PokerStars Hand #222945012898:  Hold'em No Limit ($0.05/$0.10 USD) - 2021/01/23 0:22:02 ET
Table 'Linzia' 6-max Seat #3 is the button
Seat 1: bliznec828 ($10 in chips) 
Seat 2: plisianin ($10 in chips) 
Seat 3: Samosarr ($10 in chips) 
Seat 4: Icke 816 ($10.50 in chips) 
Seat 5: Rats3366 ($7.31 in chips) 
Seat 6: Loto70 ($10.19 in chips) 
Icke 816: posts small blind $0.05
Rats3366: posts big blind $0.10
*** HOLE CARDS ***
Loto70: folds 
bliznec828: raises $0.20 to $0.30
plisianin: folds 
Samosarr: folds 
Icke 816: folds 
Rats3366: calls $0.20
*** FLOP *** [6h Qh 2s]
Icke 816 leaves the table
Rats3366: checks 
bliznec828: bets $0.41
X-rayFeeling joins the table at seat #4 
Rats3366: folds 
Uncalled bet ($0.41) returned to bliznec828
bliznec828 collected $0.62 from pot
bliznec828: doesn't show hand 
*** SUMMARY ***
Total pot $0.65 | Rake $0.03 
Board [6h Qh 2s]
Seat 1: bliznec828 collected ($0.62)
Seat 2: plisianin folded before Flop (didn't bet)
Seat 3: Samosarr (button) folded before Flop (didn't bet)
Seat 4: Icke 816 (small blind) folded before Flop
Seat 5: Rats3366 (big blind) folded on the Flop
Seat 6: Loto70 folded before Flop (didn't bet)



PokerStars Hand #222945019039:  Hold'em No Limit ($0.05/$0.10 USD) - 2021/01/23 0:22:26 ET
Table 'Linzia' 6-max Seat #5 is the button
Seat 1: bliznec828 ($10.32 in chips) 
Seat 2: plisianin ($10 in chips) 
Seat 3: Samosarr ($10 in chips) 
Seat 5: Rats3366 ($7.01 in chips) 
Seat 6: Loto70 ($10.19 in chips) 
Loto70: posts small blind $0.05
bliznec828: posts big blind $0.10
X-rayFeeling: sits out 
*** HOLE CARDS ***
plisianin: folds 
Samosarr: folds 
Rats3366: calls $0.10
Loto70: folds 
bliznec828: raises $0.25 to $0.35
Rats3366: calls $0.25
*** FLOP *** [4h 3h 2s]
bliznec828: bets $0.48
Rats3366: calls $0.48
*** TURN *** [4h 3h 2s] [4s]
bliznec828: bets $1.09
Rats3366: calls $1.09
*** RIVER *** [4h 3h 2s 4s] [Ad]
bliznec828: bets $1.22
Rats3366: calls $1.22
*** SHOW DOWN ***
bliznec828: shows [Tc Th] (two pair, Tens and Fours)
Rats3366: shows [6h Ah] (two pair, Aces and Fours)
Rats3366 collected $6.05 from pot
*** SUMMARY ***
Total pot $6.33 | Rake $0.28 
Board [4h 3h 2s 4s Ad]
Seat 1: bliznec828 (big blind) showed [Tc Th] and lost with two pair, Tens and Fours
Seat 2: plisianin folded before Flop (didn't bet)
Seat 3: Samosarr folded before Flop (didn't bet)
Seat 5: Rats3366 (button) showed [6h Ah] and won ($6.05) with two pair, Aces and Fours
Seat 6: Loto70 (small blind) folded before Flop



PokerStars Hand #222945027806:  Hold'em No Limit ($0.05/$0.10 USD) - 2021/01/23 0:22:58 ET
Table 'Linzia' 6-max Seat #6 is the button
Seat 1: bliznec828 ($10 in chips) 
Seat 2: plisianin ($10 in chips) 
Seat 3: Samosarr ($10 in chips) 
Seat 5: Rats3366 ($9.92 in chips) 
Seat 6: Loto70 ($10.14 in chips) 
bliznec828: posts small blind $0.05
plisianin: posts big blind $0.10
X-rayFeeling: sits out 
*** HOLE CARDS ***
Samosarr: folds 
Rats3366: folds 
Loto70: folds 
bliznec828: raises $0.20 to $0.30
plisianin: folds 
Uncalled bet ($0.20) returned to bliznec828
bliznec828 collected $0.20 from pot
bliznec828: doesn't show hand 
*** SUMMARY ***
Total pot $0.20 | Rake $0 
Seat 1: bliznec828 (small blind) collected ($0.20)
Seat 2: plisianin (big blind) folded before Flop
Seat 3: Samosarr folded before Flop (didn't bet)
Seat 5: Rats3366 folded before Flop (didn't bet)
Seat 6: Loto70 (button) folded before Flop (didn't bet)



PokerStars Hand #222945031142:  Hold'em No Limit ($0.05/$0.10 USD) - 2021/01/23 0:23:10 ET
Table 'Linzia' 6-max Seat #1 is the button
Seat 1: bliznec828 ($10.10 in chips) 
Seat 2: plisianin ($10 in chips) 
Seat 3: Samosarr ($10 in chips) 
Seat 5: Rats3366 ($9.92 in chips) 
Seat 6: Loto70 ($10.14 in chips) 
plisianin: posts small blind $0.05
Samosarr: posts big blind $0.10
X-rayFeeling: sits out 
*** HOLE CARDS ***
Rats3366: folds 
Loto70: raises $0.15 to $0.25
bliznec828: folds 
plisianin: folds 
Samosarr: folds 
Uncalled bet ($0.15) returned to Loto70
Loto70 collected $0.25 from pot
Loto70: doesn't show hand 
*** SUMMARY ***
Total pot $0.25 | Rake $0 
Seat 1: bliznec828 (button) folded before Flop (didn't bet)
Seat 2: plisianin (small blind) folded before Flop
Seat 3: Samosarr (big blind) folded before Flop
Seat 5: Rats3366 folded before Flop (didn't bet)
Seat 6: Loto70 collected ($0.25)



PokerStars Hand #222945035921:  Hold'em No Limit ($0.05/$0.10 USD) - 2021/01/23 0:23:27 ET
Table 'Linzia' 6-max Seat #2 is the button
Seat 1: bliznec828 ($10.10 in chips) 
Seat 2: plisianin ($10 in chips) 
Seat 3: Samosarr ($10 in chips) 
Seat 4: X-rayFeeling ($10 in chips) 
Seat 5: Rats3366 ($9.92 in chips) 
Seat 6: Loto70 ($10.29 in chips) 
Samosarr: posts small blind $0.05
X-rayFeeling: posts big blind $0.10
*** HOLE CARDS ***
Rats3366: calls $0.10
Loto70: folds 
bliznec828: folds 
plisianin: folds 
Samosarr: folds 
X-rayFeeling: checks 
*** FLOP *** [Jd 6d 6c]
X-rayFeeling: checks 
Rats3366: checks 
*** TURN *** [Jd 6d 6c] [4d]
X-rayFeeling: checks 
Rats3366: bets $0.10
X-rayFeeling: folds 
Uncalled bet ($0.10) returned to Rats3366
Rats3366 collected $0.24 from pot
*** SUMMARY ***
Total pot $0.25 | Rake $0.01 
Board [Jd 6d 6c 4d]
Seat 1: bliznec828 folded before Flop (didn't bet)
Seat 2: plisianin (button) folded before Flop (didn't bet)
Seat 3: Samosarr (small blind) folded before Flop
Seat 4: X-rayFeeling (big blind) folded on the Turn
Seat 5: Rats3366 collected ($0.24)
Seat 6: Loto70 folded before Flop (didn't bet)



PokerStars Hand #222945048699:  Hold'em No Limit ($0.05/$0.10 USD) - 2021/01/23 0:24:13 ET
Table 'Linzia' 6-max Seat #3 is the button
Seat 1: bliznec828 ($10.10 in chips) 
Seat 2: plisianin ($10 in chips) 
Seat 3: Samosarr ($10 in chips) 
Seat 4: X-rayFeeling ($10 in chips) 
Seat 5: Rats3366 ($10.06 in chips) 
Seat 6: Loto70 ($10.29 in chips) 
X-rayFeeling: posts small blind $0.05
Rats3366: posts big blind $0.10
*** HOLE CARDS ***
Loto70: folds 
bliznec828: folds 
plisianin: folds 
Samosarr: raises $0.12 to $0.22
X-rayFeeling: folds 
Rats3366: calls $0.12
*** FLOP *** [Qh 5c 8c]
Rats3366: checks 
Samosarr: bets $0.35
Rats3366: folds 
Uncalled bet ($0.35) returned to Samosarr
Samosarr collected $0.47 from pot
Samosarr: doesn't show hand 
*** SUMMARY ***
Total pot $0.49 | Rake $0.02 
Board [Qh 5c 8c]
Seat 1: bliznec828 folded before Flop (didn't bet)
Seat 2: plisianin folded before Flop (didn't bet)
Seat 3: Samosarr (button) collected ($0.47)
Seat 4: X-rayFeeling (small blind) folded before Flop
Seat 5: Rats3366 (big blind) folded on the Flop
Seat 6: Loto70 folded before Flop (didn't bet)



PokerStars Hand #222945057808:  Hold'em No Limit ($0.05/$0.10 USD) - 2021/01/23 0:24:46 ET
Table 'Linzia' 6-max Seat #4 is the button
Seat 1: bliznec828 ($10.10 in chips) 
Seat 2: plisianin ($10 in chips) 
Seat 3: Samosarr ($10.25 in chips) 
Seat 4: X-rayFeeling ($10 in chips) 
Seat 5: Rats3366 ($9.84 in chips) 
Seat 6: Loto70 ($10.29 in chips) 
Rats3366: posts small blind $0.05
Loto70: posts big blind $0.10
*** HOLE CARDS ***
bliznec828: folds 
plisianin: folds 
Samosarr: raises $0.12 to $0.22
X-rayFeeling: folds 
Rats3366: folds 
Loto70: folds 
Uncalled bet ($0.12) returned to Samosarr
Samosarr collected $0.25 from pot
Samosarr: doesn't show hand 
*** SUMMARY ***
Total pot $0.25 | Rake $0 
Seat 1: bliznec828 folded before Flop (didn't bet)
Seat 2: plisianin folded before Flop (didn't bet)
Seat 3: Samosarr collected ($0.25)
Seat 4: X-rayFeeling (button) folded before Flop (didn't bet)
Seat 5: Rats3366 (small blind) folded before Flop
Seat 6: Loto70 (big blind) folded before Flop



PokerStars Hand #222945061487:  Hold'em No Limit ($0.05/$0.10 USD) - 2021/01/23 0:25:00 ET
Table 'Linzia' 6-max Seat #5 is the button
Seat 1: bliznec828 ($10.10 in chips) 
Seat 2: plisianin ($10 in chips) 
Seat 3: Samosarr ($10.40 in chips) 
Seat 4: X-rayFeeling ($10 in chips) 
Seat 5: Rats3366 ($9.79 in chips) 
Seat 6: Loto70 ($10.19 in chips) 
Loto70: posts small blind $0.05
bliznec828: posts big blind $0.10
*** HOLE CARDS ***
plisianin: folds 
Samosarr: raises $0.15 to $0.25
X-rayFeeling: folds 
Rats3366: calls $0.25
Loto70: raises $1 to $1.25
bliznec828: folds 
Samosarr: folds 
Rats3366: folds 
Uncalled bet ($1) returned to Loto70
Loto70 collected $0.85 from pot
Loto70: doesn't show hand 
*** SUMMARY ***
Total pot $0.85 | Rake $0 
Seat 1: bliznec828 (big blind) folded before Flop
Seat 2: plisianin folded before Flop (didn't bet)
Seat 3: Samosarr folded before Flop
Seat 4: X-rayFeeling folded before Flop (didn't bet)
Seat 5: Rats3366 (button) folded before Flop
Seat 6: Loto70 (small blind) collected ($0.85)



PokerStars Hand #222945068448:  Hold'em No Limit ($0.05/$0.10 USD) - 2021/01/23 0:25:25 ET
Table 'Linzia' 6-max Seat #6 is the button
Seat 1: bliznec828 ($10 in chips) 
Seat 2: plisianin ($10 in chips) 
Seat 3: Samosarr ($10.15 in chips) 
Seat 4: X-rayFeeling ($10 in chips) 
Seat 5: Rats3366 ($9.54 in chips) 
Seat 6: Loto70 ($10.79 in chips) 
bliznec828: posts small blind $0.05
plisianin: posts big blind $0.10
*** HOLE CARDS ***
Samosarr: folds 
X-rayFeeling: folds 
Rats3366: folds 
Loto70: folds 
bliznec828: raises $0.20 to $0.30
plisianin: calls $0.20
*** FLOP *** [4s Kd 6d]
bliznec828: bets $0.29
plisianin: folds 
Uncalled bet ($0.29) returned to bliznec828
bliznec828 collected $0.57 from pot
bliznec828: doesn't show hand 
*** SUMMARY ***
Total pot $0.60 | Rake $0.03 
Board [4s Kd 6d]
Seat 1: bliznec828 (small blind) collected ($0.57)
Seat 2: plisianin (big blind) folded on the Flop
Seat 3: Samosarr folded before Flop (didn't bet)
Seat 4: X-rayFeeling folded before Flop (didn't bet)
Seat 5: Rats3366 folded before Flop (didn't bet)
Seat 6: Loto70 (button) folded before Flop (didn't bet)



PokerStars Hand #222945078187:  Hold'em No Limit ($0.05/$0.10 USD) - 2021/01/23 0:26:00 ET
Table 'Linzia' 6-max Seat #1 is the button
Seat 1: bliznec828 ($10.27 in chips) 
Seat 2: plisianin ($10 in chips) 
Seat 3: Samosarr ($10.15 in chips) 
Seat 4: X-rayFeeling ($10 in chips) 
Seat 5: Rats3366 ($9.54 in chips) 
Seat 6: Loto70 ($10.79 in chips) 
plisianin: posts small blind $0.05
Samosarr: posts big blind $0.10
*** HOLE CARDS ***
X-rayFeeling: raises $0.20 to $0.30
Rats3366: folds 
Loto70: folds 
bliznec828: folds 
plisianin: folds 
Samosarr: calls $0.20
*** FLOP *** [9c Js Qc]
Samosarr: checks 
X-rayFeeling: checks 
*** TURN *** [9c Js Qc] [Th]
Samosarr: checks 
X-rayFeeling: bets $0.37
Samosarr: folds 
Uncalled bet ($0.37) returned to X-rayFeeling
X-rayFeeling collected $0.62 from pot
X-rayFeeling: doesn't show hand 
*** SUMMARY ***
Total pot $0.65 | Rake $0.03 
Board [9c Js Qc Th]
Seat 1: bliznec828 (button) folded before Flop (didn't bet)
Seat 2: plisianin (small blind) folded before Flop
Seat 3: Samosarr (big blind) folded on the Turn
Seat 4: X-rayFeeling collected ($0.62)
Seat 5: Rats3366 folded before Flop (didn't bet)
Seat 6: Loto70 folded before Flop (didn't bet)



PokerStars Hand #222945090300:  Hold'em No Limit ($0.05/$0.10 USD) - 2021/01/23 0:26:45 ET
Table 'Linzia' 6-max Seat #2 is the button
Seat 1: bliznec828 ($10.27 in chips) 
Seat 2: plisianin ($10 in chips) 
Seat 3: Samosarr ($10 in chips) 
Seat 4: X-rayFeeling ($10.32 in chips) 
Seat 5: Rats3366 ($9.54 in chips) 
Seat 6: Loto70 ($10.79 in chips) 
Samosarr: posts small blind $0.05
X-rayFeeling: posts big blind $0.10
*** HOLE CARDS ***
Rats3366: folds 
Loto70: folds 
bliznec828: folds 
plisianin: folds 
Samosarr: folds 
Uncalled bet ($0.05) returned to X-rayFeeling
X-rayFeeling collected $0.10 from pot
X-rayFeeling: doesn't show hand 
*** SUMMARY ***
Total pot $0.10 | Rake $0 
Seat 1: bliznec828 folded before Flop (didn't bet)
Seat 2: plisianin (button) folded before Flop (didn't bet)
Seat 3: Samosarr (small blind) folded before Flop
Seat 4: X-rayFeeling (big blind) collected ($0.10)
Seat 5: Rats3366 folded before Flop (didn't bet)
Seat 6: Loto70 folded before Flop (didn't bet)



PokerStars Hand #222945093592:  Hold'em No Limit ($0.05/$0.10 USD) - 2021/01/23 0:26:57 ET
Table 'Linzia' 6-max Seat #3 is the button
Seat 1: bliznec828 ($10.27 in chips) 
Seat 2: plisianin ($10 in chips) 
Seat 3: Samosarr ($10 in chips) 
Seat 4: X-rayFeeling ($10.37 in chips) 
Seat 5: Rats3366 ($9.54 in chips) 
Seat 6: Loto70 ($10.79 in chips) 
X-rayFeeling: posts small blind $0.05
Rats3366: posts big blind $0.10
*** HOLE CARDS ***
Loto70: raises $0.20 to $0.30
bliznec828: folds 
plisianin: raises $0.75 to $1.05
Samosarr: folds 
X-rayFeeling: folds 
Rats3366: folds 
Loto70: folds 
Uncalled bet ($0.75) returned to plisianin
plisianin collected $0.75 from pot
plisianin: doesn't show hand 
*** SUMMARY ***
Total pot $0.75 | Rake $0 
Seat 1: bliznec828 folded before Flop (didn't bet)
Seat 2: plisianin collected ($0.75)
Seat 3: Samosarr (button) folded before Flop (didn't bet)
Seat 4: X-rayFeeling (small blind) folded before Flop
Seat 5: Rats3366 (big blind) folded before Flop
Seat 6: Loto70 folded before Flop



PokerStars Hand #222945102630:  Hold'em No Limit ($0.05/$0.10 USD) - 2021/01/23 0:27:30 ET
Table 'Linzia' 6-max Seat #4 is the button
Seat 1: bliznec828 ($10.27 in chips) 
Seat 2: plisianin ($10.45 in chips) 
Seat 3: Samosarr ($10 in chips) 
Seat 4: X-rayFeeling ($10.32 in chips) 
Seat 5: Rats3366 ($9.44 in chips) 
Seat 6: Loto70 ($10.49 in chips) 
Rats3366: posts small blind $0.05
Loto70: posts big blind $0.10
*** HOLE CARDS ***
bliznec828: folds 
plisianin: raises $0.15 to $0.25
Samosarr: folds 
X-rayFeeling: folds 
Rats3366: folds 
Loto70: folds 
Uncalled bet ($0.15) returned to plisianin
plisianin collected $0.25 from pot
plisianin: doesn't show hand 
*** SUMMARY ***
Total pot $0.25 | Rake $0 
Seat 1: bliznec828 folded before Flop (didn't bet)
Seat 2: plisianin collected ($0.25)
Seat 3: Samosarr folded before Flop (didn't bet)
Seat 4: X-rayFeeling (button) folded before Flop (didn't bet)
Seat 5: Rats3366 (small blind) folded before Flop
Seat 6: Loto70 (big blind) folded before Flop



PokerStars Hand #222945106108:  Hold'em No Limit ($0.05/$0.10 USD) - 2021/01/23 0:27:42 ET
Table 'Linzia' 6-max Seat #5 is the button
Seat 1: bliznec828 ($10.27 in chips) 
Seat 2: plisianin ($10.60 in chips) 
Seat 3: Samosarr ($10 in chips) 
Seat 4: X-rayFeeling ($10.32 in chips) 
Seat 5: Rats3366 ($9.39 in chips) 
Seat 6: Loto70 ($10.39 in chips) 
Loto70: posts small blind $0.05
bliznec828: posts big blind $0.10
*** HOLE CARDS ***
plisianin: folds 
Samosarr: raises $0.15 to $0.25
X-rayFeeling: calls $0.25
Rats3366: folds 
Loto70: folds 
bliznec828: folds 
*** FLOP *** [4h Qs Th]
Samosarr: checks 
X-rayFeeling: checks 
*** TURN *** [4h Qs Th] [4c]
Samosarr: bets $0.47
X-rayFeeling: folds 
Uncalled bet ($0.47) returned to Samosarr
Samosarr collected $0.62 from pot
Samosarr: doesn't show hand 
*** SUMMARY ***
Total pot $0.65 | Rake $0.03 
Board [4h Qs Th 4c]
Seat 1: bliznec828 (big blind) folded before Flop
Seat 2: plisianin folded before Flop (didn't bet)
Seat 3: Samosarr collected ($0.62)
Seat 4: X-rayFeeling folded on the Turn
Seat 5: Rats3366 (button) folded before Flop (didn't bet)
Seat 6: Loto70 (small blind) folded before Flop



PokerStars Hand #222945116868:  Hold'em No Limit ($0.05/$0.10 USD) - 2021/01/23 0:28:22 ET
Table 'Linzia' 6-max Seat #6 is the button
Seat 1: bliznec828 ($10.17 in chips) 
Seat 2: plisianin ($10.60 in chips) 
Seat 3: Samosarr ($10.37 in chips) 
Seat 4: X-rayFeeling ($10.07 in chips) 
Seat 5: Rats3366 ($9.39 in chips) 
Seat 6: Loto70 ($10.34 in chips) 
bliznec828: posts small blind $0.05
plisianin: posts big blind $0.10
*** HOLE CARDS ***
Samosarr: folds 
X-rayFeeling: raises $0.20 to $0.30
Rats3366: folds 
Loto70: folds 
bliznec828: folds 
plisianin: folds 
Uncalled bet ($0.20) returned to X-rayFeeling
X-rayFeeling collected $0.25 from pot
X-rayFeeling: doesn't show hand 
*** SUMMARY ***
Total pot $0.25 | Rake $0 
Seat 1: bliznec828 (small blind) folded before Flop
Seat 2: plisianin (big blind) folded before Flop
Seat 3: Samosarr folded before Flop (didn't bet)
Seat 4: X-rayFeeling collected ($0.25)
Seat 5: Rats3366 folded before Flop (didn't bet)
Seat 6: Loto70 (button) folded before Flop (didn't bet)



PokerStars Hand #222945119158:  Hold'em No Limit ($0.05/$0.10 USD) - 2021/01/23 0:28:31 ET
Table 'Linzia' 6-max Seat #1 is the button
Seat 1: bliznec828 ($10.12 in chips) 
Seat 2: plisianin ($10.50 in chips) 
Seat 3: Samosarr ($10.37 in chips) 
Seat 4: X-rayFeeling ($10.22 in chips) 
Seat 5: Rats3366 ($9.39 in chips) 
Seat 6: Loto70 ($10.34 in chips) 
plisianin: posts small blind $0.05
Samosarr: posts big blind $0.10
*** HOLE CARDS ***
X-rayFeeling: folds 
Rats3366: calls $0.10
Loto70: folds 
bliznec828: folds 
plisianin: folds 
Samosarr: checks 
*** FLOP *** [3s 3h Th]
Samosarr: checks 
Rats3366: bets $0.10
Samosarr: folds 
Uncalled bet ($0.10) returned to Rats3366
Rats3366 collected $0.24 from pot
*** SUMMARY ***
Total pot $0.25 | Rake $0.01 
Board [3s 3h Th]
Seat 1: bliznec828 (button) folded before Flop (didn't bet)
Seat 2: plisianin (small blind) folded before Flop
Seat 3: Samosarr (big blind) folded on the Flop
Seat 4: X-rayFeeling folded before Flop (didn't bet)
Seat 5: Rats3366 collected ($0.24)
Seat 6: Loto70 folded before Flop (didn't bet)



PokerStars Hand #222945131765:  Hold'em No Limit ($0.05/$0.10 USD) - 2021/01/23 0:28:56 ET
Table 'Linzia' 6-max Seat #2 is the button
Seat 1: bliznec828 ($10.12 in chips) 
Seat 2: plisianin ($10.45 in chips) 
Seat 3: Samosarr ($10.27 in chips) 
Seat 4: X-rayFeeling ($10.22 in chips) 
Seat 5: Rats3366 ($9.53 in chips) 
Seat 6: Loto70 ($10.34 in chips) 
Samosarr: posts small blind $0.05
X-rayFeeling: posts big blind $0.10
*** HOLE CARDS ***
Rats3366: calls $0.10
Loto70: folds 
bliznec828: folds 
plisianin: folds 
Samosarr: folds 
X-rayFeeling: checks 
*** FLOP *** [4c 6h 2h]
X-rayFeeling: checks 
Rats3366: bets $0.10
X-rayFeeling: folds 
Uncalled bet ($0.10) returned to Rats3366
Rats3366 collected $0.24 from pot
*** SUMMARY ***
Total pot $0.25 | Rake $0.01 
Board [4c 6h 2h]
Seat 1: bliznec828 folded before Flop (didn't bet)
Seat 2: plisianin (button) folded before Flop (didn't bet)
Seat 3: Samosarr (small blind) folded before Flop
Seat 4: X-rayFeeling (big blind) folded on the Flop
Seat 5: Rats3366 collected ($0.24)
Seat 6: Loto70 folded before Flop (didn't bet)



PokerStars Hand #222945138461:  Hold'em No Limit ($0.05/$0.10 USD) - 2021/01/23 0:29:21 ET
Table 'Linzia' 6-max Seat #3 is the button
Seat 1: bliznec828 ($10.12 in chips) 
Seat 2: plisianin ($10.45 in chips) 
Seat 3: Samosarr ($10.22 in chips) 
Seat 4: X-rayFeeling ($10.12 in chips) 
Seat 5: Rats3366 ($9.67 in chips) 
Seat 6: Loto70 ($10.34 in chips) 
X-rayFeeling: posts small blind $0.05
Rats3366: posts big blind $0.10
*** HOLE CARDS ***
Loto70: folds 
bliznec828: folds 
plisianin: folds 
Samosarr: folds 
X-rayFeeling: folds 
Uncalled bet ($0.05) returned to Rats3366
Rats3366 collected $0.10 from pot
*** SUMMARY ***
Total pot $0.10 | Rake $0 
Seat 1: bliznec828 folded before Flop (didn't bet)
Seat 2: plisianin folded before Flop (didn't bet)
Seat 3: Samosarr (button) folded before Flop (didn't bet)
Seat 4: X-rayFeeling (small blind) folded before Flop
Seat 5: Rats3366 (big blind) collected ($0.10)
Seat 6: Loto70 folded before Flop (didn't bet)



PokerStars Hand #222945141161:  Hold'em No Limit ($0.05/$0.10 USD) - 2021/01/23 0:29:31 ET
Table 'Linzia' 6-max Seat #4 is the button
Seat 1: bliznec828 ($10.12 in chips) 
Seat 2: plisianin ($10.45 in chips) 
Seat 3: Samosarr ($10.22 in chips) 
Seat 4: X-rayFeeling ($10.07 in chips) 
Seat 5: Rats3366 ($9.72 in chips) 
Seat 6: Loto70 ($10.34 in chips) 
Rats3366: posts small blind $0.05
Loto70: posts big blind $0.10
*** HOLE CARDS ***
bliznec828: folds 
plisianin: folds 
Samosarr: folds 
X-rayFeeling: raises $0.15 to $0.25
Rats3366: folds 
Loto70: calls $0.15
*** FLOP *** [Jd Jh 6h]
Loto70: checks 
X-rayFeeling: checks 
*** TURN *** [Jd Jh 6h] [Ah]
Loto70: bets $0.17
X-rayFeeling: calls $0.17
*** RIVER *** [Jd Jh 6h Ah] [3c]
Loto70: checks 
X-rayFeeling: bets $0.51
Loto70: folds 
Uncalled bet ($0.51) returned to X-rayFeeling
X-rayFeeling collected $0.85 from pot
X-rayFeeling: doesn't show hand 
*** SUMMARY ***
Total pot $0.89 | Rake $0.04 
Board [Jd Jh 6h Ah 3c]
Seat 1: bliznec828 folded before Flop (didn't bet)
Seat 2: plisianin folded before Flop (didn't bet)
Seat 3: Samosarr folded before Flop (didn't bet)
Seat 4: X-rayFeeling (button) collected ($0.85)
Seat 5: Rats3366 (small blind) folded before Flop
Seat 6: Loto70 (big blind) folded on the River



PokerStars Hand #222945149810:  Hold'em No Limit ($0.05/$0.10 USD) - 2021/01/23 0:30:02 ET
Table 'Linzia' 6-max Seat #5 is the button
Seat 1: bliznec828 ($10.12 in chips) 
Seat 2: plisianin ($10.45 in chips) 
Seat 3: Samosarr ($10.22 in chips) 
Seat 4: X-rayFeeling ($10.50 in chips) 
Seat 5: Rats3366 ($9.67 in chips) 
Seat 6: Loto70 ($10 in chips) 
Loto70: posts small blind $0.05
bliznec828: posts big blind $0.10
*** HOLE CARDS ***
plisianin: folds 
Samosarr: folds 
X-rayFeeling: raises $0.20 to $0.30
Rats3366: folds 
Loto70: folds 
bliznec828: folds 
Uncalled bet ($0.20) returned to X-rayFeeling
X-rayFeeling collected $0.25 from pot
X-rayFeeling: doesn't show hand 
*** SUMMARY ***
Total pot $0.25 | Rake $0 
Seat 1: bliznec828 (big blind) folded before Flop
Seat 2: plisianin folded before Flop (didn't bet)
Seat 3: Samosarr folded before Flop (didn't bet)
Seat 4: X-rayFeeling collected ($0.25)
Seat 5: Rats3366 (button) folded before Flop (didn't bet)
Seat 6: Loto70 (small blind) folded before Flop



PokerStars Hand #222945154024:  Hold'em No Limit ($0.05/$0.10 USD) - 2021/01/23 0:30:18 ET
Table 'Linzia' 6-max Seat #6 is the button
Seat 1: bliznec828 ($10.02 in chips) 
Seat 2: plisianin ($10.45 in chips) 
Seat 3: Samosarr ($10.22 in chips) 
Seat 4: X-rayFeeling ($10.65 in chips) 
Seat 5: Rats3366 ($9.67 in chips) 
Seat 6: Loto70 ($10 in chips) 
bliznec828: posts small blind $0.05
plisianin: posts big blind $0.10
*** HOLE CARDS ***
Samosarr: folds 
X-rayFeeling: folds 
Rats3366: calls $0.10
Loto70: folds 
bliznec828: folds 
plisianin: checks 
*** FLOP *** [Kd Ac 4s]
plisianin: checks 
Rats3366: bets $0.12
plisianin: calls $0.12
*** TURN *** [Kd Ac 4s] [7h]
plisianin: checks 
Rats3366: checks 
*** RIVER *** [Kd Ac 4s 7h] [Kc]
plisianin: checks 
Rats3366: bets $0.24
plisianin: folds 
Uncalled bet ($0.24) returned to Rats3366
Rats3366 collected $0.47 from pot
*** SUMMARY ***
Total pot $0.49 | Rake $0.02 
Board [Kd Ac 4s 7h Kc]
Seat 1: bliznec828 (small blind) folded before Flop
Seat 2: plisianin (big blind) folded on the River
Seat 3: Samosarr folded before Flop (didn't bet)
Seat 4: X-rayFeeling folded before Flop (didn't bet)
Seat 5: Rats3366 collected ($0.47)
Seat 6: Loto70 (button) folded before Flop (didn't bet)



PokerStars Hand #222945171004:  Hold'em No Limit ($0.05/$0.10 USD) - 2021/01/23 0:31:20 ET
Table 'Linzia' 6-max Seat #1 is the button
Seat 1: bliznec828 ($10 in chips) 
Seat 2: plisianin ($10.23 in chips) 
Seat 3: Samosarr ($10.22 in chips) 
Seat 4: X-rayFeeling ($10.65 in chips) 
Seat 5: Rats3366 ($9.92 in chips) 
Seat 6: Loto70 ($10 in chips) 
plisianin: posts small blind $0.05
Samosarr: posts big blind $0.10
*** HOLE CARDS ***
X-rayFeeling: folds 
Rats3366: calls $0.10
Loto70: raises $0.30 to $0.40
bliznec828: folds 
plisianin: folds 
Samosarr: raises $1.20 to $1.60
Rats3366: folds 
Loto70: calls $1.20
*** FLOP *** [As 9s 2h]
Samosarr: checks 
Loto70: checks 
*** TURN *** [As 9s 2h] [6h]
Samosarr: bets $1.66
Loto70: folds 
Uncalled bet ($1.66) returned to Samosarr
Samosarr collected $3.20 from pot
Samosarr: doesn't show hand 
*** SUMMARY ***
Total pot $3.35 | Rake $0.15 
Board [As 9s 2h 6h]
Seat 1: bliznec828 (button) folded before Flop (didn't bet)
Seat 2: plisianin (small blind) folded before Flop
Seat 3: Samosarr (big blind) collected ($3.20)
Seat 4: X-rayFeeling folded before Flop (didn't bet)
Seat 5: Rats3366 folded before Flop
Seat 6: Loto70 folded on the Turn



PokerStars Hand #222945186661:  Hold'em No Limit ($0.05/$0.10 USD) - 2021/01/23 0:32:18 ET
Table 'Linzia' 6-max Seat #2 is the button
Seat 1: bliznec828 ($10 in chips) 
Seat 2: plisianin ($10.18 in chips) 
Seat 3: Samosarr ($11.82 in chips) 
Seat 4: X-rayFeeling ($10.65 in chips) 
Seat 5: Rats3366 ($9.82 in chips) 
Seat 6: Loto70 ($10 in chips) 
Samosarr: posts small blind $0.05
X-rayFeeling: posts big blind $0.10
*** HOLE CARDS ***
Rats3366: folds 
Loto70: folds 
bliznec828: folds 
plisianin: folds 
Samosarr: folds 
Uncalled bet ($0.05) returned to X-rayFeeling
X-rayFeeling collected $0.10 from pot
X-rayFeeling: doesn't show hand 
*** SUMMARY ***
Total pot $0.10 | Rake $0 
Seat 1: bliznec828 folded before Flop (didn't bet)
Seat 2: plisianin (button) folded before Flop (didn't bet)
Seat 3: Samosarr (small blind) folded before Flop
Seat 4: X-rayFeeling (big blind) collected ($0.10)
Seat 5: Rats3366 folded before Flop (didn't bet)
Seat 6: Loto70 folded before Flop (didn't bet)



PokerStars Hand #222945190023:  Hold'em No Limit ($0.05/$0.10 USD) - 2021/01/23 0:32:31 ET
Table 'Linzia' 6-max Seat #3 is the button
Seat 1: bliznec828 ($10 in chips) 
Seat 2: plisianin ($10.18 in chips) 
Seat 3: Samosarr ($11.77 in chips) 
Seat 4: X-rayFeeling ($10.70 in chips) 
Seat 5: Rats3366 ($9.82 in chips) 
Seat 6: Loto70 ($10 in chips) 
X-rayFeeling: posts small blind $0.05
Rats3366: posts big blind $0.10
*** HOLE CARDS ***
Loto70: folds 
bliznec828: folds 
plisianin: folds 
Samosarr: folds 
X-rayFeeling: raises $0.20 to $0.30
Rats3366: folds 
Uncalled bet ($0.20) returned to X-rayFeeling
X-rayFeeling collected $0.20 from pot
X-rayFeeling: doesn't show hand 
*** SUMMARY ***
Total pot $0.20 | Rake $0 
Seat 1: bliznec828 folded before Flop (didn't bet)
Seat 2: plisianin folded before Flop (didn't bet)
Seat 3: Samosarr (button) folded before Flop (didn't bet)
Seat 4: X-rayFeeling (small blind) collected ($0.20)
Seat 5: Rats3366 (big blind) folded before Flop
Seat 6: Loto70 folded before Flop (didn't bet)



PokerStars Hand #222945194062:  Hold'em No Limit ($0.05/$0.10 USD) - 2021/01/23 0:32:46 ET
Table 'Linzia' 6-max Seat #4 is the button
Seat 1: bliznec828 ($10 in chips) 
Seat 2: plisianin ($10.18 in chips) 
Seat 3: Samosarr ($11.77 in chips) 
Seat 4: X-rayFeeling ($10.80 in chips) 
Seat 5: Rats3366 ($9.72 in chips) 
Seat 6: Loto70 ($10 in chips) 
Rats3366: posts small blind $0.05
Loto70: posts big blind $0.10
*** HOLE CARDS ***
bliznec828: folds 
plisianin: folds 
Samosarr: folds 
X-rayFeeling: folds 
Rats3366: calls $0.05
Loto70: checks 
*** FLOP *** [9c Qd 3s]
Rats3366: bets $0.10
Loto70: folds 
Uncalled bet ($0.10) returned to Rats3366
Rats3366 collected $0.19 from pot
*** SUMMARY ***
Total pot $0.20 | Rake $0.01 
Board [9c Qd 3s]
Seat 1: bliznec828 folded before Flop (didn't bet)
Seat 2: plisianin folded before Flop (didn't bet)
Seat 3: Samosarr folded before Flop (didn't bet)
Seat 4: X-rayFeeling (button) folded before Flop (didn't bet)
Seat 5: Rats3366 (small blind) collected ($0.19)
Seat 6: Loto70 (big blind) folded on the Flop



PokerStars Hand #222945199845:  Hold'em No Limit ($0.05/$0.10 USD) - 2021/01/23 0:33:07 ET
Table 'Linzia' 6-max Seat #5 is the button
Seat 1: bliznec828 ($10 in chips) 
Seat 2: plisianin ($10.18 in chips) 
Seat 3: Samosarr ($11.77 in chips) 
Seat 4: X-rayFeeling ($10.80 in chips) 
Seat 5: Rats3366 ($9.81 in chips) 
Seat 6: Loto70 ($10 in chips) 
Loto70: posts small blind $0.05
bliznec828: posts big blind $0.10
*** HOLE CARDS ***
plisianin: folds 
Samosarr: folds 
X-rayFeeling: folds 
Rats3366: calls $0.10
Loto70: raises $0.30 to $0.40
bliznec828: folds 
Rats3366: calls $0.30
*** FLOP *** [4d 5d Kh]
Loto70: checks 
Rats3366: checks 
*** TURN *** [4d 5d Kh] [Jh]
Loto70: bets $0.47
Rats3366: folds 
Uncalled bet ($0.47) returned to Loto70
Loto70 collected $0.86 from pot
Loto70: doesn't show hand 
*** SUMMARY ***
Total pot $0.90 | Rake $0.04 
Board [4d 5d Kh Jh]
Seat 1: bliznec828 (big blind) folded before Flop
Seat 2: plisianin folded before Flop (didn't bet)
Seat 3: Samosarr folded before Flop (didn't bet)
Seat 4: X-rayFeeling folded before Flop (didn't bet)
Seat 5: Rats3366 (button) folded on the Turn
Seat 6: Loto70 (small blind) collected ($0.86)



PokerStars Hand #222945208269:  Hold'em No Limit ($0.05/$0.10 USD) - 2021/01/23 0:33:38 ET
Table 'Linzia' 6-max Seat #6 is the button
Seat 1: bliznec828 ($10 in chips) 
Seat 2: plisianin ($10.18 in chips) 
Seat 3: Samosarr ($11.77 in chips) 
Seat 4: X-rayFeeling ($10.80 in chips) 
Seat 5: Rats3366 ($9.41 in chips) 
Seat 6: Loto70 ($10.46 in chips) 
bliznec828: posts small blind $0.05
plisianin: posts big blind $0.10
*** HOLE CARDS ***
Samosarr: raises $0.15 to $0.25
X-rayFeeling: folds 
Rats3366: folds 
Loto70: calls $0.25
bliznec828: folds 
plisianin: folds 
*** FLOP *** [Qh 6h 8d]
Samosarr: checks 
Loto70: bets $0.34
Samosarr: calls $0.34
*** TURN *** [Qh 6h 8d] [7d]
Samosarr: checks 
Loto70: bets $0.95
Samosarr: raises $2.38 to $3.33
Loto70: calls $2.38
*** RIVER *** [Qh 6h 8d 7d] [8c]
Samosarr: bets $6.54
Loto70: folds 
Uncalled bet ($6.54) returned to Samosarr
Samosarr collected $7.63 from pot
Samosarr: doesn't show hand 
*** SUMMARY ***
Total pot $7.99 | Rake $0.36 
Board [Qh 6h 8d 7d 8c]
Seat 1: bliznec828 (small blind) folded before Flop
Seat 2: plisianin (big blind) folded before Flop
Seat 3: Samosarr collected ($7.63)
Seat 4: X-rayFeeling folded before Flop (didn't bet)
Seat 5: Rats3366 folded before Flop (didn't bet)
Seat 6: Loto70 (button) folded on the River



PokerStars Hand #222945228681:  Hold'em No Limit ($0.05/$0.10 USD) - 2021/01/23 0:34:55 ET
Table 'Linzia' 6-max Seat #1 is the button
Seat 1: bliznec828 ($10 in chips) 
Seat 2: plisianin ($10.08 in chips) 
Seat 3: Samosarr ($15.48 in chips) 
Seat 4: X-rayFeeling ($10.80 in chips) 
Seat 5: Rats3366 ($9.41 in chips) 
Seat 6: Loto70 ($10 in chips) 
plisianin: posts small blind $0.05
Samosarr: posts big blind $0.10
*** HOLE CARDS ***
X-rayFeeling: raises $0.20 to $0.30
Rats3366: calls $0.30
Loto70: folds 
bliznec828: folds 
plisianin: folds 
Samosarr: folds 
*** FLOP *** [9c 2d 4d]
X-rayFeeling: bets $0.43
Rats3366: folds 
Uncalled bet ($0.43) returned to X-rayFeeling
X-rayFeeling collected $0.72 from pot
X-rayFeeling: doesn't show hand 
*** SUMMARY ***
Total pot $0.75 | Rake $0.03 
Board [9c 2d 4d]
Seat 1: bliznec828 (button) folded before Flop (didn't bet)
Seat 2: plisianin (small blind) folded before Flop
Seat 3: Samosarr (big blind) folded before Flop
Seat 4: X-rayFeeling collected ($0.72)
Seat 5: Rats3366 folded on the Flop
Seat 6: Loto70 folded before Flop (didn't bet)



PokerStars Hand #222945234810:  Hold'em No Limit ($0.05/$0.10 USD) - 2021/01/23 0:35:18 ET
Table 'Linzia' 6-max Seat #2 is the button
Seat 1: bliznec828 ($10 in chips) 
Seat 2: plisianin ($10.03 in chips) 
Seat 3: Samosarr ($15.38 in chips) 
Seat 4: X-rayFeeling ($11.22 in chips) 
Seat 5: Rats3366 ($9.11 in chips) 
Seat 6: Loto70 ($10 in chips) 
Samosarr: posts small blind $0.05
X-rayFeeling: posts big blind $0.10
*** HOLE CARDS ***
Rats3366: calls $0.10
Loto70: folds 
bliznec828: folds 
plisianin: folds 
Samosarr: raises $0.40 to $0.50
X-rayFeeling: folds 
Rats3366: folds 
Uncalled bet ($0.40) returned to Samosarr
Samosarr collected $0.30 from pot
Samosarr: doesn't show hand 
*** SUMMARY ***
Total pot $0.30 | Rake $0 
Seat 1: bliznec828 folded before Flop (didn't bet)
Seat 2: plisianin (button) folded before Flop (didn't bet)
Seat 3: Samosarr (small blind) collected ($0.30)
Seat 4: X-rayFeeling (big blind) folded before Flop
Seat 5: Rats3366 folded before Flop
Seat 6: Loto70 folded before Flop (didn't bet)



PokerStars Hand #222945240380:  Hold'em No Limit ($0.05/$0.10 USD) - 2021/01/23 0:35:39 ET
Table 'Linzia' 6-max Seat #3 is the button
Seat 1: bliznec828 ($10 in chips) 
Seat 2: plisianin ($10.03 in chips) 
Seat 3: Samosarr ($15.58 in chips) 
Seat 4: X-rayFeeling ($11.12 in chips) 
Seat 5: Rats3366 ($9.01 in chips) 
Seat 6: Loto70 ($10 in chips) 
X-rayFeeling: posts small blind $0.05
Rats3366: posts big blind $0.10
*** HOLE CARDS ***
Loto70: folds 
bliznec828: folds 
plisianin: folds 
Samosarr: raises $0.12 to $0.22
X-rayFeeling: folds 
Rats3366: calls $0.12
*** FLOP *** [2h 6h 6d]
Rats3366: bets $0.10
Samosarr: folds 
Uncalled bet ($0.10) returned to Rats3366
Rats3366 collected $0.47 from pot
*** SUMMARY ***
Total pot $0.49 | Rake $0.02 
Board [2h 6h 6d]
Seat 1: bliznec828 folded before Flop (didn't bet)
Seat 2: plisianin folded before Flop (didn't bet)
Seat 3: Samosarr (button) folded on the Flop
Seat 4: X-rayFeeling (small blind) folded before Flop
Seat 5: Rats3366 (big blind) collected ($0.47)
Seat 6: Loto70 folded before Flop (didn't bet)



PokerStars Hand #222945248669:  Hold'em No Limit ($0.05/$0.10 USD) - 2021/01/23 0:36:10 ET
Table 'Linzia' 6-max Seat #4 is the button
Seat 1: bliznec828 ($10 in chips) 
Seat 2: plisianin ($10.03 in chips) 
Seat 3: Samosarr ($15.36 in chips) 
Seat 4: X-rayFeeling ($11.07 in chips) 
Seat 5: Rats3366 ($9.26 in chips) 
Rats3366: posts small blind $0.05
Loto70: is sitting out 
bliznec828: posts big blind $0.10
*** HOLE CARDS ***
Loto70 leaves the table
plisianin: folds 
Samosarr: folds 
X-rayFeeling: folds 
Rats3366: calls $0.05
bliznec828: raises $0.30 to $0.40
Rats3366: calls $0.30
*** FLOP *** [Ts 2d 6d]
Rats3366: checks 
bliznec828: bets $0.25
Rats3366: folds 
Uncalled bet ($0.25) returned to bliznec828
bliznec828 collected $0.76 from pot
bliznec828: doesn't show hand 
*** SUMMARY ***
Total pot $0.80 | Rake $0.04 
Board [Ts 2d 6d]
Seat 1: bliznec828 (big blind) collected ($0.76)
Seat 2: plisianin folded before Flop (didn't bet)
Seat 3: Samosarr folded before Flop (didn't bet)
Seat 4: X-rayFeeling (button) folded before Flop (didn't bet)
Seat 5: Rats3366 (small blind) folded on the Flop



PokerStars Hand #222945256399:  Hold'em No Limit ($0.05/$0.10 USD) - 2021/01/23 0:36:39 ET
Table 'Linzia' 6-max Seat #5 is the button
Seat 1: bliznec828 ($10.36 in chips) 
Seat 2: plisianin ($10.03 in chips) 
Seat 3: Samosarr ($15.36 in chips) 
Seat 4: X-rayFeeling ($11.07 in chips) 
Seat 5: Rats3366 ($8.86 in chips) 
bliznec828: posts small blind $0.05
plisianin: posts big blind $0.10
*** HOLE CARDS ***
Samosarr: folds 
X-rayFeeling: raises $0.20 to $0.30
Rats3366: folds 
bliznec828: folds 
plisianin: folds 
Uncalled bet ($0.20) returned to X-rayFeeling
X-rayFeeling collected $0.25 from pot
X-rayFeeling: doesn't show hand 
*** SUMMARY ***
Total pot $0.25 | Rake $0 
Seat 1: bliznec828 (small blind) folded before Flop
Seat 2: plisianin (big blind) folded before Flop
Seat 3: Samosarr folded before Flop (didn't bet)
Seat 4: X-rayFeeling collected ($0.25)
Seat 5: Rats3366 (button) folded before Flop (didn't bet)



PokerStars Hand #222945260113:  Hold'em No Limit ($0.05/$0.10 USD) - 2021/01/23 0:36:53 ET
Table 'Linzia' 6-max Seat #1 is the button
Seat 1: bliznec828 ($10.31 in chips) 
Seat 2: plisianin ($10 in chips) 
Seat 3: Samosarr ($15.36 in chips) 
Seat 4: X-rayFeeling ($11.22 in chips) 
Seat 5: Rats3366 ($8.86 in chips) 
plisianin: posts small blind $0.05
Samosarr: posts big blind $0.10
*** HOLE CARDS ***
X-rayFeeling: folds 
Rats3366: folds 
bliznec828: folds 
plisianin: folds 
Uncalled bet ($0.05) returned to Samosarr
Samosarr collected $0.10 from pot
Samosarr: doesn't show hand 
*** SUMMARY ***
Total pot $0.10 | Rake $0 
Seat 1: bliznec828 (button) folded before Flop (didn't bet)
Seat 2: plisianin (small blind) folded before Flop
Seat 3: Samosarr (big blind) collected ($0.10)
Seat 4: X-rayFeeling folded before Flop (didn't bet)
Seat 5: Rats3366 folded before Flop (didn't bet)



PokerStars Hand #222945263965:  Hold'em No Limit ($0.05/$0.10 USD) - 2021/01/23 0:37:07 ET
Table 'Linzia' 6-max Seat #2 is the button
Seat 1: bliznec828 ($10.31 in chips) 
Seat 2: plisianin ($10 in chips) 
Seat 3: Samosarr ($15.41 in chips) 
Seat 4: X-rayFeeling ($11.22 in chips) 
Seat 5: Rats3366 ($8.86 in chips) 
Samosarr: posts small blind $0.05
X-rayFeeling: posts big blind $0.10
*** HOLE CARDS ***
Rats3366: raises $0.10 to $0.20
bliznec828: folds 
BRooK1237 joins the table at seat #6 
plisianin: folds 
Samosarr: folds 
X-rayFeeling: calls $0.10
*** FLOP *** [Ts Kh 3h]
X-rayFeeling: checks 
Rats3366: bets $0.22
X-rayFeeling: folds 
Uncalled bet ($0.22) returned to Rats3366
Rats3366 collected $0.43 from pot
*** SUMMARY ***
Total pot $0.45 | Rake $0.02 
Board [Ts Kh 3h]
Seat 1: bliznec828 folded before Flop (didn't bet)
Seat 2: plisianin (button) folded before Flop (didn't bet)
Seat 3: Samosarr (small blind) folded before Flop
Seat 4: X-rayFeeling (big blind) folded on the Flop
Seat 5: Rats3366 collected ($0.43)



PokerStars Hand #222945270681:  Hold'em No Limit ($0.05/$0.10 USD) - 2021/01/23 0:37:32 ET
Table 'Linzia' 6-max Seat #3 is the button
Seat 1: bliznec828 ($10.31 in chips) 
Seat 2: plisianin ($10 in chips) 
Seat 3: Samosarr ($15.36 in chips) 
Seat 4: X-rayFeeling ($11.02 in chips) 
Seat 5: Rats3366 ($9.09 in chips) 
Seat 6: BRooK1237 ($7.68 in chips) 
X-rayFeeling: posts small blind $0.05
Rats3366: posts big blind $0.10
BRooK1237: posts big blind $0.10
*** HOLE CARDS ***
BRooK1237: checks 
bliznec828: folds 
plisianin: folds 
Samosarr: raises $0.40 to $0.50
X-rayFeeling: folds 
Rats3366: raises $0.40 to $0.90
BRooK1237: folds 
Samosarr: calls $0.40
*** FLOP *** [Jd 2c Ks]
Rats3366: checks 
Samosarr: checks 
*** TURN *** [Jd 2c Ks] [2d]
Rats3366: bets $1.86
Samosarr has timed out
Samosarr: folds 
Uncalled bet ($1.86) returned to Rats3366
Rats3366 collected $1.86 from pot
*** SUMMARY ***
Total pot $1.95 | Rake $0.09 
Board [Jd 2c Ks 2d]
Seat 1: bliznec828 folded before Flop (didn't bet)
Seat 2: plisianin folded before Flop (didn't bet)
Seat 3: Samosarr (button) folded on the Turn
Seat 4: X-rayFeeling (small blind) folded before Flop
Seat 5: Rats3366 (big blind) collected ($1.86)
Seat 6: BRooK1237 folded before Flop (didn't bet)



PokerStars Hand #222945297632:  Hold'em No Limit ($0.05/$0.10 USD) - 2021/01/23 0:39:14 ET
Table 'Linzia' 6-max Seat #4 is the button
Seat 1: bliznec828 ($10.31 in chips) 
Seat 2: plisianin ($10 in chips) 
Seat 3: Samosarr ($14.46 in chips) 
Seat 4: X-rayFeeling ($10.97 in chips) 
Seat 5: Rats3366 ($10.05 in chips) 
Seat 6: BRooK1237 ($7.58 in chips) 
Rats3366: posts small blind $0.05
BRooK1237: posts big blind $0.10
*** HOLE CARDS ***
bliznec828: folds 
plisianin: folds 
Samosarr: raises $0.12 to $0.22
X-rayFeeling: folds 
Rats3366: folds 
BRooK1237: folds 
Uncalled bet ($0.12) returned to Samosarr
Samosarr collected $0.25 from pot
Samosarr: doesn't show hand 
*** SUMMARY ***
Total pot $0.25 | Rake $0 
Seat 1: bliznec828 folded before Flop (didn't bet)
Seat 2: plisianin folded before Flop (didn't bet)
Seat 3: Samosarr collected ($0.25)
Seat 4: X-rayFeeling (button) folded before Flop (didn't bet)
Seat 5: Rats3366 (small blind) folded before Flop
Seat 6: BRooK1237 (big blind) folded before Flop



PokerStars Hand #222945301483:  Hold'em No Limit ($0.05/$0.10 USD) - 2021/01/23 0:39:29 ET
Table 'Linzia' 6-max Seat #5 is the button
Seat 1: bliznec828 ($10.31 in chips) 
Seat 2: plisianin ($10 in chips) 
Seat 3: Samosarr ($14.61 in chips) 
Seat 4: X-rayFeeling ($10.97 in chips) 
Seat 5: Rats3366 ($10 in chips) 
Seat 6: BRooK1237 ($7.48 in chips) 
BRooK1237: posts small blind $0.05
bliznec828: posts big blind $0.10
*** HOLE CARDS ***
plisianin: folds 
Samosarr: folds 
X-rayFeeling: folds 
Rats3366: folds 
Rats3366 leaves the table
BRooK1237: calls $0.05
bliznec828: checks 
*** FLOP *** [3h Qc 2d]
BRooK1237: checks 
bliznec828: checks 
*** TURN *** [3h Qc 2d] [8s]
BRooK1237: checks 
bliznec828: checks 
*** RIVER *** [3h Qc 2d 8s] [Jc]
BRooK1237: bets $0.10
bliznec828: calls $0.10
*** SHOW DOWN ***
BRooK1237: shows [Js Ts] (a pair of Jacks)
bliznec828: shows [Qs 6h] (a pair of Queens)
bliznec828 collected $0.38 from pot
*** SUMMARY ***
Total pot $0.40 | Rake $0.02 
Board [3h Qc 2d 8s Jc]
Seat 1: bliznec828 (big blind) showed [Qs 6h] and won ($0.38) with a pair of Queens
Seat 2: plisianin folded before Flop (didn't bet)
Seat 3: Samosarr folded before Flop (didn't bet)
Seat 4: X-rayFeeling folded before Flop (didn't bet)
Seat 5: Rats3366 (button) folded before Flop (didn't bet)
Seat 6: BRooK1237 (small blind) showed [Js Ts] and lost with a pair of Jacks



PokerStars Hand #222945313877:  Hold'em No Limit ($0.05/$0.10 USD) - 2021/01/23 0:40:16 ET
Table 'Linzia' 6-max Seat #6 is the button
Seat 1: bliznec828 ($10.49 in chips) 
Seat 2: plisianin ($10 in chips) 
Seat 3: Samosarr ($14.61 in chips) 
Seat 4: X-rayFeeling ($10.97 in chips) 
Seat 6: BRooK1237 ($7.28 in chips) 
bliznec828: posts small blind $0.05
plisianin: posts big blind $0.10
*** HOLE CARDS ***
Devarm011974 joins the table at seat #5 
Samosarr: folds 
X-rayFeeling: folds 
BRooK1237: calls $0.10
bliznec828: raises $0.25 to $0.35
plisianin: raises $0.95 to $1.30
BRooK1237: calls $1.20
bliznec828: folds 
*** FLOP *** [5h 5s 2c]
plisianin: bets $0.93
BRooK1237: folds 
Uncalled bet ($0.93) returned to plisianin
plisianin collected $2.82 from pot
plisianin: doesn't show hand 
*** SUMMARY ***
Total pot $2.95 | Rake $0.13 
Board [5h 5s 2c]
Seat 1: bliznec828 (small blind) folded before Flop
Seat 2: plisianin (big blind) collected ($2.82)
Seat 3: Samosarr folded before Flop (didn't bet)
Seat 4: X-rayFeeling folded before Flop (didn't bet)
Seat 6: BRooK1237 (button) folded on the Flop



PokerStars Hand #222945324479:  Hold'em No Limit ($0.05/$0.10 USD) - 2021/01/23 0:40:56 ET
Table 'Linzia' 6-max Seat #1 is the button
Seat 1: bliznec828 ($10.14 in chips) 
Seat 2: plisianin ($11.52 in chips) 
Seat 3: Samosarr ($14.61 in chips) 
Seat 4: X-rayFeeling ($10.97 in chips) 
Seat 6: BRooK1237 ($5.98 in chips) 
plisianin: posts small blind $0.05
Samosarr: posts big blind $0.10
Devarm011974: sits out 
*** HOLE CARDS ***
X-rayFeeling: folds 
BRooK1237: folds 
bliznec828: raises $0.15 to $0.25
plisianin: folds 
Samosarr: folds 
Uncalled bet ($0.15) returned to bliznec828
bliznec828 collected $0.25 from pot
bliznec828: doesn't show hand 
*** SUMMARY ***
Total pot $0.25 | Rake $0 
Seat 1: bliznec828 (button) collected ($0.25)
Seat 2: plisianin (small blind) folded before Flop
Seat 3: Samosarr (big blind) folded before Flop
Seat 4: X-rayFeeling folded before Flop (didn't bet)
Seat 6: BRooK1237 folded before Flop (didn't bet)



PokerStars Hand #222945330545:  Hold'em No Limit ($0.05/$0.10 USD) - 2021/01/23 0:41:20 ET
Table 'Linzia' 6-max Seat #2 is the button
Seat 1: bliznec828 ($10.29 in chips) 
Seat 2: plisianin ($11.47 in chips) 
Seat 3: Samosarr ($14.51 in chips) 
Seat 4: X-rayFeeling ($10.97 in chips) 
Seat 6: BRooK1237 ($5.98 in chips) 
Samosarr: posts small blind $0.05
X-rayFeeling: posts big blind $0.10
Devarm011974: sits out 
*** HOLE CARDS ***
BRooK1237: folds 
bliznec828: folds 
plisianin: folds 
Samosarr: raises $0.12 to $0.22
X-rayFeeling: raises $0.78 to $1
Samosarr: folds 
Uncalled bet ($0.78) returned to X-rayFeeling
X-rayFeeling collected $0.44 from pot
X-rayFeeling: doesn't show hand 
*** SUMMARY ***
Total pot $0.44 | Rake $0 
Seat 1: bliznec828 folded before Flop (didn't bet)
Seat 2: plisianin (button) folded before Flop (didn't bet)
Seat 3: Samosarr (small blind) folded before Flop
Seat 4: X-rayFeeling (big blind) collected ($0.44)
Seat 6: BRooK1237 folded before Flop (didn't bet)



PokerStars Hand #222945336323:  Hold'em No Limit ($0.05/$0.10 USD) - 2021/01/23 0:41:41 ET
Table 'Linzia' 6-max Seat #3 is the button
Seat 1: bliznec828 ($10.29 in chips) 
Seat 2: plisianin ($11.47 in chips) 
Seat 3: Samosarr ($14.29 in chips) 
Seat 4: X-rayFeeling ($11.19 in chips) 
Seat 5: Devarm011974 ($6.51 in chips) 
Seat 6: BRooK1237 ($5.98 in chips) 
X-rayFeeling: posts small blind $0.05
Devarm011974: posts big blind $0.10
*** HOLE CARDS ***
BRooK1237: calls $0.10
bliznec828: folds 
plisianin: folds 
Samosarr: folds 
X-rayFeeling: folds 
Devarm011974: checks 
*** FLOP *** [8s 2d 9c]
Devarm011974: checks 
BRooK1237: checks 
*** TURN *** [8s 2d 9c] [6s]
Devarm011974: checks 
BRooK1237: checks 
*** RIVER *** [8s 2d 9c 6s] [3s]
Devarm011974: bets $0.10
BRooK1237: raises $0.40 to $0.50
Devarm011974: folds 
Uncalled bet ($0.40) returned to BRooK1237
BRooK1237 collected $0.43 from pot
BRooK1237: doesn't show hand 
*** SUMMARY ***
Total pot $0.45 | Rake $0.02 
Board [8s 2d 9c 6s 3s]
Seat 1: bliznec828 folded before Flop (didn't bet)
Seat 2: plisianin folded before Flop (didn't bet)
Seat 3: Samosarr (button) folded before Flop (didn't bet)
Seat 4: X-rayFeeling (small blind) folded before Flop
Seat 5: Devarm011974 (big blind) folded on the River
Seat 6: BRooK1237 collected ($0.43)



PokerStars Hand #222945344898:  Hold'em No Limit ($0.05/$0.10 USD) - 2021/01/23 0:42:14 ET
Table 'Linzia' 6-max Seat #4 is the button
Seat 1: bliznec828 ($10.29 in chips) 
Seat 2: plisianin ($11.47 in chips) 
Seat 3: Samosarr ($14.29 in chips) 
Seat 4: X-rayFeeling ($11.14 in chips) 
Seat 5: Devarm011974 ($6.31 in chips) 
Seat 6: BRooK1237 ($6.21 in chips) 
Devarm011974: posts small blind $0.05
BRooK1237: posts big blind $0.10
*** HOLE CARDS ***
bliznec828: folds 
plisianin: raises $0.15 to $0.25
Samosarr: folds 
X-rayFeeling: folds 
Devarm011974: calls $0.20
BRooK1237: calls $0.15
*** FLOP *** [Js 5s Kc]
Devarm011974: checks 
BRooK1237: checks 
plisianin: bets $0.50
Devarm011974: folds 
BRooK1237: calls $0.50
*** TURN *** [Js 5s Kc] [7d]
BRooK1237: checks 
plisianin: bets $0.90
BRooK1237: calls $0.90
*** RIVER *** [Js 5s Kc 7d] [4s]
BRooK1237: checks 
plisianin: bets $1.20
BRooK1237: calls $1.20
*** SHOW DOWN ***
plisianin: shows [5d 5h] (three of a kind, Fives)
BRooK1237: shows [3s 7s] (a flush, Jack high)
BRooK1237 collected $5.68 from pot
*** SUMMARY ***
Total pot $5.95 | Rake $0.27 
Board [Js 5s Kc 7d 4s]
Seat 1: bliznec828 folded before Flop (didn't bet)
Seat 2: plisianin showed [5d 5h] and lost with three of a kind, Fives
Seat 3: Samosarr folded before Flop (didn't bet)
Seat 4: X-rayFeeling (button) folded before Flop (didn't bet)
Seat 5: Devarm011974 (small blind) folded on the Flop
Seat 6: BRooK1237 (big blind) showed [3s 7s] and won ($5.68) with a flush, Jack high



PokerStars Hand #222945362022:  Hold'em No Limit ($0.05/$0.10 USD) - 2021/01/23 0:43:06 ET
Table 'Linzia' 6-max Seat #5 is the button
Seat 1: bliznec828 ($10.29 in chips) 
Seat 2: plisianin ($10 in chips) 
Seat 3: Samosarr ($14.29 in chips) 
Seat 4: X-rayFeeling ($11.14 in chips) 
Seat 5: Devarm011974 ($6.06 in chips) 
Seat 6: BRooK1237 ($9.04 in chips) 
BRooK1237: posts small blind $0.05
bliznec828: posts big blind $0.10
*** HOLE CARDS ***
plisianin has timed out
plisianin: folds 
Samosarr: folds 
X-rayFeeling: raises $0.20 to $0.30
Devarm011974: folds 
BRooK1237: calls $0.25
bliznec828: folds 
*** FLOP *** [4h 3d Td]
BRooK1237: checks 
X-rayFeeling: bets $0.40
BRooK1237: folds 
Uncalled bet ($0.40) returned to X-rayFeeling
X-rayFeeling collected $0.67 from pot
X-rayFeeling: doesn't show hand 
*** SUMMARY ***
Total pot $0.70 | Rake $0.03 
Board [4h 3d Td]
Seat 1: bliznec828 (big blind) folded before Flop
Seat 2: plisianin folded before Flop (didn't bet)
Seat 3: Samosarr folded before Flop (didn't bet)
Seat 4: X-rayFeeling collected ($0.67)
Seat 5: Devarm011974 (button) folded before Flop (didn't bet)
Seat 6: BRooK1237 (small blind) folded on the Flop



PokerStars Hand #222945481214:  Hold'em No Limit ($0.05/$0.10 USD) - 2021/01/23 0:50:51 ET
Table 'Linzia' 6-max Seat #5 is the button
Seat 1: bliznec828 ($10.51 in chips) 
Seat 2: plisianin ($10.40 in chips) 
Seat 3: Samosarr ($13.90 in chips) 
Seat 4: X-rayFeeling ($11.21 in chips) 
Seat 5: Devarm011974 ($5.84 in chips) 
Seat 6: Ginger_Hunter86 ($11.41 in chips) 
Ginger_Hunter86: posts small blind $0.05
bliznec828: posts big blind $0.10
*** HOLE CARDS ***
plisianin: folds 
Samosarr: folds 
X-rayFeeling: raises $0.20 to $0.30
Devarm011974: folds 
Ginger_Hunter86: calls $0.25
bliznec828: folds 
*** FLOP *** [Jh Js 4d]
Ginger_Hunter86: checks 
X-rayFeeling: bets $0.40
Ginger_Hunter86: calls $0.40
*** TURN *** [Jh Js 4d] [Kc]
Ginger_Hunter86: checks 
X-rayFeeling: bets $0.86
Ginger_Hunter86: calls $0.86
*** RIVER *** [Jh Js 4d Kc] [5c]
Ginger_Hunter86: bets $3.08
X-rayFeeling: folds 
Uncalled bet ($3.08) returned to Ginger_Hunter86
Ginger_Hunter86 collected $3.08 from pot
Ginger_Hunter86: doesn't show hand 
*** SUMMARY ***
Total pot $3.22 | Rake $0.14 
Board [Jh Js 4d Kc 5c]
Seat 1: bliznec828 (big blind) folded before Flop
Seat 2: plisianin folded before Flop (didn't bet)
Seat 3: Samosarr folded before Flop (didn't bet)
Seat 4: X-rayFeeling folded on the River
Seat 5: Devarm011974 (button) folded before Flop (didn't bet)
Seat 6: Ginger_Hunter86 (small blind) collected ($3.08)



PokerStars Hand #222945505180:  Hold'em No Limit ($0.05/$0.10 USD) - 2021/01/23 0:52:25 ET
Table 'Linzia' 6-max Seat #6 is the button
Seat 1: bliznec828 ($10.41 in chips) 
Seat 2: plisianin ($10.40 in chips) 
Seat 3: Samosarr ($13.90 in chips) 
Seat 4: X-rayFeeling ($10 in chips) 
Seat 5: Devarm011974 ($5.84 in chips) 
Seat 6: Ginger_Hunter86 ($12.93 in chips) 
bliznec828: posts small blind $0.05
plisianin: posts big blind $0.10
*** HOLE CARDS ***
Samosarr: folds 
X-rayFeeling: folds 
Devarm011974: calls $0.10
Ginger_Hunter86: folds 
bliznec828: calls $0.05
plisianin: checks 
*** FLOP *** [9h 2h 4s]
bliznec828: checks 
plisianin: checks 
Devarm011974: checks 
*** TURN *** [9h 2h 4s] [7s]
bliznec828: checks 
plisianin: checks 
Devarm011974: checks 
*** RIVER *** [9h 2h 4s 7s] [4d]
bliznec828: bets $0.10
plisianin: folds 
Devarm011974: folds 
Uncalled bet ($0.10) returned to bliznec828
bliznec828 collected $0.29 from pot
bliznec828: doesn't show hand 
*** SUMMARY ***
Total pot $0.30 | Rake $0.01 
Board [9h 2h 4s 7s 4d]
Seat 1: bliznec828 (small blind) collected ($0.29)
Seat 2: plisianin (big blind) folded on the River
Seat 3: Samosarr folded before Flop (didn't bet)
Seat 4: X-rayFeeling folded before Flop (didn't bet)
Seat 5: Devarm011974 folded on the River
Seat 6: Ginger_Hunter86 (button) folded before Flop (didn't bet)



PokerStars Hand #222945525540:  Hold'em No Limit ($0.05/$0.10 USD) - 2021/01/23 0:53:17 ET
Table 'Linzia' 6-max Seat #1 is the button
Seat 1: bliznec828 ($10.60 in chips) 
Seat 2: plisianin ($10.30 in chips) 
Seat 3: Samosarr ($13.90 in chips) 
Seat 4: X-rayFeeling ($10 in chips) 
Seat 5: Devarm011974 ($5.74 in chips) 
Seat 6: Ginger_Hunter86 ($12.93 in chips) 
plisianin: posts small blind $0.05
Samosarr: posts big blind $0.10
*** HOLE CARDS ***
X-rayFeeling: raises $0.20 to $0.30
Devarm011974: raises $0.20 to $0.50
Ginger_Hunter86: folds 
bliznec828: folds 
plisianin: folds 
Samosarr: folds 
X-rayFeeling: calls $0.20
*** FLOP *** [5h 7s 8c]
X-rayFeeling: checks 
Devarm011974: bets $0.10
X-rayFeeling: calls $0.10
*** TURN *** [5h 7s 8c] [8h]
X-rayFeeling: checks 
Devarm011974: bets $0.64
X-rayFeeling: folds 
Uncalled bet ($0.64) returned to Devarm011974
Devarm011974 collected $1.29 from pot
Devarm011974: doesn't show hand 
*** SUMMARY ***
Total pot $1.35 | Rake $0.06 
Board [5h 7s 8c 8h]
Seat 1: bliznec828 (button) folded before Flop (didn't bet)
Seat 2: plisianin (small blind) folded before Flop
Seat 3: Samosarr (big blind) folded before Flop
Seat 4: X-rayFeeling folded on the Turn
Seat 5: Devarm011974 collected ($1.29)
Seat 6: Ginger_Hunter86 folded before Flop (didn't bet)



PokerStars Hand #222945534572:  Hold'em No Limit ($0.05/$0.10 USD) - 2021/01/23 0:53:53 ET
Table 'Linzia' 6-max Seat #2 is the button
Seat 1: bliznec828 ($10.60 in chips) 
Seat 2: plisianin ($10.25 in chips) 
Seat 3: Samosarr ($13.80 in chips) 
Seat 4: X-rayFeeling ($10 in chips) 
Seat 5: Devarm011974 ($6.43 in chips) 
Seat 6: Ginger_Hunter86 ($12.93 in chips) 
Samosarr: posts small blind $0.05
X-rayFeeling: posts big blind $0.10
*** HOLE CARDS ***
Devarm011974: raises $0.10 to $0.20
Ginger_Hunter86: folds 
bliznec828: folds 
plisianin: folds 
Samosarr: folds 
X-rayFeeling: folds 
Uncalled bet ($0.10) returned to Devarm011974
Devarm011974 collected $0.25 from pot
Devarm011974: doesn't show hand 
*** SUMMARY ***
Total pot $0.25 | Rake $0 
Seat 1: bliznec828 folded before Flop (didn't bet)
Seat 2: plisianin (button) folded before Flop (didn't bet)
Seat 3: Samosarr (small blind) folded before Flop
Seat 4: X-rayFeeling (big blind) folded before Flop
Seat 5: Devarm011974 collected ($0.25)
Seat 6: Ginger_Hunter86 folded before Flop (didn't bet)



PokerStars Hand #222945539718:  Hold'em No Limit ($0.05/$0.10 USD) - 2021/01/23 0:54:13 ET
Table 'Linzia' 6-max Seat #3 is the button
Seat 1: bliznec828 ($10.60 in chips) 
Seat 2: plisianin ($10.25 in chips) 
Seat 3: Samosarr ($13.75 in chips) 
Seat 4: X-rayFeeling ($10 in chips) 
Seat 5: Devarm011974 ($6.58 in chips) 
Seat 6: Ginger_Hunter86 ($12.93 in chips) 
X-rayFeeling: posts small blind $0.05
Devarm011974: posts big blind $0.10
*** HOLE CARDS ***
Ginger_Hunter86: raises $0.20 to $0.30
bliznec828: folds 
plisianin: folds 
Samosarr: folds 
X-rayFeeling: folds 
Devarm011974: calls $0.20
*** FLOP *** [3h Th Tc]
Devarm011974: checks 
Ginger_Hunter86: bets $0.31
Devarm011974: folds 
Uncalled bet ($0.31) returned to Ginger_Hunter86
Ginger_Hunter86 collected $0.62 from pot
Ginger_Hunter86: doesn't show hand 
*** SUMMARY ***
Total pot $0.65 | Rake $0.03 
Board [3h Th Tc]
Seat 1: bliznec828 folded before Flop (didn't bet)
Seat 2: plisianin folded before Flop (didn't bet)
Seat 3: Samosarr (button) folded before Flop (didn't bet)
Seat 4: X-rayFeeling (small blind) folded before Flop
Seat 5: Devarm011974 (big blind) folded on the Flop
Seat 6: Ginger_Hunter86 collected ($0.62)



PokerStars Hand #222945549590:  Hold'em No Limit ($0.05/$0.10 USD) - 2021/01/23 0:54:53 ET
Table 'Linzia' 6-max Seat #4 is the button
Seat 1: bliznec828 ($10.60 in chips) 
Seat 2: plisianin ($10.25 in chips) 
Seat 3: Samosarr ($13.75 in chips) 
Seat 4: X-rayFeeling ($10 in chips) 
Seat 5: Devarm011974 ($6.28 in chips) 
Seat 6: Ginger_Hunter86 ($13.25 in chips) 
Devarm011974: posts small blind $0.05
Ginger_Hunter86: posts big blind $0.10
*** HOLE CARDS ***
bliznec828: folds 
plisianin: folds 
Samosarr: raises $0.12 to $0.22
X-rayFeeling: folds 
Devarm011974: folds 
Ginger_Hunter86: raises $0.28 to $0.50
Samosarr: folds 
Uncalled bet ($0.28) returned to Ginger_Hunter86
Ginger_Hunter86 collected $0.49 from pot
Ginger_Hunter86: doesn't show hand 
*** SUMMARY ***
Total pot $0.49 | Rake $0 
Seat 1: bliznec828 folded before Flop (didn't bet)
Seat 2: plisianin folded before Flop (didn't bet)
Seat 3: Samosarr folded before Flop
Seat 4: X-rayFeeling (button) folded before Flop (didn't bet)
Seat 5: Devarm011974 (small blind) folded before Flop
Seat 6: Ginger_Hunter86 (big blind) collected ($0.49)



PokerStars Hand #222945553842:  Hold'em No Limit ($0.05/$0.10 USD) - 2021/01/23 0:55:11 ET
Table 'Linzia' 6-max Seat #5 is the button
Seat 1: bliznec828 ($10.60 in chips) 
Seat 2: plisianin ($10.25 in chips) 
Seat 3: Samosarr ($13.53 in chips) 
Seat 4: X-rayFeeling ($10 in chips) 
Seat 5: Devarm011974 ($6.23 in chips) 
Seat 6: Ginger_Hunter86 ($13.52 in chips) 
Ginger_Hunter86: posts small blind $0.05
bliznec828: posts big blind $0.10
*** HOLE CARDS ***
plisianin: folds 
Samosarr: raises $0.15 to $0.25
X-rayFeeling: folds 
Devarm011974: folds 
Ginger_Hunter86: folds 
bliznec828: folds 
Uncalled bet ($0.15) returned to Samosarr
Samosarr collected $0.25 from pot
Samosarr: doesn't show hand 
*** SUMMARY ***
Total pot $0.25 | Rake $0 
Seat 1: bliznec828 (big blind) folded before Flop
Seat 2: plisianin folded before Flop (didn't bet)
Seat 3: Samosarr collected ($0.25)
Seat 4: X-rayFeeling folded before Flop (didn't bet)
Seat 5: Devarm011974 (button) folded before Flop (didn't bet)
Seat 6: Ginger_Hunter86 (small blind) folded before Flop



PokerStars Hand #222945556619:  Hold'em No Limit ($0.05/$0.10 USD) - 2021/01/23 0:55:25 ET
Table 'Linzia' 6-max Seat #6 is the button
Seat 1: bliznec828 ($10.50 in chips) 
Seat 2: plisianin ($10.25 in chips) 
Seat 3: Samosarr ($13.68 in chips) 
Seat 4: X-rayFeeling ($10 in chips) 
Seat 5: Devarm011974 ($6.23 in chips) 
Seat 6: Ginger_Hunter86 ($13.47 in chips) 
bliznec828: posts small blind $0.05
plisianin: posts big blind $0.10
*** HOLE CARDS ***
Samosarr: folds 
X-rayFeeling: folds 
Devarm011974: raises $0.10 to $0.20
Ginger_Hunter86: calls $0.20
bliznec828: folds 
plisianin: calls $0.10
*** FLOP *** [Js Ad Qc]
plisianin: checks 
Devarm011974: bets $0.31
Ginger_Hunter86: calls $0.31
plisianin: calls $0.31
*** TURN *** [Js Ad Qc] [5h]
plisianin: checks 
Devarm011974: bets $0.10
Ginger_Hunter86: raises $0.40 to $0.50
plisianin: folds 
Devarm011974: calls $0.40
*** RIVER *** [Js Ad Qc 5h] [8s]
Devarm011974: checks 
Ginger_Hunter86: bets $1.40
Devarm011974: folds 
Uncalled bet ($1.40) returned to Ginger_Hunter86
Ginger_Hunter86 collected $2.46 from pot
Ginger_Hunter86: doesn't show hand 
*** SUMMARY ***
Total pot $2.58 | Rake $0.12 
Board [Js Ad Qc 5h 8s]
Seat 1: bliznec828 (small blind) folded before Flop
Seat 2: plisianin (big blind) folded on the Turn
Seat 3: Samosarr folded before Flop (didn't bet)
Seat 4: X-rayFeeling folded before Flop (didn't bet)
Seat 5: Devarm011974 folded on the River
Seat 6: Ginger_Hunter86 (button) collected ($2.46)



PokerStars Hand #222945579749:  Hold'em No Limit ($0.05/$0.10 USD) - 2021/01/23 0:57:21 ET
Table 'Linzia' 6-max Seat #1 is the button
Seat 1: bliznec828 ($10.45 in chips) 
Seat 2: plisianin ($10 in chips) 
Seat 3: Samosarr ($13.68 in chips) 
Seat 4: X-rayFeeling ($10 in chips) 
Seat 5: Devarm011974 ($5.22 in chips) 
Seat 6: Ginger_Hunter86 ($14.92 in chips) 
plisianin: posts small blind $0.05
Samosarr: posts big blind $0.10
*** HOLE CARDS ***
X-rayFeeling: folds 
Devarm011974: folds 
Ginger_Hunter86: folds 
bliznec828: raises $0.15 to $0.25
plisianin: folds 
Samosarr: calls $0.15
*** FLOP *** [4h 5s 9s]
Samosarr: checks 
bliznec828: bets $0.17
Samosarr: folds 
Uncalled bet ($0.17) returned to bliznec828
bliznec828 collected $0.53 from pot
bliznec828: doesn't show hand 
*** SUMMARY ***
Total pot $0.55 | Rake $0.02 
Board [4h 5s 9s]
Seat 1: bliznec828 (button) collected ($0.53)
Seat 2: plisianin (small blind) folded before Flop
Seat 3: Samosarr (big blind) folded on the Flop
Seat 4: X-rayFeeling folded before Flop (didn't bet)
Seat 5: Devarm011974 folded before Flop (didn't bet)
Seat 6: Ginger_Hunter86 folded before Flop (didn't bet)



PokerStars Hand #222945584993:  Hold'em No Limit ($0.05/$0.10 USD) - 2021/01/23 0:57:47 ET
Table 'Linzia' 6-max Seat #2 is the button
Seat 1: bliznec828 ($10.73 in chips) 
Seat 2: plisianin ($10 in chips) 
Seat 3: Samosarr ($13.43 in chips) 
Seat 4: X-rayFeeling ($10 in chips) 
Seat 5: Devarm011974 ($5.22 in chips) 
Seat 6: Ginger_Hunter86 ($14.92 in chips) 
Samosarr: posts small blind $0.05
X-rayFeeling: posts big blind $0.10
*** HOLE CARDS ***
Devarm011974: calls $0.10
Ginger_Hunter86: calls $0.10
bliznec828: folds 
plisianin: folds 
Samosarr: folds 
X-rayFeeling: checks 
*** FLOP *** [Qd 6c 7d]
X-rayFeeling: checks 
Devarm011974: checks 
Ginger_Hunter86: bets $0.20
X-rayFeeling: folds 
Devarm011974: raises $0.73 to $0.93
Ginger_Hunter86: folds 
Uncalled bet ($0.73) returned to Devarm011974
Devarm011974 collected $0.72 from pot
Devarm011974: doesn't show hand 
*** SUMMARY ***
Total pot $0.75 | Rake $0.03 
Board [Qd 6c 7d]
Seat 1: bliznec828 folded before Flop (didn't bet)
Seat 2: plisianin (button) folded before Flop (didn't bet)
Seat 3: Samosarr (small blind) folded before Flop
Seat 4: X-rayFeeling (big blind) folded on the Flop
Seat 5: Devarm011974 collected ($0.72)
Seat 6: Ginger_Hunter86 folded on the Flop



PokerStars Hand #222945592159:  Hold'em No Limit ($0.05/$0.10 USD) - 2021/01/23 0:58:23 ET
Table 'Linzia' 6-max Seat #3 is the button
Seat 1: bliznec828 ($10.73 in chips) 
Seat 2: plisianin ($10 in chips) 
Seat 3: Samosarr ($13.38 in chips) 
Seat 4: X-rayFeeling ($10 in chips) 
Seat 5: Devarm011974 ($5.64 in chips) 
Seat 6: Ginger_Hunter86 ($14.62 in chips) 
X-rayFeeling: posts small blind $0.05
Devarm011974: posts big blind $0.10
*** HOLE CARDS ***
Ginger_Hunter86: folds 
bliznec828: folds 
plisianin: folds 
Samosarr: raises $0.12 to $0.22
X-rayFeeling: folds 
Devarm011974: raises $0.49 to $0.71
Samosarr: folds 
Uncalled bet ($0.49) returned to Devarm011974
Devarm011974 collected $0.49 from pot
Devarm011974: doesn't show hand 
*** SUMMARY ***
Total pot $0.49 | Rake $0 
Seat 1: bliznec828 folded before Flop (didn't bet)
Seat 2: plisianin folded before Flop (didn't bet)
Seat 3: Samosarr (button) folded before Flop
Seat 4: X-rayFeeling (small blind) folded before Flop
Seat 5: Devarm011974 (big blind) collected ($0.49)
Seat 6: Ginger_Hunter86 folded before Flop (didn't bet)



PokerStars Hand #222945597189:  Hold'em No Limit ($0.05/$0.10 USD) - 2021/01/23 0:58:48 ET
Table 'Linzia' 6-max Seat #4 is the button
Seat 1: bliznec828 ($10.73 in chips) 
Seat 2: plisianin ($10 in chips) 
Seat 3: Samosarr ($13.16 in chips) 
Seat 4: X-rayFeeling ($10 in chips) 
Seat 5: Devarm011974 ($5.91 in chips) 
Seat 6: Ginger_Hunter86 ($14.62 in chips) 
Devarm011974: posts small blind $0.05
Ginger_Hunter86: posts big blind $0.10
*** HOLE CARDS ***
bliznec828: folds 
plisianin: folds 
Samosarr: raises $0.12 to $0.22
X-rayFeeling: raises $0.68 to $0.90
Devarm011974: folds 
Ginger_Hunter86: calls $0.80
Samosarr: folds 
*** FLOP *** [Kc 6h 8d]
Ginger_Hunter86: checks 
X-rayFeeling: bets $1.19
Ginger_Hunter86: calls $1.19
*** TURN *** [Kc 6h 8d] [3c]
Ginger_Hunter86: checks 
X-rayFeeling: checks 
*** RIVER *** [Kc 6h 8d 3c] [Qd]
Ginger_Hunter86: bets $2.10
X-rayFeeling: calls $2.10
*** SHOW DOWN ***
Ginger_Hunter86: shows [Kh Ks] (three of a kind, Kings)
X-rayFeeling: mucks hand 
Ginger_Hunter86 collected $8.26 from pot
*** SUMMARY ***
Total pot $8.65 | Rake $0.39 
Board [Kc 6h 8d 3c Qd]
Seat 1: bliznec828 folded before Flop (didn't bet)
Seat 2: plisianin folded before Flop (didn't bet)
Seat 3: Samosarr folded before Flop
Seat 4: X-rayFeeling (button) mucked
Seat 5: Devarm011974 (small blind) folded before Flop
Seat 6: Ginger_Hunter86 (big blind) showed [Kh Ks] and won ($8.26) with three of a kind, Kings



PokerStars Hand #222945610882:  Hold'em No Limit ($0.05/$0.10 USD) - 2021/01/23 0:59:57 ET
Table 'Linzia' 6-max Seat #5 is the button
Seat 1: bliznec828 ($10.73 in chips) 
Seat 2: plisianin ($10 in chips) 
Seat 3: Samosarr ($12.94 in chips) 
Seat 4: X-rayFeeling ($10 in chips) 
Seat 5: Devarm011974 ($5.86 in chips) 
Seat 6: Ginger_Hunter86 ($18.69 in chips) 
Ginger_Hunter86: posts small blind $0.05
bliznec828: posts big blind $0.10
*** HOLE CARDS ***
plisianin: folds 
Samosarr: folds 
X-rayFeeling: raises $0.20 to $0.30
Devarm011974: calls $0.30
Ginger_Hunter86: folds 
bliznec828: folds 
*** FLOP *** [4h 9h 9d]
X-rayFeeling: checks 
Devarm011974: checks 
*** TURN *** [4h 9h 9d] [9s]
X-rayFeeling: checks 
Devarm011974: checks 
*** RIVER *** [4h 9h 9d 9s] [Qd]
X-rayFeeling: checks 
Devarm011974: checks 
*** SHOW DOWN ***
X-rayFeeling: shows [Kh Td] (three of a kind, Nines)
Devarm011974: shows [Ac Kd] (three of a kind, Nines - Ace kicker)
Devarm011974 collected $0.72 from pot
*** SUMMARY ***
Total pot $0.75 | Rake $0.03 
Board [4h 9h 9d 9s Qd]
Seat 1: bliznec828 (big blind) folded before Flop
Seat 2: plisianin folded before Flop (didn't bet)
Seat 3: Samosarr folded before Flop (didn't bet)
Seat 4: X-rayFeeling showed [Kh Td] and lost with three of a kind, Nines
Seat 5: Devarm011974 (button) showed [Ac Kd] and won ($0.72) with three of a kind, Nines
Seat 6: Ginger_Hunter86 (small blind) folded before Flop



PokerStars Hand #222945619624:  Hold'em No Limit ($0.05/$0.10 USD) - 2021/01/23 1:00:36 ET
Table 'Linzia' 6-max Seat #6 is the button
Seat 1: bliznec828 ($10.63 in chips) 
Seat 2: plisianin ($10 in chips) 
Seat 3: Samosarr ($12.94 in chips) 
Seat 4: X-rayFeeling ($10 in chips) 
Seat 5: Devarm011974 ($6.28 in chips) 
Seat 6: Ginger_Hunter86 ($18.64 in chips) 
bliznec828: posts small blind $0.05
plisianin: posts big blind $0.10
*** HOLE CARDS ***
Samosarr: folds 
X-rayFeeling: folds 
Devarm011974: calls $0.10
Ginger_Hunter86: folds 
bliznec828: raises $0.25 to $0.35
plisianin: folds 
Devarm011974: calls $0.25
*** FLOP *** [Jd Kc Ts]
bliznec828: checks 
Devarm011974: checks 
*** TURN *** [Jd Kc Ts] [9d]
bliznec828: checks 
Devarm011974: bets $0.38
bliznec828: folds 
Uncalled bet ($0.38) returned to Devarm011974
Devarm011974 collected $0.76 from pot
Devarm011974: doesn't show hand 
*** SUMMARY ***
Total pot $0.80 | Rake $0.04 
Board [Jd Kc Ts 9d]
Seat 1: bliznec828 (small blind) folded on the Turn
Seat 2: plisianin (big blind) folded before Flop
Seat 3: Samosarr folded before Flop (didn't bet)
Seat 4: X-rayFeeling folded before Flop (didn't bet)
Seat 5: Devarm011974 collected ($0.76)
Seat 6: Ginger_Hunter86 (button) folded before Flop (didn't bet)



PokerStars Hand #222945627240:  Hold'em No Limit ($0.05/$0.10 USD) - 2021/01/23 1:01:08 ET
Table 'Linzia' 6-max Seat #1 is the button
Seat 1: bliznec828 ($10.28 in chips) 
Seat 2: plisianin ($10 in chips) 
Seat 3: Samosarr ($12.94 in chips) 
Seat 4: X-rayFeeling ($10 in chips) 
Seat 5: Devarm011974 ($6.69 in chips) 
Seat 6: Ginger_Hunter86 ($18.64 in chips) 
plisianin: posts small blind $0.05
Samosarr: posts big blind $0.10
*** HOLE CARDS ***
X-rayFeeling: folds 
Devarm011974: calls $0.10
Ginger_Hunter86: calls $0.10
bliznec828: folds 
plisianin has timed out
plisianin: folds 
Samosarr: raises $0.30 to $0.40
Devarm011974: calls $0.30
Ginger_Hunter86: calls $0.30
*** FLOP *** [4s Kh Tc]
Samosarr: checks 
Devarm011974: checks 
Ginger_Hunter86: bets $0.60
Samosarr: folds 
Devarm011974: folds 
Uncalled bet ($0.60) returned to Ginger_Hunter86
Ginger_Hunter86 collected $1.19 from pot
Ginger_Hunter86: doesn't show hand 
*** SUMMARY ***
Total pot $1.25 | Rake $0.06 
Board [4s Kh Tc]
Seat 1: bliznec828 (button) folded before Flop (didn't bet)
Seat 2: plisianin (small blind) folded before Flop
Seat 3: Samosarr (big blind) folded on the Flop
Seat 4: X-rayFeeling folded before Flop (didn't bet)
Seat 5: Devarm011974 folded on the Flop
Seat 6: Ginger_Hunter86 collected ($1.19)



PokerStars Hand #222945651507:  Hold'em No Limit ($0.05/$0.10 USD) - 2021/01/23 1:02:48 ET
Table 'Linzia' 6-max Seat #2 is the button
Seat 1: bliznec828 ($10.28 in chips) 
Seat 2: plisianin ($10 in chips) 
Seat 3: Samosarr ($12.54 in chips) 
Seat 4: X-rayFeeling ($10 in chips) 
Seat 5: Devarm011974 ($6.29 in chips) 
Seat 6: Ginger_Hunter86 ($19.43 in chips) 
Samosarr: posts small blind $0.05
X-rayFeeling: posts big blind $0.10
*** HOLE CARDS ***
Devarm011974: calls $0.10
Ginger_Hunter86: folds 
bliznec828: folds 
plisianin: folds 
Samosarr: folds 
X-rayFeeling: checks 
*** FLOP *** [4h Jc 6d]
X-rayFeeling: checks 
Devarm011974: bets $0.10
X-rayFeeling: folds 
Uncalled bet ($0.10) returned to Devarm011974
Devarm011974 collected $0.24 from pot
Devarm011974: doesn't show hand 
*** SUMMARY ***
Total pot $0.25 | Rake $0.01 
Board [4h Jc 6d]
Seat 1: bliznec828 folded before Flop (didn't bet)
Seat 2: plisianin (button) folded before Flop (didn't bet)
Seat 3: Samosarr (small blind) folded before Flop
Seat 4: X-rayFeeling (big blind) folded on the Flop
Seat 5: Devarm011974 collected ($0.24)
Seat 6: Ginger_Hunter86 folded before Flop (didn't bet)



PokerStars Hand #222945655990:  Hold'em No Limit ($0.05/$0.10 USD) - 2021/01/23 1:03:06 ET
Table 'Linzia' 6-max Seat #3 is the button
Seat 1: bliznec828 ($10.28 in chips) 
Seat 2: plisianin ($10 in chips) 
Seat 3: Samosarr ($12.49 in chips) 
Seat 4: X-rayFeeling ($10 in chips) 
Seat 5: Devarm011974 ($6.43 in chips) 
Seat 6: Ginger_Hunter86 ($19.43 in chips) 
X-rayFeeling: posts small blind $0.05
Devarm011974: posts big blind $0.10
*** HOLE CARDS ***
Ginger_Hunter86: folds 
bliznec828: folds 
plisianin: raises $0.15 to $0.25
Samosarr: folds 
X-rayFeeling: folds 
Devarm011974: calls $0.15
*** FLOP *** [5h As 3c]
Devarm011974: checks 
plisianin: checks 
*** TURN *** [5h As 3c] [5d]
Devarm011974: bets $0.10
plisianin: folds 
Uncalled bet ($0.10) returned to Devarm011974
Devarm011974 collected $0.53 from pot
Devarm011974: doesn't show hand 
*** SUMMARY ***
Total pot $0.55 | Rake $0.02 
Board [5h As 3c 5d]
Seat 1: bliznec828 folded before Flop (didn't bet)
Seat 2: plisianin folded on the Turn
Seat 3: Samosarr (button) folded before Flop (didn't bet)
Seat 4: X-rayFeeling (small blind) folded before Flop
Seat 5: Devarm011974 (big blind) collected ($0.53)
Seat 6: Ginger_Hunter86 folded before Flop (didn't bet)



PokerStars Hand #222945665889:  Hold'em No Limit ($0.05/$0.10 USD) - 2021/01/23 1:03:46 ET
Table 'Linzia' 6-max Seat #4 is the button
Seat 1: bliznec828 ($10.28 in chips) 
Seat 2: plisianin ($10 in chips) 
Seat 3: Samosarr ($12.49 in chips) 
Seat 4: X-rayFeeling ($10 in chips) 
Seat 5: Devarm011974 ($6.71 in chips) 
Seat 6: Ginger_Hunter86 ($19.43 in chips) 
Devarm011974: posts small blind $0.05
Ginger_Hunter86: posts big blind $0.10
*** HOLE CARDS ***
bliznec828: folds 
plisianin: folds 
Samosarr: folds 
X-rayFeeling: raises $0.15 to $0.25
Devarm011974: calls $0.20
Ginger_Hunter86: folds 
*** FLOP *** [9s 3s 3h]
Devarm011974: checks 
X-rayFeeling: checks 
*** TURN *** [9s 3s 3h] [Ah]
Devarm011974: checks 
X-rayFeeling: checks 
*** RIVER *** [9s 3s 3h Ah] [2d]
Devarm011974: checks 
X-rayFeeling: checks 
*** SHOW DOWN ***
Devarm011974: shows [8c Kc] (a pair of Threes)
X-rayFeeling: mucks hand 
Devarm011974 collected $0.57 from pot
*** SUMMARY ***
Total pot $0.60 | Rake $0.03 
Board [9s 3s 3h Ah 2d]
Seat 1: bliznec828 folded before Flop (didn't bet)
Seat 2: plisianin folded before Flop (didn't bet)
Seat 3: Samosarr folded before Flop (didn't bet)
Seat 4: X-rayFeeling (button) mucked
Seat 5: Devarm011974 (small blind) showed [8c Kc] and won ($0.57) with a pair of Threes
Seat 6: Ginger_Hunter86 (big blind) folded before Flop



PokerStars Hand #222945672280:  Hold'em No Limit ($0.05/$0.10 USD) - 2021/01/23 1:04:13 ET
Table 'Linzia' 6-max Seat #5 is the button
Seat 1: bliznec828 ($10.28 in chips) 
Seat 2: plisianin ($10 in chips) 
Seat 3: Samosarr ($12.49 in chips) 
Seat 4: X-rayFeeling ($10 in chips) 
Seat 5: Devarm011974 ($7.03 in chips) 
Seat 6: Ginger_Hunter86 ($19.33 in chips) 
Ginger_Hunter86: posts small blind $0.05
bliznec828: posts big blind $0.10
*** HOLE CARDS ***
plisianin: folds 
Samosarr: raises $0.12 to $0.22
X-rayFeeling: folds 
Devarm011974: folds 
Ginger_Hunter86: calls $0.17
bliznec828: folds 
*** FLOP *** [4d Tc 6c]
Ginger_Hunter86: bets $0.30
Samosarr: calls $0.30
*** TURN *** [4d Tc 6c] [Qd]
Ginger_Hunter86: checks 
Samosarr: checks 
*** RIVER *** [4d Tc 6c Qd] [2s]
Ginger_Hunter86: bets $0.55
Samosarr: calls $0.55
*** SHOW DOWN ***
Ginger_Hunter86: shows [7h 6d] (a pair of Sixes)
Samosarr: shows [Ts Kc] (a pair of Tens)
Samosarr collected $2.14 from pot
*** SUMMARY ***
Total pot $2.24 | Rake $0.10 
Board [4d Tc 6c Qd 2s]
Seat 1: bliznec828 (big blind) folded before Flop
Seat 2: plisianin folded before Flop (didn't bet)
Seat 3: Samosarr showed [Ts Kc] and won ($2.14) with a pair of Tens
Seat 4: X-rayFeeling folded before Flop (didn't bet)
Seat 5: Devarm011974 (button) folded before Flop (didn't bet)
Seat 6: Ginger_Hunter86 (small blind) showed [7h 6d] and lost with a pair of Sixes



PokerStars Hand #222945687267:  Hold'em No Limit ($0.05/$0.10 USD) - 2021/01/23 1:05:12 ET
Table 'Linzia' 6-max Seat #6 is the button
Seat 1: bliznec828 ($10.18 in chips) 
Seat 2: plisianin ($10 in chips) 
Seat 3: Samosarr ($13.56 in chips) 
Seat 4: X-rayFeeling ($10 in chips) 
Seat 5: Devarm011974 ($7.03 in chips) 
Seat 6: Ginger_Hunter86 ($18.26 in chips) 
bliznec828: posts small blind $0.05
plisianin: posts big blind $0.10
*** HOLE CARDS ***
Samosarr: folds 
X-rayFeeling: folds 
Devarm011974: folds 
Ginger_Hunter86: raises $0.10 to $0.20
bliznec828: folds 
plisianin: calls $0.10
*** FLOP *** [9d 4d 7c]
plisianin: checks 
Ginger_Hunter86: bets $0.43
plisianin: folds 
Uncalled bet ($0.43) returned to Ginger_Hunter86
Ginger_Hunter86 collected $0.43 from pot
Ginger_Hunter86: doesn't show hand 
*** SUMMARY ***
Total pot $0.45 | Rake $0.02 
Board [9d 4d 7c]
Seat 1: bliznec828 (small blind) folded before Flop
Seat 2: plisianin (big blind) folded on the Flop
Seat 3: Samosarr folded before Flop (didn't bet)
Seat 4: X-rayFeeling folded before Flop (didn't bet)
Seat 5: Devarm011974 folded before Flop (didn't bet)
Seat 6: Ginger_Hunter86 (button) collected ($0.43)



PokerStars Hand #222945701740:  Hold'em No Limit ($0.05/$0.10 USD) - 2021/01/23 1:06:09 ET
Table 'Linzia' 6-max Seat #1 is the button
Seat 1: bliznec828 ($10.13 in chips) 
Seat 2: plisianin ($10 in chips) 
Seat 3: Samosarr ($13.56 in chips) 
Seat 4: X-rayFeeling ($10 in chips) 
Seat 5: Devarm011974 ($7.03 in chips) 
Seat 6: Ginger_Hunter86 ($18.49 in chips) 
plisianin: posts small blind $0.05
Samosarr: posts big blind $0.10
*** HOLE CARDS ***
X-rayFeeling: folds 
Devarm011974: calls $0.10
Ginger_Hunter86: folds 
bliznec828: raises $0.25 to $0.35
plisianin: folds 
Samosarr: calls $0.25
Devarm011974: calls $0.25
*** FLOP *** [5d Ks 5s]
Samosarr: checks 
Devarm011974: checks 
bliznec828: bets $0.53
Samosarr: calls $0.53
Devarm011974: folds 
*** TURN *** [5d Ks 5s] [Qd]
Samosarr: checks 
bliznec828: bets $1.37
Samosarr: calls $1.37
*** RIVER *** [5d Ks 5s Qd] [2d]
Samosarr: checks 
bliznec828: bets $7.88 and is all-in
Samosarr: calls $7.88
*** SHOW DOWN ***
bliznec828: shows [9c Ts] (a pair of Fives)
Samosarr: shows [Kh Jd] (two pair, Kings and Fives)
Samosarr collected $19.73 from pot
*** SUMMARY ***
Total pot $20.66 | Rake $0.93 
Board [5d Ks 5s Qd 2d]
Seat 1: bliznec828 (button) showed [9c Ts] and lost with a pair of Fives
Seat 2: plisianin (small blind) folded before Flop
Seat 3: Samosarr (big blind) showed [Kh Jd] and won ($19.73) with two pair, Kings and Fives
Seat 4: X-rayFeeling folded before Flop (didn't bet)
Seat 5: Devarm011974 folded on the Flop
Seat 6: Ginger_Hunter86 folded before Flop (didn't bet)



PokerStars Hand #222945731894:  Hold'em No Limit ($0.05/$0.10 USD) - 2021/01/23 1:08:10 ET
Table 'Linzia' 6-max Seat #2 is the button
Seat 1: bliznec828 ($10 in chips) 
Seat 2: plisianin ($10 in chips) 
Seat 3: Samosarr ($23.16 in chips) 
Seat 4: X-rayFeeling ($10 in chips) 
Seat 5: Devarm011974 ($6.68 in chips) 
Seat 6: Ginger_Hunter86 ($18.49 in chips) 
Samosarr: posts small blind $0.05
X-rayFeeling: posts big blind $0.10
*** HOLE CARDS ***
Devarm011974: folds 
Ginger_Hunter86: calls $0.10
bliznec828: folds 
plisianin: folds 
Samosarr: folds 
X-rayFeeling: checks 
*** FLOP *** [2s 8d 5h]
X-rayFeeling: checks 
Ginger_Hunter86: bets $0.20
X-rayFeeling: folds 
Uncalled bet ($0.20) returned to Ginger_Hunter86
Ginger_Hunter86 collected $0.24 from pot
Ginger_Hunter86: doesn't show hand 
*** SUMMARY ***
Total pot $0.25 | Rake $0.01 
Board [2s 8d 5h]
Seat 1: bliznec828 folded before Flop (didn't bet)
Seat 2: plisianin (button) folded before Flop (didn't bet)
Seat 3: Samosarr (small blind) folded before Flop
Seat 4: X-rayFeeling (big blind) folded on the Flop
Seat 5: Devarm011974 folded before Flop (didn't bet)
Seat 6: Ginger_Hunter86 collected ($0.24)



PokerStars Hand #222945736122:  Hold'em No Limit ($0.05/$0.10 USD) - 2021/01/23 1:08:27 ET
Table 'Linzia' 6-max Seat #3 is the button
Seat 1: bliznec828 ($10 in chips) 
Seat 2: plisianin ($10 in chips) 
Seat 3: Samosarr ($23.11 in chips) 
Seat 4: X-rayFeeling ($10 in chips) 
Seat 5: Devarm011974 ($6.68 in chips) 
Seat 6: Ginger_Hunter86 ($18.63 in chips) 
X-rayFeeling: posts small blind $0.05
Devarm011974: posts big blind $0.10
*** HOLE CARDS ***
Ginger_Hunter86: raises $0.20 to $0.30
bliznec828: folds 
plisianin: folds 
Samosarr: calls $0.30
X-rayFeeling: folds 
Devarm011974: calls $0.20
*** FLOP *** [3h Ts Th]
Devarm011974: checks 
Ginger_Hunter86: bets $0.40
Samosarr: calls $0.40
Devarm011974: calls $0.40
*** TURN *** [3h Ts Th] [2d]
Devarm011974: checks 
Ginger_Hunter86: bets $0.80
Samosarr: folds 
Devarm011974: calls $0.80
*** RIVER *** [3h Ts Th 2d] [6c]
Devarm011974: checks 
Ginger_Hunter86: checks 
*** SHOW DOWN ***
Devarm011974: shows [Ah Qs] (a pair of Tens)
Ginger_Hunter86: shows [As Qh] (a pair of Tens)
Devarm011974 collected $1.79 from pot
Ginger_Hunter86 collected $1.79 from pot
*** SUMMARY ***
Total pot $3.75 | Rake $0.17 
Board [3h Ts Th 2d 6c]
Seat 1: bliznec828 folded before Flop (didn't bet)
Seat 2: plisianin folded before Flop (didn't bet)
Seat 3: Samosarr (button) folded on the Turn
Seat 4: X-rayFeeling (small blind) folded before Flop
Seat 5: Devarm011974 (big blind) showed [Ah Qs] and won ($1.79) with a pair of Tens
Seat 6: Ginger_Hunter86 showed [As Qh] and won ($1.79) with a pair of Tens



PokerStars Hand #222945753033:  Hold'em No Limit ($0.05/$0.10 USD) - 2021/01/23 1:09:35 ET
Table 'Linzia' 6-max Seat #4 is the button
Seat 1: bliznec828 ($10 in chips) 
Seat 2: plisianin ($10 in chips) 
Seat 3: Samosarr ($22.41 in chips) 
Seat 4: X-rayFeeling ($10 in chips) 
Seat 5: Devarm011974 ($6.97 in chips) 
Seat 6: Ginger_Hunter86 ($18.92 in chips) 
Devarm011974: posts small blind $0.05
Ginger_Hunter86: posts big blind $0.10
*** HOLE CARDS ***
bliznec828: folds 
plisianin: folds 
Samosarr: folds 
X-rayFeeling: folds 
Devarm011974: calls $0.05
Ginger_Hunter86: raises $0.20 to $0.30
Devarm011974: calls $0.20
*** FLOP *** [9d 8c 3s]
Devarm011974: checks 
Ginger_Hunter86: bets $0.30
Devarm011974: calls $0.30
*** TURN *** [9d 8c 3s] [7h]
Devarm011974: checks 
Ginger_Hunter86: bets $0.50
Devarm011974: folds 
Uncalled bet ($0.50) returned to Ginger_Hunter86
Ginger_Hunter86 collected $1.15 from pot
Ginger_Hunter86: doesn't show hand 
*** SUMMARY ***
Total pot $1.20 | Rake $0.05 
Board [9d 8c 3s 7h]
Seat 1: bliznec828 folded before Flop (didn't bet)
Seat 2: plisianin folded before Flop (didn't bet)
Seat 3: Samosarr folded before Flop (didn't bet)
Seat 4: X-rayFeeling (button) folded before Flop (didn't bet)
Seat 5: Devarm011974 (small blind) folded on the Turn
Seat 6: Ginger_Hunter86 (big blind) collected ($1.15)



PokerStars Hand #222945761048:  Hold'em No Limit ($0.05/$0.10 USD) - 2021/01/23 1:10:07 ET
Table 'Linzia' 6-max Seat #5 is the button
Seat 1: bliznec828 ($10 in chips) 
Seat 3: Samosarr ($22.41 in chips) 
Seat 4: X-rayFeeling ($10 in chips) 
Seat 5: Devarm011974 ($6.37 in chips) 
Seat 6: Ginger_Hunter86 ($19.47 in chips) 
Ginger_Hunter86: posts small blind $0.05
bliznec828: posts big blind $0.10
*** HOLE CARDS ***
Samosarr: raises $0.20 to $0.30
X-rayFeeling: folds 
Devarm011974: folds 
Ginger_Hunter86: calls $0.25
bliznec828: folds 
*** FLOP *** [Tc Jd 7h]
Ginger_Hunter86: checks 
Samosarr: bets $0.35
Ginger_Hunter86: calls $0.35
*** TURN *** [Tc Jd 7h] [Qc]
Ginger_Hunter86: checks 
Samosarr: bets $1.01
Ginger_Hunter86: calls $1.01
*** RIVER *** [Tc Jd 7h Qc] [6h]
Ginger_Hunter86: checks 
Samosarr: bets $2.50
Ginger_Hunter86: folds 
Uncalled bet ($2.50) returned to Samosarr
Samosarr collected $3.27 from pot
Samosarr: doesn't show hand 
*** SUMMARY ***
Total pot $3.42 | Rake $0.15 
Board [Tc Jd 7h Qc 6h]
Seat 1: bliznec828 (big blind) folded before Flop
Seat 3: Samosarr collected ($3.27)
Seat 4: X-rayFeeling folded before Flop (didn't bet)
Seat 5: Devarm011974 (button) folded before Flop (didn't bet)
Seat 6: Ginger_Hunter86 (small blind) folded on the River



PokerStars Hand #222945785897:  Hold'em No Limit ($0.05/$0.10 USD) - 2021/01/23 1:11:08 ET
Table 'Linzia' 6-max Seat #6 is the button
Seat 1: bliznec828 ($10 in chips) 
Seat 3: Samosarr ($24.02 in chips) 
Seat 5: Devarm011974 ($6.37 in chips) 
Seat 6: Ginger_Hunter86 ($17.81 in chips) 
bliznec828: posts small blind $0.05
Samosarr: posts big blind $0.10
*** HOLE CARDS ***
Devarm011974: calls $0.10
Ginger_Hunter86: calls $0.10
bliznec828: calls $0.05
Samosarr: raises $0.40 to $0.50
Devarm011974: calls $0.40
Ginger_Hunter86: calls $0.40
bliznec828: folds 
*** FLOP *** [3d Qh 4s]
Samosarr: bets $0.50
Devarm011974: folds 
Ginger_Hunter86: folds 
Uncalled bet ($0.50) returned to Samosarr
Samosarr collected $1.53 from pot
Samosarr: doesn't show hand 
*** SUMMARY ***
Total pot $1.60 | Rake $0.07 
Board [3d Qh 4s]
Seat 1: bliznec828 (small blind) folded before Flop
Seat 3: Samosarr (big blind) collected ($1.53)
Seat 5: Devarm011974 folded on the Flop
Seat 6: Ginger_Hunter86 (button) folded on the Flop



PokerStars Hand #222945793939:  Hold'em No Limit ($0.05/$0.10 USD) - 2021/01/23 1:11:40 ET
Table 'Linzia' 6-max Seat #1 is the button
Seat 1: bliznec828 ($10 in chips) 
Seat 3: Samosarr ($25.05 in chips) 
Seat 5: Devarm011974 ($5.87 in chips) 
Seat 6: Ginger_Hunter86 ($17.31 in chips) 
Samosarr: posts small blind $0.05
Devarm011974: posts big blind $0.10
*** HOLE CARDS ***
Ginger_Hunter86: raises $0.20 to $0.30
bliznec828: folds 
Samosarr: folds 
Devarm011974: calls $0.20
*** FLOP *** [8c 2h Qs]
Devarm011974: checks 
Ginger_Hunter86: bets $0.31
Devarm011974: raises $0.31 to $0.62
Ginger_Hunter86: calls $0.31
*** TURN *** [8c 2h Qs] [4h]
Devarm011974: checks 
Ginger_Hunter86: checks 
*** RIVER *** [8c 2h Qs 4h] [9d]
Devarm011974: bets $0.90
Ginger_Hunter86: calls $0.90
*** SHOW DOWN ***
Devarm011974: shows [Kd 7c] (high card King)
Ginger_Hunter86: shows [9s Ts] (a pair of Nines)
Ginger_Hunter86 collected $3.52 from pot
*** SUMMARY ***
Total pot $3.69 | Rake $0.17 
Board [8c 2h Qs 4h 9d]
Seat 1: bliznec828 (button) folded before Flop (didn't bet)
Seat 3: Samosarr (small blind) folded before Flop
Seat 5: Devarm011974 (big blind) showed [Kd 7c] and lost with high card King
Seat 6: Ginger_Hunter86 showed [9s Ts] and won ($3.52) with a pair of Nines



PokerStars Hand #222945803273:  Hold'em No Limit ($0.05/$0.10 USD) - 2021/01/23 1:12:17 ET
Table 'Linzia' 6-max Seat #3 is the button
Seat 1: bliznec828 ($10 in chips) 
Seat 3: Samosarr ($25 in chips) 
Seat 5: Devarm011974 ($4.05 in chips) 
Seat 6: Ginger_Hunter86 ($19.01 in chips) 
Devarm011974: posts small blind $0.05
Ginger_Hunter86: posts big blind $0.10
*** HOLE CARDS ***
bliznec828: raises $0.15 to $0.25
Samosarr: folds 
Devarm011974: raises $0.60 to $0.85
Ginger_Hunter86: folds 
bliznec828: calls $0.60
*** FLOP *** [Ks 4c 9c]
Devarm011974: checks 
bliznec828: checks 
*** TURN *** [Ks 4c 9c] [6d]
Devarm011974: checks 
bliznec828: checks 
*** RIVER *** [Ks 4c 9c 6d] [Qh]
Devarm011974: bets $3.20 and is all-in
bliznec828: folds 
Uncalled bet ($3.20) returned to Devarm011974
Devarm011974 collected $1.72 from pot
Devarm011974: doesn't show hand 
*** SUMMARY ***
Total pot $1.80 | Rake $0.08 
Board [Ks 4c 9c 6d Qh]
Seat 1: bliznec828 folded on the River
Seat 3: Samosarr (button) folded before Flop (didn't bet)
Seat 5: Devarm011974 (small blind) collected ($1.72)
Seat 6: Ginger_Hunter86 (big blind) folded before Flop



PokerStars Hand #222945823312:  Hold'em No Limit ($0.05/$0.10 USD) - 2021/01/23 1:13:39 ET
Table 'Linzia' 6-max Seat #5 is the button
Seat 1: bliznec828 ($10 in chips) 
Seat 3: Samosarr ($25 in chips) 
Seat 5: Devarm011974 ($4.92 in chips) 
Seat 6: Ginger_Hunter86 ($18.91 in chips) 
Ginger_Hunter86: posts small blind $0.05
bliznec828: posts big blind $0.10
*** HOLE CARDS ***
Samosarr: folds 
Devarm011974: folds 
Ginger_Hunter86: calls $0.05
bliznec828: checks 
*** FLOP *** [3h Kd Jh]
Ginger_Hunter86: checks 
bliznec828: bets $0.10
Ginger_Hunter86: folds 
Uncalled bet ($0.10) returned to bliznec828
bliznec828 collected $0.19 from pot
bliznec828: doesn't show hand 
*** SUMMARY ***
Total pot $0.20 | Rake $0.01 
Board [3h Kd Jh]
Seat 1: bliznec828 (big blind) collected ($0.19)
Seat 3: Samosarr folded before Flop (didn't bet)
Seat 5: Devarm011974 (button) folded before Flop (didn't bet)
Seat 6: Ginger_Hunter86 (small blind) folded on the Flop



PokerStars Hand #222945829858:  Hold'em No Limit ($0.05/$0.10 USD) - 2021/01/23 1:14:06 ET
Table 'Linzia' 6-max Seat #6 is the button
Seat 1: bliznec828 ($10.09 in chips) 
Seat 3: Samosarr ($25 in chips) 
Seat 5: Devarm011974 ($4.92 in chips) 
Seat 6: Ginger_Hunter86 ($18.81 in chips) 
bliznec828: posts small blind $0.05
Samosarr: posts big blind $0.10
*** HOLE CARDS ***
Devarm011974: calls $0.10
Ginger_Hunter86: calls $0.10
bliznec828: folds 
Samosarr: checks 
*** FLOP *** [Ks Tc 3h]
Samosarr: bets $0.11
Devarm011974: calls $0.11
Ginger_Hunter86: calls $0.11
*** TURN *** [Ks Tc 3h] [Qd]
Samosarr: bets $0.49
Devarm011974: folds 
Ginger_Hunter86: calls $0.49
*** RIVER *** [Ks Tc 3h Qd] [3s]
Samosarr: bets $1.19
Ginger_Hunter86: folds 
Uncalled bet ($1.19) returned to Samosarr
Samosarr collected $1.59 from pot
Samosarr: doesn't show hand 
*** SUMMARY ***
Total pot $1.66 | Rake $0.07 
Board [Ks Tc 3h Qd 3s]
Seat 1: bliznec828 (small blind) folded before Flop
Seat 3: Samosarr (big blind) collected ($1.59)
Seat 5: Devarm011974 folded on the Turn
Seat 6: Ginger_Hunter86 (button) folded on the River



PokerStars Hand #222945842298:  Hold'em No Limit ($0.05/$0.10 USD) - 2021/01/23 1:14:56 ET
Table 'Linzia' 6-max Seat #1 is the button
Seat 1: bliznec828 ($10.04 in chips) 
Seat 3: Samosarr ($25.89 in chips) 
Seat 5: Devarm011974 ($4.71 in chips) 
Seat 6: Ginger_Hunter86 ($18.11 in chips) 
Samosarr: posts small blind $0.05
Devarm011974: posts big blind $0.10
*** HOLE CARDS ***
Ginger_Hunter86: raises $0.20 to $0.30
bliznec828: folds 
Samosarr: folds 
Devarm011974: raises $0.20 to $0.50
Ginger_Hunter86: raises $1 to $1.50
Devarm011974: calls $1
*** FLOP *** [9d 7h Ks]
Devarm011974: bets $3.21 and is all-in
Ginger_Hunter86: calls $3.21
*** TURN *** [9d 7h Ks] [Ac]
*** RIVER *** [9d 7h Ks Ac] [Qc]
*** SHOW DOWN ***
Devarm011974: shows [Jh Kd] (a pair of Kings)
Ginger_Hunter86: shows [Kc Ad] (two pair, Aces and Kings)
Ginger_Hunter86 collected $9.04 from pot
*** SUMMARY ***
Total pot $9.47 | Rake $0.43 
Board [9d 7h Ks Ac Qc]
Seat 1: bliznec828 (button) folded before Flop (didn't bet)
Seat 3: Samosarr (small blind) folded before Flop
Seat 5: Devarm011974 (big blind) showed [Jh Kd] and lost with a pair of Kings
Seat 6: Ginger_Hunter86 showed [Kc Ad] and won ($9.04) with two pair, Aces and Kings



PokerStars Hand #222945850785:  Hold'em No Limit ($0.05/$0.10 USD) - 2021/01/23 1:15:30 ET
Table 'Linzia' 6-max Seat #3 is the button
Seat 1: bliznec828 ($10.04 in chips) 
Seat 3: Samosarr ($25.84 in chips) 
Seat 6: Ginger_Hunter86 ($22.44 in chips) 
Ginger_Hunter86: posts small blind $0.05
bliznec828: posts big blind $0.10
*** HOLE CARDS ***
Samosarr: folds 
Ginger_Hunter86: calls $0.05
bliznec828: checks 
*** FLOP *** [6h Qs Jd]
Ginger_Hunter86: checks 
Devarm011974 leaves the table
bliznec828: checks 
*** TURN *** [6h Qs Jd] [Ad]
Ginger_Hunter86: bets $0.20
bliznec828: folds 
Uncalled bet ($0.20) returned to Ginger_Hunter86
Ginger_Hunter86 collected $0.19 from pot
Ginger_Hunter86: doesn't show hand 
*** SUMMARY ***
Total pot $0.20 | Rake $0.01 
Board [6h Qs Jd Ad]
Seat 1: bliznec828 (big blind) folded on the Turn
Seat 3: Samosarr (button) folded before Flop (didn't bet)
Seat 6: Ginger_Hunter86 (small blind) collected ($0.19)



PokerStars Hand #222945858123:  Hold'em No Limit ($0.05/$0.10 USD) - 2021/01/23 1:16:00 ET
Table 'Linzia' 6-max Seat #6 is the button
Seat 1: bliznec828 ($10 in chips) 
Seat 3: Samosarr ($25.84 in chips) 
Seat 6: Ginger_Hunter86 ($22.53 in chips) 
bliznec828: posts small blind $0.05
Samosarr: posts big blind $0.10
X-rayFeeling: sits out 
*** HOLE CARDS ***
Ginger_Hunter86: calls $0.10
bliznec828: folds 
Samosarr: checks 
*** FLOP *** [6d 2d 7s]
Samosarr: checks 
Ginger_Hunter86: bets $0.24
Samosarr: folds 
Uncalled bet ($0.24) returned to Ginger_Hunter86
Ginger_Hunter86 collected $0.24 from pot
Ginger_Hunter86: doesn't show hand 
*** SUMMARY ***
Total pot $0.25 | Rake $0.01 
Board [6d 2d 7s]
Seat 1: bliznec828 (small blind) folded before Flop
Seat 3: Samosarr (big blind) folded on the Flop
Seat 6: Ginger_Hunter86 (button) collected ($0.24)



PokerStars Hand #222945864147:  Hold'em No Limit ($0.05/$0.10 USD) - 2021/01/23 1:16:24 ET
Table 'Linzia' 6-max Seat #1 is the button
Seat 1: bliznec828 ($10 in chips) 
Seat 3: Samosarr ($25.74 in chips) 
Seat 4: X-rayFeeling ($10 in chips) 
Seat 6: Ginger_Hunter86 ($22.67 in chips) 
Samosarr: posts small blind $0.05
X-rayFeeling: posts big blind $0.10
*** HOLE CARDS ***
Ginger_Hunter86: raises $0.20 to $0.30
bliznec828: raises $0.90 to $1.20
Samosarr: folds 
X-rayFeeling: folds 
Ginger_Hunter86: calls $0.90
*** FLOP *** [3d Td 6c]
Ginger_Hunter86: checks 
bliznec828: bets $1.63
Ginger_Hunter86: folds 
Uncalled bet ($1.63) returned to bliznec828
bliznec828 collected $2.44 from pot
bliznec828: doesn't show hand 
*** SUMMARY ***
Total pot $2.55 | Rake $0.11 
Board [3d Td 6c]
Seat 1: bliznec828 (button) collected ($2.44)
Seat 3: Samosarr (small blind) folded before Flop
Seat 4: X-rayFeeling (big blind) folded before Flop
Seat 6: Ginger_Hunter86 folded on the Flop



PokerStars Hand #222945870471:  Hold'em No Limit ($0.05/$0.10 USD) - 2021/01/23 1:16:50 ET
Table 'Linzia' 6-max Seat #3 is the button
Seat 1: bliznec828 ($11.24 in chips) 
Seat 3: Samosarr ($25.69 in chips) 
Seat 4: X-rayFeeling ($10 in chips) 
Seat 6: Ginger_Hunter86 ($21.47 in chips) 
X-rayFeeling: posts small blind $0.05
Ginger_Hunter86: posts big blind $0.10
*** HOLE CARDS ***
bliznec828: folds 
Samosarr: folds 
X-rayFeeling: raises $0.20 to $0.30
Ginger_Hunter86: folds 
Uncalled bet ($0.20) returned to X-rayFeeling
X-rayFeeling collected $0.20 from pot
X-rayFeeling: doesn't show hand 
*** SUMMARY ***
Total pot $0.20 | Rake $0 
Seat 1: bliznec828 folded before Flop (didn't bet)
Seat 3: Samosarr (button) folded before Flop (didn't bet)
Seat 4: X-rayFeeling (small blind) collected ($0.20)
Seat 6: Ginger_Hunter86 (big blind) folded before Flop



PokerStars Hand #222945881033:  Hold'em No Limit ($0.05/$0.10 USD) - 2021/01/23 1:17:00 ET
Table 'Linzia' 6-max Seat #4 is the button
Seat 1: bliznec828 ($11.24 in chips) 
Seat 3: Samosarr ($25.69 in chips) 
Seat 4: X-rayFeeling ($10.10 in chips) 
Seat 6: Ginger_Hunter86 ($21.37 in chips) 
Ginger_Hunter86: posts small blind $0.05
bliznec828: posts big blind $0.10
*** HOLE CARDS ***
Samosarr: folds 
X-rayFeeling: folds 
Ginger_Hunter86: folds 
Uncalled bet ($0.05) returned to bliznec828
bliznec828 collected $0.10 from pot
bliznec828: doesn't show hand 
*** SUMMARY ***
Total pot $0.10 | Rake $0 
Seat 1: bliznec828 (big blind) collected ($0.10)
Seat 3: Samosarr folded before Flop (didn't bet)
Seat 4: X-rayFeeling (button) folded before Flop (didn't bet)
Seat 6: Ginger_Hunter86 (small blind) folded before Flop



PokerStars Hand #222945883162:  Hold'em No Limit ($0.05/$0.10 USD) - 2021/01/23 1:17:08 ET
Table 'Linzia' 6-max Seat #6 is the button
Seat 1: bliznec828 ($11.29 in chips) 
Seat 3: Samosarr ($25.69 in chips) 
Seat 4: X-rayFeeling ($10.10 in chips) 
Seat 6: Ginger_Hunter86 ($21.32 in chips) 
bliznec828: posts small blind $0.05
Samosarr: posts big blind $0.10
*** HOLE CARDS ***
X-rayFeeling: raises $0.20 to $0.30
Ginger_Hunter86: folds 
bliznec828: raises $1 to $1.30
Samosarr: folds 
X-rayFeeling: folds 
Uncalled bet ($1) returned to bliznec828
kubancheg joins the table at seat #5 
bliznec828 collected $0.70 from pot
plisianin was removed from the table for failing to post
plisianin leaves the table
bliznec828: doesn't show hand 
*** SUMMARY ***
Total pot $0.70 | Rake $0 
Seat 1: bliznec828 (small blind) collected ($0.70)
Seat 3: Samosarr (big blind) folded before Flop
Seat 4: X-rayFeeling folded before Flop
Seat 6: Ginger_Hunter86 (button) folded before Flop (didn't bet)



PokerStars Hand #222945886971:  Hold'em No Limit ($0.05/$0.10 USD) - 2021/01/23 1:17:24 ET
Table 'Linzia' 6-max Seat #1 is the button
Seat 1: bliznec828 ($11.69 in chips) 
Seat 4: X-rayFeeling ($10 in chips) 
Seat 5: kubancheg ($9.90 in chips) 
Seat 6: Ginger_Hunter86 ($21.32 in chips) 
X-rayFeeling: posts small blind $0.05
kubancheg: posts big blind $0.10
*** HOLE CARDS ***
Ginger_Hunter86: folds 
bliznec828: raises $0.15 to $0.25
X-rayFeeling: folds 
kubancheg: folds 
Uncalled bet ($0.15) returned to bliznec828
bliznec828 collected $0.25 from pot
bliznec828: doesn't show hand 
*** SUMMARY ***
Total pot $0.25 | Rake $0 
Seat 1: bliznec828 (button) collected ($0.25)
Seat 4: X-rayFeeling (small blind) folded before Flop
Seat 5: kubancheg (big blind) folded before Flop
Seat 6: Ginger_Hunter86 folded before Flop (didn't bet)



PokerStars Hand #222945889212:  Hold'em No Limit ($0.05/$0.10 USD) - 2021/01/23 1:17:33 ET
Table 'Linzia' 6-max Seat #4 is the button
Seat 1: bliznec828 ($11.84 in chips) 
Seat 4: X-rayFeeling ($10 in chips) 
Seat 5: kubancheg ($9.80 in chips) 
Seat 6: Ginger_Hunter86 ($21.32 in chips) 
kubancheg: posts small blind $0.05
Ginger_Hunter86: posts big blind $0.10
*** HOLE CARDS ***
bliznec828: folds 
X-rayFeeling: raises $0.15 to $0.25
kubancheg: folds 
Ginger_Hunter86: folds 
Uncalled bet ($0.15) returned to X-rayFeeling
X-rayFeeling collected $0.25 from pot
X-rayFeeling: doesn't show hand 
*** SUMMARY ***
Total pot $0.25 | Rake $0 
Seat 1: bliznec828 folded before Flop (didn't bet)
Seat 4: X-rayFeeling (button) collected ($0.25)
Seat 5: kubancheg (small blind) folded before Flop
Seat 6: Ginger_Hunter86 (big blind) folded before Flop



PokerStars Hand #222945893368:  Hold'em No Limit ($0.05/$0.10 USD) - 2021/01/23 1:17:50 ET
Table 'Linzia' 6-max Seat #5 is the button
Seat 1: bliznec828 ($11.84 in chips) 
Seat 4: X-rayFeeling ($10.15 in chips) 
Seat 5: kubancheg ($9.75 in chips) 
Seat 6: Ginger_Hunter86 ($21.22 in chips) 
Ginger_Hunter86: posts small blind $0.05
bliznec828: posts big blind $0.10
*** HOLE CARDS ***
X-rayFeeling: folds 
kubancheg: folds 
Ginger_Hunter86: raises $0.20 to $0.30
bliznec828: calls $0.20
*** FLOP *** [5d 7s 2d]
Ginger_Hunter86: bets $0.30
Samosarr leaves the table
bliznec828: raises $0.60 to $0.90
Ginger_Hunter86: folds 
Uncalled bet ($0.60) returned to bliznec828
bliznec828 collected $1.15 from pot
bliznec828: doesn't show hand 
*** SUMMARY ***
Total pot $1.20 | Rake $0.05 
Board [5d 7s 2d]
Seat 1: bliznec828 (big blind) collected ($1.15)
Seat 4: X-rayFeeling folded before Flop (didn't bet)
Seat 5: kubancheg (button) folded before Flop (didn't bet)
Seat 6: Ginger_Hunter86 (small blind) folded on the Flop



PokerStars Hand #222945903301:  Hold'em No Limit ($0.05/$0.10 USD) - 2021/01/23 1:18:30 ET
Table 'Linzia' 6-max Seat #6 is the button
Seat 1: bliznec828 ($12.39 in chips) 
Seat 4: X-rayFeeling ($10.15 in chips) 
Seat 5: kubancheg ($9.75 in chips) 
Seat 6: Ginger_Hunter86 ($20.62 in chips) 
bliznec828: posts small blind $0.05
X-rayFeeling: posts big blind $0.10
*** HOLE CARDS ***
kubancheg: raises $0.20 to $0.30
Ginger_Hunter86: calls $0.30
bliznec828: folds 
X-rayFeeling: folds 
*** FLOP *** [Td Ks Ac]
kubancheg: bets $0.36
Ginger_Hunter86: calls $0.36
*** TURN *** [Td Ks Ac] [7c]
kubancheg: bets $0.70
Ginger_Hunter86: calls $0.70
*** RIVER *** [Td Ks Ac 7c] [6s]
petrovichkag joins the table at seat #2 
petrovichkag leaves the table
kubancheg: bets $2.04
Ginger_Hunter86: folds 
Uncalled bet ($2.04) returned to kubancheg
kubancheg collected $2.74 from pot
kubancheg: doesn't show hand 
*** SUMMARY ***
Total pot $2.87 | Rake $0.13 
Board [Td Ks Ac 7c 6s]
Seat 1: bliznec828 (small blind) folded before Flop
Seat 4: X-rayFeeling (big blind) folded before Flop
Seat 5: kubancheg collected ($2.74)
Seat 6: Ginger_Hunter86 (button) folded on the River



PokerStars Hand #222945914200:  Hold'em No Limit ($0.05/$0.10 USD) - 2021/01/23 1:19:15 ET
Table 'Linzia' 6-max Seat #1 is the button
Seat 1: bliznec828 ($12.34 in chips) 
Seat 4: X-rayFeeling ($10.05 in chips) 
Seat 5: kubancheg ($11.13 in chips) 
Seat 6: Ginger_Hunter86 ($19.26 in chips) 
X-rayFeeling: posts small blind $0.05
kubancheg: posts big blind $0.10
*** HOLE CARDS ***
Ginger_Hunter86: raises $0.20 to $0.30
bliznec828: folds 
X-rayFeeling: folds 
kubancheg: folds 
Uncalled bet ($0.20) returned to Ginger_Hunter86
Ginger_Hunter86 collected $0.25 from pot
Ginger_Hunter86: doesn't show hand 
*** SUMMARY ***
Total pot $0.25 | Rake $0 
Seat 1: bliznec828 (button) folded before Flop (didn't bet)
Seat 4: X-rayFeeling (small blind) folded before Flop
Seat 5: kubancheg (big blind) folded before Flop
Seat 6: Ginger_Hunter86 collected ($0.25)



PokerStars Hand #222945916402:  Hold'em No Limit ($0.05/$0.10 USD) - 2021/01/23 1:19:24 ET
Table 'Linzia' 6-max Seat #4 is the button
Seat 1: bliznec828 ($12.34 in chips) 
Seat 4: X-rayFeeling ($10 in chips) 
Seat 5: kubancheg ($11.03 in chips) 
Seat 6: Ginger_Hunter86 ($19.41 in chips) 
kubancheg: posts small blind $0.05
Ginger_Hunter86: posts big blind $0.10
*** HOLE CARDS ***
bliznec828: folds 
X-rayFeeling: folds 
kubancheg: raises $0.10 to $0.20
Ginger_Hunter86: raises $0.30 to $0.50
kubancheg: folds 
Uncalled bet ($0.30) returned to Ginger_Hunter86
Ginger_Hunter86 collected $0.40 from pot
Ginger_Hunter86: doesn't show hand 
*** SUMMARY ***
Total pot $0.40 | Rake $0 
Seat 1: bliznec828 folded before Flop (didn't bet)
Seat 4: X-rayFeeling (button) folded before Flop (didn't bet)
Seat 5: kubancheg (small blind) folded before Flop
Seat 6: Ginger_Hunter86 (big blind) collected ($0.40)



PokerStars Hand #222945920853:  Hold'em No Limit ($0.05/$0.10 USD) - 2021/01/23 1:19:43 ET
Table 'Linzia' 6-max Seat #5 is the button
Seat 1: bliznec828 ($12.34 in chips) 
Seat 4: X-rayFeeling ($10 in chips) 
Seat 5: kubancheg ($10.83 in chips) 
Seat 6: Ginger_Hunter86 ($19.61 in chips) 
Ginger_Hunter86: posts small blind $0.05
bliznec828: posts big blind $0.10
*** HOLE CARDS ***
X-rayFeeling: folds 
kubancheg: raises $0.20 to $0.30
Ginger_Hunter86: folds 
boomware joins the table at seat #2 
LordBeardy1990 joins the table at seat #3 
bliznec828 has timed out
bliznec828: folds 
Uncalled bet ($0.20) returned to kubancheg
kubancheg collected $0.25 from pot
kubancheg: doesn't show hand 
*** SUMMARY ***
Total pot $0.25 | Rake $0 
Seat 1: bliznec828 (big blind) folded before Flop
Seat 4: X-rayFeeling folded before Flop (didn't bet)
Seat 5: kubancheg (button) collected ($0.25)
Seat 6: Ginger_Hunter86 (small blind) folded before Flop



PokerStars Hand #222945933914:  Hold'em No Limit ($0.05/$0.10 USD) - 2021/01/23 1:20:36 ET
Table 'Linzia' 6-max Seat #6 is the button
Seat 1: bliznec828 ($12.24 in chips) 
Seat 2: boomware ($10 in chips) 
Seat 3: LordBeardy1990 ($10 in chips) 
Seat 4: X-rayFeeling ($10 in chips) 
Seat 5: kubancheg ($10.98 in chips) 
Seat 6: Ginger_Hunter86 ($19.56 in chips) 
bliznec828: posts small blind $0.05
boomware: posts big blind $0.10
LordBeardy1990: posts big blind $0.10
*** HOLE CARDS ***
LordBeardy1990: checks 
X-rayFeeling: folds 
kubancheg: folds 
Ginger_Hunter86: calls $0.10
bliznec828: calls $0.05
boomware: checks 
*** FLOP *** [6c Ad 3h]
bliznec828: checks 
boomware: checks 
LordBeardy1990: bets $0.10
Ginger_Hunter86: folds 
bliznec828: folds 
boomware: folds 
Uncalled bet ($0.10) returned to LordBeardy1990
LordBeardy1990 collected $0.38 from pot
LordBeardy1990: doesn't show hand 
*** SUMMARY ***
Total pot $0.40 | Rake $0.02 
Board [6c Ad 3h]
Seat 1: bliznec828 (small blind) folded on the Flop
Seat 2: boomware (big blind) folded on the Flop
Seat 3: LordBeardy1990 collected ($0.38)
Seat 4: X-rayFeeling folded before Flop (didn't bet)
Seat 5: kubancheg folded before Flop (didn't bet)
Seat 6: Ginger_Hunter86 (button) folded on the Flop



PokerStars Hand #222945943976:  Hold'em No Limit ($0.05/$0.10 USD) - 2021/01/23 1:21:17 ET
Table 'Linzia' 6-max Seat #1 is the button
Seat 1: bliznec828 ($12.14 in chips) 
Seat 2: boomware ($9.90 in chips) 
Seat 3: LordBeardy1990 ($10.28 in chips) 
Seat 4: X-rayFeeling ($10 in chips) 
Seat 5: kubancheg ($10.98 in chips) 
Seat 6: Ginger_Hunter86 ($19.46 in chips) 
boomware: posts small blind $0.05
LordBeardy1990: posts big blind $0.10
*** HOLE CARDS ***
X-rayFeeling: folds 
kubancheg: folds 
Ginger_Hunter86: folds 
bliznec828: raises $0.15 to $0.25
boomware: folds 
LordBeardy1990: calls $0.15
*** FLOP *** [6c 5h Jh]
LordBeardy1990: bets $0.10
bliznec828: calls $0.10
*** TURN *** [6c 5h Jh] [2h]
LordBeardy1990: bets $0.10
bliznec828: calls $0.10
*** RIVER *** [6c 5h Jh 2h] [Ac]
LordBeardy1990: bets $0.10
bliznec828: raises $1.30 to $1.40
LordBeardy1990: folds 
Uncalled bet ($1.30) returned to bliznec828
bliznec828 collected $1.10 from pot
bliznec828: doesn't show hand 
*** SUMMARY ***
Total pot $1.15 | Rake $0.05 
Board [6c 5h Jh 2h Ac]
Seat 1: bliznec828 (button) collected ($1.10)
Seat 2: boomware (small blind) folded before Flop
Seat 3: LordBeardy1990 (big blind) folded on the River
Seat 4: X-rayFeeling folded before Flop (didn't bet)
Seat 5: kubancheg folded before Flop (didn't bet)
Seat 6: Ginger_Hunter86 folded before Flop (didn't bet)



PokerStars Hand #222945958795:  Hold'em No Limit ($0.05/$0.10 USD) - 2021/01/23 1:22:18 ET
Table 'Linzia' 6-max Seat #2 is the button
Seat 1: bliznec828 ($12.69 in chips) 
Seat 2: boomware ($9.85 in chips) 
Seat 3: LordBeardy1990 ($9.73 in chips) 
Seat 4: X-rayFeeling ($10 in chips) 
Seat 5: kubancheg ($10.98 in chips) 
Seat 6: Ginger_Hunter86 ($19.46 in chips) 
LordBeardy1990: posts small blind $0.05
X-rayFeeling: posts big blind $0.10
*** HOLE CARDS ***
kubancheg: raises $0.20 to $0.30
Ginger_Hunter86: calls $0.30
bliznec828: raises $1.10 to $1.40
boomware: folds 
LordBeardy1990: folds 
X-rayFeeling: folds 
kubancheg: folds 
Ginger_Hunter86: calls $1.10
*** FLOP *** [3d Jc 5d]
Ginger_Hunter86: bets $1.55
bliznec828: calls $1.55
*** TURN *** [3d Jc 5d] [7d]
Ginger_Hunter86: checks 
bliznec828: bets $3.03
Ginger_Hunter86: raises $13.48 to $16.51 and is all-in
bliznec828: calls $6.71 and is all-in
Uncalled bet ($6.77) returned to Ginger_Hunter86
*** RIVER *** [3d Jc 5d 7d] [6h]
*** SHOW DOWN ***
Ginger_Hunter86: shows [Qd Jd] (a flush, Queen high)
bliznec828: shows [Ah Ad] (a pair of Aces)
Ginger_Hunter86 collected $24.67 from pot
*** SUMMARY ***
Total pot $25.83 | Rake $1.16 
Board [3d Jc 5d 7d 6h]
Seat 1: bliznec828 showed [Ah Ad] and lost with a pair of Aces
Seat 2: boomware (button) folded before Flop (didn't bet)
Seat 3: LordBeardy1990 (small blind) folded before Flop
Seat 4: X-rayFeeling (big blind) folded before Flop
Seat 5: kubancheg folded before Flop
Seat 6: Ginger_Hunter86 showed [Qd Jd] and won ($24.67) with a flush, Queen high



PokerStars Hand #222945976363:  Hold'em No Limit ($0.05/$0.10 USD) - 2021/01/23 1:23:31 ET
Table 'Linzia' 6-max Seat #3 is the button
Seat 1: bliznec828 ($10 in chips) 
Seat 2: boomware ($9.85 in chips) 
Seat 3: LordBeardy1990 ($9.68 in chips) 
Seat 4: X-rayFeeling ($10 in chips) 
Seat 5: kubancheg ($10.68 in chips) 
Seat 6: Ginger_Hunter86 ($31.44 in chips) 
X-rayFeeling: posts small blind $0.05
kubancheg: posts big blind $0.10
*** HOLE CARDS ***
Ginger_Hunter86: raises $0.20 to $0.30
bliznec828: raises $0.80 to $1.10
boomware: folds 
LordBeardy1990: calls $1.10
X-rayFeeling: folds 
kubancheg: folds 
Ginger_Hunter86: folds 
*** FLOP *** [Kh 5c Td]
bliznec828: bets $1.27
LordBeardy1990: raises $1.27 to $2.54
bliznec828: folds 
Uncalled bet ($1.27) returned to LordBeardy1990
LordBeardy1990 collected $4.96 from pot
LordBeardy1990: doesn't show hand 
*** SUMMARY ***
Total pot $5.19 | Rake $0.23 
Board [Kh 5c Td]
Seat 1: bliznec828 folded on the Flop
Seat 2: boomware folded before Flop (didn't bet)
Seat 3: LordBeardy1990 (button) collected ($4.96)
Seat 4: X-rayFeeling (small blind) folded before Flop
Seat 5: kubancheg (big blind) folded before Flop
Seat 6: Ginger_Hunter86 folded before Flop



PokerStars Hand #222945983637:  Hold'em No Limit ($0.05/$0.10 USD) - 2021/01/23 1:24:01 ET
Table 'Linzia' 6-max Seat #4 is the button
Seat 1: bliznec828 ($10 in chips) 
Seat 2: boomware ($9.85 in chips) 
Seat 3: LordBeardy1990 ($12.27 in chips) 
Seat 4: X-rayFeeling ($10 in chips) 
Seat 5: kubancheg ($10.58 in chips) 
Seat 6: Ginger_Hunter86 ($31.14 in chips) 
kubancheg: posts small blind $0.05
Ginger_Hunter86: posts big blind $0.10
*** HOLE CARDS ***
bliznec828: folds 
boomware: folds 
LordBeardy1990: raises $0.10 to $0.20
X-rayFeeling: folds 
kubancheg: calls $0.15
Ginger_Hunter86: calls $0.10
*** FLOP *** [6s 6h 7d]
kubancheg: bets $0.28
Ginger_Hunter86: calls $0.28
LordBeardy1990: folds 
*** TURN *** [6s 6h 7d] [5c]
kubancheg: bets $0.55
Ginger_Hunter86: calls $0.55
*** RIVER *** [6s 6h 7d 5c] [9s]
kubancheg: bets $2.16
Ginger_Hunter86: calls $2.16
*** SHOW DOWN ***
kubancheg: shows [8s 7h] (a straight, Five to Nine)
Ginger_Hunter86: shows [9h 8c] (a straight, Five to Nine)
kubancheg collected $3.14 from pot
Ginger_Hunter86 collected $3.14 from pot
*** SUMMARY ***
Total pot $6.58 | Rake $0.30 
Board [6s 6h 7d 5c 9s]
Seat 1: bliznec828 folded before Flop (didn't bet)
Seat 2: boomware folded before Flop (didn't bet)
Seat 3: LordBeardy1990 folded on the Flop
Seat 4: X-rayFeeling (button) folded before Flop (didn't bet)
Seat 5: kubancheg (small blind) showed [8s 7h] and won ($3.14) with a straight, Five to Nine
Seat 6: Ginger_Hunter86 (big blind) showed [9h 8c] and won ($3.14) with a straight, Five to Nine



PokerStars Hand #222945994889:  Hold'em No Limit ($0.05/$0.10 USD) - 2021/01/23 1:24:47 ET
Table 'Linzia' 6-max Seat #5 is the button
Seat 1: bliznec828 ($10 in chips) 
Seat 2: boomware ($9.85 in chips) 
Seat 3: LordBeardy1990 ($12.07 in chips) 
Seat 4: X-rayFeeling ($10 in chips) 
Seat 5: kubancheg ($10.53 in chips) 
Seat 6: Ginger_Hunter86 ($31.09 in chips) 
Ginger_Hunter86: posts small blind $0.05
bliznec828: posts big blind $0.10
*** HOLE CARDS ***
boomware: folds 
LordBeardy1990: calls $0.10
X-rayFeeling: folds 
kubancheg: folds 
Ginger_Hunter86: calls $0.05
bliznec828: checks 
*** FLOP *** [4s 2d 9s]
Ginger_Hunter86: bets $0.20
bliznec828: calls $0.20
LordBeardy1990: calls $0.20
*** TURN *** [4s 2d 9s] [Ac]
Ginger_Hunter86: checks 
bliznec828: checks 
LordBeardy1990: bets $0.50
Ginger_Hunter86: calls $0.50
bliznec828: calls $0.50
*** RIVER *** [4s 2d 9s Ac] [4h]
Ginger_Hunter86: bets $2.29
bliznec828: folds 
LordBeardy1990: folds 
Uncalled bet ($2.29) returned to Ginger_Hunter86
Ginger_Hunter86 collected $2.29 from pot
Ginger_Hunter86: doesn't show hand 
*** SUMMARY ***
Total pot $2.40 | Rake $0.11 
Board [4s 2d 9s Ac 4h]
Seat 1: bliznec828 (big blind) folded on the River
Seat 2: boomware folded before Flop (didn't bet)
Seat 3: LordBeardy1990 folded on the River
Seat 4: X-rayFeeling folded before Flop (didn't bet)
Seat 5: kubancheg (button) folded before Flop (didn't bet)
Seat 6: Ginger_Hunter86 (small blind) collected ($2.29)



PokerStars Hand #222946021158:  Hold'em No Limit ($0.05/$0.10 USD) - 2021/01/23 1:26:36 ET
Table 'Linzia' 6-max Seat #6 is the button
Seat 1: bliznec828 ($10 in chips) 
Seat 2: boomware ($9.85 in chips) 
Seat 3: LordBeardy1990 ($11.27 in chips) 
Seat 4: X-rayFeeling ($10 in chips) 
Seat 5: kubancheg ($10.53 in chips) 
Seat 6: Ginger_Hunter86 ($32.58 in chips) 
bliznec828: posts small blind $0.05
boomware: posts big blind $0.10
*** HOLE CARDS ***
LordBeardy1990: calls $0.10
X-rayFeeling: folds 
kubancheg: folds 
Ginger_Hunter86: folds 
bliznec828: calls $0.05
boomware: raises $0.40 to $0.50
LordBeardy1990: calls $0.40
bliznec828: folds 
*** FLOP *** [5c Qh Jd]
boomware: bets $0.58
LordBeardy1990: folds 
Uncalled bet ($0.58) returned to boomware
boomware collected $1.05 from pot
boomware: doesn't show hand 
*** SUMMARY ***
Total pot $1.10 | Rake $0.05 
Board [5c Qh Jd]
Seat 1: bliznec828 (small blind) folded before Flop
Seat 2: boomware (big blind) collected ($1.05)
Seat 3: LordBeardy1990 folded on the Flop
Seat 4: X-rayFeeling folded before Flop (didn't bet)
Seat 5: kubancheg folded before Flop (didn't bet)
Seat 6: Ginger_Hunter86 (button) folded before Flop (didn't bet)



PokerStars Hand #222946029820:  Hold'em No Limit ($0.05/$0.10 USD) - 2021/01/23 1:27:12 ET
Table 'Linzia' 6-max Seat #1 is the button
Seat 1: bliznec828 ($10 in chips) 
Seat 2: boomware ($10.40 in chips) 
Seat 3: LordBeardy1990 ($10.77 in chips) 
Seat 4: X-rayFeeling ($10 in chips) 
Seat 5: kubancheg ($10.53 in chips) 
Seat 6: Ginger_Hunter86 ($32.58 in chips) 
boomware: posts small blind $0.05
LordBeardy1990: posts big blind $0.10
*** HOLE CARDS ***
X-rayFeeling: folds 
kubancheg: folds 
Ginger_Hunter86: calls $0.10
bliznec828: raises $0.25 to $0.35
boomware: folds 
LordBeardy1990: folds 
Ginger_Hunter86: calls $0.25
*** FLOP *** [2c 5s 2h]
Ginger_Hunter86: checks 
bliznec828: bets $0.27
Ginger_Hunter86: folds 
Uncalled bet ($0.27) returned to bliznec828
bliznec828 collected $0.81 from pot
bliznec828: doesn't show hand 
*** SUMMARY ***
Total pot $0.85 | Rake $0.04 
Board [2c 5s 2h]
Seat 1: bliznec828 (button) collected ($0.81)
Seat 2: boomware (small blind) folded before Flop
Seat 3: LordBeardy1990 (big blind) folded before Flop
Seat 4: X-rayFeeling folded before Flop (didn't bet)
Seat 5: kubancheg folded before Flop (didn't bet)
Seat 6: Ginger_Hunter86 folded on the Flop



PokerStars Hand #222946037156:  Hold'em No Limit ($0.05/$0.10 USD) - 2021/01/23 1:27:43 ET
Table 'Linzia' 6-max Seat #2 is the button
Seat 1: bliznec828 ($10.46 in chips) 
Seat 2: boomware ($10.35 in chips) 
Seat 3: LordBeardy1990 ($10.67 in chips) 
Seat 4: X-rayFeeling ($10 in chips) 
Seat 5: kubancheg ($10.53 in chips) 
Seat 6: Ginger_Hunter86 ($32.23 in chips) 
LordBeardy1990: posts small blind $0.05
X-rayFeeling: posts big blind $0.10
*** HOLE CARDS ***
kubancheg: folds 
Ginger_Hunter86: calls $0.10
bliznec828: raises $0.25 to $0.35
boomware: folds 
LordBeardy1990: folds 
X-rayFeeling: folds 
Ginger_Hunter86: calls $0.25
*** FLOP *** [4d 3d 6d]
Ginger_Hunter86: bets $0.40
bliznec828: calls $0.40
*** TURN *** [4d 3d 6d] [9c]
Ginger_Hunter86: checks 
bliznec828: bets $0.79
Ginger_Hunter86: calls $0.79
*** RIVER *** [4d 3d 6d 9c] [5h]
Ginger_Hunter86: checks 
bliznec828: bets $2.05
Ginger_Hunter86: calls $2.05
*** SHOW DOWN ***
bliznec828: shows [7d 7s] (a straight, Three to Seven)
Ginger_Hunter86: mucks hand 
bliznec828 collected $7 from pot
*** SUMMARY ***
Total pot $7.33 | Rake $0.33 
Board [4d 3d 6d 9c 5h]
Seat 1: bliznec828 showed [7d 7s] and won ($7) with a straight, Three to Seven
Seat 2: boomware (button) folded before Flop (didn't bet)
Seat 3: LordBeardy1990 (small blind) folded before Flop
Seat 4: X-rayFeeling (big blind) folded before Flop
Seat 5: kubancheg folded before Flop (didn't bet)
Seat 6: Ginger_Hunter86 mucked



PokerStars Hand #222946051026:  Hold'em No Limit ($0.05/$0.10 USD) - 2021/01/23 1:28:41 ET
Table 'Linzia' 6-max Seat #3 is the button
Seat 1: bliznec828 ($13.87 in chips) 
Seat 2: boomware ($10.35 in chips) 
Seat 3: LordBeardy1990 ($10.62 in chips) 
Seat 4: X-rayFeeling ($10 in chips) 
Seat 5: kubancheg ($10.53 in chips) 
Seat 6: Ginger_Hunter86 ($28.64 in chips) 
X-rayFeeling: posts small blind $0.05
kubancheg: posts big blind $0.10
*** HOLE CARDS ***
Ginger_Hunter86: raises $0.30 to $0.40
bliznec828: folds 
boomware: raises $0.95 to $1.35
LordBeardy1990: folds 
X-rayFeeling: folds 
kubancheg: folds 
Ginger_Hunter86: calls $0.95
*** FLOP *** [9h 9s 6s]
Ginger_Hunter86: bets $1.36
boomware: raises $7.64 to $9 and is all-in
Ginger_Hunter86: folds 
Uncalled bet ($7.64) returned to boomware
boomware collected $5.32 from pot
boomware: doesn't show hand 
*** SUMMARY ***
Total pot $5.57 | Rake $0.25 
Board [9h 9s 6s]
Seat 1: bliznec828 folded before Flop (didn't bet)
Seat 2: boomware collected ($5.32)
Seat 3: LordBeardy1990 (button) folded before Flop (didn't bet)
Seat 4: X-rayFeeling (small blind) folded before Flop
Seat 5: kubancheg (big blind) folded before Flop
Seat 6: Ginger_Hunter86 folded on the Flop



PokerStars Hand #222946061688:  Hold'em No Limit ($0.05/$0.10 USD) - 2021/01/23 1:29:24 ET
Table 'Linzia' 6-max Seat #4 is the button
Seat 1: bliznec828 ($13.87 in chips) 
Seat 2: boomware ($12.96 in chips) 
Seat 3: LordBeardy1990 ($10.62 in chips) 
Seat 4: X-rayFeeling ($10 in chips) 
Seat 5: kubancheg ($10.43 in chips) 
Seat 6: Ginger_Hunter86 ($25.93 in chips) 
kubancheg: posts small blind $0.05
Ginger_Hunter86: posts big blind $0.10
*** HOLE CARDS ***
bliznec828: raises $0.20 to $0.30
boomware: folds 
LordBeardy1990: folds 
X-rayFeeling: folds 
kubancheg: folds 
Ginger_Hunter86: calls $0.20
*** FLOP *** [2c Td 2s]
Ginger_Hunter86: bets $0.30
bliznec828: calls $0.30
*** TURN *** [2c Td 2s] [Qd]
Ginger_Hunter86: bets $0.50
bliznec828: folds 
Uncalled bet ($0.50) returned to Ginger_Hunter86
Ginger_Hunter86 collected $1.19 from pot
Ginger_Hunter86: doesn't show hand 
*** SUMMARY ***
Total pot $1.25 | Rake $0.06 
Board [2c Td 2s Qd]
Seat 1: bliznec828 folded on the Turn
Seat 2: boomware folded before Flop (didn't bet)
Seat 3: LordBeardy1990 folded before Flop (didn't bet)
Seat 4: X-rayFeeling (button) folded before Flop (didn't bet)
Seat 5: kubancheg (small blind) folded before Flop
Seat 6: Ginger_Hunter86 (big blind) collected ($1.19)



PokerStars Hand #222946075233:  Hold'em No Limit ($0.05/$0.10 USD) - 2021/01/23 1:30:19 ET
Table 'Linzia' 6-max Seat #5 is the button
Seat 1: bliznec828 ($13.27 in chips) 
Seat 2: boomware ($12.96 in chips) 
Seat 3: LordBeardy1990 ($10.62 in chips) 
Seat 4: X-rayFeeling ($10 in chips) 
Seat 5: kubancheg ($10.38 in chips) 
Seat 6: Ginger_Hunter86 ($26.52 in chips) 
Ginger_Hunter86: posts small blind $0.05
bliznec828: posts big blind $0.10
*** HOLE CARDS ***
boomware: folds 
LordBeardy1990: calls $0.10
X-rayFeeling: folds 
kubancheg: folds 
Ginger_Hunter86: folds 
bliznec828: checks 
*** FLOP *** [5c Qc Qh]
bliznec828: checks 
LordBeardy1990: bets $0.20
bliznec828: folds 
Uncalled bet ($0.20) returned to LordBeardy1990
LordBeardy1990 collected $0.24 from pot
LordBeardy1990: doesn't show hand 
*** SUMMARY ***
Total pot $0.25 | Rake $0.01 
Board [5c Qc Qh]
Seat 1: bliznec828 (big blind) folded on the Flop
Seat 2: boomware folded before Flop (didn't bet)
Seat 3: LordBeardy1990 collected ($0.24)
Seat 4: X-rayFeeling folded before Flop (didn't bet)
Seat 5: kubancheg (button) folded before Flop (didn't bet)
Seat 6: Ginger_Hunter86 (small blind) folded before Flop



PokerStars Hand #222946082810:  Hold'em No Limit ($0.05/$0.10 USD) - 2021/01/23 1:30:51 ET
Table 'Linzia' 6-max Seat #6 is the button
Seat 1: bliznec828 ($13.17 in chips) 
Seat 2: boomware ($12.96 in chips) 
Seat 3: LordBeardy1990 ($10.76 in chips) 
Seat 4: X-rayFeeling ($10 in chips) 
Seat 5: kubancheg ($10.38 in chips) 
Seat 6: Ginger_Hunter86 ($26.47 in chips) 
bliznec828: posts small blind $0.05
boomware: posts big blind $0.10
*** HOLE CARDS ***
LordBeardy1990: calls $0.10
X-rayFeeling: folds 
kubancheg: folds 
Ginger_Hunter86: raises $0.50 to $0.60
bliznec828: folds 
boomware: folds 
LordBeardy1990: calls $0.50
*** FLOP *** [2c 7d 8h]
LordBeardy1990: bets $0.30
Ginger_Hunter86: raises $0.70 to $1
LordBeardy1990: calls $0.70
*** TURN *** [2c 7d 8h] [9h]
LordBeardy1990: bets $0.10
Ginger_Hunter86: raises $1.70 to $1.80
LordBeardy1990: calls $1.70
*** RIVER *** [2c 7d 8h 9h] [5d]
LordBeardy1990: bets $0.10
Ginger_Hunter86: calls $0.10
*** SHOW DOWN ***
LordBeardy1990: shows [7h 4h] (a pair of Sevens)
Ginger_Hunter86: mucks hand 
LordBeardy1990 collected $6.83 from pot
*** SUMMARY ***
Total pot $7.15 | Rake $0.32 
Board [2c 7d 8h 9h 5d]
Seat 1: bliznec828 (small blind) folded before Flop
Seat 2: boomware (big blind) folded before Flop
Seat 3: LordBeardy1990 showed [7h 4h] and won ($6.83) with a pair of Sevens
Seat 4: X-rayFeeling folded before Flop (didn't bet)
Seat 5: kubancheg folded before Flop (didn't bet)
Seat 6: Ginger_Hunter86 (button) mucked



PokerStars Hand #222946099063:  Hold'em No Limit ($0.05/$0.10 USD) - 2021/01/23 1:31:57 ET
Table 'Linzia' 6-max Seat #1 is the button
Seat 1: bliznec828 ($13.12 in chips) 
Seat 2: boomware ($12.86 in chips) 
Seat 3: LordBeardy1990 ($14.09 in chips) 
Seat 4: X-rayFeeling ($10 in chips) 
Seat 5: kubancheg ($10.38 in chips) 
Seat 6: Ginger_Hunter86 ($22.97 in chips) 
boomware: posts small blind $0.05
LordBeardy1990: posts big blind $0.10
*** HOLE CARDS ***
X-rayFeeling: raises $0.20 to $0.30
kubancheg: folds 
Ginger_Hunter86: calls $0.30
bliznec828: folds 
boomware: folds 
LordBeardy1990: calls $0.20
*** FLOP *** [Jc 5d 2s]
LordBeardy1990: checks 
X-rayFeeling: bets $0.55
Ginger_Hunter86: folds 
LordBeardy1990: folds 
Uncalled bet ($0.55) returned to X-rayFeeling
X-rayFeeling collected $0.91 from pot
X-rayFeeling: doesn't show hand 
*** SUMMARY ***
Total pot $0.95 | Rake $0.04 
Board [Jc 5d 2s]
Seat 1: bliznec828 (button) folded before Flop (didn't bet)
Seat 2: boomware (small blind) folded before Flop
Seat 3: LordBeardy1990 (big blind) folded on the Flop
Seat 4: X-rayFeeling collected ($0.91)
Seat 5: kubancheg folded before Flop (didn't bet)
Seat 6: Ginger_Hunter86 folded on the Flop



PokerStars Hand #222946107574:  Hold'em No Limit ($0.05/$0.10 USD) - 2021/01/23 1:32:32 ET
Table 'Linzia' 6-max Seat #2 is the button
Seat 1: bliznec828 ($13.12 in chips) 
Seat 2: boomware ($12.81 in chips) 
Seat 3: LordBeardy1990 ($13.79 in chips) 
Seat 4: X-rayFeeling ($10.61 in chips) 
Seat 5: kubancheg ($10.38 in chips) 
Seat 6: Ginger_Hunter86 ($22.67 in chips) 
LordBeardy1990: posts small blind $0.05
X-rayFeeling: posts big blind $0.10
*** HOLE CARDS ***
kubancheg: raises $0.20 to $0.30
Ginger_Hunter86: folds 
bliznec828: folds 
boomware: folds 
LordBeardy1990: folds 
X-rayFeeling: calls $0.20
*** FLOP *** [9h Qh Ad]
X-rayFeeling: checks 
kubancheg: bets $0.41
X-rayFeeling: folds 
Uncalled bet ($0.41) returned to kubancheg
kubancheg collected $0.62 from pot
kubancheg: doesn't show hand 
*** SUMMARY ***
Total pot $0.65 | Rake $0.03 
Board [9h Qh Ad]
Seat 1: bliznec828 folded before Flop (didn't bet)
Seat 2: boomware (button) folded before Flop (didn't bet)
Seat 3: LordBeardy1990 (small blind) folded before Flop
Seat 4: X-rayFeeling (big blind) folded on the Flop
Seat 5: kubancheg collected ($0.62)
Seat 6: Ginger_Hunter86 folded before Flop (didn't bet)



PokerStars Hand #222946113930:  Hold'em No Limit ($0.05/$0.10 USD) - 2021/01/23 1:32:59 ET
Table 'Linzia' 6-max Seat #3 is the button
Seat 1: bliznec828 ($13.12 in chips) 
Seat 2: boomware ($12.81 in chips) 
Seat 3: LordBeardy1990 ($13.74 in chips) 
Seat 4: X-rayFeeling ($10.31 in chips) 
Seat 5: kubancheg ($10.70 in chips) 
Seat 6: Ginger_Hunter86 ($22.67 in chips) 
X-rayFeeling: posts small blind $0.05
kubancheg: posts big blind $0.10
*** HOLE CARDS ***
Ginger_Hunter86: folds 
bliznec828: raises $0.20 to $0.30
boomware: folds 
LordBeardy1990: calls $0.30
X-rayFeeling: calls $0.25
kubancheg: folds 
*** FLOP *** [8s Tc 2s]
X-rayFeeling: checks 
bliznec828: checks 
LordBeardy1990: bets $0.10
X-rayFeeling: folds 
bliznec828: folds 
Uncalled bet ($0.10) returned to LordBeardy1990
LordBeardy1990 collected $0.96 from pot
LordBeardy1990: doesn't show hand 
*** SUMMARY ***
Total pot $1 | Rake $0.04 
Board [8s Tc 2s]
Seat 1: bliznec828 folded on the Flop
Seat 2: boomware folded before Flop (didn't bet)
Seat 3: LordBeardy1990 (button) collected ($0.96)
Seat 4: X-rayFeeling (small blind) folded on the Flop
Seat 5: kubancheg (big blind) folded before Flop
Seat 6: Ginger_Hunter86 folded before Flop (didn't bet)



PokerStars Hand #222946122815:  Hold'em No Limit ($0.05/$0.10 USD) - 2021/01/23 1:33:35 ET
Table 'Linzia' 6-max Seat #4 is the button
Seat 1: bliznec828 ($12.82 in chips) 
Seat 2: boomware ($12.81 in chips) 
Seat 3: LordBeardy1990 ($14.40 in chips) 
Seat 4: X-rayFeeling ($10.01 in chips) 
Seat 5: kubancheg ($10.60 in chips) 
Seat 6: Ginger_Hunter86 ($22.67 in chips) 
kubancheg: posts small blind $0.05
Ginger_Hunter86: posts big blind $0.10
*** HOLE CARDS ***
bliznec828: folds 
boomware: folds 
LordBeardy1990: calls $0.10
X-rayFeeling: folds 
kubancheg: folds 
Ginger_Hunter86: checks 
*** FLOP *** [Kd 5h Jc]
Ginger_Hunter86: checks 
LordBeardy1990: bets $0.10
Ginger_Hunter86: raises $0.30 to $0.40
LordBeardy1990: calls $0.30
*** TURN *** [Kd 5h Jc] [6h]
Ginger_Hunter86: checks 
LordBeardy1990: checks 
*** RIVER *** [Kd 5h Jc 6h] [9d]
Ginger_Hunter86: bets $0.50
LordBeardy1990: folds 
Uncalled bet ($0.50) returned to Ginger_Hunter86
Ginger_Hunter86 collected $1 from pot
Ginger_Hunter86: doesn't show hand 
*** SUMMARY ***
Total pot $1.05 | Rake $0.05 
Board [Kd 5h Jc 6h 9d]
Seat 1: bliznec828 folded before Flop (didn't bet)
Seat 2: boomware folded before Flop (didn't bet)
Seat 3: LordBeardy1990 folded on the River
Seat 4: X-rayFeeling (button) folded before Flop (didn't bet)
Seat 5: kubancheg (small blind) folded before Flop
Seat 6: Ginger_Hunter86 (big blind) collected ($1)



PokerStars Hand #222946132638:  Hold'em No Limit ($0.05/$0.10 USD) - 2021/01/23 1:34:16 ET
Table 'Linzia' 6-max Seat #5 is the button
Seat 1: bliznec828 ($12.82 in chips) 
Seat 2: boomware ($12.81 in chips) 
Seat 3: LordBeardy1990 ($13.90 in chips) 
Seat 4: X-rayFeeling ($10.01 in chips) 
Seat 5: kubancheg ($10.55 in chips) 
Seat 6: Ginger_Hunter86 ($23.17 in chips) 
Ginger_Hunter86: posts small blind $0.05
bliznec828: posts big blind $0.10
*** HOLE CARDS ***
boomware: folds 
LordBeardy1990: calls $0.10
X-rayFeeling: folds 
kubancheg: folds 
Ginger_Hunter86: calls $0.05
bliznec828: checks 
*** FLOP *** [3h 4d 2d]
Ginger_Hunter86: checks 
bliznec828: checks 
LordBeardy1990: bets $0.10
Ginger_Hunter86: calls $0.10
bliznec828: calls $0.10
*** TURN *** [3h 4d 2d] [6s]
Ginger_Hunter86: checks 
bliznec828: checks 
LordBeardy1990: bets $0.30
Ginger_Hunter86: folds 
bliznec828: folds 
Uncalled bet ($0.30) returned to LordBeardy1990
LordBeardy1990 collected $0.57 from pot
LordBeardy1990: doesn't show hand 
*** SUMMARY ***
Total pot $0.60 | Rake $0.03 
Board [3h 4d 2d 6s]
Seat 1: bliznec828 (big blind) folded on the Turn
Seat 2: boomware folded before Flop (didn't bet)
Seat 3: LordBeardy1990 collected ($0.57)
Seat 4: X-rayFeeling folded before Flop (didn't bet)
Seat 5: kubancheg (button) folded before Flop (didn't bet)
Seat 6: Ginger_Hunter86 (small blind) folded on the Turn



PokerStars Hand #222946147095:  Hold'em No Limit ($0.05/$0.10 USD) - 2021/01/23 1:35:16 ET
Table 'Linzia' 6-max Seat #6 is the button
Seat 1: bliznec828 ($12.62 in chips) 
Seat 2: boomware ($12.81 in chips) 
Seat 3: LordBeardy1990 ($14.27 in chips) 
Seat 4: X-rayFeeling ($10.01 in chips) 
Seat 5: kubancheg ($10.55 in chips) 
Seat 6: Ginger_Hunter86 ($22.97 in chips) 
bliznec828: posts small blind $0.05
boomware: posts big blind $0.10
*** HOLE CARDS ***
LordBeardy1990: raises $0.10 to $0.20
X-rayFeeling: folds 
kubancheg: folds 
Ginger_Hunter86: folds 
bliznec828: folds 
boomware: folds 
Uncalled bet ($0.10) returned to LordBeardy1990
LordBeardy1990 collected $0.25 from pot
LordBeardy1990: doesn't show hand 
*** SUMMARY ***
Total pot $0.25 | Rake $0 
Seat 1: bliznec828 (small blind) folded before Flop
Seat 2: boomware (big blind) folded before Flop
Seat 3: LordBeardy1990 collected ($0.25)
Seat 4: X-rayFeeling folded before Flop (didn't bet)
Seat 5: kubancheg folded before Flop (didn't bet)
Seat 6: Ginger_Hunter86 (button) folded before Flop (didn't bet)



PokerStars Hand #222946151669:  Hold'em No Limit ($0.05/$0.10 USD) - 2021/01/23 1:35:35 ET
Table 'Linzia' 6-max Seat #1 is the button
Seat 1: bliznec828 ($12.57 in chips) 
Seat 2: boomware ($12.71 in chips) 
Seat 3: LordBeardy1990 ($14.42 in chips) 
Seat 4: X-rayFeeling ($10.01 in chips) 
Seat 5: kubancheg ($10.55 in chips) 
Seat 6: Ginger_Hunter86 ($22.97 in chips) 
boomware: posts small blind $0.05
LordBeardy1990: posts big blind $0.10
*** HOLE CARDS ***
X-rayFeeling: folds 
kubancheg: folds 
Ginger_Hunter86: raises $0.10 to $0.20
bliznec828: folds 
boomware: folds 
LordBeardy1990: calls $0.10
*** FLOP *** [3h Tc Ah]
LordBeardy1990: bets $0.10
Ginger_Hunter86: calls $0.10
*** TURN *** [3h Tc Ah] [3s]
LordBeardy1990: bets $0.10
Ginger_Hunter86: calls $0.10
*** RIVER *** [3h Tc Ah 3s] [Jc]
LordBeardy1990: bets $1
Ginger_Hunter86: folds 
Uncalled bet ($1) returned to LordBeardy1990
LordBeardy1990 collected $0.81 from pot
LordBeardy1990: doesn't show hand 
*** SUMMARY ***
Total pot $0.85 | Rake $0.04 
Board [3h Tc Ah 3s Jc]
Seat 1: bliznec828 (button) folded before Flop (didn't bet)
Seat 2: boomware (small blind) folded before Flop
Seat 3: LordBeardy1990 (big blind) collected ($0.81)
Seat 4: X-rayFeeling folded before Flop (didn't bet)
Seat 5: kubancheg folded before Flop (didn't bet)
Seat 6: Ginger_Hunter86 folded on the River



PokerStars Hand #222946163713:  Hold'em No Limit ($0.05/$0.10 USD) - 2021/01/23 1:36:25 ET
Table 'Linzia' 6-max Seat #2 is the button
Seat 1: bliznec828 ($12.57 in chips) 
Seat 2: boomware ($12.66 in chips) 
Seat 3: LordBeardy1990 ($14.83 in chips) 
Seat 4: X-rayFeeling ($10.01 in chips) 
Seat 5: kubancheg ($10.55 in chips) 
Seat 6: Ginger_Hunter86 ($22.57 in chips) 
LordBeardy1990: posts small blind $0.05
X-rayFeeling: posts big blind $0.10
*** HOLE CARDS ***
kubancheg: folds 
Ginger_Hunter86: folds 
bliznec828: folds 
boomware: raises $0.20 to $0.30
LordBeardy1990: raises $0.20 to $0.50
X-rayFeeling: folds 
boomware: calls $0.20
*** FLOP *** [7h Th 6h]
LordBeardy1990: bets $0.50
boomware: folds 
Uncalled bet ($0.50) returned to LordBeardy1990
LordBeardy1990 collected $1.05 from pot
LordBeardy1990: doesn't show hand 
*** SUMMARY ***
Total pot $1.10 | Rake $0.05 
Board [7h Th 6h]
Seat 1: bliznec828 folded before Flop (didn't bet)
Seat 2: boomware (button) folded on the Flop
Seat 3: LordBeardy1990 (small blind) collected ($1.05)
Seat 4: X-rayFeeling (big blind) folded before Flop
Seat 5: kubancheg folded before Flop (didn't bet)
Seat 6: Ginger_Hunter86 folded before Flop (didn't bet)



PokerStars Hand #222946171688:  Hold'em No Limit ($0.05/$0.10 USD) - 2021/01/23 1:36:59 ET
Table 'Linzia' 6-max Seat #3 is the button
Seat 1: bliznec828 ($12.57 in chips) 
Seat 2: boomware ($12.16 in chips) 
Seat 3: LordBeardy1990 ($15.38 in chips) 
Seat 4: X-rayFeeling ($10 in chips) 
Seat 5: kubancheg ($10.55 in chips) 
Seat 6: Ginger_Hunter86 ($22.57 in chips) 
X-rayFeeling: posts small blind $0.05
kubancheg: posts big blind $0.10
*** HOLE CARDS ***
Ginger_Hunter86: folds 
bliznec828: folds 
boomware: folds 
bliznec828 leaves the table
LordBeardy1990: calls $0.10
X-rayFeeling: folds 
kubancheg: checks 
*** FLOP *** [8c Kd 6c]
kubancheg: checks 
LordBeardy1990: checks 
*** TURN *** [8c Kd 6c] [Th]
kubancheg: checks 
LordBeardy1990: checks 
*** RIVER *** [8c Kd 6c Th] [4h]
kubancheg: checks 
LordBeardy1990: bets $0.10
kubancheg: folds 
Uncalled bet ($0.10) returned to LordBeardy1990
LordBeardy1990 collected $0.24 from pot
LordBeardy1990: doesn't show hand 
*** SUMMARY ***
Total pot $0.25 | Rake $0.01 
Board [8c Kd 6c Th 4h]
Seat 1: bliznec828 folded before Flop (didn't bet)
Seat 2: boomware folded before Flop (didn't bet)
Seat 3: LordBeardy1990 (button) collected ($0.24)
Seat 4: X-rayFeeling (small blind) folded before Flop
Seat 5: kubancheg (big blind) folded on the River
Seat 6: Ginger_Hunter86 folded before Flop (didn't bet)



PokerStars Hand #222946177404:  Hold'em No Limit ($0.05/$0.10 USD) - 2021/01/23 1:37:23 ET
Table 'Linzia' 6-max Seat #4 is the button
Seat 2: boomware ($12.16 in chips) 
Seat 3: LordBeardy1990 ($15.52 in chips) 
Seat 4: X-rayFeeling ($10 in chips) 
Seat 5: kubancheg ($10.45 in chips) 
Seat 6: Ginger_Hunter86 ($22.57 in chips) 
kubancheg: posts small blind $0.05
Ginger_Hunter86: posts big blind $0.10
*** HOLE CARDS ***
boomware: folds 
LordBeardy1990: calls $0.10
X-rayFeeling: folds 
kubancheg: folds 
Ginger_Hunter86: checks 
*** FLOP *** [Th Kh 7d]
Ginger_Hunter86: checks 
LordBeardy1990: bets $0.20
Ginger_Hunter86: calls $0.20
*** TURN *** [Th Kh 7d] [6c]
Ginger_Hunter86: checks 
LordBeardy1990: bets $0.40
Ginger_Hunter86: calls $0.40
*** RIVER *** [Th Kh 7d 6c] [9s]
Ginger_Hunter86: bets $1.38
tokuch1_toua joins the table at seat #1 
LordBeardy1990: raises $4.08 to $5.46
Ginger_Hunter86: raises $16.41 to $21.87 and is all-in
LordBeardy1990: calls $9.36 and is all-in
Uncalled bet ($7.05) returned to Ginger_Hunter86
*** SHOW DOWN ***
Ginger_Hunter86: shows [Ac As] (a pair of Aces)
LordBeardy1990: shows [8h 9c] (a straight, Six to Ten)
LordBeardy1990 collected $29.69 from pot
*** SUMMARY ***
Total pot $31.09 | Rake $1.40 
Board [Th Kh 7d 6c 9s]
Seat 2: boomware folded before Flop (didn't bet)
Seat 3: LordBeardy1990 showed [8h 9c] and won ($29.69) with a straight, Six to Ten
Seat 4: X-rayFeeling (button) folded before Flop (didn't bet)
Seat 5: kubancheg (small blind) folded before Flop
Seat 6: Ginger_Hunter86 (big blind) showed [Ac As] and lost with a pair of Aces



PokerStars Hand #222946192484:  Hold'em No Limit ($0.05/$0.10 USD) - 2021/01/23 1:38:27 ET
Table 'Linzia' 6-max Seat #5 is the button
Seat 1: tokuch1_toua ($10 in chips) 
Seat 2: boomware ($12.16 in chips) 
Seat 3: LordBeardy1990 ($29.69 in chips) 
Seat 4: X-rayFeeling ($10 in chips) 
Seat 5: kubancheg ($10.40 in chips) 
Seat 6: Ginger_Hunter86 ($7.05 in chips) 
Ginger_Hunter86: posts small blind $0.05
tokuch1_toua: posts big blind $0.10
*** HOLE CARDS ***
boomware: folds 
LordBeardy1990: calls $0.10
X-rayFeeling: folds 
kubancheg: folds 
Ginger_Hunter86: calls $0.05
tokuch1_toua: checks 
*** FLOP *** [5c 4d Ad]
Ginger_Hunter86: checks 
tokuch1_toua: checks 
LordBeardy1990: bets $0.20
Ginger_Hunter86: folds 
tokuch1_toua: folds 
Uncalled bet ($0.20) returned to LordBeardy1990
LordBeardy1990 collected $0.29 from pot
LordBeardy1990: doesn't show hand 
*** SUMMARY ***
Total pot $0.30 | Rake $0.01 
Board [5c 4d Ad]
Seat 1: tokuch1_toua (big blind) folded on the Flop
Seat 2: boomware folded before Flop (didn't bet)
Seat 3: LordBeardy1990 collected ($0.29)
Seat 4: X-rayFeeling folded before Flop (didn't bet)
Seat 5: kubancheg (button) folded before Flop (didn't bet)
Seat 6: Ginger_Hunter86 (small blind) folded on the Flop



PokerStars Hand #222946813778:  Hold'em No Limit ($0.05/$0.10 USD) - 2021/01/23 2:22:48 ET
Table 'Linzia' 6-max Seat #5 is the button
Seat 1: sunsethero13 ($10 in chips) 
Seat 2: Docpete1 ($3.85 in chips) 
Seat 3: Muhlen9 ($11.53 in chips) 
Seat 4: X-rayFeeling ($15.87 in chips) 
Seat 5: Shootnick88 ($10 in chips) 
Seat 6: 12311985 ($12.96 in chips) 
12311985: posts small blind $0.05
sunsethero13: posts big blind $0.10
*** HOLE CARDS ***
Docpete1: raises $0.20 to $0.30
Muhlen9: folds 
X-rayFeeling: folds 
Shootnick88: folds 
12311985: folds 
sunsethero13: calls $0.20
*** FLOP *** [Ts 7c Kc]
sunsethero13: checks 
Docpete1: bets $0.40
sunsethero13: calls $0.40
*** TURN *** [Ts 7c Kc] [Th]
sunsethero13: checks 
Docpete1: checks 
*** RIVER *** [Ts 7c Kc Th] [Jd]
sunsethero13: checks 
Docpete1: bets $3.15 and is all-in
sunsethero13: calls $3.15
*** SHOW DOWN ***
Docpete1: shows [Qs Ac] (a straight, Ten to Ace)
sunsethero13: shows [Kd 8d] (two pair, Kings and Tens)
Docpete1 collected $7.40 from pot
*** SUMMARY ***
Total pot $7.75 | Rake $0.35 
Board [Ts 7c Kc Th Jd]
Seat 1: sunsethero13 (big blind) showed [Kd 8d] and lost with two pair, Kings and Tens
Seat 2: Docpete1 showed [Qs Ac] and won ($7.40) with a straight, Ten to Ace
Seat 3: Muhlen9 folded before Flop (didn't bet)
Seat 4: X-rayFeeling folded before Flop (didn't bet)
Seat 5: Shootnick88 (button) folded before Flop (didn't bet)
Seat 6: 12311985 (small blind) folded before Flop



PokerStars Hand #222946199507:  Hold'em No Limit ($0.05/$0.10 USD) - 2021/01/23 1:38:56 ET
Table 'Linzia' 6-max Seat #6 is the button
Seat 1: tokuch1_toua ($10 in chips) 
Seat 2: boomware ($12.16 in chips) 
Seat 3: LordBeardy1990 ($29.88 in chips) 
Seat 4: X-rayFeeling ($10 in chips) 
Seat 5: kubancheg ($10.40 in chips) 
Seat 6: Ginger_Hunter86 ($6.95 in chips) 
tokuch1_toua: posts small blind $0.05
boomware: posts big blind $0.10
*** HOLE CARDS ***
LordBeardy1990: calls $0.10
X-rayFeeling: folds 
kubancheg: calls $0.10
Ginger_Hunter86: calls $0.10
tokuch1_toua: folds 
boomware: raises $0.90 to $1
LordBeardy1990: folds 
kubancheg: folds 
Ginger_Hunter86: raises $5.95 to $6.95 and is all-in
boomware: calls $5.95
LordBeardy1990 leaves the table
*** FLOP *** [Ac 8h 3h]
*** TURN *** [Ac 8h 3h] [2h]
*** RIVER *** [Ac 8h 3h 2h] [Kh]
*** SHOW DOWN ***
boomware: shows [7d 7c] (a pair of Sevens)
Ginger_Hunter86: shows [4s 4d] (a pair of Fours)
boomware cashed out the hand for $10.88 | Cash Out Fee $0.11
*** SUMMARY ***
Total pot $14.15 | Rake $0.64 
Board [Ac 8h 3h 2h Kh]
Seat 1: tokuch1_toua (small blind) folded before Flop
Seat 2: boomware (big blind) showed [7d 7c] and won ($13.51) with a pair of Sevens (pot not awarded as player cashed out)
Seat 3: LordBeardy1990 folded before Flop
Seat 4: X-rayFeeling folded before Flop (didn't bet)
Seat 5: kubancheg folded before Flop
Seat 6: Ginger_Hunter86 (button) showed [4s 4d] and lost with a pair of Fours



PokerStars Hand #222946213339:  Hold'em No Limit ($0.05/$0.10 USD) - 2021/01/23 1:39:53 ET
Table 'Linzia' 6-max Seat #1 is the button
Seat 1: tokuch1_toua ($10 in chips) 
Seat 2: boomware ($16.09 in chips) 
Seat 4: X-rayFeeling ($10 in chips) 
Seat 5: kubancheg ($10.30 in chips) 
boomware: posts small blind $0.05
X-rayFeeling: posts big blind $0.10
*** HOLE CARDS ***
Muhlen9 joins the table at seat #3 
kubancheg: folds 
tokuch1_toua: folds 
Ginger_Hunter86 leaves the table
boomware: folds 
Uncalled bet ($0.05) returned to X-rayFeeling
X-rayFeeling collected $0.10 from pot
X-rayFeeling: doesn't show hand 
*** SUMMARY ***
Total pot $0.10 | Rake $0 
Seat 1: tokuch1_toua (button) folded before Flop (didn't bet)
Seat 2: boomware (small blind) folded before Flop
Seat 4: X-rayFeeling (big blind) collected ($0.10)
Seat 5: kubancheg folded before Flop (didn't bet)



PokerStars Hand #222946215366:  Hold'em No Limit ($0.05/$0.10 USD) - 2021/01/23 1:40:02 ET
Table 'Linzia' 6-max Seat #2 is the button
Seat 1: tokuch1_toua ($10 in chips) 
Seat 2: boomware ($16.04 in chips) 
Seat 4: X-rayFeeling ($10.05 in chips) 
Seat 5: kubancheg ($10.30 in chips) 
X-rayFeeling: posts small blind $0.05
kubancheg: posts big blind $0.10
*** HOLE CARDS ***
tokuch1_toua: folds 
boomware: raises $0.20 to $0.30
X-rayFeeling: folds 
kubancheg: folds 
Uncalled bet ($0.20) returned to boomware
bilavych joins the table at seat #6 
boomware collected $0.25 from pot
boomware: doesn't show hand 
*** SUMMARY ***
Total pot $0.25 | Rake $0 
Seat 1: tokuch1_toua folded before Flop (didn't bet)
Seat 2: boomware (button) collected ($0.25)
Seat 4: X-rayFeeling (small blind) folded before Flop
Seat 5: kubancheg (big blind) folded before Flop



PokerStars Hand #222946217948:  Hold'em No Limit ($0.05/$0.10 USD) - 2021/01/23 1:40:13 ET
Table 'Linzia' 6-max Seat #4 is the button
Seat 2: boomware ($16.19 in chips) 
Seat 4: X-rayFeeling ($10 in chips) 
Seat 5: kubancheg ($10.20 in chips) 
Seat 6: bilavych ($8 in chips) 
kubancheg: posts small blind $0.05
bilavych: posts big blind $0.10
Muhlen9: sits out 
*** HOLE CARDS ***
boomware: raises $0.20 to $0.30
X-rayFeeling: calls $0.30
kubancheg: folds 
bilavych: raises $7.70 to $8 and is all-in
boomware: folds 
X-rayFeeling: folds 
Uncalled bet ($7.70) returned to bilavych
bilavych collected $0.95 from pot
*** SUMMARY ***
Total pot $0.95 | Rake $0 
Seat 2: boomware folded before Flop
Seat 4: X-rayFeeling (button) folded before Flop
Seat 5: kubancheg (small blind) folded before Flop
Seat 6: bilavych (big blind) collected ($0.95)



PokerStars Hand #222946222294:  Hold'em No Limit ($0.05/$0.10 USD) - 2021/01/23 1:40:31 ET
Table 'Linzia' 6-max Seat #5 is the button
Seat 1: tokuch1_toua ($10 in chips) 
Seat 2: boomware ($15.89 in chips) 
Seat 4: X-rayFeeling ($10 in chips) 
Seat 5: kubancheg ($10.15 in chips) 
Seat 6: bilavych ($8.65 in chips) 
bilavych: posts small blind $0.05
tokuch1_toua: posts big blind $0.10
Muhlen9: sits out 
*** HOLE CARDS ***
boomware: raises $0.20 to $0.30
X-rayFeeling: folds 
kubancheg: folds 
bilavych: folds 
tokuch1_toua: folds 
Uncalled bet ($0.20) returned to boomware
boomware collected $0.25 from pot
boomware: doesn't show hand 
*** SUMMARY ***
Total pot $0.25 | Rake $0 
Seat 1: tokuch1_toua (big blind) folded before Flop
Seat 2: boomware collected ($0.25)
Seat 4: X-rayFeeling folded before Flop (didn't bet)
Seat 5: kubancheg (button) folded before Flop (didn't bet)
Seat 6: bilavych (small blind) folded before Flop



PokerStars Hand #222946224700:  Hold'em No Limit ($0.05/$0.10 USD) - 2021/01/23 1:40:42 ET
Table 'Linzia' 6-max Seat #6 is the button
Seat 1: tokuch1_toua ($10 in chips) 
Seat 2: boomware ($16.04 in chips) 
Seat 4: X-rayFeeling ($10 in chips) 
Seat 5: kubancheg ($10.15 in chips) 
Seat 6: bilavych ($8.60 in chips) 
tokuch1_toua: posts small blind $0.05
boomware: posts big blind $0.10
Muhlen9: sits out 
*** HOLE CARDS ***
X-rayFeeling: folds 
kubancheg: folds 
bilavych: calls $0.10
tokuch1_toua: folds 
boomware: checks 
*** FLOP *** [6d Jd 7c]
boomware: bets $0.25
bilavych: folds 
Uncalled bet ($0.25) returned to boomware
boomware collected $0.24 from pot
boomware: doesn't show hand 
*** SUMMARY ***
Total pot $0.25 | Rake $0.01 
Board [6d Jd 7c]
Seat 1: tokuch1_toua (small blind) folded before Flop
Seat 2: boomware (big blind) collected ($0.24)
Seat 4: X-rayFeeling folded before Flop (didn't bet)
Seat 5: kubancheg folded before Flop (didn't bet)
Seat 6: bilavych (button) folded on the Flop



PokerStars Hand #222946230660:  Hold'em No Limit ($0.05/$0.10 USD) - 2021/01/23 1:41:07 ET
Table 'Linzia' 6-max Seat #1 is the button
Seat 1: tokuch1_toua ($10 in chips) 
Seat 2: boomware ($16.18 in chips) 
Seat 3: Muhlen9 ($10 in chips) 
Seat 4: X-rayFeeling ($10 in chips) 
Seat 5: kubancheg ($10.15 in chips) 
Seat 6: bilavych ($8.50 in chips) 
boomware: posts small blind $0.05
Muhlen9: posts big blind $0.10
*** HOLE CARDS ***
X-rayFeeling: folds 
kubancheg: raises $0.20 to $0.30
bilavych: folds 
tokuch1_toua: folds 
boomware: folds 
Muhlen9: folds 
Uncalled bet ($0.20) returned to kubancheg
kubancheg collected $0.25 from pot
kubancheg: doesn't show hand 
*** SUMMARY ***
Total pot $0.25 | Rake $0 
Seat 1: tokuch1_toua (button) folded before Flop (didn't bet)
Seat 2: boomware (small blind) folded before Flop
Seat 3: Muhlen9 (big blind) folded before Flop
Seat 4: X-rayFeeling folded before Flop (didn't bet)
Seat 5: kubancheg collected ($0.25)
Seat 6: bilavych folded before Flop (didn't bet)



PokerStars Hand #222946234156:  Hold'em No Limit ($0.05/$0.10 USD) - 2021/01/23 1:41:22 ET
Table 'Linzia' 6-max Seat #2 is the button
Seat 1: tokuch1_toua ($10 in chips) 
Seat 2: boomware ($16.13 in chips) 
Seat 3: Muhlen9 ($10 in chips) 
Seat 4: X-rayFeeling ($10 in chips) 
Seat 5: kubancheg ($10.30 in chips) 
Seat 6: bilavych ($8.50 in chips) 
Muhlen9: posts small blind $0.05
X-rayFeeling: posts big blind $0.10
*** HOLE CARDS ***
kubancheg has timed out
kubancheg: folds 
bilavych: folds 
tokuch1_toua: folds 
boomware: raises $0.20 to $0.30
Muhlen9: folds 
X-rayFeeling: folds 
Uncalled bet ($0.20) returned to boomware
boomware collected $0.25 from pot
boomware: doesn't show hand 
*** SUMMARY ***
Total pot $0.25 | Rake $0 
Seat 1: tokuch1_toua folded before Flop (didn't bet)
Seat 2: boomware (button) collected ($0.25)
Seat 3: Muhlen9 (small blind) folded before Flop
Seat 4: X-rayFeeling (big blind) folded before Flop
Seat 5: kubancheg folded before Flop (didn't bet)
Seat 6: bilavych folded before Flop (didn't bet)



PokerStars Hand #222946239237:  Hold'em No Limit ($0.05/$0.10 USD) - 2021/01/23 1:41:43 ET
Table 'Linzia' 6-max Seat #3 is the button
Seat 1: tokuch1_toua ($10 in chips) 
Seat 2: boomware ($16.28 in chips) 
Seat 3: Muhlen9 ($10 in chips) 
Seat 4: X-rayFeeling ($10 in chips) 
Seat 5: kubancheg ($10.30 in chips) 
Seat 6: bilavych ($8.50 in chips) 
X-rayFeeling: posts small blind $0.05
kubancheg: posts big blind $0.10
*** HOLE CARDS ***
bilavych: raises $0.10 to $0.20
tokuch1_toua: folds 
boomware: folds 
Muhlen9: folds 
X-rayFeeling: folds 
kubancheg: folds 
Uncalled bet ($0.10) returned to bilavych
bilavych collected $0.25 from pot
*** SUMMARY ***
Total pot $0.25 | Rake $0 
Seat 1: tokuch1_toua folded before Flop (didn't bet)
Seat 2: boomware folded before Flop (didn't bet)
Seat 3: Muhlen9 (button) folded before Flop (didn't bet)
Seat 4: X-rayFeeling (small blind) folded before Flop
Seat 5: kubancheg (big blind) folded before Flop
Seat 6: bilavych collected ($0.25)



PokerStars Hand #222946242404:  Hold'em No Limit ($0.05/$0.10 USD) - 2021/01/23 1:41:56 ET
Table 'Linzia' 6-max Seat #4 is the button
Seat 1: tokuch1_toua ($10 in chips) 
Seat 2: boomware ($16.28 in chips) 
Seat 3: Muhlen9 ($10 in chips) 
Seat 4: X-rayFeeling ($10 in chips) 
Seat 5: kubancheg ($10.20 in chips) 
Seat 6: bilavych ($8.65 in chips) 
kubancheg: posts small blind $0.05
bilavych: posts big blind $0.10
*** HOLE CARDS ***
tokuch1_toua: folds 
boomware: folds 
Muhlen9: folds 
X-rayFeeling: folds 
kubancheg: raises $0.20 to $0.30
bilavych: calls $0.20
*** FLOP *** [Ah Jd 4c]
kubancheg: bets $0.28
bilavych: calls $0.28
*** TURN *** [Ah Jd 4c] [Td]
kubancheg: bets $0.55
bilavych: calls $0.55
*** RIVER *** [Ah Jd 4c Td] [8s]
kubancheg: bets $1.08
bilavych: folds 
Uncalled bet ($1.08) returned to kubancheg
kubancheg collected $2.16 from pot
kubancheg: doesn't show hand 
*** SUMMARY ***
Total pot $2.26 | Rake $0.10 
Board [Ah Jd 4c Td 8s]
Seat 1: tokuch1_toua folded before Flop (didn't bet)
Seat 2: boomware folded before Flop (didn't bet)
Seat 3: Muhlen9 folded before Flop (didn't bet)
Seat 4: X-rayFeeling (button) folded before Flop (didn't bet)
Seat 5: kubancheg (small blind) collected ($2.16)
Seat 6: bilavych (big blind) folded on the River



PokerStars Hand #222946249453:  Hold'em No Limit ($0.05/$0.10 USD) - 2021/01/23 1:42:26 ET
Table 'Linzia' 6-max Seat #5 is the button
Seat 1: tokuch1_toua ($10 in chips) 
Seat 2: boomware ($16.28 in chips) 
Seat 3: Muhlen9 ($10 in chips) 
Seat 4: X-rayFeeling ($10 in chips) 
Seat 5: kubancheg ($11.23 in chips) 
Seat 6: bilavych ($7.52 in chips) 
bilavych: posts small blind $0.05
tokuch1_toua: posts big blind $0.10
*** HOLE CARDS ***
boomware: raises $0.20 to $0.30
Muhlen9: folds 
X-rayFeeling: calls $0.30
kubancheg: calls $0.30
bilavych: calls $0.25
tokuch1_toua: folds 
*** FLOP *** [7h 8c 2c]
bilavych: bets $7.22 and is all-in
boomware: folds 
X-rayFeeling: folds 
kubancheg: calls $7.22
*** TURN *** [7h 8c 2c] [8d]
*** RIVER *** [7h 8c 2c 8d] [5h]
*** SHOW DOWN ***
bilavych: shows [6h 5d] (two pair, Eights and Fives)
kubancheg: shows [6c 7c] (two pair, Eights and Sevens)
kubancheg collected $15.03 from pot
*** SUMMARY ***
Total pot $15.74 | Rake $0.71 
Board [7h 8c 2c 8d 5h]
Seat 1: tokuch1_toua (big blind) folded before Flop
Seat 2: boomware folded on the Flop
Seat 3: Muhlen9 folded before Flop (didn't bet)
Seat 4: X-rayFeeling folded on the Flop
Seat 5: kubancheg (button) showed [6c 7c] and won ($15.03) with two pair, Eights and Sevens
Seat 6: bilavych (small blind) showed [6h 5d] and lost with two pair, Eights and Fives



PokerStars Hand #222946259334:  Hold'em No Limit ($0.05/$0.10 USD) - 2021/01/23 1:43:07 ET
Table 'Linzia' 6-max Seat #1 is the button
Seat 1: tokuch1_toua ($10 in chips) 
Seat 2: boomware ($15.98 in chips) 
Seat 3: Muhlen9 ($10 in chips) 
Seat 4: X-rayFeeling ($10 in chips) 
Seat 5: kubancheg ($18.74 in chips) 
boomware: posts small blind $0.05
Muhlen9: posts big blind $0.10
*** HOLE CARDS ***
X-rayFeeling: folds 
kubancheg: folds 
tokuch1_toua: folds 
boomware: folds 
Uncalled bet ($0.05) returned to Muhlen9
Muhlen9 collected $0.10 from pot
Muhlen9: doesn't show hand 
*** SUMMARY ***
Total pot $0.10 | Rake $0 
Seat 1: tokuch1_toua (button) folded before Flop (didn't bet)
Seat 2: boomware (small blind) folded before Flop
Seat 3: Muhlen9 (big blind) collected ($0.10)
Seat 4: X-rayFeeling folded before Flop (didn't bet)
Seat 5: kubancheg folded before Flop (didn't bet)



PokerStars Hand #222946261593:  Hold'em No Limit ($0.05/$0.10 USD) - 2021/01/23 1:43:17 ET
Table 'Linzia' 6-max Seat #2 is the button
Seat 1: tokuch1_toua ($10 in chips) 
Seat 2: boomware ($15.93 in chips) 
Seat 3: Muhlen9 ($10.05 in chips) 
Seat 4: X-rayFeeling ($10 in chips) 
Seat 5: kubancheg ($18.74 in chips) 
Muhlen9: posts small blind $0.05
X-rayFeeling: posts big blind $0.10
*** HOLE CARDS ***
bilavych leaves the table
kubancheg: folds 
tokuch1_toua: raises $0.20 to $0.30
boomware: folds 
Muhlen9: folds 
X-rayFeeling: folds 
Uncalled bet ($0.20) returned to tokuch1_toua
tokuch1_toua collected $0.25 from pot
tokuch1_toua: doesn't show hand 
*** SUMMARY ***
Total pot $0.25 | Rake $0 
Seat 1: tokuch1_toua collected ($0.25)
Seat 2: boomware (button) folded before Flop (didn't bet)
Seat 3: Muhlen9 (small blind) folded before Flop
Seat 4: X-rayFeeling (big blind) folded before Flop
Seat 5: kubancheg folded before Flop (didn't bet)



PokerStars Hand #222946264468:  Hold'em No Limit ($0.05/$0.10 USD) - 2021/01/23 1:43:29 ET
Table 'Linzia' 6-max Seat #3 is the button
Seat 1: tokuch1_toua ($10.15 in chips) 
Seat 2: boomware ($15.93 in chips) 
Seat 3: Muhlen9 ($10 in chips) 
Seat 4: X-rayFeeling ($10 in chips) 
Seat 5: kubancheg ($18.74 in chips) 
X-rayFeeling: posts small blind $0.05
kubancheg: posts big blind $0.10
*** HOLE CARDS ***
12311985 joins the table at seat #6 
tokuch1_toua: raises $0.20 to $0.30
boomware: folds 
Muhlen9: calls $0.30
X-rayFeeling: raises $1.10 to $1.40
kubancheg: folds 
tokuch1_toua: folds 
Muhlen9: folds 
Uncalled bet ($1.10) returned to X-rayFeeling
X-rayFeeling collected $1 from pot
X-rayFeeling: doesn't show hand 
*** SUMMARY ***
Total pot $1 | Rake $0 
Seat 1: tokuch1_toua folded before Flop
Seat 2: boomware folded before Flop (didn't bet)
Seat 3: Muhlen9 (button) folded before Flop
Seat 4: X-rayFeeling (small blind) collected ($1)
Seat 5: kubancheg (big blind) folded before Flop



PokerStars Hand #222946269481:  Hold'em No Limit ($0.05/$0.10 USD) - 2021/01/23 1:43:50 ET
Table 'Linzia' 6-max Seat #4 is the button
Seat 1: tokuch1_toua ($10 in chips) 
Seat 2: boomware ($15.93 in chips) 
Seat 3: Muhlen9 ($10 in chips) 
Seat 4: X-rayFeeling ($10.70 in chips) 
Seat 5: kubancheg ($18.64 in chips) 
Seat 6: 12311985 ($10 in chips) 
kubancheg: posts small blind $0.05
12311985: posts big blind $0.10
*** HOLE CARDS ***
tokuch1_toua: folds 
boomware: folds 
Muhlen9: raises $0.15 to $0.25
X-rayFeeling: folds 
kubancheg: folds 
12311985: folds 
Uncalled bet ($0.15) returned to Muhlen9
Muhlen9 collected $0.25 from pot
Muhlen9: doesn't show hand 
*** SUMMARY ***
Total pot $0.25 | Rake $0 
Seat 1: tokuch1_toua folded before Flop (didn't bet)
Seat 2: boomware folded before Flop (didn't bet)
Seat 3: Muhlen9 collected ($0.25)
Seat 4: X-rayFeeling (button) folded before Flop (didn't bet)
Seat 5: kubancheg (small blind) folded before Flop
Seat 6: 12311985 (big blind) folded before Flop



PokerStars Hand #222946272274:  Hold'em No Limit ($0.05/$0.10 USD) - 2021/01/23 1:44:02 ET
Table 'Linzia' 6-max Seat #5 is the button
Seat 1: tokuch1_toua ($10 in chips) 
Seat 2: boomware ($15.93 in chips) 
Seat 3: Muhlen9 ($10.15 in chips) 
Seat 4: X-rayFeeling ($10.70 in chips) 
Seat 5: kubancheg ($18.59 in chips) 
Seat 6: 12311985 ($10 in chips) 
12311985: posts small blind $0.05
tokuch1_toua: posts big blind $0.10
*** HOLE CARDS ***
boomware: folds 
Muhlen9: folds 
X-rayFeeling: raises $0.20 to $0.30
kubancheg: raises $0.60 to $0.90
12311985: folds 
tokuch1_toua: folds 
X-rayFeeling: folds 
Uncalled bet ($0.60) returned to kubancheg
kubancheg collected $0.75 from pot
kubancheg: doesn't show hand 
*** SUMMARY ***
Total pot $0.75 | Rake $0 
Seat 1: tokuch1_toua (big blind) folded before Flop
Seat 2: boomware folded before Flop (didn't bet)
Seat 3: Muhlen9 folded before Flop (didn't bet)
Seat 4: X-rayFeeling folded before Flop
Seat 5: kubancheg (button) collected ($0.75)
Seat 6: 12311985 (small blind) folded before Flop



PokerStars Hand #222946275949:  Hold'em No Limit ($0.05/$0.10 USD) - 2021/01/23 1:44:18 ET
Table 'Linzia' 6-max Seat #6 is the button
Seat 1: tokuch1_toua ($10 in chips) 
Seat 2: boomware ($15.93 in chips) 
Seat 3: Muhlen9 ($10.15 in chips) 
Seat 4: X-rayFeeling ($10.40 in chips) 
Seat 5: kubancheg ($19.04 in chips) 
Seat 6: 12311985 ($10 in chips) 
tokuch1_toua: posts small blind $0.05
boomware: posts big blind $0.10
*** HOLE CARDS ***
Muhlen9: folds 
X-rayFeeling: raises $0.20 to $0.30
kubancheg: raises $0.60 to $0.90
12311985: folds 
tokuch1_toua: folds 
boomware: folds 
X-rayFeeling: folds 
Uncalled bet ($0.60) returned to kubancheg
kubancheg collected $0.75 from pot
kubancheg: doesn't show hand 
*** SUMMARY ***
Total pot $0.75 | Rake $0 
Seat 1: tokuch1_toua (small blind) folded before Flop
Seat 2: boomware (big blind) folded before Flop
Seat 3: Muhlen9 folded before Flop (didn't bet)
Seat 4: X-rayFeeling folded before Flop
Seat 5: kubancheg collected ($0.75)
Seat 6: 12311985 (button) folded before Flop (didn't bet)



PokerStars Hand #222946279787:  Hold'em No Limit ($0.05/$0.10 USD) - 2021/01/23 1:44:34 ET
Table 'Linzia' 6-max Seat #1 is the button
Seat 1: tokuch1_toua ($10 in chips) 
Seat 2: boomware ($15.83 in chips) 
Seat 3: Muhlen9 ($10.15 in chips) 
Seat 4: X-rayFeeling ($10.10 in chips) 
Seat 5: kubancheg ($19.49 in chips) 
Seat 6: 12311985 ($10 in chips) 
boomware: posts small blind $0.05
Muhlen9: posts big blind $0.10
*** HOLE CARDS ***
X-rayFeeling: folds 
kubancheg: folds 
12311985: raises $0.15 to $0.25
tokuch1_toua: folds 
boomware: folds 
Muhlen9: folds 
Uncalled bet ($0.15) returned to 12311985
12311985 collected $0.25 from pot
12311985: doesn't show hand 
*** SUMMARY ***
Total pot $0.25 | Rake $0 
Seat 1: tokuch1_toua (button) folded before Flop (didn't bet)
Seat 2: boomware (small blind) folded before Flop
Seat 3: Muhlen9 (big blind) folded before Flop
Seat 4: X-rayFeeling folded before Flop (didn't bet)
Seat 5: kubancheg folded before Flop (didn't bet)
Seat 6: 12311985 collected ($0.25)



PokerStars Hand #222946282967:  Hold'em No Limit ($0.05/$0.10 USD) - 2021/01/23 1:44:47 ET
Table 'Linzia' 6-max Seat #2 is the button
Seat 1: tokuch1_toua ($10 in chips) 
Seat 2: boomware ($15.78 in chips) 
Seat 3: Muhlen9 ($10.05 in chips) 
Seat 4: X-rayFeeling ($10.10 in chips) 
Seat 5: kubancheg ($19.49 in chips) 
Seat 6: 12311985 ($10.15 in chips) 
Muhlen9: posts small blind $0.05
X-rayFeeling: posts big blind $0.10
*** HOLE CARDS ***
kubancheg: folds 
12311985: folds 
kubancheg leaves the table
tokuch1_toua: folds 
boomware: folds 
Muhlen9: folds 
Uncalled bet ($0.05) returned to X-rayFeeling
X-rayFeeling collected $0.10 from pot
X-rayFeeling: doesn't show hand 
*** SUMMARY ***
Total pot $0.10 | Rake $0 
Seat 1: tokuch1_toua folded before Flop (didn't bet)
Seat 2: boomware (button) folded before Flop (didn't bet)
Seat 3: Muhlen9 (small blind) folded before Flop
Seat 4: X-rayFeeling (big blind) collected ($0.10)
Seat 5: kubancheg folded before Flop (didn't bet)
Seat 6: 12311985 folded before Flop (didn't bet)



PokerStars Hand #222946286222:  Hold'em No Limit ($0.05/$0.10 USD) - 2021/01/23 1:45:01 ET
Table 'Linzia' 6-max Seat #3 is the button
Seat 1: tokuch1_toua ($10 in chips) 
Seat 2: boomware ($15.78 in chips) 
Seat 3: Muhlen9 ($10 in chips) 
Seat 4: X-rayFeeling ($10.15 in chips) 
Seat 6: 12311985 ($10.15 in chips) 
X-rayFeeling: posts small blind $0.05
12311985: posts big blind $0.10
*** HOLE CARDS ***
tokuch1_toua: raises $0.20 to $0.30
Bocky59 joins the table at seat #5 
boomware: folds 
Muhlen9: calls $0.30
X-rayFeeling: folds 
12311985: folds 
*** FLOP *** [Th 8c 9h]
tokuch1_toua: checks 
Muhlen9: bets $0.36
tokuch1_toua: calls $0.36
*** TURN *** [Th 8c 9h] [8s]
tokuch1_toua: checks 
Muhlen9: checks 
*** RIVER *** [Th 8c 9h 8s] [4s]
tokuch1_toua: checks 
Muhlen9: bets $1.05
tokuch1_toua: folds 
Uncalled bet ($1.05) returned to Muhlen9
Muhlen9 collected $1.40 from pot
Muhlen9: doesn't show hand 
*** SUMMARY ***
Total pot $1.47 | Rake $0.07 
Board [Th 8c 9h 8s 4s]
Seat 1: tokuch1_toua folded on the River
Seat 2: boomware folded before Flop (didn't bet)
Seat 3: Muhlen9 (button) collected ($1.40)
Seat 4: X-rayFeeling (small blind) folded before Flop
Seat 6: 12311985 (big blind) folded before Flop



PokerStars Hand #222946298201:  Hold'em No Limit ($0.05/$0.10 USD) - 2021/01/23 1:45:53 ET
Table 'Linzia' 6-max Seat #4 is the button
Seat 1: tokuch1_toua ($10 in chips) 
Seat 2: boomware ($15.78 in chips) 
Seat 3: Muhlen9 ($10.74 in chips) 
Seat 4: X-rayFeeling ($10.10 in chips) 
Seat 6: 12311985 ($10.05 in chips) 
12311985: posts small blind $0.05
tokuch1_toua: posts big blind $0.10
*** HOLE CARDS ***
boomware: folds 
Muhlen9: folds 
X-rayFeeling: folds 
12311985: raises $0.20 to $0.30
tokuch1_toua: folds 
Uncalled bet ($0.20) returned to 12311985
12311985 collected $0.20 from pot
12311985: doesn't show hand 
*** SUMMARY ***
Total pot $0.20 | Rake $0 
Seat 1: tokuch1_toua (big blind) folded before Flop
Seat 2: boomware folded before Flop (didn't bet)
Seat 3: Muhlen9 folded before Flop (didn't bet)
Seat 4: X-rayFeeling (button) folded before Flop (didn't bet)
Seat 6: 12311985 (small blind) collected ($0.20)



PokerStars Hand #222946302243:  Hold'em No Limit ($0.05/$0.10 USD) - 2021/01/23 1:46:10 ET
Table 'Linzia' 6-max Seat #6 is the button
Seat 1: tokuch1_toua ($10 in chips) 
Seat 2: boomware ($15.78 in chips) 
Seat 3: Muhlen9 ($10.74 in chips) 
Seat 4: X-rayFeeling ($10.10 in chips) 
Seat 5: Bocky59 ($10 in chips) 
Seat 6: 12311985 ($10.15 in chips) 
tokuch1_toua: posts small blind $0.05
boomware: posts big blind $0.10
Bocky59: posts big blind $0.10
*** HOLE CARDS ***
Muhlen9: folds 
X-rayFeeling: calls $0.10
Bocky59: checks 
12311985: folds 
tokuch1_toua: folds 
boomware: raises $0.55 to $0.65
X-rayFeeling: calls $0.55
Bocky59: folds 
*** FLOP *** [2c Td 3s]
boomware: bets $0.76
X-rayFeeling: calls $0.76
*** TURN *** [2c Td 3s] [Ts]
boomware: checks 
X-rayFeeling: checks 
*** RIVER *** [2c Td 3s Ts] [9c]
boomware: checks 
X-rayFeeling: checks 
*** SHOW DOWN ***
boomware: shows [8c 8d] (two pair, Tens and Eights)
X-rayFeeling: mucks hand 
boomware collected $2.84 from pot
*** SUMMARY ***
Total pot $2.97 | Rake $0.13 
Board [2c Td 3s Ts 9c]
Seat 1: tokuch1_toua (small blind) folded before Flop
Seat 2: boomware (big blind) showed [8c 8d] and won ($2.84) with two pair, Tens and Eights
Seat 3: Muhlen9 folded before Flop (didn't bet)
Seat 4: X-rayFeeling mucked
Seat 5: Bocky59 folded before Flop (didn't bet)
Seat 6: 12311985 (button) folded before Flop (didn't bet)



PokerStars Hand #222946313925:  Hold'em No Limit ($0.05/$0.10 USD) - 2021/01/23 1:46:59 ET
Table 'Linzia' 6-max Seat #1 is the button
Seat 1: tokuch1_toua ($10 in chips) 
Seat 2: boomware ($17.21 in chips) 
Seat 3: Muhlen9 ($10.74 in chips) 
Seat 4: X-rayFeeling ($10 in chips) 
Seat 5: Bocky59 ($9.90 in chips) 
Seat 6: 12311985 ($10.15 in chips) 
boomware: posts small blind $0.05
Muhlen9: posts big blind $0.10
*** HOLE CARDS ***
X-rayFeeling: folds 
Bocky59: folds 
12311985: folds 
tokuch1_toua: folds 
boomware: folds 
Uncalled bet ($0.05) returned to Muhlen9
Muhlen9 collected $0.10 from pot
Muhlen9: doesn't show hand 
*** SUMMARY ***
Total pot $0.10 | Rake $0 
Seat 1: tokuch1_toua (button) folded before Flop (didn't bet)
Seat 2: boomware (small blind) folded before Flop
Seat 3: Muhlen9 (big blind) collected ($0.10)
Seat 4: X-rayFeeling folded before Flop (didn't bet)
Seat 5: Bocky59 folded before Flop (didn't bet)
Seat 6: 12311985 folded before Flop (didn't bet)



PokerStars Hand #222946317047:  Hold'em No Limit ($0.05/$0.10 USD) - 2021/01/23 1:47:13 ET
Table 'Linzia' 6-max Seat #2 is the button
Seat 1: tokuch1_toua ($10 in chips) 
Seat 2: boomware ($17.16 in chips) 
Seat 3: Muhlen9 ($10.79 in chips) 
Seat 4: X-rayFeeling ($10 in chips) 
Seat 5: Bocky59 ($9.90 in chips) 
Seat 6: 12311985 ($10.15 in chips) 
Muhlen9: posts small blind $0.05
X-rayFeeling: posts big blind $0.10
*** HOLE CARDS ***
Bocky59: calls $0.10
12311985: folds 
tokuch1_toua: folds 
boomware: raises $0.35 to $0.45
Muhlen9: folds 
X-rayFeeling: folds 
Bocky59: calls $0.35
*** FLOP *** [7d Tc 4s]
Bocky59: checks 
boomware: bets $0.55
Bocky59: calls $0.55
*** TURN *** [7d Tc 4s] [6s]
Bocky59: bets $1.03
boomware: folds 
Uncalled bet ($1.03) returned to Bocky59
Bocky59 collected $2.05 from pot
Bocky59: doesn't show hand 
*** SUMMARY ***
Total pot $2.15 | Rake $0.10 
Board [7d Tc 4s 6s]
Seat 1: tokuch1_toua folded before Flop (didn't bet)
Seat 2: boomware (button) folded on the Turn
Seat 3: Muhlen9 (small blind) folded before Flop
Seat 4: X-rayFeeling (big blind) folded before Flop
Seat 5: Bocky59 collected ($2.05)
Seat 6: 12311985 folded before Flop (didn't bet)



PokerStars Hand #222946327752:  Hold'em No Limit ($0.05/$0.10 USD) - 2021/01/23 1:47:58 ET
Table 'Linzia' 6-max Seat #3 is the button
Seat 1: tokuch1_toua ($10 in chips) 
Seat 2: boomware ($16.16 in chips) 
Seat 3: Muhlen9 ($10.74 in chips) 
Seat 4: X-rayFeeling ($10 in chips) 
Seat 5: Bocky59 ($10.95 in chips) 
Seat 6: 12311985 ($10.15 in chips) 
X-rayFeeling: posts small blind $0.05
Bocky59: posts big blind $0.10
*** HOLE CARDS ***
12311985: folds 
tokuch1_toua: folds 
boomware: folds 
Muhlen9: raises $0.15 to $0.25
X-rayFeeling: calls $0.20
Bocky59: folds 
*** FLOP *** [5s 3d Jh]
X-rayFeeling: checks 
Muhlen9: bets $0.19
X-rayFeeling: calls $0.19
*** TURN *** [5s 3d Jh] [Kh]
X-rayFeeling: checks 
Muhlen9: checks 
*** RIVER *** [5s 3d Jh Kh] [Ad]
X-rayFeeling: checks 
Muhlen9: bets $0.71
X-rayFeeling: folds 
Uncalled bet ($0.71) returned to Muhlen9
Muhlen9 collected $0.94 from pot
Muhlen9: doesn't show hand 
*** SUMMARY ***
Total pot $0.98 | Rake $0.04 
Board [5s 3d Jh Kh Ad]
Seat 1: tokuch1_toua folded before Flop (didn't bet)
Seat 2: boomware folded before Flop (didn't bet)
Seat 3: Muhlen9 (button) collected ($0.94)
Seat 4: X-rayFeeling (small blind) folded on the River
Seat 5: Bocky59 (big blind) folded before Flop
Seat 6: 12311985 folded before Flop (didn't bet)



PokerStars Hand #222946337619:  Hold'em No Limit ($0.05/$0.10 USD) - 2021/01/23 1:48:40 ET
Table 'Linzia' 6-max Seat #4 is the button
Seat 1: tokuch1_toua ($10 in chips) 
Seat 2: boomware ($16.16 in chips) 
Seat 3: Muhlen9 ($11.24 in chips) 
Seat 4: X-rayFeeling ($10 in chips) 
Seat 5: Bocky59 ($10.85 in chips) 
Seat 6: 12311985 ($10.15 in chips) 
Bocky59: posts small blind $0.05
12311985: posts big blind $0.10
*** HOLE CARDS ***
tokuch1_toua: folds 
boomware: folds 
Muhlen9: folds 
X-rayFeeling: raises $0.15 to $0.25
Bocky59: calls $0.20
12311985: folds 
*** FLOP *** [8h 4s 8c]
Bocky59: checks 
X-rayFeeling: checks 
*** TURN *** [8h 4s 8c] [6d]
Bocky59: bets $0.29
X-rayFeeling: folds 
Uncalled bet ($0.29) returned to Bocky59
Bocky59 collected $0.57 from pot
Bocky59: doesn't show hand 
*** SUMMARY ***
Total pot $0.60 | Rake $0.03 
Board [8h 4s 8c 6d]
Seat 1: tokuch1_toua folded before Flop (didn't bet)
Seat 2: boomware folded before Flop (didn't bet)
Seat 3: Muhlen9 folded before Flop (didn't bet)
Seat 4: X-rayFeeling (button) folded on the Turn
Seat 5: Bocky59 (small blind) collected ($0.57)
Seat 6: 12311985 (big blind) folded before Flop



PokerStars Hand #222946345255:  Hold'em No Limit ($0.05/$0.10 USD) - 2021/01/23 1:49:13 ET
Table 'Linzia' 6-max Seat #5 is the button
Seat 1: tokuch1_toua ($10 in chips) 
Seat 2: boomware ($16.16 in chips) 
Seat 3: Muhlen9 ($11.24 in chips) 
Seat 4: X-rayFeeling ($10 in chips) 
Seat 5: Bocky59 ($11.17 in chips) 
Seat 6: 12311985 ($10.05 in chips) 
12311985: posts small blind $0.05
tokuch1_toua: posts big blind $0.10
*** HOLE CARDS ***
boomware: folds 
Muhlen9: raises $0.15 to $0.25
X-rayFeeling: folds 
Bocky59: folds 
12311985: raises $0.75 to $1
tokuch1_toua: folds 
Muhlen9: folds 
Uncalled bet ($0.75) returned to 12311985
12311985 collected $0.60 from pot
12311985: doesn't show hand 
*** SUMMARY ***
Total pot $0.60 | Rake $0 
Seat 1: tokuch1_toua (big blind) folded before Flop
Seat 2: boomware folded before Flop (didn't bet)
Seat 3: Muhlen9 folded before Flop
Seat 4: X-rayFeeling folded before Flop (didn't bet)
Seat 5: Bocky59 (button) folded before Flop (didn't bet)
Seat 6: 12311985 (small blind) collected ($0.60)



PokerStars Hand #222946350915:  Hold'em No Limit ($0.05/$0.10 USD) - 2021/01/23 1:49:34 ET
Table 'Linzia' 6-max Seat #6 is the button
Seat 1: tokuch1_toua ($10 in chips) 
Seat 3: Muhlen9 ($10.99 in chips) 
Seat 4: X-rayFeeling ($10 in chips) 
Seat 5: Bocky59 ($11.17 in chips) 
Seat 6: 12311985 ($10.40 in chips) 
tokuch1_toua: posts small blind $0.05
boomware: is sitting out 
Muhlen9: posts big blind $0.10
*** HOLE CARDS ***
X-rayFeeling: folds 
Bocky59: folds 
12311985: folds 
boomware leaves the table
tokuch1_toua: raises $0.20 to $0.30
Muhlen9: raises $0.60 to $0.90
tokuch1_toua: folds 
Uncalled bet ($0.60) returned to Muhlen9
Muhlen9 collected $0.60 from pot
Muhlen9: doesn't show hand 
*** SUMMARY ***
Total pot $0.60 | Rake $0 
Seat 1: tokuch1_toua (small blind) folded before Flop
Seat 3: Muhlen9 (big blind) collected ($0.60)
Seat 4: X-rayFeeling folded before Flop (didn't bet)
Seat 5: Bocky59 folded before Flop (didn't bet)
Seat 6: 12311985 (button) folded before Flop (didn't bet)



PokerStars Hand #222946355078:  Hold'em No Limit ($0.05/$0.10 USD) - 2021/01/23 1:49:52 ET
Table 'Linzia' 6-max Seat #1 is the button
Seat 1: tokuch1_toua ($10 in chips) 
Seat 3: Muhlen9 ($11.29 in chips) 
Seat 4: X-rayFeeling ($10 in chips) 
Seat 5: Bocky59 ($11.17 in chips) 
Seat 6: 12311985 ($10.40 in chips) 
Muhlen9: posts small blind $0.05
IrdinTo16 joins the table at seat #2 
X-rayFeeling: posts big blind $0.10
*** HOLE CARDS ***
Bocky59: calls $0.10
12311985: folds 
tokuch1_toua: folds 
Muhlen9: folds 
X-rayFeeling: checks 
*** FLOP *** [8c 3h 3s]
X-rayFeeling: checks 
Bocky59: checks 
*** TURN *** [8c 3h 3s] [6s]
X-rayFeeling: bets $0.14
Bocky59: calls $0.14
*** RIVER *** [8c 3h 3s 6s] [Jd]
X-rayFeeling: bets $0.31
Bocky59: calls $0.31
*** SHOW DOWN ***
X-rayFeeling: shows [Kh 6d] (two pair, Sixes and Threes)
Bocky59: shows [5d Js] (two pair, Jacks and Threes)
Bocky59 collected $1.10 from pot
*** SUMMARY ***
Total pot $1.15 | Rake $0.05 
Board [8c 3h 3s 6s Jd]
Seat 1: tokuch1_toua (button) folded before Flop (didn't bet)
Seat 3: Muhlen9 (small blind) folded before Flop
Seat 4: X-rayFeeling (big blind) showed [Kh 6d] and lost with two pair, Sixes and Threes
Seat 5: Bocky59 showed [5d Js] and won ($1.10) with two pair, Jacks and Threes
Seat 6: 12311985 folded before Flop (didn't bet)



PokerStars Hand #222946360929:  Hold'em No Limit ($0.05/$0.10 USD) - 2021/01/23 1:50:17 ET
Table 'Linzia' 6-max Seat #3 is the button
Seat 1: tokuch1_toua ($10 in chips) 
Seat 3: Muhlen9 ($11.24 in chips) 
Seat 4: X-rayFeeling ($10 in chips) 
Seat 5: Bocky59 ($11.72 in chips) 
Seat 6: 12311985 ($10.40 in chips) 
X-rayFeeling: posts small blind $0.05
Bocky59: posts big blind $0.10
IrdinTo16: sits out 
*** HOLE CARDS ***
12311985: folds 
tokuch1_toua: raises $0.20 to $0.30
Muhlen9: folds 
X-rayFeeling: folds 
Bocky59: folds 
Uncalled bet ($0.20) returned to tokuch1_toua
tokuch1_toua collected $0.25 from pot
tokuch1_toua: doesn't show hand 
*** SUMMARY ***
Total pot $0.25 | Rake $0 
Seat 1: tokuch1_toua collected ($0.25)
Seat 3: Muhlen9 (button) folded before Flop (didn't bet)
Seat 4: X-rayFeeling (small blind) folded before Flop
Seat 5: Bocky59 (big blind) folded before Flop
Seat 6: 12311985 folded before Flop (didn't bet)



PokerStars Hand #222946364150:  Hold'em No Limit ($0.05/$0.10 USD) - 2021/01/23 1:50:32 ET
Table 'Linzia' 6-max Seat #4 is the button
Seat 1: tokuch1_toua ($10.15 in chips) 
Seat 3: Muhlen9 ($11.24 in chips) 
Seat 4: X-rayFeeling ($10 in chips) 
Seat 5: Bocky59 ($11.62 in chips) 
Seat 6: 12311985 ($10.40 in chips) 
Bocky59: posts small blind $0.05
12311985: posts big blind $0.10
IrdinTo16: sits out 
*** HOLE CARDS ***
tokuch1_toua: folds 
Muhlen9: raises $0.15 to $0.25
X-rayFeeling: folds 
Bocky59: calls $0.20
12311985: folds 
*** FLOP *** [2c Kc Qc]
Bocky59: bets $0.10
Muhlen9: calls $0.10
*** TURN *** [2c Kc Qc] [7s]
Bocky59: bets $0.76
Muhlen9: folds 
Uncalled bet ($0.76) returned to Bocky59
Bocky59 collected $0.76 from pot
Bocky59: doesn't show hand 
*** SUMMARY ***
Total pot $0.80 | Rake $0.04 
Board [2c Kc Qc 7s]
Seat 1: tokuch1_toua folded before Flop (didn't bet)
Seat 3: Muhlen9 folded on the Turn
Seat 4: X-rayFeeling (button) folded before Flop (didn't bet)
Seat 5: Bocky59 (small blind) collected ($0.76)
Seat 6: 12311985 (big blind) folded before Flop



PokerStars Hand #222946375375:  Hold'em No Limit ($0.05/$0.10 USD) - 2021/01/23 1:51:20 ET
Table 'Linzia' 6-max Seat #5 is the button
Seat 1: tokuch1_toua ($10.15 in chips) 
Seat 3: Muhlen9 ($10.89 in chips) 
Seat 4: X-rayFeeling ($10 in chips) 
Seat 5: Bocky59 ($12.03 in chips) 
Seat 6: 12311985 ($10.30 in chips) 
12311985: posts small blind $0.05
tokuch1_toua: posts big blind $0.10
IrdinTo16: sits out 
*** HOLE CARDS ***
Muhlen9: folds 
X-rayFeeling: folds 
Bocky59: folds 
12311985: raises $0.20 to $0.30
tokuch1_toua: calls $0.20
*** FLOP *** [Jd 6d 3s]
12311985: checks 
tokuch1_toua: bets $0.26
12311985: calls $0.26
*** TURN *** [Jd 6d 3s] [Qh]
12311985: checks 
tokuch1_toua: bets $0.48
12311985: folds 
Uncalled bet ($0.48) returned to tokuch1_toua
tokuch1_toua collected $1.07 from pot
tokuch1_toua: doesn't show hand 
*** SUMMARY ***
Total pot $1.12 | Rake $0.05 
Board [Jd 6d 3s Qh]
Seat 1: tokuch1_toua (big blind) collected ($1.07)
Seat 3: Muhlen9 folded before Flop (didn't bet)
Seat 4: X-rayFeeling folded before Flop (didn't bet)
Seat 5: Bocky59 (button) folded before Flop (didn't bet)
Seat 6: 12311985 (small blind) folded on the Turn



PokerStars Hand #222946381755:  Hold'em No Limit ($0.05/$0.10 USD) - 2021/01/23 1:51:48 ET
Table 'Linzia' 6-max Seat #6 is the button
Seat 1: tokuch1_toua ($10.66 in chips) 
Seat 2: IrdinTo16 ($10 in chips) 
Seat 3: Muhlen9 ($10.89 in chips) 
Seat 4: X-rayFeeling ($10 in chips) 
Seat 5: Bocky59 ($12.03 in chips) 
Seat 6: 12311985 ($10 in chips) 
tokuch1_toua: posts small blind $0.05
IrdinTo16: posts big blind $0.10
*** HOLE CARDS ***
Muhlen9: folds 
X-rayFeeling: folds 
Bocky59: calls $0.10
12311985: folds 
tokuch1_toua: folds 
IrdinTo16: checks 
*** FLOP *** [4h Ah Jh]
IrdinTo16: checks 
Bocky59: bets $0.24
IrdinTo16: folds 
Uncalled bet ($0.24) returned to Bocky59
Bocky59 collected $0.24 from pot
Bocky59: doesn't show hand 
*** SUMMARY ***
Total pot $0.25 | Rake $0.01 
Board [4h Ah Jh]
Seat 1: tokuch1_toua (small blind) folded before Flop
Seat 2: IrdinTo16 (big blind) folded on the Flop
Seat 3: Muhlen9 folded before Flop (didn't bet)
Seat 4: X-rayFeeling folded before Flop (didn't bet)
Seat 5: Bocky59 collected ($0.24)
Seat 6: 12311985 (button) folded before Flop (didn't bet)



PokerStars Hand #222946388555:  Hold'em No Limit ($0.05/$0.10 USD) - 2021/01/23 1:52:17 ET
Table 'Linzia' 6-max Seat #1 is the button
Seat 1: tokuch1_toua ($10.61 in chips) 
Seat 2: IrdinTo16 ($10 in chips) 
Seat 3: Muhlen9 ($10.89 in chips) 
Seat 4: X-rayFeeling ($10 in chips) 
Seat 5: Bocky59 ($12.17 in chips) 
Seat 6: 12311985 ($10 in chips) 
IrdinTo16: posts small blind $0.05
Muhlen9: posts big blind $0.10
*** HOLE CARDS ***
X-rayFeeling: folds 
Bocky59: folds 
12311985: folds 
tokuch1_toua: folds 
IrdinTo16: folds 
Uncalled bet ($0.05) returned to Muhlen9
Muhlen9 collected $0.10 from pot
Muhlen9: doesn't show hand 
*** SUMMARY ***
Total pot $0.10 | Rake $0 
Seat 1: tokuch1_toua (button) folded before Flop (didn't bet)
Seat 2: IrdinTo16 (small blind) folded before Flop
Seat 3: Muhlen9 (big blind) collected ($0.10)
Seat 4: X-rayFeeling folded before Flop (didn't bet)
Seat 5: Bocky59 folded before Flop (didn't bet)
Seat 6: 12311985 folded before Flop (didn't bet)



PokerStars Hand #222946390649:  Hold'em No Limit ($0.05/$0.10 USD) - 2021/01/23 1:52:26 ET
Table 'Linzia' 6-max Seat #2 is the button
Seat 1: tokuch1_toua ($10.61 in chips) 
Seat 2: IrdinTo16 ($10 in chips) 
Seat 3: Muhlen9 ($10.94 in chips) 
Seat 4: X-rayFeeling ($10 in chips) 
Seat 5: Bocky59 ($12.17 in chips) 
Seat 6: 12311985 ($10 in chips) 
Muhlen9: posts small blind $0.05
X-rayFeeling: posts big blind $0.10
*** HOLE CARDS ***
Bocky59: folds 
12311985: folds 
tokuch1_toua: folds 
IrdinTo16: raises $0.15 to $0.25
Muhlen9: folds 
X-rayFeeling: raises $0.65 to $0.90
IrdinTo16: folds 
Uncalled bet ($0.65) returned to X-rayFeeling
X-rayFeeling collected $0.55 from pot
X-rayFeeling: doesn't show hand 
*** SUMMARY ***
Total pot $0.55 | Rake $0 
Seat 1: tokuch1_toua folded before Flop (didn't bet)
Seat 2: IrdinTo16 (button) folded before Flop
Seat 3: Muhlen9 (small blind) folded before Flop
Seat 4: X-rayFeeling (big blind) collected ($0.55)
Seat 5: Bocky59 folded before Flop (didn't bet)
Seat 6: 12311985 folded before Flop (didn't bet)



PokerStars Hand #222946395310:  Hold'em No Limit ($0.05/$0.10 USD) - 2021/01/23 1:52:46 ET
Table 'Linzia' 6-max Seat #3 is the button
Seat 1: tokuch1_toua ($10.61 in chips) 
Seat 2: IrdinTo16 ($10 in chips) 
Seat 3: Muhlen9 ($10.89 in chips) 
Seat 4: X-rayFeeling ($10.30 in chips) 
Seat 5: Bocky59 ($12.17 in chips) 
Seat 6: 12311985 ($10 in chips) 
X-rayFeeling: posts small blind $0.05
Bocky59: posts big blind $0.10
*** HOLE CARDS ***
12311985: folds 
tokuch1_toua: folds 
IrdinTo16: raises $0.20 to $0.30
Muhlen9: folds 
X-rayFeeling: folds 
Bocky59: calls $0.20
*** FLOP *** [As 7h Js]
Bocky59: checks 
IrdinTo16: bets $0.50
Bocky59: folds 
Uncalled bet ($0.50) returned to IrdinTo16
IrdinTo16 collected $0.62 from pot
IrdinTo16: doesn't show hand 
*** SUMMARY ***
Total pot $0.65 | Rake $0.03 
Board [As 7h Js]
Seat 1: tokuch1_toua folded before Flop (didn't bet)
Seat 2: IrdinTo16 collected ($0.62)
Seat 3: Muhlen9 (button) folded before Flop (didn't bet)
Seat 4: X-rayFeeling (small blind) folded before Flop
Seat 5: Bocky59 (big blind) folded on the Flop
Seat 6: 12311985 folded before Flop (didn't bet)



PokerStars Hand #222946403567:  Hold'em No Limit ($0.05/$0.10 USD) - 2021/01/23 1:53:13 ET
Table 'Linzia' 6-max Seat #4 is the button
Seat 1: tokuch1_toua ($10.61 in chips) 
Seat 2: IrdinTo16 ($10.32 in chips) 
Seat 3: Muhlen9 ($10.89 in chips) 
Seat 4: X-rayFeeling ($10.25 in chips) 
Seat 5: Bocky59 ($11.87 in chips) 
Seat 6: 12311985 ($10 in chips) 
Bocky59: posts small blind $0.05
12311985: posts big blind $0.10
*** HOLE CARDS ***
tokuch1_toua: folds 
IrdinTo16: folds 
Muhlen9: folds 
X-rayFeeling: folds 
Bocky59: calls $0.05
12311985: raises $0.20 to $0.30
Bocky59: folds 
Uncalled bet ($0.20) returned to 12311985
12311985 collected $0.20 from pot
12311985: doesn't show hand 
*** SUMMARY ***
Total pot $0.20 | Rake $0 
Seat 1: tokuch1_toua folded before Flop (didn't bet)
Seat 2: IrdinTo16 folded before Flop (didn't bet)
Seat 3: Muhlen9 folded before Flop (didn't bet)
Seat 4: X-rayFeeling (button) folded before Flop (didn't bet)
Seat 5: Bocky59 (small blind) folded before Flop
Seat 6: 12311985 (big blind) collected ($0.20)



PokerStars Hand #222946407245:  Hold'em No Limit ($0.05/$0.10 USD) - 2021/01/23 1:53:29 ET
Table 'Linzia' 6-max Seat #5 is the button
Seat 1: tokuch1_toua ($10.61 in chips) 
Seat 2: IrdinTo16 ($10.32 in chips) 
Seat 3: Muhlen9 ($10.89 in chips) 
Seat 4: X-rayFeeling ($10.25 in chips) 
Seat 5: Bocky59 ($11.77 in chips) 
Seat 6: 12311985 ($10.10 in chips) 
12311985: posts small blind $0.05
tokuch1_toua: posts big blind $0.10
*** HOLE CARDS ***
IrdinTo16: folds 
Muhlen9: folds 
X-rayFeeling: folds 
Bocky59: raises $0.10 to $0.20
12311985: raises $0.70 to $0.90
tokuch1_toua: folds 
Bocky59: folds 
Uncalled bet ($0.70) returned to 12311985
12311985 collected $0.50 from pot
12311985: doesn't show hand 
*** SUMMARY ***
Total pot $0.50 | Rake $0 
Seat 1: tokuch1_toua (big blind) folded before Flop
Seat 2: IrdinTo16 folded before Flop (didn't bet)
Seat 3: Muhlen9 folded before Flop (didn't bet)
Seat 4: X-rayFeeling folded before Flop (didn't bet)
Seat 5: Bocky59 (button) folded before Flop
Seat 6: 12311985 (small blind) collected ($0.50)



PokerStars Hand #222946410849:  Hold'em No Limit ($0.05/$0.10 USD) - 2021/01/23 1:53:44 ET
Table 'Linzia' 6-max Seat #6 is the button
Seat 2: IrdinTo16 ($10.32 in chips) 
Seat 3: Muhlen9 ($10.89 in chips) 
Seat 4: X-rayFeeling ($10.25 in chips) 
Seat 5: Bocky59 ($11.57 in chips) 
Seat 6: 12311985 ($10.40 in chips) 
IrdinTo16: posts small blind $0.05
Muhlen9: posts big blind $0.10
*** HOLE CARDS ***
X-rayFeeling: folds 
Bocky59: folds 
12311985: raises $0.15 to $0.25
IrdinTo16: folds 
Muhlen9: calls $0.15
*** FLOP *** [9d Ad 5h]
Muhlen9: checks 
12311985: bets $0.37
Muhlen9: calls $0.37
*** TURN *** [9d Ad 5h] [Jh]
Muhlen9: checks 
12311985: bets $0.90
Muhlen9: calls $0.90
*** RIVER *** [9d Ad 5h Jh] [7c]
Muhlen9: checks 
12311985: checks 
*** SHOW DOWN ***
Muhlen9: shows [8c Ah] (a pair of Aces)
12311985: shows [5s As] (two pair, Aces and Fives)
12311985 collected $2.95 from pot
*** SUMMARY ***
Total pot $3.09 | Rake $0.14 
Board [9d Ad 5h Jh 7c]
Seat 2: IrdinTo16 (small blind) folded before Flop
Seat 3: Muhlen9 (big blind) showed [8c Ah] and lost with a pair of Aces
Seat 4: X-rayFeeling folded before Flop (didn't bet)
Seat 5: Bocky59 folded before Flop (didn't bet)
Seat 6: 12311985 (button) showed [5s As] and won ($2.95) with two pair, Aces and Fives



PokerStars Hand #222946421715:  Hold'em No Limit ($0.05/$0.10 USD) - 2021/01/23 1:54:31 ET
Table 'Linzia' 6-max Seat #2 is the button
Seat 2: IrdinTo16 ($10.27 in chips) 
Seat 3: Muhlen9 ($10 in chips) 
Seat 4: X-rayFeeling ($10.25 in chips) 
Seat 5: Bocky59 ($11.57 in chips) 
Seat 6: 12311985 ($11.83 in chips) 
Muhlen9: posts small blind $0.05
X-rayFeeling: posts big blind $0.10
tokuch1_toua: sits out 
*** HOLE CARDS ***
Bocky59: folds 
12311985: folds 
IrdinTo16: folds 
Muhlen9: folds 
Uncalled bet ($0.05) returned to X-rayFeeling
X-rayFeeling collected $0.10 from pot
X-rayFeeling: doesn't show hand 
*** SUMMARY ***
Total pot $0.10 | Rake $0 
Seat 2: IrdinTo16 (button) folded before Flop (didn't bet)
Seat 3: Muhlen9 (small blind) folded before Flop
Seat 4: X-rayFeeling (big blind) collected ($0.10)
Seat 5: Bocky59 folded before Flop (didn't bet)
Seat 6: 12311985 folded before Flop (didn't bet)



PokerStars Hand #222946426848:  Hold'em No Limit ($0.05/$0.10 USD) - 2021/01/23 1:54:53 ET
Table 'Linzia' 6-max Seat #3 is the button
Seat 2: IrdinTo16 ($10.27 in chips) 
Seat 3: Muhlen9 ($10 in chips) 
Seat 4: X-rayFeeling ($10.30 in chips) 
Seat 5: Bocky59 ($11.57 in chips) 
Seat 6: 12311985 ($11.83 in chips) 
X-rayFeeling: posts small blind $0.05
Bocky59: posts big blind $0.10
tokuch1_toua: sits out 
*** HOLE CARDS ***
12311985: folds 
IrdinTo16: folds 
Muhlen9: raises $0.15 to $0.25
X-rayFeeling: folds 
Bocky59: folds 
Uncalled bet ($0.15) returned to Muhlen9
Muhlen9 collected $0.25 from pot
Muhlen9: doesn't show hand 
*** SUMMARY ***
Total pot $0.25 | Rake $0 
Seat 2: IrdinTo16 folded before Flop (didn't bet)
Seat 3: Muhlen9 (button) collected ($0.25)
Seat 4: X-rayFeeling (small blind) folded before Flop
Seat 5: Bocky59 (big blind) folded before Flop
Seat 6: 12311985 folded before Flop (didn't bet)



PokerStars Hand #222946429625:  Hold'em No Limit ($0.05/$0.10 USD) - 2021/01/23 1:55:05 ET
Table 'Linzia' 6-max Seat #4 is the button
Seat 2: IrdinTo16 ($10.27 in chips) 
Seat 3: Muhlen9 ($10.15 in chips) 
Seat 4: X-rayFeeling ($10.25 in chips) 
Seat 5: Bocky59 ($11.47 in chips) 
Seat 6: 12311985 ($11.83 in chips) 
Bocky59: posts small blind $0.05
12311985: posts big blind $0.10
tokuch1_toua: sits out 
*** HOLE CARDS ***
IrdinTo16: folds 
Muhlen9: folds 
X-rayFeeling: folds 
Bocky59: calls $0.05
12311985: checks 
*** FLOP *** [Qc 8d Jh]
Bocky59: checks 
12311985: bets $0.19
Bocky59: calls $0.19
*** TURN *** [Qc 8d Jh] [Kc]
Bocky59: checks 
12311985: checks 
*** RIVER *** [Qc 8d Jh Kc] [5h]
Bocky59: checks 
12311985: bets $0.70
Bocky59: folds 
Uncalled bet ($0.70) returned to 12311985
12311985 collected $0.55 from pot
12311985: doesn't show hand 
*** SUMMARY ***
Total pot $0.58 | Rake $0.03 
Board [Qc 8d Jh Kc 5h]
Seat 2: IrdinTo16 folded before Flop (didn't bet)
Seat 3: Muhlen9 folded before Flop (didn't bet)
Seat 4: X-rayFeeling (button) folded before Flop (didn't bet)
Seat 5: Bocky59 (small blind) folded on the River
Seat 6: 12311985 (big blind) collected ($0.55)



PokerStars Hand #222946436423:  Hold'em No Limit ($0.05/$0.10 USD) - 2021/01/23 1:55:40 ET
Table 'Linzia' 6-max Seat #5 is the button
Seat 1: tokuch1_toua ($10.51 in chips) 
Seat 2: IrdinTo16 ($10.27 in chips) 
Seat 3: Muhlen9 ($10.15 in chips) 
Seat 4: X-rayFeeling ($10.25 in chips) 
Seat 5: Bocky59 ($11.18 in chips) 
Seat 6: 12311985 ($12.09 in chips) 
12311985: posts small blind $0.05
tokuch1_toua: posts big blind $0.10
*** HOLE CARDS ***
IrdinTo16: folds 
Muhlen9: folds 
X-rayFeeling: raises $0.20 to $0.30
Bocky59: folds 
12311985: folds 
tokuch1_toua: folds 
Uncalled bet ($0.20) returned to X-rayFeeling
X-rayFeeling collected $0.25 from pot
X-rayFeeling: doesn't show hand 
*** SUMMARY ***
Total pot $0.25 | Rake $0 
Seat 1: tokuch1_toua (big blind) folded before Flop
Seat 2: IrdinTo16 folded before Flop (didn't bet)
Seat 3: Muhlen9 folded before Flop (didn't bet)
Seat 4: X-rayFeeling collected ($0.25)
Seat 5: Bocky59 (button) folded before Flop (didn't bet)
Seat 6: 12311985 (small blind) folded before Flop



PokerStars Hand #222946438436:  Hold'em No Limit ($0.05/$0.10 USD) - 2021/01/23 1:55:50 ET
Table 'Linzia' 6-max Seat #6 is the button
Seat 1: tokuch1_toua ($10.41 in chips) 
Seat 2: IrdinTo16 ($10.27 in chips) 
Seat 3: Muhlen9 ($10.15 in chips) 
Seat 4: X-rayFeeling ($10.40 in chips) 
Seat 5: Bocky59 ($11.18 in chips) 
Seat 6: 12311985 ($12.04 in chips) 
tokuch1_toua: posts small blind $0.05
IrdinTo16: posts big blind $0.10
*** HOLE CARDS ***
Muhlen9: raises $0.15 to $0.25
X-rayFeeling: folds 
Bocky59: folds 
12311985: folds 
tokuch1_toua: folds 
IrdinTo16: folds 
Uncalled bet ($0.15) returned to Muhlen9
Muhlen9 collected $0.25 from pot
Muhlen9: doesn't show hand 
*** SUMMARY ***
Total pot $0.25 | Rake $0 
Seat 1: tokuch1_toua (small blind) folded before Flop
Seat 2: IrdinTo16 (big blind) folded before Flop
Seat 3: Muhlen9 collected ($0.25)
Seat 4: X-rayFeeling folded before Flop (didn't bet)
Seat 5: Bocky59 folded before Flop (didn't bet)
Seat 6: 12311985 (button) folded before Flop (didn't bet)



PokerStars Hand #222946440903:  Hold'em No Limit ($0.05/$0.10 USD) - 2021/01/23 1:56:03 ET
Table 'Linzia' 6-max Seat #1 is the button
Seat 1: tokuch1_toua ($10.36 in chips) 
Seat 2: IrdinTo16 ($10.17 in chips) 
Seat 3: Muhlen9 ($10.30 in chips) 
Seat 4: X-rayFeeling ($10.40 in chips) 
Seat 5: Bocky59 ($11.18 in chips) 
Seat 6: 12311985 ($12.04 in chips) 
IrdinTo16: posts small blind $0.05
Muhlen9: posts big blind $0.10
*** HOLE CARDS ***
X-rayFeeling: folds 
Bocky59: folds 
12311985: folds 
tokuch1_toua: folds 
IrdinTo16: raises $0.15 to $0.25
Muhlen9: folds 
Uncalled bet ($0.15) returned to IrdinTo16
IrdinTo16 collected $0.20 from pot
IrdinTo16: doesn't show hand 
*** SUMMARY ***
Total pot $0.20 | Rake $0 
Seat 1: tokuch1_toua (button) folded before Flop (didn't bet)
Seat 2: IrdinTo16 (small blind) collected ($0.20)
Seat 3: Muhlen9 (big blind) folded before Flop
Seat 4: X-rayFeeling folded before Flop (didn't bet)
Seat 5: Bocky59 folded before Flop (didn't bet)
Seat 6: 12311985 folded before Flop (didn't bet)



PokerStars Hand #222946443206:  Hold'em No Limit ($0.05/$0.10 USD) - 2021/01/23 1:56:15 ET
Table 'Linzia' 6-max Seat #2 is the button
Seat 1: tokuch1_toua ($10.36 in chips) 
Seat 2: IrdinTo16 ($10.27 in chips) 
Seat 3: Muhlen9 ($10.20 in chips) 
Seat 4: X-rayFeeling ($10.40 in chips) 
Seat 5: Bocky59 ($11.18 in chips) 
Seat 6: 12311985 ($12.04 in chips) 
Muhlen9: posts small blind $0.05
X-rayFeeling: posts big blind $0.10
*** HOLE CARDS ***
Bocky59: folds 
12311985: raises $0.15 to $0.25
tokuch1_toua: folds 
IrdinTo16: folds 
Muhlen9: folds 
X-rayFeeling: folds 
Uncalled bet ($0.15) returned to 12311985
12311985 collected $0.25 from pot
12311985: doesn't show hand 
*** SUMMARY ***
Total pot $0.25 | Rake $0 
Seat 1: tokuch1_toua folded before Flop (didn't bet)
Seat 2: IrdinTo16 (button) folded before Flop (didn't bet)
Seat 3: Muhlen9 (small blind) folded before Flop
Seat 4: X-rayFeeling (big blind) folded before Flop
Seat 5: Bocky59 folded before Flop (didn't bet)
Seat 6: 12311985 collected ($0.25)



PokerStars Hand #222946446857:  Hold'em No Limit ($0.05/$0.10 USD) - 2021/01/23 1:56:34 ET
Table 'Linzia' 6-max Seat #3 is the button
Seat 1: tokuch1_toua ($10.36 in chips) 
Seat 2: IrdinTo16 ($10.27 in chips) 
Seat 3: Muhlen9 ($10.15 in chips) 
Seat 4: X-rayFeeling ($10.30 in chips) 
Seat 5: Bocky59 ($11.18 in chips) 
Seat 6: 12311985 ($12.19 in chips) 
X-rayFeeling: posts small blind $0.05
Bocky59: posts big blind $0.10
*** HOLE CARDS ***
12311985: folds 
tokuch1_toua: folds 
IrdinTo16: folds 
Muhlen9: folds 
X-rayFeeling: folds 
Uncalled bet ($0.05) returned to Bocky59
Bocky59 collected $0.10 from pot
Bocky59: doesn't show hand 
*** SUMMARY ***
Total pot $0.10 | Rake $0 
Seat 1: tokuch1_toua folded before Flop (didn't bet)
Seat 2: IrdinTo16 folded before Flop (didn't bet)
Seat 3: Muhlen9 (button) folded before Flop (didn't bet)
Seat 4: X-rayFeeling (small blind) folded before Flop
Seat 5: Bocky59 (big blind) collected ($0.10)
Seat 6: 12311985 folded before Flop (didn't bet)



PokerStars Hand #222946449256:  Hold'em No Limit ($0.05/$0.10 USD) - 2021/01/23 1:56:46 ET
Table 'Linzia' 6-max Seat #4 is the button
Seat 1: tokuch1_toua ($10.36 in chips) 
Seat 2: IrdinTo16 ($10.27 in chips) 
Seat 3: Muhlen9 ($10.15 in chips) 
Seat 4: X-rayFeeling ($10.25 in chips) 
Seat 5: Bocky59 ($11.23 in chips) 
Seat 6: 12311985 ($12.19 in chips) 
Bocky59: posts small blind $0.05
12311985: posts big blind $0.10
*** HOLE CARDS ***
tokuch1_toua: folds 
IrdinTo16: folds 
Muhlen9: folds 
X-rayFeeling: folds 
Bocky59: raises $0.10 to $0.20
12311985: folds 
Uncalled bet ($0.10) returned to Bocky59
Bocky59 collected $0.20 from pot
Bocky59: doesn't show hand 
*** SUMMARY ***
Total pot $0.20 | Rake $0 
Seat 1: tokuch1_toua folded before Flop (didn't bet)
Seat 2: IrdinTo16 folded before Flop (didn't bet)
Seat 3: Muhlen9 folded before Flop (didn't bet)
Seat 4: X-rayFeeling (button) folded before Flop (didn't bet)
Seat 5: Bocky59 (small blind) collected ($0.20)
Seat 6: 12311985 (big blind) folded before Flop



PokerStars Hand #222946452050:  Hold'em No Limit ($0.05/$0.10 USD) - 2021/01/23 1:57:01 ET
Table 'Linzia' 6-max Seat #5 is the button
Seat 1: tokuch1_toua ($10.36 in chips) 
Seat 2: IrdinTo16 ($10.27 in chips) 
Seat 3: Muhlen9 ($10.15 in chips) 
Seat 4: X-rayFeeling ($10.25 in chips) 
Seat 5: Bocky59 ($11.33 in chips) 
Seat 6: 12311985 ($12.09 in chips) 
12311985: posts small blind $0.05
tokuch1_toua: posts big blind $0.10
*** HOLE CARDS ***
IrdinTo16: folds 
Muhlen9: folds 
X-rayFeeling: folds 
Bocky59: raises $0.10 to $0.20
12311985: folds 
tokuch1_toua: folds 
Uncalled bet ($0.10) returned to Bocky59
Bocky59 collected $0.25 from pot
Bocky59: doesn't show hand 
*** SUMMARY ***
Total pot $0.25 | Rake $0 
Seat 1: tokuch1_toua (big blind) folded before Flop
Seat 2: IrdinTo16 folded before Flop (didn't bet)
Seat 3: Muhlen9 folded before Flop (didn't bet)
Seat 4: X-rayFeeling folded before Flop (didn't bet)
Seat 5: Bocky59 (button) collected ($0.25)
Seat 6: 12311985 (small blind) folded before Flop



PokerStars Hand #222946454135:  Hold'em No Limit ($0.05/$0.10 USD) - 2021/01/23 1:57:12 ET
Table 'Linzia' 6-max Seat #6 is the button
Seat 1: tokuch1_toua ($10.26 in chips) 
Seat 2: IrdinTo16 ($10.27 in chips) 
Seat 3: Muhlen9 ($10.15 in chips) 
Seat 4: X-rayFeeling ($10.25 in chips) 
Seat 5: Bocky59 ($11.48 in chips) 
Seat 6: 12311985 ($12.04 in chips) 
tokuch1_toua: posts small blind $0.05
IrdinTo16: posts big blind $0.10
*** HOLE CARDS ***
Muhlen9: folds 
X-rayFeeling: folds 
Bocky59: folds 
12311985: raises $0.20 to $0.30
tokuch1_toua: folds 
IrdinTo16: folds 
Uncalled bet ($0.20) returned to 12311985
12311985 collected $0.25 from pot
12311985: doesn't show hand 
*** SUMMARY ***
Total pot $0.25 | Rake $0 
Seat 1: tokuch1_toua (small blind) folded before Flop
Seat 2: IrdinTo16 (big blind) folded before Flop
Seat 3: Muhlen9 folded before Flop (didn't bet)
Seat 4: X-rayFeeling folded before Flop (didn't bet)
Seat 5: Bocky59 folded before Flop (didn't bet)
Seat 6: 12311985 (button) collected ($0.25)



PokerStars Hand #222946456694:  Hold'em No Limit ($0.05/$0.10 USD) - 2021/01/23 1:57:25 ET
Table 'Linzia' 6-max Seat #1 is the button
Seat 1: tokuch1_toua ($10.21 in chips) 
Seat 2: IrdinTo16 ($10.17 in chips) 
Seat 3: Muhlen9 ($10.15 in chips) 
Seat 4: X-rayFeeling ($10.25 in chips) 
Seat 5: Bocky59 ($11.48 in chips) 
Seat 6: 12311985 ($12.19 in chips) 
IrdinTo16: posts small blind $0.05
Muhlen9: posts big blind $0.10
*** HOLE CARDS ***
X-rayFeeling: folds 
Bocky59: folds 
12311985: raises $0.15 to $0.25
tokuch1_toua: folds 
IrdinTo16: folds 
Muhlen9: folds 
Uncalled bet ($0.15) returned to 12311985
12311985 collected $0.25 from pot
12311985: doesn't show hand 
*** SUMMARY ***
Total pot $0.25 | Rake $0 
Seat 1: tokuch1_toua (button) folded before Flop (didn't bet)
Seat 2: IrdinTo16 (small blind) folded before Flop
Seat 3: Muhlen9 (big blind) folded before Flop
Seat 4: X-rayFeeling folded before Flop (didn't bet)
Seat 5: Bocky59 folded before Flop (didn't bet)
Seat 6: 12311985 collected ($0.25)



PokerStars Hand #222946458876:  Hold'em No Limit ($0.05/$0.10 USD) - 2021/01/23 1:57:37 ET
Table 'Linzia' 6-max Seat #2 is the button
Seat 1: tokuch1_toua ($10.21 in chips) 
Seat 2: IrdinTo16 ($10.12 in chips) 
Seat 3: Muhlen9 ($10.05 in chips) 
Seat 4: X-rayFeeling ($10.25 in chips) 
Seat 5: Bocky59 ($11.48 in chips) 
Seat 6: 12311985 ($12.34 in chips) 
Muhlen9: posts small blind $0.05
X-rayFeeling: posts big blind $0.10
*** HOLE CARDS ***
Bocky59: calls $0.10
12311985: raises $0.30 to $0.40
tokuch1_toua: folds 
IrdinTo16: folds 
Muhlen9: folds 
X-rayFeeling: folds 
Bocky59: calls $0.30
*** FLOP *** [Kd 6c Qd]
Bocky59: bets $0.10
12311985: calls $0.10
*** TURN *** [Kd 6c Qd] [8c]
Bocky59: bets $0.10
12311985: calls $0.10
*** RIVER *** [Kd 6c Qd 8c] [Tc]
Bocky59: bets $0.10
12311985: folds 
Uncalled bet ($0.10) returned to Bocky59
Bocky59 collected $1.29 from pot
Bocky59: doesn't show hand 
*** SUMMARY ***
Total pot $1.35 | Rake $0.06 
Board [Kd 6c Qd 8c Tc]
Seat 1: tokuch1_toua folded before Flop (didn't bet)
Seat 2: IrdinTo16 (button) folded before Flop (didn't bet)
Seat 3: Muhlen9 (small blind) folded before Flop
Seat 4: X-rayFeeling (big blind) folded before Flop
Seat 5: Bocky59 collected ($1.29)
Seat 6: 12311985 folded on the River



PokerStars Hand #222946466197:  Hold'em No Limit ($0.05/$0.10 USD) - 2021/01/23 1:58:14 ET
Table 'Linzia' 6-max Seat #3 is the button
Seat 1: tokuch1_toua ($10.21 in chips) 
Seat 2: IrdinTo16 ($10.12 in chips) 
Seat 3: Muhlen9 ($10 in chips) 
Seat 4: X-rayFeeling ($10.15 in chips) 
Seat 5: Bocky59 ($12.17 in chips) 
Seat 6: 12311985 ($11.74 in chips) 
X-rayFeeling: posts small blind $0.05
Bocky59: posts big blind $0.10
*** HOLE CARDS ***
12311985: folds 
tokuch1_toua: raises $0.20 to $0.30
IrdinTo16: folds 
Muhlen9: folds 
X-rayFeeling: folds 
Bocky59: folds 
Uncalled bet ($0.20) returned to tokuch1_toua
tokuch1_toua collected $0.25 from pot
tokuch1_toua: doesn't show hand 
*** SUMMARY ***
Total pot $0.25 | Rake $0 
Seat 1: tokuch1_toua collected ($0.25)
Seat 2: IrdinTo16 folded before Flop (didn't bet)
Seat 3: Muhlen9 (button) folded before Flop (didn't bet)
Seat 4: X-rayFeeling (small blind) folded before Flop
Seat 5: Bocky59 (big blind) folded before Flop
Seat 6: 12311985 folded before Flop (didn't bet)



PokerStars Hand #222946468533:  Hold'em No Limit ($0.05/$0.10 USD) - 2021/01/23 1:58:27 ET
Table 'Linzia' 6-max Seat #4 is the button
Seat 1: tokuch1_toua ($10.36 in chips) 
Seat 2: IrdinTo16 ($10.12 in chips) 
Seat 3: Muhlen9 ($10 in chips) 
Seat 4: X-rayFeeling ($10.10 in chips) 
Seat 5: Bocky59 ($12.07 in chips) 
Seat 6: 12311985 ($11.74 in chips) 
Bocky59: posts small blind $0.05
12311985: posts big blind $0.10
*** HOLE CARDS ***
tokuch1_toua: folds 
IrdinTo16: folds 
Muhlen9: folds 
X-rayFeeling: folds 
Bocky59: folds 
Uncalled bet ($0.05) returned to 12311985
12311985 collected $0.10 from pot
12311985: doesn't show hand 
*** SUMMARY ***
Total pot $0.10 | Rake $0 
Seat 1: tokuch1_toua folded before Flop (didn't bet)
Seat 2: IrdinTo16 folded before Flop (didn't bet)
Seat 3: Muhlen9 folded before Flop (didn't bet)
Seat 4: X-rayFeeling (button) folded before Flop (didn't bet)
Seat 5: Bocky59 (small blind) folded before Flop
Seat 6: 12311985 (big blind) collected ($0.10)



PokerStars Hand #222946470162:  Hold'em No Limit ($0.05/$0.10 USD) - 2021/01/23 1:58:35 ET
Table 'Linzia' 6-max Seat #5 is the button
Seat 1: tokuch1_toua ($10.36 in chips) 
Seat 2: IrdinTo16 ($10.12 in chips) 
Seat 3: Muhlen9 ($10 in chips) 
Seat 4: X-rayFeeling ($10.10 in chips) 
Seat 5: Bocky59 ($12.02 in chips) 
Seat 6: 12311985 ($11.79 in chips) 
12311985: posts small blind $0.05
tokuch1_toua: posts big blind $0.10
*** HOLE CARDS ***
IrdinTo16: folds 
Muhlen9: raises $0.15 to $0.25
X-rayFeeling: calls $0.25
Bocky59: folds 
12311985: folds 
tokuch1_toua: folds 
*** FLOP *** [7d Td 7h]
tokuch1_toua leaves the table
Muhlen9: bets $0.31
X-rayFeeling: calls $0.31
*** TURN *** [7d Td 7h] [8s]
Muhlen9: bets $0.81
X-rayFeeling: raises $1.70 to $2.51
Muhlen9: calls $1.70
*** RIVER *** [7d Td 7h 8s] [4c]
Muhlen9: checks 
X-rayFeeling: bets $5.41
Muhlen9: calls $5.41
*** SHOW DOWN ***
X-rayFeeling: shows [6d 5d] (a straight, Four to Eight)
Muhlen9: mucks hand 
X-rayFeeling collected $16.34 from pot
*** SUMMARY ***
Total pot $17.11 | Rake $0.77 
Board [7d Td 7h 8s 4c]
Seat 1: tokuch1_toua (big blind) folded before Flop
Seat 2: IrdinTo16 folded before Flop (didn't bet)
Seat 3: Muhlen9 mucked
Seat 4: X-rayFeeling showed [6d 5d] and won ($16.34) with a straight, Four to Eight
Seat 5: Bocky59 (button) folded before Flop (didn't bet)
Seat 6: 12311985 (small blind) folded before Flop



PokerStars Hand #222946478674:  Hold'em No Limit ($0.05/$0.10 USD) - 2021/01/23 1:59:19 ET
Table 'Linzia' 6-max Seat #6 is the button
Seat 2: IrdinTo16 ($10.12 in chips) 
Seat 3: Muhlen9 ($10 in chips) 
Seat 4: X-rayFeeling ($17.96 in chips) 
Seat 5: Bocky59 ($12.02 in chips) 
Seat 6: 12311985 ($11.74 in chips) 
IrdinTo16: posts small blind $0.05
Muhlen9: posts big blind $0.10
*** HOLE CARDS ***
X-rayFeeling: folds 
Bocky59: raises $0.10 to $0.20
12311985: folds 
IrdinTo16: calls $0.15
Muhlen9: folds 
*** FLOP *** [5d Kd 6s]
IrdinTo16: checks 
Bocky59: checks 
*** TURN *** [5d Kd 6s] [4c]
IrdinTo16: bets $0.31
Bocky59: calls $0.31
*** RIVER *** [5d Kd 6s 4c] [6d]
IrdinTo16: checks 
Bocky59: checks 
*** SHOW DOWN ***
IrdinTo16: shows [Qc Kh] (two pair, Kings and Sixes)
Bocky59: mucks hand 
IrdinTo16 collected $1.07 from pot
*** SUMMARY ***
Total pot $1.12 | Rake $0.05 
Board [5d Kd 6s 4c 6d]
Seat 2: IrdinTo16 (small blind) showed [Qc Kh] and won ($1.07) with two pair, Kings and Sixes
Seat 3: Muhlen9 (big blind) folded before Flop
Seat 4: X-rayFeeling folded before Flop (didn't bet)
Seat 5: Bocky59 mucked
Seat 6: 12311985 (button) folded before Flop (didn't bet)



PokerStars Hand #222946483266:  Hold'em No Limit ($0.05/$0.10 USD) - 2021/01/23 1:59:42 ET
Table 'Linzia' 6-max Seat #2 is the button
Seat 2: IrdinTo16 ($10.68 in chips) 
Seat 3: Muhlen9 ($10 in chips) 
Seat 4: X-rayFeeling ($17.96 in chips) 
Seat 5: Bocky59 ($11.51 in chips) 
Seat 6: 12311985 ($11.74 in chips) 
Muhlen9: posts small blind $0.05
X-rayFeeling: posts big blind $0.10
*** HOLE CARDS ***
Bocky59: folds 
12311985: folds 
IrdinTo16: folds 
Muhlen9: raises $0.20 to $0.30
X-rayFeeling: raises $0.60 to $0.90
Muhlen9: folds 
Uncalled bet ($0.60) returned to X-rayFeeling
X-rayFeeling collected $0.60 from pot
X-rayFeeling: doesn't show hand 
*** SUMMARY ***
Total pot $0.60 | Rake $0 
Seat 2: IrdinTo16 (button) folded before Flop (didn't bet)
Seat 3: Muhlen9 (small blind) folded before Flop
Seat 4: X-rayFeeling (big blind) collected ($0.60)
Seat 5: Bocky59 folded before Flop (didn't bet)
Seat 6: 12311985 folded before Flop (didn't bet)



PokerStars Hand #222946487288:  Hold'em No Limit ($0.05/$0.10 USD) - 2021/01/23 2:00:03 ET
Table 'Linzia' 6-max Seat #3 is the button
Seat 2: IrdinTo16 ($10.68 in chips) 
Seat 3: Muhlen9 ($10 in chips) 
Seat 4: X-rayFeeling ($18.26 in chips) 
Seat 5: Bocky59 ($11.51 in chips) 
Seat 6: 12311985 ($11.74 in chips) 
X-rayFeeling: posts small blind $0.05
Bocky59: posts big blind $0.10
*** HOLE CARDS ***
12311985: folds 
IrdinTo16: raises $0.20 to $0.30
Muhlen9: folds 
X-rayFeeling: folds 
Bocky59: calls $0.20
*** FLOP *** [7s 9d Th]
Bocky59: bets $0.31
IrdinTo16: folds 
Uncalled bet ($0.31) returned to Bocky59
Bocky59 collected $0.62 from pot
Bocky59: doesn't show hand 
*** SUMMARY ***
Total pot $0.65 | Rake $0.03 
Board [7s 9d Th]
Seat 2: IrdinTo16 folded on the Flop
Seat 3: Muhlen9 (button) folded before Flop (didn't bet)
Seat 4: X-rayFeeling (small blind) folded before Flop
Seat 5: Bocky59 (big blind) collected ($0.62)
Seat 6: 12311985 folded before Flop (didn't bet)



PokerStars Hand #222946492572:  Hold'em No Limit ($0.05/$0.10 USD) - 2021/01/23 2:00:28 ET
Table 'Linzia' 6-max Seat #4 is the button
Seat 2: IrdinTo16 ($10.38 in chips) 
Seat 3: Muhlen9 ($10 in chips) 
Seat 4: X-rayFeeling ($18.21 in chips) 
Seat 5: Bocky59 ($11.83 in chips) 
Seat 6: 12311985 ($11.74 in chips) 
Bocky59: posts small blind $0.05
12311985: posts big blind $0.10
*** HOLE CARDS ***
IrdinTo16: folds 
Muhlen9: folds 
X-rayFeeling: folds 
Bocky59: calls $0.05
12311985: checks 
*** FLOP *** [4d Jd 7c]
Bocky59: checks 
12311985: checks 
*** TURN *** [4d Jd 7c] [7s]
Bocky59: checks 
PEI Rooster joins the table at seat #1 
12311985: checks 
*** RIVER *** [4d Jd 7c 7s] [8c]
Bocky59: checks 
12311985: checks 
*** SHOW DOWN ***
Bocky59: shows [Ks 6h] (a pair of Sevens)
12311985: mucks hand 
Bocky59 collected $0.19 from pot
*** SUMMARY ***
Total pot $0.20 | Rake $0.01 
Board [4d Jd 7c 7s 8c]
Seat 2: IrdinTo16 folded before Flop (didn't bet)
Seat 3: Muhlen9 folded before Flop (didn't bet)
Seat 4: X-rayFeeling (button) folded before Flop (didn't bet)
Seat 5: Bocky59 (small blind) showed [Ks 6h] and won ($0.19) with a pair of Sevens
Seat 6: 12311985 (big blind) mucked



PokerStars Hand #222946499893:  Hold'em No Limit ($0.05/$0.10 USD) - 2021/01/23 2:01:00 ET
Table 'Linzia' 6-max Seat #5 is the button
Seat 1: PEI Rooster ($8 in chips) 
Seat 2: IrdinTo16 ($10.38 in chips) 
Seat 3: Muhlen9 ($10 in chips) 
Seat 4: X-rayFeeling ($18.21 in chips) 
Seat 5: Bocky59 ($11.92 in chips) 
Seat 6: 12311985 ($11.64 in chips) 
12311985: posts small blind $0.05
PEI Rooster: posts big blind $0.10
*** HOLE CARDS ***
IrdinTo16: folds 
Muhlen9: folds 
X-rayFeeling: folds 
Bocky59: folds 
12311985: folds 
Uncalled bet ($0.05) returned to PEI Rooster
PEI Rooster collected $0.10 from pot
PEI Rooster: doesn't show hand 
*** SUMMARY ***
Total pot $0.10 | Rake $0 
Seat 1: PEI Rooster (big blind) collected ($0.10)
Seat 2: IrdinTo16 folded before Flop (didn't bet)
Seat 3: Muhlen9 folded before Flop (didn't bet)
Seat 4: X-rayFeeling folded before Flop (didn't bet)
Seat 5: Bocky59 (button) folded before Flop (didn't bet)
Seat 6: 12311985 (small blind) folded before Flop



PokerStars Hand #222946502849:  Hold'em No Limit ($0.05/$0.10 USD) - 2021/01/23 2:01:13 ET
Table 'Linzia' 6-max Seat #6 is the button
Seat 1: PEI Rooster ($8.05 in chips) 
Seat 2: IrdinTo16 ($10.38 in chips) 
Seat 3: Muhlen9 ($10 in chips) 
Seat 4: X-rayFeeling ($18.21 in chips) 
Seat 5: Bocky59 ($11.92 in chips) 
Seat 6: 12311985 ($11.59 in chips) 
PEI Rooster: posts small blind $0.05
IrdinTo16: posts big blind $0.10
*** HOLE CARDS ***
Muhlen9: raises $0.15 to $0.25
X-rayFeeling: folds 
Bocky59: calls $0.25
12311985: folds 
PEI Rooster: folds 
IrdinTo16: raises $0.95 to $1.20
Muhlen9: folds 
Bocky59: folds 
Uncalled bet ($0.95) returned to IrdinTo16
IrdinTo16 collected $0.80 from pot
IrdinTo16: doesn't show hand 
*** SUMMARY ***
Total pot $0.80 | Rake $0 
Seat 1: PEI Rooster (small blind) folded before Flop
Seat 2: IrdinTo16 (big blind) collected ($0.80)
Seat 3: Muhlen9 folded before Flop
Seat 4: X-rayFeeling folded before Flop (didn't bet)
Seat 5: Bocky59 folded before Flop
Seat 6: 12311985 (button) folded before Flop (didn't bet)



PokerStars Hand #222946507089:  Hold'em No Limit ($0.05/$0.10 USD) - 2021/01/23 2:01:32 ET
Table 'Linzia' 6-max Seat #1 is the button
Seat 1: PEI Rooster ($8 in chips) 
Seat 2: IrdinTo16 ($10.93 in chips) 
Seat 3: Muhlen9 ($10 in chips) 
Seat 4: X-rayFeeling ($18.21 in chips) 
Seat 5: Bocky59 ($11.67 in chips) 
Seat 6: 12311985 ($11.59 in chips) 
IrdinTo16: posts small blind $0.05
Muhlen9: posts big blind $0.10
*** HOLE CARDS ***
X-rayFeeling: raises $0.20 to $0.30
Bocky59: folds 
12311985: raises $0.60 to $0.90
PEI Rooster: calls $0.90
IrdinTo16: folds 
Muhlen9: folds 
X-rayFeeling: folds 
*** FLOP *** [9d 7h 3c]
12311985: checks 
PEI Rooster: checks 
*** TURN *** [9d 7h 3c] [7d]
12311985: checks 
PEI Rooster: bets $1.08
12311985: folds 
Uncalled bet ($1.08) returned to PEI Rooster
PEI Rooster collected $2.15 from pot
PEI Rooster: doesn't show hand 
*** SUMMARY ***
Total pot $2.25 | Rake $0.10 
Board [9d 7h 3c 7d]
Seat 1: PEI Rooster (button) collected ($2.15)
Seat 2: IrdinTo16 (small blind) folded before Flop
Seat 3: Muhlen9 (big blind) folded before Flop
Seat 4: X-rayFeeling folded before Flop
Seat 5: Bocky59 folded before Flop (didn't bet)
Seat 6: 12311985 folded on the Turn



PokerStars Hand #222946518019:  Hold'em No Limit ($0.05/$0.10 USD) - 2021/01/23 2:02:19 ET
Table 'Linzia' 6-max Seat #2 is the button
Seat 1: PEI Rooster ($9.25 in chips) 
Seat 2: IrdinTo16 ($10.88 in chips) 
Seat 3: Muhlen9 ($10 in chips) 
Seat 4: X-rayFeeling ($17.91 in chips) 
Seat 5: Bocky59 ($11.67 in chips) 
Seat 6: 12311985 ($10.69 in chips) 
Muhlen9: posts small blind $0.05
X-rayFeeling: posts big blind $0.10
*** HOLE CARDS ***
Bocky59: folds 
12311985: raises $0.15 to $0.25
PEI Rooster: folds 
IrdinTo16: folds 
Muhlen9: folds 
X-rayFeeling: folds 
Uncalled bet ($0.15) returned to 12311985
12311985 collected $0.25 from pot
12311985: doesn't show hand 
*** SUMMARY ***
Total pot $0.25 | Rake $0 
Seat 1: PEI Rooster folded before Flop (didn't bet)
Seat 2: IrdinTo16 (button) folded before Flop (didn't bet)
Seat 3: Muhlen9 (small blind) folded before Flop
Seat 4: X-rayFeeling (big blind) folded before Flop
Seat 5: Bocky59 folded before Flop (didn't bet)
Seat 6: 12311985 collected ($0.25)



PokerStars Hand #222946522570:  Hold'em No Limit ($0.05/$0.10 USD) - 2021/01/23 2:02:39 ET
Table 'Linzia' 6-max Seat #3 is the button
Seat 1: PEI Rooster ($9.25 in chips) 
Seat 2: IrdinTo16 ($10.88 in chips) 
Seat 3: Muhlen9 ($10 in chips) 
Seat 4: X-rayFeeling ($17.81 in chips) 
Seat 5: Bocky59 ($11.67 in chips) 
Seat 6: 12311985 ($10.84 in chips) 
X-rayFeeling: posts small blind $0.05
Bocky59: posts big blind $0.10
*** HOLE CARDS ***
12311985: folds 
PEI Rooster: folds 
IrdinTo16: folds 
Muhlen9: folds 
X-rayFeeling: folds 
Uncalled bet ($0.05) returned to Bocky59
Bocky59 collected $0.10 from pot
Bocky59: doesn't show hand 
*** SUMMARY ***
Total pot $0.10 | Rake $0 
Seat 1: PEI Rooster folded before Flop (didn't bet)
Seat 2: IrdinTo16 folded before Flop (didn't bet)
Seat 3: Muhlen9 (button) folded before Flop (didn't bet)
Seat 4: X-rayFeeling (small blind) folded before Flop
Seat 5: Bocky59 (big blind) collected ($0.10)
Seat 6: 12311985 folded before Flop (didn't bet)



PokerStars Hand #222946526545:  Hold'em No Limit ($0.05/$0.10 USD) - 2021/01/23 2:02:56 ET
Table 'Linzia' 6-max Seat #4 is the button
Seat 1: PEI Rooster ($9.25 in chips) 
Seat 2: IrdinTo16 ($10.88 in chips) 
Seat 3: Muhlen9 ($10 in chips) 
Seat 4: X-rayFeeling ($17.76 in chips) 
Seat 5: Bocky59 ($11.72 in chips) 
Seat 6: 12311985 ($10.84 in chips) 
Bocky59: posts small blind $0.05
12311985: posts big blind $0.10
*** HOLE CARDS ***
PEI Rooster: folds 
IrdinTo16: folds 
Muhlen9: folds 
X-rayFeeling: raises $0.15 to $0.25
Bocky59: calls $0.20
12311985: folds 
*** FLOP *** [Ac 5d 7s]
Bocky59: bets $0.57
X-rayFeeling: calls $0.57
*** TURN *** [Ac 5d 7s] [4h]
Bocky59: checks 
X-rayFeeling: bets $1
Bocky59: folds 
Uncalled bet ($1) returned to X-rayFeeling
X-rayFeeling collected $1.66 from pot
X-rayFeeling: doesn't show hand 
*** SUMMARY ***
Total pot $1.74 | Rake $0.08 
Board [Ac 5d 7s 4h]
Seat 1: PEI Rooster folded before Flop (didn't bet)
Seat 2: IrdinTo16 folded before Flop (didn't bet)
Seat 3: Muhlen9 folded before Flop (didn't bet)
Seat 4: X-rayFeeling (button) collected ($1.66)
Seat 5: Bocky59 (small blind) folded on the Turn
Seat 6: 12311985 (big blind) folded before Flop



PokerStars Hand #222946541732:  Hold'em No Limit ($0.05/$0.10 USD) - 2021/01/23 2:03:26 ET
Table 'Linzia' 6-max Seat #5 is the button
Seat 1: PEI Rooster ($9.25 in chips) 
Seat 2: IrdinTo16 ($10.88 in chips) 
Seat 3: Muhlen9 ($10 in chips) 
Seat 4: X-rayFeeling ($18.60 in chips) 
Seat 5: Bocky59 ($10.90 in chips) 
Seat 6: 12311985 ($10.74 in chips) 
12311985: posts small blind $0.05
PEI Rooster: posts big blind $0.10
*** HOLE CARDS ***
IrdinTo16: folds 
Muhlen9: folds 
X-rayFeeling: folds 
Bocky59: calls $0.10
12311985: folds 
PEI Rooster: checks 
*** FLOP *** [5h Jh Jc]
PEI Rooster: checks 
Bocky59: checks 
*** TURN *** [5h Jh Jc] [7h]
PEI Rooster: bets $0.12
Bocky59: calls $0.12
*** RIVER *** [5h Jh Jc 7h] [Kd]
PEI Rooster: checks 
Bocky59: bets $0.47
PEI Rooster: folds 
Uncalled bet ($0.47) returned to Bocky59
Bocky59 collected $0.47 from pot
Bocky59: doesn't show hand 
*** SUMMARY ***
Total pot $0.49 | Rake $0.02 
Board [5h Jh Jc 7h Kd]
Seat 1: PEI Rooster (big blind) folded on the River
Seat 2: IrdinTo16 folded before Flop (didn't bet)
Seat 3: Muhlen9 folded before Flop (didn't bet)
Seat 4: X-rayFeeling folded before Flop (didn't bet)
Seat 5: Bocky59 (button) collected ($0.47)
Seat 6: 12311985 (small blind) folded before Flop



PokerStars Hand #222946548490:  Hold'em No Limit ($0.05/$0.10 USD) - 2021/01/23 2:03:55 ET
Table 'Linzia' 6-max Seat #6 is the button
Seat 1: PEI Rooster ($9.03 in chips) 
Seat 2: IrdinTo16 ($10.88 in chips) 
Seat 3: Muhlen9 ($10 in chips) 
Seat 4: X-rayFeeling ($18.60 in chips) 
Seat 5: Bocky59 ($11.15 in chips) 
Seat 6: 12311985 ($10.69 in chips) 
PEI Rooster: posts small blind $0.05
IrdinTo16: posts big blind $0.10
*** HOLE CARDS ***
Muhlen9: raises $0.15 to $0.25
X-rayFeeling: folds 
Bocky59: calls $0.25
12311985: folds 
PEI Rooster: folds 
IrdinTo16: folds 
*** FLOP *** [Qc 6h Kh]
Muhlen9: bets $0.31
Bocky59: calls $0.31
*** TURN *** [Qc 6h Kh] [3s]
Muhlen9: bets $0.81
Bocky59: calls $0.81
*** RIVER *** [Qc 6h Kh 3s] [6s]
Muhlen9: checks 
Bocky59: bets $1.38
Muhlen9: calls $1.38
*** SHOW DOWN ***
Bocky59: shows [9c Kc] (two pair, Kings and Sixes)
Muhlen9: mucks hand 
Bocky59 collected $5.40 from pot
*** SUMMARY ***
Total pot $5.65 | Rake $0.25 
Board [Qc 6h Kh 3s 6s]
Seat 1: PEI Rooster (small blind) folded before Flop
Seat 2: IrdinTo16 (big blind) folded before Flop
Seat 3: Muhlen9 mucked
Seat 4: X-rayFeeling folded before Flop (didn't bet)
Seat 5: Bocky59 showed [9c Kc] and won ($5.40) with two pair, Kings and Sixes
Seat 6: 12311985 (button) folded before Flop (didn't bet)



PokerStars Hand #222946555577:  Hold'em No Limit ($0.05/$0.10 USD) - 2021/01/23 2:04:25 ET
Table 'Linzia' 6-max Seat #1 is the button
Seat 1: PEI Rooster ($8.98 in chips) 
Seat 2: IrdinTo16 ($10.78 in chips) 
Seat 3: Muhlen9 ($10 in chips) 
Seat 4: X-rayFeeling ($18.60 in chips) 
Seat 5: Bocky59 ($13.80 in chips) 
Seat 6: 12311985 ($10.69 in chips) 
IrdinTo16: posts small blind $0.05
Muhlen9: posts big blind $0.10
*** HOLE CARDS ***
X-rayFeeling: folds 
Bocky59: folds 
12311985: folds 
PEI Rooster: calls $0.10
IrdinTo16: calls $0.05
Muhlen9: checks 
*** FLOP *** [Jh 7d 2c]
IrdinTo16: checks 
Muhlen9: checks 
PEI Rooster: bets $0.15
IrdinTo16: folds 
Muhlen9: folds 
Uncalled bet ($0.15) returned to PEI Rooster
PEI Rooster collected $0.29 from pot
PEI Rooster: doesn't show hand 
*** SUMMARY ***
Total pot $0.30 | Rake $0.01 
Board [Jh 7d 2c]
Seat 1: PEI Rooster (button) collected ($0.29)
Seat 2: IrdinTo16 (small blind) folded on the Flop
Seat 3: Muhlen9 (big blind) folded on the Flop
Seat 4: X-rayFeeling folded before Flop (didn't bet)
Seat 5: Bocky59 folded before Flop (didn't bet)
Seat 6: 12311985 folded before Flop (didn't bet)



PokerStars Hand #222946563082:  Hold'em No Limit ($0.05/$0.10 USD) - 2021/01/23 2:04:57 ET
Table 'Linzia' 6-max Seat #2 is the button
Seat 1: PEI Rooster ($9.17 in chips) 
Seat 2: IrdinTo16 ($10.68 in chips) 
Seat 3: Muhlen9 ($10 in chips) 
Seat 4: X-rayFeeling ($18.60 in chips) 
Seat 5: Bocky59 ($13.80 in chips) 
Seat 6: 12311985 ($10.69 in chips) 
Muhlen9: posts small blind $0.05
X-rayFeeling: posts big blind $0.10
*** HOLE CARDS ***
Bocky59: calls $0.10
12311985: folds 
PEI Rooster: folds 
IrdinTo16: folds 
Muhlen9: folds 
X-rayFeeling: checks 
*** FLOP *** [Qh 5d Jd]
X-rayFeeling: checks 
Bocky59: checks 
*** TURN *** [Qh 5d Jd] [Qs]
X-rayFeeling: checks 
Bocky59: bets $0.10
X-rayFeeling: folds 
Uncalled bet ($0.10) returned to Bocky59
Bocky59 collected $0.24 from pot
Bocky59: doesn't show hand 
*** SUMMARY ***
Total pot $0.25 | Rake $0.01 
Board [Qh 5d Jd Qs]
Seat 1: PEI Rooster folded before Flop (didn't bet)
Seat 2: IrdinTo16 (button) folded before Flop (didn't bet)
Seat 3: Muhlen9 (small blind) folded before Flop
Seat 4: X-rayFeeling (big blind) folded on the Turn
Seat 5: Bocky59 collected ($0.24)
Seat 6: 12311985 folded before Flop (didn't bet)



PokerStars Hand #222946569647:  Hold'em No Limit ($0.05/$0.10 USD) - 2021/01/23 2:05:25 ET
Table 'Linzia' 6-max Seat #3 is the button
Seat 1: PEI Rooster ($9.17 in chips) 
Seat 2: IrdinTo16 ($10.68 in chips) 
Seat 3: Muhlen9 ($10 in chips) 
Seat 4: X-rayFeeling ($18.50 in chips) 
Seat 5: Bocky59 ($13.94 in chips) 
Seat 6: 12311985 ($10.69 in chips) 
X-rayFeeling: posts small blind $0.05
Bocky59: posts big blind $0.10
*** HOLE CARDS ***
12311985: raises $0.15 to $0.25
PEI Rooster: calls $0.25
IrdinTo16: folds 
Muhlen9: raises $1.05 to $1.30
X-rayFeeling: folds 
Bocky59: folds 
12311985: folds 
PEI Rooster: calls $1.05
*** FLOP *** [Jc 3c 4c]
PEI Rooster: checks 
Muhlen9: checks 
*** TURN *** [Jc 3c 4c] [Kh]
PEI Rooster: bets $1
Muhlen9: folds 
Uncalled bet ($1) returned to PEI Rooster
PEI Rooster collected $2.86 from pot
PEI Rooster: doesn't show hand 
*** SUMMARY ***
Total pot $3 | Rake $0.14 
Board [Jc 3c 4c Kh]
Seat 1: PEI Rooster collected ($2.86)
Seat 2: IrdinTo16 folded before Flop (didn't bet)
Seat 3: Muhlen9 (button) folded on the Turn
Seat 4: X-rayFeeling (small blind) folded before Flop
Seat 5: Bocky59 (big blind) folded before Flop
Seat 6: 12311985 folded before Flop



PokerStars Hand #222946579596:  Hold'em No Limit ($0.05/$0.10 USD) - 2021/01/23 2:06:07 ET
Table 'Linzia' 6-max Seat #4 is the button
Seat 1: PEI Rooster ($10.73 in chips) 
Seat 2: IrdinTo16 ($10.68 in chips) 
Seat 3: Muhlen9 ($10 in chips) 
Seat 4: X-rayFeeling ($18.45 in chips) 
Seat 5: Bocky59 ($13.84 in chips) 
Seat 6: 12311985 ($10.44 in chips) 
Bocky59: posts small blind $0.05
12311985: posts big blind $0.10
*** HOLE CARDS ***
PEI Rooster: raises $0.20 to $0.30
IrdinTo16: folds 
Muhlen9: folds 
X-rayFeeling: folds 
Bocky59: folds 
12311985: folds 
Uncalled bet ($0.20) returned to PEI Rooster
Bocky59 leaves the table
PEI Rooster collected $0.25 from pot
PEI Rooster: doesn't show hand 
*** SUMMARY ***
Total pot $0.25 | Rake $0 
Seat 1: PEI Rooster collected ($0.25)
Seat 2: IrdinTo16 folded before Flop (didn't bet)
Seat 3: Muhlen9 folded before Flop (didn't bet)
Seat 4: X-rayFeeling (button) folded before Flop (didn't bet)
Seat 5: Bocky59 (small blind) folded before Flop
Seat 6: 12311985 (big blind) folded before Flop



PokerStars Hand #222946582044:  Hold'em No Limit ($0.05/$0.10 USD) - 2021/01/23 2:06:18 ET
Table 'Linzia' 6-max Seat #6 is the button
Seat 1: PEI Rooster ($10.88 in chips) 
Seat 2: IrdinTo16 ($10.68 in chips) 
Seat 3: Muhlen9 ($10 in chips) 
Seat 4: X-rayFeeling ($18.45 in chips) 
Seat 6: 12311985 ($10.34 in chips) 
PEI Rooster: posts small blind $0.05
IrdinTo16: posts big blind $0.10
*** HOLE CARDS ***
Muhlen9: folds 
X-rayFeeling: folds 
12311985: raises $0.20 to $0.30
PEI Rooster: calls $0.25
IrdinTo16: folds 
*** FLOP *** [5h Kd 2s]
PEI Rooster: bets $0.34
12311985: calls $0.34
*** TURN *** [5h Kd 2s] [Jh]
ALPHAmax99 joins the table at seat #5 
PEI Rooster: bets $0.50
12311985: folds 
Uncalled bet ($0.50) returned to PEI Rooster
PEI Rooster collected $1.32 from pot
PEI Rooster: doesn't show hand 
*** SUMMARY ***
Total pot $1.38 | Rake $0.06 
Board [5h Kd 2s Jh]
Seat 1: PEI Rooster (small blind) collected ($1.32)
Seat 2: IrdinTo16 (big blind) folded before Flop
Seat 3: Muhlen9 folded before Flop (didn't bet)
Seat 4: X-rayFeeling folded before Flop (didn't bet)
Seat 6: 12311985 (button) folded on the Turn



PokerStars Hand #222946588986:  Hold'em No Limit ($0.05/$0.10 USD) - 2021/01/23 2:06:47 ET
Table 'Linzia' 6-max Seat #1 is the button
Seat 1: PEI Rooster ($11.56 in chips) 
Seat 2: IrdinTo16 ($10.58 in chips) 
Seat 3: Muhlen9 ($10 in chips) 
Seat 4: X-rayFeeling ($18.45 in chips) 
Seat 6: 12311985 ($10 in chips) 
IrdinTo16: posts small blind $0.05
Muhlen9: posts big blind $0.10
ALPHAmax99: sits out 
*** HOLE CARDS ***
X-rayFeeling: folds 
12311985: folds 
PEI Rooster: raises $0.20 to $0.30
IrdinTo16: folds 
Muhlen9: folds 
Uncalled bet ($0.20) returned to PEI Rooster
PEI Rooster collected $0.25 from pot
PEI Rooster: doesn't show hand 
*** SUMMARY ***
Total pot $0.25 | Rake $0 
Seat 1: PEI Rooster (button) collected ($0.25)
Seat 2: IrdinTo16 (small blind) folded before Flop
Seat 3: Muhlen9 (big blind) folded before Flop
Seat 4: X-rayFeeling folded before Flop (didn't bet)
Seat 6: 12311985 folded before Flop (didn't bet)



PokerStars Hand #222946591387:  Hold'em No Limit ($0.05/$0.10 USD) - 2021/01/23 2:06:57 ET
Table 'Linzia' 6-max Seat #2 is the button
Seat 1: PEI Rooster ($11.71 in chips) 
Seat 2: IrdinTo16 ($10.53 in chips) 
Seat 3: Muhlen9 ($10 in chips) 
Seat 4: X-rayFeeling ($18.45 in chips) 
Seat 6: 12311985 ($10 in chips) 
Muhlen9: posts small blind $0.05
X-rayFeeling: posts big blind $0.10
ALPHAmax99: sits out 
*** HOLE CARDS ***
12311985: folds 
PEI Rooster: raises $0.20 to $0.30
IrdinTo16: folds 
Muhlen9: folds 
X-rayFeeling: folds 
Uncalled bet ($0.20) returned to PEI Rooster
PEI Rooster collected $0.25 from pot
PEI Rooster: doesn't show hand 
*** SUMMARY ***
Total pot $0.25 | Rake $0 
Seat 1: PEI Rooster collected ($0.25)
Seat 2: IrdinTo16 (button) folded before Flop (didn't bet)
Seat 3: Muhlen9 (small blind) folded before Flop
Seat 4: X-rayFeeling (big blind) folded before Flop
Seat 6: 12311985 folded before Flop (didn't bet)



PokerStars Hand #222946593970:  Hold'em No Limit ($0.05/$0.10 USD) - 2021/01/23 2:07:08 ET
Table 'Linzia' 6-max Seat #3 is the button
Seat 1: PEI Rooster ($11.86 in chips) 
Seat 2: IrdinTo16 ($10.53 in chips) 
Seat 3: Muhlen9 ($10 in chips) 
Seat 4: X-rayFeeling ($18.35 in chips) 
Seat 5: ALPHAmax99 ($7.35 in chips) 
Seat 6: 12311985 ($10 in chips) 
X-rayFeeling: posts small blind $0.05
ALPHAmax99: posts big blind $0.10
*** HOLE CARDS ***
12311985: folds 
PEI Rooster: calls $0.10
IrdinTo16: folds 
Muhlen9: folds 
X-rayFeeling: folds 
ALPHAmax99: checks 
*** FLOP *** [7s 4s Kh]
ALPHAmax99: checks 
PEI Rooster: checks 
*** TURN *** [7s 4s Kh] [5h]
ALPHAmax99: checks 
PEI Rooster: bets $0.12
ALPHAmax99: calls $0.12
*** RIVER *** [7s 4s Kh 5h] [9s]
ALPHAmax99: checks 
PEI Rooster: bets $0.40
ALPHAmax99: folds 
Uncalled bet ($0.40) returned to PEI Rooster
PEI Rooster collected $0.47 from pot
PEI Rooster: doesn't show hand 
*** SUMMARY ***
Total pot $0.49 | Rake $0.02 
Board [7s 4s Kh 5h 9s]
Seat 1: PEI Rooster collected ($0.47)
Seat 2: IrdinTo16 folded before Flop (didn't bet)
Seat 3: Muhlen9 (button) folded before Flop (didn't bet)
Seat 4: X-rayFeeling (small blind) folded before Flop
Seat 5: ALPHAmax99 (big blind) folded on the River
Seat 6: 12311985 folded before Flop (didn't bet)



PokerStars Hand #222946606625:  Hold'em No Limit ($0.05/$0.10 USD) - 2021/01/23 2:08:02 ET
Table 'Linzia' 6-max Seat #4 is the button
Seat 1: PEI Rooster ($12.11 in chips) 
Seat 2: IrdinTo16 ($10.53 in chips) 
Seat 3: Muhlen9 ($10 in chips) 
Seat 4: X-rayFeeling ($18.30 in chips) 
Seat 5: ALPHAmax99 ($7.13 in chips) 
Seat 6: 12311985 ($10 in chips) 
ALPHAmax99: posts small blind $0.05
12311985: posts big blind $0.10
*** HOLE CARDS ***
PEI Rooster: raises $0.20 to $0.30
IrdinTo16: folds 
Muhlen9: folds 
X-rayFeeling: folds 
ALPHAmax99: folds 
12311985: folds 
Uncalled bet ($0.20) returned to PEI Rooster
PEI Rooster collected $0.25 from pot
PEI Rooster: doesn't show hand 
*** SUMMARY ***
Total pot $0.25 | Rake $0 
Seat 1: PEI Rooster collected ($0.25)
Seat 2: IrdinTo16 folded before Flop (didn't bet)
Seat 3: Muhlen9 folded before Flop (didn't bet)
Seat 4: X-rayFeeling (button) folded before Flop (didn't bet)
Seat 5: ALPHAmax99 (small blind) folded before Flop
Seat 6: 12311985 (big blind) folded before Flop



PokerStars Hand #222946609694:  Hold'em No Limit ($0.05/$0.10 USD) - 2021/01/23 2:08:14 ET
Table 'Linzia' 6-max Seat #5 is the button
Seat 1: PEI Rooster ($12.26 in chips) 
Seat 2: IrdinTo16 ($10.53 in chips) 
Seat 3: Muhlen9 ($10 in chips) 
Seat 4: X-rayFeeling ($18.30 in chips) 
Seat 5: ALPHAmax99 ($7.08 in chips) 
Seat 6: 12311985 ($10 in chips) 
12311985: posts small blind $0.05
PEI Rooster: posts big blind $0.10
*** HOLE CARDS ***
IrdinTo16: folds 
Muhlen9: folds 
X-rayFeeling: folds 
ALPHAmax99: folds 
12311985: raises $0.20 to $0.30
PEI Rooster: calls $0.20
*** FLOP *** [8c 5d 8d]
12311985: bets $0.29
PEI Rooster: calls $0.29
*** TURN *** [8c 5d 8d] [7c]
12311985: checks 
PEI Rooster: bets $0.57
12311985: folds 
Uncalled bet ($0.57) returned to PEI Rooster
PEI Rooster collected $1.13 from pot
PEI Rooster: doesn't show hand 
*** SUMMARY ***
Total pot $1.18 | Rake $0.05 
Board [8c 5d 8d 7c]
Seat 1: PEI Rooster (big blind) collected ($1.13)
Seat 2: IrdinTo16 folded before Flop (didn't bet)
Seat 3: Muhlen9 folded before Flop (didn't bet)
Seat 4: X-rayFeeling folded before Flop (didn't bet)
Seat 5: ALPHAmax99 (button) folded before Flop (didn't bet)
Seat 6: 12311985 (small blind) folded on the Turn



PokerStars Hand #222946620093:  Hold'em No Limit ($0.05/$0.10 USD) - 2021/01/23 2:08:58 ET
Table 'Linzia' 6-max Seat #6 is the button
Seat 1: PEI Rooster ($12.80 in chips) 
Seat 3: Muhlen9 ($10 in chips) 
Seat 4: X-rayFeeling ($18.30 in chips) 
Seat 5: ALPHAmax99 ($7.08 in chips) 
Seat 6: 12311985 ($10 in chips) 
PEI Rooster: posts small blind $0.05
IrdinTo16: is sitting out 
Muhlen9: posts big blind $0.10
*** HOLE CARDS ***
X-rayFeeling: folds 
ALPHAmax99: calls $0.10
12311985: raises $0.30 to $0.40
PEI Rooster: calls $0.35
Muhlen9: folds 
ALPHAmax99: calls $0.30
*** FLOP *** [2h Kh 3s]
IrdinTo16 leaves the table
PEI Rooster: checks 
ALPHAmax99: checks 
12311985: checks 
*** TURN *** [2h Kh 3s] [3d]
PEI Rooster: checks 
ALPHAmax99: checks 
12311985: checks 
*** RIVER *** [2h Kh 3s 3d] [Kc]
PEI Rooster: checks 
ALPHAmax99: bets $1.24
12311985: calls $1.24
PEI Rooster: folds 
*** SHOW DOWN ***
ALPHAmax99: shows [9s 7c] (two pair, Kings and Threes)
12311985: shows [Qd Qc] (two pair, Kings and Queens)
12311985 collected $3.61 from pot
*** SUMMARY ***
Total pot $3.78 | Rake $0.17 
Board [2h Kh 3s 3d Kc]
Seat 1: PEI Rooster (small blind) folded on the River
Seat 3: Muhlen9 (big blind) folded before Flop
Seat 4: X-rayFeeling folded before Flop (didn't bet)
Seat 5: ALPHAmax99 showed [9s 7c] and lost with two pair, Kings and Threes
Seat 6: 12311985 (button) showed [Qd Qc] and won ($3.61) with two pair, Kings and Queens



PokerStars Hand #222946629323:  Hold'em No Limit ($0.05/$0.10 USD) - 2021/01/23 2:09:37 ET
Table 'Linzia' 6-max Seat #1 is the button
Seat 1: PEI Rooster ($12.40 in chips) 
Seat 3: Muhlen9 ($10 in chips) 
Seat 5: ALPHAmax99 ($5.44 in chips) 
Seat 6: 12311985 ($11.97 in chips) 
Muhlen9: posts small blind $0.05
ALPHAmax99: posts big blind $0.10
*** HOLE CARDS ***
12311985: folds 
PEI Rooster: folds 
pooliscool#1 joins the table at seat #2 
Muhlen9: raises $0.20 to $0.30
ALPHAmax99: calls $0.20
*** FLOP *** [6d 8d Jc]
Muhlen9: bets $0.19
ALPHAmax99: calls $0.19
*** TURN *** [6d 8d Jc] [Ah]
Muhlen9: bets $0.47
ALPHAmax99: raises $0.47 to $0.94
Muhlen9: calls $0.47
*** RIVER *** [6d 8d Jc Ah] [5c]
Muhlen9: checks 
ALPHAmax99: checks 
*** SHOW DOWN ***
Muhlen9: shows [Ac Qh] (a pair of Aces)
ALPHAmax99: mucks hand 
Muhlen9 collected $2.73 from pot
*** SUMMARY ***
Total pot $2.86 | Rake $0.13 
Board [6d 8d Jc Ah 5c]
Seat 1: PEI Rooster (button) folded before Flop (didn't bet)
Seat 3: Muhlen9 (small blind) showed [Ac Qh] and won ($2.73) with a pair of Aces
Seat 5: ALPHAmax99 (big blind) mucked
Seat 6: 12311985 folded before Flop (didn't bet)



PokerStars Hand #222946637993:  Hold'em No Limit ($0.05/$0.10 USD) - 2021/01/23 2:10:14 ET
Table 'Linzia' 6-max Seat #3 is the button
Seat 1: PEI Rooster ($12.40 in chips) 
Seat 2: pooliscool#1 ($4 in chips) 
Seat 3: Muhlen9 ($11.30 in chips) 
Seat 5: ALPHAmax99 ($4.01 in chips) 
Seat 6: 12311985 ($11.97 in chips) 
ALPHAmax99: posts small blind $0.05
12311985: posts big blind $0.10
pooliscool#1: posts big blind $0.10
*** HOLE CARDS ***
PEI Rooster: folds 
pooliscool#1: checks 
Muhlen9: folds 
ALPHAmax99: folds 
12311985: checks 
*** FLOP *** [7c Ts Ah]
12311985: checks 
pooliscool#1: checks 
*** TURN *** [7c Ts Ah] [Kd]
12311985: checks 
pooliscool#1: checks 
*** RIVER *** [7c Ts Ah Kd] [9h]
12311985: checks 
pooliscool#1: checks 
*** SHOW DOWN ***
12311985: shows [6h Kh] (a pair of Kings)
pooliscool#1: mucks hand 
12311985 collected $0.24 from pot
*** SUMMARY ***
Total pot $0.25 | Rake $0.01 
Board [7c Ts Ah Kd 9h]
Seat 1: PEI Rooster folded before Flop (didn't bet)
Seat 2: pooliscool#1 mucked
Seat 3: Muhlen9 (button) folded before Flop (didn't bet)
Seat 5: ALPHAmax99 (small blind) folded before Flop
Seat 6: 12311985 (big blind) showed [6h Kh] and won ($0.24) with a pair of Kings



PokerStars Hand #222946643995:  Hold'em No Limit ($0.05/$0.10 USD) - 2021/01/23 2:10:40 ET
Table 'Linzia' 6-max Seat #5 is the button
Seat 1: PEI Rooster ($12.40 in chips) 
Seat 2: pooliscool#1 ($3.90 in chips) 
Seat 3: Muhlen9 ($11.30 in chips) 
Seat 5: ALPHAmax99 ($3.96 in chips) 
Seat 6: 12311985 ($12.11 in chips) 
12311985: posts small blind $0.05
PEI Rooster: posts big blind $0.10
*** HOLE CARDS ***
pooliscool#1: folds 
Muhlen9: folds 
ALPHAmax99: calls $0.10
12311985: folds 
PEI Rooster: checks 
*** FLOP *** [6s 8s 2h]
PEI Rooster: checks 
ALPHAmax99: bets $0.10
PEI Rooster: calls $0.10
*** TURN *** [6s 8s 2h] [2d]
PEI Rooster: checks 
ALPHAmax99: bets $0.10
PEI Rooster: calls $0.10
*** RIVER *** [6s 8s 2h 2d] [8d]
PEI Rooster: checks 
ALPHAmax99: checks 
*** SHOW DOWN ***
PEI Rooster: shows [3c 6d] (two pair, Eights and Sixes)
ALPHAmax99: shows [6c Jc] (two pair, Eights and Sixes - Jack kicker)
ALPHAmax99 collected $0.62 from pot
*** SUMMARY ***
Total pot $0.65 | Rake $0.03 
Board [6s 8s 2h 2d 8d]
Seat 1: PEI Rooster (big blind) showed [3c 6d] and lost with two pair, Eights and Sixes
Seat 2: pooliscool#1 folded before Flop (didn't bet)
Seat 3: Muhlen9 folded before Flop (didn't bet)
Seat 5: ALPHAmax99 (button) showed [6c Jc] and won ($0.62) with two pair, Eights and Sixes
Seat 6: 12311985 (small blind) folded before Flop



PokerStars Hand #222946651684:  Hold'em No Limit ($0.05/$0.10 USD) - 2021/01/23 2:11:13 ET
Table 'Linzia' 6-max Seat #6 is the button
Seat 1: PEI Rooster ($12.10 in chips) 
Seat 2: pooliscool#1 ($3.90 in chips) 
Seat 3: Muhlen9 ($11.30 in chips) 
Seat 5: ALPHAmax99 ($4.28 in chips) 
Seat 6: 12311985 ($12.06 in chips) 
PEI Rooster: posts small blind $0.05
pooliscool#1: posts big blind $0.10
*** HOLE CARDS ***
Muhlen9: folds 
ALPHAmax99: folds 
12311985: folds 
PEI Rooster: calls $0.05
pooliscool#1: checks 
*** FLOP *** [2h 3h 6d]
PEI Rooster: checks 
pooliscool#1: checks 
*** TURN *** [2h 3h 6d] [Qc]
PEI Rooster: bets $0.10
pooliscool#1: folds 
Uncalled bet ($0.10) returned to PEI Rooster
PEI Rooster collected $0.19 from pot
PEI Rooster: doesn't show hand 
*** SUMMARY ***
Total pot $0.20 | Rake $0.01 
Board [2h 3h 6d Qc]
Seat 1: PEI Rooster (small blind) collected ($0.19)
Seat 2: pooliscool#1 (big blind) folded on the Turn
Seat 3: Muhlen9 folded before Flop (didn't bet)
Seat 5: ALPHAmax99 folded before Flop (didn't bet)
Seat 6: 12311985 (button) folded before Flop (didn't bet)



PokerStars Hand #222946656382:  Hold'em No Limit ($0.05/$0.10 USD) - 2021/01/23 2:11:33 ET
Table 'Linzia' 6-max Seat #1 is the button
Seat 1: PEI Rooster ($12.19 in chips) 
Seat 2: pooliscool#1 ($3.80 in chips) 
Seat 3: Muhlen9 ($11.30 in chips) 
Seat 5: ALPHAmax99 ($4.28 in chips) 
Seat 6: 12311985 ($12.06 in chips) 
pooliscool#1: posts small blind $0.05
Muhlen9: posts big blind $0.10
*** HOLE CARDS ***
ALPHAmax99: calls $0.10
12311985: folds 
PEI Rooster: calls $0.10
pooliscool#1: calls $0.05
Muhlen9: checks 
*** FLOP *** [4h Ts 2c]
pooliscool#1: checks 
Muhlen9: checks 
ALPHAmax99: bets $0.38
PEI Rooster: calls $0.38
pooliscool#1: folds 
Muhlen9: folds 
*** TURN *** [4h Ts 2c] [7c]
ALPHAmax99: bets $0.55
PEI Rooster: calls $0.55
*** RIVER *** [4h Ts 2c 7c] [9h]
ALPHAmax99: checks 
PEI Rooster: checks 
*** SHOW DOWN ***
ALPHAmax99: shows [8s 7s] (a pair of Sevens)
PEI Rooster: shows [Ks Td] (a pair of Tens)
PEI Rooster collected $2.16 from pot
*** SUMMARY ***
Total pot $2.26 | Rake $0.10 
Board [4h Ts 2c 7c 9h]
Seat 1: PEI Rooster (button) showed [Ks Td] and won ($2.16) with a pair of Tens
Seat 2: pooliscool#1 (small blind) folded on the Flop
Seat 3: Muhlen9 (big blind) folded on the Flop
Seat 5: ALPHAmax99 showed [8s 7s] and lost with a pair of Sevens
Seat 6: 12311985 folded before Flop (didn't bet)



PokerStars Hand #222946666381:  Hold'em No Limit ($0.05/$0.10 USD) - 2021/01/23 2:12:16 ET
Table 'Linzia' 6-max Seat #2 is the button
Seat 1: PEI Rooster ($13.32 in chips) 
Seat 2: pooliscool#1 ($3.70 in chips) 
Seat 3: Muhlen9 ($11.20 in chips) 
Seat 4: X-rayFeeling ($18.30 in chips) 
Seat 5: ALPHAmax99 ($3.25 in chips) 
Seat 6: 12311985 ($12.06 in chips) 
Muhlen9: posts small blind $0.05
X-rayFeeling: posts big blind $0.10
*** HOLE CARDS ***
ALPHAmax99: calls $0.10
12311985: folds 
PEI Rooster: folds 
pooliscool#1: folds 
Muhlen9: folds 
X-rayFeeling: checks 
*** FLOP *** [4s 4c 9s]
X-rayFeeling: checks 
ALPHAmax99: checks 
*** TURN *** [4s 4c 9s] [Ts]
X-rayFeeling: checks 
ALPHAmax99: checks 
*** RIVER *** [4s 4c 9s Ts] [Kd]
X-rayFeeling: checks 
ALPHAmax99: bets $0.24
X-rayFeeling: folds 
Uncalled bet ($0.24) returned to ALPHAmax99
ALPHAmax99 collected $0.24 from pot
ALPHAmax99: doesn't show hand 
*** SUMMARY ***
Total pot $0.25 | Rake $0.01 
Board [4s 4c 9s Ts Kd]
Seat 1: PEI Rooster folded before Flop (didn't bet)
Seat 2: pooliscool#1 (button) folded before Flop (didn't bet)
Seat 3: Muhlen9 (small blind) folded before Flop
Seat 4: X-rayFeeling (big blind) folded on the River
Seat 5: ALPHAmax99 collected ($0.24)
Seat 6: 12311985 folded before Flop (didn't bet)



PokerStars Hand #222946671159:  Hold'em No Limit ($0.05/$0.10 USD) - 2021/01/23 2:12:36 ET
Table 'Linzia' 6-max Seat #3 is the button
Seat 1: PEI Rooster ($13.32 in chips) 
Seat 2: pooliscool#1 ($3.70 in chips) 
Seat 3: Muhlen9 ($11.15 in chips) 
Seat 4: X-rayFeeling ($18.20 in chips) 
Seat 5: ALPHAmax99 ($3.39 in chips) 
Seat 6: 12311985 ($12.06 in chips) 
X-rayFeeling: posts small blind $0.05
ALPHAmax99: posts big blind $0.10
*** HOLE CARDS ***
12311985: folds 
PEI Rooster: calls $0.10
pooliscool#1: calls $0.10
Muhlen9: folds 
X-rayFeeling: calls $0.05
ALPHAmax99: checks 
*** FLOP *** [5s 5h Ah]
X-rayFeeling: checks 
ALPHAmax99: checks 
PEI Rooster: checks 
pooliscool#1: checks 
*** TURN *** [5s 5h Ah] [3c]
X-rayFeeling: bets $0.23
ALPHAmax99: calls $0.23
PEI Rooster: folds 
pooliscool#1: calls $0.23
*** RIVER *** [5s 5h Ah 3c] [Js]
X-rayFeeling: bets $0.62
ALPHAmax99: calls $0.62
pooliscool#1: calls $0.62
*** SHOW DOWN ***
X-rayFeeling: shows [6s As] (two pair, Aces and Fives)
ALPHAmax99: shows [9d Ad] (two pair, Aces and Fives)
pooliscool#1: shows [3d 3h] (a full house, Threes full of Fives)
pooliscool#1 collected $2.82 from pot
*** SUMMARY ***
Total pot $2.95 | Rake $0.13 
Board [5s 5h Ah 3c Js]
Seat 1: PEI Rooster folded on the Turn
Seat 2: pooliscool#1 showed [3d 3h] and won ($2.82) with a full house, Threes full of Fives
Seat 3: Muhlen9 (button) folded before Flop (didn't bet)
Seat 4: X-rayFeeling (small blind) showed [6s As] and lost with two pair, Aces and Fives
Seat 5: ALPHAmax99 (big blind) showed [9d Ad] and lost with two pair, Aces and Fives
Seat 6: 12311985 folded before Flop (didn't bet)



PokerStars Hand #222946678835:  Hold'em No Limit ($0.05/$0.10 USD) - 2021/01/23 2:13:09 ET
Table 'Linzia' 6-max Seat #4 is the button
Seat 1: PEI Rooster ($13.22 in chips) 
Seat 2: pooliscool#1 ($5.57 in chips) 
Seat 3: Muhlen9 ($11.15 in chips) 
Seat 4: X-rayFeeling ($17.25 in chips) 
Seat 5: ALPHAmax99 ($2.44 in chips) 
Seat 6: 12311985 ($12.06 in chips) 
ALPHAmax99: posts small blind $0.05
12311985: posts big blind $0.10
*** HOLE CARDS ***
PEI Rooster: raises $0.20 to $0.30
pooliscool#1: folds 
Muhlen9: folds 
X-rayFeeling: folds 
ALPHAmax99: folds 
12311985: folds 
Uncalled bet ($0.20) returned to PEI Rooster
PEI Rooster collected $0.25 from pot
PEI Rooster: doesn't show hand 
*** SUMMARY ***
Total pot $0.25 | Rake $0 
Seat 1: PEI Rooster collected ($0.25)
Seat 2: pooliscool#1 folded before Flop (didn't bet)
Seat 3: Muhlen9 folded before Flop (didn't bet)
Seat 4: X-rayFeeling (button) folded before Flop (didn't bet)
Seat 5: ALPHAmax99 (small blind) folded before Flop
Seat 6: 12311985 (big blind) folded before Flop



PokerStars Hand #222946682576:  Hold'em No Limit ($0.05/$0.10 USD) - 2021/01/23 2:13:25 ET
Table 'Linzia' 6-max Seat #5 is the button
Seat 1: PEI Rooster ($13.37 in chips) 
Seat 2: pooliscool#1 ($5.57 in chips) 
Seat 3: Muhlen9 ($11.15 in chips) 
Seat 4: X-rayFeeling ($17.25 in chips) 
Seat 5: ALPHAmax99 ($2.39 in chips) 
Seat 6: 12311985 ($11.96 in chips) 
12311985: posts small blind $0.05
PEI Rooster: posts big blind $0.10
*** HOLE CARDS ***
pooliscool#1: folds 
Muhlen9: folds 
X-rayFeeling: raises $0.20 to $0.30
ALPHAmax99: raises $0.20 to $0.50
12311985: folds 
PEI Rooster: folds 
X-rayFeeling: calls $0.20
*** FLOP *** [Ts 9c Th]
X-rayFeeling: checks 
ALPHAmax99: bets $1.89 and is all-in
X-rayFeeling: folds 
Uncalled bet ($1.89) returned to ALPHAmax99
ALPHAmax99 collected $1.10 from pot
ALPHAmax99: doesn't show hand 
*** SUMMARY ***
Total pot $1.15 | Rake $0.05 
Board [Ts 9c Th]
Seat 1: PEI Rooster (big blind) folded before Flop
Seat 2: pooliscool#1 folded before Flop (didn't bet)
Seat 3: Muhlen9 folded before Flop (didn't bet)
Seat 4: X-rayFeeling folded on the Flop
Seat 5: ALPHAmax99 (button) collected ($1.10)
Seat 6: 12311985 (small blind) folded before Flop



PokerStars Hand #222946688466:  Hold'em No Limit ($0.05/$0.10 USD) - 2021/01/23 2:13:51 ET
Table 'Linzia' 6-max Seat #6 is the button
Seat 1: PEI Rooster ($13.27 in chips) 
Seat 2: pooliscool#1 ($5.57 in chips) 
Seat 3: Muhlen9 ($11.15 in chips) 
Seat 4: X-rayFeeling ($16.75 in chips) 
Seat 5: ALPHAmax99 ($2.99 in chips) 
Seat 6: 12311985 ($11.91 in chips) 
PEI Rooster: posts small blind $0.05
pooliscool#1: posts big blind $0.10
*** HOLE CARDS ***
Muhlen9: folds 
X-rayFeeling: folds 
ALPHAmax99: folds 
12311985: folds 
PEI Rooster: calls $0.05
pooliscool#1: checks 
*** FLOP *** [As 2h Td]
PEI Rooster: checks 
pooliscool#1: checks 
*** TURN *** [As 2h Td] [5h]
PEI Rooster: bets $0.10
pooliscool#1: folds 
Uncalled bet ($0.10) returned to PEI Rooster
PEI Rooster collected $0.19 from pot
PEI Rooster: doesn't show hand 
*** SUMMARY ***
Total pot $0.20 | Rake $0.01 
Board [As 2h Td 5h]
Seat 1: PEI Rooster (small blind) collected ($0.19)
Seat 2: pooliscool#1 (big blind) folded on the Turn
Seat 3: Muhlen9 folded before Flop (didn't bet)
Seat 4: X-rayFeeling folded before Flop (didn't bet)
Seat 5: ALPHAmax99 folded before Flop (didn't bet)
Seat 6: 12311985 (button) folded before Flop (didn't bet)



PokerStars Hand #222946693636:  Hold'em No Limit ($0.05/$0.10 USD) - 2021/01/23 2:14:13 ET
Table 'Linzia' 6-max Seat #1 is the button
Seat 1: PEI Rooster ($13.36 in chips) 
Seat 2: pooliscool#1 ($5.47 in chips) 
Seat 3: Muhlen9 ($11.15 in chips) 
Seat 4: X-rayFeeling ($16.75 in chips) 
Seat 5: ALPHAmax99 ($2.99 in chips) 
Seat 6: 12311985 ($11.91 in chips) 
pooliscool#1: posts small blind $0.05
Muhlen9: posts big blind $0.10
*** HOLE CARDS ***
X-rayFeeling: raises $0.20 to $0.30
ALPHAmax99: folds 
12311985: folds 
PEI Rooster: folds 
pooliscool#1: calls $0.25
Muhlen9: folds 
*** FLOP *** [Ah Ac Tc]
pooliscool#1: checks 
X-rayFeeling: bets $0.40
pooliscool#1: calls $0.40
*** TURN *** [Ah Ac Tc] [Qs]
pooliscool#1: checks 
X-rayFeeling: checks 
*** RIVER *** [Ah Ac Tc Qs] [Ks]
pooliscool#1: checks 
X-rayFeeling: checks 
*** SHOW DOWN ***
pooliscool#1: shows [Qd Kh] (two pair, Aces and Kings)
X-rayFeeling: mucks hand 
pooliscool#1 collected $1.43 from pot
*** SUMMARY ***
Total pot $1.50 | Rake $0.07 
Board [Ah Ac Tc Qs Ks]
Seat 1: PEI Rooster (button) folded before Flop (didn't bet)
Seat 2: pooliscool#1 (small blind) showed [Qd Kh] and won ($1.43) with two pair, Aces and Kings
Seat 3: Muhlen9 (big blind) folded before Flop
Seat 4: X-rayFeeling mucked
Seat 5: ALPHAmax99 folded before Flop (didn't bet)
Seat 6: 12311985 folded before Flop (didn't bet)



PokerStars Hand #222946701390:  Hold'em No Limit ($0.05/$0.10 USD) - 2021/01/23 2:14:47 ET
Table 'Linzia' 6-max Seat #2 is the button
Seat 1: PEI Rooster ($13.36 in chips) 
Seat 2: pooliscool#1 ($6.20 in chips) 
Seat 3: Muhlen9 ($11.05 in chips) 
Seat 5: ALPHAmax99 ($2.99 in chips) 
Seat 6: 12311985 ($11.91 in chips) 
Muhlen9: posts small blind $0.05
ALPHAmax99: posts big blind $0.10
*** HOLE CARDS ***
12311985: raises $0.15 to $0.25
PEI Rooster: calls $0.25
pooliscool#1: folds 
Muhlen9: folds 
ALPHAmax99: folds 
*** FLOP *** [Qh 3s 8c]
12311985: checks 
PEI Rooster: bets $0.31
12311985: folds 
Uncalled bet ($0.31) returned to PEI Rooster
PEI Rooster collected $0.62 from pot
PEI Rooster: doesn't show hand 
*** SUMMARY ***
Total pot $0.65 | Rake $0.03 
Board [Qh 3s 8c]
Seat 1: PEI Rooster collected ($0.62)
Seat 2: pooliscool#1 (button) folded before Flop (didn't bet)
Seat 3: Muhlen9 (small blind) folded before Flop
Seat 5: ALPHAmax99 (big blind) folded before Flop
Seat 6: 12311985 folded on the Flop



PokerStars Hand #222946706960:  Hold'em No Limit ($0.05/$0.10 USD) - 2021/01/23 2:15:11 ET
Table 'Linzia' 6-max Seat #3 is the button
Seat 1: PEI Rooster ($13.73 in chips) 
Seat 2: pooliscool#1 ($6.20 in chips) 
Seat 3: Muhlen9 ($11 in chips) 
Seat 5: ALPHAmax99 ($2.89 in chips) 
Seat 6: 12311985 ($11.66 in chips) 
ALPHAmax99: posts small blind $0.05
12311985: posts big blind $0.10
*** HOLE CARDS ***
PEI Rooster: raises $0.20 to $0.30
pooliscool#1: folds 
Muhlen9: folds 
ALPHAmax99: folds 
12311985: folds 
Uncalled bet ($0.20) returned to PEI Rooster
PEI Rooster collected $0.25 from pot
PEI Rooster: doesn't show hand 
*** SUMMARY ***
Total pot $0.25 | Rake $0 
Seat 1: PEI Rooster collected ($0.25)
Seat 2: pooliscool#1 folded before Flop (didn't bet)
Seat 3: Muhlen9 (button) folded before Flop (didn't bet)
Seat 5: ALPHAmax99 (small blind) folded before Flop
Seat 6: 12311985 (big blind) folded before Flop



PokerStars Hand #222946711204:  Hold'em No Limit ($0.05/$0.10 USD) - 2021/01/23 2:15:29 ET
Table 'Linzia' 6-max Seat #5 is the button
Seat 1: PEI Rooster ($13.88 in chips) 
Seat 2: pooliscool#1 ($6.20 in chips) 
Seat 3: Muhlen9 ($11 in chips) 
Seat 5: ALPHAmax99 ($2.84 in chips) 
Seat 6: 12311985 ($11.56 in chips) 
12311985: posts small blind $0.05
PEI Rooster: posts big blind $0.10
*** HOLE CARDS ***
pooliscool#1: folds 
Muhlen9: raises $0.15 to $0.25
ALPHAmax99: folds 
12311985: folds 
PEI Rooster: calls $0.15
*** FLOP *** [9d 8h Kd]
PEI Rooster: checks 
Muhlen9: bets $0.27
PEI Rooster: calls $0.27
*** TURN *** [9d 8h Kd] [Qc]
pooliscool#1 leaves the table
PEI Rooster: checks 
Muhlen9: checks 
*** RIVER *** [9d 8h Kd Qc] [6h]
PEI Rooster: bets $0.52
Muhlen9: calls $0.52
*** SHOW DOWN ***
PEI Rooster: shows [As Jh] (high card Ace)
Muhlen9: shows [Kh Td] (a pair of Kings)
Muhlen9 collected $2.03 from pot
*** SUMMARY ***
Total pot $2.13 | Rake $0.10 
Board [9d 8h Kd Qc 6h]
Seat 1: PEI Rooster (big blind) showed [As Jh] and lost with high card Ace
Seat 2: pooliscool#1 folded before Flop (didn't bet)
Seat 3: Muhlen9 showed [Kh Td] and won ($2.03) with a pair of Kings
Seat 5: ALPHAmax99 (button) folded before Flop (didn't bet)
Seat 6: 12311985 (small blind) folded before Flop



PokerStars Hand #222946720431:  Hold'em No Limit ($0.05/$0.10 USD) - 2021/01/23 2:16:08 ET
Table 'Linzia' 6-max Seat #6 is the button
Seat 1: PEI Rooster ($12.84 in chips) 
Seat 3: Muhlen9 ($11.99 in chips) 
Seat 5: ALPHAmax99 ($2.84 in chips) 
Seat 6: 12311985 ($11.51 in chips) 
PEI Rooster: posts small blind $0.05
Muhlen9: posts big blind $0.10
*** HOLE CARDS ***
ALPHAmax99: folds 
12311985: raises $0.20 to $0.30
PEI Rooster: folds 
Muhlen9: raises $0.60 to $0.90
12311985: raises $1.50 to $2.40
Muhlen9: folds 
Uncalled bet ($1.50) returned to 12311985
12311985 collected $1.85 from pot
12311985: doesn't show hand 
*** SUMMARY ***
Total pot $1.85 | Rake $0 
Seat 1: PEI Rooster (small blind) folded before Flop
Seat 3: Muhlen9 (big blind) folded before Flop
Seat 5: ALPHAmax99 folded before Flop (didn't bet)
Seat 6: 12311985 (button) collected ($1.85)



PokerStars Hand #222946727641:  Hold'em No Limit ($0.05/$0.10 USD) - 2021/01/23 2:16:39 ET
Table 'Linzia' 6-max Seat #1 is the button
Seat 1: PEI Rooster ($12.79 in chips) 
Seat 3: Muhlen9 ($11.09 in chips) 
Seat 5: ALPHAmax99 ($2.84 in chips) 
Seat 6: 12311985 ($12.46 in chips) 
Muhlen9: posts small blind $0.05
ALPHAmax99: posts big blind $0.10
*** HOLE CARDS ***
12311985: folds 
PEI Rooster: folds 
Muhlen9: folds 
Uncalled bet ($0.05) returned to ALPHAmax99
ALPHAmax99 collected $0.10 from pot
ALPHAmax99: doesn't show hand 
*** SUMMARY ***
Total pot $0.10 | Rake $0 
Seat 1: PEI Rooster (button) folded before Flop (didn't bet)
Seat 3: Muhlen9 (small blind) folded before Flop
Seat 5: ALPHAmax99 (big blind) collected ($0.10)
Seat 6: 12311985 folded before Flop (didn't bet)



PokerStars Hand #222946729358:  Hold'em No Limit ($0.05/$0.10 USD) - 2021/01/23 2:16:47 ET
Table 'Linzia' 6-max Seat #3 is the button
Seat 1: PEI Rooster ($12.79 in chips) 
Seat 3: Muhlen9 ($11.04 in chips) 
Seat 5: ALPHAmax99 ($2.89 in chips) 
Seat 6: 12311985 ($12.46 in chips) 
ALPHAmax99: posts small blind $0.05
12311985: posts big blind $0.10
*** HOLE CARDS ***
PEI Rooster: calls $0.10
Muhlen9: raises $0.30 to $0.40
Docpete1 joins the table at seat #2 
ALPHAmax99: folds 
12311985: folds 
PEI Rooster: calls $0.30
*** FLOP *** [7d 8d 7h]
PEI Rooster: checks 
Muhlen9: checks 
*** TURN *** [7d 8d 7h] [9d]
PEI Rooster: checks 
Muhlen9: checks 
*** RIVER *** [7d 8d 7h 9d] [8s]
PEI Rooster: checks 
Muhlen9: checks 
*** SHOW DOWN ***
PEI Rooster: shows [3h 3c] (two pair, Eights and Sevens)
Muhlen9: shows [Ad Ks] (two pair, Eights and Sevens - Ace kicker)
Muhlen9 collected $0.91 from pot
*** SUMMARY ***
Total pot $0.95 | Rake $0.04 
Board [7d 8d 7h 9d 8s]
Seat 1: PEI Rooster showed [3h 3c] and lost with two pair, Eights and Sevens
Seat 3: Muhlen9 (button) showed [Ad Ks] and won ($0.91) with two pair, Eights and Sevens
Seat 5: ALPHAmax99 (small blind) folded before Flop
Seat 6: 12311985 (big blind) folded before Flop



PokerStars Hand #222946740127:  Hold'em No Limit ($0.05/$0.10 USD) - 2021/01/23 2:17:32 ET
Table 'Linzia' 6-max Seat #5 is the button
Seat 1: PEI Rooster ($12.39 in chips) 
Seat 3: Muhlen9 ($11.55 in chips) 
Seat 5: ALPHAmax99 ($2.84 in chips) 
Seat 6: 12311985 ($12.36 in chips) 
12311985: posts small blind $0.05
PEI Rooster: posts big blind $0.10
Docpete1: sits out 
*** HOLE CARDS ***
Muhlen9: folds 
ALPHAmax99: folds 
12311985: raises $0.20 to $0.30
PEI Rooster: folds 
Uncalled bet ($0.20) returned to 12311985
12311985 collected $0.20 from pot
12311985: doesn't show hand 
*** SUMMARY ***
Total pot $0.20 | Rake $0 
Seat 1: PEI Rooster (big blind) folded before Flop
Seat 3: Muhlen9 folded before Flop (didn't bet)
Seat 5: ALPHAmax99 (button) folded before Flop (didn't bet)
Seat 6: 12311985 (small blind) collected ($0.20)



PokerStars Hand #222946742437:  Hold'em No Limit ($0.05/$0.10 USD) - 2021/01/23 2:17:42 ET
Table 'Linzia' 6-max Seat #6 is the button
Seat 1: PEI Rooster ($12.29 in chips) 
Seat 3: Muhlen9 ($11.55 in chips) 
Seat 5: ALPHAmax99 ($2.84 in chips) 
Seat 6: 12311985 ($12.46 in chips) 
PEI Rooster: posts small blind $0.05
Docpete1 has timed out
Docpete1: is sitting out 
Muhlen9: posts big blind $0.10
*** HOLE CARDS ***
ALPHAmax99: folds 
12311985: folds 
PEI Rooster: calls $0.05
Muhlen9: checks 
*** FLOP *** [9s 7s Js]
PEI Rooster: checks 
Muhlen9: bets $0.10
Docpete1 is disconnected 
PEI Rooster: calls $0.10
*** TURN *** [9s 7s Js] [Ah]
PEI Rooster: checks 
Muhlen9: bets $0.25
PEI Rooster: folds 
Uncalled bet ($0.25) returned to Muhlen9
Muhlen9 collected $0.38 from pot
Muhlen9: doesn't show hand 
*** SUMMARY ***
Total pot $0.40 | Rake $0.02 
Board [9s 7s Js Ah]
Seat 1: PEI Rooster (small blind) folded on the Turn
Seat 3: Muhlen9 (big blind) collected ($0.38)
Seat 5: ALPHAmax99 folded before Flop (didn't bet)
Seat 6: 12311985 (button) folded before Flop (didn't bet)



PokerStars Hand #222946751283:  Hold'em No Limit ($0.05/$0.10 USD) - 2021/01/23 2:18:20 ET
Table 'Linzia' 6-max Seat #1 is the button
Seat 1: PEI Rooster ($12.09 in chips) 
Seat 3: Muhlen9 ($11.73 in chips) 
Seat 5: ALPHAmax99 ($2.84 in chips) 
Seat 6: 12311985 ($12.46 in chips) 
Muhlen9: posts small blind $0.05
ALPHAmax99: posts big blind $0.10
*** HOLE CARDS ***
12311985: folds 
PEI Rooster: raises $0.20 to $0.30
Muhlen9: folds 
ALPHAmax99: folds 
Uncalled bet ($0.20) returned to PEI Rooster
PEI Rooster collected $0.25 from pot
PEI Rooster: doesn't show hand 
*** SUMMARY ***
Total pot $0.25 | Rake $0 
Seat 1: PEI Rooster (button) collected ($0.25)
Seat 3: Muhlen9 (small blind) folded before Flop
Seat 5: ALPHAmax99 (big blind) folded before Flop
Seat 6: 12311985 folded before Flop (didn't bet)



PokerStars Hand #222946754952:  Hold'em No Limit ($0.05/$0.10 USD) - 2021/01/23 2:18:36 ET
Table 'Linzia' 6-max Seat #3 is the button
Seat 1: PEI Rooster ($12.24 in chips) 
Seat 3: Muhlen9 ($11.68 in chips) 
Seat 5: ALPHAmax99 ($2.74 in chips) 
Seat 6: 12311985 ($12.46 in chips) 
ALPHAmax99: posts small blind $0.05
12311985: posts big blind $0.10
Docpete1: sits out 
*** HOLE CARDS ***
PEI Rooster: calls $0.10
Muhlen9: folds 
ALPHAmax99: calls $0.05
12311985: checks 
*** FLOP *** [8h 2c As]
ALPHAmax99: checks 
12311985: checks 
PEI Rooster: bets $0.15
ALPHAmax99: folds 
12311985: folds 
Uncalled bet ($0.15) returned to PEI Rooster
PEI Rooster collected $0.29 from pot
PEI Rooster: doesn't show hand 
*** SUMMARY ***
Total pot $0.30 | Rake $0.01 
Board [8h 2c As]
Seat 1: PEI Rooster collected ($0.29)
Seat 3: Muhlen9 (button) folded before Flop (didn't bet)
Seat 5: ALPHAmax99 (small blind) folded on the Flop
Seat 6: 12311985 (big blind) folded on the Flop



PokerStars Hand #222946761215:  Hold'em No Limit ($0.05/$0.10 USD) - 2021/01/23 2:19:03 ET
Table 'Linzia' 6-max Seat #5 is the button
Seat 1: PEI Rooster ($12.43 in chips) 
Seat 3: Muhlen9 ($11.68 in chips) 
Seat 5: ALPHAmax99 ($2.64 in chips) 
Seat 6: 12311985 ($12.36 in chips) 
12311985: posts small blind $0.05
PEI Rooster: posts big blind $0.10
Docpete1: sits out 
*** HOLE CARDS ***
Muhlen9: folds 
ALPHAmax99: folds 
ALPHAmax99 leaves the table
12311985: folds 
Uncalled bet ($0.05) returned to PEI Rooster
PEI Rooster collected $0.10 from pot
PEI Rooster: doesn't show hand 
*** SUMMARY ***
Total pot $0.10 | Rake $0 
Seat 1: PEI Rooster (big blind) collected ($0.10)
Seat 3: Muhlen9 folded before Flop (didn't bet)
Seat 5: ALPHAmax99 (button) folded before Flop (didn't bet)
Seat 6: 12311985 (small blind) folded before Flop



PokerStars Hand #222946763639:  Hold'em No Limit ($0.05/$0.10 USD) - 2021/01/23 2:19:13 ET
Table 'Linzia' 6-max Seat #6 is the button
Seat 1: PEI Rooster ($12.48 in chips) 
Seat 2: Docpete1 ($4 in chips) 
Seat 3: Muhlen9 ($11.68 in chips) 
Seat 6: 12311985 ($12.31 in chips) 
PEI Rooster: posts small blind $0.05
Docpete1: posts big blind $0.10
*** HOLE CARDS ***
Muhlen9: folds 
Shootnick88 joins the table at seat #5 
12311985: raises $0.20 to $0.30
PEI Rooster: calls $0.25
Docpete1: folds 
*** FLOP *** [Jd 2c 8c]
PEI Rooster: checks 
12311985: checks 
*** TURN *** [Jd 2c 8c] [Jc]
PEI Rooster: checks 
12311985: checks 
*** RIVER *** [Jd 2c 8c Jc] [9d]
PEI Rooster: checks 
12311985: checks 
*** SHOW DOWN ***
PEI Rooster: shows [Qd Kh] (a pair of Jacks)
12311985: shows [Ah 5d] (a pair of Jacks - Ace kicker)
12311985 collected $0.67 from pot
*** SUMMARY ***
Total pot $0.70 | Rake $0.03 
Board [Jd 2c 8c Jc 9d]
Seat 1: PEI Rooster (small blind) showed [Qd Kh] and lost with a pair of Jacks
Seat 2: Docpete1 (big blind) folded before Flop
Seat 3: Muhlen9 folded before Flop (didn't bet)
Seat 6: 12311985 (button) showed [Ah 5d] and won ($0.67) with a pair of Jacks



PokerStars Hand #222946770125:  Hold'em No Limit ($0.05/$0.10 USD) - 2021/01/23 2:19:41 ET
Table 'Linzia' 6-max Seat #1 is the button
Seat 1: PEI Rooster ($12.18 in chips) 
Seat 2: Docpete1 ($3.90 in chips) 
Seat 3: Muhlen9 ($11.68 in chips) 
Seat 6: 12311985 ($12.68 in chips) 
Docpete1: posts small blind $0.05
Muhlen9: posts big blind $0.10
X-rayFeeling: sits out 
Shootnick88: sits out 
*** HOLE CARDS ***
12311985: folds 
PEI Rooster: raises $0.20 to $0.30
Docpete1: folds 
Muhlen9: folds 
Uncalled bet ($0.20) returned to PEI Rooster
PEI Rooster collected $0.25 from pot
PEI Rooster: doesn't show hand 
*** SUMMARY ***
Total pot $0.25 | Rake $0 
Seat 1: PEI Rooster (button) collected ($0.25)
Seat 2: Docpete1 (small blind) folded before Flop
Seat 3: Muhlen9 (big blind) folded before Flop
Seat 6: 12311985 folded before Flop (didn't bet)



PokerStars Hand #222946774362:  Hold'em No Limit ($0.05/$0.10 USD) - 2021/01/23 2:19:59 ET
Table 'Linzia' 6-max Seat #2 is the button
Seat 1: PEI Rooster ($12.33 in chips) 
Seat 2: Docpete1 ($3.85 in chips) 
Seat 3: Muhlen9 ($11.58 in chips) 
Seat 4: X-rayFeeling ($16.05 in chips) 
Seat 6: 12311985 ($12.68 in chips) 
Muhlen9: posts small blind $0.05
X-rayFeeling: posts big blind $0.10
Shootnick88: sits out 
*** HOLE CARDS ***
12311985: folds 
PEI Rooster: folds 
Docpete1: raises $0.20 to $0.30
Muhlen9: folds 
X-rayFeeling: folds 
Uncalled bet ($0.20) returned to Docpete1
Docpete1 collected $0.25 from pot
*** SUMMARY ***
Total pot $0.25 | Rake $0 
Seat 1: PEI Rooster folded before Flop (didn't bet)
Seat 2: Docpete1 (button) collected ($0.25)
Seat 3: Muhlen9 (small blind) folded before Flop
Seat 4: X-rayFeeling (big blind) folded before Flop
Seat 6: 12311985 folded before Flop (didn't bet)



PokerStars Hand #222946777314:  Hold'em No Limit ($0.05/$0.10 USD) - 2021/01/23 2:20:11 ET
Table 'Linzia' 6-max Seat #3 is the button
Seat 1: PEI Rooster ($12.33 in chips) 
Seat 2: Docpete1 ($4 in chips) 
Seat 3: Muhlen9 ($11.53 in chips) 
Seat 4: X-rayFeeling ($15.95 in chips) 
Seat 5: Shootnick88 ($10 in chips) 
Seat 6: 12311985 ($12.68 in chips) 
X-rayFeeling: posts small blind $0.05
Shootnick88: posts big blind $0.10
*** HOLE CARDS ***
12311985: folds 
PEI Rooster: calls $0.10
Docpete1: folds 
Muhlen9: folds 
X-rayFeeling: folds 
Shootnick88: checks 
*** FLOP *** [8c 5c 7d]
Shootnick88: checks 
PEI Rooster: checks 
*** TURN *** [8c 5c 7d] [7s]
Shootnick88: checks 
PEI Rooster: bets $0.12
Shootnick88: folds 
Uncalled bet ($0.12) returned to PEI Rooster
PEI Rooster collected $0.24 from pot
PEI Rooster: doesn't show hand 
*** SUMMARY ***
Total pot $0.25 | Rake $0.01 
Board [8c 5c 7d 7s]
Seat 1: PEI Rooster collected ($0.24)
Seat 2: Docpete1 folded before Flop (didn't bet)
Seat 3: Muhlen9 (button) folded before Flop (didn't bet)
Seat 4: X-rayFeeling (small blind) folded before Flop
Seat 5: Shootnick88 (big blind) folded on the Turn
Seat 6: 12311985 folded before Flop (didn't bet)



PokerStars Hand #222946783629:  Hold'em No Limit ($0.05/$0.10 USD) - 2021/01/23 2:20:38 ET
Table 'Linzia' 6-max Seat #4 is the button
Seat 1: PEI Rooster ($12.47 in chips) 
Seat 2: Docpete1 ($4 in chips) 
Seat 3: Muhlen9 ($11.53 in chips) 
Seat 4: X-rayFeeling ($15.90 in chips) 
Seat 5: Shootnick88 ($10 in chips) 
Seat 6: 12311985 ($12.68 in chips) 
Shootnick88: posts small blind $0.05
12311985: posts big blind $0.10
*** HOLE CARDS ***
PEI Rooster: folds 
Docpete1: folds 
Muhlen9: folds 
X-rayFeeling: folds 
Shootnick88: folds 
Uncalled bet ($0.05) returned to 12311985
12311985 collected $0.10 from pot
12311985: doesn't show hand 
*** SUMMARY ***
Total pot $0.10 | Rake $0 
Seat 1: PEI Rooster folded before Flop (didn't bet)
Seat 2: Docpete1 folded before Flop (didn't bet)
Seat 3: Muhlen9 folded before Flop (didn't bet)
Seat 4: X-rayFeeling (button) folded before Flop (didn't bet)
Seat 5: Shootnick88 (small blind) folded before Flop
Seat 6: 12311985 (big blind) collected ($0.10)



PokerStars Hand #222946785698:  Hold'em No Limit ($0.05/$0.10 USD) - 2021/01/23 2:20:47 ET
Table 'Linzia' 6-max Seat #5 is the button
Seat 1: PEI Rooster ($12.47 in chips) 
Seat 2: Docpete1 ($4 in chips) 
Seat 3: Muhlen9 ($11.53 in chips) 
Seat 4: X-rayFeeling ($15.90 in chips) 
Seat 5: Shootnick88 ($10 in chips) 
Seat 6: 12311985 ($12.73 in chips) 
12311985: posts small blind $0.05
PEI Rooster: posts big blind $0.10
*** HOLE CARDS ***
Docpete1: folds 
Muhlen9: folds 
X-rayFeeling: folds 
Shootnick88: folds 
12311985: folds 
Uncalled bet ($0.05) returned to PEI Rooster
PEI Rooster collected $0.10 from pot
PEI Rooster: doesn't show hand 
*** SUMMARY ***
Total pot $0.10 | Rake $0 
Seat 1: PEI Rooster (big blind) collected ($0.10)
Seat 2: Docpete1 folded before Flop (didn't bet)
Seat 3: Muhlen9 folded before Flop (didn't bet)
Seat 4: X-rayFeeling folded before Flop (didn't bet)
Seat 5: Shootnick88 (button) folded before Flop (didn't bet)
Seat 6: 12311985 (small blind) folded before Flop



PokerStars Hand #222946787348:  Hold'em No Limit ($0.05/$0.10 USD) - 2021/01/23 2:20:54 ET
Table 'Linzia' 6-max Seat #6 is the button
Seat 1: PEI Rooster ($12.52 in chips) 
Seat 2: Docpete1 ($4 in chips) 
Seat 3: Muhlen9 ($11.53 in chips) 
Seat 4: X-rayFeeling ($15.90 in chips) 
Seat 5: Shootnick88 ($10 in chips) 
Seat 6: 12311985 ($12.68 in chips) 
PEI Rooster: posts small blind $0.05
Docpete1: posts big blind $0.10
*** HOLE CARDS ***
Muhlen9: folds 
X-rayFeeling: raises $0.20 to $0.30
Shootnick88: folds 
12311985: folds 
PEI Rooster: calls $0.25
Docpete1: folds 
*** FLOP *** [6s 9s 9d]
PEI Rooster: checks 
X-rayFeeling: bets $0.40
PEI Rooster: folds 
Uncalled bet ($0.40) returned to X-rayFeeling
X-rayFeeling collected $0.67 from pot
X-rayFeeling: doesn't show hand 
*** SUMMARY ***
Total pot $0.70 | Rake $0.03 
Board [6s 9s 9d]
Seat 1: PEI Rooster (small blind) folded on the Flop
Seat 2: Docpete1 (big blind) folded before Flop
Seat 3: Muhlen9 folded before Flop (didn't bet)
Seat 4: X-rayFeeling collected ($0.67)
Seat 5: Shootnick88 folded before Flop (didn't bet)
Seat 6: 12311985 (button) folded before Flop (didn't bet)



PokerStars Hand #222946791547:  Hold'em No Limit ($0.05/$0.10 USD) - 2021/01/23 2:21:13 ET
Table 'Linzia' 6-max Seat #1 is the button
Seat 1: PEI Rooster ($12.22 in chips) 
Seat 2: Docpete1 ($3.90 in chips) 
Seat 3: Muhlen9 ($11.53 in chips) 
Seat 4: X-rayFeeling ($16.27 in chips) 
Seat 5: Shootnick88 ($10 in chips) 
Seat 6: 12311985 ($12.68 in chips) 
Docpete1: posts small blind $0.05
Muhlen9: posts big blind $0.10
*** HOLE CARDS ***
X-rayFeeling: folds 
Shootnick88: folds 
12311985: folds 
PEI Rooster: folds 
Docpete1: folds 
Uncalled bet ($0.05) returned to Muhlen9
Muhlen9 collected $0.10 from pot
*** SUMMARY ***
Total pot $0.10 | Rake $0 
Seat 1: PEI Rooster (button) folded before Flop (didn't bet)
Seat 2: Docpete1 (small blind) folded before Flop
Seat 3: Muhlen9 (big blind) collected ($0.10)
Seat 4: X-rayFeeling folded before Flop (didn't bet)
Seat 5: Shootnick88 folded before Flop (didn't bet)
Seat 6: 12311985 folded before Flop (didn't bet)



PokerStars Hand #222946793530:  Hold'em No Limit ($0.05/$0.10 USD) - 2021/01/23 2:21:21 ET
Table 'Linzia' 6-max Seat #2 is the button
Seat 1: PEI Rooster ($12.22 in chips) 
Seat 2: Docpete1 ($3.85 in chips) 
Seat 3: Muhlen9 ($11.58 in chips) 
Seat 4: X-rayFeeling ($16.27 in chips) 
Seat 5: Shootnick88 ($10 in chips) 
Seat 6: 12311985 ($12.68 in chips) 
Muhlen9: posts small blind $0.05
X-rayFeeling: posts big blind $0.10
*** HOLE CARDS ***
Shootnick88: folds 
12311985: folds 
PEI Rooster: calls $0.10
Docpete1: folds 
Muhlen9: folds 
X-rayFeeling: checks 
*** FLOP *** [8c 8d Tc]
X-rayFeeling: checks 
PEI Rooster: bets $0.12
X-rayFeeling: folds 
Uncalled bet ($0.12) returned to PEI Rooster
PEI Rooster collected $0.24 from pot
PEI Rooster: doesn't show hand 
*** SUMMARY ***
Total pot $0.25 | Rake $0.01 
Board [8c 8d Tc]
Seat 1: PEI Rooster collected ($0.24)
Seat 2: Docpete1 (button) folded before Flop (didn't bet)
Seat 3: Muhlen9 (small blind) folded before Flop
Seat 4: X-rayFeeling (big blind) folded on the Flop
Seat 5: Shootnick88 folded before Flop (didn't bet)
Seat 6: 12311985 folded before Flop (didn't bet)



PokerStars Hand #222946798436:  Hold'em No Limit ($0.05/$0.10 USD) - 2021/01/23 2:21:42 ET
Table 'Linzia' 6-max Seat #3 is the button
Seat 1: PEI Rooster ($12.36 in chips) 
Seat 2: Docpete1 ($3.85 in chips) 
Seat 3: Muhlen9 ($11.53 in chips) 
Seat 4: X-rayFeeling ($16.17 in chips) 
Seat 5: Shootnick88 ($10 in chips) 
Seat 6: 12311985 ($12.68 in chips) 
X-rayFeeling: posts small blind $0.05
Shootnick88: posts big blind $0.10
*** HOLE CARDS ***
12311985: folds 
PEI Rooster: calls $0.10
Docpete1: folds 
Muhlen9: folds 
X-rayFeeling: folds 
Shootnick88: checks 
*** FLOP *** [As 7c Kd]
Shootnick88: checks 
PEI Rooster: bets $0.12
Shootnick88: folds 
Uncalled bet ($0.12) returned to PEI Rooster
PEI Rooster collected $0.24 from pot
PEI Rooster: doesn't show hand 
*** SUMMARY ***
Total pot $0.25 | Rake $0.01 
Board [As 7c Kd]
Seat 1: PEI Rooster collected ($0.24)
Seat 2: Docpete1 folded before Flop (didn't bet)
Seat 3: Muhlen9 (button) folded before Flop (didn't bet)
Seat 4: X-rayFeeling (small blind) folded before Flop
Seat 5: Shootnick88 (big blind) folded on the Flop
Seat 6: 12311985 folded before Flop (didn't bet)



PokerStars Hand #222946803115:  Hold'em No Limit ($0.05/$0.10 USD) - 2021/01/23 2:22:02 ET
Table 'Linzia' 6-max Seat #4 is the button
Seat 1: PEI Rooster ($12.50 in chips) 
Seat 2: Docpete1 ($3.85 in chips) 
Seat 3: Muhlen9 ($11.53 in chips) 
Seat 4: X-rayFeeling ($16.12 in chips) 
Seat 5: Shootnick88 ($10 in chips) 
Seat 6: 12311985 ($12.68 in chips) 
Shootnick88: posts small blind $0.05
12311985: posts big blind $0.10
*** HOLE CARDS ***
PEI Rooster: folds 
Docpete1: folds 
Muhlen9: folds 
X-rayFeeling: raises $0.15 to $0.25
Shootnick88: folds 
12311985: calls $0.15
*** FLOP *** [3s Js Jd]
12311985: checks 
X-rayFeeling: checks 
*** TURN *** [3s Js Jd] [Kc]
PEI Rooster leaves the table
12311985: checks 
sunsethero13 joins the table at seat #1 
X-rayFeeling: checks 
*** RIVER *** [3s Js Jd Kc] [Qs]
12311985: checks 
X-rayFeeling: checks 
*** SHOW DOWN ***
12311985: shows [As 3h] (two pair, Jacks and Threes)
X-rayFeeling: mucks hand 
12311985 collected $0.53 from pot
*** SUMMARY ***
Total pot $0.55 | Rake $0.02 
Board [3s Js Jd Kc Qs]
Seat 1: PEI Rooster folded before Flop (didn't bet)
Seat 2: Docpete1 folded before Flop (didn't bet)
Seat 3: Muhlen9 folded before Flop (didn't bet)
Seat 4: X-rayFeeling (button) mucked
Seat 5: Shootnick88 (small blind) folded before Flop
Seat 6: 12311985 (big blind) showed [As 3h] and won ($0.53) with two pair, Jacks and Threes



PokerStars Hand #222946826421:  Hold'em No Limit ($0.05/$0.10 USD) - 2021/01/23 2:23:43 ET
Table 'Linzia' 6-max Seat #6 is the button
Seat 1: sunsethero13 ($10 in chips) 
Seat 2: Docpete1 ($7.40 in chips) 
Seat 3: Muhlen9 ($11.53 in chips) 
Seat 4: X-rayFeeling ($15.87 in chips) 
Seat 5: Shootnick88 ($10 in chips) 
Seat 6: 12311985 ($12.91 in chips) 
sunsethero13: posts small blind $0.05
Docpete1: posts big blind $0.10
*** HOLE CARDS ***
Muhlen9: folds 
X-rayFeeling: folds 
Shootnick88: folds 
12311985: folds 
sunsethero13: calls $0.05
Docpete1: checks 
*** FLOP *** [4c Qd 2c]
sunsethero13: checks 
Docpete1: bets $0.10
sunsethero13: folds 
Uncalled bet ($0.10) returned to Docpete1
Docpete1 collected $0.19 from pot
*** SUMMARY ***
Total pot $0.20 | Rake $0.01 
Board [4c Qd 2c]
Seat 1: sunsethero13 (small blind) folded on the Flop
Seat 2: Docpete1 (big blind) collected ($0.19)
Seat 3: Muhlen9 folded before Flop (didn't bet)
Seat 4: X-rayFeeling folded before Flop (didn't bet)
Seat 5: Shootnick88 folded before Flop (didn't bet)
Seat 6: 12311985 (button) folded before Flop (didn't bet)



PokerStars Hand #222946835536:  Hold'em No Limit ($0.05/$0.10 USD) - 2021/01/23 2:24:22 ET
Table 'Linzia' 6-max Seat #1 is the button
Seat 1: sunsethero13 ($10 in chips) 
Seat 2: Docpete1 ($7.49 in chips) 
Seat 3: Muhlen9 ($11.53 in chips) 
Seat 4: X-rayFeeling ($15.87 in chips) 
Seat 5: Shootnick88 ($10 in chips) 
Seat 6: 12311985 ($12.91 in chips) 
Docpete1: posts small blind $0.05
Muhlen9: posts big blind $0.10
*** HOLE CARDS ***
X-rayFeeling: folds 
Shootnick88: folds 
12311985: folds 
sunsethero13: folds 
Docpete1: folds 
Uncalled bet ($0.05) returned to Muhlen9
Muhlen9 collected $0.10 from pot
Muhlen9: doesn't show hand 
*** SUMMARY ***
Total pot $0.10 | Rake $0 
Seat 1: sunsethero13 (button) folded before Flop (didn't bet)
Seat 2: Docpete1 (small blind) folded before Flop
Seat 3: Muhlen9 (big blind) collected ($0.10)
Seat 4: X-rayFeeling folded before Flop (didn't bet)
Seat 5: Shootnick88 folded before Flop (didn't bet)
Seat 6: 12311985 folded before Flop (didn't bet)



PokerStars Hand #222946837589:  Hold'em No Limit ($0.05/$0.10 USD) - 2021/01/23 2:24:31 ET
Table 'Linzia' 6-max Seat #2 is the button
Seat 1: sunsethero13 ($10 in chips) 
Seat 2: Docpete1 ($7.44 in chips) 
Seat 3: Muhlen9 ($11.58 in chips) 
Seat 4: X-rayFeeling ($15.87 in chips) 
Seat 5: Shootnick88 ($10 in chips) 
Seat 6: 12311985 ($12.91 in chips) 
Muhlen9: posts small blind $0.05
X-rayFeeling: posts big blind $0.10
*** HOLE CARDS ***
Shootnick88: folds 
12311985: folds 
sunsethero13: folds 
Docpete1: raises $0.20 to $0.30
Muhlen9: folds 
X-rayFeeling: folds 
Uncalled bet ($0.20) returned to Docpete1
Docpete1 collected $0.25 from pot
*** SUMMARY ***
Total pot $0.25 | Rake $0 
Seat 1: sunsethero13 folded before Flop (didn't bet)
Seat 2: Docpete1 (button) collected ($0.25)
Seat 3: Muhlen9 (small blind) folded before Flop
Seat 4: X-rayFeeling (big blind) folded before Flop
Seat 5: Shootnick88 folded before Flop (didn't bet)
Seat 6: 12311985 folded before Flop (didn't bet)



PokerStars Hand #222946841595:  Hold'em No Limit ($0.05/$0.10 USD) - 2021/01/23 2:24:48 ET
Table 'Linzia' 6-max Seat #3 is the button
Seat 1: sunsethero13 ($10 in chips) 
Seat 2: Docpete1 ($7.59 in chips) 
Seat 3: Muhlen9 ($11.53 in chips) 
Seat 4: X-rayFeeling ($15.77 in chips) 
Seat 5: Shootnick88 ($10 in chips) 
Seat 6: 12311985 ($12.91 in chips) 
X-rayFeeling: posts small blind $0.05
Shootnick88: posts big blind $0.10
*** HOLE CARDS ***
12311985: folds 
sunsethero13: folds 
Docpete1: raises $0.20 to $0.30
Muhlen9: folds 
X-rayFeeling: calls $0.25
Shootnick88: folds 
*** FLOP *** [4d 4h 2d]
X-rayFeeling: checks 
Docpete1: bets $0.40
X-rayFeeling: folds 
Uncalled bet ($0.40) returned to Docpete1
Docpete1 collected $0.67 from pot
*** SUMMARY ***
Total pot $0.70 | Rake $0.03 
Board [4d 4h 2d]
Seat 1: sunsethero13 folded before Flop (didn't bet)
Seat 2: Docpete1 collected ($0.67)
Seat 3: Muhlen9 (button) folded before Flop (didn't bet)
Seat 4: X-rayFeeling (small blind) folded on the Flop
Seat 5: Shootnick88 (big blind) folded before Flop
Seat 6: 12311985 folded before Flop (didn't bet)



PokerStars Hand #222946848798:  Hold'em No Limit ($0.05/$0.10 USD) - 2021/01/23 2:25:19 ET
Table 'Linzia' 6-max Seat #4 is the button
Seat 1: sunsethero13 ($10 in chips) 
Seat 2: Docpete1 ($7.96 in chips) 
Seat 3: Muhlen9 ($11.53 in chips) 
Seat 4: X-rayFeeling ($15.47 in chips) 
Seat 5: Shootnick88 ($10 in chips) 
Seat 6: 12311985 ($12.91 in chips) 
Shootnick88: posts small blind $0.05
12311985: posts big blind $0.10
*** HOLE CARDS ***
sunsethero13: folds 
Docpete1: folds 
Muhlen9: raises $0.15 to $0.25
X-rayFeeling: folds 
Shootnick88: folds 
12311985: calls $0.15
*** FLOP *** [Th Qs Kc]
12311985: checks 
Muhlen9: bets $0.27
12311985: calls $0.27
*** TURN *** [Th Qs Kc] [Js]
12311985: checks 
Muhlen9: checks 
*** RIVER *** [Th Qs Kc Js] [6c]
12311985: checks 
Muhlen9: checks 
*** SHOW DOWN ***
12311985: shows [Qd Jd] (two pair, Queens and Jacks)
Muhlen9: shows [Kd Ts] (two pair, Kings and Tens)
Muhlen9 collected $1.04 from pot
*** SUMMARY ***
Total pot $1.09 | Rake $0.05 
Board [Th Qs Kc Js 6c]
Seat 1: sunsethero13 folded before Flop (didn't bet)
Seat 2: Docpete1 folded before Flop (didn't bet)
Seat 3: Muhlen9 showed [Kd Ts] and won ($1.04) with two pair, Kings and Tens
Seat 4: X-rayFeeling (button) folded before Flop (didn't bet)
Seat 5: Shootnick88 (small blind) folded before Flop
Seat 6: 12311985 (big blind) showed [Qd Jd] and lost with two pair, Queens and Jacks



PokerStars Hand #222946855820:  Hold'em No Limit ($0.05/$0.10 USD) - 2021/01/23 2:25:50 ET
Table 'Linzia' 6-max Seat #5 is the button
Seat 1: sunsethero13 ($10 in chips) 
Seat 2: Docpete1 ($7.96 in chips) 
Seat 3: Muhlen9 ($12.05 in chips) 
Seat 4: X-rayFeeling ($15.47 in chips) 
Seat 5: Shootnick88 ($10 in chips) 
Seat 6: 12311985 ($12.39 in chips) 
12311985: posts small blind $0.05
sunsethero13: posts big blind $0.10
*** HOLE CARDS ***
Docpete1: calls $0.10
Muhlen9: folds 
X-rayFeeling: folds 
Shootnick88: folds 
12311985: folds 
sunsethero13: checks 
*** FLOP *** [3h 6h 2c]
sunsethero13: checks 
Docpete1: bets $0.10
sunsethero13: calls $0.10
*** TURN *** [3h 6h 2c] [9s]
sunsethero13: checks 
Docpete1: checks 
*** RIVER *** [3h 6h 2c 9s] [Qs]
sunsethero13: checks 
Docpete1: checks 
*** SHOW DOWN ***
sunsethero13: shows [7h 2h] (a pair of Deuces)
Docpete1: mucks hand 
sunsethero13 collected $0.43 from pot
*** SUMMARY ***
Total pot $0.45 | Rake $0.02 
Board [3h 6h 2c 9s Qs]
Seat 1: sunsethero13 (big blind) showed [7h 2h] and won ($0.43) with a pair of Deuces
Seat 2: Docpete1 mucked
Seat 3: Muhlen9 folded before Flop (didn't bet)
Seat 4: X-rayFeeling folded before Flop (didn't bet)
Seat 5: Shootnick88 (button) folded before Flop (didn't bet)
Seat 6: 12311985 (small blind) folded before Flop



PokerStars Hand #222946866863:  Hold'em No Limit ($0.05/$0.10 USD) - 2021/01/23 2:26:38 ET
Table 'Linzia' 6-max Seat #6 is the button
Seat 1: sunsethero13 ($10.23 in chips) 
Seat 2: Docpete1 ($7.76 in chips) 
Seat 3: Muhlen9 ($12.05 in chips) 
Seat 4: X-rayFeeling ($15.47 in chips) 
Seat 5: Shootnick88 ($10 in chips) 
Seat 6: 12311985 ($12.34 in chips) 
sunsethero13: posts small blind $0.05
Docpete1: posts big blind $0.10
*** HOLE CARDS ***
Muhlen9: folds 
X-rayFeeling: raises $0.20 to $0.30
Shootnick88: folds 
12311985: folds 
sunsethero13: calls $0.25
Docpete1: folds 
*** FLOP *** [Tc 9s 2h]
sunsethero13: checks 
X-rayFeeling: bets $0.40
sunsethero13: calls $0.40
*** TURN *** [Tc 9s 2h] [Ks]
sunsethero13: checks 
X-rayFeeling: bets $0.86
sunsethero13: calls $0.86
*** RIVER *** [Tc 9s 2h Ks] [Ad]
sunsethero13: checks 
X-rayFeeling: bets $1.85
sunsethero13: raises $6.82 to $8.67 and is all-in
X-rayFeeling: folds 
Uncalled bet ($6.82) returned to sunsethero13
sunsethero13 collected $6.61 from pot
sunsethero13: doesn't show hand 
*** SUMMARY ***
Total pot $6.92 | Rake $0.31 
Board [Tc 9s 2h Ks Ad]
Seat 1: sunsethero13 (small blind) collected ($6.61)
Seat 2: Docpete1 (big blind) folded before Flop
Seat 3: Muhlen9 folded before Flop (didn't bet)
Seat 4: X-rayFeeling folded on the River
Seat 5: Shootnick88 folded before Flop (didn't bet)
Seat 6: 12311985 (button) folded before Flop (didn't bet)



PokerStars Hand #222946882741:  Hold'em No Limit ($0.05/$0.10 USD) - 2021/01/23 2:27:47 ET
Table 'Linzia' 6-max Seat #1 is the button
Seat 1: sunsethero13 ($13.43 in chips) 
Seat 2: Docpete1 ($7.66 in chips) 
Seat 3: Muhlen9 ($12.05 in chips) 
Seat 4: X-rayFeeling ($12.06 in chips) 
Seat 5: Shootnick88 ($10 in chips) 
Seat 6: 12311985 ($12.34 in chips) 
Docpete1: posts small blind $0.05
Muhlen9: posts big blind $0.10
*** HOLE CARDS ***
X-rayFeeling: raises $0.20 to $0.30
Shootnick88: folds 
12311985: folds 
sunsethero13: folds 
Docpete1: folds 
Muhlen9: folds 
Uncalled bet ($0.20) returned to X-rayFeeling
X-rayFeeling collected $0.25 from pot
X-rayFeeling: doesn't show hand 
*** SUMMARY ***
Total pot $0.25 | Rake $0 
Seat 1: sunsethero13 (button) folded before Flop (didn't bet)
Seat 2: Docpete1 (small blind) folded before Flop
Seat 3: Muhlen9 (big blind) folded before Flop
Seat 4: X-rayFeeling collected ($0.25)
Seat 5: Shootnick88 folded before Flop (didn't bet)
Seat 6: 12311985 folded before Flop (didn't bet)



PokerStars Hand #222946885752:  Hold'em No Limit ($0.05/$0.10 USD) - 2021/01/23 2:28:00 ET
Table 'Linzia' 6-max Seat #2 is the button
Seat 1: sunsethero13 ($13.43 in chips) 
Seat 2: Docpete1 ($7.61 in chips) 
Seat 3: Muhlen9 ($11.95 in chips) 
Seat 4: X-rayFeeling ($12.21 in chips) 
Seat 5: Shootnick88 ($10 in chips) 
Seat 6: 12311985 ($12.34 in chips) 
Muhlen9: posts small blind $0.05
X-rayFeeling: posts big blind $0.10
*** HOLE CARDS ***
Shootnick88: folds 
12311985 has timed out
12311985: folds 
sunsethero13: folds 
Docpete1: folds 
Muhlen9: raises $0.20 to $0.30
X-rayFeeling: folds 
Uncalled bet ($0.20) returned to Muhlen9
Muhlen9 collected $0.20 from pot
Muhlen9: doesn't show hand 
*** SUMMARY ***
Total pot $0.20 | Rake $0 
Seat 1: sunsethero13 folded before Flop (didn't bet)
Seat 2: Docpete1 (button) folded before Flop (didn't bet)
Seat 3: Muhlen9 (small blind) collected ($0.20)
Seat 4: X-rayFeeling (big blind) folded before Flop
Seat 5: Shootnick88 folded before Flop (didn't bet)
Seat 6: 12311985 folded before Flop (didn't bet)



PokerStars Hand #222946892017:  Hold'em No Limit ($0.05/$0.10 USD) - 2021/01/23 2:28:26 ET
Table 'Linzia' 6-max Seat #3 is the button
Seat 1: sunsethero13 ($13.43 in chips) 
Seat 2: Docpete1 ($7.61 in chips) 
Seat 3: Muhlen9 ($12.05 in chips) 
Seat 4: X-rayFeeling ($12.11 in chips) 
Seat 5: Shootnick88 ($10 in chips) 
Seat 6: 12311985 ($12.34 in chips) 
X-rayFeeling: posts small blind $0.05
Shootnick88: posts big blind $0.10
*** HOLE CARDS ***
12311985: raises $0.15 to $0.25
sunsethero13: folds 
Docpete1: folds 
Muhlen9: folds 
X-rayFeeling: folds 
Shootnick88: folds 
Uncalled bet ($0.15) returned to 12311985
12311985 collected $0.25 from pot
12311985: doesn't show hand 
*** SUMMARY ***
Total pot $0.25 | Rake $0 
Seat 1: sunsethero13 folded before Flop (didn't bet)
Seat 2: Docpete1 folded before Flop (didn't bet)
Seat 3: Muhlen9 (button) folded before Flop (didn't bet)
Seat 4: X-rayFeeling (small blind) folded before Flop
Seat 5: Shootnick88 (big blind) folded before Flop
Seat 6: 12311985 collected ($0.25)



PokerStars Hand #222946895629:  Hold'em No Limit ($0.05/$0.10 USD) - 2021/01/23 2:28:41 ET
Table 'Linzia' 6-max Seat #4 is the button
Seat 1: sunsethero13 ($13.43 in chips) 
Seat 2: Docpete1 ($7.61 in chips) 
Seat 3: Muhlen9 ($12.05 in chips) 
Seat 4: X-rayFeeling ($12.06 in chips) 
Seat 5: Shootnick88 ($10 in chips) 
Seat 6: 12311985 ($12.49 in chips) 
Shootnick88: posts small blind $0.05
12311985: posts big blind $0.10
*** HOLE CARDS ***
sunsethero13: raises $0.14 to $0.24
Docpete1: folds 
Muhlen9: folds 
X-rayFeeling: folds 
Shootnick88: folds 
12311985: folds 
Uncalled bet ($0.14) returned to sunsethero13
sunsethero13 collected $0.25 from pot
sunsethero13: doesn't show hand 
*** SUMMARY ***
Total pot $0.25 | Rake $0 
Seat 1: sunsethero13 collected ($0.25)
Seat 2: Docpete1 folded before Flop (didn't bet)
Seat 3: Muhlen9 folded before Flop (didn't bet)
Seat 4: X-rayFeeling (button) folded before Flop (didn't bet)
Seat 5: Shootnick88 (small blind) folded before Flop
Seat 6: 12311985 (big blind) folded before Flop



PokerStars Hand #222946898543:  Hold'em No Limit ($0.05/$0.10 USD) - 2021/01/23 2:28:54 ET
Table 'Linzia' 6-max Seat #5 is the button
Seat 1: sunsethero13 ($13.58 in chips) 
Seat 2: Docpete1 ($7.61 in chips) 
Seat 3: Muhlen9 ($12.05 in chips) 
Seat 4: X-rayFeeling ($12.06 in chips) 
Seat 5: Shootnick88 ($10 in chips) 
Seat 6: 12311985 ($12.39 in chips) 
12311985: posts small blind $0.05
sunsethero13: posts big blind $0.10
*** HOLE CARDS ***
Docpete1: folds 
Muhlen9: folds 
X-rayFeeling: raises $0.20 to $0.30
Shootnick88: folds 
12311985: raises $0.90 to $1.20
sunsethero13: folds 
X-rayFeeling: folds 
Uncalled bet ($0.90) returned to 12311985
12311985 collected $0.70 from pot
12311985: doesn't show hand 
*** SUMMARY ***
Total pot $0.70 | Rake $0 
Seat 1: sunsethero13 (big blind) folded before Flop
Seat 2: Docpete1 folded before Flop (didn't bet)
Seat 3: Muhlen9 folded before Flop (didn't bet)
Seat 4: X-rayFeeling folded before Flop
Seat 5: Shootnick88 (button) folded before Flop (didn't bet)
Seat 6: 12311985 (small blind) collected ($0.70)



PokerStars Hand #222946902726:  Hold'em No Limit ($0.05/$0.10 USD) - 2021/01/23 2:29:12 ET
Table 'Linzia' 6-max Seat #6 is the button
Seat 1: sunsethero13 ($13.48 in chips) 
Seat 2: Docpete1 ($7.61 in chips) 
Seat 3: Muhlen9 ($12.05 in chips) 
Seat 4: X-rayFeeling ($11.76 in chips) 
Seat 5: Shootnick88 ($10 in chips) 
Seat 6: 12311985 ($12.79 in chips) 
sunsethero13: posts small blind $0.05
Docpete1: posts big blind $0.10
*** HOLE CARDS ***
Muhlen9: folds 
X-rayFeeling: folds 
Shootnick88: folds 
12311985: folds 
sunsethero13: folds 
Uncalled bet ($0.05) returned to Docpete1
Docpete1 collected $0.10 from pot
*** SUMMARY ***
Total pot $0.10 | Rake $0 
Seat 1: sunsethero13 (small blind) folded before Flop
Seat 2: Docpete1 (big blind) collected ($0.10)
Seat 3: Muhlen9 folded before Flop (didn't bet)
Seat 4: X-rayFeeling folded before Flop (didn't bet)
Seat 5: Shootnick88 folded before Flop (didn't bet)
Seat 6: 12311985 (button) folded before Flop (didn't bet)



PokerStars Hand #222946908121:  Hold'em No Limit ($0.05/$0.10 USD) - 2021/01/23 2:29:36 ET
Table 'Linzia' 6-max Seat #1 is the button
Seat 1: sunsethero13 ($13.43 in chips) 
Seat 3: Muhlen9 ($12.05 in chips) 
Seat 4: X-rayFeeling ($11.76 in chips) 
Seat 5: Shootnick88 ($10 in chips) 
Seat 6: 12311985 ($12.79 in chips) 
Docpete1 is disconnected 
Docpete1 has timed out while disconnected
Docpete1: is sitting out 
Muhlen9: posts small blind $0.05
X-rayFeeling: posts big blind $0.10
*** HOLE CARDS ***
Shootnick88: folds 
12311985: folds 
sunsethero13: folds 
Muhlen9: raises $0.20 to $0.30
X-rayFeeling: folds 
Uncalled bet ($0.20) returned to Muhlen9
Muhlen9 collected $0.20 from pot
Muhlen9: doesn't show hand 
*** SUMMARY ***
Total pot $0.20 | Rake $0 
Seat 1: sunsethero13 (button) folded before Flop (didn't bet)
Seat 3: Muhlen9 (small blind) collected ($0.20)
Seat 4: X-rayFeeling (big blind) folded before Flop
Seat 5: Shootnick88 folded before Flop (didn't bet)
Seat 6: 12311985 folded before Flop (didn't bet)



PokerStars Hand #222946913320:  Hold'em No Limit ($0.05/$0.10 USD) - 2021/01/23 2:29:58 ET
Table 'Linzia' 6-max Seat #3 is the button
Seat 1: sunsethero13 ($13.43 in chips) 
Seat 3: Muhlen9 ($12.15 in chips) 
Seat 4: X-rayFeeling ($11.66 in chips) 
Seat 5: Shootnick88 ($10 in chips) 
Seat 6: 12311985 ($12.79 in chips) 
X-rayFeeling: posts small blind $0.05
Shootnick88: posts big blind $0.10
Docpete1: sits out 
*** HOLE CARDS ***
12311985: raises $0.15 to $0.25
sunsethero13: raises $0.65 to $0.90
Muhlen9: folds 
X-rayFeeling: folds 
Shootnick88: folds 
12311985: folds 
Uncalled bet ($0.65) returned to sunsethero13
sunsethero13 collected $0.65 from pot
sunsethero13: doesn't show hand 
*** SUMMARY ***
Total pot $0.65 | Rake $0 
Seat 1: sunsethero13 collected ($0.65)
Seat 3: Muhlen9 (button) folded before Flop (didn't bet)
Seat 4: X-rayFeeling (small blind) folded before Flop
Seat 5: Shootnick88 (big blind) folded before Flop
Seat 6: 12311985 folded before Flop



PokerStars Hand #222946918348:  Hold'em No Limit ($0.05/$0.10 USD) - 2021/01/23 2:30:19 ET
Table 'Linzia' 6-max Seat #4 is the button
Seat 1: sunsethero13 ($13.83 in chips) 
Seat 3: Muhlen9 ($12.15 in chips) 
Seat 4: X-rayFeeling ($11.61 in chips) 
Seat 5: Shootnick88 ($10 in chips) 
Seat 6: 12311985 ($12.54 in chips) 
Shootnick88: posts small blind $0.05
12311985: posts big blind $0.10
Docpete1: sits out 
*** HOLE CARDS ***
sunsethero13: folds 
Muhlen9: folds 
X-rayFeeling: folds 
Shootnick88: folds 
Uncalled bet ($0.05) returned to 12311985
12311985 collected $0.10 from pot
12311985: doesn't show hand 
*** SUMMARY ***
Total pot $0.10 | Rake $0 
Seat 1: sunsethero13 folded before Flop (didn't bet)
Seat 3: Muhlen9 folded before Flop (didn't bet)
Seat 4: X-rayFeeling (button) folded before Flop (didn't bet)
Seat 5: Shootnick88 (small blind) folded before Flop
Seat 6: 12311985 (big blind) collected ($0.10)



PokerStars Hand #222946921781:  Hold'em No Limit ($0.05/$0.10 USD) - 2021/01/23 2:30:34 ET
Table 'Linzia' 6-max Seat #5 is the button
Seat 1: sunsethero13 ($13.83 in chips) 
Seat 3: Muhlen9 ($12.15 in chips) 
Seat 4: X-rayFeeling ($11.61 in chips) 
Seat 5: Shootnick88 ($10 in chips) 
Seat 6: 12311985 ($12.59 in chips) 
12311985: posts small blind $0.05
sunsethero13: posts big blind $0.10
Docpete1: sits out 
*** HOLE CARDS ***
Muhlen9: raises $0.15 to $0.25
X-rayFeeling: folds 
Shootnick88: folds 
12311985: folds 
sunsethero13: calls $0.15
*** FLOP *** [2s Th 9d]
sunsethero13: checks 
Muhlen9: bets $0.17
sunsethero13: folds 
Uncalled bet ($0.17) returned to Muhlen9
Muhlen9 collected $0.53 from pot
Muhlen9: doesn't show hand 
*** SUMMARY ***
Total pot $0.55 | Rake $0.02 
Board [2s Th 9d]
Seat 1: sunsethero13 (big blind) folded on the Flop
Seat 3: Muhlen9 collected ($0.53)
Seat 4: X-rayFeeling folded before Flop (didn't bet)
Seat 5: Shootnick88 (button) folded before Flop (didn't bet)
Seat 6: 12311985 (small blind) folded before Flop



PokerStars Hand #222946927874:  Hold'em No Limit ($0.05/$0.10 USD) - 2021/01/23 2:31:00 ET
Table 'Linzia' 6-max Seat #6 is the button
Seat 1: sunsethero13 ($13.58 in chips) 
Seat 2: Docpete1 ($7.66 in chips) 
Seat 3: Muhlen9 ($12.43 in chips) 
Seat 4: X-rayFeeling ($11.61 in chips) 
Seat 5: Shootnick88 ($10 in chips) 
Seat 6: 12311985 ($12.54 in chips) 
sunsethero13: posts small blind $0.05
Docpete1: posts big blind $0.10
*** HOLE CARDS ***
Muhlen9: folds 
X-rayFeeling: folds 
Shootnick88: raises $0.20 to $0.30
12311985: folds 
sunsethero13: folds 
Docpete1: folds 
Uncalled bet ($0.20) returned to Shootnick88
Shootnick88 collected $0.25 from pot
Shootnick88: doesn't show hand 
*** SUMMARY ***
Total pot $0.25 | Rake $0 
Seat 1: sunsethero13 (small blind) folded before Flop
Seat 2: Docpete1 (big blind) folded before Flop
Seat 3: Muhlen9 folded before Flop (didn't bet)
Seat 4: X-rayFeeling folded before Flop (didn't bet)
Seat 5: Shootnick88 collected ($0.25)
Seat 6: 12311985 (button) folded before Flop (didn't bet)



PokerStars Hand #222946932731:  Hold'em No Limit ($0.05/$0.10 USD) - 2021/01/23 2:31:20 ET
Table 'Linzia' 6-max Seat #1 is the button
Seat 1: sunsethero13 ($13.53 in chips) 
Seat 2: Docpete1 ($7.56 in chips) 
Seat 3: Muhlen9 ($12.43 in chips) 
Seat 4: X-rayFeeling ($11.61 in chips) 
Seat 5: Shootnick88 ($10.15 in chips) 
Seat 6: 12311985 ($12.54 in chips) 
Docpete1: posts small blind $0.05
Muhlen9: posts big blind $0.10
*** HOLE CARDS ***
X-rayFeeling: folds 
Shootnick88: folds 
12311985: folds 
sunsethero13: folds 
Docpete1: raises $0.20 to $0.30
Muhlen9: folds 
Uncalled bet ($0.20) returned to Docpete1
Docpete1 collected $0.20 from pot
*** SUMMARY ***
Total pot $0.20 | Rake $0 
Seat 1: sunsethero13 (button) folded before Flop (didn't bet)
Seat 2: Docpete1 (small blind) collected ($0.20)
Seat 3: Muhlen9 (big blind) folded before Flop
Seat 4: X-rayFeeling folded before Flop (didn't bet)
Seat 5: Shootnick88 folded before Flop (didn't bet)
Seat 6: 12311985 folded before Flop (didn't bet)



PokerStars Hand #222946936684:  Hold'em No Limit ($0.05/$0.10 USD) - 2021/01/23 2:31:37 ET
Table 'Linzia' 6-max Seat #2 is the button
Seat 1: sunsethero13 ($13.53 in chips) 
Seat 2: Docpete1 ($7.66 in chips) 
Seat 3: Muhlen9 ($12.33 in chips) 
Seat 4: X-rayFeeling ($11.61 in chips) 
Seat 5: Shootnick88 ($10.15 in chips) 
Seat 6: 12311985 ($12.54 in chips) 
Muhlen9: posts small blind $0.05
X-rayFeeling: posts big blind $0.10
*** HOLE CARDS ***
Shootnick88: folds 
12311985: folds 
sunsethero13: folds 
Docpete1: folds 
Muhlen9: raises $0.20 to $0.30
X-rayFeeling: raises $0.60 to $0.90
Muhlen9: calls $0.60
*** FLOP *** [6d 6c 3d]
Muhlen9: checks 
X-rayFeeling: bets $1.03
Muhlen9: raises $1.89 to $2.92
X-rayFeeling: raises $7.79 to $10.71 and is all-in
Muhlen9: folds 
Uncalled bet ($7.79) returned to X-rayFeeling
X-rayFeeling collected $7.30 from pot
X-rayFeeling: doesn't show hand 
*** SUMMARY ***
Total pot $7.64 | Rake $0.34 
Board [6d 6c 3d]
Seat 1: sunsethero13 folded before Flop (didn't bet)
Seat 2: Docpete1 (button) folded before Flop (didn't bet)
Seat 3: Muhlen9 (small blind) folded on the Flop
Seat 4: X-rayFeeling (big blind) collected ($7.30)
Seat 5: Shootnick88 folded before Flop (didn't bet)
Seat 6: 12311985 folded before Flop (didn't bet)



PokerStars Hand #222946947630:  Hold'em No Limit ($0.05/$0.10 USD) - 2021/01/23 2:32:23 ET
Table 'Linzia' 6-max Seat #3 is the button
Seat 1: sunsethero13 ($13.53 in chips) 
Seat 2: Docpete1 ($7.66 in chips) 
Seat 3: Muhlen9 ($10 in chips) 
Seat 4: X-rayFeeling ($15.09 in chips) 
Seat 5: Shootnick88 ($10.15 in chips) 
Seat 6: 12311985 ($12.54 in chips) 
X-rayFeeling: posts small blind $0.05
Shootnick88: posts big blind $0.10
*** HOLE CARDS ***
12311985: folds 
sunsethero13: folds 
Docpete1: folds 
Muhlen9: raises $0.15 to $0.25
X-rayFeeling: folds 
Shootnick88: folds 
Uncalled bet ($0.15) returned to Muhlen9
Muhlen9 collected $0.25 from pot
Muhlen9: doesn't show hand 
*** SUMMARY ***
Total pot $0.25 | Rake $0 
Seat 1: sunsethero13 folded before Flop (didn't bet)
Seat 2: Docpete1 folded before Flop (didn't bet)
Seat 3: Muhlen9 (button) collected ($0.25)
Seat 4: X-rayFeeling (small blind) folded before Flop
Seat 5: Shootnick88 (big blind) folded before Flop
Seat 6: 12311985 folded before Flop (didn't bet)



PokerStars Hand #222946949847:  Hold'em No Limit ($0.05/$0.10 USD) - 2021/01/23 2:32:33 ET
Table 'Linzia' 6-max Seat #4 is the button
Seat 1: sunsethero13 ($13.53 in chips) 
Seat 2: Docpete1 ($7.66 in chips) 
Seat 3: Muhlen9 ($10.15 in chips) 
Seat 4: X-rayFeeling ($15.04 in chips) 
Seat 5: Shootnick88 ($10.05 in chips) 
Seat 6: 12311985 ($12.54 in chips) 
Shootnick88: posts small blind $0.05
12311985: posts big blind $0.10
*** HOLE CARDS ***
sunsethero13: raises $0.14 to $0.24
Docpete1: folds 
Muhlen9: folds 
X-rayFeeling: folds 
Shootnick88: folds 
12311985: folds 
Uncalled bet ($0.14) returned to sunsethero13
sunsethero13 collected $0.25 from pot
sunsethero13: doesn't show hand 
*** SUMMARY ***
Total pot $0.25 | Rake $0 
Seat 1: sunsethero13 collected ($0.25)
Seat 2: Docpete1 folded before Flop (didn't bet)
Seat 3: Muhlen9 folded before Flop (didn't bet)
Seat 4: X-rayFeeling (button) folded before Flop (didn't bet)
Seat 5: Shootnick88 (small blind) folded before Flop
Seat 6: 12311985 (big blind) folded before Flop



PokerStars Hand #222946954246:  Hold'em No Limit ($0.05/$0.10 USD) - 2021/01/23 2:32:52 ET
Table 'Linzia' 6-max Seat #5 is the button
Seat 1: sunsethero13 ($13.68 in chips) 
Seat 2: Docpete1 ($7.66 in chips) 
Seat 3: Muhlen9 ($10.15 in chips) 
Seat 4: X-rayFeeling ($15.04 in chips) 
Seat 5: Shootnick88 ($10 in chips) 
Seat 6: 12311985 ($12.44 in chips) 
12311985: posts small blind $0.05
sunsethero13: posts big blind $0.10
*** HOLE CARDS ***
Docpete1: folds 
Muhlen9: raises $0.15 to $0.25
X-rayFeeling: folds 
Shootnick88: folds 
12311985: folds 
sunsethero13: folds 
Uncalled bet ($0.15) returned to Muhlen9
Muhlen9 collected $0.25 from pot
Muhlen9: doesn't show hand 
*** SUMMARY ***
Total pot $0.25 | Rake $0 
Seat 1: sunsethero13 (big blind) folded before Flop
Seat 2: Docpete1 folded before Flop (didn't bet)
Seat 3: Muhlen9 collected ($0.25)
Seat 4: X-rayFeeling folded before Flop (didn't bet)
Seat 5: Shootnick88 (button) folded before Flop (didn't bet)
Seat 6: 12311985 (small blind) folded before Flop



PokerStars Hand #222946957024:  Hold'em No Limit ($0.05/$0.10 USD) - 2021/01/23 2:33:04 ET
Table 'Linzia' 6-max Seat #6 is the button
Seat 1: sunsethero13 ($13.58 in chips) 
Seat 2: Docpete1 ($7.66 in chips) 
Seat 3: Muhlen9 ($10.30 in chips) 
Seat 4: X-rayFeeling ($15.04 in chips) 
Seat 5: Shootnick88 ($10 in chips) 
Seat 6: 12311985 ($12.39 in chips) 
sunsethero13: posts small blind $0.05
Docpete1: posts big blind $0.10
*** HOLE CARDS ***
Muhlen9: folds 
X-rayFeeling: folds 
Shootnick88: raises $0.20 to $0.30
12311985: folds 
sunsethero13: calls $0.25
Docpete1: calls $0.20
*** FLOP *** [2h 2s 4c]
sunsethero13: checks 
Docpete1: checks 
Shootnick88: checks 
*** TURN *** [2h 2s 4c] [Js]
sunsethero13: checks 
Docpete1: checks 
Shootnick88: checks 
*** RIVER *** [2h 2s 4c Js] [7s]
sunsethero13: checks 
Docpete1: checks 
Shootnick88: checks 
*** SHOW DOWN ***
sunsethero13: shows [8d 8c] (two pair, Eights and Deuces)
Docpete1: mucks hand 
Shootnick88: mucks hand 
sunsethero13 collected $0.86 from pot
*** SUMMARY ***
Total pot $0.90 | Rake $0.04 
Board [2h 2s 4c Js 7s]
Seat 1: sunsethero13 (small blind) showed [8d 8c] and won ($0.86) with two pair, Eights and Deuces
Seat 2: Docpete1 (big blind) mucked
Seat 3: Muhlen9 folded before Flop (didn't bet)
Seat 4: X-rayFeeling folded before Flop (didn't bet)
Seat 5: Shootnick88 mucked
Seat 6: 12311985 (button) folded before Flop (didn't bet)



PokerStars Hand #222946969117:  Hold'em No Limit ($0.05/$0.10 USD) - 2021/01/23 2:33:55 ET
Table 'Linzia' 6-max Seat #1 is the button
Seat 1: sunsethero13 ($14.14 in chips) 
Seat 2: Docpete1 ($7.36 in chips) 
Seat 4: X-rayFeeling ($15.04 in chips) 
Seat 5: Shootnick88 ($10 in chips) 
Seat 6: 12311985 ($12.39 in chips) 
Docpete1: posts small blind $0.05
Muhlen9: is sitting out 
X-rayFeeling: posts big blind $0.10
*** HOLE CARDS ***
Shootnick88: folds 
12311985: folds 
sunsethero13: calls $0.10
Docpete1: folds 
X-rayFeeling: raises $0.30 to $0.40
sunsethero13: folds 
Uncalled bet ($0.30) returned to X-rayFeeling
X-rayFeeling collected $0.25 from pot
X-rayFeeling: doesn't show hand 
*** SUMMARY ***
Total pot $0.25 | Rake $0 
Seat 1: sunsethero13 (button) folded before Flop
Seat 2: Docpete1 (small blind) folded before Flop
Seat 4: X-rayFeeling (big blind) collected ($0.25)
Seat 5: Shootnick88 folded before Flop (didn't bet)
Seat 6: 12311985 folded before Flop (didn't bet)



PokerStars Hand #222946973601:  Hold'em No Limit ($0.05/$0.10 USD) - 2021/01/23 2:34:15 ET
Table 'Linzia' 6-max Seat #2 is the button
Seat 1: sunsethero13 ($14.04 in chips) 
Seat 2: Docpete1 ($7.31 in chips) 
Seat 4: X-rayFeeling ($15.19 in chips) 
Seat 5: Shootnick88 ($10 in chips) 
Seat 6: 12311985 ($12.39 in chips) 
X-rayFeeling: posts small blind $0.05
Shootnick88: posts big blind $0.10
*** HOLE CARDS ***
Muhlen9 leaves the table
12311985: folds 
sunsethero13: folds 
Rainlol joins the table at seat #3 
Docpete1: raises $0.20 to $0.30
X-rayFeeling: folds 
Shootnick88: calls $0.20
*** FLOP *** [6h 6c Ts]
Shootnick88: checks 
Docpete1: checks 
*** TURN *** [6h 6c Ts] [6s]
Shootnick88: checks 
Docpete1: bets $0.40
Shootnick88: folds 
Uncalled bet ($0.40) returned to Docpete1
Docpete1 collected $0.62 from pot
*** SUMMARY ***
Total pot $0.65 | Rake $0.03 
Board [6h 6c Ts 6s]
Seat 1: sunsethero13 folded before Flop (didn't bet)
Seat 2: Docpete1 (button) collected ($0.62)
Seat 4: X-rayFeeling (small blind) folded before Flop
Seat 5: Shootnick88 (big blind) folded on the Turn
Seat 6: 12311985 folded before Flop (didn't bet)



PokerStars Hand #222946981489:  Hold'em No Limit ($0.05/$0.10 USD) - 2021/01/23 2:34:48 ET
Table 'Linzia' 6-max Seat #4 is the button
Seat 1: sunsethero13 ($14.04 in chips) 
Seat 2: Docpete1 ($7.63 in chips) 
Seat 4: X-rayFeeling ($15.14 in chips) 
Seat 5: Shootnick88 ($10 in chips) 
Seat 6: 12311985 ($12.39 in chips) 
Shootnick88: posts small blind $0.05
12311985: posts big blind $0.10
Rainlol: sits out 
*** HOLE CARDS ***
sunsethero13: folds 
Docpete1: raises $0.20 to $0.30
X-rayFeeling: folds 
Shootnick88: folds 
12311985: folds 
Uncalled bet ($0.20) returned to Docpete1
Docpete1 collected $0.25 from pot
*** SUMMARY ***
Total pot $0.25 | Rake $0 
Seat 1: sunsethero13 folded before Flop (didn't bet)
Seat 2: Docpete1 collected ($0.25)
Seat 4: X-rayFeeling (button) folded before Flop (didn't bet)
Seat 5: Shootnick88 (small blind) folded before Flop
Seat 6: 12311985 (big blind) folded before Flop



PokerStars Hand #222946984378:  Hold'em No Limit ($0.05/$0.10 USD) - 2021/01/23 2:35:01 ET
Table 'Linzia' 6-max Seat #5 is the button
Seat 1: sunsethero13 ($14.04 in chips) 
Seat 2: Docpete1 ($7.78 in chips) 
Seat 4: X-rayFeeling ($15.14 in chips) 
Seat 5: Shootnick88 ($10 in chips) 
Seat 6: 12311985 ($12.29 in chips) 
12311985: posts small blind $0.05
sunsethero13: posts big blind $0.10
Rainlol: sits out 
*** HOLE CARDS ***
Docpete1: calls $0.10
X-rayFeeling: raises $0.21 to $0.31
Shootnick88: raises $0.69 to $1
12311985: folds 
sunsethero13: folds 
Docpete1: folds 
X-rayFeeling: folds 
Uncalled bet ($0.69) returned to Shootnick88
Shootnick88 collected $0.87 from pot
Shootnick88: doesn't show hand 
*** SUMMARY ***
Total pot $0.87 | Rake $0 
Seat 1: sunsethero13 (big blind) folded before Flop
Seat 2: Docpete1 folded before Flop
Seat 4: X-rayFeeling folded before Flop
Seat 5: Shootnick88 (button) collected ($0.87)
Seat 6: 12311985 (small blind) folded before Flop



PokerStars Hand #222946988951:  Hold'em No Limit ($0.05/$0.10 USD) - 2021/01/23 2:35:20 ET
Table 'Linzia' 6-max Seat #6 is the button
Seat 1: sunsethero13 ($13.94 in chips) 
Seat 2: Docpete1 ($7.68 in chips) 
Seat 4: X-rayFeeling ($14.83 in chips) 
Seat 5: Shootnick88 ($10.56 in chips) 
Seat 6: 12311985 ($12.24 in chips) 
sunsethero13: posts small blind $0.05
Docpete1: posts big blind $0.10
Rainlol: sits out 
*** HOLE CARDS ***
X-rayFeeling: folds 
Shootnick88: folds 
12311985: folds 
sunsethero13: raises $0.10 to $0.20
Docpete1: calls $0.10
*** FLOP *** [4h As Qh]
sunsethero13: checks 
Docpete1: bets $0.30
sunsethero13: folds 
Uncalled bet ($0.30) returned to Docpete1
Docpete1 collected $0.38 from pot
*** SUMMARY ***
Total pot $0.40 | Rake $0.02 
Board [4h As Qh]
Seat 1: sunsethero13 (small blind) folded on the Flop
Seat 2: Docpete1 (big blind) collected ($0.38)
Seat 4: X-rayFeeling folded before Flop (didn't bet)
Seat 5: Shootnick88 folded before Flop (didn't bet)
Seat 6: 12311985 (button) folded before Flop (didn't bet)



PokerStars Hand #222947000978:  Hold'em No Limit ($0.05/$0.10 USD) - 2021/01/23 2:36:12 ET
Table 'Linzia' 6-max Seat #1 is the button
Seat 1: sunsethero13 ($13.74 in chips) 
Seat 2: Docpete1 ($7.86 in chips) 
Seat 3: Rainlol ($10 in chips) 
Seat 4: X-rayFeeling ($14.83 in chips) 
Seat 5: Shootnick88 ($10.56 in chips) 
Seat 6: 12311985 ($12.24 in chips) 
Docpete1: posts small blind $0.05
Rainlol: posts big blind $0.10
*** HOLE CARDS ***
X-rayFeeling has timed out
X-rayFeeling: folds 
Shootnick88: raises $0.10 to $0.20
12311985: folds 
sunsethero13: folds 
Docpete1: folds 
Rainlol: folds 
Uncalled bet ($0.10) returned to Shootnick88
Shootnick88 collected $0.25 from pot
Shootnick88: doesn't show hand 
*** SUMMARY ***
Total pot $0.25 | Rake $0 
Seat 1: sunsethero13 (button) folded before Flop (didn't bet)
Seat 2: Docpete1 (small blind) folded before Flop
Seat 3: Rainlol (big blind) folded before Flop
Seat 4: X-rayFeeling folded before Flop (didn't bet)
Seat 5: Shootnick88 collected ($0.25)
Seat 6: 12311985 folded before Flop (didn't bet)



PokerStars Hand #222947008700:  Hold'em No Limit ($0.05/$0.10 USD) - 2021/01/23 2:36:45 ET
Table 'Linzia' 6-max Seat #2 is the button
Seat 1: sunsethero13 ($13.74 in chips) 
Seat 2: Docpete1 ($7.81 in chips) 
Seat 3: Rainlol ($9.90 in chips) 
Seat 4: X-rayFeeling ($14.83 in chips) 
Seat 5: Shootnick88 ($10.71 in chips) 
Seat 6: 12311985 ($12.24 in chips) 
Rainlol: posts small blind $0.05
X-rayFeeling: posts big blind $0.10
*** HOLE CARDS ***
Shootnick88: folds 
12311985: folds 
sunsethero13: folds 
Docpete1: raises $0.20 to $0.30
Rainlol: raises $0.60 to $0.90
X-rayFeeling: folds 
Docpete1: folds 
Uncalled bet ($0.60) returned to Rainlol
Rainlol collected $0.70 from pot
Rainlol: doesn't show hand 
*** SUMMARY ***
Total pot $0.70 | Rake $0 
Seat 1: sunsethero13 folded before Flop (didn't bet)
Seat 2: Docpete1 (button) folded before Flop
Seat 3: Rainlol (small blind) collected ($0.70)
Seat 4: X-rayFeeling (big blind) folded before Flop
Seat 5: Shootnick88 folded before Flop (didn't bet)
Seat 6: 12311985 folded before Flop (didn't bet)



PokerStars Hand #222947017216:  Hold'em No Limit ($0.05/$0.10 USD) - 2021/01/23 2:37:22 ET
Table 'Linzia' 6-max Seat #3 is the button
Seat 1: sunsethero13 ($13.74 in chips) 
Seat 2: Docpete1 ($7.51 in chips) 
Seat 3: Rainlol ($10.30 in chips) 
Seat 4: X-rayFeeling ($14.73 in chips) 
Seat 5: Shootnick88 ($10.71 in chips) 
Seat 6: 12311985 ($12.24 in chips) 
X-rayFeeling: posts small blind $0.05
Shootnick88: posts big blind $0.10
*** HOLE CARDS ***
12311985: raises $0.15 to $0.25
sunsethero13: folds 
Docpete1: folds 
Rainlol: folds 
X-rayFeeling: folds 
Shootnick88: folds 
Uncalled bet ($0.15) returned to 12311985
12311985 collected $0.25 from pot
12311985: doesn't show hand 
*** SUMMARY ***
Total pot $0.25 | Rake $0 
Seat 1: sunsethero13 folded before Flop (didn't bet)
Seat 2: Docpete1 folded before Flop (didn't bet)
Seat 3: Rainlol (button) folded before Flop (didn't bet)
Seat 4: X-rayFeeling (small blind) folded before Flop
Seat 5: Shootnick88 (big blind) folded before Flop
Seat 6: 12311985 collected ($0.25)



PokerStars Hand #222947020262:  Hold'em No Limit ($0.05/$0.10 USD) - 2021/01/23 2:37:36 ET
Table 'Linzia' 6-max Seat #4 is the button
Seat 1: sunsethero13 ($13.74 in chips) 
Seat 2: Docpete1 ($7.51 in chips) 
Seat 3: Rainlol ($10.30 in chips) 
Seat 4: X-rayFeeling ($14.68 in chips) 
Seat 5: Shootnick88 ($10.61 in chips) 
Seat 6: 12311985 ($12.39 in chips) 
Shootnick88: posts small blind $0.05
12311985: posts big blind $0.10
*** HOLE CARDS ***
sunsethero13: folds 
Docpete1: raises $0.20 to $0.30
Rainlol: folds 
X-rayFeeling: folds 
Shootnick88: folds 
12311985: calls $0.20
*** FLOP *** [7h 3d 7s]
12311985: checks 
Docpete1: bets $0.40
12311985: folds 
Uncalled bet ($0.40) returned to Docpete1
Docpete1 collected $0.62 from pot
*** SUMMARY ***
Total pot $0.65 | Rake $0.03 
Board [7h 3d 7s]
Seat 1: sunsethero13 folded before Flop (didn't bet)
Seat 2: Docpete1 collected ($0.62)
Seat 3: Rainlol folded before Flop (didn't bet)
Seat 4: X-rayFeeling (button) folded before Flop (didn't bet)
Seat 5: Shootnick88 (small blind) folded before Flop
Seat 6: 12311985 (big blind) folded on the Flop



PokerStars Hand #222947029128:  Hold'em No Limit ($0.05/$0.10 USD) - 2021/01/23 2:38:14 ET
Table 'Linzia' 6-max Seat #5 is the button
Seat 1: sunsethero13 ($13.74 in chips) 
Seat 2: Docpete1 ($7.83 in chips) 
Seat 3: Rainlol ($10.30 in chips) 
Seat 5: Shootnick88 ($10.56 in chips) 
Seat 6: 12311985 ($12.09 in chips) 
12311985: posts small blind $0.05
sunsethero13: posts big blind $0.10
*** HOLE CARDS ***
Docpete1: folds 
Rainlol: folds 
Shootnick88: folds 
12311985: folds 
Uncalled bet ($0.05) returned to sunsethero13
sunsethero13 collected $0.10 from pot
sunsethero13: doesn't show hand 
*** SUMMARY ***
Total pot $0.10 | Rake $0 
Seat 1: sunsethero13 (big blind) collected ($0.10)
Seat 2: Docpete1 folded before Flop (didn't bet)
Seat 3: Rainlol folded before Flop (didn't bet)
Seat 5: Shootnick88 (button) folded before Flop (didn't bet)
Seat 6: 12311985 (small blind) folded before Flop



PokerStars Hand #222947032005:  Hold'em No Limit ($0.05/$0.10 USD) - 2021/01/23 2:38:27 ET
Table 'Linzia' 6-max Seat #6 is the button
Seat 1: sunsethero13 ($13.79 in chips) 
Seat 2: Docpete1 ($7.83 in chips) 
Seat 3: Rainlol ($10.30 in chips) 
Seat 5: Shootnick88 ($10.56 in chips) 
Seat 6: 12311985 ($12.04 in chips) 
sunsethero13: posts small blind $0.05
Docpete1: posts big blind $0.10
*** HOLE CARDS ***
Rainlol: folds 
Shootnick88: folds 
12311985: folds 
sunsethero13: folds 
Uncalled bet ($0.05) returned to Docpete1
Docpete1 collected $0.10 from pot
*** SUMMARY ***
Total pot $0.10 | Rake $0 
Seat 1: sunsethero13 (small blind) folded before Flop
Seat 2: Docpete1 (big blind) collected ($0.10)
Seat 3: Rainlol folded before Flop (didn't bet)
Seat 5: Shootnick88 folded before Flop (didn't bet)
Seat 6: 12311985 (button) folded before Flop (didn't bet)



PokerStars Hand #222947034044:  Hold'em No Limit ($0.05/$0.10 USD) - 2021/01/23 2:38:36 ET
Table 'Linzia' 6-max Seat #1 is the button
Seat 1: sunsethero13 ($13.74 in chips) 
Seat 2: Docpete1 ($7.88 in chips) 
Seat 3: Rainlol ($10.30 in chips) 
Seat 5: Shootnick88 ($10.56 in chips) 
Seat 6: 12311985 ($12.04 in chips) 
Docpete1: posts small blind $0.05
Rainlol: posts big blind $0.10
*** HOLE CARDS ***
Shootnick88: folds 
12311985: folds 
sunsethero13: raises $0.20 to $0.30
Docpete1: folds 
Rainlol: folds 
Uncalled bet ($0.20) returned to sunsethero13
sunsethero13 collected $0.25 from pot
sunsethero13: doesn't show hand 
*** SUMMARY ***
Total pot $0.25 | Rake $0 
Seat 1: sunsethero13 (button) collected ($0.25)
Seat 2: Docpete1 (small blind) folded before Flop
Seat 3: Rainlol (big blind) folded before Flop
Seat 5: Shootnick88 folded before Flop (didn't bet)
Seat 6: 12311985 folded before Flop (didn't bet)



PokerStars Hand #222947037061:  Hold'em No Limit ($0.05/$0.10 USD) - 2021/01/23 2:38:49 ET
Table 'Linzia' 6-max Seat #2 is the button
Seat 1: sunsethero13 ($13.89 in chips) 
Seat 2: Docpete1 ($7.83 in chips) 
Seat 3: Rainlol ($10.20 in chips) 
Seat 5: Shootnick88 ($10.56 in chips) 
Seat 6: 12311985 ($12.04 in chips) 
Rainlol: posts small blind $0.05
Shootnick88: posts big blind $0.10
*** HOLE CARDS ***
12311985: folds 
sunsethero13: raises $0.14 to $0.24
Docpete1: raises $0.14 to $0.38
Rainlol: calls $0.33
Shootnick88: folds 
sunsethero13: calls $0.14
*** FLOP *** [Jc 4d Jd]
Rainlol: checks 
sunsethero13: checks 
Docpete1: checks 
*** TURN *** [Jc 4d Jd] [Jh]
Rainlol: bets $0.40
sunsethero13: folds 
Docpete1: folds 
Uncalled bet ($0.40) returned to Rainlol
Rainlol collected $1.18 from pot
Rainlol: doesn't show hand 
*** SUMMARY ***
Total pot $1.24 | Rake $0.06 
Board [Jc 4d Jd Jh]
Seat 1: sunsethero13 folded on the Turn
Seat 2: Docpete1 (button) folded on the Turn
Seat 3: Rainlol (small blind) collected ($1.18)
Seat 5: Shootnick88 (big blind) folded before Flop
Seat 6: 12311985 folded before Flop (didn't bet)



PokerStars Hand #222947051797:  Hold'em No Limit ($0.05/$0.10 USD) - 2021/01/23 2:39:52 ET
Table 'Linzia' 6-max Seat #3 is the button
Seat 1: sunsethero13 ($13.51 in chips) 
Seat 2: Docpete1 ($7.45 in chips) 
Seat 3: Rainlol ($11 in chips) 
Seat 5: Shootnick88 ($10.46 in chips) 
Seat 6: 12311985 ($12.04 in chips) 
Shootnick88: posts small blind $0.05
12311985: posts big blind $0.10
*** HOLE CARDS ***
sunsethero13: folds 
Docpete1: folds 
Rainlol: raises $0.20 to $0.30
Shootnick88: folds 
12311985: folds 
Uncalled bet ($0.20) returned to Rainlol
Rainlol collected $0.25 from pot
Rainlol: doesn't show hand 
*** SUMMARY ***
Total pot $0.25 | Rake $0 
Seat 1: sunsethero13 folded before Flop (didn't bet)
Seat 2: Docpete1 folded before Flop (didn't bet)
Seat 3: Rainlol (button) collected ($0.25)
Seat 5: Shootnick88 (small blind) folded before Flop
Seat 6: 12311985 (big blind) folded before Flop



PokerStars Hand #222947058190:  Hold'em No Limit ($0.05/$0.10 USD) - 2021/01/23 2:40:20 ET
Table 'Linzia' 6-max Seat #5 is the button
Seat 1: sunsethero13 ($13.51 in chips) 
Seat 2: Docpete1 ($7.45 in chips) 
Seat 3: Rainlol ($11.15 in chips) 
Seat 5: Shootnick88 ($10.41 in chips) 
Seat 6: 12311985 ($11.94 in chips) 
12311985: posts small blind $0.05
sunsethero13: posts big blind $0.10
X-rayFeeling: sits out 
*** HOLE CARDS ***
Docpete1: folds 
Rainlol: folds 
Shootnick88: raises $0.20 to $0.30
12311985: folds 
sunsethero13: folds 
Uncalled bet ($0.20) returned to Shootnick88
Shootnick88 collected $0.25 from pot
Shootnick88: doesn't show hand 
*** SUMMARY ***
Total pot $0.25 | Rake $0 
Seat 1: sunsethero13 (big blind) folded before Flop
Seat 2: Docpete1 folded before Flop (didn't bet)
Seat 3: Rainlol folded before Flop (didn't bet)
Seat 5: Shootnick88 (button) collected ($0.25)
Seat 6: 12311985 (small blind) folded before Flop



PokerStars Hand #222947060963:  Hold'em No Limit ($0.05/$0.10 USD) - 2021/01/23 2:40:32 ET
Table 'Linzia' 6-max Seat #6 is the button
Seat 1: sunsethero13 ($13.41 in chips) 
Seat 2: Docpete1 ($7.45 in chips) 
Seat 3: Rainlol ($11.15 in chips) 
Seat 5: Shootnick88 ($10.56 in chips) 
Seat 6: 12311985 ($11.89 in chips) 
sunsethero13: posts small blind $0.05
Docpete1: posts big blind $0.10
X-rayFeeling: sits out 
*** HOLE CARDS ***
Rainlol: folds 
Shootnick88: folds 
12311985: raises $0.20 to $0.30
sunsethero13: folds 
Docpete1: folds 
Uncalled bet ($0.20) returned to 12311985
12311985 collected $0.25 from pot
12311985: doesn't show hand 
*** SUMMARY ***
Total pot $0.25 | Rake $0 
Seat 1: sunsethero13 (small blind) folded before Flop
Seat 2: Docpete1 (big blind) folded before Flop
Seat 3: Rainlol folded before Flop (didn't bet)
Seat 5: Shootnick88 folded before Flop (didn't bet)
Seat 6: 12311985 (button) collected ($0.25)



PokerStars Hand #222947065047:  Hold'em No Limit ($0.05/$0.10 USD) - 2021/01/23 2:40:50 ET
Table 'Linzia' 6-max Seat #1 is the button
Seat 1: sunsethero13 ($13.36 in chips) 
Seat 2: Docpete1 ($7.35 in chips) 
Seat 3: Rainlol ($11.15 in chips) 
Seat 5: Shootnick88 ($10.56 in chips) 
Seat 6: 12311985 ($12.04 in chips) 
Docpete1: posts small blind $0.05
Rainlol: posts big blind $0.10
X-rayFeeling: sits out 
*** HOLE CARDS ***
Shootnick88: raises $0.20 to $0.30
12311985: raises $0.60 to $0.90
sunsethero13: folds 
Docpete1: folds 
Rainlol: folds 
Shootnick88: folds 
Uncalled bet ($0.60) returned to 12311985
12311985 collected $0.75 from pot
12311985: doesn't show hand 
*** SUMMARY ***
Total pot $0.75 | Rake $0 
Seat 1: sunsethero13 (button) folded before Flop (didn't bet)
Seat 2: Docpete1 (small blind) folded before Flop
Seat 3: Rainlol (big blind) folded before Flop
Seat 5: Shootnick88 folded before Flop
Seat 6: 12311985 collected ($0.75)



PokerStars Hand #222947069511:  Hold'em No Limit ($0.05/$0.10 USD) - 2021/01/23 2:41:09 ET
Table 'Linzia' 6-max Seat #2 is the button
Seat 1: sunsethero13 ($13.36 in chips) 
Seat 2: Docpete1 ($7.30 in chips) 
Seat 3: Rainlol ($11.05 in chips) 
Seat 4: X-rayFeeling ($14.68 in chips) 
Seat 5: Shootnick88 ($10.26 in chips) 
Seat 6: 12311985 ($12.49 in chips) 
Rainlol: posts small blind $0.05
X-rayFeeling: posts big blind $0.10
*** HOLE CARDS ***
Shootnick88: folds 
12311985: folds 
sunsethero13: folds 
Docpete1 has timed out
Docpete1: folds 
Rainlol: raises $0.20 to $0.30
X-rayFeeling: folds 
Uncalled bet ($0.20) returned to Rainlol
Rainlol collected $0.20 from pot
Rainlol: doesn't show hand 
*** SUMMARY ***
Total pot $0.20 | Rake $0 
Seat 1: sunsethero13 folded before Flop (didn't bet)
Seat 2: Docpete1 (button) folded before Flop (didn't bet)
Seat 3: Rainlol (small blind) collected ($0.20)
Seat 4: X-rayFeeling (big blind) folded before Flop
Seat 5: Shootnick88 folded before Flop (didn't bet)
Seat 6: 12311985 folded before Flop (didn't bet)



PokerStars Hand #222947077524:  Hold'em No Limit ($0.05/$0.10 USD) - 2021/01/23 2:41:44 ET
Table 'Linzia' 6-max Seat #3 is the button
Seat 1: sunsethero13 ($13.36 in chips) 
Seat 3: Rainlol ($11.15 in chips) 
Seat 4: X-rayFeeling ($14.58 in chips) 
Seat 5: Shootnick88 ($10.26 in chips) 
Seat 6: 12311985 ($12.49 in chips) 
X-rayFeeling: posts small blind $0.05
Shootnick88: posts big blind $0.10
*** HOLE CARDS ***
Docpete1 is disconnected 
12311985: raises $0.15 to $0.25
sunsethero13: folds 
Rainlol: folds 
X-rayFeeling: folds 
Shootnick88: folds 
Uncalled bet ($0.15) returned to 12311985
12311985 collected $0.25 from pot
12311985: doesn't show hand 
*** SUMMARY ***
Total pot $0.25 | Rake $0 
Seat 1: sunsethero13 folded before Flop (didn't bet)
Seat 3: Rainlol (button) folded before Flop (didn't bet)
Seat 4: X-rayFeeling (small blind) folded before Flop
Seat 5: Shootnick88 (big blind) folded before Flop
Seat 6: 12311985 collected ($0.25)



PokerStars Hand #222947079986:  Hold'em No Limit ($0.05/$0.10 USD) - 2021/01/23 2:41:54 ET
Table 'Linzia' 6-max Seat #4 is the button
Seat 1: sunsethero13 ($13.36 in chips) 
Seat 2: Docpete1 ($7.30 in chips) 
Seat 3: Rainlol ($11.15 in chips) 
Seat 4: X-rayFeeling ($14.53 in chips) 
Seat 5: Shootnick88 ($10.16 in chips) 
Seat 6: 12311985 ($12.64 in chips) 
Shootnick88: posts small blind $0.05
12311985: posts big blind $0.10
*** HOLE CARDS ***
sunsethero13: folds 
Docpete1: folds 
Rainlol: raises $0.20 to $0.30
X-rayFeeling: calls $0.30
Shootnick88: folds 
12311985: folds 
*** FLOP *** [Jc 2s 3d]
Rainlol: bets $0.30
X-rayFeeling: calls $0.30
*** TURN *** [Jc 2s 3d] [9s]
Rainlol: checks 
X-rayFeeling: bets $0.77
Rainlol: folds 
Uncalled bet ($0.77) returned to X-rayFeeling
X-rayFeeling collected $1.29 from pot
X-rayFeeling: doesn't show hand 
*** SUMMARY ***
Total pot $1.35 | Rake $0.06 
Board [Jc 2s 3d 9s]
Seat 1: sunsethero13 folded before Flop (didn't bet)
Seat 2: Docpete1 folded before Flop (didn't bet)
Seat 3: Rainlol folded on the Turn
Seat 4: X-rayFeeling (button) collected ($1.29)
Seat 5: Shootnick88 (small blind) folded before Flop
Seat 6: 12311985 (big blind) folded before Flop



PokerStars Hand #222947088714:  Hold'em No Limit ($0.05/$0.10 USD) - 2021/01/23 2:42:32 ET
Table 'Linzia' 6-max Seat #5 is the button
Seat 1: sunsethero13 ($13.36 in chips) 
Seat 2: Docpete1 ($7.30 in chips) 
Seat 3: Rainlol ($10.55 in chips) 
Seat 4: X-rayFeeling ($15.22 in chips) 
Seat 5: Shootnick88 ($10.11 in chips) 
Seat 6: 12311985 ($12.54 in chips) 
12311985: posts small blind $0.05
sunsethero13: posts big blind $0.10
*** HOLE CARDS ***
Docpete1: folds 
Rainlol: folds 
X-rayFeeling: folds 
Shootnick88: folds 
12311985: folds 
Uncalled bet ($0.05) returned to sunsethero13
sunsethero13 collected $0.10 from pot
sunsethero13: doesn't show hand 
*** SUMMARY ***
Total pot $0.10 | Rake $0 
Seat 1: sunsethero13 (big blind) collected ($0.10)
Seat 2: Docpete1 folded before Flop (didn't bet)
Seat 3: Rainlol folded before Flop (didn't bet)
Seat 4: X-rayFeeling folded before Flop (didn't bet)
Seat 5: Shootnick88 (button) folded before Flop (didn't bet)
Seat 6: 12311985 (small blind) folded before Flop



PokerStars Hand #222947092461:  Hold'em No Limit ($0.05/$0.10 USD) - 2021/01/23 2:42:48 ET
Table 'Linzia' 6-max Seat #6 is the button
Seat 1: sunsethero13 ($13.41 in chips) 
Seat 2: Docpete1 ($7.30 in chips) 
Seat 3: Rainlol ($10.55 in chips) 
Seat 4: X-rayFeeling ($15.22 in chips) 
Seat 5: Shootnick88 ($10.11 in chips) 
Seat 6: 12311985 ($12.49 in chips) 
sunsethero13: posts small blind $0.05
Docpete1: posts big blind $0.10
*** HOLE CARDS ***
Rainlol: folds 
X-rayFeeling: folds 
Shootnick88: raises $0.20 to $0.30
12311985: raises $0.60 to $0.90
sunsethero13: folds 
Docpete1: folds 
Shootnick88: folds 
Uncalled bet ($0.60) returned to 12311985
12311985 collected $0.75 from pot
12311985: doesn't show hand 
*** SUMMARY ***
Total pot $0.75 | Rake $0 
Seat 1: sunsethero13 (small blind) folded before Flop
Seat 2: Docpete1 (big blind) folded before Flop
Seat 3: Rainlol folded before Flop (didn't bet)
Seat 4: X-rayFeeling folded before Flop (didn't bet)
Seat 5: Shootnick88 folded before Flop
Seat 6: 12311985 (button) collected ($0.75)



PokerStars Hand #222947097343:  Hold'em No Limit ($0.05/$0.10 USD) - 2021/01/23 2:43:09 ET
Table 'Linzia' 6-max Seat #1 is the button
Seat 1: sunsethero13 ($13.36 in chips) 
Seat 2: Docpete1 ($7.20 in chips) 
Seat 3: Rainlol ($10.55 in chips) 
Seat 4: X-rayFeeling ($15.22 in chips) 
Seat 5: Shootnick88 ($10 in chips) 
Seat 6: 12311985 ($12.94 in chips) 
Docpete1: posts small blind $0.05
Rainlol: posts big blind $0.10
*** HOLE CARDS ***
X-rayFeeling: folds 
Shootnick88: raises $0.20 to $0.30
12311985: folds 
sunsethero13: calls $0.30
Docpete1: calls $0.25
Rainlol: calls $0.20
*** FLOP *** [4c Js 9d]
Docpete1: checks 
Rainlol: checks 
Shootnick88: checks 
sunsethero13: checks 
*** TURN *** [4c Js 9d] [9c]
Docpete1: checks 
Rainlol: checks 
Shootnick88: checks 
sunsethero13: bets $0.58
Docpete1: folds 
Rainlol: folds 
Shootnick88: folds 
Uncalled bet ($0.58) returned to sunsethero13
sunsethero13 collected $1.15 from pot
sunsethero13: doesn't show hand 
*** SUMMARY ***
Total pot $1.20 | Rake $0.05 
Board [4c Js 9d 9c]
Seat 1: sunsethero13 (button) collected ($1.15)
Seat 2: Docpete1 (small blind) folded on the Turn
Seat 3: Rainlol (big blind) folded on the Turn
Seat 4: X-rayFeeling folded before Flop (didn't bet)
Seat 5: Shootnick88 folded on the Turn
Seat 6: 12311985 folded before Flop (didn't bet)



PokerStars Hand #222947107736:  Hold'em No Limit ($0.05/$0.10 USD) - 2021/01/23 2:43:54 ET
Table 'Linzia' 6-max Seat #2 is the button
Seat 1: sunsethero13 ($14.21 in chips) 
Seat 2: Docpete1 ($6.90 in chips) 
Seat 3: Rainlol ($10.25 in chips) 
Seat 4: X-rayFeeling ($15.22 in chips) 
Seat 5: Shootnick88 ($10 in chips) 
Seat 6: 12311985 ($12.94 in chips) 
Rainlol: posts small blind $0.05
X-rayFeeling: posts big blind $0.10
*** HOLE CARDS ***
Shootnick88: folds 
12311985: folds 
sunsethero13: calls $0.10
Docpete1: calls $0.10
Rainlol: calls $0.05
X-rayFeeling: checks 
*** FLOP *** [Kd 4s 6d]
Rainlol: checks 
X-rayFeeling: checks 
sunsethero13: checks 
Docpete1: checks 
*** TURN *** [Kd 4s 6d] [2d]
Rainlol: checks 
X-rayFeeling: checks 
sunsethero13: checks 
Docpete1: checks 
*** RIVER *** [Kd 4s 6d 2d] [9c]
Rainlol: checks 
X-rayFeeling: checks 
sunsethero13: checks 
Docpete1: checks 
*** SHOW DOWN ***
Rainlol: shows [Ts 5s] (high card King)
X-rayFeeling: mucks hand 
sunsethero13: shows [3c As] (high card Ace)
Docpete1: shows [4c Ac] (a pair of Fours)
Docpete1 collected $0.38 from pot
*** SUMMARY ***
Total pot $0.40 | Rake $0.02 
Board [Kd 4s 6d 2d 9c]
Seat 1: sunsethero13 showed [3c As] and lost with high card Ace
Seat 2: Docpete1 (button) showed [4c Ac] and won ($0.38) with a pair of Fours
Seat 3: Rainlol (small blind) showed [Ts 5s] and lost with high card King
Seat 4: X-rayFeeling (big blind) mucked
Seat 5: Shootnick88 folded before Flop (didn't bet)
Seat 6: 12311985 folded before Flop (didn't bet)



PokerStars Hand #222947122152:  Hold'em No Limit ($0.05/$0.10 USD) - 2021/01/23 2:44:57 ET
Table 'Linzia' 6-max Seat #3 is the button
Seat 1: sunsethero13 ($14.11 in chips) 
Seat 2: Docpete1 ($7.18 in chips) 
Seat 3: Rainlol ($10.15 in chips) 
Seat 4: X-rayFeeling ($15.12 in chips) 
Seat 5: Shootnick88 ($10 in chips) 
Seat 6: 12311985 ($12.94 in chips) 
X-rayFeeling: posts small blind $0.05
Shootnick88: posts big blind $0.10
*** HOLE CARDS ***
12311985: folds 
sunsethero13: folds 
Docpete1: folds 
Rainlol: folds 
X-rayFeeling: raises $0.20 to $0.30
Shootnick88: folds 
Uncalled bet ($0.20) returned to X-rayFeeling
X-rayFeeling collected $0.20 from pot
X-rayFeeling: doesn't show hand 
*** SUMMARY ***
Total pot $0.20 | Rake $0 
Seat 1: sunsethero13 folded before Flop (didn't bet)
Seat 2: Docpete1 folded before Flop (didn't bet)
Seat 3: Rainlol (button) folded before Flop (didn't bet)
Seat 4: X-rayFeeling (small blind) collected ($0.20)
Seat 5: Shootnick88 (big blind) folded before Flop
Seat 6: 12311985 folded before Flop (didn't bet)



PokerStars Hand #222947126324:  Hold'em No Limit ($0.05/$0.10 USD) - 2021/01/23 2:45:14 ET
Table 'Linzia' 6-max Seat #4 is the button
Seat 1: sunsethero13 ($14.11 in chips) 
Seat 2: Docpete1 ($7.18 in chips) 
Seat 3: Rainlol ($10.15 in chips) 
Seat 4: X-rayFeeling ($15.22 in chips) 
Seat 5: Shootnick88 ($10 in chips) 
Seat 6: 12311985 ($12.94 in chips) 
Shootnick88: posts small blind $0.05
12311985: posts big blind $0.10
*** HOLE CARDS ***
sunsethero13: raises $0.10 to $0.20
Docpete1: folds 
Rainlol: folds 
X-rayFeeling: folds 
Shootnick88: folds 
12311985: folds 
Uncalled bet ($0.10) returned to sunsethero13
sunsethero13 collected $0.25 from pot
sunsethero13: doesn't show hand 
*** SUMMARY ***
Total pot $0.25 | Rake $0 
Seat 1: sunsethero13 collected ($0.25)
Seat 2: Docpete1 folded before Flop (didn't bet)
Seat 3: Rainlol folded before Flop (didn't bet)
Seat 4: X-rayFeeling (button) folded before Flop (didn't bet)
Seat 5: Shootnick88 (small blind) folded before Flop
Seat 6: 12311985 (big blind) folded before Flop



PokerStars Hand #222947129527:  Hold'em No Limit ($0.05/$0.10 USD) - 2021/01/23 2:45:28 ET
Table 'Linzia' 6-max Seat #5 is the button
Seat 1: sunsethero13 ($14.26 in chips) 
Seat 2: Docpete1 ($7.18 in chips) 
Seat 3: Rainlol ($10.15 in chips) 
Seat 4: X-rayFeeling ($15.22 in chips) 
Seat 5: Shootnick88 ($10 in chips) 
Seat 6: 12311985 ($12.84 in chips) 
12311985: posts small blind $0.05
sunsethero13: posts big blind $0.10
*** HOLE CARDS ***
Docpete1: folds 
Rainlol: folds 
X-rayFeeling: folds 
Shootnick88: folds 
12311985: folds 
Uncalled bet ($0.05) returned to sunsethero13
sunsethero13 collected $0.10 from pot
sunsethero13: doesn't show hand 
*** SUMMARY ***
Total pot $0.10 | Rake $0 
Seat 1: sunsethero13 (big blind) collected ($0.10)
Seat 2: Docpete1 folded before Flop (didn't bet)
Seat 3: Rainlol folded before Flop (didn't bet)
Seat 4: X-rayFeeling folded before Flop (didn't bet)
Seat 5: Shootnick88 (button) folded before Flop (didn't bet)
Seat 6: 12311985 (small blind) folded before Flop



PokerStars Hand #222947132279:  Hold'em No Limit ($0.05/$0.10 USD) - 2021/01/23 2:45:40 ET
Table 'Linzia' 6-max Seat #6 is the button
Seat 1: sunsethero13 ($14.31 in chips) 
Seat 2: Docpete1 ($7.18 in chips) 
Seat 3: Rainlol ($10.15 in chips) 
Seat 4: X-rayFeeling ($15.22 in chips) 
Seat 5: Shootnick88 ($10 in chips) 
Seat 6: 12311985 ($12.79 in chips) 
sunsethero13: posts small blind $0.05
Docpete1: posts big blind $0.10
*** HOLE CARDS ***
Rainlol: folds 
X-rayFeeling: folds 
Shootnick88: folds 
12311985: folds 
sunsethero13: folds 
Uncalled bet ($0.05) returned to Docpete1
Docpete1 collected $0.10 from pot
*** SUMMARY ***
Total pot $0.10 | Rake $0 
Seat 1: sunsethero13 (small blind) folded before Flop
Seat 2: Docpete1 (big blind) collected ($0.10)
Seat 3: Rainlol folded before Flop (didn't bet)
Seat 4: X-rayFeeling folded before Flop (didn't bet)
Seat 5: Shootnick88 folded before Flop (didn't bet)
Seat 6: 12311985 (button) folded before Flop (didn't bet)



PokerStars Hand #222947137037:  Hold'em No Limit ($0.05/$0.10 USD) - 2021/01/23 2:46:00 ET
Table 'Linzia' 6-max Seat #1 is the button
Seat 1: sunsethero13 ($14.26 in chips) 
Seat 2: Docpete1 ($7.23 in chips) 
Seat 3: Rainlol ($10.15 in chips) 
Seat 4: X-rayFeeling ($15.22 in chips) 
Seat 5: Shootnick88 ($10 in chips) 
Seat 6: 12311985 ($12.79 in chips) 
Docpete1: posts small blind $0.05
Rainlol: posts big blind $0.10
*** HOLE CARDS ***
X-rayFeeling: folds 
Shootnick88: raises $0.20 to $0.30
12311985: folds 
sunsethero13: folds 
Docpete1: folds 
Rainlol: folds 
Uncalled bet ($0.20) returned to Shootnick88
Shootnick88 collected $0.25 from pot
Shootnick88: doesn't show hand 
*** SUMMARY ***
Total pot $0.25 | Rake $0 
Seat 1: sunsethero13 (button) folded before Flop (didn't bet)
Seat 2: Docpete1 (small blind) folded before Flop
Seat 3: Rainlol (big blind) folded before Flop
Seat 4: X-rayFeeling folded before Flop (didn't bet)
Seat 5: Shootnick88 collected ($0.25)
Seat 6: 12311985 folded before Flop (didn't bet)



PokerStars Hand #222947141379:  Hold'em No Limit ($0.05/$0.10 USD) - 2021/01/23 2:46:18 ET
Table 'Linzia' 6-max Seat #2 is the button
Seat 1: sunsethero13 ($14.26 in chips) 
Seat 2: Docpete1 ($7.18 in chips) 
Seat 3: Rainlol ($10.05 in chips) 
Seat 4: X-rayFeeling ($15.22 in chips) 
Seat 5: Shootnick88 ($10.15 in chips) 
Seat 6: 12311985 ($12.79 in chips) 
Rainlol: posts small blind $0.05
X-rayFeeling: posts big blind $0.10
*** HOLE CARDS ***
Shootnick88: raises $0.20 to $0.30
12311985: folds 
sunsethero13: folds 
Docpete1: folds 
Rainlol: raises $0.70 to $1
X-rayFeeling: folds 
Shootnick88: calls $0.70
*** FLOP *** [6h 7d 3c]
Rainlol: bets $0.70
Shootnick88: calls $0.70
*** TURN *** [6h 7d 3c] [7c]
Rainlol: bets $2.23
Shootnick88: folds 
Uncalled bet ($2.23) returned to Rainlol
Rainlol collected $3.34 from pot
Rainlol: doesn't show hand 
*** SUMMARY ***
Total pot $3.50 | Rake $0.16 
Board [6h 7d 3c 7c]
Seat 1: sunsethero13 folded before Flop (didn't bet)
Seat 2: Docpete1 (button) folded before Flop (didn't bet)
Seat 3: Rainlol (small blind) collected ($3.34)
Seat 4: X-rayFeeling (big blind) folded before Flop
Seat 5: Shootnick88 folded on the Turn
Seat 6: 12311985 folded before Flop (didn't bet)



PokerStars Hand #222947150152:  Hold'em No Limit ($0.05/$0.10 USD) - 2021/01/23 2:46:55 ET
Table 'Linzia' 6-max Seat #3 is the button
Seat 1: sunsethero13 ($14.26 in chips) 
Seat 2: Docpete1 ($7.18 in chips) 
Seat 3: Rainlol ($11.69 in chips) 
Seat 4: X-rayFeeling ($15.12 in chips) 
Seat 5: Shootnick88 ($10 in chips) 
Seat 6: 12311985 ($12.79 in chips) 
X-rayFeeling: posts small blind $0.05
Shootnick88: posts big blind $0.10
*** HOLE CARDS ***
12311985: raises $0.15 to $0.25
sunsethero13: folds 
Docpete1: folds 
Rainlol: folds 
X-rayFeeling: folds 
Shootnick88: folds 
Uncalled bet ($0.15) returned to 12311985
12311985 collected $0.25 from pot
12311985: doesn't show hand 
*** SUMMARY ***
Total pot $0.25 | Rake $0 
Seat 1: sunsethero13 folded before Flop (didn't bet)
Seat 2: Docpete1 folded before Flop (didn't bet)
Seat 3: Rainlol (button) folded before Flop (didn't bet)
Seat 4: X-rayFeeling (small blind) folded before Flop
Seat 5: Shootnick88 (big blind) folded before Flop
Seat 6: 12311985 collected ($0.25)



PokerStars Hand #222947152856:  Hold'em No Limit ($0.05/$0.10 USD) - 2021/01/23 2:47:07 ET
Table 'Linzia' 6-max Seat #4 is the button
Seat 1: sunsethero13 ($14.26 in chips) 
Seat 2: Docpete1 ($7.18 in chips) 
Seat 3: Rainlol ($11.69 in chips) 
Seat 4: X-rayFeeling ($15.07 in chips) 
Seat 5: Shootnick88 ($10 in chips) 
Seat 6: 12311985 ($12.94 in chips) 
Shootnick88: posts small blind $0.05
12311985: posts big blind $0.10
*** HOLE CARDS ***
sunsethero13: folds 
Docpete1: raises $0.20 to $0.30
Rainlol: folds 
X-rayFeeling: folds 
Shootnick88: folds 
12311985: folds 
Uncalled bet ($0.20) returned to Docpete1
Docpete1 collected $0.25 from pot
*** SUMMARY ***
Total pot $0.25 | Rake $0 
Seat 1: sunsethero13 folded before Flop (didn't bet)
Seat 2: Docpete1 collected ($0.25)
Seat 3: Rainlol folded before Flop (didn't bet)
Seat 4: X-rayFeeling (button) folded before Flop (didn't bet)
Seat 5: Shootnick88 (small blind) folded before Flop
Seat 6: 12311985 (big blind) folded before Flop



PokerStars Hand #222947155601:  Hold'em No Limit ($0.05/$0.10 USD) - 2021/01/23 2:47:18 ET
Table 'Linzia' 6-max Seat #5 is the button
Seat 1: sunsethero13 ($14.26 in chips) 
Seat 2: Docpete1 ($7.33 in chips) 
Seat 3: Rainlol ($11.69 in chips) 
Seat 4: X-rayFeeling ($15.07 in chips) 
Seat 5: Shootnick88 ($10 in chips) 
Seat 6: 12311985 ($12.84 in chips) 
12311985: posts small blind $0.05
sunsethero13: posts big blind $0.10
*** HOLE CARDS ***
Docpete1: folds 
Rainlol: folds 
X-rayFeeling: folds 
Shootnick88: raises $0.20 to $0.30
12311985: folds 
sunsethero13: folds 
Uncalled bet ($0.20) returned to Shootnick88
Shootnick88 collected $0.25 from pot
Shootnick88: doesn't show hand 
*** SUMMARY ***
Total pot $0.25 | Rake $0 
Seat 1: sunsethero13 (big blind) folded before Flop
Seat 2: Docpete1 folded before Flop (didn't bet)
Seat 3: Rainlol folded before Flop (didn't bet)
Seat 4: X-rayFeeling folded before Flop (didn't bet)
Seat 5: Shootnick88 (button) collected ($0.25)
Seat 6: 12311985 (small blind) folded before Flop



PokerStars Hand #222947160745:  Hold'em No Limit ($0.05/$0.10 USD) - 2021/01/23 2:47:40 ET
Table 'Linzia' 6-max Seat #6 is the button
Seat 1: sunsethero13 ($14.16 in chips) 
Seat 2: Docpete1 ($7.33 in chips) 
Seat 3: Rainlol ($11.69 in chips) 
Seat 4: X-rayFeeling ($15.07 in chips) 
Seat 5: Shootnick88 ($10.15 in chips) 
Seat 6: 12311985 ($12.79 in chips) 
sunsethero13: posts small blind $0.05
Docpete1: posts big blind $0.10
*** HOLE CARDS ***
Rainlol: folds 
X-rayFeeling: folds 
Shootnick88: folds 
12311985: folds 
sunsethero13: folds 
Uncalled bet ($0.05) returned to Docpete1
Docpete1 collected $0.10 from pot
*** SUMMARY ***
Total pot $0.10 | Rake $0 
Seat 1: sunsethero13 (small blind) folded before Flop
Seat 2: Docpete1 (big blind) collected ($0.10)
Seat 3: Rainlol folded before Flop (didn't bet)
Seat 4: X-rayFeeling folded before Flop (didn't bet)
Seat 5: Shootnick88 folded before Flop (didn't bet)
Seat 6: 12311985 (button) folded before Flop (didn't bet)



PokerStars Hand #222947164176:  Hold'em No Limit ($0.05/$0.10 USD) - 2021/01/23 2:47:55 ET
Table 'Linzia' 6-max Seat #1 is the button
Seat 1: sunsethero13 ($14.11 in chips) 
Seat 2: Docpete1 ($7.38 in chips) 
Seat 3: Rainlol ($11.69 in chips) 
Seat 4: X-rayFeeling ($15.07 in chips) 
Seat 5: Shootnick88 ($10.15 in chips) 
Seat 6: 12311985 ($12.79 in chips) 
Docpete1: posts small blind $0.05
Rainlol: posts big blind $0.10
*** HOLE CARDS ***
X-rayFeeling: raises $0.20 to $0.30
Shootnick88: folds 
12311985: folds 
sunsethero13: folds 
Docpete1: folds 
Rainlol: folds 
Uncalled bet ($0.20) returned to X-rayFeeling
X-rayFeeling collected $0.25 from pot
X-rayFeeling: doesn't show hand 
*** SUMMARY ***
Total pot $0.25 | Rake $0 
Seat 1: sunsethero13 (button) folded before Flop (didn't bet)
Seat 2: Docpete1 (small blind) folded before Flop
Seat 3: Rainlol (big blind) folded before Flop
Seat 4: X-rayFeeling collected ($0.25)
Seat 5: Shootnick88 folded before Flop (didn't bet)
Seat 6: 12311985 folded before Flop (didn't bet)



PokerStars Hand #222947169032:  Hold'em No Limit ($0.05/$0.10 USD) - 2021/01/23 2:48:15 ET
Table 'Linzia' 6-max Seat #2 is the button
Seat 1: sunsethero13 ($14.11 in chips) 
Seat 2: Docpete1 ($7.33 in chips) 
Seat 3: Rainlol ($11.59 in chips) 
Seat 4: X-rayFeeling ($15.22 in chips) 
Seat 5: Shootnick88 ($10.15 in chips) 
Seat 6: 12311985 ($12.79 in chips) 
Rainlol: posts small blind $0.05
X-rayFeeling: posts big blind $0.10
*** HOLE CARDS ***
Shootnick88: folds 
12311985: folds 
Shootnick88 leaves the table
sunsethero13: folds 
Docpete1: folds 
Rainlol: raises $0.20 to $0.30
X-rayFeeling: calls $0.20
*** FLOP *** [8s 4c 9h]
Rainlol: bets $0.20
X-rayFeeling: calls $0.20
*** TURN *** [8s 4c 9h] [9d]
Rainlol: checks 
X-rayFeeling: bets $0.58
Rainlol: folds 
Uncalled bet ($0.58) returned to X-rayFeeling
X-rayFeeling collected $0.96 from pot
X-rayFeeling: doesn't show hand 
*** SUMMARY ***
Total pot $1 | Rake $0.04 
Board [8s 4c 9h 9d]
Seat 1: sunsethero13 folded before Flop (didn't bet)
Seat 2: Docpete1 (button) folded before Flop (didn't bet)
Seat 3: Rainlol (small blind) folded on the Turn
Seat 4: X-rayFeeling (big blind) collected ($0.96)
Seat 5: Shootnick88 folded before Flop (didn't bet)
Seat 6: 12311985 folded before Flop (didn't bet)



PokerStars Hand #222947175897:  Hold'em No Limit ($0.05/$0.10 USD) - 2021/01/23 2:48:45 ET
Table 'Linzia' 6-max Seat #3 is the button
Seat 1: sunsethero13 ($14.11 in chips) 
Seat 2: Docpete1 ($7.33 in chips) 
Seat 3: Rainlol ($11.09 in chips) 
Seat 4: X-rayFeeling ($15.68 in chips) 
Seat 6: 12311985 ($12.79 in chips) 
X-rayFeeling: posts small blind $0.05
12311985: posts big blind $0.10
*** HOLE CARDS ***
Laker_Style joins the table at seat #5 
sunsethero13: folds 
Docpete1: raises $0.20 to $0.30
Rainlol: raises $0.60 to $0.90
X-rayFeeling: folds 
12311985: folds 
Docpete1: folds 
Uncalled bet ($0.60) returned to Rainlol
Rainlol collected $0.75 from pot
Rainlol: doesn't show hand 
*** SUMMARY ***
Total pot $0.75 | Rake $0 
Seat 1: sunsethero13 folded before Flop (didn't bet)
Seat 2: Docpete1 folded before Flop
Seat 3: Rainlol (button) collected ($0.75)
Seat 4: X-rayFeeling (small blind) folded before Flop
Seat 6: 12311985 (big blind) folded before Flop



PokerStars Hand #222947180483:  Hold'em No Limit ($0.05/$0.10 USD) - 2021/01/23 2:49:04 ET
Table 'Linzia' 6-max Seat #4 is the button
Seat 1: sunsethero13 ($14.11 in chips) 
Seat 2: Docpete1 ($7.03 in chips) 
Seat 3: Rainlol ($11.54 in chips) 
Seat 4: X-rayFeeling ($15.63 in chips) 
Seat 6: 12311985 ($12.69 in chips) 
12311985: posts small blind $0.05
sunsethero13: posts big blind $0.10
*** HOLE CARDS ***
Docpete1: folds 
Rainlol: raises $0.20 to $0.30
X-rayFeeling: folds 
Docpete1 leaves the table
12311985: folds 
sunsethero13: calls $0.20
*** FLOP *** [9h 6d 3c]
sunsethero13: checks 
Rainlol: bets $0.31
sunsethero13: folds 
Uncalled bet ($0.31) returned to Rainlol
Rainlol collected $0.62 from pot
Rainlol: doesn't show hand 
*** SUMMARY ***
Total pot $0.65 | Rake $0.03 
Board [9h 6d 3c]
Seat 1: sunsethero13 (big blind) folded on the Flop
Seat 2: Docpete1 folded before Flop (didn't bet)
Seat 3: Rainlol collected ($0.62)
Seat 4: X-rayFeeling (button) folded before Flop (didn't bet)
Seat 6: 12311985 (small blind) folded before Flop



PokerStars Hand #222947191770:  Hold'em No Limit ($0.05/$0.10 USD) - 2021/01/23 2:49:52 ET
Table 'Linzia' 6-max Seat #6 is the button
Seat 1: sunsethero13 ($13.81 in chips) 
Seat 3: Rainlol ($11.86 in chips) 
Seat 4: X-rayFeeling ($15.63 in chips) 
Seat 6: 12311985 ($12.64 in chips) 
sunsethero13: posts small blind $0.05
Rainlol: posts big blind $0.10
Laker_Style: sits out 
*** HOLE CARDS ***
X-rayFeeling: folds 
12311985: folds 
sunsethero13: calls $0.05
Rainlol: raises $0.30 to $0.40
sunsethero13: calls $0.30
*** FLOP *** [9h 5c Tc]
sunsethero13: checks 
Rainlol: bets $0.30
sunsethero13: calls $0.30
*** TURN *** [9h 5c Tc] [Ah]
sunsethero13: checks 
Rainlol: bets $1
sunsethero13: folds 
Uncalled bet ($1) returned to Rainlol
Rainlol collected $1.34 from pot
Rainlol: doesn't show hand 
*** SUMMARY ***
Total pot $1.40 | Rake $0.06 
Board [9h 5c Tc Ah]
Seat 1: sunsethero13 (small blind) folded on the Turn
Seat 3: Rainlol (big blind) collected ($1.34)
Seat 4: X-rayFeeling folded before Flop (didn't bet)
Seat 6: 12311985 (button) folded before Flop (didn't bet)



PokerStars Hand #222947215733:  Hold'em No Limit ($0.05/$0.10 USD) - 2021/01/23 2:51:16 ET
Table 'Linzia' 6-max Seat #1 is the button
Seat 1: sunsethero13 ($13.11 in chips) 
Seat 3: Rainlol ($12.50 in chips) 
Seat 4: X-rayFeeling ($15.63 in chips) 
Seat 6: 12311985 ($12.64 in chips) 
Rainlol: posts small blind $0.05
X-rayFeeling: posts big blind $0.10
Laker_Style: sits out 
*** HOLE CARDS ***
12311985 has timed out
12311985: folds 
sunsethero13: folds 
Rainlol: raises $0.20 to $0.30
X-rayFeeling: calls $0.20
*** FLOP *** [6s 4h 3c]
Rainlol: checks 
X-rayFeeling: checks 
*** TURN *** [6s 4h 3c] [2h]
Rainlol: checks 
X-rayFeeling: checks 
*** RIVER *** [6s 4h 3c 2h] [As]
Rainlol: checks 
X-rayFeeling: checks 
*** SHOW DOWN ***
Rainlol: shows [Kh 8s] (high card Ace)
X-rayFeeling: shows [Ts Ac] (a pair of Aces)
X-rayFeeling collected $0.57 from pot
*** SUMMARY ***
Total pot $0.60 | Rake $0.03 
Board [6s 4h 3c 2h As]
Seat 1: sunsethero13 (button) folded before Flop (didn't bet)
Seat 3: Rainlol (small blind) showed [Kh 8s] and lost with high card Ace
Seat 4: X-rayFeeling (big blind) showed [Ts Ac] and won ($0.57) with a pair of Aces
Seat 6: 12311985 folded before Flop (didn't bet)



PokerStars Hand #222947229179:  Hold'em No Limit ($0.05/$0.10 USD) - 2021/01/23 2:52:13 ET
Table 'Linzia' 6-max Seat #3 is the button
Seat 1: sunsethero13 ($13.11 in chips) 
Seat 3: Rainlol ($12.20 in chips) 
Seat 4: X-rayFeeling ($15.90 in chips) 
Seat 5: Laker_Style ($10 in chips) 
Seat 6: 12311985 ($12.64 in chips) 
X-rayFeeling: posts small blind $0.05
Laker_Style: posts big blind $0.10
*** HOLE CARDS ***
12311985: folds 
sunsethero13: raises $0.14 to $0.24
Rainlol: folds 
X-rayFeeling: folds 
Laker_Style: folds 
Uncalled bet ($0.14) returned to sunsethero13
sunsethero13 collected $0.25 from pot
sunsethero13: doesn't show hand 
*** SUMMARY ***
Total pot $0.25 | Rake $0 
Seat 1: sunsethero13 collected ($0.25)
Seat 3: Rainlol (button) folded before Flop (didn't bet)
Seat 4: X-rayFeeling (small blind) folded before Flop
Seat 5: Laker_Style (big blind) folded before Flop
Seat 6: 12311985 folded before Flop (didn't bet)



PokerStars Hand #222947233462:  Hold'em No Limit ($0.05/$0.10 USD) - 2021/01/23 2:52:32 ET
Table 'Linzia' 6-max Seat #4 is the button
Seat 1: sunsethero13 ($13.26 in chips) 
Seat 3: Rainlol ($12.20 in chips) 
Seat 4: X-rayFeeling ($15.85 in chips) 
Seat 5: Laker_Style ($10 in chips) 
Seat 6: 12311985 ($12.64 in chips) 
Laker_Style: posts small blind $0.05
12311985: posts big blind $0.10
*** HOLE CARDS ***
sunsethero13: folds 
Rainlol: folds 
X-rayFeeling: folds 
Laker_Style: raises $0.20 to $0.30
12311985: folds 
Uncalled bet ($0.20) returned to Laker_Style
Laker_Style collected $0.20 from pot
Laker_Style: doesn't show hand 
*** SUMMARY ***
Total pot $0.20 | Rake $0 
Seat 1: sunsethero13 folded before Flop (didn't bet)
Seat 3: Rainlol folded before Flop (didn't bet)
Seat 4: X-rayFeeling (button) folded before Flop (didn't bet)
Seat 5: Laker_Style (small blind) collected ($0.20)
Seat 6: 12311985 (big blind) folded before Flop



PokerStars Hand #222947236590:  Hold'em No Limit ($0.05/$0.10 USD) - 2021/01/23 2:52:45 ET
Table 'Linzia' 6-max Seat #5 is the button
Seat 1: sunsethero13 ($13.26 in chips) 
Seat 3: Rainlol ($12.20 in chips) 
Seat 4: X-rayFeeling ($15.85 in chips) 
Seat 5: Laker_Style ($10.10 in chips) 
Seat 6: 12311985 ($12.54 in chips) 
12311985: posts small blind $0.05
sunsethero13: posts big blind $0.10
*** HOLE CARDS ***
Rainlol: folds 
X-rayFeeling: folds 
Laker_Style: raises $0.15 to $0.25
12311985: folds 
sunsethero13: raises $0.65 to $0.90
Laker_Style: calls $0.65
*** FLOP *** [9s 8d 7s]
MendramoSone joins the table at seat #2 
sunsethero13: checks 
Laker_Style: bets $0.89
sunsethero13: calls $0.89
*** TURN *** [9s 8d 7s] [7c]
sunsethero13: checks 
Laker_Style: checks 
*** RIVER *** [9s 8d 7s 7c] [Qc]
sunsethero13: bets $1.40
Laker_Style: folds 
Uncalled bet ($1.40) returned to sunsethero13
sunsethero13 collected $3.47 from pot
sunsethero13: doesn't show hand 
*** SUMMARY ***
Total pot $3.63 | Rake $0.16 
Board [9s 8d 7s 7c Qc]
Seat 1: sunsethero13 (big blind) collected ($3.47)
Seat 3: Rainlol folded before Flop (didn't bet)
Seat 4: X-rayFeeling folded before Flop (didn't bet)
Seat 5: Laker_Style (button) folded on the River
Seat 6: 12311985 (small blind) folded before Flop



PokerStars Hand #222947258225:  Hold'em No Limit ($0.05/$0.10 USD) - 2021/01/23 2:54:19 ET
Table 'Linzia' 6-max Seat #6 is the button
Seat 1: sunsethero13 ($14.94 in chips) 
Seat 2: MendramoSone ($10 in chips) 
Seat 3: Rainlol ($12.20 in chips) 
Seat 4: X-rayFeeling ($15.85 in chips) 
Seat 5: Laker_Style ($10 in chips) 
Seat 6: 12311985 ($12.49 in chips) 
sunsethero13: posts small blind $0.05
MendramoSone: posts big blind $0.10
*** HOLE CARDS ***
Rainlol: folds 
X-rayFeeling: folds 
Laker_Style: folds 
12311985: raises $0.20 to $0.30
sunsethero13: folds 
MendramoSone: folds 
Uncalled bet ($0.20) returned to 12311985
12311985 collected $0.25 from pot
12311985: doesn't show hand 
*** SUMMARY ***
Total pot $0.25 | Rake $0 
Seat 1: sunsethero13 (small blind) folded before Flop
Seat 2: MendramoSone (big blind) folded before Flop
Seat 3: Rainlol folded before Flop (didn't bet)
Seat 4: X-rayFeeling folded before Flop (didn't bet)
Seat 5: Laker_Style folded before Flop (didn't bet)
Seat 6: 12311985 (button) collected ($0.25)



PokerStars Hand #222947263446:  Hold'em No Limit ($0.05/$0.10 USD) - 2021/01/23 2:54:41 ET
Table 'Linzia' 6-max Seat #1 is the button
Seat 1: sunsethero13 ($14.89 in chips) 
Seat 2: MendramoSone ($9.90 in chips) 
Seat 3: Rainlol ($12.20 in chips) 
Seat 4: X-rayFeeling ($15.85 in chips) 
Seat 5: Laker_Style ($10 in chips) 
Seat 6: 12311985 ($12.64 in chips) 
MendramoSone: posts small blind $0.05
Rainlol: posts big blind $0.10
*** HOLE CARDS ***
X-rayFeeling: folds 
Laker_Style: folds 
12311985: folds 
sunsethero13: folds 
MendramoSone: folds 
Uncalled bet ($0.05) returned to Rainlol
Rainlol collected $0.10 from pot
Rainlol: doesn't show hand 
*** SUMMARY ***
Total pot $0.10 | Rake $0 
Seat 1: sunsethero13 (button) folded before Flop (didn't bet)
Seat 2: MendramoSone (small blind) folded before Flop
Seat 3: Rainlol (big blind) collected ($0.10)
Seat 4: X-rayFeeling folded before Flop (didn't bet)
Seat 5: Laker_Style folded before Flop (didn't bet)
Seat 6: 12311985 folded before Flop (didn't bet)



PokerStars Hand #222947266187:  Hold'em No Limit ($0.05/$0.10 USD) - 2021/01/23 2:54:52 ET
Table 'Linzia' 6-max Seat #2 is the button
Seat 1: sunsethero13 ($14.89 in chips) 
Seat 2: MendramoSone ($9.85 in chips) 
Seat 3: Rainlol ($12.25 in chips) 
Seat 4: X-rayFeeling ($15.85 in chips) 
Seat 5: Laker_Style ($10 in chips) 
Seat 6: 12311985 ($12.64 in chips) 
Rainlol: posts small blind $0.05
X-rayFeeling: posts big blind $0.10
*** HOLE CARDS ***
Laker_Style: raises $0.20 to $0.30
12311985: folds 
sunsethero13: folds 
MendramoSone: folds 
Rainlol: folds 
X-rayFeeling: folds 
Uncalled bet ($0.20) returned to Laker_Style
Laker_Style collected $0.25 from pot
Laker_Style: doesn't show hand 
*** SUMMARY ***
Total pot $0.25 | Rake $0 
Seat 1: sunsethero13 folded before Flop (didn't bet)
Seat 2: MendramoSone (button) folded before Flop (didn't bet)
Seat 3: Rainlol (small blind) folded before Flop
Seat 4: X-rayFeeling (big blind) folded before Flop
Seat 5: Laker_Style collected ($0.25)
Seat 6: 12311985 folded before Flop (didn't bet)



PokerStars Hand #222947271205:  Hold'em No Limit ($0.05/$0.10 USD) - 2021/01/23 2:55:15 ET
Table 'Linzia' 6-max Seat #3 is the button
Seat 1: sunsethero13 ($14.89 in chips) 
Seat 2: MendramoSone ($9.85 in chips) 
Seat 3: Rainlol ($12.20 in chips) 
Seat 4: X-rayFeeling ($15.75 in chips) 
Seat 5: Laker_Style ($10.15 in chips) 
Seat 6: 12311985 ($12.64 in chips) 
X-rayFeeling: posts small blind $0.05
Laker_Style: posts big blind $0.10
*** HOLE CARDS ***
12311985: raises $0.15 to $0.25
sunsethero13: folds 
MendramoSone: calls $0.25
Rainlol: folds 
X-rayFeeling: folds 
Laker_Style: folds 
*** FLOP *** [Ks 3d 8c]
12311985: bets $0.19
MendramoSone: folds 
Uncalled bet ($0.19) returned to 12311985
12311985 collected $0.62 from pot
12311985: doesn't show hand 
*** SUMMARY ***
Total pot $0.65 | Rake $0.03 
Board [Ks 3d 8c]
Seat 1: sunsethero13 folded before Flop (didn't bet)
Seat 2: MendramoSone folded on the Flop
Seat 3: Rainlol (button) folded before Flop (didn't bet)
Seat 4: X-rayFeeling (small blind) folded before Flop
Seat 5: Laker_Style (big blind) folded before Flop
Seat 6: 12311985 collected ($0.62)



PokerStars Hand #222947277897:  Hold'em No Limit ($0.05/$0.10 USD) - 2021/01/23 2:55:50 ET
Table 'Linzia' 6-max Seat #4 is the button
Seat 1: sunsethero13 ($14.89 in chips) 
Seat 2: MendramoSone ($9.60 in chips) 
Seat 3: Rainlol ($12.20 in chips) 
Seat 4: X-rayFeeling ($15.70 in chips) 
Seat 5: Laker_Style ($10.05 in chips) 
Laker_Style: posts small blind $0.05
12311985: is sitting out 
sunsethero13: posts big blind $0.10
*** HOLE CARDS ***
MendramoSone: raises $0.20 to $0.30
Rainlol: folds 
X-rayFeeling: folds 
Laker_Style: folds 
sunsethero13: calls $0.20
*** FLOP *** [6d 4h Ks]
sunsethero13: checks 
MendramoSone: bets $0.40
sunsethero13: calls $0.40
*** TURN *** [6d 4h Ks] [7h]
sunsethero13: bets $0.69
MendramoSone: calls $0.69
*** RIVER *** [6d 4h Ks 7h] [4c]
sunsethero13: checks 
MendramoSone: checks 
*** SHOW DOWN ***
sunsethero13: shows [Ah 3h] (a pair of Fours)
MendramoSone: shows [Qh Qd] (two pair, Queens and Fours)
MendramoSone collected $2.70 from pot
*** SUMMARY ***
Total pot $2.83 | Rake $0.13 
Board [6d 4h Ks 7h 4c]
Seat 1: sunsethero13 (big blind) showed [Ah 3h] and lost with a pair of Fours
Seat 2: MendramoSone showed [Qh Qd] and won ($2.70) with two pair, Queens and Fours
Seat 3: Rainlol folded before Flop (didn't bet)
Seat 4: X-rayFeeling (button) folded before Flop (didn't bet)
Seat 5: Laker_Style (small blind) folded before Flop



PokerStars Hand #222947292221:  Hold'em No Limit ($0.05/$0.10 USD) - 2021/01/23 2:57:02 ET
Table 'Linzia' 6-max Seat #5 is the button
Seat 1: sunsethero13 ($13.50 in chips) 
Seat 2: MendramoSone ($10.91 in chips) 
Seat 3: Rainlol ($12.20 in chips) 
Seat 4: X-rayFeeling ($15.70 in chips) 
Seat 5: Laker_Style ($10 in chips) 
sunsethero13: posts small blind $0.05
MendramoSone: posts big blind $0.10
*** HOLE CARDS ***
Rainlol: folds 
X-rayFeeling: folds 
Laker_Style: folds 
sunsethero13: calls $0.05
MendramoSone: checks 
*** FLOP *** [As 2d Td]
sunsethero13: bets $0.10
MendramoSone: raises $0.20 to $0.30
sunsethero13: calls $0.20
*** TURN *** [As 2d Td] [6d]
sunsethero13: checks 
MendramoSone: checks 
*** RIVER *** [As 2d Td 6d] [7c]
sunsethero13: checks 
MendramoSone: checks 
*** SHOW DOWN ***
sunsethero13: shows [3s 5s] (high card Ace)
MendramoSone: shows [5c Ad] (a pair of Aces)
MendramoSone collected $0.76 from pot
*** SUMMARY ***
Total pot $0.80 | Rake $0.04 
Board [As 2d Td 6d 7c]
Seat 1: sunsethero13 (small blind) showed [3s 5s] and lost with high card Ace
Seat 2: MendramoSone (big blind) showed [5c Ad] and won ($0.76) with a pair of Aces
Seat 3: Rainlol folded before Flop (didn't bet)
Seat 4: X-rayFeeling folded before Flop (didn't bet)
Seat 5: Laker_Style (button) folded before Flop (didn't bet)



PokerStars Hand #222947301490:  Hold'em No Limit ($0.05/$0.10 USD) - 2021/01/23 2:57:49 ET
Table 'Linzia' 6-max Seat #1 is the button
Seat 1: sunsethero13 ($13.10 in chips) 
Seat 2: MendramoSone ($11.27 in chips) 
Seat 3: Rainlol ($12.20 in chips) 
Seat 4: X-rayFeeling ($15.70 in chips) 
Seat 5: Laker_Style ($10 in chips) 
MendramoSone: posts small blind $0.05
Rainlol: posts big blind $0.10
12311985: sits out 
*** HOLE CARDS ***
X-rayFeeling: folds 
Laker_Style: raises $0.20 to $0.30
sunsethero13: folds 
MendramoSone: folds 
Rainlol: folds 
Uncalled bet ($0.20) returned to Laker_Style
Laker_Style collected $0.25 from pot
Laker_Style: doesn't show hand 
*** SUMMARY ***
Total pot $0.25 | Rake $0 
Seat 1: sunsethero13 (button) folded before Flop (didn't bet)
Seat 2: MendramoSone (small blind) folded before Flop
Seat 3: Rainlol (big blind) folded before Flop
Seat 4: X-rayFeeling folded before Flop (didn't bet)
Seat 5: Laker_Style collected ($0.25)



PokerStars Hand #222947304380:  Hold'em No Limit ($0.05/$0.10 USD) - 2021/01/23 2:58:04 ET
Table 'Linzia' 6-max Seat #2 is the button
Seat 1: sunsethero13 ($13.10 in chips) 
Seat 2: MendramoSone ($11.22 in chips) 
Seat 3: Rainlol ($12.10 in chips) 
Seat 4: X-rayFeeling ($15.70 in chips) 
Seat 5: Laker_Style ($10.15 in chips) 
Rainlol: posts small blind $0.05
X-rayFeeling: posts big blind $0.10
12311985: sits out 
*** HOLE CARDS ***
Laker_Style: folds 
sunsethero13: raises $0.20 to $0.30
MendramoSone: folds 
Rainlol: folds 
X-rayFeeling: folds 
Uncalled bet ($0.20) returned to sunsethero13
sunsethero13 collected $0.25 from pot
sunsethero13: doesn't show hand 
*** SUMMARY ***
Total pot $0.25 | Rake $0 
Seat 1: sunsethero13 collected ($0.25)
Seat 2: MendramoSone (button) folded before Flop (didn't bet)
Seat 3: Rainlol (small blind) folded before Flop
Seat 4: X-rayFeeling (big blind) folded before Flop
Seat 5: Laker_Style folded before Flop (didn't bet)



PokerStars Hand #222947309506:  Hold'em No Limit ($0.05/$0.10 USD) - 2021/01/23 2:58:30 ET
Table 'Linzia' 6-max Seat #3 is the button
Seat 1: sunsethero13 ($13.25 in chips) 
Seat 2: MendramoSone ($11.22 in chips) 
Seat 3: Rainlol ($12.05 in chips) 
Seat 4: X-rayFeeling ($15.60 in chips) 
Seat 5: Laker_Style ($10.15 in chips) 
X-rayFeeling: posts small blind $0.05
Laker_Style: posts big blind $0.10
12311985: sits out 
*** HOLE CARDS ***
sunsethero13: raises $0.20 to $0.30
MendramoSone: folds 
Rainlol: folds 
X-rayFeeling: folds 
Laker_Style: folds 
Uncalled bet ($0.20) returned to sunsethero13
sunsethero13 collected $0.25 from pot
sunsethero13: doesn't show hand 
*** SUMMARY ***
Total pot $0.25 | Rake $0 
Seat 1: sunsethero13 collected ($0.25)
Seat 2: MendramoSone folded before Flop (didn't bet)
Seat 3: Rainlol (button) folded before Flop (didn't bet)
Seat 4: X-rayFeeling (small blind) folded before Flop
Seat 5: Laker_Style (big blind) folded before Flop



PokerStars Hand #222947311742:  Hold'em No Limit ($0.05/$0.10 USD) - 2021/01/23 2:58:41 ET
Table 'Linzia' 6-max Seat #4 is the button
Seat 1: sunsethero13 ($13.40 in chips) 
Seat 2: MendramoSone ($11.22 in chips) 
Seat 3: Rainlol ($12.05 in chips) 
Seat 4: X-rayFeeling ($15.55 in chips) 
Seat 5: Laker_Style ($10.05 in chips) 
Seat 6: 12311985 ($13.01 in chips) 
Laker_Style: posts small blind $0.05
12311985: posts big blind $0.10
*** HOLE CARDS ***
sunsethero13: folds 
MendramoSone: folds 
Rainlol: raises $0.20 to $0.30
X-rayFeeling: folds 
Laker_Style: folds 
12311985: folds 
Uncalled bet ($0.20) returned to Rainlol
Rainlol collected $0.25 from pot
Rainlol: doesn't show hand 
*** SUMMARY ***
Total pot $0.25 | Rake $0 
Seat 1: sunsethero13 folded before Flop (didn't bet)
Seat 2: MendramoSone folded before Flop (didn't bet)
Seat 3: Rainlol collected ($0.25)
Seat 4: X-rayFeeling (button) folded before Flop (didn't bet)
Seat 5: Laker_Style (small blind) folded before Flop
Seat 6: 12311985 (big blind) folded before Flop



PokerStars Hand #222947314935:  Hold'em No Limit ($0.05/$0.10 USD) - 2021/01/23 2:58:57 ET
Table 'Linzia' 6-max Seat #5 is the button
Seat 1: sunsethero13 ($13.40 in chips) 
Seat 2: MendramoSone ($11.22 in chips) 
Seat 3: Rainlol ($12.20 in chips) 
Seat 4: X-rayFeeling ($15.55 in chips) 
Seat 5: Laker_Style ($10 in chips) 
Seat 6: 12311985 ($12.91 in chips) 
12311985: posts small blind $0.05
sunsethero13: posts big blind $0.10
*** HOLE CARDS ***
MendramoSone: folds 
Rainlol: raises $0.20 to $0.30
X-rayFeeling: folds 
Laker_Style: folds 
12311985: folds 
sunsethero13: folds 
Uncalled bet ($0.20) returned to Rainlol
Rainlol collected $0.25 from pot
Rainlol: doesn't show hand 
*** SUMMARY ***
Total pot $0.25 | Rake $0 
Seat 1: sunsethero13 (big blind) folded before Flop
Seat 2: MendramoSone folded before Flop (didn't bet)
Seat 3: Rainlol collected ($0.25)
Seat 4: X-rayFeeling folded before Flop (didn't bet)
Seat 5: Laker_Style (button) folded before Flop (didn't bet)
Seat 6: 12311985 (small blind) folded before Flop



PokerStars Hand #222947319142:  Hold'em No Limit ($0.05/$0.10 USD) - 2021/01/23 2:59:19 ET
Table 'Linzia' 6-max Seat #6 is the button
Seat 1: sunsethero13 ($13.30 in chips) 
Seat 2: MendramoSone ($11.22 in chips) 
Seat 3: Rainlol ($12.35 in chips) 
Seat 4: X-rayFeeling ($15.55 in chips) 
Seat 5: Laker_Style ($10 in chips) 
Seat 6: 12311985 ($12.86 in chips) 
sunsethero13: posts small blind $0.05
MendramoSone: posts big blind $0.10
*** HOLE CARDS ***
Rainlol: folds 
X-rayFeeling: folds 
Laker_Style: folds 
12311985: folds 
sunsethero13: folds 
Uncalled bet ($0.05) returned to MendramoSone
MendramoSone collected $0.10 from pot
MendramoSone: doesn't show hand 
*** SUMMARY ***
Total pot $0.10 | Rake $0 
Seat 1: sunsethero13 (small blind) folded before Flop
Seat 2: MendramoSone (big blind) collected ($0.10)
Seat 3: Rainlol folded before Flop (didn't bet)
Seat 4: X-rayFeeling folded before Flop (didn't bet)
Seat 5: Laker_Style folded before Flop (didn't bet)
Seat 6: 12311985 (button) folded before Flop (didn't bet)



PokerStars Hand #222947321888:  Hold'em No Limit ($0.05/$0.10 USD) - 2021/01/23 2:59:33 ET
Table 'Linzia' 6-max Seat #1 is the button
Seat 1: sunsethero13 ($13.25 in chips) 
Seat 2: MendramoSone ($11.27 in chips) 
Seat 3: Rainlol ($12.35 in chips) 
Seat 4: X-rayFeeling ($15.55 in chips) 
Seat 5: Laker_Style ($10 in chips) 
Seat 6: 12311985 ($12.86 in chips) 
MendramoSone: posts small blind $0.05
Rainlol: posts big blind $0.10
*** HOLE CARDS ***
X-rayFeeling: folds 
Laker_Style has timed out
Laker_Style: folds 
12311985: raises $0.15 to $0.25
sunsethero13: folds 
MendramoSone: folds 
Rainlol: folds 
Uncalled bet ($0.15) returned to 12311985
12311985 collected $0.25 from pot
12311985: doesn't show hand 
*** SUMMARY ***
Total pot $0.25 | Rake $0 
Seat 1: sunsethero13 (button) folded before Flop (didn't bet)
Seat 2: MendramoSone (small blind) folded before Flop
Seat 3: Rainlol (big blind) folded before Flop
Seat 4: X-rayFeeling folded before Flop (didn't bet)
Seat 5: Laker_Style folded before Flop (didn't bet)
Seat 6: 12311985 collected ($0.25)



PokerStars Hand #222947326058:  Hold'em No Limit ($0.05/$0.10 USD) - 2021/01/23 2:59:54 ET
Table 'Linzia' 6-max Seat #2 is the button
Seat 1: sunsethero13 ($13.25 in chips) 
Seat 2: MendramoSone ($11.22 in chips) 
Seat 3: Rainlol ($12.25 in chips) 
Seat 4: X-rayFeeling ($15.55 in chips) 
Seat 5: Laker_Style ($10 in chips) 
Seat 6: 12311985 ($13.01 in chips) 
Rainlol: posts small blind $0.05
X-rayFeeling: posts big blind $0.10
*** HOLE CARDS ***
Laker_Style: folds 
12311985: folds 
sunsethero13 has timed out
sunsethero13: folds 
MendramoSone: folds 
Rainlol: raises $0.20 to $0.30
X-rayFeeling: folds 
Uncalled bet ($0.20) returned to Rainlol
Rainlol collected $0.20 from pot
Rainlol: doesn't show hand 
*** SUMMARY ***
Total pot $0.20 | Rake $0 
Seat 1: sunsethero13 folded before Flop (didn't bet)
Seat 2: MendramoSone (button) folded before Flop (didn't bet)
Seat 3: Rainlol (small blind) collected ($0.20)
Seat 4: X-rayFeeling (big blind) folded before Flop
Seat 5: Laker_Style folded before Flop (didn't bet)
Seat 6: 12311985 folded before Flop (didn't bet)



PokerStars Hand #222947332052:  Hold'em No Limit ($0.05/$0.10 USD) - 2021/01/23 3:00:24 ET
Table 'Linzia' 6-max Seat #3 is the button
Seat 1: sunsethero13 ($13.25 in chips) 
Seat 2: MendramoSone ($11.22 in chips) 
Seat 3: Rainlol ($12.35 in chips) 
Seat 4: X-rayFeeling ($15.45 in chips) 
Seat 5: Laker_Style ($10 in chips) 
Seat 6: 12311985 ($13.01 in chips) 
X-rayFeeling: posts small blind $0.05
Laker_Style: posts big blind $0.10
*** HOLE CARDS ***
12311985: folds 
sunsethero13: raises $0.14 to $0.24
MendramoSone: folds 
Rainlol: folds 
X-rayFeeling: folds 
Laker_Style: folds 
Uncalled bet ($0.14) returned to sunsethero13
sunsethero13 collected $0.25 from pot
sunsethero13: doesn't show hand 
*** SUMMARY ***
Total pot $0.25 | Rake $0 
Seat 1: sunsethero13 collected ($0.25)
Seat 2: MendramoSone folded before Flop (didn't bet)
Seat 3: Rainlol (button) folded before Flop (didn't bet)
Seat 4: X-rayFeeling (small blind) folded before Flop
Seat 5: Laker_Style (big blind) folded before Flop
Seat 6: 12311985 folded before Flop (didn't bet)



PokerStars Hand #222947335931:  Hold'em No Limit ($0.05/$0.10 USD) - 2021/01/23 3:00:42 ET
Table 'Linzia' 6-max Seat #4 is the button
Seat 1: sunsethero13 ($13.40 in chips) 
Seat 2: MendramoSone ($11.22 in chips) 
Seat 3: Rainlol ($12.35 in chips) 
Seat 4: X-rayFeeling ($15.40 in chips) 
Seat 5: Laker_Style ($10 in chips) 
Seat 6: 12311985 ($13.01 in chips) 
Laker_Style: posts small blind $0.05
12311985: posts big blind $0.10
*** HOLE CARDS ***
sunsethero13: folds 
MendramoSone: raises $0.20 to $0.30
Rainlol: folds 
sunsethero13 leaves the table
X-rayFeeling: folds 
Laker_Style: folds 
12311985: folds 
Uncalled bet ($0.20) returned to MendramoSone
MendramoSone collected $0.25 from pot
MendramoSone: doesn't show hand 
*** SUMMARY ***
Total pot $0.25 | Rake $0 
Seat 1: sunsethero13 folded before Flop (didn't bet)
Seat 2: MendramoSone collected ($0.25)
Seat 3: Rainlol folded before Flop (didn't bet)
Seat 4: X-rayFeeling (button) folded before Flop (didn't bet)
Seat 5: Laker_Style (small blind) folded before Flop
Seat 6: 12311985 (big blind) folded before Flop



PokerStars Hand #222947341151:  Hold'em No Limit ($0.05/$0.10 USD) - 2021/01/23 3:01:06 ET
Table 'Linzia' 6-max Seat #5 is the button
Seat 2: MendramoSone ($11.37 in chips) 
Seat 3: Rainlol ($12.35 in chips) 
Seat 4: X-rayFeeling ($15.40 in chips) 
Seat 5: Laker_Style ($10 in chips) 
Seat 6: 12311985 ($12.91 in chips) 
12311985: posts small blind $0.05
MendramoSone: posts big blind $0.10
*** HOLE CARDS ***
Rainlol: folds 
X-rayFeeling: folds 
Laker_Style has timed out
Laker_Style: folds 
12311985: folds 
Uncalled bet ($0.05) returned to MendramoSone
MendramoSone collected $0.10 from pot
MendramoSone: doesn't show hand 
*** SUMMARY ***
Total pot $0.10 | Rake $0 
Seat 2: MendramoSone (big blind) collected ($0.10)
Seat 3: Rainlol folded before Flop (didn't bet)
Seat 4: X-rayFeeling folded before Flop (didn't bet)
Seat 5: Laker_Style (button) folded before Flop (didn't bet)
Seat 6: 12311985 (small blind) folded before Flop



PokerStars Hand #222947345664:  Hold'em No Limit ($0.05/$0.10 USD) - 2021/01/23 3:01:26 ET
Table 'Linzia' 6-max Seat #6 is the button
Seat 2: MendramoSone ($11.42 in chips) 
Seat 3: Rainlol ($12.35 in chips) 
Seat 4: X-rayFeeling ($15.40 in chips) 
Seat 5: Laker_Style ($10 in chips) 
Seat 6: 12311985 ($12.86 in chips) 
MendramoSone: posts small blind $0.05
Rainlol: posts big blind $0.10
*** HOLE CARDS ***
X-rayFeeling: folds 
Laker_Style: folds 
lucima10 joins the table at seat #1 
12311985: raises $0.20 to $0.30
MendramoSone: folds 
Rainlol: folds 
Uncalled bet ($0.20) returned to 12311985
12311985 collected $0.25 from pot
12311985: doesn't show hand 
*** SUMMARY ***
Total pot $0.25 | Rake $0 
Seat 2: MendramoSone (small blind) folded before Flop
Seat 3: Rainlol (big blind) folded before Flop
Seat 4: X-rayFeeling folded before Flop (didn't bet)
Seat 5: Laker_Style folded before Flop (didn't bet)
Seat 6: 12311985 (button) collected ($0.25)



PokerStars Hand #222947348622:  Hold'em No Limit ($0.05/$0.10 USD) - 2021/01/23 3:01:40 ET
Table 'Linzia' 6-max Seat #2 is the button
Seat 2: MendramoSone ($11.37 in chips) 
Seat 3: Rainlol ($12.25 in chips) 
Seat 4: X-rayFeeling ($15.40 in chips) 
Seat 5: Laker_Style ($10 in chips) 
Seat 6: 12311985 ($13.01 in chips) 
Rainlol: posts small blind $0.05
X-rayFeeling: posts big blind $0.10
lucima10: sits out 
*** HOLE CARDS ***
Laker_Style: folds 
12311985: raises $0.15 to $0.25
MendramoSone: folds 
Rainlol: folds 
X-rayFeeling: folds 
Uncalled bet ($0.15) returned to 12311985
12311985 collected $0.25 from pot
12311985: doesn't show hand 
*** SUMMARY ***
Total pot $0.25 | Rake $0 
Seat 2: MendramoSone (button) folded before Flop (didn't bet)
Seat 3: Rainlol (small blind) folded before Flop
Seat 4: X-rayFeeling (big blind) folded before Flop
Seat 5: Laker_Style folded before Flop (didn't bet)
Seat 6: 12311985 collected ($0.25)



PokerStars Hand #222947351449:  Hold'em No Limit ($0.05/$0.10 USD) - 2021/01/23 3:01:52 ET
Table 'Linzia' 6-max Seat #3 is the button
Seat 2: MendramoSone ($11.37 in chips) 
Seat 3: Rainlol ($12.20 in chips) 
Seat 4: X-rayFeeling ($15.30 in chips) 
Seat 5: Laker_Style ($10 in chips) 
Seat 6: 12311985 ($13.16 in chips) 
X-rayFeeling: posts small blind $0.05
Laker_Style: posts big blind $0.10
lucima10: sits out 
*** HOLE CARDS ***
12311985: folds 
MendramoSone: raises $0.20 to $0.30
Rainlol: folds 
X-rayFeeling: calls $0.25
Laker_Style: folds 
*** FLOP *** [Kd 3h 2c]
X-rayFeeling: checks 
MendramoSone: bets $0.40
X-rayFeeling: folds 
Uncalled bet ($0.40) returned to MendramoSone
MendramoSone collected $0.67 from pot
MendramoSone: doesn't show hand 
*** SUMMARY ***
Total pot $0.70 | Rake $0.03 
Board [Kd 3h 2c]
Seat 2: MendramoSone collected ($0.67)
Seat 3: Rainlol (button) folded before Flop (didn't bet)
Seat 4: X-rayFeeling (small blind) folded on the Flop
Seat 5: Laker_Style (big blind) folded before Flop
Seat 6: 12311985 folded before Flop (didn't bet)



PokerStars Hand #222947356046:  Hold'em No Limit ($0.05/$0.10 USD) - 2021/01/23 3:02:12 ET
Table 'Linzia' 6-max Seat #4 is the button
Seat 2: MendramoSone ($11.74 in chips) 
Seat 3: Rainlol ($12.20 in chips) 
Seat 4: X-rayFeeling ($15 in chips) 
Seat 5: Laker_Style ($10 in chips) 
Seat 6: 12311985 ($13.16 in chips) 
Laker_Style: posts small blind $0.05
12311985: posts big blind $0.10
lucima10: sits out 
*** HOLE CARDS ***
MendramoSone: folds 
Rainlol: folds 
X-rayFeeling: folds 
Laker_Style: folds 
Uncalled bet ($0.05) returned to 12311985
12311985 collected $0.10 from pot
12311985: doesn't show hand 
*** SUMMARY ***
Total pot $0.10 | Rake $0 
Seat 2: MendramoSone folded before Flop (didn't bet)
Seat 3: Rainlol folded before Flop (didn't bet)
Seat 4: X-rayFeeling (button) folded before Flop (didn't bet)
Seat 5: Laker_Style (small blind) folded before Flop
Seat 6: 12311985 (big blind) collected ($0.10)



PokerStars Hand #222947358728:  Hold'em No Limit ($0.05/$0.10 USD) - 2021/01/23 3:02:24 ET
Table 'Linzia' 6-max Seat #5 is the button
Seat 1: lucima10 ($10 in chips) 
Seat 2: MendramoSone ($11.74 in chips) 
Seat 3: Rainlol ($12.20 in chips) 
Seat 4: X-rayFeeling ($15 in chips) 
Seat 5: Laker_Style ($10 in chips) 
Seat 6: 12311985 ($13.21 in chips) 
12311985: posts small blind $0.05
lucima10: posts big blind $0.10
*** HOLE CARDS ***
MendramoSone: folds 
Rainlol: folds 
X-rayFeeling: raises $0.20 to $0.30
Laker_Style: folds 
12311985: folds 
lucima10: raises $0.70 to $1
X-rayFeeling: folds 
Uncalled bet ($0.70) returned to lucima10
lucima10 collected $0.65 from pot
lucima10: doesn't show hand 
*** SUMMARY ***
Total pot $0.65 | Rake $0 
Seat 1: lucima10 (big blind) collected ($0.65)
Seat 2: MendramoSone folded before Flop (didn't bet)
Seat 3: Rainlol folded before Flop (didn't bet)
Seat 4: X-rayFeeling folded before Flop
Seat 5: Laker_Style (button) folded before Flop (didn't bet)
Seat 6: 12311985 (small blind) folded before Flop



PokerStars Hand #222947364428:  Hold'em No Limit ($0.05/$0.10 USD) - 2021/01/23 3:02:49 ET
Table 'Linzia' 6-max Seat #6 is the button
Seat 1: lucima10 ($10.35 in chips) 
Seat 2: MendramoSone ($11.74 in chips) 
Seat 3: Rainlol ($12.20 in chips) 
Seat 4: X-rayFeeling ($14.70 in chips) 
Seat 5: Laker_Style ($10 in chips) 
Seat 6: 12311985 ($13.16 in chips) 
lucima10: posts small blind $0.05
MendramoSone: posts big blind $0.10
*** HOLE CARDS ***
Rainlol: raises $0.20 to $0.30
X-rayFeeling: folds 
Laker_Style: folds 
12311985: folds 
lucima10: folds 
MendramoSone: folds 
Uncalled bet ($0.20) returned to Rainlol
Rainlol collected $0.25 from pot
Rainlol: doesn't show hand 
*** SUMMARY ***
Total pot $0.25 | Rake $0 
Seat 1: lucima10 (small blind) folded before Flop
Seat 2: MendramoSone (big blind) folded before Flop
Seat 3: Rainlol collected ($0.25)
Seat 4: X-rayFeeling folded before Flop (didn't bet)
Seat 5: Laker_Style folded before Flop (didn't bet)
Seat 6: 12311985 (button) folded before Flop (didn't bet)



PokerStars Hand #222947367857:  Hold'em No Limit ($0.05/$0.10 USD) - 2021/01/23 3:03:04 ET
Table 'Linzia' 6-max Seat #1 is the button
Seat 1: lucima10 ($10.30 in chips) 
Seat 2: MendramoSone ($11.64 in chips) 
Seat 3: Rainlol ($12.35 in chips) 
Seat 4: X-rayFeeling ($14.70 in chips) 
Seat 5: Laker_Style ($10 in chips) 
Seat 6: 12311985 ($13.16 in chips) 
MendramoSone: posts small blind $0.05
Rainlol: posts big blind $0.10
*** HOLE CARDS ***
X-rayFeeling: folds 
Laker_Style: folds 
12311985: folds 
lucima10: folds 
MendramoSone: folds 
Uncalled bet ($0.05) returned to Rainlol
Rainlol collected $0.10 from pot
Rainlol: doesn't show hand 
*** SUMMARY ***
Total pot $0.10 | Rake $0 
Seat 1: lucima10 (button) folded before Flop (didn't bet)
Seat 2: MendramoSone (small blind) folded before Flop
Seat 3: Rainlol (big blind) collected ($0.10)
Seat 4: X-rayFeeling folded before Flop (didn't bet)
Seat 5: Laker_Style folded before Flop (didn't bet)
Seat 6: 12311985 folded before Flop (didn't bet)



PokerStars Hand #222947374077:  Hold'em No Limit ($0.05/$0.10 USD) - 2021/01/23 3:03:30 ET
Table 'Linzia' 6-max Seat #2 is the button
Seat 1: lucima10 ($10.30 in chips) 
Seat 2: MendramoSone ($11.59 in chips) 
Seat 3: Rainlol ($12.40 in chips) 
Seat 5: Laker_Style ($10 in chips) 
Seat 6: 12311985 ($13.16 in chips) 
Rainlol: posts small blind $0.05
X-rayFeeling: is sitting out 
Laker_Style: posts big blind $0.10
*** HOLE CARDS ***
X-rayFeeling leaves the table
12311985: folds 
lucima10: folds 
pastarmaa joins the table at seat #4 
MendramoSone: folds 
Rainlol: raises $0.20 to $0.30
Laker_Style: folds 
Uncalled bet ($0.20) returned to Rainlol
Rainlol collected $0.20 from pot
Rainlol: doesn't show hand 
*** SUMMARY ***
Total pot $0.20 | Rake $0 
Seat 1: lucima10 folded before Flop (didn't bet)
Seat 2: MendramoSone (button) folded before Flop (didn't bet)
Seat 3: Rainlol (small blind) collected ($0.20)
Seat 5: Laker_Style (big blind) folded before Flop
Seat 6: 12311985 folded before Flop (didn't bet)



PokerStars Hand #222947378523:  Hold'em No Limit ($0.05/$0.10 USD) - 2021/01/23 3:03:49 ET
Table 'Linzia' 6-max Seat #3 is the button
Seat 1: lucima10 ($10.30 in chips) 
Seat 2: MendramoSone ($11.59 in chips) 
Seat 3: Rainlol ($12.50 in chips) 
Seat 5: Laker_Style ($10 in chips) 
Seat 6: 12311985 ($13.16 in chips) 
Laker_Style: posts small blind $0.05
12311985: posts big blind $0.10
*** HOLE CARDS ***
lucima10: folds 
MendramoSone: raises $0.10 to $0.20
Rainlol: raises $0.50 to $0.70
Laker_Style: folds 
12311985: folds 
MendramoSone: folds 
Uncalled bet ($0.50) returned to Rainlol
Rainlol collected $0.55 from pot
Rainlol: doesn't show hand 
*** SUMMARY ***
Total pot $0.55 | Rake $0 
Seat 1: lucima10 folded before Flop (didn't bet)
Seat 2: MendramoSone folded before Flop
Seat 3: Rainlol (button) collected ($0.55)
Seat 5: Laker_Style (small blind) folded before Flop
Seat 6: 12311985 (big blind) folded before Flop



PokerStars Hand #222947386537:  Hold'em No Limit ($0.05/$0.10 USD) - 2021/01/23 3:04:24 ET
Table 'Linzia' 6-max Seat #5 is the button
Seat 1: lucima10 ($10.30 in chips) 
Seat 2: MendramoSone ($11.39 in chips) 
Seat 3: Rainlol ($12.85 in chips) 
Seat 4: pastarmaa ($4 in chips) 
Seat 5: Laker_Style ($10 in chips) 
Seat 6: 12311985 ($13.06 in chips) 
12311985: posts small blind $0.05
lucima10: posts big blind $0.10
pastarmaa: posts big blind $0.10
*** HOLE CARDS ***
MendramoSone: folds 
Rainlol: folds 
pastarmaa: checks 
Laker_Style: raises $0.40 to $0.50
12311985: folds 
lucima10: folds 
pastarmaa: folds 
Uncalled bet ($0.40) returned to Laker_Style
Laker_Style collected $0.35 from pot
Laker_Style: doesn't show hand 
*** SUMMARY ***
Total pot $0.35 | Rake $0 
Seat 1: lucima10 (big blind) folded before Flop
Seat 2: MendramoSone folded before Flop (didn't bet)
Seat 3: Rainlol folded before Flop (didn't bet)
Seat 4: pastarmaa folded before Flop (didn't bet)
Seat 5: Laker_Style (button) collected ($0.35)
Seat 6: 12311985 (small blind) folded before Flop



PokerStars Hand #222947391664:  Hold'em No Limit ($0.05/$0.10 USD) - 2021/01/23 3:04:46 ET
Table 'Linzia' 6-max Seat #6 is the button
Seat 1: lucima10 ($10.20 in chips) 
Seat 2: MendramoSone ($11.39 in chips) 
Seat 3: Rainlol ($12.85 in chips) 
Seat 4: pastarmaa ($3.90 in chips) 
Seat 5: Laker_Style ($10.25 in chips) 
Seat 6: 12311985 ($13.01 in chips) 
lucima10: posts small blind $0.05
MendramoSone: posts big blind $0.10
*** HOLE CARDS ***
Rainlol: folds 
pastarmaa: raises $0.20 to $0.30
Laker_Style: folds 
12311985: folds 
lucima10: folds 
MendramoSone: calls $0.20
*** FLOP *** [2s 9s 2c]
MendramoSone: checks 
pastarmaa: bets $0.30
MendramoSone: folds 
Uncalled bet ($0.30) returned to pastarmaa
pastarmaa collected $0.62 from pot
pastarmaa: doesn't show hand 
*** SUMMARY ***
Total pot $0.65 | Rake $0.03 
Board [2s 9s 2c]
Seat 1: lucima10 (small blind) folded before Flop
Seat 2: MendramoSone (big blind) folded on the Flop
Seat 3: Rainlol folded before Flop (didn't bet)
Seat 4: pastarmaa collected ($0.62)
Seat 5: Laker_Style folded before Flop (didn't bet)
Seat 6: 12311985 (button) folded before Flop (didn't bet)



PokerStars Hand #222947397144:  Hold'em No Limit ($0.05/$0.10 USD) - 2021/01/23 3:05:09 ET
Table 'Linzia' 6-max Seat #1 is the button
Seat 1: lucima10 ($10.15 in chips) 
Seat 2: MendramoSone ($11.09 in chips) 
Seat 3: Rainlol ($12.85 in chips) 
Seat 4: pastarmaa ($4.22 in chips) 
Seat 5: Laker_Style ($10.25 in chips) 
Seat 6: 12311985 ($13.01 in chips) 
MendramoSone: posts small blind $0.05
Rainlol: posts big blind $0.10
*** HOLE CARDS ***
pastarmaa: folds 
Laker_Style: folds 
12311985: raises $0.15 to $0.25
lucima10: folds 
MendramoSone: folds 
Rainlol: folds 
Uncalled bet ($0.15) returned to 12311985
12311985 collected $0.25 from pot
12311985: doesn't show hand 
*** SUMMARY ***
Total pot $0.25 | Rake $0 
Seat 1: lucima10 (button) folded before Flop (didn't bet)
Seat 2: MendramoSone (small blind) folded before Flop
Seat 3: Rainlol (big blind) folded before Flop
Seat 4: pastarmaa folded before Flop (didn't bet)
Seat 5: Laker_Style folded before Flop (didn't bet)
Seat 6: 12311985 collected ($0.25)



PokerStars Hand #222947401258:  Hold'em No Limit ($0.05/$0.10 USD) - 2021/01/23 3:05:27 ET
Table 'Linzia' 6-max Seat #2 is the button
Seat 1: lucima10 ($10.15 in chips) 
Seat 2: MendramoSone ($11.04 in chips) 
Seat 3: Rainlol ($12.75 in chips) 
Seat 4: pastarmaa ($4.22 in chips) 
Seat 5: Laker_Style ($10.25 in chips) 
Seat 6: 12311985 ($13.16 in chips) 
Rainlol: posts small blind $0.05
pastarmaa: posts big blind $0.10
*** HOLE CARDS ***
Laker_Style: folds 
12311985: folds 
lucima10: folds 
MendramoSone: folds 
Rainlol: raises $0.20 to $0.30
pastarmaa: calls $0.20
*** FLOP *** [4d 9c 3d]
Rainlol: bets $0.20
pastarmaa: calls $0.20
*** TURN *** [4d 9c 3d] [Kd]
Rainlol: checks 
pastarmaa: bets $0.30
Rainlol: folds 
Uncalled bet ($0.30) returned to pastarmaa
pastarmaa collected $0.96 from pot
pastarmaa: doesn't show hand 
*** SUMMARY ***
Total pot $1 | Rake $0.04 
Board [4d 9c 3d Kd]
Seat 1: lucima10 folded before Flop (didn't bet)
Seat 2: MendramoSone (button) folded before Flop (didn't bet)
Seat 3: Rainlol (small blind) folded on the Turn
Seat 4: pastarmaa (big blind) collected ($0.96)
Seat 5: Laker_Style folded before Flop (didn't bet)
Seat 6: 12311985 folded before Flop (didn't bet)



PokerStars Hand #222947407081:  Hold'em No Limit ($0.05/$0.10 USD) - 2021/01/23 3:05:52 ET
Table 'Linzia' 6-max Seat #3 is the button
Seat 1: lucima10 ($10.15 in chips) 
Seat 2: MendramoSone ($11.04 in chips) 
Seat 3: Rainlol ($12.25 in chips) 
Seat 4: pastarmaa ($4.68 in chips) 
Seat 5: Laker_Style ($10.25 in chips) 
Seat 6: 12311985 ($13.16 in chips) 
pastarmaa: posts small blind $0.05
Laker_Style: posts big blind $0.10
*** HOLE CARDS ***
12311985: folds 
lucima10: folds 
MendramoSone: raises $0.20 to $0.30
Rainlol: folds 
pastarmaa: calls $0.25
Laker_Style: folds 
*** FLOP *** [Qh Js 3d]
pastarmaa: checks 
MendramoSone: bets $0.30
pastarmaa: calls $0.30
*** TURN *** [Qh Js 3d] [Td]
pastarmaa: checks 
MendramoSone: checks 
*** RIVER *** [Qh Js 3d Td] [5d]
pastarmaa: bets $0.62
MendramoSone: folds 
Uncalled bet ($0.62) returned to pastarmaa
pastarmaa collected $1.24 from pot
pastarmaa: doesn't show hand 
*** SUMMARY ***
Total pot $1.30 | Rake $0.06 
Board [Qh Js 3d Td 5d]
Seat 1: lucima10 folded before Flop (didn't bet)
Seat 2: MendramoSone folded on the River
Seat 3: Rainlol (button) folded before Flop (didn't bet)
Seat 4: pastarmaa (small blind) collected ($1.24)
Seat 5: Laker_Style (big blind) folded before Flop
Seat 6: 12311985 folded before Flop (didn't bet)



PokerStars Hand #222947415868:  Hold'em No Limit ($0.05/$0.10 USD) - 2021/01/23 3:06:30 ET
Table 'Linzia' 6-max Seat #4 is the button
Seat 1: lucima10 ($10.15 in chips) 
Seat 2: MendramoSone ($10.44 in chips) 
Seat 3: Rainlol ($12.25 in chips) 
Seat 4: pastarmaa ($5.32 in chips) 
Seat 5: Laker_Style ($10.15 in chips) 
Seat 6: 12311985 ($13.16 in chips) 
Laker_Style: posts small blind $0.05
12311985: posts big blind $0.10
*** HOLE CARDS ***
lucima10: folds 
MendramoSone: folds 
Rainlol: folds 
pastarmaa: folds 
Laker_Style: folds 
Uncalled bet ($0.05) returned to 12311985
12311985 collected $0.10 from pot
12311985: doesn't show hand 
*** SUMMARY ***
Total pot $0.10 | Rake $0 
Seat 1: lucima10 folded before Flop (didn't bet)
Seat 2: MendramoSone folded before Flop (didn't bet)
Seat 3: Rainlol folded before Flop (didn't bet)
Seat 4: pastarmaa (button) folded before Flop (didn't bet)
Seat 5: Laker_Style (small blind) folded before Flop
Seat 6: 12311985 (big blind) collected ($0.10)



PokerStars Hand #222947419293:  Hold'em No Limit ($0.05/$0.10 USD) - 2021/01/23 3:06:45 ET
Table 'Linzia' 6-max Seat #5 is the button
Seat 1: lucima10 ($10.15 in chips) 
Seat 2: MendramoSone ($10.44 in chips) 
Seat 3: Rainlol ($12.25 in chips) 
Seat 4: pastarmaa ($5.32 in chips) 
Seat 5: Laker_Style ($10.10 in chips) 
Seat 6: 12311985 ($13.21 in chips) 
12311985: posts small blind $0.05
lucima10: posts big blind $0.10
*** HOLE CARDS ***
MendramoSone: raises $0.10 to $0.20
Rainlol: calls $0.20
pastarmaa: folds 
Laker_Style: folds 
12311985: calls $0.15
lucima10: folds 
*** FLOP *** [Kh 8d Td]
12311985: checks 
MendramoSone: checks 
Rainlol: checks 
*** TURN *** [Kh 8d Td] [4s]
12311985: bets $0.34
MendramoSone: calls $0.34
Rainlol: folds 
*** RIVER *** [Kh 8d Td 4s] [4h]
12311985: checks 
MendramoSone: checks 
*** SHOW DOWN ***
12311985: shows [9h 7h] (a pair of Fours)
MendramoSone: shows [Qs 9s] (a pair of Fours - King+Queen kicker)
MendramoSone collected $1.32 from pot
*** SUMMARY ***
Total pot $1.38 | Rake $0.06 
Board [Kh 8d Td 4s 4h]
Seat 1: lucima10 (big blind) folded before Flop
Seat 2: MendramoSone showed [Qs 9s] and won ($1.32) with a pair of Fours
Seat 3: Rainlol folded on the Turn
Seat 4: pastarmaa folded before Flop (didn't bet)
Seat 5: Laker_Style (button) folded before Flop (didn't bet)
Seat 6: 12311985 (small blind) showed [9h 7h] and lost with a pair of Fours



PokerStars Hand #222947427715:  Hold'em No Limit ($0.05/$0.10 USD) - 2021/01/23 3:07:21 ET
Table 'Linzia' 6-max Seat #6 is the button
Seat 1: lucima10 ($10.05 in chips) 
Seat 2: MendramoSone ($11.22 in chips) 
Seat 3: Rainlol ($12.05 in chips) 
Seat 4: pastarmaa ($5.32 in chips) 
Seat 5: Laker_Style ($10.10 in chips) 
Seat 6: 12311985 ($12.67 in chips) 
lucima10: posts small blind $0.05
MendramoSone: posts big blind $0.10
*** HOLE CARDS ***
Rainlol: folds 
pastarmaa: raises $0.20 to $0.30
Laker_Style: folds 
12311985: calls $0.30
lucima10: raises $0.80 to $1.10
MendramoSone: folds 
pastarmaa: folds 
12311985: folds 
Uncalled bet ($0.80) returned to lucima10
lucima10 collected $1 from pot
lucima10: doesn't show hand 
*** SUMMARY ***
Total pot $1 | Rake $0 
Seat 1: lucima10 (small blind) collected ($1)
Seat 2: MendramoSone (big blind) folded before Flop
Seat 3: Rainlol folded before Flop (didn't bet)
Seat 4: pastarmaa folded before Flop
Seat 5: Laker_Style folded before Flop (didn't bet)
Seat 6: 12311985 (button) folded before Flop



PokerStars Hand #222947433138:  Hold'em No Limit ($0.05/$0.10 USD) - 2021/01/23 3:07:45 ET
Table 'Linzia' 6-max Seat #1 is the button
Seat 1: lucima10 ($10.75 in chips) 
Seat 2: MendramoSone ($11.12 in chips) 
Seat 3: Rainlol ($12.05 in chips) 
Seat 4: pastarmaa ($5.02 in chips) 
Seat 5: Laker_Style ($10.10 in chips) 
Seat 6: 12311985 ($12.37 in chips) 
MendramoSone: posts small blind $0.05
Rainlol: posts big blind $0.10
*** HOLE CARDS ***
pastarmaa: calls $0.10
Laker_Style: raises $0.30 to $0.40
12311985: folds 
lucima10: raises $1.10 to $1.50
MendramoSone: folds 
Rainlol: folds 
pastarmaa: folds 
Laker_Style: calls $1.10
*** FLOP *** [Qc 4c 4s]
Laker_Style: checks 
lucima10: bets $0.80
Laker_Style: calls $0.80
*** TURN *** [Qc 4c 4s] [Ts]
Laker_Style: checks 
lucima10: bets $1.60
Laker_Style: folds 
Uncalled bet ($1.60) returned to lucima10
lucima10 collected $4.63 from pot
lucima10: doesn't show hand 
*** SUMMARY ***
Total pot $4.85 | Rake $0.22 
Board [Qc 4c 4s Ts]
Seat 1: lucima10 (button) collected ($4.63)
Seat 2: MendramoSone (small blind) folded before Flop
Seat 3: Rainlol (big blind) folded before Flop
Seat 4: pastarmaa folded before Flop
Seat 5: Laker_Style folded on the Turn
Seat 6: 12311985 folded before Flop (didn't bet)



PokerStars Hand #222947456608:  Hold'em No Limit ($0.05/$0.10 USD) - 2021/01/23 3:09:26 ET
Table 'Linzia' 6-max Seat #2 is the button
Seat 1: lucima10 ($13.08 in chips) 
Seat 2: MendramoSone ($11.07 in chips) 
Seat 3: Rainlol ($11.95 in chips) 
Seat 4: pastarmaa ($4.92 in chips) 
Seat 5: Laker_Style ($10 in chips) 
Seat 6: 12311985 ($12.37 in chips) 
Rainlol: posts small blind $0.05
pastarmaa: posts big blind $0.10
*** HOLE CARDS ***
Laker_Style has timed out
Laker_Style: folds 
12311985: raises $0.15 to $0.25
lucima10: folds 
MendramoSone: folds 
Rainlol: folds 
pastarmaa: calls $0.15
*** FLOP *** [9s 7c 8h]
pastarmaa: checks 
12311985: checks 
*** TURN *** [9s 7c 8h] [Kh]
pastarmaa: bets $0.20
12311985: folds 
Uncalled bet ($0.20) returned to pastarmaa
pastarmaa collected $0.53 from pot
pastarmaa: doesn't show hand 
*** SUMMARY ***
Total pot $0.55 | Rake $0.02 
Board [9s 7c 8h Kh]
Seat 1: lucima10 folded before Flop (didn't bet)
Seat 2: MendramoSone (button) folded before Flop (didn't bet)
Seat 3: Rainlol (small blind) folded before Flop
Seat 4: pastarmaa (big blind) collected ($0.53)
Seat 5: Laker_Style folded before Flop (didn't bet)
Seat 6: 12311985 folded on the Turn



PokerStars Hand #222947464510:  Hold'em No Limit ($0.05/$0.10 USD) - 2021/01/23 3:10:00 ET
Table 'Linzia' 6-max Seat #3 is the button
Seat 1: lucima10 ($13.08 in chips) 
Seat 2: MendramoSone ($11.07 in chips) 
Seat 3: Rainlol ($11.90 in chips) 
Seat 4: pastarmaa ($5.20 in chips) 
Seat 5: Laker_Style ($10 in chips) 
Seat 6: 12311985 ($12.12 in chips) 
pastarmaa: posts small blind $0.05
Laker_Style: posts big blind $0.10
*** HOLE CARDS ***
12311985: folds 
lucima10: folds 
MendramoSone: raises $0.10 to $0.20
Rainlol: folds 
pastarmaa: calls $0.15
Laker_Style: folds 
*** FLOP *** [8s 3s 9d]
pastarmaa: checks 
MendramoSone: bets $0.50
pastarmaa: calls $0.50
*** TURN *** [8s 3s 9d] [7c]
pastarmaa: checks 
MendramoSone: bets $0.70
pastarmaa: calls $0.70
*** RIVER *** [8s 3s 9d 7c] [Ac]
pastarmaa: bets $1.38
MendramoSone: folds 
Uncalled bet ($1.38) returned to pastarmaa
pastarmaa collected $2.77 from pot
pastarmaa: doesn't show hand 
*** SUMMARY ***
Total pot $2.90 | Rake $0.13 
Board [8s 3s 9d 7c Ac]
Seat 1: lucima10 folded before Flop (didn't bet)
Seat 2: MendramoSone folded on the River
Seat 3: Rainlol (button) folded before Flop (didn't bet)
Seat 4: pastarmaa (small blind) collected ($2.77)
Seat 5: Laker_Style (big blind) folded before Flop
Seat 6: 12311985 folded before Flop (didn't bet)



PokerStars Hand #222947473780:  Hold'em No Limit ($0.05/$0.10 USD) - 2021/01/23 3:10:39 ET
Table 'Linzia' 6-max Seat #4 is the button
Seat 1: lucima10 ($13.08 in chips) 
Seat 2: MendramoSone ($9.67 in chips) 
Seat 3: Rainlol ($11.90 in chips) 
Seat 4: pastarmaa ($6.57 in chips) 
Seat 5: Laker_Style ($10 in chips) 
Seat 6: 12311985 ($12.12 in chips) 
Laker_Style: posts small blind $0.05
12311985: posts big blind $0.10
*** HOLE CARDS ***
lucima10: raises $0.20 to $0.30
MendramoSone: calls $0.30
Rainlol: folds 
pastarmaa: calls $0.30
Laker_Style: folds 
12311985: folds 
*** FLOP *** [Qs As 4c]
lucima10: checks 
MendramoSone: checks 
pastarmaa: bets $0.30
lucima10: calls $0.30
MendramoSone: calls $0.30
*** TURN *** [Qs As 4c] [4s]
lucima10: checks 
MendramoSone: bets $0.90
pastarmaa: folds 
lucima10: folds 
Uncalled bet ($0.90) returned to MendramoSone
MendramoSone collected $1.86 from pot
MendramoSone: doesn't show hand 
*** SUMMARY ***
Total pot $1.95 | Rake $0.09 
Board [Qs As 4c 4s]
Seat 1: lucima10 folded on the Turn
Seat 2: MendramoSone collected ($1.86)
Seat 3: Rainlol folded before Flop (didn't bet)
Seat 4: pastarmaa (button) folded on the Turn
Seat 5: Laker_Style (small blind) folded before Flop
Seat 6: 12311985 (big blind) folded before Flop



PokerStars Hand #222947485280:  Hold'em No Limit ($0.05/$0.10 USD) - 2021/01/23 3:11:28 ET
Table 'Linzia' 6-max Seat #5 is the button
Seat 1: lucima10 ($12.48 in chips) 
Seat 2: MendramoSone ($10.93 in chips) 
Seat 3: Rainlol ($11.90 in chips) 
Seat 4: pastarmaa ($5.97 in chips) 
Seat 5: Laker_Style ($10 in chips) 
Seat 6: 12311985 ($12.02 in chips) 
12311985: posts small blind $0.05
lucima10: posts big blind $0.10
*** HOLE CARDS ***
MendramoSone: folds 
Rainlol: folds 
pastarmaa: folds 
Laker_Style: folds 
pastarmaa leaves the table
12311985: folds 
Uncalled bet ($0.05) returned to lucima10
lucima10 collected $0.10 from pot
lucima10: doesn't show hand 
*** SUMMARY ***
Total pot $0.10 | Rake $0 
Seat 1: lucima10 (big blind) collected ($0.10)
Seat 2: MendramoSone folded before Flop (didn't bet)
Seat 3: Rainlol folded before Flop (didn't bet)
Seat 4: pastarmaa folded before Flop (didn't bet)
Seat 5: Laker_Style (button) folded before Flop (didn't bet)
Seat 6: 12311985 (small blind) folded before Flop



PokerStars Hand #222947488712:  Hold'em No Limit ($0.05/$0.10 USD) - 2021/01/23 3:11:43 ET
Table 'Linzia' 6-max Seat #6 is the button
Seat 1: lucima10 ($12.53 in chips) 
Seat 2: MendramoSone ($10.93 in chips) 
Seat 3: Rainlol ($11.90 in chips) 
Seat 5: Laker_Style ($10 in chips) 
Seat 6: 12311985 ($11.97 in chips) 
lucima10: posts small blind $0.05
MendramoSone: posts big blind $0.10
*** HOLE CARDS ***
Rainlol: folds 
Laker_Style: folds 
12311985: raises $0.20 to $0.30
MayZerG joins the table at seat #4 
lucima10: folds 
MendramoSone: folds 
Uncalled bet ($0.20) returned to 12311985
12311985 collected $0.25 from pot
12311985: doesn't show hand 
MayZerG leaves the table
*** SUMMARY ***
Total pot $0.25 | Rake $0 
Seat 1: lucima10 (small blind) folded before Flop
Seat 2: MendramoSone (big blind) folded before Flop
Seat 3: Rainlol folded before Flop (didn't bet)
Seat 5: Laker_Style folded before Flop (didn't bet)
Seat 6: 12311985 (button) collected ($0.25)



PokerStars Hand #222947493135:  Hold'em No Limit ($0.05/$0.10 USD) - 2021/01/23 3:12:02 ET
Table 'Linzia' 6-max Seat #1 is the button
Seat 1: lucima10 ($12.48 in chips) 
Seat 2: MendramoSone ($10.83 in chips) 
Seat 3: Rainlol ($11.90 in chips) 
Seat 5: Laker_Style ($10 in chips) 
Seat 6: 12311985 ($12.12 in chips) 
MendramoSone: posts small blind $0.05
Rainlol: posts big blind $0.10
*** HOLE CARDS ***
Laker_Style has timed out
Laker_Style: folds 
12311985: folds 
lucima10: raises $0.20 to $0.30
MendramoSone: folds 
Rainlol: folds 
Uncalled bet ($0.20) returned to lucima10
lucima10 collected $0.25 from pot
lucima10: doesn't show hand 
*** SUMMARY ***
Total pot $0.25 | Rake $0 
Seat 1: lucima10 (button) collected ($0.25)
Seat 2: MendramoSone (small blind) folded before Flop
Seat 3: Rainlol (big blind) folded before Flop
Seat 5: Laker_Style folded before Flop (didn't bet)
Seat 6: 12311985 folded before Flop (didn't bet)



PokerStars Hand #222947498675:  Hold'em No Limit ($0.05/$0.10 USD) - 2021/01/23 3:12:25 ET
Table 'Linzia' 6-max Seat #2 is the button
Seat 1: lucima10 ($12.63 in chips) 
Seat 2: MendramoSone ($10.78 in chips) 
Seat 3: Rainlol ($11.80 in chips) 
Seat 5: Laker_Style ($10 in chips) 
Seat 6: 12311985 ($12.12 in chips) 
Rainlol: posts small blind $0.05
Laker_Style: posts big blind $0.10
*** HOLE CARDS ***
12311985: folds 
lucima10: raises $0.15 to $0.25
MendramoSone: folds 
Rainlol: folds 
Laker_Style: folds 
Uncalled bet ($0.15) returned to lucima10
lucima10 collected $0.25 from pot
lucima10: doesn't show hand 
*** SUMMARY ***
Total pot $0.25 | Rake $0 
Seat 1: lucima10 collected ($0.25)
Seat 2: MendramoSone (button) folded before Flop (didn't bet)
Seat 3: Rainlol (small blind) folded before Flop
Seat 5: Laker_Style (big blind) folded before Flop
Seat 6: 12311985 folded before Flop (didn't bet)



PokerStars Hand #222947504469:  Hold'em No Limit ($0.05/$0.10 USD) - 2021/01/23 3:12:50 ET
Table 'Linzia' 6-max Seat #3 is the button
Seat 1: lucima10 ($12.78 in chips) 
Seat 2: MendramoSone ($10.78 in chips) 
Seat 3: Rainlol ($11.75 in chips) 
Seat 5: Laker_Style ($10 in chips) 
Seat 6: 12311985 ($12.12 in chips) 
Laker_Style: posts small blind $0.05
12311985: posts big blind $0.10
*** HOLE CARDS ***
lucima10: folds 
MendramoSone: folds 
Rainlol: raises $0.20 to $0.30
Laker_Style: folds 
12311985: raises $0.90 to $1.20
Rainlol: folds 
Uncalled bet ($0.90) returned to 12311985
12311985 collected $0.65 from pot
12311985: doesn't show hand 
*** SUMMARY ***
Total pot $0.65 | Rake $0 
Seat 1: lucima10 folded before Flop (didn't bet)
Seat 2: MendramoSone folded before Flop (didn't bet)
Seat 3: Rainlol (button) folded before Flop
Seat 5: Laker_Style (small blind) folded before Flop
Seat 6: 12311985 (big blind) collected ($0.65)



PokerStars Hand #222947510440:  Hold'em No Limit ($0.05/$0.10 USD) - 2021/01/23 3:13:15 ET
Table 'Linzia' 6-max Seat #5 is the button
Seat 1: lucima10 ($12.78 in chips) 
Seat 2: MendramoSone ($10.78 in chips) 
Seat 3: Rainlol ($11.45 in chips) 
Seat 5: Laker_Style ($10 in chips) 
Seat 6: 12311985 ($12.47 in chips) 
12311985: posts small blind $0.05
lucima10: posts big blind $0.10
*** HOLE CARDS ***
MendramoSone: raises $0.20 to $0.30
Rainlol: folds 
Laker_Style: folds 
12311985: folds 
lucima10: raises $0.70 to $1
FeverPitch44 joins the table at seat #4 
MendramoSone: folds 
Uncalled bet ($0.70) returned to lucima10
lucima10 collected $0.65 from pot
lucima10: doesn't show hand 
*** SUMMARY ***
Total pot $0.65 | Rake $0 
Seat 1: lucima10 (big blind) collected ($0.65)
Seat 2: MendramoSone folded before Flop
Seat 3: Rainlol folded before Flop (didn't bet)
Seat 5: Laker_Style (button) folded before Flop (didn't bet)
Seat 6: 12311985 (small blind) folded before Flop



PokerStars Hand #222947519443:  Hold'em No Limit ($0.05/$0.10 USD) - 2021/01/23 3:13:53 ET
Table 'Linzia' 6-max Seat #6 is the button
Seat 1: lucima10 ($13.13 in chips) 
Seat 2: MendramoSone ($10.48 in chips) 
Seat 3: Rainlol ($11.45 in chips) 
Seat 5: Laker_Style ($10 in chips) 
Seat 6: 12311985 ($12.42 in chips) 
lucima10: posts small blind $0.05
MendramoSone: posts big blind $0.10
FeverPitch44: sits out 
*** HOLE CARDS ***
Rainlol: raises $0.20 to $0.30
Laker_Style: folds 
12311985: folds 
lucima10: folds 
MendramoSone: raises $0.75 to $1.05
Rainlol: folds 
Uncalled bet ($0.75) returned to MendramoSone
MendramoSone collected $0.65 from pot
MendramoSone: doesn't show hand 
*** SUMMARY ***
Total pot $0.65 | Rake $0 
Seat 1: lucima10 (small blind) folded before Flop
Seat 2: MendramoSone (big blind) collected ($0.65)
Seat 3: Rainlol folded before Flop
Seat 5: Laker_Style folded before Flop (didn't bet)
Seat 6: 12311985 (button) folded before Flop (didn't bet)



PokerStars Hand #222947523125:  Hold'em No Limit ($0.05/$0.10 USD) - 2021/01/23 3:14:08 ET
Table 'Linzia' 6-max Seat #1 is the button
Seat 1: lucima10 ($13.08 in chips) 
Seat 2: MendramoSone ($10.83 in chips) 
Seat 3: Rainlol ($11.15 in chips) 
Seat 5: Laker_Style ($10 in chips) 
Seat 6: 12311985 ($12.42 in chips) 
MendramoSone: posts small blind $0.05
Rainlol: posts big blind $0.10
FeverPitch44: sits out 
*** HOLE CARDS ***
Laker_Style: folds 
12311985: folds 
lucima10: folds 
MendramoSone: raises $0.10 to $0.20
Rainlol: calls $0.10
*** FLOP *** [Ks Ts 7c]
FeverPitch44 leaves the table
gokudousan joins the table at seat #4 
MendramoSone: checks 
Rainlol: bets $0.25
MendramoSone: calls $0.25
*** TURN *** [Ks Ts 7c] [Ah]
MendramoSone: checks 
Rainlol: checks 
*** RIVER *** [Ks Ts 7c Ah] [5d]
MendramoSone: checks 
Rainlol: bets $0.57
MendramoSone: folds 
Uncalled bet ($0.57) returned to Rainlol
Rainlol collected $0.86 from pot
Rainlol: doesn't show hand 
*** SUMMARY ***
Total pot $0.90 | Rake $0.04 
Board [Ks Ts 7c Ah 5d]
Seat 1: lucima10 (button) folded before Flop (didn't bet)
Seat 2: MendramoSone (small blind) folded on the River
Seat 3: Rainlol (big blind) collected ($0.86)
Seat 5: Laker_Style folded before Flop (didn't bet)
Seat 6: 12311985 folded before Flop (didn't bet)



PokerStars Hand #222947532261:  Hold'em No Limit ($0.05/$0.10 USD) - 2021/01/23 3:14:47 ET
Table 'Linzia' 6-max Seat #2 is the button
Seat 1: lucima10 ($13.08 in chips) 
Seat 2: MendramoSone ($10.38 in chips) 
Seat 3: Rainlol ($11.56 in chips) 
Seat 4: gokudousan ($10 in chips) 
Seat 5: Laker_Style ($10 in chips) 
Seat 6: 12311985 ($12.42 in chips) 
Rainlol: posts small blind $0.05
gokudousan: posts big blind $0.10
*** HOLE CARDS ***
Laker_Style: folds 
12311985: folds 
lucima10: folds 
MendramoSone: folds 
Rainlol: raises $0.20 to $0.30
gokudousan: folds 
Uncalled bet ($0.20) returned to Rainlol
Rainlol collected $0.20 from pot
Rainlol: doesn't show hand 
*** SUMMARY ***
Total pot $0.20 | Rake $0 
Seat 1: lucima10 folded before Flop (didn't bet)
Seat 2: MendramoSone (button) folded before Flop (didn't bet)
Seat 3: Rainlol (small blind) collected ($0.20)
Seat 4: gokudousan (big blind) folded before Flop
Seat 5: Laker_Style folded before Flop (didn't bet)
Seat 6: 12311985 folded before Flop (didn't bet)



PokerStars Hand #222947535558:  Hold'em No Limit ($0.05/$0.10 USD) - 2021/01/23 3:15:01 ET
Table 'Linzia' 6-max Seat #3 is the button
Seat 1: lucima10 ($13.08 in chips) 
Seat 2: MendramoSone ($10.38 in chips) 
Seat 3: Rainlol ($11.66 in chips) 
Seat 4: gokudousan ($9.90 in chips) 
Seat 5: Laker_Style ($10 in chips) 
Seat 6: 12311985 ($12.42 in chips) 
gokudousan: posts small blind $0.05
Laker_Style: posts big blind $0.10
*** HOLE CARDS ***
12311985: folds 
lucima10: folds 
MendramoSone: folds 
Rainlol: raises $0.20 to $0.30
gokudousan: folds 
Laker_Style: folds 
Uncalled bet ($0.20) returned to Rainlol
Rainlol collected $0.25 from pot
Rainlol: doesn't show hand 
*** SUMMARY ***
Total pot $0.25 | Rake $0 
Seat 1: lucima10 folded before Flop (didn't bet)
Seat 2: MendramoSone folded before Flop (didn't bet)
Seat 3: Rainlol (button) collected ($0.25)
Seat 4: gokudousan (small blind) folded before Flop
Seat 5: Laker_Style (big blind) folded before Flop
Seat 6: 12311985 folded before Flop (didn't bet)



PokerStars Hand #222947541045:  Hold'em No Limit ($0.05/$0.10 USD) - 2021/01/23 3:15:24 ET
Table 'Linzia' 6-max Seat #4 is the button
Seat 1: lucima10 ($13.08 in chips) 
Seat 2: MendramoSone ($10.38 in chips) 
Seat 3: Rainlol ($11.81 in chips) 
Seat 4: gokudousan ($9.85 in chips) 
Seat 5: Laker_Style ($10 in chips) 
Seat 6: 12311985 ($12.42 in chips) 
Laker_Style: posts small blind $0.05
12311985: posts big blind $0.10
*** HOLE CARDS ***
lucima10: folds 
MendramoSone: folds 
Rainlol: folds 
gokudousan: folds 
Laker_Style: raises $0.20 to $0.30
12311985: folds 
Uncalled bet ($0.20) returned to Laker_Style
Laker_Style collected $0.20 from pot
Laker_Style: doesn't show hand 
*** SUMMARY ***
Total pot $0.20 | Rake $0 
Seat 1: lucima10 folded before Flop (didn't bet)
Seat 2: MendramoSone folded before Flop (didn't bet)
Seat 3: Rainlol folded before Flop (didn't bet)
Seat 4: gokudousan (button) folded before Flop (didn't bet)
Seat 5: Laker_Style (small blind) collected ($0.20)
Seat 6: 12311985 (big blind) folded before Flop



PokerStars Hand #222947545240:  Hold'em No Limit ($0.05/$0.10 USD) - 2021/01/23 3:15:41 ET
Table 'Linzia' 6-max Seat #5 is the button
Seat 1: lucima10 ($13.08 in chips) 
Seat 2: MendramoSone ($10.38 in chips) 
Seat 3: Rainlol ($11.81 in chips) 
Seat 4: gokudousan ($9.85 in chips) 
Seat 5: Laker_Style ($10.10 in chips) 
Seat 6: 12311985 ($12.32 in chips) 
12311985: posts small blind $0.05
lucima10: posts big blind $0.10
*** HOLE CARDS ***
MendramoSone: folds 
Rainlol: folds 
gokudousan: raises $0.20 to $0.30
Laker_Style has timed out
Laker_Style: folds 
12311985: folds 
lucima10: folds 
Uncalled bet ($0.20) returned to gokudousan
gokudousan collected $0.25 from pot
gokudousan: doesn't show hand 
*** SUMMARY ***
Total pot $0.25 | Rake $0 
Seat 1: lucima10 (big blind) folded before Flop
Seat 2: MendramoSone folded before Flop (didn't bet)
Seat 3: Rainlol folded before Flop (didn't bet)
Seat 4: gokudousan collected ($0.25)
Seat 5: Laker_Style (button) folded before Flop (didn't bet)
Seat 6: 12311985 (small blind) folded before Flop



PokerStars Hand #222947552788:  Hold'em No Limit ($0.05/$0.10 USD) - 2021/01/23 3:16:13 ET
Table 'Linzia' 6-max Seat #6 is the button
Seat 1: lucima10 ($12.98 in chips) 
Seat 2: MendramoSone ($10.38 in chips) 
Seat 3: Rainlol ($11.81 in chips) 
Seat 4: gokudousan ($10 in chips) 
Seat 5: Laker_Style ($10.10 in chips) 
Seat 6: 12311985 ($12.27 in chips) 
lucima10: posts small blind $0.05
MendramoSone: posts big blind $0.10
*** HOLE CARDS ***
Rainlol: raises $0.20 to $0.30
gokudousan: folds 
Laker_Style: calls $0.30
12311985: folds 
lucima10: folds 
MendramoSone: folds 
*** FLOP *** [4c 2h Th]
Rainlol: bets $0.30
Laker_Style: calls $0.30
*** TURN *** [4c 2h Th] [6h]
Rainlol: checks 
Laker_Style: bets $0.97
Rainlol: folds 
Uncalled bet ($0.97) returned to Laker_Style
Laker_Style collected $1.29 from pot
Laker_Style: doesn't show hand 
*** SUMMARY ***
Total pot $1.35 | Rake $0.06 
Board [4c 2h Th 6h]
Seat 1: lucima10 (small blind) folded before Flop
Seat 2: MendramoSone (big blind) folded before Flop
Seat 3: Rainlol folded on the Turn
Seat 4: gokudousan folded before Flop (didn't bet)
Seat 5: Laker_Style collected ($1.29)
Seat 6: 12311985 (button) folded before Flop (didn't bet)



PokerStars Hand #222947572599:  Hold'em No Limit ($0.05/$0.10 USD) - 2021/01/23 3:17:36 ET
Table 'Linzia' 6-max Seat #1 is the button
Seat 1: lucima10 ($12.93 in chips) 
Seat 2: MendramoSone ($10.28 in chips) 
Seat 3: Rainlol ($11.21 in chips) 
Seat 4: gokudousan ($10 in chips) 
Seat 5: Laker_Style ($10.79 in chips) 
Seat 6: 12311985 ($12.27 in chips) 
MendramoSone: posts small blind $0.05
Rainlol: posts big blind $0.10
*** HOLE CARDS ***
gokudousan: folds 
Laker_Style: raises $0.20 to $0.30
12311985: folds 
lucima10: folds 
MendramoSone: calls $0.25
Rainlol: folds 
*** FLOP *** [Ts Kd 5h]
MendramoSone: bets $0.30
Laker_Style: calls $0.30
*** TURN *** [Ts Kd 5h] [4c]
MendramoSone: bets $0.50
Laker_Style: calls $0.50
*** RIVER *** [Ts Kd 5h 4c] [7s]
MendramoSone: checks 
Laker_Style: checks 
*** SHOW DOWN ***
MendramoSone: shows [Qh Jh] (high card King)
Laker_Style: shows [Jc Tc] (a pair of Tens)
Laker_Style collected $2.20 from pot
*** SUMMARY ***
Total pot $2.30 | Rake $0.10 
Board [Ts Kd 5h 4c 7s]
Seat 1: lucima10 (button) folded before Flop (didn't bet)
Seat 2: MendramoSone (small blind) showed [Qh Jh] and lost with high card King
Seat 3: Rainlol (big blind) folded before Flop
Seat 4: gokudousan folded before Flop (didn't bet)
Seat 5: Laker_Style showed [Jc Tc] and won ($2.20) with a pair of Tens
Seat 6: 12311985 folded before Flop (didn't bet)



PokerStars Hand #222947582744:  Hold'em No Limit ($0.05/$0.10 USD) - 2021/01/23 3:18:18 ET
Table 'Linzia' 6-max Seat #2 is the button
Seat 1: lucima10 ($12.93 in chips) 
Seat 2: MendramoSone ($9.18 in chips) 
Seat 3: Rainlol ($11.11 in chips) 
Seat 4: gokudousan ($10 in chips) 
Seat 5: Laker_Style ($11.89 in chips) 
Seat 6: 12311985 ($12.27 in chips) 
Rainlol: posts small blind $0.05
gokudousan: posts big blind $0.10
*** HOLE CARDS ***
Laker_Style: folds 
12311985: folds 
lucima10: raises $0.15 to $0.25
MendramoSone: raises $0.65 to $0.90
Rainlol: folds 
gokudousan: folds 
lucima10: raises $2.10 to $3
MendramoSone: calls $2.10
*** FLOP *** [6h Ad 2d]
lucima10: bets $1.50
MendramoSone: folds 
Uncalled bet ($1.50) returned to lucima10
lucima10 collected $5.87 from pot
lucima10: doesn't show hand 
*** SUMMARY ***
Total pot $6.15 | Rake $0.28 
Board [6h Ad 2d]
Seat 1: lucima10 collected ($5.87)
Seat 2: MendramoSone (button) folded on the Flop
Seat 3: Rainlol (small blind) folded before Flop
Seat 4: gokudousan (big blind) folded before Flop
Seat 5: Laker_Style folded before Flop (didn't bet)
Seat 6: 12311985 folded before Flop (didn't bet)



PokerStars Hand #222947591125:  Hold'em No Limit ($0.05/$0.10 USD) - 2021/01/23 3:18:53 ET
Table 'Linzia' 6-max Seat #3 is the button
Seat 1: lucima10 ($15.80 in chips) 
Seat 2: MendramoSone ($6.18 in chips) 
Seat 3: Rainlol ($11.06 in chips) 
Seat 4: gokudousan ($9.90 in chips) 
Seat 5: Laker_Style ($11.89 in chips) 
Seat 6: 12311985 ($12.27 in chips) 
gokudousan: posts small blind $0.05
Laker_Style: posts big blind $0.10
*** HOLE CARDS ***
12311985: folds 
lucima10: folds 
MendramoSone: folds 
Rainlol: folds 
gokudousan: raises $0.20 to $0.30
Laker_Style: folds 
Uncalled bet ($0.20) returned to gokudousan
gokudousan collected $0.20 from pot
gokudousan: doesn't show hand 
*** SUMMARY ***
Total pot $0.20 | Rake $0 
Seat 1: lucima10 folded before Flop (didn't bet)
Seat 2: MendramoSone folded before Flop (didn't bet)
Seat 3: Rainlol (button) folded before Flop (didn't bet)
Seat 4: gokudousan (small blind) collected ($0.20)
Seat 5: Laker_Style (big blind) folded before Flop
Seat 6: 12311985 folded before Flop (didn't bet)



PokerStars Hand #222947596686:  Hold'em No Limit ($0.05/$0.10 USD) - 2021/01/23 3:19:17 ET
Table 'Linzia' 6-max Seat #4 is the button
Seat 1: lucima10 ($15.80 in chips) 
Seat 2: MendramoSone ($6.18 in chips) 
Seat 3: Rainlol ($11.06 in chips) 
Seat 4: gokudousan ($10 in chips) 
Seat 5: Laker_Style ($11.79 in chips) 
Seat 6: 12311985 ($12.27 in chips) 
Laker_Style: posts small blind $0.05
12311985: posts big blind $0.10
*** HOLE CARDS ***
lucima10: folds 
MendramoSone: folds 
Rainlol: folds 
gokudousan: raises $0.20 to $0.30
Laker_Style: folds 
12311985: folds 
Uncalled bet ($0.20) returned to gokudousan
gokudousan collected $0.25 from pot
gokudousan: doesn't show hand 
*** SUMMARY ***
Total pot $0.25 | Rake $0 
Seat 1: lucima10 folded before Flop (didn't bet)
Seat 2: MendramoSone folded before Flop (didn't bet)
Seat 3: Rainlol folded before Flop (didn't bet)
Seat 4: gokudousan (button) collected ($0.25)
Seat 5: Laker_Style (small blind) folded before Flop
Seat 6: 12311985 (big blind) folded before Flop



PokerStars Hand #222947600895:  Hold'em No Limit ($0.05/$0.10 USD) - 2021/01/23 3:19:34 ET
Table 'Linzia' 6-max Seat #5 is the button
Seat 1: lucima10 ($15.80 in chips) 
Seat 2: MendramoSone ($6.18 in chips) 
Seat 3: Rainlol ($11.06 in chips) 
Seat 4: gokudousan ($10.15 in chips) 
Seat 5: Laker_Style ($11.74 in chips) 
Seat 6: 12311985 ($12.17 in chips) 
12311985: posts small blind $0.05
lucima10: posts big blind $0.10
*** HOLE CARDS ***
MendramoSone: raises $0.10 to $0.20
Rainlol: folds 
gokudousan: folds 
Laker_Style: folds 
12311985: folds 
lucima10: folds 
Uncalled bet ($0.10) returned to MendramoSone
MendramoSone collected $0.25 from pot
MendramoSone: doesn't show hand 
*** SUMMARY ***
Total pot $0.25 | Rake $0 
Seat 1: lucima10 (big blind) folded before Flop
Seat 2: MendramoSone collected ($0.25)
Seat 3: Rainlol folded before Flop (didn't bet)
Seat 4: gokudousan folded before Flop (didn't bet)
Seat 5: Laker_Style (button) folded before Flop (didn't bet)
Seat 6: 12311985 (small blind) folded before Flop



PokerStars Hand #222947605579:  Hold'em No Limit ($0.05/$0.10 USD) - 2021/01/23 3:19:54 ET
Table 'Linzia' 6-max Seat #6 is the button
Seat 1: lucima10 ($15.70 in chips) 
Seat 2: MendramoSone ($6.33 in chips) 
Seat 3: Rainlol ($11.06 in chips) 
Seat 4: gokudousan ($10.15 in chips) 
Seat 5: Laker_Style ($11.74 in chips) 
Seat 6: 12311985 ($12.12 in chips) 
lucima10: posts small blind $0.05
MendramoSone: posts big blind $0.10
*** HOLE CARDS ***
Rainlol: folds 
gokudousan: folds 
Laker_Style: folds 
12311985: folds 
lucima10: raises $0.30 to $0.40
MendramoSone: folds 
Uncalled bet ($0.30) returned to lucima10
lucima10 collected $0.20 from pot
lucima10: doesn't show hand 
*** SUMMARY ***
Total pot $0.20 | Rake $0 
Seat 1: lucima10 (small blind) collected ($0.20)
Seat 2: MendramoSone (big blind) folded before Flop
Seat 3: Rainlol folded before Flop (didn't bet)
Seat 4: gokudousan folded before Flop (didn't bet)
Seat 5: Laker_Style folded before Flop (didn't bet)
Seat 6: 12311985 (button) folded before Flop (didn't bet)



PokerStars Hand #222947608521:  Hold'em No Limit ($0.05/$0.10 USD) - 2021/01/23 3:20:06 ET
Table 'Linzia' 6-max Seat #1 is the button
Seat 1: lucima10 ($15.80 in chips) 
Seat 2: MendramoSone ($6.23 in chips) 
Seat 3: Rainlol ($11.06 in chips) 
Seat 4: gokudousan ($10.15 in chips) 
Seat 5: Laker_Style ($11.74 in chips) 
Seat 6: 12311985 ($12.12 in chips) 
MendramoSone: posts small blind $0.05
Rainlol: posts big blind $0.10
*** HOLE CARDS ***
gokudousan: folds 
Laker_Style: folds 
12311985: folds 
lucima10: folds 
MendramoSone: folds 
Uncalled bet ($0.05) returned to Rainlol
Rainlol collected $0.10 from pot
Rainlol: doesn't show hand 
*** SUMMARY ***
Total pot $0.10 | Rake $0 
Seat 1: lucima10 (button) folded before Flop (didn't bet)
Seat 2: MendramoSone (small blind) folded before Flop
Seat 3: Rainlol (big blind) collected ($0.10)
Seat 4: gokudousan folded before Flop (didn't bet)
Seat 5: Laker_Style folded before Flop (didn't bet)
Seat 6: 12311985 folded before Flop (didn't bet)



PokerStars Hand #222947611174:  Hold'em No Limit ($0.05/$0.10 USD) - 2021/01/23 3:20:17 ET
Table 'Linzia' 6-max Seat #2 is the button
Seat 1: lucima10 ($15.80 in chips) 
Seat 2: MendramoSone ($6.18 in chips) 
Seat 3: Rainlol ($11.11 in chips) 
Seat 4: gokudousan ($10.15 in chips) 
Seat 5: Laker_Style ($11.74 in chips) 
Seat 6: 12311985 ($12.12 in chips) 
Rainlol: posts small blind $0.05
gokudousan: posts big blind $0.10
*** HOLE CARDS ***
Laker_Style: folds 
12311985: folds 
lucima10: folds 
MendramoSone: folds 
Rainlol: folds 
Uncalled bet ($0.05) returned to gokudousan
gokudousan collected $0.10 from pot
gokudousan: doesn't show hand 
*** SUMMARY ***
Total pot $0.10 | Rake $0 
Seat 1: lucima10 folded before Flop (didn't bet)
Seat 2: MendramoSone (button) folded before Flop (didn't bet)
Seat 3: Rainlol (small blind) folded before Flop
Seat 4: gokudousan (big blind) collected ($0.10)
Seat 5: Laker_Style folded before Flop (didn't bet)
Seat 6: 12311985 folded before Flop (didn't bet)



PokerStars Hand #222947614026:  Hold'em No Limit ($0.05/$0.10 USD) - 2021/01/23 3:20:29 ET
Table 'Linzia' 6-max Seat #3 is the button
Seat 1: lucima10 ($15.80 in chips) 
Seat 2: MendramoSone ($6.18 in chips) 
Seat 3: Rainlol ($11.06 in chips) 
Seat 4: gokudousan ($10.20 in chips) 
Seat 5: Laker_Style ($11.74 in chips) 
Seat 6: 12311985 ($12.12 in chips) 
gokudousan: posts small blind $0.05
Laker_Style: posts big blind $0.10
*** HOLE CARDS ***
12311985: raises $0.15 to $0.25
lucima10: folds 
MendramoSone: calls $0.25
Rainlol: folds 
gokudousan: folds 
Laker_Style: calls $0.15
*** FLOP *** [Kh Ad 8h]
Laker_Style: checks 
12311985: checks 
MendramoSone: checks 
*** TURN *** [Kh Ad 8h] [Jd]
Laker_Style: checks 
12311985: checks 
MendramoSone: bets $0.40
Laker_Style: calls $0.40
12311985: calls $0.40
*** RIVER *** [Kh Ad 8h Jd] [7s]
Laker_Style: checks 
12311985: checks 
MendramoSone: bets $1
Laker_Style: calls $1
12311985: folds 
*** SHOW DOWN ***
MendramoSone: shows [Kc Td] (a pair of Kings)
Laker_Style: shows [Ah Qc] (a pair of Aces)
Laker_Style collected $3.82 from pot
*** SUMMARY ***
Total pot $4 | Rake $0.18 
Board [Kh Ad 8h Jd 7s]
Seat 1: lucima10 folded before Flop (didn't bet)
Seat 2: MendramoSone showed [Kc Td] and lost with a pair of Kings
Seat 3: Rainlol (button) folded before Flop (didn't bet)
Seat 4: gokudousan (small blind) folded before Flop
Seat 5: Laker_Style (big blind) showed [Ah Qc] and won ($3.82) with a pair of Aces
Seat 6: 12311985 folded on the River



PokerStars Hand #222947641056:  Hold'em No Limit ($0.05/$0.10 USD) - 2021/01/23 3:22:22 ET
Table 'Linzia' 6-max Seat #4 is the button
Seat 1: lucima10 ($15.80 in chips) 
Seat 2: MendramoSone ($8.60 in chips) 
Seat 3: Rainlol ($11.06 in chips) 
Seat 4: gokudousan ($10.15 in chips) 
Seat 5: Laker_Style ($13.91 in chips) 
Seat 6: 12311985 ($11.47 in chips) 
Laker_Style: posts small blind $0.05
12311985: posts big blind $0.10
*** HOLE CARDS ***
lucima10: folds 
MendramoSone: folds 
Rainlol: folds 
gokudousan: folds 
Laker_Style: raises $0.20 to $0.30
12311985: folds 
Uncalled bet ($0.20) returned to Laker_Style
Laker_Style collected $0.20 from pot
Laker_Style: doesn't show hand 
*** SUMMARY ***
Total pot $0.20 | Rake $0 
Seat 1: lucima10 folded before Flop (didn't bet)
Seat 2: MendramoSone folded before Flop (didn't bet)
Seat 3: Rainlol folded before Flop (didn't bet)
Seat 4: gokudousan (button) folded before Flop (didn't bet)
Seat 5: Laker_Style (small blind) collected ($0.20)
Seat 6: 12311985 (big blind) folded before Flop



PokerStars Hand #222947644719:  Hold'em No Limit ($0.05/$0.10 USD) - 2021/01/23 3:22:37 ET
Table 'Linzia' 6-max Seat #5 is the button
Seat 2: MendramoSone ($8.60 in chips) 
Seat 3: Rainlol ($11.06 in chips) 
Seat 4: gokudousan ($10.15 in chips) 
Seat 5: Laker_Style ($14.01 in chips) 
Seat 6: 12311985 ($11.37 in chips) 
12311985: posts small blind $0.05
lucima10: is sitting out 
lucima10 leaves the table
MendramoSone: posts big blind $0.10
*** HOLE CARDS ***
Rainlol: folds 
gokudousan: folds 
Laker_Style: folds 
12311985: folds 
Uncalled bet ($0.05) returned to MendramoSone
MendramoSone collected $0.10 from pot
MendramoSone: doesn't show hand 
*** SUMMARY ***
Total pot $0.10 | Rake $0 
Seat 2: MendramoSone (big blind) collected ($0.10)
Seat 3: Rainlol folded before Flop (didn't bet)
Seat 4: gokudousan folded before Flop (didn't bet)
Seat 5: Laker_Style (button) folded before Flop (didn't bet)
Seat 6: 12311985 (small blind) folded before Flop



PokerStars Hand #222947646844:  Hold'em No Limit ($0.05/$0.10 USD) - 2021/01/23 3:22:46 ET
Table 'Linzia' 6-max Seat #6 is the button
Seat 2: MendramoSone ($8.65 in chips) 
Seat 4: gokudousan ($10.15 in chips) 
Seat 5: Laker_Style ($14.01 in chips) 
Seat 6: 12311985 ($11.32 in chips) 
MendramoSone: posts small blind $0.05
Rainlol: is sitting out 
gokudousan: posts big blind $0.10
*** HOLE CARDS ***
Laker_Style: folds 
12311985: raises $0.20 to $0.30
Rainlol leaves the table
Coldmath joins the table at seat #1 
MendramoSone: folds 
gokudousan: calls $0.20
*** FLOP *** [Td Kd 6c]
gokudousan: checks 
12311985: bets $0.31
gokudousan: calls $0.31
*** TURN *** [Td Kd 6c] [Kc]
gokudousan: checks 
12311985: bets $0.85
gokudousan: raises $1.55 to $2.40
12311985: folds 
Uncalled bet ($1.55) returned to gokudousan
gokudousan collected $2.84 from pot
gokudousan: doesn't show hand 
*** SUMMARY ***
Total pot $2.97 | Rake $0.13 
Board [Td Kd 6c Kc]
Seat 2: MendramoSone (small blind) folded before Flop
Seat 4: gokudousan (big blind) collected ($2.84)
Seat 5: Laker_Style folded before Flop (didn't bet)
Seat 6: 12311985 (button) folded on the Turn



PokerStars Hand #222947659670:  Hold'em No Limit ($0.05/$0.10 USD) - 2021/01/23 3:23:40 ET
Table 'Linzia' 6-max Seat #2 is the button
Seat 2: MendramoSone ($8.60 in chips) 
Seat 4: gokudousan ($11.53 in chips) 
Seat 5: Laker_Style ($14.01 in chips) 
Seat 6: 12311985 ($10 in chips) 
gokudousan: posts small blind $0.05
Laker_Style: posts big blind $0.10
Coldmath: sits out 
*** HOLE CARDS ***
12311985: folds 
MendramoSone: folds 
gokudousan: raises $0.20 to $0.30
Laker_Style: folds 
Uncalled bet ($0.20) returned to gokudousan
gokudousan collected $0.20 from pot
gokudousan: doesn't show hand 
*** SUMMARY ***
Total pot $0.20 | Rake $0 
Seat 2: MendramoSone (button) folded before Flop (didn't bet)
Seat 4: gokudousan (small blind) collected ($0.20)
Seat 5: Laker_Style (big blind) folded before Flop
Seat 6: 12311985 folded before Flop (didn't bet)



PokerStars Hand #222947662536:  Hold'em No Limit ($0.05/$0.10 USD) - 2021/01/23 3:23:52 ET
Table 'Linzia' 6-max Seat #4 is the button
Seat 2: MendramoSone ($8.60 in chips) 
Seat 4: gokudousan ($11.63 in chips) 
Seat 5: Laker_Style ($13.91 in chips) 
Seat 6: 12311985 ($10 in chips) 
Laker_Style: posts small blind $0.05
12311985: posts big blind $0.10
Coldmath: sits out 
*** HOLE CARDS ***
Lord_Antoan joins the table at seat #3 
MendramoSone: raises $0.20 to $0.30
gokudousan: folds 
Laker_Style: folds 
12311985: folds 
Uncalled bet ($0.20) returned to MendramoSone
MendramoSone collected $0.25 from pot
MendramoSone: doesn't show hand 
*** SUMMARY ***
Total pot $0.25 | Rake $0 
Seat 2: MendramoSone collected ($0.25)
Seat 4: gokudousan (button) folded before Flop (didn't bet)
Seat 5: Laker_Style (small blind) folded before Flop
Seat 6: 12311985 (big blind) folded before Flop



PokerStars Hand #222947665315:  Hold'em No Limit ($0.05/$0.10 USD) - 2021/01/23 3:24:04 ET
Table 'Linzia' 6-max Seat #5 is the button
Seat 1: Coldmath ($5 in chips) 
Seat 2: MendramoSone ($8.75 in chips) 
Seat 4: gokudousan ($11.63 in chips) 
Seat 5: Laker_Style ($13.86 in chips) 
Seat 6: 12311985 ($10 in chips) 
12311985: posts small blind $0.05
Coldmath: posts big blind $0.10
Lord_Antoan: sits out 
*** HOLE CARDS ***
MendramoSone: folds 
gokudousan: folds 
Laker_Style: raises $0.15 to $0.25
12311985: folds 
Coldmath: folds 
Uncalled bet ($0.15) returned to Laker_Style
Laker_Style collected $0.25 from pot
Laker_Style: doesn't show hand 
*** SUMMARY ***
Total pot $0.25 | Rake $0 
Seat 1: Coldmath (big blind) folded before Flop
Seat 2: MendramoSone folded before Flop (didn't bet)
Seat 4: gokudousan folded before Flop (didn't bet)
Seat 5: Laker_Style (button) collected ($0.25)
Seat 6: 12311985 (small blind) folded before Flop



PokerStars Hand #222947669088:  Hold'em No Limit ($0.05/$0.10 USD) - 2021/01/23 3:24:19 ET
Table 'Linzia' 6-max Seat #6 is the button
Seat 1: Coldmath ($4.90 in chips) 
Seat 2: MendramoSone ($8.75 in chips) 
Seat 4: gokudousan ($11.63 in chips) 
Seat 5: Laker_Style ($14.01 in chips) 
Seat 6: 12311985 ($10 in chips) 
Coldmath: posts small blind $0.05
MendramoSone: posts big blind $0.10
Lord_Antoan: sits out 
*** HOLE CARDS ***
gokudousan: folds 
Laker_Style: folds 
12311985: folds 
Coldmath: raises $0.20 to $0.30
MendramoSone: folds 
Uncalled bet ($0.20) returned to Coldmath
Coldmath collected $0.20 from pot
Coldmath: doesn't show hand 
*** SUMMARY ***
Total pot $0.20 | Rake $0 
Seat 1: Coldmath (small blind) collected ($0.20)
Seat 2: MendramoSone (big blind) folded before Flop
Seat 4: gokudousan folded before Flop (didn't bet)
Seat 5: Laker_Style folded before Flop (didn't bet)
Seat 6: 12311985 (button) folded before Flop (didn't bet)



PokerStars Hand #222947671993:  Hold'em No Limit ($0.05/$0.10 USD) - 2021/01/23 3:24:31 ET
Table 'Linzia' 6-max Seat #1 is the button
Seat 1: Coldmath ($5 in chips) 
Seat 2: MendramoSone ($8.65 in chips) 
Seat 3: Lord_Antoan ($10 in chips) 
Seat 4: gokudousan ($11.63 in chips) 
Seat 5: Laker_Style ($14.01 in chips) 
Seat 6: 12311985 ($10 in chips) 
MendramoSone: posts small blind $0.05
Lord_Antoan: posts big blind $0.10
*** HOLE CARDS ***
gokudousan: folds 
Laker_Style: folds 
12311985: folds 
Coldmath: folds 
MendramoSone: folds 
Uncalled bet ($0.05) returned to Lord_Antoan
Lord_Antoan collected $0.10 from pot
Lord_Antoan: doesn't show hand 
*** SUMMARY ***
Total pot $0.10 | Rake $0 
Seat 1: Coldmath (button) folded before Flop (didn't bet)
Seat 2: MendramoSone (small blind) folded before Flop
Seat 3: Lord_Antoan (big blind) collected ($0.10)
Seat 4: gokudousan folded before Flop (didn't bet)
Seat 5: Laker_Style folded before Flop (didn't bet)
Seat 6: 12311985 folded before Flop (didn't bet)



PokerStars Hand #222947674232:  Hold'em No Limit ($0.05/$0.10 USD) - 2021/01/23 3:24:40 ET
Table 'Linzia' 6-max Seat #2 is the button
Seat 1: Coldmath ($5 in chips) 
Seat 2: MendramoSone ($8.60 in chips) 
Seat 3: Lord_Antoan ($10.05 in chips) 
Seat 4: gokudousan ($11.63 in chips) 
Seat 5: Laker_Style ($14.01 in chips) 
Seat 6: 12311985 ($10 in chips) 
Lord_Antoan: posts small blind $0.05
gokudousan: posts big blind $0.10
*** HOLE CARDS ***
Laker_Style: folds 
12311985: folds 
Coldmath: folds 
MendramoSone: folds 
Lord_Antoan: raises $0.20 to $0.30
gokudousan: folds 
Uncalled bet ($0.20) returned to Lord_Antoan
Lord_Antoan collected $0.20 from pot
Lord_Antoan: doesn't show hand 
*** SUMMARY ***
Total pot $0.20 | Rake $0 
Seat 1: Coldmath folded before Flop (didn't bet)
Seat 2: MendramoSone (button) folded before Flop (didn't bet)
Seat 3: Lord_Antoan (small blind) collected ($0.20)
Seat 4: gokudousan (big blind) folded before Flop
Seat 5: Laker_Style folded before Flop (didn't bet)
Seat 6: 12311985 folded before Flop (didn't bet)



PokerStars Hand #222947678415:  Hold'em No Limit ($0.05/$0.10 USD) - 2021/01/23 3:24:57 ET
Table 'Linzia' 6-max Seat #3 is the button
Seat 1: Coldmath ($5 in chips) 
Seat 2: MendramoSone ($8.60 in chips) 
Seat 3: Lord_Antoan ($10.15 in chips) 
Seat 4: gokudousan ($11.53 in chips) 
Seat 5: Laker_Style ($14.01 in chips) 
Seat 6: 12311985 ($10 in chips) 
gokudousan: posts small blind $0.05
Laker_Style: posts big blind $0.10
*** HOLE CARDS ***
12311985: raises $0.15 to $0.25
Coldmath: folds 
MendramoSone: folds 
Lord_Antoan: calls $0.25
gokudousan: folds 
Laker_Style: calls $0.15
*** FLOP *** [6s 4h Ks]
Laker_Style: checks 
12311985: bets $0.23
Lord_Antoan: folds 
Laker_Style: raises $0.77 to $1
12311985: folds 
Uncalled bet ($0.77) returned to Laker_Style
Laker_Style collected $1.20 from pot
Laker_Style: doesn't show hand 
*** SUMMARY ***
Total pot $1.26 | Rake $0.06 
Board [6s 4h Ks]
Seat 1: Coldmath folded before Flop (didn't bet)
Seat 2: MendramoSone folded before Flop (didn't bet)
Seat 3: Lord_Antoan (button) folded on the Flop
Seat 4: gokudousan (small blind) folded before Flop
Seat 5: Laker_Style (big blind) collected ($1.20)
Seat 6: 12311985 folded on the Flop



PokerStars Hand #222947693342:  Hold'em No Limit ($0.05/$0.10 USD) - 2021/01/23 3:26:00 ET
Table 'Linzia' 6-max Seat #4 is the button
Seat 1: Coldmath ($5 in chips) 
Seat 2: MendramoSone ($8.60 in chips) 
Seat 3: Lord_Antoan ($10 in chips) 
Seat 4: gokudousan ($11.48 in chips) 
Seat 5: Laker_Style ($14.73 in chips) 
Seat 6: 12311985 ($10 in chips) 
Laker_Style: posts small blind $0.05
12311985: posts big blind $0.10
*** HOLE CARDS ***
Coldmath: folds 
MendramoSone: folds 
Lord_Antoan: folds 
gokudousan: raises $0.20 to $0.30
Laker_Style: folds 
12311985: folds 
Uncalled bet ($0.20) returned to gokudousan
gokudousan collected $0.25 from pot
gokudousan: doesn't show hand 
*** SUMMARY ***
Total pot $0.25 | Rake $0 
Seat 1: Coldmath folded before Flop (didn't bet)
Seat 2: MendramoSone folded before Flop (didn't bet)
Seat 3: Lord_Antoan folded before Flop (didn't bet)
Seat 4: gokudousan (button) collected ($0.25)
Seat 5: Laker_Style (small blind) folded before Flop
Seat 6: 12311985 (big blind) folded before Flop



PokerStars Hand #222947697038:  Hold'em No Limit ($0.05/$0.10 USD) - 2021/01/23 3:26:15 ET
Table 'Linzia' 6-max Seat #5 is the button
Seat 1: Coldmath ($5 in chips) 
Seat 2: MendramoSone ($8.60 in chips) 
Seat 3: Lord_Antoan ($10 in chips) 
Seat 4: gokudousan ($11.63 in chips) 
Seat 5: Laker_Style ($14.68 in chips) 
Seat 6: 12311985 ($10 in chips) 
12311985: posts small blind $0.05
Coldmath: posts big blind $0.10
*** HOLE CARDS ***
MendramoSone: folds 
Lord_Antoan: folds 
gokudousan: raises $0.20 to $0.30
Laker_Style: folds 
12311985: raises $0.90 to $1.20
Coldmath: folds 
gokudousan: calls $0.90
*** FLOP *** [4h Tc 2d]
12311985: checks 
gokudousan: checks 
*** TURN *** [4h Tc 2d] [9d]
12311985: bets $1.67
gokudousan: calls $1.67
*** RIVER *** [4h Tc 2d 9d] [Kd]
12311985: bets $3.91
gokudousan: raises $4.85 to $8.76 and is all-in
12311985: folds 
Uncalled bet ($4.85) returned to gokudousan
gokudousan collected $13.05 from pot
gokudousan: doesn't show hand 
*** SUMMARY ***
Total pot $13.66 | Rake $0.61 
Board [4h Tc 2d 9d Kd]
Seat 1: Coldmath (big blind) folded before Flop
Seat 2: MendramoSone folded before Flop (didn't bet)
Seat 3: Lord_Antoan folded before Flop (didn't bet)
Seat 4: gokudousan collected ($13.05)
Seat 5: Laker_Style (button) folded before Flop (didn't bet)
Seat 6: 12311985 (small blind) folded on the River



PokerStars Hand #222947713093:  Hold'em No Limit ($0.05/$0.10 USD) - 2021/01/23 3:27:21 ET
Table 'Linzia' 6-max Seat #6 is the button
Seat 1: Coldmath ($4.90 in chips) 
Seat 2: MendramoSone ($8.60 in chips) 
Seat 3: Lord_Antoan ($10 in chips) 
Seat 4: gokudousan ($17.90 in chips) 
Seat 5: Laker_Style ($14.68 in chips) 
Seat 6: 12311985 ($10 in chips) 
Coldmath: posts small blind $0.05
MendramoSone: posts big blind $0.10
*** HOLE CARDS ***
Lord_Antoan: folds 
gokudousan: folds 
Laker_Style: folds 
12311985: folds 
Coldmath: folds 
Uncalled bet ($0.05) returned to MendramoSone
MendramoSone collected $0.10 from pot
MendramoSone: doesn't show hand 
*** SUMMARY ***
Total pot $0.10 | Rake $0 
Seat 1: Coldmath (small blind) folded before Flop
Seat 2: MendramoSone (big blind) collected ($0.10)
Seat 3: Lord_Antoan folded before Flop (didn't bet)
Seat 4: gokudousan folded before Flop (didn't bet)
Seat 5: Laker_Style folded before Flop (didn't bet)
Seat 6: 12311985 (button) folded before Flop (didn't bet)



PokerStars Hand #222947716783:  Hold'em No Limit ($0.05/$0.10 USD) - 2021/01/23 3:27:36 ET
Table 'Linzia' 6-max Seat #1 is the button
Seat 1: Coldmath ($4.85 in chips) 
Seat 2: MendramoSone ($8.65 in chips) 
Seat 3: Lord_Antoan ($10 in chips) 
Seat 4: gokudousan ($17.90 in chips) 
Seat 5: Laker_Style ($14.68 in chips) 
Seat 6: 12311985 ($10 in chips) 
MendramoSone: posts small blind $0.05
Lord_Antoan: posts big blind $0.10
*** HOLE CARDS ***
gokudousan: raises $0.20 to $0.30
Laker_Style: folds 
12311985: folds 
Coldmath: folds 
MendramoSone: folds 
Lord_Antoan: folds 
Uncalled bet ($0.20) returned to gokudousan
gokudousan collected $0.25 from pot
gokudousan: doesn't show hand 
*** SUMMARY ***
Total pot $0.25 | Rake $0 
Seat 1: Coldmath (button) folded before Flop (didn't bet)
Seat 2: MendramoSone (small blind) folded before Flop
Seat 3: Lord_Antoan (big blind) folded before Flop
Seat 4: gokudousan collected ($0.25)
Seat 5: Laker_Style folded before Flop (didn't bet)
Seat 6: 12311985 folded before Flop (didn't bet)



PokerStars Hand #222947720880:  Hold'em No Limit ($0.05/$0.10 USD) - 2021/01/23 3:27:54 ET
Table 'Linzia' 6-max Seat #2 is the button
Seat 1: Coldmath ($4.85 in chips) 
Seat 2: MendramoSone ($8.60 in chips) 
Seat 3: Lord_Antoan ($10 in chips) 
Seat 4: gokudousan ($18.05 in chips) 
Seat 5: Laker_Style ($14.68 in chips) 
Seat 6: 12311985 ($10 in chips) 
Lord_Antoan: posts small blind $0.05
gokudousan: posts big blind $0.10
*** HOLE CARDS ***
Laker_Style: folds 
12311985: folds 
Coldmath: folds 
MendramoSone: folds 
Lord_Antoan: raises $0.20 to $0.30
gokudousan: folds 
Uncalled bet ($0.20) returned to Lord_Antoan
Lord_Antoan collected $0.20 from pot
Lord_Antoan: doesn't show hand 
*** SUMMARY ***
Total pot $0.20 | Rake $0 
Seat 1: Coldmath folded before Flop (didn't bet)
Seat 2: MendramoSone (button) folded before Flop (didn't bet)
Seat 3: Lord_Antoan (small blind) collected ($0.20)
Seat 4: gokudousan (big blind) folded before Flop
Seat 5: Laker_Style folded before Flop (didn't bet)
Seat 6: 12311985 folded before Flop (didn't bet)



PokerStars Hand #222947724438:  Hold'em No Limit ($0.05/$0.10 USD) - 2021/01/23 3:28:09 ET
Table 'Linzia' 6-max Seat #3 is the button
Seat 1: Coldmath ($4.85 in chips) 
Seat 2: MendramoSone ($8.60 in chips) 
Seat 3: Lord_Antoan ($10.10 in chips) 
Seat 4: gokudousan ($17.95 in chips) 
Seat 5: Laker_Style ($14.68 in chips) 
Seat 6: 12311985 ($10 in chips) 
gokudousan: posts small blind $0.05
Laker_Style: posts big blind $0.10
*** HOLE CARDS ***
12311985: raises $0.15 to $0.25
Coldmath: folds 
MendramoSone: folds 
Lord_Antoan: folds 
gokudousan: folds 
Laker_Style: calls $0.15
*** FLOP *** [Td 2c 4c]
Laker_Style: checks 
12311985: checks 
*** TURN *** [Td 2c 4c] [2s]
Laker_Style: checks 
12311985: checks 
*** RIVER *** [Td 2c 4c 2s] [9c]
Laker_Style: checks 
12311985: checks 
*** SHOW DOWN ***
Laker_Style: shows [Ah Qd] (a pair of Deuces)
12311985: shows [3s 3d] (two pair, Threes and Deuces)
12311985 collected $0.53 from pot
*** SUMMARY ***
Total pot $0.55 | Rake $0.02 
Board [Td 2c 4c 2s 9c]
Seat 1: Coldmath folded before Flop (didn't bet)
Seat 2: MendramoSone folded before Flop (didn't bet)
Seat 3: Lord_Antoan (button) folded before Flop (didn't bet)
Seat 4: gokudousan (small blind) folded before Flop
Seat 5: Laker_Style (big blind) showed [Ah Qd] and lost with a pair of Deuces
Seat 6: 12311985 showed [3s 3d] and won ($0.53) with two pair, Threes and Deuces



PokerStars Hand #222947734466:  Hold'em No Limit ($0.05/$0.10 USD) - 2021/01/23 3:28:50 ET
Table 'Linzia' 6-max Seat #4 is the button
Seat 1: Coldmath ($4.85 in chips) 
Seat 2: MendramoSone ($8.60 in chips) 
Seat 3: Lord_Antoan ($10.10 in chips) 
Seat 4: gokudousan ($17.90 in chips) 
Seat 5: Laker_Style ($14.43 in chips) 
Laker_Style: posts small blind $0.05
12311985: is sitting out 
Coldmath: posts big blind $0.10
*** HOLE CARDS ***
MendramoSone: folds 
Lord_Antoan: folds 
gokudousan: raises $0.20 to $0.30
Laker_Style: folds 
Coldmath: folds 
Uncalled bet ($0.20) returned to gokudousan
gokudousan collected $0.25 from pot
gokudousan: doesn't show hand 
*** SUMMARY ***
Total pot $0.25 | Rake $0 
Seat 1: Coldmath (big blind) folded before Flop
Seat 2: MendramoSone folded before Flop (didn't bet)
Seat 3: Lord_Antoan folded before Flop (didn't bet)
Seat 4: gokudousan (button) collected ($0.25)
Seat 5: Laker_Style (small blind) folded before Flop



PokerStars Hand #222947737212:  Hold'em No Limit ($0.05/$0.10 USD) - 2021/01/23 3:29:01 ET
Table 'Linzia' 6-max Seat #5 is the button
Seat 1: Coldmath ($4.75 in chips) 
Seat 2: MendramoSone ($8.60 in chips) 
Seat 3: Lord_Antoan ($10.10 in chips) 
Seat 4: gokudousan ($18.05 in chips) 
Seat 5: Laker_Style ($14.38 in chips) 
Coldmath: posts small blind $0.05
MendramoSone: posts big blind $0.10
*** HOLE CARDS ***
Lord_Antoan: raises $0.20 to $0.30
12311985 leaves the table
gokudousan: raises $0.60 to $0.90
Laker_Style: folds 
Coldmath: folds 
MendramoSone: folds 
Lord_Antoan: calls $0.60
*** FLOP *** [9s Kd Th]
Lord_Antoan: checks 
Dugipokers joins the table at seat #6 
gokudousan: bets $0.70
Lord_Antoan: folds 
Uncalled bet ($0.70) returned to gokudousan
gokudousan collected $1.86 from pot
gokudousan: doesn't show hand 
*** SUMMARY ***
Total pot $1.95 | Rake $0.09 
Board [9s Kd Th]
Seat 1: Coldmath (small blind) folded before Flop
Seat 2: MendramoSone (big blind) folded before Flop
Seat 3: Lord_Antoan folded on the Flop
Seat 4: gokudousan collected ($1.86)
Seat 5: Laker_Style (button) folded before Flop (didn't bet)



PokerStars Hand #222947755103:  Hold'em No Limit ($0.05/$0.10 USD) - 2021/01/23 3:29:46 ET
Table 'Linzia' 6-max Seat #1 is the button
Seat 1: Coldmath ($4.70 in chips) 
Seat 2: MendramoSone ($8.50 in chips) 
Seat 3: Lord_Antoan ($10 in chips) 
Seat 4: gokudousan ($19.01 in chips) 
Seat 5: Laker_Style ($14.38 in chips) 
MendramoSone: posts small blind $0.05
Lord_Antoan: posts big blind $0.10
Dugipokers: sits out 
*** HOLE CARDS ***
gokudousan: folds 
Laker_Style: folds 
Coldmath: folds 
MendramoSone: folds 
Uncalled bet ($0.05) returned to Lord_Antoan
Lord_Antoan collected $0.10 from pot
Lord_Antoan: doesn't show hand 
*** SUMMARY ***
Total pot $0.10 | Rake $0 
Seat 1: Coldmath (button) folded before Flop (didn't bet)
Seat 2: MendramoSone (small blind) folded before Flop
Seat 3: Lord_Antoan (big blind) collected ($0.10)
Seat 4: gokudousan folded before Flop (didn't bet)
Seat 5: Laker_Style folded before Flop (didn't bet)



PokerStars Hand #222947759239:  Hold'em No Limit ($0.05/$0.10 USD) - 2021/01/23 3:30:03 ET
Table 'Linzia' 6-max Seat #2 is the button
Seat 1: Coldmath ($4.70 in chips) 
Seat 2: MendramoSone ($8.45 in chips) 
Seat 3: Lord_Antoan ($10.05 in chips) 
Seat 4: gokudousan ($19.01 in chips) 
Seat 5: Laker_Style ($14.38 in chips) 
Lord_Antoan: posts small blind $0.05
gokudousan: posts big blind $0.10
Dugipokers: sits out 
*** HOLE CARDS ***
Laker_Style: folds 
Coldmath: folds 
MendramoSone: folds 
Lord_Antoan: folds 
Uncalled bet ($0.05) returned to gokudousan
gokudousan collected $0.10 from pot
gokudousan: doesn't show hand 
*** SUMMARY ***
Total pot $0.10 | Rake $0 
Seat 1: Coldmath folded before Flop (didn't bet)
Seat 2: MendramoSone (button) folded before Flop (didn't bet)
Seat 3: Lord_Antoan (small blind) folded before Flop
Seat 4: gokudousan (big blind) collected ($0.10)
Seat 5: Laker_Style folded before Flop (didn't bet)



PokerStars Hand #222947761802:  Hold'em No Limit ($0.05/$0.10 USD) - 2021/01/23 3:30:14 ET
Table 'Linzia' 6-max Seat #3 is the button
Seat 1: Coldmath ($4.70 in chips) 
Seat 2: MendramoSone ($8.45 in chips) 
Seat 3: Lord_Antoan ($10 in chips) 
Seat 4: gokudousan ($19.06 in chips) 
Seat 5: Laker_Style ($14.38 in chips) 
gokudousan: posts small blind $0.05
Laker_Style: posts big blind $0.10
Dugipokers: sits out 
*** HOLE CARDS ***
Coldmath: folds 
MendramoSone: folds 
Lord_Antoan: folds 
gokudousan: raises $0.20 to $0.30
Laker_Style: folds 
Uncalled bet ($0.20) returned to gokudousan
gokudousan collected $0.20 from pot
gokudousan: doesn't show hand 
*** SUMMARY ***
Total pot $0.20 | Rake $0 
Seat 1: Coldmath folded before Flop (didn't bet)
Seat 2: MendramoSone folded before Flop (didn't bet)
Seat 3: Lord_Antoan (button) folded before Flop (didn't bet)
Seat 4: gokudousan (small blind) collected ($0.20)
Seat 5: Laker_Style (big blind) folded before Flop



PokerStars Hand #222947767494:  Hold'em No Limit ($0.05/$0.10 USD) - 2021/01/23 3:30:37 ET
Table 'Linzia' 6-max Seat #4 is the button
Seat 1: Coldmath ($4.70 in chips) 
Seat 2: MendramoSone ($8.45 in chips) 
Seat 3: Lord_Antoan ($10 in chips) 
Seat 4: gokudousan ($19.16 in chips) 
Seat 5: Laker_Style ($14.28 in chips) 
Seat 6: Dugipokers ($10 in chips) 
Laker_Style: posts small blind $0.05
Dugipokers: posts big blind $0.10
*** HOLE CARDS ***
Coldmath: folds 
MendramoSone: folds 
Lord_Antoan: raises $0.20 to $0.30
gokudousan: folds 
Laker_Style: folds 
Dugipokers: calls $0.20
*** FLOP *** [Ks 6h Ah]
Dugipokers: checks 
Lord_Antoan: checks 
*** TURN *** [Ks 6h Ah] [4s]
Dugipokers: bets $0.47
Lord_Antoan: folds 
Uncalled bet ($0.47) returned to Dugipokers
Dugipokers collected $0.62 from pot
Dugipokers: doesn't show hand 
*** SUMMARY ***
Total pot $0.65 | Rake $0.03 
Board [Ks 6h Ah 4s]
Seat 1: Coldmath folded before Flop (didn't bet)
Seat 2: MendramoSone folded before Flop (didn't bet)
Seat 3: Lord_Antoan folded on the Turn
Seat 4: gokudousan (button) folded before Flop (didn't bet)
Seat 5: Laker_Style (small blind) folded before Flop
Seat 6: Dugipokers (big blind) collected ($0.62)



PokerStars Hand #222947777545:  Hold'em No Limit ($0.05/$0.10 USD) - 2021/01/23 3:31:18 ET
Table 'Linzia' 6-max Seat #5 is the button
Seat 1: Coldmath ($4.70 in chips) 
Seat 2: MendramoSone ($8.45 in chips) 
Seat 3: Lord_Antoan ($10 in chips) 
Seat 4: gokudousan ($19.16 in chips) 
Seat 5: Laker_Style ($14.23 in chips) 
Seat 6: Dugipokers ($10.32 in chips) 
Dugipokers: posts small blind $0.05
Coldmath: posts big blind $0.10
*** HOLE CARDS ***
MendramoSone: folds 
Lord_Antoan: raises $0.20 to $0.30
gokudousan: calls $0.30
Laker_Style: folds 
Dugipokers: folds 
Coldmath: raises $0.90 to $1.20
Lord_Antoan: folds 
gokudousan: folds 
Uncalled bet ($0.90) returned to Coldmath
Coldmath collected $0.95 from pot
Coldmath: doesn't show hand 
*** SUMMARY ***
Total pot $0.95 | Rake $0 
Seat 1: Coldmath (big blind) collected ($0.95)
Seat 2: MendramoSone folded before Flop (didn't bet)
Seat 3: Lord_Antoan folded before Flop
Seat 4: gokudousan folded before Flop
Seat 5: Laker_Style (button) folded before Flop (didn't bet)
Seat 6: Dugipokers (small blind) folded before Flop



PokerStars Hand #222947792850:  Hold'em No Limit ($0.05/$0.10 USD) - 2021/01/23 3:31:56 ET
Table 'Linzia' 6-max Seat #6 is the button
Seat 1: Coldmath ($5.35 in chips) 
Seat 2: MendramoSone ($8.45 in chips) 
Seat 3: Lord_Antoan ($10 in chips) 
Seat 4: gokudousan ($18.86 in chips) 
Seat 5: Laker_Style ($14.23 in chips) 
Seat 6: Dugipokers ($10.27 in chips) 
Coldmath: posts small blind $0.05
MendramoSone: posts big blind $0.10
*** HOLE CARDS ***
Lord_Antoan: folds 
gokudousan: folds 
Laker_Style: folds 
Dugipokers: raises $0.15 to $0.25
Coldmath: folds 
MendramoSone: calls $0.15
*** FLOP *** [Ah Td Qh]
MendramoSone: checks 
Dugipokers: bets $0.40
MendramoSone: folds 
Uncalled bet ($0.40) returned to Dugipokers
Dugipokers collected $0.53 from pot
Dugipokers: doesn't show hand 
*** SUMMARY ***
Total pot $0.55 | Rake $0.02 
Board [Ah Td Qh]
Seat 1: Coldmath (small blind) folded before Flop
Seat 2: MendramoSone (big blind) folded on the Flop
Seat 3: Lord_Antoan folded before Flop (didn't bet)
Seat 4: gokudousan folded before Flop (didn't bet)
Seat 5: Laker_Style folded before Flop (didn't bet)
Seat 6: Dugipokers (button) collected ($0.53)



PokerStars Hand #222947800160:  Hold'em No Limit ($0.05/$0.10 USD) - 2021/01/23 3:32:26 ET
Table 'Linzia' 6-max Seat #1 is the button
Seat 1: Coldmath ($5.30 in chips) 
Seat 2: MendramoSone ($8.20 in chips) 
Seat 3: Lord_Antoan ($10 in chips) 
Seat 4: gokudousan ($18.86 in chips) 
Seat 5: Laker_Style ($14.23 in chips) 
Seat 6: Dugipokers ($10.55 in chips) 
MendramoSone: posts small blind $0.05
Lord_Antoan: posts big blind $0.10
*** HOLE CARDS ***
gokudousan: folds 
Laker_Style: folds 
Dugipokers: folds 
Coldmath: folds 
MendramoSone: raises $0.20 to $0.30
Lord_Antoan: raises $0.60 to $0.90
MendramoSone: folds 
Uncalled bet ($0.60) returned to Lord_Antoan
Lord_Antoan collected $0.60 from pot
Lord_Antoan: doesn't show hand 
*** SUMMARY ***
Total pot $0.60 | Rake $0 
Seat 1: Coldmath (button) folded before Flop (didn't bet)
Seat 2: MendramoSone (small blind) folded before Flop
Seat 3: Lord_Antoan (big blind) collected ($0.60)
Seat 4: gokudousan folded before Flop (didn't bet)
Seat 5: Laker_Style folded before Flop (didn't bet)
Seat 6: Dugipokers folded before Flop (didn't bet)



PokerStars Hand #222947807528:  Hold'em No Limit ($0.05/$0.10 USD) - 2021/01/23 3:32:55 ET
Table 'Linzia' 6-max Seat #2 is the button
Seat 1: Coldmath ($5.30 in chips) 
Seat 2: MendramoSone ($7.90 in chips) 
Seat 3: Lord_Antoan ($10.30 in chips) 
Seat 4: gokudousan ($18.86 in chips) 
Seat 5: Laker_Style ($14.23 in chips) 
Seat 6: Dugipokers ($10.55 in chips) 
Lord_Antoan: posts small blind $0.05
gokudousan: posts big blind $0.10
*** HOLE CARDS ***
Laker_Style: folds 
Dugipokers: folds 
Coldmath: folds 
MendramoSone: folds 
Lord_Antoan: folds 
Uncalled bet ($0.05) returned to gokudousan
gokudousan collected $0.10 from pot
gokudousan: doesn't show hand 
*** SUMMARY ***
Total pot $0.10 | Rake $0 
Seat 1: Coldmath folded before Flop (didn't bet)
Seat 2: MendramoSone (button) folded before Flop (didn't bet)
Seat 3: Lord_Antoan (small blind) folded before Flop
Seat 4: gokudousan (big blind) collected ($0.10)
Seat 5: Laker_Style folded before Flop (didn't bet)
Seat 6: Dugipokers folded before Flop (didn't bet)



PokerStars Hand #222947810303:  Hold'em No Limit ($0.05/$0.10 USD) - 2021/01/23 3:33:07 ET
Table 'Linzia' 6-max Seat #3 is the button
Seat 1: Coldmath ($5.30 in chips) 
Seat 2: MendramoSone ($7.90 in chips) 
Seat 3: Lord_Antoan ($10.25 in chips) 
Seat 4: gokudousan ($18.91 in chips) 
Seat 5: Laker_Style ($14.23 in chips) 
Seat 6: Dugipokers ($10.55 in chips) 
gokudousan: posts small blind $0.05
Laker_Style: posts big blind $0.10
*** HOLE CARDS ***
Dugipokers: folds 
Coldmath: raises $0.20 to $0.30
MendramoSone: calls $0.30
Lord_Antoan: folds 
gokudousan: folds 
Laker_Style: folds 
*** FLOP *** [Jd 6s 5h]
Coldmath: bets $0.36
MendramoSone: folds 
Uncalled bet ($0.36) returned to Coldmath
Coldmath collected $0.72 from pot
Coldmath: doesn't show hand 
*** SUMMARY ***
Total pot $0.75 | Rake $0.03 
Board [Jd 6s 5h]
Seat 1: Coldmath collected ($0.72)
Seat 2: MendramoSone folded on the Flop
Seat 3: Lord_Antoan (button) folded before Flop (didn't bet)
Seat 4: gokudousan (small blind) folded before Flop
Seat 5: Laker_Style (big blind) folded before Flop
Seat 6: Dugipokers folded before Flop (didn't bet)



PokerStars Hand #222947817128:  Hold'em No Limit ($0.05/$0.10 USD) - 2021/01/23 3:33:35 ET
Table 'Linzia' 6-max Seat #4 is the button
Seat 1: Coldmath ($5.72 in chips) 
Seat 2: MendramoSone ($7.60 in chips) 
Seat 3: Lord_Antoan ($10.25 in chips) 
Seat 4: gokudousan ($18.86 in chips) 
Seat 5: Laker_Style ($14.13 in chips) 
Seat 6: Dugipokers ($10.55 in chips) 
Laker_Style: posts small blind $0.05
Dugipokers: posts big blind $0.10
*** HOLE CARDS ***
Coldmath: folds 
MendramoSone: folds 
Lord_Antoan: folds 
gokudousan: folds 
Laker_Style: raises $0.20 to $0.30
Dugipokers: folds 
Uncalled bet ($0.20) returned to Laker_Style
Laker_Style collected $0.20 from pot
Laker_Style: doesn't show hand 
*** SUMMARY ***
Total pot $0.20 | Rake $0 
Seat 1: Coldmath folded before Flop (didn't bet)
Seat 2: MendramoSone folded before Flop (didn't bet)
Seat 3: Lord_Antoan folded before Flop (didn't bet)
Seat 4: gokudousan (button) folded before Flop (didn't bet)
Seat 5: Laker_Style (small blind) collected ($0.20)
Seat 6: Dugipokers (big blind) folded before Flop



PokerStars Hand #222947820980:  Hold'em No Limit ($0.05/$0.10 USD) - 2021/01/23 3:33:51 ET
Table 'Linzia' 6-max Seat #5 is the button
Seat 1: Coldmath ($5.72 in chips) 
Seat 2: MendramoSone ($7.60 in chips) 
Seat 3: Lord_Antoan ($10.25 in chips) 
Seat 4: gokudousan ($18.86 in chips) 
Seat 5: Laker_Style ($14.23 in chips) 
Seat 6: Dugipokers ($10.45 in chips) 
Dugipokers: posts small blind $0.05
Coldmath: posts big blind $0.10
*** HOLE CARDS ***
MendramoSone: raises $0.10 to $0.20
Lord_Antoan: folds 
gokudousan: folds 
Laker_Style: folds 
Dugipokers: calls $0.15
Coldmath: calls $0.10
*** FLOP *** [8s 5s 4s]
Dugipokers: checks 
Coldmath: checks 
MendramoSone: checks 
*** TURN *** [8s 5s 4s] [9d]
Dugipokers: bets $0.43
Coldmath: folds 
MendramoSone: calls $0.43
*** RIVER *** [8s 5s 4s 9d] [4d]
Dugipokers: bets $1.06
MendramoSone: folds 
Uncalled bet ($1.06) returned to Dugipokers
Dugipokers collected $1.39 from pot
Dugipokers: doesn't show hand 
*** SUMMARY ***
Total pot $1.46 | Rake $0.07 
Board [8s 5s 4s 9d 4d]
Seat 1: Coldmath (big blind) folded on the Turn
Seat 2: MendramoSone folded on the River
Seat 3: Lord_Antoan folded before Flop (didn't bet)
Seat 4: gokudousan folded before Flop (didn't bet)
Seat 5: Laker_Style (button) folded before Flop (didn't bet)
Seat 6: Dugipokers (small blind) collected ($1.39)



PokerStars Hand #222947835307:  Hold'em No Limit ($0.05/$0.10 USD) - 2021/01/23 3:34:49 ET
Table 'Linzia' 6-max Seat #6 is the button
Seat 1: Coldmath ($5.52 in chips) 
Seat 2: MendramoSone ($6.97 in chips) 
Seat 3: Lord_Antoan ($10.25 in chips) 
Seat 4: gokudousan ($18.86 in chips) 
Seat 5: Laker_Style ($14.23 in chips) 
Seat 6: Dugipokers ($11.21 in chips) 
Coldmath: posts small blind $0.05
MendramoSone: posts big blind $0.10
*** HOLE CARDS ***
Lord_Antoan: folds 
gokudousan: raises $0.20 to $0.30
Laker_Style: folds 
Dugipokers: folds 
Coldmath: folds 
MendramoSone: folds 
Uncalled bet ($0.20) returned to gokudousan
gokudousan collected $0.25 from pot
gokudousan: doesn't show hand 
*** SUMMARY ***
Total pot $0.25 | Rake $0 
Seat 1: Coldmath (small blind) folded before Flop
Seat 2: MendramoSone (big blind) folded before Flop
Seat 3: Lord_Antoan folded before Flop (didn't bet)
Seat 4: gokudousan collected ($0.25)
Seat 5: Laker_Style folded before Flop (didn't bet)
Seat 6: Dugipokers (button) folded before Flop (didn't bet)



PokerStars Hand #222947838710:  Hold'em No Limit ($0.05/$0.10 USD) - 2021/01/23 3:35:03 ET
Table 'Linzia' 6-max Seat #1 is the button
Seat 1: Coldmath ($5.47 in chips) 
Seat 2: MendramoSone ($6.87 in chips) 
Seat 3: Lord_Antoan ($10.25 in chips) 
Seat 4: gokudousan ($19.01 in chips) 
Seat 5: Laker_Style ($14.23 in chips) 
Seat 6: Dugipokers ($11.21 in chips) 
MendramoSone: posts small blind $0.05
Lord_Antoan: posts big blind $0.10
*** HOLE CARDS ***
gokudousan: raises $0.20 to $0.30
Laker_Style: folds 
Dugipokers: raises $0.60 to $0.90
Coldmath: raises $1.20 to $2.10
MendramoSone: folds 
Lord_Antoan: folds 
gokudousan: folds 
Dugipokers: raises $6.05 to $8.15
Coldmath: calls $3.37 and is all-in
Uncalled bet ($2.68) returned to Dugipokers
*** FLOP *** [Th 6s 5c]
*** TURN *** [Th 6s 5c] [5s]
*** RIVER *** [Th 6s 5c 5s] [7s]
*** SHOW DOWN ***
Dugipokers: shows [Ac Kd] (a pair of Fives)
Coldmath: shows [As Ah] (two pair, Aces and Fives)
Coldmath cashed out the hand for $9.97 | Cash Out Fee $0.10
*** SUMMARY ***
Total pot $11.39 | Rake $0.51 
Board [Th 6s 5c 5s 7s]
Seat 1: Coldmath (button) showed [As Ah] and won ($10.88) with two pair, Aces and Fives (pot not awarded as player cashed out)
Seat 2: MendramoSone (small blind) folded before Flop
Seat 3: Lord_Antoan (big blind) folded before Flop
Seat 4: gokudousan folded before Flop
Seat 5: Laker_Style folded before Flop (didn't bet)
Seat 6: Dugipokers showed [Ac Kd] and lost with a pair of Fives



PokerStars Hand #222947851635:  Hold'em No Limit ($0.05/$0.10 USD) - 2021/01/23 3:35:56 ET
Table 'Linzia' 6-max Seat #2 is the button
Seat 1: Coldmath ($9.97 in chips) 
Seat 2: MendramoSone ($6.82 in chips) 
Seat 3: Lord_Antoan ($10.15 in chips) 
Seat 4: gokudousan ($18.71 in chips) 
Seat 5: Laker_Style ($14.23 in chips) 
Seat 6: Dugipokers ($10 in chips) 
Lord_Antoan: posts small blind $0.05
gokudousan: posts big blind $0.10
*** HOLE CARDS ***
Laker_Style: folds 
Dugipokers: raises $0.20 to $0.30
Coldmath: folds 
MendramoSone: calls $0.30
Lord_Antoan: folds 
gokudousan: calls $0.20
*** FLOP *** [3c 2d 6s]
gokudousan: checks 
Dugipokers: bets $0.55
MendramoSone: folds 
gokudousan: folds 
Uncalled bet ($0.55) returned to Dugipokers
Dugipokers collected $0.91 from pot
Dugipokers: doesn't show hand 
*** SUMMARY ***
Total pot $0.95 | Rake $0.04 
Board [3c 2d 6s]
Seat 1: Coldmath folded before Flop (didn't bet)
Seat 2: MendramoSone (button) folded on the Flop
Seat 3: Lord_Antoan (small blind) folded before Flop
Seat 4: gokudousan (big blind) folded on the Flop
Seat 5: Laker_Style folded before Flop (didn't bet)
Seat 6: Dugipokers collected ($0.91)



PokerStars Hand #222947861622:  Hold'em No Limit ($0.05/$0.10 USD) - 2021/01/23 3:36:37 ET
Table 'Linzia' 6-max Seat #3 is the button
Seat 1: Coldmath ($9.97 in chips) 
Seat 2: MendramoSone ($6.52 in chips) 
Seat 3: Lord_Antoan ($10.10 in chips) 
Seat 4: gokudousan ($18.41 in chips) 
Seat 5: Laker_Style ($14.23 in chips) 
Seat 6: Dugipokers ($10.61 in chips) 
gokudousan: posts small blind $0.05
Laker_Style: posts big blind $0.10
*** HOLE CARDS ***
Dugipokers: folds 
Coldmath: folds 
MendramoSone: folds 
Lord_Antoan: folds 
gokudousan: folds 
Uncalled bet ($0.05) returned to Laker_Style
Laker_Style collected $0.10 from pot
Laker_Style: doesn't show hand 
*** SUMMARY ***
Total pot $0.10 | Rake $0 
Seat 1: Coldmath folded before Flop (didn't bet)
Seat 2: MendramoSone folded before Flop (didn't bet)
Seat 3: Lord_Antoan (button) folded before Flop (didn't bet)
Seat 4: gokudousan (small blind) folded before Flop
Seat 5: Laker_Style (big blind) collected ($0.10)
Seat 6: Dugipokers folded before Flop (didn't bet)



PokerStars Hand #222947864128:  Hold'em No Limit ($0.05/$0.10 USD) - 2021/01/23 3:36:47 ET
Table 'Linzia' 6-max Seat #4 is the button
Seat 1: Coldmath ($9.97 in chips) 
Seat 2: MendramoSone ($6.52 in chips) 
Seat 3: Lord_Antoan ($10.10 in chips) 
Seat 4: gokudousan ($18.36 in chips) 
Seat 5: Laker_Style ($14.28 in chips) 
Seat 6: Dugipokers ($10.61 in chips) 
Laker_Style: posts small blind $0.05
Dugipokers: posts big blind $0.10
*** HOLE CARDS ***
Coldmath: folds 
MendramoSone: raises $0.10 to $0.20
Lord_Antoan: folds 
gokudousan: folds 
Laker_Style: folds 
Dugipokers: calls $0.10
*** FLOP *** [2c 4h Qd]
Dugipokers: checks 
MendramoSone: checks 
*** TURN *** [2c 4h Qd] [8c]
Dugipokers: bets $0.22
MendramoSone: calls $0.22
*** RIVER *** [2c 4h Qd 8c] [8h]
Dugipokers: bets $0.65
MendramoSone: folds 
Uncalled bet ($0.65) returned to Dugipokers
Dugipokers collected $0.85 from pot
*** SUMMARY ***
Total pot $0.89 | Rake $0.04 
Board [2c 4h Qd 8c 8h]
Seat 1: Coldmath folded before Flop (didn't bet)
Seat 2: MendramoSone folded on the River
Seat 3: Lord_Antoan folded before Flop (didn't bet)
Seat 4: gokudousan (button) folded before Flop (didn't bet)
Seat 5: Laker_Style (small blind) folded before Flop
Seat 6: Dugipokers (big blind) collected ($0.85)



PokerStars Hand #222947873382:  Hold'em No Limit ($0.05/$0.10 USD) - 2021/01/23 3:37:25 ET
Table 'Linzia' 6-max Seat #5 is the button
Seat 1: Coldmath ($9.97 in chips) 
Seat 2: MendramoSone ($6.10 in chips) 
Seat 3: Lord_Antoan ($10.10 in chips) 
Seat 4: gokudousan ($18.36 in chips) 
Seat 5: Laker_Style ($14.23 in chips) 
Seat 6: Dugipokers ($11.04 in chips) 
Dugipokers: posts small blind $0.05
Coldmath: posts big blind $0.10
*** HOLE CARDS ***
MendramoSone: raises $0.10 to $0.20
Lord_Antoan: folds 
gokudousan: folds 
Laker_Style: folds 
Dugipokers: folds 
Coldmath: folds 
Uncalled bet ($0.10) returned to MendramoSone
MendramoSone collected $0.25 from pot
MendramoSone: doesn't show hand 
*** SUMMARY ***
Total pot $0.25 | Rake $0 
Seat 1: Coldmath (big blind) folded before Flop
Seat 2: MendramoSone collected ($0.25)
Seat 3: Lord_Antoan folded before Flop (didn't bet)
Seat 4: gokudousan folded before Flop (didn't bet)
Seat 5: Laker_Style (button) folded before Flop (didn't bet)
Seat 6: Dugipokers (small blind) folded before Flop



PokerStars Hand #222947876798:  Hold'em No Limit ($0.05/$0.10 USD) - 2021/01/23 3:37:39 ET
Table 'Linzia' 6-max Seat #6 is the button
Seat 1: Coldmath ($9.87 in chips) 
Seat 2: MendramoSone ($6.25 in chips) 
Seat 3: Lord_Antoan ($10.10 in chips) 
Seat 4: gokudousan ($18.36 in chips) 
Seat 5: Laker_Style ($14.23 in chips) 
Seat 6: Dugipokers ($10.99 in chips) 
Coldmath: posts small blind $0.05
MendramoSone: posts big blind $0.10
*** HOLE CARDS ***
Lord_Antoan: folds 
gokudousan: folds 
Laker_Style: folds 
Dugipokers: raises $0.15 to $0.25
Coldmath: folds 
MendramoSone: folds 
Uncalled bet ($0.15) returned to Dugipokers
Dugipokers collected $0.25 from pot
Dugipokers: doesn't show hand 
*** SUMMARY ***
Total pot $0.25 | Rake $0 
Seat 1: Coldmath (small blind) folded before Flop
Seat 2: MendramoSone (big blind) folded before Flop
Seat 3: Lord_Antoan folded before Flop (didn't bet)
Seat 4: gokudousan folded before Flop (didn't bet)
Seat 5: Laker_Style folded before Flop (didn't bet)
Seat 6: Dugipokers (button) collected ($0.25)



PokerStars Hand #222947879474:  Hold'em No Limit ($0.05/$0.10 USD) - 2021/01/23 3:37:50 ET
Table 'Linzia' 6-max Seat #1 is the button
Seat 1: Coldmath ($9.82 in chips) 
Seat 2: MendramoSone ($6.15 in chips) 
Seat 3: Lord_Antoan ($10.10 in chips) 
Seat 4: gokudousan ($18.36 in chips) 
Seat 5: Laker_Style ($14.23 in chips) 
Seat 6: Dugipokers ($11.14 in chips) 
MendramoSone: posts small blind $0.05
Lord_Antoan: posts big blind $0.10
*** HOLE CARDS ***
gokudousan: folds 
Laker_Style: folds 
Dugipokers: folds 
Coldmath: folds 
MendramoSone: raises $0.10 to $0.20
Lord_Antoan: folds 
Uncalled bet ($0.10) returned to MendramoSone
MendramoSone collected $0.20 from pot
MendramoSone: doesn't show hand 
*** SUMMARY ***
Total pot $0.20 | Rake $0 
Seat 1: Coldmath (button) folded before Flop (didn't bet)
Seat 2: MendramoSone (small blind) collected ($0.20)
Seat 3: Lord_Antoan (big blind) folded before Flop
Seat 4: gokudousan folded before Flop (didn't bet)
Seat 5: Laker_Style folded before Flop (didn't bet)
Seat 6: Dugipokers folded before Flop (didn't bet)



PokerStars Hand #222947883111:  Hold'em No Limit ($0.05/$0.10 USD) - 2021/01/23 3:38:05 ET
Table 'Linzia' 6-max Seat #2 is the button
Seat 1: Coldmath ($9.82 in chips) 
Seat 2: MendramoSone ($6.25 in chips) 
Seat 3: Lord_Antoan ($10 in chips) 
Seat 4: gokudousan ($18.36 in chips) 
Seat 5: Laker_Style ($14.23 in chips) 
Seat 6: Dugipokers ($11.14 in chips) 
Lord_Antoan: posts small blind $0.05
gokudousan: posts big blind $0.10
*** HOLE CARDS ***
Laker_Style: folds 
Dugipokers: folds 
Coldmath: folds 
MendramoSone: folds 
Lord_Antoan: raises $0.20 to $0.30
gokudousan: calls $0.20
*** FLOP *** [8d 8h As]
Lord_Antoan: bets $0.30
gokudousan: raises $0.60 to $0.90
Lord_Antoan: folds 
Uncalled bet ($0.60) returned to gokudousan
gokudousan collected $1.15 from pot
gokudousan: doesn't show hand 
*** SUMMARY ***
Total pot $1.20 | Rake $0.05 
Board [8d 8h As]
Seat 1: Coldmath folded before Flop (didn't bet)
Seat 2: MendramoSone (button) folded before Flop (didn't bet)
Seat 3: Lord_Antoan (small blind) folded on the Flop
Seat 4: gokudousan (big blind) collected ($1.15)
Seat 5: Laker_Style folded before Flop (didn't bet)
Seat 6: Dugipokers folded before Flop (didn't bet)



PokerStars Hand #222947893145:  Hold'em No Limit ($0.05/$0.10 USD) - 2021/01/23 3:38:47 ET
Table 'Linzia' 6-max Seat #3 is the button
Seat 1: Coldmath ($9.82 in chips) 
Seat 2: MendramoSone ($6.25 in chips) 
Seat 3: Lord_Antoan ($10 in chips) 
Seat 4: gokudousan ($18.91 in chips) 
Seat 5: Laker_Style ($14.23 in chips) 
Seat 6: Dugipokers ($11.14 in chips) 
gokudousan: posts small blind $0.05
Laker_Style: posts big blind $0.10
*** HOLE CARDS ***
Dugipokers: folds 
Coldmath: folds 
MendramoSone: folds 
Lord_Antoan: raises $0.20 to $0.30
MendramoSone leaves the table
gokudousan: calls $0.25
Patte6 joins the table at seat #2 
Laker_Style: raises $1.01 to $1.31
Lord_Antoan: folds 
gokudousan: folds 
Uncalled bet ($1.01) returned to Laker_Style
Laker_Style collected $0.90 from pot
Laker_Style: doesn't show hand 
*** SUMMARY ***
Total pot $0.90 | Rake $0 
Seat 1: Coldmath folded before Flop (didn't bet)
Seat 2: MendramoSone folded before Flop (didn't bet)
Seat 3: Lord_Antoan (button) folded before Flop
Seat 4: gokudousan (small blind) folded before Flop
Seat 5: Laker_Style (big blind) collected ($0.90)
Seat 6: Dugipokers folded before Flop (didn't bet)



PokerStars Hand #222947902644:  Hold'em No Limit ($0.05/$0.10 USD) - 2021/01/23 3:39:26 ET
Table 'Linzia' 6-max Seat #4 is the button
Seat 1: Coldmath ($9.82 in chips) 
Seat 3: Lord_Antoan ($10 in chips) 
Seat 4: gokudousan ($18.61 in chips) 
Seat 5: Laker_Style ($14.83 in chips) 
Seat 6: Dugipokers ($11.14 in chips) 
Laker_Style: posts small blind $0.05
Dugipokers: posts big blind $0.10
Patte6: sits out 
*** HOLE CARDS ***
Coldmath: folds 
Lord_Antoan: folds 
gokudousan: folds 
Laker_Style: folds 
Uncalled bet ($0.05) returned to Dugipokers
Dugipokers collected $0.10 from pot
Dugipokers: doesn't show hand 
*** SUMMARY ***
Total pot $0.10 | Rake $0 
Seat 1: Coldmath folded before Flop (didn't bet)
Seat 3: Lord_Antoan folded before Flop (didn't bet)
Seat 4: gokudousan (button) folded before Flop (didn't bet)
Seat 5: Laker_Style (small blind) folded before Flop
Seat 6: Dugipokers (big blind) collected ($0.10)



PokerStars Hand #222947906014:  Hold'em No Limit ($0.05/$0.10 USD) - 2021/01/23 3:39:40 ET
Table 'Linzia' 6-max Seat #5 is the button
Seat 1: Coldmath ($9.82 in chips) 
Seat 3: Lord_Antoan ($10 in chips) 
Seat 4: gokudousan ($18.61 in chips) 
Seat 5: Laker_Style ($14.78 in chips) 
Seat 6: Dugipokers ($11.19 in chips) 
Dugipokers: posts small blind $0.05
Coldmath: posts big blind $0.10
Patte6: sits out 
*** HOLE CARDS ***
Lord_Antoan: folds 
gokudousan: folds 
Laker_Style: folds 
Dugipokers: raises $0.20 to $0.30
Coldmath: folds 
Uncalled bet ($0.20) returned to Dugipokers
Dugipokers collected $0.20 from pot
Dugipokers: doesn't show hand 
*** SUMMARY ***
Total pot $0.20 | Rake $0 
Seat 1: Coldmath (big blind) folded before Flop
Seat 3: Lord_Antoan folded before Flop (didn't bet)
Seat 4: gokudousan folded before Flop (didn't bet)
Seat 5: Laker_Style (button) folded before Flop (didn't bet)
Seat 6: Dugipokers (small blind) collected ($0.20)



PokerStars Hand #222947909978:  Hold'em No Limit ($0.05/$0.10 USD) - 2021/01/23 3:39:56 ET
Table 'Linzia' 6-max Seat #6 is the button
Seat 1: Coldmath ($9.72 in chips) 
Seat 2: Patte6 ($10 in chips) 
Seat 3: Lord_Antoan ($10 in chips) 
Seat 4: gokudousan ($18.61 in chips) 
Seat 5: Laker_Style ($14.78 in chips) 
Seat 6: Dugipokers ($11.29 in chips) 
Coldmath: posts small blind $0.05
Patte6: posts big blind $0.10
*** HOLE CARDS ***
Lord_Antoan: folds 
gokudousan: folds 
Laker_Style: raises $0.20 to $0.30
Dugipokers: folds 
Coldmath: calls $0.25
Patte6: folds 
*** FLOP *** [4s Ks 8s]
Coldmath: bets $0.34
Laker_Style: calls $0.34
*** TURN *** [4s Ks 8s] [Jh]
Coldmath: bets $0.50
Laker_Style: calls $0.50
*** RIVER *** [4s Ks 8s Jh] [Kd]
Coldmath: bets $0.70
Laker_Style: calls $0.70
*** SHOW DOWN ***
Coldmath: shows [7d 7s] (two pair, Kings and Sevens)
Laker_Style: shows [Ad As] (two pair, Aces and Kings)
Laker_Style collected $3.61 from pot
*** SUMMARY ***
Total pot $3.78 | Rake $0.17 
Board [4s Ks 8s Jh Kd]
Seat 1: Coldmath (small blind) showed [7d 7s] and lost with two pair, Kings and Sevens
Seat 2: Patte6 (big blind) folded before Flop
Seat 3: Lord_Antoan folded before Flop (didn't bet)
Seat 4: gokudousan folded before Flop (didn't bet)
Seat 5: Laker_Style showed [Ad As] and won ($3.61) with two pair, Aces and Kings
Seat 6: Dugipokers (button) folded before Flop (didn't bet)



PokerStars Hand #222947923964:  Hold'em No Limit ($0.05/$0.10 USD) - 2021/01/23 3:40:54 ET
Table 'Linzia' 6-max Seat #1 is the button
Seat 1: Coldmath ($7.88 in chips) 
Seat 2: Patte6 ($10 in chips) 
Seat 3: Lord_Antoan ($10 in chips) 
Seat 4: gokudousan ($18.61 in chips) 
Seat 5: Laker_Style ($16.55 in chips) 
Seat 6: Dugipokers ($11.29 in chips) 
Patte6: posts small blind $0.05
Lord_Antoan: posts big blind $0.10
*** HOLE CARDS ***
gokudousan: folds 
Laker_Style: folds 
Dugipokers: folds 
Coldmath: raises $0.20 to $0.30
Patte6: folds 
Lord_Antoan: calls $0.20
*** FLOP *** [Td 8s 6h]
Lord_Antoan: checks 
Coldmath: bets $0.40
Lord_Antoan: calls $0.40
*** TURN *** [Td 8s 6h] [As]
Lord_Antoan: checks 
Coldmath: checks 
*** RIVER *** [Td 8s 6h As] [7s]
Lord_Antoan: checks 
Coldmath: bets $0.50
Lord_Antoan: calls $0.50
*** SHOW DOWN ***
Coldmath: shows [2h 2s] (a pair of Deuces)
Lord_Antoan: shows [Ah Th] (two pair, Aces and Tens)
Lord_Antoan collected $2.34 from pot
*** SUMMARY ***
Total pot $2.45 | Rake $0.11 
Board [Td 8s 6h As 7s]
Seat 1: Coldmath (button) showed [2h 2s] and lost with a pair of Deuces
Seat 2: Patte6 (small blind) folded before Flop
Seat 3: Lord_Antoan (big blind) showed [Ah Th] and won ($2.34) with two pair, Aces and Tens
Seat 4: gokudousan folded before Flop (didn't bet)
Seat 5: Laker_Style folded before Flop (didn't bet)
Seat 6: Dugipokers folded before Flop (didn't bet)



PokerStars Hand #222947933647:  Hold'em No Limit ($0.05/$0.10 USD) - 2021/01/23 3:41:34 ET
Table 'Linzia' 6-max Seat #2 is the button
Seat 1: Coldmath ($6.68 in chips) 
Seat 2: Patte6 ($10 in chips) 
Seat 3: Lord_Antoan ($11.14 in chips) 
Seat 4: gokudousan ($18.61 in chips) 
Seat 5: Laker_Style ($16.55 in chips) 
Seat 6: Dugipokers ($11.29 in chips) 
Lord_Antoan: posts small blind $0.05
gokudousan: posts big blind $0.10
*** HOLE CARDS ***
Laker_Style: raises $0.20 to $0.30
Dugipokers: folds 
Coldmath: folds 
Patte6: folds 
Lord_Antoan: folds 
gokudousan: folds 
Uncalled bet ($0.20) returned to Laker_Style
Laker_Style collected $0.25 from pot
Laker_Style: doesn't show hand 
*** SUMMARY ***
Total pot $0.25 | Rake $0 
Seat 1: Coldmath folded before Flop (didn't bet)
Seat 2: Patte6 (button) folded before Flop (didn't bet)
Seat 3: Lord_Antoan (small blind) folded before Flop
Seat 4: gokudousan (big blind) folded before Flop
Seat 5: Laker_Style collected ($0.25)
Seat 6: Dugipokers folded before Flop (didn't bet)



PokerStars Hand #222947936795:  Hold'em No Limit ($0.05/$0.10 USD) - 2021/01/23 3:41:47 ET
Table 'Linzia' 6-max Seat #3 is the button
Seat 1: Coldmath ($6.68 in chips) 
Seat 2: Patte6 ($10 in chips) 
Seat 3: Lord_Antoan ($11.09 in chips) 
Seat 4: gokudousan ($18.51 in chips) 
Seat 5: Laker_Style ($16.70 in chips) 
Seat 6: Dugipokers ($11.29 in chips) 
gokudousan: posts small blind $0.05
Laker_Style: posts big blind $0.10
*** HOLE CARDS ***
Dugipokers: folds 
Coldmath: raises $0.20 to $0.30
Patte6: folds 
Lord_Antoan: folds 
gokudousan: folds 
Laker_Style: folds 
Uncalled bet ($0.20) returned to Coldmath
Coldmath collected $0.25 from pot
Coldmath: doesn't show hand 
*** SUMMARY ***
Total pot $0.25 | Rake $0 
Seat 1: Coldmath collected ($0.25)
Seat 2: Patte6 folded before Flop (didn't bet)
Seat 3: Lord_Antoan (button) folded before Flop (didn't bet)
Seat 4: gokudousan (small blind) folded before Flop
Seat 5: Laker_Style (big blind) folded before Flop
Seat 6: Dugipokers folded before Flop (didn't bet)



PokerStars Hand #222947939382:  Hold'em No Limit ($0.05/$0.10 USD) - 2021/01/23 3:41:58 ET
Table 'Linzia' 6-max Seat #4 is the button
Seat 1: Coldmath ($6.83 in chips) 
Seat 2: Patte6 ($10 in chips) 
Seat 3: Lord_Antoan ($11.09 in chips) 
Seat 4: gokudousan ($18.46 in chips) 
Seat 5: Laker_Style ($16.60 in chips) 
Seat 6: Dugipokers ($11.29 in chips) 
Laker_Style: posts small blind $0.05
Dugipokers: posts big blind $0.10
*** HOLE CARDS ***
Coldmath: folds 
Patte6: raises $0.20 to $0.30
Lord_Antoan: folds 
gokudousan: folds 
Laker_Style: folds 
Dugipokers: raises $0.70 to $1
Patte6: folds 
Uncalled bet ($0.70) returned to Dugipokers
Dugipokers collected $0.65 from pot
Dugipokers: doesn't show hand 
*** SUMMARY ***
Total pot $0.65 | Rake $0 
Seat 1: Coldmath folded before Flop (didn't bet)
Seat 2: Patte6 folded before Flop
Seat 3: Lord_Antoan folded before Flop (didn't bet)
Seat 4: gokudousan (button) folded before Flop (didn't bet)
Seat 5: Laker_Style (small blind) folded before Flop
Seat 6: Dugipokers (big blind) collected ($0.65)



PokerStars Hand #222947943660:  Hold'em No Limit ($0.05/$0.10 USD) - 2021/01/23 3:42:15 ET
Table 'Linzia' 6-max Seat #5 is the button
Seat 1: Coldmath ($6.83 in chips) 
Seat 2: Patte6 ($10 in chips) 
Seat 3: Lord_Antoan ($11.09 in chips) 
Seat 4: gokudousan ($18.46 in chips) 
Seat 5: Laker_Style ($16.55 in chips) 
Seat 6: Dugipokers ($11.64 in chips) 
Dugipokers: posts small blind $0.05
Coldmath: posts big blind $0.10
*** HOLE CARDS ***
Patte6: folds 
Lord_Antoan: folds 
gokudousan: folds 
Laker_Style: raises $0.15 to $0.25
Dugipokers: folds 
Coldmath: folds 
Uncalled bet ($0.15) returned to Laker_Style
Laker_Style collected $0.25 from pot
Laker_Style: doesn't show hand 
*** SUMMARY ***
Total pot $0.25 | Rake $0 
Seat 1: Coldmath (big blind) folded before Flop
Seat 2: Patte6 folded before Flop (didn't bet)
Seat 3: Lord_Antoan folded before Flop (didn't bet)
Seat 4: gokudousan folded before Flop (didn't bet)
Seat 5: Laker_Style (button) collected ($0.25)
Seat 6: Dugipokers (small blind) folded before Flop



PokerStars Hand #222947946997:  Hold'em No Limit ($0.05/$0.10 USD) - 2021/01/23 3:42:29 ET
Table 'Linzia' 6-max Seat #6 is the button
Seat 1: Coldmath ($6.73 in chips) 
Seat 2: Patte6 ($10 in chips) 
Seat 3: Lord_Antoan ($11.09 in chips) 
Seat 4: gokudousan ($18.46 in chips) 
Seat 5: Laker_Style ($16.70 in chips) 
Seat 6: Dugipokers ($11.59 in chips) 
Coldmath: posts small blind $0.05
Patte6: posts big blind $0.10
*** HOLE CARDS ***
Lord_Antoan: folds 
gokudousan: raises $0.20 to $0.30
Laker_Style: folds 
Dugipokers: folds 
Coldmath: calls $0.25
Patte6: folds 
*** FLOP *** [7s Kd 8s]
Coldmath: checks 
gokudousan: checks 
*** TURN *** [7s Kd 8s] [6s]
Coldmath: checks 
gokudousan: bets $0.40
Coldmath: folds 
Uncalled bet ($0.40) returned to gokudousan
gokudousan collected $0.67 from pot
gokudousan: doesn't show hand 
*** SUMMARY ***
Total pot $0.70 | Rake $0.03 
Board [7s Kd 8s 6s]
Seat 1: Coldmath (small blind) folded on the Turn
Seat 2: Patte6 (big blind) folded before Flop
Seat 3: Lord_Antoan folded before Flop (didn't bet)
Seat 4: gokudousan collected ($0.67)
Seat 5: Laker_Style folded before Flop (didn't bet)
Seat 6: Dugipokers (button) folded before Flop (didn't bet)



PokerStars Hand #222947954012:  Hold'em No Limit ($0.05/$0.10 USD) - 2021/01/23 3:42:58 ET
Table 'Linzia' 6-max Seat #1 is the button
Seat 1: Coldmath ($6.43 in chips) 
Seat 2: Patte6 ($10 in chips) 
Seat 3: Lord_Antoan ($11.09 in chips) 
Seat 4: gokudousan ($18.83 in chips) 
Seat 5: Laker_Style ($16.70 in chips) 
Seat 6: Dugipokers ($11.59 in chips) 
Patte6: posts small blind $0.05
Lord_Antoan: posts big blind $0.10
*** HOLE CARDS ***
gokudousan: folds 
Laker_Style: folds 
Dugipokers: folds 
Coldmath: folds 
Patte6: raises $0.20 to $0.30
Lord_Antoan: raises $0.60 to $0.90
Patte6: calls $0.60
*** FLOP *** [As Td Tc]
Patte6: checks 
Lord_Antoan: bets $0.95
Patte6: calls $0.95
*** TURN *** [As Td Tc] [5d]
Patte6: checks 
Lord_Antoan: checks 
*** RIVER *** [As Td Tc 5d] [9h]
Patte6: checks 
Lord_Antoan: bets $1.94
Patte6: calls $1.94
*** SHOW DOWN ***
Lord_Antoan: shows [Qs 8s] (a pair of Tens)
Patte6: shows [Ah Jh] (two pair, Aces and Tens)
Patte6 collected $7.24 from pot
*** SUMMARY ***
Total pot $7.58 | Rake $0.34 
Board [As Td Tc 5d 9h]
Seat 1: Coldmath (button) folded before Flop (didn't bet)
Seat 2: Patte6 (small blind) showed [Ah Jh] and won ($7.24) with two pair, Aces and Tens
Seat 3: Lord_Antoan (big blind) showed [Qs 8s] and lost with a pair of Tens
Seat 4: gokudousan folded before Flop (didn't bet)
Seat 5: Laker_Style folded before Flop (didn't bet)
Seat 6: Dugipokers folded before Flop (didn't bet)



PokerStars Hand #222947968273:  Hold'em No Limit ($0.05/$0.10 USD) - 2021/01/23 3:43:56 ET
Table 'Linzia' 6-max Seat #2 is the button
Seat 1: Coldmath ($6.43 in chips) 
Seat 2: Patte6 ($13.45 in chips) 
Seat 3: Lord_Antoan ($10 in chips) 
Seat 4: gokudousan ($18.83 in chips) 
Seat 5: Laker_Style ($16.70 in chips) 
Seat 6: Dugipokers ($11.59 in chips) 
Lord_Antoan: posts small blind $0.05
gokudousan: posts big blind $0.10
*** HOLE CARDS ***
Laker_Style has timed out
Laker_Style: folds 
Dugipokers: raises $0.20 to $0.30
Coldmath: folds 
Patte6: folds 
Lord_Antoan: folds 
gokudousan: folds 
Uncalled bet ($0.20) returned to Dugipokers
Dugipokers collected $0.25 from pot
Dugipokers: doesn't show hand 
*** SUMMARY ***
Total pot $0.25 | Rake $0 
Seat 1: Coldmath folded before Flop (didn't bet)
Seat 2: Patte6 (button) folded before Flop (didn't bet)
Seat 3: Lord_Antoan (small blind) folded before Flop
Seat 4: gokudousan (big blind) folded before Flop
Seat 5: Laker_Style folded before Flop (didn't bet)
Seat 6: Dugipokers collected ($0.25)



PokerStars Hand #222947974706:  Hold'em No Limit ($0.05/$0.10 USD) - 2021/01/23 3:44:22 ET
Table 'Linzia' 6-max Seat #3 is the button
Seat 1: Coldmath ($6.43 in chips) 
Seat 2: Patte6 ($13.45 in chips) 
Seat 3: Lord_Antoan ($10 in chips) 
Seat 4: gokudousan ($18.73 in chips) 
Seat 5: Laker_Style ($16.70 in chips) 
Seat 6: Dugipokers ($11.74 in chips) 
gokudousan: posts small blind $0.05
Laker_Style: posts big blind $0.10
*** HOLE CARDS ***
Dugipokers: folds 
Dugipokers leaves the table
Coldmath: folds 
Patte6: folds 
Annu_91 joins the table at seat #6 
Lord_Antoan: folds 
gokudousan: raises $0.20 to $0.30
Laker_Style: folds 
Uncalled bet ($0.20) returned to gokudousan
gokudousan collected $0.20 from pot
gokudousan: doesn't show hand 
*** SUMMARY ***
Total pot $0.20 | Rake $0 
Seat 1: Coldmath folded before Flop (didn't bet)
Seat 2: Patte6 folded before Flop (didn't bet)
Seat 3: Lord_Antoan (button) folded before Flop (didn't bet)
Seat 4: gokudousan (small blind) collected ($0.20)
Seat 5: Laker_Style (big blind) folded before Flop
Seat 6: Dugipokers folded before Flop (didn't bet)



PokerStars Hand #222947978525:  Hold'em No Limit ($0.05/$0.10 USD) - 2021/01/23 3:44:38 ET
Table 'Linzia' 6-max Seat #4 is the button
Seat 1: Coldmath ($6.43 in chips) 
Seat 2: Patte6 ($13.45 in chips) 
Seat 3: Lord_Antoan ($10 in chips) 
Seat 4: gokudousan ($18.83 in chips) 
Seat 5: Laker_Style ($16.60 in chips) 
Seat 6: Annu_91 ($10 in chips) 
Laker_Style: posts small blind $0.05
Annu_91: posts big blind $0.10
*** HOLE CARDS ***
Coldmath: folds 
Patte6: folds 
Lord_Antoan: folds 
gokudousan: raises $0.20 to $0.30
Laker_Style: folds 
Annu_91: calls $0.20
*** FLOP *** [As Qh 3c]
Annu_91: checks 
gokudousan: bets $0.30
Annu_91: folds 
Uncalled bet ($0.30) returned to gokudousan
gokudousan collected $0.62 from pot
gokudousan: doesn't show hand 
*** SUMMARY ***
Total pot $0.65 | Rake $0.03 
Board [As Qh 3c]
Seat 1: Coldmath folded before Flop (didn't bet)
Seat 2: Patte6 folded before Flop (didn't bet)
Seat 3: Lord_Antoan folded before Flop (didn't bet)
Seat 4: gokudousan (button) collected ($0.62)
Seat 5: Laker_Style (small blind) folded before Flop
Seat 6: Annu_91 (big blind) folded on the Flop



PokerStars Hand #222947987005:  Hold'em No Limit ($0.05/$0.10 USD) - 2021/01/23 3:45:12 ET
Table 'Linzia' 6-max Seat #5 is the button
Seat 2: Patte6 ($13.45 in chips) 
Seat 3: Lord_Antoan ($10 in chips) 
Seat 4: gokudousan ($19.15 in chips) 
Seat 5: Laker_Style ($16.55 in chips) 
Seat 6: Annu_91 ($10 in chips) 
Annu_91: posts small blind $0.05
Coldmath: is sitting out 
Patte6: posts big blind $0.10
*** HOLE CARDS ***
Coldmath leaves the table
BoggywanKenobi joins the table at seat #1 
Lord_Antoan: folds 
gokudousan: folds 
Laker_Style: raises $0.15 to $0.25
Annu_91: calls $0.20
Patte6: raises $1.05 to $1.30
Laker_Style: folds 
Annu_91: folds 
Uncalled bet ($1.05) returned to Patte6
Patte6 collected $0.75 from pot
Patte6: doesn't show hand 
*** SUMMARY ***
Total pot $0.75 | Rake $0 
Seat 2: Patte6 (big blind) collected ($0.75)
Seat 3: Lord_Antoan folded before Flop (didn't bet)
Seat 4: gokudousan folded before Flop (didn't bet)
Seat 5: Laker_Style (button) folded before Flop
Seat 6: Annu_91 (small blind) folded before Flop



PokerStars Hand #222947997825:  Hold'em No Limit ($0.05/$0.10 USD) - 2021/01/23 3:45:56 ET
Table 'Linzia' 6-max Seat #6 is the button
Seat 2: Patte6 ($13.95 in chips) 
Seat 3: Lord_Antoan ($10 in chips) 
Seat 4: gokudousan ($19.15 in chips) 
Seat 5: Laker_Style ($16.30 in chips) 
Seat 6: Annu_91 ($10 in chips) 
Patte6: posts small blind $0.05
Lord_Antoan: posts big blind $0.10
*** HOLE CARDS ***
gokudousan: folds 
Laker_Style: folds 
Annu_91: calls $0.10
Patte6: folds 
Lord_Antoan: checks 
*** FLOP *** [8d 4s Tc]
Lord_Antoan: checks 
Annu_91: checks 
*** TURN *** [8d 4s Tc] [9d]
Lord_Antoan: checks 
Annu_91: checks 
*** RIVER *** [8d 4s Tc 9d] [4c]
Lord_Antoan: checks 
Annu_91: bets $0.10
Lord_Antoan: folds 
Uncalled bet ($0.10) returned to Annu_91
Annu_91 collected $0.24 from pot
Annu_91: doesn't show hand 
*** SUMMARY ***
Total pot $0.25 | Rake $0.01 
Board [8d 4s Tc 9d 4c]
Seat 2: Patte6 (small blind) folded before Flop
Seat 3: Lord_Antoan (big blind) folded on the River
Seat 4: gokudousan folded before Flop (didn't bet)
Seat 5: Laker_Style folded before Flop (didn't bet)
Seat 6: Annu_91 (button) collected ($0.24)



PokerStars Hand #222948012688:  Hold'em No Limit ($0.05/$0.10 USD) - 2021/01/23 3:46:56 ET
Table 'Linzia' 6-max Seat #2 is the button
Seat 1: BoggywanKenobi ($5 in chips) 
Seat 2: Patte6 ($13.90 in chips) 
Seat 3: Lord_Antoan ($10 in chips) 
Seat 4: gokudousan ($19.15 in chips) 
Seat 5: Laker_Style ($16.30 in chips) 
Seat 6: Annu_91 ($10.14 in chips) 
Lord_Antoan: posts small blind $0.05
gokudousan: posts big blind $0.10
BoggywanKenobi: posts big blind $0.10
*** HOLE CARDS ***
Laker_Style: folds 
Annu_91: calls $0.10
BoggywanKenobi: checks 
Patte6: folds 
Lord_Antoan: calls $0.05
gokudousan: checks 
*** FLOP *** [Qd Ts 3h]
Lord_Antoan: checks 
gokudousan: checks 
Annu_91: checks 
BoggywanKenobi: checks 
*** TURN *** [Qd Ts 3h] [Qc]
Lord_Antoan: checks 
gokudousan: checks 
Annu_91: bets $0.20
BoggywanKenobi: folds 
Lord_Antoan: folds 
gokudousan: folds 
Uncalled bet ($0.20) returned to Annu_91
Annu_91 collected $0.38 from pot
Annu_91: doesn't show hand 
*** SUMMARY ***
Total pot $0.40 | Rake $0.02 
Board [Qd Ts 3h Qc]
Seat 1: BoggywanKenobi folded on the Turn (didn't bet)
Seat 2: Patte6 (button) folded before Flop (didn't bet)
Seat 3: Lord_Antoan (small blind) folded on the Turn
Seat 4: gokudousan (big blind) folded on the Turn
Seat 5: Laker_Style folded before Flop (didn't bet)
Seat 6: Annu_91 collected ($0.38)



PokerStars Hand #222948022588:  Hold'em No Limit ($0.05/$0.10 USD) - 2021/01/23 3:47:36 ET
Table 'Linzia' 6-max Seat #3 is the button
Seat 1: BoggywanKenobi ($4.90 in chips) 
Seat 2: Patte6 ($13.90 in chips) 
Seat 3: Lord_Antoan ($10 in chips) 
Seat 4: gokudousan ($19.05 in chips) 
Seat 5: Laker_Style ($16.30 in chips) 
Seat 6: Annu_91 ($10.42 in chips) 
gokudousan: posts small blind $0.05
Laker_Style: posts big blind $0.10
*** HOLE CARDS ***
Annu_91: folds 
BoggywanKenobi: calls $0.10
Patte6: folds 
Lord_Antoan: folds 
gokudousan: folds 
Laker_Style: raises $0.40 to $0.50
BoggywanKenobi: folds 
Uncalled bet ($0.40) returned to Laker_Style
Laker_Style collected $0.25 from pot
Laker_Style: doesn't show hand 
*** SUMMARY ***
Total pot $0.25 | Rake $0 
Seat 1: BoggywanKenobi folded before Flop
Seat 2: Patte6 folded before Flop (didn't bet)
Seat 3: Lord_Antoan (button) folded before Flop (didn't bet)
Seat 4: gokudousan (small blind) folded before Flop
Seat 5: Laker_Style (big blind) collected ($0.25)
Seat 6: Annu_91 folded before Flop (didn't bet)



PokerStars Hand #222948026999:  Hold'em No Limit ($0.05/$0.10 USD) - 2021/01/23 3:47:54 ET
Table 'Linzia' 6-max Seat #4 is the button
Seat 1: BoggywanKenobi ($4.80 in chips) 
Seat 2: Patte6 ($13.90 in chips) 
Seat 3: Lord_Antoan ($10 in chips) 
Seat 4: gokudousan ($19 in chips) 
Seat 5: Laker_Style ($16.45 in chips) 
Seat 6: Annu_91 ($10.42 in chips) 
Laker_Style: posts small blind $0.05
Annu_91: posts big blind $0.10
*** HOLE CARDS ***
BoggywanKenobi: calls $0.10
Patte6: folds 
Lord_Antoan: raises $0.20 to $0.30
gokudousan: folds 
Laker_Style: folds 
Annu_91: folds 
BoggywanKenobi: calls $0.20
*** FLOP *** [Ac 8c As]
BoggywanKenobi: checks 
Annu_91 leaves the table
Lord_Antoan: bets $0.40
BoggywanKenobi: folds 
Uncalled bet ($0.40) returned to Lord_Antoan
Lord_Antoan collected $0.72 from pot
Lord_Antoan: doesn't show hand 
*** SUMMARY ***
Total pot $0.75 | Rake $0.03 
Board [Ac 8c As]
Seat 1: BoggywanKenobi folded on the Flop
Seat 2: Patte6 folded before Flop (didn't bet)
Seat 3: Lord_Antoan collected ($0.72)
Seat 4: gokudousan (button) folded before Flop (didn't bet)
Seat 5: Laker_Style (small blind) folded before Flop
Seat 6: Annu_91 (big blind) folded before Flop



PokerStars Hand #222948034398:  Hold'em No Limit ($0.05/$0.10 USD) - 2021/01/23 3:48:24 ET
Table 'Linzia' 6-max Seat #5 is the button
Seat 1: BoggywanKenobi ($4.50 in chips) 
Seat 2: Patte6 ($13.90 in chips) 
Seat 3: Lord_Antoan ($10.42 in chips) 
Seat 4: gokudousan ($19 in chips) 
Seat 5: Laker_Style ($16.40 in chips) 
BoggywanKenobi: posts small blind $0.05
Patte6: posts big blind $0.10
*** HOLE CARDS ***
Lord_Antoan: folds 
Dangerous Mind joins the table at seat #6 
gokudousan: folds 
Laker_Style: folds 
BoggywanKenobi: calls $0.05
Patte6: checks 
*** FLOP *** [Kd 4s 7c]
BoggywanKenobi: checks 
Patte6: bets $0.10
BoggywanKenobi: calls $0.10
*** TURN *** [Kd 4s 7c] [7s]
BoggywanKenobi: checks 
Patte6: bets $0.29
BoggywanKenobi: folds 
Uncalled bet ($0.29) returned to Patte6
Patte6 collected $0.38 from pot
Patte6: doesn't show hand 
*** SUMMARY ***
Total pot $0.40 | Rake $0.02 
Board [Kd 4s 7c 7s]
Seat 1: BoggywanKenobi (small blind) folded on the Turn
Seat 2: Patte6 (big blind) collected ($0.38)
Seat 3: Lord_Antoan folded before Flop (didn't bet)
Seat 4: gokudousan folded before Flop (didn't bet)
Seat 5: Laker_Style (button) folded before Flop (didn't bet)



PokerStars Hand #222948040686:  Hold'em No Limit ($0.05/$0.10 USD) - 2021/01/23 3:48:49 ET
Table 'Linzia' 6-max Seat #1 is the button
Seat 1: BoggywanKenobi ($4.30 in chips) 
Seat 2: Patte6 ($14.08 in chips) 
Seat 3: Lord_Antoan ($10.42 in chips) 
Seat 4: gokudousan ($19 in chips) 
Seat 5: Laker_Style ($16.40 in chips) 
Patte6: posts small blind $0.05
Lord_Antoan: posts big blind $0.10
Dangerous Mind: sits out 
*** HOLE CARDS ***
gokudousan: folds 
Laker_Style: folds 
BoggywanKenobi: calls $0.10
Patte6: folds 
Lord_Antoan: checks 
*** FLOP *** [8c Ad 7h]
Lord_Antoan: checks 
BoggywanKenobi: checks 
*** TURN *** [8c Ad 7h] [Tc]
Lord_Antoan: checks 
BoggywanKenobi: checks 
*** RIVER *** [8c Ad 7h Tc] [3c]
Lord_Antoan: checks 
BoggywanKenobi: bets $0.24
Lord_Antoan: folds 
Uncalled bet ($0.24) returned to BoggywanKenobi
BoggywanKenobi collected $0.24 from pot
BoggywanKenobi: doesn't show hand 
*** SUMMARY ***
Total pot $0.25 | Rake $0.01 
Board [8c Ad 7h Tc 3c]
Seat 1: BoggywanKenobi (button) collected ($0.24)
Seat 2: Patte6 (small blind) folded before Flop
Seat 3: Lord_Antoan (big blind) folded on the River
Seat 4: gokudousan folded before Flop (didn't bet)
Seat 5: Laker_Style folded before Flop (didn't bet)



PokerStars Hand #222948049414:  Hold'em No Limit ($0.05/$0.10 USD) - 2021/01/23 3:49:24 ET
Table 'Linzia' 6-max Seat #2 is the button
Seat 1: BoggywanKenobi ($4.44 in chips) 
Seat 2: Patte6 ($14.03 in chips) 
Seat 3: Lord_Antoan ($10.32 in chips) 
Seat 4: gokudousan ($19 in chips) 
Seat 5: Laker_Style ($16.40 in chips) 
Lord_Antoan: posts small blind $0.05
gokudousan: posts big blind $0.10
Dangerous Mind: sits out 
*** HOLE CARDS ***
Dangerous Mind leaves the table
Laker_Style: folds 
BoggywanKenobi: calls $0.10
Patte6: folds 
Lord_Antoan: folds 
gokudousan: checks 
*** FLOP *** [Ks 6s Td]
gokudousan: checks 
BoggywanKenobi: checks 
*** TURN *** [Ks 6s Td] [Ts]
gokudousan: checks 
wma606 joins the table at seat #6 
BoggywanKenobi: bets $0.24
gokudousan: folds 
Uncalled bet ($0.24) returned to BoggywanKenobi
BoggywanKenobi collected $0.24 from pot
BoggywanKenobi: doesn't show hand 
*** SUMMARY ***
Total pot $0.25 | Rake $0.01 
Board [Ks 6s Td Ts]
Seat 1: BoggywanKenobi collected ($0.24)
Seat 2: Patte6 (button) folded before Flop (didn't bet)
Seat 3: Lord_Antoan (small blind) folded before Flop
Seat 4: gokudousan (big blind) folded on the Turn
Seat 5: Laker_Style folded before Flop (didn't bet)



PokerStars Hand #222948060987:  Hold'em No Limit ($0.05/$0.10 USD) - 2021/01/23 3:50:11 ET
Table 'Linzia' 6-max Seat #3 is the button
Seat 1: BoggywanKenobi ($4.58 in chips) 
Seat 2: Patte6 ($14.03 in chips) 
Seat 3: Lord_Antoan ($10.27 in chips) 
Seat 4: gokudousan ($18.90 in chips) 
Seat 5: Laker_Style ($16.40 in chips) 
gokudousan: posts small blind $0.05
Laker_Style: posts big blind $0.10
wma606: sits out 
*** HOLE CARDS ***
BoggywanKenobi: calls $0.10
Patte6: folds 
Lord_Antoan: folds 
gokudousan: folds 
Laker_Style: checks 
*** FLOP *** [Jh Js 7c]
Laker_Style: bets $0.20
BoggywanKenobi: folds 
Uncalled bet ($0.20) returned to Laker_Style
Laker_Style collected $0.24 from pot
Laker_Style: doesn't show hand 
*** SUMMARY ***
Total pot $0.25 | Rake $0.01 
Board [Jh Js 7c]
Seat 1: BoggywanKenobi folded on the Flop
Seat 2: Patte6 folded before Flop (didn't bet)
Seat 3: Lord_Antoan (button) folded before Flop (didn't bet)
Seat 4: gokudousan (small blind) folded before Flop
Seat 5: Laker_Style (big blind) collected ($0.24)



PokerStars Hand #222948068131:  Hold'em No Limit ($0.05/$0.10 USD) - 2021/01/23 3:50:40 ET
Table 'Linzia' 6-max Seat #4 is the button
Seat 1: BoggywanKenobi ($4.48 in chips) 
Seat 2: Patte6 ($14.03 in chips) 
Seat 3: Lord_Antoan ($10.27 in chips) 
Seat 4: gokudousan ($18.85 in chips) 
Seat 5: Laker_Style ($16.54 in chips) 
Seat 6: wma606 ($6.45 in chips) 
Laker_Style: posts small blind $0.05
wma606: posts big blind $0.10
*** HOLE CARDS ***
BoggywanKenobi: calls $0.10
Patte6: folds 
Lord_Antoan: folds 
gokudousan: folds 
Laker_Style: raises $0.40 to $0.50
wma606: folds 
BoggywanKenobi: folds 
Uncalled bet ($0.40) returned to Laker_Style
Laker_Style collected $0.30 from pot
Laker_Style: doesn't show hand 
*** SUMMARY ***
Total pot $0.30 | Rake $0 
Seat 1: BoggywanKenobi folded before Flop
Seat 2: Patte6 folded before Flop (didn't bet)
Seat 3: Lord_Antoan folded before Flop (didn't bet)
Seat 4: gokudousan (button) folded before Flop (didn't bet)
Seat 5: Laker_Style (small blind) collected ($0.30)
Seat 6: wma606 (big blind) folded before Flop



PokerStars Hand #222948072399:  Hold'em No Limit ($0.05/$0.10 USD) - 2021/01/23 3:50:57 ET
Table 'Linzia' 6-max Seat #5 is the button
Seat 1: BoggywanKenobi ($4.38 in chips) 
Seat 2: Patte6 ($14.03 in chips) 
Seat 3: Lord_Antoan ($10.27 in chips) 
Seat 4: gokudousan ($18.85 in chips) 
Seat 5: Laker_Style ($16.74 in chips) 
Seat 6: wma606 ($6.35 in chips) 
wma606: posts small blind $0.05
BoggywanKenobi: posts big blind $0.10
*** HOLE CARDS ***
Patte6: folds 
Lord_Antoan: folds 
gokudousan: folds 
Laker_Style: raises $0.15 to $0.25
wma606: folds 
BoggywanKenobi: calls $0.15
*** FLOP *** [Ah 8d Ac]
BoggywanKenobi: checks 
Laker_Style: bets $0.27
BoggywanKenobi: calls $0.27
*** TURN *** [Ah 8d Ac] [3c]
BoggywanKenobi: checks 
Laker_Style: bets $0.78
BoggywanKenobi: calls $0.78
*** RIVER *** [Ah 8d Ac 3c] [3s]
BoggywanKenobi: checks 
Laker_Style: bets $1
BoggywanKenobi: calls $1
*** SHOW DOWN ***
Laker_Style: shows [5s As] (a full house, Aces full of Threes)
BoggywanKenobi: mucks hand 
Laker_Style collected $4.44 from pot
*** SUMMARY ***
Total pot $4.65 | Rake $0.21 
Board [Ah 8d Ac 3c 3s]
Seat 1: BoggywanKenobi (big blind) mucked
Seat 2: Patte6 folded before Flop (didn't bet)
Seat 3: Lord_Antoan folded before Flop (didn't bet)
Seat 4: gokudousan folded before Flop (didn't bet)
Seat 5: Laker_Style (button) showed [5s As] and won ($4.44) with a full house, Aces full of Threes
Seat 6: wma606 (small blind) folded before Flop



PokerStars Hand #222948084365:  Hold'em No Limit ($0.05/$0.10 USD) - 2021/01/23 3:51:45 ET
Table 'Linzia' 6-max Seat #6 is the button
Seat 1: BoggywanKenobi ($2.08 in chips) 
Seat 2: Patte6 ($14.03 in chips) 
Seat 3: Lord_Antoan ($10.27 in chips) 
Seat 4: gokudousan ($18.85 in chips) 
Seat 5: Laker_Style ($18.88 in chips) 
Seat 6: wma606 ($6.30 in chips) 
BoggywanKenobi: posts small blind $0.05
Patte6: posts big blind $0.10
*** HOLE CARDS ***
Lord_Antoan: folds 
gokudousan: raises $0.20 to $0.30
Laker_Style: folds 
wma606: folds 
BoggywanKenobi: calls $0.25
Patte6: calls $0.20
*** FLOP *** [Qh Th 9c]
BoggywanKenobi: checks 
Patte6: checks 
gokudousan: bets $0.40
BoggywanKenobi: raises $0.40 to $0.80
Lord_Antoan leaves the table
Patte6: folds 
gokudousan: calls $0.40
*** TURN *** [Qh Th 9c] [Ad]
BoggywanKenobi: bets $0.98 and is all-in
gokudousan: calls $0.98
*** RIVER *** [Qh Th 9c Ad] [7d]
*** SHOW DOWN ***
BoggywanKenobi: shows [8h Ah] (a pair of Aces)
gokudousan: shows [Ac 8c] (a pair of Aces)
BoggywanKenobi collected $2.13 from pot
gokudousan collected $2.13 from pot
*** SUMMARY ***
Total pot $4.46 | Rake $0.20 
Board [Qh Th 9c Ad 7d]
Seat 1: BoggywanKenobi (small blind) showed [8h Ah] and won ($2.13) with a pair of Aces
Seat 2: Patte6 (big blind) folded on the Flop
Seat 3: Lord_Antoan folded before Flop (didn't bet)
Seat 4: gokudousan showed [Ac 8c] and won ($2.13) with a pair of Aces
Seat 5: Laker_Style folded before Flop (didn't bet)
Seat 6: wma606 (button) folded before Flop (didn't bet)



PokerStars Hand #222948099589:  Hold'em No Limit ($0.05/$0.10 USD) - 2021/01/23 3:52:47 ET
Table 'Linzia' 6-max Seat #1 is the button
Seat 1: BoggywanKenobi ($2.13 in chips) 
Seat 2: Patte6 ($13.73 in chips) 
Seat 4: gokudousan ($18.90 in chips) 
Seat 5: Laker_Style ($18.88 in chips) 
Seat 6: wma606 ($6.30 in chips) 
Patte6: posts small blind $0.05
gokudousan: posts big blind $0.10
*** HOLE CARDS ***
Laker_Style: raises $0.20 to $0.30
wma606: raises $0.55 to $0.85
BoggywanKenobi: raises $1.28 to $2.13 and is all-in
Patte6: folds 
gokudousan: folds 
Laker_Style: raises $5.41 to $7.54
father here joins the table at seat #3 
wma606: folds 
Uncalled bet ($5.41) returned to Laker_Style
*** FLOP *** [7s 6c 3h]
*** TURN *** [7s 6c 3h] [9s]
*** RIVER *** [7s 6c 3h 9s] [5s]
*** SHOW DOWN ***
Laker_Style: shows [Jh Jc] (a pair of Jacks)
BoggywanKenobi: shows [6d 6s] (three of a kind, Sixes)
BoggywanKenobi collected $5.02 from pot
*** SUMMARY ***
Total pot $5.26 | Rake $0.24 
Board [7s 6c 3h 9s 5s]
Seat 1: BoggywanKenobi (button) showed [6d 6s] and won ($5.02) with three of a kind, Sixes
Seat 2: Patte6 (small blind) folded before Flop
Seat 4: gokudousan (big blind) folded before Flop
Seat 5: Laker_Style showed [Jh Jc] and lost with a pair of Jacks
Seat 6: wma606 folded before Flop



PokerStars Hand #222948108507:  Hold'em No Limit ($0.05/$0.10 USD) - 2021/01/23 3:53:22 ET
Table 'Linzia' 6-max Seat #2 is the button
Seat 1: BoggywanKenobi ($5.02 in chips) 
Seat 2: Patte6 ($13.68 in chips) 
Seat 4: gokudousan ($18.80 in chips) 
Seat 5: Laker_Style ($16.75 in chips) 
Seat 6: wma606 ($5.45 in chips) 
gokudousan: posts small blind $0.05
Laker_Style: posts big blind $0.10
*** HOLE CARDS ***
wma606: folds 
BoggywanKenobi: calls $0.10
Patte6: folds 
gokudousan: raises $0.20 to $0.30
Laker_Style: folds 
BoggywanKenobi: calls $0.20
*** FLOP *** [6s Qd 2s]
gokudousan: checks 
BoggywanKenobi: checks 
*** TURN *** [6s Qd 2s] [Kd]
gokudousan: checks 
BoggywanKenobi: checks 
*** RIVER *** [6s Qd 2s Kd] [9c]
gokudousan: checks 
BoggywanKenobi: bets $0.60
gokudousan: folds 
Uncalled bet ($0.60) returned to BoggywanKenobi
BoggywanKenobi collected $0.67 from pot
BoggywanKenobi: doesn't show hand 
*** SUMMARY ***
Total pot $0.70 | Rake $0.03 
Board [6s Qd 2s Kd 9c]
Seat 1: BoggywanKenobi collected ($0.67)
Seat 2: Patte6 (button) folded before Flop (didn't bet)
Seat 4: gokudousan (small blind) folded on the River
Seat 5: Laker_Style (big blind) folded before Flop
Seat 6: wma606 folded before Flop (didn't bet)



PokerStars Hand #222948121308:  Hold'em No Limit ($0.05/$0.10 USD) - 2021/01/23 3:54:14 ET
Table 'Linzia' 6-max Seat #4 is the button
Seat 1: BoggywanKenobi ($5.39 in chips) 
Seat 2: Patte6 ($13.68 in chips) 
Seat 4: gokudousan ($18.50 in chips) 
Seat 5: Laker_Style ($16.65 in chips) 
Seat 6: wma606 ($5.45 in chips) 
Laker_Style: posts small blind $0.05
wma606: posts big blind $0.10
father here: sits out 
*** HOLE CARDS ***
BoggywanKenobi: folds 
Patte6: folds 
gokudousan: folds 
Laker_Style: raises $0.20 to $0.30
wma606: calls $0.20
*** FLOP *** [5s Ad Qh]
Laker_Style: bets $0.40
wma606: calls $0.40
*** TURN *** [5s Ad Qh] [4d]
Laker_Style: bets $1.01
wma606: folds 
Uncalled bet ($1.01) returned to Laker_Style
Laker_Style collected $1.34 from pot
Laker_Style: doesn't show hand 
*** SUMMARY ***
Total pot $1.40 | Rake $0.06 
Board [5s Ad Qh 4d]
Seat 1: BoggywanKenobi folded before Flop (didn't bet)
Seat 2: Patte6 folded before Flop (didn't bet)
Seat 4: gokudousan (button) folded before Flop (didn't bet)
Seat 5: Laker_Style (small blind) collected ($1.34)
Seat 6: wma606 (big blind) folded on the Turn



PokerStars Hand #222948136556:  Hold'em No Limit ($0.05/$0.10 USD) - 2021/01/23 3:55:18 ET
Table 'Linzia' 6-max Seat #5 is the button
Seat 1: BoggywanKenobi ($5.39 in chips) 
Seat 2: Patte6 ($13.68 in chips) 
Seat 4: gokudousan ($18.50 in chips) 
Seat 5: Laker_Style ($17.29 in chips) 
Seat 6: wma606 ($4.75 in chips) 
wma606: posts small blind $0.05
BoggywanKenobi: posts big blind $0.10
father here: sits out 
*** HOLE CARDS ***
Patte6: folds 
gokudousan: folds 
Laker_Style: raises $0.15 to $0.25
wma606: folds 
BoggywanKenobi: folds 
Uncalled bet ($0.15) returned to Laker_Style
Laker_Style collected $0.25 from pot
Laker_Style: doesn't show hand 
*** SUMMARY ***
Total pot $0.25 | Rake $0 
Seat 1: BoggywanKenobi (big blind) folded before Flop
Seat 2: Patte6 folded before Flop (didn't bet)
Seat 4: gokudousan folded before Flop (didn't bet)
Seat 5: Laker_Style (button) collected ($0.25)
Seat 6: wma606 (small blind) folded before Flop



PokerStars Hand #222948139325:  Hold'em No Limit ($0.05/$0.10 USD) - 2021/01/23 3:55:32 ET
Table 'Linzia' 6-max Seat #6 is the button
Seat 1: BoggywanKenobi ($5.29 in chips) 
Seat 2: Patte6 ($13.68 in chips) 
Seat 4: gokudousan ($18.50 in chips) 
Seat 5: Laker_Style ($17.44 in chips) 
Seat 6: wma606 ($4.70 in chips) 
BoggywanKenobi: posts small blind $0.05
Patte6: posts big blind $0.10
father here: sits out 
*** HOLE CARDS ***
gokudousan: folds 
Laker_Style: folds 
wma606: raises $0.18 to $0.28
BoggywanKenobi: folds 
Patte6: folds 
Uncalled bet ($0.18) returned to wma606
wma606 collected $0.25 from pot
wma606: doesn't show hand 
*** SUMMARY ***
Total pot $0.25 | Rake $0 
Seat 1: BoggywanKenobi (small blind) folded before Flop
Seat 2: Patte6 (big blind) folded before Flop
Seat 4: gokudousan folded before Flop (didn't bet)
Seat 5: Laker_Style folded before Flop (didn't bet)
Seat 6: wma606 (button) collected ($0.25)



PokerStars Hand #222948141606:  Hold'em No Limit ($0.05/$0.10 USD) - 2021/01/23 3:55:43 ET
Table 'Linzia' 6-max Seat #1 is the button
Seat 1: BoggywanKenobi ($5.24 in chips) 
Seat 2: Patte6 ($13.58 in chips) 
Seat 3: father here ($10 in chips) 
Seat 4: gokudousan ($18.50 in chips) 
Seat 5: Laker_Style ($17.44 in chips) 
Seat 6: wma606 ($4.85 in chips) 
Patte6: posts small blind $0.05
father here: posts big blind $0.10
*** HOLE CARDS ***
gokudousan: folds 
Laker_Style: folds 
wma606: folds 
BoggywanKenobi: calls $0.10
Patte6: folds 
father here: checks 
*** FLOP *** [Ah 8c Th]
father here: checks 
BoggywanKenobi: checks 
*** TURN *** [Ah 8c Th] [5c]
father here: bets $0.24
BoggywanKenobi: folds 
Uncalled bet ($0.24) returned to father here
father here collected $0.24 from pot
*** SUMMARY ***
Total pot $0.25 | Rake $0.01 
Board [Ah 8c Th 5c]
Seat 1: BoggywanKenobi (button) folded on the Turn
Seat 2: Patte6 (small blind) folded before Flop
Seat 3: father here (big blind) collected ($0.24)
Seat 4: gokudousan folded before Flop (didn't bet)
Seat 5: Laker_Style folded before Flop (didn't bet)
Seat 6: wma606 folded before Flop (didn't bet)



PokerStars Hand #222948146987:  Hold'em No Limit ($0.05/$0.10 USD) - 2021/01/23 3:56:09 ET
Table 'Linzia' 6-max Seat #2 is the button
Seat 1: BoggywanKenobi ($5.14 in chips) 
Seat 2: Patte6 ($13.53 in chips) 
Seat 3: father here ($10.14 in chips) 
Seat 4: gokudousan ($18.50 in chips) 
Seat 5: Laker_Style ($17.44 in chips) 
Seat 6: wma606 ($4.85 in chips) 
father here: posts small blind $0.05
gokudousan: posts big blind $0.10
*** HOLE CARDS ***
Laker_Style: folds 
wma606: raises $0.18 to $0.28
BoggywanKenobi: calls $0.28
Patte6: folds 
father here: raises $0.94 to $1.22
gokudousan: folds 
wma606: folds 
BoggywanKenobi: folds 
Uncalled bet ($0.94) returned to father here
father here collected $0.94 from pot
*** SUMMARY ***
Total pot $0.94 | Rake $0 
Seat 1: BoggywanKenobi folded before Flop
Seat 2: Patte6 (button) folded before Flop (didn't bet)
Seat 3: father here (small blind) collected ($0.94)
Seat 4: gokudousan (big blind) folded before Flop
Seat 5: Laker_Style folded before Flop (didn't bet)
Seat 6: wma606 folded before Flop



PokerStars Hand #222948153710:  Hold'em No Limit ($0.05/$0.10 USD) - 2021/01/23 3:56:42 ET
Table 'Linzia' 6-max Seat #3 is the button
Seat 1: BoggywanKenobi ($4.86 in chips) 
Seat 2: Patte6 ($13.53 in chips) 
Seat 3: father here ($10.80 in chips) 
Seat 4: gokudousan ($18.40 in chips) 
Seat 5: Laker_Style ($17.44 in chips) 
Seat 6: wma606 ($4.57 in chips) 
gokudousan: posts small blind $0.05
Laker_Style: posts big blind $0.10
*** HOLE CARDS ***
wma606: folds 
BoggywanKenobi: calls $0.10
Patte6: raises $0.16 to $0.26
father here: folds 
gokudousan: folds 
Laker_Style: folds 
BoggywanKenobi: calls $0.16
*** FLOP *** [Ks 9c 7d]
BoggywanKenobi: checks 
Patte6: checks 
*** TURN *** [Ks 9c 7d] [8h]
BoggywanKenobi: bets $0.30
Patte6: folds 
Uncalled bet ($0.30) returned to BoggywanKenobi
BoggywanKenobi collected $0.64 from pot
BoggywanKenobi: doesn't show hand 
*** SUMMARY ***
Total pot $0.67 | Rake $0.03 
Board [Ks 9c 7d 8h]
Seat 1: BoggywanKenobi collected ($0.64)
Seat 2: Patte6 folded on the Turn
Seat 3: father here (button) folded before Flop (didn't bet)
Seat 4: gokudousan (small blind) folded before Flop
Seat 5: Laker_Style (big blind) folded before Flop
Seat 6: wma606 folded before Flop (didn't bet)



PokerStars Hand #222948160100:  Hold'em No Limit ($0.05/$0.10 USD) - 2021/01/23 3:57:12 ET
Table 'Linzia' 6-max Seat #4 is the button
Seat 1: BoggywanKenobi ($5.24 in chips) 
Seat 2: Patte6 ($13.27 in chips) 
Seat 3: father here ($10.80 in chips) 
Seat 4: gokudousan ($18.35 in chips) 
Seat 5: Laker_Style ($17.34 in chips) 
Seat 6: wma606 ($4.57 in chips) 
Laker_Style: posts small blind $0.05
wma606: posts big blind $0.10
*** HOLE CARDS ***
BoggywanKenobi: calls $0.10
Patte6: raises $0.20 to $0.30
father here: folds 
gokudousan: folds 
Laker_Style: folds 
wma606: calls $0.20
BoggywanKenobi: calls $0.20
*** FLOP *** [3s 4d 6s]
wma606: checks 
BoggywanKenobi: checks 
Patte6: bets $0.25
wma606: raises $0.55 to $0.80
BoggywanKenobi: folds 
Patte6: calls $0.55
*** TURN *** [3s 4d 6s] [9s]
wma606: checks 
Patte6: checks 
*** RIVER *** [3s 4d 6s 9s] [7s]
wma606: bets $1
Patte6: folds 
Uncalled bet ($1) returned to wma606
wma606 collected $2.44 from pot
wma606: doesn't show hand 
*** SUMMARY ***
Total pot $2.55 | Rake $0.11 
Board [3s 4d 6s 9s 7s]
Seat 1: BoggywanKenobi folded on the Flop
Seat 2: Patte6 folded on the River
Seat 3: father here folded before Flop (didn't bet)
Seat 4: gokudousan (button) folded before Flop (didn't bet)
Seat 5: Laker_Style (small blind) folded before Flop
Seat 6: wma606 (big blind) collected ($2.44)



PokerStars Hand #222948173455:  Hold'em No Limit ($0.05/$0.10 USD) - 2021/01/23 3:58:16 ET
Table 'Linzia' 6-max Seat #5 is the button
Seat 1: BoggywanKenobi ($4.94 in chips) 
Seat 2: Patte6 ($12.17 in chips) 
Seat 3: father here ($10.80 in chips) 
Seat 4: gokudousan ($18.35 in chips) 
Seat 5: Laker_Style ($17.29 in chips) 
Seat 6: wma606 ($5.91 in chips) 
wma606: posts small blind $0.05
BoggywanKenobi: posts big blind $0.10
*** HOLE CARDS ***
Patte6: folds 
father here: folds 
gokudousan: raises $0.20 to $0.30
Laker_Style: folds 
wma606: folds 
BoggywanKenobi: calls $0.20
*** FLOP *** [2d 9c Th]
BoggywanKenobi: checks 
gokudousan: bets $0.30
BoggywanKenobi: calls $0.30
*** TURN *** [2d 9c Th] [Kh]
BoggywanKenobi: checks 
gokudousan: checks 
*** RIVER *** [2d 9c Th Kh] [Ts]
BoggywanKenobi: bets $0.60
gokudousan: calls $0.60
*** SHOW DOWN ***
BoggywanKenobi: shows [Qd Jh] (a straight, Nine to King)
gokudousan: mucks hand 
BoggywanKenobi collected $2.34 from pot
*** SUMMARY ***
Total pot $2.45 | Rake $0.11 
Board [2d 9c Th Kh Ts]
Seat 1: BoggywanKenobi (big blind) showed [Qd Jh] and won ($2.34) with a straight, Nine to King
Seat 2: Patte6 folded before Flop (didn't bet)
Seat 3: father here folded before Flop (didn't bet)
Seat 4: gokudousan mucked
Seat 5: Laker_Style (button) folded before Flop (didn't bet)
Seat 6: wma606 (small blind) folded before Flop



PokerStars Hand #222948186964:  Hold'em No Limit ($0.05/$0.10 USD) - 2021/01/23 3:59:19 ET
Table 'Linzia' 6-max Seat #6 is the button
Seat 1: BoggywanKenobi ($6.08 in chips) 
Seat 2: Patte6 ($12.17 in chips) 
Seat 3: father here ($10.80 in chips) 
Seat 4: gokudousan ($17.15 in chips) 
Seat 5: Laker_Style ($17.29 in chips) 
Seat 6: wma606 ($5.86 in chips) 
BoggywanKenobi: posts small blind $0.05
Patte6: posts big blind $0.10
*** HOLE CARDS ***
father here: folds 
gokudousan: folds 
Laker_Style: raises $0.20 to $0.30
wma606: folds 
BoggywanKenobi: calls $0.25
Patte6: folds 
*** FLOP *** [9s Qc 5c]
BoggywanKenobi: checks 
Laker_Style: checks 
*** TURN *** [9s Qc 5c] [6c]
BoggywanKenobi: bets $0.34
Laker_Style: calls $0.34
*** RIVER *** [9s Qc 5c 6c] [9d]
BoggywanKenobi: checks 
Laker_Style: bets $0.45
BoggywanKenobi: folds 
Uncalled bet ($0.45) returned to Laker_Style
Laker_Style collected $1.32 from pot
Laker_Style: doesn't show hand 
*** SUMMARY ***
Total pot $1.38 | Rake $0.06 
Board [9s Qc 5c 6c 9d]
Seat 1: BoggywanKenobi (small blind) folded on the River
Seat 2: Patte6 (big blind) folded before Flop
Seat 3: father here folded before Flop (didn't bet)
Seat 4: gokudousan folded before Flop (didn't bet)
Seat 5: Laker_Style collected ($1.32)
Seat 6: wma606 (button) folded before Flop (didn't bet)



PokerStars Hand #222948202218:  Hold'em No Limit ($0.05/$0.10 USD) - 2021/01/23 4:00:29 ET
Table 'Linzia' 6-max Seat #1 is the button
Seat 1: BoggywanKenobi ($5.44 in chips) 
Seat 2: Patte6 ($12.07 in chips) 
Seat 4: gokudousan ($17.15 in chips) 
Seat 5: Laker_Style ($17.97 in chips) 
Seat 6: wma606 ($5.86 in chips) 
Patte6: posts small blind $0.05
father here: is sitting out 
gokudousan: posts big blind $0.10
*** HOLE CARDS ***
Laker_Style: folds 
wma606: folds 
BoggywanKenobi: calls $0.10
Patte6: folds 
gokudousan: raises $0.20 to $0.30
BoggywanKenobi: folds 
Uncalled bet ($0.20) returned to gokudousan
gokudousan collected $0.25 from pot
gokudousan: doesn't show hand 
*** SUMMARY ***
Total pot $0.25 | Rake $0 
Seat 1: BoggywanKenobi (button) folded before Flop
Seat 2: Patte6 (small blind) folded before Flop
Seat 4: gokudousan (big blind) collected ($0.25)
Seat 5: Laker_Style folded before Flop (didn't bet)
Seat 6: wma606 folded before Flop (didn't bet)



PokerStars Hand #222948206416:  Hold'em No Limit ($0.05/$0.10 USD) - 2021/01/23 4:00:46 ET
Table 'Linzia' 6-max Seat #2 is the button
Seat 1: BoggywanKenobi ($5.34 in chips) 
Seat 2: Patte6 ($12.02 in chips) 
Seat 4: gokudousan ($17.30 in chips) 
Seat 5: Laker_Style ($17.97 in chips) 
Seat 6: wma606 ($5.86 in chips) 
gokudousan: posts small blind $0.05
Laker_Style: posts big blind $0.10
*** HOLE CARDS ***
wma606: folds 
BoggywanKenobi: calls $0.10
father here leaves the table
Patte6: folds 
gokudousan: folds 
Bannnkai joins the table at seat #3 
Laker_Style: checks 
*** FLOP *** [Kc Th Ks]
Laker_Style: checks 
BoggywanKenobi: checks 
*** TURN *** [Kc Th Ks] [3c]
Laker_Style: checks 
BoggywanKenobi: bets $0.24
Laker_Style: calls $0.24
*** RIVER *** [Kc Th Ks 3c] [4s]
Laker_Style: checks 
BoggywanKenobi: checks 
*** SHOW DOWN ***
Laker_Style: shows [4d Td] (two pair, Kings and Tens)
BoggywanKenobi: mucks hand 
Laker_Style collected $0.70 from pot
*** SUMMARY ***
Total pot $0.73 | Rake $0.03 
Board [Kc Th Ks 3c 4s]
Seat 1: BoggywanKenobi mucked
Seat 2: Patte6 (button) folded before Flop (didn't bet)
Seat 4: gokudousan (small blind) folded before Flop
Seat 5: Laker_Style (big blind) showed [4d Td] and won ($0.70) with two pair, Kings and Tens
Seat 6: wma606 folded before Flop (didn't bet)



PokerStars Hand #222948227075:  Hold'em No Limit ($0.05/$0.10 USD) - 2021/01/23 4:02:09 ET
Table 'Linzia' 6-max Seat #4 is the button
Seat 1: BoggywanKenobi ($5 in chips) 
Seat 2: Patte6 ($12.02 in chips) 
Seat 4: gokudousan ($17.25 in chips) 
Seat 5: Laker_Style ($18.33 in chips) 
Seat 6: wma606 ($5.86 in chips) 
Laker_Style: posts small blind $0.05
wma606: posts big blind $0.10
Bannnkai: sits out 
*** HOLE CARDS ***
BoggywanKenobi: calls $0.10
Patte6: folds 
gokudousan: folds 
Laker_Style: raises $0.40 to $0.50
wma606: folds 
BoggywanKenobi: folds 
Uncalled bet ($0.40) returned to Laker_Style
Laker_Style collected $0.30 from pot
Laker_Style: doesn't show hand 
*** SUMMARY ***
Total pot $0.30 | Rake $0 
Seat 1: BoggywanKenobi folded before Flop
Seat 2: Patte6 folded before Flop (didn't bet)
Seat 4: gokudousan (button) folded before Flop (didn't bet)
Seat 5: Laker_Style (small blind) collected ($0.30)
Seat 6: wma606 (big blind) folded before Flop



PokerStars Hand #222948231063:  Hold'em No Limit ($0.05/$0.10 USD) - 2021/01/23 4:02:25 ET
Table 'Linzia' 6-max Seat #5 is the button
Seat 1: BoggywanKenobi ($4.90 in chips) 
Seat 2: Patte6 ($12.02 in chips) 
Seat 4: gokudousan ($17.25 in chips) 
Seat 5: Laker_Style ($18.53 in chips) 
Seat 6: wma606 ($5.76 in chips) 
wma606: posts small blind $0.05
BoggywanKenobi: posts big blind $0.10
Bannnkai: sits out 
*** HOLE CARDS ***
Patte6: folds 
gokudousan: folds 
Laker_Style: folds 
wma606: folds 
Uncalled bet ($0.05) returned to BoggywanKenobi
BoggywanKenobi collected $0.10 from pot
BoggywanKenobi: doesn't show hand 
*** SUMMARY ***
Total pot $0.10 | Rake $0 
Seat 1: BoggywanKenobi (big blind) collected ($0.10)
Seat 2: Patte6 folded before Flop (didn't bet)
Seat 4: gokudousan folded before Flop (didn't bet)
Seat 5: Laker_Style (button) folded before Flop (didn't bet)
Seat 6: wma606 (small blind) folded before Flop



PokerStars Hand #222948234139:  Hold'em No Limit ($0.05/$0.10 USD) - 2021/01/23 4:02:38 ET
Table 'Linzia' 6-max Seat #6 is the button
Seat 1: BoggywanKenobi ($4.95 in chips) 
Seat 2: Patte6 ($12.02 in chips) 
Seat 4: gokudousan ($17.25 in chips) 
Seat 5: Laker_Style ($18.53 in chips) 
Seat 6: wma606 ($5.71 in chips) 
BoggywanKenobi: posts small blind $0.05
Patte6: posts big blind $0.10
Bannnkai: sits out 
*** HOLE CARDS ***
gokudousan: folds 
Laker_Style: folds 
wma606: folds 
BoggywanKenobi: calls $0.05
Patte6: checks 
*** FLOP *** [Qc Kd 8s]
BoggywanKenobi: checks 
Patte6: checks 
*** TURN *** [Qc Kd 8s] [As]
BoggywanKenobi: checks 
Patte6: bets $0.10
BoggywanKenobi: calls $0.10
*** RIVER *** [Qc Kd 8s As] [9d]
BoggywanKenobi: checks 
Patte6: checks 
*** SHOW DOWN ***
BoggywanKenobi: shows [7c Tc] (high card Ace)
Patte6: mucks hand 
BoggywanKenobi collected $0.38 from pot
*** SUMMARY ***
Total pot $0.40 | Rake $0.02 
Board [Qc Kd 8s As 9d]
Seat 1: BoggywanKenobi (small blind) showed [7c Tc] and won ($0.38) with high card Ace
Seat 2: Patte6 (big blind) mucked
Seat 4: gokudousan folded before Flop (didn't bet)
Seat 5: Laker_Style folded before Flop (didn't bet)
Seat 6: wma606 (button) folded before Flop (didn't bet)



PokerStars Hand #222948240212:  Hold'em No Limit ($0.05/$0.10 USD) - 2021/01/23 4:03:02 ET
Table 'Linzia' 6-max Seat #1 is the button
Seat 1: BoggywanKenobi ($5.13 in chips) 
Seat 2: Patte6 ($11.82 in chips) 
Seat 3: Bannnkai ($10 in chips) 
Seat 4: gokudousan ($17.25 in chips) 
Seat 5: Laker_Style ($18.53 in chips) 
Seat 6: wma606 ($5.71 in chips) 
Patte6: posts small blind $0.05
Bannnkai: posts big blind $0.10
*** HOLE CARDS ***
gokudousan: raises $0.20 to $0.30
Laker_Style: folds 
wma606: folds 
BoggywanKenobi: folds 
Patte6: folds 
Bannnkai: folds 
Uncalled bet ($0.20) returned to gokudousan
gokudousan collected $0.25 from pot
gokudousan: doesn't show hand 
*** SUMMARY ***
Total pot $0.25 | Rake $0 
Seat 1: BoggywanKenobi (button) folded before Flop (didn't bet)
Seat 2: Patte6 (small blind) folded before Flop
Seat 3: Bannnkai (big blind) folded before Flop
Seat 4: gokudousan collected ($0.25)
Seat 5: Laker_Style folded before Flop (didn't bet)
Seat 6: wma606 folded before Flop (didn't bet)



PokerStars Hand #222948245005:  Hold'em No Limit ($0.05/$0.10 USD) - 2021/01/23 4:03:20 ET
Table 'Linzia' 6-max Seat #2 is the button
Seat 1: BoggywanKenobi ($5.13 in chips) 
Seat 2: Patte6 ($11.77 in chips) 
Seat 3: Bannnkai ($10 in chips) 
Seat 4: gokudousan ($17.40 in chips) 
Seat 5: Laker_Style ($18.53 in chips) 
Seat 6: wma606 ($5.71 in chips) 
Bannnkai: posts small blind $0.05
gokudousan: posts big blind $0.10
*** HOLE CARDS ***
Laker_Style: raises $0.20 to $0.30
wma606: folds 
BoggywanKenobi: folds 
Patte6: folds 
Bannnkai: folds 
gokudousan: folds 
Uncalled bet ($0.20) returned to Laker_Style
Laker_Style collected $0.25 from pot
Laker_Style: doesn't show hand 
*** SUMMARY ***
Total pot $0.25 | Rake $0 
Seat 1: BoggywanKenobi folded before Flop (didn't bet)
Seat 2: Patte6 (button) folded before Flop (didn't bet)
Seat 3: Bannnkai (small blind) folded before Flop
Seat 4: gokudousan (big blind) folded before Flop
Seat 5: Laker_Style collected ($0.25)
Seat 6: wma606 folded before Flop (didn't bet)



PokerStars Hand #222948249597:  Hold'em No Limit ($0.05/$0.10 USD) - 2021/01/23 4:03:38 ET
Table 'Linzia' 6-max Seat #3 is the button
Seat 1: BoggywanKenobi ($5.13 in chips) 
Seat 2: Patte6 ($11.77 in chips) 
Seat 3: Bannnkai ($10 in chips) 
Seat 4: gokudousan ($17.30 in chips) 
Seat 5: Laker_Style ($18.68 in chips) 
Seat 6: wma606 ($5.71 in chips) 
gokudousan: posts small blind $0.05
Laker_Style: posts big blind $0.10
*** HOLE CARDS ***
wma606: folds 
BoggywanKenobi: calls $0.10
Patte6: raises $0.40 to $0.50
Bannnkai: folds 
gokudousan: folds 
Laker_Style: folds 
BoggywanKenobi: calls $0.40
*** FLOP *** [Qs 6h Th]
BoggywanKenobi: checks 
Patte6: bets $0.25
BoggywanKenobi: folds 
Uncalled bet ($0.25) returned to Patte6
Patte6 collected $1.10 from pot
Patte6: doesn't show hand 
*** SUMMARY ***
Total pot $1.15 | Rake $0.05 
Board [Qs 6h Th]
Seat 1: BoggywanKenobi folded on the Flop
Seat 2: Patte6 collected ($1.10)
Seat 3: Bannnkai (button) folded before Flop (didn't bet)
Seat 4: gokudousan (small blind) folded before Flop
Seat 5: Laker_Style (big blind) folded before Flop
Seat 6: wma606 folded before Flop (didn't bet)



PokerStars Hand #222948255758:  Hold'em No Limit ($0.05/$0.10 USD) - 2021/01/23 4:04:03 ET
Table 'Linzia' 6-max Seat #4 is the button
Seat 1: BoggywanKenobi ($4.63 in chips) 
Seat 2: Patte6 ($12.37 in chips) 
Seat 3: Bannnkai ($10 in chips) 
Seat 4: gokudousan ($17.25 in chips) 
Seat 5: Laker_Style ($18.58 in chips) 
Seat 6: wma606 ($5.71 in chips) 
Laker_Style: posts small blind $0.05
wma606: posts big blind $0.10
*** HOLE CARDS ***
BoggywanKenobi: calls $0.10
Patte6: raises $0.40 to $0.50
Bannnkai: folds 
gokudousan: folds 
Laker_Style: folds 
wma606: folds 
BoggywanKenobi: calls $0.40
*** FLOP *** [Ah 3s Tc]
BoggywanKenobi: checks 
Patte6: bets $0.30
BoggywanKenobi: calls $0.30
*** TURN *** [Ah 3s Tc] [Ts]
BoggywanKenobi: checks 
Patte6: checks 
*** RIVER *** [Ah 3s Tc Ts] [7d]
BoggywanKenobi: bets $1.67
Patte6: folds 
Uncalled bet ($1.67) returned to BoggywanKenobi
BoggywanKenobi collected $1.67 from pot
BoggywanKenobi: doesn't show hand 
*** SUMMARY ***
Total pot $1.75 | Rake $0.08 
Board [Ah 3s Tc Ts 7d]
Seat 1: BoggywanKenobi collected ($1.67)
Seat 2: Patte6 folded on the River
Seat 3: Bannnkai folded before Flop (didn't bet)
Seat 4: gokudousan (button) folded before Flop (didn't bet)
Seat 5: Laker_Style (small blind) folded before Flop
Seat 6: wma606 (big blind) folded before Flop



PokerStars Hand #222948264986:  Hold'em No Limit ($0.05/$0.10 USD) - 2021/01/23 4:04:39 ET
Table 'Linzia' 6-max Seat #5 is the button
Seat 1: BoggywanKenobi ($5.50 in chips) 
Seat 2: Patte6 ($11.57 in chips) 
Seat 3: Bannnkai ($10 in chips) 
Seat 4: gokudousan ($17.25 in chips) 
Seat 5: Laker_Style ($18.53 in chips) 
Seat 6: wma606 ($5.61 in chips) 
wma606: posts small blind $0.05
BoggywanKenobi: posts big blind $0.10
*** HOLE CARDS ***
Patte6: folds 
Bannnkai: folds 
gokudousan: raises $0.20 to $0.30
Laker_Style: folds 
wma606: folds 
BoggywanKenobi: folds 
Uncalled bet ($0.20) returned to gokudousan
gokudousan collected $0.25 from pot
gokudousan: doesn't show hand 
*** SUMMARY ***
Total pot $0.25 | Rake $0 
Seat 1: BoggywanKenobi (big blind) folded before Flop
Seat 2: Patte6 folded before Flop (didn't bet)
Seat 3: Bannnkai folded before Flop (didn't bet)
Seat 4: gokudousan collected ($0.25)
Seat 5: Laker_Style (button) folded before Flop (didn't bet)
Seat 6: wma606 (small blind) folded before Flop



PokerStars Hand #222948270885:  Hold'em No Limit ($0.05/$0.10 USD) - 2021/01/23 4:05:02 ET
Table 'Linzia' 6-max Seat #6 is the button
Seat 1: BoggywanKenobi ($5.40 in chips) 
Seat 2: Patte6 ($11.57 in chips) 
Seat 3: Bannnkai ($10 in chips) 
Seat 4: gokudousan ($17.40 in chips) 
Seat 5: Laker_Style ($18.53 in chips) 
Seat 6: wma606 ($5.56 in chips) 
BoggywanKenobi: posts small blind $0.05
Patte6: posts big blind $0.10
*** HOLE CARDS ***
Bannnkai: folds 
gokudousan: folds 
Laker_Style: raises $0.20 to $0.30
wma606: folds 
BoggywanKenobi: folds 
Patte6: folds 
Uncalled bet ($0.20) returned to Laker_Style
Laker_Style collected $0.25 from pot
Laker_Style: doesn't show hand 
*** SUMMARY ***
Total pot $0.25 | Rake $0 
Seat 1: BoggywanKenobi (small blind) folded before Flop
Seat 2: Patte6 (big blind) folded before Flop
Seat 3: Bannnkai folded before Flop (didn't bet)
Seat 4: gokudousan folded before Flop (didn't bet)
Seat 5: Laker_Style collected ($0.25)
Seat 6: wma606 (button) folded before Flop (didn't bet)



PokerStars Hand #222948276854:  Hold'em No Limit ($0.05/$0.10 USD) - 2021/01/23 4:05:25 ET
Table 'Linzia' 6-max Seat #1 is the button
Seat 1: BoggywanKenobi ($5.35 in chips) 
Seat 2: Patte6 ($11.47 in chips) 
Seat 3: Bannnkai ($10 in chips) 
Seat 4: gokudousan ($17.40 in chips) 
Seat 5: Laker_Style ($18.68 in chips) 
Seat 6: wma606 ($5.56 in chips) 
Patte6: posts small blind $0.05
Bannnkai: posts big blind $0.10
*** HOLE CARDS ***
gokudousan: folds 
Laker_Style: folds 
wma606: folds 
BoggywanKenobi: calls $0.10
Patte6: folds 
Bannnkai: raises $0.40 to $0.50
BoggywanKenobi: folds 
Uncalled bet ($0.40) returned to Bannnkai
Bannnkai collected $0.25 from pot
Bannnkai: doesn't show hand 
*** SUMMARY ***
Total pot $0.25 | Rake $0 
Seat 1: BoggywanKenobi (button) folded before Flop
Seat 2: Patte6 (small blind) folded before Flop
Seat 3: Bannnkai (big blind) collected ($0.25)
Seat 4: gokudousan folded before Flop (didn't bet)
Seat 5: Laker_Style folded before Flop (didn't bet)
Seat 6: wma606 folded before Flop (didn't bet)



PokerStars Hand #222948281065:  Hold'em No Limit ($0.05/$0.10 USD) - 2021/01/23 4:05:42 ET
Table 'Linzia' 6-max Seat #2 is the button
Seat 1: BoggywanKenobi ($5.25 in chips) 
Seat 2: Patte6 ($11.42 in chips) 
Seat 3: Bannnkai ($10.15 in chips) 
Seat 4: gokudousan ($17.40 in chips) 
Seat 5: Laker_Style ($18.68 in chips) 
Seat 6: wma606 ($5.56 in chips) 
Bannnkai: posts small blind $0.05
gokudousan: posts big blind $0.10
*** HOLE CARDS ***
Laker_Style: folds 
wma606: raises $0.18 to $0.28
BoggywanKenobi: calls $0.28
Patte6: folds 
Bannnkai: folds 
gokudousan: folds 
*** FLOP *** [3c 8h 3h]
wma606: bets $0.48
BoggywanKenobi: folds 
Uncalled bet ($0.48) returned to wma606
wma606 collected $0.68 from pot
wma606: doesn't show hand 
*** SUMMARY ***
Total pot $0.71 | Rake $0.03 
Board [3c 8h 3h]
Seat 1: BoggywanKenobi folded on the Flop
Seat 2: Patte6 (button) folded before Flop (didn't bet)
Seat 3: Bannnkai (small blind) folded before Flop
Seat 4: gokudousan (big blind) folded before Flop
Seat 5: Laker_Style folded before Flop (didn't bet)
Seat 6: wma606 collected ($0.68)



PokerStars Hand #222948289393:  Hold'em No Limit ($0.05/$0.10 USD) - 2021/01/23 4:06:15 ET
Table 'Linzia' 6-max Seat #3 is the button
Seat 1: BoggywanKenobi ($4.97 in chips) 
Seat 2: Patte6 ($11.42 in chips) 
Seat 3: Bannnkai ($10.10 in chips) 
Seat 4: gokudousan ($17.30 in chips) 
Seat 5: Laker_Style ($18.68 in chips) 
Seat 6: wma606 ($5.96 in chips) 
gokudousan: posts small blind $0.05
Laker_Style: posts big blind $0.10
*** HOLE CARDS ***
wma606: folds 
BoggywanKenobi: calls $0.10
Patte6: folds 
Bannnkai: folds 
gokudousan: folds 
Laker_Style: checks 
*** FLOP *** [5c 2d 9s]
Laker_Style: checks 
BoggywanKenobi: checks 
*** TURN *** [5c 2d 9s] [Qd]
Laker_Style: checks 
BoggywanKenobi: checks 
*** RIVER *** [5c 2d 9s Qd] [8d]
Laker_Style: checks 
BoggywanKenobi: bets $0.24
Laker_Style: folds 
Uncalled bet ($0.24) returned to BoggywanKenobi
BoggywanKenobi collected $0.24 from pot
BoggywanKenobi: doesn't show hand 
*** SUMMARY ***
Total pot $0.25 | Rake $0.01 
Board [5c 2d 9s Qd 8d]
Seat 1: BoggywanKenobi collected ($0.24)
Seat 2: Patte6 folded before Flop (didn't bet)
Seat 3: Bannnkai (button) folded before Flop (didn't bet)
Seat 4: gokudousan (small blind) folded before Flop
Seat 5: Laker_Style (big blind) folded on the River
Seat 6: wma606 folded before Flop (didn't bet)



PokerStars Hand #222948305970:  Hold'em No Limit ($0.05/$0.10 USD) - 2021/01/23 4:07:20 ET
Table 'Linzia' 6-max Seat #4 is the button
Seat 1: BoggywanKenobi ($5.11 in chips) 
Seat 2: Patte6 ($11.42 in chips) 
Seat 3: Bannnkai ($10.10 in chips) 
Seat 4: gokudousan ($17.25 in chips) 
Seat 5: Laker_Style ($18.58 in chips) 
Laker_Style: posts small blind $0.05
wma606: is sitting out 
BoggywanKenobi: posts big blind $0.10
*** HOLE CARDS ***
Patte6: raises $0.20 to $0.30
wma606 leaves the table
Bannnkai: folds 
gokudousan: folds 
Laker_Style: folds 
BoggywanKenobi: calls $0.20
*** FLOP *** [5s Jh 7h]
kirankotag joins the table at seat #6 
BoggywanKenobi: checks 
Patte6: bets $0.47
BoggywanKenobi: folds 
Uncalled bet ($0.47) returned to Patte6
Patte6 collected $0.62 from pot
Patte6: doesn't show hand 
*** SUMMARY ***
Total pot $0.65 | Rake $0.03 
Board [5s Jh 7h]
Seat 1: BoggywanKenobi (big blind) folded on the Flop
Seat 2: Patte6 collected ($0.62)
Seat 3: Bannnkai folded before Flop (didn't bet)
Seat 4: gokudousan (button) folded before Flop (didn't bet)
Seat 5: Laker_Style (small blind) folded before Flop



PokerStars Hand #222948311471:  Hold'em No Limit ($0.05/$0.10 USD) - 2021/01/23 4:07:41 ET
Table 'Linzia' 6-max Seat #5 is the button
Seat 1: BoggywanKenobi ($4.81 in chips) 
Seat 2: Patte6 ($11.74 in chips) 
Seat 3: Bannnkai ($10.10 in chips) 
Seat 4: gokudousan ($17.25 in chips) 
Seat 5: Laker_Style ($18.53 in chips) 
BoggywanKenobi: posts small blind $0.05
Patte6: posts big blind $0.10
*** HOLE CARDS ***
Bannnkai: folds 
gokudousan: raises $0.20 to $0.30
Laker_Style: folds 
BoggywanKenobi: folds 
Patte6: folds 
Uncalled bet ($0.20) returned to gokudousan
gokudousan collected $0.25 from pot
gokudousan: doesn't show hand 
*** SUMMARY ***
Total pot $0.25 | Rake $0 
Seat 1: BoggywanKenobi (small blind) folded before Flop
Seat 2: Patte6 (big blind) folded before Flop
Seat 3: Bannnkai folded before Flop (didn't bet)
Seat 4: gokudousan collected ($0.25)
Seat 5: Laker_Style (button) folded before Flop (didn't bet)



PokerStars Hand #222948315828:  Hold'em No Limit ($0.05/$0.10 USD) - 2021/01/23 4:07:58 ET
Table 'Linzia' 6-max Seat #1 is the button
Seat 1: BoggywanKenobi ($4.76 in chips) 
Seat 2: Patte6 ($11.64 in chips) 
Seat 3: Bannnkai ($10.10 in chips) 
Seat 4: gokudousan ($17.40 in chips) 
Seat 5: Laker_Style ($18.53 in chips) 
Patte6: posts small blind $0.05
Bannnkai: posts big blind $0.10
kirankotag: sits out 
*** HOLE CARDS ***
gokudousan: raises $0.20 to $0.30
Laker_Style: folds 
BoggywanKenobi: folds 
Patte6: raises $0.90 to $1.20
Bannnkai: folds 
gokudousan: calls $0.90
*** FLOP *** [Ah 3s 8s]
Patte6: bets $0.84
gokudousan: folds 
Uncalled bet ($0.84) returned to Patte6
Patte6 collected $2.39 from pot
Patte6: doesn't show hand 
*** SUMMARY ***
Total pot $2.50 | Rake $0.11 
Board [Ah 3s 8s]
Seat 1: BoggywanKenobi (button) folded before Flop (didn't bet)
Seat 2: Patte6 (small blind) collected ($2.39)
Seat 3: Bannnkai (big blind) folded before Flop
Seat 4: gokudousan folded on the Flop
Seat 5: Laker_Style folded before Flop (didn't bet)



PokerStars Hand #222948324249:  Hold'em No Limit ($0.05/$0.10 USD) - 2021/01/23 4:08:31 ET
Table 'Linzia' 6-max Seat #2 is the button
Seat 1: BoggywanKenobi ($4.76 in chips) 
Seat 2: Patte6 ($12.83 in chips) 
Seat 3: Bannnkai ($10 in chips) 
Seat 4: gokudousan ($16.20 in chips) 
Seat 5: Laker_Style ($18.53 in chips) 
Bannnkai: posts small blind $0.05
gokudousan: posts big blind $0.10
kirankotag: sits out 
*** HOLE CARDS ***
Laker_Style: folds 
BoggywanKenobi: calls $0.10
Patte6: folds 
Bannnkai: folds 
gokudousan: checks 
*** FLOP *** [7d 6s Ah]
gokudousan: checks 
BoggywanKenobi: checks 
*** TURN *** [7d 6s Ah] [5d]
gokudousan: checks 
BoggywanKenobi: checks 
*** RIVER *** [7d 6s Ah 5d] [As]
gokudousan: checks 
BoggywanKenobi: bets $0.24
gokudousan: raises $0.54 to $0.78
BoggywanKenobi: folds 
Uncalled bet ($0.54) returned to gokudousan
gokudousan collected $0.70 from pot
gokudousan: doesn't show hand 
*** SUMMARY ***
Total pot $0.73 | Rake $0.03 
Board [7d 6s Ah 5d As]
Seat 1: BoggywanKenobi folded on the River
Seat 2: Patte6 (button) folded before Flop (didn't bet)
Seat 3: Bannnkai (small blind) folded before Flop
Seat 4: gokudousan (big blind) collected ($0.70)
Seat 5: Laker_Style folded before Flop (didn't bet)



PokerStars Hand #222948337196:  Hold'em No Limit ($0.05/$0.10 USD) - 2021/01/23 4:09:21 ET
Table 'Linzia' 6-max Seat #3 is the button
Seat 1: BoggywanKenobi ($4.42 in chips) 
Seat 2: Patte6 ($12.83 in chips) 
Seat 3: Bannnkai ($10 in chips) 
Seat 4: gokudousan ($16.56 in chips) 
Seat 6: kirankotag ($8 in chips) 
gokudousan: posts small blind $0.05
Laker_Style: is sitting out 
kirankotag: posts big blind $0.10
*** HOLE CARDS ***
BoggywanKenobi: calls $0.10
Patte6: raises $0.40 to $0.50
Bannnkai: folds 
gokudousan: raises $1.10 to $1.60
kirankotag: folds 
BoggywanKenobi: folds 
Patte6: folds 
Uncalled bet ($1.10) returned to gokudousan
gokudousan collected $1.20 from pot
gokudousan: doesn't show hand 
*** SUMMARY ***
Total pot $1.20 | Rake $0 
Seat 1: BoggywanKenobi folded before Flop
Seat 2: Patte6 folded before Flop
Seat 3: Bannnkai (button) folded before Flop (didn't bet)
Seat 4: gokudousan (small blind) collected ($1.20)
Seat 6: kirankotag (big blind) folded before Flop



PokerStars Hand #222948342779:  Hold'em No Limit ($0.05/$0.10 USD) - 2021/01/23 4:09:42 ET
Table 'Linzia' 6-max Seat #4 is the button
Seat 1: BoggywanKenobi ($4.32 in chips) 
Seat 2: Patte6 ($12.33 in chips) 
Seat 3: Bannnkai ($10 in chips) 
Seat 4: gokudousan ($17.26 in chips) 
Seat 6: kirankotag ($7.90 in chips) 
kirankotag: posts small blind $0.05
BoggywanKenobi: posts big blind $0.10
*** HOLE CARDS ***
Patte6: folds 
Bannnkai: folds 
gokudousan: folds 
kirankotag: folds 
Uncalled bet ($0.05) returned to BoggywanKenobi
BoggywanKenobi collected $0.10 from pot
BoggywanKenobi: doesn't show hand 
*** SUMMARY ***
Total pot $0.10 | Rake $0 
Seat 1: BoggywanKenobi (big blind) collected ($0.10)
Seat 2: Patte6 folded before Flop (didn't bet)
Seat 3: Bannnkai folded before Flop (didn't bet)
Seat 4: gokudousan (button) folded before Flop (didn't bet)
Seat 6: kirankotag (small blind) folded before Flop



PokerStars Hand #222948344784:  Hold'em No Limit ($0.05/$0.10 USD) - 2021/01/23 4:09:50 ET
Table 'Linzia' 6-max Seat #6 is the button
Seat 1: BoggywanKenobi ($4.37 in chips) 
Seat 2: Patte6 ($12.33 in chips) 
Seat 3: Bannnkai ($10 in chips) 
Seat 4: gokudousan ($17.26 in chips) 
Seat 6: kirankotag ($7.85 in chips) 
BoggywanKenobi: posts small blind $0.05
Patte6: posts big blind $0.10
*** HOLE CARDS ***
Bannnkai: folds 
gokudousan: folds 
kirankotag: folds 
BoggywanKenobi: calls $0.05
Patte6: checks 
*** FLOP *** [9h 7d 7h]
BoggywanKenobi: checks 
Patte6: checks 
*** TURN *** [9h 7d 7h] [3s]
BoggywanKenobi: checks 
Patte6: checks 
*** RIVER *** [9h 7d 7h 3s] [8s]
BoggywanKenobi: checks 
Patte6: checks 
*** SHOW DOWN ***
BoggywanKenobi: shows [Qh 2h] (a pair of Sevens)
Patte6: shows [6d Kc] (a pair of Sevens - King kicker)
Patte6 collected $0.19 from pot
*** SUMMARY ***
Total pot $0.20 | Rake $0.01 
Board [9h 7d 7h 3s 8s]
Seat 1: BoggywanKenobi (small blind) showed [Qh 2h] and lost with a pair of Sevens
Seat 2: Patte6 (big blind) showed [6d Kc] and won ($0.19) with a pair of Sevens
Seat 3: Bannnkai folded before Flop (didn't bet)
Seat 4: gokudousan folded before Flop (didn't bet)
Seat 6: kirankotag (button) folded before Flop (didn't bet)



PokerStars Hand #222948351174:  Hold'em No Limit ($0.05/$0.10 USD) - 2021/01/23 4:10:15 ET
Table 'Linzia' 6-max Seat #1 is the button
Seat 1: BoggywanKenobi ($4.27 in chips) 
Seat 2: Patte6 ($12.42 in chips) 
Seat 3: Bannnkai ($10 in chips) 
Seat 4: gokudousan ($17.26 in chips) 
Seat 6: kirankotag ($7.85 in chips) 
Patte6: posts small blind $0.05
Bannnkai: posts big blind $0.10
*** HOLE CARDS ***
gokudousan: folds 
kirankotag: folds 
BoggywanKenobi: calls $0.10
Patte6: calls $0.05
Bannnkai: checks 
*** FLOP *** [5h Qc 5s]
Patte6: checks 
Bannnkai: checks 
BoggywanKenobi: checks 
*** TURN *** [5h Qc 5s] [8d]
Patte6: checks 
Bannnkai: bets $0.20
BoggywanKenobi: folds 
Patte6: folds 
Uncalled bet ($0.20) returned to Bannnkai
Bannnkai collected $0.29 from pot
Bannnkai: doesn't show hand 
*** SUMMARY ***
Total pot $0.30 | Rake $0.01 
Board [5h Qc 5s 8d]
Seat 1: BoggywanKenobi (button) folded on the Turn
Seat 2: Patte6 (small blind) folded on the Turn
Seat 3: Bannnkai (big blind) collected ($0.29)
Seat 4: gokudousan folded before Flop (didn't bet)
Seat 6: kirankotag folded before Flop (didn't bet)



PokerStars Hand #222948356843:  Hold'em No Limit ($0.05/$0.10 USD) - 2021/01/23 4:10:38 ET
Table 'Linzia' 6-max Seat #2 is the button
Seat 1: BoggywanKenobi ($4.17 in chips) 
Seat 2: Patte6 ($12.32 in chips) 
Seat 3: Bannnkai ($10.19 in chips) 
Seat 4: gokudousan ($17.26 in chips) 
Seat 6: kirankotag ($7.85 in chips) 
Bannnkai: posts small blind $0.05
gokudousan: posts big blind $0.10
*** HOLE CARDS ***
kirankotag: folds 
BoggywanKenobi: calls $0.10
Patte6: folds 
Bannnkai: calls $0.05
gokudousan: checks 
*** FLOP *** [Ks 5s Th]
Bannnkai: checks 
gokudousan: checks 
BoggywanKenobi: checks 
*** TURN *** [Ks 5s Th] [Jh]
Bannnkai: bets $0.10
gokudousan: folds 
BoggywanKenobi: calls $0.10
*** RIVER *** [Ks 5s Th Jh] [Qc]
Bannnkai: checks 
BoggywanKenobi: bets $0.24
Bannnkai: calls $0.24
*** SHOW DOWN ***
BoggywanKenobi: shows [6s Qh] (a pair of Queens)
Bannnkai: shows [9d Kc] (a straight, Nine to King)
Bannnkai collected $0.94 from pot
*** SUMMARY ***
Total pot $0.98 | Rake $0.04 
Board [Ks 5s Th Jh Qc]
Seat 1: BoggywanKenobi showed [6s Qh] and lost with a pair of Queens
Seat 2: Patte6 (button) folded before Flop (didn't bet)
Seat 3: Bannnkai (small blind) showed [9d Kc] and won ($0.94) with a straight, Nine to King
Seat 4: gokudousan (big blind) folded on the Turn
Seat 6: kirankotag folded before Flop (didn't bet)



PokerStars Hand #222948367870:  Hold'em No Limit ($0.05/$0.10 USD) - 2021/01/23 4:11:21 ET
Table 'Linzia' 6-max Seat #3 is the button
Seat 1: BoggywanKenobi ($3.73 in chips) 
Seat 2: Patte6 ($12.32 in chips) 
Seat 3: Bannnkai ($10.69 in chips) 
Seat 4: gokudousan ($17.16 in chips) 
Seat 6: kirankotag ($7.85 in chips) 
gokudousan: posts small blind $0.05
kirankotag: posts big blind $0.10
*** HOLE CARDS ***
BoggywanKenobi: calls $0.10
Patte6: folds 
Bannnkai: folds 
gokudousan: folds 
kirankotag: checks 
*** FLOP *** [4c Ac As]
kirankotag: checks 
BoggywanKenobi: checks 
*** TURN *** [4c Ac As] [Ah]
kirankotag: checks 
BoggywanKenobi: checks 
*** RIVER *** [4c Ac As Ah] [8d]
kirankotag: checks 
BoggywanKenobi: bets $0.24
kirankotag: folds 
Uncalled bet ($0.24) returned to BoggywanKenobi
BoggywanKenobi collected $0.24 from pot
BoggywanKenobi: doesn't show hand 
*** SUMMARY ***
Total pot $0.25 | Rake $0.01 
Board [4c Ac As Ah 8d]
Seat 1: BoggywanKenobi collected ($0.24)
Seat 2: Patte6 folded before Flop (didn't bet)
Seat 3: Bannnkai (button) folded before Flop (didn't bet)
Seat 4: gokudousan (small blind) folded before Flop
Seat 6: kirankotag (big blind) folded on the River



PokerStars Hand #222948376715:  Hold'em No Limit ($0.05/$0.10 USD) - 2021/01/23 4:11:55 ET
Table 'Linzia' 6-max Seat #4 is the button
Seat 1: BoggywanKenobi ($3.87 in chips) 
Seat 2: Patte6 ($12.32 in chips) 
Seat 3: Bannnkai ($10.69 in chips) 
Seat 4: gokudousan ($17.11 in chips) 
Seat 6: kirankotag ($7.75 in chips) 
kirankotag: posts small blind $0.05
BoggywanKenobi: posts big blind $0.10
*** HOLE CARDS ***
Patte6: folds 
Bannnkai: folds 
gokudousan: raises $0.20 to $0.30
kirankotag: folds 
BoggywanKenobi: calls $0.20
*** FLOP *** [Qs Ad Jc]
BoggywanKenobi: checks 
gokudousan: bets $0.30
BoggywanKenobi: calls $0.30
*** TURN *** [Qs Ad Jc] [6h]
BoggywanKenobi: checks 
gokudousan: bets $0.60
BoggywanKenobi: calls $0.60
*** RIVER *** [Qs Ad Jc 6h] [9h]
BoggywanKenobi: checks 
gokudousan: checks 
*** SHOW DOWN ***
BoggywanKenobi: shows [Tc 9s] (a pair of Nines)
gokudousan: shows [Kd Qc] (a pair of Queens)
gokudousan collected $2.34 from pot
*** SUMMARY ***
Total pot $2.45 | Rake $0.11 
Board [Qs Ad Jc 6h 9h]
Seat 1: BoggywanKenobi (big blind) showed [Tc 9s] and lost with a pair of Nines
Seat 2: Patte6 folded before Flop (didn't bet)
Seat 3: Bannnkai folded before Flop (didn't bet)
Seat 4: gokudousan (button) showed [Kd Qc] and won ($2.34) with a pair of Queens
Seat 6: kirankotag (small blind) folded before Flop



PokerStars Hand #222948388080:  Hold'em No Limit ($0.05/$0.10 USD) - 2021/01/23 4:12:39 ET
Table 'Linzia' 6-max Seat #6 is the button
Seat 1: BoggywanKenobi ($2.67 in chips) 
Seat 2: Patte6 ($12.32 in chips) 
Seat 3: Bannnkai ($10.69 in chips) 
Seat 4: gokudousan ($18.25 in chips) 
Seat 6: kirankotag ($7.70 in chips) 
BoggywanKenobi: posts small blind $0.05
Patte6: posts big blind $0.10
Laker_Style: sits out 
*** HOLE CARDS ***
Bannnkai: folds 
gokudousan: folds 
kirankotag: folds 
BoggywanKenobi: calls $0.05
Patte6: checks 
*** FLOP *** [8s 6h Kh]
BoggywanKenobi: checks 
Patte6: bets $0.10
BoggywanKenobi: folds 
Uncalled bet ($0.10) returned to Patte6
Patte6 collected $0.19 from pot
Patte6: doesn't show hand 
*** SUMMARY ***
Total pot $0.20 | Rake $0.01 
Board [8s 6h Kh]
Seat 1: BoggywanKenobi (small blind) folded on the Flop
Seat 2: Patte6 (big blind) collected ($0.19)
Seat 3: Bannnkai folded before Flop (didn't bet)
Seat 4: gokudousan folded before Flop (didn't bet)
Seat 6: kirankotag (button) folded before Flop (didn't bet)



PokerStars Hand #222948392965:  Hold'em No Limit ($0.05/$0.10 USD) - 2021/01/23 4:12:58 ET
Table 'Linzia' 6-max Seat #1 is the button
Seat 1: BoggywanKenobi ($2.57 in chips) 
Seat 2: Patte6 ($12.41 in chips) 
Seat 3: Bannnkai ($10.69 in chips) 
Seat 4: gokudousan ($18.25 in chips) 
Seat 6: kirankotag ($7.70 in chips) 
Patte6: posts small blind $0.05
Bannnkai: posts big blind $0.10
Laker_Style: sits out 
*** HOLE CARDS ***
gokudousan: folds 
kirankotag: calls $0.10
BoggywanKenobi: calls $0.10
Patte6: raises $0.60 to $0.70
Bannnkai: folds 
kirankotag: folds 
BoggywanKenobi: calls $0.60
*** FLOP *** [Ad 8c Th]
Patte6: bets $0.77
BoggywanKenobi: raises $1.10 to $1.87 and is all-in
Patte6: calls $1.10
*** TURN *** [Ad 8c Th] [2c]
*** RIVER *** [Ad 8c Th 2c] [9h]
*** SHOW DOWN ***
Patte6: shows [Ks Ac] (a pair of Aces)
BoggywanKenobi: shows [8s 5s] (a pair of Eights)
Patte6 collected $5.10 from pot
*** SUMMARY ***
Total pot $5.34 | Rake $0.24 
Board [Ad 8c Th 2c 9h]
Seat 1: BoggywanKenobi (button) showed [8s 5s] and lost with a pair of Eights
Seat 2: Patte6 (small blind) showed [Ks Ac] and won ($5.10) with a pair of Aces
Seat 3: Bannnkai (big blind) folded before Flop
Seat 4: gokudousan folded before Flop (didn't bet)
Seat 6: kirankotag folded before Flop



PokerStars Hand #222948401977:  Hold'em No Limit ($0.05/$0.10 USD) - 2021/01/23 4:13:33 ET
Table 'Linzia' 6-max Seat #2 is the button
Seat 2: Patte6 ($14.94 in chips) 
Seat 3: Bannnkai ($10.59 in chips) 
Seat 4: gokudousan ($18.25 in chips) 
Seat 6: kirankotag ($7.60 in chips) 
Bannnkai: posts small blind $0.05
gokudousan: posts big blind $0.10
Laker_Style: sits out 
*** HOLE CARDS ***
kirankotag: calls $0.10
BoggywanKenobi leaves the table
Patte6: folds 
Bannnkai: folds 
gokudousan: checks 
*** FLOP *** [9c 4s 6h]
rpadilla33 joins the table at seat #1 
gokudousan: checks 
kirankotag: bets $0.10
gokudousan: calls $0.10
*** TURN *** [9c 4s 6h] [Js]
gokudousan: checks 
kirankotag: bets $0.10
gokudousan: calls $0.10
*** RIVER *** [9c 4s 6h Js] [8c]
gokudousan: checks 
kirankotag: checks 
*** SHOW DOWN ***
gokudousan: shows [9d Qh] (a pair of Nines)
kirankotag: mucks hand 
gokudousan collected $0.62 from pot
*** SUMMARY ***
Total pot $0.65 | Rake $0.03 
Board [9c 4s 6h Js 8c]
Seat 2: Patte6 (button) folded before Flop (didn't bet)
Seat 3: Bannnkai (small blind) folded before Flop
Seat 4: gokudousan (big blind) showed [9d Qh] and won ($0.62) with a pair of Nines
Seat 6: kirankotag mucked



PokerStars Hand #222948413255:  Hold'em No Limit ($0.05/$0.10 USD) - 2021/01/23 4:14:17 ET
Table 'Linzia' 6-max Seat #3 is the button
Seat 2: Patte6 ($14.94 in chips) 
Seat 3: Bannnkai ($10.54 in chips) 
Seat 4: gokudousan ($18.57 in chips) 
Seat 5: Laker_Style ($18.53 in chips) 
Seat 6: kirankotag ($7.30 in chips) 
gokudousan: posts small blind $0.05
Laker_Style: posts big blind $0.10
rpadilla33: sits out 
*** HOLE CARDS ***
kirankotag: calls $0.10
Patte6: raises $0.20 to $0.30
Bannnkai: folds 
gokudousan: folds 
Laker_Style: calls $0.20
kirankotag: calls $0.20
*** FLOP *** [5h 4s Tc]
Laker_Style: checks 
kirankotag: checks 
Patte6: checks 
*** TURN *** [5h 4s Tc] [2s]
Laker_Style: checks 
kirankotag: checks 
Patte6: bets $0.32
Laker_Style: folds 
kirankotag: folds 
Uncalled bet ($0.32) returned to Patte6
Patte6 collected $0.91 from pot
Patte6: doesn't show hand 
*** SUMMARY ***
Total pot $0.95 | Rake $0.04 
Board [5h 4s Tc 2s]
Seat 2: Patte6 collected ($0.91)
Seat 3: Bannnkai (button) folded before Flop (didn't bet)
Seat 4: gokudousan (small blind) folded before Flop
Seat 5: Laker_Style (big blind) folded on the Turn
Seat 6: kirankotag folded on the Turn



PokerStars Hand #222948439687:  Hold'em No Limit ($0.05/$0.10 USD) - 2021/01/23 4:15:59 ET
Table 'Linzia' 6-max Seat #4 is the button
Seat 2: Patte6 ($15.55 in chips) 
Seat 3: Bannnkai ($10.54 in chips) 
Seat 4: gokudousan ($18.52 in chips) 
Seat 5: Laker_Style ($18.23 in chips) 
Seat 6: kirankotag ($7 in chips) 
Laker_Style: posts small blind $0.05
kirankotag: posts big blind $0.10
rpadilla33: sits out 
*** HOLE CARDS ***
Patte6: folds 
Bannnkai: folds 
gokudousan: folds 
Laker_Style: folds 
Uncalled bet ($0.05) returned to kirankotag
kirankotag collected $0.10 from pot
kirankotag: doesn't show hand 
*** SUMMARY ***
Total pot $0.10 | Rake $0 
Seat 2: Patte6 folded before Flop (didn't bet)
Seat 3: Bannnkai folded before Flop (didn't bet)
Seat 4: gokudousan (button) folded before Flop (didn't bet)
Seat 5: Laker_Style (small blind) folded before Flop
Seat 6: kirankotag (big blind) collected ($0.10)



PokerStars Hand #222948444521:  Hold'em No Limit ($0.05/$0.10 USD) - 2021/01/23 4:16:17 ET
Table 'Linzia' 6-max Seat #5 is the button
Seat 1: rpadilla33 ($10 in chips) 
Seat 2: Patte6 ($15.55 in chips) 
Seat 3: Bannnkai ($10.54 in chips) 
Seat 4: gokudousan ($18.52 in chips) 
Seat 5: Laker_Style ($18.18 in chips) 
Seat 6: kirankotag ($7.05 in chips) 
kirankotag: posts small blind $0.05
rpadilla33: posts big blind $0.10
*** HOLE CARDS ***
Patte6: folds 
Bannnkai: folds 
gokudousan: folds 
Laker_Style: raises $0.15 to $0.25
kirankotag: folds 
rpadilla33: folds 
Uncalled bet ($0.15) returned to Laker_Style
Laker_Style collected $0.25 from pot
Laker_Style: doesn't show hand 
*** SUMMARY ***
Total pot $0.25 | Rake $0 
Seat 1: rpadilla33 (big blind) folded before Flop
Seat 2: Patte6 folded before Flop (didn't bet)
Seat 3: Bannnkai folded before Flop (didn't bet)
Seat 4: gokudousan folded before Flop (didn't bet)
Seat 5: Laker_Style (button) collected ($0.25)
Seat 6: kirankotag (small blind) folded before Flop



PokerStars Hand #222948450212:  Hold'em No Limit ($0.05/$0.10 USD) - 2021/01/23 4:16:39 ET
Table 'Linzia' 6-max Seat #6 is the button
Seat 1: rpadilla33 ($10 in chips) 
Seat 3: Bannnkai ($10.54 in chips) 
Seat 4: gokudousan ($18.52 in chips) 
Seat 5: Laker_Style ($18.33 in chips) 
Seat 6: kirankotag ($7 in chips) 
rpadilla33: posts small blind $0.05
Patte6: is sitting out 
Bannnkai: posts big blind $0.10
*** HOLE CARDS ***
gokudousan: folds 
Patte6 leaves the table
Laker_Style: folds 
kirankotag: folds 
rpadilla33: folds 
Uncalled bet ($0.05) returned to Bannnkai
Bannnkai collected $0.10 from pot
Impostore1988 joins the table at seat #2 
Bannnkai: doesn't show hand 
*** SUMMARY ***
Total pot $0.10 | Rake $0 
Seat 1: rpadilla33 (small blind) folded before Flop
Seat 3: Bannnkai (big blind) collected ($0.10)
Seat 4: gokudousan folded before Flop (didn't bet)
Seat 5: Laker_Style folded before Flop (didn't bet)
Seat 6: kirankotag (button) folded before Flop (didn't bet)



PokerStars Hand #222948452840:  Hold'em No Limit ($0.05/$0.10 USD) - 2021/01/23 4:16:50 ET
Table 'Linzia' 6-max Seat #1 is the button
Seat 1: rpadilla33 ($10 in chips) 
Seat 3: Bannnkai ($10.59 in chips) 
Seat 4: gokudousan ($18.52 in chips) 
Seat 5: Laker_Style ($18.33 in chips) 
Seat 6: kirankotag ($7 in chips) 
Bannnkai: posts small blind $0.05
gokudousan: posts big blind $0.10
*** HOLE CARDS ***
Laker_Style: folds 
kirankotag: folds 
rpadilla33: raises $0.20 to $0.30
Bannnkai: folds 
gokudousan: raises $0.70 to $1
rpadilla33: folds 
Uncalled bet ($0.70) returned to gokudousan
gokudousan collected $0.65 from pot
gokudousan: doesn't show hand 
*** SUMMARY ***
Total pot $0.65 | Rake $0 
Seat 1: rpadilla33 (button) folded before Flop
Seat 3: Bannnkai (small blind) folded before Flop
Seat 4: gokudousan (big blind) collected ($0.65)
Seat 5: Laker_Style folded before Flop (didn't bet)
Seat 6: kirankotag folded before Flop (didn't bet)



PokerStars Hand #222948458049:  Hold'em No Limit ($0.05/$0.10 USD) - 2021/01/23 4:17:10 ET
Table 'Linzia' 6-max Seat #3 is the button
Seat 1: rpadilla33 ($10 in chips) 
Seat 3: Bannnkai ($10.54 in chips) 
Seat 4: gokudousan ($18.87 in chips) 
Seat 5: Laker_Style ($18.33 in chips) 
Seat 6: kirankotag ($7 in chips) 
gokudousan: posts small blind $0.05
Laker_Style: posts big blind $0.10
Impostore1988: sits out 
*** HOLE CARDS ***
Impostore1988 leaves the table
kirankotag: calls $0.10
rpadilla33: folds 
Bannnkai: folds 
gokudousan: folds 
Laker_Style: checks 
*** FLOP *** [Th Td 6c]
Laker_Style: bets $0.12
kirankotag: calls $0.12
*** TURN *** [Th Td 6c] [3d]
Laker_Style: checks 
kirankotag: checks 
*** RIVER *** [Th Td 6c 3d] [9h]
Laker_Style: bets $0.30
kirankotag: folds 
Uncalled bet ($0.30) returned to Laker_Style
Laker_Style collected $0.47 from pot
Laker_Style: doesn't show hand 
*** SUMMARY ***
Total pot $0.49 | Rake $0.02 
Board [Th Td 6c 3d 9h]
Seat 1: rpadilla33 folded before Flop (didn't bet)
Seat 3: Bannnkai (button) folded before Flop (didn't bet)
Seat 4: gokudousan (small blind) folded before Flop
Seat 5: Laker_Style (big blind) collected ($0.47)
Seat 6: kirankotag folded on the River



PokerStars Hand #222948474587:  Hold'em No Limit ($0.05/$0.10 USD) - 2021/01/23 4:18:12 ET
Table 'Linzia' 6-max Seat #4 is the button
Seat 1: rpadilla33 ($10 in chips) 
Seat 3: Bannnkai ($10.54 in chips) 
Seat 4: gokudousan ($18.82 in chips) 
Seat 5: Laker_Style ($18.58 in chips) 
Seat 6: kirankotag ($6.78 in chips) 
Laker_Style: posts small blind $0.05
kirankotag: posts big blind $0.10
*** HOLE CARDS ***
StarkomT3ob joins the table at seat #2 
rpadilla33: folds 
Bannnkai: folds 
gokudousan: folds 
Laker_Style: folds 
Uncalled bet ($0.05) returned to kirankotag
kirankotag collected $0.10 from pot
kirankotag: doesn't show hand 
*** SUMMARY ***
Total pot $0.10 | Rake $0 
Seat 1: rpadilla33 folded before Flop (didn't bet)
Seat 3: Bannnkai folded before Flop (didn't bet)
Seat 4: gokudousan (button) folded before Flop (didn't bet)
Seat 5: Laker_Style (small blind) folded before Flop
Seat 6: kirankotag (big blind) collected ($0.10)



PokerStars Hand #222948478327:  Hold'em No Limit ($0.05/$0.10 USD) - 2021/01/23 4:18:27 ET
Table 'Linzia' 6-max Seat #5 is the button
Seat 1: rpadilla33 ($10 in chips) 
Seat 3: Bannnkai ($10.54 in chips) 
Seat 4: gokudousan ($18.82 in chips) 
Seat 5: Laker_Style ($18.53 in chips) 
Seat 6: kirankotag ($6.83 in chips) 
kirankotag: posts small blind $0.05
rpadilla33: posts big blind $0.10
StarkomT3ob: sits out 
*** HOLE CARDS ***
Bannnkai: raises $0.20 to $0.30
gokudousan: folds 
Laker_Style: raises $0.60 to $0.90
kirankotag: folds 
rpadilla33: folds 
Bannnkai: folds 
Uncalled bet ($0.60) returned to Laker_Style
Laker_Style collected $0.75 from pot
Laker_Style: doesn't show hand 
*** SUMMARY ***
Total pot $0.75 | Rake $0 
Seat 1: rpadilla33 (big blind) folded before Flop
Seat 3: Bannnkai folded before Flop
Seat 4: gokudousan folded before Flop (didn't bet)
Seat 5: Laker_Style (button) collected ($0.75)
Seat 6: kirankotag (small blind) folded before Flop



PokerStars Hand #222948483649:  Hold'em No Limit ($0.05/$0.10 USD) - 2021/01/23 4:18:47 ET
Table 'Linzia' 6-max Seat #6 is the button
Seat 1: rpadilla33 ($10 in chips) 
Seat 2: StarkomT3ob ($10 in chips) 
Seat 3: Bannnkai ($10.24 in chips) 
Seat 4: gokudousan ($18.82 in chips) 
Seat 5: Laker_Style ($18.98 in chips) 
Seat 6: kirankotag ($6.78 in chips) 
rpadilla33: posts small blind $0.05
StarkomT3ob: posts big blind $0.10
*** HOLE CARDS ***
Bannnkai: folds 
gokudousan: raises $0.20 to $0.30
Laker_Style: calls $0.30
kirankotag: calls $0.30
rpadilla33: folds 
StarkomT3ob: folds 
*** FLOP *** [Qs 3s 3h]
gokudousan: checks 
Laker_Style: checks 
kirankotag: bets $0.50
gokudousan: folds 
Laker_Style: folds 
Uncalled bet ($0.50) returned to kirankotag
kirankotag collected $1 from pot
kirankotag: doesn't show hand 
*** SUMMARY ***
Total pot $1.05 | Rake $0.05 
Board [Qs 3s 3h]
Seat 1: rpadilla33 (small blind) folded before Flop
Seat 2: StarkomT3ob (big blind) folded before Flop
Seat 3: Bannnkai folded before Flop (didn't bet)
Seat 4: gokudousan folded on the Flop
Seat 5: Laker_Style folded on the Flop
Seat 6: kirankotag (button) collected ($1)



PokerStars Hand #222948499777:  Hold'em No Limit ($0.05/$0.10 USD) - 2021/01/23 4:19:48 ET
Table 'Linzia' 6-max Seat #1 is the button
Seat 1: rpadilla33 ($10 in chips) 
Seat 2: StarkomT3ob ($10 in chips) 
Seat 3: Bannnkai ($10.24 in chips) 
Seat 4: gokudousan ($18.52 in chips) 
Seat 5: Laker_Style ($18.68 in chips) 
Seat 6: kirankotag ($7.48 in chips) 
StarkomT3ob: posts small blind $0.05
Bannnkai: posts big blind $0.10
*** HOLE CARDS ***
gokudousan: folds 
Laker_Style: folds 
kirankotag: calls $0.10
rpadilla33: folds 
StarkomT3ob: calls $0.05
Bannnkai: checks 
*** FLOP *** [8c 5s 9h]
StarkomT3ob: checks 
Bannnkai: checks 
kirankotag: checks 
*** TURN *** [8c 5s 9h] [Ac]
StarkomT3ob: checks 
Bannnkai: checks 
kirankotag: checks 
*** RIVER *** [8c 5s 9h Ac] [2h]
StarkomT3ob: checks 
Bannnkai: checks 
kirankotag: checks 
*** SHOW DOWN ***
StarkomT3ob: shows [7s Qd] (high card Ace)
Bannnkai: mucks hand 
kirankotag: shows [Kc 6d] (high card Ace - King kicker)
kirankotag collected $0.29 from pot
*** SUMMARY ***
Total pot $0.30 | Rake $0.01 
Board [8c 5s 9h Ac 2h]
Seat 1: rpadilla33 (button) folded before Flop (didn't bet)
Seat 2: StarkomT3ob (small blind) showed [7s Qd] and lost with high card Ace
Seat 3: Bannnkai (big blind) mucked
Seat 4: gokudousan folded before Flop (didn't bet)
Seat 5: Laker_Style folded before Flop (didn't bet)
Seat 6: kirankotag showed [Kc 6d] and won ($0.29) with high card Ace



PokerStars Hand #222948510031:  Hold'em No Limit ($0.05/$0.10 USD) - 2021/01/23 4:20:27 ET
Table 'Linzia' 6-max Seat #2 is the button
Seat 1: rpadilla33 ($10 in chips) 
Seat 2: StarkomT3ob ($10 in chips) 
Seat 3: Bannnkai ($10.14 in chips) 
Seat 4: gokudousan ($18.52 in chips) 
Seat 5: Laker_Style ($18.68 in chips) 
Seat 6: kirankotag ($7.67 in chips) 
Bannnkai: posts small blind $0.05
gokudousan: posts big blind $0.10
*** HOLE CARDS ***
Laker_Style: folds 
kirankotag: folds 
rpadilla33: raises $0.20 to $0.30
StarkomT3ob: raises $0.65 to $0.95
Bannnkai: folds 
gokudousan: folds 
rpadilla33: raises $1.45 to $2.40
StarkomT3ob: folds 
Uncalled bet ($1.45) returned to rpadilla33
rpadilla33 collected $2.05 from pot
rpadilla33: doesn't show hand 
*** SUMMARY ***
Total pot $2.05 | Rake $0 
Seat 1: rpadilla33 collected ($2.05)
Seat 2: StarkomT3ob (button) folded before Flop
Seat 3: Bannnkai (small blind) folded before Flop
Seat 4: gokudousan (big blind) folded before Flop
Seat 5: Laker_Style folded before Flop (didn't bet)
Seat 6: kirankotag folded before Flop (didn't bet)



PokerStars Hand #222948519977:  Hold'em No Limit ($0.05/$0.10 USD) - 2021/01/23 4:21:05 ET
Table 'Linzia' 6-max Seat #3 is the button
Seat 1: rpadilla33 ($11.10 in chips) 
Seat 2: StarkomT3ob ($10 in chips) 
Seat 3: Bannnkai ($10.09 in chips) 
Seat 4: gokudousan ($18.42 in chips) 
Seat 5: Laker_Style ($18.68 in chips) 
Seat 6: kirankotag ($7.67 in chips) 
gokudousan: posts small blind $0.05
Laker_Style: posts big blind $0.10
*** HOLE CARDS ***
kirankotag: folds 
rpadilla33: raises $0.20 to $0.30
StarkomT3ob: folds 
Bannnkai: folds 
gokudousan: folds 
Laker_Style: folds 
Uncalled bet ($0.20) returned to rpadilla33
rpadilla33 collected $0.25 from pot
rpadilla33: doesn't show hand 
*** SUMMARY ***
Total pot $0.25 | Rake $0 
Seat 1: rpadilla33 collected ($0.25)
Seat 2: StarkomT3ob folded before Flop (didn't bet)
Seat 3: Bannnkai (button) folded before Flop (didn't bet)
Seat 4: gokudousan (small blind) folded before Flop
Seat 5: Laker_Style (big blind) folded before Flop
Seat 6: kirankotag folded before Flop (didn't bet)



PokerStars Hand #222948523540:  Hold'em No Limit ($0.05/$0.10 USD) - 2021/01/23 4:21:18 ET
Table 'Linzia' 6-max Seat #4 is the button
Seat 1: rpadilla33 ($11.25 in chips) 
Seat 2: StarkomT3ob ($10 in chips) 
Seat 3: Bannnkai ($10.09 in chips) 
Seat 4: gokudousan ($18.37 in chips) 
Seat 5: Laker_Style ($18.58 in chips) 
Seat 6: kirankotag ($7.67 in chips) 
Laker_Style: posts small blind $0.05
kirankotag: posts big blind $0.10
*** HOLE CARDS ***
rpadilla33: folds 
StarkomT3ob: folds 
Bannnkai: folds 
gokudousan: raises $0.20 to $0.30
Laker_Style: folds 
kirankotag: calls $0.20
*** FLOP *** [4d Jh As]
kirankotag: checks 
gokudousan: bets $0.30
kirankotag: folds 
Uncalled bet ($0.30) returned to gokudousan
gokudousan collected $0.62 from pot
gokudousan: doesn't show hand 
*** SUMMARY ***
Total pot $0.65 | Rake $0.03 
Board [4d Jh As]
Seat 1: rpadilla33 folded before Flop (didn't bet)
Seat 2: StarkomT3ob folded before Flop (didn't bet)
Seat 3: Bannnkai folded before Flop (didn't bet)
Seat 4: gokudousan (button) collected ($0.62)
Seat 5: Laker_Style (small blind) folded before Flop
Seat 6: kirankotag (big blind) folded on the Flop



PokerStars Hand #222948531028:  Hold'em No Limit ($0.05/$0.10 USD) - 2021/01/23 4:21:46 ET
Table 'Linzia' 6-max Seat #5 is the button
Seat 1: rpadilla33 ($11.25 in chips) 
Seat 2: StarkomT3ob ($10 in chips) 
Seat 3: Bannnkai ($10.09 in chips) 
Seat 4: gokudousan ($18.69 in chips) 
Seat 5: Laker_Style ($18.53 in chips) 
Seat 6: kirankotag ($7.37 in chips) 
kirankotag: posts small blind $0.05
rpadilla33: posts big blind $0.10
*** HOLE CARDS ***
StarkomT3ob: folds 
Bannnkai: folds 
gokudousan: folds 
Laker_Style: folds 
kirankotag: calls $0.05
rpadilla33: checks 
*** FLOP *** [7h 8h Ks]
kirankotag: checks 
rpadilla33: checks 
*** TURN *** [7h 8h Ks] [4c]
kirankotag: bets $0.10
rpadilla33: folds 
Uncalled bet ($0.10) returned to kirankotag
kirankotag collected $0.19 from pot
kirankotag: doesn't show hand 
*** SUMMARY ***
Total pot $0.20 | Rake $0.01 
Board [7h 8h Ks 4c]
Seat 1: rpadilla33 (big blind) folded on the Turn
Seat 2: StarkomT3ob folded before Flop (didn't bet)
Seat 3: Bannnkai folded before Flop (didn't bet)
Seat 4: gokudousan folded before Flop (didn't bet)
Seat 5: Laker_Style (button) folded before Flop (didn't bet)
Seat 6: kirankotag (small blind) collected ($0.19)



PokerStars Hand #222948541495:  Hold'em No Limit ($0.05/$0.10 USD) - 2021/01/23 4:22:26 ET
Table 'Linzia' 6-max Seat #6 is the button
Seat 1: rpadilla33 ($11.15 in chips) 
Seat 2: StarkomT3ob ($10 in chips) 
Seat 3: Bannnkai ($10.09 in chips) 
Seat 4: gokudousan ($18.69 in chips) 
Seat 5: Laker_Style ($18.53 in chips) 
Seat 6: kirankotag ($7.46 in chips) 
rpadilla33: posts small blind $0.05
StarkomT3ob: posts big blind $0.10
*** HOLE CARDS ***
Bannnkai: folds 
gokudousan: folds 
Laker_Style: folds 
kirankotag: raises $0.10 to $0.20
rpadilla33: folds 
StarkomT3ob: calls $0.10
*** FLOP *** [3d Tc Ks]
StarkomT3ob: checks 
kirankotag: bets $0.43
StarkomT3ob: folds 
Uncalled bet ($0.43) returned to kirankotag
kirankotag collected $0.43 from pot
kirankotag: doesn't show hand 
*** SUMMARY ***
Total pot $0.45 | Rake $0.02 
Board [3d Tc Ks]
Seat 1: rpadilla33 (small blind) folded before Flop
Seat 2: StarkomT3ob (big blind) folded on the Flop
Seat 3: Bannnkai folded before Flop (didn't bet)
Seat 4: gokudousan folded before Flop (didn't bet)
Seat 5: Laker_Style folded before Flop (didn't bet)
Seat 6: kirankotag (button) collected ($0.43)



PokerStars Hand #222948546587:  Hold'em No Limit ($0.05/$0.10 USD) - 2021/01/23 4:22:46 ET
Table 'Linzia' 6-max Seat #1 is the button
Seat 1: rpadilla33 ($11.10 in chips) 
Seat 2: StarkomT3ob ($10 in chips) 
Seat 3: Bannnkai ($10.09 in chips) 
Seat 4: gokudousan ($18.69 in chips) 
Seat 5: Laker_Style ($18.53 in chips) 
Seat 6: kirankotag ($7.69 in chips) 
StarkomT3ob: posts small blind $0.05
Bannnkai: posts big blind $0.10
*** HOLE CARDS ***
gokudousan: folds 
Laker_Style has timed out
Laker_Style: folds 
kirankotag: raises $0.10 to $0.20
rpadilla33: folds 
StarkomT3ob: folds 
Bannnkai: calls $0.10
*** FLOP *** [9c 9s As]
Bannnkai: checks 
kirankotag: bets $0.43
Bannnkai: folds 
Uncalled bet ($0.43) returned to kirankotag
kirankotag collected $0.43 from pot
kirankotag: doesn't show hand 
*** SUMMARY ***
Total pot $0.45 | Rake $0.02 
Board [9c 9s As]
Seat 1: rpadilla33 (button) folded before Flop (didn't bet)
Seat 2: StarkomT3ob (small blind) folded before Flop
Seat 3: Bannnkai (big blind) folded on the Flop
Seat 4: gokudousan folded before Flop (didn't bet)
Seat 5: Laker_Style folded before Flop (didn't bet)
Seat 6: kirankotag collected ($0.43)



PokerStars Hand #222948555770:  Hold'em No Limit ($0.05/$0.10 USD) - 2021/01/23 4:23:21 ET
Table 'Linzia' 6-max Seat #2 is the button
Seat 1: rpadilla33 ($11.10 in chips) 
Seat 2: StarkomT3ob ($10 in chips) 
Seat 3: Bannnkai ($10 in chips) 
Seat 4: gokudousan ($18.69 in chips) 
Seat 5: Laker_Style ($18.53 in chips) 
Seat 6: kirankotag ($7.92 in chips) 
Bannnkai: posts small blind $0.05
gokudousan: posts big blind $0.10
*** HOLE CARDS ***
Laker_Style: folds 
kirankotag: raises $0.10 to $0.20
rpadilla33: calls $0.20
StarkomT3ob: folds 
Bannnkai: folds 
gokudousan: calls $0.10
*** FLOP *** [7d Ks 3h]
gokudousan: checks 
kirankotag: checks 
rpadilla33: bets $0.30
gokudousan: calls $0.30
kirankotag: calls $0.30
*** TURN *** [7d Ks 3h] [6c]
gokudousan: checks 
kirankotag: checks 
rpadilla33: bets $1.10
gokudousan: folds 
kirankotag: calls $1.10
*** RIVER *** [7d Ks 3h 6c] [4d]
kirankotag: checks 
rpadilla33: checks 
*** SHOW DOWN ***
kirankotag: shows [Jc Jh] (a pair of Jacks)
rpadilla33: shows [Jd Kd] (a pair of Kings)
rpadilla33 collected $3.58 from pot
*** SUMMARY ***
Total pot $3.75 | Rake $0.17 
Board [7d Ks 3h 6c 4d]
Seat 1: rpadilla33 showed [Jd Kd] and won ($3.58) with a pair of Kings
Seat 2: StarkomT3ob (button) folded before Flop (didn't bet)
Seat 3: Bannnkai (small blind) folded before Flop
Seat 4: gokudousan (big blind) folded on the Turn
Seat 5: Laker_Style folded before Flop (didn't bet)
Seat 6: kirankotag showed [Jc Jh] and lost with a pair of Jacks



PokerStars Hand #222948571128:  Hold'em No Limit ($0.05/$0.10 USD) - 2021/01/23 4:24:19 ET
Table 'Linzia' 6-max Seat #3 is the button
Seat 1: rpadilla33 ($13.08 in chips) 
Seat 2: StarkomT3ob ($10 in chips) 
Seat 3: Bannnkai ($10 in chips) 
Seat 4: gokudousan ($18.19 in chips) 
Seat 5: Laker_Style ($18.53 in chips) 
Seat 6: kirankotag ($6.32 in chips) 
gokudousan: posts small blind $0.05
Laker_Style: posts big blind $0.10
*** HOLE CARDS ***
kirankotag: raises $0.25 to $0.35
rpadilla33: folds 
StarkomT3ob: folds 
Bannnkai: raises $0.85 to $1.20
gokudousan: folds 
Laker_Style: folds 
kirankotag: raises $2.55 to $3.75
Bannnkai: raises $2.55 to $6.30
kirankotag: raises $0.02 to $6.32 and is all-in
Bannnkai: calls $0.02
*** FLOP *** [Td Kh 2d]
*** TURN *** [Td Kh 2d] [Ks]
*** RIVER *** [Td Kh 2d Ks] [7s]
*** SHOW DOWN ***
kirankotag: shows [Jd Ac] (a pair of Kings)
Bannnkai: shows [Qs Qh] (two pair, Kings and Queens)
Bannnkai cashed out the hand for $8.63 | Cash Out Fee $0.09
*** SUMMARY ***
Total pot $12.79 | Rake $0.58 
Board [Td Kh 2d Ks 7s]
Seat 1: rpadilla33 folded before Flop (didn't bet)
Seat 2: StarkomT3ob folded before Flop (didn't bet)
Seat 3: Bannnkai (button) showed [Qs Qh] and won ($12.21) with two pair, Kings and Queens (pot not awarded as player cashed out)
Seat 4: gokudousan (small blind) folded before Flop
Seat 5: Laker_Style (big blind) folded before Flop
Seat 6: kirankotag showed [Jd Ac] and lost with a pair of Kings



PokerStars Hand #222948583587:  Hold'em No Limit ($0.05/$0.10 USD) - 2021/01/23 4:25:07 ET
Table 'Linzia' 6-max Seat #4 is the button
Seat 1: rpadilla33 ($13.08 in chips) 
Seat 2: StarkomT3ob ($10 in chips) 
Seat 3: Bannnkai ($12.31 in chips) 
Seat 4: gokudousan ($18.14 in chips) 
Seat 5: Laker_Style ($18.43 in chips) 
Laker_Style: posts small blind $0.05
rpadilla33: posts big blind $0.10
*** HOLE CARDS ***
StarkomT3ob: folds 
kirankotag leaves the table
Bannnkai has timed out
Bannnkai: folds 
gokudousan: folds 
Laker_Style: raises $0.20 to $0.30
rpadilla33: calls $0.20
*** FLOP *** [7d Ac Ks]
Laker_Style: checks 
rpadilla33: checks 
*** TURN *** [7d Ac Ks] [7c]
Kimiuran joins the table at seat #6 
StarkomT3ob leaves the table
Laker_Style: checks 
rpadilla33: checks 
*** RIVER *** [7d Ac Ks 7c] [8h]
Laker_Style: checks 
rpadilla33: checks 
*** SHOW DOWN ***
Laker_Style: shows [9h 9d] (two pair, Nines and Sevens)
rpadilla33: shows [Qh Kd] (two pair, Kings and Sevens)
rpadilla33 collected $0.57 from pot
*** SUMMARY ***
Total pot $0.60 | Rake $0.03 
Board [7d Ac Ks 7c 8h]
Seat 1: rpadilla33 (big blind) showed [Qh Kd] and won ($0.57) with two pair, Kings and Sevens
Seat 2: StarkomT3ob folded before Flop (didn't bet)
Seat 3: Bannnkai folded before Flop (didn't bet)
Seat 4: gokudousan (button) folded before Flop (didn't bet)
Seat 5: Laker_Style (small blind) showed [9h 9d] and lost with two pair, Nines and Sevens



PokerStars Hand #222948599422:  Hold'em No Limit ($0.05/$0.10 USD) - 2021/01/23 4:26:08 ET
Table 'Linzia' 6-max Seat #5 is the button
Seat 1: rpadilla33 ($13.35 in chips) 
Seat 3: Bannnkai ($12.31 in chips) 
Seat 4: gokudousan ($18.14 in chips) 
Seat 5: Laker_Style ($18.13 in chips) 
rpadilla33: posts small blind $0.05
Bannnkai: posts big blind $0.10
*** HOLE CARDS ***
gokudousan: folds 
Laker_Style: folds 
rpadilla33: folds 
Uncalled bet ($0.05) returned to Bannnkai
Bannnkai collected $0.10 from pot
Bannnkai: doesn't show hand 
*** SUMMARY ***
Total pot $0.10 | Rake $0 
Seat 1: rpadilla33 (small blind) folded before Flop
Seat 3: Bannnkai (big blind) collected ($0.10)
Seat 4: gokudousan folded before Flop (didn't bet)
Seat 5: Laker_Style (button) folded before Flop (didn't bet)



PokerStars Hand #222948601768:  Hold'em No Limit ($0.05/$0.10 USD) - 2021/01/23 4:26:17 ET
Table 'Linzia' 6-max Seat #1 is the button
Seat 1: rpadilla33 ($13.30 in chips) 
Seat 3: Bannnkai ($12.36 in chips) 
Seat 4: gokudousan ($18.14 in chips) 
Seat 5: Laker_Style ($18.13 in chips) 
Bannnkai: posts small blind $0.05
gokudousan: posts big blind $0.10
Kimiuran: sits out 
*** HOLE CARDS ***
joan 1970 joins the table at seat #2 
Laker_Style: folds 
rpadilla33: folds 
Bannnkai: raises $0.15 to $0.25
gokudousan: raises $0.55 to $0.80
Bannnkai: folds 
Uncalled bet ($0.55) returned to gokudousan
gokudousan collected $0.50 from pot
gokudousan: doesn't show hand 
*** SUMMARY ***
Total pot $0.50 | Rake $0 
Seat 1: rpadilla33 (button) folded before Flop (didn't bet)
Seat 3: Bannnkai (small blind) folded before Flop
Seat 4: gokudousan (big blind) collected ($0.50)
Seat 5: Laker_Style folded before Flop (didn't bet)



PokerStars Hand #222948609668:  Hold'em No Limit ($0.05/$0.10 USD) - 2021/01/23 4:26:47 ET
Table 'Linzia' 6-max Seat #3 is the button
Seat 1: rpadilla33 ($13.30 in chips) 
Seat 3: Bannnkai ($12.11 in chips) 
Seat 4: gokudousan ($18.39 in chips) 
Seat 5: Laker_Style ($18.13 in chips) 
gokudousan: posts small blind $0.05
Laker_Style: posts big blind $0.10
Kimiuran: sits out 
joan 1970: sits out 
*** HOLE CARDS ***
rpadilla33: raises $0.20 to $0.30
Bannnkai: folds 
gokudousan: folds 
Laker_Style: calls $0.20
*** FLOP *** [4s 8c 9s]
Laker_Style: checks 
rpadilla33: checks 
*** TURN *** [4s 8c 9s] [9h]
Laker_Style: checks 
rpadilla33: checks 
*** RIVER *** [4s 8c 9s 9h] [5c]
Laker_Style: checks 
rpadilla33: checks 
*** SHOW DOWN ***
Laker_Style: shows [3h 3c] (two pair, Nines and Threes)
rpadilla33: mucks hand 
Laker_Style collected $0.62 from pot
*** SUMMARY ***
Total pot $0.65 | Rake $0.03 
Board [4s 8c 9s 9h 5c]
Seat 1: rpadilla33 mucked
Seat 3: Bannnkai (button) folded before Flop (didn't bet)
Seat 4: gokudousan (small blind) folded before Flop
Seat 5: Laker_Style (big blind) showed [3h 3c] and won ($0.62) with two pair, Nines and Threes



PokerStars Hand #222948628692:  Hold'em No Limit ($0.05/$0.10 USD) - 2021/01/23 4:27:59 ET
Table 'Linzia' 6-max Seat #4 is the button
Seat 1: rpadilla33 ($13 in chips) 
Seat 3: Bannnkai ($12.11 in chips) 
Seat 4: gokudousan ($18.34 in chips) 
Seat 5: Laker_Style ($18.45 in chips) 
Seat 6: Kimiuran ($10 in chips) 
Laker_Style: posts small blind $0.05
Kimiuran: posts big blind $0.10
joan 1970: sits out 
*** HOLE CARDS ***
rpadilla33: folds 
Bannnkai: raises $0.20 to $0.30
gokudousan: folds 
Laker_Style: folds 
Kimiuran: folds 
Uncalled bet ($0.20) returned to Bannnkai
Bannnkai collected $0.25 from pot
Bannnkai: doesn't show hand 
*** SUMMARY ***
Total pot $0.25 | Rake $0 
Seat 1: rpadilla33 folded before Flop (didn't bet)
Seat 3: Bannnkai collected ($0.25)
Seat 4: gokudousan (button) folded before Flop (didn't bet)
Seat 5: Laker_Style (small blind) folded before Flop
Seat 6: Kimiuran (big blind) folded before Flop



PokerStars Hand #222948633631:  Hold'em No Limit ($0.05/$0.10 USD) - 2021/01/23 4:28:18 ET
Table 'Linzia' 6-max Seat #5 is the button
Seat 1: rpadilla33 ($13 in chips) 
Seat 3: Bannnkai ($12.26 in chips) 
Seat 4: gokudousan ($18.34 in chips) 
Seat 5: Laker_Style ($18.40 in chips) 
Seat 6: Kimiuran ($10 in chips) 
Kimiuran: posts small blind $0.05
rpadilla33: posts big blind $0.10
joan 1970: sits out 
*** HOLE CARDS ***
Bannnkai: folds 
gokudousan: raises $0.20 to $0.30
Laker_Style: folds 
Kimiuran: folds 
rpadilla33: folds 
Uncalled bet ($0.20) returned to gokudousan
gokudousan collected $0.25 from pot
gokudousan: doesn't show hand 
*** SUMMARY ***
Total pot $0.25 | Rake $0 
Seat 1: rpadilla33 (big blind) folded before Flop
Seat 3: Bannnkai folded before Flop (didn't bet)
Seat 4: gokudousan collected ($0.25)
Seat 5: Laker_Style (button) folded before Flop (didn't bet)
Seat 6: Kimiuran (small blind) folded before Flop



PokerStars Hand #222948639768:  Hold'em No Limit ($0.05/$0.10 USD) - 2021/01/23 4:28:41 ET
Table 'Linzia' 6-max Seat #6 is the button
Seat 1: rpadilla33 ($12.90 in chips) 
Seat 2: joan 1970 ($10 in chips) 
Seat 3: Bannnkai ($12.26 in chips) 
Seat 4: gokudousan ($18.49 in chips) 
Seat 5: Laker_Style ($18.40 in chips) 
Seat 6: Kimiuran ($10 in chips) 
rpadilla33: posts small blind $0.05
joan 1970: posts big blind $0.10
*** HOLE CARDS ***
Bannnkai: raises $0.20 to $0.30
gokudousan: folds 
Laker_Style: folds 
Kimiuran: folds 
rpadilla33: folds 
joan 1970: calls $0.20
*** FLOP *** [2h 5s 7d]
joan 1970: checks 
Bannnkai: checks 
*** TURN *** [2h 5s 7d] [7c]
joan 1970: bets $0.30
Bannnkai: folds 
Uncalled bet ($0.30) returned to joan 1970
joan 1970 collected $0.62 from pot
joan 1970: doesn't show hand 
*** SUMMARY ***
Total pot $0.65 | Rake $0.03 
Board [2h 5s 7d 7c]
Seat 1: rpadilla33 (small blind) folded before Flop
Seat 2: joan 1970 (big blind) collected ($0.62)
Seat 3: Bannnkai folded on the Turn
Seat 4: gokudousan folded before Flop (didn't bet)
Seat 5: Laker_Style folded before Flop (didn't bet)
Seat 6: Kimiuran (button) folded before Flop (didn't bet)



PokerStars Hand #222948654421:  Hold'em No Limit ($0.05/$0.10 USD) - 2021/01/23 4:29:36 ET
Table 'Linzia' 6-max Seat #1 is the button
Seat 1: rpadilla33 ($12.85 in chips) 
Seat 2: joan 1970 ($10.32 in chips) 
Seat 3: Bannnkai ($11.96 in chips) 
Seat 4: gokudousan ($18.49 in chips) 
Seat 5: Laker_Style ($18.40 in chips) 
Seat 6: Kimiuran ($10 in chips) 
joan 1970: posts small blind $0.05
Bannnkai: posts big blind $0.10
*** HOLE CARDS ***
gokudousan: folds 
Laker_Style: folds 
Kimiuran has timed out
Kimiuran: folds 
rpadilla33: raises $0.20 to $0.30
joan 1970: calls $0.25
Bannnkai: folds 
*** FLOP *** [Ad 3s 6h]
joan 1970: checks 
rpadilla33: bets $0.30
joan 1970: calls $0.30
*** TURN *** [Ad 3s 6h] [3c]
joan 1970: checks 
rpadilla33: checks 
*** RIVER *** [Ad 3s 6h 3c] [As]
joan 1970: bets $1.20
rpadilla33: folds 
Uncalled bet ($1.20) returned to joan 1970
joan 1970 collected $1.24 from pot
joan 1970: doesn't show hand 
*** SUMMARY ***
Total pot $1.30 | Rake $0.06 
Board [Ad 3s 6h 3c As]
Seat 1: rpadilla33 (button) folded on the River
Seat 2: joan 1970 (small blind) collected ($1.24)
Seat 3: Bannnkai (big blind) folded before Flop
Seat 4: gokudousan folded before Flop (didn't bet)
Seat 5: Laker_Style folded before Flop (didn't bet)
Seat 6: Kimiuran folded before Flop (didn't bet)



PokerStars Hand #222948668227:  Hold'em No Limit ($0.05/$0.10 USD) - 2021/01/23 4:30:28 ET
Table 'Linzia' 6-max Seat #2 is the button
Seat 1: rpadilla33 ($12.25 in chips) 
Seat 2: joan 1970 ($10.96 in chips) 
Seat 3: Bannnkai ($11.86 in chips) 
Seat 4: gokudousan ($18.49 in chips) 
Seat 5: Laker_Style ($18.40 in chips) 
Seat 6: Kimiuran ($10 in chips) 
Bannnkai: posts small blind $0.05
gokudousan: posts big blind $0.10
*** HOLE CARDS ***
Laker_Style: folds 
Kimiuran: folds 
rpadilla33: folds 
joan 1970: folds 
Bannnkai: raises $0.15 to $0.25
gokudousan: folds 
Uncalled bet ($0.15) returned to Bannnkai
Bannnkai collected $0.20 from pot
Bannnkai: doesn't show hand 
*** SUMMARY ***
Total pot $0.20 | Rake $0 
Seat 1: rpadilla33 folded before Flop (didn't bet)
Seat 2: joan 1970 (button) folded before Flop (didn't bet)
Seat 3: Bannnkai (small blind) collected ($0.20)
Seat 4: gokudousan (big blind) folded before Flop
Seat 5: Laker_Style folded before Flop (didn't bet)
Seat 6: Kimiuran folded before Flop (didn't bet)



PokerStars Hand #222948676724:  Hold'em No Limit ($0.05/$0.10 USD) - 2021/01/23 4:31:00 ET
Table 'Linzia' 6-max Seat #3 is the button
Seat 1: rpadilla33 ($12.25 in chips) 
Seat 2: joan 1970 ($10.96 in chips) 
Seat 3: Bannnkai ($11.96 in chips) 
Seat 4: gokudousan ($18.39 in chips) 
Seat 5: Laker_Style ($18.40 in chips) 
Seat 6: Kimiuran ($10 in chips) 
gokudousan: posts small blind $0.05
Laker_Style: posts big blind $0.10
*** HOLE CARDS ***
Kimiuran: raises $0.15 to $0.25
rpadilla33: folds 
joan 1970: folds 
Bannnkai: folds 
gokudousan: folds 
Laker_Style: folds 
Uncalled bet ($0.15) returned to Kimiuran
Kimiuran collected $0.25 from pot
Kimiuran: doesn't show hand 
*** SUMMARY ***
Total pot $0.25 | Rake $0 
Seat 1: rpadilla33 folded before Flop (didn't bet)
Seat 2: joan 1970 folded before Flop (didn't bet)
Seat 3: Bannnkai (button) folded before Flop (didn't bet)
Seat 4: gokudousan (small blind) folded before Flop
Seat 5: Laker_Style (big blind) folded before Flop
Seat 6: Kimiuran collected ($0.25)



PokerStars Hand #222948683762:  Hold'em No Limit ($0.05/$0.10 USD) - 2021/01/23 4:31:26 ET
Table 'Linzia' 6-max Seat #4 is the button
Seat 1: rpadilla33 ($12.25 in chips) 
Seat 2: joan 1970 ($10.96 in chips) 
Seat 3: Bannnkai ($11.96 in chips) 
Seat 4: gokudousan ($18.34 in chips) 
Seat 5: Laker_Style ($18.30 in chips) 
Seat 6: Kimiuran ($10.15 in chips) 
Laker_Style: posts small blind $0.05
Kimiuran: posts big blind $0.10
*** HOLE CARDS ***
rpadilla33: folds 
joan 1970: calls $0.10
Bannnkai: raises $0.30 to $0.40
gokudousan: folds 
Laker_Style: raises $1.08 to $1.48
Kimiuran: folds 
joan 1970: calls $1.38
Bannnkai: raises $1.82 to $3.30
Laker_Style: calls $1.82
joan 1970: calls $1.82
*** FLOP *** [4c Jc Kh]
Laker_Style: checks 
joan 1970: bets $7.66 and is all-in
Bannnkai: calls $7.66
Laker_Style: folds 
*** TURN *** [4c Jc Kh] [2d]
*** RIVER *** [4c Jc Kh 2d] [7d]
*** SHOW DOWN ***
joan 1970: shows [Qd Kd] (a pair of Kings)
Bannnkai: shows [Ad Ah] (a pair of Aces)
Bannnkai cashed out the hand for $19.25 | Cash Out Fee $0.19
*** SUMMARY ***
Total pot $25.32 | Rake $1.14 
Board [4c Jc Kh 2d 7d]
Seat 1: rpadilla33 folded before Flop (didn't bet)
Seat 2: joan 1970 showed [Qd Kd] and lost with a pair of Kings
Seat 3: Bannnkai showed [Ad Ah] and won ($24.18) with a pair of Aces (pot not awarded as player cashed out)
Seat 4: gokudousan (button) folded before Flop (didn't bet)
Seat 5: Laker_Style (small blind) folded on the Flop
Seat 6: Kimiuran (big blind) folded before Flop



PokerStars Hand #222948705242:  Hold'em No Limit ($0.05/$0.10 USD) - 2021/01/23 4:32:47 ET
Table 'Linzia' 6-max Seat #5 is the button
Seat 1: rpadilla33 ($12.25 in chips) 
Seat 3: Bannnkai ($20.25 in chips) 
Seat 4: gokudousan ($18.34 in chips) 
Seat 5: Laker_Style ($15 in chips) 
Seat 6: Kimiuran ($10.05 in chips) 
Kimiuran: posts small blind $0.05
rpadilla33: posts big blind $0.10
*** HOLE CARDS ***
Bannnkai: raises $0.20 to $0.30
gokudousan: folds 
Laker_Style: folds 
Kimiuran: folds 
rpadilla33: folds 
Uncalled bet ($0.20) returned to Bannnkai
Bannnkai collected $0.25 from pot
Bannnkai: doesn't show hand 
*** SUMMARY ***
Total pot $0.25 | Rake $0 
Seat 1: rpadilla33 (big blind) folded before Flop
Seat 3: Bannnkai collected ($0.25)
Seat 4: gokudousan folded before Flop (didn't bet)
Seat 5: Laker_Style (button) folded before Flop (didn't bet)
Seat 6: Kimiuran (small blind) folded before Flop



PokerStars Hand #222948709870:  Hold'em No Limit ($0.05/$0.10 USD) - 2021/01/23 4:33:04 ET
Table 'Linzia' 6-max Seat #6 is the button
Seat 1: rpadilla33 ($12.15 in chips) 
Seat 3: Bannnkai ($20.40 in chips) 
Seat 4: gokudousan ($18.34 in chips) 
Seat 5: Laker_Style ($15 in chips) 
Seat 6: Kimiuran ($10 in chips) 
rpadilla33: posts small blind $0.05
Bannnkai: posts big blind $0.10
*** HOLE CARDS ***
gokudousan: folds 
Laker_Style has timed out
Laker_Style: folds 
Kimiuran: folds 
rpadilla33: calls $0.05
Bannnkai: checks 
*** FLOP *** [9c 5c Kh]
rpadilla33: checks 
Bannnkai: bets $0.10
rpadilla33: calls $0.10
*** TURN *** [9c 5c Kh] [Qd]
rpadilla33: checks 
Bannnkai: checks 
*** RIVER *** [9c 5c Kh Qd] [Qh]
rpadilla33: checks 
Bannnkai: checks 
*** SHOW DOWN ***
rpadilla33: shows [Td 5d] (two pair, Queens and Fives)
Bannnkai: shows [5h Jd] (two pair, Queens and Fives)
rpadilla33 collected $0.19 from pot
Bannnkai collected $0.19 from pot
*** SUMMARY ***
Total pot $0.40 | Rake $0.02 
Board [9c 5c Kh Qd Qh]
Seat 1: rpadilla33 (small blind) showed [Td 5d] and won ($0.19) with two pair, Queens and Fives
Seat 3: Bannnkai (big blind) showed [5h Jd] and won ($0.19) with two pair, Queens and Fives
Seat 4: gokudousan folded before Flop (didn't bet)
Seat 5: Laker_Style folded before Flop (didn't bet)
Seat 6: Kimiuran (button) folded before Flop (didn't bet)



PokerStars Hand #222948720052:  Hold'em No Limit ($0.05/$0.10 USD) - 2021/01/23 4:33:43 ET
Table 'Linzia' 6-max Seat #1 is the button
Seat 1: rpadilla33 ($12.14 in chips) 
Seat 3: Bannnkai ($20.39 in chips) 
Seat 4: gokudousan ($18.34 in chips) 
Seat 5: Laker_Style ($15 in chips) 
Seat 6: Kimiuran ($10 in chips) 
Bannnkai: posts small blind $0.05
gokudousan: posts big blind $0.10
*** HOLE CARDS ***
Laker_Style: folds 
Kimiuran: folds 
rpadilla33: raises $0.20 to $0.30
Bannnkai: folds 
gokudousan: folds 
Uncalled bet ($0.20) returned to rpadilla33
rpadilla33 collected $0.25 from pot
rpadilla33: doesn't show hand 
*** SUMMARY ***
Total pot $0.25 | Rake $0 
Seat 1: rpadilla33 (button) collected ($0.25)
Seat 3: Bannnkai (small blind) folded before Flop
Seat 4: gokudousan (big blind) folded before Flop
Seat 5: Laker_Style folded before Flop (didn't bet)
Seat 6: Kimiuran folded before Flop (didn't bet)



PokerStars Hand #222948723753:  Hold'em No Limit ($0.05/$0.10 USD) - 2021/01/23 4:33:56 ET
Table 'Linzia' 6-max Seat #3 is the button
Seat 1: rpadilla33 ($12.29 in chips) 
Seat 3: Bannnkai ($20.34 in chips) 
Seat 4: gokudousan ($18.24 in chips) 
Seat 5: Laker_Style ($15 in chips) 
Seat 6: Kimiuran ($10 in chips) 
gokudousan: posts small blind $0.05
Laker_Style: posts big blind $0.10
*** HOLE CARDS ***
Kimiuran: folds 
rpadilla33: raises $0.20 to $0.30
Bannnkai: folds 
gokudousan: folds 
Laker_Style: folds 
Uncalled bet ($0.20) returned to rpadilla33
rpadilla33 collected $0.25 from pot
rpadilla33: doesn't show hand 
*** SUMMARY ***
Total pot $0.25 | Rake $0 
Seat 1: rpadilla33 collected ($0.25)
Seat 3: Bannnkai (button) folded before Flop (didn't bet)
Seat 4: gokudousan (small blind) folded before Flop
Seat 5: Laker_Style (big blind) folded before Flop
Seat 6: Kimiuran folded before Flop (didn't bet)



PokerStars Hand #222948726213:  Hold'em No Limit ($0.05/$0.10 USD) - 2021/01/23 4:34:06 ET
Table 'Linzia' 6-max Seat #4 is the button
Seat 1: rpadilla33 ($12.44 in chips) 
Seat 3: Bannnkai ($20.34 in chips) 
Seat 4: gokudousan ($18.19 in chips) 
Seat 5: Laker_Style ($14.90 in chips) 
Seat 6: Kimiuran ($10 in chips) 
Laker_Style: posts small blind $0.05
Kimiuran: posts big blind $0.10
*** HOLE CARDS ***
rpadilla33: folds 
Bannnkai: raises $0.20 to $0.30
gokudousan: folds 
Laker_Style: folds 
Kimiuran: folds 
Uncalled bet ($0.20) returned to Bannnkai
Bannnkai collected $0.25 from pot
Bannnkai: doesn't show hand 
*** SUMMARY ***
Total pot $0.25 | Rake $0 
Seat 1: rpadilla33 folded before Flop (didn't bet)
Seat 3: Bannnkai collected ($0.25)
Seat 4: gokudousan (button) folded before Flop (didn't bet)
Seat 5: Laker_Style (small blind) folded before Flop
Seat 6: Kimiuran (big blind) folded before Flop



PokerStars Hand #222948729405:  Hold'em No Limit ($0.05/$0.10 USD) - 2021/01/23 4:34:18 ET
Table 'Linzia' 6-max Seat #5 is the button
Seat 1: rpadilla33 ($12.44 in chips) 
Seat 3: Bannnkai ($20.49 in chips) 
Seat 4: gokudousan ($18.19 in chips) 
Seat 5: Laker_Style ($14.85 in chips) 
Seat 6: Kimiuran ($10 in chips) 
Kimiuran: posts small blind $0.05
rpadilla33: posts big blind $0.10
*** HOLE CARDS ***
Bannnkai: raises $0.20 to $0.30
gokudousan: folds 
Laker_Style: folds 
Kimiuran: folds 
rpadilla33: folds 
Uncalled bet ($0.20) returned to Bannnkai
Bannnkai collected $0.25 from pot
Bannnkai: doesn't show hand 
*** SUMMARY ***
Total pot $0.25 | Rake $0 
Seat 1: rpadilla33 (big blind) folded before Flop
Seat 3: Bannnkai collected ($0.25)
Seat 4: gokudousan folded before Flop (didn't bet)
Seat 5: Laker_Style (button) folded before Flop (didn't bet)
Seat 6: Kimiuran (small blind) folded before Flop



PokerStars Hand #222948734316:  Hold'em No Limit ($0.05/$0.10 USD) - 2021/01/23 4:34:36 ET
Table 'Linzia' 6-max Seat #6 is the button
Seat 1: rpadilla33 ($12.34 in chips) 
Seat 3: Bannnkai ($20.64 in chips) 
Seat 4: gokudousan ($18.19 in chips) 
Seat 5: Laker_Style ($14.85 in chips) 
Seat 6: Kimiuran ($10 in chips) 
rpadilla33: posts small blind $0.05
Bannnkai: posts big blind $0.10
*** HOLE CARDS ***
gokudousan: raises $0.20 to $0.30
Laker_Style: folds 
Kimiuran: raises $0.60 to $0.90
rpadilla33: folds 
Bannnkai: folds 
gokudousan: raises $1.30 to $2.20
Kimiuran: raises $2.30 to $4.50
gokudousan: folds 
Uncalled bet ($2.30) returned to Kimiuran
Kimiuran collected $4.55 from pot
Kimiuran: doesn't show hand 
*** SUMMARY ***
Total pot $4.55 | Rake $0 
Seat 1: rpadilla33 (small blind) folded before Flop
Seat 3: Bannnkai (big blind) folded before Flop
Seat 4: gokudousan folded before Flop
Seat 5: Laker_Style folded before Flop (didn't bet)
Seat 6: Kimiuran (button) collected ($4.55)



PokerStars Hand #222948752163:  Hold'em No Limit ($0.05/$0.10 USD) - 2021/01/23 4:35:43 ET
Table 'Linzia' 6-max Seat #1 is the button
Seat 1: rpadilla33 ($12.29 in chips) 
Seat 3: Bannnkai ($20.54 in chips) 
Seat 4: gokudousan ($15.99 in chips) 
Seat 5: Laker_Style ($14.85 in chips) 
Seat 6: Kimiuran ($12.35 in chips) 
Bannnkai: posts small blind $0.05
gokudousan: posts big blind $0.10
*** HOLE CARDS ***
Laker_Style: folds 
Kimiuran: raises $0.15 to $0.25
rpadilla33: folds 
Bannnkai: folds 
gokudousan: folds 
Uncalled bet ($0.15) returned to Kimiuran
Kimiuran collected $0.25 from pot
Kimiuran: doesn't show hand 
*** SUMMARY ***
Total pot $0.25 | Rake $0 
Seat 1: rpadilla33 (button) folded before Flop (didn't bet)
Seat 3: Bannnkai (small blind) folded before Flop
Seat 4: gokudousan (big blind) folded before Flop
Seat 5: Laker_Style folded before Flop (didn't bet)
Seat 6: Kimiuran collected ($0.25)



PokerStars Hand #222948759653:  Hold'em No Limit ($0.05/$0.10 USD) - 2021/01/23 4:36:10 ET
Table 'Linzia' 6-max Seat #3 is the button
Seat 1: rpadilla33 ($12.29 in chips) 
Seat 3: Bannnkai ($20.49 in chips) 
Seat 4: gokudousan ($15.89 in chips) 
Seat 5: Laker_Style ($14.85 in chips) 
Seat 6: Kimiuran ($12.50 in chips) 
gokudousan: posts small blind $0.05
Laker_Style: posts big blind $0.10
*** HOLE CARDS ***
Kimiuran: folds 
rpadilla33: folds 
Bannnkai has timed out
Bannnkai: folds 
gokudousan: folds 
Uncalled bet ($0.05) returned to Laker_Style
Laker_Style collected $0.10 from pot
Laker_Style: doesn't show hand 
*** SUMMARY ***
Total pot $0.10 | Rake $0 
Seat 1: rpadilla33 folded before Flop (didn't bet)
Seat 3: Bannnkai (button) folded before Flop (didn't bet)
Seat 4: gokudousan (small blind) folded before Flop
Seat 5: Laker_Style (big blind) collected ($0.10)
Seat 6: Kimiuran folded before Flop (didn't bet)



PokerStars Hand #222948764726:  Hold'em No Limit ($0.05/$0.10 USD) - 2021/01/23 4:36:29 ET
Table 'Linzia' 6-max Seat #4 is the button
Seat 1: rpadilla33 ($12.29 in chips) 
Seat 4: gokudousan ($15.84 in chips) 
Seat 5: Laker_Style ($14.90 in chips) 
Seat 6: Kimiuran ($12.50 in chips) 
Laker_Style: posts small blind $0.05
Kimiuran: posts big blind $0.10
*** HOLE CARDS ***
rpadilla33: folds 
gokudousan: raises $0.20 to $0.30
Laker_Style: folds 
Kimiuran: folds 
Uncalled bet ($0.20) returned to gokudousan
gokudousan collected $0.25 from pot
gokudousan: doesn't show hand 
*** SUMMARY ***
Total pot $0.25 | Rake $0 
Seat 1: rpadilla33 folded before Flop (didn't bet)
Seat 4: gokudousan (button) collected ($0.25)
Seat 5: Laker_Style (small blind) folded before Flop
Seat 6: Kimiuran (big blind) folded before Flop



PokerStars Hand #222948769191:  Hold'em No Limit ($0.05/$0.10 USD) - 2021/01/23 4:36:46 ET
Table 'Linzia' 6-max Seat #5 is the button
Seat 1: rpadilla33 ($12.29 in chips) 
Seat 3: Bannnkai ($20.49 in chips) 
Seat 4: gokudousan ($15.99 in chips) 
Seat 5: Laker_Style ($14.85 in chips) 
Seat 6: Kimiuran ($12.40 in chips) 
Kimiuran: posts small blind $0.05
rpadilla33: posts big blind $0.10
*** HOLE CARDS ***
Bannnkai: folds 
gokudousan: folds 
Laker_Style: folds 
Kimiuran: raises $0.20 to $0.30
rpadilla33: folds 
Uncalled bet ($0.20) returned to Kimiuran
Kimiuran collected $0.20 from pot
Kimiuran: doesn't show hand 
*** SUMMARY ***
Total pot $0.20 | Rake $0 
Seat 1: rpadilla33 (big blind) folded before Flop
Seat 3: Bannnkai folded before Flop (didn't bet)
Seat 4: gokudousan folded before Flop (didn't bet)
Seat 5: Laker_Style (button) folded before Flop (didn't bet)
Seat 6: Kimiuran (small blind) collected ($0.20)



PokerStars Hand #222948773542:  Hold'em No Limit ($0.05/$0.10 USD) - 2021/01/23 4:37:02 ET
Table 'Linzia' 6-max Seat #6 is the button
Seat 1: rpadilla33 ($12.19 in chips) 
Seat 3: Bannnkai ($20.49 in chips) 
Seat 4: gokudousan ($15.99 in chips) 
Seat 5: Laker_Style ($14.85 in chips) 
Seat 6: Kimiuran ($12.50 in chips) 
rpadilla33: posts small blind $0.05
Bannnkai: posts big blind $0.10
*** HOLE CARDS ***
gokudousan: folds 
Laker_Style: folds 
Kimiuran: folds 
rpadilla33: raises $0.20 to $0.30
Bannnkai: folds 
Uncalled bet ($0.20) returned to rpadilla33
rpadilla33 collected $0.20 from pot
rpadilla33: doesn't show hand 
*** SUMMARY ***
Total pot $0.20 | Rake $0 
Seat 1: rpadilla33 (small blind) collected ($0.20)
Seat 3: Bannnkai (big blind) folded before Flop
Seat 4: gokudousan folded before Flop (didn't bet)
Seat 5: Laker_Style folded before Flop (didn't bet)
Seat 6: Kimiuran (button) folded before Flop (didn't bet)



PokerStars Hand #222948777410:  Hold'em No Limit ($0.05/$0.10 USD) - 2021/01/23 4:37:16 ET
Table 'Linzia' 6-max Seat #1 is the button
Seat 1: rpadilla33 ($12.29 in chips) 
Seat 3: Bannnkai ($20.39 in chips) 
Seat 4: gokudousan ($15.99 in chips) 
Seat 5: Laker_Style ($14.85 in chips) 
Seat 6: Kimiuran ($12.50 in chips) 
Bannnkai: posts small blind $0.05
gokudousan: posts big blind $0.10
*** HOLE CARDS ***
Laker_Style has timed out
Laker_Style: folds 
Kimiuran: raises $0.15 to $0.25
rpadilla33: raises $0.65 to $0.90
Bannnkai has timed out
Bannnkai: folds 
gokudousan: folds 
Kimiuran: calls $0.65
*** FLOP *** [Js 3h 9d]
Kimiuran: checks 
rpadilla33: bets $0.60
Kimiuran: calls $0.60
*** TURN *** [Js 3h 9d] [Ts]
Kimiuran: checks 
Bannnkai leaves the table
rpadilla33: bets $2.70
Kimiuran: calls $2.70
*** RIVER *** [Js 3h 9d Ts] [Jd]
Kimiuran: checks 
rpadilla33: bets $8.09 and is all-in
Kimiuran: calls $8.09
*** SHOW DOWN ***
rpadilla33: shows [Tc Jc] (a full house, Jacks full of Tens)
Kimiuran: shows [8d 7d] (a straight, Seven to Jack)
rpadilla33 collected $23.62 from pot
*** SUMMARY ***
Total pot $24.73 | Rake $1.11 
Board [Js 3h 9d Ts Jd]
Seat 1: rpadilla33 (button) showed [Tc Jc] and won ($23.62) with a full house, Jacks full of Tens
Seat 3: Bannnkai (small blind) folded before Flop
Seat 4: gokudousan (big blind) folded before Flop
Seat 5: Laker_Style folded before Flop (didn't bet)
Seat 6: Kimiuran showed [8d 7d] and lost with a straight, Seven to Jack



PokerStars Hand #222948808734:  Hold'em No Limit ($0.05/$0.10 USD) - 2021/01/23 4:39:12 ET
Table 'Linzia' 6-max Seat #4 is the button
Seat 1: rpadilla33 ($23.62 in chips) 
Seat 4: gokudousan ($15.89 in chips) 
Seat 5: Laker_Style ($14.85 in chips) 
Seat 6: Kimiuran ($10 in chips) 
Laker_Style: posts small blind $0.05
Kimiuran: posts big blind $0.10
*** HOLE CARDS ***
rpadilla33: folds 
gokudousan: folds 
Laker_Style: folds 
Uncalled bet ($0.05) returned to Kimiuran
Kimiuran collected $0.10 from pot
Kimiuran: doesn't show hand 
*** SUMMARY ***
Total pot $0.10 | Rake $0 
Seat 1: rpadilla33 folded before Flop (didn't bet)
Seat 4: gokudousan (button) folded before Flop (didn't bet)
Seat 5: Laker_Style (small blind) folded before Flop
Seat 6: Kimiuran (big blind) collected ($0.10)



PokerStars Hand #222948812633:  Hold'em No Limit ($0.05/$0.10 USD) - 2021/01/23 4:39:26 ET
Table 'Linzia' 6-max Seat #5 is the button
Seat 1: rpadilla33 ($23.62 in chips) 
Seat 4: gokudousan ($15.89 in chips) 
Seat 5: Laker_Style ($14.80 in chips) 
Seat 6: Kimiuran ($10.05 in chips) 
Kimiuran: posts small blind $0.05
rpadilla33: posts big blind $0.10
*** HOLE CARDS ***
gokudousan: folds 
Laker_Style: raises $0.15 to $0.25
Kimiuran: folds 
rpadilla33: folds 
Uncalled bet ($0.15) returned to Laker_Style
Laker_Style collected $0.25 from pot
Laker_Style: doesn't show hand 
*** SUMMARY ***
Total pot $0.25 | Rake $0 
Seat 1: rpadilla33 (big blind) folded before Flop
Seat 4: gokudousan folded before Flop (didn't bet)
Seat 5: Laker_Style (button) collected ($0.25)
Seat 6: Kimiuran (small blind) folded before Flop



PokerStars Hand #222948815915:  Hold'em No Limit ($0.05/$0.10 USD) - 2021/01/23 4:39:38 ET
Table 'Linzia' 6-max Seat #6 is the button
Seat 1: rpadilla33 ($23.52 in chips) 
Seat 4: gokudousan ($15.89 in chips) 
Seat 5: Laker_Style ($14.95 in chips) 
Seat 6: Kimiuran ($10 in chips) 
rpadilla33: posts small blind $0.05
gokudousan: posts big blind $0.10
*** HOLE CARDS ***
l KAAK l joins the table at seat #3 
Laker_Style has timed out
Laker_Style: folds 
Kimiuran: folds 
rpadilla33: folds 
Uncalled bet ($0.05) returned to gokudousan
gokudousan collected $0.10 from pot
joan 1970 was removed from the table for failing to post
joan 1970 leaves the table
gokudousan: doesn't show hand 
*** SUMMARY ***
Total pot $0.10 | Rake $0 
Seat 1: rpadilla33 (small blind) folded before Flop
Seat 4: gokudousan (big blind) collected ($0.10)
Seat 5: Laker_Style folded before Flop (didn't bet)
Seat 6: Kimiuran (button) folded before Flop (didn't bet)



PokerStars Hand #222948820549:  Hold'em No Limit ($0.05/$0.10 USD) - 2021/01/23 4:39:55 ET
Table 'Linzia' 6-max Seat #1 is the button
Seat 1: rpadilla33 ($23.47 in chips) 
Seat 4: gokudousan ($15.94 in chips) 
Seat 5: Laker_Style ($14.95 in chips) 
Seat 6: Kimiuran ($10 in chips) 
gokudousan: posts small blind $0.05
Laker_Style: posts big blind $0.10
*** HOLE CARDS ***
Kimiuran: folds 
rpadilla33: raises $0.20 to $0.30
gokudousan: folds 
Laker_Style: folds 
Uncalled bet ($0.20) returned to rpadilla33
rpadilla33 collected $0.25 from pot
rpadilla33: doesn't show hand 
*** SUMMARY ***
Total pot $0.25 | Rake $0 
Seat 1: rpadilla33 (button) collected ($0.25)
Seat 4: gokudousan (small blind) folded before Flop
Seat 5: Laker_Style (big blind) folded before Flop
Seat 6: Kimiuran folded before Flop (didn't bet)



PokerStars Hand #222948824369:  Hold'em No Limit ($0.05/$0.10 USD) - 2021/01/23 4:40:09 ET
Table 'Linzia' 6-max Seat #4 is the button
Seat 1: rpadilla33 ($23.62 in chips) 
Seat 4: gokudousan ($15.89 in chips) 
Seat 5: Laker_Style ($14.85 in chips) 
Seat 6: Kimiuran ($10 in chips) 
Laker_Style: posts small blind $0.05
Kimiuran: posts big blind $0.10
l KAAK l: sits out 
*** HOLE CARDS ***
rpadilla33: folds 
gokudousan: folds 
Laker_Style: folds 
Uncalled bet ($0.05) returned to Kimiuran
Kimiuran collected $0.10 from pot
Kimiuran: doesn't show hand 
*** SUMMARY ***
Total pot $0.10 | Rake $0 
Seat 1: rpadilla33 folded before Flop (didn't bet)
Seat 4: gokudousan (button) folded before Flop (didn't bet)
Seat 5: Laker_Style (small blind) folded before Flop
Seat 6: Kimiuran (big blind) collected ($0.10)



PokerStars Hand #222948829299:  Hold'em No Limit ($0.05/$0.10 USD) - 2021/01/23 4:40:26 ET
Table 'Linzia' 6-max Seat #5 is the button
Seat 1: rpadilla33 ($23.62 in chips) 
Seat 4: gokudousan ($15.89 in chips) 
Seat 5: Laker_Style ($14.80 in chips) 
Seat 6: Kimiuran ($10.05 in chips) 
Kimiuran: posts small blind $0.05
rpadilla33: posts big blind $0.10
l KAAK l: sits out 
*** HOLE CARDS ***
gokudousan: folds 
Laker_Style: raises $0.15 to $0.25
Kimiuran: folds 
rpadilla33: folds 
Uncalled bet ($0.15) returned to Laker_Style
Laker_Style collected $0.25 from pot
Laker_Style: doesn't show hand 
*** SUMMARY ***
Total pot $0.25 | Rake $0 
Seat 1: rpadilla33 (big blind) folded before Flop
Seat 4: gokudousan folded before Flop (didn't bet)
Seat 5: Laker_Style (button) collected ($0.25)
Seat 6: Kimiuran (small blind) folded before Flop



PokerStars Hand #222948835073:  Hold'em No Limit ($0.05/$0.10 USD) - 2021/01/23 4:40:47 ET
Table 'Linzia' 6-max Seat #6 is the button
Seat 1: rpadilla33 ($23.52 in chips) 
Seat 3: l KAAK l ($10 in chips) 
Seat 4: gokudousan ($15.89 in chips) 
Seat 5: Laker_Style ($14.95 in chips) 
Seat 6: Kimiuran ($10 in chips) 
rpadilla33: posts small blind $0.05
l KAAK l: posts big blind $0.10
*** HOLE CARDS ***
gokudousan: raises $0.20 to $0.30
Laker_Style: folds 
Kimiuran: folds 
rpadilla33: folds 
l KAAK l: calls $0.20
*** FLOP *** [Qh Qc Kd]
l KAAK l: checks 
gokudousan: bets $0.30
l KAAK l: calls $0.30
*** TURN *** [Qh Qc Kd] [8h]
l KAAK l: checks 
gokudousan: checks 
*** RIVER *** [Qh Qc Kd 8h] [Ac]
l KAAK l: checks 
gokudousan: checks 
*** SHOW DOWN ***
l KAAK l: shows [Ts Td] (two pair, Queens and Tens)
gokudousan: mucks hand 
l KAAK l collected $1.19 from pot
*** SUMMARY ***
Total pot $1.25 | Rake $0.06 
Board [Qh Qc Kd 8h Ac]
Seat 1: rpadilla33 (small blind) folded before Flop
Seat 3: l KAAK l (big blind) showed [Ts Td] and won ($1.19) with two pair, Queens and Tens
Seat 4: gokudousan mucked
Seat 5: Laker_Style folded before Flop (didn't bet)
Seat 6: Kimiuran (button) folded before Flop (didn't bet)



PokerStars Hand #222948845521:  Hold'em No Limit ($0.05/$0.10 USD) - 2021/01/23 4:41:25 ET
Table 'Linzia' 6-max Seat #1 is the button
Seat 1: rpadilla33 ($23.47 in chips) 
Seat 3: l KAAK l ($10.59 in chips) 
Seat 4: gokudousan ($15.29 in chips) 
Seat 5: Laker_Style ($14.95 in chips) 
Seat 6: Kimiuran ($10 in chips) 
l KAAK l: posts small blind $0.05
gokudousan: posts big blind $0.10
*** HOLE CARDS ***
Laker_Style has timed out
Laker_Style: folds 
Kimiuran: folds 
rpadilla33: folds 
l KAAK l: folds 
Uncalled bet ($0.05) returned to gokudousan
gokudousan collected $0.10 from pot
gokudousan: doesn't show hand 
*** SUMMARY ***
Total pot $0.10 | Rake $0 
Seat 1: rpadilla33 (button) folded before Flop (didn't bet)
Seat 3: l KAAK l (small blind) folded before Flop
Seat 4: gokudousan (big blind) collected ($0.10)
Seat 5: Laker_Style folded before Flop (didn't bet)
Seat 6: Kimiuran folded before Flop (didn't bet)



PokerStars Hand #222948850518:  Hold'em No Limit ($0.05/$0.10 USD) - 2021/01/23 4:41:43 ET
Table 'Linzia' 6-max Seat #3 is the button
Seat 1: rpadilla33 ($23.47 in chips) 
Seat 3: l KAAK l ($10.54 in chips) 
Seat 4: gokudousan ($15.34 in chips) 
Seat 5: Laker_Style ($14.95 in chips) 
Seat 6: Kimiuran ($10 in chips) 
gokudousan: posts small blind $0.05
Laker_Style: posts big blind $0.10
*** HOLE CARDS ***
Kimiuran: raises $0.15 to $0.25
rpadilla33: calls $0.25
l KAAK l: folds 
gokudousan: folds 
Laker_Style: calls $0.15
*** FLOP *** [Js 7s 4s]
Laker_Style: checks 
Kimiuran: checks 
rpadilla33: checks 
*** TURN *** [Js 7s 4s] [Jd]
Laker_Style: checks 
Kimiuran: bets $0.51
rpadilla33: calls $0.51
Laker_Style: folds 
*** RIVER *** [Js 7s 4s Jd] [Jc]
Kimiuran: checks 
rpadilla33: checks 
*** SHOW DOWN ***
Kimiuran: shows [Qc Ac] (three of a kind, Jacks)
rpadilla33: shows [Tc Ts] (a full house, Jacks full of Tens)
rpadilla33 collected $1.74 from pot
*** SUMMARY ***
Total pot $1.82 | Rake $0.08 
Board [Js 7s 4s Jd Jc]
Seat 1: rpadilla33 showed [Tc Ts] and won ($1.74) with a full house, Jacks full of Tens
Seat 3: l KAAK l (button) folded before Flop (didn't bet)
Seat 4: gokudousan (small blind) folded before Flop
Seat 5: Laker_Style (big blind) folded on the Turn
Seat 6: Kimiuran showed [Qc Ac] and lost with three of a kind, Jacks



PokerStars Hand #222948869840:  Hold'em No Limit ($0.05/$0.10 USD) - 2021/01/23 4:42:42 ET
Table 'Linzia' 6-max Seat #4 is the button
Seat 1: rpadilla33 ($24.45 in chips) 
Seat 3: l KAAK l ($10.54 in chips) 
Seat 4: gokudousan ($15.29 in chips) 
Seat 5: Laker_Style ($14.70 in chips) 
Laker_Style: posts small blind $0.05
Kimiuran: is sitting out 
rpadilla33: posts big blind $0.10
*** HOLE CARDS ***
l KAAK l: raises $0.17 to $0.27
gokudousan: folds 
Kimiuran leaves the table
Laker_Style: folds 
rpadilla33: folds 
Uncalled bet ($0.17) returned to l KAAK l
l KAAK l collected $0.25 from pot
l KAAK l: doesn't show hand 
*** SUMMARY ***
Total pot $0.25 | Rake $0 
Seat 1: rpadilla33 (big blind) folded before Flop
Seat 3: l KAAK l collected ($0.25)
Seat 4: gokudousan (button) folded before Flop (didn't bet)
Seat 5: Laker_Style (small blind) folded before Flop



PokerStars Hand #222948873052:  Hold'em No Limit ($0.05/$0.10 USD) - 2021/01/23 4:42:54 ET
Table 'Linzia' 6-max Seat #5 is the button
Seat 1: rpadilla33 ($24.35 in chips) 
Seat 3: l KAAK l ($10.69 in chips) 
Seat 4: gokudousan ($15.29 in chips) 
Seat 5: Laker_Style ($14.65 in chips) 
rpadilla33: posts small blind $0.05
l KAAK l: posts big blind $0.10
*** HOLE CARDS ***
gokudousan: folds 
Laker_Style: folds 
rpadilla33: calls $0.05
l KAAK l: checks 
*** FLOP *** [7h Tc 5h]
rpadilla33: checks 
l KAAK l: checks 
*** TURN *** [7h Tc 5h] [Kd]
rpadilla33: checks 
l KAAK l: checks 
*** RIVER *** [7h Tc 5h Kd] [2s]
rpadilla33: checks 
l KAAK l: checks 
*** SHOW DOWN ***
rpadilla33: shows [4d Ad] (high card Ace)
l KAAK l: shows [6d 2d] (a pair of Deuces)
l KAAK l collected $0.19 from pot
*** SUMMARY ***
Total pot $0.20 | Rake $0.01 
Board [7h Tc 5h Kd 2s]
Seat 1: rpadilla33 (small blind) showed [4d Ad] and lost with high card Ace
Seat 3: l KAAK l (big blind) showed [6d 2d] and won ($0.19) with a pair of Deuces
Seat 4: gokudousan folded before Flop (didn't bet)
Seat 5: Laker_Style (button) folded before Flop (didn't bet)



PokerStars Hand #222948882563:  Hold'em No Limit ($0.05/$0.10 USD) - 2021/01/23 4:43:28 ET
Table 'Linzia' 6-max Seat #1 is the button
Seat 1: rpadilla33 ($24.25 in chips) 
Seat 4: gokudousan ($15.29 in chips) 
Seat 5: Laker_Style ($14.65 in chips) 
gokudousan: posts small blind $0.05
Laker_Style: posts big blind $0.10
*** HOLE CARDS ***
l KAAK l leaves the table
rpadilla33: raises $0.20 to $0.30
gokudousan: calls $0.25
Laker_Style: calls $0.20
*** FLOP *** [Ks 7c 8c]
gokudousan: checks 
Laker_Style: checks 
rpadilla33: bets $0.40
gokudousan: raises $0.80 to $1.20
Laker_Style: folds 
rpadilla33: folds 
Uncalled bet ($0.80) returned to gokudousan
gokudousan collected $1.62 from pot
gokudousan: doesn't show hand 
*** SUMMARY ***
Total pot $1.70 | Rake $0.08 
Board [Ks 7c 8c]
Seat 1: rpadilla33 (button) folded on the Flop
Seat 4: gokudousan (small blind) collected ($1.62)
Seat 5: Laker_Style (big blind) folded on the Flop



PokerStars Hand #222948898855:  Hold'em No Limit ($0.05/$0.10 USD) - 2021/01/23 4:44:26 ET
Table 'Linzia' 6-max Seat #5 is the button
Seat 4: gokudousan ($16.21 in chips) 
Seat 5: Laker_Style ($14.35 in chips) 
Laker_Style: posts small blind $0.05
rpadilla33: is sitting out 
gokudousan: posts big blind $0.10
*** HOLE CARDS ***
rpadilla33 leaves the table
Laker_Style: folds 
Uncalled bet ($0.05) returned to gokudousan
gokudousan collected $0.10 from pot
gokudousan: doesn't show hand 
*** SUMMARY ***
Total pot $0.10 | Rake $0 
Seat 4: gokudousan (big blind) collected ($0.10)
Seat 5: Laker_Style (button) (small blind) folded before Flop



PokerStars Hand #222948901466:  Hold'em No Limit ($0.05/$0.10 USD) - 2021/01/23 4:44:35 ET
Table 'Linzia' 6-max Seat #4 is the button
Seat 4: gokudousan ($16.26 in chips) 
Seat 5: Laker_Style ($14.30 in chips) 
gokudousan: posts small blind $0.05
Laker_Style: posts big blind $0.10
*** HOLE CARDS ***
gokudousan: folds 
Uncalled bet ($0.05) returned to Laker_Style
gokudousan leaves the table
Laker_Style collected $0.10 from pot
Laker_Style: doesn't show hand 
*** SUMMARY ***
Total pot $0.10 | Rake $0 
Seat 4: gokudousan (button) (small blind) folded before Flop
Seat 5: Laker_Style (big blind) collected ($0.10)



