PokerStars Hand #222947146847:  Hold'em No Limit ($0.05/$0.10 USD) - 2021/01/23 2:46:41 ET
Table 'Capricorn II' 6-max Seat #4 is the button
Seat 1: rodimana ($5.94 in chips) 
Seat 2: DezKD ($10 in chips) 
Seat 3: marvinc02317 ($11.10 in chips) 
Seat 4: Vorontsov28 ($10 in chips) 
Seat 5: Ignatychok ($4.05 in chips) 
Seat 6: Alexandr.mh ($10 in chips) 
Ignatychok: posts small blind $0.05
Alexandr.mh: posts big blind $0.10
*** HOLE CARDS ***
rodimana: raises $0.10 to $0.20
DezKD: folds 
marvinc02317: calls $0.20
Vorontsov28: folds 
Ignatychok: folds 
Alexandr.mh: calls $0.10
*** FLOP *** [7d 5h 5d]
Alexandr.mh: checks 
rodimana: bets $0.30
marvinc02317: calls $0.30
Alexandr.mh: folds 
*** TURN *** [7d 5h 5d] [5s]
rodimana: checks 
marvinc02317: bets $1.19
rodimana: folds 
Uncalled bet ($1.19) returned to marvinc02317
marvinc02317 collected $1.19 from pot
*** SUMMARY ***
Total pot $1.25 | Rake $0.06 
Board [7d 5h 5d 5s]
Seat 1: rodimana folded on the Turn
Seat 2: DezKD folded before Flop (didn't bet)
Seat 3: marvinc02317 collected ($1.19)
Seat 4: Vorontsov28 (button) folded before Flop (didn't bet)
Seat 5: Ignatychok (small blind) folded before Flop
Seat 6: Alexandr.mh (big blind) folded on the Flop



PokerStars Hand #222947156166:  Hold'em No Limit ($0.05/$0.10 USD) - 2021/01/23 2:47:21 ET
Table 'Capricorn II' 6-max Seat #5 is the button
Seat 1: rodimana ($5.44 in chips) 
Seat 2: DezKD ($10 in chips) 
Seat 3: marvinc02317 ($11.79 in chips) 
Seat 4: Vorontsov28 ($10 in chips) 
Seat 5: Ignatychok ($4 in chips) 
Seat 6: Alexandr.mh ($10 in chips) 
Alexandr.mh: posts small blind $0.05
rodimana: posts big blind $0.10
*** HOLE CARDS ***
DezKD: folds 
marvinc02317: folds 
Vorontsov28: folds 
Ignatychok: folds 
Alexandr.mh: calls $0.05
rodimana: checks 
*** FLOP *** [Kd 8c 9d]
Alexandr.mh: checks 
rodimana: bets $0.20
Alexandr.mh: folds 
Uncalled bet ($0.20) returned to rodimana
rodimana collected $0.19 from pot
rodimana: doesn't show hand 
*** SUMMARY ***
Total pot $0.20 | Rake $0.01 
Board [Kd 8c 9d]
Seat 1: rodimana (big blind) collected ($0.19)
Seat 2: DezKD folded before Flop (didn't bet)
Seat 3: marvinc02317 folded before Flop (didn't bet)
Seat 4: Vorontsov28 folded before Flop (didn't bet)
Seat 5: Ignatychok (button) folded before Flop (didn't bet)
Seat 6: Alexandr.mh (small blind) folded on the Flop



PokerStars Hand #222947164588:  Hold'em No Limit ($0.05/$0.10 USD) - 2021/01/23 2:47:57 ET
Table 'Capricorn II' 6-max Seat #6 is the button
Seat 1: rodimana ($5.53 in chips) 
Seat 2: DezKD ($10 in chips) 
Seat 3: marvinc02317 ($11.79 in chips) 
Seat 4: Vorontsov28 ($10 in chips) 
Seat 5: Ignatychok ($4 in chips) 
Seat 6: Alexandr.mh ($10 in chips) 
rodimana: posts small blind $0.05
DezKD: posts big blind $0.10
*** HOLE CARDS ***
marvinc02317: folds 
Vorontsov28: folds 
Ignatychok: raises $0.20 to $0.30
Alexandr.mh: calls $0.30
rodimana: folds 
DezKD: folds 
*** FLOP *** [6h Kh Ah]
Ignatychok: bets $0.36
Alexandr.mh: folds 
Uncalled bet ($0.36) returned to Ignatychok
Ignatychok collected $0.72 from pot
*** SUMMARY ***
Total pot $0.75 | Rake $0.03 
Board [6h Kh Ah]
Seat 1: rodimana (small blind) folded before Flop
Seat 2: DezKD (big blind) folded before Flop
Seat 3: marvinc02317 folded before Flop (didn't bet)
Seat 4: Vorontsov28 folded before Flop (didn't bet)
Seat 5: Ignatychok collected ($0.72)
Seat 6: Alexandr.mh (button) folded on the Flop



PokerStars Hand #222947173646:  Hold'em No Limit ($0.05/$0.10 USD) - 2021/01/23 2:48:35 ET
Table 'Capricorn II' 6-max Seat #1 is the button
Seat 1: rodimana ($5.48 in chips) 
Seat 2: DezKD ($10 in chips) 
Seat 3: marvinc02317 ($11.79 in chips) 
Seat 4: Vorontsov28 ($10 in chips) 
Seat 5: Ignatychok ($4.42 in chips) 
Seat 6: Alexandr.mh ($10 in chips) 
DezKD: posts small blind $0.05
marvinc02317: posts big blind $0.10
*** HOLE CARDS ***
Vorontsov28: folds 
Ignatychok: folds 
Alexandr.mh: folds 
rodimana: folds 
DezKD: raises $0.15 to $0.25
marvinc02317: folds 
Uncalled bet ($0.15) returned to DezKD
DezKD collected $0.20 from pot
DezKD: doesn't show hand 
*** SUMMARY ***
Total pot $0.20 | Rake $0 
Seat 1: rodimana (button) folded before Flop (didn't bet)
Seat 2: DezKD (small blind) collected ($0.20)
Seat 3: marvinc02317 (big blind) folded before Flop
Seat 4: Vorontsov28 folded before Flop (didn't bet)
Seat 5: Ignatychok folded before Flop (didn't bet)
Seat 6: Alexandr.mh folded before Flop (didn't bet)



PokerStars Hand #222947177473:  Hold'em No Limit ($0.05/$0.10 USD) - 2021/01/23 2:48:51 ET
Table 'Capricorn II' 6-max Seat #2 is the button
Seat 1: rodimana ($5.48 in chips) 
Seat 2: DezKD ($10.10 in chips) 
Seat 3: marvinc02317 ($11.69 in chips) 
Seat 4: Vorontsov28 ($10 in chips) 
Seat 5: Ignatychok ($4.42 in chips) 
Seat 6: Alexandr.mh ($10 in chips) 
marvinc02317: posts small blind $0.05
Vorontsov28: posts big blind $0.10
*** HOLE CARDS ***
Ignatychok: folds 
Alexandr.mh: folds 
rodimana: raises $0.10 to $0.20
Alexandr.mh leaves the table
DezKD has timed out
DezKD: folds 
marvinc02317: calls $0.15
Vorontsov28: folds 
*** FLOP *** [Qh Jc 2d]
marvinc02317: checks 
rodimana: checks 
*** TURN *** [Qh Jc 2d] [9c]
marvinc02317: checks 
rodimana: bets $0.26
marvinc02317: folds 
Uncalled bet ($0.26) returned to rodimana
rodimana collected $0.48 from pot
rodimana: doesn't show hand 
*** SUMMARY ***
Total pot $0.50 | Rake $0.02 
Board [Qh Jc 2d 9c]
Seat 1: rodimana collected ($0.48)
Seat 2: DezKD (button) folded before Flop (didn't bet)
Seat 3: marvinc02317 (small blind) folded on the Turn
Seat 4: Vorontsov28 (big blind) folded before Flop
Seat 5: Ignatychok folded before Flop (didn't bet)
Seat 6: Alexandr.mh folded before Flop (didn't bet)



PokerStars Hand #222947188549:  Hold'em No Limit ($0.05/$0.10 USD) - 2021/01/23 2:49:38 ET
Table 'Capricorn II' 6-max Seat #3 is the button
Seat 1: rodimana ($5.76 in chips) 
Seat 3: marvinc02317 ($11.49 in chips) 
Seat 4: Vorontsov28 ($10 in chips) 
Seat 5: Ignatychok ($4.42 in chips) 
Vorontsov28: posts small blind $0.05
DezKD leaves the table
Ignatychok: posts big blind $0.10
*** HOLE CARDS ***
rodimana: folds 
marvinc02317: folds 
Vorontsov28: folds 
Uncalled bet ($0.05) returned to Ignatychok
Ignatychok collected $0.10 from pot
Ignatychok: doesn't show hand 
*** SUMMARY ***
Total pot $0.10 | Rake $0 
Seat 1: rodimana folded before Flop (didn't bet)
Seat 3: marvinc02317 (button) folded before Flop (didn't bet)
Seat 4: Vorontsov28 (small blind) folded before Flop
Seat 5: Ignatychok (big blind) collected ($0.10)



PokerStars Hand #222947190589:  Hold'em No Limit ($0.05/$0.10 USD) - 2021/01/23 2:49:47 ET
Table 'Capricorn II' 6-max Seat #4 is the button
Seat 1: rodimana ($5.76 in chips) 
Seat 3: marvinc02317 ($11.49 in chips) 
Seat 4: Vorontsov28 ($10 in chips) 
Seat 5: Ignatychok ($4.47 in chips) 
Ignatychok: posts small blind $0.05
rodimana: posts big blind $0.10
*** HOLE CARDS ***
marvinc02317: folds 
Vorontsov28: folds 
Ignatychok: calls $0.05
rodimana: raises $0.30 to $0.40
Ignatychok: folds 
Uncalled bet ($0.30) returned to rodimana
petrovichkag joins the table at seat #2 
rodimana collected $0.20 from pot
rodimana: doesn't show hand 
*** SUMMARY ***
Total pot $0.20 | Rake $0 
Seat 1: rodimana (big blind) collected ($0.20)
Seat 3: marvinc02317 folded before Flop (didn't bet)
Seat 4: Vorontsov28 (button) folded before Flop (didn't bet)
Seat 5: Ignatychok (small blind) folded before Flop



PokerStars Hand #222947194506:  Hold'em No Limit ($0.05/$0.10 USD) - 2021/01/23 2:50:04 ET
Table 'Capricorn II' 6-max Seat #5 is the button
Seat 1: rodimana ($5.86 in chips) 
Seat 2: petrovichkag ($10 in chips) 
Seat 3: marvinc02317 ($11.49 in chips) 
Seat 4: Vorontsov28 ($10 in chips) 
Seat 5: Ignatychok ($4.37 in chips) 
rodimana: posts small blind $0.05
petrovichkag: posts big blind $0.10
*** HOLE CARDS ***
Jermein joins the table at seat #6 
marvinc02317: folds 
Vorontsov28: folds 
Ignatychok: calls $0.10
rodimana: calls $0.05
petrovichkag: checks 
*** FLOP *** [Qs 8c Kd]
rodimana: checks 
petrovichkag: checks 
Ignatychok is disconnected 
Ignatychok has timed out while disconnected
Ignatychok: checks 
*** TURN *** [Qs 8c Kd] [8s]
rodimana: checks 
petrovichkag: checks 
Ignatychok has timed out while disconnected
Ignatychok: checks 
*** RIVER *** [Qs 8c Kd 8s] [Jh]
rodimana: checks 
petrovichkag: checks 
Ignatychok is connected 
Ignatychok is disconnected 
Ignatychok is connected 
Ignatychok: bets $0.10
rodimana: folds 
petrovichkag: folds 
Uncalled bet ($0.10) returned to Ignatychok
Ignatychok collected $0.29 from pot
Ignatychok: doesn't show hand 
*** SUMMARY ***
Total pot $0.30 | Rake $0.01 
Board [Qs 8c Kd 8s Jh]
Seat 1: rodimana (small blind) folded on the River
Seat 2: petrovichkag (big blind) folded on the River
Seat 3: marvinc02317 folded before Flop (didn't bet)
Seat 4: Vorontsov28 folded before Flop (didn't bet)
Seat 5: Ignatychok (button) collected ($0.29)



PokerStars Hand #222947221491:  Hold'em No Limit ($0.05/$0.10 USD) - 2021/01/23 2:51:40 ET
Table 'Capricorn II' 6-max Seat #1 is the button
Seat 1: rodimana ($5.76 in chips) 
Seat 2: petrovichkag ($10 in chips) 
Seat 3: marvinc02317 ($11.49 in chips) 
Seat 4: Vorontsov28 ($10 in chips) 
Seat 5: Ignatychok ($4.56 in chips) 
petrovichkag: posts small blind $0.05
marvinc02317: posts big blind $0.10
Jermein: sits out 
*** HOLE CARDS ***
Vorontsov28: folds 
Ignatychok: folds 
rodimana: raises $0.10 to $0.20
petrovichkag: folds 
marvinc02317: folds 
Uncalled bet ($0.10) returned to rodimana
rodimana collected $0.25 from pot
rodimana: doesn't show hand 
*** SUMMARY ***
Total pot $0.25 | Rake $0 
Seat 1: rodimana (button) collected ($0.25)
Seat 2: petrovichkag (small blind) folded before Flop
Seat 3: marvinc02317 (big blind) folded before Flop
Seat 4: Vorontsov28 folded before Flop (didn't bet)
Seat 5: Ignatychok folded before Flop (didn't bet)



PokerStars Hand #222947224826:  Hold'em No Limit ($0.05/$0.10 USD) - 2021/01/23 2:51:55 ET
Table 'Capricorn II' 6-max Seat #2 is the button
Seat 1: rodimana ($5.91 in chips) 
Seat 2: petrovichkag ($10 in chips) 
Seat 3: marvinc02317 ($11.39 in chips) 
Seat 4: Vorontsov28 ($10 in chips) 
Seat 5: Ignatychok ($4.56 in chips) 
marvinc02317: posts small blind $0.05
Vorontsov28: posts big blind $0.10
Jermein: sits out 
*** HOLE CARDS ***
Ignatychok: folds 
rodimana: folds 
petrovichkag: folds 
marvinc02317: raises $0.10 to $0.20
Vorontsov28: folds 
Uncalled bet ($0.10) returned to marvinc02317
marvinc02317 collected $0.20 from pot
*** SUMMARY ***
Total pot $0.20 | Rake $0 
Seat 1: rodimana folded before Flop (didn't bet)
Seat 2: petrovichkag (button) folded before Flop (didn't bet)
Seat 3: marvinc02317 (small blind) collected ($0.20)
Seat 4: Vorontsov28 (big blind) folded before Flop
Seat 5: Ignatychok folded before Flop (didn't bet)



PokerStars Hand #222947228386:  Hold'em No Limit ($0.05/$0.10 USD) - 2021/01/23 2:52:10 ET
Table 'Capricorn II' 6-max Seat #3 is the button
Seat 1: rodimana ($5.91 in chips) 
Seat 2: petrovichkag ($10 in chips) 
Seat 3: marvinc02317 ($11.49 in chips) 
Seat 4: Vorontsov28 ($10 in chips) 
Seat 5: Ignatychok ($4.56 in chips) 
Vorontsov28: posts small blind $0.05
Ignatychok: posts big blind $0.10
Jermein: sits out 
*** HOLE CARDS ***
rodimana: raises $0.10 to $0.20
petrovichkag: folds 
marvinc02317: folds 
Vorontsov28: folds 
Ignatychok: folds 
Uncalled bet ($0.10) returned to rodimana
rodimana collected $0.25 from pot
rodimana: doesn't show hand 
*** SUMMARY ***
Total pot $0.25 | Rake $0 
Seat 1: rodimana collected ($0.25)
Seat 2: petrovichkag folded before Flop (didn't bet)
Seat 3: marvinc02317 (button) folded before Flop (didn't bet)
Seat 4: Vorontsov28 (small blind) folded before Flop
Seat 5: Ignatychok (big blind) folded before Flop



PokerStars Hand #222947232078:  Hold'em No Limit ($0.05/$0.10 USD) - 2021/01/23 2:52:26 ET
Table 'Capricorn II' 6-max Seat #4 is the button
Seat 1: rodimana ($6.06 in chips) 
Seat 2: petrovichkag ($10 in chips) 
Seat 3: marvinc02317 ($11.49 in chips) 
Seat 4: Vorontsov28 ($10 in chips) 
Seat 5: Ignatychok ($4.46 in chips) 
Seat 6: Jermein ($10 in chips) 
Ignatychok: posts small blind $0.05
Jermein: posts big blind $0.10
*** HOLE CARDS ***
rodimana: folds 
petrovichkag: folds 
marvinc02317: folds 
Vorontsov28: raises $0.20 to $0.30
Ignatychok: folds 
Jermein: folds 
Uncalled bet ($0.20) returned to Vorontsov28
Vorontsov28 collected $0.25 from pot
Vorontsov28: doesn't show hand 
*** SUMMARY ***
Total pot $0.25 | Rake $0 
Seat 1: rodimana folded before Flop (didn't bet)
Seat 2: petrovichkag folded before Flop (didn't bet)
Seat 3: marvinc02317 folded before Flop (didn't bet)
Seat 4: Vorontsov28 (button) collected ($0.25)
Seat 5: Ignatychok (small blind) folded before Flop
Seat 6: Jermein (big blind) folded before Flop



PokerStars Hand #222947234859:  Hold'em No Limit ($0.05/$0.10 USD) - 2021/01/23 2:52:38 ET
Table 'Capricorn II' 6-max Seat #5 is the button
Seat 1: rodimana ($6.06 in chips) 
Seat 2: petrovichkag ($10 in chips) 
Seat 3: marvinc02317 ($11.49 in chips) 
Seat 4: Vorontsov28 ($10.15 in chips) 
Seat 5: Ignatychok ($4.41 in chips) 
Seat 6: Jermein ($10 in chips) 
Jermein: posts small blind $0.05
rodimana: posts big blind $0.10
*** HOLE CARDS ***
petrovichkag: folds 
Ignatychok is disconnected 
marvinc02317 has timed out
marvinc02317: folds 
Vorontsov28: raises $0.20 to $0.30
Ignatychok: folds 
Jermein: folds 
rodimana: calls $0.20
*** FLOP *** [3s 8d Kd]
rodimana: checks 
Vorontsov28: bets $0.20
rodimana: calls $0.20
*** TURN *** [3s 8d Kd] [Ad]
rodimana: checks 
Vorontsov28: checks 
*** RIVER *** [3s 8d Kd Ad] [5h]
rodimana: bets $0.80
Vorontsov28: folds 
Uncalled bet ($0.80) returned to rodimana
rodimana collected $1 from pot
rodimana: doesn't show hand 
*** SUMMARY ***
Total pot $1.05 | Rake $0.05 
Board [3s 8d Kd Ad 5h]
Seat 1: rodimana (big blind) collected ($1)
Seat 2: petrovichkag folded before Flop (didn't bet)
Seat 3: marvinc02317 folded before Flop (didn't bet)
Seat 4: Vorontsov28 folded on the River
Seat 5: Ignatychok (button) folded before Flop (didn't bet)
Seat 6: Jermein (small blind) folded before Flop



PokerStars Hand #222947246767:  Hold'em No Limit ($0.05/$0.10 USD) - 2021/01/23 2:53:29 ET
Table 'Capricorn II' 6-max Seat #6 is the button
Seat 1: rodimana ($6.56 in chips) 
Seat 2: petrovichkag ($10 in chips) 
Seat 3: marvinc02317 ($11.49 in chips) 
Seat 4: Vorontsov28 ($10 in chips) 
Seat 5: Ignatychok ($4.41 in chips) 
Seat 6: Jermein ($10 in chips) 
rodimana: posts small blind $0.05
petrovichkag: posts big blind $0.10
*** HOLE CARDS ***
marvinc02317 has timed out
marvinc02317: folds 
Vorontsov28: folds 
Ignatychok: folds 
Jermein: folds 
rodimana: raises $0.10 to $0.20
petrovichkag: folds 
Uncalled bet ($0.10) returned to rodimana
rodimana collected $0.20 from pot
rodimana: doesn't show hand 
*** SUMMARY ***
Total pot $0.20 | Rake $0 
Seat 1: rodimana (small blind) collected ($0.20)
Seat 2: petrovichkag (big blind) folded before Flop
Seat 3: marvinc02317 folded before Flop (didn't bet)
Seat 4: Vorontsov28 folded before Flop (didn't bet)
Seat 5: Ignatychok folded before Flop (didn't bet)
Seat 6: Jermein (button) folded before Flop (didn't bet)



PokerStars Hand #222947253528:  Hold'em No Limit ($0.05/$0.10 USD) - 2021/01/23 2:53:59 ET
Table 'Capricorn II' 6-max Seat #1 is the button
Seat 1: rodimana ($6.66 in chips) 
Seat 2: petrovichkag ($10 in chips) 
Seat 3: marvinc02317 ($11.49 in chips) 
Seat 4: Vorontsov28 ($10 in chips) 
Seat 5: Ignatychok ($4.41 in chips) 
Seat 6: Jermein ($10 in chips) 
petrovichkag: posts small blind $0.05
marvinc02317: posts big blind $0.10
*** HOLE CARDS ***
Vorontsov28: folds 
Ignatychok: folds 
Jermein: folds 
rodimana: raises $0.10 to $0.20
petrovichkag: folds 
marvinc02317: raises $0.50 to $0.70
rodimana: folds 
Uncalled bet ($0.50) returned to marvinc02317
marvinc02317 collected $0.45 from pot
*** SUMMARY ***
Total pot $0.45 | Rake $0 
Seat 1: rodimana (button) folded before Flop
Seat 2: petrovichkag (small blind) folded before Flop
Seat 3: marvinc02317 (big blind) collected ($0.45)
Seat 4: Vorontsov28 folded before Flop (didn't bet)
Seat 5: Ignatychok folded before Flop (didn't bet)
Seat 6: Jermein folded before Flop (didn't bet)



PokerStars Hand #222947257927:  Hold'em No Limit ($0.05/$0.10 USD) - 2021/01/23 2:54:17 ET
Table 'Capricorn II' 6-max Seat #2 is the button
Seat 1: rodimana ($6.46 in chips) 
Seat 2: petrovichkag ($10 in chips) 
Seat 3: marvinc02317 ($11.74 in chips) 
Seat 4: Vorontsov28 ($10 in chips) 
Seat 5: Ignatychok ($4.41 in chips) 
Seat 6: Jermein ($10 in chips) 
marvinc02317: posts small blind $0.05
Vorontsov28: posts big blind $0.10
*** HOLE CARDS ***
Ignatychok: calls $0.10
Jermein: raises $0.30 to $0.40
rodimana: folds 
petrovichkag: folds 
marvinc02317: folds 
Vorontsov28: folds 
Ignatychok: calls $0.30
*** FLOP *** [9d 2h Jh]
Ignatychok: bets $0.30
Jermein: raises $0.30 to $0.60
Ignatychok: calls $0.30
*** TURN *** [9d 2h Jh] [Td]
Ignatychok: bets $0.10
Jermein: calls $0.10
*** RIVER *** [9d 2h Jh Td] [8h]
Ignatychok: bets $0.10
Jermein: calls $0.10
*** SHOW DOWN ***
Ignatychok: shows [Jc Ah] (a pair of Jacks)
Jermein: mucks hand 
Ignatychok collected $2.44 from pot
*** SUMMARY ***
Total pot $2.55 | Rake $0.11 
Board [9d 2h Jh Td 8h]
Seat 1: rodimana folded before Flop (didn't bet)
Seat 2: petrovichkag (button) folded before Flop (didn't bet)
Seat 3: marvinc02317 (small blind) folded before Flop
Seat 4: Vorontsov28 (big blind) folded before Flop
Seat 5: Ignatychok showed [Jc Ah] and won ($2.44) with a pair of Jacks
Seat 6: Jermein mucked



PokerStars Hand #222947271235:  Hold'em No Limit ($0.05/$0.10 USD) - 2021/01/23 2:55:15 ET
Table 'Capricorn II' 6-max Seat #3 is the button
Seat 1: rodimana ($6.46 in chips) 
Seat 2: petrovichkag ($10 in chips) 
Seat 3: marvinc02317 ($11.69 in chips) 
Seat 4: Vorontsov28 ($10 in chips) 
Seat 5: Ignatychok ($5.65 in chips) 
Seat 6: Jermein ($10 in chips) 
Vorontsov28: posts small blind $0.05
Ignatychok: posts big blind $0.10
*** HOLE CARDS ***
Jermein: folds 
rodimana: raises $0.10 to $0.20
petrovichkag: folds 
marvinc02317: folds 
Vorontsov28: folds 
Ignatychok: folds 
Uncalled bet ($0.10) returned to rodimana
rodimana collected $0.25 from pot
rodimana: doesn't show hand 
*** SUMMARY ***
Total pot $0.25 | Rake $0 
Seat 1: rodimana collected ($0.25)
Seat 2: petrovichkag folded before Flop (didn't bet)
Seat 3: marvinc02317 (button) folded before Flop (didn't bet)
Seat 4: Vorontsov28 (small blind) folded before Flop
Seat 5: Ignatychok (big blind) folded before Flop
Seat 6: Jermein folded before Flop (didn't bet)



PokerStars Hand #222947275528:  Hold'em No Limit ($0.05/$0.10 USD) - 2021/01/23 2:55:37 ET
Table 'Capricorn II' 6-max Seat #4 is the button
Seat 1: rodimana ($6.61 in chips) 
Seat 2: petrovichkag ($10 in chips) 
Seat 3: marvinc02317 ($11.69 in chips) 
Seat 4: Vorontsov28 ($10 in chips) 
Seat 5: Ignatychok ($5.55 in chips) 
Seat 6: Jermein ($10 in chips) 
Ignatychok: posts small blind $0.05
Jermein: posts big blind $0.10
*** HOLE CARDS ***
rodimana: raises $0.10 to $0.20
petrovichkag: folds 
marvinc02317: raises $0.55 to $0.75
Vorontsov28: folds 
Ignatychok: folds 
Jermein: folds 
rodimana: folds 
Uncalled bet ($0.55) returned to marvinc02317
marvinc02317 collected $0.55 from pot
*** SUMMARY ***
Total pot $0.55 | Rake $0 
Seat 1: rodimana folded before Flop
Seat 2: petrovichkag folded before Flop (didn't bet)
Seat 3: marvinc02317 collected ($0.55)
Seat 4: Vorontsov28 (button) folded before Flop (didn't bet)
Seat 5: Ignatychok (small blind) folded before Flop
Seat 6: Jermein (big blind) folded before Flop



PokerStars Hand #222947278504:  Hold'em No Limit ($0.05/$0.10 USD) - 2021/01/23 2:55:53 ET
Table 'Capricorn II' 6-max Seat #5 is the button
Seat 1: rodimana ($6.41 in chips) 
Seat 2: petrovichkag ($10 in chips) 
Seat 3: marvinc02317 ($12.04 in chips) 
Seat 4: Vorontsov28 ($10 in chips) 
Seat 5: Ignatychok ($5.50 in chips) 
Seat 6: Jermein ($10 in chips) 
Jermein: posts small blind $0.05
rodimana: posts big blind $0.10
*** HOLE CARDS ***
petrovichkag: folds 
marvinc02317: folds 
Vorontsov28: folds 
Ignatychok: folds 
Jermein: calls $0.05
rodimana: checks 
*** FLOP *** [9c Ac 6c]
Jermein: checks 
rodimana: checks 
*** TURN *** [9c Ac 6c] [5c]
Jermein: checks 
rodimana: bets $0.20
Jermein: folds 
Uncalled bet ($0.20) returned to rodimana
rodimana collected $0.19 from pot
rodimana: doesn't show hand 
*** SUMMARY ***
Total pot $0.20 | Rake $0.01 
Board [9c Ac 6c 5c]
Seat 1: rodimana (big blind) collected ($0.19)
Seat 2: petrovichkag folded before Flop (didn't bet)
Seat 3: marvinc02317 folded before Flop (didn't bet)
Seat 4: Vorontsov28 folded before Flop (didn't bet)
Seat 5: Ignatychok (button) folded before Flop (didn't bet)
Seat 6: Jermein (small blind) folded on the Turn



PokerStars Hand #222947284362:  Hold'em No Limit ($0.05/$0.10 USD) - 2021/01/23 2:56:23 ET
Table 'Capricorn II' 6-max Seat #6 is the button
Seat 1: rodimana ($6.50 in chips) 
Seat 2: petrovichkag ($10 in chips) 
Seat 3: marvinc02317 ($12.04 in chips) 
Seat 4: Vorontsov28 ($10 in chips) 
Seat 5: Ignatychok ($5.50 in chips) 
Seat 6: Jermein ($10 in chips) 
rodimana: posts small blind $0.05
petrovichkag: posts big blind $0.10
*** HOLE CARDS ***
marvinc02317: folds 
Vorontsov28: folds 
Ignatychok: folds 
Jermein: folds 
rodimana: calls $0.05
petrovichkag: checks 
*** FLOP *** [Td Qs Qd]
rodimana: checks 
petrovichkag: bets $0.10
rodimana: folds 
Uncalled bet ($0.10) returned to petrovichkag
petrovichkag collected $0.19 from pot
petrovichkag: doesn't show hand 
*** SUMMARY ***
Total pot $0.20 | Rake $0.01 
Board [Td Qs Qd]
Seat 1: rodimana (small blind) folded on the Flop
Seat 2: petrovichkag (big blind) collected ($0.19)
Seat 3: marvinc02317 folded before Flop (didn't bet)
Seat 4: Vorontsov28 folded before Flop (didn't bet)
Seat 5: Ignatychok folded before Flop (didn't bet)
Seat 6: Jermein (button) folded before Flop (didn't bet)



PokerStars Hand #222947288296:  Hold'em No Limit ($0.05/$0.10 USD) - 2021/01/23 2:56:43 ET
Table 'Capricorn II' 6-max Seat #1 is the button
Seat 1: rodimana ($6.40 in chips) 
Seat 2: petrovichkag ($10.09 in chips) 
Seat 3: marvinc02317 ($12.04 in chips) 
Seat 4: Vorontsov28 ($10 in chips) 
Seat 5: Ignatychok ($5.50 in chips) 
Seat 6: Jermein ($10 in chips) 
petrovichkag: posts small blind $0.05
marvinc02317: posts big blind $0.10
*** HOLE CARDS ***
Vorontsov28: folds 
Ignatychok: folds 
Jermein: folds 
rodimana: raises $0.10 to $0.20
petrovichkag: folds 
marvinc02317: calls $0.10
*** FLOP *** [9h 4c 3d]
marvinc02317: checks 
rodimana: checks 
*** TURN *** [9h 4c 3d] [Tc]
marvinc02317: bets $0.43
rodimana: calls $0.43
*** RIVER *** [9h 4c 3d Tc] [Qh]
marvinc02317: bets $0.63
rodimana: calls $0.63
*** SHOW DOWN ***
marvinc02317: shows [7c 9d] (a pair of Nines)
rodimana: shows [4s 4d] (three of a kind, Fours)
rodimana collected $2.45 from pot
*** SUMMARY ***
Total pot $2.57 | Rake $0.12 
Board [9h 4c 3d Tc Qh]
Seat 1: rodimana (button) showed [4s 4d] and won ($2.45) with three of a kind, Fours
Seat 2: petrovichkag (small blind) folded before Flop
Seat 3: marvinc02317 (big blind) showed [7c 9d] and lost with a pair of Nines
Seat 4: Vorontsov28 folded before Flop (didn't bet)
Seat 5: Ignatychok folded before Flop (didn't bet)
Seat 6: Jermein folded before Flop (didn't bet)



PokerStars Hand #222947300052:  Hold'em No Limit ($0.05/$0.10 USD) - 2021/01/23 2:57:42 ET
Table 'Capricorn II' 6-max Seat #2 is the button
Seat 1: rodimana ($7.59 in chips) 
Seat 2: petrovichkag ($10.04 in chips) 
Seat 3: marvinc02317 ($10.78 in chips) 
Seat 4: Vorontsov28 ($10 in chips) 
Seat 5: Ignatychok ($5.50 in chips) 
Seat 6: Jermein ($10 in chips) 
marvinc02317: posts small blind $0.05
Vorontsov28: posts big blind $0.10
*** HOLE CARDS ***
Ignatychok: calls $0.10
Jermein: folds 
rodimana: folds 
petrovichkag: folds 
marvinc02317: raises $0.40 to $0.50
Vorontsov28: folds 
Ignatychok: folds 
Uncalled bet ($0.40) returned to marvinc02317
marvinc02317 collected $0.30 from pot
*** SUMMARY ***
Total pot $0.30 | Rake $0 
Seat 1: rodimana folded before Flop (didn't bet)
Seat 2: petrovichkag (button) folded before Flop (didn't bet)
Seat 3: marvinc02317 (small blind) collected ($0.30)
Seat 4: Vorontsov28 (big blind) folded before Flop
Seat 5: Ignatychok folded before Flop
Seat 6: Jermein folded before Flop (didn't bet)



PokerStars Hand #222947305456:  Hold'em No Limit ($0.05/$0.10 USD) - 2021/01/23 2:58:09 ET
Table 'Capricorn II' 6-max Seat #3 is the button
Seat 1: rodimana ($7.59 in chips) 
Seat 2: petrovichkag ($10.04 in chips) 
Seat 3: marvinc02317 ($10.98 in chips) 
Seat 4: Vorontsov28 ($10 in chips) 
Seat 5: Ignatychok ($5.40 in chips) 
Seat 6: Jermein ($10 in chips) 
Vorontsov28: posts small blind $0.05
Ignatychok: posts big blind $0.10
*** HOLE CARDS ***
Jermein: folds 
rodimana: raises $0.10 to $0.20
petrovichkag: folds 
marvinc02317: folds 
Vorontsov28: folds 
Ignatychok: calls $0.10
*** FLOP *** [Qd Kd 8h]
Ignatychok: checks 
rodimana: bets $0.24
Ignatychok: folds 
Uncalled bet ($0.24) returned to rodimana
rodimana collected $0.43 from pot
rodimana: doesn't show hand 
*** SUMMARY ***
Total pot $0.45 | Rake $0.02 
Board [Qd Kd 8h]
Seat 1: rodimana collected ($0.43)
Seat 2: petrovichkag folded before Flop (didn't bet)
Seat 3: marvinc02317 (button) folded before Flop (didn't bet)
Seat 4: Vorontsov28 (small blind) folded before Flop
Seat 5: Ignatychok (big blind) folded on the Flop
Seat 6: Jermein folded before Flop (didn't bet)



PokerStars Hand #222947309709:  Hold'em No Limit ($0.05/$0.10 USD) - 2021/01/23 2:58:31 ET
Table 'Capricorn II' 6-max Seat #4 is the button
Seat 1: rodimana ($7.82 in chips) 
Seat 2: petrovichkag ($10.04 in chips) 
Seat 3: marvinc02317 ($10.98 in chips) 
Seat 4: Vorontsov28 ($10 in chips) 
Seat 5: Ignatychok ($5.20 in chips) 
Seat 6: Jermein ($10 in chips) 
Ignatychok: posts small blind $0.05
Jermein: posts big blind $0.10
*** HOLE CARDS ***
rodimana: raises $0.10 to $0.20
petrovichkag: folds 
marvinc02317: folds 
Vorontsov28: folds 
Ignatychok: folds 
Jermein: folds 
Uncalled bet ($0.10) returned to rodimana
rodimana collected $0.25 from pot
rodimana: doesn't show hand 
*** SUMMARY ***
Total pot $0.25 | Rake $0 
Seat 1: rodimana collected ($0.25)
Seat 2: petrovichkag folded before Flop (didn't bet)
Seat 3: marvinc02317 folded before Flop (didn't bet)
Seat 4: Vorontsov28 (button) folded before Flop (didn't bet)
Seat 5: Ignatychok (small blind) folded before Flop
Seat 6: Jermein (big blind) folded before Flop



PokerStars Hand #222947312458:  Hold'em No Limit ($0.05/$0.10 USD) - 2021/01/23 2:58:45 ET
Table 'Capricorn II' 6-max Seat #5 is the button
Seat 1: rodimana ($7.97 in chips) 
Seat 2: petrovichkag ($10.04 in chips) 
Seat 3: marvinc02317 ($10.98 in chips) 
Seat 4: Vorontsov28 ($10 in chips) 
Seat 5: Ignatychok ($5.15 in chips) 
Seat 6: Jermein ($10 in chips) 
Jermein: posts small blind $0.05
rodimana: posts big blind $0.10
*** HOLE CARDS ***
petrovichkag: folds 
marvinc02317: folds 
Vorontsov28: folds 
Ignatychok: folds 
Jermein: folds 
Uncalled bet ($0.05) returned to rodimana
rodimana collected $0.10 from pot
rodimana: doesn't show hand 
*** SUMMARY ***
Total pot $0.10 | Rake $0 
Seat 1: rodimana (big blind) collected ($0.10)
Seat 2: petrovichkag folded before Flop (didn't bet)
Seat 3: marvinc02317 folded before Flop (didn't bet)
Seat 4: Vorontsov28 folded before Flop (didn't bet)
Seat 5: Ignatychok (button) folded before Flop (didn't bet)
Seat 6: Jermein (small blind) folded before Flop



PokerStars Hand #222947316601:  Hold'em No Limit ($0.05/$0.10 USD) - 2021/01/23 2:59:06 ET
Table 'Capricorn II' 6-max Seat #6 is the button
Seat 1: rodimana ($8.02 in chips) 
Seat 2: petrovichkag ($10.04 in chips) 
Seat 3: marvinc02317 ($10.98 in chips) 
Seat 4: Vorontsov28 ($10 in chips) 
Seat 5: Ignatychok ($5.15 in chips) 
Seat 6: Jermein ($10 in chips) 
rodimana: posts small blind $0.05
petrovichkag: posts big blind $0.10
*** HOLE CARDS ***
marvinc02317: raises $0.10 to $0.20
Vorontsov28: folds 
Ignatychok: folds 
Jermein: folds 
rodimana: folds 
petrovichkag: folds 
Uncalled bet ($0.10) returned to marvinc02317
marvinc02317 collected $0.25 from pot
*** SUMMARY ***
Total pot $0.25 | Rake $0 
Seat 1: rodimana (small blind) folded before Flop
Seat 2: petrovichkag (big blind) folded before Flop
Seat 3: marvinc02317 collected ($0.25)
Seat 4: Vorontsov28 folded before Flop (didn't bet)
Seat 5: Ignatychok folded before Flop (didn't bet)
Seat 6: Jermein (button) folded before Flop (didn't bet)



PokerStars Hand #222947319417:  Hold'em No Limit ($0.05/$0.10 USD) - 2021/01/23 2:59:20 ET
Table 'Capricorn II' 6-max Seat #1 is the button
Seat 1: rodimana ($7.97 in chips) 
Seat 2: petrovichkag ($10 in chips) 
Seat 3: marvinc02317 ($11.13 in chips) 
Seat 4: Vorontsov28 ($10 in chips) 
Seat 5: Ignatychok ($5.15 in chips) 
Seat 6: Jermein ($10 in chips) 
petrovichkag: posts small blind $0.05
marvinc02317: posts big blind $0.10
*** HOLE CARDS ***
Vorontsov28: folds 
Ignatychok: calls $0.10
Jermein: folds 
rodimana: folds 
petrovichkag: folds 
marvinc02317: raises $0.25 to $0.35
Ignatychok: calls $0.25
*** FLOP *** [4s 8h Tc]
marvinc02317: bets $0.36
Ignatychok: calls $0.36
*** TURN *** [4s 8h Tc] [Qh]
marvinc02317: bets $0.70
Ignatychok: folds 
Uncalled bet ($0.70) returned to marvinc02317
marvinc02317 collected $1.40 from pot
*** SUMMARY ***
Total pot $1.47 | Rake $0.07 
Board [4s 8h Tc Qh]
Seat 1: rodimana (button) folded before Flop (didn't bet)
Seat 2: petrovichkag (small blind) folded before Flop
Seat 3: marvinc02317 (big blind) collected ($1.40)
Seat 4: Vorontsov28 folded before Flop (didn't bet)
Seat 5: Ignatychok folded on the Turn
Seat 6: Jermein folded before Flop (didn't bet)



PokerStars Hand #222947328762:  Hold'em No Limit ($0.05/$0.10 USD) - 2021/01/23 3:00:08 ET
Table 'Capricorn II' 6-max Seat #2 is the button
Seat 1: rodimana ($7.97 in chips) 
Seat 2: petrovichkag ($10 in chips) 
Seat 3: marvinc02317 ($11.82 in chips) 
Seat 4: Vorontsov28 ($10 in chips) 
Seat 5: Ignatychok ($4.44 in chips) 
Seat 6: Jermein ($10 in chips) 
marvinc02317: posts small blind $0.05
Vorontsov28: posts big blind $0.10
*** HOLE CARDS ***
Ignatychok: folds 
Jermein: folds 
rodimana: raises $0.10 to $0.20
petrovichkag: raises $0.40 to $0.60
marvinc02317: folds 
Vorontsov28: folds 
rodimana: folds 
Uncalled bet ($0.40) returned to petrovichkag
petrovichkag collected $0.55 from pot
petrovichkag: doesn't show hand 
*** SUMMARY ***
Total pot $0.55 | Rake $0 
Seat 1: rodimana folded before Flop
Seat 2: petrovichkag (button) collected ($0.55)
Seat 3: marvinc02317 (small blind) folded before Flop
Seat 4: Vorontsov28 (big blind) folded before Flop
Seat 5: Ignatychok folded before Flop (didn't bet)
Seat 6: Jermein folded before Flop (didn't bet)



PokerStars Hand #222947333911:  Hold'em No Limit ($0.05/$0.10 USD) - 2021/01/23 3:00:33 ET
Table 'Capricorn II' 6-max Seat #3 is the button
Seat 1: rodimana ($7.77 in chips) 
Seat 2: petrovichkag ($10.35 in chips) 
Seat 3: marvinc02317 ($11.77 in chips) 
Seat 4: Vorontsov28 ($10 in chips) 
Seat 5: Ignatychok ($4.44 in chips) 
Seat 6: Jermein ($10 in chips) 
Vorontsov28: posts small blind $0.05
Ignatychok: posts big blind $0.10
*** HOLE CARDS ***
Jermein: folds 
rodimana: folds 
petrovichkag: folds 
marvinc02317: folds 
Vorontsov28: raises $0.20 to $0.30
Ignatychok: calls $0.20
*** FLOP *** [8s 9c Jd]
Vorontsov28: bets $0.20
Ignatychok: calls $0.20
*** TURN *** [8s 9c Jd] [8d]
Vorontsov28: bets $0.50
Ignatychok: calls $0.50
*** RIVER *** [8s 9c Jd 8d] [Qc]
Vorontsov28: checks 
Ignatychok: bets $3.44 and is all-in
Vorontsov28: folds 
Uncalled bet ($3.44) returned to Ignatychok
Ignatychok collected $1.91 from pot
Ignatychok: doesn't show hand 
*** SUMMARY ***
Total pot $2 | Rake $0.09 
Board [8s 9c Jd 8d Qc]
Seat 1: rodimana folded before Flop (didn't bet)
Seat 2: petrovichkag folded before Flop (didn't bet)
Seat 3: marvinc02317 (button) folded before Flop (didn't bet)
Seat 4: Vorontsov28 (small blind) folded on the River
Seat 5: Ignatychok (big blind) collected ($1.91)
Seat 6: Jermein folded before Flop (didn't bet)



PokerStars Hand #222947343975:  Hold'em No Limit ($0.05/$0.10 USD) - 2021/01/23 3:01:19 ET
Table 'Capricorn II' 6-max Seat #4 is the button
Seat 1: rodimana ($7.77 in chips) 
Seat 2: petrovichkag ($10.35 in chips) 
Seat 3: marvinc02317 ($11.77 in chips) 
Seat 4: Vorontsov28 ($10 in chips) 
Seat 5: Ignatychok ($5.35 in chips) 
Seat 6: Jermein ($10 in chips) 
Ignatychok: posts small blind $0.05
Jermein: posts big blind $0.10
*** HOLE CARDS ***
rodimana: raises $0.10 to $0.20
petrovichkag: folds 
marvinc02317: folds 
Vorontsov28: raises $0.70 to $0.90
Ignatychok: folds 
Jermein: folds 
rodimana: calls $0.70
*** FLOP *** [Js 6h 8s]
rodimana: checks 
Vorontsov28: bets $1
rodimana: folds 
Uncalled bet ($1) returned to Vorontsov28
Vorontsov28 collected $1.86 from pot
Vorontsov28: doesn't show hand 
*** SUMMARY ***
Total pot $1.95 | Rake $0.09 
Board [Js 6h 8s]
Seat 1: rodimana folded on the Flop
Seat 2: petrovichkag folded before Flop (didn't bet)
Seat 3: marvinc02317 folded before Flop (didn't bet)
Seat 4: Vorontsov28 (button) collected ($1.86)
Seat 5: Ignatychok (small blind) folded before Flop
Seat 6: Jermein (big blind) folded before Flop



PokerStars Hand #222947351956:  Hold'em No Limit ($0.05/$0.10 USD) - 2021/01/23 3:01:54 ET
Table 'Capricorn II' 6-max Seat #5 is the button
Seat 1: rodimana ($6.87 in chips) 
Seat 2: petrovichkag ($10.35 in chips) 
Seat 3: marvinc02317 ($11.77 in chips) 
Seat 4: Vorontsov28 ($10.96 in chips) 
Seat 5: Ignatychok ($5.30 in chips) 
Seat 6: Jermein ($10 in chips) 
Jermein: posts small blind $0.05
rodimana: posts big blind $0.10
*** HOLE CARDS ***
petrovichkag: folds 
marvinc02317: raises $0.25 to $0.35
Vorontsov28: folds 
Ignatychok: folds 
Jermein: folds 
rodimana: folds 
Uncalled bet ($0.25) returned to marvinc02317
marvinc02317 collected $0.25 from pot
*** SUMMARY ***
Total pot $0.25 | Rake $0 
Seat 1: rodimana (big blind) folded before Flop
Seat 2: petrovichkag folded before Flop (didn't bet)
Seat 3: marvinc02317 collected ($0.25)
Seat 4: Vorontsov28 folded before Flop (didn't bet)
Seat 5: Ignatychok (button) folded before Flop (didn't bet)
Seat 6: Jermein (small blind) folded before Flop



PokerStars Hand #222947354638:  Hold'em No Limit ($0.05/$0.10 USD) - 2021/01/23 3:02:06 ET
Table 'Capricorn II' 6-max Seat #6 is the button
Seat 1: rodimana ($6.77 in chips) 
Seat 2: petrovichkag ($10.35 in chips) 
Seat 3: marvinc02317 ($11.92 in chips) 
Seat 4: Vorontsov28 ($10.96 in chips) 
Seat 5: Ignatychok ($5.30 in chips) 
Seat 6: Jermein ($10 in chips) 
rodimana: posts small blind $0.05
petrovichkag: posts big blind $0.10
*** HOLE CARDS ***
marvinc02317: folds 
Vorontsov28: folds 
Ignatychok: folds 
Jermein: folds 
rodimana: raises $0.10 to $0.20
petrovichkag: calls $0.10
*** FLOP *** [Jc Kh Js]
rodimana: bets $0.20
petrovichkag: folds 
Uncalled bet ($0.20) returned to rodimana
rodimana collected $0.38 from pot
rodimana: doesn't show hand 
*** SUMMARY ***
Total pot $0.40 | Rake $0.02 
Board [Jc Kh Js]
Seat 1: rodimana (small blind) collected ($0.38)
Seat 2: petrovichkag (big blind) folded on the Flop
Seat 3: marvinc02317 folded before Flop (didn't bet)
Seat 4: Vorontsov28 folded before Flop (didn't bet)
Seat 5: Ignatychok folded before Flop (didn't bet)
Seat 6: Jermein (button) folded before Flop (didn't bet)



PokerStars Hand #222947361297:  Hold'em No Limit ($0.05/$0.10 USD) - 2021/01/23 3:02:35 ET
Table 'Capricorn II' 6-max Seat #1 is the button
Seat 1: rodimana ($6.95 in chips) 
Seat 2: petrovichkag ($10.15 in chips) 
Seat 3: marvinc02317 ($11.92 in chips) 
Seat 4: Vorontsov28 ($10.96 in chips) 
Seat 5: Ignatychok ($5.30 in chips) 
Seat 6: Jermein ($10 in chips) 
petrovichkag: posts small blind $0.05
marvinc02317: posts big blind $0.10
*** HOLE CARDS ***
Vorontsov28: folds 
Ignatychok: folds 
Jermein has timed out
Jermein: folds 
rodimana: folds 
petrovichkag: folds 
Uncalled bet ($0.05) returned to marvinc02317
marvinc02317 collected $0.10 from pot
*** SUMMARY ***
Total pot $0.10 | Rake $0 
Seat 1: rodimana (button) folded before Flop (didn't bet)
Seat 2: petrovichkag (small blind) folded before Flop
Seat 3: marvinc02317 (big blind) collected ($0.10)
Seat 4: Vorontsov28 folded before Flop (didn't bet)
Seat 5: Ignatychok folded before Flop (didn't bet)
Seat 6: Jermein folded before Flop (didn't bet)



PokerStars Hand #222947366008:  Hold'em No Limit ($0.05/$0.10 USD) - 2021/01/23 3:02:56 ET
Table 'Capricorn II' 6-max Seat #2 is the button
Seat 1: rodimana ($6.95 in chips) 
Seat 2: petrovichkag ($10.10 in chips) 
Seat 3: marvinc02317 ($11.97 in chips) 
Seat 4: Vorontsov28 ($10.96 in chips) 
Seat 5: Ignatychok ($5.30 in chips) 
Seat 6: Jermein ($10 in chips) 
marvinc02317: posts small blind $0.05
Vorontsov28: posts big blind $0.10
*** HOLE CARDS ***
Ignatychok: folds 
Jermein: raises $0.20 to $0.30
rodimana: folds 
petrovichkag: folds 
marvinc02317: folds 
Vorontsov28: folds 
Uncalled bet ($0.20) returned to Jermein
Jermein collected $0.25 from pot
Jermein: doesn't show hand 
*** SUMMARY ***
Total pot $0.25 | Rake $0 
Seat 1: rodimana folded before Flop (didn't bet)
Seat 2: petrovichkag (button) folded before Flop (didn't bet)
Seat 3: marvinc02317 (small blind) folded before Flop
Seat 4: Vorontsov28 (big blind) folded before Flop
Seat 5: Ignatychok folded before Flop (didn't bet)
Seat 6: Jermein collected ($0.25)



PokerStars Hand #222947370137:  Hold'em No Limit ($0.05/$0.10 USD) - 2021/01/23 3:03:13 ET
Table 'Capricorn II' 6-max Seat #3 is the button
Seat 1: rodimana ($6.95 in chips) 
Seat 2: petrovichkag ($10.10 in chips) 
Seat 3: marvinc02317 ($11.92 in chips) 
Seat 4: Vorontsov28 ($10.86 in chips) 
Seat 5: Ignatychok ($5.30 in chips) 
Seat 6: Jermein ($10.15 in chips) 
Vorontsov28: posts small blind $0.05
Ignatychok: posts big blind $0.10
*** HOLE CARDS ***
Jermein: raises $0.20 to $0.30
rodimana: folds 
petrovichkag: folds 
marvinc02317: folds 
Vorontsov28: folds 
Ignatychok: folds 
Uncalled bet ($0.20) returned to Jermein
Jermein collected $0.25 from pot
Jermein: doesn't show hand 
*** SUMMARY ***
Total pot $0.25 | Rake $0 
Seat 1: rodimana folded before Flop (didn't bet)
Seat 2: petrovichkag folded before Flop (didn't bet)
Seat 3: marvinc02317 (button) folded before Flop (didn't bet)
Seat 4: Vorontsov28 (small blind) folded before Flop
Seat 5: Ignatychok (big blind) folded before Flop
Seat 6: Jermein collected ($0.25)



PokerStars Hand #222947373414:  Hold'em No Limit ($0.05/$0.10 USD) - 2021/01/23 3:03:27 ET
Table 'Capricorn II' 6-max Seat #4 is the button
Seat 1: rodimana ($6.95 in chips) 
Seat 2: petrovichkag ($10.10 in chips) 
Seat 3: marvinc02317 ($11.92 in chips) 
Seat 4: Vorontsov28 ($10.81 in chips) 
Seat 5: Ignatychok ($5.20 in chips) 
Seat 6: Jermein ($10.30 in chips) 
Ignatychok: posts small blind $0.05
Jermein: posts big blind $0.10
*** HOLE CARDS ***
rodimana: folds 
petrovichkag: raises $0.14 to $0.24
marvinc02317: folds 
Vorontsov28: folds 
Ignatychok: folds 
Jermein: folds 
Uncalled bet ($0.14) returned to petrovichkag
petrovichkag collected $0.25 from pot
petrovichkag: doesn't show hand 
*** SUMMARY ***
Total pot $0.25 | Rake $0 
Seat 1: rodimana folded before Flop (didn't bet)
Seat 2: petrovichkag collected ($0.25)
Seat 3: marvinc02317 folded before Flop (didn't bet)
Seat 4: Vorontsov28 (button) folded before Flop (didn't bet)
Seat 5: Ignatychok (small blind) folded before Flop
Seat 6: Jermein (big blind) folded before Flop



PokerStars Hand #222947377563:  Hold'em No Limit ($0.05/$0.10 USD) - 2021/01/23 3:03:45 ET
Table 'Capricorn II' 6-max Seat #5 is the button
Seat 1: rodimana ($6.95 in chips) 
Seat 2: petrovichkag ($10.25 in chips) 
Seat 3: marvinc02317 ($11.92 in chips) 
Seat 4: Vorontsov28 ($10.81 in chips) 
Seat 5: Ignatychok ($5.15 in chips) 
Seat 6: Jermein ($10.20 in chips) 
Jermein: posts small blind $0.05
rodimana: posts big blind $0.10
*** HOLE CARDS ***
petrovichkag: folds 
marvinc02317: raises $0.25 to $0.35
Vorontsov28: folds 
Ignatychok: folds 
Jermein: folds 
rodimana: folds 
Uncalled bet ($0.25) returned to marvinc02317
marvinc02317 collected $0.25 from pot
*** SUMMARY ***
Total pot $0.25 | Rake $0 
Seat 1: rodimana (big blind) folded before Flop
Seat 2: petrovichkag folded before Flop (didn't bet)
Seat 3: marvinc02317 collected ($0.25)
Seat 4: Vorontsov28 folded before Flop (didn't bet)
Seat 5: Ignatychok (button) folded before Flop (didn't bet)
Seat 6: Jermein (small blind) folded before Flop



PokerStars Hand #222947380473:  Hold'em No Limit ($0.05/$0.10 USD) - 2021/01/23 3:03:57 ET
Table 'Capricorn II' 6-max Seat #6 is the button
Seat 1: rodimana ($6.85 in chips) 
Seat 2: petrovichkag ($10.25 in chips) 
Seat 3: marvinc02317 ($12.07 in chips) 
Seat 4: Vorontsov28 ($10.81 in chips) 
Seat 5: Ignatychok ($5.15 in chips) 
Seat 6: Jermein ($10.15 in chips) 
rodimana: posts small blind $0.05
petrovichkag: posts big blind $0.10
*** HOLE CARDS ***
marvinc02317: raises $0.25 to $0.35
Vorontsov28: folds 
Ignatychok: folds 
Jermein: folds 
rodimana: folds 
petrovichkag: folds 
Uncalled bet ($0.25) returned to marvinc02317
marvinc02317 collected $0.25 from pot
*** SUMMARY ***
Total pot $0.25 | Rake $0 
Seat 1: rodimana (small blind) folded before Flop
Seat 2: petrovichkag (big blind) folded before Flop
Seat 3: marvinc02317 collected ($0.25)
Seat 4: Vorontsov28 folded before Flop (didn't bet)
Seat 5: Ignatychok folded before Flop (didn't bet)
Seat 6: Jermein (button) folded before Flop (didn't bet)



PokerStars Hand #222947382676:  Hold'em No Limit ($0.05/$0.10 USD) - 2021/01/23 3:04:07 ET
Table 'Capricorn II' 6-max Seat #1 is the button
Seat 1: rodimana ($6.80 in chips) 
Seat 2: petrovichkag ($10.15 in chips) 
Seat 3: marvinc02317 ($12.22 in chips) 
Seat 4: Vorontsov28 ($10.81 in chips) 
Seat 5: Ignatychok ($5.15 in chips) 
Seat 6: Jermein ($10.15 in chips) 
petrovichkag: posts small blind $0.05
marvinc02317: posts big blind $0.10
*** HOLE CARDS ***
Vorontsov28: folds 
Ignatychok: folds 
Jermein: folds 
rodimana: raises $0.10 to $0.20
petrovichkag: folds 
marvinc02317: folds 
Uncalled bet ($0.10) returned to rodimana
rodimana collected $0.25 from pot
rodimana: doesn't show hand 
*** SUMMARY ***
Total pot $0.25 | Rake $0 
Seat 1: rodimana (button) collected ($0.25)
Seat 2: petrovichkag (small blind) folded before Flop
Seat 3: marvinc02317 (big blind) folded before Flop
Seat 4: Vorontsov28 folded before Flop (didn't bet)
Seat 5: Ignatychok folded before Flop (didn't bet)
Seat 6: Jermein folded before Flop (didn't bet)



PokerStars Hand #222947384651:  Hold'em No Limit ($0.05/$0.10 USD) - 2021/01/23 3:04:16 ET
Table 'Capricorn II' 6-max Seat #2 is the button
Seat 1: rodimana ($6.95 in chips) 
Seat 2: petrovichkag ($10.10 in chips) 
Seat 3: marvinc02317 ($12.12 in chips) 
Seat 4: Vorontsov28 ($10.81 in chips) 
Seat 5: Ignatychok ($5.15 in chips) 
Seat 6: Jermein ($10.15 in chips) 
marvinc02317: posts small blind $0.05
Vorontsov28: posts big blind $0.10
*** HOLE CARDS ***
Ignatychok: folds 
Jermein: folds 
rodimana: folds 
petrovichkag: folds 
marvinc02317: folds 
Uncalled bet ($0.05) returned to Vorontsov28
Vorontsov28 collected $0.10 from pot
Vorontsov28: doesn't show hand 
*** SUMMARY ***
Total pot $0.10 | Rake $0 
Seat 1: rodimana folded before Flop (didn't bet)
Seat 2: petrovichkag (button) folded before Flop (didn't bet)
Seat 3: marvinc02317 (small blind) folded before Flop
Seat 4: Vorontsov28 (big blind) collected ($0.10)
Seat 5: Ignatychok folded before Flop (didn't bet)
Seat 6: Jermein folded before Flop (didn't bet)



PokerStars Hand #222947387500:  Hold'em No Limit ($0.05/$0.10 USD) - 2021/01/23 3:04:28 ET
Table 'Capricorn II' 6-max Seat #3 is the button
Seat 1: rodimana ($6.95 in chips) 
Seat 2: petrovichkag ($10.10 in chips) 
Seat 3: marvinc02317 ($12.07 in chips) 
Seat 4: Vorontsov28 ($10.86 in chips) 
Seat 5: Ignatychok ($5.15 in chips) 
Seat 6: Jermein ($10.15 in chips) 
Vorontsov28: posts small blind $0.05
Ignatychok: posts big blind $0.10
*** HOLE CARDS ***
Jermein: folds 
rodimana: raises $0.10 to $0.20
petrovichkag: folds 
marvinc02317: raises $0.10 to $0.30
Vorontsov28: folds 
Ignatychok: folds 
rodimana: calls $0.10
*** FLOP *** [Jc 9c 7c]
rodimana: checks 
marvinc02317: bets $0.36
rodimana: calls $0.36
*** TURN *** [Jc 9c 7c] [4s]
rodimana: checks 
marvinc02317: checks 
*** RIVER *** [Jc 9c 7c 4s] [5d]
rodimana: checks 
marvinc02317: checks 
*** SHOW DOWN ***
rodimana: shows [9s 8s] (a pair of Nines)
marvinc02317: shows [Jh Ts] (a pair of Jacks)
marvinc02317 collected $1.40 from pot
*** SUMMARY ***
Total pot $1.47 | Rake $0.07 
Board [Jc 9c 7c 4s 5d]
Seat 1: rodimana showed [9s 8s] and lost with a pair of Nines
Seat 2: petrovichkag folded before Flop (didn't bet)
Seat 3: marvinc02317 (button) showed [Jh Ts] and won ($1.40) with a pair of Jacks
Seat 4: Vorontsov28 (small blind) folded before Flop
Seat 5: Ignatychok (big blind) folded before Flop
Seat 6: Jermein folded before Flop (didn't bet)



PokerStars Hand #222947398067:  Hold'em No Limit ($0.05/$0.10 USD) - 2021/01/23 3:05:13 ET
Table 'Capricorn II' 6-max Seat #4 is the button
Seat 1: rodimana ($6.29 in chips) 
Seat 2: petrovichkag ($10.10 in chips) 
Seat 3: marvinc02317 ($12.81 in chips) 
Seat 4: Vorontsov28 ($10.81 in chips) 
Seat 5: Ignatychok ($5.05 in chips) 
Ignatychok: posts small blind $0.05
Jermein: is sitting out 
rodimana: posts big blind $0.10
*** HOLE CARDS ***
Jermein leaves the table
petrovichkag: folds 
marvinc02317: folds 
nbg-1308 joins the table at seat #6 
Vorontsov28: folds 
Ignatychok: folds 
Uncalled bet ($0.05) returned to rodimana
rodimana collected $0.10 from pot
rodimana: doesn't show hand 
*** SUMMARY ***
Total pot $0.10 | Rake $0 
Seat 1: rodimana (big blind) collected ($0.10)
Seat 2: petrovichkag folded before Flop (didn't bet)
Seat 3: marvinc02317 folded before Flop (didn't bet)
Seat 4: Vorontsov28 (button) folded before Flop (didn't bet)
Seat 5: Ignatychok (small blind) folded before Flop



PokerStars Hand #222947400820:  Hold'em No Limit ($0.05/$0.10 USD) - 2021/01/23 3:05:25 ET
Table 'Capricorn II' 6-max Seat #5 is the button
Seat 1: rodimana ($6.34 in chips) 
Seat 2: petrovichkag ($10.10 in chips) 
Seat 3: marvinc02317 ($12.81 in chips) 
Seat 4: Vorontsov28 ($10.81 in chips) 
Seat 5: Ignatychok ($5 in chips) 
rodimana: posts small blind $0.05
petrovichkag: posts big blind $0.10
*** HOLE CARDS ***
marvinc02317: folds 
Vorontsov28: folds 
Ignatychok: folds 
rodimana: calls $0.05
petrovichkag: checks 
*** FLOP *** [7s 6h 5c]
rodimana: checks 
petrovichkag: checks 
*** TURN *** [7s 6h 5c] [Js]
rodimana: bets $0.10
petrovichkag: folds 
Uncalled bet ($0.10) returned to rodimana
rodimana collected $0.19 from pot
rodimana: doesn't show hand 
*** SUMMARY ***
Total pot $0.20 | Rake $0.01 
Board [7s 6h 5c Js]
Seat 1: rodimana (small blind) collected ($0.19)
Seat 2: petrovichkag (big blind) folded on the Turn
Seat 3: marvinc02317 folded before Flop (didn't bet)
Seat 4: Vorontsov28 folded before Flop (didn't bet)
Seat 5: Ignatychok (button) folded before Flop (didn't bet)



PokerStars Hand #222947406271:  Hold'em No Limit ($0.05/$0.10 USD) - 2021/01/23 3:05:49 ET
Table 'Capricorn II' 6-max Seat #1 is the button
Seat 1: rodimana ($6.43 in chips) 
Seat 2: petrovichkag ($10 in chips) 
Seat 3: marvinc02317 ($12.81 in chips) 
Seat 4: Vorontsov28 ($10.81 in chips) 
Seat 5: Ignatychok ($5 in chips) 
Seat 6: nbg-1308 ($10 in chips) 
petrovichkag: posts small blind $0.05
marvinc02317: posts big blind $0.10
nbg-1308: posts big blind $0.10
*** HOLE CARDS ***
Vorontsov28: folds 
Ignatychok: folds 
nbg-1308: checks 
rodimana: folds 
petrovichkag: folds 
marvinc02317: raises $0.25 to $0.35
nbg-1308: calls $0.25
*** FLOP *** [Ac 2c Qd]
marvinc02317: bets $0.36
nbg-1308: folds 
Uncalled bet ($0.36) returned to marvinc02317
marvinc02317 collected $0.72 from pot
*** SUMMARY ***
Total pot $0.75 | Rake $0.03 
Board [Ac 2c Qd]
Seat 1: rodimana (button) folded before Flop (didn't bet)
Seat 2: petrovichkag (small blind) folded before Flop
Seat 3: marvinc02317 (big blind) collected ($0.72)
Seat 4: Vorontsov28 folded before Flop (didn't bet)
Seat 5: Ignatychok folded before Flop (didn't bet)
Seat 6: nbg-1308 folded on the Flop



PokerStars Hand #222947413142:  Hold'em No Limit ($0.05/$0.10 USD) - 2021/01/23 3:06:18 ET
Table 'Capricorn II' 6-max Seat #2 is the button
Seat 1: rodimana ($6.43 in chips) 
Seat 2: petrovichkag ($10 in chips) 
Seat 3: marvinc02317 ($13.18 in chips) 
Seat 4: Vorontsov28 ($10.81 in chips) 
Seat 5: Ignatychok ($5 in chips) 
Seat 6: nbg-1308 ($9.65 in chips) 
marvinc02317: posts small blind $0.05
Vorontsov28: posts big blind $0.10
*** HOLE CARDS ***
Ignatychok: folds 
nbg-1308: folds 
rodimana: raises $0.10 to $0.20
petrovichkag: folds 
marvinc02317: calls $0.15
Vorontsov28: folds 
*** FLOP *** [4h Qd 3h]
marvinc02317: checks 
rodimana: bets $0.20
marvinc02317: folds 
Uncalled bet ($0.20) returned to rodimana
rodimana collected $0.48 from pot
rodimana: doesn't show hand 
*** SUMMARY ***
Total pot $0.50 | Rake $0.02 
Board [4h Qd 3h]
Seat 1: rodimana collected ($0.48)
Seat 2: petrovichkag (button) folded before Flop (didn't bet)
Seat 3: marvinc02317 (small blind) folded on the Flop
Seat 4: Vorontsov28 (big blind) folded before Flop
Seat 5: Ignatychok folded before Flop (didn't bet)
Seat 6: nbg-1308 folded before Flop (didn't bet)



PokerStars Hand #222947427195:  Hold'em No Limit ($0.05/$0.10 USD) - 2021/01/23 3:07:19 ET
Table 'Capricorn II' 6-max Seat #3 is the button
Seat 1: rodimana ($6.71 in chips) 
Seat 2: petrovichkag ($10 in chips) 
Seat 3: marvinc02317 ($12.98 in chips) 
Seat 4: Vorontsov28 ($10.71 in chips) 
Seat 5: Ignatychok ($5 in chips) 
Seat 6: nbg-1308 ($9.65 in chips) 
Vorontsov28: posts small blind $0.05
Ignatychok: posts big blind $0.10
*** HOLE CARDS ***
nbg-1308: raises $0.10 to $0.20
rodimana: calls $0.20
petrovichkag: folds 
marvinc02317: folds 
Vorontsov28: folds 
Ignatychok: calls $0.10
*** FLOP *** [Kc Qc Qh]
Ignatychok: checks 
nbg-1308: checks 
rodimana: bets $0.20
Ignatychok: folds 
nbg-1308: folds 
Uncalled bet ($0.20) returned to rodimana
rodimana collected $0.62 from pot
rodimana: doesn't show hand 
*** SUMMARY ***
Total pot $0.65 | Rake $0.03 
Board [Kc Qc Qh]
Seat 1: rodimana collected ($0.62)
Seat 2: petrovichkag folded before Flop (didn't bet)
Seat 3: marvinc02317 (button) folded before Flop (didn't bet)
Seat 4: Vorontsov28 (small blind) folded before Flop
Seat 5: Ignatychok (big blind) folded on the Flop
Seat 6: nbg-1308 folded on the Flop



PokerStars Hand #222947433376:  Hold'em No Limit ($0.05/$0.10 USD) - 2021/01/23 3:07:46 ET
Table 'Capricorn II' 6-max Seat #4 is the button
Seat 1: rodimana ($7.13 in chips) 
Seat 2: petrovichkag ($10 in chips) 
Seat 3: marvinc02317 ($12.98 in chips) 
Seat 4: Vorontsov28 ($10.66 in chips) 
Seat 5: Ignatychok ($4.80 in chips) 
Seat 6: nbg-1308 ($9.45 in chips) 
Ignatychok: posts small blind $0.05
nbg-1308: posts big blind $0.10
*** HOLE CARDS ***
rodimana: folds 
petrovichkag: raises $0.14 to $0.24
marvinc02317: folds 
Vorontsov28: raises $0.66 to $0.90
Ignatychok: folds 
nbg-1308: folds 
petrovichkag: calls $0.66
*** FLOP *** [7s Qh 6d]
petrovichkag: checks 
Vorontsov28: bets $1
petrovichkag: folds 
Uncalled bet ($1) returned to Vorontsov28
Vorontsov28 collected $1.86 from pot
Vorontsov28: doesn't show hand 
*** SUMMARY ***
Total pot $1.95 | Rake $0.09 
Board [7s Qh 6d]
Seat 1: rodimana folded before Flop (didn't bet)
Seat 2: petrovichkag folded on the Flop
Seat 3: marvinc02317 folded before Flop (didn't bet)
Seat 4: Vorontsov28 (button) collected ($1.86)
Seat 5: Ignatychok (small blind) folded before Flop
Seat 6: nbg-1308 (big blind) folded before Flop



PokerStars Hand #222947443991:  Hold'em No Limit ($0.05/$0.10 USD) - 2021/01/23 3:08:31 ET
Table 'Capricorn II' 6-max Seat #5 is the button
Seat 1: rodimana ($7.13 in chips) 
Seat 2: petrovichkag ($10 in chips) 
Seat 3: marvinc02317 ($12.98 in chips) 
Seat 4: Vorontsov28 ($11.62 in chips) 
Seat 5: Ignatychok ($4.75 in chips) 
Seat 6: nbg-1308 ($9.35 in chips) 
nbg-1308: posts small blind $0.05
rodimana: posts big blind $0.10
*** HOLE CARDS ***
petrovichkag: raises $0.14 to $0.24
marvinc02317: folds 
Vorontsov28: folds 
Ignatychok: calls $0.24
nbg-1308: folds 
rodimana: folds 
*** FLOP *** [4c Qs Jh]
petrovichkag: checks 
Ignatychok: bets $0.20
petrovichkag: folds 
Uncalled bet ($0.20) returned to Ignatychok
Ignatychok collected $0.60 from pot
Ignatychok: doesn't show hand 
*** SUMMARY ***
Total pot $0.63 | Rake $0.03 
Board [4c Qs Jh]
Seat 1: rodimana (big blind) folded before Flop
Seat 2: petrovichkag folded on the Flop
Seat 3: marvinc02317 folded before Flop (didn't bet)
Seat 4: Vorontsov28 folded before Flop (didn't bet)
Seat 5: Ignatychok (button) collected ($0.60)
Seat 6: nbg-1308 (small blind) folded before Flop



PokerStars Hand #222947449829:  Hold'em No Limit ($0.05/$0.10 USD) - 2021/01/23 3:08:57 ET
Table 'Capricorn II' 6-max Seat #6 is the button
Seat 1: rodimana ($7.03 in chips) 
Seat 2: petrovichkag ($10 in chips) 
Seat 3: marvinc02317 ($12.98 in chips) 
Seat 4: Vorontsov28 ($11.62 in chips) 
Seat 5: Ignatychok ($5.11 in chips) 
Seat 6: nbg-1308 ($9.30 in chips) 
rodimana: posts small blind $0.05
petrovichkag: posts big blind $0.10
*** HOLE CARDS ***
marvinc02317: folds 
Vorontsov28: folds 
Ignatychok: folds 
nbg-1308: folds 
rodimana: raises $0.20 to $0.30
petrovichkag: calls $0.20
*** FLOP *** [9c 5s 6d]
rodimana: checks 
petrovichkag: bets $0.44
rodimana: calls $0.44
*** TURN *** [9c 5s 6d] [8c]
rodimana: checks 
petrovichkag: checks 
*** RIVER *** [9c 5s 6d 8c] [Jd]
rodimana: bets $0.78
petrovichkag is disconnected 
petrovichkag is connected 
petrovichkag: folds 
Uncalled bet ($0.78) returned to rodimana
rodimana collected $1.41 from pot
rodimana: doesn't show hand 
*** SUMMARY ***
Total pot $1.48 | Rake $0.07 
Board [9c 5s 6d 8c Jd]
Seat 1: rodimana (small blind) collected ($1.41)
Seat 2: petrovichkag (big blind) folded on the River
Seat 3: marvinc02317 folded before Flop (didn't bet)
Seat 4: Vorontsov28 folded before Flop (didn't bet)
Seat 5: Ignatychok folded before Flop (didn't bet)
Seat 6: nbg-1308 (button) folded before Flop (didn't bet)



PokerStars Hand #222947471353:  Hold'em No Limit ($0.05/$0.10 USD) - 2021/01/23 3:10:29 ET
Table 'Capricorn II' 6-max Seat #1 is the button
Seat 1: rodimana ($7.70 in chips) 
Seat 2: petrovichkag ($10 in chips) 
Seat 3: marvinc02317 ($12.98 in chips) 
Seat 4: Vorontsov28 ($11.62 in chips) 
Seat 5: Ignatychok ($5.11 in chips) 
Seat 6: nbg-1308 ($9.30 in chips) 
petrovichkag: posts small blind $0.05
marvinc02317: posts big blind $0.10
*** HOLE CARDS ***
Vorontsov28: raises $0.20 to $0.30
Ignatychok: folds 
nbg-1308: folds 
rodimana: folds 
petrovichkag: folds 
marvinc02317: folds 
Uncalled bet ($0.20) returned to Vorontsov28
Vorontsov28 collected $0.25 from pot
Vorontsov28: doesn't show hand 
*** SUMMARY ***
Total pot $0.25 | Rake $0 
Seat 1: rodimana (button) folded before Flop (didn't bet)
Seat 2: petrovichkag (small blind) folded before Flop
Seat 3: marvinc02317 (big blind) folded before Flop
Seat 4: Vorontsov28 collected ($0.25)
Seat 5: Ignatychok folded before Flop (didn't bet)
Seat 6: nbg-1308 folded before Flop (didn't bet)



PokerStars Hand #222947474143:  Hold'em No Limit ($0.05/$0.10 USD) - 2021/01/23 3:10:41 ET
Table 'Capricorn II' 6-max Seat #2 is the button
Seat 1: rodimana ($7.70 in chips) 
Seat 2: petrovichkag ($10 in chips) 
Seat 3: marvinc02317 ($12.88 in chips) 
Seat 4: Vorontsov28 ($11.77 in chips) 
Seat 5: Ignatychok ($5.11 in chips) 
Seat 6: nbg-1308 ($9.30 in chips) 
marvinc02317: posts small blind $0.05
Vorontsov28: posts big blind $0.10
*** HOLE CARDS ***
Ignatychok: folds 
nbg-1308: folds 
rodimana: raises $0.10 to $0.20
petrovichkag: calls $0.20
marvinc02317: calls $0.15
Vorontsov28: raises $1.40 to $1.60
rodimana: folds 
petrovichkag: folds 
marvinc02317: folds 
Uncalled bet ($1.40) returned to Vorontsov28
Vorontsov28 collected $0.80 from pot
Vorontsov28: doesn't show hand 
*** SUMMARY ***
Total pot $0.80 | Rake $0 
Seat 1: rodimana folded before Flop
Seat 2: petrovichkag (button) folded before Flop
Seat 3: marvinc02317 (small blind) folded before Flop
Seat 4: Vorontsov28 (big blind) collected ($0.80)
Seat 5: Ignatychok folded before Flop (didn't bet)
Seat 6: nbg-1308 folded before Flop (didn't bet)



PokerStars Hand #222947480846:  Hold'em No Limit ($0.05/$0.10 USD) - 2021/01/23 3:11:09 ET
Table 'Capricorn II' 6-max Seat #3 is the button
Seat 1: rodimana ($7.50 in chips) 
Seat 2: petrovichkag ($10 in chips) 
Seat 3: marvinc02317 ($12.68 in chips) 
Seat 4: Vorontsov28 ($12.37 in chips) 
Seat 5: Ignatychok ($5.11 in chips) 
Seat 6: nbg-1308 ($9.30 in chips) 
Vorontsov28: posts small blind $0.05
Ignatychok: posts big blind $0.10
*** HOLE CARDS ***
nbg-1308: folds 
rodimana: raises $0.10 to $0.20
petrovichkag: raises $0.40 to $0.60
marvinc02317: folds 
Vorontsov28: folds 
Ignatychok: folds 
rodimana: calls $0.40
*** FLOP *** [4c 7d 2h]
rodimana: checks 
petrovichkag: checks 
*** TURN *** [4c 7d 2h] [4d]
rodimana: bets $0.10
petrovichkag: calls $0.10
*** RIVER *** [4c 7d 2h 4d] [2c]
rodimana: checks 
petrovichkag: checks 
*** SHOW DOWN ***
rodimana: shows [Ah Qs] (two pair, Fours and Deuces)
petrovichkag: shows [Ks Ac] (two pair, Fours and Deuces)
rodimana collected $0.74 from pot
petrovichkag collected $0.74 from pot
*** SUMMARY ***
Total pot $1.55 | Rake $0.07 
Board [4c 7d 2h 4d 2c]
Seat 1: rodimana showed [Ah Qs] and won ($0.74) with two pair, Fours and Deuces
Seat 2: petrovichkag showed [Ks Ac] and won ($0.74) with two pair, Fours and Deuces
Seat 3: marvinc02317 (button) folded before Flop (didn't bet)
Seat 4: Vorontsov28 (small blind) folded before Flop
Seat 5: Ignatychok (big blind) folded before Flop
Seat 6: nbg-1308 folded before Flop (didn't bet)



PokerStars Hand #222947488667:  Hold'em No Limit ($0.05/$0.10 USD) - 2021/01/23 3:11:43 ET
Table 'Capricorn II' 6-max Seat #4 is the button
Seat 1: rodimana ($7.54 in chips) 
Seat 2: petrovichkag ($10.04 in chips) 
Seat 3: marvinc02317 ($12.68 in chips) 
Seat 4: Vorontsov28 ($12.32 in chips) 
Seat 5: Ignatychok ($5.01 in chips) 
Seat 6: nbg-1308 ($9.30 in chips) 
Ignatychok: posts small blind $0.05
nbg-1308: posts big blind $0.10
*** HOLE CARDS ***
rodimana: folds 
petrovichkag: raises $0.14 to $0.24
marvinc02317: folds 
Vorontsov28: folds 
Ignatychok: folds 
nbg-1308: folds 
Uncalled bet ($0.14) returned to petrovichkag
petrovichkag collected $0.25 from pot
petrovichkag: doesn't show hand 
*** SUMMARY ***
Total pot $0.25 | Rake $0 
Seat 1: rodimana folded before Flop (didn't bet)
Seat 2: petrovichkag collected ($0.25)
Seat 3: marvinc02317 folded before Flop (didn't bet)
Seat 4: Vorontsov28 (button) folded before Flop (didn't bet)
Seat 5: Ignatychok (small blind) folded before Flop
Seat 6: nbg-1308 (big blind) folded before Flop



PokerStars Hand #222947491843:  Hold'em No Limit ($0.05/$0.10 USD) - 2021/01/23 3:11:56 ET
Table 'Capricorn II' 6-max Seat #5 is the button
Seat 1: rodimana ($7.54 in chips) 
Seat 2: petrovichkag ($10.19 in chips) 
Seat 3: marvinc02317 ($12.68 in chips) 
Seat 4: Vorontsov28 ($12.32 in chips) 
Seat 5: Ignatychok ($4.96 in chips) 
Seat 6: nbg-1308 ($9.20 in chips) 
nbg-1308: posts small blind $0.05
rodimana: posts big blind $0.10
*** HOLE CARDS ***
petrovichkag: folds 
marvinc02317: calls $0.10
Vorontsov28: folds 
Ignatychok: folds 
nbg-1308: calls $0.05
rodimana: checks 
*** FLOP *** [4d 3h 6s]
nbg-1308: bets $0.10
rodimana: calls $0.10
marvinc02317: calls $0.10
*** TURN *** [4d 3h 6s] [2d]
nbg-1308: bets $0.10
rodimana: folds 
marvinc02317: folds 
Uncalled bet ($0.10) returned to nbg-1308
nbg-1308 collected $0.57 from pot
nbg-1308: doesn't show hand 
*** SUMMARY ***
Total pot $0.60 | Rake $0.03 
Board [4d 3h 6s 2d]
Seat 1: rodimana (big blind) folded on the Turn
Seat 2: petrovichkag folded before Flop (didn't bet)
Seat 3: marvinc02317 folded on the Turn
Seat 4: Vorontsov28 folded before Flop (didn't bet)
Seat 5: Ignatychok (button) folded before Flop (didn't bet)
Seat 6: nbg-1308 (small blind) collected ($0.57)



PokerStars Hand #222947499747:  Hold'em No Limit ($0.05/$0.10 USD) - 2021/01/23 3:12:30 ET
Table 'Capricorn II' 6-max Seat #6 is the button
Seat 1: rodimana ($7.34 in chips) 
Seat 2: petrovichkag ($10.19 in chips) 
Seat 3: marvinc02317 ($12.48 in chips) 
Seat 4: Vorontsov28 ($12.32 in chips) 
Seat 5: Ignatychok ($4.96 in chips) 
Seat 6: nbg-1308 ($9.57 in chips) 
rodimana: posts small blind $0.05
petrovichkag: posts big blind $0.10
*** HOLE CARDS ***
marvinc02317: calls $0.10
Vorontsov28: folds 
Ignatychok: folds 
nbg-1308: raises $0.10 to $0.20
rodimana: raises $0.40 to $0.60
petrovichkag: folds 
marvinc02317: raises $1.50 to $2.10
nbg-1308: folds 
rodimana: folds 
Uncalled bet ($1.50) returned to marvinc02317
marvinc02317 collected $1.50 from pot
*** SUMMARY ***
Total pot $1.50 | Rake $0 
Seat 1: rodimana (small blind) folded before Flop
Seat 2: petrovichkag (big blind) folded before Flop
Seat 3: marvinc02317 collected ($1.50)
Seat 4: Vorontsov28 folded before Flop (didn't bet)
Seat 5: Ignatychok folded before Flop (didn't bet)
Seat 6: nbg-1308 (button) folded before Flop



PokerStars Hand #222947507518:  Hold'em No Limit ($0.05/$0.10 USD) - 2021/01/23 3:13:02 ET
Table 'Capricorn II' 6-max Seat #1 is the button
Seat 1: rodimana ($6.74 in chips) 
Seat 2: petrovichkag ($10.09 in chips) 
Seat 3: marvinc02317 ($13.38 in chips) 
Seat 4: Vorontsov28 ($12.32 in chips) 
Seat 5: Ignatychok ($4.96 in chips) 
Seat 6: nbg-1308 ($9.37 in chips) 
petrovichkag: posts small blind $0.05
marvinc02317: posts big blind $0.10
*** HOLE CARDS ***
Vorontsov28: folds 
Ignatychok: folds 
nbg-1308: folds 
rodimana: raises $0.10 to $0.20
petrovichkag: folds 
marvinc02317: calls $0.10
*** FLOP *** [7s Qh 9c]
marvinc02317: bets $0.22
rodimana: calls $0.22
*** TURN *** [7s Qh 9c] [Ac]
marvinc02317: bets $0.43
rodimana: calls $0.43
*** RIVER *** [7s Qh 9c Ac] [8s]
marvinc02317: bets $0.84
rodimana: calls $0.84
*** SHOW DOWN ***
marvinc02317: shows [As Td] (a pair of Aces)
rodimana: shows [8c 7c] (two pair, Eights and Sevens)
rodimana collected $3.28 from pot
*** SUMMARY ***
Total pot $3.43 | Rake $0.15 
Board [7s Qh 9c Ac 8s]
Seat 1: rodimana (button) showed [8c 7c] and won ($3.28) with two pair, Eights and Sevens
Seat 2: petrovichkag (small blind) folded before Flop
Seat 3: marvinc02317 (big blind) showed [As Td] and lost with a pair of Aces
Seat 4: Vorontsov28 folded before Flop (didn't bet)
Seat 5: Ignatychok folded before Flop (didn't bet)
Seat 6: nbg-1308 folded before Flop (didn't bet)



PokerStars Hand #222947514119:  Hold'em No Limit ($0.05/$0.10 USD) - 2021/01/23 3:13:30 ET
Table 'Capricorn II' 6-max Seat #2 is the button
Seat 1: rodimana ($8.33 in chips) 
Seat 2: petrovichkag ($10.04 in chips) 
Seat 3: marvinc02317 ($11.69 in chips) 
Seat 4: Vorontsov28 ($12.32 in chips) 
Seat 5: Ignatychok ($4.96 in chips) 
Seat 6: nbg-1308 ($9.37 in chips) 
marvinc02317: posts small blind $0.05
Vorontsov28: posts big blind $0.10
*** HOLE CARDS ***
Ignatychok: folds 
nbg-1308: folds 
rodimana: raises $0.10 to $0.20
petrovichkag: folds 
marvinc02317: folds 
Vorontsov28: calls $0.10
*** FLOP *** [3d 6c Qs]
Vorontsov28: checks 
rodimana: checks 
*** TURN *** [3d 6c Qs] [2h]
Vorontsov28: checks 
rodimana: checks 
*** RIVER *** [3d 6c Qs 2h] [Th]
Vorontsov28: checks 
rodimana: checks 
*** SHOW DOWN ***
Vorontsov28: shows [Ad 7d] (high card Ace)
rodimana: mucks hand 
Vorontsov28 collected $0.43 from pot
*** SUMMARY ***
Total pot $0.45 | Rake $0.02 
Board [3d 6c Qs 2h Th]
Seat 1: rodimana mucked
Seat 2: petrovichkag (button) folded before Flop (didn't bet)
Seat 3: marvinc02317 (small blind) folded before Flop
Seat 4: Vorontsov28 (big blind) showed [Ad 7d] and won ($0.43) with high card Ace
Seat 5: Ignatychok folded before Flop (didn't bet)
Seat 6: nbg-1308 folded before Flop (didn't bet)



PokerStars Hand #222947520293:  Hold'em No Limit ($0.05/$0.10 USD) - 2021/01/23 3:13:57 ET
Table 'Capricorn II' 6-max Seat #3 is the button
Seat 1: rodimana ($8.13 in chips) 
Seat 2: petrovichkag ($10.04 in chips) 
Seat 3: marvinc02317 ($11.64 in chips) 
Seat 4: Vorontsov28 ($12.55 in chips) 
Seat 5: Ignatychok ($4.96 in chips) 
Seat 6: nbg-1308 ($9.37 in chips) 
Vorontsov28: posts small blind $0.05
Ignatychok: posts big blind $0.10
*** HOLE CARDS ***
nbg-1308: folds 
rodimana: folds 
petrovichkag: folds 
marvinc02317: raises $0.25 to $0.35
Vorontsov28: folds 
Ignatychok: folds 
Uncalled bet ($0.25) returned to marvinc02317
marvinc02317 collected $0.25 from pot
*** SUMMARY ***
Total pot $0.25 | Rake $0 
Seat 1: rodimana folded before Flop (didn't bet)
Seat 2: petrovichkag folded before Flop (didn't bet)
Seat 3: marvinc02317 (button) collected ($0.25)
Seat 4: Vorontsov28 (small blind) folded before Flop
Seat 5: Ignatychok (big blind) folded before Flop
Seat 6: nbg-1308 folded before Flop (didn't bet)



PokerStars Hand #222947527204:  Hold'em No Limit ($0.05/$0.10 USD) - 2021/01/23 3:14:25 ET
Table 'Capricorn II' 6-max Seat #4 is the button
Seat 1: rodimana ($8.13 in chips) 
Seat 2: petrovichkag ($10.04 in chips) 
Seat 3: marvinc02317 ($11.79 in chips) 
Seat 4: Vorontsov28 ($12.50 in chips) 
Seat 5: Ignatychok ($4.86 in chips) 
Seat 6: nbg-1308 ($9.37 in chips) 
Ignatychok: posts small blind $0.05
nbg-1308: posts big blind $0.10
*** HOLE CARDS ***
rodimana: folds 
petrovichkag: folds 
marvinc02317: folds 
Vorontsov28: raises $0.20 to $0.30
Ignatychok: folds 
nbg-1308: folds 
Uncalled bet ($0.20) returned to Vorontsov28
Vorontsov28 collected $0.25 from pot
Vorontsov28: doesn't show hand 
*** SUMMARY ***
Total pot $0.25 | Rake $0 
Seat 1: rodimana folded before Flop (didn't bet)
Seat 2: petrovichkag folded before Flop (didn't bet)
Seat 3: marvinc02317 folded before Flop (didn't bet)
Seat 4: Vorontsov28 (button) collected ($0.25)
Seat 5: Ignatychok (small blind) folded before Flop
Seat 6: nbg-1308 (big blind) folded before Flop



PokerStars Hand #222947530468:  Hold'em No Limit ($0.05/$0.10 USD) - 2021/01/23 3:14:39 ET
Table 'Capricorn II' 6-max Seat #5 is the button
Seat 1: rodimana ($8.13 in chips) 
Seat 2: petrovichkag ($10.04 in chips) 
Seat 3: marvinc02317 ($11.79 in chips) 
Seat 4: Vorontsov28 ($12.65 in chips) 
Seat 5: Ignatychok ($4.81 in chips) 
Seat 6: nbg-1308 ($9.27 in chips) 
nbg-1308: posts small blind $0.05
rodimana: posts big blind $0.10
*** HOLE CARDS ***
petrovichkag: folds 
marvinc02317: folds 
Vorontsov28: raises $0.20 to $0.30
Ignatychok: folds 
nbg-1308: calls $0.25
rodimana: folds 
*** FLOP *** [Tc 4s As]
nbg-1308: checks 
Vorontsov28: bets $0.20
nbg-1308: calls $0.20
*** TURN *** [Tc 4s As] [5s]
nbg-1308: checks 
Vorontsov28: checks 
*** RIVER *** [Tc 4s As 5s] [Qc]
nbg-1308: checks 
Vorontsov28: checks 
*** SHOW DOWN ***
nbg-1308: shows [9c 9h] (a pair of Nines)
Vorontsov28: shows [Ad Jc] (a pair of Aces)
Vorontsov28 collected $1.05 from pot
*** SUMMARY ***
Total pot $1.10 | Rake $0.05 
Board [Tc 4s As 5s Qc]
Seat 1: rodimana (big blind) folded before Flop
Seat 2: petrovichkag folded before Flop (didn't bet)
Seat 3: marvinc02317 folded before Flop (didn't bet)
Seat 4: Vorontsov28 showed [Ad Jc] and won ($1.05) with a pair of Aces
Seat 5: Ignatychok (button) folded before Flop (didn't bet)
Seat 6: nbg-1308 (small blind) showed [9c 9h] and lost with a pair of Nines



PokerStars Hand #222947538147:  Hold'em No Limit ($0.05/$0.10 USD) - 2021/01/23 3:15:11 ET
Table 'Capricorn II' 6-max Seat #6 is the button
Seat 1: rodimana ($8.03 in chips) 
Seat 2: petrovichkag ($10.04 in chips) 
Seat 3: marvinc02317 ($11.79 in chips) 
Seat 4: Vorontsov28 ($13.20 in chips) 
Seat 5: Ignatychok ($4.81 in chips) 
Seat 6: nbg-1308 ($8.77 in chips) 
rodimana: posts small blind $0.05
petrovichkag: posts big blind $0.10
*** HOLE CARDS ***
marvinc02317: folds 
Vorontsov28: folds 
Ignatychok: folds 
nbg-1308: folds 
rodimana: folds 
Uncalled bet ($0.05) returned to petrovichkag
petrovichkag collected $0.10 from pot
petrovichkag: doesn't show hand 
*** SUMMARY ***
Total pot $0.10 | Rake $0 
Seat 1: rodimana (small blind) folded before Flop
Seat 2: petrovichkag (big blind) collected ($0.10)
Seat 3: marvinc02317 folded before Flop (didn't bet)
Seat 4: Vorontsov28 folded before Flop (didn't bet)
Seat 5: Ignatychok folded before Flop (didn't bet)
Seat 6: nbg-1308 (button) folded before Flop (didn't bet)



PokerStars Hand #222947541736:  Hold'em No Limit ($0.05/$0.10 USD) - 2021/01/23 3:15:27 ET
Table 'Capricorn II' 6-max Seat #1 is the button
Seat 1: rodimana ($7.98 in chips) 
Seat 2: petrovichkag ($10.09 in chips) 
Seat 3: marvinc02317 ($11.79 in chips) 
Seat 4: Vorontsov28 ($13.20 in chips) 
Seat 5: Ignatychok ($4.81 in chips) 
Seat 6: nbg-1308 ($8.77 in chips) 
petrovichkag: posts small blind $0.05
marvinc02317: posts big blind $0.10
*** HOLE CARDS ***
Vorontsov28: folds 
Ignatychok: calls $0.10
nbg-1308: calls $0.10
rodimana: calls $0.10
petrovichkag: folds 
marvinc02317: raises $0.45 to $0.55
Ignatychok: folds 
nbg-1308: calls $0.45
rodimana: folds 
*** FLOP *** [4h 4d Ks]
marvinc02317: bets $1.30
nbg-1308: folds 
Uncalled bet ($1.30) returned to marvinc02317
marvinc02317 collected $1.29 from pot
*** SUMMARY ***
Total pot $1.35 | Rake $0.06 
Board [4h 4d Ks]
Seat 1: rodimana (button) folded before Flop
Seat 2: petrovichkag (small blind) folded before Flop
Seat 3: marvinc02317 (big blind) collected ($1.29)
Seat 4: Vorontsov28 folded before Flop (didn't bet)
Seat 5: Ignatychok folded before Flop
Seat 6: nbg-1308 folded on the Flop



PokerStars Hand #222947551288:  Hold'em No Limit ($0.05/$0.10 USD) - 2021/01/23 3:16:07 ET
Table 'Capricorn II' 6-max Seat #2 is the button
Seat 1: rodimana ($7.88 in chips) 
Seat 2: petrovichkag ($10.04 in chips) 
Seat 3: marvinc02317 ($12.53 in chips) 
Seat 4: Vorontsov28 ($13.20 in chips) 
Seat 5: Ignatychok ($4.71 in chips) 
Seat 6: nbg-1308 ($8.22 in chips) 
marvinc02317: posts small blind $0.05
Vorontsov28: posts big blind $0.10
*** HOLE CARDS ***
Ignatychok: raises $0.20 to $0.30
nbg-1308: folds 
rodimana: folds 
petrovichkag: folds 
marvinc02317: raises $0.70 to $1
Vorontsov28: folds 
Ignatychok: calls $0.70
*** FLOP *** [7d 6s Kd]
marvinc02317: bets $1.10
Ignatychok: raises $2.61 to $3.71 and is all-in
marvinc02317: calls $2.61
*** TURN *** [7d 6s Kd] [9c]
*** RIVER *** [7d 6s Kd 9c] [Jc]
*** SHOW DOWN ***
marvinc02317: shows [Jd Jh] (three of a kind, Jacks)
Ignatychok: shows [Kh Qh] (a pair of Kings)
marvinc02317 collected $9.09 from pot
*** SUMMARY ***
Total pot $9.52 | Rake $0.43 
Board [7d 6s Kd 9c Jc]
Seat 1: rodimana folded before Flop (didn't bet)
Seat 2: petrovichkag (button) folded before Flop (didn't bet)
Seat 3: marvinc02317 (small blind) showed [Jd Jh] and won ($9.09) with three of a kind, Jacks
Seat 4: Vorontsov28 (big blind) folded before Flop
Seat 5: Ignatychok showed [Kh Qh] and lost with a pair of Kings
Seat 6: nbg-1308 folded before Flop (didn't bet)



PokerStars Hand #222947561145:  Hold'em No Limit ($0.05/$0.10 USD) - 2021/01/23 3:16:48 ET
Table 'Capricorn II' 6-max Seat #3 is the button
Seat 1: rodimana ($7.88 in chips) 
Seat 2: petrovichkag ($10.04 in chips) 
Seat 3: marvinc02317 ($16.91 in chips) 
Seat 4: Vorontsov28 ($13.10 in chips) 
Seat 6: nbg-1308 ($8.22 in chips) 
Vorontsov28: posts small blind $0.05
nbg-1308: posts big blind $0.10
*** HOLE CARDS ***
rodimana: folds 
petrovichkag: folds 
marvinc02317: folds 
Vorontsov28: folds 
Uncalled bet ($0.05) returned to nbg-1308
nbg-1308 collected $0.10 from pot
nbg-1308: doesn't show hand 
*** SUMMARY ***
Total pot $0.10 | Rake $0 
Seat 1: rodimana folded before Flop (didn't bet)
Seat 2: petrovichkag folded before Flop (didn't bet)
Seat 3: marvinc02317 (button) folded before Flop (didn't bet)
Seat 4: Vorontsov28 (small blind) folded before Flop
Seat 6: nbg-1308 (big blind) collected ($0.10)



PokerStars Hand #222947563617:  Hold'em No Limit ($0.05/$0.10 USD) - 2021/01/23 3:16:58 ET
Table 'Capricorn II' 6-max Seat #4 is the button
Seat 1: rodimana ($7.88 in chips) 
Seat 2: petrovichkag ($10.04 in chips) 
Seat 3: marvinc02317 ($16.91 in chips) 
Seat 4: Vorontsov28 ($13.05 in chips) 
Seat 6: nbg-1308 ($8.27 in chips) 
nbg-1308: posts small blind $0.05
rodimana: posts big blind $0.10
*** HOLE CARDS ***
petrovichkag: folds 
marvinc02317: folds 
Vorontsov28: raises $0.20 to $0.30
nbg-1308: folds 
rodimana: folds 
Uncalled bet ($0.20) returned to Vorontsov28
Vorontsov28 collected $0.25 from pot
Vorontsov28: doesn't show hand 
*** SUMMARY ***
Total pot $0.25 | Rake $0 
Seat 1: rodimana (big blind) folded before Flop
Seat 2: petrovichkag folded before Flop (didn't bet)
Seat 3: marvinc02317 folded before Flop (didn't bet)
Seat 4: Vorontsov28 (button) collected ($0.25)
Seat 6: nbg-1308 (small blind) folded before Flop



PokerStars Hand #222947569099:  Hold'em No Limit ($0.05/$0.10 USD) - 2021/01/23 3:17:22 ET
Table 'Capricorn II' 6-max Seat #6 is the button
Seat 1: rodimana ($7.78 in chips) 
Seat 2: petrovichkag ($10.04 in chips) 
Seat 3: marvinc02317 ($16.91 in chips) 
Seat 4: Vorontsov28 ($13.20 in chips) 
Seat 6: nbg-1308 ($8.22 in chips) 
rodimana: posts small blind $0.05
petrovichkag: posts big blind $0.10
*** HOLE CARDS ***
marvinc02317: folds 
Vorontsov28: folds 
nbg-1308: folds 
rodimana: raises $0.10 to $0.20
petrovichkag: folds 
Uncalled bet ($0.10) returned to rodimana
rodimana collected $0.20 from pot
rodimana: doesn't show hand 
*** SUMMARY ***
Total pot $0.20 | Rake $0 
Seat 1: rodimana (small blind) collected ($0.20)
Seat 2: petrovichkag (big blind) folded before Flop
Seat 3: marvinc02317 folded before Flop (didn't bet)
Seat 4: Vorontsov28 folded before Flop (didn't bet)
Seat 6: nbg-1308 (button) folded before Flop (didn't bet)



PokerStars Hand #222947572678:  Hold'em No Limit ($0.05/$0.10 USD) - 2021/01/23 3:17:36 ET
Table 'Capricorn II' 6-max Seat #1 is the button
Seat 1: rodimana ($7.88 in chips) 
Seat 2: petrovichkag ($10 in chips) 
Seat 3: marvinc02317 ($16.91 in chips) 
Seat 4: Vorontsov28 ($13.20 in chips) 
Seat 6: nbg-1308 ($8.22 in chips) 
petrovichkag: posts small blind $0.05
marvinc02317: posts big blind $0.10
*** HOLE CARDS ***
Vorontsov28: folds 
nbg-1308: folds 
rodimana: raises $0.10 to $0.20
petrovichkag: folds 
marvinc02317: folds 
Uncalled bet ($0.10) returned to rodimana
rodimana collected $0.25 from pot
rodimana: doesn't show hand 
*** SUMMARY ***
Total pot $0.25 | Rake $0 
Seat 1: rodimana (button) collected ($0.25)
Seat 2: petrovichkag (small blind) folded before Flop
Seat 3: marvinc02317 (big blind) folded before Flop
Seat 4: Vorontsov28 folded before Flop (didn't bet)
Seat 6: nbg-1308 folded before Flop (didn't bet)



PokerStars Hand #222947575866:  Hold'em No Limit ($0.05/$0.10 USD) - 2021/01/23 3:17:50 ET
Table 'Capricorn II' 6-max Seat #2 is the button
Seat 1: rodimana ($8.03 in chips) 
Seat 2: petrovichkag ($10 in chips) 
Seat 3: marvinc02317 ($16.81 in chips) 
Seat 4: Vorontsov28 ($13.20 in chips) 
Seat 6: nbg-1308 ($8.22 in chips) 
marvinc02317: posts small blind $0.05
Vorontsov28: posts big blind $0.10
*** HOLE CARDS ***
nbg-1308: folds 
rodimana: folds 
petrovichkag: raises $0.14 to $0.24
marvinc02317: calls $0.19
Vorontsov28: folds 
*** FLOP *** [Qc Th 4d]
marvinc02317: checks 
petrovichkag: bets $0.18
marvinc02317: folds 
Uncalled bet ($0.18) returned to petrovichkag
petrovichkag collected $0.55 from pot
petrovichkag: doesn't show hand 
*** SUMMARY ***
Total pot $0.58 | Rake $0.03 
Board [Qc Th 4d]
Seat 1: rodimana folded before Flop (didn't bet)
Seat 2: petrovichkag (button) collected ($0.55)
Seat 3: marvinc02317 (small blind) folded on the Flop
Seat 4: Vorontsov28 (big blind) folded before Flop
Seat 6: nbg-1308 folded before Flop (didn't bet)



PokerStars Hand #222947582684:  Hold'em No Limit ($0.05/$0.10 USD) - 2021/01/23 3:18:18 ET
Table 'Capricorn II' 6-max Seat #3 is the button
Seat 1: rodimana ($8.03 in chips) 
Seat 2: petrovichkag ($10.31 in chips) 
Seat 3: marvinc02317 ($16.57 in chips) 
Seat 4: Vorontsov28 ($13.10 in chips) 
Seat 6: nbg-1308 ($8.22 in chips) 
Vorontsov28: posts small blind $0.05
nbg-1308: posts big blind $0.10
*** HOLE CARDS ***
rodimana: folds 
petrovichkag: folds 
marvinc02317: folds 
Vorontsov28: folds 
Uncalled bet ($0.05) returned to nbg-1308
nbg-1308 collected $0.10 from pot
nbg-1308: doesn't show hand 
*** SUMMARY ***
Total pot $0.10 | Rake $0 
Seat 1: rodimana folded before Flop (didn't bet)
Seat 2: petrovichkag folded before Flop (didn't bet)
Seat 3: marvinc02317 (button) folded before Flop (didn't bet)
Seat 4: Vorontsov28 (small blind) folded before Flop
Seat 6: nbg-1308 (big blind) collected ($0.10)



PokerStars Hand #222947585309:  Hold'em No Limit ($0.05/$0.10 USD) - 2021/01/23 3:18:29 ET
Table 'Capricorn II' 6-max Seat #4 is the button
Seat 1: rodimana ($8.03 in chips) 
Seat 2: petrovichkag ($10.31 in chips) 
Seat 3: marvinc02317 ($16.57 in chips) 
Seat 4: Vorontsov28 ($13.05 in chips) 
Seat 6: nbg-1308 ($8.27 in chips) 
nbg-1308: posts small blind $0.05
rodimana: posts big blind $0.10
*** HOLE CARDS ***
petrovichkag: folds 
marvinc02317: folds 
Vorontsov28: folds 
nbg-1308: raises $0.10 to $0.20
rodimana: calls $0.10
*** FLOP *** [7h 4d 9c]
nbg-1308: bets $0.10
rodimana: folds 
Uncalled bet ($0.10) returned to nbg-1308
nbg-1308 collected $0.38 from pot
nbg-1308: doesn't show hand 
*** SUMMARY ***
Total pot $0.40 | Rake $0.02 
Board [7h 4d 9c]
Seat 1: rodimana (big blind) folded on the Flop
Seat 2: petrovichkag folded before Flop (didn't bet)
Seat 3: marvinc02317 folded before Flop (didn't bet)
Seat 4: Vorontsov28 (button) folded before Flop (didn't bet)
Seat 6: nbg-1308 (small blind) collected ($0.38)



PokerStars Hand #222947589000:  Hold'em No Limit ($0.05/$0.10 USD) - 2021/01/23 3:18:45 ET
Table 'Capricorn II' 6-max Seat #6 is the button
Seat 1: rodimana ($7.83 in chips) 
Seat 2: petrovichkag ($10.31 in chips) 
Seat 3: marvinc02317 ($16.57 in chips) 
Seat 4: Vorontsov28 ($13.05 in chips) 
Seat 6: nbg-1308 ($8.45 in chips) 
rodimana: posts small blind $0.05
petrovichkag: posts big blind $0.10
*** HOLE CARDS ***
marvinc02317 has timed out
marvinc02317: folds 
Vorontsov28: folds 
nbg-1308: folds 
rodimana: folds 
Uncalled bet ($0.05) returned to petrovichkag
petrovichkag collected $0.10 from pot
petrovichkag: doesn't show hand 
*** SUMMARY ***
Total pot $0.10 | Rake $0 
Seat 1: rodimana (small blind) folded before Flop
Seat 2: petrovichkag (big blind) collected ($0.10)
Seat 3: marvinc02317 folded before Flop (didn't bet)
Seat 4: Vorontsov28 folded before Flop (didn't bet)
Seat 6: nbg-1308 (button) folded before Flop (didn't bet)



PokerStars Hand #222947593598:  Hold'em No Limit ($0.05/$0.10 USD) - 2021/01/23 3:19:04 ET
Table 'Capricorn II' 6-max Seat #1 is the button
Seat 1: rodimana ($7.78 in chips) 
Seat 3: marvinc02317 ($16.57 in chips) 
Seat 4: Vorontsov28 ($13.05 in chips) 
Seat 6: nbg-1308 ($8.45 in chips) 
marvinc02317: posts small blind $0.05
Vorontsov28: posts big blind $0.10
*** HOLE CARDS ***
nbg-1308: calls $0.10
rodimana: calls $0.10
marvinc02317: folds 
Vorontsov28: checks 
*** FLOP *** [Qc 2h Qs]
Vorontsov28: bets $0.33
nbg-1308: calls $0.33
rodimana: folds 
*** TURN *** [Qc 2h Qs] [9c]
Vorontsov28: bets $0.96
nbg-1308: calls $0.96
*** RIVER *** [Qc 2h Qs 9c] [8d]
Vorontsov28: bets $2.80
nbg-1308: raises $2.80 to $5.60
Vorontsov28: calls $2.80
*** SHOW DOWN ***
nbg-1308: shows [9s 9d] (a full house, Nines full of Queens)
Vorontsov28: mucks hand 
nbg-1308 collected $13.49 from pot
*** SUMMARY ***
Total pot $14.13 | Rake $0.64 
Board [Qc 2h Qs 9c 8d]
Seat 1: rodimana (button) folded on the Flop
Seat 3: marvinc02317 (small blind) folded before Flop
Seat 4: Vorontsov28 (big blind) mucked
Seat 6: nbg-1308 showed [9s 9d] and won ($13.49) with a full house, Nines full of Queens



PokerStars Hand #222947600042:  Hold'em No Limit ($0.05/$0.10 USD) - 2021/01/23 3:19:31 ET
Table 'Capricorn II' 6-max Seat #3 is the button
Seat 1: rodimana ($7.68 in chips) 
Seat 3: marvinc02317 ($16.52 in chips) 
Seat 4: Vorontsov28 ($10 in chips) 
Seat 6: nbg-1308 ($14.95 in chips) 
Vorontsov28: posts small blind $0.05
nbg-1308: posts big blind $0.10
*** HOLE CARDS ***
rodimana: folds 
marvinc02317: raises $16.42 to $16.52 and is all-in
Vorontsov28: folds 
nbg-1308: folds 
Uncalled bet ($16.42) returned to marvinc02317
marvinc02317 collected $0.25 from pot
*** SUMMARY ***
Total pot $0.25 | Rake $0 
Seat 1: rodimana folded before Flop (didn't bet)
Seat 3: marvinc02317 (button) collected ($0.25)
Seat 4: Vorontsov28 (small blind) folded before Flop
Seat 6: nbg-1308 (big blind) folded before Flop



PokerStars Hand #222947603176:  Hold'em No Limit ($0.05/$0.10 USD) - 2021/01/23 3:19:44 ET
Table 'Capricorn II' 6-max Seat #4 is the button
Seat 1: rodimana ($7.68 in chips) 
Seat 3: marvinc02317 ($16.67 in chips) 
Seat 4: Vorontsov28 ($10 in chips) 
Seat 6: nbg-1308 ($14.85 in chips) 
nbg-1308: posts small blind $0.05
rodimana: posts big blind $0.10
*** HOLE CARDS ***
marvinc02317: folds 
Vorontsov28: raises $0.20 to $0.30
nbg-1308: folds 
rodimana: folds 
Uncalled bet ($0.20) returned to Vorontsov28
Vorontsov28 collected $0.25 from pot
Vorontsov28: doesn't show hand 
*** SUMMARY ***
Total pot $0.25 | Rake $0 
Seat 1: rodimana (big blind) folded before Flop
Seat 3: marvinc02317 folded before Flop (didn't bet)
Seat 4: Vorontsov28 (button) collected ($0.25)
Seat 6: nbg-1308 (small blind) folded before Flop



PokerStars Hand #222947605891:  Hold'em No Limit ($0.05/$0.10 USD) - 2021/01/23 3:19:55 ET
Table 'Capricorn II' 6-max Seat #6 is the button
Seat 1: rodimana ($7.58 in chips) 
Seat 3: marvinc02317 ($16.67 in chips) 
Seat 4: Vorontsov28 ($10.15 in chips) 
Seat 6: nbg-1308 ($14.80 in chips) 
rodimana: posts small blind $0.05
marvinc02317: posts big blind $0.10
*** HOLE CARDS ***
Vorontsov28: folds 
nbg-1308: folds 
rodimana: raises $0.10 to $0.20
marvinc02317: raises $16.47 to $16.67 and is all-in
rodimana: folds 
Uncalled bet ($16.47) returned to marvinc02317
marvinc02317 collected $0.40 from pot
*** SUMMARY ***
Total pot $0.40 | Rake $0 
Seat 1: rodimana (small blind) folded before Flop
Seat 3: marvinc02317 (big blind) collected ($0.40)
Seat 4: Vorontsov28 folded before Flop (didn't bet)
Seat 6: nbg-1308 (button) folded before Flop (didn't bet)



PokerStars Hand #222947608606:  Hold'em No Limit ($0.05/$0.10 USD) - 2021/01/23 3:20:07 ET
Table 'Capricorn II' 6-max Seat #1 is the button
Seat 1: rodimana ($7.38 in chips) 
Seat 3: marvinc02317 ($16.87 in chips) 
Seat 4: Vorontsov28 ($10.15 in chips) 
Seat 6: nbg-1308 ($14.80 in chips) 
marvinc02317: posts small blind $0.05
Vorontsov28: posts big blind $0.10
*** HOLE CARDS ***
nbg-1308: calls $0.10
rodimana: calls $0.10
marvinc02317: calls $0.05
Vorontsov28: checks 
*** FLOP *** [6h 8s 3d]
marvinc02317: bets $0.10
Vorontsov28: calls $0.10
nbg-1308: calls $0.10
rodimana: calls $0.10
*** TURN *** [6h 8s 3d] [Jc]
marvinc02317: bets $0.38
Vorontsov28: calls $0.38
nbg-1308: calls $0.38
rodimana: calls $0.38
*** RIVER *** [6h 8s 3d Jc] [4h]
marvinc02317: checks 
Vorontsov28: checks 
nbg-1308: bets $1.11
rodimana: calls $1.11
marvinc02317: folds 
Vorontsov28: folds 
*** SHOW DOWN ***
nbg-1308: shows [Jh 5h] (a pair of Jacks)
rodimana: shows [7h Jd] (a pair of Jacks - Eight+Seven kicker)
rodimana collected $4.34 from pot
*** SUMMARY ***
Total pot $4.54 | Rake $0.20 
Board [6h 8s 3d Jc 4h]
Seat 1: rodimana (button) showed [7h Jd] and won ($4.34) with a pair of Jacks
Seat 3: marvinc02317 (small blind) folded on the River
Seat 4: Vorontsov28 (big blind) folded on the River
Seat 6: nbg-1308 showed [Jh 5h] and lost with a pair of Jacks



PokerStars Hand #222947621484:  Hold'em No Limit ($0.05/$0.10 USD) - 2021/01/23 3:21:00 ET
Table 'Capricorn II' 6-max Seat #3 is the button
Seat 1: rodimana ($10.03 in chips) 
Seat 3: marvinc02317 ($16.29 in chips) 
Seat 4: Vorontsov28 ($10 in chips) 
Seat 6: nbg-1308 ($13.11 in chips) 
Vorontsov28: posts small blind $0.05
nbg-1308: posts big blind $0.10
petrovichkag: sits out 
*** HOLE CARDS ***
rodimana: raises $0.10 to $0.20
marvinc02317: raises $0.30 to $0.50
Vorontsov28: folds 
nbg-1308: calls $0.40
rodimana: calls $0.30
*** FLOP *** [Ks 6h 2h]
nbg-1308: checks 
rodimana: checks 
marvinc02317: bets $0.90
nbg-1308: calls $0.90
rodimana: folds 
*** TURN *** [Ks 6h 2h] [7d]
nbg-1308: checks 
marvinc02317: checks 
*** RIVER *** [Ks 6h 2h 7d] [6d]
nbg-1308: checks 
marvinc02317: checks 
*** SHOW DOWN ***
nbg-1308: shows [Th Ah] (a pair of Sixes)
marvinc02317: mucks hand 
nbg-1308 collected $3.20 from pot
Ignatychok was removed from the table for failing to post
Ignatychok leaves the table
*** SUMMARY ***
Total pot $3.35 | Rake $0.15 
Board [Ks 6h 2h 7d 6d]
Seat 1: rodimana folded on the Flop
Seat 3: marvinc02317 (button) mucked
Seat 4: Vorontsov28 (small blind) folded before Flop
Seat 6: nbg-1308 (big blind) showed [Th Ah] and won ($3.20) with a pair of Sixes



PokerStars Hand #222947629819:  Hold'em No Limit ($0.05/$0.10 USD) - 2021/01/23 3:21:35 ET
Table 'Capricorn II' 6-max Seat #4 is the button
Seat 1: rodimana ($9.53 in chips) 
Seat 3: marvinc02317 ($14.89 in chips) 
Seat 4: Vorontsov28 ($10 in chips) 
Seat 6: nbg-1308 ($14.91 in chips) 
nbg-1308: posts small blind $0.05
rodimana: posts big blind $0.10
petrovichkag: sits out 
*** HOLE CARDS ***
marvinc02317: raises $0.25 to $0.35
Vorontsov28: folds 
nbg-1308: folds 
rodimana: folds 
Uncalled bet ($0.25) returned to marvinc02317
marvinc02317 collected $0.25 from pot
*** SUMMARY ***
Total pot $0.25 | Rake $0 
Seat 1: rodimana (big blind) folded before Flop
Seat 3: marvinc02317 collected ($0.25)
Seat 4: Vorontsov28 (button) folded before Flop (didn't bet)
Seat 6: nbg-1308 (small blind) folded before Flop



PokerStars Hand #222947632756:  Hold'em No Limit ($0.05/$0.10 USD) - 2021/01/23 3:21:47 ET
Table 'Capricorn II' 6-max Seat #6 is the button
Seat 1: rodimana ($9.43 in chips) 
Seat 2: petrovichkag ($10.36 in chips) 
Seat 3: marvinc02317 ($15.04 in chips) 
Seat 4: Vorontsov28 ($10 in chips) 
Seat 6: nbg-1308 ($14.86 in chips) 
rodimana: posts small blind $0.05
petrovichkag: posts big blind $0.10
*** HOLE CARDS ***
marvinc02317: raises $0.30 to $0.40
Vorontsov28: folds 
nbg-1308: folds 
rodimana: calls $0.35
petrovichkag: calls $0.30
*** FLOP *** [Ah 5h 2s]
rodimana: checks 
petrovichkag: checks 
marvinc02317: bets $1.15
rodimana: calls $1.15
petrovichkag: calls $1.15
*** TURN *** [Ah 5h 2s] [Kc]
rodimana: checks 
petrovichkag: checks 
marvinc02317: checks 
*** RIVER *** [Ah 5h 2s Kc] [5d]
rodimana: bets $1.50
Gissbon joins the table at seat #5 
petrovichkag: folds 
marvinc02317: folds 
Uncalled bet ($1.50) returned to rodimana
rodimana collected $4.44 from pot
rodimana: doesn't show hand 
*** SUMMARY ***
Total pot $4.65 | Rake $0.21 
Board [Ah 5h 2s Kc 5d]
Seat 1: rodimana (small blind) collected ($4.44)
Seat 2: petrovichkag (big blind) folded on the River
Seat 3: marvinc02317 folded on the River
Seat 4: Vorontsov28 folded before Flop (didn't bet)
Seat 6: nbg-1308 (button) folded before Flop (didn't bet)



PokerStars Hand #222947646956:  Hold'em No Limit ($0.05/$0.10 USD) - 2021/01/23 3:22:47 ET
Table 'Capricorn II' 6-max Seat #1 is the button
Seat 1: rodimana ($12.32 in chips) 
Seat 2: petrovichkag ($10 in chips) 
Seat 3: marvinc02317 ($13.49 in chips) 
Seat 4: Vorontsov28 ($10 in chips) 
Seat 6: nbg-1308 ($14.86 in chips) 
petrovichkag: posts small blind $0.05
marvinc02317: posts big blind $0.10
*** HOLE CARDS ***
Vorontsov28: raises $0.20 to $0.30
nbg-1308: folds 
rodimana: calls $0.30
petrovichkag: folds 
marvinc02317: folds 
*** FLOP *** [Qc As 4d]
marvinc02317 leaves the table
Gissbon leaves the table
Vorontsov28: bets $0.30
rodimana: folds 
Uncalled bet ($0.30) returned to Vorontsov28
Vorontsov28 collected $0.72 from pot
Vorontsov28: doesn't show hand 
*** SUMMARY ***
Total pot $0.75 | Rake $0.03 
Board [Qc As 4d]
Seat 1: rodimana (button) folded on the Flop
Seat 2: petrovichkag (small blind) folded before Flop
Seat 3: marvinc02317 (big blind) folded before Flop
Seat 4: Vorontsov28 collected ($0.72)
Seat 6: nbg-1308 folded before Flop (didn't bet)



PokerStars Hand #222947653215:  Hold'em No Limit ($0.05/$0.10 USD) - 2021/01/23 3:23:13 ET
Table 'Capricorn II' 6-max Seat #2 is the button
Seat 1: rodimana ($12.02 in chips) 
Seat 2: petrovichkag ($10 in chips) 
Seat 4: Vorontsov28 ($10.42 in chips) 
Seat 6: nbg-1308 ($14.86 in chips) 
Vorontsov28: posts small blind $0.05
nbg-1308: posts big blind $0.10
*** HOLE CARDS ***
rodimana: raises $0.10 to $0.20
AleksCash joins the table at seat #3 
petrovichkag: calls $0.20
Vorontsov28: folds 
nbg-1308: calls $0.10
*** FLOP *** [7h Ad 8d]
nbg-1308: checks 
rodimana: checks 
petrovichkag: checks 
*** TURN *** [7h Ad 8d] [2d]
nbg-1308: checks 
rodimana: bets $0.20
petrovichkag: calls $0.20
nbg-1308: folds 
*** RIVER *** [7h Ad 8d 2d] [Td]
rodimana: checks 
petrovichkag: checks 
*** SHOW DOWN ***
rodimana: shows [Kh 9h] (high card Ace)
petrovichkag: shows [3h 3d] (a flush, Ace high)
petrovichkag collected $1 from pot
*** SUMMARY ***
Total pot $1.05 | Rake $0.05 
Board [7h Ad 8d 2d Td]
Seat 1: rodimana showed [Kh 9h] and lost with high card Ace
Seat 2: petrovichkag (button) showed [3h 3d] and won ($1) with a flush, Ace high
Seat 4: Vorontsov28 (small blind) folded before Flop
Seat 6: nbg-1308 (big blind) folded on the Turn



PokerStars Hand #222947662670:  Hold'em No Limit ($0.05/$0.10 USD) - 2021/01/23 3:23:53 ET
Table 'Capricorn II' 6-max Seat #4 is the button
Seat 1: rodimana ($11.62 in chips) 
Seat 2: petrovichkag ($10.60 in chips) 
Seat 4: Vorontsov28 ($10.37 in chips) 
Seat 6: nbg-1308 ($14.66 in chips) 
nbg-1308: posts small blind $0.05
rodimana: posts big blind $0.10
AleksCash: sits out 
*** HOLE CARDS ***
petrovichkag: folds 
Vorontsov28: folds 
nbg-1308: calls $0.05
rodimana: checks 
*** FLOP *** [2s 7d Kh]
father here joins the table at seat #5 
nbg-1308: checks 
rodimana: checks 
*** TURN *** [2s 7d Kh] [Tc]
nbg-1308: checks 
rodimana: bets $0.20
nbg-1308: folds 
Uncalled bet ($0.20) returned to rodimana
rodimana collected $0.19 from pot
rodimana: doesn't show hand 
*** SUMMARY ***
Total pot $0.20 | Rake $0.01 
Board [2s 7d Kh Tc]
Seat 1: rodimana (big blind) collected ($0.19)
Seat 2: petrovichkag folded before Flop (didn't bet)
Seat 4: Vorontsov28 (button) folded before Flop (didn't bet)
Seat 6: nbg-1308 (small blind) folded on the Turn



PokerStars Hand #222947671671:  Hold'em No Limit ($0.05/$0.10 USD) - 2021/01/23 3:24:29 ET
Table 'Capricorn II' 6-max Seat #6 is the button
Seat 1: rodimana ($11.71 in chips) 
Seat 2: petrovichkag ($10.60 in chips) 
Seat 4: Vorontsov28 ($10.37 in chips) 
Seat 6: nbg-1308 ($14.56 in chips) 
rodimana: posts small blind $0.05
petrovichkag: posts big blind $0.10
AleksCash: sits out 
father here: sits out 
*** HOLE CARDS ***
Vorontsov28: raises $0.20 to $0.30
nbg-1308: folds 
rodimana: calls $0.25
petrovichkag: folds 
*** FLOP *** [7d Js Qd]
rodimana: checks 
Vorontsov28: bets $0.20
rodimana: calls $0.20
*** TURN *** [7d Js Qd] [Ac]
rodimana: checks 
Vorontsov28: bets $0.60
rodimana: calls $0.60
*** RIVER *** [7d Js Qd Ac] [3h]
rodimana: checks 
Vorontsov28: checks 
*** SHOW DOWN ***
rodimana: shows [Ad 8c] (a pair of Aces)
Vorontsov28: shows [As Ts] (a pair of Aces - Queen+Jack+Ten kicker)
Vorontsov28 collected $2.20 from pot
*** SUMMARY ***
Total pot $2.30 | Rake $0.10 
Board [7d Js Qd Ac 3h]
Seat 1: rodimana (small blind) showed [Ad 8c] and lost with a pair of Aces
Seat 2: petrovichkag (big blind) folded before Flop
Seat 4: Vorontsov28 showed [As Ts] and won ($2.20) with a pair of Aces
Seat 6: nbg-1308 (button) folded before Flop (didn't bet)



PokerStars Hand #222947678153:  Hold'em No Limit ($0.05/$0.10 USD) - 2021/01/23 3:24:57 ET
Table 'Capricorn II' 6-max Seat #1 is the button
Seat 1: rodimana ($10.61 in chips) 
Seat 2: petrovichkag ($10.50 in chips) 
Seat 3: AleksCash ($10 in chips) 
Seat 4: Vorontsov28 ($11.47 in chips) 
Seat 6: nbg-1308 ($14.56 in chips) 
petrovichkag: posts small blind $0.05
AleksCash: posts big blind $0.10
father here: sits out 
*** HOLE CARDS ***
Vorontsov28: folds 
nbg-1308: folds 
rodimana: raises $0.10 to $0.20
petrovichkag: folds 
AleksCash: calls $0.10
*** FLOP *** [Ks 5c 4h]
AleksCash: checks 
rodimana: bets $0.20
AleksCash: folds 
Uncalled bet ($0.20) returned to rodimana
rodimana collected $0.43 from pot
rodimana: doesn't show hand 
*** SUMMARY ***
Total pot $0.45 | Rake $0.02 
Board [Ks 5c 4h]
Seat 1: rodimana (button) collected ($0.43)
Seat 2: petrovichkag (small blind) folded before Flop
Seat 3: AleksCash (big blind) folded on the Flop
Seat 4: Vorontsov28 folded before Flop (didn't bet)
Seat 6: nbg-1308 folded before Flop (didn't bet)



PokerStars Hand #222947684805:  Hold'em No Limit ($0.05/$0.10 USD) - 2021/01/23 3:25:24 ET
Table 'Capricorn II' 6-max Seat #2 is the button
Seat 1: rodimana ($10.84 in chips) 
Seat 2: petrovichkag ($10.45 in chips) 
Seat 3: AleksCash ($10 in chips) 
Seat 4: Vorontsov28 ($11.47 in chips) 
Seat 6: nbg-1308 ($14.56 in chips) 
AleksCash: posts small blind $0.05
Vorontsov28: posts big blind $0.10
father here: sits out 
*** HOLE CARDS ***
nbg-1308: folds 
rodimana: folds 
petrovichkag: folds 
AleksCash: raises $0.15 to $0.25
Vorontsov28: folds 
Uncalled bet ($0.15) returned to AleksCash
AleksCash collected $0.20 from pot
AleksCash: doesn't show hand 
*** SUMMARY ***
Total pot $0.20 | Rake $0 
Seat 1: rodimana folded before Flop (didn't bet)
Seat 2: petrovichkag (button) folded before Flop (didn't bet)
Seat 3: AleksCash (small blind) collected ($0.20)
Seat 4: Vorontsov28 (big blind) folded before Flop
Seat 6: nbg-1308 folded before Flop (didn't bet)



PokerStars Hand #222947688609:  Hold'em No Limit ($0.05/$0.10 USD) - 2021/01/23 3:25:40 ET
Table 'Capricorn II' 6-max Seat #3 is the button
Seat 1: rodimana ($10.84 in chips) 
Seat 2: petrovichkag ($10.45 in chips) 
Seat 3: AleksCash ($10.10 in chips) 
Seat 4: Vorontsov28 ($11.37 in chips) 
Seat 5: father here ($10 in chips) 
Seat 6: nbg-1308 ($14.56 in chips) 
Vorontsov28: posts small blind $0.05
father here: posts big blind $0.10
*** HOLE CARDS ***
nbg-1308: folds 
rodimana: folds 
petrovichkag: folds 
AleksCash: folds 
Vorontsov28: folds 
Uncalled bet ($0.05) returned to father here
father here collected $0.10 from pot
*** SUMMARY ***
Total pot $0.10 | Rake $0 
Seat 1: rodimana folded before Flop (didn't bet)
Seat 2: petrovichkag folded before Flop (didn't bet)
Seat 3: AleksCash (button) folded before Flop (didn't bet)
Seat 4: Vorontsov28 (small blind) folded before Flop
Seat 5: father here (big blind) collected ($0.10)
Seat 6: nbg-1308 folded before Flop (didn't bet)



PokerStars Hand #222947690677:  Hold'em No Limit ($0.05/$0.10 USD) - 2021/01/23 3:25:49 ET
Table 'Capricorn II' 6-max Seat #4 is the button
Seat 1: rodimana ($10.84 in chips) 
Seat 2: petrovichkag ($10.45 in chips) 
Seat 3: AleksCash ($10.10 in chips) 
Seat 4: Vorontsov28 ($11.32 in chips) 
Seat 5: father here ($10.05 in chips) 
Seat 6: nbg-1308 ($14.56 in chips) 
father here: posts small blind $0.05
nbg-1308: posts big blind $0.10
*** HOLE CARDS ***
rodimana: folds 
petrovichkag: raises $0.14 to $0.24
AleksCash: folds 
Vorontsov28: folds 
father here: folds 
nbg-1308: folds 
Uncalled bet ($0.14) returned to petrovichkag
petrovichkag collected $0.25 from pot
petrovichkag: doesn't show hand 
*** SUMMARY ***
Total pot $0.25 | Rake $0 
Seat 1: rodimana folded before Flop (didn't bet)
Seat 2: petrovichkag collected ($0.25)
Seat 3: AleksCash folded before Flop (didn't bet)
Seat 4: Vorontsov28 (button) folded before Flop (didn't bet)
Seat 5: father here (small blind) folded before Flop
Seat 6: nbg-1308 (big blind) folded before Flop



PokerStars Hand #222947693836:  Hold'em No Limit ($0.05/$0.10 USD) - 2021/01/23 3:26:02 ET
Table 'Capricorn II' 6-max Seat #5 is the button
Seat 1: rodimana ($10.84 in chips) 
Seat 2: petrovichkag ($10.60 in chips) 
Seat 3: AleksCash ($10.10 in chips) 
Seat 4: Vorontsov28 ($11.32 in chips) 
Seat 5: father here ($10 in chips) 
Seat 6: nbg-1308 ($14.46 in chips) 
nbg-1308: posts small blind $0.05
rodimana: posts big blind $0.10
*** HOLE CARDS ***
petrovichkag: folds 
AleksCash: folds 
Vorontsov28: folds 
father here: raises $0.20 to $0.30
nbg-1308: folds 
rodimana: calls $0.20
*** FLOP *** [Ks 3h Ad]
rodimana: checks 
father here: bets $0.40
rodimana: calls $0.40
*** TURN *** [Ks 3h Ad] [8d]
rodimana: checks 
father here: checks 
*** RIVER *** [Ks 3h Ad 8d] [2c]
rodimana: bets $0.76
father here: folds 
Uncalled bet ($0.76) returned to rodimana
rodimana collected $1.38 from pot
rodimana: doesn't show hand 
*** SUMMARY ***
Total pot $1.45 | Rake $0.07 
Board [Ks 3h Ad 8d 2c]
Seat 1: rodimana (big blind) collected ($1.38)
Seat 2: petrovichkag folded before Flop (didn't bet)
Seat 3: AleksCash folded before Flop (didn't bet)
Seat 4: Vorontsov28 folded before Flop (didn't bet)
Seat 5: father here (button) folded on the River
Seat 6: nbg-1308 (small blind) folded before Flop



PokerStars Hand #222947704504:  Hold'em No Limit ($0.05/$0.10 USD) - 2021/01/23 3:26:46 ET
Table 'Capricorn II' 6-max Seat #6 is the button
Seat 1: rodimana ($11.52 in chips) 
Seat 2: petrovichkag ($10.60 in chips) 
Seat 3: AleksCash ($10.10 in chips) 
Seat 4: Vorontsov28 ($11.32 in chips) 
Seat 5: father here ($10 in chips) 
Seat 6: nbg-1308 ($14.41 in chips) 
rodimana: posts small blind $0.05
petrovichkag: posts big blind $0.10
*** HOLE CARDS ***
AleksCash: folds 
Vorontsov28: folds 
father here: folds 
nbg-1308: raises $0.10 to $0.20
rodimana: calls $0.15
petrovichkag: folds 
*** FLOP *** [6s 8s 5d]
rodimana: checks 
nbg-1308: checks 
*** TURN *** [6s 8s 5d] [Jc]
rodimana: checks 
nbg-1308: bets $0.10
rodimana: calls $0.10
*** RIVER *** [6s 8s 5d Jc] [4s]
rodimana: checks 
nbg-1308: checks 
*** SHOW DOWN ***
rodimana: shows [Ah 9c] (high card Ace)
nbg-1308: shows [Qs Jd] (a pair of Jacks)
nbg-1308 collected $0.67 from pot
*** SUMMARY ***
Total pot $0.70 | Rake $0.03 
Board [6s 8s 5d Jc 4s]
Seat 1: rodimana (small blind) showed [Ah 9c] and lost with high card Ace
Seat 2: petrovichkag (big blind) folded before Flop
Seat 3: AleksCash folded before Flop (didn't bet)
Seat 4: Vorontsov28 folded before Flop (didn't bet)
Seat 5: father here folded before Flop (didn't bet)
Seat 6: nbg-1308 (button) showed [Qs Jd] and won ($0.67) with a pair of Jacks



PokerStars Hand #222947711615:  Hold'em No Limit ($0.05/$0.10 USD) - 2021/01/23 3:27:15 ET
Table 'Capricorn II' 6-max Seat #1 is the button
Seat 1: rodimana ($11.22 in chips) 
Seat 2: petrovichkag ($10.50 in chips) 
Seat 3: AleksCash ($10.10 in chips) 
Seat 4: Vorontsov28 ($11.32 in chips) 
Seat 5: father here ($10 in chips) 
Seat 6: nbg-1308 ($14.78 in chips) 
petrovichkag: posts small blind $0.05
AleksCash: posts big blind $0.10
*** HOLE CARDS ***
Vorontsov28: folds 
father here: folds 
nbg-1308: raises $0.10 to $0.20
rodimana: folds 
petrovichkag: folds 
AleksCash: folds 
Uncalled bet ($0.10) returned to nbg-1308
nbg-1308 collected $0.25 from pot
nbg-1308: doesn't show hand 
*** SUMMARY ***
Total pot $0.25 | Rake $0 
Seat 1: rodimana (button) folded before Flop (didn't bet)
Seat 2: petrovichkag (small blind) folded before Flop
Seat 3: AleksCash (big blind) folded before Flop
Seat 4: Vorontsov28 folded before Flop (didn't bet)
Seat 5: father here folded before Flop (didn't bet)
Seat 6: nbg-1308 collected ($0.25)



PokerStars Hand #222947716779:  Hold'em No Limit ($0.05/$0.10 USD) - 2021/01/23 3:27:36 ET
Table 'Capricorn II' 6-max Seat #2 is the button
Seat 1: rodimana ($11.22 in chips) 
Seat 2: petrovichkag ($10.45 in chips) 
Seat 3: AleksCash ($10 in chips) 
Seat 4: Vorontsov28 ($11.32 in chips) 
Seat 5: father here ($10 in chips) 
Seat 6: nbg-1308 ($14.93 in chips) 
AleksCash: posts small blind $0.05
Vorontsov28: posts big blind $0.10
*** HOLE CARDS ***
father here: folds 
nbg-1308: calls $0.10
rodimana: folds 
petrovichkag: folds 
AleksCash: folds 
Vorontsov28: checks 
*** FLOP *** [2s 8h 2c]
Vorontsov28: checks 
nbg-1308: bets $0.12
Vorontsov28: folds 
Uncalled bet ($0.12) returned to nbg-1308
nbg-1308 collected $0.24 from pot
nbg-1308: doesn't show hand 
*** SUMMARY ***
Total pot $0.25 | Rake $0.01 
Board [2s 8h 2c]
Seat 1: rodimana folded before Flop (didn't bet)
Seat 2: petrovichkag (button) folded before Flop (didn't bet)
Seat 3: AleksCash (small blind) folded before Flop
Seat 4: Vorontsov28 (big blind) folded on the Flop
Seat 5: father here folded before Flop (didn't bet)
Seat 6: nbg-1308 collected ($0.24)



PokerStars Hand #222947721826:  Hold'em No Limit ($0.05/$0.10 USD) - 2021/01/23 3:27:58 ET
Table 'Capricorn II' 6-max Seat #3 is the button
Seat 1: rodimana ($11.22 in chips) 
Seat 2: petrovichkag ($10.45 in chips) 
Seat 3: AleksCash ($10 in chips) 
Seat 4: Vorontsov28 ($11.22 in chips) 
Seat 5: father here ($10 in chips) 
Seat 6: nbg-1308 ($15.07 in chips) 
Vorontsov28: posts small blind $0.05
father here: posts big blind $0.10
*** HOLE CARDS ***
nbg-1308: calls $0.10
rodimana: folds 
petrovichkag: raises $0.30 to $0.40
AleksCash: folds 
Vorontsov28: folds 
father here: folds 
nbg-1308: folds 
Uncalled bet ($0.30) returned to petrovichkag
petrovichkag collected $0.35 from pot
petrovichkag: doesn't show hand 
*** SUMMARY ***
Total pot $0.35 | Rake $0 
Seat 1: rodimana folded before Flop (didn't bet)
Seat 2: petrovichkag collected ($0.35)
Seat 3: AleksCash (button) folded before Flop (didn't bet)
Seat 4: Vorontsov28 (small blind) folded before Flop
Seat 5: father here (big blind) folded before Flop
Seat 6: nbg-1308 folded before Flop



PokerStars Hand #222947726232:  Hold'em No Limit ($0.05/$0.10 USD) - 2021/01/23 3:28:16 ET
Table 'Capricorn II' 6-max Seat #4 is the button
Seat 1: rodimana ($11.22 in chips) 
Seat 2: petrovichkag ($10.70 in chips) 
Seat 3: AleksCash ($10 in chips) 
Seat 4: Vorontsov28 ($11.17 in chips) 
Seat 5: father here ($10 in chips) 
Seat 6: nbg-1308 ($14.97 in chips) 
father here: posts small blind $0.05
nbg-1308: posts big blind $0.10
*** HOLE CARDS ***
rodimana: folds 
petrovichkag: folds 
AleksCash: folds 
Vorontsov28: raises $0.20 to $0.30
father here: folds 
nbg-1308: folds 
Uncalled bet ($0.20) returned to Vorontsov28
Vorontsov28 collected $0.25 from pot
Vorontsov28: doesn't show hand 
*** SUMMARY ***
Total pot $0.25 | Rake $0 
Seat 1: rodimana folded before Flop (didn't bet)
Seat 2: petrovichkag folded before Flop (didn't bet)
Seat 3: AleksCash folded before Flop (didn't bet)
Seat 4: Vorontsov28 (button) collected ($0.25)
Seat 5: father here (small blind) folded before Flop
Seat 6: nbg-1308 (big blind) folded before Flop



PokerStars Hand #222947774534:  Hold'em No Limit ($0.05/$0.10 USD) - 2021/01/23 3:31:05 ET
Table 'Capricorn II' 6-max Seat #3 is the button
Seat 1: rodimana ($11.59 in chips) 
Seat 2: petrovichkag ($10.40 in chips) 
Seat 3: AleksCash ($10.46 in chips) 
Seat 4: Vorontsov28 ($11.22 in chips) 
Seat 5: father here ($10 in chips) 
Seat 6: nbg-1308 ($15.02 in chips) 
Vorontsov28: posts small blind $0.05
father here: posts big blind $0.10
*** HOLE CARDS ***
nbg-1308: calls $0.10
rodimana: folds 
petrovichkag: folds 
AleksCash: folds 
Vorontsov28: folds 
father here: checks 
*** FLOP *** [7c 4c 8s]
father here: checks 
nbg-1308: checks 
*** TURN *** [7c 4c 8s] [Kd]
father here: checks 
nbg-1308: checks 
*** RIVER *** [7c 4c 8s Kd] [6d]
father here: bets $0.24
nbg-1308: calls $0.24
*** SHOW DOWN ***
father here: shows [Ts 3d] (high card King)
nbg-1308: shows [As Ah] (a pair of Aces)
nbg-1308 collected $0.70 from pot
*** SUMMARY ***
Total pot $0.73 | Rake $0.03 
Board [7c 4c 8s Kd 6d]
Seat 1: rodimana folded before Flop (didn't bet)
Seat 2: petrovichkag folded before Flop (didn't bet)
Seat 3: AleksCash (button) folded before Flop (didn't bet)
Seat 4: Vorontsov28 (small blind) folded before Flop
Seat 5: father here (big blind) showed [Ts 3d] and lost with high card King
Seat 6: nbg-1308 showed [As Ah] and won ($0.70) with a pair of Aces



PokerStars Hand #222947795289:  Hold'em No Limit ($0.05/$0.10 USD) - 2021/01/23 3:32:06 ET
Table 'Capricorn II' 6-max Seat #4 is the button
Seat 1: rodimana ($11.59 in chips) 
Seat 2: petrovichkag ($10.40 in chips) 
Seat 3: AleksCash ($10.46 in chips) 
Seat 4: Vorontsov28 ($11.17 in chips) 
Seat 5: father here ($10 in chips) 
Seat 6: nbg-1308 ($15.38 in chips) 
father here: posts small blind $0.05
nbg-1308: posts big blind $0.10
*** HOLE CARDS ***
rodimana: folds 
petrovichkag: raises $0.14 to $0.24
AleksCash: raises $0.66 to $0.90
Vorontsov28: folds 
father here: folds 
nbg-1308: folds 
petrovichkag: folds 
Uncalled bet ($0.66) returned to AleksCash
AleksCash collected $0.63 from pot
AleksCash: doesn't show hand 
*** SUMMARY ***
Total pot $0.63 | Rake $0 
Seat 1: rodimana folded before Flop (didn't bet)
Seat 2: petrovichkag folded before Flop
Seat 3: AleksCash collected ($0.63)
Seat 4: Vorontsov28 (button) folded before Flop (didn't bet)
Seat 5: father here (small blind) folded before Flop
Seat 6: nbg-1308 (big blind) folded before Flop



PokerStars Hand #222947801475:  Hold'em No Limit ($0.05/$0.10 USD) - 2021/01/23 3:32:31 ET
Table 'Capricorn II' 6-max Seat #5 is the button
Seat 1: rodimana ($11.59 in chips) 
Seat 2: petrovichkag ($10.16 in chips) 
Seat 3: AleksCash ($10.85 in chips) 
Seat 4: Vorontsov28 ($11.17 in chips) 
Seat 5: father here ($10 in chips) 
Seat 6: nbg-1308 ($15.28 in chips) 
nbg-1308: posts small blind $0.05
rodimana: posts big blind $0.10
*** HOLE CARDS ***
petrovichkag: folds 
AleksCash: folds 
Vorontsov28: raises $0.20 to $0.30
father here: folds 
nbg-1308: folds 
rodimana: calls $0.20
*** FLOP *** [As Ad Th]
rodimana: checks 
Vorontsov28: bets $0.20
rodimana: calls $0.20
*** TURN *** [As Ad Th] [5h]
rodimana: checks 
Vorontsov28: bets $0.60
rodimana: folds 
Uncalled bet ($0.60) returned to Vorontsov28
Vorontsov28 collected $1 from pot
Vorontsov28: doesn't show hand 
*** SUMMARY ***
Total pot $1.05 | Rake $0.05 
Board [As Ad Th 5h]
Seat 1: rodimana (big blind) folded on the Turn
Seat 2: petrovichkag folded before Flop (didn't bet)
Seat 3: AleksCash folded before Flop (didn't bet)
Seat 4: Vorontsov28 collected ($1)
Seat 5: father here (button) folded before Flop (didn't bet)
Seat 6: nbg-1308 (small blind) folded before Flop



PokerStars Hand #222947809861:  Hold'em No Limit ($0.05/$0.10 USD) - 2021/01/23 3:33:05 ET
Table 'Capricorn II' 6-max Seat #6 is the button
Seat 1: rodimana ($11.09 in chips) 
Seat 2: petrovichkag ($10.16 in chips) 
Seat 3: AleksCash ($10.85 in chips) 
Seat 4: Vorontsov28 ($11.67 in chips) 
Seat 5: father here ($10 in chips) 
Seat 6: nbg-1308 ($15.23 in chips) 
rodimana: posts small blind $0.05
petrovichkag: posts big blind $0.10
*** HOLE CARDS ***
AleksCash: folds 
Vorontsov28: folds 
father here: folds 
nbg-1308: raises $0.10 to $0.20
rodimana: raises $0.40 to $0.60
petrovichkag: folds 
nbg-1308: folds 
Uncalled bet ($0.40) returned to rodimana
rodimana collected $0.50 from pot
rodimana: doesn't show hand 
*** SUMMARY ***
Total pot $0.50 | Rake $0 
Seat 1: rodimana (small blind) collected ($0.50)
Seat 2: petrovichkag (big blind) folded before Flop
Seat 3: AleksCash folded before Flop (didn't bet)
Seat 4: Vorontsov28 folded before Flop (didn't bet)
Seat 5: father here folded before Flop (didn't bet)
Seat 6: nbg-1308 (button) folded before Flop



PokerStars Hand #222947814246:  Hold'em No Limit ($0.05/$0.10 USD) - 2021/01/23 3:33:23 ET
Table 'Capricorn II' 6-max Seat #1 is the button
Seat 1: rodimana ($11.39 in chips) 
Seat 2: petrovichkag ($10.06 in chips) 
Seat 3: AleksCash ($10.85 in chips) 
Seat 4: Vorontsov28 ($11.67 in chips) 
Seat 5: father here ($10 in chips) 
Seat 6: nbg-1308 ($15.03 in chips) 
petrovichkag: posts small blind $0.05
AleksCash: posts big blind $0.10
*** HOLE CARDS ***
Vorontsov28: folds 
father here: folds 
nbg-1308: folds 
rodimana: raises $0.10 to $0.20
petrovichkag: raises $0.60 to $0.80
AleksCash: folds 
rodimana: folds 
Uncalled bet ($0.60) returned to petrovichkag
petrovichkag collected $0.50 from pot
petrovichkag: doesn't show hand 
*** SUMMARY ***
Total pot $0.50 | Rake $0 
Seat 1: rodimana (button) folded before Flop
Seat 2: petrovichkag (small blind) collected ($0.50)
Seat 3: AleksCash (big blind) folded before Flop
Seat 4: Vorontsov28 folded before Flop (didn't bet)
Seat 5: father here folded before Flop (didn't bet)
Seat 6: nbg-1308 folded before Flop (didn't bet)



PokerStars Hand #222947819166:  Hold'em No Limit ($0.05/$0.10 USD) - 2021/01/23 3:33:43 ET
Table 'Capricorn II' 6-max Seat #2 is the button
Seat 1: rodimana ($11.19 in chips) 
Seat 2: petrovichkag ($10.36 in chips) 
Seat 3: AleksCash ($10.75 in chips) 
Seat 4: Vorontsov28 ($11.67 in chips) 
Seat 5: father here ($10 in chips) 
Seat 6: nbg-1308 ($15.03 in chips) 
AleksCash: posts small blind $0.05
Vorontsov28: posts big blind $0.10
*** HOLE CARDS ***
father here: folds 
nbg-1308: calls $0.10
rodimana: folds 
petrovichkag: folds 
AleksCash: raises $0.30 to $0.40
father here leaves the table
Vorontsov28: folds 
nbg-1308: calls $0.30
*** FLOP *** [As 8c 4c]
AleksCash: bets $0.45
nbg-1308: folds 
Uncalled bet ($0.45) returned to AleksCash
AleksCash collected $0.86 from pot
AleksCash: doesn't show hand 
*** SUMMARY ***
Total pot $0.90 | Rake $0.04 
Board [As 8c 4c]
Seat 1: rodimana folded before Flop (didn't bet)
Seat 2: petrovichkag (button) folded before Flop (didn't bet)
Seat 3: AleksCash (small blind) collected ($0.86)
Seat 4: Vorontsov28 (big blind) folded before Flop
Seat 5: father here folded before Flop (didn't bet)
Seat 6: nbg-1308 folded on the Flop



PokerStars Hand #222947825492:  Hold'em No Limit ($0.05/$0.10 USD) - 2021/01/23 3:34:09 ET
Table 'Capricorn II' 6-max Seat #3 is the button
Seat 1: rodimana ($11.19 in chips) 
Seat 2: petrovichkag ($10.36 in chips) 
Seat 3: AleksCash ($11.21 in chips) 
Seat 4: Vorontsov28 ($11.57 in chips) 
Seat 6: nbg-1308 ($14.63 in chips) 
Vorontsov28: posts small blind $0.05
nbg-1308: posts big blind $0.10
*** HOLE CARDS ***
rodimana: folds 
petrovichkag: folds 
AleksCash: raises $0.15 to $0.25
rodimana leaves the table
Vorontsov28: folds 
nbg-1308: folds 
Uncalled bet ($0.15) returned to AleksCash
AleksCash collected $0.25 from pot
AleksCash: doesn't show hand 
*** SUMMARY ***
Total pot $0.25 | Rake $0 
Seat 1: rodimana folded before Flop (didn't bet)
Seat 2: petrovichkag folded before Flop (didn't bet)
Seat 3: AleksCash (button) collected ($0.25)
Seat 4: Vorontsov28 (small blind) folded before Flop
Seat 6: nbg-1308 (big blind) folded before Flop



PokerStars Hand #222947828169:  Hold'em No Limit ($0.05/$0.10 USD) - 2021/01/23 3:34:20 ET
Table 'Capricorn II' 6-max Seat #4 is the button
Seat 2: petrovichkag ($10.36 in chips) 
Seat 3: AleksCash ($11.36 in chips) 
Seat 4: Vorontsov28 ($11.52 in chips) 
Seat 6: nbg-1308 ($14.53 in chips) 
nbg-1308: posts small blind $0.05
petrovichkag: posts big blind $0.10
*** HOLE CARDS ***
AleksCash: folds 
Vorontsov28: folds 
nbg-1308: raises $0.10 to $0.20
petrovichkag: folds 
Uncalled bet ($0.10) returned to nbg-1308
nbg-1308 collected $0.20 from pot
nbg-1308: doesn't show hand 
*** SUMMARY ***
Total pot $0.20 | Rake $0 
Seat 2: petrovichkag (big blind) folded before Flop
Seat 3: AleksCash folded before Flop (didn't bet)
Seat 4: Vorontsov28 (button) folded before Flop (didn't bet)
Seat 6: nbg-1308 (small blind) collected ($0.20)



PokerStars Hand #222947830160:  Hold'em No Limit ($0.05/$0.10 USD) - 2021/01/23 3:34:28 ET
Table 'Capricorn II' 6-max Seat #6 is the button
Seat 2: petrovichkag ($10.26 in chips) 
Seat 4: Vorontsov28 ($11.52 in chips) 
Seat 6: nbg-1308 ($14.63 in chips) 
petrovichkag: posts small blind $0.05
AleksCash: is sitting out 
Vorontsov28: posts big blind $0.10
*** HOLE CARDS ***
nbg-1308: folds 
petrovichkag: folds 
Uncalled bet ($0.05) returned to Vorontsov28
Vorontsov28 collected $0.10 from pot
Vorontsov28: doesn't show hand 
*** SUMMARY ***
Total pot $0.10 | Rake $0 
Seat 2: petrovichkag (small blind) folded before Flop
Seat 4: Vorontsov28 (big blind) collected ($0.10)
Seat 6: nbg-1308 (button) folded before Flop (didn't bet)



PokerStars Hand #222947831746:  Hold'em No Limit ($0.05/$0.10 USD) - 2021/01/23 3:34:35 ET
Table 'Capricorn II' 6-max Seat #2 is the button
Seat 2: petrovichkag ($10.21 in chips) 
Seat 4: Vorontsov28 ($11.57 in chips) 
Seat 6: nbg-1308 ($14.63 in chips) 
Vorontsov28: posts small blind $0.05
nbg-1308: posts big blind $0.10
*** HOLE CARDS ***
petrovichkag: raises $0.14 to $0.24
Vorontsov28: folds 
nbg-1308: folds 
Uncalled bet ($0.14) returned to petrovichkag
petrovichkag collected $0.25 from pot
petrovichkag: doesn't show hand 
*** SUMMARY ***
Total pot $0.25 | Rake $0 
Seat 2: petrovichkag (button) collected ($0.25)
Seat 4: Vorontsov28 (small blind) folded before Flop
Seat 6: nbg-1308 (big blind) folded before Flop



PokerStars Hand #222947833172:  Hold'em No Limit ($0.05/$0.10 USD) - 2021/01/23 3:34:40 ET
Table 'Capricorn II' 6-max Seat #4 is the button
Seat 2: petrovichkag ($10.36 in chips) 
Seat 4: Vorontsov28 ($11.52 in chips) 
Seat 6: nbg-1308 ($14.53 in chips) 
nbg-1308: posts small blind $0.05
petrovichkag: posts big blind $0.10
*** HOLE CARDS ***
Vorontsov28: folds 
nbg-1308: raises $0.10 to $0.20
petrovichkag: folds 
Uncalled bet ($0.10) returned to nbg-1308
nbg-1308 collected $0.20 from pot
nbg-1308: doesn't show hand 
*** SUMMARY ***
Total pot $0.20 | Rake $0 
Seat 2: petrovichkag (big blind) folded before Flop
Seat 4: Vorontsov28 (button) folded before Flop (didn't bet)
Seat 6: nbg-1308 (small blind) collected ($0.20)



PokerStars Hand #222947834546:  Hold'em No Limit ($0.05/$0.10 USD) - 2021/01/23 3:34:46 ET
Table 'Capricorn II' 6-max Seat #2 is the button
Seat 2: petrovichkag ($10.26 in chips) 
Seat 6: nbg-1308 ($14.63 in chips) 
petrovichkag: posts small blind $0.05
Vorontsov28: is sitting out 
nbg-1308: posts big blind $0.10
*** HOLE CARDS ***
Samogonka joins the table at seat #1 
petrovichkag: folds 
Uncalled bet ($0.05) returned to nbg-1308
nbg-1308 collected $0.10 from pot
nbg-1308: doesn't show hand 
*** SUMMARY ***
Total pot $0.10 | Rake $0 
Seat 2: petrovichkag (button) (small blind) folded before Flop
Seat 6: nbg-1308 (big blind) collected ($0.10)



PokerStars Hand #222947835788:  Hold'em No Limit ($0.05/$0.10 USD) - 2021/01/23 3:34:51 ET
Table 'Capricorn II' 6-max Seat #2 is the button
Seat 1: Samogonka ($10 in chips) 
Seat 2: petrovichkag ($10.21 in chips) 
Seat 6: nbg-1308 ($14.68 in chips) 
nbg-1308: posts small blind $0.05
Samogonka: posts big blind $0.10
*** HOLE CARDS ***
petrovichkag: folds 
nbg-1308: folds 
Uncalled bet ($0.05) returned to Samogonka
Samogonka collected $0.10 from pot
*** SUMMARY ***
Total pot $0.10 | Rake $0 
Seat 1: Samogonka (big blind) collected ($0.10)
Seat 2: petrovichkag (button) folded before Flop (didn't bet)
Seat 6: nbg-1308 (small blind) folded before Flop



PokerStars Hand #222947837175:  Hold'em No Limit ($0.05/$0.10 USD) - 2021/01/23 3:34:57 ET
Table 'Capricorn II' 6-max Seat #6 is the button
Seat 1: Samogonka ($10.05 in chips) 
Seat 2: petrovichkag ($10.21 in chips) 
Seat 6: nbg-1308 ($14.63 in chips) 
Samogonka: posts small blind $0.05
petrovichkag: posts big blind $0.10
*** HOLE CARDS ***
nbg-1308: folds 
Samogonka: raises $0.20 to $0.30
SickerGC joins the table at seat #5 
petrovichkag: folds 
Uncalled bet ($0.20) returned to Samogonka
Samogonka collected $0.20 from pot
*** SUMMARY ***
Total pot $0.20 | Rake $0 
Seat 1: Samogonka (small blind) collected ($0.20)
Seat 2: petrovichkag (big blind) folded before Flop
Seat 6: nbg-1308 (button) folded before Flop (didn't bet)



PokerStars Hand #222947840070:  Hold'em No Limit ($0.05/$0.10 USD) - 2021/01/23 3:35:09 ET
Table 'Capricorn II' 6-max Seat #1 is the button
Seat 1: Samogonka ($10.15 in chips) 
Seat 2: petrovichkag ($10.11 in chips) 
Seat 5: SickerGC ($10 in chips) 
Seat 6: nbg-1308 ($14.63 in chips) 
petrovichkag: posts small blind $0.05
SickerGC: posts big blind $0.10
*** HOLE CARDS ***
nbg-1308: folds 
Samogonka: folds 
petrovichkag: folds 
Uncalled bet ($0.05) returned to SickerGC
SickerGC collected $0.10 from pot
*** SUMMARY ***
Total pot $0.10 | Rake $0 
Seat 1: Samogonka (button) folded before Flop (didn't bet)
Seat 2: petrovichkag (small blind) folded before Flop
Seat 5: SickerGC (big blind) collected ($0.10)
Seat 6: nbg-1308 folded before Flop (didn't bet)



PokerStars Hand #222947843192:  Hold'em No Limit ($0.05/$0.10 USD) - 2021/01/23 3:35:22 ET
Table 'Capricorn II' 6-max Seat #2 is the button
Seat 1: Samogonka ($10.15 in chips) 
Seat 2: petrovichkag ($10.06 in chips) 
Seat 5: SickerGC ($10.05 in chips) 
Seat 6: nbg-1308 ($14.63 in chips) 
SickerGC: posts small blind $0.05
nbg-1308: posts big blind $0.10
*** HOLE CARDS ***
Samogonka: folds 
petrovichkag: raises $0.14 to $0.24
SickerGC has timed out
SickerGC: folds 
nbg-1308: folds 
Uncalled bet ($0.14) returned to petrovichkag
petrovichkag collected $0.25 from pot
petrovichkag: doesn't show hand 
*** SUMMARY ***
Total pot $0.25 | Rake $0 
Seat 1: Samogonka folded before Flop (didn't bet)
Seat 2: petrovichkag (button) collected ($0.25)
Seat 5: SickerGC (small blind) folded before Flop
Seat 6: nbg-1308 (big blind) folded before Flop



PokerStars Hand #222947853496:  Hold'em No Limit ($0.05/$0.10 USD) - 2021/01/23 3:36:04 ET
Table 'Capricorn II' 6-max Seat #6 is the button
Seat 1: Samogonka ($10.15 in chips) 
Seat 2: petrovichkag ($10.21 in chips) 
Seat 6: nbg-1308 ($14.53 in chips) 
Samogonka: posts small blind $0.05
petrovichkag: posts big blind $0.10
AleksCash: sits out 
*** HOLE CARDS ***
nbg-1308: folds 
Samogonka: raises $0.20 to $0.30
petrovichkag: calls $0.20
*** FLOP *** [2s 5h 8h]
Samogonka: bets $0.30
petrovichkag: calls $0.30
*** TURN *** [2s 5h 8h] [Qh]
Samogonka: checks 
petrovichkag: checks 
*** RIVER *** [2s 5h 8h Qh] [9s]
Samogonka: checks 
petrovichkag: checks 
*** SHOW DOWN ***
Samogonka: shows [As 3h] (high card Ace)
petrovichkag: shows [Kd 8d] (a pair of Eights)
petrovichkag collected $1.15 from pot
*** SUMMARY ***
Total pot $1.20 | Rake $0.05 
Board [2s 5h 8h Qh 9s]
Seat 1: Samogonka (small blind) showed [As 3h] and lost with high card Ace
Seat 2: petrovichkag (big blind) showed [Kd 8d] and won ($1.15) with a pair of Eights
Seat 6: nbg-1308 (button) folded before Flop (didn't bet)



PokerStars Hand #222947861242:  Hold'em No Limit ($0.05/$0.10 USD) - 2021/01/23 3:36:35 ET
Table 'Capricorn II' 6-max Seat #1 is the button
Seat 1: Samogonka ($9.55 in chips) 
Seat 2: petrovichkag ($10.76 in chips) 
Seat 3: AleksCash ($11.36 in chips) 
Seat 5: SickerGC ($10 in chips) 
Seat 6: nbg-1308 ($14.53 in chips) 
petrovichkag: posts small blind $0.05
AleksCash: posts big blind $0.10
*** HOLE CARDS ***
SickerGC: calls $0.10
nbg-1308: folds 
Samogonka has timed out
Samogonka: folds 
petrovichkag: folds 
AleksCash: raises $0.30 to $0.40
SickerGC: calls $0.30
*** FLOP *** [7c 9c Th]
AleksCash: bets $0.50
SickerGC: folds 
Uncalled bet ($0.50) returned to AleksCash
AleksCash collected $0.81 from pot
AleksCash: doesn't show hand 
*** SUMMARY ***
Total pot $0.85 | Rake $0.04 
Board [7c 9c Th]
Seat 1: Samogonka (button) folded before Flop (didn't bet)
Seat 2: petrovichkag (small blind) folded before Flop
Seat 3: AleksCash (big blind) collected ($0.81)
Seat 5: SickerGC folded on the Flop
Seat 6: nbg-1308 folded before Flop (didn't bet)



PokerStars Hand #222947867637:  Hold'em No Limit ($0.05/$0.10 USD) - 2021/01/23 3:37:02 ET
Table 'Capricorn II' 6-max Seat #2 is the button
Seat 1: Samogonka ($9.55 in chips) 
Seat 2: petrovichkag ($10.71 in chips) 
Seat 3: AleksCash ($11.77 in chips) 
Seat 5: SickerGC ($9.60 in chips) 
Seat 6: nbg-1308 ($14.53 in chips) 
AleksCash: posts small blind $0.05
SickerGC: posts big blind $0.10
*** HOLE CARDS ***
nbg-1308: folds 
Samogonka: folds 
petrovichkag: folds 
AleksCash: folds 
Uncalled bet ($0.05) returned to SickerGC
SickerGC collected $0.10 from pot
*** SUMMARY ***
Total pot $0.10 | Rake $0 
Seat 1: Samogonka folded before Flop (didn't bet)
Seat 2: petrovichkag (button) folded before Flop (didn't bet)
Seat 3: AleksCash (small blind) folded before Flop
Seat 5: SickerGC (big blind) collected ($0.10)
Seat 6: nbg-1308 folded before Flop (didn't bet)



PokerStars Hand #222947869215:  Hold'em No Limit ($0.05/$0.10 USD) - 2021/01/23 3:37:08 ET
Table 'Capricorn II' 6-max Seat #3 is the button
Seat 1: Samogonka ($9.55 in chips) 
Seat 2: petrovichkag ($10.71 in chips) 
Seat 3: AleksCash ($11.72 in chips) 
Seat 5: SickerGC ($9.65 in chips) 
Seat 6: nbg-1308 ($14.53 in chips) 
SickerGC: posts small blind $0.05
nbg-1308: posts big blind $0.10
*** HOLE CARDS ***
Samogonka: folds 
petrovichkag: folds 
AleksCash: folds 
SickerGC: calls $0.05
nbg-1308: checks 
*** FLOP *** [Qc Ah 2c]
SickerGC: checks 
nbg-1308: checks 
*** TURN *** [Qc Ah 2c] [2s]
SickerGC: checks 
nbg-1308: checks 
*** RIVER *** [Qc Ah 2c 2s] [8s]
SickerGC: checks 
nbg-1308: checks 
*** SHOW DOWN ***
SickerGC: shows [5d Kh] (a pair of Deuces)
nbg-1308: mucks hand 
SickerGC collected $0.19 from pot
*** SUMMARY ***
Total pot $0.20 | Rake $0.01 
Board [Qc Ah 2c 2s 8s]
Seat 1: Samogonka folded before Flop (didn't bet)
Seat 2: petrovichkag folded before Flop (didn't bet)
Seat 3: AleksCash (button) folded before Flop (didn't bet)
Seat 5: SickerGC (small blind) showed [5d Kh] and won ($0.19) with a pair of Deuces
Seat 6: nbg-1308 (big blind) mucked



PokerStars Hand #222947879464:  Hold'em No Limit ($0.05/$0.10 USD) - 2021/01/23 3:37:50 ET
Table 'Capricorn II' 6-max Seat #5 is the button
Seat 1: Samogonka ($9.55 in chips) 
Seat 2: petrovichkag ($10.71 in chips) 
Seat 3: AleksCash ($11.72 in chips) 
Seat 5: SickerGC ($9.74 in chips) 
Seat 6: nbg-1308 ($14.43 in chips) 
nbg-1308: posts small blind $0.05
Samogonka: posts big blind $0.10
*** HOLE CARDS ***
petrovichkag: folds 
AleksCash: folds 
SickerGC: folds 
nbg-1308: calls $0.05
Samogonka: raises $0.30 to $0.40
nbg-1308: folds 
Uncalled bet ($0.30) returned to Samogonka
Samogonka collected $0.20 from pot
*** SUMMARY ***
Total pot $0.20 | Rake $0 
Seat 1: Samogonka (big blind) collected ($0.20)
Seat 2: petrovichkag folded before Flop (didn't bet)
Seat 3: AleksCash folded before Flop (didn't bet)
Seat 5: SickerGC (button) folded before Flop (didn't bet)
Seat 6: nbg-1308 (small blind) folded before Flop



PokerStars Hand #222947883314:  Hold'em No Limit ($0.05/$0.10 USD) - 2021/01/23 3:38:06 ET
Table 'Capricorn II' 6-max Seat #6 is the button
Seat 1: Samogonka ($9.65 in chips) 
Seat 2: petrovichkag ($10.71 in chips) 
Seat 3: AleksCash ($11.72 in chips) 
Seat 5: SickerGC ($9.74 in chips) 
Seat 6: nbg-1308 ($14.33 in chips) 
Samogonka: posts small blind $0.05
petrovichkag: posts big blind $0.10
*** HOLE CARDS ***
AleksCash: folds 
SickerGC: calls $0.10
nbg-1308: folds 
Samogonka: folds 
petrovichkag: checks 
*** FLOP *** [Jc 4c Kh]
petrovichkag: checks 
SickerGC: checks 
*** TURN *** [Jc 4c Kh] [7d]
petrovichkag: bets $0.20
SickerGC: calls $0.20
*** RIVER *** [Jc 4c Kh 7d] [Kd]
petrovichkag: bets $0.40
SickerGC: folds 
Uncalled bet ($0.40) returned to petrovichkag
petrovichkag collected $0.62 from pot
petrovichkag: doesn't show hand 
*** SUMMARY ***
Total pot $0.65 | Rake $0.03 
Board [Jc 4c Kh 7d Kd]
Seat 1: Samogonka (small blind) folded before Flop
Seat 2: petrovichkag (big blind) collected ($0.62)
Seat 3: AleksCash folded before Flop (didn't bet)
Seat 5: SickerGC folded on the River
Seat 6: nbg-1308 (button) folded before Flop (didn't bet)



PokerStars Hand #222947889835:  Hold'em No Limit ($0.05/$0.10 USD) - 2021/01/23 3:38:33 ET
Table 'Capricorn II' 6-max Seat #1 is the button
Seat 1: Samogonka ($9.60 in chips) 
Seat 2: petrovichkag ($11.03 in chips) 
Seat 3: AleksCash ($11.72 in chips) 
Seat 5: SickerGC ($9.44 in chips) 
Seat 6: nbg-1308 ($14.33 in chips) 
petrovichkag: posts small blind $0.05
AleksCash: posts big blind $0.10
*** HOLE CARDS ***
SickerGC: calls $0.10
nbg-1308: folds 
Samogonka: raises $0.30 to $0.40
petrovichkag: folds 
AleksCash: folds 
SickerGC: folds 
Uncalled bet ($0.30) returned to Samogonka
Samogonka collected $0.35 from pot
*** SUMMARY ***
Total pot $0.35 | Rake $0 
Seat 1: Samogonka (button) collected ($0.35)
Seat 2: petrovichkag (small blind) folded before Flop
Seat 3: AleksCash (big blind) folded before Flop
Seat 5: SickerGC folded before Flop
Seat 6: nbg-1308 folded before Flop (didn't bet)



PokerStars Hand #222947896032:  Hold'em No Limit ($0.05/$0.10 USD) - 2021/01/23 3:38:59 ET
Table 'Capricorn II' 6-max Seat #2 is the button
Seat 1: Samogonka ($9.85 in chips) 
Seat 2: petrovichkag ($10.98 in chips) 
Seat 3: AleksCash ($11.62 in chips) 
Seat 5: SickerGC ($9.34 in chips) 
Seat 6: nbg-1308 ($14.33 in chips) 
AleksCash: posts small blind $0.05
SickerGC: posts big blind $0.10
*** HOLE CARDS ***
nbg-1308: folds 
Samogonka: folds 
petrovichkag: raises $0.14 to $0.24
AleksCash: folds 
SickerGC: calls $0.14
*** FLOP *** [Tc Ks 3h]
SickerGC: bets $0.26
petrovichkag: folds 
Uncalled bet ($0.26) returned to SickerGC
SickerGC collected $0.51 from pot
Vorontsov28 was removed from the table for failing to post
Vorontsov28 leaves the table
*** SUMMARY ***
Total pot $0.53 | Rake $0.02 
Board [Tc Ks 3h]
Seat 1: Samogonka folded before Flop (didn't bet)
Seat 2: petrovichkag (button) folded on the Flop
Seat 3: AleksCash (small blind) folded before Flop
Seat 5: SickerGC (big blind) collected ($0.51)
Seat 6: nbg-1308 folded before Flop (didn't bet)



PokerStars Hand #222947902165:  Hold'em No Limit ($0.05/$0.10 USD) - 2021/01/23 3:39:24 ET
Table 'Capricorn II' 6-max Seat #3 is the button
Seat 1: Samogonka ($9.85 in chips) 
Seat 2: petrovichkag ($10.74 in chips) 
Seat 3: AleksCash ($11.57 in chips) 
Seat 5: SickerGC ($9.61 in chips) 
Seat 6: nbg-1308 ($14.33 in chips) 
SickerGC: posts small blind $0.05
nbg-1308: posts big blind $0.10
*** HOLE CARDS ***
Samogonka: folds 
DONTCALLME8 joins the table at seat #4 
petrovichkag: raises $0.14 to $0.24
AleksCash: folds 
SickerGC: calls $0.19
nbg-1308: calls $0.14
*** FLOP *** [2d 2s 4c]
SickerGC: checks 
nbg-1308: bets $0.10
petrovichkag: calls $0.10
SickerGC: folds 
*** TURN *** [2d 2s 4c] [5c]
nbg-1308: bets $0.10
petrovichkag: folds 
Uncalled bet ($0.10) returned to nbg-1308
nbg-1308 collected $0.88 from pot
nbg-1308: doesn't show hand 
*** SUMMARY ***
Total pot $0.92 | Rake $0.04 
Board [2d 2s 4c 5c]
Seat 1: Samogonka folded before Flop (didn't bet)
Seat 2: petrovichkag folded on the Turn
Seat 3: AleksCash (button) folded before Flop (didn't bet)
Seat 5: SickerGC (small blind) folded on the Flop
Seat 6: nbg-1308 (big blind) collected ($0.88)



PokerStars Hand #222947911674:  Hold'em No Limit ($0.05/$0.10 USD) - 2021/01/23 3:40:03 ET
Table 'Capricorn II' 6-max Seat #5 is the button
Seat 1: Samogonka ($9.85 in chips) 
Seat 2: petrovichkag ($10.40 in chips) 
Seat 3: AleksCash ($11.57 in chips) 
Seat 4: DONTCALLME8 ($10 in chips) 
Seat 5: SickerGC ($9.37 in chips) 
Seat 6: nbg-1308 ($14.87 in chips) 
nbg-1308: posts small blind $0.05
Samogonka: posts big blind $0.10
DONTCALLME8: posts big blind $0.10
*** HOLE CARDS ***
petrovichkag: folds 
AleksCash: folds 
DONTCALLME8: checks 
SickerGC: calls $0.10
nbg-1308: calls $0.05
Samogonka: checks 
*** FLOP *** [Tc 8d 9h]
nbg-1308: bets $0.10
Samogonka: folds 
DONTCALLME8: calls $0.10
SickerGC: calls $0.10
*** TURN *** [Tc 8d 9h] [Kc]
nbg-1308: bets $0.10
DONTCALLME8: calls $0.10
SickerGC: calls $0.10
*** RIVER *** [Tc 8d 9h Kc] [Qc]
nbg-1308: checks 
DONTCALLME8: bets $0.58
SickerGC: folds 
nbg-1308: folds 
Uncalled bet ($0.58) returned to DONTCALLME8
DONTCALLME8 collected $0.96 from pot
DONTCALLME8: doesn't show hand 
*** SUMMARY ***
Total pot $1 | Rake $0.04 
Board [Tc 8d 9h Kc Qc]
Seat 1: Samogonka (big blind) folded on the Flop
Seat 2: petrovichkag folded before Flop (didn't bet)
Seat 3: AleksCash folded before Flop (didn't bet)
Seat 4: DONTCALLME8 collected ($0.96)
Seat 5: SickerGC (button) folded on the River
Seat 6: nbg-1308 (small blind) folded on the River



PokerStars Hand #222947923966:  Hold'em No Limit ($0.05/$0.10 USD) - 2021/01/23 3:40:54 ET
Table 'Capricorn II' 6-max Seat #6 is the button
Seat 1: Samogonka ($9.75 in chips) 
Seat 2: petrovichkag ($10.40 in chips) 
Seat 3: AleksCash ($11.57 in chips) 
Seat 4: DONTCALLME8 ($10.66 in chips) 
Seat 5: SickerGC ($9.07 in chips) 
Seat 6: nbg-1308 ($14.57 in chips) 
Samogonka: posts small blind $0.05
petrovichkag: posts big blind $0.10
*** HOLE CARDS ***
AleksCash: folds 
DONTCALLME8: folds 
SickerGC: folds 
nbg-1308: raises $0.10 to $0.20
Samogonka: raises $0.40 to $0.60
petrovichkag: folds 
nbg-1308: folds 
Uncalled bet ($0.40) returned to Samogonka
Samogonka collected $0.50 from pot
*** SUMMARY ***
Total pot $0.50 | Rake $0 
Seat 1: Samogonka (small blind) collected ($0.50)
Seat 2: petrovichkag (big blind) folded before Flop
Seat 3: AleksCash folded before Flop (didn't bet)
Seat 4: DONTCALLME8 folded before Flop (didn't bet)
Seat 5: SickerGC folded before Flop (didn't bet)
Seat 6: nbg-1308 (button) folded before Flop



PokerStars Hand #222947931157:  Hold'em No Limit ($0.05/$0.10 USD) - 2021/01/23 3:41:24 ET
Table 'Capricorn II' 6-max Seat #1 is the button
Seat 1: Samogonka ($10.05 in chips) 
Seat 2: petrovichkag ($10.30 in chips) 
Seat 3: AleksCash ($11.57 in chips) 
Seat 4: DONTCALLME8 ($10.66 in chips) 
Seat 5: SickerGC ($9.07 in chips) 
petrovichkag: posts small blind $0.05
AleksCash: posts big blind $0.10
*** HOLE CARDS ***
DONTCALLME8: folds 
SickerGC: folds 
Samogonka: folds 
nbg-1308 leaves the table
petrovichkag: raises $0.20 to $0.30
AleksCash: folds 
Uncalled bet ($0.20) returned to petrovichkag
petrovichkag collected $0.20 from pot
petrovichkag: doesn't show hand 
*** SUMMARY ***
Total pot $0.20 | Rake $0 
Seat 1: Samogonka (button) folded before Flop (didn't bet)
Seat 2: petrovichkag (small blind) collected ($0.20)
Seat 3: AleksCash (big blind) folded before Flop
Seat 4: DONTCALLME8 folded before Flop (didn't bet)
Seat 5: SickerGC folded before Flop (didn't bet)



PokerStars Hand #222947936027:  Hold'em No Limit ($0.05/$0.10 USD) - 2021/01/23 3:41:44 ET
Table 'Capricorn II' 6-max Seat #2 is the button
Seat 1: Samogonka ($10.05 in chips) 
Seat 2: petrovichkag ($10.40 in chips) 
Seat 3: AleksCash ($11.47 in chips) 
Seat 4: DONTCALLME8 ($10.66 in chips) 
Seat 5: SickerGC ($9.07 in chips) 
AleksCash: posts small blind $0.05
DONTCALLME8: posts big blind $0.10
*** HOLE CARDS ***
SickerGC: folds 
Samogonka: folds 
petrovichkag: folds 
AleksCash: raises $0.15 to $0.25
DONTCALLME8: raises $0.40 to $0.65
AleksCash: calls $0.40
*** FLOP *** [Js Jd 4d]
AleksCash: checks 
DONTCALLME8: checks 
*** TURN *** [Js Jd 4d] [Ks]
AleksCash: checks 
DONTCALLME8: bets $0.42
AleksCash: folds 
Uncalled bet ($0.42) returned to DONTCALLME8
DONTCALLME8 collected $1.24 from pot
*** SUMMARY ***
Total pot $1.30 | Rake $0.06 
Board [Js Jd 4d Ks]
Seat 1: Samogonka folded before Flop (didn't bet)
Seat 2: petrovichkag (button) folded before Flop (didn't bet)
Seat 3: AleksCash (small blind) folded on the Turn
Seat 4: DONTCALLME8 (big blind) collected ($1.24)
Seat 5: SickerGC folded before Flop (didn't bet)



PokerStars Hand #222947947395:  Hold'em No Limit ($0.05/$0.10 USD) - 2021/01/23 3:42:31 ET
Table 'Capricorn II' 6-max Seat #3 is the button
Seat 1: Samogonka ($10.05 in chips) 
Seat 2: petrovichkag ($10.40 in chips) 
Seat 3: AleksCash ($10.82 in chips) 
Seat 4: DONTCALLME8 ($11.25 in chips) 
Seat 5: SickerGC ($9.07 in chips) 
DONTCALLME8: posts small blind $0.05
SickerGC: posts big blind $0.10
*** HOLE CARDS ***
Samogonka: folds 
petrovichkag: raises $0.14 to $0.24
AleksCash: raises $0.66 to $0.90
DONTCALLME8: folds 
SickerGC: calls $0.80
petrovichkag: calls $0.66
*** FLOP *** [Ac 9c Js]
SickerGC: checks 
petrovichkag: checks 
AleksCash: bets $1.40
SickerGC: folds 
petrovichkag: raises $2.99 to $4.39
AleksCash: raises $5.53 to $9.92 and is all-in
petrovichkag: calls $5.11 and is all-in
Uncalled bet ($0.42) returned to AleksCash
*** TURN *** [Ac 9c Js] [9s]
*** RIVER *** [Ac 9c Js 9s] [2c]
*** SHOW DOWN ***
petrovichkag: shows [Ad Ks] (two pair, Aces and Nines)
AleksCash: shows [4c Qc] (a flush, Ace high)
AleksCash collected $20.77 from pot
*** SUMMARY ***
Total pot $21.75 | Rake $0.98 
Board [Ac 9c Js 9s 2c]
Seat 1: Samogonka folded before Flop (didn't bet)
Seat 2: petrovichkag showed [Ad Ks] and lost with two pair, Aces and Nines
Seat 3: AleksCash (button) showed [4c Qc] and won ($20.77) with a flush, Ace high
Seat 4: DONTCALLME8 (small blind) folded before Flop
Seat 5: SickerGC (big blind) folded on the Flop



PokerStars Hand #222948401212:  Hold'em No Limit ($0.05/$0.10 USD) - 2021/01/23 4:13:30 ET
Table 'Capricorn II' 6-max Seat #4 is the button
Seat 1: Samogonka ($8.84 in chips) 
Seat 2: petrovichkag ($10 in chips) 
Seat 3: AleksCash ($17.87 in chips) 
Seat 4: DONTCALLME8 ($11.55 in chips) 
Seat 5: SickerGC ($10.77 in chips) 
Seat 6: llosjone ($12.13 in chips) 
SickerGC: posts small blind $0.05
llosjone: posts big blind $0.10
*** HOLE CARDS ***
Samogonka: folds 
petrovichkag: folds 
AleksCash: folds 
DONTCALLME8: folds 
SickerGC: calls $0.05
llosjone: checks 
*** FLOP *** [Ac 4h Tc]
SickerGC: checks 
llosjone: bets $0.14
SickerGC: folds 
Uncalled bet ($0.14) returned to llosjone
llosjone collected $0.19 from pot
llosjone: doesn't show hand 
*** SUMMARY ***
Total pot $0.20 | Rake $0.01 
Board [Ac 4h Tc]
Seat 1: Samogonka folded before Flop (didn't bet)
Seat 2: petrovichkag folded before Flop (didn't bet)
Seat 3: AleksCash folded before Flop (didn't bet)
Seat 4: DONTCALLME8 (button) folded before Flop (didn't bet)
Seat 5: SickerGC (small blind) folded on the Flop
Seat 6: llosjone (big blind) collected ($0.19)



PokerStars Hand #222948150793:  Hold'em No Limit ($0.05/$0.10 USD) - 2021/01/23 3:56:28 ET
Table 'Capricorn II' 6-max Seat #3 is the button
Seat 1: Samogonka ($8.18 in chips) 
Seat 2: petrovichkag ($10 in chips) 
Seat 3: AleksCash ($15.81 in chips) 
Seat 4: DONTCALLME8 ($11.99 in chips) 
Seat 5: SickerGC ($6.49 in chips) 
Seat 6: llosjone ($18.57 in chips) 
DONTCALLME8: posts small blind $0.05
SickerGC: posts big blind $0.10
*** HOLE CARDS ***
llosjone: folds 
Samogonka: folds 
petrovichkag: raises $0.14 to $0.24
AleksCash: folds 
DONTCALLME8: folds 
SickerGC: calls $0.14
*** FLOP *** [2s 5c 8s]
SickerGC: checks 
petrovichkag: checks 
*** TURN *** [2s 5c 8s] [6s]
SickerGC: checks 
petrovichkag: checks 
*** RIVER *** [2s 5c 8s 6s] [8c]
SickerGC: checks 
petrovichkag: checks 
*** SHOW DOWN ***
SickerGC: shows [Ad 4s] (a pair of Eights)
petrovichkag: mucks hand 
SickerGC collected $0.51 from pot
*** SUMMARY ***
Total pot $0.53 | Rake $0.02 
Board [2s 5c 8s 6s 8c]
Seat 1: Samogonka folded before Flop (didn't bet)
Seat 2: petrovichkag mucked
Seat 3: AleksCash (button) folded before Flop (didn't bet)
Seat 4: DONTCALLME8 (small blind) folded before Flop
Seat 5: SickerGC (big blind) showed [Ad 4s] and won ($0.51) with a pair of Eights
Seat 6: llosjone folded before Flop (didn't bet)



PokerStars Hand #222948778747:  Hold'em No Limit ($0.05/$0.10 USD) - 2021/01/23 4:37:21 ET
Table 'Capricorn II' 6-max Seat #5 is the button
Seat 1: AAA_set_nh ($10.29 in chips) 
Seat 2: petrovichkag ($18.38 in chips) 
Seat 3: AleksCash ($18.93 in chips) 
Seat 4: Sabali420 ($10.76 in chips) 
Seat 5: fralex79 ($4.46 in chips) 
Seat 6: llosjone ($11.12 in chips) 
llosjone: posts small blind $0.05
AAA_set_nh: posts big blind $0.10
*** HOLE CARDS ***
petrovichkag: folds 
AleksCash: folds 
Sabali420: folds 
fralex79: calls $0.10
llosjone: folds 
AAA_set_nh: checks 
*** FLOP *** [5h Qd Qc]
AAA_set_nh: checks 
fralex79: bets $0.10
AAA_set_nh: folds 
Uncalled bet ($0.10) returned to fralex79
fralex79 collected $0.24 from pot
*** SUMMARY ***
Total pot $0.25 | Rake $0.01 
Board [5h Qd Qc]
Seat 1: AAA_set_nh (big blind) folded on the Flop
Seat 2: petrovichkag folded before Flop (didn't bet)
Seat 3: AleksCash folded before Flop (didn't bet)
Seat 4: Sabali420 folded before Flop (didn't bet)
Seat 5: fralex79 (button) collected ($0.24)
Seat 6: llosjone (small blind) folded before Flop



PokerStars Hand #222949358433:  Hold'em No Limit ($0.05/$0.10 USD) - 2021/01/23 5:11:58 ET
Table 'Capricorn II' 6-max Seat #4 is the button
Seat 3: rpadilla33 ($11.21 in chips) 
Seat 4: romanromanro ($16.94 in chips) 
Seat 5: jazou10 ($8.09 in chips) 
Seat 6: cruxua ($15.64 in chips) 
jazou10: posts small blind $0.05
cruxua: posts big blind $0.10
3EBC96: sits out 
*** HOLE CARDS ***
rpadilla33: raises $0.20 to $0.30
romanromanro: folds 
jazou10: folds 
cruxua: folds 
Uncalled bet ($0.20) returned to rpadilla33
rpadilla33 collected $0.25 from pot
*** SUMMARY ***
Total pot $0.25 | Rake $0 
Seat 3: rpadilla33 collected ($0.25)
Seat 4: romanromanro (button) folded before Flop (didn't bet)
Seat 5: jazou10 (small blind) folded before Flop
Seat 6: cruxua (big blind) folded before Flop



PokerStars Hand #222948439064:  Hold'em No Limit ($0.05/$0.10 USD) - 2021/01/23 4:15:56 ET
Table 'Capricorn II' 6-max Seat #3 is the button
Seat 2: petrovichkag ($10 in chips) 
Seat 3: AleksCash ($17.72 in chips) 
Seat 4: DONTCALLME8 ($11.36 in chips) 
Seat 5: SickerGC ($12.91 in chips) 
Seat 6: llosjone ($10.48 in chips) 
DONTCALLME8: posts small blind $0.05
SickerGC: posts big blind $0.10
AAA_set_nh: sits out 
*** HOLE CARDS ***
llosjone: raises $0.15 to $0.25
petrovichkag: folds 
AleksCash: folds 
DONTCALLME8: folds 
SickerGC: calls $0.15
*** FLOP *** [5s 8s 6s]
SickerGC: checks 
llosjone: checks 
*** TURN *** [5s 8s 6s] [9d]
SickerGC: checks 
llosjone: checks 
*** RIVER *** [5s 8s 6s 9d] [5c]
SickerGC: checks 
llosjone: checks 
*** SHOW DOWN ***
SickerGC: shows [2d 3c] (a pair of Fives)
llosjone: shows [Jd Td] (a pair of Fives - Jack kicker)
llosjone collected $0.53 from pot
*** SUMMARY ***
Total pot $0.55 | Rake $0.02 
Board [5s 8s 6s 9d 5c]
Seat 2: petrovichkag folded before Flop (didn't bet)
Seat 3: AleksCash (button) folded before Flop (didn't bet)
Seat 4: DONTCALLME8 (small blind) folded before Flop
Seat 5: SickerGC (big blind) showed [2d 3c] and lost with a pair of Fives
Seat 6: llosjone showed [Jd Td] and won ($0.53) with a pair of Fives



PokerStars Hand #222948449960:  Hold'em No Limit ($0.05/$0.10 USD) - 2021/01/23 4:16:38 ET
Table 'Capricorn II' 6-max Seat #4 is the button
Seat 2: petrovichkag ($10 in chips) 
Seat 3: AleksCash ($17.72 in chips) 
Seat 4: DONTCALLME8 ($11.31 in chips) 
Seat 5: SickerGC ($12.66 in chips) 
Seat 6: llosjone ($10.76 in chips) 
SickerGC: posts small blind $0.05
llosjone: posts big blind $0.10
AAA_set_nh: sits out 
*** HOLE CARDS ***
petrovichkag: folds 
AleksCash: folds 
DONTCALLME8: folds 
SickerGC: folds 
Uncalled bet ($0.05) returned to llosjone
llosjone collected $0.10 from pot
llosjone: doesn't show hand 
*** SUMMARY ***
Total pot $0.10 | Rake $0 
Seat 2: petrovichkag folded before Flop (didn't bet)
Seat 3: AleksCash folded before Flop (didn't bet)
Seat 4: DONTCALLME8 (button) folded before Flop (didn't bet)
Seat 5: SickerGC (small blind) folded before Flop
Seat 6: llosjone (big blind) collected ($0.10)



PokerStars Hand #222948453493:  Hold'em No Limit ($0.05/$0.10 USD) - 2021/01/23 4:16:52 ET
Table 'Capricorn II' 6-max Seat #5 is the button
Seat 1: AAA_set_nh ($10 in chips) 
Seat 2: petrovichkag ($10 in chips) 
Seat 3: AleksCash ($17.72 in chips) 
Seat 4: DONTCALLME8 ($11.31 in chips) 
Seat 5: SickerGC ($12.61 in chips) 
Seat 6: llosjone ($10.81 in chips) 
llosjone: posts small blind $0.05
AAA_set_nh: posts big blind $0.10
*** HOLE CARDS ***
petrovichkag: raises $0.14 to $0.24
AleksCash: raises $0.66 to $0.90
DONTCALLME8: folds 
SickerGC: calls $0.90
llosjone: folds 
AAA_set_nh: folds 
petrovichkag: calls $0.66
*** FLOP *** [3c 8s Jh]
petrovichkag: checks 
AleksCash: bets $1.75
SickerGC: folds 
petrovichkag: folds 
Uncalled bet ($1.75) returned to AleksCash
AleksCash collected $2.72 from pot
AleksCash: doesn't show hand 
*** SUMMARY ***
Total pot $2.85 | Rake $0.13 
Board [3c 8s Jh]
Seat 1: AAA_set_nh (big blind) folded before Flop
Seat 2: petrovichkag folded on the Flop
Seat 3: AleksCash collected ($2.72)
Seat 4: DONTCALLME8 folded before Flop (didn't bet)
Seat 5: SickerGC (button) folded on the Flop
Seat 6: llosjone (small blind) folded before Flop



PokerStars Hand #222948463059:  Hold'em No Limit ($0.05/$0.10 USD) - 2021/01/23 4:17:29 ET
Table 'Capricorn II' 6-max Seat #6 is the button
Seat 1: AAA_set_nh ($10 in chips) 
Seat 2: petrovichkag ($10 in chips) 
Seat 3: AleksCash ($19.54 in chips) 
Seat 4: DONTCALLME8 ($11.31 in chips) 
Seat 5: SickerGC ($11.71 in chips) 
Seat 6: llosjone ($10.76 in chips) 
AAA_set_nh: posts small blind $0.05
petrovichkag: posts big blind $0.10
*** HOLE CARDS ***
AleksCash: folds 
DONTCALLME8: folds 
SickerGC: folds 
llosjone: folds 
AAA_set_nh: folds 
Uncalled bet ($0.05) returned to petrovichkag
petrovichkag collected $0.10 from pot
petrovichkag: doesn't show hand 
*** SUMMARY ***
Total pot $0.10 | Rake $0 
Seat 1: AAA_set_nh (small blind) folded before Flop
Seat 2: petrovichkag (big blind) collected ($0.10)
Seat 3: AleksCash folded before Flop (didn't bet)
Seat 4: DONTCALLME8 folded before Flop (didn't bet)
Seat 5: SickerGC folded before Flop (didn't bet)
Seat 6: llosjone (button) folded before Flop (didn't bet)



PokerStars Hand #222948465629:  Hold'em No Limit ($0.05/$0.10 USD) - 2021/01/23 4:17:39 ET
Table 'Capricorn II' 6-max Seat #1 is the button
Seat 1: AAA_set_nh ($10 in chips) 
Seat 2: petrovichkag ($10.05 in chips) 
Seat 3: AleksCash ($19.54 in chips) 
Seat 4: DONTCALLME8 ($11.31 in chips) 
Seat 5: SickerGC ($11.71 in chips) 
Seat 6: llosjone ($10.76 in chips) 
petrovichkag: posts small blind $0.05
AleksCash: posts big blind $0.10
*** HOLE CARDS ***
DONTCALLME8: raises $0.14 to $0.24
SickerGC: folds 
llosjone: folds 
AAA_set_nh: folds 
petrovichkag: folds 
AleksCash: folds 
Uncalled bet ($0.14) returned to DONTCALLME8
DONTCALLME8 collected $0.25 from pot
DONTCALLME8: doesn't show hand 
*** SUMMARY ***
Total pot $0.25 | Rake $0 
Seat 1: AAA_set_nh (button) folded before Flop (didn't bet)
Seat 2: petrovichkag (small blind) folded before Flop
Seat 3: AleksCash (big blind) folded before Flop
Seat 4: DONTCALLME8 collected ($0.25)
Seat 5: SickerGC folded before Flop (didn't bet)
Seat 6: llosjone folded before Flop (didn't bet)



PokerStars Hand #222948470729:  Hold'em No Limit ($0.05/$0.10 USD) - 2021/01/23 4:17:58 ET
Table 'Capricorn II' 6-max Seat #2 is the button
Seat 1: AAA_set_nh ($10 in chips) 
Seat 2: petrovichkag ($10 in chips) 
Seat 3: AleksCash ($19.44 in chips) 
Seat 4: DONTCALLME8 ($11.46 in chips) 
Seat 5: SickerGC ($11.71 in chips) 
Seat 6: llosjone ($10.76 in chips) 
AleksCash: posts small blind $0.05
DONTCALLME8: posts big blind $0.10
*** HOLE CARDS ***
SickerGC: calls $0.10
llosjone: folds 
AAA_set_nh: raises $0.30 to $0.40
petrovichkag: folds 
AleksCash: folds 
DONTCALLME8: calls $0.30
SickerGC: folds 
*** FLOP *** [Ad 9s 9h]
DONTCALLME8: checks 
AAA_set_nh: bets $0.46
DONTCALLME8: folds 
Uncalled bet ($0.46) returned to AAA_set_nh
AAA_set_nh collected $0.91 from pot
AAA_set_nh: doesn't show hand 
*** SUMMARY ***
Total pot $0.95 | Rake $0.04 
Board [Ad 9s 9h]
Seat 1: AAA_set_nh collected ($0.91)
Seat 2: petrovichkag (button) folded before Flop (didn't bet)
Seat 3: AleksCash (small blind) folded before Flop
Seat 4: DONTCALLME8 (big blind) folded on the Flop
Seat 5: SickerGC folded before Flop
Seat 6: llosjone folded before Flop (didn't bet)



PokerStars Hand #222948478031:  Hold'em No Limit ($0.05/$0.10 USD) - 2021/01/23 4:18:26 ET
Table 'Capricorn II' 6-max Seat #3 is the button
Seat 1: AAA_set_nh ($10.51 in chips) 
Seat 2: petrovichkag ($10 in chips) 
Seat 3: AleksCash ($19.39 in chips) 
Seat 4: DONTCALLME8 ($11.06 in chips) 
Seat 5: SickerGC ($11.61 in chips) 
Seat 6: llosjone ($10.76 in chips) 
DONTCALLME8: posts small blind $0.05
SickerGC: posts big blind $0.10
*** HOLE CARDS ***
llosjone: folds 
AAA_set_nh: folds 
petrovichkag: raises $0.14 to $0.24
AleksCash: folds 
DONTCALLME8: folds 
SickerGC: calls $0.14
*** FLOP *** [3h 4s 7h]
SickerGC: checks 
petrovichkag: checks 
*** TURN *** [3h 4s 7h] [8c]
SickerGC: checks 
petrovichkag: bets $0.40
SickerGC: folds 
Uncalled bet ($0.40) returned to petrovichkag
petrovichkag collected $0.51 from pot
petrovichkag: doesn't show hand 
*** SUMMARY ***
Total pot $0.53 | Rake $0.02 
Board [3h 4s 7h 8c]
Seat 1: AAA_set_nh folded before Flop (didn't bet)
Seat 2: petrovichkag collected ($0.51)
Seat 3: AleksCash (button) folded before Flop (didn't bet)
Seat 4: DONTCALLME8 (small blind) folded before Flop
Seat 5: SickerGC (big blind) folded on the Turn
Seat 6: llosjone folded before Flop (didn't bet)



PokerStars Hand #222948484420:  Hold'em No Limit ($0.05/$0.10 USD) - 2021/01/23 4:18:50 ET
Table 'Capricorn II' 6-max Seat #4 is the button
Seat 1: AAA_set_nh ($10.51 in chips) 
Seat 2: petrovichkag ($10.27 in chips) 
Seat 3: AleksCash ($19.39 in chips) 
Seat 4: DONTCALLME8 ($11.01 in chips) 
Seat 5: SickerGC ($11.37 in chips) 
Seat 6: llosjone ($10.76 in chips) 
SickerGC: posts small blind $0.05
llosjone: posts big blind $0.10
*** HOLE CARDS ***
AAA_set_nh: folds 
petrovichkag: folds 
AleksCash: raises $0.15 to $0.25
DONTCALLME8: folds 
SickerGC: calls $0.20
llosjone: calls $0.15
*** FLOP *** [5s Kc 6s]
SickerGC: checks 
llosjone: checks 
AleksCash: checks 
*** TURN *** [5s Kc 6s] [Js]
SickerGC: checks 
llosjone: checks 
AleksCash: checks 
*** RIVER *** [5s Kc 6s Js] [5c]
SickerGC: checks 
llosjone: checks 
AleksCash: checks 
*** SHOW DOWN ***
SickerGC: shows [7s 9d] (a pair of Fives)
llosjone: shows [Td 8h] (a pair of Fives - King+Jack+Ten kicker)
AleksCash: shows [Ah Tc] (a pair of Fives - Ace kicker)
AleksCash collected $0.72 from pot
*** SUMMARY ***
Total pot $0.75 | Rake $0.03 
Board [5s Kc 6s Js 5c]
Seat 1: AAA_set_nh folded before Flop (didn't bet)
Seat 2: petrovichkag folded before Flop (didn't bet)
Seat 3: AleksCash showed [Ah Tc] and won ($0.72) with a pair of Fives
Seat 4: DONTCALLME8 (button) folded before Flop (didn't bet)
Seat 5: SickerGC (small blind) showed [7s 9d] and lost with a pair of Fives
Seat 6: llosjone (big blind) showed [Td 8h] and lost with a pair of Fives



PokerStars Hand #222948496853:  Hold'em No Limit ($0.05/$0.10 USD) - 2021/01/23 4:19:37 ET
Table 'Capricorn II' 6-max Seat #5 is the button
Seat 1: AAA_set_nh ($10.51 in chips) 
Seat 2: petrovichkag ($10.27 in chips) 
Seat 3: AleksCash ($19.86 in chips) 
Seat 4: DONTCALLME8 ($11.01 in chips) 
Seat 5: SickerGC ($11.12 in chips) 
Seat 6: llosjone ($10.51 in chips) 
llosjone: posts small blind $0.05
AAA_set_nh: posts big blind $0.10
*** HOLE CARDS ***
petrovichkag: folds 
AleksCash: folds 
DONTCALLME8: folds 
SickerGC: calls $0.10
llosjone: folds 
AAA_set_nh: raises $0.50 to $0.60
SickerGC: calls $0.50
*** FLOP *** [Kd 3s 2c]
AAA_set_nh: bets $0.60
SickerGC: folds 
Uncalled bet ($0.60) returned to AAA_set_nh
AAA_set_nh collected $1.19 from pot
AAA_set_nh: doesn't show hand 
*** SUMMARY ***
Total pot $1.25 | Rake $0.06 
Board [Kd 3s 2c]
Seat 1: AAA_set_nh (big blind) collected ($1.19)
Seat 2: petrovichkag folded before Flop (didn't bet)
Seat 3: AleksCash folded before Flop (didn't bet)
Seat 4: DONTCALLME8 folded before Flop (didn't bet)
Seat 5: SickerGC (button) folded on the Flop
Seat 6: llosjone (small blind) folded before Flop



PokerStars Hand #222948505825:  Hold'em No Limit ($0.05/$0.10 USD) - 2021/01/23 4:20:11 ET
Table 'Capricorn II' 6-max Seat #6 is the button
Seat 1: AAA_set_nh ($11.10 in chips) 
Seat 2: petrovichkag ($10.27 in chips) 
Seat 3: AleksCash ($19.86 in chips) 
Seat 4: DONTCALLME8 ($11.01 in chips) 
Seat 5: SickerGC ($10.52 in chips) 
Seat 6: llosjone ($10.46 in chips) 
AAA_set_nh: posts small blind $0.05
petrovichkag: posts big blind $0.10
*** HOLE CARDS ***
AleksCash: folds 
DONTCALLME8: folds 
SickerGC: folds 
llosjone: folds 
AAA_set_nh: folds 
Uncalled bet ($0.05) returned to petrovichkag
petrovichkag collected $0.10 from pot
petrovichkag: doesn't show hand 
*** SUMMARY ***
Total pot $0.10 | Rake $0 
Seat 1: AAA_set_nh (small blind) folded before Flop
Seat 2: petrovichkag (big blind) collected ($0.10)
Seat 3: AleksCash folded before Flop (didn't bet)
Seat 4: DONTCALLME8 folded before Flop (didn't bet)
Seat 5: SickerGC folded before Flop (didn't bet)
Seat 6: llosjone (button) folded before Flop (didn't bet)



PokerStars Hand #222948509328:  Hold'em No Limit ($0.05/$0.10 USD) - 2021/01/23 4:20:24 ET
Table 'Capricorn II' 6-max Seat #1 is the button
Seat 1: AAA_set_nh ($11.05 in chips) 
Seat 2: petrovichkag ($10.32 in chips) 
Seat 3: AleksCash ($19.86 in chips) 
Seat 4: DONTCALLME8 ($11.01 in chips) 
Seat 5: SickerGC ($10.52 in chips) 
Seat 6: llosjone ($10.46 in chips) 
petrovichkag: posts small blind $0.05
AleksCash: posts big blind $0.10
*** HOLE CARDS ***
DONTCALLME8: raises $0.14 to $0.24
SickerGC: raises $0.14 to $0.38
llosjone: folds 
AAA_set_nh: folds 
petrovichkag: folds 
AleksCash: folds 
DONTCALLME8: calls $0.14
*** FLOP *** [9d 5s 5d]
DONTCALLME8: checks 
SickerGC: checks 
*** TURN *** [9d 5s 5d] [7c]
DONTCALLME8: checks 
SickerGC: checks 
*** RIVER *** [9d 5s 5d 7c] [Js]
DONTCALLME8: checks 
SickerGC: checks 
*** SHOW DOWN ***
DONTCALLME8: shows [Jd Qs] (two pair, Jacks and Fives)
SickerGC: mucks hand 
DONTCALLME8 collected $0.87 from pot
*** SUMMARY ***
Total pot $0.91 | Rake $0.04 
Board [9d 5s 5d 7c Js]
Seat 1: AAA_set_nh (button) folded before Flop (didn't bet)
Seat 2: petrovichkag (small blind) folded before Flop
Seat 3: AleksCash (big blind) folded before Flop
Seat 4: DONTCALLME8 showed [Jd Qs] and won ($0.87) with two pair, Jacks and Fives
Seat 5: SickerGC mucked
Seat 6: llosjone folded before Flop (didn't bet)



PokerStars Hand #222948525775:  Hold'em No Limit ($0.05/$0.10 USD) - 2021/01/23 4:21:27 ET
Table 'Capricorn II' 6-max Seat #2 is the button
Seat 1: AAA_set_nh ($11.05 in chips) 
Seat 2: petrovichkag ($10.27 in chips) 
Seat 3: AleksCash ($19.76 in chips) 
Seat 4: DONTCALLME8 ($11.50 in chips) 
Seat 5: SickerGC ($10.14 in chips) 
Seat 6: llosjone ($10.46 in chips) 
AleksCash: posts small blind $0.05
DONTCALLME8: posts big blind $0.10
*** HOLE CARDS ***
SickerGC: calls $0.10
llosjone: folds 
AAA_set_nh: folds 
petrovichkag: folds 
AleksCash: calls $0.05
DONTCALLME8: checks 
*** FLOP *** [Kh 3h 6d]
AleksCash: checks 
DONTCALLME8: checks 
SickerGC: checks 
*** TURN *** [Kh 3h 6d] [7h]
AleksCash: checks 
DONTCALLME8: checks 
SickerGC: checks 
*** RIVER *** [Kh 3h 6d 7h] [Jc]
AleksCash: checks 
DONTCALLME8: checks 
SickerGC: checks 
*** SHOW DOWN ***
AleksCash: shows [2c 2s] (a pair of Deuces)
DONTCALLME8: shows [3d Qc] (a pair of Threes)
SickerGC: shows [7d 8h] (a pair of Sevens)
SickerGC collected $0.29 from pot
*** SUMMARY ***
Total pot $0.30 | Rake $0.01 
Board [Kh 3h 6d 7h Jc]
Seat 1: AAA_set_nh folded before Flop (didn't bet)
Seat 2: petrovichkag (button) folded before Flop (didn't bet)
Seat 3: AleksCash (small blind) showed [2c 2s] and lost with a pair of Deuces
Seat 4: DONTCALLME8 (big blind) showed [3d Qc] and lost with a pair of Threes
Seat 5: SickerGC showed [7d 8h] and won ($0.29) with a pair of Sevens
Seat 6: llosjone folded before Flop (didn't bet)



PokerStars Hand #222948537767:  Hold'em No Limit ($0.05/$0.10 USD) - 2021/01/23 4:22:12 ET
Table 'Capricorn II' 6-max Seat #3 is the button
Seat 1: AAA_set_nh ($11.05 in chips) 
Seat 2: petrovichkag ($10.27 in chips) 
Seat 3: AleksCash ($19.66 in chips) 
Seat 4: DONTCALLME8 ($11.40 in chips) 
Seat 5: SickerGC ($10.33 in chips) 
Seat 6: llosjone ($10.46 in chips) 
DONTCALLME8: posts small blind $0.05
SickerGC: posts big blind $0.10
*** HOLE CARDS ***
llosjone: folds 
AAA_set_nh: folds 
petrovichkag: raises $0.14 to $0.24
AleksCash: folds 
DONTCALLME8: folds 
SickerGC: folds 
Uncalled bet ($0.14) returned to petrovichkag
petrovichkag collected $0.25 from pot
*** SUMMARY ***
Total pot $0.25 | Rake $0 
Seat 1: AAA_set_nh folded before Flop (didn't bet)
Seat 2: petrovichkag collected ($0.25)
Seat 3: AleksCash (button) folded before Flop (didn't bet)
Seat 4: DONTCALLME8 (small blind) folded before Flop
Seat 5: SickerGC (big blind) folded before Flop
Seat 6: llosjone folded before Flop (didn't bet)



PokerStars Hand #222948541206:  Hold'em No Limit ($0.05/$0.10 USD) - 2021/01/23 4:22:25 ET
Table 'Capricorn II' 6-max Seat #4 is the button
Seat 1: AAA_set_nh ($11.05 in chips) 
Seat 2: petrovichkag ($10.42 in chips) 
Seat 3: AleksCash ($19.66 in chips) 
Seat 4: DONTCALLME8 ($11.35 in chips) 
Seat 5: SickerGC ($10.23 in chips) 
Seat 6: llosjone ($10.46 in chips) 
SickerGC: posts small blind $0.05
llosjone: posts big blind $0.10
*** HOLE CARDS ***
AAA_set_nh: raises $0.20 to $0.30
petrovichkag: raises $0.60 to $0.90
AleksCash: folds 
DONTCALLME8: folds 
SickerGC: folds 
llosjone: folds 
AAA_set_nh: folds 
Uncalled bet ($0.60) returned to petrovichkag
petrovichkag collected $0.75 from pot
petrovichkag: doesn't show hand 
*** SUMMARY ***
Total pot $0.75 | Rake $0 
Seat 1: AAA_set_nh folded before Flop
Seat 2: petrovichkag collected ($0.75)
Seat 3: AleksCash folded before Flop (didn't bet)
Seat 4: DONTCALLME8 (button) folded before Flop (didn't bet)
Seat 5: SickerGC (small blind) folded before Flop
Seat 6: llosjone (big blind) folded before Flop



PokerStars Hand #222948546914:  Hold'em No Limit ($0.05/$0.10 USD) - 2021/01/23 4:22:47 ET
Table 'Capricorn II' 6-max Seat #6 is the button
Seat 1: AAA_set_nh ($10.75 in chips) 
Seat 2: petrovichkag ($10.87 in chips) 
Seat 3: AleksCash ($19.66 in chips) 
Seat 4: DONTCALLME8 ($11.35 in chips) 
Seat 6: llosjone ($10.36 in chips) 
AAA_set_nh: posts small blind $0.05
petrovichkag: posts big blind $0.10
*** HOLE CARDS ***
AleksCash: folds 
DONTCALLME8: folds 
llosjone: folds 
AAA_set_nh: folds 
Uncalled bet ($0.05) returned to petrovichkag
petrovichkag collected $0.10 from pot
petrovichkag: doesn't show hand 
*** SUMMARY ***
Total pot $0.10 | Rake $0 
Seat 1: AAA_set_nh (small blind) folded before Flop
Seat 2: petrovichkag (big blind) collected ($0.10)
Seat 3: AleksCash folded before Flop (didn't bet)
Seat 4: DONTCALLME8 folded before Flop (didn't bet)
Seat 6: llosjone (button) folded before Flop (didn't bet)



PokerStars Hand #222948550036:  Hold'em No Limit ($0.05/$0.10 USD) - 2021/01/23 4:22:59 ET
Table 'Capricorn II' 6-max Seat #1 is the button
Seat 1: AAA_set_nh ($10.70 in chips) 
Seat 2: petrovichkag ($10.92 in chips) 
Seat 3: AleksCash ($19.66 in chips) 
Seat 4: DONTCALLME8 ($11.35 in chips) 
Seat 6: llosjone ($10.36 in chips) 
petrovichkag: posts small blind $0.05
AleksCash: posts big blind $0.10
*** HOLE CARDS ***
DONTCALLME8: folds 
llosjone: folds 
AAA_set_nh: folds 
petrovichkag: raises $0.20 to $0.30
AleksCash: raises $0.70 to $1
petrovichkag: calls $0.70
*** FLOP *** [6d 6c 3d]
petrovichkag: checks 
AleksCash: bets $1.20
petrovichkag: calls $1.20
*** TURN *** [6d 6c 3d] [Kh]
petrovichkag: checks 
AleksCash: bets $2.60
petrovichkag: folds 
Uncalled bet ($2.60) returned to AleksCash
AleksCash collected $4.20 from pot
AleksCash: doesn't show hand 
*** SUMMARY ***
Total pot $4.40 | Rake $0.20 
Board [6d 6c 3d Kh]
Seat 1: AAA_set_nh (button) folded before Flop (didn't bet)
Seat 2: petrovichkag (small blind) folded on the Turn
Seat 3: AleksCash (big blind) collected ($4.20)
Seat 4: DONTCALLME8 folded before Flop (didn't bet)
Seat 6: llosjone folded before Flop (didn't bet)



PokerStars Hand #222948564084:  Hold'em No Limit ($0.05/$0.10 USD) - 2021/01/23 4:23:52 ET
Table 'Capricorn II' 6-max Seat #2 is the button
Seat 1: AAA_set_nh ($10.70 in chips) 
Seat 2: petrovichkag ($10 in chips) 
Seat 3: AleksCash ($21.66 in chips) 
Seat 4: DONTCALLME8 ($11.35 in chips) 
Seat 6: llosjone ($10.36 in chips) 
AleksCash: posts small blind $0.05
DONTCALLME8: posts big blind $0.10
*** HOLE CARDS ***
llosjone: raises $0.15 to $0.25
AAA_set_nh: folds 
petrovichkag: folds 
AleksCash: raises $0.75 to $1
DONTCALLME8: folds 
llosjone: calls $0.75
*** FLOP *** [Kh 6h 8c]
AleksCash: checks 
llosjone: checks 
*** TURN *** [Kh 6h 8c] [3d]
AleksCash: checks 
llosjone: checks 
*** RIVER *** [Kh 6h 8c 3d] [7s]
AleksCash: checks 
llosjone: checks 
*** SHOW DOWN ***
AleksCash: shows [Qd Qs] (a pair of Queens)
llosjone: mucks hand 
AleksCash collected $2.01 from pot
*** SUMMARY ***
Total pot $2.10 | Rake $0.09 
Board [Kh 6h 8c 3d 7s]
Seat 1: AAA_set_nh folded before Flop (didn't bet)
Seat 2: petrovichkag (button) folded before Flop (didn't bet)
Seat 3: AleksCash (small blind) showed [Qd Qs] and won ($2.01) with a pair of Queens
Seat 4: DONTCALLME8 (big blind) folded before Flop
Seat 6: llosjone mucked



PokerStars Hand #222948571944:  Hold'em No Limit ($0.05/$0.10 USD) - 2021/01/23 4:24:22 ET
Table 'Capricorn II' 6-max Seat #3 is the button
Seat 1: AAA_set_nh ($10.70 in chips) 
Seat 2: petrovichkag ($10 in chips) 
Seat 3: AleksCash ($22.67 in chips) 
Seat 4: DONTCALLME8 ($11.25 in chips) 
Seat 5: SickerGC ($10.18 in chips) 
Seat 6: llosjone ($9.36 in chips) 
DONTCALLME8: posts small blind $0.05
SickerGC: posts big blind $0.10
*** HOLE CARDS ***
llosjone: folds 
AAA_set_nh: folds 
petrovichkag: raises $0.14 to $0.24
AleksCash: folds 
DONTCALLME8: folds 
SickerGC: folds 
Uncalled bet ($0.14) returned to petrovichkag
petrovichkag collected $0.25 from pot
petrovichkag: doesn't show hand 
*** SUMMARY ***
Total pot $0.25 | Rake $0 
Seat 1: AAA_set_nh folded before Flop (didn't bet)
Seat 2: petrovichkag collected ($0.25)
Seat 3: AleksCash (button) folded before Flop (didn't bet)
Seat 4: DONTCALLME8 (small blind) folded before Flop
Seat 5: SickerGC (big blind) folded before Flop
Seat 6: llosjone folded before Flop (didn't bet)



PokerStars Hand #222948577579:  Hold'em No Limit ($0.05/$0.10 USD) - 2021/01/23 4:24:44 ET
Table 'Capricorn II' 6-max Seat #4 is the button
Seat 1: AAA_set_nh ($10.70 in chips) 
Seat 2: petrovichkag ($10.15 in chips) 
Seat 3: AleksCash ($22.67 in chips) 
Seat 4: DONTCALLME8 ($11.20 in chips) 
Seat 5: SickerGC ($10.08 in chips) 
Seat 6: llosjone ($10 in chips) 
SickerGC: posts small blind $0.05
llosjone: posts big blind $0.10
*** HOLE CARDS ***
AAA_set_nh: folds 
petrovichkag: folds 
AleksCash: folds 
DONTCALLME8: folds 
SickerGC: raises $0.20 to $0.30
llosjone: folds 
Uncalled bet ($0.20) returned to SickerGC
SickerGC collected $0.20 from pot
SickerGC: doesn't show hand 
*** SUMMARY ***
Total pot $0.20 | Rake $0 
Seat 1: AAA_set_nh folded before Flop (didn't bet)
Seat 2: petrovichkag folded before Flop (didn't bet)
Seat 3: AleksCash folded before Flop (didn't bet)
Seat 4: DONTCALLME8 (button) folded before Flop (didn't bet)
Seat 5: SickerGC (small blind) collected ($0.20)
Seat 6: llosjone (big blind) folded before Flop



PokerStars Hand #222948582263:  Hold'em No Limit ($0.05/$0.10 USD) - 2021/01/23 4:25:01 ET
Table 'Capricorn II' 6-max Seat #5 is the button
Seat 1: AAA_set_nh ($10.70 in chips) 
Seat 2: petrovichkag ($10.15 in chips) 
Seat 3: AleksCash ($22.67 in chips) 
Seat 4: DONTCALLME8 ($11.20 in chips) 
Seat 5: SickerGC ($10.18 in chips) 
Seat 6: llosjone ($9.90 in chips) 
llosjone: posts small blind $0.05
AAA_set_nh: posts big blind $0.10
*** HOLE CARDS ***
petrovichkag: folds 
AleksCash: folds 
DONTCALLME8: folds 
SickerGC: raises $0.20 to $0.30
llosjone: folds 
AAA_set_nh: calls $0.20
*** FLOP *** [Qd 7h Jd]
AAA_set_nh: checks 
SickerGC: bets $0.62
AAA_set_nh: calls $0.62
*** TURN *** [Qd 7h Jd] [6h]
AAA_set_nh: checks 
SickerGC: bets $1.80
AAA_set_nh: folds 
Uncalled bet ($1.80) returned to SickerGC
SickerGC collected $1.80 from pot
SickerGC: doesn't show hand 
*** SUMMARY ***
Total pot $1.89 | Rake $0.09 
Board [Qd 7h Jd 6h]
Seat 1: AAA_set_nh (big blind) folded on the Turn
Seat 2: petrovichkag folded before Flop (didn't bet)
Seat 3: AleksCash folded before Flop (didn't bet)
Seat 4: DONTCALLME8 folded before Flop (didn't bet)
Seat 5: SickerGC (button) collected ($1.80)
Seat 6: llosjone (small blind) folded before Flop



PokerStars Hand #222948588527:  Hold'em No Limit ($0.05/$0.10 USD) - 2021/01/23 4:25:26 ET
Table 'Capricorn II' 6-max Seat #6 is the button
Seat 1: AAA_set_nh ($10 in chips) 
Seat 2: petrovichkag ($10.15 in chips) 
Seat 3: AleksCash ($22.67 in chips) 
Seat 4: DONTCALLME8 ($11.20 in chips) 
Seat 5: SickerGC ($11.06 in chips) 
Seat 6: llosjone ($9.85 in chips) 
AAA_set_nh: posts small blind $0.05
petrovichkag: posts big blind $0.10
*** HOLE CARDS ***
AleksCash: folds 
DONTCALLME8: folds 
SickerGC: folds 
llosjone: raises $0.15 to $0.25
AAA_set_nh: folds 
petrovichkag: folds 
Uncalled bet ($0.15) returned to llosjone
llosjone collected $0.25 from pot
llosjone: doesn't show hand 
*** SUMMARY ***
Total pot $0.25 | Rake $0 
Seat 1: AAA_set_nh (small blind) folded before Flop
Seat 2: petrovichkag (big blind) folded before Flop
Seat 3: AleksCash folded before Flop (didn't bet)
Seat 4: DONTCALLME8 folded before Flop (didn't bet)
Seat 5: SickerGC folded before Flop (didn't bet)
Seat 6: llosjone (button) collected ($0.25)



PokerStars Hand #222948592054:  Hold'em No Limit ($0.05/$0.10 USD) - 2021/01/23 4:25:39 ET
Table 'Capricorn II' 6-max Seat #1 is the button
Seat 1: AAA_set_nh ($10 in chips) 
Seat 2: petrovichkag ($10.05 in chips) 
Seat 3: AleksCash ($22.67 in chips) 
Seat 4: DONTCALLME8 ($11.20 in chips) 
Seat 5: SickerGC ($11.06 in chips) 
Seat 6: llosjone ($10 in chips) 
petrovichkag: posts small blind $0.05
AleksCash: posts big blind $0.10
*** HOLE CARDS ***
DONTCALLME8: folds 
SickerGC: folds 
llosjone: folds 
AAA_set_nh: folds 
petrovichkag: raises $0.20 to $0.30
AleksCash: calls $0.20
*** FLOP *** [5c 5d Qd]
petrovichkag: checks 
AleksCash: bets $0.30
petrovichkag: calls $0.30
*** TURN *** [5c 5d Qd] [Kd]
petrovichkag: checks 
AleksCash: bets $1.05
petrovichkag: calls $1.05
*** RIVER *** [5c 5d Qd Kd] [6s]
petrovichkag: checks 
AleksCash: bets $4.05
petrovichkag: raises $4.35 to $8.40 and is all-in
AleksCash: calls $4.35
*** SHOW DOWN ***
petrovichkag: shows [6c 6d] (a full house, Sixes full of Fives)
AleksCash: shows [2d Ad] (a flush, Ace high)
petrovichkag collected $19.20 from pot
*** SUMMARY ***
Total pot $20.10 | Rake $0.90 
Board [5c 5d Qd Kd 6s]
Seat 1: AAA_set_nh (button) folded before Flop (didn't bet)
Seat 2: petrovichkag (small blind) showed [6c 6d] and won ($19.20) with a full house, Sixes full of Fives
Seat 3: AleksCash (big blind) showed [2d Ad] and lost with a flush, Ace high
Seat 4: DONTCALLME8 folded before Flop (didn't bet)
Seat 5: SickerGC folded before Flop (didn't bet)
Seat 6: llosjone folded before Flop (didn't bet)



PokerStars Hand #222948608729:  Hold'em No Limit ($0.05/$0.10 USD) - 2021/01/23 4:26:43 ET
Table 'Capricorn II' 6-max Seat #2 is the button
Seat 1: AAA_set_nh ($10 in chips) 
Seat 2: petrovichkag ($19.20 in chips) 
Seat 3: AleksCash ($12.62 in chips) 
Seat 4: DONTCALLME8 ($11.20 in chips) 
Seat 5: SickerGC ($11.06 in chips) 
Seat 6: llosjone ($10 in chips) 
AleksCash: posts small blind $0.05
DONTCALLME8: posts big blind $0.10
*** HOLE CARDS ***
SickerGC: calls $0.10
llosjone: folds 
AAA_set_nh: folds 
petrovichkag: raises $0.30 to $0.40
AleksCash: folds 
DONTCALLME8: calls $0.30
SickerGC: raises $1 to $1.40
petrovichkag: folds 
DONTCALLME8: folds 
Uncalled bet ($1) returned to SickerGC
SickerGC collected $1.25 from pot
SickerGC: doesn't show hand 
*** SUMMARY ***
Total pot $1.25 | Rake $0 
Seat 1: AAA_set_nh folded before Flop (didn't bet)
Seat 2: petrovichkag (button) folded before Flop
Seat 3: AleksCash (small blind) folded before Flop
Seat 4: DONTCALLME8 (big blind) folded before Flop
Seat 5: SickerGC collected ($1.25)
Seat 6: llosjone folded before Flop (didn't bet)



PokerStars Hand #222948622899:  Hold'em No Limit ($0.05/$0.10 USD) - 2021/01/23 4:27:37 ET
Table 'Capricorn II' 6-max Seat #3 is the button
Seat 1: AAA_set_nh ($10 in chips) 
Seat 2: petrovichkag ($18.80 in chips) 
Seat 3: AleksCash ($12.57 in chips) 
Seat 4: DONTCALLME8 ($10.80 in chips) 
Seat 5: SickerGC ($11.91 in chips) 
Seat 6: llosjone ($10 in chips) 
DONTCALLME8: posts small blind $0.05
SickerGC: posts big blind $0.10
*** HOLE CARDS ***
llosjone: folds 
AAA_set_nh: folds 
petrovichkag: folds 
AleksCash: raises $0.15 to $0.25
DONTCALLME8: folds 
SickerGC: calls $0.15
*** FLOP *** [7s Ah 3h]
SickerGC: checks 
AleksCash: bets $0.35
SickerGC: folds 
Uncalled bet ($0.35) returned to AleksCash
AleksCash collected $0.53 from pot
AleksCash: doesn't show hand 
*** SUMMARY ***
Total pot $0.55 | Rake $0.02 
Board [7s Ah 3h]
Seat 1: AAA_set_nh folded before Flop (didn't bet)
Seat 2: petrovichkag folded before Flop (didn't bet)
Seat 3: AleksCash (button) collected ($0.53)
Seat 4: DONTCALLME8 (small blind) folded before Flop
Seat 5: SickerGC (big blind) folded on the Flop
Seat 6: llosjone folded before Flop (didn't bet)



PokerStars Hand #222948627298:  Hold'em No Limit ($0.05/$0.10 USD) - 2021/01/23 4:27:54 ET
Table 'Capricorn II' 6-max Seat #4 is the button
Seat 1: AAA_set_nh ($10 in chips) 
Seat 2: petrovichkag ($18.80 in chips) 
Seat 3: AleksCash ($12.85 in chips) 
Seat 4: DONTCALLME8 ($10.75 in chips) 
Seat 5: SickerGC ($11.66 in chips) 
Seat 6: llosjone ($10 in chips) 
SickerGC: posts small blind $0.05
llosjone: posts big blind $0.10
*** HOLE CARDS ***
AAA_set_nh: raises $0.20 to $0.30
petrovichkag: folds 
AleksCash: raises $0.70 to $1
DONTCALLME8: raises $2.25 to $3.25
SickerGC: folds 
llosjone: folds 
AAA_set_nh: folds 
AleksCash: raises $9.60 to $12.85 and is all-in
DONTCALLME8: calls $7.50 and is all-in
Uncalled bet ($2.10) returned to AleksCash
*** FLOP *** [Ac 3c 5h]
*** TURN *** [Ac 3c 5h] [2c]
*** RIVER *** [Ac 3c 5h 2c] [9h]
*** SHOW DOWN ***
AleksCash: shows [Jd Jh] (a pair of Jacks)
DONTCALLME8: shows [Ks Kd] (a pair of Kings)
DONTCALLME8 collected $20.96 from pot
*** SUMMARY ***
Total pot $21.95 | Rake $0.99 
Board [Ac 3c 5h 2c 9h]
Seat 1: AAA_set_nh folded before Flop
Seat 2: petrovichkag folded before Flop (didn't bet)
Seat 3: AleksCash showed [Jd Jh] and lost with a pair of Jacks
Seat 4: DONTCALLME8 (button) showed [Ks Kd] and won ($20.96) with a pair of Kings
Seat 5: SickerGC (small blind) folded before Flop
Seat 6: llosjone (big blind) folded before Flop



PokerStars Hand #222948635721:  Hold'em No Limit ($0.05/$0.10 USD) - 2021/01/23 4:28:26 ET
Table 'Capricorn II' 6-max Seat #5 is the button
Seat 1: AAA_set_nh ($10 in chips) 
Seat 2: petrovichkag ($18.80 in chips) 
Seat 3: AleksCash ($10 in chips) 
Seat 4: DONTCALLME8 ($20.96 in chips) 
Seat 5: SickerGC ($11.61 in chips) 
Seat 6: llosjone ($9.90 in chips) 
llosjone: posts small blind $0.05
AAA_set_nh: posts big blind $0.10
*** HOLE CARDS ***
petrovichkag: folds 
AleksCash: raises $0.20 to $0.30
DONTCALLME8: folds 
SickerGC: calls $0.30
llosjone: folds 
AAA_set_nh: folds 
*** FLOP *** [9d 2h 5h]
AleksCash: checks 
SickerGC: checks 
*** TURN *** [9d 2h 5h] [3c]
AleksCash: checks 
SickerGC: bets $0.36
DONTCALLME8 is disconnected 
AleksCash: folds 
Uncalled bet ($0.36) returned to SickerGC
SickerGC collected $0.72 from pot
SickerGC: doesn't show hand 
*** SUMMARY ***
Total pot $0.75 | Rake $0.03 
Board [9d 2h 5h 3c]
Seat 1: AAA_set_nh (big blind) folded before Flop
Seat 2: petrovichkag folded before Flop (didn't bet)
Seat 3: AleksCash folded on the Turn
Seat 4: DONTCALLME8 folded before Flop (didn't bet)
Seat 5: SickerGC (button) collected ($0.72)
Seat 6: llosjone (small blind) folded before Flop



PokerStars Hand #222948644551:  Hold'em No Limit ($0.05/$0.10 USD) - 2021/01/23 4:28:59 ET
Table 'Capricorn II' 6-max Seat #6 is the button
Seat 1: AAA_set_nh ($10 in chips) 
Seat 2: petrovichkag ($18.80 in chips) 
Seat 3: AleksCash ($10 in chips) 
Seat 5: SickerGC ($12.03 in chips) 
Seat 6: llosjone ($9.85 in chips) 
AAA_set_nh: posts small blind $0.05
petrovichkag: posts big blind $0.10
*** HOLE CARDS ***
AleksCash: folds 
SickerGC: calls $0.10
llosjone: folds 
AAA_set_nh: raises $0.40 to $0.50
petrovichkag: folds 
SickerGC: calls $0.40
*** FLOP *** [Qh 4h 8s]
AAA_set_nh: bets $1.05
SickerGC: folds 
Uncalled bet ($1.05) returned to AAA_set_nh
AAA_set_nh collected $1.05 from pot
AAA_set_nh: doesn't show hand 
*** SUMMARY ***
Total pot $1.10 | Rake $0.05 
Board [Qh 4h 8s]
Seat 1: AAA_set_nh (small blind) collected ($1.05)
Seat 2: petrovichkag (big blind) folded before Flop
Seat 3: AleksCash folded before Flop (didn't bet)
Seat 5: SickerGC folded on the Flop
Seat 6: llosjone (button) folded before Flop (didn't bet)



PokerStars Hand #222948651511:  Hold'em No Limit ($0.05/$0.10 USD) - 2021/01/23 4:29:26 ET
Table 'Capricorn II' 6-max Seat #1 is the button
Seat 1: AAA_set_nh ($10.55 in chips) 
Seat 2: petrovichkag ($18.70 in chips) 
Seat 3: AleksCash ($10 in chips) 
Seat 5: SickerGC ($11.53 in chips) 
Seat 6: llosjone ($9.85 in chips) 
petrovichkag: posts small blind $0.05
AleksCash: posts big blind $0.10
*** HOLE CARDS ***
SickerGC: folds 
llosjone: folds 
AAA_set_nh: folds 
petrovichkag: folds 
Uncalled bet ($0.05) returned to AleksCash
AleksCash collected $0.10 from pot
AleksCash: doesn't show hand 
*** SUMMARY ***
Total pot $0.10 | Rake $0 
Seat 1: AAA_set_nh (button) folded before Flop (didn't bet)
Seat 2: petrovichkag (small blind) folded before Flop
Seat 3: AleksCash (big blind) collected ($0.10)
Seat 5: SickerGC folded before Flop (didn't bet)
Seat 6: llosjone folded before Flop (didn't bet)



PokerStars Hand #222948653395:  Hold'em No Limit ($0.05/$0.10 USD) - 2021/01/23 4:29:33 ET
Table 'Capricorn II' 6-max Seat #2 is the button
Seat 1: AAA_set_nh ($10.55 in chips) 
Seat 2: petrovichkag ($18.65 in chips) 
Seat 3: AleksCash ($10.05 in chips) 
Seat 5: SickerGC ($11.53 in chips) 
Seat 6: llosjone ($9.85 in chips) 
AleksCash: posts small blind $0.05
SickerGC: posts big blind $0.10
*** HOLE CARDS ***
llosjone: folds 
AAA_set_nh: folds 
petrovichkag: folds 
AleksCash: raises $0.15 to $0.25
SickerGC: folds 
Uncalled bet ($0.15) returned to AleksCash
AleksCash collected $0.20 from pot
AleksCash: doesn't show hand 
*** SUMMARY ***
Total pot $0.20 | Rake $0 
Seat 1: AAA_set_nh folded before Flop (didn't bet)
Seat 2: petrovichkag (button) folded before Flop (didn't bet)
Seat 3: AleksCash (small blind) collected ($0.20)
Seat 5: SickerGC (big blind) folded before Flop
Seat 6: llosjone folded before Flop (didn't bet)



PokerStars Hand #222948656451:  Hold'em No Limit ($0.05/$0.10 USD) - 2021/01/23 4:29:44 ET
Table 'Capricorn II' 6-max Seat #3 is the button
Seat 1: AAA_set_nh ($10.55 in chips) 
Seat 2: petrovichkag ($18.65 in chips) 
Seat 3: AleksCash ($10.15 in chips) 
Seat 5: SickerGC ($11.43 in chips) 
Seat 6: llosjone ($9.85 in chips) 
SickerGC: posts small blind $0.05
llosjone: posts big blind $0.10
*** HOLE CARDS ***
AAA_set_nh: folds 
petrovichkag: folds 
AleksCash: raises $0.15 to $0.25
SickerGC: raises $0.15 to $0.40
llosjone: folds 
AleksCash: calls $0.15
*** FLOP *** [7c 8c 2h]
SickerGC: bets $0.86
AleksCash: raises $8.89 to $9.75 and is all-in
SickerGC: calls $8.89
*** TURN *** [7c 8c 2h] [Jc]
*** RIVER *** [7c 8c 2h Jc] [6h]
*** SHOW DOWN ***
SickerGC: shows [As Ks] (high card Ace)
AleksCash: shows [9c Ac] (a flush, Ace high)
AleksCash collected $19.48 from pot
*** SUMMARY ***
Total pot $20.40 | Rake $0.92 
Board [7c 8c 2h Jc 6h]
Seat 1: AAA_set_nh folded before Flop (didn't bet)
Seat 2: petrovichkag folded before Flop (didn't bet)
Seat 3: AleksCash (button) showed [9c Ac] and won ($19.48) with a flush, Ace high
Seat 5: SickerGC (small blind) showed [As Ks] and lost with high card Ace
Seat 6: llosjone (big blind) folded before Flop



PokerStars Hand #222948663872:  Hold'em No Limit ($0.05/$0.10 USD) - 2021/01/23 4:30:12 ET
Table 'Capricorn II' 6-max Seat #5 is the button
Seat 1: AAA_set_nh ($10.55 in chips) 
Seat 2: petrovichkag ($18.65 in chips) 
Seat 3: AleksCash ($19.48 in chips) 
Seat 5: SickerGC ($1.28 in chips) 
Seat 6: llosjone ($9.75 in chips) 
llosjone: posts small blind $0.05
AAA_set_nh: posts big blind $0.10
*** HOLE CARDS ***
petrovichkag: folds 
AleksCash: folds 
SickerGC: raises $1.18 to $1.28 and is all-in
llosjone: folds 
AAA_set_nh: folds 
Uncalled bet ($1.18) returned to SickerGC
SickerGC collected $0.25 from pot
SickerGC: doesn't show hand 
*** SUMMARY ***
Total pot $0.25 | Rake $0 
Seat 1: AAA_set_nh (big blind) folded before Flop
Seat 2: petrovichkag folded before Flop (didn't bet)
Seat 3: AleksCash folded before Flop (didn't bet)
Seat 5: SickerGC (button) collected ($0.25)
Seat 6: llosjone (small blind) folded before Flop



PokerStars Hand #222948666342:  Hold'em No Limit ($0.05/$0.10 USD) - 2021/01/23 4:30:21 ET
Table 'Capricorn II' 6-max Seat #6 is the button
Seat 1: AAA_set_nh ($10.45 in chips) 
Seat 2: petrovichkag ($18.65 in chips) 
Seat 3: AleksCash ($19.48 in chips) 
Seat 5: SickerGC ($1.43 in chips) 
Seat 6: llosjone ($9.70 in chips) 
AAA_set_nh: posts small blind $0.05
petrovichkag: posts big blind $0.10
*** HOLE CARDS ***
AleksCash: folds 
SickerGC: folds 
llosjone: raises $0.15 to $0.25
AAA_set_nh: folds 
petrovichkag: calls $0.15
*** FLOP *** [2d 8s Kh]
petrovichkag: checks 
llosjone: checks 
*** TURN *** [2d 8s Kh] [3d]
petrovichkag: checks 
llosjone: checks 
*** RIVER *** [2d 8s Kh 3d] [3s]
petrovichkag: checks 
llosjone: checks 
*** SHOW DOWN ***
petrovichkag: shows [As 6c] (a pair of Threes)
llosjone: mucks hand 
petrovichkag collected $0.53 from pot
*** SUMMARY ***
Total pot $0.55 | Rake $0.02 
Board [2d 8s Kh 3d 3s]
Seat 1: AAA_set_nh (small blind) folded before Flop
Seat 2: petrovichkag (big blind) showed [As 6c] and won ($0.53) with a pair of Threes
Seat 3: AleksCash folded before Flop (didn't bet)
Seat 5: SickerGC folded before Flop (didn't bet)
Seat 6: llosjone (button) mucked



PokerStars Hand #222948673044:  Hold'em No Limit ($0.05/$0.10 USD) - 2021/01/23 4:30:46 ET
Table 'Capricorn II' 6-max Seat #1 is the button
Seat 1: AAA_set_nh ($10.40 in chips) 
Seat 2: petrovichkag ($18.93 in chips) 
Seat 3: AleksCash ($19.48 in chips) 
Seat 5: SickerGC ($1.43 in chips) 
Seat 6: llosjone ($9.45 in chips) 
petrovichkag: posts small blind $0.05
AleksCash: posts big blind $0.10
*** HOLE CARDS ***
SickerGC: raises $1.33 to $1.43 and is all-in
llosjone: folds 
AAA_set_nh: folds 
petrovichkag: folds 
AleksCash: calls $1.33
*** FLOP *** [Ad Tc 8s]
*** TURN *** [Ad Tc 8s] [Qd]
*** RIVER *** [Ad Tc 8s Qd] [6h]
*** SHOW DOWN ***
AleksCash: shows [3h 3s] (a pair of Threes)
SickerGC: shows [Kc Kd] (a pair of Kings)
SickerGC collected $2.78 from pot
*** SUMMARY ***
Total pot $2.91 | Rake $0.13 
Board [Ad Tc 8s Qd 6h]
Seat 1: AAA_set_nh (button) folded before Flop (didn't bet)
Seat 2: petrovichkag (small blind) folded before Flop
Seat 3: AleksCash (big blind) showed [3h 3s] and lost with a pair of Threes
Seat 5: SickerGC showed [Kc Kd] and won ($2.78) with a pair of Kings
Seat 6: llosjone folded before Flop (didn't bet)



PokerStars Hand #222948677569:  Hold'em No Limit ($0.05/$0.10 USD) - 2021/01/23 4:31:03 ET
Table 'Capricorn II' 6-max Seat #2 is the button
Seat 1: AAA_set_nh ($10.40 in chips) 
Seat 2: petrovichkag ($18.88 in chips) 
Seat 3: AleksCash ($18.05 in chips) 
Seat 5: SickerGC ($2.78 in chips) 
Seat 6: llosjone ($9.45 in chips) 
AleksCash: posts small blind $0.05
SickerGC: posts big blind $0.10
*** HOLE CARDS ***
llosjone: folds 
AAA_set_nh: raises $0.20 to $0.30
petrovichkag: folds 
AleksCash: calls $0.25
SickerGC: folds 
*** FLOP *** [5h 2d 7h]
AleksCash: checks 
AAA_set_nh: checks 
*** TURN *** [5h 2d 7h] [Jh]
AleksCash: bets $0.45
AAA_set_nh: calls $0.45
*** RIVER *** [5h 2d 7h Jh] [5c]
AleksCash: bets $17.30 and is all-in
AAA_set_nh: folds 
Uncalled bet ($17.30) returned to AleksCash
AleksCash collected $1.53 from pot
AleksCash: doesn't show hand 
*** SUMMARY ***
Total pot $1.60 | Rake $0.07 
Board [5h 2d 7h Jh 5c]
Seat 1: AAA_set_nh folded on the River
Seat 2: petrovichkag (button) folded before Flop (didn't bet)
Seat 3: AleksCash (small blind) collected ($1.53)
Seat 5: SickerGC (big blind) folded before Flop
Seat 6: llosjone folded before Flop (didn't bet)



PokerStars Hand #222948685135:  Hold'em No Limit ($0.05/$0.10 USD) - 2021/01/23 4:31:31 ET
Table 'Capricorn II' 6-max Seat #3 is the button
Seat 1: AAA_set_nh ($10 in chips) 
Seat 2: petrovichkag ($18.88 in chips) 
Seat 3: AleksCash ($18.83 in chips) 
Seat 5: SickerGC ($2.68 in chips) 
Seat 6: llosjone ($9.45 in chips) 
SickerGC: posts small blind $0.05
llosjone: posts big blind $0.10
*** HOLE CARDS ***
AAA_set_nh: folds 
petrovichkag: folds 
AleksCash: folds 
SickerGC: calls $0.05
llosjone: checks 
*** FLOP *** [8c Jh Ad]
SickerGC: checks 
llosjone: checks 
*** TURN *** [8c Jh Ad] [8s]
SickerGC: checks 
llosjone: checks 
*** RIVER *** [8c Jh Ad 8s] [4s]
SickerGC: checks 
llosjone: checks 
*** SHOW DOWN ***
SickerGC: shows [5d Ks] (a pair of Eights)
llosjone: mucks hand 
SickerGC collected $0.19 from pot
*** SUMMARY ***
Total pot $0.20 | Rake $0.01 
Board [8c Jh Ad 8s 4s]
Seat 1: AAA_set_nh folded before Flop (didn't bet)
Seat 2: petrovichkag folded before Flop (didn't bet)
Seat 3: AleksCash (button) folded before Flop (didn't bet)
Seat 5: SickerGC (small blind) showed [5d Ks] and won ($0.19) with a pair of Eights
Seat 6: llosjone (big blind) mucked



PokerStars Hand #222948692512:  Hold'em No Limit ($0.05/$0.10 USD) - 2021/01/23 4:31:59 ET
Table 'Capricorn II' 6-max Seat #5 is the button
Seat 1: AAA_set_nh ($10 in chips) 
Seat 2: petrovichkag ($18.88 in chips) 
Seat 3: AleksCash ($18.83 in chips) 
Seat 5: SickerGC ($2.77 in chips) 
Seat 6: llosjone ($9.35 in chips) 
llosjone: posts small blind $0.05
AAA_set_nh: posts big blind $0.10
*** HOLE CARDS ***
petrovichkag: folds 
AleksCash: raises $0.20 to $0.30
SickerGC: folds 
llosjone: folds 
AAA_set_nh: folds 
Uncalled bet ($0.20) returned to AleksCash
AleksCash collected $0.25 from pot
AleksCash: doesn't show hand 
*** SUMMARY ***
Total pot $0.25 | Rake $0 
Seat 1: AAA_set_nh (big blind) folded before Flop
Seat 2: petrovichkag folded before Flop (didn't bet)
Seat 3: AleksCash collected ($0.25)
Seat 5: SickerGC (button) folded before Flop (didn't bet)
Seat 6: llosjone (small blind) folded before Flop



PokerStars Hand #222948695622:  Hold'em No Limit ($0.05/$0.10 USD) - 2021/01/23 4:32:11 ET
Table 'Capricorn II' 6-max Seat #6 is the button
Seat 1: AAA_set_nh ($10 in chips) 
Seat 2: petrovichkag ($18.88 in chips) 
Seat 3: AleksCash ($18.98 in chips) 
Seat 5: SickerGC ($2.77 in chips) 
Seat 6: llosjone ($9.30 in chips) 
AAA_set_nh: posts small blind $0.05
petrovichkag: posts big blind $0.10
*** HOLE CARDS ***
AleksCash: folds 
SickerGC: folds 
llosjone: folds 
AAA_set_nh: folds 
Uncalled bet ($0.05) returned to petrovichkag
petrovichkag collected $0.10 from pot
petrovichkag: doesn't show hand 
*** SUMMARY ***
Total pot $0.10 | Rake $0 
Seat 1: AAA_set_nh (small blind) folded before Flop
Seat 2: petrovichkag (big blind) collected ($0.10)
Seat 3: AleksCash folded before Flop (didn't bet)
Seat 5: SickerGC folded before Flop (didn't bet)
Seat 6: llosjone (button) folded before Flop (didn't bet)



PokerStars Hand #222948697838:  Hold'em No Limit ($0.05/$0.10 USD) - 2021/01/23 4:32:19 ET
Table 'Capricorn II' 6-max Seat #1 is the button
Seat 1: AAA_set_nh ($10 in chips) 
Seat 2: petrovichkag ($18.93 in chips) 
Seat 3: AleksCash ($18.98 in chips) 
Seat 5: SickerGC ($2.77 in chips) 
Seat 6: llosjone ($9.30 in chips) 
petrovichkag: posts small blind $0.05
AleksCash: posts big blind $0.10
*** HOLE CARDS ***
SickerGC: folds 
llosjone: raises $0.15 to $0.25
AAA_set_nh: folds 
petrovichkag: calls $0.20
AleksCash: folds 
*** FLOP *** [9c 7h 2h]
petrovichkag: checks 
llosjone: bets $0.19
petrovichkag: folds 
Uncalled bet ($0.19) returned to llosjone
llosjone collected $0.57 from pot
llosjone: doesn't show hand 
*** SUMMARY ***
Total pot $0.60 | Rake $0.03 
Board [9c 7h 2h]
Seat 1: AAA_set_nh (button) folded before Flop (didn't bet)
Seat 2: petrovichkag (small blind) folded on the Flop
Seat 3: AleksCash (big blind) folded before Flop
Seat 5: SickerGC folded before Flop (didn't bet)
Seat 6: llosjone collected ($0.57)



PokerStars Hand #222948702953:  Hold'em No Limit ($0.05/$0.10 USD) - 2021/01/23 4:32:39 ET
Table 'Capricorn II' 6-max Seat #2 is the button
Seat 1: AAA_set_nh ($10 in chips) 
Seat 2: petrovichkag ($18.68 in chips) 
Seat 3: AleksCash ($18.88 in chips) 
Seat 5: SickerGC ($2.77 in chips) 
Seat 6: llosjone ($9.62 in chips) 
AleksCash: posts small blind $0.05
SickerGC: posts big blind $0.10
*** HOLE CARDS ***
llosjone: raises $0.15 to $0.25
AAA_set_nh: folds 
petrovichkag: folds 
AleksCash: folds 
SickerGC: raises $2.52 to $2.77 and is all-in
llosjone: calls $2.52
*** FLOP *** [Qh 2d 3s]
*** TURN *** [Qh 2d 3s] [7h]
*** RIVER *** [Qh 2d 3s 7h] [Ts]
*** SHOW DOWN ***
SickerGC: shows [Jc Ah] (high card Ace)
llosjone: shows [Th Kh] (a pair of Tens)
llosjone collected $5.34 from pot
*** SUMMARY ***
Total pot $5.59 | Rake $0.25 
Board [Qh 2d 3s 7h Ts]
Seat 1: AAA_set_nh folded before Flop (didn't bet)
Seat 2: petrovichkag (button) folded before Flop (didn't bet)
Seat 3: AleksCash (small blind) folded before Flop
Seat 5: SickerGC (big blind) showed [Jc Ah] and lost with high card Ace
Seat 6: llosjone showed [Th Kh] and won ($5.34) with a pair of Tens



PokerStars Hand #222948708201:  Hold'em No Limit ($0.05/$0.10 USD) - 2021/01/23 4:32:58 ET
Table 'Capricorn II' 6-max Seat #3 is the button
Seat 1: AAA_set_nh ($10 in chips) 
Seat 2: petrovichkag ($18.68 in chips) 
Seat 3: AleksCash ($18.83 in chips) 
Seat 6: llosjone ($12.19 in chips) 
llosjone: posts small blind $0.05
AAA_set_nh: posts big blind $0.10
*** HOLE CARDS ***
petrovichkag: folds 
AleksCash: folds 
SickerGC leaves the table
llosjone: raises $0.15 to $0.25
AAA_set_nh: raises $0.65 to $0.90
llosjone: folds 
Uncalled bet ($0.65) returned to AAA_set_nh
AAA_set_nh collected $0.50 from pot
AAA_set_nh: doesn't show hand 
*** SUMMARY ***
Total pot $0.50 | Rake $0 
Seat 1: AAA_set_nh (big blind) collected ($0.50)
Seat 2: petrovichkag folded before Flop (didn't bet)
Seat 3: AleksCash (button) folded before Flop (didn't bet)
Seat 6: llosjone (small blind) folded before Flop



PokerStars Hand #222948714147:  Hold'em No Limit ($0.05/$0.10 USD) - 2021/01/23 4:33:21 ET
Table 'Capricorn II' 6-max Seat #6 is the button
Seat 1: AAA_set_nh ($10.25 in chips) 
Seat 2: petrovichkag ($18.68 in chips) 
Seat 3: AleksCash ($18.83 in chips) 
Seat 6: llosjone ($11.94 in chips) 
AAA_set_nh: posts small blind $0.05
petrovichkag: posts big blind $0.10
*** HOLE CARDS ***
ricokovac7 joins the table at seat #5 
AleksCash: folds 
llosjone: folds 
AAA_set_nh: raises $0.20 to $0.30
petrovichkag: folds 
Uncalled bet ($0.20) returned to AAA_set_nh
AAA_set_nh collected $0.20 from pot
AAA_set_nh: doesn't show hand 
*** SUMMARY ***
Total pot $0.20 | Rake $0 
Seat 1: AAA_set_nh (small blind) collected ($0.20)
Seat 2: petrovichkag (big blind) folded before Flop
Seat 3: AleksCash folded before Flop (didn't bet)
Seat 6: llosjone (button) folded before Flop (didn't bet)



PokerStars Hand #222948716269:  Hold'em No Limit ($0.05/$0.10 USD) - 2021/01/23 4:33:29 ET
Table 'Capricorn II' 6-max Seat #1 is the button
Seat 1: AAA_set_nh ($10.35 in chips) 
Seat 2: petrovichkag ($18.58 in chips) 
Seat 3: AleksCash ($18.83 in chips) 
Seat 6: llosjone ($11.94 in chips) 
petrovichkag: posts small blind $0.05
AleksCash: posts big blind $0.10
ricokovac7: sits out 
*** HOLE CARDS ***
llosjone: folds 
AAA_set_nh: folds 
petrovichkag: folds 
Uncalled bet ($0.05) returned to AleksCash
AleksCash collected $0.10 from pot
AleksCash: doesn't show hand 
*** SUMMARY ***
Total pot $0.10 | Rake $0 
Seat 1: AAA_set_nh (button) folded before Flop (didn't bet)
Seat 2: petrovichkag (small blind) folded before Flop
Seat 3: AleksCash (big blind) collected ($0.10)
Seat 6: llosjone folded before Flop (didn't bet)



PokerStars Hand #222948718495:  Hold'em No Limit ($0.05/$0.10 USD) - 2021/01/23 4:33:37 ET
Table 'Capricorn II' 6-max Seat #2 is the button
Seat 1: AAA_set_nh ($10.35 in chips) 
Seat 2: petrovichkag ($18.53 in chips) 
Seat 3: AleksCash ($18.88 in chips) 
Seat 5: ricokovac7 ($10 in chips) 
Seat 6: llosjone ($11.94 in chips) 
AleksCash: posts small blind $0.05
ricokovac7: posts big blind $0.10
*** HOLE CARDS ***
llosjone: raises $0.10 to $0.20
AAA_set_nh: folds 
petrovichkag: folds 
AleksCash: folds 
ricokovac7: calls $0.10
*** FLOP *** [3s 5s 2d]
ricokovac7: checks 
llosjone: bets $0.14
ricokovac7: folds 
Uncalled bet ($0.14) returned to llosjone
llosjone collected $0.43 from pot
DONTCALLME8 was removed from the table for failing to post
DONTCALLME8 leaves the table
llosjone: doesn't show hand 
*** SUMMARY ***
Total pot $0.45 | Rake $0.02 
Board [3s 5s 2d]
Seat 1: AAA_set_nh folded before Flop (didn't bet)
Seat 2: petrovichkag (button) folded before Flop (didn't bet)
Seat 3: AleksCash (small blind) folded before Flop
Seat 5: ricokovac7 (big blind) folded on the Flop
Seat 6: llosjone collected ($0.43)



PokerStars Hand #222948727975:  Hold'em No Limit ($0.05/$0.10 USD) - 2021/01/23 4:34:12 ET
Table 'Capricorn II' 6-max Seat #3 is the button
Seat 1: AAA_set_nh ($10.35 in chips) 
Seat 2: petrovichkag ($18.53 in chips) 
Seat 3: AleksCash ($18.83 in chips) 
Seat 5: ricokovac7 ($9.80 in chips) 
Seat 6: llosjone ($12.17 in chips) 
ricokovac7: posts small blind $0.05
llosjone: posts big blind $0.10
*** HOLE CARDS ***
Sabali420 joins the table at seat #4 
AAA_set_nh: folds 
petrovichkag: folds 
AleksCash: folds 
ricokovac7: calls $0.05
llosjone: checks 
*** FLOP *** [9d Ah 9h]
ricokovac7: checks 
llosjone: checks 
*** TURN *** [9d Ah 9h] [8h]
ricokovac7: folds 
llosjone collected $0.19 from pot
llosjone: doesn't show hand 
*** SUMMARY ***
Total pot $0.20 | Rake $0.01 
Board [9d Ah 9h 8h]
Seat 1: AAA_set_nh folded before Flop (didn't bet)
Seat 2: petrovichkag folded before Flop (didn't bet)
Seat 3: AleksCash (button) folded before Flop (didn't bet)
Seat 5: ricokovac7 (small blind) folded on the Turn
Seat 6: llosjone (big blind) collected ($0.19)



PokerStars Hand #222948737052:  Hold'em No Limit ($0.05/$0.10 USD) - 2021/01/23 4:34:46 ET
Table 'Capricorn II' 6-max Seat #5 is the button
Seat 1: AAA_set_nh ($10.35 in chips) 
Seat 2: petrovichkag ($18.53 in chips) 
Seat 3: AleksCash ($18.83 in chips) 
Seat 5: ricokovac7 ($9.70 in chips) 
Seat 6: llosjone ($12.26 in chips) 
llosjone: posts small blind $0.05
AAA_set_nh: posts big blind $0.10
Sabali420: sits out 
*** HOLE CARDS ***
petrovichkag: folds 
AleksCash: folds 
ricokovac7: calls $0.10
llosjone: folds 
AAA_set_nh: checks 
*** FLOP *** [6d As 7d]
AAA_set_nh: bets $0.24
ricokovac7: folds 
Uncalled bet ($0.24) returned to AAA_set_nh
ricokovac7 leaves the table
AAA_set_nh collected $0.24 from pot
AAA_set_nh: doesn't show hand 
*** SUMMARY ***
Total pot $0.25 | Rake $0.01 
Board [6d As 7d]
Seat 1: AAA_set_nh (big blind) collected ($0.24)
Seat 2: petrovichkag folded before Flop (didn't bet)
Seat 3: AleksCash folded before Flop (didn't bet)
Seat 5: ricokovac7 (button) folded on the Flop
Seat 6: llosjone (small blind) folded before Flop



PokerStars Hand #222948741286:  Hold'em No Limit ($0.05/$0.10 USD) - 2021/01/23 4:35:02 ET
Table 'Capricorn II' 6-max Seat #6 is the button
Seat 1: AAA_set_nh ($10.49 in chips) 
Seat 2: petrovichkag ($18.53 in chips) 
Seat 3: AleksCash ($18.83 in chips) 
Seat 4: Sabali420 ($10 in chips) 
Seat 6: llosjone ($12.21 in chips) 
AAA_set_nh: posts small blind $0.05
petrovichkag: posts big blind $0.10
Sabali420: posts big blind $0.10
*** HOLE CARDS ***
fralex79 joins the table at seat #5 
AleksCash: folds 
Sabali420: raises $0.30 to $0.40
llosjone: calls $0.40
AAA_set_nh: folds 
petrovichkag: folds 
*** FLOP *** [3s Jh 4d]
Sabali420: checks 
llosjone: checks 
*** TURN *** [3s Jh 4d] [6h]
Sabali420: checks 
llosjone: bets $0.39
Sabali420: calls $0.39
*** RIVER *** [3s Jh 4d 6h] [4s]
Sabali420: checks 
llosjone: checks 
*** SHOW DOWN ***
Sabali420: shows [Ac Kc] (a pair of Fours)
llosjone: mucks hand 
Sabali420 collected $1.65 from pot
*** SUMMARY ***
Total pot $1.73 | Rake $0.08 
Board [3s Jh 4d 6h 4s]
Seat 1: AAA_set_nh (small blind) folded before Flop
Seat 2: petrovichkag (big blind) folded before Flop
Seat 3: AleksCash folded before Flop (didn't bet)
Seat 4: Sabali420 showed [Ac Kc] and won ($1.65) with a pair of Fours
Seat 6: llosjone (button) mucked



PokerStars Hand #222948750070:  Hold'em No Limit ($0.05/$0.10 USD) - 2021/01/23 4:35:35 ET
Table 'Capricorn II' 6-max Seat #1 is the button
Seat 1: AAA_set_nh ($10.44 in chips) 
Seat 2: petrovichkag ($18.43 in chips) 
Seat 3: AleksCash ($18.83 in chips) 
Seat 4: Sabali420 ($10.86 in chips) 
Seat 6: llosjone ($11.42 in chips) 
petrovichkag: posts small blind $0.05
AleksCash: posts big blind $0.10
fralex79: sits out 
*** HOLE CARDS ***
Sabali420: calls $0.10
llosjone: folds 
AAA_set_nh: folds 
petrovichkag: folds 
AleksCash: raises $0.40 to $0.50
Sabali420: folds 
Uncalled bet ($0.40) returned to AleksCash
AleksCash collected $0.25 from pot
AleksCash: doesn't show hand 
*** SUMMARY ***
Total pot $0.25 | Rake $0 
Seat 1: AAA_set_nh (button) folded before Flop (didn't bet)
Seat 2: petrovichkag (small blind) folded before Flop
Seat 3: AleksCash (big blind) collected ($0.25)
Seat 4: Sabali420 folded before Flop
Seat 6: llosjone folded before Flop (didn't bet)



PokerStars Hand #222948755001:  Hold'em No Limit ($0.05/$0.10 USD) - 2021/01/23 4:35:53 ET
Table 'Capricorn II' 6-max Seat #2 is the button
Seat 1: AAA_set_nh ($10.44 in chips) 
Seat 2: petrovichkag ($18.38 in chips) 
Seat 3: AleksCash ($18.98 in chips) 
Seat 4: Sabali420 ($10.76 in chips) 
Seat 6: llosjone ($11.42 in chips) 
AleksCash: posts small blind $0.05
Sabali420: posts big blind $0.10
fralex79: sits out 
*** HOLE CARDS ***
llosjone: folds 
AAA_set_nh: raises $0.15 to $0.25
petrovichkag: folds 
AleksCash: folds 
Sabali420: folds 
Uncalled bet ($0.15) returned to AAA_set_nh
AAA_set_nh collected $0.25 from pot
AAA_set_nh: doesn't show hand 
*** SUMMARY ***
Total pot $0.25 | Rake $0 
Seat 1: AAA_set_nh collected ($0.25)
Seat 2: petrovichkag (button) folded before Flop (didn't bet)
Seat 3: AleksCash (small blind) folded before Flop
Seat 4: Sabali420 (big blind) folded before Flop
Seat 6: llosjone folded before Flop (didn't bet)



PokerStars Hand #222948761602:  Hold'em No Limit ($0.05/$0.10 USD) - 2021/01/23 4:36:18 ET
Table 'Capricorn II' 6-max Seat #3 is the button
Seat 1: AAA_set_nh ($10.59 in chips) 
Seat 2: petrovichkag ($18.38 in chips) 
Seat 3: AleksCash ($18.93 in chips) 
Seat 4: Sabali420 ($10.66 in chips) 
Seat 5: fralex79 ($4 in chips) 
Seat 6: llosjone ($11.42 in chips) 
Sabali420: posts small blind $0.05
fralex79: posts big blind $0.10
*** HOLE CARDS ***
llosjone: folds 
AAA_set_nh: folds 
petrovichkag: folds 
AleksCash: folds 
Sabali420: raises $0.20 to $0.30
fralex79: folds 
Uncalled bet ($0.20) returned to Sabali420
Sabali420 collected $0.20 from pot
Sabali420: doesn't show hand 
*** SUMMARY ***
Total pot $0.20 | Rake $0 
Seat 1: AAA_set_nh folded before Flop (didn't bet)
Seat 2: petrovichkag folded before Flop (didn't bet)
Seat 3: AleksCash (button) folded before Flop (didn't bet)
Seat 4: Sabali420 (small blind) collected ($0.20)
Seat 5: fralex79 (big blind) folded before Flop
Seat 6: llosjone folded before Flop (didn't bet)



PokerStars Hand #222948767659:  Hold'em No Limit ($0.05/$0.10 USD) - 2021/01/23 4:36:40 ET
Table 'Capricorn II' 6-max Seat #4 is the button
Seat 1: AAA_set_nh ($10.59 in chips) 
Seat 2: petrovichkag ($18.38 in chips) 
Seat 3: AleksCash ($18.93 in chips) 
Seat 4: Sabali420 ($10.76 in chips) 
Seat 5: fralex79 ($3.90 in chips) 
Seat 6: llosjone ($11.42 in chips) 
fralex79: posts small blind $0.05
llosjone: posts big blind $0.10
*** HOLE CARDS ***
AAA_set_nh: raises $0.20 to $0.30
petrovichkag: folds 
AleksCash: folds 
Sabali420: folds 
fralex79: calls $0.25
llosjone: calls $0.20
*** FLOP *** [Kh 8h Td]
fralex79: checks 
llosjone: checks 
AAA_set_nh: checks 
*** TURN *** [Kh 8h Td] [Th]
fralex79: bets $0.20
llosjone: folds 
AAA_set_nh: folds 
Uncalled bet ($0.20) returned to fralex79
fralex79 collected $0.86 from pot
fralex79: doesn't show hand 
*** SUMMARY ***
Total pot $0.90 | Rake $0.04 
Board [Kh 8h Td Th]
Seat 1: AAA_set_nh folded on the Turn
Seat 2: petrovichkag folded before Flop (didn't bet)
Seat 3: AleksCash folded before Flop (didn't bet)
Seat 4: Sabali420 (button) folded before Flop (didn't bet)
Seat 5: fralex79 (small blind) collected ($0.86)
Seat 6: llosjone (big blind) folded on the Turn



PokerStars Hand #222948784524:  Hold'em No Limit ($0.05/$0.10 USD) - 2021/01/23 4:37:42 ET
Table 'Capricorn II' 6-max Seat #6 is the button
Seat 1: AAA_set_nh ($10.19 in chips) 
Seat 4: Sabali420 ($10.76 in chips) 
Seat 5: fralex79 ($4.60 in chips) 
Seat 6: llosjone ($11.07 in chips) 
AAA_set_nh: posts small blind $0.05
petrovichkag: is sitting out 
AleksCash: is sitting out 
petrovichkag leaves the table
Sabali420: posts big blind $0.10
*** HOLE CARDS ***
fralex79: folds 
llosjone: folds 
AAA_set_nh: folds 
Uncalled bet ($0.05) returned to Sabali420
Sabali420 collected $0.10 from pot
Sabali420: doesn't show hand 
*** SUMMARY ***
Total pot $0.10 | Rake $0 
Seat 1: AAA_set_nh (small blind) folded before Flop
Seat 4: Sabali420 (big blind) collected ($0.10)
Seat 5: fralex79 folded before Flop (didn't bet)
Seat 6: llosjone (button) folded before Flop (didn't bet)



PokerStars Hand #222948786509:  Hold'em No Limit ($0.05/$0.10 USD) - 2021/01/23 4:37:49 ET
Table 'Capricorn II' 6-max Seat #1 is the button
Seat 1: AAA_set_nh ($10.14 in chips) 
Seat 4: Sabali420 ($10.81 in chips) 
Seat 5: fralex79 ($4.60 in chips) 
Seat 6: llosjone ($11.07 in chips) 
Sabali420: posts small blind $0.05
fralex79: posts big blind $0.10
*** HOLE CARDS ***
llosjone: folds 
AAA_set_nh: raises $0.20 to $0.30
cruxua joins the table at seat #2 
Sabali420: folds 
fralex79: calls $0.20
*** FLOP *** [9d 6c 7s]
AleksCash leaves the table
fralex79: checks 
AAA_set_nh: checks 
*** TURN *** [9d 6c 7s] [8d]
fralex79: bets $0.10
AAA_set_nh: calls $0.10
*** RIVER *** [9d 6c 7s 8d] [Jh]
fralex79: bets $0.10
AAA_set_nh: calls $0.10
*** SHOW DOWN ***
fralex79: shows [7h 5h] (a straight, Five to Nine)
AAA_set_nh: mucks hand 
fralex79 collected $1 from pot
*** SUMMARY ***
Total pot $1.05 | Rake $0.05 
Board [9d 6c 7s 8d Jh]
Seat 1: AAA_set_nh (button) mucked
Seat 4: Sabali420 (small blind) folded before Flop
Seat 5: fralex79 (big blind) showed [7h 5h] and won ($1) with a straight, Five to Nine
Seat 6: llosjone folded before Flop (didn't bet)



PokerStars Hand #222948792477:  Hold'em No Limit ($0.05/$0.10 USD) - 2021/01/23 4:38:12 ET
Table 'Capricorn II' 6-max Seat #4 is the button
Seat 1: AAA_set_nh ($10 in chips) 
Seat 4: Sabali420 ($10.76 in chips) 
Seat 5: fralex79 ($5.10 in chips) 
Seat 6: llosjone ($11.07 in chips) 
fralex79: posts small blind $0.05
llosjone: posts big blind $0.10
cruxua: sits out 
*** HOLE CARDS ***
buradin de joins the table at seat #3 
AAA_set_nh: folds 
Sabali420: raises $0.20 to $0.30
fralex79: folds 
llosjone: folds 
Uncalled bet ($0.20) returned to Sabali420
Sabali420 collected $0.25 from pot
Sabali420: doesn't show hand 
*** SUMMARY ***
Total pot $0.25 | Rake $0 
Seat 1: AAA_set_nh folded before Flop (didn't bet)
Seat 4: Sabali420 (button) collected ($0.25)
Seat 5: fralex79 (small blind) folded before Flop
Seat 6: llosjone (big blind) folded before Flop



PokerStars Hand #222948795613:  Hold'em No Limit ($0.05/$0.10 USD) - 2021/01/23 4:38:23 ET
Table 'Capricorn II' 6-max Seat #5 is the button
Seat 1: AAA_set_nh ($10 in chips) 
Seat 4: Sabali420 ($10.91 in chips) 
Seat 5: fralex79 ($5.05 in chips) 
Seat 6: llosjone ($10.97 in chips) 
llosjone: posts small blind $0.05
AAA_set_nh: posts big blind $0.10
cruxua: sits out 
buradin de: sits out 
*** HOLE CARDS ***
Sabali420: folds 
fralex79: folds 
llosjone: folds 
Uncalled bet ($0.05) returned to AAA_set_nh
AAA_set_nh collected $0.10 from pot
AAA_set_nh: doesn't show hand 
*** SUMMARY ***
Total pot $0.10 | Rake $0 
Seat 1: AAA_set_nh (big blind) collected ($0.10)
Seat 4: Sabali420 folded before Flop (didn't bet)
Seat 5: fralex79 (button) folded before Flop (didn't bet)
Seat 6: llosjone (small blind) folded before Flop



PokerStars Hand #222948797893:  Hold'em No Limit ($0.05/$0.10 USD) - 2021/01/23 4:38:32 ET
Table 'Capricorn II' 6-max Seat #6 is the button
Seat 1: AAA_set_nh ($10.05 in chips) 
Seat 2: cruxua ($10 in chips) 
Seat 4: Sabali420 ($10.91 in chips) 
Seat 5: fralex79 ($5.05 in chips) 
Seat 6: llosjone ($10.92 in chips) 
AAA_set_nh: posts small blind $0.05
cruxua: posts big blind $0.10
buradin de: sits out 
*** HOLE CARDS ***
Sabali420: folds 
fralex79: calls $0.10
llosjone has timed out
llosjone: folds 
AAA_set_nh: folds 
cruxua: checks 
*** FLOP *** [Ah 9s 4h]
cruxua: checks 
fralex79: bets $0.10
cruxua: folds 
Uncalled bet ($0.10) returned to fralex79
fralex79 collected $0.24 from pot
fralex79: doesn't show hand 
*** SUMMARY ***
Total pot $0.25 | Rake $0.01 
Board [Ah 9s 4h]
Seat 1: AAA_set_nh (small blind) folded before Flop
Seat 2: cruxua (big blind) folded on the Flop
Seat 4: Sabali420 folded before Flop (didn't bet)
Seat 5: fralex79 collected ($0.24)
Seat 6: llosjone (button) folded before Flop (didn't bet)



PokerStars Hand #222948807246:  Hold'em No Limit ($0.05/$0.10 USD) - 2021/01/23 4:39:06 ET
Table 'Capricorn II' 6-max Seat #1 is the button
Seat 1: AAA_set_nh ($10 in chips) 
Seat 2: cruxua ($10 in chips) 
Seat 3: buradin de ($10 in chips) 
Seat 4: Sabali420 ($10.91 in chips) 
Seat 5: fralex79 ($5.19 in chips) 
Seat 6: llosjone ($10.92 in chips) 
cruxua: posts small blind $0.05
buradin de: posts big blind $0.10
*** HOLE CARDS ***
Sabali420: folds 
fralex79: folds 
llosjone: folds 
AAA_set_nh: folds 
cruxua: folds 
Uncalled bet ($0.05) returned to buradin de
buradin de collected $0.10 from pot
buradin de: doesn't show hand 
*** SUMMARY ***
Total pot $0.10 | Rake $0 
Seat 1: AAA_set_nh (button) folded before Flop (didn't bet)
Seat 2: cruxua (small blind) folded before Flop
Seat 3: buradin de (big blind) collected ($0.10)
Seat 4: Sabali420 folded before Flop (didn't bet)
Seat 5: fralex79 folded before Flop (didn't bet)
Seat 6: llosjone folded before Flop (didn't bet)



PokerStars Hand #222948809334:  Hold'em No Limit ($0.05/$0.10 USD) - 2021/01/23 4:39:14 ET
Table 'Capricorn II' 6-max Seat #2 is the button
Seat 1: AAA_set_nh ($10 in chips) 
Seat 2: cruxua ($10 in chips) 
Seat 3: buradin de ($10.05 in chips) 
Seat 4: Sabali420 ($10.91 in chips) 
Seat 5: fralex79 ($5.19 in chips) 
Seat 6: llosjone ($10.92 in chips) 
buradin de: posts small blind $0.05
Sabali420: posts big blind $0.10
*** HOLE CARDS ***
fralex79: folds 
llosjone: folds 
AAA_set_nh: folds 
cruxua: raises $0.15 to $0.25
buradin de: folds 
Sabali420: calls $0.15
*** FLOP *** [Th 9h Js]
Sabali420: checks 
cruxua: bets $0.40
Sabali420: folds 
Uncalled bet ($0.40) returned to cruxua
cruxua collected $0.53 from pot
cruxua: doesn't show hand 
*** SUMMARY ***
Total pot $0.55 | Rake $0.02 
Board [Th 9h Js]
Seat 1: AAA_set_nh folded before Flop (didn't bet)
Seat 2: cruxua (button) collected ($0.53)
Seat 3: buradin de (small blind) folded before Flop
Seat 4: Sabali420 (big blind) folded on the Flop
Seat 5: fralex79 folded before Flop (didn't bet)
Seat 6: llosjone folded before Flop (didn't bet)



PokerStars Hand #222948814374:  Hold'em No Limit ($0.05/$0.10 USD) - 2021/01/23 4:39:32 ET
Table 'Capricorn II' 6-max Seat #3 is the button
Seat 1: AAA_set_nh ($10 in chips) 
Seat 2: cruxua ($10.28 in chips) 
Seat 3: buradin de ($10 in chips) 
Seat 4: Sabali420 ($10.66 in chips) 
Seat 5: fralex79 ($5.19 in chips) 
Seat 6: llosjone ($10.92 in chips) 
Sabali420: posts small blind $0.05
fralex79: posts big blind $0.10
*** HOLE CARDS ***
llosjone: folds 
AAA_set_nh: folds 
cruxua: folds 
buradin de: folds 
Sabali420: calls $0.05
fralex79: checks 
*** FLOP *** [Kc Qd Ac]
Sabali420: bets $0.10
fralex79: folds 
Uncalled bet ($0.10) returned to Sabali420
Sabali420 collected $0.19 from pot
Sabali420: doesn't show hand 
*** SUMMARY ***
Total pot $0.20 | Rake $0.01 
Board [Kc Qd Ac]
Seat 1: AAA_set_nh folded before Flop (didn't bet)
Seat 2: cruxua folded before Flop (didn't bet)
Seat 3: buradin de (button) folded before Flop (didn't bet)
Seat 4: Sabali420 (small blind) collected ($0.19)
Seat 5: fralex79 (big blind) folded on the Flop
Seat 6: llosjone folded before Flop (didn't bet)



PokerStars Hand #222948823259:  Hold'em No Limit ($0.05/$0.10 USD) - 2021/01/23 4:40:05 ET
Table 'Capricorn II' 6-max Seat #4 is the button
Seat 1: AAA_set_nh ($10 in chips) 
Seat 2: cruxua ($10.28 in chips) 
Seat 3: buradin de ($10 in chips) 
Seat 4: Sabali420 ($10.75 in chips) 
Seat 5: fralex79 ($5.09 in chips) 
Seat 6: llosjone ($10.92 in chips) 
fralex79: posts small blind $0.05
llosjone: posts big blind $0.10
*** HOLE CARDS ***
AAA_set_nh: folds 
cruxua: folds 
buradin de: folds 
Sabali420: folds 
fralex79: raises $0.10 to $0.20
llosjone: calls $0.10
*** FLOP *** [3s Ac 7c]
fralex79: bets $0.20
llosjone: calls $0.20
*** TURN *** [3s Ac 7c] [2s]
fralex79: bets $0.80
llosjone: folds 
Uncalled bet ($0.80) returned to fralex79
fralex79 collected $0.76 from pot
fralex79: doesn't show hand 
*** SUMMARY ***
Total pot $0.80 | Rake $0.04 
Board [3s Ac 7c 2s]
Seat 1: AAA_set_nh folded before Flop (didn't bet)
Seat 2: cruxua folded before Flop (didn't bet)
Seat 3: buradin de folded before Flop (didn't bet)
Seat 4: Sabali420 (button) folded before Flop (didn't bet)
Seat 5: fralex79 (small blind) collected ($0.76)
Seat 6: llosjone (big blind) folded on the Turn



PokerStars Hand #222948829537:  Hold'em No Limit ($0.05/$0.10 USD) - 2021/01/23 4:40:27 ET
Table 'Capricorn II' 6-max Seat #5 is the button
Seat 1: AAA_set_nh ($10 in chips) 
Seat 2: cruxua ($10.28 in chips) 
Seat 3: buradin de ($10 in chips) 
Seat 4: Sabali420 ($10.75 in chips) 
Seat 5: fralex79 ($5.45 in chips) 
Seat 6: llosjone ($10.52 in chips) 
llosjone: posts small blind $0.05
AAA_set_nh: posts big blind $0.10
*** HOLE CARDS ***
cruxua: raises $0.20 to $0.30
buradin de: folds 
Sabali420: calls $0.30
fralex79: folds 
llosjone: calls $0.25
AAA_set_nh: folds 
*** FLOP *** [Ks 7s 3h]
llosjone: checks 
cruxua: bets $0.64
Sabali420: folds 
llosjone: calls $0.64
*** TURN *** [Ks 7s 3h] [3d]
llosjone: checks 
cruxua: bets $1.45
llosjone: folds 
Uncalled bet ($1.45) returned to cruxua
cruxua collected $2.18 from pot
cruxua: doesn't show hand 
*** SUMMARY ***
Total pot $2.28 | Rake $0.10 
Board [Ks 7s 3h 3d]
Seat 1: AAA_set_nh (big blind) folded before Flop
Seat 2: cruxua collected ($2.18)
Seat 3: buradin de folded before Flop (didn't bet)
Seat 4: Sabali420 folded on the Flop
Seat 5: fralex79 (button) folded before Flop (didn't bet)
Seat 6: llosjone (small blind) folded on the Turn



PokerStars Hand #222948841303:  Hold'em No Limit ($0.05/$0.10 USD) - 2021/01/23 4:41:10 ET
Table 'Capricorn II' 6-max Seat #6 is the button
Seat 1: AAA_set_nh ($10 in chips) 
Seat 2: cruxua ($11.52 in chips) 
Seat 3: buradin de ($10 in chips) 
Seat 4: Sabali420 ($10.45 in chips) 
Seat 5: fralex79 ($5.45 in chips) 
Seat 6: llosjone ($9.58 in chips) 
AAA_set_nh: posts small blind $0.05
cruxua: posts big blind $0.10
*** HOLE CARDS ***
buradin de: folds 
Sabali420: folds 
fralex79: folds 
llosjone: folds 
AAA_set_nh: folds 
Uncalled bet ($0.05) returned to cruxua
cruxua collected $0.10 from pot
cruxua: doesn't show hand 
*** SUMMARY ***
Total pot $0.10 | Rake $0 
Seat 1: AAA_set_nh (small blind) folded before Flop
Seat 2: cruxua (big blind) collected ($0.10)
Seat 3: buradin de folded before Flop (didn't bet)
Seat 4: Sabali420 folded before Flop (didn't bet)
Seat 5: fralex79 folded before Flop (didn't bet)
Seat 6: llosjone (button) folded before Flop (didn't bet)



PokerStars Hand #222948844088:  Hold'em No Limit ($0.05/$0.10 USD) - 2021/01/23 4:41:20 ET
Table 'Capricorn II' 6-max Seat #1 is the button
Seat 1: AAA_set_nh ($10 in chips) 
Seat 2: cruxua ($11.57 in chips) 
Seat 3: buradin de ($10 in chips) 
Seat 4: Sabali420 ($10.45 in chips) 
Seat 5: fralex79 ($5.45 in chips) 
Seat 6: llosjone ($9.58 in chips) 
cruxua: posts small blind $0.05
buradin de: posts big blind $0.10
*** HOLE CARDS ***
Sabali420: folds 
fralex79: folds 
llosjone: folds 
AAA_set_nh: folds 
cruxua: folds 
Uncalled bet ($0.05) returned to buradin de
buradin de collected $0.10 from pot
buradin de: doesn't show hand 
*** SUMMARY ***
Total pot $0.10 | Rake $0 
Seat 1: AAA_set_nh (button) folded before Flop (didn't bet)
Seat 2: cruxua (small blind) folded before Flop
Seat 3: buradin de (big blind) collected ($0.10)
Seat 4: Sabali420 folded before Flop (didn't bet)
Seat 5: fralex79 folded before Flop (didn't bet)
Seat 6: llosjone folded before Flop (didn't bet)



PokerStars Hand #222948846521:  Hold'em No Limit ($0.05/$0.10 USD) - 2021/01/23 4:41:29 ET
Table 'Capricorn II' 6-max Seat #2 is the button
Seat 1: AAA_set_nh ($10 in chips) 
Seat 2: cruxua ($11.52 in chips) 
Seat 3: buradin de ($10.05 in chips) 
Seat 4: Sabali420 ($10.45 in chips) 
Seat 5: fralex79 ($5.45 in chips) 
Seat 6: llosjone ($9.58 in chips) 
buradin de: posts small blind $0.05
Sabali420: posts big blind $0.10
*** HOLE CARDS ***
fralex79: folds 
llosjone: folds 
AAA_set_nh: folds 
cruxua: folds 
buradin de: calls $0.05
Sabali420: checks 
*** FLOP *** [3c 7d Qc]
buradin de: checks 
Sabali420: checks 
*** TURN *** [3c 7d Qc] [7c]
buradin de: checks 
Sabali420: checks 
*** RIVER *** [3c 7d Qc 7c] [9h]
buradin de: checks 
Sabali420: checks 
*** SHOW DOWN ***
buradin de: shows [5d As] (a pair of Sevens)
Sabali420: mucks hand 
buradin de collected $0.19 from pot
*** SUMMARY ***
Total pot $0.20 | Rake $0.01 
Board [3c 7d Qc 7c 9h]
Seat 1: AAA_set_nh folded before Flop (didn't bet)
Seat 2: cruxua (button) folded before Flop (didn't bet)
Seat 3: buradin de (small blind) showed [5d As] and won ($0.19) with a pair of Sevens
Seat 4: Sabali420 (big blind) mucked
Seat 5: fralex79 folded before Flop (didn't bet)
Seat 6: llosjone folded before Flop (didn't bet)



PokerStars Hand #222948853993:  Hold'em No Limit ($0.05/$0.10 USD) - 2021/01/23 4:41:55 ET
Table 'Capricorn II' 6-max Seat #3 is the button
Seat 1: AAA_set_nh ($10 in chips) 
Seat 2: cruxua ($11.52 in chips) 
Seat 3: buradin de ($10.14 in chips) 
Seat 4: Sabali420 ($10.35 in chips) 
Seat 5: fralex79 ($5.45 in chips) 
Seat 6: llosjone ($9.58 in chips) 
Sabali420: posts small blind $0.05
fralex79: posts big blind $0.10
*** HOLE CARDS ***
llosjone: folds 
AAA_set_nh: folds 
cruxua: folds 
buradin de: folds 
Sabali420: folds 
Uncalled bet ($0.05) returned to fralex79
fralex79 collected $0.10 from pot
fralex79: doesn't show hand 
*** SUMMARY ***
Total pot $0.10 | Rake $0 
Seat 1: AAA_set_nh folded before Flop (didn't bet)
Seat 2: cruxua folded before Flop (didn't bet)
Seat 3: buradin de (button) folded before Flop (didn't bet)
Seat 4: Sabali420 (small blind) folded before Flop
Seat 5: fralex79 (big blind) collected ($0.10)
Seat 6: llosjone folded before Flop (didn't bet)



PokerStars Hand #222948857039:  Hold'em No Limit ($0.05/$0.10 USD) - 2021/01/23 4:42:06 ET
Table 'Capricorn II' 6-max Seat #4 is the button
Seat 1: AAA_set_nh ($10 in chips) 
Seat 2: cruxua ($11.52 in chips) 
Seat 3: buradin de ($10.14 in chips) 
Seat 4: Sabali420 ($10.30 in chips) 
Seat 5: fralex79 ($5.50 in chips) 
Seat 6: llosjone ($9.58 in chips) 
fralex79: posts small blind $0.05
llosjone: posts big blind $0.10
*** HOLE CARDS ***
AAA_set_nh: folds 
cruxua: folds 
buradin de: folds 
Sabali420: raises $0.20 to $0.30
fralex79: calls $0.25
llosjone: folds 
*** FLOP *** [8s Tc 4d]
fralex79: checks 
Sabali420: checks 
*** TURN *** [8s Tc 4d] [4h]
fralex79: checks 
Sabali420: checks 
*** RIVER *** [8s Tc 4d 4h] [3c]
fralex79: bets $0.70
Sabali420: raises $2.07 to $2.77
fralex79: calls $2.07
*** SHOW DOWN ***
Sabali420: shows [Jd Kh] (a pair of Fours)
fralex79: shows [2c 4c] (three of a kind, Fours)
fralex79 collected $5.96 from pot
*** SUMMARY ***
Total pot $6.24 | Rake $0.28 
Board [8s Tc 4d 4h 3c]
Seat 1: AAA_set_nh folded before Flop (didn't bet)
Seat 2: cruxua folded before Flop (didn't bet)
Seat 3: buradin de folded before Flop (didn't bet)
Seat 4: Sabali420 (button) showed [Jd Kh] and lost with a pair of Fours
Seat 5: fralex79 (small blind) showed [2c 4c] and won ($5.96) with three of a kind, Fours
Seat 6: llosjone (big blind) folded before Flop



PokerStars Hand #222948868202:  Hold'em No Limit ($0.05/$0.10 USD) - 2021/01/23 4:42:37 ET
Table 'Capricorn II' 6-max Seat #5 is the button
Seat 1: AAA_set_nh ($10 in chips) 
Seat 2: cruxua ($11.52 in chips) 
Seat 3: buradin de ($10.14 in chips) 
Seat 4: Sabali420 ($7.23 in chips) 
Seat 5: fralex79 ($8.39 in chips) 
Seat 6: llosjone ($9.48 in chips) 
llosjone: posts small blind $0.05
AAA_set_nh: posts big blind $0.10
*** HOLE CARDS ***
cruxua: folds 
buradin de: calls $0.10
Sabali420: folds 
fralex79: folds 
llosjone: folds 
AAA_set_nh: checks 
*** FLOP *** [8s 7d Kh]
AAA_set_nh: checks 
buradin de: bets $0.10
AAA_set_nh: folds 
Uncalled bet ($0.10) returned to buradin de
buradin de collected $0.24 from pot
buradin de: doesn't show hand 
*** SUMMARY ***
Total pot $0.25 | Rake $0.01 
Board [8s 7d Kh]
Seat 1: AAA_set_nh (big blind) folded on the Flop
Seat 2: cruxua folded before Flop (didn't bet)
Seat 3: buradin de collected ($0.24)
Seat 4: Sabali420 folded before Flop (didn't bet)
Seat 5: fralex79 (button) folded before Flop (didn't bet)
Seat 6: llosjone (small blind) folded before Flop



PokerStars Hand #222948876036:  Hold'em No Limit ($0.05/$0.10 USD) - 2021/01/23 4:43:04 ET
Table 'Capricorn II' 6-max Seat #6 is the button
Seat 1: AAA_set_nh ($10 in chips) 
Seat 2: cruxua ($11.52 in chips) 
Seat 3: buradin de ($10.28 in chips) 
Seat 4: Sabali420 ($10 in chips) 
Seat 5: fralex79 ($8.39 in chips) 
Seat 6: llosjone ($9.43 in chips) 
AAA_set_nh: posts small blind $0.05
cruxua: posts big blind $0.10
*** HOLE CARDS ***
buradin de: folds 
Sabali420: folds 
fralex79: raises $0.10 to $0.20
llosjone: raises $0.18 to $0.38
AAA_set_nh: folds 
cruxua: folds 
fralex79: calls $0.18
*** FLOP *** [3d Ad 5s]
fralex79: checks 
llosjone: bets $0.29
fralex79: calls $0.29
*** TURN *** [3d Ad 5s] [4c]
fralex79: bets $0.70
llosjone: folds 
Uncalled bet ($0.70) returned to fralex79
fralex79 collected $1.42 from pot
fralex79: doesn't show hand 
*** SUMMARY ***
Total pot $1.49 | Rake $0.07 
Board [3d Ad 5s 4c]
Seat 1: AAA_set_nh (small blind) folded before Flop
Seat 2: cruxua (big blind) folded before Flop
Seat 3: buradin de folded before Flop (didn't bet)
Seat 4: Sabali420 folded before Flop (didn't bet)
Seat 5: fralex79 collected ($1.42)
Seat 6: llosjone (button) folded on the Turn



PokerStars Hand #222949382123:  Hold'em No Limit ($0.05/$0.10 USD) - 2021/01/23 5:13:19 ET
Table 'Capricorn II' 6-max Seat #1 is the button
Seat 1: PainForYou25 ($8.70 in chips) 
Seat 2: 3EBC96 ($10 in chips) 
Seat 3: rpadilla33 ($11.36 in chips) 
Seat 4: romanromanro ($16.94 in chips) 
Seat 5: jazou10 ($12.19 in chips) 
Seat 6: cruxua ($15.64 in chips) 
3EBC96: posts small blind $0.05
rpadilla33: posts big blind $0.10
*** HOLE CARDS ***
romanromanro: folds 
jazou10: calls $0.10
cruxua: folds 
PainForYou25: raises $0.20 to $0.30
3EBC96: folds 
rpadilla33: folds 
jazou10: calls $0.20
*** FLOP *** [4c 7s 3d]
jazou10: checks 
PainForYou25: bets $0.36
jazou10: folds 
Uncalled bet ($0.36) returned to PainForYou25
PainForYou25 collected $0.72 from pot
PainForYou25: doesn't show hand 
*** SUMMARY ***
Total pot $0.75 | Rake $0.03 
Board [4c 7s 3d]
Seat 1: PainForYou25 (button) collected ($0.72)
Seat 2: 3EBC96 (small blind) folded before Flop
Seat 3: rpadilla33 (big blind) folded before Flop
Seat 4: romanromanro folded before Flop (didn't bet)
Seat 5: jazou10 folded on the Flop
Seat 6: cruxua folded before Flop (didn't bet)



PokerStars Hand #222949495668:  Hold'em No Limit ($0.05/$0.10 USD) - 2021/01/23 5:19:12 ET
Table 'Capricorn II' 6-max Seat #5 is the button
Seat 1: PainForYou25 ($12.79 in chips) 
Seat 2: 3EBC96 ($12 in chips) 
Seat 3: rpadilla33 ($10 in chips) 
Seat 4: brightsunfun ($10.30 in chips) 
Seat 5: jazou10 ($11.14 in chips) 
Seat 6: cruxua ($14.74 in chips) 
cruxua: posts small blind $0.05
PainForYou25: posts big blind $0.10
*** HOLE CARDS ***
3EBC96: folds 
rpadilla33: folds 
brightsunfun: folds 
jazou10: folds 
cruxua: folds 
Uncalled bet ($0.05) returned to PainForYou25
PainForYou25 collected $0.10 from pot
PainForYou25: doesn't show hand 
*** SUMMARY ***
Total pot $0.10 | Rake $0 
Seat 1: PainForYou25 (big blind) collected ($0.10)
Seat 2: 3EBC96 folded before Flop (didn't bet)
Seat 3: rpadilla33 folded before Flop (didn't bet)
Seat 4: brightsunfun folded before Flop (didn't bet)
Seat 5: jazou10 (button) folded before Flop (didn't bet)
Seat 6: cruxua (small blind) folded before Flop



PokerStars Hand #222949559699:  Hold'em No Limit ($0.05/$0.10 USD) - 2021/01/23 5:22:44 ET
Table 'Capricorn II' 6-max Seat #1 is the button
Seat 1: PainForYou25 ($13.02 in chips) 
Seat 2: 3EBC96 ($11.90 in chips) 
Seat 3: rpadilla33 ($10.64 in chips) 
Seat 4: Chrysk2 ($10.15 in chips) 
Seat 5: jazou10 ($10.64 in chips) 
Seat 6: cruxua ($14.24 in chips) 
3EBC96: posts small blind $0.05
rpadilla33: posts big blind $0.10
*** HOLE CARDS ***
Chrysk2: raises $0.20 to $0.30
jazou10: folds 
cruxua: calls $0.30
PainForYou25: folds 
3EBC96: folds 
rpadilla33: folds 
*** FLOP *** [8h 5s Jc]
Chrysk2: bets $0.24
cruxua: calls $0.24
*** TURN *** [8h 5s Jc] [3s]
Chrysk2: checks 
cruxua: checks 
*** RIVER *** [8h 5s Jc 3s] [Jh]
Chrysk2: bets $0.43
cruxua: folds 
Uncalled bet ($0.43) returned to Chrysk2
Chrysk2 collected $1.17 from pot
Chrysk2: doesn't show hand 
*** SUMMARY ***
Total pot $1.23 | Rake $0.06 
Board [8h 5s Jc 3s Jh]
Seat 1: PainForYou25 (button) folded before Flop (didn't bet)
Seat 2: 3EBC96 (small blind) folded before Flop
Seat 3: rpadilla33 (big blind) folded before Flop
Seat 4: Chrysk2 collected ($1.17)
Seat 5: jazou10 folded before Flop (didn't bet)
Seat 6: cruxua folded on the River



PokerStars Hand #222949586115:  Hold'em No Limit ($0.05/$0.10 USD) - 2021/01/23 5:24:11 ET
Table 'Capricorn II' 6-max Seat #2 is the button
Seat 1: PainForYou25 ($13.02 in chips) 
Seat 2: 3EBC96 ($11.85 in chips) 
Seat 3: rpadilla33 ($10.54 in chips) 
Seat 4: Chrysk2 ($10.78 in chips) 
Seat 5: jazou10 ($10.64 in chips) 
Seat 6: cruxua ($13.70 in chips) 
rpadilla33: posts small blind $0.05
Chrysk2: posts big blind $0.10
*** HOLE CARDS ***
jazou10: folds 
cruxua: folds 
PainForYou25: calls $0.10
3EBC96: folds 
rpadilla33: folds 
Chrysk2: checks 
*** FLOP *** [4c 9c 3s]
Chrysk2: checks 
PainForYou25: bets $0.20
Chrysk2: raises $0.40 to $0.60
PainForYou25: calls $0.40
*** TURN *** [4c 9c 3s] [3h]
Chrysk2: bets $0.40
PainForYou25: calls $0.40
*** RIVER *** [4c 9c 3s 3h] [8c]
Chrysk2: checks 
PainForYou25: checks 
*** SHOW DOWN ***
Chrysk2: shows [4s 6h] (two pair, Fours and Threes)
PainForYou25: shows [Qc 9s] (two pair, Nines and Threes)
PainForYou25 collected $2.15 from pot
*** SUMMARY ***
Total pot $2.25 | Rake $0.10 
Board [4c 9c 3s 3h 8c]
Seat 1: PainForYou25 showed [Qc 9s] and won ($2.15) with two pair, Nines and Threes
Seat 2: 3EBC96 (button) folded before Flop (didn't bet)
Seat 3: rpadilla33 (small blind) folded before Flop
Seat 4: Chrysk2 (big blind) showed [4s 6h] and lost with two pair, Fours and Threes
Seat 5: jazou10 folded before Flop (didn't bet)
Seat 6: cruxua folded before Flop (didn't bet)



PokerStars Hand #222949618662:  Hold'em No Limit ($0.05/$0.10 USD) - 2021/01/23 5:25:58 ET
Table 'Capricorn II' 6-max Seat #3 is the button
Seat 1: PainForYou25 ($14.07 in chips) 
Seat 2: 3EBC96 ($11.85 in chips) 
Seat 3: rpadilla33 ($10.49 in chips) 
Seat 4: Chrysk2 ($9.68 in chips) 
Seat 5: jazou10 ($10.64 in chips) 
Seat 6: cruxua ($13.70 in chips) 
Chrysk2: posts small blind $0.05
jazou10: posts big blind $0.10
*** HOLE CARDS ***
cruxua: folds 
PainForYou25: raises $0.20 to $0.30
3EBC96: folds 
rpadilla33: folds 
Chrysk2: folds 
jazou10: folds 
Uncalled bet ($0.20) returned to PainForYou25
PainForYou25 collected $0.25 from pot
PainForYou25: doesn't show hand 
*** SUMMARY ***
Total pot $0.25 | Rake $0 
Seat 1: PainForYou25 collected ($0.25)
Seat 2: 3EBC96 folded before Flop (didn't bet)
Seat 3: rpadilla33 (button) folded before Flop (didn't bet)
Seat 4: Chrysk2 (small blind) folded before Flop
Seat 5: jazou10 (big blind) folded before Flop
Seat 6: cruxua folded before Flop (didn't bet)



PokerStars Hand #222949629061:  Hold'em No Limit ($0.05/$0.10 USD) - 2021/01/23 5:26:32 ET
Table 'Capricorn II' 6-max Seat #4 is the button
Seat 1: PainForYou25 ($14.22 in chips) 
Seat 2: 3EBC96 ($11.85 in chips) 
Seat 3: rpadilla33 ($10.49 in chips) 
Seat 4: Chrysk2 ($9.63 in chips) 
Seat 5: jazou10 ($10.54 in chips) 
Seat 6: cruxua ($13.70 in chips) 
jazou10: posts small blind $0.05
cruxua: posts big blind $0.10
*** HOLE CARDS ***
PainForYou25: folds 
3EBC96: folds 
rpadilla33: folds 
Chrysk2: raises $0.20 to $0.30
jazou10: folds 
cruxua: folds 
Uncalled bet ($0.20) returned to Chrysk2
Chrysk2 collected $0.25 from pot
Chrysk2: doesn't show hand 
*** SUMMARY ***
Total pot $0.25 | Rake $0 
Seat 1: PainForYou25 folded before Flop (didn't bet)
Seat 2: 3EBC96 folded before Flop (didn't bet)
Seat 3: rpadilla33 folded before Flop (didn't bet)
Seat 4: Chrysk2 (button) collected ($0.25)
Seat 5: jazou10 (small blind) folded before Flop
Seat 6: cruxua (big blind) folded before Flop



PokerStars Hand #222949635467:  Hold'em No Limit ($0.05/$0.10 USD) - 2021/01/23 5:26:53 ET
Table 'Capricorn II' 6-max Seat #5 is the button
Seat 1: PainForYou25 ($14.22 in chips) 
Seat 2: 3EBC96 ($11.85 in chips) 
Seat 3: rpadilla33 ($10.49 in chips) 
Seat 4: Chrysk2 ($9.78 in chips) 
Seat 5: jazou10 ($10.49 in chips) 
Seat 6: cruxua ($13.60 in chips) 
cruxua: posts small blind $0.05
PainForYou25: posts big blind $0.10
*** HOLE CARDS ***
3EBC96: raises $0.20 to $0.30
rpadilla33: folds 
Chrysk2: folds 
jazou10: folds 
cruxua: folds 
PainForYou25: calls $0.20
*** FLOP *** [9h 2c Th]
PainForYou25: checks 
3EBC96: bets $0.31
PainForYou25: calls $0.31
*** TURN *** [9h 2c Th] [7d]
PainForYou25: checks 
3EBC96: bets $0.91
PainForYou25: calls $0.91
*** RIVER *** [9h 2c Th 7d] [7c]
PainForYou25: checks 
3EBC96: bets $0.97
PainForYou25: calls $0.97
*** SHOW DOWN ***
3EBC96: shows [Kh Kc] (two pair, Kings and Sevens)
PainForYou25: mucks hand 
3EBC96 collected $4.80 from pot
*** SUMMARY ***
Total pot $5.03 | Rake $0.23 
Board [9h 2c Th 7d 7c]
Seat 1: PainForYou25 (big blind) mucked
Seat 2: 3EBC96 showed [Kh Kc] and won ($4.80) with two pair, Kings and Sevens
Seat 3: rpadilla33 folded before Flop (didn't bet)
Seat 4: Chrysk2 folded before Flop (didn't bet)
Seat 5: jazou10 (button) folded before Flop (didn't bet)
Seat 6: cruxua (small blind) folded before Flop



PokerStars Hand #222949657602:  Hold'em No Limit ($0.05/$0.10 USD) - 2021/01/23 5:28:06 ET
Table 'Capricorn II' 6-max Seat #6 is the button
Seat 1: PainForYou25 ($11.73 in chips) 
Seat 2: 3EBC96 ($14.16 in chips) 
Seat 3: rpadilla33 ($10.49 in chips) 
Seat 4: Chrysk2 ($10 in chips) 
Seat 5: jazou10 ($10.49 in chips) 
Seat 6: cruxua ($13.55 in chips) 
PainForYou25: posts small blind $0.05
3EBC96: posts big blind $0.10
*** HOLE CARDS ***
rpadilla33: folds 
Chrysk2: folds 
jazou10: folds 
cruxua: folds 
PainForYou25: calls $0.05
3EBC96: checks 
*** FLOP *** [9c Kd 8s]
PainForYou25: bets $0.10
3EBC96: folds 
Uncalled bet ($0.10) returned to PainForYou25
PainForYou25 collected $0.19 from pot
PainForYou25: doesn't show hand 
*** SUMMARY ***
Total pot $0.20 | Rake $0.01 
Board [9c Kd 8s]
Seat 1: PainForYou25 (small blind) collected ($0.19)
Seat 2: 3EBC96 (big blind) folded on the Flop
Seat 3: rpadilla33 folded before Flop (didn't bet)
Seat 4: Chrysk2 folded before Flop (didn't bet)
Seat 5: jazou10 folded before Flop (didn't bet)
Seat 6: cruxua (button) folded before Flop (didn't bet)



PokerStars Hand #222949666012:  Hold'em No Limit ($0.05/$0.10 USD) - 2021/01/23 5:28:33 ET
Table 'Capricorn II' 6-max Seat #1 is the button
Seat 1: PainForYou25 ($11.82 in chips) 
Seat 2: 3EBC96 ($14.06 in chips) 
Seat 3: rpadilla33 ($10.49 in chips) 
Seat 4: Chrysk2 ($10 in chips) 
Seat 5: jazou10 ($10.49 in chips) 
Seat 6: cruxua ($13.55 in chips) 
3EBC96: posts small blind $0.05
rpadilla33: posts big blind $0.10
*** HOLE CARDS ***
Chrysk2: folds 
jazou10: folds 
cruxua: raises $0.20 to $0.30
PainForYou25: folds 
3EBC96: folds 
rpadilla33: folds 
Uncalled bet ($0.20) returned to cruxua
cruxua collected $0.25 from pot
cruxua: doesn't show hand 
*** SUMMARY ***
Total pot $0.25 | Rake $0 
Seat 1: PainForYou25 (button) folded before Flop (didn't bet)
Seat 2: 3EBC96 (small blind) folded before Flop
Seat 3: rpadilla33 (big blind) folded before Flop
Seat 4: Chrysk2 folded before Flop (didn't bet)
Seat 5: jazou10 folded before Flop (didn't bet)
Seat 6: cruxua collected ($0.25)



PokerStars Hand #222949671684:  Hold'em No Limit ($0.05/$0.10 USD) - 2021/01/23 5:28:52 ET
Table 'Capricorn II' 6-max Seat #2 is the button
Seat 2: 3EBC96 ($14.01 in chips) 
Seat 3: rpadilla33 ($10.39 in chips) 
Seat 4: Chrysk2 ($10 in chips) 
Seat 5: jazou10 ($10.49 in chips) 
Seat 6: cruxua ($13.70 in chips) 
rpadilla33: posts small blind $0.05
Chrysk2: posts big blind $0.10
*** HOLE CARDS ***
jazou10: calls $0.10
cruxua: folds 
3EBC96: folds 
rpadilla33: calls $0.05
Chrysk2: checks 
*** FLOP *** [Qs 8d 6h]
rpadilla33: checks 
Chrysk2: checks 
jazou10: bets $0.10
rpadilla33: calls $0.10
Chrysk2: folds 
*** TURN *** [Qs 8d 6h] [Th]
rpadilla33: bets $0.20
jazou10: calls $0.20
*** RIVER *** [Qs 8d 6h Th] [Jc]
rpadilla33: checks 
jazou10: checks 
*** SHOW DOWN ***
rpadilla33: shows [Qd Kc] (a pair of Queens)
jazou10: mucks hand 
rpadilla33 collected $0.86 from pot
*** SUMMARY ***
Total pot $0.90 | Rake $0.04 
Board [Qs 8d 6h Th Jc]
Seat 2: 3EBC96 (button) folded before Flop (didn't bet)
Seat 3: rpadilla33 (small blind) showed [Qd Kc] and won ($0.86) with a pair of Queens
Seat 4: Chrysk2 (big blind) folded on the Flop
Seat 5: jazou10 mucked
Seat 6: cruxua folded before Flop (didn't bet)



PokerStars Hand #222949684047:  Hold'em No Limit ($0.05/$0.10 USD) - 2021/01/23 5:29:33 ET
Table 'Capricorn II' 6-max Seat #3 is the button
Seat 2: 3EBC96 ($14.01 in chips) 
Seat 3: rpadilla33 ($10.85 in chips) 
Seat 4: Chrysk2 ($9.90 in chips) 
Seat 5: jazou10 ($10.09 in chips) 
Seat 6: cruxua ($13.70 in chips) 
Chrysk2: posts small blind $0.05
jazou10: posts big blind $0.10
*** HOLE CARDS ***
cruxua: raises $0.20 to $0.30
3EBC96: folds 
rpadilla33: folds 
Chrysk2: folds 
jazou10: folds 
Uncalled bet ($0.20) returned to cruxua
cruxua collected $0.25 from pot
cruxua: doesn't show hand 
*** SUMMARY ***
Total pot $0.25 | Rake $0 
Seat 2: 3EBC96 folded before Flop (didn't bet)
Seat 3: rpadilla33 (button) folded before Flop (didn't bet)
Seat 4: Chrysk2 (small blind) folded before Flop
Seat 5: jazou10 (big blind) folded before Flop
Seat 6: cruxua collected ($0.25)



PokerStars Hand #222949691014:  Hold'em No Limit ($0.05/$0.10 USD) - 2021/01/23 5:29:55 ET
Table 'Capricorn II' 6-max Seat #4 is the button
Seat 2: 3EBC96 ($14.01 in chips) 
Seat 3: rpadilla33 ($10.85 in chips) 
Seat 4: Chrysk2 ($9.85 in chips) 
Seat 5: jazou10 ($9.99 in chips) 
Seat 6: cruxua ($13.85 in chips) 
jazou10: posts small blind $0.05
cruxua: posts big blind $0.10
*** HOLE CARDS ***
3EBC96: folds 
rpadilla33: raises $0.20 to $0.30
Chrysk2: calls $0.30
jazou10: calls $0.25
cruxua: folds 
*** FLOP *** [7h Qc Qs]
jazou10: checks 
rpadilla33: bets $0.40
Chrysk2: folds 
jazou10: folds 
Uncalled bet ($0.40) returned to rpadilla33
rpadilla33 collected $0.96 from pot
rpadilla33: doesn't show hand 
*** SUMMARY ***
Total pot $1 | Rake $0.04 
Board [7h Qc Qs]
Seat 2: 3EBC96 folded before Flop (didn't bet)
Seat 3: rpadilla33 collected ($0.96)
Seat 4: Chrysk2 (button) folded on the Flop
Seat 5: jazou10 (small blind) folded on the Flop
Seat 6: cruxua (big blind) folded before Flop



PokerStars Hand #222949702811:  Hold'em No Limit ($0.05/$0.10 USD) - 2021/01/23 5:30:34 ET
Table 'Capricorn II' 6-max Seat #5 is the button
Seat 2: 3EBC96 ($14.01 in chips) 
Seat 3: rpadilla33 ($11.51 in chips) 
Seat 4: Chrysk2 ($9.55 in chips) 
Seat 5: jazou10 ($9.69 in chips) 
Seat 6: cruxua ($13.75 in chips) 
cruxua: posts small blind $0.05
3EBC96: posts big blind $0.10
*** HOLE CARDS ***
PainForYou25 is disconnected 
rpadilla33: raises $0.20 to $0.30
Chrysk2 has timed out
Chrysk2: folds 
jazou10: folds 
cruxua: folds 
3EBC96: calls $0.20
*** FLOP *** [Th 4c 7d]
3EBC96: checks 
rpadilla33: bets $0.20
3EBC96: folds 
Uncalled bet ($0.20) returned to rpadilla33
rpadilla33 collected $0.62 from pot
rpadilla33: doesn't show hand 
*** SUMMARY ***
Total pot $0.65 | Rake $0.03 
Board [Th 4c 7d]
Seat 2: 3EBC96 (big blind) folded on the Flop
Seat 3: rpadilla33 collected ($0.62)
Seat 4: Chrysk2 folded before Flop (didn't bet)
Seat 5: jazou10 (button) folded before Flop (didn't bet)
Seat 6: cruxua (small blind) folded before Flop



PokerStars Hand #222949719225:  Hold'em No Limit ($0.05/$0.10 USD) - 2021/01/23 5:31:27 ET
Table 'Capricorn II' 6-max Seat #6 is the button
Seat 2: 3EBC96 ($13.71 in chips) 
Seat 3: rpadilla33 ($11.83 in chips) 
Seat 4: Chrysk2 ($10 in chips) 
Seat 5: jazou10 ($9.69 in chips) 
Seat 6: cruxua ($13.70 in chips) 
3EBC96: posts small blind $0.05
rpadilla33: posts big blind $0.10
*** HOLE CARDS ***
Chrysk2: raises $0.20 to $0.30
jazou10: folds 
cruxua: folds 
3EBC96: folds 
rpadilla33: folds 
Uncalled bet ($0.20) returned to Chrysk2
Chrysk2 collected $0.25 from pot
Chrysk2: doesn't show hand 
*** SUMMARY ***
Total pot $0.25 | Rake $0 
Seat 2: 3EBC96 (small blind) folded before Flop
Seat 3: rpadilla33 (big blind) folded before Flop
Seat 4: Chrysk2 collected ($0.25)
Seat 5: jazou10 folded before Flop (didn't bet)
Seat 6: cruxua (button) folded before Flop (didn't bet)



PokerStars Hand #222949722646:  Hold'em No Limit ($0.05/$0.10 USD) - 2021/01/23 5:31:38 ET
Table 'Capricorn II' 6-max Seat #2 is the button
Seat 2: 3EBC96 ($13.66 in chips) 
Seat 3: rpadilla33 ($11.73 in chips) 
Seat 4: Chrysk2 ($10.15 in chips) 
Seat 5: jazou10 ($9.69 in chips) 
Seat 6: cruxua ($13.70 in chips) 
rpadilla33: posts small blind $0.05
Chrysk2: posts big blind $0.10
*** HOLE CARDS ***
jazou10: folds 
cruxua: folds 
3EBC96: raises $0.20 to $0.30
rpadilla33: folds 
Chrysk2: raises $0.70 to $1
3EBC96: folds 
Uncalled bet ($0.70) returned to Chrysk2
Chrysk2 collected $0.65 from pot
Chrysk2: doesn't show hand 
*** SUMMARY ***
Total pot $0.65 | Rake $0 
Seat 2: 3EBC96 (button) folded before Flop
Seat 3: rpadilla33 (small blind) folded before Flop
Seat 4: Chrysk2 (big blind) collected ($0.65)
Seat 5: jazou10 folded before Flop (didn't bet)
Seat 6: cruxua folded before Flop (didn't bet)



PokerStars Hand #222949732655:  Hold'em No Limit ($0.05/$0.10 USD) - 2021/01/23 5:32:11 ET
Table 'Capricorn II' 6-max Seat #3 is the button
Seat 2: 3EBC96 ($13.36 in chips) 
Seat 3: rpadilla33 ($11.68 in chips) 
Seat 4: Chrysk2 ($10.50 in chips) 
Seat 5: jazou10 ($9.69 in chips) 
Seat 6: cruxua ($13.70 in chips) 
Chrysk2: posts small blind $0.05
jazou10: posts big blind $0.10
*** HOLE CARDS ***
cruxua: folds 
3EBC96: raises $0.20 to $0.30
rpadilla33: folds 
Chrysk2: folds 
jazou10: folds 
Uncalled bet ($0.20) returned to 3EBC96
3EBC96 collected $0.25 from pot
3EBC96: doesn't show hand 
*** SUMMARY ***
Total pot $0.25 | Rake $0 
Seat 2: 3EBC96 collected ($0.25)
Seat 3: rpadilla33 (button) folded before Flop (didn't bet)
Seat 4: Chrysk2 (small blind) folded before Flop
Seat 5: jazou10 (big blind) folded before Flop
Seat 6: cruxua folded before Flop (didn't bet)



PokerStars Hand #222949735450:  Hold'em No Limit ($0.05/$0.10 USD) - 2021/01/23 5:32:20 ET
Table 'Capricorn II' 6-max Seat #4 is the button
Seat 2: 3EBC96 ($13.51 in chips) 
Seat 3: rpadilla33 ($11.68 in chips) 
Seat 4: Chrysk2 ($10.45 in chips) 
Seat 5: jazou10 ($9.59 in chips) 
Seat 6: cruxua ($13.70 in chips) 
jazou10: posts small blind $0.05
cruxua: posts big blind $0.10
*** HOLE CARDS ***
3EBC96: folds 
rpadilla33: folds 
Chrysk2: folds 
jazou10: calls $0.05
cruxua: raises $0.40 to $0.50
jazou10: folds 
Uncalled bet ($0.40) returned to cruxua
cruxua collected $0.20 from pot
cruxua: doesn't show hand 
*** SUMMARY ***
Total pot $0.20 | Rake $0 
Seat 2: 3EBC96 folded before Flop (didn't bet)
Seat 3: rpadilla33 folded before Flop (didn't bet)
Seat 4: Chrysk2 (button) folded before Flop (didn't bet)
Seat 5: jazou10 (small blind) folded before Flop
Seat 6: cruxua (big blind) collected ($0.20)



PokerStars Hand #222949743520:  Hold'em No Limit ($0.05/$0.10 USD) - 2021/01/23 5:32:46 ET
Table 'Capricorn II' 6-max Seat #5 is the button
Seat 2: 3EBC96 ($13.51 in chips) 
Seat 3: rpadilla33 ($11.68 in chips) 
Seat 4: Chrysk2 ($10.45 in chips) 
Seat 5: jazou10 ($9.49 in chips) 
Seat 6: cruxua ($13.80 in chips) 
cruxua: posts small blind $0.05
3EBC96: posts big blind $0.10
*** HOLE CARDS ***
rpadilla33: folds 
Chrysk2: folds 
jazou10: calls $0.10
cruxua: folds 
3EBC96: checks 
*** FLOP *** [Td 2s Jh]
3EBC96: checks 
jazou10: bets $0.10
3EBC96: folds 
Uncalled bet ($0.10) returned to jazou10
jazou10 collected $0.24 from pot
jazou10: doesn't show hand 
*** SUMMARY ***
Total pot $0.25 | Rake $0.01 
Board [Td 2s Jh]
Seat 2: 3EBC96 (big blind) folded on the Flop
Seat 3: rpadilla33 folded before Flop (didn't bet)
Seat 4: Chrysk2 folded before Flop (didn't bet)
Seat 5: jazou10 (button) collected ($0.24)
Seat 6: cruxua (small blind) folded before Flop



PokerStars Hand #222949751049:  Hold'em No Limit ($0.05/$0.10 USD) - 2021/01/23 5:33:10 ET
Table 'Capricorn II' 6-max Seat #6 is the button
Seat 2: 3EBC96 ($13.41 in chips) 
Seat 4: Chrysk2 ($10.45 in chips) 
Seat 5: jazou10 ($9.63 in chips) 
Seat 6: cruxua ($13.75 in chips) 
3EBC96: posts small blind $0.05
rpadilla33: is sitting out 
Chrysk2: posts big blind $0.10
*** HOLE CARDS ***
jazou10: folds 
cruxua: folds 
3EBC96: raises $0.20 to $0.30
Chrysk2: folds 
Uncalled bet ($0.20) returned to 3EBC96
3EBC96 collected $0.20 from pot
3EBC96: doesn't show hand 
*** SUMMARY ***
Total pot $0.20 | Rake $0 
Seat 2: 3EBC96 (small blind) collected ($0.20)
Seat 4: Chrysk2 (big blind) folded before Flop
Seat 5: jazou10 folded before Flop (didn't bet)
Seat 6: cruxua (button) folded before Flop (didn't bet)



PokerStars Hand #222949759849:  Hold'em No Limit ($0.05/$0.10 USD) - 2021/01/23 5:33:39 ET
Table 'Capricorn II' 6-max Seat #2 is the button
Seat 2: 3EBC96 ($13.51 in chips) 
Seat 4: Chrysk2 ($10.35 in chips) 
Seat 5: jazou10 ($9.63 in chips) 
Seat 6: cruxua ($13.75 in chips) 
Chrysk2: posts small blind $0.05
jazou10: posts big blind $0.10
*** HOLE CARDS ***
cruxua: raises $0.20 to $0.30
3EBC96: folds 
Chrysk2: calls $0.25
jazou10: calls $0.20
*** FLOP *** [Ac As 6h]
Chrysk2: checks 
jazou10: checks 
cruxua: bets $0.40
rpadilla33 leaves the table
Chrysk2: folds 
jazou10: folds 
Uncalled bet ($0.40) returned to cruxua
cruxua collected $0.86 from pot
cruxua: doesn't show hand 
*** SUMMARY ***
Total pot $0.90 | Rake $0.04 
Board [Ac As 6h]
Seat 2: 3EBC96 (button) folded before Flop (didn't bet)
Seat 4: Chrysk2 (small blind) folded on the Flop
Seat 5: jazou10 (big blind) folded on the Flop
Seat 6: cruxua collected ($0.86)



PokerStars Hand #222949773495:  Hold'em No Limit ($0.05/$0.10 USD) - 2021/01/23 5:34:22 ET
Table 'Capricorn II' 6-max Seat #4 is the button
Seat 2: 3EBC96 ($13.51 in chips) 
Seat 4: Chrysk2 ($10.05 in chips) 
Seat 5: jazou10 ($9.33 in chips) 
Seat 6: cruxua ($14.31 in chips) 
jazou10: posts small blind $0.05
cruxua: posts big blind $0.10
*** HOLE CARDS ***
3EBC96: raises $0.20 to $0.30
Chrysk2: folds 
jazou10: folds 
cruxua: folds 
Uncalled bet ($0.20) returned to 3EBC96
3EBC96 collected $0.25 from pot
3EBC96: doesn't show hand 
*** SUMMARY ***
Total pot $0.25 | Rake $0 
Seat 2: 3EBC96 collected ($0.25)
Seat 4: Chrysk2 (button) folded before Flop (didn't bet)
Seat 5: jazou10 (small blind) folded before Flop
Seat 6: cruxua (big blind) folded before Flop



PokerStars Hand #222949776930:  Hold'em No Limit ($0.05/$0.10 USD) - 2021/01/23 5:34:33 ET
Table 'Capricorn II' 6-max Seat #5 is the button
Seat 2: 3EBC96 ($13.66 in chips) 
Seat 4: Chrysk2 ($10.05 in chips) 
Seat 5: jazou10 ($9.28 in chips) 
Seat 6: cruxua ($14.21 in chips) 
cruxua: posts small blind $0.05
3EBC96: posts big blind $0.10
*** HOLE CARDS ***
Chrysk2: folds 
jazou10: folds 
cruxua: folds 
Uncalled bet ($0.05) returned to 3EBC96
3EBC96 collected $0.10 from pot
3EBC96: doesn't show hand 
*** SUMMARY ***
Total pot $0.10 | Rake $0 
Seat 2: 3EBC96 (big blind) collected ($0.10)
Seat 4: Chrysk2 folded before Flop (didn't bet)
Seat 5: jazou10 (button) folded before Flop (didn't bet)
Seat 6: cruxua (small blind) folded before Flop



PokerStars Hand #222949780385:  Hold'em No Limit ($0.05/$0.10 USD) - 2021/01/23 5:34:45 ET
Table 'Capricorn II' 6-max Seat #6 is the button
Seat 2: 3EBC96 ($13.71 in chips) 
Seat 4: Chrysk2 ($10.05 in chips) 
Seat 5: jazou10 ($9.28 in chips) 
Seat 6: cruxua ($14.16 in chips) 
3EBC96: posts small blind $0.05
Chrysk2: posts big blind $0.10
*** HOLE CARDS ***
jazou10: calls $0.10
cruxua: raises $0.30 to $0.40
3EBC96: folds 
Chrysk2: folds 
jazou10: calls $0.30
*** FLOP *** [Jd 3d Kc]
jazou10: checks 
cruxua: bets $0.61
jazou10: calls $0.61
*** TURN *** [Jd 3d Kc] [Jc]
jazou10: checks 
cruxua: checks 
*** RIVER *** [Jd 3d Kc Jc] [3h]
jazou10: checks 
cruxua: checks 
*** SHOW DOWN ***
jazou10: shows [3c 3s] (four of a kind, Threes)
cruxua: mucks hand 
jazou10 collected $2.07 from pot
Picco1952 joins the table at seat #3 
*** SUMMARY ***
Total pot $2.17 | Rake $0.10 
Board [Jd 3d Kc Jc 3h]
Seat 2: 3EBC96 (small blind) folded before Flop
Seat 4: Chrysk2 (big blind) folded before Flop
Seat 5: jazou10 showed [3c 3s] and won ($2.07) with four of a kind, Threes
Seat 6: cruxua (button) mucked



PokerStars Hand #222949792660:  Hold'em No Limit ($0.05/$0.10 USD) - 2021/01/23 5:35:24 ET
Table 'Capricorn II' 6-max Seat #2 is the button
Seat 2: 3EBC96 ($13.66 in chips) 
Seat 4: Chrysk2 ($9.95 in chips) 
Seat 5: jazou10 ($10.34 in chips) 
Seat 6: cruxua ($13.15 in chips) 
Chrysk2: posts small blind $0.05
jazou10: posts big blind $0.10
*** HOLE CARDS ***
cruxua: folds 
3EBC96: folds 
Chrysk2: raises $0.20 to $0.30
jazou10: calls $0.20
*** FLOP *** [7d 5h 6h]
Chrysk2: bets $0.25
jazou10: folds 
Uncalled bet ($0.25) returned to Chrysk2
Chrysk2 collected $0.57 from pot
Chrysk2: doesn't show hand 
*** SUMMARY ***
Total pot $0.60 | Rake $0.03 
Board [7d 5h 6h]
Seat 2: 3EBC96 (button) folded before Flop (didn't bet)
Seat 4: Chrysk2 (small blind) collected ($0.57)
Seat 5: jazou10 (big blind) folded on the Flop
Seat 6: cruxua folded before Flop (didn't bet)



PokerStars Hand #222949800974:  Hold'em No Limit ($0.05/$0.10 USD) - 2021/01/23 5:35:50 ET
Table 'Capricorn II' 6-max Seat #4 is the button
Seat 2: 3EBC96 ($13.66 in chips) 
Seat 3: Picco1952 ($4 in chips) 
Seat 4: Chrysk2 ($10.22 in chips) 
Seat 5: jazou10 ($10.04 in chips) 
Seat 6: cruxua ($13.15 in chips) 
jazou10: posts small blind $0.05
cruxua: posts big blind $0.10
Picco1952: posts big blind $0.10
*** HOLE CARDS ***
3EBC96: folds 
Picco1952: raises $0.10 to $0.20
Chrysk2: folds 
jazou10: folds 
cruxua: calls $0.10
*** FLOP *** [As 4h 7h]
cruxua: checks 
Picco1952: checks 
*** TURN *** [As 4h 7h] [Js]
cruxua: checks 
Picco1952: bets $0.22
cruxua: calls $0.22
*** RIVER *** [As 4h 7h Js] [8c]
cruxua: checks 
Picco1952: checks 
*** SHOW DOWN ***
cruxua: shows [2d Ad] (a pair of Aces)
Picco1952: mucks hand 
cruxua collected $0.85 from pot
*** SUMMARY ***
Total pot $0.89 | Rake $0.04 
Board [As 4h 7h Js 8c]
Seat 2: 3EBC96 folded before Flop (didn't bet)
Seat 3: Picco1952 mucked
Seat 4: Chrysk2 (button) folded before Flop (didn't bet)
Seat 5: jazou10 (small blind) folded before Flop
Seat 6: cruxua (big blind) showed [2d Ad] and won ($0.85) with a pair of Aces



PokerStars Hand #222949817780:  Hold'em No Limit ($0.05/$0.10 USD) - 2021/01/23 5:36:44 ET
Table 'Capricorn II' 6-max Seat #5 is the button
Seat 2: 3EBC96 ($13.66 in chips) 
Seat 3: Picco1952 ($3.58 in chips) 
Seat 4: Chrysk2 ($10.22 in chips) 
Seat 5: jazou10 ($9.99 in chips) 
Seat 6: cruxua ($13.58 in chips) 
cruxua: posts small blind $0.05
3EBC96: posts big blind $0.10
*** HOLE CARDS ***
Picco1952: raises $0.10 to $0.20
Chrysk2: folds 
jazou10: raises $0.20 to $0.40
cruxua: folds 
3EBC96: calls $0.30
Picco1952: calls $0.20
*** FLOP *** [4h 9s Js]
3EBC96: checks 
Picco1952: bets $1.19
jazou10: raises $1.19 to $2.38
3EBC96: folds 
Picco1952: calls $1.19
*** TURN *** [4h 9s Js] [3d]
Picco1952: bets $0.80 and is all-in
jazou10: calls $0.80
*** RIVER *** [4h 9s Js 3d] [Ah]
*** SHOW DOWN ***
Picco1952: shows [2d Ad] (a pair of Aces)
jazou10: shows [Qh Qd] (a pair of Queens)
Picco1952 collected $7.27 from pot
PainForYou25 was removed from the table for failing to post
PainForYou25 leaves the table
*** SUMMARY ***
Total pot $7.61 | Rake $0.34 
Board [4h 9s Js 3d Ah]
Seat 2: 3EBC96 (big blind) folded on the Flop
Seat 3: Picco1952 showed [2d Ad] and won ($7.27) with a pair of Aces
Seat 4: Chrysk2 folded before Flop (didn't bet)
Seat 5: jazou10 (button) showed [Qh Qd] and lost with a pair of Queens
Seat 6: cruxua (small blind) folded before Flop



PokerStars Hand #222949835909:  Hold'em No Limit ($0.05/$0.10 USD) - 2021/01/23 5:37:41 ET
Table 'Capricorn II' 6-max Seat #6 is the button
Seat 2: 3EBC96 ($13.26 in chips) 
Seat 3: Picco1952 ($7.27 in chips) 
Seat 4: Chrysk2 ($10.22 in chips) 
Seat 5: jazou10 ($6.41 in chips) 
Seat 6: cruxua ($13.53 in chips) 
3EBC96: posts small blind $0.05
Picco1952: posts big blind $0.10
*** HOLE CARDS ***
Chrysk2: folds 
Muhlen9 joins the table at seat #1 
jazou10 has timed out
jazou10: folds 
cruxua: raises $0.20 to $0.30
3EBC96: folds 
Picco1952: calls $0.20
*** FLOP *** [6s 9c 2h]
Picco1952: checks 
cruxua: checks 
*** TURN *** [6s 9c 2h] [9s]
Picco1952: bets $0.62
cruxua: folds 
Uncalled bet ($0.62) returned to Picco1952
Picco1952 collected $0.62 from pot
*** SUMMARY ***
Total pot $0.65 | Rake $0.03 
Board [6s 9c 2h 9s]
Seat 2: 3EBC96 (small blind) folded before Flop
Seat 3: Picco1952 (big blind) collected ($0.62)
Seat 4: Chrysk2 folded before Flop (didn't bet)
Seat 5: jazou10 folded before Flop (didn't bet)
Seat 6: cruxua (button) folded on the Turn



PokerStars Hand #222949847568:  Hold'em No Limit ($0.05/$0.10 USD) - 2021/01/23 5:38:18 ET
Table 'Capricorn II' 6-max Seat #2 is the button
Seat 2: 3EBC96 ($13.21 in chips) 
Seat 3: Picco1952 ($7.59 in chips) 
Seat 4: Chrysk2 ($10.22 in chips) 
Seat 5: jazou10 ($6.41 in chips) 
Seat 6: cruxua ($13.23 in chips) 
Picco1952: posts small blind $0.05
Chrysk2: posts big blind $0.10
Muhlen9: sits out 
*** HOLE CARDS ***
jazou10: folds 
cruxua: folds 
3EBC96: folds 
Picco1952: calls $0.05
Chrysk2: checks 
*** FLOP *** [Ah 9h 7c]
Picco1952: bets $0.10
Chrysk2: calls $0.10
*** TURN *** [Ah 9h 7c] [Tc]
Picco1952: bets $0.10
Chrysk2: calls $0.10
*** RIVER *** [Ah 9h 7c Tc] [3h]
Picco1952: checks 
Chrysk2: checks 
*** SHOW DOWN ***
Picco1952: shows [As 5s] (a pair of Aces)
Chrysk2: mucks hand 
Picco1952 collected $0.57 from pot
*** SUMMARY ***
Total pot $0.60 | Rake $0.03 
Board [Ah 9h 7c Tc 3h]
Seat 2: 3EBC96 (button) folded before Flop (didn't bet)
Seat 3: Picco1952 (small blind) showed [As 5s] and won ($0.57) with a pair of Aces
Seat 4: Chrysk2 (big blind) mucked
Seat 5: jazou10 folded before Flop (didn't bet)
Seat 6: cruxua folded before Flop (didn't bet)



PokerStars Hand #222949860306:  Hold'em No Limit ($0.05/$0.10 USD) - 2021/01/23 5:38:59 ET
Table 'Capricorn II' 6-max Seat #3 is the button
Seat 2: 3EBC96 ($13.21 in chips) 
Seat 3: Picco1952 ($7.86 in chips) 
Seat 4: Chrysk2 ($9.92 in chips) 
Seat 5: jazou10 ($6.41 in chips) 
Seat 6: cruxua ($13.23 in chips) 
Chrysk2: posts small blind $0.05
jazou10: posts big blind $0.10
Muhlen9: sits out 
*** HOLE CARDS ***
cruxua: folds 
3EBC96: raises $0.20 to $0.30
Picco1952: folds 
Chrysk2: folds 
jazou10: calls $0.20
*** FLOP *** [Ks 9c Qd]
jazou10: checks 
3EBC96: checks 
*** TURN *** [Ks 9c Qd] [2h]
jazou10: checks 
3EBC96: checks 
*** RIVER *** [Ks 9c Qd 2h] [Tc]
jazou10: checks 
3EBC96: checks 
*** SHOW DOWN ***
jazou10: shows [9s 7d] (a pair of Nines)
3EBC96: mucks hand 
jazou10 collected $0.62 from pot
*** SUMMARY ***
Total pot $0.65 | Rake $0.03 
Board [Ks 9c Qd 2h Tc]
Seat 2: 3EBC96 mucked
Seat 3: Picco1952 (button) folded before Flop (didn't bet)
Seat 4: Chrysk2 (small blind) folded before Flop
Seat 5: jazou10 (big blind) showed [9s 7d] and won ($0.62) with a pair of Nines
Seat 6: cruxua folded before Flop (didn't bet)



PokerStars Hand #222949871801:  Hold'em No Limit ($0.05/$0.10 USD) - 2021/01/23 5:39:35 ET
Table 'Capricorn II' 6-max Seat #4 is the button
Seat 2: 3EBC96 ($12.91 in chips) 
Seat 3: Picco1952 ($7.86 in chips) 
Seat 4: Chrysk2 ($10 in chips) 
Seat 5: jazou10 ($6.73 in chips) 
Seat 6: cruxua ($13.23 in chips) 
jazou10: posts small blind $0.05
cruxua: posts big blind $0.10
Muhlen9: sits out 
*** HOLE CARDS ***
3EBC96: folds 
Picco1952: calls $0.10
Chrysk2: folds 
jazou10: folds 
cruxua: checks 
*** FLOP *** [Tc Th 5s]
cruxua: checks 
Picco1952: checks 
*** TURN *** [Tc Th 5s] [6c]
cruxua: bets $0.16
Picco1952: folds 
Uncalled bet ($0.16) returned to cruxua
cruxua collected $0.24 from pot
cruxua: doesn't show hand 
*** SUMMARY ***
Total pot $0.25 | Rake $0.01 
Board [Tc Th 5s 6c]
Seat 2: 3EBC96 folded before Flop (didn't bet)
Seat 3: Picco1952 folded on the Turn
Seat 4: Chrysk2 (button) folded before Flop (didn't bet)
Seat 5: jazou10 (small blind) folded before Flop
Seat 6: cruxua (big blind) collected ($0.24)



PokerStars Hand #222949879225:  Hold'em No Limit ($0.05/$0.10 USD) - 2021/01/23 5:39:59 ET
Table 'Capricorn II' 6-max Seat #5 is the button
Seat 1: Muhlen9 ($10 in chips) 
Seat 2: 3EBC96 ($12.91 in chips) 
Seat 3: Picco1952 ($7.76 in chips) 
Seat 4: Chrysk2 ($10 in chips) 
Seat 5: jazou10 ($6.68 in chips) 
Seat 6: cruxua ($13.37 in chips) 
cruxua: posts small blind $0.05
Muhlen9: posts big blind $0.10
*** HOLE CARDS ***
3EBC96: raises $0.20 to $0.30
Picco1952: raises $0.20 to $0.50
Chrysk2: folds 
jazou10: folds 
cruxua: folds 
Muhlen9: folds 
3EBC96: calls $0.20
*** FLOP *** [Ad 6c 2d]
3EBC96: checks 
Picco1952: bets $0.10
3EBC96: calls $0.10
*** TURN *** [Ad 6c 2d] [4h]
3EBC96: checks 
Picco1952: bets $1.29
3EBC96: folds 
Uncalled bet ($1.29) returned to Picco1952
Picco1952 collected $1.29 from pot
*** SUMMARY ***
Total pot $1.35 | Rake $0.06 
Board [Ad 6c 2d 4h]
Seat 1: Muhlen9 (big blind) folded before Flop
Seat 2: 3EBC96 folded on the Turn
Seat 3: Picco1952 collected ($1.29)
Seat 4: Chrysk2 folded before Flop (didn't bet)
Seat 5: jazou10 (button) folded before Flop (didn't bet)
Seat 6: cruxua (small blind) folded before Flop



PokerStars Hand #222949889320:  Hold'em No Limit ($0.05/$0.10 USD) - 2021/01/23 5:40:31 ET
Table 'Capricorn II' 6-max Seat #6 is the button
Seat 1: Muhlen9 ($10 in chips) 
Seat 2: 3EBC96 ($12.31 in chips) 
Seat 3: Picco1952 ($8.45 in chips) 
Seat 4: Chrysk2 ($10 in chips) 
Seat 5: jazou10 ($6.68 in chips) 
Seat 6: cruxua ($13.32 in chips) 
Muhlen9: posts small blind $0.05
3EBC96: posts big blind $0.10
*** HOLE CARDS ***
Picco1952: calls $0.10
Chrysk2: folds 
jazou10: folds 
cruxua: raises $0.30 to $0.40
Muhlen9: folds 
3EBC96: folds 
Picco1952: calls $0.30
*** FLOP *** [2h 9s 6h]
Picco1952: checks 
cruxua: bets $0.60
Picco1952: folds 
Uncalled bet ($0.60) returned to cruxua
cruxua collected $0.91 from pot
cruxua: doesn't show hand 
*** SUMMARY ***
Total pot $0.95 | Rake $0.04 
Board [2h 9s 6h]
Seat 1: Muhlen9 (small blind) folded before Flop
Seat 2: 3EBC96 (big blind) folded before Flop
Seat 3: Picco1952 folded on the Flop
Seat 4: Chrysk2 folded before Flop (didn't bet)
Seat 5: jazou10 folded before Flop (didn't bet)
Seat 6: cruxua (button) collected ($0.91)



PokerStars Hand #222949899679:  Hold'em No Limit ($0.05/$0.10 USD) - 2021/01/23 5:41:05 ET
Table 'Capricorn II' 6-max Seat #1 is the button
Seat 1: Muhlen9 ($10 in chips) 
Seat 2: 3EBC96 ($12.21 in chips) 
Seat 3: Picco1952 ($8.05 in chips) 
Seat 4: Chrysk2 ($10 in chips) 
Seat 5: jazou10 ($6.68 in chips) 
Seat 6: cruxua ($13.83 in chips) 
3EBC96: posts small blind $0.05
Picco1952: posts big blind $0.10
*** HOLE CARDS ***
Chrysk2: folds 
jazou10: folds 
cruxua: folds 
Muhlen9: folds 
3EBC96: folds 
Uncalled bet ($0.05) returned to Picco1952
Picco1952 collected $0.10 from pot
*** SUMMARY ***
Total pot $0.10 | Rake $0 
Seat 1: Muhlen9 (button) folded before Flop (didn't bet)
Seat 2: 3EBC96 (small blind) folded before Flop
Seat 3: Picco1952 (big blind) collected ($0.10)
Seat 4: Chrysk2 folded before Flop (didn't bet)
Seat 5: jazou10 folded before Flop (didn't bet)
Seat 6: cruxua folded before Flop (didn't bet)



PokerStars Hand #222949903157:  Hold'em No Limit ($0.05/$0.10 USD) - 2021/01/23 5:41:16 ET
Table 'Capricorn II' 6-max Seat #2 is the button
Seat 1: Muhlen9 ($10 in chips) 
Seat 2: 3EBC96 ($12.16 in chips) 
Seat 3: Picco1952 ($8.10 in chips) 
Seat 4: Chrysk2 ($10 in chips) 
Seat 5: jazou10 ($6.68 in chips) 
Seat 6: cruxua ($13.83 in chips) 
Picco1952: posts small blind $0.05
Chrysk2: posts big blind $0.10
*** HOLE CARDS ***
jazou10: folds 
cruxua: folds 
Muhlen9: folds 
3EBC96: raises $0.20 to $0.30
Picco1952: folds 
Chrysk2: calls $0.20
*** FLOP *** [Ks Th Tc]
Chrysk2: checks 
3EBC96: bets $0.20
Chrysk2: folds 
Uncalled bet ($0.20) returned to 3EBC96
3EBC96 collected $0.62 from pot
3EBC96: doesn't show hand 
*** SUMMARY ***
Total pot $0.65 | Rake $0.03 
Board [Ks Th Tc]
Seat 1: Muhlen9 folded before Flop (didn't bet)
Seat 2: 3EBC96 (button) collected ($0.62)
Seat 3: Picco1952 (small blind) folded before Flop
Seat 4: Chrysk2 (big blind) folded on the Flop
Seat 5: jazou10 folded before Flop (didn't bet)
Seat 6: cruxua folded before Flop (didn't bet)



PokerStars Hand #222949913258:  Hold'em No Limit ($0.05/$0.10 USD) - 2021/01/23 5:41:48 ET
Table 'Capricorn II' 6-max Seat #3 is the button
Seat 1: Muhlen9 ($10 in chips) 
Seat 2: 3EBC96 ($12.48 in chips) 
Seat 3: Picco1952 ($8.05 in chips) 
Seat 4: Chrysk2 ($9.70 in chips) 
Seat 5: jazou10 ($6.68 in chips) 
Seat 6: cruxua ($13.83 in chips) 
Chrysk2: posts small blind $0.05
jazou10: posts big blind $0.10
*** HOLE CARDS ***
cruxua: folds 
Muhlen9: folds 
3EBC96: folds 
Picco1952: raises $0.10 to $0.20
Chrysk2: raises $0.60 to $0.80
jazou10: folds 
Picco1952: calls $0.60
*** FLOP *** [5c 4h 3c]
Chrysk2: checks 
Picco1952: checks 
*** TURN *** [5c 4h 3c] [7h]
Chrysk2: checks 
Picco1952: checks 
*** RIVER *** [5c 4h 3c 7h] [5d]
Chrysk2: checks 
Picco1952: checks 
*** SHOW DOWN ***
Chrysk2: shows [Ts 8s] (a pair of Fives)
Picco1952: shows [Js Ac] (a pair of Fives - Ace kicker)
Picco1952 collected $1.62 from pot
*** SUMMARY ***
Total pot $1.70 | Rake $0.08 
Board [5c 4h 3c 7h 5d]
Seat 1: Muhlen9 folded before Flop (didn't bet)
Seat 2: 3EBC96 folded before Flop (didn't bet)
Seat 3: Picco1952 (button) showed [Js Ac] and won ($1.62) with a pair of Fives
Seat 4: Chrysk2 (small blind) showed [Ts 8s] and lost with a pair of Fives
Seat 5: jazou10 (big blind) folded before Flop
Seat 6: cruxua folded before Flop (didn't bet)



PokerStars Hand #222949925141:  Hold'em No Limit ($0.05/$0.10 USD) - 2021/01/23 5:42:26 ET
Table 'Capricorn II' 6-max Seat #4 is the button
Seat 1: Muhlen9 ($10 in chips) 
Seat 2: 3EBC96 ($12.48 in chips) 
Seat 3: Picco1952 ($8.87 in chips) 
Seat 4: Chrysk2 ($8.90 in chips) 
Seat 5: jazou10 ($6.58 in chips) 
Seat 6: cruxua ($13.83 in chips) 
jazou10: posts small blind $0.05
cruxua: posts big blind $0.10
*** HOLE CARDS ***
Muhlen9: raises $0.15 to $0.25
3EBC96: folds 
Picco1952: folds 
Chrysk2: folds 
jazou10: folds 
cruxua: folds 
Uncalled bet ($0.15) returned to Muhlen9
Muhlen9 collected $0.25 from pot
*** SUMMARY ***
Total pot $0.25 | Rake $0 
Seat 1: Muhlen9 collected ($0.25)
Seat 2: 3EBC96 folded before Flop (didn't bet)
Seat 3: Picco1952 folded before Flop (didn't bet)
Seat 4: Chrysk2 (button) folded before Flop (didn't bet)
Seat 5: jazou10 (small blind) folded before Flop
Seat 6: cruxua (big blind) folded before Flop



PokerStars Hand #222949932165:  Hold'em No Limit ($0.05/$0.10 USD) - 2021/01/23 5:42:49 ET
Table 'Capricorn II' 6-max Seat #5 is the button
Seat 1: Muhlen9 ($10.15 in chips) 
Seat 2: 3EBC96 ($12.48 in chips) 
Seat 3: Picco1952 ($8.87 in chips) 
Seat 4: Chrysk2 ($10 in chips) 
Seat 5: jazou10 ($6.53 in chips) 
Seat 6: cruxua ($13.73 in chips) 
cruxua: posts small blind $0.05
Muhlen9: posts big blind $0.10
*** HOLE CARDS ***
3EBC96: folds 
Picco1952: calls $0.10
Chrysk2: folds 
jazou10: calls $0.10
cruxua: calls $0.05
Muhlen9: checks 
*** FLOP *** [4h Kc 8s]
cruxua: bets $0.29
Muhlen9: folds 
Picco1952: calls $0.29
jazou10: folds 
*** TURN *** [4h Kc 8s] [Qc]
cruxua: bets $0.71
Picco1952: folds 
Uncalled bet ($0.71) returned to cruxua
cruxua collected $0.94 from pot
cruxua: doesn't show hand 
*** SUMMARY ***
Total pot $0.98 | Rake $0.04 
Board [4h Kc 8s Qc]
Seat 1: Muhlen9 (big blind) folded on the Flop
Seat 2: 3EBC96 folded before Flop (didn't bet)
Seat 3: Picco1952 folded on the Turn
Seat 4: Chrysk2 folded before Flop (didn't bet)
Seat 5: jazou10 (button) folded on the Flop
Seat 6: cruxua (small blind) collected ($0.94)



PokerStars Hand #222949943135:  Hold'em No Limit ($0.05/$0.10 USD) - 2021/01/23 5:43:24 ET
Table 'Capricorn II' 6-max Seat #6 is the button
Seat 1: Muhlen9 ($10.05 in chips) 
Seat 2: 3EBC96 ($12.48 in chips) 
Seat 3: Picco1952 ($8.48 in chips) 
Seat 4: Chrysk2 ($10 in chips) 
Seat 5: jazou10 ($6.43 in chips) 
Seat 6: cruxua ($14.28 in chips) 
Muhlen9: posts small blind $0.05
3EBC96: posts big blind $0.10
*** HOLE CARDS ***
Picco1952: folds 
Chrysk2: folds 
jazou10: folds 
cruxua: raises $0.15 to $0.25
Muhlen9: raises $0.65 to $0.90
3EBC96: folds 
cruxua: folds 
Uncalled bet ($0.65) returned to Muhlen9
Muhlen9 collected $0.60 from pot
Muhlen9: doesn't show hand 
*** SUMMARY ***
Total pot $0.60 | Rake $0 
Seat 1: Muhlen9 (small blind) collected ($0.60)
Seat 2: 3EBC96 (big blind) folded before Flop
Seat 3: Picco1952 folded before Flop (didn't bet)
Seat 4: Chrysk2 folded before Flop (didn't bet)
Seat 5: jazou10 folded before Flop (didn't bet)
Seat 6: cruxua (button) folded before Flop



PokerStars Hand #222949949676:  Hold'em No Limit ($0.05/$0.10 USD) - 2021/01/23 5:43:45 ET
Table 'Capricorn II' 6-max Seat #1 is the button
Seat 1: Muhlen9 ($10.40 in chips) 
Seat 2: 3EBC96 ($12.38 in chips) 
Seat 3: Picco1952 ($8.48 in chips) 
Seat 4: Chrysk2 ($10 in chips) 
Seat 5: jazou10 ($6.43 in chips) 
Seat 6: cruxua ($14.03 in chips) 
3EBC96: posts small blind $0.05
Picco1952: posts big blind $0.10
*** HOLE CARDS ***
Chrysk2: folds 
jazou10: calls $0.10
cruxua: folds 
Muhlen9: folds 
3EBC96: folds 
Picco1952: raises $0.10 to $0.20
jazou10: calls $0.10
*** FLOP *** [7s Jd 2d]
Picco1952: checks 
jazou10: checks 
*** TURN *** [7s Jd 2d] [5h]
Picco1952: checks 
jazou10: checks 
*** RIVER *** [7s Jd 2d 5h] [7d]
Picco1952: checks 
jazou10: checks 
*** SHOW DOWN ***
Picco1952: shows [Ad Ts] (a pair of Sevens)
jazou10: mucks hand 
Picco1952 collected $0.43 from pot
*** SUMMARY ***
Total pot $0.45 | Rake $0.02 
Board [7s Jd 2d 5h 7d]
Seat 1: Muhlen9 (button) folded before Flop (didn't bet)
Seat 2: 3EBC96 (small blind) folded before Flop
Seat 3: Picco1952 (big blind) showed [Ad Ts] and won ($0.43) with a pair of Sevens
Seat 4: Chrysk2 folded before Flop (didn't bet)
Seat 5: jazou10 mucked
Seat 6: cruxua folded before Flop (didn't bet)



PokerStars Hand #222949966609:  Hold'em No Limit ($0.05/$0.10 USD) - 2021/01/23 5:44:39 ET
Table 'Capricorn II' 6-max Seat #2 is the button
Seat 1: Muhlen9 ($10.40 in chips) 
Seat 2: 3EBC96 ($12.33 in chips) 
Seat 3: Picco1952 ($8.71 in chips) 
Seat 4: Chrysk2 ($10 in chips) 
Seat 5: jazou10 ($6.23 in chips) 
Seat 6: cruxua ($14.03 in chips) 
Picco1952: posts small blind $0.05
Chrysk2: posts big blind $0.10
*** HOLE CARDS ***
jazou10: calls $0.10
cruxua: raises $0.20 to $0.30
Muhlen9: folds 
3EBC96: raises $0.60 to $0.90
Picco1952: folds 
Chrysk2: folds 
jazou10: folds 
cruxua: raises $1.60 to $2.50
3EBC96: folds 
Uncalled bet ($1.60) returned to cruxua
cruxua collected $2.05 from pot
cruxua: doesn't show hand 
*** SUMMARY ***
Total pot $2.05 | Rake $0 
Seat 1: Muhlen9 folded before Flop (didn't bet)
Seat 2: 3EBC96 (button) folded before Flop
Seat 3: Picco1952 (small blind) folded before Flop
Seat 4: Chrysk2 (big blind) folded before Flop
Seat 5: jazou10 folded before Flop
Seat 6: cruxua collected ($2.05)



PokerStars Hand #222949980471:  Hold'em No Limit ($0.05/$0.10 USD) - 2021/01/23 5:45:22 ET
Table 'Capricorn II' 6-max Seat #3 is the button
Seat 1: Muhlen9 ($10.40 in chips) 
Seat 2: 3EBC96 ($11.43 in chips) 
Seat 3: Picco1952 ($8.66 in chips) 
Seat 4: Chrysk2 ($9.90 in chips) 
Seat 5: jazou10 ($6.13 in chips) 
Seat 6: cruxua ($15.18 in chips) 
Chrysk2: posts small blind $0.05
jazou10: posts big blind $0.10
*** HOLE CARDS ***
cruxua: folds 
Muhlen9: folds 
3EBC96: folds 
Picco1952: calls $0.10
Chrysk2: raises $0.30 to $0.40
jazou10: calls $0.30
Picco1952: calls $0.30
*** FLOP *** [Qc Ah Js]
Chrysk2: bets $0.70
jazou10: calls $0.70
Picco1952: folds 
*** TURN *** [Qc Ah Js] [Tc]
Chrysk2: checks 
jazou10: checks 
*** RIVER *** [Qc Ah Js Tc] [Qd]
Chrysk2: bets $1.86
jazou10: folds 
Uncalled bet ($1.86) returned to Chrysk2
Chrysk2 collected $2.48 from pot
Chrysk2: doesn't show hand 
*** SUMMARY ***
Total pot $2.60 | Rake $0.12 
Board [Qc Ah Js Tc Qd]
Seat 1: Muhlen9 folded before Flop (didn't bet)
Seat 2: 3EBC96 folded before Flop (didn't bet)
Seat 3: Picco1952 (button) folded on the Flop
Seat 4: Chrysk2 (small blind) collected ($2.48)
Seat 5: jazou10 (big blind) folded on the River
Seat 6: cruxua folded before Flop (didn't bet)



PokerStars Hand #222949992254:  Hold'em No Limit ($0.05/$0.10 USD) - 2021/01/23 5:46:00 ET
Table 'Capricorn II' 6-max Seat #4 is the button
Seat 1: Muhlen9 ($10.40 in chips) 
Seat 2: 3EBC96 ($11.43 in chips) 
Seat 3: Picco1952 ($8.26 in chips) 
Seat 4: Chrysk2 ($11.28 in chips) 
Seat 5: jazou10 ($5.03 in chips) 
Seat 6: cruxua ($15.18 in chips) 
jazou10: posts small blind $0.05
cruxua: posts big blind $0.10
*** HOLE CARDS ***
Muhlen9: folds 
3EBC96: folds 
Picco1952: calls $0.10
Chrysk2: folds 
jazou10: calls $0.05
cruxua: checks 
*** FLOP *** [8c 7h 8s]
jazou10: checks 
cruxua: bets $0.19
Picco1952: calls $0.19
jazou10: folds 
*** TURN *** [8c 7h 8s] [6d]
cruxua: bets $0.43
Picco1952: raises $0.43 to $0.86
cruxua: calls $0.43
*** RIVER *** [8c 7h 8s 6d] [7c]
cruxua: checks 
Picco1952: bets $1.15
cruxua: raises $2.65 to $3.80
Picco1952: calls $2.65
*** SHOW DOWN ***
cruxua: shows [8h Kh] (a full house, Eights full of Sevens)
Picco1952: shows [7s 8d] (a full house, Eights full of Sevens)
cruxua collected $4.78 from pot
Picco1952 collected $4.77 from pot
*** SUMMARY ***
Total pot $10 | Rake $0.45 
Board [8c 7h 8s 6d 7c]
Seat 1: Muhlen9 folded before Flop (didn't bet)
Seat 2: 3EBC96 folded before Flop (didn't bet)
Seat 3: Picco1952 showed [7s 8d] and won ($4.77) with a full house, Eights full of Sevens
Seat 4: Chrysk2 (button) folded before Flop (didn't bet)
Seat 5: jazou10 (small blind) folded on the Flop
Seat 6: cruxua (big blind) showed [8h Kh] and won ($4.78) with a full house, Eights full of Sevens



PokerStars Hand #222950012292:  Hold'em No Limit ($0.05/$0.10 USD) - 2021/01/23 5:47:03 ET
Table 'Capricorn II' 6-max Seat #5 is the button
Seat 1: Muhlen9 ($10.40 in chips) 
Seat 2: 3EBC96 ($11.43 in chips) 
Seat 3: Picco1952 ($8.08 in chips) 
Seat 4: Chrysk2 ($11.28 in chips) 
Seat 5: jazou10 ($4.93 in chips) 
Seat 6: cruxua ($15.01 in chips) 
cruxua: posts small blind $0.05
Muhlen9: posts big blind $0.10
*** HOLE CARDS ***
3EBC96: folds 
Picco1952: folds 
Chrysk2: folds 
jazou10: calls $0.10
cruxua: calls $0.05
Muhlen9: checks 
*** FLOP *** [3d 7c Kd]
cruxua: checks 
Muhlen9: checks 
jazou10: bets $0.10
cruxua: folds 
Muhlen9: folds 
Uncalled bet ($0.10) returned to jazou10
jazou10 collected $0.29 from pot
jazou10: doesn't show hand 
*** SUMMARY ***
Total pot $0.30 | Rake $0.01 
Board [3d 7c Kd]
Seat 1: Muhlen9 (big blind) folded on the Flop
Seat 2: 3EBC96 folded before Flop (didn't bet)
Seat 3: Picco1952 folded before Flop (didn't bet)
Seat 4: Chrysk2 folded before Flop (didn't bet)
Seat 5: jazou10 (button) collected ($0.29)
Seat 6: cruxua (small blind) folded on the Flop



PokerStars Hand #222947959124:  Hold'em No Limit ($0.05/$0.10 USD) - 2021/01/23 3:43:19 ET
Table 'Capricorn II' 6-max Seat #4 is the button
Seat 1: Samogonka ($10.05 in chips) 
Seat 2: petrovichkag ($10 in chips) 
Seat 3: AleksCash ($21.19 in chips) 
Seat 4: DONTCALLME8 ($11.20 in chips) 
Seat 5: SickerGC ($8.17 in chips) 
SickerGC: posts small blind $0.05
Samogonka: posts big blind $0.10
*** HOLE CARDS ***
petrovichkag: folds 
AleksCash: folds 
DONTCALLME8 has timed out
DONTCALLME8: folds 
llosjone joins the table at seat #6 
SickerGC: calls $0.05
Samogonka: raises $0.20 to $0.30
SickerGC: calls $0.20
*** FLOP *** [Jh 8c 9s]
SickerGC: checks 
Samogonka: checks 
*** TURN *** [Jh 8c 9s] [Ah]
SickerGC: checks 
Samogonka: bets $0.30
SickerGC: calls $0.30
*** RIVER *** [Jh 8c 9s Ah] [Jc]
SickerGC: checks 
Samogonka: checks 
*** SHOW DOWN ***
SickerGC: shows [3s 7s] (a pair of Jacks)
Samogonka: shows [Tc Ac] (two pair, Aces and Jacks)
Samogonka collected $1.15 from pot
*** SUMMARY ***
Total pot $1.20 | Rake $0.05 
Board [Jh 8c 9s Ah Jc]
Seat 1: Samogonka (big blind) showed [Tc Ac] and won ($1.15) with two pair, Aces and Jacks
Seat 2: petrovichkag folded before Flop (didn't bet)
Seat 3: AleksCash folded before Flop (didn't bet)
Seat 4: DONTCALLME8 (button) folded before Flop (didn't bet)
Seat 5: SickerGC (small blind) showed [3s 7s] and lost with a pair of Jacks



PokerStars Hand #222947972816:  Hold'em No Limit ($0.05/$0.10 USD) - 2021/01/23 3:44:14 ET
Table 'Capricorn II' 6-max Seat #5 is the button
Seat 1: Samogonka ($10.60 in chips) 
Seat 2: petrovichkag ($10 in chips) 
Seat 3: AleksCash ($21.19 in chips) 
Seat 4: DONTCALLME8 ($11.20 in chips) 
Seat 5: SickerGC ($7.57 in chips) 
Samogonka: posts small blind $0.05
petrovichkag: posts big blind $0.10
*** HOLE CARDS ***
AleksCash: folds 
DONTCALLME8: folds 
SickerGC: raises $0.20 to $0.30
Samogonka: folds 
petrovichkag: folds 
Uncalled bet ($0.20) returned to SickerGC
SickerGC collected $0.25 from pot
*** SUMMARY ***
Total pot $0.25 | Rake $0 
Seat 1: Samogonka (small blind) folded before Flop
Seat 2: petrovichkag (big blind) folded before Flop
Seat 3: AleksCash folded before Flop (didn't bet)
Seat 4: DONTCALLME8 folded before Flop (didn't bet)
Seat 5: SickerGC (button) collected ($0.25)



PokerStars Hand #222947977263:  Hold'em No Limit ($0.05/$0.10 USD) - 2021/01/23 3:44:32 ET
Table 'Capricorn II' 6-max Seat #1 is the button
Seat 1: Samogonka ($10.55 in chips) 
Seat 2: petrovichkag ($10 in chips) 
Seat 3: AleksCash ($21.19 in chips) 
Seat 4: DONTCALLME8 ($11.20 in chips) 
Seat 5: SickerGC ($7.72 in chips) 
petrovichkag: posts small blind $0.05
AleksCash: posts big blind $0.10
llosjone: sits out 
*** HOLE CARDS ***
DONTCALLME8: folds 
SickerGC: folds 
Samogonka: folds 
petrovichkag: raises $0.20 to $0.30
AleksCash: folds 
Uncalled bet ($0.20) returned to petrovichkag
petrovichkag collected $0.20 from pot
petrovichkag: doesn't show hand 
*** SUMMARY ***
Total pot $0.20 | Rake $0 
Seat 1: Samogonka (button) folded before Flop (didn't bet)
Seat 2: petrovichkag (small blind) collected ($0.20)
Seat 3: AleksCash (big blind) folded before Flop
Seat 4: DONTCALLME8 folded before Flop (didn't bet)
Seat 5: SickerGC folded before Flop (didn't bet)



PokerStars Hand #222947981710:  Hold'em No Limit ($0.05/$0.10 USD) - 2021/01/23 3:44:50 ET
Table 'Capricorn II' 6-max Seat #2 is the button
Seat 1: Samogonka ($10.55 in chips) 
Seat 2: petrovichkag ($10.10 in chips) 
Seat 3: AleksCash ($21.09 in chips) 
Seat 4: DONTCALLME8 ($11.20 in chips) 
Seat 5: SickerGC ($7.72 in chips) 
AleksCash: posts small blind $0.05
DONTCALLME8: posts big blind $0.10
llosjone: sits out 
*** HOLE CARDS ***
SickerGC: folds 
Samogonka: folds 
petrovichkag: folds 
AleksCash: raises $0.15 to $0.25
DONTCALLME8: raises $0.50 to $0.75
AleksCash: raises $1.70 to $2.45
DONTCALLME8: folds 
Uncalled bet ($1.70) returned to AleksCash
AleksCash collected $1.50 from pot
AleksCash: doesn't show hand 
*** SUMMARY ***
Total pot $1.50 | Rake $0 
Seat 1: Samogonka folded before Flop (didn't bet)
Seat 2: petrovichkag (button) folded before Flop (didn't bet)
Seat 3: AleksCash (small blind) collected ($1.50)
Seat 4: DONTCALLME8 (big blind) folded before Flop
Seat 5: SickerGC folded before Flop (didn't bet)



PokerStars Hand #222947992395:  Hold'em No Limit ($0.05/$0.10 USD) - 2021/01/23 3:45:34 ET
Table 'Capricorn II' 6-max Seat #3 is the button
Seat 1: Samogonka ($10.55 in chips) 
Seat 2: petrovichkag ($10.10 in chips) 
Seat 3: AleksCash ($21.84 in chips) 
Seat 4: DONTCALLME8 ($10.45 in chips) 
Seat 5: SickerGC ($7.72 in chips) 
DONTCALLME8: posts small blind $0.05
SickerGC: posts big blind $0.10
llosjone: sits out 
*** HOLE CARDS ***
Samogonka: raises $0.20 to $0.30
petrovichkag: raises $0.60 to $0.90
AleksCash: folds 
DONTCALLME8: folds 
SickerGC: folds 
Samogonka: calls $0.60
*** FLOP *** [4c 7s 8c]
Samogonka: checks 
petrovichkag: checks 
*** TURN *** [4c 7s 8c] [9h]
Samogonka: checks 
petrovichkag: checks 
*** RIVER *** [4c 7s 8c 9h] [Kd]
Samogonka: checks 
petrovichkag: bets $1.30
Samogonka: folds 
Uncalled bet ($1.30) returned to petrovichkag
petrovichkag collected $1.86 from pot
petrovichkag: doesn't show hand 
*** SUMMARY ***
Total pot $1.95 | Rake $0.09 
Board [4c 7s 8c 9h Kd]
Seat 1: Samogonka folded on the River
Seat 2: petrovichkag collected ($1.86)
Seat 3: AleksCash (button) folded before Flop (didn't bet)
Seat 4: DONTCALLME8 (small blind) folded before Flop
Seat 5: SickerGC (big blind) folded before Flop



PokerStars Hand #222948002675:  Hold'em No Limit ($0.05/$0.10 USD) - 2021/01/23 3:46:15 ET
Table 'Capricorn II' 6-max Seat #4 is the button
Seat 1: Samogonka ($9.65 in chips) 
Seat 2: petrovichkag ($11.06 in chips) 
Seat 3: AleksCash ($21.84 in chips) 
Seat 4: DONTCALLME8 ($10.40 in chips) 
Seat 5: SickerGC ($7.62 in chips) 
Seat 6: llosjone ($10 in chips) 
SickerGC: posts small blind $0.05
llosjone: posts big blind $0.10
*** HOLE CARDS ***
Samogonka: folds 
petrovichkag: folds 
AleksCash: raises $0.15 to $0.25
DONTCALLME8: calls $0.25
SickerGC: folds 
llosjone: calls $0.15
*** FLOP *** [9h 8c 6c]
llosjone: checks 
AleksCash: bets $0.50
DONTCALLME8: folds 
llosjone: raises $0.58 to $1.08
AleksCash: calls $0.58
*** TURN *** [9h 8c 6c] [2h]
llosjone: bets $1.22
AleksCash: calls $1.22
*** RIVER *** [9h 8c 6c 2h] [9d]
llosjone: bets $3.87
AleksCash: raises $8.64 to $12.51
llosjone: calls $3.58 and is all-in
Uncalled bet ($5.06) returned to AleksCash
*** SHOW DOWN ***
AleksCash: shows [9s Ks] (three of a kind, Nines)
llosjone: shows [Ts 7h] (a straight, Six to Ten)
llosjone collected $19.39 from pot
*** SUMMARY ***
Total pot $20.30 | Rake $0.91 
Board [9h 8c 6c 2h 9d]
Seat 1: Samogonka folded before Flop (didn't bet)
Seat 2: petrovichkag folded before Flop (didn't bet)
Seat 3: AleksCash showed [9s Ks] and lost with three of a kind, Nines
Seat 4: DONTCALLME8 (button) folded on the Flop
Seat 5: SickerGC (small blind) folded before Flop
Seat 6: llosjone (big blind) showed [Ts 7h] and won ($19.39) with a straight, Six to Ten



PokerStars Hand #222948020185:  Hold'em No Limit ($0.05/$0.10 USD) - 2021/01/23 3:47:27 ET
Table 'Capricorn II' 6-max Seat #5 is the button
Seat 1: Samogonka ($9.65 in chips) 
Seat 2: petrovichkag ($11.06 in chips) 
Seat 3: AleksCash ($11.84 in chips) 
Seat 4: DONTCALLME8 ($10.15 in chips) 
Seat 5: SickerGC ($7.57 in chips) 
Seat 6: llosjone ($19.39 in chips) 
llosjone: posts small blind $0.05
Samogonka: posts big blind $0.10
*** HOLE CARDS ***
petrovichkag: folds 
AleksCash: raises $0.20 to $0.30
DONTCALLME8: calls $0.30
SickerGC: folds 
llosjone: folds 
Samogonka: folds 
*** FLOP *** [6h Td 2d]
AleksCash: bets $0.45
DONTCALLME8: calls $0.45
*** TURN *** [6h Td 2d] [Kh]
AleksCash: bets $1.10
DONTCALLME8: folds 
Uncalled bet ($1.10) returned to AleksCash
AleksCash collected $1.58 from pot
AleksCash: doesn't show hand 
*** SUMMARY ***
Total pot $1.65 | Rake $0.07 
Board [6h Td 2d Kh]
Seat 1: Samogonka (big blind) folded before Flop
Seat 2: petrovichkag folded before Flop (didn't bet)
Seat 3: AleksCash collected ($1.58)
Seat 4: DONTCALLME8 folded on the Turn
Seat 5: SickerGC (button) folded before Flop (didn't bet)
Seat 6: llosjone (small blind) folded before Flop



PokerStars Hand #222948031402:  Hold'em No Limit ($0.05/$0.10 USD) - 2021/01/23 3:48:12 ET
Table 'Capricorn II' 6-max Seat #6 is the button
Seat 1: Samogonka ($9.55 in chips) 
Seat 2: petrovichkag ($11.06 in chips) 
Seat 3: AleksCash ($12.67 in chips) 
Seat 4: DONTCALLME8 ($9.40 in chips) 
Seat 5: SickerGC ($7.57 in chips) 
Seat 6: llosjone ($19.34 in chips) 
Samogonka: posts small blind $0.05
petrovichkag: posts big blind $0.10
*** HOLE CARDS ***
AleksCash: folds 
DONTCALLME8: folds 
SickerGC: raises $0.20 to $0.30
llosjone: folds 
Samogonka: folds 
petrovichkag: calls $0.20
*** FLOP *** [8s 4d 2d]
petrovichkag: checks 
SickerGC: bets $0.31
petrovichkag: calls $0.31
*** TURN *** [8s 4d 2d] [Kd]
petrovichkag: checks 
SickerGC: checks 
*** RIVER *** [8s 4d 2d Kd] [7s]
petrovichkag: bets $0.94
SickerGC: folds 
Uncalled bet ($0.94) returned to petrovichkag
petrovichkag collected $1.21 from pot
petrovichkag: doesn't show hand 
*** SUMMARY ***
Total pot $1.27 | Rake $0.06 
Board [8s 4d 2d Kd 7s]
Seat 1: Samogonka (small blind) folded before Flop
Seat 2: petrovichkag (big blind) collected ($1.21)
Seat 3: AleksCash folded before Flop (didn't bet)
Seat 4: DONTCALLME8 folded before Flop (didn't bet)
Seat 5: SickerGC folded on the River
Seat 6: llosjone (button) folded before Flop (didn't bet)



PokerStars Hand #222948045187:  Hold'em No Limit ($0.05/$0.10 USD) - 2021/01/23 3:49:07 ET
Table 'Capricorn II' 6-max Seat #1 is the button
Seat 1: Samogonka ($9.50 in chips) 
Seat 2: petrovichkag ($11.66 in chips) 
Seat 3: AleksCash ($12.67 in chips) 
Seat 4: DONTCALLME8 ($9.40 in chips) 
Seat 5: SickerGC ($6.96 in chips) 
Seat 6: llosjone ($19.34 in chips) 
petrovichkag: posts small blind $0.05
AleksCash: posts big blind $0.10
*** HOLE CARDS ***
DONTCALLME8: folds 
SickerGC: calls $0.10
llosjone: folds 
Samogonka: folds 
petrovichkag: folds 
AleksCash: checks 
*** FLOP *** [5d 6s Ah]
AleksCash: checks 
SickerGC: checks 
*** TURN *** [5d 6s Ah] [Kc]
AleksCash: bets $0.16
SickerGC: folds 
Uncalled bet ($0.16) returned to AleksCash
AleksCash collected $0.24 from pot
AleksCash: doesn't show hand 
*** SUMMARY ***
Total pot $0.25 | Rake $0.01 
Board [5d 6s Ah Kc]
Seat 1: Samogonka (button) folded before Flop (didn't bet)
Seat 2: petrovichkag (small blind) folded before Flop
Seat 3: AleksCash (big blind) collected ($0.24)
Seat 4: DONTCALLME8 folded before Flop (didn't bet)
Seat 5: SickerGC folded on the Turn
Seat 6: llosjone folded before Flop (didn't bet)



PokerStars Hand #222948055256:  Hold'em No Limit ($0.05/$0.10 USD) - 2021/01/23 3:49:48 ET
Table 'Capricorn II' 6-max Seat #2 is the button
Seat 1: Samogonka ($9.50 in chips) 
Seat 2: petrovichkag ($11.61 in chips) 
Seat 3: AleksCash ($12.81 in chips) 
Seat 4: DONTCALLME8 ($9.40 in chips) 
Seat 5: SickerGC ($6.86 in chips) 
Seat 6: llosjone ($19.34 in chips) 
AleksCash: posts small blind $0.05
DONTCALLME8: posts big blind $0.10
*** HOLE CARDS ***
SickerGC: folds 
llosjone: raises $0.15 to $0.25
Samogonka: folds 
petrovichkag: calls $0.25
AleksCash: raises $1.15 to $1.40
DONTCALLME8: folds 
llosjone: folds 
petrovichkag: folds 
Uncalled bet ($1.15) returned to AleksCash
AleksCash collected $0.85 from pot
AleksCash: doesn't show hand 
*** SUMMARY ***
Total pot $0.85 | Rake $0 
Seat 1: Samogonka folded before Flop (didn't bet)
Seat 2: petrovichkag (button) folded before Flop
Seat 3: AleksCash (small blind) collected ($0.85)
Seat 4: DONTCALLME8 (big blind) folded before Flop
Seat 5: SickerGC folded before Flop (didn't bet)
Seat 6: llosjone folded before Flop



PokerStars Hand #222948060955:  Hold'em No Limit ($0.05/$0.10 USD) - 2021/01/23 3:50:11 ET
Table 'Capricorn II' 6-max Seat #3 is the button
Seat 1: Samogonka ($9.50 in chips) 
Seat 2: petrovichkag ($11.36 in chips) 
Seat 3: AleksCash ($13.41 in chips) 
Seat 4: DONTCALLME8 ($9.30 in chips) 
Seat 5: SickerGC ($6.86 in chips) 
Seat 6: llosjone ($19.09 in chips) 
DONTCALLME8: posts small blind $0.05
SickerGC: posts big blind $0.10
*** HOLE CARDS ***
llosjone: raises $0.10 to $0.20
Samogonka: folds 
petrovichkag: folds 
AleksCash: folds 
DONTCALLME8: raises $0.60 to $0.80
SickerGC: folds 
llosjone: folds 
Uncalled bet ($0.60) returned to DONTCALLME8
DONTCALLME8 collected $0.50 from pot
DONTCALLME8: doesn't show hand 
*** SUMMARY ***
Total pot $0.50 | Rake $0 
Seat 1: Samogonka folded before Flop (didn't bet)
Seat 2: petrovichkag folded before Flop (didn't bet)
Seat 3: AleksCash (button) folded before Flop (didn't bet)
Seat 4: DONTCALLME8 (small blind) collected ($0.50)
Seat 5: SickerGC (big blind) folded before Flop
Seat 6: llosjone folded before Flop



PokerStars Hand #222948065701:  Hold'em No Limit ($0.05/$0.10 USD) - 2021/01/23 3:50:30 ET
Table 'Capricorn II' 6-max Seat #4 is the button
Seat 1: Samogonka ($9.50 in chips) 
Seat 2: petrovichkag ($11.36 in chips) 
Seat 3: AleksCash ($13.41 in chips) 
Seat 4: DONTCALLME8 ($9.60 in chips) 
Seat 5: SickerGC ($6.76 in chips) 
Seat 6: llosjone ($18.89 in chips) 
SickerGC: posts small blind $0.05
llosjone: posts big blind $0.10
*** HOLE CARDS ***
Samogonka: folds 
petrovichkag: folds 
AleksCash: folds 
DONTCALLME8: raises $0.20 to $0.30
SickerGC: folds 
llosjone: folds 
Uncalled bet ($0.20) returned to DONTCALLME8
DONTCALLME8 collected $0.25 from pot
DONTCALLME8: doesn't show hand 
*** SUMMARY ***
Total pot $0.25 | Rake $0 
Seat 1: Samogonka folded before Flop (didn't bet)
Seat 2: petrovichkag folded before Flop (didn't bet)
Seat 3: AleksCash folded before Flop (didn't bet)
Seat 4: DONTCALLME8 (button) collected ($0.25)
Seat 5: SickerGC (small blind) folded before Flop
Seat 6: llosjone (big blind) folded before Flop



PokerStars Hand #222948069669:  Hold'em No Limit ($0.05/$0.10 USD) - 2021/01/23 3:50:46 ET
Table 'Capricorn II' 6-max Seat #5 is the button
Seat 1: Samogonka ($9.50 in chips) 
Seat 2: petrovichkag ($11.36 in chips) 
Seat 3: AleksCash ($13.41 in chips) 
Seat 4: DONTCALLME8 ($9.75 in chips) 
Seat 5: SickerGC ($6.71 in chips) 
Seat 6: llosjone ($18.79 in chips) 
llosjone: posts small blind $0.05
Samogonka: posts big blind $0.10
*** HOLE CARDS ***
petrovichkag: folds 
AleksCash: raises $0.20 to $0.30
DONTCALLME8: folds 
SickerGC: folds 
llosjone: folds 
Samogonka: folds 
Uncalled bet ($0.20) returned to AleksCash
AleksCash collected $0.25 from pot
AleksCash: doesn't show hand 
*** SUMMARY ***
Total pot $0.25 | Rake $0 
Seat 1: Samogonka (big blind) folded before Flop
Seat 2: petrovichkag folded before Flop (didn't bet)
Seat 3: AleksCash collected ($0.25)
Seat 4: DONTCALLME8 folded before Flop (didn't bet)
Seat 5: SickerGC (button) folded before Flop (didn't bet)
Seat 6: llosjone (small blind) folded before Flop



PokerStars Hand #222948074018:  Hold'em No Limit ($0.05/$0.10 USD) - 2021/01/23 3:51:04 ET
Table 'Capricorn II' 6-max Seat #6 is the button
Seat 1: Samogonka ($9.40 in chips) 
Seat 2: petrovichkag ($11.36 in chips) 
Seat 3: AleksCash ($13.56 in chips) 
Seat 4: DONTCALLME8 ($9.75 in chips) 
Seat 5: SickerGC ($6.71 in chips) 
Seat 6: llosjone ($18.74 in chips) 
Samogonka: posts small blind $0.05
petrovichkag: posts big blind $0.10
*** HOLE CARDS ***
AleksCash: folds 
DONTCALLME8: folds 
SickerGC: calls $0.10
llosjone: folds 
Samogonka: calls $0.05
petrovichkag: checks 
*** FLOP *** [7s 5c Js]
Samogonka: bets $0.20
DONTCALLME8 is disconnected 
petrovichkag: folds 
SickerGC: calls $0.20
*** TURN *** [7s 5c Js] [3d]
Samogonka: bets $0.30
SickerGC: calls $0.30
*** RIVER *** [7s 5c Js 3d] [6h]
Samogonka: checks 
SickerGC: checks 
*** SHOW DOWN ***
Samogonka: shows [Jh 8h] (a pair of Jacks)
SickerGC: mucks hand 
Samogonka collected $1.24 from pot
*** SUMMARY ***
Total pot $1.30 | Rake $0.06 
Board [7s 5c Js 3d 6h]
Seat 1: Samogonka (small blind) showed [Jh 8h] and won ($1.24) with a pair of Jacks
Seat 2: petrovichkag (big blind) folded on the Flop
Seat 3: AleksCash folded before Flop (didn't bet)
Seat 4: DONTCALLME8 folded before Flop (didn't bet)
Seat 5: SickerGC mucked
Seat 6: llosjone (button) folded before Flop (didn't bet)



PokerStars Hand #222948085677:  Hold'em No Limit ($0.05/$0.10 USD) - 2021/01/23 3:51:51 ET
Table 'Capricorn II' 6-max Seat #1 is the button
Seat 1: Samogonka ($10.04 in chips) 
Seat 2: petrovichkag ($11.26 in chips) 
Seat 3: AleksCash ($13.56 in chips) 
Seat 4: DONTCALLME8 ($9.75 in chips) 
Seat 5: SickerGC ($6.11 in chips) 
Seat 6: llosjone ($18.74 in chips) 
petrovichkag: posts small blind $0.05
AleksCash: posts big blind $0.10
*** HOLE CARDS ***
DONTCALLME8: folds 
SickerGC: folds 
llosjone: folds 
Samogonka: folds 
petrovichkag: folds 
Uncalled bet ($0.05) returned to AleksCash
AleksCash collected $0.10 from pot
AleksCash: doesn't show hand 
*** SUMMARY ***
Total pot $0.10 | Rake $0 
Seat 1: Samogonka (button) folded before Flop (didn't bet)
Seat 2: petrovichkag (small blind) folded before Flop
Seat 3: AleksCash (big blind) collected ($0.10)
Seat 4: DONTCALLME8 folded before Flop (didn't bet)
Seat 5: SickerGC folded before Flop (didn't bet)
Seat 6: llosjone folded before Flop (didn't bet)



PokerStars Hand #222948088303:  Hold'em No Limit ($0.05/$0.10 USD) - 2021/01/23 3:52:01 ET
Table 'Capricorn II' 6-max Seat #2 is the button
Seat 1: Samogonka ($10.04 in chips) 
Seat 2: petrovichkag ($11.21 in chips) 
Seat 3: AleksCash ($13.61 in chips) 
Seat 4: DONTCALLME8 ($9.75 in chips) 
Seat 5: SickerGC ($6.11 in chips) 
Seat 6: llosjone ($18.74 in chips) 
AleksCash: posts small blind $0.05
DONTCALLME8: posts big blind $0.10
*** HOLE CARDS ***
SickerGC: folds 
llosjone: folds 
Samogonka: folds 
petrovichkag: raises $0.14 to $0.24
AleksCash: folds 
DONTCALLME8: calls $0.14
*** FLOP *** [2h 3s 8c]
DONTCALLME8: checks 
petrovichkag: bets $0.28
DONTCALLME8: folds 
Uncalled bet ($0.28) returned to petrovichkag
petrovichkag collected $0.51 from pot
petrovichkag: doesn't show hand 
*** SUMMARY ***
Total pot $0.53 | Rake $0.02 
Board [2h 3s 8c]
Seat 1: Samogonka folded before Flop (didn't bet)
Seat 2: petrovichkag (button) collected ($0.51)
Seat 3: AleksCash (small blind) folded before Flop
Seat 4: DONTCALLME8 (big blind) folded on the Flop
Seat 5: SickerGC folded before Flop (didn't bet)
Seat 6: llosjone folded before Flop (didn't bet)



PokerStars Hand #222948094556:  Hold'em No Limit ($0.05/$0.10 USD) - 2021/01/23 3:52:26 ET
Table 'Capricorn II' 6-max Seat #3 is the button
Seat 1: Samogonka ($10.04 in chips) 
Seat 2: petrovichkag ($11.48 in chips) 
Seat 3: AleksCash ($13.56 in chips) 
Seat 4: DONTCALLME8 ($9.51 in chips) 
Seat 5: SickerGC ($6.11 in chips) 
Seat 6: llosjone ($18.74 in chips) 
DONTCALLME8: posts small blind $0.05
SickerGC: posts big blind $0.10
*** HOLE CARDS ***
llosjone: folds 
Samogonka: raises $0.20 to $0.30
petrovichkag: folds 
AleksCash: folds 
DONTCALLME8: calls $0.25
SickerGC: folds 
*** FLOP *** [4c 5d 5c]
DONTCALLME8: checks 
Samogonka: bets $0.40
DONTCALLME8: calls $0.40
*** TURN *** [4c 5d 5c] [Js]
DONTCALLME8: checks 
Samogonka: checks 
*** RIVER *** [4c 5d 5c Js] [7s]
DONTCALLME8: bets $1.01
Samogonka: calls $1.01
*** SHOW DOWN ***
DONTCALLME8: shows [5h Ah] (three of a kind, Fives)
Samogonka: mucks hand 
DONTCALLME8 collected $3.36 from pot
*** SUMMARY ***
Total pot $3.52 | Rake $0.16 
Board [4c 5d 5c Js 7s]
Seat 1: Samogonka mucked
Seat 2: petrovichkag folded before Flop (didn't bet)
Seat 3: AleksCash (button) folded before Flop (didn't bet)
Seat 4: DONTCALLME8 (small blind) showed [5h Ah] and won ($3.36) with three of a kind, Fives
Seat 5: SickerGC (big blind) folded before Flop
Seat 6: llosjone folded before Flop (didn't bet)



PokerStars Hand #222948109343:  Hold'em No Limit ($0.05/$0.10 USD) - 2021/01/23 3:53:26 ET
Table 'Capricorn II' 6-max Seat #4 is the button
Seat 1: Samogonka ($8.33 in chips) 
Seat 2: petrovichkag ($11.48 in chips) 
Seat 3: AleksCash ($13.56 in chips) 
Seat 4: DONTCALLME8 ($11.16 in chips) 
Seat 5: SickerGC ($6.01 in chips) 
Seat 6: llosjone ($18.74 in chips) 
SickerGC: posts small blind $0.05
llosjone: posts big blind $0.10
*** HOLE CARDS ***
Samogonka: folds 
petrovichkag: folds 
AleksCash: folds 
DONTCALLME8: folds 
SickerGC: calls $0.05
llosjone: checks 
*** FLOP *** [5s Js 7h]
SickerGC: checks 
llosjone: checks 
*** TURN *** [5s Js 7h] [Jh]
SickerGC: checks 
llosjone: checks 
*** RIVER *** [5s Js 7h Jh] [Qc]
SickerGC: checks 
llosjone: checks 
*** SHOW DOWN ***
SickerGC: shows [6c 3s] (a pair of Jacks)
llosjone: shows [Qh 9h] (two pair, Queens and Jacks)
llosjone collected $0.19 from pot
*** SUMMARY ***
Total pot $0.20 | Rake $0.01 
Board [5s Js 7h Jh Qc]
Seat 1: Samogonka folded before Flop (didn't bet)
Seat 2: petrovichkag folded before Flop (didn't bet)
Seat 3: AleksCash folded before Flop (didn't bet)
Seat 4: DONTCALLME8 (button) folded before Flop (didn't bet)
Seat 5: SickerGC (small blind) showed [6c 3s] and lost with a pair of Jacks
Seat 6: llosjone (big blind) showed [Qh 9h] and won ($0.19) with two pair, Queens and Jacks



PokerStars Hand #222948116248:  Hold'em No Limit ($0.05/$0.10 USD) - 2021/01/23 3:53:54 ET
Table 'Capricorn II' 6-max Seat #5 is the button
Seat 1: Samogonka ($8.33 in chips) 
Seat 2: petrovichkag ($11.48 in chips) 
Seat 3: AleksCash ($13.56 in chips) 
Seat 4: DONTCALLME8 ($11.16 in chips) 
Seat 5: SickerGC ($5.91 in chips) 
Seat 6: llosjone ($18.83 in chips) 
llosjone: posts small blind $0.05
Samogonka: posts big blind $0.10
*** HOLE CARDS ***
petrovichkag: folds 
AleksCash: folds 
DONTCALLME8: raises $0.16 to $0.26
SickerGC: calls $0.26
llosjone: calls $0.21
Samogonka: folds 
*** FLOP *** [Tc 6s Jh]
llosjone: checks 
DONTCALLME8: checks 
SickerGC: bets $5.65 and is all-in
llosjone: folds 
DONTCALLME8: folds 
Uncalled bet ($5.65) returned to SickerGC
SickerGC collected $0.84 from pot
*** SUMMARY ***
Total pot $0.88 | Rake $0.04 
Board [Tc 6s Jh]
Seat 1: Samogonka (big blind) folded before Flop
Seat 2: petrovichkag folded before Flop (didn't bet)
Seat 3: AleksCash folded before Flop (didn't bet)
Seat 4: DONTCALLME8 folded on the Flop
Seat 5: SickerGC (button) collected ($0.84)
Seat 6: llosjone (small blind) folded on the Flop



PokerStars Hand #222948129763:  Hold'em No Limit ($0.05/$0.10 USD) - 2021/01/23 3:54:49 ET
Table 'Capricorn II' 6-max Seat #6 is the button
Seat 1: Samogonka ($8.23 in chips) 
Seat 2: petrovichkag ($11.48 in chips) 
Seat 3: AleksCash ($13.56 in chips) 
Seat 4: DONTCALLME8 ($10.90 in chips) 
Seat 6: llosjone ($18.57 in chips) 
Samogonka: posts small blind $0.05
petrovichkag: posts big blind $0.10
*** HOLE CARDS ***
AleksCash: raises $0.20 to $0.30
DONTCALLME8: folds 
llosjone: folds 
Samogonka: folds 
petrovichkag: folds 
Uncalled bet ($0.20) returned to AleksCash
AleksCash collected $0.25 from pot
AleksCash: doesn't show hand 
*** SUMMARY ***
Total pot $0.25 | Rake $0 
Seat 1: Samogonka (small blind) folded before Flop
Seat 2: petrovichkag (big blind) folded before Flop
Seat 3: AleksCash collected ($0.25)
Seat 4: DONTCALLME8 folded before Flop (didn't bet)
Seat 6: llosjone (button) folded before Flop (didn't bet)



PokerStars Hand #222948131953:  Hold'em No Limit ($0.05/$0.10 USD) - 2021/01/23 3:54:57 ET
Table 'Capricorn II' 6-max Seat #1 is the button
Seat 1: Samogonka ($8.18 in chips) 
Seat 2: petrovichkag ($11.38 in chips) 
Seat 3: AleksCash ($13.71 in chips) 
Seat 4: DONTCALLME8 ($10.90 in chips) 
Seat 6: llosjone ($18.57 in chips) 
petrovichkag: posts small blind $0.05
AleksCash: posts big blind $0.10
*** HOLE CARDS ***
DONTCALLME8: folds 
llosjone: folds 
Samogonka: folds 
petrovichkag: raises $0.20 to $0.30
AleksCash: calls $0.20
*** FLOP *** [9h 6s Qh]
petrovichkag: bets $0.19
AleksCash: calls $0.19
*** TURN *** [9h 6s Qh] [Qs]
petrovichkag: checks 
AleksCash: bets $0.94
petrovichkag: raises $2.20 to $3.14
AleksCash: raises $10.08 to $13.22 and is all-in
petrovichkag: folds 
Uncalled bet ($10.08) returned to AleksCash
AleksCash collected $6.93 from pot
AleksCash: doesn't show hand 
*** SUMMARY ***
Total pot $7.26 | Rake $0.33 
Board [9h 6s Qh Qs]
Seat 1: Samogonka (button) folded before Flop (didn't bet)
Seat 2: petrovichkag (small blind) folded on the Turn
Seat 3: AleksCash (big blind) collected ($6.93)
Seat 4: DONTCALLME8 folded before Flop (didn't bet)
Seat 6: llosjone folded before Flop (didn't bet)



PokerStars Hand #222948142455:  Hold'em No Limit ($0.05/$0.10 USD) - 2021/01/23 3:55:47 ET
Table 'Capricorn II' 6-max Seat #2 is the button
Seat 1: Samogonka ($8.18 in chips) 
Seat 2: petrovichkag ($10 in chips) 
Seat 3: AleksCash ($17.01 in chips) 
Seat 4: DONTCALLME8 ($10.90 in chips) 
Seat 6: llosjone ($18.57 in chips) 
AleksCash: posts small blind $0.05
DONTCALLME8: posts big blind $0.10
*** HOLE CARDS ***
llosjone: folds 
Samogonka: folds 
petrovichkag: folds 
AleksCash: raises $0.15 to $0.25
DONTCALLME8: calls $0.15
*** FLOP *** [8s Qc As]
AleksCash: bets $0.25
DONTCALLME8: calls $0.25
*** TURN *** [8s Qc As] [6h]
AleksCash: bets $0.70
DONTCALLME8: calls $0.70
*** RIVER *** [8s Qc As 6h] [Kd]
AleksCash: checks 
DONTCALLME8: bets $1.34
AleksCash: folds 
Uncalled bet ($1.34) returned to DONTCALLME8
DONTCALLME8 collected $2.29 from pot
DONTCALLME8: doesn't show hand 
*** SUMMARY ***
Total pot $2.40 | Rake $0.11 
Board [8s Qc As 6h Kd]
Seat 1: Samogonka folded before Flop (didn't bet)
Seat 2: petrovichkag (button) folded before Flop (didn't bet)
Seat 3: AleksCash (small blind) folded on the River
Seat 4: DONTCALLME8 (big blind) collected ($2.29)
Seat 6: llosjone folded before Flop (didn't bet)



PokerStars Hand #222948157132:  Hold'em No Limit ($0.05/$0.10 USD) - 2021/01/23 3:56:58 ET
Table 'Capricorn II' 6-max Seat #4 is the button
Seat 1: Samogonka ($8.18 in chips) 
Seat 2: petrovichkag ($10 in chips) 
Seat 3: AleksCash ($15.81 in chips) 
Seat 4: DONTCALLME8 ($11.94 in chips) 
Seat 5: SickerGC ($6.76 in chips) 
Seat 6: llosjone ($18.57 in chips) 
SickerGC: posts small blind $0.05
llosjone: posts big blind $0.10
*** HOLE CARDS ***
Samogonka: folds 
petrovichkag: folds 
AleksCash: folds 
DONTCALLME8: folds 
SickerGC: calls $0.05
llosjone: checks 
*** FLOP *** [8h 8s 6h]
SickerGC: bets $0.10
llosjone: folds 
Uncalled bet ($0.10) returned to SickerGC
SickerGC collected $0.19 from pot
*** SUMMARY ***
Total pot $0.20 | Rake $0.01 
Board [8h 8s 6h]
Seat 1: Samogonka folded before Flop (didn't bet)
Seat 2: petrovichkag folded before Flop (didn't bet)
Seat 3: AleksCash folded before Flop (didn't bet)
Seat 4: DONTCALLME8 (button) folded before Flop (didn't bet)
Seat 5: SickerGC (small blind) collected ($0.19)
Seat 6: llosjone (big blind) folded on the Flop



PokerStars Hand #222948160616:  Hold'em No Limit ($0.05/$0.10 USD) - 2021/01/23 3:57:15 ET
Table 'Capricorn II' 6-max Seat #5 is the button
Seat 1: Samogonka ($8.18 in chips) 
Seat 2: petrovichkag ($10 in chips) 
Seat 3: AleksCash ($15.81 in chips) 
Seat 4: DONTCALLME8 ($11.94 in chips) 
Seat 5: SickerGC ($6.85 in chips) 
Seat 6: llosjone ($18.47 in chips) 
llosjone: posts small blind $0.05
Samogonka: posts big blind $0.10
*** HOLE CARDS ***
petrovichkag: folds 
AleksCash: folds 
DONTCALLME8: folds 
SickerGC: raises $0.20 to $0.30
llosjone: folds 
Samogonka: folds 
Uncalled bet ($0.20) returned to SickerGC
SickerGC collected $0.25 from pot
*** SUMMARY ***
Total pot $0.25 | Rake $0 
Seat 1: Samogonka (big blind) folded before Flop
Seat 2: petrovichkag folded before Flop (didn't bet)
Seat 3: AleksCash folded before Flop (didn't bet)
Seat 4: DONTCALLME8 folded before Flop (didn't bet)
Seat 5: SickerGC (button) collected ($0.25)
Seat 6: llosjone (small blind) folded before Flop



PokerStars Hand #222948165230:  Hold'em No Limit ($0.05/$0.10 USD) - 2021/01/23 3:57:37 ET
Table 'Capricorn II' 6-max Seat #6 is the button
Seat 1: Samogonka ($8.08 in chips) 
Seat 2: petrovichkag ($10 in chips) 
Seat 3: AleksCash ($15.81 in chips) 
Seat 4: DONTCALLME8 ($11.94 in chips) 
Seat 5: SickerGC ($7 in chips) 
Seat 6: llosjone ($18.42 in chips) 
Samogonka: posts small blind $0.05
petrovichkag: posts big blind $0.10
*** HOLE CARDS ***
AleksCash: raises $0.20 to $0.30
DONTCALLME8: folds 
SickerGC: folds 
llosjone: folds 
Samogonka: folds 
petrovichkag: folds 
Uncalled bet ($0.20) returned to AleksCash
AleksCash collected $0.25 from pot
AleksCash: doesn't show hand 
*** SUMMARY ***
Total pot $0.25 | Rake $0 
Seat 1: Samogonka (small blind) folded before Flop
Seat 2: petrovichkag (big blind) folded before Flop
Seat 3: AleksCash collected ($0.25)
Seat 4: DONTCALLME8 folded before Flop (didn't bet)
Seat 5: SickerGC folded before Flop (didn't bet)
Seat 6: llosjone (button) folded before Flop (didn't bet)



PokerStars Hand #222948167274:  Hold'em No Limit ($0.05/$0.10 USD) - 2021/01/23 3:57:46 ET
Table 'Capricorn II' 6-max Seat #1 is the button
Seat 1: Samogonka ($8.03 in chips) 
Seat 2: petrovichkag ($10 in chips) 
Seat 3: AleksCash ($15.96 in chips) 
Seat 4: DONTCALLME8 ($11.94 in chips) 
Seat 5: SickerGC ($7 in chips) 
Seat 6: llosjone ($18.42 in chips) 
petrovichkag: posts small blind $0.05
AleksCash: posts big blind $0.10
*** HOLE CARDS ***
DONTCALLME8: folds 
SickerGC: folds 
llosjone: folds 
Samogonka: folds 
petrovichkag: folds 
Uncalled bet ($0.05) returned to AleksCash
AleksCash collected $0.10 from pot
AleksCash: doesn't show hand 
*** SUMMARY ***
Total pot $0.10 | Rake $0 
Seat 1: Samogonka (button) folded before Flop (didn't bet)
Seat 2: petrovichkag (small blind) folded before Flop
Seat 3: AleksCash (big blind) collected ($0.10)
Seat 4: DONTCALLME8 folded before Flop (didn't bet)
Seat 5: SickerGC folded before Flop (didn't bet)
Seat 6: llosjone folded before Flop (didn't bet)



PokerStars Hand #222948170238:  Hold'em No Limit ($0.05/$0.10 USD) - 2021/01/23 3:58:00 ET
Table 'Capricorn II' 6-max Seat #2 is the button
Seat 1: Samogonka ($8.03 in chips) 
Seat 2: petrovichkag ($10 in chips) 
Seat 3: AleksCash ($16.01 in chips) 
Seat 4: DONTCALLME8 ($11.94 in chips) 
Seat 5: SickerGC ($7 in chips) 
Seat 6: llosjone ($18.42 in chips) 
AleksCash: posts small blind $0.05
DONTCALLME8: posts big blind $0.10
*** HOLE CARDS ***
SickerGC: folds 
llosjone: raises $0.15 to $0.25
Samogonka: folds 
petrovichkag: folds 
AleksCash: folds 
DONTCALLME8: calls $0.15
*** FLOP *** [Ah 5d 8h]
DONTCALLME8: checks 
llosjone: bets $0.17
DONTCALLME8: calls $0.17
*** TURN *** [Ah 5d 8h] [5s]
DONTCALLME8: checks 
llosjone: checks 
*** RIVER *** [Ah 5d 8h 5s] [Tc]
DONTCALLME8: bets $0.52
llosjone: folds 
Uncalled bet ($0.52) returned to DONTCALLME8
DONTCALLME8 collected $0.85 from pot
DONTCALLME8: doesn't show hand 
*** SUMMARY ***
Total pot $0.89 | Rake $0.04 
Board [Ah 5d 8h 5s Tc]
Seat 1: Samogonka folded before Flop (didn't bet)
Seat 2: petrovichkag (button) folded before Flop (didn't bet)
Seat 3: AleksCash (small blind) folded before Flop
Seat 4: DONTCALLME8 (big blind) collected ($0.85)
Seat 5: SickerGC folded before Flop (didn't bet)
Seat 6: llosjone folded on the River



PokerStars Hand #222948176897:  Hold'em No Limit ($0.05/$0.10 USD) - 2021/01/23 3:58:32 ET
Table 'Capricorn II' 6-max Seat #3 is the button
Seat 1: Samogonka ($8.03 in chips) 
Seat 2: petrovichkag ($10 in chips) 
Seat 3: AleksCash ($15.96 in chips) 
Seat 4: DONTCALLME8 ($12.37 in chips) 
Seat 5: SickerGC ($7 in chips) 
Seat 6: llosjone ($18 in chips) 
DONTCALLME8: posts small blind $0.05
SickerGC: posts big blind $0.10
*** HOLE CARDS ***
llosjone: folds 
Samogonka: folds 
petrovichkag: folds 
AleksCash: folds 
DONTCALLME8: raises $0.15 to $0.25
SickerGC: raises $0.15 to $0.40
DONTCALLME8: calls $0.15
*** FLOP *** [Ad 4s 2d]
DONTCALLME8: checks 
SickerGC: bets $0.76
DONTCALLME8: folds 
Uncalled bet ($0.76) returned to SickerGC
SickerGC collected $0.76 from pot
*** SUMMARY ***
Total pot $0.80 | Rake $0.04 
Board [Ad 4s 2d]
Seat 1: Samogonka folded before Flop (didn't bet)
Seat 2: petrovichkag folded before Flop (didn't bet)
Seat 3: AleksCash (button) folded before Flop (didn't bet)
Seat 4: DONTCALLME8 (small blind) folded on the Flop
Seat 5: SickerGC (big blind) collected ($0.76)
Seat 6: llosjone folded before Flop (didn't bet)



PokerStars Hand #222948182882:  Hold'em No Limit ($0.05/$0.10 USD) - 2021/01/23 3:59:00 ET
Table 'Capricorn II' 6-max Seat #4 is the button
Seat 1: Samogonka ($8.03 in chips) 
Seat 2: petrovichkag ($10 in chips) 
Seat 3: AleksCash ($15.96 in chips) 
Seat 4: DONTCALLME8 ($11.97 in chips) 
Seat 5: SickerGC ($7.36 in chips) 
Seat 6: llosjone ($18 in chips) 
SickerGC: posts small blind $0.05
llosjone: posts big blind $0.10
*** HOLE CARDS ***
Samogonka: folds 
petrovichkag: folds 
AleksCash: folds 
DONTCALLME8: folds 
SickerGC: calls $0.05
llosjone: raises $0.15 to $0.25
SickerGC: calls $0.15
*** FLOP *** [3c Tc 6h]
SickerGC: bets $0.24
llosjone: calls $0.24
*** TURN *** [3c Tc 6h] [Ac]
SickerGC: checks 
llosjone: checks 
*** RIVER *** [3c Tc 6h Ac] [5s]
SickerGC: checks 
llosjone: checks 
*** SHOW DOWN ***
SickerGC: shows [9c Qh] (high card Ace)
llosjone: shows [Qc Th] (a pair of Tens)
llosjone collected $0.94 from pot
*** SUMMARY ***
Total pot $0.98 | Rake $0.04 
Board [3c Tc 6h Ac 5s]
Seat 1: Samogonka folded before Flop (didn't bet)
Seat 2: petrovichkag folded before Flop (didn't bet)
Seat 3: AleksCash folded before Flop (didn't bet)
Seat 4: DONTCALLME8 (button) folded before Flop (didn't bet)
Seat 5: SickerGC (small blind) showed [9c Qh] and lost with high card Ace
Seat 6: llosjone (big blind) showed [Qc Th] and won ($0.94) with a pair of Tens



PokerStars Hand #222948190028:  Hold'em No Limit ($0.05/$0.10 USD) - 2021/01/23 3:59:34 ET
Table 'Capricorn II' 6-max Seat #5 is the button
Seat 1: Samogonka ($8.03 in chips) 
Seat 2: petrovichkag ($10 in chips) 
Seat 3: AleksCash ($15.96 in chips) 
Seat 4: DONTCALLME8 ($11.97 in chips) 
Seat 5: SickerGC ($6.87 in chips) 
Seat 6: llosjone ($18.45 in chips) 
llosjone: posts small blind $0.05
Samogonka: posts big blind $0.10
*** HOLE CARDS ***
petrovichkag: folds 
AleksCash: folds 
DONTCALLME8: raises $0.15 to $0.25
SickerGC: calls $0.25
llosjone: folds 
Samogonka: folds 
*** FLOP *** [4s Ad 7c]
DONTCALLME8: bets $0.21
SickerGC: calls $0.21
*** TURN *** [4s Ad 7c] [Qh]
DONTCALLME8: bets $0.71
SickerGC: folds 
Uncalled bet ($0.71) returned to DONTCALLME8
DONTCALLME8 collected $1.02 from pot
DONTCALLME8: doesn't show hand 
*** SUMMARY ***
Total pot $1.07 | Rake $0.05 
Board [4s Ad 7c Qh]
Seat 1: Samogonka (big blind) folded before Flop
Seat 2: petrovichkag folded before Flop (didn't bet)
Seat 3: AleksCash folded before Flop (didn't bet)
Seat 4: DONTCALLME8 collected ($1.02)
Seat 5: SickerGC (button) folded on the Turn
Seat 6: llosjone (small blind) folded before Flop



PokerStars Hand #222948199139:  Hold'em No Limit ($0.05/$0.10 USD) - 2021/01/23 4:00:15 ET
Table 'Capricorn II' 6-max Seat #6 is the button
Seat 1: Samogonka ($7.93 in chips) 
Seat 2: petrovichkag ($10 in chips) 
Seat 3: AleksCash ($15.96 in chips) 
Seat 4: DONTCALLME8 ($12.53 in chips) 
Seat 5: SickerGC ($6.41 in chips) 
Seat 6: llosjone ($18.40 in chips) 
Samogonka: posts small blind $0.05
petrovichkag: posts big blind $0.10
*** HOLE CARDS ***
AleksCash: folds 
DONTCALLME8: raises $0.15 to $0.25
SickerGC: folds 
llosjone: calls $0.25
Samogonka: folds 
petrovichkag: folds 
*** FLOP *** [8c Js Ks]
DONTCALLME8: bets $0.21
llosjone: calls $0.21
*** TURN *** [8c Js Ks] [Jd]
DONTCALLME8: bets $0.31
llosjone: raises $0.54 to $0.85
DONTCALLME8: folds 
Uncalled bet ($0.54) returned to llosjone
llosjone collected $1.61 from pot
llosjone: doesn't show hand 
*** SUMMARY ***
Total pot $1.69 | Rake $0.08 
Board [8c Js Ks Jd]
Seat 1: Samogonka (small blind) folded before Flop
Seat 2: petrovichkag (big blind) folded before Flop
Seat 3: AleksCash folded before Flop (didn't bet)
Seat 4: DONTCALLME8 folded on the Turn
Seat 5: SickerGC folded before Flop (didn't bet)
Seat 6: llosjone (button) collected ($1.61)



PokerStars Hand #222948208551:  Hold'em No Limit ($0.05/$0.10 USD) - 2021/01/23 4:00:55 ET
Table 'Capricorn II' 6-max Seat #1 is the button
Seat 1: Samogonka ($7.88 in chips) 
Seat 2: petrovichkag ($10 in chips) 
Seat 3: AleksCash ($15.96 in chips) 
Seat 4: DONTCALLME8 ($11.76 in chips) 
Seat 5: SickerGC ($6.41 in chips) 
Seat 6: llosjone ($19.24 in chips) 
petrovichkag: posts small blind $0.05
AleksCash: posts big blind $0.10
*** HOLE CARDS ***
DONTCALLME8: raises $0.10 to $0.20
SickerGC: folds 
llosjone: calls $0.20
Samogonka: folds 
petrovichkag: folds 
AleksCash: calls $0.10
*** FLOP *** [6c 2h 7h]
AleksCash: checks 
DONTCALLME8: bets $0.41
llosjone: folds 
AleksCash: calls $0.41
*** TURN *** [6c 2h 7h] [8s]
AleksCash: checks 
DONTCALLME8: bets $0.90
AleksCash: folds 
Uncalled bet ($0.90) returned to DONTCALLME8
DONTCALLME8 collected $1.40 from pot
DONTCALLME8: doesn't show hand 
*** SUMMARY ***
Total pot $1.47 | Rake $0.07 
Board [6c 2h 7h 8s]
Seat 1: Samogonka (button) folded before Flop (didn't bet)
Seat 2: petrovichkag (small blind) folded before Flop
Seat 3: AleksCash (big blind) folded on the Turn
Seat 4: DONTCALLME8 collected ($1.40)
Seat 5: SickerGC folded before Flop (didn't bet)
Seat 6: llosjone folded on the Flop



PokerStars Hand #222948221408:  Hold'em No Limit ($0.05/$0.10 USD) - 2021/01/23 4:01:46 ET
Table 'Capricorn II' 6-max Seat #2 is the button
Seat 1: Samogonka ($7.88 in chips) 
Seat 2: petrovichkag ($10 in chips) 
Seat 3: AleksCash ($15.35 in chips) 
Seat 4: DONTCALLME8 ($12.55 in chips) 
Seat 5: SickerGC ($6.41 in chips) 
Seat 6: llosjone ($19.04 in chips) 
AleksCash: posts small blind $0.05
DONTCALLME8: posts big blind $0.10
*** HOLE CARDS ***
SickerGC: folds 
llosjone: raises $0.15 to $0.25
Samogonka: calls $0.25
petrovichkag: folds 
AleksCash: folds 
DONTCALLME8: folds 
*** FLOP *** [7h Ac 7s]
llosjone: bets $0.27
Samogonka: folds 
Uncalled bet ($0.27) returned to llosjone
llosjone collected $0.62 from pot
llosjone: doesn't show hand 
*** SUMMARY ***
Total pot $0.65 | Rake $0.03 
Board [7h Ac 7s]
Seat 1: Samogonka folded on the Flop
Seat 2: petrovichkag (button) folded before Flop (didn't bet)
Seat 3: AleksCash (small blind) folded before Flop
Seat 4: DONTCALLME8 (big blind) folded before Flop
Seat 5: SickerGC folded before Flop (didn't bet)
Seat 6: llosjone collected ($0.62)



PokerStars Hand #222948226715:  Hold'em No Limit ($0.05/$0.10 USD) - 2021/01/23 4:02:08 ET
Table 'Capricorn II' 6-max Seat #3 is the button
Seat 1: Samogonka ($7.63 in chips) 
Seat 2: petrovichkag ($10 in chips) 
Seat 3: AleksCash ($15.30 in chips) 
Seat 4: DONTCALLME8 ($12.45 in chips) 
Seat 5: SickerGC ($6.41 in chips) 
Seat 6: llosjone ($19.41 in chips) 
DONTCALLME8: posts small blind $0.05
SickerGC: posts big blind $0.10
*** HOLE CARDS ***
llosjone: raises $0.15 to $0.25
Samogonka: calls $0.25
petrovichkag: folds 
AleksCash: folds 
DONTCALLME8: folds 
SickerGC: raises $6.16 to $6.41 and is all-in
llosjone: raises $6.16 to $12.57
Samogonka: folds 
Uncalled bet ($6.16) returned to llosjone
*** FLOP *** [7c 3d Tc]
*** TURN *** [7c 3d Tc] [6d]
*** RIVER *** [7c 3d Tc 6d] [9c]
*** SHOW DOWN ***
SickerGC: shows [5s 5d] (a pair of Fives)
llosjone: shows [Kd Ad] (high card Ace)
SickerGC collected $12.53 from pot
*** SUMMARY ***
Total pot $13.12 | Rake $0.59 
Board [7c 3d Tc 6d 9c]
Seat 1: Samogonka folded before Flop
Seat 2: petrovichkag folded before Flop (didn't bet)
Seat 3: AleksCash (button) folded before Flop (didn't bet)
Seat 4: DONTCALLME8 (small blind) folded before Flop
Seat 5: SickerGC (big blind) showed [5s 5d] and won ($12.53) with a pair of Fives
Seat 6: llosjone showed [Kd Ad] and lost with high card Ace



PokerStars Hand #222948236433:  Hold'em No Limit ($0.05/$0.10 USD) - 2021/01/23 4:02:47 ET
Table 'Capricorn II' 6-max Seat #4 is the button
Seat 1: Samogonka ($7.38 in chips) 
Seat 2: petrovichkag ($10 in chips) 
Seat 3: AleksCash ($15.30 in chips) 
Seat 4: DONTCALLME8 ($12.40 in chips) 
Seat 5: SickerGC ($12.53 in chips) 
Seat 6: llosjone ($13 in chips) 
SickerGC: posts small blind $0.05
llosjone: posts big blind $0.10
*** HOLE CARDS ***
Samogonka: folds 
petrovichkag: folds 
AleksCash: raises $0.15 to $0.25
DONTCALLME8: folds 
SickerGC: calls $0.20
llosjone: folds 
*** FLOP *** [Qs 3c 2c]
SickerGC: checks 
AleksCash: checks 
*** TURN *** [Qs 3c 2c] [3d]
SickerGC: checks 
AleksCash: bets $0.38
SickerGC: folds 
Uncalled bet ($0.38) returned to AleksCash
AleksCash collected $0.57 from pot
AleksCash: doesn't show hand 
*** SUMMARY ***
Total pot $0.60 | Rake $0.03 
Board [Qs 3c 2c 3d]
Seat 1: Samogonka folded before Flop (didn't bet)
Seat 2: petrovichkag folded before Flop (didn't bet)
Seat 3: AleksCash collected ($0.57)
Seat 4: DONTCALLME8 (button) folded before Flop (didn't bet)
Seat 5: SickerGC (small blind) folded on the Turn
Seat 6: llosjone (big blind) folded before Flop



PokerStars Hand #222948243320:  Hold'em No Limit ($0.05/$0.10 USD) - 2021/01/23 4:03:14 ET
Table 'Capricorn II' 6-max Seat #5 is the button
Seat 1: Samogonka ($7.38 in chips) 
Seat 2: petrovichkag ($10 in chips) 
Seat 3: AleksCash ($15.62 in chips) 
Seat 4: DONTCALLME8 ($12.40 in chips) 
Seat 5: SickerGC ($12.28 in chips) 
Seat 6: llosjone ($12.90 in chips) 
llosjone: posts small blind $0.05
Samogonka: posts big blind $0.10
*** HOLE CARDS ***
petrovichkag: raises $0.14 to $0.24
AleksCash: folds 
DONTCALLME8: calls $0.24
SickerGC: folds 
llosjone: folds 
Samogonka: folds 
*** FLOP *** [As Kh 8s]
petrovichkag: bets $0.20
DONTCALLME8: folds 
Uncalled bet ($0.20) returned to petrovichkag
petrovichkag collected $0.60 from pot
petrovichkag: doesn't show hand 
*** SUMMARY ***
Total pot $0.63 | Rake $0.03 
Board [As Kh 8s]
Seat 1: Samogonka (big blind) folded before Flop
Seat 2: petrovichkag collected ($0.60)
Seat 3: AleksCash folded before Flop (didn't bet)
Seat 4: DONTCALLME8 folded on the Flop
Seat 5: SickerGC (button) folded before Flop (didn't bet)
Seat 6: llosjone (small blind) folded before Flop



PokerStars Hand #222948247136:  Hold'em No Limit ($0.05/$0.10 USD) - 2021/01/23 4:03:29 ET
Table 'Capricorn II' 6-max Seat #6 is the button
Seat 1: Samogonka ($7.28 in chips) 
Seat 2: petrovichkag ($10.36 in chips) 
Seat 3: AleksCash ($15.62 in chips) 
Seat 4: DONTCALLME8 ($12.16 in chips) 
Seat 5: SickerGC ($12.28 in chips) 
Seat 6: llosjone ($12.85 in chips) 
Samogonka: posts small blind $0.05
petrovichkag: posts big blind $0.10
*** HOLE CARDS ***
AleksCash: raises $0.20 to $0.30
DONTCALLME8: calls $0.30
SickerGC: raises $0.20 to $0.50
llosjone: folds 
Samogonka: folds 
petrovichkag: folds 
AleksCash: calls $0.20
DONTCALLME8: calls $0.20
*** FLOP *** [Kh Qd 6d]
AleksCash: checks 
DONTCALLME8: checks 
SickerGC: bets $0.79
AleksCash: calls $0.79
DONTCALLME8: calls $0.79
*** TURN *** [Kh Qd 6d] [Tc]
AleksCash: checks 
DONTCALLME8: checks 
SickerGC: checks 
*** RIVER *** [Kh Qd 6d Tc] [3s]
AleksCash: bets $1.92
DONTCALLME8: folds 
SickerGC: folds 
Uncalled bet ($1.92) returned to AleksCash
AleksCash collected $3.84 from pot
AleksCash: doesn't show hand 
*** SUMMARY ***
Total pot $4.02 | Rake $0.18 
Board [Kh Qd 6d Tc 3s]
Seat 1: Samogonka (small blind) folded before Flop
Seat 2: petrovichkag (big blind) folded before Flop
Seat 3: AleksCash collected ($3.84)
Seat 4: DONTCALLME8 folded on the River
Seat 5: SickerGC folded on the River
Seat 6: llosjone (button) folded before Flop (didn't bet)



PokerStars Hand #222948261421:  Hold'em No Limit ($0.05/$0.10 USD) - 2021/01/23 4:04:25 ET
Table 'Capricorn II' 6-max Seat #1 is the button
Seat 1: Samogonka ($7.23 in chips) 
Seat 2: petrovichkag ($10.26 in chips) 
Seat 3: AleksCash ($18.17 in chips) 
Seat 4: DONTCALLME8 ($10.87 in chips) 
Seat 5: SickerGC ($10.99 in chips) 
Seat 6: llosjone ($12.85 in chips) 
petrovichkag: posts small blind $0.05
AleksCash: posts big blind $0.10
*** HOLE CARDS ***
DONTCALLME8: folds 
SickerGC: calls $0.10
llosjone: folds 
Samogonka: raises $0.30 to $0.40
petrovichkag: folds 
AleksCash: folds 
SickerGC: calls $0.30
*** FLOP *** [Ac 3d Qc]
SickerGC: checks 
Samogonka: bets $0.50
SickerGC: raises $0.50 to $1
Samogonka: raises $5.83 to $6.83 and is all-in
SickerGC: calls $5.83
*** TURN *** [Ac 3d Qc] [4s]
*** RIVER *** [Ac 3d Qc 4s] [4c]
*** SHOW DOWN ***
SickerGC: shows [As 6h] (two pair, Aces and Fours)
Samogonka: shows [Jh Ad] (two pair, Aces and Fours)
SickerGC collected $6.98 from pot
Samogonka collected $6.97 from pot
*** SUMMARY ***
Total pot $14.61 | Rake $0.66 
Board [Ac 3d Qc 4s 4c]
Seat 1: Samogonka (button) showed [Jh Ad] and won ($6.97) with two pair, Aces and Fours
Seat 2: petrovichkag (small blind) folded before Flop
Seat 3: AleksCash (big blind) folded before Flop
Seat 4: DONTCALLME8 folded before Flop (didn't bet)
Seat 5: SickerGC showed [As 6h] and won ($6.98) with two pair, Aces and Fours
Seat 6: llosjone folded before Flop (didn't bet)



PokerStars Hand #222948278901:  Hold'em No Limit ($0.05/$0.10 USD) - 2021/01/23 4:05:33 ET
Table 'Capricorn II' 6-max Seat #2 is the button
Seat 1: Samogonka ($6.97 in chips) 
Seat 2: petrovichkag ($10.21 in chips) 
Seat 3: AleksCash ($18.07 in chips) 
Seat 4: DONTCALLME8 ($10.87 in chips) 
Seat 5: SickerGC ($10.74 in chips) 
Seat 6: llosjone ($12.85 in chips) 
AleksCash: posts small blind $0.05
DONTCALLME8: posts big blind $0.10
*** HOLE CARDS ***
SickerGC: calls $0.10
llosjone: folds 
Samogonka: folds 
petrovichkag: raises $0.30 to $0.40
AleksCash: folds 
DONTCALLME8: folds 
SickerGC: calls $0.30
*** FLOP *** [3d Ac 4h]
SickerGC: bets $0.46
petrovichkag: folds 
Uncalled bet ($0.46) returned to SickerGC
SickerGC collected $0.91 from pot
SickerGC: doesn't show hand 
*** SUMMARY ***
Total pot $0.95 | Rake $0.04 
Board [3d Ac 4h]
Seat 1: Samogonka folded before Flop (didn't bet)
Seat 2: petrovichkag (button) folded on the Flop
Seat 3: AleksCash (small blind) folded before Flop
Seat 4: DONTCALLME8 (big blind) folded before Flop
Seat 5: SickerGC collected ($0.91)
Seat 6: llosjone folded before Flop (didn't bet)



PokerStars Hand #222948292639:  Hold'em No Limit ($0.05/$0.10 USD) - 2021/01/23 4:06:28 ET
Table 'Capricorn II' 6-max Seat #3 is the button
Seat 1: Samogonka ($6.97 in chips) 
Seat 2: petrovichkag ($10 in chips) 
Seat 3: AleksCash ($18.02 in chips) 
Seat 4: DONTCALLME8 ($10.77 in chips) 
Seat 5: SickerGC ($11.25 in chips) 
Seat 6: llosjone ($12.85 in chips) 
DONTCALLME8: posts small blind $0.05
SickerGC: posts big blind $0.10
*** HOLE CARDS ***
llosjone: folds 
Samogonka: folds 
petrovichkag: folds 
AleksCash: folds 
DONTCALLME8: folds 
Uncalled bet ($0.05) returned to SickerGC
SickerGC collected $0.10 from pot
*** SUMMARY ***
Total pot $0.10 | Rake $0 
Seat 1: Samogonka folded before Flop (didn't bet)
Seat 2: petrovichkag folded before Flop (didn't bet)
Seat 3: AleksCash (button) folded before Flop (didn't bet)
Seat 4: DONTCALLME8 (small blind) folded before Flop
Seat 5: SickerGC (big blind) collected ($0.10)
Seat 6: llosjone folded before Flop (didn't bet)



PokerStars Hand #222948298092:  Hold'em No Limit ($0.05/$0.10 USD) - 2021/01/23 4:06:49 ET
Table 'Capricorn II' 6-max Seat #4 is the button
Seat 1: Samogonka ($6.97 in chips) 
Seat 2: petrovichkag ($10 in chips) 
Seat 3: AleksCash ($18.02 in chips) 
Seat 4: DONTCALLME8 ($10.72 in chips) 
Seat 5: SickerGC ($11.30 in chips) 
Seat 6: llosjone ($12.85 in chips) 
SickerGC: posts small blind $0.05
llosjone: posts big blind $0.10
*** HOLE CARDS ***
Samogonka: folds 
petrovichkag: folds 
AleksCash: folds 
DONTCALLME8: folds 
SickerGC: calls $0.05
llosjone: checks 
*** FLOP *** [8c 5d Jh]
SickerGC: checks 
llosjone: checks 
*** TURN *** [8c 5d Jh] [Kh]
SickerGC: checks 
llosjone: checks 
*** RIVER *** [8c 5d Jh Kh] [Jd]
SickerGC: bets $0.19
llosjone: folds 
Uncalled bet ($0.19) returned to SickerGC
SickerGC collected $0.19 from pot
SickerGC: doesn't show hand 
*** SUMMARY ***
Total pot $0.20 | Rake $0.01 
Board [8c 5d Jh Kh Jd]
Seat 1: Samogonka folded before Flop (didn't bet)
Seat 2: petrovichkag folded before Flop (didn't bet)
Seat 3: AleksCash folded before Flop (didn't bet)
Seat 4: DONTCALLME8 (button) folded before Flop (didn't bet)
Seat 5: SickerGC (small blind) collected ($0.19)
Seat 6: llosjone (big blind) folded on the River



PokerStars Hand #222948310902:  Hold'em No Limit ($0.05/$0.10 USD) - 2021/01/23 4:07:39 ET
Table 'Capricorn II' 6-max Seat #5 is the button
Seat 1: Samogonka ($6.97 in chips) 
Seat 2: petrovichkag ($10 in chips) 
Seat 3: AleksCash ($18.02 in chips) 
Seat 4: DONTCALLME8 ($10.72 in chips) 
Seat 5: SickerGC ($11.39 in chips) 
Seat 6: llosjone ($12.75 in chips) 
llosjone: posts small blind $0.05
Samogonka: posts big blind $0.10
*** HOLE CARDS ***
petrovichkag: folds 
AleksCash: raises $0.20 to $0.30
DONTCALLME8: folds 
SickerGC: folds 
llosjone: folds 
Samogonka: folds 
Uncalled bet ($0.20) returned to AleksCash
AleksCash collected $0.25 from pot
AleksCash: doesn't show hand 
*** SUMMARY ***
Total pot $0.25 | Rake $0 
Seat 1: Samogonka (big blind) folded before Flop
Seat 2: petrovichkag folded before Flop (didn't bet)
Seat 3: AleksCash collected ($0.25)
Seat 4: DONTCALLME8 folded before Flop (didn't bet)
Seat 5: SickerGC (button) folded before Flop (didn't bet)
Seat 6: llosjone (small blind) folded before Flop



PokerStars Hand #222948317359:  Hold'em No Limit ($0.05/$0.10 USD) - 2021/01/23 4:08:04 ET
Table 'Capricorn II' 6-max Seat #6 is the button
Seat 1: Samogonka ($6.87 in chips) 
Seat 2: petrovichkag ($10 in chips) 
Seat 3: AleksCash ($18.17 in chips) 
Seat 4: DONTCALLME8 ($10.72 in chips) 
Seat 5: SickerGC ($11.39 in chips) 
Seat 6: llosjone ($12.70 in chips) 
Samogonka: posts small blind $0.05
petrovichkag: posts big blind $0.10
*** HOLE CARDS ***
AleksCash: folds 
DONTCALLME8: folds 
SickerGC: folds 
llosjone: raises $0.15 to $0.25
Samogonka: folds 
petrovichkag: calls $0.15
*** FLOP *** [7h Jd 7d]
petrovichkag: checks 
llosjone: bets $0.17
petrovichkag: calls $0.17
*** TURN *** [7h Jd 7d] [Jc]
petrovichkag: checks 
llosjone: checks 
*** RIVER *** [7h Jd 7d Jc] [Kc]
petrovichkag: bets $0.66
llosjone: folds 
Uncalled bet ($0.66) returned to petrovichkag
petrovichkag collected $0.85 from pot
petrovichkag: doesn't show hand 
*** SUMMARY ***
Total pot $0.89 | Rake $0.04 
Board [7h Jd 7d Jc Kc]
Seat 1: Samogonka (small blind) folded before Flop
Seat 2: petrovichkag (big blind) collected ($0.85)
Seat 3: AleksCash folded before Flop (didn't bet)
Seat 4: DONTCALLME8 folded before Flop (didn't bet)
Seat 5: SickerGC folded before Flop (didn't bet)
Seat 6: llosjone (button) folded on the River



PokerStars Hand #222948323872:  Hold'em No Limit ($0.05/$0.10 USD) - 2021/01/23 4:08:29 ET
Table 'Capricorn II' 6-max Seat #1 is the button
Seat 1: Samogonka ($6.82 in chips) 
Seat 2: petrovichkag ($10.43 in chips) 
Seat 3: AleksCash ($18.17 in chips) 
Seat 4: DONTCALLME8 ($10.72 in chips) 
Seat 5: SickerGC ($11.39 in chips) 
Seat 6: llosjone ($12.28 in chips) 
petrovichkag: posts small blind $0.05
AleksCash: posts big blind $0.10
*** HOLE CARDS ***
DONTCALLME8: raises $0.20 to $0.30
SickerGC: folds 
llosjone: folds 
Samogonka: folds 
petrovichkag: folds 
AleksCash: folds 
Uncalled bet ($0.20) returned to DONTCALLME8
DONTCALLME8 collected $0.25 from pot
DONTCALLME8: doesn't show hand 
*** SUMMARY ***
Total pot $0.25 | Rake $0 
Seat 1: Samogonka (button) folded before Flop (didn't bet)
Seat 2: petrovichkag (small blind) folded before Flop
Seat 3: AleksCash (big blind) folded before Flop
Seat 4: DONTCALLME8 collected ($0.25)
Seat 5: SickerGC folded before Flop (didn't bet)
Seat 6: llosjone folded before Flop (didn't bet)



PokerStars Hand #222948328062:  Hold'em No Limit ($0.05/$0.10 USD) - 2021/01/23 4:08:45 ET
Table 'Capricorn II' 6-max Seat #2 is the button
Seat 1: Samogonka ($6.82 in chips) 
Seat 2: petrovichkag ($10.38 in chips) 
Seat 3: AleksCash ($18.07 in chips) 
Seat 4: DONTCALLME8 ($10.87 in chips) 
Seat 5: SickerGC ($11.39 in chips) 
Seat 6: llosjone ($12.28 in chips) 
AleksCash: posts small blind $0.05
DONTCALLME8: posts big blind $0.10
*** HOLE CARDS ***
SickerGC: calls $0.10
llosjone: folds 
Samogonka: folds 
petrovichkag: folds 
AleksCash: folds 
DONTCALLME8: raises $0.25 to $0.35
SickerGC: calls $0.25
*** FLOP *** [Ac Kd Ks]
DONTCALLME8: bets $0.26
SickerGC: folds 
Uncalled bet ($0.26) returned to DONTCALLME8
DONTCALLME8 collected $0.72 from pot
DONTCALLME8: doesn't show hand 
*** SUMMARY ***
Total pot $0.75 | Rake $0.03 
Board [Ac Kd Ks]
Seat 1: Samogonka folded before Flop (didn't bet)
Seat 2: petrovichkag (button) folded before Flop (didn't bet)
Seat 3: AleksCash (small blind) folded before Flop
Seat 4: DONTCALLME8 (big blind) collected ($0.72)
Seat 5: SickerGC folded on the Flop
Seat 6: llosjone folded before Flop (didn't bet)



PokerStars Hand #222948335470:  Hold'em No Limit ($0.05/$0.10 USD) - 2021/01/23 4:09:14 ET
Table 'Capricorn II' 6-max Seat #3 is the button
Seat 1: Samogonka ($6.82 in chips) 
Seat 2: petrovichkag ($10.38 in chips) 
Seat 3: AleksCash ($18.02 in chips) 
Seat 4: DONTCALLME8 ($11.24 in chips) 
Seat 5: SickerGC ($11.04 in chips) 
Seat 6: llosjone ($12.28 in chips) 
DONTCALLME8: posts small blind $0.05
SickerGC: posts big blind $0.10
*** HOLE CARDS ***
llosjone: folds 
Samogonka: folds 
petrovichkag: raises $0.14 to $0.24
AleksCash: folds 
DONTCALLME8: folds 
SickerGC: calls $0.14
*** FLOP *** [3s 7c Ks]
SickerGC: checks 
petrovichkag: bets $0.40
SickerGC: folds 
Uncalled bet ($0.40) returned to petrovichkag
petrovichkag collected $0.51 from pot
petrovichkag: doesn't show hand 
*** SUMMARY ***
Total pot $0.53 | Rake $0.02 
Board [3s 7c Ks]
Seat 1: Samogonka folded before Flop (didn't bet)
Seat 2: petrovichkag collected ($0.51)
Seat 3: AleksCash (button) folded before Flop (didn't bet)
Seat 4: DONTCALLME8 (small blind) folded before Flop
Seat 5: SickerGC (big blind) folded on the Flop
Seat 6: llosjone folded before Flop (didn't bet)



PokerStars Hand #222948346643:  Hold'em No Limit ($0.05/$0.10 USD) - 2021/01/23 4:09:58 ET
Table 'Capricorn II' 6-max Seat #4 is the button
Seat 1: Samogonka ($6.82 in chips) 
Seat 2: petrovichkag ($10.65 in chips) 
Seat 3: AleksCash ($18.02 in chips) 
Seat 4: DONTCALLME8 ($11.19 in chips) 
Seat 5: SickerGC ($10.80 in chips) 
Seat 6: llosjone ($12.28 in chips) 
SickerGC: posts small blind $0.05
llosjone: posts big blind $0.10
*** HOLE CARDS ***
Samogonka: folds 
petrovichkag: folds 
AleksCash: folds 
DONTCALLME8: folds 
SickerGC: calls $0.05
llosjone: checks 
*** FLOP *** [7s Td Qh]
SickerGC: bets $0.19
llosjone: folds 
Uncalled bet ($0.19) returned to SickerGC
SickerGC collected $0.19 from pot
*** SUMMARY ***
Total pot $0.20 | Rake $0.01 
Board [7s Td Qh]
Seat 1: Samogonka folded before Flop (didn't bet)
Seat 2: petrovichkag folded before Flop (didn't bet)
Seat 3: AleksCash folded before Flop (didn't bet)
Seat 4: DONTCALLME8 (button) folded before Flop (didn't bet)
Seat 5: SickerGC (small blind) collected ($0.19)
Seat 6: llosjone (big blind) folded on the Flop



PokerStars Hand #222948352144:  Hold'em No Limit ($0.05/$0.10 USD) - 2021/01/23 4:10:19 ET
Table 'Capricorn II' 6-max Seat #5 is the button
Seat 1: Samogonka ($6.82 in chips) 
Seat 2: petrovichkag ($10.65 in chips) 
Seat 3: AleksCash ($18.02 in chips) 
Seat 4: DONTCALLME8 ($11.19 in chips) 
Seat 5: SickerGC ($10.89 in chips) 
Seat 6: llosjone ($12.18 in chips) 
llosjone: posts small blind $0.05
Samogonka: posts big blind $0.10
*** HOLE CARDS ***
petrovichkag: folds 
AleksCash: folds 
DONTCALLME8: folds 
SickerGC: calls $0.10
llosjone: folds 
Samogonka: checks 
*** FLOP *** [9h 3d Ah]
Samogonka: checks 
SickerGC: checks 
*** TURN *** [9h 3d Ah] [Qh]
Samogonka: checks 
SickerGC: checks 
*** RIVER *** [9h 3d Ah Qh] [7d]
Samogonka: checks 
SickerGC: checks 
*** SHOW DOWN ***
Samogonka: shows [3c 5h] (a pair of Threes)
SickerGC: shows [7h Jd] (a pair of Sevens)
SickerGC collected $0.24 from pot
*** SUMMARY ***
Total pot $0.25 | Rake $0.01 
Board [9h 3d Ah Qh 7d]
Seat 1: Samogonka (big blind) showed [3c 5h] and lost with a pair of Threes
Seat 2: petrovichkag folded before Flop (didn't bet)
Seat 3: AleksCash folded before Flop (didn't bet)
Seat 4: DONTCALLME8 folded before Flop (didn't bet)
Seat 5: SickerGC (button) showed [7h Jd] and won ($0.24) with a pair of Sevens
Seat 6: llosjone (small blind) folded before Flop



PokerStars Hand #222948358138:  Hold'em No Limit ($0.05/$0.10 USD) - 2021/01/23 4:10:43 ET
Table 'Capricorn II' 6-max Seat #6 is the button
Seat 1: Samogonka ($6.72 in chips) 
Seat 2: petrovichkag ($10.65 in chips) 
Seat 3: AleksCash ($18.02 in chips) 
Seat 4: DONTCALLME8 ($11.19 in chips) 
Seat 5: SickerGC ($11.03 in chips) 
Seat 6: llosjone ($12.13 in chips) 
Samogonka: posts small blind $0.05
petrovichkag: posts big blind $0.10
*** HOLE CARDS ***
AleksCash: folds 
DONTCALLME8: folds 
SickerGC: folds 
llosjone: folds 
Samogonka: folds 
Uncalled bet ($0.05) returned to petrovichkag
petrovichkag collected $0.10 from pot
petrovichkag: doesn't show hand 
*** SUMMARY ***
Total pot $0.10 | Rake $0 
Seat 1: Samogonka (small blind) folded before Flop
Seat 2: petrovichkag (big blind) collected ($0.10)
Seat 3: AleksCash folded before Flop (didn't bet)
Seat 4: DONTCALLME8 folded before Flop (didn't bet)
Seat 5: SickerGC folded before Flop (didn't bet)
Seat 6: llosjone (button) folded before Flop (didn't bet)



PokerStars Hand #222948362834:  Hold'em No Limit ($0.05/$0.10 USD) - 2021/01/23 4:11:01 ET
Table 'Capricorn II' 6-max Seat #1 is the button
Seat 1: Samogonka ($6.67 in chips) 
Seat 2: petrovichkag ($10.70 in chips) 
Seat 3: AleksCash ($18.02 in chips) 
Seat 4: DONTCALLME8 ($11.19 in chips) 
Seat 5: SickerGC ($11.03 in chips) 
Seat 6: llosjone ($12.13 in chips) 
petrovichkag: posts small blind $0.05
AleksCash: posts big blind $0.10
*** HOLE CARDS ***
DONTCALLME8: folds 
SickerGC: calls $0.10
llosjone: folds 
Samogonka: calls $0.10
petrovichkag: raises $0.40 to $0.50
AleksCash: folds 
SickerGC: folds 
Samogonka: calls $0.40
*** FLOP *** [3c 5s Ts]
petrovichkag: bets $0.38
Samogonka: calls $0.38
*** TURN *** [3c 5s Ts] [4d]
petrovichkag: bets $1.30
Samogonka: calls $1.30
*** RIVER *** [3c 5s Ts 4d] [3s]
petrovichkag: checks 
Samogonka: checks 
*** SHOW DOWN ***
petrovichkag: shows [Jd Ks] (a pair of Threes)
Samogonka: shows [Tc As] (two pair, Tens and Threes)
Samogonka collected $4.35 from pot
*** SUMMARY ***
Total pot $4.56 | Rake $0.21 
Board [3c 5s Ts 4d 3s]
Seat 1: Samogonka (button) showed [Tc As] and won ($4.35) with two pair, Tens and Threes
Seat 2: petrovichkag (small blind) showed [Jd Ks] and lost with a pair of Threes
Seat 3: AleksCash (big blind) folded before Flop
Seat 4: DONTCALLME8 folded before Flop (didn't bet)
Seat 5: SickerGC folded before Flop
Seat 6: llosjone folded before Flop (didn't bet)



PokerStars Hand #222948378830:  Hold'em No Limit ($0.05/$0.10 USD) - 2021/01/23 4:12:03 ET
Table 'Capricorn II' 6-max Seat #2 is the button
Seat 1: Samogonka ($8.84 in chips) 
Seat 2: petrovichkag ($10 in chips) 
Seat 3: AleksCash ($17.92 in chips) 
Seat 4: DONTCALLME8 ($11.19 in chips) 
Seat 5: SickerGC ($10.93 in chips) 
Seat 6: llosjone ($12.13 in chips) 
AleksCash: posts small blind $0.05
DONTCALLME8: posts big blind $0.10
*** HOLE CARDS ***
SickerGC: raises $0.20 to $0.30
llosjone: folds 
Samogonka: folds 
petrovichkag: folds 
AleksCash: folds 
DONTCALLME8: calls $0.20
*** FLOP *** [Th 2c Qc]
DONTCALLME8: checks 
SickerGC: checks 
*** TURN *** [Th 2c Qc] [5c]
DONTCALLME8: bets $0.31
SickerGC: calls $0.31
*** RIVER *** [Th 2c Qc 5c] [Jh]
DONTCALLME8: checks 
SickerGC: checks 
*** SHOW DOWN ***
DONTCALLME8: shows [Td Kh] (a pair of Tens)
SickerGC: mucks hand 
DONTCALLME8 collected $1.21 from pot
*** SUMMARY ***
Total pot $1.27 | Rake $0.06 
Board [Th 2c Qc 5c Jh]
Seat 1: Samogonka folded before Flop (didn't bet)
Seat 2: petrovichkag (button) folded before Flop (didn't bet)
Seat 3: AleksCash (small blind) folded before Flop
Seat 4: DONTCALLME8 (big blind) showed [Td Kh] and won ($1.21) with a pair of Tens
Seat 5: SickerGC mucked
Seat 6: llosjone folded before Flop (didn't bet)



PokerStars Hand #222948388500:  Hold'em No Limit ($0.05/$0.10 USD) - 2021/01/23 4:12:40 ET
Table 'Capricorn II' 6-max Seat #3 is the button
Seat 1: Samogonka ($8.84 in chips) 
Seat 2: petrovichkag ($10 in chips) 
Seat 3: AleksCash ($17.87 in chips) 
Seat 4: DONTCALLME8 ($11.79 in chips) 
Seat 5: SickerGC ($10.32 in chips) 
Seat 6: llosjone ($12.13 in chips) 
DONTCALLME8: posts small blind $0.05
SickerGC: posts big blind $0.10
*** HOLE CARDS ***
llosjone: folds 
Samogonka: folds 
petrovichkag: raises $0.14 to $0.24
AleksCash: folds 
DONTCALLME8: calls $0.19
SickerGC: calls $0.14
*** FLOP *** [3d Ts 2c]
DONTCALLME8: checks 
SickerGC: checks 
petrovichkag: checks 
*** TURN *** [3d Ts 2c] [Js]
DONTCALLME8: checks 
SickerGC: checks 
petrovichkag: checks 
*** RIVER *** [3d Ts 2c Js] [4s]
DONTCALLME8: checks 
SickerGC: checks 
petrovichkag: checks 
*** SHOW DOWN ***
DONTCALLME8: shows [5d Qd] (high card Queen)
SickerGC: shows [Ac 5c] (a straight, Ace to Five)
petrovichkag: mucks hand 
SickerGC collected $0.69 from pot
*** SUMMARY ***
Total pot $0.72 | Rake $0.03 
Board [3d Ts 2c Js 4s]
Seat 1: Samogonka folded before Flop (didn't bet)
Seat 2: petrovichkag mucked
Seat 3: AleksCash (button) folded before Flop (didn't bet)
Seat 4: DONTCALLME8 (small blind) showed [5d Qd] and lost with high card Queen
Seat 5: SickerGC (big blind) showed [Ac 5c] and won ($0.69) with a straight, Ace to Five
Seat 6: llosjone folded before Flop (didn't bet)



PokerStars Hand #222948410071:  Hold'em No Limit ($0.05/$0.10 USD) - 2021/01/23 4:14:04 ET
Table 'Capricorn II' 6-max Seat #5 is the button
Seat 1: Samogonka ($8.84 in chips) 
Seat 2: petrovichkag ($10 in chips) 
Seat 3: AleksCash ($17.87 in chips) 
Seat 4: DONTCALLME8 ($11.55 in chips) 
Seat 5: SickerGC ($10.67 in chips) 
Seat 6: llosjone ($12.22 in chips) 
llosjone: posts small blind $0.05
Samogonka: posts big blind $0.10
*** HOLE CARDS ***
petrovichkag: folds 
AleksCash: folds 
DONTCALLME8: folds 
SickerGC: raises $0.20 to $0.30
llosjone: calls $0.25
Samogonka: folds 
*** FLOP *** [Qd 4d Ah]
Samogonka leaves the table
AAA_set_nh joins the table at seat #1 
llosjone: bets $0.22
SickerGC: raises $0.22 to $0.44
llosjone: calls $0.22
*** TURN *** [Qd 4d Ah] [7h]
llosjone: checks 
SickerGC: checks 
*** RIVER *** [Qd 4d Ah 7h] [Ts]
llosjone: bets $0.50
SickerGC: raises $0.50 to $1
llosjone: calls $0.50
*** SHOW DOWN ***
SickerGC: shows [Ac Tc] (two pair, Aces and Tens)
llosjone: mucks hand 
SickerGC collected $3.42 from pot
*** SUMMARY ***
Total pot $3.58 | Rake $0.16 
Board [Qd 4d Ah 7h Ts]
Seat 1: Samogonka (big blind) folded before Flop
Seat 2: petrovichkag folded before Flop (didn't bet)
Seat 3: AleksCash folded before Flop (didn't bet)
Seat 4: DONTCALLME8 folded before Flop (didn't bet)
Seat 5: SickerGC (button) showed [Ac Tc] and won ($3.42) with two pair, Aces and Tens
Seat 6: llosjone (small blind) mucked



PokerStars Hand #222948418101:  Hold'em No Limit ($0.05/$0.10 USD) - 2021/01/23 4:14:35 ET
Table 'Capricorn II' 6-max Seat #6 is the button
Seat 2: petrovichkag ($10 in chips) 
Seat 3: AleksCash ($17.87 in chips) 
Seat 4: DONTCALLME8 ($11.55 in chips) 
Seat 5: SickerGC ($12.35 in chips) 
Seat 6: llosjone ($10.48 in chips) 
petrovichkag: posts small blind $0.05
AleksCash: posts big blind $0.10
*** HOLE CARDS ***
DONTCALLME8: raises $0.15 to $0.25
SickerGC: calls $0.25
llosjone: folds 
petrovichkag: folds 
AleksCash: folds 
*** FLOP *** [9d 2d 9h]
DONTCALLME8: bets $0.21
SickerGC: calls $0.21
*** TURN *** [9d 2d 9h] [7s]
DONTCALLME8: checks 
SickerGC: checks 
*** RIVER *** [9d 2d 9h 7s] [5c]
DONTCALLME8: checks 
SickerGC: bets $0.51
DONTCALLME8: folds 
Uncalled bet ($0.51) returned to SickerGC
SickerGC collected $1.02 from pot
SickerGC: doesn't show hand 
*** SUMMARY ***
Total pot $1.07 | Rake $0.05 
Board [9d 2d 9h 7s 5c]
Seat 2: petrovichkag (small blind) folded before Flop
Seat 3: AleksCash (big blind) folded before Flop
Seat 4: DONTCALLME8 folded on the River
Seat 5: SickerGC collected ($1.02)
Seat 6: llosjone (button) folded before Flop (didn't bet)



PokerStars Hand #222948429515:  Hold'em No Limit ($0.05/$0.10 USD) - 2021/01/23 4:15:19 ET
Table 'Capricorn II' 6-max Seat #2 is the button
Seat 2: petrovichkag ($10 in chips) 
Seat 3: AleksCash ($17.77 in chips) 
Seat 4: DONTCALLME8 ($11.09 in chips) 
Seat 5: SickerGC ($12.91 in chips) 
Seat 6: llosjone ($10.48 in chips) 
AleksCash: posts small blind $0.05
DONTCALLME8: posts big blind $0.10
AAA_set_nh: sits out 
*** HOLE CARDS ***
SickerGC: folds 
llosjone: folds 
petrovichkag: raises $0.14 to $0.24
AleksCash: folds 
DONTCALLME8: calls $0.14
*** FLOP *** [Ks 6h 6c]
DONTCALLME8: checks 
petrovichkag: checks 
*** TURN *** [Ks 6h 6c] [7d]
DONTCALLME8: checks 
petrovichkag: checks 
*** RIVER *** [Ks 6h 6c 7d] [Jh]
DONTCALLME8: bets $0.25
petrovichkag: folds 
Uncalled bet ($0.25) returned to DONTCALLME8
DONTCALLME8 collected $0.51 from pot
DONTCALLME8: doesn't show hand 
*** SUMMARY ***
Total pot $0.53 | Rake $0.02 
Board [Ks 6h 6c 7d Jh]
Seat 2: petrovichkag (button) folded on the River
Seat 3: AleksCash (small blind) folded before Flop
Seat 4: DONTCALLME8 (big blind) collected ($0.51)
Seat 5: SickerGC folded before Flop (didn't bet)
Seat 6: llosjone folded before Flop (didn't bet)



PokerStars Hand #222948995435:  Hold'em No Limit ($0.05/$0.10 USD) - 2021/01/23 4:50:08 ET
Table 'Capricorn II' 6-max Seat #4 is the button
Seat 1: AAA_set_nh ($10 in chips) 
Seat 3: buradin de ($10.87 in chips) 
Seat 4: Sabali420 ($12.81 in chips) 
Seat 5: fralex79 ($8.48 in chips) 
Seat 6: llosjone ($9.03 in chips) 
fralex79: posts small blind $0.05
llosjone: posts big blind $0.10
Lergik: sits out 
*** HOLE CARDS ***
AAA_set_nh: folds 
buradin de: calls $0.10
Sabali420: folds 
fralex79: raises $0.20 to $0.30
llosjone: folds 
buradin de: calls $0.20
*** FLOP *** [6h 2d Kc]
fralex79: bets $0.20
buradin de: calls $0.20
*** TURN *** [6h 2d Kc] [Qd]
fralex79: checks 
buradin de: bets $0.63
fralex79: calls $0.63
*** RIVER *** [6h 2d Kc Qd] [3s]
fralex79: checks 
buradin de: checks 
*** SHOW DOWN ***
fralex79: shows [8c 8d] (a pair of Eights)
buradin de: shows [Qc Ac] (a pair of Queens)
buradin de collected $2.25 from pot
llosjone leaves the table
*** SUMMARY ***
Total pot $2.36 | Rake $0.11 
Board [6h 2d Kc Qd 3s]
Seat 1: AAA_set_nh folded before Flop (didn't bet)
Seat 3: buradin de showed [Qc Ac] and won ($2.25) with a pair of Queens
Seat 4: Sabali420 (button) folded before Flop (didn't bet)
Seat 5: fralex79 (small blind) showed [8c 8d] and lost with a pair of Eights
Seat 6: llosjone (big blind) folded before Flop



PokerStars Hand #222949004944:  Hold'em No Limit ($0.05/$0.10 USD) - 2021/01/23 4:50:41 ET
Table 'Capricorn II' 6-max Seat #5 is the button
Seat 1: AAA_set_nh ($10 in chips) 
Seat 2: Lergik ($10 in chips) 
Seat 3: buradin de ($11.99 in chips) 
Seat 4: Sabali420 ($12.81 in chips) 
Seat 5: fralex79 ($7.35 in chips) 
AAA_set_nh: posts small blind $0.05
Lergik: posts big blind $0.10
*** HOLE CARDS ***
buradin de: folds 
Sabali420: raises $0.20 to $0.30
fralex79: folds 
AAA_set_nh: raises $0.85 to $1.15
Lergik: folds 
Sabali420: folds 
Uncalled bet ($0.85) returned to AAA_set_nh
AAA_set_nh collected $0.70 from pot
AAA_set_nh: doesn't show hand 
*** SUMMARY ***
Total pot $0.70 | Rake $0 
Seat 1: AAA_set_nh (small blind) collected ($0.70)
Seat 2: Lergik (big blind) folded before Flop
Seat 3: buradin de folded before Flop (didn't bet)
Seat 4: Sabali420 folded before Flop
Seat 5: fralex79 (button) folded before Flop (didn't bet)



PokerStars Hand #222949012907:  Hold'em No Limit ($0.05/$0.10 USD) - 2021/01/23 4:51:10 ET
Table 'Capricorn II' 6-max Seat #1 is the button
Seat 1: AAA_set_nh ($10.40 in chips) 
Seat 2: Lergik ($10 in chips) 
Seat 4: Sabali420 ($12.51 in chips) 
Seat 5: fralex79 ($7.35 in chips) 
Lergik: posts small blind $0.05
buradin de: is sitting out 
Sabali420: posts big blind $0.10
*** HOLE CARDS ***
fralex79: calls $0.10
AAA_set_nh: folds 
Lergik: raises $0.20 to $0.30
Sabali420: folds 
fralex79: calls $0.20
*** FLOP *** [6d 4d 5c]
Lergik: checks 
buradin de leaves the table
fralex79: checks 
*** TURN *** [6d 4d 5c] [7c]
Lergik: checks 
fralex79: checks 
*** RIVER *** [6d 4d 5c 7c] [7d]
Lergik: checks 
fralex79: bets $0.20
Lergik: folds 
Uncalled bet ($0.20) returned to fralex79
fralex79 collected $0.67 from pot
fralex79: doesn't show hand 
*** SUMMARY ***
Total pot $0.70 | Rake $0.03 
Board [6d 4d 5c 7c 7d]
Seat 1: AAA_set_nh (button) folded before Flop (didn't bet)
Seat 2: Lergik (small blind) folded on the River
Seat 4: Sabali420 (big blind) folded before Flop
Seat 5: fralex79 collected ($0.67)



PokerStars Hand #222949021130:  Hold'em No Limit ($0.05/$0.10 USD) - 2021/01/23 4:51:39 ET
Table 'Capricorn II' 6-max Seat #2 is the button
Seat 1: AAA_set_nh ($10.40 in chips) 
Seat 2: Lergik ($10 in chips) 
Seat 4: Sabali420 ($12.41 in chips) 
Seat 5: fralex79 ($7.72 in chips) 
Sabali420: posts small blind $0.05
fralex79: posts big blind $0.10
*** HOLE CARDS ***
cruxua joins the table at seat #6 
AAA_set_nh: folds 
Lergik: folds 
Sabali420: calls $0.05
fralex79: checks 
*** FLOP *** [Kc Kh Ts]
Sabali420: checks 
fralex79: checks 
*** TURN *** [Kc Kh Ts] [3h]
ladi59 joins the table at seat #3 
Sabali420: checks 
fralex79: checks 
*** RIVER *** [Kc Kh Ts 3h] [4h]
Sabali420: checks 
fralex79: bets $0.10
Sabali420: folds 
Uncalled bet ($0.10) returned to fralex79
fralex79 collected $0.19 from pot
fralex79: doesn't show hand 
*** SUMMARY ***
Total pot $0.20 | Rake $0.01 
Board [Kc Kh Ts 3h 4h]
Seat 1: AAA_set_nh folded before Flop (didn't bet)
Seat 2: Lergik (button) folded before Flop (didn't bet)
Seat 4: Sabali420 (small blind) folded on the River
Seat 5: fralex79 (big blind) collected ($0.19)



PokerStars Hand #222949027967:  Hold'em No Limit ($0.05/$0.10 USD) - 2021/01/23 4:52:03 ET
Table 'Capricorn II' 6-max Seat #4 is the button
Seat 1: AAA_set_nh ($10.40 in chips) 
Seat 2: Lergik ($10 in chips) 
Seat 4: Sabali420 ($12.31 in chips) 
Seat 5: fralex79 ($7.81 in chips) 
Seat 6: cruxua ($12.04 in chips) 
fralex79: posts small blind $0.05
cruxua: posts big blind $0.10
ladi59: sits out 
*** HOLE CARDS ***
AAA_set_nh: folds 
Lergik: folds 
Sabali420: folds 
fralex79: calls $0.05
cruxua: checks 
*** FLOP *** [7s Ts 8s]
fralex79: checks 
cruxua: checks 
*** TURN *** [7s Ts 8s] [9c]
fralex79: checks 
cruxua: checks 
*** RIVER *** [7s Ts 8s 9c] [3h]
fralex79: checks 
cruxua: checks 
*** SHOW DOWN ***
fralex79: shows [4h 4d] (a pair of Fours)
cruxua: shows [8h 4c] (a pair of Eights)
cruxua collected $0.19 from pot
*** SUMMARY ***
Total pot $0.20 | Rake $0.01 
Board [7s Ts 8s 9c 3h]
Seat 1: AAA_set_nh folded before Flop (didn't bet)
Seat 2: Lergik folded before Flop (didn't bet)
Seat 4: Sabali420 (button) folded before Flop (didn't bet)
Seat 5: fralex79 (small blind) showed [4h 4d] and lost with a pair of Fours
Seat 6: cruxua (big blind) showed [8h 4c] and won ($0.19) with a pair of Eights



PokerStars Hand #222949035803:  Hold'em No Limit ($0.05/$0.10 USD) - 2021/01/23 4:52:31 ET
Table 'Capricorn II' 6-max Seat #5 is the button
Seat 1: AAA_set_nh ($10.40 in chips) 
Seat 2: Lergik ($10 in chips) 
Seat 4: Sabali420 ($12.31 in chips) 
Seat 5: fralex79 ($7.71 in chips) 
Seat 6: cruxua ($12.13 in chips) 
cruxua: posts small blind $0.05
AAA_set_nh: posts big blind $0.10
ladi59: sits out 
*** HOLE CARDS ***
Lergik: folds 
Sabali420: folds 
fralex79: raises $0.20 to $0.30
cruxua: folds 
AAA_set_nh: raises $0.90 to $1.20
fralex79: calls $0.90
*** FLOP *** [5d Qh Qd]
AAA_set_nh: bets $1.17
fralex79: calls $1.17
*** TURN *** [5d Qh Qd] [Jd]
AAA_set_nh: bets $4.90
fralex79: folds 
Uncalled bet ($4.90) returned to AAA_set_nh
AAA_set_nh collected $4.57 from pot
AAA_set_nh: doesn't show hand 
*** SUMMARY ***
Total pot $4.79 | Rake $0.22 
Board [5d Qh Qd Jd]
Seat 1: AAA_set_nh (big blind) collected ($4.57)
Seat 2: Lergik folded before Flop (didn't bet)
Seat 4: Sabali420 folded before Flop (didn't bet)
Seat 5: fralex79 (button) folded on the Turn
Seat 6: cruxua (small blind) folded before Flop



PokerStars Hand #222949048261:  Hold'em No Limit ($0.05/$0.10 USD) - 2021/01/23 4:53:14 ET
Table 'Capricorn II' 6-max Seat #6 is the button
Seat 1: AAA_set_nh ($12.60 in chips) 
Seat 2: Lergik ($10 in chips) 
Seat 4: Sabali420 ($12.31 in chips) 
Seat 5: fralex79 ($5.34 in chips) 
Seat 6: cruxua ($12.08 in chips) 
AAA_set_nh: posts small blind $0.05
Lergik: posts big blind $0.10
ladi59: sits out 
*** HOLE CARDS ***
Sabali420: calls $0.10
fralex79: calls $0.10
cruxua: raises $0.50 to $0.60
AAA_set_nh: folds 
Lergik: folds 
Sabali420: calls $0.50
fralex79: calls $0.50
*** FLOP *** [6c 5h 8d]
Sabali420: checks 
fralex79: checks 
cruxua: checks 
*** TURN *** [6c 5h 8d] [Jc]
Sabali420: checks 
fralex79: bets $0.10
cruxua: calls $0.10
Sabali420: calls $0.10
*** RIVER *** [6c 5h 8d Jc] [Td]
Sabali420: checks 
fralex79: checks 
cruxua: checks 
*** SHOW DOWN ***
Sabali420: shows [Th 9h] (a pair of Tens)
fralex79: mucks hand 
cruxua: mucks hand 
Sabali420 collected $2.15 from pot
*** SUMMARY ***
Total pot $2.25 | Rake $0.10 
Board [6c 5h 8d Jc Td]
Seat 1: AAA_set_nh (small blind) folded before Flop
Seat 2: Lergik (big blind) folded before Flop
Seat 4: Sabali420 showed [Th 9h] and won ($2.15) with a pair of Tens
Seat 5: fralex79 mucked
Seat 6: cruxua (button) mucked



PokerStars Hand #222949063687:  Hold'em No Limit ($0.05/$0.10 USD) - 2021/01/23 4:54:09 ET
Table 'Capricorn II' 6-max Seat #1 is the button
Seat 1: AAA_set_nh ($12.55 in chips) 
Seat 2: Lergik ($10 in chips) 
Seat 3: ladi59 ($8.74 in chips) 
Seat 4: Sabali420 ($13.76 in chips) 
Seat 5: fralex79 ($4.64 in chips) 
Seat 6: cruxua ($11.38 in chips) 
Lergik: posts small blind $0.05
ladi59: posts big blind $0.10
*** HOLE CARDS ***
Sabali420: folds 
fralex79: folds 
cruxua: folds 
AAA_set_nh: folds 
Lergik: calls $0.05
ladi59: checks 
*** FLOP *** [8s Ts 7c]
Lergik: checks 
ladi59: checks 
*** TURN *** [8s Ts 7c] [5h]
Lergik: checks 
ladi59: checks 
*** RIVER *** [8s Ts 7c 5h] [5c]
Lergik: checks 
ladi59: bets $0.20
Lergik: folds 
Uncalled bet ($0.20) returned to ladi59
ladi59 collected $0.19 from pot
*** SUMMARY ***
Total pot $0.20 | Rake $0.01 
Board [8s Ts 7c 5h 5c]
Seat 1: AAA_set_nh (button) folded before Flop (didn't bet)
Seat 2: Lergik (small blind) folded on the River
Seat 3: ladi59 (big blind) collected ($0.19)
Seat 4: Sabali420 folded before Flop (didn't bet)
Seat 5: fralex79 folded before Flop (didn't bet)
Seat 6: cruxua folded before Flop (didn't bet)



PokerStars Hand #222949084957:  Hold'em No Limit ($0.05/$0.10 USD) - 2021/01/23 4:55:28 ET
Table 'Capricorn II' 6-max Seat #2 is the button
Seat 1: AAA_set_nh ($12.55 in chips) 
Seat 2: Lergik ($10 in chips) 
Seat 3: ladi59 ($8.83 in chips) 
Seat 4: Sabali420 ($13.76 in chips) 
Seat 5: fralex79 ($4.64 in chips) 
Seat 6: cruxua ($11.38 in chips) 
ladi59: posts small blind $0.05
Sabali420: posts big blind $0.10
*** HOLE CARDS ***
fralex79: calls $0.10
cruxua: raises $0.40 to $0.50
AAA_set_nh: folds 
Lergik: folds 
ladi59: folds 
Sabali420: folds 
fralex79: calls $0.40
*** FLOP *** [6c Qd Ac]
fralex79: checks 
cruxua: bets $0.73
fralex79: folds 
Uncalled bet ($0.73) returned to cruxua
cruxua collected $1.10 from pot
cruxua: doesn't show hand 
*** SUMMARY ***
Total pot $1.15 | Rake $0.05 
Board [6c Qd Ac]
Seat 1: AAA_set_nh folded before Flop (didn't bet)
Seat 2: Lergik (button) folded before Flop (didn't bet)
Seat 3: ladi59 (small blind) folded before Flop
Seat 4: Sabali420 (big blind) folded before Flop
Seat 5: fralex79 folded on the Flop
Seat 6: cruxua collected ($1.10)



PokerStars Hand #222949094185:  Hold'em No Limit ($0.05/$0.10 USD) - 2021/01/23 4:56:07 ET
Table 'Capricorn II' 6-max Seat #3 is the button
Seat 1: AAA_set_nh ($12.55 in chips) 
Seat 2: Lergik ($10 in chips) 
Seat 3: ladi59 ($8.78 in chips) 
Seat 4: Sabali420 ($13.66 in chips) 
Seat 5: fralex79 ($4.14 in chips) 
Seat 6: cruxua ($11.98 in chips) 
Sabali420: posts small blind $0.05
fralex79: posts big blind $0.10
*** HOLE CARDS ***
cruxua: folds 
AAA_set_nh: folds 
Lergik: folds 
ladi59: raises $0.25 to $0.35
Sabali420: folds 
fralex79: folds 
Uncalled bet ($0.25) returned to ladi59
ladi59 collected $0.25 from pot
*** SUMMARY ***
Total pot $0.25 | Rake $0 
Seat 1: AAA_set_nh folded before Flop (didn't bet)
Seat 2: Lergik folded before Flop (didn't bet)
Seat 3: ladi59 (button) collected ($0.25)
Seat 4: Sabali420 (small blind) folded before Flop
Seat 5: fralex79 (big blind) folded before Flop
Seat 6: cruxua folded before Flop (didn't bet)



PokerStars Hand #222949098597:  Hold'em No Limit ($0.05/$0.10 USD) - 2021/01/23 4:56:26 ET
Table 'Capricorn II' 6-max Seat #4 is the button
Seat 1: AAA_set_nh ($12.55 in chips) 
Seat 2: Lergik ($10 in chips) 
Seat 3: ladi59 ($8.93 in chips) 
Seat 4: Sabali420 ($13.61 in chips) 
Seat 5: fralex79 ($4.04 in chips) 
Seat 6: cruxua ($11.98 in chips) 
fralex79: posts small blind $0.05
cruxua: posts big blind $0.10
*** HOLE CARDS ***
AAA_set_nh: folds 
Lergik: folds 
ladi59: folds 
Sabali420: raises $0.20 to $0.30
fralex79: calls $0.25
cruxua: folds 
*** FLOP *** [Ac Td 7d]
fralex79: checks 
Sabali420: checks 
*** TURN *** [Ac Td 7d] [Kd]
fralex79: checks 
Sabali420: bets $0.34
fralex79: folds 
Uncalled bet ($0.34) returned to Sabali420
Sabali420 collected $0.67 from pot
Sabali420: doesn't show hand 
*** SUMMARY ***
Total pot $0.70 | Rake $0.03 
Board [Ac Td 7d Kd]
Seat 1: AAA_set_nh folded before Flop (didn't bet)
Seat 2: Lergik folded before Flop (didn't bet)
Seat 3: ladi59 folded before Flop (didn't bet)
Seat 4: Sabali420 (button) collected ($0.67)
Seat 5: fralex79 (small blind) folded on the Turn
Seat 6: cruxua (big blind) folded before Flop



PokerStars Hand #222949104936:  Hold'em No Limit ($0.05/$0.10 USD) - 2021/01/23 4:56:52 ET
Table 'Capricorn II' 6-max Seat #5 is the button
Seat 1: AAA_set_nh ($12.55 in chips) 
Seat 2: Lergik ($10 in chips) 
Seat 4: Sabali420 ($13.98 in chips) 
Seat 5: fralex79 ($3.74 in chips) 
Seat 6: cruxua ($11.88 in chips) 
cruxua: posts small blind $0.05
AAA_set_nh: posts big blind $0.10
*** HOLE CARDS ***
Lergik: folds 
Sabali420: calls $0.10
fralex79: raises $0.20 to $0.30
cruxua: folds 
AAA_set_nh: folds 
Sabali420: calls $0.20
*** FLOP *** [3d As 6s]
Sabali420: checks 
fralex79: bets $0.40
Sabali420: folds 
Uncalled bet ($0.40) returned to fralex79
fralex79 collected $0.72 from pot
fralex79: doesn't show hand 
*** SUMMARY ***
Total pot $0.75 | Rake $0.03 
Board [3d As 6s]
Seat 1: AAA_set_nh (big blind) folded before Flop
Seat 2: Lergik folded before Flop (didn't bet)
Seat 4: Sabali420 folded on the Flop
Seat 5: fralex79 (button) collected ($0.72)
Seat 6: cruxua (small blind) folded before Flop



PokerStars Hand #222949116416:  Hold'em No Limit ($0.05/$0.10 USD) - 2021/01/23 4:57:40 ET
Table 'Capricorn II' 6-max Seat #6 is the button
Seat 1: AAA_set_nh ($12.45 in chips) 
Seat 4: Sabali420 ($13.68 in chips) 
Seat 5: fralex79 ($4.16 in chips) 
Seat 6: cruxua ($11.83 in chips) 
AAA_set_nh: posts small blind $0.05
Lergik: is sitting out 
Sabali420: posts big blind $0.10
*** HOLE CARDS ***
fralex79: folds 
cruxua: folds 
AAA_set_nh: raises $0.15 to $0.25
Sabali420: folds 
Uncalled bet ($0.15) returned to AAA_set_nh
AAA_set_nh collected $0.20 from pot
AAA_set_nh: doesn't show hand 
*** SUMMARY ***
Total pot $0.20 | Rake $0 
Seat 1: AAA_set_nh (small blind) collected ($0.20)
Seat 4: Sabali420 (big blind) folded before Flop
Seat 5: fralex79 folded before Flop (didn't bet)
Seat 6: cruxua (button) folded before Flop (didn't bet)



PokerStars Hand #222949119728:  Hold'em No Limit ($0.05/$0.10 USD) - 2021/01/23 4:57:54 ET
Table 'Capricorn II' 6-max Seat #1 is the button
Seat 1: AAA_set_nh ($12.55 in chips) 
Seat 5: fralex79 ($4.16 in chips) 
Seat 6: cruxua ($11.83 in chips) 
fralex79: posts small blind $0.05
cruxua: posts big blind $0.10
*** HOLE CARDS ***
AAA_set_nh: folds 
fralex79: raises $0.10 to $0.20
Sabali420 leaves the table
cruxua: raises $0.40 to $0.60
romanromanro joins the table at seat #4 
fralex79: calls $0.40
*** FLOP *** [2c Kh 9h]
fralex79: checks 
cruxua: bets $0.77
fralex79: folds 
Uncalled bet ($0.77) returned to cruxua
cruxua collected $1.15 from pot
cruxua: doesn't show hand 
*** SUMMARY ***
Total pot $1.20 | Rake $0.05 
Board [2c Kh 9h]
Seat 1: AAA_set_nh (button) folded before Flop (didn't bet)
Seat 5: fralex79 (small blind) folded on the Flop
Seat 6: cruxua (big blind) collected ($1.15)



PokerStars Hand #222949124041:  Hold'em No Limit ($0.05/$0.10 USD) - 2021/01/23 4:58:12 ET
Table 'Capricorn II' 6-max Seat #5 is the button
Seat 1: AAA_set_nh ($12.55 in chips) 
Seat 5: fralex79 ($3.56 in chips) 
Seat 6: cruxua ($12.38 in chips) 
cruxua: posts small blind $0.05
AAA_set_nh: posts big blind $0.10
Lergik: sits out 
romanromanro: sits out 
*** HOLE CARDS ***
fralex79: folds 
cruxua: raises $0.20 to $0.30
AAA_set_nh: calls $0.20
*** FLOP *** [Kh 6d 2d]
cruxua: bets $0.38
AAA_set_nh: calls $0.38
*** TURN *** [Kh 6d 2d] [Ts]
cruxua: checks 
AAA_set_nh: checks 
*** RIVER *** [Kh 6d 2d Ts] [Qh]
cruxua: checks 
AAA_set_nh: checks 
*** SHOW DOWN ***
cruxua: shows [Th As] (a pair of Tens)
AAA_set_nh: mucks hand 
cruxua collected $1.30 from pot
*** SUMMARY ***
Total pot $1.36 | Rake $0.06 
Board [Kh 6d 2d Ts Qh]
Seat 1: AAA_set_nh (big blind) mucked
Seat 5: fralex79 (button) folded before Flop (didn't bet)
Seat 6: cruxua (small blind) showed [Th As] and won ($1.30) with a pair of Tens



PokerStars Hand #222949130581:  Hold'em No Limit ($0.05/$0.10 USD) - 2021/01/23 4:58:38 ET
Table 'Capricorn II' 6-max Seat #6 is the button
Seat 1: AAA_set_nh ($11.87 in chips) 
Seat 2: Lergik ($10 in chips) 
Seat 3: ladi59 ($8.93 in chips) 
Seat 5: fralex79 ($3.56 in chips) 
Seat 6: cruxua ($13 in chips) 
AAA_set_nh: posts small blind $0.05
Lergik: posts big blind $0.10
ladi59: posts small & big blinds $0.15
romanromanro: sits out 
*** HOLE CARDS ***
ladi59: checks 
fralex79: raises $0.20 to $0.30
cruxua: calls $0.30
AAA_set_nh: raises $0.90 to $1.20
Lergik: folds 
ladi59: folds 
fralex79: calls $0.90
cruxua: folds 
*** FLOP *** [3h 4s Td]
AAA_set_nh: bets $1.41
fralex79: raises $0.95 to $2.36 and is all-in
AAA_set_nh: calls $0.95
*** TURN *** [3h 4s Td] [7d]
*** RIVER *** [3h 4s Td 7d] [2s]
*** SHOW DOWN ***
AAA_set_nh: shows [Jd Js] (a pair of Jacks)
fralex79: shows [5c 6c] (a straight, Three to Seven)
fralex79 collected $7.32 from pot
*** SUMMARY ***
Total pot $7.67 | Rake $0.35 
Board [3h 4s Td 7d 2s]
Seat 1: AAA_set_nh (small blind) showed [Jd Js] and lost with a pair of Jacks
Seat 2: Lergik (big blind) folded before Flop
Seat 3: ladi59 folded before Flop (didn't bet)
Seat 5: fralex79 showed [5c 6c] and won ($7.32) with a straight, Three to Seven
Seat 6: cruxua (button) folded before Flop



PokerStars Hand #222949144436:  Hold'em No Limit ($0.05/$0.10 USD) - 2021/01/23 4:59:36 ET
Table 'Capricorn II' 6-max Seat #1 is the button
Seat 1: AAA_set_nh ($10 in chips) 
Seat 2: Lergik ($10 in chips) 
Seat 3: ladi59 ($8.78 in chips) 
Seat 4: romanromanro ($10 in chips) 
Seat 5: fralex79 ($7.32 in chips) 
Seat 6: cruxua ($12.70 in chips) 
Lergik: posts small blind $0.05
ladi59: posts big blind $0.10
romanromanro: posts big blind $0.10
*** HOLE CARDS ***
romanromanro: raises $0.15 to $0.25
fralex79: folds 
cruxua: folds 
AAA_set_nh: folds 
Lergik: calls $0.20
ladi59: calls $0.15
*** FLOP *** [5s 8c 3s]
Lergik: checks 
ladi59: checks 
romanromanro: bets $0.40
Lergik: calls $0.40
ladi59: calls $0.40
*** TURN *** [5s 8c 3s] [5d]
Lergik: checks 
ladi59: bets $1.86
romanromanro: calls $1.86
Lergik: folds 
*** RIVER *** [5s 8c 3s 5d] [5h]
ladi59: bets $6.27 and is all-in
romanromanro: calls $6.27
*** SHOW DOWN ***
ladi59: shows [Ah 2h] (three of a kind, Fives)
romanromanro: shows [Td 8d] (a full house, Fives full of Eights)
romanromanro collected $17.39 from pot
*** SUMMARY ***
Total pot $18.21 | Rake $0.82 
Board [5s 8c 3s 5d 5h]
Seat 1: AAA_set_nh (button) folded before Flop (didn't bet)
Seat 2: Lergik (small blind) folded on the Turn
Seat 3: ladi59 (big blind) showed [Ah 2h] and lost with three of a kind, Fives
Seat 4: romanromanro showed [Td 8d] and won ($17.39) with a full house, Fives full of Eights
Seat 5: fralex79 folded before Flop (didn't bet)
Seat 6: cruxua folded before Flop (didn't bet)



PokerStars Hand #222949154948:  Hold'em No Limit ($0.05/$0.10 USD) - 2021/01/23 5:00:19 ET
Table 'Capricorn II' 6-max Seat #2 is the button
Seat 1: AAA_set_nh ($10 in chips) 
Seat 2: Lergik ($10 in chips) 
Seat 4: romanromanro ($18.61 in chips) 
Seat 5: fralex79 ($7.32 in chips) 
Seat 6: cruxua ($12.70 in chips) 
romanromanro: posts small blind $0.05
fralex79: posts big blind $0.10
*** HOLE CARDS ***
cruxua: folds 
AAA_set_nh: folds 
Lergik: folds 
ladi59 leaves the table
romanromanro: raises $0.25 to $0.35
fralex79: calls $0.25
*** FLOP *** [Qh Ad As]
romanromanro: bets $0.22
fralex79: calls $0.22
*** TURN *** [Qh Ad As] [Qd]
romanromanro: checks 
fralex79: bets $0.50
romanromanro: folds 
Uncalled bet ($0.50) returned to fralex79
fralex79 collected $1.09 from pot
fralex79: doesn't show hand 
*** SUMMARY ***
Total pot $1.14 | Rake $0.05 
Board [Qh Ad As Qd]
Seat 1: AAA_set_nh folded before Flop (didn't bet)
Seat 2: Lergik (button) folded before Flop (didn't bet)
Seat 4: romanromanro (small blind) folded on the Turn
Seat 5: fralex79 (big blind) collected ($1.09)
Seat 6: cruxua folded before Flop (didn't bet)



PokerStars Hand #222949161094:  Hold'em No Limit ($0.05/$0.10 USD) - 2021/01/23 5:00:43 ET
Table 'Capricorn II' 6-max Seat #4 is the button
Seat 1: AAA_set_nh ($10 in chips) 
Seat 2: Lergik ($10 in chips) 
Seat 4: romanromanro ($18.04 in chips) 
Seat 5: fralex79 ($7.84 in chips) 
Seat 6: cruxua ($12.70 in chips) 
fralex79: posts small blind $0.05
cruxua: posts big blind $0.10
*** HOLE CARDS ***
AAA_set_nh: folds 
Lergik: folds 
romanromanro: folds 
fralex79: calls $0.05
cruxua: checks 
*** FLOP *** [8s Qd 7c]
fralex79: checks 
cruxua: checks 
*** TURN *** [8s Qd 7c] [Js]
fralex79: checks 
cruxua: checks 
*** RIVER *** [8s Qd 7c Js] [2s]
fralex79: checks 
cruxua: checks 
*** SHOW DOWN ***
fralex79: shows [Ac 4h] (high card Ace)
cruxua: shows [6d 8h] (a pair of Eights)
cruxua collected $0.19 from pot
*** SUMMARY ***
Total pot $0.20 | Rake $0.01 
Board [8s Qd 7c Js 2s]
Seat 1: AAA_set_nh folded before Flop (didn't bet)
Seat 2: Lergik folded before Flop (didn't bet)
Seat 4: romanromanro (button) folded before Flop (didn't bet)
Seat 5: fralex79 (small blind) showed [Ac 4h] and lost with high card Ace
Seat 6: cruxua (big blind) showed [6d 8h] and won ($0.19) with a pair of Eights



PokerStars Hand #222949168256:  Hold'em No Limit ($0.05/$0.10 USD) - 2021/01/23 5:01:09 ET
Table 'Capricorn II' 6-max Seat #5 is the button
Seat 1: AAA_set_nh ($10 in chips) 
Seat 2: Lergik ($10 in chips) 
Seat 4: romanromanro ($18.04 in chips) 
Seat 5: fralex79 ($7.74 in chips) 
Seat 6: cruxua ($12.79 in chips) 
cruxua: posts small blind $0.05
AAA_set_nh: posts big blind $0.10
*** HOLE CARDS ***
Lergik: folds 
romanromanro: folds 
fralex79: folds 
cruxua: raises $0.20 to $0.30
AAA_set_nh: folds 
Uncalled bet ($0.20) returned to cruxua
cruxua collected $0.20 from pot
cruxua: doesn't show hand 
*** SUMMARY ***
Total pot $0.20 | Rake $0 
Seat 1: AAA_set_nh (big blind) folded before Flop
Seat 2: Lergik folded before Flop (didn't bet)
Seat 4: romanromanro folded before Flop (didn't bet)
Seat 5: fralex79 (button) folded before Flop (didn't bet)
Seat 6: cruxua (small blind) collected ($0.20)



PokerStars Hand #222949173338:  Hold'em No Limit ($0.05/$0.10 USD) - 2021/01/23 5:01:27 ET
Table 'Capricorn II' 6-max Seat #6 is the button
Seat 1: AAA_set_nh ($10 in chips) 
Seat 2: Lergik ($10 in chips) 
Seat 4: romanromanro ($18.04 in chips) 
Seat 5: fralex79 ($7.74 in chips) 
Seat 6: cruxua ($12.89 in chips) 
AAA_set_nh: posts small blind $0.05
Lergik: posts big blind $0.10
*** HOLE CARDS ***
romanromanro: folds 
fralex79: folds 
cruxua: raises $0.15 to $0.25
AAA_set_nh: folds 
Lergik: folds 
Uncalled bet ($0.15) returned to cruxua
cruxua collected $0.25 from pot
cruxua: doesn't show hand 
rpadilla33 joins the table at seat #3 
*** SUMMARY ***
Total pot $0.25 | Rake $0 
Seat 1: AAA_set_nh (small blind) folded before Flop
Seat 2: Lergik (big blind) folded before Flop
Seat 4: romanromanro folded before Flop (didn't bet)
Seat 5: fralex79 folded before Flop (didn't bet)
Seat 6: cruxua (button) collected ($0.25)



PokerStars Hand #222949177290:  Hold'em No Limit ($0.05/$0.10 USD) - 2021/01/23 5:01:41 ET
Table 'Capricorn II' 6-max Seat #1 is the button
Seat 1: AAA_set_nh ($10 in chips) 
Seat 2: Lergik ($10 in chips) 
Seat 3: rpadilla33 ($10 in chips) 
Seat 4: romanromanro ($18.04 in chips) 
Seat 5: fralex79 ($7.74 in chips) 
Seat 6: cruxua ($13.04 in chips) 
Lergik: posts small blind $0.05
rpadilla33 is connected 
rpadilla33: posts big blind $0.10
*** HOLE CARDS ***
romanromanro: folds 
fralex79: folds 
cruxua: folds 
AAA_set_nh: raises $0.15 to $0.25
Lergik: folds 
rpadilla33: folds 
Uncalled bet ($0.15) returned to AAA_set_nh
AAA_set_nh collected $0.25 from pot
AAA_set_nh: doesn't show hand 
*** SUMMARY ***
Total pot $0.25 | Rake $0 
Seat 1: AAA_set_nh (button) collected ($0.25)
Seat 2: Lergik (small blind) folded before Flop
Seat 3: rpadilla33 (big blind) folded before Flop
Seat 4: romanromanro folded before Flop (didn't bet)
Seat 5: fralex79 folded before Flop (didn't bet)
Seat 6: cruxua folded before Flop (didn't bet)



PokerStars Hand #222949183087:  Hold'em No Limit ($0.05/$0.10 USD) - 2021/01/23 5:02:01 ET
Table 'Capricorn II' 6-max Seat #2 is the button
Seat 1: AAA_set_nh ($10.15 in chips) 
Seat 2: Lergik ($10 in chips) 
Seat 3: rpadilla33 ($10 in chips) 
Seat 4: romanromanro ($18.04 in chips) 
Seat 5: fralex79 ($7.74 in chips) 
Seat 6: cruxua ($13.04 in chips) 
rpadilla33: posts small blind $0.05
romanromanro: posts big blind $0.10
*** HOLE CARDS ***
fralex79: folds 
cruxua: folds 
AAA_set_nh: folds 
Lergik: folds 
rpadilla33: folds 
Uncalled bet ($0.05) returned to romanromanro
romanromanro collected $0.10 from pot
romanromanro: doesn't show hand 
*** SUMMARY ***
Total pot $0.10 | Rake $0 
Seat 1: AAA_set_nh folded before Flop (didn't bet)
Seat 2: Lergik (button) folded before Flop (didn't bet)
Seat 3: rpadilla33 (small blind) folded before Flop
Seat 4: romanromanro (big blind) collected ($0.10)
Seat 5: fralex79 folded before Flop (didn't bet)
Seat 6: cruxua folded before Flop (didn't bet)



PokerStars Hand #222949187016:  Hold'em No Limit ($0.05/$0.10 USD) - 2021/01/23 5:02:14 ET
Table 'Capricorn II' 6-max Seat #3 is the button
Seat 1: AAA_set_nh ($10.15 in chips) 
Seat 2: Lergik ($10 in chips) 
Seat 3: rpadilla33 ($10 in chips) 
Seat 4: romanromanro ($18.09 in chips) 
Seat 5: fralex79 ($7.74 in chips) 
Seat 6: cruxua ($13.04 in chips) 
romanromanro: posts small blind $0.05
fralex79: posts big blind $0.10
*** HOLE CARDS ***
cruxua: folds 
AAA_set_nh: folds 
Lergik: folds 
rpadilla33: raises $0.20 to $0.30
romanromanro: folds 
fralex79: calls $0.20
*** FLOP *** [9s 3c As]
fralex79: checks 
rpadilla33: bets $0.20
fralex79: raises $0.50 to $0.70
rpadilla33: calls $0.50
*** TURN *** [9s 3c As] [8h]
fralex79: bets $1
rpadilla33: calls $1
*** RIVER *** [9s 3c As 8h] [6d]
fralex79: checks 
rpadilla33: checks 
*** SHOW DOWN ***
fralex79: shows [7d 7h] (a pair of Sevens)
rpadilla33: shows [Td Ah] (a pair of Aces)
rpadilla33 collected $3.87 from pot
*** SUMMARY ***
Total pot $4.05 | Rake $0.18 
Board [9s 3c As 8h 6d]
Seat 1: AAA_set_nh folded before Flop (didn't bet)
Seat 2: Lergik folded before Flop (didn't bet)
Seat 3: rpadilla33 (button) showed [Td Ah] and won ($3.87) with a pair of Aces
Seat 4: romanromanro (small blind) folded before Flop
Seat 5: fralex79 (big blind) showed [7d 7h] and lost with a pair of Sevens
Seat 6: cruxua folded before Flop (didn't bet)



PokerStars Hand #222949199063:  Hold'em No Limit ($0.05/$0.10 USD) - 2021/01/23 5:02:56 ET
Table 'Capricorn II' 6-max Seat #4 is the button
Seat 1: AAA_set_nh ($10.15 in chips) 
Seat 2: Lergik ($10 in chips) 
Seat 3: rpadilla33 ($11.87 in chips) 
Seat 4: romanromanro ($18.04 in chips) 
Seat 5: fralex79 ($5.74 in chips) 
Seat 6: cruxua ($13.04 in chips) 
fralex79: posts small blind $0.05
cruxua: posts big blind $0.10
*** HOLE CARDS ***
AAA_set_nh: folds 
Lergik: raises $0.20 to $0.30
rpadilla33: folds 
romanromanro: folds 
fralex79: calls $0.25
cruxua: calls $0.20
*** FLOP *** [8d 7s Jh]
fralex79: checks 
cruxua: checks 
Lergik: checks 
*** TURN *** [8d 7s Jh] [3s]
fralex79: bets $0.50
cruxua: calls $0.50
Lergik: folds 
*** RIVER *** [8d 7s Jh 3s] [9d]
fralex79: bets $1
cruxua: raises $2.54 to $3.54
fralex79: folds 
Uncalled bet ($2.54) returned to cruxua
cruxua collected $3.72 from pot
cruxua: doesn't show hand 
*** SUMMARY ***
Total pot $3.90 | Rake $0.18 
Board [8d 7s Jh 3s 9d]
Seat 1: AAA_set_nh folded before Flop (didn't bet)
Seat 2: Lergik folded on the Turn
Seat 3: rpadilla33 folded before Flop (didn't bet)
Seat 4: romanromanro (button) folded before Flop (didn't bet)
Seat 5: fralex79 (small blind) folded on the River
Seat 6: cruxua (big blind) collected ($3.72)



PokerStars Hand #222949218452:  Hold'em No Limit ($0.05/$0.10 USD) - 2021/01/23 5:04:02 ET
Table 'Capricorn II' 6-max Seat #5 is the button
Seat 1: AAA_set_nh ($10.15 in chips) 
Seat 2: Lergik ($10 in chips) 
Seat 3: rpadilla33 ($11.87 in chips) 
Seat 4: romanromanro ($18.04 in chips) 
Seat 5: fralex79 ($3.94 in chips) 
Seat 6: cruxua ($14.96 in chips) 
cruxua: posts small blind $0.05
AAA_set_nh: posts big blind $0.10
*** HOLE CARDS ***
Lergik: folds 
rpadilla33: folds 
romanromanro: folds 
fralex79: calls $0.10
cruxua: calls $0.05
AAA_set_nh: checks 
*** FLOP *** [Qd 3h Kh]
cruxua: checks 
AAA_set_nh: checks 
fralex79: bets $0.10
cruxua: folds 
AAA_set_nh: calls $0.10
*** TURN *** [Qd 3h Kh] [Tc]
AAA_set_nh: checks 
fralex79: bets $0.20
AAA_set_nh: calls $0.20
*** RIVER *** [Qd 3h Kh Tc] [Ts]
AAA_set_nh: checks 
fralex79: bets $0.40
AAA_set_nh: calls $0.40
*** SHOW DOWN ***
fralex79: shows [8c Td] (three of a kind, Tens)
AAA_set_nh: mucks hand 
fralex79 collected $1.62 from pot
*** SUMMARY ***
Total pot $1.70 | Rake $0.08 
Board [Qd 3h Kh Tc Ts]
Seat 1: AAA_set_nh (big blind) mucked
Seat 2: Lergik folded before Flop (didn't bet)
Seat 3: rpadilla33 folded before Flop (didn't bet)
Seat 4: romanromanro folded before Flop (didn't bet)
Seat 5: fralex79 (button) showed [8c Td] and won ($1.62) with three of a kind, Tens
Seat 6: cruxua (small blind) folded on the Flop



PokerStars Hand #222949230617:  Hold'em No Limit ($0.05/$0.10 USD) - 2021/01/23 5:04:43 ET
Table 'Capricorn II' 6-max Seat #6 is the button
Seat 1: AAA_set_nh ($10 in chips) 
Seat 3: rpadilla33 ($11.87 in chips) 
Seat 4: romanromanro ($18.04 in chips) 
Seat 5: fralex79 ($4.76 in chips) 
Seat 6: cruxua ($14.86 in chips) 
AAA_set_nh: posts small blind $0.05
Lergik: is sitting out 
rpadilla33: posts big blind $0.10
*** HOLE CARDS ***
romanromanro: folds 
fralex79: folds 
cruxua: folds 
AAA_set_nh: raises $0.20 to $0.30
rpadilla33: folds 
Uncalled bet ($0.20) returned to AAA_set_nh
AAA_set_nh collected $0.20 from pot
AAA_set_nh: doesn't show hand 
*** SUMMARY ***
Total pot $0.20 | Rake $0 
Seat 1: AAA_set_nh (small blind) collected ($0.20)
Seat 3: rpadilla33 (big blind) folded before Flop
Seat 4: romanromanro folded before Flop (didn't bet)
Seat 5: fralex79 folded before Flop (didn't bet)
Seat 6: cruxua (button) folded before Flop (didn't bet)



PokerStars Hand #222949234109:  Hold'em No Limit ($0.05/$0.10 USD) - 2021/01/23 5:04:55 ET
Table 'Capricorn II' 6-max Seat #1 is the button
Seat 1: AAA_set_nh ($10.10 in chips) 
Seat 3: rpadilla33 ($11.77 in chips) 
Seat 4: romanromanro ($18.04 in chips) 
Seat 5: fralex79 ($4.76 in chips) 
Seat 6: cruxua ($14.86 in chips) 
rpadilla33: posts small blind $0.05
romanromanro: posts big blind $0.10
*** HOLE CARDS ***
fralex79: folds 
cruxua: folds 
Lergik leaves the table
AAA_set_nh: folds 
rpadilla33: folds 
Uncalled bet ($0.05) returned to romanromanro
romanromanro collected $0.10 from pot
romanromanro: doesn't show hand 
*** SUMMARY ***
Total pot $0.10 | Rake $0 
Seat 1: AAA_set_nh (button) folded before Flop (didn't bet)
Seat 3: rpadilla33 (small blind) folded before Flop
Seat 4: romanromanro (big blind) collected ($0.10)
Seat 5: fralex79 folded before Flop (didn't bet)
Seat 6: cruxua folded before Flop (didn't bet)



PokerStars Hand #222949238089:  Hold'em No Limit ($0.05/$0.10 USD) - 2021/01/23 5:05:08 ET
Table 'Capricorn II' 6-max Seat #3 is the button
Seat 1: AAA_set_nh ($10.10 in chips) 
Seat 3: rpadilla33 ($11.72 in chips) 
Seat 4: romanromanro ($18.09 in chips) 
Seat 5: fralex79 ($4.76 in chips) 
Seat 6: cruxua ($14.86 in chips) 
romanromanro: posts small blind $0.05
fralex79: posts big blind $0.10
*** HOLE CARDS ***
cruxua: folds 
AAA_set_nh: folds 
rpadilla33: raises $0.20 to $0.30
romanromanro: raises $0.80 to $1.10
fralex79: folds 
rpadilla33: folds 
Uncalled bet ($0.80) returned to romanromanro
romanromanro collected $0.70 from pot
romanromanro: doesn't show hand 
*** SUMMARY ***
Total pot $0.70 | Rake $0 
Seat 1: AAA_set_nh folded before Flop (didn't bet)
Seat 3: rpadilla33 (button) folded before Flop
Seat 4: romanromanro (small blind) collected ($0.70)
Seat 5: fralex79 (big blind) folded before Flop
Seat 6: cruxua folded before Flop (didn't bet)



PokerStars Hand #222949243199:  Hold'em No Limit ($0.05/$0.10 USD) - 2021/01/23 5:05:26 ET
Table 'Capricorn II' 6-max Seat #4 is the button
Seat 1: AAA_set_nh ($10.10 in chips) 
Seat 3: rpadilla33 ($11.42 in chips) 
Seat 4: romanromanro ($18.49 in chips) 
Seat 5: fralex79 ($4.66 in chips) 
Seat 6: cruxua ($14.86 in chips) 
fralex79: posts small blind $0.05
cruxua: posts big blind $0.10
*** HOLE CARDS ***
3EBC96 joins the table at seat #2 
AAA_set_nh: raises $0.20 to $0.30
rpadilla33: folds 
romanromanro: calls $0.30
fralex79: calls $0.25
cruxua: folds 
*** FLOP *** [7c Ks 2c]
fralex79: checks 
AAA_set_nh: checks 
romanromanro: checks 
*** TURN *** [7c Ks 2c] [4c]
fralex79: bets $0.50
AAA_set_nh: raises $1.50 to $2
romanromanro: folds 
fralex79: raises $2.36 to $4.36 and is all-in
AAA_set_nh: calls $2.36
*** RIVER *** [7c Ks 2c 4c] [9h]
*** SHOW DOWN ***
fralex79: shows [4h Kh] (two pair, Kings and Fours)
AAA_set_nh: shows [Kc 9c] (a flush, King high)
AAA_set_nh collected $9.28 from pot
*** SUMMARY ***
Total pot $9.72 | Rake $0.44 
Board [7c Ks 2c 4c 9h]
Seat 1: AAA_set_nh showed [Kc 9c] and won ($9.28) with a flush, King high
Seat 3: rpadilla33 folded before Flop (didn't bet)
Seat 4: romanromanro (button) folded on the Turn
Seat 5: fralex79 (small blind) showed [4h Kh] and lost with two pair, Kings and Fours
Seat 6: cruxua (big blind) folded before Flop



PokerStars Hand #222949260339:  Hold'em No Limit ($0.05/$0.10 USD) - 2021/01/23 5:06:25 ET
Table 'Capricorn II' 6-max Seat #6 is the button
Seat 1: AAA_set_nh ($14.72 in chips) 
Seat 2: 3EBC96 ($10 in chips) 
Seat 3: rpadilla33 ($11.42 in chips) 
Seat 4: romanromanro ($18.19 in chips) 
Seat 6: cruxua ($14.76 in chips) 
AAA_set_nh: posts small blind $0.05
3EBC96: posts big blind $0.10
*** HOLE CARDS ***
rpadilla33: folds 
romanromanro: folds 
cruxua: raises $0.15 to $0.25
AAA_set_nh: folds 
3EBC96: raises $0.95 to $1.20
cruxua: folds 
Uncalled bet ($0.95) returned to 3EBC96
3EBC96 collected $0.55 from pot
3EBC96: doesn't show hand 
*** SUMMARY ***
Total pot $0.55 | Rake $0 
Seat 1: AAA_set_nh (small blind) folded before Flop
Seat 2: 3EBC96 (big blind) collected ($0.55)
Seat 3: rpadilla33 folded before Flop (didn't bet)
Seat 4: romanromanro folded before Flop (didn't bet)
Seat 6: cruxua (button) folded before Flop



PokerStars Hand #222949264391:  Hold'em No Limit ($0.05/$0.10 USD) - 2021/01/23 5:06:38 ET
Table 'Capricorn II' 6-max Seat #1 is the button
Seat 1: AAA_set_nh ($14.67 in chips) 
Seat 2: 3EBC96 ($10.30 in chips) 
Seat 3: rpadilla33 ($11.42 in chips) 
Seat 4: romanromanro ($18.19 in chips) 
Seat 6: cruxua ($14.51 in chips) 
3EBC96: posts small blind $0.05
rpadilla33: posts big blind $0.10
*** HOLE CARDS ***
romanromanro: folds 
cruxua: folds 
AAA_set_nh: raises $0.10 to $0.20
3EBC96: folds 
fralex79 leaves the table
rpadilla33: calls $0.10
*** FLOP *** [3s 7s 5c]
rpadilla33: checks 
AAA_set_nh: checks 
*** TURN *** [3s 7s 5c] [2c]
rpadilla33: checks 
AAA_set_nh: checks 
*** RIVER *** [3s 7s 5c 2c] [6h]
rpadilla33: checks 
AAA_set_nh: checks 
*** SHOW DOWN ***
rpadilla33: shows [Qd Th] (high card Queen)
AAA_set_nh: shows [Ks Jh] (high card King)
AAA_set_nh collected $0.43 from pot
*** SUMMARY ***
Total pot $0.45 | Rake $0.02 
Board [3s 7s 5c 2c 6h]
Seat 1: AAA_set_nh (button) showed [Ks Jh] and won ($0.43) with high card King
Seat 2: 3EBC96 (small blind) folded before Flop
Seat 3: rpadilla33 (big blind) showed [Qd Th] and lost with high card Queen
Seat 4: romanromanro folded before Flop (didn't bet)
Seat 6: cruxua folded before Flop (didn't bet)



PokerStars Hand #222949273329:  Hold'em No Limit ($0.05/$0.10 USD) - 2021/01/23 5:07:09 ET
Table 'Capricorn II' 6-max Seat #2 is the button
Seat 1: AAA_set_nh ($14.90 in chips) 
Seat 2: 3EBC96 ($10.25 in chips) 
Seat 3: rpadilla33 ($11.22 in chips) 
Seat 4: romanromanro ($18.19 in chips) 
Seat 6: cruxua ($14.51 in chips) 
rpadilla33: posts small blind $0.05
romanromanro: posts big blind $0.10
*** HOLE CARDS ***
cruxua: folds 
AAA_set_nh: folds 
3EBC96: folds 
rpadilla33: raises $0.20 to $0.30
jazou10 joins the table at seat #5 
romanromanro: folds 
Uncalled bet ($0.20) returned to rpadilla33
rpadilla33 collected $0.20 from pot
rpadilla33: doesn't show hand 
*** SUMMARY ***
Total pot $0.20 | Rake $0 
Seat 1: AAA_set_nh folded before Flop (didn't bet)
Seat 2: 3EBC96 (button) folded before Flop (didn't bet)
Seat 3: rpadilla33 (small blind) collected ($0.20)
Seat 4: romanromanro (big blind) folded before Flop
Seat 6: cruxua folded before Flop (didn't bet)



PokerStars Hand #222949277016:  Hold'em No Limit ($0.05/$0.10 USD) - 2021/01/23 5:07:22 ET
Table 'Capricorn II' 6-max Seat #3 is the button
Seat 1: AAA_set_nh ($14.90 in chips) 
Seat 2: 3EBC96 ($10.25 in chips) 
Seat 3: rpadilla33 ($11.32 in chips) 
Seat 4: romanromanro ($18.09 in chips) 
Seat 5: jazou10 ($8 in chips) 
Seat 6: cruxua ($14.51 in chips) 
romanromanro: posts small blind $0.05
jazou10: posts big blind $0.10
*** HOLE CARDS ***
cruxua: folds 
AAA_set_nh: folds 
3EBC96: folds 
rpadilla33: folds 
romanromanro: folds 
Uncalled bet ($0.05) returned to jazou10
jazou10 collected $0.10 from pot
jazou10: doesn't show hand 
*** SUMMARY ***
Total pot $0.10 | Rake $0 
Seat 1: AAA_set_nh folded before Flop (didn't bet)
Seat 2: 3EBC96 folded before Flop (didn't bet)
Seat 3: rpadilla33 (button) folded before Flop (didn't bet)
Seat 4: romanromanro (small blind) folded before Flop
Seat 5: jazou10 (big blind) collected ($0.10)
Seat 6: cruxua folded before Flop (didn't bet)



PokerStars Hand #222949280082:  Hold'em No Limit ($0.05/$0.10 USD) - 2021/01/23 5:07:33 ET
Table 'Capricorn II' 6-max Seat #4 is the button
Seat 1: AAA_set_nh ($14.90 in chips) 
Seat 2: 3EBC96 ($10.25 in chips) 
Seat 3: rpadilla33 ($11.32 in chips) 
Seat 4: romanromanro ($18.04 in chips) 
Seat 5: jazou10 ($8.05 in chips) 
Seat 6: cruxua ($14.51 in chips) 
jazou10: posts small blind $0.05
cruxua: posts big blind $0.10
*** HOLE CARDS ***
AAA_set_nh: folds 
3EBC96: folds 
rpadilla33: raises $0.20 to $0.30
romanromanro: folds 
jazou10: calls $0.25
cruxua: folds 
*** FLOP *** [7s 9c 3h]
jazou10: checks 
rpadilla33: bets $0.30
jazou10: calls $0.30
*** TURN *** [7s 9c 3h] [5s]
jazou10: bets $0.62
rpadilla33: folds 
Uncalled bet ($0.62) returned to jazou10
jazou10 collected $1.24 from pot
jazou10: doesn't show hand 
*** SUMMARY ***
Total pot $1.30 | Rake $0.06 
Board [7s 9c 3h 5s]
Seat 1: AAA_set_nh folded before Flop (didn't bet)
Seat 2: 3EBC96 folded before Flop (didn't bet)
Seat 3: rpadilla33 folded on the Turn
Seat 4: romanromanro (button) folded before Flop (didn't bet)
Seat 5: jazou10 (small blind) collected ($1.24)
Seat 6: cruxua (big blind) folded before Flop



PokerStars Hand #222949288360:  Hold'em No Limit ($0.05/$0.10 USD) - 2021/01/23 5:08:01 ET
Table 'Capricorn II' 6-max Seat #5 is the button
Seat 1: AAA_set_nh ($14.90 in chips) 
Seat 2: 3EBC96 ($10.25 in chips) 
Seat 3: rpadilla33 ($10.72 in chips) 
Seat 4: romanromanro ($18.04 in chips) 
Seat 5: jazou10 ($8.69 in chips) 
Seat 6: cruxua ($14.41 in chips) 
cruxua: posts small blind $0.05
AAA_set_nh: posts big blind $0.10
*** HOLE CARDS ***
3EBC96: folds 
rpadilla33: folds 
romanromanro: folds 
jazou10: folds 
cruxua: folds 
Uncalled bet ($0.05) returned to AAA_set_nh
AAA_set_nh collected $0.10 from pot
AAA_set_nh: doesn't show hand 
*** SUMMARY ***
Total pot $0.10 | Rake $0 
Seat 1: AAA_set_nh (big blind) collected ($0.10)
Seat 2: 3EBC96 folded before Flop (didn't bet)
Seat 3: rpadilla33 folded before Flop (didn't bet)
Seat 4: romanromanro folded before Flop (didn't bet)
Seat 5: jazou10 (button) folded before Flop (didn't bet)
Seat 6: cruxua (small blind) folded before Flop



PokerStars Hand #222949291173:  Hold'em No Limit ($0.05/$0.10 USD) - 2021/01/23 5:08:11 ET
Table 'Capricorn II' 6-max Seat #6 is the button
Seat 1: AAA_set_nh ($14.95 in chips) 
Seat 2: 3EBC96 ($10.25 in chips) 
Seat 3: rpadilla33 ($10.72 in chips) 
Seat 4: romanromanro ($18.04 in chips) 
Seat 5: jazou10 ($8.69 in chips) 
Seat 6: cruxua ($14.36 in chips) 
AAA_set_nh: posts small blind $0.05
3EBC96: posts big blind $0.10
*** HOLE CARDS ***
rpadilla33: folds 
romanromanro: raises $0.15 to $0.25
jazou10: folds 
cruxua: raises $0.55 to $0.80
AAA_set_nh: folds 
3EBC96: folds 
romanromanro: calls $0.55
*** FLOP *** [4s 8h As]
romanromanro: checks 
cruxua: bets $1.11
romanromanro: folds 
Uncalled bet ($1.11) returned to cruxua
cruxua collected $1.67 from pot
cruxua: doesn't show hand 
*** SUMMARY ***
Total pot $1.75 | Rake $0.08 
Board [4s 8h As]
Seat 1: AAA_set_nh (small blind) folded before Flop
Seat 2: 3EBC96 (big blind) folded before Flop
Seat 3: rpadilla33 folded before Flop (didn't bet)
Seat 4: romanromanro folded on the Flop
Seat 5: jazou10 folded before Flop (didn't bet)
Seat 6: cruxua (button) collected ($1.67)



PokerStars Hand #222949304965:  Hold'em No Limit ($0.05/$0.10 USD) - 2021/01/23 5:08:57 ET
Table 'Capricorn II' 6-max Seat #1 is the button
Seat 1: AAA_set_nh ($14.90 in chips) 
Seat 2: 3EBC96 ($10.15 in chips) 
Seat 3: rpadilla33 ($10.72 in chips) 
Seat 4: romanromanro ($17.24 in chips) 
Seat 5: jazou10 ($8.69 in chips) 
Seat 6: cruxua ($15.23 in chips) 
3EBC96: posts small blind $0.05
rpadilla33: posts big blind $0.10
*** HOLE CARDS ***
romanromanro: folds 
jazou10: calls $0.10
cruxua: folds 
AAA_set_nh: folds 
3EBC96: folds 
rpadilla33: checks 
*** FLOP *** [Qh 4d 7c]
rpadilla33: checks 
jazou10: checks 
*** TURN *** [Qh 4d 7c] [6s]
rpadilla33: checks 
jazou10: checks 
*** RIVER *** [Qh 4d 7c 6s] [5s]
rpadilla33: checks 
jazou10: checks 
*** SHOW DOWN ***
rpadilla33: shows [Jc 8c] (a straight, Four to Eight)
jazou10: mucks hand 
rpadilla33 collected $0.24 from pot
*** SUMMARY ***
Total pot $0.25 | Rake $0.01 
Board [Qh 4d 7c 6s 5s]
Seat 1: AAA_set_nh (button) folded before Flop (didn't bet)
Seat 2: 3EBC96 (small blind) folded before Flop
Seat 3: rpadilla33 (big blind) showed [Jc 8c] and won ($0.24) with a straight, Four to Eight
Seat 4: romanromanro folded before Flop (didn't bet)
Seat 5: jazou10 mucked
Seat 6: cruxua folded before Flop (didn't bet)



PokerStars Hand #222949313529:  Hold'em No Limit ($0.05/$0.10 USD) - 2021/01/23 5:09:26 ET
Table 'Capricorn II' 6-max Seat #2 is the button
Seat 1: AAA_set_nh ($14.90 in chips) 
Seat 2: 3EBC96 ($10.10 in chips) 
Seat 3: rpadilla33 ($10.86 in chips) 
Seat 4: romanromanro ($17.24 in chips) 
Seat 5: jazou10 ($8.59 in chips) 
Seat 6: cruxua ($15.23 in chips) 
rpadilla33: posts small blind $0.05
romanromanro: posts big blind $0.10
*** HOLE CARDS ***
jazou10: calls $0.10
cruxua: raises $0.30 to $0.40
AAA_set_nh: folds 
3EBC96: folds 
rpadilla33: folds 
romanromanro: folds 
jazou10: folds 
Uncalled bet ($0.30) returned to cruxua
cruxua collected $0.35 from pot
cruxua: doesn't show hand 
*** SUMMARY ***
Total pot $0.35 | Rake $0 
Seat 1: AAA_set_nh folded before Flop (didn't bet)
Seat 2: 3EBC96 (button) folded before Flop (didn't bet)
Seat 3: rpadilla33 (small blind) folded before Flop
Seat 4: romanromanro (big blind) folded before Flop
Seat 5: jazou10 folded before Flop
Seat 6: cruxua collected ($0.35)



PokerStars Hand #222949319801:  Hold'em No Limit ($0.05/$0.10 USD) - 2021/01/23 5:09:47 ET
Table 'Capricorn II' 6-max Seat #3 is the button
Seat 1: AAA_set_nh ($14.90 in chips) 
Seat 2: 3EBC96 ($10.10 in chips) 
Seat 3: rpadilla33 ($10.81 in chips) 
Seat 4: romanromanro ($17.14 in chips) 
Seat 5: jazou10 ($8.49 in chips) 
Seat 6: cruxua ($15.48 in chips) 
romanromanro: posts small blind $0.05
jazou10: posts big blind $0.10
*** HOLE CARDS ***
cruxua: folds 
AAA_set_nh: folds 
3EBC96: folds 
rpadilla33: raises $0.20 to $0.30
romanromanro: folds 
jazou10 has timed out
jazou10: folds 
Uncalled bet ($0.20) returned to rpadilla33
rpadilla33 collected $0.25 from pot
rpadilla33: doesn't show hand 
*** SUMMARY ***
Total pot $0.25 | Rake $0 
Seat 1: AAA_set_nh folded before Flop (didn't bet)
Seat 2: 3EBC96 folded before Flop (didn't bet)
Seat 3: rpadilla33 (button) collected ($0.25)
Seat 4: romanromanro (small blind) folded before Flop
Seat 5: jazou10 (big blind) folded before Flop
Seat 6: cruxua folded before Flop (didn't bet)



PokerStars Hand #222949332284:  Hold'em No Limit ($0.05/$0.10 USD) - 2021/01/23 5:10:30 ET
Table 'Capricorn II' 6-max Seat #4 is the button
Seat 1: AAA_set_nh ($14.90 in chips) 
Seat 2: 3EBC96 ($10.10 in chips) 
Seat 3: rpadilla33 ($10.96 in chips) 
Seat 4: romanromanro ($17.09 in chips) 
Seat 6: cruxua ($15.48 in chips) 
cruxua: posts small blind $0.05
AAA_set_nh: posts big blind $0.10
*** HOLE CARDS ***
3EBC96: raises $0.20 to $0.30
rpadilla33: folds 
romanromanro: folds 
cruxua: folds 
AAA_set_nh: calls $0.20
*** FLOP *** [8d Qc 4d]
AAA_set_nh: checks 
3EBC96: bets $0.31
AAA_set_nh: folds 
Uncalled bet ($0.31) returned to 3EBC96
3EBC96 collected $0.62 from pot
3EBC96: doesn't show hand 
*** SUMMARY ***
Total pot $0.65 | Rake $0.03 
Board [8d Qc 4d]
Seat 1: AAA_set_nh (big blind) folded on the Flop
Seat 2: 3EBC96 collected ($0.62)
Seat 3: rpadilla33 folded before Flop (didn't bet)
Seat 4: romanromanro (button) folded before Flop (didn't bet)
Seat 6: cruxua (small blind) folded before Flop



PokerStars Hand #222949340870:  Hold'em No Limit ($0.05/$0.10 USD) - 2021/01/23 5:10:59 ET
Table 'Capricorn II' 6-max Seat #6 is the button
Seat 1: AAA_set_nh ($14.60 in chips) 
Seat 3: rpadilla33 ($10.96 in chips) 
Seat 4: romanromanro ($17.09 in chips) 
Seat 6: cruxua ($15.43 in chips) 
AAA_set_nh: posts small blind $0.05
rpadilla33: posts big blind $0.10
jazou10: sits out 
*** HOLE CARDS ***
romanromanro: folds 
cruxua: raises $0.15 to $0.25
AAA_set_nh: folds 
rpadilla33: raises $0.85 to $1.10
cruxua: folds 
Uncalled bet ($0.85) returned to rpadilla33
rpadilla33 collected $0.55 from pot
rpadilla33: doesn't show hand 
*** SUMMARY ***
Total pot $0.55 | Rake $0 
Seat 1: AAA_set_nh (small blind) folded before Flop
Seat 3: rpadilla33 (big blind) collected ($0.55)
Seat 4: romanromanro folded before Flop (didn't bet)
Seat 6: cruxua (button) folded before Flop



PokerStars Hand #222949345900:  Hold'em No Limit ($0.05/$0.10 USD) - 2021/01/23 5:11:16 ET
Table 'Capricorn II' 6-max Seat #1 is the button
Seat 1: AAA_set_nh ($14.55 in chips) 
Seat 3: rpadilla33 ($11.26 in chips) 
Seat 4: romanromanro ($17.09 in chips) 
Seat 5: jazou10 ($8.39 in chips) 
Seat 6: cruxua ($15.18 in chips) 
rpadilla33: posts small blind $0.05
romanromanro: posts big blind $0.10
jazou10: posts small blind $0.05
*** HOLE CARDS ***
jazou10: calls $0.10
cruxua: raises $0.20 to $0.30
AAA_set_nh: folds 
rpadilla33: folds 
romanromanro: folds 
jazou10: calls $0.20
*** FLOP *** [4c Kd 7d]
jazou10: checks 
cruxua: bets $0.51
jazou10: folds 
Uncalled bet ($0.51) returned to cruxua
cruxua collected $0.76 from pot
cruxua: doesn't show hand 
*** SUMMARY ***
Total pot $0.80 | Rake $0.04 
Board [4c Kd 7d]
Seat 1: AAA_set_nh (button) folded before Flop (didn't bet)
Seat 3: rpadilla33 (small blind) folded before Flop
Seat 4: romanromanro (big blind) folded before Flop
Seat 5: jazou10 folded on the Flop
Seat 6: cruxua collected ($0.76)



PokerStars Hand #222949355596:  Hold'em No Limit ($0.05/$0.10 USD) - 2021/01/23 5:11:49 ET
Table 'Capricorn II' 6-max Seat #3 is the button
Seat 1: AAA_set_nh ($14.55 in chips) 
Seat 3: rpadilla33 ($11.21 in chips) 
Seat 4: romanromanro ($16.99 in chips) 
Seat 5: jazou10 ($8.04 in chips) 
Seat 6: cruxua ($15.64 in chips) 
romanromanro: posts small blind $0.05
jazou10: posts big blind $0.10
3EBC96: sits out 
*** HOLE CARDS ***
cruxua: folds 
AAA_set_nh: folds 
rpadilla33: folds 
romanromanro: folds 
Uncalled bet ($0.05) returned to jazou10
jazou10 collected $0.10 from pot
AAA_set_nh leaves the table
jazou10: doesn't show hand 
*** SUMMARY ***
Total pot $0.10 | Rake $0 
Seat 1: AAA_set_nh folded before Flop (didn't bet)
Seat 3: rpadilla33 (button) folded before Flop (didn't bet)
Seat 4: romanromanro (small blind) folded before Flop
Seat 5: jazou10 (big blind) collected ($0.10)
Seat 6: cruxua folded before Flop (didn't bet)



PokerStars Hand #222949360485:  Hold'em No Limit ($0.05/$0.10 USD) - 2021/01/23 5:12:05 ET
Table 'Capricorn II' 6-max Seat #5 is the button
Seat 1: PainForYou25 ($10 in chips) 
Seat 3: rpadilla33 ($11.36 in chips) 
Seat 4: romanromanro ($16.94 in chips) 
Seat 5: jazou10 ($8.04 in chips) 
Seat 6: cruxua ($15.54 in chips) 
cruxua: posts small blind $0.05
PainForYou25 is connected 
PainForYou25: posts big blind $0.10
3EBC96: sits out 
*** HOLE CARDS ***
rpadilla33: folds 
romanromanro: folds 
jazou10: folds 
cruxua: raises $0.20 to $0.30
PainForYou25: folds 
Uncalled bet ($0.20) returned to cruxua
cruxua collected $0.20 from pot
cruxua: doesn't show hand 
*** SUMMARY ***
Total pot $0.20 | Rake $0 
Seat 1: PainForYou25 (big blind) folded before Flop
Seat 3: rpadilla33 folded before Flop (didn't bet)
Seat 4: romanromanro folded before Flop (didn't bet)
Seat 5: jazou10 (button) folded before Flop (didn't bet)
Seat 6: cruxua (small blind) collected ($0.20)



PokerStars Hand #222949363589:  Hold'em No Limit ($0.05/$0.10 USD) - 2021/01/23 5:12:16 ET
Table 'Capricorn II' 6-max Seat #6 is the button
Seat 1: PainForYou25 ($9.90 in chips) 
Seat 2: 3EBC96 ($10.42 in chips) 
Seat 3: rpadilla33 ($11.36 in chips) 
Seat 4: romanromanro ($16.94 in chips) 
Seat 5: jazou10 ($8.04 in chips) 
Seat 6: cruxua ($15.64 in chips) 
PainForYou25: posts small blind $0.05
3EBC96: posts big blind $0.10
*** HOLE CARDS ***
rpadilla33: folds 
romanromanro: folds 
jazou10: raises $0.20 to $0.30
cruxua: folds 
PainForYou25: calls $0.25
3EBC96: raises $0.90 to $1.20
jazou10: calls $0.90
PainForYou25: calls $0.90
*** FLOP *** [8c Jd 9c]
PainForYou25: checks 
3EBC96: checks 
jazou10: checks 
*** TURN *** [8c Jd 9c] [3s]
PainForYou25: checks 
3EBC96: checks 
jazou10: checks 
*** RIVER *** [8c Jd 9c 3s] [5s]
PainForYou25: checks 
3EBC96: bets $2.10
jazou10: calls $2.10
PainForYou25: folds 
*** SHOW DOWN ***
3EBC96: shows [Td Kd] (high card King)
jazou10: shows [Qs Qd] (a pair of Queens)
jazou10 collected $7.45 from pot
*** SUMMARY ***
Total pot $7.80 | Rake $0.35 
Board [8c Jd 9c 3s 5s]
Seat 1: PainForYou25 (small blind) folded on the River
Seat 2: 3EBC96 (big blind) showed [Td Kd] and lost with high card King
Seat 3: rpadilla33 folded before Flop (didn't bet)
Seat 4: romanromanro folded before Flop (didn't bet)
Seat 5: jazou10 showed [Qs Qd] and won ($7.45) with a pair of Queens
Seat 6: cruxua (button) folded before Flop (didn't bet)



PokerStars Hand #222949389513:  Hold'em No Limit ($0.05/$0.10 USD) - 2021/01/23 5:13:44 ET
Table 'Capricorn II' 6-max Seat #2 is the button
Seat 1: PainForYou25 ($9.12 in chips) 
Seat 2: 3EBC96 ($10 in chips) 
Seat 3: rpadilla33 ($11.26 in chips) 
Seat 4: romanromanro ($16.94 in chips) 
Seat 5: jazou10 ($11.89 in chips) 
Seat 6: cruxua ($15.64 in chips) 
rpadilla33: posts small blind $0.05
romanromanro: posts big blind $0.10
*** HOLE CARDS ***
jazou10: folds 
cruxua: folds 
PainForYou25: calls $0.10
3EBC96: raises $0.20 to $0.30
rpadilla33: folds 
romanromanro: raises $0.75 to $1.05
PainForYou25: calls $0.95
3EBC96: calls $0.75
*** FLOP *** [7h 7d Td]
romanromanro: checks 
PainForYou25: checks 
3EBC96: checks 
*** TURN *** [7h 7d Td] [7c]
romanromanro: checks 
PainForYou25: bets $1.53
3EBC96: calls $1.53
romanromanro: calls $1.53
*** RIVER *** [7h 7d Td 7c] [5c]
romanromanro: bets $14.36 and is all-in
PainForYou25: folds 
3EBC96: folds 
Uncalled bet ($14.36) returned to romanromanro
romanromanro collected $7.44 from pot
romanromanro: doesn't show hand 
*** SUMMARY ***
Total pot $7.79 | Rake $0.35 
Board [7h 7d Td 7c 5c]
Seat 1: PainForYou25 folded on the River
Seat 2: 3EBC96 (button) folded on the River
Seat 3: rpadilla33 (small blind) folded before Flop
Seat 4: romanromanro (big blind) collected ($7.44)
Seat 5: jazou10 folded before Flop (didn't bet)
Seat 6: cruxua folded before Flop (didn't bet)



PokerStars Hand #222949408522:  Hold'em No Limit ($0.05/$0.10 USD) - 2021/01/23 5:14:49 ET
Table 'Capricorn II' 6-max Seat #3 is the button
Seat 1: PainForYou25 ($6.54 in chips) 
Seat 2: 3EBC96 ($10 in chips) 
Seat 3: rpadilla33 ($11.21 in chips) 
Seat 5: jazou10 ($11.89 in chips) 
Seat 6: cruxua ($15.64 in chips) 
jazou10: posts small blind $0.05
cruxua: posts big blind $0.10
*** HOLE CARDS ***
romanromanro was removed from the table for failing to post
romanromanro leaves the table
PainForYou25: raises $0.10 to $0.20
3EBC96: folds 
rpadilla33: folds 
brightsunfun joins the table at seat #4 
jazou10 has timed out
jazou10: folds 
cruxua: folds 
Uncalled bet ($0.10) returned to PainForYou25
PainForYou25 collected $0.25 from pot
PainForYou25: doesn't show hand 
*** SUMMARY ***
Total pot $0.25 | Rake $0 
Seat 1: PainForYou25 collected ($0.25)
Seat 2: 3EBC96 folded before Flop (didn't bet)
Seat 3: rpadilla33 (button) folded before Flop (didn't bet)
Seat 5: jazou10 (small blind) folded before Flop
Seat 6: cruxua (big blind) folded before Flop



PokerStars Hand #222949417732:  Hold'em No Limit ($0.05/$0.10 USD) - 2021/01/23 5:15:20 ET
Table 'Capricorn II' 6-max Seat #6 is the button
Seat 1: PainForYou25 ($6.69 in chips) 
Seat 2: 3EBC96 ($10 in chips) 
Seat 3: rpadilla33 ($11.21 in chips) 
Seat 6: cruxua ($15.54 in chips) 
PainForYou25: posts small blind $0.05
3EBC96: posts big blind $0.10
brightsunfun: sits out 
*** HOLE CARDS ***
rpadilla33: folds 
cruxua: raises $0.15 to $0.25
PainForYou25: folds 
3EBC96: calls $0.15
*** FLOP *** [4c Th 7h]
3EBC96: checks 
cruxua: bets $0.35
3EBC96: raises $0.65 to $1
cruxua: folds 
Uncalled bet ($0.65) returned to 3EBC96
3EBC96 collected $1.19 from pot
3EBC96: doesn't show hand 
*** SUMMARY ***
Total pot $1.25 | Rake $0.06 
Board [4c Th 7h]
Seat 1: PainForYou25 (small blind) folded before Flop
Seat 2: 3EBC96 (big blind) collected ($1.19)
Seat 3: rpadilla33 folded before Flop (didn't bet)
Seat 6: cruxua (button) folded on the Flop



PokerStars Hand #222949429715:  Hold'em No Limit ($0.05/$0.10 USD) - 2021/01/23 5:16:00 ET
Table 'Capricorn II' 6-max Seat #1 is the button
Seat 1: PainForYou25 ($6.64 in chips) 
Seat 2: 3EBC96 ($10.59 in chips) 
Seat 3: rpadilla33 ($11.21 in chips) 
Seat 5: jazou10 ($11.84 in chips) 
Seat 6: cruxua ($14.94 in chips) 
3EBC96: posts small blind $0.05
rpadilla33: posts big blind $0.10
brightsunfun: sits out 
*** HOLE CARDS ***
jazou10 has timed out
jazou10: folds 
cruxua: folds 
PainForYou25: raises $0.20 to $0.30
3EBC96: folds 
rpadilla33: raises $0.70 to $1
PainForYou25: calls $0.70
*** FLOP *** [5d Ad Jd]
rpadilla33: bets $1
PainForYou25: calls $1
*** TURN *** [5d Ad Jd] [7d]
rpadilla33: checks 
PainForYou25: bets $4.64 and is all-in
rpadilla33: calls $4.64
*** RIVER *** [5d Ad Jd 7d] [8s]
*** SHOW DOWN ***
rpadilla33: shows [Tc Td] (a flush, Ace high)
PainForYou25: shows [8d Qd] (a flush, Ace high - Queen higher)
PainForYou25 collected $12.73 from pot
*** SUMMARY ***
Total pot $13.33 | Rake $0.60 
Board [5d Ad Jd 7d 8s]
Seat 1: PainForYou25 (button) showed [8d Qd] and won ($12.73) with a flush, Ace high
Seat 2: 3EBC96 (small blind) folded before Flop
Seat 3: rpadilla33 (big blind) showed [Tc Td] and lost with a flush, Ace high
Seat 5: jazou10 folded before Flop (didn't bet)
Seat 6: cruxua folded before Flop (didn't bet)



PokerStars Hand #222949453044:  Hold'em No Limit ($0.05/$0.10 USD) - 2021/01/23 5:16:48 ET
Table 'Capricorn II' 6-max Seat #2 is the button
Seat 1: PainForYou25 ($12.73 in chips) 
Seat 2: 3EBC96 ($10.54 in chips) 
Seat 3: rpadilla33 ($10 in chips) 
Seat 4: brightsunfun ($10 in chips) 
Seat 5: jazou10 ($11.84 in chips) 
Seat 6: cruxua ($14.94 in chips) 
rpadilla33: posts small blind $0.05
brightsunfun: posts big blind $0.10
*** HOLE CARDS ***
jazou10: folds 
cruxua: folds 
PainForYou25: folds 
3EBC96: folds 
rpadilla33: raises $0.20 to $0.30
brightsunfun: calls $0.20
*** FLOP *** [Jh Kc Ts]
rpadilla33: bets $0.30
brightsunfun: calls $0.30
*** TURN *** [Jh Kc Ts] [4d]
rpadilla33: checks 
brightsunfun: checks 
*** RIVER *** [Jh Kc Ts 4d] [3d]
rpadilla33: checks 
brightsunfun: checks 
*** SHOW DOWN ***
rpadilla33: shows [3c Ah] (a pair of Threes)
brightsunfun: shows [Qd Js] (a pair of Jacks)
brightsunfun collected $1.15 from pot
*** SUMMARY ***
Total pot $1.20 | Rake $0.05 
Board [Jh Kc Ts 4d 3d]
Seat 1: PainForYou25 folded before Flop (didn't bet)
Seat 2: 3EBC96 (button) folded before Flop (didn't bet)
Seat 3: rpadilla33 (small blind) showed [3c Ah] and lost with a pair of Threes
Seat 4: brightsunfun (big blind) showed [Qd Js] and won ($1.15) with a pair of Jacks
Seat 5: jazou10 folded before Flop (didn't bet)
Seat 6: cruxua folded before Flop (didn't bet)



PokerStars Hand #222949466147:  Hold'em No Limit ($0.05/$0.10 USD) - 2021/01/23 5:17:32 ET
Table 'Capricorn II' 6-max Seat #3 is the button
Seat 1: PainForYou25 ($12.73 in chips) 
Seat 2: 3EBC96 ($10.54 in chips) 
Seat 3: rpadilla33 ($10 in chips) 
Seat 4: brightsunfun ($10.55 in chips) 
Seat 5: jazou10 ($11.84 in chips) 
Seat 6: cruxua ($14.94 in chips) 
brightsunfun: posts small blind $0.05
jazou10: posts big blind $0.10
*** HOLE CARDS ***
cruxua: folds 
PainForYou25: calls $0.10
3EBC96: raises $0.40 to $0.50
rpadilla33: calls $0.50
brightsunfun: folds 
jazou10: calls $0.40
PainForYou25: calls $0.40
*** FLOP *** [5c Js 3h]
jazou10: checks 
PainForYou25: checks 
3EBC96: bets $1
rpadilla33: folds 
jazou10: folds 
PainForYou25: folds 
Uncalled bet ($1) returned to 3EBC96
3EBC96 collected $1.96 from pot
3EBC96: doesn't show hand 
*** SUMMARY ***
Total pot $2.05 | Rake $0.09 
Board [5c Js 3h]
Seat 1: PainForYou25 folded on the Flop
Seat 2: 3EBC96 collected ($1.96)
Seat 3: rpadilla33 (button) folded on the Flop
Seat 4: brightsunfun (small blind) folded before Flop
Seat 5: jazou10 (big blind) folded on the Flop
Seat 6: cruxua folded before Flop (didn't bet)



PokerStars Hand #222949480037:  Hold'em No Limit ($0.05/$0.10 USD) - 2021/01/23 5:18:19 ET
Table 'Capricorn II' 6-max Seat #4 is the button
Seat 1: PainForYou25 ($12.23 in chips) 
Seat 2: 3EBC96 ($12 in chips) 
Seat 3: rpadilla33 ($10 in chips) 
Seat 4: brightsunfun ($10.50 in chips) 
Seat 5: jazou10 ($11.34 in chips) 
Seat 6: cruxua ($14.94 in chips) 
jazou10: posts small blind $0.05
cruxua: posts big blind $0.10
*** HOLE CARDS ***
PainForYou25: raises $0.10 to $0.20
3EBC96: folds 
rpadilla33: folds 
brightsunfun: calls $0.20
jazou10: calls $0.15
cruxua: calls $0.10
*** FLOP *** [3s 9h 4s]
jazou10: checks 
cruxua: checks 
PainForYou25: bets $0.38
brightsunfun: folds 
jazou10: folds 
cruxua: folds 
Uncalled bet ($0.38) returned to PainForYou25
PainForYou25 collected $0.76 from pot
PainForYou25: doesn't show hand 
*** SUMMARY ***
Total pot $0.80 | Rake $0.04 
Board [3s 9h 4s]
Seat 1: PainForYou25 collected ($0.76)
Seat 2: 3EBC96 folded before Flop (didn't bet)
Seat 3: rpadilla33 folded before Flop (didn't bet)
Seat 4: brightsunfun (button) folded on the Flop
Seat 5: jazou10 (small blind) folded on the Flop
Seat 6: cruxua (big blind) folded on the Flop



PokerStars Hand #222949506207:  Hold'em No Limit ($0.05/$0.10 USD) - 2021/01/23 5:19:47 ET
Table 'Capricorn II' 6-max Seat #6 is the button
Seat 1: PainForYou25 ($12.84 in chips) 
Seat 2: 3EBC96 ($12 in chips) 
Seat 3: rpadilla33 ($10 in chips) 
Seat 4: brightsunfun ($10.30 in chips) 
Seat 5: jazou10 ($11.14 in chips) 
Seat 6: cruxua ($14.69 in chips) 
PainForYou25: posts small blind $0.05
3EBC96: posts big blind $0.10
*** HOLE CARDS ***
rpadilla33: folds 
brightsunfun: folds 
jazou10: calls $0.10
cruxua: folds 
PainForYou25: calls $0.05
3EBC96: checks 
*** FLOP *** [Ac Td 6h]
PainForYou25: checks 
3EBC96: checks 
jazou10: checks 
*** TURN *** [Ac Td 6h] [9h]
PainForYou25: checks 
3EBC96: checks 
jazou10: checks 
*** RIVER *** [Ac Td 6h 9h] [Qc]
PainForYou25: checks 
3EBC96: checks 
jazou10: checks 
*** SHOW DOWN ***
PainForYou25: shows [Ah 2d] (a pair of Aces)
3EBC96: mucks hand 
jazou10: mucks hand 
PainForYou25 collected $0.29 from pot
*** SUMMARY ***
Total pot $0.30 | Rake $0.01 
Board [Ac Td 6h 9h Qc]
Seat 1: PainForYou25 (small blind) showed [Ah 2d] and won ($0.29) with a pair of Aces
Seat 2: 3EBC96 (big blind) mucked
Seat 3: rpadilla33 folded before Flop (didn't bet)
Seat 4: brightsunfun folded before Flop (didn't bet)
Seat 5: jazou10 mucked
Seat 6: cruxua (button) folded before Flop (didn't bet)



PokerStars Hand #222949517140:  Hold'em No Limit ($0.05/$0.10 USD) - 2021/01/23 5:20:23 ET
Table 'Capricorn II' 6-max Seat #1 is the button
Seat 1: PainForYou25 ($13.03 in chips) 
Seat 2: 3EBC96 ($11.90 in chips) 
Seat 3: rpadilla33 ($10 in chips) 
Seat 4: brightsunfun ($10.30 in chips) 
Seat 5: jazou10 ($11.04 in chips) 
Seat 6: cruxua ($14.69 in chips) 
3EBC96: posts small blind $0.05
rpadilla33: posts big blind $0.10
*** HOLE CARDS ***
brightsunfun: folds 
jazou10: folds 
cruxua: raises $0.20 to $0.30
PainForYou25: folds 
3EBC96: folds 
rpadilla33: calls $0.20
*** FLOP *** [2h 9c 3d]
rpadilla33: checks 
cruxua: checks 
*** TURN *** [2h 9c 3d] [Jc]
rpadilla33: bets $0.30
cruxua: folds 
Uncalled bet ($0.30) returned to rpadilla33
rpadilla33 collected $0.62 from pot
rpadilla33: doesn't show hand 
*** SUMMARY ***
Total pot $0.65 | Rake $0.03 
Board [2h 9c 3d Jc]
Seat 1: PainForYou25 (button) folded before Flop (didn't bet)
Seat 2: 3EBC96 (small blind) folded before Flop
Seat 3: rpadilla33 (big blind) collected ($0.62)
Seat 4: brightsunfun folded before Flop (didn't bet)
Seat 5: jazou10 folded before Flop (didn't bet)
Seat 6: cruxua folded on the Turn



PokerStars Hand #222949524967:  Hold'em No Limit ($0.05/$0.10 USD) - 2021/01/23 5:20:49 ET
Table 'Capricorn II' 6-max Seat #2 is the button
Seat 1: PainForYou25 ($13.03 in chips) 
Seat 2: 3EBC96 ($11.85 in chips) 
Seat 3: rpadilla33 ($10.32 in chips) 
Seat 5: jazou10 ($11.04 in chips) 
Seat 6: cruxua ($14.39 in chips) 
rpadilla33: posts small blind $0.05
brightsunfun: is sitting out 
jazou10: posts big blind $0.10
*** HOLE CARDS ***
brightsunfun leaves the table
cruxua: folds 
Chrysk2 joins the table at seat #4 
PainForYou25: folds 
3EBC96: raises $0.20 to $0.30
rpadilla33: folds 
jazou10: folds 
Uncalled bet ($0.20) returned to 3EBC96
3EBC96 collected $0.25 from pot
3EBC96: doesn't show hand 
*** SUMMARY ***
Total pot $0.25 | Rake $0 
Seat 1: PainForYou25 folded before Flop (didn't bet)
Seat 2: 3EBC96 (button) collected ($0.25)
Seat 3: rpadilla33 (small blind) folded before Flop
Seat 5: jazou10 (big blind) folded before Flop
Seat 6: cruxua folded before Flop (didn't bet)



PokerStars Hand #222949532506:  Hold'em No Limit ($0.05/$0.10 USD) - 2021/01/23 5:21:14 ET
Table 'Capricorn II' 6-max Seat #3 is the button
Seat 1: PainForYou25 ($13.03 in chips) 
Seat 2: 3EBC96 ($12 in chips) 
Seat 3: rpadilla33 ($10.27 in chips) 
Seat 5: jazou10 ($10.94 in chips) 
Seat 6: cruxua ($14.39 in chips) 
jazou10: posts small blind $0.05
cruxua: posts big blind $0.10
*** HOLE CARDS ***
PainForYou25: folds 
3EBC96: folds 
rpadilla33: raises $0.20 to $0.30
jazou10: calls $0.25
cruxua: folds 
*** FLOP *** [Qc 4d 8d]
jazou10: checks 
rpadilla33: bets $0.30
jazou10: folds 
Uncalled bet ($0.30) returned to rpadilla33
rpadilla33 collected $0.67 from pot
rpadilla33: doesn't show hand 
*** SUMMARY ***
Total pot $0.70 | Rake $0.03 
Board [Qc 4d 8d]
Seat 1: PainForYou25 folded before Flop (didn't bet)
Seat 2: 3EBC96 folded before Flop (didn't bet)
Seat 3: rpadilla33 (button) collected ($0.67)
Seat 5: jazou10 (small blind) folded on the Flop
Seat 6: cruxua (big blind) folded before Flop



PokerStars Hand #222949541597:  Hold'em No Limit ($0.05/$0.10 USD) - 2021/01/23 5:21:44 ET
Table 'Capricorn II' 6-max Seat #5 is the button
Seat 1: PainForYou25 ($13.03 in chips) 
Seat 2: 3EBC96 ($12 in chips) 
Seat 3: rpadilla33 ($10.64 in chips) 
Seat 4: Chrysk2 ($10 in chips) 
Seat 5: jazou10 ($10.64 in chips) 
Seat 6: cruxua ($14.29 in chips) 
cruxua: posts small blind $0.05
PainForYou25: posts big blind $0.10
Chrysk2: posts big blind $0.10
*** HOLE CARDS ***
3EBC96: folds 
rpadilla33: folds 
Chrysk2: raises $0.30 to $0.40
jazou10: folds 
cruxua: folds 
PainForYou25: folds 
Uncalled bet ($0.30) returned to Chrysk2
Chrysk2 collected $0.25 from pot
Chrysk2: doesn't show hand 
*** SUMMARY ***
Total pot $0.25 | Rake $0 
Seat 1: PainForYou25 (big blind) folded before Flop
Seat 2: 3EBC96 folded before Flop (didn't bet)
Seat 3: rpadilla33 folded before Flop (didn't bet)
Seat 4: Chrysk2 collected ($0.25)
Seat 5: jazou10 (button) folded before Flop (didn't bet)
Seat 6: cruxua (small blind) folded before Flop



PokerStars Hand #222949549269:  Hold'em No Limit ($0.05/$0.10 USD) - 2021/01/23 5:22:09 ET
Table 'Capricorn II' 6-max Seat #6 is the button
Seat 1: PainForYou25 ($12.93 in chips) 
Seat 2: 3EBC96 ($12 in chips) 
Seat 3: rpadilla33 ($10.64 in chips) 
Seat 4: Chrysk2 ($10.15 in chips) 
Seat 5: jazou10 ($10.64 in chips) 
Seat 6: cruxua ($14.24 in chips) 
PainForYou25: posts small blind $0.05
3EBC96: posts big blind $0.10
*** HOLE CARDS ***
rpadilla33: folds 
Chrysk2: folds 
jazou10: folds 
cruxua: folds 
PainForYou25: calls $0.05
3EBC96: checks 
*** FLOP *** [Kd Qh Tc]
PainForYou25: checks 
3EBC96: checks 
*** TURN *** [Kd Qh Tc] [Td]
PainForYou25: checks 
3EBC96: checks 
*** RIVER *** [Kd Qh Tc Td] [7s]
PainForYou25: checks 
3EBC96: checks 
*** SHOW DOWN ***
PainForYou25: shows [Ac 2h] (a pair of Tens)
3EBC96: mucks hand 
PainForYou25 collected $0.19 from pot
*** SUMMARY ***
Total pot $0.20 | Rake $0.01 
Board [Kd Qh Tc Td 7s]
Seat 1: PainForYou25 (small blind) showed [Ac 2h] and won ($0.19) with a pair of Tens
Seat 2: 3EBC96 (big blind) mucked
Seat 3: rpadilla33 folded before Flop (didn't bet)
Seat 4: Chrysk2 folded before Flop (didn't bet)
Seat 5: jazou10 folded before Flop (didn't bet)
Seat 6: cruxua (button) folded before Flop (didn't bet)



PokerStars Hand #222950024357:  Hold'em No Limit ($0.05/$0.10 USD) - 2021/01/23 5:47:41 ET
Table 'Capricorn II' 6-max Seat #6 is the button
Seat 1: Muhlen9 ($10.30 in chips) 
Seat 2: 3EBC96 ($11.43 in chips) 
Seat 3: Picco1952 ($8.08 in chips) 
Seat 4: Chrysk2 ($11.28 in chips) 
Seat 5: jazou10 ($5.12 in chips) 
Seat 6: cruxua ($14.91 in chips) 
Muhlen9: posts small blind $0.05
3EBC96: posts big blind $0.10
*** HOLE CARDS ***
Picco1952: folds 
Chrysk2: raises $0.20 to $0.30
jazou10: calls $0.30
cruxua: folds 
Muhlen9: folds 
3EBC96: folds 
*** FLOP *** [Qs 7c Jc]
Chrysk2: checks 
jazou10: checks 
*** TURN *** [Qs 7c Jc] [3c]
Chrysk2: bets $0.36
jazou10: folds 
Uncalled bet ($0.36) returned to Chrysk2
Chrysk2 collected $0.72 from pot
Chrysk2: doesn't show hand 
*** SUMMARY ***
Total pot $0.75 | Rake $0.03 
Board [Qs 7c Jc 3c]
Seat 1: Muhlen9 (small blind) folded before Flop
Seat 2: 3EBC96 (big blind) folded before Flop
Seat 3: Picco1952 folded before Flop (didn't bet)
Seat 4: Chrysk2 collected ($0.72)
Seat 5: jazou10 folded on the Turn
Seat 6: cruxua (button) folded before Flop (didn't bet)



PokerStars Hand #222950036888:  Hold'em No Limit ($0.05/$0.10 USD) - 2021/01/23 5:48:20 ET
Table 'Capricorn II' 6-max Seat #1 is the button
Seat 1: Muhlen9 ($10.25 in chips) 
Seat 2: 3EBC96 ($11.33 in chips) 
Seat 3: Picco1952 ($8.08 in chips) 
Seat 4: Chrysk2 ($11.70 in chips) 
Seat 5: jazou10 ($4.82 in chips) 
Seat 6: cruxua ($14.91 in chips) 
3EBC96: posts small blind $0.05
Picco1952: posts big blind $0.10
*** HOLE CARDS ***
Chrysk2: folds 
jazou10: calls $0.10
cruxua: raises $0.30 to $0.40
Muhlen9: folds 
3EBC96: folds 
Picco1952: calls $0.30
jazou10: calls $0.30
*** FLOP *** [8c Ad 4s]
Picco1952: checks 
jazou10: checks 
cruxua: checks 
*** TURN *** [8c Ad 4s] [Kc]
Picco1952: checks 
jazou10: checks 
cruxua: bets $0.79
Picco1952: calls $0.79
jazou10: folds 
*** RIVER *** [8c Ad 4s Kc] [Qc]
Picco1952: checks 
cruxua: bets $1.35
Picco1952: calls $1.35
*** SHOW DOWN ***
cruxua: shows [Qd Kh] (two pair, Kings and Queens)
Picco1952: shows [5c 2c] (a flush, King high)
Picco1952 collected $5.28 from pot
*** SUMMARY ***
Total pot $5.53 | Rake $0.25 
Board [8c Ad 4s Kc Qc]
Seat 1: Muhlen9 (button) folded before Flop (didn't bet)
Seat 2: 3EBC96 (small blind) folded before Flop
Seat 3: Picco1952 (big blind) showed [5c 2c] and won ($5.28) with a flush, King high
Seat 4: Chrysk2 folded before Flop (didn't bet)
Seat 5: jazou10 folded on the Turn
Seat 6: cruxua showed [Qd Kh] and lost with two pair, Kings and Queens



PokerStars Hand #222950058446:  Hold'em No Limit ($0.05/$0.10 USD) - 2021/01/23 5:49:29 ET
Table 'Capricorn II' 6-max Seat #2 is the button
Seat 1: Muhlen9 ($10.25 in chips) 
Seat 2: 3EBC96 ($11.28 in chips) 
Seat 3: Picco1952 ($10.82 in chips) 
Seat 4: Chrysk2 ($11.70 in chips) 
Seat 5: jazou10 ($4.42 in chips) 
Seat 6: cruxua ($12.37 in chips) 
Picco1952: posts small blind $0.05
Chrysk2: posts big blind $0.10
*** HOLE CARDS ***
jazou10: calls $0.10
cruxua: folds 
Muhlen9: folds 
3EBC96: folds 
Picco1952: folds 
Chrysk2: checks 
*** FLOP *** [8s 7s Ac]
Chrysk2: bets $0.15
jazou10: calls $0.15
*** TURN *** [8s 7s Ac] [4h]
Chrysk2: bets $0.25
jazou10: calls $0.25
*** RIVER *** [8s 7s Ac 4h] [9d]
Chrysk2: checks 
jazou10: checks 
*** SHOW DOWN ***
Chrysk2: shows [9c Th] (a pair of Nines)
jazou10: shows [Ad 6d] (a pair of Aces)
jazou10 collected $1 from pot
*** SUMMARY ***
Total pot $1.05 | Rake $0.05 
Board [8s 7s Ac 4h 9d]
Seat 1: Muhlen9 folded before Flop (didn't bet)
Seat 2: 3EBC96 (button) folded before Flop (didn't bet)
Seat 3: Picco1952 (small blind) folded before Flop
Seat 4: Chrysk2 (big blind) showed [9c Th] and lost with a pair of Nines
Seat 5: jazou10 showed [Ad 6d] and won ($1) with a pair of Aces
Seat 6: cruxua folded before Flop (didn't bet)



PokerStars Hand #222950069520:  Hold'em No Limit ($0.05/$0.10 USD) - 2021/01/23 5:50:04 ET
Table 'Capricorn II' 6-max Seat #3 is the button
Seat 1: Muhlen9 ($10.25 in chips) 
Seat 2: 3EBC96 ($11.28 in chips) 
Seat 3: Picco1952 ($10.77 in chips) 
Seat 4: Chrysk2 ($11.20 in chips) 
Seat 5: jazou10 ($4.92 in chips) 
Seat 6: cruxua ($12.37 in chips) 
Chrysk2: posts small blind $0.05
jazou10: posts big blind $0.10
*** HOLE CARDS ***
cruxua: folds 
Muhlen9: folds 
3EBC96: raises $0.20 to $0.30
Picco1952: folds 
Chrysk2: folds 
jazou10: folds 
Uncalled bet ($0.20) returned to 3EBC96
3EBC96 collected $0.25 from pot
3EBC96: doesn't show hand 
*** SUMMARY ***
Total pot $0.25 | Rake $0 
Seat 1: Muhlen9 folded before Flop (didn't bet)
Seat 2: 3EBC96 collected ($0.25)
Seat 3: Picco1952 (button) folded before Flop (didn't bet)
Seat 4: Chrysk2 (small blind) folded before Flop
Seat 5: jazou10 (big blind) folded before Flop
Seat 6: cruxua folded before Flop (didn't bet)



PokerStars Hand #222950072702:  Hold'em No Limit ($0.05/$0.10 USD) - 2021/01/23 5:50:14 ET
Table 'Capricorn II' 6-max Seat #4 is the button
Seat 1: Muhlen9 ($10.25 in chips) 
Seat 2: 3EBC96 ($11.43 in chips) 
Seat 3: Picco1952 ($10.77 in chips) 
Seat 4: Chrysk2 ($11.15 in chips) 
Seat 5: jazou10 ($4.82 in chips) 
Seat 6: cruxua ($12.37 in chips) 
jazou10: posts small blind $0.05
cruxua: posts big blind $0.10
*** HOLE CARDS ***
Muhlen9: folds 
3EBC96: raises $0.20 to $0.30
Picco1952: folds 
Chrysk2: folds 
jazou10: folds 
cruxua: calls $0.20
*** FLOP *** [4c Kd 4h]
cruxua: bets $0.41
3EBC96: folds 
Uncalled bet ($0.41) returned to cruxua
cruxua collected $0.62 from pot
cruxua: doesn't show hand 
*** SUMMARY ***
Total pot $0.65 | Rake $0.03 
Board [4c Kd 4h]
Seat 1: Muhlen9 folded before Flop (didn't bet)
Seat 2: 3EBC96 folded on the Flop
Seat 3: Picco1952 folded before Flop (didn't bet)
Seat 4: Chrysk2 (button) folded before Flop (didn't bet)
Seat 5: jazou10 (small blind) folded before Flop
Seat 6: cruxua (big blind) collected ($0.62)



PokerStars Hand #222950079828:  Hold'em No Limit ($0.05/$0.10 USD) - 2021/01/23 5:50:36 ET
Table 'Capricorn II' 6-max Seat #5 is the button
Seat 1: Muhlen9 ($10.25 in chips) 
Seat 2: 3EBC96 ($11.13 in chips) 
Seat 3: Picco1952 ($10.77 in chips) 
Seat 4: Chrysk2 ($11.15 in chips) 
Seat 5: jazou10 ($4.77 in chips) 
Seat 6: cruxua ($12.69 in chips) 
cruxua: posts small blind $0.05
Muhlen9: posts big blind $0.10
*** HOLE CARDS ***
3EBC96: folds 
Picco1952: folds 
Chrysk2: raises $0.20 to $0.30
jazou10: folds 
cruxua: folds 
Muhlen9: folds 
Uncalled bet ($0.20) returned to Chrysk2
Chrysk2 collected $0.25 from pot
Chrysk2: doesn't show hand 
*** SUMMARY ***
Total pot $0.25 | Rake $0 
Seat 1: Muhlen9 (big blind) folded before Flop
Seat 2: 3EBC96 folded before Flop (didn't bet)
Seat 3: Picco1952 folded before Flop (didn't bet)
Seat 4: Chrysk2 collected ($0.25)
Seat 5: jazou10 (button) folded before Flop (didn't bet)
Seat 6: cruxua (small blind) folded before Flop



PokerStars Hand #222950087520:  Hold'em No Limit ($0.05/$0.10 USD) - 2021/01/23 5:51:01 ET
Table 'Capricorn II' 6-max Seat #6 is the button
Seat 1: Muhlen9 ($10.15 in chips) 
Seat 2: 3EBC96 ($11.13 in chips) 
Seat 3: Picco1952 ($10.77 in chips) 
Seat 4: Chrysk2 ($11.30 in chips) 
Seat 5: jazou10 ($4.77 in chips) 
Seat 6: cruxua ($12.64 in chips) 
Muhlen9: posts small blind $0.05
3EBC96: posts big blind $0.10
*** HOLE CARDS ***
Picco1952: folds 
Chrysk2: folds 
jazou10: raises $0.10 to $0.20
cruxua: folds 
Muhlen9: folds 
3EBC96: folds 
Uncalled bet ($0.10) returned to jazou10
jazou10 collected $0.25 from pot
jazou10: doesn't show hand 
*** SUMMARY ***
Total pot $0.25 | Rake $0 
Seat 1: Muhlen9 (small blind) folded before Flop
Seat 2: 3EBC96 (big blind) folded before Flop
Seat 3: Picco1952 folded before Flop (didn't bet)
Seat 4: Chrysk2 folded before Flop (didn't bet)
Seat 5: jazou10 collected ($0.25)
Seat 6: cruxua (button) folded before Flop (didn't bet)



PokerStars Hand #222950092117:  Hold'em No Limit ($0.05/$0.10 USD) - 2021/01/23 5:51:15 ET
Table 'Capricorn II' 6-max Seat #1 is the button
Seat 1: Muhlen9 ($10.10 in chips) 
Seat 2: 3EBC96 ($11.03 in chips) 
Seat 3: Picco1952 ($10.77 in chips) 
Seat 4: Chrysk2 ($11.30 in chips) 
Seat 5: jazou10 ($4.92 in chips) 
Seat 6: cruxua ($12.64 in chips) 
3EBC96: posts small blind $0.05
Picco1952: posts big blind $0.10
*** HOLE CARDS ***
Chrysk2: raises $0.20 to $0.30
jazou10: folds 
cruxua: calls $0.30
Muhlen9: folds 
3EBC96: folds 
Picco1952: folds 
*** FLOP *** [4h 2h 6s]
Chrysk2: bets $0.55
cruxua: folds 
Uncalled bet ($0.55) returned to Chrysk2
Chrysk2 collected $0.72 from pot
Chrysk2: doesn't show hand 
*** SUMMARY ***
Total pot $0.75 | Rake $0.03 
Board [4h 2h 6s]
Seat 1: Muhlen9 (button) folded before Flop (didn't bet)
Seat 2: 3EBC96 (small blind) folded before Flop
Seat 3: Picco1952 (big blind) folded before Flop
Seat 4: Chrysk2 collected ($0.72)
Seat 5: jazou10 folded before Flop (didn't bet)
Seat 6: cruxua folded on the Flop



PokerStars Hand #222950100411:  Hold'em No Limit ($0.05/$0.10 USD) - 2021/01/23 5:51:42 ET
Table 'Capricorn II' 6-max Seat #2 is the button
Seat 1: Muhlen9 ($10.10 in chips) 
Seat 2: 3EBC96 ($10.98 in chips) 
Seat 3: Picco1952 ($10.67 in chips) 
Seat 4: Chrysk2 ($11.72 in chips) 
Seat 5: jazou10 ($4.92 in chips) 
Seat 6: cruxua ($12.34 in chips) 
Picco1952: posts small blind $0.05
Chrysk2: posts big blind $0.10
*** HOLE CARDS ***
jazou10: raises $0.20 to $0.30
cruxua: raises $0.60 to $0.90
Muhlen9: folds 
3EBC96: folds 
Picco1952: folds 
Chrysk2: folds 
jazou10: calls $0.60
*** FLOP *** [Qd 4d 5c]
jazou10: checks 
cruxua: bets $1.20
jazou10: calls $1.20
*** TURN *** [Qd 4d 5c] [6h]
jazou10: checks 
cruxua: bets $2.80
jazou10: raises $0.02 to $2.82 and is all-in
cruxua: calls $0.02
*** RIVER *** [Qd 4d 5c 6h] [9d]
*** SHOW DOWN ***
jazou10: shows [5d 5s] (three of a kind, Fives)
cruxua: shows [Ks Kh] (a pair of Kings)
jazou10 collected $9.54 from pot
*** SUMMARY ***
Total pot $9.99 | Rake $0.45 
Board [Qd 4d 5c 6h 9d]
Seat 1: Muhlen9 folded before Flop (didn't bet)
Seat 2: 3EBC96 (button) folded before Flop (didn't bet)
Seat 3: Picco1952 (small blind) folded before Flop
Seat 4: Chrysk2 (big blind) folded before Flop
Seat 5: jazou10 showed [5d 5s] and won ($9.54) with three of a kind, Fives
Seat 6: cruxua showed [Ks Kh] and lost with a pair of Kings



PokerStars Hand #222950118299:  Hold'em No Limit ($0.05/$0.10 USD) - 2021/01/23 5:52:39 ET
Table 'Capricorn II' 6-max Seat #3 is the button
Seat 1: Muhlen9 ($10.10 in chips) 
Seat 2: 3EBC96 ($10.98 in chips) 
Seat 3: Picco1952 ($10.62 in chips) 
Seat 4: Chrysk2 ($11.62 in chips) 
Seat 5: jazou10 ($9.54 in chips) 
Seat 6: cruxua ($10 in chips) 
Chrysk2: posts small blind $0.05
jazou10: posts big blind $0.10
*** HOLE CARDS ***
cruxua: folds 
Muhlen9: folds 
3EBC96: folds 
Picco1952: folds 
Chrysk2: raises $0.20 to $0.30
jazou10: folds 
Uncalled bet ($0.20) returned to Chrysk2
Chrysk2 collected $0.20 from pot
Chrysk2: doesn't show hand 
*** SUMMARY ***
Total pot $0.20 | Rake $0 
Seat 1: Muhlen9 folded before Flop (didn't bet)
Seat 2: 3EBC96 folded before Flop (didn't bet)
Seat 3: Picco1952 (button) folded before Flop (didn't bet)
Seat 4: Chrysk2 (small blind) collected ($0.20)
Seat 5: jazou10 (big blind) folded before Flop
Seat 6: cruxua folded before Flop (didn't bet)



PokerStars Hand #222950125775:  Hold'em No Limit ($0.05/$0.10 USD) - 2021/01/23 5:53:03 ET
Table 'Capricorn II' 6-max Seat #4 is the button
Seat 1: Muhlen9 ($10.10 in chips) 
Seat 2: 3EBC96 ($10.98 in chips) 
Seat 3: Picco1952 ($10.62 in chips) 
Seat 4: Chrysk2 ($11.72 in chips) 
Seat 5: jazou10 ($9.44 in chips) 
Seat 6: cruxua ($10 in chips) 
jazou10: posts small blind $0.05
cruxua: posts big blind $0.10
*** HOLE CARDS ***
Muhlen9: folds 
3EBC96: folds 
Picco1952: calls $0.10
Chrysk2: folds 
jazou10: folds 
cruxua: checks 
*** FLOP *** [Tc 9s Ad]
cruxua: checks 
Picco1952: checks 
*** TURN *** [Tc 9s Ad] [9d]
cruxua: checks 
Picco1952: checks 
*** RIVER *** [Tc 9s Ad 9d] [6d]
cruxua: checks 
Picco1952: checks 
*** SHOW DOWN ***
cruxua: shows [5c 8d] (a pair of Nines)
Picco1952: shows [Kh Jh] (a pair of Nines - Ace+King kicker)
Picco1952 collected $0.24 from pot
*** SUMMARY ***
Total pot $0.25 | Rake $0.01 
Board [Tc 9s Ad 9d 6d]
Seat 1: Muhlen9 folded before Flop (didn't bet)
Seat 2: 3EBC96 folded before Flop (didn't bet)
Seat 3: Picco1952 showed [Kh Jh] and won ($0.24) with a pair of Nines
Seat 4: Chrysk2 (button) folded before Flop (didn't bet)
Seat 5: jazou10 (small blind) folded before Flop
Seat 6: cruxua (big blind) showed [5c 8d] and lost with a pair of Nines



PokerStars Hand #222950140372:  Hold'em No Limit ($0.05/$0.10 USD) - 2021/01/23 5:53:49 ET
Table 'Capricorn II' 6-max Seat #5 is the button
Seat 1: Muhlen9 ($10.10 in chips) 
Seat 2: 3EBC96 ($10.98 in chips) 
Seat 3: Picco1952 ($10.76 in chips) 
Seat 4: Chrysk2 ($11.72 in chips) 
Seat 5: jazou10 ($9.39 in chips) 
Seat 6: cruxua ($10 in chips) 
cruxua: posts small blind $0.05
Muhlen9: posts big blind $0.10
*** HOLE CARDS ***
3EBC96: folds 
Picco1952: folds 
Chrysk2: raises $0.20 to $0.30
jazou10: folds 
cruxua: folds 
Muhlen9: folds 
Uncalled bet ($0.20) returned to Chrysk2
Chrysk2 collected $0.25 from pot
Chrysk2: doesn't show hand 
*** SUMMARY ***
Total pot $0.25 | Rake $0 
Seat 1: Muhlen9 (big blind) folded before Flop
Seat 2: 3EBC96 folded before Flop (didn't bet)
Seat 3: Picco1952 folded before Flop (didn't bet)
Seat 4: Chrysk2 collected ($0.25)
Seat 5: jazou10 (button) folded before Flop (didn't bet)
Seat 6: cruxua (small blind) folded before Flop



PokerStars Hand #222950146183:  Hold'em No Limit ($0.05/$0.10 USD) - 2021/01/23 5:54:07 ET
Table 'Capricorn II' 6-max Seat #6 is the button
Seat 1: Muhlen9 ($10 in chips) 
Seat 2: 3EBC96 ($10.98 in chips) 
Seat 3: Picco1952 ($10.76 in chips) 
Seat 4: Chrysk2 ($11.87 in chips) 
Seat 5: jazou10 ($9.39 in chips) 
Seat 6: cruxua ($10 in chips) 
Muhlen9: posts small blind $0.05
3EBC96: posts big blind $0.10
*** HOLE CARDS ***
Picco1952: folds 
Chrysk2: folds 
jazou10: folds 
cruxua: folds 
Muhlen9: raises $0.20 to $0.30
3EBC96: raises $0.60 to $0.90
Muhlen9: calls $0.60
*** FLOP *** [9s 7s 9d]
Muhlen9: checks 
3EBC96: bets $0.57
Muhlen9: calls $0.57
*** TURN *** [9s 7s 9d] [Kc]
Muhlen9: checks 
3EBC96: bets $1.41
Muhlen9: raises $1.41 to $2.82
3EBC96: calls $1.41
*** RIVER *** [9s 7s 9d Kc] [Js]
Muhlen9: bets $5.71 and is all-in
3EBC96: folds 
Uncalled bet ($5.71) returned to Muhlen9
Muhlen9 collected $8.19 from pot
Muhlen9: doesn't show hand 
*** SUMMARY ***
Total pot $8.58 | Rake $0.39 
Board [9s 7s 9d Kc Js]
Seat 1: Muhlen9 (small blind) collected ($8.19)
Seat 2: 3EBC96 (big blind) folded on the River
Seat 3: Picco1952 folded before Flop (didn't bet)
Seat 4: Chrysk2 folded before Flop (didn't bet)
Seat 5: jazou10 folded before Flop (didn't bet)
Seat 6: cruxua (button) folded before Flop (didn't bet)



PokerStars Hand #222950164724:  Hold'em No Limit ($0.05/$0.10 USD) - 2021/01/23 5:55:06 ET
Table 'Capricorn II' 6-max Seat #1 is the button
Seat 1: Muhlen9 ($13.90 in chips) 
Seat 2: 3EBC96 ($10 in chips) 
Seat 3: Picco1952 ($10.76 in chips) 
Seat 4: Chrysk2 ($11.87 in chips) 
Seat 5: jazou10 ($9.39 in chips) 
Seat 6: cruxua ($10 in chips) 
3EBC96: posts small blind $0.05
Picco1952: posts big blind $0.10
*** HOLE CARDS ***
Chrysk2: folds 
jazou10: folds 
cruxua: raises $0.20 to $0.30
Muhlen9: folds 
3EBC96: folds 
Picco1952: calls $0.20
*** FLOP *** [4s 5h 8c]
Picco1952: checks 
cruxua: bets $0.47
Picco1952: folds 
Uncalled bet ($0.47) returned to cruxua
cruxua collected $0.62 from pot
cruxua: doesn't show hand 
*** SUMMARY ***
Total pot $0.65 | Rake $0.03 
Board [4s 5h 8c]
Seat 1: Muhlen9 (button) folded before Flop (didn't bet)
Seat 2: 3EBC96 (small blind) folded before Flop
Seat 3: Picco1952 (big blind) folded on the Flop
Seat 4: Chrysk2 folded before Flop (didn't bet)
Seat 5: jazou10 folded before Flop (didn't bet)
Seat 6: cruxua collected ($0.62)



PokerStars Hand #222950171323:  Hold'em No Limit ($0.05/$0.10 USD) - 2021/01/23 5:55:30 ET
Table 'Capricorn II' 6-max Seat #2 is the button
Seat 1: Muhlen9 ($13.90 in chips) 
Seat 2: 3EBC96 ($10 in chips) 
Seat 3: Picco1952 ($10.46 in chips) 
Seat 4: Chrysk2 ($11.87 in chips) 
Seat 5: jazou10 ($9.39 in chips) 
Seat 6: cruxua ($10.32 in chips) 
Picco1952: posts small blind $0.05
Chrysk2: posts big blind $0.10
*** HOLE CARDS ***
jazou10: folds 
cruxua: raises $0.20 to $0.30
Muhlen9: folds 
3EBC96: raises $0.60 to $0.90
Picco1952: folds 
Chrysk2: folds 
cruxua: folds 
Uncalled bet ($0.60) returned to 3EBC96
3EBC96 collected $0.75 from pot
3EBC96: doesn't show hand 
*** SUMMARY ***
Total pot $0.75 | Rake $0 
Seat 1: Muhlen9 folded before Flop (didn't bet)
Seat 2: 3EBC96 (button) collected ($0.75)
Seat 3: Picco1952 (small blind) folded before Flop
Seat 4: Chrysk2 (big blind) folded before Flop
Seat 5: jazou10 folded before Flop (didn't bet)
Seat 6: cruxua folded before Flop



PokerStars Hand #222950177174:  Hold'em No Limit ($0.05/$0.10 USD) - 2021/01/23 5:55:51 ET
Table 'Capricorn II' 6-max Seat #3 is the button
Seat 1: Muhlen9 ($13.90 in chips) 
Seat 2: 3EBC96 ($10.45 in chips) 
Seat 3: Picco1952 ($10.41 in chips) 
Seat 4: Chrysk2 ($11.77 in chips) 
Seat 5: jazou10 ($9.39 in chips) 
Seat 6: cruxua ($10.02 in chips) 
Chrysk2: posts small blind $0.05
jazou10: posts big blind $0.10
*** HOLE CARDS ***
cruxua: raises $0.20 to $0.30
Muhlen9: folds 
3EBC96: folds 
Picco1952: calls $0.30
Chrysk2: folds 
jazou10: calls $0.20
*** FLOP *** [8s Th 8h]
jazou10: checks 
cruxua: bets $0.61
Picco1952: folds 
jazou10: folds 
Uncalled bet ($0.61) returned to cruxua
cruxua collected $0.91 from pot
cruxua: doesn't show hand 
*** SUMMARY ***
Total pot $0.95 | Rake $0.04 
Board [8s Th 8h]
Seat 1: Muhlen9 folded before Flop (didn't bet)
Seat 2: 3EBC96 folded before Flop (didn't bet)
Seat 3: Picco1952 (button) folded on the Flop
Seat 4: Chrysk2 (small blind) folded before Flop
Seat 5: jazou10 (big blind) folded on the Flop
Seat 6: cruxua collected ($0.91)



PokerStars Hand #222950189698:  Hold'em No Limit ($0.05/$0.10 USD) - 2021/01/23 5:56:37 ET
Table 'Capricorn II' 6-max Seat #4 is the button
Seat 1: Muhlen9 ($13.90 in chips) 
Seat 2: 3EBC96 ($10.45 in chips) 
Seat 3: Picco1952 ($10.11 in chips) 
Seat 4: Chrysk2 ($11.72 in chips) 
Seat 5: jazou10 ($9.09 in chips) 
Seat 6: cruxua ($10.63 in chips) 
jazou10: posts small blind $0.05
cruxua: posts big blind $0.10
*** HOLE CARDS ***
Muhlen9: raises $0.15 to $0.25
3EBC96: folds 
Picco1952: folds 
Chrysk2: folds 
jazou10: folds 
cruxua: calls $0.15
*** FLOP *** [2s Td 5c]
cruxua: checks 
Muhlen9: bets $0.17
cruxua: folds 
Uncalled bet ($0.17) returned to Muhlen9
Muhlen9 collected $0.53 from pot
Muhlen9: doesn't show hand 
*** SUMMARY ***
Total pot $0.55 | Rake $0.02 
Board [2s Td 5c]
Seat 1: Muhlen9 collected ($0.53)
Seat 2: 3EBC96 folded before Flop (didn't bet)
Seat 3: Picco1952 folded before Flop (didn't bet)
Seat 4: Chrysk2 (button) folded before Flop (didn't bet)
Seat 5: jazou10 (small blind) folded before Flop
Seat 6: cruxua (big blind) folded on the Flop



PokerStars Hand #222950202313:  Hold'em No Limit ($0.05/$0.10 USD) - 2021/01/23 5:57:22 ET
Table 'Capricorn II' 6-max Seat #5 is the button
Seat 1: Muhlen9 ($14.18 in chips) 
Seat 2: 3EBC96 ($10.45 in chips) 
Seat 3: Picco1952 ($10.11 in chips) 
Seat 4: Chrysk2 ($11.72 in chips) 
Seat 5: jazou10 ($9.04 in chips) 
Seat 6: cruxua ($10.38 in chips) 
cruxua: posts small blind $0.05
Muhlen9: posts big blind $0.10
*** HOLE CARDS ***
3EBC96: folds 
Picco1952: folds 
Chrysk2: folds 
jazou10: folds 
cruxua: raises $0.20 to $0.30
Muhlen9: calls $0.20
*** FLOP *** [Ac 3d 2d]
cruxua: bets $0.38
Muhlen9: calls $0.38
*** TURN *** [Ac 3d 2d] [Jh]
cruxua: checks 
Muhlen9: bets $0.65
cruxua: calls $0.65
*** RIVER *** [Ac 3d 2d Jh] [Js]
cruxua: checks 
Muhlen9: checks 
*** SHOW DOWN ***
cruxua: shows [Jd 9d] (three of a kind, Jacks)
Muhlen9: mucks hand 
cruxua collected $2.54 from pot
*** SUMMARY ***
Total pot $2.66 | Rake $0.12 
Board [Ac 3d 2d Jh Js]
Seat 1: Muhlen9 (big blind) mucked
Seat 2: 3EBC96 folded before Flop (didn't bet)
Seat 3: Picco1952 folded before Flop (didn't bet)
Seat 4: Chrysk2 folded before Flop (didn't bet)
Seat 5: jazou10 (button) folded before Flop (didn't bet)
Seat 6: cruxua (small blind) showed [Jd 9d] and won ($2.54) with three of a kind, Jacks



PokerStars Hand #222950218503:  Hold'em No Limit ($0.05/$0.10 USD) - 2021/01/23 5:58:21 ET
Table 'Capricorn II' 6-max Seat #6 is the button
Seat 1: Muhlen9 ($12.85 in chips) 
Seat 3: Picco1952 ($10.11 in chips) 
Seat 4: Chrysk2 ($11.72 in chips) 
Seat 5: jazou10 ($9.04 in chips) 
Seat 6: cruxua ($11.59 in chips) 
Muhlen9: posts small blind $0.05
Picco1952: posts big blind $0.10
*** HOLE CARDS ***
Chrysk2: folds 
jazou10: folds 
cruxua: raises $0.15 to $0.25
Muhlen9: folds 
Picco1952: calls $0.15
*** FLOP *** [Ad 6d 6s]
Picco1952: checks 
cruxua: checks 
*** TURN *** [Ad 6d 6s] [5s]
Picco1952: bets $0.53
cruxua: calls $0.53
*** RIVER *** [Ad 6d 6s 5s] [As]
Picco1952: checks 
cruxua: bets $0.80
Picco1952: calls $0.80
*** SHOW DOWN ***
cruxua: shows [7d Ac] (a full house, Aces full of Sixes)
Picco1952: mucks hand 
cruxua collected $3.07 from pot
*** SUMMARY ***
Total pot $3.21 | Rake $0.14 
Board [Ad 6d 6s 5s As]
Seat 1: Muhlen9 (small blind) folded before Flop
Seat 3: Picco1952 (big blind) mucked
Seat 4: Chrysk2 folded before Flop (didn't bet)
Seat 5: jazou10 folded before Flop (didn't bet)
Seat 6: cruxua (button) showed [7d Ac] and won ($3.07) with a full house, Aces full of Sixes



PokerStars Hand #222950231150:  Hold'em No Limit ($0.05/$0.10 USD) - 2021/01/23 5:59:06 ET
Table 'Capricorn II' 6-max Seat #1 is the button
Seat 1: Muhlen9 ($12.80 in chips) 
Seat 3: Picco1952 ($8.53 in chips) 
Seat 4: Chrysk2 ($11.72 in chips) 
Seat 5: jazou10 ($9.04 in chips) 
Seat 6: cruxua ($13.08 in chips) 
Picco1952: posts small blind $0.05
Chrysk2: posts big blind $0.10
*** HOLE CARDS ***
jazou10: folds 
cruxua: raises $0.20 to $0.30
Muhlen9: folds 
Picco1952: calls $0.25
Chrysk2: folds 
*** FLOP *** [6h 3c Qd]
Picco1952: checks 
cruxua: bets $0.45
Picco1952: folds 
Uncalled bet ($0.45) returned to cruxua
cruxua collected $0.67 from pot
cruxua: doesn't show hand 
*** SUMMARY ***
Total pot $0.70 | Rake $0.03 
Board [6h 3c Qd]
Seat 1: Muhlen9 (button) folded before Flop (didn't bet)
Seat 3: Picco1952 (small blind) folded on the Flop
Seat 4: Chrysk2 (big blind) folded before Flop
Seat 5: jazou10 folded before Flop (didn't bet)
Seat 6: cruxua collected ($0.67)



PokerStars Hand #222950241555:  Hold'em No Limit ($0.05/$0.10 USD) - 2021/01/23 5:59:44 ET
Table 'Capricorn II' 6-max Seat #3 is the button
Seat 1: Muhlen9 ($12.80 in chips) 
Seat 3: Picco1952 ($8.23 in chips) 
Seat 4: Chrysk2 ($11.62 in chips) 
Seat 5: jazou10 ($9.04 in chips) 
Seat 6: cruxua ($13.45 in chips) 
Chrysk2: posts small blind $0.05
jazou10: posts big blind $0.10
*** HOLE CARDS ***
cruxua: folds 
Muhlen9: folds 
Picco1952: calls $0.10
Chrysk2: folds 
jazou10: checks 
*** FLOP *** [4h 8c Td]
jazou10: checks 
Picco1952: bets $0.24
jazou10: folds 
Uncalled bet ($0.24) returned to Picco1952
Picco1952 collected $0.24 from pot
*** SUMMARY ***
Total pot $0.25 | Rake $0.01 
Board [4h 8c Td]
Seat 1: Muhlen9 folded before Flop (didn't bet)
Seat 3: Picco1952 (button) collected ($0.24)
Seat 4: Chrysk2 (small blind) folded before Flop
Seat 5: jazou10 (big blind) folded on the Flop
Seat 6: cruxua folded before Flop (didn't bet)



PokerStars Hand #222950249786:  Hold'em No Limit ($0.05/$0.10 USD) - 2021/01/23 6:00:13 ET
Table 'Capricorn II' 6-max Seat #4 is the button
Seat 1: Muhlen9 ($12.80 in chips) 
Seat 3: Picco1952 ($8.37 in chips) 
Seat 4: Chrysk2 ($11.57 in chips) 
Seat 5: jazou10 ($8.94 in chips) 
Seat 6: cruxua ($13.45 in chips) 
jazou10: posts small blind $0.05
cruxua: posts big blind $0.10
*** HOLE CARDS ***
Muhlen9: folds 
Picco1952: folds 
Chrysk2: folds 
jazou10: calls $0.05
cruxua: checks 
*** FLOP *** [7h Ad Td]
jazou10: checks 
cruxua: checks 
*** TURN *** [7h Ad Td] [7s]
jazou10: checks 
cruxua: checks 
*** RIVER *** [7h Ad Td 7s] [9h]
jazou10: checks 
cruxua: checks 
*** SHOW DOWN ***
jazou10: shows [5c 2c] (a pair of Sevens)
cruxua: shows [Ts 2s] (two pair, Tens and Sevens)
cruxua collected $0.19 from pot
*** SUMMARY ***
Total pot $0.20 | Rake $0.01 
Board [7h Ad Td 7s 9h]
Seat 1: Muhlen9 folded before Flop (didn't bet)
Seat 3: Picco1952 folded before Flop (didn't bet)
Seat 4: Chrysk2 (button) folded before Flop (didn't bet)
Seat 5: jazou10 (small blind) showed [5c 2c] and lost with a pair of Sevens
Seat 6: cruxua (big blind) showed [Ts 2s] and won ($0.19) with two pair, Tens and Sevens



PokerStars Hand #222950262373:  Hold'em No Limit ($0.05/$0.10 USD) - 2021/01/23 6:00:56 ET
Table 'Capricorn II' 6-max Seat #5 is the button
Seat 1: Muhlen9 ($12.80 in chips) 
Seat 3: Picco1952 ($8.37 in chips) 
Seat 4: Chrysk2 ($11.57 in chips) 
Seat 5: jazou10 ($8.84 in chips) 
Seat 6: cruxua ($13.54 in chips) 
cruxua: posts small blind $0.05
Muhlen9: posts big blind $0.10
*** HOLE CARDS ***
Picco1952: raises $0.10 to $0.20
Chrysk2: folds 
jazou10: calls $0.20
cruxua: folds 
Muhlen9: folds 
*** FLOP *** [As 9d Ks]
Picco1952: checks 
jazou10: checks 
*** TURN *** [As 9d Ks] [5s]
Picco1952: checks 
jazou10: bets $0.27
Picco1952: calls $0.27
*** RIVER *** [As 9d Ks 5s] [Kh]
Picco1952: checks 
jazou10: bets $0.60
Picco1952: calls $0.60
*** SHOW DOWN ***
jazou10: shows [5d 5c] (a full house, Fives full of Kings)
Picco1952: mucks hand 
jazou10 collected $2.19 from pot
*** SUMMARY ***
Total pot $2.29 | Rake $0.10 
Board [As 9d Ks 5s Kh]
Seat 1: Muhlen9 (big blind) folded before Flop
Seat 3: Picco1952 mucked
Seat 4: Chrysk2 folded before Flop (didn't bet)
Seat 5: jazou10 (button) showed [5d 5c] and won ($2.19) with a full house, Fives full of Kings
Seat 6: cruxua (small blind) folded before Flop



PokerStars Hand #222950272891:  Hold'em No Limit ($0.05/$0.10 USD) - 2021/01/23 6:01:29 ET
Table 'Capricorn II' 6-max Seat #6 is the button
Seat 1: Muhlen9 ($12.70 in chips) 
Seat 3: Picco1952 ($7.30 in chips) 
Seat 4: Chrysk2 ($11.57 in chips) 
Seat 5: jazou10 ($9.96 in chips) 
Seat 6: cruxua ($13.49 in chips) 
Muhlen9: posts small blind $0.05
Picco1952: posts big blind $0.10
*** HOLE CARDS ***
Chrysk2: folds 
jazou10: calls $0.10
cruxua: folds 
Muhlen9: folds 
Picco1952: checks 
*** FLOP *** [6d 5c 8s]
Picco1952: checks 
jazou10: checks 
*** TURN *** [6d 5c 8s] [3d]
Picco1952: checks 
jazou10: checks 
*** RIVER *** [6d 5c 8s 3d] [Th]
Picco1952: checks 
jazou10: checks 
*** SHOW DOWN ***
Picco1952: shows [3h 7d] (a pair of Threes)
jazou10: mucks hand 
Picco1952 collected $0.24 from pot
*** SUMMARY ***
Total pot $0.25 | Rake $0.01 
Board [6d 5c 8s 3d Th]
Seat 1: Muhlen9 (small blind) folded before Flop
Seat 3: Picco1952 (big blind) showed [3h 7d] and won ($0.24) with a pair of Threes
Seat 4: Chrysk2 folded before Flop (didn't bet)
Seat 5: jazou10 mucked
Seat 6: cruxua (button) folded before Flop (didn't bet)



PokerStars Hand #222950281990:  Hold'em No Limit ($0.05/$0.10 USD) - 2021/01/23 6:01:57 ET
Table 'Capricorn II' 6-max Seat #1 is the button
Seat 1: Muhlen9 ($12.65 in chips) 
Seat 3: Picco1952 ($7.44 in chips) 
Seat 4: Chrysk2 ($11.57 in chips) 
Seat 5: jazou10 ($9.86 in chips) 
Seat 6: cruxua ($13.49 in chips) 
Picco1952: posts small blind $0.05
Chrysk2: posts big blind $0.10
*** HOLE CARDS ***
jazou10: calls $0.10
cruxua: folds 
Muhlen9: folds 
Picco1952: raises $0.10 to $0.20
Chrysk2: calls $0.10
jazou10: calls $0.10
*** FLOP *** [5h Kh 4h]
Picco1952: bets $0.57
Chrysk2: raises $0.93 to $1.50
jazou10: raises $8.16 to $9.66 and is all-in
Picco1952: folds 
Chrysk2: calls $8.16
*** TURN *** [5h Kh 4h] [3s]
*** RIVER *** [5h Kh 4h 3s] [2d]
*** SHOW DOWN ***
Chrysk2: shows [Th Kc] (a pair of Kings)
jazou10: shows [6h Jh] (a flush, King high)
jazou10 collected $19.57 from pot
*** SUMMARY ***
Total pot $20.49 | Rake $0.92 
Board [5h Kh 4h 3s 2d]
Seat 1: Muhlen9 (button) folded before Flop (didn't bet)
Seat 3: Picco1952 (small blind) folded on the Flop
Seat 4: Chrysk2 (big blind) showed [Th Kc] and lost with a pair of Kings
Seat 5: jazou10 showed [6h Jh] and won ($19.57) with a flush, King high
Seat 6: cruxua folded before Flop (didn't bet)



PokerStars Hand #222950302393:  Hold'em No Limit ($0.05/$0.10 USD) - 2021/01/23 6:03:00 ET
Table 'Capricorn II' 6-max Seat #3 is the button
Seat 1: Muhlen9 ($12.65 in chips) 
Seat 3: Picco1952 ($6.67 in chips) 
Seat 4: Chrysk2 ($4 in chips) 
Seat 5: jazou10 ($19.57 in chips) 
Seat 6: cruxua ($13.49 in chips) 
Chrysk2: posts small blind $0.05
jazou10: posts big blind $0.10
3EBC96: sits out 
*** HOLE CARDS ***
cruxua: raises $0.20 to $0.30
Muhlen9: folds 
Picco1952: calls $0.30
Chrysk2: calls $0.25
jazou10: calls $0.20
*** FLOP *** [Ac 6s Kh]
Chrysk2: checks 
jazou10: checks 
cruxua: checks 
Picco1952: checks 
*** TURN *** [Ac 6s Kh] [Kc]
Chrysk2: checks 
jazou10: checks 
cruxua: checks 
Picco1952: checks 
*** RIVER *** [Ac 6s Kh Kc] [5c]
Chrysk2: checks 
jazou10: checks 
cruxua: checks 
Picco1952: checks 
*** SHOW DOWN ***
Chrysk2: shows [Th 8h] (a pair of Kings)
jazou10: mucks hand 
cruxua: shows [Js Ts] (a pair of Kings - Ace+Jack kicker)
Picco1952: mucks hand 
cruxua collected $1.15 from pot
*** SUMMARY ***
Total pot $1.20 | Rake $0.05 
Board [Ac 6s Kh Kc 5c]
Seat 1: Muhlen9 folded before Flop (didn't bet)
Seat 3: Picco1952 (button) mucked
Seat 4: Chrysk2 (small blind) showed [Th 8h] and lost with a pair of Kings
Seat 5: jazou10 (big blind) mucked
Seat 6: cruxua showed [Js Ts] and won ($1.15) with a pair of Kings



PokerStars Hand #222950319823:  Hold'em No Limit ($0.05/$0.10 USD) - 2021/01/23 6:03:55 ET
Table 'Capricorn II' 6-max Seat #4 is the button
Seat 1: Muhlen9 ($12.65 in chips) 
Seat 3: Picco1952 ($6.37 in chips) 
Seat 4: Chrysk2 ($7.70 in chips) 
Seat 5: jazou10 ($19.27 in chips) 
Seat 6: cruxua ($14.34 in chips) 
jazou10: posts small blind $0.05
cruxua: posts big blind $0.10
3EBC96: sits out 
*** HOLE CARDS ***
Muhlen9: folds 
Picco1952: calls $0.10
Chrysk2 has timed out
Chrysk2: folds 
jazou10: calls $0.05
cruxua: checks 
*** FLOP *** [8h Js Ac]
jazou10: checks 
cruxua: checks 
Picco1952: checks 
*** TURN *** [8h Js Ac] [7d]
jazou10: bets $0.15
cruxua: folds 
Picco1952: calls $0.15
*** RIVER *** [8h Js Ac 7d] [7s]
jazou10: checks 
Picco1952: bets $0.29
jazou10: calls $0.29
*** SHOW DOWN ***
Picco1952: shows [Tc 7c] (three of a kind, Sevens)
jazou10: mucks hand 
Picco1952 collected $1.13 from pot
*** SUMMARY ***
Total pot $1.18 | Rake $0.05 
Board [8h Js Ac 7d 7s]
Seat 1: Muhlen9 folded before Flop (didn't bet)
Seat 3: Picco1952 showed [Tc 7c] and won ($1.13) with three of a kind, Sevens
Seat 4: Chrysk2 (button) folded before Flop (didn't bet)
Seat 5: jazou10 (small blind) mucked
Seat 6: cruxua (big blind) folded on the Turn



PokerStars Hand #222950335262:  Hold'em No Limit ($0.05/$0.10 USD) - 2021/01/23 6:04:43 ET
Table 'Capricorn II' 6-max Seat #5 is the button
Seat 1: Muhlen9 ($12.65 in chips) 
Seat 3: Picco1952 ($6.96 in chips) 
Seat 5: jazou10 ($18.73 in chips) 
Seat 6: cruxua ($14.24 in chips) 
cruxua: posts small blind $0.05
Muhlen9: posts big blind $0.10
3EBC96: sits out 
*** HOLE CARDS ***
Picco1952: calls $0.10
jazou10: folds 
cruxua: calls $0.05
Muhlen9: checks 
*** FLOP *** [9d 7d 3h]
cruxua: checks 
Muhlen9: checks 
Picco1952: checks 
*** TURN *** [9d 7d 3h] [Kc]
cruxua: checks 
Muhlen9: checks 
Picco1952: checks 
*** RIVER *** [9d 7d 3h Kc] [Qh]
cruxua: bets $0.19
Muhlen9: folds 
Picco1952: folds 
Uncalled bet ($0.19) returned to cruxua
cruxua collected $0.29 from pot
cruxua: doesn't show hand 
*** SUMMARY ***
Total pot $0.30 | Rake $0.01 
Board [9d 7d 3h Kc Qh]
Seat 1: Muhlen9 (big blind) folded on the River
Seat 3: Picco1952 folded on the River
Seat 5: jazou10 (button) folded before Flop (didn't bet)
Seat 6: cruxua (small blind) collected ($0.29)



PokerStars Hand #222950345356:  Hold'em No Limit ($0.05/$0.10 USD) - 2021/01/23 6:05:15 ET
Table 'Capricorn II' 6-max Seat #6 is the button
Seat 1: Muhlen9 ($12.55 in chips) 
Seat 2: 3EBC96 ($10.45 in chips) 
Seat 3: Picco1952 ($6.86 in chips) 
Seat 5: jazou10 ($18.73 in chips) 
Seat 6: cruxua ($14.43 in chips) 
Muhlen9: posts small blind $0.05
3EBC96: posts big blind $0.10
*** HOLE CARDS ***
Picco1952: folds 
jazou10: calls $0.10
cruxua: folds 
Muhlen9: folds 
3EBC96: checks 
*** FLOP *** [Kc 9d Qd]
3EBC96: checks 
jazou10: checks 
*** TURN *** [Kc 9d Qd] [3h]
3EBC96: checks 
jazou10: checks 
*** RIVER *** [Kc 9d Qd 3h] [4s]
3EBC96: checks 
jazou10: checks 
*** SHOW DOWN ***
3EBC96: shows [9c Js] (a pair of Nines)
jazou10: mucks hand 
3EBC96 collected $0.24 from pot
*** SUMMARY ***
Total pot $0.25 | Rake $0.01 
Board [Kc 9d Qd 3h 4s]
Seat 1: Muhlen9 (small blind) folded before Flop
Seat 2: 3EBC96 (big blind) showed [9c Js] and won ($0.24) with a pair of Nines
Seat 3: Picco1952 folded before Flop (didn't bet)
Seat 5: jazou10 mucked
Seat 6: cruxua (button) folded before Flop (didn't bet)



PokerStars Hand #222950355033:  Hold'em No Limit ($0.05/$0.10 USD) - 2021/01/23 6:05:45 ET
Table 'Capricorn II' 6-max Seat #1 is the button
Seat 1: Muhlen9 ($12.50 in chips) 
Seat 2: 3EBC96 ($10.59 in chips) 
Seat 3: Picco1952 ($6.86 in chips) 
Seat 5: jazou10 ($18.63 in chips) 
Seat 6: cruxua ($14.43 in chips) 
3EBC96: posts small blind $0.05
Picco1952: posts big blind $0.10
*** HOLE CARDS ***
jazou10: calls $0.10
cruxua: folds 
Muhlen9: folds 
3EBC96: folds 
Picco1952: checks 
*** FLOP *** [6h 2s 9c]
Picco1952: checks 
jazou10: checks 
*** TURN *** [6h 2s 9c] [3h]
Picco1952: checks 
jazou10: checks 
*** RIVER *** [6h 2s 9c 3h] [Kd]
Picco1952: checks 
jazou10: checks 
*** SHOW DOWN ***
Picco1952: shows [2d 5c] (a pair of Deuces)
jazou10: mucks hand 
Picco1952 collected $0.24 from pot
*** SUMMARY ***
Total pot $0.25 | Rake $0.01 
Board [6h 2s 9c 3h Kd]
Seat 1: Muhlen9 (button) folded before Flop (didn't bet)
Seat 2: 3EBC96 (small blind) folded before Flop
Seat 3: Picco1952 (big blind) showed [2d 5c] and won ($0.24) with a pair of Deuces
Seat 5: jazou10 mucked
Seat 6: cruxua folded before Flop (didn't bet)



PokerStars Hand #222950364987:  Hold'em No Limit ($0.05/$0.10 USD) - 2021/01/23 6:06:15 ET
Table 'Capricorn II' 6-max Seat #2 is the button
Seat 1: Muhlen9 ($12.50 in chips) 
Seat 2: 3EBC96 ($10.54 in chips) 
Seat 3: Picco1952 ($7 in chips) 
Seat 5: jazou10 ($18.53 in chips) 
Seat 6: cruxua ($14.43 in chips) 
Picco1952: posts small blind $0.05
jazou10: posts big blind $0.10
*** HOLE CARDS ***
cruxua: folds 
Muhlen9: folds 
3EBC96: folds 
Picco1952: calls $0.05
jazou10: checks 
*** FLOP *** [Jc Qh 6h]
Picco1952: bets $0.19
jazou10: calls $0.19
*** TURN *** [Jc Qh 6h] [Ah]
Picco1952: checks 
jazou10: checks 
*** RIVER *** [Jc Qh 6h Ah] [Kd]
Picco1952: checks 
jazou10: checks 
*** SHOW DOWN ***
Picco1952: shows [Qc 9c] (a pair of Queens)
jazou10: shows [Qs 8d] (a pair of Queens)
Picco1952 collected $0.28 from pot
jazou10 collected $0.27 from pot
*** SUMMARY ***
Total pot $0.58 | Rake $0.03 
Board [Jc Qh 6h Ah Kd]
Seat 1: Muhlen9 folded before Flop (didn't bet)
Seat 2: 3EBC96 (button) folded before Flop (didn't bet)
Seat 3: Picco1952 (small blind) showed [Qc 9c] and won ($0.28) with a pair of Queens
Seat 5: jazou10 (big blind) showed [Qs 8d] and won ($0.27) with a pair of Queens
Seat 6: cruxua folded before Flop (didn't bet)



PokerStars Hand #222950371171:  Hold'em No Limit ($0.05/$0.10 USD) - 2021/01/23 6:06:34 ET
Table 'Capricorn II' 6-max Seat #3 is the button
Seat 1: Muhlen9 ($12.50 in chips) 
Seat 2: 3EBC96 ($10.54 in chips) 
Seat 3: Picco1952 ($6.99 in chips) 
Seat 5: jazou10 ($18.51 in chips) 
Seat 6: cruxua ($14.43 in chips) 
jazou10: posts small blind $0.05
cruxua: posts big blind $0.10
*** HOLE CARDS ***
Muhlen9: raises $0.15 to $0.25
3EBC96: folds 
Picco1952: folds 
jazou10: folds 
cruxua: folds 
Uncalled bet ($0.15) returned to Muhlen9
Muhlen9 collected $0.25 from pot
Muhlen9: doesn't show hand 
*** SUMMARY ***
Total pot $0.25 | Rake $0 
Seat 1: Muhlen9 collected ($0.25)
Seat 2: 3EBC96 folded before Flop (didn't bet)
Seat 3: Picco1952 (button) folded before Flop (didn't bet)
Seat 5: jazou10 (small blind) folded before Flop
Seat 6: cruxua (big blind) folded before Flop



PokerStars Hand #222950375261:  Hold'em No Limit ($0.05/$0.10 USD) - 2021/01/23 6:06:47 ET
Table 'Capricorn II' 6-max Seat #5 is the button
Seat 1: Muhlen9 ($12.65 in chips) 
Seat 2: 3EBC96 ($10.54 in chips) 
Seat 3: Picco1952 ($6.99 in chips) 
Seat 4: Chrysk2 ($10 in chips) 
Seat 5: jazou10 ($18.46 in chips) 
Seat 6: cruxua ($14.33 in chips) 
cruxua: posts small blind $0.05
Muhlen9: posts big blind $0.10
Chrysk2: posts small & big blinds $0.15
*** HOLE CARDS ***
3EBC96: folds 
Picco1952: calls $0.10
Chrysk2: checks 
jazou10: folds 
cruxua: calls $0.05
Muhlen9: checks 
*** FLOP *** [Kh Qd 9d]
cruxua: checks 
Muhlen9: checks 
Picco1952: checks 
Chrysk2: checks 
*** TURN *** [Kh Qd 9d] [9h]
cruxua: checks 
Muhlen9: checks 
Picco1952: checks 
Chrysk2: checks 
*** RIVER *** [Kh Qd 9d 9h] [Ah]
cruxua: checks 
Muhlen9: checks 
Picco1952: checks 
Chrysk2: bets $0.30
cruxua: folds 
Muhlen9: folds 
Picco1952: folds 
Uncalled bet ($0.30) returned to Chrysk2
Chrysk2 collected $0.43 from pot
Chrysk2: doesn't show hand 
*** SUMMARY ***
Total pot $0.45 | Rake $0.02 
Board [Kh Qd 9d 9h Ah]
Seat 1: Muhlen9 (big blind) folded on the River
Seat 2: 3EBC96 folded before Flop (didn't bet)
Seat 3: Picco1952 folded on the River
Seat 4: Chrysk2 collected ($0.43)
Seat 5: jazou10 (button) folded before Flop (didn't bet)
Seat 6: cruxua (small blind) folded on the River



PokerStars Hand #222950392451:  Hold'em No Limit ($0.05/$0.10 USD) - 2021/01/23 6:07:40 ET
Table 'Capricorn II' 6-max Seat #6 is the button
Seat 1: Muhlen9 ($12.55 in chips) 
Seat 2: 3EBC96 ($10.54 in chips) 
Seat 3: Picco1952 ($6.89 in chips) 
Seat 4: Chrysk2 ($10.28 in chips) 
Seat 5: jazou10 ($18.46 in chips) 
Seat 6: cruxua ($14.23 in chips) 
Muhlen9: posts small blind $0.05
3EBC96: posts big blind $0.10
*** HOLE CARDS ***
Picco1952: calls $0.10
Chrysk2: folds 
jazou10: folds 
cruxua: folds 
Muhlen9: folds 
3EBC96: checks 
*** FLOP *** [Qc Ts Jd]
3EBC96: checks 
Picco1952: checks 
*** TURN *** [Qc Ts Jd] [Kd]
3EBC96: checks 
Picco1952: checks 
*** RIVER *** [Qc Ts Jd Kd] [Js]
3EBC96: checks 
Picco1952: checks 
*** SHOW DOWN ***
3EBC96: shows [5d Qh] (two pair, Queens and Jacks)
Picco1952: mucks hand 
3EBC96 collected $0.24 from pot
*** SUMMARY ***
Total pot $0.25 | Rake $0.01 
Board [Qc Ts Jd Kd Js]
Seat 1: Muhlen9 (small blind) folded before Flop
Seat 2: 3EBC96 (big blind) showed [5d Qh] and won ($0.24) with two pair, Queens and Jacks
Seat 3: Picco1952 mucked
Seat 4: Chrysk2 folded before Flop (didn't bet)
Seat 5: jazou10 folded before Flop (didn't bet)
Seat 6: cruxua (button) folded before Flop (didn't bet)



PokerStars Hand #222950401051:  Hold'em No Limit ($0.05/$0.10 USD) - 2021/01/23 6:08:06 ET
Table 'Capricorn II' 6-max Seat #1 is the button
Seat 1: Muhlen9 ($12.50 in chips) 
Seat 2: 3EBC96 ($10.68 in chips) 
Seat 3: Picco1952 ($6.79 in chips) 
Seat 4: Chrysk2 ($10.28 in chips) 
Seat 5: jazou10 ($18.46 in chips) 
Seat 6: cruxua ($14.23 in chips) 
3EBC96: posts small blind $0.05
Picco1952: posts big blind $0.10
*** HOLE CARDS ***
Chrysk2: folds 
jazou10: folds 
cruxua: folds 
Muhlen9: raises $0.15 to $0.25
3EBC96: folds 
Picco1952: calls $0.15
*** FLOP *** [9c 2c 5h]
Picco1952: checks 
Muhlen9: checks 
*** TURN *** [9c 2c 5h] [8s]
Picco1952: bets $0.10
Muhlen9: folds 
Uncalled bet ($0.10) returned to Picco1952
Picco1952 collected $0.53 from pot
*** SUMMARY ***
Total pot $0.55 | Rake $0.02 
Board [9c 2c 5h 8s]
Seat 1: Muhlen9 (button) folded on the Turn
Seat 2: 3EBC96 (small blind) folded before Flop
Seat 3: Picco1952 (big blind) collected ($0.53)
Seat 4: Chrysk2 folded before Flop (didn't bet)
Seat 5: jazou10 folded before Flop (didn't bet)
Seat 6: cruxua folded before Flop (didn't bet)



PokerStars Hand #222950408470:  Hold'em No Limit ($0.05/$0.10 USD) - 2021/01/23 6:08:29 ET
Table 'Capricorn II' 6-max Seat #2 is the button
Seat 1: Muhlen9 ($12.25 in chips) 
Seat 2: 3EBC96 ($10.63 in chips) 
Seat 3: Picco1952 ($7.07 in chips) 
Seat 4: Chrysk2 ($10.28 in chips) 
Seat 5: jazou10 ($18.46 in chips) 
Seat 6: cruxua ($14.23 in chips) 
Picco1952: posts small blind $0.05
Chrysk2: posts big blind $0.10
*** HOLE CARDS ***
jazou10: folds 
cruxua: folds 
Muhlen9: folds 
3EBC96: folds 
Picco1952: folds 
Uncalled bet ($0.05) returned to Chrysk2
Chrysk2 collected $0.10 from pot
Chrysk2: doesn't show hand 
*** SUMMARY ***
Total pot $0.10 | Rake $0 
Seat 1: Muhlen9 folded before Flop (didn't bet)
Seat 2: 3EBC96 (button) folded before Flop (didn't bet)
Seat 3: Picco1952 (small blind) folded before Flop
Seat 4: Chrysk2 (big blind) collected ($0.10)
Seat 5: jazou10 folded before Flop (didn't bet)
Seat 6: cruxua folded before Flop (didn't bet)



PokerStars Hand #222950410965:  Hold'em No Limit ($0.05/$0.10 USD) - 2021/01/23 6:08:37 ET
Table 'Capricorn II' 6-max Seat #3 is the button
Seat 1: Muhlen9 ($12.25 in chips) 
Seat 2: 3EBC96 ($10.63 in chips) 
Seat 3: Picco1952 ($7.02 in chips) 
Seat 4: Chrysk2 ($10.33 in chips) 
Seat 5: jazou10 ($18.46 in chips) 
Seat 6: cruxua ($14.23 in chips) 
Chrysk2: posts small blind $0.05
jazou10: posts big blind $0.10
*** HOLE CARDS ***
cruxua: folds 
Muhlen9: folds 
3EBC96: folds 
Picco1952: calls $0.10
Chrysk2: calls $0.05
jazou10: checks 
*** FLOP *** [Ah 3s Qh]
Chrysk2: checks 
jazou10: checks 
Picco1952: checks 
*** TURN *** [Ah 3s Qh] [3d]
Chrysk2: checks 
jazou10: checks 
Picco1952: checks 
*** RIVER *** [Ah 3s Qh 3d] [8s]
Chrysk2: checks 
jazou10: checks 
Picco1952: checks 
*** SHOW DOWN ***
Chrysk2: shows [7h 9c] (a pair of Threes)
jazou10: shows [Tc 2d] (a pair of Threes - Ace+Queen+Ten kicker)
Picco1952: shows [Jd 8c] (two pair, Eights and Threes)
Picco1952 collected $0.29 from pot
*** SUMMARY ***
Total pot $0.30 | Rake $0.01 
Board [Ah 3s Qh 3d 8s]
Seat 1: Muhlen9 folded before Flop (didn't bet)
Seat 2: 3EBC96 folded before Flop (didn't bet)
Seat 3: Picco1952 (button) showed [Jd 8c] and won ($0.29) with two pair, Eights and Threes
Seat 4: Chrysk2 (small blind) showed [7h 9c] and lost with a pair of Threes
Seat 5: jazou10 (big blind) showed [Tc 2d] and lost with a pair of Threes
Seat 6: cruxua folded before Flop (didn't bet)



PokerStars Hand #222950429746:  Hold'em No Limit ($0.05/$0.10 USD) - 2021/01/23 6:09:34 ET
Table 'Capricorn II' 6-max Seat #4 is the button
Seat 1: Muhlen9 ($12.25 in chips) 
Seat 2: 3EBC96 ($10.63 in chips) 
Seat 3: Picco1952 ($7.21 in chips) 
Seat 4: Chrysk2 ($10.23 in chips) 
Seat 5: jazou10 ($18.36 in chips) 
Seat 6: cruxua ($14.23 in chips) 
jazou10: posts small blind $0.05
cruxua: posts big blind $0.10
*** HOLE CARDS ***
Muhlen9: folds 
3EBC96: folds 
Picco1952: calls $0.10
Chrysk2: raises $0.40 to $0.50
jazou10: folds 
cruxua: folds 
Picco1952: folds 
Uncalled bet ($0.40) returned to Chrysk2
Chrysk2 collected $0.35 from pot
Chrysk2: doesn't show hand 
*** SUMMARY ***
Total pot $0.35 | Rake $0 
Seat 1: Muhlen9 folded before Flop (didn't bet)
Seat 2: 3EBC96 folded before Flop (didn't bet)
Seat 3: Picco1952 folded before Flop
Seat 4: Chrysk2 (button) collected ($0.35)
Seat 5: jazou10 (small blind) folded before Flop
Seat 6: cruxua (big blind) folded before Flop



PokerStars Hand #222950433903:  Hold'em No Limit ($0.05/$0.10 USD) - 2021/01/23 6:09:47 ET
Table 'Capricorn II' 6-max Seat #5 is the button
Seat 1: Muhlen9 ($12.25 in chips) 
Seat 2: 3EBC96 ($10.63 in chips) 
Seat 3: Picco1952 ($7.11 in chips) 
Seat 4: Chrysk2 ($10.48 in chips) 
Seat 5: jazou10 ($18.31 in chips) 
Seat 6: cruxua ($14.13 in chips) 
cruxua: posts small blind $0.05
Muhlen9: posts big blind $0.10
*** HOLE CARDS ***
3EBC96: folds 
Picco1952: raises $0.10 to $0.20
Chrysk2: folds 
jazou10: folds 
cruxua: folds 
Muhlen9: folds 
Uncalled bet ($0.10) returned to Picco1952
Picco1952 collected $0.25 from pot
*** SUMMARY ***
Total pot $0.25 | Rake $0 
Seat 1: Muhlen9 (big blind) folded before Flop
Seat 2: 3EBC96 folded before Flop (didn't bet)
Seat 3: Picco1952 collected ($0.25)
Seat 4: Chrysk2 folded before Flop (didn't bet)
Seat 5: jazou10 (button) folded before Flop (didn't bet)
Seat 6: cruxua (small blind) folded before Flop



PokerStars Hand #222950440146:  Hold'em No Limit ($0.05/$0.10 USD) - 2021/01/23 6:10:06 ET
Table 'Capricorn II' 6-max Seat #6 is the button
Seat 1: Muhlen9 ($12.15 in chips) 
Seat 2: 3EBC96 ($10.63 in chips) 
Seat 3: Picco1952 ($7.26 in chips) 
Seat 4: Chrysk2 ($10.48 in chips) 
Seat 5: jazou10 ($18.31 in chips) 
Seat 6: cruxua ($14.08 in chips) 
Muhlen9: posts small blind $0.05
3EBC96: posts big blind $0.10
*** HOLE CARDS ***
Picco1952: folds 
Chrysk2: folds 
jazou10: folds 
cruxua: raises $0.15 to $0.25
Muhlen9: folds 
Picco1952 leaves the table
3EBC96: calls $0.15
*** FLOP *** [7s 8c 5d]
3EBC96: checks 
cruxua: checks 
*** TURN *** [7s 8c 5d] [Jh]
negritos81 joins the table at seat #3 
3EBC96: checks 
cruxua: checks 
*** RIVER *** [7s 8c 5d Jh] [As]
3EBC96: checks 
cruxua: checks 
*** SHOW DOWN ***
3EBC96: shows [Ts Qd] (high card Ace)
cruxua: shows [2s Ad] (a pair of Aces)
cruxua collected $0.53 from pot
*** SUMMARY ***
Total pot $0.55 | Rake $0.02 
Board [7s 8c 5d Jh As]
Seat 1: Muhlen9 (small blind) folded before Flop
Seat 2: 3EBC96 (big blind) showed [Ts Qd] and lost with high card Ace
Seat 3: Picco1952 folded before Flop (didn't bet)
Seat 4: Chrysk2 folded before Flop (didn't bet)
Seat 5: jazou10 folded before Flop (didn't bet)
Seat 6: cruxua (button) showed [2s Ad] and won ($0.53) with a pair of Aces



PokerStars Hand #222950449346:  Hold'em No Limit ($0.05/$0.10 USD) - 2021/01/23 6:10:34 ET
Table 'Capricorn II' 6-max Seat #1 is the button
Seat 1: Muhlen9 ($12.10 in chips) 
Seat 2: 3EBC96 ($10.38 in chips) 
Seat 3: negritos81 ($10 in chips) 
Seat 4: Chrysk2 ($10.48 in chips) 
Seat 5: jazou10 ($18.31 in chips) 
Seat 6: cruxua ($14.36 in chips) 
3EBC96: posts small blind $0.05
negritos81: posts big blind $0.10
*** HOLE CARDS ***
Chrysk2: folds 
jazou10: calls $0.10
cruxua: folds 
Muhlen9: folds 
3EBC96: folds 
negritos81: checks 
*** FLOP *** [Ks 2h 7s]
negritos81: checks 
jazou10: bets $0.10
negritos81: calls $0.10
*** TURN *** [Ks 2h 7s] [4c]
negritos81: checks 
jazou10: bets $0.22
negritos81: folds 
Uncalled bet ($0.22) returned to jazou10
jazou10 collected $0.43 from pot
jazou10: doesn't show hand 
*** SUMMARY ***
Total pot $0.45 | Rake $0.02 
Board [Ks 2h 7s 4c]
Seat 1: Muhlen9 (button) folded before Flop (didn't bet)
Seat 2: 3EBC96 (small blind) folded before Flop
Seat 3: negritos81 (big blind) folded on the Turn
Seat 4: Chrysk2 folded before Flop (didn't bet)
Seat 5: jazou10 collected ($0.43)
Seat 6: cruxua folded before Flop (didn't bet)



PokerStars Hand #222950464991:  Hold'em No Limit ($0.05/$0.10 USD) - 2021/01/23 6:11:22 ET
Table 'Capricorn II' 6-max Seat #2 is the button
Seat 1: Muhlen9 ($12.10 in chips) 
Seat 2: 3EBC96 ($10.33 in chips) 
Seat 3: negritos81 ($10 in chips) 
Seat 4: Chrysk2 ($10.48 in chips) 
Seat 5: jazou10 ($18.54 in chips) 
Seat 6: cruxua ($14.36 in chips) 
negritos81: posts small blind $0.05
Chrysk2: posts big blind $0.10
*** HOLE CARDS ***
jazou10: folds 
cruxua: folds 
Muhlen9: raises $0.15 to $0.25
3EBC96: folds 
negritos81: folds 
Chrysk2: folds 
Uncalled bet ($0.15) returned to Muhlen9
Muhlen9 collected $0.25 from pot
Muhlen9: doesn't show hand 
*** SUMMARY ***
Total pot $0.25 | Rake $0 
Seat 1: Muhlen9 collected ($0.25)
Seat 2: 3EBC96 (button) folded before Flop (didn't bet)
Seat 3: negritos81 (small blind) folded before Flop
Seat 4: Chrysk2 (big blind) folded before Flop
Seat 5: jazou10 folded before Flop (didn't bet)
Seat 6: cruxua folded before Flop (didn't bet)



PokerStars Hand #222950470646:  Hold'em No Limit ($0.05/$0.10 USD) - 2021/01/23 6:11:40 ET
Table 'Capricorn II' 6-max Seat #3 is the button
Seat 1: Muhlen9 ($12.25 in chips) 
Seat 2: 3EBC96 ($10.33 in chips) 
Seat 3: negritos81 ($10 in chips) 
Seat 4: Chrysk2 ($10.38 in chips) 
Seat 5: jazou10 ($18.54 in chips) 
Seat 6: cruxua ($14.36 in chips) 
Chrysk2: posts small blind $0.05
jazou10: posts big blind $0.10
*** HOLE CARDS ***
cruxua: folds 
Muhlen9: folds 
3EBC96: raises $0.20 to $0.30
negritos81: raises $0.80 to $1.10
Chrysk2: folds 
jazou10: calls $1
3EBC96: folds 
*** FLOP *** [8h Jh 6c]
jazou10: checks 
negritos81: bets $0.81
jazou10: folds 
Uncalled bet ($0.81) returned to negritos81
negritos81 collected $2.44 from pot
negritos81: doesn't show hand 
*** SUMMARY ***
Total pot $2.55 | Rake $0.11 
Board [8h Jh 6c]
Seat 1: Muhlen9 folded before Flop (didn't bet)
Seat 2: 3EBC96 folded before Flop
Seat 3: negritos81 (button) collected ($2.44)
Seat 4: Chrysk2 (small blind) folded before Flop
Seat 5: jazou10 (big blind) folded on the Flop
Seat 6: cruxua folded before Flop (didn't bet)



PokerStars Hand #222950481092:  Hold'em No Limit ($0.05/$0.10 USD) - 2021/01/23 6:12:12 ET
Table 'Capricorn II' 6-max Seat #4 is the button
Seat 1: Muhlen9 ($12.25 in chips) 
Seat 2: 3EBC96 ($10.03 in chips) 
Seat 3: negritos81 ($11.34 in chips) 
Seat 4: Chrysk2 ($10.33 in chips) 
Seat 5: jazou10 ($17.44 in chips) 
Seat 6: cruxua ($14.36 in chips) 
jazou10: posts small blind $0.05
cruxua: posts big blind $0.10
*** HOLE CARDS ***
Muhlen9: folds 
3EBC96: raises $0.20 to $0.30
negritos81: folds 
Chrysk2: folds 
jazou10: folds 
cruxua: folds 
Uncalled bet ($0.20) returned to 3EBC96
3EBC96 collected $0.25 from pot
3EBC96: doesn't show hand 
*** SUMMARY ***
Total pot $0.25 | Rake $0 
Seat 1: Muhlen9 folded before Flop (didn't bet)
Seat 2: 3EBC96 collected ($0.25)
Seat 3: negritos81 folded before Flop (didn't bet)
Seat 4: Chrysk2 (button) folded before Flop (didn't bet)
Seat 5: jazou10 (small blind) folded before Flop
Seat 6: cruxua (big blind) folded before Flop



PokerStars Hand #222950488216:  Hold'em No Limit ($0.05/$0.10 USD) - 2021/01/23 6:12:34 ET
Table 'Capricorn II' 6-max Seat #5 is the button
Seat 2: 3EBC96 ($10.18 in chips) 
Seat 3: negritos81 ($11.34 in chips) 
Seat 4: Chrysk2 ($10.33 in chips) 
Seat 5: jazou10 ($17.39 in chips) 
Seat 6: cruxua ($14.26 in chips) 
cruxua: posts small blind $0.05
Muhlen9: is sitting out 
3EBC96: posts big blind $0.10
*** HOLE CARDS ***
Muhlen9 leaves the table
negritos81: folds 
Chrysk2: raises $0.20 to $0.30
jazou10: folds 
cruxua: folds 
3EBC96: calls $0.20
*** FLOP *** [Ac 5h 7h]
3EBC96: checks 
Chrysk2: checks 
*** TURN *** [Ac 5h 7h] [4h]
3EBC96: bets $0.60
Chrysk2: calls $0.60
*** RIVER *** [Ac 5h 7h 4h] [3h]
Mrburns.daoc joins the table at seat #1 
3EBC96: checks 
Chrysk2: checks 
*** SHOW DOWN ***
3EBC96: shows [8s 6s] (a straight, Four to Eight)
Chrysk2: shows [8h Ks] (a flush, Eight high)
Chrysk2 collected $1.77 from pot
*** SUMMARY ***
Total pot $1.85 | Rake $0.08 
Board [Ac 5h 7h 4h 3h]
Seat 2: 3EBC96 (big blind) showed [8s 6s] and lost with a straight, Four to Eight
Seat 3: negritos81 folded before Flop (didn't bet)
Seat 4: Chrysk2 showed [8h Ks] and won ($1.77) with a flush, Eight high
Seat 5: jazou10 (button) folded before Flop (didn't bet)
Seat 6: cruxua (small blind) folded before Flop



PokerStars Hand #222950503697:  Hold'em No Limit ($0.05/$0.10 USD) - 2021/01/23 6:13:22 ET
Table 'Capricorn II' 6-max Seat #6 is the button
Seat 2: 3EBC96 ($10 in chips) 
Seat 3: negritos81 ($11.34 in chips) 
Seat 4: Chrysk2 ($11.20 in chips) 
Seat 5: jazou10 ($17.39 in chips) 
Seat 6: cruxua ($14.21 in chips) 
3EBC96: posts small blind $0.05
negritos81: posts big blind $0.10
*** HOLE CARDS ***
Chrysk2: folds 
jazou10: folds 
cruxua: folds 
3EBC96: folds 
Uncalled bet ($0.05) returned to negritos81
negritos81 collected $0.10 from pot
negritos81: doesn't show hand 
*** SUMMARY ***
Total pot $0.10 | Rake $0 
Seat 2: 3EBC96 (small blind) folded before Flop
Seat 3: negritos81 (big blind) collected ($0.10)
Seat 4: Chrysk2 folded before Flop (didn't bet)
Seat 5: jazou10 folded before Flop (didn't bet)
Seat 6: cruxua (button) folded before Flop (didn't bet)



PokerStars Hand #222950506591:  Hold'em No Limit ($0.05/$0.10 USD) - 2021/01/23 6:13:31 ET
Table 'Capricorn II' 6-max Seat #2 is the button
Seat 2: 3EBC96 ($10 in chips) 
Seat 3: negritos81 ($11.39 in chips) 
Seat 4: Chrysk2 ($11.20 in chips) 
Seat 5: jazou10 ($17.39 in chips) 
Seat 6: cruxua ($14.21 in chips) 
negritos81: posts small blind $0.05
Chrysk2: posts big blind $0.10
Mrburns.daoc: sits out 
*** HOLE CARDS ***
jazou10: folds 
cruxua: folds 
3EBC96: folds 
negritos81: folds 
Uncalled bet ($0.05) returned to Chrysk2
Chrysk2 collected $0.10 from pot
Chrysk2: doesn't show hand 
*** SUMMARY ***
Total pot $0.10 | Rake $0 
Seat 2: 3EBC96 (button) folded before Flop (didn't bet)
Seat 3: negritos81 (small blind) folded before Flop
Seat 4: Chrysk2 (big blind) collected ($0.10)
Seat 5: jazou10 folded before Flop (didn't bet)
Seat 6: cruxua folded before Flop (didn't bet)



PokerStars Hand #222950512607:  Hold'em No Limit ($0.05/$0.10 USD) - 2021/01/23 6:13:49 ET
Table 'Capricorn II' 6-max Seat #3 is the button
Seat 2: 3EBC96 ($10 in chips) 
Seat 3: negritos81 ($11.34 in chips) 
Seat 4: Chrysk2 ($11.25 in chips) 
Seat 5: jazou10 ($17.39 in chips) 
Seat 6: cruxua ($14.21 in chips) 
Chrysk2: posts small blind $0.05
jazou10: posts big blind $0.10
Mrburns.daoc: sits out 
*** HOLE CARDS ***
cruxua: folds 
3EBC96: folds 
negritos81: folds 
Chrysk2: folds 
Uncalled bet ($0.05) returned to jazou10
jazou10 collected $0.10 from pot
jazou10: doesn't show hand 
*** SUMMARY ***
Total pot $0.10 | Rake $0 
Seat 2: 3EBC96 folded before Flop (didn't bet)
Seat 3: negritos81 (button) folded before Flop (didn't bet)
Seat 4: Chrysk2 (small blind) folded before Flop
Seat 5: jazou10 (big blind) collected ($0.10)
Seat 6: cruxua folded before Flop (didn't bet)



PokerStars Hand #222950516330:  Hold'em No Limit ($0.05/$0.10 USD) - 2021/01/23 6:14:01 ET
Table 'Capricorn II' 6-max Seat #4 is the button
Seat 2: 3EBC96 ($10 in chips) 
Seat 3: negritos81 ($11.34 in chips) 
Seat 4: Chrysk2 ($11.20 in chips) 
Seat 5: jazou10 ($17.44 in chips) 
Seat 6: cruxua ($14.21 in chips) 
jazou10: posts small blind $0.05
cruxua: posts big blind $0.10
Mrburns.daoc: sits out 
*** HOLE CARDS ***
3EBC96: folds 
negritos81: folds 
Chrysk2: folds 
jazou10: calls $0.05
cruxua: checks 
*** FLOP *** [Qs 7c 9s]
jazou10: checks 
cruxua: checks 
*** TURN *** [Qs 7c 9s] [7s]
jazou10: checks 
cruxua: checks 
*** RIVER *** [Qs 7c 9s 7s] [Ad]
jazou10: checks 
cruxua: checks 
*** SHOW DOWN ***
jazou10: shows [Jc 3c] (a pair of Sevens)
cruxua: mucks hand 
jazou10 collected $0.19 from pot
*** SUMMARY ***
Total pot $0.20 | Rake $0.01 
Board [Qs 7c 9s 7s Ad]
Seat 2: 3EBC96 folded before Flop (didn't bet)
Seat 3: negritos81 folded before Flop (didn't bet)
Seat 4: Chrysk2 (button) folded before Flop (didn't bet)
Seat 5: jazou10 (small blind) showed [Jc 3c] and won ($0.19) with a pair of Sevens
Seat 6: cruxua (big blind) mucked



PokerStars Hand #222950535108:  Hold'em No Limit ($0.05/$0.10 USD) - 2021/01/23 6:14:59 ET
Table 'Capricorn II' 6-max Seat #5 is the button
Seat 1: Mrburns.daoc ($10 in chips) 
Seat 2: 3EBC96 ($10 in chips) 
Seat 3: negritos81 ($11.34 in chips) 
Seat 4: Chrysk2 ($11.20 in chips) 
Seat 5: jazou10 ($17.53 in chips) 
Seat 6: cruxua ($14.11 in chips) 
cruxua: posts small blind $0.05
Mrburns.daoc: posts big blind $0.10
*** HOLE CARDS ***
3EBC96: folds 
negritos81: raises $0.20 to $0.30
Chrysk2: folds 
jazou10: folds 
cruxua: calls $0.25
Mrburns.daoc: folds 
*** FLOP *** [8h Ts Qh]
cruxua: checks 
negritos81: bets $0.22
cruxua: raises $0.68 to $0.90
negritos81: folds 
Uncalled bet ($0.68) returned to cruxua
cruxua collected $1.09 from pot
cruxua: doesn't show hand 
*** SUMMARY ***
Total pot $1.14 | Rake $0.05 
Board [8h Ts Qh]
Seat 1: Mrburns.daoc (big blind) folded before Flop
Seat 2: 3EBC96 folded before Flop (didn't bet)
Seat 3: negritos81 folded on the Flop
Seat 4: Chrysk2 folded before Flop (didn't bet)
Seat 5: jazou10 (button) folded before Flop (didn't bet)
Seat 6: cruxua (small blind) collected ($1.09)



PokerStars Hand #222950552648:  Hold'em No Limit ($0.05/$0.10 USD) - 2021/01/23 6:15:52 ET
Table 'Capricorn II' 6-max Seat #6 is the button
Seat 1: Mrburns.daoc ($10 in chips) 
Seat 2: 3EBC96 ($10 in chips) 
Seat 3: negritos81 ($10.82 in chips) 
Seat 4: Chrysk2 ($11.20 in chips) 
Seat 5: jazou10 ($17.53 in chips) 
Seat 6: cruxua ($14.68 in chips) 
Mrburns.daoc: posts small blind $0.05
3EBC96: posts big blind $0.10
*** HOLE CARDS ***
negritos81: folds 
Chrysk2: folds 
Chrysk2 leaves the table
jazou10: calls $0.10
cruxua: folds 
Mrburns.daoc: folds 
Sheva26Rus joins the table at seat #4 
3EBC96: checks 
*** FLOP *** [6d 7c Jd]
3EBC96: checks 
jazou10: bets $0.10
3EBC96: calls $0.10
*** TURN *** [6d 7c Jd] [Jh]
3EBC96: checks 
jazou10: checks 
*** RIVER *** [6d 7c Jd Jh] [9d]
3EBC96: checks 
jazou10: bets $0.20
3EBC96: calls $0.20
*** SHOW DOWN ***
jazou10: shows [2d 5d] (a flush, Jack high)
3EBC96: mucks hand 
jazou10 collected $0.81 from pot
*** SUMMARY ***
Total pot $0.85 | Rake $0.04 
Board [6d 7c Jd Jh 9d]
Seat 1: Mrburns.daoc (small blind) folded before Flop
Seat 2: 3EBC96 (big blind) mucked
Seat 3: negritos81 folded before Flop (didn't bet)
Seat 4: Chrysk2 folded before Flop (didn't bet)
Seat 5: jazou10 showed [2d 5d] and won ($0.81) with a flush, Jack high
Seat 6: cruxua (button) folded before Flop (didn't bet)



PokerStars Hand #222950570697:  Hold'em No Limit ($0.05/$0.10 USD) - 2021/01/23 6:16:47 ET
Table 'Capricorn II' 6-max Seat #1 is the button
Seat 1: Mrburns.daoc ($10 in chips) 
Seat 2: 3EBC96 ($10 in chips) 
Seat 3: negritos81 ($10.82 in chips) 
Seat 5: jazou10 ($17.94 in chips) 
Seat 6: cruxua ($14.68 in chips) 
3EBC96: posts small blind $0.05
negritos81: posts big blind $0.10
Sheva26Rus: sits out 
*** HOLE CARDS ***
jazou10: raises $0.10 to $0.20
cruxua: raises $0.40 to $0.60
Mrburns.daoc: folds 
3EBC96: folds 
negritos81: folds 
jazou10: calls $0.40
*** FLOP *** [Ac 4s Tc]
jazou10: checks 
cruxua: bets $0.86
jazou10: folds 
Uncalled bet ($0.86) returned to cruxua
cruxua collected $1.29 from pot
cruxua: doesn't show hand 
*** SUMMARY ***
Total pot $1.35 | Rake $0.06 
Board [Ac 4s Tc]
Seat 1: Mrburns.daoc (button) folded before Flop (didn't bet)
Seat 2: 3EBC96 (small blind) folded before Flop
Seat 3: negritos81 (big blind) folded before Flop
Seat 5: jazou10 folded on the Flop
Seat 6: cruxua collected ($1.29)



PokerStars Hand #222950581028:  Hold'em No Limit ($0.05/$0.10 USD) - 2021/01/23 6:17:19 ET
Table 'Capricorn II' 6-max Seat #2 is the button
Seat 1: Mrburns.daoc ($10 in chips) 
Seat 2: 3EBC96 ($10 in chips) 
Seat 3: negritos81 ($10.72 in chips) 
Seat 4: Sheva26Rus ($10 in chips) 
Seat 5: jazou10 ($17.34 in chips) 
Seat 6: cruxua ($15.37 in chips) 
negritos81: posts small blind $0.05
Sheva26Rus: posts big blind $0.10
*** HOLE CARDS ***
jazou10: raises $0.20 to $0.30
cruxua: folds 
Mrburns.daoc: folds 
3EBC96: folds 
negritos81: folds 
Sheva26Rus: folds 
Uncalled bet ($0.20) returned to jazou10
jazou10 collected $0.25 from pot
jazou10: doesn't show hand 
*** SUMMARY ***
Total pot $0.25 | Rake $0 
Seat 1: Mrburns.daoc folded before Flop (didn't bet)
Seat 2: 3EBC96 (button) folded before Flop (didn't bet)
Seat 3: negritos81 (small blind) folded before Flop
Seat 4: Sheva26Rus (big blind) folded before Flop
Seat 5: jazou10 collected ($0.25)
Seat 6: cruxua folded before Flop (didn't bet)



PokerStars Hand #222950587655:  Hold'em No Limit ($0.05/$0.10 USD) - 2021/01/23 6:17:40 ET
Table 'Capricorn II' 6-max Seat #3 is the button
Seat 1: Mrburns.daoc ($10 in chips) 
Seat 2: 3EBC96 ($10 in chips) 
Seat 3: negritos81 ($10.67 in chips) 
Seat 4: Sheva26Rus ($10 in chips) 
Seat 5: jazou10 ($17.49 in chips) 
Seat 6: cruxua ($15.37 in chips) 
Sheva26Rus: posts small blind $0.05
jazou10: posts big blind $0.10
*** HOLE CARDS ***
cruxua: folds 
Mrburns.daoc: folds 
3EBC96: folds 
negritos81: folds 
Sheva26Rus: raises $0.20 to $0.30
jazou10: folds 
Uncalled bet ($0.20) returned to Sheva26Rus
Sheva26Rus collected $0.20 from pot
Sheva26Rus: doesn't show hand 
*** SUMMARY ***
Total pot $0.20 | Rake $0 
Seat 1: Mrburns.daoc folded before Flop (didn't bet)
Seat 2: 3EBC96 folded before Flop (didn't bet)
Seat 3: negritos81 (button) folded before Flop (didn't bet)
Seat 4: Sheva26Rus (small blind) collected ($0.20)
Seat 5: jazou10 (big blind) folded before Flop
Seat 6: cruxua folded before Flop (didn't bet)



PokerStars Hand #222950592826:  Hold'em No Limit ($0.05/$0.10 USD) - 2021/01/23 6:17:55 ET
Table 'Capricorn II' 6-max Seat #4 is the button
Seat 1: Mrburns.daoc ($10 in chips) 
Seat 2: 3EBC96 ($10 in chips) 
Seat 3: negritos81 ($10.67 in chips) 
Seat 4: Sheva26Rus ($10.10 in chips) 
Seat 5: jazou10 ($17.39 in chips) 
Seat 6: cruxua ($15.37 in chips) 
jazou10: posts small blind $0.05
cruxua: posts big blind $0.10
*** HOLE CARDS ***
Mrburns.daoc: folds 
3EBC96: folds 
negritos81 has timed out
negritos81: folds 
Sheva26Rus: folds 
jazou10: calls $0.05
cruxua: checks 
*** FLOP *** [4h 6s 2h]
jazou10: checks 
cruxua: checks 
*** TURN *** [4h 6s 2h] [7h]
jazou10: checks 
cruxua: checks 
*** RIVER *** [4h 6s 2h 7h] [4s]
jazou10: checks 
cruxua: checks 
*** SHOW DOWN ***
jazou10: shows [2c 8c] (two pair, Fours and Deuces)
cruxua: mucks hand 
jazou10 collected $0.19 from pot
*** SUMMARY ***
Total pot $0.20 | Rake $0.01 
Board [4h 6s 2h 7h 4s]
Seat 1: Mrburns.daoc folded before Flop (didn't bet)
Seat 2: 3EBC96 folded before Flop (didn't bet)
Seat 3: negritos81 folded before Flop (didn't bet)
Seat 4: Sheva26Rus (button) folded before Flop (didn't bet)
Seat 5: jazou10 (small blind) showed [2c 8c] and won ($0.19) with two pair, Fours and Deuces
Seat 6: cruxua (big blind) mucked



PokerStars Hand #222950610596:  Hold'em No Limit ($0.05/$0.10 USD) - 2021/01/23 6:18:50 ET
Table 'Capricorn II' 6-max Seat #5 is the button
Seat 1: Mrburns.daoc ($10 in chips) 
Seat 2: 3EBC96 ($10 in chips) 
Seat 3: negritos81 ($10.67 in chips) 
Seat 4: Sheva26Rus ($10.10 in chips) 
Seat 5: jazou10 ($17.48 in chips) 
Seat 6: cruxua ($15.27 in chips) 
cruxua: posts small blind $0.05
Mrburns.daoc: posts big blind $0.10
*** HOLE CARDS ***
3EBC96: raises $0.20 to $0.30
negritos81: folds 
Sheva26Rus: calls $0.30
jazou10: calls $0.30
cruxua: folds 
Mrburns.daoc: calls $0.20
*** FLOP *** [6c 5c 4s]
Mrburns.daoc: checks 
3EBC96: checks 
Sheva26Rus: bets $0.77
jazou10: calls $0.77
Mrburns.daoc: folds 
3EBC96: folds 
*** TURN *** [6c 5c 4s] [Ts]
Sheva26Rus: bets $2.26
jazou10: folds 
Uncalled bet ($2.26) returned to Sheva26Rus
Sheva26Rus collected $2.66 from pot
Sheva26Rus: doesn't show hand 
*** SUMMARY ***
Total pot $2.79 | Rake $0.13 
Board [6c 5c 4s Ts]
Seat 1: Mrburns.daoc (big blind) folded on the Flop
Seat 2: 3EBC96 folded on the Flop
Seat 3: negritos81 folded before Flop (didn't bet)
Seat 4: Sheva26Rus collected ($2.66)
Seat 5: jazou10 (button) folded on the Turn
Seat 6: cruxua (small blind) folded before Flop



PokerStars Hand #222950627978:  Hold'em No Limit ($0.05/$0.10 USD) - 2021/01/23 6:19:43 ET
Table 'Capricorn II' 6-max Seat #6 is the button
Seat 1: Mrburns.daoc ($10 in chips) 
Seat 2: 3EBC96 ($10 in chips) 
Seat 3: negritos81 ($10.67 in chips) 
Seat 4: Sheva26Rus ($11.69 in chips) 
Seat 5: jazou10 ($16.41 in chips) 
Seat 6: cruxua ($15.22 in chips) 
Mrburns.daoc: posts small blind $0.05
3EBC96: posts big blind $0.10
*** HOLE CARDS ***
negritos81: folds 
Sheva26Rus: folds 
jazou10: raises $0.10 to $0.20
cruxua: folds 
Mrburns.daoc: folds 
3EBC96: calls $0.10
*** FLOP *** [Qs Jh Ts]
3EBC96: checks 
jazou10: checks 
*** TURN *** [Qs Jh Ts] [Qc]
3EBC96: checks 
jazou10: checks 
*** RIVER *** [Qs Jh Ts Qc] [Jc]
3EBC96: checks 
jazou10: checks 
*** SHOW DOWN ***
3EBC96: shows [Ah 8c] (two pair, Queens and Jacks)
jazou10: mucks hand 
3EBC96 collected $0.43 from pot
*** SUMMARY ***
Total pot $0.45 | Rake $0.02 
Board [Qs Jh Ts Qc Jc]
Seat 1: Mrburns.daoc (small blind) folded before Flop
Seat 2: 3EBC96 (big blind) showed [Ah 8c] and won ($0.43) with two pair, Queens and Jacks
Seat 3: negritos81 folded before Flop (didn't bet)
Seat 4: Sheva26Rus folded before Flop (didn't bet)
Seat 5: jazou10 mucked
Seat 6: cruxua (button) folded before Flop (didn't bet)



PokerStars Hand #222950639305:  Hold'em No Limit ($0.05/$0.10 USD) - 2021/01/23 6:20:17 ET
Table 'Capricorn II' 6-max Seat #1 is the button
Seat 1: Mrburns.daoc ($10 in chips) 
Seat 2: 3EBC96 ($10.23 in chips) 
Seat 3: negritos81 ($10.67 in chips) 
Seat 4: Sheva26Rus ($11.69 in chips) 
Seat 5: jazou10 ($16.21 in chips) 
Seat 6: cruxua ($15.22 in chips) 
3EBC96: posts small blind $0.05
negritos81: posts big blind $0.10
*** HOLE CARDS ***
Sheva26Rus: folds 
jazou10: raises $0.20 to $0.30
cruxua: calls $0.30
Mrburns.daoc: folds 
3EBC96: folds 
negritos81: folds 
*** FLOP *** [Qh 8c 3c]
jazou10: bets $0.30
cruxua: calls $0.30
*** TURN *** [Qh 8c 3c] [5d]
jazou10: bets $0.40
cruxua: calls $0.40
*** RIVER *** [Qh 8c 3c 5d] [7c]
jazou10: bets $0.50
cruxua: calls $0.50
*** SHOW DOWN ***
jazou10: shows [Js Jd] (a pair of Jacks)
cruxua: shows [Qd Ks] (a pair of Queens)
cruxua collected $3.01 from pot
*** SUMMARY ***
Total pot $3.15 | Rake $0.14 
Board [Qh 8c 3c 5d 7c]
Seat 1: Mrburns.daoc (button) folded before Flop (didn't bet)
Seat 2: 3EBC96 (small blind) folded before Flop
Seat 3: negritos81 (big blind) folded before Flop
Seat 4: Sheva26Rus folded before Flop (didn't bet)
Seat 5: jazou10 showed [Js Jd] and lost with a pair of Jacks
Seat 6: cruxua showed [Qd Ks] and won ($3.01) with a pair of Queens



PokerStars Hand #222950652011:  Hold'em No Limit ($0.05/$0.10 USD) - 2021/01/23 6:20:56 ET
Table 'Capricorn II' 6-max Seat #2 is the button
Seat 1: Mrburns.daoc ($10 in chips) 
Seat 2: 3EBC96 ($10.18 in chips) 
Seat 3: negritos81 ($10.57 in chips) 
Seat 5: jazou10 ($14.71 in chips) 
Seat 6: cruxua ($16.73 in chips) 
negritos81: posts small blind $0.05
Sheva26Rus: is sitting out 
jazou10: posts big blind $0.10
*** HOLE CARDS ***
Sheva26Rus leaves the table
cruxua: folds 
Raffa93PK joins the table at seat #4 
Mrburns.daoc: raises $0.14 to $0.24
3EBC96: folds 
negritos81: folds 
jazou10: folds 
Uncalled bet ($0.14) returned to Mrburns.daoc
jazou10 leaves the table
Mrburns.daoc collected $0.25 from pot
Mrburns.daoc: doesn't show hand 
*** SUMMARY ***
Total pot $0.25 | Rake $0 
Seat 1: Mrburns.daoc collected ($0.25)
Seat 2: 3EBC96 (button) folded before Flop (didn't bet)
Seat 3: negritos81 (small blind) folded before Flop
Seat 5: jazou10 (big blind) folded before Flop
Seat 6: cruxua folded before Flop (didn't bet)



PokerStars Hand #222950659142:  Hold'em No Limit ($0.05/$0.10 USD) - 2021/01/23 6:21:17 ET
Table 'Capricorn II' 6-max Seat #3 is the button
Seat 1: Mrburns.daoc ($10.15 in chips) 
Seat 2: 3EBC96 ($10.18 in chips) 
Seat 3: negritos81 ($10.52 in chips) 
Seat 6: cruxua ($16.73 in chips) 
cruxua: posts small blind $0.05
Mrburns.daoc: posts big blind $0.10
*** HOLE CARDS ***
3EBC96: raises $0.20 to $0.30
negritos81: folds 
cruxua: calls $0.25
Mrburns.daoc: folds 
*** FLOP *** [8s 4c Td]
LALLYITA joins the table at seat #5 
cruxua: checks 
3EBC96: checks 
*** TURN *** [8s 4c Td] [6s]
cruxua: bets $0.50
3EBC96: folds 
Uncalled bet ($0.50) returned to cruxua
cruxua collected $0.67 from pot
cruxua: doesn't show hand 
*** SUMMARY ***
Total pot $0.70 | Rake $0.03 
Board [8s 4c Td 6s]
Seat 1: Mrburns.daoc (big blind) folded before Flop
Seat 2: 3EBC96 folded on the Turn
Seat 3: negritos81 (button) folded before Flop (didn't bet)
Seat 6: cruxua (small blind) collected ($0.67)



PokerStars Hand #222950673096:  Hold'em No Limit ($0.05/$0.10 USD) - 2021/01/23 6:21:59 ET
Table 'Capricorn II' 6-max Seat #6 is the button
Seat 1: Mrburns.daoc ($10.05 in chips) 
Seat 3: negritos81 ($10.52 in chips) 
Seat 4: Raffa93PK ($6 in chips) 
Seat 6: cruxua ($17.10 in chips) 
Mrburns.daoc: posts small blind $0.05
negritos81: posts big blind $0.10
Raffa93PK: posts big blind $0.10
LALLYITA: sits out 
*** HOLE CARDS ***
Raffa93PK: checks 
3EBC96 leaves the table
cruxua: raises $0.30 to $0.40
Mrburns.daoc: folds 
negritos81: folds 
Raffa93PK: calls $0.30
*** FLOP *** [5c Kd 5d]
Raffa93PK: checks 
cruxua: bets $0.61
Raffa93PK: calls $0.61
*** TURN *** [5c Kd 5d] [Kc]
Raffa93PK: checks 
chrisb64 joins the table at seat #2 
cruxua: bets $1.04
Raffa93PK: calls $1.04
*** RIVER *** [5c Kd 5d Kc] [Jh]
Raffa93PK: checks 
cruxua: bets $2.80
Raffa93PK: calls $2.80
*** SHOW DOWN ***
cruxua: shows [Ks 8s] (a full house, Kings full of Fives)
Raffa93PK: mucks hand 
cruxua collected $9.41 from pot
*** SUMMARY ***
Total pot $9.85 | Rake $0.44 
Board [5c Kd 5d Kc Jh]
Seat 1: Mrburns.daoc (small blind) folded before Flop
Seat 3: negritos81 (big blind) folded before Flop
Seat 4: Raffa93PK mucked
Seat 6: cruxua (button) showed [Ks 8s] and won ($9.41) with a full house, Kings full of Fives



PokerStars Hand #222950692526:  Hold'em No Limit ($0.05/$0.10 USD) - 2021/01/23 6:22:58 ET
Table 'Capricorn II' 6-max Seat #1 is the button
Seat 1: Mrburns.daoc ($10 in chips) 
Seat 3: negritos81 ($10.42 in chips) 
Seat 4: Raffa93PK ($1.15 in chips) 
Seat 6: cruxua ($21.66 in chips) 
negritos81: posts small blind $0.05
Raffa93PK: posts big blind $0.10
LALLYITA: sits out 
*** HOLE CARDS ***
cruxua: folds 
Mrburns.daoc: folds 
negritos81: folds 
Uncalled bet ($0.05) returned to Raffa93PK
Raffa93PK collected $0.10 from pot
*** SUMMARY ***
Total pot $0.10 | Rake $0 
Seat 1: Mrburns.daoc (button) folded before Flop (didn't bet)
Seat 3: negritos81 (small blind) folded before Flop
Seat 4: Raffa93PK (big blind) collected ($0.10)
Seat 6: cruxua folded before Flop (didn't bet)



PokerStars Hand #222950696846:  Hold'em No Limit ($0.05/$0.10 USD) - 2021/01/23 6:23:11 ET
Table 'Capricorn II' 6-max Seat #3 is the button
Seat 1: Mrburns.daoc ($10 in chips) 
Seat 3: negritos81 ($10.37 in chips) 
Seat 4: Raffa93PK ($1.20 in chips) 
Seat 5: LALLYITA ($10 in chips) 
Seat 6: cruxua ($21.66 in chips) 
Raffa93PK: posts small blind $0.05
LALLYITA: posts big blind $0.10
chrisb64: sits out 
*** HOLE CARDS ***
cruxua: folds 
Mrburns.daoc: raises $0.14 to $0.24
negritos81: folds 
Raffa93PK: calls $0.19
LALLYITA: folds 
*** FLOP *** [Jd Kd 7s]
Raffa93PK: checks 
Mrburns.daoc: bets $0.18
Raffa93PK: calls $0.18
*** TURN *** [Jd Kd 7s] [3h]
Raffa93PK: checks 
Mrburns.daoc: checks 
*** RIVER *** [Jd Kd 7s 3h] [6c]
Raffa93PK: checks 
Mrburns.daoc: checks 
*** SHOW DOWN ***
Raffa93PK: shows [Td Ad] (high card Ace)
Mrburns.daoc: shows [9s 9d] (a pair of Nines)
Mrburns.daoc collected $0.90 from pot
*** SUMMARY ***
Total pot $0.94 | Rake $0.04 
Board [Jd Kd 7s 3h 6c]
Seat 1: Mrburns.daoc showed [9s 9d] and won ($0.90) with a pair of Nines
Seat 3: negritos81 (button) folded before Flop (didn't bet)
Seat 4: Raffa93PK (small blind) showed [Td Ad] and lost with high card Ace
Seat 5: LALLYITA (big blind) folded before Flop
Seat 6: cruxua folded before Flop (didn't bet)



PokerStars Hand #222950711818:  Hold'em No Limit ($0.05/$0.10 USD) - 2021/01/23 6:23:56 ET
Table 'Capricorn II' 6-max Seat #4 is the button
Seat 1: Mrburns.daoc ($10.48 in chips) 
Seat 3: negritos81 ($10.37 in chips) 
Seat 4: Raffa93PK ($0.78 in chips) 
Seat 5: LALLYITA ($9.90 in chips) 
Seat 6: cruxua ($21.66 in chips) 
LALLYITA: posts small blind $0.05
cruxua: posts big blind $0.10
chrisb64: sits out 
*** HOLE CARDS ***
Mrburns.daoc: folds 
negritos81 has timed out
negritos81: folds 
Raffa93PK: calls $0.10
LALLYITA: raises $0.30 to $0.40
cruxua: folds 
Raffa93PK: raises $0.38 to $0.78 and is all-in
LALLYITA: calls $0.38
*** FLOP *** [4d 3h 6c]
*** TURN *** [4d 3h 6c] [Tc]
*** RIVER *** [4d 3h 6c Tc] [9c]
*** SHOW DOWN ***
LALLYITA: shows [Js Ad] (high card Ace)
Raffa93PK: shows [3c 9h] (two pair, Nines and Threes)
Raffa93PK collected $1.59 from pot
*** SUMMARY ***
Total pot $1.66 | Rake $0.07 
Board [4d 3h 6c Tc 9c]
Seat 1: Mrburns.daoc folded before Flop (didn't bet)
Seat 3: negritos81 folded before Flop (didn't bet)
Seat 4: Raffa93PK (button) showed [3c 9h] and won ($1.59) with two pair, Nines and Threes
Seat 5: LALLYITA (small blind) showed [Js Ad] and lost with high card Ace
Seat 6: cruxua (big blind) folded before Flop



PokerStars Hand #222950728688:  Hold'em No Limit ($0.05/$0.10 USD) - 2021/01/23 6:24:47 ET
Table 'Capricorn II' 6-max Seat #5 is the button
Seat 1: Mrburns.daoc ($10.48 in chips) 
Seat 3: negritos81 ($10.37 in chips) 
Seat 4: Raffa93PK ($4.81 in chips) 
Seat 5: LALLYITA ($9.12 in chips) 
Seat 6: cruxua ($21.56 in chips) 
cruxua: posts small blind $0.05
Mrburns.daoc: posts big blind $0.10
chrisb64: sits out 
*** HOLE CARDS ***
negritos81: folds 
Raffa93PK: calls $0.10
LALLYITA: calls $0.10
cruxua: raises $0.50 to $0.60
Mrburns.daoc: folds 
Raffa93PK: folds 
LALLYITA: folds 
Uncalled bet ($0.50) returned to cruxua
cruxua collected $0.40 from pot
cruxua: doesn't show hand 
*** SUMMARY ***
Total pot $0.40 | Rake $0 
Seat 1: Mrburns.daoc (big blind) folded before Flop
Seat 3: negritos81 folded before Flop (didn't bet)
Seat 4: Raffa93PK folded before Flop
Seat 5: LALLYITA (button) folded before Flop
Seat 6: cruxua (small blind) collected ($0.40)



PokerStars Hand #222950737604:  Hold'em No Limit ($0.05/$0.10 USD) - 2021/01/23 6:25:14 ET
Table 'Capricorn II' 6-max Seat #6 is the button
Seat 1: Mrburns.daoc ($10.38 in chips) 
Seat 2: chrisb64 ($8 in chips) 
Seat 3: negritos81 ($10.37 in chips) 
Seat 4: Raffa93PK ($4.71 in chips) 
Seat 5: LALLYITA ($9.02 in chips) 
Seat 6: cruxua ($21.86 in chips) 
Mrburns.daoc: posts small blind $0.05
chrisb64: posts big blind $0.10
*** HOLE CARDS ***
negritos81: folds 
Raffa93PK: calls $0.10
LALLYITA: calls $0.10
cruxua: folds 
Mrburns.daoc: folds 
chrisb64: checks 
*** FLOP *** [Ts Ks 5s]
chrisb64: checks 
Raffa93PK: checks 
LALLYITA: bets $0.33
chrisb64: folds 
Raffa93PK: folds 
Uncalled bet ($0.33) returned to LALLYITA
LALLYITA collected $0.33 from pot
*** SUMMARY ***
Total pot $0.35 | Rake $0.02 
Board [Ts Ks 5s]
Seat 1: Mrburns.daoc (small blind) folded before Flop
Seat 2: chrisb64 (big blind) folded on the Flop
Seat 3: negritos81 folded before Flop (didn't bet)
Seat 4: Raffa93PK folded on the Flop
Seat 5: LALLYITA collected ($0.33)
Seat 6: cruxua (button) folded before Flop (didn't bet)



PokerStars Hand #222950797265:  Hold'em No Limit ($0.05/$0.10 USD) - 2021/01/23 6:28:13 ET
Table 'Capricorn II' 6-max Seat #5 is the button
Seat 1: Mrburns.daoc ($10 in chips) 
Seat 2: chrisb64 ($7.85 in chips) 
Seat 3: negritos81 ($10.22 in chips) 
Seat 4: Raffa93PK ($4.01 in chips) 
Seat 5: LALLYITA ($9.44 in chips) 
Seat 6: cruxua ($24.03 in chips) 
cruxua: posts small blind $0.05
Mrburns.daoc: posts big blind $0.10
*** HOLE CARDS ***
chrisb64: folds 
negritos81: folds 
Raffa93PK: calls $0.10
LALLYITA: folds 
cruxua: calls $0.05
Mrburns.daoc: checks 
*** FLOP *** [5d 5c 8d]
cruxua: checks 
Mrburns.daoc: checks 
Raffa93PK: checks 
*** TURN *** [5d 5c 8d] [As]
cruxua: checks 
Mrburns.daoc: checks 
Raffa93PK: checks 
*** RIVER *** [5d 5c 8d As] [Qs]
cruxua: checks 
Mrburns.daoc: checks 
Raffa93PK: checks 
*** SHOW DOWN ***
cruxua: shows [Kh 9h] (a pair of Fives)
Mrburns.daoc: mucks hand 
Raffa93PK: mucks hand 
cruxua collected $0.29 from pot
*** SUMMARY ***
Total pot $0.30 | Rake $0.01 
Board [5d 5c 8d As Qs]
Seat 1: Mrburns.daoc (big blind) mucked
Seat 2: chrisb64 folded before Flop (didn't bet)
Seat 3: negritos81 folded before Flop (didn't bet)
Seat 4: Raffa93PK mucked
Seat 5: LALLYITA (button) folded before Flop (didn't bet)
Seat 6: cruxua (small blind) showed [Kh 9h] and won ($0.29) with a pair of Fives



PokerStars Hand #222950812445:  Hold'em No Limit ($0.05/$0.10 USD) - 2021/01/23 6:28:58 ET
Table 'Capricorn II' 6-max Seat #6 is the button
Seat 1: Mrburns.daoc ($10 in chips) 
Seat 2: chrisb64 ($7.85 in chips) 
Seat 3: negritos81 ($10.22 in chips) 
Seat 4: Raffa93PK ($3.91 in chips) 
Seat 5: LALLYITA ($9.44 in chips) 
Seat 6: cruxua ($24.22 in chips) 
Mrburns.daoc: posts small blind $0.05
chrisb64: posts big blind $0.10
*** HOLE CARDS ***
negritos81 has timed out
negritos81: folds 
Raffa93PK: calls $0.10
LALLYITA: calls $0.10
cruxua: raises $0.40 to $0.50
Mrburns.daoc: folds 
chrisb64: folds 
Raffa93PK: folds 
LALLYITA: calls $0.40
*** FLOP *** [7d Ad Ts]
LALLYITA: checks 
cruxua: bets $0.50
LALLYITA: calls $0.50
*** TURN *** [7d Ad Ts] [Td]
LALLYITA: checks 
cruxua: checks 
*** RIVER *** [7d Ad Ts Td] [Ks]
LALLYITA: bets $2.15
cruxua: folds 
Uncalled bet ($2.15) returned to LALLYITA
LALLYITA collected $2.15 from pot
LALLYITA: doesn't show hand 
*** SUMMARY ***
Total pot $2.25 | Rake $0.10 
Board [7d Ad Ts Td Ks]
Seat 1: Mrburns.daoc (small blind) folded before Flop
Seat 2: chrisb64 (big blind) folded before Flop
Seat 3: negritos81 folded before Flop (didn't bet)
Seat 4: Raffa93PK folded before Flop
Seat 5: LALLYITA collected ($2.15)
Seat 6: cruxua (button) folded on the River



PokerStars Hand #222950833657:  Hold'em No Limit ($0.05/$0.10 USD) - 2021/01/23 6:30:02 ET
Table 'Capricorn II' 6-max Seat #1 is the button
Seat 1: Mrburns.daoc ($10 in chips) 
Seat 2: chrisb64 ($7.75 in chips) 
Seat 3: negritos81 ($10.22 in chips) 
Seat 4: Raffa93PK ($3.81 in chips) 
Seat 5: LALLYITA ($10.59 in chips) 
Seat 6: cruxua ($23.22 in chips) 
chrisb64: posts small blind $0.05
negritos81: posts big blind $0.10
*** HOLE CARDS ***
Raffa93PK: calls $0.10
LALLYITA: folds 
cruxua: raises $0.30 to $0.40
Mrburns.daoc: raises $0.90 to $1.30
chrisb64: folds 
negritos81: folds 
Raffa93PK: folds 
cruxua: folds 
Uncalled bet ($0.90) returned to Mrburns.daoc
Mrburns.daoc collected $1.05 from pot
Mrburns.daoc: doesn't show hand 
*** SUMMARY ***
Total pot $1.05 | Rake $0 
Seat 1: Mrburns.daoc (button) collected ($1.05)
Seat 2: chrisb64 (small blind) folded before Flop
Seat 3: negritos81 (big blind) folded before Flop
Seat 4: Raffa93PK folded before Flop
Seat 5: LALLYITA folded before Flop (didn't bet)
Seat 6: cruxua folded before Flop



PokerStars Hand #222950845292:  Hold'em No Limit ($0.05/$0.10 USD) - 2021/01/23 6:30:37 ET
Table 'Capricorn II' 6-max Seat #2 is the button
Seat 1: Mrburns.daoc ($10.65 in chips) 
Seat 2: chrisb64 ($7.70 in chips) 
Seat 3: negritos81 ($10.12 in chips) 
Seat 4: Raffa93PK ($3.71 in chips) 
Seat 5: LALLYITA ($10.59 in chips) 
Seat 6: cruxua ($22.82 in chips) 
negritos81: posts small blind $0.05
Raffa93PK: posts big blind $0.10
*** HOLE CARDS ***
LALLYITA: calls $0.10
cruxua: folds 
Mrburns.daoc: folds 
chrisb64: calls $0.10
negritos81: folds 
Raffa93PK: checks 
*** FLOP *** [Js 2h 4d]
Raffa93PK: checks 
LALLYITA: checks 
chrisb64: bets $0.33
Raffa93PK: folds 
LALLYITA: folds 
Uncalled bet ($0.33) returned to chrisb64
chrisb64 collected $0.33 from pot
chrisb64: doesn't show hand 
*** SUMMARY ***
Total pot $0.35 | Rake $0.02 
Board [Js 2h 4d]
Seat 1: Mrburns.daoc folded before Flop (didn't bet)
Seat 2: chrisb64 (button) collected ($0.33)
Seat 3: negritos81 (small blind) folded before Flop
Seat 4: Raffa93PK (big blind) folded on the Flop
Seat 5: LALLYITA folded on the Flop
Seat 6: cruxua folded before Flop (didn't bet)



PokerStars Hand #222950856997:  Hold'em No Limit ($0.05/$0.10 USD) - 2021/01/23 6:31:12 ET
Table 'Capricorn II' 6-max Seat #3 is the button
Seat 1: Mrburns.daoc ($10.65 in chips) 
Seat 2: chrisb64 ($7.93 in chips) 
Seat 3: negritos81 ($10.07 in chips) 
Seat 4: Raffa93PK ($3.61 in chips) 
Seat 5: LALLYITA ($10.49 in chips) 
Seat 6: cruxua ($22.82 in chips) 
Raffa93PK: posts small blind $0.05
LALLYITA: posts big blind $0.10
*** HOLE CARDS ***
cruxua: folds 
Mrburns.daoc: folds 
chrisb64: folds 
negritos81 has timed out
negritos81: folds 
Raffa93PK: calls $0.05
LALLYITA: checks 
*** FLOP *** [7d 5s 8d]
Raffa93PK: checks 
LALLYITA: bets $0.19
Raffa93PK: calls $0.19
*** TURN *** [7d 5s 8d] [4h]
Raffa93PK: bets $0.20
LALLYITA: raises $10 to $10.20 and is all-in
Raffa93PK: calls $3.12 and is all-in
Uncalled bet ($6.88) returned to LALLYITA
*** RIVER *** [7d 5s 8d 4h] [Jd]
*** SHOW DOWN ***
Raffa93PK: shows [3c 6d] (a straight, Four to Eight)
LALLYITA: shows [6c 9h] (a straight, Five to Nine)
LALLYITA collected $6.90 from pot
*** SUMMARY ***
Total pot $7.22 | Rake $0.32 
Board [7d 5s 8d 4h Jd]
Seat 1: Mrburns.daoc folded before Flop (didn't bet)
Seat 2: chrisb64 folded before Flop (didn't bet)
Seat 3: negritos81 (button) folded before Flop (didn't bet)
Seat 4: Raffa93PK (small blind) showed [3c 6d] and lost with a straight, Four to Eight
Seat 5: LALLYITA (big blind) showed [6c 9h] and won ($6.90) with a straight, Five to Nine
Seat 6: cruxua folded before Flop (didn't bet)



PokerStars Hand #222950876206:  Hold'em No Limit ($0.05/$0.10 USD) - 2021/01/23 6:32:09 ET
Table 'Capricorn II' 6-max Seat #5 is the button
Seat 1: Mrburns.daoc ($10.65 in chips) 
Seat 2: chrisb64 ($7.93 in chips) 
Seat 3: negritos81 ($10.07 in chips) 
Seat 5: LALLYITA ($13.78 in chips) 
Seat 6: cruxua ($22.82 in chips) 
cruxua: posts small blind $0.05
Mrburns.daoc: posts big blind $0.10
*** HOLE CARDS ***
chrisb64: folds 
negritos81 has timed out
negritos81: folds 
LALLYITA: calls $0.10
cruxua: calls $0.05
Mrburns.daoc: checks 
*** FLOP *** [3c 4h 3s]
cruxua: checks 
Mrburns.daoc: checks 
LALLYITA: bets $0.10
cruxua: folds 
Mrburns.daoc: folds 
Uncalled bet ($0.10) returned to LALLYITA
LALLYITA collected $0.29 from pot
LALLYITA: doesn't show hand 
*** SUMMARY ***
Total pot $0.30 | Rake $0.01 
Board [3c 4h 3s]
Seat 1: Mrburns.daoc (big blind) folded on the Flop
Seat 2: chrisb64 folded before Flop (didn't bet)
Seat 3: negritos81 folded before Flop (didn't bet)
Seat 5: LALLYITA (button) collected ($0.29)
Seat 6: cruxua (small blind) folded on the Flop



PokerStars Hand #222950894931:  Hold'em No Limit ($0.05/$0.10 USD) - 2021/01/23 6:33:04 ET
Table 'Capricorn II' 6-max Seat #6 is the button
Seat 1: Mrburns.daoc ($10.55 in chips) 
Seat 2: chrisb64 ($7.93 in chips) 
Seat 4: Raffa93PK ($4 in chips) 
Seat 5: LALLYITA ($13.97 in chips) 
Seat 6: cruxua ($22.72 in chips) 
Mrburns.daoc: posts small blind $0.05
chrisb64: posts big blind $0.10
*** HOLE CARDS ***
Raffa93PK: calls $0.10
LALLYITA: folds 
cruxua: raises $0.15 to $0.25
Mrburns.daoc: folds 
chrisb64: folds 
Raffa93PK: calls $0.15
*** FLOP *** [As Kc Jh]
Raffa93PK: checks 
cruxua: checks 
*** TURN *** [As Kc Jh] [6d]
Raffa93PK: checks 
cruxua: bets $0.41
Raffa93PK: calls $0.41
*** RIVER *** [As Kc Jh 6d] [4d]
Raffa93PK: bets $0.40
cruxua: calls $0.40
*** SHOW DOWN ***
Raffa93PK: shows [4c Ks] (two pair, Kings and Fours)
cruxua: mucks hand 
Raffa93PK collected $2.17 from pot
*** SUMMARY ***
Total pot $2.27 | Rake $0.10 
Board [As Kc Jh 6d 4d]
Seat 1: Mrburns.daoc (small blind) folded before Flop
Seat 2: chrisb64 (big blind) folded before Flop
Seat 4: Raffa93PK showed [4c Ks] and won ($2.17) with two pair, Kings and Fours
Seat 5: LALLYITA folded before Flop (didn't bet)
Seat 6: cruxua (button) mucked



PokerStars Hand #222950910670:  Hold'em No Limit ($0.05/$0.10 USD) - 2021/01/23 6:33:50 ET
Table 'Capricorn II' 6-max Seat #1 is the button
Seat 1: Mrburns.daoc ($10.50 in chips) 
Seat 2: chrisb64 ($7.83 in chips) 
Seat 3: negritos81 ($10.07 in chips) 
Seat 4: Raffa93PK ($5.11 in chips) 
Seat 5: LALLYITA ($13.97 in chips) 
Seat 6: cruxua ($21.66 in chips) 
chrisb64: posts small blind $0.05
negritos81: posts big blind $0.10
*** HOLE CARDS ***
Raffa93PK: calls $0.10
LALLYITA: calls $0.10
cruxua: folds 
Mrburns.daoc: folds 
chrisb64: folds 
negritos81: checks 
*** FLOP *** [9c 5c 4d]
negritos81: checks 
Raffa93PK: checks 
LALLYITA: bets $0.33
negritos81: folds 
Raffa93PK: calls $0.33
*** TURN *** [9c 5c 4d] [Td]
Raffa93PK: checks 
LALLYITA: checks 
*** RIVER *** [9c 5c 4d Td] [Qs]
Raffa93PK: bets $0.20
LALLYITA: raises $13.34 to $13.54 and is all-in
Raffa93PK: folds 
Uncalled bet ($13.34) returned to LALLYITA
LALLYITA collected $1.35 from pot
LALLYITA: doesn't show hand 
*** SUMMARY ***
Total pot $1.41 | Rake $0.06 
Board [9c 5c 4d Td Qs]
Seat 1: Mrburns.daoc (button) folded before Flop (didn't bet)
Seat 2: chrisb64 (small blind) folded before Flop
Seat 3: negritos81 (big blind) folded on the Flop
Seat 4: Raffa93PK folded on the River
Seat 5: LALLYITA collected ($1.35)
Seat 6: cruxua folded before Flop (didn't bet)



PokerStars Hand #222950930678:  Hold'em No Limit ($0.05/$0.10 USD) - 2021/01/23 6:34:50 ET
Table 'Capricorn II' 6-max Seat #2 is the button
Seat 1: Mrburns.daoc ($10.50 in chips) 
Seat 2: chrisb64 ($7.78 in chips) 
Seat 3: negritos81 ($10 in chips) 
Seat 4: Raffa93PK ($4.48 in chips) 
Seat 5: LALLYITA ($14.69 in chips) 
Seat 6: cruxua ($21.66 in chips) 
negritos81: posts small blind $0.05
Raffa93PK: posts big blind $0.10
*** HOLE CARDS ***
LALLYITA: calls $0.10
cruxua: folds 
Mrburns.daoc: folds 
chrisb64: folds 
negritos81: folds 
Raffa93PK: checks 
*** FLOP *** [As Ts 5s]
Raffa93PK: checks 
LALLYITA: checks 
*** TURN *** [As Ts 5s] [Ac]
Raffa93PK: checks 
LALLYITA: checks 
*** RIVER *** [As Ts 5s Ac] [3s]
Raffa93PK: bets $0.20
LALLYITA: folds 
Uncalled bet ($0.20) returned to Raffa93PK
Raffa93PK collected $0.24 from pot
*** SUMMARY ***
Total pot $0.25 | Rake $0.01 
Board [As Ts 5s Ac 3s]
Seat 1: Mrburns.daoc folded before Flop (didn't bet)
Seat 2: chrisb64 (button) folded before Flop (didn't bet)
Seat 3: negritos81 (small blind) folded before Flop
Seat 4: Raffa93PK (big blind) collected ($0.24)
Seat 5: LALLYITA folded on the River
Seat 6: cruxua folded before Flop (didn't bet)



PokerStars Hand #222950942957:  Hold'em No Limit ($0.05/$0.10 USD) - 2021/01/23 6:35:26 ET
Table 'Capricorn II' 6-max Seat #3 is the button
Seat 1: Mrburns.daoc ($10.50 in chips) 
Seat 2: chrisb64 ($7.78 in chips) 
Seat 3: negritos81 ($10 in chips) 
Seat 4: Raffa93PK ($4.62 in chips) 
Seat 5: LALLYITA ($14.59 in chips) 
Seat 6: cruxua ($21.66 in chips) 
Raffa93PK: posts small blind $0.05
LALLYITA: posts big blind $0.10
*** HOLE CARDS ***
cruxua: raises $0.20 to $0.30
Mrburns.daoc: folds 
chrisb64: folds 
negritos81: folds 
Raffa93PK: folds 
LALLYITA: folds 
Uncalled bet ($0.20) returned to cruxua
cruxua collected $0.25 from pot
cruxua: doesn't show hand 
*** SUMMARY ***
Total pot $0.25 | Rake $0 
Seat 1: Mrburns.daoc folded before Flop (didn't bet)
Seat 2: chrisb64 folded before Flop (didn't bet)
Seat 3: negritos81 (button) folded before Flop (didn't bet)
Seat 4: Raffa93PK (small blind) folded before Flop
Seat 5: LALLYITA (big blind) folded before Flop
Seat 6: cruxua collected ($0.25)



PokerStars Hand #222950946431:  Hold'em No Limit ($0.05/$0.10 USD) - 2021/01/23 6:35:37 ET
Table 'Capricorn II' 6-max Seat #4 is the button
Seat 1: Mrburns.daoc ($10.50 in chips) 
Seat 2: chrisb64 ($7.78 in chips) 
Seat 3: negritos81 ($10 in chips) 
Seat 4: Raffa93PK ($4.57 in chips) 
Seat 5: LALLYITA ($14.49 in chips) 
Seat 6: cruxua ($21.81 in chips) 
LALLYITA: posts small blind $0.05
cruxua: posts big blind $0.10
*** HOLE CARDS ***
Mrburns.daoc: folds 
chrisb64: folds 
negritos81: folds 
Raffa93PK: calls $0.10
LALLYITA: calls $0.05
cruxua: checks 
*** FLOP *** [4h 9c Td]
LALLYITA: checks 
cruxua: checks 
Raffa93PK: checks 
*** TURN *** [4h 9c Td] [5h]
LALLYITA: checks 
cruxua: checks 
Raffa93PK: checks 
*** RIVER *** [4h 9c Td 5h] [Jd]
LALLYITA: bets $0.29
cruxua: folds 
Raffa93PK: folds 
Uncalled bet ($0.29) returned to LALLYITA
LALLYITA collected $0.29 from pot
LALLYITA: doesn't show hand 
*** SUMMARY ***
Total pot $0.30 | Rake $0.01 
Board [4h 9c Td 5h Jd]
Seat 1: Mrburns.daoc folded before Flop (didn't bet)
Seat 2: chrisb64 folded before Flop (didn't bet)
Seat 3: negritos81 folded before Flop (didn't bet)
Seat 4: Raffa93PK (button) folded on the River
Seat 5: LALLYITA (small blind) collected ($0.29)
Seat 6: cruxua (big blind) folded on the River



PokerStars Hand #222950969465:  Hold'em No Limit ($0.05/$0.10 USD) - 2021/01/23 6:36:46 ET
Table 'Capricorn II' 6-max Seat #5 is the button
Seat 1: Mrburns.daoc ($10.50 in chips) 
Seat 2: chrisb64 ($7.78 in chips) 
Seat 3: negritos81 ($10 in chips) 
Seat 4: Raffa93PK ($4.47 in chips) 
Seat 5: LALLYITA ($14.68 in chips) 
Seat 6: cruxua ($21.71 in chips) 
cruxua: posts small blind $0.05
Mrburns.daoc: posts big blind $0.10
*** HOLE CARDS ***
chrisb64: folds 
negritos81: raises $0.20 to $0.30
Raffa93PK: folds 
LALLYITA: folds 
cruxua: folds 
Mrburns.daoc: folds 
Uncalled bet ($0.20) returned to negritos81
negritos81 collected $0.25 from pot
negritos81: doesn't show hand 
*** SUMMARY ***
Total pot $0.25 | Rake $0 
Seat 1: Mrburns.daoc (big blind) folded before Flop
Seat 2: chrisb64 folded before Flop (didn't bet)
Seat 3: negritos81 collected ($0.25)
Seat 4: Raffa93PK folded before Flop (didn't bet)
Seat 5: LALLYITA (button) folded before Flop (didn't bet)
Seat 6: cruxua (small blind) folded before Flop



PokerStars Hand #222950974089:  Hold'em No Limit ($0.05/$0.10 USD) - 2021/01/23 6:37:00 ET
Table 'Capricorn II' 6-max Seat #6 is the button
Seat 1: Mrburns.daoc ($10.40 in chips) 
Seat 2: chrisb64 ($7.78 in chips) 
Seat 3: negritos81 ($10.15 in chips) 
Seat 4: Raffa93PK ($4.47 in chips) 
Seat 5: LALLYITA ($14.68 in chips) 
Seat 6: cruxua ($21.66 in chips) 
Mrburns.daoc: posts small blind $0.05
chrisb64: posts big blind $0.10
*** HOLE CARDS ***
negritos81: folds 
Raffa93PK: calls $0.10
LALLYITA: calls $0.10
cruxua: folds 
Mrburns.daoc: folds 
chrisb64: raises $0.40 to $0.50
Raffa93PK: calls $0.40
LALLYITA: folds 
*** FLOP *** [Ad 2s Th]
chrisb64: bets $1.10
Raffa93PK: calls $1.10
*** TURN *** [Ad 2s Th] [Qh]
chrisb64: bets $3.20
Raffa93PK: calls $2.87 and is all-in
Uncalled bet ($0.33) returned to chrisb64
*** RIVER *** [Ad 2s Th Qh] [5s]
*** SHOW DOWN ***
chrisb64: shows [Ks Ah] (a pair of Aces)
Raffa93PK: shows [As 7d] (a pair of Aces - lower kicker)
chrisb64 cashed out the hand for $8.01 | Cash Out Fee $0.08
*** SUMMARY ***
Total pot $9.09 | Rake $0.41 
Board [Ad 2s Th Qh 5s]
Seat 1: Mrburns.daoc (small blind) folded before Flop
Seat 2: chrisb64 (big blind) showed [Ks Ah] and won ($8.68) with a pair of Aces (pot not awarded as player cashed out)
Seat 3: negritos81 folded before Flop (didn't bet)
Seat 4: Raffa93PK showed [As 7d] and lost with a pair of Aces
Seat 5: LALLYITA folded before Flop
Seat 6: cruxua (button) folded before Flop (didn't bet)



PokerStars Hand #222950992254:  Hold'em No Limit ($0.05/$0.10 USD) - 2021/01/23 6:37:53 ET
Table 'Capricorn II' 6-max Seat #1 is the button
Seat 1: Mrburns.daoc ($10.35 in chips) 
Seat 2: chrisb64 ($11.32 in chips) 
Seat 5: LALLYITA ($14.58 in chips) 
Seat 6: cruxua ($21.66 in chips) 
chrisb64: posts small blind $0.05
LALLYITA: posts big blind $0.10
*** HOLE CARDS ***
cruxua: folds 
negritos81 leaves the table
Raffa93PK leaves the table
Mrburns.daoc: raises $0.19 to $0.29
chrisb64: folds 
LALLYITA: calls $0.19
*** FLOP *** [3s 6c Ks]
LALLYITA: checks 
Mrburns.daoc: checks 
*** TURN *** [3s 6c Ks] [3c]
LALLYITA: checks 
Mrburns.daoc: checks 
*** RIVER *** [3s 6c Ks 3c] [Jh]
LALLYITA: bets $0.60
Mrburns.daoc: calls $0.60
*** SHOW DOWN ***
LALLYITA: shows [7d Ad] (a pair of Threes)
Mrburns.daoc: shows [9c Js] (two pair, Jacks and Threes)
Mrburns.daoc collected $1.75 from pot
*** SUMMARY ***
Total pot $1.83 | Rake $0.08 
Board [3s 6c Ks 3c Jh]
Seat 1: Mrburns.daoc (button) showed [9c Js] and won ($1.75) with two pair, Jacks and Threes
Seat 2: chrisb64 (small blind) folded before Flop
Seat 5: LALLYITA (big blind) showed [7d Ad] and lost with a pair of Threes
Seat 6: cruxua folded before Flop (didn't bet)



PokerStars Hand #222951021216:  Hold'em No Limit ($0.05/$0.10 USD) - 2021/01/23 6:39:18 ET
Table 'Capricorn II' 6-max Seat #2 is the button
Seat 1: Mrburns.daoc ($11.21 in chips) 
Seat 2: chrisb64 ($11.27 in chips) 
Seat 5: LALLYITA ($13.69 in chips) 
Seat 6: cruxua ($21.66 in chips) 
LALLYITA: posts small blind $0.05
cruxua: posts big blind $0.10
*** HOLE CARDS ***
Mrburns.daoc: raises $0.14 to $0.24
chrisb64: folds 
LALLYITA: folds 
cruxua: folds 
Uncalled bet ($0.14) returned to Mrburns.daoc
Mrburns.daoc collected $0.25 from pot
Mrburns.daoc: doesn't show hand 
*** SUMMARY ***
Total pot $0.25 | Rake $0 
Seat 1: Mrburns.daoc collected ($0.25)
Seat 2: chrisb64 (button) folded before Flop (didn't bet)
Seat 5: LALLYITA (small blind) folded before Flop
Seat 6: cruxua (big blind) folded before Flop



PokerStars Hand #222951025233:  Hold'em No Limit ($0.05/$0.10 USD) - 2021/01/23 6:39:30 ET
Table 'Capricorn II' 6-max Seat #5 is the button
Seat 1: Mrburns.daoc ($11.36 in chips) 
Seat 2: chrisb64 ($11.27 in chips) 
Seat 5: LALLYITA ($13.64 in chips) 
Seat 6: cruxua ($21.56 in chips) 
cruxua: posts small blind $0.05
Mrburns.daoc: posts big blind $0.10
*** HOLE CARDS ***
chrisb64: folds 
LALLYITA: folds 
LALLYITA leaves the table
cruxua: raises $0.20 to $0.30
Mrburns.daoc: calls $0.20
*** FLOP *** [4d 3h Kh]
cruxua: bets $0.38
Mrburns.daoc: folds 
Uncalled bet ($0.38) returned to cruxua
cruxua collected $0.57 from pot
cruxua: doesn't show hand 
*** SUMMARY ***
Total pot $0.60 | Rake $0.03 
Board [4d 3h Kh]
Seat 1: Mrburns.daoc (big blind) folded on the Flop
Seat 2: chrisb64 folded before Flop (didn't bet)
Seat 5: LALLYITA (button) folded before Flop (didn't bet)
Seat 6: cruxua (small blind) collected ($0.57)



PokerStars Hand #222951043919:  Hold'em No Limit ($0.05/$0.10 USD) - 2021/01/23 6:40:25 ET
Table 'Capricorn II' 6-max Seat #6 is the button
Seat 1: Mrburns.daoc ($11.06 in chips) 
Seat 2: chrisb64 ($11.27 in chips) 
Seat 6: cruxua ($21.83 in chips) 
Mrburns.daoc: posts small blind $0.05
chrisb64: posts big blind $0.10
*** HOLE CARDS ***
cruxua: folds 
Mrburns.daoc: folds 
Uncalled bet ($0.05) returned to chrisb64
chrisb64 collected $0.10 from pot
chrisb64: doesn't show hand 
*** SUMMARY ***
Total pot $0.10 | Rake $0 
Seat 1: Mrburns.daoc (small blind) folded before Flop
Seat 2: chrisb64 (big blind) collected ($0.10)
Seat 6: cruxua (button) folded before Flop (didn't bet)



PokerStars Hand #222951045790:  Hold'em No Limit ($0.05/$0.10 USD) - 2021/01/23 6:40:31 ET
Table 'Capricorn II' 6-max Seat #2 is the button
Seat 1: Mrburns.daoc ($11.01 in chips) 
Seat 2: chrisb64 ($11.32 in chips) 
chrisb64: posts small blind $0.05
cruxua: is sitting out 
Mrburns.daoc: posts big blind $0.10
*** HOLE CARDS ***
chrisb64: folds 
Uncalled bet ($0.05) returned to Mrburns.daoc
Mrburns.daoc collected $0.10 from pot
Mrburns.daoc: doesn't show hand 
*** SUMMARY ***
Total pot $0.10 | Rake $0 
Seat 1: Mrburns.daoc (big blind) collected ($0.10)
Seat 2: chrisb64 (button) (small blind) folded before Flop



PokerStars Hand #222964426686:  Hold'em No Limit ($0.05/$0.10 USD) - 2021/01/23 13:43:52 ET
Table 'Capricorn III' 6-max Seat #6 is the button
Seat 1: greenthum33 ($12.48 in chips) 
Seat 2: witchdocta00 ($3.74 in chips) 
Seat 3: 9IHyKoBi4 ($8.47 in chips) 
Seat 4: ungiwar ($4.05 in chips) 
Seat 5: xiled90 ($10.14 in chips) 
Seat 6: Acedan1369 ($10.33 in chips) 
greenthum33: posts small blind $0.05
witchdocta00: posts big blind $0.10
*** HOLE CARDS ***
9IHyKoBi4 has timed out
9IHyKoBi4: folds 
ungiwar: folds 
xiled90: folds 
Acedan1369: folds 
greenthum33: folds 
Uncalled bet ($0.05) returned to witchdocta00
witchdocta00 collected $0.10 from pot
witchdocta00: doesn't show hand 
*** SUMMARY ***
Total pot $0.10 | Rake $0 
Seat 1: greenthum33 (small blind) folded before Flop
Seat 2: witchdocta00 (big blind) collected ($0.10)
Seat 3: 9IHyKoBi4 folded before Flop (didn't bet)
Seat 4: ungiwar folded before Flop (didn't bet)
Seat 5: xiled90 folded before Flop (didn't bet)
Seat 6: Acedan1369 (button) folded before Flop (didn't bet)



PokerStars Hand #222964445822:  Hold'em No Limit ($0.05/$0.10 USD) - 2021/01/23 13:44:17 ET
Table 'Capricorn III' 6-max Seat #1 is the button
Seat 1: greenthum33 ($12.43 in chips) 
Seat 2: witchdocta00 ($3.79 in chips) 
Seat 3: 9IHyKoBi4 ($8.47 in chips) 
Seat 4: ungiwar ($4.05 in chips) 
Seat 5: xiled90 ($10.14 in chips) 
Seat 6: Acedan1369 ($10.33 in chips) 
witchdocta00: posts small blind $0.05
9IHyKoBi4: posts big blind $0.10
*** HOLE CARDS ***
ungiwar: folds 
xiled90: folds 
Acedan1369 has timed out
Acedan1369: folds 
greenthum33: raises $0.20 to $0.30
witchdocta00: folds 
9IHyKoBi4: folds 
Uncalled bet ($0.20) returned to greenthum33
greenthum33 collected $0.25 from pot
greenthum33: doesn't show hand 
*** SUMMARY ***
Total pot $0.25 | Rake $0 
Seat 1: greenthum33 (button) collected ($0.25)
Seat 2: witchdocta00 (small blind) folded before Flop
Seat 3: 9IHyKoBi4 (big blind) folded before Flop
Seat 4: ungiwar folded before Flop (didn't bet)
Seat 5: xiled90 folded before Flop (didn't bet)
Seat 6: Acedan1369 folded before Flop (didn't bet)



PokerStars Hand #222964468742:  Hold'em No Limit ($0.05/$0.10 USD) - 2021/01/23 13:44:46 ET
Table 'Capricorn III' 6-max Seat #2 is the button
Seat 1: greenthum33 ($12.58 in chips) 
Seat 2: witchdocta00 ($3.74 in chips) 
Seat 3: 9IHyKoBi4 ($8.37 in chips) 
Seat 4: ungiwar ($4.05 in chips) 
Seat 5: xiled90 ($10.14 in chips) 
Seat 6: Acedan1369 ($10.33 in chips) 
9IHyKoBi4: posts small blind $0.05
ungiwar: posts big blind $0.10
*** HOLE CARDS ***
xiled90: folds 
Acedan1369: folds 
greenthum33: folds 
witchdocta00: calls $0.10
9IHyKoBi4: raises $0.10 to $0.20
ungiwar: folds 
witchdocta00: calls $0.10
*** FLOP *** [Ac Kc Kd]
9IHyKoBi4: checks 
witchdocta00: bets $0.20
9IHyKoBi4: calls $0.20
*** TURN *** [Ac Kc Kd] [Jh]
9IHyKoBi4: checks 
witchdocta00: bets $0.20
9IHyKoBi4: raises $0.20 to $0.40
witchdocta00: calls $0.20
*** RIVER *** [Ac Kc Kd Jh] [8s]
greenthum33 leaves the table
9IHyKoBi4: bets $0.50
witchdocta00: calls $0.50
*** SHOW DOWN ***
9IHyKoBi4: shows [Kh Qs] (three of a kind, Kings)
witchdocta00: mucks hand 
9IHyKoBi4 collected $2.58 from pot
*** SUMMARY ***
Total pot $2.70 | Rake $0.12 
Board [Ac Kc Kd Jh 8s]
Seat 1: greenthum33 folded before Flop (didn't bet)
Seat 2: witchdocta00 (button) mucked
Seat 3: 9IHyKoBi4 (small blind) showed [Kh Qs] and won ($2.58) with three of a kind, Kings
Seat 4: ungiwar (big blind) folded before Flop
Seat 5: xiled90 folded before Flop (didn't bet)
Seat 6: Acedan1369 folded before Flop (didn't bet)



PokerStars Hand #222964522691:  Hold'em No Limit ($0.05/$0.10 USD) - 2021/01/23 13:45:56 ET
Table 'Capricorn III' 6-max Seat #3 is the button
Seat 2: witchdocta00 ($2.44 in chips) 
Seat 3: 9IHyKoBi4 ($9.65 in chips) 
Seat 4: ungiwar ($3.95 in chips) 
Seat 5: xiled90 ($10.14 in chips) 
Seat 6: Acedan1369 ($10.33 in chips) 
ungiwar: posts small blind $0.05
xiled90: posts big blind $0.10
*** HOLE CARDS ***
Acedan1369: folds 
witchdocta00: folds 
9IHyKoBi4: raises $0.10 to $0.20
ungiwar: calls $0.15
xiled90: folds 
*** FLOP *** [Kh 9h 7c]
ungiwar: checks 
9IHyKoBi4: bets $0.20
ungiwar: folds 
Uncalled bet ($0.20) returned to 9IHyKoBi4
9IHyKoBi4 collected $0.48 from pot
9IHyKoBi4: doesn't show hand 
*** SUMMARY ***
Total pot $0.50 | Rake $0.02 
Board [Kh 9h 7c]
Seat 2: witchdocta00 folded before Flop (didn't bet)
Seat 3: 9IHyKoBi4 (button) collected ($0.48)
Seat 4: ungiwar (small blind) folded on the Flop
Seat 5: xiled90 (big blind) folded before Flop
Seat 6: Acedan1369 folded before Flop (didn't bet)



PokerStars Hand #222964556245:  Hold'em No Limit ($0.05/$0.10 USD) - 2021/01/23 13:46:40 ET
Table 'Capricorn III' 6-max Seat #4 is the button
Seat 2: witchdocta00 ($2.44 in chips) 
Seat 3: 9IHyKoBi4 ($9.93 in chips) 
Seat 4: ungiwar ($3.75 in chips) 
Seat 5: xiled90 ($10.04 in chips) 
Seat 6: Acedan1369 ($10.33 in chips) 
xiled90: posts small blind $0.05
Acedan1369: posts big blind $0.10
*** HOLE CARDS ***
witchdocta00: folds 
9IHyKoBi4: folds 
ungiwar: folds 
witchdocta00 leaves the table
12bwb3 joins the table at seat #1 
xiled90: raises $0.20 to $0.30
Acedan1369: folds 
Uncalled bet ($0.20) returned to xiled90
xiled90 collected $0.20 from pot
*** SUMMARY ***
Total pot $0.20 | Rake $0 
Seat 2: witchdocta00 folded before Flop (didn't bet)
Seat 3: 9IHyKoBi4 folded before Flop (didn't bet)
Seat 4: ungiwar (button) folded before Flop (didn't bet)
Seat 5: xiled90 (small blind) collected ($0.20)
Seat 6: Acedan1369 (big blind) folded before Flop



PokerStars Hand #222964566038:  Hold'em No Limit ($0.05/$0.10 USD) - 2021/01/23 13:46:53 ET
Table 'Capricorn III' 6-max Seat #5 is the button
Seat 1: 12bwb3 ($5 in chips) 
Seat 3: 9IHyKoBi4 ($9.93 in chips) 
Seat 4: ungiwar ($3.75 in chips) 
Seat 5: xiled90 ($10.14 in chips) 
Seat 6: Acedan1369 ($10.23 in chips) 
Acedan1369: posts small blind $0.05
12bwb3: posts big blind $0.10
*** HOLE CARDS ***
9IHyKoBi4 has timed out
9IHyKoBi4: folds 
ungiwar: folds 
xiled90: folds 
Acedan1369: folds 
Uncalled bet ($0.05) returned to 12bwb3
12bwb3 collected $0.10 from pot
12bwb3: doesn't show hand 
*** SUMMARY ***
Total pot $0.10 | Rake $0 
Seat 1: 12bwb3 (big blind) collected ($0.10)
Seat 3: 9IHyKoBi4 folded before Flop (didn't bet)
Seat 4: ungiwar folded before Flop (didn't bet)
Seat 5: xiled90 (button) folded before Flop (didn't bet)
Seat 6: Acedan1369 (small blind) folded before Flop



PokerStars Hand #222964578148:  Hold'em No Limit ($0.05/$0.10 USD) - 2021/01/23 13:47:09 ET
Table 'Capricorn III' 6-max Seat #6 is the button
Seat 1: 12bwb3 ($5.05 in chips) 
Seat 3: 9IHyKoBi4 ($9.93 in chips) 
Seat 4: ungiwar ($3.75 in chips) 
Seat 5: xiled90 ($10.14 in chips) 
Seat 6: Acedan1369 ($10.18 in chips) 
12bwb3: posts small blind $0.05
9IHyKoBi4: posts big blind $0.10
*** HOLE CARDS ***
greenthum33 joins the table at seat #2 
ungiwar: raises $0.10 to $0.20
xiled90: folds 
Acedan1369: folds 
12bwb3: folds 
9IHyKoBi4: folds 
Uncalled bet ($0.10) returned to ungiwar
ungiwar collected $0.25 from pot
ungiwar: doesn't show hand 
*** SUMMARY ***
Total pot $0.25 | Rake $0 
Seat 1: 12bwb3 (small blind) folded before Flop
Seat 3: 9IHyKoBi4 (big blind) folded before Flop
Seat 4: ungiwar collected ($0.25)
Seat 5: xiled90 folded before Flop (didn't bet)
Seat 6: Acedan1369 (button) folded before Flop (didn't bet)



PokerStars Hand #222964589264:  Hold'em No Limit ($0.05/$0.10 USD) - 2021/01/23 13:47:24 ET
Table 'Capricorn III' 6-max Seat #1 is the button
Seat 1: 12bwb3 ($5 in chips) 
Seat 3: 9IHyKoBi4 ($9.83 in chips) 
Seat 4: ungiwar ($3.90 in chips) 
Seat 5: xiled90 ($10.14 in chips) 
Seat 6: Acedan1369 ($10.18 in chips) 
9IHyKoBi4: posts small blind $0.05
ungiwar: posts big blind $0.10
*** HOLE CARDS ***
xiled90: folds 
Acedan1369: folds 
12bwb3: folds 
9IHyKoBi4: raises $0.10 to $0.20
ungiwar: calls $0.10
*** FLOP *** [8s Jc 2h]
9IHyKoBi4: checks 
ungiwar: checks 
*** TURN *** [8s Jc 2h] [Js]
9IHyKoBi4: checks 
ungiwar: checks 
*** RIVER *** [8s Jc 2h Js] [As]
9IHyKoBi4: checks 
ungiwar: bets $0.13
9IHyKoBi4: folds 
Uncalled bet ($0.13) returned to ungiwar
ungiwar collected $0.38 from pot
ungiwar: doesn't show hand 
*** SUMMARY ***
Total pot $0.40 | Rake $0.02 
Board [8s Jc 2h Js As]
Seat 1: 12bwb3 (button) folded before Flop (didn't bet)
Seat 3: 9IHyKoBi4 (small blind) folded on the River
Seat 4: ungiwar (big blind) collected ($0.38)
Seat 5: xiled90 folded before Flop (didn't bet)
Seat 6: Acedan1369 folded before Flop (didn't bet)



PokerStars Hand #222964631732:  Hold'em No Limit ($0.05/$0.10 USD) - 2021/01/23 13:48:20 ET
Table 'Capricorn III' 6-max Seat #3 is the button
Seat 1: 12bwb3 ($5 in chips) 
Seat 3: 9IHyKoBi4 ($9.63 in chips) 
Seat 4: ungiwar ($4.08 in chips) 
Seat 5: xiled90 ($10.14 in chips) 
Seat 6: Acedan1369 ($10.18 in chips) 
ungiwar: posts small blind $0.05
xiled90: posts big blind $0.10
greenthum33: sits out 
*** HOLE CARDS ***
Acedan1369: folds 
12bwb3: raises $0.10 to $0.20
9IHyKoBi4 is disconnected 
9IHyKoBi4 has timed out while disconnected
9IHyKoBi4: folds 
ungiwar: folds 
xiled90: calls $0.10
*** FLOP *** [7s Qd 5s]
xiled90: checks 
12bwb3: bets $0.22
xiled90: folds 
Uncalled bet ($0.22) returned to 12bwb3
12bwb3 collected $0.43 from pot
12bwb3: doesn't show hand 
*** SUMMARY ***
Total pot $0.45 | Rake $0.02 
Board [7s Qd 5s]
Seat 1: 12bwb3 collected ($0.43)
Seat 3: 9IHyKoBi4 (button) folded before Flop (didn't bet)
Seat 4: ungiwar (small blind) folded before Flop
Seat 5: xiled90 (big blind) folded on the Flop
Seat 6: Acedan1369 folded before Flop (didn't bet)



PokerStars Hand #222964663077:  Hold'em No Limit ($0.05/$0.10 USD) - 2021/01/23 13:49:01 ET
Table 'Capricorn III' 6-max Seat #4 is the button
Seat 1: 12bwb3 ($5.23 in chips) 
Seat 4: ungiwar ($4.03 in chips) 
Seat 5: xiled90 ($10 in chips) 
Seat 6: Acedan1369 ($10.18 in chips) 
xiled90: posts small blind $0.05
Acedan1369: posts big blind $0.10
greenthum33: sits out 
*** HOLE CARDS ***
12bwb3: folds 
ungiwar: raises $0.10 to $0.20
xiled90: folds 
Acedan1369: folds 
Uncalled bet ($0.10) returned to ungiwar
ungiwar collected $0.25 from pot
ungiwar: doesn't show hand 
*** SUMMARY ***
Total pot $0.25 | Rake $0 
Seat 1: 12bwb3 folded before Flop (didn't bet)
Seat 4: ungiwar (button) collected ($0.25)
Seat 5: xiled90 (small blind) folded before Flop
Seat 6: Acedan1369 (big blind) folded before Flop



PokerStars Hand #222964672579:  Hold'em No Limit ($0.05/$0.10 USD) - 2021/01/23 13:49:13 ET
Table 'Capricorn III' 6-max Seat #5 is the button
Seat 1: 12bwb3 ($5.23 in chips) 
Seat 4: ungiwar ($4.18 in chips) 
Seat 5: xiled90 ($10 in chips) 
Seat 6: Acedan1369 ($10.08 in chips) 
Acedan1369: posts small blind $0.05
12bwb3: posts big blind $0.10
greenthum33: sits out 
*** HOLE CARDS ***
ungiwar: folds 
xiled90: folds 
Acedan1369: raises $0.15 to $0.25
12bwb3: folds 
Uncalled bet ($0.15) returned to Acedan1369
Acedan1369 collected $0.20 from pot
Acedan1369: doesn't show hand 
*** SUMMARY ***
Total pot $0.20 | Rake $0 
Seat 1: 12bwb3 (big blind) folded before Flop
Seat 4: ungiwar folded before Flop (didn't bet)
Seat 5: xiled90 (button) folded before Flop (didn't bet)
Seat 6: Acedan1369 (small blind) collected ($0.20)



PokerStars Hand #222964683666:  Hold'em No Limit ($0.05/$0.10 USD) - 2021/01/23 13:49:28 ET
Table 'Capricorn III' 6-max Seat #6 is the button
Seat 1: 12bwb3 ($5.13 in chips) 
Seat 2: greenthum33 ($12.58 in chips) 
Seat 4: ungiwar ($4.18 in chips) 
Seat 5: xiled90 ($10 in chips) 
Seat 6: Acedan1369 ($10.18 in chips) 
12bwb3: posts small blind $0.05
greenthum33: posts big blind $0.10
*** HOLE CARDS ***
ungiwar: folds 
xiled90: folds 
Acedan1369: raises $0.15 to $0.25
12bwb3: calls $0.20
greenthum33: folds 
*** FLOP *** [Td 3d 9c]
12bwb3: checks 
Acedan1369: bets $0.43
12bwb3: folds 
Uncalled bet ($0.43) returned to Acedan1369
Acedan1369 collected $0.57 from pot
Acedan1369: doesn't show hand 
*** SUMMARY ***
Total pot $0.60 | Rake $0.03 
Board [Td 3d 9c]
Seat 1: 12bwb3 (small blind) folded on the Flop
Seat 2: greenthum33 (big blind) folded before Flop
Seat 4: ungiwar folded before Flop (didn't bet)
Seat 5: xiled90 folded before Flop (didn't bet)
Seat 6: Acedan1369 (button) collected ($0.57)



PokerStars Hand #222964700933:  Hold'em No Limit ($0.05/$0.10 USD) - 2021/01/23 13:49:50 ET
Table 'Capricorn III' 6-max Seat #1 is the button
Seat 1: 12bwb3 ($4.88 in chips) 
Seat 2: greenthum33 ($12.48 in chips) 
Seat 4: ungiwar ($4.18 in chips) 
Seat 5: xiled90 ($10 in chips) 
Seat 6: Acedan1369 ($10.50 in chips) 
greenthum33: posts small blind $0.05
ungiwar: posts big blind $0.10
*** HOLE CARDS ***
xiled90: folds 
Acedan1369: raises $0.15 to $0.25
12bwb3: folds 
greenthum33: folds 
ungiwar: folds 
Uncalled bet ($0.15) returned to Acedan1369
Acedan1369 collected $0.25 from pot
Acedan1369: doesn't show hand 
*** SUMMARY ***
Total pot $0.25 | Rake $0 
Seat 1: 12bwb3 (button) folded before Flop (didn't bet)
Seat 2: greenthum33 (small blind) folded before Flop
Seat 4: ungiwar (big blind) folded before Flop
Seat 5: xiled90 folded before Flop (didn't bet)
Seat 6: Acedan1369 collected ($0.25)



PokerStars Hand #222964713668:  Hold'em No Limit ($0.05/$0.10 USD) - 2021/01/23 13:50:07 ET
Table 'Capricorn III' 6-max Seat #2 is the button
Seat 1: 12bwb3 ($4.88 in chips) 
Seat 2: greenthum33 ($12.43 in chips) 
Seat 4: ungiwar ($4.08 in chips) 
Seat 5: xiled90 ($10 in chips) 
Seat 6: Acedan1369 ($10.65 in chips) 
ungiwar: posts small blind $0.05
xiled90: posts big blind $0.10
*** HOLE CARDS ***
Acedan1369: folds 
12bwb3: folds 
greenthum33: folds 
ungiwar: raises $0.18 to $0.28
xiled90: folds 
Uncalled bet ($0.18) returned to ungiwar
ungiwar collected $0.20 from pot
ungiwar: doesn't show hand 
*** SUMMARY ***
Total pot $0.20 | Rake $0 
Seat 1: 12bwb3 folded before Flop (didn't bet)
Seat 2: greenthum33 (button) folded before Flop (didn't bet)
Seat 4: ungiwar (small blind) collected ($0.20)
Seat 5: xiled90 (big blind) folded before Flop
Seat 6: Acedan1369 folded before Flop (didn't bet)



PokerStars Hand #222964728483:  Hold'em No Limit ($0.05/$0.10 USD) - 2021/01/23 13:50:27 ET
Table 'Capricorn III' 6-max Seat #4 is the button
Seat 1: 12bwb3 ($4.88 in chips) 
Seat 2: greenthum33 ($12.43 in chips) 
Seat 4: ungiwar ($4.18 in chips) 
Seat 5: xiled90 ($10 in chips) 
Seat 6: Acedan1369 ($10.65 in chips) 
xiled90: posts small blind $0.05
Acedan1369: posts big blind $0.10
*** HOLE CARDS ***
12bwb3: folds 
greenthum33: folds 
ungiwar: folds 
xiled90: folds 
Uncalled bet ($0.05) returned to Acedan1369
Acedan1369 collected $0.10 from pot
Acedan1369: doesn't show hand 
*** SUMMARY ***
Total pot $0.10 | Rake $0 
Seat 1: 12bwb3 folded before Flop (didn't bet)
Seat 2: greenthum33 folded before Flop (didn't bet)
Seat 4: ungiwar (button) folded before Flop (didn't bet)
Seat 5: xiled90 (small blind) folded before Flop
Seat 6: Acedan1369 (big blind) collected ($0.10)



PokerStars Hand #222964733938:  Hold'em No Limit ($0.05/$0.10 USD) - 2021/01/23 13:50:34 ET
Table 'Capricorn III' 6-max Seat #5 is the button
Seat 1: 12bwb3 ($4.88 in chips) 
Seat 2: greenthum33 ($12.43 in chips) 
Seat 4: ungiwar ($4.18 in chips) 
Seat 5: xiled90 ($10 in chips) 
Seat 6: Acedan1369 ($10.70 in chips) 
Acedan1369: posts small blind $0.05
12bwb3: posts big blind $0.10
*** HOLE CARDS ***
greenthum33: raises $0.20 to $0.30
ungiwar: folds 
xiled90: folds 
Acedan1369: folds 
12bwb3: calls $0.20
*** FLOP *** [2d 8c 9s]
12bwb3: checks 
greenthum33: bets $0.30
12bwb3: calls $0.30
*** TURN *** [2d 8c 9s] [Ts]
12bwb3: checks 
greenthum33: checks 
*** RIVER *** [2d 8c 9s Ts] [5c]
12bwb3: checks 
greenthum33: bets $0.60
12bwb3: folds 
Uncalled bet ($0.60) returned to greenthum33
greenthum33 collected $1.19 from pot
greenthum33: doesn't show hand 
*** SUMMARY ***
Total pot $1.25 | Rake $0.06 
Board [2d 8c 9s Ts 5c]
Seat 1: 12bwb3 (big blind) folded on the River
Seat 2: greenthum33 collected ($1.19)
Seat 4: ungiwar folded before Flop (didn't bet)
Seat 5: xiled90 (button) folded before Flop (didn't bet)
Seat 6: Acedan1369 (small blind) folded before Flop



PokerStars Hand #222964761621:  Hold'em No Limit ($0.05/$0.10 USD) - 2021/01/23 13:51:10 ET
Table 'Capricorn III' 6-max Seat #6 is the button
Seat 1: 12bwb3 ($4.28 in chips) 
Seat 2: greenthum33 ($13.02 in chips) 
Seat 4: ungiwar ($4.18 in chips) 
Seat 5: xiled90 ($10 in chips) 
Seat 6: Acedan1369 ($10.65 in chips) 
12bwb3: posts small blind $0.05
greenthum33: posts big blind $0.10
*** HOLE CARDS ***
ungiwar: folds 
xiled90: folds 
Acedan1369: raises $0.15 to $0.25
12bwb3: folds 
greenthum33: raises $0.25 to $0.50
Acedan1369: raises $1 to $1.50
greenthum33: folds 
Uncalled bet ($1) returned to Acedan1369
Acedan1369 collected $1.05 from pot
Acedan1369: doesn't show hand 
*** SUMMARY ***
Total pot $1.05 | Rake $0 
Seat 1: 12bwb3 (small blind) folded before Flop
Seat 2: greenthum33 (big blind) folded before Flop
Seat 4: ungiwar folded before Flop (didn't bet)
Seat 5: xiled90 folded before Flop (didn't bet)
Seat 6: Acedan1369 (button) collected ($1.05)



PokerStars Hand #222964787722:  Hold'em No Limit ($0.05/$0.10 USD) - 2021/01/23 13:51:44 ET
Table 'Capricorn III' 6-max Seat #1 is the button
Seat 1: 12bwb3 ($4.23 in chips) 
Seat 2: greenthum33 ($12.52 in chips) 
Seat 4: ungiwar ($4.18 in chips) 
Seat 5: xiled90 ($10 in chips) 
Seat 6: Acedan1369 ($11.20 in chips) 
greenthum33: posts small blind $0.05
ungiwar: posts big blind $0.10
*** HOLE CARDS ***
xiled90: folds 
Acedan1369: raises $0.30 to $0.40
12bwb3: folds 
greenthum33: folds 
ungiwar: folds 
Uncalled bet ($0.30) returned to Acedan1369
Acedan1369 collected $0.25 from pot
Acedan1369: doesn't show hand 
*** SUMMARY ***
Total pot $0.25 | Rake $0 
Seat 1: 12bwb3 (button) folded before Flop (didn't bet)
Seat 2: greenthum33 (small blind) folded before Flop
Seat 4: ungiwar (big blind) folded before Flop
Seat 5: xiled90 folded before Flop (didn't bet)
Seat 6: Acedan1369 collected ($0.25)



PokerStars Hand #222964797517:  Hold'em No Limit ($0.05/$0.10 USD) - 2021/01/23 13:51:57 ET
Table 'Capricorn III' 6-max Seat #2 is the button
Seat 1: 12bwb3 ($4.23 in chips) 
Seat 2: greenthum33 ($12.47 in chips) 
Seat 4: ungiwar ($4.08 in chips) 
Seat 5: xiled90 ($10 in chips) 
Seat 6: Acedan1369 ($11.35 in chips) 
ungiwar: posts small blind $0.05
xiled90: posts big blind $0.10
*** HOLE CARDS ***
Acedan1369: folds 
12bwb3: folds 
greenthum33: folds 
ungiwar: folds 
Uncalled bet ($0.05) returned to xiled90
xiled90 collected $0.10 from pot
xiled90: doesn't show hand 
*** SUMMARY ***
Total pot $0.10 | Rake $0 
Seat 1: 12bwb3 folded before Flop (didn't bet)
Seat 2: greenthum33 (button) folded before Flop (didn't bet)
Seat 4: ungiwar (small blind) folded before Flop
Seat 5: xiled90 (big blind) collected ($0.10)
Seat 6: Acedan1369 folded before Flop (didn't bet)



PokerStars Hand #222964803282:  Hold'em No Limit ($0.05/$0.10 USD) - 2021/01/23 13:52:04 ET
Table 'Capricorn III' 6-max Seat #4 is the button
Seat 1: 12bwb3 ($4.23 in chips) 
Seat 2: greenthum33 ($12.47 in chips) 
Seat 4: ungiwar ($4.03 in chips) 
Seat 5: xiled90 ($10.05 in chips) 
Seat 6: Acedan1369 ($11.35 in chips) 
xiled90: posts small blind $0.05
Acedan1369: posts big blind $0.10
*** HOLE CARDS ***
12bwb3: raises $0.10 to $0.20
greenthum33: folds 
ungiwar: folds 
xiled90: folds 
Acedan1369: calls $0.10
*** FLOP *** [6c 7d 3s]
Acedan1369: checks 
12bwb3: checks 
*** TURN *** [6c 7d 3s] [7s]
Acedan1369: bets $0.32
12bwb3: folds 
Uncalled bet ($0.32) returned to Acedan1369
Acedan1369 collected $0.43 from pot
Acedan1369: doesn't show hand 
*** SUMMARY ***
Total pot $0.45 | Rake $0.02 
Board [6c 7d 3s 7s]
Seat 1: 12bwb3 folded on the Turn
Seat 2: greenthum33 folded before Flop (didn't bet)
Seat 4: ungiwar (button) folded before Flop (didn't bet)
Seat 5: xiled90 (small blind) folded before Flop
Seat 6: Acedan1369 (big blind) collected ($0.43)



PokerStars Hand #222964819474:  Hold'em No Limit ($0.05/$0.10 USD) - 2021/01/23 13:52:25 ET
Table 'Capricorn III' 6-max Seat #5 is the button
Seat 1: 12bwb3 ($4.03 in chips) 
Seat 2: greenthum33 ($12.47 in chips) 
Seat 4: ungiwar ($4.03 in chips) 
Seat 5: xiled90 ($10 in chips) 
Seat 6: Acedan1369 ($11.58 in chips) 
Acedan1369: posts small blind $0.05
12bwb3: posts big blind $0.10
*** HOLE CARDS ***
greenthum33: folds 
ungiwar: folds 
xiled90: raises $0.15 to $0.25
Acedan1369: folds 
12bwb3: calls $0.15
*** FLOP *** [2h 8c 8d]
12bwb3: checks 
xiled90: checks 
*** TURN *** [2h 8c 8d] [4d]
12bwb3: checks 
xiled90: checks 
*** RIVER *** [2h 8c 8d 4d] [Th]
12bwb3: checks 
xiled90: checks 
*** SHOW DOWN ***
12bwb3: shows [Ad Qs] (a pair of Eights)
xiled90: mucks hand 
12bwb3 collected $0.53 from pot
*** SUMMARY ***
Total pot $0.55 | Rake $0.02 
Board [2h 8c 8d 4d Th]
Seat 1: 12bwb3 (big blind) showed [Ad Qs] and won ($0.53) with a pair of Eights
Seat 2: greenthum33 folded before Flop (didn't bet)
Seat 4: ungiwar folded before Flop (didn't bet)
Seat 5: xiled90 (button) mucked
Seat 6: Acedan1369 (small blind) folded before Flop



PokerStars Hand #222964840393:  Hold'em No Limit ($0.05/$0.10 USD) - 2021/01/23 13:52:53 ET
Table 'Capricorn III' 6-max Seat #6 is the button
Seat 1: 12bwb3 ($4.31 in chips) 
Seat 2: greenthum33 ($12.47 in chips) 
Seat 4: ungiwar ($4.03 in chips) 
Seat 5: xiled90 ($10 in chips) 
Seat 6: Acedan1369 ($11.53 in chips) 
12bwb3: posts small blind $0.05
greenthum33: posts big blind $0.10
*** HOLE CARDS ***
ungiwar: raises $0.10 to $0.20
xiled90: folds 
Acedan1369: folds 
12bwb3: calls $0.15
greenthum33: raises $0.20 to $0.40
ungiwar: calls $0.20
12bwb3: calls $0.20
*** FLOP *** [6s 5h Jh]
12bwb3: checks 
greenthum33: bets $0.58
ungiwar: folds 
12bwb3: folds 
Uncalled bet ($0.58) returned to greenthum33
greenthum33 collected $1.15 from pot
greenthum33: doesn't show hand 
*** SUMMARY ***
Total pot $1.20 | Rake $0.05 
Board [6s 5h Jh]
Seat 1: 12bwb3 (small blind) folded on the Flop
Seat 2: greenthum33 (big blind) collected ($1.15)
Seat 4: ungiwar folded on the Flop
Seat 5: xiled90 folded before Flop (didn't bet)
Seat 6: Acedan1369 (button) folded before Flop (didn't bet)



PokerStars Hand #222964872823:  Hold'em No Limit ($0.05/$0.10 USD) - 2021/01/23 13:53:36 ET
Table 'Capricorn III' 6-max Seat #1 is the button
Seat 1: 12bwb3 ($3.91 in chips) 
Seat 2: greenthum33 ($13.22 in chips) 
Seat 4: ungiwar ($3.63 in chips) 
Seat 5: xiled90 ($10 in chips) 
Seat 6: Acedan1369 ($11.53 in chips) 
greenthum33: posts small blind $0.05
ungiwar: posts big blind $0.10
*** HOLE CARDS ***
xiled90: folds 
Acedan1369: folds 
12bwb3: folds 
greenthum33: calls $0.05
ungiwar: raises $0.25 to $0.35
greenthum33: raises $0.25 to $0.60
ungiwar: calls $0.25
*** FLOP *** [Qc 7s Tc]
greenthum33: bets $0.60
ungiwar: raises $2.43 to $3.03 and is all-in
greenthum33: calls $2.43
*** TURN *** [Qc 7s Tc] [3h]
*** RIVER *** [Qc 7s Tc 3h] [Qh]
*** SHOW DOWN ***
greenthum33: shows [Kh As] (a pair of Queens)
ungiwar: shows [Qs Js] (three of a kind, Queens)
ungiwar collected $6.93 from pot
greenthum33 cashed out the hand for $2.16 | Cash Out Fee $0.02
*** SUMMARY ***
Total pot $7.26 | Rake $0.33 
Board [Qc 7s Tc 3h Qh]
Seat 1: 12bwb3 (button) folded before Flop (didn't bet)
Seat 2: greenthum33 (small blind) showed [Kh As] and lost with a pair of Queens (cashed out).
Seat 4: ungiwar (big blind) showed [Qs Js] and won ($6.93) with three of a kind, Queens
Seat 5: xiled90 folded before Flop (didn't bet)
Seat 6: Acedan1369 folded before Flop (didn't bet)



PokerStars Hand #222964922965:  Hold'em No Limit ($0.05/$0.10 USD) - 2021/01/23 13:54:42 ET
Table 'Capricorn III' 6-max Seat #2 is the button
Seat 1: 12bwb3 ($3.91 in chips) 
Seat 2: greenthum33 ($11.75 in chips) 
Seat 4: ungiwar ($6.93 in chips) 
Seat 5: xiled90 ($10 in chips) 
Seat 6: Acedan1369 ($11.53 in chips) 
ungiwar: posts small blind $0.05
xiled90: posts big blind $0.10
*** HOLE CARDS ***
Acedan1369: folds 
12bwb3: folds 
greenthum33: folds 
ungiwar: raises $0.18 to $0.28
xiled90: calls $0.18
*** FLOP *** [8d 9d 7d]
ungiwar: bets $0.18
xiled90: folds 
Uncalled bet ($0.18) returned to ungiwar
ungiwar collected $0.53 from pot
ungiwar: doesn't show hand 
*** SUMMARY ***
Total pot $0.56 | Rake $0.03 
Board [8d 9d 7d]
Seat 1: 12bwb3 folded before Flop (didn't bet)
Seat 2: greenthum33 (button) folded before Flop (didn't bet)
Seat 4: ungiwar (small blind) collected ($0.53)
Seat 5: xiled90 (big blind) folded on the Flop
Seat 6: Acedan1369 folded before Flop (didn't bet)



PokerStars Hand #222964947987:  Hold'em No Limit ($0.05/$0.10 USD) - 2021/01/23 13:55:19 ET
Table 'Capricorn III' 6-max Seat #4 is the button
Seat 1: 12bwb3 ($3.91 in chips) 
Seat 2: greenthum33 ($11.75 in chips) 
Seat 4: ungiwar ($7.18 in chips) 
Seat 5: xiled90 ($10 in chips) 
Seat 6: Acedan1369 ($11.53 in chips) 
xiled90: posts small blind $0.05
Acedan1369: posts big blind $0.10
*** HOLE CARDS ***
12bwb3: raises $0.10 to $0.20
greenthum33: folds 
ungiwar: folds 
xiled90: folds 
Acedan1369: folds 
Uncalled bet ($0.10) returned to 12bwb3
12bwb3 collected $0.25 from pot
12bwb3: doesn't show hand 
*** SUMMARY ***
Total pot $0.25 | Rake $0 
Seat 1: 12bwb3 collected ($0.25)
Seat 2: greenthum33 folded before Flop (didn't bet)
Seat 4: ungiwar (button) folded before Flop (didn't bet)
Seat 5: xiled90 (small blind) folded before Flop
Seat 6: Acedan1369 (big blind) folded before Flop



PokerStars Hand #222964958654:  Hold'em No Limit ($0.05/$0.10 USD) - 2021/01/23 13:55:41 ET
Table 'Capricorn III' 6-max Seat #5 is the button
Seat 1: 12bwb3 ($4.06 in chips) 
Seat 2: greenthum33 ($11.75 in chips) 
Seat 4: ungiwar ($7.18 in chips) 
Seat 5: xiled90 ($10 in chips) 
Seat 6: Acedan1369 ($11.43 in chips) 
Acedan1369: posts small blind $0.05
12bwb3: posts big blind $0.10
*** HOLE CARDS ***
greenthum33: raises $0.10 to $0.20
ungiwar: folds 
xiled90: folds 
Acedan1369: folds 
12bwb3: calls $0.10
*** FLOP *** [5d 3d Ac]
12bwb3: checks 
greenthum33: checks 
*** TURN *** [5d 3d Ac] [Js]
12bwb3: checks 
greenthum33: checks 
*** RIVER *** [5d 3d Ac Js] [Qc]
12bwb3: checks 
greenthum33: bets $0.43
12bwb3: folds 
Uncalled bet ($0.43) returned to greenthum33
greenthum33 collected $0.43 from pot
greenthum33: doesn't show hand 
*** SUMMARY ***
Total pot $0.45 | Rake $0.02 
Board [5d 3d Ac Js Qc]
Seat 1: 12bwb3 (big blind) folded on the River
Seat 2: greenthum33 collected ($0.43)
Seat 4: ungiwar folded before Flop (didn't bet)
Seat 5: xiled90 (button) folded before Flop (didn't bet)
Seat 6: Acedan1369 (small blind) folded before Flop



PokerStars Hand #222964975140:  Hold'em No Limit ($0.05/$0.10 USD) - 2021/01/23 13:56:15 ET
Table 'Capricorn III' 6-max Seat #6 is the button
Seat 1: 12bwb3 ($3.86 in chips) 
Seat 2: greenthum33 ($11.98 in chips) 
Seat 4: ungiwar ($7.18 in chips) 
Seat 5: xiled90 ($10 in chips) 
Seat 6: Acedan1369 ($11.38 in chips) 
12bwb3: posts small blind $0.05
greenthum33: posts big blind $0.10
*** HOLE CARDS ***
ungiwar: raises $0.10 to $0.20
xiled90: folds 
Acedan1369: folds 
12bwb3: calls $0.15
greenthum33: folds 
*** FLOP *** [8c Ad Kc]
12bwb3: checks 
ungiwar: bets $0.16
12bwb3: calls $0.16
*** TURN *** [8c Ad Kc] [8h]
12bwb3: checks 
ungiwar: bets $0.27
12bwb3: calls $0.27
*** RIVER *** [8c Ad Kc 8h] [Td]
12bwb3: bets $0.30
ungiwar: calls $0.30
*** SHOW DOWN ***
12bwb3: shows [As 8d] (a full house, Eights full of Aces)
ungiwar: mucks hand 
12bwb3 collected $1.87 from pot
*** SUMMARY ***
Total pot $1.96 | Rake $0.09 
Board [8c Ad Kc 8h Td]
Seat 1: 12bwb3 (small blind) showed [As 8d] and won ($1.87) with a full house, Eights full of Aces
Seat 2: greenthum33 (big blind) folded before Flop
Seat 4: ungiwar mucked
Seat 5: xiled90 folded before Flop (didn't bet)
Seat 6: Acedan1369 (button) folded before Flop (didn't bet)



PokerStars Hand #222965007701:  Hold'em No Limit ($0.05/$0.10 USD) - 2021/01/23 13:57:23 ET
Table 'Capricorn III' 6-max Seat #1 is the button
Seat 1: 12bwb3 ($4.80 in chips) 
Seat 2: greenthum33 ($11.88 in chips) 
Seat 4: ungiwar ($6.25 in chips) 
Seat 5: xiled90 ($10 in chips) 
Seat 6: Acedan1369 ($11.38 in chips) 
greenthum33: posts small blind $0.05
ungiwar: posts big blind $0.10
*** HOLE CARDS ***
xiled90: folds 
Acedan1369: folds 
12bwb3: folds 
greenthum33: raises $0.20 to $0.30
ungiwar: folds 
Uncalled bet ($0.20) returned to greenthum33
greenthum33 collected $0.20 from pot
9IHyKoBi4 was removed from the table for failing to post
9IHyKoBi4 leaves the table
greenthum33: doesn't show hand 
*** SUMMARY ***
Total pot $0.20 | Rake $0 
Seat 1: 12bwb3 (button) folded before Flop (didn't bet)
Seat 2: greenthum33 (small blind) collected ($0.20)
Seat 4: ungiwar (big blind) folded before Flop
Seat 5: xiled90 folded before Flop (didn't bet)
Seat 6: Acedan1369 folded before Flop (didn't bet)



PokerStars Hand #222965013558:  Hold'em No Limit ($0.05/$0.10 USD) - 2021/01/23 13:57:35 ET
Table 'Capricorn III' 6-max Seat #2 is the button
Seat 1: 12bwb3 ($4.80 in chips) 
Seat 2: greenthum33 ($11.98 in chips) 
Seat 4: ungiwar ($6.15 in chips) 
Seat 5: xiled90 ($10 in chips) 
Seat 6: Acedan1369 ($11.38 in chips) 
ungiwar: posts small blind $0.05
xiled90: posts big blind $0.10
*** HOLE CARDS ***
Acedan1369: folds 
12bwb3: folds 
greenthum33: folds 
ungiwar: folds 
Uncalled bet ($0.05) returned to xiled90
xiled90 collected $0.10 from pot
xiled90: doesn't show hand 
*** SUMMARY ***
Total pot $0.10 | Rake $0 
Seat 1: 12bwb3 folded before Flop (didn't bet)
Seat 2: greenthum33 (button) folded before Flop (didn't bet)
Seat 4: ungiwar (small blind) folded before Flop
Seat 5: xiled90 (big blind) collected ($0.10)
Seat 6: Acedan1369 folded before Flop (didn't bet)



PokerStars Hand #222965018350:  Hold'em No Limit ($0.05/$0.10 USD) - 2021/01/23 13:57:44 ET
Table 'Capricorn III' 6-max Seat #4 is the button
Seat 1: 12bwb3 ($4.80 in chips) 
Seat 2: greenthum33 ($11.98 in chips) 
Seat 4: ungiwar ($6.10 in chips) 
Seat 5: xiled90 ($10.05 in chips) 
Seat 6: Acedan1369 ($11.38 in chips) 
xiled90: posts small blind $0.05
CvB85 joins the table at seat #3 
Acedan1369: posts big blind $0.10
*** HOLE CARDS ***
12bwb3: folds 
greenthum33: folds 
ungiwar: folds 
xiled90: folds 
Uncalled bet ($0.05) returned to Acedan1369
Acedan1369 collected $0.10 from pot
Acedan1369: doesn't show hand 
*** SUMMARY ***
Total pot $0.10 | Rake $0 
Seat 1: 12bwb3 folded before Flop (didn't bet)
Seat 2: greenthum33 folded before Flop (didn't bet)
Seat 4: ungiwar (button) folded before Flop (didn't bet)
Seat 5: xiled90 (small blind) folded before Flop
Seat 6: Acedan1369 (big blind) collected ($0.10)



PokerStars Hand #222965022843:  Hold'em No Limit ($0.05/$0.10 USD) - 2021/01/23 13:57:53 ET
Table 'Capricorn III' 6-max Seat #5 is the button
Seat 1: 12bwb3 ($4.80 in chips) 
Seat 2: greenthum33 ($11.98 in chips) 
Seat 4: ungiwar ($6.10 in chips) 
Seat 5: xiled90 ($10 in chips) 
Seat 6: Acedan1369 ($11.43 in chips) 
Acedan1369: posts small blind $0.05
12bwb3: posts big blind $0.10
CvB85: sits out 
*** HOLE CARDS ***
greenthum33: folds 
ungiwar: folds 
xiled90: raises $0.15 to $0.25
Acedan1369: raises $0.60 to $0.85
12bwb3: folds 
xiled90: folds 
Uncalled bet ($0.60) returned to Acedan1369
Acedan1369 collected $0.60 from pot
Acedan1369: doesn't show hand 
*** SUMMARY ***
Total pot $0.60 | Rake $0 
Seat 1: 12bwb3 (big blind) folded before Flop
Seat 2: greenthum33 folded before Flop (didn't bet)
Seat 4: ungiwar folded before Flop (didn't bet)
Seat 5: xiled90 (button) folded before Flop
Seat 6: Acedan1369 (small blind) collected ($0.60)



PokerStars Hand #222965032017:  Hold'em No Limit ($0.05/$0.10 USD) - 2021/01/23 13:58:12 ET
Table 'Capricorn III' 6-max Seat #6 is the button
Seat 1: 12bwb3 ($4.70 in chips) 
Seat 2: greenthum33 ($11.98 in chips) 
Seat 4: ungiwar ($6.10 in chips) 
Seat 5: xiled90 ($10 in chips) 
Seat 6: Acedan1369 ($11.78 in chips) 
12bwb3: posts small blind $0.05
greenthum33: posts big blind $0.10
CvB85: sits out 
*** HOLE CARDS ***
ungiwar: folds 
xiled90: folds 
Acedan1369: folds 
12bwb3: folds 
Uncalled bet ($0.05) returned to greenthum33
greenthum33 collected $0.10 from pot
greenthum33: doesn't show hand 
*** SUMMARY ***
Total pot $0.10 | Rake $0 
Seat 1: 12bwb3 (small blind) folded before Flop
Seat 2: greenthum33 (big blind) collected ($0.10)
Seat 4: ungiwar folded before Flop (didn't bet)
Seat 5: xiled90 folded before Flop (didn't bet)
Seat 6: Acedan1369 (button) folded before Flop (didn't bet)



PokerStars Hand #222965036010:  Hold'em No Limit ($0.05/$0.10 USD) - 2021/01/23 13:58:20 ET
Table 'Capricorn III' 6-max Seat #1 is the button
Seat 1: 12bwb3 ($4.65 in chips) 
Seat 2: greenthum33 ($12.03 in chips) 
Seat 3: CvB85 ($10 in chips) 
Seat 4: ungiwar ($6.10 in chips) 
Seat 5: xiled90 ($10 in chips) 
Seat 6: Acedan1369 ($11.78 in chips) 
greenthum33: posts small blind $0.05
CvB85: posts big blind $0.10
*** HOLE CARDS ***
ungiwar: folds 
xiled90: folds 
Acedan1369: raises $0.15 to $0.25
12bwb3: folds 
greenthum33: folds 
CvB85: calls $0.15
*** FLOP *** [6s Qh 2c]
CvB85: checks 
Acedan1369: checks 
*** TURN *** [6s Qh 2c] [Kc]
CvB85: checks 
Acedan1369: checks 
*** RIVER *** [6s Qh 2c Kc] [Ks]
CvB85: bets $0.27
Acedan1369: folds 
Uncalled bet ($0.27) returned to CvB85
CvB85 collected $0.53 from pot
CvB85: doesn't show hand 
*** SUMMARY ***
Total pot $0.55 | Rake $0.02 
Board [6s Qh 2c Kc Ks]
Seat 1: 12bwb3 (button) folded before Flop (didn't bet)
Seat 2: greenthum33 (small blind) folded before Flop
Seat 3: CvB85 (big blind) collected ($0.53)
Seat 4: ungiwar folded before Flop (didn't bet)
Seat 5: xiled90 folded before Flop (didn't bet)
Seat 6: Acedan1369 folded on the River



PokerStars Hand #222965057848:  Hold'em No Limit ($0.05/$0.10 USD) - 2021/01/23 13:59:05 ET
Table 'Capricorn III' 6-max Seat #2 is the button
Seat 1: 12bwb3 ($4.65 in chips) 
Seat 2: greenthum33 ($11.98 in chips) 
Seat 3: CvB85 ($10.28 in chips) 
Seat 4: ungiwar ($6.10 in chips) 
Seat 5: xiled90 ($10 in chips) 
Seat 6: Acedan1369 ($11.53 in chips) 
CvB85: posts small blind $0.05
ungiwar: posts big blind $0.10
*** HOLE CARDS ***
xiled90: folds 
Acedan1369: folds 
12bwb3: folds 
greenthum33: folds 
CvB85: raises $0.20 to $0.30
ungiwar: folds 
Uncalled bet ($0.20) returned to CvB85
CvB85 collected $0.20 from pot
CvB85: doesn't show hand 
*** SUMMARY ***
Total pot $0.20 | Rake $0 
Seat 1: 12bwb3 folded before Flop (didn't bet)
Seat 2: greenthum33 (button) folded before Flop (didn't bet)
Seat 3: CvB85 (small blind) collected ($0.20)
Seat 4: ungiwar (big blind) folded before Flop
Seat 5: xiled90 folded before Flop (didn't bet)
Seat 6: Acedan1369 folded before Flop (didn't bet)



PokerStars Hand #222965066030:  Hold'em No Limit ($0.05/$0.10 USD) - 2021/01/23 13:59:22 ET
Table 'Capricorn III' 6-max Seat #3 is the button
Seat 1: 12bwb3 ($4.65 in chips) 
Seat 2: greenthum33 ($11.98 in chips) 
Seat 3: CvB85 ($10.38 in chips) 
Seat 4: ungiwar ($6 in chips) 
Seat 6: Acedan1369 ($11.53 in chips) 
ungiwar: posts small blind $0.05
xiled90: is sitting out 
Acedan1369: posts big blind $0.10
*** HOLE CARDS ***
12bwb3: raises $0.10 to $0.20
greenthum33: folds 
CvB85: calls $0.20
ungiwar: folds 
Acedan1369: folds 
*** FLOP *** [5s As 6c]
12bwb3: checks 
CvB85: bets $0.30
12bwb3: folds 
Uncalled bet ($0.30) returned to CvB85
CvB85 collected $0.53 from pot
CvB85: doesn't show hand 
*** SUMMARY ***
Total pot $0.55 | Rake $0.02 
Board [5s As 6c]
Seat 1: 12bwb3 folded on the Flop
Seat 2: greenthum33 folded before Flop (didn't bet)
Seat 3: CvB85 (button) collected ($0.53)
Seat 4: ungiwar (small blind) folded before Flop
Seat 6: Acedan1369 (big blind) folded before Flop



PokerStars Hand #222965078373:  Hold'em No Limit ($0.05/$0.10 USD) - 2021/01/23 13:59:47 ET
Table 'Capricorn III' 6-max Seat #4 is the button
Seat 1: 12bwb3 ($4.45 in chips) 
Seat 2: greenthum33 ($11.98 in chips) 
Seat 3: CvB85 ($10.71 in chips) 
Seat 4: ungiwar ($5.95 in chips) 
Seat 6: Acedan1369 ($11.43 in chips) 
Acedan1369: posts small blind $0.05
12bwb3: posts big blind $0.10
*** HOLE CARDS ***
greenthum33: folds 
CvB85: raises $0.20 to $0.30
ungiwar: raises $0.55 to $0.85
Acedan1369: folds 
12bwb3: folds 
CvB85: calls $0.55
*** FLOP *** [7s 3h 5c]
CvB85: checks 
ungiwar: checks 
*** TURN *** [7s 3h 5c] [Ts]
CvB85: bets $0.89
ungiwar: folds 
Uncalled bet ($0.89) returned to CvB85
CvB85 collected $1.77 from pot
CvB85: doesn't show hand 
*** SUMMARY ***
Total pot $1.85 | Rake $0.08 
Board [7s 3h 5c Ts]
Seat 1: 12bwb3 (big blind) folded before Flop
Seat 2: greenthum33 folded before Flop (didn't bet)
Seat 3: CvB85 collected ($1.77)
Seat 4: ungiwar (button) folded on the Turn
Seat 6: Acedan1369 (small blind) folded before Flop



PokerStars Hand #222965110879:  Hold'em No Limit ($0.05/$0.10 USD) - 2021/01/23 14:00:47 ET
Table 'Capricorn III' 6-max Seat #6 is the button
Seat 1: 12bwb3 ($4.35 in chips) 
Seat 2: greenthum33 ($11.98 in chips) 
Seat 3: CvB85 ($11.63 in chips) 
Seat 4: ungiwar ($5.10 in chips) 
Seat 6: Acedan1369 ($11.38 in chips) 
12bwb3: posts small blind $0.05
greenthum33: posts big blind $0.10
*** HOLE CARDS ***
CvB85: folds 
ungiwar: folds 
Acedan1369: folds 
12bwb3: raises $0.10 to $0.20
xiled90 leaves the table
greenthum33: folds 
Uncalled bet ($0.10) returned to 12bwb3
12bwb3 collected $0.20 from pot
12bwb3: doesn't show hand 
*** SUMMARY ***
Total pot $0.20 | Rake $0 
Seat 1: 12bwb3 (small blind) collected ($0.20)
Seat 2: greenthum33 (big blind) folded before Flop
Seat 3: CvB85 folded before Flop (didn't bet)
Seat 4: ungiwar folded before Flop (didn't bet)
Seat 6: Acedan1369 (button) folded before Flop (didn't bet)



PokerStars Hand #222965119895:  Hold'em No Limit ($0.05/$0.10 USD) - 2021/01/23 14:01:03 ET
Table 'Capricorn III' 6-max Seat #1 is the button
Seat 1: 12bwb3 ($4.45 in chips) 
Seat 2: greenthum33 ($11.88 in chips) 
Seat 3: CvB85 ($11.63 in chips) 
Seat 4: ungiwar ($5.10 in chips) 
Seat 6: Acedan1369 ($11.38 in chips) 
greenthum33: posts small blind $0.05
CvB85: posts big blind $0.10
*** HOLE CARDS ***
ungiwar: folds 
Acedan1369: raises $0.15 to $0.25
12bwb3: folds 
Mr.G pat joins the table at seat #5 
greenthum33: folds 
CvB85: folds 
Uncalled bet ($0.15) returned to Acedan1369
Acedan1369 collected $0.25 from pot
Acedan1369: doesn't show hand 
*** SUMMARY ***
Total pot $0.25 | Rake $0 
Seat 1: 12bwb3 (button) folded before Flop (didn't bet)
Seat 2: greenthum33 (small blind) folded before Flop
Seat 3: CvB85 (big blind) folded before Flop
Seat 4: ungiwar folded before Flop (didn't bet)
Seat 6: Acedan1369 collected ($0.25)



PokerStars Hand #222965127828:  Hold'em No Limit ($0.05/$0.10 USD) - 2021/01/23 14:01:16 ET
Table 'Capricorn III' 6-max Seat #2 is the button
Seat 1: 12bwb3 ($4.45 in chips) 
Seat 2: greenthum33 ($11.83 in chips) 
Seat 3: CvB85 ($11.53 in chips) 
Seat 4: ungiwar ($5.10 in chips) 
Seat 6: Acedan1369 ($11.53 in chips) 
CvB85: posts small blind $0.05
ungiwar: posts big blind $0.10
Mr.G pat: sits out 
*** HOLE CARDS ***
Acedan1369: folds 
12bwb3: raises $0.10 to $0.20
greenthum33: raises $0.20 to $0.40
CvB85: folds 
ungiwar: folds 
12bwb3: calls $0.20
*** FLOP *** [8h Kh 7c]
12bwb3: checks 
greenthum33: bets $0.80
12bwb3: folds 
Uncalled bet ($0.80) returned to greenthum33
greenthum33 collected $0.91 from pot
greenthum33: doesn't show hand 
*** SUMMARY ***
Total pot $0.95 | Rake $0.04 
Board [8h Kh 7c]
Seat 1: 12bwb3 folded on the Flop
Seat 2: greenthum33 (button) collected ($0.91)
Seat 3: CvB85 (small blind) folded before Flop
Seat 4: ungiwar (big blind) folded before Flop
Seat 6: Acedan1369 folded before Flop (didn't bet)



PokerStars Hand #222965147912:  Hold'em No Limit ($0.05/$0.10 USD) - 2021/01/23 14:01:44 ET
Table 'Capricorn III' 6-max Seat #3 is the button
Seat 1: 12bwb3 ($4.05 in chips) 
Seat 2: greenthum33 ($12.34 in chips) 
Seat 3: CvB85 ($11.48 in chips) 
Seat 4: ungiwar ($5 in chips) 
Seat 5: Mr.G pat ($8 in chips) 
Seat 6: Acedan1369 ($11.53 in chips) 
ungiwar: posts small blind $0.05
Mr.G pat: posts big blind $0.10
*** HOLE CARDS ***
Acedan1369: folds 
12bwb3: raises $0.10 to $0.20
greenthum33: folds 
CvB85: folds 
ungiwar: folds 
Mr.G pat: calls $0.10
*** FLOP *** [Jd 8c 7c]
Mr.G pat: checks 
12bwb3: checks 
*** TURN *** [Jd 8c 7c] [7d]
Mr.G pat: checks 
12bwb3: checks 
*** RIVER *** [Jd 8c 7c 7d] [6c]
Mr.G pat: bets $0.10
12bwb3: raises $0.32 to $0.42
Mr.G pat: calls $0.32
*** SHOW DOWN ***
12bwb3: shows [Jh 8h] (two pair, Jacks and Eights)
Mr.G pat: mucks hand 
12bwb3 collected $1.23 from pot
*** SUMMARY ***
Total pot $1.29 | Rake $0.06 
Board [Jd 8c 7c 7d 6c]
Seat 1: 12bwb3 showed [Jh 8h] and won ($1.23) with two pair, Jacks and Eights
Seat 2: greenthum33 folded before Flop (didn't bet)
Seat 3: CvB85 (button) folded before Flop (didn't bet)
Seat 4: ungiwar (small blind) folded before Flop
Seat 5: Mr.G pat (big blind) mucked
Seat 6: Acedan1369 folded before Flop (didn't bet)



PokerStars Hand #222965166525:  Hold'em No Limit ($0.05/$0.10 USD) - 2021/01/23 14:02:09 ET
Table 'Capricorn III' 6-max Seat #4 is the button
Seat 1: 12bwb3 ($4.66 in chips) 
Seat 2: greenthum33 ($12.34 in chips) 
Seat 3: CvB85 ($11.48 in chips) 
Seat 4: ungiwar ($4.95 in chips) 
Seat 5: Mr.G pat ($7.38 in chips) 
Seat 6: Acedan1369 ($11.53 in chips) 
Mr.G pat: posts small blind $0.05
Acedan1369: posts big blind $0.10
*** HOLE CARDS ***
12bwb3: folds 
greenthum33: folds 
CvB85: folds 
ungiwar: raises $0.10 to $0.20
Mr.G pat: calls $0.15
Acedan1369: folds 
*** FLOP *** [7c 5h Td]
Mr.G pat: checks 
ungiwar: bets $0.24
Mr.G pat: folds 
Uncalled bet ($0.24) returned to ungiwar
ungiwar collected $0.48 from pot
ungiwar: doesn't show hand 
*** SUMMARY ***
Total pot $0.50 | Rake $0.02 
Board [7c 5h Td]
Seat 1: 12bwb3 folded before Flop (didn't bet)
Seat 2: greenthum33 folded before Flop (didn't bet)
Seat 3: CvB85 folded before Flop (didn't bet)
Seat 4: ungiwar (button) collected ($0.48)
Seat 5: Mr.G pat (small blind) folded on the Flop
Seat 6: Acedan1369 (big blind) folded before Flop



PokerStars Hand #222965191717:  Hold'em No Limit ($0.05/$0.10 USD) - 2021/01/23 14:02:34 ET
Table 'Capricorn III' 6-max Seat #5 is the button
Seat 1: 12bwb3 ($4.66 in chips) 
Seat 2: greenthum33 ($12.34 in chips) 
Seat 3: CvB85 ($11.48 in chips) 
Seat 4: ungiwar ($5.23 in chips) 
Seat 5: Mr.G pat ($7.18 in chips) 
Seat 6: Acedan1369 ($11.43 in chips) 
Acedan1369: posts small blind $0.05
12bwb3: posts big blind $0.10
*** HOLE CARDS ***
greenthum33: folds 
CvB85: folds 
ungiwar: folds 
Mr.G pat: calls $0.10
Acedan1369: folds 
12bwb3: checks 
*** FLOP *** [Tc As 4d]
12bwb3: checks 
Mr.G pat: checks 
*** TURN *** [Tc As 4d] [2s]
12bwb3: checks 
Mr.G pat: checks 
*** RIVER *** [Tc As 4d 2s] [Jd]
12bwb3: checks 
Mr.G pat: checks 
*** SHOW DOWN ***
12bwb3: shows [8s 3s] (high card Ace)
Mr.G pat: shows [7s Ks] (high card Ace - King kicker)
Mr.G pat collected $0.24 from pot
*** SUMMARY ***
Total pot $0.25 | Rake $0.01 
Board [Tc As 4d 2s Jd]
Seat 1: 12bwb3 (big blind) showed [8s 3s] and lost with high card Ace
Seat 2: greenthum33 folded before Flop (didn't bet)
Seat 3: CvB85 folded before Flop (didn't bet)
Seat 4: ungiwar folded before Flop (didn't bet)
Seat 5: Mr.G pat (button) showed [7s Ks] and won ($0.24) with high card Ace
Seat 6: Acedan1369 (small blind) folded before Flop



PokerStars Hand #222965214001:  Hold'em No Limit ($0.05/$0.10 USD) - 2021/01/23 14:03:02 ET
Table 'Capricorn III' 6-max Seat #6 is the button
Seat 1: 12bwb3 ($4.56 in chips) 
Seat 2: greenthum33 ($12.34 in chips) 
Seat 3: CvB85 ($11.48 in chips) 
Seat 4: ungiwar ($5.23 in chips) 
Seat 5: Mr.G pat ($7.32 in chips) 
Seat 6: Acedan1369 ($11.38 in chips) 
12bwb3: posts small blind $0.05
greenthum33: posts big blind $0.10
*** HOLE CARDS ***
CvB85: folds 
ungiwar: raises $0.10 to $0.20
Mr.G pat: calls $0.20
Acedan1369: calls $0.20
12bwb3: folds 
greenthum33: folds 
*** FLOP *** [3d Js 7s]
ungiwar: checks 
Mr.G pat: checks 
Acedan1369: checks 
*** TURN *** [3d Js 7s] [5d]
ungiwar: checks 
Mr.G pat: bets $0.36
Acedan1369: raises $0.94 to $1.30
ungiwar: folds 
Mr.G pat: folds 
Uncalled bet ($0.94) returned to Acedan1369
Acedan1369 collected $1.40 from pot
Acedan1369: doesn't show hand 
*** SUMMARY ***
Total pot $1.47 | Rake $0.07 
Board [3d Js 7s 5d]
Seat 1: 12bwb3 (small blind) folded before Flop
Seat 2: greenthum33 (big blind) folded before Flop
Seat 3: CvB85 folded before Flop (didn't bet)
Seat 4: ungiwar folded on the Turn
Seat 5: Mr.G pat folded on the Turn
Seat 6: Acedan1369 (button) collected ($1.40)



PokerStars Hand #222965246056:  Hold'em No Limit ($0.05/$0.10 USD) - 2021/01/23 14:03:43 ET
Table 'Capricorn III' 6-max Seat #1 is the button
Seat 1: 12bwb3 ($4.51 in chips) 
Seat 2: greenthum33 ($12.24 in chips) 
Seat 3: CvB85 ($11.48 in chips) 
Seat 4: ungiwar ($5.03 in chips) 
Seat 5: Mr.G pat ($6.76 in chips) 
Seat 6: Acedan1369 ($12.22 in chips) 
greenthum33: posts small blind $0.05
CvB85: posts big blind $0.10
*** HOLE CARDS ***
ungiwar: folds 
Mr.G pat: folds 
Acedan1369: raises $0.15 to $0.25
12bwb3: folds 
greenthum33: folds 
CvB85: calls $0.15
*** FLOP *** [6s 7h 4s]
CvB85: checks 
Acedan1369: bets $0.40
CvB85: folds 
Uncalled bet ($0.40) returned to Acedan1369
Acedan1369 collected $0.53 from pot
Acedan1369: doesn't show hand 
*** SUMMARY ***
Total pot $0.55 | Rake $0.02 
Board [6s 7h 4s]
Seat 1: 12bwb3 (button) folded before Flop (didn't bet)
Seat 2: greenthum33 (small blind) folded before Flop
Seat 3: CvB85 (big blind) folded on the Flop
Seat 4: ungiwar folded before Flop (didn't bet)
Seat 5: Mr.G pat folded before Flop (didn't bet)
Seat 6: Acedan1369 collected ($0.53)



PokerStars Hand #222965262953:  Hold'em No Limit ($0.05/$0.10 USD) - 2021/01/23 14:04:05 ET
Table 'Capricorn III' 6-max Seat #2 is the button
Seat 1: 12bwb3 ($4.51 in chips) 
Seat 2: greenthum33 ($12.19 in chips) 
Seat 3: CvB85 ($11.23 in chips) 
Seat 4: ungiwar ($5.03 in chips) 
Seat 5: Mr.G pat ($6.76 in chips) 
Seat 6: Acedan1369 ($12.50 in chips) 
CvB85: posts small blind $0.05
ungiwar: posts big blind $0.10
*** HOLE CARDS ***
Mr.G pat: calls $0.10
Acedan1369: folds 
12bwb3: folds 
greenthum33: calls $0.10
CvB85: calls $0.05
ungiwar: checks 
*** FLOP *** [Ks Kd 2c]
CvB85: checks 
ungiwar: checks 
Mr.G pat: bets $0.10
greenthum33: calls $0.10
CvB85: folds 
ungiwar: folds 
*** TURN *** [Ks Kd 2c] [9h]
Mr.G pat: checks 
greenthum33: checks 
*** RIVER *** [Ks Kd 2c 9h] [Qh]
Mr.G pat: bets $0.10
greenthum33: calls $0.10
*** SHOW DOWN ***
Mr.G pat: shows [8s Kc] (three of a kind, Kings)
greenthum33: mucks hand 
Mr.G pat collected $0.76 from pot
*** SUMMARY ***
Total pot $0.80 | Rake $0.04 
Board [Ks Kd 2c 9h Qh]
Seat 1: 12bwb3 folded before Flop (didn't bet)
Seat 2: greenthum33 (button) mucked
Seat 3: CvB85 (small blind) folded on the Flop
Seat 4: ungiwar (big blind) folded on the Flop
Seat 5: Mr.G pat showed [8s Kc] and won ($0.76) with three of a kind, Kings
Seat 6: Acedan1369 folded before Flop (didn't bet)



PokerStars Hand #222965296914:  Hold'em No Limit ($0.05/$0.10 USD) - 2021/01/23 14:04:48 ET
Table 'Capricorn III' 6-max Seat #3 is the button
Seat 1: 12bwb3 ($4.51 in chips) 
Seat 2: greenthum33 ($11.89 in chips) 
Seat 3: CvB85 ($11.13 in chips) 
Seat 4: ungiwar ($4.93 in chips) 
Seat 5: Mr.G pat ($7.22 in chips) 
Seat 6: Acedan1369 ($12.50 in chips) 
ungiwar: posts small blind $0.05
Mr.G pat: posts big blind $0.10
*** HOLE CARDS ***
Acedan1369: folds 
12bwb3: folds 
greenthum33: raises $0.20 to $0.30
CvB85: folds 
ungiwar: folds 
Mr.G pat: folds 
Uncalled bet ($0.20) returned to greenthum33
greenthum33 collected $0.25 from pot
greenthum33: doesn't show hand 
*** SUMMARY ***
Total pot $0.25 | Rake $0 
Seat 1: 12bwb3 folded before Flop (didn't bet)
Seat 2: greenthum33 collected ($0.25)
Seat 3: CvB85 (button) folded before Flop (didn't bet)
Seat 4: ungiwar (small blind) folded before Flop
Seat 5: Mr.G pat (big blind) folded before Flop
Seat 6: Acedan1369 folded before Flop (didn't bet)



PokerStars Hand #222965306921:  Hold'em No Limit ($0.05/$0.10 USD) - 2021/01/23 14:05:01 ET
Table 'Capricorn III' 6-max Seat #4 is the button
Seat 1: 12bwb3 ($4.51 in chips) 
Seat 2: greenthum33 ($12.04 in chips) 
Seat 3: CvB85 ($11.13 in chips) 
Seat 4: ungiwar ($4.88 in chips) 
Seat 5: Mr.G pat ($7.12 in chips) 
Seat 6: Acedan1369 ($12.50 in chips) 
Mr.G pat: posts small blind $0.05
Acedan1369: posts big blind $0.10
*** HOLE CARDS ***
12bwb3: folds 
greenthum33: folds 
CvB85: folds 
ungiwar: folds 
Mr.G pat: calls $0.05
Acedan1369: checks 
*** FLOP *** [Tc Kh 6s]
Mr.G pat: checks 
Acedan1369: checks 
*** TURN *** [Tc Kh 6s] [Ad]
Mr.G pat: checks 
Acedan1369: checks 
*** RIVER *** [Tc Kh 6s Ad] [9s]
Mr.G pat: checks 
Acedan1369: checks 
*** SHOW DOWN ***
Mr.G pat: shows [7c Jh] (high card Ace)
Acedan1369: shows [4c 9d] (a pair of Nines)
Acedan1369 collected $0.19 from pot
*** SUMMARY ***
Total pot $0.20 | Rake $0.01 
Board [Tc Kh 6s Ad 9s]
Seat 1: 12bwb3 folded before Flop (didn't bet)
Seat 2: greenthum33 folded before Flop (didn't bet)
Seat 3: CvB85 folded before Flop (didn't bet)
Seat 4: ungiwar (button) folded before Flop (didn't bet)
Seat 5: Mr.G pat (small blind) showed [7c Jh] and lost with high card Ace
Seat 6: Acedan1369 (big blind) showed [4c 9d] and won ($0.19) with a pair of Nines



PokerStars Hand #222965354745:  Hold'em No Limit ($0.05/$0.10 USD) - 2021/01/23 14:06:01 ET
Table 'Capricorn III' 6-max Seat #5 is the button
Seat 1: 12bwb3 ($4.51 in chips) 
Seat 2: greenthum33 ($12.04 in chips) 
Seat 3: CvB85 ($11.13 in chips) 
Seat 4: ungiwar ($4.88 in chips) 
Seat 5: Mr.G pat ($7.02 in chips) 
Seat 6: Acedan1369 ($12.59 in chips) 
Acedan1369: posts small blind $0.05
12bwb3: posts big blind $0.10
*** HOLE CARDS ***
greenthum33: raises $0.20 to $0.30
CvB85: folds 
ungiwar: folds 
Mr.G pat: calls $0.30
Acedan1369: folds 
12bwb3: calls $0.20
*** FLOP *** [Jd 3s Ts]
12bwb3: checks 
greenthum33: bets $0.30
Mr.G pat: calls $0.30
12bwb3: folds 
*** TURN *** [Jd 3s Ts] [2d]
greenthum33: checks 
Mr.G pat: checks 
*** RIVER *** [Jd 3s Ts 2d] [Jc]
greenthum33: checks 
Mr.G pat: checks 
*** SHOW DOWN ***
greenthum33: shows [4c Ac] (a pair of Jacks)
Mr.G pat: shows [8s 8d] (two pair, Jacks and Eights)
Mr.G pat collected $1.48 from pot
*** SUMMARY ***
Total pot $1.55 | Rake $0.07 
Board [Jd 3s Ts 2d Jc]
Seat 1: 12bwb3 (big blind) folded on the Flop
Seat 2: greenthum33 showed [4c Ac] and lost with a pair of Jacks
Seat 3: CvB85 folded before Flop (didn't bet)
Seat 4: ungiwar folded before Flop (didn't bet)
Seat 5: Mr.G pat (button) showed [8s 8d] and won ($1.48) with two pair, Jacks and Eights
Seat 6: Acedan1369 (small blind) folded before Flop



PokerStars Hand #222965390033:  Hold'em No Limit ($0.05/$0.10 USD) - 2021/01/23 14:06:46 ET
Table 'Capricorn III' 6-max Seat #6 is the button
Seat 1: 12bwb3 ($4.21 in chips) 
Seat 2: greenthum33 ($11.44 in chips) 
Seat 3: CvB85 ($11.13 in chips) 
Seat 4: ungiwar ($4.88 in chips) 
Seat 5: Mr.G pat ($7.90 in chips) 
Seat 6: Acedan1369 ($12.54 in chips) 
12bwb3: posts small blind $0.05
greenthum33: posts big blind $0.10
*** HOLE CARDS ***
CvB85: folds 
ungiwar: folds 
Mr.G pat: folds 
Acedan1369: folds 
12bwb3: folds 
Uncalled bet ($0.05) returned to greenthum33
greenthum33 collected $0.10 from pot
greenthum33: doesn't show hand 
*** SUMMARY ***
Total pot $0.10 | Rake $0 
Seat 1: 12bwb3 (small blind) folded before Flop
Seat 2: greenthum33 (big blind) collected ($0.10)
Seat 3: CvB85 folded before Flop (didn't bet)
Seat 4: ungiwar folded before Flop (didn't bet)
Seat 5: Mr.G pat folded before Flop (didn't bet)
Seat 6: Acedan1369 (button) folded before Flop (didn't bet)



PokerStars Hand #222965405066:  Hold'em No Limit ($0.05/$0.10 USD) - 2021/01/23 14:07:05 ET
Table 'Capricorn III' 6-max Seat #1 is the button
Seat 1: 12bwb3 ($4.16 in chips) 
Seat 2: greenthum33 ($11.49 in chips) 
Seat 3: CvB85 ($11.13 in chips) 
Seat 4: ungiwar ($4.88 in chips) 
Seat 5: Mr.G pat ($7.90 in chips) 
Seat 6: Acedan1369 ($12.54 in chips) 
greenthum33: posts small blind $0.05
CvB85: posts big blind $0.10
*** HOLE CARDS ***
ungiwar: folds 
Mr.G pat: folds 
Acedan1369: raises $0.15 to $0.25
12bwb3: folds 
greenthum33: folds 
CvB85: calls $0.15
*** FLOP *** [Js 9s 7s]
CvB85: checks 
Acedan1369: bets $0.40
CvB85: folds 
Uncalled bet ($0.40) returned to Acedan1369
Acedan1369 collected $0.53 from pot
Acedan1369: doesn't show hand 
*** SUMMARY ***
Total pot $0.55 | Rake $0.02 
Board [Js 9s 7s]
Seat 1: 12bwb3 (button) folded before Flop (didn't bet)
Seat 2: greenthum33 (small blind) folded before Flop
Seat 3: CvB85 (big blind) folded on the Flop
Seat 4: ungiwar folded before Flop (didn't bet)
Seat 5: Mr.G pat folded before Flop (didn't bet)
Seat 6: Acedan1369 collected ($0.53)



PokerStars Hand #222965429995:  Hold'em No Limit ($0.05/$0.10 USD) - 2021/01/23 14:07:36 ET
Table 'Capricorn III' 6-max Seat #2 is the button
Seat 1: 12bwb3 ($4.16 in chips) 
Seat 2: greenthum33 ($11.44 in chips) 
Seat 3: CvB85 ($10.88 in chips) 
Seat 4: ungiwar ($4.88 in chips) 
Seat 5: Mr.G pat ($7.90 in chips) 
Seat 6: Acedan1369 ($12.82 in chips) 
CvB85: posts small blind $0.05
ungiwar: posts big blind $0.10
*** HOLE CARDS ***
Mr.G pat: folds 
Acedan1369 has timed out
Acedan1369: folds 
12bwb3: folds 
greenthum33: calls $0.10
CvB85: calls $0.05
ungiwar: checks 
*** FLOP *** [8h 3h Qs]
CvB85: checks 
ungiwar: checks 
greenthum33: bets $0.30
CvB85: folds 
ungiwar: raises $1.05 to $1.35
greenthum33: folds 
Uncalled bet ($1.05) returned to ungiwar
ungiwar collected $0.86 from pot
ungiwar: doesn't show hand 
*** SUMMARY ***
Total pot $0.90 | Rake $0.04 
Board [8h 3h Qs]
Seat 1: 12bwb3 folded before Flop (didn't bet)
Seat 2: greenthum33 (button) folded on the Flop
Seat 3: CvB85 (small blind) folded on the Flop
Seat 4: ungiwar (big blind) collected ($0.86)
Seat 5: Mr.G pat folded before Flop (didn't bet)
Seat 6: Acedan1369 folded before Flop (didn't bet)



PokerStars Hand #222965466853:  Hold'em No Limit ($0.05/$0.10 USD) - 2021/01/23 14:08:23 ET
Table 'Capricorn III' 6-max Seat #3 is the button
Seat 1: 12bwb3 ($4.16 in chips) 
Seat 2: greenthum33 ($11.04 in chips) 
Seat 3: CvB85 ($10.78 in chips) 
Seat 4: ungiwar ($5.34 in chips) 
Seat 5: Mr.G pat ($7.90 in chips) 
Seat 6: Acedan1369 ($12.82 in chips) 
ungiwar: posts small blind $0.05
Mr.G pat: posts big blind $0.10
*** HOLE CARDS ***
Acedan1369: folds 
12bwb3: folds 
greenthum33: calls $0.10
CvB85: raises $0.35 to $0.45
ungiwar: folds 
Mr.G pat: calls $0.35
greenthum33: folds 
*** FLOP *** [2c Qc Ts]
Mr.G pat: checks 
CvB85: bets $0.60
Mr.G pat: folds 
Uncalled bet ($0.60) returned to CvB85
CvB85 collected $1 from pot
CvB85: doesn't show hand 
*** SUMMARY ***
Total pot $1.05 | Rake $0.05 
Board [2c Qc Ts]
Seat 1: 12bwb3 folded before Flop (didn't bet)
Seat 2: greenthum33 folded before Flop
Seat 3: CvB85 (button) collected ($1)
Seat 4: ungiwar (small blind) folded before Flop
Seat 5: Mr.G pat (big blind) folded on the Flop
Seat 6: Acedan1369 folded before Flop (didn't bet)



PokerStars Hand #222965492791:  Hold'em No Limit ($0.05/$0.10 USD) - 2021/01/23 14:08:55 ET
Table 'Capricorn III' 6-max Seat #4 is the button
Seat 1: 12bwb3 ($4.16 in chips) 
Seat 2: greenthum33 ($10.94 in chips) 
Seat 3: CvB85 ($11.33 in chips) 
Seat 4: ungiwar ($5.29 in chips) 
Seat 5: Mr.G pat ($7.45 in chips) 
Seat 6: Acedan1369 ($12.82 in chips) 
Mr.G pat: posts small blind $0.05
Acedan1369: posts big blind $0.10
*** HOLE CARDS ***
12bwb3: folds 
greenthum33: calls $0.10
CvB85: folds 
ungiwar: raises $0.20 to $0.30
Mr.G pat: folds 
Acedan1369: folds 
greenthum33: calls $0.20
*** FLOP *** [Qd 4s Ks]
greenthum33: checks 
ungiwar: checks 
*** TURN *** [Qd 4s Ks] [9c]
greenthum33: checks 
ungiwar: checks 
*** RIVER *** [Qd 4s Ks 9c] [6c]
greenthum33: checks 
ungiwar: bets $0.24
greenthum33: calls $0.24
*** SHOW DOWN ***
ungiwar: shows [Jc Qh] (a pair of Queens)
greenthum33: mucks hand 
ungiwar collected $1.17 from pot
*** SUMMARY ***
Total pot $1.23 | Rake $0.06 
Board [Qd 4s Ks 9c 6c]
Seat 1: 12bwb3 folded before Flop (didn't bet)
Seat 2: greenthum33 mucked
Seat 3: CvB85 folded before Flop (didn't bet)
Seat 4: ungiwar (button) showed [Jc Qh] and won ($1.17) with a pair of Queens
Seat 5: Mr.G pat (small blind) folded before Flop
Seat 6: Acedan1369 (big blind) folded before Flop



PokerStars Hand #222965525359:  Hold'em No Limit ($0.05/$0.10 USD) - 2021/01/23 14:09:36 ET
Table 'Capricorn III' 6-max Seat #5 is the button
Seat 1: 12bwb3 ($4.16 in chips) 
Seat 2: greenthum33 ($10.40 in chips) 
Seat 3: CvB85 ($11.33 in chips) 
Seat 4: ungiwar ($5.92 in chips) 
Seat 5: Mr.G pat ($7.40 in chips) 
Seat 6: Acedan1369 ($12.72 in chips) 
Acedan1369: posts small blind $0.05
12bwb3: posts big blind $0.10
*** HOLE CARDS ***
greenthum33: calls $0.10
CvB85: folds 
ungiwar: folds 
Mr.G pat: calls $0.10
Acedan1369: folds 
12bwb3: checks 
*** FLOP *** [Ac 2s 8c]
12bwb3: checks 
greenthum33: bets $0.33
Mr.G pat: folds 
12bwb3: folds 
Uncalled bet ($0.33) returned to greenthum33
greenthum33 collected $0.33 from pot
greenthum33: doesn't show hand 
*** SUMMARY ***
Total pot $0.35 | Rake $0.02 
Board [Ac 2s 8c]
Seat 1: 12bwb3 (big blind) folded on the Flop
Seat 2: greenthum33 collected ($0.33)
Seat 3: CvB85 folded before Flop (didn't bet)
Seat 4: ungiwar folded before Flop (didn't bet)
Seat 5: Mr.G pat (button) folded on the Flop
Seat 6: Acedan1369 (small blind) folded before Flop



PokerStars Hand #222965545532:  Hold'em No Limit ($0.05/$0.10 USD) - 2021/01/23 14:10:02 ET
Table 'Capricorn III' 6-max Seat #6 is the button
Seat 1: 12bwb3 ($4.06 in chips) 
Seat 2: greenthum33 ($10.63 in chips) 
Seat 3: CvB85 ($11.33 in chips) 
Seat 4: ungiwar ($5.92 in chips) 
Seat 5: Mr.G pat ($7.30 in chips) 
Seat 6: Acedan1369 ($12.67 in chips) 
12bwb3: posts small blind $0.05
greenthum33: posts big blind $0.10
*** HOLE CARDS ***
CvB85: folds 
ungiwar: folds 
Mr.G pat: calls $0.10
Acedan1369: folds 
12bwb3: raises $0.20 to $0.30
greenthum33: folds 
Mr.G pat: calls $0.20
*** FLOP *** [8h 7d Tc]
12bwb3: checks 
Mr.G pat: checks 
*** TURN *** [8h 7d Tc] [Kh]
12bwb3: checks 
Mr.G pat: bets $0.20
12bwb3: calls $0.20
*** RIVER *** [8h 7d Tc Kh] [9d]
12bwb3: bets $0.53
Mr.G pat: calls $0.53
*** SHOW DOWN ***
12bwb3: shows [Ac Ah] (a pair of Aces)
Mr.G pat: mucks hand 
12bwb3 collected $2.06 from pot
*** SUMMARY ***
Total pot $2.16 | Rake $0.10 
Board [8h 7d Tc Kh 9d]
Seat 1: 12bwb3 (small blind) showed [Ac Ah] and won ($2.06) with a pair of Aces
Seat 2: greenthum33 (big blind) folded before Flop
Seat 3: CvB85 folded before Flop (didn't bet)
Seat 4: ungiwar folded before Flop (didn't bet)
Seat 5: Mr.G pat mucked
Seat 6: Acedan1369 (button) folded before Flop (didn't bet)



PokerStars Hand #222965571058:  Hold'em No Limit ($0.05/$0.10 USD) - 2021/01/23 14:10:34 ET
Table 'Capricorn III' 6-max Seat #1 is the button
Seat 1: 12bwb3 ($5.09 in chips) 
Seat 2: greenthum33 ($10.53 in chips) 
Seat 3: CvB85 ($11.33 in chips) 
Seat 4: ungiwar ($5.92 in chips) 
Seat 5: Mr.G pat ($6.27 in chips) 
Seat 6: Acedan1369 ($12.67 in chips) 
greenthum33: posts small blind $0.05
CvB85: posts big blind $0.10
*** HOLE CARDS ***
ungiwar: folds 
Mr.G pat: folds 
Acedan1369: raises $0.15 to $0.25
12bwb3: folds 
greenthum33: folds 
CvB85: folds 
Uncalled bet ($0.15) returned to Acedan1369
Acedan1369 collected $0.25 from pot
Acedan1369: doesn't show hand 
*** SUMMARY ***
Total pot $0.25 | Rake $0 
Seat 1: 12bwb3 (button) folded before Flop (didn't bet)
Seat 2: greenthum33 (small blind) folded before Flop
Seat 3: CvB85 (big blind) folded before Flop
Seat 4: ungiwar folded before Flop (didn't bet)
Seat 5: Mr.G pat folded before Flop (didn't bet)
Seat 6: Acedan1369 collected ($0.25)



PokerStars Hand #222965588604:  Hold'em No Limit ($0.05/$0.10 USD) - 2021/01/23 14:10:57 ET
Table 'Capricorn III' 6-max Seat #2 is the button
Seat 1: 12bwb3 ($5.09 in chips) 
Seat 2: greenthum33 ($10.48 in chips) 
Seat 3: CvB85 ($11.23 in chips) 
Seat 4: ungiwar ($5.92 in chips) 
Seat 5: Mr.G pat ($6.27 in chips) 
Seat 6: Acedan1369 ($12.82 in chips) 
CvB85: posts small blind $0.05
ungiwar: posts big blind $0.10
*** HOLE CARDS ***
Mr.G pat: calls $0.10
Acedan1369: folds 
12bwb3: folds 
greenthum33: raises $0.20 to $0.30
CvB85: folds 
ungiwar: folds 
Mr.G pat: calls $0.20
*** FLOP *** [9c Qc 3s]
Mr.G pat: checks 
greenthum33: bets $0.30
Mr.G pat: folds 
Uncalled bet ($0.30) returned to greenthum33
greenthum33 collected $0.72 from pot
greenthum33: doesn't show hand 
*** SUMMARY ***
Total pot $0.75 | Rake $0.03 
Board [9c Qc 3s]
Seat 1: 12bwb3 folded before Flop (didn't bet)
Seat 2: greenthum33 (button) collected ($0.72)
Seat 3: CvB85 (small blind) folded before Flop
Seat 4: ungiwar (big blind) folded before Flop
Seat 5: Mr.G pat folded on the Flop
Seat 6: Acedan1369 folded before Flop (didn't bet)



PokerStars Hand #222965607000:  Hold'em No Limit ($0.05/$0.10 USD) - 2021/01/23 14:11:20 ET
Table 'Capricorn III' 6-max Seat #3 is the button
Seat 1: 12bwb3 ($5.09 in chips) 
Seat 2: greenthum33 ($10.90 in chips) 
Seat 3: CvB85 ($11.18 in chips) 
Seat 4: ungiwar ($5.82 in chips) 
Seat 5: Mr.G pat ($5.97 in chips) 
Seat 6: Acedan1369 ($12.82 in chips) 
ungiwar: posts small blind $0.05
Mr.G pat: posts big blind $0.10
*** HOLE CARDS ***
Acedan1369: folds 
12bwb3: folds 
greenthum33: folds 
CvB85: folds 
ungiwar: calls $0.05
Mr.G pat: checks 
*** FLOP *** [8c Th Jd]
ungiwar: checks 
Mr.G pat: checks 
*** TURN *** [8c Th Jd] [2s]
ungiwar: checks 
Mr.G pat: bets $0.10
ungiwar: calls $0.10
*** RIVER *** [8c Th Jd 2s] [Qh]
ungiwar: checks 
Mr.G pat: bets $0.10
ungiwar: folds 
Uncalled bet ($0.10) returned to Mr.G pat
Mr.G pat collected $0.38 from pot
Mr.G pat: doesn't show hand 
*** SUMMARY ***
Total pot $0.40 | Rake $0.02 
Board [8c Th Jd 2s Qh]
Seat 1: 12bwb3 folded before Flop (didn't bet)
Seat 2: greenthum33 folded before Flop (didn't bet)
Seat 3: CvB85 (button) folded before Flop (didn't bet)
Seat 4: ungiwar (small blind) folded on the River
Seat 5: Mr.G pat (big blind) collected ($0.38)
Seat 6: Acedan1369 folded before Flop (didn't bet)



PokerStars Hand #222965628727:  Hold'em No Limit ($0.05/$0.10 USD) - 2021/01/23 14:11:47 ET
Table 'Capricorn III' 6-max Seat #4 is the button
Seat 1: 12bwb3 ($5.09 in chips) 
Seat 2: greenthum33 ($10.90 in chips) 
Seat 3: CvB85 ($11.18 in chips) 
Seat 4: ungiwar ($5.62 in chips) 
Seat 5: Mr.G pat ($6.15 in chips) 
Seat 6: Acedan1369 ($12.82 in chips) 
Mr.G pat: posts small blind $0.05
Acedan1369: posts big blind $0.10
*** HOLE CARDS ***
12bwb3: folds 
greenthum33: folds 
CvB85: raises $0.20 to $0.30
ungiwar: folds 
Mr.G pat: folds 
Acedan1369: folds 
Uncalled bet ($0.20) returned to CvB85
CvB85 collected $0.25 from pot
CvB85: doesn't show hand 
*** SUMMARY ***
Total pot $0.25 | Rake $0 
Seat 1: 12bwb3 folded before Flop (didn't bet)
Seat 2: greenthum33 folded before Flop (didn't bet)
Seat 3: CvB85 collected ($0.25)
Seat 4: ungiwar (button) folded before Flop (didn't bet)
Seat 5: Mr.G pat (small blind) folded before Flop
Seat 6: Acedan1369 (big blind) folded before Flop



PokerStars Hand #222965644958:  Hold'em No Limit ($0.05/$0.10 USD) - 2021/01/23 14:12:08 ET
Table 'Capricorn III' 6-max Seat #5 is the button
Seat 1: 12bwb3 ($5.09 in chips) 
Seat 2: greenthum33 ($10.90 in chips) 
Seat 3: CvB85 ($11.33 in chips) 
Seat 4: ungiwar ($5.62 in chips) 
Seat 5: Mr.G pat ($6.10 in chips) 
Seat 6: Acedan1369 ($12.72 in chips) 
Acedan1369: posts small blind $0.05
12bwb3: posts big blind $0.10
*** HOLE CARDS ***
greenthum33: folds 
CvB85: folds 
ungiwar: raises $0.10 to $0.20
Mr.G pat: folds 
Acedan1369: folds 
12bwb3: calls $0.10
*** FLOP *** [Kd Qh Jc]
12bwb3: checks 
ungiwar: checks 
*** TURN *** [Kd Qh Jc] [9s]
12bwb3: checks 
ungiwar: bets $0.15
12bwb3: folds 
Uncalled bet ($0.15) returned to ungiwar
ungiwar collected $0.43 from pot
ungiwar: doesn't show hand 
*** SUMMARY ***
Total pot $0.45 | Rake $0.02 
Board [Kd Qh Jc 9s]
Seat 1: 12bwb3 (big blind) folded on the Turn
Seat 2: greenthum33 folded before Flop (didn't bet)
Seat 3: CvB85 folded before Flop (didn't bet)
Seat 4: ungiwar collected ($0.43)
Seat 5: Mr.G pat (button) folded before Flop (didn't bet)
Seat 6: Acedan1369 (small blind) folded before Flop



PokerStars Hand #222965675214:  Hold'em No Limit ($0.05/$0.10 USD) - 2021/01/23 14:12:46 ET
Table 'Capricorn III' 6-max Seat #6 is the button
Seat 1: 12bwb3 ($4.89 in chips) 
Seat 2: greenthum33 ($10.90 in chips) 
Seat 3: CvB85 ($11.33 in chips) 
Seat 4: ungiwar ($5.85 in chips) 
Seat 5: Mr.G pat ($6.10 in chips) 
Seat 6: Acedan1369 ($12.67 in chips) 
12bwb3: posts small blind $0.05
greenthum33: posts big blind $0.10
*** HOLE CARDS ***
CvB85: raises $0.20 to $0.30
ungiwar: folds 
Mr.G pat: folds 
Acedan1369: folds 
12bwb3: folds 
greenthum33: folds 
Uncalled bet ($0.20) returned to CvB85
CvB85 collected $0.25 from pot
CvB85: doesn't show hand 
*** SUMMARY ***
Total pot $0.25 | Rake $0 
Seat 1: 12bwb3 (small blind) folded before Flop
Seat 2: greenthum33 (big blind) folded before Flop
Seat 3: CvB85 collected ($0.25)
Seat 4: ungiwar folded before Flop (didn't bet)
Seat 5: Mr.G pat folded before Flop (didn't bet)
Seat 6: Acedan1369 (button) folded before Flop (didn't bet)



PokerStars Hand #222965693173:  Hold'em No Limit ($0.05/$0.10 USD) - 2021/01/23 14:13:09 ET
Table 'Capricorn III' 6-max Seat #1 is the button
Seat 1: 12bwb3 ($4.84 in chips) 
Seat 2: greenthum33 ($10.80 in chips) 
Seat 3: CvB85 ($11.48 in chips) 
Seat 4: ungiwar ($5.85 in chips) 
Seat 5: Mr.G pat ($6.10 in chips) 
Seat 6: Acedan1369 ($12.67 in chips) 
greenthum33: posts small blind $0.05
CvB85: posts big blind $0.10
*** HOLE CARDS ***
ungiwar: folds 
Mr.G pat: calls $0.10
Acedan1369: raises $0.30 to $0.40
12bwb3: folds 
greenthum33: folds 
CvB85: folds 
Mr.G pat: calls $0.30
*** FLOP *** [4h 6c 9s]
Mr.G pat: checks 
Acedan1369: bets $0.41
Mr.G pat: folds 
Uncalled bet ($0.41) returned to Acedan1369
Acedan1369 collected $0.91 from pot
Acedan1369: doesn't show hand 
*** SUMMARY ***
Total pot $0.95 | Rake $0.04 
Board [4h 6c 9s]
Seat 1: 12bwb3 (button) folded before Flop (didn't bet)
Seat 2: greenthum33 (small blind) folded before Flop
Seat 3: CvB85 (big blind) folded before Flop
Seat 4: ungiwar folded before Flop (didn't bet)
Seat 5: Mr.G pat folded on the Flop
Seat 6: Acedan1369 collected ($0.91)



PokerStars Hand #222965731822:  Hold'em No Limit ($0.05/$0.10 USD) - 2021/01/23 14:13:58 ET
Table 'Capricorn III' 6-max Seat #2 is the button
Seat 1: 12bwb3 ($4.84 in chips) 
Seat 2: greenthum33 ($10.75 in chips) 
Seat 3: CvB85 ($11.38 in chips) 
Seat 4: ungiwar ($5.85 in chips) 
Seat 5: Mr.G pat ($5.70 in chips) 
Seat 6: Acedan1369 ($13.18 in chips) 
CvB85: posts small blind $0.05
ungiwar: posts big blind $0.10
*** HOLE CARDS ***
Mr.G pat: folds 
Acedan1369: raises $0.15 to $0.25
Mr.G pat leaves the table
12bwb3: folds 
greenthum33: folds 
CvB85: folds 
trip314 joins the table at seat #5 
ungiwar: folds 
Uncalled bet ($0.15) returned to Acedan1369
Acedan1369 collected $0.25 from pot
Acedan1369: doesn't show hand 
*** SUMMARY ***
Total pot $0.25 | Rake $0 
Seat 1: 12bwb3 folded before Flop (didn't bet)
Seat 2: greenthum33 (button) folded before Flop (didn't bet)
Seat 3: CvB85 (small blind) folded before Flop
Seat 4: ungiwar (big blind) folded before Flop
Seat 5: Mr.G pat folded before Flop (didn't bet)
Seat 6: Acedan1369 collected ($0.25)



PokerStars Hand #222965743697:  Hold'em No Limit ($0.05/$0.10 USD) - 2021/01/23 14:14:12 ET
Table 'Capricorn III' 6-max Seat #3 is the button
Seat 1: 12bwb3 ($4.84 in chips) 
Seat 2: greenthum33 ($10.75 in chips) 
Seat 3: CvB85 ($11.33 in chips) 
Seat 4: ungiwar ($5.75 in chips) 
Seat 5: trip314 ($10 in chips) 
Seat 6: Acedan1369 ($13.33 in chips) 
ungiwar: posts small blind $0.05
trip314: posts big blind $0.10
*** HOLE CARDS ***
Acedan1369: folds 
12bwb3: raises $0.10 to $0.20
greenthum33: folds 
CvB85: calls $0.20
ungiwar: folds 
trip314: folds 
*** FLOP *** [Qh Kd Jc]
12bwb3: checks 
CvB85: checks 
*** TURN *** [Qh Kd Jc] [8c]
12bwb3: checks 
CvB85: checks 
*** RIVER *** [Qh Kd Jc 8c] [5c]
12bwb3: bets $0.27
CvB85: folds 
Uncalled bet ($0.27) returned to 12bwb3
12bwb3 collected $0.53 from pot
12bwb3: doesn't show hand 
*** SUMMARY ***
Total pot $0.55 | Rake $0.02 
Board [Qh Kd Jc 8c 5c]
Seat 1: 12bwb3 collected ($0.53)
Seat 2: greenthum33 folded before Flop (didn't bet)
Seat 3: CvB85 (button) folded on the River
Seat 4: ungiwar (small blind) folded before Flop
Seat 5: trip314 (big blind) folded before Flop
Seat 6: Acedan1369 folded before Flop (didn't bet)



PokerStars Hand #222965763611:  Hold'em No Limit ($0.05/$0.10 USD) - 2021/01/23 14:14:38 ET
Table 'Capricorn III' 6-max Seat #4 is the button
Seat 1: 12bwb3 ($5.17 in chips) 
Seat 2: greenthum33 ($10.75 in chips) 
Seat 3: CvB85 ($11.13 in chips) 
Seat 4: ungiwar ($5.70 in chips) 
Seat 5: trip314 ($10 in chips) 
Seat 6: Acedan1369 ($13.33 in chips) 
trip314: posts small blind $0.05
Acedan1369: posts big blind $0.10
*** HOLE CARDS ***
12bwb3: folds 
greenthum33: folds 
CvB85: raises $0.20 to $0.30
ungiwar: folds 
trip314: folds 
Acedan1369: folds 
Uncalled bet ($0.20) returned to CvB85
CvB85 collected $0.25 from pot
CvB85: doesn't show hand 
*** SUMMARY ***
Total pot $0.25 | Rake $0 
Seat 1: 12bwb3 folded before Flop (didn't bet)
Seat 2: greenthum33 folded before Flop (didn't bet)
Seat 3: CvB85 collected ($0.25)
Seat 4: ungiwar (button) folded before Flop (didn't bet)
Seat 5: trip314 (small blind) folded before Flop
Seat 6: Acedan1369 (big blind) folded before Flop



PokerStars Hand #222965776947:  Hold'em No Limit ($0.05/$0.10 USD) - 2021/01/23 14:14:55 ET
Table 'Capricorn III' 6-max Seat #5 is the button
Seat 1: 12bwb3 ($5.17 in chips) 
Seat 2: greenthum33 ($10.75 in chips) 
Seat 3: CvB85 ($11.28 in chips) 
Seat 4: ungiwar ($5.70 in chips) 
Seat 5: trip314 ($10 in chips) 
Seat 6: Acedan1369 ($13.23 in chips) 
Acedan1369: posts small blind $0.05
12bwb3: posts big blind $0.10
*** HOLE CARDS ***
greenthum33: raises $0.20 to $0.30
CvB85: calls $0.30
ungiwar: folds 
trip314: folds 
Acedan1369: folds 
12bwb3: calls $0.20
*** FLOP *** [4d 3c 4s]
12bwb3: checks 
greenthum33: bets $0.46
CvB85: folds 
12bwb3: folds 
Uncalled bet ($0.46) returned to greenthum33
greenthum33 collected $0.91 from pot
greenthum33: doesn't show hand 
*** SUMMARY ***
Total pot $0.95 | Rake $0.04 
Board [4d 3c 4s]
Seat 1: 12bwb3 (big blind) folded on the Flop
Seat 2: greenthum33 collected ($0.91)
Seat 3: CvB85 folded on the Flop
Seat 4: ungiwar folded before Flop (didn't bet)
Seat 5: trip314 (button) folded before Flop (didn't bet)
Seat 6: Acedan1369 (small blind) folded before Flop



PokerStars Hand #222965806145:  Hold'em No Limit ($0.05/$0.10 USD) - 2021/01/23 14:15:31 ET
Table 'Capricorn III' 6-max Seat #6 is the button
Seat 1: 12bwb3 ($4.87 in chips) 
Seat 2: greenthum33 ($11.36 in chips) 
Seat 3: CvB85 ($10.98 in chips) 
Seat 4: ungiwar ($5.70 in chips) 
Seat 5: trip314 ($10 in chips) 
Seat 6: Acedan1369 ($13.18 in chips) 
12bwb3: posts small blind $0.05
greenthum33: posts big blind $0.10
*** HOLE CARDS ***
CvB85: folds 
ungiwar: folds 
trip314: folds 
Acedan1369: folds 
12bwb3: raises $0.10 to $0.20
greenthum33: calls $0.10
*** FLOP *** [7c Qc 2d]
12bwb3: checks 
greenthum33: checks 
*** TURN *** [7c Qc 2d] [2c]
12bwb3: checks 
greenthum33: checks 
*** RIVER *** [7c Qc 2d 2c] [6s]
12bwb3: checks 
greenthum33: checks 
*** SHOW DOWN ***
12bwb3: shows [5h Ks] (a pair of Deuces)
greenthum33: mucks hand 
12bwb3 collected $0.38 from pot
*** SUMMARY ***
Total pot $0.40 | Rake $0.02 
Board [7c Qc 2d 2c 6s]
Seat 1: 12bwb3 (small blind) showed [5h Ks] and won ($0.38) with a pair of Deuces
Seat 2: greenthum33 (big blind) mucked
Seat 3: CvB85 folded before Flop (didn't bet)
Seat 4: ungiwar folded before Flop (didn't bet)
Seat 5: trip314 folded before Flop (didn't bet)
Seat 6: Acedan1369 (button) folded before Flop (didn't bet)



PokerStars Hand #222965829770:  Hold'em No Limit ($0.05/$0.10 USD) - 2021/01/23 14:16:01 ET
Table 'Capricorn III' 6-max Seat #1 is the button
Seat 1: 12bwb3 ($5.05 in chips) 
Seat 2: greenthum33 ($11.16 in chips) 
Seat 3: CvB85 ($10.98 in chips) 
Seat 4: ungiwar ($5.70 in chips) 
Seat 5: trip314 ($10 in chips) 
Seat 6: Acedan1369 ($13.18 in chips) 
greenthum33: posts small blind $0.05
CvB85: posts big blind $0.10
*** HOLE CARDS ***
ungiwar: folds 
trip314: folds 
Acedan1369: folds 
12bwb3: folds 
greenthum33: folds 
Uncalled bet ($0.05) returned to CvB85
CvB85 collected $0.10 from pot
CvB85: doesn't show hand 
*** SUMMARY ***
Total pot $0.10 | Rake $0 
Seat 1: 12bwb3 (button) folded before Flop (didn't bet)
Seat 2: greenthum33 (small blind) folded before Flop
Seat 3: CvB85 (big blind) collected ($0.10)
Seat 4: ungiwar folded before Flop (didn't bet)
Seat 5: trip314 folded before Flop (didn't bet)
Seat 6: Acedan1369 folded before Flop (didn't bet)



PokerStars Hand #222965841343:  Hold'em No Limit ($0.05/$0.10 USD) - 2021/01/23 14:16:13 ET
Table 'Capricorn III' 6-max Seat #2 is the button
Seat 1: 12bwb3 ($5.05 in chips) 
Seat 2: greenthum33 ($11.11 in chips) 
Seat 3: CvB85 ($11.03 in chips) 
Seat 4: ungiwar ($5.70 in chips) 
Seat 5: trip314 ($10 in chips) 
Seat 6: Acedan1369 ($13.18 in chips) 
CvB85: posts small blind $0.05
ungiwar: posts big blind $0.10
*** HOLE CARDS ***
trip314: folds 
Acedan1369: folds 
12bwb3: folds 
greenthum33: raises $0.20 to $0.30
CvB85: folds 
ungiwar: calls $0.20
*** FLOP *** [Ks Kd 4c]
ungiwar: checks 
greenthum33: bets $0.30
ungiwar: folds 
Uncalled bet ($0.30) returned to greenthum33
greenthum33 collected $0.62 from pot
greenthum33: doesn't show hand 
*** SUMMARY ***
Total pot $0.65 | Rake $0.03 
Board [Ks Kd 4c]
Seat 1: 12bwb3 folded before Flop (didn't bet)
Seat 2: greenthum33 (button) collected ($0.62)
Seat 3: CvB85 (small blind) folded before Flop
Seat 4: ungiwar (big blind) folded on the Flop
Seat 5: trip314 folded before Flop (didn't bet)
Seat 6: Acedan1369 folded before Flop (didn't bet)



PokerStars Hand #222965856176:  Hold'em No Limit ($0.05/$0.10 USD) - 2021/01/23 14:16:32 ET
Table 'Capricorn III' 6-max Seat #3 is the button
Seat 1: 12bwb3 ($5.05 in chips) 
Seat 2: greenthum33 ($11.43 in chips) 
Seat 3: CvB85 ($10.98 in chips) 
Seat 4: ungiwar ($5.40 in chips) 
Seat 5: trip314 ($10 in chips) 
Seat 6: Acedan1369 ($13.18 in chips) 
ungiwar: posts small blind $0.05
trip314: posts big blind $0.10
*** HOLE CARDS ***
Acedan1369: raises $0.15 to $0.25
12bwb3: folds 
greenthum33: folds 
CvB85: calls $0.25
ungiwar: calls $0.20
trip314: folds 
*** FLOP *** [8h 2d 6s]
ungiwar: checks 
Acedan1369: checks 
CvB85: bets $0.50
ungiwar: folds 
Acedan1369: folds 
Uncalled bet ($0.50) returned to CvB85
CvB85 collected $0.81 from pot
CvB85: doesn't show hand 
*** SUMMARY ***
Total pot $0.85 | Rake $0.04 
Board [8h 2d 6s]
Seat 1: 12bwb3 folded before Flop (didn't bet)
Seat 2: greenthum33 folded before Flop (didn't bet)
Seat 3: CvB85 (button) collected ($0.81)
Seat 4: ungiwar (small blind) folded on the Flop
Seat 5: trip314 (big blind) folded before Flop
Seat 6: Acedan1369 folded on the Flop



PokerStars Hand #222965885816:  Hold'em No Limit ($0.05/$0.10 USD) - 2021/01/23 14:17:09 ET
Table 'Capricorn III' 6-max Seat #4 is the button
Seat 1: 12bwb3 ($5.05 in chips) 
Seat 2: greenthum33 ($11.43 in chips) 
Seat 3: CvB85 ($11.54 in chips) 
Seat 4: ungiwar ($5.15 in chips) 
Seat 5: trip314 ($10 in chips) 
Seat 6: Acedan1369 ($12.93 in chips) 
trip314: posts small blind $0.05
Acedan1369: posts big blind $0.10
*** HOLE CARDS ***
12bwb3: raises $0.10 to $0.20
greenthum33: folds 
CvB85: folds 
ungiwar: folds 
trip314: calls $0.15
Acedan1369: folds 
*** FLOP *** [6s 3h 6c]
trip314: checks 
12bwb3: checks 
*** TURN *** [6s 3h 6c] [6h]
trip314: bets $0.16
12bwb3: folds 
Uncalled bet ($0.16) returned to trip314
trip314 collected $0.48 from pot
trip314: doesn't show hand 
*** SUMMARY ***
Total pot $0.50 | Rake $0.02 
Board [6s 3h 6c 6h]
Seat 1: 12bwb3 folded on the Turn
Seat 2: greenthum33 folded before Flop (didn't bet)
Seat 3: CvB85 folded before Flop (didn't bet)
Seat 4: ungiwar (button) folded before Flop (didn't bet)
Seat 5: trip314 (small blind) collected ($0.48)
Seat 6: Acedan1369 (big blind) folded before Flop



PokerStars Hand #222965911929:  Hold'em No Limit ($0.05/$0.10 USD) - 2021/01/23 14:17:42 ET
Table 'Capricorn III' 6-max Seat #5 is the button
Seat 1: 12bwb3 ($4.85 in chips) 
Seat 2: greenthum33 ($11.43 in chips) 
Seat 3: CvB85 ($11.54 in chips) 
Seat 4: ungiwar ($5.15 in chips) 
Seat 5: trip314 ($10.28 in chips) 
Seat 6: Acedan1369 ($12.83 in chips) 
Acedan1369: posts small blind $0.05
12bwb3: posts big blind $0.10
*** HOLE CARDS ***
greenthum33: calls $0.10
CvB85: folds 
ungiwar: folds 
trip314: folds 
Acedan1369: folds 
12bwb3: checks 
*** FLOP *** [Qh 2h Ks]
12bwb3: checks 
greenthum33: checks 
*** TURN *** [Qh 2h Ks] [Th]
12bwb3: checks 
greenthum33: bets $0.20
12bwb3: calls $0.20
*** RIVER *** [Qh 2h Ks Th] [8d]
12bwb3: checks 
greenthum33: bets $0.62
12bwb3: calls $0.62
*** SHOW DOWN ***
greenthum33: shows [3h Ah] (a flush, Ace high)
12bwb3: mucks hand 
greenthum33 collected $1.80 from pot
*** SUMMARY ***
Total pot $1.89 | Rake $0.09 
Board [Qh 2h Ks Th 8d]
Seat 1: 12bwb3 (big blind) mucked
Seat 2: greenthum33 showed [3h Ah] and won ($1.80) with a flush, Ace high
Seat 3: CvB85 folded before Flop (didn't bet)
Seat 4: ungiwar folded before Flop (didn't bet)
Seat 5: trip314 (button) folded before Flop (didn't bet)
Seat 6: Acedan1369 (small blind) folded before Flop



PokerStars Hand #222965948303:  Hold'em No Limit ($0.05/$0.10 USD) - 2021/01/23 14:18:28 ET
Table 'Capricorn III' 6-max Seat #6 is the button
Seat 1: 12bwb3 ($3.93 in chips) 
Seat 2: greenthum33 ($12.31 in chips) 
Seat 3: CvB85 ($11.54 in chips) 
Seat 4: ungiwar ($5.15 in chips) 
Seat 5: trip314 ($10.28 in chips) 
Seat 6: Acedan1369 ($12.78 in chips) 
12bwb3: posts small blind $0.05
greenthum33: posts big blind $0.10
*** HOLE CARDS ***
CvB85: folds 
ungiwar: folds 
trip314: folds 
Acedan1369: folds 
12bwb3: folds 
Uncalled bet ($0.05) returned to greenthum33
greenthum33 collected $0.10 from pot
greenthum33: doesn't show hand 
*** SUMMARY ***
Total pot $0.10 | Rake $0 
Seat 1: 12bwb3 (small blind) folded before Flop
Seat 2: greenthum33 (big blind) collected ($0.10)
Seat 3: CvB85 folded before Flop (didn't bet)
Seat 4: ungiwar folded before Flop (didn't bet)
Seat 5: trip314 folded before Flop (didn't bet)
Seat 6: Acedan1369 (button) folded before Flop (didn't bet)



PokerStars Hand #222965968978:  Hold'em No Limit ($0.05/$0.10 USD) - 2021/01/23 14:18:54 ET
Table 'Capricorn III' 6-max Seat #1 is the button
Seat 1: 12bwb3 ($3.88 in chips) 
Seat 2: greenthum33 ($12.36 in chips) 
Seat 3: CvB85 ($11.54 in chips) 
Seat 4: ungiwar ($5.15 in chips) 
Seat 5: trip314 ($10.28 in chips) 
Seat 6: Acedan1369 ($12.78 in chips) 
greenthum33: posts small blind $0.05
CvB85: posts big blind $0.10
*** HOLE CARDS ***
ungiwar: folds 
trip314: folds 
Acedan1369 has timed out
Acedan1369: folds 
12bwb3: raises $0.10 to $0.20
greenthum33: folds 
CvB85: calls $0.10
*** FLOP *** [6h 8c Tc]
CvB85: checks 
12bwb3: checks 
*** TURN *** [6h 8c Tc] [4c]
CvB85: bets $0.22
12bwb3: calls $0.22
*** RIVER *** [6h 8c Tc 4c] [4h]
CvB85: checks 
12bwb3: bets $0.43
CvB85: calls $0.43
*** SHOW DOWN ***
12bwb3: shows [Th Ts] (a full house, Tens full of Fours)
CvB85: mucks hand 
12bwb3 collected $1.67 from pot
*** SUMMARY ***
Total pot $1.75 | Rake $0.08 
Board [6h 8c Tc 4c 4h]
Seat 1: 12bwb3 (button) showed [Th Ts] and won ($1.67) with a full house, Tens full of Fours
Seat 2: greenthum33 (small blind) folded before Flop
Seat 3: CvB85 (big blind) mucked
Seat 4: ungiwar folded before Flop (didn't bet)
Seat 5: trip314 folded before Flop (didn't bet)
Seat 6: Acedan1369 folded before Flop (didn't bet)



PokerStars Hand #222966004195:  Hold'em No Limit ($0.05/$0.10 USD) - 2021/01/23 14:19:39 ET
Table 'Capricorn III' 6-max Seat #2 is the button
Seat 1: 12bwb3 ($4.70 in chips) 
Seat 2: greenthum33 ($12.31 in chips) 
Seat 3: CvB85 ($10.69 in chips) 
Seat 4: ungiwar ($5.15 in chips) 
Seat 5: trip314 ($10.28 in chips) 
Seat 6: Acedan1369 ($12.78 in chips) 
CvB85: posts small blind $0.05
ungiwar: posts big blind $0.10
*** HOLE CARDS ***
trip314: folds 
Acedan1369: folds 
12bwb3: raises $0.10 to $0.20
greenthum33: folds 
CvB85: raises $0.70 to $0.90
ungiwar: folds 
12bwb3: folds 
Uncalled bet ($0.70) returned to CvB85
CvB85 collected $0.50 from pot
CvB85: doesn't show hand 
*** SUMMARY ***
Total pot $0.50 | Rake $0 
Seat 1: 12bwb3 folded before Flop
Seat 2: greenthum33 (button) folded before Flop (didn't bet)
Seat 3: CvB85 (small blind) collected ($0.50)
Seat 4: ungiwar (big blind) folded before Flop
Seat 5: trip314 folded before Flop (didn't bet)
Seat 6: Acedan1369 folded before Flop (didn't bet)



PokerStars Hand #222966023917:  Hold'em No Limit ($0.05/$0.10 USD) - 2021/01/23 14:20:04 ET
Table 'Capricorn III' 6-max Seat #3 is the button
Seat 1: 12bwb3 ($4.50 in chips) 
Seat 2: greenthum33 ($12.31 in chips) 
Seat 3: CvB85 ($10.99 in chips) 
Seat 4: ungiwar ($5.05 in chips) 
Seat 5: trip314 ($10.28 in chips) 
Seat 6: Acedan1369 ($12.78 in chips) 
ungiwar: posts small blind $0.05
trip314: posts big blind $0.10
*** HOLE CARDS ***
Acedan1369: folds 
12bwb3: raises $0.10 to $0.20
greenthum33: raises $0.30 to $0.50
CvB85: folds 
ungiwar: folds 
trip314: folds 
12bwb3: calls $0.30
*** FLOP *** [5h 7c 9h]
12bwb3: checks 
greenthum33: bets $0.55
12bwb3: folds 
Uncalled bet ($0.55) returned to greenthum33
greenthum33 collected $1.10 from pot
greenthum33: doesn't show hand 
*** SUMMARY ***
Total pot $1.15 | Rake $0.05 
Board [5h 7c 9h]
Seat 1: 12bwb3 folded on the Flop
Seat 2: greenthum33 collected ($1.10)
Seat 3: CvB85 (button) folded before Flop (didn't bet)
Seat 4: ungiwar (small blind) folded before Flop
Seat 5: trip314 (big blind) folded before Flop
Seat 6: Acedan1369 folded before Flop (didn't bet)



PokerStars Hand #222966046567:  Hold'em No Limit ($0.05/$0.10 USD) - 2021/01/23 14:20:33 ET
Table 'Capricorn III' 6-max Seat #4 is the button
Seat 1: 12bwb3 ($4 in chips) 
Seat 2: greenthum33 ($12.91 in chips) 
Seat 3: CvB85 ($10.99 in chips) 
Seat 4: ungiwar ($5 in chips) 
Seat 5: trip314 ($10.18 in chips) 
Seat 6: Acedan1369 ($12.78 in chips) 
trip314: posts small blind $0.05
Acedan1369: posts big blind $0.10
*** HOLE CARDS ***
12bwb3: raises $0.10 to $0.20
greenthum33: folds 
CvB85: folds 
ungiwar: calls $0.20
trip314: folds 
Acedan1369: folds 
*** FLOP *** [2s As 5c]
12bwb3: checks 
ungiwar: bets $0.35
12bwb3: calls $0.35
*** TURN *** [2s As 5c] [Ah]
12bwb3: checks 
ungiwar: bets $0.40
12bwb3: calls $0.40
*** RIVER *** [2s As 5c Ah] [Tc]
12bwb3: checks 
ungiwar: checks 
*** SHOW DOWN ***
12bwb3: shows [4s 4d] (two pair, Aces and Fours)
ungiwar: shows [Ks Ts] (two pair, Aces and Tens)
ungiwar collected $1.96 from pot
*** SUMMARY ***
Total pot $2.05 | Rake $0.09 
Board [2s As 5c Ah Tc]
Seat 1: 12bwb3 showed [4s 4d] and lost with two pair, Aces and Fours
Seat 2: greenthum33 folded before Flop (didn't bet)
Seat 3: CvB85 folded before Flop (didn't bet)
Seat 4: ungiwar (button) showed [Ks Ts] and won ($1.96) with two pair, Aces and Tens
Seat 5: trip314 (small blind) folded before Flop
Seat 6: Acedan1369 (big blind) folded before Flop



PokerStars Hand #222966081072:  Hold'em No Limit ($0.05/$0.10 USD) - 2021/01/23 14:21:13 ET
Table 'Capricorn III' 6-max Seat #5 is the button
Seat 1: 12bwb3 ($3.05 in chips) 
Seat 2: greenthum33 ($12.91 in chips) 
Seat 3: CvB85 ($10.99 in chips) 
Seat 4: ungiwar ($6.01 in chips) 
Seat 5: trip314 ($10.13 in chips) 
Seat 6: Acedan1369 ($12.68 in chips) 
Acedan1369: posts small blind $0.05
12bwb3: posts big blind $0.10
*** HOLE CARDS ***
greenthum33: folds 
CvB85: folds 
ungiwar: raises $0.10 to $0.20
trip314: folds 
Acedan1369: folds 
12bwb3: calls $0.10
*** FLOP *** [9s 3c Js]
12bwb3: checks 
ungiwar: bets $0.32
12bwb3: calls $0.32
*** TURN *** [9s 3c Js] [8d]
12bwb3: checks 
ungiwar: bets $0.78
12bwb3: raises $1.75 to $2.53 and is all-in
ungiwar: calls $1.75
*** RIVER *** [9s 3c Js 8d] [Kh]
*** SHOW DOWN ***
12bwb3: shows [Qs Ts] (a straight, Nine to King)
ungiwar: shows [Kc Jc] (two pair, Kings and Jacks)
12bwb3 collected $5.87 from pot
*** SUMMARY ***
Total pot $6.15 | Rake $0.28 
Board [9s 3c Js 8d Kh]
Seat 1: 12bwb3 (big blind) showed [Qs Ts] and won ($5.87) with a straight, Nine to King
Seat 2: greenthum33 folded before Flop (didn't bet)
Seat 3: CvB85 folded before Flop (didn't bet)
Seat 4: ungiwar showed [Kc Jc] and lost with two pair, Kings and Jacks
Seat 5: trip314 (button) folded before Flop (didn't bet)
Seat 6: Acedan1369 (small blind) folded before Flop



PokerStars Hand #222966126050:  Hold'em No Limit ($0.05/$0.10 USD) - 2021/01/23 14:22:11 ET
Table 'Capricorn III' 6-max Seat #6 is the button
Seat 1: 12bwb3 ($5.87 in chips) 
Seat 2: greenthum33 ($12.91 in chips) 
Seat 3: CvB85 ($10.99 in chips) 
Seat 4: ungiwar ($2.96 in chips) 
Seat 5: trip314 ($10.13 in chips) 
Seat 6: Acedan1369 ($12.63 in chips) 
12bwb3: posts small blind $0.05
greenthum33: posts big blind $0.10
*** HOLE CARDS ***
CvB85: folds 
ungiwar: folds 
trip314: folds 
Acedan1369: folds 
12bwb3: folds 
Uncalled bet ($0.05) returned to greenthum33
greenthum33 collected $0.10 from pot
greenthum33: doesn't show hand 
*** SUMMARY ***
Total pot $0.10 | Rake $0 
Seat 1: 12bwb3 (small blind) folded before Flop
Seat 2: greenthum33 (big blind) collected ($0.10)
Seat 3: CvB85 folded before Flop (didn't bet)
Seat 4: ungiwar folded before Flop (didn't bet)
Seat 5: trip314 folded before Flop (didn't bet)
Seat 6: Acedan1369 (button) folded before Flop (didn't bet)



PokerStars Hand #222966137185:  Hold'em No Limit ($0.05/$0.10 USD) - 2021/01/23 14:22:25 ET
Table 'Capricorn III' 6-max Seat #1 is the button
Seat 1: 12bwb3 ($5.82 in chips) 
Seat 2: greenthum33 ($12.96 in chips) 
Seat 3: CvB85 ($10.99 in chips) 
Seat 4: ungiwar ($2.96 in chips) 
Seat 5: trip314 ($10.13 in chips) 
Seat 6: Acedan1369 ($12.63 in chips) 
greenthum33: posts small blind $0.05
CvB85: posts big blind $0.10
*** HOLE CARDS ***
ungiwar: folds 
trip314: raises $0.20 to $0.30
Acedan1369: folds 
12bwb3: calls $0.30
greenthum33: folds 
CvB85: folds 
*** FLOP *** [5h 7s 6d]
trip314: checks 
12bwb3: checks 
*** TURN *** [5h 7s 6d] [Js]
trip314: bets $0.24
12bwb3: folds 
Uncalled bet ($0.24) returned to trip314
trip314 collected $0.72 from pot
trip314: doesn't show hand 
*** SUMMARY ***
Total pot $0.75 | Rake $0.03 
Board [5h 7s 6d Js]
Seat 1: 12bwb3 (button) folded on the Turn
Seat 2: greenthum33 (small blind) folded before Flop
Seat 3: CvB85 (big blind) folded before Flop
Seat 4: ungiwar folded before Flop (didn't bet)
Seat 5: trip314 collected ($0.72)
Seat 6: Acedan1369 folded before Flop (didn't bet)



PokerStars Hand #222966169852:  Hold'em No Limit ($0.05/$0.10 USD) - 2021/01/23 14:23:06 ET
Table 'Capricorn III' 6-max Seat #2 is the button
Seat 1: 12bwb3 ($5.52 in chips) 
Seat 2: greenthum33 ($12.91 in chips) 
Seat 3: CvB85 ($10.89 in chips) 
Seat 4: ungiwar ($2.96 in chips) 
Seat 5: trip314 ($10.55 in chips) 
Seat 6: Acedan1369 ($12.63 in chips) 
CvB85: posts small blind $0.05
ungiwar: posts big blind $0.10
*** HOLE CARDS ***
trip314: folds 
Acedan1369: folds 
12bwb3: folds 
greenthum33: raises $0.20 to $0.30
CvB85: calls $0.25
ungiwar: raises $2.66 to $2.96 and is all-in
greenthum33: folds 
CvB85: calls $2.66
*** FLOP *** [As 5c 6h]
*** TURN *** [As 5c 6h] [4c]
*** RIVER *** [As 5c 6h 4c] [3s]
*** SHOW DOWN ***
CvB85: shows [2h 2s] (a straight, Deuce to Six)
ungiwar: shows [Qh Kd] (high card Ace)
CvB85 collected $5.94 from pot
*** SUMMARY ***
Total pot $6.22 | Rake $0.28 
Board [As 5c 6h 4c 3s]
Seat 1: 12bwb3 folded before Flop (didn't bet)
Seat 2: greenthum33 (button) folded before Flop
Seat 3: CvB85 (small blind) showed [2h 2s] and won ($5.94) with a straight, Deuce to Six
Seat 4: ungiwar (big blind) showed [Qh Kd] and lost with high card Ace
Seat 5: trip314 folded before Flop (didn't bet)
Seat 6: Acedan1369 folded before Flop (didn't bet)



PokerStars Hand #222966230366:  Hold'em No Limit ($0.05/$0.10 USD) - 2021/01/23 14:24:24 ET
Table 'Capricorn III' 6-max Seat #3 is the button
Seat 1: 12bwb3 ($5.52 in chips) 
Seat 2: greenthum33 ($12.61 in chips) 
Seat 3: CvB85 ($13.87 in chips) 
Seat 4: ungiwar ($4 in chips) 
Seat 5: trip314 ($10.55 in chips) 
Seat 6: Acedan1369 ($12.63 in chips) 
ungiwar: posts small blind $0.05
trip314: posts big blind $0.10
*** HOLE CARDS ***
Acedan1369: folds 
12bwb3: raises $0.10 to $0.20
greenthum33: calls $0.20
CvB85: folds 
ungiwar: calls $0.15
trip314: folds 
*** FLOP *** [7h 9d Tc]
ungiwar: checks 
12bwb3: checks 
greenthum33: bets $0.34
ungiwar: raises $1.02 to $1.36
12bwb3: folds 
greenthum33: folds 
Uncalled bet ($1.02) returned to ungiwar
ungiwar collected $1.32 from pot
ungiwar: doesn't show hand 
*** SUMMARY ***
Total pot $1.38 | Rake $0.06 
Board [7h 9d Tc]
Seat 1: 12bwb3 folded on the Flop
Seat 2: greenthum33 folded on the Flop
Seat 3: CvB85 (button) folded before Flop (didn't bet)
Seat 4: ungiwar (small blind) collected ($1.32)
Seat 5: trip314 (big blind) folded before Flop
Seat 6: Acedan1369 folded before Flop (didn't bet)



PokerStars Hand #222966276072:  Hold'em No Limit ($0.05/$0.10 USD) - 2021/01/23 14:25:22 ET
Table 'Capricorn III' 6-max Seat #4 is the button
Seat 1: 12bwb3 ($5.32 in chips) 
Seat 2: greenthum33 ($12.07 in chips) 
Seat 3: CvB85 ($13.87 in chips) 
Seat 4: ungiwar ($4.78 in chips) 
Seat 5: trip314 ($10.45 in chips) 
Seat 6: Acedan1369 ($12.63 in chips) 
trip314: posts small blind $0.05
Acedan1369: posts big blind $0.10
*** HOLE CARDS ***
12bwb3: folds 
greenthum33: folds 
CvB85: folds 
ungiwar: folds 
trip314: raises $0.15 to $0.25
Acedan1369: raises $0.60 to $0.85
12bwb3 leaves the table
trip314: raises $1.55 to $2.40
Pegas499 joins the table at seat #1 
Acedan1369: folds 
Uncalled bet ($1.55) returned to trip314
trip314 collected $1.70 from pot
trip314: doesn't show hand 
*** SUMMARY ***
Total pot $1.70 | Rake $0 
Seat 1: 12bwb3 folded before Flop (didn't bet)
Seat 2: greenthum33 folded before Flop (didn't bet)
Seat 3: CvB85 folded before Flop (didn't bet)
Seat 4: ungiwar (button) folded before Flop (didn't bet)
Seat 5: trip314 (small blind) collected ($1.70)
Seat 6: Acedan1369 (big blind) folded before Flop



PokerStars Hand #222966322935:  Hold'em No Limit ($0.05/$0.10 USD) - 2021/01/23 14:26:23 ET
Table 'Capricorn III' 6-max Seat #5 is the button
Seat 1: Pegas499 ($10 in chips) 
Seat 2: greenthum33 ($12.07 in chips) 
Seat 3: CvB85 ($13.87 in chips) 
Seat 4: ungiwar ($4.78 in chips) 
Seat 5: trip314 ($11.30 in chips) 
Seat 6: Acedan1369 ($11.78 in chips) 
Acedan1369: posts small blind $0.05
Pegas499: posts big blind $0.10
*** HOLE CARDS ***
greenthum33: raises $0.20 to $0.30
CvB85: folds 
ungiwar: folds 
trip314: folds 
Acedan1369: folds 
Pegas499: calls $0.20
*** FLOP *** [5h Ad 4c]
Pegas499: checks 
greenthum33: bets $0.30
Pegas499: calls $0.30
*** TURN *** [5h Ad 4c] [7h]
Pegas499: bets $0.10
greenthum33: calls $0.10
*** RIVER *** [5h Ad 4c 7h] [Jc]
Pegas499: bets $0.10
greenthum33: calls $0.10
*** SHOW DOWN ***
Pegas499: shows [7s 5c] (two pair, Sevens and Fives)
greenthum33: mucks hand 
Pegas499 collected $1.58 from pot
*** SUMMARY ***
Total pot $1.65 | Rake $0.07 
Board [5h Ad 4c 7h Jc]
Seat 1: Pegas499 (big blind) showed [7s 5c] and won ($1.58) with two pair, Sevens and Fives
Seat 2: greenthum33 mucked
Seat 3: CvB85 folded before Flop (didn't bet)
Seat 4: ungiwar folded before Flop (didn't bet)
Seat 5: trip314 (button) folded before Flop (didn't bet)
Seat 6: Acedan1369 (small blind) folded before Flop



PokerStars Hand #222966358682:  Hold'em No Limit ($0.05/$0.10 USD) - 2021/01/23 14:27:09 ET
Table 'Capricorn III' 6-max Seat #6 is the button
Seat 1: Pegas499 ($10.78 in chips) 
Seat 2: greenthum33 ($11.27 in chips) 
Seat 3: CvB85 ($13.87 in chips) 
Seat 4: ungiwar ($4.78 in chips) 
Seat 5: trip314 ($11.30 in chips) 
Seat 6: Acedan1369 ($11.73 in chips) 
Pegas499: posts small blind $0.05
greenthum33: posts big blind $0.10
*** HOLE CARDS ***
CvB85: folds 
ungiwar: folds 
trip314: folds 
Acedan1369: folds 
Pegas499: calls $0.05
greenthum33: checks 
*** FLOP *** [Kc 7c 6c]
Pegas499: checks 
greenthum33: checks 
*** TURN *** [Kc 7c 6c] [4c]
Pegas499: checks 
greenthum33: checks 
*** RIVER *** [Kc 7c 6c 4c] [9s]
Pegas499: checks 
greenthum33: checks 
*** SHOW DOWN ***
Pegas499: shows [7d 9c] (a flush, King high)
greenthum33: mucks hand 
Pegas499 collected $0.19 from pot
*** SUMMARY ***
Total pot $0.20 | Rake $0.01 
Board [Kc 7c 6c 4c 9s]
Seat 1: Pegas499 (small blind) showed [7d 9c] and won ($0.19) with a flush, King high
Seat 2: greenthum33 (big blind) mucked
Seat 3: CvB85 folded before Flop (didn't bet)
Seat 4: ungiwar folded before Flop (didn't bet)
Seat 5: trip314 folded before Flop (didn't bet)
Seat 6: Acedan1369 (button) folded before Flop (didn't bet)



PokerStars Hand #222966386733:  Hold'em No Limit ($0.05/$0.10 USD) - 2021/01/23 14:27:38 ET
Table 'Capricorn III' 6-max Seat #1 is the button
Seat 1: Pegas499 ($10.87 in chips) 
Seat 2: greenthum33 ($11.17 in chips) 
Seat 3: CvB85 ($13.87 in chips) 
Seat 4: ungiwar ($4.78 in chips) 
Seat 5: trip314 ($11.30 in chips) 
Seat 6: Acedan1369 ($11.73 in chips) 
greenthum33: posts small blind $0.05
CvB85: posts big blind $0.10
*** HOLE CARDS ***
ungiwar: folds 
trip314: folds 
Acedan1369: folds 
Pegas499: calls $0.10
greenthum33: calls $0.05
CvB85: checks 
*** FLOP *** [Ts 6h 7c]
greenthum33: checks 
CvB85: checks 
Pegas499: bets $0.40
greenthum33: calls $0.40
CvB85: folds 
*** TURN *** [Ts 6h 7c] [Kh]
greenthum33: checks 
Pegas499: bets $0.40
greenthum33: calls $0.40
*** RIVER *** [Ts 6h 7c Kh] [Jd]
greenthum33: checks 
Pegas499: bets $0.30
greenthum33: folds 
Uncalled bet ($0.30) returned to Pegas499
Pegas499 collected $1.81 from pot
Pegas499: doesn't show hand 
*** SUMMARY ***
Total pot $1.90 | Rake $0.09 
Board [Ts 6h 7c Kh Jd]
Seat 1: Pegas499 (button) collected ($1.81)
Seat 2: greenthum33 (small blind) folded on the River
Seat 3: CvB85 (big blind) folded on the Flop
Seat 4: ungiwar folded before Flop (didn't bet)
Seat 5: trip314 folded before Flop (didn't bet)
Seat 6: Acedan1369 folded before Flop (didn't bet)



PokerStars Hand #222966427954:  Hold'em No Limit ($0.05/$0.10 USD) - 2021/01/23 14:28:31 ET
Table 'Capricorn III' 6-max Seat #2 is the button
Seat 1: Pegas499 ($11.78 in chips) 
Seat 2: greenthum33 ($10.27 in chips) 
Seat 3: CvB85 ($13.77 in chips) 
Seat 4: ungiwar ($4.78 in chips) 
Seat 5: trip314 ($11.30 in chips) 
Seat 6: Acedan1369 ($11.73 in chips) 
CvB85: posts small blind $0.05
ungiwar: posts big blind $0.10
*** HOLE CARDS ***
trip314: folds 
Acedan1369: folds 
Pegas499: calls $0.10
greenthum33: calls $0.10
CvB85: calls $0.05
ungiwar: checks 
*** FLOP *** [7c 3c 4d]
CvB85: checks 
ungiwar: checks 
Pegas499: checks 
greenthum33: checks 
*** TURN *** [7c 3c 4d] [Jd]
CvB85: checks 
ungiwar: checks 
Pegas499: checks 
greenthum33: checks 
*** RIVER *** [7c 3c 4d Jd] [6h]
CvB85: checks 
ungiwar: checks 
Pegas499: checks 
greenthum33: checks 
*** SHOW DOWN ***
CvB85: shows [Kh 4c] (a pair of Fours)
ungiwar: shows [7s 5d] (a straight, Three to Seven)
Pegas499: mucks hand 
greenthum33: mucks hand 
ungiwar collected $0.38 from pot
*** SUMMARY ***
Total pot $0.40 | Rake $0.02 
Board [7c 3c 4d Jd 6h]
Seat 1: Pegas499 mucked
Seat 2: greenthum33 (button) mucked
Seat 3: CvB85 (small blind) showed [Kh 4c] and lost with a pair of Fours
Seat 4: ungiwar (big blind) showed [7s 5d] and won ($0.38) with a straight, Three to Seven
Seat 5: trip314 folded before Flop (didn't bet)
Seat 6: Acedan1369 folded before Flop (didn't bet)



PokerStars Hand #222966462874:  Hold'em No Limit ($0.05/$0.10 USD) - 2021/01/23 14:29:17 ET
Table 'Capricorn III' 6-max Seat #3 is the button
Seat 1: Pegas499 ($11.68 in chips) 
Seat 2: greenthum33 ($10.17 in chips) 
Seat 3: CvB85 ($13.67 in chips) 
Seat 4: ungiwar ($5.06 in chips) 
Seat 5: trip314 ($11.30 in chips) 
Seat 6: Acedan1369 ($11.73 in chips) 
ungiwar: posts small blind $0.05
trip314: posts big blind $0.10
*** HOLE CARDS ***
Acedan1369: folds 
Pegas499: raises $0.10 to $0.20
greenthum33: calls $0.20
CvB85: raises $0.75 to $0.95
ungiwar: folds 
trip314: folds 
Pegas499: calls $0.75
greenthum33: folds 
*** FLOP *** [4d 9d Qs]
greenthum33 leaves the table
Pegas499: bets $0.10
Dimitrii 30 joins the table at seat #2 
CvB85: raises $0.80 to $0.90
Pegas499: calls $0.80
*** TURN *** [4d 9d Qs] [9s]
Pegas499: checks 
CvB85: bets $1.94
Pegas499: calls $1.94
*** RIVER *** [4d 9d Qs 9s] [2d]
Pegas499: bets $0.60
CvB85: calls $0.60
*** SHOW DOWN ***
Pegas499: shows [Jd Qd] (a flush, Queen high)
CvB85: mucks hand 
Pegas499 collected $8.72 from pot
*** SUMMARY ***
Total pot $9.13 | Rake $0.41 
Board [4d 9d Qs 9s 2d]
Seat 1: Pegas499 showed [Jd Qd] and won ($8.72) with a flush, Queen high
Seat 2: greenthum33 folded before Flop
Seat 3: CvB85 (button) mucked
Seat 4: ungiwar (small blind) folded before Flop
Seat 5: trip314 (big blind) folded before Flop
Seat 6: Acedan1369 folded before Flop (didn't bet)



PokerStars Hand #222966540916:  Hold'em No Limit ($0.05/$0.10 USD) - 2021/01/23 14:30:45 ET
Table 'Capricorn III' 6-max Seat #4 is the button
Seat 1: Pegas499 ($16.01 in chips) 
Seat 3: CvB85 ($9.28 in chips) 
Seat 4: ungiwar ($5.01 in chips) 
Seat 5: trip314 ($11.20 in chips) 
Seat 6: Acedan1369 ($11.73 in chips) 
trip314: posts small blind $0.05
Acedan1369: posts big blind $0.10
Dimitrii 30: sits out 
*** HOLE CARDS ***
Pegas499: calls $0.10
CvB85: folds 
ungiwar: folds 
trip314: raises $0.30 to $0.40
Acedan1369: folds 
Pegas499: calls $0.30
*** FLOP *** [4s 8s 6c]
trip314: checks 
Pegas499: checks 
*** TURN *** [4s 8s 6c] [Kh]
trip314: bets $0.43
Pegas499: folds 
Uncalled bet ($0.43) returned to trip314
trip314 collected $0.86 from pot
trip314: doesn't show hand 
*** SUMMARY ***
Total pot $0.90 | Rake $0.04 
Board [4s 8s 6c Kh]
Seat 1: Pegas499 folded on the Turn
Seat 3: CvB85 folded before Flop (didn't bet)
Seat 4: ungiwar (button) folded before Flop (didn't bet)
Seat 5: trip314 (small blind) collected ($0.86)
Seat 6: Acedan1369 (big blind) folded before Flop



PokerStars Hand #222966572180:  Hold'em No Limit ($0.05/$0.10 USD) - 2021/01/23 14:31:25 ET
Table 'Capricorn III' 6-max Seat #5 is the button
Seat 1: Pegas499 ($15.61 in chips) 
Seat 3: CvB85 ($9.28 in chips) 
Seat 4: ungiwar ($5.01 in chips) 
Seat 5: trip314 ($11.66 in chips) 
Seat 6: Acedan1369 ($11.63 in chips) 
Acedan1369: posts small blind $0.05
Pegas499: posts big blind $0.10
Dimitrii 30: sits out 
*** HOLE CARDS ***
CvB85: raises $0.20 to $0.30
ungiwar: folds 
trip314: folds 
Acedan1369: folds 
Pegas499: calls $0.20
*** FLOP *** [Kc 5h Ts]
Pegas499: checks 
CvB85: bets $0.31
Pegas499: folds 
Uncalled bet ($0.31) returned to CvB85
CvB85 collected $0.62 from pot
CvB85: doesn't show hand 
*** SUMMARY ***
Total pot $0.65 | Rake $0.03 
Board [Kc 5h Ts]
Seat 1: Pegas499 (big blind) folded on the Flop
Seat 3: CvB85 collected ($0.62)
Seat 4: ungiwar folded before Flop (didn't bet)
Seat 5: trip314 (button) folded before Flop (didn't bet)
Seat 6: Acedan1369 (small blind) folded before Flop



PokerStars Hand #222966590256:  Hold'em No Limit ($0.05/$0.10 USD) - 2021/01/23 14:31:48 ET
Table 'Capricorn III' 6-max Seat #6 is the button
Seat 1: Pegas499 ($15.31 in chips) 
Seat 2: Dimitrii 30 ($8 in chips) 
Seat 3: CvB85 ($9.60 in chips) 
Seat 4: ungiwar ($5.01 in chips) 
Seat 5: trip314 ($11.66 in chips) 
Seat 6: Acedan1369 ($11.58 in chips) 
Pegas499: posts small blind $0.05
Dimitrii 30: posts big blind $0.10
*** HOLE CARDS ***
CvB85: folds 
ungiwar: raises $0.10 to $0.20
trip314: folds 
Acedan1369: folds 
Pegas499: folds 
Dimitrii 30: folds 
Uncalled bet ($0.10) returned to ungiwar
ungiwar collected $0.25 from pot
ungiwar: doesn't show hand 
*** SUMMARY ***
Total pot $0.25 | Rake $0 
Seat 1: Pegas499 (small blind) folded before Flop
Seat 2: Dimitrii 30 (big blind) folded before Flop
Seat 3: CvB85 folded before Flop (didn't bet)
Seat 4: ungiwar collected ($0.25)
Seat 5: trip314 folded before Flop (didn't bet)
Seat 6: Acedan1369 (button) folded before Flop (didn't bet)



PokerStars Hand #222966600028:  Hold'em No Limit ($0.05/$0.10 USD) - 2021/01/23 14:32:01 ET
Table 'Capricorn III' 6-max Seat #1 is the button
Seat 1: Pegas499 ($15.26 in chips) 
Seat 2: Dimitrii 30 ($8 in chips) 
Seat 3: CvB85 ($9.60 in chips) 
Seat 4: ungiwar ($5.16 in chips) 
Seat 5: trip314 ($11.66 in chips) 
Seat 6: Acedan1369 ($11.58 in chips) 
Dimitrii 30: posts small blind $0.05
CvB85: posts big blind $0.10
*** HOLE CARDS ***
ungiwar: raises $0.10 to $0.20
trip314: folds 
Acedan1369: raises $0.65 to $0.85
Pegas499: calls $0.85
Dimitrii 30: folds 
CvB85: folds 
ungiwar: folds 
*** FLOP *** [Jc 8d 5s]
Acedan1369: checks 
Pegas499: checks 
*** TURN *** [Jc 8d 5s] [7s]
Acedan1369: bets $1.47
Pegas499: folds 
Uncalled bet ($1.47) returned to Acedan1369
Acedan1369 collected $1.96 from pot
Acedan1369: doesn't show hand 
*** SUMMARY ***
Total pot $2.05 | Rake $0.09 
Board [Jc 8d 5s 7s]
Seat 1: Pegas499 (button) folded on the Turn
Seat 2: Dimitrii 30 (small blind) folded before Flop
Seat 3: CvB85 (big blind) folded before Flop
Seat 4: ungiwar folded before Flop
Seat 5: trip314 folded before Flop (didn't bet)
Seat 6: Acedan1369 collected ($1.96)



PokerStars Hand #222966924984:  Hold'em No Limit ($0.05/$0.10 USD) - 2021/01/23 14:38:55 ET
Table 'Capricorn III' 6-max Seat #3 is the button
Seat 1: Tyrer29 ($10 in chips) 
Seat 2: Dimitrii 30 ($9.49 in chips) 
Seat 3: CvB85 ($6.95 in chips) 
Seat 4: ungiwar ($4.99 in chips) 
Seat 6: Acedan1369 ($23.63 in chips) 
ungiwar: posts small blind $0.05
Acedan1369: posts big blind $0.10
*** HOLE CARDS ***
Tyrer29: folds 
Dimitrii 30: folds 
CvB85: raises $0.20 to $0.30
ungiwar: folds 
Acedan1369: folds 
Uncalled bet ($0.20) returned to CvB85
CvB85 collected $0.25 from pot
CvB85: doesn't show hand 
*** SUMMARY ***
Total pot $0.25 | Rake $0 
Seat 1: Tyrer29 folded before Flop (didn't bet)
Seat 2: Dimitrii 30 folded before Flop (didn't bet)
Seat 3: CvB85 (button) collected ($0.25)
Seat 4: ungiwar (small blind) folded before Flop
Seat 6: Acedan1369 (big blind) folded before Flop



PokerStars Hand #222966937524:  Hold'em No Limit ($0.05/$0.10 USD) - 2021/01/23 14:39:11 ET
Table 'Capricorn III' 6-max Seat #4 is the button
Seat 1: Tyrer29 ($10 in chips) 
Seat 2: Dimitrii 30 ($9.49 in chips) 
Seat 3: CvB85 ($7.10 in chips) 
Seat 4: ungiwar ($4.94 in chips) 
Seat 6: Acedan1369 ($23.53 in chips) 
Acedan1369: posts small blind $0.05
Tyrer29: posts big blind $0.10
*** HOLE CARDS ***
Dimitrii 30: folds 
CvB85: folds 
ungiwar: raises $0.10 to $0.20
Acedan1369: folds 
Tyrer29: calls $0.10
*** FLOP *** [Ts 5h Th]
Tyrer29: checks 
ungiwar: bets $0.15
Tyrer29: folds 
Uncalled bet ($0.15) returned to ungiwar
ungiwar collected $0.43 from pot
ungiwar: doesn't show hand 
*** SUMMARY ***
Total pot $0.45 | Rake $0.02 
Board [Ts 5h Th]
Seat 1: Tyrer29 (big blind) folded on the Flop
Seat 2: Dimitrii 30 folded before Flop (didn't bet)
Seat 3: CvB85 folded before Flop (didn't bet)
Seat 4: ungiwar (button) collected ($0.43)
Seat 6: Acedan1369 (small blind) folded before Flop



PokerStars Hand #222966967031:  Hold'em No Limit ($0.05/$0.10 USD) - 2021/01/23 14:39:49 ET
Table 'Capricorn III' 6-max Seat #6 is the button
Seat 1: Tyrer29 ($10 in chips) 
Seat 2: Dimitrii 30 ($9.49 in chips) 
Seat 3: CvB85 ($7.10 in chips) 
Seat 4: ungiwar ($5.17 in chips) 
Seat 6: Acedan1369 ($23.48 in chips) 
Tyrer29: posts small blind $0.05
Dimitrii 30: posts big blind $0.10
trip314: sits out 
*** HOLE CARDS ***
CvB85: raises $0.20 to $0.30
ungiwar: folds 
Acedan1369: folds 
Tyrer29: folds 
Dimitrii 30: folds 
Uncalled bet ($0.20) returned to CvB85
CvB85 collected $0.25 from pot
CvB85: doesn't show hand 
*** SUMMARY ***
Total pot $0.25 | Rake $0 
Seat 1: Tyrer29 (small blind) folded before Flop
Seat 2: Dimitrii 30 (big blind) folded before Flop
Seat 3: CvB85 collected ($0.25)
Seat 4: ungiwar folded before Flop (didn't bet)
Seat 6: Acedan1369 (button) folded before Flop (didn't bet)



PokerStars Hand #222966978116:  Hold'em No Limit ($0.05/$0.10 USD) - 2021/01/23 14:40:03 ET
Table 'Capricorn III' 6-max Seat #1 is the button
Seat 1: Tyrer29 ($10 in chips) 
Seat 2: Dimitrii 30 ($9.39 in chips) 
Seat 3: CvB85 ($7.25 in chips) 
Seat 4: ungiwar ($5.17 in chips) 
Seat 6: Acedan1369 ($23.48 in chips) 
Dimitrii 30: posts small blind $0.05
CvB85: posts big blind $0.10
trip314: sits out 
*** HOLE CARDS ***
ungiwar: folds 
Acedan1369: raises $0.15 to $0.25
Tyrer29: calls $0.25
Dimitrii 30: folds 
CvB85: calls $0.15
*** FLOP *** [Ah Jc Ts]
CvB85: checks 
Acedan1369: checks 
Tyrer29: checks 
*** TURN *** [Ah Jc Ts] [Kh]
CvB85: checks 
Acedan1369: checks 
Tyrer29: checks 
*** RIVER *** [Ah Jc Ts Kh] [4h]
CvB85: checks 
Acedan1369: checks 
Tyrer29: bets $0.42
CvB85: folds 
Acedan1369: folds 
Uncalled bet ($0.42) returned to Tyrer29
Tyrer29 collected $0.76 from pot
*** SUMMARY ***
Total pot $0.80 | Rake $0.04 
Board [Ah Jc Ts Kh 4h]
Seat 1: Tyrer29 (button) collected ($0.76)
Seat 2: Dimitrii 30 (small blind) folded before Flop
Seat 3: CvB85 (big blind) folded on the River
Seat 4: ungiwar folded before Flop (didn't bet)
Seat 6: Acedan1369 folded on the River



PokerStars Hand #222967031159:  Hold'em No Limit ($0.05/$0.10 USD) - 2021/01/23 14:41:11 ET
Table 'Capricorn III' 6-max Seat #2 is the button
Seat 1: Tyrer29 ($10.51 in chips) 
Seat 2: Dimitrii 30 ($9.34 in chips) 
Seat 3: CvB85 ($7 in chips) 
Seat 4: ungiwar ($5.17 in chips) 
Seat 6: Acedan1369 ($23.23 in chips) 
CvB85: posts small blind $0.05
ungiwar: posts big blind $0.10
trip314: sits out 
*** HOLE CARDS ***
Acedan1369: raises $0.15 to $0.25
Tyrer29: folds 
Dimitrii 30: folds 
CvB85: folds 
ungiwar: folds 
Uncalled bet ($0.15) returned to Acedan1369
Acedan1369 collected $0.25 from pot
Acedan1369: doesn't show hand 
*** SUMMARY ***
Total pot $0.25 | Rake $0 
Seat 1: Tyrer29 folded before Flop (didn't bet)
Seat 2: Dimitrii 30 (button) folded before Flop (didn't bet)
Seat 3: CvB85 (small blind) folded before Flop
Seat 4: ungiwar (big blind) folded before Flop
Seat 6: Acedan1369 collected ($0.25)



PokerStars Hand #222967051160:  Hold'em No Limit ($0.05/$0.10 USD) - 2021/01/23 14:41:36 ET
Table 'Capricorn III' 6-max Seat #3 is the button
Seat 1: Tyrer29 ($10.51 in chips) 
Seat 2: Dimitrii 30 ($9.34 in chips) 
Seat 3: CvB85 ($6.95 in chips) 
Seat 4: ungiwar ($5.07 in chips) 
Seat 5: trip314 ($11.51 in chips) 
Seat 6: Acedan1369 ($23.38 in chips) 
ungiwar: posts small blind $0.05
trip314: posts big blind $0.10
*** HOLE CARDS ***
Acedan1369: folds 
Tyrer29: folds 
Dimitrii 30: folds 
CvB85: raises $0.20 to $0.30
ungiwar: folds 
trip314: calls $0.20
*** FLOP *** [6h Td Kh]
trip314: checks 
CvB85: bets $0.40
trip314: calls $0.40
*** TURN *** [6h Td Kh] [Jc]
trip314: checks 
CvB85: bets $0.70
trip314: calls $0.70
*** RIVER *** [6h Td Kh Jc] [2h]
trip314: checks 
CvB85: checks 
*** SHOW DOWN ***
trip314: shows [8d Kd] (a pair of Kings)
CvB85: mucks hand 
trip314 collected $2.72 from pot
*** SUMMARY ***
Total pot $2.85 | Rake $0.13 
Board [6h Td Kh Jc 2h]
Seat 1: Tyrer29 folded before Flop (didn't bet)
Seat 2: Dimitrii 30 folded before Flop (didn't bet)
Seat 3: CvB85 (button) mucked
Seat 4: ungiwar (small blind) folded before Flop
Seat 5: trip314 (big blind) showed [8d Kd] and won ($2.72) with a pair of Kings
Seat 6: Acedan1369 folded before Flop (didn't bet)



PokerStars Hand #222967085867:  Hold'em No Limit ($0.05/$0.10 USD) - 2021/01/23 14:42:21 ET
Table 'Capricorn III' 6-max Seat #4 is the button
Seat 1: Tyrer29 ($10.51 in chips) 
Seat 2: Dimitrii 30 ($9.34 in chips) 
Seat 3: CvB85 ($5.55 in chips) 
Seat 4: ungiwar ($5.02 in chips) 
Seat 5: trip314 ($12.83 in chips) 
Seat 6: Acedan1369 ($23.38 in chips) 
trip314: posts small blind $0.05
Acedan1369: posts big blind $0.10
*** HOLE CARDS ***
Tyrer29: raises $0.15 to $0.25
Dimitrii 30: folds 
CvB85: folds 
ungiwar: folds 
trip314: folds 
Acedan1369: raises $0.60 to $0.85
Tyrer29: calls $0.60
*** FLOP *** [9s Ad 2h]
Acedan1369: bets $0.75
Tyrer29: calls $0.75
*** TURN *** [9s Ad 2h] [4c]
Acedan1369: bets $2.33
Tyrer29: folds 
Uncalled bet ($2.33) returned to Acedan1369
Acedan1369 collected $3.10 from pot
Acedan1369: doesn't show hand 
*** SUMMARY ***
Total pot $3.25 | Rake $0.15 
Board [9s Ad 2h 4c]
Seat 1: Tyrer29 folded on the Turn
Seat 2: Dimitrii 30 folded before Flop (didn't bet)
Seat 3: CvB85 folded before Flop (didn't bet)
Seat 4: ungiwar (button) folded before Flop (didn't bet)
Seat 5: trip314 (small blind) folded before Flop
Seat 6: Acedan1369 (big blind) collected ($3.10)



PokerStars Hand #222967130020:  Hold'em No Limit ($0.05/$0.10 USD) - 2021/01/23 14:43:17 ET
Table 'Capricorn III' 6-max Seat #5 is the button
Seat 2: Dimitrii 30 ($9.34 in chips) 
Seat 3: CvB85 ($5.55 in chips) 
Seat 4: ungiwar ($5.02 in chips) 
Seat 5: trip314 ($12.78 in chips) 
Seat 6: Acedan1369 ($24.88 in chips) 
Acedan1369: posts small blind $0.05
Tyrer29: is sitting out 
Dimitrii 30: posts big blind $0.10
*** HOLE CARDS ***
CvB85: folds 
ungiwar: raises $0.10 to $0.20
Tyrer29 leaves the table
trip314: folds 
Acedan1369: folds 
Dimitrii 30: folds 
Uncalled bet ($0.10) returned to ungiwar
ungiwar collected $0.25 from pot
ungiwar: doesn't show hand 
*** SUMMARY ***
Total pot $0.25 | Rake $0 
Seat 2: Dimitrii 30 (big blind) folded before Flop
Seat 3: CvB85 folded before Flop (didn't bet)
Seat 4: ungiwar collected ($0.25)
Seat 5: trip314 (button) folded before Flop (didn't bet)
Seat 6: Acedan1369 (small blind) folded before Flop



PokerStars Hand #222967138785:  Hold'em No Limit ($0.05/$0.10 USD) - 2021/01/23 14:43:28 ET
Table 'Capricorn III' 6-max Seat #6 is the button
Seat 2: Dimitrii 30 ($9.24 in chips) 
Seat 3: CvB85 ($5.55 in chips) 
Seat 4: ungiwar ($5.17 in chips) 
Seat 5: trip314 ($12.78 in chips) 
Seat 6: Acedan1369 ($24.83 in chips) 
Dimitrii 30: posts small blind $0.05
CvB85: posts big blind $0.10
*** HOLE CARDS ***
ungiwar: folds 
adilpoker84 joins the table at seat #1 
trip314: folds 
Acedan1369: folds 
Dimitrii 30: folds 
Uncalled bet ($0.05) returned to CvB85
CvB85 collected $0.10 from pot
CvB85: doesn't show hand 
*** SUMMARY ***
Total pot $0.10 | Rake $0 
Seat 2: Dimitrii 30 (small blind) folded before Flop
Seat 3: CvB85 (big blind) collected ($0.10)
Seat 4: ungiwar folded before Flop (didn't bet)
Seat 5: trip314 folded before Flop (didn't bet)
Seat 6: Acedan1369 (button) folded before Flop (didn't bet)



PokerStars Hand #222967152473:  Hold'em No Limit ($0.05/$0.10 USD) - 2021/01/23 14:43:46 ET
Table 'Capricorn III' 6-max Seat #2 is the button
Seat 1: adilpoker84 ($10 in chips) 
Seat 2: Dimitrii 30 ($9.19 in chips) 
Seat 3: CvB85 ($5.60 in chips) 
Seat 4: ungiwar ($5.17 in chips) 
Seat 5: trip314 ($12.78 in chips) 
Seat 6: Acedan1369 ($24.83 in chips) 
CvB85: posts small blind $0.05
ungiwar: posts big blind $0.10
adilpoker84: posts big blind $0.10
*** HOLE CARDS ***
trip314: folds 
Acedan1369: folds 
adilpoker84: checks 
Dimitrii 30: folds 
CvB85: folds 
ungiwar: checks 
*** FLOP *** [Ks 5c Ah]
ungiwar: checks 
adilpoker84: bets $0.10
ungiwar: folds 
Uncalled bet ($0.10) returned to adilpoker84
adilpoker84 collected $0.24 from pot
adilpoker84: doesn't show hand 
*** SUMMARY ***
Total pot $0.25 | Rake $0.01 
Board [Ks 5c Ah]
Seat 1: adilpoker84 collected ($0.24)
Seat 2: Dimitrii 30 (button) folded before Flop (didn't bet)
Seat 3: CvB85 (small blind) folded before Flop
Seat 4: ungiwar (big blind) folded on the Flop
Seat 5: trip314 folded before Flop (didn't bet)
Seat 6: Acedan1369 folded before Flop (didn't bet)



PokerStars Hand #222967166010:  Hold'em No Limit ($0.05/$0.10 USD) - 2021/01/23 14:44:03 ET
Table 'Capricorn III' 6-max Seat #3 is the button
Seat 1: adilpoker84 ($10.14 in chips) 
Seat 2: Dimitrii 30 ($9.19 in chips) 
Seat 3: CvB85 ($5.55 in chips) 
Seat 4: ungiwar ($5.07 in chips) 
Seat 6: Acedan1369 ($24.83 in chips) 
ungiwar: posts small blind $0.05
trip314: is sitting out 
Acedan1369: posts big blind $0.10
*** HOLE CARDS ***
adilpoker84: raises $0.10 to $0.20
Dimitrii 30: folds 
CvB85: calls $0.20
ungiwar: folds 
Acedan1369: folds 
*** FLOP *** [Qc 2c 3s]
adilpoker84: bets $0.27
CvB85: calls $0.27
*** TURN *** [Qc 2c 3s] [5h]
adilpoker84: bets $0.60
CvB85: calls $0.60
*** RIVER *** [Qc 2c 3s 5h] [4c]
adilpoker84: bets $2.19
CvB85: folds 
Uncalled bet ($2.19) returned to adilpoker84
adilpoker84 collected $2.19 from pot
adilpoker84: doesn't show hand 
*** SUMMARY ***
Total pot $2.29 | Rake $0.10 
Board [Qc 2c 3s 5h 4c]
Seat 1: adilpoker84 collected ($2.19)
Seat 2: Dimitrii 30 folded before Flop (didn't bet)
Seat 3: CvB85 (button) folded on the River
Seat 4: ungiwar (small blind) folded before Flop
Seat 6: Acedan1369 (big blind) folded before Flop



PokerStars Hand #222967193704:  Hold'em No Limit ($0.05/$0.10 USD) - 2021/01/23 14:44:39 ET
Table 'Capricorn III' 6-max Seat #4 is the button
Seat 1: adilpoker84 ($11.26 in chips) 
Seat 2: Dimitrii 30 ($9.19 in chips) 
Seat 3: CvB85 ($4.48 in chips) 
Seat 4: ungiwar ($5.02 in chips) 
Seat 6: Acedan1369 ($24.73 in chips) 
Acedan1369: posts small blind $0.05
adilpoker84: posts big blind $0.10
*** HOLE CARDS ***
Dimitrii 30: folds 
CvB85: folds 
ungiwar: raises $0.10 to $0.20
Acedan1369: folds 
adilpoker84: calls $0.10
*** FLOP *** [8h 6c Ac]
adilpoker84: checks 
ungiwar: checks 
*** TURN *** [8h 6c Ac] [9d]
adilpoker84: checks 
ungiwar: checks 
*** RIVER *** [8h 6c Ac 9d] [8c]
adilpoker84: bets $0.10
ungiwar: raises $0.35 to $0.45
adilpoker84: folds 
Uncalled bet ($0.35) returned to ungiwar
ungiwar collected $0.62 from pot
ungiwar: doesn't show hand 
*** SUMMARY ***
Total pot $0.65 | Rake $0.03 
Board [8h 6c Ac 9d 8c]
Seat 1: adilpoker84 (big blind) folded on the River
Seat 2: Dimitrii 30 folded before Flop (didn't bet)
Seat 3: CvB85 folded before Flop (didn't bet)
Seat 4: ungiwar (button) collected ($0.62)
Seat 6: Acedan1369 (small blind) folded before Flop



PokerStars Hand #222967229268:  Hold'em No Limit ($0.05/$0.10 USD) - 2021/01/23 14:45:24 ET
Table 'Capricorn III' 6-max Seat #6 is the button
Seat 1: adilpoker84 ($10.96 in chips) 
Seat 2: Dimitrii 30 ($9.19 in chips) 
Seat 3: CvB85 ($4.48 in chips) 
Seat 4: ungiwar ($5.34 in chips) 
Seat 6: Acedan1369 ($24.68 in chips) 
adilpoker84: posts small blind $0.05
Dimitrii 30: posts big blind $0.10
*** HOLE CARDS ***
CvB85: folds 
ungiwar: folds 
Acedan1369: raises $0.15 to $0.25
adilpoker84: calls $0.20
Dimitrii 30: folds 
*** FLOP *** [5h 4s 3c]
adilpoker84: checks 
Acedan1369: bets $0.43
adilpoker84: folds 
Uncalled bet ($0.43) returned to Acedan1369
Acedan1369 collected $0.57 from pot
Acedan1369: doesn't show hand 
*** SUMMARY ***
Total pot $0.60 | Rake $0.03 
Board [5h 4s 3c]
Seat 1: adilpoker84 (small blind) folded on the Flop
Seat 2: Dimitrii 30 (big blind) folded before Flop
Seat 3: CvB85 folded before Flop (didn't bet)
Seat 4: ungiwar folded before Flop (didn't bet)
Seat 6: Acedan1369 (button) collected ($0.57)



PokerStars Hand #222967246797:  Hold'em No Limit ($0.05/$0.10 USD) - 2021/01/23 14:45:47 ET
Table 'Capricorn III' 6-max Seat #1 is the button
Seat 1: adilpoker84 ($10.71 in chips) 
Seat 2: Dimitrii 30 ($9.09 in chips) 
Seat 3: CvB85 ($4.48 in chips) 
Seat 4: ungiwar ($5.34 in chips) 
Seat 6: Acedan1369 ($25 in chips) 
Dimitrii 30: posts small blind $0.05
CvB85: posts big blind $0.10
*** HOLE CARDS ***
ungiwar: folds 
Acedan1369: raises $0.15 to $0.25
adilpoker84: folds 
Dimitrii 30: folds 
CvB85: folds 
Uncalled bet ($0.15) returned to Acedan1369
Acedan1369 collected $0.25 from pot
Acedan1369: doesn't show hand 
*** SUMMARY ***
Total pot $0.25 | Rake $0 
Seat 1: adilpoker84 (button) folded before Flop (didn't bet)
Seat 2: Dimitrii 30 (small blind) folded before Flop
Seat 3: CvB85 (big blind) folded before Flop
Seat 4: ungiwar folded before Flop (didn't bet)
Seat 6: Acedan1369 collected ($0.25)



PokerStars Hand #222967257372:  Hold'em No Limit ($0.05/$0.10 USD) - 2021/01/23 14:46:00 ET
Table 'Capricorn III' 6-max Seat #2 is the button
Seat 1: adilpoker84 ($10.71 in chips) 
Seat 2: Dimitrii 30 ($9.04 in chips) 
Seat 3: CvB85 ($4.38 in chips) 
Seat 4: ungiwar ($5.34 in chips) 
Seat 6: Acedan1369 ($25.15 in chips) 
CvB85: posts small blind $0.05
ungiwar: posts big blind $0.10
*** HOLE CARDS ***
Acedan1369: raises $0.15 to $0.25
adilpoker84: folds 
Dimitrii 30: folds 
CvB85: folds 
ungiwar: folds 
Uncalled bet ($0.15) returned to Acedan1369
trip314 leaves the table
Acedan1369 collected $0.25 from pot
Acedan1369: doesn't show hand 
*** SUMMARY ***
Total pot $0.25 | Rake $0 
Seat 1: adilpoker84 folded before Flop (didn't bet)
Seat 2: Dimitrii 30 (button) folded before Flop (didn't bet)
Seat 3: CvB85 (small blind) folded before Flop
Seat 4: ungiwar (big blind) folded before Flop
Seat 6: Acedan1369 collected ($0.25)



PokerStars Hand #222967263187:  Hold'em No Limit ($0.05/$0.10 USD) - 2021/01/23 14:46:08 ET
Table 'Capricorn III' 6-max Seat #3 is the button
Seat 1: adilpoker84 ($10.71 in chips) 
Seat 2: Dimitrii 30 ($9.04 in chips) 
Seat 3: CvB85 ($4.33 in chips) 
Seat 4: ungiwar ($5.24 in chips) 
Seat 6: Acedan1369 ($25.30 in chips) 
ungiwar: posts small blind $0.05
Acedan1369: posts big blind $0.10
*** HOLE CARDS ***
adilpoker84: raises $0.10 to $0.20
Dimitrii 30: folds 
CvB85: folds 
ochloch joins the table at seat #5 
ungiwar: folds 
Acedan1369: folds 
Uncalled bet ($0.10) returned to adilpoker84
adilpoker84 collected $0.25 from pot
adilpoker84: doesn't show hand 
*** SUMMARY ***
Total pot $0.25 | Rake $0 
Seat 1: adilpoker84 collected ($0.25)
Seat 2: Dimitrii 30 folded before Flop (didn't bet)
Seat 3: CvB85 (button) folded before Flop (didn't bet)
Seat 4: ungiwar (small blind) folded before Flop
Seat 6: Acedan1369 (big blind) folded before Flop



PokerStars Hand #222967274202:  Hold'em No Limit ($0.05/$0.10 USD) - 2021/01/23 14:46:22 ET
Table 'Capricorn III' 6-max Seat #4 is the button
Seat 1: adilpoker84 ($10.86 in chips) 
Seat 2: Dimitrii 30 ($9.04 in chips) 
Seat 3: CvB85 ($4.33 in chips) 
Seat 4: ungiwar ($5.19 in chips) 
Seat 6: Acedan1369 ($25.20 in chips) 
Acedan1369: posts small blind $0.05
adilpoker84: posts big blind $0.10
*** HOLE CARDS ***
Dimitrii 30: folds 
CvB85: folds 
ungiwar: raises $0.10 to $0.20
Acedan1369: folds 
adilpoker84: calls $0.10
*** FLOP *** [Th 7d Tc]
adilpoker84: checks 
ungiwar: bets $0.15
adilpoker84: calls $0.15
*** TURN *** [Th 7d Tc] [9s]
adilpoker84: checks 
ochloch leaves the table
ungiwar: bets $0.54
adilpoker84: folds 
Uncalled bet ($0.54) returned to ungiwar
ungiwar collected $0.72 from pot
ungiwar: doesn't show hand 
directto joins the table at seat #5 
*** SUMMARY ***
Total pot $0.75 | Rake $0.03 
Board [Th 7d Tc 9s]
Seat 1: adilpoker84 (big blind) folded on the Turn
Seat 2: Dimitrii 30 folded before Flop (didn't bet)
Seat 3: CvB85 folded before Flop (didn't bet)
Seat 4: ungiwar (button) collected ($0.72)
Seat 6: Acedan1369 (small blind) folded before Flop



PokerStars Hand #222967304939:  Hold'em No Limit ($0.05/$0.10 USD) - 2021/01/23 14:47:02 ET
Table 'Capricorn III' 6-max Seat #6 is the button
Seat 1: adilpoker84 ($10.51 in chips) 
Seat 2: Dimitrii 30 ($9.04 in chips) 
Seat 3: CvB85 ($4.33 in chips) 
Seat 4: ungiwar ($5.56 in chips) 
Seat 6: Acedan1369 ($25.15 in chips) 
adilpoker84: posts small blind $0.05
Dimitrii 30: posts big blind $0.10
directto: sits out 
*** HOLE CARDS ***
CvB85: raises $0.20 to $0.30
ungiwar: folds 
Acedan1369: folds 
adilpoker84: folds 
directto leaves the table
Dimitrii 30: folds 
Uncalled bet ($0.20) returned to CvB85
CvB85 collected $0.25 from pot
CvB85: doesn't show hand 
*** SUMMARY ***
Total pot $0.25 | Rake $0 
Seat 1: adilpoker84 (small blind) folded before Flop
Seat 2: Dimitrii 30 (big blind) folded before Flop
Seat 3: CvB85 collected ($0.25)
Seat 4: ungiwar folded before Flop (didn't bet)
Seat 6: Acedan1369 (button) folded before Flop (didn't bet)



PokerStars Hand #222967319544:  Hold'em No Limit ($0.05/$0.10 USD) - 2021/01/23 14:47:21 ET
Table 'Capricorn III' 6-max Seat #1 is the button
Seat 1: adilpoker84 ($10.46 in chips) 
Seat 2: Dimitrii 30 ($8.94 in chips) 
Seat 3: CvB85 ($4.48 in chips) 
Seat 4: ungiwar ($5.56 in chips) 
Seat 6: Acedan1369 ($25.15 in chips) 
Dimitrii 30: posts small blind $0.05
CvB85: posts big blind $0.10
*** HOLE CARDS ***
raydenel joins the table at seat #5 
ungiwar: folds 
Acedan1369: folds 
adilpoker84: raises $0.20 to $0.30
Dimitrii 30: raises $0.60 to $0.90
CvB85: calls $0.80
adilpoker84: calls $0.60
*** FLOP *** [4h 8h 3c]
Dimitrii 30: bets $1.29
CvB85: folds 
adilpoker84: calls $1.29
*** TURN *** [4h 8h 3c] [4s]
Dimitrii 30: bets $2.52
adilpoker84: calls $2.52
*** RIVER *** [4h 8h 3c 4s] [2d]
Dimitrii 30: checks 
adilpoker84: bets $1.80
Dimitrii 30: folds 
Uncalled bet ($1.80) returned to adilpoker84
adilpoker84 collected $9.86 from pot
adilpoker84: doesn't show hand 
*** SUMMARY ***
Total pot $10.32 | Rake $0.46 
Board [4h 8h 3c 4s 2d]
Seat 1: adilpoker84 (button) collected ($9.86)
Seat 2: Dimitrii 30 (small blind) folded on the River
Seat 3: CvB85 (big blind) folded on the Flop
Seat 4: ungiwar folded before Flop (didn't bet)
Seat 6: Acedan1369 folded before Flop (didn't bet)



PokerStars Hand #222967391704:  Hold'em No Limit ($0.05/$0.10 USD) - 2021/01/23 14:48:54 ET
Table 'Capricorn III' 6-max Seat #2 is the button
Seat 1: adilpoker84 ($15.61 in chips) 
Seat 2: Dimitrii 30 ($8 in chips) 
Seat 3: CvB85 ($3.58 in chips) 
Seat 4: ungiwar ($5.56 in chips) 
Seat 6: Acedan1369 ($25.15 in chips) 
CvB85: posts small blind $0.05
ungiwar: posts big blind $0.10
raydenel: sits out 
*** HOLE CARDS ***
Acedan1369: folds 
adilpoker84: calls $0.10
Dimitrii 30: folds 
CvB85: calls $0.05
ungiwar: checks 
*** FLOP *** [4s Kh Jd]
CvB85: checks 
ungiwar: checks 
adilpoker84: checks 
*** TURN *** [4s Kh Jd] [5d]
CvB85: checks 
ungiwar: checks 
adilpoker84: checks 
*** RIVER *** [4s Kh Jd 5d] [4d]
CvB85: bets $0.15
ungiwar: folds 
adilpoker84: folds 
Uncalled bet ($0.15) returned to CvB85
CvB85 collected $0.29 from pot
CvB85: doesn't show hand 
*** SUMMARY ***
Total pot $0.30 | Rake $0.01 
Board [4s Kh Jd 5d 4d]
Seat 1: adilpoker84 folded on the River
Seat 2: Dimitrii 30 (button) folded before Flop (didn't bet)
Seat 3: CvB85 (small blind) collected ($0.29)
Seat 4: ungiwar (big blind) folded on the River
Seat 6: Acedan1369 folded before Flop (didn't bet)



PokerStars Hand #222967422477:  Hold'em No Limit ($0.05/$0.10 USD) - 2021/01/23 14:49:34 ET
Table 'Capricorn III' 6-max Seat #3 is the button
Seat 1: adilpoker84 ($15.51 in chips) 
Seat 2: Dimitrii 30 ($8 in chips) 
Seat 3: CvB85 ($3.77 in chips) 
Seat 4: ungiwar ($5.46 in chips) 
Seat 5: raydenel ($10 in chips) 
Seat 6: Acedan1369 ($25.15 in chips) 
ungiwar: posts small blind $0.05
raydenel: posts big blind $0.10
*** HOLE CARDS ***
Acedan1369: raises $0.15 to $0.25
adilpoker84: calls $0.25
Dimitrii 30: folds 
CvB85: folds 
ungiwar: folds 
raydenel: folds 
*** FLOP *** [3d 4h 7h]
Acedan1369: checks 
adilpoker84: checks 
*** TURN *** [3d 4h 7h] [Jc]
Acedan1369: checks 
adilpoker84: checks 
*** RIVER *** [3d 4h 7h Jc] [6d]
Acedan1369: checks 
adilpoker84: checks 
*** SHOW DOWN ***
Acedan1369: shows [Qs Ts] (high card Queen)
adilpoker84: shows [As 8c] (high card Ace)
adilpoker84 collected $0.62 from pot
*** SUMMARY ***
Total pot $0.65 | Rake $0.03 
Board [3d 4h 7h Jc 6d]
Seat 1: adilpoker84 showed [As 8c] and won ($0.62) with high card Ace
Seat 2: Dimitrii 30 folded before Flop (didn't bet)
Seat 3: CvB85 (button) folded before Flop (didn't bet)
Seat 4: ungiwar (small blind) folded before Flop
Seat 5: raydenel (big blind) folded before Flop
Seat 6: Acedan1369 showed [Qs Ts] and lost with high card Queen



PokerStars Hand #222967452308:  Hold'em No Limit ($0.05/$0.10 USD) - 2021/01/23 14:50:12 ET
Table 'Capricorn III' 6-max Seat #4 is the button
Seat 1: adilpoker84 ($15.88 in chips) 
Seat 2: Dimitrii 30 ($8 in chips) 
Seat 3: CvB85 ($3.77 in chips) 
Seat 4: ungiwar ($5.41 in chips) 
Seat 5: raydenel ($10 in chips) 
Seat 6: Acedan1369 ($24.90 in chips) 
raydenel: posts small blind $0.05
Acedan1369: posts big blind $0.10
*** HOLE CARDS ***
adilpoker84: calls $0.10
Dimitrii 30: folds 
CvB85: raises $0.20 to $0.30
ungiwar: folds 
raydenel: folds 
Acedan1369: folds 
adilpoker84: folds 
Uncalled bet ($0.20) returned to CvB85
CvB85 collected $0.35 from pot
CvB85: doesn't show hand 
*** SUMMARY ***
Total pot $0.35 | Rake $0 
Seat 1: adilpoker84 folded before Flop
Seat 2: Dimitrii 30 folded before Flop (didn't bet)
Seat 3: CvB85 collected ($0.35)
Seat 4: ungiwar (button) folded before Flop (didn't bet)
Seat 5: raydenel (small blind) folded before Flop
Seat 6: Acedan1369 (big blind) folded before Flop



PokerStars Hand #222967464684:  Hold'em No Limit ($0.05/$0.10 USD) - 2021/01/23 14:50:29 ET
Table 'Capricorn III' 6-max Seat #5 is the button
Seat 1: adilpoker84 ($15.78 in chips) 
Seat 2: Dimitrii 30 ($8 in chips) 
Seat 3: CvB85 ($4.02 in chips) 
Seat 4: ungiwar ($5.41 in chips) 
Seat 5: raydenel ($10 in chips) 
Seat 6: Acedan1369 ($24.80 in chips) 
Acedan1369: posts small blind $0.05
adilpoker84: posts big blind $0.10
*** HOLE CARDS ***
Dimitrii 30: folds 
CvB85: raises $0.20 to $0.30
ungiwar: folds 
raydenel: folds 
Acedan1369: folds 
adilpoker84: calls $0.20
*** FLOP *** [Jd Td Qc]
adilpoker84: checks 
CvB85: bets $0.31
adilpoker84: calls $0.31
*** TURN *** [Jd Td Qc] [7c]
adilpoker84: checks 
CvB85: checks 
*** RIVER *** [Jd Td Qc 7c] [Kc]
adilpoker84: bets $0.70
CvB85: raises $1.31 to $2.01
adilpoker84: raises $13.16 to $15.17 and is all-in
CvB85: calls $1.40 and is all-in
Uncalled bet ($11.76) returned to adilpoker84
*** SHOW DOWN ***
adilpoker84: shows [9c 6c] (a flush, King high)
CvB85: shows [9s Ad] (a straight, Ten to Ace)
adilpoker84 collected $7.73 from pot
*** SUMMARY ***
Total pot $8.09 | Rake $0.36 
Board [Jd Td Qc 7c Kc]
Seat 1: adilpoker84 (big blind) showed [9c 6c] and won ($7.73) with a flush, King high
Seat 2: Dimitrii 30 folded before Flop (didn't bet)
Seat 3: CvB85 showed [9s Ad] and lost with a straight, Ten to Ace
Seat 4: ungiwar folded before Flop (didn't bet)
Seat 5: raydenel (button) folded before Flop (didn't bet)
Seat 6: Acedan1369 (small blind) folded before Flop



PokerStars Hand #222967506285:  Hold'em No Limit ($0.05/$0.10 USD) - 2021/01/23 14:51:23 ET
Table 'Capricorn III' 6-max Seat #6 is the button
Seat 1: adilpoker84 ($19.49 in chips) 
Seat 2: Dimitrii 30 ($8 in chips) 
Seat 4: ungiwar ($5.41 in chips) 
Seat 5: raydenel ($10 in chips) 
Seat 6: Acedan1369 ($24.75 in chips) 
adilpoker84: posts small blind $0.05
Dimitrii 30: posts big blind $0.10
*** HOLE CARDS ***
ungiwar: folds 
raydenel: folds 
CvB85 leaves the table
Acedan1369: raises $0.15 to $0.25
adilpoker84: folds 
Dimitrii 30: folds 
Uncalled bet ($0.15) returned to Acedan1369
Acedan1369 collected $0.25 from pot
Acedan1369: doesn't show hand 
*** SUMMARY ***
Total pot $0.25 | Rake $0 
Seat 1: adilpoker84 (small blind) folded before Flop
Seat 2: Dimitrii 30 (big blind) folded before Flop
Seat 4: ungiwar folded before Flop (didn't bet)
Seat 5: raydenel folded before Flop (didn't bet)
Seat 6: Acedan1369 (button) collected ($0.25)



PokerStars Hand #222967523639:  Hold'em No Limit ($0.05/$0.10 USD) - 2021/01/23 14:51:45 ET
Table 'Capricorn III' 6-max Seat #1 is the button
Seat 1: adilpoker84 ($19.44 in chips) 
Seat 2: Dimitrii 30 ($8 in chips) 
Seat 4: ungiwar ($5.41 in chips) 
Seat 5: raydenel ($10 in chips) 
Seat 6: Acedan1369 ($24.90 in chips) 
Dimitrii 30: posts small blind $0.05
ungiwar: posts big blind $0.10
*** HOLE CARDS ***
raydenel: folds 
Acedan1369: raises $0.15 to $0.25
adilpoker84: folds 
Dimitrii 30: folds 
ungiwar: folds 
Uncalled bet ($0.15) returned to Acedan1369
Jetam98 joins the table at seat #3 
Acedan1369 collected $0.25 from pot
Acedan1369: doesn't show hand 
*** SUMMARY ***
Total pot $0.25 | Rake $0 
Seat 1: adilpoker84 (button) folded before Flop (didn't bet)
Seat 2: Dimitrii 30 (small blind) folded before Flop
Seat 4: ungiwar (big blind) folded before Flop
Seat 5: raydenel folded before Flop (didn't bet)
Seat 6: Acedan1369 collected ($0.25)



PokerStars Hand #222967534432:  Hold'em No Limit ($0.05/$0.10 USD) - 2021/01/23 14:51:59 ET
Table 'Capricorn III' 6-max Seat #2 is the button
Seat 1: adilpoker84 ($19.44 in chips) 
Seat 2: Dimitrii 30 ($8 in chips) 
Seat 4: ungiwar ($5.31 in chips) 
Seat 5: raydenel ($10 in chips) 
Seat 6: Acedan1369 ($25.05 in chips) 
ungiwar: posts small blind $0.05
raydenel: posts big blind $0.10
*** HOLE CARDS ***
Acedan1369: folds 
adilpoker84: folds 
Dimitrii 30: folds 
ungiwar: folds 
Uncalled bet ($0.05) returned to raydenel
raydenel collected $0.10 from pot
raydenel: doesn't show hand 
*** SUMMARY ***
Total pot $0.10 | Rake $0 
Seat 1: adilpoker84 folded before Flop (didn't bet)
Seat 2: Dimitrii 30 (button) folded before Flop (didn't bet)
Seat 4: ungiwar (small blind) folded before Flop
Seat 5: raydenel (big blind) collected ($0.10)
Seat 6: Acedan1369 folded before Flop (didn't bet)



PokerStars Hand #222967539851:  Hold'em No Limit ($0.05/$0.10 USD) - 2021/01/23 14:52:06 ET
Table 'Capricorn III' 6-max Seat #4 is the button
Seat 1: adilpoker84 ($19.44 in chips) 
Seat 2: Dimitrii 30 ($8 in chips) 
Seat 3: Jetam98 ($8 in chips) 
Seat 4: ungiwar ($5.26 in chips) 
Seat 5: raydenel ($10.05 in chips) 
Seat 6: Acedan1369 ($25.05 in chips) 
raydenel: posts small blind $0.05
Acedan1369: posts big blind $0.10
Jetam98: posts big blind $0.10
*** HOLE CARDS ***
adilpoker84: folds 
Dimitrii 30: folds 
Jetam98: checks 
ungiwar: folds 
raydenel: calls $0.05
Acedan1369: raises $0.30 to $0.40
Jetam98: folds 
raydenel: folds 
Uncalled bet ($0.30) returned to Acedan1369
Acedan1369 collected $0.30 from pot
Acedan1369: doesn't show hand 
*** SUMMARY ***
Total pot $0.30 | Rake $0 
Seat 1: adilpoker84 folded before Flop (didn't bet)
Seat 2: Dimitrii 30 folded before Flop (didn't bet)
Seat 3: Jetam98 folded before Flop (didn't bet)
Seat 4: ungiwar (button) folded before Flop (didn't bet)
Seat 5: raydenel (small blind) folded before Flop
Seat 6: Acedan1369 (big blind) collected ($0.30)



PokerStars Hand #222967551604:  Hold'em No Limit ($0.05/$0.10 USD) - 2021/01/23 14:52:21 ET
Table 'Capricorn III' 6-max Seat #5 is the button
Seat 1: adilpoker84 ($19.44 in chips) 
Seat 2: Dimitrii 30 ($8 in chips) 
Seat 3: Jetam98 ($7.90 in chips) 
Seat 4: ungiwar ($5.26 in chips) 
Seat 5: raydenel ($10 in chips) 
Seat 6: Acedan1369 ($25.25 in chips) 
Acedan1369: posts small blind $0.05
adilpoker84: posts big blind $0.10
*** HOLE CARDS ***
Dimitrii 30: raises $0.15 to $0.25
Jetam98: calls $0.25
ungiwar: folds 
raydenel: folds 
Acedan1369: folds 
adilpoker84: folds 
*** FLOP *** [9d 4c 5c]
Dimitrii 30: bets $0.31
Jetam98: raises $0.31 to $0.62
Dimitrii 30: calls $0.31
*** TURN *** [9d 4c 5c] [Kd]
Dimitrii 30: bets $0.90
Jetam98: calls $0.90
*** RIVER *** [9d 4c 5c Kd] [2d]
Dimitrii 30: checks 
Jetam98: bets $6.13 and is all-in
Dimitrii 30: folds 
Uncalled bet ($6.13) returned to Jetam98
Jetam98 collected $3.52 from pot
Jetam98: doesn't show hand 
*** SUMMARY ***
Total pot $3.69 | Rake $0.17 
Board [9d 4c 5c Kd 2d]
Seat 1: adilpoker84 (big blind) folded before Flop
Seat 2: Dimitrii 30 folded on the River
Seat 3: Jetam98 collected ($3.52)
Seat 4: ungiwar folded before Flop (didn't bet)
Seat 5: raydenel (button) folded before Flop (didn't bet)
Seat 6: Acedan1369 (small blind) folded before Flop



PokerStars Hand #222967591918:  Hold'em No Limit ($0.05/$0.10 USD) - 2021/01/23 14:53:14 ET
Table 'Capricorn III' 6-max Seat #6 is the button
Seat 1: adilpoker84 ($19.34 in chips) 
Seat 2: Dimitrii 30 ($8 in chips) 
Seat 3: Jetam98 ($9.65 in chips) 
Seat 4: ungiwar ($5.26 in chips) 
Seat 5: raydenel ($10 in chips) 
Seat 6: Acedan1369 ($25.20 in chips) 
adilpoker84: posts small blind $0.05
Dimitrii 30: posts big blind $0.10
*** HOLE CARDS ***
Jetam98: folds 
ungiwar: folds 
raydenel: raises $0.20 to $0.30
Acedan1369: raises $0.55 to $0.85
adilpoker84: folds 
Dimitrii 30: folds 
raydenel: calls $0.55
*** FLOP *** [7c 5h 5c]
raydenel: checks 
Acedan1369: bets $1.33
raydenel: calls $1.33
*** TURN *** [7c 5h 5c] [5s]
raydenel: checks 
Acedan1369: bets $2
raydenel: calls $2
*** RIVER *** [7c 5h 5c 5s] [Ts]
raydenel: checks 
Acedan1369: bets $6.10
raydenel: folds 
Uncalled bet ($6.10) returned to Acedan1369
Acedan1369 collected $8.13 from pot
Acedan1369: doesn't show hand 
*** SUMMARY ***
Total pot $8.51 | Rake $0.38 
Board [7c 5h 5c 5s Ts]
Seat 1: adilpoker84 (small blind) folded before Flop
Seat 2: Dimitrii 30 (big blind) folded before Flop
Seat 3: Jetam98 folded before Flop (didn't bet)
Seat 4: ungiwar folded before Flop (didn't bet)
Seat 5: raydenel folded on the River
Seat 6: Acedan1369 (button) collected ($8.13)



PokerStars Hand #222967660424:  Hold'em No Limit ($0.05/$0.10 USD) - 2021/01/23 14:54:34 ET
Table 'Capricorn III' 6-max Seat #1 is the button
Seat 1: adilpoker84 ($19.29 in chips) 
Seat 2: Dimitrii 30 ($8 in chips) 
Seat 3: Jetam98 ($9.65 in chips) 
Seat 4: ungiwar ($5.26 in chips) 
Seat 5: raydenel ($10 in chips) 
Seat 6: Acedan1369 ($29.15 in chips) 
Dimitrii 30: posts small blind $0.05
Jetam98: posts big blind $0.10
*** HOLE CARDS ***
ungiwar: raises $0.10 to $0.20
raydenel: folds 
Acedan1369: folds 
adilpoker84: calls $0.20
Dimitrii 30: folds 
Jetam98: calls $0.10
*** FLOP *** [7h 8c 3s]
Jetam98: checks 
ungiwar: bets $0.31
adilpoker84: calls $0.31
Jetam98: calls $0.31
*** TURN *** [7h 8c 3s] [Qd]
Jetam98: checks 
ungiwar: checks 
adilpoker84: bets $0.50
Jetam98: raises $1.20 to $1.70
ungiwar: folds 
adilpoker84: calls $1.20
*** RIVER *** [7h 8c 3s Qd] [As]
Jetam98: bets $3.40
adilpoker84: raises $3.40 to $6.80
Jetam98: raises $0.64 to $7.44 and is all-in
adilpoker84: calls $0.64
*** SHOW DOWN ***
Jetam98: shows [Qs 3d] (two pair, Queens and Threes)
adilpoker84: shows [Qc Ac] (two pair, Aces and Queens)
adilpoker84 collected $18.97 from pot
*** SUMMARY ***
Total pot $19.86 | Rake $0.89 
Board [7h 8c 3s Qd As]
Seat 1: adilpoker84 (button) showed [Qc Ac] and won ($18.97) with two pair, Aces and Queens
Seat 2: Dimitrii 30 (small blind) folded before Flop
Seat 3: Jetam98 (big blind) showed [Qs 3d] and lost with two pair, Queens and Threes
Seat 4: ungiwar folded on the Turn
Seat 5: raydenel folded before Flop (didn't bet)
Seat 6: Acedan1369 folded before Flop (didn't bet)



PokerStars Hand #222967707046:  Hold'em No Limit ($0.05/$0.10 USD) - 2021/01/23 14:55:48 ET
Table 'Capricorn III' 6-max Seat #2 is the button
Seat 1: adilpoker84 ($28.61 in chips) 
Seat 2: Dimitrii 30 ($8 in chips) 
Seat 4: ungiwar ($4.75 in chips) 
Seat 5: raydenel ($10 in chips) 
Seat 6: Acedan1369 ($29.15 in chips) 
ungiwar: posts small blind $0.05
raydenel: posts big blind $0.10
*** HOLE CARDS ***
Acedan1369: folds 
adilpoker84: calls $0.10
Jetam98 leaves the table
Dimitrii 30: folds 
ungiwar: folds 
raydenel: checks 
*** FLOP *** [3d Ah 2d]
Vanozik19 joins the table at seat #3 
raydenel: checks 
adilpoker84: checks 
*** TURN *** [3d Ah 2d] [7d]
raydenel: checks 
adilpoker84: bets $0.10
raydenel: calls $0.10
*** RIVER *** [3d Ah 2d 7d] [8h]
raydenel: checks 
adilpoker84: bets $0.10
raydenel: folds 
Uncalled bet ($0.10) returned to adilpoker84
adilpoker84 collected $0.43 from pot
adilpoker84: doesn't show hand 
*** SUMMARY ***
Total pot $0.45 | Rake $0.02 
Board [3d Ah 2d 7d 8h]
Seat 1: adilpoker84 collected ($0.43)
Seat 2: Dimitrii 30 (button) folded before Flop (didn't bet)
Seat 4: ungiwar (small blind) folded before Flop
Seat 5: raydenel (big blind) folded on the River
Seat 6: Acedan1369 folded before Flop (didn't bet)



PokerStars Hand #222967737416:  Hold'em No Limit ($0.05/$0.10 USD) - 2021/01/23 14:56:45 ET
Table 'Capricorn III' 6-max Seat #4 is the button
Seat 1: adilpoker84 ($28.84 in chips) 
Seat 2: Dimitrii 30 ($8 in chips) 
Seat 4: ungiwar ($4.70 in chips) 
Seat 5: raydenel ($10 in chips) 
Seat 6: Acedan1369 ($29.15 in chips) 
raydenel: posts small blind $0.05
Acedan1369: posts big blind $0.10
Vanozik19: sits out 
*** HOLE CARDS ***
adilpoker84: raises $0.10 to $0.20
Dimitrii 30: folds 
ungiwar: calls $0.20
raydenel: folds 
Acedan1369: folds 
*** FLOP *** [Ts Qd 3c]
adilpoker84: bets $0.20
ungiwar: calls $0.20
*** TURN *** [Ts Qd 3c] [9c]
adilpoker84: bets $0.50
ungiwar: calls $0.50
*** RIVER *** [Ts Qd 3c 9c] [8c]
adilpoker84: bets $1.10
ungiwar: folds 
Uncalled bet ($1.10) returned to adilpoker84
adilpoker84 collected $1.86 from pot
adilpoker84: doesn't show hand 
*** SUMMARY ***
Total pot $1.95 | Rake $0.09 
Board [Ts Qd 3c 9c 8c]
Seat 1: adilpoker84 collected ($1.86)
Seat 2: Dimitrii 30 folded before Flop (didn't bet)
Seat 4: ungiwar (button) folded on the River
Seat 5: raydenel (small blind) folded before Flop
Seat 6: Acedan1369 (big blind) folded before Flop



PokerStars Hand #222967770071:  Hold'em No Limit ($0.05/$0.10 USD) - 2021/01/23 14:57:46 ET
Table 'Capricorn III' 6-max Seat #5 is the button
Seat 1: adilpoker84 ($29.80 in chips) 
Seat 2: Dimitrii 30 ($8 in chips) 
Seat 4: ungiwar ($3.80 in chips) 
Seat 5: raydenel ($10 in chips) 
Seat 6: Acedan1369 ($29.05 in chips) 
Acedan1369: posts small blind $0.05
adilpoker84: posts big blind $0.10
Vanozik19: sits out 
*** HOLE CARDS ***
Dimitrii 30: folds 
ungiwar: raises $0.10 to $0.20
raydenel: folds 
Acedan1369: folds 
adilpoker84: calls $0.10
*** FLOP *** [7h 2h 7s]
adilpoker84: checks 
ungiwar: bets $0.15
adilpoker84: calls $0.15
*** TURN *** [7h 2h 7s] [Ad]
adilpoker84: checks 
ungiwar: checks 
*** RIVER *** [7h 2h 7s Ad] [8h]
adilpoker84: bets $0.70
ungiwar: calls $0.70
*** SHOW DOWN ***
adilpoker84: shows [7c 8d] (a full house, Sevens full of Eights)
ungiwar: mucks hand 
adilpoker84 collected $2.05 from pot
*** SUMMARY ***
Total pot $2.15 | Rake $0.10 
Board [7h 2h 7s Ad 8h]
Seat 1: adilpoker84 (big blind) showed [7c 8d] and won ($2.05) with a full house, Sevens full of Eights
Seat 2: Dimitrii 30 folded before Flop (didn't bet)
Seat 4: ungiwar mucked
Seat 5: raydenel (button) folded before Flop (didn't bet)
Seat 6: Acedan1369 (small blind) folded before Flop



PokerStars Hand #222967789994:  Hold'em No Limit ($0.05/$0.10 USD) - 2021/01/23 14:58:23 ET
Table 'Capricorn III' 6-max Seat #6 is the button
Seat 1: adilpoker84 ($30.80 in chips) 
Seat 2: Dimitrii 30 ($8 in chips) 
Seat 4: ungiwar ($2.75 in chips) 
Seat 5: raydenel ($10 in chips) 
Seat 6: Acedan1369 ($29 in chips) 
adilpoker84: posts small blind $0.05
Dimitrii 30: posts big blind $0.10
Vanozik19: sits out 
*** HOLE CARDS ***
ungiwar: folds 
raydenel: raises $0.15 to $0.25
Acedan1369: folds 
adilpoker84: folds 
Dimitrii 30: calls $0.15
*** FLOP *** [Ts 6h 5c]
Dimitrii 30: checks 
raydenel: checks 
*** TURN *** [Ts 6h 5c] [3d]
Dimitrii 30: checks 
raydenel: bets $0.27
Dimitrii 30: calls $0.27
*** RIVER *** [Ts 6h 5c 3d] [Qh]
Dimitrii 30: checks 
raydenel: checks 
*** SHOW DOWN ***
Dimitrii 30: shows [7d 7c] (a pair of Sevens)
raydenel: shows [8h 8d] (a pair of Eights)
raydenel collected $1.04 from pot
*** SUMMARY ***
Total pot $1.09 | Rake $0.05 
Board [Ts 6h 5c 3d Qh]
Seat 1: adilpoker84 (small blind) folded before Flop
Seat 2: Dimitrii 30 (big blind) showed [7d 7c] and lost with a pair of Sevens
Seat 4: ungiwar folded before Flop (didn't bet)
Seat 5: raydenel showed [8h 8d] and won ($1.04) with a pair of Eights
Seat 6: Acedan1369 (button) folded before Flop (didn't bet)



PokerStars Hand #222967810844:  Hold'em No Limit ($0.05/$0.10 USD) - 2021/01/23 14:59:02 ET
Table 'Capricorn III' 6-max Seat #1 is the button
Seat 1: adilpoker84 ($30.75 in chips) 
Seat 2: Dimitrii 30 ($8 in chips) 
Seat 3: Vanozik19 ($10 in chips) 
Seat 4: ungiwar ($2.75 in chips) 
Seat 5: raydenel ($10.52 in chips) 
Seat 6: Acedan1369 ($29 in chips) 
Dimitrii 30: posts small blind $0.05
Vanozik19: posts big blind $0.10
*** HOLE CARDS ***
ungiwar: folds 
raydenel: raises $0.20 to $0.30
Acedan1369: folds 
adilpoker84: folds 
Dimitrii 30: folds 
Vanozik19: raises $0.65 to $0.95
raydenel: calls $0.65
*** FLOP *** [8s 9s 6h]
Vanozik19: bets $0.90
raydenel: calls $0.90
*** TURN *** [8s 9s 6h] [Jh]
Vanozik19: bets $1.97
raydenel: folds 
Uncalled bet ($1.97) returned to Vanozik19
Vanozik19 collected $3.58 from pot
*** SUMMARY ***
Total pot $3.75 | Rake $0.17 
Board [8s 9s 6h Jh]
Seat 1: adilpoker84 (button) folded before Flop (didn't bet)
Seat 2: Dimitrii 30 (small blind) folded before Flop
Seat 3: Vanozik19 (big blind) collected ($3.58)
Seat 4: ungiwar folded before Flop (didn't bet)
Seat 5: raydenel folded on the Turn
Seat 6: Acedan1369 folded before Flop (didn't bet)



PokerStars Hand #222967837417:  Hold'em No Limit ($0.05/$0.10 USD) - 2021/01/23 14:59:51 ET
Table 'Capricorn III' 6-max Seat #2 is the button
Seat 1: adilpoker84 ($30.75 in chips) 
Seat 2: Dimitrii 30 ($8 in chips) 
Seat 3: Vanozik19 ($11.73 in chips) 
Seat 4: ungiwar ($2.75 in chips) 
Seat 5: raydenel ($10 in chips) 
Seat 6: Acedan1369 ($29 in chips) 
Vanozik19: posts small blind $0.05
ungiwar: posts big blind $0.10
*** HOLE CARDS ***
raydenel: folds 
Acedan1369: raises $0.15 to $0.25
adilpoker84: folds 
Dimitrii 30: folds 
Vanozik19: folds 
ungiwar: folds 
Uncalled bet ($0.15) returned to Acedan1369
Acedan1369 collected $0.25 from pot
Acedan1369: doesn't show hand 
*** SUMMARY ***
Total pot $0.25 | Rake $0 
Seat 1: adilpoker84 folded before Flop (didn't bet)
Seat 2: Dimitrii 30 (button) folded before Flop (didn't bet)
Seat 3: Vanozik19 (small blind) folded before Flop
Seat 4: ungiwar (big blind) folded before Flop
Seat 5: raydenel folded before Flop (didn't bet)
Seat 6: Acedan1369 collected ($0.25)



PokerStars Hand #222967849036:  Hold'em No Limit ($0.05/$0.10 USD) - 2021/01/23 15:00:12 ET
Table 'Capricorn III' 6-max Seat #3 is the button
Seat 1: adilpoker84 ($30.75 in chips) 
Seat 2: Dimitrii 30 ($8 in chips) 
Seat 3: Vanozik19 ($11.68 in chips) 
Seat 4: ungiwar ($2.65 in chips) 
Seat 5: raydenel ($10 in chips) 
Seat 6: Acedan1369 ($29.15 in chips) 
ungiwar: posts small blind $0.05
raydenel: posts big blind $0.10
*** HOLE CARDS ***
Acedan1369: folds 
adilpoker84: folds 
Dimitrii 30: folds 
Vanozik19: raises $0.15 to $0.25
ungiwar: folds 
raydenel: raises $0.75 to $1
Vanozik19: folds 
Uncalled bet ($0.75) returned to raydenel
raydenel collected $0.55 from pot
raydenel: doesn't show hand 
*** SUMMARY ***
Total pot $0.55 | Rake $0 
Seat 1: adilpoker84 folded before Flop (didn't bet)
Seat 2: Dimitrii 30 folded before Flop (didn't bet)
Seat 3: Vanozik19 (button) folded before Flop
Seat 4: ungiwar (small blind) folded before Flop
Seat 5: raydenel (big blind) collected ($0.55)
Seat 6: Acedan1369 folded before Flop (didn't bet)



PokerStars Hand #222967864252:  Hold'em No Limit ($0.05/$0.10 USD) - 2021/01/23 15:00:38 ET
Table 'Capricorn III' 6-max Seat #4 is the button
Seat 1: adilpoker84 ($30.75 in chips) 
Seat 2: Dimitrii 30 ($8 in chips) 
Seat 3: Vanozik19 ($11.43 in chips) 
Seat 4: ungiwar ($2.60 in chips) 
Seat 5: raydenel ($10.30 in chips) 
Seat 6: Acedan1369 ($29.15 in chips) 
raydenel: posts small blind $0.05
Acedan1369: posts big blind $0.10
*** HOLE CARDS ***
adilpoker84: folds 
Dimitrii 30: folds 
Vanozik19: folds 
ungiwar: folds 
raydenel: raises $0.20 to $0.30
Acedan1369: folds 
Uncalled bet ($0.20) returned to raydenel
raydenel collected $0.20 from pot
raydenel: doesn't show hand 
*** SUMMARY ***
Total pot $0.20 | Rake $0 
Seat 1: adilpoker84 folded before Flop (didn't bet)
Seat 2: Dimitrii 30 folded before Flop (didn't bet)
Seat 3: Vanozik19 folded before Flop (didn't bet)
Seat 4: ungiwar (button) folded before Flop (didn't bet)
Seat 5: raydenel (small blind) collected ($0.20)
Seat 6: Acedan1369 (big blind) folded before Flop



PokerStars Hand #222967875932:  Hold'em No Limit ($0.05/$0.10 USD) - 2021/01/23 15:00:57 ET
Table 'Capricorn III' 6-max Seat #5 is the button
Seat 1: adilpoker84 ($30.75 in chips) 
Seat 2: Dimitrii 30 ($8 in chips) 
Seat 3: Vanozik19 ($11.43 in chips) 
Seat 4: ungiwar ($2.60 in chips) 
Seat 5: raydenel ($10.40 in chips) 
Seat 6: Acedan1369 ($29.05 in chips) 
Acedan1369: posts small blind $0.05
adilpoker84: posts big blind $0.10
*** HOLE CARDS ***
Dimitrii 30: folds 
Vanozik19: folds 
ungiwar: folds 
raydenel: raises $0.10 to $0.20
Acedan1369: folds 
adilpoker84: calls $0.10
*** FLOP *** [Ah Td Jc]
adilpoker84: checks 
raydenel: checks 
*** TURN *** [Ah Td Jc] [3c]
adilpoker84: bets $0.10
raydenel: calls $0.10
*** RIVER *** [Ah Td Jc 3c] [4h]
adilpoker84: bets $0.40
raydenel: folds 
Uncalled bet ($0.40) returned to adilpoker84
adilpoker84 collected $0.62 from pot
adilpoker84: doesn't show hand 
*** SUMMARY ***
Total pot $0.65 | Rake $0.03 
Board [Ah Td Jc 3c 4h]
Seat 1: adilpoker84 (big blind) collected ($0.62)
Seat 2: Dimitrii 30 folded before Flop (didn't bet)
Seat 3: Vanozik19 folded before Flop (didn't bet)
Seat 4: ungiwar folded before Flop (didn't bet)
Seat 5: raydenel (button) folded on the River
Seat 6: Acedan1369 (small blind) folded before Flop



PokerStars Hand #222967900455:  Hold'em No Limit ($0.05/$0.10 USD) - 2021/01/23 15:01:28 ET
Table 'Capricorn III' 6-max Seat #6 is the button
Seat 1: adilpoker84 ($31.07 in chips) 
Seat 2: Dimitrii 30 ($8 in chips) 
Seat 3: Vanozik19 ($11.43 in chips) 
Seat 4: ungiwar ($2.60 in chips) 
Seat 5: raydenel ($10.10 in chips) 
Seat 6: Acedan1369 ($29 in chips) 
adilpoker84: posts small blind $0.05
Dimitrii 30: posts big blind $0.10
*** HOLE CARDS ***
Vanozik19: raises $0.15 to $0.25
ungiwar: folds 
raydenel: folds 
Acedan1369: folds 
adilpoker84: folds 
Dimitrii 30: raises $0.55 to $0.80
Vanozik19: folds 
Uncalled bet ($0.55) returned to Dimitrii 30
Dimitrii 30 collected $0.55 from pot
Dimitrii 30: doesn't show hand 
*** SUMMARY ***
Total pot $0.55 | Rake $0 
Seat 1: adilpoker84 (small blind) folded before Flop
Seat 2: Dimitrii 30 (big blind) collected ($0.55)
Seat 3: Vanozik19 folded before Flop
Seat 4: ungiwar folded before Flop (didn't bet)
Seat 5: raydenel folded before Flop (didn't bet)
Seat 6: Acedan1369 (button) folded before Flop (didn't bet)



PokerStars Hand #222967933068:  Hold'em No Limit ($0.05/$0.10 USD) - 2021/01/23 15:02:07 ET
Table 'Capricorn III' 6-max Seat #1 is the button
Seat 1: adilpoker84 ($31.02 in chips) 
Seat 2: Dimitrii 30 ($8.30 in chips) 
Seat 3: Vanozik19 ($11.18 in chips) 
Seat 4: ungiwar ($2.60 in chips) 
Seat 5: raydenel ($10.10 in chips) 
Seat 6: Acedan1369 ($29 in chips) 
Dimitrii 30: posts small blind $0.05
Vanozik19: posts big blind $0.10
*** HOLE CARDS ***
ungiwar: folds 
raydenel: raises $0.20 to $0.30
Acedan1369: folds 
adilpoker84: folds 
Dimitrii 30: folds 
Vanozik19: folds 
Uncalled bet ($0.20) returned to raydenel
raydenel collected $0.25 from pot
raydenel: doesn't show hand 
*** SUMMARY ***
Total pot $0.25 | Rake $0 
Seat 1: adilpoker84 (button) folded before Flop (didn't bet)
Seat 2: Dimitrii 30 (small blind) folded before Flop
Seat 3: Vanozik19 (big blind) folded before Flop
Seat 4: ungiwar folded before Flop (didn't bet)
Seat 5: raydenel collected ($0.25)
Seat 6: Acedan1369 folded before Flop (didn't bet)



PokerStars Hand #222967951153:  Hold'em No Limit ($0.05/$0.10 USD) - 2021/01/23 15:02:31 ET
Table 'Capricorn III' 6-max Seat #2 is the button
Seat 1: adilpoker84 ($31.02 in chips) 
Seat 2: Dimitrii 30 ($8.25 in chips) 
Seat 3: Vanozik19 ($11.08 in chips) 
Seat 4: ungiwar ($2.60 in chips) 
Seat 5: raydenel ($10.25 in chips) 
Seat 6: Acedan1369 ($29 in chips) 
Vanozik19: posts small blind $0.05
ungiwar: posts big blind $0.10
*** HOLE CARDS ***
raydenel: folds 
Acedan1369: folds 
adilpoker84: calls $0.10
Dimitrii 30: folds 
Vanozik19: folds 
ungiwar: checks 
*** FLOP *** [4c 5c 9h]
ungiwar: checks 
adilpoker84: checks 
*** TURN *** [4c 5c 9h] [7c]
ungiwar: checks 
adilpoker84: bets $0.10
ungiwar: folds 
Uncalled bet ($0.10) returned to adilpoker84
adilpoker84 collected $0.24 from pot
adilpoker84: doesn't show hand 
*** SUMMARY ***
Total pot $0.25 | Rake $0.01 
Board [4c 5c 9h 7c]
Seat 1: adilpoker84 collected ($0.24)
Seat 2: Dimitrii 30 (button) folded before Flop (didn't bet)
Seat 3: Vanozik19 (small blind) folded before Flop
Seat 4: ungiwar (big blind) folded on the Turn
Seat 5: raydenel folded before Flop (didn't bet)
Seat 6: Acedan1369 folded before Flop (didn't bet)



PokerStars Hand #222967975354:  Hold'em No Limit ($0.05/$0.10 USD) - 2021/01/23 15:03:01 ET
Table 'Capricorn III' 6-max Seat #3 is the button
Seat 1: adilpoker84 ($31.16 in chips) 
Seat 2: Dimitrii 30 ($8.25 in chips) 
Seat 3: Vanozik19 ($11.03 in chips) 
Seat 4: ungiwar ($2.50 in chips) 
Seat 5: raydenel ($10.25 in chips) 
Seat 6: Acedan1369 ($29 in chips) 
ungiwar: posts small blind $0.05
raydenel: posts big blind $0.10
*** HOLE CARDS ***
Acedan1369: raises $0.15 to $0.25
adilpoker84: folds 
Dimitrii 30: raises $0.65 to $0.90
Vanozik19: folds 
ungiwar: folds 
raydenel: folds 
Acedan1369: calls $0.65
*** FLOP *** [Ah 3s 7d]
Acedan1369: checks 
Dimitrii 30: bets $0.93
Acedan1369: calls $0.93
*** TURN *** [Ah 3s 7d] [7h]
Acedan1369: checks 
Dimitrii 30: checks 
*** RIVER *** [Ah 3s 7d 7h] [5s]
Acedan1369: bets $1.20
Dimitrii 30: calls $1.20
*** SHOW DOWN ***
Acedan1369: shows [Kh Jh] (a pair of Sevens)
Dimitrii 30: shows [Qc Qs] (two pair, Queens and Sevens)
Dimitrii 30 collected $5.93 from pot
*** SUMMARY ***
Total pot $6.21 | Rake $0.28 
Board [Ah 3s 7d 7h 5s]
Seat 1: adilpoker84 folded before Flop (didn't bet)
Seat 2: Dimitrii 30 showed [Qc Qs] and won ($5.93) with two pair, Queens and Sevens
Seat 3: Vanozik19 (button) folded before Flop (didn't bet)
Seat 4: ungiwar (small blind) folded before Flop
Seat 5: raydenel (big blind) folded before Flop
Seat 6: Acedan1369 showed [Kh Jh] and lost with a pair of Sevens



PokerStars Hand #222968026865:  Hold'em No Limit ($0.05/$0.10 USD) - 2021/01/23 15:04:05 ET
Table 'Capricorn III' 6-max Seat #4 is the button
Seat 1: adilpoker84 ($31.16 in chips) 
Seat 2: Dimitrii 30 ($11.15 in chips) 
Seat 3: Vanozik19 ($11.03 in chips) 
Seat 4: ungiwar ($2.45 in chips) 
Seat 5: raydenel ($10.15 in chips) 
Seat 6: Acedan1369 ($25.97 in chips) 
raydenel: posts small blind $0.05
Acedan1369: posts big blind $0.10
*** HOLE CARDS ***
adilpoker84: folds 
Dimitrii 30: folds 
Vanozik19: folds 
ungiwar: raises $0.10 to $0.20
raydenel: folds 
Acedan1369: calls $0.10
*** FLOP *** [6c 4c 9c]
Acedan1369: checks 
ungiwar: bets $0.15
Acedan1369: folds 
Uncalled bet ($0.15) returned to ungiwar
ungiwar collected $0.43 from pot
ungiwar: doesn't show hand 
*** SUMMARY ***
Total pot $0.45 | Rake $0.02 
Board [6c 4c 9c]
Seat 1: adilpoker84 folded before Flop (didn't bet)
Seat 2: Dimitrii 30 folded before Flop (didn't bet)
Seat 3: Vanozik19 folded before Flop (didn't bet)
Seat 4: ungiwar (button) collected ($0.43)
Seat 5: raydenel (small blind) folded before Flop
Seat 6: Acedan1369 (big blind) folded on the Flop



PokerStars Hand #222968055897:  Hold'em No Limit ($0.05/$0.10 USD) - 2021/01/23 15:04:41 ET
Table 'Capricorn III' 6-max Seat #5 is the button
Seat 1: adilpoker84 ($31.16 in chips) 
Seat 2: Dimitrii 30 ($11.15 in chips) 
Seat 3: Vanozik19 ($11.03 in chips) 
Seat 4: ungiwar ($2.68 in chips) 
Seat 5: raydenel ($10.10 in chips) 
Seat 6: Acedan1369 ($25.77 in chips) 
Acedan1369: posts small blind $0.05
adilpoker84: posts big blind $0.10
*** HOLE CARDS ***
Dimitrii 30: folds 
Vanozik19: folds 
ungiwar: folds 
raydenel: folds 
Acedan1369: folds 
Uncalled bet ($0.05) returned to adilpoker84
adilpoker84 collected $0.10 from pot
adilpoker84: doesn't show hand 
*** SUMMARY ***
Total pot $0.10 | Rake $0 
Seat 1: adilpoker84 (big blind) collected ($0.10)
Seat 2: Dimitrii 30 folded before Flop (didn't bet)
Seat 3: Vanozik19 folded before Flop (didn't bet)
Seat 4: ungiwar folded before Flop (didn't bet)
Seat 5: raydenel (button) folded before Flop (didn't bet)
Seat 6: Acedan1369 (small blind) folded before Flop



PokerStars Hand #222968065194:  Hold'em No Limit ($0.05/$0.10 USD) - 2021/01/23 15:04:52 ET
Table 'Capricorn III' 6-max Seat #6 is the button
Seat 1: adilpoker84 ($31.21 in chips) 
Seat 2: Dimitrii 30 ($11.15 in chips) 
Seat 3: Vanozik19 ($11.03 in chips) 
Seat 4: ungiwar ($2.68 in chips) 
Seat 5: raydenel ($10.10 in chips) 
Seat 6: Acedan1369 ($25.72 in chips) 
adilpoker84: posts small blind $0.05
Dimitrii 30: posts big blind $0.10
*** HOLE CARDS ***
Vanozik19: folds 
ungiwar: folds 
raydenel: folds 
Acedan1369: raises $0.15 to $0.25
adilpoker84: calls $0.20
Dimitrii 30: folds 
*** FLOP *** [9s Jh 2h]
adilpoker84: checks 
Acedan1369: bets $0.43
adilpoker84: folds 
Uncalled bet ($0.43) returned to Acedan1369
Acedan1369 collected $0.57 from pot
Acedan1369: doesn't show hand 
*** SUMMARY ***
Total pot $0.60 | Rake $0.03 
Board [9s Jh 2h]
Seat 1: adilpoker84 (small blind) folded on the Flop
Seat 2: Dimitrii 30 (big blind) folded before Flop
Seat 3: Vanozik19 folded before Flop (didn't bet)
Seat 4: ungiwar folded before Flop (didn't bet)
Seat 5: raydenel folded before Flop (didn't bet)
Seat 6: Acedan1369 (button) collected ($0.57)



PokerStars Hand #222968096361:  Hold'em No Limit ($0.05/$0.10 USD) - 2021/01/23 15:05:29 ET
Table 'Capricorn III' 6-max Seat #1 is the button
Seat 1: adilpoker84 ($30.96 in chips) 
Seat 2: Dimitrii 30 ($11.05 in chips) 
Seat 3: Vanozik19 ($11.03 in chips) 
Seat 4: ungiwar ($2.68 in chips) 
Seat 5: raydenel ($10.10 in chips) 
Seat 6: Acedan1369 ($26.04 in chips) 
Dimitrii 30: posts small blind $0.05
Vanozik19: posts big blind $0.10
*** HOLE CARDS ***
ungiwar: folds 
raydenel: folds 
Acedan1369: folds 
adilpoker84: raises $0.10 to $0.20
Dimitrii 30: folds 
Vanozik19: folds 
Uncalled bet ($0.10) returned to adilpoker84
adilpoker84 collected $0.25 from pot
adilpoker84: doesn't show hand 
*** SUMMARY ***
Total pot $0.25 | Rake $0 
Seat 1: adilpoker84 (button) collected ($0.25)
Seat 2: Dimitrii 30 (small blind) folded before Flop
Seat 3: Vanozik19 (big blind) folded before Flop
Seat 4: ungiwar folded before Flop (didn't bet)
Seat 5: raydenel folded before Flop (didn't bet)
Seat 6: Acedan1369 folded before Flop (didn't bet)



PokerStars Hand #222968118614:  Hold'em No Limit ($0.05/$0.10 USD) - 2021/01/23 15:05:56 ET
Table 'Capricorn III' 6-max Seat #2 is the button
Seat 1: adilpoker84 ($31.11 in chips) 
Seat 2: Dimitrii 30 ($11 in chips) 
Seat 3: Vanozik19 ($10.93 in chips) 
Seat 4: ungiwar ($2.68 in chips) 
Seat 5: raydenel ($10.10 in chips) 
Seat 6: Acedan1369 ($26.04 in chips) 
Vanozik19: posts small blind $0.05
ungiwar: posts big blind $0.10
*** HOLE CARDS ***
raydenel: folds 
Acedan1369: folds 
adilpoker84: calls $0.10
Dimitrii 30: folds 
Vanozik19: raises $0.30 to $0.40
ungiwar: folds 
adilpoker84: folds 
Uncalled bet ($0.30) returned to Vanozik19
Vanozik19 collected $0.30 from pot
*** SUMMARY ***
Total pot $0.30 | Rake $0 
Seat 1: adilpoker84 folded before Flop
Seat 2: Dimitrii 30 (button) folded before Flop (didn't bet)
Seat 3: Vanozik19 (small blind) collected ($0.30)
Seat 4: ungiwar (big blind) folded before Flop
Seat 5: raydenel folded before Flop (didn't bet)
Seat 6: Acedan1369 folded before Flop (didn't bet)



PokerStars Hand #222968132940:  Hold'em No Limit ($0.05/$0.10 USD) - 2021/01/23 15:06:13 ET
Table 'Capricorn III' 6-max Seat #3 is the button
Seat 1: adilpoker84 ($31.01 in chips) 
Seat 2: Dimitrii 30 ($11 in chips) 
Seat 3: Vanozik19 ($11.13 in chips) 
Seat 4: ungiwar ($2.58 in chips) 
Seat 5: raydenel ($10.10 in chips) 
Seat 6: Acedan1369 ($26.04 in chips) 
ungiwar: posts small blind $0.05
raydenel: posts big blind $0.10
*** HOLE CARDS ***
Acedan1369: folds 
adilpoker84: folds 
Dimitrii 30: folds 
Vanozik19: raises $0.15 to $0.25
ungiwar: folds 
raydenel: calls $0.15
*** FLOP *** [7d 7c 5d]
raydenel: checks 
Vanozik19: checks 
*** TURN *** [7d 7c 5d] [6s]
raydenel: checks 
Vanozik19: checks 
*** RIVER *** [7d 7c 5d 6s] [Tc]
raydenel: checks 
Vanozik19: bets $0.42
raydenel: folds 
Uncalled bet ($0.42) returned to Vanozik19
Vanozik19 collected $0.53 from pot
*** SUMMARY ***
Total pot $0.55 | Rake $0.02 
Board [7d 7c 5d 6s Tc]
Seat 1: adilpoker84 folded before Flop (didn't bet)
Seat 2: Dimitrii 30 folded before Flop (didn't bet)
Seat 3: Vanozik19 (button) collected ($0.53)
Seat 4: ungiwar (small blind) folded before Flop
Seat 5: raydenel (big blind) folded on the River
Seat 6: Acedan1369 folded before Flop (didn't bet)



PokerStars Hand #222968181153:  Hold'em No Limit ($0.05/$0.10 USD) - 2021/01/23 15:07:10 ET
Table 'Capricorn III' 6-max Seat #4 is the button
Seat 1: adilpoker84 ($31.01 in chips) 
Seat 2: Dimitrii 30 ($11 in chips) 
Seat 3: Vanozik19 ($11.41 in chips) 
Seat 4: ungiwar ($2.53 in chips) 
Seat 5: raydenel ($10 in chips) 
Seat 6: Acedan1369 ($26.04 in chips) 
raydenel: posts small blind $0.05
Acedan1369: posts big blind $0.10
*** HOLE CARDS ***
adilpoker84: raises $0.10 to $0.20
Dimitrii 30: folds 
Vanozik19: folds 
ungiwar: folds 
raydenel: calls $0.15
Acedan1369: folds 
*** FLOP *** [4c Ts Jh]
raydenel: checks 
adilpoker84: bets $0.20
raydenel: calls $0.20
*** TURN *** [4c Ts Jh] [Td]
raydenel: checks 
adilpoker84: bets $0.20
raydenel: calls $0.20
*** RIVER *** [4c Ts Jh Td] [4s]
raydenel: checks 
adilpoker84: bets $0.30
raydenel: calls $0.30
*** SHOW DOWN ***
adilpoker84: shows [Kd Qc] (two pair, Tens and Fours)
raydenel: shows [Ks Qs] (two pair, Tens and Fours)
raydenel collected $0.91 from pot
adilpoker84 collected $0.90 from pot
*** SUMMARY ***
Total pot $1.90 | Rake $0.09 
Board [4c Ts Jh Td 4s]
Seat 1: adilpoker84 showed [Kd Qc] and won ($0.90) with two pair, Tens and Fours
Seat 2: Dimitrii 30 folded before Flop (didn't bet)
Seat 3: Vanozik19 folded before Flop (didn't bet)
Seat 4: ungiwar (button) folded before Flop (didn't bet)
Seat 5: raydenel (small blind) showed [Ks Qs] and won ($0.91) with two pair, Tens and Fours
Seat 6: Acedan1369 (big blind) folded before Flop



PokerStars Hand #222968217607:  Hold'em No Limit ($0.05/$0.10 USD) - 2021/01/23 15:07:54 ET
Table 'Capricorn III' 6-max Seat #5 is the button
Seat 1: adilpoker84 ($31.01 in chips) 
Seat 2: Dimitrii 30 ($11 in chips) 
Seat 3: Vanozik19 ($11.41 in chips) 
Seat 4: ungiwar ($2.53 in chips) 
Seat 5: raydenel ($10.01 in chips) 
Seat 6: Acedan1369 ($25.94 in chips) 
Acedan1369: posts small blind $0.05
adilpoker84: posts big blind $0.10
*** HOLE CARDS ***
Dimitrii 30: folds 
Vanozik19: folds 
ungiwar: raises $0.10 to $0.20
raydenel: folds 
Acedan1369: calls $0.15
adilpoker84: calls $0.10
*** FLOP *** [3h Qh 7d]
Acedan1369: checks 
adilpoker84: checks 
ungiwar: bets $0.19
Acedan1369: raises $0.51 to $0.70
adilpoker84: folds 
ungiwar: raises $1.63 to $2.33 and is all-in
Acedan1369: calls $1.63
*** TURN *** [3h Qh 7d] [8s]
*** RIVER *** [3h Qh 7d 8s] [Ts]
*** SHOW DOWN ***
Acedan1369: shows [3s 3c] (three of a kind, Threes)
ungiwar: shows [9c 9s] (a pair of Nines)
Acedan1369 collected $5.02 from pot
*** SUMMARY ***
Total pot $5.26 | Rake $0.24 
Board [3h Qh 7d 8s Ts]
Seat 1: adilpoker84 (big blind) folded on the Flop
Seat 2: Dimitrii 30 folded before Flop (didn't bet)
Seat 3: Vanozik19 folded before Flop (didn't bet)
Seat 4: ungiwar showed [9c 9s] and lost with a pair of Nines
Seat 5: raydenel (button) folded before Flop (didn't bet)
Seat 6: Acedan1369 (small blind) showed [3s 3c] and won ($5.02) with three of a kind, Threes



PokerStars Hand #222968289061:  Hold'em No Limit ($0.05/$0.10 USD) - 2021/01/23 15:09:19 ET
Table 'Capricorn III' 6-max Seat #6 is the button
Seat 1: adilpoker84 ($30.81 in chips) 
Seat 2: Dimitrii 30 ($11 in chips) 
Seat 3: Vanozik19 ($11.41 in chips) 
Seat 4: ungiwar ($4 in chips) 
Seat 5: raydenel ($10.01 in chips) 
Seat 6: Acedan1369 ($28.43 in chips) 
adilpoker84: posts small blind $0.05
Dimitrii 30: posts big blind $0.10
*** HOLE CARDS ***
Vanozik19: folds 
ungiwar: folds 
raydenel: folds 
Acedan1369: folds 
adilpoker84: calls $0.05
Dimitrii 30: checks 
*** FLOP *** [6c Qh 3c]
adilpoker84: checks 
Dimitrii 30: checks 
*** TURN *** [6c Qh 3c] [Ks]
adilpoker84: checks 
Dimitrii 30: bets $0.10
adilpoker84: folds 
Uncalled bet ($0.10) returned to Dimitrii 30
Dimitrii 30 collected $0.19 from pot
Dimitrii 30: doesn't show hand 
*** SUMMARY ***
Total pot $0.20 | Rake $0.01 
Board [6c Qh 3c Ks]
Seat 1: adilpoker84 (small blind) folded on the Turn
Seat 2: Dimitrii 30 (big blind) collected ($0.19)
Seat 3: Vanozik19 folded before Flop (didn't bet)
Seat 4: ungiwar folded before Flop (didn't bet)
Seat 5: raydenel folded before Flop (didn't bet)
Seat 6: Acedan1369 (button) folded before Flop (didn't bet)



PokerStars Hand #222968339211:  Hold'em No Limit ($0.05/$0.10 USD) - 2021/01/23 15:10:19 ET
Table 'Capricorn III' 6-max Seat #1 is the button
Seat 1: adilpoker84 ($30.71 in chips) 
Seat 2: Dimitrii 30 ($11.09 in chips) 
Seat 3: Vanozik19 ($11.41 in chips) 
Seat 4: ungiwar ($4 in chips) 
Seat 5: raydenel ($10.01 in chips) 
Seat 6: Acedan1369 ($28.43 in chips) 
Dimitrii 30: posts small blind $0.05
Vanozik19: posts big blind $0.10
*** HOLE CARDS ***
ungiwar: folds 
raydenel: folds 
Acedan1369: raises $0.15 to $0.25
adilpoker84: calls $0.25
Dimitrii 30: folds 
Vanozik19: calls $0.15
*** FLOP *** [3c 2d 9c]
Vanozik19: checks 
Acedan1369: checks 
adilpoker84: bets $0.30
Vanozik19: raises $1.20 to $1.50
Acedan1369: folds 
adilpoker84: calls $1.20
*** TURN *** [3c 2d 9c] [Kd]
Vanozik19: checks 
adilpoker84: checks 
*** RIVER *** [3c 2d 9c Kd] [7d]
Vanozik19: bets $3
adilpoker84: folds 
Uncalled bet ($3) returned to Vanozik19
Vanozik19 collected $3.63 from pot
*** SUMMARY ***
Total pot $3.80 | Rake $0.17 
Board [3c 2d 9c Kd 7d]
Seat 1: adilpoker84 (button) folded on the River
Seat 2: Dimitrii 30 (small blind) folded before Flop
Seat 3: Vanozik19 (big blind) collected ($3.63)
Seat 4: ungiwar folded before Flop (didn't bet)
Seat 5: raydenel folded before Flop (didn't bet)
Seat 6: Acedan1369 folded on the Flop



PokerStars Hand #222968390114:  Hold'em No Limit ($0.05/$0.10 USD) - 2021/01/23 15:11:19 ET
Table 'Capricorn III' 6-max Seat #2 is the button
Seat 1: adilpoker84 ($28.96 in chips) 
Seat 2: Dimitrii 30 ($11.04 in chips) 
Seat 3: Vanozik19 ($13.29 in chips) 
Seat 4: ungiwar ($4 in chips) 
Seat 5: raydenel ($10.01 in chips) 
Seat 6: Acedan1369 ($28.18 in chips) 
Vanozik19: posts small blind $0.05
ungiwar: posts big blind $0.10
*** HOLE CARDS ***
raydenel: folds 
Acedan1369: folds 
adilpoker84: raises $0.20 to $0.30
Dimitrii 30: folds 
Vanozik19: raises $0.70 to $1
ungiwar: folds 
adilpoker84: calls $0.70
*** FLOP *** [6d 3h 9h]
Vanozik19: checks 
adilpoker84: bets $0.40
Vanozik19: calls $0.40
*** TURN *** [6d 3h 9h] [Jc]
Vanozik19: checks 
adilpoker84: bets $0.40
Vanozik19: raises $1.50 to $1.90
adilpoker84: calls $1.50
*** RIVER *** [6d 3h 9h Jc] [4d]
Vanozik19: checks 
adilpoker84: checks 
*** SHOW DOWN ***
Vanozik19: shows [As Jd] (a pair of Jacks)
adilpoker84: mucks hand 
Vanozik19 collected $6.40 from pot
*** SUMMARY ***
Total pot $6.70 | Rake $0.30 
Board [6d 3h 9h Jc 4d]
Seat 1: adilpoker84 mucked
Seat 2: Dimitrii 30 (button) folded before Flop (didn't bet)
Seat 3: Vanozik19 (small blind) showed [As Jd] and won ($6.40) with a pair of Jacks
Seat 4: ungiwar (big blind) folded before Flop
Seat 5: raydenel folded before Flop (didn't bet)
Seat 6: Acedan1369 folded before Flop (didn't bet)



PokerStars Hand #222968457222:  Hold'em No Limit ($0.05/$0.10 USD) - 2021/01/23 15:12:31 ET
Table 'Capricorn III' 6-max Seat #3 is the button
Seat 1: adilpoker84 ($25.66 in chips) 
Seat 2: Dimitrii 30 ($11.04 in chips) 
Seat 3: Vanozik19 ($16.39 in chips) 
Seat 4: ungiwar ($3.90 in chips) 
Seat 5: raydenel ($10.01 in chips) 
Seat 6: Acedan1369 ($28.18 in chips) 
ungiwar: posts small blind $0.05
raydenel: posts big blind $0.10
*** HOLE CARDS ***
Acedan1369: folds 
adilpoker84: raises $0.20 to $0.30
Dimitrii 30: folds 
Vanozik19: folds 
ungiwar: calls $0.25
raydenel: calls $0.20
*** FLOP *** [4s 5c Jh]
ungiwar: checks 
raydenel: checks 
adilpoker84: bets $0.40
ungiwar: raises $0.70 to $1.10
raydenel: folds 
adilpoker84: calls $0.70
*** TURN *** [4s 5c Jh] [8c]
ungiwar: bets $2.50 and is all-in
adilpoker84: folds 
Uncalled bet ($2.50) returned to ungiwar
ungiwar collected $2.96 from pot
ungiwar: doesn't show hand 
*** SUMMARY ***
Total pot $3.10 | Rake $0.14 
Board [4s 5c Jh 8c]
Seat 1: adilpoker84 folded on the Turn
Seat 2: Dimitrii 30 folded before Flop (didn't bet)
Seat 3: Vanozik19 (button) folded before Flop (didn't bet)
Seat 4: ungiwar (small blind) collected ($2.96)
Seat 5: raydenel (big blind) folded on the Flop
Seat 6: Acedan1369 folded before Flop (didn't bet)



PokerStars Hand #222968506641:  Hold'em No Limit ($0.05/$0.10 USD) - 2021/01/23 15:13:30 ET
Table 'Capricorn III' 6-max Seat #4 is the button
Seat 1: adilpoker84 ($24.26 in chips) 
Seat 2: Dimitrii 30 ($11.04 in chips) 
Seat 3: Vanozik19 ($16.39 in chips) 
Seat 4: ungiwar ($5.46 in chips) 
Seat 5: raydenel ($10 in chips) 
Seat 6: Acedan1369 ($28.18 in chips) 
raydenel: posts small blind $0.05
Acedan1369: posts big blind $0.10
*** HOLE CARDS ***
adilpoker84: calls $0.10
Dimitrii 30: raises $0.15 to $0.25
Vanozik19: folds 
ungiwar: folds 
raydenel: calls $0.20
Acedan1369: folds 
adilpoker84: calls $0.15
*** FLOP *** [4s 3d 3s]
raydenel: checks 
adilpoker84: checks 
Dimitrii 30: checks 
*** TURN *** [4s 3d 3s] [6h]
raydenel: bets $0.41
adilpoker84: calls $0.41
Dimitrii 30: folds 
*** RIVER *** [4s 3d 3s 6h] [4d]
raydenel: checks 
adilpoker84: checks 
*** SHOW DOWN ***
raydenel: shows [7h Ah] (two pair, Fours and Threes)
adilpoker84: shows [Js 6s] (two pair, Sixes and Fours)
adilpoker84 collected $1.59 from pot
*** SUMMARY ***
Total pot $1.67 | Rake $0.08 
Board [4s 3d 3s 6h 4d]
Seat 1: adilpoker84 showed [Js 6s] and won ($1.59) with two pair, Sixes and Fours
Seat 2: Dimitrii 30 folded on the Turn
Seat 3: Vanozik19 folded before Flop (didn't bet)
Seat 4: ungiwar (button) folded before Flop (didn't bet)
Seat 5: raydenel (small blind) showed [7h Ah] and lost with two pair, Fours and Threes
Seat 6: Acedan1369 (big blind) folded before Flop



PokerStars Hand #222968539844:  Hold'em No Limit ($0.05/$0.10 USD) - 2021/01/23 15:14:10 ET
Table 'Capricorn III' 6-max Seat #5 is the button
Seat 1: adilpoker84 ($25.19 in chips) 
Seat 2: Dimitrii 30 ($10.79 in chips) 
Seat 3: Vanozik19 ($16.39 in chips) 
Seat 4: ungiwar ($5.46 in chips) 
Seat 5: raydenel ($10 in chips) 
Seat 6: Acedan1369 ($28.08 in chips) 
Acedan1369: posts small blind $0.05
adilpoker84: posts big blind $0.10
*** HOLE CARDS ***
Dimitrii 30: raises $0.15 to $0.25
Vanozik19: folds 
ungiwar: folds 
raydenel: folds 
Acedan1369: calls $0.20
adilpoker84: calls $0.15
*** FLOP *** [4c As Kc]
Acedan1369: checks 
adilpoker84: checks 
Dimitrii 30: bets $0.60
Acedan1369: folds 
adilpoker84: folds 
Uncalled bet ($0.60) returned to Dimitrii 30
Dimitrii 30 collected $0.72 from pot
Dimitrii 30: doesn't show hand 
*** SUMMARY ***
Total pot $0.75 | Rake $0.03 
Board [4c As Kc]
Seat 1: adilpoker84 (big blind) folded on the Flop
Seat 2: Dimitrii 30 collected ($0.72)
Seat 3: Vanozik19 folded before Flop (didn't bet)
Seat 4: ungiwar folded before Flop (didn't bet)
Seat 5: raydenel (button) folded before Flop (didn't bet)
Seat 6: Acedan1369 (small blind) folded on the Flop



PokerStars Hand #222968578844:  Hold'em No Limit ($0.05/$0.10 USD) - 2021/01/23 15:14:57 ET
Table 'Capricorn III' 6-max Seat #6 is the button
Seat 1: adilpoker84 ($24.94 in chips) 
Seat 2: Dimitrii 30 ($11.26 in chips) 
Seat 3: Vanozik19 ($16.39 in chips) 
Seat 4: ungiwar ($5.46 in chips) 
Seat 5: raydenel ($10 in chips) 
Seat 6: Acedan1369 ($27.83 in chips) 
adilpoker84: posts small blind $0.05
Dimitrii 30: posts big blind $0.10
*** HOLE CARDS ***
Vanozik19: folds 
ungiwar: folds 
raydenel: folds 
Acedan1369: folds 
adilpoker84: folds 
Uncalled bet ($0.05) returned to Dimitrii 30
Dimitrii 30 collected $0.10 from pot
Dimitrii 30: doesn't show hand 
*** SUMMARY ***
Total pot $0.10 | Rake $0 
Seat 1: adilpoker84 (small blind) folded before Flop
Seat 2: Dimitrii 30 (big blind) collected ($0.10)
Seat 3: Vanozik19 folded before Flop (didn't bet)
Seat 4: ungiwar folded before Flop (didn't bet)
Seat 5: raydenel folded before Flop (didn't bet)
Seat 6: Acedan1369 (button) folded before Flop (didn't bet)



PokerStars Hand #222968588437:  Hold'em No Limit ($0.05/$0.10 USD) - 2021/01/23 15:15:08 ET
Table 'Capricorn III' 6-max Seat #1 is the button
Seat 1: adilpoker84 ($24.89 in chips) 
Seat 2: Dimitrii 30 ($11.31 in chips) 
Seat 3: Vanozik19 ($16.39 in chips) 
Seat 4: ungiwar ($5.46 in chips) 
Seat 5: raydenel ($10 in chips) 
Seat 6: Acedan1369 ($27.83 in chips) 
Dimitrii 30: posts small blind $0.05
Vanozik19: posts big blind $0.10
*** HOLE CARDS ***
ungiwar: raises $0.10 to $0.20
raydenel: folds 
Acedan1369: folds 
adilpoker84: calls $0.20
Dimitrii 30: folds 
Vanozik19: folds 
*** FLOP *** [9h 5c 6d]
ungiwar: checks 
adilpoker84: checks 
*** TURN *** [9h 5c 6d] [6s]
ungiwar: checks 
adilpoker84: bets $0.10
ungiwar: calls $0.10
*** RIVER *** [9h 5c 6d 6s] [2d]
ungiwar: checks 
adilpoker84: bets $0.20
ungiwar: calls $0.20
*** SHOW DOWN ***
adilpoker84: shows [Jc 7s] (a pair of Sixes)
ungiwar: shows [Ks Qs] (a pair of Sixes - King kicker)
ungiwar collected $1.10 from pot
*** SUMMARY ***
Total pot $1.15 | Rake $0.05 
Board [9h 5c 6d 6s 2d]
Seat 1: adilpoker84 (button) showed [Jc 7s] and lost with a pair of Sixes
Seat 2: Dimitrii 30 (small blind) folded before Flop
Seat 3: Vanozik19 (big blind) folded before Flop
Seat 4: ungiwar showed [Ks Qs] and won ($1.10) with a pair of Sixes
Seat 5: raydenel folded before Flop (didn't bet)
Seat 6: Acedan1369 folded before Flop (didn't bet)



PokerStars Hand #222968640947:  Hold'em No Limit ($0.05/$0.10 USD) - 2021/01/23 15:16:09 ET
Table 'Capricorn III' 6-max Seat #2 is the button
Seat 1: adilpoker84 ($24.39 in chips) 
Seat 2: Dimitrii 30 ($11.26 in chips) 
Seat 3: Vanozik19 ($16.29 in chips) 
Seat 4: ungiwar ($6.06 in chips) 
Seat 5: raydenel ($10 in chips) 
Seat 6: Acedan1369 ($27.83 in chips) 
Vanozik19: posts small blind $0.05
ungiwar: posts big blind $0.10
*** HOLE CARDS ***
raydenel: folds 
Acedan1369: folds 
adilpoker84: folds 
Dimitrii 30: folds 
Vanozik19: raises $0.20 to $0.30
ungiwar: folds 
Uncalled bet ($0.20) returned to Vanozik19
Vanozik19 collected $0.20 from pot
*** SUMMARY ***
Total pot $0.20 | Rake $0 
Seat 1: adilpoker84 folded before Flop (didn't bet)
Seat 2: Dimitrii 30 (button) folded before Flop (didn't bet)
Seat 3: Vanozik19 (small blind) collected ($0.20)
Seat 4: ungiwar (big blind) folded before Flop
Seat 5: raydenel folded before Flop (didn't bet)
Seat 6: Acedan1369 folded before Flop (didn't bet)



PokerStars Hand #222968656621:  Hold'em No Limit ($0.05/$0.10 USD) - 2021/01/23 15:16:27 ET
Table 'Capricorn III' 6-max Seat #3 is the button
Seat 1: adilpoker84 ($24.39 in chips) 
Seat 2: Dimitrii 30 ($11.26 in chips) 
Seat 3: Vanozik19 ($16.39 in chips) 
Seat 4: ungiwar ($5.96 in chips) 
Seat 5: raydenel ($10 in chips) 
Seat 6: Acedan1369 ($27.83 in chips) 
ungiwar: posts small blind $0.05
raydenel: posts big blind $0.10
*** HOLE CARDS ***
Acedan1369: raises $0.15 to $0.25
adilpoker84: folds 
Dimitrii 30: folds 
Vanozik19: folds 
ungiwar: folds 
raydenel: folds 
Uncalled bet ($0.15) returned to Acedan1369
Acedan1369 collected $0.25 from pot
Acedan1369: doesn't show hand 
*** SUMMARY ***
Total pot $0.25 | Rake $0 
Seat 1: adilpoker84 folded before Flop (didn't bet)
Seat 2: Dimitrii 30 folded before Flop (didn't bet)
Seat 3: Vanozik19 (button) folded before Flop (didn't bet)
Seat 4: ungiwar (small blind) folded before Flop
Seat 5: raydenel (big blind) folded before Flop
Seat 6: Acedan1369 collected ($0.25)



PokerStars Hand #222968667103:  Hold'em No Limit ($0.05/$0.10 USD) - 2021/01/23 15:16:40 ET
Table 'Capricorn III' 6-max Seat #4 is the button
Seat 1: adilpoker84 ($24.39 in chips) 
Seat 2: Dimitrii 30 ($11.26 in chips) 
Seat 3: Vanozik19 ($16.39 in chips) 
Seat 4: ungiwar ($5.91 in chips) 
Seat 5: raydenel ($10 in chips) 
Seat 6: Acedan1369 ($27.98 in chips) 
raydenel: posts small blind $0.05
Acedan1369: posts big blind $0.10
*** HOLE CARDS ***
adilpoker84: calls $0.10
Dimitrii 30: folds 
Vanozik19: folds 
ungiwar: folds 
raydenel: raises $0.30 to $0.40
Acedan1369: folds 
adilpoker84: calls $0.30
*** FLOP *** [Ad Qs 6c]
raydenel: bets $0.43
adilpoker84: folds 
Uncalled bet ($0.43) returned to raydenel
raydenel collected $0.86 from pot
raydenel: doesn't show hand 
*** SUMMARY ***
Total pot $0.90 | Rake $0.04 
Board [Ad Qs 6c]
Seat 1: adilpoker84 folded on the Flop
Seat 2: Dimitrii 30 folded before Flop (didn't bet)
Seat 3: Vanozik19 folded before Flop (didn't bet)
Seat 4: ungiwar (button) folded before Flop (didn't bet)
Seat 5: raydenel (small blind) collected ($0.86)
Seat 6: Acedan1369 (big blind) folded before Flop



PokerStars Hand #222968686932:  Hold'em No Limit ($0.05/$0.10 USD) - 2021/01/23 15:17:03 ET
Table 'Capricorn III' 6-max Seat #5 is the button
Seat 1: adilpoker84 ($23.99 in chips) 
Seat 2: Dimitrii 30 ($11.26 in chips) 
Seat 3: Vanozik19 ($16.39 in chips) 
Seat 4: ungiwar ($5.91 in chips) 
Seat 5: raydenel ($10.46 in chips) 
Seat 6: Acedan1369 ($27.88 in chips) 
Acedan1369: posts small blind $0.05
adilpoker84: posts big blind $0.10
*** HOLE CARDS ***
Dimitrii 30: folds 
Vanozik19: raises $0.15 to $0.25
ungiwar: folds 
raydenel: folds 
Acedan1369: folds 
adilpoker84: calls $0.15
*** FLOP *** [Jc 5d 5h]
adilpoker84: checks 
Vanozik19: bets $0.17
adilpoker84: folds 
Uncalled bet ($0.17) returned to Vanozik19
Vanozik19 collected $0.53 from pot
*** SUMMARY ***
Total pot $0.55 | Rake $0.02 
Board [Jc 5d 5h]
Seat 1: adilpoker84 (big blind) folded on the Flop
Seat 2: Dimitrii 30 folded before Flop (didn't bet)
Seat 3: Vanozik19 collected ($0.53)
Seat 4: ungiwar folded before Flop (didn't bet)
Seat 5: raydenel (button) folded before Flop (didn't bet)
Seat 6: Acedan1369 (small blind) folded before Flop



PokerStars Hand #222968714048:  Hold'em No Limit ($0.05/$0.10 USD) - 2021/01/23 15:17:34 ET
Table 'Capricorn III' 6-max Seat #6 is the button
Seat 1: adilpoker84 ($23.74 in chips) 
Seat 2: Dimitrii 30 ($11.26 in chips) 
Seat 3: Vanozik19 ($16.67 in chips) 
Seat 4: ungiwar ($5.91 in chips) 
Seat 5: raydenel ($10.46 in chips) 
Seat 6: Acedan1369 ($27.83 in chips) 
adilpoker84: posts small blind $0.05
Dimitrii 30: posts big blind $0.10
*** HOLE CARDS ***
Vanozik19: folds 
ungiwar: folds 
raydenel: folds 
Acedan1369: raises $0.15 to $0.25
adilpoker84: folds 
Dimitrii 30: folds 
Uncalled bet ($0.15) returned to Acedan1369
Acedan1369 collected $0.25 from pot
Acedan1369: doesn't show hand 
*** SUMMARY ***
Total pot $0.25 | Rake $0 
Seat 1: adilpoker84 (small blind) folded before Flop
Seat 2: Dimitrii 30 (big blind) folded before Flop
Seat 3: Vanozik19 folded before Flop (didn't bet)
Seat 4: ungiwar folded before Flop (didn't bet)
Seat 5: raydenel folded before Flop (didn't bet)
Seat 6: Acedan1369 (button) collected ($0.25)



PokerStars Hand #222968732646:  Hold'em No Limit ($0.05/$0.10 USD) - 2021/01/23 15:17:56 ET
Table 'Capricorn III' 6-max Seat #1 is the button
Seat 1: adilpoker84 ($23.69 in chips) 
Seat 2: Dimitrii 30 ($11.16 in chips) 
Seat 3: Vanozik19 ($16.67 in chips) 
Seat 4: ungiwar ($5.91 in chips) 
Seat 5: raydenel ($10.46 in chips) 
Seat 6: Acedan1369 ($27.98 in chips) 
Dimitrii 30: posts small blind $0.05
Vanozik19: posts big blind $0.10
*** HOLE CARDS ***
ungiwar: folds 
raydenel: folds 
Acedan1369: folds 
adilpoker84: calls $0.10
Dimitrii 30: folds 
Vanozik19: checks 
*** FLOP *** [8h 2d Kc]
Vanozik19: checks 
adilpoker84: bets $0.10
Vanozik19: calls $0.10
*** TURN *** [8h 2d Kc] [2c]
Vanozik19: checks 
adilpoker84: bets $0.20
Vanozik19: calls $0.20
*** RIVER *** [8h 2d Kc 2c] [5d]
Vanozik19: checks 
adilpoker84: checks 
*** SHOW DOWN ***
Vanozik19: shows [Ks Jh] (two pair, Kings and Deuces)
adilpoker84: mucks hand 
Vanozik19 collected $0.81 from pot
*** SUMMARY ***
Total pot $0.85 | Rake $0.04 
Board [8h 2d Kc 2c 5d]
Seat 1: adilpoker84 (button) mucked
Seat 2: Dimitrii 30 (small blind) folded before Flop
Seat 3: Vanozik19 (big blind) showed [Ks Jh] and won ($0.81) with two pair, Kings and Deuces
Seat 4: ungiwar folded before Flop (didn't bet)
Seat 5: raydenel folded before Flop (didn't bet)
Seat 6: Acedan1369 folded before Flop (didn't bet)



PokerStars Hand #222968767406:  Hold'em No Limit ($0.05/$0.10 USD) - 2021/01/23 15:18:37 ET
Table 'Capricorn III' 6-max Seat #2 is the button
Seat 1: adilpoker84 ($23.29 in chips) 
Seat 2: Dimitrii 30 ($11.11 in chips) 
Seat 3: Vanozik19 ($17.08 in chips) 
Seat 4: ungiwar ($5.91 in chips) 
Seat 5: raydenel ($10.46 in chips) 
Seat 6: Acedan1369 ($27.98 in chips) 
Vanozik19: posts small blind $0.05
ungiwar: posts big blind $0.10
*** HOLE CARDS ***
raydenel: folds 
Acedan1369: folds 
adilpoker84: calls $0.10
Dimitrii 30: folds 
Vanozik19: raises $0.30 to $0.40
ungiwar: raises $5.51 to $5.91 and is all-in
adilpoker84: folds 
Vanozik19: folds 
Uncalled bet ($5.51) returned to ungiwar
ungiwar collected $0.90 from pot
ungiwar: doesn't show hand 
*** SUMMARY ***
Total pot $0.90 | Rake $0 
Seat 1: adilpoker84 folded before Flop
Seat 2: Dimitrii 30 (button) folded before Flop (didn't bet)
Seat 3: Vanozik19 (small blind) folded before Flop
Seat 4: ungiwar (big blind) collected ($0.90)
Seat 5: raydenel folded before Flop (didn't bet)
Seat 6: Acedan1369 folded before Flop (didn't bet)



PokerStars Hand #222968807759:  Hold'em No Limit ($0.05/$0.10 USD) - 2021/01/23 15:19:24 ET
Table 'Capricorn III' 6-max Seat #3 is the button
Seat 1: adilpoker84 ($23.19 in chips) 
Seat 2: Dimitrii 30 ($11.11 in chips) 
Seat 3: Vanozik19 ($16.68 in chips) 
Seat 4: ungiwar ($6.41 in chips) 
Seat 5: raydenel ($10.46 in chips) 
Seat 6: Acedan1369 ($27.98 in chips) 
ungiwar: posts small blind $0.05
raydenel: posts big blind $0.10
*** HOLE CARDS ***
Acedan1369: folds 
adilpoker84: folds 
Dimitrii 30 has timed out
Dimitrii 30: folds 
Vanozik19: raises $0.15 to $0.25
ungiwar: folds 
raydenel: folds 
Uncalled bet ($0.15) returned to Vanozik19
Vanozik19 collected $0.25 from pot
*** SUMMARY ***
Total pot $0.25 | Rake $0 
Seat 1: adilpoker84 folded before Flop (didn't bet)
Seat 2: Dimitrii 30 folded before Flop (didn't bet)
Seat 3: Vanozik19 (button) collected ($0.25)
Seat 4: ungiwar (small blind) folded before Flop
Seat 5: raydenel (big blind) folded before Flop
Seat 6: Acedan1369 folded before Flop (didn't bet)



PokerStars Hand #222968830855:  Hold'em No Limit ($0.05/$0.10 USD) - 2021/01/23 15:19:51 ET
Table 'Capricorn III' 6-max Seat #4 is the button
Seat 1: adilpoker84 ($23.19 in chips) 
Seat 3: Vanozik19 ($16.83 in chips) 
Seat 4: ungiwar ($6.36 in chips) 
Seat 5: raydenel ($10.36 in chips) 
Seat 6: Acedan1369 ($27.98 in chips) 
raydenel: posts small blind $0.05
Acedan1369: posts big blind $0.10
*** HOLE CARDS ***
adilpoker84: folds 
Vanozik19: raises $0.15 to $0.25
ungiwar: folds 
raydenel: folds 
Acedan1369: folds 
Uncalled bet ($0.15) returned to Vanozik19
Vanozik19 collected $0.25 from pot
*** SUMMARY ***
Total pot $0.25 | Rake $0 
Seat 1: adilpoker84 folded before Flop (didn't bet)
Seat 3: Vanozik19 collected ($0.25)
Seat 4: ungiwar (button) folded before Flop (didn't bet)
Seat 5: raydenel (small blind) folded before Flop
Seat 6: Acedan1369 (big blind) folded before Flop



PokerStars Hand #222968844880:  Hold'em No Limit ($0.05/$0.10 USD) - 2021/01/23 15:20:08 ET
Table 'Capricorn III' 6-max Seat #5 is the button
Seat 1: adilpoker84 ($23.19 in chips) 
Seat 2: Dimitrii 30 ($11.11 in chips) 
Seat 3: Vanozik19 ($16.98 in chips) 
Seat 4: ungiwar ($6.36 in chips) 
Seat 5: raydenel ($10.31 in chips) 
Seat 6: Acedan1369 ($27.88 in chips) 
Acedan1369: posts small blind $0.05
adilpoker84: posts big blind $0.10
*** HOLE CARDS ***
Dimitrii 30: folds 
Vanozik19: raises $0.15 to $0.25
ungiwar: folds 
raydenel: folds 
Acedan1369: folds 
adilpoker84: calls $0.15
*** FLOP *** [8s 5h 3c]
adilpoker84: checks 
Vanozik19: checks 
*** TURN *** [8s 5h 3c] [7d]
adilpoker84: checks 
Vanozik19: checks 
*** RIVER *** [8s 5h 3c 7d] [2s]
adilpoker84: bets $0.30
Vanozik19: folds 
Uncalled bet ($0.30) returned to adilpoker84
adilpoker84 collected $0.53 from pot
adilpoker84: doesn't show hand 
*** SUMMARY ***
Total pot $0.55 | Rake $0.02 
Board [8s 5h 3c 7d 2s]
Seat 1: adilpoker84 (big blind) collected ($0.53)
Seat 2: Dimitrii 30 folded before Flop (didn't bet)
Seat 3: Vanozik19 folded on the River
Seat 4: ungiwar folded before Flop (didn't bet)
Seat 5: raydenel (button) folded before Flop (didn't bet)
Seat 6: Acedan1369 (small blind) folded before Flop



PokerStars Hand #222968884875:  Hold'em No Limit ($0.05/$0.10 USD) - 2021/01/23 15:20:54 ET
Table 'Capricorn III' 6-max Seat #6 is the button
Seat 1: adilpoker84 ($23.47 in chips) 
Seat 2: Dimitrii 30 ($11.11 in chips) 
Seat 3: Vanozik19 ($16.73 in chips) 
Seat 4: ungiwar ($6.36 in chips) 
Seat 5: raydenel ($10.31 in chips) 
Seat 6: Acedan1369 ($27.83 in chips) 
adilpoker84: posts small blind $0.05
Dimitrii 30: posts big blind $0.10
*** HOLE CARDS ***
Vanozik19: folds 
ungiwar: folds 
raydenel: raises $0.15 to $0.25
Acedan1369: folds 
adilpoker84: folds 
Dimitrii 30: calls $0.15
*** FLOP *** [7c 5d 9d]
Dimitrii 30: checks 
raydenel: bets $0.35
Dimitrii 30: calls $0.35
*** TURN *** [7c 5d 9d] [4s]
Dimitrii 30: bets $0.90
raydenel: calls $0.90
*** RIVER *** [7c 5d 9d 4s] [8s]
Dimitrii 30: bets $1.80
raydenel: calls $1.80
*** SHOW DOWN ***
Dimitrii 30: shows [Ks Ts] (high card King)
raydenel: shows [9c 9h] (three of a kind, Nines)
raydenel collected $6.35 from pot
*** SUMMARY ***
Total pot $6.65 | Rake $0.30 
Board [7c 5d 9d 4s 8s]
Seat 1: adilpoker84 (small blind) folded before Flop
Seat 2: Dimitrii 30 (big blind) showed [Ks Ts] and lost with high card King
Seat 3: Vanozik19 folded before Flop (didn't bet)
Seat 4: ungiwar folded before Flop (didn't bet)
Seat 5: raydenel showed [9c 9h] and won ($6.35) with three of a kind, Nines
Seat 6: Acedan1369 (button) folded before Flop (didn't bet)



PokerStars Hand #222968931365:  Hold'em No Limit ($0.05/$0.10 USD) - 2021/01/23 15:21:48 ET
Table 'Capricorn III' 6-max Seat #1 is the button
Seat 1: adilpoker84 ($23.42 in chips) 
Seat 2: Dimitrii 30 ($8 in chips) 
Seat 3: Vanozik19 ($16.73 in chips) 
Seat 4: ungiwar ($6.36 in chips) 
Seat 5: raydenel ($13.36 in chips) 
Seat 6: Acedan1369 ($27.83 in chips) 
Dimitrii 30: posts small blind $0.05
Vanozik19: posts big blind $0.10
*** HOLE CARDS ***
ungiwar: folds 
raydenel: folds 
Acedan1369: folds 
adilpoker84: folds 
Dimitrii 30: folds 
Uncalled bet ($0.05) returned to Vanozik19
Vanozik19 collected $0.10 from pot
*** SUMMARY ***
Total pot $0.10 | Rake $0 
Seat 1: adilpoker84 (button) folded before Flop (didn't bet)
Seat 2: Dimitrii 30 (small blind) folded before Flop
Seat 3: Vanozik19 (big blind) collected ($0.10)
Seat 4: ungiwar folded before Flop (didn't bet)
Seat 5: raydenel folded before Flop (didn't bet)
Seat 6: Acedan1369 folded before Flop (didn't bet)



PokerStars Hand #222968945995:  Hold'em No Limit ($0.05/$0.10 USD) - 2021/01/23 15:22:05 ET
Table 'Capricorn III' 6-max Seat #2 is the button
Seat 1: adilpoker84 ($23.42 in chips) 
Seat 2: Dimitrii 30 ($8 in chips) 
Seat 3: Vanozik19 ($16.78 in chips) 
Seat 4: ungiwar ($6.36 in chips) 
Seat 5: raydenel ($13.36 in chips) 
Seat 6: Acedan1369 ($27.83 in chips) 
Vanozik19: posts small blind $0.05
ungiwar: posts big blind $0.10
*** HOLE CARDS ***
raydenel: raises $0.20 to $0.30
Acedan1369: folds 
adilpoker84: folds 
Dimitrii 30: folds 
Vanozik19: folds 
ungiwar: folds 
Uncalled bet ($0.20) returned to raydenel
raydenel collected $0.25 from pot
raydenel: doesn't show hand 
*** SUMMARY ***
Total pot $0.25 | Rake $0 
Seat 1: adilpoker84 folded before Flop (didn't bet)
Seat 2: Dimitrii 30 (button) folded before Flop (didn't bet)
Seat 3: Vanozik19 (small blind) folded before Flop
Seat 4: ungiwar (big blind) folded before Flop
Seat 5: raydenel collected ($0.25)
Seat 6: Acedan1369 folded before Flop (didn't bet)



PokerStars Hand #222968960740:  Hold'em No Limit ($0.05/$0.10 USD) - 2021/01/23 15:22:22 ET
Table 'Capricorn III' 6-max Seat #3 is the button
Seat 1: adilpoker84 ($23.42 in chips) 
Seat 2: Dimitrii 30 ($8 in chips) 
Seat 3: Vanozik19 ($16.73 in chips) 
Seat 4: ungiwar ($6.26 in chips) 
Seat 5: raydenel ($13.51 in chips) 
Seat 6: Acedan1369 ($27.83 in chips) 
ungiwar: posts small blind $0.05
raydenel: posts big blind $0.10
*** HOLE CARDS ***
Acedan1369: folds 
adilpoker84: raises $0.10 to $0.20
Dimitrii 30: folds 
Vanozik19: folds 
ungiwar: folds 
raydenel: calls $0.10
*** FLOP *** [2c 3s 8s]
raydenel: checks 
adilpoker84: checks 
*** TURN *** [2c 3s 8s] [Ac]
raydenel: checks 
adilpoker84: bets $0.20
raydenel: calls $0.20
*** RIVER *** [2c 3s 8s Ac] [7h]
raydenel: checks 
adilpoker84: bets $0.30
raydenel: folds 
Uncalled bet ($0.30) returned to adilpoker84
adilpoker84 collected $0.81 from pot
adilpoker84: doesn't show hand 
*** SUMMARY ***
Total pot $0.85 | Rake $0.04 
Board [2c 3s 8s Ac 7h]
Seat 1: adilpoker84 collected ($0.81)
Seat 2: Dimitrii 30 folded before Flop (didn't bet)
Seat 3: Vanozik19 (button) folded before Flop (didn't bet)
Seat 4: ungiwar (small blind) folded before Flop
Seat 5: raydenel (big blind) folded on the River
Seat 6: Acedan1369 folded before Flop (didn't bet)



PokerStars Hand #222968986798:  Hold'em No Limit ($0.05/$0.10 USD) - 2021/01/23 15:22:52 ET
Table 'Capricorn III' 6-max Seat #4 is the button
Seat 1: adilpoker84 ($23.83 in chips) 
Seat 2: Dimitrii 30 ($8 in chips) 
Seat 3: Vanozik19 ($16.73 in chips) 
Seat 4: ungiwar ($6.21 in chips) 
Seat 5: raydenel ($13.11 in chips) 
Seat 6: Acedan1369 ($27.83 in chips) 
raydenel: posts small blind $0.05
Acedan1369: posts big blind $0.10
*** HOLE CARDS ***
adilpoker84: folds 
Dimitrii 30: folds 
Vanozik19: folds 
ungiwar: raises $0.10 to $0.20
raydenel: folds 
Acedan1369: calls $0.10
*** FLOP *** [5d Ks 8s]
Acedan1369: checks 
ungiwar: bets $0.32
Acedan1369: folds 
Uncalled bet ($0.32) returned to ungiwar
ungiwar collected $0.43 from pot
ungiwar: doesn't show hand 
*** SUMMARY ***
Total pot $0.45 | Rake $0.02 
Board [5d Ks 8s]
Seat 1: adilpoker84 folded before Flop (didn't bet)
Seat 2: Dimitrii 30 folded before Flop (didn't bet)
Seat 3: Vanozik19 folded before Flop (didn't bet)
Seat 4: ungiwar (button) collected ($0.43)
Seat 5: raydenel (small blind) folded before Flop
Seat 6: Acedan1369 (big blind) folded on the Flop



PokerStars Hand #222969017735:  Hold'em No Limit ($0.05/$0.10 USD) - 2021/01/23 15:23:28 ET
Table 'Capricorn III' 6-max Seat #5 is the button
Seat 1: adilpoker84 ($23.83 in chips) 
Seat 2: Dimitrii 30 ($8 in chips) 
Seat 3: Vanozik19 ($16.73 in chips) 
Seat 4: ungiwar ($6.44 in chips) 
Seat 5: raydenel ($13.06 in chips) 
Seat 6: Acedan1369 ($27.63 in chips) 
Acedan1369: posts small blind $0.05
adilpoker84: posts big blind $0.10
*** HOLE CARDS ***
Dimitrii 30: folds 
Vanozik19: folds 
ungiwar: folds 
raydenel: folds 
Acedan1369: raises $0.15 to $0.25
adilpoker84: calls $0.15
*** FLOP *** [Kd Kh Jh]
Acedan1369: checks 
adilpoker84: checks 
*** TURN *** [Kd Kh Jh] [5d]
Acedan1369: checks 
adilpoker84: checks 
*** RIVER *** [Kd Kh Jh 5d] [9h]
Acedan1369: checks 
adilpoker84: bets $0.10
Acedan1369: folds 
Uncalled bet ($0.10) returned to adilpoker84
adilpoker84 collected $0.48 from pot
adilpoker84: doesn't show hand 
*** SUMMARY ***
Total pot $0.50 | Rake $0.02 
Board [Kd Kh Jh 5d 9h]
Seat 1: adilpoker84 (big blind) collected ($0.48)
Seat 2: Dimitrii 30 folded before Flop (didn't bet)
Seat 3: Vanozik19 folded before Flop (didn't bet)
Seat 4: ungiwar folded before Flop (didn't bet)
Seat 5: raydenel (button) folded before Flop (didn't bet)
Seat 6: Acedan1369 (small blind) folded on the River



PokerStars Hand #222969069685:  Hold'em No Limit ($0.05/$0.10 USD) - 2021/01/23 15:24:28 ET
Table 'Capricorn III' 6-max Seat #6 is the button
Seat 1: adilpoker84 ($24.06 in chips) 
Seat 2: Dimitrii 30 ($8 in chips) 
Seat 3: Vanozik19 ($16.73 in chips) 
Seat 4: ungiwar ($6.44 in chips) 
Seat 5: raydenel ($13.06 in chips) 
Seat 6: Acedan1369 ($27.38 in chips) 
adilpoker84: posts small blind $0.05
Dimitrii 30: posts big blind $0.10
*** HOLE CARDS ***
Vanozik19: folds 
ungiwar: folds 
raydenel: folds 
Acedan1369: folds 
adilpoker84: calls $0.05
Dimitrii 30: checks 
*** FLOP *** [Ks 8h 6c]
adilpoker84: checks 
Dimitrii 30: checks 
*** TURN *** [Ks 8h 6c] [Jh]
adilpoker84: checks 
Dimitrii 30: bets $0.10
adilpoker84: calls $0.10
*** RIVER *** [Ks 8h 6c Jh] [5h]
adilpoker84: checks 
Dimitrii 30: bets $0.19
adilpoker84: folds 
Uncalled bet ($0.19) returned to Dimitrii 30
Dimitrii 30 collected $0.38 from pot
Dimitrii 30: doesn't show hand 
*** SUMMARY ***
Total pot $0.40 | Rake $0.02 
Board [Ks 8h 6c Jh 5h]
Seat 1: adilpoker84 (small blind) folded on the River
Seat 2: Dimitrii 30 (big blind) collected ($0.38)
Seat 3: Vanozik19 folded before Flop (didn't bet)
Seat 4: ungiwar folded before Flop (didn't bet)
Seat 5: raydenel folded before Flop (didn't bet)
Seat 6: Acedan1369 (button) folded before Flop (didn't bet)



PokerStars Hand #222969112236:  Hold'em No Limit ($0.05/$0.10 USD) - 2021/01/23 15:25:18 ET
Table 'Capricorn III' 6-max Seat #1 is the button
Seat 1: adilpoker84 ($23.86 in chips) 
Seat 2: Dimitrii 30 ($8.18 in chips) 
Seat 3: Vanozik19 ($16.73 in chips) 
Seat 4: ungiwar ($6.44 in chips) 
Seat 5: raydenel ($13.06 in chips) 
Seat 6: Acedan1369 ($27.38 in chips) 
Dimitrii 30: posts small blind $0.05
Vanozik19: posts big blind $0.10
*** HOLE CARDS ***
ungiwar: folds 
raydenel: folds 
Acedan1369: folds 
adilpoker84: folds 
Dimitrii 30: folds 
Uncalled bet ($0.05) returned to Vanozik19
Vanozik19 collected $0.10 from pot
*** SUMMARY ***
Total pot $0.10 | Rake $0 
Seat 1: adilpoker84 (button) folded before Flop (didn't bet)
Seat 2: Dimitrii 30 (small blind) folded before Flop
Seat 3: Vanozik19 (big blind) collected ($0.10)
Seat 4: ungiwar folded before Flop (didn't bet)
Seat 5: raydenel folded before Flop (didn't bet)
Seat 6: Acedan1369 folded before Flop (didn't bet)



PokerStars Hand #222969123050:  Hold'em No Limit ($0.05/$0.10 USD) - 2021/01/23 15:25:31 ET
Table 'Capricorn III' 6-max Seat #2 is the button
Seat 1: adilpoker84 ($23.86 in chips) 
Seat 2: Dimitrii 30 ($8.13 in chips) 
Seat 3: Vanozik19 ($16.78 in chips) 
Seat 4: ungiwar ($6.44 in chips) 
Seat 5: raydenel ($13.06 in chips) 
Seat 6: Acedan1369 ($27.38 in chips) 
Vanozik19: posts small blind $0.05
ungiwar: posts big blind $0.10
*** HOLE CARDS ***
raydenel: folds 
Acedan1369: folds 
adilpoker84: raises $0.10 to $0.20
Dimitrii 30: folds 
Vanozik19: folds 
ungiwar: folds 
Uncalled bet ($0.10) returned to adilpoker84
adilpoker84 collected $0.25 from pot
adilpoker84: doesn't show hand 
*** SUMMARY ***
Total pot $0.25 | Rake $0 
Seat 1: adilpoker84 collected ($0.25)
Seat 2: Dimitrii 30 (button) folded before Flop (didn't bet)
Seat 3: Vanozik19 (small blind) folded before Flop
Seat 4: ungiwar (big blind) folded before Flop
Seat 5: raydenel folded before Flop (didn't bet)
Seat 6: Acedan1369 folded before Flop (didn't bet)



PokerStars Hand #222969143995:  Hold'em No Limit ($0.05/$0.10 USD) - 2021/01/23 15:25:55 ET
Table 'Capricorn III' 6-max Seat #3 is the button
Seat 1: adilpoker84 ($24.01 in chips) 
Seat 2: Dimitrii 30 ($8.13 in chips) 
Seat 3: Vanozik19 ($16.73 in chips) 
Seat 4: ungiwar ($6.34 in chips) 
Seat 5: raydenel ($13.06 in chips) 
Seat 6: Acedan1369 ($27.38 in chips) 
ungiwar: posts small blind $0.05
raydenel: posts big blind $0.10
*** HOLE CARDS ***
Acedan1369: folds 
adilpoker84: folds 
Dimitrii 30: folds 
Vanozik19: folds 
ungiwar: folds 
Uncalled bet ($0.05) returned to raydenel
raydenel collected $0.10 from pot
raydenel: doesn't show hand 
*** SUMMARY ***
Total pot $0.10 | Rake $0 
Seat 1: adilpoker84 folded before Flop (didn't bet)
Seat 2: Dimitrii 30 folded before Flop (didn't bet)
Seat 3: Vanozik19 (button) folded before Flop (didn't bet)
Seat 4: ungiwar (small blind) folded before Flop
Seat 5: raydenel (big blind) collected ($0.10)
Seat 6: Acedan1369 folded before Flop (didn't bet)



PokerStars Hand #222969151683:  Hold'em No Limit ($0.05/$0.10 USD) - 2021/01/23 15:26:04 ET
Table 'Capricorn III' 6-max Seat #4 is the button
Seat 1: adilpoker84 ($24.01 in chips) 
Seat 2: Dimitrii 30 ($8.13 in chips) 
Seat 3: Vanozik19 ($16.73 in chips) 
Seat 4: ungiwar ($6.29 in chips) 
Seat 5: raydenel ($13.11 in chips) 
Seat 6: Acedan1369 ($27.38 in chips) 
raydenel: posts small blind $0.05
Acedan1369: posts big blind $0.10
*** HOLE CARDS ***
adilpoker84: folds 
Dimitrii 30: folds 
Vanozik19: folds 
ungiwar: raises $0.10 to $0.20
raydenel: calls $0.15
Acedan1369: folds 
*** FLOP *** [Qc 8s 8c]
raydenel: checks 
ungiwar: checks 
*** TURN *** [Qc 8s 8c] [Ac]
raydenel: bets $0.24
ungiwar: folds 
Uncalled bet ($0.24) returned to raydenel
raydenel collected $0.48 from pot
raydenel: doesn't show hand 
*** SUMMARY ***
Total pot $0.50 | Rake $0.02 
Board [Qc 8s 8c Ac]
Seat 1: adilpoker84 folded before Flop (didn't bet)
Seat 2: Dimitrii 30 folded before Flop (didn't bet)
Seat 3: Vanozik19 folded before Flop (didn't bet)
Seat 4: ungiwar (button) folded on the Turn
Seat 5: raydenel (small blind) collected ($0.48)
Seat 6: Acedan1369 (big blind) folded before Flop



PokerStars Hand #222969186588:  Hold'em No Limit ($0.05/$0.10 USD) - 2021/01/23 15:26:45 ET
Table 'Capricorn III' 6-max Seat #5 is the button
Seat 1: adilpoker84 ($24.01 in chips) 
Seat 2: Dimitrii 30 ($8.13 in chips) 
Seat 3: Vanozik19 ($16.73 in chips) 
Seat 4: ungiwar ($6.09 in chips) 
Seat 5: raydenel ($13.39 in chips) 
Seat 6: Acedan1369 ($27.28 in chips) 
Acedan1369: posts small blind $0.05
adilpoker84: posts big blind $0.10
*** HOLE CARDS ***
Dimitrii 30: folds 
Vanozik19: folds 
ungiwar: folds 
raydenel: raises $0.10 to $0.20
Acedan1369: folds 
adilpoker84: calls $0.10
*** FLOP *** [As 9h 9s]
adilpoker84: checks 
raydenel: bets $0.22
adilpoker84: folds 
Uncalled bet ($0.22) returned to raydenel
raydenel collected $0.43 from pot
raydenel: doesn't show hand 
*** SUMMARY ***
Total pot $0.45 | Rake $0.02 
Board [As 9h 9s]
Seat 1: adilpoker84 (big blind) folded on the Flop
Seat 2: Dimitrii 30 folded before Flop (didn't bet)
Seat 3: Vanozik19 folded before Flop (didn't bet)
Seat 4: ungiwar folded before Flop (didn't bet)
Seat 5: raydenel (button) collected ($0.43)
Seat 6: Acedan1369 (small blind) folded before Flop



PokerStars Hand #222969206167:  Hold'em No Limit ($0.05/$0.10 USD) - 2021/01/23 15:27:08 ET
Table 'Capricorn III' 6-max Seat #6 is the button
Seat 1: adilpoker84 ($23.81 in chips) 
Seat 2: Dimitrii 30 ($8.13 in chips) 
Seat 3: Vanozik19 ($16.73 in chips) 
Seat 4: ungiwar ($6.09 in chips) 
Seat 5: raydenel ($13.62 in chips) 
Seat 6: Acedan1369 ($27.23 in chips) 
adilpoker84: posts small blind $0.05
Dimitrii 30: posts big blind $0.10
*** HOLE CARDS ***
Vanozik19: folds 
ungiwar: folds 
raydenel: raises $0.15 to $0.25
Acedan1369: folds 
adilpoker84: calls $0.20
Dimitrii 30: folds 
*** FLOP *** [Ts 5d Jc]
adilpoker84: checks 
raydenel: bets $0.38
adilpoker84: folds 
Uncalled bet ($0.38) returned to raydenel
raydenel collected $0.57 from pot
raydenel: doesn't show hand 
*** SUMMARY ***
Total pot $0.60 | Rake $0.03 
Board [Ts 5d Jc]
Seat 1: adilpoker84 (small blind) folded on the Flop
Seat 2: Dimitrii 30 (big blind) folded before Flop
Seat 3: Vanozik19 folded before Flop (didn't bet)
Seat 4: ungiwar folded before Flop (didn't bet)
Seat 5: raydenel collected ($0.57)
Seat 6: Acedan1369 (button) folded before Flop (didn't bet)



PokerStars Hand #222969222569:  Hold'em No Limit ($0.05/$0.10 USD) - 2021/01/23 15:27:27 ET
Table 'Capricorn III' 6-max Seat #1 is the button
Seat 1: adilpoker84 ($23.56 in chips) 
Seat 2: Dimitrii 30 ($8.03 in chips) 
Seat 3: Vanozik19 ($16.73 in chips) 
Seat 4: ungiwar ($6.09 in chips) 
Seat 5: raydenel ($13.94 in chips) 
Seat 6: Acedan1369 ($27.23 in chips) 
Dimitrii 30: posts small blind $0.05
Vanozik19: posts big blind $0.10
*** HOLE CARDS ***
ungiwar: folds 
raydenel: folds 
Acedan1369: raises $0.15 to $0.25
adilpoker84: calls $0.25
Dimitrii 30: folds 
Vanozik19: folds 
*** FLOP *** [4s 6s Jc]
Acedan1369: bets $0.28
adilpoker84: folds 
Uncalled bet ($0.28) returned to Acedan1369
Acedan1369 collected $0.62 from pot
Acedan1369: doesn't show hand 
*** SUMMARY ***
Total pot $0.65 | Rake $0.03 
Board [4s 6s Jc]
Seat 1: adilpoker84 (button) folded on the Flop
Seat 2: Dimitrii 30 (small blind) folded before Flop
Seat 3: Vanozik19 (big blind) folded before Flop
Seat 4: ungiwar folded before Flop (didn't bet)
Seat 5: raydenel folded before Flop (didn't bet)
Seat 6: Acedan1369 collected ($0.62)



PokerStars Hand #222969238234:  Hold'em No Limit ($0.05/$0.10 USD) - 2021/01/23 15:27:45 ET
Table 'Capricorn III' 6-max Seat #2 is the button
Seat 1: adilpoker84 ($23.31 in chips) 
Seat 2: Dimitrii 30 ($8 in chips) 
Seat 3: Vanozik19 ($16.63 in chips) 
Seat 4: ungiwar ($6.09 in chips) 
Seat 5: raydenel ($13.94 in chips) 
Seat 6: Acedan1369 ($27.60 in chips) 
Vanozik19: posts small blind $0.05
ungiwar: posts big blind $0.10
*** HOLE CARDS ***
raydenel: folds 
Acedan1369: raises $0.15 to $0.25
adilpoker84: calls $0.25
Dimitrii 30: folds 
Vanozik19: folds 
ungiwar: folds 
*** FLOP *** [Tc 4h 7h]
Acedan1369: bets $0.47
adilpoker84: folds 
Uncalled bet ($0.47) returned to Acedan1369
Acedan1369 collected $0.62 from pot
Acedan1369: doesn't show hand 
*** SUMMARY ***
Total pot $0.65 | Rake $0.03 
Board [Tc 4h 7h]
Seat 1: adilpoker84 folded on the Flop
Seat 2: Dimitrii 30 (button) folded before Flop (didn't bet)
Seat 3: Vanozik19 (small blind) folded before Flop
Seat 4: ungiwar (big blind) folded before Flop
Seat 5: raydenel folded before Flop (didn't bet)
Seat 6: Acedan1369 collected ($0.62)



PokerStars Hand #222969259137:  Hold'em No Limit ($0.05/$0.10 USD) - 2021/01/23 15:28:10 ET
Table 'Capricorn III' 6-max Seat #3 is the button
Seat 1: adilpoker84 ($23.06 in chips) 
Seat 2: Dimitrii 30 ($8 in chips) 
Seat 3: Vanozik19 ($16.58 in chips) 
Seat 4: ungiwar ($5.99 in chips) 
Seat 6: Acedan1369 ($27.97 in chips) 
ungiwar: posts small blind $0.05
raydenel: is sitting out 
Acedan1369: posts big blind $0.10
*** HOLE CARDS ***
adilpoker84: folds 
Dimitrii 30: folds 
raydenel leaves the table
Vanozik19: raises $0.15 to $0.25
ungiwar: folds 
Acedan1369: folds 
Uncalled bet ($0.15) returned to Vanozik19
Vanozik19 collected $0.25 from pot
*** SUMMARY ***
Total pot $0.25 | Rake $0 
Seat 1: adilpoker84 folded before Flop (didn't bet)
Seat 2: Dimitrii 30 folded before Flop (didn't bet)
Seat 3: Vanozik19 (button) collected ($0.25)
Seat 4: ungiwar (small blind) folded before Flop
Seat 6: Acedan1369 (big blind) folded before Flop



PokerStars Hand #222969279611:  Hold'em No Limit ($0.05/$0.10 USD) - 2021/01/23 15:28:34 ET
Table 'Capricorn III' 6-max Seat #4 is the button
Seat 1: adilpoker84 ($23.06 in chips) 
Seat 2: Dimitrii 30 ($8 in chips) 
Seat 3: Vanozik19 ($16.73 in chips) 
Seat 4: ungiwar ($5.94 in chips) 
Seat 6: Acedan1369 ($27.87 in chips) 
Acedan1369: posts small blind $0.05
adilpoker84: posts big blind $0.10
*** HOLE CARDS ***
Dimitrii 30: folds 
Vanozik19: folds 
ungiwar: raises $0.10 to $0.20
Acedan1369: folds 
adilpoker84: calls $0.10
*** FLOP *** [Jc Jh Td]
adilpoker84: checks 
ungiwar: bets $0.15
adilpoker84: folds 
Uncalled bet ($0.15) returned to ungiwar
ungiwar collected $0.43 from pot
ungiwar: doesn't show hand 
*** SUMMARY ***
Total pot $0.45 | Rake $0.02 
Board [Jc Jh Td]
Seat 1: adilpoker84 (big blind) folded on the Flop
Seat 2: Dimitrii 30 folded before Flop (didn't bet)
Seat 3: Vanozik19 folded before Flop (didn't bet)
Seat 4: ungiwar (button) collected ($0.43)
Seat 6: Acedan1369 (small blind) folded before Flop



PokerStars Hand #222969301747:  Hold'em No Limit ($0.05/$0.10 USD) - 2021/01/23 15:28:59 ET
Table 'Capricorn III' 6-max Seat #6 is the button
Seat 1: adilpoker84 ($22.86 in chips) 
Seat 2: Dimitrii 30 ($8 in chips) 
Seat 3: Vanozik19 ($16.73 in chips) 
Seat 4: ungiwar ($6.17 in chips) 
Seat 6: Acedan1369 ($27.82 in chips) 
adilpoker84: posts small blind $0.05
Dimitrii 30: posts big blind $0.10
*** HOLE CARDS ***
Vanozik19: folds 
ungiwar: folds 
Acedan1369: raises $0.15 to $0.25
adilpoker84: calls $0.20
Dimitrii 30: calls $0.15
*** FLOP *** [5d 4c 7c]
adilpoker84: checks 
Dimitrii 30: checks 
Acedan1369: checks 
*** TURN *** [5d 4c 7c] [Kh]
adilpoker84: checks 
Dimitrii 30: checks 
Acedan1369: bets $0.54
adilpoker84: folds 
Dimitrii 30: folds 
Uncalled bet ($0.54) returned to Acedan1369
Acedan1369 collected $0.72 from pot
Acedan1369: doesn't show hand 
*** SUMMARY ***
Total pot $0.75 | Rake $0.03 
Board [5d 4c 7c Kh]
Seat 1: adilpoker84 (small blind) folded on the Turn
Seat 2: Dimitrii 30 (big blind) folded on the Turn
Seat 3: Vanozik19 folded before Flop (didn't bet)
Seat 4: ungiwar folded before Flop (didn't bet)
Seat 6: Acedan1369 (button) collected ($0.72)



PokerStars Hand #222969387384:  Hold'em No Limit ($0.05/$0.10 USD) - 2021/01/23 15:30:38 ET
Table 'Capricorn III' 6-max Seat #1 is the button
Seat 1: adilpoker84 ($22.61 in chips) 
Seat 2: Dimitrii 30 ($8 in chips) 
Seat 3: Vanozik19 ($16.73 in chips) 
Seat 4: ungiwar ($6.17 in chips) 
Seat 6: Acedan1369 ($28.29 in chips) 
Dimitrii 30: posts small blind $0.05
Vanozik19: posts big blind $0.10
*** HOLE CARDS ***
ungiwar: folds 
Acedan1369: folds 
adilpoker84: calls $0.10
latnok04 joins the table at seat #5 
Dimitrii 30: folds 
Vanozik19: raises $0.30 to $0.40
adilpoker84: folds 
Uncalled bet ($0.30) returned to Vanozik19
Vanozik19 collected $0.25 from pot
*** SUMMARY ***
Total pot $0.25 | Rake $0 
Seat 1: adilpoker84 (button) folded before Flop
Seat 2: Dimitrii 30 (small blind) folded before Flop
Seat 3: Vanozik19 (big blind) collected ($0.25)
Seat 4: ungiwar folded before Flop (didn't bet)
Seat 6: Acedan1369 folded before Flop (didn't bet)



PokerStars Hand #222969431947:  Hold'em No Limit ($0.05/$0.10 USD) - 2021/01/23 15:31:17 ET
Table 'Capricorn III' 6-max Seat #2 is the button
Seat 1: adilpoker84 ($22.51 in chips) 
Seat 2: Dimitrii 30 ($8 in chips) 
Seat 3: Vanozik19 ($16.88 in chips) 
Seat 4: ungiwar ($6.17 in chips) 
Seat 6: Acedan1369 ($28.29 in chips) 
Vanozik19: posts small blind $0.05
ungiwar: posts big blind $0.10
latnok04: sits out 
*** HOLE CARDS ***
Acedan1369: folds 
adilpoker84: folds 
Dimitrii 30: raises $0.15 to $0.25
Vanozik19: raises $0.75 to $1
ungiwar: folds 
Dimitrii 30: folds 
Uncalled bet ($0.75) returned to Vanozik19
Vanozik19 collected $0.60 from pot
*** SUMMARY ***
Total pot $0.60 | Rake $0 
Seat 1: adilpoker84 folded before Flop (didn't bet)
Seat 2: Dimitrii 30 (button) folded before Flop
Seat 3: Vanozik19 (small blind) collected ($0.60)
Seat 4: ungiwar (big blind) folded before Flop
Seat 6: Acedan1369 folded before Flop (didn't bet)



PokerStars Hand #222969476628:  Hold'em No Limit ($0.05/$0.10 USD) - 2021/01/23 15:32:08 ET
Table 'Capricorn III' 6-max Seat #3 is the button
Seat 1: adilpoker84 ($22.51 in chips) 
Seat 2: Dimitrii 30 ($8 in chips) 
Seat 3: Vanozik19 ($17.23 in chips) 
Seat 4: ungiwar ($6.07 in chips) 
Seat 5: latnok04 ($10 in chips) 
Seat 6: Acedan1369 ($28.29 in chips) 
ungiwar: posts small blind $0.05
latnok04: posts big blind $0.10
*** HOLE CARDS ***
Acedan1369 has timed out
Acedan1369: folds 
adilpoker84: raises $0.10 to $0.20
Dimitrii 30: folds 
Vanozik19: folds 
ungiwar: calls $0.15
latnok04: folds 
*** FLOP *** [8d 8s 4h]
ungiwar: checks 
adilpoker84: checks 
*** TURN *** [8d 8s 4h] [7h]
ungiwar: bets $0.16
adilpoker84: calls $0.16
*** RIVER *** [8d 8s 4h 7h] [7c]
ungiwar: bets $0.78
adilpoker84: raises $0.78 to $1.56
ungiwar: folds 
Uncalled bet ($0.78) returned to adilpoker84
adilpoker84 collected $2.27 from pot
adilpoker84: doesn't show hand 
*** SUMMARY ***
Total pot $2.38 | Rake $0.11 
Board [8d 8s 4h 7h 7c]
Seat 1: adilpoker84 collected ($2.27)
Seat 2: Dimitrii 30 folded before Flop (didn't bet)
Seat 3: Vanozik19 (button) folded before Flop (didn't bet)
Seat 4: ungiwar (small blind) folded on the River
Seat 5: latnok04 (big blind) folded before Flop
Seat 6: Acedan1369 folded before Flop (didn't bet)



PokerStars Hand #222969527271:  Hold'em No Limit ($0.05/$0.10 USD) - 2021/01/23 15:33:07 ET
Table 'Capricorn III' 6-max Seat #4 is the button
Seat 1: adilpoker84 ($23.64 in chips) 
Seat 2: Dimitrii 30 ($8 in chips) 
Seat 3: Vanozik19 ($17.23 in chips) 
Seat 4: ungiwar ($4.93 in chips) 
Seat 5: latnok04 ($10 in chips) 
Seat 6: Acedan1369 ($28.29 in chips) 
latnok04: posts small blind $0.05
Acedan1369: posts big blind $0.10
*** HOLE CARDS ***
adilpoker84: raises $0.20 to $0.30
Dimitrii 30: folds 
Vanozik19: folds 
ungiwar: folds 
latnok04: folds 
Acedan1369: folds 
Uncalled bet ($0.20) returned to adilpoker84
latnok04 leaves the table
adilpoker84 collected $0.25 from pot
adilpoker84: doesn't show hand 
skems123 joins the table at seat #5 
*** SUMMARY ***
Total pot $0.25 | Rake $0 
Seat 1: adilpoker84 collected ($0.25)
Seat 2: Dimitrii 30 folded before Flop (didn't bet)
Seat 3: Vanozik19 folded before Flop (didn't bet)
Seat 4: ungiwar (button) folded before Flop (didn't bet)
Seat 5: latnok04 (small blind) folded before Flop
Seat 6: Acedan1369 (big blind) folded before Flop



PokerStars Hand #222969545964:  Hold'em No Limit ($0.05/$0.10 USD) - 2021/01/23 15:33:29 ET
Table 'Capricorn III' 6-max Seat #6 is the button
Seat 1: adilpoker84 ($23.79 in chips) 
Seat 2: Dimitrii 30 ($8 in chips) 
Seat 3: Vanozik19 ($17.23 in chips) 
Seat 4: ungiwar ($4.93 in chips) 
Seat 6: Acedan1369 ($28.19 in chips) 
adilpoker84: posts small blind $0.05
Dimitrii 30: posts big blind $0.10
skems123: sits out 
*** HOLE CARDS ***
Vanozik19: folds 
ungiwar: folds 
Acedan1369: folds 
adilpoker84: raises $0.20 to $0.30
Dimitrii 30: folds 
Uncalled bet ($0.20) returned to adilpoker84
adilpoker84 collected $0.20 from pot
adilpoker84: doesn't show hand 
*** SUMMARY ***
Total pot $0.20 | Rake $0 
Seat 1: adilpoker84 (small blind) collected ($0.20)
Seat 2: Dimitrii 30 (big blind) folded before Flop
Seat 3: Vanozik19 folded before Flop (didn't bet)
Seat 4: ungiwar folded before Flop (didn't bet)
Seat 6: Acedan1369 (button) folded before Flop (didn't bet)



PokerStars Hand #222969563554:  Hold'em No Limit ($0.05/$0.10 USD) - 2021/01/23 15:33:50 ET
Table 'Capricorn III' 6-max Seat #1 is the button
Seat 1: adilpoker84 ($23.89 in chips) 
Seat 2: Dimitrii 30 ($8 in chips) 
Seat 3: Vanozik19 ($17.23 in chips) 
Seat 4: ungiwar ($4.93 in chips) 
Seat 6: Acedan1369 ($28.19 in chips) 
Dimitrii 30: posts small blind $0.05
Vanozik19: posts big blind $0.10
skems123: sits out 
*** HOLE CARDS ***
ungiwar: folds 
Acedan1369: raises $0.15 to $0.25
adilpoker84: folds 
Dimitrii 30: folds 
Vanozik19: calls $0.15
*** FLOP *** [2c Js Td]
Vanozik19: checks 
Acedan1369: bets $0.24
Vanozik19: calls $0.24
*** TURN *** [2c Js Td] [7c]
Vanozik19: checks 
Acedan1369: bets $0.74
Vanozik19: calls $0.74
*** RIVER *** [2c Js Td 7c] [3s]
Vanozik19: checks 
Acedan1369: checks 
*** SHOW DOWN ***
Vanozik19: shows [Jd As] (a pair of Jacks)
Acedan1369: mucks hand 
Vanozik19 collected $2.40 from pot
*** SUMMARY ***
Total pot $2.51 | Rake $0.11 
Board [2c Js Td 7c 3s]
Seat 1: adilpoker84 (button) folded before Flop (didn't bet)
Seat 2: Dimitrii 30 (small blind) folded before Flop
Seat 3: Vanozik19 (big blind) showed [Jd As] and won ($2.40) with a pair of Jacks
Seat 4: ungiwar folded before Flop (didn't bet)
Seat 6: Acedan1369 mucked



PokerStars Hand #222969602615:  Hold'em No Limit ($0.05/$0.10 USD) - 2021/01/23 15:34:35 ET
Table 'Capricorn III' 6-max Seat #2 is the button
Seat 1: adilpoker84 ($23.89 in chips) 
Seat 2: Dimitrii 30 ($8 in chips) 
Seat 3: Vanozik19 ($18.40 in chips) 
Seat 4: ungiwar ($4.93 in chips) 
Seat 6: Acedan1369 ($26.96 in chips) 
Vanozik19: posts small blind $0.05
ungiwar: posts big blind $0.10
skems123: sits out 
*** HOLE CARDS ***
Acedan1369: folds 
adilpoker84: calls $0.10
Dimitrii 30: raises $0.30 to $0.40
Vanozik19: folds 
ungiwar: folds 
adilpoker84: calls $0.30
*** FLOP *** [Qs 6s 9s]
adilpoker84: checks 
Dimitrii 30: bets $0.46
adilpoker84: folds 
Uncalled bet ($0.46) returned to Dimitrii 30
Dimitrii 30 collected $0.91 from pot
Dimitrii 30: doesn't show hand 
*** SUMMARY ***
Total pot $0.95 | Rake $0.04 
Board [Qs 6s 9s]
Seat 1: adilpoker84 folded on the Flop
Seat 2: Dimitrii 30 (button) collected ($0.91)
Seat 3: Vanozik19 (small blind) folded before Flop
Seat 4: ungiwar (big blind) folded before Flop
Seat 6: Acedan1369 folded before Flop (didn't bet)



PokerStars Hand #222969632586:  Hold'em No Limit ($0.05/$0.10 USD) - 2021/01/23 15:35:08 ET
Table 'Capricorn III' 6-max Seat #3 is the button
Seat 1: adilpoker84 ($23.49 in chips) 
Seat 2: Dimitrii 30 ($8.51 in chips) 
Seat 3: Vanozik19 ($18.35 in chips) 
Seat 4: ungiwar ($4.83 in chips) 
Seat 5: skems123 ($10 in chips) 
Seat 6: Acedan1369 ($26.96 in chips) 
ungiwar: posts small blind $0.05
skems123: posts big blind $0.10
*** HOLE CARDS ***
Acedan1369: raises $0.15 to $0.25
adilpoker84: folds 
Dimitrii 30: folds 
Vanozik19: raises $0.65 to $0.90
ungiwar: folds 
skems123: folds 
Acedan1369: calls $0.65
*** FLOP *** [2h 7d 2c]
Acedan1369: checks 
Vanozik19: bets $0.61
Acedan1369: raises $1.19 to $1.80
Vanozik19: folds 
Uncalled bet ($1.19) returned to Acedan1369
Acedan1369 collected $3.03 from pot
Acedan1369: doesn't show hand 
*** SUMMARY ***
Total pot $3.17 | Rake $0.14 
Board [2h 7d 2c]
Seat 1: adilpoker84 folded before Flop (didn't bet)
Seat 2: Dimitrii 30 folded before Flop (didn't bet)
Seat 3: Vanozik19 (button) folded on the Flop
Seat 4: ungiwar (small blind) folded before Flop
Seat 5: skems123 (big blind) folded before Flop
Seat 6: Acedan1369 collected ($3.03)



PokerStars Hand #222969676483:  Hold'em No Limit ($0.05/$0.10 USD) - 2021/01/23 15:36:00 ET
Table 'Capricorn III' 6-max Seat #4 is the button
Seat 1: adilpoker84 ($23.49 in chips) 
Seat 2: Dimitrii 30 ($8.51 in chips) 
Seat 3: Vanozik19 ($16.84 in chips) 
Seat 4: ungiwar ($4.78 in chips) 
Seat 5: skems123 ($10 in chips) 
Seat 6: Acedan1369 ($28.48 in chips) 
skems123: posts small blind $0.05
Acedan1369: posts big blind $0.10
*** HOLE CARDS ***
adilpoker84: folds 
Dimitrii 30: folds 
Vanozik19: folds 
ungiwar: raises $0.10 to $0.20
skems123: raises $0.50 to $0.70
Acedan1369: folds 
ungiwar: calls $0.50
*** FLOP *** [As Ah 6c]
skems123: bets $0.37
ungiwar: folds 
Uncalled bet ($0.37) returned to skems123
skems123 collected $1.43 from pot
skems123: doesn't show hand 
*** SUMMARY ***
Total pot $1.50 | Rake $0.07 
Board [As Ah 6c]
Seat 1: adilpoker84 folded before Flop (didn't bet)
Seat 2: Dimitrii 30 folded before Flop (didn't bet)
Seat 3: Vanozik19 folded before Flop (didn't bet)
Seat 4: ungiwar (button) folded on the Flop
Seat 5: skems123 (small blind) collected ($1.43)
Seat 6: Acedan1369 (big blind) folded before Flop



PokerStars Hand #222969726851:  Hold'em No Limit ($0.05/$0.10 USD) - 2021/01/23 15:36:58 ET
Table 'Capricorn III' 6-max Seat #5 is the button
Seat 1: adilpoker84 ($23.49 in chips) 
Seat 2: Dimitrii 30 ($8.51 in chips) 
Seat 3: Vanozik19 ($16.84 in chips) 
Seat 4: ungiwar ($4.08 in chips) 
Seat 5: skems123 ($10.73 in chips) 
Seat 6: Acedan1369 ($28.38 in chips) 
Acedan1369: posts small blind $0.05
adilpoker84: posts big blind $0.10
*** HOLE CARDS ***
Dimitrii 30: raises $0.15 to $0.25
Vanozik19: folds 
ungiwar: folds 
skems123: folds 
Acedan1369: folds 
adilpoker84: folds 
Uncalled bet ($0.15) returned to Dimitrii 30
Dimitrii 30 collected $0.25 from pot
Dimitrii 30: doesn't show hand 
*** SUMMARY ***
Total pot $0.25 | Rake $0 
Seat 1: adilpoker84 (big blind) folded before Flop
Seat 2: Dimitrii 30 collected ($0.25)
Seat 3: Vanozik19 folded before Flop (didn't bet)
Seat 4: ungiwar folded before Flop (didn't bet)
Seat 5: skems123 (button) folded before Flop (didn't bet)
Seat 6: Acedan1369 (small blind) folded before Flop



PokerStars Hand #222969746905:  Hold'em No Limit ($0.05/$0.10 USD) - 2021/01/23 15:37:22 ET
Table 'Capricorn III' 6-max Seat #6 is the button
Seat 1: adilpoker84 ($23.39 in chips) 
Seat 2: Dimitrii 30 ($8.66 in chips) 
Seat 3: Vanozik19 ($16.84 in chips) 
Seat 4: ungiwar ($4.08 in chips) 
Seat 5: skems123 ($10.73 in chips) 
Seat 6: Acedan1369 ($28.33 in chips) 
adilpoker84: posts small blind $0.05
Dimitrii 30: posts big blind $0.10
*** HOLE CARDS ***
Vanozik19: folds 
ungiwar: folds 
skems123: folds 
Acedan1369: raises $0.15 to $0.25
adilpoker84: calls $0.20
Dimitrii 30: folds 
*** FLOP *** [9c 3h 6c]
adilpoker84: checks 
Acedan1369: bets $0.43
adilpoker84: calls $0.43
*** TURN *** [9c 3h 6c] [4h]
adilpoker84: checks 
Acedan1369: bets $1.04
adilpoker84: calls $1.04
*** RIVER *** [9c 3h 6c 4h] [3d]
adilpoker84: checks 
Acedan1369: bets $1.52
adilpoker84: calls $1.52
*** SHOW DOWN ***
Acedan1369: shows [Ks 9s] (two pair, Nines and Threes)
adilpoker84: mucks hand 
Acedan1369 collected $6.28 from pot
*** SUMMARY ***
Total pot $6.58 | Rake $0.30 
Board [9c 3h 6c 4h 3d]
Seat 1: adilpoker84 (small blind) mucked
Seat 2: Dimitrii 30 (big blind) folded before Flop
Seat 3: Vanozik19 folded before Flop (didn't bet)
Seat 4: ungiwar folded before Flop (didn't bet)
Seat 5: skems123 folded before Flop (didn't bet)
Seat 6: Acedan1369 (button) showed [Ks 9s] and won ($6.28) with two pair, Nines and Threes



PokerStars Hand #222969785340:  Hold'em No Limit ($0.05/$0.10 USD) - 2021/01/23 15:38:07 ET
Table 'Capricorn III' 6-max Seat #1 is the button
Seat 1: adilpoker84 ($20.15 in chips) 
Seat 2: Dimitrii 30 ($8.56 in chips) 
Seat 3: Vanozik19 ($16.84 in chips) 
Seat 4: ungiwar ($4.08 in chips) 
Seat 5: skems123 ($10.73 in chips) 
Seat 6: Acedan1369 ($31.37 in chips) 
Dimitrii 30: posts small blind $0.05
Vanozik19: posts big blind $0.10
*** HOLE CARDS ***
ungiwar: folds 
skems123: folds 
Acedan1369: raises $0.15 to $0.25
adilpoker84: folds 
Dimitrii 30: folds 
Vanozik19: folds 
Uncalled bet ($0.15) returned to Acedan1369
Acedan1369 collected $0.25 from pot
Acedan1369: doesn't show hand 
*** SUMMARY ***
Total pot $0.25 | Rake $0 
Seat 1: adilpoker84 (button) folded before Flop (didn't bet)
Seat 2: Dimitrii 30 (small blind) folded before Flop
Seat 3: Vanozik19 (big blind) folded before Flop
Seat 4: ungiwar folded before Flop (didn't bet)
Seat 5: skems123 folded before Flop (didn't bet)
Seat 6: Acedan1369 collected ($0.25)



PokerStars Hand #222969798896:  Hold'em No Limit ($0.05/$0.10 USD) - 2021/01/23 15:38:23 ET
Table 'Capricorn III' 6-max Seat #2 is the button
Seat 1: adilpoker84 ($20.15 in chips) 
Seat 2: Dimitrii 30 ($8.51 in chips) 
Seat 3: Vanozik19 ($16.74 in chips) 
Seat 4: ungiwar ($4.08 in chips) 
Seat 5: skems123 ($10.73 in chips) 
Seat 6: Acedan1369 ($31.52 in chips) 
Vanozik19: posts small blind $0.05
ungiwar: posts big blind $0.10
*** HOLE CARDS ***
skems123: folds 
Acedan1369: raises $0.15 to $0.25
adilpoker84: folds 
Dimitrii 30: folds 
Vanozik19: folds 
ungiwar: calls $0.15
*** FLOP *** [9h 6d Qc]
ungiwar: checks 
Acedan1369: bets $0.40
ungiwar: calls $0.40
*** TURN *** [9h 6d Qc] [Qh]
ungiwar: checks 
Acedan1369: bets $0.97
ungiwar: calls $0.97
*** RIVER *** [9h 6d Qc Qh] [2h]
ungiwar: checks 
Acedan1369: bets $2.50
ungiwar: calls $2.46 and is all-in
Uncalled bet ($0.04) returned to Acedan1369
*** SHOW DOWN ***
Acedan1369: shows [3c Tc] (a pair of Queens)
ungiwar: shows [Qd Kh] (three of a kind, Queens)
ungiwar collected $7.84 from pot
*** SUMMARY ***
Total pot $8.21 | Rake $0.37 
Board [9h 6d Qc Qh 2h]
Seat 1: adilpoker84 folded before Flop (didn't bet)
Seat 2: Dimitrii 30 (button) folded before Flop (didn't bet)
Seat 3: Vanozik19 (small blind) folded before Flop
Seat 4: ungiwar (big blind) showed [Qd Kh] and won ($7.84) with three of a kind, Queens
Seat 5: skems123 folded before Flop (didn't bet)
Seat 6: Acedan1369 showed [3c Tc] and lost with a pair of Queens



PokerStars Hand #222969863868:  Hold'em No Limit ($0.05/$0.10 USD) - 2021/01/23 15:39:32 ET
Table 'Capricorn III' 6-max Seat #3 is the button
Seat 1: adilpoker84 ($20.15 in chips) 
Seat 2: Dimitrii 30 ($8.51 in chips) 
Seat 3: Vanozik19 ($16.69 in chips) 
Seat 4: ungiwar ($7.84 in chips) 
Seat 5: skems123 ($10.73 in chips) 
Seat 6: Acedan1369 ($27.44 in chips) 
ungiwar: posts small blind $0.05
skems123: posts big blind $0.10
*** HOLE CARDS ***
Acedan1369: raises $0.15 to $0.25
adilpoker84: calls $0.25
Dimitrii 30: folds 
Vanozik19: folds 
ungiwar: folds 
skems123: folds 
*** FLOP *** [Jh Js Th]
Acedan1369: bets $0.28
adilpoker84: calls $0.28
*** TURN *** [Jh Js Th] [5h]
Acedan1369: checks 
adilpoker84: bets $0.60
Acedan1369: folds 
Uncalled bet ($0.60) returned to adilpoker84
adilpoker84 collected $1.16 from pot
adilpoker84: doesn't show hand 
*** SUMMARY ***
Total pot $1.21 | Rake $0.05 
Board [Jh Js Th 5h]
Seat 1: adilpoker84 collected ($1.16)
Seat 2: Dimitrii 30 folded before Flop (didn't bet)
Seat 3: Vanozik19 (button) folded before Flop (didn't bet)
Seat 4: ungiwar (small blind) folded before Flop
Seat 5: skems123 (big blind) folded before Flop
Seat 6: Acedan1369 folded on the Turn



PokerStars Hand #222969919116:  Hold'em No Limit ($0.05/$0.10 USD) - 2021/01/23 15:40:37 ET
Table 'Capricorn III' 6-max Seat #4 is the button
Seat 1: adilpoker84 ($20.78 in chips) 
Seat 2: Dimitrii 30 ($8.51 in chips) 
Seat 3: Vanozik19 ($16.69 in chips) 
Seat 4: ungiwar ($7.79 in chips) 
Seat 5: skems123 ($10.63 in chips) 
Seat 6: Acedan1369 ($26.91 in chips) 
skems123: posts small blind $0.05
Acedan1369: posts big blind $0.10
*** HOLE CARDS ***
adilpoker84: folds 
Dimitrii 30: raises $0.15 to $0.25
Vanozik19: raises $0.65 to $0.90
ungiwar: folds 
skems123: folds 
Acedan1369: folds 
Dimitrii 30: calls $0.65
*** FLOP *** [Qs 8h Ks]
Dimitrii 30: checks 
Vanozik19: bets $0.61
Dimitrii 30: folds 
Uncalled bet ($0.61) returned to Vanozik19
Vanozik19 collected $1.86 from pot
*** SUMMARY ***
Total pot $1.95 | Rake $0.09 
Board [Qs 8h Ks]
Seat 1: adilpoker84 folded before Flop (didn't bet)
Seat 2: Dimitrii 30 folded on the Flop
Seat 3: Vanozik19 collected ($1.86)
Seat 4: ungiwar (button) folded before Flop (didn't bet)
Seat 5: skems123 (small blind) folded before Flop
Seat 6: Acedan1369 (big blind) folded before Flop



PokerStars Hand #222969950770:  Hold'em No Limit ($0.05/$0.10 USD) - 2021/01/23 15:41:14 ET
Table 'Capricorn III' 6-max Seat #5 is the button
Seat 1: adilpoker84 ($20.78 in chips) 
Seat 2: Dimitrii 30 ($8 in chips) 
Seat 3: Vanozik19 ($17.65 in chips) 
Seat 4: ungiwar ($7.79 in chips) 
Seat 5: skems123 ($10.58 in chips) 
Seat 6: Acedan1369 ($26.81 in chips) 
Acedan1369: posts small blind $0.05
adilpoker84: posts big blind $0.10
*** HOLE CARDS ***
Dimitrii 30: folds 
Vanozik19: raises $0.15 to $0.25
ungiwar: folds 
skems123: folds 
Acedan1369: folds 
adilpoker84: raises $0.35 to $0.60
Vanozik19: calls $0.35
*** FLOP *** [4d 3c 3h]
adilpoker84: bets $0.60
Vanozik19: folds 
Uncalled bet ($0.60) returned to adilpoker84
adilpoker84 collected $1.19 from pot
adilpoker84: doesn't show hand 
*** SUMMARY ***
Total pot $1.25 | Rake $0.06 
Board [4d 3c 3h]
Seat 1: adilpoker84 (big blind) collected ($1.19)
Seat 2: Dimitrii 30 folded before Flop (didn't bet)
Seat 3: Vanozik19 folded on the Flop
Seat 4: ungiwar folded before Flop (didn't bet)
Seat 5: skems123 (button) folded before Flop (didn't bet)
Seat 6: Acedan1369 (small blind) folded before Flop



PokerStars Hand #222969977871:  Hold'em No Limit ($0.05/$0.10 USD) - 2021/01/23 15:41:47 ET
Table 'Capricorn III' 6-max Seat #6 is the button
Seat 1: adilpoker84 ($21.37 in chips) 
Seat 2: Dimitrii 30 ($8 in chips) 
Seat 3: Vanozik19 ($17.05 in chips) 
Seat 4: ungiwar ($7.79 in chips) 
Seat 5: skems123 ($10.58 in chips) 
Seat 6: Acedan1369 ($26.76 in chips) 
adilpoker84: posts small blind $0.05
Dimitrii 30: posts big blind $0.10
*** HOLE CARDS ***
Vanozik19: folds 
ungiwar: folds 
skems123: folds 
Acedan1369: raises $0.15 to $0.25
adilpoker84: folds 
Dimitrii 30: folds 
Uncalled bet ($0.15) returned to Acedan1369
Acedan1369 collected $0.25 from pot
Acedan1369: doesn't show hand 
*** SUMMARY ***
Total pot $0.25 | Rake $0 
Seat 1: adilpoker84 (small blind) folded before Flop
Seat 2: Dimitrii 30 (big blind) folded before Flop
Seat 3: Vanozik19 folded before Flop (didn't bet)
Seat 4: ungiwar folded before Flop (didn't bet)
Seat 5: skems123 folded before Flop (didn't bet)
Seat 6: Acedan1369 (button) collected ($0.25)



PokerStars Hand #222969989445:  Hold'em No Limit ($0.05/$0.10 USD) - 2021/01/23 15:42:01 ET
Table 'Capricorn III' 6-max Seat #1 is the button
Seat 1: adilpoker84 ($21.32 in chips) 
Seat 2: Dimitrii 30 ($8 in chips) 
Seat 3: Vanozik19 ($17.05 in chips) 
Seat 4: ungiwar ($7.79 in chips) 
Seat 5: skems123 ($10.58 in chips) 
Seat 6: Acedan1369 ($26.91 in chips) 
Dimitrii 30: posts small blind $0.05
Vanozik19: posts big blind $0.10
*** HOLE CARDS ***
ungiwar: folds 
skems123: raises $0.15 to $0.25
Acedan1369: folds 
adilpoker84: folds 
Dimitrii 30: folds 
Vanozik19: folds 
Uncalled bet ($0.15) returned to skems123
skems123 collected $0.25 from pot
skems123: doesn't show hand 
*** SUMMARY ***
Total pot $0.25 | Rake $0 
Seat 1: adilpoker84 (button) folded before Flop (didn't bet)
Seat 2: Dimitrii 30 (small blind) folded before Flop
Seat 3: Vanozik19 (big blind) folded before Flop
Seat 4: ungiwar folded before Flop (didn't bet)
Seat 5: skems123 collected ($0.25)
Seat 6: Acedan1369 folded before Flop (didn't bet)



PokerStars Hand #222970005348:  Hold'em No Limit ($0.05/$0.10 USD) - 2021/01/23 15:42:20 ET
Table 'Capricorn III' 6-max Seat #2 is the button
Seat 1: adilpoker84 ($21.32 in chips) 
Seat 2: Dimitrii 30 ($8 in chips) 
Seat 3: Vanozik19 ($16.95 in chips) 
Seat 5: skems123 ($10.73 in chips) 
Seat 6: Acedan1369 ($26.91 in chips) 
Vanozik19: posts small blind $0.05
ungiwar: is sitting out 
skems123: posts big blind $0.10
*** HOLE CARDS ***
Acedan1369: folds 
adilpoker84: folds 
Dimitrii 30: folds 
Vanozik19: folds 
Uncalled bet ($0.05) returned to skems123
skems123 collected $0.10 from pot
skems123: doesn't show hand 
*** SUMMARY ***
Total pot $0.10 | Rake $0 
Seat 1: adilpoker84 folded before Flop (didn't bet)
Seat 2: Dimitrii 30 (button) folded before Flop (didn't bet)
Seat 3: Vanozik19 (small blind) folded before Flop
Seat 5: skems123 (big blind) collected ($0.10)
Seat 6: Acedan1369 folded before Flop (didn't bet)



PokerStars Hand #222970015136:  Hold'em No Limit ($0.05/$0.10 USD) - 2021/01/23 15:42:31 ET
Table 'Capricorn III' 6-max Seat #3 is the button
Seat 1: adilpoker84 ($21.32 in chips) 
Seat 2: Dimitrii 30 ($8 in chips) 
Seat 3: Vanozik19 ($16.90 in chips) 
Seat 5: skems123 ($10.78 in chips) 
Seat 6: Acedan1369 ($26.91 in chips) 
skems123: posts small blind $0.05
Acedan1369: posts big blind $0.10
*** HOLE CARDS ***
adilpoker84: folds 
Dimitrii 30: folds 
Vanozik19: folds 
skems123: folds 
Uncalled bet ($0.05) returned to Acedan1369
Acedan1369 collected $0.10 from pot
Acedan1369: doesn't show hand 
*** SUMMARY ***
Total pot $0.10 | Rake $0 
Seat 1: adilpoker84 folded before Flop (didn't bet)
Seat 2: Dimitrii 30 folded before Flop (didn't bet)
Seat 3: Vanozik19 (button) folded before Flop (didn't bet)
Seat 5: skems123 (small blind) folded before Flop
Seat 6: Acedan1369 (big blind) collected ($0.10)



PokerStars Hand #222970025243:  Hold'em No Limit ($0.05/$0.10 USD) - 2021/01/23 15:42:43 ET
Table 'Capricorn III' 6-max Seat #5 is the button
Seat 1: adilpoker84 ($21.32 in chips) 
Seat 2: Dimitrii 30 ($8 in chips) 
Seat 3: Vanozik19 ($16.90 in chips) 
Seat 5: skems123 ($10.73 in chips) 
Seat 6: Acedan1369 ($26.96 in chips) 
Acedan1369: posts small blind $0.05
adilpoker84: posts big blind $0.10
*** HOLE CARDS ***
Dimitrii 30: raises $0.10 to $0.20
Vanozik19: folds 
skems123: folds 
Acedan1369: folds 
adilpoker84: calls $0.10
*** FLOP *** [Qc 5c 7h]
adilpoker84: checks 
Dimitrii 30: bets $0.22
adilpoker84: folds 
Uncalled bet ($0.22) returned to Dimitrii 30
Dimitrii 30 collected $0.43 from pot
Dimitrii 30: doesn't show hand 
*** SUMMARY ***
Total pot $0.45 | Rake $0.02 
Board [Qc 5c 7h]
Seat 1: adilpoker84 (big blind) folded on the Flop
Seat 2: Dimitrii 30 collected ($0.43)
Seat 3: Vanozik19 folded before Flop (didn't bet)
Seat 5: skems123 (button) folded before Flop (didn't bet)
Seat 6: Acedan1369 (small blind) folded before Flop



PokerStars Hand #222970045334:  Hold'em No Limit ($0.05/$0.10 USD) - 2021/01/23 15:43:07 ET
Table 'Capricorn III' 6-max Seat #6 is the button
Seat 1: adilpoker84 ($21.12 in chips) 
Seat 2: Dimitrii 30 ($8.23 in chips) 
Seat 3: Vanozik19 ($16.90 in chips) 
Seat 5: skems123 ($10.73 in chips) 
Seat 6: Acedan1369 ($26.91 in chips) 
adilpoker84: posts small blind $0.05
Dimitrii 30: posts big blind $0.10
*** HOLE CARDS ***
Vanozik19: folds 
skems123: folds 
Acedan1369: folds 
adilpoker84: calls $0.05
Dimitrii 30: raises $0.30 to $0.40
ungiwar leaves the table
adilpoker84: folds 
Uncalled bet ($0.30) returned to Dimitrii 30
Dimitrii 30 collected $0.20 from pot
Dimitrii 30: doesn't show hand 
aiv72 joins the table at seat #4 
*** SUMMARY ***
Total pot $0.20 | Rake $0 
Seat 1: adilpoker84 (small blind) folded before Flop
Seat 2: Dimitrii 30 (big blind) collected ($0.20)
Seat 3: Vanozik19 folded before Flop (didn't bet)
Seat 5: skems123 folded before Flop (didn't bet)
Seat 6: Acedan1369 (button) folded before Flop (didn't bet)



PokerStars Hand #222973973194:  Hold'em No Limit ($0.05/$0.10 USD) - 2021/01/23 17:04:08 ET
Table 'Capricorn III' 6-max Seat #3 is the button
Seat 1: adilpoker84 ($16.88 in chips) 
Seat 2: rubduckofdeath ($10.44 in chips) 
Seat 3: teddyKK ($16.90 in chips) 
Seat 4: SchuhaRt71 ($18.08 in chips) 
Seat 5: Gissbon ($11.76 in chips) 
Seat 6: bros1987 ($15.09 in chips) 
SchuhaRt71: posts small blind $0.05
Gissbon: posts big blind $0.10
*** HOLE CARDS ***
bros1987: folds 
adilpoker84: calls $0.10
rubduckofdeath: folds 
teddyKK: raises $0.30 to $0.40
SchuhaRt71: calls $0.35
Gissbon: folds 
adilpoker84: calls $0.30
*** FLOP *** [2d 7d Ad]
SchuhaRt71: checks 
adilpoker84: bets $0.50
teddyKK: folds 
SchuhaRt71: folds 
Uncalled bet ($0.50) returned to adilpoker84
adilpoker84 collected $1.24 from pot
adilpoker84: doesn't show hand 
*** SUMMARY ***
Total pot $1.30 | Rake $0.06 
Board [2d 7d Ad]
Seat 1: adilpoker84 collected ($1.24)
Seat 2: rubduckofdeath folded before Flop (didn't bet)
Seat 3: teddyKK (button) folded on the Flop
Seat 4: SchuhaRt71 (small blind) folded on the Flop
Seat 5: Gissbon (big blind) folded before Flop
Seat 6: bros1987 folded before Flop (didn't bet)



PokerStars Hand #222974016358:  Hold'em No Limit ($0.05/$0.10 USD) - 2021/01/23 17:04:48 ET
Table 'Capricorn III' 6-max Seat #4 is the button
Seat 1: adilpoker84 ($17.72 in chips) 
Seat 2: rubduckofdeath ($10.44 in chips) 
Seat 3: teddyKK ($16.50 in chips) 
Seat 4: SchuhaRt71 ($17.68 in chips) 
Seat 5: Gissbon ($11.66 in chips) 
Seat 6: bros1987 ($15.09 in chips) 
Gissbon: posts small blind $0.05
bros1987: posts big blind $0.10
*** HOLE CARDS ***
adilpoker84: calls $0.10
rubduckofdeath: folds 
teddyKK has timed out
teddyKK: folds 
SchuhaRt71: folds 
Gissbon: folds 
bros1987: raises $0.20 to $0.30
adilpoker84: calls $0.20
*** FLOP *** [Ah Tc 2c]
bros1987: bets $0.22
adilpoker84: folds 
Uncalled bet ($0.22) returned to bros1987
bros1987 collected $0.62 from pot
bros1987: doesn't show hand 
*** SUMMARY ***
Total pot $0.65 | Rake $0.03 
Board [Ah Tc 2c]
Seat 1: adilpoker84 folded on the Flop
Seat 2: rubduckofdeath folded before Flop (didn't bet)
Seat 3: teddyKK folded before Flop (didn't bet)
Seat 4: SchuhaRt71 (button) folded before Flop (didn't bet)
Seat 5: Gissbon (small blind) folded before Flop
Seat 6: bros1987 (big blind) collected ($0.62)



PokerStars Hand #222974041565:  Hold'em No Limit ($0.05/$0.10 USD) - 2021/01/23 17:05:18 ET
Table 'Capricorn III' 6-max Seat #5 is the button
Seat 1: adilpoker84 ($17.42 in chips) 
Seat 2: rubduckofdeath ($10.44 in chips) 
Seat 3: teddyKK ($16.50 in chips) 
Seat 4: SchuhaRt71 ($17.68 in chips) 
Seat 5: Gissbon ($11.61 in chips) 
Seat 6: bros1987 ($15.41 in chips) 
bros1987: posts small blind $0.05
adilpoker84: posts big blind $0.10
*** HOLE CARDS ***
rubduckofdeath: folds 
teddyKK: raises $0.20 to $0.30
SchuhaRt71: folds 
Gissbon: folds 
bros1987: folds 
adilpoker84: calls $0.20
*** FLOP *** [8c 7c 2h]
adilpoker84: checks 
teddyKK: bets $0.50
adilpoker84: calls $0.50
*** TURN *** [8c 7c 2h] [Ad]
adilpoker84: checks 
teddyKK: bets $1.20
adilpoker84: calls $1.20
*** RIVER *** [8c 7c 2h Ad] [Jc]
adilpoker84: bets $1.94
teddyKK: raises $12.56 to $14.50 and is all-in
adilpoker84: folds 
Uncalled bet ($12.56) returned to teddyKK
teddyKK collected $7.57 from pot
teddyKK: doesn't show hand 
*** SUMMARY ***
Total pot $7.93 | Rake $0.36 
Board [8c 7c 2h Ad Jc]
Seat 1: adilpoker84 (big blind) folded on the River
Seat 2: rubduckofdeath folded before Flop (didn't bet)
Seat 3: teddyKK collected ($7.57)
Seat 4: SchuhaRt71 folded before Flop (didn't bet)
Seat 5: Gissbon (button) folded before Flop (didn't bet)
Seat 6: bros1987 (small blind) folded before Flop



PokerStars Hand #222974090902:  Hold'em No Limit ($0.05/$0.10 USD) - 2021/01/23 17:06:17 ET
Table 'Capricorn III' 6-max Seat #6 is the button
Seat 1: adilpoker84 ($13.48 in chips) 
Seat 2: rubduckofdeath ($10.44 in chips) 
Seat 3: teddyKK ($20.13 in chips) 
Seat 4: SchuhaRt71 ($17.68 in chips) 
Seat 5: Gissbon ($11.61 in chips) 
Seat 6: bros1987 ($15.36 in chips) 
adilpoker84: posts small blind $0.05
rubduckofdeath: posts big blind $0.10
*** HOLE CARDS ***
teddyKK: folds 
SchuhaRt71: folds 
Gissbon: raises $0.15 to $0.25
bros1987: calls $0.25
adilpoker84: calls $0.20
rubduckofdeath: calls $0.15
*** FLOP *** [9h Qh 7s]
adilpoker84: checks 
rubduckofdeath: checks 
Gissbon: checks 
bros1987: bets $0.60
adilpoker84: calls $0.60
rubduckofdeath: folds 
Gissbon: folds 
*** TURN *** [9h Qh 7s] [9c]
adilpoker84: checks 
bros1987: checks 
*** RIVER *** [9h Qh 7s 9c] [6c]
adilpoker84: checks 
bros1987: checks 
*** SHOW DOWN ***
adilpoker84: shows [8c Jh] (a pair of Nines)
bros1987: shows [Kc Qs] (two pair, Queens and Nines)
bros1987 collected $2.10 from pot
*** SUMMARY ***
Total pot $2.20 | Rake $0.10 
Board [9h Qh 7s 9c 6c]
Seat 1: adilpoker84 (small blind) showed [8c Jh] and lost with a pair of Nines
Seat 2: rubduckofdeath (big blind) folded on the Flop
Seat 3: teddyKK folded before Flop (didn't bet)
Seat 4: SchuhaRt71 folded before Flop (didn't bet)
Seat 5: Gissbon folded on the Flop
Seat 6: bros1987 (button) showed [Kc Qs] and won ($2.10) with two pair, Queens and Nines



PokerStars Hand #222974128458:  Hold'em No Limit ($0.05/$0.10 USD) - 2021/01/23 17:07:02 ET
Table 'Capricorn III' 6-max Seat #1 is the button
Seat 1: adilpoker84 ($12.63 in chips) 
Seat 2: rubduckofdeath ($10.19 in chips) 
Seat 3: teddyKK ($20.13 in chips) 
Seat 4: SchuhaRt71 ($17.68 in chips) 
Seat 5: Gissbon ($11.36 in chips) 
Seat 6: bros1987 ($16.61 in chips) 
rubduckofdeath: posts small blind $0.05
teddyKK: posts big blind $0.10
*** HOLE CARDS ***
SchuhaRt71: folds 
Gissbon: folds 
bros1987: folds 
adilpoker84: calls $0.10
rubduckofdeath: raises $0.30 to $0.40
teddyKK: folds 
adilpoker84: calls $0.30
*** FLOP *** [Jc 5d 3h]
rubduckofdeath: bets $0.33
adilpoker84: folds 
Uncalled bet ($0.33) returned to rubduckofdeath
rubduckofdeath collected $0.86 from pot
rubduckofdeath: doesn't show hand 
*** SUMMARY ***
Total pot $0.90 | Rake $0.04 
Board [Jc 5d 3h]
Seat 1: adilpoker84 (button) folded on the Flop
Seat 2: rubduckofdeath (small blind) collected ($0.86)
Seat 3: teddyKK (big blind) folded before Flop
Seat 4: SchuhaRt71 folded before Flop (didn't bet)
Seat 5: Gissbon folded before Flop (didn't bet)
Seat 6: bros1987 folded before Flop (didn't bet)



PokerStars Hand #222974156273:  Hold'em No Limit ($0.05/$0.10 USD) - 2021/01/23 17:07:36 ET
Table 'Capricorn III' 6-max Seat #2 is the button
Seat 1: adilpoker84 ($12.23 in chips) 
Seat 2: rubduckofdeath ($10.65 in chips) 
Seat 3: teddyKK ($20.03 in chips) 
Seat 4: SchuhaRt71 ($17.68 in chips) 
Seat 5: Gissbon ($11.36 in chips) 
Seat 6: bros1987 ($16.61 in chips) 
teddyKK: posts small blind $0.05
SchuhaRt71: posts big blind $0.10
*** HOLE CARDS ***
Gissbon: folds 
bros1987: raises $0.20 to $0.30
adilpoker84: folds 
rubduckofdeath: folds 
teddyKK: raises $0.80 to $1.10
SchuhaRt71: folds 
bros1987: folds 
Uncalled bet ($0.80) returned to teddyKK
teddyKK collected $0.70 from pot
teddyKK: doesn't show hand 
*** SUMMARY ***
Total pot $0.70 | Rake $0 
Seat 1: adilpoker84 folded before Flop (didn't bet)
Seat 2: rubduckofdeath (button) folded before Flop (didn't bet)
Seat 3: teddyKK (small blind) collected ($0.70)
Seat 4: SchuhaRt71 (big blind) folded before Flop
Seat 5: Gissbon folded before Flop (didn't bet)
Seat 6: bros1987 folded before Flop



PokerStars Hand #222974170568:  Hold'em No Limit ($0.05/$0.10 USD) - 2021/01/23 17:07:53 ET
Table 'Capricorn III' 6-max Seat #3 is the button
Seat 1: adilpoker84 ($12.23 in chips) 
Seat 2: rubduckofdeath ($10.65 in chips) 
Seat 3: teddyKK ($20.43 in chips) 
Seat 4: SchuhaRt71 ($17.58 in chips) 
Seat 5: Gissbon ($11.36 in chips) 
Seat 6: bros1987 ($16.31 in chips) 
SchuhaRt71: posts small blind $0.05
Gissbon: posts big blind $0.10
*** HOLE CARDS ***
bros1987: folds 
adilpoker84: calls $0.10
rubduckofdeath: folds 
teddyKK: raises $0.20 to $0.30
SchuhaRt71: folds 
Gissbon: folds 
adilpoker84: calls $0.20
*** FLOP *** [7c Qc 9c]
adilpoker84: checks 
teddyKK: bets $0.54
adilpoker84: folds 
Uncalled bet ($0.54) returned to teddyKK
teddyKK collected $0.72 from pot
teddyKK: doesn't show hand 
*** SUMMARY ***
Total pot $0.75 | Rake $0.03 
Board [7c Qc 9c]
Seat 1: adilpoker84 folded on the Flop
Seat 2: rubduckofdeath folded before Flop (didn't bet)
Seat 3: teddyKK (button) collected ($0.72)
Seat 4: SchuhaRt71 (small blind) folded before Flop
Seat 5: Gissbon (big blind) folded before Flop
Seat 6: bros1987 folded before Flop (didn't bet)



PokerStars Hand #222974192173:  Hold'em No Limit ($0.05/$0.10 USD) - 2021/01/23 17:08:19 ET
Table 'Capricorn III' 6-max Seat #4 is the button
Seat 1: adilpoker84 ($11.93 in chips) 
Seat 2: rubduckofdeath ($10.65 in chips) 
Seat 3: teddyKK ($20.85 in chips) 
Seat 4: SchuhaRt71 ($17.53 in chips) 
Seat 5: Gissbon ($11.26 in chips) 
Seat 6: bros1987 ($16.31 in chips) 
Gissbon: posts small blind $0.05
bros1987: posts big blind $0.10
*** HOLE CARDS ***
adilpoker84 has timed out
adilpoker84: folds 
rubduckofdeath: folds 
teddyKK: folds 
SchuhaRt71: raises $0.20 to $0.30
Gissbon: folds 
bros1987: calls $0.20
*** FLOP *** [9c Qs Kd]
bros1987: checks 
SchuhaRt71: bets $0.31
bros1987: raises $0.69 to $1
SchuhaRt71: calls $0.69
*** TURN *** [9c Qs Kd] [8h]
bros1987: checks 
SchuhaRt71: checks 
*** RIVER *** [9c Qs Kd 8h] [Ac]
bros1987: checks 
SchuhaRt71: bets $1.69
bros1987: folds 
Uncalled bet ($1.69) returned to SchuhaRt71
SchuhaRt71 collected $2.53 from pot
SchuhaRt71: doesn't show hand 
*** SUMMARY ***
Total pot $2.65 | Rake $0.12 
Board [9c Qs Kd 8h Ac]
Seat 1: adilpoker84 folded before Flop (didn't bet)
Seat 2: rubduckofdeath folded before Flop (didn't bet)
Seat 3: teddyKK folded before Flop (didn't bet)
Seat 4: SchuhaRt71 (button) collected ($2.53)
Seat 5: Gissbon (small blind) folded before Flop
Seat 6: bros1987 (big blind) folded on the River



PokerStars Hand #222974236812:  Hold'em No Limit ($0.05/$0.10 USD) - 2021/01/23 17:09:12 ET
Table 'Capricorn III' 6-max Seat #5 is the button
Seat 1: adilpoker84 ($11.93 in chips) 
Seat 2: rubduckofdeath ($10.65 in chips) 
Seat 3: teddyKK ($20.85 in chips) 
Seat 4: SchuhaRt71 ($18.76 in chips) 
Seat 5: Gissbon ($11.21 in chips) 
Seat 6: bros1987 ($15.01 in chips) 
bros1987: posts small blind $0.05
adilpoker84: posts big blind $0.10
*** HOLE CARDS ***
rubduckofdeath: folds 
teddyKK: folds 
SchuhaRt71: folds 
Gissbon: folds 
bros1987: folds 
Uncalled bet ($0.05) returned to adilpoker84
adilpoker84 collected $0.10 from pot
adilpoker84: doesn't show hand 
*** SUMMARY ***
Total pot $0.10 | Rake $0 
Seat 1: adilpoker84 (big blind) collected ($0.10)
Seat 2: rubduckofdeath folded before Flop (didn't bet)
Seat 3: teddyKK folded before Flop (didn't bet)
Seat 4: SchuhaRt71 folded before Flop (didn't bet)
Seat 5: Gissbon (button) folded before Flop (didn't bet)
Seat 6: bros1987 (small blind) folded before Flop



PokerStars Hand #222974243973:  Hold'em No Limit ($0.05/$0.10 USD) - 2021/01/23 17:09:21 ET
Table 'Capricorn III' 6-max Seat #6 is the button
Seat 1: adilpoker84 ($11.98 in chips) 
Seat 2: rubduckofdeath ($10.65 in chips) 
Seat 3: teddyKK ($20.85 in chips) 
Seat 4: SchuhaRt71 ($18.76 in chips) 
Seat 5: Gissbon ($11.21 in chips) 
Seat 6: bros1987 ($14.96 in chips) 
adilpoker84: posts small blind $0.05
rubduckofdeath: posts big blind $0.10
*** HOLE CARDS ***
teddyKK: folds 
SchuhaRt71: folds 
Gissbon: raises $0.15 to $0.25
bros1987: folds 
adilpoker84: calls $0.20
rubduckofdeath: folds 
*** FLOP *** [Qd 8h 2s]
adilpoker84: checks 
Gissbon: checks 
*** TURN *** [Qd 8h 2s] [Kc]
adilpoker84: checks 
Gissbon: checks 
*** RIVER *** [Qd 8h 2s Kc] [4s]
adilpoker84: bets $0.10
Gissbon: folds 
Uncalled bet ($0.10) returned to adilpoker84
adilpoker84 collected $0.57 from pot
adilpoker84: doesn't show hand 
*** SUMMARY ***
Total pot $0.60 | Rake $0.03 
Board [Qd 8h 2s Kc 4s]
Seat 1: adilpoker84 (small blind) collected ($0.57)
Seat 2: rubduckofdeath (big blind) folded before Flop
Seat 3: teddyKK folded before Flop (didn't bet)
Seat 4: SchuhaRt71 folded before Flop (didn't bet)
Seat 5: Gissbon folded on the River
Seat 6: bros1987 (button) folded before Flop (didn't bet)



PokerStars Hand #222974268787:  Hold'em No Limit ($0.05/$0.10 USD) - 2021/01/23 17:09:51 ET
Table 'Capricorn III' 6-max Seat #1 is the button
Seat 1: adilpoker84 ($12.30 in chips) 
Seat 2: rubduckofdeath ($10.55 in chips) 
Seat 3: teddyKK ($20.85 in chips) 
Seat 4: SchuhaRt71 ($18.76 in chips) 
Seat 5: Gissbon ($10.96 in chips) 
Seat 6: bros1987 ($14.96 in chips) 
rubduckofdeath: posts small blind $0.05
teddyKK: posts big blind $0.10
*** HOLE CARDS ***
SchuhaRt71: folds 
Gissbon: folds 
bros1987: raises $0.16 to $0.26
adilpoker84: folds 
rubduckofdeath: folds 
teddyKK: calls $0.16
*** FLOP *** [9d Qh 2d]
teddyKK: checks 
bros1987: bets $0.40
teddyKK: folds 
Uncalled bet ($0.40) returned to bros1987
bros1987 collected $0.54 from pot
bros1987: doesn't show hand 
*** SUMMARY ***
Total pot $0.57 | Rake $0.03 
Board [9d Qh 2d]
Seat 1: adilpoker84 (button) folded before Flop (didn't bet)
Seat 2: rubduckofdeath (small blind) folded before Flop
Seat 3: teddyKK (big blind) folded on the Flop
Seat 4: SchuhaRt71 folded before Flop (didn't bet)
Seat 5: Gissbon folded before Flop (didn't bet)
Seat 6: bros1987 collected ($0.54)



PokerStars Hand #222974293365:  Hold'em No Limit ($0.05/$0.10 USD) - 2021/01/23 17:10:21 ET
Table 'Capricorn III' 6-max Seat #2 is the button
Seat 1: adilpoker84 ($12.30 in chips) 
Seat 2: rubduckofdeath ($10.50 in chips) 
Seat 3: teddyKK ($20.59 in chips) 
Seat 4: SchuhaRt71 ($18.76 in chips) 
Seat 5: Gissbon ($10.96 in chips) 
Seat 6: bros1987 ($15.24 in chips) 
teddyKK: posts small blind $0.05
SchuhaRt71: posts big blind $0.10
*** HOLE CARDS ***
Gissbon: folds 
bros1987: folds 
adilpoker84: folds 
rubduckofdeath: raises $0.20 to $0.30
teddyKK: folds 
SchuhaRt71: raises $0.80 to $1.10
rubduckofdeath: calls $0.80
*** FLOP *** [3h Th 8s]
SchuhaRt71: bets $1.43
rubduckofdeath: folds 
Uncalled bet ($1.43) returned to SchuhaRt71
SchuhaRt71 collected $2.15 from pot
SchuhaRt71: doesn't show hand 
*** SUMMARY ***
Total pot $2.25 | Rake $0.10 
Board [3h Th 8s]
Seat 1: adilpoker84 folded before Flop (didn't bet)
Seat 2: rubduckofdeath (button) folded on the Flop
Seat 3: teddyKK (small blind) folded before Flop
Seat 4: SchuhaRt71 (big blind) collected ($2.15)
Seat 5: Gissbon folded before Flop (didn't bet)
Seat 6: bros1987 folded before Flop (didn't bet)



PokerStars Hand #222974322849:  Hold'em No Limit ($0.05/$0.10 USD) - 2021/01/23 17:10:56 ET
Table 'Capricorn III' 6-max Seat #3 is the button
Seat 1: adilpoker84 ($12.30 in chips) 
Seat 2: rubduckofdeath ($10 in chips) 
Seat 3: teddyKK ($20.54 in chips) 
Seat 4: SchuhaRt71 ($19.81 in chips) 
Seat 5: Gissbon ($10.96 in chips) 
Seat 6: bros1987 ($15.24 in chips) 
SchuhaRt71: posts small blind $0.05
Gissbon: posts big blind $0.10
*** HOLE CARDS ***
bros1987: folds 
adilpoker84: folds 
rubduckofdeath: raises $0.20 to $0.30
teddyKK: folds 
SchuhaRt71: folds 
Gissbon: folds 
Uncalled bet ($0.20) returned to rubduckofdeath
rubduckofdeath collected $0.25 from pot
rubduckofdeath: doesn't show hand 
*** SUMMARY ***
Total pot $0.25 | Rake $0 
Seat 1: adilpoker84 folded before Flop (didn't bet)
Seat 2: rubduckofdeath collected ($0.25)
Seat 3: teddyKK (button) folded before Flop (didn't bet)
Seat 4: SchuhaRt71 (small blind) folded before Flop
Seat 5: Gissbon (big blind) folded before Flop
Seat 6: bros1987 folded before Flop (didn't bet)



PokerStars Hand #222974341965:  Hold'em No Limit ($0.05/$0.10 USD) - 2021/01/23 17:11:19 ET
Table 'Capricorn III' 6-max Seat #4 is the button
Seat 1: adilpoker84 ($12.30 in chips) 
Seat 2: rubduckofdeath ($10.15 in chips) 
Seat 3: teddyKK ($20.54 in chips) 
Seat 4: SchuhaRt71 ($19.76 in chips) 
Seat 5: Gissbon ($10.86 in chips) 
Seat 6: bros1987 ($15.24 in chips) 
Gissbon: posts small blind $0.05
bros1987: posts big blind $0.10
*** HOLE CARDS ***
adilpoker84: folds 
rubduckofdeath: folds 
teddyKK: raises $0.20 to $0.30
SchuhaRt71: folds 
Gissbon: folds 
bros1987: raises $0.70 to $1
teddyKK: calls $0.70
*** FLOP *** [5h Qd Qh]
bros1987: bets $0.70
teddyKK: folds 
Uncalled bet ($0.70) returned to bros1987
bros1987 collected $1.96 from pot
bros1987: doesn't show hand 
*** SUMMARY ***
Total pot $2.05 | Rake $0.09 
Board [5h Qd Qh]
Seat 1: adilpoker84 folded before Flop (didn't bet)
Seat 2: rubduckofdeath folded before Flop (didn't bet)
Seat 3: teddyKK folded on the Flop
Seat 4: SchuhaRt71 (button) folded before Flop (didn't bet)
Seat 5: Gissbon (small blind) folded before Flop
Seat 6: bros1987 (big blind) collected ($1.96)



PokerStars Hand #222974365199:  Hold'em No Limit ($0.05/$0.10 USD) - 2021/01/23 17:11:47 ET
Table 'Capricorn III' 6-max Seat #5 is the button
Seat 1: adilpoker84 ($12.30 in chips) 
Seat 2: rubduckofdeath ($10.15 in chips) 
Seat 3: teddyKK ($19.54 in chips) 
Seat 4: SchuhaRt71 ($19.76 in chips) 
Seat 5: Gissbon ($10.81 in chips) 
Seat 6: bros1987 ($16.20 in chips) 
bros1987: posts small blind $0.05
adilpoker84: posts big blind $0.10
*** HOLE CARDS ***
rubduckofdeath: folds 
teddyKK: folds 
SchuhaRt71: folds 
Gissbon: folds 
bros1987: folds 
Uncalled bet ($0.05) returned to adilpoker84
adilpoker84 collected $0.10 from pot
adilpoker84: doesn't show hand 
*** SUMMARY ***
Total pot $0.10 | Rake $0 
Seat 1: adilpoker84 (big blind) collected ($0.10)
Seat 2: rubduckofdeath folded before Flop (didn't bet)
Seat 3: teddyKK folded before Flop (didn't bet)
Seat 4: SchuhaRt71 folded before Flop (didn't bet)
Seat 5: Gissbon (button) folded before Flop (didn't bet)
Seat 6: bros1987 (small blind) folded before Flop



PokerStars Hand #222974376108:  Hold'em No Limit ($0.05/$0.10 USD) - 2021/01/23 17:12:00 ET
Table 'Capricorn III' 6-max Seat #6 is the button
Seat 1: adilpoker84 ($12.35 in chips) 
Seat 2: rubduckofdeath ($10.15 in chips) 
Seat 3: teddyKK ($19.54 in chips) 
Seat 4: SchuhaRt71 ($19.76 in chips) 
Seat 5: Gissbon ($10.81 in chips) 
Seat 6: bros1987 ($16.15 in chips) 
adilpoker84: posts small blind $0.05
rubduckofdeath: posts big blind $0.10
*** HOLE CARDS ***
teddyKK: folds 
SchuhaRt71: folds 
Gissbon: folds 
bros1987: folds 
adilpoker84: calls $0.05
rubduckofdeath: checks 
*** FLOP *** [5d 6s 8s]
adilpoker84: checks 
rubduckofdeath: bets $0.10
adilpoker84: raises $0.10 to $0.20
rubduckofdeath: calls $0.10
*** TURN *** [5d 6s 8s] [Kd]
adilpoker84: checks 
rubduckofdeath: bets $0.29
adilpoker84: calls $0.29
*** RIVER *** [5d 6s 8s Kd] [9c]
adilpoker84: checks 
rubduckofdeath: checks 
*** SHOW DOWN ***
adilpoker84: shows [8h 3d] (a pair of Eights)
rubduckofdeath: shows [Kh 5s] (two pair, Kings and Fives)
rubduckofdeath collected $1.13 from pot
*** SUMMARY ***
Total pot $1.18 | Rake $0.05 
Board [5d 6s 8s Kd 9c]
Seat 1: adilpoker84 (small blind) showed [8h 3d] and lost with a pair of Eights
Seat 2: rubduckofdeath (big blind) showed [Kh 5s] and won ($1.13) with two pair, Kings and Fives
Seat 3: teddyKK folded before Flop (didn't bet)
Seat 4: SchuhaRt71 folded before Flop (didn't bet)
Seat 5: Gissbon folded before Flop (didn't bet)
Seat 6: bros1987 (button) folded before Flop (didn't bet)



PokerStars Hand #222974406240:  Hold'em No Limit ($0.05/$0.10 USD) - 2021/01/23 17:12:37 ET
Table 'Capricorn III' 6-max Seat #1 is the button
Seat 1: adilpoker84 ($11.76 in chips) 
Seat 2: rubduckofdeath ($10.69 in chips) 
Seat 3: teddyKK ($19.54 in chips) 
Seat 4: SchuhaRt71 ($19.76 in chips) 
Seat 5: Gissbon ($10.81 in chips) 
Seat 6: bros1987 ($16.15 in chips) 
rubduckofdeath: posts small blind $0.05
teddyKK: posts big blind $0.10
*** HOLE CARDS ***
SchuhaRt71: folds 
Gissbon: folds 
bros1987: folds 
adilpoker84: raises $0.10 to $0.20
rubduckofdeath: folds 
teddyKK: folds 
Uncalled bet ($0.10) returned to adilpoker84
adilpoker84 collected $0.25 from pot
adilpoker84: doesn't show hand 
*** SUMMARY ***
Total pot $0.25 | Rake $0 
Seat 1: adilpoker84 (button) collected ($0.25)
Seat 2: rubduckofdeath (small blind) folded before Flop
Seat 3: teddyKK (big blind) folded before Flop
Seat 4: SchuhaRt71 folded before Flop (didn't bet)
Seat 5: Gissbon folded before Flop (didn't bet)
Seat 6: bros1987 folded before Flop (didn't bet)



PokerStars Hand #222974417732:  Hold'em No Limit ($0.05/$0.10 USD) - 2021/01/23 17:12:51 ET
Table 'Capricorn III' 6-max Seat #2 is the button
Seat 1: adilpoker84 ($11.91 in chips) 
Seat 2: rubduckofdeath ($10.64 in chips) 
Seat 3: teddyKK ($19.44 in chips) 
Seat 4: SchuhaRt71 ($19.76 in chips) 
Seat 5: Gissbon ($10.81 in chips) 
Seat 6: bros1987 ($16.15 in chips) 
teddyKK: posts small blind $0.05
SchuhaRt71: posts big blind $0.10
*** HOLE CARDS ***
Gissbon: folds 
bros1987: folds 
adilpoker84: calls $0.10
rubduckofdeath: folds 
teddyKK: calls $0.05
SchuhaRt71: checks 
*** FLOP *** [7h 5c 8h]
teddyKK: bets $0.22
SchuhaRt71: raises $0.98 to $1.20
adilpoker84: calls $1.20
teddyKK: calls $0.98
*** TURN *** [7h 5c 8h] [8d]
teddyKK: checks 
SchuhaRt71: bets $2.85
adilpoker84: calls $2.85
teddyKK: folds 
*** RIVER *** [7h 5c 8h 8d] [8c]
SchuhaRt71: checks 
adilpoker84: checks 
*** SHOW DOWN ***
SchuhaRt71: shows [6c 4c] (a straight, Four to Eight)
adilpoker84: mucks hand 
SchuhaRt71 collected $9.17 from pot
*** SUMMARY ***
Total pot $9.60 | Rake $0.43 
Board [7h 5c 8h 8d 8c]
Seat 1: adilpoker84 mucked
Seat 2: rubduckofdeath (button) folded before Flop (didn't bet)
Seat 3: teddyKK (small blind) folded on the Turn
Seat 4: SchuhaRt71 (big blind) showed [6c 4c] and won ($9.17) with a straight, Four to Eight
Seat 5: Gissbon folded before Flop (didn't bet)
Seat 6: bros1987 folded before Flop (didn't bet)



PokerStars Hand #222974465471:  Hold'em No Limit ($0.05/$0.10 USD) - 2021/01/23 17:13:49 ET
Table 'Capricorn III' 6-max Seat #3 is the button
Seat 1: adilpoker84 ($7.76 in chips) 
Seat 2: rubduckofdeath ($10.64 in chips) 
Seat 3: teddyKK ($18.14 in chips) 
Seat 4: SchuhaRt71 ($24.78 in chips) 
Seat 5: Gissbon ($10.81 in chips) 
Seat 6: bros1987 ($16.15 in chips) 
SchuhaRt71: posts small blind $0.05
Gissbon: posts big blind $0.10
*** HOLE CARDS ***
bros1987: folds 
adilpoker84: folds 
rubduckofdeath: folds 
teddyKK has timed out
teddyKK: folds 
SchuhaRt71: folds 
Uncalled bet ($0.05) returned to Gissbon
Gissbon collected $0.10 from pot
Gissbon: doesn't show hand 
*** SUMMARY ***
Total pot $0.10 | Rake $0 
Seat 1: adilpoker84 folded before Flop (didn't bet)
Seat 2: rubduckofdeath folded before Flop (didn't bet)
Seat 3: teddyKK (button) folded before Flop (didn't bet)
Seat 4: SchuhaRt71 (small blind) folded before Flop
Seat 5: Gissbon (big blind) collected ($0.10)
Seat 6: bros1987 folded before Flop (didn't bet)



PokerStars Hand #222974480945:  Hold'em No Limit ($0.05/$0.10 USD) - 2021/01/23 17:14:08 ET
Table 'Capricorn III' 6-max Seat #4 is the button
Seat 1: adilpoker84 ($7.76 in chips) 
Seat 2: rubduckofdeath ($10.64 in chips) 
Seat 4: SchuhaRt71 ($24.73 in chips) 
Seat 5: Gissbon ($10.86 in chips) 
Seat 6: bros1987 ($16.15 in chips) 
Gissbon: posts small blind $0.05
bros1987: posts big blind $0.10
*** HOLE CARDS ***
adilpoker84: folds 
rubduckofdeath: folds 
SchuhaRt71: folds 
Gissbon: raises $0.20 to $0.30
bros1987: raises $0.70 to $1
Gissbon: calls $0.70
*** FLOP *** [9s 8s 6d]
Gissbon: bets $0.76
bros1987: calls $0.76
*** TURN *** [9s 8s 6d] [Qd]
Gissbon: bets $1.34
bros1987: calls $1.34
*** RIVER *** [9s 8s 6d Qd] [9h]
Gissbon: bets $2.37
bros1987: calls $2.37
*** SHOW DOWN ***
Gissbon: shows [6h 6c] (a full house, Sixes full of Nines)
bros1987: mucks hand 
Gissbon collected $10.45 from pot
*** SUMMARY ***
Total pot $10.94 | Rake $0.49 
Board [9s 8s 6d Qd 9h]
Seat 1: adilpoker84 folded before Flop (didn't bet)
Seat 2: rubduckofdeath folded before Flop (didn't bet)
Seat 4: SchuhaRt71 (button) folded before Flop (didn't bet)
Seat 5: Gissbon (small blind) showed [6h 6c] and won ($10.45) with a full house, Sixes full of Nines
Seat 6: bros1987 (big blind) mucked



PokerStars Hand #222974530878:  Hold'em No Limit ($0.05/$0.10 USD) - 2021/01/23 17:15:08 ET
Table 'Capricorn III' 6-max Seat #5 is the button
Seat 1: adilpoker84 ($7.76 in chips) 
Seat 2: rubduckofdeath ($10.64 in chips) 
Seat 4: SchuhaRt71 ($24.73 in chips) 
Seat 5: Gissbon ($15.84 in chips) 
Seat 6: bros1987 ($10.68 in chips) 
bros1987: posts small blind $0.05
adilpoker84: posts big blind $0.10
*** HOLE CARDS ***
rubduckofdeath: folds 
SchuhaRt71: folds 
Gissbon: folds 
bros1987: folds 
Uncalled bet ($0.05) returned to adilpoker84
adilpoker84 collected $0.10 from pot
adilpoker84: doesn't show hand 
*** SUMMARY ***
Total pot $0.10 | Rake $0 
Seat 1: adilpoker84 (big blind) collected ($0.10)
Seat 2: rubduckofdeath folded before Flop (didn't bet)
Seat 4: SchuhaRt71 folded before Flop (didn't bet)
Seat 5: Gissbon (button) folded before Flop (didn't bet)
Seat 6: bros1987 (small blind) folded before Flop



PokerStars Hand #222974538887:  Hold'em No Limit ($0.05/$0.10 USD) - 2021/01/23 17:15:18 ET
Table 'Capricorn III' 6-max Seat #6 is the button
Seat 1: adilpoker84 ($7.81 in chips) 
Seat 2: rubduckofdeath ($10.64 in chips) 
Seat 4: SchuhaRt71 ($24.73 in chips) 
Seat 5: Gissbon ($15.84 in chips) 
Seat 6: bros1987 ($10.63 in chips) 
adilpoker84: posts small blind $0.05
rubduckofdeath: posts big blind $0.10
*** HOLE CARDS ***
SchuhaRt71: folds 
Gissbon: folds 
bros1987: folds 
adilpoker84: calls $0.05
rubduckofdeath: checks 
*** FLOP *** [Td 3s 4d]
adilpoker84: checks 
rubduckofdeath: checks 
*** TURN *** [Td 3s 4d] [3d]
adilpoker84: checks 
rubduckofdeath: checks 
*** RIVER *** [Td 3s 4d 3d] [Tc]
adilpoker84: checks 
rubduckofdeath: checks 
*** SHOW DOWN ***
adilpoker84: shows [7s 8h] (two pair, Tens and Threes)
rubduckofdeath: shows [Jc 6s] (two pair, Tens and Threes - Jack kicker)
rubduckofdeath collected $0.19 from pot
*** SUMMARY ***
Total pot $0.20 | Rake $0.01 
Board [Td 3s 4d 3d Tc]
Seat 1: adilpoker84 (small blind) showed [7s 8h] and lost with two pair, Tens and Threes
Seat 2: rubduckofdeath (big blind) showed [Jc 6s] and won ($0.19) with two pair, Tens and Threes
Seat 4: SchuhaRt71 folded before Flop (didn't bet)
Seat 5: Gissbon folded before Flop (didn't bet)
Seat 6: bros1987 (button) folded before Flop (didn't bet)



PokerStars Hand #222974559771:  Hold'em No Limit ($0.05/$0.10 USD) - 2021/01/23 17:15:43 ET
Table 'Capricorn III' 6-max Seat #1 is the button
Seat 1: adilpoker84 ($7.71 in chips) 
Seat 2: rubduckofdeath ($10.73 in chips) 
Seat 4: SchuhaRt71 ($24.73 in chips) 
Seat 5: Gissbon ($15.84 in chips) 
Seat 6: bros1987 ($10.63 in chips) 
rubduckofdeath: posts small blind $0.05
SchuhaRt71: posts big blind $0.10
*** HOLE CARDS ***
Gissbon: raises $0.15 to $0.25
bros1987: folds 
adilpoker84: calls $0.25
rubduckofdeath: folds 
SchuhaRt71: raises $0.90 to $1.15
Gissbon: folds 
adilpoker84: folds 
Uncalled bet ($0.90) returned to SchuhaRt71
SchuhaRt71 collected $0.80 from pot
SchuhaRt71: doesn't show hand 
*** SUMMARY ***
Total pot $0.80 | Rake $0 
Seat 1: adilpoker84 (button) folded before Flop
Seat 2: rubduckofdeath (small blind) folded before Flop
Seat 4: SchuhaRt71 (big blind) collected ($0.80)
Seat 5: Gissbon folded before Flop
Seat 6: bros1987 folded before Flop (didn't bet)



PokerStars Hand #222974580434:  Hold'em No Limit ($0.05/$0.10 USD) - 2021/01/23 17:16:08 ET
Table 'Capricorn III' 6-max Seat #2 is the button
Seat 1: adilpoker84 ($7.46 in chips) 
Seat 2: rubduckofdeath ($10.68 in chips) 
Seat 4: SchuhaRt71 ($25.28 in chips) 
Seat 5: Gissbon ($15.59 in chips) 
Seat 6: bros1987 ($10.63 in chips) 
SchuhaRt71: posts small blind $0.05
Gissbon: posts big blind $0.10
*** HOLE CARDS ***
bros1987: raises $0.20 to $0.30
adilpoker84: folds 
rubduckofdeath: raises $0.75 to $1.05
SchuhaRt71: folds 
Gissbon: folds 
bros1987: calls $0.75
*** FLOP *** [3d 7s 9d]
bros1987: checks 
rubduckofdeath: checks 
*** TURN *** [3d 7s 9d] [2c]
bros1987: bets $1.20
rubduckofdeath: folds 
Uncalled bet ($1.20) returned to bros1987
bros1987 collected $2.15 from pot
bros1987: doesn't show hand 
*** SUMMARY ***
Total pot $2.25 | Rake $0.10 
Board [3d 7s 9d 2c]
Seat 1: adilpoker84 folded before Flop (didn't bet)
Seat 2: rubduckofdeath (button) folded on the Turn
Seat 4: SchuhaRt71 (small blind) folded before Flop
Seat 5: Gissbon (big blind) folded before Flop
Seat 6: bros1987 collected ($2.15)



PokerStars Hand #222974607479:  Hold'em No Limit ($0.05/$0.10 USD) - 2021/01/23 17:16:41 ET
Table 'Capricorn III' 6-max Seat #4 is the button
Seat 1: adilpoker84 ($7.46 in chips) 
Seat 2: rubduckofdeath ($10 in chips) 
Seat 4: SchuhaRt71 ($25.23 in chips) 
Seat 5: Gissbon ($15.49 in chips) 
Seat 6: bros1987 ($11.73 in chips) 
Gissbon: posts small blind $0.05
bros1987: posts big blind $0.10
*** HOLE CARDS ***
adilpoker84: folds 
rubduckofdeath: folds 
SchuhaRt71: folds 
Gissbon: folds 
Uncalled bet ($0.05) returned to bros1987
bros1987 collected $0.10 from pot
bros1987: doesn't show hand 
*** SUMMARY ***
Total pot $0.10 | Rake $0 
Seat 1: adilpoker84 folded before Flop (didn't bet)
Seat 2: rubduckofdeath folded before Flop (didn't bet)
Seat 4: SchuhaRt71 (button) folded before Flop (didn't bet)
Seat 5: Gissbon (small blind) folded before Flop
Seat 6: bros1987 (big blind) collected ($0.10)



PokerStars Hand #222974622912:  Hold'em No Limit ($0.05/$0.10 USD) - 2021/01/23 17:17:00 ET
Table 'Capricorn III' 6-max Seat #5 is the button
Seat 1: adilpoker84 ($7.46 in chips) 
Seat 2: rubduckofdeath ($10 in chips) 
Seat 4: SchuhaRt71 ($25.23 in chips) 
Seat 5: Gissbon ($15.44 in chips) 
Seat 6: bros1987 ($11.78 in chips) 
bros1987: posts small blind $0.05
adilpoker84: posts big blind $0.10
*** HOLE CARDS ***
rubduckofdeath: folds 
SchuhaRt71: folds 
Gissbon: folds 
bros1987: raises $0.20 to $0.30
adilpoker84: raises $0.30 to $0.60
bros1987: calls $0.30
*** FLOP *** [6h 7d 8d]
bros1987: checks 
adilpoker84: bets $0.50
bros1987: raises $1.30 to $1.80
adilpoker84: calls $1.30
*** TURN *** [6h 7d 8d] [Qc]
bros1987: bets $9.38 and is all-in
adilpoker84: folds 
Uncalled bet ($9.38) returned to bros1987
bros1987 collected $4.58 from pot
bros1987: doesn't show hand 
*** SUMMARY ***
Total pot $4.80 | Rake $0.22 
Board [6h 7d 8d Qc]
Seat 1: adilpoker84 (big blind) folded on the Turn
Seat 2: rubduckofdeath folded before Flop (didn't bet)
Seat 4: SchuhaRt71 folded before Flop (didn't bet)
Seat 5: Gissbon (button) folded before Flop (didn't bet)
Seat 6: bros1987 (small blind) collected ($4.58)



PokerStars Hand #222974660325:  Hold'em No Limit ($0.05/$0.10 USD) - 2021/01/23 17:17:45 ET
Table 'Capricorn III' 6-max Seat #6 is the button
Seat 1: adilpoker84 ($5.06 in chips) 
Seat 2: rubduckofdeath ($10 in chips) 
Seat 4: SchuhaRt71 ($25.23 in chips) 
Seat 5: Gissbon ($15.44 in chips) 
Seat 6: bros1987 ($13.96 in chips) 
adilpoker84: posts small blind $0.05
rubduckofdeath: posts big blind $0.10
*** HOLE CARDS ***
SchuhaRt71: folds 
Gissbon: folds 
bros1987: folds 
adilpoker84: raises $0.10 to $0.20
rubduckofdeath: folds 
Uncalled bet ($0.10) returned to adilpoker84
adilpoker84 collected $0.20 from pot
adilpoker84: doesn't show hand 
*** SUMMARY ***
Total pot $0.20 | Rake $0 
Seat 1: adilpoker84 (small blind) collected ($0.20)
Seat 2: rubduckofdeath (big blind) folded before Flop
Seat 4: SchuhaRt71 folded before Flop (didn't bet)
Seat 5: Gissbon folded before Flop (didn't bet)
Seat 6: bros1987 (button) folded before Flop (didn't bet)



PokerStars Hand #222974670031:  Hold'em No Limit ($0.05/$0.10 USD) - 2021/01/23 17:17:57 ET
Table 'Capricorn III' 6-max Seat #1 is the button
Seat 1: adilpoker84 ($5.16 in chips) 
Seat 2: rubduckofdeath ($10 in chips) 
Seat 4: SchuhaRt71 ($25.23 in chips) 
Seat 5: Gissbon ($15.44 in chips) 
Seat 6: bros1987 ($13.96 in chips) 
rubduckofdeath: posts small blind $0.05
SchuhaRt71: posts big blind $0.10
*** HOLE CARDS ***
Gissbon: folds 
bros1987: folds 
adilpoker84: calls $0.10
rubduckofdeath: folds 
SchuhaRt71: checks 
*** FLOP *** [5c Ah 8d]
SchuhaRt71: checks 
adilpoker84: checks 
*** TURN *** [5c Ah 8d] [Td]
SchuhaRt71: checks 
adilpoker84: checks 
*** RIVER *** [5c Ah 8d Td] [Qd]
SchuhaRt71: checks 
adilpoker84: checks 
*** SHOW DOWN ***
SchuhaRt71: shows [4h 3s] (high card Ace)
adilpoker84: shows [5s Ks] (a pair of Fives)
adilpoker84 collected $0.24 from pot
*** SUMMARY ***
Total pot $0.25 | Rake $0.01 
Board [5c Ah 8d Td Qd]
Seat 1: adilpoker84 (button) showed [5s Ks] and won ($0.24) with a pair of Fives
Seat 2: rubduckofdeath (small blind) folded before Flop
Seat 4: SchuhaRt71 (big blind) showed [4h 3s] and lost with high card Ace
Seat 5: Gissbon folded before Flop (didn't bet)
Seat 6: bros1987 folded before Flop (didn't bet)



PokerStars Hand #222974686251:  Hold'em No Limit ($0.05/$0.10 USD) - 2021/01/23 17:18:17 ET
Table 'Capricorn III' 6-max Seat #2 is the button
Seat 1: adilpoker84 ($5.30 in chips) 
Seat 2: rubduckofdeath ($10 in chips) 
Seat 4: SchuhaRt71 ($25.13 in chips) 
Seat 5: Gissbon ($15.44 in chips) 
Seat 6: bros1987 ($13.96 in chips) 
SchuhaRt71: posts small blind $0.05
Gissbon: posts big blind $0.10
*** HOLE CARDS ***
bros1987: folds 
adilpoker84: calls $0.10
rubduckofdeath: folds 
SchuhaRt71: folds 
Gissbon: checks 
*** FLOP *** [8d 4c Jc]
Gissbon: checks 
adilpoker84: bets $0.20
Gissbon: folds 
Uncalled bet ($0.20) returned to adilpoker84
adilpoker84 collected $0.24 from pot
adilpoker84: doesn't show hand 
*** SUMMARY ***
Total pot $0.25 | Rake $0.01 
Board [8d 4c Jc]
Seat 1: adilpoker84 collected ($0.24)
Seat 2: rubduckofdeath (button) folded before Flop (didn't bet)
Seat 4: SchuhaRt71 (small blind) folded before Flop
Seat 5: Gissbon (big blind) folded on the Flop
Seat 6: bros1987 folded before Flop (didn't bet)



PokerStars Hand #222974698127:  Hold'em No Limit ($0.05/$0.10 USD) - 2021/01/23 17:18:31 ET
Table 'Capricorn III' 6-max Seat #4 is the button
Seat 1: adilpoker84 ($5.44 in chips) 
Seat 2: rubduckofdeath ($10 in chips) 
Seat 4: SchuhaRt71 ($25.08 in chips) 
Seat 5: Gissbon ($15.34 in chips) 
Seat 6: bros1987 ($13.96 in chips) 
Gissbon: posts small blind $0.05
bros1987: posts big blind $0.10
*** HOLE CARDS ***
adilpoker84: folds 
rubduckofdeath: raises $0.20 to $0.30
SchuhaRt71: folds 
Gissbon: folds 
bros1987: raises $0.70 to $1
rubduckofdeath: calls $0.70
*** FLOP *** [Th Qh Js]
bros1987: bets $0.70
rubduckofdeath: calls $0.70
*** TURN *** [Th Qh Js] [3d]
bros1987: bets $1.80
rubduckofdeath: calls $1.80
*** RIVER *** [Th Qh Js 3d] [6h]
bros1987: checks 
rubduckofdeath: checks 
*** SHOW DOWN ***
bros1987: shows [Kc Ad] (a straight, Ten to Ace)
rubduckofdeath: mucks hand 
bros1987 collected $6.73 from pot
*** SUMMARY ***
Total pot $7.05 | Rake $0.32 
Board [Th Qh Js 3d 6h]
Seat 1: adilpoker84 folded before Flop (didn't bet)
Seat 2: rubduckofdeath mucked
Seat 4: SchuhaRt71 (button) folded before Flop (didn't bet)
Seat 5: Gissbon (small blind) folded before Flop
Seat 6: bros1987 (big blind) showed [Kc Ad] and won ($6.73) with a straight, Ten to Ace



PokerStars Hand #222974742037:  Hold'em No Limit ($0.05/$0.10 USD) - 2021/01/23 17:19:25 ET
Table 'Capricorn III' 6-max Seat #5 is the button
Seat 1: adilpoker84 ($5.44 in chips) 
Seat 2: rubduckofdeath ($10 in chips) 
Seat 4: SchuhaRt71 ($25.08 in chips) 
Seat 5: Gissbon ($15.29 in chips) 
Seat 6: bros1987 ($17.19 in chips) 
bros1987: posts small blind $0.05
adilpoker84: posts big blind $0.10
*** HOLE CARDS ***
rubduckofdeath: folds 
SchuhaRt71: folds 
Gissbon: folds 
bros1987: folds 
Uncalled bet ($0.05) returned to adilpoker84
adilpoker84 collected $0.10 from pot
adilpoker84: doesn't show hand 
*** SUMMARY ***
Total pot $0.10 | Rake $0 
Seat 1: adilpoker84 (big blind) collected ($0.10)
Seat 2: rubduckofdeath folded before Flop (didn't bet)
Seat 4: SchuhaRt71 folded before Flop (didn't bet)
Seat 5: Gissbon (button) folded before Flop (didn't bet)
Seat 6: bros1987 (small blind) folded before Flop



PokerStars Hand #222974749306:  Hold'em No Limit ($0.05/$0.10 USD) - 2021/01/23 17:19:34 ET
Table 'Capricorn III' 6-max Seat #6 is the button
Seat 1: adilpoker84 ($5.49 in chips) 
Seat 2: rubduckofdeath ($10 in chips) 
Seat 4: SchuhaRt71 ($25.08 in chips) 
Seat 5: Gissbon ($15.29 in chips) 
Seat 6: bros1987 ($17.14 in chips) 
adilpoker84: posts small blind $0.05
rubduckofdeath: posts big blind $0.10
*** HOLE CARDS ***
SchuhaRt71: folds 
Gissbon: folds 
bros1987: folds 
adilpoker84: raises $0.10 to $0.20
rubduckofdeath: folds 
Uncalled bet ($0.10) returned to adilpoker84
adilpoker84 collected $0.20 from pot
adilpoker84: doesn't show hand 
*** SUMMARY ***
Total pot $0.20 | Rake $0 
Seat 1: adilpoker84 (small blind) collected ($0.20)
Seat 2: rubduckofdeath (big blind) folded before Flop
Seat 4: SchuhaRt71 folded before Flop (didn't bet)
Seat 5: Gissbon folded before Flop (didn't bet)
Seat 6: bros1987 (button) folded before Flop (didn't bet)



PokerStars Hand #222974759272:  Hold'em No Limit ($0.05/$0.10 USD) - 2021/01/23 17:19:46 ET
Table 'Capricorn III' 6-max Seat #1 is the button
Seat 1: adilpoker84 ($5.59 in chips) 
Seat 2: rubduckofdeath ($10 in chips) 
Seat 4: SchuhaRt71 ($25.08 in chips) 
Seat 5: Gissbon ($15.29 in chips) 
Seat 6: bros1987 ($17.14 in chips) 
rubduckofdeath: posts small blind $0.05
SchuhaRt71: posts big blind $0.10
*** HOLE CARDS ***
Gissbon: folds 
bros1987: folds 
adilpoker84: raises $0.10 to $0.20
rubduckofdeath: folds 
SchuhaRt71: folds 
Uncalled bet ($0.10) returned to adilpoker84
adilpoker84 collected $0.25 from pot
adilpoker84: doesn't show hand 
*** SUMMARY ***
Total pot $0.25 | Rake $0 
Seat 1: adilpoker84 (button) collected ($0.25)
Seat 2: rubduckofdeath (small blind) folded before Flop
Seat 4: SchuhaRt71 (big blind) folded before Flop
Seat 5: Gissbon folded before Flop (didn't bet)
Seat 6: bros1987 folded before Flop (didn't bet)



PokerStars Hand #222974769710:  Hold'em No Limit ($0.05/$0.10 USD) - 2021/01/23 17:19:59 ET
Table 'Capricorn III' 6-max Seat #2 is the button
Seat 1: adilpoker84 ($5.74 in chips) 
Seat 2: rubduckofdeath ($10 in chips) 
Seat 4: SchuhaRt71 ($24.98 in chips) 
Seat 6: bros1987 ($17.14 in chips) 
SchuhaRt71: posts small blind $0.05
Gissbon: is sitting out 
bros1987: posts big blind $0.10
*** HOLE CARDS ***
adilpoker84: raises $0.10 to $0.20
Gissbon leaves the table
rubduckofdeath: folds 
SchuhaRt71: folds 
bros1987: folds 
Uncalled bet ($0.10) returned to adilpoker84
adilpoker84 collected $0.25 from pot
adilpoker84: doesn't show hand 
*** SUMMARY ***
Total pot $0.25 | Rake $0 
Seat 1: adilpoker84 collected ($0.25)
Seat 2: rubduckofdeath (button) folded before Flop (didn't bet)
Seat 4: SchuhaRt71 (small blind) folded before Flop
Seat 6: bros1987 (big blind) folded before Flop



PokerStars Hand #222974783902:  Hold'em No Limit ($0.05/$0.10 USD) - 2021/01/23 17:20:16 ET
Table 'Capricorn III' 6-max Seat #4 is the button
Seat 1: adilpoker84 ($5.89 in chips) 
Seat 2: rubduckofdeath ($10 in chips) 
Seat 4: SchuhaRt71 ($24.93 in chips) 
Seat 6: bros1987 ($17.04 in chips) 
bros1987: posts small blind $0.05
adilpoker84: posts big blind $0.10
*** HOLE CARDS ***
rubduckofdeath: folds 
SchuhaRt71: folds 
bros1987: folds 
Uncalled bet ($0.05) returned to adilpoker84
adilpoker84 collected $0.10 from pot
adilpoker84: doesn't show hand 
*** SUMMARY ***
Total pot $0.10 | Rake $0 
Seat 1: adilpoker84 (big blind) collected ($0.10)
Seat 2: rubduckofdeath folded before Flop (didn't bet)
Seat 4: SchuhaRt71 (button) folded before Flop (didn't bet)
Seat 6: bros1987 (small blind) folded before Flop



PokerStars Hand #222974791180:  Hold'em No Limit ($0.05/$0.10 USD) - 2021/01/23 17:20:25 ET
Table 'Capricorn III' 6-max Seat #6 is the button
Seat 1: adilpoker84 ($5.94 in chips) 
Seat 2: rubduckofdeath ($10 in chips) 
Seat 4: SchuhaRt71 ($24.93 in chips) 
Seat 6: bros1987 ($16.99 in chips) 
adilpoker84: posts small blind $0.05
rubduckofdeath: posts big blind $0.10
*** HOLE CARDS ***
SchuhaRt71: folds 
bros1987: raises $0.16 to $0.26
adilpoker84: calls $0.21
rubduckofdeath: raises $0.78 to $1.04
bros1987: folds 
adilpoker84: calls $0.78
*** FLOP *** [Ts 4s Th]
adilpoker84: checks 
rubduckofdeath: bets $1.12
adilpoker84: folds 
Uncalled bet ($1.12) returned to rubduckofdeath
rubduckofdeath collected $2.23 from pot
rubduckofdeath: doesn't show hand 
*** SUMMARY ***
Total pot $2.34 | Rake $0.11 
Board [Ts 4s Th]
Seat 1: adilpoker84 (small blind) folded on the Flop
Seat 2: rubduckofdeath (big blind) collected ($2.23)
Seat 4: SchuhaRt71 folded before Flop (didn't bet)
Seat 6: bros1987 (button) folded before Flop



PokerStars Hand #222974811327:  Hold'em No Limit ($0.05/$0.10 USD) - 2021/01/23 17:20:50 ET
Table 'Capricorn III' 6-max Seat #1 is the button
Seat 1: adilpoker84 ($4.90 in chips) 
Seat 2: rubduckofdeath ($11.19 in chips) 
Seat 4: SchuhaRt71 ($24.93 in chips) 
Seat 6: bros1987 ($16.73 in chips) 
rubduckofdeath: posts small blind $0.05
SchuhaRt71: posts big blind $0.10
*** HOLE CARDS ***
bros1987: folds 
adilpoker84: folds 
rubduckofdeath: raises $0.20 to $0.30
SchuhaRt71: folds 
Uncalled bet ($0.20) returned to rubduckofdeath
rubduckofdeath collected $0.20 from pot
teddyKK was removed from the table for failing to post
teddyKK leaves the table
rubduckofdeath: doesn't show hand 
*** SUMMARY ***
Total pot $0.20 | Rake $0 
Seat 1: adilpoker84 (button) folded before Flop (didn't bet)
Seat 2: rubduckofdeath (small blind) collected ($0.20)
Seat 4: SchuhaRt71 (big blind) folded before Flop
Seat 6: bros1987 folded before Flop (didn't bet)



PokerStars Hand #222974821065:  Hold'em No Limit ($0.05/$0.10 USD) - 2021/01/23 17:21:02 ET
Table 'Capricorn III' 6-max Seat #2 is the button
Seat 1: adilpoker84 ($4.90 in chips) 
Seat 2: rubduckofdeath ($11.29 in chips) 
Seat 4: SchuhaRt71 ($24.83 in chips) 
Seat 6: bros1987 ($16.73 in chips) 
SchuhaRt71: posts small blind $0.05
bros1987: posts big blind $0.10
*** HOLE CARDS ***
adilpoker84: folds 
bawsak17 joins the table at seat #5 
rubduckofdeath: folds 
SchuhaRt71: raises $0.15 to $0.25
bros1987: calls $0.15
*** FLOP *** [6s Kd 9h]
SchuhaRt71: bets $0.30
bros1987: folds 
Uncalled bet ($0.30) returned to SchuhaRt71
SchuhaRt71 collected $0.48 from pot
SchuhaRt71: doesn't show hand 
*** SUMMARY ***
Total pot $0.50 | Rake $0.02 
Board [6s Kd 9h]
Seat 1: adilpoker84 folded before Flop (didn't bet)
Seat 2: rubduckofdeath (button) folded before Flop (didn't bet)
Seat 4: SchuhaRt71 (small blind) collected ($0.48)
Seat 6: bros1987 (big blind) folded on the Flop



PokerStars Hand #222974840135:  Hold'em No Limit ($0.05/$0.10 USD) - 2021/01/23 17:21:26 ET
Table 'Capricorn III' 6-max Seat #4 is the button
Seat 1: adilpoker84 ($4.90 in chips) 
Seat 2: rubduckofdeath ($11.29 in chips) 
Seat 4: SchuhaRt71 ($25.06 in chips) 
Seat 6: bros1987 ($16.48 in chips) 
bros1987: posts small blind $0.05
adilpoker84: posts big blind $0.10
*** HOLE CARDS ***
rubduckofdeath: folds 
SchuhaRt71: folds 
bros1987: raises $0.16 to $0.26
adilpoker84: calls $0.16
*** FLOP *** [4d Jc 5d]
bros1987: bets $0.50
adilpoker84: raises $0.50 to $1
bros1987: raises $15.22 to $16.22 and is all-in
adilpoker84: calls $3.64 and is all-in
Uncalled bet ($11.58) returned to bros1987
*** TURN *** [4d Jc 5d] [7c]
*** RIVER *** [4d Jc 5d 7c] [Ts]
*** SHOW DOWN ***
bros1987: shows [5h 4h] (two pair, Fives and Fours)
adilpoker84: shows [5c Qc] (a pair of Fives)
bros1987 collected $9.36 from pot
adilpoker84 cashed out the hand for $2.81 | Cash Out Fee $0.03
*** SUMMARY ***
Total pot $9.80 | Rake $0.44 
Board [4d Jc 5d 7c Ts]
Seat 1: adilpoker84 (big blind) showed [5c Qc] and lost with a pair of Fives (cashed out).
Seat 2: rubduckofdeath folded before Flop (didn't bet)
Seat 4: SchuhaRt71 (button) folded before Flop (didn't bet)
Seat 6: bros1987 (small blind) showed [5h 4h] and won ($9.36) with two pair, Fives and Fours



PokerStars Hand #222974863006:  Hold'em No Limit ($0.05/$0.10 USD) - 2021/01/23 17:21:54 ET
Table 'Capricorn III' 6-max Seat #6 is the button
Seat 1: adilpoker84 ($2.81 in chips) 
Seat 2: rubduckofdeath ($11.29 in chips) 
Seat 4: SchuhaRt71 ($25.06 in chips) 
Seat 6: bros1987 ($20.94 in chips) 
adilpoker84: posts small blind $0.05
rubduckofdeath: posts big blind $0.10
bawsak17: sits out 
*** HOLE CARDS ***
SchuhaRt71: folds 
bros1987: folds 
adilpoker84: raises $0.10 to $0.20
rubduckofdeath: folds 
Uncalled bet ($0.10) returned to adilpoker84
adilpoker84 collected $0.20 from pot
adilpoker84: doesn't show hand 
*** SUMMARY ***
Total pot $0.20 | Rake $0 
Seat 1: adilpoker84 (small blind) collected ($0.20)
Seat 2: rubduckofdeath (big blind) folded before Flop
Seat 4: SchuhaRt71 folded before Flop (didn't bet)
Seat 6: bros1987 (button) folded before Flop (didn't bet)



PokerStars Hand #222974870416:  Hold'em No Limit ($0.05/$0.10 USD) - 2021/01/23 17:22:03 ET
Table 'Capricorn III' 6-max Seat #1 is the button
Seat 1: adilpoker84 ($2.91 in chips) 
Seat 2: rubduckofdeath ($11.19 in chips) 
Seat 4: SchuhaRt71 ($25.06 in chips) 
Seat 6: bros1987 ($20.94 in chips) 
rubduckofdeath: posts small blind $0.05
SchuhaRt71: posts big blind $0.10
bawsak17: sits out 
*** HOLE CARDS ***
bros1987: folds 
adilpoker84: calls $0.10
rubduckofdeath: folds 
SchuhaRt71: checks 
*** FLOP *** [4c 8h 7s]
SchuhaRt71: checks 
teddyKK joins the table at seat #3 
adilpoker84: checks 
*** TURN *** [4c 8h 7s] [2c]
SchuhaRt71: checks 
adilpoker84: checks 
*** RIVER *** [4c 8h 7s 2c] [9c]
SchuhaRt71: checks 
adilpoker84: checks 
*** SHOW DOWN ***
SchuhaRt71: shows [3d 2s] (a pair of Deuces)
adilpoker84: mucks hand 
SchuhaRt71 collected $0.24 from pot
*** SUMMARY ***
Total pot $0.25 | Rake $0.01 
Board [4c 8h 7s 2c 9c]
Seat 1: adilpoker84 (button) mucked
Seat 2: rubduckofdeath (small blind) folded before Flop
Seat 4: SchuhaRt71 (big blind) showed [3d 2s] and won ($0.24) with a pair of Deuces
Seat 6: bros1987 folded before Flop (didn't bet)



PokerStars Hand #222974899109:  Hold'em No Limit ($0.05/$0.10 USD) - 2021/01/23 17:22:38 ET
Table 'Capricorn III' 6-max Seat #2 is the button
Seat 1: adilpoker84 ($2.81 in chips) 
Seat 2: rubduckofdeath ($11.14 in chips) 
Seat 4: SchuhaRt71 ($25.20 in chips) 
Seat 5: bawsak17 ($10 in chips) 
Seat 6: bros1987 ($20.94 in chips) 
SchuhaRt71: posts small blind $0.05
bawsak17: posts big blind $0.10
*** HOLE CARDS ***
bros1987: folds 
adilpoker84: calls $0.10
rubduckofdeath: raises $0.20 to $0.30
SchuhaRt71: folds 
bawsak17: folds 
adilpoker84: calls $0.20
*** FLOP *** [Ts Js 6d]
adilpoker84: checks 
rubduckofdeath: bets $0.36
adilpoker84: calls $0.36
*** TURN *** [Ts Js 6d] [9c]
adilpoker84: checks 
rubduckofdeath: checks 
*** RIVER *** [Ts Js 6d 9c] [Th]
adilpoker84: bets $2.15 and is all-in
rubduckofdeath: folds 
Uncalled bet ($2.15) returned to adilpoker84
adilpoker84 collected $1.40 from pot
adilpoker84: doesn't show hand 
*** SUMMARY ***
Total pot $1.47 | Rake $0.07 
Board [Ts Js 6d 9c Th]
Seat 1: adilpoker84 collected ($1.40)
Seat 2: rubduckofdeath (button) folded on the River
Seat 4: SchuhaRt71 (small blind) folded before Flop
Seat 5: bawsak17 (big blind) folded before Flop
Seat 6: bros1987 folded before Flop (didn't bet)



PokerStars Hand #222974924089:  Hold'em No Limit ($0.05/$0.10 USD) - 2021/01/23 17:23:09 ET
Table 'Capricorn III' 6-max Seat #4 is the button
Seat 1: adilpoker84 ($3.55 in chips) 
Seat 2: rubduckofdeath ($10.48 in chips) 
Seat 4: SchuhaRt71 ($25.15 in chips) 
Seat 5: bawsak17 ($10 in chips) 
Seat 6: bros1987 ($20.94 in chips) 
bawsak17: posts small blind $0.05
bros1987: posts big blind $0.10
teddyKK: sits out 
*** HOLE CARDS ***
adilpoker84: calls $0.10
rubduckofdeath: folds 
SchuhaRt71: folds 
bawsak17: folds 
bros1987: checks 
*** FLOP *** [9s 8c 7s]
bros1987: checks 
adilpoker84: checks 
*** TURN *** [9s 8c 7s] [7c]
bros1987: checks 
adilpoker84: bets $0.10
bros1987: calls $0.10
*** RIVER *** [9s 8c 7s 7c] [Tc]
bros1987: checks 
adilpoker84: bets $0.30
bros1987: calls $0.30
*** SHOW DOWN ***
adilpoker84: shows [Kc Js] (a straight, Seven to Jack)
bros1987: mucks hand 
adilpoker84 collected $1 from pot
*** SUMMARY ***
Total pot $1.05 | Rake $0.05 
Board [9s 8c 7s 7c Tc]
Seat 1: adilpoker84 showed [Kc Js] and won ($1) with a straight, Seven to Jack
Seat 2: rubduckofdeath folded before Flop (didn't bet)
Seat 4: SchuhaRt71 (button) folded before Flop (didn't bet)
Seat 5: bawsak17 (small blind) folded before Flop
Seat 6: bros1987 (big blind) mucked



PokerStars Hand #222974944542:  Hold'em No Limit ($0.05/$0.10 USD) - 2021/01/23 17:23:34 ET
Table 'Capricorn III' 6-max Seat #5 is the button
Seat 1: adilpoker84 ($4.05 in chips) 
Seat 2: rubduckofdeath ($10.48 in chips) 
Seat 4: SchuhaRt71 ($25.15 in chips) 
Seat 5: bawsak17 ($10 in chips) 
Seat 6: bros1987 ($20.44 in chips) 
bros1987: posts small blind $0.05
adilpoker84: posts big blind $0.10
teddyKK: sits out 
*** HOLE CARDS ***
rubduckofdeath: folds 
SchuhaRt71: raises $0.20 to $0.30
bawsak17: folds 
bros1987: calls $0.25
adilpoker84: calls $0.20
*** FLOP *** [5c Js 5d]
bros1987: checks 
adilpoker84: checks 
SchuhaRt71: checks 
*** TURN *** [5c Js 5d] [3h]
bros1987: bets $0.39
adilpoker84: folds 
SchuhaRt71: folds 
Uncalled bet ($0.39) returned to bros1987
bros1987 collected $0.86 from pot
bros1987: doesn't show hand 
*** SUMMARY ***
Total pot $0.90 | Rake $0.04 
Board [5c Js 5d 3h]
Seat 1: adilpoker84 (big blind) folded on the Turn
Seat 2: rubduckofdeath folded before Flop (didn't bet)
Seat 4: SchuhaRt71 folded on the Turn
Seat 5: bawsak17 (button) folded before Flop (didn't bet)
Seat 6: bros1987 (small blind) collected ($0.86)



PokerStars Hand #222974976877:  Hold'em No Limit ($0.05/$0.10 USD) - 2021/01/23 17:24:14 ET
Table 'Capricorn III' 6-max Seat #6 is the button
Seat 1: adilpoker84 ($3.75 in chips) 
Seat 2: rubduckofdeath ($10.48 in chips) 
Seat 4: SchuhaRt71 ($24.85 in chips) 
Seat 5: bawsak17 ($10 in chips) 
Seat 6: bros1987 ($21 in chips) 
adilpoker84: posts small blind $0.05
rubduckofdeath: posts big blind $0.10
teddyKK: sits out 
*** HOLE CARDS ***
SchuhaRt71: folds 
bawsak17: folds 
bros1987: folds 
adilpoker84: calls $0.05
rubduckofdeath: checks 
*** FLOP *** [8d 7d 2d]
adilpoker84: checks 
rubduckofdeath: checks 
*** TURN *** [8d 7d 2d] [Qd]
adilpoker84: checks 
rubduckofdeath: checks 
*** RIVER *** [8d 7d 2d Qd] [4h]
adilpoker84: checks 
rubduckofdeath: checks 
*** SHOW DOWN ***
adilpoker84: shows [6c Jh] (high card Queen)
rubduckofdeath: shows [Tc 7c] (a pair of Sevens)
rubduckofdeath collected $0.19 from pot
*** SUMMARY ***
Total pot $0.20 | Rake $0.01 
Board [8d 7d 2d Qd 4h]
Seat 1: adilpoker84 (small blind) showed [6c Jh] and lost with high card Queen
Seat 2: rubduckofdeath (big blind) showed [Tc 7c] and won ($0.19) with a pair of Sevens
Seat 4: SchuhaRt71 folded before Flop (didn't bet)
Seat 5: bawsak17 folded before Flop (didn't bet)
Seat 6: bros1987 (button) folded before Flop (didn't bet)



PokerStars Hand #222975002660:  Hold'em No Limit ($0.05/$0.10 USD) - 2021/01/23 17:24:46 ET
Table 'Capricorn III' 6-max Seat #1 is the button
Seat 1: adilpoker84 ($3.65 in chips) 
Seat 2: rubduckofdeath ($10.57 in chips) 
Seat 3: teddyKK ($17.12 in chips) 
Seat 4: SchuhaRt71 ($24.85 in chips) 
Seat 5: bawsak17 ($10 in chips) 
Seat 6: bros1987 ($21 in chips) 
rubduckofdeath: posts small blind $0.05
teddyKK: posts big blind $0.10
*** HOLE CARDS ***
SchuhaRt71: folds 
bawsak17: folds 
bros1987: raises $0.16 to $0.26
adilpoker84: calls $0.26
rubduckofdeath: folds 
teddyKK: folds 
*** FLOP *** [Td 6d Tc]
bros1987: bets $0.22
adilpoker84: raises $0.38 to $0.60
bros1987: folds 
Uncalled bet ($0.38) returned to adilpoker84
adilpoker84 collected $1.06 from pot
adilpoker84: doesn't show hand 
*** SUMMARY ***
Total pot $1.11 | Rake $0.05 
Board [Td 6d Tc]
Seat 1: adilpoker84 (button) collected ($1.06)
Seat 2: rubduckofdeath (small blind) folded before Flop
Seat 3: teddyKK (big blind) folded before Flop
Seat 4: SchuhaRt71 folded before Flop (didn't bet)
Seat 5: bawsak17 folded before Flop (didn't bet)
Seat 6: bros1987 folded on the Flop



PokerStars Hand #222975025094:  Hold'em No Limit ($0.05/$0.10 USD) - 2021/01/23 17:25:14 ET
Table 'Capricorn III' 6-max Seat #2 is the button
Seat 1: adilpoker84 ($4.23 in chips) 
Seat 2: rubduckofdeath ($10.52 in chips) 
Seat 3: teddyKK ($17.02 in chips) 
Seat 4: SchuhaRt71 ($24.85 in chips) 
Seat 5: bawsak17 ($10 in chips) 
Seat 6: bros1987 ($20.52 in chips) 
teddyKK: posts small blind $0.05
SchuhaRt71: posts big blind $0.10
*** HOLE CARDS ***
bawsak17: folds 
bros1987: folds 
adilpoker84: folds 
rubduckofdeath: folds 
teddyKK: raises $0.20 to $0.30
SchuhaRt71: folds 
Uncalled bet ($0.20) returned to teddyKK
teddyKK collected $0.20 from pot
teddyKK: doesn't show hand 
*** SUMMARY ***
Total pot $0.20 | Rake $0 
Seat 1: adilpoker84 folded before Flop (didn't bet)
Seat 2: rubduckofdeath (button) folded before Flop (didn't bet)
Seat 3: teddyKK (small blind) collected ($0.20)
Seat 4: SchuhaRt71 (big blind) folded before Flop
Seat 5: bawsak17 folded before Flop (didn't bet)
Seat 6: bros1987 folded before Flop (didn't bet)



PokerStars Hand #222975034823:  Hold'em No Limit ($0.05/$0.10 USD) - 2021/01/23 17:25:26 ET
Table 'Capricorn III' 6-max Seat #3 is the button
Seat 1: adilpoker84 ($4.23 in chips) 
Seat 2: rubduckofdeath ($10.52 in chips) 
Seat 3: teddyKK ($17.12 in chips) 
Seat 4: SchuhaRt71 ($24.75 in chips) 
Seat 5: bawsak17 ($10 in chips) 
Seat 6: bros1987 ($20.52 in chips) 
SchuhaRt71: posts small blind $0.05
bawsak17: posts big blind $0.10
*** HOLE CARDS ***
bros1987: folds 
adilpoker84: raises $0.10 to $0.20
rubduckofdeath: raises $0.55 to $0.75
teddyKK: folds 
SchuhaRt71: folds 
bawsak17: folds 
adilpoker84: raises $0.75 to $1.50
rubduckofdeath: raises $3.15 to $4.65
adilpoker84: calls $2.73 and is all-in
Uncalled bet ($0.42) returned to rubduckofdeath
*** FLOP *** [Jc 8s Kh]
*** TURN *** [Jc 8s Kh] [3c]
*** RIVER *** [Jc 8s Kh 3c] [5c]
*** SHOW DOWN ***
adilpoker84: shows [Ad Ac] (a pair of Aces)
rubduckofdeath: shows [Kd Ah] (a pair of Kings)
adilpoker84 collected $8.22 from pot
*** SUMMARY ***
Total pot $8.61 | Rake $0.39 
Board [Jc 8s Kh 3c 5c]
Seat 1: adilpoker84 showed [Ad Ac] and won ($8.22) with a pair of Aces
Seat 2: rubduckofdeath showed [Kd Ah] and lost with a pair of Kings
Seat 3: teddyKK (button) folded before Flop (didn't bet)
Seat 4: SchuhaRt71 (small blind) folded before Flop
Seat 5: bawsak17 (big blind) folded before Flop
Seat 6: bros1987 folded before Flop (didn't bet)



PokerStars Hand #222975063476:  Hold'em No Limit ($0.05/$0.10 USD) - 2021/01/23 17:26:02 ET
Table 'Capricorn III' 6-max Seat #4 is the button
Seat 1: adilpoker84 ($8.22 in chips) 
Seat 2: rubduckofdeath ($10 in chips) 
Seat 3: teddyKK ($17.12 in chips) 
Seat 4: SchuhaRt71 ($24.70 in chips) 
Seat 5: bawsak17 ($10 in chips) 
Seat 6: bros1987 ($20.52 in chips) 
bawsak17: posts small blind $0.05
bros1987: posts big blind $0.10
*** HOLE CARDS ***
adilpoker84: folds 
rubduckofdeath: folds 
teddyKK: folds 
SchuhaRt71: folds 
bawsak17: raises $0.15 to $0.25
bros1987: folds 
Uncalled bet ($0.15) returned to bawsak17
bawsak17 collected $0.20 from pot
bawsak17: doesn't show hand 
*** SUMMARY ***
Total pot $0.20 | Rake $0 
Seat 1: adilpoker84 folded before Flop (didn't bet)
Seat 2: rubduckofdeath folded before Flop (didn't bet)
Seat 3: teddyKK folded before Flop (didn't bet)
Seat 4: SchuhaRt71 (button) folded before Flop (didn't bet)
Seat 5: bawsak17 (small blind) collected ($0.20)
Seat 6: bros1987 (big blind) folded before Flop



PokerStars Hand #222975076588:  Hold'em No Limit ($0.05/$0.10 USD) - 2021/01/23 17:26:18 ET
Table 'Capricorn III' 6-max Seat #5 is the button
Seat 1: adilpoker84 ($8.22 in chips) 
Seat 2: rubduckofdeath ($10 in chips) 
Seat 3: teddyKK ($17.12 in chips) 
Seat 4: SchuhaRt71 ($24.70 in chips) 
Seat 5: bawsak17 ($10.10 in chips) 
Seat 6: bros1987 ($20.42 in chips) 
bros1987: posts small blind $0.05
adilpoker84: posts big blind $0.10
*** HOLE CARDS ***
rubduckofdeath: raises $0.20 to $0.30
teddyKK: folds 
SchuhaRt71: folds 
bawsak17: calls $0.30
bros1987: folds 
adilpoker84: calls $0.20
*** FLOP *** [Tc 8c 8d]
adilpoker84: checks 
rubduckofdeath: bets $0.46
bawsak17: calls $0.46
adilpoker84: folds 
*** TURN *** [Tc 8c 8d] [Jd]
rubduckofdeath: checks 
bawsak17: checks 
*** RIVER *** [Tc 8c 8d Jd] [5c]
rubduckofdeath: checks 
bawsak17: bets $1.34
rubduckofdeath: calls $1.34
*** SHOW DOWN ***
bawsak17: shows [9c Ac] (a flush, Ace high)
rubduckofdeath: mucks hand 
bawsak17 collected $4.35 from pot
*** SUMMARY ***
Total pot $4.55 | Rake $0.20 
Board [Tc 8c 8d Jd 5c]
Seat 1: adilpoker84 (big blind) folded on the Flop
Seat 2: rubduckofdeath mucked
Seat 3: teddyKK folded before Flop (didn't bet)
Seat 4: SchuhaRt71 folded before Flop (didn't bet)
Seat 5: bawsak17 (button) showed [9c Ac] and won ($4.35) with a flush, Ace high
Seat 6: bros1987 (small blind) folded before Flop



PokerStars Hand #222975119887:  Hold'em No Limit ($0.05/$0.10 USD) - 2021/01/23 17:27:12 ET
Table 'Capricorn III' 6-max Seat #6 is the button
Seat 1: adilpoker84 ($7.92 in chips) 
Seat 2: rubduckofdeath ($10 in chips) 
Seat 3: teddyKK ($17.12 in chips) 
Seat 4: SchuhaRt71 ($24.70 in chips) 
Seat 5: bawsak17 ($12.35 in chips) 
Seat 6: bros1987 ($20.37 in chips) 
adilpoker84: posts small blind $0.05
rubduckofdeath: posts big blind $0.10
*** HOLE CARDS ***
teddyKK: folds 
SchuhaRt71: folds 
bawsak17: raises $0.15 to $0.25
bros1987: calls $0.25
adilpoker84: folds 
rubduckofdeath: raises $0.80 to $1.05
bawsak17: raises $11.30 to $12.35 and is all-in
bros1987: folds 
rubduckofdeath: folds 
Uncalled bet ($11.30) returned to bawsak17
bawsak17 collected $2.40 from pot
bawsak17: doesn't show hand 
*** SUMMARY ***
Total pot $2.40 | Rake $0 
Seat 1: adilpoker84 (small blind) folded before Flop
Seat 2: rubduckofdeath (big blind) folded before Flop
Seat 3: teddyKK folded before Flop (didn't bet)
Seat 4: SchuhaRt71 folded before Flop (didn't bet)
Seat 5: bawsak17 collected ($2.40)
Seat 6: bros1987 (button) folded before Flop



PokerStars Hand #222975139692:  Hold'em No Limit ($0.05/$0.10 USD) - 2021/01/23 17:27:37 ET
Table 'Capricorn III' 6-max Seat #1 is the button
Seat 1: adilpoker84 ($7.87 in chips) 
Seat 2: rubduckofdeath ($10 in chips) 
Seat 3: teddyKK ($17.12 in chips) 
Seat 4: SchuhaRt71 ($24.70 in chips) 
Seat 5: bawsak17 ($13.70 in chips) 
Seat 6: bros1987 ($20.12 in chips) 
rubduckofdeath: posts small blind $0.05
teddyKK: posts big blind $0.10
*** HOLE CARDS ***
SchuhaRt71: folds 
bawsak17: raises $0.15 to $0.25
bros1987: raises $0.75 to $1
adilpoker84: folds 
rubduckofdeath: folds 
teddyKK: folds 
bawsak17: folds 
Uncalled bet ($0.75) returned to bros1987
bros1987 collected $0.65 from pot
bros1987: doesn't show hand 
*** SUMMARY ***
Total pot $0.65 | Rake $0 
Seat 1: adilpoker84 (button) folded before Flop (didn't bet)
Seat 2: rubduckofdeath (small blind) folded before Flop
Seat 3: teddyKK (big blind) folded before Flop
Seat 4: SchuhaRt71 folded before Flop (didn't bet)
Seat 5: bawsak17 folded before Flop
Seat 6: bros1987 collected ($0.65)



PokerStars Hand #222975155338:  Hold'em No Limit ($0.05/$0.10 USD) - 2021/01/23 17:27:53 ET
Table 'Capricorn III' 6-max Seat #2 is the button
Seat 1: adilpoker84 ($7.87 in chips) 
Seat 2: rubduckofdeath ($10 in chips) 
Seat 3: teddyKK ($17.02 in chips) 
Seat 4: SchuhaRt71 ($24.70 in chips) 
Seat 5: bawsak17 ($13.45 in chips) 
Seat 6: bros1987 ($20.52 in chips) 
teddyKK: posts small blind $0.05
SchuhaRt71: posts big blind $0.10
*** HOLE CARDS ***
bawsak17: folds 
bros1987: folds 
adilpoker84: folds 
rubduckofdeath: folds 
teddyKK: folds 
Uncalled bet ($0.05) returned to SchuhaRt71
SchuhaRt71 collected $0.10 from pot
SchuhaRt71: doesn't show hand 
*** SUMMARY ***
Total pot $0.10 | Rake $0 
Seat 1: adilpoker84 folded before Flop (didn't bet)
Seat 2: rubduckofdeath (button) folded before Flop (didn't bet)
Seat 3: teddyKK (small blind) folded before Flop
Seat 4: SchuhaRt71 (big blind) collected ($0.10)
Seat 5: bawsak17 folded before Flop (didn't bet)
Seat 6: bros1987 folded before Flop (didn't bet)



PokerStars Hand #222975167756:  Hold'em No Limit ($0.05/$0.10 USD) - 2021/01/23 17:28:08 ET
Table 'Capricorn III' 6-max Seat #3 is the button
Seat 1: adilpoker84 ($7.87 in chips) 
Seat 2: rubduckofdeath ($10 in chips) 
Seat 3: teddyKK ($16.97 in chips) 
Seat 4: SchuhaRt71 ($24.75 in chips) 
SchuhaRt71: posts small blind $0.05
bawsak17: is sitting out 
bros1987: is sitting out 
adilpoker84: posts big blind $0.10
*** HOLE CARDS ***
rubduckofdeath: folds 
bawsak17 leaves the table
teddyKK: folds 
SchuhaRt71: raises $0.50 to $0.60
adilpoker84: calls $0.50
*** FLOP *** [6d Kc 2h]
SchuhaRt71: bets $0.86
Lovimdzen joins the table at seat #5 
adilpoker84: folds 
Uncalled bet ($0.86) returned to SchuhaRt71
SchuhaRt71 collected $1.15 from pot
SchuhaRt71: doesn't show hand 
*** SUMMARY ***
Total pot $1.20 | Rake $0.05 
Board [6d Kc 2h]
Seat 1: adilpoker84 (big blind) folded on the Flop
Seat 2: rubduckofdeath folded before Flop (didn't bet)
Seat 3: teddyKK (button) folded before Flop (didn't bet)
Seat 4: SchuhaRt71 (small blind) collected ($1.15)



PokerStars Hand #222975193368:  Hold'em No Limit ($0.05/$0.10 USD) - 2021/01/23 17:28:40 ET
Table 'Capricorn III' 6-max Seat #4 is the button
Seat 1: adilpoker84 ($7.27 in chips) 
Seat 2: rubduckofdeath ($10 in chips) 
Seat 3: teddyKK ($16.97 in chips) 
Seat 4: SchuhaRt71 ($25.30 in chips) 
adilpoker84: posts small blind $0.05
rubduckofdeath: posts big blind $0.10
*** HOLE CARDS ***
teddyKK: raises $0.20 to $0.30
SchuhaRt71: folds 
adilpoker84: calls $0.25
rubduckofdeath: folds 
*** FLOP *** [7h Qc 8c]
adilpoker84: checks 
teddyKK: checks 
*** TURN *** [7h Qc 8c] [4h]
adilpoker84: checks 
teddyKK: checks 
*** RIVER *** [7h Qc 8c 4h] [Ac]
adilpoker84: checks 
teddyKK: checks 
*** SHOW DOWN ***
adilpoker84: shows [9s Kh] (high card Ace)
teddyKK: shows [3c 3d] (a pair of Threes)
teddyKK collected $0.67 from pot
*** SUMMARY ***
Total pot $0.70 | Rake $0.03 
Board [7h Qc 8c 4h Ac]
Seat 1: adilpoker84 (small blind) showed [9s Kh] and lost with high card Ace
Seat 2: rubduckofdeath (big blind) folded before Flop
Seat 3: teddyKK showed [3c 3d] and won ($0.67) with a pair of Threes
Seat 4: SchuhaRt71 (button) folded before Flop (didn't bet)



PokerStars Hand #222975232069:  Hold'em No Limit ($0.05/$0.10 USD) - 2021/01/23 17:29:29 ET
Table 'Capricorn III' 6-max Seat #1 is the button
Seat 1: adilpoker84 ($6.97 in chips) 
Seat 2: rubduckofdeath ($10 in chips) 
Seat 3: teddyKK ($17.34 in chips) 
Seat 4: SchuhaRt71 ($25.30 in chips) 
rubduckofdeath: posts small blind $0.05
teddyKK: posts big blind $0.10
Lovimdzen: sits out 
*** HOLE CARDS ***
SchuhaRt71: folds 
adilpoker84: calls $0.10
rubduckofdeath: folds 
teddyKK: raises $0.40 to $0.50
adilpoker84: folds 
Uncalled bet ($0.40) returned to teddyKK
teddyKK collected $0.25 from pot
teddyKK: doesn't show hand 
*** SUMMARY ***
Total pot $0.25 | Rake $0 
Seat 1: adilpoker84 (button) folded before Flop
Seat 2: rubduckofdeath (small blind) folded before Flop
Seat 3: teddyKK (big blind) collected ($0.25)
Seat 4: SchuhaRt71 folded before Flop (didn't bet)



PokerStars Hand #222975243906:  Hold'em No Limit ($0.05/$0.10 USD) - 2021/01/23 17:29:44 ET
Table 'Capricorn III' 6-max Seat #2 is the button
Seat 1: adilpoker84 ($6.87 in chips) 
Seat 2: rubduckofdeath ($10 in chips) 
Seat 3: teddyKK ($17.49 in chips) 
Seat 5: Lovimdzen ($4 in chips) 
teddyKK: posts small blind $0.05
SchuhaRt71: is sitting out 
Lovimdzen: posts big blind $0.10
*** HOLE CARDS ***
adilpoker84: raises $0.20 to $0.30
rubduckofdeath: folds 
bros1987 leaves the table
teddyKK: folds 
joma620 joins the table at seat #6 
Lovimdzen: calls $0.20
*** FLOP *** [2c Td Qd]
Lovimdzen: checks 
adilpoker84: bets $0.30
Lovimdzen: calls $0.30
*** TURN *** [2c Td Qd] [3h]
Lovimdzen: checks 
adilpoker84: bets $0.60
Lovimdzen: folds 
Uncalled bet ($0.60) returned to adilpoker84
adilpoker84 collected $1.19 from pot
adilpoker84: doesn't show hand 
*** SUMMARY ***
Total pot $1.25 | Rake $0.06 
Board [2c Td Qd 3h]
Seat 1: adilpoker84 collected ($1.19)
Seat 2: rubduckofdeath (button) folded before Flop (didn't bet)
Seat 3: teddyKK (small blind) folded before Flop
Seat 5: Lovimdzen (big blind) folded on the Turn



PokerStars Hand #222975281179:  Hold'em No Limit ($0.05/$0.10 USD) - 2021/01/23 17:30:31 ET
Table 'Capricorn III' 6-max Seat #3 is the button
Seat 1: adilpoker84 ($7.46 in chips) 
Seat 2: rubduckofdeath ($10 in chips) 
Seat 3: teddyKK ($17.44 in chips) 
Seat 5: Lovimdzen ($3.40 in chips) 
Seat 6: joma620 ($10 in chips) 
Lovimdzen: posts small blind $0.05
joma620: posts big blind $0.10
*** HOLE CARDS ***
adilpoker84: calls $0.10
rubduckofdeath: folds 
teddyKK: raises $0.30 to $0.40
Lovimdzen: folds 
joma620: folds 
adilpoker84: calls $0.30
*** FLOP *** [4h Ad 2s]
adilpoker84: checks 
teddyKK: checks 
*** TURN *** [4h Ad 2s] [5s]
adilpoker84: bets $0.50
teddyKK: folds 
Uncalled bet ($0.50) returned to adilpoker84
adilpoker84 collected $0.91 from pot
adilpoker84: doesn't show hand 
*** SUMMARY ***
Total pot $0.95 | Rake $0.04 
Board [4h Ad 2s 5s]
Seat 1: adilpoker84 collected ($0.91)
Seat 2: rubduckofdeath folded before Flop (didn't bet)
Seat 3: teddyKK (button) folded on the Turn
Seat 5: Lovimdzen (small blind) folded before Flop
Seat 6: joma620 (big blind) folded before Flop



PokerStars Hand #222975321090:  Hold'em No Limit ($0.05/$0.10 USD) - 2021/01/23 17:31:22 ET
Table 'Capricorn III' 6-max Seat #5 is the button
Seat 1: adilpoker84 ($7.97 in chips) 
Seat 2: rubduckofdeath ($10 in chips) 
Seat 3: teddyKK ($17.04 in chips) 
Seat 5: Lovimdzen ($3.35 in chips) 
Seat 6: joma620 ($10 in chips) 
joma620: posts small blind $0.05
adilpoker84: posts big blind $0.10
*** HOLE CARDS ***
rubduckofdeath: folds 
teddyKK: raises $0.20 to $0.30
Lovimdzen: folds 
joma620: folds 
adilpoker84: folds 
Uncalled bet ($0.20) returned to teddyKK
teddyKK collected $0.25 from pot
teddyKK: doesn't show hand 
*** SUMMARY ***
Total pot $0.25 | Rake $0 
Seat 1: adilpoker84 (big blind) folded before Flop
Seat 2: rubduckofdeath folded before Flop (didn't bet)
Seat 3: teddyKK collected ($0.25)
Seat 5: Lovimdzen (button) folded before Flop (didn't bet)
Seat 6: joma620 (small blind) folded before Flop



PokerStars Hand #222975332676:  Hold'em No Limit ($0.05/$0.10 USD) - 2021/01/23 17:31:36 ET
Table 'Capricorn III' 6-max Seat #6 is the button
Seat 1: adilpoker84 ($7.87 in chips) 
Seat 2: rubduckofdeath ($10 in chips) 
Seat 3: teddyKK ($17.19 in chips) 
Seat 5: Lovimdzen ($3.35 in chips) 
Seat 6: joma620 ($10 in chips) 
adilpoker84: posts small blind $0.05
rubduckofdeath: posts big blind $0.10
*** HOLE CARDS ***
teddyKK: folds 
Lovimdzen has timed out
Lovimdzen: folds 
joma620: raises $0.20 to $0.30
adilpoker84: folds 
rubduckofdeath: calls $0.20
*** FLOP *** [Kh 9d Td]
rubduckofdeath: checks 
joma620: checks 
*** TURN *** [Kh 9d Td] [Ac]
rubduckofdeath: checks 
joma620: checks 
*** RIVER *** [Kh 9d Td Ac] [8s]
rubduckofdeath: checks 
joma620: checks 
*** SHOW DOWN ***
rubduckofdeath: shows [Qh Ts] (a pair of Tens)
joma620: mucks hand 
rubduckofdeath collected $0.62 from pot
*** SUMMARY ***
Total pot $0.65 | Rake $0.03 
Board [Kh 9d Td Ac 8s]
Seat 1: adilpoker84 (small blind) folded before Flop
Seat 2: rubduckofdeath (big blind) showed [Qh Ts] and won ($0.62) with a pair of Tens
Seat 3: teddyKK folded before Flop (didn't bet)
Seat 5: Lovimdzen folded before Flop (didn't bet)
Seat 6: joma620 (button) mucked



PokerStars Hand #222975396568:  Hold'em No Limit ($0.05/$0.10 USD) - 2021/01/23 17:32:57 ET
Table 'Capricorn III' 6-max Seat #1 is the button
Seat 1: adilpoker84 ($7.82 in chips) 
Seat 2: rubduckofdeath ($10.32 in chips) 
Seat 3: teddyKK ($17.19 in chips) 
Seat 5: Lovimdzen ($3.35 in chips) 
Seat 6: joma620 ($10 in chips) 
rubduckofdeath: posts small blind $0.05
teddyKK: posts big blind $0.10
*** HOLE CARDS ***
Lovimdzen: folds 
joma620: folds 
adilpoker84: folds 
rubduckofdeath: folds 
Uncalled bet ($0.05) returned to teddyKK
teddyKK collected $0.10 from pot
teddyKK: doesn't show hand 
*** SUMMARY ***
Total pot $0.10 | Rake $0 
Seat 1: adilpoker84 (button) folded before Flop (didn't bet)
Seat 2: rubduckofdeath (small blind) folded before Flop
Seat 3: teddyKK (big blind) collected ($0.10)
Seat 5: Lovimdzen folded before Flop (didn't bet)
Seat 6: joma620 folded before Flop (didn't bet)



PokerStars Hand #222975411826:  Hold'em No Limit ($0.05/$0.10 USD) - 2021/01/23 17:33:17 ET
Table 'Capricorn III' 6-max Seat #2 is the button
Seat 1: adilpoker84 ($7.82 in chips) 
Seat 2: rubduckofdeath ($10.27 in chips) 
Seat 3: teddyKK ($17.24 in chips) 
Seat 5: Lovimdzen ($3.35 in chips) 
Seat 6: joma620 ($10 in chips) 
teddyKK: posts small blind $0.05
Lovimdzen: posts big blind $0.10
*** HOLE CARDS ***
joma620: folds 
adilpoker84: raises $0.20 to $0.30
rubduckofdeath: folds 
teddyKK: calls $0.25
Lovimdzen: calls $0.20
*** FLOP *** [9d 3h Qs]
teddyKK: checks 
Lovimdzen: checks 
adilpoker84: bets $0.30
teddyKK: calls $0.30
Lovimdzen: calls $0.30
*** TURN *** [9d 3h Qs] [Qh]
teddyKK: checks 
Lovimdzen: checks 
adilpoker84: bets $0.30
teddyKK: calls $0.30
Lovimdzen: calls $0.30
*** RIVER *** [9d 3h Qs Qh] [Ac]
teddyKK: checks 
Lovimdzen: bets $1.20
adilpoker84: folds 
teddyKK: calls $1.20
*** SHOW DOWN ***
Lovimdzen: shows [Td Js] (a pair of Queens)
teddyKK: shows [As 9s] (two pair, Aces and Queens)
teddyKK collected $4.87 from pot
*** SUMMARY ***
Total pot $5.10 | Rake $0.23 
Board [9d 3h Qs Qh Ac]
Seat 1: adilpoker84 folded on the River
Seat 2: rubduckofdeath (button) folded before Flop (didn't bet)
Seat 3: teddyKK (small blind) showed [As 9s] and won ($4.87) with two pair, Aces and Queens
Seat 5: Lovimdzen (big blind) showed [Td Js] and lost with a pair of Queens
Seat 6: joma620 folded before Flop (didn't bet)



PokerStars Hand #222975473596:  Hold'em No Limit ($0.05/$0.10 USD) - 2021/01/23 17:34:35 ET
Table 'Capricorn III' 6-max Seat #3 is the button
Seat 1: adilpoker84 ($6.92 in chips) 
Seat 2: rubduckofdeath ($10.27 in chips) 
Seat 3: teddyKK ($20.01 in chips) 
Seat 5: Lovimdzen ($1.25 in chips) 
Seat 6: joma620 ($10 in chips) 
Lovimdzen: posts small blind $0.05
joma620: posts big blind $0.10
*** HOLE CARDS ***
adilpoker84: calls $0.10
rubduckofdeath: folds 
teddyKK has timed out
teddyKK: folds 
Lovimdzen: raises $0.20 to $0.30
joma620: calls $0.20
adilpoker84: calls $0.20
*** FLOP *** [3h Jc Kc]
Lovimdzen: bets $0.53
joma620: folds 
adilpoker84: folds 
Uncalled bet ($0.53) returned to Lovimdzen
Lovimdzen collected $0.86 from pot
Lovimdzen: doesn't show hand 
*** SUMMARY ***
Total pot $0.90 | Rake $0.04 
Board [3h Jc Kc]
Seat 1: adilpoker84 folded on the Flop
Seat 2: rubduckofdeath folded before Flop (didn't bet)
Seat 3: teddyKK (button) folded before Flop (didn't bet)
Seat 5: Lovimdzen (small blind) collected ($0.86)
Seat 6: joma620 (big blind) folded on the Flop



PokerStars Hand #222975513988:  Hold'em No Limit ($0.05/$0.10 USD) - 2021/01/23 17:35:15 ET
Table 'Capricorn III' 6-max Seat #5 is the button
Seat 1: adilpoker84 ($6.62 in chips) 
Seat 2: rubduckofdeath ($10.27 in chips) 
Seat 3: teddyKK ($20.01 in chips) 
Seat 5: Lovimdzen ($1.81 in chips) 
Seat 6: joma620 ($10 in chips) 
joma620: posts small blind $0.05
adilpoker84: posts big blind $0.10
*** HOLE CARDS ***
rubduckofdeath: folds 
teddyKK: folds 
Lovimdzen: raises $0.20 to $0.30
joma620: folds 
adilpoker84: calls $0.20
*** FLOP *** [7s 4c 2c]
adilpoker84: checks 
Lovimdzen: bets $0.40
adilpoker84: folds 
Uncalled bet ($0.40) returned to Lovimdzen
Lovimdzen collected $0.62 from pot
Lovimdzen: doesn't show hand 
*** SUMMARY ***
Total pot $0.65 | Rake $0.03 
Board [7s 4c 2c]
Seat 1: adilpoker84 (big blind) folded on the Flop
Seat 2: rubduckofdeath folded before Flop (didn't bet)
Seat 3: teddyKK folded before Flop (didn't bet)
Seat 5: Lovimdzen (button) collected ($0.62)
Seat 6: joma620 (small blind) folded before Flop



PokerStars Hand #222975535280:  Hold'em No Limit ($0.05/$0.10 USD) - 2021/01/23 17:35:42 ET
Table 'Capricorn III' 6-max Seat #6 is the button
Seat 1: adilpoker84 ($6.32 in chips) 
Seat 2: rubduckofdeath ($10.27 in chips) 
Seat 3: teddyKK ($20.01 in chips) 
Seat 5: Lovimdzen ($2.13 in chips) 
Seat 6: joma620 ($10 in chips) 
adilpoker84: posts small blind $0.05
rubduckofdeath: posts big blind $0.10
*** HOLE CARDS ***
teddyKK has timed out
teddyKK: folds 
Lovimdzen: folds 
joma620: raises $0.20 to $0.30
adilpoker84: calls $0.25
rubduckofdeath: folds 
*** FLOP *** [5c Qd 7h]
adilpoker84: checks 
joma620: checks 
*** TURN *** [5c Qd 7h] [9h]
adilpoker84: bets $0.20
joma620: raises $0.80 to $1
adilpoker84: folds 
Uncalled bet ($0.80) returned to joma620
joma620 collected $1.05 from pot
joma620: doesn't show hand 
*** SUMMARY ***
Total pot $1.10 | Rake $0.05 
Board [5c Qd 7h 9h]
Seat 1: adilpoker84 (small blind) folded on the Turn
Seat 2: rubduckofdeath (big blind) folded before Flop
Seat 3: teddyKK folded before Flop (didn't bet)
Seat 5: Lovimdzen folded before Flop (didn't bet)
Seat 6: joma620 (button) collected ($1.05)



PokerStars Hand #222975571477:  Hold'em No Limit ($0.05/$0.10 USD) - 2021/01/23 17:36:29 ET
Table 'Capricorn III' 6-max Seat #1 is the button
Seat 1: adilpoker84 ($5.82 in chips) 
Seat 2: rubduckofdeath ($10.17 in chips) 
Seat 3: teddyKK ($20.01 in chips) 
Seat 5: Lovimdzen ($2.13 in chips) 
Seat 6: joma620 ($10.55 in chips) 
rubduckofdeath: posts small blind $0.05
teddyKK: posts big blind $0.10
SchuhaRt71: sits out 
*** HOLE CARDS ***
Lovimdzen: folds 
joma620: folds 
adilpoker84: folds 
rubduckofdeath: folds 
Uncalled bet ($0.05) returned to teddyKK
teddyKK collected $0.10 from pot
teddyKK: doesn't show hand 
*** SUMMARY ***
Total pot $0.10 | Rake $0 
Seat 1: adilpoker84 (button) folded before Flop (didn't bet)
Seat 2: rubduckofdeath (small blind) folded before Flop
Seat 3: teddyKK (big blind) collected ($0.10)
Seat 5: Lovimdzen folded before Flop (didn't bet)
Seat 6: joma620 folded before Flop (didn't bet)



PokerStars Hand #222975581043:  Hold'em No Limit ($0.05/$0.10 USD) - 2021/01/23 17:36:41 ET
Table 'Capricorn III' 6-max Seat #2 is the button
Seat 1: adilpoker84 ($5.82 in chips) 
Seat 2: rubduckofdeath ($10.12 in chips) 
Seat 3: teddyKK ($20.06 in chips) 
Seat 4: SchuhaRt71 ($25.30 in chips) 
Seat 5: Lovimdzen ($2.13 in chips) 
Seat 6: joma620 ($10.55 in chips) 
teddyKK: posts small blind $0.05
SchuhaRt71: posts big blind $0.10
*** HOLE CARDS ***
Lovimdzen: folds 
joma620: folds 
adilpoker84: folds 
rubduckofdeath: folds 
teddyKK: folds 
Uncalled bet ($0.05) returned to SchuhaRt71
SchuhaRt71 collected $0.10 from pot
SchuhaRt71: doesn't show hand 
*** SUMMARY ***
Total pot $0.10 | Rake $0 
Seat 1: adilpoker84 folded before Flop (didn't bet)
Seat 2: rubduckofdeath (button) folded before Flop (didn't bet)
Seat 3: teddyKK (small blind) folded before Flop
Seat 4: SchuhaRt71 (big blind) collected ($0.10)
Seat 5: Lovimdzen folded before Flop (didn't bet)
Seat 6: joma620 folded before Flop (didn't bet)



PokerStars Hand #222975591802:  Hold'em No Limit ($0.05/$0.10 USD) - 2021/01/23 17:36:55 ET
Table 'Capricorn III' 6-max Seat #3 is the button
Seat 1: adilpoker84 ($5.82 in chips) 
Seat 2: rubduckofdeath ($10.12 in chips) 
Seat 3: teddyKK ($20.01 in chips) 
Seat 4: SchuhaRt71 ($25.35 in chips) 
Seat 5: Lovimdzen ($2.13 in chips) 
Seat 6: joma620 ($10.55 in chips) 
SchuhaRt71: posts small blind $0.05
Lovimdzen: posts big blind $0.10
*** HOLE CARDS ***
joma620: folds 
adilpoker84: folds 
rubduckofdeath: folds 
teddyKK: folds 
SchuhaRt71: raises $0.15 to $0.25
Lovimdzen: calls $0.15
*** FLOP *** [Ad Qd Tc]
SchuhaRt71: checks 
Lovimdzen: checks 
*** TURN *** [Ad Qd Tc] [7s]
SchuhaRt71: bets $0.36
Lovimdzen: calls $0.36
*** RIVER *** [Ad Qd Tc 7s] [5h]
SchuhaRt71: checks 
Lovimdzen: bets $0.60
SchuhaRt71: folds 
Uncalled bet ($0.60) returned to Lovimdzen
Lovimdzen collected $1.17 from pot
Lovimdzen: doesn't show hand 
*** SUMMARY ***
Total pot $1.22 | Rake $0.05 
Board [Ad Qd Tc 7s 5h]
Seat 1: adilpoker84 folded before Flop (didn't bet)
Seat 2: rubduckofdeath folded before Flop (didn't bet)
Seat 3: teddyKK (button) folded before Flop (didn't bet)
Seat 4: SchuhaRt71 (small blind) folded on the River
Seat 5: Lovimdzen (big blind) collected ($1.17)
Seat 6: joma620 folded before Flop (didn't bet)



PokerStars Hand #222975651425:  Hold'em No Limit ($0.05/$0.10 USD) - 2021/01/23 17:38:13 ET
Table 'Capricorn III' 6-max Seat #4 is the button
Seat 1: adilpoker84 ($5.82 in chips) 
Seat 2: rubduckofdeath ($10.12 in chips) 
Seat 3: teddyKK ($20.01 in chips) 
Seat 4: SchuhaRt71 ($24.74 in chips) 
Seat 5: Lovimdzen ($2.69 in chips) 
Seat 6: joma620 ($10.55 in chips) 
Lovimdzen: posts small blind $0.05
joma620: posts big blind $0.10
*** HOLE CARDS ***
adilpoker84: folds 
rubduckofdeath: raises $0.20 to $0.30
teddyKK: calls $0.30
SchuhaRt71: folds 
Lovimdzen: folds 
joma620: folds 
*** FLOP *** [4s 3s Qd]
rubduckofdeath: bets $0.36
teddyKK: raises $0.84 to $1.20
rubduckofdeath: calls $0.84
*** TURN *** [4s 3s Qd] [8s]
rubduckofdeath: checks 
teddyKK: checks 
*** RIVER *** [4s 3s Qd 8s] [5d]
rubduckofdeath: bets $1.51
teddyKK: calls $1.51
*** SHOW DOWN ***
rubduckofdeath: shows [Ks Qh] (a pair of Queens)
teddyKK: shows [4c 4h] (three of a kind, Fours)
teddyKK collected $5.89 from pot
*** SUMMARY ***
Total pot $6.17 | Rake $0.28 
Board [4s 3s Qd 8s 5d]
Seat 1: adilpoker84 folded before Flop (didn't bet)
Seat 2: rubduckofdeath showed [Ks Qh] and lost with a pair of Queens
Seat 3: teddyKK showed [4c 4h] and won ($5.89) with three of a kind, Fours
Seat 4: SchuhaRt71 (button) folded before Flop (didn't bet)
Seat 5: Lovimdzen (small blind) folded before Flop
Seat 6: joma620 (big blind) folded before Flop



PokerStars Hand #222975687583:  Hold'em No Limit ($0.05/$0.10 USD) - 2021/01/23 17:39:00 ET
Table 'Capricorn III' 6-max Seat #5 is the button
Seat 1: adilpoker84 ($5.82 in chips) 
Seat 2: rubduckofdeath ($10 in chips) 
Seat 3: teddyKK ($22.89 in chips) 
Seat 4: SchuhaRt71 ($24.74 in chips) 
Seat 5: Lovimdzen ($2.64 in chips) 
Seat 6: joma620 ($10.45 in chips) 
joma620: posts small blind $0.05
adilpoker84: posts big blind $0.10
*** HOLE CARDS ***
rubduckofdeath: folds 
teddyKK: folds 
SchuhaRt71: raises $0.30 to $0.40
Lovimdzen: folds 
joma620: folds 
adilpoker84: calls $0.30
*** FLOP *** [7s 4h Td]
adilpoker84: checks 
SchuhaRt71: bets $0.41
adilpoker84: folds 
Uncalled bet ($0.41) returned to SchuhaRt71
SchuhaRt71 collected $0.81 from pot
SchuhaRt71: doesn't show hand 
*** SUMMARY ***
Total pot $0.85 | Rake $0.04 
Board [7s 4h Td]
Seat 1: adilpoker84 (big blind) folded on the Flop
Seat 2: rubduckofdeath folded before Flop (didn't bet)
Seat 3: teddyKK folded before Flop (didn't bet)
Seat 4: SchuhaRt71 collected ($0.81)
Seat 5: Lovimdzen (button) folded before Flop (didn't bet)
Seat 6: joma620 (small blind) folded before Flop



PokerStars Hand #222975712458:  Hold'em No Limit ($0.05/$0.10 USD) - 2021/01/23 17:39:32 ET
Table 'Capricorn III' 6-max Seat #6 is the button
Seat 1: adilpoker84 ($5.42 in chips) 
Seat 2: rubduckofdeath ($10 in chips) 
Seat 3: teddyKK ($22.89 in chips) 
Seat 4: SchuhaRt71 ($25.15 in chips) 
Seat 5: Lovimdzen ($2.64 in chips) 
Seat 6: joma620 ($10.40 in chips) 
adilpoker84: posts small blind $0.05
rubduckofdeath: posts big blind $0.10
*** HOLE CARDS ***
teddyKK: folds 
SchuhaRt71: folds 
Lovimdzen: folds 
joma620: folds 
adilpoker84: calls $0.05
rubduckofdeath: checks 
*** FLOP *** [8h 6d Th]
adilpoker84: checks 
rubduckofdeath: checks 
*** TURN *** [8h 6d Th] [8c]
adilpoker84: bets $0.20
rubduckofdeath: folds 
Uncalled bet ($0.20) returned to adilpoker84
adilpoker84 collected $0.19 from pot
adilpoker84: doesn't show hand 
*** SUMMARY ***
Total pot $0.20 | Rake $0.01 
Board [8h 6d Th 8c]
Seat 1: adilpoker84 (small blind) collected ($0.19)
Seat 2: rubduckofdeath (big blind) folded on the Turn
Seat 3: teddyKK folded before Flop (didn't bet)
Seat 4: SchuhaRt71 folded before Flop (didn't bet)
Seat 5: Lovimdzen folded before Flop (didn't bet)
Seat 6: joma620 (button) folded before Flop (didn't bet)



PokerStars Hand #222975730929:  Hold'em No Limit ($0.05/$0.10 USD) - 2021/01/23 17:39:56 ET
Table 'Capricorn III' 6-max Seat #1 is the button
Seat 1: adilpoker84 ($5.51 in chips) 
Seat 2: rubduckofdeath ($10 in chips) 
Seat 3: teddyKK ($22.89 in chips) 
Seat 4: SchuhaRt71 ($25.15 in chips) 
Seat 5: Lovimdzen ($2.64 in chips) 
Seat 6: joma620 ($10.40 in chips) 
rubduckofdeath: posts small blind $0.05
teddyKK: posts big blind $0.10
*** HOLE CARDS ***
SchuhaRt71: folds 
Lovimdzen: folds 
joma620: folds 
adilpoker84: calls $0.10
rubduckofdeath: folds 
teddyKK: checks 
*** FLOP *** [9s Ad Qd]
teddyKK: bets $0.20
adilpoker84: folds 
Uncalled bet ($0.20) returned to teddyKK
teddyKK collected $0.24 from pot
teddyKK: doesn't show hand 
*** SUMMARY ***
Total pot $0.25 | Rake $0.01 
Board [9s Ad Qd]
Seat 1: adilpoker84 (button) folded on the Flop
Seat 2: rubduckofdeath (small blind) folded before Flop
Seat 3: teddyKK (big blind) collected ($0.24)
Seat 4: SchuhaRt71 folded before Flop (didn't bet)
Seat 5: Lovimdzen folded before Flop (didn't bet)
Seat 6: joma620 folded before Flop (didn't bet)



PokerStars Hand #222975758736:  Hold'em No Limit ($0.05/$0.10 USD) - 2021/01/23 17:40:33 ET
Table 'Capricorn III' 6-max Seat #2 is the button
Seat 1: adilpoker84 ($5.41 in chips) 
Seat 2: rubduckofdeath ($10 in chips) 
Seat 3: teddyKK ($23.03 in chips) 
Seat 4: SchuhaRt71 ($25.15 in chips) 
Seat 5: Lovimdzen ($2.64 in chips) 
Seat 6: joma620 ($10.40 in chips) 
teddyKK: posts small blind $0.05
SchuhaRt71: posts big blind $0.10
*** HOLE CARDS ***
Lovimdzen: raises $0.20 to $0.30
joma620: folds 
adilpoker84: folds 
rubduckofdeath: folds 
teddyKK: folds 
SchuhaRt71: folds 
Uncalled bet ($0.20) returned to Lovimdzen
Lovimdzen collected $0.25 from pot
Lovimdzen: doesn't show hand 
*** SUMMARY ***
Total pot $0.25 | Rake $0 
Seat 1: adilpoker84 folded before Flop (didn't bet)
Seat 2: rubduckofdeath (button) folded before Flop (didn't bet)
Seat 3: teddyKK (small blind) folded before Flop
Seat 4: SchuhaRt71 (big blind) folded before Flop
Seat 5: Lovimdzen collected ($0.25)
Seat 6: joma620 folded before Flop (didn't bet)



PokerStars Hand #222975778916:  Hold'em No Limit ($0.05/$0.10 USD) - 2021/01/23 17:40:59 ET
Table 'Capricorn III' 6-max Seat #3 is the button
Seat 1: adilpoker84 ($5.41 in chips) 
Seat 2: rubduckofdeath ($10 in chips) 
Seat 3: teddyKK ($22.98 in chips) 
Seat 4: SchuhaRt71 ($25.05 in chips) 
Seat 5: Lovimdzen ($2.79 in chips) 
Seat 6: joma620 ($10.40 in chips) 
SchuhaRt71: posts small blind $0.05
Lovimdzen: posts big blind $0.10
*** HOLE CARDS ***
joma620: folds 
adilpoker84: folds 
rubduckofdeath: raises $0.20 to $0.30
teddyKK: folds 
SchuhaRt71: calls $0.25
Lovimdzen: folds 
*** FLOP *** [6d Kc Kd]
SchuhaRt71: checks 
rubduckofdeath: bets $0.34
SchuhaRt71: calls $0.34
*** TURN *** [6d Kc Kd] [8s]
SchuhaRt71: checks 
rubduckofdeath: checks 
*** RIVER *** [6d Kc Kd 8s] [9h]
SchuhaRt71: checks 
rubduckofdeath: checks 
*** SHOW DOWN ***
SchuhaRt71: shows [7h Ah] (a pair of Kings)
rubduckofdeath: shows [Ad 5d] (a pair of Kings)
SchuhaRt71 collected $0.66 from pot
rubduckofdeath collected $0.66 from pot
*** SUMMARY ***
Total pot $1.38 | Rake $0.06 
Board [6d Kc Kd 8s 9h]
Seat 1: adilpoker84 folded before Flop (didn't bet)
Seat 2: rubduckofdeath showed [Ad 5d] and won ($0.66) with a pair of Kings
Seat 3: teddyKK (button) folded before Flop (didn't bet)
Seat 4: SchuhaRt71 (small blind) showed [7h Ah] and won ($0.66) with a pair of Kings
Seat 5: Lovimdzen (big blind) folded before Flop
Seat 6: joma620 folded before Flop (didn't bet)



PokerStars Hand #222975817900:  Hold'em No Limit ($0.05/$0.10 USD) - 2021/01/23 17:41:50 ET
Table 'Capricorn III' 6-max Seat #4 is the button
Seat 1: adilpoker84 ($5.41 in chips) 
Seat 2: rubduckofdeath ($10.02 in chips) 
Seat 3: teddyKK ($22.98 in chips) 
Seat 4: SchuhaRt71 ($25.07 in chips) 
Seat 5: Lovimdzen ($2.69 in chips) 
Seat 6: joma620 ($10.40 in chips) 
Lovimdzen: posts small blind $0.05
joma620: posts big blind $0.10
*** HOLE CARDS ***
adilpoker84: calls $0.10
rubduckofdeath: folds 
teddyKK: folds 
SchuhaRt71: folds 
Lovimdzen: raises $0.20 to $0.30
joma620: folds 
adilpoker84: calls $0.20
*** FLOP *** [Jh Kh 7s]
Lovimdzen: bets $0.30
adilpoker84: calls $0.30
*** TURN *** [Jh Kh 7s] [9h]
Lovimdzen: bets $0.30
adilpoker84: calls $0.30
*** RIVER *** [Jh Kh 7s 9h] [9s]
Lovimdzen: bets $0.60
adilpoker84: calls $0.60
*** SHOW DOWN ***
Lovimdzen: shows [Td Ts] (two pair, Tens and Nines)
adilpoker84: mucks hand 
Lovimdzen collected $2.96 from pot
*** SUMMARY ***
Total pot $3.10 | Rake $0.14 
Board [Jh Kh 7s 9h 9s]
Seat 1: adilpoker84 mucked
Seat 2: rubduckofdeath folded before Flop (didn't bet)
Seat 3: teddyKK folded before Flop (didn't bet)
Seat 4: SchuhaRt71 (button) folded before Flop (didn't bet)
Seat 5: Lovimdzen (small blind) showed [Td Ts] and won ($2.96) with two pair, Tens and Nines
Seat 6: joma620 (big blind) folded before Flop



PokerStars Hand #222975852700:  Hold'em No Limit ($0.05/$0.10 USD) - 2021/01/23 17:42:35 ET
Table 'Capricorn III' 6-max Seat #5 is the button
Seat 1: adilpoker84 ($3.91 in chips) 
Seat 2: rubduckofdeath ($10.02 in chips) 
Seat 3: teddyKK ($22.98 in chips) 
Seat 4: SchuhaRt71 ($25.07 in chips) 
Seat 5: Lovimdzen ($4.15 in chips) 
Seat 6: joma620 ($10.30 in chips) 
joma620: posts small blind $0.05
adilpoker84: posts big blind $0.10
*** HOLE CARDS ***
rubduckofdeath: folds 
teddyKK: raises $0.20 to $0.30
SchuhaRt71: folds 
Lovimdzen: folds 
joma620: folds 
adilpoker84: folds 
Uncalled bet ($0.20) returned to teddyKK
teddyKK collected $0.25 from pot
teddyKK: doesn't show hand 
*** SUMMARY ***
Total pot $0.25 | Rake $0 
Seat 1: adilpoker84 (big blind) folded before Flop
Seat 2: rubduckofdeath folded before Flop (didn't bet)
Seat 3: teddyKK collected ($0.25)
Seat 4: SchuhaRt71 folded before Flop (didn't bet)
Seat 5: Lovimdzen (button) folded before Flop (didn't bet)
Seat 6: joma620 (small blind) folded before Flop



PokerStars Hand #222970065525:  Hold'em No Limit ($0.05/$0.10 USD) - 2021/01/23 15:43:31 ET
Table 'Capricorn III' 6-max Seat #1 is the button
Seat 1: adilpoker84 ($21.02 in chips) 
Seat 2: Dimitrii 30 ($8.33 in chips) 
Seat 3: Vanozik19 ($16.90 in chips) 
Seat 5: skems123 ($10.73 in chips) 
Seat 6: Acedan1369 ($26.91 in chips) 
Dimitrii 30: posts small blind $0.05
Vanozik19: posts big blind $0.10
aiv72: sits out 
*** HOLE CARDS ***
skems123: raises $0.15 to $0.25
Acedan1369: folds 
adilpoker84: folds 
Dimitrii 30: folds 
Vanozik19: folds 
Uncalled bet ($0.15) returned to skems123
skems123 collected $0.25 from pot
skems123: doesn't show hand 
*** SUMMARY ***
Total pot $0.25 | Rake $0 
Seat 1: adilpoker84 (button) folded before Flop (didn't bet)
Seat 2: Dimitrii 30 (small blind) folded before Flop
Seat 3: Vanozik19 (big blind) folded before Flop
Seat 5: skems123 collected ($0.25)
Seat 6: Acedan1369 folded before Flop (didn't bet)



PokerStars Hand #222970077739:  Hold'em No Limit ($0.05/$0.10 USD) - 2021/01/23 15:43:45 ET
Table 'Capricorn III' 6-max Seat #2 is the button
Seat 1: adilpoker84 ($21.02 in chips) 
Seat 2: Dimitrii 30 ($8.28 in chips) 
Seat 3: Vanozik19 ($16.80 in chips) 
Seat 4: aiv72 ($7.79 in chips) 
Seat 5: skems123 ($10.88 in chips) 
Seat 6: Acedan1369 ($26.91 in chips) 
Vanozik19: posts small blind $0.05
aiv72: posts big blind $0.10
*** HOLE CARDS ***
skems123: raises $0.15 to $0.25
Acedan1369: folds 
adilpoker84: calls $0.25
Dimitrii 30: folds 
Vanozik19: folds 
aiv72: calls $0.15
*** FLOP *** [Jc Js 7s]
aiv72: checks 
skems123: bets $0.27
adilpoker84: folds 
aiv72: folds 
Uncalled bet ($0.27) returned to skems123
skems123 collected $0.76 from pot
skems123: doesn't show hand 
*** SUMMARY ***
Total pot $0.80 | Rake $0.04 
Board [Jc Js 7s]
Seat 1: adilpoker84 folded on the Flop
Seat 2: Dimitrii 30 (button) folded before Flop (didn't bet)
Seat 3: Vanozik19 (small blind) folded before Flop
Seat 4: aiv72 (big blind) folded on the Flop
Seat 5: skems123 collected ($0.76)
Seat 6: Acedan1369 folded before Flop (didn't bet)



PokerStars Hand #222970112967:  Hold'em No Limit ($0.05/$0.10 USD) - 2021/01/23 15:44:27 ET
Table 'Capricorn III' 6-max Seat #3 is the button
Seat 1: adilpoker84 ($20.77 in chips) 
Seat 2: Dimitrii 30 ($8.28 in chips) 
Seat 3: Vanozik19 ($16.75 in chips) 
Seat 4: aiv72 ($7.54 in chips) 
Seat 5: skems123 ($11.39 in chips) 
Seat 6: Acedan1369 ($26.91 in chips) 
aiv72: posts small blind $0.05
skems123: posts big blind $0.10
*** HOLE CARDS ***
Acedan1369: folds 
adilpoker84: calls $0.10
Dimitrii 30: folds 
Vanozik19: folds 
aiv72: calls $0.05
skems123: checks 
*** FLOP *** [5d As 7d]
aiv72: checks 
skems123: bets $0.15
adilpoker84: raises $0.15 to $0.30
aiv72: folds 
skems123: calls $0.15
*** TURN *** [5d As 7d] [3c]
skems123: checks 
adilpoker84: bets $0.60
skems123: folds 
Uncalled bet ($0.60) returned to adilpoker84
adilpoker84 collected $0.86 from pot
adilpoker84: doesn't show hand 
*** SUMMARY ***
Total pot $0.90 | Rake $0.04 
Board [5d As 7d 3c]
Seat 1: adilpoker84 collected ($0.86)
Seat 2: Dimitrii 30 folded before Flop (didn't bet)
Seat 3: Vanozik19 (button) folded before Flop (didn't bet)
Seat 4: aiv72 (small blind) folded on the Flop
Seat 5: skems123 (big blind) folded on the Turn
Seat 6: Acedan1369 folded before Flop (didn't bet)



PokerStars Hand #222970176102:  Hold'em No Limit ($0.05/$0.10 USD) - 2021/01/23 15:45:42 ET
Table 'Capricorn III' 6-max Seat #4 is the button
Seat 1: adilpoker84 ($21.23 in chips) 
Seat 2: Dimitrii 30 ($8.28 in chips) 
Seat 3: Vanozik19 ($16.75 in chips) 
Seat 4: aiv72 ($7.44 in chips) 
Seat 5: skems123 ($10.99 in chips) 
Seat 6: Acedan1369 ($26.91 in chips) 
skems123: posts small blind $0.05
Acedan1369: posts big blind $0.10
*** HOLE CARDS ***
adilpoker84: calls $0.10
Dimitrii 30: folds 
Vanozik19: folds 
aiv72 has timed out
aiv72: folds 
skems123: folds 
Acedan1369: checks 
*** FLOP *** [8s 3s 7d]
Acedan1369: checks 
adilpoker84: checks 
*** TURN *** [8s 3s 7d] [5c]
Acedan1369: checks 
adilpoker84: checks 
*** RIVER *** [8s 3s 7d 5c] [Ks]
Acedan1369: checks 
adilpoker84: bets $0.10
Acedan1369: folds 
Uncalled bet ($0.10) returned to adilpoker84
adilpoker84 collected $0.24 from pot
adilpoker84: doesn't show hand 
*** SUMMARY ***
Total pot $0.25 | Rake $0.01 
Board [8s 3s 7d 5c Ks]
Seat 1: adilpoker84 collected ($0.24)
Seat 2: Dimitrii 30 folded before Flop (didn't bet)
Seat 3: Vanozik19 folded before Flop (didn't bet)
Seat 4: aiv72 (button) folded before Flop (didn't bet)
Seat 5: skems123 (small blind) folded before Flop
Seat 6: Acedan1369 (big blind) folded on the River



PokerStars Hand #222970212428:  Hold'em No Limit ($0.05/$0.10 USD) - 2021/01/23 15:46:26 ET
Table 'Capricorn III' 6-max Seat #5 is the button
Seat 1: adilpoker84 ($21.37 in chips) 
Seat 2: Dimitrii 30 ($8.28 in chips) 
Seat 3: Vanozik19 ($16.75 in chips) 
Seat 4: aiv72 ($7.44 in chips) 
Seat 5: skems123 ($10.94 in chips) 
Seat 6: Acedan1369 ($26.81 in chips) 
Acedan1369: posts small blind $0.05
adilpoker84: posts big blind $0.10
*** HOLE CARDS ***
Dimitrii 30: folds 
Vanozik19: folds 
aiv72: raises $0.10 to $0.20
skems123: folds 
Acedan1369: folds 
adilpoker84: calls $0.10
*** FLOP *** [Tc 5d Kc]
adilpoker84: checks 
aiv72: checks 
*** TURN *** [Tc 5d Kc] [6s]
adilpoker84: checks 
aiv72: bets $0.10
adilpoker84: calls $0.10
*** RIVER *** [Tc 5d Kc 6s] [Js]
adilpoker84: checks 
aiv72: bets $0.80
adilpoker84: folds 
Uncalled bet ($0.80) returned to aiv72
aiv72 collected $0.62 from pot
aiv72: doesn't show hand 
*** SUMMARY ***
Total pot $0.65 | Rake $0.03 
Board [Tc 5d Kc 6s Js]
Seat 1: adilpoker84 (big blind) folded on the River
Seat 2: Dimitrii 30 folded before Flop (didn't bet)
Seat 3: Vanozik19 folded before Flop (didn't bet)
Seat 4: aiv72 collected ($0.62)
Seat 5: skems123 (button) folded before Flop (didn't bet)
Seat 6: Acedan1369 (small blind) folded before Flop



PokerStars Hand #222970260073:  Hold'em No Limit ($0.05/$0.10 USD) - 2021/01/23 15:47:23 ET
Table 'Capricorn III' 6-max Seat #6 is the button
Seat 1: adilpoker84 ($21.07 in chips) 
Seat 2: Dimitrii 30 ($8.28 in chips) 
Seat 3: Vanozik19 ($16.75 in chips) 
Seat 4: aiv72 ($7.76 in chips) 
Seat 5: skems123 ($10.94 in chips) 
Seat 6: Acedan1369 ($26.76 in chips) 
adilpoker84: posts small blind $0.05
Dimitrii 30: posts big blind $0.10
*** HOLE CARDS ***
Vanozik19: folds 
aiv72: calls $0.10
skems123: folds 
Vanozik19 leaves the table
Acedan1369: raises $0.30 to $0.40
adilpoker84: folds 
Dimitrii 30: folds 
aiv72: calls $0.30
*** FLOP *** [6c Ks 5c]
aiv72: checks 
teddyKK joins the table at seat #3 
Acedan1369: checks 
*** TURN *** [6c Ks 5c] [3c]
aiv72: checks 
Acedan1369: checks 
*** RIVER *** [6c Ks 5c 3c] [6s]
aiv72: bets $0.10
Acedan1369: folds 
Uncalled bet ($0.10) returned to aiv72
aiv72 collected $0.91 from pot
aiv72: doesn't show hand 
*** SUMMARY ***
Total pot $0.95 | Rake $0.04 
Board [6c Ks 5c 3c 6s]
Seat 1: adilpoker84 (small blind) folded before Flop
Seat 2: Dimitrii 30 (big blind) folded before Flop
Seat 3: Vanozik19 folded before Flop (didn't bet)
Seat 4: aiv72 collected ($0.91)
Seat 5: skems123 folded before Flop (didn't bet)
Seat 6: Acedan1369 (button) folded on the River



PokerStars Hand #222970296908:  Hold'em No Limit ($0.05/$0.10 USD) - 2021/01/23 15:48:07 ET
Table 'Capricorn III' 6-max Seat #1 is the button
Seat 1: adilpoker84 ($21.02 in chips) 
Seat 2: Dimitrii 30 ($8.18 in chips) 
Seat 3: teddyKK ($10 in chips) 
Seat 4: aiv72 ($8.27 in chips) 
Seat 5: skems123 ($10.94 in chips) 
Seat 6: Acedan1369 ($26.36 in chips) 
Dimitrii 30: posts small blind $0.05
teddyKK: posts big blind $0.10
*** HOLE CARDS ***
aiv72: calls $0.10
skems123: folds 
Acedan1369: folds 
adilpoker84: calls $0.10
Dimitrii 30: folds 
teddyKK: checks 
*** FLOP *** [3d 6d Qs]
teddyKK: checks 
aiv72: checks 
adilpoker84: checks 
*** TURN *** [3d 6d Qs] [Qd]
teddyKK: checks 
aiv72: checks 
adilpoker84: bets $0.10
teddyKK: folds 
aiv72: folds 
Uncalled bet ($0.10) returned to adilpoker84
adilpoker84 collected $0.33 from pot
adilpoker84: doesn't show hand 
*** SUMMARY ***
Total pot $0.35 | Rake $0.02 
Board [3d 6d Qs Qd]
Seat 1: adilpoker84 (button) collected ($0.33)
Seat 2: Dimitrii 30 (small blind) folded before Flop
Seat 3: teddyKK (big blind) folded on the Turn
Seat 4: aiv72 folded on the Turn
Seat 5: skems123 folded before Flop (didn't bet)
Seat 6: Acedan1369 folded before Flop (didn't bet)



PokerStars Hand #222970353597:  Hold'em No Limit ($0.05/$0.10 USD) - 2021/01/23 15:49:15 ET
Table 'Capricorn III' 6-max Seat #2 is the button
Seat 1: adilpoker84 ($21.25 in chips) 
Seat 2: Dimitrii 30 ($8.13 in chips) 
Seat 3: teddyKK ($10 in chips) 
Seat 4: aiv72 ($8.17 in chips) 
Seat 5: skems123 ($10.94 in chips) 
Seat 6: Acedan1369 ($26.36 in chips) 
teddyKK: posts small blind $0.05
aiv72: posts big blind $0.10
*** HOLE CARDS ***
skems123: raises $0.15 to $0.25
Acedan1369: folds 
adilpoker84: folds 
Dimitrii 30: folds 
teddyKK: folds 
aiv72: folds 
Uncalled bet ($0.15) returned to skems123
skems123 collected $0.25 from pot
skems123: doesn't show hand 
*** SUMMARY ***
Total pot $0.25 | Rake $0 
Seat 1: adilpoker84 folded before Flop (didn't bet)
Seat 2: Dimitrii 30 (button) folded before Flop (didn't bet)
Seat 3: teddyKK (small blind) folded before Flop
Seat 4: aiv72 (big blind) folded before Flop
Seat 5: skems123 collected ($0.25)
Seat 6: Acedan1369 folded before Flop (didn't bet)



PokerStars Hand #222970370380:  Hold'em No Limit ($0.05/$0.10 USD) - 2021/01/23 15:49:35 ET
Table 'Capricorn III' 6-max Seat #3 is the button
Seat 1: adilpoker84 ($21.25 in chips) 
Seat 2: Dimitrii 30 ($8.13 in chips) 
Seat 3: teddyKK ($10 in chips) 
Seat 4: aiv72 ($8.07 in chips) 
Seat 5: skems123 ($11.09 in chips) 
Seat 6: Acedan1369 ($26.36 in chips) 
aiv72: posts small blind $0.05
skems123: posts big blind $0.10
*** HOLE CARDS ***
Acedan1369: folds 
adilpoker84: raises $0.20 to $0.30
Dimitrii 30: folds 
teddyKK: folds 
aiv72: folds 
skems123: folds 
Uncalled bet ($0.20) returned to adilpoker84
adilpoker84 collected $0.25 from pot
adilpoker84: doesn't show hand 
*** SUMMARY ***
Total pot $0.25 | Rake $0 
Seat 1: adilpoker84 collected ($0.25)
Seat 2: Dimitrii 30 folded before Flop (didn't bet)
Seat 3: teddyKK (button) folded before Flop (didn't bet)
Seat 4: aiv72 (small blind) folded before Flop
Seat 5: skems123 (big blind) folded before Flop
Seat 6: Acedan1369 folded before Flop (didn't bet)



PokerStars Hand #222970394303:  Hold'em No Limit ($0.05/$0.10 USD) - 2021/01/23 15:50:04 ET
Table 'Capricorn III' 6-max Seat #4 is the button
Seat 1: adilpoker84 ($21.40 in chips) 
Seat 2: Dimitrii 30 ($8.13 in chips) 
Seat 3: teddyKK ($10 in chips) 
Seat 4: aiv72 ($8.02 in chips) 
Seat 5: skems123 ($10.99 in chips) 
Seat 6: Acedan1369 ($26.36 in chips) 
skems123: posts small blind $0.05
Acedan1369: posts big blind $0.10
*** HOLE CARDS ***
adilpoker84: folds 
Dimitrii 30: folds 
teddyKK: raises $0.20 to $0.30
Dimitrii 30 leaves the table
aiv72 has timed out
aiv72: folds 
skems123: folds 
Acedan1369: folds 
Uncalled bet ($0.20) returned to teddyKK
teddyKK collected $0.25 from pot
teddyKK: doesn't show hand 
*** SUMMARY ***
Total pot $0.25 | Rake $0 
Seat 1: adilpoker84 folded before Flop (didn't bet)
Seat 2: Dimitrii 30 folded before Flop (didn't bet)
Seat 3: teddyKK collected ($0.25)
Seat 4: aiv72 (button) folded before Flop (didn't bet)
Seat 5: skems123 (small blind) folded before Flop
Seat 6: Acedan1369 (big blind) folded before Flop



PokerStars Hand #222970421205:  Hold'em No Limit ($0.05/$0.10 USD) - 2021/01/23 15:50:36 ET
Table 'Capricorn III' 6-max Seat #5 is the button
Seat 1: adilpoker84 ($21.40 in chips) 
Seat 3: teddyKK ($10.15 in chips) 
Seat 5: skems123 ($10.94 in chips) 
Seat 6: Acedan1369 ($26.26 in chips) 
Acedan1369: posts small blind $0.05
adilpoker84: posts big blind $0.10
*** HOLE CARDS ***
teddyKK: folds 
skems123: folds 
Acedan1369: folds 
Uncalled bet ($0.05) returned to adilpoker84
adilpoker84 collected $0.10 from pot
adilpoker84: doesn't show hand 
*** SUMMARY ***
Total pot $0.10 | Rake $0 
Seat 1: adilpoker84 (big blind) collected ($0.10)
Seat 3: teddyKK folded before Flop (didn't bet)
Seat 5: skems123 (button) folded before Flop (didn't bet)
Seat 6: Acedan1369 (small blind) folded before Flop



PokerStars Hand #222970436246:  Hold'em No Limit ($0.05/$0.10 USD) - 2021/01/23 15:50:54 ET
Table 'Capricorn III' 6-max Seat #6 is the button
Seat 1: adilpoker84 ($21.45 in chips) 
Seat 3: teddyKK ($10.15 in chips) 
Seat 4: aiv72 ($8.02 in chips) 
Seat 5: skems123 ($10.94 in chips) 
Seat 6: Acedan1369 ($26.21 in chips) 
adilpoker84: posts small blind $0.05
teddyKK: posts big blind $0.10
*** HOLE CARDS ***
aiv72: raises $0.10 to $0.20
skems123: folds 
Acedan1369: folds 
maria west side joins the table at seat #2 
adilpoker84: folds 
teddyKK: folds 
Uncalled bet ($0.10) returned to aiv72
aiv72 collected $0.25 from pot
aiv72: doesn't show hand 
*** SUMMARY ***
Total pot $0.25 | Rake $0 
Seat 1: adilpoker84 (small blind) folded before Flop
Seat 3: teddyKK (big blind) folded before Flop
Seat 4: aiv72 collected ($0.25)
Seat 5: skems123 folded before Flop (didn't bet)
Seat 6: Acedan1369 (button) folded before Flop (didn't bet)



PokerStars Hand #222970456699:  Hold'em No Limit ($0.05/$0.10 USD) - 2021/01/23 15:51:19 ET
Table 'Capricorn III' 6-max Seat #1 is the button
Seat 1: adilpoker84 ($21.40 in chips) 
Seat 3: teddyKK ($10.05 in chips) 
Seat 4: aiv72 ($8.17 in chips) 
Seat 5: skems123 ($10.94 in chips) 
Seat 6: Acedan1369 ($26.21 in chips) 
teddyKK: posts small blind $0.05
aiv72: posts big blind $0.10
*** HOLE CARDS ***
skems123: folds 
Acedan1369: folds 
adilpoker84: raises $0.20 to $0.30
teddyKK: folds 
aiv72: calls $0.20
*** FLOP *** [4c Qc 2s]
aiv72: checks 
adilpoker84: checks 
*** TURN *** [4c Qc 2s] [5h]
aiv72: bets $0.10
adilpoker84: calls $0.10
*** RIVER *** [4c Qc 2s 5h] [Jd]
aiv72: checks 
adilpoker84: bets $0.30
aiv72: folds 
Uncalled bet ($0.30) returned to adilpoker84
adilpoker84 collected $0.81 from pot
adilpoker84: doesn't show hand 
*** SUMMARY ***
Total pot $0.85 | Rake $0.04 
Board [4c Qc 2s 5h Jd]
Seat 1: adilpoker84 (button) collected ($0.81)
Seat 3: teddyKK (small blind) folded before Flop
Seat 4: aiv72 (big blind) folded on the River
Seat 5: skems123 folded before Flop (didn't bet)
Seat 6: Acedan1369 folded before Flop (didn't bet)



PokerStars Hand #222970520640:  Hold'em No Limit ($0.05/$0.10 USD) - 2021/01/23 15:52:35 ET
Table 'Capricorn III' 6-max Seat #3 is the button
Seat 1: adilpoker84 ($21.81 in chips) 
Seat 3: teddyKK ($10 in chips) 
Seat 4: aiv72 ($7.77 in chips) 
Seat 5: skems123 ($10.94 in chips) 
Seat 6: Acedan1369 ($26.21 in chips) 
aiv72: posts small blind $0.05
skems123: posts big blind $0.10
maria west side: sits out 
*** HOLE CARDS ***
Acedan1369: folds 
adilpoker84: folds 
teddyKK: folds 
aiv72: raises $0.60 to $0.70
skems123: folds 
Uncalled bet ($0.60) returned to aiv72
aiv72 collected $0.20 from pot
aiv72: doesn't show hand 
*** SUMMARY ***
Total pot $0.20 | Rake $0 
Seat 1: adilpoker84 folded before Flop (didn't bet)
Seat 3: teddyKK (button) folded before Flop (didn't bet)
Seat 4: aiv72 (small blind) collected ($0.20)
Seat 5: skems123 (big blind) folded before Flop
Seat 6: Acedan1369 folded before Flop (didn't bet)



PokerStars Hand #222970536907:  Hold'em No Limit ($0.05/$0.10 USD) - 2021/01/23 15:52:55 ET
Table 'Capricorn III' 6-max Seat #4 is the button
Seat 1: adilpoker84 ($21.81 in chips) 
Seat 3: teddyKK ($10 in chips) 
Seat 4: aiv72 ($7.87 in chips) 
Seat 5: skems123 ($10.84 in chips) 
Seat 6: Acedan1369 ($26.21 in chips) 
skems123: posts small blind $0.05
Acedan1369: posts big blind $0.10
maria west side: sits out 
*** HOLE CARDS ***
adilpoker84: calls $0.10
teddyKK: folds 
aiv72: calls $0.10
skems123: folds 
Acedan1369: checks 
*** FLOP *** [8d 5s Js]
Acedan1369: checks 
adilpoker84: checks 
aiv72: checks 
*** TURN *** [8d 5s Js] [Th]
Acedan1369: checks 
adilpoker84: bets $0.20
aiv72: calls $0.20
Acedan1369: calls $0.20
*** RIVER *** [8d 5s Js Th] [Tc]
Acedan1369: checks 
adilpoker84: checks 
aiv72: bets $0.60
Acedan1369: folds 
adilpoker84: folds 
Uncalled bet ($0.60) returned to aiv72
aiv72 collected $0.91 from pot
aiv72: doesn't show hand 
*** SUMMARY ***
Total pot $0.95 | Rake $0.04 
Board [8d 5s Js Th Tc]
Seat 1: adilpoker84 folded on the River
Seat 3: teddyKK folded before Flop (didn't bet)
Seat 4: aiv72 (button) collected ($0.91)
Seat 5: skems123 (small blind) folded before Flop
Seat 6: Acedan1369 (big blind) folded on the River



PokerStars Hand #222970599507:  Hold'em No Limit ($0.05/$0.10 USD) - 2021/01/23 15:54:10 ET
Table 'Capricorn III' 6-max Seat #5 is the button
Seat 1: adilpoker84 ($21.51 in chips) 
Seat 3: teddyKK ($10 in chips) 
Seat 4: aiv72 ($8.48 in chips) 
Seat 5: skems123 ($10.79 in chips) 
Seat 6: Acedan1369 ($25.91 in chips) 
Acedan1369: posts small blind $0.05
adilpoker84: posts big blind $0.10
maria west side: sits out 
*** HOLE CARDS ***
teddyKK: folds 
aiv72: raises $0.10 to $0.20
skems123: folds 
Acedan1369: folds 
adilpoker84: calls $0.10
*** FLOP *** [Qc 9c Th]
adilpoker84: checks 
aiv72: bets $0.30
adilpoker84: folds 
Uncalled bet ($0.30) returned to aiv72
aiv72 collected $0.43 from pot
aiv72: doesn't show hand 
*** SUMMARY ***
Total pot $0.45 | Rake $0.02 
Board [Qc 9c Th]
Seat 1: adilpoker84 (big blind) folded on the Flop
Seat 3: teddyKK folded before Flop (didn't bet)
Seat 4: aiv72 collected ($0.43)
Seat 5: skems123 (button) folded before Flop (didn't bet)
Seat 6: Acedan1369 (small blind) folded before Flop



PokerStars Hand #222970634417:  Hold'em No Limit ($0.05/$0.10 USD) - 2021/01/23 15:54:52 ET
Table 'Capricorn III' 6-max Seat #6 is the button
Seat 1: adilpoker84 ($21.31 in chips) 
Seat 2: maria west side ($4 in chips) 
Seat 3: teddyKK ($10 in chips) 
Seat 4: aiv72 ($8.71 in chips) 
Seat 5: skems123 ($10.79 in chips) 
Seat 6: Acedan1369 ($25.86 in chips) 
adilpoker84: posts small blind $0.05
maria west side: posts big blind $0.10
*** HOLE CARDS ***
teddyKK: raises $0.20 to $0.30
aiv72: calls $0.30
skems123: folds 
Acedan1369: folds 
adilpoker84: calls $0.25
maria west side has timed out
maria west side: folds 
*** FLOP *** [8s Qh Td]
adilpoker84: checks 
teddyKK: bets $0.70
aiv72: calls $0.70
adilpoker84: calls $0.70
*** TURN *** [8s Qh Td] [5s]
adilpoker84: checks 
teddyKK: bets $2.30
aiv72: folds 
adilpoker84: folds 
Uncalled bet ($2.30) returned to teddyKK
teddyKK collected $2.96 from pot
teddyKK: doesn't show hand 
*** SUMMARY ***
Total pot $3.10 | Rake $0.14 
Board [8s Qh Td 5s]
Seat 1: adilpoker84 (small blind) folded on the Turn
Seat 2: maria west side (big blind) folded before Flop
Seat 3: teddyKK collected ($2.96)
Seat 4: aiv72 folded on the Turn
Seat 5: skems123 folded before Flop (didn't bet)
Seat 6: Acedan1369 (button) folded before Flop (didn't bet)



PokerStars Hand #222970692945:  Hold'em No Limit ($0.05/$0.10 USD) - 2021/01/23 15:56:20 ET
Table 'Capricorn III' 6-max Seat #1 is the button
Seat 1: adilpoker84 ($20.31 in chips) 
Seat 2: maria west side ($3.90 in chips) 
Seat 3: teddyKK ($11.96 in chips) 
Seat 4: aiv72 ($7.71 in chips) 
Seat 5: skems123 ($10.79 in chips) 
Seat 6: Acedan1369 ($25.86 in chips) 
maria west side: posts small blind $0.05
teddyKK: posts big blind $0.10
*** HOLE CARDS ***
aiv72: raises $0.10 to $0.20
skems123: folds 
Acedan1369: folds 
adilpoker84: folds 
maria west side has timed out
maria west side: folds 
teddyKK: folds 
Uncalled bet ($0.10) returned to aiv72
aiv72 collected $0.25 from pot
aiv72: doesn't show hand 
*** SUMMARY ***
Total pot $0.25 | Rake $0 
Seat 1: adilpoker84 (button) folded before Flop (didn't bet)
Seat 2: maria west side (small blind) folded before Flop
Seat 3: teddyKK (big blind) folded before Flop
Seat 4: aiv72 collected ($0.25)
Seat 5: skems123 folded before Flop (didn't bet)
Seat 6: Acedan1369 folded before Flop (didn't bet)



PokerStars Hand #222970710196:  Hold'em No Limit ($0.05/$0.10 USD) - 2021/01/23 15:56:50 ET
Table 'Capricorn III' 6-max Seat #3 is the button
Seat 1: adilpoker84 ($20.31 in chips) 
Seat 3: teddyKK ($11.86 in chips) 
Seat 4: aiv72 ($7.86 in chips) 
Seat 5: skems123 ($10.79 in chips) 
Seat 6: Acedan1369 ($25.86 in chips) 
aiv72: posts small blind $0.05
skems123: posts big blind $0.10
*** HOLE CARDS ***
Acedan1369: raises $0.15 to $0.25
adilpoker84: calls $0.25
teddyKK: folds 
aiv72: calls $0.20
skems123: folds 
*** FLOP *** [8s Kc 2d]
aiv72: checks 
Acedan1369: checks 
adilpoker84: checks 
*** TURN *** [8s Kc 2d] [8h]
aiv72: checks 
Acedan1369: checks 
adilpoker84: bets $0.20
aiv72: folds 
Acedan1369: folds 
Uncalled bet ($0.20) returned to adilpoker84
adilpoker84 collected $0.81 from pot
adilpoker84: doesn't show hand 
*** SUMMARY ***
Total pot $0.85 | Rake $0.04 
Board [8s Kc 2d 8h]
Seat 1: adilpoker84 collected ($0.81)
Seat 3: teddyKK (button) folded before Flop (didn't bet)
Seat 4: aiv72 (small blind) folded on the Turn
Seat 5: skems123 (big blind) folded before Flop
Seat 6: Acedan1369 folded on the Turn



PokerStars Hand #222970730384:  Hold'em No Limit ($0.05/$0.10 USD) - 2021/01/23 15:57:26 ET
Table 'Capricorn III' 6-max Seat #4 is the button
Seat 1: adilpoker84 ($20.87 in chips) 
Seat 3: teddyKK ($11.86 in chips) 
Seat 4: aiv72 ($7.61 in chips) 
Seat 5: skems123 ($10.69 in chips) 
Seat 6: Acedan1369 ($25.61 in chips) 
skems123: posts small blind $0.05
Acedan1369: posts big blind $0.10
*** HOLE CARDS ***
adilpoker84: calls $0.10
teddyKK: folds 
aiv72 has timed out
aiv72: folds 
skems123: folds 
Acedan1369: checks 
*** FLOP *** [Ah 3d 2s]
Acedan1369: checks 
adilpoker84: checks 
*** TURN *** [Ah 3d 2s] [Tc]
Acedan1369: checks 
adilpoker84: checks 
*** RIVER *** [Ah 3d 2s Tc] [5h]
Acedan1369: checks 
adilpoker84: checks 
*** SHOW DOWN ***
Acedan1369: shows [6h 2d] (a pair of Deuces)
adilpoker84: mucks hand 
Acedan1369 collected $0.24 from pot
*** SUMMARY ***
Total pot $0.25 | Rake $0.01 
Board [Ah 3d 2s Tc 5h]
Seat 1: adilpoker84 mucked
Seat 3: teddyKK folded before Flop (didn't bet)
Seat 4: aiv72 (button) folded before Flop (didn't bet)
Seat 5: skems123 (small blind) folded before Flop
Seat 6: Acedan1369 (big blind) showed [6h 2d] and won ($0.24) with a pair of Deuces



PokerStars Hand #222970773508:  Hold'em No Limit ($0.05/$0.10 USD) - 2021/01/23 15:58:42 ET
Table 'Capricorn III' 6-max Seat #5 is the button
Seat 1: adilpoker84 ($20.77 in chips) 
Seat 3: teddyKK ($11.86 in chips) 
Seat 4: aiv72 ($7.61 in chips) 
Seat 5: skems123 ($10.64 in chips) 
Seat 6: Acedan1369 ($25.75 in chips) 
Acedan1369: posts small blind $0.05
adilpoker84: posts big blind $0.10
*** HOLE CARDS ***
teddyKK: raises $0.20 to $0.30
aiv72: raises $0.20 to $0.50
skems123 has timed out
skems123: folds 
Acedan1369: folds 
adilpoker84: folds 
teddyKK: calls $0.20
*** FLOP *** [Kh 6h 3h]
teddyKK: checks 
aiv72: bets $0.90
teddyKK: raises $2.18 to $3.08
aiv72: folds 
Uncalled bet ($2.18) returned to teddyKK
teddyKK collected $2.82 from pot
teddyKK: doesn't show hand 
*** SUMMARY ***
Total pot $2.95 | Rake $0.13 
Board [Kh 6h 3h]
Seat 1: adilpoker84 (big blind) folded before Flop
Seat 3: teddyKK collected ($2.82)
Seat 4: aiv72 folded on the Flop
Seat 5: skems123 (button) folded before Flop (didn't bet)
Seat 6: Acedan1369 (small blind) folded before Flop



PokerStars Hand #222970798913:  Hold'em No Limit ($0.05/$0.10 USD) - 2021/01/23 15:59:27 ET
Table 'Capricorn III' 6-max Seat #6 is the button
Seat 1: adilpoker84 ($20.67 in chips) 
Seat 3: teddyKK ($13.28 in chips) 
Seat 4: aiv72 ($6.21 in chips) 
Seat 5: skems123 ($10.64 in chips) 
Seat 6: Acedan1369 ($25.70 in chips) 
adilpoker84: posts small blind $0.05
teddyKK: posts big blind $0.10
*** HOLE CARDS ***
aiv72: raises $0.10 to $0.20
skems123: folds 
Acedan1369: folds 
adilpoker84: folds 
teddyKK: folds 
Uncalled bet ($0.10) returned to aiv72
aiv72 collected $0.25 from pot
aiv72: doesn't show hand 
*** SUMMARY ***
Total pot $0.25 | Rake $0 
Seat 1: adilpoker84 (small blind) folded before Flop
Seat 3: teddyKK (big blind) folded before Flop
Seat 4: aiv72 collected ($0.25)
Seat 5: skems123 folded before Flop (didn't bet)
Seat 6: Acedan1369 (button) folded before Flop (didn't bet)



PokerStars Hand #222970810965:  Hold'em No Limit ($0.05/$0.10 USD) - 2021/01/23 15:59:48 ET
Table 'Capricorn III' 6-max Seat #1 is the button
Seat 1: adilpoker84 ($20.62 in chips) 
Seat 3: teddyKK ($13.18 in chips) 
Seat 4: aiv72 ($6.36 in chips) 
Seat 5: skems123 ($10.64 in chips) 
Seat 6: Acedan1369 ($25.70 in chips) 
teddyKK: posts small blind $0.05
aiv72: posts big blind $0.10
*** HOLE CARDS ***
skems123: folds 
Acedan1369: folds 
adilpoker84: folds 
teddyKK: folds 
Uncalled bet ($0.05) returned to aiv72
aiv72 collected $0.10 from pot
aiv72: doesn't show hand 
*** SUMMARY ***
Total pot $0.10 | Rake $0 
Seat 1: adilpoker84 (button) folded before Flop (didn't bet)
Seat 3: teddyKK (small blind) folded before Flop
Seat 4: aiv72 (big blind) collected ($0.10)
Seat 5: skems123 folded before Flop (didn't bet)
Seat 6: Acedan1369 folded before Flop (didn't bet)



PokerStars Hand #222970819875:  Hold'em No Limit ($0.05/$0.10 USD) - 2021/01/23 16:00:04 ET
Table 'Capricorn III' 6-max Seat #3 is the button
Seat 1: adilpoker84 ($20.62 in chips) 
Seat 3: teddyKK ($13.13 in chips) 
Seat 4: aiv72 ($6.41 in chips) 
Seat 5: skems123 ($10.64 in chips) 
Seat 6: Acedan1369 ($25.70 in chips) 
aiv72: posts small blind $0.05
skems123: posts big blind $0.10
*** HOLE CARDS ***
Acedan1369: folds 
adilpoker84: calls $0.10
teddyKK: folds 
aiv72: raises $0.10 to $0.20
skems123: folds 
adilpoker84: calls $0.10
*** FLOP *** [7d 2s 8s]
aiv72: checks 
adilpoker84: checks 
*** TURN *** [7d 2s 8s] [As]
aiv72: checks 
adilpoker84: checks 
*** RIVER *** [7d 2s 8s As] [Ah]
aiv72: checks 
adilpoker84: bets $0.10
aiv72: folds 
Uncalled bet ($0.10) returned to adilpoker84
adilpoker84 collected $0.48 from pot
adilpoker84: doesn't show hand 
*** SUMMARY ***
Total pot $0.50 | Rake $0.02 
Board [7d 2s 8s As Ah]
Seat 1: adilpoker84 collected ($0.48)
Seat 3: teddyKK (button) folded before Flop (didn't bet)
Seat 4: aiv72 (small blind) folded on the River
Seat 5: skems123 (big blind) folded before Flop
Seat 6: Acedan1369 folded before Flop (didn't bet)



PokerStars Hand #222970836876:  Hold'em No Limit ($0.05/$0.10 USD) - 2021/01/23 16:00:31 ET
Table 'Capricorn III' 6-max Seat #4 is the button
Seat 1: adilpoker84 ($20.90 in chips) 
Seat 3: teddyKK ($13.13 in chips) 
Seat 4: aiv72 ($6.21 in chips) 
Seat 5: skems123 ($10.54 in chips) 
Seat 6: Acedan1369 ($25.70 in chips) 
skems123: posts small blind $0.05
Acedan1369: posts big blind $0.10
*** HOLE CARDS ***
adilpoker84: calls $0.10
teddyKK: folds 
aiv72: raises $0.10 to $0.20
skems123: raises $0.50 to $0.70
Acedan1369: calls $0.60
adilpoker84: calls $0.60
aiv72: raises $5.51 to $6.21 and is all-in
skems123: folds 
Acedan1369: folds 
adilpoker84: folds 
Uncalled bet ($5.51) returned to aiv72
aiv72 collected $2.80 from pot
aiv72: doesn't show hand 
*** SUMMARY ***
Total pot $2.80 | Rake $0 
Seat 1: adilpoker84 folded before Flop
Seat 3: teddyKK folded before Flop (didn't bet)
Seat 4: aiv72 (button) collected ($2.80)
Seat 5: skems123 (small blind) folded before Flop
Seat 6: Acedan1369 (big blind) folded before Flop



PokerStars Hand #222970884814:  Hold'em No Limit ($0.05/$0.10 USD) - 2021/01/23 16:01:42 ET
Table 'Capricorn III' 6-max Seat #5 is the button
Seat 1: adilpoker84 ($20.20 in chips) 
Seat 3: teddyKK ($13.13 in chips) 
Seat 4: aiv72 ($8.31 in chips) 
Seat 5: skems123 ($10 in chips) 
Seat 6: Acedan1369 ($25 in chips) 
Acedan1369: posts small blind $0.05
adilpoker84: posts big blind $0.10
*** HOLE CARDS ***
teddyKK: folds 
aiv72 has timed out
aiv72: folds 
skems123: folds 
Acedan1369: raises $0.15 to $0.25
adilpoker84: calls $0.15
*** FLOP *** [2c 8s 3c]
Acedan1369: checks 
adilpoker84: checks 
*** TURN *** [2c 8s 3c] [As]
Acedan1369: checks 
adilpoker84: checks 
*** RIVER *** [2c 8s 3c As] [7h]
Acedan1369: checks 
adilpoker84: bets $0.10
Acedan1369: folds 
Uncalled bet ($0.10) returned to adilpoker84
adilpoker84 collected $0.48 from pot
adilpoker84: doesn't show hand 
*** SUMMARY ***
Total pot $0.50 | Rake $0.02 
Board [2c 8s 3c As 7h]
Seat 1: adilpoker84 (big blind) collected ($0.48)
Seat 3: teddyKK folded before Flop (didn't bet)
Seat 4: aiv72 folded before Flop (didn't bet)
Seat 5: skems123 (button) folded before Flop (didn't bet)
Seat 6: Acedan1369 (small blind) folded on the River



PokerStars Hand #222970926419:  Hold'em No Limit ($0.05/$0.10 USD) - 2021/01/23 16:02:35 ET
Table 'Capricorn III' 6-max Seat #6 is the button
Seat 1: adilpoker84 ($20.43 in chips) 
Seat 3: teddyKK ($13.13 in chips) 
Seat 4: aiv72 ($8.31 in chips) 
Seat 5: skems123 ($10 in chips) 
Seat 6: Acedan1369 ($24.75 in chips) 
adilpoker84: posts small blind $0.05
teddyKK: posts big blind $0.10
*** HOLE CARDS ***
aiv72: calls $0.10
skems123: folds 
Acedan1369 has timed out
Acedan1369: folds 
adilpoker84: calls $0.05
teddyKK: checks 
*** FLOP *** [5d 7d 3c]
adilpoker84: bets $0.10
teddyKK: raises $0.20 to $0.30
aiv72: calls $0.30
adilpoker84: calls $0.20
*** TURN *** [5d 7d 3c] [Ks]
adilpoker84: checks 
teddyKK: checks 
aiv72: checks 
*** RIVER *** [5d 7d 3c Ks] [Th]
adilpoker84: checks 
teddyKK: checks 
aiv72: checks 
*** SHOW DOWN ***
adilpoker84: shows [6h 5h] (a pair of Fives)
teddyKK: shows [Jc 7s] (a pair of Sevens)
aiv72: mucks hand 
teddyKK collected $1.15 from pot
*** SUMMARY ***
Total pot $1.20 | Rake $0.05 
Board [5d 7d 3c Ks Th]
Seat 1: adilpoker84 (small blind) showed [6h 5h] and lost with a pair of Fives
Seat 3: teddyKK (big blind) showed [Jc 7s] and won ($1.15) with a pair of Sevens
Seat 4: aiv72 mucked
Seat 5: skems123 folded before Flop (didn't bet)
Seat 6: Acedan1369 (button) folded before Flop (didn't bet)



PokerStars Hand #222970972608:  Hold'em No Limit ($0.05/$0.10 USD) - 2021/01/23 16:03:32 ET
Table 'Capricorn III' 6-max Seat #1 is the button
Seat 1: adilpoker84 ($20.03 in chips) 
Seat 3: teddyKK ($13.88 in chips) 
Seat 4: aiv72 ($7.91 in chips) 
Seat 5: skems123 ($10 in chips) 
Seat 6: Acedan1369 ($24.75 in chips) 
teddyKK: posts small blind $0.05
aiv72: posts big blind $0.10
*** HOLE CARDS ***
skems123: folds 
Acedan1369 has timed out
Acedan1369: folds 
adilpoker84: calls $0.10
teddyKK: folds 
aiv72: raises $1 to $1.10
adilpoker84: folds 
Uncalled bet ($1) returned to aiv72
aiv72 collected $0.25 from pot
aiv72: doesn't show hand 
*** SUMMARY ***
Total pot $0.25 | Rake $0 
Seat 1: adilpoker84 (button) folded before Flop
Seat 3: teddyKK (small blind) folded before Flop
Seat 4: aiv72 (big blind) collected ($0.25)
Seat 5: skems123 folded before Flop (didn't bet)
Seat 6: Acedan1369 folded before Flop (didn't bet)



PokerStars Hand #222970993122:  Hold'em No Limit ($0.05/$0.10 USD) - 2021/01/23 16:03:57 ET
Table 'Capricorn III' 6-max Seat #3 is the button
Seat 1: adilpoker84 ($19.93 in chips) 
Seat 3: teddyKK ($13.83 in chips) 
Seat 4: aiv72 ($8.06 in chips) 
Seat 5: skems123 ($10 in chips) 
aiv72: posts small blind $0.05
skems123: posts big blind $0.10
*** HOLE CARDS ***
adilpoker84: raises $0.10 to $0.20
teddyKK: folds 
aiv72: raises $0.30 to $0.50
skems123: folds 
adilpoker84: calls $0.30
*** FLOP *** [4d Td 8h]
aiv72: checks 
adilpoker84: bets $0.20
aiv72: calls $0.20
*** TURN *** [4d Td 8h] [4c]
aiv72: bets $7.36 and is all-in
adilpoker84: folds 
Uncalled bet ($7.36) returned to aiv72
aiv72 collected $1.43 from pot
aiv72: doesn't show hand 
*** SUMMARY ***
Total pot $1.50 | Rake $0.07 
Board [4d Td 8h 4c]
Seat 1: adilpoker84 folded on the Turn
Seat 3: teddyKK (button) folded before Flop (didn't bet)
Seat 4: aiv72 (small blind) collected ($1.43)
Seat 5: skems123 (big blind) folded before Flop



PokerStars Hand #222971020938:  Hold'em No Limit ($0.05/$0.10 USD) - 2021/01/23 16:04:31 ET
Table 'Capricorn III' 6-max Seat #4 is the button
Seat 1: adilpoker84 ($19.23 in chips) 
Seat 3: teddyKK ($13.83 in chips) 
Seat 4: aiv72 ($8.79 in chips) 
Seat 5: skems123 ($10 in chips) 
Seat 6: Acedan1369 ($24.75 in chips) 
skems123: posts small blind $0.05
Acedan1369: posts big blind $0.10
*** HOLE CARDS ***
adilpoker84: calls $0.10
teddyKK: folds 
aiv72: calls $0.10
skems123: folds 
Acedan1369: checks 
*** FLOP *** [Kh 5c 9c]
Acedan1369: checks 
adilpoker84: checks 
aiv72: checks 
*** TURN *** [Kh 5c 9c] [7c]
Acedan1369: checks 
adilpoker84: bets $0.20
aiv72: calls $0.20
Acedan1369: folds 
*** RIVER *** [Kh 5c 9c 7c] [3s]
adilpoker84: bets $0.20
aiv72: folds 
Uncalled bet ($0.20) returned to adilpoker84
adilpoker84 collected $0.72 from pot
adilpoker84: doesn't show hand 
*** SUMMARY ***
Total pot $0.75 | Rake $0.03 
Board [Kh 5c 9c 7c 3s]
Seat 1: adilpoker84 collected ($0.72)
Seat 3: teddyKK folded before Flop (didn't bet)
Seat 4: aiv72 (button) folded on the River
Seat 5: skems123 (small blind) folded before Flop
Seat 6: Acedan1369 (big blind) folded on the Turn



PokerStars Hand #222971064130:  Hold'em No Limit ($0.05/$0.10 USD) - 2021/01/23 16:05:22 ET
Table 'Capricorn III' 6-max Seat #5 is the button
Seat 1: adilpoker84 ($19.65 in chips) 
Seat 3: teddyKK ($13.83 in chips) 
Seat 4: aiv72 ($8.49 in chips) 
Seat 5: skems123 ($10 in chips) 
Seat 6: Acedan1369 ($24.65 in chips) 
Acedan1369: posts small blind $0.05
adilpoker84: posts big blind $0.10
*** HOLE CARDS ***
teddyKK: folds 
aiv72: raises $0.10 to $0.20
skems123: folds 
Acedan1369: folds 
adilpoker84: raises $0.30 to $0.50
aiv72: raises $0.30 to $0.80
adilpoker84: calls $0.30
*** FLOP *** [Ah 4h 5d]
adilpoker84: checks 
aiv72: bets $0.10
adilpoker84: calls $0.10
*** TURN *** [Ah 4h 5d] [5s]
adilpoker84: checks 
aiv72: bets $0.10
adilpoker84: calls $0.10
*** RIVER *** [Ah 4h 5d 5s] [5c]
adilpoker84: bets $0.30
aiv72: calls $0.30
*** SHOW DOWN ***
adilpoker84: shows [7c 7h] (a full house, Fives full of Sevens)
aiv72: shows [3h As] (a full house, Fives full of Aces)
aiv72 collected $2.53 from pot
*** SUMMARY ***
Total pot $2.65 | Rake $0.12 
Board [Ah 4h 5d 5s 5c]
Seat 1: adilpoker84 (big blind) showed [7c 7h] and lost with a full house, Fives full of Sevens
Seat 3: teddyKK folded before Flop (didn't bet)
Seat 4: aiv72 showed [3h As] and won ($2.53) with a full house, Fives full of Aces
Seat 5: skems123 (button) folded before Flop (didn't bet)
Seat 6: Acedan1369 (small blind) folded before Flop



PokerStars Hand #222971091115:  Hold'em No Limit ($0.05/$0.10 USD) - 2021/01/23 16:05:55 ET
Table 'Capricorn III' 6-max Seat #6 is the button
Seat 1: adilpoker84 ($18.35 in chips) 
Seat 3: teddyKK ($13.83 in chips) 
Seat 4: aiv72 ($9.72 in chips) 
Seat 5: skems123 ($10 in chips) 
Seat 6: Acedan1369 ($24.60 in chips) 
adilpoker84: posts small blind $0.05
teddyKK: posts big blind $0.10
*** HOLE CARDS ***
aiv72: calls $0.10
skems123: folds 
Acedan1369: folds 
adilpoker84: calls $0.05
teddyKK: checks 
*** FLOP *** [Td Jh As]
adilpoker84: bets $0.10
teddyKK: folds 
aiv72: calls $0.10
*** TURN *** [Td Jh As] [5h]
adilpoker84: bets $0.10
aiv72: calls $0.10
*** RIVER *** [Td Jh As 5h] [5d]
adilpoker84: bets $0.10
aiv72: folds 
Uncalled bet ($0.10) returned to adilpoker84
adilpoker84 collected $0.67 from pot
adilpoker84: doesn't show hand 
*** SUMMARY ***
Total pot $0.70 | Rake $0.03 
Board [Td Jh As 5h 5d]
Seat 1: adilpoker84 (small blind) collected ($0.67)
Seat 3: teddyKK (big blind) folded on the Flop
Seat 4: aiv72 folded on the River
Seat 5: skems123 folded before Flop (didn't bet)
Seat 6: Acedan1369 (button) folded before Flop (didn't bet)



PokerStars Hand #222971126504:  Hold'em No Limit ($0.05/$0.10 USD) - 2021/01/23 16:06:37 ET
Table 'Capricorn III' 6-max Seat #1 is the button
Seat 1: adilpoker84 ($18.72 in chips) 
Seat 3: teddyKK ($13.73 in chips) 
Seat 4: aiv72 ($9.42 in chips) 
Seat 5: skems123 ($10 in chips) 
Seat 6: Acedan1369 ($24.60 in chips) 
teddyKK: posts small blind $0.05
aiv72: posts big blind $0.10
*** HOLE CARDS ***
skems123: folds 
Acedan1369: folds 
adilpoker84: folds 
teddyKK: folds 
Uncalled bet ($0.05) returned to aiv72
aiv72 collected $0.10 from pot
aiv72: doesn't show hand 
*** SUMMARY ***
Total pot $0.10 | Rake $0 
Seat 1: adilpoker84 (button) folded before Flop (didn't bet)
Seat 3: teddyKK (small blind) folded before Flop
Seat 4: aiv72 (big blind) collected ($0.10)
Seat 5: skems123 folded before Flop (didn't bet)
Seat 6: Acedan1369 folded before Flop (didn't bet)



PokerStars Hand #222972062345:  Hold'em No Limit ($0.05/$0.10 USD) - 2021/01/23 16:24:46 ET
Table 'Capricorn III' 6-max Seat #2 is the button
Seat 1: adilpoker84 ($12.86 in chips) 
Seat 2: bubbleburner85 ($7.06 in chips) 
Seat 3: teddyKK ($17.38 in chips) 
Seat 4: SchuhaRt71 ($12.48 in chips) 
Seat 5: skems123 ($10.40 in chips) 
Seat 6: heicci ($9.85 in chips) 
teddyKK: posts small blind $0.05
SchuhaRt71: posts big blind $0.10
*** HOLE CARDS ***
skems123: folds 
heicci: raises $0.20 to $0.30
adilpoker84: calls $0.30
bubbleburner85: folds 
bubbleburner85 leaves the table
teddyKK: folds 
SchuhaRt71: folds 
*** FLOP *** [3s 4s 9c]
johnysvk18 joins the table at seat #2 
heicci: bets $0.30
adilpoker84: calls $0.30
*** TURN *** [3s 4s 9c] [Td]
heicci: bets $0.65
adilpoker84: folds 
Uncalled bet ($0.65) returned to heicci
heicci collected $1.29 from pot
heicci: doesn't show hand 
*** SUMMARY ***
Total pot $1.35 | Rake $0.06 
Board [3s 4s 9c Td]
Seat 1: adilpoker84 folded on the Turn
Seat 2: bubbleburner85 (button) folded before Flop (didn't bet)
Seat 3: teddyKK (small blind) folded before Flop
Seat 4: SchuhaRt71 (big blind) folded before Flop
Seat 5: skems123 folded before Flop (didn't bet)
Seat 6: heicci collected ($1.29)



PokerStars Hand #222972096801:  Hold'em No Limit ($0.05/$0.10 USD) - 2021/01/23 16:25:27 ET
Table 'Capricorn III' 6-max Seat #3 is the button
Seat 1: adilpoker84 ($12.26 in chips) 
Seat 3: teddyKK ($17.33 in chips) 
Seat 4: SchuhaRt71 ($12.38 in chips) 
Seat 5: skems123 ($10.40 in chips) 
Seat 6: heicci ($10.54 in chips) 
SchuhaRt71: posts small blind $0.05
skems123: posts big blind $0.10
johnysvk18: sits out 
*** HOLE CARDS ***
heicci: folds 
adilpoker84: calls $0.10
teddyKK: folds 
SchuhaRt71: folds 
skems123: raises $0.30 to $0.40
adilpoker84: calls $0.30
*** FLOP *** [2d 5d 2s]
skems123: checks 
adilpoker84: checks 
*** TURN *** [2d 5d 2s] [2c]
skems123: checks 
adilpoker84: checks 
*** RIVER *** [2d 5d 2s 2c] [Kh]
johnysvk18 leaves the table
Burlica2013 joins the table at seat #2 
Burlica2013 leaves the table
skems123: bets $0.40
adilpoker84: calls $0.40
*** SHOW DOWN ***
skems123: shows [Qh Kc] (a full house, Deuces full of Kings)
adilpoker84: mucks hand 
skems123 collected $1.58 from pot
*** SUMMARY ***
Total pot $1.65 | Rake $0.07 
Board [2d 5d 2s 2c Kh]
Seat 1: adilpoker84 mucked
Seat 3: teddyKK (button) folded before Flop (didn't bet)
Seat 4: SchuhaRt71 (small blind) folded before Flop
Seat 5: skems123 (big blind) showed [Qh Kc] and won ($1.58) with a full house, Deuces full of Kings
Seat 6: heicci folded before Flop (didn't bet)



PokerStars Hand #222972130829:  Hold'em No Limit ($0.05/$0.10 USD) - 2021/01/23 16:26:07 ET
Table 'Capricorn III' 6-max Seat #4 is the button
Seat 1: adilpoker84 ($11.46 in chips) 
Seat 3: teddyKK ($17.33 in chips) 
Seat 4: SchuhaRt71 ($12.33 in chips) 
Seat 5: skems123 ($11.18 in chips) 
Seat 6: heicci ($10.54 in chips) 
skems123: posts small blind $0.05
heicci: posts big blind $0.10
*** HOLE CARDS ***
adilpoker84: calls $0.10
teddyKK: folds 
SchuhaRt71: raises $0.60 to $0.70
skems123: folds 
heicci: calls $0.60
adilpoker84: calls $0.60
*** FLOP *** [2h 4s 3h]
heicci: checks 
adilpoker84: checks 
SchuhaRt71: bets $1.75
heicci: folds 
adilpoker84: calls $1.75
*** TURN *** [2h 4s 3h] [7h]
adilpoker84: checks 
SchuhaRt71: checks 
*** RIVER *** [2h 4s 3h 7h] [5s]
adilpoker84: bets $2.70
SchuhaRt71: folds 
Uncalled bet ($2.70) returned to adilpoker84
azatik88 joins the table at seat #2 
adilpoker84 collected $5.40 from pot
adilpoker84: doesn't show hand 
*** SUMMARY ***
Total pot $5.65 | Rake $0.25 
Board [2h 4s 3h 7h 5s]
Seat 1: adilpoker84 collected ($5.40)
Seat 3: teddyKK folded before Flop (didn't bet)
Seat 4: SchuhaRt71 (button) folded on the River
Seat 5: skems123 (small blind) folded before Flop
Seat 6: heicci (big blind) folded on the Flop



PokerStars Hand #222972163358:  Hold'em No Limit ($0.05/$0.10 USD) - 2021/01/23 16:26:45 ET
Table 'Capricorn III' 6-max Seat #5 is the button
Seat 1: adilpoker84 ($14.41 in chips) 
Seat 2: azatik88 ($5.77 in chips) 
Seat 3: teddyKK ($17.33 in chips) 
Seat 4: SchuhaRt71 ($10 in chips) 
Seat 5: skems123 ($11.13 in chips) 
Seat 6: heicci ($9.84 in chips) 
heicci: posts small blind $0.05
adilpoker84: posts big blind $0.10
azatik88 is connected 
azatik88: posts big blind $0.10
*** HOLE CARDS ***
azatik88: checks 
teddyKK: folds 
SchuhaRt71: raises $0.45 to $0.55
skems123: folds 
heicci: folds 
adilpoker84: folds 
azatik88: folds 
Uncalled bet ($0.45) returned to SchuhaRt71
SchuhaRt71 collected $0.35 from pot
SchuhaRt71: doesn't show hand 
*** SUMMARY ***
Total pot $0.35 | Rake $0 
Seat 1: adilpoker84 (big blind) folded before Flop
Seat 2: azatik88 folded before Flop (didn't bet)
Seat 3: teddyKK folded before Flop (didn't bet)
Seat 4: SchuhaRt71 collected ($0.35)
Seat 5: skems123 (button) folded before Flop (didn't bet)
Seat 6: heicci (small blind) folded before Flop



PokerStars Hand #222972183023:  Hold'em No Limit ($0.05/$0.10 USD) - 2021/01/23 16:27:08 ET
Table 'Capricorn III' 6-max Seat #6 is the button
Seat 1: adilpoker84 ($14.31 in chips) 
Seat 2: azatik88 ($5.67 in chips) 
Seat 3: teddyKK ($17.33 in chips) 
Seat 4: SchuhaRt71 ($10.25 in chips) 
Seat 5: skems123 ($11.13 in chips) 
Seat 6: heicci ($9.79 in chips) 
adilpoker84: posts small blind $0.05
azatik88: posts big blind $0.10
*** HOLE CARDS ***
teddyKK: folds 
SchuhaRt71: folds 
skems123: folds 
heicci: folds 
adilpoker84: calls $0.05
azatik88: checks 
*** FLOP *** [Kc 5s 7d]
adilpoker84: checks 
azatik88: checks 
*** TURN *** [Kc 5s 7d] [7s]
adilpoker84: checks 
azatik88: bets $0.19
adilpoker84: folds 
Uncalled bet ($0.19) returned to azatik88
azatik88 collected $0.19 from pot
*** SUMMARY ***
Total pot $0.20 | Rake $0.01 
Board [Kc 5s 7d 7s]
Seat 1: adilpoker84 (small blind) folded on the Turn
Seat 2: azatik88 (big blind) collected ($0.19)
Seat 3: teddyKK folded before Flop (didn't bet)
Seat 4: SchuhaRt71 folded before Flop (didn't bet)
Seat 5: skems123 folded before Flop (didn't bet)
Seat 6: heicci (button) folded before Flop (didn't bet)



PokerStars Hand #222972212058:  Hold'em No Limit ($0.05/$0.10 USD) - 2021/01/23 16:27:43 ET
Table 'Capricorn III' 6-max Seat #1 is the button
Seat 1: adilpoker84 ($14.21 in chips) 
Seat 2: azatik88 ($5.76 in chips) 
Seat 3: teddyKK ($17.33 in chips) 
Seat 4: SchuhaRt71 ($10.25 in chips) 
Seat 5: skems123 ($11.13 in chips) 
Seat 6: heicci ($9.79 in chips) 
azatik88: posts small blind $0.05
teddyKK: posts big blind $0.10
*** HOLE CARDS ***
SchuhaRt71: raises $0.30 to $0.40
skems123: folds 
heicci: folds 
adilpoker84: folds 
azatik88: folds 
teddyKK: folds 
Uncalled bet ($0.30) returned to SchuhaRt71
SchuhaRt71 collected $0.25 from pot
SchuhaRt71: doesn't show hand 
*** SUMMARY ***
Total pot $0.25 | Rake $0 
Seat 1: adilpoker84 (button) folded before Flop (didn't bet)
Seat 2: azatik88 (small blind) folded before Flop
Seat 3: teddyKK (big blind) folded before Flop
Seat 4: SchuhaRt71 collected ($0.25)
Seat 5: skems123 folded before Flop (didn't bet)
Seat 6: heicci folded before Flop (didn't bet)



PokerStars Hand #222972225803:  Hold'em No Limit ($0.05/$0.10 USD) - 2021/01/23 16:27:59 ET
Table 'Capricorn III' 6-max Seat #2 is the button
Seat 1: adilpoker84 ($14.21 in chips) 
Seat 2: azatik88 ($5.71 in chips) 
Seat 3: teddyKK ($17.23 in chips) 
Seat 4: SchuhaRt71 ($10.40 in chips) 
Seat 5: skems123 ($11.13 in chips) 
Seat 6: heicci ($9.79 in chips) 
teddyKK: posts small blind $0.05
SchuhaRt71: posts big blind $0.10
*** HOLE CARDS ***
skems123: folds 
heicci: folds 
adilpoker84: folds 
azatik88: raises $0.30 to $0.40
teddyKK: folds 
SchuhaRt71: folds 
Uncalled bet ($0.30) returned to azatik88
azatik88 collected $0.25 from pot
*** SUMMARY ***
Total pot $0.25 | Rake $0 
Seat 1: adilpoker84 folded before Flop (didn't bet)
Seat 2: azatik88 (button) collected ($0.25)
Seat 3: teddyKK (small blind) folded before Flop
Seat 4: SchuhaRt71 (big blind) folded before Flop
Seat 5: skems123 folded before Flop (didn't bet)
Seat 6: heicci folded before Flop (didn't bet)



PokerStars Hand #222972239352:  Hold'em No Limit ($0.05/$0.10 USD) - 2021/01/23 16:28:15 ET
Table 'Capricorn III' 6-max Seat #3 is the button
Seat 1: adilpoker84 ($14.21 in chips) 
Seat 2: azatik88 ($5.86 in chips) 
Seat 3: teddyKK ($17.18 in chips) 
Seat 4: SchuhaRt71 ($10.30 in chips) 
Seat 5: skems123 ($11.13 in chips) 
Seat 6: heicci ($9.79 in chips) 
SchuhaRt71: posts small blind $0.05
skems123: posts big blind $0.10
*** HOLE CARDS ***
heicci: folds 
adilpoker84: folds 
azatik88: folds 
teddyKK: raises $0.20 to $0.30
SchuhaRt71: folds 
skems123: folds 
Uncalled bet ($0.20) returned to teddyKK
teddyKK collected $0.25 from pot
teddyKK: doesn't show hand 
*** SUMMARY ***
Total pot $0.25 | Rake $0 
Seat 1: adilpoker84 folded before Flop (didn't bet)
Seat 2: azatik88 folded before Flop (didn't bet)
Seat 3: teddyKK (button) collected ($0.25)
Seat 4: SchuhaRt71 (small blind) folded before Flop
Seat 5: skems123 (big blind) folded before Flop
Seat 6: heicci folded before Flop (didn't bet)



PokerStars Hand #222972256540:  Hold'em No Limit ($0.05/$0.10 USD) - 2021/01/23 16:28:35 ET
Table 'Capricorn III' 6-max Seat #4 is the button
Seat 1: adilpoker84 ($14.21 in chips) 
Seat 2: azatik88 ($5.86 in chips) 
Seat 3: teddyKK ($17.33 in chips) 
Seat 4: SchuhaRt71 ($10.25 in chips) 
Seat 5: skems123 ($11.03 in chips) 
Seat 6: heicci ($9.79 in chips) 
skems123: posts small blind $0.05
heicci: posts big blind $0.10
*** HOLE CARDS ***
adilpoker84: raises $0.10 to $0.20
azatik88: folds 
teddyKK: folds 
SchuhaRt71: folds 
skems123: folds 
heicci: calls $0.10
*** FLOP *** [7d 2c 9h]
heicci: bets $0.30
adilpoker84: raises $0.30 to $0.60
heicci: calls $0.30
*** TURN *** [7d 2c 9h] [Ks]
heicci: checks 
adilpoker84: bets $0.79
heicci: raises $1.31 to $2.10
adilpoker84: calls $1.31
*** RIVER *** [7d 2c 9h Ks] [Ah]
heicci: bets $6.89 and is all-in
adilpoker84: calls $6.89
*** SHOW DOWN ***
heicci: shows [7s Qs] (a pair of Sevens)
adilpoker84: shows [9c 7c] (two pair, Nines and Sevens)
adilpoker84 collected $18.75 from pot
*** SUMMARY ***
Total pot $19.63 | Rake $0.88 
Board [7d 2c 9h Ks Ah]
Seat 1: adilpoker84 showed [9c 7c] and won ($18.75) with two pair, Nines and Sevens
Seat 2: azatik88 folded before Flop (didn't bet)
Seat 3: teddyKK folded before Flop (didn't bet)
Seat 4: SchuhaRt71 (button) folded before Flop (didn't bet)
Seat 5: skems123 (small blind) folded before Flop
Seat 6: heicci (big blind) showed [7s Qs] and lost with a pair of Sevens



PokerStars Hand #222972297570:  Hold'em No Limit ($0.05/$0.10 USD) - 2021/01/23 16:29:23 ET
Table 'Capricorn III' 6-max Seat #5 is the button
Seat 1: adilpoker84 ($23.17 in chips) 
Seat 2: azatik88 ($5.86 in chips) 
Seat 3: teddyKK ($17.33 in chips) 
Seat 4: SchuhaRt71 ($10.25 in chips) 
Seat 5: skems123 ($10.98 in chips) 
adilpoker84: posts small blind $0.05
azatik88: posts big blind $0.10
*** HOLE CARDS ***
heicci leaves the table
teddyKK: folds 
SchuhaRt71: folds 
skems123: folds 
adilpoker84: calls $0.05
azatik88: raises $0.20 to $0.30
adilpoker84: folds 
Uncalled bet ($0.20) returned to azatik88
azatik88 collected $0.20 from pot
*** SUMMARY ***
Total pot $0.20 | Rake $0 
Seat 1: adilpoker84 (small blind) folded before Flop
Seat 2: azatik88 (big blind) collected ($0.20)
Seat 3: teddyKK folded before Flop (didn't bet)
Seat 4: SchuhaRt71 folded before Flop (didn't bet)
Seat 5: skems123 (button) folded before Flop (didn't bet)



PokerStars Hand #222972314119:  Hold'em No Limit ($0.05/$0.10 USD) - 2021/01/23 16:29:43 ET
Table 'Capricorn III' 6-max Seat #1 is the button
Seat 1: adilpoker84 ($23.07 in chips) 
Seat 2: azatik88 ($5.96 in chips) 
Seat 3: teddyKK ($17.33 in chips) 
Seat 4: SchuhaRt71 ($10.25 in chips) 
Seat 5: skems123 ($10.98 in chips) 
azatik88: posts small blind $0.05
teddyKK: posts big blind $0.10
*** HOLE CARDS ***
SchuhaRt71: folds 
skems123: folds 
adilpoker84: folds 
azatik88: raises $0.30 to $0.40
teddyKK: folds 
Uncalled bet ($0.30) returned to azatik88
azatik88 collected $0.20 from pot
*** SUMMARY ***
Total pot $0.20 | Rake $0 
Seat 1: adilpoker84 (button) folded before Flop (didn't bet)
Seat 2: azatik88 (small blind) collected ($0.20)
Seat 3: teddyKK (big blind) folded before Flop
Seat 4: SchuhaRt71 folded before Flop (didn't bet)
Seat 5: skems123 folded before Flop (didn't bet)



PokerStars Hand #222972326184:  Hold'em No Limit ($0.05/$0.10 USD) - 2021/01/23 16:29:57 ET
Table 'Capricorn III' 6-max Seat #2 is the button
Seat 1: adilpoker84 ($23.07 in chips) 
Seat 2: azatik88 ($6.06 in chips) 
Seat 3: teddyKK ($17.23 in chips) 
Seat 4: SchuhaRt71 ($10.25 in chips) 
Seat 5: skems123 ($10.98 in chips) 
teddyKK: posts small blind $0.05
SchuhaRt71: posts big blind $0.10
*** HOLE CARDS ***
skems123: folds 
adilpoker84: folds 
azatik88: raises $0.30 to $0.40
teddyKK: calls $0.35
SchuhaRt71: folds 
*** FLOP *** [4h Jd Kd]
teddyKK: checks 
azatik88: bets $0.43
teddyKK: folds 
Uncalled bet ($0.43) returned to azatik88
azatik88 collected $0.86 from pot
azatik88: doesn't show hand 
*** SUMMARY ***
Total pot $0.90 | Rake $0.04 
Board [4h Jd Kd]
Seat 1: adilpoker84 folded before Flop (didn't bet)
Seat 2: azatik88 (button) collected ($0.86)
Seat 3: teddyKK (small blind) folded on the Flop
Seat 4: SchuhaRt71 (big blind) folded before Flop
Seat 5: skems123 folded before Flop (didn't bet)



PokerStars Hand #222972354000:  Hold'em No Limit ($0.05/$0.10 USD) - 2021/01/23 16:30:29 ET
Table 'Capricorn III' 6-max Seat #3 is the button
Seat 1: adilpoker84 ($23.07 in chips) 
Seat 2: azatik88 ($6.52 in chips) 
Seat 3: teddyKK ($16.83 in chips) 
Seat 4: SchuhaRt71 ($10.15 in chips) 
SchuhaRt71: posts small blind $0.05
skems123: is sitting out 
adilpoker84: posts big blind $0.10
*** HOLE CARDS ***
skems123 leaves the table
azatik88: calls $0.10
teddyKK: folds 
SchuhaRt71: raises $0.30 to $0.40
adilpoker84: folds 
azatik88: calls $0.30
*** FLOP *** [6c Ts 8d]
SchuhaRt71: bets $0.80
azatik88: folds 
Uncalled bet ($0.80) returned to SchuhaRt71
SchuhaRt71 collected $0.86 from pot
SchuhaRt71: doesn't show hand 
*** SUMMARY ***
Total pot $0.90 | Rake $0.04 
Board [6c Ts 8d]
Seat 1: adilpoker84 (big blind) folded before Flop
Seat 2: azatik88 folded on the Flop
Seat 3: teddyKK (button) folded before Flop (didn't bet)
Seat 4: SchuhaRt71 (small blind) collected ($0.86)



PokerStars Hand #222972386185:  Hold'em No Limit ($0.05/$0.10 USD) - 2021/01/23 16:31:02 ET
Table 'Capricorn III' 6-max Seat #4 is the button
Seat 1: adilpoker84 ($22.97 in chips) 
Seat 2: azatik88 ($6.12 in chips) 
Seat 3: teddyKK ($16.83 in chips) 
Seat 4: SchuhaRt71 ($10.61 in chips) 
adilpoker84: posts small blind $0.05
azatik88: posts big blind $0.10
*** HOLE CARDS ***
teddyKK: folds 
SchuhaRt71: raises $0.15 to $0.25
adilpoker84: raises $0.25 to $0.50
azatik88: folds 
SchuhaRt71: calls $0.25
*** FLOP *** [3s 2d 4c]
adilpoker84: bets $0.53
Gissbon joins the table at seat #5 
SchuhaRt71: raises $0.82 to $1.35
adilpoker84: raises $2.15 to $3.50
SchuhaRt71: raises $6.61 to $10.11 and is all-in
adilpoker84: calls $6.61
*** TURN *** [3s 2d 4c] [6s]
*** RIVER *** [3s 2d 4c 6s] [Qh]
*** SHOW DOWN ***
adilpoker84: shows [Ad As] (a pair of Aces)
SchuhaRt71: shows [2s 2h] (three of a kind, Deuces)
SchuhaRt71 collected $20.36 from pot
adilpoker84 cashed out the hand for $4.22 | Cash Out Fee $0.04
*** SUMMARY ***
Total pot $21.32 | Rake $0.96 
Board [3s 2d 4c 6s Qh]
Seat 1: adilpoker84 (small blind) showed [Ad As] and lost with a pair of Aces (cashed out).
Seat 2: azatik88 (big blind) folded before Flop
Seat 3: teddyKK folded before Flop (didn't bet)
Seat 4: SchuhaRt71 (button) showed [2s 2h] and won ($20.36) with three of a kind, Deuces



PokerStars Hand #222972426783:  Hold'em No Limit ($0.05/$0.10 USD) - 2021/01/23 16:31:50 ET
Table 'Capricorn III' 6-max Seat #1 is the button
Seat 1: adilpoker84 ($16.58 in chips) 
Seat 2: azatik88 ($6.02 in chips) 
Seat 3: teddyKK ($16.83 in chips) 
Seat 4: SchuhaRt71 ($20.36 in chips) 
azatik88: posts small blind $0.05
teddyKK: posts big blind $0.10
Gissbon: sits out 
*** HOLE CARDS ***
SchuhaRt71: folds 
adilpoker84: raises $0.10 to $0.20
azatik88: calls $0.15
teddyKK: folds 
*** FLOP *** [4c Ks 9h]
azatik88: checks 
adilpoker84: bets $0.20
azatik88: calls $0.20
*** TURN *** [4c Ks 9h] [Kc]
azatik88: checks 
adilpoker84: checks 
*** RIVER *** [4c Ks 9h Kc] [Qc]
azatik88: checks 
adilpoker84: checks 
*** SHOW DOWN ***
azatik88: shows [As 6s] (a pair of Kings)
adilpoker84: shows [Ad 4d] (two pair, Kings and Fours)
adilpoker84 collected $0.86 from pot
*** SUMMARY ***
Total pot $0.90 | Rake $0.04 
Board [4c Ks 9h Kc Qc]
Seat 1: adilpoker84 (button) showed [Ad 4d] and won ($0.86) with two pair, Kings and Fours
Seat 2: azatik88 (small blind) showed [As 6s] and lost with a pair of Kings
Seat 3: teddyKK (big blind) folded before Flop
Seat 4: SchuhaRt71 folded before Flop (didn't bet)



PokerStars Hand #222972465244:  Hold'em No Limit ($0.05/$0.10 USD) - 2021/01/23 16:32:35 ET
Table 'Capricorn III' 6-max Seat #2 is the button
Seat 1: adilpoker84 ($17.04 in chips) 
Seat 2: azatik88 ($5.62 in chips) 
Seat 3: teddyKK ($16.73 in chips) 
Seat 4: SchuhaRt71 ($20.36 in chips) 
teddyKK: posts small blind $0.05
SchuhaRt71: posts big blind $0.10
Gissbon: sits out 
*** HOLE CARDS ***
adilpoker84: calls $0.10
azatik88: raises $0.35 to $0.45
teddyKK: folds 
SchuhaRt71: folds 
adilpoker84: calls $0.35
*** FLOP *** [Jh 5s Qd]
adilpoker84: checks 
azatik88: bets $0.70
adilpoker84: calls $0.70
*** TURN *** [Jh 5s Qd] [7h]
adilpoker84: checks 
azatik88: bets $1.10
adilpoker84: calls $1.10
*** RIVER *** [Jh 5s Qd 7h] [4h]
adilpoker84: checks 
azatik88: checks 
*** SHOW DOWN ***
adilpoker84: shows [Qs Tc] (a pair of Queens)
azatik88: mucks hand 
adilpoker84 collected $4.44 from pot
*** SUMMARY ***
Total pot $4.65 | Rake $0.21 
Board [Jh 5s Qd 7h 4h]
Seat 1: adilpoker84 showed [Qs Tc] and won ($4.44) with a pair of Queens
Seat 2: azatik88 (button) mucked
Seat 3: teddyKK (small blind) folded before Flop
Seat 4: SchuhaRt71 (big blind) folded before Flop



PokerStars Hand #222972516862:  Hold'em No Limit ($0.05/$0.10 USD) - 2021/01/23 16:33:37 ET
Table 'Capricorn III' 6-max Seat #3 is the button
Seat 1: adilpoker84 ($19.23 in chips) 
Seat 2: azatik88 ($3.37 in chips) 
Seat 3: teddyKK ($16.68 in chips) 
Seat 4: SchuhaRt71 ($20.26 in chips) 
Seat 5: Gissbon ($10 in chips) 
SchuhaRt71: posts small blind $0.05
Gissbon: posts big blind $0.10
*** HOLE CARDS ***
adilpoker84: folds 
azatik88: calls $0.10
teddyKK: folds 
SchuhaRt71: folds 
Gissbon: checks 
*** FLOP *** [8d Qd 4d]
bros1987 joins the table at seat #6 
Gissbon: checks 
azatik88: bets $0.20
Gissbon: calls $0.20
*** TURN *** [8d Qd 4d] [6d]
Gissbon: checks 
azatik88: checks 
*** RIVER *** [8d Qd 4d 6d] [9c]
Gissbon: bets $0.25
azatik88: calls $0.25
*** SHOW DOWN ***
Gissbon: shows [Kd Qc] (a flush, King high)
azatik88: mucks hand 
Gissbon collected $1.10 from pot
*** SUMMARY ***
Total pot $1.15 | Rake $0.05 
Board [8d Qd 4d 6d 9c]
Seat 1: adilpoker84 folded before Flop (didn't bet)
Seat 2: azatik88 mucked
Seat 3: teddyKK (button) folded before Flop (didn't bet)
Seat 4: SchuhaRt71 (small blind) folded before Flop
Seat 5: Gissbon (big blind) showed [Kd Qc] and won ($1.10) with a flush, King high



PokerStars Hand #222972575673:  Hold'em No Limit ($0.05/$0.10 USD) - 2021/01/23 16:34:47 ET
Table 'Capricorn III' 6-max Seat #4 is the button
Seat 1: adilpoker84 ($19.23 in chips) 
Seat 2: azatik88 ($2.82 in chips) 
Seat 3: teddyKK ($16.68 in chips) 
Seat 4: SchuhaRt71 ($20.21 in chips) 
Seat 5: Gissbon ($10.55 in chips) 
Seat 6: bros1987 ($10 in chips) 
Gissbon: posts small blind $0.05
bros1987: posts big blind $0.10
*** HOLE CARDS ***
adilpoker84: raises $0.20 to $0.30
azatik88: folds 
teddyKK: folds 
SchuhaRt71: calls $0.30
Gissbon: folds 
bros1987: calls $0.20
*** FLOP *** [Ts 4c Th]
bros1987: checks 
adilpoker84: bets $0.40
SchuhaRt71: folds 
bros1987: calls $0.40
*** TURN *** [Ts 4c Th] [2h]
bros1987: checks 
adilpoker84: checks 
*** RIVER *** [Ts 4c Th 2h] [Jh]
bros1987: bets $1.20
adilpoker84: calls $1.20
*** SHOW DOWN ***
bros1987: shows [Td Jc] (a full house, Tens full of Jacks)
adilpoker84: mucks hand 
bros1987 collected $3.96 from pot
*** SUMMARY ***
Total pot $4.15 | Rake $0.19 
Board [Ts 4c Th 2h Jh]
Seat 1: adilpoker84 mucked
Seat 2: azatik88 folded before Flop (didn't bet)
Seat 3: teddyKK folded before Flop (didn't bet)
Seat 4: SchuhaRt71 (button) folded on the Flop
Seat 5: Gissbon (small blind) folded before Flop
Seat 6: bros1987 (big blind) showed [Td Jc] and won ($3.96) with a full house, Tens full of Jacks



PokerStars Hand #222972627187:  Hold'em No Limit ($0.05/$0.10 USD) - 2021/01/23 16:35:48 ET
Table 'Capricorn III' 6-max Seat #5 is the button
Seat 1: adilpoker84 ($17.33 in chips) 
Seat 2: azatik88 ($2.82 in chips) 
Seat 3: teddyKK ($16.68 in chips) 
Seat 4: SchuhaRt71 ($19.91 in chips) 
Seat 5: Gissbon ($10.50 in chips) 
Seat 6: bros1987 ($12.06 in chips) 
bros1987: posts small blind $0.05
adilpoker84: posts big blind $0.10
*** HOLE CARDS ***
azatik88: folds 
teddyKK: folds 
SchuhaRt71: folds 
Gissbon: folds 
bros1987: folds 
Uncalled bet ($0.05) returned to adilpoker84
adilpoker84 collected $0.10 from pot
adilpoker84: doesn't show hand 
*** SUMMARY ***
Total pot $0.10 | Rake $0 
Seat 1: adilpoker84 (big blind) collected ($0.10)
Seat 2: azatik88 folded before Flop (didn't bet)
Seat 3: teddyKK folded before Flop (didn't bet)
Seat 4: SchuhaRt71 folded before Flop (didn't bet)
Seat 5: Gissbon (button) folded before Flop (didn't bet)
Seat 6: bros1987 (small blind) folded before Flop



PokerStars Hand #222972641676:  Hold'em No Limit ($0.05/$0.10 USD) - 2021/01/23 16:36:05 ET
Table 'Capricorn III' 6-max Seat #6 is the button
Seat 1: adilpoker84 ($17.38 in chips) 
Seat 2: azatik88 ($2.82 in chips) 
Seat 3: teddyKK ($16.68 in chips) 
Seat 4: SchuhaRt71 ($19.91 in chips) 
Seat 5: Gissbon ($10.50 in chips) 
Seat 6: bros1987 ($12.01 in chips) 
adilpoker84: posts small blind $0.05
azatik88: posts big blind $0.10
*** HOLE CARDS ***
teddyKK: folds 
SchuhaRt71: folds 
Gissbon: folds 
bros1987: raises $0.16 to $0.26
adilpoker84: calls $0.21
azatik88: folds 
*** FLOP *** [6h 2s 5s]
adilpoker84: checks 
bros1987: bets $0.40
adilpoker84: calls $0.40
*** TURN *** [6h 2s 5s] [Jh]
adilpoker84: checks 
bros1987: checks 
*** RIVER *** [6h 2s 5s Jh] [3c]
adilpoker84: bets $0.60
bros1987: folds 
Uncalled bet ($0.60) returned to adilpoker84
adilpoker84 collected $1.36 from pot
adilpoker84: doesn't show hand 
*** SUMMARY ***
Total pot $1.42 | Rake $0.06 
Board [6h 2s 5s Jh 3c]
Seat 1: adilpoker84 (small blind) collected ($1.36)
Seat 2: azatik88 (big blind) folded before Flop
Seat 3: teddyKK folded before Flop (didn't bet)
Seat 4: SchuhaRt71 folded before Flop (didn't bet)
Seat 5: Gissbon folded before Flop (didn't bet)
Seat 6: bros1987 (button) folded on the River



PokerStars Hand #222972676648:  Hold'em No Limit ($0.05/$0.10 USD) - 2021/01/23 16:36:47 ET
Table 'Capricorn III' 6-max Seat #1 is the button
Seat 1: adilpoker84 ($18.08 in chips) 
Seat 2: azatik88 ($2.72 in chips) 
Seat 3: teddyKK ($16.68 in chips) 
Seat 4: SchuhaRt71 ($19.91 in chips) 
Seat 5: Gissbon ($10.50 in chips) 
Seat 6: bros1987 ($11.35 in chips) 
azatik88: posts small blind $0.05
teddyKK: posts big blind $0.10
*** HOLE CARDS ***
SchuhaRt71: folds 
Gissbon: folds 
bros1987: raises $0.20 to $0.30
adilpoker84: folds 
azatik88: calls $0.25
teddyKK: folds 
*** FLOP *** [7d 8h 9h]
azatik88: checks 
bros1987: bets $0.20
azatik88: raises $2.22 to $2.42 and is all-in
bros1987: calls $2.22
*** TURN *** [7d 8h 9h] [Ks]
*** RIVER *** [7d 8h 9h Ks] [5h]
*** SHOW DOWN ***
azatik88: shows [6h 7s] (a straight, Five to Nine)
bros1987: shows [Th Jh] (a flush, Jack high)
bros1987 collected $5.29 from pot
azatik88 cashed out the hand for $0.13
*** SUMMARY ***
Total pot $5.54 | Rake $0.25 
Board [7d 8h 9h Ks 5h]
Seat 1: adilpoker84 (button) folded before Flop (didn't bet)
Seat 2: azatik88 (small blind) showed [6h 7s] and lost with a straight, Five to Nine (cashed out).
Seat 3: teddyKK (big blind) folded before Flop
Seat 4: SchuhaRt71 folded before Flop (didn't bet)
Seat 5: Gissbon folded before Flop (didn't bet)
Seat 6: bros1987 showed [Th Jh] and won ($5.29) with a flush, Jack high



PokerStars Hand #222972709355:  Hold'em No Limit ($0.05/$0.10 USD) - 2021/01/23 16:37:26 ET
Table 'Capricorn III' 6-max Seat #2 is the button
Seat 1: adilpoker84 ($18.08 in chips) 
Seat 2: azatik88 ($0.13 in chips) 
Seat 3: teddyKK ($16.58 in chips) 
Seat 4: SchuhaRt71 ($19.91 in chips) 
Seat 5: Gissbon ($10.50 in chips) 
Seat 6: bros1987 ($13.92 in chips) 
teddyKK: posts small blind $0.05
SchuhaRt71: posts big blind $0.10
*** HOLE CARDS ***
Gissbon: folds 
bros1987: folds 
adilpoker84: calls $0.10
azatik88: raises $0.03 to $0.13 and is all-in
teddyKK: folds 
SchuhaRt71: folds 
adilpoker84: calls $0.03
*** FLOP *** [Js Kh Jh]
*** TURN *** [Js Kh Jh] [6d]
*** RIVER *** [Js Kh Jh 6d] [5s]
*** SHOW DOWN ***
adilpoker84: shows [9d Ks] (two pair, Kings and Jacks)
azatik88: shows [Ad Kc] (two pair, Kings and Jacks - Ace kicker)
azatik88 collected $0.39 from pot
adilpoker84 cashed out the hand for $0.10
*** SUMMARY ***
Total pot $0.41 | Rake $0.02 
Board [Js Kh Jh 6d 5s]
Seat 1: adilpoker84 showed [9d Ks] and lost with two pair, Kings and Jacks (cashed out).
Seat 2: azatik88 (button) showed [Ad Kc] and won ($0.39) with two pair, Kings and Jacks
Seat 3: teddyKK (small blind) folded before Flop
Seat 4: SchuhaRt71 (big blind) folded before Flop
Seat 5: Gissbon folded before Flop (didn't bet)
Seat 6: bros1987 folded before Flop (didn't bet)



PokerStars Hand #222972737830:  Hold'em No Limit ($0.05/$0.10 USD) - 2021/01/23 16:38:00 ET
Table 'Capricorn III' 6-max Seat #3 is the button
Seat 1: adilpoker84 ($18.05 in chips) 
Seat 2: azatik88 ($0.39 in chips) 
Seat 3: teddyKK ($16.53 in chips) 
Seat 4: SchuhaRt71 ($19.81 in chips) 
Seat 5: Gissbon ($10.50 in chips) 
Seat 6: bros1987 ($13.92 in chips) 
SchuhaRt71: posts small blind $0.05
Gissbon: posts big blind $0.10
*** HOLE CARDS ***
bros1987: folds 
adilpoker84: folds 
azatik88: raises $0.29 to $0.39 and is all-in
teddyKK: folds 
SchuhaRt71: folds 
Gissbon: calls $0.29
*** FLOP *** [5d Kc Jd]
*** TURN *** [5d Kc Jd] [8c]
*** RIVER *** [5d Kc Jd 8c] [4c]
*** SHOW DOWN ***
Gissbon: shows [4h 3d] (a pair of Fours)
azatik88: shows [Qh 8s] (a pair of Eights)
azatik88 collected $0.79 from pot
*** SUMMARY ***
Total pot $0.83 | Rake $0.04 
Board [5d Kc Jd 8c 4c]
Seat 1: adilpoker84 folded before Flop (didn't bet)
Seat 2: azatik88 showed [Qh 8s] and won ($0.79) with a pair of Eights
Seat 3: teddyKK (button) folded before Flop (didn't bet)
Seat 4: SchuhaRt71 (small blind) folded before Flop
Seat 5: Gissbon (big blind) showed [4h 3d] and lost with a pair of Fours
Seat 6: bros1987 folded before Flop (didn't bet)



PokerStars Hand #222972763303:  Hold'em No Limit ($0.05/$0.10 USD) - 2021/01/23 16:38:31 ET
Table 'Capricorn III' 6-max Seat #4 is the button
Seat 1: adilpoker84 ($18.05 in chips) 
Seat 2: azatik88 ($0.79 in chips) 
Seat 3: teddyKK ($16.53 in chips) 
Seat 4: SchuhaRt71 ($19.76 in chips) 
Seat 5: Gissbon ($10.11 in chips) 
Seat 6: bros1987 ($13.92 in chips) 
Gissbon: posts small blind $0.05
bros1987: posts big blind $0.10
*** HOLE CARDS ***
adilpoker84: folds 
azatik88: raises $0.69 to $0.79 and is all-in
teddyKK: folds 
SchuhaRt71: calls $0.79
Gissbon: folds 
bros1987: folds 
*** FLOP *** [Js Td Qs]
*** TURN *** [Js Td Qs] [6s]
*** RIVER *** [Js Td Qs 6s] [Kd]
*** SHOW DOWN ***
azatik88: shows [Ad 9d] (a straight, Ten to Ace)
SchuhaRt71: shows [Ks Qd] (two pair, Kings and Queens)
azatik88 collected $1.65 from pot
*** SUMMARY ***
Total pot $1.73 | Rake $0.08 
Board [Js Td Qs 6s Kd]
Seat 1: adilpoker84 folded before Flop (didn't bet)
Seat 2: azatik88 showed [Ad 9d] and won ($1.65) with a straight, Ten to Ace
Seat 3: teddyKK folded before Flop (didn't bet)
Seat 4: SchuhaRt71 (button) showed [Ks Qd] and lost with two pair, Kings and Queens
Seat 5: Gissbon (small blind) folded before Flop
Seat 6: bros1987 (big blind) folded before Flop



PokerStars Hand #222972784136:  Hold'em No Limit ($0.05/$0.10 USD) - 2021/01/23 16:38:56 ET
Table 'Capricorn III' 6-max Seat #5 is the button
Seat 1: adilpoker84 ($18.05 in chips) 
Seat 2: azatik88 ($1.65 in chips) 
Seat 3: teddyKK ($16.53 in chips) 
Seat 4: SchuhaRt71 ($18.97 in chips) 
Seat 5: Gissbon ($10.06 in chips) 
Seat 6: bros1987 ($13.82 in chips) 
bros1987: posts small blind $0.05
adilpoker84: posts big blind $0.10
*** HOLE CARDS ***
azatik88: folds 
teddyKK: folds 
SchuhaRt71: raises $0.20 to $0.30
Gissbon: folds 
bros1987: folds 
adilpoker84: calls $0.20
*** FLOP *** [4d Qd 2c]
adilpoker84: checks 
SchuhaRt71: checks 
*** TURN *** [4d Qd 2c] [4s]
adilpoker84: bets $0.20
SchuhaRt71: folds 
Uncalled bet ($0.20) returned to adilpoker84
adilpoker84 collected $0.62 from pot
adilpoker84: doesn't show hand 
*** SUMMARY ***
Total pot $0.65 | Rake $0.03 
Board [4d Qd 2c 4s]
Seat 1: adilpoker84 (big blind) collected ($0.62)
Seat 2: azatik88 folded before Flop (didn't bet)
Seat 3: teddyKK folded before Flop (didn't bet)
Seat 4: SchuhaRt71 folded on the Turn
Seat 5: Gissbon (button) folded before Flop (didn't bet)
Seat 6: bros1987 (small blind) folded before Flop



PokerStars Hand #222972813502:  Hold'em No Limit ($0.05/$0.10 USD) - 2021/01/23 16:39:31 ET
Table 'Capricorn III' 6-max Seat #6 is the button
Seat 1: adilpoker84 ($18.37 in chips) 
Seat 2: azatik88 ($1.65 in chips) 
Seat 3: teddyKK ($16.53 in chips) 
Seat 4: SchuhaRt71 ($18.67 in chips) 
Seat 5: Gissbon ($10.06 in chips) 
Seat 6: bros1987 ($13.77 in chips) 
adilpoker84: posts small blind $0.05
azatik88: posts big blind $0.10
*** HOLE CARDS ***
teddyKK: folds 
SchuhaRt71: folds 
Gissbon: folds 
bros1987: folds 
adilpoker84: calls $0.05
azatik88: raises $1.55 to $1.65 and is all-in
adilpoker84: folds 
Uncalled bet ($1.55) returned to azatik88
azatik88 collected $0.20 from pot
*** SUMMARY ***
Total pot $0.20 | Rake $0 
Seat 1: adilpoker84 (small blind) folded before Flop
Seat 2: azatik88 (big blind) collected ($0.20)
Seat 3: teddyKK folded before Flop (didn't bet)
Seat 4: SchuhaRt71 folded before Flop (didn't bet)
Seat 5: Gissbon folded before Flop (didn't bet)
Seat 6: bros1987 (button) folded before Flop (didn't bet)



PokerStars Hand #222972840638:  Hold'em No Limit ($0.05/$0.10 USD) - 2021/01/23 16:39:52 ET
Table 'Capricorn III' 6-max Seat #1 is the button
Seat 1: adilpoker84 ($18.27 in chips) 
Seat 2: azatik88 ($1.75 in chips) 
Seat 3: teddyKK ($16.53 in chips) 
Seat 4: SchuhaRt71 ($18.67 in chips) 
Seat 5: Gissbon ($10.06 in chips) 
Seat 6: bros1987 ($13.77 in chips) 
azatik88: posts small blind $0.05
teddyKK: posts big blind $0.10
*** HOLE CARDS ***
SchuhaRt71: folds 
Gissbon: folds 
bros1987: folds 
adilpoker84: folds 
azatik88: calls $0.05
teddyKK: checks 
*** FLOP *** [Kh 3h Ad]
azatik88: checks 
teddyKK: checks 
*** TURN *** [Kh 3h Ad] [4h]
azatik88: bets $0.10
teddyKK: folds 
Uncalled bet ($0.10) returned to azatik88
azatik88 collected $0.19 from pot
*** SUMMARY ***
Total pot $0.20 | Rake $0.01 
Board [Kh 3h Ad 4h]
Seat 1: adilpoker84 (button) folded before Flop (didn't bet)
Seat 2: azatik88 (small blind) collected ($0.19)
Seat 3: teddyKK (big blind) folded on the Turn
Seat 4: SchuhaRt71 folded before Flop (didn't bet)
Seat 5: Gissbon folded before Flop (didn't bet)
Seat 6: bros1987 folded before Flop (didn't bet)



PokerStars Hand #222972871560:  Hold'em No Limit ($0.05/$0.10 USD) - 2021/01/23 16:40:29 ET
Table 'Capricorn III' 6-max Seat #2 is the button
Seat 1: adilpoker84 ($18.27 in chips) 
Seat 2: azatik88 ($1.84 in chips) 
Seat 3: teddyKK ($16.43 in chips) 
Seat 4: SchuhaRt71 ($18.67 in chips) 
Seat 5: Gissbon ($10.06 in chips) 
Seat 6: bros1987 ($13.77 in chips) 
teddyKK: posts small blind $0.05
SchuhaRt71: posts big blind $0.10
*** HOLE CARDS ***
Gissbon: folds 
bros1987: folds 
adilpoker84: folds 
azatik88: folds 
teddyKK: folds 
Uncalled bet ($0.05) returned to SchuhaRt71
SchuhaRt71 collected $0.10 from pot
SchuhaRt71: doesn't show hand 
*** SUMMARY ***
Total pot $0.10 | Rake $0 
Seat 1: adilpoker84 folded before Flop (didn't bet)
Seat 2: azatik88 (button) folded before Flop (didn't bet)
Seat 3: teddyKK (small blind) folded before Flop
Seat 4: SchuhaRt71 (big blind) collected ($0.10)
Seat 5: Gissbon folded before Flop (didn't bet)
Seat 6: bros1987 folded before Flop (didn't bet)



PokerStars Hand #222972877837:  Hold'em No Limit ($0.05/$0.10 USD) - 2021/01/23 16:40:37 ET
Table 'Capricorn III' 6-max Seat #3 is the button
Seat 1: adilpoker84 ($18.27 in chips) 
Seat 2: azatik88 ($1.84 in chips) 
Seat 3: teddyKK ($16.38 in chips) 
Seat 4: SchuhaRt71 ($18.72 in chips) 
Seat 5: Gissbon ($10.06 in chips) 
Seat 6: bros1987 ($13.77 in chips) 
SchuhaRt71: posts small blind $0.05
Gissbon: posts big blind $0.10
*** HOLE CARDS ***
bros1987: folds 
adilpoker84: raises $0.10 to $0.20
azatik88: folds 
teddyKK: raises $0.50 to $0.70
SchuhaRt71: calls $0.65
Gissbon: folds 
adilpoker84: calls $0.50
*** FLOP *** [3s 2d Jh]
SchuhaRt71: checks 
adilpoker84: checks 
teddyKK: bets $0.90
SchuhaRt71: calls $0.90
adilpoker84: folds 
*** TURN *** [3s 2d Jh] [Qh]
SchuhaRt71: checks 
teddyKK: bets $1.70
SchuhaRt71: folds 
Uncalled bet ($1.70) returned to teddyKK
teddyKK collected $3.82 from pot
teddyKK: doesn't show hand 
*** SUMMARY ***
Total pot $4 | Rake $0.18 
Board [3s 2d Jh Qh]
Seat 1: adilpoker84 folded on the Flop
Seat 2: azatik88 folded before Flop (didn't bet)
Seat 3: teddyKK (button) collected ($3.82)
Seat 4: SchuhaRt71 (small blind) folded on the Turn
Seat 5: Gissbon (big blind) folded before Flop
Seat 6: bros1987 folded before Flop (didn't bet)



PokerStars Hand #222972945647:  Hold'em No Limit ($0.05/$0.10 USD) - 2021/01/23 16:41:59 ET
Table 'Capricorn III' 6-max Seat #4 is the button
Seat 1: adilpoker84 ($17.57 in chips) 
Seat 2: azatik88 ($1.84 in chips) 
Seat 3: teddyKK ($18.60 in chips) 
Seat 4: SchuhaRt71 ($17.12 in chips) 
Seat 5: Gissbon ($10 in chips) 
Seat 6: bros1987 ($13.77 in chips) 
Gissbon: posts small blind $0.05
bros1987: posts big blind $0.10
*** HOLE CARDS ***
adilpoker84: folds 
azatik88: calls $0.10
teddyKK: folds 
SchuhaRt71: folds 
Gissbon: raises $0.30 to $0.40
bros1987: folds 
azatik88: folds 
Uncalled bet ($0.30) returned to Gissbon
Gissbon collected $0.30 from pot
Gissbon: doesn't show hand 
*** SUMMARY ***
Total pot $0.30 | Rake $0 
Seat 1: adilpoker84 folded before Flop (didn't bet)
Seat 2: azatik88 folded before Flop
Seat 3: teddyKK folded before Flop (didn't bet)
Seat 4: SchuhaRt71 (button) folded before Flop (didn't bet)
Seat 5: Gissbon (small blind) collected ($0.30)
Seat 6: bros1987 (big blind) folded before Flop



PokerStars Hand #222972963186:  Hold'em No Limit ($0.05/$0.10 USD) - 2021/01/23 16:42:21 ET
Table 'Capricorn III' 6-max Seat #5 is the button
Seat 1: adilpoker84 ($17.57 in chips) 
Seat 2: azatik88 ($1.74 in chips) 
Seat 3: teddyKK ($18.60 in chips) 
Seat 4: SchuhaRt71 ($17.12 in chips) 
Seat 5: Gissbon ($10.20 in chips) 
Seat 6: bros1987 ($13.67 in chips) 
bros1987: posts small blind $0.05
adilpoker84: posts big blind $0.10
*** HOLE CARDS ***
azatik88: raises $1.64 to $1.74 and is all-in
teddyKK: folds 
SchuhaRt71: folds 
Gissbon: folds 
bros1987: folds 
adilpoker84: folds 
Uncalled bet ($1.64) returned to azatik88
azatik88 collected $0.25 from pot
*** SUMMARY ***
Total pot $0.25 | Rake $0 
Seat 1: adilpoker84 (big blind) folded before Flop
Seat 2: azatik88 collected ($0.25)
Seat 3: teddyKK folded before Flop (didn't bet)
Seat 4: SchuhaRt71 folded before Flop (didn't bet)
Seat 5: Gissbon (button) folded before Flop (didn't bet)
Seat 6: bros1987 (small blind) folded before Flop



PokerStars Hand #222972983079:  Hold'em No Limit ($0.05/$0.10 USD) - 2021/01/23 16:42:45 ET
Table 'Capricorn III' 6-max Seat #6 is the button
Seat 1: adilpoker84 ($17.47 in chips) 
Seat 2: azatik88 ($1.89 in chips) 
Seat 3: teddyKK ($18.60 in chips) 
Seat 4: SchuhaRt71 ($17.12 in chips) 
Seat 5: Gissbon ($10.20 in chips) 
Seat 6: bros1987 ($13.62 in chips) 
adilpoker84: posts small blind $0.05
azatik88: posts big blind $0.10
*** HOLE CARDS ***
teddyKK: folds 
SchuhaRt71: raises $0.20 to $0.30
Gissbon: folds 
bros1987: folds 
adilpoker84: calls $0.25
azatik88: folds 
*** FLOP *** [Td Th 3c]
adilpoker84: checks 
SchuhaRt71: checks 
*** TURN *** [Td Th 3c] [Qc]
adilpoker84: bets $0.30
SchuhaRt71: folds 
Uncalled bet ($0.30) returned to adilpoker84
adilpoker84 collected $0.67 from pot
adilpoker84: doesn't show hand 
*** SUMMARY ***
Total pot $0.70 | Rake $0.03 
Board [Td Th 3c Qc]
Seat 1: adilpoker84 (small blind) collected ($0.67)
Seat 2: azatik88 (big blind) folded before Flop
Seat 3: teddyKK folded before Flop (didn't bet)
Seat 4: SchuhaRt71 folded on the Turn
Seat 5: Gissbon folded before Flop (didn't bet)
Seat 6: bros1987 (button) folded before Flop (didn't bet)



PokerStars Hand #222973373841:  Hold'em No Limit ($0.05/$0.10 USD) - 2021/01/23 16:50:35 ET
Table 'Capricorn III' 6-max Seat #6 is the button
Seat 1: adilpoker84 ($17.10 in chips) 
Seat 2: rubduckofdeath ($10 in chips) 
Seat 3: teddyKK ($20.96 in chips) 
Seat 5: Gissbon ($10.32 in chips) 
Seat 6: bros1987 ($12.57 in chips) 
adilpoker84: posts small blind $0.05
rubduckofdeath: posts big blind $0.10
*** HOLE CARDS ***
teddyKK: folds 
Gissbon: folds 
bros1987: folds 
adilpoker84: calls $0.05
rubduckofdeath: checks 
*** FLOP *** [6h 5d 4s]
adilpoker84: bets $0.10
rubduckofdeath: calls $0.10
*** TURN *** [6h 5d 4s] [7h]
adilpoker84: checks 
rubduckofdeath: checks 
*** RIVER *** [6h 5d 4s 7h] [Kd]
adilpoker84: checks 
rubduckofdeath: checks 
*** SHOW DOWN ***
adilpoker84: shows [Ts 3s] (a straight, Three to Seven)
rubduckofdeath: shows [5c 3d] (a straight, Three to Seven)
adilpoker84 collected $0.19 from pot
rubduckofdeath collected $0.19 from pot
*** SUMMARY ***
Total pot $0.40 | Rake $0.02 
Board [6h 5d 4s 7h Kd]
Seat 1: adilpoker84 (small blind) showed [Ts 3s] and won ($0.19) with a straight, Three to Seven
Seat 2: rubduckofdeath (big blind) showed [5c 3d] and won ($0.19) with a straight, Three to Seven
Seat 3: teddyKK folded before Flop (didn't bet)
Seat 5: Gissbon folded before Flop (didn't bet)
Seat 6: bros1987 (button) folded before Flop (didn't bet)



PokerStars Hand #222973400564:  Hold'em No Limit ($0.05/$0.10 USD) - 2021/01/23 16:51:07 ET
Table 'Capricorn III' 6-max Seat #1 is the button
Seat 1: adilpoker84 ($17.09 in chips) 
Seat 2: rubduckofdeath ($10 in chips) 
Seat 3: teddyKK ($20.96 in chips) 
Seat 5: Gissbon ($10.32 in chips) 
Seat 6: bros1987 ($12.57 in chips) 
rubduckofdeath: posts small blind $0.05
teddyKK: posts big blind $0.10
*** HOLE CARDS ***
Gissbon: folds 
bros1987: raises $0.16 to $0.26
adilpoker84: folds 
rubduckofdeath: folds 
teddyKK: folds 
Uncalled bet ($0.16) returned to bros1987
bros1987 collected $0.25 from pot
bros1987: doesn't show hand 
*** SUMMARY ***
Total pot $0.25 | Rake $0 
Seat 1: adilpoker84 (button) folded before Flop (didn't bet)
Seat 2: rubduckofdeath (small blind) folded before Flop
Seat 3: teddyKK (big blind) folded before Flop
Seat 5: Gissbon folded before Flop (didn't bet)
Seat 6: bros1987 collected ($0.25)



PokerStars Hand #222973422189:  Hold'em No Limit ($0.05/$0.10 USD) - 2021/01/23 16:51:32 ET
Table 'Capricorn III' 6-max Seat #2 is the button
Seat 1: adilpoker84 ($17.09 in chips) 
Seat 2: rubduckofdeath ($10 in chips) 
Seat 3: teddyKK ($20.86 in chips) 
Seat 5: Gissbon ($10.32 in chips) 
Seat 6: bros1987 ($12.72 in chips) 
teddyKK: posts small blind $0.05
Gissbon: posts big blind $0.10
*** HOLE CARDS ***
bros1987: raises $0.20 to $0.30
adilpoker84: folds 
rubduckofdeath: folds 
teddyKK: calls $0.25
Gissbon: folds 
*** FLOP *** [Qd 2d 4d]
teddyKK: checks 
bros1987: bets $0.30
teddyKK: calls $0.30
*** TURN *** [Qd 2d 4d] [Qc]
teddyKK: checks 
bros1987: checks 
*** RIVER *** [Qd 2d 4d Qc] [6h]
teddyKK: checks 
bros1987: checks 
*** SHOW DOWN ***
teddyKK: shows [Ah Qh] (three of a kind, Queens)
bros1987: mucks hand 
teddyKK collected $1.24 from pot
*** SUMMARY ***
Total pot $1.30 | Rake $0.06 
Board [Qd 2d 4d Qc 6h]
Seat 1: adilpoker84 folded before Flop (didn't bet)
Seat 2: rubduckofdeath (button) folded before Flop (didn't bet)
Seat 3: teddyKK (small blind) showed [Ah Qh] and won ($1.24) with three of a kind, Queens
Seat 5: Gissbon (big blind) folded before Flop
Seat 6: bros1987 mucked



PokerStars Hand #222973473444:  Hold'em No Limit ($0.05/$0.10 USD) - 2021/01/23 16:52:34 ET
Table 'Capricorn III' 6-max Seat #3 is the button
Seat 1: adilpoker84 ($17.09 in chips) 
Seat 2: rubduckofdeath ($10 in chips) 
Seat 3: teddyKK ($21.50 in chips) 
Seat 5: Gissbon ($10.22 in chips) 
Seat 6: bros1987 ($12.12 in chips) 
Gissbon: posts small blind $0.05
bros1987: posts big blind $0.10
*** HOLE CARDS ***
adilpoker84: calls $0.10
rubduckofdeath: raises $0.35 to $0.45
teddyKK: folds 
Gissbon: folds 
bros1987: folds 
adilpoker84: calls $0.35
*** FLOP *** [4h 9c Ts]
adilpoker84: checks 
rubduckofdeath: bets $0.50
adilpoker84: calls $0.50
*** TURN *** [4h 9c Ts] [8d]
adilpoker84: checks 
rubduckofdeath: checks 
*** RIVER *** [4h 9c Ts 8d] [7c]
adilpoker84: bets $0.50
rubduckofdeath: folds 
Uncalled bet ($0.50) returned to adilpoker84
adilpoker84 collected $1.96 from pot
adilpoker84: doesn't show hand 
*** SUMMARY ***
Total pot $2.05 | Rake $0.09 
Board [4h 9c Ts 8d 7c]
Seat 1: adilpoker84 collected ($1.96)
Seat 2: rubduckofdeath folded on the River
Seat 3: teddyKK (button) folded before Flop (didn't bet)
Seat 5: Gissbon (small blind) folded before Flop
Seat 6: bros1987 (big blind) folded before Flop



PokerStars Hand #222973510673:  Hold'em No Limit ($0.05/$0.10 USD) - 2021/01/23 16:53:18 ET
Table 'Capricorn III' 6-max Seat #5 is the button
Seat 1: adilpoker84 ($18.10 in chips) 
Seat 2: rubduckofdeath ($10 in chips) 
Seat 3: teddyKK ($21.50 in chips) 
Seat 5: Gissbon ($10.17 in chips) 
Seat 6: bros1987 ($12.02 in chips) 
bros1987: posts small blind $0.05
adilpoker84: posts big blind $0.10
SchuhaRt71: sits out 
*** HOLE CARDS ***
rubduckofdeath: folds 
teddyKK: folds 
Gissbon: folds 
bros1987: folds 
Uncalled bet ($0.05) returned to adilpoker84
adilpoker84 collected $0.10 from pot
adilpoker84: doesn't show hand 
*** SUMMARY ***
Total pot $0.10 | Rake $0 
Seat 1: adilpoker84 (big blind) collected ($0.10)
Seat 2: rubduckofdeath folded before Flop (didn't bet)
Seat 3: teddyKK folded before Flop (didn't bet)
Seat 5: Gissbon (button) folded before Flop (didn't bet)
Seat 6: bros1987 (small blind) folded before Flop



PokerStars Hand #222973521354:  Hold'em No Limit ($0.05/$0.10 USD) - 2021/01/23 16:53:31 ET
Table 'Capricorn III' 6-max Seat #6 is the button
Seat 1: adilpoker84 ($18.15 in chips) 
Seat 2: rubduckofdeath ($10 in chips) 
Seat 3: teddyKK ($21.50 in chips) 
Seat 5: Gissbon ($10.17 in chips) 
Seat 6: bros1987 ($11.97 in chips) 
adilpoker84: posts small blind $0.05
rubduckofdeath: posts big blind $0.10
SchuhaRt71: sits out 
*** HOLE CARDS ***
teddyKK: folds 
Gissbon: folds 
bros1987: folds 
adilpoker84: calls $0.05
rubduckofdeath: checks 
*** FLOP *** [6c 6s Ah]
adilpoker84: checks 
rubduckofdeath: checks 
*** TURN *** [6c 6s Ah] [4h]
adilpoker84: bets $0.10
rubduckofdeath: folds 
Uncalled bet ($0.10) returned to adilpoker84
adilpoker84 collected $0.19 from pot
adilpoker84: doesn't show hand 
*** SUMMARY ***
Total pot $0.20 | Rake $0.01 
Board [6c 6s Ah 4h]
Seat 1: adilpoker84 (small blind) collected ($0.19)
Seat 2: rubduckofdeath (big blind) folded on the Turn
Seat 3: teddyKK folded before Flop (didn't bet)
Seat 5: Gissbon folded before Flop (didn't bet)
Seat 6: bros1987 (button) folded before Flop (didn't bet)



PokerStars Hand #222973544946:  Hold'em No Limit ($0.05/$0.10 USD) - 2021/01/23 16:53:59 ET
Table 'Capricorn III' 6-max Seat #1 is the button
Seat 1: adilpoker84 ($18.24 in chips) 
Seat 2: rubduckofdeath ($10 in chips) 
Seat 3: teddyKK ($21.50 in chips) 
Seat 5: Gissbon ($10.17 in chips) 
Seat 6: bros1987 ($11.97 in chips) 
rubduckofdeath: posts small blind $0.05
teddyKK: posts big blind $0.10
SchuhaRt71: sits out 
*** HOLE CARDS ***
Gissbon: folds 
bros1987: folds 
adilpoker84: calls $0.10
rubduckofdeath: folds 
teddyKK: checks 
*** FLOP *** [9c 2h 8c]
teddyKK: checks 
adilpoker84: bets $0.10
teddyKK: folds 
Uncalled bet ($0.10) returned to adilpoker84
adilpoker84 collected $0.24 from pot
adilpoker84: doesn't show hand 
*** SUMMARY ***
Total pot $0.25 | Rake $0.01 
Board [9c 2h 8c]
Seat 1: adilpoker84 (button) collected ($0.24)
Seat 2: rubduckofdeath (small blind) folded before Flop
Seat 3: teddyKK (big blind) folded on the Flop
Seat 5: Gissbon folded before Flop (didn't bet)
Seat 6: bros1987 folded before Flop (didn't bet)



PokerStars Hand #222973575700:  Hold'em No Limit ($0.05/$0.10 USD) - 2021/01/23 16:54:36 ET
Table 'Capricorn III' 6-max Seat #2 is the button
Seat 1: adilpoker84 ($18.38 in chips) 
Seat 2: rubduckofdeath ($10 in chips) 
Seat 3: teddyKK ($21.40 in chips) 
Seat 4: SchuhaRt71 ($17.11 in chips) 
Seat 5: Gissbon ($10.17 in chips) 
Seat 6: bros1987 ($11.97 in chips) 
teddyKK: posts small blind $0.05
SchuhaRt71: posts big blind $0.10
*** HOLE CARDS ***
Gissbon: raises $0.15 to $0.25
bros1987: folds 
adilpoker84: folds 
rubduckofdeath: calls $0.25
teddyKK: folds 
SchuhaRt71: folds 
*** FLOP *** [Kh As 9s]
Gissbon: bets $0.25
rubduckofdeath: calls $0.25
*** TURN *** [Kh As 9s] [Kc]
Gissbon: checks 
rubduckofdeath: bets $0.60
Gissbon: calls $0.60
*** RIVER *** [Kh As 9s Kc] [6h]
Gissbon: checks 
rubduckofdeath: checks 
*** SHOW DOWN ***
Gissbon: shows [9c 9d] (a full house, Nines full of Kings)
rubduckofdeath: mucks hand 
Gissbon collected $2.24 from pot
*** SUMMARY ***
Total pot $2.35 | Rake $0.11 
Board [Kh As 9s Kc 6h]
Seat 1: adilpoker84 folded before Flop (didn't bet)
Seat 2: rubduckofdeath (button) mucked
Seat 3: teddyKK (small blind) folded before Flop
Seat 4: SchuhaRt71 (big blind) folded before Flop
Seat 5: Gissbon showed [9c 9d] and won ($2.24) with a full house, Nines full of Kings
Seat 6: bros1987 folded before Flop (didn't bet)



PokerStars Hand #222973607515:  Hold'em No Limit ($0.05/$0.10 USD) - 2021/01/23 16:55:17 ET
Table 'Capricorn III' 6-max Seat #3 is the button
Seat 1: adilpoker84 ($18.38 in chips) 
Seat 2: rubduckofdeath ($10 in chips) 
Seat 3: teddyKK ($21.35 in chips) 
Seat 4: SchuhaRt71 ($17.01 in chips) 
Seat 5: Gissbon ($11.31 in chips) 
Seat 6: bros1987 ($11.97 in chips) 
SchuhaRt71: posts small blind $0.05
Gissbon: posts big blind $0.10
*** HOLE CARDS ***
bros1987: folds 
adilpoker84: calls $0.10
rubduckofdeath: raises $0.30 to $0.40
teddyKK: folds 
SchuhaRt71: folds 
Gissbon: folds 
adilpoker84: calls $0.30
*** FLOP *** [Qd 4d Jh]
adilpoker84: checks 
rubduckofdeath: bets $0.52
adilpoker84: calls $0.52
*** TURN *** [Qd 4d Jh] [Qc]
adilpoker84: checks 
rubduckofdeath: checks 
*** RIVER *** [Qd 4d Jh Qc] [9d]
adilpoker84: bets $1
rubduckofdeath: calls $1
*** SHOW DOWN ***
adilpoker84: shows [9s Js] (two pair, Queens and Jacks)
rubduckofdeath: shows [Ah Ac] (two pair, Aces and Queens)
rubduckofdeath collected $3.81 from pot
*** SUMMARY ***
Total pot $3.99 | Rake $0.18 
Board [Qd 4d Jh Qc 9d]
Seat 1: adilpoker84 showed [9s Js] and lost with two pair, Queens and Jacks
Seat 2: rubduckofdeath showed [Ah Ac] and won ($3.81) with two pair, Aces and Queens
Seat 3: teddyKK (button) folded before Flop (didn't bet)
Seat 4: SchuhaRt71 (small blind) folded before Flop
Seat 5: Gissbon (big blind) folded before Flop
Seat 6: bros1987 folded before Flop (didn't bet)



PokerStars Hand #222973636090:  Hold'em No Limit ($0.05/$0.10 USD) - 2021/01/23 16:56:08 ET
Table 'Capricorn III' 6-max Seat #4 is the button
Seat 1: adilpoker84 ($16.46 in chips) 
Seat 2: rubduckofdeath ($11.89 in chips) 
Seat 3: teddyKK ($21.35 in chips) 
Seat 4: SchuhaRt71 ($16.96 in chips) 
Seat 5: Gissbon ($11.21 in chips) 
Seat 6: bros1987 ($11.97 in chips) 
Gissbon: posts small blind $0.05
bros1987: posts big blind $0.10
*** HOLE CARDS ***
adilpoker84: raises $0.40 to $0.50
rubduckofdeath: folds 
teddyKK: folds 
SchuhaRt71: folds 
Gissbon: folds 
bros1987: calls $0.40
*** FLOP *** [3d Jh Js]
bros1987: checks 
adilpoker84: bets $0.50
bros1987: calls $0.50
*** TURN *** [3d Jh Js] [4s]
bros1987: checks 
adilpoker84: bets $0.50
bros1987: folds 
Uncalled bet ($0.50) returned to adilpoker84
adilpoker84 collected $1.96 from pot
adilpoker84: doesn't show hand 
*** SUMMARY ***
Total pot $2.05 | Rake $0.09 
Board [3d Jh Js 4s]
Seat 1: adilpoker84 collected ($1.96)
Seat 2: rubduckofdeath folded before Flop (didn't bet)
Seat 3: teddyKK folded before Flop (didn't bet)
Seat 4: SchuhaRt71 (button) folded before Flop (didn't bet)
Seat 5: Gissbon (small blind) folded before Flop
Seat 6: bros1987 (big blind) folded on the Turn



PokerStars Hand #222973658866:  Hold'em No Limit ($0.05/$0.10 USD) - 2021/01/23 16:56:48 ET
Table 'Capricorn III' 6-max Seat #5 is the button
Seat 1: adilpoker84 ($17.42 in chips) 
Seat 2: rubduckofdeath ($11.89 in chips) 
Seat 3: teddyKK ($21.35 in chips) 
Seat 4: SchuhaRt71 ($16.96 in chips) 
Seat 5: Gissbon ($11.16 in chips) 
Seat 6: bros1987 ($10.97 in chips) 
bros1987: posts small blind $0.05
adilpoker84: posts big blind $0.10
*** HOLE CARDS ***
rubduckofdeath: folds 
teddyKK: folds 
SchuhaRt71: folds 
Gissbon: raises $0.15 to $0.25
bros1987: folds 
adilpoker84: calls $0.15
*** FLOP *** [9h 4s Qd]
adilpoker84: checks 
Gissbon: checks 
*** TURN *** [9h 4s Qd] [7d]
adilpoker84: checks 
Gissbon: checks 
*** RIVER *** [9h 4s Qd 7d] [9c]
adilpoker84: checks 
Gissbon: checks 
*** SHOW DOWN ***
adilpoker84: shows [5d Jc] (a pair of Nines)
Gissbon: shows [As 4c] (two pair, Nines and Fours)
Gissbon collected $0.53 from pot
*** SUMMARY ***
Total pot $0.55 | Rake $0.02 
Board [9h 4s Qd 7d 9c]
Seat 1: adilpoker84 (big blind) showed [5d Jc] and lost with a pair of Nines
Seat 2: rubduckofdeath folded before Flop (didn't bet)
Seat 3: teddyKK folded before Flop (didn't bet)
Seat 4: SchuhaRt71 folded before Flop (didn't bet)
Seat 5: Gissbon (button) showed [As 4c] and won ($0.53) with two pair, Nines and Fours
Seat 6: bros1987 (small blind) folded before Flop



PokerStars Hand #222973690557:  Hold'em No Limit ($0.05/$0.10 USD) - 2021/01/23 16:57:43 ET
Table 'Capricorn III' 6-max Seat #6 is the button
Seat 1: adilpoker84 ($17.17 in chips) 
Seat 2: rubduckofdeath ($11.89 in chips) 
Seat 3: teddyKK ($21.35 in chips) 
Seat 4: SchuhaRt71 ($16.96 in chips) 
Seat 5: Gissbon ($11.44 in chips) 
Seat 6: bros1987 ($10.92 in chips) 
adilpoker84: posts small blind $0.05
rubduckofdeath: posts big blind $0.10
*** HOLE CARDS ***
teddyKK: raises $0.20 to $0.30
SchuhaRt71: folds 
Gissbon: folds 
bros1987: folds 
adilpoker84: calls $0.25
rubduckofdeath: folds 
*** FLOP *** [Jd 4h 8h]
adilpoker84: checks 
teddyKK: checks 
*** TURN *** [Jd 4h 8h] [3c]
adilpoker84: checks 
teddyKK: checks 
*** RIVER *** [Jd 4h 8h 3c] [2s]
adilpoker84: bets $0.30
teddyKK: folds 
Uncalled bet ($0.30) returned to adilpoker84
adilpoker84 collected $0.67 from pot
adilpoker84: doesn't show hand 
*** SUMMARY ***
Total pot $0.70 | Rake $0.03 
Board [Jd 4h 8h 3c 2s]
Seat 1: adilpoker84 (small blind) collected ($0.67)
Seat 2: rubduckofdeath (big blind) folded before Flop
Seat 3: teddyKK folded on the River
Seat 4: SchuhaRt71 folded before Flop (didn't bet)
Seat 5: Gissbon folded before Flop (didn't bet)
Seat 6: bros1987 (button) folded before Flop (didn't bet)



PokerStars Hand #222973717053:  Hold'em No Limit ($0.05/$0.10 USD) - 2021/01/23 16:58:29 ET
Table 'Capricorn III' 6-max Seat #1 is the button
Seat 1: adilpoker84 ($17.54 in chips) 
Seat 2: rubduckofdeath ($11.79 in chips) 
Seat 3: teddyKK ($21.05 in chips) 
Seat 4: SchuhaRt71 ($16.96 in chips) 
Seat 5: Gissbon ($11.44 in chips) 
Seat 6: bros1987 ($10.92 in chips) 
rubduckofdeath: posts small blind $0.05
teddyKK: posts big blind $0.10
*** HOLE CARDS ***
SchuhaRt71: folds 
Gissbon: folds 
bros1987: folds 
adilpoker84: calls $0.10
rubduckofdeath: folds 
teddyKK: checks 
*** FLOP *** [Qc 9s 4s]
teddyKK: checks 
adilpoker84: bets $0.20
teddyKK: folds 
Uncalled bet ($0.20) returned to adilpoker84
adilpoker84 collected $0.24 from pot
adilpoker84: doesn't show hand 
*** SUMMARY ***
Total pot $0.25 | Rake $0.01 
Board [Qc 9s 4s]
Seat 1: adilpoker84 (button) collected ($0.24)
Seat 2: rubduckofdeath (small blind) folded before Flop
Seat 3: teddyKK (big blind) folded on the Flop
Seat 4: SchuhaRt71 folded before Flop (didn't bet)
Seat 5: Gissbon folded before Flop (didn't bet)
Seat 6: bros1987 folded before Flop (didn't bet)



PokerStars Hand #222973742830:  Hold'em No Limit ($0.05/$0.10 USD) - 2021/01/23 16:59:13 ET
Table 'Capricorn III' 6-max Seat #2 is the button
Seat 1: adilpoker84 ($17.68 in chips) 
Seat 2: rubduckofdeath ($11.74 in chips) 
Seat 3: teddyKK ($20.95 in chips) 
Seat 4: SchuhaRt71 ($16.96 in chips) 
Seat 5: Gissbon ($11.44 in chips) 
Seat 6: bros1987 ($10.92 in chips) 
teddyKK: posts small blind $0.05
SchuhaRt71: posts big blind $0.10
*** HOLE CARDS ***
Gissbon: folds 
bros1987: folds 
adilpoker84: calls $0.10
rubduckofdeath: folds 
teddyKK: folds 
SchuhaRt71: checks 
*** FLOP *** [9c 5h 2h]
SchuhaRt71: checks 
adilpoker84: checks 
*** TURN *** [9c 5h 2h] [7d]
SchuhaRt71: bets $0.18
adilpoker84: folds 
Uncalled bet ($0.18) returned to SchuhaRt71
SchuhaRt71 collected $0.24 from pot
SchuhaRt71: doesn't show hand 
*** SUMMARY ***
Total pot $0.25 | Rake $0.01 
Board [9c 5h 2h 7d]
Seat 1: adilpoker84 folded on the Turn
Seat 2: rubduckofdeath (button) folded before Flop (didn't bet)
Seat 3: teddyKK (small blind) folded before Flop
Seat 4: SchuhaRt71 (big blind) collected ($0.24)
Seat 5: Gissbon folded before Flop (didn't bet)
Seat 6: bros1987 folded before Flop (didn't bet)



PokerStars Hand #222973766254:  Hold'em No Limit ($0.05/$0.10 USD) - 2021/01/23 16:59:53 ET
Table 'Capricorn III' 6-max Seat #3 is the button
Seat 1: adilpoker84 ($17.58 in chips) 
Seat 2: rubduckofdeath ($11.74 in chips) 
Seat 3: teddyKK ($20.90 in chips) 
Seat 4: SchuhaRt71 ($17.10 in chips) 
Seat 5: Gissbon ($11.44 in chips) 
Seat 6: bros1987 ($10.92 in chips) 
SchuhaRt71: posts small blind $0.05
Gissbon: posts big blind $0.10
*** HOLE CARDS ***
bros1987: raises $0.20 to $0.30
adilpoker84: folds 
rubduckofdeath: calls $0.30
teddyKK: calls $0.30
SchuhaRt71: folds 
Gissbon: folds 
*** FLOP *** [9h Ts 7d]
bros1987: bets $0.45
rubduckofdeath: calls $0.45
teddyKK: folds 
*** TURN *** [9h Ts 7d] [Kc]
bros1987: bets $1
rubduckofdeath: folds 
Uncalled bet ($1) returned to bros1987
bros1987 collected $1.86 from pot
bros1987: doesn't show hand 
*** SUMMARY ***
Total pot $1.95 | Rake $0.09 
Board [9h Ts 7d Kc]
Seat 1: adilpoker84 folded before Flop (didn't bet)
Seat 2: rubduckofdeath folded on the Turn
Seat 3: teddyKK (button) folded on the Flop
Seat 4: SchuhaRt71 (small blind) folded before Flop
Seat 5: Gissbon (big blind) folded before Flop
Seat 6: bros1987 collected ($1.86)



PokerStars Hand #222973797183:  Hold'em No Limit ($0.05/$0.10 USD) - 2021/01/23 17:00:42 ET
Table 'Capricorn III' 6-max Seat #4 is the button
Seat 1: adilpoker84 ($17.58 in chips) 
Seat 2: rubduckofdeath ($10.99 in chips) 
Seat 3: teddyKK ($20.60 in chips) 
Seat 4: SchuhaRt71 ($17.05 in chips) 
Seat 5: Gissbon ($11.34 in chips) 
Seat 6: bros1987 ($12.03 in chips) 
Gissbon: posts small blind $0.05
bros1987: posts big blind $0.10
*** HOLE CARDS ***
adilpoker84: calls $0.10
rubduckofdeath: calls $0.10
teddyKK: calls $0.10
SchuhaRt71: raises $0.30 to $0.40
Gissbon: folds 
bros1987: folds 
adilpoker84: calls $0.30
rubduckofdeath: calls $0.30
teddyKK: folds 
*** FLOP *** [Qs Qc 2c]
adilpoker84: checks 
rubduckofdeath: checks 
SchuhaRt71: bets $0.92
adilpoker84: folds 
rubduckofdeath: folds 
Uncalled bet ($0.92) returned to SchuhaRt71
SchuhaRt71 collected $1.38 from pot
SchuhaRt71: doesn't show hand 
*** SUMMARY ***
Total pot $1.45 | Rake $0.07 
Board [Qs Qc 2c]
Seat 1: adilpoker84 folded on the Flop
Seat 2: rubduckofdeath folded on the Flop
Seat 3: teddyKK folded before Flop
Seat 4: SchuhaRt71 (button) collected ($1.38)
Seat 5: Gissbon (small blind) folded before Flop
Seat 6: bros1987 (big blind) folded before Flop



PokerStars Hand #222973832103:  Hold'em No Limit ($0.05/$0.10 USD) - 2021/01/23 17:01:30 ET
Table 'Capricorn III' 6-max Seat #5 is the button
Seat 1: adilpoker84 ($17.18 in chips) 
Seat 2: rubduckofdeath ($10.59 in chips) 
Seat 3: teddyKK ($20.50 in chips) 
Seat 4: SchuhaRt71 ($18.03 in chips) 
Seat 5: Gissbon ($11.29 in chips) 
Seat 6: bros1987 ($11.93 in chips) 
bros1987: posts small blind $0.05
adilpoker84: posts big blind $0.10
*** HOLE CARDS ***
rubduckofdeath: folds 
teddyKK: folds 
SchuhaRt71: folds 
Gissbon: raises $0.15 to $0.25
bros1987: calls $0.20
adilpoker84: calls $0.15
*** FLOP *** [7h 2c 7d]
bros1987: checks 
adilpoker84: checks 
Gissbon: bets $0.29
bros1987: folds 
adilpoker84: folds 
Uncalled bet ($0.29) returned to Gissbon
Gissbon collected $0.72 from pot
Gissbon: doesn't show hand 
*** SUMMARY ***
Total pot $0.75 | Rake $0.03 
Board [7h 2c 7d]
Seat 1: adilpoker84 (big blind) folded on the Flop
Seat 2: rubduckofdeath folded before Flop (didn't bet)
Seat 3: teddyKK folded before Flop (didn't bet)
Seat 4: SchuhaRt71 folded before Flop (didn't bet)
Seat 5: Gissbon (button) collected ($0.72)
Seat 6: bros1987 (small blind) folded on the Flop



PokerStars Hand #222973865115:  Hold'em No Limit ($0.05/$0.10 USD) - 2021/01/23 17:02:11 ET
Table 'Capricorn III' 6-max Seat #6 is the button
Seat 1: adilpoker84 ($16.93 in chips) 
Seat 2: rubduckofdeath ($10.59 in chips) 
Seat 3: teddyKK ($20.50 in chips) 
Seat 4: SchuhaRt71 ($18.03 in chips) 
Seat 5: Gissbon ($11.76 in chips) 
Seat 6: bros1987 ($11.68 in chips) 
adilpoker84: posts small blind $0.05
rubduckofdeath: posts big blind $0.10
*** HOLE CARDS ***
teddyKK: folds 
SchuhaRt71: raises $0.30 to $0.40
Gissbon: folds 
bros1987: folds 
adilpoker84: folds 
rubduckofdeath: folds 
Uncalled bet ($0.30) returned to SchuhaRt71
SchuhaRt71 collected $0.25 from pot
SchuhaRt71: doesn't show hand 
*** SUMMARY ***
Total pot $0.25 | Rake $0 
Seat 1: adilpoker84 (small blind) folded before Flop
Seat 2: rubduckofdeath (big blind) folded before Flop
Seat 3: teddyKK folded before Flop (didn't bet)
Seat 4: SchuhaRt71 collected ($0.25)
Seat 5: Gissbon folded before Flop (didn't bet)
Seat 6: bros1987 (button) folded before Flop (didn't bet)



PokerStars Hand #222973885541:  Hold'em No Limit ($0.05/$0.10 USD) - 2021/01/23 17:02:35 ET
Table 'Capricorn III' 6-max Seat #1 is the button
Seat 1: adilpoker84 ($16.88 in chips) 
Seat 2: rubduckofdeath ($10.49 in chips) 
Seat 3: teddyKK ($20.50 in chips) 
Seat 4: SchuhaRt71 ($18.18 in chips) 
Seat 5: Gissbon ($11.76 in chips) 
Seat 6: bros1987 ($11.68 in chips) 
rubduckofdeath: posts small blind $0.05
teddyKK: posts big blind $0.10
*** HOLE CARDS ***
SchuhaRt71: folds 
Gissbon: folds 
bros1987: raises $0.20 to $0.30
adilpoker84 is disconnected 
adilpoker84 has timed out while being disconnected
adilpoker84: folds 
rubduckofdeath: folds 
teddyKK: calls $0.20
*** FLOP *** [4d 4c Jc]
teddyKK: checks 
bros1987: bets $0.40
teddyKK: calls $0.40
*** TURN *** [4d 4c Jc] [Kc]
teddyKK: checks 
bros1987: checks 
*** RIVER *** [4d 4c Jc Kc] [Qh]
teddyKK: bets $0.70
bros1987: raises $2.30 to $3
teddyKK: calls $2.30
*** SHOW DOWN ***
bros1987: shows [Qd Qc] (a full house, Queens full of Fours)
teddyKK: mucks hand 
bros1987 collected $7.11 from pot
*** SUMMARY ***
Total pot $7.45 | Rake $0.34 
Board [4d 4c Jc Kc Qh]
Seat 1: adilpoker84 (button) folded before Flop (didn't bet)
Seat 2: rubduckofdeath (small blind) folded before Flop
Seat 3: teddyKK (big blind) mucked
Seat 4: SchuhaRt71 folded before Flop (didn't bet)
Seat 5: Gissbon folded before Flop (didn't bet)
Seat 6: bros1987 showed [Qd Qc] and won ($7.11) with a full house, Queens full of Fours



PokerStars Hand #222973942307:  Hold'em No Limit ($0.05/$0.10 USD) - 2021/01/23 17:03:43 ET
Table 'Capricorn III' 6-max Seat #2 is the button
Seat 1: adilpoker84 ($16.88 in chips) 
Seat 2: rubduckofdeath ($10.44 in chips) 
Seat 3: teddyKK ($16.80 in chips) 
Seat 4: SchuhaRt71 ($18.18 in chips) 
Seat 5: Gissbon ($11.76 in chips) 
Seat 6: bros1987 ($15.09 in chips) 
teddyKK: posts small blind $0.05
SchuhaRt71: posts big blind $0.10
*** HOLE CARDS ***
Gissbon: folds 
bros1987: folds 
adilpoker84: folds 
rubduckofdeath: folds 
teddyKK: raises $0.20 to $0.30
SchuhaRt71: folds 
Uncalled bet ($0.20) returned to teddyKK
teddyKK collected $0.20 from pot
teddyKK: doesn't show hand 
*** SUMMARY ***
Total pot $0.20 | Rake $0 
Seat 1: adilpoker84 folded before Flop (didn't bet)
Seat 2: rubduckofdeath (button) folded before Flop (didn't bet)
Seat 3: teddyKK (small blind) collected ($0.20)
Seat 4: SchuhaRt71 (big blind) folded before Flop
Seat 5: Gissbon folded before Flop (didn't bet)
Seat 6: bros1987 folded before Flop (didn't bet)



PokerStars Hand #222976301122:  Hold'em No Limit ($0.05/$0.10 USD) - 2021/01/23 17:52:38 ET
Table 'Capricorn III' 6-max Seat #2 is the button
Seat 1: adilpoker84 ($4.89 in chips) 
Seat 2: rubduckofdeath ($10 in chips) 
Seat 3: teddyKK ($25.48 in chips) 
Seat 4: SchuhaRt71 ($21.13 in chips) 
Seat 5: Lovimdzen ($4.27 in chips) 
Seat 6: joma620 ($10.18 in chips) 
teddyKK: posts small blind $0.05
SchuhaRt71: posts big blind $0.10
*** HOLE CARDS ***
Lovimdzen: raises $0.10 to $0.20
joma620: folds 
adilpoker84: calls $0.20
rubduckofdeath: folds 
teddyKK: raises $0.70 to $0.90
SchuhaRt71: folds 
Lovimdzen: folds 
adilpoker84: calls $0.70
*** FLOP *** [Kh Jd Qs]
teddyKK: bets $1.51
adilpoker84: raises $2.48 to $3.99 and is all-in
teddyKK: calls $2.48
*** TURN *** [Kh Jd Qs] [4s]
*** RIVER *** [Kh Jd Qs 4s] [2s]
*** SHOW DOWN ***
teddyKK: shows [Kd Qc] (two pair, Kings and Queens)
adilpoker84: shows [Td 9s] (a straight, Nine to King)
adilpoker84 collected $9.63 from pot
*** SUMMARY ***
Total pot $10.08 | Rake $0.45 
Board [Kh Jd Qs 4s 2s]
Seat 1: adilpoker84 showed [Td 9s] and won ($9.63) with a straight, Nine to King
Seat 2: rubduckofdeath (button) folded before Flop (didn't bet)
Seat 3: teddyKK (small blind) showed [Kd Qc] and lost with two pair, Kings and Queens
Seat 4: SchuhaRt71 (big blind) folded before Flop
Seat 5: Lovimdzen folded before Flop
Seat 6: joma620 folded before Flop (didn't bet)



PokerStars Hand #222976342568:  Hold'em No Limit ($0.05/$0.10 USD) - 2021/01/23 17:53:35 ET
Table 'Capricorn III' 6-max Seat #3 is the button
Seat 1: adilpoker84 ($9.63 in chips) 
Seat 2: rubduckofdeath ($10 in chips) 
Seat 3: teddyKK ($20.59 in chips) 
Seat 4: SchuhaRt71 ($21.03 in chips) 
Seat 5: Lovimdzen ($4.07 in chips) 
Seat 6: joma620 ($10.18 in chips) 
SchuhaRt71: posts small blind $0.05
Lovimdzen: posts big blind $0.10
*** HOLE CARDS ***
joma620: raises $0.20 to $0.30
adilpoker84: calls $0.30
rubduckofdeath: calls $0.30
teddyKK: calls $0.30
SchuhaRt71: folds 
Lovimdzen: raises $0.90 to $1.20
joma620: folds 
adilpoker84: calls $0.90
rubduckofdeath: calls $0.90
teddyKK: calls $0.90
*** FLOP *** [Kh 6c 4c]
Lovimdzen: bets $2.87 and is all-in
adilpoker84: calls $2.87
rubduckofdeath: folds 
teddyKK: folds 
*** TURN *** [Kh 6c 4c] [8d]
*** RIVER *** [Kh 6c 4c 8d] [6d]
*** SHOW DOWN ***
Lovimdzen: shows [Ac Ah] (two pair, Aces and Sixes)
adilpoker84: shows [Jc Js] (two pair, Jacks and Sixes)
Lovimdzen collected $10.40 from pot
adilpoker84 cashed out the hand for $0.86 | Cash Out Fee $0.01
*** SUMMARY ***
Total pot $10.89 | Rake $0.49 
Board [Kh 6c 4c 8d 6d]
Seat 1: adilpoker84 showed [Jc Js] and lost with two pair, Jacks and Sixes (cashed out).
Seat 2: rubduckofdeath folded on the Flop
Seat 3: teddyKK (button) folded on the Flop
Seat 4: SchuhaRt71 (small blind) folded before Flop
Seat 5: Lovimdzen (big blind) showed [Ac Ah] and won ($10.40) with two pair, Aces and Sixes
Seat 6: joma620 folded before Flop



PokerStars Hand #222976392711:  Hold'em No Limit ($0.05/$0.10 USD) - 2021/01/23 17:54:44 ET
Table 'Capricorn III' 6-max Seat #4 is the button
Seat 1: adilpoker84 ($6.42 in chips) 
Seat 2: rubduckofdeath ($10 in chips) 
Seat 3: teddyKK ($19.39 in chips) 
Seat 4: SchuhaRt71 ($20.98 in chips) 
Seat 5: Lovimdzen ($10.40 in chips) 
Seat 6: joma620 ($10 in chips) 
Lovimdzen: posts small blind $0.05
joma620: posts big blind $0.10
*** HOLE CARDS ***
adilpoker84: folds 
rubduckofdeath: folds 
teddyKK: raises $0.20 to $0.30
SchuhaRt71: folds 
Lovimdzen: folds 
joma620: folds 
Uncalled bet ($0.20) returned to teddyKK
teddyKK collected $0.25 from pot
teddyKK: doesn't show hand 
*** SUMMARY ***
Total pot $0.25 | Rake $0 
Seat 1: adilpoker84 folded before Flop (didn't bet)
Seat 2: rubduckofdeath folded before Flop (didn't bet)
Seat 3: teddyKK collected ($0.25)
Seat 4: SchuhaRt71 (button) folded before Flop (didn't bet)
Seat 5: Lovimdzen (small blind) folded before Flop
Seat 6: joma620 (big blind) folded before Flop



PokerStars Hand #222976407491:  Hold'em No Limit ($0.05/$0.10 USD) - 2021/01/23 17:55:05 ET
Table 'Capricorn III' 6-max Seat #5 is the button
Seat 1: adilpoker84 ($6.42 in chips) 
Seat 2: rubduckofdeath ($10 in chips) 
Seat 3: teddyKK ($19.54 in chips) 
Seat 4: SchuhaRt71 ($20.98 in chips) 
Seat 5: Lovimdzen ($10.35 in chips) 
Seat 6: joma620 ($10 in chips) 
joma620: posts small blind $0.05
adilpoker84: posts big blind $0.10
*** HOLE CARDS ***
rubduckofdeath: folds 
teddyKK: folds 
SchuhaRt71: folds 
Lovimdzen: raises $0.20 to $0.30
joma620: folds 
adilpoker84: calls $0.20
*** FLOP *** [4s 2s 5d]
adilpoker84: checks 
Lovimdzen: bets $0.20
adilpoker84: folds 
Uncalled bet ($0.20) returned to Lovimdzen
Lovimdzen collected $0.62 from pot
Lovimdzen: doesn't show hand 
*** SUMMARY ***
Total pot $0.65 | Rake $0.03 
Board [4s 2s 5d]
Seat 1: adilpoker84 (big blind) folded on the Flop
Seat 2: rubduckofdeath folded before Flop (didn't bet)
Seat 3: teddyKK folded before Flop (didn't bet)
Seat 4: SchuhaRt71 folded before Flop (didn't bet)
Seat 5: Lovimdzen (button) collected ($0.62)
Seat 6: joma620 (small blind) folded before Flop



PokerStars Hand #222976423820:  Hold'em No Limit ($0.05/$0.10 USD) - 2021/01/23 17:55:34 ET
Table 'Capricorn III' 6-max Seat #6 is the button
Seat 1: adilpoker84 ($6.12 in chips) 
Seat 2: rubduckofdeath ($10 in chips) 
Seat 3: teddyKK ($19.54 in chips) 
Seat 4: SchuhaRt71 ($20.98 in chips) 
Seat 5: Lovimdzen ($10.67 in chips) 
Seat 6: joma620 ($10 in chips) 
adilpoker84: posts small blind $0.05
rubduckofdeath: posts big blind $0.10
*** HOLE CARDS ***
teddyKK: raises $0.20 to $0.30
SchuhaRt71: folds 
Lovimdzen: folds 
joma620: folds 
adilpoker84: folds 
rubduckofdeath is disconnected 
rubduckofdeath is connected 
rubduckofdeath: folds 
Uncalled bet ($0.20) returned to teddyKK
teddyKK collected $0.25 from pot
teddyKK: doesn't show hand 
*** SUMMARY ***
Total pot $0.25 | Rake $0 
Seat 1: adilpoker84 (small blind) folded before Flop
Seat 2: rubduckofdeath (big blind) folded before Flop
Seat 3: teddyKK collected ($0.25)
Seat 4: SchuhaRt71 folded before Flop (didn't bet)
Seat 5: Lovimdzen folded before Flop (didn't bet)
Seat 6: joma620 (button) folded before Flop (didn't bet)



PokerStars Hand #222976443811:  Hold'em No Limit ($0.05/$0.10 USD) - 2021/01/23 17:56:12 ET
Table 'Capricorn III' 6-max Seat #1 is the button
Seat 1: adilpoker84 ($6.07 in chips) 
Seat 2: rubduckofdeath ($10 in chips) 
Seat 3: teddyKK ($19.69 in chips) 
Seat 4: SchuhaRt71 ($20.98 in chips) 
Seat 5: Lovimdzen ($10.67 in chips) 
Seat 6: joma620 ($10 in chips) 
rubduckofdeath: posts small blind $0.05
teddyKK: posts big blind $0.10
*** HOLE CARDS ***
SchuhaRt71: folds 
Lovimdzen: raises $0.20 to $0.30
joma620: folds 
adilpoker84: calls $0.30
rubduckofdeath: folds 
teddyKK: calls $0.20
*** FLOP *** [Ah 7d 9h]
teddyKK: checks 
Lovimdzen: bets $0.50
adilpoker84: calls $0.50
teddyKK: folds 
*** TURN *** [Ah 7d 9h] [5c]
Lovimdzen: checks 
adilpoker84: checks 
*** RIVER *** [Ah 7d 9h 5c] [Js]
Lovimdzen: bets $0.80
adilpoker84: calls $0.80
*** SHOW DOWN ***
Lovimdzen: shows [Kd 4d] (high card Ace)
adilpoker84: shows [As 2s] (a pair of Aces)
adilpoker84 collected $3.39 from pot
*** SUMMARY ***
Total pot $3.55 | Rake $0.16 
Board [Ah 7d 9h 5c Js]
Seat 1: adilpoker84 (button) showed [As 2s] and won ($3.39) with a pair of Aces
Seat 2: rubduckofdeath (small blind) folded before Flop
Seat 3: teddyKK (big blind) folded on the Flop
Seat 4: SchuhaRt71 folded before Flop (didn't bet)
Seat 5: Lovimdzen showed [Kd 4d] and lost with high card Ace
Seat 6: joma620 folded before Flop (didn't bet)



PokerStars Hand #222976470428:  Hold'em No Limit ($0.05/$0.10 USD) - 2021/01/23 17:57:02 ET
Table 'Capricorn III' 6-max Seat #2 is the button
Seat 1: adilpoker84 ($7.86 in chips) 
Seat 2: rubduckofdeath ($10 in chips) 
Seat 3: teddyKK ($19.39 in chips) 
Seat 4: SchuhaRt71 ($20.98 in chips) 
Seat 5: Lovimdzen ($9.07 in chips) 
Seat 6: joma620 ($10 in chips) 
teddyKK: posts small blind $0.05
SchuhaRt71: posts big blind $0.10
*** HOLE CARDS ***
Lovimdzen: folds 
joma620: folds 
adilpoker84: folds 
rubduckofdeath: folds 
teddyKK: folds 
Uncalled bet ($0.05) returned to SchuhaRt71
SchuhaRt71 collected $0.10 from pot
SchuhaRt71: doesn't show hand 
*** SUMMARY ***
Total pot $0.10 | Rake $0 
Seat 1: adilpoker84 folded before Flop (didn't bet)
Seat 2: rubduckofdeath (button) folded before Flop (didn't bet)
Seat 3: teddyKK (small blind) folded before Flop
Seat 4: SchuhaRt71 (big blind) collected ($0.10)
Seat 5: Lovimdzen folded before Flop (didn't bet)
Seat 6: joma620 folded before Flop (didn't bet)



PokerStars Hand #222976475461:  Hold'em No Limit ($0.05/$0.10 USD) - 2021/01/23 17:57:12 ET
Table 'Capricorn III' 6-max Seat #3 is the button
Seat 1: adilpoker84 ($7.86 in chips) 
Seat 2: rubduckofdeath ($10 in chips) 
Seat 3: teddyKK ($19.34 in chips) 
Seat 4: SchuhaRt71 ($21.03 in chips) 
Seat 5: Lovimdzen ($9.07 in chips) 
Seat 6: joma620 ($10 in chips) 
SchuhaRt71: posts small blind $0.05
Lovimdzen: posts big blind $0.10
*** HOLE CARDS ***
joma620: folds 
adilpoker84: calls $0.10
rubduckofdeath: folds 
teddyKK: raises $0.40 to $0.50
SchuhaRt71: folds 
Lovimdzen: folds 
adilpoker84: calls $0.40
*** FLOP *** [6h Jh Ac]
adilpoker84: checks 
teddyKK: bets $0.55
adilpoker84: folds 
Uncalled bet ($0.55) returned to teddyKK
teddyKK collected $1.10 from pot
teddyKK: doesn't show hand 
*** SUMMARY ***
Total pot $1.15 | Rake $0.05 
Board [6h Jh Ac]
Seat 1: adilpoker84 folded on the Flop
Seat 2: rubduckofdeath folded before Flop (didn't bet)
Seat 3: teddyKK (button) collected ($1.10)
Seat 4: SchuhaRt71 (small blind) folded before Flop
Seat 5: Lovimdzen (big blind) folded before Flop
Seat 6: joma620 folded before Flop (didn't bet)



PokerStars Hand #222976487509:  Hold'em No Limit ($0.05/$0.10 USD) - 2021/01/23 17:57:34 ET
Table 'Capricorn III' 6-max Seat #4 is the button
Seat 1: adilpoker84 ($7.36 in chips) 
Seat 2: rubduckofdeath ($10 in chips) 
Seat 3: teddyKK ($19.94 in chips) 
Seat 4: SchuhaRt71 ($20.98 in chips) 
Seat 5: Lovimdzen ($8.97 in chips) 
Seat 6: joma620 ($10 in chips) 
Lovimdzen: posts small blind $0.05
joma620: posts big blind $0.10
*** HOLE CARDS ***
adilpoker84: calls $0.10
rubduckofdeath: folds 
teddyKK: folds 
SchuhaRt71: folds 
Lovimdzen: folds 
joma620: checks 
*** FLOP *** [Qd 7c Ah]
joma620: checks 
adilpoker84: checks 
*** TURN *** [Qd 7c Ah] [8d]
joma620: bets $0.12
adilpoker84: folds 
Uncalled bet ($0.12) returned to joma620
joma620 collected $0.24 from pot
joma620: doesn't show hand 
*** SUMMARY ***
Total pot $0.25 | Rake $0.01 
Board [Qd 7c Ah 8d]
Seat 1: adilpoker84 folded on the Turn
Seat 2: rubduckofdeath folded before Flop (didn't bet)
Seat 3: teddyKK folded before Flop (didn't bet)
Seat 4: SchuhaRt71 (button) folded before Flop (didn't bet)
Seat 5: Lovimdzen (small blind) folded before Flop
Seat 6: joma620 (big blind) collected ($0.24)



PokerStars Hand #222976503053:  Hold'em No Limit ($0.05/$0.10 USD) - 2021/01/23 17:58:04 ET
Table 'Capricorn III' 6-max Seat #5 is the button
Seat 1: adilpoker84 ($7.26 in chips) 
Seat 2: rubduckofdeath ($10 in chips) 
Seat 3: teddyKK ($19.94 in chips) 
Seat 4: SchuhaRt71 ($20.98 in chips) 
Seat 5: Lovimdzen ($8.92 in chips) 
Seat 6: joma620 ($10.14 in chips) 
joma620: posts small blind $0.05
adilpoker84: posts big blind $0.10
*** HOLE CARDS ***
rubduckofdeath: folds 
teddyKK: folds 
SchuhaRt71: raises $0.40 to $0.50
Lovimdzen: folds 
joma620: folds 
adilpoker84: folds 
Uncalled bet ($0.40) returned to SchuhaRt71
SchuhaRt71 collected $0.25 from pot
SchuhaRt71: doesn't show hand 
*** SUMMARY ***
Total pot $0.25 | Rake $0 
Seat 1: adilpoker84 (big blind) folded before Flop
Seat 2: rubduckofdeath folded before Flop (didn't bet)
Seat 3: teddyKK folded before Flop (didn't bet)
Seat 4: SchuhaRt71 collected ($0.25)
Seat 5: Lovimdzen (button) folded before Flop (didn't bet)
Seat 6: joma620 (small blind) folded before Flop



PokerStars Hand #222976512658:  Hold'em No Limit ($0.05/$0.10 USD) - 2021/01/23 17:58:22 ET
Table 'Capricorn III' 6-max Seat #6 is the button
Seat 1: adilpoker84 ($7.16 in chips) 
Seat 2: rubduckofdeath ($10 in chips) 
Seat 3: teddyKK ($19.94 in chips) 
Seat 4: SchuhaRt71 ($21.13 in chips) 
Seat 5: Lovimdzen ($8.92 in chips) 
Seat 6: joma620 ($10.09 in chips) 
adilpoker84: posts small blind $0.05
rubduckofdeath: posts big blind $0.10
*** HOLE CARDS ***
teddyKK: folds 
SchuhaRt71: folds 
Lovimdzen: folds 
joma620: raises $0.20 to $0.30
adilpoker84: folds 
rubduckofdeath: raises $0.65 to $0.95
joma620: folds 
Uncalled bet ($0.65) returned to rubduckofdeath
rubduckofdeath collected $0.65 from pot
rubduckofdeath: doesn't show hand 
*** SUMMARY ***
Total pot $0.65 | Rake $0 
Seat 1: adilpoker84 (small blind) folded before Flop
Seat 2: rubduckofdeath (big blind) collected ($0.65)
Seat 3: teddyKK folded before Flop (didn't bet)
Seat 4: SchuhaRt71 folded before Flop (didn't bet)
Seat 5: Lovimdzen folded before Flop (didn't bet)
Seat 6: joma620 (button) folded before Flop



PokerStars Hand #222976531092:  Hold'em No Limit ($0.05/$0.10 USD) - 2021/01/23 17:58:56 ET
Table 'Capricorn III' 6-max Seat #1 is the button
Seat 1: adilpoker84 ($7.11 in chips) 
Seat 2: rubduckofdeath ($10.35 in chips) 
Seat 3: teddyKK ($19.94 in chips) 
Seat 4: SchuhaRt71 ($21.13 in chips) 
Seat 5: Lovimdzen ($8.92 in chips) 
Seat 6: joma620 ($10 in chips) 
rubduckofdeath: posts small blind $0.05
teddyKK: posts big blind $0.10
*** HOLE CARDS ***
SchuhaRt71: raises $0.20 to $0.30
Lovimdzen: folds 
joma620: folds 
adilpoker84: calls $0.30
rubduckofdeath: folds 
teddyKK: folds 
*** FLOP *** [4d Jc Ts]
SchuhaRt71: bets $0.60
adilpoker84: calls $0.60
*** TURN *** [4d Jc Ts] [9h]
SchuhaRt71: bets $1.40
adilpoker84: calls $1.40
*** RIVER *** [4d Jc Ts 9h] [3d]
SchuhaRt71: bets $3.03
adilpoker84: calls $3.03
*** SHOW DOWN ***
SchuhaRt71: shows [Td Jd] (two pair, Jacks and Tens)
adilpoker84: mucks hand 
SchuhaRt71 collected $10.32 from pot
*** SUMMARY ***
Total pot $10.81 | Rake $0.49 
Board [4d Jc Ts 9h 3d]
Seat 1: adilpoker84 (button) mucked
Seat 2: rubduckofdeath (small blind) folded before Flop
Seat 3: teddyKK (big blind) folded before Flop
Seat 4: SchuhaRt71 showed [Td Jd] and won ($10.32) with two pair, Jacks and Tens
Seat 5: Lovimdzen folded before Flop (didn't bet)
Seat 6: joma620 folded before Flop (didn't bet)



PokerStars Hand #222976566003:  Hold'em No Limit ($0.05/$0.10 USD) - 2021/01/23 17:59:53 ET
Table 'Capricorn III' 6-max Seat #2 is the button
Seat 1: adilpoker84 ($1.78 in chips) 
Seat 2: rubduckofdeath ($10.30 in chips) 
Seat 3: teddyKK ($19.84 in chips) 
Seat 4: SchuhaRt71 ($26.12 in chips) 
Seat 5: Lovimdzen ($8.92 in chips) 
Seat 6: joma620 ($10 in chips) 
teddyKK: posts small blind $0.05
SchuhaRt71: posts big blind $0.10
*** HOLE CARDS ***
Lovimdzen: folds 
joma620: folds 
adilpoker84: calls $0.10
rubduckofdeath: folds 
teddyKK: raises $0.40 to $0.50
SchuhaRt71: folds 
adilpoker84: calls $0.40
*** FLOP *** [8s Qs 9s]
teddyKK: checks 
adilpoker84: bets $1.28 and is all-in
teddyKK: calls $1.28
*** TURN *** [8s Qs 9s] [9d]
*** RIVER *** [8s Qs 9s 9d] [5h]
*** SHOW DOWN ***
teddyKK: shows [Kd Ah] (a pair of Nines)
adilpoker84: shows [Qd 4d] (two pair, Queens and Nines)
adilpoker84 collected $3.50 from pot
*** SUMMARY ***
Total pot $3.66 | Rake $0.16 
Board [8s Qs 9s 9d 5h]
Seat 1: adilpoker84 showed [Qd 4d] and won ($3.50) with two pair, Queens and Nines
Seat 2: rubduckofdeath (button) folded before Flop (didn't bet)
Seat 3: teddyKK (small blind) showed [Kd Ah] and lost with a pair of Nines
Seat 4: SchuhaRt71 (big blind) folded before Flop
Seat 5: Lovimdzen folded before Flop (didn't bet)
Seat 6: joma620 folded before Flop (didn't bet)



PokerStars Hand #222976593039:  Hold'em No Limit ($0.05/$0.10 USD) - 2021/01/23 18:00:40 ET
Table 'Capricorn III' 6-max Seat #3 is the button
Seat 1: adilpoker84 ($3.50 in chips) 
Seat 2: rubduckofdeath ($10.30 in chips) 
Seat 3: teddyKK ($18.06 in chips) 
Seat 4: SchuhaRt71 ($26.02 in chips) 
Seat 5: Lovimdzen ($8.92 in chips) 
Seat 6: joma620 ($10 in chips) 
SchuhaRt71: posts small blind $0.05
Lovimdzen: posts big blind $0.10
*** HOLE CARDS ***
joma620: folds 
adilpoker84: raises $0.40 to $0.50
rubduckofdeath: folds 
teddyKK: folds 
SchuhaRt71: folds 
Lovimdzen: calls $0.40
*** FLOP *** [4s 8s 3h]
Lovimdzen: checks 
adilpoker84: bets $0.50
Lovimdzen: folds 
Uncalled bet ($0.50) returned to adilpoker84
adilpoker84 collected $1 from pot
adilpoker84: doesn't show hand 
*** SUMMARY ***
Total pot $1.05 | Rake $0.05 
Board [4s 8s 3h]
Seat 1: adilpoker84 collected ($1)
Seat 2: rubduckofdeath folded before Flop (didn't bet)
Seat 3: teddyKK (button) folded before Flop (didn't bet)
Seat 4: SchuhaRt71 (small blind) folded before Flop
Seat 5: Lovimdzen (big blind) folded on the Flop
Seat 6: joma620 folded before Flop (didn't bet)



PokerStars Hand #222976610586:  Hold'em No Limit ($0.05/$0.10 USD) - 2021/01/23 18:01:09 ET
Table 'Capricorn III' 6-max Seat #4 is the button
Seat 1: adilpoker84 ($4 in chips) 
Seat 2: rubduckofdeath ($10.30 in chips) 
Seat 3: teddyKK ($18.06 in chips) 
Seat 4: SchuhaRt71 ($25.97 in chips) 
Seat 5: Lovimdzen ($8.42 in chips) 
Seat 6: joma620 ($10 in chips) 
Lovimdzen: posts small blind $0.05
joma620: posts big blind $0.10
*** HOLE CARDS ***
adilpoker84: calls $0.10
rubduckofdeath: folds 
teddyKK: raises $0.30 to $0.40
SchuhaRt71: folds 
Lovimdzen: folds 
joma620: folds 
adilpoker84: calls $0.30
*** FLOP *** [Th 4s 6c]
adilpoker84: checks 
teddyKK: bets $0.68
adilpoker84: folds 
Uncalled bet ($0.68) returned to teddyKK
teddyKK collected $0.91 from pot
teddyKK: doesn't show hand 
*** SUMMARY ***
Total pot $0.95 | Rake $0.04 
Board [Th 4s 6c]
Seat 1: adilpoker84 folded on the Flop
Seat 2: rubduckofdeath folded before Flop (didn't bet)
Seat 3: teddyKK collected ($0.91)
Seat 4: SchuhaRt71 (button) folded before Flop (didn't bet)
Seat 5: Lovimdzen (small blind) folded before Flop
Seat 6: joma620 (big blind) folded before Flop



PokerStars Hand #222976625619:  Hold'em No Limit ($0.05/$0.10 USD) - 2021/01/23 18:01:32 ET
Table 'Capricorn III' 6-max Seat #5 is the button
Seat 1: adilpoker84 ($3.60 in chips) 
Seat 2: rubduckofdeath ($10.30 in chips) 
Seat 3: teddyKK ($18.57 in chips) 
Seat 4: SchuhaRt71 ($25.97 in chips) 
Seat 5: Lovimdzen ($8.37 in chips) 
Seat 6: joma620 ($10 in chips) 
joma620: posts small blind $0.05
adilpoker84: posts big blind $0.10
*** HOLE CARDS ***
rubduckofdeath: folds 
teddyKK: folds 
SchuhaRt71: folds 
Lovimdzen: raises $0.20 to $0.30
joma620: folds 
adilpoker84: raises $0.30 to $0.60
Lovimdzen: calls $0.30
*** FLOP *** [5h Td 6d]
adilpoker84: bets $0.60
Lovimdzen: calls $0.60
*** TURN *** [5h Td 6d] [Th]
adilpoker84: bets $2.40 and is all-in
Lovimdzen: calls $2.40
*** RIVER *** [5h Td 6d Th] [Jh]
*** SHOW DOWN ***
adilpoker84: shows [9h 9c] (two pair, Tens and Nines)
Lovimdzen: shows [6h Qc] (two pair, Tens and Sixes)
adilpoker84 collected $6.92 from pot
*** SUMMARY ***
Total pot $7.25 | Rake $0.33 
Board [5h Td 6d Th Jh]
Seat 1: adilpoker84 (big blind) showed [9h 9c] and won ($6.92) with two pair, Tens and Nines
Seat 2: rubduckofdeath folded before Flop (didn't bet)
Seat 3: teddyKK folded before Flop (didn't bet)
Seat 4: SchuhaRt71 folded before Flop (didn't bet)
Seat 5: Lovimdzen (button) showed [6h Qc] and lost with two pair, Tens and Sixes
Seat 6: joma620 (small blind) folded before Flop



PokerStars Hand #222976651878:  Hold'em No Limit ($0.05/$0.10 USD) - 2021/01/23 18:02:11 ET
Table 'Capricorn III' 6-max Seat #6 is the button
Seat 1: adilpoker84 ($6.92 in chips) 
Seat 2: rubduckofdeath ($10.30 in chips) 
Seat 3: teddyKK ($18.57 in chips) 
Seat 4: SchuhaRt71 ($25.97 in chips) 
Seat 5: Lovimdzen ($4.77 in chips) 
Seat 6: joma620 ($10 in chips) 
adilpoker84: posts small blind $0.05
rubduckofdeath: posts big blind $0.10
*** HOLE CARDS ***
teddyKK: folds 
SchuhaRt71: folds 
Lovimdzen: raises $0.10 to $0.20
joma620: folds 
adilpoker84: calls $0.15
rubduckofdeath: calls $0.10
*** FLOP *** [4d 4h 6s]
adilpoker84: bets $0.20
rubduckofdeath: folds 
Lovimdzen: calls $0.20
*** TURN *** [4d 4h 6s] [7h]
adilpoker84: bets $0.20
Lovimdzen: calls $0.20
*** RIVER *** [4d 4h 6s 7h] [3d]
adilpoker84: bets $0.20
Lovimdzen: raises $0.40 to $0.60
adilpoker84: folds 
Uncalled bet ($0.40) returned to Lovimdzen
Lovimdzen collected $1.72 from pot
Lovimdzen: doesn't show hand 
*** SUMMARY ***
Total pot $1.80 | Rake $0.08 
Board [4d 4h 6s 7h 3d]
Seat 1: adilpoker84 (small blind) folded on the River
Seat 2: rubduckofdeath (big blind) folded on the Flop
Seat 3: teddyKK folded before Flop (didn't bet)
Seat 4: SchuhaRt71 folded before Flop (didn't bet)
Seat 5: Lovimdzen collected ($1.72)
Seat 6: joma620 (button) folded before Flop (didn't bet)



PokerStars Hand #222976690943:  Hold'em No Limit ($0.05/$0.10 USD) - 2021/01/23 18:03:07 ET
Table 'Capricorn III' 6-max Seat #1 is the button
Seat 1: adilpoker84 ($6.12 in chips) 
Seat 2: rubduckofdeath ($10.10 in chips) 
Seat 3: teddyKK ($18.57 in chips) 
Seat 4: SchuhaRt71 ($25.97 in chips) 
Seat 5: Lovimdzen ($5.69 in chips) 
Seat 6: joma620 ($10 in chips) 
rubduckofdeath: posts small blind $0.05
teddyKK: posts big blind $0.10
*** HOLE CARDS ***
SchuhaRt71: folds 
Lovimdzen: folds 
joma620: folds 
adilpoker84: calls $0.10
rubduckofdeath: raises $0.30 to $0.40
teddyKK: folds 
adilpoker84: folds 
Uncalled bet ($0.30) returned to rubduckofdeath
rubduckofdeath collected $0.30 from pot
rubduckofdeath: doesn't show hand 
*** SUMMARY ***
Total pot $0.30 | Rake $0 
Seat 1: adilpoker84 (button) folded before Flop
Seat 2: rubduckofdeath (small blind) collected ($0.30)
Seat 3: teddyKK (big blind) folded before Flop
Seat 4: SchuhaRt71 folded before Flop (didn't bet)
Seat 5: Lovimdzen folded before Flop (didn't bet)
Seat 6: joma620 folded before Flop (didn't bet)



PokerStars Hand #222976707344:  Hold'em No Limit ($0.05/$0.10 USD) - 2021/01/23 18:03:30 ET
Table 'Capricorn III' 6-max Seat #2 is the button
Seat 1: adilpoker84 ($6.02 in chips) 
Seat 2: rubduckofdeath ($10.30 in chips) 
Seat 3: teddyKK ($18.47 in chips) 
Seat 4: SchuhaRt71 ($25.97 in chips) 
Seat 5: Lovimdzen ($5.69 in chips) 
Seat 6: joma620 ($10 in chips) 
teddyKK: posts small blind $0.05
SchuhaRt71: posts big blind $0.10
*** HOLE CARDS ***
Lovimdzen: raises $0.20 to $0.30
joma620: folds 
adilpoker84: calls $0.30
rubduckofdeath: folds 
teddyKK: folds 
SchuhaRt71: raises $1 to $1.30
Lovimdzen: raises $4.39 to $5.69 and is all-in
adilpoker84: folds 
SchuhaRt71: folds 
Uncalled bet ($4.39) returned to Lovimdzen
Lovimdzen collected $2.95 from pot
Lovimdzen: doesn't show hand 
*** SUMMARY ***
Total pot $2.95 | Rake $0 
Seat 1: adilpoker84 folded before Flop
Seat 2: rubduckofdeath (button) folded before Flop (didn't bet)
Seat 3: teddyKK (small blind) folded before Flop
Seat 4: SchuhaRt71 (big blind) folded before Flop
Seat 5: Lovimdzen collected ($2.95)
Seat 6: joma620 folded before Flop (didn't bet)



PokerStars Hand #222976740423:  Hold'em No Limit ($0.05/$0.10 USD) - 2021/01/23 18:04:17 ET
Table 'Capricorn III' 6-max Seat #3 is the button
Seat 1: adilpoker84 ($5.72 in chips) 
Seat 2: rubduckofdeath ($10.30 in chips) 
Seat 3: teddyKK ($18.42 in chips) 
Seat 4: SchuhaRt71 ($24.67 in chips) 
Seat 5: Lovimdzen ($7.34 in chips) 
Seat 6: joma620 ($10 in chips) 
SchuhaRt71: posts small blind $0.05
Lovimdzen: posts big blind $0.10
*** HOLE CARDS ***
joma620: folds 
adilpoker84: folds 
rubduckofdeath: folds 
teddyKK: raises $0.20 to $0.30
SchuhaRt71: folds 
Lovimdzen: calls $0.20
*** FLOP *** [7d Ts 4h]
Lovimdzen: checks 
teddyKK: bets $0.40
Lovimdzen: calls $0.40
*** TURN *** [7d Ts 4h] [3c]
Lovimdzen: checks 
teddyKK: checks 
*** RIVER *** [7d Ts 4h 3c] [6d]
Lovimdzen: bets $0.80
teddyKK: raises $1.80 to $2.60
Lovimdzen: calls $1.80
*** SHOW DOWN ***
teddyKK: shows [5s 4s] (a straight, Three to Seven)
Lovimdzen: mucks hand 
teddyKK collected $6.35 from pot
*** SUMMARY ***
Total pot $6.65 | Rake $0.30 
Board [7d Ts 4h 3c 6d]
Seat 1: adilpoker84 folded before Flop (didn't bet)
Seat 2: rubduckofdeath folded before Flop (didn't bet)
Seat 3: teddyKK (button) showed [5s 4s] and won ($6.35) with a straight, Three to Seven
Seat 4: SchuhaRt71 (small blind) folded before Flop
Seat 5: Lovimdzen (big blind) mucked
Seat 6: joma620 folded before Flop (didn't bet)



PokerStars Hand #222976782899:  Hold'em No Limit ($0.05/$0.10 USD) - 2021/01/23 18:05:16 ET
Table 'Capricorn III' 6-max Seat #4 is the button
Seat 1: adilpoker84 ($5.72 in chips) 
Seat 2: rubduckofdeath ($10.30 in chips) 
Seat 3: teddyKK ($21.47 in chips) 
Seat 4: SchuhaRt71 ($24.62 in chips) 
Seat 5: Lovimdzen ($4.04 in chips) 
Seat 6: joma620 ($10 in chips) 
Lovimdzen: posts small blind $0.05
joma620: posts big blind $0.10
*** HOLE CARDS ***
adilpoker84: folds 
rubduckofdeath: folds 
teddyKK: raises $0.20 to $0.30
SchuhaRt71: folds 
Lovimdzen: calls $0.25
joma620: calls $0.20
*** FLOP *** [4d Jh As]
Lovimdzen: checks 
joma620: checks 
teddyKK: bets $0.43
Lovimdzen: calls $0.43
joma620: folds 
*** TURN *** [4d Jh As] [5h]
Lovimdzen: checks 
teddyKK: checks 
*** RIVER *** [4d Jh As 5h] [2c]
Lovimdzen: bets $0.80
teddyKK: folds 
Uncalled bet ($0.80) returned to Lovimdzen
Lovimdzen collected $1.68 from pot
Lovimdzen: doesn't show hand 
*** SUMMARY ***
Total pot $1.76 | Rake $0.08 
Board [4d Jh As 5h 2c]
Seat 1: adilpoker84 folded before Flop (didn't bet)
Seat 2: rubduckofdeath folded before Flop (didn't bet)
Seat 3: teddyKK folded on the River
Seat 4: SchuhaRt71 (button) folded before Flop (didn't bet)
Seat 5: Lovimdzen (small blind) collected ($1.68)
Seat 6: joma620 (big blind) folded on the Flop



PokerStars Hand #222976828999:  Hold'em No Limit ($0.05/$0.10 USD) - 2021/01/23 18:06:22 ET
Table 'Capricorn III' 6-max Seat #5 is the button
Seat 1: adilpoker84 ($5.72 in chips) 
Seat 2: rubduckofdeath ($10.30 in chips) 
Seat 3: teddyKK ($20.74 in chips) 
Seat 4: SchuhaRt71 ($24.62 in chips) 
Seat 5: Lovimdzen ($4.99 in chips) 
Seat 6: joma620 ($10 in chips) 
joma620: posts small blind $0.05
adilpoker84: posts big blind $0.10
*** HOLE CARDS ***
rubduckofdeath: folds 
teddyKK: raises $0.20 to $0.30
SchuhaRt71: folds 
Lovimdzen: folds 
joma620: folds 
adilpoker84: calls $0.20
*** FLOP *** [2s 5h As]
adilpoker84: checks 
teddyKK: checks 
*** TURN *** [2s 5h As] [Ts]
adilpoker84: bets $0.40
teddyKK: folds 
Uncalled bet ($0.40) returned to adilpoker84
adilpoker84 collected $0.62 from pot
adilpoker84: doesn't show hand 
*** SUMMARY ***
Total pot $0.65 | Rake $0.03 
Board [2s 5h As Ts]
Seat 1: adilpoker84 (big blind) collected ($0.62)
Seat 2: rubduckofdeath folded before Flop (didn't bet)
Seat 3: teddyKK folded on the Turn
Seat 4: SchuhaRt71 folded before Flop (didn't bet)
Seat 5: Lovimdzen (button) folded before Flop (didn't bet)
Seat 6: joma620 (small blind) folded before Flop



PokerStars Hand #222976852836:  Hold'em No Limit ($0.05/$0.10 USD) - 2021/01/23 18:06:56 ET
Table 'Capricorn III' 6-max Seat #6 is the button
Seat 1: adilpoker84 ($6.04 in chips) 
Seat 2: rubduckofdeath ($10.30 in chips) 
Seat 3: teddyKK ($20.44 in chips) 
Seat 4: SchuhaRt71 ($24.62 in chips) 
Seat 5: Lovimdzen ($4.99 in chips) 
Seat 6: joma620 ($10 in chips) 
adilpoker84: posts small blind $0.05
rubduckofdeath: posts big blind $0.10
*** HOLE CARDS ***
teddyKK: folds 
SchuhaRt71: folds 
Lovimdzen: raises $0.10 to $0.20
joma620: folds 
adilpoker84: calls $0.15
rubduckofdeath: calls $0.10
*** FLOP *** [4h 9c 7d]
adilpoker84: checks 
rubduckofdeath: checks 
Lovimdzen: checks 
*** TURN *** [4h 9c 7d] [5h]
adilpoker84: checks 
rubduckofdeath: checks 
Lovimdzen: checks 
*** RIVER *** [4h 9c 7d 5h] [7h]
adilpoker84: bets $0.30
rubduckofdeath: folds 
Lovimdzen: folds 
Uncalled bet ($0.30) returned to adilpoker84
adilpoker84 collected $0.57 from pot
adilpoker84: doesn't show hand 
*** SUMMARY ***
Total pot $0.60 | Rake $0.03 
Board [4h 9c 7d 5h 7h]
Seat 1: adilpoker84 (small blind) collected ($0.57)
Seat 2: rubduckofdeath (big blind) folded on the River
Seat 3: teddyKK folded before Flop (didn't bet)
Seat 4: SchuhaRt71 folded before Flop (didn't bet)
Seat 5: Lovimdzen folded on the River
Seat 6: joma620 (button) folded before Flop (didn't bet)



PokerStars Hand #222976892374:  Hold'em No Limit ($0.05/$0.10 USD) - 2021/01/23 18:07:52 ET
Table 'Capricorn III' 6-max Seat #1 is the button
Seat 1: adilpoker84 ($6.41 in chips) 
Seat 2: rubduckofdeath ($10.10 in chips) 
Seat 3: teddyKK ($20.44 in chips) 
Seat 4: SchuhaRt71 ($24.62 in chips) 
Seat 5: Lovimdzen ($4.79 in chips) 
Seat 6: joma620 ($10 in chips) 
rubduckofdeath: posts small blind $0.05
teddyKK: posts big blind $0.10
*** HOLE CARDS ***
SchuhaRt71: folds 
Lovimdzen: raises $0.10 to $0.20
joma620: folds 
adilpoker84: folds 
rubduckofdeath: raises $0.50 to $0.70
teddyKK: folds 
Lovimdzen: calls $0.50
*** FLOP *** [Qh 5h 2c]
rubduckofdeath: bets $0.72
Lovimdzen: folds 
Uncalled bet ($0.72) returned to rubduckofdeath
rubduckofdeath collected $1.43 from pot
rubduckofdeath: doesn't show hand 
*** SUMMARY ***
Total pot $1.50 | Rake $0.07 
Board [Qh 5h 2c]
Seat 1: adilpoker84 (button) folded before Flop (didn't bet)
Seat 2: rubduckofdeath (small blind) collected ($1.43)
Seat 3: teddyKK (big blind) folded before Flop
Seat 4: SchuhaRt71 folded before Flop (didn't bet)
Seat 5: Lovimdzen folded on the Flop
Seat 6: joma620 folded before Flop (didn't bet)



PokerStars Hand #222976910924:  Hold'em No Limit ($0.05/$0.10 USD) - 2021/01/23 18:08:19 ET
Table 'Capricorn III' 6-max Seat #2 is the button
Seat 1: adilpoker84 ($6.41 in chips) 
Seat 2: rubduckofdeath ($10.83 in chips) 
Seat 3: teddyKK ($20.34 in chips) 
Seat 4: SchuhaRt71 ($24.62 in chips) 
Seat 5: Lovimdzen ($4.09 in chips) 
Seat 6: joma620 ($10 in chips) 
teddyKK: posts small blind $0.05
SchuhaRt71: posts big blind $0.10
*** HOLE CARDS ***
Lovimdzen: folds 
joma620: folds 
adilpoker84: calls $0.10
rubduckofdeath: folds 
teddyKK: folds 
SchuhaRt71: checks 
*** FLOP *** [Js Ts 7d]
Lovimdzen is disconnected 
SchuhaRt71: checks 
adilpoker84: bets $0.20
SchuhaRt71: folds 
Uncalled bet ($0.20) returned to adilpoker84
adilpoker84 collected $0.24 from pot
adilpoker84: doesn't show hand 
*** SUMMARY ***
Total pot $0.25 | Rake $0.01 
Board [Js Ts 7d]
Seat 1: adilpoker84 collected ($0.24)
Seat 2: rubduckofdeath (button) folded before Flop (didn't bet)
Seat 3: teddyKK (small blind) folded before Flop
Seat 4: SchuhaRt71 (big blind) folded on the Flop
Seat 5: Lovimdzen folded before Flop (didn't bet)
Seat 6: joma620 folded before Flop (didn't bet)



PokerStars Hand #222976927526:  Hold'em No Limit ($0.05/$0.10 USD) - 2021/01/23 18:08:42 ET
Table 'Capricorn III' 6-max Seat #3 is the button
Seat 1: adilpoker84 ($6.55 in chips) 
Seat 2: rubduckofdeath ($10.83 in chips) 
Seat 3: teddyKK ($20.29 in chips) 
Seat 4: SchuhaRt71 ($24.52 in chips) 
Seat 6: joma620 ($10 in chips) 
SchuhaRt71: posts small blind $0.05
Lovimdzen has timed out while disconnected
Lovimdzen: is sitting out 
joma620: posts big blind $0.10
*** HOLE CARDS ***
adilpoker84 has timed out
adilpoker84: folds 
rubduckofdeath: raises $0.20 to $0.30
teddyKK: raises $0.60 to $0.90
SchuhaRt71: folds 
joma620: folds 
rubduckofdeath: calls $0.60
*** FLOP *** [4s 3c Tc]
rubduckofdeath: checks 
teddyKK: bets $1.10
rubduckofdeath: calls $1.10
*** TURN *** [4s 3c Tc] [4h]
rubduckofdeath: checks 
teddyKK: checks 
*** RIVER *** [4s 3c Tc 4h] [5d]
rubduckofdeath: bets $1.98
teddyKK: calls $1.98
*** SHOW DOWN ***
rubduckofdeath: shows [Qh Th] (two pair, Tens and Fours)
teddyKK: mucks hand 
rubduckofdeath collected $7.75 from pot
*** SUMMARY ***
Total pot $8.11 | Rake $0.36 
Board [4s 3c Tc 4h 5d]
Seat 1: adilpoker84 folded before Flop (didn't bet)
Seat 2: rubduckofdeath showed [Qh Th] and won ($7.75) with two pair, Tens and Fours
Seat 3: teddyKK (button) mucked
Seat 4: SchuhaRt71 (small blind) folded before Flop
Seat 6: joma620 (big blind) folded before Flop



PokerStars Hand #222976982402:  Hold'em No Limit ($0.05/$0.10 USD) - 2021/01/23 18:09:53 ET
Table 'Capricorn III' 6-max Seat #4 is the button
Seat 1: adilpoker84 ($6.55 in chips) 
Seat 2: rubduckofdeath ($14.60 in chips) 
Seat 3: teddyKK ($16.31 in chips) 
Seat 4: SchuhaRt71 ($24.47 in chips) 
Seat 6: joma620 ($10 in chips) 
joma620: posts small blind $0.05
adilpoker84: posts big blind $0.10
*** HOLE CARDS ***
rubduckofdeath: raises $0.20 to $0.30
teddyKK: folds 
teddyKK leaves the table
SchuhaRt71: folds 
joma620: calls $0.25
adilpoker84: calls $0.20
*** FLOP *** [Ad Jd Kc]
joma620: checks 
adilpoker84: checks 
rubduckofdeath: bets $0.43
joma620: folds 
adilpoker84: folds 
Uncalled bet ($0.43) returned to rubduckofdeath
rubduckofdeath collected $0.86 from pot
rubduckofdeath: doesn't show hand 
*** SUMMARY ***
Total pot $0.90 | Rake $0.04 
Board [Ad Jd Kc]
Seat 1: adilpoker84 (big blind) folded on the Flop
Seat 2: rubduckofdeath collected ($0.86)
Seat 3: teddyKK folded before Flop (didn't bet)
Seat 4: SchuhaRt71 (button) folded before Flop (didn't bet)
Seat 6: joma620 (small blind) folded on the Flop



PokerStars Hand #222977015127:  Hold'em No Limit ($0.05/$0.10 USD) - 2021/01/23 18:10:32 ET
Table 'Capricorn III' 6-max Seat #6 is the button
Seat 1: adilpoker84 ($6.25 in chips) 
Seat 2: rubduckofdeath ($15.16 in chips) 
Seat 4: SchuhaRt71 ($24.47 in chips) 
Seat 6: joma620 ($10 in chips) 
adilpoker84: posts small blind $0.05
rubduckofdeath: posts big blind $0.10
*** HOLE CARDS ***
SchuhaRt71: folds 
joma620: folds 
adilpoker84: calls $0.05
rubduckofdeath: checks 
*** FLOP *** [Ks Qs 4s]
adilpoker84: checks 
rubduckofdeath: bets $0.10
adilpoker84: folds 
Uncalled bet ($0.10) returned to rubduckofdeath
rubduckofdeath collected $0.19 from pot
rubduckofdeath: doesn't show hand 
*** SUMMARY ***
Total pot $0.20 | Rake $0.01 
Board [Ks Qs 4s]
Seat 1: adilpoker84 (small blind) folded on the Flop
Seat 2: rubduckofdeath (big blind) collected ($0.19)
Seat 4: SchuhaRt71 folded before Flop (didn't bet)
Seat 6: joma620 (button) folded before Flop (didn't bet)



PokerStars Hand #222977029448:  Hold'em No Limit ($0.05/$0.10 USD) - 2021/01/23 18:10:52 ET
Table 'Capricorn III' 6-max Seat #1 is the button
Seat 1: adilpoker84 ($6.15 in chips) 
Seat 2: rubduckofdeath ($15.25 in chips) 
Seat 6: joma620 ($10 in chips) 
rubduckofdeath: posts small blind $0.05
SchuhaRt71: is sitting out 
joma620: posts big blind $0.10
*** HOLE CARDS ***
adilpoker84: raises $0.10 to $0.20
rubduckofdeath: folds 
joma620: folds 
Uncalled bet ($0.10) returned to adilpoker84
adilpoker84 collected $0.25 from pot
adilpoker84: doesn't show hand 
*** SUMMARY ***
Total pot $0.25 | Rake $0 
Seat 1: adilpoker84 (button) collected ($0.25)
Seat 2: rubduckofdeath (small blind) folded before Flop
Seat 6: joma620 (big blind) folded before Flop



PokerStars Hand #222977033232:  Hold'em No Limit ($0.05/$0.10 USD) - 2021/01/23 18:10:58 ET
Table 'Capricorn III' 6-max Seat #2 is the button
Seat 1: adilpoker84 ($6.30 in chips) 
Seat 2: rubduckofdeath ($15.20 in chips) 
Seat 6: joma620 ($10 in chips) 
joma620: posts small blind $0.05
adilpoker84: posts big blind $0.10
*** HOLE CARDS ***
rubduckofdeath: folds 
joma620: folds 
Uncalled bet ($0.05) returned to adilpoker84
adilpoker84 collected $0.10 from pot
adilpoker84: doesn't show hand 
*** SUMMARY ***
Total pot $0.10 | Rake $0 
Seat 1: adilpoker84 (big blind) collected ($0.10)
Seat 2: rubduckofdeath (button) folded before Flop (didn't bet)
Seat 6: joma620 (small blind) folded before Flop



PokerStars Hand #222977039107:  Hold'em No Limit ($0.05/$0.10 USD) - 2021/01/23 18:11:06 ET
Table 'Capricorn III' 6-max Seat #6 is the button
Seat 1: adilpoker84 ($6.35 in chips) 
Seat 2: rubduckofdeath ($15.20 in chips) 
Seat 6: joma620 ($10 in chips) 
adilpoker84: posts small blind $0.05
rubduckofdeath: posts big blind $0.10
*** HOLE CARDS ***
joma620: folds 
adilpoker84: calls $0.05
rubduckofdeath: checks 
*** FLOP *** [5d Ac 8c]
adilpoker84: checks 
rubduckofdeath: checks 
*** TURN *** [5d Ac 8c] [Jc]
adilpoker84: bets $0.10
rubduckofdeath: folds 
Uncalled bet ($0.10) returned to adilpoker84
adilpoker84 collected $0.19 from pot
adilpoker84: doesn't show hand 
*** SUMMARY ***
Total pot $0.20 | Rake $0.01 
Board [5d Ac 8c Jc]
Seat 1: adilpoker84 (small blind) collected ($0.19)
Seat 2: rubduckofdeath (big blind) folded on the Turn
Seat 6: joma620 (button) folded before Flop (didn't bet)



PokerStars Hand #222977047739:  Hold'em No Limit ($0.05/$0.10 USD) - 2021/01/23 18:11:19 ET
Table 'Capricorn III' 6-max Seat #1 is the button
Seat 1: adilpoker84 ($6.44 in chips) 
Seat 2: rubduckofdeath ($15.10 in chips) 
Seat 6: joma620 ($10 in chips) 
rubduckofdeath: posts small blind $0.05
joma620: posts big blind $0.10
*** HOLE CARDS ***
adilpoker84: calls $0.10
rubduckofdeath: folds 
joma620: checks 
*** FLOP *** [Kd Qs Th]
joma620: checks 
adilpoker84: checks 
*** TURN *** [Kd Qs Th] [Qc]
joma620: checks 
adilpoker84: checks 
*** RIVER *** [Kd Qs Th Qc] [9s]
joma620: bets $0.10
adilpoker84: folds 
Uncalled bet ($0.10) returned to joma620
joma620 collected $0.24 from pot
joma620: doesn't show hand 
*** SUMMARY ***
Total pot $0.25 | Rake $0.01 
Board [Kd Qs Th Qc 9s]
Seat 1: adilpoker84 (button) folded on the River
Seat 2: rubduckofdeath (small blind) folded before Flop
Seat 6: joma620 (big blind) collected ($0.24)



PokerStars Hand #222977065999:  Hold'em No Limit ($0.05/$0.10 USD) - 2021/01/23 18:11:45 ET
Table 'Capricorn III' 6-max Seat #2 is the button
Seat 1: adilpoker84 ($6.34 in chips) 
Seat 2: rubduckofdeath ($15.05 in chips) 
Seat 6: joma620 ($10.14 in chips) 
joma620: posts small blind $0.05
adilpoker84: posts big blind $0.10
*** HOLE CARDS ***
rubduckofdeath: folds 
joma620: folds 
Uncalled bet ($0.05) returned to adilpoker84
adilpoker84 collected $0.10 from pot
adilpoker84: doesn't show hand 
*** SUMMARY ***
Total pot $0.10 | Rake $0 
Seat 1: adilpoker84 (big blind) collected ($0.10)
Seat 2: rubduckofdeath (button) folded before Flop (didn't bet)
Seat 6: joma620 (small blind) folded before Flop



PokerStars Hand #222977074144:  Hold'em No Limit ($0.05/$0.10 USD) - 2021/01/23 18:11:57 ET
Table 'Capricorn III' 6-max Seat #6 is the button
Seat 1: adilpoker84 ($6.39 in chips) 
Seat 2: rubduckofdeath ($15.05 in chips) 
Seat 6: joma620 ($10.09 in chips) 
adilpoker84: posts small blind $0.05
rubduckofdeath: posts big blind $0.10
*** HOLE CARDS ***
joma620: raises $0.20 to $0.30
adilpoker84: raises $0.30 to $0.60
rubduckofdeath: folds 
marcin116 joins the table at seat #3 
joma620: raises $0.80 to $1.40
adilpoker84: raises $1.10 to $2.50
joma620: raises $7.59 to $10.09 and is all-in
adilpoker84: calls $3.89 and is all-in
Uncalled bet ($3.70) returned to joma620
*** FLOP *** [Kd 8c 9h]
*** TURN *** [Kd 8c 9h] [6c]
*** RIVER *** [Kd 8c 9h 6c] [8h]
*** SHOW DOWN ***
adilpoker84: shows [As Js] (a pair of Eights)
joma620: shows [Qh Qc] (two pair, Queens and Eights)
joma620 collected $12.30 from pot
*** SUMMARY ***
Total pot $12.88 | Rake $0.58 
Board [Kd 8c 9h 6c 8h]
Seat 1: adilpoker84 (small blind) showed [As Js] and lost with a pair of Eights
Seat 2: rubduckofdeath (big blind) folded before Flop
Seat 6: joma620 (button) showed [Qh Qc] and won ($12.30) with two pair, Queens and Eights



PokerStars Hand #222977104005:  Hold'em No Limit ($0.05/$0.10 USD) - 2021/01/23 18:12:40 ET
Table 'Capricorn III' 6-max Seat #2 is the button
Seat 2: rubduckofdeath ($14.95 in chips) 
Seat 6: joma620 ($16 in chips) 
rubduckofdeath: posts small blind $0.05
joma620: posts big blind $0.10
*** HOLE CARDS ***
rubduckofdeath: calls $0.05
joma620: checks 
*** FLOP *** [Ks 3c Jd]
adilpoker84 leaves the table
joma620: checks 
rubduckofdeath: checks 
*** TURN *** [Ks 3c Jd] [Qd]
joma620: checks 
rubduckofdeath: bets $0.10
joma620: folds 
Uncalled bet ($0.10) returned to rubduckofdeath
rubduckofdeath collected $0.19 from pot
Lovimdzen was removed from the table for failing to post
Lovimdzen leaves the table
rubduckofdeath: doesn't show hand 
*** SUMMARY ***
Total pot $0.20 | Rake $0.01 
Board [Ks 3c Jd Qd]
Seat 2: rubduckofdeath (button) (small blind) collected ($0.19)
Seat 6: joma620 (big blind) folded on the Turn



PokerStars Hand #222977126161:  Hold'em No Limit ($0.05/$0.10 USD) - 2021/01/23 18:13:13 ET
Table 'Capricorn III' 6-max Seat #2 is the button
Seat 2: rubduckofdeath ($15.04 in chips) 
Seat 3: marcin116 ($10 in chips) 
rubduckofdeath: posts small blind $0.05
marcin116: posts big blind $0.10
*** HOLE CARDS ***
rubduckofdeath: folds 
Uncalled bet ($0.05) returned to marcin116
marcin116 collected $0.10 from pot
marcin116: doesn't show hand 
*** SUMMARY ***
Total pot $0.10 | Rake $0 
Seat 2: rubduckofdeath (button) (small blind) folded before Flop
Seat 3: marcin116 (big blind) collected ($0.10)



PokerStars Hand #222977130097:  Hold'em No Limit ($0.05/$0.10 USD) - 2021/01/23 18:13:18 ET
Table 'Capricorn III' 6-max Seat #3 is the button
Seat 2: rubduckofdeath ($14.99 in chips) 
Seat 3: marcin116 ($10.05 in chips) 
marcin116: posts small blind $0.05
rubduckofdeath: posts big blind $0.10
*** HOLE CARDS ***
marcin116: raises $0.25 to $0.35
rubduckofdeath: folds 
Uncalled bet ($0.25) returned to marcin116
marcin116 collected $0.20 from pot
SchuhaRt71 was removed from the table for failing to post
SchuhaRt71 leaves the table
marcin116: doesn't show hand 
*** SUMMARY ***
Total pot $0.20 | Rake $0 
Seat 2: rubduckofdeath (big blind) folded before Flop
Seat 3: marcin116 (button) (small blind) collected ($0.20)



