PokerStars Hand #222962487859:  Hold'em No Limit ($0.05/$0.10 USD) - 2021/01/23 13:00:16 ET
Table 'Grus IV' 6-max Seat #3 is the button
Seat 3: lolo01337 ($10 in chips) 
Seat 4: Mario Chaves ($10.06 in chips) 
Seat 5: MrBearJew ($6.11 in chips) 
Seat 6: AndriuWasa ($10 in chips) 
Mario Chaves: posts small blind $0.05
MrBearJew: posts big blind $0.10
Lyskamm: sits out 
*** HOLE CARDS ***
AndriuWasa: folds 
lolo01337: folds 
Mario Chaves: folds 
Uncalled bet ($0.05) returned to MrBearJew
MrBearJew collected $0.10 from pot
*** SUMMARY ***
Total pot $0.10 | Rake $0 
Seat 3: lolo01337 (button) folded before Flop (didn't bet)
Seat 4: Mario Chaves (small blind) folded before Flop
Seat 5: MrBearJew (big blind) collected ($0.10)
Seat 6: AndriuWasa folded before Flop (didn't bet)



PokerStars Hand #222962492096:  Hold'em No Limit ($0.05/$0.10 USD) - 2021/01/23 13:00:24 ET
Table 'Grus IV' 6-max Seat #4 is the button
Seat 3: lolo01337 ($10 in chips) 
Seat 4: Mario Chaves ($10.01 in chips) 
Seat 5: MrBearJew ($6.16 in chips) 
Seat 6: AndriuWasa ($10 in chips) 
MrBearJew: posts small blind $0.05
AndriuWasa: posts big blind $0.10
Lyskamm: sits out 
*** HOLE CARDS ***
lolo01337: folds 
Mario Chaves: folds 
MrBearJew: calls $0.05
AndriuWasa: raises $0.30 to $0.40
MrBearJew: calls $0.30
*** FLOP *** [Kc 6c 9c]
MrBearJew: checks 
AndriuWasa: checks 
*** TURN *** [Kc 6c 9c] [Ad]
MrBearJew: checks 
AndriuWasa: bets $0.25
MrBearJew: calls $0.25
*** RIVER *** [Kc 6c 9c Ad] [7h]
MrBearJew: bets $0.62
AndriuWasa: calls $0.62
*** SHOW DOWN ***
MrBearJew: shows [3s As] (a pair of Aces)
AndriuWasa: shows [Ah Js] (a pair of Aces - King+Jack kicker)
AndriuWasa collected $2.43 from pot
*** SUMMARY ***
Total pot $2.54 | Rake $0.11 
Board [Kc 6c 9c Ad 7h]
Seat 3: lolo01337 folded before Flop (didn't bet)
Seat 4: Mario Chaves (button) folded before Flop (didn't bet)
Seat 5: MrBearJew (small blind) showed [3s As] and lost with a pair of Aces
Seat 6: AndriuWasa (big blind) showed [Ah Js] and won ($2.43) with a pair of Aces



PokerStars Hand #222962512370:  Hold'em No Limit ($0.05/$0.10 USD) - 2021/01/23 13:01:01 ET
Table 'Grus IV' 6-max Seat #5 is the button
Seat 1: Lyskamm ($10 in chips) 
Seat 3: lolo01337 ($10 in chips) 
Seat 4: Mario Chaves ($10.01 in chips) 
Seat 5: MrBearJew ($4.89 in chips) 
Seat 6: AndriuWasa ($11.16 in chips) 
AndriuWasa: posts small blind $0.05
Lyskamm: posts big blind $0.10
*** HOLE CARDS ***
lolo01337: folds 
Mario Chaves: folds 
MrBearJew: folds 
AndriuWasa: raises $0.22 to $0.32
Lyskamm: calls $0.22
*** FLOP *** [2c Kc 4s]
AndriuWasa: bets $0.20
Lyskamm: calls $0.20
*** TURN *** [2c Kc 4s] [Ac]
AndriuWasa: checks 
Lyskamm: bets $0.50
AndriuWasa: folds 
Uncalled bet ($0.50) returned to Lyskamm
Lyskamm collected $0.99 from pot
Lyskamm: doesn't show hand 
*** SUMMARY ***
Total pot $1.04 | Rake $0.05 
Board [2c Kc 4s Ac]
Seat 1: Lyskamm (big blind) collected ($0.99)
Seat 3: lolo01337 folded before Flop (didn't bet)
Seat 4: Mario Chaves folded before Flop (didn't bet)
Seat 5: MrBearJew (button) folded before Flop (didn't bet)
Seat 6: AndriuWasa (small blind) folded on the Turn



PokerStars Hand #222962531112:  Hold'em No Limit ($0.05/$0.10 USD) - 2021/01/23 13:01:33 ET
Table 'Grus IV' 6-max Seat #6 is the button
Seat 1: Lyskamm ($10.47 in chips) 
Seat 3: lolo01337 ($10 in chips) 
Seat 4: Mario Chaves ($10.01 in chips) 
Seat 5: MrBearJew ($4.89 in chips) 
Seat 6: AndriuWasa ($10.64 in chips) 
Lyskamm: posts small blind $0.05
lolo01337: posts big blind $0.10
*** HOLE CARDS ***
Mario Chaves: folds 
MrBearJew: folds 
AndriuWasa: folds 
Lyskamm: folds 
Uncalled bet ($0.05) returned to lolo01337
lolo01337 collected $0.10 from pot
lolo01337: doesn't show hand 
*** SUMMARY ***
Total pot $0.10 | Rake $0 
Seat 1: Lyskamm (small blind) folded before Flop
Seat 3: lolo01337 (big blind) collected ($0.10)
Seat 4: Mario Chaves folded before Flop (didn't bet)
Seat 5: MrBearJew folded before Flop (didn't bet)
Seat 6: AndriuWasa (button) folded before Flop (didn't bet)



PokerStars Hand #222962539790:  Hold'em No Limit ($0.05/$0.10 USD) - 2021/01/23 13:01:47 ET
Table 'Grus IV' 6-max Seat #1 is the button
Seat 1: Lyskamm ($10.42 in chips) 
Seat 3: lolo01337 ($10.05 in chips) 
Seat 4: Mario Chaves ($10.01 in chips) 
Seat 5: MrBearJew ($4.89 in chips) 
Seat 6: AndriuWasa ($10.64 in chips) 
lolo01337: posts small blind $0.05
Mario Chaves: posts big blind $0.10
*** HOLE CARDS ***
MrBearJew: folds 
AndriuWasa: folds 
Lyskamm: folds 
lolo01337: folds 
Uncalled bet ($0.05) returned to Mario Chaves
Mario Chaves collected $0.10 from pot
Mario Chaves: doesn't show hand 
*** SUMMARY ***
Total pot $0.10 | Rake $0 
Seat 1: Lyskamm (button) folded before Flop (didn't bet)
Seat 3: lolo01337 (small blind) folded before Flop
Seat 4: Mario Chaves (big blind) collected ($0.10)
Seat 5: MrBearJew folded before Flop (didn't bet)
Seat 6: AndriuWasa folded before Flop (didn't bet)



PokerStars Hand #222962545132:  Hold'em No Limit ($0.05/$0.10 USD) - 2021/01/23 13:01:55 ET
Table 'Grus IV' 6-max Seat #3 is the button
Seat 1: Lyskamm ($10.42 in chips) 
Seat 3: lolo01337 ($10 in chips) 
Seat 4: Mario Chaves ($10.06 in chips) 
Seat 5: MrBearJew ($4.89 in chips) 
Seat 6: AndriuWasa ($10.64 in chips) 
Mario Chaves: posts small blind $0.05
MrBearJew: posts big blind $0.10
*** HOLE CARDS ***
AndriuWasa: folds 
Lyskamm: folds 
lolo01337: raises $0.10 to $0.20
Mario Chaves: folds 
MrBearJew: calls $0.10
*** FLOP *** [Jh 9c Qs]
MrBearJew: bets $0.43
lolo01337: folds 
Uncalled bet ($0.43) returned to MrBearJew
MrBearJew collected $0.43 from pot
*** SUMMARY ***
Total pot $0.45 | Rake $0.02 
Board [Jh 9c Qs]
Seat 1: Lyskamm folded before Flop (didn't bet)
Seat 3: lolo01337 (button) folded on the Flop
Seat 4: Mario Chaves (small blind) folded before Flop
Seat 5: MrBearJew (big blind) collected ($0.43)
Seat 6: AndriuWasa folded before Flop (didn't bet)



PokerStars Hand #222962560131:  Hold'em No Limit ($0.05/$0.10 USD) - 2021/01/23 13:02:18 ET
Table 'Grus IV' 6-max Seat #4 is the button
Seat 1: Lyskamm ($10.42 in chips) 
Seat 3: lolo01337 ($10 in chips) 
Seat 4: Mario Chaves ($10.01 in chips) 
Seat 5: MrBearJew ($5.12 in chips) 
Seat 6: AndriuWasa ($10.64 in chips) 
MrBearJew: posts small blind $0.05
AndriuWasa: posts big blind $0.10
*** HOLE CARDS ***
Lyskamm: folds 
lolo01337: folds 
Mario Chaves: raises $0.20 to $0.30
MrBearJew: folds 
AndriuWasa: calls $0.20
*** FLOP *** [4d 6s 5c]
AndriuWasa: checks 
Mario Chaves: checks 
*** TURN *** [4d 6s 5c] [Kc]
AndriuWasa: checks 
Mario Chaves: bets $0.40
AndriuWasa: folds 
Uncalled bet ($0.40) returned to Mario Chaves
Mario Chaves collected $0.62 from pot
Mario Chaves: doesn't show hand 
*** SUMMARY ***
Total pot $0.65 | Rake $0.03 
Board [4d 6s 5c Kc]
Seat 1: Lyskamm folded before Flop (didn't bet)
Seat 3: lolo01337 folded before Flop (didn't bet)
Seat 4: Mario Chaves (button) collected ($0.62)
Seat 5: MrBearJew (small blind) folded before Flop
Seat 6: AndriuWasa (big blind) folded on the Turn



PokerStars Hand #222962581317:  Hold'em No Limit ($0.05/$0.10 USD) - 2021/01/23 13:02:50 ET
Table 'Grus IV' 6-max Seat #5 is the button
Seat 1: Lyskamm ($10.42 in chips) 
Seat 3: lolo01337 ($10 in chips) 
Seat 4: Mario Chaves ($10.33 in chips) 
Seat 5: MrBearJew ($5.07 in chips) 
Seat 6: AndriuWasa ($10.34 in chips) 
AndriuWasa: posts small blind $0.05
Lyskamm: posts big blind $0.10
*** HOLE CARDS ***
lolo01337: folds 
MrBearJew is disconnected 
Mario Chaves: folds 
MrBearJew has timed out while disconnected
MrBearJew: folds 
AndriuWasa: folds 
Uncalled bet ($0.05) returned to Lyskamm
Lyskamm collected $0.10 from pot
Lyskamm: doesn't show hand 
*** SUMMARY ***
Total pot $0.10 | Rake $0 
Seat 1: Lyskamm (big blind) collected ($0.10)
Seat 3: lolo01337 folded before Flop (didn't bet)
Seat 4: Mario Chaves folded before Flop (didn't bet)
Seat 5: MrBearJew (button) folded before Flop (didn't bet)
Seat 6: AndriuWasa (small blind) folded before Flop



PokerStars Hand #222962593156:  Hold'em No Limit ($0.05/$0.10 USD) - 2021/01/23 13:03:07 ET
Table 'Grus IV' 6-max Seat #6 is the button
Seat 1: Lyskamm ($10.47 in chips) 
Seat 3: lolo01337 ($10 in chips) 
Seat 4: Mario Chaves ($10.33 in chips) 
Seat 6: AndriuWasa ($10.29 in chips) 
Lyskamm: posts small blind $0.05
lolo01337: posts big blind $0.10
*** HOLE CARDS ***
Mario Chaves: folds 
AndriuWasa: folds 
Lyskamm: raises $0.20 to $0.30
lolo01337: calls $0.20
*** FLOP *** [6h 8d Ah]
Lyskamm: bets $0.29
lolo01337: calls $0.29
*** TURN *** [6h 8d Ah] [6d]
Lyskamm: checks 
lolo01337: checks 
*** RIVER *** [6h 8d Ah 6d] [6c]
Lyskamm: checks 
lolo01337: bets $0.34
Lyskamm: folds 
Uncalled bet ($0.34) returned to lolo01337
lolo01337 collected $1.13 from pot
lolo01337: doesn't show hand 
*** SUMMARY ***
Total pot $1.18 | Rake $0.05 
Board [6h 8d Ah 6d 6c]
Seat 1: Lyskamm (small blind) folded on the River
Seat 3: lolo01337 (big blind) collected ($1.13)
Seat 4: Mario Chaves folded before Flop (didn't bet)
Seat 6: AndriuWasa (button) folded before Flop (didn't bet)



PokerStars Hand #222962626386:  Hold'em No Limit ($0.05/$0.10 USD) - 2021/01/23 13:03:56 ET
Table 'Grus IV' 6-max Seat #1 is the button
Seat 1: Lyskamm ($9.88 in chips) 
Seat 3: lolo01337 ($10.54 in chips) 
Seat 4: Mario Chaves ($10.33 in chips) 
Seat 5: MrBearJew ($5.07 in chips) 
Seat 6: AndriuWasa ($10.29 in chips) 
lolo01337: posts small blind $0.05
Mario Chaves: posts big blind $0.10
*** HOLE CARDS ***
MrBearJew: raises $0.25 to $0.35
AndriuWasa: folds 
Lyskamm: folds 
lolo01337: folds 
Mario Chaves: folds 
Uncalled bet ($0.25) returned to MrBearJew
MrBearJew collected $0.25 from pot
*** SUMMARY ***
Total pot $0.25 | Rake $0 
Seat 1: Lyskamm (button) folded before Flop (didn't bet)
Seat 3: lolo01337 (small blind) folded before Flop
Seat 4: Mario Chaves (big blind) folded before Flop
Seat 5: MrBearJew collected ($0.25)
Seat 6: AndriuWasa folded before Flop (didn't bet)



PokerStars Hand #222962637733:  Hold'em No Limit ($0.05/$0.10 USD) - 2021/01/23 13:04:12 ET
Table 'Grus IV' 6-max Seat #3 is the button
Seat 1: Lyskamm ($9.88 in chips) 
Seat 3: lolo01337 ($10.49 in chips) 
Seat 4: Mario Chaves ($10.23 in chips) 
Seat 5: MrBearJew ($5.22 in chips) 
Seat 6: AndriuWasa ($10.29 in chips) 
Mario Chaves: posts small blind $0.05
MrBearJew: posts big blind $0.10
*** HOLE CARDS ***
AndriuWasa: folds 
Lyskamm: folds 
lolo01337: folds 
Mario Chaves: folds 
Uncalled bet ($0.05) returned to MrBearJew
MrBearJew collected $0.10 from pot
*** SUMMARY ***
Total pot $0.10 | Rake $0 
Seat 1: Lyskamm folded before Flop (didn't bet)
Seat 3: lolo01337 (button) folded before Flop (didn't bet)
Seat 4: Mario Chaves (small blind) folded before Flop
Seat 5: MrBearJew (big blind) collected ($0.10)
Seat 6: AndriuWasa folded before Flop (didn't bet)



PokerStars Hand #222962643653:  Hold'em No Limit ($0.05/$0.10 USD) - 2021/01/23 13:04:21 ET
Table 'Grus IV' 6-max Seat #4 is the button
Seat 1: Lyskamm ($9.88 in chips) 
Seat 3: lolo01337 ($10.49 in chips) 
Seat 4: Mario Chaves ($10.18 in chips) 
Seat 5: MrBearJew ($5.27 in chips) 
Seat 6: AndriuWasa ($10.29 in chips) 
MrBearJew: posts small blind $0.05
AndriuWasa: posts big blind $0.10
*** HOLE CARDS ***
Lyskamm: folds 
lolo01337: folds 
Mario Chaves: folds 
MrBearJew: raises $0.10 to $0.20
AndriuWasa: calls $0.10
*** FLOP *** [5d Ks 3d]
MrBearJew: bets $0.10
AndriuWasa: raises $0.31 to $0.41
MrBearJew: folds 
Uncalled bet ($0.31) returned to AndriuWasa
AndriuWasa collected $0.57 from pot
AndriuWasa: doesn't show hand 
*** SUMMARY ***
Total pot $0.60 | Rake $0.03 
Board [5d Ks 3d]
Seat 1: Lyskamm folded before Flop (didn't bet)
Seat 3: lolo01337 folded before Flop (didn't bet)
Seat 4: Mario Chaves (button) folded before Flop (didn't bet)
Seat 5: MrBearJew (small blind) folded on the Flop
Seat 6: AndriuWasa (big blind) collected ($0.57)



PokerStars Hand #222962665004:  Hold'em No Limit ($0.05/$0.10 USD) - 2021/01/23 13:04:52 ET
Table 'Grus IV' 6-max Seat #5 is the button
Seat 1: Lyskamm ($9.88 in chips) 
Seat 3: lolo01337 ($10.49 in chips) 
Seat 4: Mario Chaves ($10.18 in chips) 
Seat 5: MrBearJew ($4.97 in chips) 
Seat 6: AndriuWasa ($10.56 in chips) 
AndriuWasa: posts small blind $0.05
Lyskamm: posts big blind $0.10
*** HOLE CARDS ***
lolo01337: raises $0.20 to $0.30
Mario Chaves: folds 
MrBearJew: calls $0.30
AndriuWasa: folds 
Lyskamm: folds 
*** FLOP *** [5c 6d Ks]
lolo01337: bets $0.22
MrBearJew: folds 
Uncalled bet ($0.22) returned to lolo01337
lolo01337 collected $0.72 from pot
lolo01337: doesn't show hand 
*** SUMMARY ***
Total pot $0.75 | Rake $0.03 
Board [5c 6d Ks]
Seat 1: Lyskamm (big blind) folded before Flop
Seat 3: lolo01337 collected ($0.72)
Seat 4: Mario Chaves folded before Flop (didn't bet)
Seat 5: MrBearJew (button) folded on the Flop
Seat 6: AndriuWasa (small blind) folded before Flop



PokerStars Hand #222962678148:  Hold'em No Limit ($0.05/$0.10 USD) - 2021/01/23 13:05:11 ET
Table 'Grus IV' 6-max Seat #6 is the button
Seat 1: Lyskamm ($9.78 in chips) 
Seat 3: lolo01337 ($10.91 in chips) 
Seat 4: Mario Chaves ($10.18 in chips) 
Seat 5: MrBearJew ($4.67 in chips) 
Seat 6: AndriuWasa ($10.51 in chips) 
Lyskamm: posts small blind $0.05
lolo01337: posts big blind $0.10
*** HOLE CARDS ***
Mario Chaves: raises $0.20 to $0.30
MrBearJew: folds 
AndriuWasa: folds 
Lyskamm: folds 
lolo01337: folds 
Uncalled bet ($0.20) returned to Mario Chaves
Mario Chaves collected $0.25 from pot
handbrake333 was removed from the table for failing to post
handbrake333 leaves the table
Mario Chaves: doesn't show hand 
*** SUMMARY ***
Total pot $0.25 | Rake $0 
Seat 1: Lyskamm (small blind) folded before Flop
Seat 3: lolo01337 (big blind) folded before Flop
Seat 4: Mario Chaves collected ($0.25)
Seat 5: MrBearJew folded before Flop (didn't bet)
Seat 6: AndriuWasa (button) folded before Flop (didn't bet)



PokerStars Hand #222962688015:  Hold'em No Limit ($0.05/$0.10 USD) - 2021/01/23 13:05:25 ET
Table 'Grus IV' 6-max Seat #1 is the button
Seat 1: Lyskamm ($9.73 in chips) 
Seat 3: lolo01337 ($10.81 in chips) 
Seat 4: Mario Chaves ($10.33 in chips) 
Seat 5: MrBearJew ($4.67 in chips) 
Seat 6: AndriuWasa ($10.51 in chips) 
lolo01337: posts small blind $0.05
Mario Chaves: posts big blind $0.10
*** HOLE CARDS ***
dancayamanda joins the table at seat #2 
MrBearJew: folds 
AndriuWasa: folds 
Lyskamm: folds 
lolo01337: folds 
Uncalled bet ($0.05) returned to Mario Chaves
Mario Chaves collected $0.10 from pot
Mario Chaves: doesn't show hand 
*** SUMMARY ***
Total pot $0.10 | Rake $0 
Seat 1: Lyskamm (button) folded before Flop (didn't bet)
Seat 3: lolo01337 (small blind) folded before Flop
Seat 4: Mario Chaves (big blind) collected ($0.10)
Seat 5: MrBearJew folded before Flop (didn't bet)
Seat 6: AndriuWasa folded before Flop (didn't bet)



PokerStars Hand #222962691778:  Hold'em No Limit ($0.05/$0.10 USD) - 2021/01/23 13:05:31 ET
Table 'Grus IV' 6-max Seat #3 is the button
Seat 1: Lyskamm ($9.73 in chips) 
Seat 3: lolo01337 ($10.76 in chips) 
Seat 4: Mario Chaves ($10.38 in chips) 
Seat 5: MrBearJew ($4.67 in chips) 
Seat 6: AndriuWasa ($10.51 in chips) 
Mario Chaves: posts small blind $0.05
MrBearJew: posts big blind $0.10
dancayamanda: sits out 
*** HOLE CARDS ***
AndriuWasa: raises $0.15 to $0.25
Lyskamm: folds 
lolo01337: folds 
Mario Chaves: folds 
MrBearJew: calls $0.15
*** FLOP *** [4s Td Jc]
MrBearJew: bets $0.27
AndriuWasa: calls $0.27
*** TURN *** [4s Td Jc] [4h]
MrBearJew: checks 
AndriuWasa: checks 
*** RIVER *** [4s Td Jc 4h] [6h]
MrBearJew: checks 
AndriuWasa: checks 
*** SHOW DOWN ***
MrBearJew: shows [Qs Kh] (a pair of Fours)
AndriuWasa: shows [Ac Kc] (a pair of Fours - Ace kicker)
AndriuWasa collected $1.04 from pot
*** SUMMARY ***
Total pot $1.09 | Rake $0.05 
Board [4s Td Jc 4h 6h]
Seat 1: Lyskamm folded before Flop (didn't bet)
Seat 3: lolo01337 (button) folded before Flop (didn't bet)
Seat 4: Mario Chaves (small blind) folded before Flop
Seat 5: MrBearJew (big blind) showed [Qs Kh] and lost with a pair of Fours
Seat 6: AndriuWasa showed [Ac Kc] and won ($1.04) with a pair of Fours



PokerStars Hand #222962708042:  Hold'em No Limit ($0.05/$0.10 USD) - 2021/01/23 13:05:54 ET
Table 'Grus IV' 6-max Seat #4 is the button
Seat 1: Lyskamm ($9.73 in chips) 
Seat 3: lolo01337 ($10.76 in chips) 
Seat 4: Mario Chaves ($10.33 in chips) 
Seat 5: MrBearJew ($4.15 in chips) 
Seat 6: AndriuWasa ($11.03 in chips) 
MrBearJew: posts small blind $0.05
AndriuWasa: posts big blind $0.10
dancayamanda: sits out 
*** HOLE CARDS ***
Lyskamm: folds 
lolo01337: folds 
Mario Chaves: raises $0.20 to $0.30
MrBearJew: folds 
AndriuWasa: folds 
Uncalled bet ($0.20) returned to Mario Chaves
Mario Chaves collected $0.25 from pot
Mario Chaves: doesn't show hand 
*** SUMMARY ***
Total pot $0.25 | Rake $0 
Seat 1: Lyskamm folded before Flop (didn't bet)
Seat 3: lolo01337 folded before Flop (didn't bet)
Seat 4: Mario Chaves (button) collected ($0.25)
Seat 5: MrBearJew (small blind) folded before Flop
Seat 6: AndriuWasa (big blind) folded before Flop



PokerStars Hand #222962723438:  Hold'em No Limit ($0.05/$0.10 USD) - 2021/01/23 13:06:16 ET
Table 'Grus IV' 6-max Seat #5 is the button
Seat 1: Lyskamm ($9.73 in chips) 
Seat 3: lolo01337 ($10.76 in chips) 
Seat 4: Mario Chaves ($10.48 in chips) 
Seat 5: MrBearJew ($4.10 in chips) 
Seat 6: AndriuWasa ($10.93 in chips) 
AndriuWasa: posts small blind $0.05
Lyskamm: posts big blind $0.10
dancayamanda: sits out 
*** HOLE CARDS ***
lolo01337: folds 
Mario Chaves: folds 
MrBearJew: folds 
AndriuWasa: raises $0.22 to $0.32
Lyskamm: calls $0.22
*** FLOP *** [5c Jd 2d]
AndriuWasa: bets $0.20
Lyskamm: calls $0.20
*** TURN *** [5c Jd 2d] [7d]
AndriuWasa: bets $0.33
Lyskamm: calls $0.33
*** RIVER *** [5c Jd 2d 7d] [Td]
AndriuWasa: checks 
Lyskamm: checks 
*** SHOW DOWN ***
AndriuWasa: shows [Jh Kh] (a pair of Jacks)
Lyskamm: mucks hand 
AndriuWasa collected $1.62 from pot
*** SUMMARY ***
Total pot $1.70 | Rake $0.08 
Board [5c Jd 2d 7d Td]
Seat 1: Lyskamm (big blind) mucked
Seat 3: lolo01337 folded before Flop (didn't bet)
Seat 4: Mario Chaves folded before Flop (didn't bet)
Seat 5: MrBearJew (button) folded before Flop (didn't bet)
Seat 6: AndriuWasa (small blind) showed [Jh Kh] and won ($1.62) with a pair of Jacks



PokerStars Hand #222962747985:  Hold'em No Limit ($0.05/$0.10 USD) - 2021/01/23 13:06:52 ET
Table 'Grus IV' 6-max Seat #6 is the button
Seat 1: Lyskamm ($8.88 in chips) 
Seat 2: dancayamanda ($10 in chips) 
Seat 3: lolo01337 ($10.76 in chips) 
Seat 4: Mario Chaves ($10.48 in chips) 
Seat 5: MrBearJew ($4.10 in chips) 
Seat 6: AndriuWasa ($11.70 in chips) 
Lyskamm: posts small blind $0.05
dancayamanda: posts big blind $0.10
*** HOLE CARDS ***
lolo01337: folds 
Mario Chaves: folds 
MrBearJew: raises $0.25 to $0.35
AndriuWasa: folds 
Lyskamm: folds 
dancayamanda: calls $0.25
*** FLOP *** [3d Ac 4s]
dancayamanda: checks 
MrBearJew: bets $0.36
dancayamanda: folds 
Uncalled bet ($0.36) returned to MrBearJew
MrBearJew collected $0.72 from pot
*** SUMMARY ***
Total pot $0.75 | Rake $0.03 
Board [3d Ac 4s]
Seat 1: Lyskamm (small blind) folded before Flop
Seat 2: dancayamanda (big blind) folded on the Flop
Seat 3: lolo01337 folded before Flop (didn't bet)
Seat 4: Mario Chaves folded before Flop (didn't bet)
Seat 5: MrBearJew collected ($0.72)
Seat 6: AndriuWasa (button) folded before Flop (didn't bet)



PokerStars Hand #222962773677:  Hold'em No Limit ($0.05/$0.10 USD) - 2021/01/23 13:07:29 ET
Table 'Grus IV' 6-max Seat #1 is the button
Seat 1: Lyskamm ($8.83 in chips) 
Seat 2: dancayamanda ($10 in chips) 
Seat 3: lolo01337 ($10.76 in chips) 
Seat 4: Mario Chaves ($10.48 in chips) 
Seat 5: MrBearJew ($4.47 in chips) 
Seat 6: AndriuWasa ($11.70 in chips) 
dancayamanda: posts small blind $0.05
lolo01337: posts big blind $0.10
*** HOLE CARDS ***
Mario Chaves: folds 
MrBearJew: folds 
AndriuWasa: folds 
Lyskamm: raises $0.20 to $0.30
dancayamanda: raises $0.60 to $0.90
lolo01337: folds 
Lyskamm: folds 
Uncalled bet ($0.60) returned to dancayamanda
dancayamanda collected $0.70 from pot
dancayamanda: doesn't show hand 
*** SUMMARY ***
Total pot $0.70 | Rake $0 
Seat 1: Lyskamm (button) folded before Flop
Seat 2: dancayamanda (small blind) collected ($0.70)
Seat 3: lolo01337 (big blind) folded before Flop
Seat 4: Mario Chaves folded before Flop (didn't bet)
Seat 5: MrBearJew folded before Flop (didn't bet)
Seat 6: AndriuWasa folded before Flop (didn't bet)



PokerStars Hand #222962791135:  Hold'em No Limit ($0.05/$0.10 USD) - 2021/01/23 13:07:55 ET
Table 'Grus IV' 6-max Seat #2 is the button
Seat 1: Lyskamm ($8.53 in chips) 
Seat 2: dancayamanda ($10.40 in chips) 
Seat 3: lolo01337 ($10.66 in chips) 
Seat 4: Mario Chaves ($10.48 in chips) 
Seat 5: MrBearJew ($4.47 in chips) 
Seat 6: AndriuWasa ($11.70 in chips) 
lolo01337: posts small blind $0.05
Mario Chaves: posts big blind $0.10
*** HOLE CARDS ***
MrBearJew: raises $0.10 to $0.20
AndriuWasa: folds 
Lyskamm: folds 
dancayamanda: raises $0.50 to $0.70
lolo01337: folds 
Mario Chaves: folds 
MrBearJew: calls $0.50
*** FLOP *** [4h 7h 5d]
MrBearJew: checks 
dancayamanda: checks 
*** TURN *** [4h 7h 5d] [Tc]
MrBearJew: bets $1.48
dancayamanda: folds 
Uncalled bet ($1.48) returned to MrBearJew
MrBearJew collected $1.48 from pot
*** SUMMARY ***
Total pot $1.55 | Rake $0.07 
Board [4h 7h 5d Tc]
Seat 1: Lyskamm folded before Flop (didn't bet)
Seat 2: dancayamanda (button) folded on the Turn
Seat 3: lolo01337 (small blind) folded before Flop
Seat 4: Mario Chaves (big blind) folded before Flop
Seat 5: MrBearJew collected ($1.48)
Seat 6: AndriuWasa folded before Flop (didn't bet)



PokerStars Hand #222962828568:  Hold'em No Limit ($0.05/$0.10 USD) - 2021/01/23 13:08:49 ET
Table 'Grus IV' 6-max Seat #3 is the button
Seat 1: Lyskamm ($8.53 in chips) 
Seat 2: dancayamanda ($10 in chips) 
Seat 3: lolo01337 ($10.61 in chips) 
Seat 4: Mario Chaves ($10.38 in chips) 
Seat 5: MrBearJew ($5.25 in chips) 
Seat 6: AndriuWasa ($11.70 in chips) 
Mario Chaves: posts small blind $0.05
MrBearJew: posts big blind $0.10
*** HOLE CARDS ***
AndriuWasa: folds 
Lyskamm: folds 
dancayamanda: folds 
lolo01337: folds 
Mario Chaves: folds 
Uncalled bet ($0.05) returned to MrBearJew
MrBearJew collected $0.10 from pot
*** SUMMARY ***
Total pot $0.10 | Rake $0 
Seat 1: Lyskamm folded before Flop (didn't bet)
Seat 2: dancayamanda folded before Flop (didn't bet)
Seat 3: lolo01337 (button) folded before Flop (didn't bet)
Seat 4: Mario Chaves (small blind) folded before Flop
Seat 5: MrBearJew (big blind) collected ($0.10)
Seat 6: AndriuWasa folded before Flop (didn't bet)



PokerStars Hand #222962835892:  Hold'em No Limit ($0.05/$0.10 USD) - 2021/01/23 13:09:00 ET
Table 'Grus IV' 6-max Seat #4 is the button
Seat 1: Lyskamm ($8.53 in chips) 
Seat 2: dancayamanda ($10 in chips) 
Seat 3: lolo01337 ($10.61 in chips) 
Seat 4: Mario Chaves ($10.33 in chips) 
Seat 5: MrBearJew ($5.30 in chips) 
Seat 6: AndriuWasa ($11.70 in chips) 
MrBearJew: posts small blind $0.05
AndriuWasa: posts big blind $0.10
*** HOLE CARDS ***
Lyskamm: folds 
dancayamanda: folds 
lolo01337: folds 
Mario Chaves: folds 
MrBearJew: raises $0.10 to $0.20
AndriuWasa: calls $0.10
*** FLOP *** [3h Kc 4h]
MrBearJew: bets $0.10
AndriuWasa: folds 
Uncalled bet ($0.10) returned to MrBearJew
MrBearJew collected $0.38 from pot
*** SUMMARY ***
Total pot $0.40 | Rake $0.02 
Board [3h Kc 4h]
Seat 1: Lyskamm folded before Flop (didn't bet)
Seat 2: dancayamanda folded before Flop (didn't bet)
Seat 3: lolo01337 folded before Flop (didn't bet)
Seat 4: Mario Chaves (button) folded before Flop (didn't bet)
Seat 5: MrBearJew (small blind) collected ($0.38)
Seat 6: AndriuWasa (big blind) folded on the Flop



PokerStars Hand #222962851840:  Hold'em No Limit ($0.05/$0.10 USD) - 2021/01/23 13:09:23 ET
Table 'Grus IV' 6-max Seat #5 is the button
Seat 1: Lyskamm ($8.53 in chips) 
Seat 2: dancayamanda ($10 in chips) 
Seat 3: lolo01337 ($10.61 in chips) 
Seat 4: Mario Chaves ($10.33 in chips) 
Seat 5: MrBearJew ($5.48 in chips) 
Seat 6: AndriuWasa ($11.50 in chips) 
AndriuWasa: posts small blind $0.05
Lyskamm: posts big blind $0.10
*** HOLE CARDS ***
dancayamanda: folds 
lolo01337: folds 
Mario Chaves: folds 
MrBearJew: folds 
AndriuWasa: folds 
Uncalled bet ($0.05) returned to Lyskamm
Lyskamm collected $0.10 from pot
Lyskamm: doesn't show hand 
*** SUMMARY ***
Total pot $0.10 | Rake $0 
Seat 1: Lyskamm (big blind) collected ($0.10)
Seat 2: dancayamanda folded before Flop (didn't bet)
Seat 3: lolo01337 folded before Flop (didn't bet)
Seat 4: Mario Chaves folded before Flop (didn't bet)
Seat 5: MrBearJew (button) folded before Flop (didn't bet)
Seat 6: AndriuWasa (small blind) folded before Flop



PokerStars Hand #222962863371:  Hold'em No Limit ($0.05/$0.10 USD) - 2021/01/23 13:09:40 ET
Table 'Grus IV' 6-max Seat #6 is the button
Seat 1: Lyskamm ($8.58 in chips) 
Seat 2: dancayamanda ($10 in chips) 
Seat 3: lolo01337 ($10.61 in chips) 
Seat 4: Mario Chaves ($10.33 in chips) 
Seat 5: MrBearJew ($5.48 in chips) 
Seat 6: AndriuWasa ($11.45 in chips) 
Lyskamm: posts small blind $0.05
dancayamanda: posts big blind $0.10
*** HOLE CARDS ***
lolo01337: folds 
Mario Chaves: raises $0.20 to $0.30
MrBearJew: calls $0.30
AndriuWasa: folds 
Lyskamm: folds 
dancayamanda: folds 
*** FLOP *** [6h Ac Ah]
Mario Chaves: checks 
MrBearJew: checks 
*** TURN *** [6h Ac Ah] [8c]
Mario Chaves: checks 
MrBearJew: bets $0.36
Mario Chaves: calls $0.36
*** RIVER *** [6h Ac Ah 8c] [6s]
Mario Chaves: checks 
MrBearJew: checks 
*** SHOW DOWN ***
Mario Chaves: shows [As Ad] (four of a kind, Aces)
MrBearJew: mucks hand 
Mario Chaves collected $1.40 from pot
*** SUMMARY ***
Total pot $1.47 | Rake $0.07 
Board [6h Ac Ah 8c 6s]
Seat 1: Lyskamm (small blind) folded before Flop
Seat 2: dancayamanda (big blind) folded before Flop
Seat 3: lolo01337 folded before Flop (didn't bet)
Seat 4: Mario Chaves showed [As Ad] and won ($1.40) with four of a kind, Aces
Seat 5: MrBearJew mucked
Seat 6: AndriuWasa (button) folded before Flop (didn't bet)



PokerStars Hand #222962901502:  Hold'em No Limit ($0.05/$0.10 USD) - 2021/01/23 13:10:35 ET
Table 'Grus IV' 6-max Seat #1 is the button
Seat 1: Lyskamm ($8.53 in chips) 
Seat 2: dancayamanda ($10 in chips) 
Seat 3: lolo01337 ($10.61 in chips) 
Seat 4: Mario Chaves ($11.07 in chips) 
Seat 5: MrBearJew ($4.82 in chips) 
Seat 6: AndriuWasa ($11.45 in chips) 
dancayamanda: posts small blind $0.05
lolo01337: posts big blind $0.10
*** HOLE CARDS ***
Mario Chaves: folds 
MrBearJew: calls $0.10
AndriuWasa: folds 
Lyskamm: folds 
dancayamanda: raises $0.30 to $0.40
lolo01337: folds 
MrBearJew: calls $0.30
*** FLOP *** [8c Jd Th]
lolo01337 leaves the table
Fimzik joins the table at seat #3 
dancayamanda: checks 
MrBearJew: checks 
*** TURN *** [8c Jd Th] [Jh]
dancayamanda: bets $0.65
MrBearJew: folds 
Uncalled bet ($0.65) returned to dancayamanda
dancayamanda collected $0.86 from pot
dancayamanda: doesn't show hand 
*** SUMMARY ***
Total pot $0.90 | Rake $0.04 
Board [8c Jd Th Jh]
Seat 1: Lyskamm (button) folded before Flop (didn't bet)
Seat 2: dancayamanda (small blind) collected ($0.86)
Seat 3: lolo01337 (big blind) folded before Flop
Seat 4: Mario Chaves folded before Flop (didn't bet)
Seat 5: MrBearJew folded on the Turn
Seat 6: AndriuWasa folded before Flop (didn't bet)



PokerStars Hand #222962940640:  Hold'em No Limit ($0.05/$0.10 USD) - 2021/01/23 13:11:32 ET
Table 'Grus IV' 6-max Seat #2 is the button
Seat 1: Lyskamm ($8.53 in chips) 
Seat 2: dancayamanda ($10.46 in chips) 
Seat 4: Mario Chaves ($11.07 in chips) 
Seat 5: MrBearJew ($4.42 in chips) 
Seat 6: AndriuWasa ($11.45 in chips) 
Mario Chaves: posts small blind $0.05
MrBearJew: posts big blind $0.10
*** HOLE CARDS ***
AndriuWasa: folds 
Lyskamm: folds 
dancayamanda: raises $0.15 to $0.25
Mario Chaves: folds 
MrBearJew: raises $0.65 to $0.90
dancayamanda: folds 
Uncalled bet ($0.65) returned to MrBearJew
MrBearJew collected $0.55 from pot
*** SUMMARY ***
Total pot $0.55 | Rake $0 
Seat 1: Lyskamm folded before Flop (didn't bet)
Seat 2: dancayamanda (button) folded before Flop
Seat 4: Mario Chaves (small blind) folded before Flop
Seat 5: MrBearJew (big blind) collected ($0.55)
Seat 6: AndriuWasa folded before Flop (didn't bet)



PokerStars Hand #222962961411:  Hold'em No Limit ($0.05/$0.10 USD) - 2021/01/23 13:12:03 ET
Table 'Grus IV' 6-max Seat #4 is the button
Seat 1: Lyskamm ($8.53 in chips) 
Seat 2: dancayamanda ($10.21 in chips) 
Seat 4: Mario Chaves ($11.02 in chips) 
Seat 5: MrBearJew ($4.72 in chips) 
Seat 6: AndriuWasa ($11.45 in chips) 
MrBearJew: posts small blind $0.05
AndriuWasa: posts big blind $0.10
Fimzik: sits out 
*** HOLE CARDS ***
Lyskamm: folds 
dancayamanda: raises $0.15 to $0.25
Mario Chaves: folds 
MrBearJew: folds 
AndriuWasa: raises $0.85 to $1.10
dancayamanda: folds 
Uncalled bet ($0.85) returned to AndriuWasa
AndriuWasa collected $0.55 from pot
AndriuWasa: doesn't show hand 
*** SUMMARY ***
Total pot $0.55 | Rake $0 
Seat 1: Lyskamm folded before Flop (didn't bet)
Seat 2: dancayamanda folded before Flop
Seat 4: Mario Chaves (button) folded before Flop (didn't bet)
Seat 5: MrBearJew (small blind) folded before Flop
Seat 6: AndriuWasa (big blind) collected ($0.55)



PokerStars Hand #222962979848:  Hold'em No Limit ($0.05/$0.10 USD) - 2021/01/23 13:12:30 ET
Table 'Grus IV' 6-max Seat #5 is the button
Seat 1: Lyskamm ($8.53 in chips) 
Seat 2: dancayamanda ($10 in chips) 
Seat 4: Mario Chaves ($11.02 in chips) 
Seat 5: MrBearJew ($4.67 in chips) 
Seat 6: AndriuWasa ($11.75 in chips) 
AndriuWasa: posts small blind $0.05
Lyskamm: posts big blind $0.10
Fimzik: sits out 
*** HOLE CARDS ***
dancayamanda: folds 
Mario Chaves: folds 
MrBearJew: calls $0.10
AndriuWasa: raises $0.45 to $0.55
Lyskamm: folds 
MrBearJew: calls $0.45
*** FLOP *** [9d Kh 5s]
AndriuWasa: checks 
MrBearJew: bets $0.58
AndriuWasa: calls $0.58
*** TURN *** [9d Kh 5s] [2s]
AndriuWasa: checks 
MrBearJew: bets $1.13
AndriuWasa: folds 
Uncalled bet ($1.13) returned to MrBearJew
MrBearJew collected $2.25 from pot
*** SUMMARY ***
Total pot $2.36 | Rake $0.11 
Board [9d Kh 5s 2s]
Seat 1: Lyskamm (big blind) folded before Flop
Seat 2: dancayamanda folded before Flop (didn't bet)
Seat 4: Mario Chaves folded before Flop (didn't bet)
Seat 5: MrBearJew (button) collected ($2.25)
Seat 6: AndriuWasa (small blind) folded on the Turn



PokerStars Hand #222963026995:  Hold'em No Limit ($0.05/$0.10 USD) - 2021/01/23 13:13:38 ET
Table 'Grus IV' 6-max Seat #6 is the button
Seat 1: Lyskamm ($8.43 in chips) 
Seat 2: dancayamanda ($10 in chips) 
Seat 4: Mario Chaves ($11.02 in chips) 
Seat 5: MrBearJew ($5.79 in chips) 
Seat 6: AndriuWasa ($10.62 in chips) 
Lyskamm: posts small blind $0.05
dancayamanda: posts big blind $0.10
Fimzik: sits out 
*** HOLE CARDS ***
Mario Chaves: folds 
MrBearJew: calls $0.10
AndriuWasa: folds 
Lyskamm: folds 
dancayamanda: checks 
*** FLOP *** [9c Qd Jd]
dancayamanda: checks 
MrBearJew: checks 
*** TURN *** [9c Qd Jd] [Ad]
dancayamanda: checks 
MrBearJew: checks 
*** RIVER *** [9c Qd Jd Ad] [Qs]
dancayamanda: checks 
MrBearJew: checks 
*** SHOW DOWN ***
dancayamanda: shows [5s 2h] (a pair of Queens)
MrBearJew: shows [6s 9s] (two pair, Queens and Nines)
MrBearJew collected $0.24 from pot
*** SUMMARY ***
Total pot $0.25 | Rake $0.01 
Board [9c Qd Jd Ad Qs]
Seat 1: Lyskamm (small blind) folded before Flop
Seat 2: dancayamanda (big blind) showed [5s 2h] and lost with a pair of Queens
Seat 4: Mario Chaves folded before Flop (didn't bet)
Seat 5: MrBearJew showed [6s 9s] and won ($0.24) with two pair, Queens and Nines
Seat 6: AndriuWasa (button) folded before Flop (didn't bet)



PokerStars Hand #222963049507:  Hold'em No Limit ($0.05/$0.10 USD) - 2021/01/23 13:14:11 ET
Table 'Grus IV' 6-max Seat #1 is the button
Seat 1: Lyskamm ($8.38 in chips) 
Seat 2: dancayamanda ($10 in chips) 
Seat 3: Fimzik ($10 in chips) 
Seat 4: Mario Chaves ($11.02 in chips) 
Seat 5: MrBearJew ($5.93 in chips) 
Seat 6: AndriuWasa ($10.62 in chips) 
dancayamanda: posts small blind $0.05
Fimzik: posts big blind $0.10
*** HOLE CARDS ***
Mario Chaves: folds 
MrBearJew: raises $5.83 to $5.93 and is all-in
AndriuWasa: folds 
Lyskamm: folds 
dancayamanda: folds 
Fimzik: folds 
Uncalled bet ($5.83) returned to MrBearJew
MrBearJew collected $0.25 from pot
*** SUMMARY ***
Total pot $0.25 | Rake $0 
Seat 1: Lyskamm (button) folded before Flop (didn't bet)
Seat 2: dancayamanda (small blind) folded before Flop
Seat 3: Fimzik (big blind) folded before Flop
Seat 4: Mario Chaves folded before Flop (didn't bet)
Seat 5: MrBearJew collected ($0.25)
Seat 6: AndriuWasa folded before Flop (didn't bet)



PokerStars Hand #222963059989:  Hold'em No Limit ($0.05/$0.10 USD) - 2021/01/23 13:14:27 ET
Table 'Grus IV' 6-max Seat #2 is the button
Seat 1: Lyskamm ($8.38 in chips) 
Seat 2: dancayamanda ($10 in chips) 
Seat 3: Fimzik ($10 in chips) 
Seat 4: Mario Chaves ($11.02 in chips) 
Seat 5: MrBearJew ($6.08 in chips) 
Seat 6: AndriuWasa ($10.62 in chips) 
Fimzik: posts small blind $0.05
Mario Chaves: posts big blind $0.10
*** HOLE CARDS ***
MrBearJew: calls $0.10
AndriuWasa: folds 
Lyskamm: folds 
dancayamanda: folds 
Fimzik: folds 
Mario Chaves: checks 
*** FLOP *** [3s 6h 5d]
Mario Chaves: checks 
MrBearJew: checks 
*** TURN *** [3s 6h 5d] [Qs]
Mario Chaves: bets $0.20
MrBearJew: calls $0.20
*** RIVER *** [3s 6h 5d Qs] [9h]
Mario Chaves: bets $1.80
MrBearJew: folds 
Uncalled bet ($1.80) returned to Mario Chaves
Mario Chaves collected $0.62 from pot
Mario Chaves: doesn't show hand 
*** SUMMARY ***
Total pot $0.65 | Rake $0.03 
Board [3s 6h 5d Qs 9h]
Seat 1: Lyskamm folded before Flop (didn't bet)
Seat 2: dancayamanda (button) folded before Flop (didn't bet)
Seat 3: Fimzik (small blind) folded before Flop
Seat 4: Mario Chaves (big blind) collected ($0.62)
Seat 5: MrBearJew folded on the River
Seat 6: AndriuWasa folded before Flop (didn't bet)



PokerStars Hand #222963090243:  Hold'em No Limit ($0.05/$0.10 USD) - 2021/01/23 13:14:59 ET
Table 'Grus IV' 6-max Seat #3 is the button
Seat 1: Lyskamm ($8.38 in chips) 
Seat 2: dancayamanda ($10 in chips) 
Seat 3: Fimzik ($10 in chips) 
Seat 4: Mario Chaves ($11.34 in chips) 
Seat 5: MrBearJew ($5.78 in chips) 
Seat 6: AndriuWasa ($10.62 in chips) 
Mario Chaves: posts small blind $0.05
MrBearJew: posts big blind $0.10
*** HOLE CARDS ***
AndriuWasa: raises $0.15 to $0.25
Lyskamm: folds 
dancayamanda: folds 
Fimzik: folds 
Mario Chaves: folds 
MrBearJew: calls $0.15
*** FLOP *** [9c Jh 4c]
MrBearJew: bets $0.53
AndriuWasa: folds 
Uncalled bet ($0.53) returned to MrBearJew
MrBearJew collected $0.53 from pot
*** SUMMARY ***
Total pot $0.55 | Rake $0.02 
Board [9c Jh 4c]
Seat 1: Lyskamm folded before Flop (didn't bet)
Seat 2: dancayamanda folded before Flop (didn't bet)
Seat 3: Fimzik (button) folded before Flop (didn't bet)
Seat 4: Mario Chaves (small blind) folded before Flop
Seat 5: MrBearJew (big blind) collected ($0.53)
Seat 6: AndriuWasa folded on the Flop



PokerStars Hand #222963105309:  Hold'em No Limit ($0.05/$0.10 USD) - 2021/01/23 13:15:19 ET
Table 'Grus IV' 6-max Seat #4 is the button
Seat 1: Lyskamm ($8.38 in chips) 
Seat 2: dancayamanda ($10 in chips) 
Seat 3: Fimzik ($10 in chips) 
Seat 4: Mario Chaves ($11.29 in chips) 
Seat 5: MrBearJew ($6.06 in chips) 
Seat 6: AndriuWasa ($10.37 in chips) 
MrBearJew: posts small blind $0.05
AndriuWasa: posts big blind $0.10
*** HOLE CARDS ***
Lyskamm: folds 
dancayamanda: folds 
Fimzik: folds 
Mario Chaves: folds 
MrBearJew: folds 
Uncalled bet ($0.05) returned to AndriuWasa
AndriuWasa collected $0.10 from pot
AndriuWasa: doesn't show hand 
*** SUMMARY ***
Total pot $0.10 | Rake $0 
Seat 1: Lyskamm folded before Flop (didn't bet)
Seat 2: dancayamanda folded before Flop (didn't bet)
Seat 3: Fimzik folded before Flop (didn't bet)
Seat 4: Mario Chaves (button) folded before Flop (didn't bet)
Seat 5: MrBearJew (small blind) folded before Flop
Seat 6: AndriuWasa (big blind) collected ($0.10)



PokerStars Hand #222963119125:  Hold'em No Limit ($0.05/$0.10 USD) - 2021/01/23 13:15:38 ET
Table 'Grus IV' 6-max Seat #5 is the button
Seat 1: Lyskamm ($8.38 in chips) 
Seat 2: dancayamanda ($10 in chips) 
Seat 3: Fimzik ($10 in chips) 
Seat 4: Mario Chaves ($11.29 in chips) 
Seat 5: MrBearJew ($6.01 in chips) 
Seat 6: AndriuWasa ($10.42 in chips) 
AndriuWasa: posts small blind $0.05
Lyskamm: posts big blind $0.10
*** HOLE CARDS ***
dancayamanda: folds 
Fimzik: raises $0.15 to $0.25
Mario Chaves: folds 
MrBearJew: folds 
AndriuWasa: folds 
Lyskamm: folds 
Uncalled bet ($0.15) returned to Fimzik
Fimzik collected $0.25 from pot
Fimzik: doesn't show hand 
*** SUMMARY ***
Total pot $0.25 | Rake $0 
Seat 1: Lyskamm (big blind) folded before Flop
Seat 2: dancayamanda folded before Flop (didn't bet)
Seat 3: Fimzik collected ($0.25)
Seat 4: Mario Chaves folded before Flop (didn't bet)
Seat 5: MrBearJew (button) folded before Flop (didn't bet)
Seat 6: AndriuWasa (small blind) folded before Flop



PokerStars Hand #222963127117:  Hold'em No Limit ($0.05/$0.10 USD) - 2021/01/23 13:15:49 ET
Table 'Grus IV' 6-max Seat #6 is the button
Seat 1: Lyskamm ($8.28 in chips) 
Seat 2: dancayamanda ($10 in chips) 
Seat 3: Fimzik ($10.15 in chips) 
Seat 4: Mario Chaves ($11.29 in chips) 
Seat 5: MrBearJew ($6.01 in chips) 
Seat 6: AndriuWasa ($10.37 in chips) 
Lyskamm: posts small blind $0.05
dancayamanda: posts big blind $0.10
*** HOLE CARDS ***
Fimzik: folds 
Mario Chaves: raises $0.20 to $0.30
MrBearJew: calls $0.30
AndriuWasa: folds 
Lyskamm: folds 
dancayamanda: calls $0.20
*** FLOP *** [7d 7s 5c]
dancayamanda: checks 
Mario Chaves: bets $0.40
MrBearJew: folds 
dancayamanda: calls $0.40
*** TURN *** [7d 7s 5c] [5h]
dancayamanda: checks 
Mario Chaves: bets $0.47
dancayamanda: calls $0.47
*** RIVER *** [7d 7s 5c 5h] [3c]
dancayamanda: checks 
Mario Chaves: bets $0.40
dancayamanda: raises $1.11 to $1.51
Mario Chaves: calls $1.11
*** SHOW DOWN ***
dancayamanda: shows [8s 8h] (two pair, Eights and Sevens)
Mario Chaves: shows [Ts Tc] (two pair, Tens and Sevens)
Mario Chaves collected $5.45 from pot
*** SUMMARY ***
Total pot $5.71 | Rake $0.26 
Board [7d 7s 5c 5h 3c]
Seat 1: Lyskamm (small blind) folded before Flop
Seat 2: dancayamanda (big blind) showed [8s 8h] and lost with two pair, Eights and Sevens
Seat 3: Fimzik folded before Flop (didn't bet)
Seat 4: Mario Chaves showed [Ts Tc] and won ($5.45) with two pair, Tens and Sevens
Seat 5: MrBearJew folded on the Flop
Seat 6: AndriuWasa (button) folded before Flop (didn't bet)



PokerStars Hand #222963216342:  Hold'em No Limit ($0.05/$0.10 USD) - 2021/01/23 13:17:39 ET
Table 'Grus IV' 6-max Seat #1 is the button
Seat 1: Lyskamm ($8.23 in chips) 
Seat 2: dancayamanda ($10 in chips) 
Seat 3: Fimzik ($10.15 in chips) 
Seat 4: Mario Chaves ($14.06 in chips) 
Seat 5: MrBearJew ($5.71 in chips) 
Seat 6: AndriuWasa ($10.37 in chips) 
dancayamanda: posts small blind $0.05
Fimzik: posts big blind $0.10
*** HOLE CARDS ***
Mario Chaves: folds 
MrBearJew: folds 
AndriuWasa: folds 
Lyskamm: folds 
dancayamanda: raises $0.20 to $0.30
Fimzik: raises $0.60 to $0.90
dancayamanda: folds 
Uncalled bet ($0.60) returned to Fimzik
Fimzik collected $0.60 from pot
Fimzik: doesn't show hand 
*** SUMMARY ***
Total pot $0.60 | Rake $0 
Seat 1: Lyskamm (button) folded before Flop (didn't bet)
Seat 2: dancayamanda (small blind) folded before Flop
Seat 3: Fimzik (big blind) collected ($0.60)
Seat 4: Mario Chaves folded before Flop (didn't bet)
Seat 5: MrBearJew folded before Flop (didn't bet)
Seat 6: AndriuWasa folded before Flop (didn't bet)



PokerStars Hand #222963233547:  Hold'em No Limit ($0.05/$0.10 USD) - 2021/01/23 13:18:02 ET
Table 'Grus IV' 6-max Seat #2 is the button
Seat 1: Lyskamm ($8.23 in chips) 
Seat 2: dancayamanda ($10 in chips) 
Seat 3: Fimzik ($10.45 in chips) 
Seat 4: Mario Chaves ($14.06 in chips) 
Seat 5: MrBearJew ($5.71 in chips) 
Seat 6: AndriuWasa ($10.37 in chips) 
Fimzik: posts small blind $0.05
Mario Chaves: posts big blind $0.10
*** HOLE CARDS ***
MrBearJew: folds 
AndriuWasa is disconnected 
AndriuWasa is connected 
AndriuWasa: folds 
Lyskamm: raises $0.20 to $0.30
dancayamanda: folds 
Fimzik: folds 
Mario Chaves: raises $0.60 to $0.90
Lyskamm: folds 
Uncalled bet ($0.60) returned to Mario Chaves
Mario Chaves collected $0.65 from pot
Mario Chaves: doesn't show hand 
*** SUMMARY ***
Total pot $0.65 | Rake $0 
Seat 1: Lyskamm folded before Flop
Seat 2: dancayamanda (button) folded before Flop (didn't bet)
Seat 3: Fimzik (small blind) folded before Flop
Seat 4: Mario Chaves (big blind) collected ($0.65)
Seat 5: MrBearJew folded before Flop (didn't bet)
Seat 6: AndriuWasa folded before Flop (didn't bet)



PokerStars Hand #222963262759:  Hold'em No Limit ($0.05/$0.10 USD) - 2021/01/23 13:18:41 ET
Table 'Grus IV' 6-max Seat #3 is the button
Seat 1: Lyskamm ($7.93 in chips) 
Seat 2: dancayamanda ($10 in chips) 
Seat 3: Fimzik ($10.40 in chips) 
Seat 4: Mario Chaves ($14.41 in chips) 
Seat 5: MrBearJew ($5.71 in chips) 
Seat 6: AndriuWasa ($10.37 in chips) 
Mario Chaves: posts small blind $0.05
MrBearJew: posts big blind $0.10
*** HOLE CARDS ***
AndriuWasa: folds 
Lyskamm: raises $0.20 to $0.30
dancayamanda: folds 
Fimzik: folds 
Mario Chaves: folds 
MrBearJew: calls $0.20
*** FLOP *** [5d 9h 7d]
MrBearJew: bets $0.31
Lyskamm: calls $0.31
*** TURN *** [5d 9h 7d] [4c]
MrBearJew: bets $0.61
Lyskamm: calls $0.61
*** RIVER *** [5d 9h 7d 4c] [3h]
MrBearJew: checks 
Lyskamm: bets $0.79
MrBearJew: folds 
Uncalled bet ($0.79) returned to Lyskamm
Lyskamm collected $2.38 from pot
Lyskamm: doesn't show hand 
*** SUMMARY ***
Total pot $2.49 | Rake $0.11 
Board [5d 9h 7d 4c 3h]
Seat 1: Lyskamm collected ($2.38)
Seat 2: dancayamanda folded before Flop (didn't bet)
Seat 3: Fimzik (button) folded before Flop (didn't bet)
Seat 4: Mario Chaves (small blind) folded before Flop
Seat 5: MrBearJew (big blind) folded on the River
Seat 6: AndriuWasa folded before Flop (didn't bet)



PokerStars Hand #222963291088:  Hold'em No Limit ($0.05/$0.10 USD) - 2021/01/23 13:19:19 ET
Table 'Grus IV' 6-max Seat #4 is the button
Seat 1: Lyskamm ($9.09 in chips) 
Seat 2: dancayamanda ($10 in chips) 
Seat 3: Fimzik ($10.40 in chips) 
Seat 4: Mario Chaves ($14.36 in chips) 
Seat 5: MrBearJew ($4.49 in chips) 
Seat 6: AndriuWasa ($10.37 in chips) 
MrBearJew: posts small blind $0.05
AndriuWasa: posts big blind $0.10
*** HOLE CARDS ***
Lyskamm: folds 
dancayamanda: folds 
Fimzik: folds 
Mario Chaves: folds 
MrBearJew: raises $0.10 to $0.20
AndriuWasa: folds 
Uncalled bet ($0.10) returned to MrBearJew
MrBearJew collected $0.20 from pot
*** SUMMARY ***
Total pot $0.20 | Rake $0 
Seat 1: Lyskamm folded before Flop (didn't bet)
Seat 2: dancayamanda folded before Flop (didn't bet)
Seat 3: Fimzik folded before Flop (didn't bet)
Seat 4: Mario Chaves (button) folded before Flop (didn't bet)
Seat 5: MrBearJew (small blind) collected ($0.20)
Seat 6: AndriuWasa (big blind) folded before Flop



PokerStars Hand #222963303211:  Hold'em No Limit ($0.05/$0.10 USD) - 2021/01/23 13:19:35 ET
Table 'Grus IV' 6-max Seat #5 is the button
Seat 1: Lyskamm ($9.09 in chips) 
Seat 2: dancayamanda ($10 in chips) 
Seat 3: Fimzik ($10.40 in chips) 
Seat 4: Mario Chaves ($14.36 in chips) 
Seat 5: MrBearJew ($4.59 in chips) 
Seat 6: AndriuWasa ($10.27 in chips) 
AndriuWasa: posts small blind $0.05
Lyskamm: posts big blind $0.10
*** HOLE CARDS ***
dancayamanda: folds 
Fimzik: raises $0.15 to $0.25
Mario Chaves: folds 
MrBearJew: folds 
AndriuWasa: raises $0.85 to $1.10
Lyskamm: folds 
Fimzik: folds 
Uncalled bet ($0.85) returned to AndriuWasa
AndriuWasa collected $0.60 from pot
AndriuWasa: doesn't show hand 
*** SUMMARY ***
Total pot $0.60 | Rake $0 
Seat 1: Lyskamm (big blind) folded before Flop
Seat 2: dancayamanda folded before Flop (didn't bet)
Seat 3: Fimzik folded before Flop
Seat 4: Mario Chaves folded before Flop (didn't bet)
Seat 5: MrBearJew (button) folded before Flop (didn't bet)
Seat 6: AndriuWasa (small blind) collected ($0.60)



PokerStars Hand #222963319775:  Hold'em No Limit ($0.05/$0.10 USD) - 2021/01/23 13:19:57 ET
Table 'Grus IV' 6-max Seat #6 is the button
Seat 1: Lyskamm ($8.99 in chips) 
Seat 2: dancayamanda ($10 in chips) 
Seat 3: Fimzik ($10.15 in chips) 
Seat 4: Mario Chaves ($14.36 in chips) 
Seat 5: MrBearJew ($4.59 in chips) 
Seat 6: AndriuWasa ($10.62 in chips) 
Lyskamm: posts small blind $0.05
dancayamanda: posts big blind $0.10
*** HOLE CARDS ***
Fimzik: folds 
Mario Chaves: folds 
MrBearJew: folds 
AndriuWasa: raises $0.15 to $0.25
Lyskamm: raises $0.75 to $1
dancayamanda: folds 
AndriuWasa: folds 
Uncalled bet ($0.75) returned to Lyskamm
Lyskamm collected $0.60 from pot
Lyskamm: doesn't show hand 
*** SUMMARY ***
Total pot $0.60 | Rake $0 
Seat 1: Lyskamm (small blind) collected ($0.60)
Seat 2: dancayamanda (big blind) folded before Flop
Seat 3: Fimzik folded before Flop (didn't bet)
Seat 4: Mario Chaves folded before Flop (didn't bet)
Seat 5: MrBearJew folded before Flop (didn't bet)
Seat 6: AndriuWasa (button) folded before Flop



PokerStars Hand #222963340009:  Hold'em No Limit ($0.05/$0.10 USD) - 2021/01/23 13:20:24 ET
Table 'Grus IV' 6-max Seat #1 is the button
Seat 1: Lyskamm ($9.34 in chips) 
Seat 2: dancayamanda ($10 in chips) 
Seat 3: Fimzik ($10.15 in chips) 
Seat 4: Mario Chaves ($14.36 in chips) 
Seat 5: MrBearJew ($4.59 in chips) 
Seat 6: AndriuWasa ($10.37 in chips) 
dancayamanda: posts small blind $0.05
Fimzik: posts big blind $0.10
*** HOLE CARDS ***
Mario Chaves: folds 
MrBearJew: folds 
AndriuWasa: folds 
Lyskamm: raises $0.20 to $0.30
dancayamanda: folds 
Fimzik: folds 
Uncalled bet ($0.20) returned to Lyskamm
Lyskamm collected $0.25 from pot
Lyskamm: doesn't show hand 
*** SUMMARY ***
Total pot $0.25 | Rake $0 
Seat 1: Lyskamm (button) collected ($0.25)
Seat 2: dancayamanda (small blind) folded before Flop
Seat 3: Fimzik (big blind) folded before Flop
Seat 4: Mario Chaves folded before Flop (didn't bet)
Seat 5: MrBearJew folded before Flop (didn't bet)
Seat 6: AndriuWasa folded before Flop (didn't bet)



PokerStars Hand #222963353777:  Hold'em No Limit ($0.05/$0.10 USD) - 2021/01/23 13:20:42 ET
Table 'Grus IV' 6-max Seat #2 is the button
Seat 1: Lyskamm ($9.49 in chips) 
Seat 2: dancayamanda ($10 in chips) 
Seat 3: Fimzik ($10.05 in chips) 
Seat 4: Mario Chaves ($14.36 in chips) 
Seat 5: MrBearJew ($4.59 in chips) 
Seat 6: AndriuWasa ($10.37 in chips) 
Fimzik: posts small blind $0.05
Mario Chaves: posts big blind $0.10
*** HOLE CARDS ***
MrBearJew: folds 
AndriuWasa: raises $0.15 to $0.25
Lyskamm: folds 
dancayamanda: folds 
Fimzik: folds 
Mario Chaves: folds 
Uncalled bet ($0.15) returned to AndriuWasa
AndriuWasa collected $0.25 from pot
AndriuWasa: doesn't show hand 
*** SUMMARY ***
Total pot $0.25 | Rake $0 
Seat 1: Lyskamm folded before Flop (didn't bet)
Seat 2: dancayamanda (button) folded before Flop (didn't bet)
Seat 3: Fimzik (small blind) folded before Flop
Seat 4: Mario Chaves (big blind) folded before Flop
Seat 5: MrBearJew folded before Flop (didn't bet)
Seat 6: AndriuWasa collected ($0.25)



PokerStars Hand #222963367520:  Hold'em No Limit ($0.05/$0.10 USD) - 2021/01/23 13:21:01 ET
Table 'Grus IV' 6-max Seat #3 is the button
Seat 1: Lyskamm ($9.49 in chips) 
Seat 2: dancayamanda ($10 in chips) 
Seat 3: Fimzik ($10 in chips) 
Seat 4: Mario Chaves ($14.26 in chips) 
Seat 5: MrBearJew ($4.59 in chips) 
Seat 6: AndriuWasa ($10.52 in chips) 
Mario Chaves: posts small blind $0.05
MrBearJew: posts big blind $0.10
*** HOLE CARDS ***
AndriuWasa: folds 
Lyskamm: folds 
dancayamanda: folds 
Fimzik: folds 
Mario Chaves: folds 
Uncalled bet ($0.05) returned to MrBearJew
MrBearJew collected $0.10 from pot
*** SUMMARY ***
Total pot $0.10 | Rake $0 
Seat 1: Lyskamm folded before Flop (didn't bet)
Seat 2: dancayamanda folded before Flop (didn't bet)
Seat 3: Fimzik (button) folded before Flop (didn't bet)
Seat 4: Mario Chaves (small blind) folded before Flop
Seat 5: MrBearJew (big blind) collected ($0.10)
Seat 6: AndriuWasa folded before Flop (didn't bet)



PokerStars Hand #222963374616:  Hold'em No Limit ($0.05/$0.10 USD) - 2021/01/23 13:21:10 ET
Table 'Grus IV' 6-max Seat #4 is the button
Seat 1: Lyskamm ($9.49 in chips) 
Seat 2: dancayamanda ($10 in chips) 
Seat 3: Fimzik ($10 in chips) 
Seat 4: Mario Chaves ($14.21 in chips) 
Seat 5: MrBearJew ($4.64 in chips) 
Seat 6: AndriuWasa ($10.52 in chips) 
MrBearJew: posts small blind $0.05
AndriuWasa: posts big blind $0.10
*** HOLE CARDS ***
Lyskamm: folds 
dancayamanda: raises $0.15 to $0.25
Fimzik: folds 
Mario Chaves: folds 
MrBearJew: calls $0.20
AndriuWasa: calls $0.15
*** FLOP *** [9d 9h 8d]
MrBearJew: bets $0.10
AndriuWasa: calls $0.10
dancayamanda: calls $0.10
*** TURN *** [9d 9h 8d] [Ts]
MrBearJew: checks 
AndriuWasa: checks 
dancayamanda: checks 
*** RIVER *** [9d 9h 8d Ts] [5h]
MrBearJew: checks 
AndriuWasa: bets $0.33
dancayamanda: folds 
MrBearJew: folds 
Uncalled bet ($0.33) returned to AndriuWasa
AndriuWasa collected $1 from pot
AndriuWasa: doesn't show hand 
*** SUMMARY ***
Total pot $1.05 | Rake $0.05 
Board [9d 9h 8d Ts 5h]
Seat 1: Lyskamm folded before Flop (didn't bet)
Seat 2: dancayamanda folded on the River
Seat 3: Fimzik folded before Flop (didn't bet)
Seat 4: Mario Chaves (button) folded before Flop (didn't bet)
Seat 5: MrBearJew (small blind) folded on the River
Seat 6: AndriuWasa (big blind) collected ($1)



PokerStars Hand #222963407845:  Hold'em No Limit ($0.05/$0.10 USD) - 2021/01/23 13:21:54 ET
Table 'Grus IV' 6-max Seat #5 is the button
Seat 1: Lyskamm ($9.49 in chips) 
Seat 2: dancayamanda ($10 in chips) 
Seat 3: Fimzik ($10 in chips) 
Seat 4: Mario Chaves ($14.21 in chips) 
Seat 5: MrBearJew ($4.29 in chips) 
Seat 6: AndriuWasa ($11.17 in chips) 
AndriuWasa: posts small blind $0.05
Lyskamm: posts big blind $0.10
*** HOLE CARDS ***
dancayamanda: raises $0.15 to $0.25
Fimzik: folds 
Mario Chaves: raises $0.50 to $0.75
MrBearJew: calls $0.75
AndriuWasa: folds 
Lyskamm: folds 
dancayamanda: calls $0.50
*** FLOP *** [5s Jd 2s]
dancayamanda: checks 
Mario Chaves: checks 
MrBearJew: checks 
*** TURN *** [5s Jd 2s] [Qd]
dancayamanda: checks 
Mario Chaves: bets $1.21
MrBearJew: calls $1.21
dancayamanda: folds 
*** RIVER *** [5s Jd 2s Qd] [4h]
Mario Chaves: checks 
MrBearJew: bets $2.33 and is all-in
Mario Chaves: folds 
Uncalled bet ($2.33) returned to MrBearJew
MrBearJew collected $4.60 from pot
*** SUMMARY ***
Total pot $4.82 | Rake $0.22 
Board [5s Jd 2s Qd 4h]
Seat 1: Lyskamm (big blind) folded before Flop
Seat 2: dancayamanda folded on the Turn
Seat 3: Fimzik folded before Flop (didn't bet)
Seat 4: Mario Chaves folded on the River
Seat 5: MrBearJew (button) collected ($4.60)
Seat 6: AndriuWasa (small blind) folded before Flop



PokerStars Hand #222963453959:  Hold'em No Limit ($0.05/$0.10 USD) - 2021/01/23 13:22:56 ET
Table 'Grus IV' 6-max Seat #6 is the button
Seat 1: Lyskamm ($9.39 in chips) 
Seat 2: dancayamanda ($10 in chips) 
Seat 3: Fimzik ($10 in chips) 
Seat 4: Mario Chaves ($12.25 in chips) 
Seat 5: MrBearJew ($6.93 in chips) 
Seat 6: AndriuWasa ($11.12 in chips) 
Lyskamm: posts small blind $0.05
dancayamanda: posts big blind $0.10
*** HOLE CARDS ***
Fimzik: folds 
Mario Chaves: folds 
MrBearJew: folds 
Fimzik leaves the table
AndriuWasa: folds 
Lyskamm: folds 
Uncalled bet ($0.05) returned to dancayamanda
dancayamanda collected $0.10 from pot
dancayamanda: doesn't show hand 
*** SUMMARY ***
Total pot $0.10 | Rake $0 
Seat 1: Lyskamm (small blind) folded before Flop
Seat 2: dancayamanda (big blind) collected ($0.10)
Seat 3: Fimzik folded before Flop (didn't bet)
Seat 4: Mario Chaves folded before Flop (didn't bet)
Seat 5: MrBearJew folded before Flop (didn't bet)
Seat 6: AndriuWasa (button) folded before Flop (didn't bet)



PokerStars Hand #222963463189:  Hold'em No Limit ($0.05/$0.10 USD) - 2021/01/23 13:23:08 ET
Table 'Grus IV' 6-max Seat #1 is the button
Seat 1: Lyskamm ($9.34 in chips) 
Seat 2: dancayamanda ($10.05 in chips) 
Seat 4: Mario Chaves ($12.25 in chips) 
Seat 5: MrBearJew ($6.93 in chips) 
Seat 6: AndriuWasa ($11.12 in chips) 
dancayamanda: posts small blind $0.05
Mario Chaves: posts big blind $0.10
*** HOLE CARDS ***
MrBearJew: raises $0.10 to $0.20
mini sonic joins the table at seat #3 
AndriuWasa is disconnected 
AndriuWasa is connected 
AndriuWasa: folds 
Lyskamm: folds 
dancayamanda: folds 
Mario Chaves: folds 
Uncalled bet ($0.10) returned to MrBearJew
MrBearJew collected $0.25 from pot
*** SUMMARY ***
Total pot $0.25 | Rake $0 
Seat 1: Lyskamm (button) folded before Flop (didn't bet)
Seat 2: dancayamanda (small blind) folded before Flop
Seat 4: Mario Chaves (big blind) folded before Flop
Seat 5: MrBearJew collected ($0.25)
Seat 6: AndriuWasa folded before Flop (didn't bet)



PokerStars Hand #222963489002:  Hold'em No Limit ($0.05/$0.10 USD) - 2021/01/23 13:23:42 ET
Table 'Grus IV' 6-max Seat #2 is the button
Seat 1: Lyskamm ($9.34 in chips) 
Seat 2: dancayamanda ($10 in chips) 
Seat 4: Mario Chaves ($12.15 in chips) 
Seat 6: AndriuWasa ($11.12 in chips) 
Mario Chaves: posts small blind $0.05
MrBearJew: is sitting out 
AndriuWasa: posts big blind $0.10
*** HOLE CARDS ***
Lyskamm: folds 
dancayamanda: folds 
MrBearJew leaves the table
Mario Chaves: raises $0.20 to $0.30
AndriuWasa: folds 
Uncalled bet ($0.20) returned to Mario Chaves
Mario Chaves collected $0.20 from pot
Mario Chaves: doesn't show hand 
*** SUMMARY ***
Total pot $0.20 | Rake $0 
Seat 1: Lyskamm folded before Flop (didn't bet)
Seat 2: dancayamanda (button) folded before Flop (didn't bet)
Seat 4: Mario Chaves (small blind) collected ($0.20)
Seat 6: AndriuWasa (big blind) folded before Flop



PokerStars Hand #222963499506:  Hold'em No Limit ($0.05/$0.10 USD) - 2021/01/23 13:23:56 ET
Table 'Grus IV' 6-max Seat #4 is the button
Seat 1: Lyskamm ($9.34 in chips) 
Seat 2: dancayamanda ($10 in chips) 
Seat 3: mini sonic ($4 in chips) 
Seat 4: Mario Chaves ($12.25 in chips) 
Seat 6: AndriuWasa ($11.02 in chips) 
AndriuWasa: posts small blind $0.05
Lyskamm: posts big blind $0.10
mini sonic: posts big blind $0.10
*** HOLE CARDS ***
dancayamanda: folds 
mini sonic: checks 
Mario Chaves: raises $0.30 to $0.40
AndriuWasa: folds 
Lyskamm: folds 
mini sonic: calls $0.30
*** FLOP *** [Qd 9c Ac]
mini sonic: checks 
Mario Chaves: bets $0.30
mini sonic: folds 
Uncalled bet ($0.30) returned to Mario Chaves
Mario Chaves collected $0.91 from pot
Mario Chaves: doesn't show hand 
*** SUMMARY ***
Total pot $0.95 | Rake $0.04 
Board [Qd 9c Ac]
Seat 1: Lyskamm (big blind) folded before Flop
Seat 2: dancayamanda folded before Flop (didn't bet)
Seat 3: mini sonic folded on the Flop
Seat 4: Mario Chaves (button) collected ($0.91)
Seat 6: AndriuWasa (small blind) folded before Flop



PokerStars Hand #222963519573:  Hold'em No Limit ($0.05/$0.10 USD) - 2021/01/23 13:24:22 ET
Table 'Grus IV' 6-max Seat #6 is the button
Seat 1: Lyskamm ($9.24 in chips) 
Seat 2: dancayamanda ($10 in chips) 
Seat 3: mini sonic ($3.60 in chips) 
Seat 4: Mario Chaves ($12.76 in chips) 
Seat 6: AndriuWasa ($10.97 in chips) 
Lyskamm: posts small blind $0.05
rc10111967 joins the table at seat #5 
dancayamanda: posts big blind $0.10
*** HOLE CARDS ***
mini sonic: folds 
Mario Chaves: folds 
AndriuWasa: raises $0.15 to $0.25
Lyskamm: calls $0.20
dancayamanda: raises $1.10 to $1.35
AndriuWasa: folds 
Lyskamm: folds 
Uncalled bet ($1.10) returned to dancayamanda
dancayamanda collected $0.75 from pot
dancayamanda: doesn't show hand 
*** SUMMARY ***
Total pot $0.75 | Rake $0 
Seat 1: Lyskamm (small blind) folded before Flop
Seat 2: dancayamanda (big blind) collected ($0.75)
Seat 3: mini sonic folded before Flop (didn't bet)
Seat 4: Mario Chaves folded before Flop (didn't bet)
Seat 6: AndriuWasa (button) folded before Flop



PokerStars Hand #222963539776:  Hold'em No Limit ($0.05/$0.10 USD) - 2021/01/23 13:24:49 ET
Table 'Grus IV' 6-max Seat #1 is the button
Seat 1: Lyskamm ($8.99 in chips) 
Seat 2: dancayamanda ($10.50 in chips) 
Seat 3: mini sonic ($3.60 in chips) 
Seat 4: Mario Chaves ($12.76 in chips) 
Seat 5: rc10111967 ($7.80 in chips) 
Seat 6: AndriuWasa ($10.72 in chips) 
dancayamanda: posts small blind $0.05
mini sonic: posts big blind $0.10
rc10111967: posts big blind $0.10
*** HOLE CARDS ***
Mario Chaves: folds 
rc10111967: raises $0.10 to $0.20
AndriuWasa: raises $0.60 to $0.80
Lyskamm: folds 
dancayamanda: folds 
mini sonic: raises $2.80 to $3.60 and is all-in
rc10111967: folds 
AndriuWasa: calls $2.80
*** FLOP *** [4h 5c Kh]
*** TURN *** [4h 5c Kh] [Ad]
*** RIVER *** [4h 5c Kh Ad] [Ac]
*** SHOW DOWN ***
mini sonic: shows [Jc Qs] (a pair of Aces)
AndriuWasa: shows [Ah Jh] (three of a kind, Aces)
AndriuWasa collected $7.11 from pot
*** SUMMARY ***
Total pot $7.45 | Rake $0.34 
Board [4h 5c Kh Ad Ac]
Seat 1: Lyskamm (button) folded before Flop (didn't bet)
Seat 2: dancayamanda (small blind) folded before Flop
Seat 3: mini sonic (big blind) showed [Jc Qs] and lost with a pair of Aces
Seat 4: Mario Chaves folded before Flop (didn't bet)
Seat 5: rc10111967 folded before Flop
Seat 6: AndriuWasa showed [Ah Jh] and won ($7.11) with three of a kind, Aces



PokerStars Hand #222963562709:  Hold'em No Limit ($0.05/$0.10 USD) - 2021/01/23 13:25:19 ET
Table 'Grus IV' 6-max Seat #2 is the button
Seat 1: Lyskamm ($8.99 in chips) 
Seat 2: dancayamanda ($10.45 in chips) 
Seat 4: Mario Chaves ($12.76 in chips) 
Seat 5: rc10111967 ($7.60 in chips) 
Seat 6: AndriuWasa ($14.23 in chips) 
Mario Chaves: posts small blind $0.05
rc10111967: posts big blind $0.10
*** HOLE CARDS ***
AndriuWasa: folds 
Lyskamm: folds 
dancayamanda: folds 
mini sonic leaves the table
Mario Chaves: folds 
Uncalled bet ($0.05) returned to rc10111967
rc10111967 collected $0.10 from pot
*** SUMMARY ***
Total pot $0.10 | Rake $0 
Seat 1: Lyskamm folded before Flop (didn't bet)
Seat 2: dancayamanda (button) folded before Flop (didn't bet)
Seat 4: Mario Chaves (small blind) folded before Flop
Seat 5: rc10111967 (big blind) collected ($0.10)
Seat 6: AndriuWasa folded before Flop (didn't bet)



PokerStars Hand #222963573798:  Hold'em No Limit ($0.05/$0.10 USD) - 2021/01/23 13:25:34 ET
Table 'Grus IV' 6-max Seat #4 is the button
Seat 1: Lyskamm ($8.99 in chips) 
Seat 2: dancayamanda ($10.45 in chips) 
Seat 4: Mario Chaves ($12.71 in chips) 
Seat 5: rc10111967 ($7.65 in chips) 
Seat 6: AndriuWasa ($14.23 in chips) 
rc10111967: posts small blind $0.05
AndriuWasa: posts big blind $0.10
*** HOLE CARDS ***
Lyskamm: folds 
dancayamanda: raises $0.15 to $0.25
Mario Chaves: folds 
rc10111967: calls $0.20
AndriuWasa: calls $0.15
*** FLOP *** [2d 2h Tc]
neurophunker joins the table at seat #3 
rc10111967: bets $0.10
AndriuWasa: calls $0.10
dancayamanda: calls $0.10
*** TURN *** [2d 2h Tc] [6h]
rc10111967: checks 
AndriuWasa: checks 
Mario Chaves leaves the table
dancayamanda: checks 
*** RIVER *** [2d 2h Tc 6h] [Ah]
rc10111967: bets $0.10
AndriuWasa: calls $0.10
dancayamanda: folds 
*** SHOW DOWN ***
rc10111967: shows [3h Qd] (a pair of Deuces)
AndriuWasa: shows [Ac Jc] (two pair, Aces and Deuces)
AndriuWasa collected $1.19 from pot
*** SUMMARY ***
Total pot $1.25 | Rake $0.06 
Board [2d 2h Tc 6h Ah]
Seat 1: Lyskamm folded before Flop (didn't bet)
Seat 2: dancayamanda folded on the River
Seat 4: Mario Chaves (button) folded before Flop (didn't bet)
Seat 5: rc10111967 (small blind) showed [3h Qd] and lost with a pair of Deuces
Seat 6: AndriuWasa (big blind) showed [Ac Jc] and won ($1.19) with two pair, Aces and Deuces



PokerStars Hand #222963612121:  Hold'em No Limit ($0.05/$0.10 USD) - 2021/01/23 13:26:24 ET
Table 'Grus IV' 6-max Seat #5 is the button
Seat 1: Lyskamm ($8.99 in chips) 
Seat 2: dancayamanda ($10.10 in chips) 
Seat 5: rc10111967 ($7.20 in chips) 
Seat 6: AndriuWasa ($14.97 in chips) 
AndriuWasa: posts small blind $0.05
Lyskamm: posts big blind $0.10
neurophunker: sits out 
*** HOLE CARDS ***
LoongWalk joins the table at seat #4 
dancayamanda: raises $0.15 to $0.25
rc10111967: calls $0.25
AndriuWasa: folds 
Lyskamm: folds 
*** FLOP *** [Qd Th Js]
dancayamanda: checks 
rc10111967: checks 
*** TURN *** [Qd Th Js] [Tc]
dancayamanda: checks 
rc10111967: checks 
*** RIVER *** [Qd Th Js Tc] [Ac]
dancayamanda: bets $0.47
rc10111967: raises $6.48 to $6.95 and is all-in
dancayamanda: calls $6.48
*** SHOW DOWN ***
rc10111967: shows [6c Kd] (a straight, Ten to Ace)
dancayamanda: shows [Jd Kc] (a straight, Ten to Ace)
dancayamanda collected $6.95 from pot
rc10111967 collected $6.95 from pot
*** SUMMARY ***
Total pot $14.55 | Rake $0.65 
Board [Qd Th Js Tc Ac]
Seat 1: Lyskamm (big blind) folded before Flop
Seat 2: dancayamanda showed [Jd Kc] and won ($6.95) with a straight, Ten to Ace
Seat 5: rc10111967 (button) showed [6c Kd] and won ($6.95) with a straight, Ten to Ace
Seat 6: AndriuWasa (small blind) folded before Flop



PokerStars Hand #222963681026:  Hold'em No Limit ($0.05/$0.10 USD) - 2021/01/23 13:27:55 ET
Table 'Grus IV' 6-max Seat #6 is the button
Seat 1: Lyskamm ($8.89 in chips) 
Seat 2: dancayamanda ($10 in chips) 
Seat 4: LoongWalk ($8 in chips) 
Seat 5: rc10111967 ($6.95 in chips) 
Seat 6: AndriuWasa ($14.92 in chips) 
Lyskamm: posts small blind $0.05
dancayamanda: posts big blind $0.10
neurophunker: sits out 
LoongWalk: posts big blind $0.10
*** HOLE CARDS ***
LoongWalk: checks 
rc10111967: raises $0.40 to $0.50
AndriuWasa: folds 
Lyskamm: folds 
dancayamanda: folds 
LoongWalk: folds 
Uncalled bet ($0.40) returned to rc10111967
rc10111967 collected $0.35 from pot
*** SUMMARY ***
Total pot $0.35 | Rake $0 
Seat 1: Lyskamm (small blind) folded before Flop
Seat 2: dancayamanda (big blind) folded before Flop
Seat 4: LoongWalk folded before Flop (didn't bet)
Seat 5: rc10111967 collected ($0.35)
Seat 6: AndriuWasa (button) folded before Flop (didn't bet)



PokerStars Hand #222963697317:  Hold'em No Limit ($0.05/$0.10 USD) - 2021/01/23 13:28:17 ET
Table 'Grus IV' 6-max Seat #1 is the button
Seat 1: Lyskamm ($8.84 in chips) 
Seat 2: dancayamanda ($10 in chips) 
Seat 3: neurophunker ($10 in chips) 
Seat 4: LoongWalk ($7.90 in chips) 
Seat 5: rc10111967 ($7.20 in chips) 
Seat 6: AndriuWasa ($14.92 in chips) 
dancayamanda: posts small blind $0.05
neurophunker: posts big blind $0.10
*** HOLE CARDS ***
LoongWalk: folds 
rc10111967: raises $0.40 to $0.50
AndriuWasa: folds 
Lyskamm: calls $0.50
dancayamanda: folds 
neurophunker: folds 
*** FLOP *** [3d 9c 5d]
rc10111967: checks 
Lyskamm: checks 
*** TURN *** [3d 9c 5d] [8h]
rc10111967: bets $1.10
Lyskamm: folds 
Uncalled bet ($1.10) returned to rc10111967
rc10111967 collected $1.10 from pot
*** SUMMARY ***
Total pot $1.15 | Rake $0.05 
Board [3d 9c 5d 8h]
Seat 1: Lyskamm (button) folded on the Turn
Seat 2: dancayamanda (small blind) folded before Flop
Seat 3: neurophunker (big blind) folded before Flop
Seat 4: LoongWalk folded before Flop (didn't bet)
Seat 5: rc10111967 collected ($1.10)
Seat 6: AndriuWasa folded before Flop (didn't bet)



PokerStars Hand #222963739894:  Hold'em No Limit ($0.05/$0.10 USD) - 2021/01/23 13:29:13 ET
Table 'Grus IV' 6-max Seat #2 is the button
Seat 1: Lyskamm ($8.34 in chips) 
Seat 2: dancayamanda ($10 in chips) 
Seat 3: neurophunker ($9.90 in chips) 
Seat 4: LoongWalk ($7.90 in chips) 
Seat 5: rc10111967 ($7.80 in chips) 
Seat 6: AndriuWasa ($14.92 in chips) 
neurophunker: posts small blind $0.05
LoongWalk: posts big blind $0.10
*** HOLE CARDS ***
rc10111967: calls $0.10
AndriuWasa: folds 
Lyskamm: folds 
dancayamanda: folds 
neurophunker: folds 
LoongWalk: checks 
*** FLOP *** [Kh Kd 8h]
LoongWalk: checks 
rc10111967: bets $0.24
LoongWalk: folds 
Uncalled bet ($0.24) returned to rc10111967
rc10111967 collected $0.24 from pot
*** SUMMARY ***
Total pot $0.25 | Rake $0.01 
Board [Kh Kd 8h]
Seat 1: Lyskamm folded before Flop (didn't bet)
Seat 2: dancayamanda (button) folded before Flop (didn't bet)
Seat 3: neurophunker (small blind) folded before Flop
Seat 4: LoongWalk (big blind) folded on the Flop
Seat 5: rc10111967 collected ($0.24)
Seat 6: AndriuWasa folded before Flop (didn't bet)



PokerStars Hand #222963760126:  Hold'em No Limit ($0.05/$0.10 USD) - 2021/01/23 13:29:40 ET
Table 'Grus IV' 6-max Seat #3 is the button
Seat 1: Lyskamm ($8.34 in chips) 
Seat 2: dancayamanda ($10 in chips) 
Seat 3: neurophunker ($9.85 in chips) 
Seat 4: LoongWalk ($7.80 in chips) 
Seat 5: rc10111967 ($7.94 in chips) 
Seat 6: AndriuWasa ($14.92 in chips) 
LoongWalk: posts small blind $0.05
rc10111967: posts big blind $0.10
*** HOLE CARDS ***
AndriuWasa: raises $0.15 to $0.25
Lyskamm: folds 
dancayamanda: folds 
neurophunker: folds 
LoongWalk: folds 
rc10111967: calls $0.15
*** FLOP *** [6s Kh 8c]
rc10111967: bets $0.10
AndriuWasa: calls $0.10
*** TURN *** [6s Kh 8c] [8d]
rc10111967: bets $0.36
AndriuWasa: calls $0.36
*** RIVER *** [6s Kh 8c 8d] [7d]
rc10111967: bets $2.20
AndriuWasa: folds 
Uncalled bet ($2.20) returned to rc10111967
rc10111967 collected $1.40 from pot
*** SUMMARY ***
Total pot $1.47 | Rake $0.07 
Board [6s Kh 8c 8d 7d]
Seat 1: Lyskamm folded before Flop (didn't bet)
Seat 2: dancayamanda folded before Flop (didn't bet)
Seat 3: neurophunker (button) folded before Flop (didn't bet)
Seat 4: LoongWalk (small blind) folded before Flop
Seat 5: rc10111967 (big blind) collected ($1.40)
Seat 6: AndriuWasa folded on the River



PokerStars Hand #222963811926:  Hold'em No Limit ($0.05/$0.10 USD) - 2021/01/23 13:30:47 ET
Table 'Grus IV' 6-max Seat #4 is the button
Seat 1: Lyskamm ($8.34 in chips) 
Seat 2: dancayamanda ($10 in chips) 
Seat 3: neurophunker ($9.85 in chips) 
Seat 4: LoongWalk ($7.75 in chips) 
Seat 5: rc10111967 ($8.63 in chips) 
Seat 6: AndriuWasa ($14.21 in chips) 
rc10111967: posts small blind $0.05
AndriuWasa: posts big blind $0.10
*** HOLE CARDS ***
Lyskamm: folds 
dancayamanda: folds 
neurophunker: raises $0.20 to $0.30
LoongWalk: folds 
rc10111967: folds 
AndriuWasa: folds 
Uncalled bet ($0.20) returned to neurophunker
neurophunker collected $0.25 from pot
neurophunker: doesn't show hand 
*** SUMMARY ***
Total pot $0.25 | Rake $0 
Seat 1: Lyskamm folded before Flop (didn't bet)
Seat 2: dancayamanda folded before Flop (didn't bet)
Seat 3: neurophunker collected ($0.25)
Seat 4: LoongWalk (button) folded before Flop (didn't bet)
Seat 5: rc10111967 (small blind) folded before Flop
Seat 6: AndriuWasa (big blind) folded before Flop



PokerStars Hand #222963825425:  Hold'em No Limit ($0.05/$0.10 USD) - 2021/01/23 13:31:05 ET
Table 'Grus IV' 6-max Seat #5 is the button
Seat 1: Lyskamm ($8.34 in chips) 
Seat 2: dancayamanda ($10 in chips) 
Seat 3: neurophunker ($10 in chips) 
Seat 4: LoongWalk ($7.75 in chips) 
Seat 5: rc10111967 ($8.58 in chips) 
Seat 6: AndriuWasa ($14.11 in chips) 
AndriuWasa: posts small blind $0.05
Lyskamm: posts big blind $0.10
*** HOLE CARDS ***
dancayamanda: folds 
neurophunker: raises $0.20 to $0.30
LoongWalk: folds 
rc10111967: calls $0.30
AndriuWasa: folds 
Lyskamm: calls $0.20
*** FLOP *** [2h 5h 2s]
Lyskamm: checks 
neurophunker: checks 
rc10111967: bets $0.91
Lyskamm: folds 
neurophunker: folds 
Uncalled bet ($0.91) returned to rc10111967
rc10111967 collected $0.91 from pot
*** SUMMARY ***
Total pot $0.95 | Rake $0.04 
Board [2h 5h 2s]
Seat 1: Lyskamm (big blind) folded on the Flop
Seat 2: dancayamanda folded before Flop (didn't bet)
Seat 3: neurophunker folded on the Flop
Seat 4: LoongWalk folded before Flop (didn't bet)
Seat 5: rc10111967 (button) collected ($0.91)
Seat 6: AndriuWasa (small blind) folded before Flop



PokerStars Hand #222963866168:  Hold'em No Limit ($0.05/$0.10 USD) - 2021/01/23 13:31:57 ET
Table 'Grus IV' 6-max Seat #6 is the button
Seat 1: Lyskamm ($8.04 in chips) 
Seat 2: dancayamanda ($10 in chips) 
Seat 3: neurophunker ($9.70 in chips) 
Seat 4: LoongWalk ($7.75 in chips) 
Seat 5: rc10111967 ($9.19 in chips) 
Seat 6: AndriuWasa ($14.06 in chips) 
Lyskamm: posts small blind $0.05
dancayamanda: posts big blind $0.10
*** HOLE CARDS ***
neurophunker: folds 
LoongWalk: raises $0.20 to $0.30
rc10111967: folds 
AndriuWasa: folds 
Lyskamm: calls $0.25
dancayamanda: folds 
*** FLOP *** [7s Kd 9h]
Lyskamm: checks 
LoongWalk: bets $0.30
Lyskamm: folds 
Uncalled bet ($0.30) returned to LoongWalk
LoongWalk collected $0.67 from pot
LoongWalk: doesn't show hand 
*** SUMMARY ***
Total pot $0.70 | Rake $0.03 
Board [7s Kd 9h]
Seat 1: Lyskamm (small blind) folded on the Flop
Seat 2: dancayamanda (big blind) folded before Flop
Seat 3: neurophunker folded before Flop (didn't bet)
Seat 4: LoongWalk collected ($0.67)
Seat 5: rc10111967 folded before Flop (didn't bet)
Seat 6: AndriuWasa (button) folded before Flop (didn't bet)



PokerStars Hand #222963890455:  Hold'em No Limit ($0.05/$0.10 USD) - 2021/01/23 13:32:28 ET
Table 'Grus IV' 6-max Seat #1 is the button
Seat 1: Lyskamm ($7.74 in chips) 
Seat 2: dancayamanda ($10 in chips) 
Seat 3: neurophunker ($9.70 in chips) 
Seat 4: LoongWalk ($8.12 in chips) 
Seat 5: rc10111967 ($9.19 in chips) 
Seat 6: AndriuWasa ($14.06 in chips) 
dancayamanda: posts small blind $0.05
neurophunker: posts big blind $0.10
*** HOLE CARDS ***
LoongWalk: folds 
rc10111967: folds 
AndriuWasa: folds 
Lyskamm: raises $0.20 to $0.30
dancayamanda: folds 
neurophunker: calls $0.20
*** FLOP *** [6c 7s Kc]
neurophunker: checks 
Lyskamm: bets $0.31
neurophunker: calls $0.31
*** TURN *** [6c 7s Kc] [3s]
neurophunker: checks 
Lyskamm: bets $0.61
neurophunker: calls $0.61
*** RIVER *** [6c 7s Kc 3s] [9h]
neurophunker: checks 
Lyskamm: checks 
*** SHOW DOWN ***
neurophunker: shows [Td 7d] (a pair of Sevens)
Lyskamm: mucks hand 
neurophunker collected $2.38 from pot
*** SUMMARY ***
Total pot $2.49 | Rake $0.11 
Board [6c 7s Kc 3s 9h]
Seat 1: Lyskamm (button) mucked
Seat 2: dancayamanda (small blind) folded before Flop
Seat 3: neurophunker (big blind) showed [Td 7d] and won ($2.38) with a pair of Sevens
Seat 4: LoongWalk folded before Flop (didn't bet)
Seat 5: rc10111967 folded before Flop (didn't bet)
Seat 6: AndriuWasa folded before Flop (didn't bet)



PokerStars Hand #222963953139:  Hold'em No Limit ($0.05/$0.10 USD) - 2021/01/23 13:33:48 ET
Table 'Grus IV' 6-max Seat #2 is the button
Seat 1: Lyskamm ($6.52 in chips) 
Seat 2: dancayamanda ($10 in chips) 
Seat 3: neurophunker ($10.86 in chips) 
Seat 4: LoongWalk ($8.12 in chips) 
Seat 5: rc10111967 ($9.19 in chips) 
Seat 6: AndriuWasa ($14.06 in chips) 
neurophunker: posts small blind $0.05
LoongWalk: posts big blind $0.10
*** HOLE CARDS ***
rc10111967: raises $0.10 to $0.20
AndriuWasa: folds 
Lyskamm: folds 
dancayamanda: folds 
neurophunker: folds 
LoongWalk: calls $0.10
*** FLOP *** [Jc 7s Ts]
LoongWalk: checks 
rc10111967: bets $0.22
LoongWalk: calls $0.22
*** TURN *** [Jc 7s Ts] [4d]
LoongWalk: checks 
rc10111967: bets $0.43
LoongWalk: calls $0.43
*** RIVER *** [Jc 7s Ts 4d] [3h]
LoongWalk: checks 
rc10111967: checks 
*** SHOW DOWN ***
LoongWalk: shows [8s 8d] (a pair of Eights)
rc10111967: mucks hand 
LoongWalk collected $1.67 from pot
*** SUMMARY ***
Total pot $1.75 | Rake $0.08 
Board [Jc 7s Ts 4d 3h]
Seat 1: Lyskamm folded before Flop (didn't bet)
Seat 2: dancayamanda (button) folded before Flop (didn't bet)
Seat 3: neurophunker (small blind) folded before Flop
Seat 4: LoongWalk (big blind) showed [8s 8d] and won ($1.67) with a pair of Eights
Seat 5: rc10111967 mucked
Seat 6: AndriuWasa folded before Flop (didn't bet)



PokerStars Hand #222964016458:  Hold'em No Limit ($0.05/$0.10 USD) - 2021/01/23 13:35:10 ET
Table 'Grus IV' 6-max Seat #3 is the button
Seat 1: Lyskamm ($6.52 in chips) 
Seat 2: dancayamanda ($10 in chips) 
Seat 3: neurophunker ($10.81 in chips) 
Seat 4: LoongWalk ($8.94 in chips) 
Seat 5: rc10111967 ($8.34 in chips) 
Seat 6: AndriuWasa ($14.06 in chips) 
LoongWalk: posts small blind $0.05
rc10111967: posts big blind $0.10
*** HOLE CARDS ***
AndriuWasa: folds 
Lyskamm: folds 
dancayamanda: folds 
neurophunker: folds 
LoongWalk: folds 
Uncalled bet ($0.05) returned to rc10111967
rc10111967 collected $0.10 from pot
*** SUMMARY ***
Total pot $0.10 | Rake $0 
Seat 1: Lyskamm folded before Flop (didn't bet)
Seat 2: dancayamanda folded before Flop (didn't bet)
Seat 3: neurophunker (button) folded before Flop (didn't bet)
Seat 4: LoongWalk (small blind) folded before Flop
Seat 5: rc10111967 (big blind) collected ($0.10)
Seat 6: AndriuWasa folded before Flop (didn't bet)



PokerStars Hand #222964025399:  Hold'em No Limit ($0.05/$0.10 USD) - 2021/01/23 13:35:21 ET
Table 'Grus IV' 6-max Seat #4 is the button
Seat 1: Lyskamm ($6.52 in chips) 
Seat 2: dancayamanda ($10 in chips) 
Seat 3: neurophunker ($10.81 in chips) 
Seat 4: LoongWalk ($8.89 in chips) 
Seat 5: rc10111967 ($8.39 in chips) 
Seat 6: AndriuWasa ($14.06 in chips) 
rc10111967: posts small blind $0.05
AndriuWasa: posts big blind $0.10
*** HOLE CARDS ***
Lyskamm: folds 
dancayamanda: folds 
neurophunker: raises $0.20 to $0.30
LoongWalk: folds 
rc10111967: calls $0.25
AndriuWasa: folds 
*** FLOP *** [Ks 3s 5h]
rc10111967: bets $0.34
neurophunker: folds 
Uncalled bet ($0.34) returned to rc10111967
rc10111967 collected $0.67 from pot
*** SUMMARY ***
Total pot $0.70 | Rake $0.03 
Board [Ks 3s 5h]
Seat 1: Lyskamm folded before Flop (didn't bet)
Seat 2: dancayamanda folded before Flop (didn't bet)
Seat 3: neurophunker folded on the Flop
Seat 4: LoongWalk (button) folded before Flop (didn't bet)
Seat 5: rc10111967 (small blind) collected ($0.67)
Seat 6: AndriuWasa (big blind) folded before Flop



PokerStars Hand #222964049541:  Hold'em No Limit ($0.05/$0.10 USD) - 2021/01/23 13:35:52 ET
Table 'Grus IV' 6-max Seat #5 is the button
Seat 1: Lyskamm ($6.52 in chips) 
Seat 2: dancayamanda ($10 in chips) 
Seat 3: neurophunker ($10.51 in chips) 
Seat 4: LoongWalk ($8.89 in chips) 
Seat 5: rc10111967 ($8.76 in chips) 
Seat 6: AndriuWasa ($13.96 in chips) 
AndriuWasa: posts small blind $0.05
Lyskamm: posts big blind $0.10
*** HOLE CARDS ***
dancayamanda: folds 
neurophunker: folds 
LoongWalk: folds 
rc10111967: raises $0.10 to $0.20
AndriuWasa: folds 
Lyskamm: folds 
Uncalled bet ($0.10) returned to rc10111967
rc10111967 collected $0.25 from pot
*** SUMMARY ***
Total pot $0.25 | Rake $0 
Seat 1: Lyskamm (big blind) folded before Flop
Seat 2: dancayamanda folded before Flop (didn't bet)
Seat 3: neurophunker folded before Flop (didn't bet)
Seat 4: LoongWalk folded before Flop (didn't bet)
Seat 5: rc10111967 (button) collected ($0.25)
Seat 6: AndriuWasa (small blind) folded before Flop



PokerStars Hand #222964064818:  Hold'em No Limit ($0.05/$0.10 USD) - 2021/01/23 13:36:12 ET
Table 'Grus IV' 6-max Seat #6 is the button
Seat 1: Lyskamm ($6.42 in chips) 
Seat 2: dancayamanda ($10 in chips) 
Seat 3: neurophunker ($10.51 in chips) 
Seat 4: LoongWalk ($8.89 in chips) 
Seat 5: rc10111967 ($8.91 in chips) 
Seat 6: AndriuWasa ($13.91 in chips) 
Lyskamm: posts small blind $0.05
dancayamanda: posts big blind $0.10
*** HOLE CARDS ***
neurophunker has timed out
neurophunker: folds 
LoongWalk: folds 
rc10111967: raises $0.10 to $0.20
AndriuWasa: folds 
Lyskamm: folds 
dancayamanda: calls $0.10
*** FLOP *** [Jh Th Qc]
dancayamanda: checks 
rc10111967: checks 
*** TURN *** [Jh Th Qc] [Ah]
dancayamanda: checks 
rc10111967: checks 
*** RIVER *** [Jh Th Qc Ah] [Ks]
dancayamanda: checks 
rc10111967: bets $0.50
dancayamanda: calls $0.50
*** SHOW DOWN ***
rc10111967: shows [Qd 7d] (a straight, Ten to Ace)
dancayamanda: shows [8s Jd] (a straight, Ten to Ace)
dancayamanda collected $0.69 from pot
rc10111967 collected $0.69 from pot
*** SUMMARY ***
Total pot $1.45 | Rake $0.07 
Board [Jh Th Qc Ah Ks]
Seat 1: Lyskamm (small blind) folded before Flop
Seat 2: dancayamanda (big blind) showed [8s Jd] and won ($0.69) with a straight, Ten to Ace
Seat 3: neurophunker folded before Flop (didn't bet)
Seat 4: LoongWalk folded before Flop (didn't bet)
Seat 5: rc10111967 showed [Qd 7d] and won ($0.69) with a straight, Ten to Ace
Seat 6: AndriuWasa (button) folded before Flop (didn't bet)



PokerStars Hand #222964110153:  Hold'em No Limit ($0.05/$0.10 USD) - 2021/01/23 13:37:11 ET
Table 'Grus IV' 6-max Seat #1 is the button
Seat 1: Lyskamm ($6.37 in chips) 
Seat 2: dancayamanda ($10 in chips) 
Seat 3: neurophunker ($10.51 in chips) 
Seat 4: LoongWalk ($8.89 in chips) 
Seat 5: rc10111967 ($8.90 in chips) 
Seat 6: AndriuWasa ($13.91 in chips) 
dancayamanda: posts small blind $0.05
neurophunker: posts big blind $0.10
*** HOLE CARDS ***
LoongWalk: folds 
rc10111967: calls $0.10
AndriuWasa: folds 
Lyskamm: raises $0.40 to $0.50
dancayamanda: folds 
neurophunker: folds 
rc10111967: folds 
Uncalled bet ($0.40) returned to Lyskamm
Lyskamm collected $0.35 from pot
Lyskamm: doesn't show hand 
*** SUMMARY ***
Total pot $0.35 | Rake $0 
Seat 1: Lyskamm (button) collected ($0.35)
Seat 2: dancayamanda (small blind) folded before Flop
Seat 3: neurophunker (big blind) folded before Flop
Seat 4: LoongWalk folded before Flop (didn't bet)
Seat 5: rc10111967 folded before Flop
Seat 6: AndriuWasa folded before Flop (didn't bet)



PokerStars Hand #222964132841:  Hold'em No Limit ($0.05/$0.10 USD) - 2021/01/23 13:37:40 ET
Table 'Grus IV' 6-max Seat #2 is the button
Seat 1: Lyskamm ($6.62 in chips) 
Seat 2: dancayamanda ($10 in chips) 
Seat 3: neurophunker ($10.41 in chips) 
Seat 4: LoongWalk ($8.89 in chips) 
Seat 5: rc10111967 ($8.80 in chips) 
Seat 6: AndriuWasa ($13.91 in chips) 
neurophunker: posts small blind $0.05
LoongWalk: posts big blind $0.10
*** HOLE CARDS ***
rc10111967: calls $0.10
AndriuWasa: folds 
Lyskamm: raises $0.40 to $0.50
dancayamanda: folds 
neurophunker: calls $0.45
LoongWalk: folds 
rc10111967: folds 
*** FLOP *** [9c 4s 4h]
neurophunker: checks 
Lyskamm: bets $0.58
neurophunker: calls $0.58
*** TURN *** [9c 4s 4h] [Qs]
neurophunker: checks 
Lyskamm: checks 
*** RIVER *** [9c 4s 4h Qs] [3h]
neurophunker: checks 
Lyskamm: checks 
*** SHOW DOWN ***
neurophunker: shows [Ks Jh] (a pair of Fours)
Lyskamm: shows [Kh Ad] (a pair of Fours - Ace kicker)
Lyskamm collected $2.25 from pot
*** SUMMARY ***
Total pot $2.36 | Rake $0.11 
Board [9c 4s 4h Qs 3h]
Seat 1: Lyskamm showed [Kh Ad] and won ($2.25) with a pair of Fours
Seat 2: dancayamanda (button) folded before Flop (didn't bet)
Seat 3: neurophunker (small blind) showed [Ks Jh] and lost with a pair of Fours
Seat 4: LoongWalk (big blind) folded before Flop
Seat 5: rc10111967 folded before Flop
Seat 6: AndriuWasa folded before Flop (didn't bet)



PokerStars Hand #222964195526:  Hold'em No Limit ($0.05/$0.10 USD) - 2021/01/23 13:39:01 ET
Table 'Grus IV' 6-max Seat #3 is the button
Seat 1: Lyskamm ($7.79 in chips) 
Seat 2: dancayamanda ($10 in chips) 
Seat 3: neurophunker ($9.33 in chips) 
Seat 4: LoongWalk ($8.79 in chips) 
Seat 5: rc10111967 ($8.70 in chips) 
Seat 6: AndriuWasa ($13.91 in chips) 
LoongWalk: posts small blind $0.05
rc10111967: posts big blind $0.10
*** HOLE CARDS ***
AndriuWasa: raises $0.15 to $0.25
Lyskamm: folds 
dancayamanda: raises $0.55 to $0.80
neurophunker: folds 
LoongWalk: folds 
rc10111967: folds 
AndriuWasa: folds 
Uncalled bet ($0.55) returned to dancayamanda
dancayamanda collected $0.65 from pot
dancayamanda: doesn't show hand 
*** SUMMARY ***
Total pot $0.65 | Rake $0 
Seat 1: Lyskamm folded before Flop (didn't bet)
Seat 2: dancayamanda collected ($0.65)
Seat 3: neurophunker (button) folded before Flop (didn't bet)
Seat 4: LoongWalk (small blind) folded before Flop
Seat 5: rc10111967 (big blind) folded before Flop
Seat 6: AndriuWasa folded before Flop



PokerStars Hand #222964222783:  Hold'em No Limit ($0.05/$0.10 USD) - 2021/01/23 13:39:36 ET
Table 'Grus IV' 6-max Seat #4 is the button
Seat 1: Lyskamm ($7.79 in chips) 
Seat 2: dancayamanda ($10.40 in chips) 
Seat 3: neurophunker ($9.33 in chips) 
Seat 4: LoongWalk ($8.74 in chips) 
Seat 6: AndriuWasa ($13.66 in chips) 
AndriuWasa: posts small blind $0.05
Lyskamm: posts big blind $0.10
*** HOLE CARDS ***
dancayamanda: raises $0.15 to $0.25
neurophunker: folds 
LoongWalk: folds 
AndriuWasa: folds 
Lyskamm: folds 
Uncalled bet ($0.15) returned to dancayamanda
dancayamanda collected $0.25 from pot
dancayamanda: doesn't show hand 
*** SUMMARY ***
Total pot $0.25 | Rake $0 
Seat 1: Lyskamm (big blind) folded before Flop
Seat 2: dancayamanda collected ($0.25)
Seat 3: neurophunker folded before Flop (didn't bet)
Seat 4: LoongWalk (button) folded before Flop (didn't bet)
Seat 6: AndriuWasa (small blind) folded before Flop



PokerStars Hand #222964229701:  Hold'em No Limit ($0.05/$0.10 USD) - 2021/01/23 13:39:45 ET
Table 'Grus IV' 6-max Seat #6 is the button
Seat 1: Lyskamm ($7.69 in chips) 
Seat 2: dancayamanda ($10.55 in chips) 
Seat 3: neurophunker ($9.33 in chips) 
Seat 4: LoongWalk ($8.74 in chips) 
Seat 6: AndriuWasa ($13.61 in chips) 
Lyskamm: posts small blind $0.05
dancayamanda: posts big blind $0.10
*** HOLE CARDS ***
neurophunker: folds 
LoongWalk: folds 
AndriuWasa: raises $0.15 to $0.25
Lyskamm: folds 
dancayamanda: calls $0.15
*** FLOP *** [Qs Qc 4h]
dancayamanda: checks 
AndriuWasa: checks 
*** TURN *** [Qs Qc 4h] [Ts]
dancayamanda: checks 
AndriuWasa: checks 
*** RIVER *** [Qs Qc 4h Ts] [Kh]
dancayamanda: checks 
AndriuWasa: checks 
*** SHOW DOWN ***
dancayamanda: shows [As 7c] (a pair of Queens)
AndriuWasa: shows [6c Ad] (a pair of Queens)
dancayamanda collected $0.27 from pot
AndriuWasa collected $0.26 from pot
*** SUMMARY ***
Total pot $0.55 | Rake $0.02 
Board [Qs Qc 4h Ts Kh]
Seat 1: Lyskamm (small blind) folded before Flop
Seat 2: dancayamanda (big blind) showed [As 7c] and won ($0.27) with a pair of Queens
Seat 3: neurophunker folded before Flop (didn't bet)
Seat 4: LoongWalk folded before Flop (didn't bet)
Seat 6: AndriuWasa (button) showed [6c Ad] and won ($0.26) with a pair of Queens



PokerStars Hand #222964256809:  Hold'em No Limit ($0.05/$0.10 USD) - 2021/01/23 13:40:20 ET
Table 'Grus IV' 6-max Seat #1 is the button
Seat 1: Lyskamm ($7.64 in chips) 
Seat 2: dancayamanda ($10.57 in chips) 
Seat 3: neurophunker ($9.33 in chips) 
Seat 4: LoongWalk ($8.74 in chips) 
Seat 6: AndriuWasa ($13.62 in chips) 
dancayamanda: posts small blind $0.05
neurophunker: posts big blind $0.10
*** HOLE CARDS ***
LoongWalk: folds 
AndriuWasa: folds 
Lyskamm: folds 
dancayamanda: raises $0.20 to $0.30
neurophunker: folds 
Uncalled bet ($0.20) returned to dancayamanda
dancayamanda collected $0.20 from pot
dancayamanda: doesn't show hand 
*** SUMMARY ***
Total pot $0.20 | Rake $0 
Seat 1: Lyskamm (button) folded before Flop (didn't bet)
Seat 2: dancayamanda (small blind) collected ($0.20)
Seat 3: neurophunker (big blind) folded before Flop
Seat 4: LoongWalk folded before Flop (didn't bet)
Seat 6: AndriuWasa folded before Flop (didn't bet)



PokerStars Hand #222964267496:  Hold'em No Limit ($0.05/$0.10 USD) - 2021/01/23 13:40:34 ET
Table 'Grus IV' 6-max Seat #2 is the button
Seat 1: Lyskamm ($7.64 in chips) 
Seat 2: dancayamanda ($10.67 in chips) 
Seat 3: neurophunker ($9.23 in chips) 
Seat 4: LoongWalk ($8.74 in chips) 
Seat 6: AndriuWasa ($13.62 in chips) 
neurophunker: posts small blind $0.05
LoongWalk: posts big blind $0.10
*** HOLE CARDS ***
AndriuWasa: folds 
Lyskamm: raises $0.20 to $0.30
dancayamanda: folds 
neurophunker: folds 
LoongWalk: folds 
Uncalled bet ($0.20) returned to Lyskamm
Lyskamm collected $0.25 from pot
Lyskamm: doesn't show hand 
*** SUMMARY ***
Total pot $0.25 | Rake $0 
Seat 1: Lyskamm collected ($0.25)
Seat 2: dancayamanda (button) folded before Flop (didn't bet)
Seat 3: neurophunker (small blind) folded before Flop
Seat 4: LoongWalk (big blind) folded before Flop
Seat 6: AndriuWasa folded before Flop (didn't bet)



PokerStars Hand #222964280801:  Hold'em No Limit ($0.05/$0.10 USD) - 2021/01/23 13:40:51 ET
Table 'Grus IV' 6-max Seat #3 is the button
Seat 1: Lyskamm ($7.79 in chips) 
Seat 2: dancayamanda ($10.67 in chips) 
Seat 3: neurophunker ($9.18 in chips) 
Seat 4: LoongWalk ($8.64 in chips) 
Seat 6: AndriuWasa ($13.62 in chips) 
LoongWalk: posts small blind $0.05
AndriuWasa: posts big blind $0.10
*** HOLE CARDS ***
Lyskamm: raises $0.20 to $0.30
dancayamanda: folds 
neurophunker: calls $0.30
LoongWalk: folds 
AndriuWasa: folds 
*** FLOP *** [6c Qc 8s]
Lyskamm: checks 
neurophunker: bets $0.40
Lyskamm: folds 
Uncalled bet ($0.40) returned to neurophunker
neurophunker collected $0.72 from pot
neurophunker: doesn't show hand 
*** SUMMARY ***
Total pot $0.75 | Rake $0.03 
Board [6c Qc 8s]
Seat 1: Lyskamm folded on the Flop
Seat 2: dancayamanda folded before Flop (didn't bet)
Seat 3: neurophunker (button) collected ($0.72)
Seat 4: LoongWalk (small blind) folded before Flop
Seat 6: AndriuWasa (big blind) folded before Flop



PokerStars Hand #222964309901:  Hold'em No Limit ($0.05/$0.10 USD) - 2021/01/23 13:41:28 ET
Table 'Grus IV' 6-max Seat #4 is the button
Seat 1: Lyskamm ($7.49 in chips) 
Seat 2: dancayamanda ($10.67 in chips) 
Seat 3: neurophunker ($9.60 in chips) 
Seat 4: LoongWalk ($8.59 in chips) 
Seat 6: AndriuWasa ($13.52 in chips) 
AndriuWasa: posts small blind $0.05
Lyskamm: posts big blind $0.10
*** HOLE CARDS ***
dancayamanda: folds 
neurophunker: raises $0.20 to $0.30
LoongWalk: folds 
AndriuWasa: folds 
Lyskamm: calls $0.20
*** FLOP *** [Ts 7c 3h]
Lyskamm: checks 
neurophunker: bets $0.40
Lyskamm: folds 
Uncalled bet ($0.40) returned to neurophunker
neurophunker collected $0.62 from pot
neurophunker: doesn't show hand 
*** SUMMARY ***
Total pot $0.65 | Rake $0.03 
Board [Ts 7c 3h]
Seat 1: Lyskamm (big blind) folded on the Flop
Seat 2: dancayamanda folded before Flop (didn't bet)
Seat 3: neurophunker collected ($0.62)
Seat 4: LoongWalk (button) folded before Flop (didn't bet)
Seat 6: AndriuWasa (small blind) folded before Flop



PokerStars Hand #222964338621:  Hold'em No Limit ($0.05/$0.10 USD) - 2021/01/23 13:42:06 ET
Table 'Grus IV' 6-max Seat #6 is the button
Seat 1: Lyskamm ($7.19 in chips) 
Seat 2: dancayamanda ($10.67 in chips) 
Seat 3: neurophunker ($9.92 in chips) 
Seat 4: LoongWalk ($8.59 in chips) 
Seat 6: AndriuWasa ($13.47 in chips) 
Lyskamm: posts small blind $0.05
dancayamanda: posts big blind $0.10
*** HOLE CARDS ***
neurophunker: raises $0.15 to $0.25
LoongWalk: folds 
AndriuWasa: folds 
Lyskamm: folds 
dancayamanda: folds 
Uncalled bet ($0.15) returned to neurophunker
neurophunker collected $0.25 from pot
neurophunker: doesn't show hand 
*** SUMMARY ***
Total pot $0.25 | Rake $0 
Seat 1: Lyskamm (small blind) folded before Flop
Seat 2: dancayamanda (big blind) folded before Flop
Seat 3: neurophunker collected ($0.25)
Seat 4: LoongWalk folded before Flop (didn't bet)
Seat 6: AndriuWasa (button) folded before Flop (didn't bet)



PokerStars Hand #222964348489:  Hold'em No Limit ($0.05/$0.10 USD) - 2021/01/23 13:42:18 ET
Table 'Grus IV' 6-max Seat #1 is the button
Seat 1: Lyskamm ($7.14 in chips) 
Seat 2: dancayamanda ($10.57 in chips) 
Seat 3: neurophunker ($10.07 in chips) 
Seat 4: LoongWalk ($8.59 in chips) 
Seat 6: AndriuWasa ($13.47 in chips) 
dancayamanda: posts small blind $0.05
neurophunker: posts big blind $0.10
*** HOLE CARDS ***
LoongWalk: folds 
AndriuWasa: folds 
Lyskamm: folds 
dancayamanda: folds 
Uncalled bet ($0.05) returned to neurophunker
neurophunker collected $0.10 from pot
neurophunker: doesn't show hand 
*** SUMMARY ***
Total pot $0.10 | Rake $0 
Seat 1: Lyskamm (button) folded before Flop (didn't bet)
Seat 2: dancayamanda (small blind) folded before Flop
Seat 3: neurophunker (big blind) collected ($0.10)
Seat 4: LoongWalk folded before Flop (didn't bet)
Seat 6: AndriuWasa folded before Flop (didn't bet)



PokerStars Hand #222964359441:  Hold'em No Limit ($0.05/$0.10 USD) - 2021/01/23 13:42:33 ET
Table 'Grus IV' 6-max Seat #2 is the button
Seat 1: Lyskamm ($7.14 in chips) 
Seat 2: dancayamanda ($10.52 in chips) 
Seat 3: neurophunker ($10.12 in chips) 
Seat 4: LoongWalk ($8.59 in chips) 
Seat 6: AndriuWasa ($13.47 in chips) 
neurophunker: posts small blind $0.05
LoongWalk: posts big blind $0.10
*** HOLE CARDS ***
AndriuWasa: folds 
Lyskamm: folds 
dancayamanda: raises $0.15 to $0.25
neurophunker: folds 
LoongWalk: folds 
Uncalled bet ($0.15) returned to dancayamanda
dancayamanda collected $0.25 from pot
dancayamanda: doesn't show hand 
*** SUMMARY ***
Total pot $0.25 | Rake $0 
Seat 1: Lyskamm folded before Flop (didn't bet)
Seat 2: dancayamanda (button) collected ($0.25)
Seat 3: neurophunker (small blind) folded before Flop
Seat 4: LoongWalk (big blind) folded before Flop
Seat 6: AndriuWasa folded before Flop (didn't bet)



PokerStars Hand #222964374692:  Hold'em No Limit ($0.05/$0.10 USD) - 2021/01/23 13:42:52 ET
Table 'Grus IV' 6-max Seat #3 is the button
Seat 1: Lyskamm ($7.14 in chips) 
Seat 2: dancayamanda ($10.67 in chips) 
Seat 3: neurophunker ($10.07 in chips) 
Seat 4: LoongWalk ($8.49 in chips) 
Seat 6: AndriuWasa ($13.47 in chips) 
LoongWalk: posts small blind $0.05
AndriuWasa: posts big blind $0.10
*** HOLE CARDS ***
Lyskamm: folds 
dancayamanda: raises $0.15 to $0.25
neurophunker: folds 
LoongWalk: folds 
AndriuWasa: folds 
Uncalled bet ($0.15) returned to dancayamanda
dancayamanda collected $0.25 from pot
dancayamanda: doesn't show hand 
*** SUMMARY ***
Total pot $0.25 | Rake $0 
Seat 1: Lyskamm folded before Flop (didn't bet)
Seat 2: dancayamanda collected ($0.25)
Seat 3: neurophunker (button) folded before Flop (didn't bet)
Seat 4: LoongWalk (small blind) folded before Flop
Seat 6: AndriuWasa (big blind) folded before Flop



PokerStars Hand #222964392617:  Hold'em No Limit ($0.05/$0.10 USD) - 2021/01/23 13:43:15 ET
Table 'Grus IV' 6-max Seat #4 is the button
Seat 1: Lyskamm ($7.14 in chips) 
Seat 2: dancayamanda ($10.82 in chips) 
Seat 3: neurophunker ($10.07 in chips) 
Seat 4: LoongWalk ($8.44 in chips) 
Seat 6: AndriuWasa ($13.37 in chips) 
AndriuWasa: posts small blind $0.05
Lyskamm: posts big blind $0.10
*** HOLE CARDS ***
dancayamanda: folds 
neurophunker: folds 
LoongWalk: raises $0.20 to $0.30
AndriuWasa: folds 
Lyskamm: folds 
Uncalled bet ($0.20) returned to LoongWalk
LoongWalk collected $0.25 from pot
LoongWalk: doesn't show hand 
*** SUMMARY ***
Total pot $0.25 | Rake $0 
Seat 1: Lyskamm (big blind) folded before Flop
Seat 2: dancayamanda folded before Flop (didn't bet)
Seat 3: neurophunker folded before Flop (didn't bet)
Seat 4: LoongWalk (button) collected ($0.25)
Seat 6: AndriuWasa (small blind) folded before Flop



PokerStars Hand #222964403228:  Hold'em No Limit ($0.05/$0.10 USD) - 2021/01/23 13:43:29 ET
Table 'Grus IV' 6-max Seat #6 is the button
Seat 1: Lyskamm ($7.04 in chips) 
Seat 2: dancayamanda ($10.82 in chips) 
Seat 3: neurophunker ($10.07 in chips) 
Seat 4: LoongWalk ($8.59 in chips) 
Seat 5: rc10111967 ($8.60 in chips) 
Seat 6: AndriuWasa ($13.32 in chips) 
Lyskamm: posts small blind $0.05
dancayamanda: posts big blind $0.10
rc10111967: posts small & big blinds $0.15
*** HOLE CARDS ***
neurophunker: raises $0.20 to $0.30
LoongWalk: calls $0.30
rc10111967: folds 
AndriuWasa: folds 
Lyskamm: calls $0.25
dancayamanda: folds 
*** FLOP *** [5d 3d 6d]
Lyskamm: checks 
neurophunker: bets $0.60
LoongWalk: calls $0.60
Lyskamm: folds 
*** TURN *** [5d 3d 6d] [6s]
neurophunker: bets $1.20
LoongWalk: calls $1.20
*** RIVER *** [5d 3d 6d 6s] [5s]
neurophunker: bets $7.97 and is all-in
LoongWalk: folds 
Uncalled bet ($7.97) returned to neurophunker
neurophunker collected $4.54 from pot
neurophunker: doesn't show hand 
*** SUMMARY ***
Total pot $4.75 | Rake $0.21 
Board [5d 3d 6d 6s 5s]
Seat 1: Lyskamm (small blind) folded on the Flop
Seat 2: dancayamanda (big blind) folded before Flop
Seat 3: neurophunker collected ($4.54)
Seat 4: LoongWalk folded on the River
Seat 5: rc10111967 folded before Flop (didn't bet)
Seat 6: AndriuWasa (button) folded before Flop (didn't bet)



PokerStars Hand #222964461368:  Hold'em No Limit ($0.05/$0.10 USD) - 2021/01/23 13:44:37 ET
Table 'Grus IV' 6-max Seat #1 is the button
Seat 1: Lyskamm ($6.74 in chips) 
Seat 2: dancayamanda ($10.72 in chips) 
Seat 3: neurophunker ($12.51 in chips) 
Seat 4: LoongWalk ($6.49 in chips) 
Seat 5: rc10111967 ($8.45 in chips) 
Seat 6: AndriuWasa ($13.32 in chips) 
dancayamanda: posts small blind $0.05
neurophunker: posts big blind $0.10
*** HOLE CARDS ***
LoongWalk: folds 
rc10111967: calls $0.10
AndriuWasa: raises $0.25 to $0.35
Lyskamm: folds 
dancayamanda: folds 
neurophunker: folds 
rc10111967: folds 
Uncalled bet ($0.25) returned to AndriuWasa
AndriuWasa collected $0.35 from pot
AndriuWasa: doesn't show hand 
*** SUMMARY ***
Total pot $0.35 | Rake $0 
Seat 1: Lyskamm (button) folded before Flop (didn't bet)
Seat 2: dancayamanda (small blind) folded before Flop
Seat 3: neurophunker (big blind) folded before Flop
Seat 4: LoongWalk folded before Flop (didn't bet)
Seat 5: rc10111967 folded before Flop
Seat 6: AndriuWasa collected ($0.35)



PokerStars Hand #222964487963:  Hold'em No Limit ($0.05/$0.10 USD) - 2021/01/23 13:45:11 ET
Table 'Grus IV' 6-max Seat #2 is the button
Seat 1: Lyskamm ($6.74 in chips) 
Seat 2: dancayamanda ($10.67 in chips) 
Seat 3: neurophunker ($12.41 in chips) 
Seat 4: LoongWalk ($6.49 in chips) 
Seat 5: rc10111967 ($8.35 in chips) 
Seat 6: AndriuWasa ($13.57 in chips) 
neurophunker: posts small blind $0.05
LoongWalk: posts big blind $0.10
*** HOLE CARDS ***
rc10111967: calls $0.10
AndriuWasa: folds 
Lyskamm: raises $0.40 to $0.50
dancayamanda: folds 
neurophunker: raises $1.90 to $2.40
LoongWalk: folds 
rc10111967: folds 
Lyskamm: folds 
Uncalled bet ($1.90) returned to neurophunker
neurophunker collected $1.20 from pot
neurophunker: doesn't show hand 
*** SUMMARY ***
Total pot $1.20 | Rake $0 
Seat 1: Lyskamm folded before Flop
Seat 2: dancayamanda (button) folded before Flop (didn't bet)
Seat 3: neurophunker (small blind) collected ($1.20)
Seat 4: LoongWalk (big blind) folded before Flop
Seat 5: rc10111967 folded before Flop
Seat 6: AndriuWasa folded before Flop (didn't bet)



PokerStars Hand #222964522459:  Hold'em No Limit ($0.05/$0.10 USD) - 2021/01/23 13:45:56 ET
Table 'Grus IV' 6-max Seat #3 is the button
Seat 1: Lyskamm ($6.24 in chips) 
Seat 2: dancayamanda ($10.67 in chips) 
Seat 3: neurophunker ($13.11 in chips) 
Seat 4: LoongWalk ($6.39 in chips) 
Seat 5: rc10111967 ($8.25 in chips) 
Seat 6: AndriuWasa ($13.57 in chips) 
LoongWalk: posts small blind $0.05
rc10111967: posts big blind $0.10
*** HOLE CARDS ***
AndriuWasa: folds 
Lyskamm: folds 
dancayamanda: folds 
neurophunker: folds 
LoongWalk: folds 
Uncalled bet ($0.05) returned to rc10111967
rc10111967 collected $0.10 from pot
*** SUMMARY ***
Total pot $0.10 | Rake $0 
Seat 1: Lyskamm folded before Flop (didn't bet)
Seat 2: dancayamanda folded before Flop (didn't bet)
Seat 3: neurophunker (button) folded before Flop (didn't bet)
Seat 4: LoongWalk (small blind) folded before Flop
Seat 5: rc10111967 (big blind) collected ($0.10)
Seat 6: AndriuWasa folded before Flop (didn't bet)



PokerStars Hand #222964533299:  Hold'em No Limit ($0.05/$0.10 USD) - 2021/01/23 13:46:10 ET
Table 'Grus IV' 6-max Seat #4 is the button
Seat 1: Lyskamm ($6.24 in chips) 
Seat 2: dancayamanda ($10.67 in chips) 
Seat 3: neurophunker ($13.11 in chips) 
Seat 4: LoongWalk ($6.34 in chips) 
Seat 5: rc10111967 ($8.30 in chips) 
Seat 6: AndriuWasa ($13.57 in chips) 
rc10111967: posts small blind $0.05
AndriuWasa: posts big blind $0.10
*** HOLE CARDS ***
Lyskamm: folds 
dancayamanda: folds 
neurophunker: raises $0.15 to $0.25
LoongWalk: calls $0.25
rc10111967: calls $0.20
AndriuWasa: folds 
*** FLOP *** [9c Js Td]
rc10111967: bets $0.81
neurophunker: folds 
LoongWalk: calls $0.81
*** TURN *** [9c Js Td] [As]
rc10111967: bets $7.24 and is all-in
LoongWalk: calls $5.28 and is all-in
Uncalled bet ($1.96) returned to rc10111967
*** RIVER *** [9c Js Td As] [2s]
*** SHOW DOWN ***
rc10111967: shows [8s Qd] (a straight, Eight to Queen)
LoongWalk: shows [Qh Kd] (a straight, Ten to Ace)
LoongWalk collected $12.44 from pot
rc10111967 cashed out the hand for $0.43
*** SUMMARY ***
Total pot $13.03 | Rake $0.59 
Board [9c Js Td As 2s]
Seat 1: Lyskamm folded before Flop (didn't bet)
Seat 2: dancayamanda folded before Flop (didn't bet)
Seat 3: neurophunker folded on the Flop
Seat 4: LoongWalk (button) showed [Qh Kd] and won ($12.44) with a straight, Ten to Ace
Seat 5: rc10111967 (small blind) showed [8s Qd] and lost with a straight, Eight to Queen (cashed out).
Seat 6: AndriuWasa (big blind) folded before Flop



PokerStars Hand #222964580426:  Hold'em No Limit ($0.05/$0.10 USD) - 2021/01/23 13:47:12 ET
Table 'Grus IV' 6-max Seat #5 is the button
Seat 1: Lyskamm ($6.24 in chips) 
Seat 2: dancayamanda ($10.67 in chips) 
Seat 3: neurophunker ($12.86 in chips) 
Seat 4: LoongWalk ($12.44 in chips) 
Seat 5: rc10111967 ($2.39 in chips) 
Seat 6: AndriuWasa ($13.47 in chips) 
AndriuWasa: posts small blind $0.05
Lyskamm: posts big blind $0.10
*** HOLE CARDS ***
dancayamanda: folds 
neurophunker: folds 
LoongWalk: folds 
rc10111967: raises $0.20 to $0.30
AndriuWasa: folds 
Lyskamm: folds 
Uncalled bet ($0.20) returned to rc10111967
rc10111967 collected $0.25 from pot
*** SUMMARY ***
Total pot $0.25 | Rake $0 
Seat 1: Lyskamm (big blind) folded before Flop
Seat 2: dancayamanda folded before Flop (didn't bet)
Seat 3: neurophunker folded before Flop (didn't bet)
Seat 4: LoongWalk folded before Flop (didn't bet)
Seat 5: rc10111967 (button) collected ($0.25)
Seat 6: AndriuWasa (small blind) folded before Flop



PokerStars Hand #222964591090:  Hold'em No Limit ($0.05/$0.10 USD) - 2021/01/23 13:47:26 ET
Table 'Grus IV' 6-max Seat #6 is the button
Seat 1: Lyskamm ($6.14 in chips) 
Seat 2: dancayamanda ($10.67 in chips) 
Seat 3: neurophunker ($12.86 in chips) 
Seat 4: LoongWalk ($12.44 in chips) 
Seat 5: rc10111967 ($2.54 in chips) 
Seat 6: AndriuWasa ($13.42 in chips) 
Lyskamm: posts small blind $0.05
dancayamanda: posts big blind $0.10
*** HOLE CARDS ***
neurophunker: raises $0.20 to $0.30
LoongWalk: folds 
LoongWalk leaves the table
rc10111967: folds 
AndriuWasa: folds 
Lyskamm: folds 
dancayamanda: folds 
Uncalled bet ($0.20) returned to neurophunker
neurophunker collected $0.25 from pot
neurophunker: doesn't show hand 
*** SUMMARY ***
Total pot $0.25 | Rake $0 
Seat 1: Lyskamm (small blind) folded before Flop
Seat 2: dancayamanda (big blind) folded before Flop
Seat 3: neurophunker collected ($0.25)
Seat 4: LoongWalk folded before Flop (didn't bet)
Seat 5: rc10111967 folded before Flop (didn't bet)
Seat 6: AndriuWasa (button) folded before Flop (didn't bet)



PokerStars Hand #222964606267:  Hold'em No Limit ($0.05/$0.10 USD) - 2021/01/23 13:47:46 ET
Table 'Grus IV' 6-max Seat #1 is the button
Seat 1: Lyskamm ($6.09 in chips) 
Seat 2: dancayamanda ($10.57 in chips) 
Seat 3: neurophunker ($13.01 in chips) 
Seat 5: rc10111967 ($2.54 in chips) 
Seat 6: AndriuWasa ($13.42 in chips) 
dancayamanda: posts small blind $0.05
neurophunker: posts big blind $0.10
*** HOLE CARDS ***
rc10111967: calls $0.10
AndriuWasa: folds 
Lyskamm: folds 
Pagetts joins the table at seat #4 
dancayamanda: folds 
neurophunker: checks 
*** FLOP *** [3c 6h 3h]
neurophunker: checks 
rc10111967: bets $0.24
neurophunker: folds 
Uncalled bet ($0.24) returned to rc10111967
rc10111967 collected $0.24 from pot
*** SUMMARY ***
Total pot $0.25 | Rake $0.01 
Board [3c 6h 3h]
Seat 1: Lyskamm (button) folded before Flop (didn't bet)
Seat 2: dancayamanda (small blind) folded before Flop
Seat 3: neurophunker (big blind) folded on the Flop
Seat 5: rc10111967 collected ($0.24)
Seat 6: AndriuWasa folded before Flop (didn't bet)



PokerStars Hand #222964629623:  Hold'em No Limit ($0.05/$0.10 USD) - 2021/01/23 13:48:17 ET
Table 'Grus IV' 6-max Seat #2 is the button
Seat 1: Lyskamm ($6.09 in chips) 
Seat 2: dancayamanda ($10.52 in chips) 
Seat 3: neurophunker ($12.91 in chips) 
Seat 4: Pagetts ($10 in chips) 
Seat 5: rc10111967 ($2.68 in chips) 
Seat 6: AndriuWasa ($13.42 in chips) 
neurophunker: posts small blind $0.05
Pagetts: posts big blind $0.10
*** HOLE CARDS ***
rc10111967: raises $0.10 to $0.20
AndriuWasa: folds 
Lyskamm: folds 
dancayamanda: folds 
neurophunker: calls $0.15
Pagetts: folds 
*** FLOP *** [Ac 6h 3c]
neurophunker: checks 
rc10111967: bets $0.48
neurophunker: folds 
Uncalled bet ($0.48) returned to rc10111967
rc10111967 collected $0.48 from pot
*** SUMMARY ***
Total pot $0.50 | Rake $0.02 
Board [Ac 6h 3c]
Seat 1: Lyskamm folded before Flop (didn't bet)
Seat 2: dancayamanda (button) folded before Flop (didn't bet)
Seat 3: neurophunker (small blind) folded on the Flop
Seat 4: Pagetts (big blind) folded before Flop
Seat 5: rc10111967 collected ($0.48)
Seat 6: AndriuWasa folded before Flop (didn't bet)



PokerStars Hand #222964662285:  Hold'em No Limit ($0.05/$0.10 USD) - 2021/01/23 13:49:00 ET
Table 'Grus IV' 6-max Seat #3 is the button
Seat 1: Lyskamm ($6.09 in chips) 
Seat 2: dancayamanda ($10.52 in chips) 
Seat 3: neurophunker ($12.71 in chips) 
Seat 4: Pagetts ($9.90 in chips) 
Seat 5: rc10111967 ($2.96 in chips) 
Seat 6: AndriuWasa ($13.42 in chips) 
Pagetts: posts small blind $0.05
rc10111967: posts big blind $0.10
*** HOLE CARDS ***
AndriuWasa: folds 
Lyskamm: folds 
dancayamanda: raises $0.15 to $0.25
neurophunker: calls $0.25
Pagetts: calls $0.20
rc10111967: raises $0.75 to $1
dancayamanda: raises $2.10 to $3.10
neurophunker: folds 
Pagetts: folds 
rc10111967: calls $1.96 and is all-in
Uncalled bet ($0.14) returned to dancayamanda
*** FLOP *** [Ts Th Td]
*** TURN *** [Ts Th Td] [7c]
*** RIVER *** [Ts Th Td 7c] [2c]
*** SHOW DOWN ***
rc10111967: shows [As Kc] (three of a kind, Tens)
dancayamanda: shows [Qd Qh] (a full house, Tens full of Queens)
dancayamanda collected $6.13 from pot
*** SUMMARY ***
Total pot $6.42 | Rake $0.29 
Board [Ts Th Td 7c 2c]
Seat 1: Lyskamm folded before Flop (didn't bet)
Seat 2: dancayamanda showed [Qd Qh] and won ($6.13) with a full house, Tens full of Queens
Seat 3: neurophunker (button) folded before Flop
Seat 4: Pagetts (small blind) folded before Flop
Seat 5: rc10111967 (big blind) showed [As Kc] and lost with three of a kind, Tens
Seat 6: AndriuWasa folded before Flop (didn't bet)



PokerStars Hand #222964696131:  Hold'em No Limit ($0.05/$0.10 USD) - 2021/01/23 13:49:44 ET
Table 'Grus IV' 6-max Seat #4 is the button
Seat 1: Lyskamm ($6.09 in chips) 
Seat 2: dancayamanda ($13.69 in chips) 
Seat 3: neurophunker ($12.46 in chips) 
Seat 4: Pagetts ($9.65 in chips) 
Seat 6: AndriuWasa ($13.42 in chips) 
AndriuWasa: posts small blind $0.05
Lyskamm: posts big blind $0.10
*** HOLE CARDS ***
dancayamanda: folds 
neurophunker: folds 
Pagetts: calls $0.10
AndriuWasa: folds 
rc10111967 leaves the table
Lyskamm: checks 
*** FLOP *** [Qs 5d 6c]
Lyskamm: checks 
Pagetts: bets $0.10
Lyskamm: folds 
Uncalled bet ($0.10) returned to Pagetts
Pagetts collected $0.24 from pot
Pagetts: doesn't show hand 
BetGuy69 joins the table at seat #5 
*** SUMMARY ***
Total pot $0.25 | Rake $0.01 
Board [Qs 5d 6c]
Seat 1: Lyskamm (big blind) folded on the Flop
Seat 2: dancayamanda folded before Flop (didn't bet)
Seat 3: neurophunker folded before Flop (didn't bet)
Seat 4: Pagetts (button) collected ($0.24)
Seat 6: AndriuWasa (small blind) folded before Flop



PokerStars Hand #222964712697:  Hold'em No Limit ($0.05/$0.10 USD) - 2021/01/23 13:50:06 ET
Table 'Grus IV' 6-max Seat #6 is the button
Seat 1: Lyskamm ($5.99 in chips) 
Seat 2: dancayamanda ($13.69 in chips) 
Seat 3: neurophunker ($12.46 in chips) 
Seat 4: Pagetts ($9.79 in chips) 
Seat 6: AndriuWasa ($13.37 in chips) 
Lyskamm: posts small blind $0.05
dancayamanda: posts big blind $0.10
BetGuy69: sits out 
*** HOLE CARDS ***
neurophunker: folds 
Pagetts: raises $0.10 to $0.20
AndriuWasa: folds 
Lyskamm: folds 
dancayamanda: calls $0.10
*** FLOP *** [4h 8h 6d]
dancayamanda: checks 
Pagetts: checks 
*** TURN *** [4h 8h 6d] [Ac]
dancayamanda: checks 
Pagetts: checks 
*** RIVER *** [4h 8h 6d Ac] [7s]
dancayamanda: bets $0.40
Pagetts: folds 
Uncalled bet ($0.40) returned to dancayamanda
dancayamanda collected $0.43 from pot
dancayamanda: doesn't show hand 
*** SUMMARY ***
Total pot $0.45 | Rake $0.02 
Board [4h 8h 6d Ac 7s]
Seat 1: Lyskamm (small blind) folded before Flop
Seat 2: dancayamanda (big blind) collected ($0.43)
Seat 3: neurophunker folded before Flop (didn't bet)
Seat 4: Pagetts folded on the River
Seat 6: AndriuWasa (button) folded before Flop (didn't bet)



PokerStars Hand #222964742991:  Hold'em No Limit ($0.05/$0.10 USD) - 2021/01/23 13:50:45 ET
Table 'Grus IV' 6-max Seat #1 is the button
Seat 1: Lyskamm ($5.94 in chips) 
Seat 2: dancayamanda ($13.92 in chips) 
Seat 3: neurophunker ($12.46 in chips) 
Seat 4: Pagetts ($9.59 in chips) 
Seat 6: AndriuWasa ($13.37 in chips) 
dancayamanda: posts small blind $0.05
neurophunker: posts big blind $0.10
BetGuy69: sits out 
*** HOLE CARDS ***
Pagetts: calls $0.10
AndriuWasa: raises $0.25 to $0.35
Lyskamm: folds 
dancayamanda: folds 
neurophunker: calls $0.25
Pagetts: folds 
*** FLOP *** [Qd 3c 4d]
neurophunker: checks 
AndriuWasa: checks 
*** TURN *** [Qd 3c 4d] [2s]
neurophunker: checks 
AndriuWasa: checks 
*** RIVER *** [Qd 3c 4d 2s] [Jc]
neurophunker: checks 
AndriuWasa: checks 
*** SHOW DOWN ***
neurophunker: shows [Kh Ts] (high card King)
AndriuWasa: shows [Kd Td] (high card King)
neurophunker collected $0.41 from pot
AndriuWasa collected $0.40 from pot
*** SUMMARY ***
Total pot $0.85 | Rake $0.04 
Board [Qd 3c 4d 2s Jc]
Seat 1: Lyskamm (button) folded before Flop (didn't bet)
Seat 2: dancayamanda (small blind) folded before Flop
Seat 3: neurophunker (big blind) showed [Kh Ts] and won ($0.41) with high card King
Seat 4: Pagetts folded before Flop
Seat 6: AndriuWasa showed [Kd Td] and won ($0.40) with high card King



PokerStars Hand #222964789673:  Hold'em No Limit ($0.05/$0.10 USD) - 2021/01/23 13:51:46 ET
Table 'Grus IV' 6-max Seat #2 is the button
Seat 1: Lyskamm ($5.94 in chips) 
Seat 2: dancayamanda ($13.87 in chips) 
Seat 3: neurophunker ($12.52 in chips) 
Seat 4: Pagetts ($9.49 in chips) 
Seat 6: AndriuWasa ($13.42 in chips) 
neurophunker: posts small blind $0.05
Pagetts: posts big blind $0.10
BetGuy69: sits out 
*** HOLE CARDS ***
AndriuWasa: folds 
Lyskamm: folds 
dancayamanda: raises $0.15 to $0.25
neurophunker: folds 
Pagetts: calls $0.15
*** FLOP *** [4s 2h 8c]
Pagetts: checks 
dancayamanda: checks 
*** TURN *** [4s 2h 8c] [7s]
Pagetts: checks 
dancayamanda: bets $0.27
Pagetts: folds 
Uncalled bet ($0.27) returned to dancayamanda
dancayamanda collected $0.53 from pot
dancayamanda: doesn't show hand 
*** SUMMARY ***
Total pot $0.55 | Rake $0.02 
Board [4s 2h 8c 7s]
Seat 1: Lyskamm folded before Flop (didn't bet)
Seat 2: dancayamanda (button) collected ($0.53)
Seat 3: neurophunker (small blind) folded before Flop
Seat 4: Pagetts (big blind) folded on the Turn
Seat 6: AndriuWasa folded before Flop (didn't bet)



PokerStars Hand #222964822902:  Hold'em No Limit ($0.05/$0.10 USD) - 2021/01/23 13:52:30 ET
Table 'Grus IV' 6-max Seat #3 is the button
Seat 1: Lyskamm ($5.94 in chips) 
Seat 2: dancayamanda ($14.15 in chips) 
Seat 3: neurophunker ($12.47 in chips) 
Seat 4: Pagetts ($9.24 in chips) 
Seat 5: BetGuy69 ($10 in chips) 
Seat 6: AndriuWasa ($13.42 in chips) 
Pagetts: posts small blind $0.05
BetGuy69: posts big blind $0.10
*** HOLE CARDS ***
AndriuWasa: raises $0.15 to $0.25
Lyskamm: folds 
dancayamanda: folds 
neurophunker: folds 
Pagetts: folds 
BetGuy69: folds 
Uncalled bet ($0.15) returned to AndriuWasa
AndriuWasa collected $0.25 from pot
AndriuWasa: doesn't show hand 
*** SUMMARY ***
Total pot $0.25 | Rake $0 
Seat 1: Lyskamm folded before Flop (didn't bet)
Seat 2: dancayamanda folded before Flop (didn't bet)
Seat 3: neurophunker (button) folded before Flop (didn't bet)
Seat 4: Pagetts (small blind) folded before Flop
Seat 5: BetGuy69 (big blind) folded before Flop
Seat 6: AndriuWasa collected ($0.25)



PokerStars Hand #222964841547:  Hold'em No Limit ($0.05/$0.10 USD) - 2021/01/23 13:52:55 ET
Table 'Grus IV' 6-max Seat #4 is the button
Seat 1: Lyskamm ($5.94 in chips) 
Seat 2: dancayamanda ($14.15 in chips) 
Seat 3: neurophunker ($12.47 in chips) 
Seat 4: Pagetts ($9.19 in chips) 
Seat 5: BetGuy69 ($10 in chips) 
Seat 6: AndriuWasa ($13.57 in chips) 
BetGuy69: posts small blind $0.05
AndriuWasa: posts big blind $0.10
*** HOLE CARDS ***
Lyskamm: folds 
dancayamanda: folds 
neurophunker: folds 
Pagetts: calls $0.10
BetGuy69: folds 
AndriuWasa: checks 
*** FLOP *** [5d Jd Th]
AndriuWasa: checks 
Pagetts: checks 
*** TURN *** [5d Jd Th] [9d]
AndriuWasa: bets $0.13
Pagetts: calls $0.13
*** RIVER *** [5d Jd Th 9d] [6c]
AndriuWasa: checks 
Pagetts: checks 
*** SHOW DOWN ***
AndriuWasa: shows [5h Ts] (two pair, Tens and Fives)
Pagetts: mucks hand 
AndriuWasa collected $0.49 from pot
*** SUMMARY ***
Total pot $0.51 | Rake $0.02 
Board [5d Jd Th 9d 6c]
Seat 1: Lyskamm folded before Flop (didn't bet)
Seat 2: dancayamanda folded before Flop (didn't bet)
Seat 3: neurophunker folded before Flop (didn't bet)
Seat 4: Pagetts (button) mucked
Seat 5: BetGuy69 (small blind) folded before Flop
Seat 6: AndriuWasa (big blind) showed [5h Ts] and won ($0.49) with two pair, Tens and Fives



PokerStars Hand #222964878509:  Hold'em No Limit ($0.05/$0.10 USD) - 2021/01/23 13:53:43 ET
Table 'Grus IV' 6-max Seat #5 is the button
Seat 1: Lyskamm ($5.94 in chips) 
Seat 2: dancayamanda ($14.15 in chips) 
Seat 3: neurophunker ($12.47 in chips) 
Seat 4: Pagetts ($8.96 in chips) 
Seat 5: BetGuy69 ($10 in chips) 
Seat 6: AndriuWasa ($13.83 in chips) 
AndriuWasa: posts small blind $0.05
Lyskamm: posts big blind $0.10
*** HOLE CARDS ***
dancayamanda: folds 
neurophunker: raises $0.20 to $0.30
Pagetts: folds 
BetGuy69: folds 
AndriuWasa: folds 
Lyskamm: folds 
Uncalled bet ($0.20) returned to neurophunker
neurophunker collected $0.25 from pot
neurophunker: doesn't show hand 
*** SUMMARY ***
Total pot $0.25 | Rake $0 
Seat 1: Lyskamm (big blind) folded before Flop
Seat 2: dancayamanda folded before Flop (didn't bet)
Seat 3: neurophunker collected ($0.25)
Seat 4: Pagetts folded before Flop (didn't bet)
Seat 5: BetGuy69 (button) folded before Flop (didn't bet)
Seat 6: AndriuWasa (small blind) folded before Flop



PokerStars Hand #222964892930:  Hold'em No Limit ($0.05/$0.10 USD) - 2021/01/23 13:54:02 ET
Table 'Grus IV' 6-max Seat #6 is the button
Seat 1: Lyskamm ($5.84 in chips) 
Seat 2: dancayamanda ($14.15 in chips) 
Seat 3: neurophunker ($12.62 in chips) 
Seat 4: Pagetts ($8.96 in chips) 
Seat 5: BetGuy69 ($10 in chips) 
Seat 6: AndriuWasa ($13.78 in chips) 
Lyskamm: posts small blind $0.05
dancayamanda: posts big blind $0.10
*** HOLE CARDS ***
neurophunker: folds 
Pagetts: calls $0.10
BetGuy69: raises $0.30 to $0.40
AndriuWasa: folds 
Lyskamm: calls $0.35
dancayamanda: folds 
Pagetts: folds 
*** FLOP *** [9h 4s 2h]
Lyskamm: checks 
BetGuy69: bets $0.63
Lyskamm: folds 
Uncalled bet ($0.63) returned to BetGuy69
BetGuy69 collected $0.96 from pot
BetGuy69: doesn't show hand 
*** SUMMARY ***
Total pot $1 | Rake $0.04 
Board [9h 4s 2h]
Seat 1: Lyskamm (small blind) folded on the Flop
Seat 2: dancayamanda (big blind) folded before Flop
Seat 3: neurophunker folded before Flop (didn't bet)
Seat 4: Pagetts folded before Flop
Seat 5: BetGuy69 collected ($0.96)
Seat 6: AndriuWasa (button) folded before Flop (didn't bet)



PokerStars Hand #222964922512:  Hold'em No Limit ($0.05/$0.10 USD) - 2021/01/23 13:54:41 ET
Table 'Grus IV' 6-max Seat #1 is the button
Seat 1: Lyskamm ($5.44 in chips) 
Seat 2: dancayamanda ($14.05 in chips) 
Seat 4: Pagetts ($8.86 in chips) 
Seat 5: BetGuy69 ($10.56 in chips) 
Seat 6: AndriuWasa ($13.78 in chips) 
dancayamanda: posts small blind $0.05
Pagetts: posts big blind $0.10
*** HOLE CARDS ***
BetGuy69: folds 
AndriuWasa: folds 
Lyskamm: raises $0.15 to $0.25
dancayamanda: folds 
neurophunker leaves the table
Pagetts: calls $0.15
*** FLOP *** [Ac 8c 4h]
Pagetts: checks 
Lyskamm: bets $0.27
Pagetts: folds 
Uncalled bet ($0.27) returned to Lyskamm
Lyskamm collected $0.53 from pot
Lyskamm: doesn't show hand 
*** SUMMARY ***
Total pot $0.55 | Rake $0.02 
Board [Ac 8c 4h]
Seat 1: Lyskamm (button) collected ($0.53)
Seat 2: dancayamanda (small blind) folded before Flop
Seat 4: Pagetts (big blind) folded on the Flop
Seat 5: BetGuy69 folded before Flop (didn't bet)
Seat 6: AndriuWasa folded before Flop (didn't bet)



PokerStars Hand #222964940485:  Hold'em No Limit ($0.05/$0.10 USD) - 2021/01/23 13:55:05 ET
Table 'Grus IV' 6-max Seat #2 is the button
Seat 1: Lyskamm ($5.72 in chips) 
Seat 2: dancayamanda ($14 in chips) 
Seat 4: Pagetts ($8.61 in chips) 
Seat 5: BetGuy69 ($10.56 in chips) 
Seat 6: AndriuWasa ($13.78 in chips) 
Pagetts: posts small blind $0.05
BetGuy69: posts big blind $0.10
*** HOLE CARDS ***
AndriuWasa: folds 
Lyskamm: folds 
dancayamanda: folds 
TOLK78 joins the table at seat #3 
Pagetts: calls $0.05
BetGuy69: checks 
*** FLOP *** [6h 5s 3h]
Pagetts: checks 
BetGuy69: bets $0.15
Pagetts: calls $0.15
*** TURN *** [6h 5s 3h] [5h]
Pagetts: checks 
BetGuy69: checks 
*** RIVER *** [6h 5s 3h 5h] [7h]
Pagetts: bets $8.36 and is all-in
BetGuy69: folds 
Uncalled bet ($8.36) returned to Pagetts
Pagetts collected $0.48 from pot
Pagetts: doesn't show hand 
*** SUMMARY ***
Total pot $0.50 | Rake $0.02 
Board [6h 5s 3h 5h 7h]
Seat 1: Lyskamm folded before Flop (didn't bet)
Seat 2: dancayamanda (button) folded before Flop (didn't bet)
Seat 4: Pagetts (small blind) collected ($0.48)
Seat 5: BetGuy69 (big blind) folded on the River
Seat 6: AndriuWasa folded before Flop (didn't bet)



PokerStars Hand #222964961681:  Hold'em No Limit ($0.05/$0.10 USD) - 2021/01/23 13:55:48 ET
Table 'Grus IV' 6-max Seat #4 is the button
Seat 1: Lyskamm ($5.72 in chips) 
Seat 4: Pagetts ($8.84 in chips) 
Seat 5: BetGuy69 ($10.31 in chips) 
Seat 6: AndriuWasa ($13.78 in chips) 
BetGuy69: posts small blind $0.05
AndriuWasa: posts big blind $0.10
TOLK78: sits out 
*** HOLE CARDS ***
Lyskamm: folds 
Pagetts: calls $0.10
BetGuy69: folds 
AndriuWasa: checks 
*** FLOP *** [7d 7s 4d]
AndriuWasa: checks 
Pagetts: checks 
*** TURN *** [7d 7s 4d] [6c]
AndriuWasa: checks 
Pagetts: bets $0.60
AndriuWasa: folds 
Uncalled bet ($0.60) returned to Pagetts
Pagetts collected $0.24 from pot
Pagetts: doesn't show hand 
*** SUMMARY ***
Total pot $0.25 | Rake $0.01 
Board [7d 7s 4d 6c]
Seat 1: Lyskamm folded before Flop (didn't bet)
Seat 4: Pagetts (button) collected ($0.24)
Seat 5: BetGuy69 (small blind) folded before Flop
Seat 6: AndriuWasa (big blind) folded on the Turn



PokerStars Hand #222964978507:  Hold'em No Limit ($0.05/$0.10 USD) - 2021/01/23 13:56:22 ET
Table 'Grus IV' 6-max Seat #5 is the button
Seat 1: Lyskamm ($5.72 in chips) 
Seat 4: Pagetts ($8.98 in chips) 
Seat 5: BetGuy69 ($10.26 in chips) 
Seat 6: AndriuWasa ($13.68 in chips) 
AndriuWasa: posts small blind $0.05
Lyskamm: posts big blind $0.10
TOLK78: sits out 
*** HOLE CARDS ***
Pagetts: raises $0.10 to $0.20
BetGuy69: folds 
AndriuWasa: folds 
Lyskamm: folds 
Uncalled bet ($0.10) returned to Pagetts
Pagetts collected $0.25 from pot
Pagetts: doesn't show hand 
*** SUMMARY ***
Total pot $0.25 | Rake $0 
Seat 1: Lyskamm (big blind) folded before Flop
Seat 4: Pagetts collected ($0.25)
Seat 5: BetGuy69 (button) folded before Flop (didn't bet)
Seat 6: AndriuWasa (small blind) folded before Flop



PokerStars Hand #222964982207:  Hold'em No Limit ($0.05/$0.10 USD) - 2021/01/23 13:56:30 ET
Table 'Grus IV' 6-max Seat #6 is the button
Seat 1: Lyskamm ($5.62 in chips) 
Seat 3: TOLK78 ($10 in chips) 
Seat 4: Pagetts ($9.13 in chips) 
Seat 5: BetGuy69 ($10.26 in chips) 
Seat 6: AndriuWasa ($13.63 in chips) 
Lyskamm: posts small blind $0.05
TOLK78: posts big blind $0.10
*** HOLE CARDS ***
Pagetts: raises $0.10 to $0.20
BetGuy69: folds 
AndriuWasa: folds 
Lyskamm: folds 
TOLK78: folds 
Uncalled bet ($0.10) returned to Pagetts
Pagetts collected $0.25 from pot
Pagetts: doesn't show hand 
*** SUMMARY ***
Total pot $0.25 | Rake $0 
Seat 1: Lyskamm (small blind) folded before Flop
Seat 3: TOLK78 (big blind) folded before Flop
Seat 4: Pagetts collected ($0.25)
Seat 5: BetGuy69 folded before Flop (didn't bet)
Seat 6: AndriuWasa (button) folded before Flop (didn't bet)



PokerStars Hand #222964985967:  Hold'em No Limit ($0.05/$0.10 USD) - 2021/01/23 13:56:38 ET
Table 'Grus IV' 6-max Seat #1 is the button
Seat 1: Lyskamm ($5.57 in chips) 
Seat 3: TOLK78 ($10 in chips) 
Seat 4: Pagetts ($9.28 in chips) 
Seat 5: BetGuy69 ($10.26 in chips) 
Seat 6: AndriuWasa ($13.63 in chips) 
TOLK78: posts small blind $0.05
Pagetts: posts big blind $0.10
*** HOLE CARDS ***
BetGuy69: folds 
AndriuWasa: raises $0.15 to $0.25
Lyskamm: folds 
TOLK78: folds 
Pagetts: calls $0.15
*** FLOP *** [2s Qd 3c]
Pagetts: checks 
AndriuWasa: bets $0.28
Pagetts: calls $0.28
*** TURN *** [2s Qd 3c] [6s]
Pagetts: checks 
AndriuWasa: bets $0.56
Pagetts: folds 
Uncalled bet ($0.56) returned to AndriuWasa
AndriuWasa collected $1.06 from pot
AndriuWasa: doesn't show hand 
*** SUMMARY ***
Total pot $1.11 | Rake $0.05 
Board [2s Qd 3c 6s]
Seat 1: Lyskamm (button) folded before Flop (didn't bet)
Seat 3: TOLK78 (small blind) folded before Flop
Seat 4: Pagetts (big blind) folded on the Turn
Seat 5: BetGuy69 folded before Flop (didn't bet)
Seat 6: AndriuWasa collected ($1.06)



PokerStars Hand #222964997730:  Hold'em No Limit ($0.05/$0.10 USD) - 2021/01/23 13:57:02 ET
Table 'Grus IV' 6-max Seat #3 is the button
Seat 1: Lyskamm ($5.57 in chips) 
Seat 3: TOLK78 ($10 in chips) 
Seat 4: Pagetts ($8.75 in chips) 
Seat 5: BetGuy69 ($10.26 in chips) 
Seat 6: AndriuWasa ($14.16 in chips) 
Pagetts: posts small blind $0.05
BetGuy69: posts big blind $0.10
*** HOLE CARDS ***
AndriuWasa: folds 
Lyskamm: folds 
TOLK78: raises $0.20 to $0.30
Pagetts: folds 
BetGuy69: folds 
Uncalled bet ($0.20) returned to TOLK78
Pagetts leaves the table
TOLK78 collected $0.25 from pot
*** SUMMARY ***
Total pot $0.25 | Rake $0 
Seat 1: Lyskamm folded before Flop (didn't bet)
Seat 3: TOLK78 (button) collected ($0.25)
Seat 4: Pagetts (small blind) folded before Flop
Seat 5: BetGuy69 (big blind) folded before Flop
Seat 6: AndriuWasa folded before Flop (didn't bet)



PokerStars Hand #222965001720:  Hold'em No Limit ($0.05/$0.10 USD) - 2021/01/23 13:57:10 ET
Table 'Grus IV' 6-max Seat #5 is the button
Seat 1: Lyskamm ($5.57 in chips) 
Seat 3: TOLK78 ($10.15 in chips) 
Seat 5: BetGuy69 ($10.16 in chips) 
Seat 6: AndriuWasa ($14.16 in chips) 
AndriuWasa: posts small blind $0.05
Lyskamm: posts big blind $0.10
*** HOLE CARDS ***
TOLK78: folds 
BetGuy69: raises $0.15 to $0.25
AndriuWasa: folds 
chris2766 joins the table at seat #4 
Lyskamm: folds 
Uncalled bet ($0.15) returned to BetGuy69
BetGuy69 collected $0.25 from pot
BetGuy69: doesn't show hand 
*** SUMMARY ***
Total pot $0.25 | Rake $0 
Seat 1: Lyskamm (big blind) folded before Flop
Seat 3: TOLK78 folded before Flop (didn't bet)
Seat 5: BetGuy69 (button) collected ($0.25)
Seat 6: AndriuWasa (small blind) folded before Flop



PokerStars Hand #222965006626:  Hold'em No Limit ($0.05/$0.10 USD) - 2021/01/23 13:57:20 ET
Table 'Grus IV' 6-max Seat #6 is the button
Seat 1: Lyskamm ($5.47 in chips) 
Seat 3: TOLK78 ($10.15 in chips) 
Seat 5: BetGuy69 ($10.31 in chips) 
Seat 6: AndriuWasa ($14.11 in chips) 
Lyskamm: posts small blind $0.05
TOLK78: posts big blind $0.10
chris2766: sits out 
*** HOLE CARDS ***
BetGuy69: folds 
AndriuWasa: folds 
Lyskamm: folds 
Uncalled bet ($0.05) returned to TOLK78
TOLK78 collected $0.10 from pot
*** SUMMARY ***
Total pot $0.10 | Rake $0 
Seat 1: Lyskamm (small blind) folded before Flop
Seat 3: TOLK78 (big blind) collected ($0.10)
Seat 5: BetGuy69 folded before Flop (didn't bet)
Seat 6: AndriuWasa (button) folded before Flop (didn't bet)



PokerStars Hand #222965008714:  Hold'em No Limit ($0.05/$0.10 USD) - 2021/01/23 13:57:25 ET
Table 'Grus IV' 6-max Seat #1 is the button
Seat 1: Lyskamm ($5.42 in chips) 
Seat 3: TOLK78 ($10.20 in chips) 
Seat 4: chris2766 ($10 in chips) 
Seat 5: BetGuy69 ($10.31 in chips) 
Seat 6: AndriuWasa ($14.11 in chips) 
TOLK78: posts small blind $0.05
chris2766: posts big blind $0.10
*** HOLE CARDS ***
BetGuy69: raises $0.20 to $0.30
AndriuWasa: folds 
Lyskamm: folds 
TOLK78: folds 
chris2766: folds 
Uncalled bet ($0.20) returned to BetGuy69
BetGuy69 collected $0.25 from pot
BetGuy69: doesn't show hand 
*** SUMMARY ***
Total pot $0.25 | Rake $0 
Seat 1: Lyskamm (button) folded before Flop (didn't bet)
Seat 3: TOLK78 (small blind) folded before Flop
Seat 4: chris2766 (big blind) folded before Flop
Seat 5: BetGuy69 collected ($0.25)
Seat 6: AndriuWasa folded before Flop (didn't bet)



PokerStars Hand #222965015180:  Hold'em No Limit ($0.05/$0.10 USD) - 2021/01/23 13:57:38 ET
Table 'Grus IV' 6-max Seat #3 is the button
Seat 1: Lyskamm ($5.42 in chips) 
Seat 3: TOLK78 ($10.15 in chips) 
Seat 4: chris2766 ($10 in chips) 
chris2766: posts small blind $0.05
BetGuy69: is sitting out 
AndriuWasa: is sitting out 
Lyskamm: posts big blind $0.10
*** HOLE CARDS ***
AndriuWasa leaves the table
TOLK78: raises $0.20 to $0.30
chris2766: folds 
Gopstephan joins the table at seat #6 
Lyskamm: folds 
Uncalled bet ($0.20) returned to TOLK78
TOLK78 collected $0.25 from pot
*** SUMMARY ***
Total pot $0.25 | Rake $0 
Seat 1: Lyskamm (big blind) folded before Flop
Seat 3: TOLK78 (button) collected ($0.25)
Seat 4: chris2766 (small blind) folded before Flop



PokerStars Hand #222965022892:  Hold'em No Limit ($0.05/$0.10 USD) - 2021/01/23 13:57:54 ET
Table 'Grus IV' 6-max Seat #1 is the button
Seat 1: Lyskamm ($5.32 in chips) 
Seat 4: chris2766 ($10 in chips) 
Lyskamm: posts small blind $0.05
TOLK78: is sitting out 
chris2766: posts big blind $0.10
*** HOLE CARDS ***
Lyskamm: folds 
Uncalled bet ($0.05) returned to chris2766
chris2766 collected $0.10 from pot
chris2766: doesn't show hand 
*** SUMMARY ***
Total pot $0.10 | Rake $0 
Seat 1: Lyskamm (button) (small blind) folded before Flop
Seat 4: chris2766 (big blind) collected ($0.10)



PokerStars Hand #222965025264:  Hold'em No Limit ($0.05/$0.10 USD) - 2021/01/23 13:57:58 ET
Table 'Grus IV' 6-max Seat #1 is the button
Seat 1: Lyskamm ($5.27 in chips) 
Seat 4: chris2766 ($10.05 in chips) 
Seat 5: BetGuy69 ($10.46 in chips) 
chris2766: posts small blind $0.05
BetGuy69: posts big blind $0.10
Gopstephan: sits out 
*** HOLE CARDS ***
Lyskamm: raises $0.20 to $0.30
TOLK78 leaves the table
chris2766: folds 
BetGuy69: folds 
Uncalled bet ($0.20) returned to Lyskamm
Lyskamm collected $0.25 from pot
Lyskamm: doesn't show hand 
*** SUMMARY ***
Total pot $0.25 | Rake $0 
Seat 1: Lyskamm (button) collected ($0.25)
Seat 4: chris2766 (small blind) folded before Flop
Seat 5: BetGuy69 (big blind) folded before Flop



PokerStars Hand #222965029211:  Hold'em No Limit ($0.05/$0.10 USD) - 2021/01/23 13:58:06 ET
Table 'Grus IV' 6-max Seat #4 is the button
Seat 1: Lyskamm ($5.42 in chips) 
Seat 4: chris2766 ($10 in chips) 
Seat 5: BetGuy69 ($10.36 in chips) 
Seat 6: Gopstephan ($10 in chips) 
BetGuy69: posts small blind $0.05
Gopstephan: posts big blind $0.10
*** HOLE CARDS ***
Lyskamm: folds 
chris2766: folds 
BetGuy69: folds 
Uncalled bet ($0.05) returned to Gopstephan
Gopstephan collected $0.10 from pot
Gopstephan: doesn't show hand 
*** SUMMARY ***
Total pot $0.10 | Rake $0 
Seat 1: Lyskamm folded before Flop (didn't bet)
Seat 4: chris2766 (button) folded before Flop (didn't bet)
Seat 5: BetGuy69 (small blind) folded before Flop
Seat 6: Gopstephan (big blind) collected ($0.10)



PokerStars Hand #222965032643:  Hold'em No Limit ($0.05/$0.10 USD) - 2021/01/23 13:58:13 ET
Table 'Grus IV' 6-max Seat #5 is the button
Seat 1: Lyskamm ($5.42 in chips) 
Seat 4: chris2766 ($10 in chips) 
Seat 5: BetGuy69 ($10.31 in chips) 
Seat 6: Gopstephan ($10.05 in chips) 
Gopstephan: posts small blind $0.05
Lyskamm: posts big blind $0.10
*** HOLE CARDS ***
chris2766: folds 
BetGuy69: folds 
Gopstephan: folds 
Uncalled bet ($0.05) returned to Lyskamm
Lyskamm collected $0.10 from pot
Lyskamm: doesn't show hand 
*** SUMMARY ***
Total pot $0.10 | Rake $0 
Seat 1: Lyskamm (big blind) collected ($0.10)
Seat 4: chris2766 folded before Flop (didn't bet)
Seat 5: BetGuy69 (button) folded before Flop (didn't bet)
Seat 6: Gopstephan (small blind) folded before Flop



PokerStars Hand #222965037989:  Hold'em No Limit ($0.05/$0.10 USD) - 2021/01/23 13:58:24 ET
Table 'Grus IV' 6-max Seat #6 is the button
Seat 1: Lyskamm ($5.47 in chips) 
Seat 4: chris2766 ($10 in chips) 
Seat 5: BetGuy69 ($10.31 in chips) 
Seat 6: Gopstephan ($10 in chips) 
Lyskamm: posts small blind $0.05
chris2766: posts big blind $0.10
*** HOLE CARDS ***
BetGuy69: folds 
rolzi73 joins the table at seat #3 
Gopstephan: folds 
Lyskamm: raises $0.20 to $0.30
chris2766: folds 
Uncalled bet ($0.20) returned to Lyskamm
Lyskamm collected $0.20 from pot
dancayamanda was removed from the table for failing to post
dancayamanda leaves the table
Lyskamm: doesn't show hand 
*** SUMMARY ***
Total pot $0.20 | Rake $0 
Seat 1: Lyskamm (small blind) collected ($0.20)
Seat 4: chris2766 (big blind) folded before Flop
Seat 5: BetGuy69 folded before Flop (didn't bet)
Seat 6: Gopstephan (button) folded before Flop (didn't bet)



PokerStars Hand #222965046340:  Hold'em No Limit ($0.05/$0.10 USD) - 2021/01/23 13:58:41 ET
Table 'Grus IV' 6-max Seat #1 is the button
Seat 1: Lyskamm ($5.57 in chips) 
Seat 4: chris2766 ($10 in chips) 
Seat 5: BetGuy69 ($10.31 in chips) 
Seat 6: Gopstephan ($10 in chips) 
chris2766: posts small blind $0.05
BetGuy69: posts big blind $0.10
*** HOLE CARDS ***
Gopstephan: folds 
Lyskamm: folds 
chris2766: calls $0.05
BetGuy69: checks 
*** FLOP *** [Ts 6c Js]
chris2766: checks 
BetGuy69: bets $0.30
chris2766: calls $0.30
*** TURN *** [Ts 6c Js] [Ad]
Vinogradov8d joins the table at seat #2 
chris2766: checks 
BetGuy69: bets $0.95
chris2766: folds 
Uncalled bet ($0.95) returned to BetGuy69
BetGuy69 collected $0.76 from pot
BetGuy69: doesn't show hand 
*** SUMMARY ***
Total pot $0.80 | Rake $0.04 
Board [Ts 6c Js Ad]
Seat 1: Lyskamm (button) folded before Flop (didn't bet)
Seat 4: chris2766 (small blind) folded on the Turn
Seat 5: BetGuy69 (big blind) collected ($0.76)
Seat 6: Gopstephan folded before Flop (didn't bet)



PokerStars Hand #222965059543:  Hold'em No Limit ($0.05/$0.10 USD) - 2021/01/23 13:59:08 ET
Table 'Grus IV' 6-max Seat #4 is the button
Seat 1: Lyskamm ($5.57 in chips) 
Seat 3: rolzi73 ($8 in chips) 
Seat 4: chris2766 ($10 in chips) 
Seat 5: BetGuy69 ($10.67 in chips) 
Seat 6: Gopstephan ($10 in chips) 
BetGuy69: posts small blind $0.05
Gopstephan: posts big blind $0.10
Vinogradov8d: sits out 
rolzi73: posts big blind $0.10
*** HOLE CARDS ***
Lyskamm: folds 
rolzi73: checks 
chris2766: calls $0.10
BetGuy69: folds 
Gopstephan: checks 
*** FLOP *** [2c Qd 3s]
Gopstephan: checks 
rolzi73: checks 
chris2766: checks 
*** TURN *** [2c Qd 3s] [Js]
Gopstephan: checks 
rolzi73: checks 
chris2766: checks 
*** RIVER *** [2c Qd 3s Js] [8h]
Gopstephan: checks 
rolzi73: checks 
chris2766: checks 
*** SHOW DOWN ***
Gopstephan: shows [7c 9c] (high card Queen)
rolzi73: shows [Ah 4d] (high card Ace)
chris2766: shows [8d Td] (a pair of Eights)
chris2766 collected $0.33 from pot
*** SUMMARY ***
Total pot $0.35 | Rake $0.02 
Board [2c Qd 3s Js 8h]
Seat 1: Lyskamm folded before Flop (didn't bet)
Seat 3: rolzi73 showed [Ah 4d] and lost with high card Ace
Seat 4: chris2766 (button) showed [8d Td] and won ($0.33) with a pair of Eights
Seat 5: BetGuy69 (small blind) folded before Flop
Seat 6: Gopstephan (big blind) showed [7c 9c] and lost with high card Queen



PokerStars Hand #222965082425:  Hold'em No Limit ($0.05/$0.10 USD) - 2021/01/23 13:59:55 ET
Table 'Grus IV' 6-max Seat #5 is the button
Seat 1: Lyskamm ($5.57 in chips) 
Seat 3: rolzi73 ($7.90 in chips) 
Seat 4: chris2766 ($10.23 in chips) 
Seat 5: BetGuy69 ($10.62 in chips) 
Seat 6: Gopstephan ($9.90 in chips) 
Gopstephan: posts small blind $0.05
Lyskamm: posts big blind $0.10
Vinogradov8d: sits out 
*** HOLE CARDS ***
rolzi73: folds 
chris2766: folds 
BetGuy69: folds 
Gopstephan: folds 
Uncalled bet ($0.05) returned to Lyskamm
Lyskamm collected $0.10 from pot
Lyskamm: doesn't show hand 
*** SUMMARY ***
Total pot $0.10 | Rake $0 
Seat 1: Lyskamm (big blind) collected ($0.10)
Seat 3: rolzi73 folded before Flop (didn't bet)
Seat 4: chris2766 folded before Flop (didn't bet)
Seat 5: BetGuy69 (button) folded before Flop (didn't bet)
Seat 6: Gopstephan (small blind) folded before Flop



PokerStars Hand #222965093745:  Hold'em No Limit ($0.05/$0.10 USD) - 2021/01/23 14:00:15 ET
Table 'Grus IV' 6-max Seat #6 is the button
Seat 1: Lyskamm ($5.62 in chips) 
Seat 2: Vinogradov8d ($5.07 in chips) 
Seat 3: rolzi73 ($7.90 in chips) 
Seat 4: chris2766 ($10.23 in chips) 
Seat 5: BetGuy69 ($10.62 in chips) 
Seat 6: Gopstephan ($9.85 in chips) 
Lyskamm: posts small blind $0.05
Vinogradov8d: posts big blind $0.10
*** HOLE CARDS ***
rolzi73: calls $0.10
chris2766: folds 
BetGuy69: folds 
Gopstephan: raises $0.20 to $0.30
Lyskamm: folds 
Vinogradov8d: calls $0.20
rolzi73: calls $0.20
*** FLOP *** [8d Kd 4h]
Vinogradov8d: checks 
rolzi73: bets $0.45
Gopstephan: calls $0.45
Vinogradov8d: folds 
*** TURN *** [8d Kd 4h] [7h]
rolzi73: bets $1.77
Gopstephan: folds 
Uncalled bet ($1.77) returned to rolzi73
rolzi73 collected $1.77 from pot
rolzi73: doesn't show hand 
*** SUMMARY ***
Total pot $1.85 | Rake $0.08 
Board [8d Kd 4h 7h]
Seat 1: Lyskamm (small blind) folded before Flop
Seat 2: Vinogradov8d (big blind) folded on the Flop
Seat 3: rolzi73 collected ($1.77)
Seat 4: chris2766 folded before Flop (didn't bet)
Seat 5: BetGuy69 folded before Flop (didn't bet)
Seat 6: Gopstephan (button) folded on the Turn



PokerStars Hand #222965122408:  Hold'em No Limit ($0.05/$0.10 USD) - 2021/01/23 14:01:07 ET
Table 'Grus IV' 6-max Seat #1 is the button
Seat 1: Lyskamm ($5.57 in chips) 
Seat 2: Vinogradov8d ($4.77 in chips) 
Seat 3: rolzi73 ($8.92 in chips) 
Seat 4: chris2766 ($10.23 in chips) 
Seat 5: BetGuy69 ($10.62 in chips) 
Seat 6: Gopstephan ($9.10 in chips) 
Vinogradov8d: posts small blind $0.05
rolzi73: posts big blind $0.10
*** HOLE CARDS ***
chris2766: folds 
BetGuy69: folds 
Gopstephan: folds 
Lyskamm: raises $0.20 to $0.30
Vinogradov8d: folds 
rolzi73: folds 
Uncalled bet ($0.20) returned to Lyskamm
Lyskamm collected $0.25 from pot
Lyskamm: doesn't show hand 
*** SUMMARY ***
Total pot $0.25 | Rake $0 
Seat 1: Lyskamm (button) collected ($0.25)
Seat 2: Vinogradov8d (small blind) folded before Flop
Seat 3: rolzi73 (big blind) folded before Flop
Seat 4: chris2766 folded before Flop (didn't bet)
Seat 5: BetGuy69 folded before Flop (didn't bet)
Seat 6: Gopstephan folded before Flop (didn't bet)



PokerStars Hand #222965134742:  Hold'em No Limit ($0.05/$0.10 USD) - 2021/01/23 14:01:25 ET
Table 'Grus IV' 6-max Seat #2 is the button
Seat 1: Lyskamm ($5.72 in chips) 
Seat 2: Vinogradov8d ($4.72 in chips) 
Seat 3: rolzi73 ($8.82 in chips) 
Seat 4: chris2766 ($10.23 in chips) 
Seat 5: BetGuy69 ($10.62 in chips) 
Seat 6: Gopstephan ($9.10 in chips) 
rolzi73: posts small blind $0.05
chris2766: posts big blind $0.10
*** HOLE CARDS ***
BetGuy69: folds 
Gopstephan: folds 
Lyskamm: folds 
Vinogradov8d: folds 
rolzi73: raises $0.10 to $0.20
chris2766: folds 
Uncalled bet ($0.10) returned to rolzi73
rolzi73 collected $0.20 from pot
rolzi73: doesn't show hand 
*** SUMMARY ***
Total pot $0.20 | Rake $0 
Seat 1: Lyskamm folded before Flop (didn't bet)
Seat 2: Vinogradov8d (button) folded before Flop (didn't bet)
Seat 3: rolzi73 (small blind) collected ($0.20)
Seat 4: chris2766 (big blind) folded before Flop
Seat 5: BetGuy69 folded before Flop (didn't bet)
Seat 6: Gopstephan folded before Flop (didn't bet)



PokerStars Hand #222965144916:  Hold'em No Limit ($0.05/$0.10 USD) - 2021/01/23 14:01:40 ET
Table 'Grus IV' 6-max Seat #3 is the button
Seat 1: Lyskamm ($5.72 in chips) 
Seat 2: Vinogradov8d ($4.72 in chips) 
Seat 3: rolzi73 ($8.92 in chips) 
Seat 4: chris2766 ($10.13 in chips) 
Seat 5: BetGuy69 ($10.62 in chips) 
Seat 6: Gopstephan ($9.10 in chips) 
chris2766: posts small blind $0.05
BetGuy69: posts big blind $0.10
*** HOLE CARDS ***
Gopstephan: folds 
Lyskamm: folds 
Vinogradov8d: folds 
rolzi73: raises $0.10 to $0.20
chris2766: calls $0.15
BetGuy69: folds 
*** FLOP *** [Qc 2d Jc]
chris2766: checks 
rolzi73: checks 
*** TURN *** [Qc 2d Jc] [Kc]
chris2766: checks 
rolzi73: checks 
*** RIVER *** [Qc 2d Jc Kc] [7s]
chris2766: checks 
rolzi73: bets $1.80
chris2766: folds 
Uncalled bet ($1.80) returned to rolzi73
rolzi73 collected $0.48 from pot
rolzi73: doesn't show hand 
*** SUMMARY ***
Total pot $0.50 | Rake $0.02 
Board [Qc 2d Jc Kc 7s]
Seat 1: Lyskamm folded before Flop (didn't bet)
Seat 2: Vinogradov8d folded before Flop (didn't bet)
Seat 3: rolzi73 (button) collected ($0.48)
Seat 4: chris2766 (small blind) folded on the River
Seat 5: BetGuy69 (big blind) folded before Flop
Seat 6: Gopstephan folded before Flop (didn't bet)



PokerStars Hand #222965171679:  Hold'em No Limit ($0.05/$0.10 USD) - 2021/01/23 14:02:16 ET
Table 'Grus IV' 6-max Seat #4 is the button
Seat 1: Lyskamm ($5.72 in chips) 
Seat 2: Vinogradov8d ($4.72 in chips) 
Seat 3: rolzi73 ($9.20 in chips) 
Seat 4: chris2766 ($10 in chips) 
Seat 5: BetGuy69 ($10.52 in chips) 
Seat 6: Gopstephan ($9.10 in chips) 
BetGuy69: posts small blind $0.05
Gopstephan: posts big blind $0.10
*** HOLE CARDS ***
Lyskamm: raises $0.20 to $0.30
Vinogradov8d: folds 
rolzi73: folds 
chris2766: folds 
BetGuy69: folds 
Gopstephan: folds 
Uncalled bet ($0.20) returned to Lyskamm
Lyskamm collected $0.25 from pot
Lyskamm: doesn't show hand 
*** SUMMARY ***
Total pot $0.25 | Rake $0 
Seat 1: Lyskamm collected ($0.25)
Seat 2: Vinogradov8d folded before Flop (didn't bet)
Seat 3: rolzi73 folded before Flop (didn't bet)
Seat 4: chris2766 (button) folded before Flop (didn't bet)
Seat 5: BetGuy69 (small blind) folded before Flop
Seat 6: Gopstephan (big blind) folded before Flop



PokerStars Hand #222965188987:  Hold'em No Limit ($0.05/$0.10 USD) - 2021/01/23 14:02:30 ET
Table 'Grus IV' 6-max Seat #5 is the button
Seat 1: Lyskamm ($5.87 in chips) 
Seat 2: Vinogradov8d ($4.72 in chips) 
Seat 3: rolzi73 ($9.20 in chips) 
Seat 4: chris2766 ($10 in chips) 
Seat 5: BetGuy69 ($10.47 in chips) 
Seat 6: Gopstephan ($9 in chips) 
Gopstephan: posts small blind $0.05
Lyskamm: posts big blind $0.10
*** HOLE CARDS ***
Vinogradov8d: folds 
rolzi73: calls $0.10
chris2766: folds 
BetGuy69: raises $0.30 to $0.40
Gopstephan: folds 
Lyskamm: folds 
rolzi73: raises $0.30 to $0.70
BetGuy69: calls $0.30
*** FLOP *** [3s 9d 4d]
rolzi73: checks 
BetGuy69: bets $0.49
rolzi73: calls $0.49
*** TURN *** [3s 9d 4d] [Ac]
rolzi73: checks 
BetGuy69: checks 
*** RIVER *** [3s 9d 4d Ac] [7d]
rolzi73: checks 
BetGuy69: checks 
*** SHOW DOWN ***
rolzi73: shows [Ah Qc] (a pair of Aces)
BetGuy69: mucks hand 
rolzi73 collected $2.42 from pot
*** SUMMARY ***
Total pot $2.53 | Rake $0.11 
Board [3s 9d 4d Ac 7d]
Seat 1: Lyskamm (big blind) folded before Flop
Seat 2: Vinogradov8d folded before Flop (didn't bet)
Seat 3: rolzi73 showed [Ah Qc] and won ($2.42) with a pair of Aces
Seat 4: chris2766 folded before Flop (didn't bet)
Seat 5: BetGuy69 (button) mucked
Seat 6: Gopstephan (small blind) folded before Flop



PokerStars Hand #222965223766:  Hold'em No Limit ($0.05/$0.10 USD) - 2021/01/23 14:03:15 ET
Table 'Grus IV' 6-max Seat #6 is the button
Seat 1: Lyskamm ($5.77 in chips) 
Seat 2: Vinogradov8d ($4.72 in chips) 
Seat 3: rolzi73 ($10.43 in chips) 
Seat 4: chris2766 ($10 in chips) 
Seat 5: BetGuy69 ($10 in chips) 
Seat 6: Gopstephan ($9.95 in chips) 
Lyskamm: posts small blind $0.05
Vinogradov8d: posts big blind $0.10
*** HOLE CARDS ***
rolzi73: raises $0.10 to $0.20
chris2766: folds 
BetGuy69: folds 
Gopstephan: folds 
Lyskamm: folds 
Vinogradov8d: folds 
Uncalled bet ($0.10) returned to rolzi73
rolzi73 collected $0.25 from pot
rolzi73: doesn't show hand 
*** SUMMARY ***
Total pot $0.25 | Rake $0 
Seat 1: Lyskamm (small blind) folded before Flop
Seat 2: Vinogradov8d (big blind) folded before Flop
Seat 3: rolzi73 collected ($0.25)
Seat 4: chris2766 folded before Flop (didn't bet)
Seat 5: BetGuy69 folded before Flop (didn't bet)
Seat 6: Gopstephan (button) folded before Flop (didn't bet)



PokerStars Hand #222965233414:  Hold'em No Limit ($0.05/$0.10 USD) - 2021/01/23 14:03:28 ET
Table 'Grus IV' 6-max Seat #1 is the button
Seat 1: Lyskamm ($5.72 in chips) 
Seat 2: Vinogradov8d ($4.62 in chips) 
Seat 3: rolzi73 ($10.58 in chips) 
Seat 4: chris2766 ($10 in chips) 
Seat 5: BetGuy69 ($10 in chips) 
Seat 6: Gopstephan ($9.95 in chips) 
Vinogradov8d: posts small blind $0.05
rolzi73: posts big blind $0.10
*** HOLE CARDS ***
chris2766 has timed out
chris2766: folds 
BetGuy69: folds 
Gopstephan: raises $0.20 to $0.30
Lyskamm: folds 
Vinogradov8d: calls $0.25
rolzi73: folds 
*** FLOP *** [Kc 9c 6c]
Vinogradov8d: bets $0.40
Gopstephan: calls $0.40
*** TURN *** [Kc 9c 6c] [3h]
rolzi73 leaves the table
Vinogradov8d: bets $0.80
papalo.gr joins the table at seat #3 
Gopstephan: calls $0.80
*** RIVER *** [Kc 9c 6c 3h] [2c]
Vinogradov8d: bets $3.12 and is all-in
Gopstephan: folds 
Uncalled bet ($3.12) returned to Vinogradov8d
Vinogradov8d collected $2.96 from pot
*** SUMMARY ***
Total pot $3.10 | Rake $0.14 
Board [Kc 9c 6c 3h 2c]
Seat 1: Lyskamm (button) folded before Flop (didn't bet)
Seat 2: Vinogradov8d (small blind) collected ($2.96)
Seat 3: rolzi73 (big blind) folded before Flop
Seat 4: chris2766 folded before Flop (didn't bet)
Seat 5: BetGuy69 folded before Flop (didn't bet)
Seat 6: Gopstephan folded on the River



PokerStars Hand #222965282711:  Hold'em No Limit ($0.05/$0.10 USD) - 2021/01/23 14:04:30 ET
Table 'Grus IV' 6-max Seat #2 is the button
Seat 1: Lyskamm ($5.72 in chips) 
Seat 2: Vinogradov8d ($6.08 in chips) 
Seat 4: chris2766 ($10 in chips) 
Seat 5: BetGuy69 ($10 in chips) 
Seat 6: Gopstephan ($8.45 in chips) 
chris2766: posts small blind $0.05
BetGuy69: posts big blind $0.10
*** HOLE CARDS ***
Gopstephan: folds 
Lyskamm: folds 
Vinogradov8d: calls $0.10
chris2766: calls $0.05
BetGuy69: checks 
*** FLOP *** [Td 6c 2c]
chris2766: checks 
BetGuy69: checks 
Vinogradov8d: checks 
*** TURN *** [Td 6c 2c] [Qc]
chris2766: checks 
BetGuy69: checks 
Vinogradov8d: checks 
*** RIVER *** [Td 6c 2c Qc] [Jd]
chris2766: checks 
BetGuy69: checks 
Vinogradov8d: checks 
*** SHOW DOWN ***
chris2766: shows [6h 4s] (a pair of Sixes)
BetGuy69: shows [5d Jh] (a pair of Jacks)
Vinogradov8d: mucks hand 
BetGuy69 collected $0.29 from pot
*** SUMMARY ***
Total pot $0.30 | Rake $0.01 
Board [Td 6c 2c Qc Jd]
Seat 1: Lyskamm folded before Flop (didn't bet)
Seat 2: Vinogradov8d (button) mucked
Seat 4: chris2766 (small blind) showed [6h 4s] and lost with a pair of Sixes
Seat 5: BetGuy69 (big blind) showed [5d Jh] and won ($0.29) with a pair of Jacks
Seat 6: Gopstephan folded before Flop (didn't bet)



PokerStars Hand #222965315685:  Hold'em No Limit ($0.05/$0.10 USD) - 2021/01/23 14:05:12 ET
Table 'Grus IV' 6-max Seat #4 is the button
Seat 1: Lyskamm ($5.72 in chips) 
Seat 2: Vinogradov8d ($5.98 in chips) 
Seat 3: papalo.gr ($10 in chips) 
Seat 4: chris2766 ($10 in chips) 
Seat 5: BetGuy69 ($10.19 in chips) 
Seat 6: Gopstephan ($8.45 in chips) 
BetGuy69: posts small blind $0.05
Gopstephan: posts big blind $0.10
papalo.gr: posts big blind $0.10
*** HOLE CARDS ***
Lyskamm: folds 
Vinogradov8d: folds 
papalo.gr: checks 
chris2766: folds 
BetGuy69: folds 
Gopstephan: checks 
*** FLOP *** [7d Jd 4h]
Gopstephan: checks 
papalo.gr: bets $0.10
Gopstephan: folds 
Uncalled bet ($0.10) returned to papalo.gr
papalo.gr collected $0.24 from pot
*** SUMMARY ***
Total pot $0.25 | Rake $0.01 
Board [7d Jd 4h]
Seat 1: Lyskamm folded before Flop (didn't bet)
Seat 2: Vinogradov8d folded before Flop (didn't bet)
Seat 3: papalo.gr collected ($0.24)
Seat 4: chris2766 (button) folded before Flop (didn't bet)
Seat 5: BetGuy69 (small blind) folded before Flop
Seat 6: Gopstephan (big blind) folded on the Flop



PokerStars Hand #222965340364:  Hold'em No Limit ($0.05/$0.10 USD) - 2021/01/23 14:05:43 ET
Table 'Grus IV' 6-max Seat #5 is the button
Seat 1: Lyskamm ($5.72 in chips) 
Seat 2: Vinogradov8d ($5.98 in chips) 
Seat 3: papalo.gr ($10.14 in chips) 
Seat 4: chris2766 ($10 in chips) 
Seat 5: BetGuy69 ($10.14 in chips) 
Seat 6: Gopstephan ($8.35 in chips) 
Gopstephan: posts small blind $0.05
Lyskamm: posts big blind $0.10
*** HOLE CARDS ***
Vinogradov8d: folds 
papalo.gr: raises $0.10 to $0.20
chris2766: folds 
BetGuy69: calls $0.20
Gopstephan: folds 
Lyskamm: folds 
*** FLOP *** [3h 8s Ts]
papalo.gr: checks 
BetGuy69: checks 
*** TURN *** [3h 8s Ts] [9s]
papalo.gr: checks 
BetGuy69: bets $0.45
papalo.gr: calls $0.45
*** RIVER *** [3h 8s Ts 9s] [Ad]
papalo.gr: checks 
BetGuy69: bets $1.25
papalo.gr: calls $1.25
*** SHOW DOWN ***
BetGuy69: shows [Js Qh] (a straight, Eight to Queen)
papalo.gr: mucks hand 
BetGuy69 collected $3.77 from pot
*** SUMMARY ***
Total pot $3.95 | Rake $0.18 
Board [3h 8s Ts 9s Ad]
Seat 1: Lyskamm (big blind) folded before Flop
Seat 2: Vinogradov8d folded before Flop (didn't bet)
Seat 3: papalo.gr mucked
Seat 4: chris2766 folded before Flop (didn't bet)
Seat 5: BetGuy69 (button) showed [Js Qh] and won ($3.77) with a straight, Eight to Queen
Seat 6: Gopstephan (small blind) folded before Flop



PokerStars Hand #222965373357:  Hold'em No Limit ($0.05/$0.10 USD) - 2021/01/23 14:06:25 ET
Table 'Grus IV' 6-max Seat #6 is the button
Seat 1: Lyskamm ($5.62 in chips) 
Seat 2: Vinogradov8d ($5.98 in chips) 
Seat 3: papalo.gr ($8.24 in chips) 
Seat 4: chris2766 ($10 in chips) 
Seat 5: BetGuy69 ($12.01 in chips) 
Seat 6: Gopstephan ($8.30 in chips) 
Lyskamm: posts small blind $0.05
Vinogradov8d: posts big blind $0.10
*** HOLE CARDS ***
papalo.gr: raises $0.10 to $0.20
chris2766: calls $0.20
BetGuy69: folds 
Gopstephan: folds 
Lyskamm: folds 
Vinogradov8d: folds 
*** FLOP *** [Qc 4s 2c]
papalo.gr: checks 
chris2766: bets $0.34
papalo.gr: folds 
Uncalled bet ($0.34) returned to chris2766
chris2766 collected $0.53 from pot
chris2766: doesn't show hand 
*** SUMMARY ***
Total pot $0.55 | Rake $0.02 
Board [Qc 4s 2c]
Seat 1: Lyskamm (small blind) folded before Flop
Seat 2: Vinogradov8d (big blind) folded before Flop
Seat 3: papalo.gr folded on the Flop
Seat 4: chris2766 collected ($0.53)
Seat 5: BetGuy69 folded before Flop (didn't bet)
Seat 6: Gopstephan (button) folded before Flop (didn't bet)



PokerStars Hand #222965406033:  Hold'em No Limit ($0.05/$0.10 USD) - 2021/01/23 14:07:06 ET
Table 'Grus IV' 6-max Seat #1 is the button
Seat 1: Lyskamm ($5.57 in chips) 
Seat 2: Vinogradov8d ($5.88 in chips) 
Seat 3: papalo.gr ($8.04 in chips) 
Seat 4: chris2766 ($10.33 in chips) 
Seat 5: BetGuy69 ($12.01 in chips) 
Seat 6: Gopstephan ($8.30 in chips) 
Vinogradov8d: posts small blind $0.05
papalo.gr: posts big blind $0.10
*** HOLE CARDS ***
chris2766: folds 
BetGuy69: folds 
Gopstephan: folds 
Lyskamm: raises $0.15 to $0.25
Vinogradov8d: folds 
papalo.gr: calls $0.15
*** FLOP *** [Ts Jc 4s]
papalo.gr: checks 
Lyskamm: checks 
*** TURN *** [Ts Jc 4s] [Ad]
papalo.gr: bets $0.20
Lyskamm: folds 
Uncalled bet ($0.20) returned to papalo.gr
papalo.gr collected $0.53 from pot
*** SUMMARY ***
Total pot $0.55 | Rake $0.02 
Board [Ts Jc 4s Ad]
Seat 1: Lyskamm (button) folded on the Turn
Seat 2: Vinogradov8d (small blind) folded before Flop
Seat 3: papalo.gr (big blind) collected ($0.53)
Seat 4: chris2766 folded before Flop (didn't bet)
Seat 5: BetGuy69 folded before Flop (didn't bet)
Seat 6: Gopstephan folded before Flop (didn't bet)



PokerStars Hand #222965430424:  Hold'em No Limit ($0.05/$0.10 USD) - 2021/01/23 14:07:37 ET
Table 'Grus IV' 6-max Seat #2 is the button
Seat 1: Lyskamm ($5.32 in chips) 
Seat 2: Vinogradov8d ($5.83 in chips) 
Seat 3: papalo.gr ($8.32 in chips) 
Seat 4: chris2766 ($10.33 in chips) 
Seat 5: BetGuy69 ($12.01 in chips) 
Seat 6: Gopstephan ($8.30 in chips) 
papalo.gr: posts small blind $0.05
chris2766: posts big blind $0.10
*** HOLE CARDS ***
BetGuy69: folds 
Gopstephan: folds 
Lyskamm: folds 
Vinogradov8d: folds 
papalo.gr: raises $0.10 to $0.20
chris2766: calls $0.10
*** FLOP *** [7c 4s Qh]
papalo.gr: checks 
chris2766: checks 
*** TURN *** [7c 4s Qh] [4d]
papalo.gr: checks 
chris2766: checks 
*** RIVER *** [7c 4s Qh 4d] [4h]
papalo.gr: checks 
chris2766: checks 
*** SHOW DOWN ***
papalo.gr: shows [As Kh] (three of a kind, Fours)
chris2766: mucks hand 
papalo.gr collected $0.38 from pot
*** SUMMARY ***
Total pot $0.40 | Rake $0.02 
Board [7c 4s Qh 4d 4h]
Seat 1: Lyskamm folded before Flop (didn't bet)
Seat 2: Vinogradov8d (button) folded before Flop (didn't bet)
Seat 3: papalo.gr (small blind) showed [As Kh] and won ($0.38) with three of a kind, Fours
Seat 4: chris2766 (big blind) mucked
Seat 5: BetGuy69 folded before Flop (didn't bet)
Seat 6: Gopstephan folded before Flop (didn't bet)



PokerStars Hand #222965453715:  Hold'em No Limit ($0.05/$0.10 USD) - 2021/01/23 14:08:06 ET
Table 'Grus IV' 6-max Seat #3 is the button
Seat 1: Lyskamm ($5.32 in chips) 
Seat 2: Vinogradov8d ($5.83 in chips) 
Seat 3: papalo.gr ($8.50 in chips) 
Seat 4: chris2766 ($10.13 in chips) 
Seat 5: BetGuy69 ($12.01 in chips) 
Seat 6: Gopstephan ($8.30 in chips) 
chris2766: posts small blind $0.05
BetGuy69: posts big blind $0.10
*** HOLE CARDS ***
Gopstephan: calls $0.10
Lyskamm: folds 
Vinogradov8d: folds 
papalo.gr: raises $0.10 to $0.20
chris2766: folds 
BetGuy69: folds 
Gopstephan: calls $0.10
*** FLOP *** [7s Qh 4d]
Gopstephan: checks 
papalo.gr: bets $0.30
Gopstephan: calls $0.30
*** TURN *** [7s Qh 4d] [Kh]
Gopstephan: checks 
papalo.gr: bets $0.50
Gopstephan: folds 
Uncalled bet ($0.50) returned to papalo.gr
papalo.gr collected $1.10 from pot
*** SUMMARY ***
Total pot $1.15 | Rake $0.05 
Board [7s Qh 4d Kh]
Seat 1: Lyskamm folded before Flop (didn't bet)
Seat 2: Vinogradov8d folded before Flop (didn't bet)
Seat 3: papalo.gr (button) collected ($1.10)
Seat 4: chris2766 (small blind) folded before Flop
Seat 5: BetGuy69 (big blind) folded before Flop
Seat 6: Gopstephan folded on the Turn



PokerStars Hand #222965507295:  Hold'em No Limit ($0.05/$0.10 USD) - 2021/01/23 14:09:13 ET
Table 'Grus IV' 6-max Seat #4 is the button
Seat 1: Lyskamm ($5.32 in chips) 
Seat 2: Vinogradov8d ($5.83 in chips) 
Seat 3: papalo.gr ($9.10 in chips) 
Seat 4: chris2766 ($10.08 in chips) 
Seat 5: BetGuy69 ($11.91 in chips) 
Seat 6: Gopstephan ($7.80 in chips) 
BetGuy69: posts small blind $0.05
Gopstephan: posts big blind $0.10
*** HOLE CARDS ***
Lyskamm: folds 
Vinogradov8d: folds 
papalo.gr: raises $0.50 to $0.60
chris2766: calls $0.60
BetGuy69: folds 
Gopstephan: folds 
*** FLOP *** [7s 3s 5c]
papalo.gr: checks 
chris2766: bets $0.84
papalo.gr: calls $0.84
*** TURN *** [7s 3s 5c] [3h]
papalo.gr: checks 
chris2766: bets $1.70
papalo.gr: calls $1.70
*** RIVER *** [7s 3s 5c 3h] [8h]
papalo.gr: checks 
chris2766: checks 
*** SHOW DOWN ***
papalo.gr: shows [Js Ad] (a pair of Threes)
chris2766: shows [9h 9s] (two pair, Nines and Threes)
chris2766 collected $6.14 from pot
*** SUMMARY ***
Total pot $6.43 | Rake $0.29 
Board [7s 3s 5c 3h 8h]
Seat 1: Lyskamm folded before Flop (didn't bet)
Seat 2: Vinogradov8d folded before Flop (didn't bet)
Seat 3: papalo.gr showed [Js Ad] and lost with a pair of Threes
Seat 4: chris2766 (button) showed [9h 9s] and won ($6.14) with two pair, Nines and Threes
Seat 5: BetGuy69 (small blind) folded before Flop
Seat 6: Gopstephan (big blind) folded before Flop



PokerStars Hand #222965540915:  Hold'em No Limit ($0.05/$0.10 USD) - 2021/01/23 14:09:56 ET
Table 'Grus IV' 6-max Seat #5 is the button
Seat 1: Lyskamm ($5.32 in chips) 
Seat 2: Vinogradov8d ($5.83 in chips) 
Seat 3: papalo.gr ($5.96 in chips) 
Seat 4: chris2766 ($13.08 in chips) 
Seat 5: BetGuy69 ($11.86 in chips) 
Seat 6: Gopstephan ($7.70 in chips) 
Gopstephan: posts small blind $0.05
Lyskamm: posts big blind $0.10
*** HOLE CARDS ***
Vinogradov8d: folds 
papalo.gr: calls $0.10
chris2766: folds 
BetGuy69: folds 
Gopstephan: folds 
Lyskamm: checks 
*** FLOP *** [2s 9h 8d]
Lyskamm: checks 
papalo.gr: checks 
*** TURN *** [2s 9h 8d] [Kd]
Lyskamm: bets $0.12
papalo.gr: folds 
Uncalled bet ($0.12) returned to Lyskamm
Lyskamm collected $0.24 from pot
Lyskamm: doesn't show hand 
*** SUMMARY ***
Total pot $0.25 | Rake $0.01 
Board [2s 9h 8d Kd]
Seat 1: Lyskamm (big blind) collected ($0.24)
Seat 2: Vinogradov8d folded before Flop (didn't bet)
Seat 3: papalo.gr folded on the Turn
Seat 4: chris2766 folded before Flop (didn't bet)
Seat 5: BetGuy69 (button) folded before Flop (didn't bet)
Seat 6: Gopstephan (small blind) folded before Flop



PokerStars Hand #222965566953:  Hold'em No Limit ($0.05/$0.10 USD) - 2021/01/23 14:10:29 ET
Table 'Grus IV' 6-max Seat #6 is the button
Seat 1: Lyskamm ($5.46 in chips) 
Seat 2: Vinogradov8d ($5.83 in chips) 
Seat 3: papalo.gr ($5.86 in chips) 
Seat 4: chris2766 ($13.08 in chips) 
Seat 5: BetGuy69 ($11.86 in chips) 
Seat 6: Gopstephan ($7.65 in chips) 
Lyskamm: posts small blind $0.05
Vinogradov8d: posts big blind $0.10
*** HOLE CARDS ***
papalo.gr: calls $0.10
chris2766: folds 
BetGuy69: folds 
Gopstephan: folds 
Lyskamm: raises $0.30 to $0.40
Vinogradov8d: folds 
papalo.gr: raises $0.80 to $1.20
Lyskamm: calls $0.80
*** FLOP *** [8d Ts 4c]
Lyskamm: checks 
papalo.gr: bets $4.66 and is all-in
Lyskamm: calls $4.26 and is all-in
Uncalled bet ($0.40) returned to papalo.gr
*** TURN *** [8d Ts 4c] [9d]
*** RIVER *** [8d Ts 4c 9d] [6s]
*** SHOW DOWN ***
Lyskamm: shows [Ah As] (a pair of Aces)
papalo.gr: shows [Ks Tc] (a pair of Tens)
Lyskamm collected $10.52 from pot
*** SUMMARY ***
Total pot $11.02 | Rake $0.50 
Board [8d Ts 4c 9d 6s]
Seat 1: Lyskamm (small blind) showed [Ah As] and won ($10.52) with a pair of Aces
Seat 2: Vinogradov8d (big blind) folded before Flop
Seat 3: papalo.gr showed [Ks Tc] and lost with a pair of Tens
Seat 4: chris2766 folded before Flop (didn't bet)
Seat 5: BetGuy69 folded before Flop (didn't bet)
Seat 6: Gopstephan (button) folded before Flop (didn't bet)



PokerStars Hand #222965596395:  Hold'em No Limit ($0.05/$0.10 USD) - 2021/01/23 14:11:07 ET
Table 'Grus IV' 6-max Seat #1 is the button
Seat 1: Lyskamm ($10.52 in chips) 
Seat 2: Vinogradov8d ($5.73 in chips) 
Seat 3: papalo.gr ($0.40 in chips) 
Seat 4: chris2766 ($13.08 in chips) 
Seat 5: BetGuy69 ($11.86 in chips) 
Seat 6: Gopstephan ($10 in chips) 
Vinogradov8d: posts small blind $0.05
papalo.gr: posts big blind $0.10
*** HOLE CARDS ***
chris2766: folds 
BetGuy69: folds 
Gopstephan: folds 
Lyskamm: raises $0.20 to $0.30
Vinogradov8d: folds 
papalo.gr: raises $0.10 to $0.40 and is all-in
Lyskamm: calls $0.10
*** FLOP *** [Th 8c 5c]
*** TURN *** [Th 8c 5c] [8h]
*** RIVER *** [Th 8c 5c 8h] [2d]
*** SHOW DOWN ***
papalo.gr: shows [6c Ts] (two pair, Tens and Eights)
Lyskamm: shows [Tc Qd] (two pair, Tens and Eights - Queen kicker)
Lyskamm collected $0.81 from pot
*** SUMMARY ***
Total pot $0.85 | Rake $0.04 
Board [Th 8c 5c 8h 2d]
Seat 1: Lyskamm (button) showed [Tc Qd] and won ($0.81) with two pair, Tens and Eights
Seat 2: Vinogradov8d (small blind) folded before Flop
Seat 3: papalo.gr (big blind) showed [6c Ts] and lost with two pair, Tens and Eights
Seat 4: chris2766 folded before Flop (didn't bet)
Seat 5: BetGuy69 folded before Flop (didn't bet)
Seat 6: Gopstephan folded before Flop (didn't bet)



PokerStars Hand #222965619678:  Hold'em No Limit ($0.05/$0.10 USD) - 2021/01/23 14:11:36 ET
Table 'Grus IV' 6-max Seat #2 is the button
Seat 1: Lyskamm ($10.93 in chips) 
Seat 2: Vinogradov8d ($5.68 in chips) 
Seat 4: chris2766 ($13.08 in chips) 
Seat 5: BetGuy69 ($11.86 in chips) 
Seat 6: Gopstephan ($10 in chips) 
chris2766: posts small blind $0.05
BetGuy69: posts big blind $0.10
*** HOLE CARDS ***
Gopstephan: folds 
Lyskamm: folds 
papalo.gr leaves the table
Vinogradov8d: folds 
jorgeebanks joins the table at seat #3 
chris2766: raises $0.10 to $0.20
BetGuy69: folds 
Uncalled bet ($0.10) returned to chris2766
chris2766 collected $0.20 from pot
chris2766: doesn't show hand 
*** SUMMARY ***
Total pot $0.20 | Rake $0 
Seat 1: Lyskamm folded before Flop (didn't bet)
Seat 2: Vinogradov8d (button) folded before Flop (didn't bet)
Seat 4: chris2766 (small blind) collected ($0.20)
Seat 5: BetGuy69 (big blind) folded before Flop
Seat 6: Gopstephan folded before Flop (didn't bet)



PokerStars Hand #222965628208:  Hold'em No Limit ($0.05/$0.10 USD) - 2021/01/23 14:11:47 ET
Table 'Grus IV' 6-max Seat #4 is the button
Seat 1: Lyskamm ($10.93 in chips) 
Seat 2: Vinogradov8d ($5.68 in chips) 
Seat 4: chris2766 ($13.18 in chips) 
Seat 5: BetGuy69 ($11.76 in chips) 
Seat 6: Gopstephan ($10 in chips) 
BetGuy69: posts small blind $0.05
Gopstephan: posts big blind $0.10
jorgeebanks: sits out 
*** HOLE CARDS ***
Lyskamm: folds 
Lyskamm leaves the table
Vinogradov8d: folds 
FF007L666 joins the table at seat #1 
chris2766: raises $0.10 to $0.20
BetGuy69: raises $0.50 to $0.70
Gopstephan: folds 
FF007L666 leaves the table
chris2766: folds 
Uncalled bet ($0.50) returned to BetGuy69
BetGuy69 collected $0.50 from pot
BetGuy69: doesn't show hand 
*** SUMMARY ***
Total pot $0.50 | Rake $0 
Seat 1: Lyskamm folded before Flop (didn't bet)
Seat 2: Vinogradov8d folded before Flop (didn't bet)
Seat 4: chris2766 (button) folded before Flop
Seat 5: BetGuy69 (small blind) collected ($0.50)
Seat 6: Gopstephan (big blind) folded before Flop



PokerStars Hand #222965652076:  Hold'em No Limit ($0.05/$0.10 USD) - 2021/01/23 14:12:17 ET
Table 'Grus IV' 6-max Seat #5 is the button
Seat 2: Vinogradov8d ($5.68 in chips) 
Seat 4: chris2766 ($12.98 in chips) 
Seat 5: BetGuy69 ($12.06 in chips) 
Seat 6: Gopstephan ($9.90 in chips) 
Gopstephan: posts small blind $0.05
Vinogradov8d: posts big blind $0.10
jorgeebanks: sits out 
*** HOLE CARDS ***
$iganov1 joins the table at seat #1 
chris2766: folds 
BetGuy69: raises $0.15 to $0.25
Gopstephan: calls $0.20
Vinogradov8d: calls $0.15
*** FLOP *** [6s 8d Td]
Gopstephan: checks 
Vinogradov8d: bets $0.50
BetGuy69: folds 
Gopstephan: calls $0.50
*** TURN *** [6s 8d Td] [Ah]
Gopstephan: bets $1.67
Vinogradov8d: raises $3.26 to $4.93 and is all-in
Gopstephan: folds 
Uncalled bet ($3.26) returned to Vinogradov8d
Vinogradov8d collected $4.86 from pot
*** SUMMARY ***
Total pot $5.09 | Rake $0.23 
Board [6s 8d Td Ah]
Seat 2: Vinogradov8d (big blind) collected ($4.86)
Seat 4: chris2766 folded before Flop (didn't bet)
Seat 5: BetGuy69 (button) folded on the Flop
Seat 6: Gopstephan (small blind) folded on the Turn



PokerStars Hand #222965692561:  Hold'em No Limit ($0.05/$0.10 USD) - 2021/01/23 14:13:08 ET
Table 'Grus IV' 6-max Seat #6 is the button
Seat 2: Vinogradov8d ($8.12 in chips) 
Seat 3: jorgeebanks ($10 in chips) 
Seat 4: chris2766 ($12.98 in chips) 
Seat 5: BetGuy69 ($11.81 in chips) 
Seat 6: Gopstephan ($7.48 in chips) 
Vinogradov8d: posts small blind $0.05
jorgeebanks: posts big blind $0.10
*** HOLE CARDS ***
chris2766: raises $0.10 to $0.20
BetGuy69: folds 
Gopstephan: folds 
Vinogradov8d: folds 
jorgeebanks: folds 
Uncalled bet ($0.10) returned to chris2766
chris2766 collected $0.25 from pot
chris2766: doesn't show hand 
*** SUMMARY ***
Total pot $0.25 | Rake $0 
Seat 2: Vinogradov8d (small blind) folded before Flop
Seat 3: jorgeebanks (big blind) folded before Flop
Seat 4: chris2766 collected ($0.25)
Seat 5: BetGuy69 folded before Flop (didn't bet)
Seat 6: Gopstephan (button) folded before Flop (didn't bet)



PokerStars Hand #222965710059:  Hold'em No Limit ($0.05/$0.10 USD) - 2021/01/23 14:13:30 ET
Table 'Grus IV' 6-max Seat #2 is the button
Seat 2: Vinogradov8d ($8.07 in chips) 
Seat 3: jorgeebanks ($9.90 in chips) 
Seat 4: chris2766 ($13.13 in chips) 
Seat 5: BetGuy69 ($11.81 in chips) 
Seat 6: Gopstephan ($7.48 in chips) 
jorgeebanks: posts small blind $0.05
chris2766: posts big blind $0.10
$iganov1: sits out 
*** HOLE CARDS ***
BetGuy69: folds 
Gopstephan: folds 
Vinogradov8d: folds 
jorgeebanks: folds 
Uncalled bet ($0.05) returned to chris2766
chris2766 collected $0.10 from pot
chris2766: doesn't show hand 
*** SUMMARY ***
Total pot $0.10 | Rake $0 
Seat 2: Vinogradov8d (button) folded before Flop (didn't bet)
Seat 3: jorgeebanks (small blind) folded before Flop
Seat 4: chris2766 (big blind) collected ($0.10)
Seat 5: BetGuy69 folded before Flop (didn't bet)
Seat 6: Gopstephan folded before Flop (didn't bet)



PokerStars Hand #222965718443:  Hold'em No Limit ($0.05/$0.10 USD) - 2021/01/23 14:13:41 ET
Table 'Grus IV' 6-max Seat #3 is the button
Seat 2: Vinogradov8d ($8.07 in chips) 
Seat 3: jorgeebanks ($9.85 in chips) 
Seat 4: chris2766 ($13.18 in chips) 
Seat 5: BetGuy69 ($11.81 in chips) 
Seat 6: Gopstephan ($7.48 in chips) 
chris2766: posts small blind $0.05
BetGuy69: posts big blind $0.10
$iganov1: sits out 
*** HOLE CARDS ***
Gopstephan: folds 
Vinogradov8d: folds 
jorgeebanks: raises $0.20 to $0.30
chris2766: folds 
BetGuy69: folds 
Uncalled bet ($0.20) returned to jorgeebanks
jorgeebanks collected $0.25 from pot
jorgeebanks: doesn't show hand 
*** SUMMARY ***
Total pot $0.25 | Rake $0 
Seat 2: Vinogradov8d folded before Flop (didn't bet)
Seat 3: jorgeebanks (button) collected ($0.25)
Seat 4: chris2766 (small blind) folded before Flop
Seat 5: BetGuy69 (big blind) folded before Flop
Seat 6: Gopstephan folded before Flop (didn't bet)



PokerStars Hand #222965732520:  Hold'em No Limit ($0.05/$0.10 USD) - 2021/01/23 14:13:58 ET
Table 'Grus IV' 6-max Seat #4 is the button
Seat 2: Vinogradov8d ($8.07 in chips) 
Seat 3: jorgeebanks ($10 in chips) 
Seat 4: chris2766 ($13.13 in chips) 
Seat 5: BetGuy69 ($11.71 in chips) 
Seat 6: Gopstephan ($7.48 in chips) 
BetGuy69: posts small blind $0.05
Gopstephan: posts big blind $0.10
$iganov1: sits out 
*** HOLE CARDS ***
Vinogradov8d: folds 
jorgeebanks: raises $0.20 to $0.30
chris2766: raises $0.90 to $1.20
BetGuy69: folds 
Gopstephan: folds 
jorgeebanks: calls $0.90
*** FLOP *** [7s 4d Qs]
jorgeebanks: checks 
chris2766: bets $1.70
jorgeebanks: folds 
Uncalled bet ($1.70) returned to chris2766
chris2766 collected $2.44 from pot
chris2766: doesn't show hand 
*** SUMMARY ***
Total pot $2.55 | Rake $0.11 
Board [7s 4d Qs]
Seat 2: Vinogradov8d folded before Flop (didn't bet)
Seat 3: jorgeebanks folded on the Flop
Seat 4: chris2766 (button) collected ($2.44)
Seat 5: BetGuy69 (small blind) folded before Flop
Seat 6: Gopstephan (big blind) folded before Flop



PokerStars Hand #222965754535:  Hold'em No Limit ($0.05/$0.10 USD) - 2021/01/23 14:14:26 ET
Table 'Grus IV' 6-max Seat #5 is the button
Seat 1: $iganov1 ($10 in chips) 
Seat 2: Vinogradov8d ($8.07 in chips) 
Seat 3: jorgeebanks ($10 in chips) 
Seat 4: chris2766 ($14.37 in chips) 
Seat 5: BetGuy69 ($11.66 in chips) 
Seat 6: Gopstephan ($7.38 in chips) 
Gopstephan: posts small blind $0.05
$iganov1: posts big blind $0.10
*** HOLE CARDS ***
Vinogradov8d: folds 
jorgeebanks: folds 
chris2766: folds 
BetGuy69: raises $0.15 to $0.25
Gopstephan: folds 
$iganov1: folds 
Uncalled bet ($0.15) returned to BetGuy69
BetGuy69 collected $0.25 from pot
BetGuy69: doesn't show hand 
*** SUMMARY ***
Total pot $0.25 | Rake $0 
Seat 1: $iganov1 (big blind) folded before Flop
Seat 2: Vinogradov8d folded before Flop (didn't bet)
Seat 3: jorgeebanks folded before Flop (didn't bet)
Seat 4: chris2766 folded before Flop (didn't bet)
Seat 5: BetGuy69 (button) collected ($0.25)
Seat 6: Gopstephan (small blind) folded before Flop



PokerStars Hand #222965765232:  Hold'em No Limit ($0.05/$0.10 USD) - 2021/01/23 14:14:40 ET
Table 'Grus IV' 6-max Seat #6 is the button
Seat 1: $iganov1 ($10 in chips) 
Seat 2: Vinogradov8d ($8.07 in chips) 
Seat 3: jorgeebanks ($10 in chips) 
Seat 4: chris2766 ($14.37 in chips) 
Seat 5: BetGuy69 ($11.81 in chips) 
Seat 6: Gopstephan ($7.33 in chips) 
$iganov1: posts small blind $0.05
Vinogradov8d: posts big blind $0.10
*** HOLE CARDS ***
jorgeebanks: folds 
chris2766: raises $0.12 to $0.22
BetGuy69: folds 
Gopstephan: calls $0.22
$iganov1: folds 
Vinogradov8d: calls $0.12
*** FLOP *** [6s 3s 8d]
Vinogradov8d: checks 
chris2766: checks 
Gopstephan: checks 
*** TURN *** [6s 3s 8d] [As]
Vinogradov8d: bets $0.40
chris2766: calls $0.40
Gopstephan: folds 
*** RIVER *** [6s 3s 8d As] [3d]
Vinogradov8d: checks 
chris2766: bets $0.60
Vinogradov8d: calls $0.60
*** SHOW DOWN ***
chris2766: shows [Jh Ah] (two pair, Aces and Threes)
Vinogradov8d: mucks hand 
chris2766 collected $2.59 from pot
*** SUMMARY ***
Total pot $2.71 | Rake $0.12 
Board [6s 3s 8d As 3d]
Seat 1: $iganov1 (small blind) folded before Flop
Seat 2: Vinogradov8d (big blind) mucked
Seat 3: jorgeebanks folded before Flop (didn't bet)
Seat 4: chris2766 showed [Jh Ah] and won ($2.59) with two pair, Aces and Threes
Seat 5: BetGuy69 folded before Flop (didn't bet)
Seat 6: Gopstephan (button) folded on the Turn



PokerStars Hand #222965809615:  Hold'em No Limit ($0.05/$0.10 USD) - 2021/01/23 14:15:36 ET
Table 'Grus IV' 6-max Seat #1 is the button
Seat 1: $iganov1 ($10 in chips) 
Seat 2: Vinogradov8d ($6.85 in chips) 
Seat 3: jorgeebanks ($10 in chips) 
Seat 4: chris2766 ($15.74 in chips) 
Seat 5: BetGuy69 ($11.81 in chips) 
Seat 6: Gopstephan ($7.11 in chips) 
Vinogradov8d: posts small blind $0.05
jorgeebanks: posts big blind $0.10
*** HOLE CARDS ***
chris2766: folds 
BetGuy69: folds 
Gopstephan: raises $0.20 to $0.30
$iganov1: folds 
Vinogradov8d: calls $0.25
jorgeebanks: folds 
*** FLOP *** [6s 8h 2h]
Vinogradov8d: bets $0.40
Gopstephan: calls $0.40
*** TURN *** [6s 8h 2h] [6c]
Vinogradov8d: bets $0.70
Gopstephan: calls $0.70
*** RIVER *** [6s 8h 2h 6c] [3c]
Vinogradov8d: bets $1
Gopstephan: folds 
Uncalled bet ($1) returned to Vinogradov8d
Vinogradov8d collected $2.77 from pot
*** SUMMARY ***
Total pot $2.90 | Rake $0.13 
Board [6s 8h 2h 6c 3c]
Seat 1: $iganov1 (button) folded before Flop (didn't bet)
Seat 2: Vinogradov8d (small blind) collected ($2.77)
Seat 3: jorgeebanks (big blind) folded before Flop
Seat 4: chris2766 folded before Flop (didn't bet)
Seat 5: BetGuy69 folded before Flop (didn't bet)
Seat 6: Gopstephan folded on the River



PokerStars Hand #222965853262:  Hold'em No Limit ($0.05/$0.10 USD) - 2021/01/23 14:16:28 ET
Table 'Grus IV' 6-max Seat #2 is the button
Seat 1: $iganov1 ($10 in chips) 
Seat 2: Vinogradov8d ($8.22 in chips) 
Seat 3: jorgeebanks ($9.90 in chips) 
Seat 4: chris2766 ($15.74 in chips) 
Seat 5: BetGuy69 ($11.81 in chips) 
Seat 6: Gopstephan ($8.60 in chips) 
jorgeebanks: posts small blind $0.05
chris2766: posts big blind $0.10
*** HOLE CARDS ***
BetGuy69: raises $0.20 to $0.30
Gopstephan: folds 
$iganov1: folds 
Vinogradov8d: folds 
jorgeebanks: calls $0.25
chris2766: calls $0.20
*** FLOP *** [3h 2d 8d]
jorgeebanks: checks 
chris2766: checks 
BetGuy69: checks 
*** TURN *** [3h 2d 8d] [2c]
jorgeebanks: bets $0.26
chris2766: calls $0.26
BetGuy69: folds 
*** RIVER *** [3h 2d 8d 2c] [Kc]
jorgeebanks: checks 
chris2766: checks 
*** SHOW DOWN ***
jorgeebanks: shows [Kd Td] (two pair, Kings and Deuces)
chris2766: mucks hand 
jorgeebanks collected $1.36 from pot
*** SUMMARY ***
Total pot $1.42 | Rake $0.06 
Board [3h 2d 8d 2c Kc]
Seat 1: $iganov1 folded before Flop (didn't bet)
Seat 2: Vinogradov8d (button) folded before Flop (didn't bet)
Seat 3: jorgeebanks (small blind) showed [Kd Td] and won ($1.36) with two pair, Kings and Deuces
Seat 4: chris2766 (big blind) mucked
Seat 5: BetGuy69 folded on the Turn
Seat 6: Gopstephan folded before Flop (didn't bet)



PokerStars Hand #222965880336:  Hold'em No Limit ($0.05/$0.10 USD) - 2021/01/23 14:17:02 ET
Table 'Grus IV' 6-max Seat #3 is the button
Seat 2: Vinogradov8d ($8.22 in chips) 
Seat 3: jorgeebanks ($10.70 in chips) 
Seat 4: chris2766 ($15.18 in chips) 
Seat 5: BetGuy69 ($11.51 in chips) 
Seat 6: Gopstephan ($8.60 in chips) 
chris2766: posts small blind $0.05
BetGuy69: posts big blind $0.10
*** HOLE CARDS ***
Gopstephan: folds 
Vinogradov8d: folds 
jorgeebanks: folds 
chris2766: raises $0.10 to $0.20
BetGuy69: calls $0.10
*** FLOP *** [8c Kh 5s]
chris2766: bets $0.20
BetGuy69: folds 
Uncalled bet ($0.20) returned to chris2766
chris2766 collected $0.38 from pot
chris2766: doesn't show hand 
*** SUMMARY ***
Total pot $0.40 | Rake $0.02 
Board [8c Kh 5s]
Seat 2: Vinogradov8d folded before Flop (didn't bet)
Seat 3: jorgeebanks (button) folded before Flop (didn't bet)
Seat 4: chris2766 (small blind) collected ($0.38)
Seat 5: BetGuy69 (big blind) folded on the Flop
Seat 6: Gopstephan folded before Flop (didn't bet)



PokerStars Hand #222965903720:  Hold'em No Limit ($0.05/$0.10 USD) - 2021/01/23 14:17:32 ET
Table 'Grus IV' 6-max Seat #4 is the button
Seat 2: Vinogradov8d ($8.22 in chips) 
Seat 3: jorgeebanks ($10.70 in chips) 
Seat 4: chris2766 ($15.36 in chips) 
Seat 5: BetGuy69 ($11.31 in chips) 
Seat 6: Gopstephan ($8.60 in chips) 
BetGuy69: posts small blind $0.05
Gopstephan: posts big blind $0.10
*** HOLE CARDS ***
Vinogradov8d: folds 
jorgeebanks: folds 
chris2766: folds 
BetGuy69: folds 
Uncalled bet ($0.05) returned to Gopstephan
Gopstephan collected $0.10 from pot
Gopstephan: doesn't show hand 
*** SUMMARY ***
Total pot $0.10 | Rake $0 
Seat 2: Vinogradov8d folded before Flop (didn't bet)
Seat 3: jorgeebanks folded before Flop (didn't bet)
Seat 4: chris2766 (button) folded before Flop (didn't bet)
Seat 5: BetGuy69 (small blind) folded before Flop
Seat 6: Gopstephan (big blind) collected ($0.10)



PokerStars Hand #222965914134:  Hold'em No Limit ($0.05/$0.10 USD) - 2021/01/23 14:17:45 ET
Table 'Grus IV' 6-max Seat #5 is the button
Seat 2: Vinogradov8d ($8.22 in chips) 
Seat 3: jorgeebanks ($10.70 in chips) 
Seat 4: chris2766 ($15.36 in chips) 
Seat 5: BetGuy69 ($11.26 in chips) 
Seat 6: Gopstephan ($8.65 in chips) 
Gopstephan: posts small blind $0.05
Vinogradov8d: posts big blind $0.10
*** HOLE CARDS ***
jorgeebanks: folds 
chris2766: folds 
BetGuy69: folds 
Gopstephan: raises $0.20 to $0.30
Vinogradov8d: calls $0.20
*** FLOP *** [Td 8c 5d]
Gopstephan: bets $0.28
Vinogradov8d: calls $0.28
*** TURN *** [Td 8c 5d] [Jh]
Gopstephan: bets $1.11
Vinogradov8d: calls $1.11
*** RIVER *** [Td 8c 5d Jh] [2s]
Gopstephan: checks 
Vinogradov8d: bets $3.23
Gopstephan: folds 
Uncalled bet ($3.23) returned to Vinogradov8d
Vinogradov8d collected $3.23 from pot
*** SUMMARY ***
Total pot $3.38 | Rake $0.15 
Board [Td 8c 5d Jh 2s]
Seat 2: Vinogradov8d (big blind) collected ($3.23)
Seat 3: jorgeebanks folded before Flop (didn't bet)
Seat 4: chris2766 folded before Flop (didn't bet)
Seat 5: BetGuy69 (button) folded before Flop (didn't bet)
Seat 6: Gopstephan (small blind) folded on the River



PokerStars Hand #222965965825:  Hold'em No Limit ($0.05/$0.10 USD) - 2021/01/23 14:18:50 ET
Table 'Grus IV' 6-max Seat #6 is the button
Seat 2: Vinogradov8d ($9.76 in chips) 
Seat 3: jorgeebanks ($10.70 in chips) 
Seat 4: chris2766 ($15.36 in chips) 
Seat 5: BetGuy69 ($11.26 in chips) 
Seat 6: Gopstephan ($6.96 in chips) 
Vinogradov8d: posts small blind $0.05
jorgeebanks: posts big blind $0.10
*** HOLE CARDS ***
chris2766: folds 
BetGuy69: folds 
Gopstephan: folds 
Vinogradov8d: folds 
Uncalled bet ($0.05) returned to jorgeebanks
jorgeebanks collected $0.10 from pot
jorgeebanks: doesn't show hand 
*** SUMMARY ***
Total pot $0.10 | Rake $0 
Seat 2: Vinogradov8d (small blind) folded before Flop
Seat 3: jorgeebanks (big blind) collected ($0.10)
Seat 4: chris2766 folded before Flop (didn't bet)
Seat 5: BetGuy69 folded before Flop (didn't bet)
Seat 6: Gopstephan (button) folded before Flop (didn't bet)



PokerStars Hand #222965979780:  Hold'em No Limit ($0.05/$0.10 USD) - 2021/01/23 14:19:08 ET
Table 'Grus IV' 6-max Seat #2 is the button
Seat 2: Vinogradov8d ($9.71 in chips) 
Seat 3: jorgeebanks ($10.75 in chips) 
Seat 4: chris2766 ($15.36 in chips) 
Seat 5: BetGuy69 ($11.26 in chips) 
Seat 6: Gopstephan ($6.96 in chips) 
jorgeebanks: posts small blind $0.05
chris2766: posts big blind $0.10
*** HOLE CARDS ***
BetGuy69: folds 
Gopstephan: folds 
Vinogradov8d: folds 
Vinogradov8d leaves the table
jorgeebanks: folds 
Uncalled bet ($0.05) returned to chris2766
chris2766 collected $0.10 from pot
chris2766: doesn't show hand 
*** SUMMARY ***
Total pot $0.10 | Rake $0 
Seat 2: Vinogradov8d (button) folded before Flop (didn't bet)
Seat 3: jorgeebanks (small blind) folded before Flop
Seat 4: chris2766 (big blind) collected ($0.10)
Seat 5: BetGuy69 folded before Flop (didn't bet)
Seat 6: Gopstephan folded before Flop (didn't bet)



PokerStars Hand #222965989508:  Hold'em No Limit ($0.05/$0.10 USD) - 2021/01/23 14:19:20 ET
Table 'Grus IV' 6-max Seat #3 is the button
Seat 3: jorgeebanks ($10.70 in chips) 
Seat 4: chris2766 ($15.41 in chips) 
Seat 5: BetGuy69 ($11.26 in chips) 
Seat 6: Gopstephan ($6.96 in chips) 
chris2766: posts small blind $0.05
BetGuy69: posts big blind $0.10
*** HOLE CARDS ***
Gopstephan: folds 
jorgeebanks: raises $0.25 to $0.35
Eduard Gl joins the table at seat #2 
chris2766: folds 
BetGuy69: folds 
Uncalled bet ($0.25) returned to jorgeebanks
jorgeebanks collected $0.25 from pot
jorgeebanks: doesn't show hand 
*** SUMMARY ***
Total pot $0.25 | Rake $0 
Seat 3: jorgeebanks (button) collected ($0.25)
Seat 4: chris2766 (small blind) folded before Flop
Seat 5: BetGuy69 (big blind) folded before Flop
Seat 6: Gopstephan folded before Flop (didn't bet)



PokerStars Hand #222966001322:  Hold'em No Limit ($0.05/$0.10 USD) - 2021/01/23 14:19:35 ET
Table 'Grus IV' 6-max Seat #4 is the button
Seat 3: jorgeebanks ($10.85 in chips) 
Seat 4: chris2766 ($15.36 in chips) 
Seat 5: BetGuy69 ($11.16 in chips) 
Seat 6: Gopstephan ($6.96 in chips) 
BetGuy69: posts small blind $0.05
Gopstephan: posts big blind $0.10
Eduard Gl: sits out 
*** HOLE CARDS ***
jorgeebanks: raises $0.20 to $0.30
chris2766: folds 
BetGuy69: folds 
Gopstephan: folds 
Uncalled bet ($0.20) returned to jorgeebanks
jorgeebanks collected $0.25 from pot
jorgeebanks: doesn't show hand 
*** SUMMARY ***
Total pot $0.25 | Rake $0 
Seat 3: jorgeebanks collected ($0.25)
Seat 4: chris2766 (button) folded before Flop (didn't bet)
Seat 5: BetGuy69 (small blind) folded before Flop
Seat 6: Gopstephan (big blind) folded before Flop



PokerStars Hand #222966016312:  Hold'em No Limit ($0.05/$0.10 USD) - 2021/01/23 14:19:54 ET
Table 'Grus IV' 6-max Seat #5 is the button
Seat 2: Eduard Gl ($10 in chips) 
Seat 3: jorgeebanks ($11 in chips) 
Seat 4: chris2766 ($15.36 in chips) 
Seat 5: BetGuy69 ($11.11 in chips) 
Seat 6: Gopstephan ($6.86 in chips) 
Gopstephan: posts small blind $0.05
Eduard Gl: posts big blind $0.10
*** HOLE CARDS ***
jorgeebanks: folds 
chris2766: folds 
BetGuy69: folds 
Gopstephan: folds 
Uncalled bet ($0.05) returned to Eduard Gl
Eduard Gl collected $0.10 from pot
Eduard Gl: doesn't show hand 
*** SUMMARY ***
Total pot $0.10 | Rake $0 
Seat 2: Eduard Gl (big blind) collected ($0.10)
Seat 3: jorgeebanks folded before Flop (didn't bet)
Seat 4: chris2766 folded before Flop (didn't bet)
Seat 5: BetGuy69 (button) folded before Flop (didn't bet)
Seat 6: Gopstephan (small blind) folded before Flop



PokerStars Hand #222966034611:  Hold'em No Limit ($0.05/$0.10 USD) - 2021/01/23 14:20:18 ET
Table 'Grus IV' 6-max Seat #6 is the button
Seat 2: Eduard Gl ($10.05 in chips) 
Seat 3: jorgeebanks ($11 in chips) 
Seat 4: chris2766 ($15.36 in chips) 
Seat 5: BetGuy69 ($11.11 in chips) 
Seat 6: Gopstephan ($6.81 in chips) 
Eduard Gl: posts small blind $0.05
jorgeebanks: posts big blind $0.10
*** HOLE CARDS ***
chris2766: raises $0.10 to $0.20
BetGuy69: folds 
Gopstephan: folds 
Eduard Gl: folds 
jorgeebanks: raises $0.45 to $0.65
chris2766: calls $0.45
*** FLOP *** [Kh 4h 9d]
jorgeebanks: bets $0.65
chris2766: folds 
Uncalled bet ($0.65) returned to jorgeebanks
jorgeebanks collected $1.29 from pot
jorgeebanks: doesn't show hand 
*** SUMMARY ***
Total pot $1.35 | Rake $0.06 
Board [Kh 4h 9d]
Seat 2: Eduard Gl (small blind) folded before Flop
Seat 3: jorgeebanks (big blind) collected ($1.29)
Seat 4: chris2766 folded on the Flop
Seat 5: BetGuy69 folded before Flop (didn't bet)
Seat 6: Gopstephan (button) folded before Flop (didn't bet)



PokerStars Hand #222966052116:  Hold'em No Limit ($0.05/$0.10 USD) - 2021/01/23 14:20:40 ET
Table 'Grus IV' 6-max Seat #2 is the button
Seat 2: Eduard Gl ($10 in chips) 
Seat 3: jorgeebanks ($11.64 in chips) 
Seat 4: chris2766 ($14.71 in chips) 
Seat 5: BetGuy69 ($11.11 in chips) 
Seat 6: Gopstephan ($6.81 in chips) 
jorgeebanks: posts small blind $0.05
chris2766: posts big blind $0.10
*** HOLE CARDS ***
BetGuy69: folds 
Gopstephan: folds 
Eduard Gl: raises $0.15 to $0.25
jorgeebanks: folds 
chris2766: calls $0.15
*** FLOP *** [Jd Qs Jc]
chris2766: checks 
Eduard Gl: bets $0.30
chris2766: folds 
Uncalled bet ($0.30) returned to Eduard Gl
Eduard Gl collected $0.53 from pot
Eduard Gl: doesn't show hand 
*** SUMMARY ***
Total pot $0.55 | Rake $0.02 
Board [Jd Qs Jc]
Seat 2: Eduard Gl (button) collected ($0.53)
Seat 3: jorgeebanks (small blind) folded before Flop
Seat 4: chris2766 (big blind) folded on the Flop
Seat 5: BetGuy69 folded before Flop (didn't bet)
Seat 6: Gopstephan folded before Flop (didn't bet)



PokerStars Hand #222966082556:  Hold'em No Limit ($0.05/$0.10 USD) - 2021/01/23 14:21:15 ET
Table 'Grus IV' 6-max Seat #3 is the button
Seat 2: Eduard Gl ($10.28 in chips) 
Seat 3: jorgeebanks ($11.59 in chips) 
Seat 4: chris2766 ($14.46 in chips) 
Seat 5: BetGuy69 ($11.11 in chips) 
Seat 6: Gopstephan ($6.81 in chips) 
chris2766: posts small blind $0.05
BetGuy69: posts big blind $0.10
*** HOLE CARDS ***
Gopstephan: folds 
Eduard Gl: folds 
jorgeebanks: folds 
chris2766: raises $0.10 to $0.20
BetGuy69: raises $0.40 to $0.60
Gopstephan leaves the table
chris2766: folds 
Uncalled bet ($0.40) returned to BetGuy69
BetGuy69 collected $0.40 from pot
BetGuy69: doesn't show hand 
*** SUMMARY ***
Total pot $0.40 | Rake $0 
Seat 2: Eduard Gl folded before Flop (didn't bet)
Seat 3: jorgeebanks (button) folded before Flop (didn't bet)
Seat 4: chris2766 (small blind) folded before Flop
Seat 5: BetGuy69 (big blind) collected ($0.40)
Seat 6: Gopstephan folded before Flop (didn't bet)



PokerStars Hand #222966097740:  Hold'em No Limit ($0.05/$0.10 USD) - 2021/01/23 14:21:35 ET
Table 'Grus IV' 6-max Seat #4 is the button
Seat 2: Eduard Gl ($10.28 in chips) 
Seat 3: jorgeebanks ($11.59 in chips) 
Seat 4: chris2766 ($14.26 in chips) 
Seat 5: BetGuy69 ($11.31 in chips) 
BetGuy69: posts small blind $0.05
Eduard Gl: posts big blind $0.10
*** HOLE CARDS ***
jorgeebanks: raises $0.20 to $0.30
chris2766: calls $0.30
BetGuy69: folds 
Eduard Gl: folds 
*** FLOP *** [9c Kh Qh]
jorgeebanks: checks 
yesss.28 joins the table at seat #6 
chris2766: checks 
*** TURN *** [9c Kh Qh] [6d]
jorgeebanks: checks 
chris2766: bets $0.47
jorgeebanks: folds 
Uncalled bet ($0.47) returned to chris2766
chris2766 collected $0.72 from pot
chris2766: doesn't show hand 
*** SUMMARY ***
Total pot $0.75 | Rake $0.03 
Board [9c Kh Qh 6d]
Seat 2: Eduard Gl (big blind) folded before Flop
Seat 3: jorgeebanks folded on the Turn
Seat 4: chris2766 (button) collected ($0.72)
Seat 5: BetGuy69 (small blind) folded before Flop



PokerStars Hand #222966116619:  Hold'em No Limit ($0.05/$0.10 USD) - 2021/01/23 14:21:59 ET
Table 'Grus IV' 6-max Seat #5 is the button
Seat 2: Eduard Gl ($10.18 in chips) 
Seat 3: jorgeebanks ($11.29 in chips) 
Seat 4: chris2766 ($14.68 in chips) 
Seat 5: BetGuy69 ($11.26 in chips) 
Eduard Gl: posts small blind $0.05
jorgeebanks: posts big blind $0.10
*** HOLE CARDS ***
chris2766: folds 
BetGuy69: raises $0.15 to $0.25
Eduard Gl: folds 
jorgeebanks: calls $0.15
*** FLOP *** [Qd 5c Ac]
jorgeebanks: checks 
BetGuy69: checks 
*** TURN *** [Qd 5c Ac] [4s]
jorgeebanks: checks 
BetGuy69: checks 
*** RIVER *** [Qd 5c Ac 4s] [Kh]
jorgeebanks: checks 
BetGuy69: checks 
*** SHOW DOWN ***
jorgeebanks: shows [Js 9s] (high card Ace)
BetGuy69: shows [Th Qh] (a pair of Queens)
BetGuy69 collected $0.53 from pot
*** SUMMARY ***
Total pot $0.55 | Rake $0.02 
Board [Qd 5c Ac 4s Kh]
Seat 2: Eduard Gl (small blind) folded before Flop
Seat 3: jorgeebanks (big blind) showed [Js 9s] and lost with high card Ace
Seat 4: chris2766 folded before Flop (didn't bet)
Seat 5: BetGuy69 (button) showed [Th Qh] and won ($0.53) with a pair of Queens



PokerStars Hand #222966139513:  Hold'em No Limit ($0.05/$0.10 USD) - 2021/01/23 14:22:28 ET
Table 'Grus IV' 6-max Seat #2 is the button
Seat 2: Eduard Gl ($10.13 in chips) 
Seat 3: jorgeebanks ($11.04 in chips) 
Seat 4: chris2766 ($14.68 in chips) 
Seat 5: BetGuy69 ($11.54 in chips) 
Seat 6: yesss.28 ($10 in chips) 
jorgeebanks: posts small blind $0.05
chris2766: posts big blind $0.10
yesss.28: posts big blind $0.10
*** HOLE CARDS ***
BetGuy69: folds 
yesss.28: checks 
Eduard Gl: raises $0.50 to $0.60
jorgeebanks: calls $0.55
chris2766: folds 
yesss.28: folds 
*** FLOP *** [5c 4h 3s]
jorgeebanks: bets $0.67
Eduard Gl: folds 
Uncalled bet ($0.67) returned to jorgeebanks
jorgeebanks collected $1.34 from pot
jorgeebanks: doesn't show hand 
*** SUMMARY ***
Total pot $1.40 | Rake $0.06 
Board [5c 4h 3s]
Seat 2: Eduard Gl (button) folded on the Flop
Seat 3: jorgeebanks (small blind) collected ($1.34)
Seat 4: chris2766 (big blind) folded before Flop
Seat 5: BetGuy69 folded before Flop (didn't bet)
Seat 6: yesss.28 folded before Flop (didn't bet)



PokerStars Hand #222966163049:  Hold'em No Limit ($0.05/$0.10 USD) - 2021/01/23 14:22:58 ET
Table 'Grus IV' 6-max Seat #3 is the button
Seat 2: Eduard Gl ($10 in chips) 
Seat 3: jorgeebanks ($11.78 in chips) 
Seat 4: chris2766 ($14.58 in chips) 
Seat 5: BetGuy69 ($11.54 in chips) 
Seat 6: yesss.28 ($9.90 in chips) 
chris2766: posts small blind $0.05
BetGuy69: posts big blind $0.10
*** HOLE CARDS ***
yesss.28: folds 
Eduard Gl: folds 
jorgeebanks: raises $0.25 to $0.35
chris2766: folds 
BetGuy69: calls $0.25
*** FLOP *** [Kh Tc 5d]
BetGuy69: checks 
jorgeebanks: bets $0.36
BetGuy69: folds 
Uncalled bet ($0.36) returned to jorgeebanks
jorgeebanks collected $0.72 from pot
jorgeebanks: doesn't show hand 
*** SUMMARY ***
Total pot $0.75 | Rake $0.03 
Board [Kh Tc 5d]
Seat 2: Eduard Gl folded before Flop (didn't bet)
Seat 3: jorgeebanks (button) collected ($0.72)
Seat 4: chris2766 (small blind) folded before Flop
Seat 5: BetGuy69 (big blind) folded on the Flop
Seat 6: yesss.28 folded before Flop (didn't bet)



PokerStars Hand #222966179385:  Hold'em No Limit ($0.05/$0.10 USD) - 2021/01/23 14:23:19 ET
Table 'Grus IV' 6-max Seat #4 is the button
Seat 2: Eduard Gl ($10 in chips) 
Seat 3: jorgeebanks ($12.15 in chips) 
Seat 4: chris2766 ($14.53 in chips) 
Seat 5: BetGuy69 ($11.19 in chips) 
Seat 6: yesss.28 ($9.90 in chips) 
BetGuy69: posts small blind $0.05
yesss.28: posts big blind $0.10
*** HOLE CARDS ***
Eduard Gl: folds 
jorgeebanks: folds 
chris2766: folds 
BetGuy69: folds 
Uncalled bet ($0.05) returned to yesss.28
yesss.28 collected $0.10 from pot
yesss.28: doesn't show hand 
*** SUMMARY ***
Total pot $0.10 | Rake $0 
Seat 2: Eduard Gl folded before Flop (didn't bet)
Seat 3: jorgeebanks folded before Flop (didn't bet)
Seat 4: chris2766 (button) folded before Flop (didn't bet)
Seat 5: BetGuy69 (small blind) folded before Flop
Seat 6: yesss.28 (big blind) collected ($0.10)



PokerStars Hand #222966187322:  Hold'em No Limit ($0.05/$0.10 USD) - 2021/01/23 14:23:29 ET
Table 'Grus IV' 6-max Seat #5 is the button
Seat 2: Eduard Gl ($10 in chips) 
Seat 3: jorgeebanks ($12.15 in chips) 
Seat 4: chris2766 ($14.53 in chips) 
Seat 5: BetGuy69 ($11.14 in chips) 
Seat 6: yesss.28 ($9.95 in chips) 
yesss.28: posts small blind $0.05
Eduard Gl: posts big blind $0.10
*** HOLE CARDS ***
jorgeebanks: folds 
chris2766: raises $0.25 to $0.35
BetGuy69: folds 
yesss.28: calls $0.30
Eduard Gl: folds 
*** FLOP *** [Jd 6h 4s]
yesss.28: bets $0.76
chris2766: folds 
Uncalled bet ($0.76) returned to yesss.28
yesss.28 collected $0.76 from pot
$iganov1 was removed from the table for failing to post
$iganov1 leaves the table
yesss.28: doesn't show hand 
*** SUMMARY ***
Total pot $0.80 | Rake $0.04 
Board [Jd 6h 4s]
Seat 2: Eduard Gl (big blind) folded before Flop
Seat 3: jorgeebanks folded before Flop (didn't bet)
Seat 4: chris2766 folded on the Flop
Seat 5: BetGuy69 (button) folded before Flop (didn't bet)
Seat 6: yesss.28 (small blind) collected ($0.76)



PokerStars Hand #222966211649:  Hold'em No Limit ($0.05/$0.10 USD) - 2021/01/23 14:24:00 ET
Table 'Grus IV' 6-max Seat #6 is the button
Seat 2: Eduard Gl ($10 in chips) 
Seat 3: jorgeebanks ($12.15 in chips) 
Seat 4: chris2766 ($14.18 in chips) 
Seat 5: BetGuy69 ($11.14 in chips) 
Seat 6: yesss.28 ($10.36 in chips) 
Eduard Gl: posts small blind $0.05
jorgeebanks: posts big blind $0.10
*** HOLE CARDS ***
chris2766: raises $0.10 to $0.20
BetGuy69: folds 
yesss.28: folds 
Slick1858 joins the table at seat #1 
Eduard Gl: folds 
jorgeebanks: raises $0.45 to $0.65
chris2766: calls $0.45
*** FLOP *** [8h 7c Js]
jorgeebanks: checks 
chris2766: checks 
*** TURN *** [8h 7c Js] [Ad]
jorgeebanks: bets $0.65
chris2766: calls $0.65
*** RIVER *** [8h 7c Js Ad] [7s]
jorgeebanks: bets $1.27
chris2766: calls $1.27
*** SHOW DOWN ***
jorgeebanks: shows [5s 5d] (two pair, Sevens and Fives)
chris2766: shows [Ts As] (two pair, Aces and Sevens)
chris2766 collected $4.96 from pot
*** SUMMARY ***
Total pot $5.19 | Rake $0.23 
Board [8h 7c Js Ad 7s]
Seat 2: Eduard Gl (small blind) folded before Flop
Seat 3: jorgeebanks (big blind) showed [5s 5d] and lost with two pair, Sevens and Fives
Seat 4: chris2766 showed [Ts As] and won ($4.96) with two pair, Aces and Sevens
Seat 5: BetGuy69 folded before Flop (didn't bet)
Seat 6: yesss.28 (button) folded before Flop (didn't bet)



PokerStars Hand #222966239632:  Hold'em No Limit ($0.05/$0.10 USD) - 2021/01/23 14:24:36 ET
Table 'Grus IV' 6-max Seat #2 is the button
Seat 1: Slick1858 ($4.50 in chips) 
Seat 2: Eduard Gl ($10 in chips) 
Seat 3: jorgeebanks ($9.58 in chips) 
Seat 4: chris2766 ($16.57 in chips) 
Seat 5: BetGuy69 ($11.14 in chips) 
Seat 6: yesss.28 ($10.36 in chips) 
jorgeebanks: posts small blind $0.05
chris2766: posts big blind $0.10
Slick1858: posts big blind $0.10
*** HOLE CARDS ***
BetGuy69: folds 
yesss.28: calls $0.10
Slick1858: checks 
Eduard Gl: raises $0.60 to $0.70
jorgeebanks: folds 
chris2766: folds 
yesss.28: calls $0.60
Slick1858: folds 
*** FLOP *** [Kd 3d Td]
yesss.28: bets $1.58
Eduard Gl: raises $7.72 to $9.30 and is all-in
yesss.28: calls $7.72
*** TURN *** [Kd 3d Td] [9c]
*** RIVER *** [Kd 3d Td 9c] [8s]
*** SHOW DOWN ***
yesss.28: shows [Kh 2s] (a pair of Kings)
Eduard Gl: shows [Ad Js] (high card Ace)
yesss.28 collected $19.34 from pot
*** SUMMARY ***
Total pot $20.25 | Rake $0.91 
Board [Kd 3d Td 9c 8s]
Seat 1: Slick1858 folded before Flop (didn't bet)
Seat 2: Eduard Gl (button) showed [Ad Js] and lost with high card Ace
Seat 3: jorgeebanks (small blind) folded before Flop
Seat 4: chris2766 (big blind) folded before Flop
Seat 5: BetGuy69 folded before Flop (didn't bet)
Seat 6: yesss.28 showed [Kh 2s] and won ($19.34) with a pair of Kings



PokerStars Hand #222966276995:  Hold'em No Limit ($0.05/$0.10 USD) - 2021/01/23 14:25:23 ET
Table 'Grus IV' 6-max Seat #3 is the button
Seat 1: Slick1858 ($4.40 in chips) 
Seat 2: Eduard Gl ($10 in chips) 
Seat 3: jorgeebanks ($10 in chips) 
Seat 4: chris2766 ($16.47 in chips) 
Seat 5: BetGuy69 ($11.14 in chips) 
Seat 6: yesss.28 ($19.70 in chips) 
chris2766: posts small blind $0.05
BetGuy69: posts big blind $0.10
*** HOLE CARDS ***
yesss.28: calls $0.10
Slick1858: folds 
Eduard Gl: raises $0.50 to $0.60
jorgeebanks: folds 
chris2766: folds 
BetGuy69: folds 
yesss.28: calls $0.50
*** FLOP *** [5c 5h 2h]
yesss.28: checks 
Eduard Gl: bets $0.90
yesss.28: folds 
Uncalled bet ($0.90) returned to Eduard Gl
Eduard Gl collected $1.29 from pot
Eduard Gl: doesn't show hand 
*** SUMMARY ***
Total pot $1.35 | Rake $0.06 
Board [5c 5h 2h]
Seat 1: Slick1858 folded before Flop (didn't bet)
Seat 2: Eduard Gl collected ($1.29)
Seat 3: jorgeebanks (button) folded before Flop (didn't bet)
Seat 4: chris2766 (small blind) folded before Flop
Seat 5: BetGuy69 (big blind) folded before Flop
Seat 6: yesss.28 folded on the Flop



PokerStars Hand #222966306874:  Hold'em No Limit ($0.05/$0.10 USD) - 2021/01/23 14:26:02 ET
Table 'Grus IV' 6-max Seat #4 is the button
Seat 1: Slick1858 ($4.40 in chips) 
Seat 2: Eduard Gl ($10.69 in chips) 
Seat 3: jorgeebanks ($10 in chips) 
Seat 4: chris2766 ($16.42 in chips) 
Seat 5: BetGuy69 ($11.04 in chips) 
Seat 6: yesss.28 ($19.10 in chips) 
BetGuy69: posts small blind $0.05
yesss.28: posts big blind $0.10
*** HOLE CARDS ***
Slick1858: calls $0.10
Eduard Gl: folds 
jorgeebanks: folds 
chris2766: folds 
BetGuy69: folds 
yesss.28: checks 
*** FLOP *** [Tc Qc Ad]
yesss.28: checks 
Slick1858: checks 
*** TURN *** [Tc Qc Ad] [2c]
yesss.28: checks 
Slick1858: checks 
*** RIVER *** [Tc Qc Ad 2c] [Ac]
yesss.28: bets $0.24
Slick1858: folds 
Uncalled bet ($0.24) returned to yesss.28
yesss.28 collected $0.24 from pot
yesss.28: doesn't show hand 
*** SUMMARY ***
Total pot $0.25 | Rake $0.01 
Board [Tc Qc Ad 2c Ac]
Seat 1: Slick1858 folded on the River
Seat 2: Eduard Gl folded before Flop (didn't bet)
Seat 3: jorgeebanks folded before Flop (didn't bet)
Seat 4: chris2766 (button) folded before Flop (didn't bet)
Seat 5: BetGuy69 (small blind) folded before Flop
Seat 6: yesss.28 (big blind) collected ($0.24)



PokerStars Hand #222966330830:  Hold'em No Limit ($0.05/$0.10 USD) - 2021/01/23 14:26:33 ET
Table 'Grus IV' 6-max Seat #5 is the button
Seat 1: Slick1858 ($4.30 in chips) 
Seat 2: Eduard Gl ($10.69 in chips) 
Seat 3: jorgeebanks ($10 in chips) 
Seat 4: chris2766 ($16.42 in chips) 
Seat 5: BetGuy69 ($10.99 in chips) 
Seat 6: yesss.28 ($19.24 in chips) 
yesss.28: posts small blind $0.05
Slick1858: posts big blind $0.10
*** HOLE CARDS ***
Eduard Gl: raises $0.20 to $0.30
jorgeebanks: folds 
chris2766: folds 
BetGuy69: calls $0.30
yesss.28: calls $0.25
Slick1858: calls $0.20
*** FLOP *** [Qd 4c 4h]
yesss.28: checks 
Slick1858: checks 
Eduard Gl: checks 
BetGuy69: checks 
*** TURN *** [Qd 4c 4h] [5s]
yesss.28: checks 
Slick1858: checks 
Eduard Gl: checks 
BetGuy69: checks 
*** RIVER *** [Qd 4c 4h 5s] [Tc]
yesss.28: bets $1.15
Slick1858: folds 
Eduard Gl: folds 
BetGuy69: folds 
Uncalled bet ($1.15) returned to yesss.28
yesss.28 collected $1.15 from pot
yesss.28: doesn't show hand 
*** SUMMARY ***
Total pot $1.20 | Rake $0.05 
Board [Qd 4c 4h 5s Tc]
Seat 1: Slick1858 (big blind) folded on the River
Seat 2: Eduard Gl folded on the River
Seat 3: jorgeebanks folded before Flop (didn't bet)
Seat 4: chris2766 folded before Flop (didn't bet)
Seat 5: BetGuy69 (button) folded on the River
Seat 6: yesss.28 (small blind) collected ($1.15)



PokerStars Hand #222966374202:  Hold'em No Limit ($0.05/$0.10 USD) - 2021/01/23 14:27:22 ET
Table 'Grus IV' 6-max Seat #6 is the button
Seat 1: Slick1858 ($4 in chips) 
Seat 2: Eduard Gl ($10.39 in chips) 
Seat 3: jorgeebanks ($10 in chips) 
Seat 4: chris2766 ($16.42 in chips) 
Seat 5: BetGuy69 ($10.69 in chips) 
Seat 6: yesss.28 ($20.09 in chips) 
Slick1858: posts small blind $0.05
Eduard Gl: posts big blind $0.10
*** HOLE CARDS ***
jorgeebanks: folds 
chris2766: folds 
BetGuy69: folds 
yesss.28: raises $0.25 to $0.35
Slick1858: folds 
Eduard Gl: folds 
Uncalled bet ($0.25) returned to yesss.28
yesss.28 collected $0.25 from pot
yesss.28: doesn't show hand 
*** SUMMARY ***
Total pot $0.25 | Rake $0 
Seat 1: Slick1858 (small blind) folded before Flop
Seat 2: Eduard Gl (big blind) folded before Flop
Seat 3: jorgeebanks folded before Flop (didn't bet)
Seat 4: chris2766 folded before Flop (didn't bet)
Seat 5: BetGuy69 folded before Flop (didn't bet)
Seat 6: yesss.28 (button) collected ($0.25)



PokerStars Hand #222966387200:  Hold'em No Limit ($0.05/$0.10 USD) - 2021/01/23 14:27:39 ET
Table 'Grus IV' 6-max Seat #1 is the button
Seat 1: Slick1858 ($3.95 in chips) 
Seat 2: Eduard Gl ($10.29 in chips) 
Seat 3: jorgeebanks ($10 in chips) 
Seat 4: chris2766 ($16.42 in chips) 
Seat 5: BetGuy69 ($10.69 in chips) 
Seat 6: yesss.28 ($20.24 in chips) 
Eduard Gl: posts small blind $0.05
jorgeebanks: posts big blind $0.10
*** HOLE CARDS ***
chris2766: folds 
BetGuy69: folds 
yesss.28: raises $0.10 to $0.20
Slick1858: calls $0.20
Eduard Gl: folds 
jorgeebanks: calls $0.10
*** FLOP *** [8s Qd 4s]
jorgeebanks: bets $0.10
yesss.28: calls $0.10
Slick1858: calls $0.10
*** TURN *** [8s Qd 4s] [Td]
jorgeebanks: bets $9.70 and is all-in
yesss.28: calls $9.70
Slick1858: calls $3.65 and is all-in
*** RIVER *** [8s Qd 4s Td] [As]
*** SHOW DOWN ***
jorgeebanks: shows [4h Th] (two pair, Tens and Fours)
yesss.28: shows [Jc 9d] (a straight, Eight to Queen)
yesss.28 collected $11.56 from side pot
Slick1858: shows [Qs Ts] (a flush, Ace high)
Slick1858 collected $11.36 from main pot
*** SUMMARY ***
Total pot $24 Main pot $11.36. Side pot $11.56. | Rake $1.08 
Board [8s Qd 4s Td As]
Seat 1: Slick1858 (button) showed [Qs Ts] and won ($11.36) with a flush, Ace high
Seat 2: Eduard Gl (small blind) folded before Flop
Seat 3: jorgeebanks (big blind) showed [4h Th] and lost with two pair, Tens and Fours
Seat 4: chris2766 folded before Flop (didn't bet)
Seat 5: BetGuy69 folded before Flop (didn't bet)
Seat 6: yesss.28 showed [Jc 9d] and won ($11.56) with a straight, Eight to Queen



PokerStars Hand #222966428678:  Hold'em No Limit ($0.05/$0.10 USD) - 2021/01/23 14:28:32 ET
Table 'Grus IV' 6-max Seat #2 is the button
Seat 1: Slick1858 ($11.36 in chips) 
Seat 2: Eduard Gl ($10.24 in chips) 
Seat 4: chris2766 ($16.42 in chips) 
Seat 5: BetGuy69 ($10.69 in chips) 
Seat 6: yesss.28 ($21.80 in chips) 
chris2766: posts small blind $0.05
BetGuy69: posts big blind $0.10
*** HOLE CARDS ***
jorgeebanks leaves the table
yesss.28: calls $0.10
Slick1858: folds 
Eduard Gl: raises $0.50 to $0.60
chris2766: folds 
vodka4fun joins the table at seat #3 
BetGuy69: folds 
yesss.28: calls $0.50
*** FLOP *** [Ts 8d 4d]
yesss.28: bets $1.29
Eduard Gl: folds 
Uncalled bet ($1.29) returned to yesss.28
yesss.28 collected $1.29 from pot
yesss.28: doesn't show hand 
*** SUMMARY ***
Total pot $1.35 | Rake $0.06 
Board [Ts 8d 4d]
Seat 1: Slick1858 folded before Flop (didn't bet)
Seat 2: Eduard Gl (button) folded on the Flop
Seat 4: chris2766 (small blind) folded before Flop
Seat 5: BetGuy69 (big blind) folded before Flop
Seat 6: yesss.28 collected ($1.29)



PokerStars Hand #222966455636:  Hold'em No Limit ($0.05/$0.10 USD) - 2021/01/23 14:29:07 ET
Table 'Grus IV' 6-max Seat #4 is the button
Seat 1: Slick1858 ($11.36 in chips) 
Seat 2: Eduard Gl ($10 in chips) 
Seat 4: chris2766 ($16.37 in chips) 
Seat 5: BetGuy69 ($10.59 in chips) 
Seat 6: yesss.28 ($22.49 in chips) 
BetGuy69: posts small blind $0.05
yesss.28: posts big blind $0.10
vodka4fun: sits out 
*** HOLE CARDS ***
Slick1858: calls $0.10
Eduard Gl: raises $0.20 to $0.30
chris2766: folds 
BetGuy69: folds 
yesss.28: raises $0.75 to $1.05
Slick1858: calls $0.95
Eduard Gl: calls $0.75
*** FLOP *** [2s 3d 8s]
yesss.28: bets $3.06
Slick1858: folds 
Eduard Gl: raises $5.89 to $8.95 and is all-in
yesss.28: calls $5.89
*** TURN *** [2s 3d 8s] [5c]
*** RIVER *** [2s 3d 8s 5c] [7h]
*** SHOW DOWN ***
yesss.28: shows [As Ac] (a pair of Aces)
Eduard Gl: shows [2c 2h] (three of a kind, Deuces)
Eduard Gl collected $20.15 from pot
*** SUMMARY ***
Total pot $21.10 | Rake $0.95 
Board [2s 3d 8s 5c 7h]
Seat 1: Slick1858 folded on the Flop
Seat 2: Eduard Gl showed [2c 2h] and won ($20.15) with three of a kind, Deuces
Seat 4: chris2766 (button) folded before Flop (didn't bet)
Seat 5: BetGuy69 (small blind) folded before Flop
Seat 6: yesss.28 (big blind) showed [As Ac] and lost with a pair of Aces



PokerStars Hand #222966507633:  Hold'em No Limit ($0.05/$0.10 USD) - 2021/01/23 14:30:03 ET
Table 'Grus IV' 6-max Seat #5 is the button
Seat 2: Eduard Gl ($20.15 in chips) 
Seat 4: chris2766 ($16.37 in chips) 
Seat 5: BetGuy69 ($10.54 in chips) 
Seat 6: yesss.28 ($12.49 in chips) 
yesss.28: posts small blind $0.05
Eduard Gl: posts big blind $0.10
vodka4fun: sits out 
*** HOLE CARDS ***
chris2766: folds 
BetGuy69: raises $0.15 to $0.25
yesss.28: calls $0.20
Eduard Gl: folds 
*** FLOP *** [2h Tc Qd]
yesss.28: checks 
BetGuy69: checks 
*** TURN *** [2h Tc Qd] [8h]
Slick1858 leaves the table
yesss.28: checks 
BetGuy69: checks 
*** RIVER *** [2h Tc Qd 8h] [2d]
yesss.28: bets $0.57
BetGuy69: folds 
Uncalled bet ($0.57) returned to yesss.28
yesss.28 collected $0.57 from pot
yesss.28: doesn't show hand 
*** SUMMARY ***
Total pot $0.60 | Rake $0.03 
Board [2h Tc Qd 8h 2d]
Seat 2: Eduard Gl (big blind) folded before Flop
Seat 4: chris2766 folded before Flop (didn't bet)
Seat 5: BetGuy69 (button) folded on the River
Seat 6: yesss.28 (small blind) collected ($0.57)



PokerStars Hand #222966536952:  Hold'em No Limit ($0.05/$0.10 USD) - 2021/01/23 14:30:40 ET
Table 'Grus IV' 6-max Seat #6 is the button
Seat 2: Eduard Gl ($20.05 in chips) 
Seat 3: vodka4fun ($10 in chips) 
Seat 4: chris2766 ($16.37 in chips) 
Seat 5: BetGuy69 ($10.29 in chips) 
Seat 6: yesss.28 ($12.81 in chips) 
Eduard Gl: posts small blind $0.05
vodka4fun: posts big blind $0.10
*** HOLE CARDS ***
chris2766: folds 
BetGuy69: raises $0.20 to $0.30
alfredovga joins the table at seat #1 
yesss.28: calls $0.30
Eduard Gl: folds 
vodka4fun: raises $1.20 to $1.50
BetGuy69: folds 
yesss.28: calls $1.20
*** FLOP *** [9d 4d Td]
BetGuy69 leaves the table
vodka4fun: checks 
Ctac A. joins the table at seat #5 
yesss.28: bets $1.60
vodka4fun: folds 
Uncalled bet ($1.60) returned to yesss.28
yesss.28 collected $3.20 from pot
yesss.28: doesn't show hand 
*** SUMMARY ***
Total pot $3.35 | Rake $0.15 
Board [9d 4d Td]
Seat 2: Eduard Gl (small blind) folded before Flop
Seat 3: vodka4fun (big blind) folded on the Flop
Seat 4: chris2766 folded before Flop (didn't bet)
Seat 5: BetGuy69 folded before Flop
Seat 6: yesss.28 (button) collected ($3.20)



PokerStars Hand #222966571453:  Hold'em No Limit ($0.05/$0.10 USD) - 2021/01/23 14:31:24 ET
Table 'Grus IV' 6-max Seat #2 is the button
Seat 1: alfredovga ($10 in chips) 
Seat 2: Eduard Gl ($20 in chips) 
Seat 3: vodka4fun ($10 in chips) 
Seat 4: chris2766 ($16.37 in chips) 
Seat 6: yesss.28 ($14.51 in chips) 
vodka4fun: posts small blind $0.05
chris2766: posts big blind $0.10
Ctac A.: sits out 
alfredovga: posts big blind $0.10
*** HOLE CARDS ***
yesss.28: calls $0.10
alfredovga: checks 
Eduard Gl: folds 
vodka4fun: folds 
chris2766: checks 
*** FLOP *** [Qh Jd Qc]
chris2766: checks 
yesss.28: bets $0.33
alfredovga: folds 
chris2766: calls $0.33
*** TURN *** [Qh Jd Qc] [4s]
chris2766: checks 
yesss.28: bets $0.96
chris2766: folds 
Uncalled bet ($0.96) returned to yesss.28
yesss.28 collected $0.96 from pot
yesss.28: doesn't show hand 
*** SUMMARY ***
Total pot $1.01 | Rake $0.05 
Board [Qh Jd Qc 4s]
Seat 1: alfredovga folded on the Flop (didn't bet)
Seat 2: Eduard Gl (button) folded before Flop (didn't bet)
Seat 3: vodka4fun (small blind) folded before Flop
Seat 4: chris2766 (big blind) folded on the Turn
Seat 6: yesss.28 collected ($0.96)



PokerStars Hand #222966599765:  Hold'em No Limit ($0.05/$0.10 USD) - 2021/01/23 14:32:00 ET
Table 'Grus IV' 6-max Seat #3 is the button
Seat 1: alfredovga ($9.90 in chips) 
Seat 2: Eduard Gl ($20 in chips) 
Seat 3: vodka4fun ($10 in chips) 
Seat 4: chris2766 ($15.94 in chips) 
Seat 5: Ctac A. ($10 in chips) 
Seat 6: yesss.28 ($15.04 in chips) 
chris2766: posts small blind $0.05
Ctac A.: posts big blind $0.10
*** HOLE CARDS ***
yesss.28: raises $0.25 to $0.35
alfredovga: calls $0.35
Eduard Gl: folds 
vodka4fun: folds 
chris2766: folds 
Ctac A.: folds 
*** FLOP *** [Ah Ks Td]
yesss.28: bets $0.81
alfredovga: folds 
Uncalled bet ($0.81) returned to yesss.28
yesss.28 collected $0.81 from pot
yesss.28: doesn't show hand 
*** SUMMARY ***
Total pot $0.85 | Rake $0.04 
Board [Ah Ks Td]
Seat 1: alfredovga folded on the Flop
Seat 2: Eduard Gl folded before Flop (didn't bet)
Seat 3: vodka4fun (button) folded before Flop (didn't bet)
Seat 4: chris2766 (small blind) folded before Flop
Seat 5: Ctac A. (big blind) folded before Flop
Seat 6: yesss.28 collected ($0.81)



PokerStars Hand #222966615036:  Hold'em No Limit ($0.05/$0.10 USD) - 2021/01/23 14:32:20 ET
Table 'Grus IV' 6-max Seat #4 is the button
Seat 1: alfredovga ($9.55 in chips) 
Seat 2: Eduard Gl ($20 in chips) 
Seat 3: vodka4fun ($10 in chips) 
Seat 4: chris2766 ($15.89 in chips) 
Seat 5: Ctac A. ($10 in chips) 
Seat 6: yesss.28 ($15.50 in chips) 
Ctac A.: posts small blind $0.05
yesss.28: posts big blind $0.10
*** HOLE CARDS ***
alfredovga: calls $0.10
Eduard Gl: folds 
vodka4fun: folds 
chris2766: folds 
Ctac A.: calls $0.05
yesss.28: raises $0.30 to $0.40
alfredovga: calls $0.30
Ctac A.: calls $0.30
*** FLOP *** [9h Qc 8s]
Ctac A.: checks 
yesss.28: bets $1.15
alfredovga: folds 
Ctac A.: folds 
Uncalled bet ($1.15) returned to yesss.28
yesss.28 collected $1.15 from pot
yesss.28: doesn't show hand 
*** SUMMARY ***
Total pot $1.20 | Rake $0.05 
Board [9h Qc 8s]
Seat 1: alfredovga folded on the Flop
Seat 2: Eduard Gl folded before Flop (didn't bet)
Seat 3: vodka4fun folded before Flop (didn't bet)
Seat 4: chris2766 (button) folded before Flop (didn't bet)
Seat 5: Ctac A. (small blind) folded on the Flop
Seat 6: yesss.28 (big blind) collected ($1.15)



PokerStars Hand #222966903986:  Hold'em No Limit ($0.05/$0.10 USD) - 2021/01/23 14:38:28 ET
Table 'Grus IV' 6-max Seat #3 is the button
Seat 1: alfredovga ($10.79 in chips) 
Seat 2: Eduard Gl ($32.49 in chips) 
Seat 3: vodka4fun ($14.28 in chips) 
Seat 4: chris2766 ($15.24 in chips) 
Seat 5: sAnt1n135 ($10 in chips) 
chris2766: posts small blind $0.05
sAnt1n135: posts big blind $0.10
*** HOLE CARDS ***
alfredovga: folds 
Eduard Gl: folds 
vodka4fun: folds 
chris2766: raises $0.10 to $0.20
sAnt1n135: calls $0.10
*** FLOP *** [2c Ah Qs]
chris2766: checks 
sAnt1n135: bets $0.20
chris2766: calls $0.20
*** TURN *** [2c Ah Qs] [Qc]
chris2766: checks 
sAnt1n135: bets $0.30
chris2766: raises $0.88 to $1.18
sAnt1n135: folds 
Uncalled bet ($0.88) returned to chris2766
chris2766 collected $1.34 from pot
chris2766: doesn't show hand 
*** SUMMARY ***
Total pot $1.40 | Rake $0.06 
Board [2c Ah Qs Qc]
Seat 1: alfredovga folded before Flop (didn't bet)
Seat 2: Eduard Gl folded before Flop (didn't bet)
Seat 3: vodka4fun (button) folded before Flop (didn't bet)
Seat 4: chris2766 (small blind) collected ($1.34)
Seat 5: sAnt1n135 (big blind) folded on the Turn



PokerStars Hand #222966951680:  Hold'em No Limit ($0.05/$0.10 USD) - 2021/01/23 14:39:29 ET
Table 'Grus IV' 6-max Seat #4 is the button
Seat 1: alfredovga ($10.79 in chips) 
Seat 2: Eduard Gl ($32.49 in chips) 
Seat 3: vodka4fun ($14.28 in chips) 
Seat 4: chris2766 ($15.88 in chips) 
Seat 5: sAnt1n135 ($9.30 in chips) 
Seat 6: yesss.28 ($10 in chips) 
sAnt1n135: posts small blind $0.05
yesss.28: posts big blind $0.10
*** HOLE CARDS ***
alfredovga: folds 
Eduard Gl: folds 
vodka4fun: folds 
chris2766: raises $0.10 to $0.20
sAnt1n135: folds 
yesss.28: calls $0.10
*** FLOP *** [9h Kd Tc]
yesss.28: bets $0.43
chris2766: folds 
Uncalled bet ($0.43) returned to yesss.28
yesss.28 collected $0.43 from pot
yesss.28: doesn't show hand 
*** SUMMARY ***
Total pot $0.45 | Rake $0.02 
Board [9h Kd Tc]
Seat 1: alfredovga folded before Flop (didn't bet)
Seat 2: Eduard Gl folded before Flop (didn't bet)
Seat 3: vodka4fun folded before Flop (didn't bet)
Seat 4: chris2766 (button) folded on the Flop
Seat 5: sAnt1n135 (small blind) folded before Flop
Seat 6: yesss.28 (big blind) collected ($0.43)



PokerStars Hand #222966978827:  Hold'em No Limit ($0.05/$0.10 USD) - 2021/01/23 14:40:04 ET
Table 'Grus IV' 6-max Seat #5 is the button
Seat 1: alfredovga ($10.79 in chips) 
Seat 2: Eduard Gl ($32.49 in chips) 
Seat 3: vodka4fun ($14.28 in chips) 
Seat 4: chris2766 ($15.68 in chips) 
Seat 5: sAnt1n135 ($9.25 in chips) 
Seat 6: yesss.28 ($10.23 in chips) 
yesss.28: posts small blind $0.05
alfredovga: posts big blind $0.10
*** HOLE CARDS ***
Eduard Gl: raises $0.20 to $0.30
vodka4fun: raises $0.70 to $1
chris2766: folds 
sAnt1n135: folds 
yesss.28: calls $0.95
alfredovga: folds 
Eduard Gl: calls $0.70
*** FLOP *** [Kd 4s 4d]
yesss.28: checks 
Eduard Gl: checks 
vodka4fun: bets $1
yesss.28: folds 
Eduard Gl: calls $1
*** TURN *** [Kd 4s 4d] [Ts]
Eduard Gl: bets $2.44
vodka4fun: calls $2.44
*** RIVER *** [Kd 4s 4d Ts] [Ac]
Eduard Gl: checks 
vodka4fun: checks 
*** SHOW DOWN ***
Eduard Gl: shows [6d 5d] (a pair of Fours)
vodka4fun: shows [Ad 7d] (two pair, Aces and Fours)
vodka4fun collected $9.53 from pot
*** SUMMARY ***
Total pot $9.98 | Rake $0.45 
Board [Kd 4s 4d Ts Ac]
Seat 1: alfredovga (big blind) folded before Flop
Seat 2: Eduard Gl showed [6d 5d] and lost with a pair of Fours
Seat 3: vodka4fun showed [Ad 7d] and won ($9.53) with two pair, Aces and Fours
Seat 4: chris2766 folded before Flop (didn't bet)
Seat 5: sAnt1n135 (button) folded before Flop (didn't bet)
Seat 6: yesss.28 (small blind) folded on the Flop



PokerStars Hand #222967035190:  Hold'em No Limit ($0.05/$0.10 USD) - 2021/01/23 14:41:16 ET
Table 'Grus IV' 6-max Seat #6 is the button
Seat 1: alfredovga ($10.69 in chips) 
Seat 2: Eduard Gl ($28.05 in chips) 
Seat 3: vodka4fun ($19.37 in chips) 
Seat 4: chris2766 ($15.68 in chips) 
Seat 5: sAnt1n135 ($9.25 in chips) 
Seat 6: yesss.28 ($9.23 in chips) 
alfredovga: posts small blind $0.05
Eduard Gl: posts big blind $0.10
*** HOLE CARDS ***
vodka4fun: raises $0.20 to $0.30
chris2766: folds 
sAnt1n135: folds 
yesss.28: calls $0.30
alfredovga: folds 
Eduard Gl: folds 
*** FLOP *** [5h Qs 7c]
vodka4fun: bets $0.40
yesss.28: raises $0.40 to $0.80
vodka4fun has timed out
vodka4fun: folds 
Uncalled bet ($0.40) returned to yesss.28
yesss.28 collected $1.48 from pot
yesss.28: doesn't show hand 
*** SUMMARY ***
Total pot $1.55 | Rake $0.07 
Board [5h Qs 7c]
Seat 1: alfredovga (small blind) folded before Flop
Seat 2: Eduard Gl (big blind) folded before Flop
Seat 3: vodka4fun folded on the Flop
Seat 4: chris2766 folded before Flop (didn't bet)
Seat 5: sAnt1n135 folded before Flop (didn't bet)
Seat 6: yesss.28 (button) collected ($1.48)



PokerStars Hand #222967136610:  Hold'em No Limit ($0.05/$0.10 USD) - 2021/01/23 14:43:26 ET
Table 'Grus IV' 6-max Seat #2 is the button
Seat 1: alfredovga ($10.64 in chips) 
Seat 2: Eduard Gl ($27.90 in chips) 
Seat 3: vodka4fun ($18.47 in chips) 
Seat 4: chris2766 ($15.48 in chips) 
Seat 5: sAnt1n135 ($9.25 in chips) 
Seat 6: yesss.28 ($10.43 in chips) 
vodka4fun: posts small blind $0.05
chris2766: posts big blind $0.10
*** HOLE CARDS ***
sAnt1n135: folds 
yesss.28: raises $0.10 to $0.20
alfredovga: folds 
Eduard Gl: folds 
vodka4fun: folds 
chris2766: calls $0.10
*** FLOP *** [8d Qs 6c]
chris2766: checks 
yesss.28: bets $0.43
chris2766: calls $0.43
*** TURN *** [8d Qs 6c] [3c]
chris2766: checks 
yesss.28: checks 
*** RIVER *** [8d Qs 6c 3c] [Ts]
chris2766: checks 
yesss.28: checks 
*** SHOW DOWN ***
chris2766: shows [8h As] (a pair of Eights)
yesss.28: mucks hand 
chris2766 collected $1.25 from pot
*** SUMMARY ***
Total pot $1.31 | Rake $0.06 
Board [8d Qs 6c 3c Ts]
Seat 1: alfredovga folded before Flop (didn't bet)
Seat 2: Eduard Gl (button) folded before Flop (didn't bet)
Seat 3: vodka4fun (small blind) folded before Flop
Seat 4: chris2766 (big blind) showed [8h As] and won ($1.25) with a pair of Eights
Seat 5: sAnt1n135 folded before Flop (didn't bet)
Seat 6: yesss.28 mucked



PokerStars Hand #222967166384:  Hold'em No Limit ($0.05/$0.10 USD) - 2021/01/23 14:44:04 ET
Table 'Grus IV' 6-max Seat #3 is the button
Seat 1: alfredovga ($10.64 in chips) 
Seat 2: Eduard Gl ($27.90 in chips) 
Seat 3: vodka4fun ($18.42 in chips) 
Seat 4: chris2766 ($16.10 in chips) 
Seat 5: sAnt1n135 ($9.25 in chips) 
Seat 6: yesss.28 ($9.80 in chips) 
chris2766: posts small blind $0.05
sAnt1n135: posts big blind $0.10
*** HOLE CARDS ***
yesss.28: folds 
alfredovga: folds 
Eduard Gl: folds 
vodka4fun: folds 
chris2766: raises $0.10 to $0.20
sAnt1n135: raises $0.50 to $0.70
chris2766: folds 
Uncalled bet ($0.50) returned to sAnt1n135
sAnt1n135 collected $0.40 from pot
sAnt1n135: doesn't show hand 
*** SUMMARY ***
Total pot $0.40 | Rake $0 
Seat 1: alfredovga folded before Flop (didn't bet)
Seat 2: Eduard Gl folded before Flop (didn't bet)
Seat 3: vodka4fun (button) folded before Flop (didn't bet)
Seat 4: chris2766 (small blind) folded before Flop
Seat 5: sAnt1n135 (big blind) collected ($0.40)
Seat 6: yesss.28 folded before Flop (didn't bet)



PokerStars Hand #222967182688:  Hold'em No Limit ($0.05/$0.10 USD) - 2021/01/23 14:44:25 ET
Table 'Grus IV' 6-max Seat #4 is the button
Seat 1: alfredovga ($10.64 in chips) 
Seat 2: Eduard Gl ($27.90 in chips) 
Seat 3: vodka4fun ($18.42 in chips) 
Seat 4: chris2766 ($15.90 in chips) 
Seat 5: sAnt1n135 ($9.45 in chips) 
Seat 6: yesss.28 ($9.80 in chips) 
sAnt1n135: posts small blind $0.05
yesss.28: posts big blind $0.10
*** HOLE CARDS ***
alfredovga: raises $0.10 to $0.20
Eduard Gl: folds 
vodka4fun: folds 
chris2766: calls $0.20
sAnt1n135: folds 
yesss.28: calls $0.10
*** FLOP *** [3s 4d Qd]
yesss.28: checks 
alfredovga: bets $0.60
chris2766: folds 
yesss.28: folds 
Uncalled bet ($0.60) returned to alfredovga
alfredovga collected $0.62 from pot
alfredovga: doesn't show hand 
*** SUMMARY ***
Total pot $0.65 | Rake $0.03 
Board [3s 4d Qd]
Seat 1: alfredovga collected ($0.62)
Seat 2: Eduard Gl folded before Flop (didn't bet)
Seat 3: vodka4fun folded before Flop (didn't bet)
Seat 4: chris2766 (button) folded on the Flop
Seat 5: sAnt1n135 (small blind) folded before Flop
Seat 6: yesss.28 (big blind) folded on the Flop



PokerStars Hand #222967203321:  Hold'em No Limit ($0.05/$0.10 USD) - 2021/01/23 14:44:51 ET
Table 'Grus IV' 6-max Seat #5 is the button
Seat 1: alfredovga ($11.06 in chips) 
Seat 2: Eduard Gl ($27.90 in chips) 
Seat 3: vodka4fun ($18.42 in chips) 
Seat 4: chris2766 ($15.70 in chips) 
Seat 5: sAnt1n135 ($9.40 in chips) 
Seat 6: yesss.28 ($9.60 in chips) 
yesss.28: posts small blind $0.05
alfredovga: posts big blind $0.10
*** HOLE CARDS ***
Eduard Gl: folds 
vodka4fun: folds 
chris2766: folds 
sAnt1n135: raises $0.13 to $0.23
yesss.28: raises $0.13 to $0.36
alfredovga: calls $0.26
sAnt1n135: calls $0.13
*** FLOP *** [7d 9c 6c]
yesss.28: bets $1.03
alfredovga: calls $1.03
sAnt1n135: folds 
*** TURN *** [7d 9c 6c] [3c]
yesss.28: bets $3
alfredovga: folds 
Uncalled bet ($3) returned to yesss.28
yesss.28 collected $3 from pot
yesss.28: doesn't show hand 
*** SUMMARY ***
Total pot $3.14 | Rake $0.14 
Board [7d 9c 6c 3c]
Seat 1: alfredovga (big blind) folded on the Turn
Seat 2: Eduard Gl folded before Flop (didn't bet)
Seat 3: vodka4fun folded before Flop (didn't bet)
Seat 4: chris2766 folded before Flop (didn't bet)
Seat 5: sAnt1n135 (button) folded on the Flop
Seat 6: yesss.28 (small blind) collected ($3)



PokerStars Hand #222967234026:  Hold'em No Limit ($0.05/$0.10 USD) - 2021/01/23 14:45:31 ET
Table 'Grus IV' 6-max Seat #6 is the button
Seat 1: alfredovga ($9.67 in chips) 
Seat 2: Eduard Gl ($27.90 in chips) 
Seat 3: vodka4fun ($18.42 in chips) 
Seat 4: chris2766 ($15.70 in chips) 
Seat 5: sAnt1n135 ($9.04 in chips) 
Seat 6: yesss.28 ($11.21 in chips) 
alfredovga: posts small blind $0.05
Eduard Gl: posts big blind $0.10
*** HOLE CARDS ***
vodka4fun: folds 
chris2766: raises $0.10 to $0.20
sAnt1n135: folds 
yesss.28: folds 
alfredovga: calls $0.15
Eduard Gl: folds 
*** FLOP *** [Jh Tc 6h]
alfredovga: checks 
chris2766: checks 
*** TURN *** [Jh Tc 6h] [Kc]
alfredovga: bets $0.10
chris2766: calls $0.10
*** RIVER *** [Jh Tc 6h Kc] [Qh]
alfredovga: checks 
chris2766: checks 
*** SHOW DOWN ***
alfredovga: shows [Kd 7c] (a pair of Kings)
chris2766: shows [9d 9h] (a straight, Nine to King)
chris2766 collected $0.67 from pot
*** SUMMARY ***
Total pot $0.70 | Rake $0.03 
Board [Jh Tc 6h Kc Qh]
Seat 1: alfredovga (small blind) showed [Kd 7c] and lost with a pair of Kings
Seat 2: Eduard Gl (big blind) folded before Flop
Seat 3: vodka4fun folded before Flop (didn't bet)
Seat 4: chris2766 showed [9d 9h] and won ($0.67) with a straight, Nine to King
Seat 5: sAnt1n135 folded before Flop (didn't bet)
Seat 6: yesss.28 (button) folded before Flop (didn't bet)



PokerStars Hand #222967263235:  Hold'em No Limit ($0.05/$0.10 USD) - 2021/01/23 14:46:08 ET
Table 'Grus IV' 6-max Seat #1 is the button
Seat 1: alfredovga ($9.37 in chips) 
Seat 2: Eduard Gl ($27.80 in chips) 
Seat 3: vodka4fun ($18.42 in chips) 
Seat 4: chris2766 ($16.07 in chips) 
Seat 5: sAnt1n135 ($9.04 in chips) 
Seat 6: yesss.28 ($11.21 in chips) 
Eduard Gl: posts small blind $0.05
vodka4fun: posts big blind $0.10
*** HOLE CARDS ***
chris2766: folds 
sAnt1n135: folds 
yesss.28: raises $0.25 to $0.35
alfredovga: folds 
Eduard Gl: calls $0.30
vodka4fun: calls $0.25
*** FLOP *** [Kh Kd 4c]
Eduard Gl: checks 
vodka4fun: checks 
yesss.28: checks 
*** TURN *** [Kh Kd 4c] [7s]
Eduard Gl: bets $0.60
vodka4fun: calls $0.60
yesss.28: raises $0.60 to $1.20
Eduard Gl: folds 
vodka4fun: calls $0.60
*** RIVER *** [Kh Kd 4c 7s] [2d]
vodka4fun: checks 
yesss.28: bets $3.87
vodka4fun: folds 
Uncalled bet ($3.87) returned to yesss.28
yesss.28 collected $3.87 from pot
yesss.28: doesn't show hand 
*** SUMMARY ***
Total pot $4.05 | Rake $0.18 
Board [Kh Kd 4c 7s 2d]
Seat 1: alfredovga (button) folded before Flop (didn't bet)
Seat 2: Eduard Gl (small blind) folded on the Turn
Seat 3: vodka4fun (big blind) folded on the River
Seat 4: chris2766 folded before Flop (didn't bet)
Seat 5: sAnt1n135 folded before Flop (didn't bet)
Seat 6: yesss.28 collected ($3.87)



PokerStars Hand #222967314657:  Hold'em No Limit ($0.05/$0.10 USD) - 2021/01/23 14:47:15 ET
Table 'Grus IV' 6-max Seat #2 is the button
Seat 1: alfredovga ($9.37 in chips) 
Seat 2: Eduard Gl ($26.85 in chips) 
Seat 3: vodka4fun ($16.87 in chips) 
Seat 4: chris2766 ($16.07 in chips) 
Seat 5: sAnt1n135 ($9.04 in chips) 
Seat 6: yesss.28 ($13.53 in chips) 
vodka4fun: posts small blind $0.05
chris2766: posts big blind $0.10
*** HOLE CARDS ***
sAnt1n135: folds 
yesss.28: raises $0.25 to $0.35
alfredovga: folds 
Eduard Gl: folds 
vodka4fun: calls $0.30
chris2766: calls $0.25
*** FLOP *** [Jh Jd Td]
vodka4fun: checks 
chris2766: checks 
yesss.28: bets $1
vodka4fun: folds 
chris2766: folds 
Uncalled bet ($1) returned to yesss.28
yesss.28 collected $1 from pot
yesss.28: doesn't show hand 
*** SUMMARY ***
Total pot $1.05 | Rake $0.05 
Board [Jh Jd Td]
Seat 1: alfredovga folded before Flop (didn't bet)
Seat 2: Eduard Gl (button) folded before Flop (didn't bet)
Seat 3: vodka4fun (small blind) folded on the Flop
Seat 4: chris2766 (big blind) folded on the Flop
Seat 5: sAnt1n135 folded before Flop (didn't bet)
Seat 6: yesss.28 collected ($1)



PokerStars Hand #222967335749:  Hold'em No Limit ($0.05/$0.10 USD) - 2021/01/23 14:47:42 ET
Table 'Grus IV' 6-max Seat #3 is the button
Seat 1: alfredovga ($9.37 in chips) 
Seat 2: Eduard Gl ($26.85 in chips) 
Seat 3: vodka4fun ($16.52 in chips) 
Seat 4: chris2766 ($15.72 in chips) 
Seat 5: sAnt1n135 ($9.04 in chips) 
Seat 6: yesss.28 ($14.18 in chips) 
chris2766: posts small blind $0.05
sAnt1n135: posts big blind $0.10
*** HOLE CARDS ***
yesss.28: raises $0.25 to $0.35
alfredovga: folds 
Eduard Gl: calls $0.35
vodka4fun: folds 
chris2766: folds 
sAnt1n135: folds 
*** FLOP *** [6s 4s Th]
yesss.28: bets $0.81
Eduard Gl: folds 
Uncalled bet ($0.81) returned to yesss.28
yesss.28 collected $0.81 from pot
yesss.28: doesn't show hand 
*** SUMMARY ***
Total pot $0.85 | Rake $0.04 
Board [6s 4s Th]
Seat 1: alfredovga folded before Flop (didn't bet)
Seat 2: Eduard Gl folded on the Flop
Seat 3: vodka4fun (button) folded before Flop (didn't bet)
Seat 4: chris2766 (small blind) folded before Flop
Seat 5: sAnt1n135 (big blind) folded before Flop
Seat 6: yesss.28 collected ($0.81)



PokerStars Hand #222967353968:  Hold'em No Limit ($0.05/$0.10 USD) - 2021/01/23 14:48:05 ET
Table 'Grus IV' 6-max Seat #4 is the button
Seat 1: alfredovga ($9.37 in chips) 
Seat 2: Eduard Gl ($26.50 in chips) 
Seat 3: vodka4fun ($16.52 in chips) 
Seat 4: chris2766 ($15.67 in chips) 
Seat 5: sAnt1n135 ($8.94 in chips) 
Seat 6: yesss.28 ($14.64 in chips) 
sAnt1n135: posts small blind $0.05
yesss.28: posts big blind $0.10
*** HOLE CARDS ***
alfredovga: raises $0.10 to $0.20
Eduard Gl: folds 
vodka4fun: calls $0.20
chris2766: folds 
sAnt1n135: calls $0.15
yesss.28: calls $0.10
*** FLOP *** [3d 2s 6s]
sAnt1n135: checks 
yesss.28: bets $0.76
alfredovga: calls $0.76
vodka4fun: folds 
sAnt1n135: folds 
*** TURN *** [3d 2s 6s] [Qc]
yesss.28: bets $1.11
alfredovga: calls $1.11
*** RIVER *** [3d 2s 6s Qc] [Ad]
yesss.28: bets $4.34
alfredovga: folds 
Uncalled bet ($4.34) returned to yesss.28
yesss.28 collected $4.34 from pot
yesss.28: doesn't show hand 
*** SUMMARY ***
Total pot $4.54 | Rake $0.20 
Board [3d 2s 6s Qc Ad]
Seat 1: alfredovga folded on the River
Seat 2: Eduard Gl folded before Flop (didn't bet)
Seat 3: vodka4fun folded on the Flop
Seat 4: chris2766 (button) folded before Flop (didn't bet)
Seat 5: sAnt1n135 (small blind) folded on the Flop
Seat 6: yesss.28 (big blind) collected ($4.34)



PokerStars Hand #222967396778:  Hold'em No Limit ($0.05/$0.10 USD) - 2021/01/23 14:49:00 ET
Table 'Grus IV' 6-max Seat #5 is the button
Seat 1: alfredovga ($7.30 in chips) 
Seat 2: Eduard Gl ($26.50 in chips) 
Seat 3: vodka4fun ($16.32 in chips) 
Seat 5: sAnt1n135 ($8.74 in chips) 
Seat 6: yesss.28 ($16.91 in chips) 
yesss.28: posts small blind $0.05
alfredovga: posts big blind $0.10
*** HOLE CARDS ***
Eduard Gl: folds 
vodka4fun: folds 
sAnt1n135: folds 
yesss.28: calls $0.05
alfredovga: raises $0.20 to $0.30
yesss.28: calls $0.20
*** FLOP *** [Jh 5c 9d]
yesss.28: checks 
alfredovga: checks 
*** TURN *** [Jh 5c 9d] [Ts]
yesss.28: bets $0.57
alfredovga: folds 
Uncalled bet ($0.57) returned to yesss.28
yesss.28 collected $0.57 from pot
yesss.28: doesn't show hand 
*** SUMMARY ***
Total pot $0.60 | Rake $0.03 
Board [Jh 5c 9d Ts]
Seat 1: alfredovga (big blind) folded on the Turn
Seat 2: Eduard Gl folded before Flop (didn't bet)
Seat 3: vodka4fun folded before Flop (didn't bet)
Seat 5: sAnt1n135 (button) folded before Flop (didn't bet)
Seat 6: yesss.28 (small blind) collected ($0.57)



PokerStars Hand #222967425608:  Hold'em No Limit ($0.05/$0.10 USD) - 2021/01/23 14:49:38 ET
Table 'Grus IV' 6-max Seat #6 is the button
Seat 1: alfredovga ($7 in chips) 
Seat 2: Eduard Gl ($26.50 in chips) 
Seat 3: vodka4fun ($16.32 in chips) 
Seat 5: sAnt1n135 ($8.74 in chips) 
Seat 6: yesss.28 ($17.18 in chips) 
alfredovga: posts small blind $0.05
Eduard Gl: posts big blind $0.10
*** HOLE CARDS ***
vodka4fun: raises $0.20 to $0.30
sAnt1n135: calls $0.30
yesss.28: folds 
alfredovga: calls $0.25
Eduard Gl: calls $0.20
*** FLOP *** [Jd 2h 5s]
alfredovga: checks 
Eduard Gl: checks 
vodka4fun: checks 
sAnt1n135: checks 
*** TURN *** [Jd 2h 5s] [4d]
alfredovga: checks 
Eduard Gl: checks 
vodka4fun: checks 
sAnt1n135: checks 
*** RIVER *** [Jd 2h 5s 4d] [Ac]
alfredovga: checks 
Eduard Gl: checks 
vodka4fun: checks 
sAnt1n135: checks 
*** SHOW DOWN ***
alfredovga: shows [8h 6h] (high card Ace)
Eduard Gl: shows [4c 6d] (a pair of Fours)
vodka4fun: mucks hand 
sAnt1n135: mucks hand 
Eduard Gl collected $1.15 from pot
*** SUMMARY ***
Total pot $1.20 | Rake $0.05 
Board [Jd 2h 5s 4d Ac]
Seat 1: alfredovga (small blind) showed [8h 6h] and lost with high card Ace
Seat 2: Eduard Gl (big blind) showed [4c 6d] and won ($1.15) with a pair of Fours
Seat 3: vodka4fun mucked
Seat 5: sAnt1n135 mucked
Seat 6: yesss.28 (button) folded before Flop (didn't bet)



PokerStars Hand #222967464265:  Hold'em No Limit ($0.05/$0.10 USD) - 2021/01/23 14:50:28 ET
Table 'Grus IV' 6-max Seat #1 is the button
Seat 1: alfredovga ($6.70 in chips) 
Seat 2: Eduard Gl ($27.35 in chips) 
Seat 3: vodka4fun ($16.02 in chips) 
Seat 5: sAnt1n135 ($8.44 in chips) 
Seat 6: yesss.28 ($17.18 in chips) 
Eduard Gl: posts small blind $0.05
vodka4fun: posts big blind $0.10
*** HOLE CARDS ***
sAnt1n135: folds 
yesss.28: calls $0.10
alfredovga: folds 
Eduard Gl: folds 
vodka4fun: checks 
*** FLOP *** [5d Kc Ts]
vodka4fun: checks 
yesss.28: checks 
*** TURN *** [5d Kc Ts] [6c]
vodka4fun: checks 
yesss.28: checks 
*** RIVER *** [5d Kc Ts 6c] [5h]
vodka4fun: checks 
yesss.28: bets $0.24
vodka4fun: calls $0.24
*** SHOW DOWN ***
yesss.28: shows [4c 9s] (a pair of Fives)
vodka4fun: shows [2c 2d] (two pair, Fives and Deuces)
vodka4fun collected $0.70 from pot
*** SUMMARY ***
Total pot $0.73 | Rake $0.03 
Board [5d Kc Ts 6c 5h]
Seat 1: alfredovga (button) folded before Flop (didn't bet)
Seat 2: Eduard Gl (small blind) folded before Flop
Seat 3: vodka4fun (big blind) showed [2c 2d] and won ($0.70) with two pair, Fives and Deuces
Seat 5: sAnt1n135 folded before Flop (didn't bet)
Seat 6: yesss.28 showed [4c 9s] and lost with a pair of Fives



PokerStars Hand #222967482433:  Hold'em No Limit ($0.05/$0.10 USD) - 2021/01/23 14:50:52 ET
Table 'Grus IV' 6-max Seat #2 is the button
Seat 1: alfredovga ($6.70 in chips) 
Seat 2: Eduard Gl ($27.30 in chips) 
Seat 3: vodka4fun ($16.38 in chips) 
Seat 5: sAnt1n135 ($8.44 in chips) 
Seat 6: yesss.28 ($16.84 in chips) 
vodka4fun: posts small blind $0.05
sAnt1n135: posts big blind $0.10
*** HOLE CARDS ***
yesss.28: raises $0.25 to $0.35
alfredovga: folds 
Eduard Gl: folds 
vodka4fun: calls $0.30
sAnt1n135: folds 
*** FLOP *** [Qc Ts 4c]
vodka4fun: checks 
yesss.28: bets $0.76
vodka4fun: raises $1.24 to $2
yesss.28: calls $1.24
*** TURN *** [Qc Ts 4c] [4h]
vodka4fun: checks 
yesss.28: checks 
*** RIVER *** [Qc Ts 4c 4h] [Kh]
vodka4fun: checks 
yesss.28: bets $4.58
vodka4fun: raises $9.45 to $14.03 and is all-in
yesss.28: folds 
Uncalled bet ($9.45) returned to vodka4fun
vodka4fun collected $13.33 from pot
*** SUMMARY ***
Total pot $13.96 | Rake $0.63 
Board [Qc Ts 4c 4h Kh]
Seat 1: alfredovga folded before Flop (didn't bet)
Seat 2: Eduard Gl (button) folded before Flop (didn't bet)
Seat 3: vodka4fun (small blind) collected ($13.33)
Seat 5: sAnt1n135 (big blind) folded before Flop
Seat 6: yesss.28 folded on the River



PokerStars Hand #222967523871:  Hold'em No Limit ($0.05/$0.10 USD) - 2021/01/23 14:51:45 ET
Table 'Grus IV' 6-max Seat #3 is the button
Seat 1: alfredovga ($6.70 in chips) 
Seat 2: Eduard Gl ($27.30 in chips) 
Seat 3: vodka4fun ($22.78 in chips) 
Seat 5: sAnt1n135 ($8.34 in chips) 
Seat 6: yesss.28 ($9.91 in chips) 
sAnt1n135: posts small blind $0.05
yesss.28: posts big blind $0.10
*** HOLE CARDS ***
alfredovga: folds 
Eduard Gl: folds 
vodka4fun: raises $0.20 to $0.30
sAnt1n135: folds 
yesss.28: raises $0.65 to $0.95
vodka4fun: folds 
Uncalled bet ($0.65) returned to yesss.28
yesss.28 collected $0.65 from pot
yesss.28: doesn't show hand 
*** SUMMARY ***
Total pot $0.65 | Rake $0 
Seat 1: alfredovga folded before Flop (didn't bet)
Seat 2: Eduard Gl folded before Flop (didn't bet)
Seat 3: vodka4fun (button) folded before Flop
Seat 5: sAnt1n135 (small blind) folded before Flop
Seat 6: yesss.28 (big blind) collected ($0.65)



PokerStars Hand #222967542383:  Hold'em No Limit ($0.05/$0.10 USD) - 2021/01/23 14:52:10 ET
Table 'Grus IV' 6-max Seat #5 is the button
Seat 1: alfredovga ($6.70 in chips) 
Seat 2: Eduard Gl ($27.30 in chips) 
Seat 3: vodka4fun ($22.48 in chips) 
Seat 5: sAnt1n135 ($8.29 in chips) 
Seat 6: yesss.28 ($10.26 in chips) 
yesss.28: posts small blind $0.05
alfredovga: posts big blind $0.10
chris2766: sits out 
*** HOLE CARDS ***
Eduard Gl: raises $0.20 to $0.30
vodka4fun: folds 
sAnt1n135: raises $0.75 to $1.05
yesss.28: calls $1
alfredovga: folds 
Eduard Gl: calls $0.75
*** FLOP *** [9d 2d 9c]
yesss.28: checks 
Eduard Gl: checks 
sAnt1n135: bets $1.71
yesss.28: folds 
Eduard Gl: folds 
Uncalled bet ($1.71) returned to sAnt1n135
sAnt1n135 collected $3.10 from pot
sAnt1n135: doesn't show hand 
*** SUMMARY ***
Total pot $3.25 | Rake $0.15 
Board [9d 2d 9c]
Seat 1: alfredovga (big blind) folded before Flop
Seat 2: Eduard Gl folded on the Flop
Seat 3: vodka4fun folded before Flop (didn't bet)
Seat 5: sAnt1n135 (button) collected ($3.10)
Seat 6: yesss.28 (small blind) folded on the Flop



PokerStars Hand #222967563728:  Hold'em No Limit ($0.05/$0.10 USD) - 2021/01/23 14:52:37 ET
Table 'Grus IV' 6-max Seat #6 is the button
Seat 1: alfredovga ($6.60 in chips) 
Seat 2: Eduard Gl ($26.25 in chips) 
Seat 3: vodka4fun ($22.48 in chips) 
Seat 5: sAnt1n135 ($10.34 in chips) 
Seat 6: yesss.28 ($9.21 in chips) 
alfredovga: posts small blind $0.05
Eduard Gl: posts big blind $0.10
chris2766: sits out 
*** HOLE CARDS ***
vodka4fun: folds 
sAnt1n135: raises $0.13 to $0.23
yesss.28: calls $0.23
alfredovga: folds 
Eduard Gl: raises $1.17 to $1.40
sAnt1n135: folds 
yesss.28: calls $1.17
*** FLOP *** [5h 8c Tc]
Eduard Gl: checks 
yesss.28: bets $2.94
Eduard Gl: raises $21.91 to $24.85 and is all-in
yesss.28: calls $4.87 and is all-in
Uncalled bet ($17.04) returned to Eduard Gl
*** TURN *** [5h 8c Tc] [8h]
*** RIVER *** [5h 8c Tc 8h] [8d]
*** SHOW DOWN ***
Eduard Gl: shows [Ks Kc] (a full house, Eights full of Kings)
yesss.28: shows [4c Jc] (three of a kind, Eights)
Eduard Gl collected $17.86 from pot
*** SUMMARY ***
Total pot $18.70 | Rake $0.84 
Board [5h 8c Tc 8h 8d]
Seat 1: alfredovga (small blind) folded before Flop
Seat 2: Eduard Gl (big blind) showed [Ks Kc] and won ($17.86) with a full house, Eights full of Kings
Seat 3: vodka4fun folded before Flop (didn't bet)
Seat 5: sAnt1n135 folded before Flop
Seat 6: yesss.28 (button) showed [4c Jc] and lost with three of a kind, Eights



PokerStars Hand #222967598933:  Hold'em No Limit ($0.05/$0.10 USD) - 2021/01/23 14:53:23 ET
Table 'Grus IV' 6-max Seat #1 is the button
Seat 1: alfredovga ($6.55 in chips) 
Seat 2: Eduard Gl ($34.90 in chips) 
Seat 3: vodka4fun ($22.48 in chips) 
Seat 5: sAnt1n135 ($10.11 in chips) 
Eduard Gl: posts small blind $0.05
vodka4fun: posts big blind $0.10
chris2766: sits out 
*** HOLE CARDS ***
sAnt1n135: folds 
alfredovga: folds 
yesss.28 leaves the table
Eduard Gl: raises $0.20 to $0.30
vodka4fun: folds 
Uncalled bet ($0.20) returned to Eduard Gl
Eduard Gl collected $0.20 from pot
Eduard Gl: doesn't show hand 
*** SUMMARY ***
Total pot $0.20 | Rake $0 
Seat 1: alfredovga (button) folded before Flop (didn't bet)
Seat 2: Eduard Gl (small blind) collected ($0.20)
Seat 3: vodka4fun (big blind) folded before Flop
Seat 5: sAnt1n135 folded before Flop (didn't bet)



PokerStars Hand #222967609471:  Hold'em No Limit ($0.05/$0.10 USD) - 2021/01/23 14:53:37 ET
Table 'Grus IV' 6-max Seat #2 is the button
Seat 1: alfredovga ($6.55 in chips) 
Seat 2: Eduard Gl ($35 in chips) 
Seat 3: vodka4fun ($22.38 in chips) 
Seat 4: chris2766 ($15.67 in chips) 
Seat 5: sAnt1n135 ($10.11 in chips) 
vodka4fun: posts small blind $0.05
chris2766: posts big blind $0.10
*** HOLE CARDS ***
aII-in,really? joins the table at seat #6 
sAnt1n135: folds 
alfredovga: calls $0.10
Eduard Gl: folds 
vodka4fun: raises $0.37 to $0.47
chris2766: folds 
alfredovga: calls $0.37
*** FLOP *** [4s 8c Jd]
vodka4fun: bets $0.66
alfredovga: folds 
Uncalled bet ($0.66) returned to vodka4fun
vodka4fun collected $0.99 from pot
*** SUMMARY ***
Total pot $1.04 | Rake $0.05 
Board [4s 8c Jd]
Seat 1: alfredovga folded on the Flop
Seat 2: Eduard Gl (button) folded before Flop (didn't bet)
Seat 3: vodka4fun (small blind) collected ($0.99)
Seat 4: chris2766 (big blind) folded before Flop
Seat 5: sAnt1n135 folded before Flop (didn't bet)



PokerStars Hand #222967637705:  Hold'em No Limit ($0.05/$0.10 USD) - 2021/01/23 14:54:05 ET
Table 'Grus IV' 6-max Seat #3 is the button
Seat 1: alfredovga ($6.08 in chips) 
Seat 2: Eduard Gl ($35 in chips) 
Seat 3: vodka4fun ($22.90 in chips) 
Seat 4: chris2766 ($15.57 in chips) 
Seat 5: sAnt1n135 ($10.11 in chips) 
chris2766: posts small blind $0.05
sAnt1n135: posts big blind $0.10
aII-in,really?: sits out 
*** HOLE CARDS ***
alfredovga: folds 
Eduard Gl: folds 
vodka4fun: raises $0.20 to $0.30
chris2766: folds 
sAnt1n135: raises $0.50 to $0.80
vodka4fun: folds 
Uncalled bet ($0.50) returned to sAnt1n135
sAnt1n135 collected $0.65 from pot
sAnt1n135: doesn't show hand 
*** SUMMARY ***
Total pot $0.65 | Rake $0 
Seat 1: alfredovga folded before Flop (didn't bet)
Seat 2: Eduard Gl folded before Flop (didn't bet)
Seat 3: vodka4fun (button) folded before Flop
Seat 4: chris2766 (small blind) folded before Flop
Seat 5: sAnt1n135 (big blind) collected ($0.65)



PokerStars Hand #222967672326:  Hold'em No Limit ($0.05/$0.10 USD) - 2021/01/23 14:54:50 ET
Table 'Grus IV' 6-max Seat #4 is the button
Seat 1: alfredovga ($6.08 in chips) 
Seat 2: Eduard Gl ($35 in chips) 
Seat 3: vodka4fun ($22.60 in chips) 
Seat 4: chris2766 ($15.52 in chips) 
Seat 5: sAnt1n135 ($10.46 in chips) 
Seat 6: aII-in,really? ($10 in chips) 
sAnt1n135: posts small blind $0.05
aII-in,really?: posts big blind $0.10
*** HOLE CARDS ***
alfredovga: raises $0.10 to $0.20
Eduard Gl: folds 
vodka4fun: folds 
chris2766: calls $0.20
sAnt1n135: folds 
aII-in,really?: folds 
*** FLOP *** [Ad 9s 6h]
alfredovga: bets $0.50
chris2766: folds 
Uncalled bet ($0.50) returned to alfredovga
alfredovga collected $0.53 from pot
alfredovga: doesn't show hand 
*** SUMMARY ***
Total pot $0.55 | Rake $0.02 
Board [Ad 9s 6h]
Seat 1: alfredovga collected ($0.53)
Seat 2: Eduard Gl folded before Flop (didn't bet)
Seat 3: vodka4fun folded before Flop (didn't bet)
Seat 4: chris2766 (button) folded on the Flop
Seat 5: sAnt1n135 (small blind) folded before Flop
Seat 6: aII-in,really? (big blind) folded before Flop



PokerStars Hand #222967693504:  Hold'em No Limit ($0.05/$0.10 USD) - 2021/01/23 14:55:22 ET
Table 'Grus IV' 6-max Seat #5 is the button
Seat 1: alfredovga ($6.41 in chips) 
Seat 2: Eduard Gl ($35 in chips) 
Seat 3: vodka4fun ($22.60 in chips) 
Seat 4: chris2766 ($15.32 in chips) 
Seat 5: sAnt1n135 ($10.41 in chips) 
Seat 6: aII-in,really? ($9.90 in chips) 
aII-in,really?: posts small blind $0.05
alfredovga: posts big blind $0.10
*** HOLE CARDS ***
Eduard Gl: raises $0.20 to $0.30
vodka4fun: folds 
chris2766: folds 
sAnt1n135: folds 
aII-in,really?: folds 
alfredovga: folds 
Uncalled bet ($0.20) returned to Eduard Gl
Eduard Gl collected $0.25 from pot
Eduard Gl: doesn't show hand 
*** SUMMARY ***
Total pot $0.25 | Rake $0 
Seat 1: alfredovga (big blind) folded before Flop
Seat 2: Eduard Gl collected ($0.25)
Seat 3: vodka4fun folded before Flop (didn't bet)
Seat 4: chris2766 folded before Flop (didn't bet)
Seat 5: sAnt1n135 (button) folded before Flop (didn't bet)
Seat 6: aII-in,really? (small blind) folded before Flop



PokerStars Hand #222967709063:  Hold'em No Limit ($0.05/$0.10 USD) - 2021/01/23 14:55:51 ET
Table 'Grus IV' 6-max Seat #6 is the button
Seat 1: alfredovga ($6.31 in chips) 
Seat 2: Eduard Gl ($35.15 in chips) 
Seat 3: vodka4fun ($22.60 in chips) 
Seat 4: chris2766 ($15.32 in chips) 
Seat 5: sAnt1n135 ($10.41 in chips) 
Seat 6: aII-in,really? ($10 in chips) 
alfredovga: posts small blind $0.05
Eduard Gl: posts big blind $0.10
*** HOLE CARDS ***
vodka4fun: folds 
chris2766: folds 
sAnt1n135: folds 
aII-in,really?: raises $0.20 to $0.30
alfredovga: folds 
Eduard Gl: folds 
Uncalled bet ($0.20) returned to aII-in,really?
aII-in,really? collected $0.25 from pot
*** SUMMARY ***
Total pot $0.25 | Rake $0 
Seat 1: alfredovga (small blind) folded before Flop
Seat 2: Eduard Gl (big blind) folded before Flop
Seat 3: vodka4fun folded before Flop (didn't bet)
Seat 4: chris2766 folded before Flop (didn't bet)
Seat 5: sAnt1n135 folded before Flop (didn't bet)
Seat 6: aII-in,really? (button) collected ($0.25)



PokerStars Hand #222967714641:  Hold'em No Limit ($0.05/$0.10 USD) - 2021/01/23 14:56:02 ET
Table 'Grus IV' 6-max Seat #1 is the button
Seat 1: alfredovga ($6.26 in chips) 
Seat 2: Eduard Gl ($35.05 in chips) 
Seat 3: vodka4fun ($22.60 in chips) 
Seat 4: chris2766 ($15.32 in chips) 
Seat 5: sAnt1n135 ($10.41 in chips) 
Seat 6: aII-in,really? ($10.15 in chips) 
Eduard Gl: posts small blind $0.05
vodka4fun: posts big blind $0.10
*** HOLE CARDS ***
chris2766: raises $0.10 to $0.20
sAnt1n135: folds 
aII-in,really?: folds 
alfredovga: folds 
Eduard Gl: folds 
vodka4fun: calls $0.10
*** FLOP *** [6c Th 9s]
vodka4fun: checks 
chris2766: checks 
*** TURN *** [6c Th 9s] [Td]
vodka4fun: checks 
chris2766: checks 
*** RIVER *** [6c Th 9s Td] [9d]
vodka4fun: checks 
chris2766: checks 
*** SHOW DOWN ***
vodka4fun: shows [3h 3c] (two pair, Tens and Nines)
chris2766: shows [Kd Jd] (two pair, Tens and Nines - King kicker)
chris2766 collected $0.43 from pot
*** SUMMARY ***
Total pot $0.45 | Rake $0.02 
Board [6c Th 9s Td 9d]
Seat 1: alfredovga (button) folded before Flop (didn't bet)
Seat 2: Eduard Gl (small blind) folded before Flop
Seat 3: vodka4fun (big blind) showed [3h 3c] and lost with two pair, Tens and Nines
Seat 4: chris2766 showed [Kd Jd] and won ($0.43) with two pair, Tens and Nines
Seat 5: sAnt1n135 folded before Flop (didn't bet)
Seat 6: aII-in,really? folded before Flop (didn't bet)



PokerStars Hand #222967735989:  Hold'em No Limit ($0.05/$0.10 USD) - 2021/01/23 14:56:42 ET
Table 'Grus IV' 6-max Seat #2 is the button
Seat 1: alfredovga ($6.26 in chips) 
Seat 2: Eduard Gl ($35 in chips) 
Seat 3: vodka4fun ($22.40 in chips) 
Seat 4: chris2766 ($15.55 in chips) 
Seat 5: sAnt1n135 ($10.41 in chips) 
Seat 6: aII-in,really? ($10.15 in chips) 
vodka4fun: posts small blind $0.05
chris2766: posts big blind $0.10
*** HOLE CARDS ***
sAnt1n135: folds 
aII-in,really?: folds 
alfredovga: calls $0.10
Eduard Gl: folds 
vodka4fun: folds 
chris2766: checks 
*** FLOP *** [5h 8c 7c]
chris2766: checks 
alfredovga: bets $0.20
chris2766: calls $0.20
*** TURN *** [5h 8c 7c] [Qc]
chris2766: checks 
alfredovga: checks 
*** RIVER *** [5h 8c 7c Qc] [9c]
chris2766: checks 
alfredovga: bets $0.60
chris2766: folds 
Uncalled bet ($0.60) returned to alfredovga
alfredovga collected $0.62 from pot
alfredovga: doesn't show hand 
*** SUMMARY ***
Total pot $0.65 | Rake $0.03 
Board [5h 8c 7c Qc 9c]
Seat 1: alfredovga collected ($0.62)
Seat 2: Eduard Gl (button) folded before Flop (didn't bet)
Seat 3: vodka4fun (small blind) folded before Flop
Seat 4: chris2766 (big blind) folded on the River
Seat 5: sAnt1n135 folded before Flop (didn't bet)
Seat 6: aII-in,really? folded before Flop (didn't bet)



PokerStars Hand #222967764882:  Hold'em No Limit ($0.05/$0.10 USD) - 2021/01/23 14:57:36 ET
Table 'Grus IV' 6-max Seat #3 is the button
Seat 1: alfredovga ($6.58 in chips) 
Seat 2: Eduard Gl ($35 in chips) 
Seat 3: vodka4fun ($22.35 in chips) 
Seat 4: chris2766 ($15.25 in chips) 
Seat 5: sAnt1n135 ($10.41 in chips) 
Seat 6: aII-in,really? ($10.15 in chips) 
chris2766: posts small blind $0.05
sAnt1n135: posts big blind $0.10
*** HOLE CARDS ***
aII-in,really?: folds 
alfredovga: folds 
Eduard Gl: folds 
vodka4fun: raises $0.20 to $0.30
chris2766: folds 
sAnt1n135: folds 
Uncalled bet ($0.20) returned to vodka4fun
vodka4fun collected $0.25 from pot
*** SUMMARY ***
Total pot $0.25 | Rake $0 
Seat 1: alfredovga folded before Flop (didn't bet)
Seat 2: Eduard Gl folded before Flop (didn't bet)
Seat 3: vodka4fun (button) collected ($0.25)
Seat 4: chris2766 (small blind) folded before Flop
Seat 5: sAnt1n135 (big blind) folded before Flop
Seat 6: aII-in,really? folded before Flop (didn't bet)



PokerStars Hand #222967774880:  Hold'em No Limit ($0.05/$0.10 USD) - 2021/01/23 14:57:55 ET
Table 'Grus IV' 6-max Seat #4 is the button
Seat 1: alfredovga ($6.58 in chips) 
Seat 2: Eduard Gl ($35 in chips) 
Seat 3: vodka4fun ($22.50 in chips) 
Seat 4: chris2766 ($15.20 in chips) 
Seat 5: sAnt1n135 ($10.31 in chips) 
Seat 6: aII-in,really? ($10.15 in chips) 
sAnt1n135: posts small blind $0.05
aII-in,really?: posts big blind $0.10
*** HOLE CARDS ***
alfredovga: raises $0.25 to $0.35
Eduard Gl: folds 
vodka4fun: folds 
chris2766: folds 
sAnt1n135: folds 
aII-in,really?: folds 
Uncalled bet ($0.25) returned to alfredovga
alfredovga collected $0.25 from pot
*** SUMMARY ***
Total pot $0.25 | Rake $0 
Seat 1: alfredovga collected ($0.25)
Seat 2: Eduard Gl folded before Flop (didn't bet)
Seat 3: vodka4fun folded before Flop (didn't bet)
Seat 4: chris2766 (button) folded before Flop (didn't bet)
Seat 5: sAnt1n135 (small blind) folded before Flop
Seat 6: aII-in,really? (big blind) folded before Flop



PokerStars Hand #222967787768:  Hold'em No Limit ($0.05/$0.10 USD) - 2021/01/23 14:58:19 ET
Table 'Grus IV' 6-max Seat #5 is the button
Seat 1: alfredovga ($6.73 in chips) 
Seat 2: Eduard Gl ($35 in chips) 
Seat 3: vodka4fun ($22.50 in chips) 
Seat 4: chris2766 ($15.20 in chips) 
Seat 5: sAnt1n135 ($10.26 in chips) 
Seat 6: aII-in,really? ($10.05 in chips) 
aII-in,really?: posts small blind $0.05
alfredovga: posts big blind $0.10
*** HOLE CARDS ***
Eduard Gl: folds 
vodka4fun: folds 
chris2766: folds 
sAnt1n135: folds 
aII-in,really?: folds 
Uncalled bet ($0.05) returned to alfredovga
alfredovga collected $0.10 from pot
alfredovga: doesn't show hand 
*** SUMMARY ***
Total pot $0.10 | Rake $0 
Seat 1: alfredovga (big blind) collected ($0.10)
Seat 2: Eduard Gl folded before Flop (didn't bet)
Seat 3: vodka4fun folded before Flop (didn't bet)
Seat 4: chris2766 folded before Flop (didn't bet)
Seat 5: sAnt1n135 (button) folded before Flop (didn't bet)
Seat 6: aII-in,really? (small blind) folded before Flop



PokerStars Hand #222967800101:  Hold'em No Limit ($0.05/$0.10 USD) - 2021/01/23 14:58:42 ET
Table 'Grus IV' 6-max Seat #6 is the button
Seat 1: alfredovga ($6.78 in chips) 
Seat 2: Eduard Gl ($35 in chips) 
Seat 3: vodka4fun ($22.50 in chips) 
Seat 4: chris2766 ($15.20 in chips) 
Seat 5: sAnt1n135 ($10.26 in chips) 
Seat 6: aII-in,really? ($10 in chips) 
alfredovga: posts small blind $0.05
Eduard Gl: posts big blind $0.10
*** HOLE CARDS ***
vodka4fun: folds 
chris2766: folds 
sAnt1n135: folds 
aII-in,really?: folds 
alfredovga: raises $0.10 to $0.20
Eduard Gl: calls $0.10
*** FLOP *** [Kc 5h As]
alfredovga: bets $0.10
Eduard Gl: folds 
Uncalled bet ($0.10) returned to alfredovga
alfredovga collected $0.38 from pot
alfredovga: doesn't show hand 
*** SUMMARY ***
Total pot $0.40 | Rake $0.02 
Board [Kc 5h As]
Seat 1: alfredovga (small blind) collected ($0.38)
Seat 2: Eduard Gl (big blind) folded on the Flop
Seat 3: vodka4fun folded before Flop (didn't bet)
Seat 4: chris2766 folded before Flop (didn't bet)
Seat 5: sAnt1n135 folded before Flop (didn't bet)
Seat 6: aII-in,really? (button) folded before Flop (didn't bet)



PokerStars Hand #222967814813:  Hold'em No Limit ($0.05/$0.10 USD) - 2021/01/23 14:59:09 ET
Table 'Grus IV' 6-max Seat #1 is the button
Seat 1: alfredovga ($6.96 in chips) 
Seat 2: Eduard Gl ($34.80 in chips) 
Seat 3: vodka4fun ($22.50 in chips) 
Seat 4: chris2766 ($15.20 in chips) 
Seat 5: sAnt1n135 ($10.26 in chips) 
Seat 6: aII-in,really? ($10 in chips) 
Eduard Gl: posts small blind $0.05
vodka4fun: posts big blind $0.10
*** HOLE CARDS ***
chris2766: folds 
sAnt1n135: folds 
aII-in,really?: folds 
alfredovga: folds 
Eduard Gl: raises $0.20 to $0.30
vodka4fun: raises $0.80 to $1.10
Eduard Gl: folds 
Uncalled bet ($0.80) returned to vodka4fun
vodka4fun collected $0.60 from pot
*** SUMMARY ***
Total pot $0.60 | Rake $0 
Seat 1: alfredovga (button) folded before Flop (didn't bet)
Seat 2: Eduard Gl (small blind) folded before Flop
Seat 3: vodka4fun (big blind) collected ($0.60)
Seat 4: chris2766 folded before Flop (didn't bet)
Seat 5: sAnt1n135 folded before Flop (didn't bet)
Seat 6: aII-in,really? folded before Flop (didn't bet)



PokerStars Hand #222967825432:  Hold'em No Limit ($0.05/$0.10 USD) - 2021/01/23 14:59:29 ET
Table 'Grus IV' 6-max Seat #2 is the button
Seat 1: alfredovga ($6.96 in chips) 
Seat 2: Eduard Gl ($34.50 in chips) 
Seat 3: vodka4fun ($22.80 in chips) 
Seat 4: chris2766 ($15.20 in chips) 
Seat 5: sAnt1n135 ($10.26 in chips) 
Seat 6: aII-in,really? ($10 in chips) 
vodka4fun: posts small blind $0.05
chris2766: posts big blind $0.10
*** HOLE CARDS ***
sAnt1n135: folds 
aII-in,really?: folds 
alfredovga: folds 
Eduard Gl: raises $0.10 to $0.20
vodka4fun: raises $0.60 to $0.80
chris2766: folds 
Eduard Gl: calls $0.60
*** FLOP *** [9s 5h 9h]
vodka4fun: checks 
Eduard Gl: bets $0.95
vodka4fun: calls $0.95
*** TURN *** [9s 5h 9h] [7h]
vodka4fun: checks 
Eduard Gl: bets $2.40
vodka4fun: folds 
Uncalled bet ($2.40) returned to Eduard Gl
Eduard Gl collected $3.44 from pot
Eduard Gl: doesn't show hand 
*** SUMMARY ***
Total pot $3.60 | Rake $0.16 
Board [9s 5h 9h 7h]
Seat 1: alfredovga folded before Flop (didn't bet)
Seat 2: Eduard Gl (button) collected ($3.44)
Seat 3: vodka4fun (small blind) folded on the Turn
Seat 4: chris2766 (big blind) folded before Flop
Seat 5: sAnt1n135 folded before Flop (didn't bet)
Seat 6: aII-in,really? folded before Flop (didn't bet)



PokerStars Hand #222967862739:  Hold'em No Limit ($0.05/$0.10 USD) - 2021/01/23 15:00:35 ET
Table 'Grus IV' 6-max Seat #3 is the button
Seat 1: alfredovga ($6.96 in chips) 
Seat 2: Eduard Gl ($36.19 in chips) 
Seat 3: vodka4fun ($21.05 in chips) 
Seat 4: chris2766 ($15.10 in chips) 
Seat 5: sAnt1n135 ($10.26 in chips) 
Seat 6: aII-in,really? ($10 in chips) 
chris2766: posts small blind $0.05
sAnt1n135: posts big blind $0.10
*** HOLE CARDS ***
aII-in,really?: folds 
alfredovga: raises $0.10 to $0.20
Eduard Gl: raises $0.55 to $0.75
vodka4fun: folds 
chris2766: folds 
sAnt1n135: folds 
alfredovga: calls $0.55
*** FLOP *** [Qc 2s Td]
alfredovga: bets $1.60
Eduard Gl: folds 
Uncalled bet ($1.60) returned to alfredovga
alfredovga collected $1.58 from pot
alfredovga: doesn't show hand 
*** SUMMARY ***
Total pot $1.65 | Rake $0.07 
Board [Qc 2s Td]
Seat 1: alfredovga collected ($1.58)
Seat 2: Eduard Gl folded on the Flop
Seat 3: vodka4fun (button) folded before Flop (didn't bet)
Seat 4: chris2766 (small blind) folded before Flop
Seat 5: sAnt1n135 (big blind) folded before Flop
Seat 6: aII-in,really? folded before Flop (didn't bet)



PokerStars Hand #222967877171:  Hold'em No Limit ($0.05/$0.10 USD) - 2021/01/23 15:00:59 ET
Table 'Grus IV' 6-max Seat #4 is the button
Seat 1: alfredovga ($7.79 in chips) 
Seat 2: Eduard Gl ($35.44 in chips) 
Seat 3: vodka4fun ($21.05 in chips) 
Seat 4: chris2766 ($15.05 in chips) 
Seat 5: sAnt1n135 ($10.16 in chips) 
Seat 6: aII-in,really? ($10 in chips) 
sAnt1n135: posts small blind $0.05
aII-in,really?: posts big blind $0.10
*** HOLE CARDS ***
alfredovga: folds 
Eduard Gl: folds 
vodka4fun: folds 
chris2766: raises $0.17 to $0.27
sAnt1n135: raises $0.64 to $0.91
aII-in,really?: folds 
chris2766: calls $0.64
*** FLOP *** [6c Ks Ad]
sAnt1n135: checks 
chris2766: bets $0.80
sAnt1n135: calls $0.80
*** TURN *** [6c Ks Ad] [Ts]
sAnt1n135: checks 
chris2766: checks 
*** RIVER *** [6c Ks Ad Ts] [9d]
sAnt1n135: bets $3.40
chris2766: folds 
Uncalled bet ($3.40) returned to sAnt1n135
sAnt1n135 collected $3.36 from pot
sAnt1n135: doesn't show hand 
*** SUMMARY ***
Total pot $3.52 | Rake $0.16 
Board [6c Ks Ad Ts 9d]
Seat 1: alfredovga folded before Flop (didn't bet)
Seat 2: Eduard Gl folded before Flop (didn't bet)
Seat 3: vodka4fun folded before Flop (didn't bet)
Seat 4: chris2766 (button) folded on the River
Seat 5: sAnt1n135 (small blind) collected ($3.36)
Seat 6: aII-in,really? (big blind) folded before Flop



PokerStars Hand #222967920943:  Hold'em No Limit ($0.05/$0.10 USD) - 2021/01/23 15:01:51 ET
Table 'Grus IV' 6-max Seat #5 is the button
Seat 1: alfredovga ($7.79 in chips) 
Seat 2: Eduard Gl ($35.44 in chips) 
Seat 3: vodka4fun ($21.05 in chips) 
Seat 4: chris2766 ($13.34 in chips) 
Seat 5: sAnt1n135 ($11.81 in chips) 
Seat 6: aII-in,really? ($9.90 in chips) 
aII-in,really?: posts small blind $0.05
alfredovga: posts big blind $0.10
*** HOLE CARDS ***
Eduard Gl: raises $0.20 to $0.30
vodka4fun: raises $0.70 to $1
chris2766: folds 
sAnt1n135: folds 
aII-in,really?: folds 
alfredovga: folds 
Eduard Gl: raises $1.60 to $2.60
vodka4fun: folds 
Uncalled bet ($1.60) returned to Eduard Gl
Eduard Gl collected $2.15 from pot
Eduard Gl: doesn't show hand 
*** SUMMARY ***
Total pot $2.15 | Rake $0 
Seat 1: alfredovga (big blind) folded before Flop
Seat 2: Eduard Gl collected ($2.15)
Seat 3: vodka4fun folded before Flop
Seat 4: chris2766 folded before Flop (didn't bet)
Seat 5: sAnt1n135 (button) folded before Flop (didn't bet)
Seat 6: aII-in,really? (small blind) folded before Flop



PokerStars Hand #222967945918:  Hold'em No Limit ($0.05/$0.10 USD) - 2021/01/23 15:02:24 ET
Table 'Grus IV' 6-max Seat #6 is the button
Seat 1: alfredovga ($7.69 in chips) 
Seat 2: Eduard Gl ($36.59 in chips) 
Seat 3: vodka4fun ($20.05 in chips) 
Seat 4: chris2766 ($13.34 in chips) 
Seat 5: sAnt1n135 ($11.81 in chips) 
Seat 6: aII-in,really? ($10 in chips) 
alfredovga: posts small blind $0.05
Eduard Gl: posts big blind $0.10
*** HOLE CARDS ***
vodka4fun: folds 
chris2766: folds 
sAnt1n135: folds 
aII-in,really?: folds 
alfredovga: folds 
Uncalled bet ($0.05) returned to Eduard Gl
Eduard Gl collected $0.10 from pot
Eduard Gl: doesn't show hand 
*** SUMMARY ***
Total pot $0.10 | Rake $0 
Seat 1: alfredovga (small blind) folded before Flop
Seat 2: Eduard Gl (big blind) collected ($0.10)
Seat 3: vodka4fun folded before Flop (didn't bet)
Seat 4: chris2766 folded before Flop (didn't bet)
Seat 5: sAnt1n135 folded before Flop (didn't bet)
Seat 6: aII-in,really? (button) folded before Flop (didn't bet)



PokerStars Hand #222967959801:  Hold'em No Limit ($0.05/$0.10 USD) - 2021/01/23 15:02:42 ET
Table 'Grus IV' 6-max Seat #1 is the button
Seat 1: alfredovga ($7.64 in chips) 
Seat 2: Eduard Gl ($36.64 in chips) 
Seat 3: vodka4fun ($20.05 in chips) 
Seat 4: chris2766 ($13.34 in chips) 
Seat 5: sAnt1n135 ($11.81 in chips) 
Seat 6: aII-in,really? ($10 in chips) 
Eduard Gl: posts small blind $0.05
vodka4fun: posts big blind $0.10
*** HOLE CARDS ***
chris2766: raises $0.12 to $0.22
sAnt1n135: folds 
aII-in,really?: folds 
alfredovga: folds 
Eduard Gl: folds 
vodka4fun: folds 
Uncalled bet ($0.12) returned to chris2766
chris2766 collected $0.25 from pot
chris2766: doesn't show hand 
*** SUMMARY ***
Total pot $0.25 | Rake $0 
Seat 1: alfredovga (button) folded before Flop (didn't bet)
Seat 2: Eduard Gl (small blind) folded before Flop
Seat 3: vodka4fun (big blind) folded before Flop
Seat 4: chris2766 collected ($0.25)
Seat 5: sAnt1n135 folded before Flop (didn't bet)
Seat 6: aII-in,really? folded before Flop (didn't bet)



PokerStars Hand #222967997092:  Hold'em No Limit ($0.05/$0.10 USD) - 2021/01/23 15:03:28 ET
Table 'Grus IV' 6-max Seat #2 is the button
Seat 1: alfredovga ($7.64 in chips) 
Seat 2: Eduard Gl ($36.59 in chips) 
Seat 3: vodka4fun ($19.95 in chips) 
Seat 4: chris2766 ($13.49 in chips) 
Seat 5: sAnt1n135 ($11.81 in chips) 
Seat 6: aII-in,really? ($10 in chips) 
vodka4fun: posts small blind $0.05
chris2766: posts big blind $0.10
*** HOLE CARDS ***
sAnt1n135: folds 
aII-in,really?: folds 
alfredovga: raises $0.10 to $0.20
Eduard Gl: folds 
vodka4fun: folds 
chris2766: calls $0.10
*** FLOP *** [Ks 2h 9c]
chris2766: checks 
alfredovga: bets $0.40
chris2766: folds 
Uncalled bet ($0.40) returned to alfredovga
alfredovga collected $0.43 from pot
alfredovga: doesn't show hand 
*** SUMMARY ***
Total pot $0.45 | Rake $0.02 
Board [Ks 2h 9c]
Seat 1: alfredovga collected ($0.43)
Seat 2: Eduard Gl (button) folded before Flop (didn't bet)
Seat 3: vodka4fun (small blind) folded before Flop
Seat 4: chris2766 (big blind) folded on the Flop
Seat 5: sAnt1n135 folded before Flop (didn't bet)
Seat 6: aII-in,really? folded before Flop (didn't bet)



PokerStars Hand #222968039499:  Hold'em No Limit ($0.05/$0.10 USD) - 2021/01/23 15:04:20 ET
Table 'Grus IV' 6-max Seat #3 is the button
Seat 1: alfredovga ($7.87 in chips) 
Seat 2: Eduard Gl ($36.59 in chips) 
Seat 3: vodka4fun ($19.90 in chips) 
Seat 4: chris2766 ($13.29 in chips) 
Seat 5: sAnt1n135 ($11.81 in chips) 
Seat 6: aII-in,really? ($10 in chips) 
chris2766: posts small blind $0.05
sAnt1n135: posts big blind $0.10
*** HOLE CARDS ***
aII-in,really?: folds 
alfredovga: raises $0.10 to $0.20
Eduard Gl: folds 
vodka4fun: folds 
chris2766: calls $0.15
sAnt1n135: folds 
*** FLOP *** [Th 5d 3c]
chris2766: checks 
alfredovga: checks 
*** TURN *** [Th 5d 3c] [2s]
chris2766: checks 
alfredovga: checks 
*** RIVER *** [Th 5d 3c 2s] [3d]
chris2766: checks 
alfredovga: checks 
*** SHOW DOWN ***
chris2766: shows [5h Jh] (two pair, Fives and Threes)
alfredovga: mucks hand 
chris2766 collected $0.48 from pot
*** SUMMARY ***
Total pot $0.50 | Rake $0.02 
Board [Th 5d 3c 2s 3d]
Seat 1: alfredovga mucked
Seat 2: Eduard Gl folded before Flop (didn't bet)
Seat 3: vodka4fun (button) folded before Flop (didn't bet)
Seat 4: chris2766 (small blind) showed [5h Jh] and won ($0.48) with two pair, Fives and Threes
Seat 5: sAnt1n135 (big blind) folded before Flop
Seat 6: aII-in,really? folded before Flop (didn't bet)



PokerStars Hand #222968068801:  Hold'em No Limit ($0.05/$0.10 USD) - 2021/01/23 15:04:56 ET
Table 'Grus IV' 6-max Seat #4 is the button
Seat 1: alfredovga ($7.67 in chips) 
Seat 2: Eduard Gl ($36.59 in chips) 
Seat 3: vodka4fun ($19.90 in chips) 
Seat 4: chris2766 ($13.57 in chips) 
Seat 5: sAnt1n135 ($11.71 in chips) 
Seat 6: aII-in,really? ($10 in chips) 
sAnt1n135: posts small blind $0.05
aII-in,really?: posts big blind $0.10
*** HOLE CARDS ***
alfredovga: folds 
Eduard Gl: raises $0.20 to $0.30
vodka4fun: folds 
chris2766: folds 
sAnt1n135: folds 
aII-in,really?: folds 
Uncalled bet ($0.20) returned to Eduard Gl
Eduard Gl collected $0.25 from pot
Eduard Gl: doesn't show hand 
*** SUMMARY ***
Total pot $0.25 | Rake $0 
Seat 1: alfredovga folded before Flop (didn't bet)
Seat 2: Eduard Gl collected ($0.25)
Seat 3: vodka4fun folded before Flop (didn't bet)
Seat 4: chris2766 (button) folded before Flop (didn't bet)
Seat 5: sAnt1n135 (small blind) folded before Flop
Seat 6: aII-in,really? (big blind) folded before Flop



PokerStars Hand #222968082820:  Hold'em No Limit ($0.05/$0.10 USD) - 2021/01/23 15:05:13 ET
Table 'Grus IV' 6-max Seat #5 is the button
Seat 1: alfredovga ($7.67 in chips) 
Seat 2: Eduard Gl ($36.74 in chips) 
Seat 3: vodka4fun ($19.90 in chips) 
Seat 4: chris2766 ($13.57 in chips) 
Seat 5: sAnt1n135 ($11.66 in chips) 
Seat 6: aII-in,really? ($9.90 in chips) 
aII-in,really?: posts small blind $0.05
alfredovga: posts big blind $0.10
*** HOLE CARDS ***
Eduard Gl: folds 
vodka4fun: folds 
chris2766: folds 
sAnt1n135: raises $0.13 to $0.23
aII-in,really?: calls $0.18
alfredovga: folds 
*** FLOP *** [2d 9c Jh]
aII-in,really?: checks 
sAnt1n135: checks 
*** TURN *** [2d 9c Jh] [9h]
aII-in,really?: checks 
chris2766 leaves the table
sAnt1n135: bets $0.30
aII-in,really?: calls $0.30
*** RIVER *** [2d 9c Jh 9h] [3c]
aII-in,really?: checks 
No1Sparkles joins the table at seat #4 
sAnt1n135: checks 
*** SHOW DOWN ***
aII-in,really?: shows [Kc Js] (two pair, Jacks and Nines)
sAnt1n135: mucks hand 
aII-in,really? collected $1.11 from pot
*** SUMMARY ***
Total pot $1.16 | Rake $0.05 
Board [2d 9c Jh 9h 3c]
Seat 1: alfredovga (big blind) folded before Flop
Seat 2: Eduard Gl folded before Flop (didn't bet)
Seat 3: vodka4fun folded before Flop (didn't bet)
Seat 4: chris2766 folded before Flop (didn't bet)
Seat 5: sAnt1n135 (button) mucked
Seat 6: aII-in,really? (small blind) showed [Kc Js] and won ($1.11) with two pair, Jacks and Nines



PokerStars Hand #222968125565:  Hold'em No Limit ($0.05/$0.10 USD) - 2021/01/23 15:06:04 ET
Table 'Grus IV' 6-max Seat #6 is the button
Seat 1: alfredovga ($7.57 in chips) 
Seat 2: Eduard Gl ($36.74 in chips) 
Seat 3: vodka4fun ($19.90 in chips) 
Seat 5: sAnt1n135 ($11.13 in chips) 
Seat 6: aII-in,really? ($10.48 in chips) 
alfredovga: posts small blind $0.05
Eduard Gl: posts big blind $0.10
No1Sparkles: sits out 
*** HOLE CARDS ***
vodka4fun: folds 
sAnt1n135: folds 
aII-in,really?: folds 
alfredovga: folds 
Uncalled bet ($0.05) returned to Eduard Gl
Eduard Gl collected $0.10 from pot
Eduard Gl: doesn't show hand 
*** SUMMARY ***
Total pot $0.10 | Rake $0 
Seat 1: alfredovga (small blind) folded before Flop
Seat 2: Eduard Gl (big blind) collected ($0.10)
Seat 3: vodka4fun folded before Flop (didn't bet)
Seat 5: sAnt1n135 folded before Flop (didn't bet)
Seat 6: aII-in,really? (button) folded before Flop (didn't bet)



PokerStars Hand #222968135685:  Hold'em No Limit ($0.05/$0.10 USD) - 2021/01/23 15:06:16 ET
Table 'Grus IV' 6-max Seat #1 is the button
Seat 1: alfredovga ($7.52 in chips) 
Seat 2: Eduard Gl ($36.79 in chips) 
Seat 3: vodka4fun ($19.90 in chips) 
Seat 5: sAnt1n135 ($11.13 in chips) 
Seat 6: aII-in,really? ($10.48 in chips) 
Eduard Gl: posts small blind $0.05
vodka4fun: posts big blind $0.10
No1Sparkles: sits out 
*** HOLE CARDS ***
sAnt1n135: folds 
aII-in,really?: folds 
alfredovga: folds 
Eduard Gl: calls $0.05
vodka4fun: checks 
*** FLOP *** [6h 7s As]
Eduard Gl: bets $0.10
vodka4fun: folds 
Uncalled bet ($0.10) returned to Eduard Gl
Eduard Gl collected $0.19 from pot
Eduard Gl: doesn't show hand 
*** SUMMARY ***
Total pot $0.20 | Rake $0.01 
Board [6h 7s As]
Seat 1: alfredovga (button) folded before Flop (didn't bet)
Seat 2: Eduard Gl (small blind) collected ($0.19)
Seat 3: vodka4fun (big blind) folded on the Flop
Seat 5: sAnt1n135 folded before Flop (didn't bet)
Seat 6: aII-in,really? folded before Flop (didn't bet)



PokerStars Hand #222968155507:  Hold'em No Limit ($0.05/$0.10 USD) - 2021/01/23 15:06:40 ET
Table 'Grus IV' 6-max Seat #2 is the button
Seat 1: alfredovga ($7.52 in chips) 
Seat 2: Eduard Gl ($36.88 in chips) 
Seat 3: vodka4fun ($19.80 in chips) 
Seat 4: No1Sparkles ($10 in chips) 
Seat 5: sAnt1n135 ($11.13 in chips) 
Seat 6: aII-in,really? ($10.48 in chips) 
vodka4fun: posts small blind $0.05
No1Sparkles: posts big blind $0.10
*** HOLE CARDS ***
sAnt1n135: folds 
aII-in,really?: folds 
alfredovga: folds 
Eduard Gl: raises $0.10 to $0.20
vodka4fun: folds 
No1Sparkles: folds 
Uncalled bet ($0.10) returned to Eduard Gl
Eduard Gl collected $0.25 from pot
Eduard Gl: doesn't show hand 
*** SUMMARY ***
Total pot $0.25 | Rake $0 
Seat 1: alfredovga folded before Flop (didn't bet)
Seat 2: Eduard Gl (button) collected ($0.25)
Seat 3: vodka4fun (small blind) folded before Flop
Seat 4: No1Sparkles (big blind) folded before Flop
Seat 5: sAnt1n135 folded before Flop (didn't bet)
Seat 6: aII-in,really? folded before Flop (didn't bet)



PokerStars Hand #222968170718:  Hold'em No Limit ($0.05/$0.10 USD) - 2021/01/23 15:06:58 ET
Table 'Grus IV' 6-max Seat #3 is the button
Seat 1: alfredovga ($7.52 in chips) 
Seat 2: Eduard Gl ($37.03 in chips) 
Seat 3: vodka4fun ($19.75 in chips) 
Seat 4: No1Sparkles ($10 in chips) 
Seat 5: sAnt1n135 ($11.13 in chips) 
Seat 6: aII-in,really? ($10.48 in chips) 
No1Sparkles: posts small blind $0.05
sAnt1n135: posts big blind $0.10
*** HOLE CARDS ***
aII-in,really?: folds 
alfredovga: raises $0.10 to $0.20
Eduard Gl: folds 
vodka4fun: raises $0.56 to $0.76
No1Sparkles: folds 
sAnt1n135: folds 
alfredovga: calls $0.56
*** FLOP *** [9d Js 7c]
alfredovga: checks 
vodka4fun: checks 
*** TURN *** [9d Js 7c] [4c]
alfredovga: bets $1.60
vodka4fun: calls $1.60
*** RIVER *** [9d Js 7c 4c] [Jc]
alfredovga: bets $4.60
vodka4fun: folds 
Uncalled bet ($4.60) returned to alfredovga
alfredovga collected $4.65 from pot
*** SUMMARY ***
Total pot $4.87 | Rake $0.22 
Board [9d Js 7c 4c Jc]
Seat 1: alfredovga collected ($4.65)
Seat 2: Eduard Gl folded before Flop (didn't bet)
Seat 3: vodka4fun (button) folded on the River
Seat 4: No1Sparkles (small blind) folded before Flop
Seat 5: sAnt1n135 (big blind) folded before Flop
Seat 6: aII-in,really? folded before Flop (didn't bet)



PokerStars Hand #222968200434:  Hold'em No Limit ($0.05/$0.10 USD) - 2021/01/23 15:07:33 ET
Table 'Grus IV' 6-max Seat #4 is the button
Seat 1: alfredovga ($9.81 in chips) 
Seat 2: Eduard Gl ($37.03 in chips) 
Seat 3: vodka4fun ($17.39 in chips) 
Seat 4: No1Sparkles ($10 in chips) 
Seat 5: sAnt1n135 ($11.03 in chips) 
Seat 6: aII-in,really? ($10.48 in chips) 
sAnt1n135: posts small blind $0.05
aII-in,really?: posts big blind $0.10
*** HOLE CARDS ***
alfredovga: calls $0.10
Eduard Gl: folds 
vodka4fun: raises $0.33 to $0.43
No1Sparkles: folds 
sAnt1n135: folds 
aII-in,really?: folds 
alfredovga: calls $0.33
*** FLOP *** [7h 5h 6c]
alfredovga: checks 
vodka4fun: bets $0.77
alfredovga: folds 
Uncalled bet ($0.77) returned to vodka4fun
vodka4fun collected $0.96 from pot
*** SUMMARY ***
Total pot $1.01 | Rake $0.05 
Board [7h 5h 6c]
Seat 1: alfredovga folded on the Flop
Seat 2: Eduard Gl folded before Flop (didn't bet)
Seat 3: vodka4fun collected ($0.96)
Seat 4: No1Sparkles (button) folded before Flop (didn't bet)
Seat 5: sAnt1n135 (small blind) folded before Flop
Seat 6: aII-in,really? (big blind) folded before Flop



PokerStars Hand #222968224558:  Hold'em No Limit ($0.05/$0.10 USD) - 2021/01/23 15:08:02 ET
Table 'Grus IV' 6-max Seat #5 is the button
Seat 1: alfredovga ($9.38 in chips) 
Seat 2: Eduard Gl ($37.03 in chips) 
Seat 3: vodka4fun ($17.92 in chips) 
Seat 4: No1Sparkles ($10 in chips) 
Seat 5: sAnt1n135 ($10.98 in chips) 
Seat 6: aII-in,really? ($10.38 in chips) 
aII-in,really?: posts small blind $0.05
alfredovga: posts big blind $0.10
*** HOLE CARDS ***
Eduard Gl: folds 
vodka4fun: folds 
No1Sparkles: folds 
sAnt1n135: folds 
aII-in,really?: folds 
Uncalled bet ($0.05) returned to alfredovga
alfredovga collected $0.10 from pot
alfredovga: doesn't show hand 
*** SUMMARY ***
Total pot $0.10 | Rake $0 
Seat 1: alfredovga (big blind) collected ($0.10)
Seat 2: Eduard Gl folded before Flop (didn't bet)
Seat 3: vodka4fun folded before Flop (didn't bet)
Seat 4: No1Sparkles folded before Flop (didn't bet)
Seat 5: sAnt1n135 (button) folded before Flop (didn't bet)
Seat 6: aII-in,really? (small blind) folded before Flop



PokerStars Hand #222968243798:  Hold'em No Limit ($0.05/$0.10 USD) - 2021/01/23 15:08:25 ET
Table 'Grus IV' 6-max Seat #6 is the button
Seat 1: alfredovga ($9.43 in chips) 
Seat 2: Eduard Gl ($37.03 in chips) 
Seat 3: vodka4fun ($17.92 in chips) 
Seat 4: No1Sparkles ($10 in chips) 
Seat 5: sAnt1n135 ($10.98 in chips) 
Seat 6: aII-in,really? ($10.33 in chips) 
alfredovga: posts small blind $0.05
Eduard Gl: posts big blind $0.10
*** HOLE CARDS ***
vodka4fun: folds 
No1Sparkles: folds 
sAnt1n135: raises $0.10 to $0.20
aII-in,really?: calls $0.20
alfredovga: calls $0.15
Eduard Gl: calls $0.10
*** FLOP *** [Ks 3h 7d]
alfredovga: checks 
Eduard Gl: checks 
sAnt1n135: checks 
aII-in,really?: checks 
*** TURN *** [Ks 3h 7d] [6s]
alfredovga: checks 
Eduard Gl: checks 
sAnt1n135: checks 
aII-in,really?: bets $0.40
alfredovga: calls $0.40
Eduard Gl: folds 
sAnt1n135: folds 
*** RIVER *** [Ks 3h 7d 6s] [9s]
alfredovga: checks 
aII-in,really?: checks 
*** SHOW DOWN ***
alfredovga: shows [9h 8d] (a pair of Nines)
aII-in,really?: shows [Js Kc] (a pair of Kings)
aII-in,really? collected $1.53 from pot
*** SUMMARY ***
Total pot $1.60 | Rake $0.07 
Board [Ks 3h 7d 6s 9s]
Seat 1: alfredovga (small blind) showed [9h 8d] and lost with a pair of Nines
Seat 2: Eduard Gl (big blind) folded on the Turn
Seat 3: vodka4fun folded before Flop (didn't bet)
Seat 4: No1Sparkles folded before Flop (didn't bet)
Seat 5: sAnt1n135 folded on the Turn
Seat 6: aII-in,really? (button) showed [Js Kc] and won ($1.53) with a pair of Kings



PokerStars Hand #222968287232:  Hold'em No Limit ($0.05/$0.10 USD) - 2021/01/23 15:09:17 ET
Table 'Grus IV' 6-max Seat #1 is the button
Seat 1: alfredovga ($8.83 in chips) 
Seat 2: Eduard Gl ($36.83 in chips) 
Seat 3: vodka4fun ($17.92 in chips) 
Seat 4: No1Sparkles ($10 in chips) 
Seat 5: sAnt1n135 ($10.78 in chips) 
Seat 6: aII-in,really? ($11.26 in chips) 
Eduard Gl: posts small blind $0.05
vodka4fun: posts big blind $0.10
*** HOLE CARDS ***
No1Sparkles: raises $0.20 to $0.30
sAnt1n135: folds 
aII-in,really?: folds 
alfredovga: calls $0.30
Eduard Gl: folds 
vodka4fun: folds 
*** FLOP *** [9h 5h Ad]
No1Sparkles: bets $0.36
alfredovga: calls $0.36
*** TURN *** [9h 5h Ad] [Qh]
No1Sparkles: bets $0.70
alfredovga: calls $0.70
*** RIVER *** [9h 5h Ad Qh] [Jh]
No1Sparkles: checks 
alfredovga: bets $2.70
No1Sparkles: folds 
Uncalled bet ($2.70) returned to alfredovga
alfredovga collected $2.74 from pot
alfredovga: doesn't show hand 
*** SUMMARY ***
Total pot $2.87 | Rake $0.13 
Board [9h 5h Ad Qh Jh]
Seat 1: alfredovga (button) collected ($2.74)
Seat 2: Eduard Gl (small blind) folded before Flop
Seat 3: vodka4fun (big blind) folded before Flop
Seat 4: No1Sparkles folded on the River
Seat 5: sAnt1n135 folded before Flop (didn't bet)
Seat 6: aII-in,really? folded before Flop (didn't bet)



PokerStars Hand #222968331511:  Hold'em No Limit ($0.05/$0.10 USD) - 2021/01/23 15:10:10 ET
Table 'Grus IV' 6-max Seat #2 is the button
Seat 1: alfredovga ($10.21 in chips) 
Seat 2: Eduard Gl ($36.78 in chips) 
Seat 3: vodka4fun ($17.82 in chips) 
Seat 4: No1Sparkles ($10 in chips) 
Seat 5: sAnt1n135 ($10.78 in chips) 
Seat 6: aII-in,really? ($11.26 in chips) 
vodka4fun: posts small blind $0.05
No1Sparkles: posts big blind $0.10
*** HOLE CARDS ***
sAnt1n135: folds 
aII-in,really?: folds 
alfredovga: calls $0.10
Eduard Gl: folds 
vodka4fun: folds 
No1Sparkles: checks 
*** FLOP *** [2s Td As]
No1Sparkles: bets $0.30
alfredovga: calls $0.30
*** TURN *** [2s Td As] [Tc]
No1Sparkles: checks 
alfredovga: checks 
*** RIVER *** [2s Td As Tc] [2c]
No1Sparkles: bets $9.60 and is all-in
alfredovga: folds 
Uncalled bet ($9.60) returned to No1Sparkles
No1Sparkles collected $0.81 from pot
No1Sparkles: doesn't show hand 
*** SUMMARY ***
Total pot $0.85 | Rake $0.04 
Board [2s Td As Tc 2c]
Seat 1: alfredovga folded on the River
Seat 2: Eduard Gl (button) folded before Flop (didn't bet)
Seat 3: vodka4fun (small blind) folded before Flop
Seat 4: No1Sparkles (big blind) collected ($0.81)
Seat 5: sAnt1n135 folded before Flop (didn't bet)
Seat 6: aII-in,really? folded before Flop (didn't bet)



PokerStars Hand #222968365962:  Hold'em No Limit ($0.05/$0.10 USD) - 2021/01/23 15:10:51 ET
Table 'Grus IV' 6-max Seat #3 is the button
Seat 1: alfredovga ($9.81 in chips) 
Seat 2: Eduard Gl ($36.78 in chips) 
Seat 3: vodka4fun ($17.77 in chips) 
Seat 4: No1Sparkles ($10.41 in chips) 
Seat 5: sAnt1n135 ($10.78 in chips) 
Seat 6: aII-in,really? ($11.26 in chips) 
No1Sparkles: posts small blind $0.05
sAnt1n135: posts big blind $0.10
*** HOLE CARDS ***
aII-in,really?: folds 
alfredovga: calls $0.10
Eduard Gl: folds 
vodka4fun: folds 
No1Sparkles: calls $0.05
sAnt1n135: checks 
*** FLOP *** [2h Kd Th]
No1Sparkles: checks 
sAnt1n135: checks 
alfredovga: bets $0.10
No1Sparkles: folds 
sAnt1n135: folds 
Uncalled bet ($0.10) returned to alfredovga
alfredovga collected $0.29 from pot
*** SUMMARY ***
Total pot $0.30 | Rake $0.01 
Board [2h Kd Th]
Seat 1: alfredovga collected ($0.29)
Seat 2: Eduard Gl folded before Flop (didn't bet)
Seat 3: vodka4fun (button) folded before Flop (didn't bet)
Seat 4: No1Sparkles (small blind) folded on the Flop
Seat 5: sAnt1n135 (big blind) folded on the Flop
Seat 6: aII-in,really? folded before Flop (didn't bet)



PokerStars Hand #222968397221:  Hold'em No Limit ($0.05/$0.10 USD) - 2021/01/23 15:11:28 ET
Table 'Grus IV' 6-max Seat #4 is the button
Seat 1: alfredovga ($10 in chips) 
Seat 2: Eduard Gl ($36.78 in chips) 
Seat 3: vodka4fun ($17.77 in chips) 
Seat 4: No1Sparkles ($10.31 in chips) 
Seat 5: sAnt1n135 ($10.68 in chips) 
sAnt1n135: posts small blind $0.05
aII-in,really?: is sitting out 
aII-in,really? leaves the table
alfredovga: posts big blind $0.10
*** HOLE CARDS ***
Eduard Gl: folds 
vodka4fun: folds 
GoodmanAR joins the table at seat #6 
GoodmanAR leaves the table
No1Sparkles: folds 
sAnt1n135: folds 
Uncalled bet ($0.05) returned to alfredovga
alfredovga collected $0.10 from pot
*** SUMMARY ***
Total pot $0.10 | Rake $0 
Seat 1: alfredovga (big blind) collected ($0.10)
Seat 2: Eduard Gl folded before Flop (didn't bet)
Seat 3: vodka4fun folded before Flop (didn't bet)
Seat 4: No1Sparkles (button) folded before Flop (didn't bet)
Seat 5: sAnt1n135 (small blind) folded before Flop



PokerStars Hand #222968406480:  Hold'em No Limit ($0.05/$0.10 USD) - 2021/01/23 15:11:39 ET
Table 'Grus IV' 6-max Seat #5 is the button
Seat 1: alfredovga ($10.05 in chips) 
Seat 2: Eduard Gl ($36.78 in chips) 
Seat 3: vodka4fun ($17.77 in chips) 
Seat 4: No1Sparkles ($10.31 in chips) 
Seat 5: sAnt1n135 ($10.63 in chips) 
alfredovga: posts small blind $0.05
Eduard Gl: posts big blind $0.10
*** HOLE CARDS ***
crnispajdermen joins the table at seat #6 
vodka4fun: folds 
No1Sparkles: folds 
sAnt1n135: folds 
alfredovga: folds 
Uncalled bet ($0.05) returned to Eduard Gl
Eduard Gl collected $0.10 from pot
Eduard Gl: doesn't show hand 
*** SUMMARY ***
Total pot $0.10 | Rake $0 
Seat 1: alfredovga (small blind) folded before Flop
Seat 2: Eduard Gl (big blind) collected ($0.10)
Seat 3: vodka4fun folded before Flop (didn't bet)
Seat 4: No1Sparkles folded before Flop (didn't bet)
Seat 5: sAnt1n135 (button) folded before Flop (didn't bet)



PokerStars Hand #222968414690:  Hold'em No Limit ($0.05/$0.10 USD) - 2021/01/23 15:11:49 ET
Table 'Grus IV' 6-max Seat #1 is the button
Seat 1: alfredovga ($10 in chips) 
Seat 2: Eduard Gl ($36.83 in chips) 
Seat 3: vodka4fun ($17.77 in chips) 
Seat 4: No1Sparkles ($10.31 in chips) 
Seat 5: sAnt1n135 ($10.63 in chips) 
Seat 6: crnispajdermen ($10 in chips) 
Eduard Gl: posts small blind $0.05
vodka4fun: posts big blind $0.10
crnispajdermen: posts big blind $0.10
*** HOLE CARDS ***
No1Sparkles: folds 
sAnt1n135: raises $0.20 to $0.30
crnispajdermen: folds 
alfredovga: folds 
Eduard Gl: folds 
vodka4fun: folds 
Uncalled bet ($0.20) returned to sAnt1n135
sAnt1n135 collected $0.35 from pot
sAnt1n135: doesn't show hand 
*** SUMMARY ***
Total pot $0.35 | Rake $0 
Seat 1: alfredovga (button) folded before Flop (didn't bet)
Seat 2: Eduard Gl (small blind) folded before Flop
Seat 3: vodka4fun (big blind) folded before Flop
Seat 4: No1Sparkles folded before Flop (didn't bet)
Seat 5: sAnt1n135 collected ($0.35)
Seat 6: crnispajdermen folded before Flop (didn't bet)



PokerStars Hand #222968436329:  Hold'em No Limit ($0.05/$0.10 USD) - 2021/01/23 15:12:06 ET
Table 'Grus IV' 6-max Seat #2 is the button
Seat 1: alfredovga ($10 in chips) 
Seat 2: Eduard Gl ($36.78 in chips) 
Seat 3: vodka4fun ($17.67 in chips) 
Seat 4: No1Sparkles ($10.31 in chips) 
Seat 5: sAnt1n135 ($10.88 in chips) 
Seat 6: crnispajdermen ($9.90 in chips) 
vodka4fun: posts small blind $0.05
No1Sparkles: posts big blind $0.10
*** HOLE CARDS ***
sAnt1n135: folds 
crnispajdermen: raises $0.40 to $0.50
alfredovga: folds 
Eduard Gl: folds 
vodka4fun: folds 
No1Sparkles: folds 
Uncalled bet ($0.40) returned to crnispajdermen
crnispajdermen collected $0.25 from pot
crnispajdermen: doesn't show hand 
*** SUMMARY ***
Total pot $0.25 | Rake $0 
Seat 1: alfredovga folded before Flop (didn't bet)
Seat 2: Eduard Gl (button) folded before Flop (didn't bet)
Seat 3: vodka4fun (small blind) folded before Flop
Seat 4: No1Sparkles (big blind) folded before Flop
Seat 5: sAnt1n135 folded before Flop (didn't bet)
Seat 6: crnispajdermen collected ($0.25)



PokerStars Hand #222968467787:  Hold'em No Limit ($0.05/$0.10 USD) - 2021/01/23 15:12:44 ET
Table 'Grus IV' 6-max Seat #3 is the button
Seat 1: alfredovga ($10 in chips) 
Seat 2: Eduard Gl ($36.78 in chips) 
Seat 3: vodka4fun ($17.62 in chips) 
Seat 4: No1Sparkles ($10.21 in chips) 
Seat 5: sAnt1n135 ($10.88 in chips) 
Seat 6: crnispajdermen ($10.05 in chips) 
No1Sparkles: posts small blind $0.05
sAnt1n135: posts big blind $0.10
*** HOLE CARDS ***
crnispajdermen: raises $0.20 to $0.30
alfredovga: calls $0.30
Eduard Gl: folds 
vodka4fun: folds 
No1Sparkles: calls $0.25
sAnt1n135: folds 
*** FLOP *** [Qs 9c As]
No1Sparkles: checks 
crnispajdermen: checks 
alfredovga: bets $1
No1Sparkles: folds 
crnispajdermen: folds 
Uncalled bet ($1) returned to alfredovga
alfredovga collected $0.96 from pot
*** SUMMARY ***
Total pot $1 | Rake $0.04 
Board [Qs 9c As]
Seat 1: alfredovga collected ($0.96)
Seat 2: Eduard Gl folded before Flop (didn't bet)
Seat 3: vodka4fun (button) folded before Flop (didn't bet)
Seat 4: No1Sparkles (small blind) folded on the Flop
Seat 5: sAnt1n135 (big blind) folded before Flop
Seat 6: crnispajdermen folded on the Flop



PokerStars Hand #222968509256:  Hold'em No Limit ($0.05/$0.10 USD) - 2021/01/23 15:13:33 ET
Table 'Grus IV' 6-max Seat #4 is the button
Seat 1: alfredovga ($10.66 in chips) 
Seat 2: Eduard Gl ($36.78 in chips) 
Seat 3: vodka4fun ($17.62 in chips) 
Seat 4: No1Sparkles ($10 in chips) 
Seat 5: sAnt1n135 ($10.78 in chips) 
Seat 6: crnispajdermen ($9.75 in chips) 
sAnt1n135: posts small blind $0.05
crnispajdermen: posts big blind $0.10
*** HOLE CARDS ***
alfredovga: folds 
Eduard Gl: raises $0.20 to $0.30
vodka4fun: folds 
No1Sparkles: folds 
sAnt1n135: folds 
crnispajdermen: folds 
Uncalled bet ($0.20) returned to Eduard Gl
Eduard Gl collected $0.25 from pot
Eduard Gl: doesn't show hand 
*** SUMMARY ***
Total pot $0.25 | Rake $0 
Seat 1: alfredovga folded before Flop (didn't bet)
Seat 2: Eduard Gl collected ($0.25)
Seat 3: vodka4fun folded before Flop (didn't bet)
Seat 4: No1Sparkles (button) folded before Flop (didn't bet)
Seat 5: sAnt1n135 (small blind) folded before Flop
Seat 6: crnispajdermen (big blind) folded before Flop



PokerStars Hand #222968521524:  Hold'em No Limit ($0.05/$0.10 USD) - 2021/01/23 15:13:48 ET
Table 'Grus IV' 6-max Seat #5 is the button
Seat 1: alfredovga ($10.66 in chips) 
Seat 2: Eduard Gl ($36.93 in chips) 
Seat 3: vodka4fun ($17.62 in chips) 
Seat 4: No1Sparkles ($10 in chips) 
Seat 5: sAnt1n135 ($10.73 in chips) 
Seat 6: crnispajdermen ($9.65 in chips) 
crnispajdermen: posts small blind $0.05
alfredovga: posts big blind $0.10
*** HOLE CARDS ***
Eduard Gl: raises $0.20 to $0.30
vodka4fun: raises $0.70 to $1
No1Sparkles: folds 
sAnt1n135: folds 
crnispajdermen: folds 
alfredovga: folds 
Eduard Gl: calls $0.70
*** FLOP *** [6h Th 5s]
Eduard Gl: bets $1.03
vodka4fun: folds 
Uncalled bet ($1.03) returned to Eduard Gl
Eduard Gl collected $2.05 from pot
Eduard Gl: doesn't show hand 
*** SUMMARY ***
Total pot $2.15 | Rake $0.10 
Board [6h Th 5s]
Seat 1: alfredovga (big blind) folded before Flop
Seat 2: Eduard Gl collected ($2.05)
Seat 3: vodka4fun folded on the Flop
Seat 4: No1Sparkles folded before Flop (didn't bet)
Seat 5: sAnt1n135 (button) folded before Flop (didn't bet)
Seat 6: crnispajdermen (small blind) folded before Flop



PokerStars Hand #222968562489:  Hold'em No Limit ($0.05/$0.10 USD) - 2021/01/23 15:14:37 ET
Table 'Grus IV' 6-max Seat #6 is the button
Seat 1: alfredovga ($10.56 in chips) 
Seat 2: Eduard Gl ($37.98 in chips) 
Seat 3: vodka4fun ($16.62 in chips) 
Seat 4: No1Sparkles ($10 in chips) 
Seat 5: sAnt1n135 ($10.73 in chips) 
Seat 6: crnispajdermen ($9.60 in chips) 
alfredovga: posts small blind $0.05
Eduard Gl: posts big blind $0.10
*** HOLE CARDS ***
vodka4fun: raises $0.20 to $0.30
No1Sparkles: folds 
sAnt1n135: folds 
crnispajdermen: calls $0.30
alfredovga: folds 
Eduard Gl: folds 
*** FLOP *** [Kh Jh 3s]
vodka4fun: bets $0.40
crnispajdermen: calls $0.40
*** TURN *** [Kh Jh 3s] [4d]
vodka4fun: checks 
crnispajdermen: checks 
*** RIVER *** [Kh Jh 3s 4d] [5h]
vodka4fun: checks 
crnispajdermen: bets $1.48
vodka4fun: folds 
Uncalled bet ($1.48) returned to crnispajdermen
crnispajdermen collected $1.48 from pot
crnispajdermen: doesn't show hand 
*** SUMMARY ***
Total pot $1.55 | Rake $0.07 
Board [Kh Jh 3s 4d 5h]
Seat 1: alfredovga (small blind) folded before Flop
Seat 2: Eduard Gl (big blind) folded before Flop
Seat 3: vodka4fun folded on the River
Seat 4: No1Sparkles folded before Flop (didn't bet)
Seat 5: sAnt1n135 folded before Flop (didn't bet)
Seat 6: crnispajdermen (button) collected ($1.48)



PokerStars Hand #222968624313:  Hold'em No Limit ($0.05/$0.10 USD) - 2021/01/23 15:15:49 ET
Table 'Grus IV' 6-max Seat #1 is the button
Seat 1: alfredovga ($10.51 in chips) 
Seat 2: Eduard Gl ($37.88 in chips) 
Seat 3: vodka4fun ($15.92 in chips) 
Seat 4: No1Sparkles ($10 in chips) 
Seat 5: sAnt1n135 ($10.73 in chips) 
Seat 6: crnispajdermen ($10.38 in chips) 
Eduard Gl: posts small blind $0.05
vodka4fun: posts big blind $0.10
*** HOLE CARDS ***
No1Sparkles: folds 
sAnt1n135: folds 
crnispajdermen: raises $0.20 to $0.30
alfredovga: calls $0.30
Eduard Gl: raises $1.10 to $1.40
vodka4fun: folds 
crnispajdermen: calls $1.10
alfredovga: folds 
*** FLOP *** [6d 2s 4c]
Eduard Gl: bets $2.40
crnispajdermen: raises $6.58 to $8.98 and is all-in
Eduard Gl: calls $6.58
*** TURN *** [6d 2s 4c] [6c]
*** RIVER *** [6d 2s 4c 6c] [9h]
*** SHOW DOWN ***
Eduard Gl: shows [Kh Kd] (two pair, Kings and Sixes)
crnispajdermen: shows [2d 2c] (a full house, Deuces full of Sixes)
crnispajdermen collected $20.21 from pot
Eduard Gl cashed out the hand for $2.01 | Cash Out Fee $0.02
*** SUMMARY ***
Total pot $21.16 | Rake $0.95 
Board [6d 2s 4c 6c 9h]
Seat 1: alfredovga (button) folded before Flop
Seat 2: Eduard Gl (small blind) showed [Kh Kd] and lost with two pair, Kings and Sixes (cashed out).
Seat 3: vodka4fun (big blind) folded before Flop
Seat 4: No1Sparkles folded before Flop (didn't bet)
Seat 5: sAnt1n135 folded before Flop (didn't bet)
Seat 6: crnispajdermen showed [2d 2c] and won ($20.21) with a full house, Deuces full of Sixes



PokerStars Hand #222968660517:  Hold'em No Limit ($0.05/$0.10 USD) - 2021/01/23 15:16:32 ET
Table 'Grus IV' 6-max Seat #2 is the button
Seat 1: alfredovga ($10.21 in chips) 
Seat 2: Eduard Gl ($29.51 in chips) 
Seat 3: vodka4fun ($15.82 in chips) 
Seat 4: No1Sparkles ($10 in chips) 
Seat 5: sAnt1n135 ($10.73 in chips) 
Seat 6: crnispajdermen ($20.21 in chips) 
vodka4fun: posts small blind $0.05
No1Sparkles: posts big blind $0.10
*** HOLE CARDS ***
sAnt1n135: folds 
crnispajdermen: folds 
alfredovga: calls $0.10
Eduard Gl: raises $0.50 to $0.60
vodka4fun: folds 
No1Sparkles: folds 
alfredovga: calls $0.50
*** FLOP *** [Jc Ks Ad]
alfredovga: checks 
Eduard Gl: bets $0.90
alfredovga: calls $0.90
*** TURN *** [Jc Ks Ad] [9d]
crnispajdermen leaves the table
alfredovga: checks 
Eduard Gl: checks 
*** RIVER *** [Jc Ks Ad 9d] [5s]
alfredovga: checks 
Eduard Gl: checks 
*** SHOW DOWN ***
alfredovga: shows [Qh 4h] (high card Ace)
Eduard Gl: shows [Kh 8h] (a pair of Kings)
Eduard Gl collected $3.01 from pot
*** SUMMARY ***
Total pot $3.15 | Rake $0.14 
Board [Jc Ks Ad 9d 5s]
Seat 1: alfredovga showed [Qh 4h] and lost with high card Ace
Seat 2: Eduard Gl (button) showed [Kh 8h] and won ($3.01) with a pair of Kings
Seat 3: vodka4fun (small blind) folded before Flop
Seat 4: No1Sparkles (big blind) folded before Flop
Seat 5: sAnt1n135 folded before Flop (didn't bet)
Seat 6: crnispajdermen folded before Flop (didn't bet)



PokerStars Hand #222968700134:  Hold'em No Limit ($0.05/$0.10 USD) - 2021/01/23 15:17:18 ET
Table 'Grus IV' 6-max Seat #3 is the button
Seat 1: alfredovga ($8.71 in chips) 
Seat 2: Eduard Gl ($31.02 in chips) 
Seat 3: vodka4fun ($15.77 in chips) 
Seat 4: No1Sparkles ($10 in chips) 
Seat 5: sAnt1n135 ($10.73 in chips) 
No1Sparkles: posts small blind $0.05
sAnt1n135: posts big blind $0.10
*** HOLE CARDS ***
alfredovga: folds 
Eduard Gl: raises $0.20 to $0.30
vodka4fun: raises $0.70 to $1
Mikseruga joins the table at seat #6 
No1Sparkles: folds 
sAnt1n135: folds 
Eduard Gl: folds 
Uncalled bet ($0.70) returned to vodka4fun
vodka4fun collected $0.75 from pot
*** SUMMARY ***
Total pot $0.75 | Rake $0 
Seat 1: alfredovga folded before Flop (didn't bet)
Seat 2: Eduard Gl folded before Flop
Seat 3: vodka4fun (button) collected ($0.75)
Seat 4: No1Sparkles (small blind) folded before Flop
Seat 5: sAnt1n135 (big blind) folded before Flop



PokerStars Hand #222968711566:  Hold'em No Limit ($0.05/$0.10 USD) - 2021/01/23 15:17:31 ET
Table 'Grus IV' 6-max Seat #4 is the button
Seat 1: alfredovga ($8.71 in chips) 
Seat 2: Eduard Gl ($30.72 in chips) 
Seat 3: vodka4fun ($16.22 in chips) 
Seat 4: No1Sparkles ($10 in chips) 
Seat 5: sAnt1n135 ($10.63 in chips) 
Seat 6: Mikseruga ($4 in chips) 
sAnt1n135: posts small blind $0.05
Mikseruga: posts big blind $0.10
*** HOLE CARDS ***
alfredovga: raises $0.10 to $0.20
Eduard Gl: folds 
vodka4fun: raises $0.56 to $0.76
No1Sparkles: folds 
sAnt1n135: folds 
Mikseruga: folds 
alfredovga: calls $0.56
*** FLOP *** [5h 2c 9d]
alfredovga: checks 
vodka4fun: bets $1.07
alfredovga: folds 
Uncalled bet ($1.07) returned to vodka4fun
vodka4fun collected $1.59 from pot
*** SUMMARY ***
Total pot $1.67 | Rake $0.08 
Board [5h 2c 9d]
Seat 1: alfredovga folded on the Flop
Seat 2: Eduard Gl folded before Flop (didn't bet)
Seat 3: vodka4fun collected ($1.59)
Seat 4: No1Sparkles (button) folded before Flop (didn't bet)
Seat 5: sAnt1n135 (small blind) folded before Flop
Seat 6: Mikseruga (big blind) folded before Flop



PokerStars Hand #222968731398:  Hold'em No Limit ($0.05/$0.10 USD) - 2021/01/23 15:17:55 ET
Table 'Grus IV' 6-max Seat #5 is the button
Seat 1: alfredovga ($7.95 in chips) 
Seat 2: Eduard Gl ($30.72 in chips) 
Seat 3: vodka4fun ($17.05 in chips) 
Seat 4: No1Sparkles ($10 in chips) 
Seat 5: sAnt1n135 ($10.58 in chips) 
Seat 6: Mikseruga ($3.90 in chips) 
Mikseruga: posts small blind $0.05
alfredovga: posts big blind $0.10
*** HOLE CARDS ***
Eduard Gl: folds 
vodka4fun: folds 
No1Sparkles: folds 
sAnt1n135: folds 
Mikseruga: folds 
Uncalled bet ($0.05) returned to alfredovga
alfredovga collected $0.10 from pot
alfredovga: doesn't show hand 
*** SUMMARY ***
Total pot $0.10 | Rake $0 
Seat 1: alfredovga (big blind) collected ($0.10)
Seat 2: Eduard Gl folded before Flop (didn't bet)
Seat 3: vodka4fun folded before Flop (didn't bet)
Seat 4: No1Sparkles folded before Flop (didn't bet)
Seat 5: sAnt1n135 (button) folded before Flop (didn't bet)
Seat 6: Mikseruga (small blind) folded before Flop



PokerStars Hand #222968739121:  Hold'em No Limit ($0.05/$0.10 USD) - 2021/01/23 15:18:04 ET
Table 'Grus IV' 6-max Seat #6 is the button
Seat 1: alfredovga ($8 in chips) 
Seat 2: Eduard Gl ($30.72 in chips) 
Seat 3: vodka4fun ($17.05 in chips) 
Seat 4: No1Sparkles ($10 in chips) 
Seat 5: sAnt1n135 ($10.58 in chips) 
Seat 6: Mikseruga ($3.85 in chips) 
alfredovga: posts small blind $0.05
Eduard Gl: posts big blind $0.10
*** HOLE CARDS ***
vodka4fun: folds 
No1Sparkles: folds 
sAnt1n135: raises $0.20 to $0.30
Mikseruga: folds 
alfredovga: calls $0.25
Eduard Gl: folds 
*** FLOP *** [8h 9s Ad]
alfredovga: checks 
sAnt1n135: bets $0.40
alfredovga: calls $0.40
*** TURN *** [8h 9s Ad] [4c]
alfredovga: checks 
sAnt1n135: checks 
*** RIVER *** [8h 9s Ad 4c] [6s]
alfredovga: checks 
sAnt1n135: bets $1.07
alfredovga: folds 
Uncalled bet ($1.07) returned to sAnt1n135
sAnt1n135 collected $1.43 from pot
sAnt1n135: doesn't show hand 
*** SUMMARY ***
Total pot $1.50 | Rake $0.07 
Board [8h 9s Ad 4c 6s]
Seat 1: alfredovga (small blind) folded on the River
Seat 2: Eduard Gl (big blind) folded before Flop
Seat 3: vodka4fun folded before Flop (didn't bet)
Seat 4: No1Sparkles folded before Flop (didn't bet)
Seat 5: sAnt1n135 collected ($1.43)
Seat 6: Mikseruga (button) folded before Flop (didn't bet)



PokerStars Hand #222968774071:  Hold'em No Limit ($0.05/$0.10 USD) - 2021/01/23 15:18:45 ET
Table 'Grus IV' 6-max Seat #1 is the button
Seat 1: alfredovga ($7.30 in chips) 
Seat 2: Eduard Gl ($30.62 in chips) 
Seat 4: No1Sparkles ($10 in chips) 
Seat 5: sAnt1n135 ($11.31 in chips) 
Seat 6: Mikseruga ($3.85 in chips) 
Eduard Gl: posts small blind $0.05
vodka4fun: is sitting out 
No1Sparkles: posts big blind $0.10
*** HOLE CARDS ***
sAnt1n135: folds 
Mikseruga: folds 
alfredovga: calls $0.10
Eduard Gl: folds 
No1Sparkles: checks 
*** FLOP *** [2d As Kh]
No1Sparkles: checks 
alfredovga: bets $0.10
No1Sparkles: folds 
Uncalled bet ($0.10) returned to alfredovga
alfredovga collected $0.24 from pot
alfredovga: doesn't show hand 
*** SUMMARY ***
Total pot $0.25 | Rake $0.01 
Board [2d As Kh]
Seat 1: alfredovga (button) collected ($0.24)
Seat 2: Eduard Gl (small blind) folded before Flop
Seat 4: No1Sparkles (big blind) folded on the Flop
Seat 5: sAnt1n135 folded before Flop (didn't bet)
Seat 6: Mikseruga folded before Flop (didn't bet)



PokerStars Hand #222968797524:  Hold'em No Limit ($0.05/$0.10 USD) - 2021/01/23 15:19:12 ET
Table 'Grus IV' 6-max Seat #2 is the button
Seat 1: alfredovga ($7.44 in chips) 
Seat 2: Eduard Gl ($30.57 in chips) 
Seat 4: No1Sparkles ($10 in chips) 
Seat 5: sAnt1n135 ($11.31 in chips) 
Seat 6: Mikseruga ($3.85 in chips) 
No1Sparkles: posts small blind $0.05
sAnt1n135: posts big blind $0.10
*** HOLE CARDS ***
Mikseruga: folds 
alfredovga: raises $0.10 to $0.20
Eduard Gl: folds 
No1Sparkles: folds 
sAnt1n135: folds 
Uncalled bet ($0.10) returned to alfredovga
alfredovga collected $0.25 from pot
*** SUMMARY ***
Total pot $0.25 | Rake $0 
Seat 1: alfredovga collected ($0.25)
Seat 2: Eduard Gl (button) folded before Flop (didn't bet)
Seat 4: No1Sparkles (small blind) folded before Flop
Seat 5: sAnt1n135 (big blind) folded before Flop
Seat 6: Mikseruga folded before Flop (didn't bet)



PokerStars Hand #222968809771:  Hold'em No Limit ($0.05/$0.10 USD) - 2021/01/23 15:19:27 ET
Table 'Grus IV' 6-max Seat #4 is the button
Seat 1: alfredovga ($7.59 in chips) 
Seat 2: Eduard Gl ($30.57 in chips) 
Seat 4: No1Sparkles ($10 in chips) 
Seat 5: sAnt1n135 ($11.21 in chips) 
Seat 6: Mikseruga ($3.85 in chips) 
sAnt1n135: posts small blind $0.05
Mikseruga: posts big blind $0.10
*** HOLE CARDS ***
alfredovga: raises $0.10 to $0.20
Eduard Gl: folds 
No1Sparkles: raises $0.10 to $0.30
sAnt1n135: folds 
Mikseruga: folds 
alfredovga: raises $0.10 to $0.40
No1Sparkles: calls $0.10
*** FLOP *** [8d Kh Qs]
alfredovga: bets $0.90
No1Sparkles: folds 
Uncalled bet ($0.90) returned to alfredovga
alfredovga collected $0.91 from pot
alfredovga: doesn't show hand 
*** SUMMARY ***
Total pot $0.95 | Rake $0.04 
Board [8d Kh Qs]
Seat 1: alfredovga collected ($0.91)
Seat 2: Eduard Gl folded before Flop (didn't bet)
Seat 4: No1Sparkles (button) folded on the Flop
Seat 5: sAnt1n135 (small blind) folded before Flop
Seat 6: Mikseruga (big blind) folded before Flop



PokerStars Hand #222968831534:  Hold'em No Limit ($0.05/$0.10 USD) - 2021/01/23 15:19:52 ET
Table 'Grus IV' 6-max Seat #5 is the button
Seat 1: alfredovga ($8.10 in chips) 
Seat 2: Eduard Gl ($30.57 in chips) 
Seat 4: No1Sparkles ($10 in chips) 
Seat 5: sAnt1n135 ($11.16 in chips) 
Seat 6: Mikseruga ($3.75 in chips) 
Mikseruga: posts small blind $0.05
alfredovga: posts big blind $0.10
vodka4fun: sits out 
*** HOLE CARDS ***
Eduard Gl: folds 
No1Sparkles: folds 
sAnt1n135: raises $0.13 to $0.23
Mikseruga: calls $0.18
alfredovga: raises $0.69 to $0.92
sAnt1n135: folds 
Mikseruga: folds 
Uncalled bet ($0.69) returned to alfredovga
alfredovga collected $0.69 from pot
alfredovga: doesn't show hand 
*** SUMMARY ***
Total pot $0.69 | Rake $0 
Seat 1: alfredovga (big blind) collected ($0.69)
Seat 2: Eduard Gl folded before Flop (didn't bet)
Seat 4: No1Sparkles folded before Flop (didn't bet)
Seat 5: sAnt1n135 (button) folded before Flop
Seat 6: Mikseruga (small blind) folded before Flop



PokerStars Hand #222968857467:  Hold'em No Limit ($0.05/$0.10 USD) - 2021/01/23 15:20:22 ET
Table 'Grus IV' 6-max Seat #6 is the button
Seat 1: alfredovga ($8.56 in chips) 
Seat 2: Eduard Gl ($30.57 in chips) 
Seat 4: No1Sparkles ($10 in chips) 
Seat 5: sAnt1n135 ($10.93 in chips) 
Seat 6: Mikseruga ($3.52 in chips) 
alfredovga: posts small blind $0.05
Eduard Gl: posts big blind $0.10
vodka4fun: sits out 
*** HOLE CARDS ***
No1Sparkles: folds 
sAnt1n135: folds 
Mikseruga: folds 
alfredovga: calls $0.05
Eduard Gl: checks 
*** FLOP *** [As 3d 5c]
alfredovga: bets $0.20
Eduard Gl: calls $0.20
*** TURN *** [As 3d 5c] [Td]
alfredovga: bets $0.30
Eduard Gl: folds 
Uncalled bet ($0.30) returned to alfredovga
alfredovga collected $0.57 from pot
alfredovga: doesn't show hand 
*** SUMMARY ***
Total pot $0.60 | Rake $0.03 
Board [As 3d 5c Td]
Seat 1: alfredovga (small blind) collected ($0.57)
Seat 2: Eduard Gl (big blind) folded on the Turn
Seat 4: No1Sparkles folded before Flop (didn't bet)
Seat 5: sAnt1n135 folded before Flop (didn't bet)
Seat 6: Mikseruga (button) folded before Flop (didn't bet)



PokerStars Hand #222968883287:  Hold'em No Limit ($0.05/$0.10 USD) - 2021/01/23 15:20:52 ET
Table 'Grus IV' 6-max Seat #1 is the button
Seat 1: alfredovga ($8.83 in chips) 
Seat 2: Eduard Gl ($30.27 in chips) 
Seat 3: vodka4fun ($17.05 in chips) 
Seat 4: No1Sparkles ($10 in chips) 
Seat 5: sAnt1n135 ($10.93 in chips) 
Seat 6: Mikseruga ($3.52 in chips) 
Eduard Gl: posts small blind $0.05
vodka4fun: posts big blind $0.10
*** HOLE CARDS ***
No1Sparkles: folds 
sAnt1n135: raises $0.20 to $0.30
Mikseruga: folds 
alfredovga: calls $0.30
Eduard Gl: folds 
vodka4fun: calls $0.20
*** FLOP *** [9s 5s Ks]
vodka4fun: checks 
sAnt1n135: checks 
alfredovga: checks 
*** TURN *** [9s 5s Ks] [2c]
vodka4fun: bets $0.73
sAnt1n135: folds 
alfredovga: folds 
Uncalled bet ($0.73) returned to vodka4fun
vodka4fun collected $0.91 from pot
*** SUMMARY ***
Total pot $0.95 | Rake $0.04 
Board [9s 5s Ks 2c]
Seat 1: alfredovga (button) folded on the Turn
Seat 2: Eduard Gl (small blind) folded before Flop
Seat 3: vodka4fun (big blind) collected ($0.91)
Seat 4: No1Sparkles folded before Flop (didn't bet)
Seat 5: sAnt1n135 folded on the Turn
Seat 6: Mikseruga folded before Flop (didn't bet)



PokerStars Hand #222968910843:  Hold'em No Limit ($0.05/$0.10 USD) - 2021/01/23 15:21:24 ET
Table 'Grus IV' 6-max Seat #2 is the button
Seat 1: alfredovga ($8.53 in chips) 
Seat 2: Eduard Gl ($30.22 in chips) 
Seat 3: vodka4fun ($17.66 in chips) 
Seat 4: No1Sparkles ($10 in chips) 
Seat 5: sAnt1n135 ($10.63 in chips) 
Seat 6: Mikseruga ($3.52 in chips) 
vodka4fun: posts small blind $0.05
No1Sparkles: posts big blind $0.10
*** HOLE CARDS ***
sAnt1n135: folds 
Mikseruga: folds 
alfredovga: folds 
Eduard Gl: raises $0.10 to $0.20
vodka4fun: folds 
No1Sparkles: calls $0.10
*** FLOP *** [9h 4c 2c]
No1Sparkles: checks 
Eduard Gl: bets $0.30
No1Sparkles: calls $0.30
*** TURN *** [9h 4c 2c] [Ad]
No1Sparkles: checks 
Eduard Gl: checks 
*** RIVER *** [9h 4c 2c Ad] [Qh]
No1Sparkles: bets $0.66
Eduard Gl: calls $0.66
*** SHOW DOWN ***
No1Sparkles: shows [Jh As] (a pair of Aces)
Eduard Gl: mucks hand 
No1Sparkles collected $2.26 from pot
*** SUMMARY ***
Total pot $2.37 | Rake $0.11 
Board [9h 4c 2c Ad Qh]
Seat 1: alfredovga folded before Flop (didn't bet)
Seat 2: Eduard Gl (button) mucked
Seat 3: vodka4fun (small blind) folded before Flop
Seat 4: No1Sparkles (big blind) showed [Jh As] and won ($2.26) with a pair of Aces
Seat 5: sAnt1n135 folded before Flop (didn't bet)
Seat 6: Mikseruga folded before Flop (didn't bet)



PokerStars Hand #222968944900:  Hold'em No Limit ($0.05/$0.10 USD) - 2021/01/23 15:22:04 ET
Table 'Grus IV' 6-max Seat #3 is the button
Seat 1: alfredovga ($8.53 in chips) 
Seat 2: Eduard Gl ($29.06 in chips) 
Seat 3: vodka4fun ($17.61 in chips) 
Seat 4: No1Sparkles ($11.10 in chips) 
Seat 5: sAnt1n135 ($10.63 in chips) 
Seat 6: Mikseruga ($3.52 in chips) 
No1Sparkles: posts small blind $0.05
sAnt1n135: posts big blind $0.10
*** HOLE CARDS ***
Mikseruga: raises $0.20 to $0.30
alfredovga: folds 
Eduard Gl: folds 
vodka4fun: folds 
No1Sparkles: folds 
sAnt1n135: folds 
Uncalled bet ($0.20) returned to Mikseruga
Mikseruga collected $0.25 from pot
Mikseruga: doesn't show hand 
*** SUMMARY ***
Total pot $0.25 | Rake $0 
Seat 1: alfredovga folded before Flop (didn't bet)
Seat 2: Eduard Gl folded before Flop (didn't bet)
Seat 3: vodka4fun (button) folded before Flop (didn't bet)
Seat 4: No1Sparkles (small blind) folded before Flop
Seat 5: sAnt1n135 (big blind) folded before Flop
Seat 6: Mikseruga collected ($0.25)



PokerStars Hand #222968969860:  Hold'em No Limit ($0.05/$0.10 USD) - 2021/01/23 15:22:32 ET
Table 'Grus IV' 6-max Seat #4 is the button
Seat 1: alfredovga ($8.53 in chips) 
Seat 2: Eduard Gl ($29.06 in chips) 
Seat 3: vodka4fun ($17.61 in chips) 
Seat 4: No1Sparkles ($11.05 in chips) 
Seat 5: sAnt1n135 ($10.53 in chips) 
Seat 6: Mikseruga ($3.67 in chips) 
sAnt1n135: posts small blind $0.05
Mikseruga: posts big blind $0.10
*** HOLE CARDS ***
alfredovga: folds 
Eduard Gl: folds 
vodka4fun: folds 
No1Sparkles: folds 
sAnt1n135: folds 
Uncalled bet ($0.05) returned to Mikseruga
Mikseruga collected $0.10 from pot
Mikseruga: doesn't show hand 
*** SUMMARY ***
Total pot $0.10 | Rake $0 
Seat 1: alfredovga folded before Flop (didn't bet)
Seat 2: Eduard Gl folded before Flop (didn't bet)
Seat 3: vodka4fun folded before Flop (didn't bet)
Seat 4: No1Sparkles (button) folded before Flop (didn't bet)
Seat 5: sAnt1n135 (small blind) folded before Flop
Seat 6: Mikseruga (big blind) collected ($0.10)



PokerStars Hand #222968983012:  Hold'em No Limit ($0.05/$0.10 USD) - 2021/01/23 15:22:48 ET
Table 'Grus IV' 6-max Seat #5 is the button
Seat 1: alfredovga ($8.53 in chips) 
Seat 2: Eduard Gl ($29.06 in chips) 
Seat 3: vodka4fun ($17.61 in chips) 
Seat 4: No1Sparkles ($11.05 in chips) 
Seat 5: sAnt1n135 ($10.48 in chips) 
Seat 6: Mikseruga ($3.72 in chips) 
Mikseruga: posts small blind $0.05
alfredovga: posts big blind $0.10
*** HOLE CARDS ***
Eduard Gl: folds 
vodka4fun: folds 
No1Sparkles: folds 
sAnt1n135: folds 
Mikseruga: raises $0.20 to $0.30
alfredovga: folds 
Uncalled bet ($0.20) returned to Mikseruga
Mikseruga collected $0.20 from pot
Mikseruga: doesn't show hand 
*** SUMMARY ***
Total pot $0.20 | Rake $0 
Seat 1: alfredovga (big blind) folded before Flop
Seat 2: Eduard Gl folded before Flop (didn't bet)
Seat 3: vodka4fun folded before Flop (didn't bet)
Seat 4: No1Sparkles folded before Flop (didn't bet)
Seat 5: sAnt1n135 (button) folded before Flop (didn't bet)
Seat 6: Mikseruga (small blind) collected ($0.20)



PokerStars Hand #222969000839:  Hold'em No Limit ($0.05/$0.10 USD) - 2021/01/23 15:23:08 ET
Table 'Grus IV' 6-max Seat #6 is the button
Seat 1: alfredovga ($8.43 in chips) 
Seat 2: Eduard Gl ($29.06 in chips) 
Seat 3: vodka4fun ($17.61 in chips) 
Seat 4: No1Sparkles ($11.05 in chips) 
Seat 5: sAnt1n135 ($10.48 in chips) 
Seat 6: Mikseruga ($3.82 in chips) 
alfredovga: posts small blind $0.05
Eduard Gl: posts big blind $0.10
*** HOLE CARDS ***
vodka4fun: folds 
No1Sparkles has timed out
No1Sparkles: folds 
sAnt1n135: folds 
Mikseruga: raises $0.10 to $0.20
alfredovga: raises $0.10 to $0.30
Eduard Gl: folds 
Mikseruga: calls $0.10
*** FLOP *** [Tc 9d Js]
alfredovga: bets $0.70
Mikseruga: calls $0.70
*** TURN *** [Tc 9d Js] [8d]
alfredovga: bets $2
Mikseruga: raises $0.82 to $2.82 and is all-in
alfredovga: calls $0.82
*** RIVER *** [Tc 9d Js 8d] [6d]
*** SHOW DOWN ***
alfredovga: shows [Th Ad] (a pair of Tens)
Mikseruga: shows [Jc Ah] (a pair of Jacks)
Mikseruga collected $7.39 from pot
*** SUMMARY ***
Total pot $7.74 | Rake $0.35 
Board [Tc 9d Js 8d 6d]
Seat 1: alfredovga (small blind) showed [Th Ad] and lost with a pair of Tens
Seat 2: Eduard Gl (big blind) folded before Flop
Seat 3: vodka4fun folded before Flop (didn't bet)
Seat 4: No1Sparkles folded before Flop (didn't bet)
Seat 5: sAnt1n135 folded before Flop (didn't bet)
Seat 6: Mikseruga (button) showed [Jc Ah] and won ($7.39) with a pair of Jacks



PokerStars Hand #222969049536:  Hold'em No Limit ($0.05/$0.10 USD) - 2021/01/23 15:24:05 ET
Table 'Grus IV' 6-max Seat #1 is the button
Seat 1: alfredovga ($4.61 in chips) 
Seat 2: Eduard Gl ($28.96 in chips) 
Seat 3: vodka4fun ($17.61 in chips) 
Seat 5: sAnt1n135 ($10.48 in chips) 
Seat 6: Mikseruga ($7.39 in chips) 
Eduard Gl: posts small blind $0.05
vodka4fun: posts big blind $0.10
*** HOLE CARDS ***
sAnt1n135: raises $0.20 to $0.30
Mikseruga: folds 
alfredovga: raises $0.20 to $0.50
Eduard Gl: folds 
vodka4fun: folds 
sAnt1n135: raises $1.15 to $1.65
alfredovga: calls $1.15
*** FLOP *** [6h 4d 5h]
sAnt1n135: checks 
alfredovga: bets $2.96 and is all-in
sAnt1n135: calls $2.96
*** TURN *** [6h 4d 5h] [7c]
*** RIVER *** [6h 4d 5h 7c] [2s]
*** SHOW DOWN ***
sAnt1n135: shows [Kc Ac] (high card Ace)
alfredovga: shows [9h Jc] (high card Jack)
sAnt1n135 collected $8.95 from pot
*** SUMMARY ***
Total pot $9.37 | Rake $0.42 
Board [6h 4d 5h 7c 2s]
Seat 1: alfredovga (button) showed [9h Jc] and lost with high card Jack
Seat 2: Eduard Gl (small blind) folded before Flop
Seat 3: vodka4fun (big blind) folded before Flop
Seat 5: sAnt1n135 showed [Kc Ac] and won ($8.95) with high card Ace
Seat 6: Mikseruga folded before Flop (didn't bet)



PokerStars Hand #222969094824:  Hold'em No Limit ($0.05/$0.10 USD) - 2021/01/23 15:24:58 ET
Table 'Grus IV' 6-max Seat #2 is the button
Seat 2: Eduard Gl ($28.91 in chips) 
Seat 3: vodka4fun ($17.51 in chips) 
Seat 5: sAnt1n135 ($14.82 in chips) 
Seat 6: Mikseruga ($7.39 in chips) 
vodka4fun: posts small blind $0.05
sAnt1n135: posts big blind $0.10
*** HOLE CARDS ***
Mikseruga: folds 
Eduard Gl: folds 
alfredovga leaves the table
vodka4fun: raises $0.17 to $0.27
sAnt1n135: raises $0.54 to $0.81
vodka4fun: calls $0.54
*** FLOP *** [Qh Ad 9d]
vodka4fun: checks 
sAnt1n135: checks 
*** TURN *** [Qh Ad 9d] [4d]
Mikseruga leaves the table
vodka4fun: checks 
Sobir.S joins the table at seat #1 
sAnt1n135: bets $0.90
vodka4fun: calls $0.90
*** RIVER *** [Qh Ad 9d 4d] [Qd]
clasicos joins the table at seat #6 
vodka4fun: checks 
sAnt1n135: checks 
*** SHOW DOWN ***
vodka4fun: shows [8s As] (two pair, Aces and Queens)
sAnt1n135: shows [Jd Kh] (a flush, Ace high)
sAnt1n135 collected $3.27 from pot
*** SUMMARY ***
Total pot $3.42 | Rake $0.15 
Board [Qh Ad 9d 4d Qd]
Seat 2: Eduard Gl (button) folded before Flop (didn't bet)
Seat 3: vodka4fun (small blind) showed [8s As] and lost with two pair, Aces and Queens
Seat 5: sAnt1n135 (big blind) showed [Jd Kh] and won ($3.27) with a flush, Ace high
Seat 6: Mikseruga folded before Flop (didn't bet)



PokerStars Hand #222969132587:  Hold'em No Limit ($0.05/$0.10 USD) - 2021/01/23 15:25:42 ET
Table 'Grus IV' 6-max Seat #3 is the button
Seat 1: Sobir.S ($10 in chips) 
Seat 2: Eduard Gl ($28.91 in chips) 
Seat 3: vodka4fun ($15.80 in chips) 
Seat 5: sAnt1n135 ($16.38 in chips) 
Seat 6: clasicos ($10 in chips) 
sAnt1n135: posts small blind $0.05
clasicos: posts big blind $0.10
Sobir.S: posts big blind $0.10
*** HOLE CARDS ***
Sobir.S: checks 
Eduard Gl: folds 
vodka4fun: folds 
sAnt1n135: folds 
clasicos: checks 
*** FLOP *** [4s 9d 9s]
clasicos: checks 
Sobir.S: checks 
*** TURN *** [4s 9d 9s] [Ts]
clasicos: checks 
Sobir.S: bets $0.10
clasicos: raises $0.15 to $0.25
Sobir.S: folds 
Uncalled bet ($0.15) returned to clasicos
clasicos collected $0.43 from pot
clasicos: doesn't show hand 
*** SUMMARY ***
Total pot $0.45 | Rake $0.02 
Board [4s 9d 9s Ts]
Seat 1: Sobir.S folded on the Turn
Seat 2: Eduard Gl folded before Flop (didn't bet)
Seat 3: vodka4fun (button) folded before Flop (didn't bet)
Seat 5: sAnt1n135 (small blind) folded before Flop
Seat 6: clasicos (big blind) collected ($0.43)



PokerStars Hand #222969163456:  Hold'em No Limit ($0.05/$0.10 USD) - 2021/01/23 15:26:18 ET
Table 'Grus IV' 6-max Seat #5 is the button
Seat 1: Sobir.S ($9.80 in chips) 
Seat 2: Eduard Gl ($28.91 in chips) 
Seat 3: vodka4fun ($15.80 in chips) 
Seat 5: sAnt1n135 ($16.33 in chips) 
Seat 6: clasicos ($10.23 in chips) 
clasicos: posts small blind $0.05
Sobir.S: posts big blind $0.10
No1Sparkles: sits out 
*** HOLE CARDS ***
Eduard Gl: folds 
vodka4fun: raises $0.20 to $0.30
sAnt1n135: folds 
clasicos: folds 
Sobir.S: folds 
Uncalled bet ($0.20) returned to vodka4fun
vodka4fun collected $0.25 from pot
*** SUMMARY ***
Total pot $0.25 | Rake $0 
Seat 1: Sobir.S (big blind) folded before Flop
Seat 2: Eduard Gl folded before Flop (didn't bet)
Seat 3: vodka4fun collected ($0.25)
Seat 5: sAnt1n135 (button) folded before Flop (didn't bet)
Seat 6: clasicos (small blind) folded before Flop



PokerStars Hand #222969174409:  Hold'em No Limit ($0.05/$0.10 USD) - 2021/01/23 15:26:30 ET
Table 'Grus IV' 6-max Seat #6 is the button
Seat 1: Sobir.S ($9.70 in chips) 
Seat 2: Eduard Gl ($28.91 in chips) 
Seat 3: vodka4fun ($15.95 in chips) 
Seat 5: sAnt1n135 ($16.33 in chips) 
Seat 6: clasicos ($10.18 in chips) 
Sobir.S: posts small blind $0.05
Eduard Gl: posts big blind $0.10
No1Sparkles: sits out 
*** HOLE CARDS ***
vodka4fun: folds 
sAnt1n135: folds 
clasicos: raises $0.15 to $0.25
Sobir.S: calls $0.20
Eduard Gl: calls $0.15
*** FLOP *** [Td 3s 6c]
Sobir.S: checks 
Eduard Gl: bets $0.45
clasicos: folds 
Sobir.S: raises $0.75 to $1.20
Eduard Gl: folds 
Uncalled bet ($0.75) returned to Sobir.S
Sobir.S collected $1.58 from pot
*** SUMMARY ***
Total pot $1.65 | Rake $0.07 
Board [Td 3s 6c]
Seat 1: Sobir.S (small blind) collected ($1.58)
Seat 2: Eduard Gl (big blind) folded on the Flop
Seat 3: vodka4fun folded before Flop (didn't bet)
Seat 5: sAnt1n135 folded before Flop (didn't bet)
Seat 6: clasicos (button) folded on the Flop



PokerStars Hand #222969202237:  Hold'em No Limit ($0.05/$0.10 USD) - 2021/01/23 15:27:03 ET
Table 'Grus IV' 6-max Seat #1 is the button
Seat 1: Sobir.S ($10.58 in chips) 
Seat 2: Eduard Gl ($28.21 in chips) 
Seat 3: vodka4fun ($15.95 in chips) 
Seat 5: sAnt1n135 ($16.33 in chips) 
Seat 6: clasicos ($9.93 in chips) 
Eduard Gl: posts small blind $0.05
vodka4fun: posts big blind $0.10
No1Sparkles: sits out 
*** HOLE CARDS ***
sAnt1n135: folds 
clasicos: folds 
Sobir.S: folds 
Eduard Gl: raises $0.20 to $0.30
vodka4fun: calls $0.20
*** FLOP *** [7c Qh 6c]
Eduard Gl: checks 
vodka4fun: checks 
*** TURN *** [7c Qh 6c] [Ad]
Eduard Gl: bets $0.30
vodka4fun: calls $0.30
*** RIVER *** [7c Qh 6c Ad] [4d]
Eduard Gl: checks 
vodka4fun: checks 
*** SHOW DOWN ***
Eduard Gl: shows [Tc Js] (high card Ace)
vodka4fun: shows [Jc Qs] (a pair of Queens)
vodka4fun collected $1.15 from pot
*** SUMMARY ***
Total pot $1.20 | Rake $0.05 
Board [7c Qh 6c Ad 4d]
Seat 1: Sobir.S (button) folded before Flop (didn't bet)
Seat 2: Eduard Gl (small blind) showed [Tc Js] and lost with high card Ace
Seat 3: vodka4fun (big blind) showed [Jc Qs] and won ($1.15) with a pair of Queens
Seat 5: sAnt1n135 folded before Flop (didn't bet)
Seat 6: clasicos folded before Flop (didn't bet)



PokerStars Hand #222969256768:  Hold'em No Limit ($0.05/$0.10 USD) - 2021/01/23 15:28:07 ET
Table 'Grus IV' 6-max Seat #2 is the button
Seat 1: Sobir.S ($10.58 in chips) 
Seat 2: Eduard Gl ($27.61 in chips) 
Seat 3: vodka4fun ($16.50 in chips) 
Seat 4: No1Sparkles ($11.05 in chips) 
Seat 5: sAnt1n135 ($16.33 in chips) 
Seat 6: clasicos ($9.93 in chips) 
vodka4fun: posts small blind $0.05
No1Sparkles: posts big blind $0.10
*** HOLE CARDS ***
sAnt1n135: folds 
clasicos: folds 
Sobir.S: folds 
Eduard Gl: raises $0.10 to $0.20
vodka4fun: raises $0.60 to $0.80
No1Sparkles: folds 
Eduard Gl: calls $0.60
*** FLOP *** [2c Jd Ad]
vodka4fun: checks 
Eduard Gl: checks 
*** TURN *** [2c Jd Ad] [9c]
vodka4fun: bets $0.90
Eduard Gl: folds 
Uncalled bet ($0.90) returned to vodka4fun
vodka4fun collected $1.62 from pot
*** SUMMARY ***
Total pot $1.70 | Rake $0.08 
Board [2c Jd Ad 9c]
Seat 1: Sobir.S folded before Flop (didn't bet)
Seat 2: Eduard Gl (button) folded on the Turn
Seat 3: vodka4fun (small blind) collected ($1.62)
Seat 4: No1Sparkles (big blind) folded before Flop
Seat 5: sAnt1n135 folded before Flop (didn't bet)
Seat 6: clasicos folded before Flop (didn't bet)



PokerStars Hand #222969292211:  Hold'em No Limit ($0.05/$0.10 USD) - 2021/01/23 15:28:48 ET
Table 'Grus IV' 6-max Seat #3 is the button
Seat 1: Sobir.S ($10.58 in chips) 
Seat 2: Eduard Gl ($26.81 in chips) 
Seat 3: vodka4fun ($17.32 in chips) 
Seat 4: No1Sparkles ($10.95 in chips) 
Seat 5: sAnt1n135 ($16.33 in chips) 
Seat 6: clasicos ($9.93 in chips) 
No1Sparkles: posts small blind $0.05
sAnt1n135: posts big blind $0.10
*** HOLE CARDS ***
clasicos: raises $0.20 to $0.30
Sobir.S: folds 
Eduard Gl: folds 
vodka4fun: folds 
No1Sparkles: folds 
sAnt1n135: folds 
Uncalled bet ($0.20) returned to clasicos
clasicos collected $0.25 from pot
clasicos: doesn't show hand 
*** SUMMARY ***
Total pot $0.25 | Rake $0 
Seat 1: Sobir.S folded before Flop (didn't bet)
Seat 2: Eduard Gl folded before Flop (didn't bet)
Seat 3: vodka4fun (button) folded before Flop (didn't bet)
Seat 4: No1Sparkles (small blind) folded before Flop
Seat 5: sAnt1n135 (big blind) folded before Flop
Seat 6: clasicos collected ($0.25)



PokerStars Hand #222969309804:  Hold'em No Limit ($0.05/$0.10 USD) - 2021/01/23 15:29:08 ET
Table 'Grus IV' 6-max Seat #4 is the button
Seat 1: Sobir.S ($10.58 in chips) 
Seat 2: Eduard Gl ($26.81 in chips) 
Seat 3: vodka4fun ($17.32 in chips) 
Seat 4: No1Sparkles ($10.90 in chips) 
Seat 5: sAnt1n135 ($16.23 in chips) 
Seat 6: clasicos ($10.08 in chips) 
sAnt1n135: posts small blind $0.05
clasicos: posts big blind $0.10
*** HOLE CARDS ***
Sobir.S: raises $0.20 to $0.30
Eduard Gl: folds 
vodka4fun: calls $0.30
No1Sparkles: folds 
sAnt1n135: folds 
clasicos: folds 
*** FLOP *** [5s 2c 5h]
Sobir.S: bets $0.48
vodka4fun: calls $0.48
*** TURN *** [5s 2c 5h] [Qd]
Sobir.S: bets $1.09
vodka4fun: folds 
Uncalled bet ($1.09) returned to Sobir.S
Sobir.S collected $1.63 from pot
*** SUMMARY ***
Total pot $1.71 | Rake $0.08 
Board [5s 2c 5h Qd]
Seat 1: Sobir.S collected ($1.63)
Seat 2: Eduard Gl folded before Flop (didn't bet)
Seat 3: vodka4fun folded on the Turn
Seat 4: No1Sparkles (button) folded before Flop (didn't bet)
Seat 5: sAnt1n135 (small blind) folded before Flop
Seat 6: clasicos (big blind) folded before Flop



PokerStars Hand #222969351064:  Hold'em No Limit ($0.05/$0.10 USD) - 2021/01/23 15:29:57 ET
Table 'Grus IV' 6-max Seat #5 is the button
Seat 1: Sobir.S ($11.43 in chips) 
Seat 2: Eduard Gl ($26.81 in chips) 
Seat 3: vodka4fun ($16.54 in chips) 
Seat 4: No1Sparkles ($10.90 in chips) 
Seat 5: sAnt1n135 ($16.18 in chips) 
Seat 6: clasicos ($9.98 in chips) 
clasicos: posts small blind $0.05
Sobir.S: posts big blind $0.10
*** HOLE CARDS ***
Eduard Gl: folds 
vodka4fun: folds 
No1Sparkles: raises $0.20 to $0.30
sAnt1n135: folds 
clasicos: folds 
Sobir.S: folds 
Uncalled bet ($0.20) returned to No1Sparkles
No1Sparkles collected $0.25 from pot
No1Sparkles: doesn't show hand 
*** SUMMARY ***
Total pot $0.25 | Rake $0 
Seat 1: Sobir.S (big blind) folded before Flop
Seat 2: Eduard Gl folded before Flop (didn't bet)
Seat 3: vodka4fun folded before Flop (didn't bet)
Seat 4: No1Sparkles collected ($0.25)
Seat 5: sAnt1n135 (button) folded before Flop (didn't bet)
Seat 6: clasicos (small blind) folded before Flop



PokerStars Hand #222969372361:  Hold'em No Limit ($0.05/$0.10 USD) - 2021/01/23 15:30:20 ET
Table 'Grus IV' 6-max Seat #6 is the button
Seat 1: Sobir.S ($11.33 in chips) 
Seat 2: Eduard Gl ($26.81 in chips) 
Seat 3: vodka4fun ($16.54 in chips) 
Seat 4: No1Sparkles ($11.05 in chips) 
Seat 5: sAnt1n135 ($16.18 in chips) 
Seat 6: clasicos ($9.93 in chips) 
Sobir.S: posts small blind $0.05
Eduard Gl: posts big blind $0.10
*** HOLE CARDS ***
vodka4fun: folds 
No1Sparkles: folds 
sAnt1n135: folds 
clasicos: raises $0.15 to $0.25
Sobir.S: folds 
Eduard Gl: calls $0.15
*** FLOP *** [7h 2c 3s]
Eduard Gl: checks 
clasicos: checks 
*** TURN *** [7h 2c 3s] [Kd]
Eduard Gl: bets $0.40
clasicos: calls $0.40
*** RIVER *** [7h 2c 3s Kd] [6h]
Eduard Gl: bets $0.95
clasicos: calls $0.95
*** SHOW DOWN ***
Eduard Gl: shows [5c 4s] (a straight, Three to Seven)
clasicos: mucks hand 
Eduard Gl collected $3.10 from pot
*** SUMMARY ***
Total pot $3.25 | Rake $0.15 
Board [7h 2c 3s Kd 6h]
Seat 1: Sobir.S (small blind) folded before Flop
Seat 2: Eduard Gl (big blind) showed [5c 4s] and won ($3.10) with a straight, Three to Seven
Seat 3: vodka4fun folded before Flop (didn't bet)
Seat 4: No1Sparkles folded before Flop (didn't bet)
Seat 5: sAnt1n135 folded before Flop (didn't bet)
Seat 6: clasicos (button) mucked



PokerStars Hand #222969420627:  Hold'em No Limit ($0.05/$0.10 USD) - 2021/01/23 15:31:05 ET
Table 'Grus IV' 6-max Seat #1 is the button
Seat 1: Sobir.S ($11.28 in chips) 
Seat 2: Eduard Gl ($28.31 in chips) 
Seat 3: vodka4fun ($16.54 in chips) 
Seat 4: No1Sparkles ($11.05 in chips) 
Seat 5: sAnt1n135 ($16.18 in chips) 
Seat 6: clasicos ($10 in chips) 
Eduard Gl: posts small blind $0.05
vodka4fun: posts big blind $0.10
*** HOLE CARDS ***
No1Sparkles: folds 
sAnt1n135: raises $0.20 to $0.30
clasicos: folds 
Sobir.S: folds 
Eduard Gl: folds 
vodka4fun: calls $0.20
*** FLOP *** [Ks As 6c]
vodka4fun: checks 
sAnt1n135: bets $0.30
vodka4fun: folds 
Uncalled bet ($0.30) returned to sAnt1n135
sAnt1n135 collected $0.62 from pot
sAnt1n135: doesn't show hand 
*** SUMMARY ***
Total pot $0.65 | Rake $0.03 
Board [Ks As 6c]
Seat 1: Sobir.S (button) folded before Flop (didn't bet)
Seat 2: Eduard Gl (small blind) folded before Flop
Seat 3: vodka4fun (big blind) folded on the Flop
Seat 4: No1Sparkles folded before Flop (didn't bet)
Seat 5: sAnt1n135 collected ($0.62)
Seat 6: clasicos folded before Flop (didn't bet)



PokerStars Hand #222969440514:  Hold'em No Limit ($0.05/$0.10 USD) - 2021/01/23 15:31:27 ET
Table 'Grus IV' 6-max Seat #2 is the button
Seat 1: Sobir.S ($11.28 in chips) 
Seat 2: Eduard Gl ($28.26 in chips) 
Seat 3: vodka4fun ($16.24 in chips) 
Seat 4: No1Sparkles ($11.05 in chips) 
Seat 5: sAnt1n135 ($16.50 in chips) 
Seat 6: clasicos ($10 in chips) 
vodka4fun: posts small blind $0.05
No1Sparkles: posts big blind $0.10
*** HOLE CARDS ***
sAnt1n135: folds 
clasicos: folds 
Sobir.S: folds 
Eduard Gl: raises $0.10 to $0.20
vodka4fun: raises $0.50 to $0.70
No1Sparkles: folds 
Eduard Gl: folds 
Uncalled bet ($0.50) returned to vodka4fun
vodka4fun collected $0.50 from pot
*** SUMMARY ***
Total pot $0.50 | Rake $0 
Seat 1: Sobir.S folded before Flop (didn't bet)
Seat 2: Eduard Gl (button) folded before Flop
Seat 3: vodka4fun (small blind) collected ($0.50)
Seat 4: No1Sparkles (big blind) folded before Flop
Seat 5: sAnt1n135 folded before Flop (didn't bet)
Seat 6: clasicos folded before Flop (didn't bet)



PokerStars Hand #222969462180:  Hold'em No Limit ($0.05/$0.10 USD) - 2021/01/23 15:31:52 ET
Table 'Grus IV' 6-max Seat #3 is the button
Seat 1: Sobir.S ($11.28 in chips) 
Seat 2: Eduard Gl ($28.06 in chips) 
Seat 3: vodka4fun ($16.54 in chips) 
Seat 4: No1Sparkles ($10.95 in chips) 
Seat 5: sAnt1n135 ($16.50 in chips) 
Seat 6: clasicos ($10 in chips) 
No1Sparkles: posts small blind $0.05
sAnt1n135: posts big blind $0.10
*** HOLE CARDS ***
clasicos: folds 
Sobir.S: folds 
Eduard Gl: folds 
vodka4fun: folds 
No1Sparkles: folds 
Uncalled bet ($0.05) returned to sAnt1n135
sAnt1n135 collected $0.10 from pot
sAnt1n135: doesn't show hand 
*** SUMMARY ***
Total pot $0.10 | Rake $0 
Seat 1: Sobir.S folded before Flop (didn't bet)
Seat 2: Eduard Gl folded before Flop (didn't bet)
Seat 3: vodka4fun (button) folded before Flop (didn't bet)
Seat 4: No1Sparkles (small blind) folded before Flop
Seat 5: sAnt1n135 (big blind) collected ($0.10)
Seat 6: clasicos folded before Flop (didn't bet)



PokerStars Hand #222969472635:  Hold'em No Limit ($0.05/$0.10 USD) - 2021/01/23 15:32:04 ET
Table 'Grus IV' 6-max Seat #4 is the button
Seat 1: Sobir.S ($11.28 in chips) 
Seat 2: Eduard Gl ($28.06 in chips) 
Seat 3: vodka4fun ($16.54 in chips) 
Seat 4: No1Sparkles ($10.90 in chips) 
Seat 5: sAnt1n135 ($16.55 in chips) 
Seat 6: clasicos ($10 in chips) 
sAnt1n135: posts small blind $0.05
clasicos: posts big blind $0.10
*** HOLE CARDS ***
Sobir.S: folds 
Eduard Gl: folds 
vodka4fun: raises $0.20 to $0.30
No1Sparkles: folds 
sAnt1n135: folds 
clasicos: folds 
Uncalled bet ($0.20) returned to vodka4fun
vodka4fun collected $0.25 from pot
*** SUMMARY ***
Total pot $0.25 | Rake $0 
Seat 1: Sobir.S folded before Flop (didn't bet)
Seat 2: Eduard Gl folded before Flop (didn't bet)
Seat 3: vodka4fun collected ($0.25)
Seat 4: No1Sparkles (button) folded before Flop (didn't bet)
Seat 5: sAnt1n135 (small blind) folded before Flop
Seat 6: clasicos (big blind) folded before Flop



PokerStars Hand #222969481801:  Hold'em No Limit ($0.05/$0.10 USD) - 2021/01/23 15:32:14 ET
Table 'Grus IV' 6-max Seat #5 is the button
Seat 1: Sobir.S ($11.28 in chips) 
Seat 2: Eduard Gl ($28.06 in chips) 
Seat 3: vodka4fun ($16.69 in chips) 
Seat 4: No1Sparkles ($10.90 in chips) 
Seat 5: sAnt1n135 ($16.50 in chips) 
Seat 6: clasicos ($9.90 in chips) 
clasicos: posts small blind $0.05
Sobir.S: posts big blind $0.10
*** HOLE CARDS ***
Eduard Gl: folds 
vodka4fun: folds 
No1Sparkles: folds 
sAnt1n135: raises $0.13 to $0.23
clasicos: folds 
Sobir.S: folds 
Uncalled bet ($0.13) returned to sAnt1n135
sAnt1n135 collected $0.25 from pot
sAnt1n135: doesn't show hand 
*** SUMMARY ***
Total pot $0.25 | Rake $0 
Seat 1: Sobir.S (big blind) folded before Flop
Seat 2: Eduard Gl folded before Flop (didn't bet)
Seat 3: vodka4fun folded before Flop (didn't bet)
Seat 4: No1Sparkles folded before Flop (didn't bet)
Seat 5: sAnt1n135 (button) collected ($0.25)
Seat 6: clasicos (small blind) folded before Flop



PokerStars Hand #222969495559:  Hold'em No Limit ($0.05/$0.10 USD) - 2021/01/23 15:32:30 ET
Table 'Grus IV' 6-max Seat #6 is the button
Seat 1: Sobir.S ($11.18 in chips) 
Seat 2: Eduard Gl ($28.06 in chips) 
Seat 3: vodka4fun ($16.69 in chips) 
Seat 4: No1Sparkles ($10.90 in chips) 
Seat 5: sAnt1n135 ($16.65 in chips) 
Seat 6: clasicos ($9.85 in chips) 
Sobir.S: posts small blind $0.05
Eduard Gl: posts big blind $0.10
*** HOLE CARDS ***
vodka4fun: folds 
No1Sparkles: folds 
sAnt1n135: folds 
clasicos: raises $0.10 to $0.20
Sobir.S: folds 
Eduard Gl: raises $0.70 to $0.90
clasicos: calls $0.70
*** FLOP *** [8c Qs 4s]
Eduard Gl: bets $1.15
clasicos: raises $4.07 to $5.22
Eduard Gl: folds 
Uncalled bet ($4.07) returned to clasicos
clasicos collected $3.96 from pot
clasicos: doesn't show hand 
*** SUMMARY ***
Total pot $4.15 | Rake $0.19 
Board [8c Qs 4s]
Seat 1: Sobir.S (small blind) folded before Flop
Seat 2: Eduard Gl (big blind) folded on the Flop
Seat 3: vodka4fun folded before Flop (didn't bet)
Seat 4: No1Sparkles folded before Flop (didn't bet)
Seat 5: sAnt1n135 folded before Flop (didn't bet)
Seat 6: clasicos (button) collected ($3.96)



PokerStars Hand #222969528866:  Hold'em No Limit ($0.05/$0.10 USD) - 2021/01/23 15:33:09 ET
Table 'Grus IV' 6-max Seat #1 is the button
Seat 1: Sobir.S ($11.13 in chips) 
Seat 2: Eduard Gl ($26.01 in chips) 
Seat 3: vodka4fun ($16.69 in chips) 
Seat 4: No1Sparkles ($10.90 in chips) 
Seat 5: sAnt1n135 ($16.65 in chips) 
Seat 6: clasicos ($11.76 in chips) 
Eduard Gl: posts small blind $0.05
vodka4fun: posts big blind $0.10
*** HOLE CARDS ***
No1Sparkles: folds 
sAnt1n135: folds 
clasicos: folds 
Sobir.S: folds 
Eduard Gl: raises $0.15 to $0.25
vodka4fun: calls $0.15
*** FLOP *** [Ac Qd 6c]
Eduard Gl: checks 
vodka4fun: checks 
*** TURN *** [Ac Qd 6c] [Ah]
Eduard Gl: checks 
vodka4fun: bets $0.38
Eduard Gl: folds 
Uncalled bet ($0.38) returned to vodka4fun
vodka4fun collected $0.48 from pot
*** SUMMARY ***
Total pot $0.50 | Rake $0.02 
Board [Ac Qd 6c Ah]
Seat 1: Sobir.S (button) folded before Flop (didn't bet)
Seat 2: Eduard Gl (small blind) folded on the Turn
Seat 3: vodka4fun (big blind) collected ($0.48)
Seat 4: No1Sparkles folded before Flop (didn't bet)
Seat 5: sAnt1n135 folded before Flop (didn't bet)
Seat 6: clasicos folded before Flop (didn't bet)



PokerStars Hand #222969576417:  Hold'em No Limit ($0.05/$0.10 USD) - 2021/01/23 15:34:05 ET
Table 'Grus IV' 6-max Seat #2 is the button
Seat 1: Sobir.S ($11.13 in chips) 
Seat 2: Eduard Gl ($25.76 in chips) 
Seat 3: vodka4fun ($16.92 in chips) 
Seat 4: No1Sparkles ($10.90 in chips) 
Seat 5: sAnt1n135 ($16.65 in chips) 
Seat 6: clasicos ($11.76 in chips) 
vodka4fun: posts small blind $0.05
No1Sparkles: posts big blind $0.10
*** HOLE CARDS ***
sAnt1n135: folds 
clasicos: raises $0.20 to $0.30
Sobir.S: folds 
Eduard Gl: folds 
vodka4fun: folds 
No1Sparkles: folds 
Uncalled bet ($0.20) returned to clasicos
clasicos collected $0.25 from pot
clasicos: doesn't show hand 
*** SUMMARY ***
Total pot $0.25 | Rake $0 
Seat 1: Sobir.S folded before Flop (didn't bet)
Seat 2: Eduard Gl (button) folded before Flop (didn't bet)
Seat 3: vodka4fun (small blind) folded before Flop
Seat 4: No1Sparkles (big blind) folded before Flop
Seat 5: sAnt1n135 folded before Flop (didn't bet)
Seat 6: clasicos collected ($0.25)



PokerStars Hand #222969593798:  Hold'em No Limit ($0.05/$0.10 USD) - 2021/01/23 15:34:25 ET
Table 'Grus IV' 6-max Seat #3 is the button
Seat 1: Sobir.S ($11.13 in chips) 
Seat 2: Eduard Gl ($25.76 in chips) 
Seat 3: vodka4fun ($16.87 in chips) 
Seat 4: No1Sparkles ($10.80 in chips) 
Seat 5: sAnt1n135 ($16.65 in chips) 
Seat 6: clasicos ($11.91 in chips) 
No1Sparkles: posts small blind $0.05
sAnt1n135: posts big blind $0.10
*** HOLE CARDS ***
clasicos: folds 
Sobir.S: folds 
Eduard Gl: folds 
vodka4fun: raises $0.20 to $0.30
No1Sparkles: folds 
sAnt1n135: folds 
Uncalled bet ($0.20) returned to vodka4fun
vodka4fun collected $0.25 from pot
*** SUMMARY ***
Total pot $0.25 | Rake $0 
Seat 1: Sobir.S folded before Flop (didn't bet)
Seat 2: Eduard Gl folded before Flop (didn't bet)
Seat 3: vodka4fun (button) collected ($0.25)
Seat 4: No1Sparkles (small blind) folded before Flop
Seat 5: sAnt1n135 (big blind) folded before Flop
Seat 6: clasicos folded before Flop (didn't bet)



PokerStars Hand #222969614386:  Hold'em No Limit ($0.05/$0.10 USD) - 2021/01/23 15:34:49 ET
Table 'Grus IV' 6-max Seat #4 is the button
Seat 1: Sobir.S ($11.13 in chips) 
Seat 2: Eduard Gl ($25.76 in chips) 
Seat 3: vodka4fun ($17.02 in chips) 
Seat 4: No1Sparkles ($10.75 in chips) 
Seat 5: sAnt1n135 ($16.55 in chips) 
Seat 6: clasicos ($11.91 in chips) 
sAnt1n135: posts small blind $0.05
clasicos: posts big blind $0.10
*** HOLE CARDS ***
Sobir.S: folds 
Eduard Gl: folds 
vodka4fun: raises $0.20 to $0.30
No1Sparkles: folds 
sAnt1n135: folds 
clasicos: folds 
Uncalled bet ($0.20) returned to vodka4fun
vodka4fun collected $0.25 from pot
*** SUMMARY ***
Total pot $0.25 | Rake $0 
Seat 1: Sobir.S folded before Flop (didn't bet)
Seat 2: Eduard Gl folded before Flop (didn't bet)
Seat 3: vodka4fun collected ($0.25)
Seat 4: No1Sparkles (button) folded before Flop (didn't bet)
Seat 5: sAnt1n135 (small blind) folded before Flop
Seat 6: clasicos (big blind) folded before Flop



PokerStars Hand #222969625087:  Hold'em No Limit ($0.05/$0.10 USD) - 2021/01/23 15:34:59 ET
Table 'Grus IV' 6-max Seat #5 is the button
Seat 1: Sobir.S ($11.13 in chips) 
Seat 2: Eduard Gl ($25.76 in chips) 
Seat 3: vodka4fun ($17.17 in chips) 
Seat 4: No1Sparkles ($10.75 in chips) 
Seat 5: sAnt1n135 ($16.50 in chips) 
Seat 6: clasicos ($11.81 in chips) 
clasicos: posts small blind $0.05
Sobir.S: posts big blind $0.10
*** HOLE CARDS ***
Eduard Gl: folds 
vodka4fun: folds 
No1Sparkles: folds 
sAnt1n135: folds 
clasicos: folds 
Uncalled bet ($0.05) returned to Sobir.S
Sobir.S collected $0.10 from pot
*** SUMMARY ***
Total pot $0.10 | Rake $0 
Seat 1: Sobir.S (big blind) collected ($0.10)
Seat 2: Eduard Gl folded before Flop (didn't bet)
Seat 3: vodka4fun folded before Flop (didn't bet)
Seat 4: No1Sparkles folded before Flop (didn't bet)
Seat 5: sAnt1n135 (button) folded before Flop (didn't bet)
Seat 6: clasicos (small blind) folded before Flop



PokerStars Hand #222969637345:  Hold'em No Limit ($0.05/$0.10 USD) - 2021/01/23 15:35:14 ET
Table 'Grus IV' 6-max Seat #6 is the button
Seat 1: Sobir.S ($11.18 in chips) 
Seat 2: Eduard Gl ($25.76 in chips) 
Seat 3: vodka4fun ($17.17 in chips) 
Seat 4: No1Sparkles ($10.75 in chips) 
Seat 5: sAnt1n135 ($16.50 in chips) 
Seat 6: clasicos ($11.76 in chips) 
Sobir.S: posts small blind $0.05
Eduard Gl: posts big blind $0.10
*** HOLE CARDS ***
vodka4fun: folds 
No1Sparkles: folds 
sAnt1n135: folds 
clasicos: folds 
Sobir.S: folds 
Uncalled bet ($0.05) returned to Eduard Gl
Eduard Gl collected $0.10 from pot
Eduard Gl: doesn't show hand 
*** SUMMARY ***
Total pot $0.10 | Rake $0 
Seat 1: Sobir.S (small blind) folded before Flop
Seat 2: Eduard Gl (big blind) collected ($0.10)
Seat 3: vodka4fun folded before Flop (didn't bet)
Seat 4: No1Sparkles folded before Flop (didn't bet)
Seat 5: sAnt1n135 folded before Flop (didn't bet)
Seat 6: clasicos (button) folded before Flop (didn't bet)



PokerStars Hand #222969650111:  Hold'em No Limit ($0.05/$0.10 USD) - 2021/01/23 15:35:29 ET
Table 'Grus IV' 6-max Seat #1 is the button
Seat 1: Sobir.S ($11.13 in chips) 
Seat 2: Eduard Gl ($25.81 in chips) 
Seat 3: vodka4fun ($17.17 in chips) 
Seat 4: No1Sparkles ($10.75 in chips) 
Seat 5: sAnt1n135 ($16.50 in chips) 
Seat 6: clasicos ($11.76 in chips) 
Eduard Gl: posts small blind $0.05
vodka4fun: posts big blind $0.10
*** HOLE CARDS ***
No1Sparkles: folds 
sAnt1n135: folds 
clasicos: folds 
Sobir.S: folds 
Eduard Gl: raises $0.20 to $0.30
vodka4fun: calls $0.20
*** FLOP *** [Tc Ts Th]
Eduard Gl: bets $0.30
vodka4fun: calls $0.30
*** TURN *** [Tc Ts Th] [Qh]
Eduard Gl: bets $0.60
vodka4fun: calls $0.60
*** RIVER *** [Tc Ts Th Qh] [Jh]
Eduard Gl: checks 
vodka4fun: bets $2.20
Eduard Gl: calls $2.20
*** SHOW DOWN ***
vodka4fun: shows [Js Qd] (a full house, Tens full of Queens)
Eduard Gl: mucks hand 
vodka4fun collected $6.49 from pot
*** SUMMARY ***
Total pot $6.80 | Rake $0.31 
Board [Tc Ts Th Qh Jh]
Seat 1: Sobir.S (button) folded before Flop (didn't bet)
Seat 2: Eduard Gl (small blind) mucked
Seat 3: vodka4fun (big blind) showed [Js Qd] and won ($6.49) with a full house, Tens full of Queens
Seat 4: No1Sparkles folded before Flop (didn't bet)
Seat 5: sAnt1n135 folded before Flop (didn't bet)
Seat 6: clasicos folded before Flop (didn't bet)



PokerStars Hand #222969700415:  Hold'em No Limit ($0.05/$0.10 USD) - 2021/01/23 15:36:28 ET
Table 'Grus IV' 6-max Seat #2 is the button
Seat 1: Sobir.S ($11.13 in chips) 
Seat 2: Eduard Gl ($22.41 in chips) 
Seat 3: vodka4fun ($20.26 in chips) 
Seat 4: No1Sparkles ($10.75 in chips) 
Seat 5: sAnt1n135 ($16.50 in chips) 
Seat 6: clasicos ($11.76 in chips) 
vodka4fun: posts small blind $0.05
No1Sparkles: posts big blind $0.10
*** HOLE CARDS ***
sAnt1n135: folds 
clasicos: folds 
Sobir.S: raises $0.20 to $0.30
Eduard Gl: folds 
vodka4fun: calls $0.25
No1Sparkles: folds 
*** FLOP *** [Ah 5s Ac]
vodka4fun: checks 
Sobir.S: checks 
*** TURN *** [Ah 5s Ac] [5d]
vodka4fun: bets $0.45
Sobir.S: folds 
Uncalled bet ($0.45) returned to vodka4fun
vodka4fun collected $0.67 from pot
*** SUMMARY ***
Total pot $0.70 | Rake $0.03 
Board [Ah 5s Ac 5d]
Seat 1: Sobir.S folded on the Turn
Seat 2: Eduard Gl (button) folded before Flop (didn't bet)
Seat 3: vodka4fun (small blind) collected ($0.67)
Seat 4: No1Sparkles (big blind) folded before Flop
Seat 5: sAnt1n135 folded before Flop (didn't bet)
Seat 6: clasicos folded before Flop (didn't bet)



PokerStars Hand #222969743969:  Hold'em No Limit ($0.05/$0.10 USD) - 2021/01/23 15:37:19 ET
Table 'Grus IV' 6-max Seat #3 is the button
Seat 1: Sobir.S ($10.83 in chips) 
Seat 2: Eduard Gl ($22.41 in chips) 
Seat 3: vodka4fun ($20.63 in chips) 
Seat 4: No1Sparkles ($10.65 in chips) 
Seat 5: sAnt1n135 ($16.50 in chips) 
Seat 6: clasicos ($11.76 in chips) 
No1Sparkles: posts small blind $0.05
sAnt1n135: posts big blind $0.10
*** HOLE CARDS ***
clasicos: folds 
Sobir.S: folds 
Eduard Gl: folds 
vodka4fun: folds 
No1Sparkles: folds 
Uncalled bet ($0.05) returned to sAnt1n135
sAnt1n135 collected $0.10 from pot
sAnt1n135: doesn't show hand 
*** SUMMARY ***
Total pot $0.10 | Rake $0 
Seat 1: Sobir.S folded before Flop (didn't bet)
Seat 2: Eduard Gl folded before Flop (didn't bet)
Seat 3: vodka4fun (button) folded before Flop (didn't bet)
Seat 4: No1Sparkles (small blind) folded before Flop
Seat 5: sAnt1n135 (big blind) collected ($0.10)
Seat 6: clasicos folded before Flop (didn't bet)



PokerStars Hand #222969756577:  Hold'em No Limit ($0.05/$0.10 USD) - 2021/01/23 15:37:34 ET
Table 'Grus IV' 6-max Seat #4 is the button
Seat 1: Sobir.S ($10.83 in chips) 
Seat 2: Eduard Gl ($22.41 in chips) 
Seat 3: vodka4fun ($20.63 in chips) 
Seat 4: No1Sparkles ($10.60 in chips) 
Seat 5: sAnt1n135 ($16.55 in chips) 
Seat 6: clasicos ($11.76 in chips) 
sAnt1n135: posts small blind $0.05
clasicos: posts big blind $0.10
*** HOLE CARDS ***
Sobir.S: raises $0.20 to $0.30
Eduard Gl: folds 
vodka4fun: folds 
No1Sparkles: folds 
sAnt1n135: folds 
clasicos: folds 
Uncalled bet ($0.20) returned to Sobir.S
Sobir.S collected $0.25 from pot
*** SUMMARY ***
Total pot $0.25 | Rake $0 
Seat 1: Sobir.S collected ($0.25)
Seat 2: Eduard Gl folded before Flop (didn't bet)
Seat 3: vodka4fun folded before Flop (didn't bet)
Seat 4: No1Sparkles (button) folded before Flop (didn't bet)
Seat 5: sAnt1n135 (small blind) folded before Flop
Seat 6: clasicos (big blind) folded before Flop



PokerStars Hand #222969774246:  Hold'em No Limit ($0.05/$0.10 USD) - 2021/01/23 15:37:54 ET
Table 'Grus IV' 6-max Seat #5 is the button
Seat 1: Sobir.S ($10.98 in chips) 
Seat 2: Eduard Gl ($22.41 in chips) 
Seat 3: vodka4fun ($20.63 in chips) 
Seat 4: No1Sparkles ($10.60 in chips) 
Seat 5: sAnt1n135 ($16.50 in chips) 
Seat 6: clasicos ($11.66 in chips) 
clasicos: posts small blind $0.05
Sobir.S: posts big blind $0.10
*** HOLE CARDS ***
Eduard Gl: folds 
vodka4fun: raises $0.20 to $0.30
No1Sparkles: folds 
sAnt1n135: folds 
clasicos: folds 
Sobir.S: raises $0.80 to $1.10
vodka4fun: calls $0.80
*** FLOP *** [8c 3h 4c]
Sobir.S: bets $1.08
vodka4fun: calls $1.08
*** TURN *** [8c 3h 4c] [9h]
Sobir.S: checks 
vodka4fun: checks 
*** RIVER *** [8c 3h 4c 9h] [8d]
Sobir.S: bets $2.11
vodka4fun: calls $2.11
*** SHOW DOWN ***
Sobir.S: shows [Ac Kd] (a pair of Eights)
vodka4fun: shows [6d 6s] (two pair, Eights and Sixes)
vodka4fun collected $8.24 from pot
*** SUMMARY ***
Total pot $8.63 | Rake $0.39 
Board [8c 3h 4c 9h 8d]
Seat 1: Sobir.S (big blind) showed [Ac Kd] and lost with a pair of Eights
Seat 2: Eduard Gl folded before Flop (didn't bet)
Seat 3: vodka4fun showed [6d 6s] and won ($8.24) with two pair, Eights and Sixes
Seat 4: No1Sparkles folded before Flop (didn't bet)
Seat 5: sAnt1n135 (button) folded before Flop (didn't bet)
Seat 6: clasicos (small blind) folded before Flop



PokerStars Hand #222969882449:  Hold'em No Limit ($0.05/$0.10 USD) - 2021/01/23 15:39:53 ET
Table 'Grus IV' 6-max Seat #6 is the button
Seat 1: Sobir.S ($6.69 in chips) 
Seat 2: Eduard Gl ($22.41 in chips) 
Seat 3: vodka4fun ($24.58 in chips) 
Seat 4: No1Sparkles ($10.60 in chips) 
Seat 5: sAnt1n135 ($16.50 in chips) 
Seat 6: clasicos ($11.61 in chips) 
Sobir.S: posts small blind $0.05
Eduard Gl: posts big blind $0.10
*** HOLE CARDS ***
vodka4fun: folds 
No1Sparkles: folds 
sAnt1n135: raises $0.20 to $0.30
clasicos: folds 
Sobir.S: calls $0.25
Eduard Gl: folds 
*** FLOP *** [9d 5c Th]
Sobir.S: checks 
sAnt1n135: bets $0.37
Sobir.S: folds 
Uncalled bet ($0.37) returned to sAnt1n135
sAnt1n135 collected $0.67 from pot
sAnt1n135: doesn't show hand 
*** SUMMARY ***
Total pot $0.70 | Rake $0.03 
Board [9d 5c Th]
Seat 1: Sobir.S (small blind) folded on the Flop
Seat 2: Eduard Gl (big blind) folded before Flop
Seat 3: vodka4fun folded before Flop (didn't bet)
Seat 4: No1Sparkles folded before Flop (didn't bet)
Seat 5: sAnt1n135 collected ($0.67)
Seat 6: clasicos (button) folded before Flop (didn't bet)



PokerStars Hand #222969914780:  Hold'em No Limit ($0.05/$0.10 USD) - 2021/01/23 15:40:32 ET
Table 'Grus IV' 6-max Seat #1 is the button
Seat 1: Sobir.S ($6.39 in chips) 
Seat 2: Eduard Gl ($22.31 in chips) 
Seat 3: vodka4fun ($24.58 in chips) 
Seat 4: No1Sparkles ($10.60 in chips) 
Seat 5: sAnt1n135 ($16.87 in chips) 
Seat 6: clasicos ($11.61 in chips) 
Eduard Gl: posts small blind $0.05
vodka4fun: posts big blind $0.10
*** HOLE CARDS ***
No1Sparkles: folds 
sAnt1n135: folds 
clasicos: folds 
Sobir.S: raises $0.20 to $0.30
Eduard Gl: folds 
vodka4fun: folds 
Uncalled bet ($0.20) returned to Sobir.S
Sobir.S collected $0.25 from pot
*** SUMMARY ***
Total pot $0.25 | Rake $0 
Seat 1: Sobir.S (button) collected ($0.25)
Seat 2: Eduard Gl (small blind) folded before Flop
Seat 3: vodka4fun (big blind) folded before Flop
Seat 4: No1Sparkles folded before Flop (didn't bet)
Seat 5: sAnt1n135 folded before Flop (didn't bet)
Seat 6: clasicos folded before Flop (didn't bet)



PokerStars Hand #222969931992:  Hold'em No Limit ($0.05/$0.10 USD) - 2021/01/23 15:40:52 ET
Table 'Grus IV' 6-max Seat #2 is the button
Seat 1: Sobir.S ($6.54 in chips) 
Seat 2: Eduard Gl ($22.26 in chips) 
Seat 3: vodka4fun ($24.48 in chips) 
Seat 4: No1Sparkles ($10.60 in chips) 
Seat 5: sAnt1n135 ($16.87 in chips) 
Seat 6: clasicos ($11.61 in chips) 
vodka4fun: posts small blind $0.05
No1Sparkles: posts big blind $0.10
*** HOLE CARDS ***
sAnt1n135: folds 
clasicos: folds 
Sobir.S: folds 
Eduard Gl: folds 
vodka4fun: raises $0.25 to $0.35
No1Sparkles: folds 
Uncalled bet ($0.25) returned to vodka4fun
vodka4fun collected $0.20 from pot
*** SUMMARY ***
Total pot $0.20 | Rake $0 
Seat 1: Sobir.S folded before Flop (didn't bet)
Seat 2: Eduard Gl (button) folded before Flop (didn't bet)
Seat 3: vodka4fun (small blind) collected ($0.20)
Seat 4: No1Sparkles (big blind) folded before Flop
Seat 5: sAnt1n135 folded before Flop (didn't bet)
Seat 6: clasicos folded before Flop (didn't bet)



PokerStars Hand #222969948526:  Hold'em No Limit ($0.05/$0.10 USD) - 2021/01/23 15:41:12 ET
Table 'Grus IV' 6-max Seat #3 is the button
Seat 1: Sobir.S ($6.54 in chips) 
Seat 2: Eduard Gl ($22.26 in chips) 
Seat 3: vodka4fun ($24.58 in chips) 
Seat 4: No1Sparkles ($10.50 in chips) 
Seat 5: sAnt1n135 ($16.87 in chips) 
Seat 6: clasicos ($11.61 in chips) 
No1Sparkles: posts small blind $0.05
sAnt1n135: posts big blind $0.10
*** HOLE CARDS ***
clasicos: raises $0.20 to $0.30
Sobir.S: folds 
Eduard Gl: folds 
vodka4fun: folds 
No1Sparkles: folds 
sAnt1n135: folds 
Uncalled bet ($0.20) returned to clasicos
clasicos collected $0.25 from pot
clasicos: doesn't show hand 
*** SUMMARY ***
Total pot $0.25 | Rake $0 
Seat 1: Sobir.S folded before Flop (didn't bet)
Seat 2: Eduard Gl folded before Flop (didn't bet)
Seat 3: vodka4fun (button) folded before Flop (didn't bet)
Seat 4: No1Sparkles (small blind) folded before Flop
Seat 5: sAnt1n135 (big blind) folded before Flop
Seat 6: clasicos collected ($0.25)



PokerStars Hand #222969969198:  Hold'em No Limit ($0.05/$0.10 USD) - 2021/01/23 15:41:37 ET
Table 'Grus IV' 6-max Seat #4 is the button
Seat 1: Sobir.S ($6.54 in chips) 
Seat 2: Eduard Gl ($22.26 in chips) 
Seat 3: vodka4fun ($24.58 in chips) 
Seat 4: No1Sparkles ($10.45 in chips) 
Seat 5: sAnt1n135 ($16.77 in chips) 
Seat 6: clasicos ($11.76 in chips) 
sAnt1n135: posts small blind $0.05
clasicos: posts big blind $0.10
*** HOLE CARDS ***
Sobir.S: folds 
Eduard Gl: folds 
vodka4fun: raises $0.20 to $0.30
No1Sparkles: calls $0.30
sAnt1n135: folds 
clasicos: folds 
*** FLOP *** [Jh 6s 2s]
vodka4fun: bets $0.40
No1Sparkles: calls $0.40
*** TURN *** [Jh 6s 2s] [Ts]
vodka4fun: checks 
No1Sparkles: bets $0.98
vodka4fun: folds 
Uncalled bet ($0.98) returned to No1Sparkles
No1Sparkles collected $1.48 from pot
No1Sparkles: doesn't show hand 
*** SUMMARY ***
Total pot $1.55 | Rake $0.07 
Board [Jh 6s 2s Ts]
Seat 1: Sobir.S folded before Flop (didn't bet)
Seat 2: Eduard Gl folded before Flop (didn't bet)
Seat 3: vodka4fun folded on the Turn
Seat 4: No1Sparkles (button) collected ($1.48)
Seat 5: sAnt1n135 (small blind) folded before Flop
Seat 6: clasicos (big blind) folded before Flop



PokerStars Hand #222970013803:  Hold'em No Limit ($0.05/$0.10 USD) - 2021/01/23 15:42:30 ET
Table 'Grus IV' 6-max Seat #5 is the button
Seat 1: Sobir.S ($6.54 in chips) 
Seat 2: Eduard Gl ($22.26 in chips) 
Seat 3: vodka4fun ($23.88 in chips) 
Seat 4: No1Sparkles ($11.23 in chips) 
Seat 5: sAnt1n135 ($16.72 in chips) 
Seat 6: clasicos ($11.66 in chips) 
clasicos: posts small blind $0.05
Sobir.S: posts big blind $0.10
*** HOLE CARDS ***
Eduard Gl: raises $0.20 to $0.30
vodka4fun: folds 
No1Sparkles: folds 
sAnt1n135: folds 
clasicos: folds 
Sobir.S: calls $0.20
*** FLOP *** [3d 7h Kh]
Sobir.S: checks 
Eduard Gl: checks 
*** TURN *** [3d 7h Kh] [Qc]
Sobir.S: checks 
Eduard Gl: bets $0.50
Sobir.S: folds 
Uncalled bet ($0.50) returned to Eduard Gl
Eduard Gl collected $0.62 from pot
Eduard Gl: doesn't show hand 
*** SUMMARY ***
Total pot $0.65 | Rake $0.03 
Board [3d 7h Kh Qc]
Seat 1: Sobir.S (big blind) folded on the Turn
Seat 2: Eduard Gl collected ($0.62)
Seat 3: vodka4fun folded before Flop (didn't bet)
Seat 4: No1Sparkles folded before Flop (didn't bet)
Seat 5: sAnt1n135 (button) folded before Flop (didn't bet)
Seat 6: clasicos (small blind) folded before Flop



PokerStars Hand #222970048167:  Hold'em No Limit ($0.05/$0.10 USD) - 2021/01/23 15:43:10 ET
Table 'Grus IV' 6-max Seat #6 is the button
Seat 1: Sobir.S ($6.24 in chips) 
Seat 2: Eduard Gl ($22.58 in chips) 
Seat 3: vodka4fun ($23.88 in chips) 
Seat 4: No1Sparkles ($11.23 in chips) 
Seat 5: sAnt1n135 ($16.72 in chips) 
Seat 6: clasicos ($11.61 in chips) 
Sobir.S: posts small blind $0.05
Eduard Gl: posts big blind $0.10
*** HOLE CARDS ***
vodka4fun: folds 
No1Sparkles: folds 
sAnt1n135: folds 
clasicos: folds 
Sobir.S: folds 
Uncalled bet ($0.05) returned to Eduard Gl
Eduard Gl collected $0.10 from pot
Eduard Gl: doesn't show hand 
*** SUMMARY ***
Total pot $0.10 | Rake $0 
Seat 1: Sobir.S (small blind) folded before Flop
Seat 2: Eduard Gl (big blind) collected ($0.10)
Seat 3: vodka4fun folded before Flop (didn't bet)
Seat 4: No1Sparkles folded before Flop (didn't bet)
Seat 5: sAnt1n135 folded before Flop (didn't bet)
Seat 6: clasicos (button) folded before Flop (didn't bet)



PokerStars Hand #222970057629:  Hold'em No Limit ($0.05/$0.10 USD) - 2021/01/23 15:43:22 ET
Table 'Grus IV' 6-max Seat #1 is the button
Seat 1: Sobir.S ($6.19 in chips) 
Seat 2: Eduard Gl ($22.63 in chips) 
Seat 3: vodka4fun ($23.88 in chips) 
Seat 4: No1Sparkles ($11.23 in chips) 
Seat 5: sAnt1n135 ($16.72 in chips) 
Seat 6: clasicos ($11.61 in chips) 
Eduard Gl: posts small blind $0.05
vodka4fun: posts big blind $0.10
*** HOLE CARDS ***
No1Sparkles: folds 
sAnt1n135: folds 
clasicos: folds 
Sobir.S: raises $0.20 to $0.30
Eduard Gl: folds 
vodka4fun: folds 
Uncalled bet ($0.20) returned to Sobir.S
Sobir.S collected $0.25 from pot
*** SUMMARY ***
Total pot $0.25 | Rake $0 
Seat 1: Sobir.S (button) collected ($0.25)
Seat 2: Eduard Gl (small blind) folded before Flop
Seat 3: vodka4fun (big blind) folded before Flop
Seat 4: No1Sparkles folded before Flop (didn't bet)
Seat 5: sAnt1n135 folded before Flop (didn't bet)
Seat 6: clasicos folded before Flop (didn't bet)



PokerStars Hand #222970076182:  Hold'em No Limit ($0.05/$0.10 USD) - 2021/01/23 15:43:44 ET
Table 'Grus IV' 6-max Seat #2 is the button
Seat 1: Sobir.S ($6.34 in chips) 
Seat 2: Eduard Gl ($22.58 in chips) 
Seat 3: vodka4fun ($23.78 in chips) 
Seat 4: No1Sparkles ($11.23 in chips) 
Seat 5: sAnt1n135 ($16.72 in chips) 
Seat 6: clasicos ($11.61 in chips) 
vodka4fun: posts small blind $0.05
No1Sparkles: posts big blind $0.10
*** HOLE CARDS ***
sAnt1n135: folds 
clasicos: folds 
Sobir.S: raises $0.20 to $0.30
Eduard Gl: folds 
vodka4fun: folds 
No1Sparkles: folds 
Uncalled bet ($0.20) returned to Sobir.S
Sobir.S collected $0.25 from pot
*** SUMMARY ***
Total pot $0.25 | Rake $0 
Seat 1: Sobir.S collected ($0.25)
Seat 2: Eduard Gl (button) folded before Flop (didn't bet)
Seat 3: vodka4fun (small blind) folded before Flop
Seat 4: No1Sparkles (big blind) folded before Flop
Seat 5: sAnt1n135 folded before Flop (didn't bet)
Seat 6: clasicos folded before Flop (didn't bet)



PokerStars Hand #222970089252:  Hold'em No Limit ($0.05/$0.10 USD) - 2021/01/23 15:43:59 ET
Table 'Grus IV' 6-max Seat #3 is the button
Seat 1: Sobir.S ($6.49 in chips) 
Seat 2: Eduard Gl ($22.58 in chips) 
Seat 3: vodka4fun ($23.73 in chips) 
Seat 4: No1Sparkles ($11.13 in chips) 
Seat 5: sAnt1n135 ($16.72 in chips) 
Seat 6: clasicos ($11.61 in chips) 
No1Sparkles: posts small blind $0.05
sAnt1n135: posts big blind $0.10
*** HOLE CARDS ***
clasicos: folds 
Sobir.S: folds 
Eduard Gl: folds 
vodka4fun: raises $0.20 to $0.30
No1Sparkles: folds 
sAnt1n135: raises $0.65 to $0.95
vodka4fun: calls $0.65
*** FLOP *** [Ad 5s 3h]
sAnt1n135: bets $0.61
vodka4fun: calls $0.61
*** TURN *** [Ad 5s 3h] [3d]
sAnt1n135: bets $1.67
vodka4fun has timed out
vodka4fun: folds 
Uncalled bet ($1.67) returned to sAnt1n135
sAnt1n135 collected $3.03 from pot
sAnt1n135: doesn't show hand 
*** SUMMARY ***
Total pot $3.17 | Rake $0.14 
Board [Ad 5s 3h 3d]
Seat 1: Sobir.S folded before Flop (didn't bet)
Seat 2: Eduard Gl folded before Flop (didn't bet)
Seat 3: vodka4fun (button) folded on the Turn
Seat 4: No1Sparkles (small blind) folded before Flop
Seat 5: sAnt1n135 (big blind) collected ($3.03)
Seat 6: clasicos folded before Flop (didn't bet)



PokerStars Hand #222970177895:  Hold'em No Limit ($0.05/$0.10 USD) - 2021/01/23 15:45:44 ET
Table 'Grus IV' 6-max Seat #4 is the button
Seat 1: Sobir.S ($6.49 in chips) 
Seat 2: Eduard Gl ($22.58 in chips) 
Seat 3: vodka4fun ($22.17 in chips) 
Seat 4: No1Sparkles ($11.08 in chips) 
Seat 5: sAnt1n135 ($18.19 in chips) 
sAnt1n135: posts small blind $0.05
clasicos: is sitting out 
Sobir.S: posts big blind $0.10
*** HOLE CARDS ***
Eduard Gl: folds 
vodka4fun: raises $0.20 to $0.30
No1Sparkles: folds 
sAnt1n135: folds 
Sobir.S: folds 
Uncalled bet ($0.20) returned to vodka4fun
vodka4fun collected $0.25 from pot
*** SUMMARY ***
Total pot $0.25 | Rake $0 
Seat 1: Sobir.S (big blind) folded before Flop
Seat 2: Eduard Gl folded before Flop (didn't bet)
Seat 3: vodka4fun collected ($0.25)
Seat 4: No1Sparkles (button) folded before Flop (didn't bet)
Seat 5: sAnt1n135 (small blind) folded before Flop



PokerStars Hand #222970187393:  Hold'em No Limit ($0.05/$0.10 USD) - 2021/01/23 15:45:56 ET
Table 'Grus IV' 6-max Seat #5 is the button
Seat 1: Sobir.S ($6.39 in chips) 
Seat 2: Eduard Gl ($22.58 in chips) 
Seat 3: vodka4fun ($22.32 in chips) 
Seat 4: No1Sparkles ($11.08 in chips) 
Seat 5: sAnt1n135 ($18.14 in chips) 
Sobir.S: posts small blind $0.05
Eduard Gl: posts big blind $0.10
*** HOLE CARDS ***
clasicos leaves the table
vodka4fun: folds 
No1Sparkles: raises $0.20 to $0.30
sAnt1n135: folds 
Sobir.S: folds 
puschdl joins the table at seat #6 
Eduard Gl: folds 
Uncalled bet ($0.20) returned to No1Sparkles
No1Sparkles collected $0.25 from pot
No1Sparkles: doesn't show hand 
*** SUMMARY ***
Total pot $0.25 | Rake $0 
Seat 1: Sobir.S (small blind) folded before Flop
Seat 2: Eduard Gl (big blind) folded before Flop
Seat 3: vodka4fun folded before Flop (didn't bet)
Seat 4: No1Sparkles collected ($0.25)
Seat 5: sAnt1n135 (button) folded before Flop (didn't bet)



PokerStars Hand #222970195742:  Hold'em No Limit ($0.05/$0.10 USD) - 2021/01/23 15:46:06 ET
Table 'Grus IV' 6-max Seat #1 is the button
Seat 1: Sobir.S ($6.34 in chips) 
Seat 2: Eduard Gl ($22.48 in chips) 
Seat 3: vodka4fun ($22.32 in chips) 
Seat 4: No1Sparkles ($11.23 in chips) 
Seat 5: sAnt1n135 ($18.14 in chips) 
Eduard Gl: posts small blind $0.05
vodka4fun: posts big blind $0.10
puschdl has timed out
puschdl: is sitting out 
*** HOLE CARDS ***
No1Sparkles: folds 
sAnt1n135: folds 
Sobir.S: folds 
Eduard Gl: folds 
Uncalled bet ($0.05) returned to vodka4fun
vodka4fun collected $0.10 from pot
*** SUMMARY ***
Total pot $0.10 | Rake $0 
Seat 1: Sobir.S (button) folded before Flop (didn't bet)
Seat 2: Eduard Gl (small blind) folded before Flop
Seat 3: vodka4fun (big blind) collected ($0.10)
Seat 4: No1Sparkles folded before Flop (didn't bet)
Seat 5: sAnt1n135 folded before Flop (didn't bet)



PokerStars Hand #222970216583:  Hold'em No Limit ($0.05/$0.10 USD) - 2021/01/23 15:46:31 ET
Table 'Grus IV' 6-max Seat #2 is the button
Seat 1: Sobir.S ($6.34 in chips) 
Seat 2: Eduard Gl ($22.43 in chips) 
Seat 3: vodka4fun ($22.37 in chips) 
Seat 4: No1Sparkles ($11.23 in chips) 
Seat 5: sAnt1n135 ($18.14 in chips) 
Seat 6: puschdl ($8 in chips) 
vodka4fun: posts small blind $0.05
No1Sparkles: posts big blind $0.10
puschdl: posts big blind $0.10
*** HOLE CARDS ***
sAnt1n135: folds 
puschdl: checks 
Sobir.S: raises $0.30 to $0.40
Eduard Gl: folds 
vodka4fun: folds 
No1Sparkles: folds 
puschdl: calls $0.30
*** FLOP *** [3d 8c 7d]
puschdl: bets $0.45
Sobir.S: raises $0.75 to $1.20
puschdl: calls $0.75
*** TURN *** [3d 8c 7d] [Kh]
puschdl: checks 
Sobir.S: bets $2.13
puschdl: calls $2.13
*** RIVER *** [3d 8c 7d Kh] [Th]
puschdl: checks 
Sobir.S: bets $2.61 and is all-in
puschdl: calls $2.61
*** SHOW DOWN ***
Sobir.S: shows [Jh Jc] (a pair of Jacks)
puschdl: shows [9s 7s] (a pair of Sevens)
Sobir.S collected $12.25 from pot
*** SUMMARY ***
Total pot $12.83 | Rake $0.58 
Board [3d 8c 7d Kh Th]
Seat 1: Sobir.S showed [Jh Jc] and won ($12.25) with a pair of Jacks
Seat 2: Eduard Gl (button) folded before Flop (didn't bet)
Seat 3: vodka4fun (small blind) folded before Flop
Seat 4: No1Sparkles (big blind) folded before Flop
Seat 5: sAnt1n135 folded before Flop (didn't bet)
Seat 6: puschdl showed [9s 7s] and lost with a pair of Sevens



PokerStars Hand #222970273254:  Hold'em No Limit ($0.05/$0.10 USD) - 2021/01/23 15:47:38 ET
Table 'Grus IV' 6-max Seat #3 is the button
Seat 1: Sobir.S ($12.25 in chips) 
Seat 2: Eduard Gl ($22.43 in chips) 
Seat 3: vodka4fun ($22.32 in chips) 
Seat 4: No1Sparkles ($11.13 in chips) 
Seat 5: sAnt1n135 ($18.14 in chips) 
Seat 6: puschdl ($1.66 in chips) 
No1Sparkles: posts small blind $0.05
sAnt1n135: posts big blind $0.10
*** HOLE CARDS ***
puschdl: raises $1.56 to $1.66 and is all-in
Sobir.S: folds 
Eduard Gl: folds 
vodka4fun: folds 
No1Sparkles: calls $1.61
sAnt1n135: folds 
*** FLOP *** [8h 3d 2s]
*** TURN *** [8h 3d 2s] [Js]
*** RIVER *** [8h 3d 2s Js] [Ks]
*** SHOW DOWN ***
No1Sparkles: shows [Ah Qc] (high card Ace)
puschdl: shows [4h Ac] (high card Ace - lower kicker)
No1Sparkles collected $3.27 from pot
*** SUMMARY ***
Total pot $3.42 | Rake $0.15 
Board [8h 3d 2s Js Ks]
Seat 1: Sobir.S folded before Flop (didn't bet)
Seat 2: Eduard Gl folded before Flop (didn't bet)
Seat 3: vodka4fun (button) folded before Flop (didn't bet)
Seat 4: No1Sparkles (small blind) showed [Ah Qc] and won ($3.27) with high card Ace
Seat 5: sAnt1n135 (big blind) folded before Flop
Seat 6: puschdl showed [4h Ac] and lost with high card Ace



PokerStars Hand #222970297093:  Hold'em No Limit ($0.05/$0.10 USD) - 2021/01/23 15:48:07 ET
Table 'Grus IV' 6-max Seat #4 is the button
Seat 1: Sobir.S ($12.25 in chips) 
Seat 2: Eduard Gl ($22.43 in chips) 
Seat 3: vodka4fun ($22.32 in chips) 
Seat 4: No1Sparkles ($12.74 in chips) 
Seat 5: sAnt1n135 ($18.04 in chips) 
sAnt1n135: posts small blind $0.05
Sobir.S: posts big blind $0.10
*** HOLE CARDS ***
Eduard Gl: folds 
vodka4fun: folds 
puschdl leaves the table
No1Sparkles: folds 
sAnt1n135: raises $0.10 to $0.20
Sobir.S: folds 
Uncalled bet ($0.10) returned to sAnt1n135
sAnt1n135 collected $0.20 from pot
sAnt1n135: doesn't show hand 
*** SUMMARY ***
Total pot $0.20 | Rake $0 
Seat 1: Sobir.S (big blind) folded before Flop
Seat 2: Eduard Gl folded before Flop (didn't bet)
Seat 3: vodka4fun folded before Flop (didn't bet)
Seat 4: No1Sparkles (button) folded before Flop (didn't bet)
Seat 5: sAnt1n135 (small blind) collected ($0.20)



PokerStars Hand #222970311827:  Hold'em No Limit ($0.05/$0.10 USD) - 2021/01/23 15:48:25 ET
Table 'Grus IV' 6-max Seat #5 is the button
Seat 1: Sobir.S ($12.15 in chips) 
Seat 2: Eduard Gl ($22.43 in chips) 
Seat 3: vodka4fun ($22.32 in chips) 
Seat 4: No1Sparkles ($12.74 in chips) 
Seat 5: sAnt1n135 ($18.14 in chips) 
Sobir.S: posts small blind $0.05
Eduard Gl: posts big blind $0.10
*** HOLE CARDS ***
vodka4fun: folds 
No1Sparkles: folds 
sAnt1n135: raises $0.13 to $0.23
Sobir.S: calls $0.18
Eduard Gl: calls $0.13
*** FLOP *** [Tc 6c 8c]
Sobir.S: checks 
Eduard Gl: bets $0.40
sAnt1n135: folds 
Sobir.S: raises $0.60 to $1
Eduard Gl: folds 
Uncalled bet ($0.60) returned to Sobir.S
Sobir.S collected $1.42 from pot
*** SUMMARY ***
Total pot $1.49 | Rake $0.07 
Board [Tc 6c 8c]
Seat 1: Sobir.S (small blind) collected ($1.42)
Seat 2: Eduard Gl (big blind) folded on the Flop
Seat 3: vodka4fun folded before Flop (didn't bet)
Seat 4: No1Sparkles folded before Flop (didn't bet)
Seat 5: sAnt1n135 (button) folded on the Flop



PokerStars Hand #222970341336:  Hold'em No Limit ($0.05/$0.10 USD) - 2021/01/23 15:49:00 ET
Table 'Grus IV' 6-max Seat #1 is the button
Seat 1: Sobir.S ($12.94 in chips) 
Seat 2: Eduard Gl ($21.80 in chips) 
Seat 3: vodka4fun ($22.32 in chips) 
Seat 4: No1Sparkles ($12.74 in chips) 
Seat 5: sAnt1n135 ($17.91 in chips) 
Eduard Gl: posts small blind $0.05
vodka4fun: posts big blind $0.10
*** HOLE CARDS ***
No1Sparkles: folds 
sAnt1n135: folds 
Sobir.S: folds 
Eduard Gl: raises $0.20 to $0.30
vodka4fun: folds 
Uncalled bet ($0.20) returned to Eduard Gl
Eduard Gl collected $0.20 from pot
Eduard Gl: doesn't show hand 
*** SUMMARY ***
Total pot $0.20 | Rake $0 
Seat 1: Sobir.S (button) folded before Flop (didn't bet)
Seat 2: Eduard Gl (small blind) collected ($0.20)
Seat 3: vodka4fun (big blind) folded before Flop
Seat 4: No1Sparkles folded before Flop (didn't bet)
Seat 5: sAnt1n135 folded before Flop (didn't bet)



PokerStars Hand #222970355915:  Hold'em No Limit ($0.05/$0.10 USD) - 2021/01/23 15:49:18 ET
Table 'Grus IV' 6-max Seat #2 is the button
Seat 1: Sobir.S ($12.94 in chips) 
Seat 2: Eduard Gl ($21.90 in chips) 
Seat 3: vodka4fun ($22.22 in chips) 
Seat 5: sAnt1n135 ($17.91 in chips) 
vodka4fun: posts small blind $0.05
No1Sparkles: is sitting out 
sAnt1n135: posts big blind $0.10
*** HOLE CARDS ***
Sobir.S: folds 
Eduard Gl: raises $0.10 to $0.20
vodka4fun: folds 
sAnt1n135: folds 
Uncalled bet ($0.10) returned to Eduard Gl
Eduard Gl collected $0.25 from pot
Eduard Gl: doesn't show hand 
*** SUMMARY ***
Total pot $0.25 | Rake $0 
Seat 1: Sobir.S folded before Flop (didn't bet)
Seat 2: Eduard Gl (button) collected ($0.25)
Seat 3: vodka4fun (small blind) folded before Flop
Seat 5: sAnt1n135 (big blind) folded before Flop



PokerStars Hand #222970362272:  Hold'em No Limit ($0.05/$0.10 USD) - 2021/01/23 15:49:26 ET
Table 'Grus IV' 6-max Seat #3 is the button
Seat 1: Sobir.S ($12.94 in chips) 
Seat 2: Eduard Gl ($22.05 in chips) 
Seat 3: vodka4fun ($22.17 in chips) 
Seat 5: sAnt1n135 ($17.81 in chips) 
sAnt1n135: posts small blind $0.05
Sobir.S: posts big blind $0.10
*** HOLE CARDS ***
Eduard Gl: folds 
vodka4fun: raises $0.20 to $0.30
sAnt1n135: folds 
Sobir.S: raises $0.60 to $0.90
vodka4fun: calls $0.60
*** FLOP *** [6c 6d 7d]
No1Sparkles leaves the table
Sobir.S: bets $1.77
vodka4fun: calls $1.77
*** TURN *** [6c 6d 7d] [Jh]
Sobir.S: bets $2.58
chesspokerplay joins the table at seat #4 
vodka4fun: calls $2.58
*** RIVER *** [6c 6d 7d Jh] [As]
Sobir.S: bets $7.69 and is all-in
vodka4fun: calls $7.69
*** SHOW DOWN ***
Sobir.S: shows [Ah Ad] (a full house, Aces full of Sixes)
vodka4fun: shows [Jd Ac] (two pair, Aces and Jacks)
Sobir.S collected $24.93 from pot
*** SUMMARY ***
Total pot $25.93 | Rake $1 
Board [6c 6d 7d Jh As]
Seat 1: Sobir.S (big blind) showed [Ah Ad] and won ($24.93) with a full house, Aces full of Sixes
Seat 2: Eduard Gl folded before Flop (didn't bet)
Seat 3: vodka4fun (button) showed [Jd Ac] and lost with two pair, Aces and Jacks
Seat 5: sAnt1n135 (small blind) folded before Flop



PokerStars Hand #222970426349:  Hold'em No Limit ($0.05/$0.10 USD) - 2021/01/23 15:50:43 ET
Table 'Grus IV' 6-max Seat #5 is the button
Seat 1: Sobir.S ($24.93 in chips) 
Seat 2: Eduard Gl ($22.05 in chips) 
Seat 3: vodka4fun ($10 in chips) 
Seat 4: chesspokerplay ($10 in chips) 
Seat 5: sAnt1n135 ($17.76 in chips) 
Sobir.S: posts small blind $0.05
Eduard Gl: posts big blind $0.10
chesspokerplay: posts big blind $0.10
*** HOLE CARDS ***
vodka4fun: folds 
chesspokerplay: checks 
sAnt1n135: folds 
Sobir.S: raises $0.30 to $0.40
Eduard Gl: folds 
chesspokerplay: folds 
Uncalled bet ($0.30) returned to Sobir.S
Sobir.S collected $0.30 from pot
*** SUMMARY ***
Total pot $0.30 | Rake $0 
Seat 1: Sobir.S (small blind) collected ($0.30)
Seat 2: Eduard Gl (big blind) folded before Flop
Seat 3: vodka4fun folded before Flop (didn't bet)
Seat 4: chesspokerplay folded before Flop (didn't bet)
Seat 5: sAnt1n135 (button) folded before Flop (didn't bet)



PokerStars Hand #222970438549:  Hold'em No Limit ($0.05/$0.10 USD) - 2021/01/23 15:50:57 ET
Table 'Grus IV' 6-max Seat #1 is the button
Seat 1: Sobir.S ($25.13 in chips) 
Seat 2: Eduard Gl ($21.95 in chips) 
Seat 3: vodka4fun ($10 in chips) 
Seat 4: chesspokerplay ($9.90 in chips) 
Seat 5: sAnt1n135 ($17.76 in chips) 
Eduard Gl: posts small blind $0.05
vodka4fun: posts big blind $0.10
*** HOLE CARDS ***
chesspokerplay: folds 
sAnt1n135: folds 
Sobir.S: folds 
Eduard Gl: raises $0.20 to $0.30
vodka4fun: folds 
Uncalled bet ($0.20) returned to Eduard Gl
Eduard Gl collected $0.20 from pot
Eduard Gl: doesn't show hand 
*** SUMMARY ***
Total pot $0.20 | Rake $0 
Seat 1: Sobir.S (button) folded before Flop (didn't bet)
Seat 2: Eduard Gl (small blind) collected ($0.20)
Seat 3: vodka4fun (big blind) folded before Flop
Seat 4: chesspokerplay folded before Flop (didn't bet)
Seat 5: sAnt1n135 folded before Flop (didn't bet)



PokerStars Hand #222970449701:  Hold'em No Limit ($0.05/$0.10 USD) - 2021/01/23 15:51:11 ET
Table 'Grus IV' 6-max Seat #2 is the button
Seat 1: Sobir.S ($25.13 in chips) 
Seat 2: Eduard Gl ($22.05 in chips) 
Seat 3: vodka4fun ($10 in chips) 
Seat 4: chesspokerplay ($9.90 in chips) 
Seat 5: sAnt1n135 ($17.76 in chips) 
vodka4fun: posts small blind $0.05
chesspokerplay: posts big blind $0.10
*** HOLE CARDS ***
sAnt1n135: raises $0.13 to $0.23
Sobir.S: folds 
Sobir.S leaves the table
Eduard Gl: folds 
vodka4fun: folds 
chesspokerplay: calls $0.13
*** FLOP *** [4s 9s 8s]
chesspokerplay: checks 
sAnt1n135: checks 
*** TURN *** [4s 9s 8s] [Qh]
chesspokerplay: checks 
sAnt1n135: checks 
*** RIVER *** [4s 9s 8s Qh] [Tc]
chesspokerplay: bets $0.10
sAnt1n135: folds 
Uncalled bet ($0.10) returned to chesspokerplay
chesspokerplay collected $0.49 from pot
*** SUMMARY ***
Total pot $0.51 | Rake $0.02 
Board [4s 9s 8s Qh Tc]
Seat 1: Sobir.S folded before Flop (didn't bet)
Seat 2: Eduard Gl (button) folded before Flop (didn't bet)
Seat 3: vodka4fun (small blind) folded before Flop
Seat 4: chesspokerplay (big blind) collected ($0.49)
Seat 5: sAnt1n135 folded on the River



PokerStars Hand #222970485582:  Hold'em No Limit ($0.05/$0.10 USD) - 2021/01/23 15:51:53 ET
Table 'Grus IV' 6-max Seat #3 is the button
Seat 2: Eduard Gl ($22.05 in chips) 
Seat 3: vodka4fun ($10 in chips) 
Seat 4: chesspokerplay ($10.16 in chips) 
Seat 5: sAnt1n135 ($17.53 in chips) 
chesspokerplay: posts small blind $0.05
sAnt1n135: posts big blind $0.10
*** HOLE CARDS ***
Eduard Gl: folds 
vodka4fun: raises $0.20 to $0.30
chesspokerplay: folds 
sAnt1n135: folds 
Uncalled bet ($0.20) returned to vodka4fun
vodka4fun collected $0.25 from pot
*** SUMMARY ***
Total pot $0.25 | Rake $0 
Seat 2: Eduard Gl folded before Flop (didn't bet)
Seat 3: vodka4fun (button) collected ($0.25)
Seat 4: chesspokerplay (small blind) folded before Flop
Seat 5: sAnt1n135 (big blind) folded before Flop



PokerStars Hand #222970490959:  Hold'em No Limit ($0.05/$0.10 USD) - 2021/01/23 15:52:00 ET
Table 'Grus IV' 6-max Seat #4 is the button
Seat 2: Eduard Gl ($22.05 in chips) 
Seat 3: vodka4fun ($10.15 in chips) 
Seat 4: chesspokerplay ($10.11 in chips) 
Seat 5: sAnt1n135 ($17.43 in chips) 
sAnt1n135: posts small blind $0.05
Eduard Gl: posts big blind $0.10
*** HOLE CARDS ***
vodka4fun: folds 
chesspokerplay: folds 
vodka4fun leaves the table
sAnt1n135: folds 
Uncalled bet ($0.05) returned to Eduard Gl
Eduard Gl collected $0.10 from pot
Eduard Gl: doesn't show hand 
*** SUMMARY ***
Total pot $0.10 | Rake $0 
Seat 2: Eduard Gl (big blind) collected ($0.10)
Seat 3: vodka4fun folded before Flop (didn't bet)
Seat 4: chesspokerplay (button) folded before Flop (didn't bet)
Seat 5: sAnt1n135 (small blind) folded before Flop



PokerStars Hand #222970497038:  Hold'em No Limit ($0.05/$0.10 USD) - 2021/01/23 15:52:07 ET
Table 'Grus IV' 6-max Seat #5 is the button
Seat 2: Eduard Gl ($22.10 in chips) 
Seat 4: chesspokerplay ($10.11 in chips) 
Seat 5: sAnt1n135 ($17.38 in chips) 
Eduard Gl: posts small blind $0.05
chesspokerplay: posts big blind $0.10
*** HOLE CARDS ***
sAnt1n135: folds 
Eduard Gl: raises $0.20 to $0.30
chesspokerplay: folds 
Uncalled bet ($0.20) returned to Eduard Gl
Eduard Gl collected $0.20 from pot
Eduard Gl: doesn't show hand 
*** SUMMARY ***
Total pot $0.20 | Rake $0 
Seat 2: Eduard Gl (small blind) collected ($0.20)
Seat 4: chesspokerplay (big blind) folded before Flop
Seat 5: sAnt1n135 (button) folded before Flop (didn't bet)



PokerStars Hand #222970504100:  Hold'em No Limit ($0.05/$0.10 USD) - 2021/01/23 15:52:16 ET
Table 'Grus IV' 6-max Seat #2 is the button
Seat 2: Eduard Gl ($22.20 in chips) 
Seat 4: chesspokerplay ($10.01 in chips) 
Seat 5: sAnt1n135 ($17.38 in chips) 
chesspokerplay: posts small blind $0.05
sAnt1n135: posts big blind $0.10
*** HOLE CARDS ***
Eduard Gl: raises $0.10 to $0.20
chesspokerplay: calls $0.15
sAnt1n135: calls $0.10
*** FLOP *** [4s 9d Jc]
chesspokerplay: checks 
sAnt1n135: checks 
Eduard Gl: bets $0.30
chesspokerplay: calls $0.30
sAnt1n135: folds 
*** TURN *** [4s 9d Jc] [Kd]
chesspokerplay: checks 
Eduard Gl: checks 
*** RIVER *** [4s 9d Jc Kd] [2c]
chesspokerplay: bets $0.70
Assetgasse joins the table at seat #6 
Eduard Gl: folds 
Uncalled bet ($0.70) returned to chesspokerplay
chesspokerplay collected $1.15 from pot
chesspokerplay: doesn't show hand 
*** SUMMARY ***
Total pot $1.20 | Rake $0.05 
Board [4s 9d Jc Kd 2c]
Seat 2: Eduard Gl (button) folded on the River
Seat 4: chesspokerplay (small blind) collected ($1.15)
Seat 5: sAnt1n135 (big blind) folded on the Flop



PokerStars Hand #222970529710:  Hold'em No Limit ($0.05/$0.10 USD) - 2021/01/23 15:52:46 ET
Table 'Grus IV' 6-max Seat #4 is the button
Seat 2: Eduard Gl ($21.70 in chips) 
Seat 4: chesspokerplay ($10.66 in chips) 
Seat 5: sAnt1n135 ($17.18 in chips) 
Seat 6: Assetgasse ($10 in chips) 
sAnt1n135: posts small blind $0.05
Assetgasse: posts big blind $0.10
*** HOLE CARDS ***
Eduard Gl: folds 
chesspokerplay: folds 
sAnt1n135: raises $0.13 to $0.23
Assetgasse: folds 
Uncalled bet ($0.13) returned to sAnt1n135
sAnt1n135 collected $0.20 from pot
sAnt1n135: doesn't show hand 
*** SUMMARY ***
Total pot $0.20 | Rake $0 
Seat 2: Eduard Gl folded before Flop (didn't bet)
Seat 4: chesspokerplay (button) folded before Flop (didn't bet)
Seat 5: sAnt1n135 (small blind) collected ($0.20)
Seat 6: Assetgasse (big blind) folded before Flop



PokerStars Hand #222970537370:  Hold'em No Limit ($0.05/$0.10 USD) - 2021/01/23 15:52:55 ET
Table 'Grus IV' 6-max Seat #5 is the button
Seat 2: Eduard Gl ($21.70 in chips) 
Seat 4: chesspokerplay ($10.66 in chips) 
Seat 5: sAnt1n135 ($17.28 in chips) 
Seat 6: Assetgasse ($10 in chips) 
Assetgasse: posts small blind $0.05
Eduard Gl: posts big blind $0.10
*** HOLE CARDS ***
chesspokerplay: folds 
sAnt1n135: folds 
chesspokerplay leaves the table
Assetgasse: folds 
Uncalled bet ($0.05) returned to Eduard Gl
Eduard Gl collected $0.10 from pot
Eduard Gl: doesn't show hand 
*** SUMMARY ***
Total pot $0.10 | Rake $0 
Seat 2: Eduard Gl (big blind) collected ($0.10)
Seat 4: chesspokerplay folded before Flop (didn't bet)
Seat 5: sAnt1n135 (button) folded before Flop (didn't bet)
Seat 6: Assetgasse (small blind) folded before Flop



PokerStars Hand #222970543145:  Hold'em No Limit ($0.05/$0.10 USD) - 2021/01/23 15:53:02 ET
Table 'Grus IV' 6-max Seat #6 is the button
Seat 2: Eduard Gl ($21.75 in chips) 
Seat 5: sAnt1n135 ($17.28 in chips) 
Seat 6: Assetgasse ($10 in chips) 
Eduard Gl: posts small blind $0.05
sAnt1n135: posts big blind $0.10
*** HOLE CARDS ***
Assetgasse: folds 
Eduard Gl: raises $0.20 to $0.30
sAnt1n135: folds 
Uncalled bet ($0.20) returned to Eduard Gl
Eduard Gl collected $0.20 from pot
Eduard Gl: doesn't show hand 
*** SUMMARY ***
Total pot $0.20 | Rake $0 
Seat 2: Eduard Gl (small blind) collected ($0.20)
Seat 5: sAnt1n135 (big blind) folded before Flop
Seat 6: Assetgasse (button) folded before Flop (didn't bet)



PokerStars Hand #222970550926:  Hold'em No Limit ($0.05/$0.10 USD) - 2021/01/23 15:53:12 ET
Table 'Grus IV' 6-max Seat #2 is the button
Seat 2: Eduard Gl ($21.85 in chips) 
Seat 5: sAnt1n135 ($17.18 in chips) 
Seat 6: Assetgasse ($10 in chips) 
sAnt1n135: posts small blind $0.05
Assetgasse: posts big blind $0.10
*** HOLE CARDS ***
Eduard Gl has timed out
Eduard Gl: folds 
sAnt1n135: folds 
Uncalled bet ($0.05) returned to Assetgasse
Assetgasse collected $0.10 from pot
Assetgasse: doesn't show hand 
*** SUMMARY ***
Total pot $0.10 | Rake $0 
Seat 2: Eduard Gl (button) folded before Flop (didn't bet)
Seat 5: sAnt1n135 (small blind) folded before Flop
Seat 6: Assetgasse (big blind) collected ($0.10)



PokerStars Hand #222970562378:  Hold'em No Limit ($0.05/$0.10 USD) - 2021/01/23 15:53:25 ET
Table 'Grus IV' 6-max Seat #6 is the button
Seat 5: sAnt1n135 ($17.13 in chips) 
Seat 6: Assetgasse ($10.05 in chips) 
Assetgasse: posts small blind $0.05
sAnt1n135: posts big blind $0.10
*** HOLE CARDS ***
Assetgasse: raises $0.10 to $0.20
sAnt1n135: calls $0.10
*** FLOP *** [3d 5s 6d]
sAnt1n135: checks 
Assetgasse: checks 
*** TURN *** [3d 5s 6d] [Qc]
sAnt1n135: bets $0.20
Assetgasse: folds 
Uncalled bet ($0.20) returned to sAnt1n135
sAnt1n135 collected $0.38 from pot
sAnt1n135: doesn't show hand 
*** SUMMARY ***
Total pot $0.40 | Rake $0.02 
Board [3d 5s 6d Qc]
Seat 5: sAnt1n135 (big blind) collected ($0.38)
Seat 6: Assetgasse (button) (small blind) folded on the Turn



PokerStars Hand #222970578233:  Hold'em No Limit ($0.05/$0.10 USD) - 2021/01/23 15:53:44 ET
Table 'Grus IV' 6-max Seat #5 is the button
Seat 2: Eduard Gl ($21.85 in chips) 
Seat 5: sAnt1n135 ($17.31 in chips) 
Seat 6: Assetgasse ($10 in chips) 
Assetgasse: posts small blind $0.05
Eduard Gl: posts big blind $0.10
*** HOLE CARDS ***
sAnt1n135: raises $0.10 to $0.20
Assetgasse: folds 
Eduard Gl: calls $0.10
*** FLOP *** [Ts As 2h]
Eduard Gl: checks 
sAnt1n135: checks 
*** TURN *** [Ts As 2h] [Th]
Assetgasse leaves the table
Eduard Gl: bets $0.30
sAnt1n135: folds 
Uncalled bet ($0.30) returned to Eduard Gl
Eduard Gl collected $0.43 from pot
Eduard Gl: doesn't show hand 
*** SUMMARY ***
Total pot $0.45 | Rake $0.02 
Board [Ts As 2h Th]
Seat 2: Eduard Gl (big blind) collected ($0.43)
Seat 5: sAnt1n135 (button) folded on the Turn
Seat 6: Assetgasse (small blind) folded before Flop



PokerStars Hand #222970595637:  Hold'em No Limit ($0.05/$0.10 USD) - 2021/01/23 15:54:05 ET
Table 'Grus IV' 6-max Seat #2 is the button
Seat 2: Eduard Gl ($22.08 in chips) 
Seat 5: sAnt1n135 ($17.11 in chips) 
Eduard Gl: posts small blind $0.05
sAnt1n135: posts big blind $0.10
*** HOLE CARDS ***
Eduard Gl: raises $0.10 to $0.20
sAnt1n135: calls $0.10
*** FLOP *** [Kc 2h 2d]
sAnt1n135: checks 
Eduard Gl: bets $0.20
sAnt1n135: calls $0.20
*** TURN *** [Kc 2h 2d] [8h]
sAnt1n135: checks 
Eduard Gl: bets $0.40
sAnt1n135: folds 
Uncalled bet ($0.40) returned to Eduard Gl
Eduard Gl collected $0.76 from pot
Eduard Gl: doesn't show hand 
*** SUMMARY ***
Total pot $0.80 | Rake $0.04 
Board [Kc 2h 2d 8h]
Seat 2: Eduard Gl (button) (small blind) collected ($0.76)
Seat 5: sAnt1n135 (big blind) folded on the Turn



PokerStars Hand #222970618153:  Hold'em No Limit ($0.05/$0.10 USD) - 2021/01/23 15:54:33 ET
Table 'Grus IV' 6-max Seat #5 is the button
Seat 2: Eduard Gl ($22.44 in chips) 
Seat 5: sAnt1n135 ($16.71 in chips) 
sAnt1n135: posts small blind $0.05
Eduard Gl: posts big blind $0.10
*** HOLE CARDS ***
sAnt1n135: raises $0.20 to $0.30
Eduard Gl: folds 
Uncalled bet ($0.20) returned to sAnt1n135
sAnt1n135 collected $0.20 from pot
sAnt1n135: doesn't show hand 
*** SUMMARY ***
Total pot $0.20 | Rake $0 
Seat 2: Eduard Gl (big blind) folded before Flop
Seat 5: sAnt1n135 (button) (small blind) collected ($0.20)



PokerStars Hand #222970623330:  Hold'em No Limit ($0.05/$0.10 USD) - 2021/01/23 15:54:39 ET
Table 'Grus IV' 6-max Seat #2 is the button
Seat 2: Eduard Gl ($22.34 in chips) 
Seat 5: sAnt1n135 ($16.81 in chips) 
Eduard Gl: posts small blind $0.05
sAnt1n135: posts big blind $0.10
*** HOLE CARDS ***
Eduard Gl: raises $0.10 to $0.20
sAnt1n135: raises $0.40 to $0.60
Eduard Gl: folds 
Uncalled bet ($0.40) returned to sAnt1n135
sAnt1n135 collected $0.40 from pot
sAnt1n135: doesn't show hand 
*** SUMMARY ***
Total pot $0.40 | Rake $0 
Seat 2: Eduard Gl (button) (small blind) folded before Flop
Seat 5: sAnt1n135 (big blind) collected ($0.40)



PokerStars Hand #222970643825:  Hold'em No Limit ($0.05/$0.10 USD) - 2021/01/23 15:55:04 ET
Table 'Grus IV' 6-max Seat #5 is the button
Seat 2: Eduard Gl ($22.14 in chips) 
Seat 5: sAnt1n135 ($17.01 in chips) 
sAnt1n135: posts small blind $0.05
Eduard Gl: posts big blind $0.10
*** HOLE CARDS ***
sAnt1n135: folds 
Uncalled bet ($0.05) returned to Eduard Gl
Eduard Gl collected $0.10 from pot
Eduard Gl: doesn't show hand 
*** SUMMARY ***
Total pot $0.10 | Rake $0 
Seat 2: Eduard Gl (big blind) collected ($0.10)
Seat 5: sAnt1n135 (button) (small blind) folded before Flop



PokerStars Hand #222970647690:  Hold'em No Limit ($0.05/$0.10 USD) - 2021/01/23 15:55:08 ET
Table 'Grus IV' 6-max Seat #2 is the button
Seat 2: Eduard Gl ($22.19 in chips) 
Seat 5: sAnt1n135 ($16.96 in chips) 
Eduard Gl: posts small blind $0.05
sAnt1n135: posts big blind $0.10
*** HOLE CARDS ***
Eduard Gl: raises $0.10 to $0.20
sAnt1n135: folds 
Uncalled bet ($0.10) returned to Eduard Gl
Eduard Gl collected $0.20 from pot
Eduard Gl: doesn't show hand 
*** SUMMARY ***
Total pot $0.20 | Rake $0 
Seat 2: Eduard Gl (button) (small blind) collected ($0.20)
Seat 5: sAnt1n135 (big blind) folded before Flop



PokerStars Hand #222970652125:  Hold'em No Limit ($0.05/$0.10 USD) - 2021/01/23 15:55:16 ET
Table 'Grus IV' 6-max Seat #5 is the button
Seat 2: Eduard Gl ($22.29 in chips) 
Seat 5: sAnt1n135 ($16.86 in chips) 
sAnt1n135: posts small blind $0.05
Eduard Gl: posts big blind $0.10
*** HOLE CARDS ***
sAnt1n135: raises $0.20 to $0.30
Eduard Gl: folds 
Uncalled bet ($0.20) returned to sAnt1n135
sAnt1n135 collected $0.20 from pot
sAnt1n135: doesn't show hand 
*** SUMMARY ***
Total pot $0.20 | Rake $0 
Seat 2: Eduard Gl (big blind) folded before Flop
Seat 5: sAnt1n135 (button) (small blind) collected ($0.20)



PokerStars Hand #222970655948:  Hold'em No Limit ($0.05/$0.10 USD) - 2021/01/23 15:55:23 ET
Table 'Grus IV' 6-max Seat #2 is the button
Seat 2: Eduard Gl ($22.19 in chips) 
Seat 5: sAnt1n135 ($16.96 in chips) 
Eduard Gl: posts small blind $0.05
sAnt1n135: posts big blind $0.10
*** HOLE CARDS ***
Eduard Gl: raises $0.10 to $0.20
sAnt1n135: folds 
Uncalled bet ($0.10) returned to Eduard Gl
Eduard Gl collected $0.20 from pot
Eduard Gl: doesn't show hand 
*** SUMMARY ***
Total pot $0.20 | Rake $0 
Seat 2: Eduard Gl (button) (small blind) collected ($0.20)
Seat 5: sAnt1n135 (big blind) folded before Flop



PokerStars Hand #222970659473:  Hold'em No Limit ($0.05/$0.10 USD) - 2021/01/23 15:55:29 ET
Table 'Grus IV' 6-max Seat #5 is the button
Seat 2: Eduard Gl ($22.29 in chips) 
Seat 5: sAnt1n135 ($16.86 in chips) 
sAnt1n135: posts small blind $0.05
Eduard Gl: posts big blind $0.10
*** HOLE CARDS ***
sAnt1n135: raises $0.20 to $0.30
Eduard Gl: calls $0.20
*** FLOP *** [4d 7c Kd]
Eduard Gl: checks 
sAnt1n135: bets $0.31
Eduard Gl: folds 
Uncalled bet ($0.31) returned to sAnt1n135
sAnt1n135 collected $0.57 from pot
sAnt1n135: doesn't show hand 
*** SUMMARY ***
Total pot $0.60 | Rake $0.03 
Board [4d 7c Kd]
Seat 2: Eduard Gl (big blind) folded on the Flop
Seat 5: sAnt1n135 (button) (small blind) collected ($0.57)



PokerStars Hand #222970669143:  Hold'em No Limit ($0.05/$0.10 USD) - 2021/01/23 15:55:47 ET
Table 'Grus IV' 6-max Seat #2 is the button
Seat 2: Eduard Gl ($21.99 in chips) 
Seat 5: sAnt1n135 ($17.13 in chips) 
Eduard Gl: posts small blind $0.05
sAnt1n135: posts big blind $0.10
*** HOLE CARDS ***
Eduard Gl: raises $0.10 to $0.20
sAnt1n135: folds 
Uncalled bet ($0.10) returned to Eduard Gl
Eduard Gl collected $0.20 from pot
Eduard Gl: doesn't show hand 
*** SUMMARY ***
Total pot $0.20 | Rake $0 
Seat 2: Eduard Gl (button) (small blind) collected ($0.20)
Seat 5: sAnt1n135 (big blind) folded before Flop



PokerStars Hand #222970672089:  Hold'em No Limit ($0.05/$0.10 USD) - 2021/01/23 15:55:52 ET
Table 'Grus IV' 6-max Seat #5 is the button
Seat 2: Eduard Gl ($22.09 in chips) 
Seat 5: sAnt1n135 ($17.03 in chips) 
sAnt1n135: posts small blind $0.05
Eduard Gl: posts big blind $0.10
*** HOLE CARDS ***
sAnt1n135: raises $0.13 to $0.23
Eduard Gl: raises $0.46 to $0.69
sAnt1n135: calls $0.46
*** FLOP *** [3s 6s 5d]
Eduard Gl: bets $0.90
Nikolay0816 joins the table at seat #4 
sAnt1n135: calls $0.90
*** TURN *** [3s 6s 5d] [Tc]
Eduard Gl: checks 
sAnt1n135: bets $1.40
Eduard Gl: calls $1.40
*** RIVER *** [3s 6s 5d Tc] [9d]
Eduard Gl: checks 
sAnt1n135: bets $14.04 and is all-in
Eduard Gl: folds 
Uncalled bet ($14.04) returned to sAnt1n135
sAnt1n135 collected $5.71 from pot
sAnt1n135: doesn't show hand 
*** SUMMARY ***
Total pot $5.98 | Rake $0.27 
Board [3s 6s 5d Tc 9d]
Seat 2: Eduard Gl (big blind) folded on the River
Seat 5: sAnt1n135 (button) (small blind) collected ($5.71)



PokerStars Hand #222970696992:  Hold'em No Limit ($0.05/$0.10 USD) - 2021/01/23 15:56:27 ET
Table 'Grus IV' 6-max Seat #5 is the button
Seat 2: Eduard Gl ($19.10 in chips) 
Seat 4: Nikolay0816 ($8 in chips) 
Seat 5: sAnt1n135 ($19.75 in chips) 
Eduard Gl: posts small blind $0.05
Nikolay0816: posts big blind $0.10
*** HOLE CARDS ***
sAnt1n135: folds 
Eduard Gl: raises $0.15 to $0.25
Nikolay0816: folds 
Uncalled bet ($0.15) returned to Eduard Gl
Eduard Gl collected $0.20 from pot
Eduard Gl: doesn't show hand 
*** SUMMARY ***
Total pot $0.20 | Rake $0 
Seat 2: Eduard Gl (small blind) collected ($0.20)
Seat 4: Nikolay0816 (big blind) folded before Flop
Seat 5: sAnt1n135 (button) folded before Flop (didn't bet)



PokerStars Hand #222970702473:  Hold'em No Limit ($0.05/$0.10 USD) - 2021/01/23 15:56:37 ET
Table 'Grus IV' 6-max Seat #2 is the button
Seat 2: Eduard Gl ($19.20 in chips) 
Seat 4: Nikolay0816 ($7.90 in chips) 
Seat 5: sAnt1n135 ($19.75 in chips) 
Nikolay0816: posts small blind $0.05
sAnt1n135: posts big blind $0.10
*** HOLE CARDS ***
Eduard Gl: raises $0.10 to $0.20
Nikolay0816: folds 
sAnt1n135: calls $0.10
*** FLOP *** [8h 6h 2d]
sAnt1n135: checks 
Eduard Gl: bets $0.30
sAnt1n135: raises $0.40 to $0.70
Eduard Gl: folds 
Uncalled bet ($0.40) returned to sAnt1n135
sAnt1n135 collected $1 from pot
sAnt1n135: doesn't show hand 
*** SUMMARY ***
Total pot $1.05 | Rake $0.05 
Board [8h 6h 2d]
Seat 2: Eduard Gl (button) folded on the Flop
Seat 4: Nikolay0816 (small blind) folded before Flop
Seat 5: sAnt1n135 (big blind) collected ($1)



PokerStars Hand #222970717179:  Hold'em No Limit ($0.05/$0.10 USD) - 2021/01/23 15:57:03 ET
Table 'Grus IV' 6-max Seat #4 is the button
Seat 2: Eduard Gl ($18.70 in chips) 
Seat 4: Nikolay0816 ($7.85 in chips) 
Seat 5: sAnt1n135 ($20.25 in chips) 
sAnt1n135: posts small blind $0.05
Eduard Gl: posts big blind $0.10
*** HOLE CARDS ***
Nikolay0816: raises $0.10 to $0.20
sAnt1n135: folds 
Eduard Gl: folds 
Uncalled bet ($0.10) returned to Nikolay0816
Nikolay0816 collected $0.25 from pot
*** SUMMARY ***
Total pot $0.25 | Rake $0 
Seat 2: Eduard Gl (big blind) folded before Flop
Seat 4: Nikolay0816 (button) collected ($0.25)
Seat 5: sAnt1n135 (small blind) folded before Flop



PokerStars Hand #222970720715:  Hold'em No Limit ($0.05/$0.10 USD) - 2021/01/23 15:57:09 ET
Table 'Grus IV' 6-max Seat #5 is the button
Seat 2: Eduard Gl ($18.60 in chips) 
Seat 4: Nikolay0816 ($8 in chips) 
Seat 5: sAnt1n135 ($20.20 in chips) 
Eduard Gl: posts small blind $0.05
Nikolay0816: posts big blind $0.10
*** HOLE CARDS ***
sAnt1n135: folds 
Eduard Gl: folds 
Uncalled bet ($0.05) returned to Nikolay0816
Nikolay0816 collected $0.10 from pot
*** SUMMARY ***
Total pot $0.10 | Rake $0 
Seat 2: Eduard Gl (small blind) folded before Flop
Seat 4: Nikolay0816 (big blind) collected ($0.10)
Seat 5: sAnt1n135 (button) folded before Flop (didn't bet)



PokerStars Hand #222970723209:  Hold'em No Limit ($0.05/$0.10 USD) - 2021/01/23 15:57:13 ET
Table 'Grus IV' 6-max Seat #2 is the button
Seat 2: Eduard Gl ($18.55 in chips) 
Seat 4: Nikolay0816 ($8.05 in chips) 
Seat 5: sAnt1n135 ($20.20 in chips) 
Nikolay0816: posts small blind $0.05
sAnt1n135: posts big blind $0.10
*** HOLE CARDS ***
Eduard Gl: folds 
Nikolay0816: folds 
Uncalled bet ($0.05) returned to sAnt1n135
sAnt1n135 collected $0.10 from pot
sAnt1n135: doesn't show hand 
*** SUMMARY ***
Total pot $0.10 | Rake $0 
Seat 2: Eduard Gl (button) folded before Flop (didn't bet)
Seat 4: Nikolay0816 (small blind) folded before Flop
Seat 5: sAnt1n135 (big blind) collected ($0.10)



PokerStars Hand #222970726283:  Hold'em No Limit ($0.05/$0.10 USD) - 2021/01/23 15:57:19 ET
Table 'Grus IV' 6-max Seat #4 is the button
Seat 2: Eduard Gl ($18.55 in chips) 
Seat 4: Nikolay0816 ($8 in chips) 
Seat 5: sAnt1n135 ($20.25 in chips) 
sAnt1n135: posts small blind $0.05
Eduard Gl: posts big blind $0.10
*** HOLE CARDS ***
Nikolay0816: folds 
nettasha joins the table at seat #6 
sAnt1n135: folds 
Uncalled bet ($0.05) returned to Eduard Gl
Eduard Gl collected $0.10 from pot
Eduard Gl: doesn't show hand 
*** SUMMARY ***
Total pot $0.10 | Rake $0 
Seat 2: Eduard Gl (big blind) collected ($0.10)
Seat 4: Nikolay0816 (button) folded before Flop (didn't bet)
Seat 5: sAnt1n135 (small blind) folded before Flop



PokerStars Hand #222970731080:  Hold'em No Limit ($0.05/$0.10 USD) - 2021/01/23 15:57:27 ET
Table 'Grus IV' 6-max Seat #5 is the button
Seat 2: Eduard Gl ($18.60 in chips) 
Seat 4: Nikolay0816 ($8 in chips) 
Seat 5: sAnt1n135 ($20.20 in chips) 
Eduard Gl: posts small blind $0.05
Nikolay0816: posts big blind $0.10
*** HOLE CARDS ***
sAnt1n135: raises $0.20 to $0.30
Eduard Gl: raises $0.70 to $1
ImperialOxxx joins the table at seat #3 
Nikolay0816: folds 
sAnt1n135: calls $0.70
*** FLOP *** [Th 4h 9h]
Eduard Gl: checks 
sAnt1n135: checks 
*** TURN *** [Th 4h 9h] [4s]
Eduard Gl: bets $1.01
sAnt1n135: folds 
Uncalled bet ($1.01) returned to Eduard Gl
Eduard Gl collected $2.01 from pot
Eduard Gl: doesn't show hand 
*** SUMMARY ***
Total pot $2.10 | Rake $0.09 
Board [Th 4h 9h 4s]
Seat 2: Eduard Gl (small blind) collected ($2.01)
Seat 4: Nikolay0816 (big blind) folded before Flop
Seat 5: sAnt1n135 (button) folded on the Turn



PokerStars Hand #222970744612:  Hold'em No Limit ($0.05/$0.10 USD) - 2021/01/23 15:57:51 ET
Table 'Grus IV' 6-max Seat #2 is the button
Seat 2: Eduard Gl ($19.61 in chips) 
Seat 4: Nikolay0816 ($7.90 in chips) 
Seat 5: sAnt1n135 ($19.20 in chips) 
Nikolay0816: posts small blind $0.05
sAnt1n135: posts big blind $0.10
nettasha: sits out 
*** HOLE CARDS ***
Eduard Gl: folds 
Nikolay0816: folds 
Uncalled bet ($0.05) returned to sAnt1n135
sAnt1n135 collected $0.10 from pot
sAnt1n135: doesn't show hand 
*** SUMMARY ***
Total pot $0.10 | Rake $0 
Seat 2: Eduard Gl (button) folded before Flop (didn't bet)
Seat 4: Nikolay0816 (small blind) folded before Flop
Seat 5: sAnt1n135 (big blind) collected ($0.10)



PokerStars Hand #222970748315:  Hold'em No Limit ($0.05/$0.10 USD) - 2021/01/23 15:57:58 ET
Table 'Grus IV' 6-max Seat #4 is the button
Seat 2: Eduard Gl ($19.61 in chips) 
Seat 4: Nikolay0816 ($7.85 in chips) 
Seat 5: sAnt1n135 ($19.25 in chips) 
Seat 6: nettasha ($10 in chips) 
sAnt1n135: posts small blind $0.05
nettasha: posts big blind $0.10
ImperialOxxx: sits out 
*** HOLE CARDS ***
Eduard Gl: folds 
Nikolay0816: folds 
sAnt1n135: folds 
Uncalled bet ($0.05) returned to nettasha
nettasha collected $0.10 from pot
nettasha: doesn't show hand 
*** SUMMARY ***
Total pot $0.10 | Rake $0 
Seat 2: Eduard Gl folded before Flop (didn't bet)
Seat 4: Nikolay0816 (button) folded before Flop (didn't bet)
Seat 5: sAnt1n135 (small blind) folded before Flop
Seat 6: nettasha (big blind) collected ($0.10)



PokerStars Hand #222970752376:  Hold'em No Limit ($0.05/$0.10 USD) - 2021/01/23 15:58:05 ET
Table 'Grus IV' 6-max Seat #5 is the button
Seat 2: Eduard Gl ($19.61 in chips) 
Seat 4: Nikolay0816 ($7.85 in chips) 
Seat 5: sAnt1n135 ($19.20 in chips) 
Seat 6: nettasha ($10.05 in chips) 
nettasha: posts small blind $0.05
Eduard Gl: posts big blind $0.10
ImperialOxxx: sits out 
*** HOLE CARDS ***
Nikolay0816: folds 
sAnt1n135: raises $0.13 to $0.23
nettasha: folds 
Eduard Gl: folds 
Uncalled bet ($0.13) returned to sAnt1n135
sAnt1n135 collected $0.25 from pot
sAnt1n135: doesn't show hand 
*** SUMMARY ***
Total pot $0.25 | Rake $0 
Seat 2: Eduard Gl (big blind) folded before Flop
Seat 4: Nikolay0816 folded before Flop (didn't bet)
Seat 5: sAnt1n135 (button) collected ($0.25)
Seat 6: nettasha (small blind) folded before Flop



PokerStars Hand #222970760854:  Hold'em No Limit ($0.05/$0.10 USD) - 2021/01/23 15:58:20 ET
Table 'Grus IV' 6-max Seat #6 is the button
Seat 2: Eduard Gl ($19.51 in chips) 
Seat 3: ImperialOxxx ($10 in chips) 
Seat 4: Nikolay0816 ($7.85 in chips) 
Seat 5: sAnt1n135 ($19.35 in chips) 
Seat 6: nettasha ($10 in chips) 
Eduard Gl: posts small blind $0.05
ImperialOxxx: posts big blind $0.10
*** HOLE CARDS ***
Nikolay0816: folds 
sAnt1n135: folds 
nettasha: folds 
Eduard Gl: raises $0.20 to $0.30
ImperialOxxx: folds 
Uncalled bet ($0.20) returned to Eduard Gl
Eduard Gl collected $0.20 from pot
Eduard Gl: doesn't show hand 
hempju1ce joins the table at seat #1 
*** SUMMARY ***
Total pot $0.20 | Rake $0 
Seat 2: Eduard Gl (small blind) collected ($0.20)
Seat 3: ImperialOxxx (big blind) folded before Flop
Seat 4: Nikolay0816 folded before Flop (didn't bet)
Seat 5: sAnt1n135 folded before Flop (didn't bet)
Seat 6: nettasha (button) folded before Flop (didn't bet)



PokerStars Hand #222970767374:  Hold'em No Limit ($0.05/$0.10 USD) - 2021/01/23 15:58:31 ET
Table 'Grus IV' 6-max Seat #2 is the button
Seat 2: Eduard Gl ($19.61 in chips) 
Seat 3: ImperialOxxx ($10 in chips) 
Seat 4: Nikolay0816 ($7.85 in chips) 
Seat 5: sAnt1n135 ($19.35 in chips) 
Seat 6: nettasha ($10 in chips) 
ImperialOxxx: posts small blind $0.05
Nikolay0816: posts big blind $0.10
hempju1ce: sits out 
*** HOLE CARDS ***
sAnt1n135: folds 
nettasha: folds 
Eduard Gl: folds 
ImperialOxxx: raises $0.15 to $0.25
Nikolay0816: raises $0.15 to $0.40
ImperialOxxx: calls $0.15
*** FLOP *** [4c 4s 7c]
ImperialOxxx: checks 
Nikolay0816: bets $0.38
ImperialOxxx: calls $0.38
*** TURN *** [4c 4s 7c] [Kd]
ImperialOxxx: checks 
Nikolay0816: bets $1.49
ImperialOxxx: folds 
Uncalled bet ($1.49) returned to Nikolay0816
Nikolay0816 collected $1.49 from pot
*** SUMMARY ***
Total pot $1.56 | Rake $0.07 
Board [4c 4s 7c Kd]
Seat 2: Eduard Gl (button) folded before Flop (didn't bet)
Seat 3: ImperialOxxx (small blind) folded on the Turn
Seat 4: Nikolay0816 (big blind) collected ($1.49)
Seat 5: sAnt1n135 folded before Flop (didn't bet)
Seat 6: nettasha folded before Flop (didn't bet)



PokerStars Hand #222970790136:  Hold'em No Limit ($0.05/$0.10 USD) - 2021/01/23 15:59:11 ET
Table 'Grus IV' 6-max Seat #3 is the button
Seat 2: Eduard Gl ($19.61 in chips) 
Seat 3: ImperialOxxx ($10 in chips) 
Seat 4: Nikolay0816 ($8.56 in chips) 
Seat 5: sAnt1n135 ($19.35 in chips) 
Seat 6: nettasha ($10 in chips) 
Nikolay0816: posts small blind $0.05
sAnt1n135: posts big blind $0.10
hempju1ce: sits out 
*** HOLE CARDS ***
nettasha: folds 
Eduard Gl: folds 
ImperialOxxx: folds 
Nikolay0816: folds 
Uncalled bet ($0.05) returned to sAnt1n135
sAnt1n135 collected $0.10 from pot
sAnt1n135: doesn't show hand 
*** SUMMARY ***
Total pot $0.10 | Rake $0 
Seat 2: Eduard Gl folded before Flop (didn't bet)
Seat 3: ImperialOxxx (button) folded before Flop (didn't bet)
Seat 4: Nikolay0816 (small blind) folded before Flop
Seat 5: sAnt1n135 (big blind) collected ($0.10)
Seat 6: nettasha folded before Flop (didn't bet)



PokerStars Hand #222970797568:  Hold'em No Limit ($0.05/$0.10 USD) - 2021/01/23 15:59:24 ET
Table 'Grus IV' 6-max Seat #4 is the button
Seat 2: Eduard Gl ($19.61 in chips) 
Seat 3: ImperialOxxx ($10 in chips) 
Seat 4: Nikolay0816 ($8.51 in chips) 
Seat 5: sAnt1n135 ($19.40 in chips) 
Seat 6: nettasha ($10 in chips) 
sAnt1n135: posts small blind $0.05
nettasha: posts big blind $0.10
hempju1ce: sits out 
*** HOLE CARDS ***
Eduard Gl: folds 
ImperialOxxx: folds 
Nikolay0816: folds 
sAnt1n135: folds 
Uncalled bet ($0.05) returned to nettasha
nettasha collected $0.10 from pot
nettasha: doesn't show hand 
*** SUMMARY ***
Total pot $0.10 | Rake $0 
Seat 2: Eduard Gl folded before Flop (didn't bet)
Seat 3: ImperialOxxx folded before Flop (didn't bet)
Seat 4: Nikolay0816 (button) folded before Flop (didn't bet)
Seat 5: sAnt1n135 (small blind) folded before Flop
Seat 6: nettasha (big blind) collected ($0.10)



PokerStars Hand #222970802610:  Hold'em No Limit ($0.05/$0.10 USD) - 2021/01/23 15:59:33 ET
Table 'Grus IV' 6-max Seat #5 is the button
Seat 1: hempju1ce ($10 in chips) 
Seat 2: Eduard Gl ($19.61 in chips) 
Seat 3: ImperialOxxx ($10 in chips) 
Seat 4: Nikolay0816 ($8.51 in chips) 
Seat 5: sAnt1n135 ($19.35 in chips) 
Seat 6: nettasha ($10.05 in chips) 
nettasha: posts small blind $0.05
hempju1ce: posts big blind $0.10
*** HOLE CARDS ***
Eduard Gl: folds 
ImperialOxxx: folds 
Nikolay0816: calls $0.10
sAnt1n135: folds 
nettasha: raises $0.40 to $0.50
hempju1ce: raises $0.40 to $0.90
Nikolay0816: calls $0.80
nettasha: calls $0.40
*** FLOP *** [3d 2h Qs]
nettasha: checks 
hempju1ce: bets $2.58
Nikolay0816: raises $2.58 to $5.16
nettasha: folds 
hempju1ce: raises $3.94 to $9.10 and is all-in
Nikolay0816: calls $2.45 and is all-in
Uncalled bet ($1.49) returned to hempju1ce
*** TURN *** [3d 2h Qs] [2c]
*** RIVER *** [3d 2h Qs 2c] [7d]
*** SHOW DOWN ***
hempju1ce: shows [Ac As] (two pair, Aces and Deuces)
Nikolay0816: shows [Kd Kh] (two pair, Kings and Deuces)
hempju1ce collected $17.11 from pot
*** SUMMARY ***
Total pot $17.92 | Rake $0.81 
Board [3d 2h Qs 2c 7d]
Seat 1: hempju1ce (big blind) showed [Ac As] and won ($17.11) with two pair, Aces and Deuces
Seat 2: Eduard Gl folded before Flop (didn't bet)
Seat 3: ImperialOxxx folded before Flop (didn't bet)
Seat 4: Nikolay0816 showed [Kd Kh] and lost with two pair, Kings and Deuces
Seat 5: sAnt1n135 (button) folded before Flop (didn't bet)
Seat 6: nettasha (small blind) folded on the Flop



PokerStars Hand #222970838632:  Hold'em No Limit ($0.05/$0.10 USD) - 2021/01/23 16:00:33 ET
Table 'Grus IV' 6-max Seat #6 is the button
Seat 1: hempju1ce ($18.60 in chips) 
Seat 2: Eduard Gl ($19.61 in chips) 
Seat 3: ImperialOxxx ($10 in chips) 
Seat 5: sAnt1n135 ($19.35 in chips) 
Seat 6: nettasha ($10 in chips) 
hempju1ce: posts small blind $0.05
Eduard Gl: posts big blind $0.10
*** HOLE CARDS ***
Nikolay0816 leaves the table
ImperialOxxx: folds 
sAnt1n135: folds 
nettasha: folds 
hempju1ce: calls $0.05
Eduard Gl: checks 
*** FLOP *** [2c 8s 4s]
hempju1ce: checks 
Eduard Gl: checks 
*** TURN *** [2c 8s 4s] [Ks]
hempju1ce: checks 
Eduard Gl: checks 
*** RIVER *** [2c 8s 4s Ks] [7h]
Impstool joins the table at seat #4 
hempju1ce: checks 
Eduard Gl: bets $0.10
hempju1ce: folds 
Uncalled bet ($0.10) returned to Eduard Gl
Eduard Gl collected $0.19 from pot
Eduard Gl: doesn't show hand 
*** SUMMARY ***
Total pot $0.20 | Rake $0.01 
Board [2c 8s 4s Ks 7h]
Seat 1: hempju1ce (small blind) folded on the River
Seat 2: Eduard Gl (big blind) collected ($0.19)
Seat 3: ImperialOxxx folded before Flop (didn't bet)
Seat 5: sAnt1n135 folded before Flop (didn't bet)
Seat 6: nettasha (button) folded before Flop (didn't bet)



PokerStars Hand #222970863347:  Hold'em No Limit ($0.05/$0.10 USD) - 2021/01/23 16:01:11 ET
Table 'Grus IV' 6-max Seat #1 is the button
Seat 1: hempju1ce ($18.50 in chips) 
Seat 2: Eduard Gl ($19.70 in chips) 
Seat 3: ImperialOxxx ($10 in chips) 
Seat 5: sAnt1n135 ($19.35 in chips) 
Seat 6: nettasha ($10 in chips) 
Eduard Gl: posts small blind $0.05
ImperialOxxx: posts big blind $0.10
Impstool: sits out 
*** HOLE CARDS ***
sAnt1n135: folds 
nettasha: folds 
hempju1ce: raises $0.20 to $0.30
Eduard Gl: folds 
ImperialOxxx: calls $0.20
*** FLOP *** [6s 3s 5d]
ImperialOxxx: checks 
hempju1ce: checks 
*** TURN *** [6s 3s 5d] [9c]
ImperialOxxx: bets $0.40
hempju1ce: calls $0.40
*** RIVER *** [6s 3s 5d 9c] [4c]
ImperialOxxx: checks 
hempju1ce: bets $1.38
ImperialOxxx: folds 
Uncalled bet ($1.38) returned to hempju1ce
hempju1ce collected $1.38 from pot
hempju1ce: doesn't show hand 
*** SUMMARY ***
Total pot $1.45 | Rake $0.07 
Board [6s 3s 5d 9c 4c]
Seat 1: hempju1ce (button) collected ($1.38)
Seat 2: Eduard Gl (small blind) folded before Flop
Seat 3: ImperialOxxx (big blind) folded on the River
Seat 5: sAnt1n135 folded before Flop (didn't bet)
Seat 6: nettasha folded before Flop (didn't bet)



PokerStars Hand #222970896686:  Hold'em No Limit ($0.05/$0.10 USD) - 2021/01/23 16:01:58 ET
Table 'Grus IV' 6-max Seat #2 is the button
Seat 1: hempju1ce ($19.18 in chips) 
Seat 2: Eduard Gl ($19.65 in chips) 
Seat 3: ImperialOxxx ($10 in chips) 
Seat 4: Impstool ($4 in chips) 
Seat 5: sAnt1n135 ($19.35 in chips) 
Seat 6: nettasha ($10 in chips) 
ImperialOxxx: posts small blind $0.05
Impstool: posts big blind $0.10
*** HOLE CARDS ***
sAnt1n135: raises $0.20 to $0.30
nettasha: folds 
hempju1ce: folds 
Eduard Gl: raises $0.75 to $1.05
ImperialOxxx: folds 
Impstool: folds 
sAnt1n135: raises $1.35 to $2.40
Eduard Gl: calls $1.35
*** FLOP *** [Jc 2h 3c]
sAnt1n135: bets $1.56
Eduard Gl: raises $15.69 to $17.25 and is all-in
sAnt1n135: calls $15.39 and is all-in
Uncalled bet ($0.30) returned to Eduard Gl
*** TURN *** [Jc 2h 3c] [Qs]
*** RIVER *** [Jc 2h 3c Qs] [Kd]
*** SHOW DOWN ***
sAnt1n135: shows [Jh Js] (three of a kind, Jacks)
Eduard Gl: shows [Ah Jd] (a pair of Jacks)
sAnt1n135 collected $37.35 from pot
Eduard Gl cashed out the hand for $0.70 | Cash Out Fee $0.01
*** SUMMARY ***
Total pot $38.85 | Rake $1.50 
Board [Jc 2h 3c Qs Kd]
Seat 1: hempju1ce folded before Flop (didn't bet)
Seat 2: Eduard Gl (button) showed [Ah Jd] and lost with a pair of Jacks (cashed out).
Seat 3: ImperialOxxx (small blind) folded before Flop
Seat 4: Impstool (big blind) folded before Flop
Seat 5: sAnt1n135 showed [Jh Js] and won ($37.35) with three of a kind, Jacks
Seat 6: nettasha folded before Flop (didn't bet)



PokerStars Hand #222970928357:  Hold'em No Limit ($0.05/$0.10 USD) - 2021/01/23 16:02:38 ET
Table 'Grus IV' 6-max Seat #3 is the button
Seat 1: hempju1ce ($19.18 in chips) 
Seat 2: Eduard Gl ($10 in chips) 
Seat 3: ImperialOxxx ($10 in chips) 
Seat 4: Impstool ($3.90 in chips) 
Seat 5: sAnt1n135 ($37.35 in chips) 
Seat 6: nettasha ($10 in chips) 
Impstool: posts small blind $0.05
sAnt1n135: posts big blind $0.10
*** HOLE CARDS ***
nettasha: folds 
hempju1ce: folds 
Eduard Gl: raises $0.25 to $0.35
ImperialOxxx: folds 
Impstool: calls $0.30
sAnt1n135: folds 
*** FLOP *** [2d 4s Qs]
Impstool: bets $0.70
Eduard Gl: folds 
Uncalled bet ($0.70) returned to Impstool
Impstool collected $0.76 from pot
Impstool: doesn't show hand 
*** SUMMARY ***
Total pot $0.80 | Rake $0.04 
Board [2d 4s Qs]
Seat 1: hempju1ce folded before Flop (didn't bet)
Seat 2: Eduard Gl folded on the Flop
Seat 3: ImperialOxxx (button) folded before Flop (didn't bet)
Seat 4: Impstool (small blind) collected ($0.76)
Seat 5: sAnt1n135 (big blind) folded before Flop
Seat 6: nettasha folded before Flop (didn't bet)



PokerStars Hand #222970951109:  Hold'em No Limit ($0.05/$0.10 USD) - 2021/01/23 16:03:06 ET
Table 'Grus IV' 6-max Seat #4 is the button
Seat 1: hempju1ce ($19.18 in chips) 
Seat 2: Eduard Gl ($10 in chips) 
Seat 3: ImperialOxxx ($10 in chips) 
Seat 4: Impstool ($4.31 in chips) 
Seat 5: sAnt1n135 ($37.25 in chips) 
Seat 6: nettasha ($10 in chips) 
sAnt1n135: posts small blind $0.05
nettasha: posts big blind $0.10
*** HOLE CARDS ***
hempju1ce: folds 
Eduard Gl: raises $0.20 to $0.30
ImperialOxxx: folds 
Impstool: calls $0.30
sAnt1n135: folds 
nettasha: folds 
*** FLOP *** [Qh 7c 3s]
Eduard Gl: bets $0.40
Impstool: raises $1.52 to $1.92
Eduard Gl: folds 
Uncalled bet ($1.52) returned to Impstool
Impstool collected $1.48 from pot
Impstool: doesn't show hand 
*** SUMMARY ***
Total pot $1.55 | Rake $0.07 
Board [Qh 7c 3s]
Seat 1: hempju1ce folded before Flop (didn't bet)
Seat 2: Eduard Gl folded on the Flop
Seat 3: ImperialOxxx folded before Flop (didn't bet)
Seat 4: Impstool (button) collected ($1.48)
Seat 5: sAnt1n135 (small blind) folded before Flop
Seat 6: nettasha (big blind) folded before Flop



PokerStars Hand #222970970669:  Hold'em No Limit ($0.05/$0.10 USD) - 2021/01/23 16:03:30 ET
Table 'Grus IV' 6-max Seat #5 is the button
Seat 1: hempju1ce ($19.18 in chips) 
Seat 2: Eduard Gl ($10 in chips) 
Seat 3: ImperialOxxx ($10 in chips) 
Seat 4: Impstool ($5.09 in chips) 
Seat 5: sAnt1n135 ($37.20 in chips) 
Seat 6: nettasha ($10 in chips) 
nettasha: posts small blind $0.05
hempju1ce: posts big blind $0.10
*** HOLE CARDS ***
Eduard Gl: folds 
ImperialOxxx: folds 
Impstool: folds 
sAnt1n135: folds 
nettasha: raises $0.15 to $0.25
hempju1ce: calls $0.15
*** FLOP *** [2s 2c Tc]
nettasha: checks 
hempju1ce: checks 
*** TURN *** [2s 2c Tc] [8c]
nettasha: bets $0.32
hempju1ce: calls $0.32
*** RIVER *** [2s 2c Tc 8c] [Ah]
nettasha: checks 
hempju1ce: bets $1.09
nettasha: folds 
Uncalled bet ($1.09) returned to hempju1ce
hempju1ce collected $1.09 from pot
hempju1ce: doesn't show hand 
*** SUMMARY ***
Total pot $1.14 | Rake $0.05 
Board [2s 2c Tc 8c Ah]
Seat 1: hempju1ce (big blind) collected ($1.09)
Seat 2: Eduard Gl folded before Flop (didn't bet)
Seat 3: ImperialOxxx folded before Flop (didn't bet)
Seat 4: Impstool folded before Flop (didn't bet)
Seat 5: sAnt1n135 (button) folded before Flop (didn't bet)
Seat 6: nettasha (small blind) folded on the River



PokerStars Hand #222971001248:  Hold'em No Limit ($0.05/$0.10 USD) - 2021/01/23 16:04:07 ET
Table 'Grus IV' 6-max Seat #6 is the button
Seat 1: hempju1ce ($19.70 in chips) 
Seat 2: Eduard Gl ($10 in chips) 
Seat 3: ImperialOxxx ($10 in chips) 
Seat 4: Impstool ($5.09 in chips) 
Seat 5: sAnt1n135 ($37.20 in chips) 
Seat 6: nettasha ($10 in chips) 
hempju1ce: posts small blind $0.05
Eduard Gl: posts big blind $0.10
*** HOLE CARDS ***
ImperialOxxx: folds 
Impstool: raises $0.10 to $0.20
sAnt1n135: raises $0.50 to $0.70
nettasha: folds 
hempju1ce: folds 
Eduard Gl: folds 
Impstool: calls $0.50
*** FLOP *** [Qs 5d 2d]
Impstool: bets $0.70
sAnt1n135: folds 
Uncalled bet ($0.70) returned to Impstool
Impstool collected $1.48 from pot
Impstool: doesn't show hand 
*** SUMMARY ***
Total pot $1.55 | Rake $0.07 
Board [Qs 5d 2d]
Seat 1: hempju1ce (small blind) folded before Flop
Seat 2: Eduard Gl (big blind) folded before Flop
Seat 3: ImperialOxxx folded before Flop (didn't bet)
Seat 4: Impstool collected ($1.48)
Seat 5: sAnt1n135 folded on the Flop
Seat 6: nettasha (button) folded before Flop (didn't bet)



PokerStars Hand #222971032861:  Hold'em No Limit ($0.05/$0.10 USD) - 2021/01/23 16:04:45 ET
Table 'Grus IV' 6-max Seat #1 is the button
Seat 1: hempju1ce ($19.65 in chips) 
Seat 2: Eduard Gl ($10 in chips) 
Seat 3: ImperialOxxx ($10 in chips) 
Seat 4: Impstool ($5.87 in chips) 
Seat 5: sAnt1n135 ($36.50 in chips) 
Seat 6: nettasha ($10 in chips) 
Eduard Gl: posts small blind $0.05
ImperialOxxx: posts big blind $0.10
*** HOLE CARDS ***
Impstool: folds 
sAnt1n135: folds 
nettasha: folds 
hempju1ce: folds 
Eduard Gl: folds 
Uncalled bet ($0.05) returned to ImperialOxxx
ImperialOxxx collected $0.10 from pot
ImperialOxxx: doesn't show hand 
*** SUMMARY ***
Total pot $0.10 | Rake $0 
Seat 1: hempju1ce (button) folded before Flop (didn't bet)
Seat 2: Eduard Gl (small blind) folded before Flop
Seat 3: ImperialOxxx (big blind) collected ($0.10)
Seat 4: Impstool folded before Flop (didn't bet)
Seat 5: sAnt1n135 folded before Flop (didn't bet)
Seat 6: nettasha folded before Flop (didn't bet)



PokerStars Hand #222971050304:  Hold'em No Limit ($0.05/$0.10 USD) - 2021/01/23 16:05:06 ET
Table 'Grus IV' 6-max Seat #2 is the button
Seat 1: hempju1ce ($19.65 in chips) 
Seat 2: Eduard Gl ($10 in chips) 
Seat 3: ImperialOxxx ($10.05 in chips) 
Seat 4: Impstool ($5.87 in chips) 
Seat 5: sAnt1n135 ($36.50 in chips) 
Seat 6: nettasha ($10 in chips) 
ImperialOxxx: posts small blind $0.05
Impstool: posts big blind $0.10
*** HOLE CARDS ***
sAnt1n135: raises $0.20 to $0.30
nettasha: folds 
hempju1ce: folds 
Eduard Gl: folds 
ImperialOxxx: folds 
Impstool: folds 
Uncalled bet ($0.20) returned to sAnt1n135
sAnt1n135 collected $0.25 from pot
sAnt1n135: doesn't show hand 
*** SUMMARY ***
Total pot $0.25 | Rake $0 
Seat 1: hempju1ce folded before Flop (didn't bet)
Seat 2: Eduard Gl (button) folded before Flop (didn't bet)
Seat 3: ImperialOxxx (small blind) folded before Flop
Seat 4: Impstool (big blind) folded before Flop
Seat 5: sAnt1n135 collected ($0.25)
Seat 6: nettasha folded before Flop (didn't bet)



PokerStars Hand #222971072982:  Hold'em No Limit ($0.05/$0.10 USD) - 2021/01/23 16:05:33 ET
Table 'Grus IV' 6-max Seat #3 is the button
Seat 1: hempju1ce ($19.65 in chips) 
Seat 2: Eduard Gl ($10 in chips) 
Seat 3: ImperialOxxx ($10 in chips) 
Seat 4: Impstool ($5.77 in chips) 
Seat 5: sAnt1n135 ($36.65 in chips) 
Seat 6: nettasha ($10 in chips) 
Impstool: posts small blind $0.05
sAnt1n135: posts big blind $0.10
*** HOLE CARDS ***
nettasha: folds 
hempju1ce: folds 
Eduard Gl: folds 
ImperialOxxx: folds 
Impstool: folds 
Uncalled bet ($0.05) returned to sAnt1n135
sAnt1n135 collected $0.10 from pot
sAnt1n135: doesn't show hand 
*** SUMMARY ***
Total pot $0.10 | Rake $0 
Seat 1: hempju1ce folded before Flop (didn't bet)
Seat 2: Eduard Gl folded before Flop (didn't bet)
Seat 3: ImperialOxxx (button) folded before Flop (didn't bet)
Seat 4: Impstool (small blind) folded before Flop
Seat 5: sAnt1n135 (big blind) collected ($0.10)
Seat 6: nettasha folded before Flop (didn't bet)



PokerStars Hand #222971085559:  Hold'em No Limit ($0.05/$0.10 USD) - 2021/01/23 16:05:48 ET
Table 'Grus IV' 6-max Seat #4 is the button
Seat 1: hempju1ce ($19.65 in chips) 
Seat 2: Eduard Gl ($10 in chips) 
Seat 3: ImperialOxxx ($10 in chips) 
Seat 4: Impstool ($5.72 in chips) 
Seat 5: sAnt1n135 ($36.70 in chips) 
Seat 6: nettasha ($10 in chips) 
sAnt1n135: posts small blind $0.05
nettasha: posts big blind $0.10
*** HOLE CARDS ***
hempju1ce: folds 
Eduard Gl: folds 
ImperialOxxx: raises $0.15 to $0.25
Impstool: folds 
sAnt1n135: folds 
nettasha: folds 
Uncalled bet ($0.15) returned to ImperialOxxx
ImperialOxxx collected $0.25 from pot
ImperialOxxx: doesn't show hand 
*** SUMMARY ***
Total pot $0.25 | Rake $0 
Seat 1: hempju1ce folded before Flop (didn't bet)
Seat 2: Eduard Gl folded before Flop (didn't bet)
Seat 3: ImperialOxxx collected ($0.25)
Seat 4: Impstool (button) folded before Flop (didn't bet)
Seat 5: sAnt1n135 (small blind) folded before Flop
Seat 6: nettasha (big blind) folded before Flop



PokerStars Hand #222971115623:  Hold'em No Limit ($0.05/$0.10 USD) - 2021/01/23 16:06:24 ET
Table 'Grus IV' 6-max Seat #5 is the button
Seat 1: hempju1ce ($19.65 in chips) 
Seat 2: Eduard Gl ($10 in chips) 
Seat 3: ImperialOxxx ($10.15 in chips) 
Seat 4: Impstool ($5.72 in chips) 
Seat 5: sAnt1n135 ($36.65 in chips) 
Seat 6: nettasha ($10 in chips) 
nettasha: posts small blind $0.05
hempju1ce: posts big blind $0.10
*** HOLE CARDS ***
Eduard Gl: folds 
ImperialOxxx: folds 
Impstool: folds 
sAnt1n135: folds 
nettasha: raises $0.15 to $0.25
hempju1ce: folds 
Uncalled bet ($0.15) returned to nettasha
nettasha collected $0.20 from pot
nettasha: doesn't show hand 
*** SUMMARY ***
Total pot $0.20 | Rake $0 
Seat 1: hempju1ce (big blind) folded before Flop
Seat 2: Eduard Gl folded before Flop (didn't bet)
Seat 3: ImperialOxxx folded before Flop (didn't bet)
Seat 4: Impstool folded before Flop (didn't bet)
Seat 5: sAnt1n135 (button) folded before Flop (didn't bet)
Seat 6: nettasha (small blind) collected ($0.20)



PokerStars Hand #222971155161:  Hold'em No Limit ($0.05/$0.10 USD) - 2021/01/23 16:07:11 ET
Table 'Grus IV' 6-max Seat #6 is the button
Seat 1: hempju1ce ($19.55 in chips) 
Seat 2: Eduard Gl ($10 in chips) 
Seat 3: ImperialOxxx ($10.15 in chips) 
Seat 4: Impstool ($5.72 in chips) 
Seat 5: sAnt1n135 ($36.65 in chips) 
Seat 6: nettasha ($10.10 in chips) 
hempju1ce: posts small blind $0.05
Eduard Gl: posts big blind $0.10
*** HOLE CARDS ***
ImperialOxxx: folds 
Impstool: folds 
sAnt1n135: folds 
nettasha: folds 
hempju1ce: calls $0.05
Eduard Gl: raises $0.50 to $0.60
hempju1ce: folds 
Uncalled bet ($0.50) returned to Eduard Gl
Eduard Gl collected $0.20 from pot
Eduard Gl: doesn't show hand 
*** SUMMARY ***
Total pot $0.20 | Rake $0 
Seat 1: hempju1ce (small blind) folded before Flop
Seat 2: Eduard Gl (big blind) collected ($0.20)
Seat 3: ImperialOxxx folded before Flop (didn't bet)
Seat 4: Impstool folded before Flop (didn't bet)
Seat 5: sAnt1n135 folded before Flop (didn't bet)
Seat 6: nettasha (button) folded before Flop (didn't bet)



PokerStars Hand #222971174461:  Hold'em No Limit ($0.05/$0.10 USD) - 2021/01/23 16:07:34 ET
Table 'Grus IV' 6-max Seat #1 is the button
Seat 1: hempju1ce ($19.45 in chips) 
Seat 2: Eduard Gl ($10.10 in chips) 
Seat 3: ImperialOxxx ($10.15 in chips) 
Seat 4: Impstool ($5.72 in chips) 
Seat 5: sAnt1n135 ($36.65 in chips) 
Seat 6: nettasha ($10.10 in chips) 
Eduard Gl: posts small blind $0.05
ImperialOxxx: posts big blind $0.10
*** HOLE CARDS ***
Impstool: raises $0.20 to $0.30
sAnt1n135: folds 
nettasha: folds 
hempju1ce: folds 
Eduard Gl: raises $0.70 to $1
ImperialOxxx: folds 
Impstool: calls $0.70
*** FLOP *** [4s 5s 7s]
Eduard Gl: checks 
Impstool: bets $1.01
Eduard Gl: raises $8.09 to $9.10 and is all-in
Impstool: folds 
Uncalled bet ($8.09) returned to Eduard Gl
Eduard Gl collected $3.93 from pot
Eduard Gl: doesn't show hand 
*** SUMMARY ***
Total pot $4.12 | Rake $0.19 
Board [4s 5s 7s]
Seat 1: hempju1ce (button) folded before Flop (didn't bet)
Seat 2: Eduard Gl (small blind) collected ($3.93)
Seat 3: ImperialOxxx (big blind) folded before Flop
Seat 4: Impstool folded on the Flop
Seat 5: sAnt1n135 folded before Flop (didn't bet)
Seat 6: nettasha folded before Flop (didn't bet)



PokerStars Hand #222971465796:  Hold'em No Limit ($0.05/$0.10 USD) - 2021/01/23 16:13:16 ET
Table 'Grus IV' 6-max Seat #4 is the button
Seat 1: hempju1ce ($19 in chips) 
Seat 2: Eduard Gl ($10 in chips) 
Seat 3: ImperialOxxx ($11.32 in chips) 
Seat 4: 311420212216613 ($10 in chips) 
Seat 5: sAnt1n135 ($40.93 in chips) 
sAnt1n135: posts small blind $0.05
nettasha: is sitting out 
hempju1ce: posts big blind $0.10
*** HOLE CARDS ***
nettasha leaves the table
Eduard Gl: folds 
ImperialOxxx: raises $0.15 to $0.25
311420212216613: folds 
sAnt1n135: folds 
hempju1ce: calls $0.15
*** FLOP *** [4s 7c 6h]
hempju1ce: bets $0.30
ImperialOxxx: calls $0.30
*** TURN *** [4s 7c 6h] [3s]
starikan872 joins the table at seat #6 
hempju1ce: bets $0.55
ImperialOxxx: folds 
Uncalled bet ($0.55) returned to hempju1ce
hempju1ce collected $1.10 from pot
hempju1ce: doesn't show hand 
*** SUMMARY ***
Total pot $1.15 | Rake $0.05 
Board [4s 7c 6h 3s]
Seat 1: hempju1ce (big blind) collected ($1.10)
Seat 2: Eduard Gl folded before Flop (didn't bet)
Seat 3: ImperialOxxx folded on the Turn
Seat 4: 311420212216613 (button) folded before Flop (didn't bet)
Seat 5: sAnt1n135 (small blind) folded before Flop



PokerStars Hand #222971493917:  Hold'em No Limit ($0.05/$0.10 USD) - 2021/01/23 16:13:50 ET
Table 'Grus IV' 6-max Seat #5 is the button
Seat 1: hempju1ce ($19.55 in chips) 
Seat 2: Eduard Gl ($10 in chips) 
Seat 3: ImperialOxxx ($10.77 in chips) 
Seat 4: 311420212216613 ($10 in chips) 
Seat 5: sAnt1n135 ($40.88 in chips) 
hempju1ce: posts small blind $0.05
Eduard Gl: posts big blind $0.10
*** HOLE CARDS ***
ImperialOxxx: folds 
311420212216613: raises $0.12 to $0.22
sAnt1n135: folds 
hempju1ce: folds 
Eduard Gl: raises $0.68 to $0.90
311420212216613: folds 
Uncalled bet ($0.68) returned to Eduard Gl
Eduard Gl collected $0.49 from pot
Eduard Gl: doesn't show hand 
*** SUMMARY ***
Total pot $0.49 | Rake $0 
Seat 1: hempju1ce (small blind) folded before Flop
Seat 2: Eduard Gl (big blind) collected ($0.49)
Seat 3: ImperialOxxx folded before Flop (didn't bet)
Seat 4: 311420212216613 folded before Flop
Seat 5: sAnt1n135 (button) folded before Flop (didn't bet)



PokerStars Hand #222971527031:  Hold'em No Limit ($0.05/$0.10 USD) - 2021/01/23 16:14:30 ET
Table 'Grus IV' 6-max Seat #1 is the button
Seat 1: hempju1ce ($19.50 in chips) 
Seat 2: Eduard Gl ($10.27 in chips) 
Seat 3: ImperialOxxx ($10.77 in chips) 
Seat 4: 311420212216613 ($10 in chips) 
Seat 5: sAnt1n135 ($40.88 in chips) 
Eduard Gl: posts small blind $0.05
ImperialOxxx: posts big blind $0.10
starikan872: sits out 
*** HOLE CARDS ***
311420212216613: folds 
sAnt1n135: folds 
hempju1ce: raises $0.20 to $0.30
Eduard Gl: folds 
ImperialOxxx: calls $0.20
*** FLOP *** [Th Kh 9c]
ImperialOxxx: checks 
hempju1ce: checks 
*** TURN *** [Th Kh 9c] [5c]
ImperialOxxx: checks 
hempju1ce: checks 
*** RIVER *** [Th Kh 9c 5c] [4h]
ImperialOxxx: checks 
hempju1ce: checks 
*** SHOW DOWN ***
ImperialOxxx: shows [Ah 6d] (high card Ace)
hempju1ce: shows [Ad Jh] (high card Ace - King+Jack kicker)
hempju1ce collected $0.62 from pot
*** SUMMARY ***
Total pot $0.65 | Rake $0.03 
Board [Th Kh 9c 5c 4h]
Seat 1: hempju1ce (button) showed [Ad Jh] and won ($0.62) with high card Ace
Seat 2: Eduard Gl (small blind) folded before Flop
Seat 3: ImperialOxxx (big blind) showed [Ah 6d] and lost with high card Ace
Seat 4: 311420212216613 folded before Flop (didn't bet)
Seat 5: sAnt1n135 folded before Flop (didn't bet)



PokerStars Hand #222971547172:  Hold'em No Limit ($0.05/$0.10 USD) - 2021/01/23 16:14:54 ET
Table 'Grus IV' 6-max Seat #2 is the button
Seat 1: hempju1ce ($19.82 in chips) 
Seat 2: Eduard Gl ($10.22 in chips) 
Seat 3: ImperialOxxx ($10.47 in chips) 
Seat 4: 311420212216613 ($10 in chips) 
Seat 5: sAnt1n135 ($40.88 in chips) 
ImperialOxxx: posts small blind $0.05
311420212216613: posts big blind $0.10
starikan872: sits out 
*** HOLE CARDS ***
sAnt1n135: folds 
hempju1ce: folds 
Eduard Gl: folds 
ImperialOxxx: raises $0.15 to $0.25
311420212216613: folds 
Uncalled bet ($0.15) returned to ImperialOxxx
ImperialOxxx collected $0.20 from pot
ImperialOxxx: doesn't show hand 
*** SUMMARY ***
Total pot $0.20 | Rake $0 
Seat 1: hempju1ce folded before Flop (didn't bet)
Seat 2: Eduard Gl (button) folded before Flop (didn't bet)
Seat 3: ImperialOxxx (small blind) collected ($0.20)
Seat 4: 311420212216613 (big blind) folded before Flop
Seat 5: sAnt1n135 folded before Flop (didn't bet)



PokerStars Hand #222971556663:  Hold'em No Limit ($0.05/$0.10 USD) - 2021/01/23 16:15:06 ET
Table 'Grus IV' 6-max Seat #3 is the button
Seat 1: hempju1ce ($19.82 in chips) 
Seat 2: Eduard Gl ($10.22 in chips) 
Seat 3: ImperialOxxx ($10.57 in chips) 
Seat 4: 311420212216613 ($10 in chips) 
Seat 5: sAnt1n135 ($40.88 in chips) 
311420212216613: posts small blind $0.05
sAnt1n135: posts big blind $0.10
starikan872: sits out 
*** HOLE CARDS ***
hempju1ce: calls $0.10
Eduard Gl: folds 
ImperialOxxx: folds 
311420212216613: folds 
sAnt1n135: checks 
*** FLOP *** [As 6h Tc]
sAnt1n135: checks 
hempju1ce: bets $0.20
sAnt1n135: folds 
Uncalled bet ($0.20) returned to hempju1ce
hempju1ce collected $0.24 from pot
hempju1ce: doesn't show hand 
*** SUMMARY ***
Total pot $0.25 | Rake $0.01 
Board [As 6h Tc]
Seat 1: hempju1ce collected ($0.24)
Seat 2: Eduard Gl folded before Flop (didn't bet)
Seat 3: ImperialOxxx (button) folded before Flop (didn't bet)
Seat 4: 311420212216613 (small blind) folded before Flop
Seat 5: sAnt1n135 (big blind) folded on the Flop



PokerStars Hand #222971581243:  Hold'em No Limit ($0.05/$0.10 USD) - 2021/01/23 16:15:34 ET
Table 'Grus IV' 6-max Seat #4 is the button
Seat 1: hempju1ce ($19.96 in chips) 
Seat 2: Eduard Gl ($10.22 in chips) 
Seat 3: ImperialOxxx ($10.57 in chips) 
Seat 4: 311420212216613 ($10 in chips) 
Seat 5: sAnt1n135 ($40.78 in chips) 
Seat 6: starikan872 ($10 in chips) 
sAnt1n135: posts small blind $0.05
starikan872: posts big blind $0.10
*** HOLE CARDS ***
hempju1ce: calls $0.10
Eduard Gl: folds 
ImperialOxxx: folds 
311420212216613: raises $0.30 to $0.40
sAnt1n135: raises $1 to $1.40
starikan872: folds 
hempju1ce: folds 
311420212216613: calls $1
*** FLOP *** [Kc 5c Jd]
sAnt1n135: bets $1.57
311420212216613: folds 
Uncalled bet ($1.57) returned to sAnt1n135
sAnt1n135 collected $2.86 from pot
sAnt1n135: doesn't show hand 
*** SUMMARY ***
Total pot $3 | Rake $0.14 
Board [Kc 5c Jd]
Seat 1: hempju1ce folded before Flop
Seat 2: Eduard Gl folded before Flop (didn't bet)
Seat 3: ImperialOxxx folded before Flop (didn't bet)
Seat 4: 311420212216613 (button) folded on the Flop
Seat 5: sAnt1n135 (small blind) collected ($2.86)
Seat 6: starikan872 (big blind) folded before Flop



PokerStars Hand #222971612263:  Hold'em No Limit ($0.05/$0.10 USD) - 2021/01/23 16:16:10 ET
Table 'Grus IV' 6-max Seat #5 is the button
Seat 1: hempju1ce ($19.86 in chips) 
Seat 2: Eduard Gl ($10.22 in chips) 
Seat 3: ImperialOxxx ($10.57 in chips) 
Seat 4: 311420212216613 ($10 in chips) 
Seat 5: sAnt1n135 ($42.24 in chips) 
Seat 6: starikan872 ($10 in chips) 
starikan872: posts small blind $0.05
hempju1ce: posts big blind $0.10
*** HOLE CARDS ***
Eduard Gl: folds 
ImperialOxxx: folds 
311420212216613: folds 
sAnt1n135: raises $0.13 to $0.23
starikan872: folds 
hempju1ce: calls $0.13
*** FLOP *** [Ks Jd Qs]
hempju1ce: checks 
sAnt1n135: checks 
*** TURN *** [Ks Jd Qs] [Ad]
hempju1ce: checks 
sAnt1n135: bets $0.37
hempju1ce: calls $0.37
*** RIVER *** [Ks Jd Qs Ad] [8c]
hempju1ce: checks 
sAnt1n135: bets $0.89
hempju1ce: calls $0.89
*** SHOW DOWN ***
sAnt1n135: shows [Th 7h] (a straight, Ten to Ace)
hempju1ce: mucks hand 
sAnt1n135 collected $2.89 from pot
*** SUMMARY ***
Total pot $3.03 | Rake $0.14 
Board [Ks Jd Qs Ad 8c]
Seat 1: hempju1ce (big blind) mucked
Seat 2: Eduard Gl folded before Flop (didn't bet)
Seat 3: ImperialOxxx folded before Flop (didn't bet)
Seat 4: 311420212216613 folded before Flop (didn't bet)
Seat 5: sAnt1n135 (button) showed [Th 7h] and won ($2.89) with a straight, Ten to Ace
Seat 6: starikan872 (small blind) folded before Flop



PokerStars Hand #222971659291:  Hold'em No Limit ($0.05/$0.10 USD) - 2021/01/23 16:17:05 ET
Table 'Grus IV' 6-max Seat #6 is the button
Seat 1: hempju1ce ($18.37 in chips) 
Seat 2: Eduard Gl ($10.22 in chips) 
Seat 3: ImperialOxxx ($10.57 in chips) 
Seat 4: 311420212216613 ($10 in chips) 
Seat 5: sAnt1n135 ($43.64 in chips) 
Seat 6: starikan872 ($10 in chips) 
hempju1ce: posts small blind $0.05
Eduard Gl: posts big blind $0.10
*** HOLE CARDS ***
ImperialOxxx: raises $0.15 to $0.25
311420212216613: folds 
sAnt1n135: folds 
starikan872: folds 
hempju1ce: folds 
Eduard Gl: folds 
Uncalled bet ($0.15) returned to ImperialOxxx
ImperialOxxx collected $0.25 from pot
ImperialOxxx: doesn't show hand 
*** SUMMARY ***
Total pot $0.25 | Rake $0 
Seat 1: hempju1ce (small blind) folded before Flop
Seat 2: Eduard Gl (big blind) folded before Flop
Seat 3: ImperialOxxx collected ($0.25)
Seat 4: 311420212216613 folded before Flop (didn't bet)
Seat 5: sAnt1n135 folded before Flop (didn't bet)
Seat 6: starikan872 (button) folded before Flop (didn't bet)



PokerStars Hand #222971676953:  Hold'em No Limit ($0.05/$0.10 USD) - 2021/01/23 16:17:26 ET
Table 'Grus IV' 6-max Seat #1 is the button
Seat 1: hempju1ce ($18.32 in chips) 
Seat 2: Eduard Gl ($10.12 in chips) 
Seat 3: ImperialOxxx ($10.72 in chips) 
Seat 4: 311420212216613 ($10 in chips) 
Seat 5: sAnt1n135 ($43.64 in chips) 
Seat 6: starikan872 ($10 in chips) 
Eduard Gl: posts small blind $0.05
ImperialOxxx: posts big blind $0.10
*** HOLE CARDS ***
311420212216613: folds 
sAnt1n135: folds 
starikan872: folds 
hempju1ce: folds 
Eduard Gl: raises $0.20 to $0.30
ImperialOxxx: folds 
Uncalled bet ($0.20) returned to Eduard Gl
Eduard Gl collected $0.20 from pot
Eduard Gl: doesn't show hand 
*** SUMMARY ***
Total pot $0.20 | Rake $0 
Seat 1: hempju1ce (button) folded before Flop (didn't bet)
Seat 2: Eduard Gl (small blind) collected ($0.20)
Seat 3: ImperialOxxx (big blind) folded before Flop
Seat 4: 311420212216613 folded before Flop (didn't bet)
Seat 5: sAnt1n135 folded before Flop (didn't bet)
Seat 6: starikan872 folded before Flop (didn't bet)



PokerStars Hand #222971685722:  Hold'em No Limit ($0.05/$0.10 USD) - 2021/01/23 16:17:36 ET
Table 'Grus IV' 6-max Seat #2 is the button
Seat 1: hempju1ce ($18.32 in chips) 
Seat 2: Eduard Gl ($10.22 in chips) 
Seat 3: ImperialOxxx ($10.62 in chips) 
Seat 4: 311420212216613 ($10 in chips) 
Seat 5: sAnt1n135 ($43.64 in chips) 
Seat 6: starikan872 ($10 in chips) 
ImperialOxxx: posts small blind $0.05
311420212216613: posts big blind $0.10
*** HOLE CARDS ***
sAnt1n135: folds 
starikan872: folds 
hempju1ce: raises $0.20 to $0.30
Eduard Gl: folds 
ImperialOxxx: folds 
311420212216613: folds 
Uncalled bet ($0.20) returned to hempju1ce
hempju1ce collected $0.25 from pot
hempju1ce: doesn't show hand 
*** SUMMARY ***
Total pot $0.25 | Rake $0 
Seat 1: hempju1ce collected ($0.25)
Seat 2: Eduard Gl (button) folded before Flop (didn't bet)
Seat 3: ImperialOxxx (small blind) folded before Flop
Seat 4: 311420212216613 (big blind) folded before Flop
Seat 5: sAnt1n135 folded before Flop (didn't bet)
Seat 6: starikan872 folded before Flop (didn't bet)



PokerStars Hand #222971701881:  Hold'em No Limit ($0.05/$0.10 USD) - 2021/01/23 16:17:54 ET
Table 'Grus IV' 6-max Seat #3 is the button
Seat 1: hempju1ce ($18.47 in chips) 
Seat 2: Eduard Gl ($10.22 in chips) 
Seat 3: ImperialOxxx ($10.57 in chips) 
Seat 4: 311420212216613 ($10 in chips) 
Seat 5: sAnt1n135 ($43.64 in chips) 
Seat 6: starikan872 ($10 in chips) 
311420212216613: posts small blind $0.05
sAnt1n135: posts big blind $0.10
*** HOLE CARDS ***
starikan872: folds 
hempju1ce: folds 
Eduard Gl: folds 
ImperialOxxx: folds 
311420212216613: folds 
Uncalled bet ($0.05) returned to sAnt1n135
sAnt1n135 collected $0.10 from pot
sAnt1n135: doesn't show hand 
*** SUMMARY ***
Total pot $0.10 | Rake $0 
Seat 1: hempju1ce folded before Flop (didn't bet)
Seat 2: Eduard Gl folded before Flop (didn't bet)
Seat 3: ImperialOxxx (button) folded before Flop (didn't bet)
Seat 4: 311420212216613 (small blind) folded before Flop
Seat 5: sAnt1n135 (big blind) collected ($0.10)
Seat 6: starikan872 folded before Flop (didn't bet)



PokerStars Hand #222971706658:  Hold'em No Limit ($0.05/$0.10 USD) - 2021/01/23 16:18:00 ET
Table 'Grus IV' 6-max Seat #4 is the button
Seat 1: hempju1ce ($18.47 in chips) 
Seat 2: Eduard Gl ($10.22 in chips) 
Seat 3: ImperialOxxx ($10.57 in chips) 
Seat 4: 311420212216613 ($10 in chips) 
Seat 5: sAnt1n135 ($43.69 in chips) 
Seat 6: starikan872 ($10 in chips) 
sAnt1n135: posts small blind $0.05
starikan872: posts big blind $0.10
*** HOLE CARDS ***
hempju1ce: calls $0.10
Eduard Gl: folds 
ImperialOxxx: folds 
311420212216613: raises $0.30 to $0.40
sAnt1n135: folds 
starikan872: folds 
hempju1ce: calls $0.30
*** FLOP *** [Ks Kh 9s]
hempju1ce: checks 
311420212216613: bets $0.30
hempju1ce: calls $0.30
*** TURN *** [Ks Kh 9s] [5s]
hempju1ce: bets $0.90
311420212216613: folds 
Uncalled bet ($0.90) returned to hempju1ce
hempju1ce collected $1.48 from pot
hempju1ce: doesn't show hand 
*** SUMMARY ***
Total pot $1.55 | Rake $0.07 
Board [Ks Kh 9s 5s]
Seat 1: hempju1ce collected ($1.48)
Seat 2: Eduard Gl folded before Flop (didn't bet)
Seat 3: ImperialOxxx folded before Flop (didn't bet)
Seat 4: 311420212216613 (button) folded on the Turn
Seat 5: sAnt1n135 (small blind) folded before Flop
Seat 6: starikan872 (big blind) folded before Flop



PokerStars Hand #222971756202:  Hold'em No Limit ($0.05/$0.10 USD) - 2021/01/23 16:18:57 ET
Table 'Grus IV' 6-max Seat #5 is the button
Seat 1: hempju1ce ($19.25 in chips) 
Seat 2: Eduard Gl ($10.22 in chips) 
Seat 3: ImperialOxxx ($10.57 in chips) 
Seat 4: 311420212216613 ($10 in chips) 
Seat 5: sAnt1n135 ($43.64 in chips) 
Seat 6: starikan872 ($10 in chips) 
starikan872: posts small blind $0.05
hempju1ce: posts big blind $0.10
*** HOLE CARDS ***
Eduard Gl: folds 
ImperialOxxx: folds 
311420212216613: folds 
sAnt1n135: folds 
starikan872: folds 
Uncalled bet ($0.05) returned to hempju1ce
hempju1ce collected $0.10 from pot
hempju1ce: doesn't show hand 
*** SUMMARY ***
Total pot $0.10 | Rake $0 
Seat 1: hempju1ce (big blind) collected ($0.10)
Seat 2: Eduard Gl folded before Flop (didn't bet)
Seat 3: ImperialOxxx folded before Flop (didn't bet)
Seat 4: 311420212216613 folded before Flop (didn't bet)
Seat 5: sAnt1n135 (button) folded before Flop (didn't bet)
Seat 6: starikan872 (small blind) folded before Flop



PokerStars Hand #222971762176:  Hold'em No Limit ($0.05/$0.10 USD) - 2021/01/23 16:19:04 ET
Table 'Grus IV' 6-max Seat #6 is the button
Seat 1: hempju1ce ($19.30 in chips) 
Seat 2: Eduard Gl ($10.22 in chips) 
Seat 3: ImperialOxxx ($10.57 in chips) 
Seat 4: 311420212216613 ($10 in chips) 
Seat 5: sAnt1n135 ($43.64 in chips) 
Seat 6: starikan872 ($10 in chips) 
hempju1ce: posts small blind $0.05
Eduard Gl: posts big blind $0.10
*** HOLE CARDS ***
ImperialOxxx: folds 
311420212216613: folds 
sAnt1n135: raises $0.20 to $0.30
starikan872: raises $0.60 to $0.90
hempju1ce: folds 
Eduard Gl: folds 
sAnt1n135: folds 
Uncalled bet ($0.60) returned to starikan872
starikan872 collected $0.75 from pot
starikan872: doesn't show hand 
*** SUMMARY ***
Total pot $0.75 | Rake $0 
Seat 1: hempju1ce (small blind) folded before Flop
Seat 2: Eduard Gl (big blind) folded before Flop
Seat 3: ImperialOxxx folded before Flop (didn't bet)
Seat 4: 311420212216613 folded before Flop (didn't bet)
Seat 5: sAnt1n135 folded before Flop
Seat 6: starikan872 (button) collected ($0.75)



PokerStars Hand #222971785536:  Hold'em No Limit ($0.05/$0.10 USD) - 2021/01/23 16:19:31 ET
Table 'Grus IV' 6-max Seat #1 is the button
Seat 1: hempju1ce ($19.25 in chips) 
Seat 2: Eduard Gl ($10.12 in chips) 
Seat 3: ImperialOxxx ($10.57 in chips) 
Seat 4: 311420212216613 ($10 in chips) 
Seat 5: sAnt1n135 ($43.34 in chips) 
Seat 6: starikan872 ($10.45 in chips) 
Eduard Gl: posts small blind $0.05
ImperialOxxx: posts big blind $0.10
*** HOLE CARDS ***
311420212216613: raises $0.12 to $0.22
sAnt1n135: folds 
starikan872: folds 
hempju1ce: folds 
Eduard Gl: folds 
ImperialOxxx: folds 
Uncalled bet ($0.12) returned to 311420212216613
311420212216613 collected $0.25 from pot
311420212216613: doesn't show hand 
*** SUMMARY ***
Total pot $0.25 | Rake $0 
Seat 1: hempju1ce (button) folded before Flop (didn't bet)
Seat 2: Eduard Gl (small blind) folded before Flop
Seat 3: ImperialOxxx (big blind) folded before Flop
Seat 4: 311420212216613 collected ($0.25)
Seat 5: sAnt1n135 folded before Flop (didn't bet)
Seat 6: starikan872 folded before Flop (didn't bet)



PokerStars Hand #222971795987:  Hold'em No Limit ($0.05/$0.10 USD) - 2021/01/23 16:19:43 ET
Table 'Grus IV' 6-max Seat #2 is the button
Seat 1: hempju1ce ($19.25 in chips) 
Seat 2: Eduard Gl ($10.07 in chips) 
Seat 3: ImperialOxxx ($10.47 in chips) 
Seat 4: 311420212216613 ($10.15 in chips) 
Seat 5: sAnt1n135 ($43.34 in chips) 
Seat 6: starikan872 ($10.45 in chips) 
ImperialOxxx: posts small blind $0.05
311420212216613: posts big blind $0.10
*** HOLE CARDS ***
sAnt1n135: folds 
starikan872: folds 
hempju1ce: calls $0.10
Eduard Gl: folds 
ImperialOxxx: folds 
311420212216613: checks 
*** FLOP *** [2c 9d 7h]
311420212216613: checks 
hempju1ce: checks 
*** TURN *** [2c 9d 7h] [8d]
311420212216613: checks 
hempju1ce: checks 
*** RIVER *** [2c 9d 7h 8d] [Kd]
311420212216613: checks 
hempju1ce: checks 
*** SHOW DOWN ***
311420212216613: shows [5s Ad] (high card Ace)
hempju1ce: shows [Ah Jc] (high card Ace - King+Jack kicker)
hempju1ce collected $0.24 from pot
*** SUMMARY ***
Total pot $0.25 | Rake $0.01 
Board [2c 9d 7h 8d Kd]
Seat 1: hempju1ce showed [Ah Jc] and won ($0.24) with high card Ace
Seat 2: Eduard Gl (button) folded before Flop (didn't bet)
Seat 3: ImperialOxxx (small blind) folded before Flop
Seat 4: 311420212216613 (big blind) showed [5s Ad] and lost with high card Ace
Seat 5: sAnt1n135 folded before Flop (didn't bet)
Seat 6: starikan872 folded before Flop (didn't bet)



PokerStars Hand #222971819722:  Hold'em No Limit ($0.05/$0.10 USD) - 2021/01/23 16:20:11 ET
Table 'Grus IV' 6-max Seat #3 is the button
Seat 1: hempju1ce ($19.39 in chips) 
Seat 2: Eduard Gl ($10.07 in chips) 
Seat 3: ImperialOxxx ($10.42 in chips) 
Seat 4: 311420212216613 ($10.05 in chips) 
Seat 5: sAnt1n135 ($43.34 in chips) 
Seat 6: starikan872 ($10.45 in chips) 
311420212216613: posts small blind $0.05
sAnt1n135: posts big blind $0.10
*** HOLE CARDS ***
starikan872: folds 
hempju1ce: folds 
Eduard Gl: folds 
ImperialOxxx: folds 
311420212216613: folds 
Uncalled bet ($0.05) returned to sAnt1n135
sAnt1n135 collected $0.10 from pot
sAnt1n135: doesn't show hand 
*** SUMMARY ***
Total pot $0.10 | Rake $0 
Seat 1: hempju1ce folded before Flop (didn't bet)
Seat 2: Eduard Gl folded before Flop (didn't bet)
Seat 3: ImperialOxxx (button) folded before Flop (didn't bet)
Seat 4: 311420212216613 (small blind) folded before Flop
Seat 5: sAnt1n135 (big blind) collected ($0.10)
Seat 6: starikan872 folded before Flop (didn't bet)



PokerStars Hand #222971831743:  Hold'em No Limit ($0.05/$0.10 USD) - 2021/01/23 16:20:25 ET
Table 'Grus IV' 6-max Seat #4 is the button
Seat 1: hempju1ce ($19.39 in chips) 
Seat 2: Eduard Gl ($10.07 in chips) 
Seat 3: ImperialOxxx ($10.42 in chips) 
Seat 4: 311420212216613 ($10 in chips) 
Seat 5: sAnt1n135 ($43.39 in chips) 
Seat 6: starikan872 ($10.45 in chips) 
sAnt1n135: posts small blind $0.05
starikan872: posts big blind $0.10
*** HOLE CARDS ***
hempju1ce: folds 
Eduard Gl: folds 
ImperialOxxx: folds 
311420212216613: raises $0.15 to $0.25
sAnt1n135: folds 
starikan872: folds 
Uncalled bet ($0.15) returned to 311420212216613
311420212216613 collected $0.25 from pot
311420212216613: doesn't show hand 
*** SUMMARY ***
Total pot $0.25 | Rake $0 
Seat 1: hempju1ce folded before Flop (didn't bet)
Seat 2: Eduard Gl folded before Flop (didn't bet)
Seat 3: ImperialOxxx folded before Flop (didn't bet)
Seat 4: 311420212216613 (button) collected ($0.25)
Seat 5: sAnt1n135 (small blind) folded before Flop
Seat 6: starikan872 (big blind) folded before Flop



PokerStars Hand #222971853527:  Hold'em No Limit ($0.05/$0.10 USD) - 2021/01/23 16:20:50 ET
Table 'Grus IV' 6-max Seat #5 is the button
Seat 1: hempju1ce ($19.39 in chips) 
Seat 2: Eduard Gl ($10.07 in chips) 
Seat 3: ImperialOxxx ($10.42 in chips) 
Seat 4: 311420212216613 ($10.15 in chips) 
Seat 5: sAnt1n135 ($43.34 in chips) 
Seat 6: starikan872 ($10.35 in chips) 
starikan872: posts small blind $0.05
hempju1ce: posts big blind $0.10
*** HOLE CARDS ***
Eduard Gl: folds 
ImperialOxxx: folds 
311420212216613: folds 
sAnt1n135: folds 
starikan872: raises $0.15 to $0.25
hempju1ce: calls $0.15
*** FLOP *** [Kd 5d 3d]
starikan872: checks 
hempju1ce: checks 
*** TURN *** [Kd 5d 3d] [8c]
starikan872: checks 
hempju1ce: checks 
*** RIVER *** [Kd 5d 3d 8c] [6s]
starikan872: bets $0.32
hempju1ce: calls $0.32
*** SHOW DOWN ***
starikan872: shows [Qs 6c] (a pair of Sixes)
hempju1ce: shows [Ks 4s] (a pair of Kings)
hempju1ce collected $1.09 from pot
*** SUMMARY ***
Total pot $1.14 | Rake $0.05 
Board [Kd 5d 3d 8c 6s]
Seat 1: hempju1ce (big blind) showed [Ks 4s] and won ($1.09) with a pair of Kings
Seat 2: Eduard Gl folded before Flop (didn't bet)
Seat 3: ImperialOxxx folded before Flop (didn't bet)
Seat 4: 311420212216613 folded before Flop (didn't bet)
Seat 5: sAnt1n135 (button) folded before Flop (didn't bet)
Seat 6: starikan872 (small blind) showed [Qs 6c] and lost with a pair of Sixes



PokerStars Hand #222971890985:  Hold'em No Limit ($0.05/$0.10 USD) - 2021/01/23 16:21:34 ET
Table 'Grus IV' 6-max Seat #6 is the button
Seat 1: hempju1ce ($19.91 in chips) 
Seat 2: Eduard Gl ($10.07 in chips) 
Seat 3: ImperialOxxx ($10.42 in chips) 
Seat 4: 311420212216613 ($10.15 in chips) 
Seat 5: sAnt1n135 ($43.34 in chips) 
Seat 6: starikan872 ($10 in chips) 
hempju1ce: posts small blind $0.05
Eduard Gl: posts big blind $0.10
*** HOLE CARDS ***
ImperialOxxx: raises $0.15 to $0.25
311420212216613: folds 
sAnt1n135: folds 
starikan872: calls $0.25
hempju1ce: folds 
Eduard Gl: calls $0.15
*** FLOP *** [Ts Qh 3c]
Eduard Gl: checks 
ImperialOxxx: bets $0.51
starikan872: calls $0.51
Eduard Gl: folds 
*** TURN *** [Ts Qh 3c] [4c]
ImperialOxxx: bets $1.50
starikan872: folds 
Uncalled bet ($1.50) returned to ImperialOxxx
ImperialOxxx collected $1.74 from pot
ImperialOxxx: doesn't show hand 
*** SUMMARY ***
Total pot $1.82 | Rake $0.08 
Board [Ts Qh 3c 4c]
Seat 1: hempju1ce (small blind) folded before Flop
Seat 2: Eduard Gl (big blind) folded on the Flop
Seat 3: ImperialOxxx collected ($1.74)
Seat 4: 311420212216613 folded before Flop (didn't bet)
Seat 5: sAnt1n135 folded before Flop (didn't bet)
Seat 6: starikan872 (button) folded on the Turn



PokerStars Hand #222971937568:  Hold'em No Limit ($0.05/$0.10 USD) - 2021/01/23 16:22:28 ET
Table 'Grus IV' 6-max Seat #1 is the button
Seat 1: hempju1ce ($19.86 in chips) 
Seat 2: Eduard Gl ($10 in chips) 
Seat 3: ImperialOxxx ($11.40 in chips) 
Seat 4: 311420212216613 ($10.15 in chips) 
Seat 5: sAnt1n135 ($43.34 in chips) 
Seat 6: starikan872 ($10 in chips) 
Eduard Gl: posts small blind $0.05
ImperialOxxx: posts big blind $0.10
*** HOLE CARDS ***
311420212216613: folds 
sAnt1n135: folds 
starikan872: folds 
hempju1ce: folds 
Eduard Gl: folds 
Uncalled bet ($0.05) returned to ImperialOxxx
ImperialOxxx collected $0.10 from pot
ImperialOxxx: doesn't show hand 
*** SUMMARY ***
Total pot $0.10 | Rake $0 
Seat 1: hempju1ce (button) folded before Flop (didn't bet)
Seat 2: Eduard Gl (small blind) folded before Flop
Seat 3: ImperialOxxx (big blind) collected ($0.10)
Seat 4: 311420212216613 folded before Flop (didn't bet)
Seat 5: sAnt1n135 folded before Flop (didn't bet)
Seat 6: starikan872 folded before Flop (didn't bet)



PokerStars Hand #222971948403:  Hold'em No Limit ($0.05/$0.10 USD) - 2021/01/23 16:22:41 ET
Table 'Grus IV' 6-max Seat #2 is the button
Seat 1: hempju1ce ($19.86 in chips) 
Seat 2: Eduard Gl ($10 in chips) 
Seat 3: ImperialOxxx ($11.45 in chips) 
Seat 4: 311420212216613 ($10.15 in chips) 
Seat 5: sAnt1n135 ($43.34 in chips) 
Seat 6: starikan872 ($10 in chips) 
ImperialOxxx: posts small blind $0.05
311420212216613: posts big blind $0.10
*** HOLE CARDS ***
sAnt1n135: folds 
starikan872: folds 
hempju1ce: folds 
Eduard Gl: folds 
ImperialOxxx: folds 
Uncalled bet ($0.05) returned to 311420212216613
311420212216613 collected $0.10 from pot
311420212216613: doesn't show hand 
*** SUMMARY ***
Total pot $0.10 | Rake $0 
Seat 1: hempju1ce folded before Flop (didn't bet)
Seat 2: Eduard Gl (button) folded before Flop (didn't bet)
Seat 3: ImperialOxxx (small blind) folded before Flop
Seat 4: 311420212216613 (big blind) collected ($0.10)
Seat 5: sAnt1n135 folded before Flop (didn't bet)
Seat 6: starikan872 folded before Flop (didn't bet)



PokerStars Hand #222971963768:  Hold'em No Limit ($0.05/$0.10 USD) - 2021/01/23 16:22:59 ET
Table 'Grus IV' 6-max Seat #3 is the button
Seat 1: hempju1ce ($19.86 in chips) 
Seat 2: Eduard Gl ($10 in chips) 
Seat 3: ImperialOxxx ($11.40 in chips) 
Seat 4: 311420212216613 ($10.20 in chips) 
Seat 5: sAnt1n135 ($43.34 in chips) 
Seat 6: starikan872 ($10 in chips) 
311420212216613: posts small blind $0.05
sAnt1n135: posts big blind $0.10
*** HOLE CARDS ***
starikan872: folds 
hempju1ce: folds 
Eduard Gl: raises $0.20 to $0.30
ImperialOxxx: raises $0.75 to $1.05
311420212216613: folds 
sAnt1n135: folds 
Eduard Gl: folds 
Uncalled bet ($0.75) returned to ImperialOxxx
ImperialOxxx collected $0.75 from pot
ImperialOxxx: doesn't show hand 
*** SUMMARY ***
Total pot $0.75 | Rake $0 
Seat 1: hempju1ce folded before Flop (didn't bet)
Seat 2: Eduard Gl folded before Flop
Seat 3: ImperialOxxx (button) collected ($0.75)
Seat 4: 311420212216613 (small blind) folded before Flop
Seat 5: sAnt1n135 (big blind) folded before Flop
Seat 6: starikan872 folded before Flop (didn't bet)



PokerStars Hand #222971990766:  Hold'em No Limit ($0.05/$0.10 USD) - 2021/01/23 16:23:22 ET
Table 'Grus IV' 6-max Seat #4 is the button
Seat 1: hempju1ce ($19.86 in chips) 
Seat 2: Eduard Gl ($10 in chips) 
Seat 3: ImperialOxxx ($11.85 in chips) 
Seat 4: 311420212216613 ($10.15 in chips) 
Seat 5: sAnt1n135 ($43.24 in chips) 
Seat 6: starikan872 ($10 in chips) 
sAnt1n135: posts small blind $0.05
starikan872: posts big blind $0.10
*** HOLE CARDS ***
hempju1ce: folds 
Eduard Gl: folds 
ImperialOxxx: folds 
311420212216613: raises $0.15 to $0.25
sAnt1n135: folds 
starikan872: folds 
Uncalled bet ($0.15) returned to 311420212216613
311420212216613 collected $0.25 from pot
311420212216613: doesn't show hand 
*** SUMMARY ***
Total pot $0.25 | Rake $0 
Seat 1: hempju1ce folded before Flop (didn't bet)
Seat 2: Eduard Gl folded before Flop (didn't bet)
Seat 3: ImperialOxxx folded before Flop (didn't bet)
Seat 4: 311420212216613 (button) collected ($0.25)
Seat 5: sAnt1n135 (small blind) folded before Flop
Seat 6: starikan872 (big blind) folded before Flop



PokerStars Hand #222972008339:  Hold'em No Limit ($0.05/$0.10 USD) - 2021/01/23 16:23:43 ET
Table 'Grus IV' 6-max Seat #5 is the button
Seat 1: hempju1ce ($19.86 in chips) 
Seat 2: Eduard Gl ($10 in chips) 
Seat 3: ImperialOxxx ($11.85 in chips) 
Seat 4: 311420212216613 ($10.30 in chips) 
Seat 5: sAnt1n135 ($43.19 in chips) 
Seat 6: starikan872 ($10 in chips) 
starikan872: posts small blind $0.05
hempju1ce: posts big blind $0.10
*** HOLE CARDS ***
Eduard Gl: folds 
ImperialOxxx: folds 
311420212216613: folds 
sAnt1n135: folds 
starikan872: folds 
Uncalled bet ($0.05) returned to hempju1ce
hempju1ce collected $0.10 from pot
hempju1ce: doesn't show hand 
*** SUMMARY ***
Total pot $0.10 | Rake $0 
Seat 1: hempju1ce (big blind) collected ($0.10)
Seat 2: Eduard Gl folded before Flop (didn't bet)
Seat 3: ImperialOxxx folded before Flop (didn't bet)
Seat 4: 311420212216613 folded before Flop (didn't bet)
Seat 5: sAnt1n135 (button) folded before Flop (didn't bet)
Seat 6: starikan872 (small blind) folded before Flop



PokerStars Hand #222972018509:  Hold'em No Limit ($0.05/$0.10 USD) - 2021/01/23 16:23:55 ET
Table 'Grus IV' 6-max Seat #6 is the button
Seat 1: hempju1ce ($19.91 in chips) 
Seat 2: Eduard Gl ($10 in chips) 
Seat 3: ImperialOxxx ($11.85 in chips) 
Seat 4: 311420212216613 ($10.30 in chips) 
Seat 5: sAnt1n135 ($43.19 in chips) 
Seat 6: starikan872 ($10 in chips) 
hempju1ce: posts small blind $0.05
Eduard Gl: posts big blind $0.10
*** HOLE CARDS ***
ImperialOxxx: folds 
311420212216613: folds 
sAnt1n135: raises $0.20 to $0.30
starikan872: folds 
hempju1ce: folds 
Eduard Gl: folds 
Uncalled bet ($0.20) returned to sAnt1n135
sAnt1n135 collected $0.25 from pot
sAnt1n135: doesn't show hand 
*** SUMMARY ***
Total pot $0.25 | Rake $0 
Seat 1: hempju1ce (small blind) folded before Flop
Seat 2: Eduard Gl (big blind) folded before Flop
Seat 3: ImperialOxxx folded before Flop (didn't bet)
Seat 4: 311420212216613 folded before Flop (didn't bet)
Seat 5: sAnt1n135 collected ($0.25)
Seat 6: starikan872 (button) folded before Flop (didn't bet)



PokerStars Hand #222972034754:  Hold'em No Limit ($0.05/$0.10 USD) - 2021/01/23 16:24:14 ET
Table 'Grus IV' 6-max Seat #1 is the button
Seat 1: hempju1ce ($19.86 in chips) 
Seat 2: Eduard Gl ($10 in chips) 
Seat 3: ImperialOxxx ($11.85 in chips) 
Seat 4: 311420212216613 ($10.30 in chips) 
Seat 5: sAnt1n135 ($43.34 in chips) 
Seat 6: starikan872 ($10 in chips) 
Eduard Gl: posts small blind $0.05
ImperialOxxx: posts big blind $0.10
*** HOLE CARDS ***
311420212216613: folds 
sAnt1n135: raises $0.20 to $0.30
starikan872: folds 
hempju1ce: folds 
Eduard Gl: folds 
ImperialOxxx: folds 
Uncalled bet ($0.20) returned to sAnt1n135
sAnt1n135 collected $0.25 from pot
sAnt1n135: doesn't show hand 
*** SUMMARY ***
Total pot $0.25 | Rake $0 
Seat 1: hempju1ce (button) folded before Flop (didn't bet)
Seat 2: Eduard Gl (small blind) folded before Flop
Seat 3: ImperialOxxx (big blind) folded before Flop
Seat 4: 311420212216613 folded before Flop (didn't bet)
Seat 5: sAnt1n135 collected ($0.25)
Seat 6: starikan872 folded before Flop (didn't bet)



PokerStars Hand #222972050201:  Hold'em No Limit ($0.05/$0.10 USD) - 2021/01/23 16:24:32 ET
Table 'Grus IV' 6-max Seat #2 is the button
Seat 1: hempju1ce ($19.86 in chips) 
Seat 2: Eduard Gl ($10 in chips) 
Seat 3: ImperialOxxx ($11.75 in chips) 
Seat 4: 311420212216613 ($10.30 in chips) 
Seat 5: sAnt1n135 ($43.49 in chips) 
Seat 6: starikan872 ($10 in chips) 
ImperialOxxx: posts small blind $0.05
311420212216613: posts big blind $0.10
*** HOLE CARDS ***
sAnt1n135: raises $0.20 to $0.30
starikan872: folds 
hempju1ce: folds 
Eduard Gl: folds 
ImperialOxxx: calls $0.25
311420212216613: calls $0.20
*** FLOP *** [Ks 5s 8s]
ImperialOxxx: checks 
311420212216613: checks 
sAnt1n135: checks 
*** TURN *** [Ks 5s 8s] [7h]
ImperialOxxx: checks 
311420212216613: bets $0.65
sAnt1n135: folds 
ImperialOxxx: calls $0.65
*** RIVER *** [Ks 5s 8s 7h] [3s]
ImperialOxxx: bets $10.80 and is all-in
311420212216613: folds 
Uncalled bet ($10.80) returned to ImperialOxxx
ImperialOxxx collected $2.10 from pot
ImperialOxxx: doesn't show hand 
*** SUMMARY ***
Total pot $2.20 | Rake $0.10 
Board [Ks 5s 8s 7h 3s]
Seat 1: hempju1ce folded before Flop (didn't bet)
Seat 2: Eduard Gl (button) folded before Flop (didn't bet)
Seat 3: ImperialOxxx (small blind) collected ($2.10)
Seat 4: 311420212216613 (big blind) folded on the River
Seat 5: sAnt1n135 folded on the Turn
Seat 6: starikan872 folded before Flop (didn't bet)



PokerStars Hand #222972110404:  Hold'em No Limit ($0.05/$0.10 USD) - 2021/01/23 16:25:43 ET
Table 'Grus IV' 6-max Seat #3 is the button
Seat 1: hempju1ce ($19.86 in chips) 
Seat 2: Eduard Gl ($10 in chips) 
Seat 3: ImperialOxxx ($12.90 in chips) 
Seat 4: 311420212216613 ($10 in chips) 
Seat 5: sAnt1n135 ($43.19 in chips) 
Seat 6: starikan872 ($10 in chips) 
311420212216613: posts small blind $0.05
sAnt1n135: posts big blind $0.10
*** HOLE CARDS ***
starikan872: folds 
hempju1ce: folds 
Eduard Gl: folds 
ImperialOxxx: folds 
311420212216613: folds 
Uncalled bet ($0.05) returned to sAnt1n135
sAnt1n135 collected $0.10 from pot
*** SUMMARY ***
Total pot $0.10 | Rake $0 
Seat 1: hempju1ce folded before Flop (didn't bet)
Seat 2: Eduard Gl folded before Flop (didn't bet)
Seat 3: ImperialOxxx (button) folded before Flop (didn't bet)
Seat 4: 311420212216613 (small blind) folded before Flop
Seat 5: sAnt1n135 (big blind) collected ($0.10)
Seat 6: starikan872 folded before Flop (didn't bet)



PokerStars Hand #222972120582:  Hold'em No Limit ($0.05/$0.10 USD) - 2021/01/23 16:25:55 ET
Table 'Grus IV' 6-max Seat #4 is the button
Seat 1: hempju1ce ($19.86 in chips) 
Seat 2: Eduard Gl ($10 in chips) 
Seat 3: ImperialOxxx ($12.90 in chips) 
Seat 4: 311420212216613 ($10 in chips) 
Seat 5: sAnt1n135 ($43.24 in chips) 
Seat 6: starikan872 ($10 in chips) 
sAnt1n135: posts small blind $0.05
starikan872: posts big blind $0.10
*** HOLE CARDS ***
hempju1ce: calls $0.10
Eduard Gl: folds 
ImperialOxxx: folds 
311420212216613: raises $0.15 to $0.25
sAnt1n135: raises $0.70 to $0.95
starikan872: folds 
hempju1ce: folds 
311420212216613: folds 
Uncalled bet ($0.70) returned to sAnt1n135
sAnt1n135 collected $0.70 from pot
sAnt1n135: doesn't show hand 
*** SUMMARY ***
Total pot $0.70 | Rake $0 
Seat 1: hempju1ce folded before Flop
Seat 2: Eduard Gl folded before Flop (didn't bet)
Seat 3: ImperialOxxx folded before Flop (didn't bet)
Seat 4: 311420212216613 (button) folded before Flop
Seat 5: sAnt1n135 (small blind) collected ($0.70)
Seat 6: starikan872 (big blind) folded before Flop



PokerStars Hand #222972139419:  Hold'em No Limit ($0.05/$0.10 USD) - 2021/01/23 16:26:17 ET
Table 'Grus IV' 6-max Seat #5 is the button
Seat 1: hempju1ce ($19.76 in chips) 
Seat 2: Eduard Gl ($10 in chips) 
Seat 3: ImperialOxxx ($12.90 in chips) 
Seat 4: 311420212216613 ($10 in chips) 
Seat 5: sAnt1n135 ($43.69 in chips) 
Seat 6: starikan872 ($10 in chips) 
starikan872: posts small blind $0.05
hempju1ce: posts big blind $0.10
*** HOLE CARDS ***
Eduard Gl: raises $0.20 to $0.30
ImperialOxxx: folds 
311420212216613: folds 
sAnt1n135: folds 
starikan872: folds 
hempju1ce: calls $0.20
*** FLOP *** [8h 7d 7h]
hempju1ce: checks 
Eduard Gl: bets $0.40
hempju1ce: raises $0.40 to $0.80
Eduard Gl: raises $0.40 to $1.20
hempju1ce: calls $0.40
*** TURN *** [8h 7d 7h] [9c]
hempju1ce: bets $1.45
Eduard Gl: calls $1.45
*** RIVER *** [8h 7d 7h 9c] [9d]
hempju1ce: bets $2.84
Eduard Gl: folds 
Uncalled bet ($2.84) returned to hempju1ce
hempju1ce collected $5.68 from pot
hempju1ce: doesn't show hand 
*** SUMMARY ***
Total pot $5.95 | Rake $0.27 
Board [8h 7d 7h 9c 9d]
Seat 1: hempju1ce (big blind) collected ($5.68)
Seat 2: Eduard Gl folded on the River
Seat 3: ImperialOxxx folded before Flop (didn't bet)
Seat 4: 311420212216613 folded before Flop (didn't bet)
Seat 5: sAnt1n135 (button) folded before Flop (didn't bet)
Seat 6: starikan872 (small blind) folded before Flop



PokerStars Hand #222972198269:  Hold'em No Limit ($0.05/$0.10 USD) - 2021/01/23 16:27:26 ET
Table 'Grus IV' 6-max Seat #6 is the button
Seat 1: hempju1ce ($22.49 in chips) 
Seat 2: Eduard Gl ($10 in chips) 
Seat 3: ImperialOxxx ($12.90 in chips) 
Seat 4: 311420212216613 ($10 in chips) 
Seat 5: sAnt1n135 ($43.69 in chips) 
Seat 6: starikan872 ($10 in chips) 
hempju1ce: posts small blind $0.05
Eduard Gl: posts big blind $0.10
*** HOLE CARDS ***
ImperialOxxx: folds 
311420212216613: folds 
sAnt1n135: raises $0.20 to $0.30
starikan872: raises $0.60 to $0.90
hempju1ce: folds 
Eduard Gl: folds 
sAnt1n135: calls $0.60
*** FLOP *** [5d 6c Tc]
sAnt1n135: checks 
starikan872: bets $1.10
sAnt1n135: calls $1.10
*** TURN *** [5d 6c Tc] [6d]
sAnt1n135: checks 
starikan872: bets $2.61
sAnt1n135: folds 
Uncalled bet ($2.61) returned to starikan872
starikan872 collected $3.96 from pot
starikan872: doesn't show hand 
*** SUMMARY ***
Total pot $4.15 | Rake $0.19 
Board [5d 6c Tc 6d]
Seat 1: hempju1ce (small blind) folded before Flop
Seat 2: Eduard Gl (big blind) folded before Flop
Seat 3: ImperialOxxx folded before Flop (didn't bet)
Seat 4: 311420212216613 folded before Flop (didn't bet)
Seat 5: sAnt1n135 folded on the Turn
Seat 6: starikan872 (button) collected ($3.96)



PokerStars Hand #222972252928:  Hold'em No Limit ($0.05/$0.10 USD) - 2021/01/23 16:28:31 ET
Table 'Grus IV' 6-max Seat #1 is the button
Seat 1: hempju1ce ($22.44 in chips) 
Seat 2: Eduard Gl ($10 in chips) 
Seat 3: ImperialOxxx ($12.90 in chips) 
Seat 4: 311420212216613 ($10 in chips) 
Seat 5: sAnt1n135 ($41.69 in chips) 
Seat 6: starikan872 ($11.96 in chips) 
Eduard Gl: posts small blind $0.05
ImperialOxxx: posts big blind $0.10
*** HOLE CARDS ***
311420212216613: folds 
sAnt1n135: folds 
starikan872: folds 
hempju1ce: folds 
Eduard Gl: folds 
Uncalled bet ($0.05) returned to ImperialOxxx
ImperialOxxx collected $0.10 from pot
ImperialOxxx: doesn't show hand 
*** SUMMARY ***
Total pot $0.10 | Rake $0 
Seat 1: hempju1ce (button) folded before Flop (didn't bet)
Seat 2: Eduard Gl (small blind) folded before Flop
Seat 3: ImperialOxxx (big blind) collected ($0.10)
Seat 4: 311420212216613 folded before Flop (didn't bet)
Seat 5: sAnt1n135 folded before Flop (didn't bet)
Seat 6: starikan872 folded before Flop (didn't bet)



PokerStars Hand #222972265815:  Hold'em No Limit ($0.05/$0.10 USD) - 2021/01/23 16:28:46 ET
Table 'Grus IV' 6-max Seat #2 is the button
Seat 1: hempju1ce ($22.44 in chips) 
Seat 2: Eduard Gl ($10 in chips) 
Seat 3: ImperialOxxx ($12.95 in chips) 
Seat 4: 311420212216613 ($10 in chips) 
Seat 5: sAnt1n135 ($41.69 in chips) 
Seat 6: starikan872 ($11.96 in chips) 
ImperialOxxx: posts small blind $0.05
311420212216613: posts big blind $0.10
*** HOLE CARDS ***
sAnt1n135: folds 
starikan872: raises $0.20 to $0.30
hempju1ce: folds 
Eduard Gl: folds 
ImperialOxxx: folds 
311420212216613: folds 
Uncalled bet ($0.20) returned to starikan872
starikan872 collected $0.25 from pot
starikan872: doesn't show hand 
*** SUMMARY ***
Total pot $0.25 | Rake $0 
Seat 1: hempju1ce folded before Flop (didn't bet)
Seat 2: Eduard Gl (button) folded before Flop (didn't bet)
Seat 3: ImperialOxxx (small blind) folded before Flop
Seat 4: 311420212216613 (big blind) folded before Flop
Seat 5: sAnt1n135 folded before Flop (didn't bet)
Seat 6: starikan872 collected ($0.25)



PokerStars Hand #222972280401:  Hold'em No Limit ($0.05/$0.10 USD) - 2021/01/23 16:29:03 ET
Table 'Grus IV' 6-max Seat #3 is the button
Seat 1: hempju1ce ($22.44 in chips) 
Seat 2: Eduard Gl ($10 in chips) 
Seat 3: ImperialOxxx ($12.90 in chips) 
Seat 4: 311420212216613 ($10 in chips) 
Seat 5: sAnt1n135 ($41.69 in chips) 
Seat 6: starikan872 ($12.11 in chips) 
311420212216613: posts small blind $0.05
sAnt1n135: posts big blind $0.10
*** HOLE CARDS ***
starikan872: folds 
hempju1ce: raises $0.10 to $0.20
Eduard Gl: folds 
ImperialOxxx: folds 
311420212216613: folds 
sAnt1n135: folds 
Uncalled bet ($0.10) returned to hempju1ce
hempju1ce collected $0.25 from pot
hempju1ce: doesn't show hand 
*** SUMMARY ***
Total pot $0.25 | Rake $0 
Seat 1: hempju1ce collected ($0.25)
Seat 2: Eduard Gl folded before Flop (didn't bet)
Seat 3: ImperialOxxx (button) folded before Flop (didn't bet)
Seat 4: 311420212216613 (small blind) folded before Flop
Seat 5: sAnt1n135 (big blind) folded before Flop
Seat 6: starikan872 folded before Flop (didn't bet)



PokerStars Hand #222972292338:  Hold'em No Limit ($0.05/$0.10 USD) - 2021/01/23 16:29:17 ET
Table 'Grus IV' 6-max Seat #4 is the button
Seat 1: hempju1ce ($22.59 in chips) 
Seat 2: Eduard Gl ($10 in chips) 
Seat 3: ImperialOxxx ($12.90 in chips) 
Seat 4: 311420212216613 ($10 in chips) 
Seat 5: sAnt1n135 ($41.59 in chips) 
Seat 6: starikan872 ($12.11 in chips) 
sAnt1n135: posts small blind $0.05
starikan872: posts big blind $0.10
*** HOLE CARDS ***
hempju1ce: folds 
Eduard Gl: folds 
ImperialOxxx: folds 
311420212216613: folds 
sAnt1n135: raises $0.13 to $0.23
starikan872: calls $0.13
*** FLOP *** [6d 2s 5d]
sAnt1n135: bets $0.30
starikan872: calls $0.30
*** TURN *** [6d 2s 5d] [Ts]
sAnt1n135: checks 
starikan872: bets $0.67
sAnt1n135: folds 
Uncalled bet ($0.67) returned to starikan872
starikan872 collected $1.01 from pot
starikan872: doesn't show hand 
*** SUMMARY ***
Total pot $1.06 | Rake $0.05 
Board [6d 2s 5d Ts]
Seat 1: hempju1ce folded before Flop (didn't bet)
Seat 2: Eduard Gl folded before Flop (didn't bet)
Seat 3: ImperialOxxx folded before Flop (didn't bet)
Seat 4: 311420212216613 (button) folded before Flop (didn't bet)
Seat 5: sAnt1n135 (small blind) folded on the Turn
Seat 6: starikan872 (big blind) collected ($1.01)



PokerStars Hand #222972326314:  Hold'em No Limit ($0.05/$0.10 USD) - 2021/01/23 16:29:57 ET
Table 'Grus IV' 6-max Seat #5 is the button
Seat 1: hempju1ce ($22.59 in chips) 
Seat 2: Eduard Gl ($10 in chips) 
Seat 3: ImperialOxxx ($12.90 in chips) 
Seat 4: 311420212216613 ($10 in chips) 
Seat 5: sAnt1n135 ($41.06 in chips) 
Seat 6: starikan872 ($12.59 in chips) 
starikan872: posts small blind $0.05
hempju1ce: posts big blind $0.10
*** HOLE CARDS ***
Eduard Gl: folds 
ImperialOxxx: folds 
311420212216613: folds 
sAnt1n135: raises $0.13 to $0.23
starikan872: folds 
hempju1ce: folds 
Uncalled bet ($0.13) returned to sAnt1n135
sAnt1n135 collected $0.25 from pot
sAnt1n135: doesn't show hand 
*** SUMMARY ***
Total pot $0.25 | Rake $0 
Seat 1: hempju1ce (big blind) folded before Flop
Seat 2: Eduard Gl folded before Flop (didn't bet)
Seat 3: ImperialOxxx folded before Flop (didn't bet)
Seat 4: 311420212216613 folded before Flop (didn't bet)
Seat 5: sAnt1n135 (button) collected ($0.25)
Seat 6: starikan872 (small blind) folded before Flop



PokerStars Hand #222972338349:  Hold'em No Limit ($0.05/$0.10 USD) - 2021/01/23 16:30:11 ET
Table 'Grus IV' 6-max Seat #6 is the button
Seat 1: hempju1ce ($22.49 in chips) 
Seat 2: Eduard Gl ($10 in chips) 
Seat 3: ImperialOxxx ($12.90 in chips) 
Seat 4: 311420212216613 ($10 in chips) 
Seat 5: sAnt1n135 ($41.21 in chips) 
Seat 6: starikan872 ($12.54 in chips) 
hempju1ce: posts small blind $0.05
Eduard Gl: posts big blind $0.10
*** HOLE CARDS ***
ImperialOxxx: folds 
311420212216613: raises $0.15 to $0.25
sAnt1n135: folds 
starikan872: folds 
hempju1ce: calls $0.20
Eduard Gl: calls $0.15
*** FLOP *** [Qd 9s Qs]
hempju1ce: checks 
Eduard Gl: checks 
311420212216613: bets $0.24
hempju1ce: folds 
Eduard Gl: folds 
Uncalled bet ($0.24) returned to 311420212216613
311420212216613 collected $0.72 from pot
311420212216613: doesn't show hand 
*** SUMMARY ***
Total pot $0.75 | Rake $0.03 
Board [Qd 9s Qs]
Seat 1: hempju1ce (small blind) folded on the Flop
Seat 2: Eduard Gl (big blind) folded on the Flop
Seat 3: ImperialOxxx folded before Flop (didn't bet)
Seat 4: 311420212216613 collected ($0.72)
Seat 5: sAnt1n135 folded before Flop (didn't bet)
Seat 6: starikan872 (button) folded before Flop (didn't bet)



PokerStars Hand #222972364575:  Hold'em No Limit ($0.05/$0.10 USD) - 2021/01/23 16:30:42 ET
Table 'Grus IV' 6-max Seat #1 is the button
Seat 1: hempju1ce ($22.24 in chips) 
Seat 2: Eduard Gl ($10 in chips) 
Seat 3: ImperialOxxx ($12.90 in chips) 
Seat 4: 311420212216613 ($10.47 in chips) 
Seat 5: sAnt1n135 ($41.21 in chips) 
Seat 6: starikan872 ($12.54 in chips) 
Eduard Gl: posts small blind $0.05
ImperialOxxx: posts big blind $0.10
*** HOLE CARDS ***
311420212216613: raises $0.12 to $0.22
sAnt1n135: folds 
starikan872: folds 
hempju1ce: calls $0.22
Eduard Gl: folds 
ImperialOxxx: folds 
*** FLOP *** [Td 2c 7s]
311420212216613: checks 
hempju1ce: checks 
*** TURN *** [Td 2c 7s] [7h]
311420212216613: checks 
hempju1ce: checks 
*** RIVER *** [Td 2c 7s 7h] [Th]
311420212216613: checks 
Eduard Gl leaves the table
hempju1ce: checks 
*** SHOW DOWN ***
311420212216613: shows [9h 8h] (two pair, Tens and Sevens)
hempju1ce: shows [Ks Qs] (two pair, Tens and Sevens - King kicker)
hempju1ce collected $0.56 from pot
*** SUMMARY ***
Total pot $0.59 | Rake $0.03 
Board [Td 2c 7s 7h Th]
Seat 1: hempju1ce (button) showed [Ks Qs] and won ($0.56) with two pair, Tens and Sevens
Seat 2: Eduard Gl (small blind) folded before Flop
Seat 3: ImperialOxxx (big blind) folded before Flop
Seat 4: 311420212216613 showed [9h 8h] and lost with two pair, Tens and Sevens
Seat 5: sAnt1n135 folded before Flop (didn't bet)
Seat 6: starikan872 folded before Flop (didn't bet)



PokerStars Hand #222972417475:  Hold'em No Limit ($0.05/$0.10 USD) - 2021/01/23 16:31:39 ET
Table 'Grus IV' 6-max Seat #3 is the button
Seat 1: hempju1ce ($22.58 in chips) 
Seat 3: ImperialOxxx ($12.80 in chips) 
Seat 4: 311420212216613 ($10.25 in chips) 
Seat 5: sAnt1n135 ($41.21 in chips) 
Seat 6: starikan872 ($12.54 in chips) 
311420212216613: posts small blind $0.05
sAnt1n135: posts big blind $0.10
*** HOLE CARDS ***
AK-47Rossiya joins the table at seat #2 
starikan872: folds 
hempju1ce: folds 
ImperialOxxx: folds 
311420212216613: raises $0.20 to $0.30
sAnt1n135: folds 
Uncalled bet ($0.20) returned to 311420212216613
311420212216613 collected $0.20 from pot
311420212216613: doesn't show hand 
*** SUMMARY ***
Total pot $0.20 | Rake $0 
Seat 1: hempju1ce folded before Flop (didn't bet)
Seat 3: ImperialOxxx (button) folded before Flop (didn't bet)
Seat 4: 311420212216613 (small blind) collected ($0.20)
Seat 5: sAnt1n135 (big blind) folded before Flop
Seat 6: starikan872 folded before Flop (didn't bet)



PokerStars Hand #222972437755:  Hold'em No Limit ($0.05/$0.10 USD) - 2021/01/23 16:32:03 ET
Table 'Grus IV' 6-max Seat #4 is the button
Seat 1: hempju1ce ($22.58 in chips) 
Seat 3: ImperialOxxx ($12.80 in chips) 
Seat 4: 311420212216613 ($10.35 in chips) 
Seat 5: sAnt1n135 ($41.11 in chips) 
Seat 6: starikan872 ($12.54 in chips) 
sAnt1n135: posts small blind $0.05
starikan872: posts big blind $0.10
AK-47Rossiya: sits out 
*** HOLE CARDS ***
hempju1ce: folds 
ImperialOxxx: raises $0.15 to $0.25
311420212216613: raises $0.55 to $0.80
sAnt1n135: folds 
starikan872: folds 
ImperialOxxx: calls $0.55
*** FLOP *** [7h Ah As]
ImperialOxxx: checks 
311420212216613: bets $0.55
ImperialOxxx: calls $0.55
*** TURN *** [7h Ah As] [3c]
ImperialOxxx: checks 
311420212216613: checks 
*** RIVER *** [7h Ah As 3c] [9s]
ImperialOxxx: bets $11.45 and is all-in
311420212216613: folds 
Uncalled bet ($11.45) returned to ImperialOxxx
ImperialOxxx collected $2.72 from pot
ImperialOxxx: doesn't show hand 
*** SUMMARY ***
Total pot $2.85 | Rake $0.13 
Board [7h Ah As 3c 9s]
Seat 1: hempju1ce folded before Flop (didn't bet)
Seat 3: ImperialOxxx collected ($2.72)
Seat 4: 311420212216613 (button) folded on the River
Seat 5: sAnt1n135 (small blind) folded before Flop
Seat 6: starikan872 (big blind) folded before Flop



PokerStars Hand #222972469284:  Hold'em No Limit ($0.05/$0.10 USD) - 2021/01/23 16:32:40 ET
Table 'Grus IV' 6-max Seat #5 is the button
Seat 1: hempju1ce ($22.58 in chips) 
Seat 3: ImperialOxxx ($14.17 in chips) 
Seat 4: 311420212216613 ($10 in chips) 
Seat 5: sAnt1n135 ($41.06 in chips) 
Seat 6: starikan872 ($12.44 in chips) 
starikan872: posts small blind $0.05
hempju1ce: posts big blind $0.10
AK-47Rossiya: sits out 
*** HOLE CARDS ***
ImperialOxxx: folds 
311420212216613: folds 
sAnt1n135: folds 
starikan872: raises $0.15 to $0.25
hempju1ce: folds 
Uncalled bet ($0.15) returned to starikan872
starikan872 collected $0.20 from pot
starikan872: doesn't show hand 
*** SUMMARY ***
Total pot $0.20 | Rake $0 
Seat 1: hempju1ce (big blind) folded before Flop
Seat 3: ImperialOxxx folded before Flop (didn't bet)
Seat 4: 311420212216613 folded before Flop (didn't bet)
Seat 5: sAnt1n135 (button) folded before Flop (didn't bet)
Seat 6: starikan872 (small blind) collected ($0.20)



PokerStars Hand #222972479825:  Hold'em No Limit ($0.05/$0.10 USD) - 2021/01/23 16:32:53 ET
Table 'Grus IV' 6-max Seat #6 is the button
Seat 1: hempju1ce ($22.48 in chips) 
Seat 2: AK-47Rossiya ($10 in chips) 
Seat 3: ImperialOxxx ($14.17 in chips) 
Seat 4: 311420212216613 ($10 in chips) 
Seat 5: sAnt1n135 ($41.06 in chips) 
Seat 6: starikan872 ($12.54 in chips) 
hempju1ce: posts small blind $0.05
AK-47Rossiya: posts big blind $0.10
*** HOLE CARDS ***
ImperialOxxx: folds 
311420212216613: folds 
sAnt1n135: folds 
starikan872: raises $0.15 to $0.25
hempju1ce: folds 
AK-47Rossiya: folds 
Uncalled bet ($0.15) returned to starikan872
starikan872 collected $0.25 from pot
starikan872: doesn't show hand 
*** SUMMARY ***
Total pot $0.25 | Rake $0 
Seat 1: hempju1ce (small blind) folded before Flop
Seat 2: AK-47Rossiya (big blind) folded before Flop
Seat 3: ImperialOxxx folded before Flop (didn't bet)
Seat 4: 311420212216613 folded before Flop (didn't bet)
Seat 5: sAnt1n135 folded before Flop (didn't bet)
Seat 6: starikan872 (button) collected ($0.25)



PokerStars Hand #222972490699:  Hold'em No Limit ($0.05/$0.10 USD) - 2021/01/23 16:33:06 ET
Table 'Grus IV' 6-max Seat #1 is the button
Seat 1: hempju1ce ($22.43 in chips) 
Seat 2: AK-47Rossiya ($10 in chips) 
Seat 3: ImperialOxxx ($14.17 in chips) 
Seat 4: 311420212216613 ($10 in chips) 
Seat 5: sAnt1n135 ($41.06 in chips) 
Seat 6: starikan872 ($12.69 in chips) 
AK-47Rossiya: posts small blind $0.05
ImperialOxxx: posts big blind $0.10
*** HOLE CARDS ***
311420212216613: raises $0.12 to $0.22
sAnt1n135: folds 
starikan872: folds 
hempju1ce: folds 
AK-47Rossiya: folds 
ImperialOxxx: folds 
Uncalled bet ($0.12) returned to 311420212216613
311420212216613 collected $0.25 from pot
311420212216613: doesn't show hand 
*** SUMMARY ***
Total pot $0.25 | Rake $0 
Seat 1: hempju1ce (button) folded before Flop (didn't bet)
Seat 2: AK-47Rossiya (small blind) folded before Flop
Seat 3: ImperialOxxx (big blind) folded before Flop
Seat 4: 311420212216613 collected ($0.25)
Seat 5: sAnt1n135 folded before Flop (didn't bet)
Seat 6: starikan872 folded before Flop (didn't bet)



PokerStars Hand #222972501659:  Hold'em No Limit ($0.05/$0.10 USD) - 2021/01/23 16:33:19 ET
Table 'Grus IV' 6-max Seat #2 is the button
Seat 1: hempju1ce ($22.43 in chips) 
Seat 2: AK-47Rossiya ($10 in chips) 
Seat 3: ImperialOxxx ($14.07 in chips) 
Seat 4: 311420212216613 ($10.15 in chips) 
Seat 5: sAnt1n135 ($41.06 in chips) 
Seat 6: starikan872 ($12.69 in chips) 
ImperialOxxx: posts small blind $0.05
311420212216613: posts big blind $0.10
*** HOLE CARDS ***
sAnt1n135: folds 
starikan872: folds 
hempju1ce: folds 
AK-47Rossiya: folds 
ImperialOxxx: raises $0.15 to $0.25
311420212216613: folds 
Uncalled bet ($0.15) returned to ImperialOxxx
ImperialOxxx collected $0.20 from pot
ImperialOxxx: doesn't show hand 
*** SUMMARY ***
Total pot $0.20 | Rake $0 
Seat 1: hempju1ce folded before Flop (didn't bet)
Seat 2: AK-47Rossiya (button) folded before Flop (didn't bet)
Seat 3: ImperialOxxx (small blind) collected ($0.20)
Seat 4: 311420212216613 (big blind) folded before Flop
Seat 5: sAnt1n135 folded before Flop (didn't bet)
Seat 6: starikan872 folded before Flop (didn't bet)



PokerStars Hand #222972514031:  Hold'em No Limit ($0.05/$0.10 USD) - 2021/01/23 16:33:33 ET
Table 'Grus IV' 6-max Seat #3 is the button
Seat 1: hempju1ce ($22.43 in chips) 
Seat 2: AK-47Rossiya ($10 in chips) 
Seat 3: ImperialOxxx ($14.17 in chips) 
Seat 4: 311420212216613 ($10.05 in chips) 
Seat 5: sAnt1n135 ($41.06 in chips) 
Seat 6: starikan872 ($12.69 in chips) 
311420212216613: posts small blind $0.05
sAnt1n135: posts big blind $0.10
*** HOLE CARDS ***
starikan872: folds 
hempju1ce: calls $0.10
AK-47Rossiya: folds 
ImperialOxxx: folds 
311420212216613: folds 
sAnt1n135: checks 
*** FLOP *** [8h 2d 5h]
sAnt1n135: checks 
hempju1ce: bets $0.24
sAnt1n135: folds 
Uncalled bet ($0.24) returned to hempju1ce
hempju1ce collected $0.24 from pot
hempju1ce: doesn't show hand 
*** SUMMARY ***
Total pot $0.25 | Rake $0.01 
Board [8h 2d 5h]
Seat 1: hempju1ce collected ($0.24)
Seat 2: AK-47Rossiya folded before Flop (didn't bet)
Seat 3: ImperialOxxx (button) folded before Flop (didn't bet)
Seat 4: 311420212216613 (small blind) folded before Flop
Seat 5: sAnt1n135 (big blind) folded on the Flop
Seat 6: starikan872 folded before Flop (didn't bet)



PokerStars Hand #222972537716:  Hold'em No Limit ($0.05/$0.10 USD) - 2021/01/23 16:34:02 ET
Table 'Grus IV' 6-max Seat #4 is the button
Seat 1: hempju1ce ($22.57 in chips) 
Seat 2: AK-47Rossiya ($10 in chips) 
Seat 3: ImperialOxxx ($14.17 in chips) 
Seat 4: 311420212216613 ($10 in chips) 
Seat 5: sAnt1n135 ($40.96 in chips) 
Seat 6: starikan872 ($12.69 in chips) 
sAnt1n135: posts small blind $0.05
starikan872: posts big blind $0.10
*** HOLE CARDS ***
hempju1ce: folds 
AK-47Rossiya: folds 
ImperialOxxx: folds 
311420212216613: folds 
sAnt1n135: folds 
Uncalled bet ($0.05) returned to starikan872
starikan872 collected $0.10 from pot
starikan872: doesn't show hand 
*** SUMMARY ***
Total pot $0.10 | Rake $0 
Seat 1: hempju1ce folded before Flop (didn't bet)
Seat 2: AK-47Rossiya folded before Flop (didn't bet)
Seat 3: ImperialOxxx folded before Flop (didn't bet)
Seat 4: 311420212216613 (button) folded before Flop (didn't bet)
Seat 5: sAnt1n135 (small blind) folded before Flop
Seat 6: starikan872 (big blind) collected ($0.10)



PokerStars Hand #222972545579:  Hold'em No Limit ($0.05/$0.10 USD) - 2021/01/23 16:34:11 ET
Table 'Grus IV' 6-max Seat #5 is the button
Seat 1: hempju1ce ($22.57 in chips) 
Seat 2: AK-47Rossiya ($10 in chips) 
Seat 3: ImperialOxxx ($14.17 in chips) 
Seat 4: 311420212216613 ($10 in chips) 
Seat 5: sAnt1n135 ($40.91 in chips) 
Seat 6: starikan872 ($12.74 in chips) 
starikan872: posts small blind $0.05
hempju1ce: posts big blind $0.10
*** HOLE CARDS ***
AK-47Rossiya: folds 
ImperialOxxx: raises $0.15 to $0.25
311420212216613: folds 
sAnt1n135: calls $0.25
starikan872: folds 
hempju1ce: folds 
*** FLOP *** [2d 5c 8h]
ImperialOxxx: checks 
sAnt1n135: bets $0.34
ImperialOxxx: calls $0.34
*** TURN *** [2d 5c 8h] [6s]
ImperialOxxx: checks 
sAnt1n135: bets $0.70
ImperialOxxx: folds 
Uncalled bet ($0.70) returned to sAnt1n135
sAnt1n135 collected $1.27 from pot
sAnt1n135: doesn't show hand 
*** SUMMARY ***
Total pot $1.33 | Rake $0.06 
Board [2d 5c 8h 6s]
Seat 1: hempju1ce (big blind) folded before Flop
Seat 2: AK-47Rossiya folded before Flop (didn't bet)
Seat 3: ImperialOxxx folded on the Turn
Seat 4: 311420212216613 folded before Flop (didn't bet)
Seat 5: sAnt1n135 (button) collected ($1.27)
Seat 6: starikan872 (small blind) folded before Flop



PokerStars Hand #222972575569:  Hold'em No Limit ($0.05/$0.10 USD) - 2021/01/23 16:34:47 ET
Table 'Grus IV' 6-max Seat #6 is the button
Seat 1: hempju1ce ($22.47 in chips) 
Seat 2: AK-47Rossiya ($10 in chips) 
Seat 3: ImperialOxxx ($13.58 in chips) 
Seat 4: 311420212216613 ($10 in chips) 
Seat 5: sAnt1n135 ($41.59 in chips) 
Seat 6: starikan872 ($12.69 in chips) 
hempju1ce: posts small blind $0.05
AK-47Rossiya: posts big blind $0.10
*** HOLE CARDS ***
ImperialOxxx: folds 
311420212216613: raises $0.12 to $0.22
sAnt1n135: folds 
starikan872: folds 
hempju1ce: folds 
AK-47Rossiya: folds 
Uncalled bet ($0.12) returned to 311420212216613
311420212216613 collected $0.25 from pot
311420212216613: doesn't show hand 
*** SUMMARY ***
Total pot $0.25 | Rake $0 
Seat 1: hempju1ce (small blind) folded before Flop
Seat 2: AK-47Rossiya (big blind) folded before Flop
Seat 3: ImperialOxxx folded before Flop (didn't bet)
Seat 4: 311420212216613 collected ($0.25)
Seat 5: sAnt1n135 folded before Flop (didn't bet)
Seat 6: starikan872 (button) folded before Flop (didn't bet)



PokerStars Hand #222972592142:  Hold'em No Limit ($0.05/$0.10 USD) - 2021/01/23 16:35:06 ET
Table 'Grus IV' 6-max Seat #1 is the button
Seat 1: hempju1ce ($22.42 in chips) 
Seat 2: AK-47Rossiya ($10 in chips) 
Seat 3: ImperialOxxx ($13.58 in chips) 
Seat 4: 311420212216613 ($10.15 in chips) 
Seat 5: sAnt1n135 ($41.59 in chips) 
Seat 6: starikan872 ($12.69 in chips) 
AK-47Rossiya: posts small blind $0.05
ImperialOxxx: posts big blind $0.10
*** HOLE CARDS ***
311420212216613: folds 
sAnt1n135: raises $0.20 to $0.30
starikan872: folds 
hempju1ce: calls $0.30
AK-47Rossiya: folds 
ImperialOxxx: folds 
*** FLOP *** [3s Jd Qd]
sAnt1n135: bets $0.54
hempju1ce: folds 
Uncalled bet ($0.54) returned to sAnt1n135
sAnt1n135 collected $0.72 from pot
sAnt1n135: doesn't show hand 
*** SUMMARY ***
Total pot $0.75 | Rake $0.03 
Board [3s Jd Qd]
Seat 1: hempju1ce (button) folded on the Flop
Seat 2: AK-47Rossiya (small blind) folded before Flop
Seat 3: ImperialOxxx (big blind) folded before Flop
Seat 4: 311420212216613 folded before Flop (didn't bet)
Seat 5: sAnt1n135 collected ($0.72)
Seat 6: starikan872 folded before Flop (didn't bet)



PokerStars Hand #222972614820:  Hold'em No Limit ($0.05/$0.10 USD) - 2021/01/23 16:35:33 ET
Table 'Grus IV' 6-max Seat #2 is the button
Seat 1: hempju1ce ($22.12 in chips) 
Seat 2: AK-47Rossiya ($10 in chips) 
Seat 3: ImperialOxxx ($13.48 in chips) 
Seat 4: 311420212216613 ($10.15 in chips) 
Seat 5: sAnt1n135 ($42.01 in chips) 
Seat 6: starikan872 ($12.69 in chips) 
ImperialOxxx: posts small blind $0.05
311420212216613: posts big blind $0.10
*** HOLE CARDS ***
sAnt1n135: raises $0.20 to $0.30
starikan872: folds 
hempju1ce: folds 
AK-47Rossiya: folds 
ImperialOxxx: folds 
311420212216613: folds 
Uncalled bet ($0.20) returned to sAnt1n135
sAnt1n135 collected $0.25 from pot
sAnt1n135: doesn't show hand 
*** SUMMARY ***
Total pot $0.25 | Rake $0 
Seat 1: hempju1ce folded before Flop (didn't bet)
Seat 2: AK-47Rossiya (button) folded before Flop (didn't bet)
Seat 3: ImperialOxxx (small blind) folded before Flop
Seat 4: 311420212216613 (big blind) folded before Flop
Seat 5: sAnt1n135 collected ($0.25)
Seat 6: starikan872 folded before Flop (didn't bet)



PokerStars Hand #222972624272:  Hold'em No Limit ($0.05/$0.10 USD) - 2021/01/23 16:35:45 ET
Table 'Grus IV' 6-max Seat #3 is the button
Seat 1: hempju1ce ($22.12 in chips) 
Seat 2: AK-47Rossiya ($10 in chips) 
Seat 3: ImperialOxxx ($13.43 in chips) 
Seat 4: 311420212216613 ($10.05 in chips) 
Seat 6: starikan872 ($12.69 in chips) 
311420212216613: posts small blind $0.05
sAnt1n135: is sitting out 
starikan872: posts big blind $0.10
*** HOLE CARDS ***
hempju1ce: folds 
AK-47Rossiya: folds 
ImperialOxxx: raises $0.15 to $0.25
311420212216613: raises $0.65 to $0.90
starikan872: folds 
sAnt1n135 leaves the table
Tophado0091 joins the table at seat #5 
ImperialOxxx: folds 
Uncalled bet ($0.65) returned to 311420212216613
311420212216613 collected $0.60 from pot
311420212216613: doesn't show hand 
*** SUMMARY ***
Total pot $0.60 | Rake $0 
Seat 1: hempju1ce folded before Flop (didn't bet)
Seat 2: AK-47Rossiya folded before Flop (didn't bet)
Seat 3: ImperialOxxx (button) folded before Flop
Seat 4: 311420212216613 (small blind) collected ($0.60)
Seat 6: starikan872 (big blind) folded before Flop



PokerStars Hand #222972646908:  Hold'em No Limit ($0.05/$0.10 USD) - 2021/01/23 16:36:12 ET
Table 'Grus IV' 6-max Seat #4 is the button
Seat 1: hempju1ce ($22.12 in chips) 
Seat 2: AK-47Rossiya ($10 in chips) 
Seat 3: ImperialOxxx ($13.18 in chips) 
Seat 4: 311420212216613 ($10.40 in chips) 
Seat 6: starikan872 ($12.59 in chips) 
starikan872: posts small blind $0.05
hempju1ce: posts big blind $0.10
*** HOLE CARDS ***
AK-47Rossiya: folds 
ImperialOxxx: folds 
311420212216613: raises $0.15 to $0.25
starikan872: folds 
hempju1ce: folds 
Uncalled bet ($0.15) returned to 311420212216613
311420212216613 collected $0.25 from pot
311420212216613: doesn't show hand 
*** SUMMARY ***
Total pot $0.25 | Rake $0 
Seat 1: hempju1ce (big blind) folded before Flop
Seat 2: AK-47Rossiya folded before Flop (didn't bet)
Seat 3: ImperialOxxx folded before Flop (didn't bet)
Seat 4: 311420212216613 (button) collected ($0.25)
Seat 6: starikan872 (small blind) folded before Flop



PokerStars Hand #222972659015:  Hold'em No Limit ($0.05/$0.10 USD) - 2021/01/23 16:36:26 ET
Table 'Grus IV' 6-max Seat #6 is the button
Seat 1: hempju1ce ($22.02 in chips) 
Seat 2: AK-47Rossiya ($10 in chips) 
Seat 3: ImperialOxxx ($13.18 in chips) 
Seat 4: 311420212216613 ($10.55 in chips) 
Seat 5: Tophado0091 ($5 in chips) 
Seat 6: starikan872 ($12.54 in chips) 
hempju1ce: posts small blind $0.05
AK-47Rossiya: posts big blind $0.10
Tophado0091: posts big blind $0.10
*** HOLE CARDS ***
ImperialOxxx: folds 
311420212216613: folds 
Tophado0091: checks 
starikan872: folds 
hempju1ce: raises $0.40 to $0.50
AK-47Rossiya: folds 
Tophado0091: calls $0.40
*** FLOP *** [7c 3d 7h]
hempju1ce: bets $0.60
Tophado0091: calls $0.60
*** TURN *** [7c 3d 7h] [As]
hempju1ce: bets $1.10
Tophado0091: folds 
Uncalled bet ($1.10) returned to hempju1ce
hempju1ce collected $2.20 from pot
hempju1ce: doesn't show hand 
*** SUMMARY ***
Total pot $2.30 | Rake $0.10 
Board [7c 3d 7h As]
Seat 1: hempju1ce (small blind) collected ($2.20)
Seat 2: AK-47Rossiya (big blind) folded before Flop
Seat 3: ImperialOxxx folded before Flop (didn't bet)
Seat 4: 311420212216613 folded before Flop (didn't bet)
Seat 5: Tophado0091 folded on the Turn
Seat 6: starikan872 (button) folded before Flop (didn't bet)



PokerStars Hand #222972683711:  Hold'em No Limit ($0.05/$0.10 USD) - 2021/01/23 16:36:55 ET
Table 'Grus IV' 6-max Seat #1 is the button
Seat 1: hempju1ce ($23.12 in chips) 
Seat 2: AK-47Rossiya ($10 in chips) 
Seat 3: ImperialOxxx ($13.18 in chips) 
Seat 4: 311420212216613 ($10.55 in chips) 
Seat 5: Tophado0091 ($3.90 in chips) 
Seat 6: starikan872 ($12.54 in chips) 
AK-47Rossiya: posts small blind $0.05
ImperialOxxx: posts big blind $0.10
*** HOLE CARDS ***
311420212216613: raises $0.12 to $0.22
Tophado0091: folds 
starikan872: folds 
hempju1ce: folds 
AK-47Rossiya: folds 
ImperialOxxx: calls $0.12
*** FLOP *** [3h 6c 8d]
ImperialOxxx: checks 
311420212216613: checks 
*** TURN *** [3h 6c 8d] [Kd]
ImperialOxxx: checks 
311420212216613: checks 
*** RIVER *** [3h 6c 8d Kd] [Qc]
ImperialOxxx: checks 
311420212216613: checks 
*** SHOW DOWN ***
ImperialOxxx: shows [7s Ac] (high card Ace)
311420212216613: shows [Ah Jh] (high card Ace - King+Queen+Jack kicker)
311420212216613 collected $0.47 from pot
*** SUMMARY ***
Total pot $0.49 | Rake $0.02 
Board [3h 6c 8d Kd Qc]
Seat 1: hempju1ce (button) folded before Flop (didn't bet)
Seat 2: AK-47Rossiya (small blind) folded before Flop
Seat 3: ImperialOxxx (big blind) showed [7s Ac] and lost with high card Ace
Seat 4: 311420212216613 showed [Ah Jh] and won ($0.47) with high card Ace
Seat 5: Tophado0091 folded before Flop (didn't bet)
Seat 6: starikan872 folded before Flop (didn't bet)



PokerStars Hand #222972715098:  Hold'em No Limit ($0.05/$0.10 USD) - 2021/01/23 16:37:33 ET
Table 'Grus IV' 6-max Seat #2 is the button
Seat 1: hempju1ce ($23.12 in chips) 
Seat 2: AK-47Rossiya ($10 in chips) 
Seat 3: ImperialOxxx ($12.96 in chips) 
Seat 4: 311420212216613 ($10.80 in chips) 
Seat 5: Tophado0091 ($3.90 in chips) 
Seat 6: starikan872 ($12.54 in chips) 
ImperialOxxx: posts small blind $0.05
311420212216613: posts big blind $0.10
*** HOLE CARDS ***
Tophado0091: folds 
starikan872: folds 
hempju1ce: folds 
AK-47Rossiya: folds 
ImperialOxxx: raises $0.15 to $0.25
311420212216613: calls $0.15
*** FLOP *** [5c 7c 7s]
ImperialOxxx: bets $0.30
311420212216613: folds 
Uncalled bet ($0.30) returned to ImperialOxxx
ImperialOxxx collected $0.48 from pot
ImperialOxxx: doesn't show hand 
*** SUMMARY ***
Total pot $0.50 | Rake $0.02 
Board [5c 7c 7s]
Seat 1: hempju1ce folded before Flop (didn't bet)
Seat 2: AK-47Rossiya (button) folded before Flop (didn't bet)
Seat 3: ImperialOxxx (small blind) collected ($0.48)
Seat 4: 311420212216613 (big blind) folded on the Flop
Seat 5: Tophado0091 folded before Flop (didn't bet)
Seat 6: starikan872 folded before Flop (didn't bet)



PokerStars Hand #222972730486:  Hold'em No Limit ($0.05/$0.10 USD) - 2021/01/23 16:37:51 ET
Table 'Grus IV' 6-max Seat #3 is the button
Seat 1: hempju1ce ($23.12 in chips) 
Seat 2: AK-47Rossiya ($10 in chips) 
Seat 3: ImperialOxxx ($13.19 in chips) 
Seat 4: 311420212216613 ($10.55 in chips) 
Seat 5: Tophado0091 ($3.90 in chips) 
Seat 6: starikan872 ($12.54 in chips) 
311420212216613: posts small blind $0.05
Tophado0091: posts big blind $0.10
*** HOLE CARDS ***
starikan872: raises $0.20 to $0.30
hempju1ce: calls $0.30
AK-47Rossiya: folds 
ImperialOxxx: folds 
311420212216613: folds 
Tophado0091: calls $0.20
*** FLOP *** [5d 7s 4d]
Tophado0091: checks 
starikan872: checks 
hempju1ce: checks 
*** TURN *** [5d 7s 4d] [Jh]
Tophado0091: bets $0.10
starikan872: calls $0.10
hempju1ce: folds 
*** RIVER *** [5d 7s 4d Jh] [8s]
Tophado0091: bets $0.50
starikan872: folds 
Uncalled bet ($0.50) returned to Tophado0091
Tophado0091 collected $1.10 from pot
Tophado0091: doesn't show hand 
*** SUMMARY ***
Total pot $1.15 | Rake $0.05 
Board [5d 7s 4d Jh 8s]
Seat 1: hempju1ce folded on the Turn
Seat 2: AK-47Rossiya folded before Flop (didn't bet)
Seat 3: ImperialOxxx (button) folded before Flop (didn't bet)
Seat 4: 311420212216613 (small blind) folded before Flop
Seat 5: Tophado0091 (big blind) collected ($1.10)
Seat 6: starikan872 folded on the River



PokerStars Hand #222972775870:  Hold'em No Limit ($0.05/$0.10 USD) - 2021/01/23 16:38:46 ET
Table 'Grus IV' 6-max Seat #4 is the button
Seat 1: hempju1ce ($22.82 in chips) 
Seat 2: AK-47Rossiya ($10 in chips) 
Seat 3: ImperialOxxx ($13.19 in chips) 
Seat 4: 311420212216613 ($10.50 in chips) 
Seat 5: Tophado0091 ($4.60 in chips) 
Seat 6: starikan872 ($12.14 in chips) 
Tophado0091: posts small blind $0.05
starikan872: posts big blind $0.10
*** HOLE CARDS ***
hempju1ce: raises $0.10 to $0.20
AK-47Rossiya: folds 
ImperialOxxx: folds 
311420212216613: folds 
Tophado0091: calls $0.15
starikan872: folds 
*** FLOP *** [Kd Tc 5d]
Tophado0091: checks 
hempju1ce: bets $0.30
Tophado0091: calls $0.30
*** TURN *** [Kd Tc 5d] [Jc]
Tophado0091: checks 
hempju1ce: bets $0.70
Tophado0091: calls $0.70
*** RIVER *** [Kd Tc 5d Jc] [8s]
Tophado0091: checks 
hempju1ce: bets $1.50
Tophado0091: folds 
Uncalled bet ($1.50) returned to hempju1ce
hempju1ce collected $2.39 from pot
hempju1ce: doesn't show hand 
*** SUMMARY ***
Total pot $2.50 | Rake $0.11 
Board [Kd Tc 5d Jc 8s]
Seat 1: hempju1ce collected ($2.39)
Seat 2: AK-47Rossiya folded before Flop (didn't bet)
Seat 3: ImperialOxxx folded before Flop (didn't bet)
Seat 4: 311420212216613 (button) folded before Flop (didn't bet)
Seat 5: Tophado0091 (small blind) folded on the River
Seat 6: starikan872 (big blind) folded before Flop



PokerStars Hand #222972808690:  Hold'em No Limit ($0.05/$0.10 USD) - 2021/01/23 16:39:26 ET
Table 'Grus IV' 6-max Seat #5 is the button
Seat 1: hempju1ce ($24.01 in chips) 
Seat 2: AK-47Rossiya ($10 in chips) 
Seat 3: ImperialOxxx ($13.19 in chips) 
Seat 4: 311420212216613 ($10.50 in chips) 
Seat 5: Tophado0091 ($3.40 in chips) 
Seat 6: starikan872 ($12.04 in chips) 
starikan872: posts small blind $0.05
hempju1ce: posts big blind $0.10
*** HOLE CARDS ***
AK-47Rossiya: folds 
ImperialOxxx: folds 
311420212216613: raises $0.15 to $0.25
Tophado0091: folds 
starikan872: folds 
hempju1ce: folds 
Uncalled bet ($0.15) returned to 311420212216613
311420212216613 collected $0.25 from pot
311420212216613: doesn't show hand 
*** SUMMARY ***
Total pot $0.25 | Rake $0 
Seat 1: hempju1ce (big blind) folded before Flop
Seat 2: AK-47Rossiya folded before Flop (didn't bet)
Seat 3: ImperialOxxx folded before Flop (didn't bet)
Seat 4: 311420212216613 collected ($0.25)
Seat 5: Tophado0091 (button) folded before Flop (didn't bet)
Seat 6: starikan872 (small blind) folded before Flop



PokerStars Hand #222972822828:  Hold'em No Limit ($0.05/$0.10 USD) - 2021/01/23 16:39:43 ET
Table 'Grus IV' 6-max Seat #6 is the button
Seat 1: hempju1ce ($23.91 in chips) 
Seat 2: AK-47Rossiya ($10 in chips) 
Seat 3: ImperialOxxx ($13.19 in chips) 
Seat 4: 311420212216613 ($10.65 in chips) 
Seat 5: Tophado0091 ($3.40 in chips) 
Seat 6: starikan872 ($11.99 in chips) 
hempju1ce: posts small blind $0.05
AK-47Rossiya: posts big blind $0.10
*** HOLE CARDS ***
ImperialOxxx: raises $0.15 to $0.25
311420212216613: raises $0.50 to $0.75
Tophado0091: calls $0.75
starikan872: folds 
hempju1ce: folds 
AK-47Rossiya: folds 
ImperialOxxx: calls $0.50
*** FLOP *** [4s 8c Qh]
ImperialOxxx: checks 
311420212216613: checks 
Tophado0091: checks 
*** TURN *** [4s 8c Qh] [As]
ImperialOxxx: checks 
311420212216613: bets $1.72
Tophado0091: raises $0.93 to $2.65 and is all-in
ImperialOxxx: folds 
311420212216613: calls $0.93
*** RIVER *** [4s 8c Qh As] [Ks]
*** SHOW DOWN ***
311420212216613: shows [Ah Kd] (two pair, Aces and Kings)
Tophado0091: shows [9s Js] (a flush, Ace high)
Tophado0091 collected $7.35 from pot
*** SUMMARY ***
Total pot $7.70 | Rake $0.35 
Board [4s 8c Qh As Ks]
Seat 1: hempju1ce (small blind) folded before Flop
Seat 2: AK-47Rossiya (big blind) folded before Flop
Seat 3: ImperialOxxx folded on the Turn
Seat 4: 311420212216613 showed [Ah Kd] and lost with two pair, Aces and Kings
Seat 5: Tophado0091 showed [9s Js] and won ($7.35) with a flush, Ace high
Seat 6: starikan872 (button) folded before Flop (didn't bet)



PokerStars Hand #222972876631:  Hold'em No Limit ($0.05/$0.10 USD) - 2021/01/23 16:40:36 ET
Table 'Grus IV' 6-max Seat #1 is the button
Seat 1: hempju1ce ($23.86 in chips) 
Seat 2: AK-47Rossiya ($10 in chips) 
Seat 3: ImperialOxxx ($12.44 in chips) 
Seat 4: 311420212216613 ($10 in chips) 
Seat 5: Tophado0091 ($7.35 in chips) 
Seat 6: starikan872 ($11.99 in chips) 
AK-47Rossiya: posts small blind $0.05
ImperialOxxx: posts big blind $0.10
*** HOLE CARDS ***
311420212216613: folds 
Tophado0091: calls $0.10
starikan872: folds 
hempju1ce: raises $0.30 to $0.40
AK-47Rossiya: folds 
ImperialOxxx: folds 
Tophado0091: calls $0.30
*** FLOP *** [6s Kd 7s]
Tophado0091: checks 
hempju1ce: checks 
*** TURN *** [6s Kd 7s] [Kc]
Tophado0091: checks 
hempju1ce: checks 
*** RIVER *** [6s Kd 7s Kc] [6h]
Tophado0091: bets $0.50
hempju1ce: calls $0.50
*** SHOW DOWN ***
Tophado0091: shows [4s 8s] (two pair, Kings and Sixes)
hempju1ce: shows [Ac Qd] (two pair, Kings and Sixes - Ace kicker)
hempju1ce collected $1.86 from pot
*** SUMMARY ***
Total pot $1.95 | Rake $0.09 
Board [6s Kd 7s Kc 6h]
Seat 1: hempju1ce (button) showed [Ac Qd] and won ($1.86) with two pair, Kings and Sixes
Seat 2: AK-47Rossiya (small blind) folded before Flop
Seat 3: ImperialOxxx (big blind) folded before Flop
Seat 4: 311420212216613 folded before Flop (didn't bet)
Seat 5: Tophado0091 showed [4s 8s] and lost with two pair, Kings and Sixes
Seat 6: starikan872 folded before Flop (didn't bet)



PokerStars Hand #222972904405:  Hold'em No Limit ($0.05/$0.10 USD) - 2021/01/23 16:41:09 ET
Table 'Grus IV' 6-max Seat #2 is the button
Seat 1: hempju1ce ($24.82 in chips) 
Seat 2: AK-47Rossiya ($10 in chips) 
Seat 3: ImperialOxxx ($12.34 in chips) 
Seat 4: 311420212216613 ($10 in chips) 
Seat 5: Tophado0091 ($6.45 in chips) 
Seat 6: starikan872 ($11.99 in chips) 
ImperialOxxx: posts small blind $0.05
311420212216613: posts big blind $0.10
*** HOLE CARDS ***
Tophado0091: folds 
starikan872: folds 
hempju1ce: folds 
AK-47Rossiya: raises $0.20 to $0.30
ImperialOxxx: folds 
311420212216613: folds 
Uncalled bet ($0.20) returned to AK-47Rossiya
AK-47Rossiya collected $0.25 from pot
AK-47Rossiya: doesn't show hand 
*** SUMMARY ***
Total pot $0.25 | Rake $0 
Seat 1: hempju1ce folded before Flop (didn't bet)
Seat 2: AK-47Rossiya (button) collected ($0.25)
Seat 3: ImperialOxxx (small blind) folded before Flop
Seat 4: 311420212216613 (big blind) folded before Flop
Seat 5: Tophado0091 folded before Flop (didn't bet)
Seat 6: starikan872 folded before Flop (didn't bet)



PokerStars Hand #222972916093:  Hold'em No Limit ($0.05/$0.10 USD) - 2021/01/23 16:41:24 ET
Table 'Grus IV' 6-max Seat #3 is the button
Seat 1: hempju1ce ($24.82 in chips) 
Seat 2: AK-47Rossiya ($10.15 in chips) 
Seat 3: ImperialOxxx ($12.29 in chips) 
Seat 4: 311420212216613 ($10 in chips) 
Seat 5: Tophado0091 ($6.45 in chips) 
Seat 6: starikan872 ($11.99 in chips) 
311420212216613: posts small blind $0.05
Tophado0091: posts big blind $0.10
*** HOLE CARDS ***
starikan872: folds 
hempju1ce: folds 
AK-47Rossiya: folds 
ImperialOxxx: folds 
311420212216613: folds 
Uncalled bet ($0.05) returned to Tophado0091
Tophado0091 collected $0.10 from pot
Tophado0091: doesn't show hand 
*** SUMMARY ***
Total pot $0.10 | Rake $0 
Seat 1: hempju1ce folded before Flop (didn't bet)
Seat 2: AK-47Rossiya folded before Flop (didn't bet)
Seat 3: ImperialOxxx (button) folded before Flop (didn't bet)
Seat 4: 311420212216613 (small blind) folded before Flop
Seat 5: Tophado0091 (big blind) collected ($0.10)
Seat 6: starikan872 folded before Flop (didn't bet)



PokerStars Hand #222972924929:  Hold'em No Limit ($0.05/$0.10 USD) - 2021/01/23 16:41:34 ET
Table 'Grus IV' 6-max Seat #4 is the button
Seat 1: hempju1ce ($24.82 in chips) 
Seat 2: AK-47Rossiya ($10.15 in chips) 
Seat 3: ImperialOxxx ($12.29 in chips) 
Seat 4: 311420212216613 ($10 in chips) 
Seat 5: Tophado0091 ($6.50 in chips) 
Seat 6: starikan872 ($11.99 in chips) 
Tophado0091: posts small blind $0.05
starikan872: posts big blind $0.10
*** HOLE CARDS ***
hempju1ce: folds 
AK-47Rossiya: folds 
ImperialOxxx: raises $0.15 to $0.25
311420212216613: calls $0.25
Tophado0091: raises $0.15 to $0.40
starikan872: calls $0.30
ImperialOxxx: calls $0.15
311420212216613: calls $0.15
*** FLOP *** [2s 9d 4h]
Tophado0091: bets $1.10
starikan872: folds 
ImperialOxxx: calls $1.10
311420212216613: folds 
*** TURN *** [2s 9d 4h] [Ac]
Tophado0091: bets $1.40
ImperialOxxx: calls $1.40
*** RIVER *** [2s 9d 4h Ac] [4s]
Tophado0091: bets $1.10
ImperialOxxx: calls $1.10
*** SHOW DOWN ***
Tophado0091: shows [Ad Qd] (two pair, Aces and Fours)
ImperialOxxx: mucks hand 
Tophado0091 collected $8.40 from pot
*** SUMMARY ***
Total pot $8.80 | Rake $0.40 
Board [2s 9d 4h Ac 4s]
Seat 1: hempju1ce folded before Flop (didn't bet)
Seat 2: AK-47Rossiya folded before Flop (didn't bet)
Seat 3: ImperialOxxx mucked
Seat 4: 311420212216613 (button) folded on the Flop
Seat 5: Tophado0091 (small blind) showed [Ad Qd] and won ($8.40) with two pair, Aces and Fours
Seat 6: starikan872 (big blind) folded on the Flop



PokerStars Hand #222972976990:  Hold'em No Limit ($0.05/$0.10 USD) - 2021/01/23 16:42:37 ET
Table 'Grus IV' 6-max Seat #5 is the button
Seat 1: hempju1ce ($24.82 in chips) 
Seat 2: AK-47Rossiya ($10.15 in chips) 
Seat 3: ImperialOxxx ($10 in chips) 
Seat 4: 311420212216613 ($10 in chips) 
Seat 5: Tophado0091 ($10.90 in chips) 
Seat 6: starikan872 ($11.59 in chips) 
starikan872: posts small blind $0.05
hempju1ce: posts big blind $0.10
*** HOLE CARDS ***
AK-47Rossiya: raises $0.20 to $0.30
ImperialOxxx: folds 
311420212216613: folds 
Tophado0091: calls $0.30
starikan872: folds 
hempju1ce: folds 
*** FLOP *** [Qs Ah Js]
AK-47Rossiya: bets $0.48
Tophado0091: calls $0.48
*** TURN *** [Qs Ah Js] [6s]
AK-47Rossiya: bets $1.45
Tophado0091: folds 
Uncalled bet ($1.45) returned to AK-47Rossiya
AK-47Rossiya collected $1.63 from pot
AK-47Rossiya: doesn't show hand 
*** SUMMARY ***
Total pot $1.71 | Rake $0.08 
Board [Qs Ah Js 6s]
Seat 1: hempju1ce (big blind) folded before Flop
Seat 2: AK-47Rossiya collected ($1.63)
Seat 3: ImperialOxxx folded before Flop (didn't bet)
Seat 4: 311420212216613 folded before Flop (didn't bet)
Seat 5: Tophado0091 (button) folded on the Turn
Seat 6: starikan872 (small blind) folded before Flop



