PokerStars Hand #222963562701:  Hold'em No Limit ($0.05/$0.10 USD) - 2021/01/23 13:25:19 ET
Table 'Transvaalia' 6-max Seat #2 is the button
Seat 2: lastfox ($11.88 in chips) 
Seat 3: vicman121 ($10 in chips) 
Seat 4: TGVon ($10.55 in chips) 
Seat 5: ABIGOR 98 ($7.96 in chips) 
Seat 6: Bly5678 ($7.03 in chips) 
vicman121: posts small blind $0.05
TGVon: posts big blind $0.10
*** HOLE CARDS ***
ABIGOR 98: folds 
ABIGOR 98 leaves the table
Bly5678: folds 
lastfox: raises $0.13 to $0.23
vicman121: folds 
TGVon: calls $0.13
*** FLOP *** [Qs Jh Js]
TGVon: checks 
lastfox: bets $0.37
TGVon: calls $0.37
*** TURN *** [Qs Jh Js] [Ac]
TGVon: checks 
lastfox: bets $0.89
TGVon: folds 
Uncalled bet ($0.89) returned to lastfox
lastfox collected $1.19 from pot
lastfox: doesn't show hand 
*** SUMMARY ***
Total pot $1.25 | Rake $0.06 
Board [Qs Jh Js Ac]
Seat 2: lastfox (button) collected ($1.19)
Seat 3: vicman121 (small blind) folded before Flop
Seat 4: TGVon (big blind) folded on the Turn
Seat 5: ABIGOR 98 folded before Flop (didn't bet)
Seat 6: Bly5678 folded before Flop (didn't bet)



PokerStars Hand #222963606828:  Hold'em No Limit ($0.05/$0.10 USD) - 2021/01/23 13:26:17 ET
Table 'Transvaalia' 6-max Seat #3 is the button
Seat 2: lastfox ($12.47 in chips) 
Seat 3: vicman121 ($10 in chips) 
Seat 4: TGVon ($10 in chips) 
Seat 6: Bly5678 ($7.03 in chips) 
TGVon: posts small blind $0.05
Bly5678: posts big blind $0.10
*** HOLE CARDS ***
lastfox: folds 
vicman121: folds 
TGVon: folds 
Uncalled bet ($0.05) returned to Bly5678
Bly5678 collected $0.10 from pot
*** SUMMARY ***
Total pot $0.10 | Rake $0 
Seat 2: lastfox folded before Flop (didn't bet)
Seat 3: vicman121 (button) folded before Flop (didn't bet)
Seat 4: TGVon (small blind) folded before Flop
Seat 6: Bly5678 (big blind) collected ($0.10)



PokerStars Hand #222963613954:  Hold'em No Limit ($0.05/$0.10 USD) - 2021/01/23 13:26:27 ET
Table 'Transvaalia' 6-max Seat #4 is the button
Seat 2: lastfox ($12.47 in chips) 
Seat 3: vicman121 ($10 in chips) 
Seat 4: TGVon ($10 in chips) 
Seat 6: Bly5678 ($7.08 in chips) 
Bly5678: posts small blind $0.05
lastfox: posts big blind $0.10
*** HOLE CARDS ***
vicman121: folds 
TGVon: folds 
Bly5678: raises $0.10 to $0.20
lastfox: calls $0.10
*** FLOP *** [4d 8d As]
Bly5678: bets $0.19
lastfox: folds 
Uncalled bet ($0.19) returned to Bly5678
Bly5678 collected $0.38 from pot
*** SUMMARY ***
Total pot $0.40 | Rake $0.02 
Board [4d 8d As]
Seat 2: lastfox (big blind) folded on the Flop
Seat 3: vicman121 folded before Flop (didn't bet)
Seat 4: TGVon (button) folded before Flop (didn't bet)
Seat 6: Bly5678 (small blind) collected ($0.38)



PokerStars Hand #222963627385:  Hold'em No Limit ($0.05/$0.10 USD) - 2021/01/23 13:26:45 ET
Table 'Transvaalia' 6-max Seat #6 is the button
Seat 2: lastfox ($12.27 in chips) 
Seat 3: vicman121 ($10 in chips) 
Seat 4: TGVon ($10 in chips) 
Seat 6: Bly5678 ($7.26 in chips) 
lastfox: posts small blind $0.05
vicman121: posts big blind $0.10
*** HOLE CARDS ***
TGVon: folds 
FreshStyIe joins the table at seat #1 
Bly5678: calls $0.10
lastfox: folds 
vicman121: checks 
*** FLOP *** [8h 4s Ah]
vicman121: bets $0.10
Bly5678: folds 
Uncalled bet ($0.10) returned to vicman121
vicman121 collected $0.24 from pot
vicman121: doesn't show hand 
*** SUMMARY ***
Total pot $0.25 | Rake $0.01 
Board [8h 4s Ah]
Seat 2: lastfox (small blind) folded before Flop
Seat 3: vicman121 (big blind) collected ($0.24)
Seat 4: TGVon folded before Flop (didn't bet)
Seat 6: Bly5678 (button) folded on the Flop



PokerStars Hand #222963652878:  Hold'em No Limit ($0.05/$0.10 USD) - 2021/01/23 13:27:18 ET
Table 'Transvaalia' 6-max Seat #2 is the button
Seat 2: lastfox ($12.22 in chips) 
Seat 3: vicman121 ($10.14 in chips) 
Seat 4: TGVon ($10 in chips) 
Seat 6: Bly5678 ($7.16 in chips) 
vicman121: posts small blind $0.05
TGVon: posts big blind $0.10
FreshStyIe: sits out 
*** HOLE CARDS ***
Bly5678: raises $0.10 to $0.20
lastfox: folds 
vicman121: folds 
TGVon: raises $0.70 to $0.90
Bly5678: folds 
Uncalled bet ($0.70) returned to TGVon
TGVon collected $0.45 from pot
TGVon: doesn't show hand 
*** SUMMARY ***
Total pot $0.45 | Rake $0 
Seat 2: lastfox (button) folded before Flop (didn't bet)
Seat 3: vicman121 (small blind) folded before Flop
Seat 4: TGVon (big blind) collected ($0.45)
Seat 6: Bly5678 folded before Flop



PokerStars Hand #222963664372:  Hold'em No Limit ($0.05/$0.10 USD) - 2021/01/23 13:27:33 ET
Table 'Transvaalia' 6-max Seat #3 is the button
Seat 2: lastfox ($12.22 in chips) 
Seat 3: vicman121 ($10.09 in chips) 
Seat 4: TGVon ($10.25 in chips) 
Seat 6: Bly5678 ($6.96 in chips) 
TGVon: posts small blind $0.05
Bly5678: posts big blind $0.10
FreshStyIe: sits out 
*** HOLE CARDS ***
lastfox: folds 
vicman121: folds 
TGVon: folds 
Uncalled bet ($0.05) returned to Bly5678
Bly5678 collected $0.10 from pot
*** SUMMARY ***
Total pot $0.10 | Rake $0 
Seat 2: lastfox folded before Flop (didn't bet)
Seat 3: vicman121 (button) folded before Flop (didn't bet)
Seat 4: TGVon (small blind) folded before Flop
Seat 6: Bly5678 (big blind) collected ($0.10)



PokerStars Hand #222963672648:  Hold'em No Limit ($0.05/$0.10 USD) - 2021/01/23 13:27:44 ET
Table 'Transvaalia' 6-max Seat #4 is the button
Seat 1: FreshStyIe ($10 in chips) 
Seat 2: lastfox ($12.22 in chips) 
Seat 3: vicman121 ($10.09 in chips) 
Seat 4: TGVon ($10.20 in chips) 
Seat 6: Bly5678 ($7.01 in chips) 
Bly5678: posts small blind $0.05
FreshStyIe: posts big blind $0.10
*** HOLE CARDS ***
OShane110 joins the table at seat #5 
lastfox: raises $0.13 to $0.23
vicman121: folds 
TGVon: folds 
Bly5678: calls $0.18
FreshStyIe: folds 
*** FLOP *** [Ad 4h Qh]
Bly5678: checks 
lastfox: checks 
*** TURN *** [Ad 4h Qh] [3h]
Bly5678: checks 
lastfox: checks 
*** RIVER *** [Ad 4h Qh 3h] [3s]
Bly5678: bets $0.10
lastfox: calls $0.10
*** SHOW DOWN ***
Bly5678: shows [Qc 7c] (two pair, Queens and Threes)
lastfox: mucks hand 
Bly5678 collected $0.73 from pot
*** SUMMARY ***
Total pot $0.76 | Rake $0.03 
Board [Ad 4h Qh 3h 3s]
Seat 1: FreshStyIe (big blind) folded before Flop
Seat 2: lastfox mucked
Seat 3: vicman121 folded before Flop (didn't bet)
Seat 4: TGVon (button) folded before Flop (didn't bet)
Seat 6: Bly5678 (small blind) showed [Qc 7c] and won ($0.73) with two pair, Queens and Threes



PokerStars Hand #222963703737:  Hold'em No Limit ($0.05/$0.10 USD) - 2021/01/23 13:28:25 ET
Table 'Transvaalia' 6-max Seat #6 is the button
Seat 1: FreshStyIe ($10 in chips) 
Seat 2: lastfox ($11.89 in chips) 
Seat 3: vicman121 ($10.09 in chips) 
Seat 4: TGVon ($10.20 in chips) 
Seat 5: OShane110 ($7.08 in chips) 
Seat 6: Bly5678 ($7.41 in chips) 
FreshStyIe: posts small blind $0.05
lastfox: posts big blind $0.10
OShane110: posts big blind $0.10
*** HOLE CARDS ***
vicman121 has timed out
vicman121: folds 
TGVon: folds 
OShane110: raises $0.10 to $0.20
Bly5678: folds 
FreshStyIe: folds 
lastfox: calls $0.10
*** FLOP *** [Jd Kh Jh]
lastfox: checks 
OShane110: checks 
*** TURN *** [Jd Kh Jh] [4h]
lastfox: checks 
OShane110: checks 
*** RIVER *** [Jd Kh Jh 4h] [Ks]
lastfox: checks 
OShane110: checks 
*** SHOW DOWN ***
lastfox: shows [3c 6c] (two pair, Kings and Jacks)
OShane110: mucks hand 
lastfox collected $0.43 from pot
*** SUMMARY ***
Total pot $0.45 | Rake $0.02 
Board [Jd Kh Jh 4h Ks]
Seat 1: FreshStyIe (small blind) folded before Flop
Seat 2: lastfox (big blind) showed [3c 6c] and won ($0.43) with two pair, Kings and Jacks
Seat 3: vicman121 folded before Flop (didn't bet)
Seat 4: TGVon folded before Flop (didn't bet)
Seat 5: OShane110 mucked
Seat 6: Bly5678 (button) folded before Flop (didn't bet)



PokerStars Hand #222963727168:  Hold'em No Limit ($0.05/$0.10 USD) - 2021/01/23 13:28:56 ET
Table 'Transvaalia' 6-max Seat #1 is the button
Seat 1: FreshStyIe ($10 in chips) 
Seat 2: lastfox ($12.12 in chips) 
Seat 3: vicman121 ($10.09 in chips) 
Seat 4: TGVon ($10.20 in chips) 
Seat 5: OShane110 ($6.88 in chips) 
Seat 6: Bly5678 ($7.41 in chips) 
lastfox: posts small blind $0.05
vicman121: posts big blind $0.10
*** HOLE CARDS ***
TGVon: folds 
OShane110: raises $0.70 to $0.80
Bly5678: folds 
FreshStyIe: folds 
lastfox: calls $0.75
vicman121: folds 
*** FLOP *** [9d 3h 4c]
lastfox: checks 
OShane110: checks 
*** TURN *** [9d 3h 4c] [Qs]
lastfox: bets $1.35
OShane110: folds 
Uncalled bet ($1.35) returned to lastfox
lastfox collected $1.62 from pot
lastfox: doesn't show hand 
*** SUMMARY ***
Total pot $1.70 | Rake $0.08 
Board [9d 3h 4c Qs]
Seat 1: FreshStyIe (button) folded before Flop (didn't bet)
Seat 2: lastfox (small blind) collected ($1.62)
Seat 3: vicman121 (big blind) folded before Flop
Seat 4: TGVon folded before Flop (didn't bet)
Seat 5: OShane110 folded on the Turn
Seat 6: Bly5678 folded before Flop (didn't bet)



PokerStars Hand #222963769504:  Hold'em No Limit ($0.05/$0.10 USD) - 2021/01/23 13:29:53 ET
Table 'Transvaalia' 6-max Seat #2 is the button
Seat 1: FreshStyIe ($10 in chips) 
Seat 2: lastfox ($12.94 in chips) 
Seat 3: vicman121 ($10 in chips) 
Seat 4: TGVon ($10.20 in chips) 
Seat 5: OShane110 ($6.08 in chips) 
Seat 6: Bly5678 ($7.41 in chips) 
vicman121: posts small blind $0.05
TGVon: posts big blind $0.10
*** HOLE CARDS ***
OShane110: raises $1 to $1.10
Bly5678: folds 
FreshStyIe: folds 
lastfox: folds 
vicman121: folds 
TGVon: folds 
Uncalled bet ($1) returned to OShane110
OShane110 collected $0.25 from pot
OShane110: doesn't show hand 
*** SUMMARY ***
Total pot $0.25 | Rake $0 
Seat 1: FreshStyIe folded before Flop (didn't bet)
Seat 2: lastfox (button) folded before Flop (didn't bet)
Seat 3: vicman121 (small blind) folded before Flop
Seat 4: TGVon (big blind) folded before Flop
Seat 5: OShane110 collected ($0.25)
Seat 6: Bly5678 folded before Flop (didn't bet)



PokerStars Hand #222963788571:  Hold'em No Limit ($0.05/$0.10 USD) - 2021/01/23 13:30:17 ET
Table 'Transvaalia' 6-max Seat #3 is the button
Seat 1: FreshStyIe ($10 in chips) 
Seat 2: lastfox ($12.94 in chips) 
Seat 3: vicman121 ($10 in chips) 
Seat 4: TGVon ($10.10 in chips) 
Seat 5: OShane110 ($6.23 in chips) 
Seat 6: Bly5678 ($7.41 in chips) 
TGVon: posts small blind $0.05
OShane110: posts big blind $0.10
*** HOLE CARDS ***
Bly5678: calls $0.10
FreshStyIe: folds 
lastfox: folds 
vicman121: folds 
TGVon: folds 
OShane110: checks 
*** FLOP *** [9h Js 9d]
OShane110: bets $0.12
Bly5678: folds 
Uncalled bet ($0.12) returned to OShane110
OShane110 collected $0.24 from pot
OShane110: doesn't show hand 
*** SUMMARY ***
Total pot $0.25 | Rake $0.01 
Board [9h Js 9d]
Seat 1: FreshStyIe folded before Flop (didn't bet)
Seat 2: lastfox folded before Flop (didn't bet)
Seat 3: vicman121 (button) folded before Flop (didn't bet)
Seat 4: TGVon (small blind) folded before Flop
Seat 5: OShane110 (big blind) collected ($0.24)
Seat 6: Bly5678 folded on the Flop



PokerStars Hand #222963820455:  Hold'em No Limit ($0.05/$0.10 USD) - 2021/01/23 13:30:58 ET
Table 'Transvaalia' 6-max Seat #4 is the button
Seat 1: FreshStyIe ($10 in chips) 
Seat 2: lastfox ($12.94 in chips) 
Seat 3: vicman121 ($10 in chips) 
Seat 4: TGVon ($10.05 in chips) 
Seat 5: OShane110 ($6.37 in chips) 
Seat 6: Bly5678 ($7.31 in chips) 
OShane110: posts small blind $0.05
Bly5678: posts big blind $0.10
*** HOLE CARDS ***
FreshStyIe: folds 
lastfox: folds 
vicman121: folds 
TGVon: raises $0.15 to $0.25
OShane110: folds 
Bly5678: folds 
Uncalled bet ($0.15) returned to TGVon
TGVon collected $0.25 from pot
TGVon: doesn't show hand 
*** SUMMARY ***
Total pot $0.25 | Rake $0 
Seat 1: FreshStyIe folded before Flop (didn't bet)
Seat 2: lastfox folded before Flop (didn't bet)
Seat 3: vicman121 folded before Flop (didn't bet)
Seat 4: TGVon (button) collected ($0.25)
Seat 5: OShane110 (small blind) folded before Flop
Seat 6: Bly5678 (big blind) folded before Flop



PokerStars Hand #222963834540:  Hold'em No Limit ($0.05/$0.10 USD) - 2021/01/23 13:31:16 ET
Table 'Transvaalia' 6-max Seat #5 is the button
Seat 1: FreshStyIe ($10 in chips) 
Seat 2: lastfox ($12.94 in chips) 
Seat 3: vicman121 ($10 in chips) 
Seat 4: TGVon ($10.20 in chips) 
Seat 5: OShane110 ($6.32 in chips) 
Seat 6: Bly5678 ($7.21 in chips) 
Bly5678: posts small blind $0.05
FreshStyIe: posts big blind $0.10
*** HOLE CARDS ***
lastfox: folds 
vicman121: folds 
TGVon: folds 
OShane110: raises $0.25 to $0.35
Bly5678: raises $0.55 to $0.90
FreshStyIe: folds 
OShane110: calls $0.55
*** FLOP *** [Th Ad 2s]
Bly5678: bets $0.40
OShane110: calls $0.40
*** TURN *** [Th Ad 2s] [8c]
Bly5678: checks 
OShane110: checks 
*** RIVER *** [Th Ad 2s 8c] [6c]
Bly5678: bets $1.29
OShane110: folds 
Uncalled bet ($1.29) returned to Bly5678
Bly5678 collected $2.58 from pot
*** SUMMARY ***
Total pot $2.70 | Rake $0.12 
Board [Th Ad 2s 8c 6c]
Seat 1: FreshStyIe (big blind) folded before Flop
Seat 2: lastfox folded before Flop (didn't bet)
Seat 3: vicman121 folded before Flop (didn't bet)
Seat 4: TGVon folded before Flop (didn't bet)
Seat 5: OShane110 (button) folded on the River
Seat 6: Bly5678 (small blind) collected ($2.58)



PokerStars Hand #222963873031:  Hold'em No Limit ($0.05/$0.10 USD) - 2021/01/23 13:32:06 ET
Table 'Transvaalia' 6-max Seat #6 is the button
Seat 1: FreshStyIe ($10 in chips) 
Seat 2: lastfox ($12.94 in chips) 
Seat 3: vicman121 ($10 in chips) 
Seat 4: TGVon ($10.20 in chips) 
Seat 5: OShane110 ($5.02 in chips) 
Seat 6: Bly5678 ($8.49 in chips) 
FreshStyIe: posts small blind $0.05
lastfox: posts big blind $0.10
*** HOLE CARDS ***
vicman121: folds 
TGVon: folds 
OShane110: calls $0.10
Bly5678: calls $0.10
FreshStyIe: folds 
lastfox: checks 
*** FLOP *** [6s 5c Qd]
lastfox: checks 
OShane110: bets $0.10
Bly5678: calls $0.10
lastfox: calls $0.10
*** TURN *** [6s 5c Qd] [Kh]
lastfox: checks 
OShane110: checks 
Bly5678: checks 
*** RIVER *** [6s 5c Qd Kh] [8c]
lastfox: checks 
OShane110: bets $0.62
Bly5678: folds 
lastfox: folds 
Uncalled bet ($0.62) returned to OShane110
OShane110 collected $0.62 from pot
OShane110: doesn't show hand 
*** SUMMARY ***
Total pot $0.65 | Rake $0.03 
Board [6s 5c Qd Kh 8c]
Seat 1: FreshStyIe (small blind) folded before Flop
Seat 2: lastfox (big blind) folded on the River
Seat 3: vicman121 folded before Flop (didn't bet)
Seat 4: TGVon folded before Flop (didn't bet)
Seat 5: OShane110 collected ($0.62)
Seat 6: Bly5678 (button) folded on the River



PokerStars Hand #222963907157:  Hold'em No Limit ($0.05/$0.10 USD) - 2021/01/23 13:32:49 ET
Table 'Transvaalia' 6-max Seat #1 is the button
Seat 1: FreshStyIe ($10 in chips) 
Seat 2: lastfox ($12.74 in chips) 
Seat 3: vicman121 ($10 in chips) 
Seat 4: TGVon ($10.20 in chips) 
Seat 5: OShane110 ($5.44 in chips) 
Seat 6: Bly5678 ($8.29 in chips) 
lastfox: posts small blind $0.05
vicman121: posts big blind $0.10
*** HOLE CARDS ***
TGVon: folds 
OShane110: calls $0.10
Bly5678: raises $0.20 to $0.30
FreshStyIe: folds 
lastfox: folds 
vicman121: folds 
OShane110: calls $0.20
*** FLOP *** [2s Tc 4d]
OShane110: bets $0.10
Bly5678: raises $0.30 to $0.40
OShane110: calls $0.30
*** TURN *** [2s Tc 4d] [Ac]
OShane110: checks 
Bly5678: bets $0.74
OShane110: calls $0.74
*** RIVER *** [2s Tc 4d Ac] [6h]
OShane110: checks 
Bly5678: bets $1.50
OShane110: folds 
Uncalled bet ($1.50) returned to Bly5678
Bly5678 collected $2.89 from pot
*** SUMMARY ***
Total pot $3.03 | Rake $0.14 
Board [2s Tc 4d Ac 6h]
Seat 1: FreshStyIe (button) folded before Flop (didn't bet)
Seat 2: lastfox (small blind) folded before Flop
Seat 3: vicman121 (big blind) folded before Flop
Seat 4: TGVon folded before Flop (didn't bet)
Seat 5: OShane110 folded on the River
Seat 6: Bly5678 collected ($2.89)



PokerStars Hand #222963946497:  Hold'em No Limit ($0.05/$0.10 USD) - 2021/01/23 13:33:40 ET
Table 'Transvaalia' 6-max Seat #2 is the button
Seat 1: FreshStyIe ($10 in chips) 
Seat 2: lastfox ($12.69 in chips) 
Seat 3: vicman121 ($10 in chips) 
Seat 4: TGVon ($10.20 in chips) 
Seat 5: OShane110 ($4 in chips) 
Seat 6: Bly5678 ($9.74 in chips) 
vicman121: posts small blind $0.05
TGVon: posts big blind $0.10
*** HOLE CARDS ***
OShane110: raises $3.90 to $4 and is all-in
Bly5678: folds 
FreshStyIe: folds 
lastfox: folds 
vicman121: folds 
TGVon: calls $3.90
*** FLOP *** [5d 3s 9h]
*** TURN *** [5d 3s 9h] [Td]
*** RIVER *** [5d 3s 9h Td] [2c]
*** SHOW DOWN ***
TGVon: shows [Kd Jc] (high card King)
OShane110: shows [7s 8h] (high card Ten)
TGVon collected $7.69 from pot
*** SUMMARY ***
Total pot $8.05 | Rake $0.36 
Board [5d 3s 9h Td 2c]
Seat 1: FreshStyIe folded before Flop (didn't bet)
Seat 2: lastfox (button) folded before Flop (didn't bet)
Seat 3: vicman121 (small blind) folded before Flop
Seat 4: TGVon (big blind) showed [Kd Jc] and won ($7.69) with high card King
Seat 5: OShane110 showed [7s 8h] and lost with high card Ten
Seat 6: Bly5678 folded before Flop (didn't bet)



PokerStars Hand #222963966590:  Hold'em No Limit ($0.05/$0.10 USD) - 2021/01/23 13:34:06 ET
Table 'Transvaalia' 6-max Seat #3 is the button
Seat 1: FreshStyIe ($10 in chips) 
Seat 2: lastfox ($12.69 in chips) 
Seat 3: vicman121 ($10 in chips) 
Seat 4: TGVon ($13.89 in chips) 
Seat 6: Bly5678 ($9.74 in chips) 
TGVon: posts small blind $0.05
Bly5678: posts big blind $0.10
*** HOLE CARDS ***
FreshStyIe: folds 
lastfox: folds 
vicman121: folds 
OShane110 is disconnected 
TGVon: raises $0.20 to $0.30
Bly5678: calls $0.20
*** FLOP *** [Kd Qd 9h]
TGVon: checks 
OShane110 leaves the table
Bly5678: bets $0.30
TGVon: calls $0.30
*** TURN *** [Kd Qd 9h] [4s]
TGVon: checks 
Bly5678: checks 
*** RIVER *** [Kd Qd 9h 4s] [4d]
TGVon: bets $0.38
Bly5678: calls $0.38
*** SHOW DOWN ***
TGVon: shows [Jh Kh] (two pair, Kings and Fours)
Bly5678: shows [5d 6d] (a flush, King high)
Bly5678 collected $1.87 from pot
*** SUMMARY ***
Total pot $1.96 | Rake $0.09 
Board [Kd Qd 9h 4s 4d]
Seat 1: FreshStyIe folded before Flop (didn't bet)
Seat 2: lastfox folded before Flop (didn't bet)
Seat 3: vicman121 (button) folded before Flop (didn't bet)
Seat 4: TGVon (small blind) showed [Jh Kh] and lost with two pair, Kings and Fours
Seat 6: Bly5678 (big blind) showed [5d 6d] and won ($1.87) with a flush, King high



PokerStars Hand #222964005856:  Hold'em No Limit ($0.05/$0.10 USD) - 2021/01/23 13:34:56 ET
Table 'Transvaalia' 6-max Seat #4 is the button
Seat 1: FreshStyIe ($10 in chips) 
Seat 2: lastfox ($12.69 in chips) 
Seat 3: vicman121 ($10 in chips) 
Seat 4: TGVon ($12.91 in chips) 
Seat 6: Bly5678 ($10.63 in chips) 
Bly5678: posts small blind $0.05
FreshStyIe: posts big blind $0.10
*** HOLE CARDS ***
lastfox: folds 
vicman121: folds 
TGVon: folds 
Bly5678: raises $0.10 to $0.20
FreshStyIe: folds 
Uncalled bet ($0.10) returned to Bly5678
Bly5678 collected $0.20 from pot
*** SUMMARY ***
Total pot $0.20 | Rake $0 
Seat 1: FreshStyIe (big blind) folded before Flop
Seat 2: lastfox folded before Flop (didn't bet)
Seat 3: vicman121 folded before Flop (didn't bet)
Seat 4: TGVon (button) folded before Flop (didn't bet)
Seat 6: Bly5678 (small blind) collected ($0.20)



PokerStars Hand #222964015346:  Hold'em No Limit ($0.05/$0.10 USD) - 2021/01/23 13:35:08 ET
Table 'Transvaalia' 6-max Seat #6 is the button
Seat 1: FreshStyIe ($10 in chips) 
Seat 2: lastfox ($12.69 in chips) 
Seat 3: vicman121 ($10 in chips) 
Seat 4: TGVon ($12.91 in chips) 
Seat 6: Bly5678 ($10.73 in chips) 
FreshStyIe: posts small blind $0.05
lastfox: posts big blind $0.10
*** HOLE CARDS ***
vicman121: folds 
TGVon: folds 
Bly5678: folds 
FreshStyIe: raises $0.15 to $0.25
lastfox: folds 
Uncalled bet ($0.15) returned to FreshStyIe
FreshStyIe collected $0.20 from pot
FreshStyIe: doesn't show hand 
*** SUMMARY ***
Total pot $0.20 | Rake $0 
Seat 1: FreshStyIe (small blind) collected ($0.20)
Seat 2: lastfox (big blind) folded before Flop
Seat 3: vicman121 folded before Flop (didn't bet)
Seat 4: TGVon folded before Flop (didn't bet)
Seat 6: Bly5678 (button) folded before Flop (didn't bet)



PokerStars Hand #222964023014:  Hold'em No Limit ($0.05/$0.10 USD) - 2021/01/23 13:35:18 ET
Table 'Transvaalia' 6-max Seat #1 is the button
Seat 1: FreshStyIe ($10.10 in chips) 
Seat 2: lastfox ($12.59 in chips) 
Seat 3: vicman121 ($10 in chips) 
Seat 4: TGVon ($12.91 in chips) 
Seat 6: Bly5678 ($10.73 in chips) 
lastfox: posts small blind $0.05
vicman121: posts big blind $0.10
*** HOLE CARDS ***
vasilisvel43 joins the table at seat #5 
TGVon: folds 
Bly5678: raises $0.20 to $0.30
FreshStyIe: folds 
lastfox: raises $0.85 to $1.15
vicman121: folds 
Bly5678: folds 
Uncalled bet ($0.85) returned to lastfox
lastfox collected $0.70 from pot
lastfox: doesn't show hand 
*** SUMMARY ***
Total pot $0.70 | Rake $0 
Seat 1: FreshStyIe (button) folded before Flop (didn't bet)
Seat 2: lastfox (small blind) collected ($0.70)
Seat 3: vicman121 (big blind) folded before Flop
Seat 4: TGVon folded before Flop (didn't bet)
Seat 6: Bly5678 folded before Flop



PokerStars Hand #222964041705:  Hold'em No Limit ($0.05/$0.10 USD) - 2021/01/23 13:35:42 ET
Table 'Transvaalia' 6-max Seat #2 is the button
Seat 1: FreshStyIe ($10.10 in chips) 
Seat 2: lastfox ($12.99 in chips) 
Seat 3: vicman121 ($10 in chips) 
Seat 4: TGVon ($12.91 in chips) 
Seat 5: vasilisvel43 ($10 in chips) 
Seat 6: Bly5678 ($10.43 in chips) 
vicman121: posts small blind $0.05
TGVon: posts big blind $0.10
vasilisvel43: posts big blind $0.10
*** HOLE CARDS ***
vasilisvel43: checks 
Bly5678: folds 
FreshStyIe: folds 
lastfox: folds 
vicman121: folds 
TGVon: checks 
*** FLOP *** [Ac 9c 2d]
TGVon: checks 
vasilisvel43: checks 
*** TURN *** [Ac 9c 2d] [9s]
TGVon: bets $0.18
vasilisvel43: folds 
Uncalled bet ($0.18) returned to TGVon
TGVon collected $0.24 from pot
TGVon: doesn't show hand 
*** SUMMARY ***
Total pot $0.25 | Rake $0.01 
Board [Ac 9c 2d 9s]
Seat 1: FreshStyIe folded before Flop (didn't bet)
Seat 2: lastfox (button) folded before Flop (didn't bet)
Seat 3: vicman121 (small blind) folded before Flop
Seat 4: TGVon (big blind) collected ($0.24)
Seat 5: vasilisvel43 folded on the Turn (didn't bet)
Seat 6: Bly5678 folded before Flop (didn't bet)



PokerStars Hand #222964064707:  Hold'em No Limit ($0.05/$0.10 USD) - 2021/01/23 13:36:12 ET
Table 'Transvaalia' 6-max Seat #3 is the button
Seat 1: FreshStyIe ($10.10 in chips) 
Seat 2: lastfox ($12.99 in chips) 
Seat 3: vicman121 ($10 in chips) 
Seat 4: TGVon ($13.05 in chips) 
Seat 5: vasilisvel43 ($9.90 in chips) 
Seat 6: Bly5678 ($10.43 in chips) 
TGVon: posts small blind $0.05
vasilisvel43: posts big blind $0.10
*** HOLE CARDS ***
Bly5678: folds 
FreshStyIe: folds 
lastfox: raises $0.13 to $0.23
vicman121: raises $0.67 to $0.90
TGVon: folds 
vasilisvel43: calls $0.80
lastfox: calls $0.67
*** FLOP *** [6d Kd Ks]
vasilisvel43: checks 
lastfox: checks 
vicman121: bets $0.79
vasilisvel43: folds 
lastfox: folds 
Uncalled bet ($0.79) returned to vicman121
vicman121 collected $2.63 from pot
vicman121: doesn't show hand 
*** SUMMARY ***
Total pot $2.75 | Rake $0.12 
Board [6d Kd Ks]
Seat 1: FreshStyIe folded before Flop (didn't bet)
Seat 2: lastfox folded on the Flop
Seat 3: vicman121 (button) collected ($2.63)
Seat 4: TGVon (small blind) folded before Flop
Seat 5: vasilisvel43 (big blind) folded on the Flop
Seat 6: Bly5678 folded before Flop (didn't bet)



PokerStars Hand #222964102455:  Hold'em No Limit ($0.05/$0.10 USD) - 2021/01/23 13:37:01 ET
Table 'Transvaalia' 6-max Seat #4 is the button
Seat 1: FreshStyIe ($10.10 in chips) 
Seat 2: lastfox ($12.09 in chips) 
Seat 3: vicman121 ($11.73 in chips) 
Seat 4: TGVon ($13 in chips) 
Seat 5: vasilisvel43 ($9 in chips) 
Seat 6: Bly5678 ($10.43 in chips) 
vasilisvel43: posts small blind $0.05
Bly5678: posts big blind $0.10
*** HOLE CARDS ***
FreshStyIe: folds 
lastfox: folds 
vicman121: folds 
TGVon: folds 
vasilisvel43: calls $0.05
Bly5678: raises $0.20 to $0.30
vasilisvel43: calls $0.20
*** FLOP *** [4d Tc 7s]
vasilisvel43: bets $0.10
Bly5678: raises $0.40 to $0.50
vasilisvel43: calls $0.40
*** TURN *** [4d Tc 7s] [Jc]
vasilisvel43: bets $0.77
Bly5678: folds 
Uncalled bet ($0.77) returned to vasilisvel43
vasilisvel43 collected $1.53 from pot
vasilisvel43: doesn't show hand 
*** SUMMARY ***
Total pot $1.60 | Rake $0.07 
Board [4d Tc 7s Jc]
Seat 1: FreshStyIe folded before Flop (didn't bet)
Seat 2: lastfox folded before Flop (didn't bet)
Seat 3: vicman121 folded before Flop (didn't bet)
Seat 4: TGVon (button) folded before Flop (didn't bet)
Seat 5: vasilisvel43 (small blind) collected ($1.53)
Seat 6: Bly5678 (big blind) folded on the Turn



PokerStars Hand #222964129383:  Hold'em No Limit ($0.05/$0.10 USD) - 2021/01/23 13:37:35 ET
Table 'Transvaalia' 6-max Seat #5 is the button
Seat 1: FreshStyIe ($10.10 in chips) 
Seat 2: lastfox ($12.09 in chips) 
Seat 3: vicman121 ($11.73 in chips) 
Seat 4: TGVon ($13 in chips) 
Seat 5: vasilisvel43 ($9.73 in chips) 
Seat 6: Bly5678 ($9.63 in chips) 
Bly5678: posts small blind $0.05
FreshStyIe: posts big blind $0.10
*** HOLE CARDS ***
lastfox: folds 
vicman121: folds 
TGVon: raises $0.15 to $0.25
vasilisvel43: calls $0.25
Bly5678: calls $0.20
FreshStyIe: folds 
*** FLOP *** [Tc Kh As]
Bly5678: checks 
TGVon: checks 
vasilisvel43: bets $0.41
Bly5678: calls $0.41
TGVon: folds 
*** TURN *** [Tc Kh As] [9s]
Bly5678: checks 
vasilisvel43: bets $0.80
Bly5678: calls $0.80
*** RIVER *** [Tc Kh As 9s] [Jh]
Bly5678: bets $1.56
vasilisvel43: calls $1.56
*** SHOW DOWN ***
Bly5678: shows [6c Ah] (a pair of Aces)
vasilisvel43: shows [Ts Ks] (two pair, Kings and Tens)
vasilisvel43 collected $6.10 from pot
*** SUMMARY ***
Total pot $6.39 | Rake $0.29 
Board [Tc Kh As 9s Jh]
Seat 1: FreshStyIe (big blind) folded before Flop
Seat 2: lastfox folded before Flop (didn't bet)
Seat 3: vicman121 folded before Flop (didn't bet)
Seat 4: TGVon folded on the Flop
Seat 5: vasilisvel43 (button) showed [Ts Ks] and won ($6.10) with two pair, Kings and Tens
Seat 6: Bly5678 (small blind) showed [6c Ah] and lost with a pair of Aces



PokerStars Hand #222964175999:  Hold'em No Limit ($0.05/$0.10 USD) - 2021/01/23 13:38:36 ET
Table 'Transvaalia' 6-max Seat #6 is the button
Seat 1: FreshStyIe ($10 in chips) 
Seat 2: lastfox ($12.09 in chips) 
Seat 3: vicman121 ($11.73 in chips) 
Seat 4: TGVon ($12.75 in chips) 
Seat 5: vasilisvel43 ($12.81 in chips) 
Seat 6: Bly5678 ($6.61 in chips) 
FreshStyIe: posts small blind $0.05
lastfox: posts big blind $0.10
*** HOLE CARDS ***
vicman121: raises $0.20 to $0.30
TGVon: folds 
vasilisvel43: folds 
Bly5678: calls $0.30
FreshStyIe: folds 
lastfox: folds 
*** FLOP *** [2h 7d 5h]
vicman121: bets $0.54
Bly5678: folds 
Uncalled bet ($0.54) returned to vicman121
vicman121 collected $0.72 from pot
vicman121: doesn't show hand 
*** SUMMARY ***
Total pot $0.75 | Rake $0.03 
Board [2h 7d 5h]
Seat 1: FreshStyIe (small blind) folded before Flop
Seat 2: lastfox (big blind) folded before Flop
Seat 3: vicman121 collected ($0.72)
Seat 4: TGVon folded before Flop (didn't bet)
Seat 5: vasilisvel43 folded before Flop (didn't bet)
Seat 6: Bly5678 (button) folded on the Flop



PokerStars Hand #222964198188:  Hold'em No Limit ($0.05/$0.10 USD) - 2021/01/23 13:39:04 ET
Table 'Transvaalia' 6-max Seat #1 is the button
Seat 1: FreshStyIe ($10 in chips) 
Seat 2: lastfox ($11.99 in chips) 
Seat 3: vicman121 ($12.15 in chips) 
Seat 4: TGVon ($12.75 in chips) 
Seat 5: vasilisvel43 ($12.81 in chips) 
Seat 6: Bly5678 ($6.31 in chips) 
lastfox: posts small blind $0.05
vicman121: posts big blind $0.10
*** HOLE CARDS ***
TGVon: folds 
vasilisvel43: calls $0.10
Bly5678: folds 
FreshStyIe: folds 
lastfox: raises $0.23 to $0.33
vicman121: folds 
vasilisvel43: calls $0.23
*** FLOP *** [9d 9h 7d]
lastfox: checks 
vasilisvel43: checks 
*** TURN *** [9d 9h 7d] [8c]
lastfox: checks 
vasilisvel43: bets $0.40
lastfox: calls $0.40
*** RIVER *** [9d 9h 7d 8c] [2h]
lastfox: checks 
vasilisvel43: checks 
*** SHOW DOWN ***
lastfox: shows [Ts Ac] (a pair of Nines)
vasilisvel43: mucks hand 
lastfox collected $1.49 from pot
*** SUMMARY ***
Total pot $1.56 | Rake $0.07 
Board [9d 9h 7d 8c 2h]
Seat 1: FreshStyIe (button) folded before Flop (didn't bet)
Seat 2: lastfox (small blind) showed [Ts Ac] and won ($1.49) with a pair of Nines
Seat 3: vicman121 (big blind) folded before Flop
Seat 4: TGVon folded before Flop (didn't bet)
Seat 5: vasilisvel43 mucked
Seat 6: Bly5678 folded before Flop (didn't bet)



PokerStars Hand #222964230850:  Hold'em No Limit ($0.05/$0.10 USD) - 2021/01/23 13:39:47 ET
Table 'Transvaalia' 6-max Seat #2 is the button
Seat 1: FreshStyIe ($10 in chips) 
Seat 2: lastfox ($12.75 in chips) 
Seat 3: vicman121 ($12.05 in chips) 
Seat 4: TGVon ($12.75 in chips) 
Seat 5: vasilisvel43 ($12.08 in chips) 
Seat 6: Bly5678 ($6.31 in chips) 
vicman121: posts small blind $0.05
TGVon: posts big blind $0.10
*** HOLE CARDS ***
vasilisvel43: raises $0.10 to $0.20
Bly5678: folds 
FreshStyIe: folds 
lastfox: folds 
vicman121: folds 
TGVon: folds 
Uncalled bet ($0.10) returned to vasilisvel43
vasilisvel43 collected $0.25 from pot
vasilisvel43: doesn't show hand 
*** SUMMARY ***
Total pot $0.25 | Rake $0 
Seat 1: FreshStyIe folded before Flop (didn't bet)
Seat 2: lastfox (button) folded before Flop (didn't bet)
Seat 3: vicman121 (small blind) folded before Flop
Seat 4: TGVon (big blind) folded before Flop
Seat 5: vasilisvel43 collected ($0.25)
Seat 6: Bly5678 folded before Flop (didn't bet)



PokerStars Hand #222964245353:  Hold'em No Limit ($0.05/$0.10 USD) - 2021/01/23 13:40:05 ET
Table 'Transvaalia' 6-max Seat #3 is the button
Seat 1: FreshStyIe ($10 in chips) 
Seat 2: lastfox ($12.75 in chips) 
Seat 3: vicman121 ($12 in chips) 
Seat 4: TGVon ($12.65 in chips) 
Seat 5: vasilisvel43 ($12.23 in chips) 
Seat 6: Bly5678 ($6.31 in chips) 
TGVon: posts small blind $0.05
vasilisvel43: posts big blind $0.10
*** HOLE CARDS ***
Bly5678: folds 
FreshStyIe: folds 
lastfox: folds 
Bly5678 leaves the table
vicman121: raises $0.15 to $0.25
TGVon: folds 
vasilisvel43: calls $0.15
*** FLOP *** [Kh 8h Tc]
bazil139 joins the table at seat #6 
vasilisvel43: bets $0.10
vicman121: calls $0.10
*** TURN *** [Kh 8h Tc] [Ah]
vasilisvel43: bets $0.30
vicman121: folds 
Uncalled bet ($0.30) returned to vasilisvel43
vasilisvel43 collected $0.72 from pot
vasilisvel43: doesn't show hand 
*** SUMMARY ***
Total pot $0.75 | Rake $0.03 
Board [Kh 8h Tc Ah]
Seat 1: FreshStyIe folded before Flop (didn't bet)
Seat 2: lastfox folded before Flop (didn't bet)
Seat 3: vicman121 (button) folded on the Turn
Seat 4: TGVon (small blind) folded before Flop
Seat 5: vasilisvel43 (big blind) collected ($0.72)
Seat 6: Bly5678 folded before Flop (didn't bet)



PokerStars Hand #222964277377:  Hold'em No Limit ($0.05/$0.10 USD) - 2021/01/23 13:40:47 ET
Table 'Transvaalia' 6-max Seat #4 is the button
Seat 1: FreshStyIe ($10 in chips) 
Seat 2: lastfox ($12.75 in chips) 
Seat 3: vicman121 ($11.65 in chips) 
Seat 4: TGVon ($12.60 in chips) 
Seat 5: vasilisvel43 ($12.60 in chips) 
Seat 6: bazil139 ($10 in chips) 
vasilisvel43: posts small blind $0.05
bazil139: posts big blind $0.10
*** HOLE CARDS ***
FreshStyIe: folds 
lastfox: folds 
vicman121: folds 
TGVon: folds 
vasilisvel43: calls $0.05
bazil139: checks 
*** FLOP *** [7h Jh Kd]
vasilisvel43: bets $0.10
bazil139: calls $0.10
*** TURN *** [7h Jh Kd] [Js]
vasilisvel43: bets $0.10
bazil139: calls $0.10
*** RIVER *** [7h Jh Kd Js] [9c]
vasilisvel43: bets $1.30
bazil139: calls $1.30
*** SHOW DOWN ***
vasilisvel43: shows [Ts Ac] (a pair of Jacks)
bazil139: shows [Kh 8d] (two pair, Kings and Jacks)
bazil139 collected $3.06 from pot
*** SUMMARY ***
Total pot $3.20 | Rake $0.14 
Board [7h Jh Kd Js 9c]
Seat 1: FreshStyIe folded before Flop (didn't bet)
Seat 2: lastfox folded before Flop (didn't bet)
Seat 3: vicman121 folded before Flop (didn't bet)
Seat 4: TGVon (button) folded before Flop (didn't bet)
Seat 5: vasilisvel43 (small blind) showed [Ts Ac] and lost with a pair of Jacks
Seat 6: bazil139 (big blind) showed [Kh 8d] and won ($3.06) with two pair, Kings and Jacks



PokerStars Hand #222964325893:  Hold'em No Limit ($0.05/$0.10 USD) - 2021/01/23 13:41:49 ET
Table 'Transvaalia' 6-max Seat #5 is the button
Seat 1: FreshStyIe ($10 in chips) 
Seat 2: lastfox ($12.75 in chips) 
Seat 3: vicman121 ($11.65 in chips) 
Seat 4: TGVon ($12.60 in chips) 
Seat 5: vasilisvel43 ($11 in chips) 
Seat 6: bazil139 ($11.46 in chips) 
bazil139: posts small blind $0.05
FreshStyIe: posts big blind $0.10
*** HOLE CARDS ***
lastfox: folds 
vicman121: folds 
TGVon: folds 
vasilisvel43: calls $0.10
bazil139: folds 
FreshStyIe: checks 
*** FLOP *** [9d 6h Kh]
FreshStyIe: checks 
vasilisvel43: checks 
*** TURN *** [9d 6h Kh] [Th]
FreshStyIe: checks 
vasilisvel43: checks 
*** RIVER *** [9d 6h Kh Th] [8d]
FreshStyIe: checks 
vasilisvel43: bets $0.40
FreshStyIe: folds 
Uncalled bet ($0.40) returned to vasilisvel43
vasilisvel43 collected $0.24 from pot
vasilisvel43: doesn't show hand 
*** SUMMARY ***
Total pot $0.25 | Rake $0.01 
Board [9d 6h Kh Th 8d]
Seat 1: FreshStyIe (big blind) folded on the River
Seat 2: lastfox folded before Flop (didn't bet)
Seat 3: vicman121 folded before Flop (didn't bet)
Seat 4: TGVon folded before Flop (didn't bet)
Seat 5: vasilisvel43 (button) collected ($0.24)
Seat 6: bazil139 (small blind) folded before Flop



PokerStars Hand #222964960118:  Hold'em No Limit ($0.05/$0.10 USD) - 2021/01/23 13:55:44 ET
Table 'Transvaalia' 6-max Seat #1 is the button
Seat 1: FreshStyIe ($10 in chips) 
Seat 2: lastfox ($21.19 in chips) 
Seat 3: vicman121 ($11.66 in chips) 
Seat 4: EFBrasi ($6.71 in chips) 
Seat 5: vasilisvel43 ($15.78 in chips) 
Seat 6: bazil139 ($9.99 in chips) 
lastfox: posts small blind $0.05
vicman121: posts big blind $0.10
*** HOLE CARDS ***
EFBrasi: raises $0.10 to $0.20
vasilisvel43: calls $0.20
bazil139: folds 
FreshStyIe: raises $1.10 to $1.30
lastfox: folds 
vicman121: folds 
EFBrasi: calls $1.10
vasilisvel43: calls $1.10
*** FLOP *** [8d Ts 5h]
EFBrasi: checks 
vasilisvel43: checks 
FreshStyIe: bets $2.10
EFBrasi: folds 
vasilisvel43: calls $2.10
*** TURN *** [8d Ts 5h] [4s]
vasilisvel43: bets $1.30
FreshStyIe: raises $5.30 to $6.60 and is all-in
vasilisvel43: calls $5.30
*** RIVER *** [8d Ts 5h 4s] [Ad]
*** SHOW DOWN ***
vasilisvel43: shows [9s 8s] (a pair of Eights)
FreshStyIe: shows [Qd Qc] (a pair of Queens)
FreshStyIe collected $20.48 from pot
*** SUMMARY ***
Total pot $21.45 | Rake $0.97 
Board [8d Ts 5h 4s Ad]
Seat 1: FreshStyIe (button) showed [Qd Qc] and won ($20.48) with a pair of Queens
Seat 2: lastfox (small blind) folded before Flop
Seat 3: vicman121 (big blind) folded before Flop
Seat 4: EFBrasi folded on the Flop
Seat 5: vasilisvel43 showed [9s 8s] and lost with a pair of Eights
Seat 6: bazil139 folded before Flop (didn't bet)



PokerStars Hand #222964993862:  Hold'em No Limit ($0.05/$0.10 USD) - 2021/01/23 13:56:54 ET
Table 'Transvaalia' 6-max Seat #2 is the button
Seat 1: FreshStyIe ($20.48 in chips) 
Seat 2: lastfox ($21.14 in chips) 
Seat 3: vicman121 ($11.56 in chips) 
Seat 4: EFBrasi ($5.41 in chips) 
Seat 5: vasilisvel43 ($5.78 in chips) 
Seat 6: bazil139 ($9.99 in chips) 
vicman121: posts small blind $0.05
EFBrasi: posts big blind $0.10
*** HOLE CARDS ***
vasilisvel43: calls $0.10
bazil139: folds 
FreshStyIe: folds 
lastfox: folds 
vicman121: folds 
EFBrasi: checks 
*** FLOP *** [9s Td 2s]
EFBrasi: checks 
vasilisvel43: checks 
*** TURN *** [9s Td 2s] [3c]
EFBrasi: bets $0.10
vasilisvel43: raises $0.10 to $0.20
EFBrasi: raises $0.32 to $0.52
vasilisvel43: raises $0.32 to $0.84
EFBrasi: calls $0.32
*** RIVER *** [9s Td 2s 3c] [7c]
EFBrasi: checks 
vasilisvel43: bets $4.84 and is all-in
EFBrasi: folds 
Uncalled bet ($4.84) returned to vasilisvel43
vasilisvel43 collected $1.84 from pot
*** SUMMARY ***
Total pot $1.93 | Rake $0.09 
Board [9s Td 2s 3c 7c]
Seat 1: FreshStyIe folded before Flop (didn't bet)
Seat 2: lastfox (button) folded before Flop (didn't bet)
Seat 3: vicman121 (small blind) folded before Flop
Seat 4: EFBrasi (big blind) folded on the River
Seat 5: vasilisvel43 collected ($1.84)
Seat 6: bazil139 folded before Flop (didn't bet)



PokerStars Hand #222965025151:  Hold'em No Limit ($0.05/$0.10 USD) - 2021/01/23 13:57:58 ET
Table 'Transvaalia' 6-max Seat #3 is the button
Seat 1: FreshStyIe ($20.48 in chips) 
Seat 2: lastfox ($21.14 in chips) 
Seat 3: vicman121 ($11.51 in chips) 
Seat 4: EFBrasi ($4.47 in chips) 
Seat 5: vasilisvel43 ($6.68 in chips) 
Seat 6: bazil139 ($9.99 in chips) 
EFBrasi: posts small blind $0.05
vasilisvel43: posts big blind $0.10
*** HOLE CARDS ***
bazil139: folds 
FreshStyIe: raises $0.15 to $0.25
lastfox: folds 
vicman121: calls $0.25
EFBrasi: folds 
vasilisvel43: calls $0.15
*** FLOP *** [Kd Kh 9d]
vasilisvel43: checks 
FreshStyIe: checks 
vicman121: checks 
*** TURN *** [Kd Kh 9d] [3h]
vasilisvel43: checks 
FreshStyIe: bets $0.45
vicman121: folds 
vasilisvel43: calls $0.45
*** RIVER *** [Kd Kh 9d 3h] [6s]
vasilisvel43: bets $0.70
FreshStyIe: calls $0.70
*** SHOW DOWN ***
vasilisvel43: shows [Tc Jd] (a pair of Kings)
FreshStyIe: shows [6d 5d] (two pair, Kings and Sixes)
FreshStyIe collected $2.96 from pot
*** SUMMARY ***
Total pot $3.10 | Rake $0.14 
Board [Kd Kh 9d 3h 6s]
Seat 1: FreshStyIe showed [6d 5d] and won ($2.96) with two pair, Kings and Sixes
Seat 2: lastfox folded before Flop (didn't bet)
Seat 3: vicman121 (button) folded on the Turn
Seat 4: EFBrasi (small blind) folded before Flop
Seat 5: vasilisvel43 (big blind) showed [Tc Jd] and lost with a pair of Kings
Seat 6: bazil139 folded before Flop (didn't bet)



PokerStars Hand #222965066153:  Hold'em No Limit ($0.05/$0.10 USD) - 2021/01/23 13:59:22 ET
Table 'Transvaalia' 6-max Seat #4 is the button
Seat 1: FreshStyIe ($22.04 in chips) 
Seat 2: lastfox ($21.14 in chips) 
Seat 3: vicman121 ($11.26 in chips) 
Seat 4: EFBrasi ($4.42 in chips) 
Seat 5: vasilisvel43 ($5.28 in chips) 
Seat 6: bazil139 ($9.99 in chips) 
vasilisvel43: posts small blind $0.05
bazil139: posts big blind $0.10
*** HOLE CARDS ***
EFBrasi is disconnected 
FreshStyIe: folds 
lastfox: folds 
vicman121: raises $0.15 to $0.25
EFBrasi has timed out while disconnected
EFBrasi: folds 
vasilisvel43: calls $0.20
bazil139: folds 
*** FLOP *** [4c Qc 9h]
vasilisvel43: checks 
vicman121: bets $0.38
vasilisvel43: calls $0.38
*** TURN *** [4c Qc 9h] [Th]
vasilisvel43: checks 
vicman121: bets $0.86
vasilisvel43: calls $0.86
*** RIVER *** [4c Qc 9h Th] [3h]
vasilisvel43: checks 
vicman121: bets $0.88
vasilisvel43: raises $2.91 to $3.79 and is all-in
vicman121: calls $2.91
*** SHOW DOWN ***
vasilisvel43: shows [5s 9s] (a pair of Nines)
vicman121: shows [Kd Qh] (a pair of Queens)
vicman121 collected $10.18 from pot
*** SUMMARY ***
Total pot $10.66 | Rake $0.48 
Board [4c Qc 9h Th 3h]
Seat 1: FreshStyIe folded before Flop (didn't bet)
Seat 2: lastfox folded before Flop (didn't bet)
Seat 3: vicman121 showed [Kd Qh] and won ($10.18) with a pair of Queens
Seat 4: EFBrasi (button) folded before Flop (didn't bet)
Seat 5: vasilisvel43 (small blind) showed [5s 9s] and lost with a pair of Nines
Seat 6: bazil139 (big blind) folded before Flop



PokerStars Hand #222965130674:  Hold'em No Limit ($0.05/$0.10 USD) - 2021/01/23 14:01:19 ET
Table 'Transvaalia' 6-max Seat #6 is the button
Seat 1: FreshStyIe ($22.04 in chips) 
Seat 2: lastfox ($21.14 in chips) 
Seat 3: vicman121 ($16.16 in chips) 
Seat 4: EFBrasi ($4.42 in chips) 
Seat 6: bazil139 ($9.89 in chips) 
FreshStyIe: posts small blind $0.05
lastfox: posts big blind $0.10
*** HOLE CARDS ***
vicman121: folds 
EFBrasi: calls $0.10
vasilisvel43 leaves the table
bazil139: folds 
FreshStyIe: folds 
lastfox: checks 
*** FLOP *** [As 7s 4h]
lastfox: checks 
EFBrasi: checks 
*** TURN *** [As 7s 4h] [9d]
KiraLasVegas joins the table at seat #5 
lastfox: checks 
EFBrasi: bets $0.10
lastfox: calls $0.10
*** RIVER *** [As 7s 4h 9d] [Jh]
lastfox: checks 
EFBrasi: bets $0.43
lastfox: folds 
Uncalled bet ($0.43) returned to EFBrasi
EFBrasi collected $0.43 from pot
EFBrasi: doesn't show hand 
*** SUMMARY ***
Total pot $0.45 | Rake $0.02 
Board [As 7s 4h 9d Jh]
Seat 1: FreshStyIe (small blind) folded before Flop
Seat 2: lastfox (big blind) folded on the River
Seat 3: vicman121 folded before Flop (didn't bet)
Seat 4: EFBrasi collected ($0.43)
Seat 6: bazil139 (button) folded before Flop (didn't bet)



PokerStars Hand #222965155824:  Hold'em No Limit ($0.05/$0.10 USD) - 2021/01/23 14:01:54 ET
Table 'Transvaalia' 6-max Seat #1 is the button
Seat 1: FreshStyIe ($21.99 in chips) 
Seat 2: lastfox ($20.94 in chips) 
Seat 3: vicman121 ($16.16 in chips) 
Seat 4: EFBrasi ($4.65 in chips) 
Seat 6: bazil139 ($9.89 in chips) 
lastfox: posts small blind $0.05
vicman121: posts big blind $0.10
KiraLasVegas: sits out 
*** HOLE CARDS ***
EFBrasi: raises $0.10 to $0.20
bazil139: folds 
FreshStyIe: folds 
lastfox: folds 
vicman121: folds 
Uncalled bet ($0.10) returned to EFBrasi
EFBrasi collected $0.25 from pot
EFBrasi: doesn't show hand 
*** SUMMARY ***
Total pot $0.25 | Rake $0 
Seat 1: FreshStyIe (button) folded before Flop (didn't bet)
Seat 2: lastfox (small blind) folded before Flop
Seat 3: vicman121 (big blind) folded before Flop
Seat 4: EFBrasi collected ($0.25)
Seat 6: bazil139 folded before Flop (didn't bet)



PokerStars Hand #222965173220:  Hold'em No Limit ($0.05/$0.10 USD) - 2021/01/23 14:02:18 ET
Table 'Transvaalia' 6-max Seat #2 is the button
Seat 1: FreshStyIe ($21.99 in chips) 
Seat 2: lastfox ($20.89 in chips) 
Seat 3: vicman121 ($16.06 in chips) 
Seat 4: EFBrasi ($4.80 in chips) 
Seat 6: bazil139 ($9.89 in chips) 
vicman121: posts small blind $0.05
EFBrasi: posts big blind $0.10
KiraLasVegas: sits out 
*** HOLE CARDS ***
bazil139: raises $0.11 to $0.21
FreshStyIe: folds 
lastfox: calls $0.21
vicman121: folds 
EFBrasi: calls $0.11
*** FLOP *** [5s 6s 8h]
EFBrasi: checks 
bazil139: checks 
lastfox: bets $0.49
EFBrasi: folds 
bazil139: folds 
Uncalled bet ($0.49) returned to lastfox
lastfox collected $0.65 from pot
lastfox: doesn't show hand 
*** SUMMARY ***
Total pot $0.68 | Rake $0.03 
Board [5s 6s 8h]
Seat 1: FreshStyIe folded before Flop (didn't bet)
Seat 2: lastfox (button) collected ($0.65)
Seat 3: vicman121 (small blind) folded before Flop
Seat 4: EFBrasi (big blind) folded on the Flop
Seat 6: bazil139 folded on the Flop



PokerStars Hand #222965213465:  Hold'em No Limit ($0.05/$0.10 USD) - 2021/01/23 14:03:02 ET
Table 'Transvaalia' 6-max Seat #3 is the button
Seat 1: FreshStyIe ($21.99 in chips) 
Seat 2: lastfox ($21.33 in chips) 
Seat 3: vicman121 ($16.01 in chips) 
Seat 4: EFBrasi ($4.59 in chips) 
Seat 5: KiraLasVegas ($10 in chips) 
Seat 6: bazil139 ($9.68 in chips) 
EFBrasi: posts small blind $0.05
KiraLasVegas: posts big blind $0.10
*** HOLE CARDS ***
bazil139: folds 
FreshStyIe: folds 
lastfox: folds 
vicman121: raises $0.15 to $0.25
EFBrasi: calls $0.20
KiraLasVegas: folds 
*** FLOP *** [2h As 7h]
EFBrasi: checks 
vicman121: bets $0.17
EFBrasi: calls $0.17
*** TURN *** [2h As 7h] [9d]
EFBrasi: checks 
vicman121: checks 
*** RIVER *** [2h As 7h 9d] [Kc]
EFBrasi: bets $0.40
vicman121: calls $0.40
*** SHOW DOWN ***
EFBrasi: shows [6s 8s] (high card Ace)
vicman121: shows [Kh Qs] (a pair of Kings)
vicman121 collected $1.66 from pot
*** SUMMARY ***
Total pot $1.74 | Rake $0.08 
Board [2h As 7h 9d Kc]
Seat 1: FreshStyIe folded before Flop (didn't bet)
Seat 2: lastfox folded before Flop (didn't bet)
Seat 3: vicman121 (button) showed [Kh Qs] and won ($1.66) with a pair of Kings
Seat 4: EFBrasi (small blind) showed [6s 8s] and lost with high card Ace
Seat 5: KiraLasVegas (big blind) folded before Flop
Seat 6: bazil139 folded before Flop (didn't bet)



PokerStars Hand #222965259020:  Hold'em No Limit ($0.05/$0.10 USD) - 2021/01/23 14:04:00 ET
Table 'Transvaalia' 6-max Seat #4 is the button
Seat 1: FreshStyIe ($21.99 in chips) 
Seat 2: lastfox ($21.33 in chips) 
Seat 3: vicman121 ($16.85 in chips) 
Seat 4: EFBrasi ($3.77 in chips) 
Seat 5: KiraLasVegas ($10 in chips) 
Seat 6: bazil139 ($9.68 in chips) 
KiraLasVegas: posts small blind $0.05
bazil139: posts big blind $0.10
*** HOLE CARDS ***
FreshStyIe: folds 
lastfox: folds 
vicman121: folds 
EFBrasi: folds 
KiraLasVegas: raises $0.15 to $0.25
bazil139: raises $0.55 to $0.80
KiraLasVegas: folds 
Uncalled bet ($0.55) returned to bazil139
bazil139 collected $0.50 from pot
bazil139: doesn't show hand 
*** SUMMARY ***
Total pot $0.50 | Rake $0 
Seat 1: FreshStyIe folded before Flop (didn't bet)
Seat 2: lastfox folded before Flop (didn't bet)
Seat 3: vicman121 folded before Flop (didn't bet)
Seat 4: EFBrasi (button) folded before Flop (didn't bet)
Seat 5: KiraLasVegas (small blind) folded before Flop
Seat 6: bazil139 (big blind) collected ($0.50)



PokerStars Hand #222965274386:  Hold'em No Limit ($0.05/$0.10 USD) - 2021/01/23 14:04:20 ET
Table 'Transvaalia' 6-max Seat #5 is the button
Seat 1: FreshStyIe ($21.99 in chips) 
Seat 2: lastfox ($21.33 in chips) 
Seat 3: vicman121 ($16.85 in chips) 
Seat 4: EFBrasi ($3.77 in chips) 
Seat 5: KiraLasVegas ($10 in chips) 
Seat 6: bazil139 ($9.93 in chips) 
bazil139: posts small blind $0.05
FreshStyIe: posts big blind $0.10
*** HOLE CARDS ***
lastfox: folds 
vicman121: folds 
EFBrasi: folds 
KiraLasVegas: raises $0.15 to $0.25
bazil139: raises $0.55 to $0.80
FreshStyIe: folds 
KiraLasVegas: folds 
Uncalled bet ($0.55) returned to bazil139
bazil139 collected $0.60 from pot
bazil139: doesn't show hand 
*** SUMMARY ***
Total pot $0.60 | Rake $0 
Seat 1: FreshStyIe (big blind) folded before Flop
Seat 2: lastfox folded before Flop (didn't bet)
Seat 3: vicman121 folded before Flop (didn't bet)
Seat 4: EFBrasi folded before Flop (didn't bet)
Seat 5: KiraLasVegas (button) folded before Flop
Seat 6: bazil139 (small blind) collected ($0.60)



PokerStars Hand #222965295145:  Hold'em No Limit ($0.05/$0.10 USD) - 2021/01/23 14:04:46 ET
Table 'Transvaalia' 6-max Seat #6 is the button
Seat 1: FreshStyIe ($21.89 in chips) 
Seat 2: lastfox ($21.33 in chips) 
Seat 3: vicman121 ($16.85 in chips) 
Seat 4: EFBrasi ($3.77 in chips) 
Seat 5: KiraLasVegas ($10 in chips) 
Seat 6: bazil139 ($10.28 in chips) 
FreshStyIe: posts small blind $0.05
lastfox: posts big blind $0.10
*** HOLE CARDS ***
vicman121: folds 
EFBrasi: folds 
KiraLasVegas: folds 
bazil139: raises $0.15 to $0.25
FreshStyIe: folds 
lastfox: folds 
Uncalled bet ($0.15) returned to bazil139
bazil139 collected $0.25 from pot
bazil139: doesn't show hand 
*** SUMMARY ***
Total pot $0.25 | Rake $0 
Seat 1: FreshStyIe (small blind) folded before Flop
Seat 2: lastfox (big blind) folded before Flop
Seat 3: vicman121 folded before Flop (didn't bet)
Seat 4: EFBrasi folded before Flop (didn't bet)
Seat 5: KiraLasVegas folded before Flop (didn't bet)
Seat 6: bazil139 (button) collected ($0.25)



PokerStars Hand #222965309605:  Hold'em No Limit ($0.05/$0.10 USD) - 2021/01/23 14:05:04 ET
Table 'Transvaalia' 6-max Seat #1 is the button
Seat 1: FreshStyIe ($21.84 in chips) 
Seat 2: lastfox ($21.23 in chips) 
Seat 3: vicman121 ($16.85 in chips) 
Seat 4: EFBrasi ($3.77 in chips) 
Seat 5: KiraLasVegas ($10 in chips) 
Seat 6: bazil139 ($10.43 in chips) 
lastfox: posts small blind $0.05
vicman121: posts big blind $0.10
*** HOLE CARDS ***
EFBrasi: folds 
KiraLasVegas: folds 
bazil139: folds 
FreshStyIe: raises $0.15 to $0.25
lastfox: folds 
vicman121: folds 
Uncalled bet ($0.15) returned to FreshStyIe
FreshStyIe collected $0.25 from pot
FreshStyIe: doesn't show hand 
*** SUMMARY ***
Total pot $0.25 | Rake $0 
Seat 1: FreshStyIe (button) collected ($0.25)
Seat 2: lastfox (small blind) folded before Flop
Seat 3: vicman121 (big blind) folded before Flop
Seat 4: EFBrasi folded before Flop (didn't bet)
Seat 5: KiraLasVegas folded before Flop (didn't bet)
Seat 6: bazil139 folded before Flop (didn't bet)



PokerStars Hand #222965319356:  Hold'em No Limit ($0.05/$0.10 USD) - 2021/01/23 14:05:16 ET
Table 'Transvaalia' 6-max Seat #2 is the button
Seat 1: FreshStyIe ($21.99 in chips) 
Seat 2: lastfox ($21.18 in chips) 
Seat 3: vicman121 ($16.75 in chips) 
Seat 4: EFBrasi ($3.77 in chips) 
Seat 5: KiraLasVegas ($10 in chips) 
Seat 6: bazil139 ($10.43 in chips) 
vicman121: posts small blind $0.05
EFBrasi: posts big blind $0.10
*** HOLE CARDS ***
KiraLasVegas: folds 
bazil139: raises $0.11 to $0.21
FreshStyIe: folds 
KiraLasVegas leaves the table
lastfox: folds 
vicman121: folds 
EFBrasi: calls $0.11
*** FLOP *** [Tc 2h 7s]
EFBrasi: checks 
bazil139: checks 
*** TURN *** [Tc 2h 7s] [As]
EFBrasi: checks 
bazil139: bets $0.20
EFBrasi: calls $0.20
*** RIVER *** [Tc 2h 7s As] [Qc]
enitram45 joins the table at seat #5 
EFBrasi: checks 
bazil139: bets $0.50
EFBrasi: calls $0.50
*** SHOW DOWN ***
bazil139: shows [Ac Qh] (two pair, Aces and Queens)
EFBrasi: mucks hand 
bazil139 collected $1.79 from pot
*** SUMMARY ***
Total pot $1.87 | Rake $0.08 
Board [Tc 2h 7s As Qc]
Seat 1: FreshStyIe folded before Flop (didn't bet)
Seat 2: lastfox (button) folded before Flop (didn't bet)
Seat 3: vicman121 (small blind) folded before Flop
Seat 4: EFBrasi (big blind) mucked
Seat 5: KiraLasVegas folded before Flop (didn't bet)
Seat 6: bazil139 showed [Ac Qh] and won ($1.79) with two pair, Aces and Queens



PokerStars Hand #222965341890:  Hold'em No Limit ($0.05/$0.10 USD) - 2021/01/23 14:05:45 ET
Table 'Transvaalia' 6-max Seat #3 is the button
Seat 1: FreshStyIe ($21.99 in chips) 
Seat 2: lastfox ($21.18 in chips) 
Seat 3: vicman121 ($16.70 in chips) 
Seat 4: EFBrasi ($2.86 in chips) 
Seat 5: enitram45 ($10 in chips) 
Seat 6: bazil139 ($11.31 in chips) 
EFBrasi: posts small blind $0.05
enitram45: posts big blind $0.10
*** HOLE CARDS ***
bazil139: folds 
FreshStyIe: raises $0.15 to $0.25
lastfox: folds 
vicman121: calls $0.25
EFBrasi: folds 
enitram45: folds 
*** FLOP *** [3s Ad 7c]
FreshStyIe: checks 
vicman121: bets $0.25
FreshStyIe: calls $0.25
*** TURN *** [3s Ad 7c] [Ac]
FreshStyIe: checks 
vicman121: bets $0.83
FreshStyIe: calls $0.83
*** RIVER *** [3s Ad 7c Ac] [2c]
FreshStyIe: checks 
vicman121: bets $2.01
FreshStyIe: calls $2.01
*** SHOW DOWN ***
vicman121: shows [4s 5s] (a straight, Ace to Five)
FreshStyIe: mucks hand 
vicman121 collected $6.52 from pot
*** SUMMARY ***
Total pot $6.83 | Rake $0.31 
Board [3s Ad 7c Ac 2c]
Seat 1: FreshStyIe mucked
Seat 2: lastfox folded before Flop (didn't bet)
Seat 3: vicman121 (button) showed [4s 5s] and won ($6.52) with a straight, Ace to Five
Seat 4: EFBrasi (small blind) folded before Flop
Seat 5: enitram45 (big blind) folded before Flop
Seat 6: bazil139 folded before Flop (didn't bet)



PokerStars Hand #222965441447:  Hold'em No Limit ($0.05/$0.10 USD) - 2021/01/23 14:07:50 ET
Table 'Transvaalia' 6-max Seat #4 is the button
Seat 1: FreshStyIe ($18.65 in chips) 
Seat 2: lastfox ($21.18 in chips) 
Seat 3: vicman121 ($19.88 in chips) 
Seat 4: EFBrasi ($2.81 in chips) 
Seat 5: enitram45 ($9.90 in chips) 
Seat 6: bazil139 ($11.31 in chips) 
enitram45: posts small blind $0.05
bazil139: posts big blind $0.10
*** HOLE CARDS ***
FreshStyIe: folds 
lastfox: folds 
vicman121: folds 
EFBrasi: raises $0.10 to $0.20
enitram45: folds 
bazil139: folds 
Uncalled bet ($0.10) returned to EFBrasi
EFBrasi collected $0.25 from pot
EFBrasi: doesn't show hand 
*** SUMMARY ***
Total pot $0.25 | Rake $0 
Seat 1: FreshStyIe folded before Flop (didn't bet)
Seat 2: lastfox folded before Flop (didn't bet)
Seat 3: vicman121 folded before Flop (didn't bet)
Seat 4: EFBrasi (button) collected ($0.25)
Seat 5: enitram45 (small blind) folded before Flop
Seat 6: bazil139 (big blind) folded before Flop



PokerStars Hand #222965455465:  Hold'em No Limit ($0.05/$0.10 USD) - 2021/01/23 14:08:08 ET
Table 'Transvaalia' 6-max Seat #5 is the button
Seat 2: lastfox ($21.18 in chips) 
Seat 3: vicman121 ($19.88 in chips) 
Seat 4: EFBrasi ($2.96 in chips) 
Seat 5: enitram45 ($9.85 in chips) 
Seat 6: bazil139 ($11.21 in chips) 
bazil139: posts small blind $0.05
FreshStyIe: is sitting out 
lastfox: posts big blind $0.10
*** HOLE CARDS ***
FreshStyIe leaves the table
vicman121 has timed out
vicman121: folds 
EFBrasi: raises $0.10 to $0.20
enitram45: folds 
bazil139: folds 
lastfox: folds 
Uncalled bet ($0.10) returned to EFBrasi
EFBrasi collected $0.25 from pot
EFBrasi: doesn't show hand 
Gissbon joins the table at seat #1 
*** SUMMARY ***
Total pot $0.25 | Rake $0 
Seat 2: lastfox (big blind) folded before Flop
Seat 3: vicman121 folded before Flop (didn't bet)
Seat 4: EFBrasi collected ($0.25)
Seat 5: enitram45 (button) folded before Flop (didn't bet)
Seat 6: bazil139 (small blind) folded before Flop



PokerStars Hand #222965473898:  Hold'em No Limit ($0.05/$0.10 USD) - 2021/01/23 14:08:31 ET
Table 'Transvaalia' 6-max Seat #6 is the button
Seat 2: lastfox ($21.08 in chips) 
Seat 3: vicman121 ($19.88 in chips) 
Seat 4: EFBrasi ($3.11 in chips) 
Seat 5: enitram45 ($9.85 in chips) 
Seat 6: bazil139 ($11.16 in chips) 
lastfox: posts small blind $0.05
vicman121: posts big blind $0.10
*** HOLE CARDS ***
EFBrasi: calls $0.10
enitram45: raises $0.10 to $0.20
bazil139: folds 
lastfox: folds 
vicman121: calls $0.10
EFBrasi: calls $0.10
*** FLOP *** [Qh 2s 9c]
vicman121: checks 
EFBrasi: checks 
enitram45: bets $0.30
vicman121: calls $0.30
EFBrasi: folds 
*** TURN *** [Qh 2s 9c] [Jc]
Gissbon leaves the table
vicman121: checks 
enitram45: checks 
*** RIVER *** [Qh 2s 9c Jc] [Ah]
rogdor30 joins the table at seat #1 
vicman121: checks 
enitram45: checks 
*** SHOW DOWN ***
vicman121: shows [2h 2c] (three of a kind, Deuces)
enitram45: mucks hand 
vicman121 collected $1.19 from pot
*** SUMMARY ***
Total pot $1.25 | Rake $0.06 
Board [Qh 2s 9c Jc Ah]
Seat 2: lastfox (small blind) folded before Flop
Seat 3: vicman121 (big blind) showed [2h 2c] and won ($1.19) with three of a kind, Deuces
Seat 4: EFBrasi folded on the Flop
Seat 5: enitram45 mucked
Seat 6: bazil139 (button) folded before Flop (didn't bet)



PokerStars Hand #222965509722:  Hold'em No Limit ($0.05/$0.10 USD) - 2021/01/23 14:09:16 ET
Table 'Transvaalia' 6-max Seat #2 is the button
Seat 2: lastfox ($21.03 in chips) 
Seat 3: vicman121 ($20.57 in chips) 
Seat 4: EFBrasi ($2.91 in chips) 
Seat 5: enitram45 ($9.35 in chips) 
Seat 6: bazil139 ($11.16 in chips) 
vicman121: posts small blind $0.05
EFBrasi: posts big blind $0.10
rogdor30: sits out 
*** HOLE CARDS ***
enitram45: folds 
bazil139: folds 
lastfox: raises $0.13 to $0.23
vicman121: folds 
EFBrasi: raises $0.13 to $0.36
lastfox: calls $0.13
*** FLOP *** [7h 3c 9d]
EFBrasi: bets $0.74
lastfox: raises $1.67 to $2.41
EFBrasi: raises $0.14 to $2.55 and is all-in
lastfox: calls $0.14
*** TURN *** [7h 3c 9d] [8s]
*** RIVER *** [7h 3c 9d 8s] [Qd]
*** SHOW DOWN ***
EFBrasi: shows [9h Qh] (two pair, Queens and Nines)
lastfox: shows [5h 6c] (a straight, Five to Nine)
lastfox collected $5.61 from pot
*** SUMMARY ***
Total pot $5.87 | Rake $0.26 
Board [7h 3c 9d 8s Qd]
Seat 2: lastfox (button) showed [5h 6c] and won ($5.61) with a straight, Five to Nine
Seat 3: vicman121 (small blind) folded before Flop
Seat 4: EFBrasi (big blind) showed [9h Qh] and lost with two pair, Queens and Nines
Seat 5: enitram45 folded before Flop (didn't bet)
Seat 6: bazil139 folded before Flop (didn't bet)



PokerStars Hand #222965546842:  Hold'em No Limit ($0.05/$0.10 USD) - 2021/01/23 14:10:03 ET
Table 'Transvaalia' 6-max Seat #3 is the button
Seat 2: lastfox ($23.73 in chips) 
Seat 3: vicman121 ($20.52 in chips) 
Seat 5: enitram45 ($9.35 in chips) 
Seat 6: bazil139 ($11.16 in chips) 
enitram45: posts small blind $0.05
bazil139: posts big blind $0.10
rogdor30: sits out 
*** HOLE CARDS ***
lastfox: folds 
EFBrasi leaves the table
vicman121: folds 
enitram45: folds 
Uncalled bet ($0.05) returned to bazil139
bazil139 collected $0.10 from pot
bazil139: doesn't show hand 
*** SUMMARY ***
Total pot $0.10 | Rake $0 
Seat 2: lastfox folded before Flop (didn't bet)
Seat 3: vicman121 (button) folded before Flop (didn't bet)
Seat 5: enitram45 (small blind) folded before Flop
Seat 6: bazil139 (big blind) collected ($0.10)



PokerStars Hand #222965559127:  Hold'em No Limit ($0.05/$0.10 USD) - 2021/01/23 14:10:19 ET
Table 'Transvaalia' 6-max Seat #5 is the button
Seat 1: rogdor30 ($10 in chips) 
Seat 2: lastfox ($23.73 in chips) 
Seat 3: vicman121 ($20.52 in chips) 
Seat 5: enitram45 ($9.30 in chips) 
Seat 6: bazil139 ($11.21 in chips) 
bazil139: posts small blind $0.05
rogdor30: posts big blind $0.10
*** HOLE CARDS ***
lastfox: folds 
vicman121: folds 
enitram45: folds 
bazil139: folds 
Uncalled bet ($0.05) returned to rogdor30
rogdor30 collected $0.10 from pot
rogdor30: doesn't show hand 
Kobert72 joins the table at seat #4 
*** SUMMARY ***
Total pot $0.10 | Rake $0 
Seat 1: rogdor30 (big blind) collected ($0.10)
Seat 2: lastfox folded before Flop (didn't bet)
Seat 3: vicman121 folded before Flop (didn't bet)
Seat 5: enitram45 (button) folded before Flop (didn't bet)
Seat 6: bazil139 (small blind) folded before Flop



PokerStars Hand #222965564004:  Hold'em No Limit ($0.05/$0.10 USD) - 2021/01/23 14:10:25 ET
Table 'Transvaalia' 6-max Seat #6 is the button
Seat 1: rogdor30 ($10.05 in chips) 
Seat 2: lastfox ($23.73 in chips) 
Seat 3: vicman121 ($20.52 in chips) 
Seat 5: enitram45 ($9.30 in chips) 
Seat 6: bazil139 ($11.16 in chips) 
rogdor30: posts small blind $0.05
lastfox: posts big blind $0.10
Kobert72: sits out 
*** HOLE CARDS ***
vicman121: folds 
enitram45: folds 
bazil139: folds 
rogdor30: folds 
Uncalled bet ($0.05) returned to lastfox
lastfox collected $0.10 from pot
lastfox: doesn't show hand 
*** SUMMARY ***
Total pot $0.10 | Rake $0 
Seat 1: rogdor30 (small blind) folded before Flop
Seat 2: lastfox (big blind) collected ($0.10)
Seat 3: vicman121 folded before Flop (didn't bet)
Seat 5: enitram45 folded before Flop (didn't bet)
Seat 6: bazil139 (button) folded before Flop (didn't bet)



PokerStars Hand #222965572767:  Hold'em No Limit ($0.05/$0.10 USD) - 2021/01/23 14:10:36 ET
Table 'Transvaalia' 6-max Seat #1 is the button
Seat 1: rogdor30 ($10 in chips) 
Seat 2: lastfox ($23.78 in chips) 
Seat 3: vicman121 ($20.52 in chips) 
Seat 5: enitram45 ($9.30 in chips) 
Seat 6: bazil139 ($11.16 in chips) 
lastfox: posts small blind $0.05
vicman121: posts big blind $0.10
Kobert72: sits out 
*** HOLE CARDS ***
enitram45: folds 
bazil139: folds 
rogdor30: folds 
lastfox: folds 
Uncalled bet ($0.05) returned to vicman121
vicman121 collected $0.10 from pot
vicman121: doesn't show hand 
*** SUMMARY ***
Total pot $0.10 | Rake $0 
Seat 1: rogdor30 (button) folded before Flop (didn't bet)
Seat 2: lastfox (small blind) folded before Flop
Seat 3: vicman121 (big blind) collected ($0.10)
Seat 5: enitram45 folded before Flop (didn't bet)
Seat 6: bazil139 folded before Flop (didn't bet)



PokerStars Hand #222965579493:  Hold'em No Limit ($0.05/$0.10 USD) - 2021/01/23 14:10:45 ET
Table 'Transvaalia' 6-max Seat #2 is the button
Seat 1: rogdor30 ($10 in chips) 
Seat 2: lastfox ($23.73 in chips) 
Seat 3: vicman121 ($20.57 in chips) 
Seat 4: Kobert72 ($10 in chips) 
Seat 5: enitram45 ($9.30 in chips) 
Seat 6: bazil139 ($11.16 in chips) 
vicman121: posts small blind $0.05
Kobert72: posts big blind $0.10
*** HOLE CARDS ***
enitram45: folds 
bazil139: folds 
rogdor30: folds 
lastfox: folds 
vicman121: folds 
Uncalled bet ($0.05) returned to Kobert72
Kobert72 collected $0.10 from pot
Kobert72: doesn't show hand 
*** SUMMARY ***
Total pot $0.10 | Rake $0 
Seat 1: rogdor30 folded before Flop (didn't bet)
Seat 2: lastfox (button) folded before Flop (didn't bet)
Seat 3: vicman121 (small blind) folded before Flop
Seat 4: Kobert72 (big blind) collected ($0.10)
Seat 5: enitram45 folded before Flop (didn't bet)
Seat 6: bazil139 folded before Flop (didn't bet)



PokerStars Hand #222965597482:  Hold'em No Limit ($0.05/$0.10 USD) - 2021/01/23 14:11:08 ET
Table 'Transvaalia' 6-max Seat #3 is the button
Seat 1: rogdor30 ($10 in chips) 
Seat 2: lastfox ($23.73 in chips) 
Seat 3: vicman121 ($20.52 in chips) 
Seat 4: Kobert72 ($10.05 in chips) 
Seat 5: enitram45 ($9.30 in chips) 
Seat 6: bazil139 ($11.16 in chips) 
Kobert72: posts small blind $0.05
enitram45: posts big blind $0.10
*** HOLE CARDS ***
bazil139: folds 
rogdor30: folds 
lastfox: folds 
vicman121: folds 
Kobert72: folds 
Uncalled bet ($0.05) returned to enitram45
enitram45 collected $0.10 from pot
enitram45: doesn't show hand 
*** SUMMARY ***
Total pot $0.10 | Rake $0 
Seat 1: rogdor30 folded before Flop (didn't bet)
Seat 2: lastfox folded before Flop (didn't bet)
Seat 3: vicman121 (button) folded before Flop (didn't bet)
Seat 4: Kobert72 (small blind) folded before Flop
Seat 5: enitram45 (big blind) collected ($0.10)
Seat 6: bazil139 folded before Flop (didn't bet)



PokerStars Hand #222965609234:  Hold'em No Limit ($0.05/$0.10 USD) - 2021/01/23 14:11:23 ET
Table 'Transvaalia' 6-max Seat #4 is the button
Seat 1: rogdor30 ($10 in chips) 
Seat 2: lastfox ($23.73 in chips) 
Seat 3: vicman121 ($20.52 in chips) 
Seat 4: Kobert72 ($10 in chips) 
Seat 5: enitram45 ($9.35 in chips) 
Seat 6: bazil139 ($11.16 in chips) 
enitram45: posts small blind $0.05
bazil139: posts big blind $0.10
*** HOLE CARDS ***
rogdor30: folds 
lastfox: folds 
vicman121: raises $0.15 to $0.25
Kobert72: folds 
enitram45: folds 
bazil139: folds 
Uncalled bet ($0.15) returned to vicman121
vicman121 collected $0.25 from pot
vicman121: doesn't show hand 
*** SUMMARY ***
Total pot $0.25 | Rake $0 
Seat 1: rogdor30 folded before Flop (didn't bet)
Seat 2: lastfox folded before Flop (didn't bet)
Seat 3: vicman121 collected ($0.25)
Seat 4: Kobert72 (button) folded before Flop (didn't bet)
Seat 5: enitram45 (small blind) folded before Flop
Seat 6: bazil139 (big blind) folded before Flop



PokerStars Hand #222965626138:  Hold'em No Limit ($0.05/$0.10 USD) - 2021/01/23 14:11:44 ET
Table 'Transvaalia' 6-max Seat #5 is the button
Seat 1: rogdor30 ($10 in chips) 
Seat 2: lastfox ($23.73 in chips) 
Seat 3: vicman121 ($20.67 in chips) 
Seat 4: Kobert72 ($10 in chips) 
Seat 5: enitram45 ($9.30 in chips) 
Seat 6: bazil139 ($11.06 in chips) 
bazil139: posts small blind $0.05
rogdor30: posts big blind $0.10
*** HOLE CARDS ***
lastfox: raises $0.13 to $0.23
vicman121: folds 
Kobert72: folds 
enitram45: raises $0.27 to $0.50
bazil139: folds 
rogdor30: folds 
lastfox: calls $0.27
*** FLOP *** [Jc 9d Kc]
lastfox: checks 
enitram45: bets $0.50
lastfox: folds 
Uncalled bet ($0.50) returned to enitram45
enitram45 collected $1.10 from pot
enitram45: doesn't show hand 
*** SUMMARY ***
Total pot $1.15 | Rake $0.05 
Board [Jc 9d Kc]
Seat 1: rogdor30 (big blind) folded before Flop
Seat 2: lastfox folded on the Flop
Seat 3: vicman121 folded before Flop (didn't bet)
Seat 4: Kobert72 folded before Flop (didn't bet)
Seat 5: enitram45 (button) collected ($1.10)
Seat 6: bazil139 (small blind) folded before Flop



PokerStars Hand #222965880906:  Hold'em No Limit ($0.05/$0.10 USD) - 2021/01/23 14:17:03 ET
Table 'Transvaalia' 6-max Seat #6 is the button
Seat 1: rogdor30 ($10 in chips) 
Seat 2: lastfox ($22.92 in chips) 
Seat 3: vicman121 ($20.98 in chips) 
Seat 4: Kobert72 ($10.11 in chips) 
Seat 5: enitram45 ($10.18 in chips) 
Seat 6: BetGuy69 ($10 in chips) 
rogdor30: posts small blind $0.05
lastfox: posts big blind $0.10
*** HOLE CARDS ***
vicman121: folds 
Kobert72: folds 
enitram45: folds 
BetGuy69: folds 
rogdor30: folds 
Uncalled bet ($0.05) returned to lastfox
lastfox collected $0.10 from pot
lastfox: doesn't show hand 
*** SUMMARY ***
Total pot $0.10 | Rake $0 
Seat 1: rogdor30 (small blind) folded before Flop
Seat 2: lastfox (big blind) collected ($0.10)
Seat 3: vicman121 folded before Flop (didn't bet)
Seat 4: Kobert72 folded before Flop (didn't bet)
Seat 5: enitram45 folded before Flop (didn't bet)
Seat 6: BetGuy69 (button) folded before Flop (didn't bet)



PokerStars Hand #222965889572:  Hold'em No Limit ($0.05/$0.10 USD) - 2021/01/23 14:17:14 ET
Table 'Transvaalia' 6-max Seat #1 is the button
Seat 1: rogdor30 ($10 in chips) 
Seat 2: lastfox ($22.97 in chips) 
Seat 3: vicman121 ($20.98 in chips) 
Seat 4: Kobert72 ($10.11 in chips) 
Seat 5: enitram45 ($10.18 in chips) 
Seat 6: BetGuy69 ($10 in chips) 
lastfox: posts small blind $0.05
vicman121: posts big blind $0.10
*** HOLE CARDS ***
Kobert72: folds 
enitram45: folds 
BetGuy69: raises $0.20 to $0.30
rogdor30: folds 
lastfox: folds 
vicman121: calls $0.20
*** FLOP *** [2h Js As]
vicman121: checks 
BetGuy69: checks 
*** TURN *** [2h Js As] [3h]
vicman121: bets $0.47
BetGuy69: folds 
Uncalled bet ($0.47) returned to vicman121
vicman121 collected $0.62 from pot
vicman121: doesn't show hand 
*** SUMMARY ***
Total pot $0.65 | Rake $0.03 
Board [2h Js As 3h]
Seat 1: rogdor30 (button) folded before Flop (didn't bet)
Seat 2: lastfox (small blind) folded before Flop
Seat 3: vicman121 (big blind) collected ($0.62)
Seat 4: Kobert72 folded before Flop (didn't bet)
Seat 5: enitram45 folded before Flop (didn't bet)
Seat 6: BetGuy69 folded on the Turn



PokerStars Hand #222965917980:  Hold'em No Limit ($0.05/$0.10 USD) - 2021/01/23 14:17:50 ET
Table 'Transvaalia' 6-max Seat #2 is the button
Seat 1: rogdor30 ($10 in chips) 
Seat 2: lastfox ($22.92 in chips) 
Seat 3: vicman121 ($21.30 in chips) 
Seat 4: Kobert72 ($10.11 in chips) 
Seat 5: enitram45 ($10.18 in chips) 
Seat 6: BetGuy69 ($10 in chips) 
vicman121: posts small blind $0.05
Kobert72: posts big blind $0.10
*** HOLE CARDS ***
enitram45: folds 
BetGuy69: folds 
rogdor30: folds 
lastfox: folds 
vicman121: folds 
Uncalled bet ($0.05) returned to Kobert72
Kobert72 collected $0.10 from pot
Kobert72: doesn't show hand 
*** SUMMARY ***
Total pot $0.10 | Rake $0 
Seat 1: rogdor30 folded before Flop (didn't bet)
Seat 2: lastfox (button) folded before Flop (didn't bet)
Seat 3: vicman121 (small blind) folded before Flop
Seat 4: Kobert72 (big blind) collected ($0.10)
Seat 5: enitram45 folded before Flop (didn't bet)
Seat 6: BetGuy69 folded before Flop (didn't bet)



PokerStars Hand #222965928223:  Hold'em No Limit ($0.05/$0.10 USD) - 2021/01/23 14:18:03 ET
Table 'Transvaalia' 6-max Seat #3 is the button
Seat 1: rogdor30 ($10 in chips) 
Seat 2: lastfox ($22.92 in chips) 
Seat 3: vicman121 ($21.25 in chips) 
Seat 4: Kobert72 ($10.16 in chips) 
Seat 5: enitram45 ($10.18 in chips) 
Seat 6: BetGuy69 ($10 in chips) 
Kobert72: posts small blind $0.05
enitram45: posts big blind $0.10
*** HOLE CARDS ***
BetGuy69: folds 
rogdor30: folds 
lastfox: raises $0.25 to $0.35
vicman121: folds 
Kobert72: folds 
enitram45: folds 
Uncalled bet ($0.25) returned to lastfox
lastfox collected $0.25 from pot
lastfox: doesn't show hand 
*** SUMMARY ***
Total pot $0.25 | Rake $0 
Seat 1: rogdor30 folded before Flop (didn't bet)
Seat 2: lastfox collected ($0.25)
Seat 3: vicman121 (button) folded before Flop (didn't bet)
Seat 4: Kobert72 (small blind) folded before Flop
Seat 5: enitram45 (big blind) folded before Flop
Seat 6: BetGuy69 folded before Flop (didn't bet)



PokerStars Hand #222965942882:  Hold'em No Limit ($0.05/$0.10 USD) - 2021/01/23 14:18:21 ET
Table 'Transvaalia' 6-max Seat #4 is the button
Seat 1: rogdor30 ($10 in chips) 
Seat 2: lastfox ($23.07 in chips) 
Seat 3: vicman121 ($21.25 in chips) 
Seat 4: Kobert72 ($10.11 in chips) 
Seat 5: enitram45 ($10.08 in chips) 
Seat 6: BetGuy69 ($10 in chips) 
enitram45: posts small blind $0.05
BetGuy69: posts big blind $0.10
*** HOLE CARDS ***
rogdor30: folds 
lastfox: folds 
vicman121: folds 
Kobert72: folds 
enitram45: folds 
Uncalled bet ($0.05) returned to BetGuy69
BetGuy69 collected $0.10 from pot
BetGuy69: doesn't show hand 
rogdor30 leaves the table
*** SUMMARY ***
Total pot $0.10 | Rake $0 
Seat 1: rogdor30 folded before Flop (didn't bet)
Seat 2: lastfox folded before Flop (didn't bet)
Seat 3: vicman121 folded before Flop (didn't bet)
Seat 4: Kobert72 (button) folded before Flop (didn't bet)
Seat 5: enitram45 (small blind) folded before Flop
Seat 6: BetGuy69 (big blind) collected ($0.10)



PokerStars Hand #222965950360:  Hold'em No Limit ($0.05/$0.10 USD) - 2021/01/23 14:18:31 ET
Table 'Transvaalia' 6-max Seat #5 is the button
Seat 2: lastfox ($23.07 in chips) 
Seat 3: vicman121 ($21.25 in chips) 
Seat 4: Kobert72 ($10.11 in chips) 
Seat 5: enitram45 ($10.03 in chips) 
Seat 6: BetGuy69 ($10.05 in chips) 
BetGuy69: posts small blind $0.05
lastfox: posts big blind $0.10
*** HOLE CARDS ***
vicman121: folds 
Kobert72: folds 
enitram45: raises $0.20 to $0.30
BetGuy69: raises $0.70 to $1
lastfox: folds 
enitram45: folds 
Uncalled bet ($0.70) returned to BetGuy69
BetGuy69 collected $0.70 from pot
BetGuy69: doesn't show hand 
*** SUMMARY ***
Total pot $0.70 | Rake $0 
Seat 2: lastfox (big blind) folded before Flop
Seat 3: vicman121 folded before Flop (didn't bet)
Seat 4: Kobert72 folded before Flop (didn't bet)
Seat 5: enitram45 (button) folded before Flop
Seat 6: BetGuy69 (small blind) collected ($0.70)



PokerStars Hand #222965960733:  Hold'em No Limit ($0.05/$0.10 USD) - 2021/01/23 14:18:44 ET
Table 'Transvaalia' 6-max Seat #6 is the button
Seat 2: lastfox ($22.97 in chips) 
Seat 3: vicman121 ($21.25 in chips) 
Seat 4: Kobert72 ($10.11 in chips) 
Seat 5: enitram45 ($9.73 in chips) 
Seat 6: BetGuy69 ($10.45 in chips) 
lastfox: posts small blind $0.05
vicman121: posts big blind $0.10
*** HOLE CARDS ***
Kobert72: folds 
enitram45: folds 
BetGuy69: raises $0.15 to $0.25
lastfox: folds 
vicman121: folds 
Uncalled bet ($0.15) returned to BetGuy69
BetGuy69 collected $0.25 from pot
BetGuy69: doesn't show hand 
*** SUMMARY ***
Total pot $0.25 | Rake $0 
Seat 2: lastfox (small blind) folded before Flop
Seat 3: vicman121 (big blind) folded before Flop
Seat 4: Kobert72 folded before Flop (didn't bet)
Seat 5: enitram45 folded before Flop (didn't bet)
Seat 6: BetGuy69 (button) collected ($0.25)



PokerStars Hand #222965968943:  Hold'em No Limit ($0.05/$0.10 USD) - 2021/01/23 14:18:54 ET
Table 'Transvaalia' 6-max Seat #2 is the button
Seat 2: lastfox ($22.92 in chips) 
Seat 3: vicman121 ($21.15 in chips) 
Seat 4: Kobert72 ($10.11 in chips) 
Seat 5: enitram45 ($9.73 in chips) 
Seat 6: BetGuy69 ($10.60 in chips) 
vicman121: posts small blind $0.05
Kobert72: posts big blind $0.10
*** HOLE CARDS ***
enitram45: folds 
BetGuy69: raises $0.20 to $0.30
lastfox: folds 
vicman121: raises $0.70 to $1
Spud-JCT joins the table at seat #1 
Kobert72: folds 
BetGuy69: calls $0.70
*** FLOP *** [4d 2h 5h]
vicman121: bets $0.60
BetGuy69: folds 
Uncalled bet ($0.60) returned to vicman121
vicman121 collected $2.01 from pot
vicman121: doesn't show hand 
*** SUMMARY ***
Total pot $2.10 | Rake $0.09 
Board [4d 2h 5h]
Seat 2: lastfox (button) folded before Flop (didn't bet)
Seat 3: vicman121 (small blind) collected ($2.01)
Seat 4: Kobert72 (big blind) folded before Flop
Seat 5: enitram45 folded before Flop (didn't bet)
Seat 6: BetGuy69 folded on the Flop



PokerStars Hand #222965997279:  Hold'em No Limit ($0.05/$0.10 USD) - 2021/01/23 14:19:30 ET
Table 'Transvaalia' 6-max Seat #3 is the button
Seat 1: Spud-JCT ($8 in chips) 
Seat 2: lastfox ($22.92 in chips) 
Seat 3: vicman121 ($22.16 in chips) 
Seat 4: Kobert72 ($10.01 in chips) 
Seat 5: enitram45 ($9.73 in chips) 
Seat 6: BetGuy69 ($10 in chips) 
Kobert72: posts small blind $0.05
enitram45: posts big blind $0.10
Spud-JCT: posts big blind $0.10
*** HOLE CARDS ***
BetGuy69: folds 
Spud-JCT: raises $0.10 to $0.20
lastfox: folds 
vicman121: folds 
Kobert72: folds 
enitram45: calls $0.10
*** FLOP *** [Kh 7h Jh]
enitram45: checks 
Spud-JCT: checks 
*** TURN *** [Kh 7h Jh] [Ts]
enitram45: checks 
Spud-JCT: checks 
*** RIVER *** [Kh 7h Jh Ts] [8h]
enitram45: checks 
Spud-JCT: checks 
*** SHOW DOWN ***
enitram45: shows [Tc 8s] (two pair, Tens and Eights)
Spud-JCT: mucks hand 
enitram45 collected $0.43 from pot
*** SUMMARY ***
Total pot $0.45 | Rake $0.02 
Board [Kh 7h Jh Ts 8h]
Seat 1: Spud-JCT mucked
Seat 2: lastfox folded before Flop (didn't bet)
Seat 3: vicman121 (button) folded before Flop (didn't bet)
Seat 4: Kobert72 (small blind) folded before Flop
Seat 5: enitram45 (big blind) showed [Tc 8s] and won ($0.43) with two pair, Tens and Eights
Seat 6: BetGuy69 folded before Flop (didn't bet)



PokerStars Hand #222966014093:  Hold'em No Limit ($0.05/$0.10 USD) - 2021/01/23 14:19:52 ET
Table 'Transvaalia' 6-max Seat #4 is the button
Seat 1: Spud-JCT ($7.80 in chips) 
Seat 2: lastfox ($22.92 in chips) 
Seat 3: vicman121 ($22.16 in chips) 
Seat 4: Kobert72 ($10 in chips) 
Seat 5: enitram45 ($9.96 in chips) 
Seat 6: BetGuy69 ($10 in chips) 
enitram45: posts small blind $0.05
BetGuy69: posts big blind $0.10
*** HOLE CARDS ***
Spud-JCT: folds 
lastfox: folds 
vicman121: folds 
Kobert72: folds 
enitram45: calls $0.05
BetGuy69: raises $0.30 to $0.40
enitram45: calls $0.30
*** FLOP *** [7s Qc 3s]
enitram45: checks 
BetGuy69: bets $0.25
enitram45: calls $0.25
*** TURN *** [7s Qc 3s] [2c]
enitram45: checks 
BetGuy69: checks 
*** RIVER *** [7s Qc 3s 2c] [Qh]
enitram45: bets $0.62
BetGuy69: folds 
Uncalled bet ($0.62) returned to enitram45
enitram45 collected $1.24 from pot
enitram45: doesn't show hand 
*** SUMMARY ***
Total pot $1.30 | Rake $0.06 
Board [7s Qc 3s 2c Qh]
Seat 1: Spud-JCT folded before Flop (didn't bet)
Seat 2: lastfox folded before Flop (didn't bet)
Seat 3: vicman121 folded before Flop (didn't bet)
Seat 4: Kobert72 (button) folded before Flop (didn't bet)
Seat 5: enitram45 (small blind) collected ($1.24)
Seat 6: BetGuy69 (big blind) folded on the River



PokerStars Hand #222966037504:  Hold'em No Limit ($0.05/$0.10 USD) - 2021/01/23 14:20:22 ET
Table 'Transvaalia' 6-max Seat #5 is the button
Seat 1: Spud-JCT ($7.80 in chips) 
Seat 2: lastfox ($22.92 in chips) 
Seat 3: vicman121 ($22.16 in chips) 
Seat 4: Kobert72 ($10 in chips) 
Seat 5: enitram45 ($10.55 in chips) 
Seat 6: BetGuy69 ($10 in chips) 
BetGuy69: posts small blind $0.05
Spud-JCT: posts big blind $0.10
*** HOLE CARDS ***
lastfox: folds 
vicman121: folds 
Kobert72: folds 
enitram45: folds 
BetGuy69: raises $0.20 to $0.30
Spud-JCT: calls $0.20
*** FLOP *** [Jd Js 3d]
BetGuy69: checks 
Spud-JCT: bets $0.10
BetGuy69: calls $0.10
*** TURN *** [Jd Js 3d] [2d]
BetGuy69: checks 
Spud-JCT: bets $0.70
BetGuy69: folds 
Uncalled bet ($0.70) returned to Spud-JCT
Spud-JCT collected $0.76 from pot
Spud-JCT: doesn't show hand 
*** SUMMARY ***
Total pot $0.80 | Rake $0.04 
Board [Jd Js 3d 2d]
Seat 1: Spud-JCT (big blind) collected ($0.76)
Seat 2: lastfox folded before Flop (didn't bet)
Seat 3: vicman121 folded before Flop (didn't bet)
Seat 4: Kobert72 folded before Flop (didn't bet)
Seat 5: enitram45 (button) folded before Flop (didn't bet)
Seat 6: BetGuy69 (small blind) folded on the Turn



PokerStars Hand #222966062290:  Hold'em No Limit ($0.05/$0.10 USD) - 2021/01/23 14:20:53 ET
Table 'Transvaalia' 6-max Seat #6 is the button
Seat 1: Spud-JCT ($8.16 in chips) 
Seat 2: lastfox ($22.92 in chips) 
Seat 3: vicman121 ($22.16 in chips) 
Seat 4: Kobert72 ($10 in chips) 
Seat 5: enitram45 ($10.55 in chips) 
Seat 6: BetGuy69 ($10 in chips) 
Spud-JCT: posts small blind $0.05
lastfox: posts big blind $0.10
*** HOLE CARDS ***
vicman121: folds 
Kobert72: folds 
enitram45: folds 
BetGuy69: raises $0.15 to $0.25
Spud-JCT: folds 
lastfox: calls $0.15
*** FLOP *** [4d 8d 6c]
lastfox: checks 
BetGuy69: checks 
*** TURN *** [4d 8d 6c] [2d]
lastfox: bets $0.40
BetGuy69: folds 
Uncalled bet ($0.40) returned to lastfox
lastfox collected $0.53 from pot
lastfox: doesn't show hand 
*** SUMMARY ***
Total pot $0.55 | Rake $0.02 
Board [4d 8d 6c 2d]
Seat 1: Spud-JCT (small blind) folded before Flop
Seat 2: lastfox (big blind) collected ($0.53)
Seat 3: vicman121 folded before Flop (didn't bet)
Seat 4: Kobert72 folded before Flop (didn't bet)
Seat 5: enitram45 folded before Flop (didn't bet)
Seat 6: BetGuy69 (button) folded on the Turn



PokerStars Hand #222966087296:  Hold'em No Limit ($0.05/$0.10 USD) - 2021/01/23 14:21:21 ET
Table 'Transvaalia' 6-max Seat #1 is the button
Seat 1: Spud-JCT ($8.11 in chips) 
Seat 2: lastfox ($23.20 in chips) 
Seat 3: vicman121 ($22.16 in chips) 
Seat 4: Kobert72 ($10 in chips) 
Seat 5: enitram45 ($10.55 in chips) 
Seat 6: BetGuy69 ($10 in chips) 
lastfox: posts small blind $0.05
vicman121: posts big blind $0.10
*** HOLE CARDS ***
Kobert72: folds 
enitram45: raises $0.10 to $0.20
BetGuy69: folds 
Spud-JCT: folds 
lastfox: folds 
vicman121: folds 
Uncalled bet ($0.10) returned to enitram45
enitram45 collected $0.25 from pot
enitram45: doesn't show hand 
*** SUMMARY ***
Total pot $0.25 | Rake $0 
Seat 1: Spud-JCT (button) folded before Flop (didn't bet)
Seat 2: lastfox (small blind) folded before Flop
Seat 3: vicman121 (big blind) folded before Flop
Seat 4: Kobert72 folded before Flop (didn't bet)
Seat 5: enitram45 collected ($0.25)
Seat 6: BetGuy69 folded before Flop (didn't bet)



PokerStars Hand #222966099258:  Hold'em No Limit ($0.05/$0.10 USD) - 2021/01/23 14:21:37 ET
Table 'Transvaalia' 6-max Seat #2 is the button
Seat 1: Spud-JCT ($8.11 in chips) 
Seat 2: lastfox ($23.15 in chips) 
Seat 3: vicman121 ($22.06 in chips) 
Seat 4: Kobert72 ($10 in chips) 
Seat 5: enitram45 ($10.70 in chips) 
Seat 6: BetGuy69 ($10 in chips) 
vicman121: posts small blind $0.05
Kobert72: posts big blind $0.10
*** HOLE CARDS ***
enitram45: folds 
BetGuy69: raises $0.20 to $0.30
Spud-JCT: calls $0.30
enitram45 leaves the table
lastfox: folds 
vicman121: folds 
Kobert72: folds 
*** FLOP *** [7c 6h 3d]
BetGuy69: bets $0.54
Spud-JCT: folds 
Uncalled bet ($0.54) returned to BetGuy69
BetGuy69 collected $0.72 from pot
BetGuy69: doesn't show hand 
*** SUMMARY ***
Total pot $0.75 | Rake $0.03 
Board [7c 6h 3d]
Seat 1: Spud-JCT folded on the Flop
Seat 2: lastfox (button) folded before Flop (didn't bet)
Seat 3: vicman121 (small blind) folded before Flop
Seat 4: Kobert72 (big blind) folded before Flop
Seat 5: enitram45 folded before Flop (didn't bet)
Seat 6: BetGuy69 collected ($0.72)



PokerStars Hand #222966116882:  Hold'em No Limit ($0.05/$0.10 USD) - 2021/01/23 14:21:59 ET
Table 'Transvaalia' 6-max Seat #3 is the button
Seat 1: Spud-JCT ($7.81 in chips) 
Seat 2: lastfox ($23.15 in chips) 
Seat 3: vicman121 ($22.01 in chips) 
Seat 4: Kobert72 ($10 in chips) 
Seat 6: BetGuy69 ($10.42 in chips) 
jojoboon78 joins the table at seat #5 
Kobert72: posts small blind $0.05
BetGuy69: posts big blind $0.10
*** HOLE CARDS ***
Spud-JCT: folds 
lastfox: raises $0.12 to $0.22
vicman121: folds 
Kobert72: folds 
BetGuy69: raises $0.68 to $0.90
lastfox: folds 
Uncalled bet ($0.68) returned to BetGuy69
BetGuy69 collected $0.49 from pot
BetGuy69: doesn't show hand 
*** SUMMARY ***
Total pot $0.49 | Rake $0 
Seat 1: Spud-JCT folded before Flop (didn't bet)
Seat 2: lastfox folded before Flop
Seat 3: vicman121 (button) folded before Flop (didn't bet)
Seat 4: Kobert72 (small blind) folded before Flop
Seat 6: BetGuy69 (big blind) collected ($0.49)



PokerStars Hand #222966129818:  Hold'em No Limit ($0.05/$0.10 USD) - 2021/01/23 14:22:16 ET
Table 'Transvaalia' 6-max Seat #4 is the button
Seat 1: Spud-JCT ($7.81 in chips) 
Seat 2: lastfox ($22.93 in chips) 
Seat 3: vicman121 ($22.01 in chips) 
Seat 4: Kobert72 ($10 in chips) 
Seat 6: BetGuy69 ($10.69 in chips) 
BetGuy69: posts small blind $0.05
Spud-JCT: posts big blind $0.10
*** HOLE CARDS ***
lastfox: raises $0.13 to $0.23
vicman121: folds 
Kobert72: folds 
BetGuy69: folds 
Spud-JCT: folds 
Uncalled bet ($0.13) returned to lastfox
lastfox collected $0.25 from pot
lastfox: doesn't show hand 
*** SUMMARY ***
Total pot $0.25 | Rake $0 
Seat 1: Spud-JCT (big blind) folded before Flop
Seat 2: lastfox collected ($0.25)
Seat 3: vicman121 folded before Flop (didn't bet)
Seat 4: Kobert72 (button) folded before Flop (didn't bet)
Seat 6: BetGuy69 (small blind) folded before Flop



PokerStars Hand #222966138503:  Hold'em No Limit ($0.05/$0.10 USD) - 2021/01/23 14:22:27 ET
Table 'Transvaalia' 6-max Seat #6 is the button
Seat 1: Spud-JCT ($7.71 in chips) 
Seat 2: lastfox ($23.08 in chips) 
Seat 3: vicman121 ($22.01 in chips) 
Seat 4: Kobert72 ($10 in chips) 
Seat 5: jojoboon78 ($10 in chips) 
Seat 6: BetGuy69 ($10.64 in chips) 
Spud-JCT: posts small blind $0.05
lastfox: posts big blind $0.10
jojoboon78: posts big blind $0.10
*** HOLE CARDS ***
vicman121: folds 
Kobert72: folds 
jojoboon78: raises $0.20 to $0.30
BetGuy69: calls $0.30
Spud-JCT: calls $0.25
lastfox: folds 
*** FLOP *** [2d Tc 4s]
Spud-JCT: checks 
jojoboon78: bets $0.48
BetGuy69: calls $0.48
Spud-JCT: folds 
*** TURN *** [2d Tc 4s] [Js]
jojoboon78: bets $1.25
BetGuy69: folds 
Uncalled bet ($1.25) returned to jojoboon78
jojoboon78 collected $1.87 from pot
jojoboon78: doesn't show hand 
*** SUMMARY ***
Total pot $1.96 | Rake $0.09 
Board [2d Tc 4s Js]
Seat 1: Spud-JCT (small blind) folded on the Flop
Seat 2: lastfox (big blind) folded before Flop
Seat 3: vicman121 folded before Flop (didn't bet)
Seat 4: Kobert72 folded before Flop (didn't bet)
Seat 5: jojoboon78 collected ($1.87)
Seat 6: BetGuy69 (button) folded on the Turn



PokerStars Hand #222966170584:  Hold'em No Limit ($0.05/$0.10 USD) - 2021/01/23 14:23:07 ET
Table 'Transvaalia' 6-max Seat #1 is the button
Seat 1: Spud-JCT ($7.41 in chips) 
Seat 2: lastfox ($22.98 in chips) 
Seat 3: vicman121 ($22.01 in chips) 
Seat 4: Kobert72 ($10 in chips) 
Seat 5: jojoboon78 ($11.09 in chips) 
Seat 6: BetGuy69 ($10 in chips) 
lastfox: posts small blind $0.05
vicman121: posts big blind $0.10
*** HOLE CARDS ***
Kobert72: folds 
jojoboon78: raises $0.15 to $0.25
BetGuy69: folds 
Spud-JCT: calls $0.25
lastfox: folds 
vicman121: folds 
*** FLOP *** [Ts 4d Kc]
jojoboon78: checks 
Spud-JCT: checks 
*** TURN *** [Ts 4d Kc] [7s]
jojoboon78: bets $0.31
Spud-JCT: folds 
Uncalled bet ($0.31) returned to jojoboon78
jojoboon78 collected $0.62 from pot
jojoboon78: doesn't show hand 
*** SUMMARY ***
Total pot $0.65 | Rake $0.03 
Board [Ts 4d Kc 7s]
Seat 1: Spud-JCT (button) folded on the Turn
Seat 2: lastfox (small blind) folded before Flop
Seat 3: vicman121 (big blind) folded before Flop
Seat 4: Kobert72 folded before Flop (didn't bet)
Seat 5: jojoboon78 collected ($0.62)
Seat 6: BetGuy69 folded before Flop (didn't bet)



PokerStars Hand #222966192593:  Hold'em No Limit ($0.05/$0.10 USD) - 2021/01/23 14:23:35 ET
Table 'Transvaalia' 6-max Seat #2 is the button
Seat 1: Spud-JCT ($7.16 in chips) 
Seat 2: lastfox ($22.93 in chips) 
Seat 3: vicman121 ($21.91 in chips) 
Seat 4: Kobert72 ($10 in chips) 
Seat 5: jojoboon78 ($11.46 in chips) 
Seat 6: BetGuy69 ($10 in chips) 
vicman121: posts small blind $0.05
Kobert72: posts big blind $0.10
*** HOLE CARDS ***
jojoboon78: folds 
BetGuy69: folds 
Spud-JCT: folds 
lastfox: folds 
vicman121: raises $0.20 to $0.30
Kobert72: calls $0.20
*** FLOP *** [6c Jh 8d]
BetGuy69 leaves the table
FacuLarrocca joins the table at seat #6 
vicman121: bets $0.17
Kobert72: calls $0.17
*** TURN *** [6c Jh 8d] [Ac]
vicman121: checks 
Kobert72: checks 
*** RIVER *** [6c Jh 8d Ac] [3h]
vicman121: checks 
Kobert72: checks 
*** SHOW DOWN ***
vicman121: shows [Qh Js] (a pair of Jacks)
Kobert72: mucks hand 
vicman121 collected $0.90 from pot
*** SUMMARY ***
Total pot $0.94 | Rake $0.04 
Board [6c Jh 8d Ac 3h]
Seat 1: Spud-JCT folded before Flop (didn't bet)
Seat 2: lastfox (button) folded before Flop (didn't bet)
Seat 3: vicman121 (small blind) showed [Qh Js] and won ($0.90) with a pair of Jacks
Seat 4: Kobert72 (big blind) mucked
Seat 5: jojoboon78 folded before Flop (didn't bet)
Seat 6: BetGuy69 folded before Flop (didn't bet)



PokerStars Hand #222966236005:  Hold'em No Limit ($0.05/$0.10 USD) - 2021/01/23 14:24:31 ET
Table 'Transvaalia' 6-max Seat #3 is the button
Seat 1: Spud-JCT ($7.16 in chips) 
Seat 2: lastfox ($22.93 in chips) 
Seat 3: vicman121 ($22.34 in chips) 
Seat 4: Kobert72 ($10 in chips) 
Seat 5: jojoboon78 ($11.46 in chips) 
Kobert72: posts small blind $0.05
jojoboon78: posts big blind $0.10
FacuLarrocca: sits out 
*** HOLE CARDS ***
Spud-JCT: calls $0.10
lastfox: raises $0.35 to $0.45
vicman121: raises $1.15 to $1.60
Kobert72: folds 
jojoboon78: folds 
Spud-JCT: calls $1.50
lastfox: folds 
*** FLOP *** [3h 5h 8s]
Spud-JCT: checks 
vicman121: bets $1.09
Spud-JCT: calls $1.09
*** TURN *** [3h 5h 8s] [Ac]
Spud-JCT: bets $0.30
vicman121: calls $0.30
*** RIVER *** [3h 5h 8s Ac] [Jc]
Spud-JCT: bets $4.17 and is all-in
vicman121: calls $4.17
*** SHOW DOWN ***
Spud-JCT: shows [Kh As] (a pair of Aces)
vicman121: shows [Kd Ks] (a pair of Kings)
Spud-JCT collected $14.25 from pot
*** SUMMARY ***
Total pot $14.92 | Rake $0.67 
Board [3h 5h 8s Ac Jc]
Seat 1: Spud-JCT showed [Kh As] and won ($14.25) with a pair of Aces
Seat 2: lastfox folded before Flop
Seat 3: vicman121 (button) showed [Kd Ks] and lost with a pair of Kings
Seat 4: Kobert72 (small blind) folded before Flop
Seat 5: jojoboon78 (big blind) folded before Flop



PokerStars Hand #222966277039:  Hold'em No Limit ($0.05/$0.10 USD) - 2021/01/23 14:25:23 ET
Table 'Transvaalia' 6-max Seat #4 is the button
Seat 1: Spud-JCT ($14.25 in chips) 
Seat 2: lastfox ($22.48 in chips) 
Seat 3: vicman121 ($15.18 in chips) 
Seat 4: Kobert72 ($10 in chips) 
Seat 5: jojoboon78 ($11.36 in chips) 
Seat 6: FacuLarrocca ($10 in chips) 
jojoboon78: posts small blind $0.05
FacuLarrocca: posts big blind $0.10
*** HOLE CARDS ***
Spud-JCT: calls $0.10
lastfox: folds 
vicman121: folds 
Kobert72: folds 
jojoboon78: folds 
FacuLarrocca: checks 
*** FLOP *** [Kc 9d 9c]
FacuLarrocca: checks 
Spud-JCT: bets $0.10
FacuLarrocca: folds 
Uncalled bet ($0.10) returned to Spud-JCT
Spud-JCT collected $0.24 from pot
Spud-JCT: doesn't show hand 
*** SUMMARY ***
Total pot $0.25 | Rake $0.01 
Board [Kc 9d 9c]
Seat 1: Spud-JCT collected ($0.24)
Seat 2: lastfox folded before Flop (didn't bet)
Seat 3: vicman121 folded before Flop (didn't bet)
Seat 4: Kobert72 (button) folded before Flop (didn't bet)
Seat 5: jojoboon78 (small blind) folded before Flop
Seat 6: FacuLarrocca (big blind) folded on the Flop



PokerStars Hand #222966293211:  Hold'em No Limit ($0.05/$0.10 USD) - 2021/01/23 14:25:44 ET
Table 'Transvaalia' 6-max Seat #5 is the button
Seat 1: Spud-JCT ($14.39 in chips) 
Seat 2: lastfox ($22.48 in chips) 
Seat 3: vicman121 ($15.18 in chips) 
Seat 4: Kobert72 ($10 in chips) 
Seat 5: jojoboon78 ($11.31 in chips) 
Seat 6: FacuLarrocca ($10 in chips) 
FacuLarrocca: posts small blind $0.05
Spud-JCT: posts big blind $0.10
*** HOLE CARDS ***
lastfox: folds 
vicman121: folds 
Kobert72: folds 
jojoboon78: raises $0.15 to $0.25
FacuLarrocca: folds 
Spud-JCT: folds 
Uncalled bet ($0.15) returned to jojoboon78
jojoboon78 collected $0.25 from pot
jojoboon78: doesn't show hand 
*** SUMMARY ***
Total pot $0.25 | Rake $0 
Seat 1: Spud-JCT (big blind) folded before Flop
Seat 2: lastfox folded before Flop (didn't bet)
Seat 3: vicman121 folded before Flop (didn't bet)
Seat 4: Kobert72 folded before Flop (didn't bet)
Seat 5: jojoboon78 (button) collected ($0.25)
Seat 6: FacuLarrocca (small blind) folded before Flop



PokerStars Hand #222966304006:  Hold'em No Limit ($0.05/$0.10 USD) - 2021/01/23 14:25:58 ET
Table 'Transvaalia' 6-max Seat #6 is the button
Seat 1: Spud-JCT ($14.29 in chips) 
Seat 3: vicman121 ($15.18 in chips) 
Seat 4: Kobert72 ($10 in chips) 
Seat 5: jojoboon78 ($11.46 in chips) 
Seat 6: FacuLarrocca ($10 in chips) 
Spud-JCT: posts small blind $0.05
lastfox has timed out
lastfox: is sitting out 
vicman121: posts big blind $0.10
*** HOLE CARDS ***
lastfox is disconnected 
Kobert72: folds 
jojoboon78: raises $0.15 to $0.25
FacuLarrocca: folds 
Spud-JCT: calls $0.20
vicman121: folds 
*** FLOP *** [6h 6s 5s]
Spud-JCT: bets $0.10
jojoboon78: raises $0.30 to $0.40
Spud-JCT: calls $0.30
*** TURN *** [6h 6s 5s] [Ad]
Spud-JCT: bets $0.10
jojoboon78: raises $0.60 to $0.70
Spud-JCT: folds 
Uncalled bet ($0.60) returned to jojoboon78
jojoboon78 collected $1.53 from pot
jojoboon78: doesn't show hand 
*** SUMMARY ***
Total pot $1.60 | Rake $0.07 
Board [6h 6s 5s Ad]
Seat 1: Spud-JCT (small blind) folded on the Turn
Seat 3: vicman121 (big blind) folded before Flop
Seat 4: Kobert72 folded before Flop (didn't bet)
Seat 5: jojoboon78 collected ($1.53)
Seat 6: FacuLarrocca (button) folded before Flop (didn't bet)



PokerStars Hand #222966362726:  Hold'em No Limit ($0.05/$0.10 USD) - 2021/01/23 14:27:14 ET
Table 'Transvaalia' 6-max Seat #1 is the button
Seat 1: Spud-JCT ($13.54 in chips) 
Seat 3: vicman121 ($15.08 in chips) 
Seat 4: Kobert72 ($10 in chips) 
Seat 5: jojoboon78 ($12.24 in chips) 
Seat 6: FacuLarrocca ($10 in chips) 
vicman121: posts small blind $0.05
Kobert72: posts big blind $0.10
*** HOLE CARDS ***
jojoboon78: raises $0.15 to $0.25
FacuLarrocca: folds 
Spud-JCT: calls $0.25
vicman121: folds 
Kobert72: folds 
*** FLOP *** [2s As 7h]
jojoboon78: bets $0.31
Spud-JCT: folds 
Uncalled bet ($0.31) returned to jojoboon78
jojoboon78 collected $0.62 from pot
jojoboon78: doesn't show hand 
*** SUMMARY ***
Total pot $0.65 | Rake $0.03 
Board [2s As 7h]
Seat 1: Spud-JCT (button) folded on the Flop
Seat 3: vicman121 (small blind) folded before Flop
Seat 4: Kobert72 (big blind) folded before Flop
Seat 5: jojoboon78 collected ($0.62)
Seat 6: FacuLarrocca folded before Flop (didn't bet)



PokerStars Hand #222966393852:  Hold'em No Limit ($0.05/$0.10 USD) - 2021/01/23 14:27:47 ET
Table 'Transvaalia' 6-max Seat #3 is the button
Seat 1: Spud-JCT ($13.29 in chips) 
Seat 3: vicman121 ($15.03 in chips) 
Seat 4: Kobert72 ($10 in chips) 
Seat 5: jojoboon78 ($12.61 in chips) 
Seat 6: FacuLarrocca ($10 in chips) 
Kobert72: posts small blind $0.05
jojoboon78: posts big blind $0.10
*** HOLE CARDS ***
FacuLarrocca: folds 
Spud-JCT: folds 
vicman121: folds 
Kobert72: folds 
Uncalled bet ($0.05) returned to jojoboon78
jojoboon78 collected $0.10 from pot
jojoboon78: doesn't show hand 
*** SUMMARY ***
Total pot $0.10 | Rake $0 
Seat 1: Spud-JCT folded before Flop (didn't bet)
Seat 3: vicman121 (button) folded before Flop (didn't bet)
Seat 4: Kobert72 (small blind) folded before Flop
Seat 5: jojoboon78 (big blind) collected ($0.10)
Seat 6: FacuLarrocca folded before Flop (didn't bet)



PokerStars Hand #222966403976:  Hold'em No Limit ($0.05/$0.10 USD) - 2021/01/23 14:28:00 ET
Table 'Transvaalia' 6-max Seat #4 is the button
Seat 1: Spud-JCT ($13.29 in chips) 
Seat 3: vicman121 ($15.03 in chips) 
Seat 4: Kobert72 ($10 in chips) 
Seat 5: jojoboon78 ($12.66 in chips) 
Seat 6: FacuLarrocca ($10 in chips) 
jojoboon78: posts small blind $0.05
FacuLarrocca: posts big blind $0.10
lastfox: sits out 
*** HOLE CARDS ***
Spud-JCT: calls $0.10
vicman121: folds 
Kobert72: folds 
jojoboon78: calls $0.05
FacuLarrocca: checks 
*** FLOP *** [Ah 4s Kd]
jojoboon78: checks 
FacuLarrocca: checks 
Spud-JCT: checks 
*** TURN *** [Ah 4s Kd] [6h]
jojoboon78: checks 
FacuLarrocca: checks 
Spud-JCT: checks 
*** RIVER *** [Ah 4s Kd 6h] [7c]
jojoboon78: checks 
FacuLarrocca: checks 
Spud-JCT: checks 
*** SHOW DOWN ***
jojoboon78: shows [Qc 2d] (high card Ace)
FacuLarrocca: shows [Qh 4c] (a pair of Fours)
Spud-JCT: shows [Js 6s] (a pair of Sixes)
Spud-JCT collected $0.29 from pot
*** SUMMARY ***
Total pot $0.30 | Rake $0.01 
Board [Ah 4s Kd 6h 7c]
Seat 1: Spud-JCT showed [Js 6s] and won ($0.29) with a pair of Sixes
Seat 3: vicman121 folded before Flop (didn't bet)
Seat 4: Kobert72 (button) folded before Flop (didn't bet)
Seat 5: jojoboon78 (small blind) showed [Qc 2d] and lost with high card Ace
Seat 6: FacuLarrocca (big blind) showed [Qh 4c] and lost with a pair of Fours



PokerStars Hand #222966436325:  Hold'em No Limit ($0.05/$0.10 USD) - 2021/01/23 14:28:42 ET
Table 'Transvaalia' 6-max Seat #5 is the button
Seat 1: Spud-JCT ($13.48 in chips) 
Seat 3: vicman121 ($15.03 in chips) 
Seat 4: Kobert72 ($10 in chips) 
Seat 5: jojoboon78 ($12.56 in chips) 
Seat 6: FacuLarrocca ($10 in chips) 
FacuLarrocca: posts small blind $0.05
Spud-JCT: posts big blind $0.10
lastfox: sits out 
*** HOLE CARDS ***
vicman121: folds 
Kobert72: folds 
jojoboon78: raises $0.15 to $0.25
FacuLarrocca: folds 
Spud-JCT: calls $0.15
*** FLOP *** [Kd 3h Kc]
Spud-JCT: checks 
jojoboon78: bets $0.27
Spud-JCT: folds 
Uncalled bet ($0.27) returned to jojoboon78
jojoboon78 collected $0.53 from pot
jojoboon78: doesn't show hand 
*** SUMMARY ***
Total pot $0.55 | Rake $0.02 
Board [Kd 3h Kc]
Seat 1: Spud-JCT (big blind) folded on the Flop
Seat 3: vicman121 folded before Flop (didn't bet)
Seat 4: Kobert72 folded before Flop (didn't bet)
Seat 5: jojoboon78 (button) collected ($0.53)
Seat 6: FacuLarrocca (small blind) folded before Flop



PokerStars Hand #222966458604:  Hold'em No Limit ($0.05/$0.10 USD) - 2021/01/23 14:29:11 ET
Table 'Transvaalia' 6-max Seat #6 is the button
Seat 1: Spud-JCT ($13.23 in chips) 
Seat 2: lastfox ($22.48 in chips) 
Seat 3: vicman121 ($15.03 in chips) 
Seat 4: Kobert72 ($10 in chips) 
Seat 5: jojoboon78 ($12.84 in chips) 
Seat 6: FacuLarrocca ($10 in chips) 
Spud-JCT: posts small blind $0.05
lastfox: posts big blind $0.10
*** HOLE CARDS ***
vicman121: folds 
Kobert72: raises $0.13 to $0.23
jojoboon78: calls $0.23
FacuLarrocca: folds 
Spud-JCT: calls $0.18
lastfox: folds 
*** FLOP *** [8d 6c 4h]
Spud-JCT: bets $0.10
Kobert72: folds 
jojoboon78: calls $0.10
*** TURN *** [8d 6c 4h] [Jd]
Spud-JCT: checks 
jojoboon78: checks 
*** RIVER *** [8d 6c 4h Jd] [Qc]
Spud-JCT: checks 
jojoboon78: checks 
*** SHOW DOWN ***
Spud-JCT: shows [8s 7d] (a pair of Eights)
jojoboon78: mucks hand 
Spud-JCT collected $0.95 from pot
*** SUMMARY ***
Total pot $0.99 | Rake $0.04 
Board [8d 6c 4h Jd Qc]
Seat 1: Spud-JCT (small blind) showed [8s 7d] and won ($0.95) with a pair of Eights
Seat 2: lastfox (big blind) folded before Flop
Seat 3: vicman121 folded before Flop (didn't bet)
Seat 4: Kobert72 folded on the Flop
Seat 5: jojoboon78 mucked
Seat 6: FacuLarrocca (button) folded before Flop (didn't bet)



PokerStars Hand #222966506033:  Hold'em No Limit ($0.05/$0.10 USD) - 2021/01/23 14:30:01 ET
Table 'Transvaalia' 6-max Seat #1 is the button
Seat 1: Spud-JCT ($13.85 in chips) 
Seat 2: lastfox ($22.38 in chips) 
Seat 3: vicman121 ($15.03 in chips) 
Seat 4: Kobert72 ($10 in chips) 
Seat 5: jojoboon78 ($12.51 in chips) 
Seat 6: FacuLarrocca ($10 in chips) 
lastfox: posts small blind $0.05
vicman121: posts big blind $0.10
*** HOLE CARDS ***
Kobert72: folds 
jojoboon78: folds 
FacuLarrocca: folds 
Spud-JCT: calls $0.10
lastfox: folds 
vicman121: checks 
*** FLOP *** [5s Ah 6s]
vicman121: checks 
Spud-JCT: checks 
*** TURN *** [5s Ah 6s] [4c]
vicman121: checks 
Spud-JCT: checks 
*** RIVER *** [5s Ah 6s 4c] [4h]
vicman121: checks 
Spud-JCT: checks 
*** SHOW DOWN ***
vicman121: shows [Th 8d] (a pair of Fours)
Spud-JCT: shows [7c 3c] (a straight, Three to Seven)
Spud-JCT collected $0.24 from pot
*** SUMMARY ***
Total pot $0.25 | Rake $0.01 
Board [5s Ah 6s 4c 4h]
Seat 1: Spud-JCT (button) showed [7c 3c] and won ($0.24) with a straight, Three to Seven
Seat 2: lastfox (small blind) folded before Flop
Seat 3: vicman121 (big blind) showed [Th 8d] and lost with a pair of Fours
Seat 4: Kobert72 folded before Flop (didn't bet)
Seat 5: jojoboon78 folded before Flop (didn't bet)
Seat 6: FacuLarrocca folded before Flop (didn't bet)



PokerStars Hand #222966535103:  Hold'em No Limit ($0.05/$0.10 USD) - 2021/01/23 14:30:38 ET
Table 'Transvaalia' 6-max Seat #2 is the button
Seat 1: Spud-JCT ($13.99 in chips) 
Seat 2: lastfox ($22.33 in chips) 
Seat 4: Kobert72 ($10 in chips) 
Seat 5: jojoboon78 ($12.51 in chips) 
Seat 6: FacuLarrocca ($10 in chips) 
Kobert72: posts small blind $0.05
jojoboon78: posts big blind $0.10
*** HOLE CARDS ***
FacuLarrocca: folds 
Spud-JCT: calls $0.10
lastfox: folds 
Kobert72: folds 
jojoboon78: checks 
*** FLOP *** [Jc 7d Ac]
jojoboon78: checks 
Spud-JCT: checks 
*** TURN *** [Jc 7d Ac] [9h]
jojoboon78: checks 
Spud-JCT: checks 
*** RIVER *** [Jc 7d Ac 9h] [9s]
jojoboon78: checks 
Spud-JCT: checks 
*** SHOW DOWN ***
jojoboon78: shows [3c 6d] (a pair of Nines)
Spud-JCT: shows [8s 3s] (a pair of Nines - Ace+Jack+Eight kicker)
Spud-JCT collected $0.24 from pot
*** SUMMARY ***
Total pot $0.25 | Rake $0.01 
Board [Jc 7d Ac 9h 9s]
Seat 1: Spud-JCT showed [8s 3s] and won ($0.24) with a pair of Nines
Seat 2: lastfox (button) folded before Flop (didn't bet)
Seat 4: Kobert72 (small blind) folded before Flop
Seat 5: jojoboon78 (big blind) showed [3c 6d] and lost with a pair of Nines
Seat 6: FacuLarrocca folded before Flop (didn't bet)



PokerStars Hand #222966557469:  Hold'em No Limit ($0.05/$0.10 USD) - 2021/01/23 14:31:06 ET
Table 'Transvaalia' 6-max Seat #4 is the button
Seat 1: Spud-JCT ($14.13 in chips) 
Seat 2: lastfox ($22.33 in chips) 
Seat 4: Kobert72 ($10 in chips) 
Seat 5: jojoboon78 ($12.41 in chips) 
Seat 6: FacuLarrocca ($10 in chips) 
jojoboon78: posts small blind $0.05
FacuLarrocca: posts big blind $0.10
*** HOLE CARDS ***
Spud-JCT: calls $0.10
lastfox: folds 
Kobert72: folds 
jojoboon78: calls $0.05
FacuLarrocca: checks 
*** FLOP *** [Qc 9s Td]
jojoboon78: checks 
FacuLarrocca: checks 
Spud-JCT: checks 
*** TURN *** [Qc 9s Td] [5d]
jojoboon78: bets $0.19
FacuLarrocca: folds 
Spud-JCT: calls $0.19
*** RIVER *** [Qc 9s Td 5d] [As]
jojoboon78: checks 
Spud-JCT: checks 
*** SHOW DOWN ***
jojoboon78: shows [Qs 8h] (a pair of Queens)
Spud-JCT: mucks hand 
jojoboon78 collected $0.65 from pot
*** SUMMARY ***
Total pot $0.68 | Rake $0.03 
Board [Qc 9s Td 5d As]
Seat 1: Spud-JCT mucked
Seat 2: lastfox folded before Flop (didn't bet)
Seat 4: Kobert72 (button) folded before Flop (didn't bet)
Seat 5: jojoboon78 (small blind) showed [Qs 8h] and won ($0.65) with a pair of Queens
Seat 6: FacuLarrocca (big blind) folded on the Turn



PokerStars Hand #222966585820:  Hold'em No Limit ($0.05/$0.10 USD) - 2021/01/23 14:31:42 ET
Table 'Transvaalia' 6-max Seat #5 is the button
Seat 1: Spud-JCT ($13.84 in chips) 
Seat 2: lastfox ($22.33 in chips) 
Seat 4: Kobert72 ($10 in chips) 
Seat 5: jojoboon78 ($12.77 in chips) 
Seat 6: FacuLarrocca ($10 in chips) 
FacuLarrocca: posts small blind $0.05
Spud-JCT: posts big blind $0.10
vicman121: sits out 
*** HOLE CARDS ***
lastfox: folds 
Kobert72: folds 
jojoboon78: raises $0.15 to $0.25
FacuLarrocca: folds 
Spud-JCT: calls $0.15
*** FLOP *** [7c Qs 8s]
Spud-JCT: checks 
jojoboon78: bets $0.27
Spud-JCT: calls $0.27
*** TURN *** [7c Qs 8s] [9h]
Spud-JCT: checks 
jojoboon78: checks 
*** RIVER *** [7c Qs 8s 9h] [6d]
Spud-JCT: checks 
jojoboon78: checks 
*** SHOW DOWN ***
Spud-JCT: shows [Th Qd] (a straight, Six to Ten)
jojoboon78: mucks hand 
Spud-JCT collected $1.04 from pot
*** SUMMARY ***
Total pot $1.09 | Rake $0.05 
Board [7c Qs 8s 9h 6d]
Seat 1: Spud-JCT (big blind) showed [Th Qd] and won ($1.04) with a straight, Six to Ten
Seat 2: lastfox folded before Flop (didn't bet)
Seat 4: Kobert72 folded before Flop (didn't bet)
Seat 5: jojoboon78 (button) mucked
Seat 6: FacuLarrocca (small blind) folded before Flop



PokerStars Hand #222966622962:  Hold'em No Limit ($0.05/$0.10 USD) - 2021/01/23 14:32:30 ET
Table 'Transvaalia' 6-max Seat #6 is the button
Seat 1: Spud-JCT ($14.36 in chips) 
Seat 2: lastfox ($22.33 in chips) 
Seat 3: vicman121 ($14.93 in chips) 
Seat 4: Kobert72 ($10 in chips) 
Seat 5: jojoboon78 ($12.25 in chips) 
Seat 6: FacuLarrocca ($10 in chips) 
Spud-JCT: posts small blind $0.05
lastfox: posts big blind $0.10
vicman121: posts small blind $0.05
*** HOLE CARDS ***
vicman121: folds 
Kobert72: folds 
jojoboon78: folds 
FacuLarrocca: raises $0.15 to $0.25
Spud-JCT: calls $0.20
lastfox: raises $0.97 to $1.22
FacuLarrocca: folds 
Spud-JCT: calls $0.97
*** FLOP *** [4s 7d 6d]
Spud-JCT: checks 
lastfox: checks 
*** TURN *** [4s 7d 6d] [Jc]
Spud-JCT: checks 
lastfox: checks 
*** RIVER *** [4s 7d 6d Jc] [Th]
Spud-JCT: checks 
lastfox: checks 
*** SHOW DOWN ***
Spud-JCT: shows [Qd Kd] (high card King)
lastfox: shows [As 3s] (high card Ace)
lastfox collected $2.62 from pot
*** SUMMARY ***
Total pot $2.74 | Rake $0.12 
Board [4s 7d 6d Jc Th]
Seat 1: Spud-JCT (small blind) showed [Qd Kd] and lost with high card King
Seat 2: lastfox (big blind) showed [As 3s] and won ($2.62) with high card Ace
Seat 3: vicman121 folded before Flop (didn't bet)
Seat 4: Kobert72 folded before Flop (didn't bet)
Seat 5: jojoboon78 folded before Flop (didn't bet)
Seat 6: FacuLarrocca (button) folded before Flop



PokerStars Hand #222966659061:  Hold'em No Limit ($0.05/$0.10 USD) - 2021/01/23 14:33:16 ET
Table 'Transvaalia' 6-max Seat #1 is the button
Seat 1: Spud-JCT ($13.14 in chips) 
Seat 2: lastfox ($23.73 in chips) 
Seat 3: vicman121 ($14.88 in chips) 
Seat 4: Kobert72 ($10 in chips) 
Seat 5: jojoboon78 ($12.25 in chips) 
Seat 6: FacuLarrocca ($10 in chips) 
lastfox: posts small blind $0.05
vicman121: posts big blind $0.10
*** HOLE CARDS ***
Kobert72: folds 
jojoboon78: folds 
FacuLarrocca: folds 
Spud-JCT: calls $0.10
lastfox: folds 
vicman121: raises $0.40 to $0.50
Spud-JCT: calls $0.40
*** FLOP *** [Js 4c 4h]
vicman121: bets $0.30
Spud-JCT: calls $0.30
*** TURN *** [Js 4c 4h] [7c]
vicman121: checks 
Spud-JCT: checks 
*** RIVER *** [Js 4c 4h 7c] [7d]
vicman121: checks 
Spud-JCT: checks 
*** SHOW DOWN ***
vicman121: shows [Ad Qd] (two pair, Sevens and Fours)
Spud-JCT: mucks hand 
vicman121 collected $1.58 from pot
*** SUMMARY ***
Total pot $1.65 | Rake $0.07 
Board [Js 4c 4h 7c 7d]
Seat 1: Spud-JCT (button) mucked
Seat 2: lastfox (small blind) folded before Flop
Seat 3: vicman121 (big blind) showed [Ad Qd] and won ($1.58) with two pair, Sevens and Fours
Seat 4: Kobert72 folded before Flop (didn't bet)
Seat 5: jojoboon78 folded before Flop (didn't bet)
Seat 6: FacuLarrocca folded before Flop (didn't bet)



PokerStars Hand #222966695814:  Hold'em No Limit ($0.05/$0.10 USD) - 2021/01/23 14:34:03 ET
Table 'Transvaalia' 6-max Seat #2 is the button
Seat 1: Spud-JCT ($12.34 in chips) 
Seat 2: lastfox ($23.68 in chips) 
Seat 3: vicman121 ($15.66 in chips) 
Seat 4: Kobert72 ($10 in chips) 
Seat 5: jojoboon78 ($12.25 in chips) 
Seat 6: FacuLarrocca ($10 in chips) 
vicman121: posts small blind $0.05
Kobert72: posts big blind $0.10
*** HOLE CARDS ***
jojoboon78: folds 
FacuLarrocca: folds 
Spud-JCT: folds 
lastfox: raises $0.13 to $0.23
vicman121: folds 
Kobert72: folds 
Uncalled bet ($0.13) returned to lastfox
lastfox collected $0.25 from pot
lastfox: doesn't show hand 
*** SUMMARY ***
Total pot $0.25 | Rake $0 
Seat 1: Spud-JCT folded before Flop (didn't bet)
Seat 2: lastfox (button) collected ($0.25)
Seat 3: vicman121 (small blind) folded before Flop
Seat 4: Kobert72 (big blind) folded before Flop
Seat 5: jojoboon78 folded before Flop (didn't bet)
Seat 6: FacuLarrocca folded before Flop (didn't bet)



PokerStars Hand #222966715084:  Hold'em No Limit ($0.05/$0.10 USD) - 2021/01/23 14:34:27 ET
Table 'Transvaalia' 6-max Seat #3 is the button
Seat 1: Spud-JCT ($12.34 in chips) 
Seat 2: lastfox ($23.83 in chips) 
Seat 3: vicman121 ($15.61 in chips) 
Seat 4: Kobert72 ($10 in chips) 
Seat 5: jojoboon78 ($12.25 in chips) 
Seat 6: FacuLarrocca ($10 in chips) 
Kobert72: posts small blind $0.05
jojoboon78: posts big blind $0.10
*** HOLE CARDS ***
FacuLarrocca: raises $0.20 to $0.30
Spud-JCT: calls $0.30
lastfox: folds 
vicman121: folds 
Kobert72: folds 
jojoboon78: calls $0.20
*** FLOP *** [Td 7s 6c]
jojoboon78: checks 
FacuLarrocca: checks 
Spud-JCT: checks 
*** TURN *** [Td 7s 6c] [2d]
jojoboon78: checks 
FacuLarrocca: checks 
Spud-JCT: checks 
*** RIVER *** [Td 7s 6c 2d] [8c]
jojoboon78: checks 
FacuLarrocca: checks 
Spud-JCT: checks 
*** SHOW DOWN ***
jojoboon78: shows [Qh 3h] (high card Queen)
FacuLarrocca: shows [Kd As] (high card Ace)
Spud-JCT: mucks hand 
FacuLarrocca collected $0.91 from pot
*** SUMMARY ***
Total pot $0.95 | Rake $0.04 
Board [Td 7s 6c 2d 8c]
Seat 1: Spud-JCT mucked
Seat 2: lastfox folded before Flop (didn't bet)
Seat 3: vicman121 (button) folded before Flop (didn't bet)
Seat 4: Kobert72 (small blind) folded before Flop
Seat 5: jojoboon78 (big blind) showed [Qh 3h] and lost with high card Queen
Seat 6: FacuLarrocca showed [Kd As] and won ($0.91) with high card Ace



PokerStars Hand #222966747053:  Hold'em No Limit ($0.05/$0.10 USD) - 2021/01/23 14:35:08 ET
Table 'Transvaalia' 6-max Seat #4 is the button
Seat 1: Spud-JCT ($12.04 in chips) 
Seat 2: lastfox ($23.83 in chips) 
Seat 3: vicman121 ($15.61 in chips) 
Seat 4: Kobert72 ($10 in chips) 
Seat 5: jojoboon78 ($11.95 in chips) 
Seat 6: FacuLarrocca ($10.61 in chips) 
jojoboon78: posts small blind $0.05
FacuLarrocca: posts big blind $0.10
*** HOLE CARDS ***
Spud-JCT: calls $0.10
lastfox: raises $0.25 to $0.35
vicman121: folds 
Kobert72: folds 
jojoboon78: raises $0.45 to $0.80
FacuLarrocca: folds 
Spud-JCT: calls $0.70
lastfox: calls $0.45
*** FLOP *** [9c 5d 3c]
jojoboon78: bets $1.20
Spud-JCT: folds 
lastfox: folds 
Uncalled bet ($1.20) returned to jojoboon78
jojoboon78 collected $2.39 from pot
jojoboon78: doesn't show hand 
*** SUMMARY ***
Total pot $2.50 | Rake $0.11 
Board [9c 5d 3c]
Seat 1: Spud-JCT folded on the Flop
Seat 2: lastfox folded on the Flop
Seat 3: vicman121 folded before Flop (didn't bet)
Seat 4: Kobert72 (button) folded before Flop (didn't bet)
Seat 5: jojoboon78 (small blind) collected ($2.39)
Seat 6: FacuLarrocca (big blind) folded before Flop



PokerStars Hand #222966784275:  Hold'em No Limit ($0.05/$0.10 USD) - 2021/01/23 14:35:56 ET
Table 'Transvaalia' 6-max Seat #5 is the button
Seat 1: Spud-JCT ($11.24 in chips) 
Seat 2: lastfox ($23.03 in chips) 
Seat 3: vicman121 ($15.61 in chips) 
Seat 4: Kobert72 ($10 in chips) 
Seat 5: jojoboon78 ($13.54 in chips) 
Seat 6: FacuLarrocca ($10.51 in chips) 
FacuLarrocca: posts small blind $0.05
Spud-JCT: posts big blind $0.10
*** HOLE CARDS ***
lastfox: folds 
vicman121: raises $0.20 to $0.30
Kobert72: folds 
jojoboon78: folds 
FacuLarrocca: folds 
Spud-JCT: calls $0.20
*** FLOP *** [3h Ac 6s]
Spud-JCT: checks 
vicman121: bets $0.19
Spud-JCT: folds 
Uncalled bet ($0.19) returned to vicman121
vicman121 collected $0.62 from pot
vicman121: doesn't show hand 
*** SUMMARY ***
Total pot $0.65 | Rake $0.03 
Board [3h Ac 6s]
Seat 1: Spud-JCT (big blind) folded on the Flop
Seat 2: lastfox folded before Flop (didn't bet)
Seat 3: vicman121 collected ($0.62)
Seat 4: Kobert72 folded before Flop (didn't bet)
Seat 5: jojoboon78 (button) folded before Flop (didn't bet)
Seat 6: FacuLarrocca (small blind) folded before Flop



PokerStars Hand #222966814407:  Hold'em No Limit ($0.05/$0.10 USD) - 2021/01/23 14:36:34 ET
Table 'Transvaalia' 6-max Seat #6 is the button
Seat 1: Spud-JCT ($10.94 in chips) 
Seat 2: lastfox ($23.03 in chips) 
Seat 3: vicman121 ($15.93 in chips) 
Seat 4: Kobert72 ($10 in chips) 
Seat 5: jojoboon78 ($13.54 in chips) 
Seat 6: FacuLarrocca ($10.46 in chips) 
Spud-JCT: posts small blind $0.05
lastfox: posts big blind $0.10
*** HOLE CARDS ***
vicman121: folds 
Kobert72: folds 
jojoboon78: raises $0.15 to $0.25
FacuLarrocca: folds 
Spud-JCT: calls $0.20
lastfox: calls $0.15
*** FLOP *** [4c 2h 3c]
Spud-JCT: checks 
lastfox: bets $0.48
jojoboon78: folds 
Spud-JCT: calls $0.48
*** TURN *** [4c 2h 3c] [Kh]
Spud-JCT: checks 
lastfox: checks 
*** RIVER *** [4c 2h 3c Kh] [6s]
Spud-JCT: bets $0.50
lastfox: raises $4.85 to $5.35
Spud-JCT: folds 
Uncalled bet ($4.85) returned to lastfox
lastfox collected $2.59 from pot
lastfox: doesn't show hand 
*** SUMMARY ***
Total pot $2.71 | Rake $0.12 
Board [4c 2h 3c Kh 6s]
Seat 1: Spud-JCT (small blind) folded on the River
Seat 2: lastfox (big blind) collected ($2.59)
Seat 3: vicman121 folded before Flop (didn't bet)
Seat 4: Kobert72 folded before Flop (didn't bet)
Seat 5: jojoboon78 folded on the Flop
Seat 6: FacuLarrocca (button) folded before Flop (didn't bet)



PokerStars Hand #222966885962:  Hold'em No Limit ($0.05/$0.10 USD) - 2021/01/23 14:38:05 ET
Table 'Transvaalia' 6-max Seat #1 is the button
Seat 1: Spud-JCT ($9.71 in chips) 
Seat 2: lastfox ($24.39 in chips) 
Seat 3: vicman121 ($15.93 in chips) 
Seat 4: Kobert72 ($10 in chips) 
Seat 5: jojoboon78 ($13.29 in chips) 
Seat 6: FacuLarrocca ($10.46 in chips) 
lastfox: posts small blind $0.05
vicman121: posts big blind $0.10
*** HOLE CARDS ***
Kobert72: folds 
jojoboon78: folds 
FacuLarrocca: raises $0.20 to $0.30
Spud-JCT: calls $0.30
lastfox: folds 
vicman121: folds 
*** FLOP *** [5c Jc Ks]
FacuLarrocca: checks 
Spud-JCT: checks 
*** TURN *** [5c Jc Ks] [2h]
FacuLarrocca: bets $0.54
Spud-JCT: calls $0.54
*** RIVER *** [5c Jc Ks 2h] [Qs]
FacuLarrocca: bets $2.63
Spud-JCT: calls $2.63
*** SHOW DOWN ***
FacuLarrocca: shows [Kh Kc] (three of a kind, Kings)
Spud-JCT: mucks hand 
FacuLarrocca collected $6.77 from pot
*** SUMMARY ***
Total pot $7.09 | Rake $0.32 
Board [5c Jc Ks 2h Qs]
Seat 1: Spud-JCT (button) mucked
Seat 2: lastfox (small blind) folded before Flop
Seat 3: vicman121 (big blind) folded before Flop
Seat 4: Kobert72 folded before Flop (didn't bet)
Seat 5: jojoboon78 folded before Flop (didn't bet)
Seat 6: FacuLarrocca showed [Kh Kc] and won ($6.77) with three of a kind, Kings



PokerStars Hand #222966914694:  Hold'em No Limit ($0.05/$0.10 USD) - 2021/01/23 14:38:42 ET
Table 'Transvaalia' 6-max Seat #2 is the button
Seat 1: Spud-JCT ($6.24 in chips) 
Seat 2: lastfox ($24.34 in chips) 
Seat 3: vicman121 ($15.83 in chips) 
Seat 4: Kobert72 ($10 in chips) 
Seat 5: jojoboon78 ($13.29 in chips) 
Seat 6: FacuLarrocca ($13.76 in chips) 
vicman121: posts small blind $0.05
Kobert72: posts big blind $0.10
*** HOLE CARDS ***
jojoboon78: folds 
FacuLarrocca: folds 
Spud-JCT: folds 
lastfox: raises $0.13 to $0.23
vicman121: folds 
Kobert72: calls $0.13
*** FLOP *** [7c 4s Kd]
Kobert72: checks 
lastfox: checks 
*** TURN *** [7c 4s Kd] [9d]
Kobert72: checks 
lastfox: bets $0.33
Kobert72: calls $0.33
*** RIVER *** [7c 4s Kd 9d] [Ts]
Kobert72: checks 
lastfox: checks 
*** SHOW DOWN ***
Kobert72: shows [8d 9h] (a pair of Nines)
lastfox: shows [8s 9s] (a pair of Nines)
Kobert72 collected $0.56 from pot
lastfox collected $0.56 from pot
*** SUMMARY ***
Total pot $1.17 | Rake $0.05 
Board [7c 4s Kd 9d Ts]
Seat 1: Spud-JCT folded before Flop (didn't bet)
Seat 2: lastfox (button) showed [8s 9s] and won ($0.56) with a pair of Nines
Seat 3: vicman121 (small blind) folded before Flop
Seat 4: Kobert72 (big blind) showed [8d 9h] and won ($0.56) with a pair of Nines
Seat 5: jojoboon78 folded before Flop (didn't bet)
Seat 6: FacuLarrocca folded before Flop (didn't bet)



PokerStars Hand #222966966751:  Hold'em No Limit ($0.05/$0.10 USD) - 2021/01/23 14:39:49 ET
Table 'Transvaalia' 6-max Seat #3 is the button
Seat 1: Spud-JCT ($6.24 in chips) 
Seat 2: lastfox ($24.34 in chips) 
Seat 3: vicman121 ($15.78 in chips) 
Seat 4: Kobert72 ($10 in chips) 
Seat 5: jojoboon78 ($13.29 in chips) 
Seat 6: FacuLarrocca ($13.76 in chips) 
Kobert72: posts small blind $0.05
jojoboon78: posts big blind $0.10
*** HOLE CARDS ***
FacuLarrocca: folds 
Spud-JCT: folds 
lastfox: folds 
vicman121 has timed out
vicman121: folds 
Kobert72: folds 
Uncalled bet ($0.05) returned to jojoboon78
jojoboon78 collected $0.10 from pot
jojoboon78: doesn't show hand 
*** SUMMARY ***
Total pot $0.10 | Rake $0 
Seat 1: Spud-JCT folded before Flop (didn't bet)
Seat 2: lastfox folded before Flop (didn't bet)
Seat 3: vicman121 (button) folded before Flop (didn't bet)
Seat 4: Kobert72 (small blind) folded before Flop
Seat 5: jojoboon78 (big blind) collected ($0.10)
Seat 6: FacuLarrocca folded before Flop (didn't bet)



PokerStars Hand #222966985466:  Hold'em No Limit ($0.05/$0.10 USD) - 2021/01/23 14:40:12 ET
Table 'Transvaalia' 6-max Seat #4 is the button
Seat 1: Spud-JCT ($6.24 in chips) 
Seat 2: lastfox ($24.34 in chips) 
Seat 4: Kobert72 ($10 in chips) 
Seat 5: jojoboon78 ($13.34 in chips) 
Seat 6: FacuLarrocca ($13.76 in chips) 
jojoboon78: posts small blind $0.05
FacuLarrocca: posts big blind $0.10
*** HOLE CARDS ***
Spud-JCT: calls $0.10
lastfox: folds 
Kobert72: folds 
jojoboon78: calls $0.05
FacuLarrocca: checks 
*** FLOP *** [6d Kd 2d]
jojoboon78: bets $0.19
FacuLarrocca: folds 
Spud-JCT: folds 
Uncalled bet ($0.19) returned to jojoboon78
jojoboon78 collected $0.29 from pot
jojoboon78: doesn't show hand 
*** SUMMARY ***
Total pot $0.30 | Rake $0.01 
Board [6d Kd 2d]
Seat 1: Spud-JCT folded on the Flop
Seat 2: lastfox folded before Flop (didn't bet)
Seat 4: Kobert72 (button) folded before Flop (didn't bet)
Seat 5: jojoboon78 (small blind) collected ($0.29)
Seat 6: FacuLarrocca (big blind) folded on the Flop



PokerStars Hand #222967004406:  Hold'em No Limit ($0.05/$0.10 USD) - 2021/01/23 14:40:37 ET
Table 'Transvaalia' 6-max Seat #5 is the button
Seat 1: Spud-JCT ($6.14 in chips) 
Seat 2: lastfox ($24.34 in chips) 
Seat 3: vicman121 ($15.78 in chips) 
Seat 4: Kobert72 ($10 in chips) 
Seat 5: jojoboon78 ($13.53 in chips) 
Seat 6: FacuLarrocca ($13.66 in chips) 
FacuLarrocca: posts small blind $0.05
Spud-JCT: posts big blind $0.10
*** HOLE CARDS ***
lastfox: folds 
vicman121: folds 
Kobert72: folds 
jojoboon78: raises $0.15 to $0.25
FacuLarrocca: folds 
Spud-JCT: calls $0.15
*** FLOP *** [9d 7c Ts]
Spud-JCT: checks 
jojoboon78: bets $0.27
Spud-JCT: calls $0.27
*** TURN *** [9d 7c Ts] [Ad]
Spud-JCT: checks 
jojoboon78: bets $0.52
Spud-JCT: calls $0.52
*** RIVER *** [9d 7c Ts Ad] [2d]
Spud-JCT: bets $1.01
jojoboon78: calls $1.01
*** SHOW DOWN ***
Spud-JCT: shows [Js Ac] (a pair of Aces)
jojoboon78: shows [Jd 8d] (a flush, Ace high)
jojoboon78 collected $3.96 from pot
*** SUMMARY ***
Total pot $4.15 | Rake $0.19 
Board [9d 7c Ts Ad 2d]
Seat 1: Spud-JCT (big blind) showed [Js Ac] and lost with a pair of Aces
Seat 2: lastfox folded before Flop (didn't bet)
Seat 3: vicman121 folded before Flop (didn't bet)
Seat 4: Kobert72 folded before Flop (didn't bet)
Seat 5: jojoboon78 (button) showed [Jd 8d] and won ($3.96) with a flush, Ace high
Seat 6: FacuLarrocca (small blind) folded before Flop



PokerStars Hand #222967045350:  Hold'em No Limit ($0.05/$0.10 USD) - 2021/01/23 14:41:29 ET
Table 'Transvaalia' 6-max Seat #6 is the button
Seat 1: Spud-JCT ($4.09 in chips) 
Seat 2: lastfox ($24.34 in chips) 
Seat 3: vicman121 ($15.78 in chips) 
Seat 4: Kobert72 ($10 in chips) 
Seat 5: jojoboon78 ($15.44 in chips) 
Seat 6: FacuLarrocca ($13.61 in chips) 
Spud-JCT: posts small blind $0.05
lastfox: posts big blind $0.10
*** HOLE CARDS ***
vicman121: folds 
Kobert72: folds 
jojoboon78: raises $0.15 to $0.25
FacuLarrocca: folds 
Spud-JCT: calls $0.20
lastfox: calls $0.15
*** FLOP *** [Th Qh Jc]
Spud-JCT: checks 
lastfox: checks 
jojoboon78: bets $0.36
Spud-JCT: folds 
lastfox: raises $1.08 to $1.44
jojoboon78: folds 
Uncalled bet ($1.08) returned to lastfox
lastfox collected $1.40 from pot
lastfox: doesn't show hand 
*** SUMMARY ***
Total pot $1.47 | Rake $0.07 
Board [Th Qh Jc]
Seat 1: Spud-JCT (small blind) folded on the Flop
Seat 2: lastfox (big blind) collected ($1.40)
Seat 3: vicman121 folded before Flop (didn't bet)
Seat 4: Kobert72 folded before Flop (didn't bet)
Seat 5: jojoboon78 folded on the Flop
Seat 6: FacuLarrocca (button) folded before Flop (didn't bet)



PokerStars Hand #222967078982:  Hold'em No Limit ($0.05/$0.10 USD) - 2021/01/23 14:42:12 ET
Table 'Transvaalia' 6-max Seat #1 is the button
Seat 1: Spud-JCT ($3.84 in chips) 
Seat 2: lastfox ($25.13 in chips) 
Seat 3: vicman121 ($15.78 in chips) 
Seat 4: Kobert72 ($10 in chips) 
Seat 5: jojoboon78 ($14.83 in chips) 
Seat 6: FacuLarrocca ($13.61 in chips) 
lastfox: posts small blind $0.05
vicman121: posts big blind $0.10
*** HOLE CARDS ***
Kobert72: folds 
jojoboon78: folds 
FacuLarrocca: folds 
Spud-JCT: folds 
lastfox: folds 
Uncalled bet ($0.05) returned to vicman121
vicman121 collected $0.10 from pot
vicman121: doesn't show hand 
*** SUMMARY ***
Total pot $0.10 | Rake $0 
Seat 1: Spud-JCT (button) folded before Flop (didn't bet)
Seat 2: lastfox (small blind) folded before Flop
Seat 3: vicman121 (big blind) collected ($0.10)
Seat 4: Kobert72 folded before Flop (didn't bet)
Seat 5: jojoboon78 folded before Flop (didn't bet)
Seat 6: FacuLarrocca folded before Flop (didn't bet)



PokerStars Hand #222967084416:  Hold'em No Limit ($0.05/$0.10 USD) - 2021/01/23 14:42:19 ET
Table 'Transvaalia' 6-max Seat #2 is the button
Seat 1: Spud-JCT ($3.84 in chips) 
Seat 2: lastfox ($25.08 in chips) 
Seat 3: vicman121 ($15.83 in chips) 
Seat 4: Kobert72 ($10 in chips) 
Seat 5: jojoboon78 ($14.83 in chips) 
Seat 6: FacuLarrocca ($13.61 in chips) 
vicman121: posts small blind $0.05
Kobert72: posts big blind $0.10
*** HOLE CARDS ***
jojoboon78: folds 
FacuLarrocca: raises $0.20 to $0.30
Spud-JCT: calls $0.30
lastfox: folds 
vicman121: folds 
Kobert72: folds 
*** FLOP *** [Jc 4d 7h]
FacuLarrocca: bets $0.36
Spud-JCT: folds 
Uncalled bet ($0.36) returned to FacuLarrocca
FacuLarrocca collected $0.72 from pot
FacuLarrocca: doesn't show hand 
*** SUMMARY ***
Total pot $0.75 | Rake $0.03 
Board [Jc 4d 7h]
Seat 1: Spud-JCT folded on the Flop
Seat 2: lastfox (button) folded before Flop (didn't bet)
Seat 3: vicman121 (small blind) folded before Flop
Seat 4: Kobert72 (big blind) folded before Flop
Seat 5: jojoboon78 folded before Flop (didn't bet)
Seat 6: FacuLarrocca collected ($0.72)



PokerStars Hand #222967103692:  Hold'em No Limit ($0.05/$0.10 USD) - 2021/01/23 14:42:44 ET
Table 'Transvaalia' 6-max Seat #3 is the button
Seat 1: Spud-JCT ($3.54 in chips) 
Seat 2: lastfox ($25.08 in chips) 
Seat 3: vicman121 ($15.78 in chips) 
Seat 4: Kobert72 ($10 in chips) 
Seat 5: jojoboon78 ($14.83 in chips) 
Seat 6: FacuLarrocca ($14.03 in chips) 
Kobert72: posts small blind $0.05
jojoboon78: posts big blind $0.10
*** HOLE CARDS ***
FacuLarrocca: folds 
Spud-JCT: calls $0.10
lastfox: folds 
vicman121: folds 
Kobert72: folds 
jojoboon78: raises $0.20 to $0.30
Spud-JCT: calls $0.20
*** FLOP *** [Qs 9h 9s]
jojoboon78: bets $0.31
Spud-JCT: raises $0.31 to $0.62
jojoboon78: calls $0.31
*** TURN *** [Qs 9h 9s] [7d]
jojoboon78: checks 
Spud-JCT: checks 
*** RIVER *** [Qs 9h 9s 7d] [4h]
jojoboon78: bets $1.20
Spud-JCT: calls $1.20
*** SHOW DOWN ***
jojoboon78: shows [9c 8c] (three of a kind, Nines)
Spud-JCT: mucks hand 
jojoboon78 collected $4.10 from pot
*** SUMMARY ***
Total pot $4.29 | Rake $0.19 
Board [Qs 9h 9s 7d 4h]
Seat 1: Spud-JCT mucked
Seat 2: lastfox folded before Flop (didn't bet)
Seat 3: vicman121 (button) folded before Flop (didn't bet)
Seat 4: Kobert72 (small blind) folded before Flop
Seat 5: jojoboon78 (big blind) showed [9c 8c] and won ($4.10) with three of a kind, Nines
Seat 6: FacuLarrocca folded before Flop (didn't bet)



PokerStars Hand #222967139292:  Hold'em No Limit ($0.05/$0.10 USD) - 2021/01/23 14:43:29 ET
Table 'Transvaalia' 6-max Seat #4 is the button
Seat 1: Spud-JCT ($1.42 in chips) 
Seat 2: lastfox ($25.08 in chips) 
Seat 3: vicman121 ($15.78 in chips) 
Seat 4: Kobert72 ($10 in chips) 
Seat 5: jojoboon78 ($16.81 in chips) 
Seat 6: FacuLarrocca ($14.03 in chips) 
jojoboon78: posts small blind $0.05
FacuLarrocca: posts big blind $0.10
*** HOLE CARDS ***
Spud-JCT: raises $1.32 to $1.42 and is all-in
lastfox: raises $2.63 to $4.05
vicman121: folds 
Kobert72: folds 
jojoboon78: folds 
FacuLarrocca: folds 
Uncalled bet ($2.63) returned to lastfox
*** FLOP *** [7h Ac Ks]
*** TURN *** [7h Ac Ks] [Qs]
*** RIVER *** [7h Ac Ks Qs] [2h]
*** SHOW DOWN ***
Spud-JCT: shows [Jc 9d] (high card Ace)
lastfox: shows [Kd Qd] (two pair, Kings and Queens)
lastfox collected $2.86 from pot
*** SUMMARY ***
Total pot $2.99 | Rake $0.13 
Board [7h Ac Ks Qs 2h]
Seat 1: Spud-JCT showed [Jc 9d] and lost with high card Ace
Seat 2: lastfox showed [Kd Qd] and won ($2.86) with two pair, Kings and Queens
Seat 3: vicman121 folded before Flop (didn't bet)
Seat 4: Kobert72 (button) folded before Flop (didn't bet)
Seat 5: jojoboon78 (small blind) folded before Flop
Seat 6: FacuLarrocca (big blind) folded before Flop



PokerStars Hand #222967166747:  Hold'em No Limit ($0.05/$0.10 USD) - 2021/01/23 14:44:04 ET
Table 'Transvaalia' 6-max Seat #5 is the button
Seat 2: lastfox ($26.52 in chips) 
Seat 3: vicman121 ($15.78 in chips) 
Seat 4: Kobert72 ($10 in chips) 
Seat 5: jojoboon78 ($16.76 in chips) 
Seat 6: FacuLarrocca ($13.93 in chips) 
FacuLarrocca: posts small blind $0.05
lastfox: posts big blind $0.10
*** HOLE CARDS ***
vicman121: raises $0.20 to $0.30
Kobert72: folds 
jojoboon78: folds 
FacuLarrocca: folds 
lastfox: folds 
Uncalled bet ($0.20) returned to vicman121
vicman121 collected $0.25 from pot
vicman121: doesn't show hand 
*** SUMMARY ***
Total pot $0.25 | Rake $0 
Seat 2: lastfox (big blind) folded before Flop
Seat 3: vicman121 collected ($0.25)
Seat 4: Kobert72 folded before Flop (didn't bet)
Seat 5: jojoboon78 (button) folded before Flop (didn't bet)
Seat 6: FacuLarrocca (small blind) folded before Flop



PokerStars Hand #222967184526:  Hold'em No Limit ($0.05/$0.10 USD) - 2021/01/23 14:44:27 ET
Table 'Transvaalia' 6-max Seat #6 is the button
Seat 2: lastfox ($26.42 in chips) 
Seat 3: vicman121 ($15.93 in chips) 
Seat 4: Kobert72 ($10 in chips) 
Seat 5: jojoboon78 ($16.76 in chips) 
Seat 6: FacuLarrocca ($13.88 in chips) 
lastfox: posts small blind $0.05
vicman121: posts big blind $0.10
*** HOLE CARDS ***
Kobert72: folds 
jojoboon78: folds 
FacuLarrocca: raises $0.15 to $0.25
lastfox: raises $0.75 to $1
vicman121: folds 
FacuLarrocca: folds 
Uncalled bet ($0.75) returned to lastfox
lastfox collected $0.60 from pot
lastfox: doesn't show hand 
*** SUMMARY ***
Total pot $0.60 | Rake $0 
Seat 2: lastfox (small blind) collected ($0.60)
Seat 3: vicman121 (big blind) folded before Flop
Seat 4: Kobert72 folded before Flop (didn't bet)
Seat 5: jojoboon78 folded before Flop (didn't bet)
Seat 6: FacuLarrocca (button) folded before Flop



PokerStars Hand #222967203086:  Hold'em No Limit ($0.05/$0.10 USD) - 2021/01/23 14:44:51 ET
Table 'Transvaalia' 6-max Seat #2 is the button
Seat 1: Spud-JCT ($10 in chips) 
Seat 2: lastfox ($26.77 in chips) 
Seat 3: vicman121 ($15.83 in chips) 
Seat 4: Kobert72 ($10 in chips) 
Seat 5: jojoboon78 ($16.76 in chips) 
Seat 6: FacuLarrocca ($13.63 in chips) 
vicman121: posts small blind $0.05
Kobert72: posts big blind $0.10
Spud-JCT: posts small & big blinds $0.15
*** HOLE CARDS ***
jojoboon78: folds 
FacuLarrocca: folds 
Spud-JCT: checks 
lastfox: folds 
vicman121: folds 
Kobert72: checks 
*** FLOP *** [3d Jc 7s]
Kobert72: checks 
Spud-JCT: checks 
*** TURN *** [3d Jc 7s] [4h]
Kobert72: checks 
Spud-JCT: checks 
*** RIVER *** [3d Jc 7s 4h] [6d]
Kobert72: checks 
Spud-JCT: bets $0.50
Kobert72: folds 
Uncalled bet ($0.50) returned to Spud-JCT
Spud-JCT collected $0.29 from pot
Spud-JCT: doesn't show hand 
*** SUMMARY ***
Total pot $0.30 | Rake $0.01 
Board [3d Jc 7s 4h 6d]
Seat 1: Spud-JCT collected ($0.29)
Seat 2: lastfox (button) folded before Flop (didn't bet)
Seat 3: vicman121 (small blind) folded before Flop
Seat 4: Kobert72 (big blind) folded on the River
Seat 5: jojoboon78 folded before Flop (didn't bet)
Seat 6: FacuLarrocca folded before Flop (didn't bet)



PokerStars Hand #222967245141:  Hold'em No Limit ($0.05/$0.10 USD) - 2021/01/23 14:45:45 ET
Table 'Transvaalia' 6-max Seat #3 is the button
Seat 1: Spud-JCT ($10.14 in chips) 
Seat 2: lastfox ($26.77 in chips) 
Seat 3: vicman121 ($15.78 in chips) 
Seat 4: Kobert72 ($10 in chips) 
Seat 5: jojoboon78 ($16.76 in chips) 
Seat 6: FacuLarrocca ($13.63 in chips) 
Kobert72: posts small blind $0.05
jojoboon78: posts big blind $0.10
*** HOLE CARDS ***
FacuLarrocca: folds 
Spud-JCT: calls $0.10
lastfox: folds 
vicman121: folds 
Kobert72: folds 
jojoboon78: checks 
*** FLOP *** [2s 6s Ts]
jojoboon78: checks 
Spud-JCT: bets $0.10
jojoboon78: folds 
Uncalled bet ($0.10) returned to Spud-JCT
Spud-JCT collected $0.24 from pot
Spud-JCT: doesn't show hand 
*** SUMMARY ***
Total pot $0.25 | Rake $0.01 
Board [2s 6s Ts]
Seat 1: Spud-JCT collected ($0.24)
Seat 2: lastfox folded before Flop (didn't bet)
Seat 3: vicman121 (button) folded before Flop (didn't bet)
Seat 4: Kobert72 (small blind) folded before Flop
Seat 5: jojoboon78 (big blind) folded on the Flop
Seat 6: FacuLarrocca folded before Flop (didn't bet)



PokerStars Hand #222967264444:  Hold'em No Limit ($0.05/$0.10 USD) - 2021/01/23 14:46:10 ET
Table 'Transvaalia' 6-max Seat #4 is the button
Seat 1: Spud-JCT ($10.28 in chips) 
Seat 2: lastfox ($26.77 in chips) 
Seat 3: vicman121 ($15.78 in chips) 
Seat 4: Kobert72 ($10 in chips) 
Seat 5: jojoboon78 ($16.66 in chips) 
Seat 6: FacuLarrocca ($13.63 in chips) 
jojoboon78: posts small blind $0.05
FacuLarrocca: posts big blind $0.10
*** HOLE CARDS ***
Spud-JCT: calls $0.10
lastfox: folds 
vicman121: folds 
Kobert72: raises $0.20 to $0.30
jojoboon78: folds 
FacuLarrocca: folds 
Spud-JCT: calls $0.20
*** FLOP *** [Jh 6s Qd]
Spud-JCT: checks 
Kobert72: bets $0.24
Spud-JCT: folds 
Uncalled bet ($0.24) returned to Kobert72
Kobert72 collected $0.72 from pot
Kobert72: doesn't show hand 
*** SUMMARY ***
Total pot $0.75 | Rake $0.03 
Board [Jh 6s Qd]
Seat 1: Spud-JCT folded on the Flop
Seat 2: lastfox folded before Flop (didn't bet)
Seat 3: vicman121 folded before Flop (didn't bet)
Seat 4: Kobert72 (button) collected ($0.72)
Seat 5: jojoboon78 (small blind) folded before Flop
Seat 6: FacuLarrocca (big blind) folded before Flop



PokerStars Hand #222967288116:  Hold'em No Limit ($0.05/$0.10 USD) - 2021/01/23 14:46:40 ET
Table 'Transvaalia' 6-max Seat #5 is the button
Seat 1: Spud-JCT ($9.98 in chips) 
Seat 2: lastfox ($26.77 in chips) 
Seat 3: vicman121 ($15.78 in chips) 
Seat 4: Kobert72 ($10.42 in chips) 
Seat 5: jojoboon78 ($16.61 in chips) 
Seat 6: FacuLarrocca ($13.53 in chips) 
FacuLarrocca: posts small blind $0.05
Spud-JCT: posts big blind $0.10
*** HOLE CARDS ***
lastfox: raises $0.13 to $0.23
vicman121: folds 
Kobert72: folds 
jojoboon78: calls $0.23
FacuLarrocca: folds 
Spud-JCT: folds 
*** FLOP *** [Jc 7d 4s]
lastfox: bets $0.44
jojoboon78: folds 
Uncalled bet ($0.44) returned to lastfox
lastfox collected $0.58 from pot
lastfox: doesn't show hand 
*** SUMMARY ***
Total pot $0.61 | Rake $0.03 
Board [Jc 7d 4s]
Seat 1: Spud-JCT (big blind) folded before Flop
Seat 2: lastfox collected ($0.58)
Seat 3: vicman121 folded before Flop (didn't bet)
Seat 4: Kobert72 folded before Flop (didn't bet)
Seat 5: jojoboon78 (button) folded on the Flop
Seat 6: FacuLarrocca (small blind) folded before Flop



PokerStars Hand #222967308034:  Hold'em No Limit ($0.05/$0.10 USD) - 2021/01/23 14:47:06 ET
Table 'Transvaalia' 6-max Seat #6 is the button
Seat 1: Spud-JCT ($9.88 in chips) 
Seat 2: lastfox ($27.12 in chips) 
Seat 3: vicman121 ($15.78 in chips) 
Seat 4: Kobert72 ($10.42 in chips) 
Seat 5: jojoboon78 ($16.38 in chips) 
Seat 6: FacuLarrocca ($13.48 in chips) 
Spud-JCT: posts small blind $0.05
lastfox: posts big blind $0.10
*** HOLE CARDS ***
vicman121: folds 
Kobert72: folds 
jojoboon78: folds 
FacuLarrocca: folds 
Spud-JCT: calls $0.05
lastfox: checks 
*** FLOP *** [9s Td 7c]
Spud-JCT: checks 
lastfox: checks 
*** TURN *** [9s Td 7c] [5c]
Spud-JCT: checks 
lastfox: checks 
*** RIVER *** [9s Td 7c 5c] [Ts]
Spud-JCT: checks 
lastfox: bets $0.14
Spud-JCT: calls $0.14
*** SHOW DOWN ***
lastfox: shows [6c Th] (three of a kind, Tens)
Spud-JCT: mucks hand 
lastfox collected $0.46 from pot
*** SUMMARY ***
Total pot $0.48 | Rake $0.02 
Board [9s Td 7c 5c Ts]
Seat 1: Spud-JCT (small blind) mucked
Seat 2: lastfox (big blind) showed [6c Th] and won ($0.46) with three of a kind, Tens
Seat 3: vicman121 folded before Flop (didn't bet)
Seat 4: Kobert72 folded before Flop (didn't bet)
Seat 5: jojoboon78 folded before Flop (didn't bet)
Seat 6: FacuLarrocca (button) folded before Flop (didn't bet)



PokerStars Hand #222967336227:  Hold'em No Limit ($0.05/$0.10 USD) - 2021/01/23 14:47:42 ET
Table 'Transvaalia' 6-max Seat #1 is the button
Seat 1: Spud-JCT ($9.64 in chips) 
Seat 2: lastfox ($27.34 in chips) 
Seat 3: vicman121 ($15.78 in chips) 
Seat 4: Kobert72 ($10.42 in chips) 
Seat 5: jojoboon78 ($16.38 in chips) 
Seat 6: FacuLarrocca ($13.48 in chips) 
lastfox: posts small blind $0.05
vicman121: posts big blind $0.10
*** HOLE CARDS ***
Kobert72: raises $0.13 to $0.23
jojoboon78: folds 
FacuLarrocca: folds 
Spud-JCT: calls $0.23
lastfox: folds 
vicman121: folds 
*** FLOP *** [9h 2d 2h]
Kobert72: checks 
Spud-JCT: checks 
*** TURN *** [9h 2d 2h] [7h]
Kobert72: bets $0.19
Spud-JCT: folds 
Uncalled bet ($0.19) returned to Kobert72
Kobert72 collected $0.58 from pot
Kobert72: doesn't show hand 
*** SUMMARY ***
Total pot $0.61 | Rake $0.03 
Board [9h 2d 2h 7h]
Seat 1: Spud-JCT (button) folded on the Turn
Seat 2: lastfox (small blind) folded before Flop
Seat 3: vicman121 (big blind) folded before Flop
Seat 4: Kobert72 collected ($0.58)
Seat 5: jojoboon78 folded before Flop (didn't bet)
Seat 6: FacuLarrocca folded before Flop (didn't bet)



PokerStars Hand #222967366618:  Hold'em No Limit ($0.05/$0.10 USD) - 2021/01/23 14:48:22 ET
Table 'Transvaalia' 6-max Seat #2 is the button
Seat 1: Spud-JCT ($9.41 in chips) 
Seat 2: lastfox ($27.29 in chips) 
Seat 3: vicman121 ($15.68 in chips) 
Seat 4: Kobert72 ($10.77 in chips) 
Seat 5: jojoboon78 ($16.38 in chips) 
Seat 6: FacuLarrocca ($13.48 in chips) 
vicman121: posts small blind $0.05
Kobert72: posts big blind $0.10
*** HOLE CARDS ***
jojoboon78: raises $0.15 to $0.25
FacuLarrocca: folds 
Spud-JCT: calls $0.25
lastfox: calls $0.25
vicman121: folds 
Kobert72: folds 
*** FLOP *** [Jd 5s 9d]
jojoboon78: bets $0.43
Spud-JCT: calls $0.43
lastfox: calls $0.43
*** TURN *** [Jd 5s 9d] [3s]
jojoboon78: bets $1.05
Spud-JCT: folds 
lastfox: folds 
Uncalled bet ($1.05) returned to jojoboon78
jojoboon78 collected $2.09 from pot
jojoboon78: doesn't show hand 
*** SUMMARY ***
Total pot $2.19 | Rake $0.10 
Board [Jd 5s 9d 3s]
Seat 1: Spud-JCT folded on the Turn
Seat 2: lastfox (button) folded on the Turn
Seat 3: vicman121 (small blind) folded before Flop
Seat 4: Kobert72 (big blind) folded before Flop
Seat 5: jojoboon78 collected ($2.09)
Seat 6: FacuLarrocca folded before Flop (didn't bet)



PokerStars Hand #222967409769:  Hold'em No Limit ($0.05/$0.10 USD) - 2021/01/23 14:49:17 ET
Table 'Transvaalia' 6-max Seat #3 is the button
Seat 1: Spud-JCT ($8.73 in chips) 
Seat 2: lastfox ($26.61 in chips) 
Seat 3: vicman121 ($15.63 in chips) 
Seat 4: Kobert72 ($10.67 in chips) 
Seat 5: jojoboon78 ($17.79 in chips) 
Seat 6: FacuLarrocca ($13.48 in chips) 
Kobert72: posts small blind $0.05
jojoboon78: posts big blind $0.10
*** HOLE CARDS ***
FacuLarrocca: folds 
Spud-JCT: folds 
lastfox: folds 
vicman121: folds 
Kobert72: raises $0.20 to $0.30
jojoboon78: calls $0.20
*** FLOP *** [2s 9h 9c]
Kobert72: bets $0.19
jojoboon78: calls $0.19
*** TURN *** [2s 9h 9c] [5s]
Kobert72: checks 
jojoboon78: checks 
*** RIVER *** [2s 9h 9c 5s] [Js]
Kobert72: bets $0.71
jojoboon78: calls $0.71
*** SHOW DOWN ***
Kobert72: shows [Qc 7c] (a pair of Nines)
jojoboon78: shows [7d 9d] (three of a kind, Nines)
jojoboon78 collected $2.29 from pot
*** SUMMARY ***
Total pot $2.40 | Rake $0.11 
Board [2s 9h 9c 5s Js]
Seat 1: Spud-JCT folded before Flop (didn't bet)
Seat 2: lastfox folded before Flop (didn't bet)
Seat 3: vicman121 (button) folded before Flop (didn't bet)
Seat 4: Kobert72 (small blind) showed [Qc 7c] and lost with a pair of Nines
Seat 5: jojoboon78 (big blind) showed [7d 9d] and won ($2.29) with three of a kind, Nines
Seat 6: FacuLarrocca folded before Flop (didn't bet)



PokerStars Hand #222967454002:  Hold'em No Limit ($0.05/$0.10 USD) - 2021/01/23 14:50:15 ET
Table 'Transvaalia' 6-max Seat #4 is the button
Seat 1: Spud-JCT ($8.73 in chips) 
Seat 2: lastfox ($26.61 in chips) 
Seat 3: vicman121 ($15.63 in chips) 
Seat 4: Kobert72 ($10 in chips) 
Seat 5: jojoboon78 ($18.88 in chips) 
Seat 6: FacuLarrocca ($13.48 in chips) 
jojoboon78: posts small blind $0.05
FacuLarrocca: posts big blind $0.10
*** HOLE CARDS ***
Spud-JCT: folds 
lastfox: folds 
vicman121: folds 
Kobert72: folds 
jojoboon78: calls $0.05
FacuLarrocca: checks 
*** FLOP *** [7c Th Ac]
jojoboon78: checks 
FacuLarrocca: checks 
*** TURN *** [7c Th Ac] [Qs]
jojoboon78: bets $0.19
FacuLarrocca: folds 
Uncalled bet ($0.19) returned to jojoboon78
jojoboon78 collected $0.19 from pot
jojoboon78: doesn't show hand 
*** SUMMARY ***
Total pot $0.20 | Rake $0.01 
Board [7c Th Ac Qs]
Seat 1: Spud-JCT folded before Flop (didn't bet)
Seat 2: lastfox folded before Flop (didn't bet)
Seat 3: vicman121 folded before Flop (didn't bet)
Seat 4: Kobert72 (button) folded before Flop (didn't bet)
Seat 5: jojoboon78 (small blind) collected ($0.19)
Seat 6: FacuLarrocca (big blind) folded on the Turn



PokerStars Hand #222967489078:  Hold'em No Limit ($0.05/$0.10 USD) - 2021/01/23 14:51:00 ET
Table 'Transvaalia' 6-max Seat #5 is the button
Seat 1: Spud-JCT ($8.73 in chips) 
Seat 2: lastfox ($26.61 in chips) 
Seat 3: vicman121 ($15.63 in chips) 
Seat 4: Kobert72 ($10 in chips) 
Seat 5: jojoboon78 ($18.97 in chips) 
Seat 6: FacuLarrocca ($13.38 in chips) 
FacuLarrocca: posts small blind $0.05
Spud-JCT: posts big blind $0.10
*** HOLE CARDS ***
lastfox: folds 
vicman121: folds 
Kobert72: raises $0.13 to $0.23
jojoboon78: folds 
FacuLarrocca: folds 
Spud-JCT: folds 
Uncalled bet ($0.13) returned to Kobert72
Kobert72 collected $0.25 from pot
Kobert72: doesn't show hand 
*** SUMMARY ***
Total pot $0.25 | Rake $0 
Seat 1: Spud-JCT (big blind) folded before Flop
Seat 2: lastfox folded before Flop (didn't bet)
Seat 3: vicman121 folded before Flop (didn't bet)
Seat 4: Kobert72 collected ($0.25)
Seat 5: jojoboon78 (button) folded before Flop (didn't bet)
Seat 6: FacuLarrocca (small blind) folded before Flop



PokerStars Hand #222967499549:  Hold'em No Limit ($0.05/$0.10 USD) - 2021/01/23 14:51:14 ET
Table 'Transvaalia' 6-max Seat #6 is the button
Seat 1: Spud-JCT ($8.63 in chips) 
Seat 2: lastfox ($26.61 in chips) 
Seat 3: vicman121 ($15.63 in chips) 
Seat 4: Kobert72 ($10.15 in chips) 
Seat 5: jojoboon78 ($18.97 in chips) 
Seat 6: FacuLarrocca ($13.33 in chips) 
Spud-JCT: posts small blind $0.05
lastfox: posts big blind $0.10
*** HOLE CARDS ***
vicman121: folds 
Kobert72: folds 
jojoboon78: raises $0.15 to $0.25
FacuLarrocca: folds 
Spud-JCT: folds 
lastfox: calls $0.15
*** FLOP *** [9d 4h 8h]
lastfox: bets $0.40
jojoboon78: calls $0.40
*** TURN *** [9d 4h 8h] [3d]
lastfox: bets $0.97
jojoboon78: calls $0.97
*** RIVER *** [9d 4h 8h 3d] [2s]
lastfox: checks 
jojoboon78: bets $1.57
lastfox: calls $1.57
*** SHOW DOWN ***
jojoboon78: shows [Td Th] (a pair of Tens)
lastfox: mucks hand 
jojoboon78 collected $6.14 from pot
*** SUMMARY ***
Total pot $6.43 | Rake $0.29 
Board [9d 4h 8h 3d 2s]
Seat 1: Spud-JCT (small blind) folded before Flop
Seat 2: lastfox (big blind) mucked
Seat 3: vicman121 folded before Flop (didn't bet)
Seat 4: Kobert72 folded before Flop (didn't bet)
Seat 5: jojoboon78 showed [Td Th] and won ($6.14) with a pair of Tens
Seat 6: FacuLarrocca (button) folded before Flop (didn't bet)



PokerStars Hand #222967544661:  Hold'em No Limit ($0.05/$0.10 USD) - 2021/01/23 14:52:13 ET
Table 'Transvaalia' 6-max Seat #1 is the button
Seat 1: Spud-JCT ($8.58 in chips) 
Seat 2: lastfox ($23.42 in chips) 
Seat 3: vicman121 ($15.63 in chips) 
Seat 4: Kobert72 ($10.15 in chips) 
Seat 5: jojoboon78 ($21.92 in chips) 
Seat 6: FacuLarrocca ($13.33 in chips) 
lastfox: posts small blind $0.05
vicman121: posts big blind $0.10
*** HOLE CARDS ***
Kobert72: folds 
jojoboon78: raises $0.15 to $0.25
FacuLarrocca: raises $0.65 to $0.90
Spud-JCT: folds 
lastfox: folds 
vicman121: folds 
jojoboon78: calls $0.65
*** FLOP *** [Qc 4h Ts]
jojoboon78: checks 
FacuLarrocca: bets $0.93
jojoboon78: raises $1.47 to $2.40
FacuLarrocca: folds 
Uncalled bet ($1.47) returned to jojoboon78
jojoboon78 collected $3.64 from pot
jojoboon78: doesn't show hand 
*** SUMMARY ***
Total pot $3.81 | Rake $0.17 
Board [Qc 4h Ts]
Seat 1: Spud-JCT (button) folded before Flop (didn't bet)
Seat 2: lastfox (small blind) folded before Flop
Seat 3: vicman121 (big blind) folded before Flop
Seat 4: Kobert72 folded before Flop (didn't bet)
Seat 5: jojoboon78 collected ($3.64)
Seat 6: FacuLarrocca folded on the Flop



PokerStars Hand #222967581977:  Hold'em No Limit ($0.05/$0.10 USD) - 2021/01/23 14:53:01 ET
Table 'Transvaalia' 6-max Seat #2 is the button
Seat 1: Spud-JCT ($8.58 in chips) 
Seat 2: lastfox ($23.37 in chips) 
Seat 3: vicman121 ($15.53 in chips) 
Seat 4: Kobert72 ($10.15 in chips) 
Seat 5: jojoboon78 ($23.73 in chips) 
Seat 6: FacuLarrocca ($11.50 in chips) 
vicman121: posts small blind $0.05
Kobert72: posts big blind $0.10
*** HOLE CARDS ***
jojoboon78: raises $0.15 to $0.25
FacuLarrocca: folds 
Spud-JCT: folds 
lastfox: folds 
vicman121: folds 
Kobert72: folds 
Uncalled bet ($0.15) returned to jojoboon78
jojoboon78 collected $0.25 from pot
jojoboon78: doesn't show hand 
*** SUMMARY ***
Total pot $0.25 | Rake $0 
Seat 1: Spud-JCT folded before Flop (didn't bet)
Seat 2: lastfox (button) folded before Flop (didn't bet)
Seat 3: vicman121 (small blind) folded before Flop
Seat 4: Kobert72 (big blind) folded before Flop
Seat 5: jojoboon78 collected ($0.25)
Seat 6: FacuLarrocca folded before Flop (didn't bet)



PokerStars Hand #222967594147:  Hold'em No Limit ($0.05/$0.10 USD) - 2021/01/23 14:53:17 ET
Table 'Transvaalia' 6-max Seat #3 is the button
Seat 1: Spud-JCT ($8.58 in chips) 
Seat 2: lastfox ($23.37 in chips) 
Seat 3: vicman121 ($15.48 in chips) 
Seat 4: Kobert72 ($10.05 in chips) 
Seat 5: jojoboon78 ($23.88 in chips) 
Seat 6: FacuLarrocca ($11.50 in chips) 
Kobert72: posts small blind $0.05
jojoboon78: posts big blind $0.10
*** HOLE CARDS ***
FacuLarrocca: raises $0.20 to $0.30
Spud-JCT: folds 
lastfox: folds 
vicman121: folds 
Kobert72: folds 
jojoboon78: calls $0.20
*** FLOP *** [4c 7c 9d]
jojoboon78: checks 
FacuLarrocca: bets $0.47
jojoboon78: calls $0.47
*** TURN *** [4c 7c 9d] [Qs]
jojoboon78: checks 
FacuLarrocca: bets $2.28
jojoboon78: folds 
Uncalled bet ($2.28) returned to FacuLarrocca
FacuLarrocca collected $1.52 from pot
FacuLarrocca: doesn't show hand 
*** SUMMARY ***
Total pot $1.59 | Rake $0.07 
Board [4c 7c 9d Qs]
Seat 1: Spud-JCT folded before Flop (didn't bet)
Seat 2: lastfox folded before Flop (didn't bet)
Seat 3: vicman121 (button) folded before Flop (didn't bet)
Seat 4: Kobert72 (small blind) folded before Flop
Seat 5: jojoboon78 (big blind) folded on the Turn
Seat 6: FacuLarrocca collected ($1.52)



PokerStars Hand #222967634586:  Hold'em No Limit ($0.05/$0.10 USD) - 2021/01/23 14:54:01 ET
Table 'Transvaalia' 6-max Seat #4 is the button
Seat 1: Spud-JCT ($8.58 in chips) 
Seat 2: lastfox ($23.37 in chips) 
Seat 3: vicman121 ($15.48 in chips) 
Seat 4: Kobert72 ($10 in chips) 
Seat 5: jojoboon78 ($23.11 in chips) 
Seat 6: FacuLarrocca ($12.25 in chips) 
jojoboon78: posts small blind $0.05
FacuLarrocca: posts big blind $0.10
*** HOLE CARDS ***
Spud-JCT: calls $0.10
lastfox: folds 
vicman121: folds 
Kobert72: folds 
jojoboon78: folds 
FacuLarrocca: raises $0.25 to $0.35
Spud-JCT: calls $0.25
*** FLOP *** [2h As Kh]
FacuLarrocca: checks 
Spud-JCT: checks 
*** TURN *** [2h As Kh] [8d]
FacuLarrocca: bets $0.24
Spud-JCT: folds 
Uncalled bet ($0.24) returned to FacuLarrocca
FacuLarrocca collected $0.72 from pot
FacuLarrocca: doesn't show hand 
*** SUMMARY ***
Total pot $0.75 | Rake $0.03 
Board [2h As Kh 8d]
Seat 1: Spud-JCT folded on the Turn
Seat 2: lastfox folded before Flop (didn't bet)
Seat 3: vicman121 folded before Flop (didn't bet)
Seat 4: Kobert72 (button) folded before Flop (didn't bet)
Seat 5: jojoboon78 (small blind) folded before Flop
Seat 6: FacuLarrocca (big blind) collected ($0.72)



PokerStars Hand #222967657322:  Hold'em No Limit ($0.05/$0.10 USD) - 2021/01/23 14:54:31 ET
Table 'Transvaalia' 6-max Seat #5 is the button
Seat 1: Spud-JCT ($8.23 in chips) 
Seat 2: lastfox ($23.37 in chips) 
Seat 3: vicman121 ($15.48 in chips) 
Seat 4: Kobert72 ($10 in chips) 
Seat 5: jojoboon78 ($23.06 in chips) 
Seat 6: FacuLarrocca ($12.62 in chips) 
FacuLarrocca: posts small blind $0.05
Spud-JCT: posts big blind $0.10
*** HOLE CARDS ***
lastfox: raises $0.13 to $0.23
vicman121: folds 
Kobert72: folds 
jojoboon78: calls $0.23
FacuLarrocca: folds 
Spud-JCT: calls $0.13
*** FLOP *** [Td As 9h]
Spud-JCT: bets $0.10
lastfox: calls $0.10
jojoboon78: calls $0.10
*** TURN *** [Td As 9h] [2d]
Spud-JCT: checks 
lastfox: checks 
jojoboon78: checks 
*** RIVER *** [Td As 9h 2d] [3d]
Spud-JCT: bets $1.80
lastfox: folds 
jojoboon78: folds 
Uncalled bet ($1.80) returned to Spud-JCT
Spud-JCT collected $0.99 from pot
Spud-JCT: doesn't show hand 
*** SUMMARY ***
Total pot $1.04 | Rake $0.05 
Board [Td As 9h 2d 3d]
Seat 1: Spud-JCT (big blind) collected ($0.99)
Seat 2: lastfox folded on the River
Seat 3: vicman121 folded before Flop (didn't bet)
Seat 4: Kobert72 folded before Flop (didn't bet)
Seat 5: jojoboon78 (button) folded on the River
Seat 6: FacuLarrocca (small blind) folded before Flop



PokerStars Hand #222967696079:  Hold'em No Limit ($0.05/$0.10 USD) - 2021/01/23 14:55:27 ET
Table 'Transvaalia' 6-max Seat #6 is the button
Seat 1: Spud-JCT ($8.89 in chips) 
Seat 2: lastfox ($23.04 in chips) 
Seat 3: vicman121 ($15.48 in chips) 
Seat 4: Kobert72 ($10 in chips) 
Seat 5: jojoboon78 ($22.73 in chips) 
Seat 6: FacuLarrocca ($12.57 in chips) 
Spud-JCT: posts small blind $0.05
lastfox: posts big blind $0.10
*** HOLE CARDS ***
vicman121: folds 
Kobert72: raises $0.13 to $0.23
jojoboon78: calls $0.23
FacuLarrocca: raises $0.87 to $1.10
Spud-JCT: folds 
lastfox: folds 
Kobert72: folds 
jojoboon78: calls $0.87
*** FLOP *** [3d 2s 8h]
jojoboon78: checks 
FacuLarrocca: bets $1.23
jojoboon78: raises $2.47 to $3.70
FacuLarrocca: calls $2.47
*** TURN *** [3d 2s 8h] [6c]
jojoboon78: bets $9.53
FacuLarrocca: calls $7.77 and is all-in
Uncalled bet ($1.76) returned to jojoboon78
*** RIVER *** [3d 2s 8h 6c] [2d]
*** SHOW DOWN ***
jojoboon78: shows [As Ad] (two pair, Aces and Deuces)
FacuLarrocca: shows [9s 9h] (two pair, Nines and Deuces)
jojoboon78 collected $24.37 from pot
*** SUMMARY ***
Total pot $25.52 | Rake $1.15 
Board [3d 2s 8h 6c 2d]
Seat 1: Spud-JCT (small blind) folded before Flop
Seat 2: lastfox (big blind) folded before Flop
Seat 3: vicman121 folded before Flop (didn't bet)
Seat 4: Kobert72 folded before Flop
Seat 5: jojoboon78 showed [As Ad] and won ($24.37) with two pair, Aces and Deuces
Seat 6: FacuLarrocca (button) showed [9s 9h] and lost with two pair, Nines and Deuces



PokerStars Hand #222967731389:  Hold'em No Limit ($0.05/$0.10 USD) - 2021/01/23 14:56:33 ET
Table 'Transvaalia' 6-max Seat #1 is the button
Seat 1: Spud-JCT ($8.84 in chips) 
Seat 2: lastfox ($22.94 in chips) 
Seat 3: vicman121 ($15.48 in chips) 
Seat 4: Kobert72 ($10 in chips) 
Seat 5: jojoboon78 ($34.53 in chips) 
Seat 6: FacuLarrocca ($10 in chips) 
lastfox: posts small blind $0.05
vicman121: posts big blind $0.10
*** HOLE CARDS ***
Kobert72: folds 
jojoboon78: raises $0.15 to $0.25
FacuLarrocca: raises $0.65 to $0.90
Spud-JCT: folds 
lastfox: folds 
vicman121: folds 
jojoboon78: calls $0.65
*** FLOP *** [7h Qc 2h]
jojoboon78: checks 
FacuLarrocca: bets $0.93
jojoboon78: calls $0.93
*** TURN *** [7h Qc 2h] [Tc]
jojoboon78: checks 
FacuLarrocca: bets $2.73
jojoboon78: calls $2.73
*** RIVER *** [7h Qc 2h Tc] [5c]
jojoboon78: checks 
FacuLarrocca: checks 
*** SHOW DOWN ***
jojoboon78: shows [5s Qs] (two pair, Queens and Fives)
FacuLarrocca: mucks hand 
jojoboon78 collected $8.85 from pot
*** SUMMARY ***
Total pot $9.27 | Rake $0.42 
Board [7h Qc 2h Tc 5c]
Seat 1: Spud-JCT (button) folded before Flop (didn't bet)
Seat 2: lastfox (small blind) folded before Flop
Seat 3: vicman121 (big blind) folded before Flop
Seat 4: Kobert72 folded before Flop (didn't bet)
Seat 5: jojoboon78 showed [5s Qs] and won ($8.85) with two pair, Queens and Fives
Seat 6: FacuLarrocca mucked



PokerStars Hand #222967769787:  Hold'em No Limit ($0.05/$0.10 USD) - 2021/01/23 14:57:45 ET
Table 'Transvaalia' 6-max Seat #2 is the button
Seat 1: Spud-JCT ($8.84 in chips) 
Seat 2: lastfox ($22.89 in chips) 
Seat 3: vicman121 ($15.38 in chips) 
Seat 4: Kobert72 ($10 in chips) 
Seat 5: jojoboon78 ($38.82 in chips) 
Seat 6: FacuLarrocca ($10 in chips) 
vicman121: posts small blind $0.05
Kobert72: posts big blind $0.10
*** HOLE CARDS ***
jojoboon78: raises $0.15 to $0.25
FacuLarrocca: folds 
Spud-JCT: folds 
lastfox: folds 
vicman121: folds 
Kobert72: calls $0.15
*** FLOP *** [4c 9h 3h]
Kobert72: checks 
vicman121 leaves the table
jojoboon78: bets $0.27
raydenel joins the table at seat #3 
Kobert72: folds 
Uncalled bet ($0.27) returned to jojoboon78
jojoboon78 collected $0.53 from pot
jojoboon78: doesn't show hand 
*** SUMMARY ***
Total pot $0.55 | Rake $0.02 
Board [4c 9h 3h]
Seat 1: Spud-JCT folded before Flop (didn't bet)
Seat 2: lastfox (button) folded before Flop (didn't bet)
Seat 3: vicman121 (small blind) folded before Flop
Seat 4: Kobert72 (big blind) folded on the Flop
Seat 5: jojoboon78 collected ($0.53)
Seat 6: FacuLarrocca folded before Flop (didn't bet)



PokerStars Hand #222967788703:  Hold'em No Limit ($0.05/$0.10 USD) - 2021/01/23 14:58:20 ET
Table 'Transvaalia' 6-max Seat #4 is the button
Seat 1: Spud-JCT ($8.84 in chips) 
Seat 2: lastfox ($22.89 in chips) 
Seat 4: Kobert72 ($10 in chips) 
Seat 5: jojoboon78 ($39.10 in chips) 
Seat 6: FacuLarrocca ($10 in chips) 
jojoboon78: posts small blind $0.05
FacuLarrocca: posts big blind $0.10
raydenel: sits out 
*** HOLE CARDS ***
Spud-JCT: calls $0.10
lastfox: folds 
Kobert72: folds 
jojoboon78: calls $0.05
FacuLarrocca: checks 
*** FLOP *** [7h 3h 5c]
jojoboon78: checks 
FacuLarrocca: checks 
Spud-JCT: checks 
*** TURN *** [7h 3h 5c] [7d]
jojoboon78: checks 
FacuLarrocca: checks 
Spud-JCT: bets $0.80
jojoboon78: folds 
FacuLarrocca: folds 
Uncalled bet ($0.80) returned to Spud-JCT
Spud-JCT collected $0.29 from pot
Spud-JCT: doesn't show hand 
*** SUMMARY ***
Total pot $0.30 | Rake $0.01 
Board [7h 3h 5c 7d]
Seat 1: Spud-JCT collected ($0.29)
Seat 2: lastfox folded before Flop (didn't bet)
Seat 4: Kobert72 (button) folded before Flop (didn't bet)
Seat 5: jojoboon78 (small blind) folded on the Turn
Seat 6: FacuLarrocca (big blind) folded on the Turn



PokerStars Hand #222967808600:  Hold'em No Limit ($0.05/$0.10 USD) - 2021/01/23 14:58:58 ET
Table 'Transvaalia' 6-max Seat #5 is the button
Seat 1: Spud-JCT ($9.03 in chips) 
Seat 2: lastfox ($22.89 in chips) 
Seat 4: Kobert72 ($10 in chips) 
Seat 5: jojoboon78 ($39 in chips) 
Seat 6: FacuLarrocca ($10 in chips) 
FacuLarrocca: posts small blind $0.05
Spud-JCT: posts big blind $0.10
raydenel: sits out 
*** HOLE CARDS ***
lastfox: raises $0.13 to $0.23
Kobert72: folds 
jojoboon78: calls $0.23
FacuLarrocca: folds 
Spud-JCT: calls $0.13
*** FLOP *** [Kc 5h 7d]
Spud-JCT: checks 
lastfox: checks 
jojoboon78: checks 
*** TURN *** [Kc 5h 7d] [8s]
Spud-JCT: checks 
lastfox: checks 
jojoboon78: bets $0.36
Spud-JCT: calls $0.36
lastfox: calls $0.36
*** RIVER *** [Kc 5h 7d 8s] [3d]
Spud-JCT: checks 
lastfox: checks 
jojoboon78: checks 
*** SHOW DOWN ***
Spud-JCT: shows [3s 6c] (a pair of Threes)
lastfox: shows [Jh Js] (a pair of Jacks)
jojoboon78: mucks hand 
lastfox collected $1.74 from pot
*** SUMMARY ***
Total pot $1.82 | Rake $0.08 
Board [Kc 5h 7d 8s 3d]
Seat 1: Spud-JCT (big blind) showed [3s 6c] and lost with a pair of Threes
Seat 2: lastfox showed [Jh Js] and won ($1.74) with a pair of Jacks
Seat 4: Kobert72 folded before Flop (didn't bet)
Seat 5: jojoboon78 (button) mucked
Seat 6: FacuLarrocca (small blind) folded before Flop



PokerStars Hand #222967842511:  Hold'em No Limit ($0.05/$0.10 USD) - 2021/01/23 15:00:00 ET
Table 'Transvaalia' 6-max Seat #6 is the button
Seat 1: Spud-JCT ($8.44 in chips) 
Seat 2: lastfox ($24.04 in chips) 
Seat 4: Kobert72 ($10 in chips) 
Seat 5: jojoboon78 ($38.41 in chips) 
Seat 6: FacuLarrocca ($10 in chips) 
Spud-JCT: posts small blind $0.05
lastfox: posts big blind $0.10
raydenel: sits out 
*** HOLE CARDS ***
Kobert72: folds 
jojoboon78: raises $0.15 to $0.25
FacuLarrocca: folds 
Spud-JCT: calls $0.20
lastfox: folds 
*** FLOP *** [8c 9d Qd]
Spud-JCT: bets $0.10
jojoboon78: calls $0.10
*** TURN *** [8c 9d Qd] [Td]
Spud-JCT: bets $0.80
jojoboon78: folds 
Uncalled bet ($0.80) returned to Spud-JCT
Spud-JCT collected $0.76 from pot
Spud-JCT: doesn't show hand 
*** SUMMARY ***
Total pot $0.80 | Rake $0.04 
Board [8c 9d Qd Td]
Seat 1: Spud-JCT (small blind) collected ($0.76)
Seat 2: lastfox (big blind) folded before Flop
Seat 4: Kobert72 folded before Flop (didn't bet)
Seat 5: jojoboon78 folded on the Turn
Seat 6: FacuLarrocca (button) folded before Flop (didn't bet)



PokerStars Hand #222967864959:  Hold'em No Limit ($0.05/$0.10 USD) - 2021/01/23 15:00:39 ET
Table 'Transvaalia' 6-max Seat #1 is the button
Seat 1: Spud-JCT ($8.85 in chips) 
Seat 2: lastfox ($23.94 in chips) 
Seat 3: raydenel ($10 in chips) 
Seat 4: Kobert72 ($10 in chips) 
Seat 5: jojoboon78 ($38.06 in chips) 
Seat 6: FacuLarrocca ($10 in chips) 
lastfox: posts small blind $0.05
raydenel: posts big blind $0.10
*** HOLE CARDS ***
Kobert72: folds 
jojoboon78: raises $0.15 to $0.25
FacuLarrocca: folds 
Spud-JCT: calls $0.25
lastfox: raises $0.97 to $1.22
raydenel: folds 
jojoboon78: folds 
Spud-JCT: calls $0.97
*** FLOP *** [3c 4c 8d]
lastfox: checks 
Spud-JCT: checks 
*** TURN *** [3c 4c 8d] [Ts]
lastfox: checks 
Spud-JCT: checks 
*** RIVER *** [3c 4c 8d Ts] [Qd]
lastfox: checks 
Spud-JCT: checks 
*** SHOW DOWN ***
lastfox: shows [Ah Jd] (high card Ace)
Spud-JCT: shows [7h Th] (a pair of Tens)
Spud-JCT collected $2.66 from pot
*** SUMMARY ***
Total pot $2.79 | Rake $0.13 
Board [3c 4c 8d Ts Qd]
Seat 1: Spud-JCT (button) showed [7h Th] and won ($2.66) with a pair of Tens
Seat 2: lastfox (small blind) showed [Ah Jd] and lost with high card Ace
Seat 3: raydenel (big blind) folded before Flop
Seat 4: Kobert72 folded before Flop (didn't bet)
Seat 5: jojoboon78 folded before Flop
Seat 6: FacuLarrocca folded before Flop (didn't bet)



PokerStars Hand #222967900719:  Hold'em No Limit ($0.05/$0.10 USD) - 2021/01/23 15:01:29 ET
Table 'Transvaalia' 6-max Seat #2 is the button
Seat 1: Spud-JCT ($10.29 in chips) 
Seat 2: lastfox ($22.72 in chips) 
Seat 3: raydenel ($10 in chips) 
Seat 4: Kobert72 ($10 in chips) 
Seat 5: jojoboon78 ($37.81 in chips) 
Seat 6: FacuLarrocca ($10 in chips) 
raydenel: posts small blind $0.05
Kobert72: posts big blind $0.10
*** HOLE CARDS ***
jojoboon78: raises $0.15 to $0.25
FacuLarrocca: folds 
Spud-JCT: folds 
lastfox: folds 
raydenel: calls $0.20
Kobert72: folds 
*** FLOP *** [Kd Th 9h]
raydenel: checks 
jojoboon78: bets $0.29
raydenel: calls $0.29
*** TURN *** [Kd Th 9h] [3d]
raydenel: checks 
jojoboon78: bets $0.57
raydenel: calls $0.57
*** RIVER *** [Kd Th 9h 3d] [8c]
raydenel: checks 
jojoboon78: bets $1.11
raydenel: folds 
Uncalled bet ($1.11) returned to jojoboon78
jojoboon78 collected $2.22 from pot
jojoboon78: doesn't show hand 
*** SUMMARY ***
Total pot $2.32 | Rake $0.10 
Board [Kd Th 9h 3d 8c]
Seat 1: Spud-JCT folded before Flop (didn't bet)
Seat 2: lastfox (button) folded before Flop (didn't bet)
Seat 3: raydenel (small blind) folded on the River
Seat 4: Kobert72 (big blind) folded before Flop
Seat 5: jojoboon78 collected ($2.22)
Seat 6: FacuLarrocca folded before Flop (didn't bet)



PokerStars Hand #222967930309:  Hold'em No Limit ($0.05/$0.10 USD) - 2021/01/23 15:02:03 ET
Table 'Transvaalia' 6-max Seat #3 is the button
Seat 1: Spud-JCT ($10.29 in chips) 
Seat 2: lastfox ($22.72 in chips) 
Seat 3: raydenel ($10 in chips) 
Seat 4: Kobert72 ($10 in chips) 
Seat 6: FacuLarrocca ($10 in chips) 
Kobert72: posts small blind $0.05
jojoboon78: is sitting out 
FacuLarrocca: posts big blind $0.10
*** HOLE CARDS ***
Spud-JCT: calls $0.10
lastfox: folds 
jojoboon78 leaves the table
raydenel: folds 
iqpower joins the table at seat #5 
Kobert72: raises $0.13 to $0.23
FacuLarrocca: folds 
Spud-JCT: calls $0.13
*** FLOP *** [Qh 3s 5s]
Kobert72: bets $0.17
Spud-JCT: calls $0.17
*** TURN *** [Qh 3s 5s] [2c]
Kobert72: bets $0.47
Spud-JCT: raises $3.33 to $3.80
Kobert72: folds 
Uncalled bet ($3.33) returned to Spud-JCT
Spud-JCT collected $1.76 from pot
Spud-JCT: doesn't show hand 
*** SUMMARY ***
Total pot $1.84 | Rake $0.08 
Board [Qh 3s 5s 2c]
Seat 1: Spud-JCT collected ($1.76)
Seat 2: lastfox folded before Flop (didn't bet)
Seat 3: raydenel (button) folded before Flop (didn't bet)
Seat 4: Kobert72 (small blind) folded on the Turn
Seat 6: FacuLarrocca (big blind) folded before Flop



PokerStars Hand #222967965788:  Hold'em No Limit ($0.05/$0.10 USD) - 2021/01/23 15:02:49 ET
Table 'Transvaalia' 6-max Seat #4 is the button
Seat 1: Spud-JCT ($11.18 in chips) 
Seat 2: lastfox ($22.72 in chips) 
Seat 3: raydenel ($10 in chips) 
Seat 4: Kobert72 ($10 in chips) 
Seat 6: FacuLarrocca ($10 in chips) 
FacuLarrocca: posts small blind $0.05
Spud-JCT: posts big blind $0.10
*** HOLE CARDS ***
lastfox: raises $0.13 to $0.23
raydenel: calls $0.23
Kobert72: folds 
FacuLarrocca: folds 
Spud-JCT: calls $0.13
*** FLOP *** [Qc 6c 5s]
Spud-JCT: checks 
lastfox: bets $0.53
raydenel: calls $0.53
Spud-JCT: calls $0.53
*** TURN *** [Qc 6c 5s] [8s]
Spud-JCT: checks 
lastfox: checks 
raydenel: bets $1.12
Spud-JCT: folds 
lastfox: calls $1.12
*** RIVER *** [Qc 6c 5s 8s] [Kh]
lastfox: checks 
raydenel: checks 
*** SHOW DOWN ***
lastfox: shows [4c 5c] (a pair of Fives)
raydenel: shows [Jc Kc] (a pair of Kings)
raydenel collected $4.36 from pot
*** SUMMARY ***
Total pot $4.57 | Rake $0.21 
Board [Qc 6c 5s 8s Kh]
Seat 1: Spud-JCT (big blind) folded on the Turn
Seat 2: lastfox showed [4c 5c] and lost with a pair of Fives
Seat 3: raydenel showed [Jc Kc] and won ($4.36) with a pair of Kings
Seat 4: Kobert72 (button) folded before Flop (didn't bet)
Seat 6: FacuLarrocca (small blind) folded before Flop



PokerStars Hand #222968001631:  Hold'em No Limit ($0.05/$0.10 USD) - 2021/01/23 15:03:33 ET
Table 'Transvaalia' 6-max Seat #6 is the button
Seat 1: Spud-JCT ($10.42 in chips) 
Seat 2: lastfox ($20.84 in chips) 
Seat 3: raydenel ($12.48 in chips) 
Seat 4: Kobert72 ($10 in chips) 
Seat 6: FacuLarrocca ($10 in chips) 
Spud-JCT: posts small blind $0.05
lastfox: posts big blind $0.10
iqpower: sits out 
*** HOLE CARDS ***
raydenel: folds 
Kobert72: folds 
FacuLarrocca: folds 
Spud-JCT: folds 
Uncalled bet ($0.05) returned to lastfox
lastfox collected $0.10 from pot
lastfox: doesn't show hand 
*** SUMMARY ***
Total pot $0.10 | Rake $0 
Seat 1: Spud-JCT (small blind) folded before Flop
Seat 2: lastfox (big blind) collected ($0.10)
Seat 3: raydenel folded before Flop (didn't bet)
Seat 4: Kobert72 folded before Flop (didn't bet)
Seat 6: FacuLarrocca (button) folded before Flop (didn't bet)



PokerStars Hand #222968011725:  Hold'em No Limit ($0.05/$0.10 USD) - 2021/01/23 15:03:46 ET
Table 'Transvaalia' 6-max Seat #1 is the button
Seat 1: Spud-JCT ($10.37 in chips) 
Seat 2: lastfox ($20.89 in chips) 
Seat 3: raydenel ($12.48 in chips) 
Seat 4: Kobert72 ($10 in chips) 
Seat 6: FacuLarrocca ($10 in chips) 
lastfox: posts small blind $0.05
raydenel: posts big blind $0.10
iqpower: sits out 
*** HOLE CARDS ***
Kobert72: folds 
FacuLarrocca: folds 
Spud-JCT: folds 
lastfox: raises $0.13 to $0.23
raydenel: folds 
Uncalled bet ($0.13) returned to lastfox
lastfox collected $0.20 from pot
*** SUMMARY ***
Total pot $0.20 | Rake $0 
Seat 1: Spud-JCT (button) folded before Flop (didn't bet)
Seat 2: lastfox (small blind) collected ($0.20)
Seat 3: raydenel (big blind) folded before Flop
Seat 4: Kobert72 folded before Flop (didn't bet)
Seat 6: FacuLarrocca folded before Flop (didn't bet)



PokerStars Hand #222968023134:  Hold'em No Limit ($0.05/$0.10 USD) - 2021/01/23 15:04:00 ET
Table 'Transvaalia' 6-max Seat #2 is the button
Seat 1: Spud-JCT ($10.37 in chips) 
Seat 2: lastfox ($20.99 in chips) 
Seat 3: raydenel ($12.38 in chips) 
Seat 4: Kobert72 ($10 in chips) 
Seat 6: FacuLarrocca ($10 in chips) 
raydenel: posts small blind $0.05
Kobert72: posts big blind $0.10
iqpower: sits out 
*** HOLE CARDS ***
FacuLarrocca: folds 
Spud-JCT: folds 
lastfox: raises $0.15 to $0.25
raydenel: folds 
Kobert72: folds 
Uncalled bet ($0.15) returned to lastfox
lastfox collected $0.25 from pot
lastfox: doesn't show hand 
*** SUMMARY ***
Total pot $0.25 | Rake $0 
Seat 1: Spud-JCT folded before Flop (didn't bet)
Seat 2: lastfox (button) collected ($0.25)
Seat 3: raydenel (small blind) folded before Flop
Seat 4: Kobert72 (big blind) folded before Flop
Seat 6: FacuLarrocca folded before Flop (didn't bet)



PokerStars Hand #222968035075:  Hold'em No Limit ($0.05/$0.10 USD) - 2021/01/23 15:04:15 ET
Table 'Transvaalia' 6-max Seat #3 is the button
Seat 1: Spud-JCT ($10.37 in chips) 
Seat 2: lastfox ($21.14 in chips) 
Seat 3: raydenel ($12.33 in chips) 
Seat 4: Kobert72 ($10 in chips) 
Seat 5: iqpower ($10 in chips) 
Seat 6: FacuLarrocca ($10 in chips) 
Kobert72: posts small blind $0.05
iqpower: posts big blind $0.10
*** HOLE CARDS ***
FacuLarrocca: folds 
Spud-JCT: calls $0.10
lastfox: folds 
raydenel: folds 
Kobert72: folds 
iqpower: checks 
*** FLOP *** [6h 9c 4h]
iqpower: checks 
Spud-JCT: checks 
*** TURN *** [6h 9c 4h] [4d]
iqpower: checks 
Spud-JCT: checks 
*** RIVER *** [6h 9c 4h 4d] [Tc]
iqpower: bets $0.15
Spud-JCT: folds 
Uncalled bet ($0.15) returned to iqpower
iqpower collected $0.24 from pot
iqpower: doesn't show hand 
*** SUMMARY ***
Total pot $0.25 | Rake $0.01 
Board [6h 9c 4h 4d Tc]
Seat 1: Spud-JCT folded on the River
Seat 2: lastfox folded before Flop (didn't bet)
Seat 3: raydenel (button) folded before Flop (didn't bet)
Seat 4: Kobert72 (small blind) folded before Flop
Seat 5: iqpower (big blind) collected ($0.24)
Seat 6: FacuLarrocca folded before Flop (didn't bet)



PokerStars Hand #222968065100:  Hold'em No Limit ($0.05/$0.10 USD) - 2021/01/23 15:04:52 ET
Table 'Transvaalia' 6-max Seat #4 is the button
Seat 1: Spud-JCT ($10.27 in chips) 
Seat 2: lastfox ($21.14 in chips) 
Seat 3: raydenel ($12.33 in chips) 
Seat 4: Kobert72 ($10 in chips) 
Seat 5: iqpower ($10.14 in chips) 
Seat 6: FacuLarrocca ($10 in chips) 
iqpower: posts small blind $0.05
FacuLarrocca: posts big blind $0.10
*** HOLE CARDS ***
Spud-JCT: calls $0.10
lastfox: folds 
raydenel: calls $0.10
Kobert72: calls $0.10
iqpower: folds 
FacuLarrocca: checks 
*** FLOP *** [2c 4d Qd]
FacuLarrocca: checks 
Spud-JCT: checks 
raydenel: bets $0.29
Kobert72: folds 
FacuLarrocca: calls $0.29
Spud-JCT: folds 
*** TURN *** [2c 4d Qd] [5c]
FacuLarrocca: checks 
raydenel: bets $0.65
FacuLarrocca: calls $0.65
*** RIVER *** [2c 4d Qd 5c] [9d]
FacuLarrocca: checks 
raydenel: checks 
*** SHOW DOWN ***
FacuLarrocca: shows [Th Qc] (a pair of Queens)
raydenel: shows [4s 4c] (three of a kind, Fours)
raydenel collected $2.23 from pot
*** SUMMARY ***
Total pot $2.33 | Rake $0.10 
Board [2c 4d Qd 5c 9d]
Seat 1: Spud-JCT folded on the Flop
Seat 2: lastfox folded before Flop (didn't bet)
Seat 3: raydenel showed [4s 4c] and won ($2.23) with three of a kind, Fours
Seat 4: Kobert72 (button) folded on the Flop
Seat 5: iqpower (small blind) folded before Flop
Seat 6: FacuLarrocca (big blind) showed [Th Qc] and lost with a pair of Queens



PokerStars Hand #222968101419:  Hold'em No Limit ($0.05/$0.10 USD) - 2021/01/23 15:05:35 ET
Table 'Transvaalia' 6-max Seat #5 is the button
Seat 1: Spud-JCT ($10.17 in chips) 
Seat 2: lastfox ($21.14 in chips) 
Seat 3: raydenel ($13.52 in chips) 
Seat 4: Kobert72 ($10 in chips) 
Seat 5: iqpower ($10.09 in chips) 
Seat 6: FacuLarrocca ($10 in chips) 
FacuLarrocca: posts small blind $0.05
Spud-JCT: posts big blind $0.10
*** HOLE CARDS ***
lastfox: raises $0.13 to $0.23
raydenel: folds 
Kobert72: raises $0.50 to $0.73
iqpower: folds 
FacuLarrocca: folds 
Spud-JCT: folds 
lastfox: folds 
Uncalled bet ($0.50) returned to Kobert72
Kobert72 collected $0.61 from pot
Kobert72: doesn't show hand 
*** SUMMARY ***
Total pot $0.61 | Rake $0 
Seat 1: Spud-JCT (big blind) folded before Flop
Seat 2: lastfox folded before Flop
Seat 3: raydenel folded before Flop (didn't bet)
Seat 4: Kobert72 collected ($0.61)
Seat 5: iqpower (button) folded before Flop (didn't bet)
Seat 6: FacuLarrocca (small blind) folded before Flop



PokerStars Hand #222968116105:  Hold'em No Limit ($0.05/$0.10 USD) - 2021/01/23 15:05:53 ET
Table 'Transvaalia' 6-max Seat #6 is the button
Seat 1: Spud-JCT ($10.07 in chips) 
Seat 2: lastfox ($20.91 in chips) 
Seat 3: raydenel ($13.52 in chips) 
Seat 4: Kobert72 ($10.38 in chips) 
Seat 5: iqpower ($10.09 in chips) 
Seat 6: FacuLarrocca ($10 in chips) 
Spud-JCT: posts small blind $0.05
lastfox: posts big blind $0.10
*** HOLE CARDS ***
raydenel: folds 
Kobert72: folds 
iqpower: folds 
FacuLarrocca: folds 
Spud-JCT: calls $0.05
lastfox: checks 
*** FLOP *** [Kc Qh 7s]
Spud-JCT: checks 
lastfox: checks 
*** TURN *** [Kc Qh 7s] [Qs]
Spud-JCT: checks 
lastfox: checks 
*** RIVER *** [Kc Qh 7s Qs] [9d]
Spud-JCT: checks 
lastfox: checks 
*** SHOW DOWN ***
Spud-JCT: shows [8s Tc] (a pair of Queens)
lastfox: shows [2s 9s] (two pair, Queens and Nines)
lastfox collected $0.19 from pot
*** SUMMARY ***
Total pot $0.20 | Rake $0.01 
Board [Kc Qh 7s Qs 9d]
Seat 1: Spud-JCT (small blind) showed [8s Tc] and lost with a pair of Queens
Seat 2: lastfox (big blind) showed [2s 9s] and won ($0.19) with two pair, Queens and Nines
Seat 3: raydenel folded before Flop (didn't bet)
Seat 4: Kobert72 folded before Flop (didn't bet)
Seat 5: iqpower folded before Flop (didn't bet)
Seat 6: FacuLarrocca (button) folded before Flop (didn't bet)



PokerStars Hand #222968174276:  Hold'em No Limit ($0.05/$0.10 USD) - 2021/01/23 15:07:02 ET
Table 'Transvaalia' 6-max Seat #1 is the button
Seat 1: Spud-JCT ($9.97 in chips) 
Seat 2: lastfox ($21 in chips) 
Seat 3: raydenel ($13.52 in chips) 
Seat 4: Kobert72 ($10.38 in chips) 
Seat 5: iqpower ($10.09 in chips) 
Seat 6: FacuLarrocca ($10 in chips) 
lastfox: posts small blind $0.05
raydenel: posts big blind $0.10
*** HOLE CARDS ***
Kobert72: folds 
iqpower: raises $0.15 to $0.25
FacuLarrocca: folds 
Spud-JCT: folds 
lastfox: calls $0.20
raydenel: folds 
*** FLOP *** [6h Ah 3s]
lastfox: checks 
iqpower: bets $0.20
lastfox: folds 
Uncalled bet ($0.20) returned to iqpower
iqpower collected $0.57 from pot
iqpower: doesn't show hand 
*** SUMMARY ***
Total pot $0.60 | Rake $0.03 
Board [6h Ah 3s]
Seat 1: Spud-JCT (button) folded before Flop (didn't bet)
Seat 2: lastfox (small blind) folded on the Flop
Seat 3: raydenel (big blind) folded before Flop
Seat 4: Kobert72 folded before Flop (didn't bet)
Seat 5: iqpower collected ($0.57)
Seat 6: FacuLarrocca folded before Flop (didn't bet)



PokerStars Hand #222968205932:  Hold'em No Limit ($0.05/$0.10 USD) - 2021/01/23 15:07:40 ET
Table 'Transvaalia' 6-max Seat #2 is the button
Seat 1: Spud-JCT ($9.97 in chips) 
Seat 2: lastfox ($20.75 in chips) 
Seat 3: raydenel ($13.42 in chips) 
Seat 5: iqpower ($10.41 in chips) 
Seat 6: FacuLarrocca ($10 in chips) 
raydenel: posts small blind $0.05
Kobert72: is sitting out 
iqpower: posts big blind $0.10
*** HOLE CARDS ***
FacuLarrocca: folds 
Kobert72 leaves the table
Spud-JCT: calls $0.10
lastfox: folds 
raydenel: folds 
iqpower: checks 
*** FLOP *** [4c 7h 4d]
iqpower: bets $0.15
Spud-JCT: calls $0.15
*** TURN *** [4c 7h 4d] [6h]
iqpower: bets $0.30
Spud-JCT: calls $0.30
*** RIVER *** [4c 7h 4d 6h] [Tc]
iqpower: checks 
Spud-JCT: checks 
*** SHOW DOWN ***
iqpower: shows [8d 7s] (two pair, Sevens and Fours)
Spud-JCT: shows [4h Ad] (three of a kind, Fours)
KiraLasVegas joins the table at seat #4 
Spud-JCT collected $1.10 from pot
*** SUMMARY ***
Total pot $1.15 | Rake $0.05 
Board [4c 7h 4d 6h Tc]
Seat 1: Spud-JCT showed [4h Ad] and won ($1.10) with three of a kind, Fours
Seat 2: lastfox (button) folded before Flop (didn't bet)
Seat 3: raydenel (small blind) folded before Flop
Seat 5: iqpower (big blind) showed [8d 7s] and lost with two pair, Sevens and Fours
Seat 6: FacuLarrocca folded before Flop (didn't bet)



PokerStars Hand #222968235479:  Hold'em No Limit ($0.05/$0.10 USD) - 2021/01/23 15:08:15 ET
Table 'Transvaalia' 6-max Seat #3 is the button
Seat 1: Spud-JCT ($10.52 in chips) 
Seat 2: lastfox ($20.75 in chips) 
Seat 3: raydenel ($13.37 in chips) 
Seat 5: iqpower ($10 in chips) 
Seat 6: FacuLarrocca ($10 in chips) 
iqpower: posts small blind $0.05
FacuLarrocca: posts big blind $0.10
*** HOLE CARDS ***
Spud-JCT: calls $0.10
lastfox: folds 
raydenel: folds 
iqpower: folds 
FacuLarrocca: checks 
*** FLOP *** [Ad Ah Qh]
FacuLarrocca: checks 
Spud-JCT: checks 
*** TURN *** [Ad Ah Qh] [2c]
FacuLarrocca: checks 
Spud-JCT: checks 
*** RIVER *** [Ad Ah Qh 2c] [3s]
FacuLarrocca: checks 
Spud-JCT: checks 
*** SHOW DOWN ***
FacuLarrocca: shows [3d 9h] (two pair, Aces and Threes)
Spud-JCT: mucks hand 
FacuLarrocca collected $0.24 from pot
*** SUMMARY ***
Total pot $0.25 | Rake $0.01 
Board [Ad Ah Qh 2c 3s]
Seat 1: Spud-JCT mucked
Seat 2: lastfox folded before Flop (didn't bet)
Seat 3: raydenel (button) folded before Flop (didn't bet)
Seat 5: iqpower (small blind) folded before Flop
Seat 6: FacuLarrocca (big blind) showed [3d 9h] and won ($0.24) with two pair, Aces and Threes



PokerStars Hand #222968253899:  Hold'em No Limit ($0.05/$0.10 USD) - 2021/01/23 15:08:37 ET
Table 'Transvaalia' 6-max Seat #5 is the button
Seat 1: Spud-JCT ($10.42 in chips) 
Seat 2: lastfox ($20.75 in chips) 
Seat 3: raydenel ($13.37 in chips) 
Seat 5: iqpower ($10 in chips) 
Seat 6: FacuLarrocca ($10.14 in chips) 
FacuLarrocca: posts small blind $0.05
Spud-JCT: posts big blind $0.10
KiraLasVegas: sits out 
*** HOLE CARDS ***
lastfox: folds 
raydenel: raises $0.15 to $0.25
iqpower: folds 
FacuLarrocca: folds 
Spud-JCT: calls $0.15
*** FLOP *** [2h 9c 6s]
Spud-JCT: checks 
raydenel: bets $0.35
Spud-JCT: calls $0.35
*** TURN *** [2h 9c 6s] [4d]
Spud-JCT: checks 
raydenel: bets $0.89
Spud-JCT: calls $0.89
*** RIVER *** [2h 9c 6s 4d] [Kd]
Spud-JCT: checks 
raydenel: bets $2.17
Spud-JCT: calls $2.17
*** SHOW DOWN ***
raydenel: shows [2s 2d] (three of a kind, Deuces)
Spud-JCT: mucks hand 
raydenel collected $7.04 from pot
*** SUMMARY ***
Total pot $7.37 | Rake $0.33 
Board [2h 9c 6s 4d Kd]
Seat 1: Spud-JCT (big blind) mucked
Seat 2: lastfox folded before Flop (didn't bet)
Seat 3: raydenel showed [2s 2d] and won ($7.04) with three of a kind, Deuces
Seat 5: iqpower (button) folded before Flop (didn't bet)
Seat 6: FacuLarrocca (small blind) folded before Flop



PokerStars Hand #222968284079:  Hold'em No Limit ($0.05/$0.10 USD) - 2021/01/23 15:09:13 ET
Table 'Transvaalia' 6-max Seat #6 is the button
Seat 1: Spud-JCT ($6.76 in chips) 
Seat 2: lastfox ($20.75 in chips) 
Seat 3: raydenel ($16.75 in chips) 
Seat 5: iqpower ($10 in chips) 
Seat 6: FacuLarrocca ($10.09 in chips) 
Spud-JCT: posts small blind $0.05
lastfox: posts big blind $0.10
KiraLasVegas: sits out 
*** HOLE CARDS ***
raydenel: folds 
iqpower: folds 
FacuLarrocca: folds 
Spud-JCT: calls $0.05
lastfox: checks 
*** FLOP *** [9h Jh 8d]
Spud-JCT: checks 
lastfox: checks 
*** TURN *** [9h Jh 8d] [As]
Spud-JCT: checks 
lastfox: checks 
*** RIVER *** [9h Jh 8d As] [7s]
Spud-JCT: checks 
lastfox: checks 
*** SHOW DOWN ***
Spud-JCT: shows [2d 2s] (a pair of Deuces)
lastfox: shows [Tc 5c] (a straight, Seven to Jack)
lastfox collected $0.19 from pot
*** SUMMARY ***
Total pot $0.20 | Rake $0.01 
Board [9h Jh 8d As 7s]
Seat 1: Spud-JCT (small blind) showed [2d 2s] and lost with a pair of Deuces
Seat 2: lastfox (big blind) showed [Tc 5c] and won ($0.19) with a straight, Seven to Jack
Seat 3: raydenel folded before Flop (didn't bet)
Seat 5: iqpower folded before Flop (didn't bet)
Seat 6: FacuLarrocca (button) folded before Flop (didn't bet)



PokerStars Hand #222968323059:  Hold'em No Limit ($0.05/$0.10 USD) - 2021/01/23 15:09:59 ET
Table 'Transvaalia' 6-max Seat #1 is the button
Seat 1: Spud-JCT ($6.66 in chips) 
Seat 2: lastfox ($20.84 in chips) 
Seat 3: raydenel ($16.75 in chips) 
Seat 5: iqpower ($10 in chips) 
Seat 6: FacuLarrocca ($10.09 in chips) 
lastfox: posts small blind $0.05
raydenel: posts big blind $0.10
KiraLasVegas: sits out 
*** HOLE CARDS ***
iqpower: folds 
FacuLarrocca: raises $0.20 to $0.30
Spud-JCT: folds 
lastfox: folds 
raydenel: folds 
Uncalled bet ($0.20) returned to FacuLarrocca
FacuLarrocca collected $0.25 from pot
FacuLarrocca: doesn't show hand 
*** SUMMARY ***
Total pot $0.25 | Rake $0 
Seat 1: Spud-JCT (button) folded before Flop (didn't bet)
Seat 2: lastfox (small blind) folded before Flop
Seat 3: raydenel (big blind) folded before Flop
Seat 5: iqpower folded before Flop (didn't bet)
Seat 6: FacuLarrocca collected ($0.25)



PokerStars Hand #222968335427:  Hold'em No Limit ($0.05/$0.10 USD) - 2021/01/23 15:10:14 ET
Table 'Transvaalia' 6-max Seat #2 is the button
Seat 1: Spud-JCT ($6.66 in chips) 
Seat 2: lastfox ($20.79 in chips) 
Seat 3: raydenel ($16.65 in chips) 
Seat 4: KiraLasVegas ($10 in chips) 
Seat 5: iqpower ($10 in chips) 
Seat 6: FacuLarrocca ($10.24 in chips) 
raydenel: posts small blind $0.05
KiraLasVegas: posts big blind $0.10
*** HOLE CARDS ***
iqpower: folds 
FacuLarrocca: folds 
Spud-JCT: calls $0.10
lastfox: folds 
raydenel: calls $0.05
KiraLasVegas: raises $0.30 to $0.40
Spud-JCT: calls $0.30
raydenel: folds 
*** FLOP *** [8d 3h Ts]
KiraLasVegas: bets $0.30
Spud-JCT: folds 
Uncalled bet ($0.30) returned to KiraLasVegas
KiraLasVegas collected $0.86 from pot
KiraLasVegas: doesn't show hand 
*** SUMMARY ***
Total pot $0.90 | Rake $0.04 
Board [8d 3h Ts]
Seat 1: Spud-JCT folded on the Flop
Seat 2: lastfox (button) folded before Flop (didn't bet)
Seat 3: raydenel (small blind) folded before Flop
Seat 4: KiraLasVegas (big blind) collected ($0.86)
Seat 5: iqpower folded before Flop (didn't bet)
Seat 6: FacuLarrocca folded before Flop (didn't bet)



PokerStars Hand #222968364924:  Hold'em No Limit ($0.05/$0.10 USD) - 2021/01/23 15:10:49 ET
Table 'Transvaalia' 6-max Seat #3 is the button
Seat 1: Spud-JCT ($6.26 in chips) 
Seat 2: lastfox ($20.79 in chips) 
Seat 3: raydenel ($16.55 in chips) 
Seat 4: KiraLasVegas ($10.46 in chips) 
Seat 5: iqpower ($10 in chips) 
Seat 6: FacuLarrocca ($10.24 in chips) 
KiraLasVegas: posts small blind $0.05
iqpower: posts big blind $0.10
*** HOLE CARDS ***
FacuLarrocca: raises $0.20 to $0.30
Spud-JCT: calls $0.30
lastfox: folds 
raydenel: folds 
KiraLasVegas: folds 
iqpower: folds 
*** FLOP *** [Js 9d Ts]
FacuLarrocca: checks 
Spud-JCT: checks 
*** TURN *** [Js 9d Ts] [Tc]
FacuLarrocca: bets $0.54
Spud-JCT: calls $0.54
*** RIVER *** [Js 9d Ts Tc] [5h]
FacuLarrocca: checks 
Spud-JCT: checks 
*** SHOW DOWN ***
FacuLarrocca: shows [9c Qc] (two pair, Tens and Nines)
Spud-JCT: mucks hand 
FacuLarrocca collected $1.75 from pot
*** SUMMARY ***
Total pot $1.83 | Rake $0.08 
Board [Js 9d Ts Tc 5h]
Seat 1: Spud-JCT mucked
Seat 2: lastfox folded before Flop (didn't bet)
Seat 3: raydenel (button) folded before Flop (didn't bet)
Seat 4: KiraLasVegas (small blind) folded before Flop
Seat 5: iqpower (big blind) folded before Flop
Seat 6: FacuLarrocca showed [9c Qc] and won ($1.75) with two pair, Tens and Nines



PokerStars Hand #222968393987:  Hold'em No Limit ($0.05/$0.10 USD) - 2021/01/23 15:11:24 ET
Table 'Transvaalia' 6-max Seat #4 is the button
Seat 1: Spud-JCT ($5.42 in chips) 
Seat 2: lastfox ($20.79 in chips) 
Seat 3: raydenel ($16.55 in chips) 
Seat 4: KiraLasVegas ($10.41 in chips) 
Seat 5: iqpower ($10 in chips) 
Seat 6: FacuLarrocca ($11.15 in chips) 
iqpower: posts small blind $0.05
FacuLarrocca: posts big blind $0.10
*** HOLE CARDS ***
Spud-JCT: calls $0.10
lastfox: folds 
raydenel: folds 
KiraLasVegas: folds 
iqpower: folds 
FacuLarrocca: checks 
*** FLOP *** [3h Ac 2d]
FacuLarrocca: checks 
Spud-JCT: checks 
*** TURN *** [3h Ac 2d] [Ah]
FacuLarrocca: checks 
Spud-JCT: checks 
*** RIVER *** [3h Ac 2d Ah] [Tc]
FacuLarrocca: bets $0.18
Spud-JCT: folds 
Uncalled bet ($0.18) returned to FacuLarrocca
FacuLarrocca collected $0.24 from pot
FacuLarrocca: doesn't show hand 
*** SUMMARY ***
Total pot $0.25 | Rake $0.01 
Board [3h Ac 2d Ah Tc]
Seat 1: Spud-JCT folded on the River
Seat 2: lastfox folded before Flop (didn't bet)
Seat 3: raydenel folded before Flop (didn't bet)
Seat 4: KiraLasVegas (button) folded before Flop (didn't bet)
Seat 5: iqpower (small blind) folded before Flop
Seat 6: FacuLarrocca (big blind) collected ($0.24)



PokerStars Hand #222968415272:  Hold'em No Limit ($0.05/$0.10 USD) - 2021/01/23 15:11:49 ET
Table 'Transvaalia' 6-max Seat #5 is the button
Seat 1: Spud-JCT ($5.32 in chips) 
Seat 2: lastfox ($20.79 in chips) 
Seat 3: raydenel ($16.55 in chips) 
Seat 4: KiraLasVegas ($10.41 in chips) 
Seat 5: iqpower ($10 in chips) 
Seat 6: FacuLarrocca ($11.29 in chips) 
FacuLarrocca: posts small blind $0.05
Spud-JCT: posts big blind $0.10
*** HOLE CARDS ***
lastfox: folds 
raydenel: folds 
KiraLasVegas: folds 
iqpower: folds 
FacuLarrocca: raises $0.20 to $0.30
Spud-JCT: calls $0.20
*** FLOP *** [2h 8s 3c]
FacuLarrocca: checks 
Spud-JCT: checks 
*** TURN *** [2h 8s 3c] [3s]
FacuLarrocca: checks 
Spud-JCT: checks 
*** RIVER *** [2h 8s 3c 3s] [Ks]
FacuLarrocca: bets $0.43
Spud-JCT: folds 
Uncalled bet ($0.43) returned to FacuLarrocca
FacuLarrocca collected $0.57 from pot
FacuLarrocca: doesn't show hand 
*** SUMMARY ***
Total pot $0.60 | Rake $0.03 
Board [2h 8s 3c 3s Ks]
Seat 1: Spud-JCT (big blind) folded on the River
Seat 2: lastfox folded before Flop (didn't bet)
Seat 3: raydenel folded before Flop (didn't bet)
Seat 4: KiraLasVegas folded before Flop (didn't bet)
Seat 5: iqpower (button) folded before Flop (didn't bet)
Seat 6: FacuLarrocca (small blind) collected ($0.57)



PokerStars Hand #222968444571:  Hold'em No Limit ($0.05/$0.10 USD) - 2021/01/23 15:12:16 ET
Table 'Transvaalia' 6-max Seat #6 is the button
Seat 1: Spud-JCT ($5.02 in chips) 
Seat 2: lastfox ($20.79 in chips) 
Seat 3: raydenel ($16.55 in chips) 
Seat 4: KiraLasVegas ($10.41 in chips) 
Seat 5: iqpower ($10 in chips) 
Seat 6: FacuLarrocca ($11.56 in chips) 
Spud-JCT: posts small blind $0.05
lastfox: posts big blind $0.10
*** HOLE CARDS ***
raydenel: folds 
KiraLasVegas: folds 
iqpower: raises $0.15 to $0.25
FacuLarrocca: folds 
Spud-JCT: folds 
lastfox: folds 
Uncalled bet ($0.15) returned to iqpower
iqpower collected $0.25 from pot
iqpower: doesn't show hand 
*** SUMMARY ***
Total pot $0.25 | Rake $0 
Seat 1: Spud-JCT (small blind) folded before Flop
Seat 2: lastfox (big blind) folded before Flop
Seat 3: raydenel folded before Flop (didn't bet)
Seat 4: KiraLasVegas folded before Flop (didn't bet)
Seat 5: iqpower collected ($0.25)
Seat 6: FacuLarrocca (button) folded before Flop (didn't bet)



PokerStars Hand #222968460605:  Hold'em No Limit ($0.05/$0.10 USD) - 2021/01/23 15:12:35 ET
Table 'Transvaalia' 6-max Seat #1 is the button
Seat 1: Spud-JCT ($4.97 in chips) 
Seat 2: lastfox ($20.69 in chips) 
Seat 3: raydenel ($16.55 in chips) 
Seat 4: KiraLasVegas ($10.41 in chips) 
Seat 5: iqpower ($10.15 in chips) 
Seat 6: FacuLarrocca ($11.56 in chips) 
lastfox: posts small blind $0.05
raydenel: posts big blind $0.10
*** HOLE CARDS ***
KiraLasVegas: folds 
iqpower: folds 
FacuLarrocca: folds 
Spud-JCT: calls $0.10
lastfox: folds 
raydenel: checks 
*** FLOP *** [4c 5d Kc]
raydenel: bets $0.12
Spud-JCT: calls $0.12
*** TURN *** [4c 5d Kc] [9c]
raydenel: bets $0.24
Spud-JCT: calls $0.24
*** RIVER *** [4c 5d Kc 9c] [9s]
raydenel: checks 
Spud-JCT: checks 
*** SHOW DOWN ***
raydenel: shows [Kh Tc] (two pair, Kings and Nines)
Spud-JCT: mucks hand 
raydenel collected $0.93 from pot
*** SUMMARY ***
Total pot $0.97 | Rake $0.04 
Board [4c 5d Kc 9c 9s]
Seat 1: Spud-JCT (button) mucked
Seat 2: lastfox (small blind) folded before Flop
Seat 3: raydenel (big blind) showed [Kh Tc] and won ($0.93) with two pair, Kings and Nines
Seat 4: KiraLasVegas folded before Flop (didn't bet)
Seat 5: iqpower folded before Flop (didn't bet)
Seat 6: FacuLarrocca folded before Flop (didn't bet)



PokerStars Hand #222968494354:  Hold'em No Limit ($0.05/$0.10 USD) - 2021/01/23 15:13:15 ET
Table 'Transvaalia' 6-max Seat #2 is the button
Seat 1: Spud-JCT ($4.51 in chips) 
Seat 2: lastfox ($20.64 in chips) 
Seat 3: raydenel ($17.02 in chips) 
Seat 4: KiraLasVegas ($10.41 in chips) 
Seat 5: iqpower ($10.15 in chips) 
Seat 6: FacuLarrocca ($11.56 in chips) 
raydenel: posts small blind $0.05
KiraLasVegas: posts big blind $0.10
*** HOLE CARDS ***
iqpower: folds 
FacuLarrocca: raises $0.20 to $0.30
Spud-JCT: raises $0.20 to $0.50
lastfox: folds 
raydenel: folds 
KiraLasVegas: folds 
FacuLarrocca: calls $0.20
*** FLOP *** [3s 4d 9h]
FacuLarrocca: checks 
Spud-JCT: checks 
*** TURN *** [3s 4d 9h] [Kc]
FacuLarrocca: checks 
Spud-JCT: checks 
*** RIVER *** [3s 4d 9h Kc] [4s]
FacuLarrocca: checks 
Spud-JCT: checks 
*** SHOW DOWN ***
FacuLarrocca: shows [Ac Jc] (a pair of Fours)
Spud-JCT: mucks hand 
FacuLarrocca collected $1.10 from pot
*** SUMMARY ***
Total pot $1.15 | Rake $0.05 
Board [3s 4d 9h Kc 4s]
Seat 1: Spud-JCT mucked
Seat 2: lastfox (button) folded before Flop (didn't bet)
Seat 3: raydenel (small blind) folded before Flop
Seat 4: KiraLasVegas (big blind) folded before Flop
Seat 5: iqpower folded before Flop (didn't bet)
Seat 6: FacuLarrocca showed [Ac Jc] and won ($1.10) with a pair of Fours



PokerStars Hand #222968517082:  Hold'em No Limit ($0.05/$0.10 USD) - 2021/01/23 15:13:42 ET
Table 'Transvaalia' 6-max Seat #3 is the button
Seat 1: Spud-JCT ($4.01 in chips) 
Seat 2: lastfox ($20.64 in chips) 
Seat 3: raydenel ($16.97 in chips) 
Seat 4: KiraLasVegas ($10.31 in chips) 
Seat 6: FacuLarrocca ($12.16 in chips) 
KiraLasVegas: posts small blind $0.05
iqpower: is sitting out 
FacuLarrocca: posts big blind $0.10
*** HOLE CARDS ***
Spud-JCT: calls $0.10
lastfox: folds 
raydenel: folds 
iqpower leaves the table
KiraLasVegas: calls $0.05
Viten'kA83 joins the table at seat #5 
FacuLarrocca: raises $0.30 to $0.40
Spud-JCT: calls $0.30
KiraLasVegas: folds 
*** FLOP *** [2d 4c 3h]
FacuLarrocca: checks 
Spud-JCT: checks 
*** TURN *** [2d 4c 3h] [Th]
FacuLarrocca: bets $0.28
Viten'kA83 leaves the table
Spud-JCT: calls $0.28
*** RIVER *** [2d 4c 3h Th] [7d]
FacuLarrocca: checks 
Spud-JCT: checks 
*** SHOW DOWN ***
FacuLarrocca: shows [Jc 9c] (high card Jack)
Spud-JCT: shows [Ac Kc] (high card Ace)
Spud-JCT collected $1.39 from pot
*** SUMMARY ***
Total pot $1.46 | Rake $0.07 
Board [2d 4c 3h Th 7d]
Seat 1: Spud-JCT showed [Ac Kc] and won ($1.39) with high card Ace
Seat 2: lastfox folded before Flop (didn't bet)
Seat 3: raydenel (button) folded before Flop (didn't bet)
Seat 4: KiraLasVegas (small blind) folded before Flop
Seat 6: FacuLarrocca (big blind) showed [Jc 9c] and lost with high card Jack



PokerStars Hand #222968553657:  Hold'em No Limit ($0.05/$0.10 USD) - 2021/01/23 15:14:26 ET
Table 'Transvaalia' 6-max Seat #4 is the button
Seat 1: Spud-JCT ($4.72 in chips) 
Seat 2: lastfox ($20.64 in chips) 
Seat 3: raydenel ($16.97 in chips) 
Seat 4: KiraLasVegas ($10.21 in chips) 
Seat 6: FacuLarrocca ($11.48 in chips) 
Kobert72 joins the table at seat #5 
FacuLarrocca: posts small blind $0.05
Spud-JCT: posts big blind $0.10
*** HOLE CARDS ***
lastfox: folds 
raydenel: folds 
KiraLasVegas: raises $0.15 to $0.25
FacuLarrocca: folds 
Spud-JCT: calls $0.15
*** FLOP *** [2c 3h Jd]
Spud-JCT: checks 
KiraLasVegas: bets $0.19
Spud-JCT: calls $0.19
*** TURN *** [2c 3h Jd] [Ts]
Spud-JCT: checks 
KiraLasVegas: bets $0.31
Spud-JCT: folds 
Uncalled bet ($0.31) returned to KiraLasVegas
KiraLasVegas collected $0.89 from pot
KiraLasVegas: doesn't show hand 
*** SUMMARY ***
Total pot $0.93 | Rake $0.04 
Board [2c 3h Jd Ts]
Seat 1: Spud-JCT (big blind) folded on the Turn
Seat 2: lastfox folded before Flop (didn't bet)
Seat 3: raydenel folded before Flop (didn't bet)
Seat 4: KiraLasVegas (button) collected ($0.89)
Seat 6: FacuLarrocca (small blind) folded before Flop



PokerStars Hand #222968587913:  Hold'em No Limit ($0.05/$0.10 USD) - 2021/01/23 15:15:07 ET
Table 'Transvaalia' 6-max Seat #6 is the button
Seat 1: Spud-JCT ($4.28 in chips) 
Seat 2: lastfox ($20.64 in chips) 
Seat 3: raydenel ($16.97 in chips) 
Seat 4: KiraLasVegas ($10.66 in chips) 
Seat 6: FacuLarrocca ($11.43 in chips) 
Spud-JCT: posts small blind $0.05
lastfox: posts big blind $0.10
Kobert72: sits out 
*** HOLE CARDS ***
raydenel: raises $0.20 to $0.30
KiraLasVegas: folds 
FacuLarrocca: folds 
Spud-JCT: folds 
lastfox: folds 
Uncalled bet ($0.20) returned to raydenel
raydenel collected $0.25 from pot
raydenel: doesn't show hand 
*** SUMMARY ***
Total pot $0.25 | Rake $0 
Seat 1: Spud-JCT (small blind) folded before Flop
Seat 2: lastfox (big blind) folded before Flop
Seat 3: raydenel collected ($0.25)
Seat 4: KiraLasVegas folded before Flop (didn't bet)
Seat 6: FacuLarrocca (button) folded before Flop (didn't bet)



PokerStars Hand #222968610556:  Hold'em No Limit ($0.05/$0.10 USD) - 2021/01/23 15:15:33 ET
Table 'Transvaalia' 6-max Seat #1 is the button
Seat 1: Spud-JCT ($4.23 in chips) 
Seat 2: lastfox ($20.54 in chips) 
Seat 3: raydenel ($17.12 in chips) 
Seat 4: KiraLasVegas ($10.66 in chips) 
Seat 6: FacuLarrocca ($11.43 in chips) 
lastfox: posts small blind $0.05
raydenel: posts big blind $0.10
Kobert72: sits out 
*** HOLE CARDS ***
KiraLasVegas: folds 
FacuLarrocca: raises $0.20 to $0.30
KiraLasVegas leaves the table
Spud-JCT: calls $0.30
lastfox: folds 
raydenel: calls $0.20
*** FLOP *** [4c Td 5d]
raydenel: checks 
FacuLarrocca: checks 
Spud-JCT: checks 
*** TURN *** [4c Td 5d] [8d]
raydenel: checks 
FacuLarrocca: checks 
Spud-JCT: checks 
*** RIVER *** [4c Td 5d 8d] [9d]
raydenel: checks 
FacuLarrocca: checks 
Spud-JCT: checks 
*** SHOW DOWN ***
raydenel: shows [4s 3d] (a flush, Ten high)
FacuLarrocca: mucks hand 
Spud-JCT: mucks hand 
raydenel collected $0.91 from pot
*** SUMMARY ***
Total pot $0.95 | Rake $0.04 
Board [4c Td 5d 8d 9d]
Seat 1: Spud-JCT (button) mucked
Seat 2: lastfox (small blind) folded before Flop
Seat 3: raydenel (big blind) showed [4s 3d] and won ($0.91) with a flush, Ten high
Seat 4: KiraLasVegas folded before Flop (didn't bet)
Seat 6: FacuLarrocca mucked



PokerStars Hand #222968640005:  Hold'em No Limit ($0.05/$0.10 USD) - 2021/01/23 15:16:08 ET
Table 'Transvaalia' 6-max Seat #2 is the button
Seat 1: Spud-JCT ($3.93 in chips) 
Seat 2: lastfox ($20.49 in chips) 
Seat 3: raydenel ($17.73 in chips) 
Seat 5: Kobert72 ($10.38 in chips) 
Seat 6: FacuLarrocca ($11.13 in chips) 
raydenel: posts small blind $0.05
Kobert72: posts big blind $0.10
*** HOLE CARDS ***
FacuLarrocca: folds 
Spud-JCT: calls $0.10
lastfox: raises $0.23 to $0.33
raydenel: folds 
Jürgen_huber joins the table at seat #4 
Kobert72: folds 
Spud-JCT: calls $0.23
*** FLOP *** [7d 9d 7h]
Spud-JCT: checks 
lastfox: checks 
*** TURN *** [7d 9d 7h] [Th]
Spud-JCT: checks 
lastfox: checks 
*** RIVER *** [7d 9d 7h Th] [Kh]
Spud-JCT: checks 
lastfox: checks 
*** SHOW DOWN ***
Spud-JCT: shows [Jc 4c] (a pair of Sevens)
lastfox: shows [8c Kc] (two pair, Kings and Sevens)
lastfox collected $0.77 from pot
*** SUMMARY ***
Total pot $0.81 | Rake $0.04 
Board [7d 9d 7h Th Kh]
Seat 1: Spud-JCT showed [Jc 4c] and lost with a pair of Sevens
Seat 2: lastfox (button) showed [8c Kc] and won ($0.77) with two pair, Kings and Sevens
Seat 3: raydenel (small blind) folded before Flop
Seat 5: Kobert72 (big blind) folded before Flop
Seat 6: FacuLarrocca folded before Flop (didn't bet)



PokerStars Hand #222968671001:  Hold'em No Limit ($0.05/$0.10 USD) - 2021/01/23 15:16:44 ET
Table 'Transvaalia' 6-max Seat #3 is the button
Seat 1: Spud-JCT ($3.60 in chips) 
Seat 2: lastfox ($20.93 in chips) 
Seat 3: raydenel ($17.68 in chips) 
Seat 5: Kobert72 ($10.28 in chips) 
Seat 6: FacuLarrocca ($11.13 in chips) 
Kobert72: posts small blind $0.05
FacuLarrocca: posts big blind $0.10
*** HOLE CARDS ***
Spud-JCT: calls $0.10
lastfox: folds 
raydenel: folds 
Kobert72: folds 
FacuLarrocca: checks 
*** FLOP *** [3c 6d Ks]
FacuLarrocca: checks 
Spud-JCT: checks 
*** TURN *** [3c 6d Ks] [5d]
FacuLarrocca: checks 
Spud-JCT: checks 
*** RIVER *** [3c 6d Ks 5d] [9d]
FacuLarrocca: checks 
Spud-JCT: bets $3.50 and is all-in
FacuLarrocca: folds 
Uncalled bet ($3.50) returned to Spud-JCT
Spud-JCT collected $0.24 from pot
Spud-JCT: doesn't show hand 
*** SUMMARY ***
Total pot $0.25 | Rake $0.01 
Board [3c 6d Ks 5d 9d]
Seat 1: Spud-JCT collected ($0.24)
Seat 2: lastfox folded before Flop (didn't bet)
Seat 3: raydenel (button) folded before Flop (didn't bet)
Seat 5: Kobert72 (small blind) folded before Flop
Seat 6: FacuLarrocca (big blind) folded on the River



PokerStars Hand #222968697321:  Hold'em No Limit ($0.05/$0.10 USD) - 2021/01/23 15:17:15 ET
Table 'Transvaalia' 6-max Seat #5 is the button
Seat 1: Spud-JCT ($3.74 in chips) 
Seat 2: lastfox ($20.93 in chips) 
Seat 3: raydenel ($17.68 in chips) 
Seat 5: Kobert72 ($10.23 in chips) 
Seat 6: FacuLarrocca ($11.03 in chips) 
FacuLarrocca: posts small blind $0.05
Spud-JCT: posts big blind $0.10
Jürgen_huber: sits out 
*** HOLE CARDS ***
lastfox: folds 
raydenel: folds 
Kobert72: raises $0.13 to $0.23
FacuLarrocca: folds 
Spud-JCT: calls $0.13
*** FLOP *** [Ts 2d 4d]
Spud-JCT: checks 
Kobert72: checks 
*** TURN *** [Ts 2d 4d] [8h]
Spud-JCT: checks 
Jürgen_huber leaves the table
Kobert72: checks 
*** RIVER *** [Ts 2d 4d 8h] [7d]
Spud-JCT: bets $1.40
Kobert72: folds 
Uncalled bet ($1.40) returned to Spud-JCT
Spud-JCT collected $0.49 from pot
Spud-JCT: doesn't show hand 
*** SUMMARY ***
Total pot $0.51 | Rake $0.02 
Board [Ts 2d 4d 8h 7d]
Seat 1: Spud-JCT (big blind) collected ($0.49)
Seat 2: lastfox folded before Flop (didn't bet)
Seat 3: raydenel folded before Flop (didn't bet)
Seat 5: Kobert72 (button) folded on the River
Seat 6: FacuLarrocca (small blind) folded before Flop



PokerStars Hand #222968734025:  Hold'em No Limit ($0.05/$0.10 USD) - 2021/01/23 15:17:58 ET
Table 'Transvaalia' 6-max Seat #6 is the button
Seat 1: Spud-JCT ($4 in chips) 
Seat 2: lastfox ($20.93 in chips) 
Seat 3: raydenel ($17.68 in chips) 
Seat 5: Kobert72 ($10 in chips) 
Seat 6: FacuLarrocca ($10.98 in chips) 
Spud-JCT: posts small blind $0.05
lastfox: posts big blind $0.10
*** HOLE CARDS ***
raydenel: folds 
Kobert72: raises $0.13 to $0.23
FacuLarrocca: folds 
Spud-JCT: calls $0.18
lastfox: folds 
*** FLOP *** [Ts 9s 3h]
Spud-JCT: checks 
Kobert72: bets $0.40
imam skalu joins the table at seat #4 
Spud-JCT: folds 
Uncalled bet ($0.40) returned to Kobert72
Kobert72 collected $0.53 from pot
Kobert72: doesn't show hand 
*** SUMMARY ***
Total pot $0.56 | Rake $0.03 
Board [Ts 9s 3h]
Seat 1: Spud-JCT (small blind) folded on the Flop
Seat 2: lastfox (big blind) folded before Flop
Seat 3: raydenel folded before Flop (didn't bet)
Seat 5: Kobert72 collected ($0.53)
Seat 6: FacuLarrocca (button) folded before Flop (didn't bet)



PokerStars Hand #222968759025:  Hold'em No Limit ($0.05/$0.10 USD) - 2021/01/23 15:18:27 ET
Table 'Transvaalia' 6-max Seat #1 is the button
Seat 1: Spud-JCT ($3.77 in chips) 
Seat 2: lastfox ($20.83 in chips) 
Seat 3: raydenel ($17.68 in chips) 
Seat 5: Kobert72 ($10.30 in chips) 
Seat 6: FacuLarrocca ($10.98 in chips) 
lastfox: posts small blind $0.05
raydenel: posts big blind $0.10
imam skalu: is sitting out 
*** HOLE CARDS ***
imam skalu leaves the table
Kobert72: raises $0.13 to $0.23
FacuLarrocca: folds 
Spud-JCT: folds 
lastfox: folds 
raydenel: folds 
Uncalled bet ($0.13) returned to Kobert72
Kobert72 collected $0.25 from pot
Kobert72: doesn't show hand 
*** SUMMARY ***
Total pot $0.25 | Rake $0 
Seat 1: Spud-JCT (button) folded before Flop (didn't bet)
Seat 2: lastfox (small blind) folded before Flop
Seat 3: raydenel (big blind) folded before Flop
Seat 5: Kobert72 collected ($0.25)
Seat 6: FacuLarrocca folded before Flop (didn't bet)



PokerStars Hand #222968771779:  Hold'em No Limit ($0.05/$0.10 USD) - 2021/01/23 15:18:42 ET
Table 'Transvaalia' 6-max Seat #2 is the button
Seat 1: Spud-JCT ($3.77 in chips) 
Seat 2: lastfox ($20.78 in chips) 
Seat 3: raydenel ($17.58 in chips) 
Seat 5: Kobert72 ($10.45 in chips) 
Seat 6: FacuLarrocca ($10.98 in chips) 
raydenel: posts small blind $0.05
Kobert72: posts big blind $0.10
*** HOLE CARDS ***
FacuLarrocca: folds 
Spud-JCT: calls $0.10
lastfox: folds 
raydenel: calls $0.05
Kobert72: checks 
*** FLOP *** [3c 7c 2h]
imam skalu joins the table at seat #4 
raydenel: checks 
Kobert72: checks 
Spud-JCT: checks 
*** TURN *** [3c 7c 2h] [3d]
raydenel: checks 
Kobert72: checks 
Spud-JCT: checks 
*** RIVER *** [3c 7c 2h 3d] [Kd]
raydenel: checks 
Kobert72: checks 
Spud-JCT: checks 
*** SHOW DOWN ***
raydenel: shows [Qs Td] (a pair of Threes)
Kobert72: mucks hand 
Spud-JCT: shows [5c 2c] (two pair, Threes and Deuces)
Spud-JCT collected $0.29 from pot
*** SUMMARY ***
Total pot $0.30 | Rake $0.01 
Board [3c 7c 2h 3d Kd]
Seat 1: Spud-JCT showed [5c 2c] and won ($0.29) with two pair, Threes and Deuces
Seat 2: lastfox (button) folded before Flop (didn't bet)
Seat 3: raydenel (small blind) showed [Qs Td] and lost with a pair of Threes
Seat 5: Kobert72 (big blind) mucked
Seat 6: FacuLarrocca folded before Flop (didn't bet)



PokerStars Hand #222968805972:  Hold'em No Limit ($0.05/$0.10 USD) - 2021/01/23 15:19:22 ET
Table 'Transvaalia' 6-max Seat #3 is the button
Seat 1: Spud-JCT ($3.96 in chips) 
Seat 2: lastfox ($20.78 in chips) 
Seat 3: raydenel ($17.48 in chips) 
Seat 5: Kobert72 ($10.35 in chips) 
Seat 6: FacuLarrocca ($10.98 in chips) 
Kobert72: posts small blind $0.05
FacuLarrocca: posts big blind $0.10
*** HOLE CARDS ***
Spud-JCT: calls $0.10
lastfox: folds 
raydenel: folds 
Kobert72: folds 
FacuLarrocca: raises $0.30 to $0.40
Spud-JCT: calls $0.30
*** FLOP *** [7s Jh 2s]
FacuLarrocca: checks 
Spud-JCT: checks 
*** TURN *** [7s Jh 2s] [8h]
FacuLarrocca: checks 
Spud-JCT: checks 
*** RIVER *** [7s Jh 2s 8h] [2h]
FacuLarrocca: checks 
Spud-JCT: checks 
*** SHOW DOWN ***
FacuLarrocca: shows [Kd Td] (a pair of Deuces)
Spud-JCT: shows [4s 8s] (two pair, Eights and Deuces)
Spud-JCT collected $0.81 from pot
*** SUMMARY ***
Total pot $0.85 | Rake $0.04 
Board [7s Jh 2s 8h 2h]
Seat 1: Spud-JCT showed [4s 8s] and won ($0.81) with two pair, Eights and Deuces
Seat 2: lastfox folded before Flop (didn't bet)
Seat 3: raydenel (button) folded before Flop (didn't bet)
Seat 5: Kobert72 (small blind) folded before Flop
Seat 6: FacuLarrocca (big blind) showed [Kd Td] and lost with a pair of Deuces



PokerStars Hand #222968829084:  Hold'em No Limit ($0.05/$0.10 USD) - 2021/01/23 15:19:49 ET
Table 'Transvaalia' 6-max Seat #5 is the button
Seat 1: Spud-JCT ($4.37 in chips) 
Seat 2: lastfox ($20.78 in chips) 
Seat 3: raydenel ($17.48 in chips) 
Seat 5: Kobert72 ($10.30 in chips) 
Seat 6: FacuLarrocca ($10.58 in chips) 
FacuLarrocca: posts small blind $0.05
Spud-JCT: posts big blind $0.10
imam skalu: sits out 
*** HOLE CARDS ***
lastfox: folds 
raydenel: folds 
Kobert72: raises $0.13 to $0.23
FacuLarrocca: folds 
Spud-JCT: folds 
Uncalled bet ($0.13) returned to Kobert72
Kobert72 collected $0.25 from pot
Kobert72: doesn't show hand 
*** SUMMARY ***
Total pot $0.25 | Rake $0 
Seat 1: Spud-JCT (big blind) folded before Flop
Seat 2: lastfox folded before Flop (didn't bet)
Seat 3: raydenel folded before Flop (didn't bet)
Seat 5: Kobert72 (button) collected ($0.25)
Seat 6: FacuLarrocca (small blind) folded before Flop



PokerStars Hand #222968840876:  Hold'em No Limit ($0.05/$0.10 USD) - 2021/01/23 15:20:03 ET
Table 'Transvaalia' 6-max Seat #6 is the button
Seat 1: Spud-JCT ($4.27 in chips) 
Seat 2: lastfox ($20.78 in chips) 
Seat 3: raydenel ($17.48 in chips) 
Seat 5: Kobert72 ($10.45 in chips) 
Seat 6: FacuLarrocca ($10.53 in chips) 
Spud-JCT: posts small blind $0.05
lastfox: posts big blind $0.10
imam skalu: sits out 
*** HOLE CARDS ***
raydenel: folds 
Kobert72: raises $0.13 to $0.23
FacuLarrocca: folds 
Spud-JCT: calls $0.18
lastfox: folds 
*** FLOP *** [4s 3d 8s]
Spud-JCT: checks 
Kobert72: checks 
*** TURN *** [4s 3d 8s] [7h]
Spud-JCT: checks 
Kobert72: bets $0.40
Spud-JCT: calls $0.40
*** RIVER *** [4s 3d 8s 7h] [5d]
Spud-JCT: bets $0.80
Kobert72: folds 
Uncalled bet ($0.80) returned to Spud-JCT
Spud-JCT collected $1.30 from pot
Spud-JCT: doesn't show hand 
*** SUMMARY ***
Total pot $1.36 | Rake $0.06 
Board [4s 3d 8s 7h 5d]
Seat 1: Spud-JCT (small blind) collected ($1.30)
Seat 2: lastfox (big blind) folded before Flop
Seat 3: raydenel folded before Flop (didn't bet)
Seat 5: Kobert72 folded on the River
Seat 6: FacuLarrocca (button) folded before Flop (didn't bet)



PokerStars Hand #222968879945:  Hold'em No Limit ($0.05/$0.10 USD) - 2021/01/23 15:20:49 ET
Table 'Transvaalia' 6-max Seat #1 is the button
Seat 1: Spud-JCT ($4.94 in chips) 
Seat 2: lastfox ($20.68 in chips) 
Seat 3: raydenel ($17.48 in chips) 
Seat 5: Kobert72 ($10 in chips) 
Seat 6: FacuLarrocca ($10.53 in chips) 
lastfox: posts small blind $0.05
raydenel: posts big blind $0.10
imam skalu: sits out 
*** HOLE CARDS ***
Kobert72: folds 
FacuLarrocca: folds 
Spud-JCT: calls $0.10
lastfox: folds 
raydenel: checks 
*** FLOP *** [Ts Qs 6c]
raydenel: checks 
Spud-JCT: checks 
*** TURN *** [Ts Qs 6c] [7s]
raydenel: bets $0.12
Spud-JCT: folds 
Uncalled bet ($0.12) returned to raydenel
raydenel collected $0.24 from pot
raydenel: doesn't show hand 
*** SUMMARY ***
Total pot $0.25 | Rake $0.01 
Board [Ts Qs 6c 7s]
Seat 1: Spud-JCT (button) folded on the Turn
Seat 2: lastfox (small blind) folded before Flop
Seat 3: raydenel (big blind) collected ($0.24)
Seat 5: Kobert72 folded before Flop (didn't bet)
Seat 6: FacuLarrocca folded before Flop (didn't bet)



PokerStars Hand #222968900741:  Hold'em No Limit ($0.05/$0.10 USD) - 2021/01/23 15:21:13 ET
Table 'Transvaalia' 6-max Seat #2 is the button
Seat 1: Spud-JCT ($4.84 in chips) 
Seat 2: lastfox ($20.63 in chips) 
Seat 3: raydenel ($17.62 in chips) 
Seat 4: imam skalu ($8 in chips) 
Seat 5: Kobert72 ($10 in chips) 
Seat 6: FacuLarrocca ($10.53 in chips) 
raydenel: posts small blind $0.05
imam skalu: posts big blind $0.10
*** HOLE CARDS ***
Kobert72: folds 
FacuLarrocca: folds 
Spud-JCT: calls $0.10
lastfox: raises $0.23 to $0.33
raydenel: folds 
imam skalu: folds 
Spud-JCT: calls $0.23
*** FLOP *** [5h Qh 8s]
Spud-JCT: checks 
lastfox: checks 
*** TURN *** [5h Qh 8s] [As]
Spud-JCT: checks 
lastfox: checks 
*** RIVER *** [5h Qh 8s As] [7h]
Spud-JCT: checks 
lastfox: checks 
*** SHOW DOWN ***
Spud-JCT: shows [Tc Jc] (high card Ace)
lastfox: shows [4h 4d] (a pair of Fours)
lastfox collected $0.77 from pot
*** SUMMARY ***
Total pot $0.81 | Rake $0.04 
Board [5h Qh 8s As 7h]
Seat 1: Spud-JCT showed [Tc Jc] and lost with high card Ace
Seat 2: lastfox (button) showed [4h 4d] and won ($0.77) with a pair of Fours
Seat 3: raydenel (small blind) folded before Flop
Seat 4: imam skalu (big blind) folded before Flop
Seat 5: Kobert72 folded before Flop (didn't bet)
Seat 6: FacuLarrocca folded before Flop (didn't bet)



PokerStars Hand #222968950492:  Hold'em No Limit ($0.05/$0.10 USD) - 2021/01/23 15:22:10 ET
Table 'Transvaalia' 6-max Seat #3 is the button
Seat 1: Spud-JCT ($4.51 in chips) 
Seat 2: lastfox ($21.07 in chips) 
Seat 3: raydenel ($17.57 in chips) 
Seat 4: imam skalu ($7.90 in chips) 
Seat 5: Kobert72 ($10 in chips) 
Seat 6: FacuLarrocca ($10.53 in chips) 
imam skalu: posts small blind $0.05
Kobert72: posts big blind $0.10
*** HOLE CARDS ***
FacuLarrocca: folds 
Spud-JCT: folds 
lastfox: folds 
raydenel: folds 
imam skalu: folds 
Uncalled bet ($0.05) returned to Kobert72
Kobert72 collected $0.10 from pot
Kobert72: doesn't show hand 
*** SUMMARY ***
Total pot $0.10 | Rake $0 
Seat 1: Spud-JCT folded before Flop (didn't bet)
Seat 2: lastfox folded before Flop (didn't bet)
Seat 3: raydenel (button) folded before Flop (didn't bet)
Seat 4: imam skalu (small blind) folded before Flop
Seat 5: Kobert72 (big blind) collected ($0.10)
Seat 6: FacuLarrocca folded before Flop (didn't bet)



PokerStars Hand #222969036069:  Hold'em No Limit ($0.05/$0.10 USD) - 2021/01/23 15:23:49 ET
Table 'Transvaalia' 6-max Seat #1 is the button
Seat 1: Spud-JCT ($4.36 in chips) 
Seat 2: lastfox ($21.27 in chips) 
Seat 3: raydenel ($17.57 in chips) 
Seat 4: imam skalu ($10.96 in chips) 
Seat 5: Kobert72 ($10 in chips) 
Seat 6: FacuLarrocca ($10 in chips) 
lastfox: posts small blind $0.05
raydenel: posts big blind $0.10
*** HOLE CARDS ***
imam skalu: folds 
Kobert72: raises $0.13 to $0.23
FacuLarrocca: folds 
Spud-JCT: folds 
lastfox: folds 
raydenel: calls $0.13
*** FLOP *** [Qs 3s Js]
raydenel: checks 
Kobert72: checks 
*** TURN *** [Qs 3s Js] [3c]
raydenel: bets $0.33
Kobert72: folds 
Uncalled bet ($0.33) returned to raydenel
raydenel collected $0.49 from pot
raydenel: doesn't show hand 
*** SUMMARY ***
Total pot $0.51 | Rake $0.02 
Board [Qs 3s Js 3c]
Seat 1: Spud-JCT (button) folded before Flop (didn't bet)
Seat 2: lastfox (small blind) folded before Flop
Seat 3: raydenel (big blind) collected ($0.49)
Seat 4: imam skalu folded before Flop (didn't bet)
Seat 5: Kobert72 folded on the Turn
Seat 6: FacuLarrocca folded before Flop (didn't bet)



PokerStars Hand #222969062067:  Hold'em No Limit ($0.05/$0.10 USD) - 2021/01/23 15:24:20 ET
Table 'Transvaalia' 6-max Seat #2 is the button
Seat 1: Spud-JCT ($4.36 in chips) 
Seat 2: lastfox ($21.22 in chips) 
Seat 3: raydenel ($17.83 in chips) 
Seat 4: imam skalu ($10.96 in chips) 
Seat 5: Kobert72 ($10 in chips) 
Seat 6: FacuLarrocca ($10 in chips) 
raydenel: posts small blind $0.05
imam skalu: posts big blind $0.10
*** HOLE CARDS ***
Kobert72: folds 
FacuLarrocca: folds 
Spud-JCT: calls $0.10
lastfox: folds 
raydenel: folds 
imam skalu: checks 
*** FLOP *** [Ts Tc 2s]
imam skalu: checks 
Spud-JCT: checks 
*** TURN *** [Ts Tc 2s] [8s]
imam skalu: bets $0.10
Spud-JCT: folds 
Uncalled bet ($0.10) returned to imam skalu
imam skalu collected $0.24 from pot
imam skalu: doesn't show hand 
*** SUMMARY ***
Total pot $0.25 | Rake $0.01 
Board [Ts Tc 2s 8s]
Seat 1: Spud-JCT folded on the Turn
Seat 2: lastfox (button) folded before Flop (didn't bet)
Seat 3: raydenel (small blind) folded before Flop
Seat 4: imam skalu (big blind) collected ($0.24)
Seat 5: Kobert72 folded before Flop (didn't bet)
Seat 6: FacuLarrocca folded before Flop (didn't bet)



PokerStars Hand #222969089066:  Hold'em No Limit ($0.05/$0.10 USD) - 2021/01/23 15:24:51 ET
Table 'Transvaalia' 6-max Seat #3 is the button
Seat 1: Spud-JCT ($4.26 in chips) 
Seat 2: lastfox ($21.22 in chips) 
Seat 3: raydenel ($17.78 in chips) 
Seat 4: imam skalu ($11.10 in chips) 
Seat 5: Kobert72 ($10 in chips) 
Seat 6: FacuLarrocca ($10 in chips) 
imam skalu: posts small blind $0.05
Kobert72: posts big blind $0.10
*** HOLE CARDS ***
FacuLarrocca: raises $0.20 to $0.30
Spud-JCT: folds 
lastfox: folds 
raydenel: calls $0.30
imam skalu: raises $0.70 to $1
Kobert72: folds 
FacuLarrocca: calls $0.70
raydenel: calls $0.70
*** FLOP *** [4c 3h Ks]
imam skalu: bets $1
FacuLarrocca: folds 
raydenel: folds 
Uncalled bet ($1) returned to imam skalu
imam skalu collected $2.96 from pot
imam skalu: doesn't show hand 
*** SUMMARY ***
Total pot $3.10 | Rake $0.14 
Board [4c 3h Ks]
Seat 1: Spud-JCT folded before Flop (didn't bet)
Seat 2: lastfox folded before Flop (didn't bet)
Seat 3: raydenel (button) folded on the Flop
Seat 4: imam skalu (small blind) collected ($2.96)
Seat 5: Kobert72 (big blind) folded before Flop
Seat 6: FacuLarrocca folded on the Flop



PokerStars Hand #222969125216:  Hold'em No Limit ($0.05/$0.10 USD) - 2021/01/23 15:25:33 ET
Table 'Transvaalia' 6-max Seat #4 is the button
Seat 1: Spud-JCT ($4.26 in chips) 
Seat 2: lastfox ($21.22 in chips) 
Seat 3: raydenel ($16.78 in chips) 
Seat 4: imam skalu ($13.06 in chips) 
Seat 5: Kobert72 ($10 in chips) 
Seat 6: FacuLarrocca ($10 in chips) 
Kobert72: posts small blind $0.05
FacuLarrocca: posts big blind $0.10
*** HOLE CARDS ***
Spud-JCT: calls $0.10
lastfox: folds 
raydenel: folds 
imam skalu: folds 
Kobert72: folds 
FacuLarrocca: checks 
*** FLOP *** [8s 7c 9d]
FacuLarrocca: checks 
Spud-JCT: checks 
*** TURN *** [8s 7c 9d] [5d]
FacuLarrocca: checks 
Spud-JCT: bets $0.70
FacuLarrocca: calls $0.70
*** RIVER *** [8s 7c 9d 5d] [3d]
FacuLarrocca: checks 
Spud-JCT: bets $0.60
FacuLarrocca: calls $0.60
*** SHOW DOWN ***
Spud-JCT: shows [8c 7s] (two pair, Eights and Sevens)
FacuLarrocca: shows [9h 7d] (two pair, Nines and Sevens)
FacuLarrocca collected $2.72 from pot
*** SUMMARY ***
Total pot $2.85 | Rake $0.13 
Board [8s 7c 9d 5d 3d]
Seat 1: Spud-JCT showed [8c 7s] and lost with two pair, Eights and Sevens
Seat 2: lastfox folded before Flop (didn't bet)
Seat 3: raydenel folded before Flop (didn't bet)
Seat 4: imam skalu (button) folded before Flop (didn't bet)
Seat 5: Kobert72 (small blind) folded before Flop
Seat 6: FacuLarrocca (big blind) showed [9h 7d] and won ($2.72) with two pair, Nines and Sevens



PokerStars Hand #222969160180:  Hold'em No Limit ($0.05/$0.10 USD) - 2021/01/23 15:26:14 ET
Table 'Transvaalia' 6-max Seat #5 is the button
Seat 1: Spud-JCT ($2.86 in chips) 
Seat 2: lastfox ($21.22 in chips) 
Seat 3: raydenel ($16.78 in chips) 
Seat 4: imam skalu ($13.06 in chips) 
Seat 5: Kobert72 ($10 in chips) 
Seat 6: FacuLarrocca ($11.32 in chips) 
FacuLarrocca: posts small blind $0.05
Spud-JCT: posts big blind $0.10
*** HOLE CARDS ***
lastfox: folds 
raydenel: folds 
imam skalu: folds 
Kobert72: raises $0.13 to $0.23
FacuLarrocca: folds 
Spud-JCT: folds 
Uncalled bet ($0.13) returned to Kobert72
Kobert72 collected $0.25 from pot
Kobert72: doesn't show hand 
*** SUMMARY ***
Total pot $0.25 | Rake $0 
Seat 1: Spud-JCT (big blind) folded before Flop
Seat 2: lastfox folded before Flop (didn't bet)
Seat 3: raydenel folded before Flop (didn't bet)
Seat 4: imam skalu folded before Flop (didn't bet)
Seat 5: Kobert72 (button) collected ($0.25)
Seat 6: FacuLarrocca (small blind) folded before Flop



PokerStars Hand #222969168233:  Hold'em No Limit ($0.05/$0.10 USD) - 2021/01/23 15:26:23 ET
Table 'Transvaalia' 6-max Seat #6 is the button
Seat 1: Spud-JCT ($2.76 in chips) 
Seat 2: lastfox ($21.22 in chips) 
Seat 3: raydenel ($16.78 in chips) 
Seat 4: imam skalu ($13.06 in chips) 
Seat 5: Kobert72 ($10.15 in chips) 
Seat 6: FacuLarrocca ($11.27 in chips) 
Spud-JCT: posts small blind $0.05
lastfox: posts big blind $0.10
*** HOLE CARDS ***
raydenel: raises $0.20 to $0.30
imam skalu: folds 
Kobert72: folds 
FacuLarrocca: folds 
Spud-JCT: raises $2.46 to $2.76 and is all-in
lastfox: folds 
raydenel: folds 
Uncalled bet ($2.46) returned to Spud-JCT
Spud-JCT collected $0.70 from pot
Spud-JCT: doesn't show hand 
*** SUMMARY ***
Total pot $0.70 | Rake $0 
Seat 1: Spud-JCT (small blind) collected ($0.70)
Seat 2: lastfox (big blind) folded before Flop
Seat 3: raydenel folded before Flop
Seat 4: imam skalu folded before Flop (didn't bet)
Seat 5: Kobert72 folded before Flop (didn't bet)
Seat 6: FacuLarrocca (button) folded before Flop (didn't bet)



PokerStars Hand #222969183426:  Hold'em No Limit ($0.05/$0.10 USD) - 2021/01/23 15:26:41 ET
Table 'Transvaalia' 6-max Seat #1 is the button
Seat 1: Spud-JCT ($3.16 in chips) 
Seat 2: lastfox ($21.12 in chips) 
Seat 3: raydenel ($16.48 in chips) 
Seat 4: imam skalu ($13.06 in chips) 
Seat 5: Kobert72 ($10.15 in chips) 
Seat 6: FacuLarrocca ($11.27 in chips) 
lastfox: posts small blind $0.05
raydenel: posts big blind $0.10
*** HOLE CARDS ***
imam skalu: raises $0.10 to $0.20
Kobert72: folds 
FacuLarrocca: folds 
Spud-JCT: calls $0.20
lastfox: folds 
raydenel: calls $0.10
*** FLOP *** [Ad 6h 4d]
raydenel: checks 
imam skalu: checks 
Spud-JCT: checks 
*** TURN *** [Ad 6h 4d] [Th]
raydenel: checks 
imam skalu: bets $0.30
Spud-JCT: folds 
raydenel: folds 
Uncalled bet ($0.30) returned to imam skalu
imam skalu collected $0.62 from pot
imam skalu: doesn't show hand 
*** SUMMARY ***
Total pot $0.65 | Rake $0.03 
Board [Ad 6h 4d Th]
Seat 1: Spud-JCT (button) folded on the Turn
Seat 2: lastfox (small blind) folded before Flop
Seat 3: raydenel (big blind) folded on the Turn
Seat 4: imam skalu collected ($0.62)
Seat 5: Kobert72 folded before Flop (didn't bet)
Seat 6: FacuLarrocca folded before Flop (didn't bet)



PokerStars Hand #222969212940:  Hold'em No Limit ($0.05/$0.10 USD) - 2021/01/23 15:27:16 ET
Table 'Transvaalia' 6-max Seat #2 is the button
Seat 1: Spud-JCT ($2.96 in chips) 
Seat 2: lastfox ($21.07 in chips) 
Seat 3: raydenel ($16.28 in chips) 
Seat 4: imam skalu ($13.48 in chips) 
Seat 5: Kobert72 ($10.15 in chips) 
Seat 6: FacuLarrocca ($11.27 in chips) 
raydenel: posts small blind $0.05
imam skalu: posts big blind $0.10
*** HOLE CARDS ***
Kobert72: folds 
FacuLarrocca: folds 
Spud-JCT: folds 
lastfox: folds 
raydenel: folds 
Uncalled bet ($0.05) returned to imam skalu
imam skalu collected $0.10 from pot
imam skalu: doesn't show hand 
*** SUMMARY ***
Total pot $0.10 | Rake $0 
Seat 1: Spud-JCT folded before Flop (didn't bet)
Seat 2: lastfox (button) folded before Flop (didn't bet)
Seat 3: raydenel (small blind) folded before Flop
Seat 4: imam skalu (big blind) collected ($0.10)
Seat 5: Kobert72 folded before Flop (didn't bet)
Seat 6: FacuLarrocca folded before Flop (didn't bet)



PokerStars Hand #222969220531:  Hold'em No Limit ($0.05/$0.10 USD) - 2021/01/23 15:27:24 ET
Table 'Transvaalia' 6-max Seat #3 is the button
Seat 1: Spud-JCT ($2.96 in chips) 
Seat 2: lastfox ($21.07 in chips) 
Seat 3: raydenel ($16.23 in chips) 
Seat 4: imam skalu ($13.53 in chips) 
Seat 5: Kobert72 ($10.15 in chips) 
Seat 6: FacuLarrocca ($11.27 in chips) 
imam skalu: posts small blind $0.05
Kobert72: posts big blind $0.10
*** HOLE CARDS ***
FacuLarrocca: folds 
Spud-JCT: folds 
lastfox: folds 
raydenel: folds 
imam skalu: calls $0.05
Kobert72: checks 
*** FLOP *** [Jh 5s 3h]
imam skalu: checks 
Kobert72: bets $0.14
imam skalu: calls $0.14
*** TURN *** [Jh 5s 3h] [4c]
imam skalu: checks 
Kobert72: bets $0.35
imam skalu: folds 
Uncalled bet ($0.35) returned to Kobert72
Kobert72 collected $0.46 from pot
Kobert72: doesn't show hand 
*** SUMMARY ***
Total pot $0.48 | Rake $0.02 
Board [Jh 5s 3h 4c]
Seat 1: Spud-JCT folded before Flop (didn't bet)
Seat 2: lastfox folded before Flop (didn't bet)
Seat 3: raydenel (button) folded before Flop (didn't bet)
Seat 4: imam skalu (small blind) folded on the Turn
Seat 5: Kobert72 (big blind) collected ($0.46)
Seat 6: FacuLarrocca folded before Flop (didn't bet)



PokerStars Hand #222969250131:  Hold'em No Limit ($0.05/$0.10 USD) - 2021/01/23 15:27:59 ET
Table 'Transvaalia' 6-max Seat #4 is the button
Seat 1: Spud-JCT ($2.96 in chips) 
Seat 2: lastfox ($21.07 in chips) 
Seat 3: raydenel ($16.23 in chips) 
Seat 4: imam skalu ($13.29 in chips) 
Seat 5: Kobert72 ($10.37 in chips) 
Seat 6: FacuLarrocca ($11.27 in chips) 
Kobert72: posts small blind $0.05
FacuLarrocca: posts big blind $0.10
*** HOLE CARDS ***
Spud-JCT: calls $0.10
lastfox: folds 
raydenel: raises $0.25 to $0.35
imam skalu: folds 
Kobert72: folds 
FacuLarrocca: calls $0.25
Spud-JCT: calls $0.25
*** FLOP *** [Kc 8s 3s]
FacuLarrocca: checks 
Spud-JCT: checks 
raydenel: checks 
*** TURN *** [Kc 8s 3s] [5c]
FacuLarrocca: checks 
Spud-JCT: checks 
raydenel: bets $0.70
FacuLarrocca: folds 
Spud-JCT: folds 
Uncalled bet ($0.70) returned to raydenel
raydenel collected $1.05 from pot
raydenel: doesn't show hand 
*** SUMMARY ***
Total pot $1.10 | Rake $0.05 
Board [Kc 8s 3s 5c]
Seat 1: Spud-JCT folded on the Turn
Seat 2: lastfox folded before Flop (didn't bet)
Seat 3: raydenel collected ($1.05)
Seat 4: imam skalu (button) folded before Flop (didn't bet)
Seat 5: Kobert72 (small blind) folded before Flop
Seat 6: FacuLarrocca (big blind) folded on the Turn



PokerStars Hand #222969279841:  Hold'em No Limit ($0.05/$0.10 USD) - 2021/01/23 15:28:34 ET
Table 'Transvaalia' 6-max Seat #5 is the button
Seat 1: Spud-JCT ($2.61 in chips) 
Seat 2: lastfox ($21.07 in chips) 
Seat 3: raydenel ($16.93 in chips) 
Seat 4: imam skalu ($13.29 in chips) 
Seat 5: Kobert72 ($10.32 in chips) 
Seat 6: FacuLarrocca ($10.92 in chips) 
FacuLarrocca: posts small blind $0.05
Spud-JCT: posts big blind $0.10
*** HOLE CARDS ***
lastfox: folds 
raydenel: folds 
imam skalu: folds 
Kobert72: folds 
FacuLarrocca: folds 
Uncalled bet ($0.05) returned to Spud-JCT
Spud-JCT collected $0.10 from pot
Spud-JCT: doesn't show hand 
*** SUMMARY ***
Total pot $0.10 | Rake $0 
Seat 1: Spud-JCT (big blind) collected ($0.10)
Seat 2: lastfox folded before Flop (didn't bet)
Seat 3: raydenel folded before Flop (didn't bet)
Seat 4: imam skalu folded before Flop (didn't bet)
Seat 5: Kobert72 (button) folded before Flop (didn't bet)
Seat 6: FacuLarrocca (small blind) folded before Flop



PokerStars Hand #222969285173:  Hold'em No Limit ($0.05/$0.10 USD) - 2021/01/23 15:28:40 ET
Table 'Transvaalia' 6-max Seat #6 is the button
Seat 1: Spud-JCT ($2.66 in chips) 
Seat 2: lastfox ($21.07 in chips) 
Seat 3: raydenel ($16.93 in chips) 
Seat 4: imam skalu ($13.29 in chips) 
Seat 5: Kobert72 ($10.32 in chips) 
Seat 6: FacuLarrocca ($10.87 in chips) 
Spud-JCT: posts small blind $0.05
lastfox: posts big blind $0.10
*** HOLE CARDS ***
raydenel: folds 
imam skalu: raises $0.15 to $0.25
Kobert72: raises $0.48 to $0.73
FacuLarrocca: folds 
Spud-JCT: folds 
lastfox: folds 
imam skalu: calls $0.48
*** FLOP *** [Qd Ac Ks]
imam skalu: bets $0.80
Kobert72: calls $0.80
*** TURN *** [Qd Ac Ks] [As]
imam skalu: checks 
Kobert72: checks 
*** RIVER *** [Qd Ac Ks As] [Td]
imam skalu: checks 
Kobert72: checks 
*** SHOW DOWN ***
imam skalu: shows [Qc Kh] (two pair, Aces and Kings)
Kobert72: shows [Jh Jc] (a straight, Ten to Ace)
Kobert72 collected $3.07 from pot
*** SUMMARY ***
Total pot $3.21 | Rake $0.14 
Board [Qd Ac Ks As Td]
Seat 1: Spud-JCT (small blind) folded before Flop
Seat 2: lastfox (big blind) folded before Flop
Seat 3: raydenel folded before Flop (didn't bet)
Seat 4: imam skalu showed [Qc Kh] and lost with two pair, Aces and Kings
Seat 5: Kobert72 showed [Jh Jc] and won ($3.07) with a straight, Ten to Ace
Seat 6: FacuLarrocca (button) folded before Flop (didn't bet)



PokerStars Hand #222969314698:  Hold'em No Limit ($0.05/$0.10 USD) - 2021/01/23 15:29:14 ET
Table 'Transvaalia' 6-max Seat #1 is the button
Seat 1: Spud-JCT ($2.61 in chips) 
Seat 2: lastfox ($20.97 in chips) 
Seat 4: imam skalu ($11.76 in chips) 
Seat 5: Kobert72 ($11.86 in chips) 
Seat 6: FacuLarrocca ($10.87 in chips) 
lastfox: posts small blind $0.05
raydenel: is sitting out 
imam skalu: posts big blind $0.10
*** HOLE CARDS ***
Kobert72: raises $0.13 to $0.23
FacuLarrocca: folds 
raydenel leaves the table
Spud-JCT: folds 
lastfox: calls $0.18
imam skalu: calls $0.13
*** FLOP *** [2s 9c 7c]
killer135799 joins the table at seat #3 
lastfox: checks 
imam skalu: checks 
Kobert72: checks 
*** TURN *** [2s 9c 7c] [5s]
lastfox: checks 
imam skalu: checks 
Kobert72: checks 
*** RIVER *** [2s 9c 7c 5s] [2h]
lastfox: checks 
imam skalu: checks 
Kobert72: checks 
*** SHOW DOWN ***
lastfox: shows [7h 8c] (two pair, Sevens and Deuces)
imam skalu: mucks hand 
Kobert72: mucks hand 
lastfox collected $0.66 from pot
*** SUMMARY ***
Total pot $0.69 | Rake $0.03 
Board [2s 9c 7c 5s 2h]
Seat 1: Spud-JCT (button) folded before Flop (didn't bet)
Seat 2: lastfox (small blind) showed [7h 8c] and won ($0.66) with two pair, Sevens and Deuces
Seat 4: imam skalu (big blind) mucked
Seat 5: Kobert72 mucked
Seat 6: FacuLarrocca folded before Flop (didn't bet)



PokerStars Hand #222969347408:  Hold'em No Limit ($0.05/$0.10 USD) - 2021/01/23 15:29:52 ET
Table 'Transvaalia' 6-max Seat #2 is the button
Seat 1: Spud-JCT ($2.61 in chips) 
Seat 2: lastfox ($21.40 in chips) 
Seat 4: imam skalu ($11.53 in chips) 
Seat 5: Kobert72 ($11.63 in chips) 
Seat 6: FacuLarrocca ($10.87 in chips) 
imam skalu: posts small blind $0.05
Kobert72: posts big blind $0.10
*** HOLE CARDS ***
FacuLarrocca: raises $0.20 to $0.30
Spud-JCT: calls $0.30
lastfox: folds 
imam skalu: folds 
Kobert72: folds 
*** FLOP *** [2s 5h 4d]
FacuLarrocca: checks 
Spud-JCT: checks 
*** TURN *** [2s 5h 4d] [8h]
FacuLarrocca: checks 
Spud-JCT: checks 
*** RIVER *** [2s 5h 4d 8h] [8d]
FacuLarrocca: checks 
Spud-JCT: checks 
*** SHOW DOWN ***
FacuLarrocca: shows [Qd Ah] (a pair of Eights)
Spud-JCT: shows [5d 6d] (two pair, Eights and Fives)
Spud-JCT collected $0.72 from pot
*** SUMMARY ***
Total pot $0.75 | Rake $0.03 
Board [2s 5h 4d 8h 8d]
Seat 1: Spud-JCT showed [5d 6d] and won ($0.72) with two pair, Eights and Fives
Seat 2: lastfox (button) folded before Flop (didn't bet)
Seat 4: imam skalu (small blind) folded before Flop
Seat 5: Kobert72 (big blind) folded before Flop
Seat 6: FacuLarrocca showed [Qd Ah] and lost with a pair of Eights



PokerStars Hand #222969384125:  Hold'em No Limit ($0.05/$0.10 USD) - 2021/01/23 15:30:34 ET
Table 'Transvaalia' 6-max Seat #4 is the button
Seat 1: Spud-JCT ($3.03 in chips) 
Seat 2: lastfox ($21.40 in chips) 
Seat 3: killer135799 ($4 in chips) 
Seat 4: imam skalu ($11.48 in chips) 
Seat 5: Kobert72 ($11.53 in chips) 
Seat 6: FacuLarrocca ($10.57 in chips) 
Kobert72: posts small blind $0.05
FacuLarrocca: posts big blind $0.10
killer135799: posts big blind $0.10
*** HOLE CARDS ***
Spud-JCT: calls $0.10
lastfox: folds 
killer135799: checks 
imam skalu: folds 
Kobert72: folds 
FacuLarrocca: checks 
*** FLOP *** [As 4c 5h]
FacuLarrocca: checks 
Spud-JCT: checks 
killer135799: checks 
*** TURN *** [As 4c 5h] [Ah]
FacuLarrocca: checks 
Spud-JCT: checks 
killer135799: checks 
*** RIVER *** [As 4c 5h Ah] [3c]
FacuLarrocca: bets $0.25
Spud-JCT: folds 
killer135799: folds 
Uncalled bet ($0.25) returned to FacuLarrocca
FacuLarrocca collected $0.33 from pot
FacuLarrocca: doesn't show hand 
*** SUMMARY ***
Total pot $0.35 | Rake $0.02 
Board [As 4c 5h Ah 3c]
Seat 1: Spud-JCT folded on the River
Seat 2: lastfox folded before Flop (didn't bet)
Seat 3: killer135799 folded on the River (didn't bet)
Seat 4: imam skalu (button) folded before Flop (didn't bet)
Seat 5: Kobert72 (small blind) folded before Flop
Seat 6: FacuLarrocca (big blind) collected ($0.33)



PokerStars Hand #222969421197:  Hold'em No Limit ($0.05/$0.10 USD) - 2021/01/23 15:31:05 ET
Table 'Transvaalia' 6-max Seat #5 is the button
Seat 1: Spud-JCT ($2.93 in chips) 
Seat 2: lastfox ($21.40 in chips) 
Seat 3: killer135799 ($3.90 in chips) 
Seat 4: imam skalu ($11.48 in chips) 
Seat 5: Kobert72 ($11.48 in chips) 
Seat 6: FacuLarrocca ($10.80 in chips) 
FacuLarrocca: posts small blind $0.05
Spud-JCT: posts big blind $0.10
*** HOLE CARDS ***
lastfox: folds 
killer135799: calls $0.10
imam skalu: calls $0.10
Kobert72: folds 
FacuLarrocca: folds 
Spud-JCT: raises $0.10 to $0.20
killer135799: calls $0.10
imam skalu: calls $0.10
*** FLOP *** [3h Qh Ac]
Spud-JCT: bets $2.73 and is all-in
killer135799: folds 
imam skalu: folds 
Uncalled bet ($2.73) returned to Spud-JCT
Spud-JCT collected $0.62 from pot
Spud-JCT: doesn't show hand 
*** SUMMARY ***
Total pot $0.65 | Rake $0.03 
Board [3h Qh Ac]
Seat 1: Spud-JCT (big blind) collected ($0.62)
Seat 2: lastfox folded before Flop (didn't bet)
Seat 3: killer135799 folded on the Flop
Seat 4: imam skalu folded on the Flop
Seat 5: Kobert72 (button) folded before Flop (didn't bet)
Seat 6: FacuLarrocca (small blind) folded before Flop



PokerStars Hand #222969455926:  Hold'em No Limit ($0.05/$0.10 USD) - 2021/01/23 15:31:44 ET
Table 'Transvaalia' 6-max Seat #6 is the button
Seat 1: Spud-JCT ($3.35 in chips) 
Seat 2: lastfox ($21.40 in chips) 
Seat 3: killer135799 ($3.70 in chips) 
Seat 4: imam skalu ($11.28 in chips) 
Seat 5: Kobert72 ($11.48 in chips) 
Seat 6: FacuLarrocca ($10.75 in chips) 
Spud-JCT: posts small blind $0.05
lastfox: posts big blind $0.10
*** HOLE CARDS ***
killer135799: calls $0.10
imam skalu: raises $0.20 to $0.30
Kobert72: folds 
FacuLarrocca: folds 
Spud-JCT: calls $0.25
lastfox: folds 
killer135799: calls $0.20
*** FLOP *** [9s 5c Ks]
Spud-JCT: checks 
killer135799: checks 
imam skalu: bets $0.40
Spud-JCT: raises $0.40 to $0.80
killer135799: folds 
imam skalu: calls $0.40
*** TURN *** [9s 5c Ks] [Jh]
Spud-JCT: bets $2.25 and is all-in
imam skalu: folds 
Uncalled bet ($2.25) returned to Spud-JCT
Spud-JCT collected $2.48 from pot
Spud-JCT: doesn't show hand 
*** SUMMARY ***
Total pot $2.60 | Rake $0.12 
Board [9s 5c Ks Jh]
Seat 1: Spud-JCT (small blind) collected ($2.48)
Seat 2: lastfox (big blind) folded before Flop
Seat 3: killer135799 folded on the Flop
Seat 4: imam skalu folded on the Turn
Seat 5: Kobert72 folded before Flop (didn't bet)
Seat 6: FacuLarrocca (button) folded before Flop (didn't bet)



PokerStars Hand #222969490667:  Hold'em No Limit ($0.05/$0.10 USD) - 2021/01/23 15:32:25 ET
Table 'Transvaalia' 6-max Seat #1 is the button
Seat 1: Spud-JCT ($4.73 in chips) 
Seat 2: lastfox ($21.30 in chips) 
Seat 3: killer135799 ($3.40 in chips) 
Seat 4: imam skalu ($10.18 in chips) 
Seat 5: Kobert72 ($11.48 in chips) 
Seat 6: FacuLarrocca ($10.75 in chips) 
lastfox: posts small blind $0.05
killer135799: posts big blind $0.10
*** HOLE CARDS ***
imam skalu: folds 
Kobert72: folds 
FacuLarrocca: folds 
Spud-JCT: calls $0.10
lastfox: calls $0.05
killer135799: checks 
*** FLOP *** [As 8d 9s]
lastfox: checks 
killer135799: checks 
Spud-JCT: checks 
*** TURN *** [As 8d 9s] [Jd]
lastfox: checks 
killer135799: checks 
Spud-JCT: checks 
*** RIVER *** [As 8d 9s Jd] [Qc]
lastfox: checks 
killer135799: bets $0.29
Spud-JCT: folds 
lastfox: folds 
Uncalled bet ($0.29) returned to killer135799
killer135799 collected $0.29 from pot
killer135799: doesn't show hand 
*** SUMMARY ***
Total pot $0.30 | Rake $0.01 
Board [As 8d 9s Jd Qc]
Seat 1: Spud-JCT (button) folded on the River
Seat 2: lastfox (small blind) folded on the River
Seat 3: killer135799 (big blind) collected ($0.29)
Seat 4: imam skalu folded before Flop (didn't bet)
Seat 5: Kobert72 folded before Flop (didn't bet)
Seat 6: FacuLarrocca folded before Flop (didn't bet)



PokerStars Hand #222969517708:  Hold'em No Limit ($0.05/$0.10 USD) - 2021/01/23 15:32:56 ET
Table 'Transvaalia' 6-max Seat #2 is the button
Seat 1: Spud-JCT ($4.63 in chips) 
Seat 2: lastfox ($21.20 in chips) 
Seat 3: killer135799 ($3.59 in chips) 
Seat 4: imam skalu ($10.18 in chips) 
Seat 5: Kobert72 ($11.48 in chips) 
Seat 6: FacuLarrocca ($10.75 in chips) 
killer135799: posts small blind $0.05
imam skalu: posts big blind $0.10
*** HOLE CARDS ***
Kobert72: folds 
FacuLarrocca: folds 
Spud-JCT: calls $0.10
lastfox: folds 
killer135799: calls $0.05
imam skalu: checks 
*** FLOP *** [5s As 8d]
killer135799: checks 
imam skalu: checks 
Spud-JCT: bets $0.10
killer135799: folds 
imam skalu: folds 
Uncalled bet ($0.10) returned to Spud-JCT
Spud-JCT collected $0.29 from pot
Spud-JCT: doesn't show hand 
*** SUMMARY ***
Total pot $0.30 | Rake $0.01 
Board [5s As 8d]
Seat 1: Spud-JCT collected ($0.29)
Seat 2: lastfox (button) folded before Flop (didn't bet)
Seat 3: killer135799 (small blind) folded on the Flop
Seat 4: imam skalu (big blind) folded on the Flop
Seat 5: Kobert72 folded before Flop (didn't bet)
Seat 6: FacuLarrocca folded before Flop (didn't bet)



PokerStars Hand #222969536641:  Hold'em No Limit ($0.05/$0.10 USD) - 2021/01/23 15:33:18 ET
Table 'Transvaalia' 6-max Seat #3 is the button
Seat 1: Spud-JCT ($4.82 in chips) 
Seat 2: lastfox ($21.20 in chips) 
Seat 3: killer135799 ($3.49 in chips) 
Seat 4: imam skalu ($10.08 in chips) 
Seat 5: Kobert72 ($11.48 in chips) 
Seat 6: FacuLarrocca ($10.75 in chips) 
imam skalu: posts small blind $0.05
Kobert72: posts big blind $0.10
*** HOLE CARDS ***
FacuLarrocca: folds 
Spud-JCT: calls $0.10
lastfox: folds 
killer135799: folds 
imam skalu: folds 
Kobert72: checks 
*** FLOP *** [5h 4c Qc]
Kobert72: checks 
Spud-JCT: bets $0.50
Kobert72: folds 
Uncalled bet ($0.50) returned to Spud-JCT
Spud-JCT collected $0.24 from pot
Spud-JCT: doesn't show hand 
*** SUMMARY ***
Total pot $0.25 | Rake $0.01 
Board [5h 4c Qc]
Seat 1: Spud-JCT collected ($0.24)
Seat 2: lastfox folded before Flop (didn't bet)
Seat 3: killer135799 (button) folded before Flop (didn't bet)
Seat 4: imam skalu (small blind) folded before Flop
Seat 5: Kobert72 (big blind) folded on the Flop
Seat 6: FacuLarrocca folded before Flop (didn't bet)



PokerStars Hand #222969553354:  Hold'em No Limit ($0.05/$0.10 USD) - 2021/01/23 15:33:38 ET
Table 'Transvaalia' 6-max Seat #4 is the button
Seat 1: Spud-JCT ($4.96 in chips) 
Seat 2: lastfox ($21.20 in chips) 
Seat 3: killer135799 ($3.49 in chips) 
Seat 4: imam skalu ($10.03 in chips) 
Seat 5: Kobert72 ($11.38 in chips) 
Seat 6: FacuLarrocca ($10.75 in chips) 
Kobert72: posts small blind $0.05
FacuLarrocca: posts big blind $0.10
*** HOLE CARDS ***
Spud-JCT: calls $0.10
lastfox: folds 
killer135799: raises $3.39 to $3.49 and is all-in
imam skalu: folds 
Kobert72: folds 
FacuLarrocca: folds 
Spud-JCT: calls $3.39
*** FLOP *** [9s 4d 2s]
*** TURN *** [9s 4d 2s] [4s]
*** RIVER *** [9s 4d 2s 4s] [6h]
*** SHOW DOWN ***
Spud-JCT: shows [Kh Qh] (a pair of Fours)
killer135799: shows [8h As] (a pair of Fours - Ace kicker)
killer135799 collected $6.81 from pot
*** SUMMARY ***
Total pot $7.13 | Rake $0.32 
Board [9s 4d 2s 4s 6h]
Seat 1: Spud-JCT showed [Kh Qh] and lost with a pair of Fours
Seat 2: lastfox folded before Flop (didn't bet)
Seat 3: killer135799 showed [8h As] and won ($6.81) with a pair of Fours
Seat 4: imam skalu (button) folded before Flop (didn't bet)
Seat 5: Kobert72 (small blind) folded before Flop
Seat 6: FacuLarrocca (big blind) folded before Flop



PokerStars Hand #222969576492:  Hold'em No Limit ($0.05/$0.10 USD) - 2021/01/23 15:34:05 ET
Table 'Transvaalia' 6-max Seat #5 is the button
Seat 1: Spud-JCT ($1.47 in chips) 
Seat 2: lastfox ($21.20 in chips) 
Seat 3: killer135799 ($6.81 in chips) 
Seat 4: imam skalu ($10.03 in chips) 
Seat 5: Kobert72 ($11.33 in chips) 
Seat 6: FacuLarrocca ($10.65 in chips) 
FacuLarrocca: posts small blind $0.05
Spud-JCT: posts big blind $0.10
*** HOLE CARDS ***
lastfox: folds 
killer135799: folds 
imam skalu: folds 
Kobert72: folds 
FacuLarrocca: folds 
Uncalled bet ($0.05) returned to Spud-JCT
Spud-JCT collected $0.10 from pot
Spud-JCT: doesn't show hand 
*** SUMMARY ***
Total pot $0.10 | Rake $0 
Seat 1: Spud-JCT (big blind) collected ($0.10)
Seat 2: lastfox folded before Flop (didn't bet)
Seat 3: killer135799 folded before Flop (didn't bet)
Seat 4: imam skalu folded before Flop (didn't bet)
Seat 5: Kobert72 (button) folded before Flop (didn't bet)
Seat 6: FacuLarrocca (small blind) folded before Flop



PokerStars Hand #222969582867:  Hold'em No Limit ($0.05/$0.10 USD) - 2021/01/23 15:34:12 ET
Table 'Transvaalia' 6-max Seat #6 is the button
Seat 1: Spud-JCT ($1.52 in chips) 
Seat 2: lastfox ($21.20 in chips) 
Seat 3: killer135799 ($6.81 in chips) 
Seat 4: imam skalu ($10.03 in chips) 
Seat 5: Kobert72 ($11.33 in chips) 
Seat 6: FacuLarrocca ($10.60 in chips) 
Spud-JCT: posts small blind $0.05
lastfox: posts big blind $0.10
*** HOLE CARDS ***
killer135799: folds 
imam skalu: raises $0.15 to $0.25
Kobert72: folds 
FacuLarrocca: folds 
Spud-JCT: folds 
lastfox: calls $0.15
*** FLOP *** [2s 9h Th]
lastfox: checks 
imam skalu: bets $0.27
lastfox: calls $0.27
*** TURN *** [2s 9h Th] [9s]
lastfox: checks 
imam skalu: bets $0.51
lastfox: raises $2.54 to $3.05
imam skalu: folds 
Uncalled bet ($2.54) returned to lastfox
lastfox collected $2.02 from pot
lastfox: doesn't show hand 
*** SUMMARY ***
Total pot $2.11 | Rake $0.09 
Board [2s 9h Th 9s]
Seat 1: Spud-JCT (small blind) folded before Flop
Seat 2: lastfox (big blind) collected ($2.02)
Seat 3: killer135799 folded before Flop (didn't bet)
Seat 4: imam skalu folded on the Turn
Seat 5: Kobert72 folded before Flop (didn't bet)
Seat 6: FacuLarrocca (button) folded before Flop (didn't bet)



PokerStars Hand #222969621037:  Hold'em No Limit ($0.05/$0.10 USD) - 2021/01/23 15:34:55 ET
Table 'Transvaalia' 6-max Seat #1 is the button
Seat 1: Spud-JCT ($1.47 in chips) 
Seat 2: lastfox ($22.19 in chips) 
Seat 3: killer135799 ($6.81 in chips) 
Seat 4: imam skalu ($9 in chips) 
Seat 5: Kobert72 ($11.33 in chips) 
Seat 6: FacuLarrocca ($10.60 in chips) 
lastfox: posts small blind $0.05
killer135799: posts big blind $0.10
*** HOLE CARDS ***
imam skalu: folds 
imam skalu leaves the table
Kobert72: folds 
FacuLarrocca: folds 
Spud-JCT: calls $0.10
luisperse joins the table at seat #4 
lastfox: raises $0.23 to $0.33
killer135799: raises $0.23 to $0.56
Spud-JCT: folds 
lastfox: calls $0.23
*** FLOP *** [9s 5c 4h]
lastfox: checks 
killer135799: bets $0.58
lastfox: folds 
Uncalled bet ($0.58) returned to killer135799
killer135799 collected $1.17 from pot
killer135799: doesn't show hand 
*** SUMMARY ***
Total pot $1.22 | Rake $0.05 
Board [9s 5c 4h]
Seat 1: Spud-JCT (button) folded before Flop
Seat 2: lastfox (small blind) folded on the Flop
Seat 3: killer135799 (big blind) collected ($1.17)
Seat 4: imam skalu folded before Flop (didn't bet)
Seat 5: Kobert72 folded before Flop (didn't bet)
Seat 6: FacuLarrocca folded before Flop (didn't bet)



PokerStars Hand #222969655828:  Hold'em No Limit ($0.05/$0.10 USD) - 2021/01/23 15:35:35 ET
Table 'Transvaalia' 6-max Seat #2 is the button
Seat 1: Spud-JCT ($1.37 in chips) 
Seat 2: lastfox ($21.63 in chips) 
Seat 3: killer135799 ($7.42 in chips) 
Seat 4: luisperse ($4 in chips) 
Seat 5: Kobert72 ($11.33 in chips) 
Seat 6: FacuLarrocca ($10.60 in chips) 
killer135799: posts small blind $0.05
luisperse: posts big blind $0.10
*** HOLE CARDS ***
Kobert72: folds 
FacuLarrocca: folds 
Spud-JCT: folds 
lastfox: raises $0.13 to $0.23
killer135799: folds 
luisperse: folds 
Uncalled bet ($0.13) returned to lastfox
lastfox collected $0.25 from pot
lastfox: doesn't show hand 
*** SUMMARY ***
Total pot $0.25 | Rake $0 
Seat 1: Spud-JCT folded before Flop (didn't bet)
Seat 2: lastfox (button) collected ($0.25)
Seat 3: killer135799 (small blind) folded before Flop
Seat 4: luisperse (big blind) folded before Flop
Seat 5: Kobert72 folded before Flop (didn't bet)
Seat 6: FacuLarrocca folded before Flop (didn't bet)



PokerStars Hand #222969681582:  Hold'em No Limit ($0.05/$0.10 USD) - 2021/01/23 15:36:06 ET
Table 'Transvaalia' 6-max Seat #3 is the button
Seat 1: Spud-JCT ($1.37 in chips) 
Seat 2: lastfox ($21.78 in chips) 
Seat 3: killer135799 ($7.37 in chips) 
Seat 4: luisperse ($3.90 in chips) 
Seat 5: Kobert72 ($11.33 in chips) 
Seat 6: FacuLarrocca ($10.60 in chips) 
luisperse: posts small blind $0.05
Kobert72: posts big blind $0.10
*** HOLE CARDS ***
FacuLarrocca: folds 
Spud-JCT is disconnected 
Spud-JCT has timed out while being disconnected
Spud-JCT: folds 
lastfox: raises $0.13 to $0.23
killer135799: raises $0.61 to $0.84
luisperse: folds 
Kobert72: folds 
lastfox: calls $0.61
*** FLOP *** [Ts Tc As]
lastfox: checks 
killer135799: bets $0.87
lastfox: folds 
Uncalled bet ($0.87) returned to killer135799
killer135799 collected $1.75 from pot
killer135799: doesn't show hand 
*** SUMMARY ***
Total pot $1.83 | Rake $0.08 
Board [Ts Tc As]
Seat 1: Spud-JCT folded before Flop (didn't bet)
Seat 2: lastfox folded on the Flop
Seat 3: killer135799 (button) collected ($1.75)
Seat 4: luisperse (small blind) folded before Flop
Seat 5: Kobert72 (big blind) folded before Flop
Seat 6: FacuLarrocca folded before Flop (didn't bet)



PokerStars Hand #222969720675:  Hold'em No Limit ($0.05/$0.10 USD) - 2021/01/23 15:36:51 ET
Table 'Transvaalia' 6-max Seat #4 is the button
Seat 2: lastfox ($20.94 in chips) 
Seat 3: killer135799 ($8.28 in chips) 
Seat 4: luisperse ($3.85 in chips) 
Seat 5: Kobert72 ($11.23 in chips) 
Seat 6: FacuLarrocca ($10.60 in chips) 
Kobert72: posts small blind $0.05
FacuLarrocca: posts big blind $0.10
*** HOLE CARDS ***
lastfox: raises $0.13 to $0.23
killer135799: calls $0.23
luisperse: folds 
Kobert72: folds 
FacuLarrocca: folds 
*** FLOP *** [3c Jh 6h]
lastfox: bets $0.39
killer135799: raises $0.39 to $0.78
lastfox: raises $1.56 to $2.34
killer135799: calls $1.56
*** TURN *** [3c Jh 6h] [7h]
lastfox: checks 
killer135799: bets $2.52
lastfox: raises $5.04 to $7.56
killer135799: calls $3.19 and is all-in
Uncalled bet ($1.85) returned to lastfox
*** RIVER *** [3c Jh 6h 7h] [8c]
*** SHOW DOWN ***
lastfox: shows [Ah Ad] (a pair of Aces)
killer135799: shows [Jd Qs] (a pair of Jacks)
lastfox collected $15.96 from pot
*** SUMMARY ***
Total pot $16.71 | Rake $0.75 
Board [3c Jh 6h 7h 8c]
Seat 2: lastfox showed [Ah Ad] and won ($15.96) with a pair of Aces
Seat 3: killer135799 showed [Jd Qs] and lost with a pair of Jacks
Seat 4: luisperse (button) folded before Flop (didn't bet)
Seat 5: Kobert72 (small blind) folded before Flop
Seat 6: FacuLarrocca (big blind) folded before Flop



PokerStars Hand #222969746996:  Hold'em No Limit ($0.05/$0.10 USD) - 2021/01/23 15:37:22 ET
Table 'Transvaalia' 6-max Seat #5 is the button
Seat 2: lastfox ($28.62 in chips) 
Seat 4: luisperse ($3.85 in chips) 
Seat 5: Kobert72 ($11.18 in chips) 
Seat 6: FacuLarrocca ($10.50 in chips) 
FacuLarrocca: posts small blind $0.05
lastfox: posts big blind $0.10
*** HOLE CARDS ***
luisperse: calls $0.10
Kobert72: folds 
FacuLarrocca: folds 
lastfox: checks 
*** FLOP *** [7d 5c 3c]
lastfox: checks 
luisperse: checks 
*** TURN *** [7d 5c 3c] [Kc]
lastfox: checks 
luisperse: checks 
*** RIVER *** [7d 5c 3c Kc] [9s]
lastfox: checks 
luisperse: checks 
*** SHOW DOWN ***
lastfox: shows [5d Js] (a pair of Fives)
luisperse: mucks hand 
lastfox collected $0.24 from pot
*** SUMMARY ***
Total pot $0.25 | Rake $0.01 
Board [7d 5c 3c Kc 9s]
Seat 2: lastfox (big blind) showed [5d Js] and won ($0.24) with a pair of Fives
Seat 4: luisperse mucked
Seat 5: Kobert72 (button) folded before Flop (didn't bet)
Seat 6: FacuLarrocca (small blind) folded before Flop



PokerStars Hand #222969769483:  Hold'em No Limit ($0.05/$0.10 USD) - 2021/01/23 15:37:49 ET
Table 'Transvaalia' 6-max Seat #6 is the button
Seat 2: lastfox ($28.76 in chips) 
Seat 3: killer135799 ($4 in chips) 
Seat 4: luisperse ($3.75 in chips) 
Seat 5: Kobert72 ($11.18 in chips) 
Seat 6: FacuLarrocca ($10.45 in chips) 
lastfox: posts small blind $0.05
killer135799: posts big blind $0.10
*** HOLE CARDS ***
luisperse: folds 
Kobert72: folds 
FacuLarrocca: raises $0.15 to $0.25
lastfox: folds 
killer135799: raises $3.75 to $4 and is all-in
FacuLarrocca: folds 
Uncalled bet ($3.75) returned to killer135799
killer135799 collected $0.55 from pot
killer135799: doesn't show hand 
*** SUMMARY ***
Total pot $0.55 | Rake $0 
Seat 2: lastfox (small blind) folded before Flop
Seat 3: killer135799 (big blind) collected ($0.55)
Seat 4: luisperse folded before Flop (didn't bet)
Seat 5: Kobert72 folded before Flop (didn't bet)
Seat 6: FacuLarrocca (button) folded before Flop



PokerStars Hand #222969782184:  Hold'em No Limit ($0.05/$0.10 USD) - 2021/01/23 15:38:04 ET
Table 'Transvaalia' 6-max Seat #2 is the button
Seat 2: lastfox ($28.71 in chips) 
Seat 3: killer135799 ($4.30 in chips) 
Seat 4: luisperse ($3.75 in chips) 
Seat 5: Kobert72 ($11.18 in chips) 
Seat 6: FacuLarrocca ($10.20 in chips) 
killer135799: posts small blind $0.05
luisperse: posts big blind $0.10
*** HOLE CARDS ***
Kobert72: folds 
FacuLarrocca: folds 
lastfox: folds 
killer135799: folds 
Uncalled bet ($0.05) returned to luisperse
luisperse collected $0.10 from pot
luisperse: doesn't show hand 
*** SUMMARY ***
Total pot $0.10 | Rake $0 
Seat 2: lastfox (button) folded before Flop (didn't bet)
Seat 3: killer135799 (small blind) folded before Flop
Seat 4: luisperse (big blind) collected ($0.10)
Seat 5: Kobert72 folded before Flop (didn't bet)
Seat 6: FacuLarrocca folded before Flop (didn't bet)



PokerStars Hand #222969787875:  Hold'em No Limit ($0.05/$0.10 USD) - 2021/01/23 15:38:10 ET
Table 'Transvaalia' 6-max Seat #3 is the button
Seat 2: lastfox ($28.71 in chips) 
Seat 3: killer135799 ($4.25 in chips) 
Seat 4: luisperse ($3.80 in chips) 
Seat 5: Kobert72 ($11.18 in chips) 
Seat 6: FacuLarrocca ($10.20 in chips) 
luisperse: posts small blind $0.05
Kobert72: posts big blind $0.10
*** HOLE CARDS ***
FacuLarrocca: folds 
lastfox: folds 
killer135799: raises $4.15 to $4.25 and is all-in
luisperse: calls $3.75 and is all-in
Kobert72: folds 
Uncalled bet ($0.45) returned to killer135799
*** FLOP *** [3s Ks Ac]
*** TURN *** [3s Ks Ac] [8s]
*** RIVER *** [3s Ks Ac 8s] [5h]
*** SHOW DOWN ***
luisperse: shows [8c 8d] (three of a kind, Eights)
killer135799: shows [Kh Qs] (a pair of Kings)
luisperse collected $7.35 from pot
*** SUMMARY ***
Total pot $7.70 | Rake $0.35 
Board [3s Ks Ac 8s 5h]
Seat 2: lastfox folded before Flop (didn't bet)
Seat 3: killer135799 (button) showed [Kh Qs] and lost with a pair of Kings
Seat 4: luisperse (small blind) showed [8c 8d] and won ($7.35) with three of a kind, Eights
Seat 5: Kobert72 (big blind) folded before Flop
Seat 6: FacuLarrocca folded before Flop (didn't bet)



PokerStars Hand #222969824743:  Hold'em No Limit ($0.05/$0.10 USD) - 2021/01/23 15:38:45 ET
Table 'Transvaalia' 6-max Seat #4 is the button
Seat 2: lastfox ($28.71 in chips) 
Seat 3: killer135799 ($0.45 in chips) 
Seat 4: luisperse ($7.35 in chips) 
Seat 5: Kobert72 ($11.08 in chips) 
Seat 6: FacuLarrocca ($10.20 in chips) 
Kobert72: posts small blind $0.05
FacuLarrocca: posts big blind $0.10
*** HOLE CARDS ***
lastfox: folds 
killer135799: raises $0.35 to $0.45 and is all-in
luisperse: folds 
Kobert72: folds 
FacuLarrocca: folds 
Uncalled bet ($0.35) returned to killer135799
killer135799 collected $0.25 from pot
killer135799: doesn't show hand 
*** SUMMARY ***
Total pot $0.25 | Rake $0 
Seat 2: lastfox folded before Flop (didn't bet)
Seat 3: killer135799 collected ($0.25)
Seat 4: luisperse (button) folded before Flop (didn't bet)
Seat 5: Kobert72 (small blind) folded before Flop
Seat 6: FacuLarrocca (big blind) folded before Flop



PokerStars Hand #222969843142:  Hold'em No Limit ($0.05/$0.10 USD) - 2021/01/23 15:39:07 ET
Table 'Transvaalia' 6-max Seat #5 is the button
Seat 2: lastfox ($28.71 in chips) 
Seat 3: killer135799 ($0.60 in chips) 
Seat 4: luisperse ($7.35 in chips) 
Seat 5: Kobert72 ($11.03 in chips) 
Seat 6: FacuLarrocca ($10.10 in chips) 
FacuLarrocca: posts small blind $0.05
lastfox: posts big blind $0.10
*** HOLE CARDS ***
killer135799: raises $0.50 to $0.60 and is all-in
luisperse: folds 
Kobert72: folds 
FacuLarrocca: calls $0.55
lastfox: calls $0.50
*** FLOP *** [5c 3h 7s]
FacuLarrocca: checks 
lastfox: checks 
*** TURN *** [5c 3h 7s] [6c]
FacuLarrocca: checks 
lastfox: checks 
*** RIVER *** [5c 3h 7s 6c] [3d]
FacuLarrocca: checks 
lastfox: checks 
*** SHOW DOWN ***
FacuLarrocca: shows [Ks Ts] (a pair of Threes)
lastfox: mucks hand 
killer135799: shows [4c Tc] (a straight, Three to Seven)
killer135799 collected $1.72 from pot
*** SUMMARY ***
Total pot $1.80 | Rake $0.08 
Board [5c 3h 7s 6c 3d]
Seat 2: lastfox (big blind) mucked
Seat 3: killer135799 showed [4c Tc] and won ($1.72) with a straight, Three to Seven
Seat 4: luisperse folded before Flop (didn't bet)
Seat 5: Kobert72 (button) folded before Flop (didn't bet)
Seat 6: FacuLarrocca (small blind) showed [Ks Ts] and lost with a pair of Threes



PokerStars Hand #222969876200:  Hold'em No Limit ($0.05/$0.10 USD) - 2021/01/23 15:39:46 ET
Table 'Transvaalia' 6-max Seat #6 is the button
Seat 2: lastfox ($28.11 in chips) 
Seat 3: killer135799 ($1.72 in chips) 
Seat 4: luisperse ($7.35 in chips) 
Seat 5: Kobert72 ($11.03 in chips) 
Seat 6: FacuLarrocca ($10 in chips) 
lastfox: posts small blind $0.05
killer135799: posts big blind $0.10
*** HOLE CARDS ***
luisperse: calls $0.10
Kobert72: folds 
FacuLarrocca: raises $0.35 to $0.45
lastfox: folds 
killer135799: raises $1.27 to $1.72 and is all-in
luisperse: folds 
FacuLarrocca: calls $1.27
*** FLOP *** [Kc 7h Tc]
*** TURN *** [Kc 7h Tc] [Qh]
*** RIVER *** [Kc 7h Tc Qh] [5d]
*** SHOW DOWN ***
killer135799: shows [Ah 5c] (a pair of Fives)
FacuLarrocca: shows [Jd Ad] (a straight, Ten to Ace)
FacuLarrocca collected $3.43 from pot
*** SUMMARY ***
Total pot $3.59 | Rake $0.16 
Board [Kc 7h Tc Qh 5d]
Seat 2: lastfox (small blind) folded before Flop
Seat 3: killer135799 (big blind) showed [Ah 5c] and lost with a pair of Fives
Seat 4: luisperse folded before Flop
Seat 5: Kobert72 folded before Flop (didn't bet)
Seat 6: FacuLarrocca (button) showed [Jd Ad] and won ($3.43) with a straight, Ten to Ace



PokerStars Hand #222969908996:  Hold'em No Limit ($0.05/$0.10 USD) - 2021/01/23 15:40:25 ET
Table 'Transvaalia' 6-max Seat #2 is the button
Seat 2: lastfox ($28.06 in chips) 
Seat 4: luisperse ($7.25 in chips) 
Seat 5: Kobert72 ($11.03 in chips) 
Seat 6: FacuLarrocca ($11.71 in chips) 
luisperse: posts small blind $0.05
Kobert72: posts big blind $0.10
*** HOLE CARDS ***
FacuLarrocca: folds 
lastfox: folds 
killer135799 leaves the table
luisperse: folds 
Uncalled bet ($0.05) returned to Kobert72
Kobert72 collected $0.10 from pot
Kobert72: doesn't show hand 
*** SUMMARY ***
Total pot $0.10 | Rake $0 
Seat 2: lastfox (button) folded before Flop (didn't bet)
Seat 4: luisperse (small blind) folded before Flop
Seat 5: Kobert72 (big blind) collected ($0.10)
Seat 6: FacuLarrocca folded before Flop (didn't bet)



PokerStars Hand #222969917752:  Hold'em No Limit ($0.05/$0.10 USD) - 2021/01/23 15:40:36 ET
Table 'Transvaalia' 6-max Seat #4 is the button
Seat 2: lastfox ($28.06 in chips) 
Seat 4: luisperse ($7.20 in chips) 
Seat 5: Kobert72 ($11.08 in chips) 
Seat 6: FacuLarrocca ($11.71 in chips) 
Kobert72: posts small blind $0.05
FacuLarrocca: posts big blind $0.10
*** HOLE CARDS ***
lastfox: folds 
luisperse: folds 
Kobert72: folds 
Uncalled bet ($0.05) returned to FacuLarrocca
FacuLarrocca collected $0.10 from pot
FacuLarrocca: doesn't show hand 
*** SUMMARY ***
Total pot $0.10 | Rake $0 
Seat 2: lastfox folded before Flop (didn't bet)
Seat 4: luisperse (button) folded before Flop (didn't bet)
Seat 5: Kobert72 (small blind) folded before Flop
Seat 6: FacuLarrocca (big blind) collected ($0.10)



PokerStars Hand #222969924236:  Hold'em No Limit ($0.05/$0.10 USD) - 2021/01/23 15:40:43 ET
Table 'Transvaalia' 6-max Seat #5 is the button
Seat 4: luisperse ($7.20 in chips) 
Seat 5: Kobert72 ($11.03 in chips) 
Seat 6: FacuLarrocca ($11.76 in chips) 
FacuLarrocca: posts small blind $0.05
lastfox: is sitting out 
luisperse: posts big blind $0.10
*** HOLE CARDS ***
Kobert72: folds 
lastfox leaves the table
FacuLarrocca: folds 
Uncalled bet ($0.05) returned to luisperse
luisperse collected $0.10 from pot
luisperse: doesn't show hand 
*** SUMMARY ***
Total pot $0.10 | Rake $0 
Seat 4: luisperse (big blind) collected ($0.10)
Seat 5: Kobert72 (button) folded before Flop (didn't bet)
Seat 6: FacuLarrocca (small blind) folded before Flop



PokerStars Hand #222969928610:  Hold'em No Limit ($0.05/$0.10 USD) - 2021/01/23 15:40:48 ET
Table 'Transvaalia' 6-max Seat #6 is the button
Seat 4: luisperse ($7.25 in chips) 
Seat 5: Kobert72 ($11.03 in chips) 
Seat 6: FacuLarrocca ($11.71 in chips) 
luisperse: posts small blind $0.05
Kobert72: posts big blind $0.10
*** HOLE CARDS ***
Michael_Kss joins the table at seat #3 
FacuLarrocca: raises $0.15 to $0.25
luisperse: raises $0.15 to $0.40
Kobert72: folds 
FacuLarrocca: calls $0.15
*** FLOP *** [9s 8h 7d]
Kobert72 leaves the table
luisperse: bets $0.86
FacuLarrocca: calls $0.86
*** TURN *** [9s 8h 7d] [6d]
luisperse: bets $2.50
FacuLarrocca: folds 
Uncalled bet ($2.50) returned to luisperse
luisperse collected $2.50 from pot
luisperse: doesn't show hand 
*** SUMMARY ***
Total pot $2.62 | Rake $0.12 
Board [9s 8h 7d 6d]
Seat 4: luisperse (small blind) collected ($2.50)
Seat 5: Kobert72 (big blind) folded before Flop
Seat 6: FacuLarrocca (button) folded on the Turn



PokerStars Hand #222969958686:  Hold'em No Limit ($0.05/$0.10 USD) - 2021/01/23 15:41:24 ET
Table 'Transvaalia' 6-max Seat #4 is the button
Seat 3: Michael_Kss ($10 in chips) 
Seat 4: luisperse ($8.49 in chips) 
Seat 6: FacuLarrocca ($10.45 in chips) 
FacuLarrocca: posts small blind $0.05
Michael_Kss: posts big blind $0.10
*** HOLE CARDS ***
luisperse: folds 
FacuLarrocca: raises $0.20 to $0.30
Michael_Kss: calls $0.20
*** FLOP *** [8d 2s 9s]
FacuLarrocca: checks 
Michael_Kss: bets $0.31
FacuLarrocca: raises $0.89 to $1.20
Michael_Kss: calls $0.89
*** TURN *** [8d 2s 9s] [9h]
FacuLarrocca: bets $1.43
Michael_Kss: raises $2.27 to $3.70
johan416 joins the table at seat #2 
FacuLarrocca: folds 
Uncalled bet ($2.27) returned to Michael_Kss
Michael_Kss collected $5.60 from pot
Spud-JCT was removed from the table for failing to post
Spud-JCT leaves the table
*** SUMMARY ***
Total pot $5.86 | Rake $0.26 
Board [8d 2s 9s 9h]
Seat 3: Michael_Kss (big blind) collected ($5.60)
Seat 4: luisperse (button) folded before Flop (didn't bet)
Seat 6: FacuLarrocca (small blind) folded on the Turn



PokerStars Hand #222970006093:  Hold'em No Limit ($0.05/$0.10 USD) - 2021/01/23 15:42:21 ET
Table 'Transvaalia' 6-max Seat #6 is the button
Seat 3: Michael_Kss ($12.67 in chips) 
Seat 4: luisperse ($8.49 in chips) 
Seat 6: FacuLarrocca ($10 in chips) 
Michael_Kss: posts small blind $0.05
luisperse: posts big blind $0.10
*** HOLE CARDS ***
FacuLarrocca: folds 
Michael_Kss: raises $0.15 to $0.25
luisperse: calls $0.15
*** FLOP *** [Jc Kd 3h]
poseidoporunbot joins the table at seat #5 
meteor9867 joins the table at seat #1 
Michael_Kss: bets $0.16
luisperse: folds 
Uncalled bet ($0.16) returned to Michael_Kss
Michael_Kss collected $0.48 from pot
*** SUMMARY ***
Total pot $0.50 | Rake $0.02 
Board [Jc Kd 3h]
Seat 3: Michael_Kss (small blind) collected ($0.48)
Seat 4: luisperse (big blind) folded on the Flop
Seat 6: FacuLarrocca (button) folded before Flop (didn't bet)



PokerStars Hand #222970041466:  Hold'em No Limit ($0.05/$0.10 USD) - 2021/01/23 15:43:02 ET
Table 'Transvaalia' 6-max Seat #3 is the button
Seat 2: johan416 ($10 in chips) 
Seat 3: Michael_Kss ($12.90 in chips) 
Seat 4: luisperse ($8.24 in chips) 
Seat 5: poseidoporunbot ($10 in chips) 
Seat 6: FacuLarrocca ($10 in chips) 
luisperse: posts small blind $0.05
poseidoporunbot: posts big blind $0.10
meteor9867: sits out 
johan416: posts big blind $0.10
*** HOLE CARDS ***
FacuLarrocca: folds 
johan416: raises $0.10 to $0.20
Michael_Kss: folds 
luisperse: folds 
poseidoporunbot: raises $1 to $1.20
johan416: calls $1
*** FLOP *** [Th 7d Jh]
poseidoporunbot: bets $0.50
johan416: calls $0.50
*** TURN *** [Th 7d Jh] [Jc]
poseidoporunbot: checks 
johan416: bets $1.10
poseidoporunbot: folds 
Uncalled bet ($1.10) returned to johan416
johan416 collected $3.29 from pot
johan416: doesn't show hand 
*** SUMMARY ***
Total pot $3.45 | Rake $0.16 
Board [Th 7d Jh Jc]
Seat 2: johan416 collected ($3.29)
Seat 3: Michael_Kss (button) folded before Flop (didn't bet)
Seat 4: luisperse (small blind) folded before Flop
Seat 5: poseidoporunbot (big blind) folded on the Turn
Seat 6: FacuLarrocca folded before Flop (didn't bet)



PokerStars Hand #222970110736:  Hold'em No Limit ($0.05/$0.10 USD) - 2021/01/23 15:44:25 ET
Table 'Transvaalia' 6-max Seat #4 is the button
Seat 2: johan416 ($11.59 in chips) 
Seat 3: Michael_Kss ($12.90 in chips) 
Seat 4: luisperse ($8.19 in chips) 
Seat 5: poseidoporunbot ($10 in chips) 
Seat 6: FacuLarrocca ($10 in chips) 
poseidoporunbot: posts small blind $0.05
FacuLarrocca: posts big blind $0.10
meteor9867: sits out 
*** HOLE CARDS ***
johan416: folds 
Michael_Kss: folds 
luisperse: folds 
poseidoporunbot: folds 
Uncalled bet ($0.05) returned to FacuLarrocca
FacuLarrocca collected $0.10 from pot
FacuLarrocca: doesn't show hand 
*** SUMMARY ***
Total pot $0.10 | Rake $0 
Seat 2: johan416 folded before Flop (didn't bet)
Seat 3: Michael_Kss folded before Flop (didn't bet)
Seat 4: luisperse (button) folded before Flop (didn't bet)
Seat 5: poseidoporunbot (small blind) folded before Flop
Seat 6: FacuLarrocca (big blind) collected ($0.10)



PokerStars Hand #222970127575:  Hold'em No Limit ($0.05/$0.10 USD) - 2021/01/23 15:44:45 ET
Table 'Transvaalia' 6-max Seat #5 is the button
Seat 1: meteor9867 ($10 in chips) 
Seat 2: johan416 ($11.59 in chips) 
Seat 3: Michael_Kss ($12.90 in chips) 
Seat 4: luisperse ($8.19 in chips) 
Seat 5: poseidoporunbot ($10 in chips) 
Seat 6: FacuLarrocca ($10.05 in chips) 
FacuLarrocca: posts small blind $0.05
meteor9867: posts big blind $0.10
*** HOLE CARDS ***
johan416: folds 
Michael_Kss: folds 
luisperse: folds 
poseidoporunbot: raises $0.15 to $0.25
FacuLarrocca: folds 
meteor9867: folds 
Uncalled bet ($0.15) returned to poseidoporunbot
poseidoporunbot collected $0.25 from pot
*** SUMMARY ***
Total pot $0.25 | Rake $0 
Seat 1: meteor9867 (big blind) folded before Flop
Seat 2: johan416 folded before Flop (didn't bet)
Seat 3: Michael_Kss folded before Flop (didn't bet)
Seat 4: luisperse folded before Flop (didn't bet)
Seat 5: poseidoporunbot (button) collected ($0.25)
Seat 6: FacuLarrocca (small blind) folded before Flop



PokerStars Hand #222970147816:  Hold'em No Limit ($0.05/$0.10 USD) - 2021/01/23 15:45:09 ET
Table 'Transvaalia' 6-max Seat #6 is the button
Seat 1: meteor9867 ($10 in chips) 
Seat 2: johan416 ($11.59 in chips) 
Seat 3: Michael_Kss ($12.90 in chips) 
Seat 4: luisperse ($8.19 in chips) 
Seat 5: poseidoporunbot ($10.15 in chips) 
Seat 6: FacuLarrocca ($10 in chips) 
meteor9867: posts small blind $0.05
johan416: posts big blind $0.10
*** HOLE CARDS ***
Michael_Kss: folds 
luisperse: calls $0.10
poseidoporunbot: folds 
FacuLarrocca: folds 
meteor9867: folds 
johan416: checks 
*** FLOP *** [Jc Ac Kc]
johan416: bets $0.10
luisperse: calls $0.10
*** TURN *** [Jc Ac Kc] [9d]
johan416: checks 
luisperse: checks 
*** RIVER *** [Jc Ac Kc 9d] [6s]
johan416: checks 
luisperse: checks 
*** SHOW DOWN ***
johan416: shows [7h Kh] (a pair of Kings)
luisperse: shows [Ah 3h] (a pair of Aces)
luisperse collected $0.43 from pot
*** SUMMARY ***
Total pot $0.45 | Rake $0.02 
Board [Jc Ac Kc 9d 6s]
Seat 1: meteor9867 (small blind) folded before Flop
Seat 2: johan416 (big blind) showed [7h Kh] and lost with a pair of Kings
Seat 3: Michael_Kss folded before Flop (didn't bet)
Seat 4: luisperse showed [Ah 3h] and won ($0.43) with a pair of Aces
Seat 5: poseidoporunbot folded before Flop (didn't bet)
Seat 6: FacuLarrocca (button) folded before Flop (didn't bet)



PokerStars Hand #222970187447:  Hold'em No Limit ($0.05/$0.10 USD) - 2021/01/23 15:45:56 ET
Table 'Transvaalia' 6-max Seat #1 is the button
Seat 1: meteor9867 ($10 in chips) 
Seat 2: johan416 ($11.39 in chips) 
Seat 3: Michael_Kss ($12.90 in chips) 
Seat 4: luisperse ($8.42 in chips) 
Seat 5: poseidoporunbot ($10.15 in chips) 
Seat 6: FacuLarrocca ($10 in chips) 
johan416: posts small blind $0.05
Michael_Kss: posts big blind $0.10
*** HOLE CARDS ***
luisperse: folds 
poseidoporunbot: folds 
FacuLarrocca: folds 
meteor9867: raises $0.15 to $0.25
johan416: calls $0.20
Michael_Kss: raises $0.90 to $1.15
meteor9867: folds 
johan416: folds 
Uncalled bet ($0.90) returned to Michael_Kss
Michael_Kss collected $0.75 from pot
*** SUMMARY ***
Total pot $0.75 | Rake $0 
Seat 1: meteor9867 (button) folded before Flop
Seat 2: johan416 (small blind) folded before Flop
Seat 3: Michael_Kss (big blind) collected ($0.75)
Seat 4: luisperse folded before Flop (didn't bet)
Seat 5: poseidoporunbot folded before Flop (didn't bet)
Seat 6: FacuLarrocca folded before Flop (didn't bet)



PokerStars Hand #222970227892:  Hold'em No Limit ($0.05/$0.10 USD) - 2021/01/23 15:46:44 ET
Table 'Transvaalia' 6-max Seat #2 is the button
Seat 1: meteor9867 ($10 in chips) 
Seat 2: johan416 ($11.14 in chips) 
Seat 3: Michael_Kss ($13.40 in chips) 
Seat 4: luisperse ($8.42 in chips) 
Seat 5: poseidoporunbot ($10.15 in chips) 
Seat 6: FacuLarrocca ($10 in chips) 
Michael_Kss: posts small blind $0.05
luisperse: posts big blind $0.10
*** HOLE CARDS ***
poseidoporunbot: folds 
FacuLarrocca: raises $0.20 to $0.30
meteor9867: folds 
johan416: folds 
Michael_Kss: raises $0.90 to $1.20
luisperse: folds 
FacuLarrocca: folds 
Uncalled bet ($0.90) returned to Michael_Kss
Michael_Kss collected $0.70 from pot
*** SUMMARY ***
Total pot $0.70 | Rake $0 
Seat 1: meteor9867 folded before Flop (didn't bet)
Seat 2: johan416 (button) folded before Flop (didn't bet)
Seat 3: Michael_Kss (small blind) collected ($0.70)
Seat 4: luisperse (big blind) folded before Flop
Seat 5: poseidoporunbot folded before Flop (didn't bet)
Seat 6: FacuLarrocca folded before Flop



PokerStars Hand #222970264380:  Hold'em No Limit ($0.05/$0.10 USD) - 2021/01/23 15:47:28 ET
Table 'Transvaalia' 6-max Seat #3 is the button
Seat 1: meteor9867 ($10 in chips) 
Seat 2: johan416 ($11.14 in chips) 
Seat 3: Michael_Kss ($13.80 in chips) 
Seat 4: luisperse ($8.32 in chips) 
Seat 6: FacuLarrocca ($10 in chips) 
luisperse: posts small blind $0.05
poseidoporunbot: is sitting out 
FacuLarrocca: posts big blind $0.10
*** HOLE CARDS ***
poseidoporunbot leaves the table
meteor9867: folds 
johan416: raises $0.20 to $0.30
Michael_Kss: folds 
luisperse: folds 
FacuLarrocca: folds 
Uncalled bet ($0.20) returned to johan416
johan416 collected $0.25 from pot
johan416: doesn't show hand 
*** SUMMARY ***
Total pot $0.25 | Rake $0 
Seat 1: meteor9867 folded before Flop (didn't bet)
Seat 2: johan416 collected ($0.25)
Seat 3: Michael_Kss (button) folded before Flop (didn't bet)
Seat 4: luisperse (small blind) folded before Flop
Seat 6: FacuLarrocca (big blind) folded before Flop



PokerStars Hand #222970278879:  Hold'em No Limit ($0.05/$0.10 USD) - 2021/01/23 15:47:45 ET
Table 'Transvaalia' 6-max Seat #4 is the button
Seat 1: meteor9867 ($10 in chips) 
Seat 2: johan416 ($11.29 in chips) 
Seat 3: Michael_Kss ($13.80 in chips) 
Seat 4: luisperse ($8.27 in chips) 
Seat 6: FacuLarrocca ($10 in chips) 
FacuLarrocca: posts small blind $0.05
meteor9867: posts big blind $0.10
*** HOLE CARDS ***
johan416: calls $0.10
Michael_Kss: folds 
luisperse: folds 
FacuLarrocca: folds 
Oleg032 joins the table at seat #5 
meteor9867: checks 
*** FLOP *** [6h 6c Js]
meteor9867: checks 
johan416: bets $0.10
meteor9867: calls $0.10
*** TURN *** [6h 6c Js] [9h]
meteor9867: bets $0.18
Michael_Kss leaves the table
johan416: calls $0.18
*** RIVER *** [6h 6c Js 9h] [Ah]
meteor9867: checks 
johan416: checks 
*** SHOW DOWN ***
meteor9867: shows [5h Jc] (two pair, Jacks and Sixes)
johan416: mucks hand 
meteor9867 collected $0.77 from pot
*** SUMMARY ***
Total pot $0.81 | Rake $0.04 
Board [6h 6c Js 9h Ah]
Seat 1: meteor9867 (big blind) showed [5h Jc] and won ($0.77) with two pair, Jacks and Sixes
Seat 2: johan416 mucked
Seat 3: Michael_Kss folded before Flop (didn't bet)
Seat 4: luisperse (button) folded before Flop (didn't bet)
Seat 6: FacuLarrocca (small blind) folded before Flop



PokerStars Hand #222970305923:  Hold'em No Limit ($0.05/$0.10 USD) - 2021/01/23 15:48:18 ET
Table 'Transvaalia' 6-max Seat #6 is the button
Seat 1: meteor9867 ($10.39 in chips) 
Seat 2: johan416 ($10.91 in chips) 
Seat 4: luisperse ($8.27 in chips) 
Seat 6: FacuLarrocca ($10 in chips) 
meteor9867: posts small blind $0.05
johan416: posts big blind $0.10
Oleg032: sits out 
*** HOLE CARDS ***
luisperse: folds 
eddieamn joins the table at seat #3 
FacuLarrocca: raises $0.15 to $0.25
meteor9867: folds 
johan416: folds 
Uncalled bet ($0.15) returned to FacuLarrocca
FacuLarrocca collected $0.25 from pot
FacuLarrocca: doesn't show hand 
*** SUMMARY ***
Total pot $0.25 | Rake $0 
Seat 1: meteor9867 (small blind) folded before Flop
Seat 2: johan416 (big blind) folded before Flop
Seat 4: luisperse folded before Flop (didn't bet)
Seat 6: FacuLarrocca (button) collected ($0.25)



PokerStars Hand #222970313891:  Hold'em No Limit ($0.05/$0.10 USD) - 2021/01/23 15:48:27 ET
Table 'Transvaalia' 6-max Seat #1 is the button
Seat 1: meteor9867 ($10.34 in chips) 
Seat 2: johan416 ($10.81 in chips) 
Seat 3: eddieamn ($10 in chips) 
Seat 4: luisperse ($8.27 in chips) 
Seat 6: FacuLarrocca ($10.15 in chips) 
johan416: posts small blind $0.05
eddieamn: posts big blind $0.10
Oleg032: sits out 
*** HOLE CARDS ***
luisperse: folds 
FacuLarrocca: folds 
meteor9867: folds 
johan416: calls $0.05
eddieamn: checks 
*** FLOP *** [7d 9c Ad]
johan416: bets $0.10
eddieamn: raises $0.50 to $0.60
johan416: folds 
Uncalled bet ($0.50) returned to eddieamn
eddieamn collected $0.38 from pot
*** SUMMARY ***
Total pot $0.40 | Rake $0.02 
Board [7d 9c Ad]
Seat 1: meteor9867 (button) folded before Flop (didn't bet)
Seat 2: johan416 (small blind) folded on the Flop
Seat 3: eddieamn (big blind) collected ($0.38)
Seat 4: luisperse folded before Flop (didn't bet)
Seat 6: FacuLarrocca folded before Flop (didn't bet)



PokerStars Hand #222970336807:  Hold'em No Limit ($0.05/$0.10 USD) - 2021/01/23 15:48:55 ET
Table 'Transvaalia' 6-max Seat #2 is the button
Seat 1: meteor9867 ($10.34 in chips) 
Seat 2: johan416 ($10.61 in chips) 
Seat 3: eddieamn ($10.18 in chips) 
Seat 4: luisperse ($8.27 in chips) 
Seat 6: FacuLarrocca ($10.15 in chips) 
eddieamn: posts small blind $0.05
luisperse: posts big blind $0.10
Oleg032: sits out 
*** HOLE CARDS ***
FacuLarrocca: folds 
meteor9867: folds 
johan416: folds 
eddieamn: folds 
Uncalled bet ($0.05) returned to luisperse
luisperse collected $0.10 from pot
luisperse: doesn't show hand 
*** SUMMARY ***
Total pot $0.10 | Rake $0 
Seat 1: meteor9867 folded before Flop (didn't bet)
Seat 2: johan416 (button) folded before Flop (didn't bet)
Seat 3: eddieamn (small blind) folded before Flop
Seat 4: luisperse (big blind) collected ($0.10)
Seat 6: FacuLarrocca folded before Flop (didn't bet)



PokerStars Hand #222970346264:  Hold'em No Limit ($0.05/$0.10 USD) - 2021/01/23 15:49:06 ET
Table 'Transvaalia' 6-max Seat #3 is the button
Seat 1: meteor9867 ($10.34 in chips) 
Seat 2: johan416 ($10.61 in chips) 
Seat 3: eddieamn ($10.13 in chips) 
Seat 4: luisperse ($8.32 in chips) 
Seat 5: Oleg032 ($10 in chips) 
Seat 6: FacuLarrocca ($10.15 in chips) 
luisperse: posts small blind $0.05
Oleg032: posts big blind $0.10
*** HOLE CARDS ***
FacuLarrocca: folds 
meteor9867: folds 
johan416: folds 
eddieamn: raises $0.20 to $0.30
luisperse: folds 
Oleg032: folds 
Uncalled bet ($0.20) returned to eddieamn
eddieamn collected $0.25 from pot
*** SUMMARY ***
Total pot $0.25 | Rake $0 
Seat 1: meteor9867 folded before Flop (didn't bet)
Seat 2: johan416 folded before Flop (didn't bet)
Seat 3: eddieamn (button) collected ($0.25)
Seat 4: luisperse (small blind) folded before Flop
Seat 5: Oleg032 (big blind) folded before Flop
Seat 6: FacuLarrocca folded before Flop (didn't bet)



PokerStars Hand #222970357273:  Hold'em No Limit ($0.05/$0.10 USD) - 2021/01/23 15:49:19 ET
Table 'Transvaalia' 6-max Seat #4 is the button
Seat 1: meteor9867 ($10.34 in chips) 
Seat 2: johan416 ($10.61 in chips) 
Seat 3: eddieamn ($10.28 in chips) 
Seat 4: luisperse ($8.27 in chips) 
Seat 5: Oleg032 ($10 in chips) 
Seat 6: FacuLarrocca ($10.15 in chips) 
Oleg032: posts small blind $0.05
FacuLarrocca: posts big blind $0.10
*** HOLE CARDS ***
meteor9867: folds 
johan416: folds 
eddieamn: raises $0.20 to $0.30
luisperse: folds 
Oleg032: folds 
FacuLarrocca: folds 
Uncalled bet ($0.20) returned to eddieamn
eddieamn collected $0.25 from pot
*** SUMMARY ***
Total pot $0.25 | Rake $0 
Seat 1: meteor9867 folded before Flop (didn't bet)
Seat 2: johan416 folded before Flop (didn't bet)
Seat 3: eddieamn collected ($0.25)
Seat 4: luisperse (button) folded before Flop (didn't bet)
Seat 5: Oleg032 (small blind) folded before Flop
Seat 6: FacuLarrocca (big blind) folded before Flop



PokerStars Hand #222970367472:  Hold'em No Limit ($0.05/$0.10 USD) - 2021/01/23 15:49:32 ET
Table 'Transvaalia' 6-max Seat #5 is the button
Seat 2: johan416 ($10.61 in chips) 
Seat 3: eddieamn ($10.43 in chips) 
Seat 4: luisperse ($8.27 in chips) 
Seat 5: Oleg032 ($10 in chips) 
Seat 6: FacuLarrocca ($10.05 in chips) 
FacuLarrocca: posts small blind $0.05
meteor9867: is sitting out 
johan416: posts big blind $0.10
*** HOLE CARDS ***
meteor9867 leaves the table
eddieamn: folds 
luisperse: folds 
Oleg032: folds 
FacuLarrocca: folds 
Uncalled bet ($0.05) returned to johan416
johan416 collected $0.10 from pot
johan416: doesn't show hand 
*** SUMMARY ***
Total pot $0.10 | Rake $0 
Seat 2: johan416 (big blind) collected ($0.10)
Seat 3: eddieamn folded before Flop (didn't bet)
Seat 4: luisperse folded before Flop (didn't bet)
Seat 5: Oleg032 (button) folded before Flop (didn't bet)
Seat 6: FacuLarrocca (small blind) folded before Flop



PokerStars Hand #222970380095:  Hold'em No Limit ($0.05/$0.10 USD) - 2021/01/23 15:49:47 ET
Table 'Transvaalia' 6-max Seat #6 is the button
Seat 2: johan416 ($10.66 in chips) 
Seat 3: eddieamn ($10.43 in chips) 
Seat 4: luisperse ($8.27 in chips) 
Seat 5: Oleg032 ($10 in chips) 
Seat 6: FacuLarrocca ($10 in chips) 
johan416: posts small blind $0.05
eddieamn: posts big blind $0.10
*** HOLE CARDS ***
luisperse: folds 
Oleg032: folds 
FacuLarrocca: raises $0.20 to $0.30
johan416: folds 
eddieamn: folds 
Uncalled bet ($0.20) returned to FacuLarrocca
FacuLarrocca collected $0.25 from pot
FacuLarrocca: doesn't show hand 
*** SUMMARY ***
Total pot $0.25 | Rake $0 
Seat 2: johan416 (small blind) folded before Flop
Seat 3: eddieamn (big blind) folded before Flop
Seat 4: luisperse folded before Flop (didn't bet)
Seat 5: Oleg032 folded before Flop (didn't bet)
Seat 6: FacuLarrocca (button) collected ($0.25)



PokerStars Hand #222970394003:  Hold'em No Limit ($0.05/$0.10 USD) - 2021/01/23 15:50:03 ET
Table 'Transvaalia' 6-max Seat #2 is the button
Seat 2: johan416 ($10.61 in chips) 
Seat 3: eddieamn ($10.33 in chips) 
Seat 4: luisperse ($8.27 in chips) 
Seat 5: Oleg032 ($10 in chips) 
Seat 6: FacuLarrocca ($10.15 in chips) 
eddieamn: posts small blind $0.05
luisperse: posts big blind $0.10
*** HOLE CARDS ***
Oleg032: folds 
FacuLarrocca: raises $0.20 to $0.30
johan416: folds 
eddieamn: folds 
luisperse: calls $0.20
*** FLOP *** [3s 6s Ac]
luisperse: checks 
FacuLarrocca: checks 
*** TURN *** [3s 6s Ac] [Kh]
luisperse: checks 
FacuLarrocca: checks 
*** RIVER *** [3s 6s Ac Kh] [4s]
luisperse: bets $0.31
FacuLarrocca: folds 
Uncalled bet ($0.31) returned to luisperse
luisperse collected $0.62 from pot
luisperse: doesn't show hand 
*** SUMMARY ***
Total pot $0.65 | Rake $0.03 
Board [3s 6s Ac Kh 4s]
Seat 2: johan416 (button) folded before Flop (didn't bet)
Seat 3: eddieamn (small blind) folded before Flop
Seat 4: luisperse (big blind) collected ($0.62)
Seat 5: Oleg032 folded before Flop (didn't bet)
Seat 6: FacuLarrocca folded on the River



PokerStars Hand #222970422706:  Hold'em No Limit ($0.05/$0.10 USD) - 2021/01/23 15:50:38 ET
Table 'Transvaalia' 6-max Seat #3 is the button
Seat 2: johan416 ($10.61 in chips) 
Seat 3: eddieamn ($10.28 in chips) 
Seat 4: luisperse ($8.59 in chips) 
Seat 5: Oleg032 ($10 in chips) 
Seat 6: FacuLarrocca ($10 in chips) 
luisperse: posts small blind $0.05
Oleg032: posts big blind $0.10
*** HOLE CARDS ***
FacuLarrocca: folds 
broo2522 joins the table at seat #1 
johan416: raises $0.30 to $0.40
eddieamn: folds 
luisperse: folds 
Oleg032: folds 
Uncalled bet ($0.30) returned to johan416
johan416 collected $0.25 from pot
johan416: doesn't show hand 
*** SUMMARY ***
Total pot $0.25 | Rake $0 
Seat 2: johan416 collected ($0.25)
Seat 3: eddieamn (button) folded before Flop (didn't bet)
Seat 4: luisperse (small blind) folded before Flop
Seat 5: Oleg032 (big blind) folded before Flop
Seat 6: FacuLarrocca folded before Flop (didn't bet)



PokerStars Hand #222970444898:  Hold'em No Limit ($0.05/$0.10 USD) - 2021/01/23 15:51:05 ET
Table 'Transvaalia' 6-max Seat #4 is the button
Seat 1: broo2522 ($8 in chips) 
Seat 2: johan416 ($10.76 in chips) 
Seat 3: eddieamn ($10.28 in chips) 
Seat 4: luisperse ($8.54 in chips) 
Seat 5: Oleg032 ($10 in chips) 
Seat 6: FacuLarrocca ($10 in chips) 
Oleg032: posts small blind $0.05
FacuLarrocca: posts big blind $0.10
broo2522: posts big blind $0.10
*** HOLE CARDS ***
broo2522: raises $0.10 to $0.20
johan416: folds 
eddieamn: folds 
luisperse: folds 
Oleg032: folds 
FacuLarrocca: folds 
Uncalled bet ($0.10) returned to broo2522
broo2522 collected $0.25 from pot
broo2522: doesn't show hand 
*** SUMMARY ***
Total pot $0.25 | Rake $0 
Seat 1: broo2522 collected ($0.25)
Seat 2: johan416 folded before Flop (didn't bet)
Seat 3: eddieamn folded before Flop (didn't bet)
Seat 4: luisperse (button) folded before Flop (didn't bet)
Seat 5: Oleg032 (small blind) folded before Flop
Seat 6: FacuLarrocca (big blind) folded before Flop



PokerStars Hand #222970454386:  Hold'em No Limit ($0.05/$0.10 USD) - 2021/01/23 15:51:16 ET
Table 'Transvaalia' 6-max Seat #5 is the button
Seat 1: broo2522 ($8.15 in chips) 
Seat 2: johan416 ($10.76 in chips) 
Seat 3: eddieamn ($10.28 in chips) 
Seat 4: luisperse ($8.54 in chips) 
Seat 5: Oleg032 ($10 in chips) 
Seat 6: FacuLarrocca ($10 in chips) 
FacuLarrocca: posts small blind $0.05
broo2522: posts big blind $0.10
*** HOLE CARDS ***
johan416: raises $0.20 to $0.30
eddieamn: folds 
luisperse: calls $0.30
Oleg032: folds 
FacuLarrocca: folds 
broo2522: calls $0.20
*** FLOP *** [Qc 8h 6h]
broo2522: checks 
johan416: checks 
luisperse: bets $0.46
broo2522: calls $0.46
johan416: folds 
*** TURN *** [Qc 8h 6h] [Ah]
broo2522: checks 
luisperse: bets $1.79
broo2522: folds 
Uncalled bet ($1.79) returned to luisperse
luisperse collected $1.79 from pot
luisperse: doesn't show hand 
*** SUMMARY ***
Total pot $1.87 | Rake $0.08 
Board [Qc 8h 6h Ah]
Seat 1: broo2522 (big blind) folded on the Turn
Seat 2: johan416 folded on the Flop
Seat 3: eddieamn folded before Flop (didn't bet)
Seat 4: luisperse collected ($1.79)
Seat 5: Oleg032 (button) folded before Flop (didn't bet)
Seat 6: FacuLarrocca (small blind) folded before Flop



PokerStars Hand #222970506230:  Hold'em No Limit ($0.05/$0.10 USD) - 2021/01/23 15:52:18 ET
Table 'Transvaalia' 6-max Seat #6 is the button
Seat 1: broo2522 ($7.39 in chips) 
Seat 2: johan416 ($10.46 in chips) 
Seat 3: eddieamn ($10.28 in chips) 
Seat 4: luisperse ($9.57 in chips) 
Seat 5: Oleg032 ($10 in chips) 
Seat 6: FacuLarrocca ($10 in chips) 
broo2522: posts small blind $0.05
johan416: posts big blind $0.10
*** HOLE CARDS ***
eddieamn: folds 
luisperse: raises $0.10 to $0.20
Oleg032: folds 
FacuLarrocca: folds 
broo2522: folds 
johan416: calls $0.10
*** FLOP *** [3d 6d Qc]
johan416: checks 
luisperse: bets $0.43
johan416: calls $0.43
*** TURN *** [3d 6d Qc] [3s]
johan416: checks 
luisperse: bets $1.25
johan416: calls $1.25
*** RIVER *** [3d 6d Qc 3s] [Jh]
johan416: checks 
luisperse: bets $1.82
johan416: calls $1.82
*** SHOW DOWN ***
luisperse: shows [Kd Ks] (two pair, Kings and Threes)
johan416: mucks hand 
luisperse collected $7.11 from pot
*** SUMMARY ***
Total pot $7.45 | Rake $0.34 
Board [3d 6d Qc 3s Jh]
Seat 1: broo2522 (small blind) folded before Flop
Seat 2: johan416 (big blind) mucked
Seat 3: eddieamn folded before Flop (didn't bet)
Seat 4: luisperse showed [Kd Ks] and won ($7.11) with two pair, Kings and Threes
Seat 5: Oleg032 folded before Flop (didn't bet)
Seat 6: FacuLarrocca (button) folded before Flop (didn't bet)



PokerStars Hand #222970553036:  Hold'em No Limit ($0.05/$0.10 USD) - 2021/01/23 15:53:14 ET
Table 'Transvaalia' 6-max Seat #1 is the button
Seat 1: broo2522 ($7.34 in chips) 
Seat 2: johan416 ($6.76 in chips) 
Seat 3: eddieamn ($10.28 in chips) 
Seat 4: luisperse ($12.98 in chips) 
Seat 5: Oleg032 ($10 in chips) 
Seat 6: FacuLarrocca ($10 in chips) 
johan416: posts small blind $0.05
eddieamn: posts big blind $0.10
*** HOLE CARDS ***
luisperse has timed out
luisperse: folds 
Oleg032: folds 
FacuLarrocca: folds 
broo2522: folds 
johan416: calls $0.05
eddieamn: checks 
*** FLOP *** [4h 5s Kc]
johan416: bets $0.10
eddieamn: calls $0.10
*** TURN *** [4h 5s Kc] [9s]
johan416: checks 
eddieamn: checks 
*** RIVER *** [4h 5s Kc 9s] [Th]
johan416: checks 
eddieamn: checks 
*** SHOW DOWN ***
johan416: shows [Ah 4d] (a pair of Fours)
eddieamn: shows [6s 5c] (a pair of Fives)
eddieamn collected $0.38 from pot
*** SUMMARY ***
Total pot $0.40 | Rake $0.02 
Board [4h 5s Kc 9s Th]
Seat 1: broo2522 (button) folded before Flop (didn't bet)
Seat 2: johan416 (small blind) showed [Ah 4d] and lost with a pair of Fours
Seat 3: eddieamn (big blind) showed [6s 5c] and won ($0.38) with a pair of Fives
Seat 4: luisperse folded before Flop (didn't bet)
Seat 5: Oleg032 folded before Flop (didn't bet)
Seat 6: FacuLarrocca folded before Flop (didn't bet)



PokerStars Hand #222970587244:  Hold'em No Limit ($0.05/$0.10 USD) - 2021/01/23 15:53:55 ET
Table 'Transvaalia' 6-max Seat #2 is the button
Seat 1: broo2522 ($7.34 in chips) 
Seat 2: johan416 ($6.56 in chips) 
Seat 3: eddieamn ($10.46 in chips) 
Seat 4: luisperse ($12.98 in chips) 
Seat 5: Oleg032 ($10 in chips) 
Seat 6: FacuLarrocca ($10 in chips) 
eddieamn: posts small blind $0.05
luisperse: posts big blind $0.10
*** HOLE CARDS ***
Oleg032: folds 
FacuLarrocca: folds 
broo2522: folds 
johan416: calls $0.10
eddieamn: raises $0.50 to $0.60
luisperse: folds 
johan416: folds 
Uncalled bet ($0.50) returned to eddieamn
eddieamn collected $0.30 from pot
*** SUMMARY ***
Total pot $0.30 | Rake $0 
Seat 1: broo2522 folded before Flop (didn't bet)
Seat 2: johan416 (button) folded before Flop
Seat 3: eddieamn (small blind) collected ($0.30)
Seat 4: luisperse (big blind) folded before Flop
Seat 5: Oleg032 folded before Flop (didn't bet)
Seat 6: FacuLarrocca folded before Flop (didn't bet)



PokerStars Hand #222970603142:  Hold'em No Limit ($0.05/$0.10 USD) - 2021/01/23 15:54:14 ET
Table 'Transvaalia' 6-max Seat #3 is the button
Seat 1: broo2522 ($7.34 in chips) 
Seat 2: johan416 ($6.46 in chips) 
Seat 3: eddieamn ($10.66 in chips) 
Seat 4: luisperse ($12.88 in chips) 
Seat 5: Oleg032 ($10 in chips) 
Seat 6: FacuLarrocca ($10 in chips) 
luisperse: posts small blind $0.05
Oleg032: posts big blind $0.10
*** HOLE CARDS ***
FacuLarrocca: folds 
broo2522: calls $0.10
johan416: folds 
eddieamn: folds 
luisperse: calls $0.05
Oleg032: checks 
*** FLOP *** [Kc 7d Ah]
luisperse: bets $0.15
Oleg032: folds 
broo2522: calls $0.15
*** TURN *** [Kc 7d Ah] [Qh]
luisperse: bets $0.57
broo2522: calls $0.57
*** RIVER *** [Kc 7d Ah Qh] [2h]
luisperse: checks 
broo2522: checks 
*** SHOW DOWN ***
luisperse: shows [Ad 3s] (a pair of Aces)
broo2522: mucks hand 
luisperse collected $1.66 from pot
*** SUMMARY ***
Total pot $1.74 | Rake $0.08 
Board [Kc 7d Ah Qh 2h]
Seat 1: broo2522 mucked
Seat 2: johan416 folded before Flop (didn't bet)
Seat 3: eddieamn (button) folded before Flop (didn't bet)
Seat 4: luisperse (small blind) showed [Ad 3s] and won ($1.66) with a pair of Aces
Seat 5: Oleg032 (big blind) folded on the Flop
Seat 6: FacuLarrocca folded before Flop (didn't bet)



PokerStars Hand #222970641052:  Hold'em No Limit ($0.05/$0.10 USD) - 2021/01/23 15:55:00 ET
Table 'Transvaalia' 6-max Seat #4 is the button
Seat 1: broo2522 ($6.52 in chips) 
Seat 2: johan416 ($6.46 in chips) 
Seat 3: eddieamn ($10.66 in chips) 
Seat 4: luisperse ($13.72 in chips) 
Seat 5: Oleg032 ($10 in chips) 
Seat 6: FacuLarrocca ($10 in chips) 
Oleg032: posts small blind $0.05
FacuLarrocca: posts big blind $0.10
*** HOLE CARDS ***
broo2522: raises $0.10 to $0.20
johan416: calls $0.20
eddieamn: folds 
luisperse: raises $0.10 to $0.30
Oleg032: folds 
FacuLarrocca: folds 
broo2522: calls $0.10
johan416: calls $0.10
*** FLOP *** [9s 4h 3c]
broo2522: checks 
johan416: checks 
luisperse: bets $1
broo2522: calls $1
johan416: calls $1
*** TURN *** [9s 4h 3c] [9d]
broo2522: checks 
johan416: checks 
luisperse: bets $1.10
broo2522: folds 
johan416: folds 
Uncalled bet ($1.10) returned to luisperse
luisperse collected $3.87 from pot
luisperse: doesn't show hand 
*** SUMMARY ***
Total pot $4.05 | Rake $0.18 
Board [9s 4h 3c 9d]
Seat 1: broo2522 folded on the Turn
Seat 2: johan416 folded on the Turn
Seat 3: eddieamn folded before Flop (didn't bet)
Seat 4: luisperse (button) collected ($3.87)
Seat 5: Oleg032 (small blind) folded before Flop
Seat 6: FacuLarrocca (big blind) folded before Flop



PokerStars Hand #222970680728:  Hold'em No Limit ($0.05/$0.10 USD) - 2021/01/23 15:55:58 ET
Table 'Transvaalia' 6-max Seat #5 is the button
Seat 1: broo2522 ($5.22 in chips) 
Seat 2: johan416 ($5.16 in chips) 
Seat 3: eddieamn ($10.66 in chips) 
Seat 4: luisperse ($16.29 in chips) 
Seat 5: Oleg032 ($10 in chips) 
Seat 6: FacuLarrocca ($10 in chips) 
FacuLarrocca: posts small blind $0.05
broo2522: posts big blind $0.10
*** HOLE CARDS ***
johan416: raises $0.10 to $0.20
eddieamn: folds 
luisperse: folds 
Oleg032: folds 
FacuLarrocca: folds 
broo2522: folds 
Uncalled bet ($0.10) returned to johan416
johan416 collected $0.25 from pot
johan416: doesn't show hand 
*** SUMMARY ***
Total pot $0.25 | Rake $0 
Seat 1: broo2522 (big blind) folded before Flop
Seat 2: johan416 collected ($0.25)
Seat 3: eddieamn folded before Flop (didn't bet)
Seat 4: luisperse folded before Flop (didn't bet)
Seat 5: Oleg032 (button) folded before Flop (didn't bet)
Seat 6: FacuLarrocca (small blind) folded before Flop



PokerStars Hand #222970693056:  Hold'em No Limit ($0.05/$0.10 USD) - 2021/01/23 15:56:20 ET
Table 'Transvaalia' 6-max Seat #6 is the button
Seat 1: broo2522 ($5.12 in chips) 
Seat 2: johan416 ($5.31 in chips) 
Seat 3: eddieamn ($10.66 in chips) 
Seat 4: luisperse ($16.29 in chips) 
Seat 5: Oleg032 ($10 in chips) 
Seat 6: FacuLarrocca ($10 in chips) 
broo2522: posts small blind $0.05
johan416: posts big blind $0.10
*** HOLE CARDS ***
eddieamn: folds 
luisperse: folds 
Oleg032: folds 
FacuLarrocca: raises $0.15 to $0.25
broo2522: calls $0.20
johan416: calls $0.15
*** FLOP *** [7d 3d 7c]
broo2522: checks 
johan416: bets $0.20
FacuLarrocca: folds 
broo2522: folds 
Uncalled bet ($0.20) returned to johan416
johan416 collected $0.72 from pot
johan416: doesn't show hand 
*** SUMMARY ***
Total pot $0.75 | Rake $0.03 
Board [7d 3d 7c]
Seat 1: broo2522 (small blind) folded on the Flop
Seat 2: johan416 (big blind) collected ($0.72)
Seat 3: eddieamn folded before Flop (didn't bet)
Seat 4: luisperse folded before Flop (didn't bet)
Seat 5: Oleg032 folded before Flop (didn't bet)
Seat 6: FacuLarrocca (button) folded on the Flop



PokerStars Hand #222970716430:  Hold'em No Limit ($0.05/$0.10 USD) - 2021/01/23 15:57:02 ET
Table 'Transvaalia' 6-max Seat #1 is the button
Seat 1: broo2522 ($4.87 in chips) 
Seat 2: johan416 ($5.78 in chips) 
Seat 3: eddieamn ($10.66 in chips) 
Seat 4: luisperse ($16.29 in chips) 
Seat 5: Oleg032 ($10 in chips) 
Seat 6: FacuLarrocca ($10 in chips) 
johan416: posts small blind $0.05
eddieamn: posts big blind $0.10
*** HOLE CARDS ***
luisperse: folds 
Oleg032: folds 
FacuLarrocca: folds 
broo2522: folds 
johan416: calls $0.05
eddieamn: checks 
*** FLOP *** [5c Ah Qd]
johan416: bets $0.10
eddieamn: raises $0.70 to $0.80
johan416: folds 
Uncalled bet ($0.70) returned to eddieamn
eddieamn collected $0.38 from pot
*** SUMMARY ***
Total pot $0.40 | Rake $0.02 
Board [5c Ah Qd]
Seat 1: broo2522 (button) folded before Flop (didn't bet)
Seat 2: johan416 (small blind) folded on the Flop
Seat 3: eddieamn (big blind) collected ($0.38)
Seat 4: luisperse folded before Flop (didn't bet)
Seat 5: Oleg032 folded before Flop (didn't bet)
Seat 6: FacuLarrocca folded before Flop (didn't bet)



PokerStars Hand #222970739262:  Hold'em No Limit ($0.05/$0.10 USD) - 2021/01/23 15:57:42 ET
Table 'Transvaalia' 6-max Seat #2 is the button
Seat 1: broo2522 ($4.87 in chips) 
Seat 2: johan416 ($5.58 in chips) 
Seat 3: eddieamn ($10.84 in chips) 
Seat 4: luisperse ($16.29 in chips) 
Seat 5: Oleg032 ($10 in chips) 
Seat 6: FacuLarrocca ($10 in chips) 
eddieamn: posts small blind $0.05
luisperse: posts big blind $0.10
*** HOLE CARDS ***
Oleg032: folds 
FacuLarrocca: folds 
broo2522: folds 
johan416: folds 
eddieamn: raises $0.20 to $0.30
luisperse: calls $0.20
*** FLOP *** [8c Ah 9d]
eddieamn: checks 
luisperse: checks 
*** TURN *** [8c Ah 9d] [9s]
eddieamn: bets $0.30
luisperse: folds 
Uncalled bet ($0.30) returned to eddieamn
eddieamn collected $0.57 from pot
*** SUMMARY ***
Total pot $0.60 | Rake $0.03 
Board [8c Ah 9d 9s]
Seat 1: broo2522 folded before Flop (didn't bet)
Seat 2: johan416 (button) folded before Flop (didn't bet)
Seat 3: eddieamn (small blind) collected ($0.57)
Seat 4: luisperse (big blind) folded on the Turn
Seat 5: Oleg032 folded before Flop (didn't bet)
Seat 6: FacuLarrocca folded before Flop (didn't bet)



PokerStars Hand #222970753091:  Hold'em No Limit ($0.05/$0.10 USD) - 2021/01/23 15:58:06 ET
Table 'Transvaalia' 6-max Seat #3 is the button
Seat 1: broo2522 ($4.87 in chips) 
Seat 2: johan416 ($5.58 in chips) 
Seat 3: eddieamn ($11.11 in chips) 
Seat 4: luisperse ($15.99 in chips) 
Seat 5: Oleg032 ($10 in chips) 
Seat 6: FacuLarrocca ($10 in chips) 
luisperse: posts small blind $0.05
Oleg032: posts big blind $0.10
*** HOLE CARDS ***
FacuLarrocca: raises $0.20 to $0.30
broo2522: folds 
johan416: folds 
eddieamn: folds 
luisperse: folds 
Oleg032: folds 
Uncalled bet ($0.20) returned to FacuLarrocca
FacuLarrocca collected $0.25 from pot
FacuLarrocca: doesn't show hand 
*** SUMMARY ***
Total pot $0.25 | Rake $0 
Seat 1: broo2522 folded before Flop (didn't bet)
Seat 2: johan416 folded before Flop (didn't bet)
Seat 3: eddieamn (button) folded before Flop (didn't bet)
Seat 4: luisperse (small blind) folded before Flop
Seat 5: Oleg032 (big blind) folded before Flop
Seat 6: FacuLarrocca collected ($0.25)



PokerStars Hand #222970770325:  Hold'em No Limit ($0.05/$0.10 USD) - 2021/01/23 15:58:36 ET
Table 'Transvaalia' 6-max Seat #4 is the button
Seat 1: broo2522 ($4.87 in chips) 
Seat 2: johan416 ($5.58 in chips) 
Seat 3: eddieamn ($11.11 in chips) 
Seat 4: luisperse ($15.94 in chips) 
Seat 5: Oleg032 ($10 in chips) 
Seat 6: FacuLarrocca ($10.15 in chips) 
Oleg032: posts small blind $0.05
FacuLarrocca: posts big blind $0.10
*** HOLE CARDS ***
broo2522: raises $0.10 to $0.20
johan416: folds 
eddieamn: folds 
luisperse: calls $0.20
Oleg032: folds 
FacuLarrocca: folds 
*** FLOP *** [6h 7s 4h]
broo2522: bets $0.10
luisperse: folds 
Uncalled bet ($0.10) returned to broo2522
broo2522 collected $0.53 from pot
broo2522: doesn't show hand 
*** SUMMARY ***
Total pot $0.55 | Rake $0.02 
Board [6h 7s 4h]
Seat 1: broo2522 collected ($0.53)
Seat 2: johan416 folded before Flop (didn't bet)
Seat 3: eddieamn folded before Flop (didn't bet)
Seat 4: luisperse (button) folded on the Flop
Seat 5: Oleg032 (small blind) folded before Flop
Seat 6: FacuLarrocca (big blind) folded before Flop



PokerStars Hand #222970786521:  Hold'em No Limit ($0.05/$0.10 USD) - 2021/01/23 15:59:05 ET
Table 'Transvaalia' 6-max Seat #5 is the button
Seat 1: broo2522 ($5.20 in chips) 
Seat 2: johan416 ($5.58 in chips) 
Seat 3: eddieamn ($11.11 in chips) 
Seat 4: luisperse ($15.74 in chips) 
Seat 5: Oleg032 ($10 in chips) 
Seat 6: FacuLarrocca ($10.05 in chips) 
FacuLarrocca: posts small blind $0.05
broo2522: posts big blind $0.10
*** HOLE CARDS ***
johan416: raises $0.20 to $0.30
eddieamn: folds 
luisperse: folds 
Oleg032: folds 
FacuLarrocca: folds 
broo2522: folds 
Uncalled bet ($0.20) returned to johan416
johan416 collected $0.25 from pot
johan416: doesn't show hand 
*** SUMMARY ***
Total pot $0.25 | Rake $0 
Seat 1: broo2522 (big blind) folded before Flop
Seat 2: johan416 collected ($0.25)
Seat 3: eddieamn folded before Flop (didn't bet)
Seat 4: luisperse folded before Flop (didn't bet)
Seat 5: Oleg032 (button) folded before Flop (didn't bet)
Seat 6: FacuLarrocca (small blind) folded before Flop



PokerStars Hand #222970797630:  Hold'em No Limit ($0.05/$0.10 USD) - 2021/01/23 15:59:25 ET
Table 'Transvaalia' 6-max Seat #6 is the button
Seat 1: broo2522 ($5.10 in chips) 
Seat 2: johan416 ($5.73 in chips) 
Seat 3: eddieamn ($11.11 in chips) 
Seat 4: luisperse ($15.74 in chips) 
Seat 5: Oleg032 ($10 in chips) 
Seat 6: FacuLarrocca ($10 in chips) 
broo2522: posts small blind $0.05
johan416: posts big blind $0.10
*** HOLE CARDS ***
eddieamn: folds 
luisperse: calls $0.10
Oleg032: folds 
FacuLarrocca: folds 
broo2522: calls $0.05
johan416: checks 
*** FLOP *** [8d Kd 4d]
broo2522: checks 
johan416: checks 
luisperse: checks 
*** TURN *** [8d Kd 4d] [Kh]
broo2522: checks 
johan416: bets $0.10
luisperse: calls $0.10
broo2522: folds 
*** RIVER *** [8d Kd 4d Kh] [6h]
johan416: bets $0.30
luisperse: folds 
Uncalled bet ($0.30) returned to johan416
johan416 collected $0.48 from pot
johan416: doesn't show hand 
*** SUMMARY ***
Total pot $0.50 | Rake $0.02 
Board [8d Kd 4d Kh 6h]
Seat 1: broo2522 (small blind) folded on the Turn
Seat 2: johan416 (big blind) collected ($0.48)
Seat 3: eddieamn folded before Flop (didn't bet)
Seat 4: luisperse folded on the River
Seat 5: Oleg032 folded before Flop (didn't bet)
Seat 6: FacuLarrocca (button) folded before Flop (didn't bet)



PokerStars Hand #222970816904:  Hold'em No Limit ($0.05/$0.10 USD) - 2021/01/23 15:59:58 ET
Table 'Transvaalia' 6-max Seat #1 is the button
Seat 1: broo2522 ($5 in chips) 
Seat 2: johan416 ($6.01 in chips) 
Seat 3: eddieamn ($11.11 in chips) 
Seat 4: luisperse ($15.54 in chips) 
Seat 5: Oleg032 ($10 in chips) 
Seat 6: FacuLarrocca ($10 in chips) 
johan416: posts small blind $0.05
eddieamn: posts big blind $0.10
*** HOLE CARDS ***
luisperse: folds 
Oleg032: raises $0.15 to $0.25
FacuLarrocca: raises $0.65 to $0.90
broo2522: calls $0.90
johan416: calls $0.85
eddieamn: folds 
Oleg032: folds 
*** FLOP *** [6c Ts Qh]
johan416: checks 
FacuLarrocca: bets $1.46
broo2522: calls $1.46
johan416: folds 
*** TURN *** [6c Ts Qh] [2d]
FacuLarrocca: bets $4.28
broo2522: calls $2.64 and is all-in
Uncalled bet ($1.64) returned to FacuLarrocca
*** RIVER *** [6c Ts Qh 2d] [2h]
*** SHOW DOWN ***
FacuLarrocca: shows [Kh Qd] (two pair, Queens and Deuces)
broo2522: shows [Ks Tc] (two pair, Tens and Deuces)
FacuLarrocca collected $10.74 from pot
*** SUMMARY ***
Total pot $11.25 | Rake $0.51 
Board [6c Ts Qh 2d 2h]
Seat 1: broo2522 (button) showed [Ks Tc] and lost with two pair, Tens and Deuces
Seat 2: johan416 (small blind) folded on the Flop
Seat 3: eddieamn (big blind) folded before Flop
Seat 4: luisperse folded before Flop (didn't bet)
Seat 5: Oleg032 folded before Flop
Seat 6: FacuLarrocca showed [Kh Qd] and won ($10.74) with two pair, Queens and Deuces



PokerStars Hand #222970848092:  Hold'em No Limit ($0.05/$0.10 USD) - 2021/01/23 16:00:48 ET
Table 'Transvaalia' 6-max Seat #2 is the button
Seat 2: johan416 ($5.11 in chips) 
Seat 3: eddieamn ($11.01 in chips) 
Seat 4: luisperse ($15.54 in chips) 
Seat 5: Oleg032 ($10 in chips) 
Seat 6: FacuLarrocca ($15.74 in chips) 
eddieamn: posts small blind $0.05
luisperse: posts big blind $0.10
*** HOLE CARDS ***
Oleg032: raises $0.15 to $0.25
FacuLarrocca: folds 
johan416: folds 
eddieamn: folds 
luisperse: folds 
Uncalled bet ($0.15) returned to Oleg032
Oleg032 collected $0.25 from pot
Oleg032: doesn't show hand 
*** SUMMARY ***
Total pot $0.25 | Rake $0 
Seat 2: johan416 (button) folded before Flop (didn't bet)
Seat 3: eddieamn (small blind) folded before Flop
Seat 4: luisperse (big blind) folded before Flop
Seat 5: Oleg032 collected ($0.25)
Seat 6: FacuLarrocca folded before Flop (didn't bet)



PokerStars Hand #222970854043:  Hold'em No Limit ($0.05/$0.10 USD) - 2021/01/23 16:00:57 ET
Table 'Transvaalia' 6-max Seat #3 is the button
Seat 2: johan416 ($5.11 in chips) 
Seat 3: eddieamn ($10.96 in chips) 
Seat 4: luisperse ($15.44 in chips) 
Seat 5: Oleg032 ($10.15 in chips) 
Seat 6: FacuLarrocca ($15.74 in chips) 
luisperse: posts small blind $0.05
Oleg032: posts big blind $0.10
*** HOLE CARDS ***
FacuLarrocca: folds 
johan416: folds 
eddieamn: raises $0.20 to $0.30
luisperse: folds 
Oleg032: calls $0.20
*** FLOP *** [As 7d Tc]
Oleg032: checks 
broo2522 is disconnected 
eddieamn: checks 
*** TURN *** [As 7d Tc] [9h]
Oleg032: checks 
eddieamn: bets $0.30
Oleg032: folds 
Uncalled bet ($0.30) returned to eddieamn
eddieamn collected $0.62 from pot
*** SUMMARY ***
Total pot $0.65 | Rake $0.03 
Board [As 7d Tc 9h]
Seat 2: johan416 folded before Flop (didn't bet)
Seat 3: eddieamn (button) collected ($0.62)
Seat 4: luisperse (small blind) folded before Flop
Seat 5: Oleg032 (big blind) folded on the Turn
Seat 6: FacuLarrocca folded before Flop (didn't bet)



PokerStars Hand #222970870874:  Hold'em No Limit ($0.05/$0.10 USD) - 2021/01/23 16:01:22 ET
Table 'Transvaalia' 6-max Seat #4 is the button
Seat 2: johan416 ($5.11 in chips) 
Seat 3: eddieamn ($11.28 in chips) 
Seat 4: luisperse ($15.39 in chips) 
Seat 5: Oleg032 ($10 in chips) 
Seat 6: FacuLarrocca ($15.74 in chips) 
Oleg032: posts small blind $0.05
FacuLarrocca: posts big blind $0.10
*** HOLE CARDS ***
johan416: folds 
eddieamn: folds 
luisperse: folds 
Oleg032: folds 
Uncalled bet ($0.05) returned to FacuLarrocca
FacuLarrocca collected $0.10 from pot
FacuLarrocca: doesn't show hand 
*** SUMMARY ***
Total pot $0.10 | Rake $0 
Seat 2: johan416 folded before Flop (didn't bet)
Seat 3: eddieamn folded before Flop (didn't bet)
Seat 4: luisperse (button) folded before Flop (didn't bet)
Seat 5: Oleg032 (small blind) folded before Flop
Seat 6: FacuLarrocca (big blind) collected ($0.10)



PokerStars Hand #222970880271:  Hold'em No Limit ($0.05/$0.10 USD) - 2021/01/23 16:01:35 ET
Table 'Transvaalia' 6-max Seat #5 is the button
Seat 2: johan416 ($5.11 in chips) 
Seat 3: eddieamn ($11.28 in chips) 
Seat 4: luisperse ($15.39 in chips) 
Seat 5: Oleg032 ($10 in chips) 
Seat 6: FacuLarrocca ($15.79 in chips) 
FacuLarrocca: posts small blind $0.05
johan416: posts big blind $0.10
*** HOLE CARDS ***
eddieamn: folds 
luisperse: folds 
Oleg032: folds 
FacuLarrocca: raises $0.20 to $0.30
johan416: calls $0.20
*** FLOP *** [5s 8d Js]
FacuLarrocca: checks 
johan416: bets $0.30
FacuLarrocca: calls $0.30
*** TURN *** [5s 8d Js] [4d]
FacuLarrocca: checks 
johan416: bets $1.70
FacuLarrocca: folds 
Uncalled bet ($1.70) returned to johan416
johan416 collected $1.15 from pot
johan416: doesn't show hand 
*** SUMMARY ***
Total pot $1.20 | Rake $0.05 
Board [5s 8d Js 4d]
Seat 2: johan416 (big blind) collected ($1.15)
Seat 3: eddieamn folded before Flop (didn't bet)
Seat 4: luisperse folded before Flop (didn't bet)
Seat 5: Oleg032 (button) folded before Flop (didn't bet)
Seat 6: FacuLarrocca (small blind) folded on the Turn



PokerStars Hand #222970919416:  Hold'em No Limit ($0.05/$0.10 USD) - 2021/01/23 16:02:26 ET
Table 'Transvaalia' 6-max Seat #6 is the button
Seat 2: johan416 ($5.66 in chips) 
Seat 3: eddieamn ($11.28 in chips) 
Seat 4: luisperse ($15.39 in chips) 
Seat 5: Oleg032 ($10 in chips) 
Seat 6: FacuLarrocca ($15.19 in chips) 
johan416: posts small blind $0.05
eddieamn: posts big blind $0.10
*** HOLE CARDS ***
luisperse: raises $0.10 to $0.20
Oleg032: raises $0.55 to $0.75
FacuLarrocca: folds 
johan416: calls $0.70
eddieamn: folds 
luisperse: calls $0.55
*** FLOP *** [8d 5s 9s]
johan416: bets $4.91 and is all-in
luisperse: folds 
Oleg032: calls $4.91
johan416 has timed out
*** TURN *** [8d 5s 9s] [4d]
*** RIVER *** [8d 5s 9s 4d] [Jd]
*** SHOW DOWN ***
johan416: shows [As Kc] (high card Ace)
Oleg032: shows [Qd Qc] (a pair of Queens)
Oleg032 cashed out the hand for $8.24 | Cash Out Fee $0.08
*** SUMMARY ***
Total pot $12.17 | Rake $0.55 
Board [8d 5s 9s 4d Jd]
Seat 2: johan416 (small blind) showed [As Kc] and lost with high card Ace
Seat 3: eddieamn (big blind) folded before Flop
Seat 4: luisperse folded on the Flop
Seat 5: Oleg032 showed [Qd Qc] and won ($11.62) with a pair of Queens (pot not awarded as player cashed out)
Seat 6: FacuLarrocca (button) folded before Flop (didn't bet)



PokerStars Hand #222970971102:  Hold'em No Limit ($0.05/$0.10 USD) - 2021/01/23 16:03:31 ET
Table 'Transvaalia' 6-max Seat #3 is the button
Seat 3: eddieamn ($11.18 in chips) 
Seat 4: luisperse ($14.64 in chips) 
Seat 5: Oleg032 ($12.58 in chips) 
Seat 6: FacuLarrocca ($15.19 in chips) 
luisperse: posts small blind $0.05
Oleg032: posts big blind $0.10
*** HOLE CARDS ***
FacuLarrocca: raises $0.20 to $0.30
eddieamn: folds 
luisperse: folds 
johan416 leaves the table
Oleg032: folds 
Uncalled bet ($0.20) returned to FacuLarrocca
FacuLarrocca collected $0.25 from pot
FacuLarrocca: doesn't show hand 
*** SUMMARY ***
Total pot $0.25 | Rake $0 
Seat 3: eddieamn (button) folded before Flop (didn't bet)
Seat 4: luisperse (small blind) folded before Flop
Seat 5: Oleg032 (big blind) folded before Flop
Seat 6: FacuLarrocca collected ($0.25)



PokerStars Hand #222970979766:  Hold'em No Limit ($0.05/$0.10 USD) - 2021/01/23 16:03:41 ET
Table 'Transvaalia' 6-max Seat #4 is the button
Seat 3: eddieamn ($11.18 in chips) 
Seat 4: luisperse ($14.59 in chips) 
Seat 5: Oleg032 ($12.48 in chips) 
Seat 6: FacuLarrocca ($15.34 in chips) 
Oleg032: posts small blind $0.05
FacuLarrocca: posts big blind $0.10
*** HOLE CARDS ***
eddieamn: folds 
luisperse: raises $0.10 to $0.20
Oleg032: calls $0.15
FacuLarrocca: calls $0.10
*** FLOP *** [Ks 2c 4s]
Oleg032: checks 
FacuLarrocca: checks 
luisperse: checks 
*** TURN *** [Ks 2c 4s] [5h]
Oleg032: checks 
FacuLarrocca: checks 
luisperse: bets $0.80
Oleg032: folds 
FacuLarrocca: folds 
Uncalled bet ($0.80) returned to luisperse
luisperse collected $0.57 from pot
luisperse: doesn't show hand 
*** SUMMARY ***
Total pot $0.60 | Rake $0.03 
Board [Ks 2c 4s 5h]
Seat 3: eddieamn folded before Flop (didn't bet)
Seat 4: luisperse (button) collected ($0.57)
Seat 5: Oleg032 (small blind) folded on the Turn
Seat 6: FacuLarrocca (big blind) folded on the Turn



PokerStars Hand #222971011199:  Hold'em No Limit ($0.05/$0.10 USD) - 2021/01/23 16:04:19 ET
Table 'Transvaalia' 6-max Seat #5 is the button
Seat 3: eddieamn ($11.18 in chips) 
Seat 4: luisperse ($14.96 in chips) 
Seat 5: Oleg032 ($12.28 in chips) 
Seat 6: FacuLarrocca ($15.14 in chips) 
FacuLarrocca: posts small blind $0.05
eddieamn: posts big blind $0.10
*** HOLE CARDS ***
luisperse: calls $0.10
Assetgasse joins the table at seat #2 
Oleg032: raises $0.15 to $0.25
FacuLarrocca: folds 
eddieamn: folds 
luisperse: calls $0.15
*** FLOP *** [6s 5d Ad]
luisperse: checks 
Oleg032: checks 
*** TURN *** [6s 5d Ad] [3h]
luisperse: bets $0.31
Assetgasse leaves the table
Oleg032: folds 
Uncalled bet ($0.31) returned to luisperse
luisperse collected $0.62 from pot
luisperse: doesn't show hand 
*** SUMMARY ***
Total pot $0.65 | Rake $0.03 
Board [6s 5d Ad 3h]
Seat 3: eddieamn (big blind) folded before Flop
Seat 4: luisperse collected ($0.62)
Seat 5: Oleg032 (button) folded on the Turn
Seat 6: FacuLarrocca (small blind) folded before Flop



PokerStars Hand #222971054053:  Hold'em No Limit ($0.05/$0.10 USD) - 2021/01/23 16:05:10 ET
Table 'Transvaalia' 6-max Seat #6 is the button
Seat 3: eddieamn ($11.08 in chips) 
Seat 4: luisperse ($15.33 in chips) 
Seat 5: Oleg032 ($12.03 in chips) 
Seat 6: FacuLarrocca ($15.09 in chips) 
eddieamn: posts small blind $0.05
luisperse: posts big blind $0.10
*** HOLE CARDS ***
Oleg032: raises $0.15 to $0.25
FacuLarrocca: folds 
eddieamn: folds 
sloup111 joins the table at seat #2 
luisperse: calls $0.15
*** FLOP *** [3s Js 2h]
luisperse: checks 
Oleg032: checks 
*** TURN *** [3s Js 2h] [3c]
luisperse: checks 
Oleg032: checks 
*** RIVER *** [3s Js 2h 3c] [5h]
luisperse: checks 
Oleg032: checks 
sloup111 leaves the table
*** SHOW DOWN ***
luisperse: shows [Kh Qc] (a pair of Threes)
Oleg032: shows [9d Ad] (a pair of Threes - Ace kicker)
Oleg032 collected $0.53 from pot
*** SUMMARY ***
Total pot $0.55 | Rake $0.02 
Board [3s Js 2h 3c 5h]
Seat 3: eddieamn (small blind) folded before Flop
Seat 4: luisperse (big blind) showed [Kh Qc] and lost with a pair of Threes
Seat 5: Oleg032 showed [9d Ad] and won ($0.53) with a pair of Threes
Seat 6: FacuLarrocca (button) folded before Flop (didn't bet)



PokerStars Hand #222971096888:  Hold'em No Limit ($0.05/$0.10 USD) - 2021/01/23 16:06:01 ET
Table 'Transvaalia' 6-max Seat #3 is the button
Seat 3: eddieamn ($11.03 in chips) 
Seat 4: luisperse ($15.08 in chips) 
Seat 5: Oleg032 ($12.31 in chips) 
Seat 6: FacuLarrocca ($15.09 in chips) 
luisperse: posts small blind $0.05
Oleg032: posts big blind $0.10
*** HOLE CARDS ***
FacuLarrocca: raises $0.20 to $0.30
eddieamn: folds 
luisperse: folds 
Oleg032: folds 
Uncalled bet ($0.20) returned to FacuLarrocca
FacuLarrocca collected $0.25 from pot
FacuLarrocca: doesn't show hand 
*** SUMMARY ***
Total pot $0.25 | Rake $0 
Seat 3: eddieamn (button) folded before Flop (didn't bet)
Seat 4: luisperse (small blind) folded before Flop
Seat 5: Oleg032 (big blind) folded before Flop
Seat 6: FacuLarrocca collected ($0.25)



PokerStars Hand #222971114327:  Hold'em No Limit ($0.05/$0.10 USD) - 2021/01/23 16:06:22 ET
Table 'Transvaalia' 6-max Seat #4 is the button
Seat 3: eddieamn ($11.03 in chips) 
Seat 4: luisperse ($15.03 in chips) 
Seat 5: Oleg032 ($12.21 in chips) 
Seat 6: FacuLarrocca ($15.24 in chips) 
Oleg032: posts small blind $0.05
FacuLarrocca: posts big blind $0.10
*** HOLE CARDS ***
eddieamn: raises $0.20 to $0.30
luisperse: folds 
Oleg032: folds 
FacuLarrocca: calls $0.20
*** FLOP *** [Ah 7h 9s]
FacuLarrocca: checks 
luisperse leaves the table
eddieamn: bets $0.20
FacuLarrocca: raises $0.77 to $0.97
eddieamn: folds 
Uncalled bet ($0.77) returned to FacuLarrocca
FacuLarrocca collected $1 from pot
FacuLarrocca: doesn't show hand 
*** SUMMARY ***
Total pot $1.05 | Rake $0.05 
Board [Ah 7h 9s]
Seat 3: eddieamn folded on the Flop
Seat 4: luisperse (button) folded before Flop (didn't bet)
Seat 5: Oleg032 (small blind) folded before Flop
Seat 6: FacuLarrocca (big blind) collected ($1)



PokerStars Hand #222971137200:  Hold'em No Limit ($0.05/$0.10 USD) - 2021/01/23 16:06:49 ET
Table 'Transvaalia' 6-max Seat #5 is the button
Seat 3: eddieamn ($10.53 in chips) 
Seat 5: Oleg032 ($12.16 in chips) 
Seat 6: FacuLarrocca ($15.74 in chips) 
FacuLarrocca: posts small blind $0.05
eddieamn: posts big blind $0.10
*** HOLE CARDS ***
JonnyDoubleYou joins the table at seat #2 
Vecherov joins the table at seat #4 
Oleg032: folds 
FacuLarrocca: raises $0.20 to $0.30
eddieamn: raises $0.90 to $1.20
FacuLarrocca: calls $0.90
*** FLOP *** [7c 9c 6c]
FacuLarrocca: checks 
eddieamn: bets $1.50
FacuLarrocca: folds 
Uncalled bet ($1.50) returned to eddieamn
eddieamn collected $2.29 from pot
*** SUMMARY ***
Total pot $2.40 | Rake $0.11 
Board [7c 9c 6c]
Seat 3: eddieamn (big blind) collected ($2.29)
Seat 5: Oleg032 (button) folded before Flop (didn't bet)
Seat 6: FacuLarrocca (small blind) folded on the Flop



PokerStars Hand #222971165178:  Hold'em No Limit ($0.05/$0.10 USD) - 2021/01/23 16:07:23 ET
Table 'Transvaalia' 6-max Seat #6 is the button
Seat 3: eddieamn ($11.62 in chips) 
Seat 4: Vecherov ($10 in chips) 
Seat 5: Oleg032 ($12.16 in chips) 
Seat 6: FacuLarrocca ($14.54 in chips) 
eddieamn: posts small blind $0.05
Vecherov: posts big blind $0.10
*** HOLE CARDS ***
Oleg032: raises $0.15 to $0.25
FacuLarrocca: folds 
eddieamn: folds 
Vecherov: folds 
Uncalled bet ($0.15) returned to Oleg032
Oleg032 collected $0.25 from pot
Oleg032: doesn't show hand 
*** SUMMARY ***
Total pot $0.25 | Rake $0 
Seat 3: eddieamn (small blind) folded before Flop
Seat 4: Vecherov (big blind) folded before Flop
Seat 5: Oleg032 collected ($0.25)
Seat 6: FacuLarrocca (button) folded before Flop (didn't bet)



PokerStars Hand #222971173657:  Hold'em No Limit ($0.05/$0.10 USD) - 2021/01/23 16:07:33 ET
Table 'Transvaalia' 6-max Seat #3 is the button
Seat 2: JonnyDoubleYou ($5.65 in chips) 
Seat 3: eddieamn ($11.57 in chips) 
Seat 4: Vecherov ($10 in chips) 
Seat 5: Oleg032 ($12.31 in chips) 
Seat 6: FacuLarrocca ($14.54 in chips) 
Vecherov: posts small blind $0.05
Oleg032: posts big blind $0.10
JonnyDoubleYou: posts big blind $0.10
*** HOLE CARDS ***
FacuLarrocca: folds 
JonnyDoubleYou: checks 
eddieamn: calls $0.10
Vecherov: raises $0.50 to $0.60
Oleg032: folds 
JonnyDoubleYou: folds 
eddieamn: folds 
Uncalled bet ($0.50) returned to Vecherov
Vecherov collected $0.40 from pot
Vecherov: doesn't show hand 
*** SUMMARY ***
Total pot $0.40 | Rake $0 
Seat 2: JonnyDoubleYou folded before Flop (didn't bet)
Seat 3: eddieamn (button) folded before Flop
Seat 4: Vecherov (small blind) collected ($0.40)
Seat 5: Oleg032 (big blind) folded before Flop
Seat 6: FacuLarrocca folded before Flop (didn't bet)



PokerStars Hand #222971190969:  Hold'em No Limit ($0.05/$0.10 USD) - 2021/01/23 16:07:54 ET
Table 'Transvaalia' 6-max Seat #4 is the button
Seat 2: JonnyDoubleYou ($5.55 in chips) 
Seat 3: eddieamn ($11.47 in chips) 
Seat 4: Vecherov ($10.30 in chips) 
Seat 5: Oleg032 ($12.21 in chips) 
Seat 6: FacuLarrocca ($14.54 in chips) 
Oleg032: posts small blind $0.05
FacuLarrocca: posts big blind $0.10
*** HOLE CARDS ***
JonnyDoubleYou: raises $0.40 to $0.50
eddieamn: folds 
Vecherov: folds 
Oleg032: folds 
FacuLarrocca: folds 
Uncalled bet ($0.40) returned to JonnyDoubleYou
JonnyDoubleYou collected $0.25 from pot
JonnyDoubleYou: doesn't show hand 
*** SUMMARY ***
Total pot $0.25 | Rake $0 
Seat 2: JonnyDoubleYou collected ($0.25)
Seat 3: eddieamn folded before Flop (didn't bet)
Seat 4: Vecherov (button) folded before Flop (didn't bet)
Seat 5: Oleg032 (small blind) folded before Flop
Seat 6: FacuLarrocca (big blind) folded before Flop



PokerStars Hand #222971215705:  Hold'em No Limit ($0.05/$0.10 USD) - 2021/01/23 16:08:24 ET
Table 'Transvaalia' 6-max Seat #5 is the button
Seat 2: JonnyDoubleYou ($5.70 in chips) 
Seat 3: eddieamn ($11.47 in chips) 
Seat 4: Vecherov ($10.30 in chips) 
Seat 5: Oleg032 ($12.16 in chips) 
Seat 6: FacuLarrocca ($14.44 in chips) 
FacuLarrocca: posts small blind $0.05
JonnyDoubleYou: posts big blind $0.10
*** HOLE CARDS ***
eddieamn: folds 
Vecherov: raises $0.20 to $0.30
Oleg032: calls $0.30
FacuLarrocca: folds 
JonnyDoubleYou: folds 
*** FLOP *** [3c 5c Kh]
Vecherov: checks 
Oleg032: checks 
*** TURN *** [3c 5c Kh] [6c]
Vecherov: bets $0.50
Oleg032: folds 
Uncalled bet ($0.50) returned to Vecherov
Vecherov collected $0.72 from pot
broo2522 was removed from the table for failing to post
broo2522 leaves the table
Vecherov: doesn't show hand 
*** SUMMARY ***
Total pot $0.75 | Rake $0.03 
Board [3c 5c Kh 6c]
Seat 2: JonnyDoubleYou (big blind) folded before Flop
Seat 3: eddieamn folded before Flop (didn't bet)
Seat 4: Vecherov collected ($0.72)
Seat 5: Oleg032 (button) folded on the Turn
Seat 6: FacuLarrocca (small blind) folded before Flop



PokerStars Hand #222971254396:  Hold'em No Limit ($0.05/$0.10 USD) - 2021/01/23 16:09:11 ET
Table 'Transvaalia' 6-max Seat #6 is the button
Seat 2: JonnyDoubleYou ($5.60 in chips) 
Seat 3: eddieamn ($11.47 in chips) 
Seat 4: Vecherov ($10.72 in chips) 
Seat 5: Oleg032 ($11.86 in chips) 
Seat 6: FacuLarrocca ($14.39 in chips) 
JonnyDoubleYou: posts small blind $0.05
eddieamn: posts big blind $0.10
*** HOLE CARDS ***
Vecherov: raises $0.20 to $0.30
Oleg032: folds 
FacuLarrocca: folds 
tomcairnes joins the table at seat #1 
JonnyDoubleYou: folds 
eddieamn: folds 
Uncalled bet ($0.20) returned to Vecherov
Vecherov collected $0.25 from pot
Vecherov: doesn't show hand 
*** SUMMARY ***
Total pot $0.25 | Rake $0 
Seat 2: JonnyDoubleYou (small blind) folded before Flop
Seat 3: eddieamn (big blind) folded before Flop
Seat 4: Vecherov collected ($0.25)
Seat 5: Oleg032 folded before Flop (didn't bet)
Seat 6: FacuLarrocca (button) folded before Flop (didn't bet)



PokerStars Hand #222971265229:  Hold'em No Limit ($0.05/$0.10 USD) - 2021/01/23 16:09:24 ET
Table 'Transvaalia' 6-max Seat #2 is the button
Seat 2: JonnyDoubleYou ($5.55 in chips) 
Seat 3: eddieamn ($11.37 in chips) 
Seat 5: Oleg032 ($11.86 in chips) 
Seat 6: FacuLarrocca ($14.39 in chips) 
eddieamn: posts small blind $0.05
Vecherov: is sitting out 
Oleg032: posts big blind $0.10
tomcairnes: sits out 
*** HOLE CARDS ***
Vecherov leaves the table
FacuLarrocca: folds 
JonnyDoubleYou: folds 
FacuLarrocca leaves the table
eddieamn: folds 
Uncalled bet ($0.05) returned to Oleg032
Oleg032 collected $0.10 from pot
Oleg032: doesn't show hand 
*** SUMMARY ***
Total pot $0.10 | Rake $0 
Seat 2: JonnyDoubleYou (button) folded before Flop (didn't bet)
Seat 3: eddieamn (small blind) folded before Flop
Seat 5: Oleg032 (big blind) collected ($0.10)
Seat 6: FacuLarrocca folded before Flop (didn't bet)



PokerStars Hand #222971273499:  Hold'em No Limit ($0.05/$0.10 USD) - 2021/01/23 16:09:34 ET
Table 'Transvaalia' 6-max Seat #3 is the button
Seat 1: tomcairnes ($8 in chips) 
Seat 2: JonnyDoubleYou ($5.55 in chips) 
Seat 3: eddieamn ($11.32 in chips) 
Seat 5: Oleg032 ($11.91 in chips) 
Oleg032: posts small blind $0.05
tomcairnes: posts big blind $0.10
*** HOLE CARDS ***
JonnyDoubleYou: calls $0.10
eddieamn: folds 
Oleg032: raises $0.20 to $0.30
tomcairnes: folds 
JonnyDoubleYou: calls $0.20
*** FLOP *** [5c 6d Ad]
Oleg032: bets $0.50
Chrstphr1 joins the table at seat #6 
JonnyDoubleYou: calls $0.50
*** TURN *** [5c 6d Ad] [Th]
samluis6 joins the table at seat #4 
Oleg032: bets $0.81
JonnyDoubleYou: folds 
Uncalled bet ($0.81) returned to Oleg032
Oleg032 collected $1.62 from pot
Oleg032: doesn't show hand 
*** SUMMARY ***
Total pot $1.70 | Rake $0.08 
Board [5c 6d Ad Th]
Seat 1: tomcairnes (big blind) folded before Flop
Seat 2: JonnyDoubleYou folded on the Turn
Seat 3: eddieamn (button) folded before Flop (didn't bet)
Seat 5: Oleg032 (small blind) collected ($1.62)



PokerStars Hand #222971303345:  Hold'em No Limit ($0.05/$0.10 USD) - 2021/01/23 16:10:10 ET
Table 'Transvaalia' 6-max Seat #5 is the button
Seat 1: tomcairnes ($7.90 in chips) 
Seat 2: JonnyDoubleYou ($4.75 in chips) 
Seat 3: eddieamn ($11.32 in chips) 
Seat 4: samluis6 ($4 in chips) 
Seat 5: Oleg032 ($12.73 in chips) 
tomcairnes: posts small blind $0.05
JonnyDoubleYou: posts big blind $0.10
samluis6: posts big blind $0.10
*** HOLE CARDS ***
eddieamn: folds 
samluis6: checks 
Oleg032: folds 
tomcairnes: raises $0.10 to $0.20
JonnyDoubleYou: folds 
samluis6: calls $0.10
*** FLOP *** [2s Jd 3d]
tomcairnes: checks 
samluis6: checks 
*** TURN *** [2s Jd 3d] [7d]
tomcairnes: bets $0.20
samluis6: folds 
Uncalled bet ($0.20) returned to tomcairnes
tomcairnes collected $0.48 from pot
tomcairnes: doesn't show hand 
*** SUMMARY ***
Total pot $0.50 | Rake $0.02 
Board [2s Jd 3d 7d]
Seat 1: tomcairnes (small blind) collected ($0.48)
Seat 2: JonnyDoubleYou (big blind) folded before Flop
Seat 3: eddieamn folded before Flop (didn't bet)
Seat 4: samluis6 folded on the Turn
Seat 5: Oleg032 (button) folded before Flop (didn't bet)



PokerStars Hand #222971339322:  Hold'em No Limit ($0.05/$0.10 USD) - 2021/01/23 16:10:52 ET
Table 'Transvaalia' 6-max Seat #1 is the button
Seat 1: tomcairnes ($8.18 in chips) 
Seat 2: JonnyDoubleYou ($4.65 in chips) 
Seat 3: eddieamn ($11.32 in chips) 
Seat 4: samluis6 ($3.80 in chips) 
Seat 5: Oleg032 ($12.73 in chips) 
JonnyDoubleYou: posts small blind $0.05
eddieamn: posts big blind $0.10
Chrstphr1: sits out 
*** HOLE CARDS ***
samluis6: folds 
Oleg032: raises $0.15 to $0.25
tomcairnes: folds 
JonnyDoubleYou: folds 
eddieamn: calls $0.15
*** FLOP *** [As Jc Qd]
eddieamn: checks 
Oleg032: checks 
*** TURN *** [As Jc Qd] [7s]
eddieamn: checks 
Oleg032: checks 
*** RIVER *** [As Jc Qd 7s] [3h]
eddieamn: bets $0.30
Oleg032: calls $0.30
*** SHOW DOWN ***
eddieamn: shows [Td Ac] (a pair of Aces)
Oleg032: mucks hand 
eddieamn collected $1.10 from pot
*** SUMMARY ***
Total pot $1.15 | Rake $0.05 
Board [As Jc Qd 7s 3h]
Seat 1: tomcairnes (button) folded before Flop (didn't bet)
Seat 2: JonnyDoubleYou (small blind) folded before Flop
Seat 3: eddieamn (big blind) showed [Td Ac] and won ($1.10) with a pair of Aces
Seat 4: samluis6 folded before Flop (didn't bet)
Seat 5: Oleg032 mucked



PokerStars Hand #222971382260:  Hold'em No Limit ($0.05/$0.10 USD) - 2021/01/23 16:11:44 ET
Table 'Transvaalia' 6-max Seat #2 is the button
Seat 1: tomcairnes ($8.18 in chips) 
Seat 2: JonnyDoubleYou ($4.60 in chips) 
Seat 3: eddieamn ($11.87 in chips) 
Seat 4: samluis6 ($3.80 in chips) 
Seat 5: Oleg032 ($12.18 in chips) 
eddieamn: posts small blind $0.05
samluis6: posts big blind $0.10
Chrstphr1: sits out 
*** HOLE CARDS ***
Oleg032: folds 
tomcairnes: calls $0.10
JonnyDoubleYou: folds 
eddieamn: folds 
samluis6: checks 
*** FLOP *** [9d Kd Ad]
samluis6: checks 
tomcairnes: bets $0.20
samluis6: folds 
Uncalled bet ($0.20) returned to tomcairnes
tomcairnes collected $0.24 from pot
tomcairnes: doesn't show hand 
*** SUMMARY ***
Total pot $0.25 | Rake $0.01 
Board [9d Kd Ad]
Seat 1: tomcairnes collected ($0.24)
Seat 2: JonnyDoubleYou (button) folded before Flop (didn't bet)
Seat 3: eddieamn (small blind) folded before Flop
Seat 4: samluis6 (big blind) folded on the Flop
Seat 5: Oleg032 folded before Flop (didn't bet)



PokerStars Hand #222971413697:  Hold'em No Limit ($0.05/$0.10 USD) - 2021/01/23 16:12:22 ET
Table 'Transvaalia' 6-max Seat #3 is the button
Seat 1: tomcairnes ($8.32 in chips) 
Seat 2: JonnyDoubleYou ($4.60 in chips) 
Seat 3: eddieamn ($11.82 in chips) 
Seat 4: samluis6 ($3.70 in chips) 
Seat 5: Oleg032 ($12.18 in chips) 
samluis6: posts small blind $0.05
Oleg032: posts big blind $0.10
Chrstphr1: sits out 
*** HOLE CARDS ***
tomcairnes: folds 
JonnyDoubleYou: folds 
eddieamn: folds 
samluis6: calls $0.05
Oleg032: raises $0.10 to $0.20
samluis6: folds 
Uncalled bet ($0.10) returned to Oleg032
Oleg032 collected $0.20 from pot
Oleg032: doesn't show hand 
*** SUMMARY ***
Total pot $0.20 | Rake $0 
Seat 1: tomcairnes folded before Flop (didn't bet)
Seat 2: JonnyDoubleYou folded before Flop (didn't bet)
Seat 3: eddieamn (button) folded before Flop (didn't bet)
Seat 4: samluis6 (small blind) folded before Flop
Seat 5: Oleg032 (big blind) collected ($0.20)



PokerStars Hand #222971429739:  Hold'em No Limit ($0.05/$0.10 USD) - 2021/01/23 16:12:42 ET
Table 'Transvaalia' 6-max Seat #4 is the button
Seat 1: tomcairnes ($8.32 in chips) 
Seat 2: JonnyDoubleYou ($4.60 in chips) 
Seat 3: eddieamn ($11.82 in chips) 
Seat 4: samluis6 ($3.60 in chips) 
Seat 5: Oleg032 ($12.28 in chips) 
Seat 6: Chrstphr1 ($8 in chips) 
Oleg032: posts small blind $0.05
Chrstphr1: posts big blind $0.10
*** HOLE CARDS ***
tomcairnes: folds 
JonnyDoubleYou: folds 
eddieamn: raises $0.20 to $0.30
samluis6: folds 
Oleg032: calls $0.25
Chrstphr1: calls $0.20
*** FLOP *** [2s 5d 6c]
Oleg032: checks 
Chrstphr1: checks 
eddieamn: bets $0.50
Oleg032: calls $0.50
Chrstphr1: folds 
*** TURN *** [2s 5d 6c] [3s]
Oleg032: checks 
eddieamn: checks 
*** RIVER *** [2s 5d 6c 3s] [7h]
Oleg032: bets $0.91
eddieamn: calls $0.91
*** SHOW DOWN ***
Oleg032: shows [Ac Tc] (high card Ace)
eddieamn: shows [Ts Th] (a pair of Tens)
eddieamn collected $3.55 from pot
*** SUMMARY ***
Total pot $3.72 | Rake $0.17 
Board [2s 5d 6c 3s 7h]
Seat 1: tomcairnes folded before Flop (didn't bet)
Seat 2: JonnyDoubleYou folded before Flop (didn't bet)
Seat 3: eddieamn showed [Ts Th] and won ($3.55) with a pair of Tens
Seat 4: samluis6 (button) folded before Flop (didn't bet)
Seat 5: Oleg032 (small blind) showed [Ac Tc] and lost with high card Ace
Seat 6: Chrstphr1 (big blind) folded on the Flop



PokerStars Hand #222971475654:  Hold'em No Limit ($0.05/$0.10 USD) - 2021/01/23 16:13:28 ET
Table 'Transvaalia' 6-max Seat #5 is the button
Seat 1: tomcairnes ($8.32 in chips) 
Seat 2: JonnyDoubleYou ($4.60 in chips) 
Seat 3: eddieamn ($13.66 in chips) 
Seat 4: samluis6 ($3.60 in chips) 
Seat 5: Oleg032 ($10.57 in chips) 
Seat 6: Chrstphr1 ($7.70 in chips) 
Chrstphr1: posts small blind $0.05
tomcairnes: posts big blind $0.10
*** HOLE CARDS ***
JonnyDoubleYou: raises $0.20 to $0.30
eddieamn: folds 
samluis6: folds 
Oleg032: folds 
Chrstphr1: calls $0.25
tomcairnes: folds 
*** FLOP *** [7d 4c 9c]
Chrstphr1: checks 
JonnyDoubleYou: bets $0.50
Chrstphr1: calls $0.50
*** TURN *** [7d 4c 9c] [Qc]
Chrstphr1: checks 
JonnyDoubleYou: bets $0.80
Chrstphr1: calls $0.80
*** RIVER *** [7d 4c 9c Qc] [3s]
Chrstphr1: bets $1.57
JonnyDoubleYou: folds 
Uncalled bet ($1.57) returned to Chrstphr1
Chrstphr1 collected $3.15 from pot
Chrstphr1: doesn't show hand 
*** SUMMARY ***
Total pot $3.30 | Rake $0.15 
Board [7d 4c 9c Qc 3s]
Seat 1: tomcairnes (big blind) folded before Flop
Seat 2: JonnyDoubleYou folded on the River
Seat 3: eddieamn folded before Flop (didn't bet)
Seat 4: samluis6 folded before Flop (didn't bet)
Seat 5: Oleg032 (button) folded before Flop (didn't bet)
Seat 6: Chrstphr1 (small blind) collected ($3.15)



PokerStars Hand #222971529962:  Hold'em No Limit ($0.05/$0.10 USD) - 2021/01/23 16:14:34 ET
Table 'Transvaalia' 6-max Seat #6 is the button
Seat 1: tomcairnes ($8.22 in chips) 
Seat 2: JonnyDoubleYou ($3 in chips) 
Seat 3: eddieamn ($13.66 in chips) 
Seat 4: samluis6 ($3.60 in chips) 
Seat 5: Oleg032 ($10.57 in chips) 
Seat 6: Chrstphr1 ($9.25 in chips) 
tomcairnes: posts small blind $0.05
JonnyDoubleYou: posts big blind $0.10
*** HOLE CARDS ***
eddieamn: folds 
samluis6: calls $0.10
Oleg032: folds 
Chrstphr1: calls $0.10
tomcairnes: folds 
JonnyDoubleYou: checks 
*** FLOP *** [Jc 8d Jh]
JonnyDoubleYou: checks 
samluis6: checks 
Chrstphr1: bets $0.30
JonnyDoubleYou: folds 
samluis6: calls $0.30
*** TURN *** [Jc 8d Jh] [Qd]
samluis6: checks 
Chrstphr1: checks 
*** RIVER *** [Jc 8d Jh Qd] [2h]
samluis6: bets $0.40
Chrstphr1: calls $0.40
*** SHOW DOWN ***
samluis6: shows [6s Js] (three of a kind, Jacks)
Chrstphr1: mucks hand 
samluis6 collected $1.67 from pot
*** SUMMARY ***
Total pot $1.75 | Rake $0.08 
Board [Jc 8d Jh Qd 2h]
Seat 1: tomcairnes (small blind) folded before Flop
Seat 2: JonnyDoubleYou (big blind) folded on the Flop
Seat 3: eddieamn folded before Flop (didn't bet)
Seat 4: samluis6 showed [6s Js] and won ($1.67) with three of a kind, Jacks
Seat 5: Oleg032 folded before Flop (didn't bet)
Seat 6: Chrstphr1 (button) mucked



PokerStars Hand #222971573670:  Hold'em No Limit ($0.05/$0.10 USD) - 2021/01/23 16:15:25 ET
Table 'Transvaalia' 6-max Seat #1 is the button
Seat 1: tomcairnes ($8.17 in chips) 
Seat 2: JonnyDoubleYou ($2.90 in chips) 
Seat 3: eddieamn ($13.66 in chips) 
Seat 4: samluis6 ($4.47 in chips) 
Seat 5: Oleg032 ($10.57 in chips) 
Seat 6: Chrstphr1 ($8.45 in chips) 
JonnyDoubleYou: posts small blind $0.05
eddieamn: posts big blind $0.10
*** HOLE CARDS ***
samluis6: calls $0.10
Oleg032: folds 
Chrstphr1: folds 
tomcairnes: raises $0.10 to $0.20
JonnyDoubleYou: folds 
eddieamn: raises $0.90 to $1.10
samluis6: folds 
tomcairnes: calls $0.90
*** FLOP *** [6h 4c 9s]
eddieamn: checks 
tomcairnes: checks 
*** TURN *** [6h 4c 9s] [Kd]
eddieamn: bets $1.30
tomcairnes: folds 
Uncalled bet ($1.30) returned to eddieamn
eddieamn collected $2.24 from pot
*** SUMMARY ***
Total pot $2.35 | Rake $0.11 
Board [6h 4c 9s Kd]
Seat 1: tomcairnes (button) folded on the Turn
Seat 2: JonnyDoubleYou (small blind) folded before Flop
Seat 3: eddieamn (big blind) collected ($2.24)
Seat 4: samluis6 folded before Flop
Seat 5: Oleg032 folded before Flop (didn't bet)
Seat 6: Chrstphr1 folded before Flop (didn't bet)



PokerStars Hand #222971630792:  Hold'em No Limit ($0.05/$0.10 USD) - 2021/01/23 16:16:32 ET
Table 'Transvaalia' 6-max Seat #2 is the button
Seat 1: tomcairnes ($7.07 in chips) 
Seat 2: JonnyDoubleYou ($2.85 in chips) 
Seat 3: eddieamn ($14.80 in chips) 
Seat 4: samluis6 ($4.37 in chips) 
Seat 5: Oleg032 ($10.57 in chips) 
Seat 6: Chrstphr1 ($8.45 in chips) 
eddieamn: posts small blind $0.05
samluis6: posts big blind $0.10
*** HOLE CARDS ***
Oleg032: folds 
Chrstphr1: folds 
tomcairnes: folds 
JonnyDoubleYou: raises $0.90 to $1
eddieamn: folds 
samluis6: folds 
Uncalled bet ($0.90) returned to JonnyDoubleYou
JonnyDoubleYou collected $0.25 from pot
JonnyDoubleYou: doesn't show hand 
*** SUMMARY ***
Total pot $0.25 | Rake $0 
Seat 1: tomcairnes folded before Flop (didn't bet)
Seat 2: JonnyDoubleYou (button) collected ($0.25)
Seat 3: eddieamn (small blind) folded before Flop
Seat 4: samluis6 (big blind) folded before Flop
Seat 5: Oleg032 folded before Flop (didn't bet)
Seat 6: Chrstphr1 folded before Flop (didn't bet)



PokerStars Hand #222971648426:  Hold'em No Limit ($0.05/$0.10 USD) - 2021/01/23 16:16:52 ET
Table 'Transvaalia' 6-max Seat #3 is the button
Seat 1: tomcairnes ($7.07 in chips) 
Seat 2: JonnyDoubleYou ($3 in chips) 
Seat 3: eddieamn ($14.75 in chips) 
Seat 4: samluis6 ($4.27 in chips) 
Seat 5: Oleg032 ($10.57 in chips) 
Seat 6: Chrstphr1 ($8.45 in chips) 
samluis6: posts small blind $0.05
Oleg032: posts big blind $0.10
*** HOLE CARDS ***
Chrstphr1: raises $0.20 to $0.30
tomcairnes: folds 
JonnyDoubleYou: folds 
eddieamn: folds 
samluis6: calls $0.25
Oleg032: folds 
*** FLOP *** [4s 9h Qc]
samluis6: checks 
Chrstphr1: bets $0.30
samluis6: folds 
Uncalled bet ($0.30) returned to Chrstphr1
Chrstphr1 collected $0.67 from pot
Chrstphr1: doesn't show hand 
*** SUMMARY ***
Total pot $0.70 | Rake $0.03 
Board [4s 9h Qc]
Seat 1: tomcairnes folded before Flop (didn't bet)
Seat 2: JonnyDoubleYou folded before Flop (didn't bet)
Seat 3: eddieamn (button) folded before Flop (didn't bet)
Seat 4: samluis6 (small blind) folded on the Flop
Seat 5: Oleg032 (big blind) folded before Flop
Seat 6: Chrstphr1 collected ($0.67)



PokerStars Hand #222971674580:  Hold'em No Limit ($0.05/$0.10 USD) - 2021/01/23 16:17:23 ET
Table 'Transvaalia' 6-max Seat #4 is the button
Seat 1: tomcairnes ($7.07 in chips) 
Seat 2: JonnyDoubleYou ($3 in chips) 
Seat 3: eddieamn ($14.75 in chips) 
Seat 4: samluis6 ($3.97 in chips) 
Seat 5: Oleg032 ($10.47 in chips) 
Seat 6: Chrstphr1 ($8.82 in chips) 
Oleg032: posts small blind $0.05
Chrstphr1: posts big blind $0.10
*** HOLE CARDS ***
tomcairnes: folds 
JonnyDoubleYou: calls $0.10
eddieamn: raises $0.40 to $0.50
samluis6: folds 
Oleg032: folds 
Chrstphr1: folds 
JonnyDoubleYou: calls $0.40
*** FLOP *** [Qs Js 6s]
JonnyDoubleYou: checks 
eddieamn: checks 
*** TURN *** [Qs Js 6s] [9s]
JonnyDoubleYou: bets $1
eddieamn: folds 
Uncalled bet ($1) returned to JonnyDoubleYou
JonnyDoubleYou collected $1.10 from pot
JonnyDoubleYou: doesn't show hand 
*** SUMMARY ***
Total pot $1.15 | Rake $0.05 
Board [Qs Js 6s 9s]
Seat 1: tomcairnes folded before Flop (didn't bet)
Seat 2: JonnyDoubleYou collected ($1.10)
Seat 3: eddieamn folded on the Turn
Seat 4: samluis6 (button) folded before Flop (didn't bet)
Seat 5: Oleg032 (small blind) folded before Flop
Seat 6: Chrstphr1 (big blind) folded before Flop



PokerStars Hand #222971704486:  Hold'em No Limit ($0.05/$0.10 USD) - 2021/01/23 16:17:57 ET
Table 'Transvaalia' 6-max Seat #5 is the button
Seat 1: tomcairnes ($7.07 in chips) 
Seat 2: JonnyDoubleYou ($3.60 in chips) 
Seat 3: eddieamn ($14.25 in chips) 
Seat 4: samluis6 ($3.97 in chips) 
Seat 5: Oleg032 ($10.42 in chips) 
Seat 6: Chrstphr1 ($8.72 in chips) 
Chrstphr1: posts small blind $0.05
tomcairnes: posts big blind $0.10
*** HOLE CARDS ***
JonnyDoubleYou: folds 
eddieamn: folds 
samluis6: calls $0.10
Oleg032: raises $0.15 to $0.25
Chrstphr1: calls $0.20
tomcairnes: folds 
samluis6: calls $0.15
*** FLOP *** [6c 8h Jd]
Chrstphr1: checks 
samluis6: checks 
Oleg032: bets $0.54
Chrstphr1: folds 
samluis6: folds 
Uncalled bet ($0.54) returned to Oleg032
Oleg032 collected $0.81 from pot
Oleg032: doesn't show hand 
*** SUMMARY ***
Total pot $0.85 | Rake $0.04 
Board [6c 8h Jd]
Seat 1: tomcairnes (big blind) folded before Flop
Seat 2: JonnyDoubleYou folded before Flop (didn't bet)
Seat 3: eddieamn folded before Flop (didn't bet)
Seat 4: samluis6 folded on the Flop
Seat 5: Oleg032 (button) collected ($0.81)
Seat 6: Chrstphr1 (small blind) folded on the Flop



PokerStars Hand #222971730559:  Hold'em No Limit ($0.05/$0.10 USD) - 2021/01/23 16:18:27 ET
Table 'Transvaalia' 6-max Seat #6 is the button
Seat 1: tomcairnes ($6.97 in chips) 
Seat 2: JonnyDoubleYou ($3.60 in chips) 
Seat 3: eddieamn ($14.25 in chips) 
Seat 4: samluis6 ($3.72 in chips) 
Seat 5: Oleg032 ($10.98 in chips) 
Seat 6: Chrstphr1 ($8.47 in chips) 
tomcairnes: posts small blind $0.05
JonnyDoubleYou: posts big blind $0.10
*** HOLE CARDS ***
eddieamn: folds 
samluis6: calls $0.10
Oleg032: raises $0.15 to $0.25
Chrstphr1: folds 
tomcairnes: raises $0.15 to $0.40
JonnyDoubleYou: folds 
samluis6: folds 
Oleg032: calls $0.15
*** FLOP *** [Ah Ac 5d]
tomcairnes: bets $0.48
Oleg032: folds 
Uncalled bet ($0.48) returned to tomcairnes
tomcairnes collected $0.96 from pot
tomcairnes: doesn't show hand 
*** SUMMARY ***
Total pot $1 | Rake $0.04 
Board [Ah Ac 5d]
Seat 1: tomcairnes (small blind) collected ($0.96)
Seat 2: JonnyDoubleYou (big blind) folded before Flop
Seat 3: eddieamn folded before Flop (didn't bet)
Seat 4: samluis6 folded before Flop
Seat 5: Oleg032 folded on the Flop
Seat 6: Chrstphr1 (button) folded before Flop (didn't bet)



PokerStars Hand #222971751431:  Hold'em No Limit ($0.05/$0.10 USD) - 2021/01/23 16:18:52 ET
Table 'Transvaalia' 6-max Seat #1 is the button
Seat 1: tomcairnes ($7.53 in chips) 
Seat 2: JonnyDoubleYou ($3.50 in chips) 
Seat 3: eddieamn ($14.25 in chips) 
Seat 4: samluis6 ($3.62 in chips) 
Seat 5: Oleg032 ($10.58 in chips) 
Seat 6: Chrstphr1 ($8.47 in chips) 
JonnyDoubleYou: posts small blind $0.05
eddieamn: posts big blind $0.10
*** HOLE CARDS ***
samluis6: folds 
Oleg032: raises $0.15 to $0.25
Chrstphr1: folds 
tomcairnes: folds 
JonnyDoubleYou: calls $0.20
eddieamn: folds 
*** FLOP *** [Jd 7d 9d]
JonnyDoubleYou: checks 
Oleg032: checks 
*** TURN *** [Jd 7d 9d] [Ks]
JonnyDoubleYou: checks 
Oleg032: bets $0.38
JonnyDoubleYou: calls $0.38
*** RIVER *** [Jd 7d 9d Ks] [Qs]
JonnyDoubleYou: checks 
Oleg032: checks 
*** SHOW DOWN ***
JonnyDoubleYou: shows [As Th] (a straight, Ten to Ace)
Oleg032: mucks hand 
JonnyDoubleYou collected $1.30 from pot
*** SUMMARY ***
Total pot $1.36 | Rake $0.06 
Board [Jd 7d 9d Ks Qs]
Seat 1: tomcairnes (button) folded before Flop (didn't bet)
Seat 2: JonnyDoubleYou (small blind) showed [As Th] and won ($1.30) with a straight, Ten to Ace
Seat 3: eddieamn (big blind) folded before Flop
Seat 4: samluis6 folded before Flop (didn't bet)
Seat 5: Oleg032 mucked
Seat 6: Chrstphr1 folded before Flop (didn't bet)



PokerStars Hand #222971789129:  Hold'em No Limit ($0.05/$0.10 USD) - 2021/01/23 16:19:35 ET
Table 'Transvaalia' 6-max Seat #2 is the button
Seat 1: tomcairnes ($7.53 in chips) 
Seat 2: JonnyDoubleYou ($4.17 in chips) 
Seat 3: eddieamn ($14.15 in chips) 
Seat 4: samluis6 ($3.62 in chips) 
Seat 5: Oleg032 ($10 in chips) 
Seat 6: Chrstphr1 ($8.47 in chips) 
eddieamn: posts small blind $0.05
samluis6: posts big blind $0.10
*** HOLE CARDS ***
Oleg032: raises $0.15 to $0.25
Chrstphr1: folds 
tomcairnes: folds 
JonnyDoubleYou: folds 
eddieamn: calls $0.20
samluis6: calls $0.15
*** FLOP *** [8d 3d 5d]
eddieamn: checks 
samluis6: bets $0.20
Oleg032: calls $0.20
eddieamn: folds 
*** TURN *** [8d 3d 5d] [Qh]
samluis6: bets $0.30
Oleg032: folds 
Uncalled bet ($0.30) returned to samluis6
samluis6 collected $1.10 from pot
samluis6: doesn't show hand 
*** SUMMARY ***
Total pot $1.15 | Rake $0.05 
Board [8d 3d 5d Qh]
Seat 1: tomcairnes folded before Flop (didn't bet)
Seat 2: JonnyDoubleYou (button) folded before Flop (didn't bet)
Seat 3: eddieamn (small blind) folded on the Flop
Seat 4: samluis6 (big blind) collected ($1.10)
Seat 5: Oleg032 folded on the Turn
Seat 6: Chrstphr1 folded before Flop (didn't bet)



PokerStars Hand #222971834657:  Hold'em No Limit ($0.05/$0.10 USD) - 2021/01/23 16:20:28 ET
Table 'Transvaalia' 6-max Seat #3 is the button
Seat 1: tomcairnes ($7.53 in chips) 
Seat 2: JonnyDoubleYou ($4.17 in chips) 
Seat 3: eddieamn ($13.90 in chips) 
Seat 4: samluis6 ($4.27 in chips) 
Seat 5: Oleg032 ($10 in chips) 
Seat 6: Chrstphr1 ($8.47 in chips) 
samluis6: posts small blind $0.05
Oleg032: posts big blind $0.10
*** HOLE CARDS ***
Chrstphr1: folds 
tomcairnes: folds 
JonnyDoubleYou: calls $0.10
eddieamn: raises $0.40 to $0.50
samluis6: calls $0.45
Oleg032: folds 
JonnyDoubleYou: calls $0.40
*** FLOP *** [3c 8c Qd]
samluis6: bets $0.20
JonnyDoubleYou: folds 
eddieamn: raises $0.80 to $1
samluis6: calls $0.80
*** TURN *** [3c 8c Qd] [2h]
samluis6: checks 
eddieamn: bets $12.40 and is all-in
samluis6: calls $2.77 and is all-in
Uncalled bet ($9.63) returned to eddieamn
*** RIVER *** [3c 8c Qd 2h] [2c]
*** SHOW DOWN ***
samluis6: shows [Ac Tc] (a flush, Ace high)
eddieamn: shows [9c 7c] (a flush, Nine high)
samluis6 collected $8.73 from pot
*** SUMMARY ***
Total pot $9.14 | Rake $0.41 
Board [3c 8c Qd 2h 2c]
Seat 1: tomcairnes folded before Flop (didn't bet)
Seat 2: JonnyDoubleYou folded on the Flop
Seat 3: eddieamn (button) showed [9c 7c] and lost with a flush, Nine high
Seat 4: samluis6 (small blind) showed [Ac Tc] and won ($8.73) with a flush, Ace high
Seat 5: Oleg032 (big blind) folded before Flop
Seat 6: Chrstphr1 folded before Flop (didn't bet)



PokerStars Hand #222971919765:  Hold'em No Limit ($0.05/$0.10 USD) - 2021/01/23 16:22:07 ET
Table 'Transvaalia' 6-max Seat #4 is the button
Seat 1: tomcairnes ($7.53 in chips) 
Seat 2: JonnyDoubleYou ($3.67 in chips) 
Seat 3: eddieamn ($10 in chips) 
Seat 4: samluis6 ($8.73 in chips) 
Seat 5: Oleg032 ($10 in chips) 
Seat 6: Chrstphr1 ($8.47 in chips) 
Oleg032: posts small blind $0.05
Chrstphr1: posts big blind $0.10
*** HOLE CARDS ***
tomcairnes: folds 
JonnyDoubleYou: folds 
eddieamn: folds 
samluis6: calls $0.10
Oleg032: folds 
Chrstphr1: checks 
*** FLOP *** [Qh Ts Jc]
Chrstphr1: checks 
samluis6: bets $0.20
Chrstphr1: folds 
Uncalled bet ($0.20) returned to samluis6
samluis6 collected $0.24 from pot
samluis6: doesn't show hand 
*** SUMMARY ***
Total pot $0.25 | Rake $0.01 
Board [Qh Ts Jc]
Seat 1: tomcairnes folded before Flop (didn't bet)
Seat 2: JonnyDoubleYou folded before Flop (didn't bet)
Seat 3: eddieamn folded before Flop (didn't bet)
Seat 4: samluis6 (button) collected ($0.24)
Seat 5: Oleg032 (small blind) folded before Flop
Seat 6: Chrstphr1 (big blind) folded on the Flop



PokerStars Hand #222971944087:  Hold'em No Limit ($0.05/$0.10 USD) - 2021/01/23 16:22:36 ET
Table 'Transvaalia' 6-max Seat #5 is the button
Seat 1: tomcairnes ($7.53 in chips) 
Seat 2: JonnyDoubleYou ($3.67 in chips) 
Seat 3: eddieamn ($10 in chips) 
Seat 4: samluis6 ($8.87 in chips) 
Seat 5: Oleg032 ($10 in chips) 
Seat 6: Chrstphr1 ($8.37 in chips) 
Chrstphr1: posts small blind $0.05
tomcairnes: posts big blind $0.10
*** HOLE CARDS ***
JonnyDoubleYou: folds 
eddieamn: folds 
samluis6: calls $0.10
Oleg032: folds 
Chrstphr1: raises $0.20 to $0.30
tomcairnes: folds 
samluis6: calls $0.20
*** FLOP *** [Jc 5s 8h]
Chrstphr1: bets $0.40
samluis6: folds 
Uncalled bet ($0.40) returned to Chrstphr1
Chrstphr1 collected $0.67 from pot
Chrstphr1: doesn't show hand 
*** SUMMARY ***
Total pot $0.70 | Rake $0.03 
Board [Jc 5s 8h]
Seat 1: tomcairnes (big blind) folded before Flop
Seat 2: JonnyDoubleYou folded before Flop (didn't bet)
Seat 3: eddieamn folded before Flop (didn't bet)
Seat 4: samluis6 folded on the Flop
Seat 5: Oleg032 (button) folded before Flop (didn't bet)
Seat 6: Chrstphr1 (small blind) collected ($0.67)



PokerStars Hand #222971971139:  Hold'em No Limit ($0.05/$0.10 USD) - 2021/01/23 16:23:07 ET
Table 'Transvaalia' 6-max Seat #6 is the button
Seat 1: tomcairnes ($7.43 in chips) 
Seat 2: JonnyDoubleYou ($3.67 in chips) 
Seat 3: eddieamn ($10 in chips) 
Seat 4: samluis6 ($8.57 in chips) 
Seat 5: Oleg032 ($10 in chips) 
Seat 6: Chrstphr1 ($8.74 in chips) 
tomcairnes: posts small blind $0.05
JonnyDoubleYou: posts big blind $0.10
*** HOLE CARDS ***
eddieamn: raises $0.20 to $0.30
samluis6: folds 
Oleg032: folds 
Chrstphr1: folds 
tomcairnes: calls $0.25
JonnyDoubleYou: calls $0.20
*** FLOP *** [5c Kh 5d]
tomcairnes: bets $0.43
JonnyDoubleYou: folds 
eddieamn: folds 
Uncalled bet ($0.43) returned to tomcairnes
tomcairnes collected $0.86 from pot
tomcairnes: doesn't show hand 
*** SUMMARY ***
Total pot $0.90 | Rake $0.04 
Board [5c Kh 5d]
Seat 1: tomcairnes (small blind) collected ($0.86)
Seat 2: JonnyDoubleYou (big blind) folded on the Flop
Seat 3: eddieamn folded on the Flop
Seat 4: samluis6 folded before Flop (didn't bet)
Seat 5: Oleg032 folded before Flop (didn't bet)
Seat 6: Chrstphr1 (button) folded before Flop (didn't bet)



PokerStars Hand #222972008331:  Hold'em No Limit ($0.05/$0.10 USD) - 2021/01/23 16:23:42 ET
Table 'Transvaalia' 6-max Seat #1 is the button
Seat 1: tomcairnes ($7.99 in chips) 
Seat 2: JonnyDoubleYou ($3.37 in chips) 
Seat 3: eddieamn ($10 in chips) 
Seat 4: samluis6 ($8.57 in chips) 
Seat 5: Oleg032 ($10 in chips) 
Seat 6: Chrstphr1 ($8.74 in chips) 
JonnyDoubleYou: posts small blind $0.05
eddieamn: posts big blind $0.10
*** HOLE CARDS ***
samluis6: calls $0.10
Oleg032: raises $0.15 to $0.25
Chrstphr1: calls $0.25
tomcairnes: folds 
JonnyDoubleYou: folds 
eddieamn: calls $0.15
samluis6: calls $0.15
*** FLOP *** [7c 3d Jc]
eddieamn: checks 
samluis6: checks 
Oleg032: checks 
Chrstphr1: checks 
*** TURN *** [7c 3d Jc] [Qc]
eddieamn: checks 
samluis6: bets $0.20
Oleg032: folds 
Chrstphr1: calls $0.20
eddieamn: folds 
*** RIVER *** [7c 3d Jc Qc] [Td]
samluis6: bets $0.20
Chrstphr1: raises $0.30 to $0.50
samluis6: calls $0.30
*** SHOW DOWN ***
Chrstphr1: shows [As Qh] (a pair of Queens)
samluis6: mucks hand 
Chrstphr1 collected $2.34 from pot
*** SUMMARY ***
Total pot $2.45 | Rake $0.11 
Board [7c 3d Jc Qc Td]
Seat 1: tomcairnes (button) folded before Flop (didn't bet)
Seat 2: JonnyDoubleYou (small blind) folded before Flop
Seat 3: eddieamn (big blind) folded on the Turn
Seat 4: samluis6 mucked
Seat 5: Oleg032 folded on the Turn
Seat 6: Chrstphr1 showed [As Qh] and won ($2.34) with a pair of Queens



PokerStars Hand #222972066239:  Hold'em No Limit ($0.05/$0.10 USD) - 2021/01/23 16:24:51 ET
Table 'Transvaalia' 6-max Seat #2 is the button
Seat 1: tomcairnes ($7.99 in chips) 
Seat 2: JonnyDoubleYou ($3.32 in chips) 
Seat 3: eddieamn ($10 in chips) 
Seat 4: samluis6 ($7.62 in chips) 
Seat 5: Oleg032 ($10 in chips) 
Seat 6: Chrstphr1 ($10.13 in chips) 
eddieamn: posts small blind $0.05
samluis6: posts big blind $0.10
*** HOLE CARDS ***
Oleg032: raises $0.15 to $0.25
Chrstphr1: calls $0.25
tomcairnes: folds 
JonnyDoubleYou: folds 
eddieamn: folds 
samluis6: folds 
*** FLOP *** [Ac 5c 7h]
Oleg032: bets $0.20
Chrstphr1: folds 
Uncalled bet ($0.20) returned to Oleg032
Oleg032 collected $0.62 from pot
Oleg032: doesn't show hand 
*** SUMMARY ***
Total pot $0.65 | Rake $0.03 
Board [Ac 5c 7h]
Seat 1: tomcairnes folded before Flop (didn't bet)
Seat 2: JonnyDoubleYou (button) folded before Flop (didn't bet)
Seat 3: eddieamn (small blind) folded before Flop
Seat 4: samluis6 (big blind) folded before Flop
Seat 5: Oleg032 collected ($0.62)
Seat 6: Chrstphr1 folded on the Flop



PokerStars Hand #222972084257:  Hold'em No Limit ($0.05/$0.10 USD) - 2021/01/23 16:25:12 ET
Table 'Transvaalia' 6-max Seat #3 is the button
Seat 1: tomcairnes ($7.99 in chips) 
Seat 2: JonnyDoubleYou ($3.32 in chips) 
Seat 3: eddieamn ($10 in chips) 
Seat 5: Oleg032 ($10.37 in chips) 
Seat 6: Chrstphr1 ($9.88 in chips) 
samluis6: is sitting out 
samluis6 leaves the table
Oleg032: posts small blind $0.05
Chrstphr1: posts big blind $0.10
*** HOLE CARDS ***
tomcairnes: folds 
JonnyDoubleYou: calls $0.10
eddieamn: folds 
and 07335 joins the table at seat #4 
Oleg032: calls $0.05
Chrstphr1: checks 
*** FLOP *** [Th 4h Ts]
Oleg032: checks 
Chrstphr1: checks 
JonnyDoubleYou: checks 
*** TURN *** [Th 4h Ts] [8c]
Oleg032: bets $0.15
Chrstphr1: folds 
JonnyDoubleYou: folds 
Uncalled bet ($0.15) returned to Oleg032
Oleg032 collected $0.29 from pot
Oleg032: doesn't show hand 
*** SUMMARY ***
Total pot $0.30 | Rake $0.01 
Board [Th 4h Ts 8c]
Seat 1: tomcairnes folded before Flop (didn't bet)
Seat 2: JonnyDoubleYou folded on the Turn
Seat 3: eddieamn (button) folded before Flop (didn't bet)
Seat 5: Oleg032 (small blind) collected ($0.29)
Seat 6: Chrstphr1 (big blind) folded on the Turn



PokerStars Hand #222972113914:  Hold'em No Limit ($0.05/$0.10 USD) - 2021/01/23 16:25:47 ET
Table 'Transvaalia' 6-max Seat #5 is the button
Seat 1: tomcairnes ($7.99 in chips) 
Seat 2: JonnyDoubleYou ($3.22 in chips) 
Seat 3: eddieamn ($10 in chips) 
Seat 5: Oleg032 ($10.56 in chips) 
Seat 6: Chrstphr1 ($9.78 in chips) 
Chrstphr1: posts small blind $0.05
tomcairnes: posts big blind $0.10
and 07335: sits out 
*** HOLE CARDS ***
JonnyDoubleYou: folds 
eddieamn: folds 
Oleg032: raises $0.15 to $0.25
Chrstphr1: folds 
tomcairnes: folds 
Uncalled bet ($0.15) returned to Oleg032
Oleg032 collected $0.25 from pot
Oleg032: doesn't show hand 
*** SUMMARY ***
Total pot $0.25 | Rake $0 
Seat 1: tomcairnes (big blind) folded before Flop
Seat 2: JonnyDoubleYou folded before Flop (didn't bet)
Seat 3: eddieamn folded before Flop (didn't bet)
Seat 5: Oleg032 (button) collected ($0.25)
Seat 6: Chrstphr1 (small blind) folded before Flop



PokerStars Hand #222972125972:  Hold'em No Limit ($0.05/$0.10 USD) - 2021/01/23 16:26:01 ET
Table 'Transvaalia' 6-max Seat #6 is the button
Seat 1: tomcairnes ($7.89 in chips) 
Seat 2: JonnyDoubleYou ($3.22 in chips) 
Seat 3: eddieamn ($10 in chips) 
Seat 5: Oleg032 ($10.71 in chips) 
Seat 6: Chrstphr1 ($9.73 in chips) 
tomcairnes: posts small blind $0.05
JonnyDoubleYou: posts big blind $0.10
and 07335: sits out 
*** HOLE CARDS ***
eddieamn: folds 
Oleg032: folds 
Chrstphr1: folds 
tomcairnes: calls $0.05
JonnyDoubleYou: checks 
*** FLOP *** [Qc Kc 8s]
tomcairnes: checks 
JonnyDoubleYou: checks 
*** TURN *** [Qc Kc 8s] [9d]
tomcairnes: checks 
JonnyDoubleYou: checks 
*** RIVER *** [Qc Kc 8s 9d] [4s]
tomcairnes: checks 
JonnyDoubleYou: checks 
*** SHOW DOWN ***
tomcairnes: shows [6h As] (high card Ace)
JonnyDoubleYou: shows [Qh 2s] (a pair of Queens)
JonnyDoubleYou collected $0.19 from pot
*** SUMMARY ***
Total pot $0.20 | Rake $0.01 
Board [Qc Kc 8s 9d 4s]
Seat 1: tomcairnes (small blind) showed [6h As] and lost with high card Ace
Seat 2: JonnyDoubleYou (big blind) showed [Qh 2s] and won ($0.19) with a pair of Queens
Seat 3: eddieamn folded before Flop (didn't bet)
Seat 5: Oleg032 folded before Flop (didn't bet)
Seat 6: Chrstphr1 (button) folded before Flop (didn't bet)



PokerStars Hand #222972162530:  Hold'em No Limit ($0.05/$0.10 USD) - 2021/01/23 16:26:44 ET
Table 'Transvaalia' 6-max Seat #1 is the button
Seat 1: tomcairnes ($7.79 in chips) 
Seat 2: JonnyDoubleYou ($3.31 in chips) 
Seat 3: eddieamn ($10 in chips) 
Seat 5: Oleg032 ($10.71 in chips) 
Seat 6: Chrstphr1 ($9.73 in chips) 
JonnyDoubleYou: posts small blind $0.05
eddieamn: posts big blind $0.10
and 07335: sits out 
*** HOLE CARDS ***
Oleg032: folds 
Chrstphr1: raises $0.20 to $0.30
tomcairnes: calls $0.30
JonnyDoubleYou: folds 
eddieamn: raises $0.90 to $1.20
Chrstphr1: folds 
tomcairnes: calls $0.90
*** FLOP *** [9d 8h 9c]
eddieamn: bets $0.80
tomcairnes: calls $0.80
*** TURN *** [9d 8h 9c] [6h]
eddieamn: checks 
tomcairnes: checks 
*** RIVER *** [9d 8h 9c 6h] [Ad]
eddieamn: bets $8 and is all-in
tomcairnes: folds 
Uncalled bet ($8) returned to eddieamn
eddieamn collected $4.15 from pot
*** SUMMARY ***
Total pot $4.35 | Rake $0.20 
Board [9d 8h 9c 6h Ad]
Seat 1: tomcairnes (button) folded on the River
Seat 2: JonnyDoubleYou (small blind) folded before Flop
Seat 3: eddieamn (big blind) collected ($4.15)
Seat 5: Oleg032 folded before Flop (didn't bet)
Seat 6: Chrstphr1 folded before Flop



PokerStars Hand #222972218538:  Hold'em No Limit ($0.05/$0.10 USD) - 2021/01/23 16:27:50 ET
Table 'Transvaalia' 6-max Seat #2 is the button
Seat 1: tomcairnes ($5.79 in chips) 
Seat 2: JonnyDoubleYou ($3.26 in chips) 
Seat 3: eddieamn ($12.15 in chips) 
Seat 4: and 07335 ($10 in chips) 
Seat 5: Oleg032 ($10.71 in chips) 
Seat 6: Chrstphr1 ($9.43 in chips) 
eddieamn: posts small blind $0.05
and 07335: posts big blind $0.10
*** HOLE CARDS ***
Oleg032: folds 
Chrstphr1: folds 
tomcairnes: folds 
JonnyDoubleYou: folds 
eddieamn: folds 
Uncalled bet ($0.05) returned to and 07335
and 07335 collected $0.10 from pot
and 07335: doesn't show hand 
*** SUMMARY ***
Total pot $0.10 | Rake $0 
Seat 1: tomcairnes folded before Flop (didn't bet)
Seat 2: JonnyDoubleYou (button) folded before Flop (didn't bet)
Seat 3: eddieamn (small blind) folded before Flop
Seat 4: and 07335 (big blind) collected ($0.10)
Seat 5: Oleg032 folded before Flop (didn't bet)
Seat 6: Chrstphr1 folded before Flop (didn't bet)



PokerStars Hand #222972234979:  Hold'em No Limit ($0.05/$0.10 USD) - 2021/01/23 16:28:09 ET
Table 'Transvaalia' 6-max Seat #3 is the button
Seat 1: tomcairnes ($5.79 in chips) 
Seat 2: JonnyDoubleYou ($3.26 in chips) 
Seat 3: eddieamn ($12.10 in chips) 
Seat 4: and 07335 ($10.05 in chips) 
Seat 5: Oleg032 ($10.71 in chips) 
Seat 6: Chrstphr1 ($9.43 in chips) 
and 07335: posts small blind $0.05
Oleg032: posts big blind $0.10
*** HOLE CARDS ***
Chrstphr1: folds 
tomcairnes: folds 
JonnyDoubleYou: folds 
eddieamn: raises $0.20 to $0.30
and 07335: folds 
Oleg032: calls $0.20
*** FLOP *** [6s Tc 5h]
Oleg032: checks 
eddieamn: checks 
*** TURN *** [6s Tc 5h] [3d]
Oleg032: checks 
eddieamn: checks 
*** RIVER *** [6s Tc 5h 3d] [5d]
Oleg032: checks 
eddieamn: checks 
*** SHOW DOWN ***
Oleg032: shows [Jd 9h] (a pair of Fives)
eddieamn: mucks hand 
Oleg032 collected $0.62 from pot
*** SUMMARY ***
Total pot $0.65 | Rake $0.03 
Board [6s Tc 5h 3d 5d]
Seat 1: tomcairnes folded before Flop (didn't bet)
Seat 2: JonnyDoubleYou folded before Flop (didn't bet)
Seat 3: eddieamn (button) mucked
Seat 4: and 07335 (small blind) folded before Flop
Seat 5: Oleg032 (big blind) showed [Jd 9h] and won ($0.62) with a pair of Fives
Seat 6: Chrstphr1 folded before Flop (didn't bet)



PokerStars Hand #222972262085:  Hold'em No Limit ($0.05/$0.10 USD) - 2021/01/23 16:28:41 ET
Table 'Transvaalia' 6-max Seat #4 is the button
Seat 1: tomcairnes ($5.79 in chips) 
Seat 2: JonnyDoubleYou ($3.26 in chips) 
Seat 3: eddieamn ($11.80 in chips) 
Seat 4: and 07335 ($10 in chips) 
Seat 5: Oleg032 ($11.03 in chips) 
Seat 6: Chrstphr1 ($9.43 in chips) 
Oleg032: posts small blind $0.05
Chrstphr1: posts big blind $0.10
*** HOLE CARDS ***
tomcairnes: folds 
JonnyDoubleYou: folds 
eddieamn: folds 
and 07335: raises $0.15 to $0.25
Oleg032: folds 
Chrstphr1: calls $0.15
*** FLOP *** [Td Qs 9d]
Chrstphr1: checks 
and 07335: checks 
*** TURN *** [Td Qs 9d] [7h]
Chrstphr1: checks 
and 07335: checks 
*** RIVER *** [Td Qs 9d 7h] [Kh]
Chrstphr1: bets $0.53
and 07335: folds 
Uncalled bet ($0.53) returned to Chrstphr1
Chrstphr1 collected $0.53 from pot
Chrstphr1: doesn't show hand 
*** SUMMARY ***
Total pot $0.55 | Rake $0.02 
Board [Td Qs 9d 7h Kh]
Seat 1: tomcairnes folded before Flop (didn't bet)
Seat 2: JonnyDoubleYou folded before Flop (didn't bet)
Seat 3: eddieamn folded before Flop (didn't bet)
Seat 4: and 07335 (button) folded on the River
Seat 5: Oleg032 (small blind) folded before Flop
Seat 6: Chrstphr1 (big blind) collected ($0.53)



PokerStars Hand #222972303958:  Hold'em No Limit ($0.05/$0.10 USD) - 2021/01/23 16:29:31 ET
Table 'Transvaalia' 6-max Seat #5 is the button
Seat 1: tomcairnes ($5.79 in chips) 
Seat 2: JonnyDoubleYou ($3.26 in chips) 
Seat 3: eddieamn ($11.80 in chips) 
Seat 4: and 07335 ($10 in chips) 
Seat 5: Oleg032 ($10.98 in chips) 
Seat 6: Chrstphr1 ($9.71 in chips) 
Chrstphr1: posts small blind $0.05
tomcairnes: posts big blind $0.10
*** HOLE CARDS ***
JonnyDoubleYou: folds 
eddieamn: folds 
and 07335: folds 
Oleg032: raises $0.15 to $0.25
Chrstphr1: folds 
tomcairnes: folds 
Uncalled bet ($0.15) returned to Oleg032
Chrstphr1 leaves the table
Oleg032 collected $0.25 from pot
Oleg032: doesn't show hand 
*** SUMMARY ***
Total pot $0.25 | Rake $0 
Seat 1: tomcairnes (big blind) folded before Flop
Seat 2: JonnyDoubleYou folded before Flop (didn't bet)
Seat 3: eddieamn folded before Flop (didn't bet)
Seat 4: and 07335 folded before Flop (didn't bet)
Seat 5: Oleg032 (button) collected ($0.25)
Seat 6: Chrstphr1 (small blind) folded before Flop



PokerStars Hand #222972322102:  Hold'em No Limit ($0.05/$0.10 USD) - 2021/01/23 16:29:52 ET
Table 'Transvaalia' 6-max Seat #1 is the button
Seat 1: tomcairnes ($5.69 in chips) 
Seat 2: JonnyDoubleYou ($3.26 in chips) 
Seat 3: eddieamn ($11.80 in chips) 
Seat 4: and 07335 ($10 in chips) 
Seat 5: Oleg032 ($11.13 in chips) 
JonnyDoubleYou: posts small blind $0.05
eddieamn: posts big blind $0.10
*** HOLE CARDS ***
and 07335: folds 
Oleg032: raises $0.15 to $0.25
tomcairnes: folds 
JonnyDoubleYou: calls $0.20
eddieamn: folds 
*** FLOP *** [5s 8s 2c]
JonnyDoubleYou: checks 
Oleg032: checks 
*** TURN *** [5s 8s 2c] [6s]
JonnyDoubleYou: checks 
Oleg032: checks 
*** RIVER *** [5s 8s 2c 6s] [7d]
JonnyDoubleYou: checks 
Oleg032: bets $0.38
JonnyDoubleYou: calls $0.38
*** SHOW DOWN ***
Oleg032: shows [Th 9d] (a straight, Six to Ten)
JonnyDoubleYou: mucks hand 
Oleg032 collected $1.30 from pot
*** SUMMARY ***
Total pot $1.36 | Rake $0.06 
Board [5s 8s 2c 6s 7d]
Seat 1: tomcairnes (button) folded before Flop (didn't bet)
Seat 2: JonnyDoubleYou (small blind) mucked
Seat 3: eddieamn (big blind) folded before Flop
Seat 4: and 07335 folded before Flop (didn't bet)
Seat 5: Oleg032 showed [Th 9d] and won ($1.30) with a straight, Six to Ten



PokerStars Hand #222972349443:  Hold'em No Limit ($0.05/$0.10 USD) - 2021/01/23 16:30:24 ET
Table 'Transvaalia' 6-max Seat #2 is the button
Seat 1: tomcairnes ($5.69 in chips) 
Seat 2: JonnyDoubleYou ($2.63 in chips) 
Seat 3: eddieamn ($11.70 in chips) 
Seat 4: and 07335 ($10 in chips) 
Seat 5: Oleg032 ($11.80 in chips) 
eddieamn: posts small blind $0.05
and 07335: posts big blind $0.10
*** HOLE CARDS ***
Oleg032: folds 
tomcairnes: folds 
JonnyDoubleYou: raises $0.40 to $0.50
eddieamn: calls $0.45
and 07335: folds 
*** FLOP *** [Qs Ac Js]
eddieamn: checks 
JonnyDoubleYou: bets $0.70
I_Not_Alone joins the table at seat #6 
eddieamn: folds 
Uncalled bet ($0.70) returned to JonnyDoubleYou
JonnyDoubleYou collected $1.05 from pot
JonnyDoubleYou: doesn't show hand 
*** SUMMARY ***
Total pot $1.10 | Rake $0.05 
Board [Qs Ac Js]
Seat 1: tomcairnes folded before Flop (didn't bet)
Seat 2: JonnyDoubleYou (button) collected ($1.05)
Seat 3: eddieamn (small blind) folded on the Flop
Seat 4: and 07335 (big blind) folded before Flop
Seat 5: Oleg032 folded before Flop (didn't bet)



PokerStars Hand #222972371819:  Hold'em No Limit ($0.05/$0.10 USD) - 2021/01/23 16:30:50 ET
Table 'Transvaalia' 6-max Seat #3 is the button
Seat 1: tomcairnes ($5.69 in chips) 
Seat 2: JonnyDoubleYou ($3.18 in chips) 
Seat 3: eddieamn ($11.20 in chips) 
Seat 4: and 07335 ($10 in chips) 
Seat 5: Oleg032 ($11.80 in chips) 
and 07335: posts small blind $0.05
Oleg032: posts big blind $0.10
I_Not_Alone: sits out 
*** HOLE CARDS ***
tomcairnes: folds 
JonnyDoubleYou: folds 
eddieamn: raises $0.12 to $0.22
and 07335: folds 
Oleg032: raises $0.73 to $0.95
eddieamn: calls $0.73
*** FLOP *** [5h 9c 2d]
Oleg032: checks 
eddieamn: checks 
*** TURN *** [5h 9c 2d] [3s]
Oleg032: checks 
eddieamn: bets $1.30
Oleg032: folds 
Uncalled bet ($1.30) returned to eddieamn
eddieamn collected $1.86 from pot
*** SUMMARY ***
Total pot $1.95 | Rake $0.09 
Board [5h 9c 2d 3s]
Seat 1: tomcairnes folded before Flop (didn't bet)
Seat 2: JonnyDoubleYou folded before Flop (didn't bet)
Seat 3: eddieamn (button) collected ($1.86)
Seat 4: and 07335 (small blind) folded before Flop
Seat 5: Oleg032 (big blind) folded on the Turn



PokerStars Hand #222972587727:  Hold'em No Limit ($0.05/$0.10 USD) - 2021/01/23 16:35:01 ET
Table 'Transvaalia' 6-max Seat #3 is the button
Seat 1: tomcairnes ($5.54 in chips) 
Seat 2: JonnyDoubleYou ($3.34 in chips) 
Seat 3: eddieamn ($11.76 in chips) 
Seat 4: hesus32 ($3.70 in chips) 
Seat 5: Oleg032 ($11.55 in chips) 
Seat 6: I_Not_Alone ($10 in chips) 
hesus32: posts small blind $0.05
Oleg032: posts big blind $0.10
*** HOLE CARDS ***
I_Not_Alone: folds 
tomcairnes: calls $0.10
JonnyDoubleYou: folds 
eddieamn: raises $0.40 to $0.50
hesus32: folds 
Oleg032: folds 
tomcairnes: folds 
Uncalled bet ($0.40) returned to eddieamn
eddieamn collected $0.35 from pot
*** SUMMARY ***
Total pot $0.35 | Rake $0 
Seat 1: tomcairnes folded before Flop
Seat 2: JonnyDoubleYou folded before Flop (didn't bet)
Seat 3: eddieamn (button) collected ($0.35)
Seat 4: hesus32 (small blind) folded before Flop
Seat 5: Oleg032 (big blind) folded before Flop
Seat 6: I_Not_Alone folded before Flop (didn't bet)



PokerStars Hand #222972608894:  Hold'em No Limit ($0.05/$0.10 USD) - 2021/01/23 16:35:26 ET
Table 'Transvaalia' 6-max Seat #4 is the button
Seat 1: tomcairnes ($5.44 in chips) 
Seat 2: JonnyDoubleYou ($3.34 in chips) 
Seat 3: eddieamn ($12.01 in chips) 
Seat 4: hesus32 ($3.65 in chips) 
Seat 5: Oleg032 ($11.45 in chips) 
Seat 6: I_Not_Alone ($10 in chips) 
Oleg032: posts small blind $0.05
I_Not_Alone: posts big blind $0.10
*** HOLE CARDS ***
tomcairnes: calls $0.10
JonnyDoubleYou: folds 
eddieamn: folds 
hesus32: folds 
Oleg032: raises $0.20 to $0.30
I_Not_Alone: folds 
tomcairnes: calls $0.20
*** FLOP *** [Ad 9s Jc]
Oleg032: checks 
tomcairnes: checks 
*** TURN *** [Ad 9s Jc] [As]
Oleg032: checks 
tomcairnes: checks 
*** RIVER *** [Ad 9s Jc As] [6c]
Oleg032: checks 
tomcairnes: checks 
*** SHOW DOWN ***
Oleg032: shows [8d 9c] (two pair, Aces and Nines)
tomcairnes: mucks hand 
Oleg032 collected $0.67 from pot
*** SUMMARY ***
Total pot $0.70 | Rake $0.03 
Board [Ad 9s Jc As 6c]
Seat 1: tomcairnes mucked
Seat 2: JonnyDoubleYou folded before Flop (didn't bet)
Seat 3: eddieamn folded before Flop (didn't bet)
Seat 4: hesus32 (button) folded before Flop (didn't bet)
Seat 5: Oleg032 (small blind) showed [8d 9c] and won ($0.67) with two pair, Aces and Nines
Seat 6: I_Not_Alone (big blind) folded before Flop



PokerStars Hand #222972638794:  Hold'em No Limit ($0.05/$0.10 USD) - 2021/01/23 16:36:02 ET
Table 'Transvaalia' 6-max Seat #5 is the button
Seat 1: tomcairnes ($5.14 in chips) 
Seat 2: JonnyDoubleYou ($3.34 in chips) 
Seat 3: eddieamn ($12.01 in chips) 
Seat 4: hesus32 ($3.65 in chips) 
Seat 5: Oleg032 ($11.82 in chips) 
Seat 6: I_Not_Alone ($10 in chips) 
I_Not_Alone: posts small blind $0.05
tomcairnes: posts big blind $0.10
*** HOLE CARDS ***
JonnyDoubleYou: folds 
eddieamn: folds 
hesus32: raises $0.20 to $0.30
Oleg032: raises $0.75 to $1.05
I_Not_Alone: folds 
tomcairnes: folds 
hesus32: raises $2.60 to $3.65 and is all-in
Oleg032: calls $2.60
*** FLOP *** [9d Js Qc]
*** TURN *** [9d Js Qc] [7c]
*** RIVER *** [9d Js Qc 7c] [6c]
*** SHOW DOWN ***
hesus32: shows [Ac Ad] (a pair of Aces)
Oleg032: shows [Jc Ah] (a pair of Jacks)
hesus32 collected $7.11 from pot
*** SUMMARY ***
Total pot $7.45 | Rake $0.34 
Board [9d Js Qc 7c 6c]
Seat 1: tomcairnes (big blind) folded before Flop
Seat 2: JonnyDoubleYou folded before Flop (didn't bet)
Seat 3: eddieamn folded before Flop (didn't bet)
Seat 4: hesus32 showed [Ac Ad] and won ($7.11) with a pair of Aces
Seat 5: Oleg032 (button) showed [Jc Ah] and lost with a pair of Jacks
Seat 6: I_Not_Alone (small blind) folded before Flop



PokerStars Hand #222972667659:  Hold'em No Limit ($0.05/$0.10 USD) - 2021/01/23 16:36:36 ET
Table 'Transvaalia' 6-max Seat #6 is the button
Seat 1: tomcairnes ($5.04 in chips) 
Seat 2: JonnyDoubleYou ($3.34 in chips) 
Seat 3: eddieamn ($12.01 in chips) 
Seat 4: hesus32 ($7.11 in chips) 
Seat 5: Oleg032 ($10 in chips) 
Seat 6: I_Not_Alone ($10 in chips) 
tomcairnes: posts small blind $0.05
JonnyDoubleYou: posts big blind $0.10
*** HOLE CARDS ***
eddieamn: folds 
hesus32: folds 
Oleg032: folds 
I_Not_Alone: folds 
tomcairnes: raises $0.10 to $0.20
JonnyDoubleYou: calls $0.10
*** FLOP *** [Td 8d Jc]
tomcairnes: bets $0.20
JonnyDoubleYou: calls $0.20
*** TURN *** [Td 8d Jc] [2c]
tomcairnes: bets $0.20
JonnyDoubleYou: calls $0.20
*** RIVER *** [Td 8d Jc 2c] [6h]
tomcairnes: checks 
JonnyDoubleYou: checks 
*** SHOW DOWN ***
tomcairnes: shows [5d 5s] (a pair of Fives)
JonnyDoubleYou: mucks hand 
tomcairnes collected $1.15 from pot
*** SUMMARY ***
Total pot $1.20 | Rake $0.05 
Board [Td 8d Jc 2c 6h]
Seat 1: tomcairnes (small blind) showed [5d 5s] and won ($1.15) with a pair of Fives
Seat 2: JonnyDoubleYou (big blind) mucked
Seat 3: eddieamn folded before Flop (didn't bet)
Seat 4: hesus32 folded before Flop (didn't bet)
Seat 5: Oleg032 folded before Flop (didn't bet)
Seat 6: I_Not_Alone (button) folded before Flop (didn't bet)



PokerStars Hand #222972704407:  Hold'em No Limit ($0.05/$0.10 USD) - 2021/01/23 16:37:20 ET
Table 'Transvaalia' 6-max Seat #1 is the button
Seat 1: tomcairnes ($5.59 in chips) 
Seat 2: JonnyDoubleYou ($2.74 in chips) 
Seat 3: eddieamn ($12.01 in chips) 
Seat 4: hesus32 ($7.11 in chips) 
Seat 5: Oleg032 ($10 in chips) 
Seat 6: I_Not_Alone ($10 in chips) 
JonnyDoubleYou: posts small blind $0.05
eddieamn: posts big blind $0.10
*** HOLE CARDS ***
hesus32: calls $0.10
Oleg032: folds 
I_Not_Alone: folds 
tomcairnes: calls $0.10
JonnyDoubleYou: folds 
eddieamn: checks 
*** FLOP *** [Kd Qd 6s]
eddieamn: checks 
hesus32: checks 
tomcairnes: bets $0.33
eddieamn: raises $0.57 to $0.90
hesus32: folds 
tomcairnes: calls $0.57
*** TURN *** [Kd Qd 6s] [3c]
eddieamn: bets $2
tomcairnes: raises $2 to $4
eddieamn: raises $7.01 to $11.01 and is all-in
tomcairnes: calls $0.59 and is all-in
Uncalled bet ($6.42) returned to eddieamn
*** RIVER *** [Kd Qd 6s 3c] [Ks]
*** SHOW DOWN ***
eddieamn: shows [6c Kc] (a full house, Kings full of Sixes)
tomcairnes: shows [Tc Jc] (a pair of Kings)
eddieamn cashed out the hand for $8.77 | Cash Out Fee $0.09
*** SUMMARY ***
Total pot $11.33 | Rake $0.51 
Board [Kd Qd 6s 3c Ks]
Seat 1: tomcairnes (button) showed [Tc Jc] and lost with a pair of Kings
Seat 2: JonnyDoubleYou (small blind) folded before Flop
Seat 3: eddieamn (big blind) showed [6c Kc] and won ($10.82) with a full house, Kings full of Sixes (pot not awarded as player cashed out)
Seat 4: hesus32 folded on the Flop
Seat 5: Oleg032 folded before Flop (didn't bet)
Seat 6: I_Not_Alone folded before Flop (didn't bet)



PokerStars Hand #222972749224:  Hold'em No Limit ($0.05/$0.10 USD) - 2021/01/23 16:38:14 ET
Table 'Transvaalia' 6-max Seat #2 is the button
Seat 2: JonnyDoubleYou ($2.69 in chips) 
Seat 3: eddieamn ($15.19 in chips) 
Seat 4: hesus32 ($7.01 in chips) 
Seat 5: Oleg032 ($10 in chips) 
Seat 6: I_Not_Alone ($10 in chips) 
eddieamn: posts small blind $0.05
hesus32: posts big blind $0.10
*** HOLE CARDS ***
Oleg032: folds 
I_Not_Alone: raises $0.15 to $0.25
tomcairnes leaves the table
JonnyDoubleYou: folds 
eddieamn: folds 
hesus32: calls $0.15
*** FLOP *** [7h 4c 2c]
hesus32: checks 
I_Not_Alone: bets $0.27
hesus32: calls $0.27
*** TURN *** [7h 4c 2c] [Qc]
Spieler977 joins the table at seat #1 
hesus32: checks 
I_Not_Alone: bets $0.53
hesus32: calls $0.53
*** RIVER *** [7h 4c 2c Qc] [Qs]
hesus32: checks 
I_Not_Alone: bets $2
hesus32: folds 
Uncalled bet ($2) returned to I_Not_Alone
I_Not_Alone collected $2.05 from pot
I_Not_Alone: doesn't show hand 
*** SUMMARY ***
Total pot $2.15 | Rake $0.10 
Board [7h 4c 2c Qc Qs]
Seat 2: JonnyDoubleYou (button) folded before Flop (didn't bet)
Seat 3: eddieamn (small blind) folded before Flop
Seat 4: hesus32 (big blind) folded on the River
Seat 5: Oleg032 folded before Flop (didn't bet)
Seat 6: I_Not_Alone collected ($2.05)



PokerStars Hand #222972783368:  Hold'em No Limit ($0.05/$0.10 USD) - 2021/01/23 16:38:55 ET
Table 'Transvaalia' 6-max Seat #3 is the button
Seat 2: JonnyDoubleYou ($2.69 in chips) 
Seat 3: eddieamn ($15.14 in chips) 
Seat 4: hesus32 ($5.96 in chips) 
Seat 5: Oleg032 ($10 in chips) 
Seat 6: I_Not_Alone ($11 in chips) 
hesus32: posts small blind $0.05
Oleg032: posts big blind $0.10
Spieler977: sits out 
*** HOLE CARDS ***
I_Not_Alone: folds 
JonnyDoubleYou: folds 
eddieamn: raises $0.12 to $0.22
hesus32: folds 
Oleg032: folds 
Uncalled bet ($0.12) returned to eddieamn
eddieamn collected $0.25 from pot
*** SUMMARY ***
Total pot $0.25 | Rake $0 
Seat 2: JonnyDoubleYou folded before Flop (didn't bet)
Seat 3: eddieamn (button) collected ($0.25)
Seat 4: hesus32 (small blind) folded before Flop
Seat 5: Oleg032 (big blind) folded before Flop
Seat 6: I_Not_Alone folded before Flop (didn't bet)



PokerStars Hand #222972792897:  Hold'em No Limit ($0.05/$0.10 USD) - 2021/01/23 16:39:07 ET
Table 'Transvaalia' 6-max Seat #4 is the button
Seat 2: JonnyDoubleYou ($2.69 in chips) 
Seat 3: eddieamn ($15.29 in chips) 
Seat 4: hesus32 ($5.91 in chips) 
Seat 5: Oleg032 ($10 in chips) 
Seat 6: I_Not_Alone ($11 in chips) 
Oleg032: posts small blind $0.05
I_Not_Alone: posts big blind $0.10
Spieler977: sits out 
*** HOLE CARDS ***
JonnyDoubleYou: raises $0.10 to $0.20
eddieamn: raises $0.60 to $0.80
hesus32: folds 
Oleg032: folds 
I_Not_Alone: folds 
JonnyDoubleYou: raises $1.89 to $2.69 and is all-in
eddieamn: calls $1.89
*** FLOP *** [Ah Js Qc]
*** TURN *** [Ah Js Qc] [9c]
*** RIVER *** [Ah Js Qc 9c] [8s]
*** SHOW DOWN ***
JonnyDoubleYou: shows [Qh Qs] (three of a kind, Queens)
eddieamn: shows [Td Tc] (a straight, Eight to Queen)
eddieamn collected $5.28 from pot
*** SUMMARY ***
Total pot $5.53 | Rake $0.25 
Board [Ah Js Qc 9c 8s]
Seat 2: JonnyDoubleYou showed [Qh Qs] and lost with three of a kind, Queens
Seat 3: eddieamn showed [Td Tc] and won ($5.28) with a straight, Eight to Queen
Seat 4: hesus32 (button) folded before Flop (didn't bet)
Seat 5: Oleg032 (small blind) folded before Flop
Seat 6: I_Not_Alone (big blind) folded before Flop



PokerStars Hand #222972818879:  Hold'em No Limit ($0.05/$0.10 USD) - 2021/01/23 16:39:38 ET
Table 'Transvaalia' 6-max Seat #5 is the button
Seat 1: Spieler977 ($10 in chips) 
Seat 3: eddieamn ($17.88 in chips) 
Seat 4: hesus32 ($5.91 in chips) 
Seat 5: Oleg032 ($10 in chips) 
Seat 6: I_Not_Alone ($10.90 in chips) 
I_Not_Alone: posts small blind $0.05
Spieler977: posts big blind $0.10
*** HOLE CARDS ***
eddieamn: raises $0.20 to $0.30
hesus32: folds 
Oleg032: folds 
I_Not_Alone: folds 
Spieler977: folds 
Uncalled bet ($0.20) returned to eddieamn
eddieamn collected $0.25 from pot
*** SUMMARY ***
Total pot $0.25 | Rake $0 
Seat 1: Spieler977 (big blind) folded before Flop
Seat 3: eddieamn collected ($0.25)
Seat 4: hesus32 folded before Flop (didn't bet)
Seat 5: Oleg032 (button) folded before Flop (didn't bet)
Seat 6: I_Not_Alone (small blind) folded before Flop



PokerStars Hand #222972828706:  Hold'em No Limit ($0.05/$0.10 USD) - 2021/01/23 16:39:50 ET
Table 'Transvaalia' 6-max Seat #6 is the button
Seat 1: Spieler977 ($10 in chips) 
Seat 2: JonnyDoubleYou ($10 in chips) 
Seat 3: eddieamn ($18.03 in chips) 
Seat 4: hesus32 ($5.91 in chips) 
Seat 5: Oleg032 ($10 in chips) 
Seat 6: I_Not_Alone ($10.85 in chips) 
Spieler977: posts small blind $0.05
JonnyDoubleYou: posts big blind $0.10
*** HOLE CARDS ***
eddieamn: folds 
hesus32: folds 
Oleg032: folds 
I_Not_Alone: folds 
Spieler977: raises $0.20 to $0.30
JonnyDoubleYou: folds 
Uncalled bet ($0.20) returned to Spieler977
Spieler977 collected $0.20 from pot
Spieler977: doesn't show hand 
*** SUMMARY ***
Total pot $0.20 | Rake $0 
Seat 1: Spieler977 (small blind) collected ($0.20)
Seat 2: JonnyDoubleYou (big blind) folded before Flop
Seat 3: eddieamn folded before Flop (didn't bet)
Seat 4: hesus32 folded before Flop (didn't bet)
Seat 5: Oleg032 folded before Flop (didn't bet)
Seat 6: I_Not_Alone (button) folded before Flop (didn't bet)



PokerStars Hand #222972850403:  Hold'em No Limit ($0.05/$0.10 USD) - 2021/01/23 16:40:04 ET
Table 'Transvaalia' 6-max Seat #1 is the button
Seat 1: Spieler977 ($10.10 in chips) 
Seat 2: JonnyDoubleYou ($9.90 in chips) 
Seat 3: eddieamn ($18.03 in chips) 
Seat 4: hesus32 ($5.91 in chips) 
Seat 5: Oleg032 ($10 in chips) 
Seat 6: I_Not_Alone ($10.85 in chips) 
JonnyDoubleYou: posts small blind $0.05
eddieamn: posts big blind $0.10
*** HOLE CARDS ***
hesus32: folds 
Oleg032: folds 
I_Not_Alone: folds 
Spieler977: raises $0.20 to $0.30
JonnyDoubleYou: folds 
eddieamn: folds 
Uncalled bet ($0.20) returned to Spieler977
Spieler977 collected $0.25 from pot
Spieler977: doesn't show hand 
*** SUMMARY ***
Total pot $0.25 | Rake $0 
Seat 1: Spieler977 (button) collected ($0.25)
Seat 2: JonnyDoubleYou (small blind) folded before Flop
Seat 3: eddieamn (big blind) folded before Flop
Seat 4: hesus32 folded before Flop (didn't bet)
Seat 5: Oleg032 folded before Flop (didn't bet)
Seat 6: I_Not_Alone folded before Flop (didn't bet)



PokerStars Hand #222972863514:  Hold'em No Limit ($0.05/$0.10 USD) - 2021/01/23 16:40:20 ET
Table 'Transvaalia' 6-max Seat #2 is the button
Seat 1: Spieler977 ($10.25 in chips) 
Seat 2: JonnyDoubleYou ($9.85 in chips) 
Seat 3: eddieamn ($17.93 in chips) 
Seat 4: hesus32 ($5.91 in chips) 
Seat 5: Oleg032 ($10 in chips) 
Seat 6: I_Not_Alone ($10.85 in chips) 
eddieamn: posts small blind $0.05
hesus32: posts big blind $0.10
*** HOLE CARDS ***
Oleg032: folds 
I_Not_Alone: folds 
Spieler977: raises $0.20 to $0.30
JonnyDoubleYou: folds 
eddieamn: folds 
hesus32: calls $0.20
*** FLOP *** [7c 3s 2d]
hesus32: checks 
Spieler977: checks 
*** TURN *** [7c 3s 2d] [5s]
hesus32: bets $0.20
JonnyDoubleYou leaves the table
Spieler977: folds 
Uncalled bet ($0.20) returned to hesus32
hesus32 collected $0.62 from pot
hesus32: doesn't show hand 
*** SUMMARY ***
Total pot $0.65 | Rake $0.03 
Board [7c 3s 2d 5s]
Seat 1: Spieler977 folded on the Turn
Seat 2: JonnyDoubleYou (button) folded before Flop (didn't bet)
Seat 3: eddieamn (small blind) folded before Flop
Seat 4: hesus32 (big blind) collected ($0.62)
Seat 5: Oleg032 folded before Flop (didn't bet)
Seat 6: I_Not_Alone folded before Flop (didn't bet)



PokerStars Hand #222972905924:  Hold'em No Limit ($0.05/$0.10 USD) - 2021/01/23 16:41:11 ET
Table 'Transvaalia' 6-max Seat #3 is the button
Seat 1: Spieler977 ($10 in chips) 
Seat 3: eddieamn ($17.88 in chips) 
Seat 4: hesus32 ($6.23 in chips) 
Seat 5: Oleg032 ($10 in chips) 
Seat 6: I_Not_Alone ($10.85 in chips) 
hesus32: posts small blind $0.05
Oleg032: posts big blind $0.10
*** HOLE CARDS ***
I_Not_Alone: folds 
Spieler977: folds 
Yellowbaanana joins the table at seat #2 
eddieamn: folds 
hesus32: raises $0.20 to $0.30
Oleg032: calls $0.20
*** FLOP *** [9h 8c 9s]
eddieamn leaves the table
hesus32: bets $0.28
Oleg032: folds 
Uncalled bet ($0.28) returned to hesus32
hesus32 collected $0.57 from pot
hesus32: doesn't show hand 
*** SUMMARY ***
Total pot $0.60 | Rake $0.03 
Board [9h 8c 9s]
Seat 1: Spieler977 folded before Flop (didn't bet)
Seat 3: eddieamn (button) folded before Flop (didn't bet)
Seat 4: hesus32 (small blind) collected ($0.57)
Seat 5: Oleg032 (big blind) folded on the Flop
Seat 6: I_Not_Alone folded before Flop (didn't bet)



PokerStars Hand #222972933947:  Hold'em No Limit ($0.05/$0.10 USD) - 2021/01/23 16:41:45 ET
Table 'Transvaalia' 6-max Seat #4 is the button
Seat 1: Spieler977 ($10 in chips) 
Seat 2: Yellowbaanana ($8 in chips) 
Seat 4: hesus32 ($6.50 in chips) 
Seat 5: Oleg032 ($10 in chips) 
Seat 6: I_Not_Alone ($10.85 in chips) 
Oleg032: posts small blind $0.05
I_Not_Alone: posts big blind $0.10
Yellowbaanana: posts big blind $0.10
*** HOLE CARDS ***
Spieler977: folds 
Yellowbaanana: checks 
hesus32: folds 
Oleg032: folds 
I_Not_Alone: checks 
*** FLOP *** [4h 2s Ac]
I_Not_Alone: checks 
Yellowbaanana: checks 
*** TURN *** [4h 2s Ac] [8d]
I_Not_Alone: checks 
Yellowbaanana: checks 
*** RIVER *** [4h 2s Ac 8d] [Td]
I_Not_Alone: checks 
Yellowbaanana: bets $0.10
I_Not_Alone: folds 
Uncalled bet ($0.10) returned to Yellowbaanana
Yellowbaanana collected $0.24 from pot
Yellowbaanana: doesn't show hand 
*** SUMMARY ***
Total pot $0.25 | Rake $0.01 
Board [4h 2s Ac 8d Td]
Seat 1: Spieler977 folded before Flop (didn't bet)
Seat 2: Yellowbaanana collected ($0.24)
Seat 4: hesus32 (button) folded before Flop (didn't bet)
Seat 5: Oleg032 (small blind) folded before Flop
Seat 6: I_Not_Alone (big blind) folded on the River



PokerStars Hand #222973978503:  Hold'em No Limit ($0.05/$0.10 USD) - 2021/01/23 17:04:14 ET
Table 'Transvaalia' 6-max Seat #1 is the button
Seat 1: Spieler977 ($10 in chips) 
Seat 2: Yellowbaanana ($17.46 in chips) 
Seat 3: bawsak17 ($11.85 in chips) 
Seat 4: baadnewz01 ($10 in chips) 
Seat 5: Loks95 ($8.57 in chips) 
Seat 6: I_Not_Alone ($13.50 in chips) 
Yellowbaanana: posts small blind $0.05
bawsak17: posts big blind $0.10
*** HOLE CARDS ***
baadnewz01: folds 
Loks95: calls $0.10
I_Not_Alone: folds 
Spieler977: raises $0.30 to $0.40
Yellowbaanana: calls $0.35
bawsak17: folds 
Loks95: calls $0.30
*** FLOP *** [Jc Td Tc]
Yellowbaanana: checks 
Loks95: checks 
Spieler977: checks 
*** TURN *** [Jc Td Tc] [9s]
Yellowbaanana: checks 
Loks95: checks 
Spieler977: checks 
*** RIVER *** [Jc Td Tc 9s] [Qh]
Yellowbaanana: checks 
Loks95: checks 
Spieler977: checks 
*** SHOW DOWN ***
Yellowbaanana: shows [Ah Jd] (two pair, Jacks and Tens)
Loks95: mucks hand 
Spieler977: mucks hand 
Yellowbaanana collected $1.24 from pot
*** SUMMARY ***
Total pot $1.30 | Rake $0.06 
Board [Jc Td Tc 9s Qh]
Seat 1: Spieler977 (button) mucked
Seat 2: Yellowbaanana (small blind) showed [Ah Jd] and won ($1.24) with two pair, Jacks and Tens
Seat 3: bawsak17 (big blind) folded before Flop
Seat 4: baadnewz01 folded before Flop (didn't bet)
Seat 5: Loks95 mucked
Seat 6: I_Not_Alone folded before Flop (didn't bet)



PokerStars Hand #222974034632:  Hold'em No Limit ($0.05/$0.10 USD) - 2021/01/23 17:05:10 ET
Table 'Transvaalia' 6-max Seat #2 is the button
Seat 1: Spieler977 ($10 in chips) 
Seat 2: Yellowbaanana ($18.30 in chips) 
Seat 3: bawsak17 ($11.75 in chips) 
Seat 4: baadnewz01 ($10 in chips) 
Seat 5: Loks95 ($8.17 in chips) 
Seat 6: I_Not_Alone ($13.50 in chips) 
bawsak17: posts small blind $0.05
baadnewz01: posts big blind $0.10
*** HOLE CARDS ***
Loks95: calls $0.10
I_Not_Alone: folds 
Spieler977: folds 
Yellowbaanana: calls $0.10
bawsak17: folds 
baadnewz01: checks 
*** FLOP *** [9s 8s Ks]
baadnewz01: checks 
Loks95: checks 
Yellowbaanana: bets $0.17
baadnewz01: folds 
Loks95: folds 
Uncalled bet ($0.17) returned to Yellowbaanana
Yellowbaanana collected $0.33 from pot
Yellowbaanana: doesn't show hand 
*** SUMMARY ***
Total pot $0.35 | Rake $0.02 
Board [9s 8s Ks]
Seat 1: Spieler977 folded before Flop (didn't bet)
Seat 2: Yellowbaanana (button) collected ($0.33)
Seat 3: bawsak17 (small blind) folded before Flop
Seat 4: baadnewz01 (big blind) folded on the Flop
Seat 5: Loks95 folded on the Flop
Seat 6: I_Not_Alone folded before Flop (didn't bet)



PokerStars Hand #222974075367:  Hold'em No Limit ($0.05/$0.10 USD) - 2021/01/23 17:05:59 ET
Table 'Transvaalia' 6-max Seat #3 is the button
Seat 1: Spieler977 ($10 in chips) 
Seat 2: Yellowbaanana ($18.53 in chips) 
Seat 3: bawsak17 ($11.70 in chips) 
Seat 4: baadnewz01 ($10 in chips) 
Seat 5: Loks95 ($8.07 in chips) 
Seat 6: I_Not_Alone ($13.50 in chips) 
baadnewz01: posts small blind $0.05
Loks95: posts big blind $0.10
*** HOLE CARDS ***
I_Not_Alone: raises $0.15 to $0.25
Spieler977: folds 
Yellowbaanana: folds 
bawsak17: folds 
baadnewz01: calls $0.20
Loks95: folds 
*** FLOP *** [2d 8d 8h]
baadnewz01: checks 
I_Not_Alone: bets $0.18
baadnewz01: calls $0.18
*** TURN *** [2d 8d 8h] [Kh]
baadnewz01: checks 
I_Not_Alone: bets $0.29
baadnewz01: calls $0.29
*** RIVER *** [2d 8d 8h Kh] [Ks]
baadnewz01: checks 
I_Not_Alone: checks 
*** SHOW DOWN ***
baadnewz01: shows [Jd Jh] (two pair, Kings and Jacks)
I_Not_Alone: shows [Qc Qs] (two pair, Kings and Queens)
I_Not_Alone collected $1.47 from pot
*** SUMMARY ***
Total pot $1.54 | Rake $0.07 
Board [2d 8d 8h Kh Ks]
Seat 1: Spieler977 folded before Flop (didn't bet)
Seat 2: Yellowbaanana folded before Flop (didn't bet)
Seat 3: bawsak17 (button) folded before Flop (didn't bet)
Seat 4: baadnewz01 (small blind) showed [Jd Jh] and lost with two pair, Kings and Jacks
Seat 5: Loks95 (big blind) folded before Flop
Seat 6: I_Not_Alone showed [Qc Qs] and won ($1.47) with two pair, Kings and Queens



PokerStars Hand #222974122144:  Hold'em No Limit ($0.05/$0.10 USD) - 2021/01/23 17:06:55 ET
Table 'Transvaalia' 6-max Seat #4 is the button
Seat 1: Spieler977 ($10 in chips) 
Seat 2: Yellowbaanana ($18.53 in chips) 
Seat 3: bawsak17 ($11.70 in chips) 
Seat 4: baadnewz01 ($10 in chips) 
Seat 5: Loks95 ($7.97 in chips) 
Seat 6: I_Not_Alone ($14.25 in chips) 
Loks95: posts small blind $0.05
I_Not_Alone: posts big blind $0.10
*** HOLE CARDS ***
Spieler977: folds 
Yellowbaanana: folds 
bawsak17: raises $0.15 to $0.25
baadnewz01: folds 
Loks95: calls $0.20
I_Not_Alone: folds 
*** FLOP *** [8s Ac 9h]
Loks95: checks 
bawsak17: checks 
*** TURN *** [8s Ac 9h] [7c]
Loks95: checks 
bawsak17: checks 
*** RIVER *** [8s Ac 9h 7c] [Ad]
Loks95: checks 
bawsak17: checks 
*** SHOW DOWN ***
Loks95: shows [4s 8c] (two pair, Aces and Eights)
bawsak17: mucks hand 
Loks95 collected $0.57 from pot
*** SUMMARY ***
Total pot $0.60 | Rake $0.03 
Board [8s Ac 9h 7c Ad]
Seat 1: Spieler977 folded before Flop (didn't bet)
Seat 2: Yellowbaanana folded before Flop (didn't bet)
Seat 3: bawsak17 mucked
Seat 4: baadnewz01 (button) folded before Flop (didn't bet)
Seat 5: Loks95 (small blind) showed [4s 8c] and won ($0.57) with two pair, Aces and Eights
Seat 6: I_Not_Alone (big blind) folded before Flop



PokerStars Hand #222974158453:  Hold'em No Limit ($0.05/$0.10 USD) - 2021/01/23 17:07:38 ET
Table 'Transvaalia' 6-max Seat #5 is the button
Seat 1: Spieler977 ($10 in chips) 
Seat 2: Yellowbaanana ($18.53 in chips) 
Seat 3: bawsak17 ($11.45 in chips) 
Seat 4: baadnewz01 ($10 in chips) 
Seat 5: Loks95 ($8.29 in chips) 
Seat 6: I_Not_Alone ($14.15 in chips) 
I_Not_Alone: posts small blind $0.05
Spieler977: posts big blind $0.10
*** HOLE CARDS ***
Yellowbaanana: calls $0.10
bawsak17: folds 
baadnewz01: folds 
Loks95: folds 
I_Not_Alone: folds 
Spieler977: checks 
*** FLOP *** [Qc Jh Qh]
Spieler977: checks 
Yellowbaanana: bets $0.24
Spieler977: folds 
Uncalled bet ($0.24) returned to Yellowbaanana
Yellowbaanana collected $0.24 from pot
Yellowbaanana: doesn't show hand 
*** SUMMARY ***
Total pot $0.25 | Rake $0.01 
Board [Qc Jh Qh]
Seat 1: Spieler977 (big blind) folded on the Flop
Seat 2: Yellowbaanana collected ($0.24)
Seat 3: bawsak17 folded before Flop (didn't bet)
Seat 4: baadnewz01 folded before Flop (didn't bet)
Seat 5: Loks95 (button) folded before Flop (didn't bet)
Seat 6: I_Not_Alone (small blind) folded before Flop



PokerStars Hand #222974184455:  Hold'em No Limit ($0.05/$0.10 USD) - 2021/01/23 17:08:10 ET
Table 'Transvaalia' 6-max Seat #6 is the button
Seat 1: Spieler977 ($10 in chips) 
Seat 2: Yellowbaanana ($18.67 in chips) 
Seat 3: bawsak17 ($11.45 in chips) 
Seat 4: baadnewz01 ($10 in chips) 
Seat 5: Loks95 ($8.29 in chips) 
Seat 6: I_Not_Alone ($14.10 in chips) 
Spieler977: posts small blind $0.05
Yellowbaanana: posts big blind $0.10
*** HOLE CARDS ***
bawsak17: folds 
baadnewz01: folds 
Loks95: calls $0.10
I_Not_Alone: folds 
Spieler977: raises $0.30 to $0.40
Yellowbaanana: folds 
Loks95: calls $0.30
*** FLOP *** [9h 6c 6d]
Spieler977: bets $0.65
Loks95: folds 
Uncalled bet ($0.65) returned to Spieler977
Spieler977 collected $0.86 from pot
Spieler977: doesn't show hand 
*** SUMMARY ***
Total pot $0.90 | Rake $0.04 
Board [9h 6c 6d]
Seat 1: Spieler977 (small blind) collected ($0.86)
Seat 2: Yellowbaanana (big blind) folded before Flop
Seat 3: bawsak17 folded before Flop (didn't bet)
Seat 4: baadnewz01 folded before Flop (didn't bet)
Seat 5: Loks95 folded on the Flop
Seat 6: I_Not_Alone (button) folded before Flop (didn't bet)



PokerStars Hand #222974213088:  Hold'em No Limit ($0.05/$0.10 USD) - 2021/01/23 17:08:44 ET
Table 'Transvaalia' 6-max Seat #1 is the button
Seat 1: Spieler977 ($10.46 in chips) 
Seat 2: Yellowbaanana ($18.57 in chips) 
Seat 3: bawsak17 ($11.45 in chips) 
Seat 4: baadnewz01 ($10 in chips) 
Seat 5: Loks95 ($7.89 in chips) 
Seat 6: I_Not_Alone ($14.10 in chips) 
Yellowbaanana: posts small blind $0.05
bawsak17: posts big blind $0.10
*** HOLE CARDS ***
baadnewz01: raises $0.20 to $0.30
Loks95: folds 
I_Not_Alone: folds 
Spieler977: folds 
Yellowbaanana: folds 
bawsak17: calls $0.20
*** FLOP *** [3c 8c Tc]
bawsak17: checks 
baadnewz01: bets $0.30
bawsak17: folds 
Uncalled bet ($0.30) returned to baadnewz01
baadnewz01 collected $0.62 from pot
baadnewz01: doesn't show hand 
*** SUMMARY ***
Total pot $0.65 | Rake $0.03 
Board [3c 8c Tc]
Seat 1: Spieler977 (button) folded before Flop (didn't bet)
Seat 2: Yellowbaanana (small blind) folded before Flop
Seat 3: bawsak17 (big blind) folded on the Flop
Seat 4: baadnewz01 collected ($0.62)
Seat 5: Loks95 folded before Flop (didn't bet)
Seat 6: I_Not_Alone folded before Flop (didn't bet)



PokerStars Hand #222974236014:  Hold'em No Limit ($0.05/$0.10 USD) - 2021/01/23 17:09:11 ET
Table 'Transvaalia' 6-max Seat #2 is the button
Seat 1: Spieler977 ($10.46 in chips) 
Seat 2: Yellowbaanana ($18.52 in chips) 
Seat 3: bawsak17 ($11.15 in chips) 
Seat 4: baadnewz01 ($10.32 in chips) 
Seat 5: Loks95 ($7.89 in chips) 
Seat 6: I_Not_Alone ($14.10 in chips) 
bawsak17: posts small blind $0.05
baadnewz01: posts big blind $0.10
*** HOLE CARDS ***
Loks95: calls $0.10
I_Not_Alone: folds 
Spieler977: folds 
Yellowbaanana: calls $0.10
bawsak17: folds 
baadnewz01: checks 
*** FLOP *** [Qh 2d Ks]
baadnewz01: checks 
Loks95: checks 
Yellowbaanana: bets $0.33
baadnewz01: folds 
Loks95: folds 
Uncalled bet ($0.33) returned to Yellowbaanana
Yellowbaanana collected $0.33 from pot
Yellowbaanana: doesn't show hand 
*** SUMMARY ***
Total pot $0.35 | Rake $0.02 
Board [Qh 2d Ks]
Seat 1: Spieler977 folded before Flop (didn't bet)
Seat 2: Yellowbaanana (button) collected ($0.33)
Seat 3: bawsak17 (small blind) folded before Flop
Seat 4: baadnewz01 (big blind) folded on the Flop
Seat 5: Loks95 folded on the Flop
Seat 6: I_Not_Alone folded before Flop (didn't bet)



PokerStars Hand #222974266334:  Hold'em No Limit ($0.05/$0.10 USD) - 2021/01/23 17:09:48 ET
Table 'Transvaalia' 6-max Seat #3 is the button
Seat 1: Spieler977 ($10.46 in chips) 
Seat 2: Yellowbaanana ($18.75 in chips) 
Seat 3: bawsak17 ($11.10 in chips) 
Seat 4: baadnewz01 ($10.22 in chips) 
Seat 5: Loks95 ($7.79 in chips) 
Seat 6: I_Not_Alone ($14.10 in chips) 
baadnewz01: posts small blind $0.05
Loks95: posts big blind $0.10
*** HOLE CARDS ***
I_Not_Alone: folds 
Spieler977: folds 
Yellowbaanana: folds 
bawsak17: raises $0.15 to $0.25
baadnewz01: folds 
Loks95: calls $0.15
*** FLOP *** [6s 4c Kd]
Loks95: checks 
bawsak17: bets $0.27
Loks95: folds 
Uncalled bet ($0.27) returned to bawsak17
bawsak17 collected $0.53 from pot
bawsak17: doesn't show hand 
*** SUMMARY ***
Total pot $0.55 | Rake $0.02 
Board [6s 4c Kd]
Seat 1: Spieler977 folded before Flop (didn't bet)
Seat 2: Yellowbaanana folded before Flop (didn't bet)
Seat 3: bawsak17 (button) collected ($0.53)
Seat 4: baadnewz01 (small blind) folded before Flop
Seat 5: Loks95 (big blind) folded on the Flop
Seat 6: I_Not_Alone folded before Flop (didn't bet)



PokerStars Hand #222974294850:  Hold'em No Limit ($0.05/$0.10 USD) - 2021/01/23 17:10:22 ET
Table 'Transvaalia' 6-max Seat #4 is the button
Seat 1: Spieler977 ($10.46 in chips) 
Seat 2: Yellowbaanana ($18.75 in chips) 
Seat 3: bawsak17 ($11.38 in chips) 
Seat 4: baadnewz01 ($10.17 in chips) 
Seat 5: Loks95 ($7.54 in chips) 
Seat 6: I_Not_Alone ($14.10 in chips) 
Loks95: posts small blind $0.05
I_Not_Alone: posts big blind $0.10
*** HOLE CARDS ***
Spieler977: raises $0.20 to $0.30
Yellowbaanana: folds 
bawsak17: folds 
baadnewz01: folds 
Loks95: calls $0.25
I_Not_Alone: folds 
*** FLOP *** [7s 6c Ad]
Loks95: checks 
Spieler977: bets $0.50
Loks95: calls $0.50
*** TURN *** [7s 6c Ad] [Ac]
Loks95: checks 
Spieler977: checks 
*** RIVER *** [7s 6c Ad Ac] [9s]
Loks95: checks 
Spieler977: bets $1.22
Loks95: calls $1.22
*** SHOW DOWN ***
Spieler977: shows [Kc Ah] (three of a kind, Aces)
Loks95: mucks hand 
Spieler977 collected $3.95 from pot
*** SUMMARY ***
Total pot $4.14 | Rake $0.19 
Board [7s 6c Ad Ac 9s]
Seat 1: Spieler977 showed [Kc Ah] and won ($3.95) with three of a kind, Aces
Seat 2: Yellowbaanana folded before Flop (didn't bet)
Seat 3: bawsak17 folded before Flop (didn't bet)
Seat 4: baadnewz01 (button) folded before Flop (didn't bet)
Seat 5: Loks95 (small blind) mucked
Seat 6: I_Not_Alone (big blind) folded before Flop



PokerStars Hand #222974340737:  Hold'em No Limit ($0.05/$0.10 USD) - 2021/01/23 17:11:17 ET
Table 'Transvaalia' 6-max Seat #5 is the button
Seat 1: Spieler977 ($12.39 in chips) 
Seat 2: Yellowbaanana ($18.75 in chips) 
Seat 3: bawsak17 ($11.38 in chips) 
Seat 4: baadnewz01 ($10.17 in chips) 
Seat 5: Loks95 ($5.52 in chips) 
Seat 6: I_Not_Alone ($14 in chips) 
I_Not_Alone: posts small blind $0.05
Spieler977: posts big blind $0.10
*** HOLE CARDS ***
Yellowbaanana: calls $0.10
bawsak17: raises $0.30 to $0.40
baadnewz01: folds 
Loks95: calls $0.40
I_Not_Alone: folds 
Spieler977: folds 
Yellowbaanana: folds 
*** FLOP *** [3c 6s As]
bawsak17: bets $0.50
Loks95: folds 
Uncalled bet ($0.50) returned to bawsak17
bawsak17 collected $1 from pot
bawsak17: doesn't show hand 
*** SUMMARY ***
Total pot $1.05 | Rake $0.05 
Board [3c 6s As]
Seat 1: Spieler977 (big blind) folded before Flop
Seat 2: Yellowbaanana folded before Flop
Seat 3: bawsak17 collected ($1)
Seat 4: baadnewz01 folded before Flop (didn't bet)
Seat 5: Loks95 (button) folded on the Flop
Seat 6: I_Not_Alone (small blind) folded before Flop



PokerStars Hand #222974364339:  Hold'em No Limit ($0.05/$0.10 USD) - 2021/01/23 17:11:46 ET
Table 'Transvaalia' 6-max Seat #6 is the button
Seat 1: Spieler977 ($12.29 in chips) 
Seat 2: Yellowbaanana ($18.65 in chips) 
Seat 3: bawsak17 ($11.98 in chips) 
Seat 4: baadnewz01 ($10.17 in chips) 
Seat 5: Loks95 ($5.12 in chips) 
Seat 6: I_Not_Alone ($13.95 in chips) 
Spieler977: posts small blind $0.05
Yellowbaanana: posts big blind $0.10
*** HOLE CARDS ***
bawsak17: folds 
baadnewz01: folds 
Loks95: folds 
I_Not_Alone: raises $0.15 to $0.25
Spieler977: folds 
Yellowbaanana: folds 
Uncalled bet ($0.15) returned to I_Not_Alone
I_Not_Alone collected $0.25 from pot
I_Not_Alone: doesn't show hand 
*** SUMMARY ***
Total pot $0.25 | Rake $0 
Seat 1: Spieler977 (small blind) folded before Flop
Seat 2: Yellowbaanana (big blind) folded before Flop
Seat 3: bawsak17 folded before Flop (didn't bet)
Seat 4: baadnewz01 folded before Flop (didn't bet)
Seat 5: Loks95 folded before Flop (didn't bet)
Seat 6: I_Not_Alone (button) collected ($0.25)



PokerStars Hand #222974382568:  Hold'em No Limit ($0.05/$0.10 USD) - 2021/01/23 17:12:08 ET
Table 'Transvaalia' 6-max Seat #1 is the button
Seat 1: Spieler977 ($12.24 in chips) 
Seat 2: Yellowbaanana ($18.55 in chips) 
Seat 3: bawsak17 ($11.98 in chips) 
Seat 4: baadnewz01 ($10.17 in chips) 
Seat 5: Loks95 ($5.12 in chips) 
Seat 6: I_Not_Alone ($14.10 in chips) 
Yellowbaanana: posts small blind $0.05
bawsak17: posts big blind $0.10
*** HOLE CARDS ***
baadnewz01: folds 
Loks95: raises $0.80 to $0.90
I_Not_Alone: folds 
Spieler977: folds 
Yellowbaanana: folds 
bawsak17: folds 
Uncalled bet ($0.80) returned to Loks95
Loks95 collected $0.25 from pot
Loks95: doesn't show hand 
*** SUMMARY ***
Total pot $0.25 | Rake $0 
Seat 1: Spieler977 (button) folded before Flop (didn't bet)
Seat 2: Yellowbaanana (small blind) folded before Flop
Seat 3: bawsak17 (big blind) folded before Flop
Seat 4: baadnewz01 folded before Flop (didn't bet)
Seat 5: Loks95 collected ($0.25)
Seat 6: I_Not_Alone folded before Flop (didn't bet)



PokerStars Hand #222974408314:  Hold'em No Limit ($0.05/$0.10 USD) - 2021/01/23 17:12:39 ET
Table 'Transvaalia' 6-max Seat #2 is the button
Seat 1: Spieler977 ($12.24 in chips) 
Seat 2: Yellowbaanana ($18.50 in chips) 
Seat 3: bawsak17 ($11.88 in chips) 
Seat 4: baadnewz01 ($10.17 in chips) 
Seat 5: Loks95 ($5.27 in chips) 
Seat 6: I_Not_Alone ($14.10 in chips) 
bawsak17: posts small blind $0.05
baadnewz01: posts big blind $0.10
*** HOLE CARDS ***
Loks95: raises $0.90 to $1
I_Not_Alone has timed out
I_Not_Alone: folds 
Spieler977: folds 
Yellowbaanana: folds 
bawsak17: folds 
baadnewz01: folds 
Uncalled bet ($0.90) returned to Loks95
Loks95 collected $0.25 from pot
Loks95: doesn't show hand 
*** SUMMARY ***
Total pot $0.25 | Rake $0 
Seat 1: Spieler977 folded before Flop (didn't bet)
Seat 2: Yellowbaanana (button) folded before Flop (didn't bet)
Seat 3: bawsak17 (small blind) folded before Flop
Seat 4: baadnewz01 (big blind) folded before Flop
Seat 5: Loks95 collected ($0.25)
Seat 6: I_Not_Alone folded before Flop (didn't bet)



PokerStars Hand #222974434353:  Hold'em No Limit ($0.05/$0.10 USD) - 2021/01/23 17:13:11 ET
Table 'Transvaalia' 6-max Seat #3 is the button
Seat 1: Spieler977 ($12.24 in chips) 
Seat 2: Yellowbaanana ($18.50 in chips) 
Seat 3: bawsak17 ($11.83 in chips) 
Seat 4: baadnewz01 ($10.07 in chips) 
Seat 5: Loks95 ($5.42 in chips) 
Seat 6: I_Not_Alone ($14.10 in chips) 
baadnewz01: posts small blind $0.05
Loks95: posts big blind $0.10
*** HOLE CARDS ***
I_Not_Alone: folds 
Spieler977: folds 
Yellowbaanana: folds 
bawsak17: folds 
baadnewz01: folds 
Uncalled bet ($0.05) returned to Loks95
Loks95 collected $0.10 from pot
Loks95: doesn't show hand 
*** SUMMARY ***
Total pot $0.10 | Rake $0 
Seat 1: Spieler977 folded before Flop (didn't bet)
Seat 2: Yellowbaanana folded before Flop (didn't bet)
Seat 3: bawsak17 (button) folded before Flop (didn't bet)
Seat 4: baadnewz01 (small blind) folded before Flop
Seat 5: Loks95 (big blind) collected ($0.10)
Seat 6: I_Not_Alone folded before Flop (didn't bet)



PokerStars Hand #222974452700:  Hold'em No Limit ($0.05/$0.10 USD) - 2021/01/23 17:13:33 ET
Table 'Transvaalia' 6-max Seat #4 is the button
Seat 1: Spieler977 ($12.24 in chips) 
Seat 2: Yellowbaanana ($18.50 in chips) 
Seat 3: bawsak17 ($11.83 in chips) 
Seat 4: baadnewz01 ($10.02 in chips) 
Seat 5: Loks95 ($5.47 in chips) 
Seat 6: I_Not_Alone ($14.10 in chips) 
Loks95: posts small blind $0.05
I_Not_Alone: posts big blind $0.10
*** HOLE CARDS ***
Spieler977: raises $0.20 to $0.30
Yellowbaanana: folds 
bawsak17: folds 
baadnewz01: folds 
Loks95: folds 
I_Not_Alone: folds 
Uncalled bet ($0.20) returned to Spieler977
Spieler977 collected $0.25 from pot
Spieler977: doesn't show hand 
*** SUMMARY ***
Total pot $0.25 | Rake $0 
Seat 1: Spieler977 collected ($0.25)
Seat 2: Yellowbaanana folded before Flop (didn't bet)
Seat 3: bawsak17 folded before Flop (didn't bet)
Seat 4: baadnewz01 (button) folded before Flop (didn't bet)
Seat 5: Loks95 (small blind) folded before Flop
Seat 6: I_Not_Alone (big blind) folded before Flop



PokerStars Hand #222974473685:  Hold'em No Limit ($0.05/$0.10 USD) - 2021/01/23 17:13:59 ET
Table 'Transvaalia' 6-max Seat #5 is the button
Seat 1: Spieler977 ($12.39 in chips) 
Seat 2: Yellowbaanana ($18.50 in chips) 
Seat 3: bawsak17 ($11.83 in chips) 
Seat 4: baadnewz01 ($10.02 in chips) 
Seat 5: Loks95 ($5.42 in chips) 
Seat 6: I_Not_Alone ($14 in chips) 
I_Not_Alone: posts small blind $0.05
Spieler977: posts big blind $0.10
*** HOLE CARDS ***
Yellowbaanana: calls $0.10
bawsak17: folds 
baadnewz01: raises $0.30 to $0.40
Loks95: folds 
I_Not_Alone: folds 
Spieler977: folds 
Yellowbaanana: folds 
Uncalled bet ($0.30) returned to baadnewz01
baadnewz01 collected $0.35 from pot
baadnewz01: doesn't show hand 
*** SUMMARY ***
Total pot $0.35 | Rake $0 
Seat 1: Spieler977 (big blind) folded before Flop
Seat 2: Yellowbaanana folded before Flop
Seat 3: bawsak17 folded before Flop (didn't bet)
Seat 4: baadnewz01 collected ($0.35)
Seat 5: Loks95 (button) folded before Flop (didn't bet)
Seat 6: I_Not_Alone (small blind) folded before Flop



PokerStars Hand #222974499178:  Hold'em No Limit ($0.05/$0.10 USD) - 2021/01/23 17:14:30 ET
Table 'Transvaalia' 6-max Seat #6 is the button
Seat 1: Spieler977 ($12.29 in chips) 
Seat 2: Yellowbaanana ($18.40 in chips) 
Seat 3: bawsak17 ($11.83 in chips) 
Seat 4: baadnewz01 ($10.27 in chips) 
Seat 5: Loks95 ($5.42 in chips) 
Seat 6: I_Not_Alone ($13.95 in chips) 
Spieler977: posts small blind $0.05
Yellowbaanana: posts big blind $0.10
*** HOLE CARDS ***
bawsak17: folds 
baadnewz01: folds 
Loks95: calls $0.10
I_Not_Alone: folds 
Spieler977: folds 
Yellowbaanana: checks 
*** FLOP *** [Qs Ac Js]
Yellowbaanana: checks 
Loks95: checks 
*** TURN *** [Qs Ac Js] [7s]
Yellowbaanana: checks 
Loks95: bets $0.24
Yellowbaanana: folds 
Uncalled bet ($0.24) returned to Loks95
Loks95 collected $0.24 from pot
Loks95: doesn't show hand 
*** SUMMARY ***
Total pot $0.25 | Rake $0.01 
Board [Qs Ac Js 7s]
Seat 1: Spieler977 (small blind) folded before Flop
Seat 2: Yellowbaanana (big blind) folded on the Turn
Seat 3: bawsak17 folded before Flop (didn't bet)
Seat 4: baadnewz01 folded before Flop (didn't bet)
Seat 5: Loks95 collected ($0.24)
Seat 6: I_Not_Alone (button) folded before Flop (didn't bet)



PokerStars Hand #222974524621:  Hold'em No Limit ($0.05/$0.10 USD) - 2021/01/23 17:15:01 ET
Table 'Transvaalia' 6-max Seat #1 is the button
Seat 1: Spieler977 ($12.24 in chips) 
Seat 2: Yellowbaanana ($18.30 in chips) 
Seat 3: bawsak17 ($11.83 in chips) 
Seat 4: baadnewz01 ($10.27 in chips) 
Seat 5: Loks95 ($5.56 in chips) 
Seat 6: I_Not_Alone ($13.95 in chips) 
Yellowbaanana: posts small blind $0.05
bawsak17: posts big blind $0.10
*** HOLE CARDS ***
baadnewz01: folds 
Loks95: raises $0.10 to $0.20
I_Not_Alone: folds 
Spieler977: folds 
Yellowbaanana: folds 
bawsak17: calls $0.10
*** FLOP *** [Qs 9h 9d]
bawsak17: checks 
Loks95: checks 
*** TURN *** [Qs 9h 9d] [3s]
bawsak17: checks 
Loks95: checks 
*** RIVER *** [Qs 9h 9d 3s] [6c]
bawsak17: checks 
Loks95: checks 
*** SHOW DOWN ***
bawsak17: shows [8d Kc] (a pair of Nines)
Loks95: mucks hand 
bawsak17 collected $0.43 from pot
*** SUMMARY ***
Total pot $0.45 | Rake $0.02 
Board [Qs 9h 9d 3s 6c]
Seat 1: Spieler977 (button) folded before Flop (didn't bet)
Seat 2: Yellowbaanana (small blind) folded before Flop
Seat 3: bawsak17 (big blind) showed [8d Kc] and won ($0.43) with a pair of Nines
Seat 4: baadnewz01 folded before Flop (didn't bet)
Seat 5: Loks95 mucked
Seat 6: I_Not_Alone folded before Flop (didn't bet)



PokerStars Hand #222974552684:  Hold'em No Limit ($0.05/$0.10 USD) - 2021/01/23 17:15:35 ET
Table 'Transvaalia' 6-max Seat #2 is the button
Seat 1: Spieler977 ($12.24 in chips) 
Seat 2: Yellowbaanana ($18.25 in chips) 
Seat 3: bawsak17 ($12.06 in chips) 
Seat 4: baadnewz01 ($10.27 in chips) 
Seat 5: Loks95 ($5.36 in chips) 
Seat 6: I_Not_Alone ($13.95 in chips) 
bawsak17: posts small blind $0.05
baadnewz01: posts big blind $0.10
*** HOLE CARDS ***
Loks95: raises $1.80 to $1.90
I_Not_Alone: folds 
Spieler977: folds 
Yellowbaanana: folds 
bawsak17: folds 
baadnewz01: folds 
Uncalled bet ($1.80) returned to Loks95
Loks95 collected $0.25 from pot
Loks95: doesn't show hand 
*** SUMMARY ***
Total pot $0.25 | Rake $0 
Seat 1: Spieler977 folded before Flop (didn't bet)
Seat 2: Yellowbaanana (button) folded before Flop (didn't bet)
Seat 3: bawsak17 (small blind) folded before Flop
Seat 4: baadnewz01 (big blind) folded before Flop
Seat 5: Loks95 collected ($0.25)
Seat 6: I_Not_Alone folded before Flop (didn't bet)



PokerStars Hand #222974571484:  Hold'em No Limit ($0.05/$0.10 USD) - 2021/01/23 17:15:58 ET
Table 'Transvaalia' 6-max Seat #3 is the button
Seat 1: Spieler977 ($12.24 in chips) 
Seat 2: Yellowbaanana ($18.25 in chips) 
Seat 3: bawsak17 ($12.01 in chips) 
Seat 4: baadnewz01 ($10.17 in chips) 
Seat 5: Loks95 ($5.51 in chips) 
Seat 6: I_Not_Alone ($13.95 in chips) 
baadnewz01: posts small blind $0.05
Loks95: posts big blind $0.10
*** HOLE CARDS ***
I_Not_Alone: folds 
Spieler977: folds 
Yellowbaanana: folds 
bawsak17: folds 
baadnewz01: folds 
Uncalled bet ($0.05) returned to Loks95
Loks95 collected $0.10 from pot
Loks95: doesn't show hand 
*** SUMMARY ***
Total pot $0.10 | Rake $0 
Seat 1: Spieler977 folded before Flop (didn't bet)
Seat 2: Yellowbaanana folded before Flop (didn't bet)
Seat 3: bawsak17 (button) folded before Flop (didn't bet)
Seat 4: baadnewz01 (small blind) folded before Flop
Seat 5: Loks95 (big blind) collected ($0.10)
Seat 6: I_Not_Alone folded before Flop (didn't bet)



PokerStars Hand #222974587186:  Hold'em No Limit ($0.05/$0.10 USD) - 2021/01/23 17:16:17 ET
Table 'Transvaalia' 6-max Seat #4 is the button
Seat 1: Spieler977 ($12.24 in chips) 
Seat 2: Yellowbaanana ($18.25 in chips) 
Seat 3: bawsak17 ($12.01 in chips) 
Seat 4: baadnewz01 ($10.12 in chips) 
Seat 5: Loks95 ($5.56 in chips) 
Seat 6: I_Not_Alone ($13.95 in chips) 
Loks95: posts small blind $0.05
I_Not_Alone: posts big blind $0.10
*** HOLE CARDS ***
Spieler977: folds 
Yellowbaanana: folds 
bawsak17: folds 
baadnewz01: folds 
Loks95: calls $0.05
I_Not_Alone: checks 
*** FLOP *** [2h 6d 4d]
Loks95: bets $0.10
I_Not_Alone: calls $0.10
*** TURN *** [2h 6d 4d] [9c]
Loks95: bets $0.10
I_Not_Alone: calls $0.10
*** RIVER *** [2h 6d 4d 9c] [Jh]
Loks95: bets $0.10
I_Not_Alone: raises $0.40 to $0.50
Loks95: calls $0.40
*** SHOW DOWN ***
I_Not_Alone: shows [6h Js] (two pair, Jacks and Sixes)
Loks95: mucks hand 
I_Not_Alone collected $1.53 from pot
*** SUMMARY ***
Total pot $1.60 | Rake $0.07 
Board [2h 6d 4d 9c Jh]
Seat 1: Spieler977 folded before Flop (didn't bet)
Seat 2: Yellowbaanana folded before Flop (didn't bet)
Seat 3: bawsak17 folded before Flop (didn't bet)
Seat 4: baadnewz01 (button) folded before Flop (didn't bet)
Seat 5: Loks95 (small blind) mucked
Seat 6: I_Not_Alone (big blind) showed [6h Js] and won ($1.53) with two pair, Jacks and Sixes



PokerStars Hand #222974636587:  Hold'em No Limit ($0.05/$0.10 USD) - 2021/01/23 17:17:17 ET
Table 'Transvaalia' 6-max Seat #5 is the button
Seat 1: Spieler977 ($12.24 in chips) 
Seat 2: Yellowbaanana ($18.25 in chips) 
Seat 3: bawsak17 ($12.01 in chips) 
Seat 4: baadnewz01 ($10.12 in chips) 
Seat 5: Loks95 ($4.76 in chips) 
Seat 6: I_Not_Alone ($14.68 in chips) 
I_Not_Alone: posts small blind $0.05
Spieler977: posts big blind $0.10
*** HOLE CARDS ***
Yellowbaanana: folds 
bawsak17: folds 
baadnewz01: folds 
Loks95: raises $2.50 to $2.60
I_Not_Alone: folds 
Spieler977: folds 
Uncalled bet ($2.50) returned to Loks95
Loks95 collected $0.25 from pot
Loks95: doesn't show hand 
*** SUMMARY ***
Total pot $0.25 | Rake $0 
Seat 1: Spieler977 (big blind) folded before Flop
Seat 2: Yellowbaanana folded before Flop (didn't bet)
Seat 3: bawsak17 folded before Flop (didn't bet)
Seat 4: baadnewz01 folded before Flop (didn't bet)
Seat 5: Loks95 (button) collected ($0.25)
Seat 6: I_Not_Alone (small blind) folded before Flop



PokerStars Hand #222974646585:  Hold'em No Limit ($0.05/$0.10 USD) - 2021/01/23 17:17:29 ET
Table 'Transvaalia' 6-max Seat #6 is the button
Seat 1: Spieler977 ($12.14 in chips) 
Seat 2: Yellowbaanana ($18.25 in chips) 
Seat 3: bawsak17 ($12.01 in chips) 
Seat 4: baadnewz01 ($10.12 in chips) 
Seat 5: Loks95 ($4.91 in chips) 
Seat 6: I_Not_Alone ($14.63 in chips) 
Spieler977: posts small blind $0.05
Yellowbaanana: posts big blind $0.10
*** HOLE CARDS ***
bawsak17: folds 
baadnewz01: folds 
Loks95: calls $0.10
I_Not_Alone: folds 
Spieler977: folds 
Yellowbaanana: checks 
*** FLOP *** [2d Ac Jh]
Yellowbaanana: checks 
Loks95: checks 
*** TURN *** [2d Ac Jh] [Qc]
Yellowbaanana: bets $0.24
Loks95: folds 
Uncalled bet ($0.24) returned to Yellowbaanana
Yellowbaanana collected $0.24 from pot
Yellowbaanana: doesn't show hand 
*** SUMMARY ***
Total pot $0.25 | Rake $0.01 
Board [2d Ac Jh Qc]
Seat 1: Spieler977 (small blind) folded before Flop
Seat 2: Yellowbaanana (big blind) collected ($0.24)
Seat 3: bawsak17 folded before Flop (didn't bet)
Seat 4: baadnewz01 folded before Flop (didn't bet)
Seat 5: Loks95 folded on the Turn
Seat 6: I_Not_Alone (button) folded before Flop (didn't bet)



PokerStars Hand #222974668036:  Hold'em No Limit ($0.05/$0.10 USD) - 2021/01/23 17:17:55 ET
Table 'Transvaalia' 6-max Seat #1 is the button
Seat 1: Spieler977 ($12.09 in chips) 
Seat 2: Yellowbaanana ($18.39 in chips) 
Seat 3: bawsak17 ($12.01 in chips) 
Seat 4: baadnewz01 ($10.12 in chips) 
Seat 5: Loks95 ($4.81 in chips) 
Seat 6: I_Not_Alone ($14.63 in chips) 
Yellowbaanana: posts small blind $0.05
bawsak17: posts big blind $0.10
*** HOLE CARDS ***
baadnewz01: folds 
Loks95: calls $0.10
I_Not_Alone: folds 
Spieler977: folds 
Yellowbaanana: calls $0.05
bawsak17: checks 
*** FLOP *** [Tc Td 2h]
Yellowbaanana: checks 
bawsak17: checks 
Loks95: checks 
*** TURN *** [Tc Td 2h] [8h]
Yellowbaanana: checks 
bawsak17: checks 
Loks95: checks 
*** RIVER *** [Tc Td 2h 8h] [Qc]
Yellowbaanana: checks 
bawsak17: checks 
Loks95: bets $0.29
Yellowbaanana: folds 
bawsak17: folds 
Uncalled bet ($0.29) returned to Loks95
Loks95 collected $0.29 from pot
Loks95: doesn't show hand 
*** SUMMARY ***
Total pot $0.30 | Rake $0.01 
Board [Tc Td 2h 8h Qc]
Seat 1: Spieler977 (button) folded before Flop (didn't bet)
Seat 2: Yellowbaanana (small blind) folded on the River
Seat 3: bawsak17 (big blind) folded on the River
Seat 4: baadnewz01 folded before Flop (didn't bet)
Seat 5: Loks95 collected ($0.29)
Seat 6: I_Not_Alone folded before Flop (didn't bet)



PokerStars Hand #222974717288:  Hold'em No Limit ($0.05/$0.10 USD) - 2021/01/23 17:18:55 ET
Table 'Transvaalia' 6-max Seat #2 is the button
Seat 1: Spieler977 ($12.09 in chips) 
Seat 2: Yellowbaanana ($18.29 in chips) 
Seat 3: bawsak17 ($11.91 in chips) 
Seat 4: baadnewz01 ($10.12 in chips) 
Seat 5: Loks95 ($5 in chips) 
Seat 6: I_Not_Alone ($14.63 in chips) 
bawsak17: posts small blind $0.05
baadnewz01: posts big blind $0.10
*** HOLE CARDS ***
Loks95: raises $0.10 to $0.20
I_Not_Alone: folds 
Spieler977: folds 
Yellowbaanana: calls $0.20
bawsak17: folds 
baadnewz01: folds 
*** FLOP *** [Jd 7d 4c]
Loks95: checks 
Yellowbaanana: checks 
*** TURN *** [Jd 7d 4c] [3h]
Loks95: checks 
Yellowbaanana: checks 
*** RIVER *** [Jd 7d 4c 3h] [8h]
Loks95: bets $0.10
Yellowbaanana: calls $0.10
*** SHOW DOWN ***
Loks95: shows [Ac 8s] (a pair of Eights)
Yellowbaanana: mucks hand 
Loks95 collected $0.72 from pot
*** SUMMARY ***
Total pot $0.75 | Rake $0.03 
Board [Jd 7d 4c 3h 8h]
Seat 1: Spieler977 folded before Flop (didn't bet)
Seat 2: Yellowbaanana (button) mucked
Seat 3: bawsak17 (small blind) folded before Flop
Seat 4: baadnewz01 (big blind) folded before Flop
Seat 5: Loks95 showed [Ac 8s] and won ($0.72) with a pair of Eights
Seat 6: I_Not_Alone folded before Flop (didn't bet)



PokerStars Hand #222974742028:  Hold'em No Limit ($0.05/$0.10 USD) - 2021/01/23 17:19:25 ET
Table 'Transvaalia' 6-max Seat #3 is the button
Seat 1: Spieler977 ($12.09 in chips) 
Seat 2: Yellowbaanana ($17.99 in chips) 
Seat 3: bawsak17 ($11.86 in chips) 
Seat 4: baadnewz01 ($10.02 in chips) 
Seat 5: Loks95 ($5.42 in chips) 
Seat 6: I_Not_Alone ($14.63 in chips) 
baadnewz01: posts small blind $0.05
Loks95: posts big blind $0.10
*** HOLE CARDS ***
I_Not_Alone: folds 
Spieler977: raises $0.20 to $0.30
Yellowbaanana: folds 
bawsak17: folds 
baadnewz01: folds 
Loks95: calls $0.20
*** FLOP *** [Qc 7s 8s]
Loks95: checks 
Spieler977: bets $0.47
Loks95: calls $0.47
*** TURN *** [Qc 7s 8s] [4d]
Loks95: checks 
Spieler977: bets $1.14
Loks95: calls $1.14
*** RIVER *** [Qc 7s 8s 4d] [Kc]
Loks95: bets $3.51 and is all-in
Spieler977: folds 
Uncalled bet ($3.51) returned to Loks95
Loks95 collected $3.70 from pot
Loks95: doesn't show hand 
*** SUMMARY ***
Total pot $3.87 | Rake $0.17 
Board [Qc 7s 8s 4d Kc]
Seat 1: Spieler977 folded on the River
Seat 2: Yellowbaanana folded before Flop (didn't bet)
Seat 3: bawsak17 (button) folded before Flop (didn't bet)
Seat 4: baadnewz01 (small blind) folded before Flop
Seat 5: Loks95 (big blind) collected ($3.70)
Seat 6: I_Not_Alone folded before Flop (didn't bet)



PokerStars Hand #222974779061:  Hold'em No Limit ($0.05/$0.10 USD) - 2021/01/23 17:20:10 ET
Table 'Transvaalia' 6-max Seat #4 is the button
Seat 1: Spieler977 ($10.18 in chips) 
Seat 2: Yellowbaanana ($17.99 in chips) 
Seat 3: bawsak17 ($11.86 in chips) 
Seat 4: baadnewz01 ($10 in chips) 
Seat 5: Loks95 ($7.21 in chips) 
Seat 6: I_Not_Alone ($14.63 in chips) 
Loks95: posts small blind $0.05
I_Not_Alone: posts big blind $0.10
*** HOLE CARDS ***
Spieler977: folds 
Yellowbaanana: calls $0.10
bawsak17: folds 
baadnewz01: folds 
Loks95: folds 
I_Not_Alone: checks 
*** FLOP *** [9s Kh Qd]
I_Not_Alone: checks 
Yellowbaanana: checks 
*** TURN *** [9s Kh Qd] [Qs]
I_Not_Alone: checks 
Yellowbaanana: checks 
*** RIVER *** [9s Kh Qd Qs] [3c]
I_Not_Alone: checks 
Yellowbaanana: checks 
*** SHOW DOWN ***
I_Not_Alone: shows [9d 8c] (two pair, Queens and Nines)
Yellowbaanana: mucks hand 
I_Not_Alone collected $0.24 from pot
*** SUMMARY ***
Total pot $0.25 | Rake $0.01 
Board [9s Kh Qd Qs 3c]
Seat 1: Spieler977 folded before Flop (didn't bet)
Seat 2: Yellowbaanana mucked
Seat 3: bawsak17 folded before Flop (didn't bet)
Seat 4: baadnewz01 (button) folded before Flop (didn't bet)
Seat 5: Loks95 (small blind) folded before Flop
Seat 6: I_Not_Alone (big blind) showed [9d 8c] and won ($0.24) with two pair, Queens and Nines



PokerStars Hand #222974807332:  Hold'em No Limit ($0.05/$0.10 USD) - 2021/01/23 17:20:45 ET
Table 'Transvaalia' 6-max Seat #5 is the button
Seat 1: Spieler977 ($10.18 in chips) 
Seat 2: Yellowbaanana ($17.89 in chips) 
Seat 3: bawsak17 ($11.86 in chips) 
Seat 4: baadnewz01 ($10 in chips) 
Seat 5: Loks95 ($7.16 in chips) 
Seat 6: I_Not_Alone ($14.77 in chips) 
I_Not_Alone: posts small blind $0.05
Spieler977: posts big blind $0.10
*** HOLE CARDS ***
Yellowbaanana: folds 
bawsak17: raises $0.15 to $0.25
baadnewz01: folds 
Loks95: raises $0.15 to $0.40
I_Not_Alone: folds 
Spieler977: calls $0.30
bawsak17: calls $0.15
*** FLOP *** [Ks Kh Tc]
Spieler977: checks 
bawsak17: checks 
Loks95: bets $1.19
Spieler977: folds 
bawsak17: folds 
Uncalled bet ($1.19) returned to Loks95
Loks95 collected $1.19 from pot
Loks95: doesn't show hand 
*** SUMMARY ***
Total pot $1.25 | Rake $0.06 
Board [Ks Kh Tc]
Seat 1: Spieler977 (big blind) folded on the Flop
Seat 2: Yellowbaanana folded before Flop (didn't bet)
Seat 3: bawsak17 folded on the Flop
Seat 4: baadnewz01 folded before Flop (didn't bet)
Seat 5: Loks95 (button) collected ($1.19)
Seat 6: I_Not_Alone (small blind) folded before Flop



PokerStars Hand #222974870704:  Hold'em No Limit ($0.05/$0.10 USD) - 2021/01/23 17:22:03 ET
Table 'Transvaalia' 6-max Seat #6 is the button
Seat 1: Spieler977 ($10 in chips) 
Seat 2: Yellowbaanana ($17.89 in chips) 
Seat 3: bawsak17 ($11.46 in chips) 
Seat 4: baadnewz01 ($10 in chips) 
Seat 5: Loks95 ($7.95 in chips) 
Seat 6: I_Not_Alone ($14.72 in chips) 
Spieler977: posts small blind $0.05
Yellowbaanana: posts big blind $0.10
*** HOLE CARDS ***
bawsak17: folds 
baadnewz01: folds 
Loks95: calls $0.10
I_Not_Alone: raises $0.20 to $0.30
Spieler977: folds 
Yellowbaanana: folds 
Loks95: calls $0.20
*** FLOP *** [Kc 8h Qh]
Loks95: checks 
I_Not_Alone: checks 
*** TURN *** [Kc 8h Qh] [Th]
Loks95: checks 
I_Not_Alone: bets $0.22
Loks95: folds 
Uncalled bet ($0.22) returned to I_Not_Alone
I_Not_Alone collected $0.72 from pot
I_Not_Alone: doesn't show hand 
*** SUMMARY ***
Total pot $0.75 | Rake $0.03 
Board [Kc 8h Qh Th]
Seat 1: Spieler977 (small blind) folded before Flop
Seat 2: Yellowbaanana (big blind) folded before Flop
Seat 3: bawsak17 folded before Flop (didn't bet)
Seat 4: baadnewz01 folded before Flop (didn't bet)
Seat 5: Loks95 folded on the Turn
Seat 6: I_Not_Alone (button) collected ($0.72)



PokerStars Hand #222974911346:  Hold'em No Limit ($0.05/$0.10 USD) - 2021/01/23 17:22:53 ET
Table 'Transvaalia' 6-max Seat #1 is the button
Seat 1: Spieler977 ($10 in chips) 
Seat 2: Yellowbaanana ($17.79 in chips) 
Seat 3: bawsak17 ($11.46 in chips) 
Seat 4: baadnewz01 ($10 in chips) 
Seat 5: Loks95 ($7.65 in chips) 
Seat 6: I_Not_Alone ($15.14 in chips) 
Yellowbaanana: posts small blind $0.05
bawsak17: posts big blind $0.10
*** HOLE CARDS ***
baadnewz01: folds 
Loks95: calls $0.10
I_Not_Alone: folds 
Spieler977: raises $0.30 to $0.40
Yellowbaanana: folds 
bawsak17: folds 
Loks95: raises $0.30 to $0.70
Spieler977: calls $0.30
*** FLOP *** [7s 2s Ts]
Loks95: bets $1.48
Spieler977: folds 
Uncalled bet ($1.48) returned to Loks95
Loks95 collected $1.48 from pot
Loks95: doesn't show hand 
*** SUMMARY ***
Total pot $1.55 | Rake $0.07 
Board [7s 2s Ts]
Seat 1: Spieler977 (button) folded on the Flop
Seat 2: Yellowbaanana (small blind) folded before Flop
Seat 3: bawsak17 (big blind) folded before Flop
Seat 4: baadnewz01 folded before Flop (didn't bet)
Seat 5: Loks95 collected ($1.48)
Seat 6: I_Not_Alone folded before Flop (didn't bet)



PokerStars Hand #222974939246:  Hold'em No Limit ($0.05/$0.10 USD) - 2021/01/23 17:23:27 ET
Table 'Transvaalia' 6-max Seat #2 is the button
Seat 1: Spieler977 ($10 in chips) 
Seat 2: Yellowbaanana ($17.74 in chips) 
Seat 3: bawsak17 ($11.36 in chips) 
Seat 4: baadnewz01 ($10 in chips) 
Seat 5: Loks95 ($8.43 in chips) 
Seat 6: I_Not_Alone ($15.14 in chips) 
bawsak17: posts small blind $0.05
baadnewz01: posts big blind $0.10
*** HOLE CARDS ***
Loks95: folds 
I_Not_Alone: folds 
Spieler977: raises $0.20 to $0.30
Yellowbaanana: folds 
bawsak17: folds 
Loks95 leaves the table
baadnewz01: folds 
Uncalled bet ($0.20) returned to Spieler977
Spieler977 collected $0.25 from pot
Spieler977: doesn't show hand 
*** SUMMARY ***
Total pot $0.25 | Rake $0 
Seat 1: Spieler977 collected ($0.25)
Seat 2: Yellowbaanana (button) folded before Flop (didn't bet)
Seat 3: bawsak17 (small blind) folded before Flop
Seat 4: baadnewz01 (big blind) folded before Flop
Seat 5: Loks95 folded before Flop (didn't bet)
Seat 6: I_Not_Alone folded before Flop (didn't bet)



PokerStars Hand #222974968206:  Hold'em No Limit ($0.05/$0.10 USD) - 2021/01/23 17:24:03 ET
Table 'Transvaalia' 6-max Seat #3 is the button
Seat 1: Spieler977 ($10.15 in chips) 
Seat 2: Yellowbaanana ($17.74 in chips) 
Seat 3: bawsak17 ($11.31 in chips) 
Seat 4: baadnewz01 ($10 in chips) 
Seat 6: I_Not_Alone ($15.14 in chips) 
baadnewz01: posts small blind $0.05
I_Not_Alone: posts big blind $0.10
*** HOLE CARDS ***
Spieler977: folds 
dancayamanda joins the table at seat #5 
Yellowbaanana has timed out
Yellowbaanana: folds 
bawsak17: raises $0.15 to $0.25
baadnewz01: raises $0.75 to $1
I_Not_Alone: folds 
bawsak17: calls $0.75
*** FLOP *** [2c Kc 3h]
baadnewz01: bets $1
bawsak17: folds 
Uncalled bet ($1) returned to baadnewz01
baadnewz01 collected $2.01 from pot
baadnewz01: doesn't show hand 
*** SUMMARY ***
Total pot $2.10 | Rake $0.09 
Board [2c Kc 3h]
Seat 1: Spieler977 folded before Flop (didn't bet)
Seat 2: Yellowbaanana folded before Flop (didn't bet)
Seat 3: bawsak17 (button) folded on the Flop
Seat 4: baadnewz01 (small blind) collected ($2.01)
Seat 6: I_Not_Alone (big blind) folded before Flop



PokerStars Hand #222975013509:  Hold'em No Limit ($0.05/$0.10 USD) - 2021/01/23 17:25:00 ET
Table 'Transvaalia' 6-max Seat #4 is the button
Seat 1: Spieler977 ($10.15 in chips) 
Seat 2: Yellowbaanana ($17.74 in chips) 
Seat 3: bawsak17 ($10.31 in chips) 
Seat 4: baadnewz01 ($11.01 in chips) 
Seat 6: I_Not_Alone ($15.04 in chips) 
I_Not_Alone: posts small blind $0.05
Spieler977: posts big blind $0.10
*** HOLE CARDS ***
Yellowbaanana: folds 
bawsak17: folds 
baadnewz01: raises $0.20 to $0.30
I_Not_Alone: folds 
Spieler977: folds 
Uncalled bet ($0.20) returned to baadnewz01
baadnewz01 collected $0.25 from pot
baadnewz01: doesn't show hand 
*** SUMMARY ***
Total pot $0.25 | Rake $0 
Seat 1: Spieler977 (big blind) folded before Flop
Seat 2: Yellowbaanana folded before Flop (didn't bet)
Seat 3: bawsak17 folded before Flop (didn't bet)
Seat 4: baadnewz01 (button) collected ($0.25)
Seat 6: I_Not_Alone (small blind) folded before Flop



PokerStars Hand #222975029340:  Hold'em No Limit ($0.05/$0.10 USD) - 2021/01/23 17:25:19 ET
Table 'Transvaalia' 6-max Seat #6 is the button
Seat 1: Spieler977 ($10.05 in chips) 
Seat 2: Yellowbaanana ($17.74 in chips) 
Seat 3: bawsak17 ($10.31 in chips) 
Seat 4: baadnewz01 ($11.16 in chips) 
Seat 6: I_Not_Alone ($14.99 in chips) 
Spieler977: posts small blind $0.05
Yellowbaanana: posts big blind $0.10
dancayamanda: sits out 
*** HOLE CARDS ***
bawsak17: folds 
baadnewz01: folds 
I_Not_Alone: raises $0.15 to $0.25
Spieler977: folds 
Yellowbaanana: folds 
Uncalled bet ($0.15) returned to I_Not_Alone
I_Not_Alone collected $0.25 from pot
I_Not_Alone: doesn't show hand 
*** SUMMARY ***
Total pot $0.25 | Rake $0 
Seat 1: Spieler977 (small blind) folded before Flop
Seat 2: Yellowbaanana (big blind) folded before Flop
Seat 3: bawsak17 folded before Flop (didn't bet)
Seat 4: baadnewz01 folded before Flop (didn't bet)
Seat 6: I_Not_Alone (button) collected ($0.25)



PokerStars Hand #222975048261:  Hold'em No Limit ($0.05/$0.10 USD) - 2021/01/23 17:25:43 ET
Table 'Transvaalia' 6-max Seat #1 is the button
Seat 1: Spieler977 ($10 in chips) 
Seat 2: Yellowbaanana ($17.64 in chips) 
Seat 4: baadnewz01 ($11.16 in chips) 
Seat 6: I_Not_Alone ($15.14 in chips) 
Yellowbaanana: posts small blind $0.05
bawsak17: is sitting out 
baadnewz01: posts big blind $0.10
dancayamanda: sits out 
*** HOLE CARDS ***
bawsak17 leaves the table
I_Not_Alone: folds 
Spieler977: folds 
Yellowbaanana: calls $0.05
baadnewz01: raises $0.40 to $0.50
Yellowbaanana: folds 
Uncalled bet ($0.40) returned to baadnewz01
baadnewz01 collected $0.20 from pot
baadnewz01: doesn't show hand 
*** SUMMARY ***
Total pot $0.20 | Rake $0 
Seat 1: Spieler977 (button) folded before Flop (didn't bet)
Seat 2: Yellowbaanana (small blind) folded before Flop
Seat 4: baadnewz01 (big blind) collected ($0.20)
Seat 6: I_Not_Alone folded before Flop (didn't bet)



PokerStars Hand #222975066843:  Hold'em No Limit ($0.05/$0.10 USD) - 2021/01/23 17:26:06 ET
Table 'Transvaalia' 6-max Seat #2 is the button
Seat 1: Spieler977 ($10 in chips) 
Seat 2: Yellowbaanana ($17.54 in chips) 
Seat 4: baadnewz01 ($11.26 in chips) 
Seat 5: dancayamanda ($10 in chips) 
Seat 6: I_Not_Alone ($15.14 in chips) 
baadnewz01: posts small blind $0.05
dancayamanda: posts big blind $0.10
*** HOLE CARDS ***
I_Not_Alone: raises $0.15 to $0.25
Spieler977: folds 
nosachkn joins the table at seat #3 
Yellowbaanana: calls $0.25
baadnewz01: folds 
dancayamanda: folds 
*** FLOP *** [5d 7c Qh]
dancayamanda leaves the table
I_Not_Alone: checks 
Yellowbaanana: checks 
*** TURN *** [5d 7c Qh] [6s]
I_Not_Alone: checks 
Yellowbaanana: checks 
*** RIVER *** [5d 7c Qh 6s] [4s]
I_Not_Alone: checks 
Yellowbaanana: checks 
*** SHOW DOWN ***
I_Not_Alone: shows [Td Jd] (high card Queen)
Yellowbaanana: shows [2s 2h] (a pair of Deuces)
Yellowbaanana collected $0.62 from pot
*** SUMMARY ***
Total pot $0.65 | Rake $0.03 
Board [5d 7c Qh 6s 4s]
Seat 1: Spieler977 folded before Flop (didn't bet)
Seat 2: Yellowbaanana (button) showed [2s 2h] and won ($0.62) with a pair of Deuces
Seat 4: baadnewz01 (small blind) folded before Flop
Seat 5: dancayamanda (big blind) folded before Flop
Seat 6: I_Not_Alone showed [Td Jd] and lost with high card Queen



PokerStars Hand #222975100090:  Hold'em No Limit ($0.05/$0.10 USD) - 2021/01/23 17:26:47 ET
Table 'Transvaalia' 6-max Seat #4 is the button
Seat 1: Spieler977 ($10 in chips) 
Seat 2: Yellowbaanana ($17.91 in chips) 
Seat 4: baadnewz01 ($11.21 in chips) 
Seat 6: I_Not_Alone ($14.89 in chips) 
I_Not_Alone: posts small blind $0.05
Spieler977: posts big blind $0.10
nosachkn: sits out 
*** HOLE CARDS ***
Yellowbaanana: folds 
VETUS1 joins the table at seat #5 
baadnewz01: raises $0.20 to $0.30
I_Not_Alone: folds 
Spieler977: folds 
Uncalled bet ($0.20) returned to baadnewz01
baadnewz01 collected $0.25 from pot
baadnewz01: doesn't show hand 
*** SUMMARY ***
Total pot $0.25 | Rake $0 
Seat 1: Spieler977 (big blind) folded before Flop
Seat 2: Yellowbaanana folded before Flop (didn't bet)
Seat 4: baadnewz01 (button) collected ($0.25)
Seat 6: I_Not_Alone (small blind) folded before Flop



PokerStars Hand #222975119014:  Hold'em No Limit ($0.05/$0.10 USD) - 2021/01/23 17:27:11 ET
Table 'Transvaalia' 6-max Seat #6 is the button
Seat 1: Spieler977 ($10 in chips) 
Seat 2: Yellowbaanana ($17.91 in chips) 
Seat 4: baadnewz01 ($11.36 in chips) 
Seat 5: VETUS1 ($8 in chips) 
Seat 6: I_Not_Alone ($14.84 in chips) 
Spieler977: posts small blind $0.05
Yellowbaanana: posts big blind $0.10
nosachkn: sits out 
VETUS1: posts big blind $0.10
*** HOLE CARDS ***
baadnewz01: folds 
VETUS1: checks 
I_Not_Alone: folds 
Spieler977: folds 
Yellowbaanana: checks 
*** FLOP *** [5h Ah 7d]
Yellowbaanana: checks 
VETUS1: checks 
*** TURN *** [5h Ah 7d] [2s]
Yellowbaanana: checks 
VETUS1: checks 
*** RIVER *** [5h Ah 7d 2s] [7h]
Yellowbaanana: checks 
VETUS1: bets $0.10
Yellowbaanana: raises $0.44 to $0.54
VETUS1: folds 
Uncalled bet ($0.44) returned to Yellowbaanana
Yellowbaanana collected $0.43 from pot
*** SUMMARY ***
Total pot $0.45 | Rake $0.02 
Board [5h Ah 7d 2s 7h]
Seat 1: Spieler977 (small blind) folded before Flop
Seat 2: Yellowbaanana (big blind) collected ($0.43)
Seat 4: baadnewz01 folded before Flop (didn't bet)
Seat 5: VETUS1 folded on the River
Seat 6: I_Not_Alone (button) folded before Flop (didn't bet)



PokerStars Hand #222975159699:  Hold'em No Limit ($0.05/$0.10 USD) - 2021/01/23 17:27:58 ET
Table 'Transvaalia' 6-max Seat #1 is the button
Seat 1: Spieler977 ($10 in chips) 
Seat 2: Yellowbaanana ($18.14 in chips) 
Seat 3: nosachkn ($10 in chips) 
Seat 4: baadnewz01 ($11.36 in chips) 
Seat 5: VETUS1 ($7.80 in chips) 
Seat 6: I_Not_Alone ($14.84 in chips) 
Yellowbaanana: posts small blind $0.05
nosachkn: posts big blind $0.10
*** HOLE CARDS ***
baadnewz01: folds 
VETUS1: folds 
I_Not_Alone: folds 
Spieler977: folds 
Yellowbaanana: calls $0.05
nosachkn: raises $0.30 to $0.40
Yellowbaanana: folds 
Uncalled bet ($0.30) returned to nosachkn
nosachkn collected $0.20 from pot
nosachkn: doesn't show hand 
*** SUMMARY ***
Total pot $0.20 | Rake $0 
Seat 1: Spieler977 (button) folded before Flop (didn't bet)
Seat 2: Yellowbaanana (small blind) folded before Flop
Seat 3: nosachkn (big blind) collected ($0.20)
Seat 4: baadnewz01 folded before Flop (didn't bet)
Seat 5: VETUS1 folded before Flop (didn't bet)
Seat 6: I_Not_Alone folded before Flop (didn't bet)



PokerStars Hand #222975187024:  Hold'em No Limit ($0.05/$0.10 USD) - 2021/01/23 17:28:33 ET
Table 'Transvaalia' 6-max Seat #2 is the button
Seat 1: Spieler977 ($10 in chips) 
Seat 2: Yellowbaanana ($18.04 in chips) 
Seat 3: nosachkn ($10.10 in chips) 
Seat 4: baadnewz01 ($11.36 in chips) 
Seat 5: VETUS1 ($7.80 in chips) 
Seat 6: I_Not_Alone ($14.84 in chips) 
nosachkn: posts small blind $0.05
baadnewz01: posts big blind $0.10
*** HOLE CARDS ***
VETUS1: folds 
I_Not_Alone: folds 
Spieler977: raises $0.20 to $0.30
Yellowbaanana has timed out
Yellowbaanana: folds 
nosachkn: folds 
baadnewz01: calls $0.20
*** FLOP *** [5d 9h Tc]
baadnewz01: checks 
Spieler977: checks 
*** TURN *** [5d 9h Tc] [5c]
baadnewz01: bets $0.30
Spieler977: folds 
Uncalled bet ($0.30) returned to baadnewz01
baadnewz01 collected $0.62 from pot
baadnewz01: doesn't show hand 
*** SUMMARY ***
Total pot $0.65 | Rake $0.03 
Board [5d 9h Tc 5c]
Seat 1: Spieler977 folded on the Turn
Seat 2: Yellowbaanana (button) folded before Flop (didn't bet)
Seat 3: nosachkn (small blind) folded before Flop
Seat 4: baadnewz01 (big blind) collected ($0.62)
Seat 5: VETUS1 folded before Flop (didn't bet)
Seat 6: I_Not_Alone folded before Flop (didn't bet)



PokerStars Hand #222975228561:  Hold'em No Limit ($0.05/$0.10 USD) - 2021/01/23 17:29:25 ET
Table 'Transvaalia' 6-max Seat #3 is the button
Seat 1: Spieler977 ($10 in chips) 
Seat 2: Yellowbaanana ($18.04 in chips) 
Seat 3: nosachkn ($10.05 in chips) 
Seat 4: baadnewz01 ($11.68 in chips) 
Seat 5: VETUS1 ($7.80 in chips) 
Seat 6: I_Not_Alone ($14.84 in chips) 
baadnewz01: posts small blind $0.05
VETUS1: posts big blind $0.10
*** HOLE CARDS ***
I_Not_Alone: folds 
Spieler977: folds 
Yellowbaanana: folds 
nosachkn: raises $0.10 to $0.20
baadnewz01: folds 
VETUS1: calls $0.10
*** FLOP *** [9d Kd Ks]
VETUS1: checks 
nosachkn: bets $0.22
VETUS1: folds 
Uncalled bet ($0.22) returned to nosachkn
nosachkn collected $0.43 from pot
nosachkn: doesn't show hand 
*** SUMMARY ***
Total pot $0.45 | Rake $0.02 
Board [9d Kd Ks]
Seat 1: Spieler977 folded before Flop (didn't bet)
Seat 2: Yellowbaanana folded before Flop (didn't bet)
Seat 3: nosachkn (button) collected ($0.43)
Seat 4: baadnewz01 (small blind) folded before Flop
Seat 5: VETUS1 (big blind) folded on the Flop
Seat 6: I_Not_Alone folded before Flop (didn't bet)



PokerStars Hand #222975248847:  Hold'em No Limit ($0.05/$0.10 USD) - 2021/01/23 17:29:50 ET
Table 'Transvaalia' 6-max Seat #4 is the button
Seat 1: Spieler977 ($10 in chips) 
Seat 2: Yellowbaanana ($18.04 in chips) 
Seat 3: nosachkn ($10.28 in chips) 
Seat 4: baadnewz01 ($11.63 in chips) 
Seat 5: VETUS1 ($7.60 in chips) 
Seat 6: I_Not_Alone ($14.84 in chips) 
VETUS1: posts small blind $0.05
I_Not_Alone: posts big blind $0.10
*** HOLE CARDS ***
Spieler977: folds 
Yellowbaanana: calls $0.10
nosachkn: folds 
baadnewz01: raises $0.40 to $0.50
VETUS1: folds 
I_Not_Alone: folds 
Yellowbaanana: folds 
Uncalled bet ($0.40) returned to baadnewz01
baadnewz01 collected $0.35 from pot
baadnewz01: doesn't show hand 
*** SUMMARY ***
Total pot $0.35 | Rake $0 
Seat 1: Spieler977 folded before Flop (didn't bet)
Seat 2: Yellowbaanana folded before Flop
Seat 3: nosachkn folded before Flop (didn't bet)
Seat 4: baadnewz01 (button) collected ($0.35)
Seat 5: VETUS1 (small blind) folded before Flop
Seat 6: I_Not_Alone (big blind) folded before Flop



PokerStars Hand #222975264619:  Hold'em No Limit ($0.05/$0.10 USD) - 2021/01/23 17:30:10 ET
Table 'Transvaalia' 6-max Seat #5 is the button
Seat 1: Spieler977 ($10 in chips) 
Seat 2: Yellowbaanana ($17.94 in chips) 
Seat 3: nosachkn ($10.28 in chips) 
Seat 4: baadnewz01 ($11.88 in chips) 
Seat 5: VETUS1 ($7.55 in chips) 
Seat 6: I_Not_Alone ($14.74 in chips) 
I_Not_Alone: posts small blind $0.05
Spieler977: posts big blind $0.10
*** HOLE CARDS ***
Yellowbaanana has timed out
Yellowbaanana: folds 
nosachkn: folds 
baadnewz01: folds 
VETUS1: folds 
I_Not_Alone: folds 
Uncalled bet ($0.05) returned to Spieler977
Spieler977 collected $0.10 from pot
Spieler977: doesn't show hand 
*** SUMMARY ***
Total pot $0.10 | Rake $0 
Seat 1: Spieler977 (big blind) collected ($0.10)
Seat 2: Yellowbaanana folded before Flop (didn't bet)
Seat 3: nosachkn folded before Flop (didn't bet)
Seat 4: baadnewz01 folded before Flop (didn't bet)
Seat 5: VETUS1 (button) folded before Flop (didn't bet)
Seat 6: I_Not_Alone (small blind) folded before Flop



PokerStars Hand #222975283750:  Hold'em No Limit ($0.05/$0.10 USD) - 2021/01/23 17:30:34 ET
Table 'Transvaalia' 6-max Seat #6 is the button
Seat 1: Spieler977 ($10.05 in chips) 
Seat 2: Yellowbaanana ($17.94 in chips) 
Seat 3: nosachkn ($10.28 in chips) 
Seat 4: baadnewz01 ($11.88 in chips) 
Seat 5: VETUS1 ($7.55 in chips) 
Seat 6: I_Not_Alone ($14.69 in chips) 
Spieler977: posts small blind $0.05
Yellowbaanana: posts big blind $0.10
*** HOLE CARDS ***
nosachkn: folds 
baadnewz01: raises $0.20 to $0.30
VETUS1: calls $0.30
I_Not_Alone: folds 
Spieler977: folds 
Yellowbaanana: folds 
*** FLOP *** [6d 6h 2s]
baadnewz01: bets $0.30
VETUS1: calls $0.30
*** TURN *** [6d 6h 2s] [7s]
baadnewz01: bets $0.60
VETUS1: calls $0.60
*** RIVER *** [6d 6h 2s 7s] [6s]
baadnewz01: bets $1.20
VETUS1: raises $1.20 to $2.40
baadnewz01: calls $1.20
*** SHOW DOWN ***
VETUS1: shows [Td As] (three of a kind, Sixes)
baadnewz01: shows [Ks Kd] (a full house, Sixes full of Kings)
baadnewz01 collected $7.02 from pot
*** SUMMARY ***
Total pot $7.35 | Rake $0.33 
Board [6d 6h 2s 7s 6s]
Seat 1: Spieler977 (small blind) folded before Flop
Seat 2: Yellowbaanana (big blind) folded before Flop
Seat 3: nosachkn folded before Flop (didn't bet)
Seat 4: baadnewz01 showed [Ks Kd] and won ($7.02) with a full house, Sixes full of Kings
Seat 5: VETUS1 showed [Td As] and lost with three of a kind, Sixes
Seat 6: I_Not_Alone (button) folded before Flop (didn't bet)



PokerStars Hand #222975355828:  Hold'em No Limit ($0.05/$0.10 USD) - 2021/01/23 17:32:06 ET
Table 'Transvaalia' 6-max Seat #1 is the button
Seat 1: Spieler977 ($10 in chips) 
Seat 2: Yellowbaanana ($17.84 in chips) 
Seat 3: nosachkn ($10.28 in chips) 
Seat 4: baadnewz01 ($15.30 in chips) 
Seat 5: VETUS1 ($3.95 in chips) 
Seat 6: I_Not_Alone ($14.69 in chips) 
Yellowbaanana: posts small blind $0.05
nosachkn: posts big blind $0.10
*** HOLE CARDS ***
baadnewz01: folds 
VETUS1: folds 
I_Not_Alone: folds 
Spieler977: folds 
Yellowbaanana: folds 
Uncalled bet ($0.05) returned to nosachkn
nosachkn collected $0.10 from pot
nosachkn: doesn't show hand 
*** SUMMARY ***
Total pot $0.10 | Rake $0 
Seat 1: Spieler977 (button) folded before Flop (didn't bet)
Seat 2: Yellowbaanana (small blind) folded before Flop
Seat 3: nosachkn (big blind) collected ($0.10)
Seat 4: baadnewz01 folded before Flop (didn't bet)
Seat 5: VETUS1 folded before Flop (didn't bet)
Seat 6: I_Not_Alone folded before Flop (didn't bet)



PokerStars Hand #222975369280:  Hold'em No Limit ($0.05/$0.10 USD) - 2021/01/23 17:32:23 ET
Table 'Transvaalia' 6-max Seat #2 is the button
Seat 1: Spieler977 ($10 in chips) 
Seat 2: Yellowbaanana ($17.79 in chips) 
Seat 3: nosachkn ($10.33 in chips) 
Seat 4: baadnewz01 ($15.30 in chips) 
Seat 5: VETUS1 ($3.95 in chips) 
Seat 6: I_Not_Alone ($14.69 in chips) 
nosachkn: posts small blind $0.05
baadnewz01: posts big blind $0.10
*** HOLE CARDS ***
VETUS1: folds 
I_Not_Alone: folds 
Spieler977: folds 
Yellowbaanana: calls $0.10
nosachkn: folds 
baadnewz01: checks 
*** FLOP *** [Jh 2h As]
baadnewz01: checks 
Yellowbaanana: checks 
*** TURN *** [Jh 2h As] [Ks]
baadnewz01: checks 
Yellowbaanana: checks 
*** RIVER *** [Jh 2h As Ks] [9d]
baadnewz01: checks 
Yellowbaanana: checks 
*** SHOW DOWN ***
baadnewz01: shows [8s 9c] (a pair of Nines)
Yellowbaanana: mucks hand 
baadnewz01 collected $0.24 from pot
*** SUMMARY ***
Total pot $0.25 | Rake $0.01 
Board [Jh 2h As Ks 9d]
Seat 1: Spieler977 folded before Flop (didn't bet)
Seat 2: Yellowbaanana (button) mucked
Seat 3: nosachkn (small blind) folded before Flop
Seat 4: baadnewz01 (big blind) showed [8s 9c] and won ($0.24) with a pair of Nines
Seat 5: VETUS1 folded before Flop (didn't bet)
Seat 6: I_Not_Alone folded before Flop (didn't bet)



PokerStars Hand #222975403666:  Hold'em No Limit ($0.05/$0.10 USD) - 2021/01/23 17:33:07 ET
Table 'Transvaalia' 6-max Seat #3 is the button
Seat 1: Spieler977 ($10 in chips) 
Seat 2: Yellowbaanana ($17.69 in chips) 
Seat 3: nosachkn ($10.28 in chips) 
Seat 4: baadnewz01 ($15.44 in chips) 
Seat 5: VETUS1 ($3.95 in chips) 
Seat 6: I_Not_Alone ($14.69 in chips) 
baadnewz01: posts small blind $0.05
VETUS1: posts big blind $0.10
*** HOLE CARDS ***
I_Not_Alone: raises $0.15 to $0.25
Spieler977: folds 
Yellowbaanana: folds 
nosachkn: folds 
baadnewz01: folds 
VETUS1: folds 
Uncalled bet ($0.15) returned to I_Not_Alone
I_Not_Alone collected $0.25 from pot
I_Not_Alone: doesn't show hand 
*** SUMMARY ***
Total pot $0.25 | Rake $0 
Seat 1: Spieler977 folded before Flop (didn't bet)
Seat 2: Yellowbaanana folded before Flop (didn't bet)
Seat 3: nosachkn (button) folded before Flop (didn't bet)
Seat 4: baadnewz01 (small blind) folded before Flop
Seat 5: VETUS1 (big blind) folded before Flop
Seat 6: I_Not_Alone collected ($0.25)



PokerStars Hand #222975421334:  Hold'em No Limit ($0.05/$0.10 USD) - 2021/01/23 17:33:29 ET
Table 'Transvaalia' 6-max Seat #4 is the button
Seat 1: Spieler977 ($10 in chips) 
Seat 2: Yellowbaanana ($17.69 in chips) 
Seat 3: nosachkn ($10.28 in chips) 
Seat 4: baadnewz01 ($15.39 in chips) 
Seat 5: VETUS1 ($3.85 in chips) 
Seat 6: I_Not_Alone ($14.84 in chips) 
VETUS1: posts small blind $0.05
I_Not_Alone: posts big blind $0.10
*** HOLE CARDS ***
Spieler977: folds 
Yellowbaanana: calls $0.10
nosachkn: folds 
baadnewz01: folds 
VETUS1: calls $0.05
I_Not_Alone: checks 
*** FLOP *** [3h 8c 7c]
VETUS1: checks 
I_Not_Alone: checks 
Yellowbaanana: bets $0.29
VETUS1: calls $0.29
I_Not_Alone: folds 
*** TURN *** [3h 8c 7c] [Ad]
VETUS1: checks 
Yellowbaanana: bets $0.84
VETUS1: folds 
Uncalled bet ($0.84) returned to Yellowbaanana
Yellowbaanana collected $0.84 from pot
Yellowbaanana: doesn't show hand 
*** SUMMARY ***
Total pot $0.88 | Rake $0.04 
Board [3h 8c 7c Ad]
Seat 1: Spieler977 folded before Flop (didn't bet)
Seat 2: Yellowbaanana collected ($0.84)
Seat 3: nosachkn folded before Flop (didn't bet)
Seat 4: baadnewz01 (button) folded before Flop (didn't bet)
Seat 5: VETUS1 (small blind) folded on the Turn
Seat 6: I_Not_Alone (big blind) folded on the Flop



PokerStars Hand #222975469884:  Hold'em No Limit ($0.05/$0.10 USD) - 2021/01/23 17:34:31 ET
Table 'Transvaalia' 6-max Seat #5 is the button
Seat 1: Spieler977 ($10 in chips) 
Seat 2: Yellowbaanana ($18.14 in chips) 
Seat 3: nosachkn ($10.28 in chips) 
Seat 4: baadnewz01 ($15.39 in chips) 
Seat 5: VETUS1 ($3.46 in chips) 
Seat 6: I_Not_Alone ($14.74 in chips) 
I_Not_Alone: posts small blind $0.05
Spieler977: posts big blind $0.10
*** HOLE CARDS ***
Yellowbaanana: calls $0.10
nosachkn: raises $0.30 to $0.40
baadnewz01: folds 
VETUS1: calls $0.40
I_Not_Alone: folds 
Spieler977: folds 
Yellowbaanana: folds 
*** FLOP *** [5d Qc 6s]
nosachkn: checks 
VETUS1: checks 
*** TURN *** [5d Qc 6s] [2c]
nosachkn: checks 
VETUS1: checks 
*** RIVER *** [5d Qc 6s 2c] [5h]
nosachkn: checks 
VETUS1: checks 
*** SHOW DOWN ***
nosachkn: shows [3d 3h] (two pair, Fives and Threes)
VETUS1: mucks hand 
nosachkn collected $1 from pot
*** SUMMARY ***
Total pot $1.05 | Rake $0.05 
Board [5d Qc 6s 2c 5h]
Seat 1: Spieler977 (big blind) folded before Flop
Seat 2: Yellowbaanana folded before Flop
Seat 3: nosachkn showed [3d 3h] and won ($1) with two pair, Fives and Threes
Seat 4: baadnewz01 folded before Flop (didn't bet)
Seat 5: VETUS1 (button) mucked
Seat 6: I_Not_Alone (small blind) folded before Flop



PokerStars Hand #222975510519:  Hold'em No Limit ($0.05/$0.10 USD) - 2021/01/23 17:35:10 ET
Table 'Transvaalia' 6-max Seat #6 is the button
Seat 1: Spieler977 ($10 in chips) 
Seat 2: Yellowbaanana ($18.04 in chips) 
Seat 3: nosachkn ($10.88 in chips) 
Seat 4: baadnewz01 ($15.39 in chips) 
Seat 5: VETUS1 ($3.06 in chips) 
Seat 6: I_Not_Alone ($14.69 in chips) 
Spieler977: posts small blind $0.05
Yellowbaanana: posts big blind $0.10
*** HOLE CARDS ***
nosachkn: folds 
baadnewz01: raises $0.20 to $0.30
VETUS1: folds 
I_Not_Alone: folds 
Spieler977: folds 
Yellowbaanana: folds 
Uncalled bet ($0.20) returned to baadnewz01
baadnewz01 collected $0.25 from pot
baadnewz01: doesn't show hand 
*** SUMMARY ***
Total pot $0.25 | Rake $0 
Seat 1: Spieler977 (small blind) folded before Flop
Seat 2: Yellowbaanana (big blind) folded before Flop
Seat 3: nosachkn folded before Flop (didn't bet)
Seat 4: baadnewz01 collected ($0.25)
Seat 5: VETUS1 folded before Flop (didn't bet)
Seat 6: I_Not_Alone (button) folded before Flop (didn't bet)



PokerStars Hand #222975541467:  Hold'em No Limit ($0.05/$0.10 USD) - 2021/01/23 17:35:50 ET
Table 'Transvaalia' 6-max Seat #1 is the button
Seat 1: Spieler977 ($10 in chips) 
Seat 2: Yellowbaanana ($17.94 in chips) 
Seat 3: nosachkn ($10.88 in chips) 
Seat 4: baadnewz01 ($15.54 in chips) 
Seat 5: VETUS1 ($3.06 in chips) 
Seat 6: I_Not_Alone ($14.69 in chips) 
Yellowbaanana: posts small blind $0.05
nosachkn: posts big blind $0.10
*** HOLE CARDS ***
baadnewz01: folds 
VETUS1: raises $0.35 to $0.45
I_Not_Alone: folds 
Spieler977: folds 
Yellowbaanana: calls $0.40
nosachkn: folds 
*** FLOP *** [Jd 4d 9c]
Yellowbaanana: checks 
VETUS1: bets $0.96
Yellowbaanana: folds 
Uncalled bet ($0.96) returned to VETUS1
VETUS1 collected $0.96 from pot
VETUS1: doesn't show hand 
*** SUMMARY ***
Total pot $1 | Rake $0.04 
Board [Jd 4d 9c]
Seat 1: Spieler977 (button) folded before Flop (didn't bet)
Seat 2: Yellowbaanana (small blind) folded on the Flop
Seat 3: nosachkn (big blind) folded before Flop
Seat 4: baadnewz01 folded before Flop (didn't bet)
Seat 5: VETUS1 collected ($0.96)
Seat 6: I_Not_Alone folded before Flop (didn't bet)



PokerStars Hand #222975562295:  Hold'em No Limit ($0.05/$0.10 USD) - 2021/01/23 17:36:17 ET
Table 'Transvaalia' 6-max Seat #2 is the button
Seat 1: Spieler977 ($10 in chips) 
Seat 2: Yellowbaanana ($17.49 in chips) 
Seat 3: nosachkn ($10.78 in chips) 
Seat 4: baadnewz01 ($15.54 in chips) 
Seat 5: VETUS1 ($3.57 in chips) 
Seat 6: I_Not_Alone ($14.69 in chips) 
nosachkn: posts small blind $0.05
baadnewz01: posts big blind $0.10
*** HOLE CARDS ***
VETUS1: folds 
I_Not_Alone: folds 
Spieler977: folds 
Yellowbaanana: calls $0.10
nosachkn: calls $0.05
baadnewz01: checks 
*** FLOP *** [Jh 4c 8h]
nosachkn: checks 
baadnewz01: checks 
Yellowbaanana: checks 
*** TURN *** [Jh 4c 8h] [Ah]
nosachkn: bets $0.15
baadnewz01: folds 
Yellowbaanana: folds 
Uncalled bet ($0.15) returned to nosachkn
nosachkn collected $0.29 from pot
nosachkn: doesn't show hand 
*** SUMMARY ***
Total pot $0.30 | Rake $0.01 
Board [Jh 4c 8h Ah]
Seat 1: Spieler977 folded before Flop (didn't bet)
Seat 2: Yellowbaanana (button) folded on the Turn
Seat 3: nosachkn (small blind) collected ($0.29)
Seat 4: baadnewz01 (big blind) folded on the Turn
Seat 5: VETUS1 folded before Flop (didn't bet)
Seat 6: I_Not_Alone folded before Flop (didn't bet)



PokerStars Hand #222975611241:  Hold'em No Limit ($0.05/$0.10 USD) - 2021/01/23 17:37:21 ET
Table 'Transvaalia' 6-max Seat #3 is the button
Seat 1: Spieler977 ($10 in chips) 
Seat 2: Yellowbaanana ($17.39 in chips) 
Seat 3: nosachkn ($10.97 in chips) 
Seat 4: baadnewz01 ($15.44 in chips) 
Seat 5: VETUS1 ($3.57 in chips) 
Seat 6: I_Not_Alone ($14.69 in chips) 
baadnewz01: posts small blind $0.05
VETUS1: posts big blind $0.10
*** HOLE CARDS ***
I_Not_Alone: folds 
Spieler977: folds 
Yellowbaanana: calls $0.10
nosachkn: folds 
baadnewz01: folds 
VETUS1: raises $0.25 to $0.35
Yellowbaanana: calls $0.25
*** FLOP *** [Ts Jd 6d]
VETUS1: bets $0.36
Yellowbaanana: raises $1.44 to $1.80
VETUS1: raises $1.42 to $3.22 and is all-in
Yellowbaanana: calls $1.42
*** TURN *** [Ts Jd 6d] [Js]
*** RIVER *** [Ts Jd 6d Js] [2h]
*** SHOW DOWN ***
VETUS1: shows [Ah Qc] (a pair of Jacks)
Yellowbaanana: shows [Kd Jh] (three of a kind, Jacks)
Yellowbaanana collected $6.87 from pot
*** SUMMARY ***
Total pot $7.19 | Rake $0.32 
Board [Ts Jd 6d Js 2h]
Seat 1: Spieler977 folded before Flop (didn't bet)
Seat 2: Yellowbaanana showed [Kd Jh] and won ($6.87) with three of a kind, Jacks
Seat 3: nosachkn (button) folded before Flop (didn't bet)
Seat 4: baadnewz01 (small blind) folded before Flop
Seat 5: VETUS1 (big blind) showed [Ah Qc] and lost with a pair of Jacks
Seat 6: I_Not_Alone folded before Flop (didn't bet)



PokerStars Hand #222975667426:  Hold'em No Limit ($0.05/$0.10 USD) - 2021/01/23 17:38:34 ET
Table 'Transvaalia' 6-max Seat #4 is the button
Seat 1: Spieler977 ($10 in chips) 
Seat 2: Yellowbaanana ($20.69 in chips) 
Seat 3: nosachkn ($10.97 in chips) 
Seat 4: baadnewz01 ($15.39 in chips) 
Seat 6: I_Not_Alone ($14.69 in chips) 
I_Not_Alone: posts small blind $0.05
Spieler977: posts big blind $0.10
*** HOLE CARDS ***
Yellowbaanana: calls $0.10
nosachkn: folds 
baadnewz01: folds 
I_Not_Alone: folds 
VETUS1 leaves the table
Spieler977: raises $0.30 to $0.40
Yellowbaanana: folds 
Uncalled bet ($0.30) returned to Spieler977
Spieler977 collected $0.25 from pot
Spieler977: doesn't show hand 
*** SUMMARY ***
Total pot $0.25 | Rake $0 
Seat 1: Spieler977 (big blind) collected ($0.25)
Seat 2: Yellowbaanana folded before Flop
Seat 3: nosachkn folded before Flop (didn't bet)
Seat 4: baadnewz01 (button) folded before Flop (didn't bet)
Seat 6: I_Not_Alone (small blind) folded before Flop



PokerStars Hand #222975681372:  Hold'em No Limit ($0.05/$0.10 USD) - 2021/01/23 17:38:52 ET
Table 'Transvaalia' 6-max Seat #6 is the button
Seat 1: Spieler977 ($10.15 in chips) 
Seat 2: Yellowbaanana ($20.59 in chips) 
Seat 3: nosachkn ($10.97 in chips) 
Seat 4: baadnewz01 ($15.39 in chips) 
Seat 6: I_Not_Alone ($14.64 in chips) 
Spieler977: posts small blind $0.05
Yellowbaanana: posts big blind $0.10
*** HOLE CARDS ***
nosachkn: folds 
baadnewz01: folds 
I_Not_Alone: raises $0.15 to $0.25
Spieler977: folds 
Yellowbaanana: calls $0.15
*** FLOP *** [Ah 8c 2h]
BigBoyVicsera joins the table at seat #5 
Yellowbaanana: checks 
I_Not_Alone: checks 
*** TURN *** [Ah 8c 2h] [8s]
Yellowbaanana: checks 
I_Not_Alone: checks 
*** RIVER *** [Ah 8c 2h 8s] [Ks]
Yellowbaanana: bets $0.53
I_Not_Alone: calls $0.53
*** SHOW DOWN ***
Yellowbaanana: shows [4c Ac] (two pair, Aces and Eights)
I_Not_Alone: mucks hand 
Yellowbaanana collected $1.54 from pot
*** SUMMARY ***
Total pot $1.61 | Rake $0.07 
Board [Ah 8c 2h 8s Ks]
Seat 1: Spieler977 (small blind) folded before Flop
Seat 2: Yellowbaanana (big blind) showed [4c Ac] and won ($1.54) with two pair, Aces and Eights
Seat 3: nosachkn folded before Flop (didn't bet)
Seat 4: baadnewz01 folded before Flop (didn't bet)
Seat 6: I_Not_Alone (button) mucked



PokerStars Hand #222975744541:  Hold'em No Limit ($0.05/$0.10 USD) - 2021/01/23 17:40:14 ET
Table 'Transvaalia' 6-max Seat #1 is the button
Seat 1: Spieler977 ($10.10 in chips) 
Seat 2: Yellowbaanana ($21.35 in chips) 
Seat 3: nosachkn ($10.97 in chips) 
Seat 4: baadnewz01 ($15.39 in chips) 
Seat 6: I_Not_Alone ($13.86 in chips) 
Yellowbaanana: posts small blind $0.05
nosachkn: posts big blind $0.10
BigBoyVicsera: sits out 
*** HOLE CARDS ***
baadnewz01: folds 
I_Not_Alone: folds 
Spieler977: folds 
Yellowbaanana: calls $0.05
nosachkn: checks 
*** FLOP *** [4d 8s Qc]
Yellowbaanana: checks 
nosachkn: checks 
*** TURN *** [4d 8s Qc] [3s]
Yellowbaanana: checks 
nosachkn: checks 
*** RIVER *** [4d 8s Qc 3s] [7d]
Yellowbaanana: bets $0.19
nosachkn: folds 
Uncalled bet ($0.19) returned to Yellowbaanana
Yellowbaanana collected $0.19 from pot
Yellowbaanana: doesn't show hand 
*** SUMMARY ***
Total pot $0.20 | Rake $0.01 
Board [4d 8s Qc 3s 7d]
Seat 1: Spieler977 (button) folded before Flop (didn't bet)
Seat 2: Yellowbaanana (small blind) collected ($0.19)
Seat 3: nosachkn (big blind) folded on the River
Seat 4: baadnewz01 folded before Flop (didn't bet)
Seat 6: I_Not_Alone folded before Flop (didn't bet)



PokerStars Hand #222975768427:  Hold'em No Limit ($0.05/$0.10 USD) - 2021/01/23 17:40:45 ET
Table 'Transvaalia' 6-max Seat #2 is the button
Seat 1: Spieler977 ($10.10 in chips) 
Seat 2: Yellowbaanana ($21.44 in chips) 
Seat 3: nosachkn ($10.87 in chips) 
Seat 4: baadnewz01 ($15.39 in chips) 
Seat 6: I_Not_Alone ($13.86 in chips) 
nosachkn: posts small blind $0.05
baadnewz01: posts big blind $0.10
BigBoyVicsera: sits out 
*** HOLE CARDS ***
I_Not_Alone: folds 
Spieler977: folds 
Yellowbaanana: folds 
nosachkn: folds 
Uncalled bet ($0.05) returned to baadnewz01
baadnewz01 collected $0.10 from pot
baadnewz01: doesn't show hand 
*** SUMMARY ***
Total pot $0.10 | Rake $0 
Seat 1: Spieler977 folded before Flop (didn't bet)
Seat 2: Yellowbaanana (button) folded before Flop (didn't bet)
Seat 3: nosachkn (small blind) folded before Flop
Seat 4: baadnewz01 (big blind) collected ($0.10)
Seat 6: I_Not_Alone folded before Flop (didn't bet)



PokerStars Hand #222975777251:  Hold'em No Limit ($0.05/$0.10 USD) - 2021/01/23 17:40:57 ET
Table 'Transvaalia' 6-max Seat #3 is the button
Seat 1: Spieler977 ($10.10 in chips) 
Seat 2: Yellowbaanana ($21.44 in chips) 
Seat 3: nosachkn ($10.82 in chips) 
Seat 4: baadnewz01 ($15.44 in chips) 
Seat 5: BigBoyVicsera ($8 in chips) 
Seat 6: I_Not_Alone ($13.86 in chips) 
baadnewz01: posts small blind $0.05
BigBoyVicsera: posts big blind $0.10
*** HOLE CARDS ***
I_Not_Alone: folds 
Spieler977: folds 
Yellowbaanana: folds 
nosachkn: raises $0.20 to $0.30
baadnewz01: raises $0.90 to $1.20
BigBoyVicsera: calls $1.10
nosachkn: folds 
*** FLOP *** [2s 5h 8s]
baadnewz01: bets $1.73
BigBoyVicsera: calls $1.73
*** TURN *** [2s 5h 8s] [7c]
baadnewz01: bets $5.20
BigBoyVicsera: calls $5.07 and is all-in
Uncalled bet ($0.13) returned to baadnewz01
*** RIVER *** [2s 5h 8s 7c] [9c]
*** SHOW DOWN ***
baadnewz01: shows [Ad Ah] (a pair of Aces)
BigBoyVicsera: shows [3s 3h] (a pair of Threes)
baadnewz01 collected $15.57 from pot
BigBoyVicsera cashed out the hand for $0.69 | Cash Out Fee $0.01
*** SUMMARY ***
Total pot $16.30 | Rake $0.73 
Board [2s 5h 8s 7c 9c]
Seat 1: Spieler977 folded before Flop (didn't bet)
Seat 2: Yellowbaanana folded before Flop (didn't bet)
Seat 3: nosachkn (button) folded before Flop
Seat 4: baadnewz01 (small blind) showed [Ad Ah] and won ($15.57) with a pair of Aces
Seat 5: BigBoyVicsera (big blind) showed [3s 3h] and lost with a pair of Threes (cashed out).
Seat 6: I_Not_Alone folded before Flop (didn't bet)



PokerStars Hand #222972953938:  Hold'em No Limit ($0.05/$0.10 USD) - 2021/01/23 16:42:09 ET
Table 'Transvaalia' 6-max Seat #5 is the button
Seat 1: Spieler977 ($10 in chips) 
Seat 2: Yellowbaanana ($8.14 in chips) 
Seat 4: hesus32 ($6.50 in chips) 
Seat 5: Oleg032 ($10 in chips) 
Seat 6: I_Not_Alone ($10.75 in chips) 
I_Not_Alone: posts small blind $0.05
Spieler977: posts big blind $0.10
*** HOLE CARDS ***
Yellowbaanana: calls $0.10
hesus32: folds 
bawsak17 joins the table at seat #3 
Oleg032: folds 
I_Not_Alone: folds 
Spieler977: checks 
*** FLOP *** [7s Ac 6s]
Spieler977: checks 
Yellowbaanana: checks 
*** TURN *** [7s Ac 6s] [2c]
Spieler977: checks 
Yellowbaanana: checks 
*** RIVER *** [7s Ac 6s 2c] [7h]
Spieler977: checks 
Yellowbaanana: bets $0.10
Spieler977: calls $0.10
*** SHOW DOWN ***
Yellowbaanana: shows [Qd Jh] (a pair of Sevens)
Spieler977: shows [6h 4h] (two pair, Sevens and Sixes)
Spieler977 collected $0.43 from pot
*** SUMMARY ***
Total pot $0.45 | Rake $0.02 
Board [7s Ac 6s 2c 7h]
Seat 1: Spieler977 (big blind) showed [6h 4h] and won ($0.43) with two pair, Sevens and Sixes
Seat 2: Yellowbaanana showed [Qd Jh] and lost with a pair of Sevens
Seat 4: hesus32 folded before Flop (didn't bet)
Seat 5: Oleg032 (button) folded before Flop (didn't bet)
Seat 6: I_Not_Alone (small blind) folded before Flop



PokerStars Hand #222972994045:  Hold'em No Limit ($0.05/$0.10 USD) - 2021/01/23 16:42:58 ET
Table 'Transvaalia' 6-max Seat #6 is the button
Seat 1: Spieler977 ($10.23 in chips) 
Seat 2: Yellowbaanana ($7.94 in chips) 
Seat 4: hesus32 ($6.50 in chips) 
Seat 5: Oleg032 ($10 in chips) 
Seat 6: I_Not_Alone ($10.70 in chips) 
Spieler977: posts small blind $0.05
Yellowbaanana: posts big blind $0.10
bawsak17: sits out 
*** HOLE CARDS ***
hesus32: raises $0.20 to $0.30
Oleg032: calls $0.30
I_Not_Alone: folds 
Spieler977: folds 
Yellowbaanana: calls $0.20
*** FLOP *** [2h 4d 6c]
Yellowbaanana: checks 
hesus32: bets $0.20
Oleg032: folds 
Yellowbaanana: calls $0.20
*** TURN *** [2h 4d 6c] [5d]
Yellowbaanana: bets $7.44 and is all-in
hesus32: folds 
Uncalled bet ($7.44) returned to Yellowbaanana
Yellowbaanana collected $1.29 from pot
Yellowbaanana: doesn't show hand 
*** SUMMARY ***
Total pot $1.35 | Rake $0.06 
Board [2h 4d 6c 5d]
Seat 1: Spieler977 (small blind) folded before Flop
Seat 2: Yellowbaanana (big blind) collected ($1.29)
Seat 4: hesus32 folded on the Turn
Seat 5: Oleg032 folded on the Flop
Seat 6: I_Not_Alone (button) folded before Flop (didn't bet)



PokerStars Hand #222973024288:  Hold'em No Limit ($0.05/$0.10 USD) - 2021/01/23 16:43:36 ET
Table 'Transvaalia' 6-max Seat #1 is the button
Seat 1: Spieler977 ($10.18 in chips) 
Seat 2: Yellowbaanana ($8.73 in chips) 
Seat 3: bawsak17 ($10 in chips) 
Seat 4: hesus32 ($6 in chips) 
Seat 5: Oleg032 ($10 in chips) 
Seat 6: I_Not_Alone ($10.70 in chips) 
Yellowbaanana: posts small blind $0.05
bawsak17: posts big blind $0.10
*** HOLE CARDS ***
hesus32: calls $0.10
Oleg032: folds 
I_Not_Alone: folds 
Spieler977 has timed out
Spieler977: folds 
Yellowbaanana: calls $0.05
bawsak17: checks 
*** FLOP *** [Qh 5c Ts]
Yellowbaanana: checks 
bawsak17: checks 
hesus32: checks 
*** TURN *** [Qh 5c Ts] [3d]
Yellowbaanana: checks 
bawsak17: checks 
hesus32: checks 
*** RIVER *** [Qh 5c Ts 3d] [Qd]
Yellowbaanana: bets $0.10
bawsak17: folds 
hesus32: folds 
Uncalled bet ($0.10) returned to Yellowbaanana
Yellowbaanana collected $0.29 from pot
Yellowbaanana: doesn't show hand 
*** SUMMARY ***
Total pot $0.30 | Rake $0.01 
Board [Qh 5c Ts 3d Qd]
Seat 1: Spieler977 (button) folded before Flop (didn't bet)
Seat 2: Yellowbaanana (small blind) collected ($0.29)
Seat 3: bawsak17 (big blind) folded on the River
Seat 4: hesus32 folded on the River
Seat 5: Oleg032 folded before Flop (didn't bet)
Seat 6: I_Not_Alone folded before Flop (didn't bet)



PokerStars Hand #222973064021:  Hold'em No Limit ($0.05/$0.10 USD) - 2021/01/23 16:44:24 ET
Table 'Transvaalia' 6-max Seat #2 is the button
Seat 2: Yellowbaanana ($8.92 in chips) 
Seat 3: bawsak17 ($10 in chips) 
Seat 4: hesus32 ($5.90 in chips) 
Seat 5: Oleg032 ($10 in chips) 
Seat 6: I_Not_Alone ($10.70 in chips) 
bawsak17: posts small blind $0.05
hesus32: posts big blind $0.10
*** HOLE CARDS ***
Oleg032: raises $0.15 to $0.25
I_Not_Alone: folds 
Yellowbaanana: calls $0.25
bawsak17: folds 
hesus32: calls $0.15
*** FLOP *** [Kc Qs 5d]
hesus32: checks 
Oleg032: checks 
Yellowbaanana: checks 
*** TURN *** [Kc Qs 5d] [7s]
hesus32: checks 
Oleg032: bets $0.25
Yellowbaanana: folds 
hesus32: calls $0.25
*** RIVER *** [Kc Qs 5d 7s] [8s]
hesus32: checks 
Oleg032: bets $0.62
hesus32: folds 
Uncalled bet ($0.62) returned to Oleg032
Oleg032 collected $1.24 from pot
Oleg032: doesn't show hand 
*** SUMMARY ***
Total pot $1.30 | Rake $0.06 
Board [Kc Qs 5d 7s 8s]
Seat 2: Yellowbaanana (button) folded on the Turn
Seat 3: bawsak17 (small blind) folded before Flop
Seat 4: hesus32 (big blind) folded on the River
Seat 5: Oleg032 collected ($1.24)
Seat 6: I_Not_Alone folded before Flop (didn't bet)



PokerStars Hand #222973123984:  Hold'em No Limit ($0.05/$0.10 USD) - 2021/01/23 16:45:37 ET
Table 'Transvaalia' 6-max Seat #3 is the button
Seat 1: Spieler977 ($10.18 in chips) 
Seat 2: Yellowbaanana ($8.67 in chips) 
Seat 3: bawsak17 ($10 in chips) 
Seat 4: hesus32 ($5.40 in chips) 
Seat 5: Oleg032 ($10.74 in chips) 
Seat 6: I_Not_Alone ($10.70 in chips) 
hesus32: posts small blind $0.05
Oleg032: posts big blind $0.10
*** HOLE CARDS ***
I_Not_Alone: folds 
Spieler977: folds 
Yellowbaanana: calls $0.10
bawsak17: folds 
hesus32: calls $0.05
Oleg032: checks 
*** FLOP *** [8s 4c Tc]
hesus32: checks 
Oleg032: checks 
Yellowbaanana: checks 
*** TURN *** [8s 4c Tc] [7s]
hesus32: bets $0.20
Oleg032: calls $0.20
Yellowbaanana: folds 
*** RIVER *** [8s 4c Tc 7s] [Td]
hesus32: bets $0.33
Oleg032: folds 
Uncalled bet ($0.33) returned to hesus32
hesus32 collected $0.67 from pot
hesus32: doesn't show hand 
*** SUMMARY ***
Total pot $0.70 | Rake $0.03 
Board [8s 4c Tc 7s Td]
Seat 1: Spieler977 folded before Flop (didn't bet)
Seat 2: Yellowbaanana folded on the Turn
Seat 3: bawsak17 (button) folded before Flop (didn't bet)
Seat 4: hesus32 (small blind) collected ($0.67)
Seat 5: Oleg032 (big blind) folded on the River
Seat 6: I_Not_Alone folded before Flop (didn't bet)



PokerStars Hand #222973156537:  Hold'em No Limit ($0.05/$0.10 USD) - 2021/01/23 16:46:16 ET
Table 'Transvaalia' 6-max Seat #4 is the button
Seat 1: Spieler977 ($10.18 in chips) 
Seat 2: Yellowbaanana ($8.57 in chips) 
Seat 3: bawsak17 ($10 in chips) 
Seat 4: hesus32 ($5.77 in chips) 
Seat 5: Oleg032 ($10.44 in chips) 
Seat 6: I_Not_Alone ($10.70 in chips) 
Oleg032: posts small blind $0.05
I_Not_Alone: posts big blind $0.10
*** HOLE CARDS ***
Spieler977: folds 
Yellowbaanana: calls $0.10
bawsak17: raises $0.30 to $0.40
hesus32: folds 
Oleg032: folds 
I_Not_Alone: folds 
Yellowbaanana: folds 
Uncalled bet ($0.30) returned to bawsak17
bawsak17 collected $0.35 from pot
bawsak17: doesn't show hand 
*** SUMMARY ***
Total pot $0.35 | Rake $0 
Seat 1: Spieler977 folded before Flop (didn't bet)
Seat 2: Yellowbaanana folded before Flop
Seat 3: bawsak17 collected ($0.35)
Seat 4: hesus32 (button) folded before Flop (didn't bet)
Seat 5: Oleg032 (small blind) folded before Flop
Seat 6: I_Not_Alone (big blind) folded before Flop



PokerStars Hand #222973172070:  Hold'em No Limit ($0.05/$0.10 USD) - 2021/01/23 16:46:34 ET
Table 'Transvaalia' 6-max Seat #5 is the button
Seat 1: Spieler977 ($10.18 in chips) 
Seat 2: Yellowbaanana ($8.47 in chips) 
Seat 3: bawsak17 ($10.25 in chips) 
Seat 4: hesus32 ($5.77 in chips) 
Seat 5: Oleg032 ($10.39 in chips) 
Seat 6: I_Not_Alone ($10.60 in chips) 
I_Not_Alone: posts small blind $0.05
Spieler977: posts big blind $0.10
*** HOLE CARDS ***
Yellowbaanana: calls $0.10
bawsak17: folds 
hesus32: folds 
Oleg032: raises $0.15 to $0.25
I_Not_Alone: folds 
Spieler977: folds 
Yellowbaanana: calls $0.15
*** FLOP *** [Td Jd Kd]
Yellowbaanana: checks 
Oleg032: checks 
*** TURN *** [Td Jd Kd] [9d]
Yellowbaanana: bets $0.62
Oleg032: folds 
Uncalled bet ($0.62) returned to Yellowbaanana
Yellowbaanana collected $0.62 from pot
Yellowbaanana: doesn't show hand 
*** SUMMARY ***
Total pot $0.65 | Rake $0.03 
Board [Td Jd Kd 9d]
Seat 1: Spieler977 (big blind) folded before Flop
Seat 2: Yellowbaanana collected ($0.62)
Seat 3: bawsak17 folded before Flop (didn't bet)
Seat 4: hesus32 folded before Flop (didn't bet)
Seat 5: Oleg032 (button) folded on the Turn
Seat 6: I_Not_Alone (small blind) folded before Flop



PokerStars Hand #222973202634:  Hold'em No Limit ($0.05/$0.10 USD) - 2021/01/23 16:47:11 ET
Table 'Transvaalia' 6-max Seat #6 is the button
Seat 1: Spieler977 ($10.08 in chips) 
Seat 2: Yellowbaanana ($8.84 in chips) 
Seat 3: bawsak17 ($10.25 in chips) 
Seat 4: hesus32 ($5.77 in chips) 
Seat 5: Oleg032 ($10.14 in chips) 
Seat 6: I_Not_Alone ($10.55 in chips) 
Spieler977: posts small blind $0.05
Yellowbaanana: posts big blind $0.10
*** HOLE CARDS ***
bawsak17: raises $0.15 to $0.25
hesus32: folds 
Oleg032: raises $0.65 to $0.90
I_Not_Alone: folds 
Spieler977: folds 
Yellowbaanana: folds 
bawsak17: calls $0.65
*** FLOP *** [Ad Qs 5h]
bawsak17: checks 
Oleg032: checks 
*** TURN *** [Ad Qs 5h] [Ts]
bawsak17: checks 
Oleg032: bets $0.93
bawsak17: calls $0.93
*** RIVER *** [Ad Qs 5h Ts] [3d]
bawsak17: checks 
Oleg032: checks 
*** SHOW DOWN ***
bawsak17: shows [As 8s] (a pair of Aces)
Oleg032: mucks hand 
bawsak17 collected $3.64 from pot
*** SUMMARY ***
Total pot $3.81 | Rake $0.17 
Board [Ad Qs 5h Ts 3d]
Seat 1: Spieler977 (small blind) folded before Flop
Seat 2: Yellowbaanana (big blind) folded before Flop
Seat 3: bawsak17 showed [As 8s] and won ($3.64) with a pair of Aces
Seat 4: hesus32 folded before Flop (didn't bet)
Seat 5: Oleg032 mucked
Seat 6: I_Not_Alone (button) folded before Flop (didn't bet)



PokerStars Hand #222973238368:  Hold'em No Limit ($0.05/$0.10 USD) - 2021/01/23 16:47:54 ET
Table 'Transvaalia' 6-max Seat #1 is the button
Seat 1: Spieler977 ($10.03 in chips) 
Seat 2: Yellowbaanana ($8.74 in chips) 
Seat 3: bawsak17 ($12.06 in chips) 
Seat 4: hesus32 ($5.77 in chips) 
Seat 5: Oleg032 ($10 in chips) 
Seat 6: I_Not_Alone ($10.55 in chips) 
Yellowbaanana: posts small blind $0.05
bawsak17: posts big blind $0.10
*** HOLE CARDS ***
hesus32: folds 
Oleg032: folds 
I_Not_Alone: folds 
Spieler977: folds 
Yellowbaanana: calls $0.05
bawsak17: checks 
*** FLOP *** [Jh 6c Jc]
Yellowbaanana: bets $0.10
bawsak17: calls $0.10
*** TURN *** [Jh 6c Jc] [7d]
Yellowbaanana: bets $0.10
bawsak17: raises $0.29 to $0.39
Yellowbaanana: calls $0.29
*** RIVER *** [Jh 6c Jc 7d] [3d]
Yellowbaanana: bets $8.15 and is all-in
bawsak17: folds 
Uncalled bet ($8.15) returned to Yellowbaanana
Yellowbaanana collected $1.13 from pot
Yellowbaanana: doesn't show hand 
*** SUMMARY ***
Total pot $1.18 | Rake $0.05 
Board [Jh 6c Jc 7d 3d]
Seat 1: Spieler977 (button) folded before Flop (didn't bet)
Seat 2: Yellowbaanana (small blind) collected ($1.13)
Seat 3: bawsak17 (big blind) folded on the River
Seat 4: hesus32 folded before Flop (didn't bet)
Seat 5: Oleg032 folded before Flop (didn't bet)
Seat 6: I_Not_Alone folded before Flop (didn't bet)



PokerStars Hand #222973264503:  Hold'em No Limit ($0.05/$0.10 USD) - 2021/01/23 16:48:25 ET
Table 'Transvaalia' 6-max Seat #2 is the button
Seat 1: Spieler977 ($10.03 in chips) 
Seat 2: Yellowbaanana ($9.28 in chips) 
Seat 3: bawsak17 ($11.47 in chips) 
Seat 4: hesus32 ($5.77 in chips) 
Seat 5: Oleg032 ($10 in chips) 
Seat 6: I_Not_Alone ($10.55 in chips) 
bawsak17: posts small blind $0.05
hesus32: posts big blind $0.10
*** HOLE CARDS ***
Oleg032: raises $0.15 to $0.25
I_Not_Alone: folds 
Spieler977: folds 
Yellowbaanana: folds 
bawsak17: folds 
hesus32: calls $0.15
*** FLOP *** [2s 2h Ks]
hesus32: checks 
Oleg032: checks 
*** TURN *** [2s 2h Ks] [8d]
hesus32: checks 
Oleg032: checks 
*** RIVER *** [2s 2h Ks 8d] [Kd]
hesus32: bets $0.10
Oleg032: folds 
Uncalled bet ($0.10) returned to hesus32
hesus32 collected $0.53 from pot
hesus32: doesn't show hand 
*** SUMMARY ***
Total pot $0.55 | Rake $0.02 
Board [2s 2h Ks 8d Kd]
Seat 1: Spieler977 folded before Flop (didn't bet)
Seat 2: Yellowbaanana (button) folded before Flop (didn't bet)
Seat 3: bawsak17 (small blind) folded before Flop
Seat 4: hesus32 (big blind) collected ($0.53)
Seat 5: Oleg032 folded on the River
Seat 6: I_Not_Alone folded before Flop (didn't bet)



PokerStars Hand #222973295741:  Hold'em No Limit ($0.05/$0.10 USD) - 2021/01/23 16:49:02 ET
Table 'Transvaalia' 6-max Seat #3 is the button
Seat 1: Spieler977 ($10.03 in chips) 
Seat 2: Yellowbaanana ($9.28 in chips) 
Seat 3: bawsak17 ($11.42 in chips) 
Seat 4: hesus32 ($6.05 in chips) 
Seat 5: Oleg032 ($10 in chips) 
Seat 6: I_Not_Alone ($10.55 in chips) 
hesus32: posts small blind $0.05
Oleg032: posts big blind $0.10
*** HOLE CARDS ***
I_Not_Alone: folds 
Spieler977: folds 
Yellowbaanana: calls $0.10
bawsak17: folds 
hesus32: calls $0.05
Oleg032: checks 
*** FLOP *** [3s 8c 6h]
hesus32: bets $0.20
Oleg032: folds 
Yellowbaanana: raises $0.40 to $0.60
hesus32: calls $0.40
*** TURN *** [3s 8c 6h] [9d]
hesus32: checks 
Yellowbaanana: bets $1.43
hesus32: calls $1.43
*** RIVER *** [3s 8c 6h 9d] [6s]
hesus32: checks 
Yellowbaanana: bets $4.16
hesus32: calls $3.92 and is all-in
Uncalled bet ($0.24) returned to Yellowbaanana
*** SHOW DOWN ***
Yellowbaanana: shows [Th Ts] (two pair, Tens and Sixes)
hesus32: shows [Kc 8d] (two pair, Eights and Sixes)
Yellowbaanana collected $11.65 from pot
*** SUMMARY ***
Total pot $12.20 | Rake $0.55 
Board [3s 8c 6h 9d 6s]
Seat 1: Spieler977 folded before Flop (didn't bet)
Seat 2: Yellowbaanana showed [Th Ts] and won ($11.65) with two pair, Tens and Sixes
Seat 3: bawsak17 (button) folded before Flop (didn't bet)
Seat 4: hesus32 (small blind) showed [Kc 8d] and lost with two pair, Eights and Sixes
Seat 5: Oleg032 (big blind) folded on the Flop
Seat 6: I_Not_Alone folded before Flop (didn't bet)



PokerStars Hand #222973353077:  Hold'em No Limit ($0.05/$0.10 USD) - 2021/01/23 16:50:10 ET
Table 'Transvaalia' 6-max Seat #5 is the button
Seat 1: Spieler977 ($10.03 in chips) 
Seat 2: Yellowbaanana ($14.88 in chips) 
Seat 3: bawsak17 ($11.42 in chips) 
Seat 5: Oleg032 ($10 in chips) 
Seat 6: I_Not_Alone ($10.55 in chips) 
I_Not_Alone: posts small blind $0.05
Spieler977: posts big blind $0.10
*** HOLE CARDS ***
Yellowbaanana: calls $0.10
bawsak17 is disconnected 
bawsak17 has timed out while disconnected
bawsak17: folds 
Oleg032: folds 
I_Not_Alone: folds 
Spieler977: checks 
*** FLOP *** [5h 2d 6c]
Spieler977: bets $0.18
Yellowbaanana: folds 
Uncalled bet ($0.18) returned to Spieler977
Spieler977 collected $0.24 from pot
Spieler977: doesn't show hand 
*** SUMMARY ***
Total pot $0.25 | Rake $0.01 
Board [5h 2d 6c]
Seat 1: Spieler977 (big blind) collected ($0.24)
Seat 2: Yellowbaanana folded on the Flop
Seat 3: bawsak17 folded before Flop (didn't bet)
Seat 5: Oleg032 (button) folded before Flop (didn't bet)
Seat 6: I_Not_Alone (small blind) folded before Flop



PokerStars Hand #222973385230:  Hold'em No Limit ($0.05/$0.10 USD) - 2021/01/23 16:50:48 ET
Table 'Transvaalia' 6-max Seat #6 is the button
Seat 1: Spieler977 ($10.17 in chips) 
Seat 2: Yellowbaanana ($14.78 in chips) 
Seat 4: hesus32 ($4 in chips) 
Seat 5: Oleg032 ($10 in chips) 
Seat 6: I_Not_Alone ($10.50 in chips) 
Spieler977: posts small blind $0.05
Yellowbaanana: posts big blind $0.10
*** HOLE CARDS ***
hesus32: folds 
Oleg032: folds 
I_Not_Alone: folds 
Spieler977: folds 
Uncalled bet ($0.05) returned to Yellowbaanana
Yellowbaanana collected $0.10 from pot
Yellowbaanana: doesn't show hand 
*** SUMMARY ***
Total pot $0.10 | Rake $0 
Seat 1: Spieler977 (small blind) folded before Flop
Seat 2: Yellowbaanana (big blind) collected ($0.10)
Seat 4: hesus32 folded before Flop (didn't bet)
Seat 5: Oleg032 folded before Flop (didn't bet)
Seat 6: I_Not_Alone (button) folded before Flop (didn't bet)



PokerStars Hand #222973398041:  Hold'em No Limit ($0.05/$0.10 USD) - 2021/01/23 16:51:04 ET
Table 'Transvaalia' 6-max Seat #1 is the button
Seat 1: Spieler977 ($10.12 in chips) 
Seat 2: Yellowbaanana ($14.83 in chips) 
Seat 4: hesus32 ($4 in chips) 
Seat 5: Oleg032 ($10 in chips) 
Seat 6: I_Not_Alone ($10.50 in chips) 
Yellowbaanana: posts small blind $0.05
hesus32: posts big blind $0.10
*** HOLE CARDS ***
Oleg032: folds 
I_Not_Alone: folds 
Spieler977: folds 
Yellowbaanana: calls $0.05
hesus32: raises $0.20 to $0.30
Yellowbaanana: calls $0.20
*** FLOP *** [5d Ah 9s]
Yellowbaanana: checks 
hesus32: bets $0.30
Yellowbaanana: calls $0.30
*** TURN *** [5d Ah 9s] [6c]
Yellowbaanana: checks 
hesus32: bets $0.57
Yellowbaanana: calls $0.57
*** RIVER *** [5d Ah 9s 6c] [Qd]
Yellowbaanana: checks 
hesus32: checks 
*** SHOW DOWN ***
Yellowbaanana: shows [7c 9h] (a pair of Nines)
hesus32: mucks hand 
Yellowbaanana collected $2.23 from pot
*** SUMMARY ***
Total pot $2.34 | Rake $0.11 
Board [5d Ah 9s 6c Qd]
Seat 1: Spieler977 (button) folded before Flop (didn't bet)
Seat 2: Yellowbaanana (small blind) showed [7c 9h] and won ($2.23) with a pair of Nines
Seat 4: hesus32 (big blind) mucked
Seat 5: Oleg032 folded before Flop (didn't bet)
Seat 6: I_Not_Alone folded before Flop (didn't bet)



PokerStars Hand #222973425820:  Hold'em No Limit ($0.05/$0.10 USD) - 2021/01/23 16:51:37 ET
Table 'Transvaalia' 6-max Seat #2 is the button
Seat 1: Spieler977 ($10.12 in chips) 
Seat 2: Yellowbaanana ($15.89 in chips) 
Seat 4: hesus32 ($2.83 in chips) 
Seat 5: Oleg032 ($10 in chips) 
Seat 6: I_Not_Alone ($10.50 in chips) 
hesus32: posts small blind $0.05
Oleg032: posts big blind $0.10
*** HOLE CARDS ***
I_Not_Alone: folds 
Spieler977: folds 
Yellowbaanana: calls $0.10
hesus32: calls $0.05
Oleg032: checks 
*** FLOP *** [4h Kh 6d]
hesus32: checks 
Oleg032: checks 
Yellowbaanana: checks 
*** TURN *** [4h Kh 6d] [3d]
hesus32: bets $0.29
Oleg032: folds 
Yellowbaanana: calls $0.29
*** RIVER *** [4h Kh 6d 3d] [2d]
hesus32: bets $0.84
Yellowbaanana: calls $0.84
*** SHOW DOWN ***
hesus32: shows [3s 4d] (two pair, Fours and Threes)
Yellowbaanana: shows [5s 3c] (a straight, Deuce to Six)
Yellowbaanana collected $2.44 from pot
*** SUMMARY ***
Total pot $2.56 | Rake $0.12 
Board [4h Kh 6d 3d 2d]
Seat 1: Spieler977 folded before Flop (didn't bet)
Seat 2: Yellowbaanana (button) showed [5s 3c] and won ($2.44) with a straight, Deuce to Six
Seat 4: hesus32 (small blind) showed [3s 4d] and lost with two pair, Fours and Threes
Seat 5: Oleg032 (big blind) folded on the Turn
Seat 6: I_Not_Alone folded before Flop (didn't bet)



PokerStars Hand #222973470474:  Hold'em No Limit ($0.05/$0.10 USD) - 2021/01/23 16:52:30 ET
Table 'Transvaalia' 6-max Seat #4 is the button
Seat 1: Spieler977 ($10.12 in chips) 
Seat 2: Yellowbaanana ($17.10 in chips) 
Seat 4: hesus32 ($1.60 in chips) 
Seat 5: Oleg032 ($10 in chips) 
Seat 6: I_Not_Alone ($10.50 in chips) 
Oleg032: posts small blind $0.05
I_Not_Alone: posts big blind $0.10
*** HOLE CARDS ***
Spieler977: folds 
Yellowbaanana: calls $0.10
hesus32: calls $0.10
Oleg032: folds 
I_Not_Alone: checks 
*** FLOP *** [Tc 5s 6h]
I_Not_Alone: checks 
Yellowbaanana: checks 
hesus32: checks 
*** TURN *** [Tc 5s 6h] [Ts]
I_Not_Alone: checks 
Yellowbaanana: checks 
hesus32: checks 
*** RIVER *** [Tc 5s 6h Ts] [3s]
I_Not_Alone: checks 
Yellowbaanana: bets $0.10
hesus32: folds 
I_Not_Alone: folds 
Uncalled bet ($0.10) returned to Yellowbaanana
Yellowbaanana collected $0.33 from pot
Yellowbaanana: doesn't show hand 
*** SUMMARY ***
Total pot $0.35 | Rake $0.02 
Board [Tc 5s 6h Ts 3s]
Seat 1: Spieler977 folded before Flop (didn't bet)
Seat 2: Yellowbaanana collected ($0.33)
Seat 4: hesus32 (button) folded on the River
Seat 5: Oleg032 (small blind) folded before Flop
Seat 6: I_Not_Alone (big blind) folded on the River



PokerStars Hand #222973506122:  Hold'em No Limit ($0.05/$0.10 USD) - 2021/01/23 16:53:13 ET
Table 'Transvaalia' 6-max Seat #5 is the button
Seat 1: Spieler977 ($10.12 in chips) 
Seat 2: Yellowbaanana ($17.33 in chips) 
Seat 4: hesus32 ($1.50 in chips) 
Seat 5: Oleg032 ($10 in chips) 
Seat 6: I_Not_Alone ($10.40 in chips) 
I_Not_Alone: posts small blind $0.05
Spieler977: posts big blind $0.10
bawsak17: sits out 
*** HOLE CARDS ***
Yellowbaanana: calls $0.10
hesus32: calls $0.10
Oleg032: raises $0.15 to $0.25
I_Not_Alone: folds 
Spieler977: calls $0.15
Yellowbaanana: folds 
hesus32: calls $0.15
*** FLOP *** [5c Jc 6s]
Spieler977: checks 
hesus32: checks 
Oleg032: checks 
*** TURN *** [5c Jc 6s] [4c]
Spieler977: checks 
hesus32: checks 
Oleg032: checks 
*** RIVER *** [5c Jc 6s 4c] [Kc]
Spieler977: checks 
hesus32: bets $0.43
Oleg032: folds 
Spieler977: folds 
Uncalled bet ($0.43) returned to hesus32
hesus32 collected $0.86 from pot
hesus32: doesn't show hand 
*** SUMMARY ***
Total pot $0.90 | Rake $0.04 
Board [5c Jc 6s 4c Kc]
Seat 1: Spieler977 (big blind) folded on the River
Seat 2: Yellowbaanana folded before Flop
Seat 4: hesus32 collected ($0.86)
Seat 5: Oleg032 (button) folded on the River
Seat 6: I_Not_Alone (small blind) folded before Flop



PokerStars Hand #222973544476:  Hold'em No Limit ($0.05/$0.10 USD) - 2021/01/23 16:53:59 ET
Table 'Transvaalia' 6-max Seat #6 is the button
Seat 1: Spieler977 ($10 in chips) 
Seat 2: Yellowbaanana ($17.23 in chips) 
Seat 4: hesus32 ($2.11 in chips) 
Seat 5: Oleg032 ($10 in chips) 
Seat 6: I_Not_Alone ($10.35 in chips) 
Spieler977: posts small blind $0.05
Yellowbaanana: posts big blind $0.10
bawsak17: sits out 
*** HOLE CARDS ***
hesus32: calls $0.10
Oleg032: raises $0.15 to $0.25
I_Not_Alone: folds 
Spieler977: folds 
Yellowbaanana: calls $0.15
hesus32: calls $0.15
*** FLOP *** [2s 8d 2h]
Yellowbaanana: checks 
hesus32: checks 
Oleg032: checks 
*** TURN *** [2s 8d 2h] [2c]
Yellowbaanana: bets $0.76
hesus32: folds 
Oleg032: folds 
Uncalled bet ($0.76) returned to Yellowbaanana
Yellowbaanana collected $0.76 from pot
Yellowbaanana: doesn't show hand 
*** SUMMARY ***
Total pot $0.80 | Rake $0.04 
Board [2s 8d 2h 2c]
Seat 1: Spieler977 (small blind) folded before Flop
Seat 2: Yellowbaanana (big blind) collected ($0.76)
Seat 4: hesus32 folded on the Turn
Seat 5: Oleg032 folded on the Turn
Seat 6: I_Not_Alone (button) folded before Flop (didn't bet)



PokerStars Hand #222973570713:  Hold'em No Limit ($0.05/$0.10 USD) - 2021/01/23 16:54:30 ET
Table 'Transvaalia' 6-max Seat #1 is the button
Seat 1: Spieler977 ($10 in chips) 
Seat 2: Yellowbaanana ($17.74 in chips) 
Seat 3: bawsak17 ($11.42 in chips) 
Seat 4: hesus32 ($1.86 in chips) 
Seat 5: Oleg032 ($10 in chips) 
Seat 6: I_Not_Alone ($10.35 in chips) 
Yellowbaanana: posts small blind $0.05
bawsak17: posts big blind $0.10
*** HOLE CARDS ***
hesus32: folds 
Oleg032: folds 
I_Not_Alone: folds 
Spieler977: folds 
Yellowbaanana: calls $0.05
bawsak17: checks 
*** FLOP *** [Jc 7c 4h]
Yellowbaanana: checks 
bawsak17: bets $0.10
Yellowbaanana: calls $0.10
*** TURN *** [Jc 7c 4h] [9s]
Yellowbaanana: checks 
bawsak17: bets $0.23
Yellowbaanana: folds 
Uncalled bet ($0.23) returned to bawsak17
bawsak17 collected $0.38 from pot
bawsak17: doesn't show hand 
*** SUMMARY ***
Total pot $0.40 | Rake $0.02 
Board [Jc 7c 4h 9s]
Seat 1: Spieler977 (button) folded before Flop (didn't bet)
Seat 2: Yellowbaanana (small blind) folded on the Turn
Seat 3: bawsak17 (big blind) collected ($0.38)
Seat 4: hesus32 folded before Flop (didn't bet)
Seat 5: Oleg032 folded before Flop (didn't bet)
Seat 6: I_Not_Alone folded before Flop (didn't bet)



PokerStars Hand #222973595809:  Hold'em No Limit ($0.05/$0.10 USD) - 2021/01/23 16:55:01 ET
Table 'Transvaalia' 6-max Seat #2 is the button
Seat 1: Spieler977 ($10 in chips) 
Seat 2: Yellowbaanana ($17.54 in chips) 
Seat 3: bawsak17 ($11.60 in chips) 
Seat 4: hesus32 ($1.86 in chips) 
Seat 5: Oleg032 ($10 in chips) 
Seat 6: I_Not_Alone ($10.35 in chips) 
bawsak17: posts small blind $0.05
hesus32: posts big blind $0.10
*** HOLE CARDS ***
Oleg032: folds 
I_Not_Alone: folds 
Spieler977: folds 
Yellowbaanana: calls $0.10
bawsak17: calls $0.05
hesus32: checks 
*** FLOP *** [2d 8h Ac]
bawsak17: checks 
hesus32: checks 
Yellowbaanana: checks 
*** TURN *** [2d 8h Ac] [6c]
bawsak17: bets $0.10
hesus32: calls $0.10
Yellowbaanana: calls $0.10
*** RIVER *** [2d 8h Ac 6c] [4s]
bawsak17: bets $0.10
hesus32: calls $0.10
Yellowbaanana: raises $0.10 to $0.20
bawsak17: calls $0.10
hesus32: calls $0.10
*** SHOW DOWN ***
Yellowbaanana: shows [Js Jh] (a pair of Jacks)
bawsak17: shows [6h Ad] (two pair, Aces and Sixes)
hesus32: mucks hand 
bawsak17 collected $1.15 from pot
*** SUMMARY ***
Total pot $1.20 | Rake $0.05 
Board [2d 8h Ac 6c 4s]
Seat 1: Spieler977 folded before Flop (didn't bet)
Seat 2: Yellowbaanana (button) showed [Js Jh] and lost with a pair of Jacks
Seat 3: bawsak17 (small blind) showed [6h Ad] and won ($1.15) with two pair, Aces and Sixes
Seat 4: hesus32 (big blind) mucked
Seat 5: Oleg032 folded before Flop (didn't bet)
Seat 6: I_Not_Alone folded before Flop (didn't bet)



PokerStars Hand #222973621561:  Hold'em No Limit ($0.05/$0.10 USD) - 2021/01/23 16:55:42 ET
Table 'Transvaalia' 6-max Seat #3 is the button
Seat 1: Spieler977 ($10 in chips) 
Seat 2: Yellowbaanana ($17.14 in chips) 
Seat 3: bawsak17 ($12.35 in chips) 
Seat 4: hesus32 ($1.46 in chips) 
Seat 6: I_Not_Alone ($10.35 in chips) 
hesus32: posts small blind $0.05
Oleg032: is sitting out 
I_Not_Alone: posts big blind $0.10
*** HOLE CARDS ***
Spieler977: folds 
Yellowbaanana: folds 
bawsak17: folds 
hesus32: calls $0.05
Oleg032 leaves the table
I_Not_Alone: checks 
*** FLOP *** [7s 4c Ah]
hesus32: checks 
I_Not_Alone: checks 
*** TURN *** [7s 4c Ah] [9c]
hesus32: checks 
I_Not_Alone: checks 
*** RIVER *** [7s 4c Ah 9c] [Td]
hesus32: checks 
I_Not_Alone: checks 
*** SHOW DOWN ***
hesus32: shows [4s 2c] (a pair of Fours)
I_Not_Alone: mucks hand 
hesus32 collected $0.19 from pot
*** SUMMARY ***
Total pot $0.20 | Rake $0.01 
Board [7s 4c Ah 9c Td]
Seat 1: Spieler977 folded before Flop (didn't bet)
Seat 2: Yellowbaanana folded before Flop (didn't bet)
Seat 3: bawsak17 (button) folded before Flop (didn't bet)
Seat 4: hesus32 (small blind) showed [4s 2c] and won ($0.19) with a pair of Fours
Seat 6: I_Not_Alone (big blind) mucked



PokerStars Hand #222973636468:  Hold'em No Limit ($0.05/$0.10 USD) - 2021/01/23 16:56:09 ET
Table 'Transvaalia' 6-max Seat #4 is the button
Seat 1: Spieler977 ($10 in chips) 
Seat 2: Yellowbaanana ($17.14 in chips) 
Seat 3: bawsak17 ($12.35 in chips) 
Seat 4: hesus32 ($1.55 in chips) 
Seat 6: I_Not_Alone ($10.25 in chips) 
I_Not_Alone: posts small blind $0.05
Spieler977: posts big blind $0.10
*** HOLE CARDS ***
Yellowbaanana: calls $0.10
bawsak17: raises $0.30 to $0.40
hesus32: folds 
I_Not_Alone: folds 
Spieler977: folds 
Yellowbaanana: folds 
Uncalled bet ($0.30) returned to bawsak17
bawsak17 collected $0.35 from pot
bawsak17: doesn't show hand 
*** SUMMARY ***
Total pot $0.35 | Rake $0 
Seat 1: Spieler977 (big blind) folded before Flop
Seat 2: Yellowbaanana folded before Flop
Seat 3: bawsak17 collected ($0.35)
Seat 4: hesus32 (button) folded before Flop (didn't bet)
Seat 6: I_Not_Alone (small blind) folded before Flop



PokerStars Hand #222973647381:  Hold'em No Limit ($0.05/$0.10 USD) - 2021/01/23 16:56:28 ET
Table 'Transvaalia' 6-max Seat #6 is the button
Seat 1: Spieler977 ($10 in chips) 
Seat 2: Yellowbaanana ($17.04 in chips) 
Seat 3: bawsak17 ($12.60 in chips) 
Seat 4: hesus32 ($1.55 in chips) 
Seat 6: I_Not_Alone ($10.20 in chips) 
Spieler977: posts small blind $0.05
Yellowbaanana: posts big blind $0.10
*** HOLE CARDS ***
bawsak17: raises $0.15 to $0.25
hesus32: folds 
I_Not_Alone: folds 
Spieler977: folds 
Loks95 joins the table at seat #5 
Yellowbaanana: calls $0.15
*** FLOP *** [8d Ad 6d]
Yellowbaanana: checks 
bawsak17: checks 
*** TURN *** [8d Ad 6d] [Ts]
Yellowbaanana: bets $0.53
bawsak17: calls $0.53
*** RIVER *** [8d Ad 6d Ts] [5d]
Yellowbaanana: checks 
bawsak17: checks 
*** SHOW DOWN ***
Yellowbaanana: shows [3d Td] (a flush, Ace high)
bawsak17: mucks hand 
Yellowbaanana collected $1.54 from pot
*** SUMMARY ***
Total pot $1.61 | Rake $0.07 
Board [8d Ad 6d Ts 5d]
Seat 1: Spieler977 (small blind) folded before Flop
Seat 2: Yellowbaanana (big blind) showed [3d Td] and won ($1.54) with a flush, Ace high
Seat 3: bawsak17 mucked
Seat 4: hesus32 folded before Flop (didn't bet)
Seat 6: I_Not_Alone (button) folded before Flop (didn't bet)



PokerStars Hand #222973666924:  Hold'em No Limit ($0.05/$0.10 USD) - 2021/01/23 16:57:02 ET
Table 'Transvaalia' 6-max Seat #1 is the button
Seat 1: Spieler977 ($10 in chips) 
Seat 2: Yellowbaanana ($17.80 in chips) 
Seat 3: bawsak17 ($11.82 in chips) 
Seat 4: hesus32 ($1.55 in chips) 
Seat 6: I_Not_Alone ($10.20 in chips) 
Yellowbaanana: posts small blind $0.05
bawsak17: posts big blind $0.10
Loks95: sits out 
*** HOLE CARDS ***
hesus32: folds 
I_Not_Alone: folds 
Spieler977: folds 
Yellowbaanana: calls $0.05
bawsak17: checks 
*** FLOP *** [Qs 2c 8d]
Yellowbaanana: checks 
bawsak17: checks 
*** TURN *** [Qs 2c 8d] [5h]
Yellowbaanana: checks 
bawsak17: bets $0.11
Yellowbaanana: folds 
Uncalled bet ($0.11) returned to bawsak17
bawsak17 collected $0.19 from pot
bawsak17: doesn't show hand 
*** SUMMARY ***
Total pot $0.20 | Rake $0.01 
Board [Qs 2c 8d 5h]
Seat 1: Spieler977 (button) folded before Flop (didn't bet)
Seat 2: Yellowbaanana (small blind) folded on the Turn
Seat 3: bawsak17 (big blind) collected ($0.19)
Seat 4: hesus32 folded before Flop (didn't bet)
Seat 6: I_Not_Alone folded before Flop (didn't bet)



PokerStars Hand #222973686095:  Hold'em No Limit ($0.05/$0.10 USD) - 2021/01/23 16:57:35 ET
Table 'Transvaalia' 6-max Seat #2 is the button
Seat 1: Spieler977 ($10 in chips) 
Seat 2: Yellowbaanana ($17.70 in chips) 
Seat 3: bawsak17 ($11.91 in chips) 
Seat 4: hesus32 ($1.55 in chips) 
Seat 5: Loks95 ($10 in chips) 
Seat 6: I_Not_Alone ($10.20 in chips) 
bawsak17: posts small blind $0.05
hesus32: posts big blind $0.10
Loks95: posts big blind $0.10
*** HOLE CARDS ***
Loks95: checks 
I_Not_Alone: folds 
Spieler977: folds 
Yellowbaanana: calls $0.10
bawsak17: calls $0.05
hesus32: raises $0.30 to $0.40
Loks95: calls $0.30
Yellowbaanana: calls $0.30
bawsak17: calls $0.30
*** FLOP *** [8h Th Qd]
bawsak17: checks 
hesus32: bets $1.15 and is all-in
Loks95: calls $1.15
Yellowbaanana: folds 
bawsak17: folds 
*** TURN *** [8h Th Qd] [2d]
*** RIVER *** [8h Th Qd 2d] [7h]
*** SHOW DOWN ***
hesus32: shows [Td Ad] (a pair of Tens)
Loks95: shows [Jc Kd] (high card King)
hesus32 collected $3.72 from pot
*** SUMMARY ***
Total pot $3.90 | Rake $0.18 
Board [8h Th Qd 2d 7h]
Seat 1: Spieler977 folded before Flop (didn't bet)
Seat 2: Yellowbaanana (button) folded on the Flop
Seat 3: bawsak17 (small blind) folded on the Flop
Seat 4: hesus32 (big blind) showed [Td Ad] and won ($3.72) with a pair of Tens
Seat 5: Loks95 showed [Jc Kd] and lost with high card King
Seat 6: I_Not_Alone folded before Flop (didn't bet)



PokerStars Hand #222973717145:  Hold'em No Limit ($0.05/$0.10 USD) - 2021/01/23 16:58:29 ET
Table 'Transvaalia' 6-max Seat #3 is the button
Seat 1: Spieler977 ($10 in chips) 
Seat 2: Yellowbaanana ($17.30 in chips) 
Seat 3: bawsak17 ($11.51 in chips) 
Seat 4: hesus32 ($3.72 in chips) 
Seat 5: Loks95 ($8.45 in chips) 
Seat 6: I_Not_Alone ($10.20 in chips) 
hesus32: posts small blind $0.05
Loks95: posts big blind $0.10
*** HOLE CARDS ***
I_Not_Alone: folds 
Spieler977: folds 
Yellowbaanana: calls $0.10
bawsak17: raises $0.30 to $0.40
hesus32: folds 
Loks95: calls $0.30
Yellowbaanana: calls $0.30
*** FLOP *** [Td 8d 2h]
Loks95: checks 
Yellowbaanana: checks 
bawsak17: bets $0.60
Loks95: folds 
Yellowbaanana: folds 
Uncalled bet ($0.60) returned to bawsak17
bawsak17 collected $1.19 from pot
bawsak17: doesn't show hand 
*** SUMMARY ***
Total pot $1.25 | Rake $0.06 
Board [Td 8d 2h]
Seat 1: Spieler977 folded before Flop (didn't bet)
Seat 2: Yellowbaanana folded on the Flop
Seat 3: bawsak17 (button) collected ($1.19)
Seat 4: hesus32 (small blind) folded before Flop
Seat 5: Loks95 (big blind) folded on the Flop
Seat 6: I_Not_Alone folded before Flop (didn't bet)



PokerStars Hand #222973736691:  Hold'em No Limit ($0.05/$0.10 USD) - 2021/01/23 16:59:03 ET
Table 'Transvaalia' 6-max Seat #4 is the button
Seat 1: Spieler977 ($10 in chips) 
Seat 2: Yellowbaanana ($16.90 in chips) 
Seat 3: bawsak17 ($12.30 in chips) 
Seat 4: hesus32 ($3.67 in chips) 
Seat 5: Loks95 ($8.05 in chips) 
Seat 6: I_Not_Alone ($10.20 in chips) 
Loks95: posts small blind $0.05
I_Not_Alone: posts big blind $0.10
*** HOLE CARDS ***
Spieler977: folds 
Yellowbaanana: folds 
bawsak17: folds 
hesus32: calls $0.10
Loks95: calls $0.05
I_Not_Alone: raises $0.30 to $0.40
hesus32: calls $0.30
Loks95: folds 
*** FLOP *** [Qh 6h Qd]
I_Not_Alone: bets $0.27
hesus32: calls $0.27
*** TURN *** [Qh 6h Qd] [5d]
I_Not_Alone: bets $0.80
hesus32: calls $0.80
*** RIVER *** [Qh 6h Qd 5d] [Jc]
I_Not_Alone: bets $2.06
hesus32: calls $2.06
*** SHOW DOWN ***
I_Not_Alone: shows [As Qc] (three of a kind, Queens)
hesus32: mucks hand 
I_Not_Alone collected $6.84 from pot
*** SUMMARY ***
Total pot $7.16 | Rake $0.32 
Board [Qh 6h Qd 5d Jc]
Seat 1: Spieler977 folded before Flop (didn't bet)
Seat 2: Yellowbaanana folded before Flop (didn't bet)
Seat 3: bawsak17 folded before Flop (didn't bet)
Seat 4: hesus32 (button) mucked
Seat 5: Loks95 (small blind) folded before Flop
Seat 6: I_Not_Alone (big blind) showed [As Qc] and won ($6.84) with three of a kind, Queens



PokerStars Hand #222973762610:  Hold'em No Limit ($0.05/$0.10 USD) - 2021/01/23 16:59:47 ET
Table 'Transvaalia' 6-max Seat #5 is the button
Seat 1: Spieler977 ($10 in chips) 
Seat 2: Yellowbaanana ($16.90 in chips) 
Seat 3: bawsak17 ($12.30 in chips) 
Seat 4: hesus32 ($0.14 in chips) 
Seat 5: Loks95 ($7.95 in chips) 
Seat 6: I_Not_Alone ($13.51 in chips) 
I_Not_Alone: posts small blind $0.05
Spieler977: posts big blind $0.10
*** HOLE CARDS ***
Yellowbaanana: folds 
bawsak17: folds 
hesus32: raises $0.04 to $0.14 and is all-in
Loks95: calls $0.14
I_Not_Alone: folds 
Spieler977: calls $0.04
*** FLOP *** [Ac 6h 5h]
Spieler977: checks 
Loks95: checks 
*** TURN *** [Ac 6h 5h] [Jd]
Spieler977: bets $0.34
Loks95: folds 
Uncalled bet ($0.34) returned to Spieler977
*** RIVER *** [Ac 6h 5h Jd] [2c]
*** SHOW DOWN ***
Spieler977: shows [5d Ad] (two pair, Aces and Fives)
hesus32: shows [Qh Th] (high card Ace)
Spieler977 collected $0.45 from pot
*** SUMMARY ***
Total pot $0.47 | Rake $0.02 
Board [Ac 6h 5h Jd 2c]
Seat 1: Spieler977 (big blind) showed [5d Ad] and won ($0.45) with two pair, Aces and Fives
Seat 2: Yellowbaanana folded before Flop (didn't bet)
Seat 3: bawsak17 folded before Flop (didn't bet)
Seat 4: hesus32 showed [Qh Th] and lost with high card Ace
Seat 5: Loks95 (button) folded on the Turn
Seat 6: I_Not_Alone (small blind) folded before Flop



PokerStars Hand #222973788178:  Hold'em No Limit ($0.05/$0.10 USD) - 2021/01/23 17:00:28 ET
Table 'Transvaalia' 6-max Seat #6 is the button
Seat 1: Spieler977 ($10.31 in chips) 
Seat 2: Yellowbaanana ($16.90 in chips) 
Seat 3: bawsak17 ($12.30 in chips) 
Seat 5: Loks95 ($7.81 in chips) 
Seat 6: I_Not_Alone ($13.46 in chips) 
Spieler977: posts small blind $0.05
Yellowbaanana: posts big blind $0.10
*** HOLE CARDS ***
bawsak17: folds 
Loks95: calls $0.10
I_Not_Alone: folds 
hesus32 leaves the table
Spieler977: folds 
Yellowbaanana: checks 
*** FLOP *** [9d 7c 4d]
Yellowbaanana: checks 
Loks95: checks 
*** TURN *** [9d 7c 4d] [2c]
Yellowbaanana: checks 
Loks95: checks 
*** RIVER *** [9d 7c 4d 2c] [9c]
Yellowbaanana: checks 
Loks95: checks 
*** SHOW DOWN ***
Yellowbaanana: shows [2d Ts] (two pair, Nines and Deuces)
Loks95: mucks hand 
Yellowbaanana collected $0.24 from pot
*** SUMMARY ***
Total pot $0.25 | Rake $0.01 
Board [9d 7c 4d 2c 9c]
Seat 1: Spieler977 (small blind) folded before Flop
Seat 2: Yellowbaanana (big blind) showed [2d Ts] and won ($0.24) with two pair, Nines and Deuces
Seat 3: bawsak17 folded before Flop (didn't bet)
Seat 5: Loks95 mucked
Seat 6: I_Not_Alone (button) folded before Flop (didn't bet)



PokerStars Hand #222973805733:  Hold'em No Limit ($0.05/$0.10 USD) - 2021/01/23 17:00:54 ET
Table 'Transvaalia' 6-max Seat #1 is the button
Seat 1: Spieler977 ($10.26 in chips) 
Seat 2: Yellowbaanana ($17.04 in chips) 
Seat 3: bawsak17 ($12.30 in chips) 
Seat 5: Loks95 ($7.71 in chips) 
Seat 6: I_Not_Alone ($13.46 in chips) 
Yellowbaanana: posts small blind $0.05
bawsak17: posts big blind $0.10
*** HOLE CARDS ***
baadnewz01 joins the table at seat #4 
Loks95: calls $0.10
I_Not_Alone: folds 
Spieler977: folds 
Yellowbaanana: calls $0.05
bawsak17: raises $0.30 to $0.40
Loks95: calls $0.30
Yellowbaanana: folds 
*** FLOP *** [6s 5d 8h]
bawsak17: checks 
Loks95: checks 
*** TURN *** [6s 5d 8h] [Jd]
bawsak17: checks 
Loks95: checks 
*** RIVER *** [6s 5d 8h Jd] [2s]
bawsak17: checks 
Loks95: bets $0.86
bawsak17: folds 
Uncalled bet ($0.86) returned to Loks95
Loks95 collected $0.86 from pot
Loks95: doesn't show hand 
*** SUMMARY ***
Total pot $0.90 | Rake $0.04 
Board [6s 5d 8h Jd 2s]
Seat 1: Spieler977 (button) folded before Flop (didn't bet)
Seat 2: Yellowbaanana (small blind) folded before Flop
Seat 3: bawsak17 (big blind) folded on the River
Seat 5: Loks95 collected ($0.86)
Seat 6: I_Not_Alone folded before Flop (didn't bet)



PokerStars Hand #222973837184:  Hold'em No Limit ($0.05/$0.10 USD) - 2021/01/23 17:01:36 ET
Table 'Transvaalia' 6-max Seat #2 is the button
Seat 1: Spieler977 ($10.26 in chips) 
Seat 2: Yellowbaanana ($16.94 in chips) 
Seat 3: bawsak17 ($11.90 in chips) 
Seat 4: baadnewz01 ($10 in chips) 
Seat 5: Loks95 ($8.17 in chips) 
Seat 6: I_Not_Alone ($13.46 in chips) 
bawsak17: posts small blind $0.05
baadnewz01: posts big blind $0.10
*** HOLE CARDS ***
Loks95: calls $0.10
I_Not_Alone: folds 
Spieler977: raises $0.30 to $0.40
Yellowbaanana: folds 
bawsak17: folds 
baadnewz01: calls $0.30
Loks95: raises $0.80 to $1.20
Spieler977: folds 
baadnewz01: folds 
Uncalled bet ($0.80) returned to Loks95
Loks95 collected $1.25 from pot
Loks95: doesn't show hand 
*** SUMMARY ***
Total pot $1.25 | Rake $0 
Seat 1: Spieler977 folded before Flop
Seat 2: Yellowbaanana (button) folded before Flop (didn't bet)
Seat 3: bawsak17 (small blind) folded before Flop
Seat 4: baadnewz01 (big blind) folded before Flop
Seat 5: Loks95 collected ($1.25)
Seat 6: I_Not_Alone folded before Flop (didn't bet)



PokerStars Hand #222973868638:  Hold'em No Limit ($0.05/$0.10 USD) - 2021/01/23 17:02:15 ET
Table 'Transvaalia' 6-max Seat #3 is the button
Seat 1: Spieler977 ($10 in chips) 
Seat 2: Yellowbaanana ($16.94 in chips) 
Seat 3: bawsak17 ($11.85 in chips) 
Seat 4: baadnewz01 ($10 in chips) 
Seat 5: Loks95 ($9.02 in chips) 
Seat 6: I_Not_Alone ($13.46 in chips) 
baadnewz01: posts small blind $0.05
Loks95: posts big blind $0.10
*** HOLE CARDS ***
I_Not_Alone: folds 
Spieler977: folds 
Yellowbaanana: calls $0.10
bawsak17: folds 
baadnewz01: folds 
Loks95: raises $0.10 to $0.20
Yellowbaanana: calls $0.10
*** FLOP *** [8d 8h 5c]
Loks95: checks 
Yellowbaanana: checks 
*** TURN *** [8d 8h 5c] [4h]
Loks95: checks 
Yellowbaanana: checks 
*** RIVER *** [8d 8h 5c 4h] [4d]
Loks95: checks 
Yellowbaanana: bets $0.43
Loks95: calls $0.43
*** SHOW DOWN ***
Yellowbaanana: shows [Ah 8c] (a full house, Eights full of Fours)
Loks95: mucks hand 
Yellowbaanana collected $1.25 from pot
*** SUMMARY ***
Total pot $1.31 | Rake $0.06 
Board [8d 8h 5c 4h 4d]
Seat 1: Spieler977 folded before Flop (didn't bet)
Seat 2: Yellowbaanana showed [Ah 8c] and won ($1.25) with a full house, Eights full of Fours
Seat 3: bawsak17 (button) folded before Flop (didn't bet)
Seat 4: baadnewz01 (small blind) folded before Flop
Seat 5: Loks95 (big blind) mucked
Seat 6: I_Not_Alone folded before Flop (didn't bet)



PokerStars Hand #222973904388:  Hold'em No Limit ($0.05/$0.10 USD) - 2021/01/23 17:02:59 ET
Table 'Transvaalia' 6-max Seat #4 is the button
Seat 1: Spieler977 ($10 in chips) 
Seat 2: Yellowbaanana ($17.56 in chips) 
Seat 3: bawsak17 ($11.85 in chips) 
Seat 4: baadnewz01 ($10 in chips) 
Seat 5: Loks95 ($8.39 in chips) 
Seat 6: I_Not_Alone ($13.46 in chips) 
Loks95: posts small blind $0.05
I_Not_Alone: posts big blind $0.10
*** HOLE CARDS ***
Spieler977: folds 
Yellowbaanana: folds 
bawsak17: folds 
baadnewz01: folds 
Loks95: calls $0.05
I_Not_Alone: checks 
*** FLOP *** [Ad 9h Kc]
Loks95: checks 
I_Not_Alone: bets $0.10
Loks95: folds 
Uncalled bet ($0.10) returned to I_Not_Alone
I_Not_Alone collected $0.19 from pot
I_Not_Alone: doesn't show hand 
*** SUMMARY ***
Total pot $0.20 | Rake $0.01 
Board [Ad 9h Kc]
Seat 1: Spieler977 folded before Flop (didn't bet)
Seat 2: Yellowbaanana folded before Flop (didn't bet)
Seat 3: bawsak17 folded before Flop (didn't bet)
Seat 4: baadnewz01 (button) folded before Flop (didn't bet)
Seat 5: Loks95 (small blind) folded on the Flop
Seat 6: I_Not_Alone (big blind) collected ($0.19)



PokerStars Hand #222973920988:  Hold'em No Limit ($0.05/$0.10 USD) - 2021/01/23 17:03:18 ET
Table 'Transvaalia' 6-max Seat #5 is the button
Seat 1: Spieler977 ($10 in chips) 
Seat 2: Yellowbaanana ($17.56 in chips) 
Seat 3: bawsak17 ($11.85 in chips) 
Seat 4: baadnewz01 ($10 in chips) 
Seat 5: Loks95 ($8.29 in chips) 
Seat 6: I_Not_Alone ($13.55 in chips) 
I_Not_Alone: posts small blind $0.05
Spieler977: posts big blind $0.10
*** HOLE CARDS ***
Yellowbaanana: folds 
bawsak17: folds 
baadnewz01: folds 
Loks95: calls $0.10
I_Not_Alone: folds 
Spieler977: checks 
*** FLOP *** [6c 2h Jc]
Spieler977: checks 
Loks95: checks 
*** TURN *** [6c 2h Jc] [Tc]
Spieler977: checks 
Loks95: checks 
*** RIVER *** [6c 2h Jc Tc] [3h]
Spieler977: checks 
Loks95: checks 
*** SHOW DOWN ***
Spieler977: shows [Qh 4h] (high card Queen)
Loks95: shows [8h 6d] (a pair of Sixes)
Loks95 collected $0.24 from pot
*** SUMMARY ***
Total pot $0.25 | Rake $0.01 
Board [6c 2h Jc Tc 3h]
Seat 1: Spieler977 (big blind) showed [Qh 4h] and lost with high card Queen
Seat 2: Yellowbaanana folded before Flop (didn't bet)
Seat 3: bawsak17 folded before Flop (didn't bet)
Seat 4: baadnewz01 folded before Flop (didn't bet)
Seat 5: Loks95 (button) showed [8h 6d] and won ($0.24) with a pair of Sixes
Seat 6: I_Not_Alone (small blind) folded before Flop



PokerStars Hand #222973961147:  Hold'em No Limit ($0.05/$0.10 USD) - 2021/01/23 17:03:54 ET
Table 'Transvaalia' 6-max Seat #6 is the button
Seat 1: Spieler977 ($10 in chips) 
Seat 2: Yellowbaanana ($17.56 in chips) 
Seat 3: bawsak17 ($11.85 in chips) 
Seat 4: baadnewz01 ($10 in chips) 
Seat 5: Loks95 ($8.43 in chips) 
Seat 6: I_Not_Alone ($13.50 in chips) 
Spieler977: posts small blind $0.05
Yellowbaanana: posts big blind $0.10
*** HOLE CARDS ***
bawsak17: folds 
baadnewz01: folds 
Loks95: calls $0.10
I_Not_Alone: folds 
Spieler977: folds 
Yellowbaanana: checks 
*** FLOP *** [8s Kh 3d]
Yellowbaanana: checks 
Loks95: bets $0.10
Yellowbaanana: folds 
Uncalled bet ($0.10) returned to Loks95
Loks95 collected $0.24 from pot
Loks95: doesn't show hand 
*** SUMMARY ***
Total pot $0.25 | Rake $0.01 
Board [8s Kh 3d]
Seat 1: Spieler977 (small blind) folded before Flop
Seat 2: Yellowbaanana (big blind) folded on the Flop
Seat 3: bawsak17 folded before Flop (didn't bet)
Seat 4: baadnewz01 folded before Flop (didn't bet)
Seat 5: Loks95 collected ($0.24)
Seat 6: I_Not_Alone (button) folded before Flop (didn't bet)



PokerStars Hand #222976409881:  Hold'em No Limit ($0.05/$0.10 USD) - 2021/01/23 17:55:08 ET
Table 'Transvaalia' 6-max Seat #5 is the button
Seat 1: Spieler977 ($12.39 in chips) 
Seat 2: Yellowbaanana ($18.74 in chips) 
Seat 3: nosachkn ($10.50 in chips) 
Seat 4: baadnewz01 ($23.38 in chips) 
Seat 5: Gintaras20 ($11.02 in chips) 
Seat 6: raydenel ($10 in chips) 
raydenel: posts small blind $0.05
Spieler977: posts big blind $0.10
*** HOLE CARDS ***
Yellowbaanana: calls $0.10
nosachkn: folds 
baadnewz01: folds 
Gintaras20: raises $0.25 to $0.35
raydenel: calls $0.30
Spieler977: folds 
Yellowbaanana: calls $0.25
*** FLOP *** [7s 6s 5s]
raydenel: checks 
Yellowbaanana: checks 
Gintaras20: bets $0.55
raydenel: folds 
Yellowbaanana: folds 
Uncalled bet ($0.55) returned to Gintaras20
Gintaras20 collected $1.10 from pot
Gintaras20: doesn't show hand 
*** SUMMARY ***
Total pot $1.15 | Rake $0.05 
Board [7s 6s 5s]
Seat 1: Spieler977 (big blind) folded before Flop
Seat 2: Yellowbaanana folded on the Flop
Seat 3: nosachkn folded before Flop (didn't bet)
Seat 4: baadnewz01 folded before Flop (didn't bet)
Seat 5: Gintaras20 (button) collected ($1.10)
Seat 6: raydenel (small blind) folded on the Flop



PokerStars Hand #222976424835:  Hold'em No Limit ($0.05/$0.10 USD) - 2021/01/23 17:55:36 ET
Table 'Transvaalia' 6-max Seat #6 is the button
Seat 1: Spieler977 ($12.29 in chips) 
Seat 2: Yellowbaanana ($18.39 in chips) 
Seat 3: nosachkn ($10.50 in chips) 
Seat 4: baadnewz01 ($23.38 in chips) 
Seat 5: Gintaras20 ($11.77 in chips) 
Seat 6: raydenel ($10 in chips) 
Spieler977: posts small blind $0.05
Yellowbaanana: posts big blind $0.10
*** HOLE CARDS ***
nosachkn: folds 
baadnewz01: folds 
Gintaras20: folds 
raydenel: raises $0.10 to $0.20
Spieler977: folds 
Yellowbaanana: calls $0.10
*** FLOP *** [3s 5h 5s]
Yellowbaanana: checks 
raydenel: checks 
*** TURN *** [3s 5h 5s] [4c]
Yellowbaanana: bets $0.43
raydenel: folds 
Uncalled bet ($0.43) returned to Yellowbaanana
Yellowbaanana collected $0.43 from pot
Yellowbaanana: doesn't show hand 
*** SUMMARY ***
Total pot $0.45 | Rake $0.02 
Board [3s 5h 5s 4c]
Seat 1: Spieler977 (small blind) folded before Flop
Seat 2: Yellowbaanana (big blind) collected ($0.43)
Seat 3: nosachkn folded before Flop (didn't bet)
Seat 4: baadnewz01 folded before Flop (didn't bet)
Seat 5: Gintaras20 folded before Flop (didn't bet)
Seat 6: raydenel (button) folded on the Turn



PokerStars Hand #222976439930:  Hold'em No Limit ($0.05/$0.10 USD) - 2021/01/23 17:56:05 ET
Table 'Transvaalia' 6-max Seat #1 is the button
Seat 1: Spieler977 ($12.24 in chips) 
Seat 2: Yellowbaanana ($18.62 in chips) 
Seat 3: nosachkn ($10.50 in chips) 
Seat 4: baadnewz01 ($23.38 in chips) 
Seat 5: Gintaras20 ($11.77 in chips) 
Seat 6: raydenel ($10 in chips) 
Yellowbaanana: posts small blind $0.05
nosachkn: posts big blind $0.10
*** HOLE CARDS ***
baadnewz01: folds 
Gintaras20: folds 
raydenel: folds 
Spieler977: folds 
Yellowbaanana: calls $0.05
nosachkn: checks 
*** FLOP *** [2d Ks 7c]
Yellowbaanana: checks 
nosachkn: checks 
*** TURN *** [2d Ks 7c] [9h]
Yellowbaanana: checks 
nosachkn: checks 
*** RIVER *** [2d Ks 7c 9h] [7d]
Yellowbaanana: checks 
nosachkn: checks 
*** SHOW DOWN ***
Yellowbaanana: shows [9c Kc] (two pair, Kings and Nines)
nosachkn: mucks hand 
Yellowbaanana collected $0.19 from pot
*** SUMMARY ***
Total pot $0.20 | Rake $0.01 
Board [2d Ks 7c 9h 7d]
Seat 1: Spieler977 (button) folded before Flop (didn't bet)
Seat 2: Yellowbaanana (small blind) showed [9c Kc] and won ($0.19) with two pair, Kings and Nines
Seat 3: nosachkn (big blind) mucked
Seat 4: baadnewz01 folded before Flop (didn't bet)
Seat 5: Gintaras20 folded before Flop (didn't bet)
Seat 6: raydenel folded before Flop (didn't bet)



PokerStars Hand #222976453673:  Hold'em No Limit ($0.05/$0.10 USD) - 2021/01/23 17:56:31 ET
Table 'Transvaalia' 6-max Seat #2 is the button
Seat 1: Spieler977 ($12.24 in chips) 
Seat 2: Yellowbaanana ($18.71 in chips) 
Seat 3: nosachkn ($10.40 in chips) 
Seat 4: baadnewz01 ($23.38 in chips) 
Seat 5: Gintaras20 ($11.77 in chips) 
Seat 6: raydenel ($10 in chips) 
nosachkn: posts small blind $0.05
baadnewz01: posts big blind $0.10
*** HOLE CARDS ***
Gintaras20: folds 
raydenel: folds 
Spieler977: folds 
Yellowbaanana: folds 
nosachkn: raises $0.10 to $0.20
baadnewz01: calls $0.10
*** FLOP *** [8c 2h Qh]
nosachkn: bets $0.19
baadnewz01: folds 
Uncalled bet ($0.19) returned to nosachkn
nosachkn collected $0.38 from pot
nosachkn: doesn't show hand 
*** SUMMARY ***
Total pot $0.40 | Rake $0.02 
Board [8c 2h Qh]
Seat 1: Spieler977 folded before Flop (didn't bet)
Seat 2: Yellowbaanana (button) folded before Flop (didn't bet)
Seat 3: nosachkn (small blind) collected ($0.38)
Seat 4: baadnewz01 (big blind) folded on the Flop
Seat 5: Gintaras20 folded before Flop (didn't bet)
Seat 6: raydenel folded before Flop (didn't bet)



PokerStars Hand #222976467534:  Hold'em No Limit ($0.05/$0.10 USD) - 2021/01/23 17:56:57 ET
Table 'Transvaalia' 6-max Seat #3 is the button
Seat 1: Spieler977 ($12.24 in chips) 
Seat 2: Yellowbaanana ($18.71 in chips) 
Seat 3: nosachkn ($10.58 in chips) 
Seat 4: baadnewz01 ($23.18 in chips) 
Seat 5: Gintaras20 ($11.77 in chips) 
Seat 6: raydenel ($10 in chips) 
baadnewz01: posts small blind $0.05
Gintaras20: posts big blind $0.10
*** HOLE CARDS ***
raydenel: folds 
Spieler977: folds 
Yellowbaanana: calls $0.10
nosachkn: folds 
baadnewz01: folds 
Gintaras20: checks 
*** FLOP *** [Js 6s Jh]
Gintaras20: bets $0.12
Yellowbaanana: calls $0.12
*** TURN *** [Js 6s Jh] [5c]
Gintaras20: bets $0.35
Yellowbaanana: folds 
Uncalled bet ($0.35) returned to Gintaras20
Gintaras20 collected $0.47 from pot
Gintaras20: doesn't show hand 
*** SUMMARY ***
Total pot $0.49 | Rake $0.02 
Board [Js 6s Jh 5c]
Seat 1: Spieler977 folded before Flop (didn't bet)
Seat 2: Yellowbaanana folded on the Turn
Seat 3: nosachkn (button) folded before Flop (didn't bet)
Seat 4: baadnewz01 (small blind) folded before Flop
Seat 5: Gintaras20 (big blind) collected ($0.47)
Seat 6: raydenel folded before Flop (didn't bet)



PokerStars Hand #222976488044:  Hold'em No Limit ($0.05/$0.10 USD) - 2021/01/23 17:57:35 ET
Table 'Transvaalia' 6-max Seat #4 is the button
Seat 1: Spieler977 ($12.24 in chips) 
Seat 2: Yellowbaanana ($18.49 in chips) 
Seat 3: nosachkn ($10.58 in chips) 
Seat 4: baadnewz01 ($23.13 in chips) 
Seat 5: Gintaras20 ($12.02 in chips) 
Seat 6: raydenel ($10 in chips) 
Gintaras20: posts small blind $0.05
raydenel: posts big blind $0.10
*** HOLE CARDS ***
Spieler977: folds 
Yellowbaanana: folds 
nosachkn: folds 
baadnewz01: raises $0.20 to $0.30
Gintaras20: folds 
raydenel: folds 
Uncalled bet ($0.20) returned to baadnewz01
baadnewz01 collected $0.25 from pot
baadnewz01: doesn't show hand 
*** SUMMARY ***
Total pot $0.25 | Rake $0 
Seat 1: Spieler977 folded before Flop (didn't bet)
Seat 2: Yellowbaanana folded before Flop (didn't bet)
Seat 3: nosachkn folded before Flop (didn't bet)
Seat 4: baadnewz01 (button) collected ($0.25)
Seat 5: Gintaras20 (small blind) folded before Flop
Seat 6: raydenel (big blind) folded before Flop



PokerStars Hand #222976495958:  Hold'em No Limit ($0.05/$0.10 USD) - 2021/01/23 17:57:50 ET
Table 'Transvaalia' 6-max Seat #5 is the button
Seat 1: Spieler977 ($12.24 in chips) 
Seat 2: Yellowbaanana ($18.49 in chips) 
Seat 3: nosachkn ($10.58 in chips) 
Seat 4: baadnewz01 ($23.28 in chips) 
Seat 5: Gintaras20 ($11.97 in chips) 
Seat 6: raydenel ($10 in chips) 
raydenel: posts small blind $0.05
Spieler977: posts big blind $0.10
*** HOLE CARDS ***
Yellowbaanana: calls $0.10
nosachkn: raises $0.30 to $0.40
baadnewz01: folds 
Gintaras20: folds 
raydenel: folds 
Spieler977: folds 
Yellowbaanana: raises $18.09 to $18.49 and is all-in
nosachkn: folds 
Uncalled bet ($18.09) returned to Yellowbaanana
Yellowbaanana collected $0.95 from pot
Yellowbaanana: doesn't show hand 
*** SUMMARY ***
Total pot $0.95 | Rake $0 
Seat 1: Spieler977 (big blind) folded before Flop
Seat 2: Yellowbaanana collected ($0.95)
Seat 3: nosachkn folded before Flop
Seat 4: baadnewz01 folded before Flop (didn't bet)
Seat 5: Gintaras20 (button) folded before Flop (didn't bet)
Seat 6: raydenel (small blind) folded before Flop



PokerStars Hand #222976511014:  Hold'em No Limit ($0.05/$0.10 USD) - 2021/01/23 17:58:19 ET
Table 'Transvaalia' 6-max Seat #6 is the button
Seat 1: Spieler977 ($12.14 in chips) 
Seat 2: Yellowbaanana ($19.04 in chips) 
Seat 3: nosachkn ($10.18 in chips) 
Seat 4: baadnewz01 ($23.28 in chips) 
Seat 5: Gintaras20 ($11.97 in chips) 
Seat 6: raydenel ($10 in chips) 
Spieler977: posts small blind $0.05
Yellowbaanana: posts big blind $0.10
*** HOLE CARDS ***
nosachkn: folds 
baadnewz01: folds 
Gintaras20: folds 
raydenel: folds 
Spieler977: folds 
Uncalled bet ($0.05) returned to Yellowbaanana
Yellowbaanana collected $0.10 from pot
Yellowbaanana: doesn't show hand 
*** SUMMARY ***
Total pot $0.10 | Rake $0 
Seat 1: Spieler977 (small blind) folded before Flop
Seat 2: Yellowbaanana (big blind) collected ($0.10)
Seat 3: nosachkn folded before Flop (didn't bet)
Seat 4: baadnewz01 folded before Flop (didn't bet)
Seat 5: Gintaras20 folded before Flop (didn't bet)
Seat 6: raydenel (button) folded before Flop (didn't bet)



PokerStars Hand #222976517683:  Hold'em No Limit ($0.05/$0.10 USD) - 2021/01/23 17:58:31 ET
Table 'Transvaalia' 6-max Seat #1 is the button
Seat 1: Spieler977 ($12.09 in chips) 
Seat 2: Yellowbaanana ($19.09 in chips) 
Seat 3: nosachkn ($10.18 in chips) 
Seat 4: baadnewz01 ($23.28 in chips) 
Seat 5: Gintaras20 ($11.97 in chips) 
Seat 6: raydenel ($10 in chips) 
Yellowbaanana: posts small blind $0.05
nosachkn: posts big blind $0.10
*** HOLE CARDS ***
baadnewz01: folds 
Gintaras20: folds 
raydenel: raises $0.15 to $0.25
Spieler977: raises $0.65 to $0.90
Yellowbaanana: folds 
nosachkn: folds 
raydenel: folds 
Uncalled bet ($0.65) returned to Spieler977
Spieler977 collected $0.65 from pot
Spieler977: doesn't show hand 
*** SUMMARY ***
Total pot $0.65 | Rake $0 
Seat 1: Spieler977 (button) collected ($0.65)
Seat 2: Yellowbaanana (small blind) folded before Flop
Seat 3: nosachkn (big blind) folded before Flop
Seat 4: baadnewz01 folded before Flop (didn't bet)
Seat 5: Gintaras20 folded before Flop (didn't bet)
Seat 6: raydenel folded before Flop



PokerStars Hand #222976531420:  Hold'em No Limit ($0.05/$0.10 USD) - 2021/01/23 17:58:57 ET
Table 'Transvaalia' 6-max Seat #2 is the button
Seat 1: Spieler977 ($12.49 in chips) 
Seat 2: Yellowbaanana ($19.04 in chips) 
Seat 3: nosachkn ($10.08 in chips) 
Seat 4: baadnewz01 ($23.28 in chips) 
Seat 5: Gintaras20 ($11.97 in chips) 
Seat 6: raydenel ($10 in chips) 
nosachkn: posts small blind $0.05
baadnewz01: posts big blind $0.10
*** HOLE CARDS ***
Gintaras20: folds 
raydenel: folds 
Spieler977: folds 
Yellowbaanana: folds 
nosachkn: raises $0.10 to $0.20
baadnewz01: folds 
Uncalled bet ($0.10) returned to nosachkn
nosachkn collected $0.20 from pot
nosachkn: doesn't show hand 
*** SUMMARY ***
Total pot $0.20 | Rake $0 
Seat 1: Spieler977 folded before Flop (didn't bet)
Seat 2: Yellowbaanana (button) folded before Flop (didn't bet)
Seat 3: nosachkn (small blind) collected ($0.20)
Seat 4: baadnewz01 (big blind) folded before Flop
Seat 5: Gintaras20 folded before Flop (didn't bet)
Seat 6: raydenel folded before Flop (didn't bet)



PokerStars Hand #222976551910:  Hold'em No Limit ($0.05/$0.10 USD) - 2021/01/23 17:59:27 ET
Table 'Transvaalia' 6-max Seat #3 is the button
Seat 1: Spieler977 ($12.49 in chips) 
Seat 2: Yellowbaanana ($19.04 in chips) 
Seat 3: nosachkn ($10.18 in chips) 
Seat 4: baadnewz01 ($23.18 in chips) 
Seat 5: Gintaras20 ($11.97 in chips) 
Seat 6: raydenel ($10 in chips) 
baadnewz01: posts small blind $0.05
Gintaras20: posts big blind $0.10
*** HOLE CARDS ***
raydenel: folds 
Spieler977: folds 
Yellowbaanana: folds 
nosachkn: folds 
baadnewz01: folds 
Uncalled bet ($0.05) returned to Gintaras20
Gintaras20 collected $0.10 from pot
Gintaras20: doesn't show hand 
*** SUMMARY ***
Total pot $0.10 | Rake $0 
Seat 1: Spieler977 folded before Flop (didn't bet)
Seat 2: Yellowbaanana folded before Flop (didn't bet)
Seat 3: nosachkn (button) folded before Flop (didn't bet)
Seat 4: baadnewz01 (small blind) folded before Flop
Seat 5: Gintaras20 (big blind) collected ($0.10)
Seat 6: raydenel folded before Flop (didn't bet)



PokerStars Hand #222976563022:  Hold'em No Limit ($0.05/$0.10 USD) - 2021/01/23 17:59:48 ET
Table 'Transvaalia' 6-max Seat #4 is the button
Seat 1: Spieler977 ($12.49 in chips) 
Seat 2: Yellowbaanana ($19.04 in chips) 
Seat 3: nosachkn ($10.18 in chips) 
Seat 4: baadnewz01 ($23.13 in chips) 
Seat 5: Gintaras20 ($12.02 in chips) 
Seat 6: raydenel ($10 in chips) 
Gintaras20: posts small blind $0.05
raydenel: posts big blind $0.10
*** HOLE CARDS ***
Spieler977: folds 
Yellowbaanana: calls $0.10
nosachkn: raises $0.30 to $0.40
baadnewz01: folds 
Gintaras20: folds 
raydenel: folds 
Yellowbaanana: folds 
Uncalled bet ($0.30) returned to nosachkn
nosachkn collected $0.35 from pot
nosachkn: doesn't show hand 
*** SUMMARY ***
Total pot $0.35 | Rake $0 
Seat 1: Spieler977 folded before Flop (didn't bet)
Seat 2: Yellowbaanana folded before Flop
Seat 3: nosachkn collected ($0.35)
Seat 4: baadnewz01 (button) folded before Flop (didn't bet)
Seat 5: Gintaras20 (small blind) folded before Flop
Seat 6: raydenel (big blind) folded before Flop



PokerStars Hand #222976576529:  Hold'em No Limit ($0.05/$0.10 USD) - 2021/01/23 18:00:12 ET
Table 'Transvaalia' 6-max Seat #5 is the button
Seat 1: Spieler977 ($12.49 in chips) 
Seat 2: Yellowbaanana ($18.94 in chips) 
Seat 3: nosachkn ($10.43 in chips) 
Seat 4: baadnewz01 ($23.13 in chips) 
Seat 5: Gintaras20 ($11.97 in chips) 
Seat 6: raydenel ($10 in chips) 
raydenel: posts small blind $0.05
Spieler977: posts big blind $0.10
*** HOLE CARDS ***
Yellowbaanana: calls $0.10
nosachkn: folds 
baadnewz01: folds 
Gintaras20: folds 
raydenel: folds 
Spieler977: checks 
*** FLOP *** [3s Ts 9h]
Spieler977: checks 
Yellowbaanana: checks 
*** TURN *** [3s Ts 9h] [Ah]
Spieler977: checks 
Yellowbaanana: bets $0.24
Spieler977: folds 
Uncalled bet ($0.24) returned to Yellowbaanana
Yellowbaanana collected $0.24 from pot
Yellowbaanana: doesn't show hand 
*** SUMMARY ***
Total pot $0.25 | Rake $0.01 
Board [3s Ts 9h Ah]
Seat 1: Spieler977 (big blind) folded on the Turn
Seat 2: Yellowbaanana collected ($0.24)
Seat 3: nosachkn folded before Flop (didn't bet)
Seat 4: baadnewz01 folded before Flop (didn't bet)
Seat 5: Gintaras20 (button) folded before Flop (didn't bet)
Seat 6: raydenel (small blind) folded before Flop



PokerStars Hand #222976592933:  Hold'em No Limit ($0.05/$0.10 USD) - 2021/01/23 18:00:40 ET
Table 'Transvaalia' 6-max Seat #6 is the button
Seat 1: Spieler977 ($12.39 in chips) 
Seat 2: Yellowbaanana ($19.08 in chips) 
Seat 3: nosachkn ($10.43 in chips) 
Seat 4: baadnewz01 ($23.13 in chips) 
Seat 5: Gintaras20 ($11.97 in chips) 
Seat 6: raydenel ($10 in chips) 
Spieler977: posts small blind $0.05
Yellowbaanana: posts big blind $0.10
*** HOLE CARDS ***
nosachkn: folds 
baadnewz01: folds 
Gintaras20: folds 
raydenel: raises $0.10 to $0.20
Spieler977: folds 
Yellowbaanana: calls $0.10
*** FLOP *** [8c 5h 7c]
Yellowbaanana: checks 
raydenel: checks 
*** TURN *** [8c 5h 7c] [9c]
Yellowbaanana: bets $0.43
raydenel: folds 
Uncalled bet ($0.43) returned to Yellowbaanana
Yellowbaanana collected $0.43 from pot
Yellowbaanana: doesn't show hand 
*** SUMMARY ***
Total pot $0.45 | Rake $0.02 
Board [8c 5h 7c 9c]
Seat 1: Spieler977 (small blind) folded before Flop
Seat 2: Yellowbaanana (big blind) collected ($0.43)
Seat 3: nosachkn folded before Flop (didn't bet)
Seat 4: baadnewz01 folded before Flop (didn't bet)
Seat 5: Gintaras20 folded before Flop (didn't bet)
Seat 6: raydenel (button) folded on the Turn



PokerStars Hand #222976613122:  Hold'em No Limit ($0.05/$0.10 USD) - 2021/01/23 18:01:13 ET
Table 'Transvaalia' 6-max Seat #1 is the button
Seat 1: Spieler977 ($12.34 in chips) 
Seat 2: Yellowbaanana ($19.31 in chips) 
Seat 3: nosachkn ($10.43 in chips) 
Seat 4: baadnewz01 ($23.13 in chips) 
Seat 5: Gintaras20 ($11.97 in chips) 
Seat 6: raydenel ($10 in chips) 
Yellowbaanana: posts small blind $0.05
nosachkn: posts big blind $0.10
*** HOLE CARDS ***
baadnewz01: folds 
Gintaras20: folds 
raydenel: folds 
Spieler977: folds 
Yellowbaanana: calls $0.05
nosachkn: checks 
*** FLOP *** [3h 4h Jh]
Yellowbaanana: checks 
nosachkn: bets $0.14
Yellowbaanana: calls $0.14
*** TURN *** [3h 4h Jh] [Kd]
Yellowbaanana: checks 
nosachkn: bets $0.35
Yellowbaanana: calls $0.35
*** RIVER *** [3h 4h Jh Kd] [Ac]
Yellowbaanana: checks 
nosachkn: bets $0.85
Yellowbaanana: calls $0.85
*** SHOW DOWN ***
nosachkn: shows [2h 8h] (a flush, Jack high)
Yellowbaanana: mucks hand 
nosachkn collected $2.75 from pot
*** SUMMARY ***
Total pot $2.88 | Rake $0.13 
Board [3h 4h Jh Kd Ac]
Seat 1: Spieler977 (button) folded before Flop (didn't bet)
Seat 2: Yellowbaanana (small blind) mucked
Seat 3: nosachkn (big blind) showed [2h 8h] and won ($2.75) with a flush, Jack high
Seat 4: baadnewz01 folded before Flop (didn't bet)
Seat 5: Gintaras20 folded before Flop (didn't bet)
Seat 6: raydenel folded before Flop (didn't bet)



PokerStars Hand #222976643747:  Hold'em No Limit ($0.05/$0.10 USD) - 2021/01/23 18:01:59 ET
Table 'Transvaalia' 6-max Seat #2 is the button
Seat 1: Spieler977 ($12.34 in chips) 
Seat 2: Yellowbaanana ($17.87 in chips) 
Seat 3: nosachkn ($11.74 in chips) 
Seat 4: baadnewz01 ($23.13 in chips) 
Seat 5: Gintaras20 ($11.97 in chips) 
Seat 6: raydenel ($10 in chips) 
nosachkn: posts small blind $0.05
baadnewz01: posts big blind $0.10
*** HOLE CARDS ***
Gintaras20: folds 
raydenel: folds 
Spieler977: folds 
Yellowbaanana: calls $0.10
nosachkn: folds 
baadnewz01: checks 
*** FLOP *** [Kc Js Qs]
baadnewz01: checks 
Yellowbaanana: checks 
*** TURN *** [Kc Js Qs] [Ac]
baadnewz01: checks 
Yellowbaanana: checks 
*** RIVER *** [Kc Js Qs Ac] [Kd]
baadnewz01: checks 
Yellowbaanana: checks 
*** SHOW DOWN ***
baadnewz01: shows [6c Jc] (two pair, Kings and Jacks)
Yellowbaanana: mucks hand 
baadnewz01 collected $0.24 from pot
*** SUMMARY ***
Total pot $0.25 | Rake $0.01 
Board [Kc Js Qs Ac Kd]
Seat 1: Spieler977 folded before Flop (didn't bet)
Seat 2: Yellowbaanana (button) mucked
Seat 3: nosachkn (small blind) folded before Flop
Seat 4: baadnewz01 (big blind) showed [6c Jc] and won ($0.24) with two pair, Kings and Jacks
Seat 5: Gintaras20 folded before Flop (didn't bet)
Seat 6: raydenel folded before Flop (didn't bet)



PokerStars Hand #222976668134:  Hold'em No Limit ($0.05/$0.10 USD) - 2021/01/23 18:02:35 ET
Table 'Transvaalia' 6-max Seat #3 is the button
Seat 1: Spieler977 ($12.34 in chips) 
Seat 2: Yellowbaanana ($17.77 in chips) 
Seat 3: nosachkn ($11.69 in chips) 
Seat 4: baadnewz01 ($23.27 in chips) 
Seat 5: Gintaras20 ($11.97 in chips) 
Seat 6: raydenel ($10 in chips) 
baadnewz01: posts small blind $0.05
Gintaras20: posts big blind $0.10
*** HOLE CARDS ***
raydenel: raises $0.20 to $0.30
Spieler977: folds 
Yellowbaanana: calls $0.30
nosachkn: folds 
baadnewz01: folds 
Gintaras20: calls $0.20
*** FLOP *** [Kh 6c Kc]
Gintaras20: checks 
raydenel: checks 
Yellowbaanana: bets $0.91
Gintaras20: folds 
raydenel: folds 
Uncalled bet ($0.91) returned to Yellowbaanana
Yellowbaanana collected $0.91 from pot
Yellowbaanana: doesn't show hand 
*** SUMMARY ***
Total pot $0.95 | Rake $0.04 
Board [Kh 6c Kc]
Seat 1: Spieler977 folded before Flop (didn't bet)
Seat 2: Yellowbaanana collected ($0.91)
Seat 3: nosachkn (button) folded before Flop (didn't bet)
Seat 4: baadnewz01 (small blind) folded before Flop
Seat 5: Gintaras20 (big blind) folded on the Flop
Seat 6: raydenel folded on the Flop



PokerStars Hand #222976691742:  Hold'em No Limit ($0.05/$0.10 USD) - 2021/01/23 18:03:08 ET
Table 'Transvaalia' 6-max Seat #4 is the button
Seat 1: Spieler977 ($12.34 in chips) 
Seat 2: Yellowbaanana ($18.38 in chips) 
Seat 3: nosachkn ($11.69 in chips) 
Seat 4: baadnewz01 ($23.22 in chips) 
Seat 5: Gintaras20 ($11.67 in chips) 
Seat 6: raydenel ($10 in chips) 
Gintaras20: posts small blind $0.05
raydenel: posts big blind $0.10
*** HOLE CARDS ***
Spieler977: folds 
Yellowbaanana: calls $0.10
nosachkn: raises $0.30 to $0.40
baadnewz01: folds 
Gintaras20: folds 
raydenel: folds 
Yellowbaanana: folds 
Uncalled bet ($0.30) returned to nosachkn
nosachkn collected $0.35 from pot
nosachkn: doesn't show hand 
*** SUMMARY ***
Total pot $0.35 | Rake $0 
Seat 1: Spieler977 folded before Flop (didn't bet)
Seat 2: Yellowbaanana folded before Flop
Seat 3: nosachkn collected ($0.35)
Seat 4: baadnewz01 (button) folded before Flop (didn't bet)
Seat 5: Gintaras20 (small blind) folded before Flop
Seat 6: raydenel (big blind) folded before Flop



PokerStars Hand #222976704005:  Hold'em No Limit ($0.05/$0.10 USD) - 2021/01/23 18:03:25 ET
Table 'Transvaalia' 6-max Seat #5 is the button
Seat 1: Spieler977 ($12.34 in chips) 
Seat 2: Yellowbaanana ($18.28 in chips) 
Seat 3: nosachkn ($11.94 in chips) 
Seat 4: baadnewz01 ($23.22 in chips) 
Seat 5: Gintaras20 ($11.62 in chips) 
Seat 6: raydenel ($10 in chips) 
raydenel: posts small blind $0.05
Spieler977: posts big blind $0.10
*** HOLE CARDS ***
Yellowbaanana: folds 
nosachkn: folds 
baadnewz01: folds 
Gintaras20: folds 
raydenel: folds 
Uncalled bet ($0.05) returned to Spieler977
Spieler977 collected $0.10 from pot
Spieler977: doesn't show hand 
*** SUMMARY ***
Total pot $0.10 | Rake $0 
Seat 1: Spieler977 (big blind) collected ($0.10)
Seat 2: Yellowbaanana folded before Flop (didn't bet)
Seat 3: nosachkn folded before Flop (didn't bet)
Seat 4: baadnewz01 folded before Flop (didn't bet)
Seat 5: Gintaras20 (button) folded before Flop (didn't bet)
Seat 6: raydenel (small blind) folded before Flop



PokerStars Hand #222976709109:  Hold'em No Limit ($0.05/$0.10 USD) - 2021/01/23 18:03:33 ET
Table 'Transvaalia' 6-max Seat #6 is the button
Seat 1: Spieler977 ($12.39 in chips) 
Seat 2: Yellowbaanana ($18.28 in chips) 
Seat 3: nosachkn ($11.94 in chips) 
Seat 4: baadnewz01 ($23.22 in chips) 
Seat 5: Gintaras20 ($11.62 in chips) 
Seat 6: raydenel ($10 in chips) 
Spieler977: posts small blind $0.05
Yellowbaanana: posts big blind $0.10
*** HOLE CARDS ***
nosachkn: folds 
baadnewz01: raises $0.20 to $0.30
Gintaras20: folds 
raydenel: folds 
Spieler977: folds 
Yellowbaanana: calls $0.20
*** FLOP *** [Jc Qc 6s]
Yellowbaanana: checks 
baadnewz01: checks 
*** TURN *** [Jc Qc 6s] [Td]
Yellowbaanana: checks 
baadnewz01: checks 
*** RIVER *** [Jc Qc 6s Td] [7s]
Yellowbaanana: bets $0.31
baadnewz01: folds 
Uncalled bet ($0.31) returned to Yellowbaanana
Yellowbaanana collected $0.62 from pot
Yellowbaanana: doesn't show hand 
*** SUMMARY ***
Total pot $0.65 | Rake $0.03 
Board [Jc Qc 6s Td 7s]
Seat 1: Spieler977 (small blind) folded before Flop
Seat 2: Yellowbaanana (big blind) collected ($0.62)
Seat 3: nosachkn folded before Flop (didn't bet)
Seat 4: baadnewz01 folded on the River
Seat 5: Gintaras20 folded before Flop (didn't bet)
Seat 6: raydenel (button) folded before Flop (didn't bet)



PokerStars Hand #222976753804:  Hold'em No Limit ($0.05/$0.10 USD) - 2021/01/23 18:04:36 ET
Table 'Transvaalia' 6-max Seat #1 is the button
Seat 1: Spieler977 ($12.34 in chips) 
Seat 2: Yellowbaanana ($18.60 in chips) 
Seat 3: nosachkn ($11.94 in chips) 
Seat 4: baadnewz01 ($22.92 in chips) 
Seat 5: Gintaras20 ($11.62 in chips) 
Seat 6: raydenel ($10 in chips) 
Yellowbaanana: posts small blind $0.05
nosachkn: posts big blind $0.10
*** HOLE CARDS ***
baadnewz01: folds 
Gintaras20: folds 
raydenel: folds 
Spieler977: folds 
Yellowbaanana: calls $0.05
nosachkn: raises $0.30 to $0.40
Yellowbaanana: folds 
Uncalled bet ($0.30) returned to nosachkn
nosachkn collected $0.20 from pot
nosachkn: doesn't show hand 
*** SUMMARY ***
Total pot $0.20 | Rake $0 
Seat 1: Spieler977 (button) folded before Flop (didn't bet)
Seat 2: Yellowbaanana (small blind) folded before Flop
Seat 3: nosachkn (big blind) collected ($0.20)
Seat 4: baadnewz01 folded before Flop (didn't bet)
Seat 5: Gintaras20 folded before Flop (didn't bet)
Seat 6: raydenel folded before Flop (didn't bet)



PokerStars Hand #222976771682:  Hold'em No Limit ($0.05/$0.10 USD) - 2021/01/23 18:05:01 ET
Table 'Transvaalia' 6-max Seat #2 is the button
Seat 1: Spieler977 ($12.34 in chips) 
Seat 2: Yellowbaanana ($18.50 in chips) 
Seat 3: nosachkn ($12.04 in chips) 
Seat 4: baadnewz01 ($22.92 in chips) 
Seat 5: Gintaras20 ($11.62 in chips) 
Seat 6: raydenel ($10 in chips) 
nosachkn: posts small blind $0.05
baadnewz01: posts big blind $0.10
*** HOLE CARDS ***
Gintaras20: folds 
raydenel: raises $0.20 to $0.30
Spieler977: folds 
Yellowbaanana: folds 
nosachkn: folds 
baadnewz01: calls $0.20
*** FLOP *** [9h 4d 3s]
baadnewz01: checks 
raydenel: bets $0.40
baadnewz01: calls $0.40
*** TURN *** [9h 4d 3s] [Th]
baadnewz01: checks 
raydenel: bets $0.70
baadnewz01: folds 
Uncalled bet ($0.70) returned to raydenel
raydenel collected $1.38 from pot
raydenel: doesn't show hand 
*** SUMMARY ***
Total pot $1.45 | Rake $0.07 
Board [9h 4d 3s Th]
Seat 1: Spieler977 folded before Flop (didn't bet)
Seat 2: Yellowbaanana (button) folded before Flop (didn't bet)
Seat 3: nosachkn (small blind) folded before Flop
Seat 4: baadnewz01 (big blind) folded on the Turn
Seat 5: Gintaras20 folded before Flop (didn't bet)
Seat 6: raydenel collected ($1.38)



PokerStars Hand #222976830179:  Hold'em No Limit ($0.05/$0.10 USD) - 2021/01/23 18:06:23 ET
Table 'Transvaalia' 6-max Seat #3 is the button
Seat 1: Spieler977 ($12.34 in chips) 
Seat 2: Yellowbaanana ($18.50 in chips) 
Seat 3: nosachkn ($11.99 in chips) 
Seat 4: baadnewz01 ($22.22 in chips) 
Seat 5: Gintaras20 ($11.62 in chips) 
Seat 6: raydenel ($10.68 in chips) 
baadnewz01: posts small blind $0.05
Gintaras20: posts big blind $0.10
*** HOLE CARDS ***
raydenel: folds 
Spieler977: folds 
Yellowbaanana: folds 
nosachkn: folds 
baadnewz01: folds 
Uncalled bet ($0.05) returned to Gintaras20
Gintaras20 collected $0.10 from pot
Gintaras20: doesn't show hand 
*** SUMMARY ***
Total pot $0.10 | Rake $0 
Seat 1: Spieler977 folded before Flop (didn't bet)
Seat 2: Yellowbaanana folded before Flop (didn't bet)
Seat 3: nosachkn (button) folded before Flop (didn't bet)
Seat 4: baadnewz01 (small blind) folded before Flop
Seat 5: Gintaras20 (big blind) collected ($0.10)
Seat 6: raydenel folded before Flop (didn't bet)



PokerStars Hand #222976837526:  Hold'em No Limit ($0.05/$0.10 USD) - 2021/01/23 18:06:34 ET
Table 'Transvaalia' 6-max Seat #4 is the button
Seat 1: Spieler977 ($12.34 in chips) 
Seat 2: Yellowbaanana ($18.50 in chips) 
Seat 3: nosachkn ($11.99 in chips) 
Seat 4: baadnewz01 ($22.17 in chips) 
Seat 5: Gintaras20 ($11.67 in chips) 
Seat 6: raydenel ($10.68 in chips) 
Gintaras20: posts small blind $0.05
raydenel: posts big blind $0.10
*** HOLE CARDS ***
Spieler977: folds 
Yellowbaanana: folds 
nosachkn: folds 
baadnewz01: raises $0.20 to $0.30
Gintaras20: folds 
raydenel: folds 
Uncalled bet ($0.20) returned to baadnewz01
baadnewz01 collected $0.25 from pot
baadnewz01: doesn't show hand 
*** SUMMARY ***
Total pot $0.25 | Rake $0 
Seat 1: Spieler977 folded before Flop (didn't bet)
Seat 2: Yellowbaanana folded before Flop (didn't bet)
Seat 3: nosachkn folded before Flop (didn't bet)
Seat 4: baadnewz01 (button) collected ($0.25)
Seat 5: Gintaras20 (small blind) folded before Flop
Seat 6: raydenel (big blind) folded before Flop



PokerStars Hand #222976854774:  Hold'em No Limit ($0.05/$0.10 USD) - 2021/01/23 18:06:58 ET
Table 'Transvaalia' 6-max Seat #5 is the button
Seat 1: Spieler977 ($12.34 in chips) 
Seat 2: Yellowbaanana ($18.50 in chips) 
Seat 3: nosachkn ($11.99 in chips) 
Seat 4: baadnewz01 ($22.32 in chips) 
Seat 5: Gintaras20 ($11.62 in chips) 
Seat 6: raydenel ($10.58 in chips) 
raydenel: posts small blind $0.05
Spieler977: posts big blind $0.10
*** HOLE CARDS ***
Yellowbaanana: calls $0.10
nosachkn: raises $0.30 to $0.40
baadnewz01: folds 
Gintaras20: folds 
raydenel: calls $0.35
Spieler977: folds 
Yellowbaanana: calls $0.30
*** FLOP *** [Jc Kd Ac]
raydenel: checks 
Yellowbaanana: checks 
nosachkn: bets $0.83
raydenel: folds 
Yellowbaanana: folds 
Uncalled bet ($0.83) returned to nosachkn
nosachkn collected $1.24 from pot
nosachkn: doesn't show hand 
*** SUMMARY ***
Total pot $1.30 | Rake $0.06 
Board [Jc Kd Ac]
Seat 1: Spieler977 (big blind) folded before Flop
Seat 2: Yellowbaanana folded on the Flop
Seat 3: nosachkn collected ($1.24)
Seat 4: baadnewz01 folded before Flop (didn't bet)
Seat 5: Gintaras20 (button) folded before Flop (didn't bet)
Seat 6: raydenel (small blind) folded on the Flop



PokerStars Hand #222976879401:  Hold'em No Limit ($0.05/$0.10 USD) - 2021/01/23 18:07:33 ET
Table 'Transvaalia' 6-max Seat #6 is the button
Seat 1: Spieler977 ($12.24 in chips) 
Seat 2: Yellowbaanana ($18.10 in chips) 
Seat 3: nosachkn ($12.83 in chips) 
Seat 4: baadnewz01 ($22.32 in chips) 
Seat 5: Gintaras20 ($11.62 in chips) 
Seat 6: raydenel ($10.18 in chips) 
Spieler977: posts small blind $0.05
Yellowbaanana: posts big blind $0.10
*** HOLE CARDS ***
nosachkn: folds 
baadnewz01: folds 
Gintaras20: raises $0.15 to $0.25
raydenel: calls $0.25
Spieler977: folds 
Yellowbaanana: folds 
*** FLOP *** [2h 2s 7s]
Gintaras20: bets $0.31
raydenel: calls $0.31
*** TURN *** [2h 2s 7s] [9c]
Gintaras20: checks 
raydenel: checks 
*** RIVER *** [2h 2s 7s 9c] [As]
Gintaras20: checks 
raydenel: checks 
*** SHOW DOWN ***
Gintaras20: shows [Jc Ad] (two pair, Aces and Deuces)
raydenel: mucks hand 
Gintaras20 collected $1.21 from pot
*** SUMMARY ***
Total pot $1.27 | Rake $0.06 
Board [2h 2s 7s 9c As]
Seat 1: Spieler977 (small blind) folded before Flop
Seat 2: Yellowbaanana (big blind) folded before Flop
Seat 3: nosachkn folded before Flop (didn't bet)
Seat 4: baadnewz01 folded before Flop (didn't bet)
Seat 5: Gintaras20 showed [Jc Ad] and won ($1.21) with two pair, Aces and Deuces
Seat 6: raydenel (button) mucked



PokerStars Hand #222976897408:  Hold'em No Limit ($0.05/$0.10 USD) - 2021/01/23 18:07:59 ET
Table 'Transvaalia' 6-max Seat #1 is the button
Seat 1: Spieler977 ($12.19 in chips) 
Seat 2: Yellowbaanana ($18 in chips) 
Seat 3: nosachkn ($12.83 in chips) 
Seat 4: baadnewz01 ($22.32 in chips) 
Seat 5: Gintaras20 ($12.27 in chips) 
Seat 6: raydenel ($10 in chips) 
Yellowbaanana: posts small blind $0.05
nosachkn: posts big blind $0.10
*** HOLE CARDS ***
baadnewz01: folds 
Gintaras20: folds 
raydenel: folds 
Spieler977: folds 
Yellowbaanana: calls $0.05
nosachkn: raises $0.30 to $0.40
Yellowbaanana: calls $0.30
*** FLOP *** [3d 2s 3c]
Yellowbaanana: checks 
nosachkn: checks 
*** TURN *** [3d 2s 3c] [4s]
Yellowbaanana: checks 
nosachkn: checks 
*** RIVER *** [3d 2s 3c 4s] [5s]
Yellowbaanana: checks 
nosachkn: checks 
*** SHOW DOWN ***
Yellowbaanana: shows [9c Qs] (a pair of Threes)
nosachkn: shows [Kd 7s] (a pair of Threes - King kicker)
nosachkn collected $0.76 from pot
*** SUMMARY ***
Total pot $0.80 | Rake $0.04 
Board [3d 2s 3c 4s 5s]
Seat 1: Spieler977 (button) folded before Flop (didn't bet)
Seat 2: Yellowbaanana (small blind) showed [9c Qs] and lost with a pair of Threes
Seat 3: nosachkn (big blind) showed [Kd 7s] and won ($0.76) with a pair of Threes
Seat 4: baadnewz01 folded before Flop (didn't bet)
Seat 5: Gintaras20 folded before Flop (didn't bet)
Seat 6: raydenel folded before Flop (didn't bet)



PokerStars Hand #222976923320:  Hold'em No Limit ($0.05/$0.10 USD) - 2021/01/23 18:08:36 ET
Table 'Transvaalia' 6-max Seat #2 is the button
Seat 1: Spieler977 ($12.19 in chips) 
Seat 2: Yellowbaanana ($17.60 in chips) 
Seat 3: nosachkn ($13.19 in chips) 
Seat 4: baadnewz01 ($22.32 in chips) 
Seat 5: Gintaras20 ($12.27 in chips) 
Seat 6: raydenel ($10 in chips) 
nosachkn: posts small blind $0.05
baadnewz01: posts big blind $0.10
*** HOLE CARDS ***
Gintaras20: folds 
raydenel: folds 
Spieler977: folds 
Yellowbaanana: calls $0.10
nosachkn: folds 
baadnewz01: checks 
*** FLOP *** [Js 6d Td]
baadnewz01: checks 
Yellowbaanana: bets $0.24
baadnewz01: folds 
Uncalled bet ($0.24) returned to Yellowbaanana
Yellowbaanana collected $0.24 from pot
Yellowbaanana: doesn't show hand 
*** SUMMARY ***
Total pot $0.25 | Rake $0.01 
Board [Js 6d Td]
Seat 1: Spieler977 folded before Flop (didn't bet)
Seat 2: Yellowbaanana (button) collected ($0.24)
Seat 3: nosachkn (small blind) folded before Flop
Seat 4: baadnewz01 (big blind) folded on the Flop
Seat 5: Gintaras20 folded before Flop (didn't bet)
Seat 6: raydenel folded before Flop (didn't bet)



PokerStars Hand #222976938975:  Hold'em No Limit ($0.05/$0.10 USD) - 2021/01/23 18:08:59 ET
Table 'Transvaalia' 6-max Seat #3 is the button
Seat 1: Spieler977 ($12.19 in chips) 
Seat 2: Yellowbaanana ($17.74 in chips) 
Seat 3: nosachkn ($13.14 in chips) 
Seat 4: baadnewz01 ($22.22 in chips) 
Seat 5: Gintaras20 ($12.27 in chips) 
Seat 6: raydenel ($10 in chips) 
baadnewz01: posts small blind $0.05
Gintaras20: posts big blind $0.10
*** HOLE CARDS ***
raydenel: folds 
Spieler977: folds 
Yellowbaanana: folds 
nosachkn: folds 
baadnewz01: folds 
Uncalled bet ($0.05) returned to Gintaras20
Gintaras20 collected $0.10 from pot
Gintaras20: doesn't show hand 
*** SUMMARY ***
Total pot $0.10 | Rake $0 
Seat 1: Spieler977 folded before Flop (didn't bet)
Seat 2: Yellowbaanana folded before Flop (didn't bet)
Seat 3: nosachkn (button) folded before Flop (didn't bet)
Seat 4: baadnewz01 (small blind) folded before Flop
Seat 5: Gintaras20 (big blind) collected ($0.10)
Seat 6: raydenel folded before Flop (didn't bet)



PokerStars Hand #222976946760:  Hold'em No Limit ($0.05/$0.10 USD) - 2021/01/23 18:09:10 ET
Table 'Transvaalia' 6-max Seat #4 is the button
Seat 1: Spieler977 ($12.19 in chips) 
Seat 2: Yellowbaanana ($17.74 in chips) 
Seat 3: nosachkn ($13.14 in chips) 
Seat 4: baadnewz01 ($22.17 in chips) 
Seat 5: Gintaras20 ($12.32 in chips) 
Seat 6: raydenel ($10 in chips) 
Gintaras20: posts small blind $0.05
raydenel: posts big blind $0.10
*** HOLE CARDS ***
Spieler977: folds 
Yellowbaanana: calls $0.10
nosachkn: raises $0.30 to $0.40
baadnewz01: folds 
Gintaras20: folds 
raydenel: folds 
Yellowbaanana: folds 
Uncalled bet ($0.30) returned to nosachkn
nosachkn collected $0.35 from pot
nosachkn: doesn't show hand 
*** SUMMARY ***
Total pot $0.35 | Rake $0 
Seat 1: Spieler977 folded before Flop (didn't bet)
Seat 2: Yellowbaanana folded before Flop
Seat 3: nosachkn collected ($0.35)
Seat 4: baadnewz01 (button) folded before Flop (didn't bet)
Seat 5: Gintaras20 (small blind) folded before Flop
Seat 6: raydenel (big blind) folded before Flop



PokerStars Hand #222976959766:  Hold'em No Limit ($0.05/$0.10 USD) - 2021/01/23 18:09:29 ET
Table 'Transvaalia' 6-max Seat #5 is the button
Seat 1: Spieler977 ($12.19 in chips) 
Seat 2: Yellowbaanana ($17.64 in chips) 
Seat 3: nosachkn ($13.39 in chips) 
Seat 4: baadnewz01 ($22.17 in chips) 
Seat 5: Gintaras20 ($12.27 in chips) 
Seat 6: raydenel ($10 in chips) 
raydenel: posts small blind $0.05
Spieler977: posts big blind $0.10
*** HOLE CARDS ***
Yellowbaanana: folds 
nosachkn: folds 
baadnewz01: raises $0.20 to $0.30
Gintaras20: folds 
raydenel: folds 
Spieler977: calls $0.20
*** FLOP *** [Kc 7h 5h]
Spieler977: checks 
baadnewz01: bets $0.30
Spieler977: folds 
Uncalled bet ($0.30) returned to baadnewz01
baadnewz01 collected $0.62 from pot
baadnewz01: doesn't show hand 
*** SUMMARY ***
Total pot $0.65 | Rake $0.03 
Board [Kc 7h 5h]
Seat 1: Spieler977 (big blind) folded on the Flop
Seat 2: Yellowbaanana folded before Flop (didn't bet)
Seat 3: nosachkn folded before Flop (didn't bet)
Seat 4: baadnewz01 collected ($0.62)
Seat 5: Gintaras20 (button) folded before Flop (didn't bet)
Seat 6: raydenel (small blind) folded before Flop



PokerStars Hand #222976995543:  Hold'em No Limit ($0.05/$0.10 USD) - 2021/01/23 18:10:03 ET
Table 'Transvaalia' 6-max Seat #6 is the button
Seat 1: Spieler977 ($11.89 in chips) 
Seat 2: Yellowbaanana ($17.64 in chips) 
Seat 3: nosachkn ($13.39 in chips) 
Seat 4: baadnewz01 ($22.49 in chips) 
Seat 5: Gintaras20 ($12.27 in chips) 
Seat 6: raydenel ($10 in chips) 
Spieler977: posts small blind $0.05
Yellowbaanana: posts big blind $0.10
*** HOLE CARDS ***
nosachkn: folds 
baadnewz01: raises $0.20 to $0.30
Gintaras20: folds 
raydenel: folds 
Spieler977: folds 
Yellowbaanana: folds 
Uncalled bet ($0.20) returned to baadnewz01
baadnewz01 collected $0.25 from pot
baadnewz01: doesn't show hand 
*** SUMMARY ***
Total pot $0.25 | Rake $0 
Seat 1: Spieler977 (small blind) folded before Flop
Seat 2: Yellowbaanana (big blind) folded before Flop
Seat 3: nosachkn folded before Flop (didn't bet)
Seat 4: baadnewz01 collected ($0.25)
Seat 5: Gintaras20 folded before Flop (didn't bet)
Seat 6: raydenel (button) folded before Flop (didn't bet)



PokerStars Hand #222977007259:  Hold'em No Limit ($0.05/$0.10 USD) - 2021/01/23 18:10:20 ET
Table 'Transvaalia' 6-max Seat #1 is the button
Seat 1: Spieler977 ($11.84 in chips) 
Seat 2: Yellowbaanana ($17.54 in chips) 
Seat 3: nosachkn ($13.39 in chips) 
Seat 4: baadnewz01 ($22.64 in chips) 
Seat 5: Gintaras20 ($12.27 in chips) 
Seat 6: raydenel ($10 in chips) 
Yellowbaanana: posts small blind $0.05
nosachkn: posts big blind $0.10
*** HOLE CARDS ***
baadnewz01: folds 
Gintaras20: folds 
raydenel: raises $0.15 to $0.25
Spieler977: folds 
Yellowbaanana: calls $0.20
nosachkn: folds 
*** FLOP *** [Qh 7s 9d]
Yellowbaanana: checks 
raydenel: bets $0.30
Yellowbaanana: folds 
Uncalled bet ($0.30) returned to raydenel
raydenel collected $0.57 from pot
raydenel: doesn't show hand 
*** SUMMARY ***
Total pot $0.60 | Rake $0.03 
Board [Qh 7s 9d]
Seat 1: Spieler977 (button) folded before Flop (didn't bet)
Seat 2: Yellowbaanana (small blind) folded on the Flop
Seat 3: nosachkn (big blind) folded before Flop
Seat 4: baadnewz01 folded before Flop (didn't bet)
Seat 5: Gintaras20 folded before Flop (didn't bet)
Seat 6: raydenel collected ($0.57)



PokerStars Hand #222977024563:  Hold'em No Limit ($0.05/$0.10 USD) - 2021/01/23 18:10:45 ET
Table 'Transvaalia' 6-max Seat #2 is the button
Seat 1: Spieler977 ($11.84 in chips) 
Seat 2: Yellowbaanana ($17.29 in chips) 
Seat 3: nosachkn ($13.29 in chips) 
Seat 4: baadnewz01 ($22.64 in chips) 
Seat 5: Gintaras20 ($12.27 in chips) 
Seat 6: raydenel ($10.32 in chips) 
nosachkn: posts small blind $0.05
baadnewz01: posts big blind $0.10
*** HOLE CARDS ***
Gintaras20: folds 
raydenel: raises $0.10 to $0.20
Spieler977: folds 
Yellowbaanana: folds 
nosachkn: folds 
baadnewz01: folds 
Uncalled bet ($0.10) returned to raydenel
raydenel collected $0.25 from pot
*** SUMMARY ***
Total pot $0.25 | Rake $0 
Seat 1: Spieler977 folded before Flop (didn't bet)
Seat 2: Yellowbaanana (button) folded before Flop (didn't bet)
Seat 3: nosachkn (small blind) folded before Flop
Seat 4: baadnewz01 (big blind) folded before Flop
Seat 5: Gintaras20 folded before Flop (didn't bet)
Seat 6: raydenel collected ($0.25)



PokerStars Hand #222977033363:  Hold'em No Limit ($0.05/$0.10 USD) - 2021/01/23 18:10:58 ET
Table 'Transvaalia' 6-max Seat #3 is the button
Seat 1: Spieler977 ($11.84 in chips) 
Seat 2: Yellowbaanana ($17.29 in chips) 
Seat 3: nosachkn ($13.24 in chips) 
Seat 4: baadnewz01 ($22.54 in chips) 
Seat 5: Gintaras20 ($12.27 in chips) 
Seat 6: raydenel ($10.47 in chips) 
baadnewz01: posts small blind $0.05
Gintaras20: posts big blind $0.10
*** HOLE CARDS ***
raydenel: folds 
Spieler977: folds 
Yellowbaanana: folds 
nosachkn: raises $0.20 to $0.30
baadnewz01: folds 
Gintaras20: folds 
Uncalled bet ($0.20) returned to nosachkn
nosachkn collected $0.25 from pot
nosachkn: doesn't show hand 
*** SUMMARY ***
Total pot $0.25 | Rake $0 
Seat 1: Spieler977 folded before Flop (didn't bet)
Seat 2: Yellowbaanana folded before Flop (didn't bet)
Seat 3: nosachkn (button) collected ($0.25)
Seat 4: baadnewz01 (small blind) folded before Flop
Seat 5: Gintaras20 (big blind) folded before Flop
Seat 6: raydenel folded before Flop (didn't bet)



PokerStars Hand #222977043200:  Hold'em No Limit ($0.05/$0.10 USD) - 2021/01/23 18:11:12 ET
Table 'Transvaalia' 6-max Seat #4 is the button
Seat 1: Spieler977 ($11.84 in chips) 
Seat 2: Yellowbaanana ($17.29 in chips) 
Seat 3: nosachkn ($13.39 in chips) 
Seat 4: baadnewz01 ($22.49 in chips) 
Seat 5: Gintaras20 ($12.17 in chips) 
Seat 6: raydenel ($10.47 in chips) 
Gintaras20: posts small blind $0.05
raydenel: posts big blind $0.10
*** HOLE CARDS ***
Spieler977: folds 
Yellowbaanana: calls $0.10
nosachkn has timed out
nosachkn: folds 
baadnewz01: raises $0.30 to $0.40
Gintaras20: folds 
raydenel: folds 
Yellowbaanana: calls $0.30
*** FLOP *** [Qd Jc Td]
Yellowbaanana: checks 
baadnewz01: checks 
*** TURN *** [Qd Jc Td] [Ts]
Yellowbaanana: checks 
baadnewz01: checks 
*** RIVER *** [Qd Jc Td Ts] [Tc]
Yellowbaanana: checks 
baadnewz01: checks 
*** SHOW DOWN ***
Yellowbaanana: shows [3d 3s] (a full house, Tens full of Threes)
baadnewz01: shows [6s 6h] (a full house, Tens full of Sixes)
baadnewz01 collected $0.91 from pot
*** SUMMARY ***
Total pot $0.95 | Rake $0.04 
Board [Qd Jc Td Ts Tc]
Seat 1: Spieler977 folded before Flop (didn't bet)
Seat 2: Yellowbaanana showed [3d 3s] and lost with a full house, Tens full of Threes
Seat 3: nosachkn folded before Flop (didn't bet)
Seat 4: baadnewz01 (button) showed [6s 6h] and won ($0.91) with a full house, Tens full of Sixes
Seat 5: Gintaras20 (small blind) folded before Flop
Seat 6: raydenel (big blind) folded before Flop



PokerStars Hand #222977068479:  Hold'em No Limit ($0.05/$0.10 USD) - 2021/01/23 18:11:49 ET
Table 'Transvaalia' 6-max Seat #5 is the button
Seat 1: Spieler977 ($11.84 in chips) 
Seat 2: Yellowbaanana ($16.89 in chips) 
Seat 3: nosachkn ($13.39 in chips) 
Seat 4: baadnewz01 ($23 in chips) 
Seat 5: Gintaras20 ($12.12 in chips) 
Seat 6: raydenel ($10.37 in chips) 
raydenel: posts small blind $0.05
Spieler977: posts big blind $0.10
*** HOLE CARDS ***
Yellowbaanana: calls $0.10
nosachkn: raises $0.40 to $0.50
baadnewz01: folds 
Gintaras20: calls $0.50
raydenel: folds 
Spieler977: folds 
Yellowbaanana: folds 
*** FLOP *** [Ks 6c Tc]
nosachkn: checks 
Gintaras20: bets $0.60
nosachkn: calls $0.60
*** TURN *** [Ks 6c Tc] [5h]
nosachkn: checks 
Gintaras20: bets $1.17
nosachkn: raises $2.34 to $3.51
Gintaras20: calls $2.34
*** RIVER *** [Ks 6c Tc 5h] [6h]
nosachkn: bets $8.78 and is all-in
Gintaras20: calls $7.51 and is all-in
Uncalled bet ($1.27) returned to nosachkn
*** SHOW DOWN ***
nosachkn: shows [Kc Kh] (a full house, Kings full of Sixes)
Gintaras20: shows [Td Jd] (two pair, Tens and Sixes)
nosachkn collected $23.39 from pot
*** SUMMARY ***
Total pot $24.49 | Rake $1.10 
Board [Ks 6c Tc 5h 6h]
Seat 1: Spieler977 (big blind) folded before Flop
Seat 2: Yellowbaanana folded before Flop
Seat 3: nosachkn showed [Kc Kh] and won ($23.39) with a full house, Kings full of Sixes
Seat 4: baadnewz01 folded before Flop (didn't bet)
Seat 5: Gintaras20 (button) showed [Td Jd] and lost with two pair, Tens and Sixes
Seat 6: raydenel (small blind) folded before Flop



PokerStars Hand #222977114235:  Hold'em No Limit ($0.05/$0.10 USD) - 2021/01/23 18:12:55 ET
Table 'Transvaalia' 6-max Seat #6 is the button
Seat 1: Spieler977 ($11.74 in chips) 
Seat 2: Yellowbaanana ($16.79 in chips) 
Seat 3: nosachkn ($24.66 in chips) 
Seat 4: baadnewz01 ($23 in chips) 
Seat 5: Gintaras20 ($4 in chips) 
Seat 6: raydenel ($10.32 in chips) 
Spieler977: posts small blind $0.05
Yellowbaanana: posts big blind $0.10
*** HOLE CARDS ***
nosachkn: folds 
baadnewz01: folds 
Gintaras20: raises $0.15 to $0.25
raydenel: folds 
Spieler977: folds 
Yellowbaanana: folds 
Uncalled bet ($0.15) returned to Gintaras20
Gintaras20 collected $0.25 from pot
Gintaras20: doesn't show hand 
*** SUMMARY ***
Total pot $0.25 | Rake $0 
Seat 1: Spieler977 (small blind) folded before Flop
Seat 2: Yellowbaanana (big blind) folded before Flop
Seat 3: nosachkn folded before Flop (didn't bet)
Seat 4: baadnewz01 folded before Flop (didn't bet)
Seat 5: Gintaras20 collected ($0.25)
Seat 6: raydenel (button) folded before Flop (didn't bet)



PokerStars Hand #222977123297:  Hold'em No Limit ($0.05/$0.10 USD) - 2021/01/23 18:13:08 ET
Table 'Transvaalia' 6-max Seat #1 is the button
Seat 1: Spieler977 ($11.69 in chips) 
Seat 2: Yellowbaanana ($16.69 in chips) 
Seat 3: nosachkn ($24.66 in chips) 
Seat 4: baadnewz01 ($23 in chips) 
Seat 5: Gintaras20 ($10 in chips) 
Seat 6: raydenel ($10.32 in chips) 
Yellowbaanana: posts small blind $0.05
nosachkn: posts big blind $0.10
*** HOLE CARDS ***
baadnewz01: folds 
Gintaras20: folds 
raydenel: folds 
Spieler977: folds 
Yellowbaanana: calls $0.05
nosachkn: checks 
*** FLOP *** [6d Js 7h]
Yellowbaanana: checks 
nosachkn: checks 
*** TURN *** [6d Js 7h] [4c]
Yellowbaanana: checks 
nosachkn: checks 
*** RIVER *** [6d Js 7h 4c] [Jd]
Yellowbaanana: checks 
nosachkn: checks 
*** SHOW DOWN ***
Yellowbaanana: shows [Ac Kd] (a pair of Jacks)
nosachkn: shows [Tc 7c] (two pair, Jacks and Sevens)
nosachkn collected $0.19 from pot
*** SUMMARY ***
Total pot $0.20 | Rake $0.01 
Board [6d Js 7h 4c Jd]
Seat 1: Spieler977 (button) folded before Flop (didn't bet)
Seat 2: Yellowbaanana (small blind) showed [Ac Kd] and lost with a pair of Jacks
Seat 3: nosachkn (big blind) showed [Tc 7c] and won ($0.19) with two pair, Jacks and Sevens
Seat 4: baadnewz01 folded before Flop (didn't bet)
Seat 5: Gintaras20 folded before Flop (didn't bet)
Seat 6: raydenel folded before Flop (didn't bet)



PokerStars Hand #222977141493:  Hold'em No Limit ($0.05/$0.10 USD) - 2021/01/23 18:13:35 ET
Table 'Transvaalia' 6-max Seat #2 is the button
Seat 1: Spieler977 ($11.69 in chips) 
Seat 2: Yellowbaanana ($16.59 in chips) 
Seat 3: nosachkn ($24.75 in chips) 
Seat 4: baadnewz01 ($23 in chips) 
Seat 5: Gintaras20 ($10 in chips) 
Seat 6: raydenel ($10.32 in chips) 
nosachkn: posts small blind $0.05
baadnewz01: posts big blind $0.10
*** HOLE CARDS ***
Gintaras20: folds 
raydenel: folds 
Spieler977: raises $0.20 to $0.30
Yellowbaanana: folds 
nosachkn: folds 
baadnewz01: calls $0.20
*** FLOP *** [Th Td 4h]
baadnewz01: checks 
Spieler977: bets $0.47
baadnewz01: folds 
Uncalled bet ($0.47) returned to Spieler977
Spieler977 collected $0.62 from pot
Spieler977: doesn't show hand 
*** SUMMARY ***
Total pot $0.65 | Rake $0.03 
Board [Th Td 4h]
Seat 1: Spieler977 collected ($0.62)
Seat 2: Yellowbaanana (button) folded before Flop (didn't bet)
Seat 3: nosachkn (small blind) folded before Flop
Seat 4: baadnewz01 (big blind) folded on the Flop
Seat 5: Gintaras20 folded before Flop (didn't bet)
Seat 6: raydenel folded before Flop (didn't bet)



PokerStars Hand #222977191466:  Hold'em No Limit ($0.05/$0.10 USD) - 2021/01/23 18:14:48 ET
Table 'Transvaalia' 6-max Seat #3 is the button
Seat 1: Spieler977 ($12.01 in chips) 
Seat 2: Yellowbaanana ($16.59 in chips) 
Seat 3: nosachkn ($24.70 in chips) 
Seat 4: baadnewz01 ($22.70 in chips) 
Seat 5: Gintaras20 ($10 in chips) 
Seat 6: raydenel ($10.32 in chips) 
baadnewz01: posts small blind $0.05
Gintaras20: posts big blind $0.10
*** HOLE CARDS ***
raydenel: folds 
Spieler977: folds 
Yellowbaanana: calls $0.10
nosachkn: folds 
baadnewz01: folds 
Gintaras20: checks 
*** FLOP *** [7c 7d 5c]
Gintaras20: checks 
Yellowbaanana: bets $0.12
Gintaras20: folds 
Uncalled bet ($0.12) returned to Yellowbaanana
Yellowbaanana collected $0.24 from pot
Yellowbaanana: doesn't show hand 
*** SUMMARY ***
Total pot $0.25 | Rake $0.01 
Board [7c 7d 5c]
Seat 1: Spieler977 folded before Flop (didn't bet)
Seat 2: Yellowbaanana collected ($0.24)
Seat 3: nosachkn (button) folded before Flop (didn't bet)
Seat 4: baadnewz01 (small blind) folded before Flop
Seat 5: Gintaras20 (big blind) folded on the Flop
Seat 6: raydenel folded before Flop (didn't bet)



PokerStars Hand #222977208705:  Hold'em No Limit ($0.05/$0.10 USD) - 2021/01/23 18:15:13 ET
Table 'Transvaalia' 6-max Seat #4 is the button
Seat 1: Spieler977 ($12.01 in chips) 
Seat 2: Yellowbaanana ($16.73 in chips) 
Seat 3: nosachkn ($24.70 in chips) 
Seat 4: baadnewz01 ($22.65 in chips) 
Seat 5: Gintaras20 ($9.90 in chips) 
Seat 6: raydenel ($10.32 in chips) 
Gintaras20: posts small blind $0.05
raydenel: posts big blind $0.10
*** HOLE CARDS ***
Spieler977: folds 
Yellowbaanana: folds 
nosachkn: folds 
baadnewz01: raises $0.20 to $0.30
Gintaras20: calls $0.25
raydenel: calls $0.20
*** FLOP *** [5s 3d Ts]
Gintaras20: bets $0.65
raydenel: folds 
baadnewz01: folds 
Uncalled bet ($0.65) returned to Gintaras20
Gintaras20 collected $0.86 from pot
Gintaras20: doesn't show hand 
*** SUMMARY ***
Total pot $0.90 | Rake $0.04 
Board [5s 3d Ts]
Seat 1: Spieler977 folded before Flop (didn't bet)
Seat 2: Yellowbaanana folded before Flop (didn't bet)
Seat 3: nosachkn folded before Flop (didn't bet)
Seat 4: baadnewz01 (button) folded on the Flop
Seat 5: Gintaras20 (small blind) collected ($0.86)
Seat 6: raydenel (big blind) folded on the Flop



PokerStars Hand #222977238534:  Hold'em No Limit ($0.05/$0.10 USD) - 2021/01/23 18:15:57 ET
Table 'Transvaalia' 6-max Seat #5 is the button
Seat 2: Yellowbaanana ($16.73 in chips) 
Seat 3: nosachkn ($24.70 in chips) 
Seat 4: baadnewz01 ($22.35 in chips) 
Seat 5: Gintaras20 ($10.46 in chips) 
Seat 6: raydenel ($10.02 in chips) 
raydenel: posts small blind $0.05
Spieler977: is sitting out 
Spieler977 leaves the table
Yellowbaanana: posts big blind $0.10
*** HOLE CARDS ***
fred00205 joins the table at seat #1 
nosachkn has timed out
nosachkn: folds 
baadnewz01: raises $0.20 to $0.30
Gintaras20: folds 
raydenel: folds 
Yellowbaanana: folds 
Uncalled bet ($0.20) returned to baadnewz01
baadnewz01 collected $0.25 from pot
baadnewz01: doesn't show hand 
*** SUMMARY ***
Total pot $0.25 | Rake $0 
Seat 2: Yellowbaanana (big blind) folded before Flop
Seat 3: nosachkn folded before Flop (didn't bet)
Seat 4: baadnewz01 collected ($0.25)
Seat 5: Gintaras20 (button) folded before Flop (didn't bet)
Seat 6: raydenel (small blind) folded before Flop



PokerStars Hand #222977252992:  Hold'em No Limit ($0.05/$0.10 USD) - 2021/01/23 18:16:18 ET
Table 'Transvaalia' 6-max Seat #6 is the button
Seat 2: Yellowbaanana ($16.63 in chips) 
Seat 3: nosachkn ($24.70 in chips) 
Seat 4: baadnewz01 ($22.50 in chips) 
Seat 5: Gintaras20 ($10.46 in chips) 
Seat 6: raydenel ($10 in chips) 
Yellowbaanana: posts small blind $0.05
nosachkn: posts big blind $0.10
*** HOLE CARDS ***
baadnewz01: folds 
Gintaras20: folds 
raydenel: folds 
Yellowbaanana: calls $0.05
nosachkn: checks 
*** FLOP *** [6s 4s 9d]
Yellowbaanana: checks 
nosachkn: checks 
*** TURN *** [6s 4s 9d] [3s]
Yellowbaanana: checks 
nosachkn: checks 
*** RIVER *** [6s 4s 9d 3s] [Tc]
Yellowbaanana: checks 
nosachkn: checks 
*** SHOW DOWN ***
Yellowbaanana: shows [Ks 8d] (high card King)
nosachkn: mucks hand 
Yellowbaanana collected $0.19 from pot
*** SUMMARY ***
Total pot $0.20 | Rake $0.01 
Board [6s 4s 9d 3s Tc]
Seat 2: Yellowbaanana (small blind) showed [Ks 8d] and won ($0.19) with high card King
Seat 3: nosachkn (big blind) mucked
Seat 4: baadnewz01 folded before Flop (didn't bet)
Seat 5: Gintaras20 folded before Flop (didn't bet)
Seat 6: raydenel (button) folded before Flop (didn't bet)



PokerStars Hand #222977273441:  Hold'em No Limit ($0.05/$0.10 USD) - 2021/01/23 18:16:49 ET
Table 'Transvaalia' 6-max Seat #2 is the button
Seat 1: fred00205 ($8 in chips) 
Seat 2: Yellowbaanana ($16.72 in chips) 
Seat 3: nosachkn ($24.60 in chips) 
Seat 4: baadnewz01 ($22.50 in chips) 
Seat 5: Gintaras20 ($10.46 in chips) 
Seat 6: raydenel ($10 in chips) 
nosachkn: posts small blind $0.05
baadnewz01: posts big blind $0.10
fred00205: posts big blind $0.10
*** HOLE CARDS ***
Gintaras20: raises $0.15 to $0.25
raydenel: folds 
fred00205: calls $0.15
Yellowbaanana: folds 
nosachkn: folds 
baadnewz01: folds 
*** FLOP *** [Jc 9h 9s]
Gintaras20: bets $0.31
fred00205: raises $0.31 to $0.62
Gintaras20: calls $0.31
*** TURN *** [Jc 9h 9s] [2d]
Gintaras20: checks 
fred00205: bets $0.50
Gintaras20: calls $0.50
*** RIVER *** [Jc 9h 9s 2d] [2c]
Gintaras20: checks 
fred00205: bets $6.63 and is all-in
Gintaras20: folds 
Uncalled bet ($6.63) returned to fred00205
fred00205 collected $2.76 from pot
fred00205: doesn't show hand 
*** SUMMARY ***
Total pot $2.89 | Rake $0.13 
Board [Jc 9h 9s 2d 2c]
Seat 1: fred00205 collected ($2.76)
Seat 2: Yellowbaanana (button) folded before Flop (didn't bet)
Seat 3: nosachkn (small blind) folded before Flop
Seat 4: baadnewz01 (big blind) folded before Flop
Seat 5: Gintaras20 folded on the River
Seat 6: raydenel folded before Flop (didn't bet)



PokerStars Hand #222977307670:  Hold'em No Limit ($0.05/$0.10 USD) - 2021/01/23 18:17:39 ET
Table 'Transvaalia' 6-max Seat #3 is the button
Seat 1: fred00205 ($9.39 in chips) 
Seat 2: Yellowbaanana ($16.72 in chips) 
Seat 3: nosachkn ($24.55 in chips) 
Seat 4: baadnewz01 ($22.40 in chips) 
Seat 5: Gintaras20 ($9.09 in chips) 
Seat 6: raydenel ($10 in chips) 
baadnewz01: posts small blind $0.05
Gintaras20: posts big blind $0.10
*** HOLE CARDS ***
raydenel: folds 
fred00205: calls $0.10
Yellowbaanana: calls $0.10
nosachkn: folds 
baadnewz01: folds 
Gintaras20: checks 
*** FLOP *** [Ah 3h Qc]
Gintaras20: bets $0.25
fred00205: folds 
Yellowbaanana: folds 
Uncalled bet ($0.25) returned to Gintaras20
Gintaras20 collected $0.33 from pot
Gintaras20: doesn't show hand 
*** SUMMARY ***
Total pot $0.35 | Rake $0.02 
Board [Ah 3h Qc]
Seat 1: fred00205 folded on the Flop
Seat 2: Yellowbaanana folded on the Flop
Seat 3: nosachkn (button) folded before Flop (didn't bet)
Seat 4: baadnewz01 (small blind) folded before Flop
Seat 5: Gintaras20 (big blind) collected ($0.33)
Seat 6: raydenel folded before Flop (didn't bet)



PokerStars Hand #222977328877:  Hold'em No Limit ($0.05/$0.10 USD) - 2021/01/23 18:18:11 ET
Table 'Transvaalia' 6-max Seat #4 is the button
Seat 1: fred00205 ($9.29 in chips) 
Seat 2: Yellowbaanana ($16.62 in chips) 
Seat 3: nosachkn ($24.55 in chips) 
Seat 4: baadnewz01 ($22.35 in chips) 
Seat 5: Gintaras20 ($9.32 in chips) 
Seat 6: raydenel ($10 in chips) 
Gintaras20: posts small blind $0.05
raydenel: posts big blind $0.10
*** HOLE CARDS ***
fred00205: calls $0.10
Yellowbaanana: folds 
nosachkn: folds 
Yellowbaanana leaves the table
baadnewz01: folds 
Gintaras20: calls $0.05
raydenel: checks 
*** FLOP *** [9s 4h 6c]
Gintaras20: bets $0.15
raydenel: folds 
fred00205: folds 
Uncalled bet ($0.15) returned to Gintaras20
Gintaras20 collected $0.29 from pot
Gintaras20: doesn't show hand 
*** SUMMARY ***
Total pot $0.30 | Rake $0.01 
Board [9s 4h 6c]
Seat 1: fred00205 folded on the Flop
Seat 2: Yellowbaanana folded before Flop (didn't bet)
Seat 3: nosachkn folded before Flop (didn't bet)
Seat 4: baadnewz01 (button) folded before Flop (didn't bet)
Seat 5: Gintaras20 (small blind) collected ($0.29)
Seat 6: raydenel (big blind) folded on the Flop



PokerStars Hand #222977346821:  Hold'em No Limit ($0.05/$0.10 USD) - 2021/01/23 18:18:37 ET
Table 'Transvaalia' 6-max Seat #5 is the button
Seat 1: fred00205 ($9.19 in chips) 
Seat 3: nosachkn ($24.55 in chips) 
Seat 4: baadnewz01 ($22.35 in chips) 
Seat 5: Gintaras20 ($9.51 in chips) 
Seat 6: raydenel ($10 in chips) 
raydenel: posts small blind $0.05
fred00205: posts big blind $0.10
*** HOLE CARDS ***
nosachkn: folds 
attilakorte joins the table at seat #2 
baadnewz01: raises $0.20 to $0.30
Gintaras20: calls $0.30
raydenel: folds 
fred00205: calls $0.20
*** FLOP *** [6c 6h 8d]
fred00205: checks 
baadnewz01: bets $0.40
Gintaras20: folds 
fred00205: folds 
Uncalled bet ($0.40) returned to baadnewz01
baadnewz01 collected $0.91 from pot
baadnewz01: doesn't show hand 
*** SUMMARY ***
Total pot $0.95 | Rake $0.04 
Board [6c 6h 8d]
Seat 1: fred00205 (big blind) folded on the Flop
Seat 3: nosachkn folded before Flop (didn't bet)
Seat 4: baadnewz01 collected ($0.91)
Seat 5: Gintaras20 (button) folded on the Flop
Seat 6: raydenel (small blind) folded before Flop



PokerStars Hand #222977373173:  Hold'em No Limit ($0.05/$0.10 USD) - 2021/01/23 18:19:17 ET
Table 'Transvaalia' 6-max Seat #6 is the button
Seat 1: fred00205 ($8.89 in chips) 
Seat 2: attilakorte ($10 in chips) 
Seat 3: nosachkn ($24.55 in chips) 
Seat 4: baadnewz01 ($22.96 in chips) 
Seat 5: Gintaras20 ($9.21 in chips) 
Seat 6: raydenel ($10 in chips) 
fred00205: posts small blind $0.05
attilakorte: posts big blind $0.10
*** HOLE CARDS ***
nosachkn: folds 
baadnewz01: folds 
Gintaras20: folds 
raydenel: raises $0.10 to $0.20
fred00205: calls $0.15
attilakorte: raises $0.80 to $1
raydenel: folds 
fred00205: calls $0.80
*** FLOP *** [3h Ts 3s]
fred00205: checks 
attilakorte: bets $1.09
fred00205: folds 
Uncalled bet ($1.09) returned to attilakorte
attilakorte collected $2.10 from pot
attilakorte: doesn't show hand 
*** SUMMARY ***
Total pot $2.20 | Rake $0.10 
Board [3h Ts 3s]
Seat 1: fred00205 (small blind) folded on the Flop
Seat 2: attilakorte (big blind) collected ($2.10)
Seat 3: nosachkn folded before Flop (didn't bet)
Seat 4: baadnewz01 folded before Flop (didn't bet)
Seat 5: Gintaras20 folded before Flop (didn't bet)
Seat 6: raydenel (button) folded before Flop



PokerStars Hand #222977404922:  Hold'em No Limit ($0.05/$0.10 USD) - 2021/01/23 18:20:04 ET
Table 'Transvaalia' 6-max Seat #1 is the button
Seat 1: fred00205 ($7.89 in chips) 
Seat 2: attilakorte ($11.10 in chips) 
Seat 3: nosachkn ($24.55 in chips) 
Seat 4: baadnewz01 ($22.96 in chips) 
Seat 5: Gintaras20 ($9.21 in chips) 
Seat 6: raydenel ($10 in chips) 
attilakorte: posts small blind $0.05
nosachkn: posts big blind $0.10
*** HOLE CARDS ***
baadnewz01: folds 
Gintaras20: raises $0.15 to $0.25
raydenel: calls $0.25
fred00205: folds 
attilakorte: folds 
nosachkn: folds 
*** FLOP *** [Td Ks 9h]
Gintaras20: bets $0.31
raydenel: raises $0.62 to $0.93
Gintaras20: folds 
Uncalled bet ($0.62) returned to raydenel
raydenel collected $1.21 from pot
raydenel: doesn't show hand 
*** SUMMARY ***
Total pot $1.27 | Rake $0.06 
Board [Td Ks 9h]
Seat 1: fred00205 (button) folded before Flop (didn't bet)
Seat 2: attilakorte (small blind) folded before Flop
Seat 3: nosachkn (big blind) folded before Flop
Seat 4: baadnewz01 folded before Flop (didn't bet)
Seat 5: Gintaras20 folded on the Flop
Seat 6: raydenel collected ($1.21)



PokerStars Hand #222977429179:  Hold'em No Limit ($0.05/$0.10 USD) - 2021/01/23 18:20:40 ET
Table 'Transvaalia' 6-max Seat #2 is the button
Seat 1: fred00205 ($7.89 in chips) 
Seat 2: attilakorte ($11.05 in chips) 
Seat 3: nosachkn ($24.45 in chips) 
Seat 4: baadnewz01 ($22.96 in chips) 
Seat 5: Gintaras20 ($8.65 in chips) 
Seat 6: raydenel ($10.65 in chips) 
nosachkn: posts small blind $0.05
baadnewz01: posts big blind $0.10
*** HOLE CARDS ***
Gintaras20: folds 
raydenel: folds 
fred00205: folds 
attilakorte: raises $0.12 to $0.22
nosachkn: folds 
baadnewz01: calls $0.12
*** FLOP *** [Ah 7d 8d]
baadnewz01: checks 
attilakorte: bets $0.16
baadnewz01: raises $0.32 to $0.48
attilakorte: folds 
Uncalled bet ($0.32) returned to baadnewz01
baadnewz01 collected $0.77 from pot
baadnewz01: doesn't show hand 
*** SUMMARY ***
Total pot $0.81 | Rake $0.04 
Board [Ah 7d 8d]
Seat 1: fred00205 folded before Flop (didn't bet)
Seat 2: attilakorte (button) folded on the Flop
Seat 3: nosachkn (small blind) folded before Flop
Seat 4: baadnewz01 (big blind) collected ($0.77)
Seat 5: Gintaras20 folded before Flop (didn't bet)
Seat 6: raydenel folded before Flop (didn't bet)



PokerStars Hand #222977454101:  Hold'em No Limit ($0.05/$0.10 USD) - 2021/01/23 18:21:18 ET
Table 'Transvaalia' 6-max Seat #3 is the button
Seat 1: fred00205 ($7.89 in chips) 
Seat 2: attilakorte ($10.67 in chips) 
Seat 3: nosachkn ($24.40 in chips) 
Seat 4: baadnewz01 ($23.35 in chips) 
Seat 5: Gintaras20 ($8.65 in chips) 
Seat 6: raydenel ($10.65 in chips) 
baadnewz01: posts small blind $0.05
Gintaras20: posts big blind $0.10
*** HOLE CARDS ***
raydenel: folds 
fred00205: calls $0.10
attilakorte: folds 
nosachkn: folds 
baadnewz01: folds 
Gintaras20: checks 
*** FLOP *** [As 7c 7h]
Gintaras20: checks 
fred00205: checks 
*** TURN *** [As 7c 7h] [2s]
Gintaras20: checks 
fred00205: checks 
*** RIVER *** [As 7c 7h 2s] [5s]
Gintaras20: checks 
fred00205: checks 
*** SHOW DOWN ***
Gintaras20: shows [8h 9c] (a pair of Sevens)
fred00205: shows [Kc Jd] (a pair of Sevens - Ace+King kicker)
fred00205 collected $0.24 from pot
*** SUMMARY ***
Total pot $0.25 | Rake $0.01 
Board [As 7c 7h 2s 5s]
Seat 1: fred00205 showed [Kc Jd] and won ($0.24) with a pair of Sevens
Seat 2: attilakorte folded before Flop (didn't bet)
Seat 3: nosachkn (button) folded before Flop (didn't bet)
Seat 4: baadnewz01 (small blind) folded before Flop
Seat 5: Gintaras20 (big blind) showed [8h 9c] and lost with a pair of Sevens
Seat 6: raydenel folded before Flop (didn't bet)



PokerStars Hand #222977478051:  Hold'em No Limit ($0.05/$0.10 USD) - 2021/01/23 18:21:54 ET
Table 'Transvaalia' 6-max Seat #4 is the button
Seat 1: fred00205 ($8.03 in chips) 
Seat 2: attilakorte ($10.67 in chips) 
Seat 3: nosachkn ($24.40 in chips) 
Seat 4: baadnewz01 ($23.30 in chips) 
Seat 5: Gintaras20 ($8.55 in chips) 
Seat 6: raydenel ($10.65 in chips) 
Gintaras20: posts small blind $0.05
raydenel: posts big blind $0.10
*** HOLE CARDS ***
fred00205: calls $0.10
attilakorte: folds 
nosachkn: raises $0.30 to $0.40
baadnewz01: calls $0.40
Gintaras20: calls $0.35
raydenel: calls $0.30
fred00205: calls $0.30
*** FLOP *** [4c 8c 6s]
Gintaras20: bets $1.43
raydenel: folds 
fred00205: folds 
nosachkn: folds 
baadnewz01: folds 
Uncalled bet ($1.43) returned to Gintaras20
Gintaras20 collected $1.91 from pot
Gintaras20: doesn't show hand 
*** SUMMARY ***
Total pot $2 | Rake $0.09 
Board [4c 8c 6s]
Seat 1: fred00205 folded on the Flop
Seat 2: attilakorte folded before Flop (didn't bet)
Seat 3: nosachkn folded on the Flop
Seat 4: baadnewz01 (button) folded on the Flop
Seat 5: Gintaras20 (small blind) collected ($1.91)
Seat 6: raydenel (big blind) folded on the Flop



PokerStars Hand #222977499062:  Hold'em No Limit ($0.05/$0.10 USD) - 2021/01/23 18:22:26 ET
Table 'Transvaalia' 6-max Seat #5 is the button
Seat 1: fred00205 ($7.63 in chips) 
Seat 2: attilakorte ($10.67 in chips) 
Seat 3: nosachkn ($24 in chips) 
Seat 4: baadnewz01 ($22.90 in chips) 
Seat 5: Gintaras20 ($10.06 in chips) 
Seat 6: raydenel ($10.25 in chips) 
raydenel: posts small blind $0.05
fred00205: posts big blind $0.10
*** HOLE CARDS ***
attilakorte: folds 
nosachkn: folds 
baadnewz01: folds 
Gintaras20: calls $0.10
raydenel: raises $0.30 to $0.40
fred00205: calls $0.30
Gintaras20: calls $0.30
*** FLOP *** [Ah Kh Th]
raydenel: bets $0.58
fred00205: calls $0.58
Gintaras20: folds 
*** TURN *** [Ah Kh Th] [5s]
raydenel: bets $1.13
fred00205: calls $1.13
*** RIVER *** [Ah Kh Th 5s] [2d]
raydenel: checks 
fred00205: checks 
*** SHOW DOWN ***
raydenel: shows [2c As] (two pair, Aces and Deuces)
fred00205: mucks hand 
raydenel collected $4.41 from pot
*** SUMMARY ***
Total pot $4.62 | Rake $0.21 
Board [Ah Kh Th 5s 2d]
Seat 1: fred00205 (big blind) mucked
Seat 2: attilakorte folded before Flop (didn't bet)
Seat 3: nosachkn folded before Flop (didn't bet)
Seat 4: baadnewz01 folded before Flop (didn't bet)
Seat 5: Gintaras20 (button) folded on the Flop
Seat 6: raydenel (small blind) showed [2c As] and won ($4.41) with two pair, Aces and Deuces



PokerStars Hand #222977535228:  Hold'em No Limit ($0.05/$0.10 USD) - 2021/01/23 18:23:08 ET
Table 'Transvaalia' 6-max Seat #6 is the button
Seat 1: fred00205 ($5.52 in chips) 
Seat 2: attilakorte ($10.67 in chips) 
Seat 3: nosachkn ($24 in chips) 
Seat 4: baadnewz01 ($22.90 in chips) 
Seat 5: Gintaras20 ($9.66 in chips) 
Seat 6: raydenel ($12.55 in chips) 
fred00205: posts small blind $0.05
attilakorte: posts big blind $0.10
*** HOLE CARDS ***
nosachkn: folds 
baadnewz01: folds 
Gintaras20: raises $0.15 to $0.25
raydenel: folds 
fred00205: folds 
attilakorte: folds 
Uncalled bet ($0.15) returned to Gintaras20
Gintaras20 collected $0.25 from pot
*** SUMMARY ***
Total pot $0.25 | Rake $0 
Seat 1: fred00205 (small blind) folded before Flop
Seat 2: attilakorte (big blind) folded before Flop
Seat 3: nosachkn folded before Flop (didn't bet)
Seat 4: baadnewz01 folded before Flop (didn't bet)
Seat 5: Gintaras20 collected ($0.25)
Seat 6: raydenel (button) folded before Flop (didn't bet)



PokerStars Hand #222977543485:  Hold'em No Limit ($0.05/$0.10 USD) - 2021/01/23 18:23:20 ET
Table 'Transvaalia' 6-max Seat #1 is the button
Seat 1: fred00205 ($5.47 in chips) 
Seat 2: attilakorte ($10.57 in chips) 
Seat 3: nosachkn ($24 in chips) 
Seat 4: baadnewz01 ($22.90 in chips) 
Seat 5: Gintaras20 ($9.81 in chips) 
Seat 6: raydenel ($12.55 in chips) 
attilakorte: posts small blind $0.05
nosachkn: posts big blind $0.10
*** HOLE CARDS ***
baadnewz01: folds 
Gintaras20: raises $0.15 to $0.25
raydenel: folds 
fred00205: calls $0.25
attilakorte: folds 
nosachkn: folds 
*** FLOP *** [4c Js 2h]
Gintaras20: bets $0.31
fred00205: folds 
Uncalled bet ($0.31) returned to Gintaras20
Gintaras20 collected $0.62 from pot
Gintaras20: doesn't show hand 
*** SUMMARY ***
Total pot $0.65 | Rake $0.03 
Board [4c Js 2h]
Seat 1: fred00205 (button) folded on the Flop
Seat 2: attilakorte (small blind) folded before Flop
Seat 3: nosachkn (big blind) folded before Flop
Seat 4: baadnewz01 folded before Flop (didn't bet)
Seat 5: Gintaras20 collected ($0.62)
Seat 6: raydenel folded before Flop (didn't bet)



PokerStars Hand #222977557244:  Hold'em No Limit ($0.05/$0.10 USD) - 2021/01/23 18:23:41 ET
Table 'Transvaalia' 6-max Seat #2 is the button
Seat 1: fred00205 ($5.22 in chips) 
Seat 2: attilakorte ($10.52 in chips) 
Seat 3: nosachkn ($23.90 in chips) 
Seat 4: baadnewz01 ($22.90 in chips) 
Seat 5: Gintaras20 ($10.18 in chips) 
Seat 6: raydenel ($12.55 in chips) 
nosachkn: posts small blind $0.05
baadnewz01: posts big blind $0.10
*** HOLE CARDS ***
Gintaras20: folds 
raydenel: folds 
fred00205: calls $0.10
attilakorte: folds 
nosachkn: folds 
baadnewz01: checks 
*** FLOP *** [3s 4d 6s]
baadnewz01: checks 
fred00205: checks 
*** TURN *** [3s 4d 6s] [As]
baadnewz01: checks 
fred00205: checks 
*** RIVER *** [3s 4d 6s As] [Ac]
baadnewz01: checks 
fred00205: checks 
*** SHOW DOWN ***
baadnewz01: shows [Jh 3h] (two pair, Aces and Threes)
fred00205: mucks hand 
baadnewz01 collected $0.24 from pot
*** SUMMARY ***
Total pot $0.25 | Rake $0.01 
Board [3s 4d 6s As Ac]
Seat 1: fred00205 mucked
Seat 2: attilakorte (button) folded before Flop (didn't bet)
Seat 3: nosachkn (small blind) folded before Flop
Seat 4: baadnewz01 (big blind) showed [Jh 3h] and won ($0.24) with two pair, Aces and Threes
Seat 5: Gintaras20 folded before Flop (didn't bet)
Seat 6: raydenel folded before Flop (didn't bet)



PokerStars Hand #222977591774:  Hold'em No Limit ($0.05/$0.10 USD) - 2021/01/23 18:24:34 ET
Table 'Transvaalia' 6-max Seat #3 is the button
Seat 1: fred00205 ($5.12 in chips) 
Seat 2: attilakorte ($10.52 in chips) 
Seat 3: nosachkn ($23.85 in chips) 
Seat 4: baadnewz01 ($23.04 in chips) 
Seat 5: Gintaras20 ($10.18 in chips) 
Seat 6: raydenel ($12.55 in chips) 
baadnewz01: posts small blind $0.05
Gintaras20: posts big blind $0.10
*** HOLE CARDS ***
raydenel: folds 
fred00205: calls $0.10
attilakorte: folds 
nosachkn: folds 
baadnewz01: folds 
Gintaras20: checks 
*** FLOP *** [As 6d Ad]
Gintaras20: checks 
fred00205: checks 
*** TURN *** [As 6d Ad] [5c]
Gintaras20: bets $0.18
fred00205: calls $0.18
*** RIVER *** [As 6d Ad 5c] [8s]
Gintaras20: checks 
fred00205: checks 
*** SHOW DOWN ***
Gintaras20: shows [4s 3s] (a pair of Aces)
fred00205: shows [Jd 3h] (a pair of Aces - Jack kicker)
fred00205 collected $0.58 from pot
*** SUMMARY ***
Total pot $0.61 | Rake $0.03 
Board [As 6d Ad 5c 8s]
Seat 1: fred00205 showed [Jd 3h] and won ($0.58) with a pair of Aces
Seat 2: attilakorte folded before Flop (didn't bet)
Seat 3: nosachkn (button) folded before Flop (didn't bet)
Seat 4: baadnewz01 (small blind) folded before Flop
Seat 5: Gintaras20 (big blind) showed [4s 3s] and lost with a pair of Aces
Seat 6: raydenel folded before Flop (didn't bet)



PokerStars Hand #222977629838:  Hold'em No Limit ($0.05/$0.10 USD) - 2021/01/23 18:25:32 ET
Table 'Transvaalia' 6-max Seat #4 is the button
Seat 1: fred00205 ($5.42 in chips) 
Seat 2: attilakorte ($10.52 in chips) 
Seat 3: nosachkn ($23.85 in chips) 
Seat 4: baadnewz01 ($22.99 in chips) 
Seat 5: Gintaras20 ($9.90 in chips) 
Seat 6: raydenel ($12.55 in chips) 
Gintaras20: posts small blind $0.05
raydenel: posts big blind $0.10
*** HOLE CARDS ***
fred00205: calls $0.10
attilakorte: folds 
nosachkn: folds 
baadnewz01: raises $0.30 to $0.40
Gintaras20: folds 
raydenel: folds 
fred00205: folds 
Uncalled bet ($0.30) returned to baadnewz01
baadnewz01 collected $0.35 from pot
baadnewz01: doesn't show hand 
*** SUMMARY ***
Total pot $0.35 | Rake $0 
Seat 1: fred00205 folded before Flop
Seat 2: attilakorte folded before Flop (didn't bet)
Seat 3: nosachkn folded before Flop (didn't bet)
Seat 4: baadnewz01 (button) collected ($0.35)
Seat 5: Gintaras20 (small blind) folded before Flop
Seat 6: raydenel (big blind) folded before Flop



PokerStars Hand #222977648065:  Hold'em No Limit ($0.05/$0.10 USD) - 2021/01/23 18:26:00 ET
Table 'Transvaalia' 6-max Seat #5 is the button
Seat 1: fred00205 ($5.32 in chips) 
Seat 2: attilakorte ($10.52 in chips) 
Seat 3: nosachkn ($23.85 in chips) 
Seat 4: baadnewz01 ($23.24 in chips) 
Seat 5: Gintaras20 ($9.85 in chips) 
Seat 6: raydenel ($12.45 in chips) 
raydenel: posts small blind $0.05
fred00205: posts big blind $0.10
*** HOLE CARDS ***
attilakorte: folds 
nosachkn: folds 
baadnewz01: raises $0.20 to $0.30
Gintaras20: folds 
raydenel: folds 
fred00205: folds 
Uncalled bet ($0.20) returned to baadnewz01
baadnewz01 collected $0.25 from pot
baadnewz01: doesn't show hand 
*** SUMMARY ***
Total pot $0.25 | Rake $0 
Seat 1: fred00205 (big blind) folded before Flop
Seat 2: attilakorte folded before Flop (didn't bet)
Seat 3: nosachkn folded before Flop (didn't bet)
Seat 4: baadnewz01 collected ($0.25)
Seat 5: Gintaras20 (button) folded before Flop (didn't bet)
Seat 6: raydenel (small blind) folded before Flop



PokerStars Hand #222977656977:  Hold'em No Limit ($0.05/$0.10 USD) - 2021/01/23 18:26:13 ET
Table 'Transvaalia' 6-max Seat #6 is the button
Seat 1: fred00205 ($5.22 in chips) 
Seat 2: attilakorte ($10.52 in chips) 
Seat 3: nosachkn ($23.85 in chips) 
Seat 4: baadnewz01 ($23.39 in chips) 
Seat 5: Gintaras20 ($9.85 in chips) 
Seat 6: raydenel ($12.40 in chips) 
fred00205: posts small blind $0.05
attilakorte: posts big blind $0.10
*** HOLE CARDS ***
nosachkn: folds 
baadnewz01: folds 
Gintaras20: folds 
raydenel: raises $0.10 to $0.20
fred00205: calls $0.15
attilakorte: folds 
*** FLOP *** [Kh Qs 8d]
fred00205: checks 
raydenel: bets $0.24
fred00205: calls $0.24
*** TURN *** [Kh Qs 8d] [3h]
fred00205: checks 
raydenel: checks 
*** RIVER *** [Kh Qs 8d 3h] [Jh]
fred00205: checks 
raydenel: checks 
*** SHOW DOWN ***
fred00205: shows [4s Js] (a pair of Jacks)
raydenel: shows [9c Qd] (a pair of Queens)
raydenel collected $0.94 from pot
*** SUMMARY ***
Total pot $0.98 | Rake $0.04 
Board [Kh Qs 8d 3h Jh]
Seat 1: fred00205 (small blind) showed [4s Js] and lost with a pair of Jacks
Seat 2: attilakorte (big blind) folded before Flop
Seat 3: nosachkn folded before Flop (didn't bet)
Seat 4: baadnewz01 folded before Flop (didn't bet)
Seat 5: Gintaras20 folded before Flop (didn't bet)
Seat 6: raydenel (button) showed [9c Qd] and won ($0.94) with a pair of Queens



PokerStars Hand #222977680475:  Hold'em No Limit ($0.05/$0.10 USD) - 2021/01/23 18:26:50 ET
Table 'Transvaalia' 6-max Seat #1 is the button
Seat 1: fred00205 ($4.78 in chips) 
Seat 2: attilakorte ($10.42 in chips) 
Seat 3: nosachkn ($23.85 in chips) 
Seat 4: baadnewz01 ($23.39 in chips) 
Seat 5: Gintaras20 ($9.85 in chips) 
Seat 6: raydenel ($12.90 in chips) 
attilakorte: posts small blind $0.05
nosachkn: posts big blind $0.10
*** HOLE CARDS ***
baadnewz01: folds 
Gintaras20: folds 
raydenel: folds 
fred00205: calls $0.10
attilakorte: folds 
nosachkn: raises $0.30 to $0.40
fred00205: calls $0.30
*** FLOP *** [7s 2c Kd]
nosachkn: bets $0.41
fred00205: calls $0.41
*** TURN *** [7s 2c Kd] [8c]
nosachkn: checks 
fred00205: checks 
*** RIVER *** [7s 2c Kd 8c] [5h]
nosachkn: checks 
fred00205: checks 
*** SHOW DOWN ***
nosachkn: shows [7c Ah] (a pair of Sevens)
fred00205: shows [Kc As] (a pair of Kings)
fred00205 collected $1.59 from pot
*** SUMMARY ***
Total pot $1.67 | Rake $0.08 
Board [7s 2c Kd 8c 5h]
Seat 1: fred00205 (button) showed [Kc As] and won ($1.59) with a pair of Kings
Seat 2: attilakorte (small blind) folded before Flop
Seat 3: nosachkn (big blind) showed [7c Ah] and lost with a pair of Sevens
Seat 4: baadnewz01 folded before Flop (didn't bet)
Seat 5: Gintaras20 folded before Flop (didn't bet)
Seat 6: raydenel folded before Flop (didn't bet)



PokerStars Hand #222977709378:  Hold'em No Limit ($0.05/$0.10 USD) - 2021/01/23 18:27:33 ET
Table 'Transvaalia' 6-max Seat #2 is the button
Seat 1: fred00205 ($5.56 in chips) 
Seat 2: attilakorte ($10.37 in chips) 
Seat 3: nosachkn ($23.04 in chips) 
Seat 4: baadnewz01 ($23.39 in chips) 
Seat 5: Gintaras20 ($9.85 in chips) 
Seat 6: raydenel ($12.90 in chips) 
nosachkn: posts small blind $0.05
baadnewz01: posts big blind $0.10
*** HOLE CARDS ***
Gintaras20: folds 
raydenel: folds 
fred00205: calls $0.10
attilakorte: raises $0.30 to $0.40
nosachkn: folds 
baadnewz01: folds 
fred00205: folds 
Uncalled bet ($0.30) returned to attilakorte
attilakorte collected $0.35 from pot
attilakorte: doesn't show hand 
*** SUMMARY ***
Total pot $0.35 | Rake $0 
Seat 1: fred00205 folded before Flop
Seat 2: attilakorte (button) collected ($0.35)
Seat 3: nosachkn (small blind) folded before Flop
Seat 4: baadnewz01 (big blind) folded before Flop
Seat 5: Gintaras20 folded before Flop (didn't bet)
Seat 6: raydenel folded before Flop (didn't bet)



PokerStars Hand #222977721195:  Hold'em No Limit ($0.05/$0.10 USD) - 2021/01/23 18:27:51 ET
Table 'Transvaalia' 6-max Seat #3 is the button
Seat 1: fred00205 ($5.46 in chips) 
Seat 2: attilakorte ($10.62 in chips) 
Seat 3: nosachkn ($22.99 in chips) 
Seat 4: baadnewz01 ($23.29 in chips) 
Seat 5: Gintaras20 ($9.85 in chips) 
Seat 6: raydenel ($12.90 in chips) 
baadnewz01: posts small blind $0.05
Gintaras20: posts big blind $0.10
*** HOLE CARDS ***
raydenel: folds 
fred00205: folds 
attilakorte: folds 
nosachkn: folds 
baadnewz01: raises $0.20 to $0.30
Gintaras20: folds 
Uncalled bet ($0.20) returned to baadnewz01
baadnewz01 collected $0.20 from pot
baadnewz01: doesn't show hand 
*** SUMMARY ***
Total pot $0.20 | Rake $0 
Seat 1: fred00205 folded before Flop (didn't bet)
Seat 2: attilakorte folded before Flop (didn't bet)
Seat 3: nosachkn (button) folded before Flop (didn't bet)
Seat 4: baadnewz01 (small blind) collected ($0.20)
Seat 5: Gintaras20 (big blind) folded before Flop
Seat 6: raydenel folded before Flop (didn't bet)



PokerStars Hand #222977729798:  Hold'em No Limit ($0.05/$0.10 USD) - 2021/01/23 18:28:05 ET
Table 'Transvaalia' 6-max Seat #4 is the button
Seat 1: fred00205 ($5.46 in chips) 
Seat 2: attilakorte ($10.62 in chips) 
Seat 3: nosachkn ($22.99 in chips) 
Seat 4: baadnewz01 ($23.39 in chips) 
Seat 5: Gintaras20 ($9.75 in chips) 
Seat 6: raydenel ($12.90 in chips) 
Gintaras20: posts small blind $0.05
raydenel: posts big blind $0.10
*** HOLE CARDS ***
fred00205: folds 
attilakorte: raises $0.12 to $0.22
nosachkn: folds 
baadnewz01: raises $0.44 to $0.66
Gintaras20: folds 
raydenel: folds 
attilakorte: calls $0.44
*** FLOP *** [7c 8s 2h]
attilakorte: checks 
baadnewz01: checks 
*** TURN *** [7c 8s 2h] [3c]
attilakorte: bets $0.73
baadnewz01: folds 
Uncalled bet ($0.73) returned to attilakorte
attilakorte collected $1.40 from pot
attilakorte: doesn't show hand 
*** SUMMARY ***
Total pot $1.47 | Rake $0.07 
Board [7c 8s 2h 3c]
Seat 1: fred00205 folded before Flop (didn't bet)
Seat 2: attilakorte collected ($1.40)
Seat 3: nosachkn folded before Flop (didn't bet)
Seat 4: baadnewz01 (button) folded on the Turn
Seat 5: Gintaras20 (small blind) folded before Flop
Seat 6: raydenel (big blind) folded before Flop



PokerStars Hand #222977760946:  Hold'em No Limit ($0.05/$0.10 USD) - 2021/01/23 18:28:52 ET
Table 'Transvaalia' 6-max Seat #5 is the button
Seat 1: fred00205 ($5.46 in chips) 
Seat 2: attilakorte ($11.36 in chips) 
Seat 3: nosachkn ($22.99 in chips) 
Seat 4: baadnewz01 ($22.73 in chips) 
Seat 5: Gintaras20 ($9.70 in chips) 
Seat 6: raydenel ($12.80 in chips) 
raydenel: posts small blind $0.05
fred00205: posts big blind $0.10
*** HOLE CARDS ***
attilakorte: folds 
nosachkn: folds 
baadnewz01: folds 
Gintaras20: folds 
raydenel: raises $0.15 to $0.25
fred00205: raises $5.21 to $5.46 and is all-in
raydenel: folds 
Uncalled bet ($5.21) returned to fred00205
fred00205 collected $0.50 from pot
fred00205: doesn't show hand 
*** SUMMARY ***
Total pot $0.50 | Rake $0 
Seat 1: fred00205 (big blind) collected ($0.50)
Seat 2: attilakorte folded before Flop (didn't bet)
Seat 3: nosachkn folded before Flop (didn't bet)
Seat 4: baadnewz01 folded before Flop (didn't bet)
Seat 5: Gintaras20 (button) folded before Flop (didn't bet)
Seat 6: raydenel (small blind) folded before Flop



PokerStars Hand #222977786142:  Hold'em No Limit ($0.05/$0.10 USD) - 2021/01/23 18:29:31 ET
Table 'Transvaalia' 6-max Seat #6 is the button
Seat 1: fred00205 ($5.71 in chips) 
Seat 2: attilakorte ($11.36 in chips) 
Seat 3: nosachkn ($22.99 in chips) 
Seat 4: baadnewz01 ($22.73 in chips) 
Seat 5: Gintaras20 ($9.70 in chips) 
Seat 6: raydenel ($12.55 in chips) 
fred00205: posts small blind $0.05
attilakorte: posts big blind $0.10
*** HOLE CARDS ***
nosachkn: raises $0.30 to $0.40
baadnewz01: calls $0.40
Gintaras20: folds 
raydenel: folds 
fred00205: folds 
attilakorte: calls $0.30
*** FLOP *** [2d Qs Jh]
attilakorte: checks 
nosachkn: checks 
baadnewz01: checks 
*** TURN *** [2d Qs Jh] [Qh]
attilakorte: checks 
nosachkn: checks 
baadnewz01: checks 
*** RIVER *** [2d Qs Jh Qh] [Qd]
attilakorte: checks 
nosachkn: checks 
baadnewz01: checks 
*** SHOW DOWN ***
attilakorte: shows [4s 4d] (a full house, Queens full of Fours)
nosachkn: mucks hand 
baadnewz01: shows [9d 9s] (a full house, Queens full of Nines)
baadnewz01 collected $1.19 from pot
*** SUMMARY ***
Total pot $1.25 | Rake $0.06 
Board [2d Qs Jh Qh Qd]
Seat 1: fred00205 (small blind) folded before Flop
Seat 2: attilakorte (big blind) showed [4s 4d] and lost with a full house, Queens full of Fours
Seat 3: nosachkn mucked
Seat 4: baadnewz01 showed [9d 9s] and won ($1.19) with a full house, Queens full of Nines
Seat 5: Gintaras20 folded before Flop (didn't bet)
Seat 6: raydenel (button) folded before Flop (didn't bet)



PokerStars Hand #222977833056:  Hold'em No Limit ($0.05/$0.10 USD) - 2021/01/23 18:30:43 ET
Table 'Transvaalia' 6-max Seat #1 is the button
Seat 1: fred00205 ($5.66 in chips) 
Seat 2: attilakorte ($10.96 in chips) 
Seat 3: nosachkn ($22.59 in chips) 
Seat 4: baadnewz01 ($23.52 in chips) 
Seat 5: Gintaras20 ($9.70 in chips) 
Seat 6: raydenel ($12.55 in chips) 
attilakorte: posts small blind $0.05
nosachkn: posts big blind $0.10
*** HOLE CARDS ***
baadnewz01: folds 
baadnewz01 leaves the table
Gintaras20: folds 
raydenel: folds 
fred00205: folds 
attilakorte: raises $0.12 to $0.22
nosachkn: folds 
Uncalled bet ($0.12) returned to attilakorte
attilakorte collected $0.20 from pot
attilakorte: doesn't show hand 
*** SUMMARY ***
Total pot $0.20 | Rake $0 
Seat 1: fred00205 (button) folded before Flop (didn't bet)
Seat 2: attilakorte (small blind) collected ($0.20)
Seat 3: nosachkn (big blind) folded before Flop
Seat 4: baadnewz01 folded before Flop (didn't bet)
Seat 5: Gintaras20 folded before Flop (didn't bet)
Seat 6: raydenel folded before Flop (didn't bet)



PokerStars Hand #222977842885:  Hold'em No Limit ($0.05/$0.10 USD) - 2021/01/23 18:30:58 ET
Table 'Transvaalia' 6-max Seat #2 is the button
Seat 1: fred00205 ($5.66 in chips) 
Seat 2: attilakorte ($11.06 in chips) 
Seat 3: nosachkn ($22.49 in chips) 
Seat 5: Gintaras20 ($9.70 in chips) 
Seat 6: raydenel ($12.55 in chips) 
nosachkn: posts small blind $0.05
Gintaras20: posts big blind $0.10
*** HOLE CARDS ***
raydenel: raises $0.20 to $0.30
fred00205: folds 
attilakorte: folds 
nosachkn: folds 
Gintaras20: folds 
Uncalled bet ($0.20) returned to raydenel
raydenel collected $0.25 from pot
raydenel: doesn't show hand 
*** SUMMARY ***
Total pot $0.25 | Rake $0 
Seat 1: fred00205 folded before Flop (didn't bet)
Seat 2: attilakorte (button) folded before Flop (didn't bet)
Seat 3: nosachkn (small blind) folded before Flop
Seat 5: Gintaras20 (big blind) folded before Flop
Seat 6: raydenel collected ($0.25)



PokerStars Hand #222977853931:  Hold'em No Limit ($0.05/$0.10 USD) - 2021/01/23 18:31:15 ET
Table 'Transvaalia' 6-max Seat #3 is the button
Seat 1: fred00205 ($5.66 in chips) 
Seat 2: attilakorte ($11.06 in chips) 
Seat 3: nosachkn ($22.44 in chips) 
Seat 5: Gintaras20 ($9.60 in chips) 
Seat 6: raydenel ($12.70 in chips) 
Gintaras20: posts small blind $0.05
raydenel: posts big blind $0.10
*** HOLE CARDS ***
fred00205: calls $0.10
attilakorte: folds 
nosachkn: raises $0.30 to $0.40
Gintaras20: folds 
raydenel: folds 
fred00205: calls $0.30
*** FLOP *** [4c Jc 2h]
fred00205: checks 
nosachkn: bets $0.46
fred00205: folds 
Uncalled bet ($0.46) returned to nosachkn
nosachkn collected $0.91 from pot
nosachkn: doesn't show hand 
*** SUMMARY ***
Total pot $0.95 | Rake $0.04 
Board [4c Jc 2h]
Seat 1: fred00205 folded on the Flop
Seat 2: attilakorte folded before Flop (didn't bet)
Seat 3: nosachkn (button) collected ($0.91)
Seat 5: Gintaras20 (small blind) folded before Flop
Seat 6: raydenel (big blind) folded before Flop



PokerStars Hand #222977870693:  Hold'em No Limit ($0.05/$0.10 USD) - 2021/01/23 18:31:41 ET
Table 'Transvaalia' 6-max Seat #5 is the button
Seat 1: fred00205 ($5.26 in chips) 
Seat 2: attilakorte ($11.06 in chips) 
Seat 3: nosachkn ($22.95 in chips) 
Seat 5: Gintaras20 ($9.55 in chips) 
Seat 6: raydenel ($12.60 in chips) 
raydenel: posts small blind $0.05
fred00205: posts big blind $0.10
*** HOLE CARDS ***
attilakorte: folds 
nosachkn: folds 
Gintaras20: folds 
raydenel: folds 
Uncalled bet ($0.05) returned to fred00205
fred00205 collected $0.10 from pot
fred00205: doesn't show hand 
*** SUMMARY ***
Total pot $0.10 | Rake $0 
Seat 1: fred00205 (big blind) collected ($0.10)
Seat 2: attilakorte folded before Flop (didn't bet)
Seat 3: nosachkn folded before Flop (didn't bet)
Seat 5: Gintaras20 (button) folded before Flop (didn't bet)
Seat 6: raydenel (small blind) folded before Flop



PokerStars Hand #222977876944:  Hold'em No Limit ($0.05/$0.10 USD) - 2021/01/23 18:31:50 ET
Table 'Transvaalia' 6-max Seat #6 is the button
Seat 1: fred00205 ($5.31 in chips) 
Seat 2: attilakorte ($11.06 in chips) 
Seat 3: nosachkn ($22.95 in chips) 
Seat 5: Gintaras20 ($9.55 in chips) 
Seat 6: raydenel ($12.55 in chips) 
fred00205: posts small blind $0.05
attilakorte: posts big blind $0.10
*** HOLE CARDS ***
nosachkn: folds 
Gintaras20: raises $0.15 to $0.25
kitkatcrs joins the table at seat #4 
raydenel: folds 
fred00205: folds 
attilakorte: folds 
Uncalled bet ($0.15) returned to Gintaras20
Gintaras20 collected $0.25 from pot
Gintaras20: doesn't show hand 
*** SUMMARY ***
Total pot $0.25 | Rake $0 
Seat 1: fred00205 (small blind) folded before Flop
Seat 2: attilakorte (big blind) folded before Flop
Seat 3: nosachkn folded before Flop (didn't bet)
Seat 5: Gintaras20 collected ($0.25)
Seat 6: raydenel (button) folded before Flop (didn't bet)



PokerStars Hand #222977883778:  Hold'em No Limit ($0.05/$0.10 USD) - 2021/01/23 18:32:01 ET
Table 'Transvaalia' 6-max Seat #1 is the button
Seat 1: fred00205 ($5.26 in chips) 
Seat 2: attilakorte ($10.96 in chips) 
Seat 3: nosachkn ($22.95 in chips) 
Seat 5: Gintaras20 ($9.70 in chips) 
Seat 6: raydenel ($12.55 in chips) 
attilakorte: posts small blind $0.05
nosachkn: posts big blind $0.10
kitkatcrs: sits out 
*** HOLE CARDS ***
Gintaras20: folds 
raydenel: folds 
fred00205: calls $0.10
attilakorte: folds 
nosachkn: checks 
*** FLOP *** [2s 8h Ks]
nosachkn: checks 
fred00205: checks 
*** TURN *** [2s 8h Ks] [2h]
nosachkn: checks 
fred00205: checks 
*** RIVER *** [2s 8h Ks 2h] [9d]
nosachkn: checks 
fred00205: bets $0.40
nosachkn: folds 
Uncalled bet ($0.40) returned to fred00205
fred00205 collected $0.24 from pot
fred00205: doesn't show hand 
*** SUMMARY ***
Total pot $0.25 | Rake $0.01 
Board [2s 8h Ks 2h 9d]
Seat 1: fred00205 (button) collected ($0.24)
Seat 2: attilakorte (small blind) folded before Flop
Seat 3: nosachkn (big blind) folded on the River
Seat 5: Gintaras20 folded before Flop (didn't bet)
Seat 6: raydenel folded before Flop (didn't bet)



PokerStars Hand #222977908924:  Hold'em No Limit ($0.05/$0.10 USD) - 2021/01/23 18:32:39 ET
Table 'Transvaalia' 6-max Seat #2 is the button
Seat 1: fred00205 ($5.40 in chips) 
Seat 2: attilakorte ($10.91 in chips) 
Seat 3: nosachkn ($22.85 in chips) 
Seat 4: kitkatcrs ($10 in chips) 
Seat 5: Gintaras20 ($9.70 in chips) 
Seat 6: raydenel ($12.55 in chips) 
nosachkn: posts small blind $0.05
kitkatcrs: posts big blind $0.10
*** HOLE CARDS ***
Gintaras20: folds 
raydenel: raises $0.20 to $0.30
fred00205: folds 
attilakorte: folds 
nosachkn: folds 
kitkatcrs: raises $0.70 to $1
raydenel: folds 
Uncalled bet ($0.70) returned to kitkatcrs
kitkatcrs collected $0.65 from pot
kitkatcrs: doesn't show hand 
*** SUMMARY ***
Total pot $0.65 | Rake $0 
Seat 1: fred00205 folded before Flop (didn't bet)
Seat 2: attilakorte (button) folded before Flop (didn't bet)
Seat 3: nosachkn (small blind) folded before Flop
Seat 4: kitkatcrs (big blind) collected ($0.65)
Seat 5: Gintaras20 folded before Flop (didn't bet)
Seat 6: raydenel folded before Flop



PokerStars Hand #222977928389:  Hold'em No Limit ($0.05/$0.10 USD) - 2021/01/23 18:33:09 ET
Table 'Transvaalia' 6-max Seat #3 is the button
Seat 1: fred00205 ($5.40 in chips) 
Seat 2: attilakorte ($10.91 in chips) 
Seat 3: nosachkn ($22.80 in chips) 
Seat 4: kitkatcrs ($10.35 in chips) 
Seat 5: Gintaras20 ($9.70 in chips) 
Seat 6: raydenel ($12.25 in chips) 
kitkatcrs: posts small blind $0.05
Gintaras20: posts big blind $0.10
*** HOLE CARDS ***
raydenel: folds 
fred00205: calls $0.10
attilakorte: folds 
nosachkn: raises $0.30 to $0.40
kitkatcrs: calls $0.35
Gintaras20: folds 
fred00205: calls $0.30
*** FLOP *** [9s Kd 6c]
kitkatcrs: checks 
fred00205: checks 
nosachkn: checks 
*** TURN *** [9s Kd 6c] [8s]
kitkatcrs: bets $0.50
fred00205: folds 
nosachkn: folds 
Uncalled bet ($0.50) returned to kitkatcrs
kitkatcrs collected $1.24 from pot
kitkatcrs: doesn't show hand 
*** SUMMARY ***
Total pot $1.30 | Rake $0.06 
Board [9s Kd 6c 8s]
Seat 1: fred00205 folded on the Turn
Seat 2: attilakorte folded before Flop (didn't bet)
Seat 3: nosachkn (button) folded on the Turn
Seat 4: kitkatcrs (small blind) collected ($1.24)
Seat 5: Gintaras20 (big blind) folded before Flop
Seat 6: raydenel folded before Flop (didn't bet)



PokerStars Hand #222977973120:  Hold'em No Limit ($0.05/$0.10 USD) - 2021/01/23 18:34:17 ET
Table 'Transvaalia' 6-max Seat #4 is the button
Seat 1: fred00205 ($5 in chips) 
Seat 2: attilakorte ($10.91 in chips) 
Seat 3: nosachkn ($22.40 in chips) 
Seat 4: kitkatcrs ($11.19 in chips) 
Seat 5: Gintaras20 ($9.60 in chips) 
Gintaras20: posts small blind $0.05
raydenel: is sitting out 
fred00205: posts big blind $0.10
*** HOLE CARDS ***
attilakorte: folds 
raydenel leaves the table
nosachkn: folds 
kitkatcrs: folds 
Gintaras20: folds 
Uncalled bet ($0.05) returned to fred00205
fred00205 collected $0.10 from pot
fred00205: doesn't show hand 
*** SUMMARY ***
Total pot $0.10 | Rake $0 
Seat 1: fred00205 (big blind) collected ($0.10)
Seat 2: attilakorte folded before Flop (didn't bet)
Seat 3: nosachkn folded before Flop (didn't bet)
Seat 4: kitkatcrs (button) folded before Flop (didn't bet)
Seat 5: Gintaras20 (small blind) folded before Flop



PokerStars Hand #222977979477:  Hold'em No Limit ($0.05/$0.10 USD) - 2021/01/23 18:34:27 ET
Table 'Transvaalia' 6-max Seat #5 is the button
Seat 1: fred00205 ($5.05 in chips) 
Seat 2: attilakorte ($10.91 in chips) 
Seat 3: nosachkn ($22.40 in chips) 
Seat 4: kitkatcrs ($11.19 in chips) 
Seat 5: Gintaras20 ($9.55 in chips) 
fred00205: posts small blind $0.05
attilakorte: posts big blind $0.10
*** HOLE CARDS ***
nosachkn: raises $0.20 to $0.30
kitkatcrs: folds 
Gintaras20: folds 
fred00205: folds 
attilakorte: folds 
Uncalled bet ($0.20) returned to nosachkn
nosachkn collected $0.25 from pot
nosachkn: doesn't show hand 
*** SUMMARY ***
Total pot $0.25 | Rake $0 
Seat 1: fred00205 (small blind) folded before Flop
Seat 2: attilakorte (big blind) folded before Flop
Seat 3: nosachkn collected ($0.25)
Seat 4: kitkatcrs folded before Flop (didn't bet)
Seat 5: Gintaras20 (button) folded before Flop (didn't bet)



PokerStars Hand #222977990353:  Hold'em No Limit ($0.05/$0.10 USD) - 2021/01/23 18:34:43 ET
Table 'Transvaalia' 6-max Seat #1 is the button
Seat 1: fred00205 ($5 in chips) 
Seat 2: attilakorte ($10.81 in chips) 
Seat 3: nosachkn ($22.55 in chips) 
Seat 4: kitkatcrs ($11.19 in chips) 
Seat 5: Gintaras20 ($9.55 in chips) 
attilakorte: posts small blind $0.05
nosachkn: posts big blind $0.10
*** HOLE CARDS ***
kitkatcrs: folds 
Gintaras20: folds 
fred00205: calls $0.10
attilakorte: folds 
nosachkn: checks 
*** FLOP *** [4c 3s As]
nosachkn: checks 
fred00205: checks 
*** TURN *** [4c 3s As] [Qs]
nosachkn: checks 
fred00205: checks 
*** RIVER *** [4c 3s As Qs] [6s]
nosachkn: checks 
fred00205: checks 
*** SHOW DOWN ***
nosachkn: shows [9c 4d] (a pair of Fours)
fred00205: shows [6h 7h] (a pair of Sixes)
fred00205 collected $0.24 from pot
*** SUMMARY ***
Total pot $0.25 | Rake $0.01 
Board [4c 3s As Qs 6s]
Seat 1: fred00205 (button) showed [6h 7h] and won ($0.24) with a pair of Sixes
Seat 2: attilakorte (small blind) folded before Flop
Seat 3: nosachkn (big blind) showed [9c 4d] and lost with a pair of Fours
Seat 4: kitkatcrs folded before Flop (didn't bet)
Seat 5: Gintaras20 folded before Flop (didn't bet)



PokerStars Hand #222978011128:  Hold'em No Limit ($0.05/$0.10 USD) - 2021/01/23 18:35:15 ET
Table 'Transvaalia' 6-max Seat #2 is the button
Seat 1: fred00205 ($5.14 in chips) 
Seat 2: attilakorte ($10.76 in chips) 
Seat 3: nosachkn ($22.45 in chips) 
Seat 4: kitkatcrs ($11.19 in chips) 
Seat 5: Gintaras20 ($9.55 in chips) 
nosachkn: posts small blind $0.05
kitkatcrs: posts big blind $0.10
*** HOLE CARDS ***
Gintaras20: raises $0.15 to $0.25
fred00205: calls $0.25
attilakorte: folds 
nosachkn: folds 
kitkatcrs: folds 
*** FLOP *** [Ks 4c 8s]
Gintaras20: bets $0.47
fred00205: calls $0.47
*** TURN *** [Ks 4c 8s] [7h]
Gintaras20: bets $1.14
fred00205: folds 
Uncalled bet ($1.14) returned to Gintaras20
Gintaras20 collected $1.52 from pot
Gintaras20: doesn't show hand 
*** SUMMARY ***
Total pot $1.59 | Rake $0.07 
Board [Ks 4c 8s 7h]
Seat 1: fred00205 folded on the Turn
Seat 2: attilakorte (button) folded before Flop (didn't bet)
Seat 3: nosachkn (small blind) folded before Flop
Seat 4: kitkatcrs (big blind) folded before Flop
Seat 5: Gintaras20 collected ($1.52)



PokerStars Hand #222978039071:  Hold'em No Limit ($0.05/$0.10 USD) - 2021/01/23 18:35:58 ET
Table 'Transvaalia' 6-max Seat #3 is the button
Seat 1: fred00205 ($4.42 in chips) 
Seat 2: attilakorte ($10.76 in chips) 
Seat 3: nosachkn ($22.40 in chips) 
Seat 4: kitkatcrs ($11.09 in chips) 
Seat 5: Gintaras20 ($10.35 in chips) 
kitkatcrs: posts small blind $0.05
Gintaras20: posts big blind $0.10
*** HOLE CARDS ***
fred00205: calls $0.10
attilakorte: folds 
nosachkn: raises $0.30 to $0.40
kitkatcrs: folds 
Gintaras20: folds 
MurphyCooler joins the table at seat #6 
fred00205: calls $0.30
*** FLOP *** [2c 6c 3s]
fred00205: checks 
kitkatcrs leaves the table
nosachkn: bets $0.46
fred00205: folds 
Uncalled bet ($0.46) returned to nosachkn
nosachkn collected $0.91 from pot
nosachkn: doesn't show hand 
*** SUMMARY ***
Total pot $0.95 | Rake $0.04 
Board [2c 6c 3s]
Seat 1: fred00205 folded on the Flop
Seat 2: attilakorte folded before Flop (didn't bet)
Seat 3: nosachkn (button) collected ($0.91)
Seat 4: kitkatcrs (small blind) folded before Flop
Seat 5: Gintaras20 (big blind) folded before Flop



PokerStars Hand #222978060272:  Hold'em No Limit ($0.05/$0.10 USD) - 2021/01/23 18:36:31 ET
Table 'Transvaalia' 6-max Seat #5 is the button
Seat 1: fred00205 ($4.02 in chips) 
Seat 2: attilakorte ($10.76 in chips) 
Seat 3: nosachkn ($22.91 in chips) 
Seat 5: Gintaras20 ($10.25 in chips) 
fred00205: posts small blind $0.05
attilakorte: posts big blind $0.10
*** HOLE CARDS ***
nosachkn: folds 
Gintaras20: raises $0.15 to $0.25
fred00205: folds 
attilakorte: folds 
Uncalled bet ($0.15) returned to Gintaras20
Gintaras20 collected $0.25 from pot
Gintaras20: doesn't show hand 
*** SUMMARY ***
Total pot $0.25 | Rake $0 
Seat 1: fred00205 (small blind) folded before Flop
Seat 2: attilakorte (big blind) folded before Flop
Seat 3: nosachkn folded before Flop (didn't bet)
Seat 5: Gintaras20 (button) collected ($0.25)



PokerStars Hand #222978068225:  Hold'em No Limit ($0.05/$0.10 USD) - 2021/01/23 18:36:43 ET
Table 'Transvaalia' 6-max Seat #1 is the button
Seat 1: fred00205 ($3.97 in chips) 
Seat 2: attilakorte ($10.66 in chips) 
Seat 3: nosachkn ($22.91 in chips) 
Seat 5: Gintaras20 ($10.40 in chips) 
Seat 6: MurphyCooler ($8 in chips) 
attilakorte: posts small blind $0.05
nosachkn: posts big blind $0.10
MurphyCooler: posts big blind $0.10
*** HOLE CARDS ***
Gintaras20: raises $0.25 to $0.35
MurphyCooler: folds 
alexos04 joins the table at seat #4 
fred00205: folds 
attilakorte: folds 
nosachkn: folds 
Uncalled bet ($0.25) returned to Gintaras20
Gintaras20 collected $0.35 from pot
Gintaras20: doesn't show hand 
*** SUMMARY ***
Total pot $0.35 | Rake $0 
Seat 1: fred00205 (button) folded before Flop (didn't bet)
Seat 2: attilakorte (small blind) folded before Flop
Seat 3: nosachkn (big blind) folded before Flop
Seat 5: Gintaras20 collected ($0.35)
Seat 6: MurphyCooler folded before Flop (didn't bet)



PokerStars Hand #222978080780:  Hold'em No Limit ($0.05/$0.10 USD) - 2021/01/23 18:37:03 ET
Table 'Transvaalia' 6-max Seat #2 is the button
Seat 1: fred00205 ($3.97 in chips) 
Seat 2: attilakorte ($10.61 in chips) 
Seat 3: nosachkn ($22.81 in chips) 
Seat 4: alexos04 ($10 in chips) 
Seat 5: Gintaras20 ($10.65 in chips) 
Seat 6: MurphyCooler ($7.90 in chips) 
nosachkn: posts small blind $0.05
alexos04: posts big blind $0.10
*** HOLE CARDS ***
Gintaras20: folds 
MurphyCooler: folds 
fred00205: folds 
attilakorte: folds 
nosachkn: folds 
Uncalled bet ($0.05) returned to alexos04
alexos04 collected $0.10 from pot
alexos04: doesn't show hand 
*** SUMMARY ***
Total pot $0.10 | Rake $0 
Seat 1: fred00205 folded before Flop (didn't bet)
Seat 2: attilakorte (button) folded before Flop (didn't bet)
Seat 3: nosachkn (small blind) folded before Flop
Seat 4: alexos04 (big blind) collected ($0.10)
Seat 5: Gintaras20 folded before Flop (didn't bet)
Seat 6: MurphyCooler folded before Flop (didn't bet)



PokerStars Hand #222978089665:  Hold'em No Limit ($0.05/$0.10 USD) - 2021/01/23 18:37:16 ET
Table 'Transvaalia' 6-max Seat #3 is the button
Seat 1: fred00205 ($3.97 in chips) 
Seat 2: attilakorte ($10.61 in chips) 
Seat 3: nosachkn ($22.76 in chips) 
Seat 4: alexos04 ($10.05 in chips) 
Seat 5: Gintaras20 ($10.65 in chips) 
Seat 6: MurphyCooler ($7.90 in chips) 
alexos04: posts small blind $0.05
Gintaras20: posts big blind $0.10
*** HOLE CARDS ***
MurphyCooler: calls $0.10
fred00205: folds 
attilakorte: folds 
nosachkn: folds 
alexos04: raises $0.30 to $0.40
Gintaras20: folds 
MurphyCooler: calls $0.30
*** FLOP *** [Ac 4d 4c]
alexos04: bets $0.30
MurphyCooler: raises $0.30 to $0.60
alexos04: folds 
Uncalled bet ($0.30) returned to MurphyCooler
MurphyCooler collected $1.43 from pot
MurphyCooler: doesn't show hand 
*** SUMMARY ***
Total pot $1.50 | Rake $0.07 
Board [Ac 4d 4c]
Seat 1: fred00205 folded before Flop (didn't bet)
Seat 2: attilakorte folded before Flop (didn't bet)
Seat 3: nosachkn (button) folded before Flop (didn't bet)
Seat 4: alexos04 (small blind) folded on the Flop
Seat 5: Gintaras20 (big blind) folded before Flop
Seat 6: MurphyCooler collected ($1.43)



PokerStars Hand #222978113080:  Hold'em No Limit ($0.05/$0.10 USD) - 2021/01/23 18:37:53 ET
Table 'Transvaalia' 6-max Seat #4 is the button
Seat 1: fred00205 ($3.97 in chips) 
Seat 2: attilakorte ($10.61 in chips) 
Seat 3: nosachkn ($22.76 in chips) 
Seat 4: alexos04 ($10 in chips) 
Seat 6: MurphyCooler ($8.63 in chips) 
MurphyCooler: posts small blind $0.05
fred00205: posts big blind $0.10
*** HOLE CARDS ***
attilakorte: raises $0.12 to $0.22
nosachkn: folds 
alexos04: folds 
MurphyCooler: folds 
fred00205: folds 
Uncalled bet ($0.12) returned to attilakorte
attilakorte collected $0.25 from pot
attilakorte: doesn't show hand 
*** SUMMARY ***
Total pot $0.25 | Rake $0 
Seat 1: fred00205 (big blind) folded before Flop
Seat 2: attilakorte collected ($0.25)
Seat 3: nosachkn folded before Flop (didn't bet)
Seat 4: alexos04 (button) folded before Flop (didn't bet)
Seat 6: MurphyCooler (small blind) folded before Flop



PokerStars Hand #222978123516:  Hold'em No Limit ($0.05/$0.10 USD) - 2021/01/23 18:38:09 ET
Table 'Transvaalia' 6-max Seat #6 is the button
Seat 1: fred00205 ($3.87 in chips) 
Seat 2: attilakorte ($10.76 in chips) 
Seat 3: nosachkn ($22.76 in chips) 
Seat 4: alexos04 ($10 in chips) 
Seat 6: MurphyCooler ($8.58 in chips) 
fred00205: posts small blind $0.05
attilakorte: posts big blind $0.10
*** HOLE CARDS ***
nosachkn: folds 
alexos04: folds 
MurphyCooler: calls $0.10
fred00205: calls $0.05
attilakorte: checks 
*** FLOP *** [Jd 7d Ad]
fred00205: checks 
attilakorte: bets $0.15
MurphyCooler: folds 
fred00205: calls $0.15
*** TURN *** [Jd 7d Ad] [Kc]
fred00205: checks 
attilakorte: bets $0.50
fred00205: calls $0.50
*** RIVER *** [Jd 7d Ad Kc] [7c]
fred00205: checks 
attilakorte: bets $1.50
fred00205: raises $1.62 to $3.12 and is all-in
attilakorte: calls $1.62
*** SHOW DOWN ***
fred00205: shows [Ah Ts] (two pair, Aces and Sevens)
attilakorte: shows [6d 2d] (a flush, Ace high)
attilakorte collected $7.49 from pot
*** SUMMARY ***
Total pot $7.84 | Rake $0.35 
Board [Jd 7d Ad Kc 7c]
Seat 1: fred00205 (small blind) showed [Ah Ts] and lost with two pair, Aces and Sevens
Seat 2: attilakorte (big blind) showed [6d 2d] and won ($7.49) with a flush, Ace high
Seat 3: nosachkn folded before Flop (didn't bet)
Seat 4: alexos04 folded before Flop (didn't bet)
Seat 6: MurphyCooler (button) folded on the Flop



PokerStars Hand #222978161932:  Hold'em No Limit ($0.05/$0.10 USD) - 2021/01/23 18:39:09 ET
Table 'Transvaalia' 6-max Seat #2 is the button
Seat 2: attilakorte ($14.38 in chips) 
Seat 3: nosachkn ($22.76 in chips) 
Seat 4: alexos04 ($10 in chips) 
Seat 6: MurphyCooler ($8.48 in chips) 
nosachkn: posts small blind $0.05
alexos04: posts big blind $0.10
*** HOLE CARDS ***
MurphyCooler: folds 
attilakorte: folds 
nosachkn: folds 
Uncalled bet ($0.05) returned to alexos04
alexos04 collected $0.10 from pot
alexos04: doesn't show hand 
fred00205 leaves the table
*** SUMMARY ***
Total pot $0.10 | Rake $0 
Seat 2: attilakorte (button) folded before Flop (didn't bet)
Seat 3: nosachkn (small blind) folded before Flop
Seat 4: alexos04 (big blind) collected ($0.10)
Seat 6: MurphyCooler folded before Flop (didn't bet)



PokerStars Hand #222978166921:  Hold'em No Limit ($0.05/$0.10 USD) - 2021/01/23 18:39:17 ET
Table 'Transvaalia' 6-max Seat #3 is the button
Seat 2: attilakorte ($14.38 in chips) 
Seat 3: nosachkn ($22.71 in chips) 
Seat 4: alexos04 ($10.05 in chips) 
Seat 6: MurphyCooler ($8.48 in chips) 
alexos04: posts small blind $0.05
MurphyCooler: posts big blind $0.10
*** HOLE CARDS ***
attilakorte: folds 
nosachkn: folds 
alexos04: raises $0.20 to $0.30
MurphyCooler: folds 
Uncalled bet ($0.20) returned to alexos04
alexos04 collected $0.20 from pot
alexos04: doesn't show hand 
*** SUMMARY ***
Total pot $0.20 | Rake $0 
Seat 2: attilakorte folded before Flop (didn't bet)
Seat 3: nosachkn (button) folded before Flop (didn't bet)
Seat 4: alexos04 (small blind) collected ($0.20)
Seat 6: MurphyCooler (big blind) folded before Flop



PokerStars Hand #222978173503:  Hold'em No Limit ($0.05/$0.10 USD) - 2021/01/23 18:39:27 ET
Table 'Transvaalia' 6-max Seat #4 is the button
Seat 3: nosachkn ($22.71 in chips) 
Seat 4: alexos04 ($10.15 in chips) 
Seat 6: MurphyCooler ($8.38 in chips) 
MurphyCooler: posts small blind $0.05
attilakorte: is sitting out 
nosachkn: posts big blind $0.10
*** HOLE CARDS ***
alexos04: folds 
MurphyCooler: folds 
Uncalled bet ($0.05) returned to nosachkn
nosachkn collected $0.10 from pot
nosachkn: doesn't show hand 
*** SUMMARY ***
Total pot $0.10 | Rake $0 
Seat 3: nosachkn (big blind) collected ($0.10)
Seat 4: alexos04 (button) folded before Flop (didn't bet)
Seat 6: MurphyCooler (small blind) folded before Flop



PokerStars Hand #222978179199:  Hold'em No Limit ($0.05/$0.10 USD) - 2021/01/23 18:39:36 ET
Table 'Transvaalia' 6-max Seat #6 is the button
Seat 3: nosachkn ($22.76 in chips) 
Seat 4: alexos04 ($10.15 in chips) 
Seat 6: MurphyCooler ($8.33 in chips) 
nosachkn: posts small blind $0.05
alexos04: posts big blind $0.10
*** HOLE CARDS ***
MurphyCooler: folds 
nosachkn: folds 
Uncalled bet ($0.05) returned to alexos04
alexos04 collected $0.10 from pot
alexos04: doesn't show hand 
*** SUMMARY ***
Total pot $0.10 | Rake $0 
Seat 3: nosachkn (small blind) folded before Flop
Seat 4: alexos04 (big blind) collected ($0.10)
Seat 6: MurphyCooler (button) folded before Flop (didn't bet)



PokerStars Hand #222978184271:  Hold'em No Limit ($0.05/$0.10 USD) - 2021/01/23 18:39:44 ET
Table 'Transvaalia' 6-max Seat #3 is the button
Seat 3: nosachkn ($22.71 in chips) 
Seat 4: alexos04 ($10.20 in chips) 
Seat 6: MurphyCooler ($8.33 in chips) 
alexos04: posts small blind $0.05
MurphyCooler: posts big blind $0.10
*** HOLE CARDS ***
attilakorte leaves the table
nosachkn: raises $0.10 to $0.20
alexos04: folds 
MurphyCooler: calls $0.10
*** FLOP *** [6s Tc As]
MurphyCooler: checks 
nosachkn: checks 
*** TURN *** [6s Tc As] [9c]
MurphyCooler: checks 
nosachkn: bets $0.22
MurphyCooler: calls $0.22
*** RIVER *** [6s Tc As 9c] [8s]
MurphyCooler: bets $0.85
nosachkn: folds 
Uncalled bet ($0.85) returned to MurphyCooler
MurphyCooler collected $0.85 from pot
MurphyCooler: doesn't show hand 
*** SUMMARY ***
Total pot $0.89 | Rake $0.04 
Board [6s Tc As 9c 8s]
Seat 3: nosachkn (button) folded on the River
Seat 4: alexos04 (small blind) folded before Flop
Seat 6: MurphyCooler (big blind) collected ($0.85)



PokerStars Hand #222978202636:  Hold'em No Limit ($0.05/$0.10 USD) - 2021/01/23 18:40:12 ET
Table 'Transvaalia' 6-max Seat #4 is the button
Seat 3: nosachkn ($22.29 in chips) 
Seat 4: alexos04 ($10.15 in chips) 
Seat 6: MurphyCooler ($8.76 in chips) 
MurphyCooler: posts small blind $0.05
nosachkn: posts big blind $0.10
*** HOLE CARDS ***
alexos04: folds 
MurphyCooler: calls $0.05
nosachkn: raises $0.10 to $0.20
MurphyCooler: calls $0.10
*** FLOP *** [7c Jh Tc]
MurphyCooler: checks 
nosachkn: bets $0.25
MurphyCooler: folds 
Uncalled bet ($0.25) returned to nosachkn
nosachkn collected $0.38 from pot
nosachkn: doesn't show hand 
*** SUMMARY ***
Total pot $0.40 | Rake $0.02 
Board [7c Jh Tc]
Seat 3: nosachkn (big blind) collected ($0.38)
Seat 4: alexos04 (button) folded before Flop (didn't bet)
Seat 6: MurphyCooler (small blind) folded on the Flop



PokerStars Hand #222978213566:  Hold'em No Limit ($0.05/$0.10 USD) - 2021/01/23 18:40:30 ET
Table 'Transvaalia' 6-max Seat #6 is the button
Seat 3: nosachkn ($22.47 in chips) 
Seat 4: alexos04 ($10.15 in chips) 
Seat 6: MurphyCooler ($8.56 in chips) 
nosachkn: posts small blind $0.05
alexos04: posts big blind $0.10
*** HOLE CARDS ***
MurphyCooler: folds 
nosachkn: raises $0.10 to $0.20
alexos04: folds 
Uncalled bet ($0.10) returned to nosachkn
nosachkn collected $0.20 from pot
nosachkn: doesn't show hand 
*** SUMMARY ***
Total pot $0.20 | Rake $0 
Seat 3: nosachkn (small blind) collected ($0.20)
Seat 4: alexos04 (big blind) folded before Flop
Seat 6: MurphyCooler (button) folded before Flop (didn't bet)



PokerStars Hand #222978219773:  Hold'em No Limit ($0.05/$0.10 USD) - 2021/01/23 18:40:39 ET
Table 'Transvaalia' 6-max Seat #3 is the button
Seat 3: nosachkn ($22.57 in chips) 
Seat 4: alexos04 ($10.05 in chips) 
Seat 6: MurphyCooler ($8.56 in chips) 
alexos04: posts small blind $0.05
MurphyCooler: posts big blind $0.10
*** HOLE CARDS ***
nosachkn: raises $0.10 to $0.20
alexos04: calls $0.15
MurphyCooler: folds 
*** FLOP *** [8d Js 9s]
alexos04: checks 
nosachkn: bets $0.32
alexos04: calls $0.32
*** TURN *** [8d Js 9s] [As]
alexos04: checks 
nosachkn: bets $0.55
betfair21 joins the table at seat #1 
alexos04: folds 
Uncalled bet ($0.55) returned to nosachkn
nosachkn collected $1.09 from pot
Gintaras20 was removed from the table for failing to post
Gintaras20 leaves the table
nosachkn: doesn't show hand 
*** SUMMARY ***
Total pot $1.14 | Rake $0.05 
Board [8d Js 9s As]
Seat 3: nosachkn (button) collected ($1.09)
Seat 4: alexos04 (small blind) folded on the Turn
Seat 6: MurphyCooler (big blind) folded before Flop



PokerStars Hand #222978248979:  Hold'em No Limit ($0.05/$0.10 USD) - 2021/01/23 18:41:25 ET
Table 'Transvaalia' 6-max Seat #4 is the button
Seat 3: nosachkn ($23.14 in chips) 
Seat 4: alexos04 ($10 in chips) 
Seat 6: MurphyCooler ($8.46 in chips) 
MurphyCooler: posts small blind $0.05
nosachkn: posts big blind $0.10
*** HOLE CARDS ***
alexos04: raises $0.20 to $0.30
MurphyCooler: calls $0.25
nosachkn: folds 
*** FLOP *** [2h Ks 3h]
MurphyCooler: checks 
alexos04: bets $0.30
MurphyCooler: folds 
Uncalled bet ($0.30) returned to alexos04
alexos04 collected $0.67 from pot
alexos04: doesn't show hand 
*** SUMMARY ***
Total pot $0.70 | Rake $0.03 
Board [2h Ks 3h]
Seat 3: nosachkn (big blind) folded before Flop
Seat 4: alexos04 (button) collected ($0.67)
Seat 6: MurphyCooler (small blind) folded on the Flop



PokerStars Hand #222978260542:  Hold'em No Limit ($0.05/$0.10 USD) - 2021/01/23 18:41:44 ET
Table 'Transvaalia' 6-max Seat #6 is the button
Seat 3: nosachkn ($23.04 in chips) 
Seat 4: alexos04 ($10.37 in chips) 
Seat 6: MurphyCooler ($8.16 in chips) 
nosachkn: posts small blind $0.05
alexos04: posts big blind $0.10
*** HOLE CARDS ***
MurphyCooler: folds 
nosachkn: raises $0.10 to $0.20
alexos04: raises $0.70 to $0.90
nosachkn: calls $0.70
*** FLOP *** [4h 4s 2d]
nosachkn: checks 
alexos04: bets $1.10
ryankozlegeny joins the table at seat #5 
nosachkn: folds 
Uncalled bet ($1.10) returned to alexos04
alexos04 collected $1.72 from pot
alexos04: doesn't show hand 
*** SUMMARY ***
Total pot $1.80 | Rake $0.08 
Board [4h 4s 2d]
Seat 3: nosachkn (small blind) folded on the Flop
Seat 4: alexos04 (big blind) collected ($1.72)
Seat 6: MurphyCooler (button) folded before Flop (didn't bet)



PokerStars Hand #222978807530:  Hold'em No Limit ($0.05/$0.10 USD) - 2021/01/23 18:56:36 ET
Table 'Transvaalia' 6-max Seat #4 is the button
Seat 1: Wagner GT ($10 in chips) 
Seat 2: Vecherov ($10 in chips) 
Seat 3: Caigoo ($13.02 in chips) 
Seat 4: alexos04 ($10 in chips) 
Seat 5: OllieMac86 ($10.53 in chips) 
Seat 6: MurphyCooler ($8.56 in chips) 
OllieMac86: posts small blind $0.05
MurphyCooler: posts big blind $0.10
*** HOLE CARDS ***
Wagner GT: raises $0.15 to $0.25
Vecherov: folds 
Caigoo: raises $0.50 to $0.75
alexos04: folds 
OllieMac86: folds 
MurphyCooler: folds 
Wagner GT: folds 
Uncalled bet ($0.50) returned to Caigoo
Caigoo collected $0.65 from pot
Caigoo: doesn't show hand 
*** SUMMARY ***
Total pot $0.65 | Rake $0 
Seat 1: Wagner GT folded before Flop
Seat 2: Vecherov folded before Flop (didn't bet)
Seat 3: Caigoo collected ($0.65)
Seat 4: alexos04 (button) folded before Flop (didn't bet)
Seat 5: OllieMac86 (small blind) folded before Flop
Seat 6: MurphyCooler (big blind) folded before Flop



PokerStars Hand #222978820772:  Hold'em No Limit ($0.05/$0.10 USD) - 2021/01/23 18:57:06 ET
Table 'Transvaalia' 6-max Seat #5 is the button
Seat 1: Wagner GT ($10 in chips) 
Seat 2: Vecherov ($10 in chips) 
Seat 3: Caigoo ($13.42 in chips) 
Seat 4: alexos04 ($10 in chips) 
Seat 5: OllieMac86 ($10.48 in chips) 
Seat 6: MurphyCooler ($8.46 in chips) 
MurphyCooler: posts small blind $0.05
Wagner GT: posts big blind $0.10
*** HOLE CARDS ***
Vecherov: folds 
Caigoo: folds 
alexos04: folds 
OllieMac86: folds 
MurphyCooler: folds 
Uncalled bet ($0.05) returned to Wagner GT
Wagner GT collected $0.10 from pot
Wagner GT: doesn't show hand 
*** SUMMARY ***
Total pot $0.10 | Rake $0 
Seat 1: Wagner GT (big blind) collected ($0.10)
Seat 2: Vecherov folded before Flop (didn't bet)
Seat 3: Caigoo folded before Flop (didn't bet)
Seat 4: alexos04 folded before Flop (didn't bet)
Seat 5: OllieMac86 (button) folded before Flop (didn't bet)
Seat 6: MurphyCooler (small blind) folded before Flop



PokerStars Hand #222978827047:  Hold'em No Limit ($0.05/$0.10 USD) - 2021/01/23 18:57:20 ET
Table 'Transvaalia' 6-max Seat #6 is the button
Seat 1: Wagner GT ($10.05 in chips) 
Seat 2: Vecherov ($10 in chips) 
Seat 3: Caigoo ($13.42 in chips) 
Seat 4: alexos04 ($10 in chips) 
Seat 5: OllieMac86 ($10.48 in chips) 
Seat 6: MurphyCooler ($8.41 in chips) 
Wagner GT: posts small blind $0.05
Vecherov: posts big blind $0.10
*** HOLE CARDS ***
Caigoo: folds 
alexos04: folds 
OllieMac86: folds 
MurphyCooler: calls $0.10
Wagner GT: folds 
Vecherov: checks 
*** FLOP *** [2c 6d 3d]
Vecherov: checks 
MurphyCooler: checks 
*** TURN *** [2c 6d 3d] [Jc]
Vecherov: checks 
MurphyCooler: bets $0.10
Vecherov: calls $0.10
*** RIVER *** [2c 6d 3d Jc] [9c]
Vecherov: checks 
MurphyCooler: checks 
*** SHOW DOWN ***
Vecherov: shows [5d 2s] (a pair of Deuces)
MurphyCooler: shows [Jh 7h] (a pair of Jacks)
MurphyCooler collected $0.43 from pot
*** SUMMARY ***
Total pot $0.45 | Rake $0.02 
Board [2c 6d 3d Jc 9c]
Seat 1: Wagner GT (small blind) folded before Flop
Seat 2: Vecherov (big blind) showed [5d 2s] and lost with a pair of Deuces
Seat 3: Caigoo folded before Flop (didn't bet)
Seat 4: alexos04 folded before Flop (didn't bet)
Seat 5: OllieMac86 folded before Flop (didn't bet)
Seat 6: MurphyCooler (button) showed [Jh 7h] and won ($0.43) with a pair of Jacks



PokerStars Hand #222978851423:  Hold'em No Limit ($0.05/$0.10 USD) - 2021/01/23 18:58:15 ET
Table 'Transvaalia' 6-max Seat #1 is the button
Seat 1: Wagner GT ($10 in chips) 
Seat 2: Vecherov ($10 in chips) 
Seat 3: Caigoo ($13.42 in chips) 
Seat 4: alexos04 ($10 in chips) 
Seat 5: OllieMac86 ($10.48 in chips) 
Seat 6: MurphyCooler ($8.64 in chips) 
Vecherov: posts small blind $0.05
Caigoo: posts big blind $0.10
*** HOLE CARDS ***
alexos04: folds 
OllieMac86: folds 
MurphyCooler: folds 
Wagner GT: raises $0.20 to $0.30
Vecherov: folds 
Caigoo: folds 
Uncalled bet ($0.20) returned to Wagner GT
Wagner GT collected $0.25 from pot
Wagner GT: doesn't show hand 
*** SUMMARY ***
Total pot $0.25 | Rake $0 
Seat 1: Wagner GT (button) collected ($0.25)
Seat 2: Vecherov (small blind) folded before Flop
Seat 3: Caigoo (big blind) folded before Flop
Seat 4: alexos04 folded before Flop (didn't bet)
Seat 5: OllieMac86 folded before Flop (didn't bet)
Seat 6: MurphyCooler folded before Flop (didn't bet)



PokerStars Hand #222978865841:  Hold'em No Limit ($0.05/$0.10 USD) - 2021/01/23 18:58:47 ET
Table 'Transvaalia' 6-max Seat #2 is the button
Seat 1: Wagner GT ($10.15 in chips) 
Seat 2: Vecherov ($10 in chips) 
Seat 3: Caigoo ($13.32 in chips) 
Seat 4: alexos04 ($10 in chips) 
Seat 5: OllieMac86 ($10.48 in chips) 
Seat 6: MurphyCooler ($8.64 in chips) 
Caigoo: posts small blind $0.05
alexos04: posts big blind $0.10
*** HOLE CARDS ***
OllieMac86: folds 
MurphyCooler: calls $0.10
Wagner GT: folds 
Vecherov: folds 
Caigoo: raises $0.30 to $0.40
alexos04: folds 
MurphyCooler: calls $0.30
*** FLOP *** [3d Ad Qs]
Caigoo: bets $0.50
MurphyCooler: folds 
Uncalled bet ($0.50) returned to Caigoo
Caigoo collected $0.86 from pot
Caigoo: doesn't show hand 
*** SUMMARY ***
Total pot $0.90 | Rake $0.04 
Board [3d Ad Qs]
Seat 1: Wagner GT folded before Flop (didn't bet)
Seat 2: Vecherov (button) folded before Flop (didn't bet)
Seat 3: Caigoo (small blind) collected ($0.86)
Seat 4: alexos04 (big blind) folded before Flop
Seat 5: OllieMac86 folded before Flop (didn't bet)
Seat 6: MurphyCooler folded on the Flop



PokerStars Hand #222978880008:  Hold'em No Limit ($0.05/$0.10 USD) - 2021/01/23 18:59:19 ET
Table 'Transvaalia' 6-max Seat #3 is the button
Seat 1: Wagner GT ($10.15 in chips) 
Seat 2: Vecherov ($10 in chips) 
Seat 3: Caigoo ($13.78 in chips) 
Seat 4: alexos04 ($10 in chips) 
Seat 5: OllieMac86 ($10.48 in chips) 
Seat 6: MurphyCooler ($8.24 in chips) 
alexos04: posts small blind $0.05
OllieMac86: posts big blind $0.10
*** HOLE CARDS ***
MurphyCooler: calls $0.10
Wagner GT: folds 
Vecherov: folds 
Caigoo: folds 
alexos04: folds 
OllieMac86: checks 
*** FLOP *** [Kh 3s 5c]
OllieMac86: checks 
MurphyCooler: checks 
*** TURN *** [Kh 3s 5c] [Jh]
OllieMac86: checks 
MurphyCooler: checks 
*** RIVER *** [Kh 3s 5c Jh] [2d]
OllieMac86: checks 
MurphyCooler: checks 
*** SHOW DOWN ***
OllieMac86: shows [7s Qs] (high card King)
MurphyCooler: shows [Js 9d] (a pair of Jacks)
MurphyCooler collected $0.24 from pot
*** SUMMARY ***
Total pot $0.25 | Rake $0.01 
Board [Kh 3s 5c Jh 2d]
Seat 1: Wagner GT folded before Flop (didn't bet)
Seat 2: Vecherov folded before Flop (didn't bet)
Seat 3: Caigoo (button) folded before Flop (didn't bet)
Seat 4: alexos04 (small blind) folded before Flop
Seat 5: OllieMac86 (big blind) showed [7s Qs] and lost with high card King
Seat 6: MurphyCooler showed [Js 9d] and won ($0.24) with a pair of Jacks



PokerStars Hand #222978892180:  Hold'em No Limit ($0.05/$0.10 USD) - 2021/01/23 18:59:46 ET
Table 'Transvaalia' 6-max Seat #4 is the button
Seat 1: Wagner GT ($10.15 in chips) 
Seat 2: Vecherov ($10 in chips) 
Seat 3: Caigoo ($13.78 in chips) 
Seat 4: alexos04 ($10 in chips) 
Seat 5: OllieMac86 ($10.38 in chips) 
Seat 6: MurphyCooler ($8.38 in chips) 
OllieMac86: posts small blind $0.05
MurphyCooler: posts big blind $0.10
*** HOLE CARDS ***
Wagner GT: folds 
Vecherov: folds 
Caigoo: folds 
alexos04: folds 
OllieMac86: raises $0.20 to $0.30
MurphyCooler: calls $0.20
*** FLOP *** [Tc Js 7s]
OllieMac86: checks 
MurphyCooler: checks 
*** TURN *** [Tc Js 7s] [Ks]
OllieMac86: bets $0.39
MurphyCooler: folds 
Uncalled bet ($0.39) returned to OllieMac86
OllieMac86 collected $0.57 from pot
OllieMac86: doesn't show hand 
*** SUMMARY ***
Total pot $0.60 | Rake $0.03 
Board [Tc Js 7s Ks]
Seat 1: Wagner GT folded before Flop (didn't bet)
Seat 2: Vecherov folded before Flop (didn't bet)
Seat 3: Caigoo folded before Flop (didn't bet)
Seat 4: alexos04 (button) folded before Flop (didn't bet)
Seat 5: OllieMac86 (small blind) collected ($0.57)
Seat 6: MurphyCooler (big blind) folded on the Turn



PokerStars Hand #222978901156:  Hold'em No Limit ($0.05/$0.10 USD) - 2021/01/23 19:00:06 ET
Table 'Transvaalia' 6-max Seat #5 is the button
Seat 1: Wagner GT ($10.15 in chips) 
Seat 2: Vecherov ($10 in chips) 
Seat 3: Caigoo ($13.78 in chips) 
Seat 4: alexos04 ($10 in chips) 
Seat 5: OllieMac86 ($10.65 in chips) 
Seat 6: MurphyCooler ($8.08 in chips) 
MurphyCooler: posts small blind $0.05
Wagner GT: posts big blind $0.10
*** HOLE CARDS ***
Vecherov: folds 
Caigoo: folds 
alexos04: folds 
OllieMac86: raises $0.20 to $0.30
MurphyCooler: calls $0.25
Wagner GT: calls $0.20
*** FLOP *** [Tc 8d 4s]
MurphyCooler: checks 
Wagner GT: checks 
OllieMac86: checks 
*** TURN *** [Tc 8d 4s] [6s]
MurphyCooler: checks 
Wagner GT: bets $0.65
OllieMac86: folds 
MurphyCooler: folds 
Uncalled bet ($0.65) returned to Wagner GT
Wagner GT collected $0.86 from pot
Wagner GT: doesn't show hand 
*** SUMMARY ***
Total pot $0.90 | Rake $0.04 
Board [Tc 8d 4s 6s]
Seat 1: Wagner GT (big blind) collected ($0.86)
Seat 2: Vecherov folded before Flop (didn't bet)
Seat 3: Caigoo folded before Flop (didn't bet)
Seat 4: alexos04 folded before Flop (didn't bet)
Seat 5: OllieMac86 (button) folded on the Turn
Seat 6: MurphyCooler (small blind) folded on the Turn



PokerStars Hand #222978923182:  Hold'em No Limit ($0.05/$0.10 USD) - 2021/01/23 19:00:51 ET
Table 'Transvaalia' 6-max Seat #6 is the button
Seat 1: Wagner GT ($10.71 in chips) 
Seat 3: Caigoo ($13.78 in chips) 
Seat 4: alexos04 ($10 in chips) 
Seat 5: OllieMac86 ($10.35 in chips) 
Seat 6: MurphyCooler ($7.78 in chips) 
Wagner GT: posts small blind $0.05
Vecherov: is sitting out 
Caigoo: posts big blind $0.10
*** HOLE CARDS ***
Vecherov leaves the table
alexos04: folds 
OllieMac86: folds 
MurphyCooler: folds 
No1Sparkles joins the table at seat #2 
Wagner GT: folds 
Uncalled bet ($0.05) returned to Caigoo
Caigoo collected $0.10 from pot
Caigoo: doesn't show hand 
*** SUMMARY ***
Total pot $0.10 | Rake $0 
Seat 1: Wagner GT (small blind) folded before Flop
Seat 3: Caigoo (big blind) collected ($0.10)
Seat 4: alexos04 folded before Flop (didn't bet)
Seat 5: OllieMac86 folded before Flop (didn't bet)
Seat 6: MurphyCooler (button) folded before Flop (didn't bet)



PokerStars Hand #222978931904:  Hold'em No Limit ($0.05/$0.10 USD) - 2021/01/23 19:01:07 ET
Table 'Transvaalia' 6-max Seat #1 is the button
Seat 1: Wagner GT ($10.66 in chips) 
Seat 3: Caigoo ($13.83 in chips) 
Seat 4: alexos04 ($10 in chips) 
Seat 5: OllieMac86 ($10.35 in chips) 
Seat 6: MurphyCooler ($7.78 in chips) 
Caigoo: posts small blind $0.05
alexos04: posts big blind $0.10
*** HOLE CARDS ***
OllieMac86: folds 
MurphyCooler: calls $0.10
Wagner GT: folds 
Caigoo: folds 
alexos04: checks 
*** FLOP *** [9d 7c Kd]
alexos04: checks 
MurphyCooler: checks 
*** TURN *** [9d 7c Kd] [5d]
alexos04: bets $0.20
MurphyCooler: folds 
Uncalled bet ($0.20) returned to alexos04
alexos04 collected $0.24 from pot
alexos04: doesn't show hand 
*** SUMMARY ***
Total pot $0.25 | Rake $0.01 
Board [9d 7c Kd 5d]
Seat 1: Wagner GT (button) folded before Flop (didn't bet)
Seat 3: Caigoo (small blind) folded before Flop
Seat 4: alexos04 (big blind) collected ($0.24)
Seat 5: OllieMac86 folded before Flop (didn't bet)
Seat 6: MurphyCooler folded on the Turn



PokerStars Hand #222978943066:  Hold'em No Limit ($0.05/$0.10 USD) - 2021/01/23 19:01:27 ET
Table 'Transvaalia' 6-max Seat #3 is the button
Seat 1: Wagner GT ($10.66 in chips) 
Seat 3: Caigoo ($13.78 in chips) 
Seat 4: alexos04 ($10.14 in chips) 
Seat 5: OllieMac86 ($10.35 in chips) 
Seat 6: MurphyCooler ($7.68 in chips) 
alexos04: posts small blind $0.05
OllieMac86: posts big blind $0.10
No1Sparkles: sits out 
*** HOLE CARDS ***
MurphyCooler: folds 
Wagner GT: folds 
Caigoo: raises $0.15 to $0.25
alexos04: folds 
OllieMac86: raises $0.75 to $1
Caigoo: folds 
Uncalled bet ($0.75) returned to OllieMac86
OllieMac86 collected $0.55 from pot
OllieMac86: doesn't show hand 
*** SUMMARY ***
Total pot $0.55 | Rake $0 
Seat 1: Wagner GT folded before Flop (didn't bet)
Seat 3: Caigoo (button) folded before Flop
Seat 4: alexos04 (small blind) folded before Flop
Seat 5: OllieMac86 (big blind) collected ($0.55)
Seat 6: MurphyCooler folded before Flop (didn't bet)



PokerStars Hand #222978952960:  Hold'em No Limit ($0.05/$0.10 USD) - 2021/01/23 19:01:45 ET
Table 'Transvaalia' 6-max Seat #4 is the button
Seat 1: Wagner GT ($10.66 in chips) 
Seat 3: Caigoo ($13.53 in chips) 
Seat 4: alexos04 ($10.09 in chips) 
Seat 5: OllieMac86 ($10.65 in chips) 
Seat 6: MurphyCooler ($7.68 in chips) 
OllieMac86: posts small blind $0.05
MurphyCooler: posts big blind $0.10
No1Sparkles: sits out 
*** HOLE CARDS ***
Wagner GT: folds 
Caigoo: raises $0.15 to $0.25
alexos04: calls $0.25
OllieMac86: folds 
MurphyCooler: folds 
*** FLOP *** [7c Tc 4c]
Caigoo: bets $0.30
alexos04: calls $0.30
*** TURN *** [7c Tc 4c] [7s]
Caigoo: checks 
alexos04: bets $0.60
Caigoo: calls $0.60
*** RIVER *** [7c Tc 4c 7s] [4s]
Caigoo: checks 
alexos04: checks 
*** SHOW DOWN ***
Caigoo: shows [Kd Th] (two pair, Tens and Sevens)
alexos04: shows [Ts Kc] (two pair, Tens and Sevens)
Caigoo collected $1.17 from pot
alexos04 collected $1.17 from pot
*** SUMMARY ***
Total pot $2.45 | Rake $0.11 
Board [7c Tc 4c 7s 4s]
Seat 1: Wagner GT folded before Flop (didn't bet)
Seat 3: Caigoo showed [Kd Th] and won ($1.17) with two pair, Tens and Sevens
Seat 4: alexos04 (button) showed [Ts Kc] and won ($1.17) with two pair, Tens and Sevens
Seat 5: OllieMac86 (small blind) folded before Flop
Seat 6: MurphyCooler (big blind) folded before Flop



PokerStars Hand #222978991775:  Hold'em No Limit ($0.05/$0.10 USD) - 2021/01/23 19:02:51 ET
Table 'Transvaalia' 6-max Seat #5 is the button
Seat 1: Wagner GT ($10.66 in chips) 
Seat 3: Caigoo ($13.55 in chips) 
Seat 4: alexos04 ($10.11 in chips) 
Seat 5: OllieMac86 ($10.60 in chips) 
Seat 6: MurphyCooler ($7.58 in chips) 
MurphyCooler: posts small blind $0.05
Wagner GT: posts big blind $0.10
No1Sparkles: sits out 
*** HOLE CARDS ***
Caigoo: folds 
alexos04: folds 
OllieMac86: folds 
MurphyCooler: calls $0.05
Wagner GT: checks 
*** FLOP *** [Qs 2c Tc]
MurphyCooler: bets $0.10
Wagner GT: folds 
Uncalled bet ($0.10) returned to MurphyCooler
MurphyCooler collected $0.19 from pot
MurphyCooler: doesn't show hand 
*** SUMMARY ***
Total pot $0.20 | Rake $0.01 
Board [Qs 2c Tc]
Seat 1: Wagner GT (big blind) folded on the Flop
Seat 3: Caigoo folded before Flop (didn't bet)
Seat 4: alexos04 folded before Flop (didn't bet)
Seat 5: OllieMac86 (button) folded before Flop (didn't bet)
Seat 6: MurphyCooler (small blind) collected ($0.19)



PokerStars Hand #222978998731:  Hold'em No Limit ($0.05/$0.10 USD) - 2021/01/23 19:03:03 ET
Table 'Transvaalia' 6-max Seat #6 is the button
Seat 1: Wagner GT ($10.56 in chips) 
Seat 2: No1Sparkles ($10 in chips) 
Seat 3: Caigoo ($13.55 in chips) 
Seat 4: alexos04 ($10.11 in chips) 
Seat 5: OllieMac86 ($10.60 in chips) 
Seat 6: MurphyCooler ($7.67 in chips) 
Wagner GT: posts small blind $0.05
No1Sparkles: posts big blind $0.10
*** HOLE CARDS ***
Caigoo: folds 
alexos04: folds 
OllieMac86: raises $0.20 to $0.30
MurphyCooler: calls $0.30
Wagner GT: folds 
No1Sparkles: folds 
*** FLOP *** [9h Ks 8c]
OllieMac86: checks 
MurphyCooler: checks 
*** TURN *** [9h Ks 8c] [5s]
OllieMac86: bets $0.41
MurphyCooler: calls $0.41
*** RIVER *** [9h Ks 8c 5s] [Td]
OllieMac86: checks 
MurphyCooler: checks 
*** SHOW DOWN ***
OllieMac86: shows [6d Ad] (high card Ace)
MurphyCooler: mucks hand 
OllieMac86 collected $1.50 from pot
*** SUMMARY ***
Total pot $1.57 | Rake $0.07 
Board [9h Ks 8c 5s Td]
Seat 1: Wagner GT (small blind) folded before Flop
Seat 2: No1Sparkles (big blind) folded before Flop
Seat 3: Caigoo folded before Flop (didn't bet)
Seat 4: alexos04 folded before Flop (didn't bet)
Seat 5: OllieMac86 showed [6d Ad] and won ($1.50) with high card Ace
Seat 6: MurphyCooler (button) mucked



PokerStars Hand #222979013781:  Hold'em No Limit ($0.05/$0.10 USD) - 2021/01/23 19:03:29 ET
Table 'Transvaalia' 6-max Seat #1 is the button
Seat 1: Wagner GT ($10.51 in chips) 
Seat 2: No1Sparkles ($10 in chips) 
Seat 3: Caigoo ($13.55 in chips) 
Seat 4: alexos04 ($10.11 in chips) 
Seat 5: OllieMac86 ($11.39 in chips) 
Seat 6: MurphyCooler ($6.96 in chips) 
No1Sparkles: posts small blind $0.05
Caigoo: posts big blind $0.10
*** HOLE CARDS ***
alexos04: raises $0.20 to $0.30
OllieMac86: folds 
MurphyCooler: folds 
Wagner GT: folds 
No1Sparkles: calls $0.25
Caigoo: folds 
*** FLOP *** [2d 8d 3s]
No1Sparkles: checks 
alexos04: checks 
*** TURN *** [2d 8d 3s] [Js]
No1Sparkles: bets $0.44
alexos04: calls $0.44
*** RIVER *** [2d 8d 3s Js] [Qs]
No1Sparkles: checks 
alexos04: checks 
*** SHOW DOWN ***
No1Sparkles: shows [9h 8h] (a pair of Eights)
alexos04: mucks hand 
No1Sparkles collected $1.51 from pot
*** SUMMARY ***
Total pot $1.58 | Rake $0.07 
Board [2d 8d 3s Js Qs]
Seat 1: Wagner GT (button) folded before Flop (didn't bet)
Seat 2: No1Sparkles (small blind) showed [9h 8h] and won ($1.51) with a pair of Eights
Seat 3: Caigoo (big blind) folded before Flop
Seat 4: alexos04 mucked
Seat 5: OllieMac86 folded before Flop (didn't bet)
Seat 6: MurphyCooler folded before Flop (didn't bet)



PokerStars Hand #222979042131:  Hold'em No Limit ($0.05/$0.10 USD) - 2021/01/23 19:04:18 ET
Table 'Transvaalia' 6-max Seat #2 is the button
Seat 1: Wagner GT ($10.51 in chips) 
Seat 2: No1Sparkles ($10.77 in chips) 
Seat 3: Caigoo ($13.45 in chips) 
Seat 4: alexos04 ($10 in chips) 
Seat 5: OllieMac86 ($11.39 in chips) 
Seat 6: MurphyCooler ($6.96 in chips) 
Caigoo: posts small blind $0.05
alexos04: posts big blind $0.10
*** HOLE CARDS ***
OllieMac86: folds 
MurphyCooler: folds 
Wagner GT: folds 
No1Sparkles: folds 
Caigoo: folds 
Uncalled bet ($0.05) returned to alexos04
alexos04 collected $0.10 from pot
alexos04: doesn't show hand 
*** SUMMARY ***
Total pot $0.10 | Rake $0 
Seat 1: Wagner GT folded before Flop (didn't bet)
Seat 2: No1Sparkles (button) folded before Flop (didn't bet)
Seat 3: Caigoo (small blind) folded before Flop
Seat 4: alexos04 (big blind) collected ($0.10)
Seat 5: OllieMac86 folded before Flop (didn't bet)
Seat 6: MurphyCooler folded before Flop (didn't bet)



PokerStars Hand #222979047633:  Hold'em No Limit ($0.05/$0.10 USD) - 2021/01/23 19:04:28 ET
Table 'Transvaalia' 6-max Seat #3 is the button
Seat 1: Wagner GT ($10.51 in chips) 
Seat 2: No1Sparkles ($10.77 in chips) 
Seat 3: Caigoo ($13.40 in chips) 
Seat 4: alexos04 ($10.05 in chips) 
Seat 5: OllieMac86 ($11.39 in chips) 
Seat 6: MurphyCooler ($6.96 in chips) 
alexos04: posts small blind $0.05
OllieMac86: posts big blind $0.10
*** HOLE CARDS ***
MurphyCooler: folds 
Wagner GT: raises $0.15 to $0.25
No1Sparkles: folds 
Caigoo: folds 
alexos04: folds 
OllieMac86: folds 
Uncalled bet ($0.15) returned to Wagner GT
Wagner GT collected $0.25 from pot
Wagner GT: doesn't show hand 
*** SUMMARY ***
Total pot $0.25 | Rake $0 
Seat 1: Wagner GT collected ($0.25)
Seat 2: No1Sparkles folded before Flop (didn't bet)
Seat 3: Caigoo (button) folded before Flop (didn't bet)
Seat 4: alexos04 (small blind) folded before Flop
Seat 5: OllieMac86 (big blind) folded before Flop
Seat 6: MurphyCooler folded before Flop (didn't bet)



PokerStars Hand #222979062044:  Hold'em No Limit ($0.05/$0.10 USD) - 2021/01/23 19:04:53 ET
Table 'Transvaalia' 6-max Seat #4 is the button
Seat 1: Wagner GT ($10.66 in chips) 
Seat 2: No1Sparkles ($10.77 in chips) 
Seat 3: Caigoo ($13.40 in chips) 
Seat 4: alexos04 ($10 in chips) 
Seat 5: OllieMac86 ($11.29 in chips) 
Seat 6: MurphyCooler ($6.96 in chips) 
OllieMac86: posts small blind $0.05
MurphyCooler: posts big blind $0.10
*** HOLE CARDS ***
Wagner GT: folds 
No1Sparkles: folds 
Caigoo: folds 
alexos04: folds 
OllieMac86: raises $0.20 to $0.30
MurphyCooler: calls $0.20
*** FLOP *** [2c Kh 8h]
OllieMac86: checks 
MurphyCooler: checks 
*** TURN *** [2c Kh 8h] [6d]
OllieMac86: bets $0.39
MurphyCooler: calls $0.39
*** RIVER *** [2c Kh 8h 6d] [Qh]
OllieMac86: checks 
MurphyCooler: bets $0.50
OllieMac86: folds 
Uncalled bet ($0.50) returned to MurphyCooler
MurphyCooler collected $1.32 from pot
MurphyCooler: doesn't show hand 
*** SUMMARY ***
Total pot $1.38 | Rake $0.06 
Board [2c Kh 8h 6d Qh]
Seat 1: Wagner GT folded before Flop (didn't bet)
Seat 2: No1Sparkles folded before Flop (didn't bet)
Seat 3: Caigoo folded before Flop (didn't bet)
Seat 4: alexos04 (button) folded before Flop (didn't bet)
Seat 5: OllieMac86 (small blind) folded on the River
Seat 6: MurphyCooler (big blind) collected ($1.32)



PokerStars Hand #222979087064:  Hold'em No Limit ($0.05/$0.10 USD) - 2021/01/23 19:05:23 ET
Table 'Transvaalia' 6-max Seat #5 is the button
Seat 1: Wagner GT ($10.66 in chips) 
Seat 2: No1Sparkles ($10.77 in chips) 
Seat 3: Caigoo ($13.40 in chips) 
Seat 4: alexos04 ($10 in chips) 
Seat 5: OllieMac86 ($10.60 in chips) 
Seat 6: MurphyCooler ($7.59 in chips) 
MurphyCooler: posts small blind $0.05
Wagner GT: posts big blind $0.10
*** HOLE CARDS ***
No1Sparkles: folds 
Caigoo: raises $0.20 to $0.30
alexos04: folds 
OllieMac86: folds 
MurphyCooler: folds 
Wagner GT: folds 
Uncalled bet ($0.20) returned to Caigoo
Caigoo collected $0.25 from pot
Caigoo: doesn't show hand 
*** SUMMARY ***
Total pot $0.25 | Rake $0 
Seat 1: Wagner GT (big blind) folded before Flop
Seat 2: No1Sparkles folded before Flop (didn't bet)
Seat 3: Caigoo collected ($0.25)
Seat 4: alexos04 folded before Flop (didn't bet)
Seat 5: OllieMac86 (button) folded before Flop (didn't bet)
Seat 6: MurphyCooler (small blind) folded before Flop



PokerStars Hand #222979093497:  Hold'em No Limit ($0.05/$0.10 USD) - 2021/01/23 19:05:34 ET
Table 'Transvaalia' 6-max Seat #6 is the button
Seat 1: Wagner GT ($10.56 in chips) 
Seat 2: No1Sparkles ($10.77 in chips) 
Seat 3: Caigoo ($13.55 in chips) 
Seat 4: alexos04 ($10 in chips) 
Seat 5: OllieMac86 ($10.60 in chips) 
Seat 6: MurphyCooler ($7.54 in chips) 
Wagner GT: posts small blind $0.05
No1Sparkles: posts big blind $0.10
*** HOLE CARDS ***
Caigoo: folds 
alexos04: folds 
OllieMac86: folds 
MurphyCooler: folds 
Wagner GT: raises $0.20 to $0.30
No1Sparkles: folds 
Uncalled bet ($0.20) returned to Wagner GT
Wagner GT collected $0.20 from pot
Wagner GT: doesn't show hand 
*** SUMMARY ***
Total pot $0.20 | Rake $0 
Seat 1: Wagner GT (small blind) collected ($0.20)
Seat 2: No1Sparkles (big blind) folded before Flop
Seat 3: Caigoo folded before Flop (didn't bet)
Seat 4: alexos04 folded before Flop (didn't bet)
Seat 5: OllieMac86 folded before Flop (didn't bet)
Seat 6: MurphyCooler (button) folded before Flop (didn't bet)



PokerStars Hand #222979104962:  Hold'em No Limit ($0.05/$0.10 USD) - 2021/01/23 19:05:54 ET
Table 'Transvaalia' 6-max Seat #1 is the button
Seat 1: Wagner GT ($10.66 in chips) 
Seat 2: No1Sparkles ($10.67 in chips) 
Seat 3: Caigoo ($13.55 in chips) 
Seat 4: alexos04 ($10 in chips) 
Seat 5: OllieMac86 ($10.60 in chips) 
Seat 6: MurphyCooler ($7.54 in chips) 
No1Sparkles: posts small blind $0.05
Caigoo: posts big blind $0.10
*** HOLE CARDS ***
alexos04: folds 
OllieMac86: folds 
MurphyCooler: raises $0.10 to $0.20
Wagner GT: folds 
No1Sparkles: calls $0.15
Caigoo: calls $0.10
*** FLOP *** [Qd Ad Kd]
No1Sparkles: checks 
Caigoo: checks 
MurphyCooler: bets $0.10
No1Sparkles: raises $0.30 to $0.40
Caigoo: calls $0.40
MurphyCooler: folds 
*** TURN *** [Qd Ad Kd] [Ts]
No1Sparkles: checks 
Caigoo: checks 
*** RIVER *** [Qd Ad Kd Ts] [4h]
No1Sparkles: checks 
Caigoo: bets $0.43
No1Sparkles: calls $0.43
*** SHOW DOWN ***
Caigoo: shows [Kc Qh] (two pair, Kings and Queens)
No1Sparkles: mucks hand 
Caigoo collected $2.25 from pot
*** SUMMARY ***
Total pot $2.36 | Rake $0.11 
Board [Qd Ad Kd Ts 4h]
Seat 1: Wagner GT (button) folded before Flop (didn't bet)
Seat 2: No1Sparkles (small blind) mucked
Seat 3: Caigoo (big blind) showed [Kc Qh] and won ($2.25) with two pair, Kings and Queens
Seat 4: alexos04 folded before Flop (didn't bet)
Seat 5: OllieMac86 folded before Flop (didn't bet)
Seat 6: MurphyCooler folded on the Flop



PokerStars Hand #222979163250:  Hold'em No Limit ($0.05/$0.10 USD) - 2021/01/23 19:07:18 ET
Table 'Transvaalia' 6-max Seat #2 is the button
Seat 1: Wagner GT ($10.66 in chips) 
Seat 2: No1Sparkles ($10 in chips) 
Seat 3: Caigoo ($14.77 in chips) 
Seat 4: alexos04 ($10 in chips) 
Seat 5: OllieMac86 ($10.60 in chips) 
Seat 6: MurphyCooler ($7.24 in chips) 
Caigoo: posts small blind $0.05
alexos04: posts big blind $0.10
*** HOLE CARDS ***
OllieMac86: folds 
MurphyCooler: raises $0.10 to $0.20
Wagner GT: folds 
No1Sparkles: folds 
Caigoo: folds 
alexos04: calls $0.10
*** FLOP *** [4d Qc Qd]
alexos04: checks 
MurphyCooler: bets $0.20
alexos04: calls $0.20
*** TURN *** [4d Qc Qd] [7s]
alexos04: checks 
MurphyCooler: bets $0.20
No1Sparkles was removed from the table for failing to post
No1Sparkles leaves the table
alexos04: folds 
Uncalled bet ($0.20) returned to MurphyCooler
MurphyCooler collected $0.81 from pot
MurphyCooler: doesn't show hand 
*** SUMMARY ***
Total pot $0.85 | Rake $0.04 
Board [4d Qc Qd 7s]
Seat 1: Wagner GT folded before Flop (didn't bet)
Seat 2: No1Sparkles (button) folded before Flop (didn't bet)
Seat 3: Caigoo (small blind) folded before Flop
Seat 4: alexos04 (big blind) folded on the Turn
Seat 5: OllieMac86 folded before Flop (didn't bet)
Seat 6: MurphyCooler collected ($0.81)



PokerStars Hand #222979197652:  Hold'em No Limit ($0.05/$0.10 USD) - 2021/01/23 19:08:19 ET
Table 'Transvaalia' 6-max Seat #3 is the button
Seat 1: Wagner GT ($10.66 in chips) 
Seat 3: Caigoo ($14.72 in chips) 
Seat 4: alexos04 ($10 in chips) 
Seat 5: OllieMac86 ($10.60 in chips) 
Seat 6: MurphyCooler ($7.65 in chips) 
alexos04: posts small blind $0.05
OllieMac86: posts big blind $0.10
*** HOLE CARDS ***
MurphyCooler: raises $0.10 to $0.20
Wagner GT: calls $0.20
Caigoo: folds 
alexos04: folds 
OllieMac86: folds 
*** FLOP *** [9s As 8h]
MurphyCooler: checks 
Wagner GT: bets $0.17
MurphyCooler: calls $0.17
*** TURN *** [9s As 8h] [2c]
MurphyCooler: checks 
Wagner GT: bets $0.64
MurphyCooler: calls $0.64
*** RIVER *** [9s As 8h 2c] [Jh]
MurphyCooler: bets $6.64 and is all-in
Wagner GT: folds 
Uncalled bet ($6.64) returned to MurphyCooler
MurphyCooler collected $2.07 from pot
MurphyCooler: doesn't show hand 
*** SUMMARY ***
Total pot $2.17 | Rake $0.10 
Board [9s As 8h 2c Jh]
Seat 1: Wagner GT folded on the River
Seat 3: Caigoo (button) folded before Flop (didn't bet)
Seat 4: alexos04 (small blind) folded before Flop
Seat 5: OllieMac86 (big blind) folded before Flop
Seat 6: MurphyCooler collected ($2.07)



PokerStars Hand #222979228255:  Hold'em No Limit ($0.05/$0.10 USD) - 2021/01/23 19:09:14 ET
Table 'Transvaalia' 6-max Seat #4 is the button
Seat 1: Wagner GT ($10 in chips) 
Seat 3: Caigoo ($14.72 in chips) 
Seat 4: alexos04 ($10 in chips) 
Seat 5: OllieMac86 ($10.50 in chips) 
Seat 6: MurphyCooler ($8.71 in chips) 
OllieMac86: posts small blind $0.05
MurphyCooler: posts big blind $0.10
*** HOLE CARDS ***
Wagner GT: folds 
Caigoo: folds 
alexos04: folds 
OllieMac86: raises $0.20 to $0.30
MurphyCooler: folds 
Uncalled bet ($0.20) returned to OllieMac86
OllieMac86 collected $0.20 from pot
OllieMac86: doesn't show hand 
*** SUMMARY ***
Total pot $0.20 | Rake $0 
Seat 1: Wagner GT folded before Flop (didn't bet)
Seat 3: Caigoo folded before Flop (didn't bet)
Seat 4: alexos04 (button) folded before Flop (didn't bet)
Seat 5: OllieMac86 (small blind) collected ($0.20)
Seat 6: MurphyCooler (big blind) folded before Flop



PokerStars Hand #222979233226:  Hold'em No Limit ($0.05/$0.10 USD) - 2021/01/23 19:09:23 ET
Table 'Transvaalia' 6-max Seat #5 is the button
Seat 1: Wagner GT ($10 in chips) 
Seat 3: Caigoo ($14.72 in chips) 
Seat 4: alexos04 ($10 in chips) 
Seat 5: OllieMac86 ($10.60 in chips) 
Seat 6: MurphyCooler ($8.61 in chips) 
MurphyCooler: posts small blind $0.05
Wagner GT: posts big blind $0.10
*** HOLE CARDS ***
Caigoo: folds 
alexos04: folds 
OllieMac86: raises $0.20 to $0.30
MurphyCooler: folds 
Wagner GT has timed out
Wagner GT: folds 
Uncalled bet ($0.20) returned to OllieMac86
OllieMac86 collected $0.25 from pot
OllieMac86: doesn't show hand 
*** SUMMARY ***
Total pot $0.25 | Rake $0 
Seat 1: Wagner GT (big blind) folded before Flop
Seat 3: Caigoo folded before Flop (didn't bet)
Seat 4: alexos04 folded before Flop (didn't bet)
Seat 5: OllieMac86 (button) collected ($0.25)
Seat 6: MurphyCooler (small blind) folded before Flop



PokerStars Hand #222979261356:  Hold'em No Limit ($0.05/$0.10 USD) - 2021/01/23 19:10:13 ET
Table 'Transvaalia' 6-max Seat #6 is the button
Seat 1: Wagner GT ($10 in chips) 
Seat 3: Caigoo ($14.72 in chips) 
Seat 4: alexos04 ($10 in chips) 
Seat 5: OllieMac86 ($10.75 in chips) 
Seat 6: MurphyCooler ($8.56 in chips) 
Wagner GT: posts small blind $0.05
Caigoo: posts big blind $0.10
*** HOLE CARDS ***
alexos04: folds 
OllieMac86: folds 
MurphyCooler: calls $0.10
Wagner GT: folds 
Caigoo: checks 
*** FLOP *** [4s Jd 7d]
everbodylovebdy joins the table at seat #2 
Caigoo: bets $0.12
MurphyCooler: calls $0.12
*** TURN *** [4s Jd 7d] [Ad]
Caigoo: checks 
MurphyCooler: bets $0.47
Caigoo: folds 
Uncalled bet ($0.47) returned to MurphyCooler
MurphyCooler collected $0.47 from pot
MurphyCooler: doesn't show hand 
*** SUMMARY ***
Total pot $0.49 | Rake $0.02 
Board [4s Jd 7d Ad]
Seat 1: Wagner GT (small blind) folded before Flop
Seat 3: Caigoo (big blind) folded on the Turn
Seat 4: alexos04 folded before Flop (didn't bet)
Seat 5: OllieMac86 folded before Flop (didn't bet)
Seat 6: MurphyCooler (button) collected ($0.47)



PokerStars Hand #222979286639:  Hold'em No Limit ($0.05/$0.10 USD) - 2021/01/23 19:10:57 ET
Table 'Transvaalia' 6-max Seat #1 is the button
Seat 1: Wagner GT ($10 in chips) 
Seat 3: Caigoo ($14.50 in chips) 
Seat 4: alexos04 ($10 in chips) 
Seat 5: OllieMac86 ($10.75 in chips) 
Seat 6: MurphyCooler ($8.81 in chips) 
Caigoo: posts small blind $0.05
alexos04: posts big blind $0.10
*** HOLE CARDS ***
OllieMac86: folds 
MurphyCooler: calls $0.10
Wagner GT: calls $0.10
Caigoo: folds 
alexos04: checks 
*** FLOP *** [Jd Td Js]
alexos04: checks 
MurphyCooler: checks 
Wagner GT: bets $0.10
alexos04: calls $0.10
MurphyCooler: calls $0.10
*** TURN *** [Jd Td Js] [9h]
alexos04: checks 
MurphyCooler: checks 
Wagner GT: checks 
*** RIVER *** [Jd Td Js 9h] [2h]
alexos04: checks 
MurphyCooler: checks 
Wagner GT: checks 
*** SHOW DOWN ***
alexos04: shows [9d 8s] (two pair, Jacks and Nines)
MurphyCooler: mucks hand 
Wagner GT: mucks hand 
alexos04 collected $0.62 from pot
*** SUMMARY ***
Total pot $0.65 | Rake $0.03 
Board [Jd Td Js 9h 2h]
Seat 1: Wagner GT (button) mucked
Seat 3: Caigoo (small blind) folded before Flop
Seat 4: alexos04 (big blind) showed [9d 8s] and won ($0.62) with two pair, Jacks and Nines
Seat 5: OllieMac86 folded before Flop (didn't bet)
Seat 6: MurphyCooler mucked



PokerStars Hand #222979335493:  Hold'em No Limit ($0.05/$0.10 USD) - 2021/01/23 19:12:24 ET
Table 'Transvaalia' 6-max Seat #3 is the button
Seat 1: Wagner GT ($10 in chips) 
Seat 3: Caigoo ($14.45 in chips) 
Seat 4: alexos04 ($10.42 in chips) 
Seat 5: OllieMac86 ($10.75 in chips) 
Seat 6: MurphyCooler ($8.61 in chips) 
alexos04: posts small blind $0.05
OllieMac86: posts big blind $0.10
everbodylovebdy: sits out 
*** HOLE CARDS ***
MurphyCooler: raises $0.10 to $0.20
Wagner GT: folds 
Caigoo: folds 
alexos04: folds 
OllieMac86: folds 
Uncalled bet ($0.10) returned to MurphyCooler
MurphyCooler collected $0.25 from pot
MurphyCooler: doesn't show hand 
*** SUMMARY ***
Total pot $0.25 | Rake $0 
Seat 1: Wagner GT folded before Flop (didn't bet)
Seat 3: Caigoo (button) folded before Flop (didn't bet)
Seat 4: alexos04 (small blind) folded before Flop
Seat 5: OllieMac86 (big blind) folded before Flop
Seat 6: MurphyCooler collected ($0.25)



PokerStars Hand #222979340772:  Hold'em No Limit ($0.05/$0.10 USD) - 2021/01/23 19:12:34 ET
Table 'Transvaalia' 6-max Seat #4 is the button
Seat 1: Wagner GT ($10 in chips) 
Seat 3: Caigoo ($14.45 in chips) 
Seat 4: alexos04 ($10.37 in chips) 
Seat 5: OllieMac86 ($10.65 in chips) 
Seat 6: MurphyCooler ($8.76 in chips) 
OllieMac86: posts small blind $0.05
MurphyCooler: posts big blind $0.10
everbodylovebdy: sits out 
*** HOLE CARDS ***
Wagner GT: folds 
Caigoo: folds 
alexos04: raises $0.20 to $0.30
OllieMac86: folds 
MurphyCooler: calls $0.20
*** FLOP *** [5c 6d 8h]
MurphyCooler: bets $0.10
alexos04: calls $0.10
*** TURN *** [5c 6d 8h] [8s]
MurphyCooler: bets $0.81
alexos04: folds 
Uncalled bet ($0.81) returned to MurphyCooler
MurphyCooler collected $0.81 from pot
MurphyCooler: doesn't show hand 
*** SUMMARY ***
Total pot $0.85 | Rake $0.04 
Board [5c 6d 8h 8s]
Seat 1: Wagner GT folded before Flop (didn't bet)
Seat 3: Caigoo folded before Flop (didn't bet)
Seat 4: alexos04 (button) folded on the Turn
Seat 5: OllieMac86 (small blind) folded before Flop
Seat 6: MurphyCooler (big blind) collected ($0.81)



PokerStars Hand #222979358963:  Hold'em No Limit ($0.05/$0.10 USD) - 2021/01/23 19:13:07 ET
Table 'Transvaalia' 6-max Seat #5 is the button
Seat 1: Wagner GT ($10 in chips) 
Seat 3: Caigoo ($14.45 in chips) 
Seat 4: alexos04 ($10 in chips) 
Seat 5: OllieMac86 ($10.60 in chips) 
Seat 6: MurphyCooler ($9.17 in chips) 
MurphyCooler: posts small blind $0.05
Wagner GT: posts big blind $0.10
everbodylovebdy: sits out 
*** HOLE CARDS ***
Caigoo: folds 
alexos04: folds 
OllieMac86: folds 
MurphyCooler: calls $0.05
Wagner GT: checks 
*** FLOP *** [Ah Ks 2s]
MurphyCooler: checks 
Wagner GT: checks 
*** TURN *** [Ah Ks 2s] [7c]
MurphyCooler: checks 
Wagner GT: checks 
*** RIVER *** [Ah Ks 2s 7c] [Kc]
MurphyCooler: checks 
Wagner GT: checks 
*** SHOW DOWN ***
MurphyCooler: shows [7s 4s] (two pair, Kings and Sevens)
Wagner GT: mucks hand 
MurphyCooler collected $0.19 from pot
*** SUMMARY ***
Total pot $0.20 | Rake $0.01 
Board [Ah Ks 2s 7c Kc]
Seat 1: Wagner GT (big blind) mucked
Seat 3: Caigoo folded before Flop (didn't bet)
Seat 4: alexos04 folded before Flop (didn't bet)
Seat 5: OllieMac86 (button) folded before Flop (didn't bet)
Seat 6: MurphyCooler (small blind) showed [7s 4s] and won ($0.19) with two pair, Kings and Sevens



PokerStars Hand #222979387858:  Hold'em No Limit ($0.05/$0.10 USD) - 2021/01/23 19:13:59 ET
Table 'Transvaalia' 6-max Seat #6 is the button
Seat 1: Wagner GT ($10 in chips) 
Seat 2: everbodylovebdy ($8 in chips) 
Seat 3: Caigoo ($14.45 in chips) 
Seat 4: alexos04 ($10 in chips) 
Seat 5: OllieMac86 ($10.60 in chips) 
Seat 6: MurphyCooler ($9.26 in chips) 
Wagner GT: posts small blind $0.05
everbodylovebdy: posts big blind $0.10
*** HOLE CARDS ***
Caigoo: folds 
alexos04: folds 
OllieMac86: folds 
MurphyCooler: calls $0.10
Wagner GT: raises $0.50 to $0.60
everbodylovebdy: folds 
MurphyCooler: folds 
Uncalled bet ($0.50) returned to Wagner GT
Wagner GT collected $0.30 from pot
Wagner GT: doesn't show hand 
*** SUMMARY ***
Total pot $0.30 | Rake $0 
Seat 1: Wagner GT (small blind) collected ($0.30)
Seat 2: everbodylovebdy (big blind) folded before Flop
Seat 3: Caigoo folded before Flop (didn't bet)
Seat 4: alexos04 folded before Flop (didn't bet)
Seat 5: OllieMac86 folded before Flop (didn't bet)
Seat 6: MurphyCooler (button) folded before Flop



PokerStars Hand #222979397566:  Hold'em No Limit ($0.05/$0.10 USD) - 2021/01/23 19:14:17 ET
Table 'Transvaalia' 6-max Seat #1 is the button
Seat 1: Wagner GT ($10.20 in chips) 
Seat 2: everbodylovebdy ($7.90 in chips) 
Seat 3: Caigoo ($14.45 in chips) 
Seat 4: alexos04 ($10 in chips) 
Seat 5: OllieMac86 ($10.60 in chips) 
Seat 6: MurphyCooler ($9.16 in chips) 
everbodylovebdy: posts small blind $0.05
Caigoo: posts big blind $0.10
*** HOLE CARDS ***
alexos04: folds 
OllieMac86: folds 
MurphyCooler: folds 
Wagner GT: folds 
everbodylovebdy: folds 
Uncalled bet ($0.05) returned to Caigoo
Caigoo collected $0.10 from pot
Caigoo: doesn't show hand 
*** SUMMARY ***
Total pot $0.10 | Rake $0 
Seat 1: Wagner GT (button) folded before Flop (didn't bet)
Seat 2: everbodylovebdy (small blind) folded before Flop
Seat 3: Caigoo (big blind) collected ($0.10)
Seat 4: alexos04 folded before Flop (didn't bet)
Seat 5: OllieMac86 folded before Flop (didn't bet)
Seat 6: MurphyCooler folded before Flop (didn't bet)



PokerStars Hand #222979403026:  Hold'em No Limit ($0.05/$0.10 USD) - 2021/01/23 19:14:27 ET
Table 'Transvaalia' 6-max Seat #2 is the button
Seat 1: Wagner GT ($10.20 in chips) 
Seat 2: everbodylovebdy ($7.85 in chips) 
Seat 3: Caigoo ($14.50 in chips) 
Seat 4: alexos04 ($10 in chips) 
Seat 5: OllieMac86 ($10.60 in chips) 
Seat 6: MurphyCooler ($9.16 in chips) 
Caigoo: posts small blind $0.05
alexos04: posts big blind $0.10
*** HOLE CARDS ***
OllieMac86: raises $0.20 to $0.30
MurphyCooler: calls $0.30
Wagner GT: folds 
everbodylovebdy: folds 
Caigoo: folds 
alexos04: calls $0.20
*** FLOP *** [Js 5d 7c]
alexos04: checks 
OllieMac86: checks 
MurphyCooler: checks 
*** TURN *** [Js 5d 7c] [7d]
alexos04: bets $0.30
OllieMac86: folds 
MurphyCooler: folds 
Uncalled bet ($0.30) returned to alexos04
alexos04 collected $0.91 from pot
alexos04: doesn't show hand 
*** SUMMARY ***
Total pot $0.95 | Rake $0.04 
Board [Js 5d 7c 7d]
Seat 1: Wagner GT folded before Flop (didn't bet)
Seat 2: everbodylovebdy (button) folded before Flop (didn't bet)
Seat 3: Caigoo (small blind) folded before Flop
Seat 4: alexos04 (big blind) collected ($0.91)
Seat 5: OllieMac86 folded on the Turn
Seat 6: MurphyCooler folded on the Turn



PokerStars Hand #222979427656:  Hold'em No Limit ($0.05/$0.10 USD) - 2021/01/23 19:15:11 ET
Table 'Transvaalia' 6-max Seat #3 is the button
Seat 1: Wagner GT ($10.20 in chips) 
Seat 2: everbodylovebdy ($7.85 in chips) 
Seat 3: Caigoo ($14.45 in chips) 
Seat 4: alexos04 ($10.61 in chips) 
Seat 5: OllieMac86 ($10.30 in chips) 
Seat 6: MurphyCooler ($8.86 in chips) 
alexos04: posts small blind $0.05
OllieMac86: posts big blind $0.10
*** HOLE CARDS ***
MurphyCooler: folds 
Wagner GT: folds 
everbodylovebdy: calls $0.10
Caigoo: folds 
alexos04: raises $0.40 to $0.50
OllieMac86: folds 
everbodylovebdy: calls $0.40
*** FLOP *** [Kd 5c 7d]
alexos04: bets $0.60
everbodylovebdy: folds 
Uncalled bet ($0.60) returned to alexos04
alexos04 collected $1.05 from pot
alexos04: doesn't show hand 
*** SUMMARY ***
Total pot $1.10 | Rake $0.05 
Board [Kd 5c 7d]
Seat 1: Wagner GT folded before Flop (didn't bet)
Seat 2: everbodylovebdy folded on the Flop
Seat 3: Caigoo (button) folded before Flop (didn't bet)
Seat 4: alexos04 (small blind) collected ($1.05)
Seat 5: OllieMac86 (big blind) folded before Flop
Seat 6: MurphyCooler folded before Flop (didn't bet)



PokerStars Hand #222979452416:  Hold'em No Limit ($0.05/$0.10 USD) - 2021/01/23 19:15:56 ET
Table 'Transvaalia' 6-max Seat #4 is the button
Seat 1: Wagner GT ($10.20 in chips) 
Seat 2: everbodylovebdy ($7.35 in chips) 
Seat 3: Caigoo ($14.45 in chips) 
Seat 4: alexos04 ($11.16 in chips) 
Seat 5: OllieMac86 ($10.20 in chips) 
Seat 6: MurphyCooler ($8.86 in chips) 
OllieMac86: posts small blind $0.05
MurphyCooler: posts big blind $0.10
*** HOLE CARDS ***
Wagner GT: folds 
everbodylovebdy has timed out
everbodylovebdy: folds 
Caigoo: folds 
alexos04: folds 
OllieMac86: folds 
Uncalled bet ($0.05) returned to MurphyCooler
MurphyCooler collected $0.10 from pot
MurphyCooler: doesn't show hand 
*** SUMMARY ***
Total pot $0.10 | Rake $0 
Seat 1: Wagner GT folded before Flop (didn't bet)
Seat 2: everbodylovebdy folded before Flop (didn't bet)
Seat 3: Caigoo folded before Flop (didn't bet)
Seat 4: alexos04 (button) folded before Flop (didn't bet)
Seat 5: OllieMac86 (small blind) folded before Flop
Seat 6: MurphyCooler (big blind) collected ($0.10)



PokerStars Hand #222979460674:  Hold'em No Limit ($0.05/$0.10 USD) - 2021/01/23 19:16:11 ET
Table 'Transvaalia' 6-max Seat #5 is the button
Seat 1: Wagner GT ($10.20 in chips) 
Seat 2: everbodylovebdy ($7.35 in chips) 
Seat 3: Caigoo ($14.45 in chips) 
Seat 4: alexos04 ($11.16 in chips) 
Seat 5: OllieMac86 ($10.15 in chips) 
Seat 6: MurphyCooler ($8.91 in chips) 
MurphyCooler: posts small blind $0.05
Wagner GT: posts big blind $0.10
*** HOLE CARDS ***
everbodylovebdy has timed out
everbodylovebdy: folds 
Caigoo: folds 
alexos04: folds 
OllieMac86: folds 
MurphyCooler: calls $0.05
Wagner GT: raises $0.40 to $0.50
MurphyCooler: folds 
Uncalled bet ($0.40) returned to Wagner GT
Wagner GT collected $0.20 from pot
Wagner GT: doesn't show hand 
*** SUMMARY ***
Total pot $0.20 | Rake $0 
Seat 1: Wagner GT (big blind) collected ($0.20)
Seat 2: everbodylovebdy folded before Flop (didn't bet)
Seat 3: Caigoo folded before Flop (didn't bet)
Seat 4: alexos04 folded before Flop (didn't bet)
Seat 5: OllieMac86 (button) folded before Flop (didn't bet)
Seat 6: MurphyCooler (small blind) folded before Flop



PokerStars Hand #222979472500:  Hold'em No Limit ($0.05/$0.10 USD) - 2021/01/23 19:16:33 ET
Table 'Transvaalia' 6-max Seat #6 is the button
Seat 1: Wagner GT ($10.30 in chips) 
Seat 2: everbodylovebdy ($7.35 in chips) 
Seat 3: Caigoo ($14.45 in chips) 
Seat 4: alexos04 ($11.16 in chips) 
Seat 5: OllieMac86 ($10.15 in chips) 
Seat 6: MurphyCooler ($8.81 in chips) 
Wagner GT: posts small blind $0.05
everbodylovebdy: posts big blind $0.10
*** HOLE CARDS ***
Caigoo: raises $0.20 to $0.30
alexos04: folds 
OllieMac86: folds 
MurphyCooler: folds 
Wagner GT: folds 
everbodylovebdy: folds 
Uncalled bet ($0.20) returned to Caigoo
Caigoo collected $0.25 from pot
Caigoo: doesn't show hand 
*** SUMMARY ***
Total pot $0.25 | Rake $0 
Seat 1: Wagner GT (small blind) folded before Flop
Seat 2: everbodylovebdy (big blind) folded before Flop
Seat 3: Caigoo collected ($0.25)
Seat 4: alexos04 folded before Flop (didn't bet)
Seat 5: OllieMac86 folded before Flop (didn't bet)
Seat 6: MurphyCooler (button) folded before Flop (didn't bet)



PokerStars Hand #222979486606:  Hold'em No Limit ($0.05/$0.10 USD) - 2021/01/23 19:16:59 ET
Table 'Transvaalia' 6-max Seat #1 is the button
Seat 1: Wagner GT ($10.25 in chips) 
Seat 2: everbodylovebdy ($7.25 in chips) 
Seat 3: Caigoo ($14.60 in chips) 
Seat 4: alexos04 ($11.16 in chips) 
Seat 5: OllieMac86 ($10.15 in chips) 
Seat 6: MurphyCooler ($8.81 in chips) 
everbodylovebdy: posts small blind $0.05
Caigoo: posts big blind $0.10
*** HOLE CARDS ***
alexos04: folds 
OllieMac86: folds 
MurphyCooler: calls $0.10
Wagner GT: folds 
everbodylovebdy: folds 
Caigoo: checks 
*** FLOP *** [9h 3s Qh]
Caigoo: bets $0.12
MurphyCooler: folds 
Uncalled bet ($0.12) returned to Caigoo
Caigoo collected $0.24 from pot
Caigoo: doesn't show hand 
*** SUMMARY ***
Total pot $0.25 | Rake $0.01 
Board [9h 3s Qh]
Seat 1: Wagner GT (button) folded before Flop (didn't bet)
Seat 2: everbodylovebdy (small blind) folded before Flop
Seat 3: Caigoo (big blind) collected ($0.24)
Seat 4: alexos04 folded before Flop (didn't bet)
Seat 5: OllieMac86 folded before Flop (didn't bet)
Seat 6: MurphyCooler folded on the Flop



PokerStars Hand #222979501855:  Hold'em No Limit ($0.05/$0.10 USD) - 2021/01/23 19:17:27 ET
Table 'Transvaalia' 6-max Seat #2 is the button
Seat 1: Wagner GT ($10.25 in chips) 
Seat 2: everbodylovebdy ($7.20 in chips) 
Seat 3: Caigoo ($14.74 in chips) 
Seat 4: alexos04 ($11.16 in chips) 
Seat 5: OllieMac86 ($10.15 in chips) 
Seat 6: MurphyCooler ($8.71 in chips) 
Caigoo: posts small blind $0.05
alexos04: posts big blind $0.10
*** HOLE CARDS ***
OllieMac86: folds 
MurphyCooler: calls $0.10
Wagner GT: folds 
everbodylovebdy: folds 
Caigoo: raises $0.30 to $0.40
alexos04: folds 
MurphyCooler: folds 
Uncalled bet ($0.30) returned to Caigoo
Caigoo collected $0.30 from pot
Caigoo: doesn't show hand 
*** SUMMARY ***
Total pot $0.30 | Rake $0 
Seat 1: Wagner GT folded before Flop (didn't bet)
Seat 2: everbodylovebdy (button) folded before Flop (didn't bet)
Seat 3: Caigoo (small blind) collected ($0.30)
Seat 4: alexos04 (big blind) folded before Flop
Seat 5: OllieMac86 folded before Flop (didn't bet)
Seat 6: MurphyCooler folded before Flop



PokerStars Hand #222979517104:  Hold'em No Limit ($0.05/$0.10 USD) - 2021/01/23 19:17:55 ET
Table 'Transvaalia' 6-max Seat #3 is the button
Seat 1: Wagner GT ($10.25 in chips) 
Seat 2: everbodylovebdy ($7.20 in chips) 
Seat 3: Caigoo ($14.94 in chips) 
Seat 4: alexos04 ($11.06 in chips) 
Seat 5: OllieMac86 ($10.15 in chips) 
Seat 6: MurphyCooler ($8.61 in chips) 
alexos04: posts small blind $0.05
OllieMac86: posts big blind $0.10
*** HOLE CARDS ***
MurphyCooler: folds 
Wagner GT: folds 
everbodylovebdy: raises $0.10 to $0.20
Caigoo: folds 
alexos04: folds 
OllieMac86: calls $0.10
*** FLOP *** [Tc 2s 7d]
OllieMac86: checks 
everbodylovebdy: bets $0.20
OllieMac86: calls $0.20
*** TURN *** [Tc 2s 7d] [6c]
OllieMac86: checks 
everbodylovebdy: bets $0.50
OllieMac86: calls $0.50
*** RIVER *** [Tc 2s 7d 6c] [9c]
OllieMac86: checks 
everbodylovebdy: bets $1.97
OllieMac86: calls $1.97
*** SHOW DOWN ***
everbodylovebdy: shows [As Jc] (high card Ace)
OllieMac86: shows [8d Td] (a straight, Six to Ten)
OllieMac86 collected $5.53 from pot
*** SUMMARY ***
Total pot $5.79 | Rake $0.26 
Board [Tc 2s 7d 6c 9c]
Seat 1: Wagner GT folded before Flop (didn't bet)
Seat 2: everbodylovebdy showed [As Jc] and lost with high card Ace
Seat 3: Caigoo (button) folded before Flop (didn't bet)
Seat 4: alexos04 (small blind) folded before Flop
Seat 5: OllieMac86 (big blind) showed [8d Td] and won ($5.53) with a straight, Six to Ten
Seat 6: MurphyCooler folded before Flop (didn't bet)



PokerStars Hand #222979549968:  Hold'em No Limit ($0.05/$0.10 USD) - 2021/01/23 19:18:55 ET
Table 'Transvaalia' 6-max Seat #4 is the button
Seat 1: Wagner GT ($10.25 in chips) 
Seat 2: everbodylovebdy ($4.33 in chips) 
Seat 3: Caigoo ($14.94 in chips) 
Seat 4: alexos04 ($11.01 in chips) 
Seat 5: OllieMac86 ($12.81 in chips) 
Seat 6: MurphyCooler ($8.61 in chips) 
OllieMac86: posts small blind $0.05
MurphyCooler: posts big blind $0.10
*** HOLE CARDS ***
Wagner GT: folds 
everbodylovebdy has timed out
everbodylovebdy: folds 
Caigoo: folds 
alexos04: folds 
OllieMac86: folds 
Uncalled bet ($0.05) returned to MurphyCooler
MurphyCooler collected $0.10 from pot
MurphyCooler: doesn't show hand 
*** SUMMARY ***
Total pot $0.10 | Rake $0 
Seat 1: Wagner GT folded before Flop (didn't bet)
Seat 2: everbodylovebdy folded before Flop (didn't bet)
Seat 3: Caigoo folded before Flop (didn't bet)
Seat 4: alexos04 (button) folded before Flop (didn't bet)
Seat 5: OllieMac86 (small blind) folded before Flop
Seat 6: MurphyCooler (big blind) collected ($0.10)



PokerStars Hand #222979560543:  Hold'em No Limit ($0.05/$0.10 USD) - 2021/01/23 19:19:15 ET
Table 'Transvaalia' 6-max Seat #5 is the button
Seat 1: Wagner GT ($10.25 in chips) 
Seat 3: Caigoo ($14.94 in chips) 
Seat 4: alexos04 ($11.01 in chips) 
Seat 5: OllieMac86 ($12.76 in chips) 
Seat 6: MurphyCooler ($8.66 in chips) 
MurphyCooler: posts small blind $0.05
Wagner GT: posts big blind $0.10
*** HOLE CARDS ***
Caigoo: folds 
alexos04: folds 
OllieMac86: raises $0.20 to $0.30
MurphyCooler: folds 
Wagner GT: folds 
Uncalled bet ($0.20) returned to OllieMac86
OllieMac86 collected $0.25 from pot
OllieMac86: doesn't show hand 
*** SUMMARY ***
Total pot $0.25 | Rake $0 
Seat 1: Wagner GT (big blind) folded before Flop
Seat 3: Caigoo folded before Flop (didn't bet)
Seat 4: alexos04 folded before Flop (didn't bet)
Seat 5: OllieMac86 (button) collected ($0.25)
Seat 6: MurphyCooler (small blind) folded before Flop



PokerStars Hand #222979576780:  Hold'em No Limit ($0.05/$0.10 USD) - 2021/01/23 19:19:45 ET
Table 'Transvaalia' 6-max Seat #6 is the button
Seat 1: Wagner GT ($10.15 in chips) 
Seat 2: everbodylovebdy ($4.33 in chips) 
Seat 3: Caigoo ($14.94 in chips) 
Seat 4: alexos04 ($11.01 in chips) 
Seat 5: OllieMac86 ($12.91 in chips) 
Seat 6: MurphyCooler ($8.61 in chips) 
Wagner GT: posts small blind $0.05
everbodylovebdy: posts big blind $0.10
*** HOLE CARDS ***
Caigoo: folds 
alexos04: raises $0.20 to $0.30
OllieMac86: folds 
MurphyCooler: calls $0.30
Wagner GT: raises $1.05 to $1.35
everbodylovebdy: raises $2.98 to $4.33 and is all-in
alexos04: folds 
MurphyCooler: folds 
Wagner GT: folds 
Uncalled bet ($2.98) returned to everbodylovebdy
everbodylovebdy collected $3.30 from pot
everbodylovebdy: doesn't show hand 
*** SUMMARY ***
Total pot $3.30 | Rake $0 
Seat 1: Wagner GT (small blind) folded before Flop
Seat 2: everbodylovebdy (big blind) collected ($3.30)
Seat 3: Caigoo folded before Flop (didn't bet)
Seat 4: alexos04 folded before Flop
Seat 5: OllieMac86 folded before Flop (didn't bet)
Seat 6: MurphyCooler (button) folded before Flop



PokerStars Hand #222979605775:  Hold'em No Limit ($0.05/$0.10 USD) - 2021/01/23 19:20:39 ET
Table 'Transvaalia' 6-max Seat #1 is the button
Seat 1: Wagner GT ($10 in chips) 
Seat 2: everbodylovebdy ($6.28 in chips) 
Seat 4: alexos04 ($10.71 in chips) 
Seat 5: OllieMac86 ($12.91 in chips) 
Seat 6: MurphyCooler ($8.31 in chips) 
everbodylovebdy: posts small blind $0.05
Caigoo: is sitting out 
alexos04: posts big blind $0.10
*** HOLE CARDS ***
Caigoo leaves the table
OllieMac86: raises $0.20 to $0.30
MurphyCooler: calls $0.30
romanskiy1 joins the table at seat #3 
Wagner GT: calls $0.30
everbodylovebdy: folds 
alexos04: folds 
*** FLOP *** [3d Jc 2d]
OllieMac86: checks 
MurphyCooler: checks 
Wagner GT: bets $0.33
OllieMac86: raises $0.67 to $1
MurphyCooler: folds 
Wagner GT: folds 
Uncalled bet ($0.67) returned to OllieMac86
OllieMac86 collected $1.63 from pot
OllieMac86: doesn't show hand 
*** SUMMARY ***
Total pot $1.71 | Rake $0.08 
Board [3d Jc 2d]
Seat 1: Wagner GT (button) folded on the Flop
Seat 2: everbodylovebdy (small blind) folded before Flop
Seat 4: alexos04 (big blind) folded before Flop
Seat 5: OllieMac86 collected ($1.63)
Seat 6: MurphyCooler folded on the Flop



PokerStars Hand #222979629297:  Hold'em No Limit ($0.05/$0.10 USD) - 2021/01/23 19:21:23 ET
Table 'Transvaalia' 6-max Seat #2 is the button
Seat 1: Wagner GT ($10 in chips) 
Seat 2: everbodylovebdy ($6.23 in chips) 
Seat 4: alexos04 ($10.61 in chips) 
Seat 5: OllieMac86 ($13.91 in chips) 
Seat 6: MurphyCooler ($8.01 in chips) 
alexos04: posts small blind $0.05
OllieMac86: posts big blind $0.10
*** HOLE CARDS ***
MurphyCooler: folds 
Wagner GT: folds 
everbodylovebdy: folds 
alexos04: raises $0.20 to $0.30
OllieMac86: calls $0.20
*** FLOP *** [Jd Qd 3h]
alexos04: bets $0.30
OllieMac86: calls $0.30
*** TURN *** [Jd Qd 3h] [Ah]
alexos04: bets $0.40
OllieMac86: folds 
Uncalled bet ($0.40) returned to alexos04
alexos04 collected $1.15 from pot
alexos04: doesn't show hand 
*** SUMMARY ***
Total pot $1.20 | Rake $0.05 
Board [Jd Qd 3h Ah]
Seat 1: Wagner GT folded before Flop (didn't bet)
Seat 2: everbodylovebdy (button) folded before Flop (didn't bet)
Seat 4: alexos04 (small blind) collected ($1.15)
Seat 5: OllieMac86 (big blind) folded on the Turn
Seat 6: MurphyCooler folded before Flop (didn't bet)



PokerStars Hand #222979648534:  Hold'em No Limit ($0.05/$0.10 USD) - 2021/01/23 19:22:00 ET
Table 'Transvaalia' 6-max Seat #4 is the button
Seat 1: Wagner GT ($10 in chips) 
Seat 2: everbodylovebdy ($6.23 in chips) 
Seat 4: alexos04 ($11.16 in chips) 
Seat 5: OllieMac86 ($13.31 in chips) 
Seat 6: MurphyCooler ($8.01 in chips) 
OllieMac86: posts small blind $0.05
MurphyCooler: posts big blind $0.10
romanskiy1: sits out 
*** HOLE CARDS ***
Wagner GT: folds 
everbodylovebdy: folds 
alexos04: folds 
OllieMac86: raises $0.20 to $0.30
MurphyCooler: folds 
Uncalled bet ($0.20) returned to OllieMac86
OllieMac86 collected $0.20 from pot
OllieMac86: doesn't show hand 
*** SUMMARY ***
Total pot $0.20 | Rake $0 
Seat 1: Wagner GT folded before Flop (didn't bet)
Seat 2: everbodylovebdy folded before Flop (didn't bet)
Seat 4: alexos04 (button) folded before Flop (didn't bet)
Seat 5: OllieMac86 (small blind) collected ($0.20)
Seat 6: MurphyCooler (big blind) folded before Flop



PokerStars Hand #222979656249:  Hold'em No Limit ($0.05/$0.10 USD) - 2021/01/23 19:22:14 ET
Table 'Transvaalia' 6-max Seat #5 is the button
Seat 1: Wagner GT ($10 in chips) 
Seat 2: everbodylovebdy ($6.23 in chips) 
Seat 4: alexos04 ($11.16 in chips) 
Seat 5: OllieMac86 ($13.41 in chips) 
Seat 6: MurphyCooler ($7.91 in chips) 
MurphyCooler: posts small blind $0.05
Wagner GT: posts big blind $0.10
everbodylovebdy is disconnected 
romanskiy1: sits out 
*** HOLE CARDS ***
everbodylovebdy has timed out while disconnected
everbodylovebdy: folds 
alexos04: folds 
OllieMac86: folds 
MurphyCooler: calls $0.05
Wagner GT has timed out
Wagner GT: checks 
*** FLOP *** [6c 2c 5s]
MurphyCooler: bets $0.19
Wagner GT: folds 
Uncalled bet ($0.19) returned to MurphyCooler
MurphyCooler collected $0.19 from pot
MurphyCooler: doesn't show hand 
*** SUMMARY ***
Total pot $0.20 | Rake $0.01 
Board [6c 2c 5s]
Seat 1: Wagner GT (big blind) folded on the Flop
Seat 2: everbodylovebdy folded before Flop (didn't bet)
Seat 4: alexos04 folded before Flop (didn't bet)
Seat 5: OllieMac86 (button) folded before Flop (didn't bet)
Seat 6: MurphyCooler (small blind) collected ($0.19)



PokerStars Hand #222979682346:  Hold'em No Limit ($0.05/$0.10 USD) - 2021/01/23 19:23:03 ET
Table 'Transvaalia' 6-max Seat #6 is the button
Seat 1: Wagner GT ($10 in chips) 
Seat 2: everbodylovebdy ($6.23 in chips) 
Seat 4: alexos04 ($11.16 in chips) 
Seat 5: OllieMac86 ($13.41 in chips) 
Seat 6: MurphyCooler ($8 in chips) 
Wagner GT: posts small blind $0.05
everbodylovebdy: posts big blind $0.10
romanskiy1: sits out 
*** HOLE CARDS ***
alexos04: folds 
OllieMac86: folds 
MurphyCooler: folds 
Wagner GT: folds 
Uncalled bet ($0.05) returned to everbodylovebdy
everbodylovebdy collected $0.10 from pot
everbodylovebdy: doesn't show hand 
*** SUMMARY ***
Total pot $0.10 | Rake $0 
Seat 1: Wagner GT (small blind) folded before Flop
Seat 2: everbodylovebdy (big blind) collected ($0.10)
Seat 4: alexos04 folded before Flop (didn't bet)
Seat 5: OllieMac86 folded before Flop (didn't bet)
Seat 6: MurphyCooler (button) folded before Flop (didn't bet)



PokerStars Hand #222979687258:  Hold'em No Limit ($0.05/$0.10 USD) - 2021/01/23 19:23:12 ET
Table 'Transvaalia' 6-max Seat #1 is the button
Seat 1: Wagner GT ($10 in chips) 
Seat 2: everbodylovebdy ($6.28 in chips) 
Seat 3: romanskiy1 ($10 in chips) 
Seat 4: alexos04 ($11.16 in chips) 
Seat 5: OllieMac86 ($13.41 in chips) 
Seat 6: MurphyCooler ($8 in chips) 
everbodylovebdy: posts small blind $0.05
romanskiy1: posts big blind $0.10
*** HOLE CARDS ***
alexos04: raises $0.20 to $0.30
OllieMac86: folds 
MurphyCooler: folds 
Wagner GT has timed out
Wagner GT: folds 
everbodylovebdy: folds 
romanskiy1: folds 
Uncalled bet ($0.20) returned to alexos04
alexos04 collected $0.25 from pot
alexos04: doesn't show hand 
*** SUMMARY ***
Total pot $0.25 | Rake $0 
Seat 1: Wagner GT (button) folded before Flop (didn't bet)
Seat 2: everbodylovebdy (small blind) folded before Flop
Seat 3: romanskiy1 (big blind) folded before Flop
Seat 4: alexos04 collected ($0.25)
Seat 5: OllieMac86 folded before Flop (didn't bet)
Seat 6: MurphyCooler folded before Flop (didn't bet)



PokerStars Hand #222979703001:  Hold'em No Limit ($0.05/$0.10 USD) - 2021/01/23 19:23:42 ET
Table 'Transvaalia' 6-max Seat #2 is the button
Seat 1: Wagner GT ($10 in chips) 
Seat 2: everbodylovebdy ($6.23 in chips) 
Seat 3: romanskiy1 ($10 in chips) 
Seat 4: alexos04 ($11.31 in chips) 
Seat 5: OllieMac86 ($13.41 in chips) 
Seat 6: MurphyCooler ($8 in chips) 
romanskiy1: posts small blind $0.05
alexos04: posts big blind $0.10
*** HOLE CARDS ***
OllieMac86: folds 
MurphyCooler: folds 
Wagner GT: raises $0.15 to $0.25
everbodylovebdy: calls $0.25
romanskiy1: folds 
alexos04: folds 
*** FLOP *** [5s Kd Ts]
Wagner GT: checks 
everbodylovebdy: checks 
*** TURN *** [5s Kd Ts] [Ks]
Wagner GT: checks 
everbodylovebdy: checks 
*** RIVER *** [5s Kd Ts Ks] [Qd]
Wagner GT: bets $0.47
everbodylovebdy: folds 
Uncalled bet ($0.47) returned to Wagner GT
Wagner GT collected $0.62 from pot
Wagner GT: doesn't show hand 
*** SUMMARY ***
Total pot $0.65 | Rake $0.03 
Board [5s Kd Ts Ks Qd]
Seat 1: Wagner GT collected ($0.62)
Seat 2: everbodylovebdy (button) folded on the River
Seat 3: romanskiy1 (small blind) folded before Flop
Seat 4: alexos04 (big blind) folded before Flop
Seat 5: OllieMac86 folded before Flop (didn't bet)
Seat 6: MurphyCooler folded before Flop (didn't bet)



PokerStars Hand #222979724727:  Hold'em No Limit ($0.05/$0.10 USD) - 2021/01/23 19:24:23 ET
Table 'Transvaalia' 6-max Seat #3 is the button
Seat 1: Wagner GT ($10.37 in chips) 
Seat 2: everbodylovebdy ($5.98 in chips) 
Seat 3: romanskiy1 ($10 in chips) 
Seat 4: alexos04 ($11.21 in chips) 
Seat 5: OllieMac86 ($13.41 in chips) 
Seat 6: MurphyCooler ($8 in chips) 
alexos04: posts small blind $0.05
OllieMac86: posts big blind $0.10
*** HOLE CARDS ***
MurphyCooler: folds 
Wagner GT: raises $0.15 to $0.25
everbodylovebdy: calls $0.25
romanskiy1: folds 
alexos04: folds 
OllieMac86: folds 
*** FLOP *** [Jh Qd Kh]
Wagner GT: checks 
everbodylovebdy: bets $0.40
Wagner GT: folds 
Uncalled bet ($0.40) returned to everbodylovebdy
everbodylovebdy collected $0.62 from pot
everbodylovebdy: doesn't show hand 
*** SUMMARY ***
Total pot $0.65 | Rake $0.03 
Board [Jh Qd Kh]
Seat 1: Wagner GT folded on the Flop
Seat 2: everbodylovebdy collected ($0.62)
Seat 3: romanskiy1 (button) folded before Flop (didn't bet)
Seat 4: alexos04 (small blind) folded before Flop
Seat 5: OllieMac86 (big blind) folded before Flop
Seat 6: MurphyCooler folded before Flop (didn't bet)



PokerStars Hand #222979740714:  Hold'em No Limit ($0.05/$0.10 USD) - 2021/01/23 19:24:53 ET
Table 'Transvaalia' 6-max Seat #4 is the button
Seat 1: Wagner GT ($10.12 in chips) 
Seat 2: everbodylovebdy ($6.35 in chips) 
Seat 3: romanskiy1 ($10 in chips) 
Seat 4: alexos04 ($11.16 in chips) 
Seat 5: OllieMac86 ($13.31 in chips) 
Seat 6: MurphyCooler ($8 in chips) 
OllieMac86: posts small blind $0.05
MurphyCooler: posts big blind $0.10
*** HOLE CARDS ***
Wagner GT: folds 
everbodylovebdy: folds 
romanskiy1: folds 
alexos04: folds 
OllieMac86: raises $0.20 to $0.30
MurphyCooler: folds 
Uncalled bet ($0.20) returned to OllieMac86
OllieMac86 collected $0.20 from pot
OllieMac86: doesn't show hand 
*** SUMMARY ***
Total pot $0.20 | Rake $0 
Seat 1: Wagner GT folded before Flop (didn't bet)
Seat 2: everbodylovebdy folded before Flop (didn't bet)
Seat 3: romanskiy1 folded before Flop (didn't bet)
Seat 4: alexos04 (button) folded before Flop (didn't bet)
Seat 5: OllieMac86 (small blind) collected ($0.20)
Seat 6: MurphyCooler (big blind) folded before Flop



PokerStars Hand #222979750970:  Hold'em No Limit ($0.05/$0.10 USD) - 2021/01/23 19:25:13 ET
Table 'Transvaalia' 6-max Seat #5 is the button
Seat 1: Wagner GT ($10.12 in chips) 
Seat 2: everbodylovebdy ($6.35 in chips) 
Seat 3: romanskiy1 ($10 in chips) 
Seat 4: alexos04 ($11.16 in chips) 
Seat 5: OllieMac86 ($13.41 in chips) 
Seat 6: MurphyCooler ($7.90 in chips) 
MurphyCooler: posts small blind $0.05
Wagner GT: posts big blind $0.10
*** HOLE CARDS ***
everbodylovebdy: folds 
romanskiy1: folds 
alexos04: folds 
OllieMac86: raises $0.20 to $0.30
MurphyCooler: folds 
Wagner GT: folds 
Uncalled bet ($0.20) returned to OllieMac86
OllieMac86 collected $0.25 from pot
OllieMac86: doesn't show hand 
*** SUMMARY ***
Total pot $0.25 | Rake $0 
Seat 1: Wagner GT (big blind) folded before Flop
Seat 2: everbodylovebdy folded before Flop (didn't bet)
Seat 3: romanskiy1 folded before Flop (didn't bet)
Seat 4: alexos04 folded before Flop (didn't bet)
Seat 5: OllieMac86 (button) collected ($0.25)
Seat 6: MurphyCooler (small blind) folded before Flop



PokerStars Hand #222979766056:  Hold'em No Limit ($0.05/$0.10 USD) - 2021/01/23 19:25:41 ET
Table 'Transvaalia' 6-max Seat #6 is the button
Seat 1: Wagner GT ($10.02 in chips) 
Seat 2: everbodylovebdy ($6.35 in chips) 
Seat 3: romanskiy1 ($10 in chips) 
Seat 4: alexos04 ($11.16 in chips) 
Seat 5: OllieMac86 ($13.56 in chips) 
Seat 6: MurphyCooler ($7.85 in chips) 
Wagner GT: posts small blind $0.05
everbodylovebdy: posts big blind $0.10
*** HOLE CARDS ***
romanskiy1: folds 
alexos04: folds 
OllieMac86: raises $0.20 to $0.30
MurphyCooler: folds 
Wagner GT: folds 
everbodylovebdy: folds 
Uncalled bet ($0.20) returned to OllieMac86
OllieMac86 collected $0.25 from pot
OllieMac86: doesn't show hand 
*** SUMMARY ***
Total pot $0.25 | Rake $0 
Seat 1: Wagner GT (small blind) folded before Flop
Seat 2: everbodylovebdy (big blind) folded before Flop
Seat 3: romanskiy1 folded before Flop (didn't bet)
Seat 4: alexos04 folded before Flop (didn't bet)
Seat 5: OllieMac86 collected ($0.25)
Seat 6: MurphyCooler (button) folded before Flop (didn't bet)



PokerStars Hand #222979777637:  Hold'em No Limit ($0.05/$0.10 USD) - 2021/01/23 19:26:03 ET
Table 'Transvaalia' 6-max Seat #1 is the button
Seat 1: Wagner GT ($10 in chips) 
Seat 2: everbodylovebdy ($6.25 in chips) 
Seat 3: romanskiy1 ($10 in chips) 
Seat 4: alexos04 ($11.16 in chips) 
Seat 5: OllieMac86 ($13.71 in chips) 
Seat 6: MurphyCooler ($7.85 in chips) 
everbodylovebdy: posts small blind $0.05
romanskiy1: posts big blind $0.10
*** HOLE CARDS ***
alexos04: raises $0.20 to $0.30
OllieMac86: folds 
MurphyCooler: folds 
Wagner GT: folds 
everbodylovebdy: folds 
romanskiy1: folds 
Uncalled bet ($0.20) returned to alexos04
alexos04 collected $0.25 from pot
alexos04: doesn't show hand 
*** SUMMARY ***
Total pot $0.25 | Rake $0 
Seat 1: Wagner GT (button) folded before Flop (didn't bet)
Seat 2: everbodylovebdy (small blind) folded before Flop
Seat 3: romanskiy1 (big blind) folded before Flop
Seat 4: alexos04 collected ($0.25)
Seat 5: OllieMac86 folded before Flop (didn't bet)
Seat 6: MurphyCooler folded before Flop (didn't bet)



PokerStars Hand #222979786733:  Hold'em No Limit ($0.05/$0.10 USD) - 2021/01/23 19:26:20 ET
Table 'Transvaalia' 6-max Seat #2 is the button
Seat 1: Wagner GT ($10 in chips) 
Seat 2: everbodylovebdy ($6.20 in chips) 
Seat 3: romanskiy1 ($10 in chips) 
Seat 4: alexos04 ($11.31 in chips) 
Seat 5: OllieMac86 ($13.71 in chips) 
Seat 6: MurphyCooler ($7.85 in chips) 
romanskiy1: posts small blind $0.05
alexos04: posts big blind $0.10
*** HOLE CARDS ***
OllieMac86: folds 
MurphyCooler: calls $0.10
Wagner GT has timed out
Wagner GT: folds 
everbodylovebdy: calls $0.10
romanskiy1: folds 
alexos04: checks 
*** FLOP *** [6h 3c 7s]
alexos04: checks 
MurphyCooler: checks 
everbodylovebdy: checks 
*** TURN *** [6h 3c 7s] [Js]
alexos04: checks 
MurphyCooler: checks 
everbodylovebdy: bets $0.30
alexos04: folds 
MurphyCooler: folds 
Uncalled bet ($0.30) returned to everbodylovebdy
everbodylovebdy collected $0.33 from pot
everbodylovebdy: doesn't show hand 
*** SUMMARY ***
Total pot $0.35 | Rake $0.02 
Board [6h 3c 7s Js]
Seat 1: Wagner GT folded before Flop (didn't bet)
Seat 2: everbodylovebdy (button) collected ($0.33)
Seat 3: romanskiy1 (small blind) folded before Flop
Seat 4: alexos04 (big blind) folded on the Turn
Seat 5: OllieMac86 folded before Flop (didn't bet)
Seat 6: MurphyCooler folded on the Turn



PokerStars Hand #222979827033:  Hold'em No Limit ($0.05/$0.10 USD) - 2021/01/23 19:27:32 ET
Table 'Transvaalia' 6-max Seat #3 is the button
Seat 1: Wagner GT ($10 in chips) 
Seat 2: everbodylovebdy ($6.43 in chips) 
Seat 3: romanskiy1 ($10 in chips) 
Seat 4: alexos04 ($11.21 in chips) 
Seat 5: OllieMac86 ($13.71 in chips) 
Seat 6: MurphyCooler ($7.75 in chips) 
alexos04: posts small blind $0.05
OllieMac86: posts big blind $0.10
*** HOLE CARDS ***
MurphyCooler: folds 
Wagner GT: folds 
everbodylovebdy: folds 
romanskiy1: raises $0.20 to $0.30
alexos04: folds 
OllieMac86: calls $0.20
*** FLOP *** [Th 4d 6s]
OllieMac86: checks 
romanskiy1: bets $0.31
OllieMac86: calls $0.31
*** TURN *** [Th 4d 6s] [9s]
OllieMac86: bets $0.82
romanskiy1: calls $0.82
*** RIVER *** [Th 4d 6s 9s] [7s]
OllieMac86: checks 
romanskiy1: checks 
*** SHOW DOWN ***
OllieMac86: shows [Td Qd] (a pair of Tens)
romanskiy1: mucks hand 
OllieMac86 collected $2.78 from pot
*** SUMMARY ***
Total pot $2.91 | Rake $0.13 
Board [Th 4d 6s 9s 7s]
Seat 1: Wagner GT folded before Flop (didn't bet)
Seat 2: everbodylovebdy folded before Flop (didn't bet)
Seat 3: romanskiy1 (button) mucked
Seat 4: alexos04 (small blind) folded before Flop
Seat 5: OllieMac86 (big blind) showed [Td Qd] and won ($2.78) with a pair of Tens
Seat 6: MurphyCooler folded before Flop (didn't bet)



PokerStars Hand #222979846142:  Hold'em No Limit ($0.05/$0.10 USD) - 2021/01/23 19:28:08 ET
Table 'Transvaalia' 6-max Seat #4 is the button
Seat 1: Wagner GT ($10 in chips) 
Seat 2: everbodylovebdy ($6.43 in chips) 
Seat 3: romanskiy1 ($10 in chips) 
Seat 4: alexos04 ($11.16 in chips) 
Seat 5: OllieMac86 ($15.06 in chips) 
Seat 6: MurphyCooler ($7.75 in chips) 
OllieMac86: posts small blind $0.05
MurphyCooler: posts big blind $0.10
*** HOLE CARDS ***
Wagner GT: folds 
everbodylovebdy: calls $0.10
romanskiy1: folds 
alexos04: folds 
OllieMac86: raises $0.40 to $0.50
MurphyCooler: folds 
everbodylovebdy: calls $0.40
*** FLOP *** [5h Tc Js]
OllieMac86: bets $0.71
everbodylovebdy: folds 
Uncalled bet ($0.71) returned to OllieMac86
OllieMac86 collected $1.05 from pot
OllieMac86: doesn't show hand 
*** SUMMARY ***
Total pot $1.10 | Rake $0.05 
Board [5h Tc Js]
Seat 1: Wagner GT folded before Flop (didn't bet)
Seat 2: everbodylovebdy folded on the Flop
Seat 3: romanskiy1 folded before Flop (didn't bet)
Seat 4: alexos04 (button) folded before Flop (didn't bet)
Seat 5: OllieMac86 (small blind) collected ($1.05)
Seat 6: MurphyCooler (big blind) folded before Flop



PokerStars Hand #222979862440:  Hold'em No Limit ($0.05/$0.10 USD) - 2021/01/23 19:28:40 ET
Table 'Transvaalia' 6-max Seat #5 is the button
Seat 1: Wagner GT ($10 in chips) 
Seat 2: everbodylovebdy ($5.93 in chips) 
Seat 3: romanskiy1 ($10 in chips) 
Seat 4: alexos04 ($11.16 in chips) 
Seat 5: OllieMac86 ($15.61 in chips) 
Seat 6: MurphyCooler ($7.65 in chips) 
MurphyCooler: posts small blind $0.05
Wagner GT: posts big blind $0.10
*** HOLE CARDS ***
everbodylovebdy has timed out
everbodylovebdy: folds 
romanskiy1: folds 
alexos04: folds 
OllieMac86: folds 
MurphyCooler: calls $0.05
Wagner GT: checks 
*** FLOP *** [8c Ts Qd]
MurphyCooler: checks 
Wagner GT: bets $0.10
MurphyCooler: folds 
Uncalled bet ($0.10) returned to Wagner GT
Wagner GT collected $0.19 from pot
Wagner GT: doesn't show hand 
*** SUMMARY ***
Total pot $0.20 | Rake $0.01 
Board [8c Ts Qd]
Seat 1: Wagner GT (big blind) collected ($0.19)
Seat 2: everbodylovebdy folded before Flop (didn't bet)
Seat 3: romanskiy1 folded before Flop (didn't bet)
Seat 4: alexos04 folded before Flop (didn't bet)
Seat 5: OllieMac86 (button) folded before Flop (didn't bet)
Seat 6: MurphyCooler (small blind) folded on the Flop



PokerStars Hand #222979879607:  Hold'em No Limit ($0.05/$0.10 USD) - 2021/01/23 19:29:12 ET
Table 'Transvaalia' 6-max Seat #6 is the button
Seat 1: Wagner GT ($10.09 in chips) 
Seat 2: everbodylovebdy ($5.93 in chips) 
Seat 3: romanskiy1 ($10 in chips) 
Seat 4: alexos04 ($11.16 in chips) 
Seat 5: OllieMac86 ($15.61 in chips) 
Seat 6: MurphyCooler ($7.55 in chips) 
Wagner GT: posts small blind $0.05
everbodylovebdy: posts big blind $0.10
*** HOLE CARDS ***
romanskiy1: folds 
alexos04: folds 
OllieMac86: raises $0.20 to $0.30
MurphyCooler: calls $0.30
Wagner GT: folds 
everbodylovebdy: folds 
*** FLOP *** [Kh 2s 4h]
OllieMac86: checks 
MurphyCooler: checks 
*** TURN *** [Kh 2s 4h] [7h]
OllieMac86: bets $0.49
MurphyCooler: folds 
Uncalled bet ($0.49) returned to OllieMac86
OllieMac86 collected $0.72 from pot
OllieMac86: doesn't show hand 
*** SUMMARY ***
Total pot $0.75 | Rake $0.03 
Board [Kh 2s 4h 7h]
Seat 1: Wagner GT (small blind) folded before Flop
Seat 2: everbodylovebdy (big blind) folded before Flop
Seat 3: romanskiy1 folded before Flop (didn't bet)
Seat 4: alexos04 folded before Flop (didn't bet)
Seat 5: OllieMac86 collected ($0.72)
Seat 6: MurphyCooler (button) folded on the Turn



PokerStars Hand #222979894329:  Hold'em No Limit ($0.05/$0.10 USD) - 2021/01/23 19:29:41 ET
Table 'Transvaalia' 6-max Seat #2 is the button
Seat 2: everbodylovebdy ($5.83 in chips) 
Seat 3: romanskiy1 ($10 in chips) 
Seat 4: alexos04 ($11.16 in chips) 
Seat 5: OllieMac86 ($16.03 in chips) 
Seat 6: MurphyCooler ($7.25 in chips) 
romanskiy1: posts small blind $0.05
alexos04: posts big blind $0.10
*** HOLE CARDS ***
OllieMac86: folds 
MurphyCooler: folds 
everbodylovebdy: raises $0.10 to $0.20
romanskiy1: folds 
alexos04: calls $0.10
*** FLOP *** [6h 6d Td]
alexos04: checks 
everbodylovebdy: bets $0.30
alexos04: calls $0.30
*** TURN *** [6h 6d Td] [5h]
alexos04: checks 
everbodylovebdy: bets $0.50
alexos04: folds 
Uncalled bet ($0.50) returned to everbodylovebdy
everbodylovebdy collected $1 from pot
everbodylovebdy: doesn't show hand 
*** SUMMARY ***
Total pot $1.05 | Rake $0.05 
Board [6h 6d Td 5h]
Seat 2: everbodylovebdy (button) collected ($1)
Seat 3: romanskiy1 (small blind) folded before Flop
Seat 4: alexos04 (big blind) folded on the Turn
Seat 5: OllieMac86 folded before Flop (didn't bet)
Seat 6: MurphyCooler folded before Flop (didn't bet)



PokerStars Hand #222979924248:  Hold'em No Limit ($0.05/$0.10 USD) - 2021/01/23 19:30:38 ET
Table 'Transvaalia' 6-max Seat #3 is the button
Seat 2: everbodylovebdy ($6.33 in chips) 
Seat 3: romanskiy1 ($10 in chips) 
Seat 4: alexos04 ($10.66 in chips) 
Seat 5: OllieMac86 ($16.03 in chips) 
Seat 6: MurphyCooler ($7.25 in chips) 
alexos04: posts small blind $0.05
OllieMac86: posts big blind $0.10
*** HOLE CARDS ***
MurphyCooler: calls $0.10
everbodylovebdy: folds 
romanskiy1: folds 
alexos04: raises $0.40 to $0.50
OllieMac86: folds 
MurphyCooler: folds 
Uncalled bet ($0.40) returned to alexos04
alexos04 collected $0.30 from pot
alexos04: doesn't show hand 
*** SUMMARY ***
Total pot $0.30 | Rake $0 
Seat 2: everbodylovebdy folded before Flop (didn't bet)
Seat 3: romanskiy1 (button) folded before Flop (didn't bet)
Seat 4: alexos04 (small blind) collected ($0.30)
Seat 5: OllieMac86 (big blind) folded before Flop
Seat 6: MurphyCooler folded before Flop



PokerStars Hand #222979935578:  Hold'em No Limit ($0.05/$0.10 USD) - 2021/01/23 19:31:00 ET
Table 'Transvaalia' 6-max Seat #4 is the button
Seat 1: Wagner GT ($10.04 in chips) 
Seat 2: everbodylovebdy ($6.33 in chips) 
Seat 3: romanskiy1 ($10 in chips) 
Seat 4: alexos04 ($10.86 in chips) 
Seat 5: OllieMac86 ($15.93 in chips) 
Seat 6: MurphyCooler ($7.15 in chips) 
OllieMac86: posts small blind $0.05
MurphyCooler: posts big blind $0.10
*** HOLE CARDS ***
Wagner GT: folds 
everbodylovebdy: folds 
romanskiy1: folds 
alexos04: folds 
OllieMac86: raises $0.20 to $0.30
MurphyCooler: calls $0.20
*** FLOP *** [2h 9h Ts]
OllieMac86: checks 
MurphyCooler: checks 
*** TURN *** [2h 9h Ts] [Js]
OllieMac86: checks 
MurphyCooler: bets $0.57
OllieMac86: folds 
Uncalled bet ($0.57) returned to MurphyCooler
MurphyCooler collected $0.57 from pot
MurphyCooler: doesn't show hand 
*** SUMMARY ***
Total pot $0.60 | Rake $0.03 
Board [2h 9h Ts Js]
Seat 1: Wagner GT folded before Flop (didn't bet)
Seat 2: everbodylovebdy folded before Flop (didn't bet)
Seat 3: romanskiy1 folded before Flop (didn't bet)
Seat 4: alexos04 (button) folded before Flop (didn't bet)
Seat 5: OllieMac86 (small blind) folded on the Turn
Seat 6: MurphyCooler (big blind) collected ($0.57)



PokerStars Hand #222979948914:  Hold'em No Limit ($0.05/$0.10 USD) - 2021/01/23 19:31:26 ET
Table 'Transvaalia' 6-max Seat #5 is the button
Seat 1: Wagner GT ($10.04 in chips) 
Seat 2: everbodylovebdy ($6.33 in chips) 
Seat 3: romanskiy1 ($10 in chips) 
Seat 4: alexos04 ($10.86 in chips) 
Seat 5: OllieMac86 ($15.63 in chips) 
Seat 6: MurphyCooler ($7.42 in chips) 
MurphyCooler: posts small blind $0.05
Wagner GT: posts big blind $0.10
*** HOLE CARDS ***
everbodylovebdy: calls $0.10
romanskiy1: raises $0.30 to $0.40
alexos04: folds 
OllieMac86: folds 
MurphyCooler: folds 
Wagner GT: folds 
everbodylovebdy: calls $0.30
*** FLOP *** [5h 8h 8s]
everbodylovebdy: checks 
romanskiy1: bets $0.46
everbodylovebdy: folds 
Uncalled bet ($0.46) returned to romanskiy1
romanskiy1 collected $0.91 from pot
romanskiy1: doesn't show hand 
*** SUMMARY ***
Total pot $0.95 | Rake $0.04 
Board [5h 8h 8s]
Seat 1: Wagner GT (big blind) folded before Flop
Seat 2: everbodylovebdy folded on the Flop
Seat 3: romanskiy1 collected ($0.91)
Seat 4: alexos04 folded before Flop (didn't bet)
Seat 5: OllieMac86 (button) folded before Flop (didn't bet)
Seat 6: MurphyCooler (small blind) folded before Flop



PokerStars Hand #222979970016:  Hold'em No Limit ($0.05/$0.10 USD) - 2021/01/23 19:32:07 ET
Table 'Transvaalia' 6-max Seat #6 is the button
Seat 1: Wagner GT ($10 in chips) 
Seat 2: everbodylovebdy ($5.93 in chips) 
Seat 3: romanskiy1 ($10.51 in chips) 
Seat 4: alexos04 ($10.86 in chips) 
Seat 5: OllieMac86 ($15.63 in chips) 
Seat 6: MurphyCooler ($7.37 in chips) 
Wagner GT: posts small blind $0.05
everbodylovebdy: posts big blind $0.10
*** HOLE CARDS ***
romanskiy1: folds 
alexos04: folds 
OllieMac86: raises $0.20 to $0.30
MurphyCooler: folds 
Wagner GT: folds 
everbodylovebdy: calls $0.20
*** FLOP *** [3c 4d 9c]
everbodylovebdy: checks 
OllieMac86: bets $0.42
everbodylovebdy: calls $0.42
*** TURN *** [3c 4d 9c] [Jd]
everbodylovebdy: checks 
OllieMac86: bets $0.97
everbodylovebdy: folds 
Uncalled bet ($0.97) returned to OllieMac86
OllieMac86 collected $1.42 from pot
OllieMac86: doesn't show hand 
*** SUMMARY ***
Total pot $1.49 | Rake $0.07 
Board [3c 4d 9c Jd]
Seat 1: Wagner GT (small blind) folded before Flop
Seat 2: everbodylovebdy (big blind) folded on the Turn
Seat 3: romanskiy1 folded before Flop (didn't bet)
Seat 4: alexos04 folded before Flop (didn't bet)
Seat 5: OllieMac86 collected ($1.42)
Seat 6: MurphyCooler (button) folded before Flop (didn't bet)



PokerStars Hand #222979997025:  Hold'em No Limit ($0.05/$0.10 USD) - 2021/01/23 19:32:44 ET
Table 'Transvaalia' 6-max Seat #1 is the button
Seat 1: Wagner GT ($10 in chips) 
Seat 2: everbodylovebdy ($5.21 in chips) 
Seat 3: romanskiy1 ($10.51 in chips) 
Seat 4: alexos04 ($10.86 in chips) 
Seat 5: OllieMac86 ($16.33 in chips) 
Seat 6: MurphyCooler ($7.37 in chips) 
everbodylovebdy: posts small blind $0.05
romanskiy1: posts big blind $0.10
*** HOLE CARDS ***
alexos04: folds 
OllieMac86: folds 
MurphyCooler: calls $0.10
Wagner GT: folds 
everbodylovebdy: folds 
romanskiy1: raises $0.40 to $0.50
MurphyCooler: folds 
Uncalled bet ($0.40) returned to romanskiy1
romanskiy1 collected $0.25 from pot
romanskiy1: doesn't show hand 
*** SUMMARY ***
Total pot $0.25 | Rake $0 
Seat 1: Wagner GT (button) folded before Flop (didn't bet)
Seat 2: everbodylovebdy (small blind) folded before Flop
Seat 3: romanskiy1 (big blind) collected ($0.25)
Seat 4: alexos04 folded before Flop (didn't bet)
Seat 5: OllieMac86 folded before Flop (didn't bet)
Seat 6: MurphyCooler folded before Flop



PokerStars Hand #222980009156:  Hold'em No Limit ($0.05/$0.10 USD) - 2021/01/23 19:33:07 ET
Table 'Transvaalia' 6-max Seat #2 is the button
Seat 1: Wagner GT ($10 in chips) 
Seat 2: everbodylovebdy ($5.16 in chips) 
Seat 3: romanskiy1 ($10.66 in chips) 
Seat 4: alexos04 ($10.86 in chips) 
Seat 5: OllieMac86 ($16.33 in chips) 
Seat 6: MurphyCooler ($7.27 in chips) 
romanskiy1: posts small blind $0.05
alexos04: posts big blind $0.10
*** HOLE CARDS ***
OllieMac86: folds 
MurphyCooler: raises $0.10 to $0.20
Wagner GT: folds 
everbodylovebdy: raises $0.20 to $0.40
romanskiy1: folds 
alexos04: folds 
MurphyCooler: calls $0.20
*** FLOP *** [2h Td 9s]
MurphyCooler: checks 
everbodylovebdy: bets $0.60
MurphyCooler: folds 
Uncalled bet ($0.60) returned to everbodylovebdy
everbodylovebdy collected $0.91 from pot
everbodylovebdy: doesn't show hand 
*** SUMMARY ***
Total pot $0.95 | Rake $0.04 
Board [2h Td 9s]
Seat 1: Wagner GT folded before Flop (didn't bet)
Seat 2: everbodylovebdy (button) collected ($0.91)
Seat 3: romanskiy1 (small blind) folded before Flop
Seat 4: alexos04 (big blind) folded before Flop
Seat 5: OllieMac86 folded before Flop (didn't bet)
Seat 6: MurphyCooler folded on the Flop



PokerStars Hand #222980026096:  Hold'em No Limit ($0.05/$0.10 USD) - 2021/01/23 19:33:41 ET
Table 'Transvaalia' 6-max Seat #3 is the button
Seat 1: Wagner GT ($10 in chips) 
Seat 2: everbodylovebdy ($5.67 in chips) 
Seat 3: romanskiy1 ($10.61 in chips) 
Seat 4: alexos04 ($10.76 in chips) 
Seat 5: OllieMac86 ($16.33 in chips) 
Seat 6: MurphyCooler ($6.87 in chips) 
alexos04: posts small blind $0.05
OllieMac86: posts big blind $0.10
*** HOLE CARDS ***
MurphyCooler: folds 
Wagner GT has timed out
Wagner GT: folds 
everbodylovebdy: calls $0.10
romanskiy1: raises $0.40 to $0.50
alexos04: folds 
OllieMac86: calls $0.40
everbodylovebdy: folds 
*** FLOP *** [Qd 3h 7c]
OllieMac86: checks 
romanskiy1: bets $0.73
OllieMac86: calls $0.73
*** TURN *** [Qd 3h 7c] [9h]
OllieMac86: checks 
romanskiy1: checks 
*** RIVER *** [Qd 3h 7c 9h] [Qc]
OllieMac86: bets $1.80
romanskiy1: folds 
Uncalled bet ($1.80) returned to OllieMac86
OllieMac86 collected $2.49 from pot
OllieMac86: doesn't show hand 
*** SUMMARY ***
Total pot $2.61 | Rake $0.12 
Board [Qd 3h 7c 9h Qc]
Seat 1: Wagner GT folded before Flop (didn't bet)
Seat 2: everbodylovebdy folded before Flop
Seat 3: romanskiy1 (button) folded on the River
Seat 4: alexos04 (small blind) folded before Flop
Seat 5: OllieMac86 (big blind) collected ($2.49)
Seat 6: MurphyCooler folded before Flop (didn't bet)



PokerStars Hand #222980053663:  Hold'em No Limit ($0.05/$0.10 USD) - 2021/01/23 19:34:35 ET
Table 'Transvaalia' 6-max Seat #4 is the button
Seat 1: Wagner GT ($10 in chips) 
Seat 2: everbodylovebdy ($5.57 in chips) 
Seat 3: romanskiy1 ($10 in chips) 
Seat 4: alexos04 ($10.71 in chips) 
Seat 5: OllieMac86 ($17.59 in chips) 
Seat 6: MurphyCooler ($6.87 in chips) 
OllieMac86: posts small blind $0.05
MurphyCooler: posts big blind $0.10
*** HOLE CARDS ***
Wagner GT: raises $0.15 to $0.25
everbodylovebdy: calls $0.25
romanskiy1: folds 
alexos04: folds 
OllieMac86: folds 
MurphyCooler: folds 
*** FLOP *** [2c Tc 5h]
Wagner GT: checks 
everbodylovebdy: bets $0.30
Wagner GT: calls $0.30
*** TURN *** [2c Tc 5h] [8c]
Wagner GT: checks 
everbodylovebdy: bets $0.50
Wagner GT: calls $0.50
*** RIVER *** [2c Tc 5h 8c] [7h]
Wagner GT: checks 
everbodylovebdy: checks 
*** SHOW DOWN ***
Wagner GT: shows [Kd Qs] (high card King)
everbodylovebdy: shows [Ah Ts] (a pair of Tens)
everbodylovebdy collected $2.15 from pot
*** SUMMARY ***
Total pot $2.25 | Rake $0.10 
Board [2c Tc 5h 8c 7h]
Seat 1: Wagner GT showed [Kd Qs] and lost with high card King
Seat 2: everbodylovebdy showed [Ah Ts] and won ($2.15) with a pair of Tens
Seat 3: romanskiy1 folded before Flop (didn't bet)
Seat 4: alexos04 (button) folded before Flop (didn't bet)
Seat 5: OllieMac86 (small blind) folded before Flop
Seat 6: MurphyCooler (big blind) folded before Flop



PokerStars Hand #222980088898:  Hold'em No Limit ($0.05/$0.10 USD) - 2021/01/23 19:35:45 ET
Table 'Transvaalia' 6-max Seat #5 is the button
Seat 1: Wagner GT ($10 in chips) 
Seat 2: everbodylovebdy ($6.67 in chips) 
Seat 3: romanskiy1 ($10 in chips) 
Seat 4: alexos04 ($10.71 in chips) 
Seat 5: OllieMac86 ($17.54 in chips) 
Seat 6: MurphyCooler ($6.77 in chips) 
MurphyCooler: posts small blind $0.05
Wagner GT: posts big blind $0.10
*** HOLE CARDS ***
everbodylovebdy: folds 
romanskiy1: folds 
alexos04: raises $0.20 to $0.30
OllieMac86: folds 
MurphyCooler: folds 
Wagner GT: calls $0.20
*** FLOP *** [9s Td 6d]
Wagner GT: checks 
alexos04: checks 
*** TURN *** [9s Td 6d] [3d]
Wagner GT: bets $0.47
alexos04: calls $0.47
*** RIVER *** [9s Td 6d 3d] [4c]
Wagner GT: checks 
alexos04: bets $0.70
Wagner GT: folds 
Uncalled bet ($0.70) returned to alexos04
alexos04 collected $1.52 from pot
alexos04: doesn't show hand 
*** SUMMARY ***
Total pot $1.59 | Rake $0.07 
Board [9s Td 6d 3d 4c]
Seat 1: Wagner GT (big blind) folded on the River
Seat 2: everbodylovebdy folded before Flop (didn't bet)
Seat 3: romanskiy1 folded before Flop (didn't bet)
Seat 4: alexos04 collected ($1.52)
Seat 5: OllieMac86 (button) folded before Flop (didn't bet)
Seat 6: MurphyCooler (small blind) folded before Flop



PokerStars Hand #222980118710:  Hold'em No Limit ($0.05/$0.10 USD) - 2021/01/23 19:36:44 ET
Table 'Transvaalia' 6-max Seat #6 is the button
Seat 1: Wagner GT ($10 in chips) 
Seat 2: everbodylovebdy ($6.67 in chips) 
Seat 3: romanskiy1 ($10 in chips) 
Seat 4: alexos04 ($11.46 in chips) 
Seat 5: OllieMac86 ($17.54 in chips) 
Seat 6: MurphyCooler ($6.72 in chips) 
Wagner GT: posts small blind $0.05
everbodylovebdy: posts big blind $0.10
*** HOLE CARDS ***
romanskiy1: folds 
alexos04: folds 
OllieMac86: folds 
MurphyCooler: calls $0.10
Wagner GT: folds 
everbodylovebdy: checks 
*** FLOP *** [2h Ah Jh]
everbodylovebdy: checks 
MurphyCooler: bets $0.10
everbodylovebdy: raises $0.10 to $0.20
MurphyCooler: calls $0.10
*** TURN *** [2h Ah Jh] [As]
everbodylovebdy: bets $0.30
MurphyCooler: folds 
Uncalled bet ($0.30) returned to everbodylovebdy
everbodylovebdy collected $0.62 from pot
everbodylovebdy: doesn't show hand 
*** SUMMARY ***
Total pot $0.65 | Rake $0.03 
Board [2h Ah Jh As]
Seat 1: Wagner GT (small blind) folded before Flop
Seat 2: everbodylovebdy (big blind) collected ($0.62)
Seat 3: romanskiy1 folded before Flop (didn't bet)
Seat 4: alexos04 folded before Flop (didn't bet)
Seat 5: OllieMac86 folded before Flop (didn't bet)
Seat 6: MurphyCooler (button) folded on the Turn



PokerStars Hand #222980138229:  Hold'em No Limit ($0.05/$0.10 USD) - 2021/01/23 19:37:23 ET
Table 'Transvaalia' 6-max Seat #1 is the button
Seat 1: Wagner GT ($10 in chips) 
Seat 2: everbodylovebdy ($6.99 in chips) 
Seat 3: romanskiy1 ($10 in chips) 
Seat 4: alexos04 ($11.46 in chips) 
Seat 5: OllieMac86 ($17.54 in chips) 
Seat 6: MurphyCooler ($6.42 in chips) 
everbodylovebdy: posts small blind $0.05
romanskiy1: posts big blind $0.10
*** HOLE CARDS ***
alexos04: raises $0.20 to $0.30
OllieMac86: folds 
MurphyCooler: folds 
Wagner GT: folds 
everbodylovebdy: folds 
romanskiy1: folds 
Uncalled bet ($0.20) returned to alexos04
alexos04 collected $0.25 from pot
alexos04: doesn't show hand 
*** SUMMARY ***
Total pot $0.25 | Rake $0 
Seat 1: Wagner GT (button) folded before Flop (didn't bet)
Seat 2: everbodylovebdy (small blind) folded before Flop
Seat 3: romanskiy1 (big blind) folded before Flop
Seat 4: alexos04 collected ($0.25)
Seat 5: OllieMac86 folded before Flop (didn't bet)
Seat 6: MurphyCooler folded before Flop (didn't bet)



PokerStars Hand #222980148348:  Hold'em No Limit ($0.05/$0.10 USD) - 2021/01/23 19:37:43 ET
Table 'Transvaalia' 6-max Seat #2 is the button
Seat 1: Wagner GT ($10 in chips) 
Seat 2: everbodylovebdy ($6.94 in chips) 
Seat 3: romanskiy1 ($10 in chips) 
Seat 4: alexos04 ($11.61 in chips) 
Seat 5: OllieMac86 ($17.54 in chips) 
Seat 6: MurphyCooler ($6.42 in chips) 
romanskiy1: posts small blind $0.05
alexos04: posts big blind $0.10
*** HOLE CARDS ***
OllieMac86: folds 
MurphyCooler: folds 
Wagner GT: raises $0.15 to $0.25
everbodylovebdy: folds 
romanskiy1: calls $0.20
alexos04: folds 
*** FLOP *** [Ad 9h 9s]
romanskiy1: checks 
Wagner GT: checks 
*** TURN *** [Ad 9h 9s] [7s]
romanskiy1: bets $0.38
Wagner GT: calls $0.38
*** RIVER *** [Ad 9h 9s 7s] [5h]
romanskiy1: checks 
Wagner GT: bets $0.87
romanskiy1: raises $1.52 to $2.39
Wagner GT: folds 
Uncalled bet ($1.52) returned to romanskiy1
romanskiy1 collected $2.96 from pot
romanskiy1: doesn't show hand 
*** SUMMARY ***
Total pot $3.10 | Rake $0.14 
Board [Ad 9h 9s 7s 5h]
Seat 1: Wagner GT folded on the River
Seat 2: everbodylovebdy (button) folded before Flop (didn't bet)
Seat 3: romanskiy1 (small blind) collected ($2.96)
Seat 4: alexos04 (big blind) folded before Flop
Seat 5: OllieMac86 folded before Flop (didn't bet)
Seat 6: MurphyCooler folded before Flop (didn't bet)



PokerStars Hand #222980184419:  Hold'em No Limit ($0.05/$0.10 USD) - 2021/01/23 19:38:55 ET
Table 'Transvaalia' 6-max Seat #3 is the button
Seat 1: Wagner GT ($10 in chips) 
Seat 2: everbodylovebdy ($6.94 in chips) 
Seat 3: romanskiy1 ($11.46 in chips) 
Seat 4: alexos04 ($11.51 in chips) 
Seat 5: OllieMac86 ($17.54 in chips) 
Seat 6: MurphyCooler ($6.42 in chips) 
alexos04: posts small blind $0.05
OllieMac86: posts big blind $0.10
*** HOLE CARDS ***
MurphyCooler: folds 
Wagner GT: raises $0.15 to $0.25
everbodylovebdy: folds 
romanskiy1 has timed out
romanskiy1: folds 
alexos04: folds 
romanskiy1 is disconnected 
OllieMac86: calls $0.15
*** FLOP *** [3h Qs Ad]
OllieMac86: checks 
Wagner GT: checks 
*** TURN *** [3h Qs Ad] [Kh]
OllieMac86: bets $0.36
Wagner GT: calls $0.36
*** RIVER *** [3h Qs Ad Kh] [Ks]
OllieMac86: checks 
Wagner GT: bets $0.81
OllieMac86: folds 
Uncalled bet ($0.81) returned to Wagner GT
Wagner GT collected $1.21 from pot
Wagner GT: doesn't show hand 
*** SUMMARY ***
Total pot $1.27 | Rake $0.06 
Board [3h Qs Ad Kh Ks]
Seat 1: Wagner GT collected ($1.21)
Seat 2: everbodylovebdy folded before Flop (didn't bet)
Seat 3: romanskiy1 (button) folded before Flop (didn't bet)
Seat 4: alexos04 (small blind) folded before Flop
Seat 5: OllieMac86 (big blind) folded on the River
Seat 6: MurphyCooler folded before Flop (didn't bet)



PokerStars Hand #222980226532:  Hold'em No Limit ($0.05/$0.10 USD) - 2021/01/23 19:40:19 ET
Table 'Transvaalia' 6-max Seat #4 is the button
Seat 1: Wagner GT ($10.60 in chips) 
Seat 2: everbodylovebdy ($6.94 in chips) 
Seat 4: alexos04 ($11.46 in chips) 
Seat 5: OllieMac86 ($16.93 in chips) 
Seat 6: MurphyCooler ($6.42 in chips) 
OllieMac86: posts small blind $0.05
MurphyCooler: posts big blind $0.10
*** HOLE CARDS ***
Wagner GT: folds 
everbodylovebdy: folds 
alexos04: folds 
OllieMac86: raises $0.20 to $0.30
MurphyCooler: calls $0.20
*** FLOP *** [3d 6s 9c]
OllieMac86: checks 
MurphyCooler: bets $0.10
OllieMac86: calls $0.10
*** TURN *** [3d 6s 9c] [Jh]
OllieMac86: checks 
MurphyCooler: bets $0.10
OllieMac86: calls $0.10
*** RIVER *** [3d 6s 9c Jh] [8h]
OllieMac86: checks 
MurphyCooler: checks 
*** SHOW DOWN ***
OllieMac86: shows [5s As] (high card Ace)
MurphyCooler: shows [9d Qc] (a pair of Nines)
MurphyCooler collected $0.96 from pot
*** SUMMARY ***
Total pot $1 | Rake $0.04 
Board [3d 6s 9c Jh 8h]
Seat 1: Wagner GT folded before Flop (didn't bet)
Seat 2: everbodylovebdy folded before Flop (didn't bet)
Seat 4: alexos04 (button) folded before Flop (didn't bet)
Seat 5: OllieMac86 (small blind) showed [5s As] and lost with high card Ace
Seat 6: MurphyCooler (big blind) showed [9d Qc] and won ($0.96) with a pair of Nines



PokerStars Hand #222980239687:  Hold'em No Limit ($0.05/$0.10 USD) - 2021/01/23 19:40:46 ET
Table 'Transvaalia' 6-max Seat #5 is the button
Seat 1: Wagner GT ($10.60 in chips) 
Seat 2: everbodylovebdy ($6.94 in chips) 
Seat 4: alexos04 ($11.46 in chips) 
Seat 5: OllieMac86 ($16.43 in chips) 
Seat 6: MurphyCooler ($6.88 in chips) 
MurphyCooler: posts small blind $0.05
Wagner GT: posts big blind $0.10
*** HOLE CARDS ***
everbodylovebdy: folds 
alexos04: folds 
OllieMac86: raises $0.20 to $0.30
MurphyCooler: folds 
Wagner GT: folds 
Uncalled bet ($0.20) returned to OllieMac86
OllieMac86 collected $0.25 from pot
OllieMac86: doesn't show hand 
*** SUMMARY ***
Total pot $0.25 | Rake $0 
Seat 1: Wagner GT (big blind) folded before Flop
Seat 2: everbodylovebdy folded before Flop (didn't bet)
Seat 4: alexos04 folded before Flop (didn't bet)
Seat 5: OllieMac86 (button) collected ($0.25)
Seat 6: MurphyCooler (small blind) folded before Flop



PokerStars Hand #222980249154:  Hold'em No Limit ($0.05/$0.10 USD) - 2021/01/23 19:41:05 ET
Table 'Transvaalia' 6-max Seat #6 is the button
Seat 1: Wagner GT ($10.50 in chips) 
Seat 2: everbodylovebdy ($6.94 in chips) 
Seat 3: romanskiy1 ($11.46 in chips) 
Seat 4: alexos04 ($11.46 in chips) 
Seat 5: OllieMac86 ($16.58 in chips) 
Seat 6: MurphyCooler ($6.83 in chips) 
Wagner GT: posts small blind $0.05
everbodylovebdy: posts big blind $0.10
*** HOLE CARDS ***
romanskiy1: folds 
alexos04: raises $0.20 to $0.30
OllieMac86: folds 
MurphyCooler: folds 
Wagner GT: folds 
everbodylovebdy: folds 
Uncalled bet ($0.20) returned to alexos04
alexos04 collected $0.25 from pot
alexos04: doesn't show hand 
*** SUMMARY ***
Total pot $0.25 | Rake $0 
Seat 1: Wagner GT (small blind) folded before Flop
Seat 2: everbodylovebdy (big blind) folded before Flop
Seat 3: romanskiy1 folded before Flop (didn't bet)
Seat 4: alexos04 collected ($0.25)
Seat 5: OllieMac86 folded before Flop (didn't bet)
Seat 6: MurphyCooler (button) folded before Flop (didn't bet)



PokerStars Hand #222980255402:  Hold'em No Limit ($0.05/$0.10 USD) - 2021/01/23 19:41:17 ET
Table 'Transvaalia' 6-max Seat #1 is the button
Seat 1: Wagner GT ($10.45 in chips) 
Seat 2: everbodylovebdy ($6.84 in chips) 
Seat 3: romanskiy1 ($11.46 in chips) 
Seat 4: alexos04 ($11.61 in chips) 
Seat 5: OllieMac86 ($16.58 in chips) 
Seat 6: MurphyCooler ($6.83 in chips) 
everbodylovebdy: posts small blind $0.05
romanskiy1: posts big blind $0.10
*** HOLE CARDS ***
alexos04: folds 
OllieMac86: folds 
MurphyCooler: folds 
Wagner GT: raises $0.20 to $0.30
everbodylovebdy: folds 
romanskiy1: folds 
Uncalled bet ($0.20) returned to Wagner GT
Wagner GT collected $0.25 from pot
Wagner GT: doesn't show hand 
*** SUMMARY ***
Total pot $0.25 | Rake $0 
Seat 1: Wagner GT (button) collected ($0.25)
Seat 2: everbodylovebdy (small blind) folded before Flop
Seat 3: romanskiy1 (big blind) folded before Flop
Seat 4: alexos04 folded before Flop (didn't bet)
Seat 5: OllieMac86 folded before Flop (didn't bet)
Seat 6: MurphyCooler folded before Flop (didn't bet)



PokerStars Hand #222980264086:  Hold'em No Limit ($0.05/$0.10 USD) - 2021/01/23 19:41:35 ET
Table 'Transvaalia' 6-max Seat #2 is the button
Seat 1: Wagner GT ($10.60 in chips) 
Seat 2: everbodylovebdy ($6.79 in chips) 
Seat 3: romanskiy1 ($11.36 in chips) 
Seat 4: alexos04 ($11.61 in chips) 
Seat 5: OllieMac86 ($16.58 in chips) 
Seat 6: MurphyCooler ($6.83 in chips) 
romanskiy1: posts small blind $0.05
alexos04: posts big blind $0.10
*** HOLE CARDS ***
OllieMac86: folds 
MurphyCooler: folds 
Wagner GT: folds 
everbodylovebdy: folds 
romanskiy1: raises $0.20 to $0.30
alexos04: folds 
Uncalled bet ($0.20) returned to romanskiy1
romanskiy1 collected $0.20 from pot
romanskiy1: doesn't show hand 
*** SUMMARY ***
Total pot $0.20 | Rake $0 
Seat 1: Wagner GT folded before Flop (didn't bet)
Seat 2: everbodylovebdy (button) folded before Flop (didn't bet)
Seat 3: romanskiy1 (small blind) collected ($0.20)
Seat 4: alexos04 (big blind) folded before Flop
Seat 5: OllieMac86 folded before Flop (didn't bet)
Seat 6: MurphyCooler folded before Flop (didn't bet)



PokerStars Hand #222980272168:  Hold'em No Limit ($0.05/$0.10 USD) - 2021/01/23 19:41:52 ET
Table 'Transvaalia' 6-max Seat #3 is the button
Seat 1: Wagner GT ($10.60 in chips) 
Seat 2: everbodylovebdy ($6.79 in chips) 
Seat 3: romanskiy1 ($11.46 in chips) 
Seat 4: alexos04 ($11.51 in chips) 
Seat 5: OllieMac86 ($16.58 in chips) 
Seat 6: MurphyCooler ($6.83 in chips) 
alexos04: posts small blind $0.05
OllieMac86: posts big blind $0.10
*** HOLE CARDS ***
MurphyCooler: raises $0.10 to $0.20
Wagner GT has timed out
Wagner GT: folds 
everbodylovebdy: folds 
romanskiy1: folds 
alexos04: folds 
OllieMac86: calls $0.10
*** FLOP *** [5c 3c Td]
OllieMac86: checks 
MurphyCooler: checks 
*** TURN *** [5c 3c Td] [4s]
OllieMac86: bets $0.30
MurphyCooler: folds 
Uncalled bet ($0.30) returned to OllieMac86
OllieMac86 collected $0.43 from pot
OllieMac86: doesn't show hand 
*** SUMMARY ***
Total pot $0.45 | Rake $0.02 
Board [5c 3c Td 4s]
Seat 1: Wagner GT folded before Flop (didn't bet)
Seat 2: everbodylovebdy folded before Flop (didn't bet)
Seat 3: romanskiy1 (button) folded before Flop (didn't bet)
Seat 4: alexos04 (small blind) folded before Flop
Seat 5: OllieMac86 (big blind) collected ($0.43)
Seat 6: MurphyCooler folded on the Turn



PokerStars Hand #222980291049:  Hold'em No Limit ($0.05/$0.10 USD) - 2021/01/23 19:42:30 ET
Table 'Transvaalia' 6-max Seat #4 is the button
Seat 1: Wagner GT ($10.60 in chips) 
Seat 2: everbodylovebdy ($6.79 in chips) 
Seat 3: romanskiy1 ($11.46 in chips) 
Seat 4: alexos04 ($11.46 in chips) 
Seat 5: OllieMac86 ($16.81 in chips) 
Seat 6: MurphyCooler ($6.63 in chips) 
OllieMac86: posts small blind $0.05
MurphyCooler: posts big blind $0.10
*** HOLE CARDS ***
Wagner GT: folds 
everbodylovebdy has timed out
everbodylovebdy: folds 
romanskiy1: folds 
alexos04: raises $0.20 to $0.30
OllieMac86: folds 
MurphyCooler: folds 
Uncalled bet ($0.20) returned to alexos04
alexos04 collected $0.25 from pot
alexos04: doesn't show hand 
*** SUMMARY ***
Total pot $0.25 | Rake $0 
Seat 1: Wagner GT folded before Flop (didn't bet)
Seat 2: everbodylovebdy folded before Flop (didn't bet)
Seat 3: romanskiy1 folded before Flop (didn't bet)
Seat 4: alexos04 (button) collected ($0.25)
Seat 5: OllieMac86 (small blind) folded before Flop
Seat 6: MurphyCooler (big blind) folded before Flop



PokerStars Hand #222980301353:  Hold'em No Limit ($0.05/$0.10 USD) - 2021/01/23 19:42:51 ET
Table 'Transvaalia' 6-max Seat #5 is the button
Seat 1: Wagner GT ($10.60 in chips) 
Seat 2: everbodylovebdy ($6.79 in chips) 
Seat 3: romanskiy1 ($11.46 in chips) 
Seat 4: alexos04 ($11.61 in chips) 
Seat 5: OllieMac86 ($16.76 in chips) 
Seat 6: MurphyCooler ($6.53 in chips) 
MurphyCooler: posts small blind $0.05
Wagner GT: posts big blind $0.10
*** HOLE CARDS ***
everbodylovebdy: folds 
romanskiy1: folds 
alexos04: folds 
OllieMac86: raises $0.20 to $0.30
MurphyCooler: calls $0.25
Wagner GT: folds 
*** FLOP *** [Ac 8c 6d]
MurphyCooler: bets $0.67
OllieMac86: folds 
Uncalled bet ($0.67) returned to MurphyCooler
MurphyCooler collected $0.67 from pot
MurphyCooler: doesn't show hand 
*** SUMMARY ***
Total pot $0.70 | Rake $0.03 
Board [Ac 8c 6d]
Seat 1: Wagner GT (big blind) folded before Flop
Seat 2: everbodylovebdy folded before Flop (didn't bet)
Seat 3: romanskiy1 folded before Flop (didn't bet)
Seat 4: alexos04 folded before Flop (didn't bet)
Seat 5: OllieMac86 (button) folded on the Flop
Seat 6: MurphyCooler (small blind) collected ($0.67)



PokerStars Hand #222980312430:  Hold'em No Limit ($0.05/$0.10 USD) - 2021/01/23 19:43:13 ET
Table 'Transvaalia' 6-max Seat #6 is the button
Seat 1: Wagner GT ($10.50 in chips) 
Seat 2: everbodylovebdy ($6.79 in chips) 
Seat 3: romanskiy1 ($11.46 in chips) 
Seat 4: alexos04 ($11.61 in chips) 
Seat 5: OllieMac86 ($16.46 in chips) 
Seat 6: MurphyCooler ($6.90 in chips) 
Wagner GT: posts small blind $0.05
everbodylovebdy: posts big blind $0.10
*** HOLE CARDS ***
romanskiy1: folds 
alexos04: folds 
OllieMac86: folds 
MurphyCooler: folds 
Wagner GT: folds 
Uncalled bet ($0.05) returned to everbodylovebdy
everbodylovebdy collected $0.10 from pot
everbodylovebdy: doesn't show hand 
*** SUMMARY ***
Total pot $0.10 | Rake $0 
Seat 1: Wagner GT (small blind) folded before Flop
Seat 2: everbodylovebdy (big blind) collected ($0.10)
Seat 3: romanskiy1 folded before Flop (didn't bet)
Seat 4: alexos04 folded before Flop (didn't bet)
Seat 5: OllieMac86 folded before Flop (didn't bet)
Seat 6: MurphyCooler (button) folded before Flop (didn't bet)



PokerStars Hand #222980316666:  Hold'em No Limit ($0.05/$0.10 USD) - 2021/01/23 19:43:22 ET
Table 'Transvaalia' 6-max Seat #1 is the button
Seat 1: Wagner GT ($10.45 in chips) 
Seat 2: everbodylovebdy ($6.84 in chips) 
Seat 3: romanskiy1 ($11.46 in chips) 
Seat 4: alexos04 ($11.61 in chips) 
Seat 5: OllieMac86 ($16.46 in chips) 
Seat 6: MurphyCooler ($6.90 in chips) 
everbodylovebdy: posts small blind $0.05
romanskiy1: posts big blind $0.10
*** HOLE CARDS ***
alexos04: raises $0.20 to $0.30
OllieMac86: folds 
MurphyCooler: calls $0.30
Wagner GT: calls $0.30
everbodylovebdy: folds 
romanskiy1: folds 
*** FLOP *** [7h Jh 7s]
alexos04: bets $0.60
MurphyCooler: folds 
Wagner GT: folds 
Uncalled bet ($0.60) returned to alexos04
alexos04 collected $1 from pot
alexos04: doesn't show hand 
*** SUMMARY ***
Total pot $1.05 | Rake $0.05 
Board [7h Jh 7s]
Seat 1: Wagner GT (button) folded on the Flop
Seat 2: everbodylovebdy (small blind) folded before Flop
Seat 3: romanskiy1 (big blind) folded before Flop
Seat 4: alexos04 collected ($1)
Seat 5: OllieMac86 folded before Flop (didn't bet)
Seat 6: MurphyCooler folded on the Flop



PokerStars Hand #222980363554:  Hold'em No Limit ($0.05/$0.10 USD) - 2021/01/23 19:44:58 ET
Table 'Transvaalia' 6-max Seat #2 is the button
Seat 1: Wagner GT ($10.15 in chips) 
Seat 2: everbodylovebdy ($6.79 in chips) 
Seat 3: romanskiy1 ($11.36 in chips) 
Seat 4: alexos04 ($12.31 in chips) 
Seat 5: OllieMac86 ($16.46 in chips) 
Seat 6: MurphyCooler ($6.60 in chips) 
romanskiy1: posts small blind $0.05
alexos04: posts big blind $0.10
*** HOLE CARDS ***
OllieMac86: folds 
MurphyCooler: folds 
Wagner GT: raises $0.15 to $0.25
everbodylovebdy: calls $0.25
romanskiy1: folds 
alexos04: folds 
*** FLOP *** [8d Th 9d]
Wagner GT: checks 
everbodylovebdy: bets $0.31
Wagner GT: raises $0.93 to $1.24
everbodylovebdy: raises $5.30 to $6.54 and is all-in
Wagner GT: calls $5.30
*** TURN *** [8d Th 9d] [8s]
*** RIVER *** [8d Th 9d 8s] [3c]
*** SHOW DOWN ***
Wagner GT: shows [Jd Kc] (a pair of Eights)
everbodylovebdy: shows [As 9h] (two pair, Nines and Eights)
everbodylovebdy collected $13.11 from pot
*** SUMMARY ***
Total pot $13.73 | Rake $0.62 
Board [8d Th 9d 8s 3c]
Seat 1: Wagner GT showed [Jd Kc] and lost with a pair of Eights
Seat 2: everbodylovebdy (button) showed [As 9h] and won ($13.11) with two pair, Nines and Eights
Seat 3: romanskiy1 (small blind) folded before Flop
Seat 4: alexos04 (big blind) folded before Flop
Seat 5: OllieMac86 folded before Flop (didn't bet)
Seat 6: MurphyCooler folded before Flop (didn't bet)



PokerStars Hand #222980389696:  Hold'em No Limit ($0.05/$0.10 USD) - 2021/01/23 19:45:51 ET
Table 'Transvaalia' 6-max Seat #3 is the button
Seat 1: Wagner GT ($10 in chips) 
Seat 2: everbodylovebdy ($13.11 in chips) 
Seat 3: romanskiy1 ($11.31 in chips) 
Seat 4: alexos04 ($12.21 in chips) 
Seat 5: OllieMac86 ($16.46 in chips) 
Seat 6: MurphyCooler ($6.60 in chips) 
alexos04: posts small blind $0.05
OllieMac86: posts big blind $0.10
*** HOLE CARDS ***
MurphyCooler: calls $0.10
Wagner GT: folds 
everbodylovebdy: folds 
romanskiy1: raises $0.30 to $0.40
alexos04: folds 
OllieMac86: folds 
MurphyCooler: calls $0.30
*** FLOP *** [Qc Qh Kc]
MurphyCooler: checks 
romanskiy1: bets $0.46
MurphyCooler: folds 
Uncalled bet ($0.46) returned to romanskiy1
romanskiy1 collected $0.91 from pot
romanskiy1: doesn't show hand 
*** SUMMARY ***
Total pot $0.95 | Rake $0.04 
Board [Qc Qh Kc]
Seat 1: Wagner GT folded before Flop (didn't bet)
Seat 2: everbodylovebdy folded before Flop (didn't bet)
Seat 3: romanskiy1 (button) collected ($0.91)
Seat 4: alexos04 (small blind) folded before Flop
Seat 5: OllieMac86 (big blind) folded before Flop
Seat 6: MurphyCooler folded on the Flop



PokerStars Hand #222980404743:  Hold'em No Limit ($0.05/$0.10 USD) - 2021/01/23 19:46:22 ET
Table 'Transvaalia' 6-max Seat #4 is the button
Seat 1: Wagner GT ($10 in chips) 
Seat 2: everbodylovebdy ($13.11 in chips) 
Seat 3: romanskiy1 ($11.82 in chips) 
Seat 4: alexos04 ($12.16 in chips) 
Seat 5: OllieMac86 ($16.36 in chips) 
Seat 6: MurphyCooler ($6.20 in chips) 
OllieMac86: posts small blind $0.05
MurphyCooler: posts big blind $0.10
*** HOLE CARDS ***
Wagner GT: raises $0.15 to $0.25
everbodylovebdy: folds 
romanskiy1: folds 
alexos04: folds 
OllieMac86: folds 
MurphyCooler: calls $0.15
*** FLOP *** [3d 3c 3h]
MurphyCooler: bets $0.53
Wagner GT: calls $0.53
*** TURN *** [3d 3c 3h] [Kc]
MurphyCooler: checks 
Wagner GT: checks 
*** RIVER *** [3d 3c 3h Kc] [Ts]
MurphyCooler: checks 
Wagner GT: checks 
*** SHOW DOWN ***
MurphyCooler: shows [5h Ad] (three of a kind, Threes)
Wagner GT: shows [5s 5c] (a full house, Threes full of Fives)
Wagner GT collected $1.54 from pot
*** SUMMARY ***
Total pot $1.61 | Rake $0.07 
Board [3d 3c 3h Kc Ts]
Seat 1: Wagner GT showed [5s 5c] and won ($1.54) with a full house, Threes full of Fives
Seat 2: everbodylovebdy folded before Flop (didn't bet)
Seat 3: romanskiy1 folded before Flop (didn't bet)
Seat 4: alexos04 (button) folded before Flop (didn't bet)
Seat 5: OllieMac86 (small blind) folded before Flop
Seat 6: MurphyCooler (big blind) showed [5h Ad] and lost with three of a kind, Threes



PokerStars Hand #222980432067:  Hold'em No Limit ($0.05/$0.10 USD) - 2021/01/23 19:47:12 ET
Table 'Transvaalia' 6-max Seat #5 is the button
Seat 1: Wagner GT ($10.76 in chips) 
Seat 2: everbodylovebdy ($13.11 in chips) 
Seat 3: romanskiy1 ($11.82 in chips) 
Seat 4: alexos04 ($12.16 in chips) 
Seat 5: OllieMac86 ($16.31 in chips) 
Seat 6: MurphyCooler ($5.42 in chips) 
MurphyCooler: posts small blind $0.05
Wagner GT: posts big blind $0.10
*** HOLE CARDS ***
everbodylovebdy: calls $0.10
romanskiy1: folds 
alexos04: folds 
OllieMac86: folds 
MurphyCooler: raises $0.10 to $0.20
Wagner GT: folds 
everbodylovebdy: calls $0.10
*** FLOP *** [6h 4h Kc]
MurphyCooler: checks 
everbodylovebdy: checks 
*** TURN *** [6h 4h Kc] [4c]
MurphyCooler: checks 
everbodylovebdy: checks 
*** RIVER *** [6h 4h Kc 4c] [6s]
MurphyCooler: checks 
everbodylovebdy: checks 
*** SHOW DOWN ***
MurphyCooler: shows [Th Ad] (two pair, Sixes and Fours)
everbodylovebdy: shows [9d Ac] (two pair, Sixes and Fours)
MurphyCooler collected $0.24 from pot
everbodylovebdy collected $0.24 from pot
*** SUMMARY ***
Total pot $0.50 | Rake $0.02 
Board [6h 4h Kc 4c 6s]
Seat 1: Wagner GT (big blind) folded before Flop
Seat 2: everbodylovebdy showed [9d Ac] and won ($0.24) with two pair, Sixes and Fours
Seat 3: romanskiy1 folded before Flop (didn't bet)
Seat 4: alexos04 folded before Flop (didn't bet)
Seat 5: OllieMac86 (button) folded before Flop (didn't bet)
Seat 6: MurphyCooler (small blind) showed [Th Ad] and won ($0.24) with two pair, Sixes and Fours



PokerStars Hand #222980455543:  Hold'em No Limit ($0.05/$0.10 USD) - 2021/01/23 19:47:44 ET
Table 'Transvaalia' 6-max Seat #6 is the button
Seat 2: everbodylovebdy ($13.15 in chips) 
Seat 3: romanskiy1 ($11.82 in chips) 
Seat 4: alexos04 ($12.16 in chips) 
Seat 5: OllieMac86 ($16.31 in chips) 
Seat 6: MurphyCooler ($5.46 in chips) 
everbodylovebdy: posts small blind $0.05
romanskiy1: posts big blind $0.10
*** HOLE CARDS ***
alexos04: raises $0.20 to $0.30
OllieMac86: folds 
MurphyCooler: calls $0.30
everbodylovebdy: folds 
romanskiy1: folds 
*** FLOP *** [Jd Jc 9h]
alexos04: bets $0.30
MurphyCooler: folds 
Uncalled bet ($0.30) returned to alexos04
alexos04 collected $0.72 from pot
alexos04: doesn't show hand 
*** SUMMARY ***
Total pot $0.75 | Rake $0.03 
Board [Jd Jc 9h]
Seat 2: everbodylovebdy (small blind) folded before Flop
Seat 3: romanskiy1 (big blind) folded before Flop
Seat 4: alexos04 collected ($0.72)
Seat 5: OllieMac86 folded before Flop (didn't bet)
Seat 6: MurphyCooler (button) folded on the Flop



PokerStars Hand #222980464963:  Hold'em No Limit ($0.05/$0.10 USD) - 2021/01/23 19:48:03 ET
Table 'Transvaalia' 6-max Seat #2 is the button
Seat 2: everbodylovebdy ($13.10 in chips) 
Seat 3: romanskiy1 ($11.72 in chips) 
Seat 4: alexos04 ($12.58 in chips) 
Seat 5: OllieMac86 ($16.31 in chips) 
Seat 6: MurphyCooler ($5.16 in chips) 
romanskiy1: posts small blind $0.05
alexos04: posts big blind $0.10
*** HOLE CARDS ***
OllieMac86: raises $0.20 to $0.30
MurphyCooler: folds 
everbodylovebdy: folds 
romanskiy1: calls $0.25
alexos04: folds 
*** FLOP *** [Ks 9h Jh]
romanskiy1: checks 
OllieMac86: checks 
*** TURN *** [Ks 9h Jh] [5d]
romanskiy1: checks 
OllieMac86: bets $0.46
romanskiy1: folds 
Uncalled bet ($0.46) returned to OllieMac86
OllieMac86 collected $0.67 from pot
OllieMac86: doesn't show hand 
*** SUMMARY ***
Total pot $0.70 | Rake $0.03 
Board [Ks 9h Jh 5d]
Seat 2: everbodylovebdy (button) folded before Flop (didn't bet)
Seat 3: romanskiy1 (small blind) folded on the Turn
Seat 4: alexos04 (big blind) folded before Flop
Seat 5: OllieMac86 collected ($0.67)
Seat 6: MurphyCooler folded before Flop (didn't bet)



PokerStars Hand #222980483862:  Hold'em No Limit ($0.05/$0.10 USD) - 2021/01/23 19:48:43 ET
Table 'Transvaalia' 6-max Seat #3 is the button
Seat 2: everbodylovebdy ($13.10 in chips) 
Seat 3: romanskiy1 ($11.42 in chips) 
Seat 4: alexos04 ($12.48 in chips) 
Seat 5: OllieMac86 ($16.68 in chips) 
Seat 6: MurphyCooler ($5.16 in chips) 
alexos04: posts small blind $0.05
OllieMac86: posts big blind $0.10
*** HOLE CARDS ***
MurphyCooler: calls $0.10
everbodylovebdy: calls $0.10
romanskiy1: folds 
alexos04: folds 
OllieMac86: checks 
*** FLOP *** [3d 8d Jc]
OllieMac86: checks 
MurphyCooler: checks 
everbodylovebdy: bets $0.16
OllieMac86: folds 
MurphyCooler: folds 
Uncalled bet ($0.16) returned to everbodylovebdy
everbodylovebdy collected $0.33 from pot
everbodylovebdy: doesn't show hand 
*** SUMMARY ***
Total pot $0.35 | Rake $0.02 
Board [3d 8d Jc]
Seat 2: everbodylovebdy collected ($0.33)
Seat 3: romanskiy1 (button) folded before Flop (didn't bet)
Seat 4: alexos04 (small blind) folded before Flop
Seat 5: OllieMac86 (big blind) folded on the Flop
Seat 6: MurphyCooler folded on the Flop



PokerStars Hand #222980498570:  Hold'em No Limit ($0.05/$0.10 USD) - 2021/01/23 19:49:13 ET
Table 'Transvaalia' 6-max Seat #4 is the button
Seat 2: everbodylovebdy ($13.33 in chips) 
Seat 3: romanskiy1 ($11.42 in chips) 
Seat 4: alexos04 ($12.43 in chips) 
Seat 5: OllieMac86 ($16.58 in chips) 
Seat 6: MurphyCooler ($5.06 in chips) 
OllieMac86: posts small blind $0.05
MurphyCooler: posts big blind $0.10
*** HOLE CARDS ***
everbodylovebdy: folds 
romanskiy1: raises $0.20 to $0.30
alexos04: folds 
OllieMac86: folds 
MurphyCooler: calls $0.20
*** FLOP *** [Kc 6d Jd]
MurphyCooler: bets $0.10
romanskiy1: raises $0.41 to $0.51
MurphyCooler: calls $0.41
*** TURN *** [Kc 6d Jd] [Tc]
MurphyCooler: checks 
romanskiy1: checks 
*** RIVER *** [Kc 6d Jd Tc] [5s]
MurphyCooler: checks 
romanskiy1: checks 
*** SHOW DOWN ***
MurphyCooler: shows [4d 5d] (a pair of Fives)
romanskiy1: shows [9s 9h] (a pair of Nines)
romanskiy1 collected $1.59 from pot
*** SUMMARY ***
Total pot $1.67 | Rake $0.08 
Board [Kc 6d Jd Tc 5s]
Seat 2: everbodylovebdy folded before Flop (didn't bet)
Seat 3: romanskiy1 showed [9s 9h] and won ($1.59) with a pair of Nines
Seat 4: alexos04 (button) folded before Flop (didn't bet)
Seat 5: OllieMac86 (small blind) folded before Flop
Seat 6: MurphyCooler (big blind) showed [4d 5d] and lost with a pair of Fives



PokerStars Hand #222980516001:  Hold'em No Limit ($0.05/$0.10 USD) - 2021/01/23 19:49:50 ET
Table 'Transvaalia' 6-max Seat #5 is the button
Seat 2: everbodylovebdy ($13.33 in chips) 
Seat 3: romanskiy1 ($12.20 in chips) 
Seat 4: alexos04 ($12.43 in chips) 
Seat 5: OllieMac86 ($16.53 in chips) 
Seat 6: MurphyCooler ($4.25 in chips) 
MurphyCooler: posts small blind $0.05
everbodylovebdy: posts big blind $0.10
*** HOLE CARDS ***
romanskiy1: folds 
alexos04: folds 
OllieMac86: folds 
MurphyCooler: calls $0.05
everbodylovebdy: checks 
*** FLOP *** [3d 5s Ks]
MurphyCooler: bets $0.60
everbodylovebdy: folds 
Uncalled bet ($0.60) returned to MurphyCooler
MurphyCooler collected $0.19 from pot
MurphyCooler: doesn't show hand 
*** SUMMARY ***
Total pot $0.20 | Rake $0.01 
Board [3d 5s Ks]
Seat 2: everbodylovebdy (big blind) folded on the Flop
Seat 3: romanskiy1 folded before Flop (didn't bet)
Seat 4: alexos04 folded before Flop (didn't bet)
Seat 5: OllieMac86 (button) folded before Flop (didn't bet)
Seat 6: MurphyCooler (small blind) collected ($0.19)



PokerStars Hand #222980523076:  Hold'em No Limit ($0.05/$0.10 USD) - 2021/01/23 19:50:05 ET
Table 'Transvaalia' 6-max Seat #6 is the button
Seat 2: everbodylovebdy ($13.23 in chips) 
Seat 3: romanskiy1 ($12.20 in chips) 
Seat 4: alexos04 ($12.43 in chips) 
Seat 5: OllieMac86 ($16.53 in chips) 
Seat 6: MurphyCooler ($4.34 in chips) 
everbodylovebdy: posts small blind $0.05
romanskiy1: posts big blind $0.10
*** HOLE CARDS ***
alexos04: raises $0.20 to $0.30
OllieMac86: folds 
MurphyCooler: folds 
everbodylovebdy: folds 
romanskiy1: folds 
Uncalled bet ($0.20) returned to alexos04
alexos04 collected $0.25 from pot
alexos04: doesn't show hand 
*** SUMMARY ***
Total pot $0.25 | Rake $0 
Seat 2: everbodylovebdy (small blind) folded before Flop
Seat 3: romanskiy1 (big blind) folded before Flop
Seat 4: alexos04 collected ($0.25)
Seat 5: OllieMac86 folded before Flop (didn't bet)
Seat 6: MurphyCooler (button) folded before Flop (didn't bet)



PokerStars Hand #222980528836:  Hold'em No Limit ($0.05/$0.10 USD) - 2021/01/23 19:50:17 ET
Table 'Transvaalia' 6-max Seat #2 is the button
Seat 2: everbodylovebdy ($13.18 in chips) 
Seat 3: romanskiy1 ($12.10 in chips) 
Seat 4: alexos04 ($12.58 in chips) 
Seat 5: OllieMac86 ($16.53 in chips) 
Seat 6: MurphyCooler ($4.34 in chips) 
romanskiy1: posts small blind $0.05
alexos04: posts big blind $0.10
*** HOLE CARDS ***
OllieMac86: raises $0.20 to $0.30
MurphyCooler: calls $0.30
everbodylovebdy: folds 
romanskiy1: folds 
alexos04: calls $0.20
*** FLOP *** [5c 2d 2s]
alexos04: checks 
OllieMac86: checks 
MurphyCooler: checks 
*** TURN *** [5c 2d 2s] [3s]
alexos04: checks 
OllieMac86: checks 
MurphyCooler: checks 
*** RIVER *** [5c 2d 2s 3s] [4h]
alexos04: checks 
OllieMac86: bets $0.52
MurphyCooler: folds 
MurphyCooler leaves the table
alexos04: calls $0.52
*** SHOW DOWN ***
OllieMac86: shows [Ac 7c] (a straight, Ace to Five)
alexos04: shows [Ad Jc] (a straight, Ace to Five)
alexos04 collected $0.95 from pot
OllieMac86 collected $0.95 from pot
*** SUMMARY ***
Total pot $1.99 | Rake $0.09 
Board [5c 2d 2s 3s 4h]
Seat 2: everbodylovebdy (button) folded before Flop (didn't bet)
Seat 3: romanskiy1 (small blind) folded before Flop
Seat 4: alexos04 (big blind) showed [Ad Jc] and won ($0.95) with a straight, Ace to Five
Seat 5: OllieMac86 showed [Ac 7c] and won ($0.95) with a straight, Ace to Five
Seat 6: MurphyCooler folded on the River



PokerStars Hand #222980561942:  Hold'em No Limit ($0.05/$0.10 USD) - 2021/01/23 19:51:26 ET
Table 'Transvaalia' 6-max Seat #3 is the button
Seat 2: everbodylovebdy ($13.18 in chips) 
Seat 3: romanskiy1 ($12.05 in chips) 
Seat 4: alexos04 ($12.71 in chips) 
Seat 5: OllieMac86 ($16.66 in chips) 
alexos04: posts small blind $0.05
OllieMac86: posts big blind $0.10
*** HOLE CARDS ***
everbodylovebdy: raises $0.10 to $0.20
romanskiy1: folds 
alexos04: folds 
OllieMac86: calls $0.10
*** FLOP *** [3s 5s Ah]
OllieMac86: checks 
everbodylovebdy: bets $0.20
OllieMac86: calls $0.20
*** TURN *** [3s 5s Ah] [Qs]
OllieMac86: checks 
everbodylovebdy: checks 
*** RIVER *** [3s 5s Ah Qs] [As]
OllieMac86: checks 
everbodylovebdy: checks 
*** SHOW DOWN ***
OllieMac86: shows [3h Jc] (two pair, Aces and Threes)
everbodylovebdy: shows [4s 4c] (a flush, Ace high)
everbodylovebdy collected $0.81 from pot
*** SUMMARY ***
Total pot $0.85 | Rake $0.04 
Board [3s 5s Ah Qs As]
Seat 2: everbodylovebdy showed [4s 4c] and won ($0.81) with a flush, Ace high
Seat 3: romanskiy1 (button) folded before Flop (didn't bet)
Seat 4: alexos04 (small blind) folded before Flop
Seat 5: OllieMac86 (big blind) showed [3h Jc] and lost with two pair, Aces and Threes



PokerStars Hand #222980579610:  Hold'em No Limit ($0.05/$0.10 USD) - 2021/01/23 19:52:04 ET
Table 'Transvaalia' 6-max Seat #4 is the button
Seat 2: everbodylovebdy ($13.59 in chips) 
Seat 3: romanskiy1 ($12.05 in chips) 
Seat 4: alexos04 ($12.66 in chips) 
Seat 5: OllieMac86 ($16.26 in chips) 
OllieMac86: posts small blind $0.05
everbodylovebdy: posts big blind $0.10
*** HOLE CARDS ***
romanskiy1: raises $0.20 to $0.30
alexos04: folds 
OllieMac86: folds 
JcTigrera.9 joins the table at seat #6 
everbodylovebdy: folds 
Uncalled bet ($0.20) returned to romanskiy1
romanskiy1 collected $0.25 from pot
romanskiy1: doesn't show hand 
*** SUMMARY ***
Total pot $0.25 | Rake $0 
Seat 2: everbodylovebdy (big blind) folded before Flop
Seat 3: romanskiy1 collected ($0.25)
Seat 4: alexos04 (button) folded before Flop (didn't bet)
Seat 5: OllieMac86 (small blind) folded before Flop



PokerStars Hand #222980584674:  Hold'em No Limit ($0.05/$0.10 USD) - 2021/01/23 19:52:15 ET
Table 'Transvaalia' 6-max Seat #5 is the button
Seat 2: everbodylovebdy ($13.49 in chips) 
Seat 3: romanskiy1 ($12.20 in chips) 
Seat 4: alexos04 ($12.66 in chips) 
Seat 5: OllieMac86 ($16.21 in chips) 
everbodylovebdy: posts small blind $0.05
romanskiy1: posts big blind $0.10
*** HOLE CARDS ***
alexos04: folds 
OllieMac86: raises $0.20 to $0.30
everbodylovebdy: calls $0.25
romanskiy1: folds 
*** FLOP *** [2d 5c Jh]
everbodylovebdy: checks 
OllieMac86: bets $0.38
everbodylovebdy: folds 
Uncalled bet ($0.38) returned to OllieMac86
OllieMac86 collected $0.67 from pot
OllieMac86: doesn't show hand 
*** SUMMARY ***
Total pot $0.70 | Rake $0.03 
Board [2d 5c Jh]
Seat 2: everbodylovebdy (small blind) folded on the Flop
Seat 3: romanskiy1 (big blind) folded before Flop
Seat 4: alexos04 folded before Flop (didn't bet)
Seat 5: OllieMac86 (button) collected ($0.67)



PokerStars Hand #222980599934:  Hold'em No Limit ($0.05/$0.10 USD) - 2021/01/23 19:52:47 ET
Table 'Transvaalia' 6-max Seat #2 is the button
Seat 2: everbodylovebdy ($13.19 in chips) 
Seat 3: romanskiy1 ($12.10 in chips) 
Seat 4: alexos04 ($12.66 in chips) 
Seat 5: OllieMac86 ($16.58 in chips) 
romanskiy1: posts small blind $0.05
alexos04: posts big blind $0.10
JcTigrera.9: sits out 
*** HOLE CARDS ***
OllieMac86: folds 
everbodylovebdy: folds 
romanskiy1: folds 
Uncalled bet ($0.05) returned to alexos04
alexos04 collected $0.10 from pot
alexos04: doesn't show hand 
*** SUMMARY ***
Total pot $0.10 | Rake $0 
Seat 2: everbodylovebdy (button) folded before Flop (didn't bet)
Seat 3: romanskiy1 (small blind) folded before Flop
Seat 4: alexos04 (big blind) collected ($0.10)
Seat 5: OllieMac86 folded before Flop (didn't bet)



PokerStars Hand #222980603075:  Hold'em No Limit ($0.05/$0.10 USD) - 2021/01/23 19:52:54 ET
Table 'Transvaalia' 6-max Seat #3 is the button
Seat 2: everbodylovebdy ($13.19 in chips) 
Seat 3: romanskiy1 ($12.05 in chips) 
Seat 4: alexos04 ($12.71 in chips) 
Seat 5: OllieMac86 ($16.58 in chips) 
alexos04: posts small blind $0.05
OllieMac86: posts big blind $0.10
JcTigrera.9: sits out 
*** HOLE CARDS ***
everbodylovebdy: folds 
romanskiy1: folds 
alexos04: raises $0.20 to $0.30
OllieMac86: calls $0.20
*** FLOP *** [Ah 5s Ad]
alexos04: bets $0.30
OllieMac86: raises $0.60 to $0.90
alexos04: calls $0.60
*** TURN *** [Ah 5s Ad] [3c]
alexos04: checks 
OllieMac86: checks 
*** RIVER *** [Ah 5s Ad 3c] [Ts]
alexos04: bets $1.30
OllieMac86: folds 
Uncalled bet ($1.30) returned to alexos04
alexos04 collected $2.29 from pot
alexos04: doesn't show hand 
*** SUMMARY ***
Total pot $2.40 | Rake $0.11 
Board [Ah 5s Ad 3c Ts]
Seat 2: everbodylovebdy folded before Flop (didn't bet)
Seat 3: romanskiy1 (button) folded before Flop (didn't bet)
Seat 4: alexos04 (small blind) collected ($2.29)
Seat 5: OllieMac86 (big blind) folded on the River



PokerStars Hand #222980632391:  Hold'em No Limit ($0.05/$0.10 USD) - 2021/01/23 19:53:56 ET
Table 'Transvaalia' 6-max Seat #4 is the button
Seat 2: everbodylovebdy ($13.19 in chips) 
Seat 3: romanskiy1 ($12.05 in chips) 
Seat 4: alexos04 ($13.80 in chips) 
Seat 5: OllieMac86 ($15.38 in chips) 
Seat 6: JcTigrera.9 ($10 in chips) 
OllieMac86: posts small blind $0.05
JcTigrera.9: posts big blind $0.10
Wagner GT: sits out 
*** HOLE CARDS ***
everbodylovebdy: calls $0.10
romanskiy1: folds 
alexos04: folds 
OllieMac86: folds 
JcTigrera.9: checks 
*** FLOP *** [Th 9h Ac]
JcTigrera.9: checks 
everbodylovebdy: checks 
*** TURN *** [Th 9h Ac] [8c]
JcTigrera.9: bets $0.20
everbodylovebdy: raises $0.20 to $0.40
JcTigrera.9: calls $0.20
*** RIVER *** [Th 9h Ac 8c] [5d]
JcTigrera.9: checks 
everbodylovebdy: bets $0.20
JcTigrera.9: calls $0.20
*** SHOW DOWN ***
everbodylovebdy: shows [Ad 7s] (a pair of Aces)
JcTigrera.9: mucks hand 
everbodylovebdy collected $1.38 from pot
*** SUMMARY ***
Total pot $1.45 | Rake $0.07 
Board [Th 9h Ac 8c 5d]
Seat 2: everbodylovebdy showed [Ad 7s] and won ($1.38) with a pair of Aces
Seat 3: romanskiy1 folded before Flop (didn't bet)
Seat 4: alexos04 (button) folded before Flop (didn't bet)
Seat 5: OllieMac86 (small blind) folded before Flop
Seat 6: JcTigrera.9 (big blind) mucked



PokerStars Hand #222980654021:  Hold'em No Limit ($0.05/$0.10 USD) - 2021/01/23 19:54:42 ET
Table 'Transvaalia' 6-max Seat #5 is the button
Seat 1: Wagner GT ($10.66 in chips) 
Seat 2: everbodylovebdy ($13.87 in chips) 
Seat 3: romanskiy1 ($12.05 in chips) 
Seat 4: alexos04 ($13.80 in chips) 
Seat 5: OllieMac86 ($15.33 in chips) 
Seat 6: JcTigrera.9 ($9.30 in chips) 
JcTigrera.9: posts small blind $0.05
Wagner GT: posts big blind $0.10
*** HOLE CARDS ***
everbodylovebdy: calls $0.10
romanskiy1: raises $0.30 to $0.40
alexos04: folds 
OllieMac86: folds 
JcTigrera.9: folds 
Wagner GT: calls $0.30
everbodylovebdy: calls $0.30
*** FLOP *** [2s Ad Td]
Wagner GT: checks 
JcTigrera.9 leaves the table
everbodylovebdy: bets $0.40
romanskiy1: calls $0.40
Wagner GT: folds 
*** TURN *** [2s Ad Td] [2d]
everbodylovebdy: bets $0.70
romanskiy1: calls $0.70
*** RIVER *** [2s Ad Td 2d] [Qc]
everbodylovebdy: bets $1.64
romanskiy1: folds 
Uncalled bet ($1.64) returned to everbodylovebdy
everbodylovebdy collected $3.29 from pot
everbodylovebdy: doesn't show hand 
*** SUMMARY ***
Total pot $3.45 | Rake $0.16 
Board [2s Ad Td 2d Qc]
Seat 1: Wagner GT (big blind) folded on the Flop
Seat 2: everbodylovebdy collected ($3.29)
Seat 3: romanskiy1 folded on the River
Seat 4: alexos04 folded before Flop (didn't bet)
Seat 5: OllieMac86 (button) folded before Flop (didn't bet)
Seat 6: JcTigrera.9 (small blind) folded before Flop



PokerStars Hand #222980682133:  Hold'em No Limit ($0.05/$0.10 USD) - 2021/01/23 19:55:53 ET
Table 'Transvaalia' 6-max Seat #1 is the button
Seat 1: Wagner GT ($10.26 in chips) 
Seat 2: everbodylovebdy ($15.66 in chips) 
Seat 3: romanskiy1 ($10.55 in chips) 
Seat 4: alexos04 ($13.80 in chips) 
Seat 5: OllieMac86 ($15.33 in chips) 
everbodylovebdy: posts small blind $0.05
romanskiy1: posts big blind $0.10
*** HOLE CARDS ***
alexos04: raises $0.20 to $0.30
OllieMac86: folds 
Wagner GT: folds 
everbodylovebdy: folds 
romanskiy1: folds 
Uncalled bet ($0.20) returned to alexos04
alexos04 collected $0.25 from pot
alexos04: doesn't show hand 
*** SUMMARY ***
Total pot $0.25 | Rake $0 
Seat 1: Wagner GT (button) folded before Flop (didn't bet)
Seat 2: everbodylovebdy (small blind) folded before Flop
Seat 3: romanskiy1 (big blind) folded before Flop
Seat 4: alexos04 collected ($0.25)
Seat 5: OllieMac86 folded before Flop (didn't bet)



PokerStars Hand #222980686580:  Hold'em No Limit ($0.05/$0.10 USD) - 2021/01/23 19:56:05 ET
Table 'Transvaalia' 6-max Seat #2 is the button
Seat 1: Wagner GT ($10.26 in chips) 
Seat 2: everbodylovebdy ($15.61 in chips) 
Seat 3: romanskiy1 ($10.45 in chips) 
Seat 4: alexos04 ($13.95 in chips) 
Seat 5: OllieMac86 ($15.33 in chips) 
romanskiy1: posts small blind $0.05
alexos04: posts big blind $0.10
*** HOLE CARDS ***
OllieMac86: folds 
Wagner GT: raises $0.15 to $0.25
everbodylovebdy: calls $0.25
romanskiy1: folds 
alexos04: folds 
*** FLOP *** [9d Jh 5c]
Wagner GT: checks 
everbodylovebdy: bets $0.20
Wagner GT: raises $0.60 to $0.80
everbodylovebdy: calls $0.60
*** TURN *** [9d Jh 5c] [7c]
Wagner GT: checks 
everbodylovebdy: bets $1.07
Wagner GT: folds 
Uncalled bet ($1.07) returned to everbodylovebdy
everbodylovebdy collected $2.15 from pot
everbodylovebdy: doesn't show hand 
*** SUMMARY ***
Total pot $2.25 | Rake $0.10 
Board [9d Jh 5c 7c]
Seat 1: Wagner GT folded on the Turn
Seat 2: everbodylovebdy (button) collected ($2.15)
Seat 3: romanskiy1 (small blind) folded before Flop
Seat 4: alexos04 (big blind) folded before Flop
Seat 5: OllieMac86 folded before Flop (didn't bet)



PokerStars Hand #222980714984:  Hold'em No Limit ($0.05/$0.10 USD) - 2021/01/23 19:57:23 ET
Table 'Transvaalia' 6-max Seat #3 is the button
Seat 1: Wagner GT ($10 in chips) 
Seat 2: everbodylovebdy ($16.71 in chips) 
Seat 3: romanskiy1 ($10.40 in chips) 
Seat 4: alexos04 ($13.85 in chips) 
Seat 5: OllieMac86 ($15.33 in chips) 
alexos04: posts small blind $0.05
OllieMac86: posts big blind $0.10
*** HOLE CARDS ***
Wagner GT: folds 
Wagner GT leaves the table
everbodylovebdy: raises $0.10 to $0.20
romanskiy1: folds 
alexos04: folds 
OllieMac86: folds 
Uncalled bet ($0.10) returned to everbodylovebdy
everbodylovebdy collected $0.25 from pot
everbodylovebdy: doesn't show hand 
*** SUMMARY ***
Total pot $0.25 | Rake $0 
Seat 1: Wagner GT folded before Flop (didn't bet)
Seat 2: everbodylovebdy collected ($0.25)
Seat 3: romanskiy1 (button) folded before Flop (didn't bet)
Seat 4: alexos04 (small blind) folded before Flop
Seat 5: OllieMac86 (big blind) folded before Flop



PokerStars Hand #222980720032:  Hold'em No Limit ($0.05/$0.10 USD) - 2021/01/23 19:57:37 ET
Table 'Transvaalia' 6-max Seat #4 is the button
Seat 2: everbodylovebdy ($16.86 in chips) 
Seat 3: romanskiy1 ($10.40 in chips) 
Seat 4: alexos04 ($13.80 in chips) 
Seat 5: OllieMac86 ($15.23 in chips) 
OllieMac86: posts small blind $0.05
everbodylovebdy: posts big blind $0.10
*** HOLE CARDS ***
romanskiy1: folds 
alexos04: folds 
OllieMac86: raises $0.20 to $0.30
everbodylovebdy: calls $0.20
*** FLOP *** [4h 8c Jd]
OllieMac86: checks 
everbodylovebdy: checks 
*** TURN *** [4h 8c Jd] [Js]
OllieMac86: bets $0.39
everbodylovebdy: raises $0.39 to $0.78
OllieMac86: folds 
Uncalled bet ($0.39) returned to everbodylovebdy
everbodylovebdy collected $1.32 from pot
everbodylovebdy: doesn't show hand 
*** SUMMARY ***
Total pot $1.38 | Rake $0.06 
Board [4h 8c Jd Js]
Seat 2: everbodylovebdy (big blind) collected ($1.32)
Seat 3: romanskiy1 folded before Flop (didn't bet)
Seat 4: alexos04 (button) folded before Flop (didn't bet)
Seat 5: OllieMac86 (small blind) folded on the Turn



PokerStars Hand #222980729402:  Hold'em No Limit ($0.05/$0.10 USD) - 2021/01/23 19:58:03 ET
Table 'Transvaalia' 6-max Seat #5 is the button
Seat 2: everbodylovebdy ($17.49 in chips) 
Seat 3: romanskiy1 ($10.40 in chips) 
Seat 4: alexos04 ($13.80 in chips) 
Seat 5: OllieMac86 ($14.54 in chips) 
everbodylovebdy: posts small blind $0.05
romanskiy1: posts big blind $0.10
*** HOLE CARDS ***
alexos04: folds 
OllieMac86: folds 
everbodylovebdy: calls $0.05
romanskiy1: raises $0.30 to $0.40
everbodylovebdy: calls $0.30
*** FLOP *** [8c Kh 7c]
everbodylovebdy: checks 
romanskiy1: bets $0.51
everbodylovebdy: calls $0.51
*** TURN *** [8c Kh 7c] [9s]
everbodylovebdy: checks 
romanskiy1: bets $1.16
everbodylovebdy: calls $1.16
*** RIVER *** [8c Kh 7c 9s] [Ks]
everbodylovebdy: checks 
romanskiy1: bets $2.63
everbodylovebdy: folds 
Uncalled bet ($2.63) returned to romanskiy1
romanskiy1 collected $3.95 from pot
romanskiy1: doesn't show hand 
*** SUMMARY ***
Total pot $4.14 | Rake $0.19 
Board [8c Kh 7c 9s Ks]
Seat 2: everbodylovebdy (small blind) folded on the River
Seat 3: romanskiy1 (big blind) collected ($3.95)
Seat 4: alexos04 folded before Flop (didn't bet)
Seat 5: OllieMac86 (button) folded before Flop (didn't bet)



PokerStars Hand #222980748164:  Hold'em No Limit ($0.05/$0.10 USD) - 2021/01/23 19:58:55 ET
Table 'Transvaalia' 6-max Seat #2 is the button
Seat 2: everbodylovebdy ($15.42 in chips) 
Seat 3: romanskiy1 ($12.28 in chips) 
Seat 4: alexos04 ($13.80 in chips) 
Seat 5: OllieMac86 ($14.54 in chips) 
romanskiy1: posts small blind $0.05
alexos04: posts big blind $0.10
*** HOLE CARDS ***
OllieMac86: raises $0.20 to $0.30
everbodylovebdy: folds 
romanskiy1: raises $0.70 to $1
alexos04: folds 
OllieMac86: folds 
Uncalled bet ($0.70) returned to romanskiy1
romanskiy1 collected $0.70 from pot
romanskiy1: doesn't show hand 
*** SUMMARY ***
Total pot $0.70 | Rake $0 
Seat 2: everbodylovebdy (button) folded before Flop (didn't bet)
Seat 3: romanskiy1 (small blind) collected ($0.70)
Seat 4: alexos04 (big blind) folded before Flop
Seat 5: OllieMac86 folded before Flop



PokerStars Hand #222980753306:  Hold'em No Limit ($0.05/$0.10 USD) - 2021/01/23 19:59:10 ET
Table 'Transvaalia' 6-max Seat #3 is the button
Seat 2: everbodylovebdy ($15.42 in chips) 
Seat 3: romanskiy1 ($12.68 in chips) 
Seat 4: alexos04 ($13.70 in chips) 
Seat 5: OllieMac86 ($14.24 in chips) 
alexos04: posts small blind $0.05
OllieMac86: posts big blind $0.10
*** HOLE CARDS ***
everbodylovebdy: folds 
romanskiy1: raises $0.20 to $0.30
alexos04: folds 
OllieMac86: calls $0.20
*** FLOP *** [4s Td 9h]
OllieMac86: checks 
romanskiy1: bets $0.41
OllieMac86: calls $0.41
*** TURN *** [4s Td 9h] [3d]
OllieMac86: checks 
romanskiy1: bets $0.93
OllieMac86: folds 
Uncalled bet ($0.93) returned to romanskiy1
romanskiy1 collected $1.40 from pot
romanskiy1: doesn't show hand 
*** SUMMARY ***
Total pot $1.47 | Rake $0.07 
Board [4s Td 9h 3d]
Seat 2: everbodylovebdy folded before Flop (didn't bet)
Seat 3: romanskiy1 (button) collected ($1.40)
Seat 4: alexos04 (small blind) folded before Flop
Seat 5: OllieMac86 (big blind) folded on the Turn



PokerStars Hand #222980770654:  Hold'em No Limit ($0.05/$0.10 USD) - 2021/01/23 19:59:57 ET
Table 'Transvaalia' 6-max Seat #4 is the button
Seat 2: everbodylovebdy ($15.42 in chips) 
Seat 3: romanskiy1 ($13.37 in chips) 
Seat 4: alexos04 ($13.65 in chips) 
Seat 5: OllieMac86 ($13.53 in chips) 
OllieMac86: posts small blind $0.05
everbodylovebdy: posts big blind $0.10
*** HOLE CARDS ***
romanskiy1: folds 
alexos04: folds 
OllieMac86: folds 
Uncalled bet ($0.05) returned to everbodylovebdy
everbodylovebdy collected $0.10 from pot
everbodylovebdy: doesn't show hand 
*** SUMMARY ***
Total pot $0.10 | Rake $0 
Seat 2: everbodylovebdy (big blind) collected ($0.10)
Seat 3: romanskiy1 folded before Flop (didn't bet)
Seat 4: alexos04 (button) folded before Flop (didn't bet)
Seat 5: OllieMac86 (small blind) folded before Flop



PokerStars Hand #222980773279:  Hold'em No Limit ($0.05/$0.10 USD) - 2021/01/23 20:00:03 ET
Table 'Transvaalia' 6-max Seat #5 is the button
Seat 2: everbodylovebdy ($15.47 in chips) 
Seat 3: romanskiy1 ($13.37 in chips) 
Seat 4: alexos04 ($13.65 in chips) 
Seat 5: OllieMac86 ($13.48 in chips) 
everbodylovebdy: posts small blind $0.05
romanskiy1: posts big blind $0.10
*** HOLE CARDS ***
alexos04: folds 
OllieMac86: folds 
everbodylovebdy: calls $0.05
romanskiy1: checks 
*** FLOP *** [9d As Kc]
everbodylovebdy: checks 
romanskiy1: bets $0.19
everbodylovebdy: calls $0.19
*** TURN *** [9d As Kc] [Ks]
everbodylovebdy: checks 
romanskiy1: checks 
*** RIVER *** [9d As Kc Ks] [7h]
everbodylovebdy: checks 
romanskiy1: bets $0.37
everbodylovebdy: calls $0.37
*** SHOW DOWN ***
romanskiy1: shows [2c Ah] (two pair, Aces and Kings)
everbodylovebdy: mucks hand 
romanskiy1 collected $1.26 from pot
*** SUMMARY ***
Total pot $1.32 | Rake $0.06 
Board [9d As Kc Ks 7h]
Seat 2: everbodylovebdy (small blind) mucked
Seat 3: romanskiy1 (big blind) showed [2c Ah] and won ($1.26) with two pair, Aces and Kings
Seat 4: alexos04 folded before Flop (didn't bet)
Seat 5: OllieMac86 (button) folded before Flop (didn't bet)



PokerStars Hand #222980792719:  Hold'em No Limit ($0.05/$0.10 USD) - 2021/01/23 20:00:51 ET
Table 'Transvaalia' 6-max Seat #2 is the button
Seat 2: everbodylovebdy ($14.81 in chips) 
Seat 3: romanskiy1 ($13.97 in chips) 
Seat 4: alexos04 ($13.65 in chips) 
Seat 5: OllieMac86 ($13.48 in chips) 
romanskiy1: posts small blind $0.05
alexos04: posts big blind $0.10
*** HOLE CARDS ***
OllieMac86: raises $0.20 to $0.30
everbodylovebdy: calls $0.30
romanskiy1: folds 
alexos04: folds 
*** FLOP *** [Jc 7c Jd]
OllieMac86: checks 
everbodylovebdy: bets $0.30
OllieMac86: calls $0.30
*** TURN *** [Jc 7c Jd] [6h]
OllieMac86: bets $0.88
everbodylovebdy: folds 
Uncalled bet ($0.88) returned to OllieMac86
OllieMac86 collected $1.29 from pot
OllieMac86: doesn't show hand 
*** SUMMARY ***
Total pot $1.35 | Rake $0.06 
Board [Jc 7c Jd 6h]
Seat 2: everbodylovebdy (button) folded on the Turn
Seat 3: romanskiy1 (small blind) folded before Flop
Seat 4: alexos04 (big blind) folded before Flop
Seat 5: OllieMac86 collected ($1.29)



PokerStars Hand #222980806369:  Hold'em No Limit ($0.05/$0.10 USD) - 2021/01/23 20:01:23 ET
Table 'Transvaalia' 6-max Seat #3 is the button
Seat 2: everbodylovebdy ($14.21 in chips) 
Seat 3: romanskiy1 ($13.92 in chips) 
Seat 4: alexos04 ($13.55 in chips) 
Seat 5: OllieMac86 ($14.17 in chips) 
alexos04: posts small blind $0.05
OllieMac86: posts big blind $0.10
*** HOLE CARDS ***
everbodylovebdy: folds 
romanskiy1: folds 
alexos04: folds 
Uncalled bet ($0.05) returned to OllieMac86
OllieMac86 collected $0.10 from pot
OllieMac86: doesn't show hand 
*** SUMMARY ***
Total pot $0.10 | Rake $0 
Seat 2: everbodylovebdy folded before Flop (didn't bet)
Seat 3: romanskiy1 (button) folded before Flop (didn't bet)
Seat 4: alexos04 (small blind) folded before Flop
Seat 5: OllieMac86 (big blind) collected ($0.10)



PokerStars Hand #222980811790:  Hold'em No Limit ($0.05/$0.10 USD) - 2021/01/23 20:01:35 ET
Table 'Transvaalia' 6-max Seat #4 is the button
Seat 2: everbodylovebdy ($14.21 in chips) 
Seat 3: romanskiy1 ($13.92 in chips) 
Seat 4: alexos04 ($13.50 in chips) 
Seat 5: OllieMac86 ($14.22 in chips) 
OllieMac86: posts small blind $0.05
everbodylovebdy: posts big blind $0.10
*** HOLE CARDS ***
romanskiy1: raises $0.20 to $0.30
alexos04: raises $0.60 to $0.90
OllieMac86: folds 
everbodylovebdy: folds 
romanskiy1: folds 
Uncalled bet ($0.60) returned to alexos04
alexos04 collected $0.75 from pot
alexos04: doesn't show hand 
*** SUMMARY ***
Total pot $0.75 | Rake $0 
Seat 2: everbodylovebdy (big blind) folded before Flop
Seat 3: romanskiy1 folded before Flop
Seat 4: alexos04 (button) collected ($0.75)
Seat 5: OllieMac86 (small blind) folded before Flop



PokerStars Hand #222980817270:  Hold'em No Limit ($0.05/$0.10 USD) - 2021/01/23 20:01:47 ET
Table 'Transvaalia' 6-max Seat #5 is the button
Seat 2: everbodylovebdy ($14.11 in chips) 
Seat 3: romanskiy1 ($13.62 in chips) 
Seat 4: alexos04 ($13.95 in chips) 
Seat 5: OllieMac86 ($14.17 in chips) 
everbodylovebdy: posts small blind $0.05
romanskiy1: posts big blind $0.10
*** HOLE CARDS ***
alexos04: folds 
OllieMac86: raises $0.20 to $0.30
everbodylovebdy: folds 
romanskiy1: folds 
Uncalled bet ($0.20) returned to OllieMac86
OllieMac86 collected $0.25 from pot
OllieMac86: doesn't show hand 
*** SUMMARY ***
Total pot $0.25 | Rake $0 
Seat 2: everbodylovebdy (small blind) folded before Flop
Seat 3: romanskiy1 (big blind) folded before Flop
Seat 4: alexos04 folded before Flop (didn't bet)
Seat 5: OllieMac86 (button) collected ($0.25)



PokerStars Hand #222980822910:  Hold'em No Limit ($0.05/$0.10 USD) - 2021/01/23 20:02:00 ET
Table 'Transvaalia' 6-max Seat #2 is the button
Seat 2: everbodylovebdy ($14.06 in chips) 
Seat 3: romanskiy1 ($13.52 in chips) 
Seat 4: alexos04 ($13.95 in chips) 
Seat 5: OllieMac86 ($14.32 in chips) 
romanskiy1: posts small blind $0.05
alexos04: posts big blind $0.10
*** HOLE CARDS ***
OllieMac86: folds 
everbodylovebdy: folds 
romanskiy1: raises $0.20 to $0.30
alexos04: raises $0.60 to $0.90
romanskiy1: folds 
Uncalled bet ($0.60) returned to alexos04
alexos04 collected $0.60 from pot
alexos04: doesn't show hand 
*** SUMMARY ***
Total pot $0.60 | Rake $0 
Seat 2: everbodylovebdy (button) folded before Flop (didn't bet)
Seat 3: romanskiy1 (small blind) folded before Flop
Seat 4: alexos04 (big blind) collected ($0.60)
Seat 5: OllieMac86 folded before Flop (didn't bet)



PokerStars Hand #222980942221:  Hold'em No Limit ($0.05/$0.10 USD) - 2021/01/23 20:05:58 ET
Table 'Transvaalia' 6-max Seat #2 is the button
Seat 2: everbodylovebdy ($13.88 in chips) 
Seat 3: romanskiy1 ($13.53 in chips) 
Seat 4: alexos04 ($10.54 in chips) 
Seat 5: OllieMac86 ($17.48 in chips) 
romanskiy1: posts small blind $0.05
alexos04: posts big blind $0.10
*** HOLE CARDS ***
OllieMac86: folds 
everbodylovebdy: folds 
romanskiy1: raises $0.20 to $0.30
alexos04: folds 
Uncalled bet ($0.20) returned to romanskiy1
romanskiy1 collected $0.20 from pot
romanskiy1: doesn't show hand 
*** SUMMARY ***
Total pot $0.20 | Rake $0 
Seat 2: everbodylovebdy (button) folded before Flop (didn't bet)
Seat 3: romanskiy1 (small blind) collected ($0.20)
Seat 4: alexos04 (big blind) folded before Flop
Seat 5: OllieMac86 folded before Flop (didn't bet)



PokerStars Hand #222980947267:  Hold'em No Limit ($0.05/$0.10 USD) - 2021/01/23 20:06:09 ET
Table 'Transvaalia' 6-max Seat #3 is the button
Seat 2: everbodylovebdy ($13.88 in chips) 
Seat 3: romanskiy1 ($13.63 in chips) 
Seat 4: alexos04 ($10.44 in chips) 
Seat 5: OllieMac86 ($17.48 in chips) 
alexos04: posts small blind $0.05
OllieMac86: posts big blind $0.10
*** HOLE CARDS ***
everbodylovebdy: folds 
romanskiy1: raises $0.20 to $0.30
alexos04: folds 
OllieMac86: folds 
Uncalled bet ($0.20) returned to romanskiy1
romanskiy1 collected $0.25 from pot
romanskiy1: doesn't show hand 
*** SUMMARY ***
Total pot $0.25 | Rake $0 
Seat 2: everbodylovebdy folded before Flop (didn't bet)
Seat 3: romanskiy1 (button) collected ($0.25)
Seat 4: alexos04 (small blind) folded before Flop
Seat 5: OllieMac86 (big blind) folded before Flop



PokerStars Hand #222980954625:  Hold'em No Limit ($0.05/$0.10 USD) - 2021/01/23 20:06:25 ET
Table 'Transvaalia' 6-max Seat #4 is the button
Seat 2: everbodylovebdy ($13.88 in chips) 
Seat 3: romanskiy1 ($13.78 in chips) 
Seat 4: alexos04 ($10.39 in chips) 
Seat 5: OllieMac86 ($17.38 in chips) 
OllieMac86: posts small blind $0.05
everbodylovebdy: posts big blind $0.10
*** HOLE CARDS ***
romanskiy1: raises $0.20 to $0.30
alexos04: folds 
OllieMac86: folds 
Smeweo joins the table at seat #6 
everbodylovebdy: calls $0.20
*** FLOP *** [Jc 5s 8h]
everbodylovebdy: bets $0.31
romanskiy1: calls $0.31
*** TURN *** [Jc 5s 8h] [2h]
everbodylovebdy: bets $0.60
romanskiy1: calls $0.60
*** RIVER *** [Jc 5s 8h 2h] [5h]
everbodylovebdy: bets $2.36
romanskiy1: calls $2.36
*** SHOW DOWN ***
everbodylovebdy: shows [Ah 8c] (two pair, Eights and Fives)
romanskiy1: shows [Th Jh] (a flush, Jack high)
romanskiy1 collected $6.87 from pot
*** SUMMARY ***
Total pot $7.19 | Rake $0.32 
Board [Jc 5s 8h 2h 5h]
Seat 2: everbodylovebdy (big blind) showed [Ah 8c] and lost with two pair, Eights and Fives
Seat 3: romanskiy1 showed [Th Jh] and won ($6.87) with a flush, Jack high
Seat 4: alexos04 (button) folded before Flop (didn't bet)
Seat 5: OllieMac86 (small blind) folded before Flop



PokerStars Hand #222980971846:  Hold'em No Limit ($0.05/$0.10 USD) - 2021/01/23 20:07:02 ET
Table 'Transvaalia' 6-max Seat #5 is the button
Seat 2: everbodylovebdy ($10.31 in chips) 
Seat 3: romanskiy1 ($17.08 in chips) 
Seat 4: alexos04 ($10.39 in chips) 
Seat 5: OllieMac86 ($17.33 in chips) 
everbodylovebdy: posts small blind $0.05
romanskiy1: posts big blind $0.10
*** HOLE CARDS ***
alexos04: folds 
Elviskochito joins the table at seat #1 
OllieMac86: raises $0.20 to $0.30
everbodylovebdy: folds 
romanskiy1: folds 
Uncalled bet ($0.20) returned to OllieMac86
OllieMac86 collected $0.25 from pot
OllieMac86: doesn't show hand 
*** SUMMARY ***
Total pot $0.25 | Rake $0 
Seat 2: everbodylovebdy (small blind) folded before Flop
Seat 3: romanskiy1 (big blind) folded before Flop
Seat 4: alexos04 folded before Flop (didn't bet)
Seat 5: OllieMac86 (button) collected ($0.25)



PokerStars Hand #222980977218:  Hold'em No Limit ($0.05/$0.10 USD) - 2021/01/23 20:07:13 ET
Table 'Transvaalia' 6-max Seat #2 is the button
Seat 2: everbodylovebdy ($10.26 in chips) 
Seat 3: romanskiy1 ($16.98 in chips) 
Seat 4: alexos04 ($10.39 in chips) 
Seat 5: OllieMac86 ($17.48 in chips) 
romanskiy1: posts small blind $0.05
alexos04: posts big blind $0.10
Smeweo: sits out 
Elviskochito: sits out 
*** HOLE CARDS ***
OllieMac86: folds 
everbodylovebdy: folds 
romanskiy1: folds 
Uncalled bet ($0.05) returned to alexos04
alexos04 collected $0.10 from pot
alexos04: doesn't show hand 
*** SUMMARY ***
Total pot $0.10 | Rake $0 
Seat 2: everbodylovebdy (button) folded before Flop (didn't bet)
Seat 3: romanskiy1 (small blind) folded before Flop
Seat 4: alexos04 (big blind) collected ($0.10)
Seat 5: OllieMac86 folded before Flop (didn't bet)



PokerStars Hand #222980981834:  Hold'em No Limit ($0.05/$0.10 USD) - 2021/01/23 20:07:23 ET
Table 'Transvaalia' 6-max Seat #3 is the button
Seat 2: everbodylovebdy ($10.26 in chips) 
Seat 3: romanskiy1 ($16.93 in chips) 
Seat 4: alexos04 ($10.44 in chips) 
Seat 5: OllieMac86 ($17.48 in chips) 
alexos04: posts small blind $0.05
OllieMac86: posts big blind $0.10
Smeweo: sits out 
Elviskochito: sits out 
*** HOLE CARDS ***
everbodylovebdy: calls $0.10
romanskiy1: folds 
alexos04: folds 
OllieMac86: checks 
*** FLOP *** [Js Jd Kd]
OllieMac86: checks 
everbodylovebdy: checks 
*** TURN *** [Js Jd Kd] [Kh]
Smeweo leaves the table
OllieMac86: checks 
everbodylovebdy: bets $0.22
OllieMac86: folds 
Uncalled bet ($0.22) returned to everbodylovebdy
everbodylovebdy collected $0.24 from pot
everbodylovebdy: doesn't show hand 
*** SUMMARY ***
Total pot $0.25 | Rake $0.01 
Board [Js Jd Kd Kh]
Seat 2: everbodylovebdy collected ($0.24)
Seat 3: romanskiy1 (button) folded before Flop (didn't bet)
Seat 4: alexos04 (small blind) folded before Flop
Seat 5: OllieMac86 (big blind) folded on the Turn



PokerStars Hand #222980996718:  Hold'em No Limit ($0.05/$0.10 USD) - 2021/01/23 20:07:56 ET
Table 'Transvaalia' 6-max Seat #4 is the button
Seat 1: Elviskochito ($10 in chips) 
Seat 2: everbodylovebdy ($10.40 in chips) 
Seat 3: romanskiy1 ($16.93 in chips) 
Seat 4: alexos04 ($10.39 in chips) 
Seat 5: OllieMac86 ($17.38 in chips) 
OllieMac86: posts small blind $0.05
Elviskochito: posts big blind $0.10
*** HOLE CARDS ***
everbodylovebdy: folds 
romanskiy1: folds 
alexos04: raises $0.20 to $0.30
OllieMac86: folds 
Elviskochito: folds 
Uncalled bet ($0.20) returned to alexos04
alexos04 collected $0.25 from pot
alexos04: doesn't show hand 
*** SUMMARY ***
Total pot $0.25 | Rake $0 
Seat 1: Elviskochito (big blind) folded before Flop
Seat 2: everbodylovebdy folded before Flop (didn't bet)
Seat 3: romanskiy1 folded before Flop (didn't bet)
Seat 4: alexos04 (button) collected ($0.25)
Seat 5: OllieMac86 (small blind) folded before Flop



PokerStars Hand #222981005987:  Hold'em No Limit ($0.05/$0.10 USD) - 2021/01/23 20:08:16 ET
Table 'Transvaalia' 6-max Seat #5 is the button
Seat 1: Elviskochito ($10 in chips) 
Seat 2: everbodylovebdy ($10.40 in chips) 
Seat 3: romanskiy1 ($16.93 in chips) 
Seat 4: alexos04 ($10.54 in chips) 
Seat 5: OllieMac86 ($17.33 in chips) 
Elviskochito: posts small blind $0.05
everbodylovebdy: posts big blind $0.10
*** HOLE CARDS ***
romanskiy1: folds 
alexos04: folds 
OllieMac86: folds 
Elviskochito: raises $0.20 to $0.30
everbodylovebdy: folds 
Uncalled bet ($0.20) returned to Elviskochito
Elviskochito collected $0.20 from pot
*** SUMMARY ***
Total pot $0.20 | Rake $0 
Seat 1: Elviskochito (small blind) collected ($0.20)
Seat 2: everbodylovebdy (big blind) folded before Flop
Seat 3: romanskiy1 folded before Flop (didn't bet)
Seat 4: alexos04 folded before Flop (didn't bet)
Seat 5: OllieMac86 (button) folded before Flop (didn't bet)



PokerStars Hand #222981010600:  Hold'em No Limit ($0.05/$0.10 USD) - 2021/01/23 20:08:26 ET
Table 'Transvaalia' 6-max Seat #1 is the button
Seat 1: Elviskochito ($10.10 in chips) 
Seat 2: everbodylovebdy ($10.30 in chips) 
Seat 3: romanskiy1 ($16.93 in chips) 
Seat 4: alexos04 ($10.54 in chips) 
Seat 5: OllieMac86 ($17.33 in chips) 
everbodylovebdy: posts small blind $0.05
romanskiy1: posts big blind $0.10
*** HOLE CARDS ***
alexos04: folds 
OllieMac86: raises $0.20 to $0.30
Elviskochito: folds 
everbodylovebdy: calls $0.25
romanskiy1: folds 
*** FLOP *** [9d Th 4s]
everbodylovebdy: bets $0.10
OllieMac86: raises $0.20 to $0.30
everbodylovebdy: calls $0.20
*** TURN *** [9d Th 4s] [7h]
everbodylovebdy: bets $0.62
OllieMac86: raises $0.98 to $1.60
everbodylovebdy: calls $0.98
*** RIVER *** [9d Th 4s 7h] [Qh]
everbodylovebdy: checks 
OllieMac86: checks 
*** SHOW DOWN ***
everbodylovebdy: shows [Td Kc] (a pair of Tens)
OllieMac86: shows [7c Tc] (two pair, Tens and Sevens)
OllieMac86 collected $4.30 from pot
*** SUMMARY ***
Total pot $4.50 | Rake $0.20 
Board [9d Th 4s 7h Qh]
Seat 1: Elviskochito (button) folded before Flop (didn't bet)
Seat 2: everbodylovebdy (small blind) showed [Td Kc] and lost with a pair of Tens
Seat 3: romanskiy1 (big blind) folded before Flop
Seat 4: alexos04 folded before Flop (didn't bet)
Seat 5: OllieMac86 showed [7c Tc] and won ($4.30) with two pair, Tens and Sevens



PokerStars Hand #222981058053:  Hold'em No Limit ($0.05/$0.10 USD) - 2021/01/23 20:09:50 ET
Table 'Transvaalia' 6-max Seat #2 is the button
Seat 1: Elviskochito ($10.10 in chips) 
Seat 2: everbodylovebdy ($8.10 in chips) 
Seat 3: romanskiy1 ($16.83 in chips) 
Seat 5: OllieMac86 ($19.43 in chips) 
romanskiy1: posts small blind $0.05
alexos04: is sitting out 
OllieMac86: posts big blind $0.10
*** HOLE CARDS ***
Elviskochito: folds 
alexos04 leaves the table
everbodylovebdy: calls $0.10
romanskiy1: folds 
OllieMac86: checks 
*** FLOP *** [Qc 2c Ks]
OllieMac86: checks 
everbodylovebdy: checks 
*** TURN *** [Qc 2c Ks] [Ah]
OllieMac86: checks 
Mcdog43 joins the table at seat #4 
everbodylovebdy: bets $0.20
OllieMac86: folds 
Uncalled bet ($0.20) returned to everbodylovebdy
everbodylovebdy collected $0.24 from pot
everbodylovebdy: doesn't show hand 
*** SUMMARY ***
Total pot $0.25 | Rake $0.01 
Board [Qc 2c Ks Ah]
Seat 1: Elviskochito folded before Flop (didn't bet)
Seat 2: everbodylovebdy (button) collected ($0.24)
Seat 3: romanskiy1 (small blind) folded before Flop
Seat 5: OllieMac86 (big blind) folded on the Turn



PokerStars Hand #222981072541:  Hold'em No Limit ($0.05/$0.10 USD) - 2021/01/23 20:10:21 ET
Table 'Transvaalia' 6-max Seat #3 is the button
Seat 1: Elviskochito ($10.10 in chips) 
Seat 2: everbodylovebdy ($8.24 in chips) 
Seat 3: romanskiy1 ($16.78 in chips) 
Seat 5: OllieMac86 ($19.33 in chips) 
OllieMac86: posts small blind $0.05
Elviskochito: posts big blind $0.10
*** HOLE CARDS ***
WoodyCanBluff joins the table at seat #6 
everbodylovebdy: raises $0.10 to $0.20
romanskiy1: folds 
OllieMac86: folds 
Elviskochito: folds 
Uncalled bet ($0.10) returned to everbodylovebdy
everbodylovebdy collected $0.25 from pot
everbodylovebdy: doesn't show hand 
*** SUMMARY ***
Total pot $0.25 | Rake $0 
Seat 1: Elviskochito (big blind) folded before Flop
Seat 2: everbodylovebdy collected ($0.25)
Seat 3: romanskiy1 (button) folded before Flop (didn't bet)
Seat 5: OllieMac86 (small blind) folded before Flop



PokerStars Hand #222981076499:  Hold'em No Limit ($0.05/$0.10 USD) - 2021/01/23 20:10:30 ET
Table 'Transvaalia' 6-max Seat #5 is the button
Seat 1: Elviskochito ($10 in chips) 
Seat 2: everbodylovebdy ($8.39 in chips) 
Seat 3: romanskiy1 ($16.78 in chips) 
Seat 5: OllieMac86 ($19.28 in chips) 
Elviskochito: posts small blind $0.05
everbodylovebdy: posts big blind $0.10
Mcdog43: sits out 
*** HOLE CARDS ***
romanskiy1: raises $0.20 to $0.30
OllieMac86: folds 
Elviskochito: folds 
everbodylovebdy: calls $0.20
*** FLOP *** [9s Th 8s]
everbodylovebdy: checks 
romanskiy1: bets $0.41
everbodylovebdy: calls $0.41
*** TURN *** [9s Th 8s] [4d]
everbodylovebdy: checks 
romanskiy1: checks 
*** RIVER *** [9s Th 8s 4d] [4h]
everbodylovebdy: checks 
romanskiy1: checks 
*** SHOW DOWN ***
everbodylovebdy: shows [Ad 5s] (a pair of Fours)
romanskiy1: shows [Ac 7c] (a pair of Fours)
everbodylovebdy collected $0.70 from pot
romanskiy1 collected $0.70 from pot
*** SUMMARY ***
Total pot $1.47 | Rake $0.07 
Board [9s Th 8s 4d 4h]
Seat 1: Elviskochito (small blind) folded before Flop
Seat 2: everbodylovebdy (big blind) showed [Ad 5s] and won ($0.70) with a pair of Fours
Seat 3: romanskiy1 showed [Ac 7c] and won ($0.70) with a pair of Fours
Seat 5: OllieMac86 (button) folded before Flop (didn't bet)



PokerStars Hand #222981095985:  Hold'em No Limit ($0.05/$0.10 USD) - 2021/01/23 20:11:13 ET
Table 'Transvaalia' 6-max Seat #1 is the button
Seat 1: Elviskochito ($10 in chips) 
Seat 2: everbodylovebdy ($8.38 in chips) 
Seat 3: romanskiy1 ($16.77 in chips) 
Seat 5: OllieMac86 ($19.28 in chips) 
Seat 6: WoodyCanBluff ($5 in chips) 
everbodylovebdy: posts small blind $0.05
romanskiy1: posts big blind $0.10
Mcdog43: sits out 
WoodyCanBluff: posts big blind $0.10
*** HOLE CARDS ***
OllieMac86: raises $0.30 to $0.40
WoodyCanBluff: calls $0.30
Elviskochito: folds 
everbodylovebdy: folds 
romanskiy1: folds 
*** FLOP *** [5d Ac 5s]
OllieMac86: bets $0.62
WoodyCanBluff: folds 
Uncalled bet ($0.62) returned to OllieMac86
OllieMac86 collected $0.91 from pot
OllieMac86: doesn't show hand 
*** SUMMARY ***
Total pot $0.95 | Rake $0.04 
Board [5d Ac 5s]
Seat 1: Elviskochito (button) folded before Flop (didn't bet)
Seat 2: everbodylovebdy (small blind) folded before Flop
Seat 3: romanskiy1 (big blind) folded before Flop
Seat 5: OllieMac86 collected ($0.91)
Seat 6: WoodyCanBluff folded on the Flop



PokerStars Hand #222981105660:  Hold'em No Limit ($0.05/$0.10 USD) - 2021/01/23 20:11:35 ET
Table 'Transvaalia' 6-max Seat #2 is the button
Seat 1: Elviskochito ($10 in chips) 
Seat 2: everbodylovebdy ($8.33 in chips) 
Seat 3: romanskiy1 ($16.67 in chips) 
Seat 4: Mcdog43 ($10 in chips) 
Seat 5: OllieMac86 ($19.79 in chips) 
Seat 6: WoodyCanBluff ($4.60 in chips) 
romanskiy1: posts small blind $0.05
Mcdog43: posts big blind $0.10
*** HOLE CARDS ***
OllieMac86: folds 
WoodyCanBluff: folds 
Elviskochito: raises $0.20 to $0.30
everbodylovebdy: folds 
romanskiy1: raises $0.70 to $1
Mcdog43: folds 
Elviskochito: calls $0.70
*** FLOP *** [Ks Kd 7h]
romanskiy1: checks 
Elviskochito: bets $0.80
romanskiy1: folds 
Uncalled bet ($0.80) returned to Elviskochito
Elviskochito collected $2.01 from pot
*** SUMMARY ***
Total pot $2.10 | Rake $0.09 
Board [Ks Kd 7h]
Seat 1: Elviskochito collected ($2.01)
Seat 2: everbodylovebdy (button) folded before Flop (didn't bet)
Seat 3: romanskiy1 (small blind) folded on the Flop
Seat 4: Mcdog43 (big blind) folded before Flop
Seat 5: OllieMac86 folded before Flop (didn't bet)
Seat 6: WoodyCanBluff folded before Flop (didn't bet)



PokerStars Hand #222981120339:  Hold'em No Limit ($0.05/$0.10 USD) - 2021/01/23 20:12:07 ET
Table 'Transvaalia' 6-max Seat #3 is the button
Seat 1: Elviskochito ($11.01 in chips) 
Seat 2: everbodylovebdy ($8.33 in chips) 
Seat 3: romanskiy1 ($15.67 in chips) 
Seat 4: Mcdog43 ($9.90 in chips) 
Seat 5: OllieMac86 ($19.79 in chips) 
Seat 6: WoodyCanBluff ($4.60 in chips) 
Mcdog43: posts small blind $0.05
OllieMac86: posts big blind $0.10
*** HOLE CARDS ***
WoodyCanBluff: raises $0.20 to $0.30
Elviskochito: folds 
everbodylovebdy: folds 
romanskiy1: raises $0.60 to $0.90
Mcdog43: folds 
OllieMac86: folds 
WoodyCanBluff: calls $0.60
*** FLOP *** [2s Js 4d]
WoodyCanBluff: bets $1.20
romanskiy1: calls $1.20
*** TURN *** [2s Js 4d] [Th]
WoodyCanBluff: bets $2.50 and is all-in
romanskiy1: folds 
Uncalled bet ($2.50) returned to WoodyCanBluff
WoodyCanBluff collected $4.15 from pot
WoodyCanBluff: doesn't show hand 
*** SUMMARY ***
Total pot $4.35 | Rake $0.20 
Board [2s Js 4d Th]
Seat 1: Elviskochito folded before Flop (didn't bet)
Seat 2: everbodylovebdy folded before Flop (didn't bet)
Seat 3: romanskiy1 (button) folded on the Turn
Seat 4: Mcdog43 (small blind) folded before Flop
Seat 5: OllieMac86 (big blind) folded before Flop
Seat 6: WoodyCanBluff collected ($4.15)



PokerStars Hand #222981149647:  Hold'em No Limit ($0.05/$0.10 USD) - 2021/01/23 20:13:13 ET
Table 'Transvaalia' 6-max Seat #4 is the button
Seat 1: Elviskochito ($11.01 in chips) 
Seat 2: everbodylovebdy ($8.33 in chips) 
Seat 3: romanskiy1 ($13.57 in chips) 
Seat 4: Mcdog43 ($9.85 in chips) 
Seat 5: OllieMac86 ($19.69 in chips) 
Seat 6: WoodyCanBluff ($6.65 in chips) 
OllieMac86: posts small blind $0.05
WoodyCanBluff: posts big blind $0.10
*** HOLE CARDS ***
Elviskochito: folds 
everbodylovebdy: raises $0.10 to $0.20
romanskiy1: folds 
Mcdog43: folds 
OllieMac86: folds 
WoodyCanBluff: calls $0.10
*** FLOP *** [Kc Ah 3s]
WoodyCanBluff: checks 
everbodylovebdy: bets $0.10
WoodyCanBluff: folds 
Uncalled bet ($0.10) returned to everbodylovebdy
everbodylovebdy collected $0.43 from pot
everbodylovebdy: doesn't show hand 
*** SUMMARY ***
Total pot $0.45 | Rake $0.02 
Board [Kc Ah 3s]
Seat 1: Elviskochito folded before Flop (didn't bet)
Seat 2: everbodylovebdy collected ($0.43)
Seat 3: romanskiy1 folded before Flop (didn't bet)
Seat 4: Mcdog43 (button) folded before Flop (didn't bet)
Seat 5: OllieMac86 (small blind) folded before Flop
Seat 6: WoodyCanBluff (big blind) folded on the Flop



PokerStars Hand #222981158874:  Hold'em No Limit ($0.05/$0.10 USD) - 2021/01/23 20:13:33 ET
Table 'Transvaalia' 6-max Seat #5 is the button
Seat 1: Elviskochito ($11.01 in chips) 
Seat 2: everbodylovebdy ($8.56 in chips) 
Seat 3: romanskiy1 ($13.57 in chips) 
Seat 4: Mcdog43 ($9.85 in chips) 
Seat 5: OllieMac86 ($19.64 in chips) 
Seat 6: WoodyCanBluff ($6.45 in chips) 
WoodyCanBluff: posts small blind $0.05
Elviskochito: posts big blind $0.10
*** HOLE CARDS ***
everbodylovebdy: folds 
romanskiy1: raises $0.20 to $0.30
Mcdog43: folds 
OllieMac86: folds 
WoodyCanBluff: folds 
Elviskochito: raises $0.70 to $1
romanskiy1: calls $0.70
*** FLOP *** [5s Ts 3s]
Elviskochito: bets $0.78
romanskiy1: calls $0.78
*** TURN *** [5s Ts 3s] [Qd]
Elviskochito: checks 
romanskiy1: bets $1.73
Elviskochito: calls $1.73
*** RIVER *** [5s Ts 3s Qd] [6h]
Elviskochito: checks 
romanskiy1: bets $4.50
Elviskochito: folds 
Uncalled bet ($4.50) returned to romanskiy1
romanskiy1 collected $6.75 from pot
romanskiy1: doesn't show hand 
*** SUMMARY ***
Total pot $7.07 | Rake $0.32 
Board [5s Ts 3s Qd 6h]
Seat 1: Elviskochito (big blind) folded on the River
Seat 2: everbodylovebdy folded before Flop (didn't bet)
Seat 3: romanskiy1 collected ($6.75)
Seat 4: Mcdog43 folded before Flop (didn't bet)
Seat 5: OllieMac86 (button) folded before Flop (didn't bet)
Seat 6: WoodyCanBluff (small blind) folded before Flop



PokerStars Hand #222981183645:  Hold'em No Limit ($0.05/$0.10 USD) - 2021/01/23 20:14:29 ET
Table 'Transvaalia' 6-max Seat #6 is the button
Seat 1: Elviskochito ($10 in chips) 
Seat 2: everbodylovebdy ($8.56 in chips) 
Seat 3: romanskiy1 ($16.81 in chips) 
Seat 4: Mcdog43 ($9.85 in chips) 
Seat 5: OllieMac86 ($19.64 in chips) 
Seat 6: WoodyCanBluff ($6.40 in chips) 
Elviskochito: posts small blind $0.05
everbodylovebdy: posts big blind $0.10
*** HOLE CARDS ***
romanskiy1: folds 
Mcdog43: folds 
OllieMac86: folds 
WoodyCanBluff: calls $0.10
Elviskochito: calls $0.05
everbodylovebdy: checks 
*** FLOP *** [Jh 6c 8d]
Elviskochito: checks 
everbodylovebdy: checks 
WoodyCanBluff: bets $0.20
Elviskochito: folds 
everbodylovebdy: calls $0.20
*** TURN *** [Jh 6c 8d] [Qd]
everbodylovebdy: checks 
WoodyCanBluff: checks 
*** RIVER *** [Jh 6c 8d Qd] [9d]
everbodylovebdy: checks 
WoodyCanBluff: checks 
*** SHOW DOWN ***
everbodylovebdy: shows [6h Ks] (a pair of Sixes)
WoodyCanBluff: shows [5h 8c] (a pair of Eights)
WoodyCanBluff collected $0.67 from pot
*** SUMMARY ***
Total pot $0.70 | Rake $0.03 
Board [Jh 6c 8d Qd 9d]
Seat 1: Elviskochito (small blind) folded on the Flop
Seat 2: everbodylovebdy (big blind) showed [6h Ks] and lost with a pair of Sixes
Seat 3: romanskiy1 folded before Flop (didn't bet)
Seat 4: Mcdog43 folded before Flop (didn't bet)
Seat 5: OllieMac86 folded before Flop (didn't bet)
Seat 6: WoodyCanBluff (button) showed [5h 8c] and won ($0.67) with a pair of Eights



PokerStars Hand #222981207734:  Hold'em No Limit ($0.05/$0.10 USD) - 2021/01/23 20:15:22 ET
Table 'Transvaalia' 6-max Seat #1 is the button
Seat 1: Elviskochito ($10 in chips) 
Seat 2: everbodylovebdy ($8.26 in chips) 
Seat 3: romanskiy1 ($16.81 in chips) 
Seat 4: Mcdog43 ($9.85 in chips) 
Seat 5: OllieMac86 ($19.64 in chips) 
Seat 6: WoodyCanBluff ($6.77 in chips) 
everbodylovebdy: posts small blind $0.05
romanskiy1: posts big blind $0.10
*** HOLE CARDS ***
Mcdog43: folds 
OllieMac86: folds 
WoodyCanBluff: calls $0.10
Elviskochito: folds 
everbodylovebdy: calls $0.05
romanskiy1: checks 
*** FLOP *** [4d Ts Kd]
everbodylovebdy: bets $0.10
romanskiy1: folds 
WoodyCanBluff: folds 
Uncalled bet ($0.10) returned to everbodylovebdy
everbodylovebdy collected $0.29 from pot
everbodylovebdy: doesn't show hand 
*** SUMMARY ***
Total pot $0.30 | Rake $0.01 
Board [4d Ts Kd]
Seat 1: Elviskochito (button) folded before Flop (didn't bet)
Seat 2: everbodylovebdy (small blind) collected ($0.29)
Seat 3: romanskiy1 (big blind) folded on the Flop
Seat 4: Mcdog43 folded before Flop (didn't bet)
Seat 5: OllieMac86 folded before Flop (didn't bet)
Seat 6: WoodyCanBluff folded on the Flop



PokerStars Hand #222981220552:  Hold'em No Limit ($0.05/$0.10 USD) - 2021/01/23 20:15:51 ET
Table 'Transvaalia' 6-max Seat #2 is the button
Seat 1: Elviskochito ($10 in chips) 
Seat 2: everbodylovebdy ($8.45 in chips) 
Seat 3: romanskiy1 ($16.71 in chips) 
Seat 4: Mcdog43 ($9.85 in chips) 
Seat 5: OllieMac86 ($19.64 in chips) 
Seat 6: WoodyCanBluff ($6.67 in chips) 
romanskiy1: posts small blind $0.05
Mcdog43: posts big blind $0.10
*** HOLE CARDS ***
OllieMac86: folds 
WoodyCanBluff: folds 
WoodyCanBluff leaves the table
Elviskochito: folds 
everbodylovebdy: calls $0.10
romanskiy1: folds 
Mcdog43: checks 
*** FLOP *** [Jd As 6c]
Mcdog43: checks 
everbodylovebdy: checks 
*** TURN *** [Jd As 6c] [8c]
Mcdog43: bets $0.20
everbodylovebdy: calls $0.20
*** RIVER *** [Jd As 6c 8c] [4h]
Elviskochito leaves the table
Mcdog43: checks 
everbodylovebdy: checks 
*** SHOW DOWN ***
Mcdog43: shows [Ks 2c] (high card Ace)
everbodylovebdy: shows [8h Qh] (a pair of Eights)
everbodylovebdy collected $0.62 from pot
*** SUMMARY ***
Total pot $0.65 | Rake $0.03 
Board [Jd As 6c 8c 4h]
Seat 1: Elviskochito folded before Flop (didn't bet)
Seat 2: everbodylovebdy (button) showed [8h Qh] and won ($0.62) with a pair of Eights
Seat 3: romanskiy1 (small blind) folded before Flop
Seat 4: Mcdog43 (big blind) showed [Ks 2c] and lost with high card Ace
Seat 5: OllieMac86 folded before Flop (didn't bet)
Seat 6: WoodyCanBluff folded before Flop (didn't bet)



PokerStars Hand #222981238215:  Hold'em No Limit ($0.05/$0.10 USD) - 2021/01/23 20:16:31 ET
Table 'Transvaalia' 6-max Seat #3 is the button
Seat 2: everbodylovebdy ($8.77 in chips) 
Seat 3: romanskiy1 ($16.66 in chips) 
Seat 4: Mcdog43 ($9.55 in chips) 
Seat 5: OllieMac86 ($19.64 in chips) 
Mcdog43: posts small blind $0.05
OllieMac86: posts big blind $0.10
*** HOLE CARDS ***
everbodylovebdy has timed out
everbodylovebdy: folds 
romanskiy1: raises $0.20 to $0.30
Mcdog43: folds 
OllieMac86: folds 
Uncalled bet ($0.20) returned to romanskiy1
romanskiy1 collected $0.25 from pot
romanskiy1: doesn't show hand 
*** SUMMARY ***
Total pot $0.25 | Rake $0 
Seat 2: everbodylovebdy folded before Flop (didn't bet)
Seat 3: romanskiy1 (button) collected ($0.25)
Seat 4: Mcdog43 (small blind) folded before Flop
Seat 5: OllieMac86 (big blind) folded before Flop



PokerStars Hand #222981246453:  Hold'em No Limit ($0.05/$0.10 USD) - 2021/01/23 20:16:50 ET
Table 'Transvaalia' 6-max Seat #4 is the button
Seat 3: romanskiy1 ($16.81 in chips) 
Seat 4: Mcdog43 ($9.50 in chips) 
Seat 5: OllieMac86 ($19.54 in chips) 
OllieMac86: posts small blind $0.05
romanskiy1: posts big blind $0.10
*** HOLE CARDS ***
Mcdog43: folds 
OllieMac86: raises $0.20 to $0.30
romanskiy1: calls $0.20
*** FLOP *** [As Kd 7c]
OllieMac86: checks 
romanskiy1: checks 
*** TURN *** [As Kd 7c] [6d]
OllieMac86: bets $0.39
romanskiy1: folds 
Uncalled bet ($0.39) returned to OllieMac86
OllieMac86 collected $0.57 from pot
OllieMac86: doesn't show hand 
*** SUMMARY ***
Total pot $0.60 | Rake $0.03 
Board [As Kd 7c 6d]
Seat 3: romanskiy1 (big blind) folded on the Turn
Seat 4: Mcdog43 (button) folded before Flop (didn't bet)
Seat 5: OllieMac86 (small blind) collected ($0.57)



PokerStars Hand #222981255442:  Hold'em No Limit ($0.05/$0.10 USD) - 2021/01/23 20:17:10 ET
Table 'Transvaalia' 6-max Seat #5 is the button
Seat 3: romanskiy1 ($16.51 in chips) 
Seat 4: Mcdog43 ($9.50 in chips) 
Seat 5: OllieMac86 ($19.81 in chips) 
romanskiy1: posts small blind $0.05
Mcdog43: posts big blind $0.10
*** HOLE CARDS ***
OllieMac86: folds 
romanskiy1: raises $0.20 to $0.30
Mcdog43: raises $0.60 to $0.90
romanskiy1: folds 
Uncalled bet ($0.60) returned to Mcdog43
Mcdog43 collected $0.60 from pot
*** SUMMARY ***
Total pot $0.60 | Rake $0 
Seat 3: romanskiy1 (small blind) folded before Flop
Seat 4: Mcdog43 (big blind) collected ($0.60)
Seat 5: OllieMac86 (button) folded before Flop (didn't bet)



PokerStars Hand #222981264850:  Hold'em No Limit ($0.05/$0.10 USD) - 2021/01/23 20:17:31 ET
Table 'Transvaalia' 6-max Seat #3 is the button
Seat 3: romanskiy1 ($16.21 in chips) 
Seat 4: Mcdog43 ($9.80 in chips) 
Seat 5: OllieMac86 ($19.81 in chips) 
Mcdog43: posts small blind $0.05
OllieMac86: posts big blind $0.10
everbodylovebdy: sits out 
*** HOLE CARDS ***
romanskiy1: folds 
Mcdog43: raises $0.20 to $0.30
OllieMac86: calls $0.20
*** FLOP *** [2s 9s 2h]
Mcdog43: bets $0.25
OllieMac86: calls $0.25
*** TURN *** [2s 9s 2h] [Kh]
Mcdog43: checks 
OllieMac86: bets $0.80
Mcdog43: calls $0.80
*** RIVER *** [2s 9s 2h Kh] [6d]
Mcdog43: checks 
OllieMac86: checks 
*** SHOW DOWN ***
Mcdog43: shows [Js Kd] (two pair, Kings and Deuces)
OllieMac86: mucks hand 
Mcdog43 collected $2.58 from pot
*** SUMMARY ***
Total pot $2.70 | Rake $0.12 
Board [2s 9s 2h Kh 6d]
Seat 3: romanskiy1 (button) folded before Flop (didn't bet)
Seat 4: Mcdog43 (small blind) showed [Js Kd] and won ($2.58) with two pair, Kings and Deuces
Seat 5: OllieMac86 (big blind) mucked



PokerStars Hand #222981277945:  Hold'em No Limit ($0.05/$0.10 USD) - 2021/01/23 20:18:01 ET
Table 'Transvaalia' 6-max Seat #4 is the button
Seat 2: everbodylovebdy ($8.77 in chips) 
Seat 3: romanskiy1 ($16.21 in chips) 
Seat 4: Mcdog43 ($11.03 in chips) 
Seat 5: OllieMac86 ($18.46 in chips) 
OllieMac86: posts small blind $0.05
everbodylovebdy: posts big blind $0.10
*** HOLE CARDS ***
romanskiy1: folds 
Mcdog43: raises $0.10 to $0.20
OllieMac86: folds 
everbodylovebdy: calls $0.10
*** FLOP *** [9d 8d Qd]
everbodylovebdy: checks 
Mcdog43: checks 
*** TURN *** [9d 8d Qd] [2c]
everbodylovebdy: checks 
Mcdog43: bets $0.30
everbodylovebdy: folds 
Uncalled bet ($0.30) returned to Mcdog43
Mcdog43 collected $0.43 from pot
*** SUMMARY ***
Total pot $0.45 | Rake $0.02 
Board [9d 8d Qd 2c]
Seat 2: everbodylovebdy (big blind) folded on the Turn
Seat 3: romanskiy1 folded before Flop (didn't bet)
Seat 4: Mcdog43 (button) collected ($0.43)
Seat 5: OllieMac86 (small blind) folded before Flop



PokerStars Hand #222981294977:  Hold'em No Limit ($0.05/$0.10 USD) - 2021/01/23 20:18:40 ET
Table 'Transvaalia' 6-max Seat #5 is the button
Seat 2: everbodylovebdy ($8.57 in chips) 
Seat 3: romanskiy1 ($16.21 in chips) 
Seat 4: Mcdog43 ($11.26 in chips) 
Seat 5: OllieMac86 ($18.41 in chips) 
everbodylovebdy: posts small blind $0.05
romanskiy1: posts big blind $0.10
*** HOLE CARDS ***
Mcdog43: raises $0.12 to $0.22
OllieMac86: calls $0.22
everbodylovebdy: folds 
romanskiy1: folds 
*** FLOP *** [4s 2h Jd]
Mcdog43: bets $0.20
OllieMac86: folds 
Uncalled bet ($0.20) returned to Mcdog43
Mcdog43 collected $0.56 from pot
*** SUMMARY ***
Total pot $0.59 | Rake $0.03 
Board [4s 2h Jd]
Seat 2: everbodylovebdy (small blind) folded before Flop
Seat 3: romanskiy1 (big blind) folded before Flop
Seat 4: Mcdog43 collected ($0.56)
Seat 5: OllieMac86 (button) folded on the Flop



PokerStars Hand #222981312220:  Hold'em No Limit ($0.05/$0.10 USD) - 2021/01/23 20:19:19 ET
Table 'Transvaalia' 6-max Seat #2 is the button
Seat 2: everbodylovebdy ($8.52 in chips) 
Seat 3: romanskiy1 ($16.11 in chips) 
Seat 4: Mcdog43 ($11.60 in chips) 
Seat 5: OllieMac86 ($18.19 in chips) 
romanskiy1: posts small blind $0.05
Mcdog43: posts big blind $0.10
*** HOLE CARDS ***
OllieMac86: folds 
everbodylovebdy: folds 
romanskiy1: folds 
Uncalled bet ($0.05) returned to Mcdog43
Mcdog43 collected $0.10 from pot
*** SUMMARY ***
Total pot $0.10 | Rake $0 
Seat 2: everbodylovebdy (button) folded before Flop (didn't bet)
Seat 3: romanskiy1 (small blind) folded before Flop
Seat 4: Mcdog43 (big blind) collected ($0.10)
Seat 5: OllieMac86 folded before Flop (didn't bet)



PokerStars Hand #222981317098:  Hold'em No Limit ($0.05/$0.10 USD) - 2021/01/23 20:19:31 ET
Table 'Transvaalia' 6-max Seat #3 is the button
Seat 2: everbodylovebdy ($8.52 in chips) 
Seat 3: romanskiy1 ($16.06 in chips) 
Seat 4: Mcdog43 ($11.65 in chips) 
Seat 5: OllieMac86 ($18.19 in chips) 
Mcdog43: posts small blind $0.05
OllieMac86: posts big blind $0.10
*** HOLE CARDS ***
everbodylovebdy: raises $0.10 to $0.20
romanskiy1: folds 
Mcdog43: folds 
OllieMac86: folds 
Uncalled bet ($0.10) returned to everbodylovebdy
everbodylovebdy collected $0.25 from pot
everbodylovebdy: doesn't show hand 
*** SUMMARY ***
Total pot $0.25 | Rake $0 
Seat 2: everbodylovebdy collected ($0.25)
Seat 3: romanskiy1 (button) folded before Flop (didn't bet)
Seat 4: Mcdog43 (small blind) folded before Flop
Seat 5: OllieMac86 (big blind) folded before Flop



PokerStars Hand #222981322237:  Hold'em No Limit ($0.05/$0.10 USD) - 2021/01/23 20:19:42 ET
Table 'Transvaalia' 6-max Seat #4 is the button
Seat 2: everbodylovebdy ($8.67 in chips) 
Seat 3: romanskiy1 ($16.06 in chips) 
Seat 4: Mcdog43 ($11.60 in chips) 
Seat 5: OllieMac86 ($18.09 in chips) 
OllieMac86: posts small blind $0.05
everbodylovebdy: posts big blind $0.10
*** HOLE CARDS ***
romanskiy1: folds 
Mcdog43: raises $0.10 to $0.20
OllieMac86: folds 
everbodylovebdy: calls $0.10
*** FLOP *** [4h 2c 3c]
everbodylovebdy: checks 
Mcdog43: bets $0.20
everbodylovebdy: folds 
Uncalled bet ($0.20) returned to Mcdog43
Mcdog43 collected $0.43 from pot
*** SUMMARY ***
Total pot $0.45 | Rake $0.02 
Board [4h 2c 3c]
Seat 2: everbodylovebdy (big blind) folded on the Flop
Seat 3: romanskiy1 folded before Flop (didn't bet)
Seat 4: Mcdog43 (button) collected ($0.43)
Seat 5: OllieMac86 (small blind) folded before Flop



PokerStars Hand #222981335820:  Hold'em No Limit ($0.05/$0.10 USD) - 2021/01/23 20:20:14 ET
Table 'Transvaalia' 6-max Seat #5 is the button
Seat 2: everbodylovebdy ($8.47 in chips) 
Seat 3: romanskiy1 ($16.06 in chips) 
Seat 4: Mcdog43 ($11.83 in chips) 
Seat 5: OllieMac86 ($18.04 in chips) 
everbodylovebdy: posts small blind $0.05
romanskiy1: posts big blind $0.10
*** HOLE CARDS ***
Mcdog43: folds 
OllieMac86: folds 
everbodylovebdy: folds 
Uncalled bet ($0.05) returned to romanskiy1
romanskiy1 collected $0.10 from pot
romanskiy1: doesn't show hand 
*** SUMMARY ***
Total pot $0.10 | Rake $0 
Seat 2: everbodylovebdy (small blind) folded before Flop
Seat 3: romanskiy1 (big blind) collected ($0.10)
Seat 4: Mcdog43 folded before Flop (didn't bet)
Seat 5: OllieMac86 (button) folded before Flop (didn't bet)



PokerStars Hand #222981339241:  Hold'em No Limit ($0.05/$0.10 USD) - 2021/01/23 20:20:22 ET
Table 'Transvaalia' 6-max Seat #2 is the button
Seat 2: everbodylovebdy ($8.42 in chips) 
Seat 3: romanskiy1 ($16.11 in chips) 
Seat 4: Mcdog43 ($11.83 in chips) 
Seat 5: OllieMac86 ($18.04 in chips) 
romanskiy1: posts small blind $0.05
Mcdog43: posts big blind $0.10
*** HOLE CARDS ***
OllieMac86: raises $0.20 to $0.30
everbodylovebdy: folds 
romanskiy1: folds 
Mcdog43: calls $0.20
*** FLOP *** [Qs 7c 3d]
Mcdog43: checks 
OllieMac86: bets $0.42
Mcdog43: calls $0.42
*** TURN *** [Qs 7c 3d] [Kc]
Mcdog43: checks 
OllieMac86: bets $0.97
Mcdog43: raises $1.58 to $2.55
OllieMac86: folds 
Uncalled bet ($1.58) returned to Mcdog43
Mcdog43 collected $3.28 from pot
*** SUMMARY ***
Total pot $3.43 | Rake $0.15 
Board [Qs 7c 3d Kc]
Seat 2: everbodylovebdy (button) folded before Flop (didn't bet)
Seat 3: romanskiy1 (small blind) folded before Flop
Seat 4: Mcdog43 (big blind) collected ($3.28)
Seat 5: OllieMac86 folded on the Turn



PokerStars Hand #222981358260:  Hold'em No Limit ($0.05/$0.10 USD) - 2021/01/23 20:21:05 ET
Table 'Transvaalia' 6-max Seat #3 is the button
Seat 3: romanskiy1 ($16.06 in chips) 
Seat 4: Mcdog43 ($13.42 in chips) 
Seat 5: OllieMac86 ($16.35 in chips) 
Mcdog43: posts small blind $0.05
OllieMac86: posts big blind $0.10
*** HOLE CARDS ***
romanskiy1: raises $0.20 to $0.30
Mcdog43: folds 
OllieMac86: folds 
Uncalled bet ($0.20) returned to romanskiy1
romanskiy1 collected $0.25 from pot
romanskiy1: doesn't show hand 
*** SUMMARY ***
Total pot $0.25 | Rake $0 
Seat 3: romanskiy1 (button) collected ($0.25)
Seat 4: Mcdog43 (small blind) folded before Flop
Seat 5: OllieMac86 (big blind) folded before Flop



PokerStars Hand #222981361658:  Hold'em No Limit ($0.05/$0.10 USD) - 2021/01/23 20:21:13 ET
Table 'Transvaalia' 6-max Seat #4 is the button
Seat 3: romanskiy1 ($16.21 in chips) 
Seat 4: Mcdog43 ($13.37 in chips) 
Seat 5: OllieMac86 ($16.25 in chips) 
OllieMac86: posts small blind $0.05
romanskiy1: posts big blind $0.10
*** HOLE CARDS ***
Mcdog43: folds 
OllieMac86: raises $0.20 to $0.30
romanskiy1: folds 
Uncalled bet ($0.20) returned to OllieMac86
OllieMac86 collected $0.20 from pot
OllieMac86: doesn't show hand 
*** SUMMARY ***
Total pot $0.20 | Rake $0 
Seat 3: romanskiy1 (big blind) folded before Flop
Seat 4: Mcdog43 (button) folded before Flop (didn't bet)
Seat 5: OllieMac86 (small blind) collected ($0.20)



PokerStars Hand #222981364886:  Hold'em No Limit ($0.05/$0.10 USD) - 2021/01/23 20:21:20 ET
Table 'Transvaalia' 6-max Seat #5 is the button
Seat 3: romanskiy1 ($16.11 in chips) 
Seat 4: Mcdog43 ($13.37 in chips) 
Seat 5: OllieMac86 ($16.35 in chips) 
romanskiy1: posts small blind $0.05
Mcdog43: posts big blind $0.10
*** HOLE CARDS ***
OllieMac86: raises $0.20 to $0.30
romanskiy1: folds 
everbodylovebdy is disconnected 
Mcdog43: folds 
Uncalled bet ($0.20) returned to OllieMac86
OllieMac86 collected $0.25 from pot
OllieMac86: doesn't show hand 
*** SUMMARY ***
Total pot $0.25 | Rake $0 
Seat 3: romanskiy1 (small blind) folded before Flop
Seat 4: Mcdog43 (big blind) folded before Flop
Seat 5: OllieMac86 (button) collected ($0.25)



PokerStars Hand #222981369877:  Hold'em No Limit ($0.05/$0.10 USD) - 2021/01/23 20:21:31 ET
Table 'Transvaalia' 6-max Seat #3 is the button
Seat 3: romanskiy1 ($16.06 in chips) 
Seat 4: Mcdog43 ($13.27 in chips) 
Seat 5: OllieMac86 ($16.50 in chips) 
Mcdog43: posts small blind $0.05
OllieMac86: posts big blind $0.10
*** HOLE CARDS ***
romanskiy1: folds 
Mcdog43: raises $0.20 to $0.30
romanskiy1 leaves the table
OllieMac86: folds 
Uncalled bet ($0.20) returned to Mcdog43
Mcdog43 collected $0.20 from pot
*** SUMMARY ***
Total pot $0.20 | Rake $0 
Seat 3: romanskiy1 (button) folded before Flop (didn't bet)
Seat 4: Mcdog43 (small blind) collected ($0.20)
Seat 5: OllieMac86 (big blind) folded before Flop



PokerStars Hand #222981372790:  Hold'em No Limit ($0.05/$0.10 USD) - 2021/01/23 20:21:38 ET
Table 'Transvaalia' 6-max Seat #5 is the button
Seat 4: Mcdog43 ($13.37 in chips) 
Seat 5: OllieMac86 ($16.40 in chips) 
OllieMac86: posts small blind $0.05
Mcdog43: posts big blind $0.10
*** HOLE CARDS ***
OllieMac86: raises $0.20 to $0.30
Mcdog43: folds 
Uncalled bet ($0.20) returned to OllieMac86
OllieMac86 collected $0.20 from pot
OllieMac86: doesn't show hand 
*** SUMMARY ***
Total pot $0.20 | Rake $0 
Seat 4: Mcdog43 (big blind) folded before Flop
Seat 5: OllieMac86 (button) (small blind) collected ($0.20)



PokerStars Hand #222981375850:  Hold'em No Limit ($0.05/$0.10 USD) - 2021/01/23 20:21:45 ET
Table 'Transvaalia' 6-max Seat #4 is the button
Seat 4: Mcdog43 ($13.27 in chips) 
Seat 5: OllieMac86 ($16.50 in chips) 
Mcdog43: posts small blind $0.05
OllieMac86: posts big blind $0.10
*** HOLE CARDS ***
Mcdog43: raises $0.10 to $0.20
OllieMac86: calls $0.10
*** FLOP *** [Th 8s 4s]
OllieMac86: checks 
Mcdog43: bets $0.20
OllieMac86: raises $0.40 to $0.60
Mcdog43: folds 
Uncalled bet ($0.40) returned to OllieMac86
OllieMac86 collected $0.76 from pot
OllieMac86: doesn't show hand 
*** SUMMARY ***
Total pot $0.80 | Rake $0.04 
Board [Th 8s 4s]
Seat 4: Mcdog43 (button) (small blind) folded on the Flop
Seat 5: OllieMac86 (big blind) collected ($0.76)



PokerStars Hand #222981384039:  Hold'em No Limit ($0.05/$0.10 USD) - 2021/01/23 20:22:04 ET
Table 'Transvaalia' 6-max Seat #5 is the button
Seat 4: Mcdog43 ($12.87 in chips) 
Seat 5: OllieMac86 ($16.86 in chips) 
OllieMac86: posts small blind $0.05
Mcdog43: posts big blind $0.10
*** HOLE CARDS ***
OllieMac86: raises $0.20 to $0.30
Mcdog43: calls $0.20
*** FLOP *** [Ts Qd 2s]
Mcdog43: checks 
OllieMac86: checks 
*** TURN *** [Ts Qd 2s] [Td]
Mcdog43: bets $0.35
OllieMac86: folds 
Uncalled bet ($0.35) returned to Mcdog43
Mcdog43 collected $0.57 from pot
*** SUMMARY ***
Total pot $0.60 | Rake $0.03 
Board [Ts Qd 2s Td]
Seat 4: Mcdog43 (big blind) collected ($0.57)
Seat 5: OllieMac86 (button) (small blind) folded on the Turn



PokerStars Hand #222981395855:  Hold'em No Limit ($0.05/$0.10 USD) - 2021/01/23 20:22:31 ET
Table 'Transvaalia' 6-max Seat #4 is the button
Seat 4: Mcdog43 ($13.14 in chips) 
Seat 5: OllieMac86 ($16.56 in chips) 
Mcdog43: posts small blind $0.05
OllieMac86: posts big blind $0.10
*** HOLE CARDS ***
Mcdog43: raises $0.10 to $0.20
OllieMac86: calls $0.10
*** FLOP *** [9h 6h 5s]
OllieMac86: checks 
Mcdog43: bets $0.20
OllieMac86: calls $0.20
*** TURN *** [9h 6h 5s] [As]
OllieMac86: checks 
Mcdog43: bets $0.45
OllieMac86: calls $0.45
*** RIVER *** [9h 6h 5s As] [Jc]
OllieMac86: checks 
Mcdog43: checks 
*** SHOW DOWN ***
OllieMac86: shows [4c Ah] (a pair of Aces)
Mcdog43: mucks hand 
OllieMac86 collected $1.62 from pot
*** SUMMARY ***
Total pot $1.70 | Rake $0.08 
Board [9h 6h 5s As Jc]
Seat 4: Mcdog43 (button) (small blind) mucked
Seat 5: OllieMac86 (big blind) showed [4c Ah] and won ($1.62) with a pair of Aces



PokerStars Hand #222981410176:  Hold'em No Limit ($0.05/$0.10 USD) - 2021/01/23 20:23:04 ET
Table 'Transvaalia' 6-max Seat #5 is the button
Seat 4: Mcdog43 ($12.29 in chips) 
Seat 5: OllieMac86 ($17.33 in chips) 
OllieMac86: posts small blind $0.05
Mcdog43: posts big blind $0.10
*** HOLE CARDS ***
OllieMac86: raises $0.20 to $0.30
Mcdog43: calls $0.20
*** FLOP *** [2s 2d 6h]
Mcdog43: checks 
OllieMac86: bets $0.32
Mcdog43: folds 
Uncalled bet ($0.32) returned to OllieMac86
OllieMac86 collected $0.57 from pot
OllieMac86: doesn't show hand 
*** SUMMARY ***
Total pot $0.60 | Rake $0.03 
Board [2s 2d 6h]
Seat 4: Mcdog43 (big blind) folded on the Flop
Seat 5: OllieMac86 (button) (small blind) collected ($0.57)



PokerStars Hand #222981420567:  Hold'em No Limit ($0.05/$0.10 USD) - 2021/01/23 20:23:22 ET
Table 'Transvaalia' 6-max Seat #4 is the button
Seat 4: Mcdog43 ($11.99 in chips) 
Seat 5: OllieMac86 ($17.60 in chips) 
Mcdog43: posts small blind $0.05
OllieMac86: posts big blind $0.10
*** HOLE CARDS ***
KramSS joins the table at seat #6 
Mcdog43: raises $0.10 to $0.20
OllieMac86: folds 
Uncalled bet ($0.10) returned to Mcdog43
Mcdog43 collected $0.20 from pot
*** SUMMARY ***
Total pot $0.20 | Rake $0 
Seat 4: Mcdog43 (button) (small blind) collected ($0.20)
Seat 5: OllieMac86 (big blind) folded before Flop



PokerStars Hand #222981423038:  Hold'em No Limit ($0.05/$0.10 USD) - 2021/01/23 20:23:28 ET
Table 'Transvaalia' 6-max Seat #4 is the button
Seat 4: Mcdog43 ($12.09 in chips) 
Seat 5: OllieMac86 ($17.50 in chips) 
Seat 6: KramSS ($10 in chips) 
OllieMac86: posts small blind $0.05
KramSS: posts big blind $0.10
*** HOLE CARDS ***
Mcdog43: folds 
OllieMac86: raises $0.20 to $0.30
KramSS: folds 
Uncalled bet ($0.20) returned to OllieMac86
OllieMac86 collected $0.20 from pot
OllieMac86: doesn't show hand 
*** SUMMARY ***
Total pot $0.20 | Rake $0 
Seat 4: Mcdog43 (button) folded before Flop (didn't bet)
Seat 5: OllieMac86 (small blind) collected ($0.20)
Seat 6: KramSS (big blind) folded before Flop



PokerStars Hand #222981429099:  Hold'em No Limit ($0.05/$0.10 USD) - 2021/01/23 20:23:42 ET
Table 'Transvaalia' 6-max Seat #5 is the button
Seat 4: Mcdog43 ($12.09 in chips) 
Seat 5: OllieMac86 ($17.60 in chips) 
Seat 6: KramSS ($10 in chips) 
KramSS: posts small blind $0.05
Mcdog43: posts big blind $0.10
*** HOLE CARDS ***
OllieMac86: raises $0.20 to $0.30
KramSS: folds 
Mcdog43: folds 
Uncalled bet ($0.20) returned to OllieMac86
OllieMac86 collected $0.25 from pot
OllieMac86: doesn't show hand 
*** SUMMARY ***
Total pot $0.25 | Rake $0 
Seat 4: Mcdog43 (big blind) folded before Flop
Seat 5: OllieMac86 (button) collected ($0.25)
Seat 6: KramSS (small blind) folded before Flop



PokerStars Hand #222981434824:  Hold'em No Limit ($0.05/$0.10 USD) - 2021/01/23 20:23:55 ET
Table 'Transvaalia' 6-max Seat #6 is the button
Seat 4: Mcdog43 ($11.99 in chips) 
Seat 5: OllieMac86 ($17.75 in chips) 
Seat 6: KramSS ($10 in chips) 
Mcdog43: posts small blind $0.05
OllieMac86: posts big blind $0.10
*** HOLE CARDS ***
KramSS: folds 
Mcdog43: calls $0.05
OllieMac86: checks 
*** FLOP *** [6h 4h Jh]
Mcdog43: bets $0.10
OllieMac86: folds 
Uncalled bet ($0.10) returned to Mcdog43
Mcdog43 collected $0.19 from pot
*** SUMMARY ***
Total pot $0.20 | Rake $0.01 
Board [6h 4h Jh]
Seat 4: Mcdog43 (small blind) collected ($0.19)
Seat 5: OllieMac86 (big blind) folded on the Flop
Seat 6: KramSS (button) folded before Flop (didn't bet)



PokerStars Hand #222981440808:  Hold'em No Limit ($0.05/$0.10 USD) - 2021/01/23 20:24:08 ET
Table 'Transvaalia' 6-max Seat #4 is the button
Seat 4: Mcdog43 ($12.08 in chips) 
Seat 5: OllieMac86 ($17.65 in chips) 
Seat 6: KramSS ($10 in chips) 
OllieMac86: posts small blind $0.05
KramSS: posts big blind $0.10
*** HOLE CARDS ***
Mcdog43: raises $0.10 to $0.20
OllieMac86: raises $0.50 to $0.70
KramSS: folds 
Mcdog43: calls $0.50
*** FLOP *** [Jh 8s 7h]
OllieMac86: checks 
Mcdog43: checks 
*** TURN *** [Jh 8s 7h] [6d]
OllieMac86: bets $0.82
Mcdog43: folds 
Uncalled bet ($0.82) returned to OllieMac86
OllieMac86 collected $1.43 from pot
OllieMac86: doesn't show hand 
*** SUMMARY ***
Total pot $1.50 | Rake $0.07 
Board [Jh 8s 7h 6d]
Seat 4: Mcdog43 (button) folded on the Turn
Seat 5: OllieMac86 (small blind) collected ($1.43)
Seat 6: KramSS (big blind) folded before Flop



PokerStars Hand #222981457277:  Hold'em No Limit ($0.05/$0.10 USD) - 2021/01/23 20:24:46 ET
Table 'Transvaalia' 6-max Seat #5 is the button
Seat 4: Mcdog43 ($11.38 in chips) 
Seat 5: OllieMac86 ($18.38 in chips) 
Seat 6: KramSS ($10 in chips) 
KramSS: posts small blind $0.05
Mcdog43: posts big blind $0.10
*** HOLE CARDS ***
OllieMac86: folds 
KramSS: folds 
Uncalled bet ($0.05) returned to Mcdog43
Mcdog43 collected $0.10 from pot
*** SUMMARY ***
Total pot $0.10 | Rake $0 
Seat 4: Mcdog43 (big blind) collected ($0.10)
Seat 5: OllieMac86 (button) folded before Flop (didn't bet)
Seat 6: KramSS (small blind) folded before Flop



PokerStars Hand #222981459955:  Hold'em No Limit ($0.05/$0.10 USD) - 2021/01/23 20:24:52 ET
Table 'Transvaalia' 6-max Seat #6 is the button
Seat 4: Mcdog43 ($11.43 in chips) 
Seat 5: OllieMac86 ($18.38 in chips) 
Seat 6: KramSS ($10 in chips) 
Mcdog43: posts small blind $0.05
OllieMac86: posts big blind $0.10
*** HOLE CARDS ***
KramSS: folds 
Mcdog43: raises $0.20 to $0.30
OllieMac86: calls $0.20
*** FLOP *** [Qd Ks 9s]
Mcdog43: bets $0.35
OllieMac86: calls $0.35
*** TURN *** [Qd Ks 9s] [Ts]
Mcdog43: bets $0.90
OllieMac86: raises $1.30 to $2.20
Mcdog43: folds 
Uncalled bet ($1.30) returned to OllieMac86
OllieMac86 collected $2.96 from pot
OllieMac86: doesn't show hand 
*** SUMMARY ***
Total pot $3.10 | Rake $0.14 
Board [Qd Ks 9s Ts]
Seat 4: Mcdog43 (small blind) folded on the Turn
Seat 5: OllieMac86 (big blind) collected ($2.96)
Seat 6: KramSS (button) folded before Flop (didn't bet)



PokerStars Hand #222981471002:  Hold'em No Limit ($0.05/$0.10 USD) - 2021/01/23 20:25:17 ET
Table 'Transvaalia' 6-max Seat #4 is the button
Seat 4: Mcdog43 ($9.88 in chips) 
Seat 5: OllieMac86 ($19.79 in chips) 
Seat 6: KramSS ($10 in chips) 
OllieMac86: posts small blind $0.05
KramSS: posts big blind $0.10
*** HOLE CARDS ***
Mcdog43: folds 
OllieMac86: raises $0.20 to $0.30
KramSS: raises $0.70 to $1
OllieMac86: folds 
Uncalled bet ($0.70) returned to KramSS
KramSS collected $0.60 from pot
KramSS: doesn't show hand 
*** SUMMARY ***
Total pot $0.60 | Rake $0 
Seat 4: Mcdog43 (button) folded before Flop (didn't bet)
Seat 5: OllieMac86 (small blind) folded before Flop
Seat 6: KramSS (big blind) collected ($0.60)



PokerStars Hand #222981476707:  Hold'em No Limit ($0.05/$0.10 USD) - 2021/01/23 20:25:30 ET
Table 'Transvaalia' 6-max Seat #5 is the button
Seat 4: Mcdog43 ($9.88 in chips) 
Seat 5: OllieMac86 ($19.49 in chips) 
Seat 6: KramSS ($10.30 in chips) 
KramSS: posts small blind $0.05
Mcdog43: posts big blind $0.10
*** HOLE CARDS ***
OllieMac86: raises $0.20 to $0.30
KramSS: folds 
Mcdog43: calls $0.20
*** FLOP *** [4d 4c 2s]
Mcdog43: checks 
OllieMac86: bets $0.40
Mcdog43: calls $0.40
*** TURN *** [4d 4c 2s] [8c]
Mcdog43: checks 
OllieMac86: bets $0.94
wolverstine joins the table at seat #3 
Mcdog43: calls $0.94
*** RIVER *** [4d 4c 2s 8c] [Ac]
wolverstine leaves the table
Mcdog43: checks 
OllieMac86: checks 
*** SHOW DOWN ***
Mcdog43: shows [4h 7h] (three of a kind, Fours)
OllieMac86: mucks hand 
Mcdog43 collected $3.18 from pot
*** SUMMARY ***
Total pot $3.33 | Rake $0.15 
Board [4d 4c 2s 8c Ac]
Seat 4: Mcdog43 (big blind) showed [4h 7h] and won ($3.18) with three of a kind, Fours
Seat 5: OllieMac86 (button) mucked
Seat 6: KramSS (small blind) folded before Flop



PokerStars Hand #222981493013:  Hold'em No Limit ($0.05/$0.10 USD) - 2021/01/23 20:26:07 ET
Table 'Transvaalia' 6-max Seat #6 is the button
Seat 4: Mcdog43 ($11.42 in chips) 
Seat 5: OllieMac86 ($17.85 in chips) 
Seat 6: KramSS ($10.25 in chips) 
Mcdog43: posts small blind $0.05
OllieMac86: posts big blind $0.10
*** HOLE CARDS ***
KramSS: raises $0.15 to $0.25
Mcdog43: folds 
OllieMac86: calls $0.15
*** FLOP *** [Qc 8d Kh]
OllieMac86: checks 
KramSS: checks 
*** TURN *** [Qc 8d Kh] [Jc]
OllieMac86: bets $0.40
KramSS: folds 
Uncalled bet ($0.40) returned to OllieMac86
OllieMac86 collected $0.53 from pot
OllieMac86: doesn't show hand 
*** SUMMARY ***
Total pot $0.55 | Rake $0.02 
Board [Qc 8d Kh Jc]
Seat 4: Mcdog43 (small blind) folded before Flop
Seat 5: OllieMac86 (big blind) collected ($0.53)
Seat 6: KramSS (button) folded on the Turn



PokerStars Hand #222981503916:  Hold'em No Limit ($0.05/$0.10 USD) - 2021/01/23 20:26:32 ET
Table 'Transvaalia' 6-max Seat #4 is the button
Seat 4: Mcdog43 ($11.37 in chips) 
Seat 5: OllieMac86 ($18.13 in chips) 
Seat 6: KramSS ($10 in chips) 
OllieMac86: posts small blind $0.05
KramSS: posts big blind $0.10
*** HOLE CARDS ***
Mcdog43: raises $0.10 to $0.20
OllieMac86: folds 
KramSS: folds 
Uncalled bet ($0.10) returned to Mcdog43
Mcdog43 collected $0.25 from pot
*** SUMMARY ***
Total pot $0.25 | Rake $0 
Seat 4: Mcdog43 (button) collected ($0.25)
Seat 5: OllieMac86 (small blind) folded before Flop
Seat 6: KramSS (big blind) folded before Flop



PokerStars Hand #222981507228:  Hold'em No Limit ($0.05/$0.10 USD) - 2021/01/23 20:26:39 ET
Table 'Transvaalia' 6-max Seat #5 is the button
Seat 4: Mcdog43 ($11.52 in chips) 
Seat 5: OllieMac86 ($18.08 in chips) 
Seat 6: KramSS ($10 in chips) 
KramSS: posts small blind $0.05
Mcdog43: posts big blind $0.10
*** HOLE CARDS ***
OllieMac86: raises $0.20 to $0.30
KramSS: calls $0.25
Mcdog43: folds 
*** FLOP *** [7s Qc 3c]
KramSS: checks 
OllieMac86: bets $0.46
KramSS: folds 
Uncalled bet ($0.46) returned to OllieMac86
OllieMac86 collected $0.67 from pot
*** SUMMARY ***
Total pot $0.70 | Rake $0.03 
Board [7s Qc 3c]
Seat 4: Mcdog43 (big blind) folded before Flop
Seat 5: OllieMac86 (button) collected ($0.67)
Seat 6: KramSS (small blind) folded on the Flop



PokerStars Hand #222981522952:  Hold'em No Limit ($0.05/$0.10 USD) - 2021/01/23 20:26:58 ET
Table 'Transvaalia' 6-max Seat #6 is the button
Seat 4: Mcdog43 ($11.42 in chips) 
Seat 5: OllieMac86 ($18.45 in chips) 
Seat 6: KramSS ($10 in chips) 
Mcdog43: posts small blind $0.05
OllieMac86: posts big blind $0.10
*** HOLE CARDS ***
KramSS: folds 
Mcdog43: folds 
Uncalled bet ($0.05) returned to OllieMac86
OllieMac86 collected $0.10 from pot
OllieMac86: doesn't show hand 
*** SUMMARY ***
Total pot $0.10 | Rake $0 
Seat 4: Mcdog43 (small blind) folded before Flop
Seat 5: OllieMac86 (big blind) collected ($0.10)
Seat 6: KramSS (button) folded before Flop (didn't bet)



PokerStars Hand #222981524863:  Hold'em No Limit ($0.05/$0.10 USD) - 2021/01/23 20:27:03 ET
Table 'Transvaalia' 6-max Seat #4 is the button
Seat 4: Mcdog43 ($11.37 in chips) 
Seat 5: OllieMac86 ($18.50 in chips) 
Seat 6: KramSS ($10 in chips) 
OllieMac86: posts small blind $0.05
KramSS: posts big blind $0.10
*** HOLE CARDS ***
Mcdog43: raises $0.10 to $0.20
OllieMac86: folds 
KramSS: folds 
Uncalled bet ($0.10) returned to Mcdog43
Mcdog43 collected $0.25 from pot
*** SUMMARY ***
Total pot $0.25 | Rake $0 
Seat 4: Mcdog43 (button) collected ($0.25)
Seat 5: OllieMac86 (small blind) folded before Flop
Seat 6: KramSS (big blind) folded before Flop



PokerStars Hand #222981530910:  Hold'em No Limit ($0.05/$0.10 USD) - 2021/01/23 20:27:17 ET
Table 'Transvaalia' 6-max Seat #5 is the button
Seat 4: Mcdog43 ($11.52 in chips) 
Seat 5: OllieMac86 ($18.45 in chips) 
Seat 6: KramSS ($10 in chips) 
KramSS: posts small blind $0.05
Mcdog43: posts big blind $0.10
*** HOLE CARDS ***
OllieMac86: raises $0.20 to $0.30
KramSS: folds 
Mcdog43: folds 
Uncalled bet ($0.20) returned to OllieMac86
OllieMac86 collected $0.25 from pot
OllieMac86: doesn't show hand 
*** SUMMARY ***
Total pot $0.25 | Rake $0 
Seat 4: Mcdog43 (big blind) folded before Flop
Seat 5: OllieMac86 (button) collected ($0.25)
Seat 6: KramSS (small blind) folded before Flop



PokerStars Hand #222981534335:  Hold'em No Limit ($0.05/$0.10 USD) - 2021/01/23 20:27:24 ET
Table 'Transvaalia' 6-max Seat #6 is the button
Seat 4: Mcdog43 ($11.42 in chips) 
Seat 5: OllieMac86 ($18.60 in chips) 
Seat 6: KramSS ($10 in chips) 
Mcdog43: posts small blind $0.05
OllieMac86: posts big blind $0.10
*** HOLE CARDS ***
KramSS: raises $0.15 to $0.25
Mcdog43: folds 
OllieMac86: calls $0.15
*** FLOP *** [8h 2s Th]
OllieMac86: checks 
KramSS: bets $0.31
OllieMac86: calls $0.31
*** TURN *** [8h 2s Th] [3s]
OllieMac86: checks 
KramSS: bets $0.70
OllieMac86: raises $0.90 to $1.60
KramSS: calls $0.90
*** RIVER *** [8h 2s Th 3s] [4s]
OllieMac86: checks 
KramSS: checks 
*** SHOW DOWN ***
OllieMac86: shows [2c Kc] (a pair of Deuces)
KramSS: shows [Qd Qh] (a pair of Queens)
KramSS collected $4.17 from pot
*** SUMMARY ***
Total pot $4.37 | Rake $0.20 
Board [8h 2s Th 3s 4s]
Seat 4: Mcdog43 (small blind) folded before Flop
Seat 5: OllieMac86 (big blind) showed [2c Kc] and lost with a pair of Deuces
Seat 6: KramSS (button) showed [Qd Qh] and won ($4.17) with a pair of Queens



PokerStars Hand #222981559676:  Hold'em No Limit ($0.05/$0.10 USD) - 2021/01/23 20:28:24 ET
Table 'Transvaalia' 6-max Seat #4 is the button
Seat 4: Mcdog43 ($11.37 in chips) 
Seat 5: OllieMac86 ($16.44 in chips) 
Seat 6: KramSS ($12.01 in chips) 
OllieMac86: posts small blind $0.05
KramSS: posts big blind $0.10
*** HOLE CARDS ***
Mcdog43: raises $0.10 to $0.20
OllieMac86: folds 
KramSS: calls $0.10
*** FLOP *** [Qs 4h Kd]
KramSS: checks 
Mcdog43: bets $0.25
KramSS: folds 
Uncalled bet ($0.25) returned to Mcdog43
Mcdog43 collected $0.43 from pot
*** SUMMARY ***
Total pot $0.45 | Rake $0.02 
Board [Qs 4h Kd]
Seat 4: Mcdog43 (button) collected ($0.43)
Seat 5: OllieMac86 (small blind) folded before Flop
Seat 6: KramSS (big blind) folded on the Flop



PokerStars Hand #222981568245:  Hold'em No Limit ($0.05/$0.10 USD) - 2021/01/23 20:28:44 ET
Table 'Transvaalia' 6-max Seat #5 is the button
Seat 4: Mcdog43 ($11.60 in chips) 
Seat 5: OllieMac86 ($16.39 in chips) 
Seat 6: KramSS ($11.81 in chips) 
KramSS: posts small blind $0.05
Mcdog43: posts big blind $0.10
*** HOLE CARDS ***
OllieMac86: raises $0.20 to $0.30
KramSS: folds 
Mcdog43: folds 
Uncalled bet ($0.20) returned to OllieMac86
OllieMac86 collected $0.25 from pot
OllieMac86: doesn't show hand 
*** SUMMARY ***
Total pot $0.25 | Rake $0 
Seat 4: Mcdog43 (big blind) folded before Flop
Seat 5: OllieMac86 (button) collected ($0.25)
Seat 6: KramSS (small blind) folded before Flop



PokerStars Hand #222981572279:  Hold'em No Limit ($0.05/$0.10 USD) - 2021/01/23 20:28:53 ET
Table 'Transvaalia' 6-max Seat #6 is the button
Seat 4: Mcdog43 ($11.50 in chips) 
Seat 5: OllieMac86 ($16.54 in chips) 
Seat 6: KramSS ($11.76 in chips) 
Mcdog43: posts small blind $0.05
OllieMac86: posts big blind $0.10
*** HOLE CARDS ***
KramSS: raises $0.15 to $0.25
Mcdog43: folds 
OllieMac86: folds 
Uncalled bet ($0.15) returned to KramSS
KramSS collected $0.25 from pot
KramSS: doesn't show hand 
*** SUMMARY ***
Total pot $0.25 | Rake $0 
Seat 4: Mcdog43 (small blind) folded before Flop
Seat 5: OllieMac86 (big blind) folded before Flop
Seat 6: KramSS (button) collected ($0.25)



PokerStars Hand #222981576920:  Hold'em No Limit ($0.05/$0.10 USD) - 2021/01/23 20:29:04 ET
Table 'Transvaalia' 6-max Seat #5 is the button
Seat 4: Mcdog43 ($11.45 in chips) 
Seat 5: OllieMac86 ($16.44 in chips) 
OllieMac86: posts small blind $0.05
KramSS: is sitting out 
Mcdog43: posts big blind $0.10
*** HOLE CARDS ***
OllieMac86: raises $0.20 to $0.30
Mcdog43: calls $0.20
*** FLOP *** [2c 6c As]
Mcdog43: checks 
KramSS leaves the table
OllieMac86: checks 
*** TURN *** [2c 6c As] [Ah]
Mcdog43: checks 
OllieMac86: bets $0.39
Mcdog43: folds 
Uncalled bet ($0.39) returned to OllieMac86
OllieMac86 collected $0.57 from pot
OllieMac86: doesn't show hand 
*** SUMMARY ***
Total pot $0.60 | Rake $0.03 
Board [2c 6c As Ah]
Seat 4: Mcdog43 (big blind) folded on the Turn
Seat 5: OllieMac86 (button) (small blind) collected ($0.57)



PokerStars Hand #222981589532:  Hold'em No Limit ($0.05/$0.10 USD) - 2021/01/23 20:29:34 ET
Table 'Transvaalia' 6-max Seat #4 is the button
Seat 4: Mcdog43 ($11.15 in chips) 
Seat 5: OllieMac86 ($16.71 in chips) 
Mcdog43: posts small blind $0.05
OllieMac86: posts big blind $0.10
*** HOLE CARDS ***
Mcdog43: raises $0.10 to $0.20
OllieMac86: folds 
Uncalled bet ($0.10) returned to Mcdog43
Mcdog43 collected $0.20 from pot
*** SUMMARY ***
Total pot $0.20 | Rake $0 
Seat 4: Mcdog43 (button) (small blind) collected ($0.20)
Seat 5: OllieMac86 (big blind) folded before Flop



