PokerStars Hand #222949380561:  Hold'em No Limit ($0.05/$0.10 USD) - 2021/01/23 5:13:13 ET
Table 'Saito II' 6-max Seat #2 is the button
Seat 1: fizruk5 ($10.51 in chips) 
Seat 2: Boodoolai ($10 in chips) 
Seat 3: NooBeeK ($10 in chips) 
Seat 4: Balintgergo88 ($7.35 in chips) 
Seat 6: kisgabeszkaa ($5.48 in chips) 
NooBeeK: posts small blind $0.05
Balintgergo88: posts big blind $0.10
Gari Nerskiy: sits out 
*** HOLE CARDS ***
kisgabeszkaa: calls $0.10
fizruk5: folds 
Boodoolai: raises $0.25 to $0.35
NooBeeK: folds 
Balintgergo88: folds 
kisgabeszkaa: calls $0.25
*** FLOP *** [4d 6s Tc]
kisgabeszkaa: checks 
Boodoolai: checks 
*** TURN *** [4d 6s Tc] [4c]
kisgabeszkaa: checks 
Boodoolai: bets $0.35
kisgabeszkaa: calls $0.35
*** RIVER *** [4d 6s Tc 4c] [7h]
kisgabeszkaa: bets $0.30
Boodoolai: folds 
Uncalled bet ($0.30) returned to kisgabeszkaa
kisgabeszkaa collected $1.48 from pot
*** SUMMARY ***
Total pot $1.55 | Rake $0.07 
Board [4d 6s Tc 4c 7h]
Seat 1: fizruk5 folded before Flop (didn't bet)
Seat 2: Boodoolai (button) folded on the River
Seat 3: NooBeeK (small blind) folded before Flop
Seat 4: Balintgergo88 (big blind) folded before Flop
Seat 6: kisgabeszkaa collected ($1.48)



PokerStars Hand #222949394903:  Hold'em No Limit ($0.05/$0.10 USD) - 2021/01/23 5:14:02 ET
Table 'Saito II' 6-max Seat #3 is the button
Seat 1: fizruk5 ($10.51 in chips) 
Seat 2: Boodoolai ($10 in chips) 
Seat 3: NooBeeK ($10 in chips) 
Seat 4: Balintgergo88 ($7.25 in chips) 
Seat 5: Gari Nerskiy ($10 in chips) 
Seat 6: kisgabeszkaa ($6.26 in chips) 
Balintgergo88: posts small blind $0.05
Gari Nerskiy: posts big blind $0.10
*** HOLE CARDS ***
kisgabeszkaa: calls $0.10
fizruk5: folds 
Boodoolai: folds 
NooBeeK: raises $0.25 to $0.35
Balintgergo88: folds 
Gari Nerskiy: folds 
kisgabeszkaa: folds 
Uncalled bet ($0.25) returned to NooBeeK
NooBeeK collected $0.35 from pot
NooBeeK: doesn't show hand 
*** SUMMARY ***
Total pot $0.35 | Rake $0 
Seat 1: fizruk5 folded before Flop (didn't bet)
Seat 2: Boodoolai folded before Flop (didn't bet)
Seat 3: NooBeeK (button) collected ($0.35)
Seat 4: Balintgergo88 (small blind) folded before Flop
Seat 5: Gari Nerskiy (big blind) folded before Flop
Seat 6: kisgabeszkaa folded before Flop



PokerStars Hand #222949401973:  Hold'em No Limit ($0.05/$0.10 USD) - 2021/01/23 5:14:26 ET
Table 'Saito II' 6-max Seat #4 is the button
Seat 1: fizruk5 ($10.51 in chips) 
Seat 2: Boodoolai ($10 in chips) 
Seat 3: NooBeeK ($10.25 in chips) 
Seat 4: Balintgergo88 ($7.20 in chips) 
Seat 5: Gari Nerskiy ($10 in chips) 
Seat 6: kisgabeszkaa ($6.16 in chips) 
Gari Nerskiy: posts small blind $0.05
kisgabeszkaa: posts big blind $0.10
*** HOLE CARDS ***
fizruk5: folds 
Boodoolai: folds 
NooBeeK: folds 
Balintgergo88: calls $0.10
Gari Nerskiy: folds 
kisgabeszkaa: checks 
*** FLOP *** [Qc 8h 3d]
kisgabeszkaa: checks 
Balintgergo88: checks 
*** TURN *** [Qc 8h 3d] [5h]
kisgabeszkaa: checks 
Balintgergo88: checks 
*** RIVER *** [Qc 8h 3d 5h] [Ad]
kisgabeszkaa: checks 
Balintgergo88: checks 
*** SHOW DOWN ***
kisgabeszkaa: shows [3c 8c] (two pair, Eights and Threes)
Balintgergo88: shows [8d Qs] (two pair, Queens and Eights)
Balintgergo88 collected $0.24 from pot
*** SUMMARY ***
Total pot $0.25 | Rake $0.01 
Board [Qc 8h 3d 5h Ad]
Seat 1: fizruk5 folded before Flop (didn't bet)
Seat 2: Boodoolai folded before Flop (didn't bet)
Seat 3: NooBeeK folded before Flop (didn't bet)
Seat 4: Balintgergo88 (button) showed [8d Qs] and won ($0.24) with two pair, Queens and Eights
Seat 5: Gari Nerskiy (small blind) folded before Flop
Seat 6: kisgabeszkaa (big blind) showed [3c 8c] and lost with two pair, Eights and Threes



PokerStars Hand #222949418462:  Hold'em No Limit ($0.05/$0.10 USD) - 2021/01/23 5:15:22 ET
Table 'Saito II' 6-max Seat #5 is the button
Seat 1: fizruk5 ($10.51 in chips) 
Seat 2: Boodoolai ($10 in chips) 
Seat 3: NooBeeK ($10.25 in chips) 
Seat 4: Balintgergo88 ($7.34 in chips) 
Seat 5: Gari Nerskiy ($10 in chips) 
Seat 6: kisgabeszkaa ($6.06 in chips) 
kisgabeszkaa: posts small blind $0.05
fizruk5: posts big blind $0.10
*** HOLE CARDS ***
Boodoolai: folds 
NooBeeK: folds 
Balintgergo88: calls $0.10
Gari Nerskiy: folds 
kisgabeszkaa: calls $0.05
fizruk5: checks 
*** FLOP *** [Qh 3d Jh]
kisgabeszkaa: checks 
fizruk5: bets $0.19
Balintgergo88: calls $0.19
kisgabeszkaa: folds 
*** TURN *** [Qh 3d Jh] [8c]
fizruk5: checks 
Balintgergo88: checks 
*** RIVER *** [Qh 3d Jh 8c] [4s]
fizruk5: checks 
Balintgergo88: checks 
*** SHOW DOWN ***
fizruk5: shows [Qs Td] (a pair of Queens)
Balintgergo88: mucks hand 
fizruk5 collected $0.65 from pot
*** SUMMARY ***
Total pot $0.68 | Rake $0.03 
Board [Qh 3d Jh 8c 4s]
Seat 1: fizruk5 (big blind) showed [Qs Td] and won ($0.65) with a pair of Queens
Seat 2: Boodoolai folded before Flop (didn't bet)
Seat 3: NooBeeK folded before Flop (didn't bet)
Seat 4: Balintgergo88 mucked
Seat 5: Gari Nerskiy (button) folded before Flop (didn't bet)
Seat 6: kisgabeszkaa (small blind) folded on the Flop



PokerStars Hand #222949429959:  Hold'em No Limit ($0.05/$0.10 USD) - 2021/01/23 5:16:01 ET
Table 'Saito II' 6-max Seat #6 is the button
Seat 1: fizruk5 ($10.87 in chips) 
Seat 2: Boodoolai ($10 in chips) 
Seat 3: NooBeeK ($10.25 in chips) 
Seat 4: Balintgergo88 ($7.05 in chips) 
Seat 5: Gari Nerskiy ($10 in chips) 
Seat 6: kisgabeszkaa ($5.96 in chips) 
fizruk5: posts small blind $0.05
Boodoolai: posts big blind $0.10
*** HOLE CARDS ***
NooBeeK: folds 
Balintgergo88: folds 
Gari Nerskiy: raises $0.15 to $0.25
kisgabeszkaa: folds 
fizruk5: folds 
Boodoolai: folds 
Uncalled bet ($0.15) returned to Gari Nerskiy
Gari Nerskiy collected $0.25 from pot
Gari Nerskiy: doesn't show hand 
*** SUMMARY ***
Total pot $0.25 | Rake $0 
Seat 1: fizruk5 (small blind) folded before Flop
Seat 2: Boodoolai (big blind) folded before Flop
Seat 3: NooBeeK folded before Flop (didn't bet)
Seat 4: Balintgergo88 folded before Flop (didn't bet)
Seat 5: Gari Nerskiy collected ($0.25)
Seat 6: kisgabeszkaa (button) folded before Flop (didn't bet)



PokerStars Hand #222949436155:  Hold'em No Limit ($0.05/$0.10 USD) - 2021/01/23 5:16:22 ET
Table 'Saito II' 6-max Seat #1 is the button
Seat 1: fizruk5 ($10.82 in chips) 
Seat 2: Boodoolai ($10 in chips) 
Seat 3: NooBeeK ($10.25 in chips) 
Seat 4: Balintgergo88 ($7.05 in chips) 
Seat 5: Gari Nerskiy ($10.15 in chips) 
Seat 6: kisgabeszkaa ($5.96 in chips) 
Boodoolai: posts small blind $0.05
NooBeeK: posts big blind $0.10
*** HOLE CARDS ***
Balintgergo88: folds 
Gari Nerskiy: folds 
kisgabeszkaa: folds 
fizruk5: folds 
Boodoolai: raises $0.15 to $0.25
NooBeeK: calls $0.15
*** FLOP *** [Jd 5s Qd]
Boodoolai: bets $0.25
NooBeeK: folds 
Uncalled bet ($0.25) returned to Boodoolai
Boodoolai collected $0.48 from pot
Boodoolai: doesn't show hand 
*** SUMMARY ***
Total pot $0.50 | Rake $0.02 
Board [Jd 5s Qd]
Seat 1: fizruk5 (button) folded before Flop (didn't bet)
Seat 2: Boodoolai (small blind) collected ($0.48)
Seat 3: NooBeeK (big blind) folded on the Flop
Seat 4: Balintgergo88 folded before Flop (didn't bet)
Seat 5: Gari Nerskiy folded before Flop (didn't bet)
Seat 6: kisgabeszkaa folded before Flop (didn't bet)



PokerStars Hand #222949453903:  Hold'em No Limit ($0.05/$0.10 USD) - 2021/01/23 5:16:51 ET
Table 'Saito II' 6-max Seat #2 is the button
Seat 1: fizruk5 ($10.82 in chips) 
Seat 2: Boodoolai ($10.23 in chips) 
Seat 3: NooBeeK ($10 in chips) 
Seat 4: Balintgergo88 ($7.05 in chips) 
Seat 5: Gari Nerskiy ($10.15 in chips) 
Seat 6: kisgabeszkaa ($5.96 in chips) 
NooBeeK: posts small blind $0.05
Balintgergo88: posts big blind $0.10
*** HOLE CARDS ***
Gari Nerskiy: folds 
kisgabeszkaa: folds 
fizruk5: folds 
Boodoolai: folds 
NooBeeK: folds 
Uncalled bet ($0.05) returned to Balintgergo88
Balintgergo88 collected $0.10 from pot
Balintgergo88: doesn't show hand 
*** SUMMARY ***
Total pot $0.10 | Rake $0 
Seat 1: fizruk5 folded before Flop (didn't bet)
Seat 2: Boodoolai (button) folded before Flop (didn't bet)
Seat 3: NooBeeK (small blind) folded before Flop
Seat 4: Balintgergo88 (big blind) collected ($0.10)
Seat 5: Gari Nerskiy folded before Flop (didn't bet)
Seat 6: kisgabeszkaa folded before Flop (didn't bet)



PokerStars Hand #222949459178:  Hold'em No Limit ($0.05/$0.10 USD) - 2021/01/23 5:17:09 ET
Table 'Saito II' 6-max Seat #3 is the button
Seat 1: fizruk5 ($10.82 in chips) 
Seat 2: Boodoolai ($10.23 in chips) 
Seat 3: NooBeeK ($10 in chips) 
Seat 4: Balintgergo88 ($7.10 in chips) 
Seat 5: Gari Nerskiy ($10.15 in chips) 
Seat 6: kisgabeszkaa ($5.96 in chips) 
Balintgergo88: posts small blind $0.05
Gari Nerskiy: posts big blind $0.10
*** HOLE CARDS ***
kisgabeszkaa: folds 
fizruk5: folds 
Boodoolai: folds 
NooBeeK: raises $0.15 to $0.25
Balintgergo88: folds 
Gari Nerskiy: raises $1 to $1.25
NooBeeK: folds 
Uncalled bet ($1) returned to Gari Nerskiy
Gari Nerskiy collected $0.55 from pot
Gari Nerskiy: doesn't show hand 
*** SUMMARY ***
Total pot $0.55 | Rake $0 
Seat 1: fizruk5 folded before Flop (didn't bet)
Seat 2: Boodoolai folded before Flop (didn't bet)
Seat 3: NooBeeK (button) folded before Flop
Seat 4: Balintgergo88 (small blind) folded before Flop
Seat 5: Gari Nerskiy (big blind) collected ($0.55)
Seat 6: kisgabeszkaa folded before Flop (didn't bet)



PokerStars Hand #222949469019:  Hold'em No Limit ($0.05/$0.10 USD) - 2021/01/23 5:17:42 ET
Table 'Saito II' 6-max Seat #4 is the button
Seat 1: fizruk5 ($10.82 in chips) 
Seat 2: Boodoolai ($10.23 in chips) 
Seat 3: NooBeeK ($10 in chips) 
Seat 4: Balintgergo88 ($7.05 in chips) 
Seat 5: Gari Nerskiy ($10.45 in chips) 
Seat 6: kisgabeszkaa ($5.96 in chips) 
Gari Nerskiy: posts small blind $0.05
kisgabeszkaa: posts big blind $0.10
*** HOLE CARDS ***
fizruk5: folds 
Boodoolai: folds 
NooBeeK: folds 
Balintgergo88: calls $0.10
Gari Nerskiy: folds 
kisgabeszkaa: checks 
*** FLOP *** [3h Jc 7h]
kisgabeszkaa: checks 
Balintgergo88: checks 
*** TURN *** [3h Jc 7h] [Kd]
kisgabeszkaa: checks 
Balintgergo88: checks 
*** RIVER *** [3h Jc 7h Kd] [4c]
kisgabeszkaa: checks 
Balintgergo88: checks 
*** SHOW DOWN ***
kisgabeszkaa: shows [6s 9c] (high card King)
Balintgergo88: shows [Ac 4s] (a pair of Fours)
Balintgergo88 collected $0.24 from pot
*** SUMMARY ***
Total pot $0.25 | Rake $0.01 
Board [3h Jc 7h Kd 4c]
Seat 1: fizruk5 folded before Flop (didn't bet)
Seat 2: Boodoolai folded before Flop (didn't bet)
Seat 3: NooBeeK folded before Flop (didn't bet)
Seat 4: Balintgergo88 (button) showed [Ac 4s] and won ($0.24) with a pair of Fours
Seat 5: Gari Nerskiy (small blind) folded before Flop
Seat 6: kisgabeszkaa (big blind) showed [6s 9c] and lost with high card King



PokerStars Hand #222949479861:  Hold'em No Limit ($0.05/$0.10 USD) - 2021/01/23 5:18:18 ET
Table 'Saito II' 6-max Seat #5 is the button
Seat 1: fizruk5 ($10.82 in chips) 
Seat 2: Boodoolai ($10.23 in chips) 
Seat 3: NooBeeK ($10 in chips) 
Seat 4: Balintgergo88 ($7.19 in chips) 
Seat 5: Gari Nerskiy ($10.40 in chips) 
Seat 6: kisgabeszkaa ($5.86 in chips) 
kisgabeszkaa: posts small blind $0.05
fizruk5: posts big blind $0.10
*** HOLE CARDS ***
Boodoolai: folds 
NooBeeK: folds 
Balintgergo88: folds 
Gari Nerskiy: folds 
kisgabeszkaa: calls $0.05
fizruk5: raises $0.35 to $0.45
kisgabeszkaa: calls $0.35
*** FLOP *** [6h 3c Ks]
kisgabeszkaa: checks 
fizruk5: bets $0.45
kisgabeszkaa: calls $0.45
*** TURN *** [6h 3c Ks] [Jc]
kisgabeszkaa: checks 
fizruk5: checks 
*** RIVER *** [6h 3c Ks Jc] [Ah]
kisgabeszkaa: checks 
fizruk5: bets $1
kisgabeszkaa: folds 
Uncalled bet ($1) returned to fizruk5
fizruk5 collected $1.72 from pot
fizruk5: doesn't show hand 
*** SUMMARY ***
Total pot $1.80 | Rake $0.08 
Board [6h 3c Ks Jc Ah]
Seat 1: fizruk5 (big blind) collected ($1.72)
Seat 2: Boodoolai folded before Flop (didn't bet)
Seat 3: NooBeeK folded before Flop (didn't bet)
Seat 4: Balintgergo88 folded before Flop (didn't bet)
Seat 5: Gari Nerskiy (button) folded before Flop (didn't bet)
Seat 6: kisgabeszkaa (small blind) folded on the River



PokerStars Hand #222949495058:  Hold'em No Limit ($0.05/$0.10 USD) - 2021/01/23 5:19:10 ET
Table 'Saito II' 6-max Seat #6 is the button
Seat 1: fizruk5 ($11.64 in chips) 
Seat 2: Boodoolai ($10.23 in chips) 
Seat 3: NooBeeK ($10 in chips) 
Seat 4: Balintgergo88 ($7.19 in chips) 
Seat 5: Gari Nerskiy ($10.40 in chips) 
Seat 6: kisgabeszkaa ($4.96 in chips) 
fizruk5: posts small blind $0.05
Boodoolai: posts big blind $0.10
*** HOLE CARDS ***
NooBeeK: folds 
Balintgergo88: calls $0.10
Gari Nerskiy: folds 
kisgabeszkaa: folds 
fizruk5: raises $0.30 to $0.40
Boodoolai: folds 
Balintgergo88: calls $0.30
*** FLOP *** [8c Ad As]
fizruk5: checks 
Balintgergo88: checks 
*** TURN *** [8c Ad As] [9h]
fizruk5: bets $0.20
Balintgergo88: calls $0.20
*** RIVER *** [8c Ad As 9h] [Qh]
fizruk5: checks 
Balintgergo88: checks 
*** SHOW DOWN ***
fizruk5: shows [Qc Ks] (two pair, Aces and Queens)
Balintgergo88: mucks hand 
fizruk5 collected $1.24 from pot
*** SUMMARY ***
Total pot $1.30 | Rake $0.06 
Board [8c Ad As 9h Qh]
Seat 1: fizruk5 (small blind) showed [Qc Ks] and won ($1.24) with two pair, Aces and Queens
Seat 2: Boodoolai (big blind) folded before Flop
Seat 3: NooBeeK folded before Flop (didn't bet)
Seat 4: Balintgergo88 mucked
Seat 5: Gari Nerskiy folded before Flop (didn't bet)
Seat 6: kisgabeszkaa (button) folded before Flop (didn't bet)



PokerStars Hand #222949509214:  Hold'em No Limit ($0.05/$0.10 USD) - 2021/01/23 5:19:57 ET
Table 'Saito II' 6-max Seat #1 is the button
Seat 1: fizruk5 ($12.28 in chips) 
Seat 2: Boodoolai ($10.13 in chips) 
Seat 3: NooBeeK ($10 in chips) 
Seat 4: Balintgergo88 ($6.59 in chips) 
Seat 5: Gari Nerskiy ($10.40 in chips) 
Seat 6: kisgabeszkaa ($4.96 in chips) 
Boodoolai: posts small blind $0.05
NooBeeK: posts big blind $0.10
*** HOLE CARDS ***
Balintgergo88: folds 
Gari Nerskiy: folds 
kisgabeszkaa: calls $0.10
fizruk5: folds 
Boodoolai: folds 
NooBeeK: checks 
*** FLOP *** [8d Kd 7d]
NooBeeK: checks 
kisgabeszkaa: checks 
*** TURN *** [8d Kd 7d] [5h]
NooBeeK: bets $0.10
kisgabeszkaa: calls $0.10
*** RIVER *** [8d Kd 7d 5h] [Td]
NooBeeK: bets $0.32
kisgabeszkaa: calls $0.32
*** SHOW DOWN ***
NooBeeK: shows [6s 3c] (high card King)
kisgabeszkaa: shows [Kc Ks] (three of a kind, Kings)
kisgabeszkaa collected $1.04 from pot
*** SUMMARY ***
Total pot $1.09 | Rake $0.05 
Board [8d Kd 7d 5h Td]
Seat 1: fizruk5 (button) folded before Flop (didn't bet)
Seat 2: Boodoolai (small blind) folded before Flop
Seat 3: NooBeeK (big blind) showed [6s 3c] and lost with high card King
Seat 4: Balintgergo88 folded before Flop (didn't bet)
Seat 5: Gari Nerskiy folded before Flop (didn't bet)
Seat 6: kisgabeszkaa showed [Kc Ks] and won ($1.04) with three of a kind, Kings



PokerStars Hand #222949524010:  Hold'em No Limit ($0.05/$0.10 USD) - 2021/01/23 5:20:45 ET
Table 'Saito II' 6-max Seat #2 is the button
Seat 1: fizruk5 ($12.28 in chips) 
Seat 2: Boodoolai ($10.08 in chips) 
Seat 3: NooBeeK ($10 in chips) 
Seat 4: Balintgergo88 ($6.59 in chips) 
Seat 5: Gari Nerskiy ($10.40 in chips) 
Seat 6: kisgabeszkaa ($5.48 in chips) 
NooBeeK: posts small blind $0.05
Balintgergo88: posts big blind $0.10
*** HOLE CARDS ***
Gari Nerskiy: folds 
kisgabeszkaa: calls $0.10
fizruk5: folds 
Boodoolai: folds 
NooBeeK: calls $0.05
Balintgergo88: checks 
*** FLOP *** [Jh Kc Jc]
NooBeeK: checks 
Balintgergo88: checks 
kisgabeszkaa: checks 
*** TURN *** [Jh Kc Jc] [6s]
NooBeeK: bets $0.10
Balintgergo88: folds 
kisgabeszkaa: calls $0.10
*** RIVER *** [Jh Kc Jc 6s] [8d]
NooBeeK: bets $0.16
kisgabeszkaa: calls $0.16
*** SHOW DOWN ***
NooBeeK: shows [Kh 9d] (two pair, Kings and Jacks)
kisgabeszkaa: shows [Kd Td] (two pair, Kings and Jacks - Ten kicker)
kisgabeszkaa collected $0.78 from pot
*** SUMMARY ***
Total pot $0.82 | Rake $0.04 
Board [Jh Kc Jc 6s 8d]
Seat 1: fizruk5 folded before Flop (didn't bet)
Seat 2: Boodoolai (button) folded before Flop (didn't bet)
Seat 3: NooBeeK (small blind) showed [Kh 9d] and lost with two pair, Kings and Jacks
Seat 4: Balintgergo88 (big blind) folded on the Turn
Seat 5: Gari Nerskiy folded before Flop (didn't bet)
Seat 6: kisgabeszkaa showed [Kd Td] and won ($0.78) with two pair, Kings and Jacks



PokerStars Hand #222949534980:  Hold'em No Limit ($0.05/$0.10 USD) - 2021/01/23 5:21:22 ET
Table 'Saito II' 6-max Seat #3 is the button
Seat 1: fizruk5 ($12.28 in chips) 
Seat 2: Boodoolai ($10.08 in chips) 
Seat 3: NooBeeK ($10 in chips) 
Seat 4: Balintgergo88 ($6.49 in chips) 
Seat 5: Gari Nerskiy ($10.40 in chips) 
Seat 6: kisgabeszkaa ($5.90 in chips) 
Balintgergo88: posts small blind $0.05
Gari Nerskiy: posts big blind $0.10
*** HOLE CARDS ***
kisgabeszkaa: calls $0.10
fizruk5: calls $0.10
Boodoolai: folds 
NooBeeK: folds 
Balintgergo88: folds 
Gari Nerskiy: checks 
*** FLOP *** [8h 3c 5h]
Gari Nerskiy: checks 
kisgabeszkaa: checks 
fizruk5: bets $0.22
Balintgergo88 leaves the table
Gari Nerskiy: calls $0.22
Raikkoboy joins the table at seat #4 
kisgabeszkaa: folds 
*** TURN *** [8h 3c 5h] [7c]
kisgabeszkaa leaves the table
Gari Nerskiy: checks 
Laker_Style joins the table at seat #6 
fizruk5: checks 
*** RIVER *** [8h 3c 5h 7c] [Kc]
Gari Nerskiy: checks 
fizruk5: checks 
*** SHOW DOWN ***
Gari Nerskiy: shows [3d Qh] (a pair of Threes)
fizruk5: mucks hand 
Gari Nerskiy collected $0.75 from pot
*** SUMMARY ***
Total pot $0.79 | Rake $0.04 
Board [8h 3c 5h 7c Kc]
Seat 1: fizruk5 mucked
Seat 2: Boodoolai folded before Flop (didn't bet)
Seat 3: NooBeeK (button) folded before Flop (didn't bet)
Seat 4: Balintgergo88 (small blind) folded before Flop
Seat 5: Gari Nerskiy (big blind) showed [3d Qh] and won ($0.75) with a pair of Threes
Seat 6: kisgabeszkaa folded on the Flop



PokerStars Hand #222949552433:  Hold'em No Limit ($0.05/$0.10 USD) - 2021/01/23 5:22:19 ET
Table 'Saito II' 6-max Seat #5 is the button
Seat 1: fizruk5 ($11.96 in chips) 
Seat 2: Boodoolai ($10.08 in chips) 
Seat 3: NooBeeK ($10 in chips) 
Seat 5: Gari Nerskiy ($10.83 in chips) 
fizruk5: posts small blind $0.05
Boodoolai: posts big blind $0.10
Raikkoboy: sits out 
*** HOLE CARDS ***
NooBeeK: raises $0.15 to $0.25
Gari Nerskiy: folds 
fizruk5: folds 
Boodoolai: folds 
Uncalled bet ($0.15) returned to NooBeeK
NooBeeK collected $0.25 from pot
NooBeeK: doesn't show hand 
*** SUMMARY ***
Total pot $0.25 | Rake $0 
Seat 1: fizruk5 (small blind) folded before Flop
Seat 2: Boodoolai (big blind) folded before Flop
Seat 3: NooBeeK collected ($0.25)
Seat 5: Gari Nerskiy (button) folded before Flop (didn't bet)



PokerStars Hand #222949555625:  Hold'em No Limit ($0.05/$0.10 USD) - 2021/01/23 5:22:30 ET
Table 'Saito II' 6-max Seat #1 is the button
Seat 1: fizruk5 ($11.91 in chips) 
Seat 2: Boodoolai ($10 in chips) 
Seat 3: NooBeeK ($10.15 in chips) 
Seat 5: Gari Nerskiy ($10.83 in chips) 
Boodoolai: posts small blind $0.05
NooBeeK: posts big blind $0.10
Raikkoboy: sits out 
Laker_Style: sits out 
*** HOLE CARDS ***
Gari Nerskiy: folds 
fizruk5: folds 
Boodoolai: folds 
Uncalled bet ($0.05) returned to NooBeeK
NooBeeK collected $0.10 from pot
NooBeeK: doesn't show hand 
*** SUMMARY ***
Total pot $0.10 | Rake $0 
Seat 1: fizruk5 (button) folded before Flop (didn't bet)
Seat 2: Boodoolai (small blind) folded before Flop
Seat 3: NooBeeK (big blind) collected ($0.10)
Seat 5: Gari Nerskiy folded before Flop (didn't bet)



PokerStars Hand #222949557708:  Hold'em No Limit ($0.05/$0.10 USD) - 2021/01/23 5:22:37 ET
Table 'Saito II' 6-max Seat #2 is the button
Seat 1: fizruk5 ($11.91 in chips) 
Seat 2: Boodoolai ($10 in chips) 
Seat 3: NooBeeK ($10.20 in chips) 
Seat 4: Raikkoboy ($10 in chips) 
Seat 5: Gari Nerskiy ($10.83 in chips) 
NooBeeK: posts small blind $0.05
Raikkoboy: posts big blind $0.10
Laker_Style: sits out 
*** HOLE CARDS ***
Gari Nerskiy: folds 
fizruk5: folds 
Boodoolai: raises $0.15 to $0.25
NooBeeK: folds 
Raikkoboy: folds 
Uncalled bet ($0.15) returned to Boodoolai
Boodoolai collected $0.25 from pot
Boodoolai: doesn't show hand 
*** SUMMARY ***
Total pot $0.25 | Rake $0 
Seat 1: fizruk5 folded before Flop (didn't bet)
Seat 2: Boodoolai (button) collected ($0.25)
Seat 3: NooBeeK (small blind) folded before Flop
Seat 4: Raikkoboy (big blind) folded before Flop
Seat 5: Gari Nerskiy folded before Flop (didn't bet)



PokerStars Hand #222949562186:  Hold'em No Limit ($0.05/$0.10 USD) - 2021/01/23 5:22:52 ET
Table 'Saito II' 6-max Seat #3 is the button
Seat 1: fizruk5 ($11.91 in chips) 
Seat 2: Boodoolai ($10.15 in chips) 
Seat 3: NooBeeK ($10.15 in chips) 
Seat 4: Raikkoboy ($10 in chips) 
Seat 5: Gari Nerskiy ($10.83 in chips) 
Raikkoboy: posts small blind $0.05
Gari Nerskiy: posts big blind $0.10
Laker_Style: sits out 
*** HOLE CARDS ***
fizruk5: folds 
Boodoolai: folds 
NooBeeK: raises $0.15 to $0.25
Raikkoboy: folds 
Gari Nerskiy: calls $0.15
*** FLOP *** [9c 2c 4d]
Gari Nerskiy: checks 
NooBeeK: checks 
*** TURN *** [9c 2c 4d] [4h]
Gari Nerskiy: bets $0.33
NooBeeK: folds 
Uncalled bet ($0.33) returned to Gari Nerskiy
Gari Nerskiy collected $0.53 from pot
Gari Nerskiy: doesn't show hand 
*** SUMMARY ***
Total pot $0.55 | Rake $0.02 
Board [9c 2c 4d 4h]
Seat 1: fizruk5 folded before Flop (didn't bet)
Seat 2: Boodoolai folded before Flop (didn't bet)
Seat 3: NooBeeK (button) folded on the Turn
Seat 4: Raikkoboy (small blind) folded before Flop
Seat 5: Gari Nerskiy (big blind) collected ($0.53)



PokerStars Hand #222949572299:  Hold'em No Limit ($0.05/$0.10 USD) - 2021/01/23 5:23:25 ET
Table 'Saito II' 6-max Seat #4 is the button
Seat 1: fizruk5 ($11.91 in chips) 
Seat 2: Boodoolai ($10.15 in chips) 
Seat 3: NooBeeK ($10 in chips) 
Seat 4: Raikkoboy ($10 in chips) 
Seat 5: Gari Nerskiy ($11.11 in chips) 
Seat 6: Laker_Style ($10 in chips) 
Gari Nerskiy: posts small blind $0.05
Laker_Style: posts big blind $0.10
*** HOLE CARDS ***
fizruk5: folds 
Boodoolai: folds 
NooBeeK: folds 
Raikkoboy: folds 
Gari Nerskiy: raises $0.20 to $0.30
Laker_Style: folds 
Uncalled bet ($0.20) returned to Gari Nerskiy
Gari Nerskiy collected $0.20 from pot
Gari Nerskiy: doesn't show hand 
*** SUMMARY ***
Total pot $0.20 | Rake $0 
Seat 1: fizruk5 folded before Flop (didn't bet)
Seat 2: Boodoolai folded before Flop (didn't bet)
Seat 3: NooBeeK folded before Flop (didn't bet)
Seat 4: Raikkoboy (button) folded before Flop (didn't bet)
Seat 5: Gari Nerskiy (small blind) collected ($0.20)
Seat 6: Laker_Style (big blind) folded before Flop



PokerStars Hand #222949579985:  Hold'em No Limit ($0.05/$0.10 USD) - 2021/01/23 5:23:51 ET
Table 'Saito II' 6-max Seat #5 is the button
Seat 1: fizruk5 ($11.91 in chips) 
Seat 2: Boodoolai ($10.15 in chips) 
Seat 3: NooBeeK ($10 in chips) 
Seat 4: Raikkoboy ($10 in chips) 
Seat 5: Gari Nerskiy ($11.21 in chips) 
Seat 6: Laker_Style ($10 in chips) 
Laker_Style: posts small blind $0.05
fizruk5: posts big blind $0.10
*** HOLE CARDS ***
Boodoolai: folds 
NooBeeK: folds 
Raikkoboy: raises $0.14 to $0.24
Gari Nerskiy: folds 
Laker_Style: folds 
fizruk5: raises $0.61 to $0.85
Raikkoboy: raises $1.25 to $2.10
fizruk5: folds 
Uncalled bet ($1.25) returned to Raikkoboy
Raikkoboy collected $1.75 from pot
Raikkoboy: doesn't show hand 
*** SUMMARY ***
Total pot $1.75 | Rake $0 
Seat 1: fizruk5 (big blind) folded before Flop
Seat 2: Boodoolai folded before Flop (didn't bet)
Seat 3: NooBeeK folded before Flop (didn't bet)
Seat 4: Raikkoboy collected ($1.75)
Seat 5: Gari Nerskiy (button) folded before Flop (didn't bet)
Seat 6: Laker_Style (small blind) folded before Flop



PokerStars Hand #222949595277:  Hold'em No Limit ($0.05/$0.10 USD) - 2021/01/23 5:24:41 ET
Table 'Saito II' 6-max Seat #6 is the button
Seat 1: fizruk5 ($11.06 in chips) 
Seat 2: Boodoolai ($10.15 in chips) 
Seat 3: NooBeeK ($10 in chips) 
Seat 4: Raikkoboy ($10.90 in chips) 
Seat 5: Gari Nerskiy ($11.21 in chips) 
Seat 6: Laker_Style ($10 in chips) 
fizruk5: posts small blind $0.05
Boodoolai: posts big blind $0.10
*** HOLE CARDS ***
NooBeeK: raises $0.15 to $0.25
Raikkoboy: folds 
Gari Nerskiy: folds 
Laker_Style: folds 
fizruk5: folds 
Boodoolai: folds 
Uncalled bet ($0.15) returned to NooBeeK
NooBeeK collected $0.25 from pot
NooBeeK: doesn't show hand 
*** SUMMARY ***
Total pot $0.25 | Rake $0 
Seat 1: fizruk5 (small blind) folded before Flop
Seat 2: Boodoolai (big blind) folded before Flop
Seat 3: NooBeeK collected ($0.25)
Seat 4: Raikkoboy folded before Flop (didn't bet)
Seat 5: Gari Nerskiy folded before Flop (didn't bet)
Seat 6: Laker_Style (button) folded before Flop (didn't bet)



PokerStars Hand #222949599205:  Hold'em No Limit ($0.05/$0.10 USD) - 2021/01/23 5:24:54 ET
Table 'Saito II' 6-max Seat #1 is the button
Seat 1: fizruk5 ($11.01 in chips) 
Seat 2: Boodoolai ($10.05 in chips) 
Seat 4: Raikkoboy ($10.90 in chips) 
Seat 5: Gari Nerskiy ($11.21 in chips) 
Seat 6: Laker_Style ($10 in chips) 
Boodoolai: posts small blind $0.05
NooBeeK: is sitting out 
Raikkoboy: posts big blind $0.10
*** HOLE CARDS ***
Gari Nerskiy: folds 
Laker_Style: folds 
fizruk5: folds 
Boodoolai: folds 
Uncalled bet ($0.05) returned to Raikkoboy
Raikkoboy collected $0.10 from pot
Raikkoboy: doesn't show hand 
*** SUMMARY ***
Total pot $0.10 | Rake $0 
Seat 1: fizruk5 (button) folded before Flop (didn't bet)
Seat 2: Boodoolai (small blind) folded before Flop
Seat 4: Raikkoboy (big blind) collected ($0.10)
Seat 5: Gari Nerskiy folded before Flop (didn't bet)
Seat 6: Laker_Style folded before Flop (didn't bet)



PokerStars Hand #222949601764:  Hold'em No Limit ($0.05/$0.10 USD) - 2021/01/23 5:25:02 ET
Table 'Saito II' 6-max Seat #2 is the button
Seat 1: fizruk5 ($11.01 in chips) 
Seat 2: Boodoolai ($10 in chips) 
Seat 4: Raikkoboy ($10.95 in chips) 
Seat 5: Gari Nerskiy ($11.21 in chips) 
Seat 6: Laker_Style ($10 in chips) 
Raikkoboy: posts small blind $0.05
Gari Nerskiy: posts big blind $0.10
*** HOLE CARDS ***
NooBeeK leaves the table
BestAger joins the table at seat #3 
Laker_Style: raises $0.20 to $0.30
fizruk5: calls $0.30
Boodoolai: folds 
Raikkoboy: folds 
Gari Nerskiy: folds 
*** FLOP *** [6d 6c 9c]
Laker_Style: bets $0.50
fizruk5: calls $0.50
*** TURN *** [6d 6c 9c] [8s]
Laker_Style: bets $1.34
fizruk5: calls $1.34
*** RIVER *** [6d 6c 9c 8s] [Ah]
Laker_Style: checks 
fizruk5: bets $2.82
Laker_Style: calls $2.82
*** SHOW DOWN ***
fizruk5: shows [Qc Ac] (two pair, Aces and Sixes)
Laker_Style: mucks hand 
fizruk5 collected $9.62 from pot
*** SUMMARY ***
Total pot $10.07 | Rake $0.45 
Board [6d 6c 9c 8s Ah]
Seat 1: fizruk5 showed [Qc Ac] and won ($9.62) with two pair, Aces and Sixes
Seat 2: Boodoolai (button) folded before Flop (didn't bet)
Seat 4: Raikkoboy (small blind) folded before Flop
Seat 5: Gari Nerskiy (big blind) folded before Flop
Seat 6: Laker_Style mucked



PokerStars Hand #222949614523:  Hold'em No Limit ($0.05/$0.10 USD) - 2021/01/23 5:25:44 ET
Table 'Saito II' 6-max Seat #4 is the button
Seat 1: fizruk5 ($15.67 in chips) 
Seat 2: Boodoolai ($10 in chips) 
Seat 3: BestAger ($8 in chips) 
Seat 4: Raikkoboy ($10.90 in chips) 
Seat 5: Gari Nerskiy ($11.11 in chips) 
Seat 6: Laker_Style ($10 in chips) 
Gari Nerskiy: posts small blind $0.05
Laker_Style: posts big blind $0.10
BestAger: posts big blind $0.10
*** HOLE CARDS ***
fizruk5: folds 
Boodoolai: folds 
BestAger: checks 
Raikkoboy: folds 
Gari Nerskiy: folds 
Laker_Style: checks 
*** FLOP *** [2h 2d 8h]
Laker_Style: checks 
BestAger: checks 
*** TURN *** [2h 2d 8h] [Ac]
Laker_Style: checks 
BestAger: checks 
*** RIVER *** [2h 2d 8h Ac] [7d]
Laker_Style: checks 
BestAger: checks 
*** SHOW DOWN ***
Laker_Style: shows [Jd 5c] (a pair of Deuces)
BestAger: shows [6d Kh] (a pair of Deuces - Ace+King kicker)
BestAger collected $0.24 from pot
*** SUMMARY ***
Total pot $0.25 | Rake $0.01 
Board [2h 2d 8h Ac 7d]
Seat 1: fizruk5 folded before Flop (didn't bet)
Seat 2: Boodoolai folded before Flop (didn't bet)
Seat 3: BestAger showed [6d Kh] and won ($0.24) with a pair of Deuces
Seat 4: Raikkoboy (button) folded before Flop (didn't bet)
Seat 5: Gari Nerskiy (small blind) folded before Flop
Seat 6: Laker_Style (big blind) showed [Jd 5c] and lost with a pair of Deuces



PokerStars Hand #222949626505:  Hold'em No Limit ($0.05/$0.10 USD) - 2021/01/23 5:26:23 ET
Table 'Saito II' 6-max Seat #5 is the button
Seat 1: fizruk5 ($15.67 in chips) 
Seat 2: Boodoolai ($10 in chips) 
Seat 3: BestAger ($8.14 in chips) 
Seat 4: Raikkoboy ($10.90 in chips) 
Seat 5: Gari Nerskiy ($11.06 in chips) 
Seat 6: Laker_Style ($10 in chips) 
Laker_Style: posts small blind $0.05
fizruk5: posts big blind $0.10
*** HOLE CARDS ***
Boodoolai: folds 
BestAger: folds 
Raikkoboy: folds 
Gari Nerskiy: raises $0.10 to $0.20
Laker_Style: folds 
fizruk5: calls $0.10
*** FLOP *** [7c 7h 2d]
fizruk5: checks 
Gari Nerskiy: bets $0.12
fizruk5: calls $0.12
*** TURN *** [7c 7h 2d] [4h]
fizruk5: checks 
Gari Nerskiy: bets $0.53
fizruk5: folds 
Uncalled bet ($0.53) returned to Gari Nerskiy
Gari Nerskiy collected $0.66 from pot
Gari Nerskiy: doesn't show hand 
*** SUMMARY ***
Total pot $0.69 | Rake $0.03 
Board [7c 7h 2d 4h]
Seat 1: fizruk5 (big blind) folded on the Turn
Seat 2: Boodoolai folded before Flop (didn't bet)
Seat 3: BestAger folded before Flop (didn't bet)
Seat 4: Raikkoboy folded before Flop (didn't bet)
Seat 5: Gari Nerskiy (button) collected ($0.66)
Seat 6: Laker_Style (small blind) folded before Flop



PokerStars Hand #222949641899:  Hold'em No Limit ($0.05/$0.10 USD) - 2021/01/23 5:27:14 ET
Table 'Saito II' 6-max Seat #6 is the button
Seat 1: fizruk5 ($15.35 in chips) 
Seat 2: Boodoolai ($10 in chips) 
Seat 3: BestAger ($8.14 in chips) 
Seat 4: Raikkoboy ($10.90 in chips) 
Seat 5: Gari Nerskiy ($11.40 in chips) 
Seat 6: Laker_Style ($10 in chips) 
fizruk5: posts small blind $0.05
Boodoolai: posts big blind $0.10
*** HOLE CARDS ***
BestAger: folds 
Raikkoboy: raises $0.14 to $0.24
Gari Nerskiy: folds 
Laker_Style: folds 
fizruk5: folds 
Boodoolai: folds 
Uncalled bet ($0.14) returned to Raikkoboy
Raikkoboy collected $0.25 from pot
Raikkoboy: doesn't show hand 
*** SUMMARY ***
Total pot $0.25 | Rake $0 
Seat 1: fizruk5 (small blind) folded before Flop
Seat 2: Boodoolai (big blind) folded before Flop
Seat 3: BestAger folded before Flop (didn't bet)
Seat 4: Raikkoboy collected ($0.25)
Seat 5: Gari Nerskiy folded before Flop (didn't bet)
Seat 6: Laker_Style (button) folded before Flop (didn't bet)



PokerStars Hand #222949647365:  Hold'em No Limit ($0.05/$0.10 USD) - 2021/01/23 5:27:32 ET
Table 'Saito II' 6-max Seat #1 is the button
Seat 1: fizruk5 ($15.30 in chips) 
Seat 2: Boodoolai ($10 in chips) 
Seat 3: BestAger ($8.14 in chips) 
Seat 4: Raikkoboy ($11.05 in chips) 
Seat 5: Gari Nerskiy ($11.40 in chips) 
Seat 6: Laker_Style ($10 in chips) 
Boodoolai: posts small blind $0.05
BestAger: posts big blind $0.10
*** HOLE CARDS ***
Raikkoboy: folds 
Gari Nerskiy: raises $0.20 to $0.30
Laker_Style: folds 
fizruk5: folds 
Boodoolai: folds 
BestAger: raises $0.50 to $0.80
Gari Nerskiy: folds 
Uncalled bet ($0.50) returned to BestAger
BestAger collected $0.65 from pot
BestAger: doesn't show hand 
*** SUMMARY ***
Total pot $0.65 | Rake $0 
Seat 1: fizruk5 (button) folded before Flop (didn't bet)
Seat 2: Boodoolai (small blind) folded before Flop
Seat 3: BestAger (big blind) collected ($0.65)
Seat 4: Raikkoboy folded before Flop (didn't bet)
Seat 5: Gari Nerskiy folded before Flop
Seat 6: Laker_Style folded before Flop (didn't bet)



PokerStars Hand #222949656625:  Hold'em No Limit ($0.05/$0.10 USD) - 2021/01/23 5:28:03 ET
Table 'Saito II' 6-max Seat #2 is the button
Seat 1: fizruk5 ($15.30 in chips) 
Seat 2: Boodoolai ($10 in chips) 
Seat 3: BestAger ($8.49 in chips) 
Seat 4: Raikkoboy ($11.05 in chips) 
Seat 5: Gari Nerskiy ($11.10 in chips) 
Seat 6: Laker_Style ($10 in chips) 
BestAger: posts small blind $0.05
Raikkoboy: posts big blind $0.10
*** HOLE CARDS ***
Gari Nerskiy: folds 
Laker_Style: folds 
fizruk5: folds 
Boodoolai: raises $0.15 to $0.25
BestAger: folds 
Raikkoboy: calls $0.15
*** FLOP *** [8s 4s Ad]
Raikkoboy: checks 
Boodoolai: bets $0.25
Raikkoboy: calls $0.25
*** TURN *** [8s 4s Ad] [Qd]
Raikkoboy: checks 
Boodoolai: bets $0.60
Raikkoboy: folds 
Uncalled bet ($0.60) returned to Boodoolai
Boodoolai collected $1 from pot
Boodoolai: doesn't show hand 
*** SUMMARY ***
Total pot $1.05 | Rake $0.05 
Board [8s 4s Ad Qd]
Seat 1: fizruk5 folded before Flop (didn't bet)
Seat 2: Boodoolai (button) collected ($1)
Seat 3: BestAger (small blind) folded before Flop
Seat 4: Raikkoboy (big blind) folded on the Turn
Seat 5: Gari Nerskiy folded before Flop (didn't bet)
Seat 6: Laker_Style folded before Flop (didn't bet)



PokerStars Hand #222949667274:  Hold'em No Limit ($0.05/$0.10 USD) - 2021/01/23 5:28:38 ET
Table 'Saito II' 6-max Seat #3 is the button
Seat 1: fizruk5 ($15.30 in chips) 
Seat 2: Boodoolai ($10.50 in chips) 
Seat 3: BestAger ($8.44 in chips) 
Seat 4: Raikkoboy ($10.55 in chips) 
Seat 5: Gari Nerskiy ($11.10 in chips) 
Seat 6: Laker_Style ($10 in chips) 
Raikkoboy: posts small blind $0.05
Gari Nerskiy: posts big blind $0.10
*** HOLE CARDS ***
Laker_Style: folds 
fizruk5: raises $0.20 to $0.30
Boodoolai: folds 
BestAger: calls $0.30
Raikkoboy: folds 
Gari Nerskiy: folds 
*** FLOP *** [6d Js Kd]
fizruk5: checks 
BestAger: bets $0.30
fizruk5: calls $0.30
*** TURN *** [6d Js Kd] [6c]
fizruk5: checks 
BestAger: bets $0.50
fizruk5: folds 
Uncalled bet ($0.50) returned to BestAger
BestAger collected $1.29 from pot
BestAger: doesn't show hand 
*** SUMMARY ***
Total pot $1.35 | Rake $0.06 
Board [6d Js Kd 6c]
Seat 1: fizruk5 folded on the Turn
Seat 2: Boodoolai folded before Flop (didn't bet)
Seat 3: BestAger (button) collected ($1.29)
Seat 4: Raikkoboy (small blind) folded before Flop
Seat 5: Gari Nerskiy (big blind) folded before Flop
Seat 6: Laker_Style folded before Flop (didn't bet)



PokerStars Hand #222949680280:  Hold'em No Limit ($0.05/$0.10 USD) - 2021/01/23 5:29:20 ET
Table 'Saito II' 6-max Seat #4 is the button
Seat 1: fizruk5 ($14.70 in chips) 
Seat 2: Boodoolai ($10.50 in chips) 
Seat 3: BestAger ($9.13 in chips) 
Seat 4: Raikkoboy ($10.50 in chips) 
Seat 5: Gari Nerskiy ($11 in chips) 
Seat 6: Laker_Style ($10 in chips) 
Gari Nerskiy: posts small blind $0.05
Laker_Style: posts big blind $0.10
*** HOLE CARDS ***
fizruk5: folds 
Boodoolai: folds 
BestAger: raises $0.20 to $0.30
Raikkoboy: folds 
Gari Nerskiy: folds 
Laker_Style: folds 
Uncalled bet ($0.20) returned to BestAger
BestAger collected $0.25 from pot
BestAger: doesn't show hand 
*** SUMMARY ***
Total pot $0.25 | Rake $0 
Seat 1: fizruk5 folded before Flop (didn't bet)
Seat 2: Boodoolai folded before Flop (didn't bet)
Seat 3: BestAger collected ($0.25)
Seat 4: Raikkoboy (button) folded before Flop (didn't bet)
Seat 5: Gari Nerskiy (small blind) folded before Flop
Seat 6: Laker_Style (big blind) folded before Flop



PokerStars Hand #222949686282:  Hold'em No Limit ($0.05/$0.10 USD) - 2021/01/23 5:29:40 ET
Table 'Saito II' 6-max Seat #5 is the button
Seat 1: fizruk5 ($14.70 in chips) 
Seat 2: Boodoolai ($10.50 in chips) 
Seat 3: BestAger ($9.28 in chips) 
Seat 4: Raikkoboy ($10.50 in chips) 
Seat 5: Gari Nerskiy ($10.95 in chips) 
Seat 6: Laker_Style ($10 in chips) 
Laker_Style: posts small blind $0.05
fizruk5: posts big blind $0.10
*** HOLE CARDS ***
Boodoolai: folds 
BestAger: folds 
Raikkoboy: folds 
Gari Nerskiy: folds 
Laker_Style: raises $0.20 to $0.30
fizruk5: calls $0.20
*** FLOP *** [Qs 3h Kh]
Laker_Style: bets $0.40
fizruk5: folds 
Uncalled bet ($0.40) returned to Laker_Style
Laker_Style collected $0.57 from pot
Laker_Style: doesn't show hand 
*** SUMMARY ***
Total pot $0.60 | Rake $0.03 
Board [Qs 3h Kh]
Seat 1: fizruk5 (big blind) folded on the Flop
Seat 2: Boodoolai folded before Flop (didn't bet)
Seat 3: BestAger folded before Flop (didn't bet)
Seat 4: Raikkoboy folded before Flop (didn't bet)
Seat 5: Gari Nerskiy (button) folded before Flop (didn't bet)
Seat 6: Laker_Style (small blind) collected ($0.57)



PokerStars Hand #222949693650:  Hold'em No Limit ($0.05/$0.10 USD) - 2021/01/23 5:30:04 ET
Table 'Saito II' 6-max Seat #6 is the button
Seat 1: fizruk5 ($14.40 in chips) 
Seat 2: Boodoolai ($10.50 in chips) 
Seat 3: BestAger ($9.28 in chips) 
Seat 4: Raikkoboy ($10.50 in chips) 
Seat 5: Gari Nerskiy ($10.95 in chips) 
Seat 6: Laker_Style ($10.27 in chips) 
fizruk5: posts small blind $0.05
Boodoolai: posts big blind $0.10
*** HOLE CARDS ***
BestAger: raises $0.20 to $0.30
Raikkoboy: folds 
Gari Nerskiy: folds 
Laker_Style: folds 
fizruk5: folds 
Boodoolai: calls $0.20
*** FLOP *** [3d 5h Kh]
Boodoolai: checks 
BestAger: bets $0.20
Boodoolai: calls $0.20
*** TURN *** [3d 5h Kh] [Js]
Boodoolai: checks 
BestAger: checks 
*** RIVER *** [3d 5h Kh Js] [7s]
Boodoolai: bets $0.70
BestAger: folds 
Uncalled bet ($0.70) returned to Boodoolai
Boodoolai collected $1 from pot
Boodoolai: doesn't show hand 
*** SUMMARY ***
Total pot $1.05 | Rake $0.05 
Board [3d 5h Kh Js 7s]
Seat 1: fizruk5 (small blind) folded before Flop
Seat 2: Boodoolai (big blind) collected ($1)
Seat 3: BestAger folded on the River
Seat 4: Raikkoboy folded before Flop (didn't bet)
Seat 5: Gari Nerskiy folded before Flop (didn't bet)
Seat 6: Laker_Style (button) folded before Flop (didn't bet)



PokerStars Hand #222949710551:  Hold'em No Limit ($0.05/$0.10 USD) - 2021/01/23 5:30:59 ET
Table 'Saito II' 6-max Seat #1 is the button
Seat 1: fizruk5 ($14.35 in chips) 
Seat 2: Boodoolai ($11 in chips) 
Seat 3: BestAger ($8.78 in chips) 
Seat 4: Raikkoboy ($10.50 in chips) 
Seat 5: Gari Nerskiy ($10.95 in chips) 
Seat 6: Laker_Style ($10.27 in chips) 
Boodoolai: posts small blind $0.05
BestAger: posts big blind $0.10
*** HOLE CARDS ***
Raikkoboy: folds 
Gari Nerskiy: folds 
Laker_Style: raises $0.20 to $0.30
fizruk5: folds 
Boodoolai: folds 
BestAger: calls $0.20
*** FLOP *** [Th 6h 4h]
BestAger: bets $0.30
Laker_Style: calls $0.30
*** TURN *** [Th 6h 4h] [7h]
BestAger: bets $0.30
Laker_Style: folds 
Uncalled bet ($0.30) returned to BestAger
BestAger collected $1.19 from pot
BestAger: doesn't show hand 
*** SUMMARY ***
Total pot $1.25 | Rake $0.06 
Board [Th 6h 4h 7h]
Seat 1: fizruk5 (button) folded before Flop (didn't bet)
Seat 2: Boodoolai (small blind) folded before Flop
Seat 3: BestAger (big blind) collected ($1.19)
Seat 4: Raikkoboy folded before Flop (didn't bet)
Seat 5: Gari Nerskiy folded before Flop (didn't bet)
Seat 6: Laker_Style folded on the Turn



PokerStars Hand #222949727106:  Hold'em No Limit ($0.05/$0.10 USD) - 2021/01/23 5:31:53 ET
Table 'Saito II' 6-max Seat #2 is the button
Seat 1: fizruk5 ($14.35 in chips) 
Seat 2: Boodoolai ($10.95 in chips) 
Seat 3: BestAger ($9.37 in chips) 
Seat 4: Raikkoboy ($10.50 in chips) 
Seat 5: Gari Nerskiy ($10.95 in chips) 
Seat 6: Laker_Style ($10 in chips) 
BestAger: posts small blind $0.05
Raikkoboy: posts big blind $0.10
*** HOLE CARDS ***
Gari Nerskiy: folds 
Laker_Style: raises $0.20 to $0.30
fizruk5: folds 
Boodoolai: folds 
BestAger: folds 
Raikkoboy: calls $0.20
*** FLOP *** [Ah Jh 8d]
Raikkoboy: checks 
Laker_Style: bets $0.31
Raikkoboy: folds 
Uncalled bet ($0.31) returned to Laker_Style
Laker_Style collected $0.62 from pot
Laker_Style: doesn't show hand 
*** SUMMARY ***
Total pot $0.65 | Rake $0.03 
Board [Ah Jh 8d]
Seat 1: fizruk5 folded before Flop (didn't bet)
Seat 2: Boodoolai (button) folded before Flop (didn't bet)
Seat 3: BestAger (small blind) folded before Flop
Seat 4: Raikkoboy (big blind) folded on the Flop
Seat 5: Gari Nerskiy folded before Flop (didn't bet)
Seat 6: Laker_Style collected ($0.62)



PokerStars Hand #222949741705:  Hold'em No Limit ($0.05/$0.10 USD) - 2021/01/23 5:32:40 ET
Table 'Saito II' 6-max Seat #3 is the button
Seat 1: fizruk5 ($14.35 in chips) 
Seat 2: Boodoolai ($10.95 in chips) 
Seat 3: BestAger ($9.32 in chips) 
Seat 4: Raikkoboy ($10.20 in chips) 
Seat 5: Gari Nerskiy ($10.95 in chips) 
Seat 6: Laker_Style ($10.32 in chips) 
Raikkoboy: posts small blind $0.05
Gari Nerskiy: posts big blind $0.10
*** HOLE CARDS ***
Laker_Style: folds 
fizruk5: folds 
Boodoolai: folds 
BestAger: raises $0.20 to $0.30
Raikkoboy: folds 
Gari Nerskiy: calls $0.20
*** FLOP *** [3h 4s Qc]
Gari Nerskiy: checks 
BestAger: checks 
*** TURN *** [3h 4s Qc] [Tc]
Gari Nerskiy: bets $0.50
BestAger: folds 
Uncalled bet ($0.50) returned to Gari Nerskiy
Gari Nerskiy collected $0.62 from pot
Gari Nerskiy: doesn't show hand 
*** SUMMARY ***
Total pot $0.65 | Rake $0.03 
Board [3h 4s Qc Tc]
Seat 1: fizruk5 folded before Flop (didn't bet)
Seat 2: Boodoolai folded before Flop (didn't bet)
Seat 3: BestAger (button) folded on the Turn
Seat 4: Raikkoboy (small blind) folded before Flop
Seat 5: Gari Nerskiy (big blind) collected ($0.62)
Seat 6: Laker_Style folded before Flop (didn't bet)



PokerStars Hand #222949749461:  Hold'em No Limit ($0.05/$0.10 USD) - 2021/01/23 5:33:05 ET
Table 'Saito II' 6-max Seat #4 is the button
Seat 1: fizruk5 ($14.35 in chips) 
Seat 2: Boodoolai ($10.95 in chips) 
Seat 3: BestAger ($9.02 in chips) 
Seat 4: Raikkoboy ($10.15 in chips) 
Seat 5: Gari Nerskiy ($11.27 in chips) 
Seat 6: Laker_Style ($10.32 in chips) 
Gari Nerskiy: posts small blind $0.05
Laker_Style: posts big blind $0.10
*** HOLE CARDS ***
fizruk5: folds 
Boodoolai: folds 
BestAger: folds 
Raikkoboy: folds 
Gari Nerskiy: raises $0.20 to $0.30
Laker_Style: folds 
Uncalled bet ($0.20) returned to Gari Nerskiy
Gari Nerskiy collected $0.20 from pot
Gari Nerskiy: doesn't show hand 
*** SUMMARY ***
Total pot $0.20 | Rake $0 
Seat 1: fizruk5 folded before Flop (didn't bet)
Seat 2: Boodoolai folded before Flop (didn't bet)
Seat 3: BestAger folded before Flop (didn't bet)
Seat 4: Raikkoboy (button) folded before Flop (didn't bet)
Seat 5: Gari Nerskiy (small blind) collected ($0.20)
Seat 6: Laker_Style (big blind) folded before Flop



PokerStars Hand #222949755797:  Hold'em No Limit ($0.05/$0.10 USD) - 2021/01/23 5:33:26 ET
Table 'Saito II' 6-max Seat #5 is the button
Seat 1: fizruk5 ($14.35 in chips) 
Seat 2: Boodoolai ($10.95 in chips) 
Seat 3: BestAger ($9.02 in chips) 
Seat 4: Raikkoboy ($10.15 in chips) 
Seat 5: Gari Nerskiy ($11.37 in chips) 
Seat 6: Laker_Style ($10.22 in chips) 
Laker_Style: posts small blind $0.05
fizruk5: posts big blind $0.10
*** HOLE CARDS ***
Boodoolai: folds 
BestAger: folds 
Raikkoboy: folds 
Gari Nerskiy: raises $0.10 to $0.20
Laker_Style: folds 
fizruk5: folds 
Uncalled bet ($0.10) returned to Gari Nerskiy
Gari Nerskiy collected $0.25 from pot
Gari Nerskiy: doesn't show hand 
*** SUMMARY ***
Total pot $0.25 | Rake $0 
Seat 1: fizruk5 (big blind) folded before Flop
Seat 2: Boodoolai folded before Flop (didn't bet)
Seat 3: BestAger folded before Flop (didn't bet)
Seat 4: Raikkoboy folded before Flop (didn't bet)
Seat 5: Gari Nerskiy (button) collected ($0.25)
Seat 6: Laker_Style (small blind) folded before Flop



PokerStars Hand #222949763015:  Hold'em No Limit ($0.05/$0.10 USD) - 2021/01/23 5:33:49 ET
Table 'Saito II' 6-max Seat #6 is the button
Seat 1: fizruk5 ($14.25 in chips) 
Seat 2: Boodoolai ($10.95 in chips) 
Seat 3: BestAger ($9.02 in chips) 
Seat 4: Raikkoboy ($10.15 in chips) 
Seat 5: Gari Nerskiy ($11.52 in chips) 
Seat 6: Laker_Style ($10.17 in chips) 
fizruk5: posts small blind $0.05
Boodoolai: posts big blind $0.10
*** HOLE CARDS ***
BestAger: raises $0.20 to $0.30
Raikkoboy: folds 
Gari Nerskiy: folds 
Laker_Style: folds 
fizruk5: calls $0.25
Boodoolai: folds 
*** FLOP *** [Ah 8h 3h]
fizruk5: checks 
BestAger: checks 
*** TURN *** [Ah 8h 3h] [7s]
fizruk5: bets $0.45
BestAger: calls $0.45
*** RIVER *** [Ah 8h 3h 7s] [6d]
fizruk5: checks 
BestAger: checks 
*** SHOW DOWN ***
fizruk5: shows [Qh Ac] (a pair of Aces)
BestAger: mucks hand 
fizruk5 collected $1.53 from pot
*** SUMMARY ***
Total pot $1.60 | Rake $0.07 
Board [Ah 8h 3h 7s 6d]
Seat 1: fizruk5 (small blind) showed [Qh Ac] and won ($1.53) with a pair of Aces
Seat 2: Boodoolai (big blind) folded before Flop
Seat 3: BestAger mucked
Seat 4: Raikkoboy folded before Flop (didn't bet)
Seat 5: Gari Nerskiy folded before Flop (didn't bet)
Seat 6: Laker_Style (button) folded before Flop (didn't bet)



PokerStars Hand #222949772249:  Hold'em No Limit ($0.05/$0.10 USD) - 2021/01/23 5:34:19 ET
Table 'Saito II' 6-max Seat #1 is the button
Seat 1: fizruk5 ($15.03 in chips) 
Seat 2: Boodoolai ($10.85 in chips) 
Seat 3: BestAger ($8.27 in chips) 
Seat 4: Raikkoboy ($10.15 in chips) 
Seat 5: Gari Nerskiy ($11.52 in chips) 
Seat 6: Laker_Style ($10.17 in chips) 
Boodoolai: posts small blind $0.05
BestAger: posts big blind $0.10
*** HOLE CARDS ***
Raikkoboy: folds 
Gari Nerskiy: folds 
Laker_Style: folds 
fizruk5: raises $0.15 to $0.25
Boodoolai: folds 
BestAger: raises $0.55 to $0.80
fizruk5: folds 
Uncalled bet ($0.55) returned to BestAger
BestAger collected $0.55 from pot
BestAger: doesn't show hand 
*** SUMMARY ***
Total pot $0.55 | Rake $0 
Seat 1: fizruk5 (button) folded before Flop
Seat 2: Boodoolai (small blind) folded before Flop
Seat 3: BestAger (big blind) collected ($0.55)
Seat 4: Raikkoboy folded before Flop (didn't bet)
Seat 5: Gari Nerskiy folded before Flop (didn't bet)
Seat 6: Laker_Style folded before Flop (didn't bet)



PokerStars Hand #222949780948:  Hold'em No Limit ($0.05/$0.10 USD) - 2021/01/23 5:34:46 ET
Table 'Saito II' 6-max Seat #2 is the button
Seat 1: fizruk5 ($14.78 in chips) 
Seat 2: Boodoolai ($10.80 in chips) 
Seat 3: BestAger ($8.57 in chips) 
Seat 4: Raikkoboy ($10.15 in chips) 
Seat 5: Gari Nerskiy ($11.52 in chips) 
Seat 6: Laker_Style ($10.17 in chips) 
BestAger: posts small blind $0.05
Raikkoboy: posts big blind $0.10
*** HOLE CARDS ***
Gari Nerskiy: folds 
Laker_Style: folds 
fizruk5: folds 
Boodoolai: folds 
BestAger: raises $0.20 to $0.30
Raikkoboy: folds 
Uncalled bet ($0.20) returned to BestAger
BestAger collected $0.20 from pot
BestAger: doesn't show hand 
*** SUMMARY ***
Total pot $0.20 | Rake $0 
Seat 1: fizruk5 folded before Flop (didn't bet)
Seat 2: Boodoolai (button) folded before Flop (didn't bet)
Seat 3: BestAger (small blind) collected ($0.20)
Seat 4: Raikkoboy (big blind) folded before Flop
Seat 5: Gari Nerskiy folded before Flop (didn't bet)
Seat 6: Laker_Style folded before Flop (didn't bet)



PokerStars Hand #222949785291:  Hold'em No Limit ($0.05/$0.10 USD) - 2021/01/23 5:35:00 ET
Table 'Saito II' 6-max Seat #3 is the button
Seat 1: fizruk5 ($14.78 in chips) 
Seat 2: Boodoolai ($10.80 in chips) 
Seat 3: BestAger ($8.67 in chips) 
Seat 4: Raikkoboy ($10.05 in chips) 
Seat 5: Gari Nerskiy ($11.52 in chips) 
Seat 6: Laker_Style ($10.17 in chips) 
Raikkoboy: posts small blind $0.05
Gari Nerskiy: posts big blind $0.10
*** HOLE CARDS ***
Laker_Style: raises $0.20 to $0.30
fizruk5: folds 
Boodoolai: folds 
BestAger: folds 
Raikkoboy: folds 
Gari Nerskiy: folds 
Uncalled bet ($0.20) returned to Laker_Style
Laker_Style collected $0.25 from pot
Laker_Style: doesn't show hand 
*** SUMMARY ***
Total pot $0.25 | Rake $0 
Seat 1: fizruk5 folded before Flop (didn't bet)
Seat 2: Boodoolai folded before Flop (didn't bet)
Seat 3: BestAger (button) folded before Flop (didn't bet)
Seat 4: Raikkoboy (small blind) folded before Flop
Seat 5: Gari Nerskiy (big blind) folded before Flop
Seat 6: Laker_Style collected ($0.25)



PokerStars Hand #222949789425:  Hold'em No Limit ($0.05/$0.10 USD) - 2021/01/23 5:35:14 ET
Table 'Saito II' 6-max Seat #4 is the button
Seat 1: fizruk5 ($14.78 in chips) 
Seat 2: Boodoolai ($10.80 in chips) 
Seat 3: BestAger ($8.67 in chips) 
Seat 4: Raikkoboy ($10 in chips) 
Seat 5: Gari Nerskiy ($11.42 in chips) 
Seat 6: Laker_Style ($10.32 in chips) 
Gari Nerskiy: posts small blind $0.05
Laker_Style: posts big blind $0.10
*** HOLE CARDS ***
fizruk5: folds 
Boodoolai: folds 
BestAger: folds 
Raikkoboy: raises $0.14 to $0.24
Gari Nerskiy: folds 
Laker_Style: calls $0.14
*** FLOP *** [Ah 5s Js]
Laker_Style: checks 
Raikkoboy: bets $0.17
Laker_Style: folds 
Uncalled bet ($0.17) returned to Raikkoboy
Raikkoboy collected $0.51 from pot
Raikkoboy: doesn't show hand 
*** SUMMARY ***
Total pot $0.53 | Rake $0.02 
Board [Ah 5s Js]
Seat 1: fizruk5 folded before Flop (didn't bet)
Seat 2: Boodoolai folded before Flop (didn't bet)
Seat 3: BestAger folded before Flop (didn't bet)
Seat 4: Raikkoboy (button) collected ($0.51)
Seat 5: Gari Nerskiy (small blind) folded before Flop
Seat 6: Laker_Style (big blind) folded on the Flop



PokerStars Hand #222949805686:  Hold'em No Limit ($0.05/$0.10 USD) - 2021/01/23 5:36:05 ET
Table 'Saito II' 6-max Seat #5 is the button
Seat 1: fizruk5 ($14.78 in chips) 
Seat 2: Boodoolai ($10.80 in chips) 
Seat 3: BestAger ($8.67 in chips) 
Seat 4: Raikkoboy ($10.27 in chips) 
Seat 5: Gari Nerskiy ($11.37 in chips) 
Seat 6: Laker_Style ($10.08 in chips) 
Laker_Style: posts small blind $0.05
fizruk5: posts big blind $0.10
*** HOLE CARDS ***
Boodoolai: folds 
BestAger: folds 
Raikkoboy: folds 
Gari Nerskiy: raises $0.10 to $0.20
Laker_Style: folds 
fizruk5: raises $0.60 to $0.80
Gari Nerskiy: folds 
Uncalled bet ($0.60) returned to fizruk5
fizruk5 collected $0.45 from pot
fizruk5: doesn't show hand 
*** SUMMARY ***
Total pot $0.45 | Rake $0 
Seat 1: fizruk5 (big blind) collected ($0.45)
Seat 2: Boodoolai folded before Flop (didn't bet)
Seat 3: BestAger folded before Flop (didn't bet)
Seat 4: Raikkoboy folded before Flop (didn't bet)
Seat 5: Gari Nerskiy (button) folded before Flop
Seat 6: Laker_Style (small blind) folded before Flop



PokerStars Hand #222949817229:  Hold'em No Limit ($0.05/$0.10 USD) - 2021/01/23 5:36:42 ET
Table 'Saito II' 6-max Seat #6 is the button
Seat 1: fizruk5 ($15.03 in chips) 
Seat 2: Boodoolai ($10.80 in chips) 
Seat 3: BestAger ($8.67 in chips) 
Seat 4: Raikkoboy ($10.27 in chips) 
Seat 5: Gari Nerskiy ($11.17 in chips) 
Seat 6: Laker_Style ($10.03 in chips) 
fizruk5: posts small blind $0.05
Boodoolai: posts big blind $0.10
*** HOLE CARDS ***
BestAger: folds 
Raikkoboy: folds 
Gari Nerskiy: folds 
Laker_Style: raises $0.15 to $0.25
fizruk5: folds 
Boodoolai: folds 
Uncalled bet ($0.15) returned to Laker_Style
Laker_Style collected $0.25 from pot
Laker_Style: doesn't show hand 
*** SUMMARY ***
Total pot $0.25 | Rake $0 
Seat 1: fizruk5 (small blind) folded before Flop
Seat 2: Boodoolai (big blind) folded before Flop
Seat 3: BestAger folded before Flop (didn't bet)
Seat 4: Raikkoboy folded before Flop (didn't bet)
Seat 5: Gari Nerskiy folded before Flop (didn't bet)
Seat 6: Laker_Style (button) collected ($0.25)



PokerStars Hand #222949821034:  Hold'em No Limit ($0.05/$0.10 USD) - 2021/01/23 5:36:54 ET
Table 'Saito II' 6-max Seat #1 is the button
Seat 1: fizruk5 ($14.98 in chips) 
Seat 2: Boodoolai ($10.70 in chips) 
Seat 3: BestAger ($8.67 in chips) 
Seat 4: Raikkoboy ($10.27 in chips) 
Seat 5: Gari Nerskiy ($11.17 in chips) 
Seat 6: Laker_Style ($10.18 in chips) 
Boodoolai: posts small blind $0.05
BestAger: posts big blind $0.10
*** HOLE CARDS ***
Raikkoboy: folds 
Gari Nerskiy: raises $0.20 to $0.30
Laker_Style: raises $0.60 to $0.90
fizruk5: folds 
Boodoolai: folds 
BestAger: folds 
Gari Nerskiy: calls $0.60
*** FLOP *** [2h Jd 6h]
Gari Nerskiy: checks 
Laker_Style: bets $1
Gari Nerskiy: raises $1.95 to $2.95
Laker_Style: calls $1.95
*** TURN *** [2h Jd 6h] [Ac]
Gari Nerskiy: bets $7.32 and is all-in
Laker_Style: calls $6.33 and is all-in
Uncalled bet ($0.99) returned to Gari Nerskiy
*** FIRST RIVER *** [2h Jd 6h Ac] [8s]
*** SECOND RIVER *** [2h Jd 6h Ac] [7h]
*** FIRST SHOW DOWN ***
Gari Nerskiy: shows [Js Jh] (three of a kind, Jacks)
Laker_Style: shows [Kc Ks] (a pair of Kings)
Gari Nerskiy collected $9.80 from pot
*** SECOND SHOW DOWN ***
Gari Nerskiy: shows [Js Jh] (three of a kind, Jacks)
Laker_Style: shows [Kc Ks] (a pair of Kings)
Gari Nerskiy collected $9.79 from pot
*** SUMMARY ***
Total pot $20.51 | Rake $0.92 
Hand was run twice
FIRST Board [2h Jd 6h Ac 8s]
SECOND Board [2h Jd 6h Ac 7h]
Seat 1: fizruk5 (button) folded before Flop (didn't bet)
Seat 2: Boodoolai (small blind) folded before Flop
Seat 3: BestAger (big blind) folded before Flop
Seat 4: Raikkoboy folded before Flop (didn't bet)
Seat 5: Gari Nerskiy showed [Js Jh] and won ($9.80) with three of a kind, Jacks, and won ($9.79) with three of a kind, Jacks
Seat 6: Laker_Style showed [Kc Ks] and lost with a pair of Kings, and lost with a pair of Kings



PokerStars Hand #222949840559:  Hold'em No Limit ($0.05/$0.10 USD) - 2021/01/23 5:37:56 ET
Table 'Saito II' 6-max Seat #2 is the button
Seat 1: fizruk5 ($14.98 in chips) 
Seat 2: Boodoolai ($10.65 in chips) 
Seat 3: BestAger ($8.57 in chips) 
Seat 4: Raikkoboy ($10.27 in chips) 
Seat 5: Gari Nerskiy ($20.58 in chips) 
Seat 6: Laker_Style ($10 in chips) 
BestAger: posts small blind $0.05
Raikkoboy: posts big blind $0.10
*** HOLE CARDS ***
Gari Nerskiy: folds 
Laker_Style: folds 
fizruk5: folds 
Boodoolai: folds 
BestAger: raises $0.20 to $0.30
Raikkoboy: folds 
Uncalled bet ($0.20) returned to BestAger
BestAger collected $0.20 from pot
BestAger: doesn't show hand 
*** SUMMARY ***
Total pot $0.20 | Rake $0 
Seat 1: fizruk5 folded before Flop (didn't bet)
Seat 2: Boodoolai (button) folded before Flop (didn't bet)
Seat 3: BestAger (small blind) collected ($0.20)
Seat 4: Raikkoboy (big blind) folded before Flop
Seat 5: Gari Nerskiy folded before Flop (didn't bet)
Seat 6: Laker_Style folded before Flop (didn't bet)



PokerStars Hand #222949844871:  Hold'em No Limit ($0.05/$0.10 USD) - 2021/01/23 5:38:10 ET
Table 'Saito II' 6-max Seat #3 is the button
Seat 1: fizruk5 ($14.98 in chips) 
Seat 2: Boodoolai ($10.65 in chips) 
Seat 3: BestAger ($8.67 in chips) 
Seat 4: Raikkoboy ($10.17 in chips) 
Seat 5: Gari Nerskiy ($20.58 in chips) 
Seat 6: Laker_Style ($10 in chips) 
Raikkoboy: posts small blind $0.05
Gari Nerskiy: posts big blind $0.10
*** HOLE CARDS ***
Laker_Style: folds 
fizruk5: folds 
Boodoolai: folds 
BestAger: raises $0.10 to $0.20
Raikkoboy: folds 
Gari Nerskiy: calls $0.10
*** FLOP *** [Th 6h Kd]
Gari Nerskiy: checks 
BestAger: bets $0.30
Gari Nerskiy: raises $0.90 to $1.20
BestAger: folds 
Uncalled bet ($0.90) returned to Gari Nerskiy
Gari Nerskiy collected $1 from pot
Gari Nerskiy: doesn't show hand 
*** SUMMARY ***
Total pot $1.05 | Rake $0.05 
Board [Th 6h Kd]
Seat 1: fizruk5 folded before Flop (didn't bet)
Seat 2: Boodoolai folded before Flop (didn't bet)
Seat 3: BestAger (button) folded on the Flop
Seat 4: Raikkoboy (small blind) folded before Flop
Seat 5: Gari Nerskiy (big blind) collected ($1)
Seat 6: Laker_Style folded before Flop (didn't bet)



PokerStars Hand #222949857344:  Hold'em No Limit ($0.05/$0.10 USD) - 2021/01/23 5:38:50 ET
Table 'Saito II' 6-max Seat #4 is the button
Seat 1: fizruk5 ($14.98 in chips) 
Seat 2: Boodoolai ($10.65 in chips) 
Seat 3: BestAger ($8.17 in chips) 
Seat 4: Raikkoboy ($10.12 in chips) 
Seat 5: Gari Nerskiy ($21.08 in chips) 
Seat 6: Laker_Style ($10 in chips) 
Gari Nerskiy: posts small blind $0.05
Laker_Style: posts big blind $0.10
*** HOLE CARDS ***
fizruk5: folds 
Boodoolai: folds 
BestAger: raises $0.20 to $0.30
Raikkoboy: folds 
Gari Nerskiy: folds 
Laker_Style: calls $0.20
*** FLOP *** [2s 3c 7c]
Laker_Style: bets $0.43
BestAger: calls $0.43
*** TURN *** [2s 3c 7c] [4s]
Laker_Style: bets $1.15
BestAger: calls $1.15
*** RIVER *** [2s 3c 7c 4s] [7s]
Laker_Style: bets $8.12 and is all-in
BestAger: folds 
Uncalled bet ($8.12) returned to Laker_Style
Laker_Style collected $3.64 from pot
Laker_Style: doesn't show hand 
*** SUMMARY ***
Total pot $3.81 | Rake $0.17 
Board [2s 3c 7c 4s 7s]
Seat 1: fizruk5 folded before Flop (didn't bet)
Seat 2: Boodoolai folded before Flop (didn't bet)
Seat 3: BestAger folded on the River
Seat 4: Raikkoboy (button) folded before Flop (didn't bet)
Seat 5: Gari Nerskiy (small blind) folded before Flop
Seat 6: Laker_Style (big blind) collected ($3.64)



PokerStars Hand #222949873778:  Hold'em No Limit ($0.05/$0.10 USD) - 2021/01/23 5:39:41 ET
Table 'Saito II' 6-max Seat #5 is the button
Seat 1: fizruk5 ($14.98 in chips) 
Seat 2: Boodoolai ($10.65 in chips) 
Seat 3: BestAger ($6.29 in chips) 
Seat 4: Raikkoboy ($10.12 in chips) 
Seat 5: Gari Nerskiy ($21.03 in chips) 
Seat 6: Laker_Style ($11.76 in chips) 
Laker_Style: posts small blind $0.05
fizruk5: posts big blind $0.10
*** HOLE CARDS ***
Boodoolai: folds 
BestAger: raises $0.20 to $0.30
Raikkoboy: raises $0.60 to $0.90
Gari Nerskiy: folds 
Laker_Style: folds 
fizruk5: folds 
BestAger: calls $0.60
*** FLOP *** [Tc Td 4s]
BestAger: checks 
Raikkoboy: bets $0.63
BestAger: calls $0.63
*** TURN *** [Tc Td 4s] [Ad]
BestAger: checks 
Raikkoboy: checks 
*** RIVER *** [Tc Td 4s Ad] [7c]
BestAger: checks 
Raikkoboy: bets $0.84
BestAger: calls $0.84
*** SHOW DOWN ***
Raikkoboy: shows [5s As] (two pair, Aces and Tens)
BestAger: mucks hand 
Raikkoboy collected $4.67 from pot
*** SUMMARY ***
Total pot $4.89 | Rake $0.22 
Board [Tc Td 4s Ad 7c]
Seat 1: fizruk5 (big blind) folded before Flop
Seat 2: Boodoolai folded before Flop (didn't bet)
Seat 3: BestAger mucked
Seat 4: Raikkoboy showed [5s As] and won ($4.67) with two pair, Aces and Tens
Seat 5: Gari Nerskiy (button) folded before Flop (didn't bet)
Seat 6: Laker_Style (small blind) folded before Flop



PokerStars Hand #222949896201:  Hold'em No Limit ($0.05/$0.10 USD) - 2021/01/23 5:40:54 ET
Table 'Saito II' 6-max Seat #6 is the button
Seat 1: fizruk5 ($14.88 in chips) 
Seat 2: Boodoolai ($10.65 in chips) 
Seat 3: BestAger ($3.92 in chips) 
Seat 4: Raikkoboy ($12.42 in chips) 
Seat 5: Gari Nerskiy ($21.03 in chips) 
Seat 6: Laker_Style ($11.71 in chips) 
fizruk5: posts small blind $0.05
Boodoolai: posts big blind $0.10
*** HOLE CARDS ***
BestAger: folds 
Raikkoboy: folds 
Gari Nerskiy: folds 
Laker_Style: folds 
fizruk5: folds 
Uncalled bet ($0.05) returned to Boodoolai
Boodoolai collected $0.10 from pot
Boodoolai: doesn't show hand 
*** SUMMARY ***
Total pot $0.10 | Rake $0 
Seat 1: fizruk5 (small blind) folded before Flop
Seat 2: Boodoolai (big blind) collected ($0.10)
Seat 3: BestAger folded before Flop (didn't bet)
Seat 4: Raikkoboy folded before Flop (didn't bet)
Seat 5: Gari Nerskiy folded before Flop (didn't bet)
Seat 6: Laker_Style (button) folded before Flop (didn't bet)



PokerStars Hand #222949900595:  Hold'em No Limit ($0.05/$0.10 USD) - 2021/01/23 5:41:08 ET
Table 'Saito II' 6-max Seat #1 is the button
Seat 1: fizruk5 ($14.83 in chips) 
Seat 2: Boodoolai ($10.70 in chips) 
Seat 3: BestAger ($3.92 in chips) 
Seat 4: Raikkoboy ($12.42 in chips) 
Seat 5: Gari Nerskiy ($21.03 in chips) 
Seat 6: Laker_Style ($11.71 in chips) 
Boodoolai: posts small blind $0.05
BestAger: posts big blind $0.10
*** HOLE CARDS ***
Raikkoboy: raises $0.14 to $0.24
Gari Nerskiy: folds 
Laker_Style: folds 
fizruk5: calls $0.24
Boodoolai: folds 
BestAger: raises $0.76 to $1
Raikkoboy: folds 
fizruk5: folds 
Uncalled bet ($0.76) returned to BestAger
BestAger collected $0.77 from pot
BestAger: doesn't show hand 
*** SUMMARY ***
Total pot $0.77 | Rake $0 
Seat 1: fizruk5 (button) folded before Flop
Seat 2: Boodoolai (small blind) folded before Flop
Seat 3: BestAger (big blind) collected ($0.77)
Seat 4: Raikkoboy folded before Flop
Seat 5: Gari Nerskiy folded before Flop (didn't bet)
Seat 6: Laker_Style folded before Flop (didn't bet)



PokerStars Hand #222949912215:  Hold'em No Limit ($0.05/$0.10 USD) - 2021/01/23 5:41:45 ET
Table 'Saito II' 6-max Seat #2 is the button
Seat 1: fizruk5 ($14.59 in chips) 
Seat 2: Boodoolai ($10.65 in chips) 
Seat 3: BestAger ($4.45 in chips) 
Seat 4: Raikkoboy ($12.18 in chips) 
Seat 5: Gari Nerskiy ($21.03 in chips) 
Seat 6: Laker_Style ($11.71 in chips) 
BestAger: posts small blind $0.05
Raikkoboy: posts big blind $0.10
*** HOLE CARDS ***
Gari Nerskiy: folds 
Laker_Style: folds 
fizruk5: folds 
Boodoolai: folds 
BestAger: raises $0.10 to $0.20
Raikkoboy: calls $0.10
*** FLOP *** [2c 2h 4h]
BestAger: bets $0.20
Raikkoboy: folds 
Uncalled bet ($0.20) returned to BestAger
BestAger collected $0.38 from pot
BestAger: doesn't show hand 
*** SUMMARY ***
Total pot $0.40 | Rake $0.02 
Board [2c 2h 4h]
Seat 1: fizruk5 folded before Flop (didn't bet)
Seat 2: Boodoolai (button) folded before Flop (didn't bet)
Seat 3: BestAger (small blind) collected ($0.38)
Seat 4: Raikkoboy (big blind) folded on the Flop
Seat 5: Gari Nerskiy folded before Flop (didn't bet)
Seat 6: Laker_Style folded before Flop (didn't bet)



PokerStars Hand #222949920291:  Hold'em No Limit ($0.05/$0.10 USD) - 2021/01/23 5:42:11 ET
Table 'Saito II' 6-max Seat #3 is the button
Seat 1: fizruk5 ($14.59 in chips) 
Seat 2: Boodoolai ($10.65 in chips) 
Seat 3: BestAger ($4.63 in chips) 
Seat 4: Raikkoboy ($11.98 in chips) 
Seat 5: Gari Nerskiy ($21.03 in chips) 
Seat 6: Laker_Style ($11.71 in chips) 
Raikkoboy: posts small blind $0.05
Gari Nerskiy: posts big blind $0.10
*** HOLE CARDS ***
Laker_Style: folds 
fizruk5: folds 
Boodoolai: folds 
BestAger: folds 
Raikkoboy: raises $0.30 to $0.40
Gari Nerskiy: folds 
Uncalled bet ($0.30) returned to Raikkoboy
Raikkoboy collected $0.20 from pot
Raikkoboy: doesn't show hand 
*** SUMMARY ***
Total pot $0.20 | Rake $0 
Seat 1: fizruk5 folded before Flop (didn't bet)
Seat 2: Boodoolai folded before Flop (didn't bet)
Seat 3: BestAger (button) folded before Flop (didn't bet)
Seat 4: Raikkoboy (small blind) collected ($0.20)
Seat 5: Gari Nerskiy (big blind) folded before Flop
Seat 6: Laker_Style folded before Flop (didn't bet)



PokerStars Hand #222949930186:  Hold'em No Limit ($0.05/$0.10 USD) - 2021/01/23 5:42:42 ET
Table 'Saito II' 6-max Seat #4 is the button
Seat 1: fizruk5 ($14.59 in chips) 
Seat 2: Boodoolai ($10.65 in chips) 
Seat 3: BestAger ($4.63 in chips) 
Seat 4: Raikkoboy ($12.08 in chips) 
Seat 5: Gari Nerskiy ($20.93 in chips) 
Seat 6: Laker_Style ($11.71 in chips) 
Gari Nerskiy: posts small blind $0.05
Laker_Style: posts big blind $0.10
*** HOLE CARDS ***
fizruk5: folds 
Boodoolai: folds 
BestAger: folds 
Raikkoboy: raises $0.14 to $0.24
Gari Nerskiy: folds 
Laker_Style: folds 
Uncalled bet ($0.14) returned to Raikkoboy
Raikkoboy collected $0.25 from pot
Raikkoboy: doesn't show hand 
*** SUMMARY ***
Total pot $0.25 | Rake $0 
Seat 1: fizruk5 folded before Flop (didn't bet)
Seat 2: Boodoolai folded before Flop (didn't bet)
Seat 3: BestAger folded before Flop (didn't bet)
Seat 4: Raikkoboy (button) collected ($0.25)
Seat 5: Gari Nerskiy (small blind) folded before Flop
Seat 6: Laker_Style (big blind) folded before Flop



PokerStars Hand #222949936947:  Hold'em No Limit ($0.05/$0.10 USD) - 2021/01/23 5:43:04 ET
Table 'Saito II' 6-max Seat #5 is the button
Seat 1: fizruk5 ($14.59 in chips) 
Seat 2: Boodoolai ($10.65 in chips) 
Seat 3: BestAger ($4.63 in chips) 
Seat 4: Raikkoboy ($12.23 in chips) 
Seat 5: Gari Nerskiy ($20.88 in chips) 
Seat 6: Laker_Style ($11.61 in chips) 
Laker_Style: posts small blind $0.05
fizruk5: posts big blind $0.10
*** HOLE CARDS ***
Boodoolai: folds 
BestAger: raises $0.20 to $0.30
Raikkoboy: folds 
Gari Nerskiy: folds 
Laker_Style: folds 
fizruk5: folds 
Uncalled bet ($0.20) returned to BestAger
BestAger collected $0.25 from pot
BestAger: doesn't show hand 
*** SUMMARY ***
Total pot $0.25 | Rake $0 
Seat 1: fizruk5 (big blind) folded before Flop
Seat 2: Boodoolai folded before Flop (didn't bet)
Seat 3: BestAger collected ($0.25)
Seat 4: Raikkoboy folded before Flop (didn't bet)
Seat 5: Gari Nerskiy (button) folded before Flop (didn't bet)
Seat 6: Laker_Style (small blind) folded before Flop



PokerStars Hand #222949944688:  Hold'em No Limit ($0.05/$0.10 USD) - 2021/01/23 5:43:29 ET
Table 'Saito II' 6-max Seat #6 is the button
Seat 1: fizruk5 ($14.49 in chips) 
Seat 3: BestAger ($4.78 in chips) 
Seat 4: Raikkoboy ($12.23 in chips) 
Seat 5: Gari Nerskiy ($20.88 in chips) 
Seat 6: Laker_Style ($11.56 in chips) 
fizruk5: posts small blind $0.05
Boodoolai: is sitting out 
BestAger: posts big blind $0.10
*** HOLE CARDS ***
Raikkoboy: folds 
Gari Nerskiy: folds 
Laker_Style: raises $0.15 to $0.25
fizruk5: folds 
BestAger: folds 
Uncalled bet ($0.15) returned to Laker_Style
Laker_Style collected $0.25 from pot
Laker_Style: doesn't show hand 
*** SUMMARY ***
Total pot $0.25 | Rake $0 
Seat 1: fizruk5 (small blind) folded before Flop
Seat 3: BestAger (big blind) folded before Flop
Seat 4: Raikkoboy folded before Flop (didn't bet)
Seat 5: Gari Nerskiy folded before Flop (didn't bet)
Seat 6: Laker_Style (button) collected ($0.25)



PokerStars Hand #222949948498:  Hold'em No Limit ($0.05/$0.10 USD) - 2021/01/23 5:43:41 ET
Table 'Saito II' 6-max Seat #1 is the button
Seat 1: fizruk5 ($14.44 in chips) 
Seat 3: BestAger ($4.68 in chips) 
Seat 4: Raikkoboy ($12.23 in chips) 
Seat 5: Gari Nerskiy ($20.88 in chips) 
Seat 6: Laker_Style ($11.71 in chips) 
BestAger: posts small blind $0.05
Raikkoboy: posts big blind $0.10
*** HOLE CARDS ***
Gari Nerskiy: folds 
Laker_Style has timed out
Laker_Style: folds 
Boodoolai leaves the table
fizruk5: raises $0.15 to $0.25
Sheva26Rus joins the table at seat #2 
BestAger: folds 
Raikkoboy: folds 
Uncalled bet ($0.15) returned to fizruk5
fizruk5 collected $0.25 from pot
fizruk5: doesn't show hand 
*** SUMMARY ***
Total pot $0.25 | Rake $0 
Seat 1: fizruk5 (button) collected ($0.25)
Seat 3: BestAger (small blind) folded before Flop
Seat 4: Raikkoboy (big blind) folded before Flop
Seat 5: Gari Nerskiy folded before Flop (didn't bet)
Seat 6: Laker_Style folded before Flop (didn't bet)



PokerStars Hand #222949956061:  Hold'em No Limit ($0.05/$0.10 USD) - 2021/01/23 5:44:05 ET
Table 'Saito II' 6-max Seat #3 is the button
Seat 1: fizruk5 ($14.59 in chips) 
Seat 3: BestAger ($4.63 in chips) 
Seat 4: Raikkoboy ($12.13 in chips) 
Seat 5: Gari Nerskiy ($20.88 in chips) 
Raikkoboy: posts small blind $0.05
Gari Nerskiy: posts big blind $0.10
Sheva26Rus: sits out 
*** HOLE CARDS ***
fizruk5: raises $0.15 to $0.25
BestAger: calls $0.25
Raikkoboy: folds 
Gari Nerskiy: calls $0.15
*** FLOP *** [3d 9c 5h]
Gari Nerskiy: checks 
fizruk5: checks 
BestAger: bets $0.30
Gari Nerskiy: folds 
fizruk5: folds 
Uncalled bet ($0.30) returned to BestAger
BestAger collected $0.76 from pot
BestAger: doesn't show hand 
*** SUMMARY ***
Total pot $0.80 | Rake $0.04 
Board [3d 9c 5h]
Seat 1: fizruk5 folded on the Flop
Seat 3: BestAger (button) collected ($0.76)
Seat 4: Raikkoboy (small blind) folded before Flop
Seat 5: Gari Nerskiy (big blind) folded on the Flop



PokerStars Hand #222949966573:  Hold'em No Limit ($0.05/$0.10 USD) - 2021/01/23 5:44:39 ET
Table 'Saito II' 6-max Seat #4 is the button
Seat 1: fizruk5 ($14.34 in chips) 
Seat 3: BestAger ($5.14 in chips) 
Seat 4: Raikkoboy ($12.08 in chips) 
Seat 5: Gari Nerskiy ($20.63 in chips) 
Seat 6: Laker_Style ($11.71 in chips) 
Gari Nerskiy: posts small blind $0.05
Laker_Style: posts big blind $0.10
Sheva26Rus: sits out 
*** HOLE CARDS ***
fizruk5: folds 
BestAger: folds 
Raikkoboy: raises $0.14 to $0.24
Gari Nerskiy: folds 
Laker_Style: folds 
Uncalled bet ($0.14) returned to Raikkoboy
Raikkoboy collected $0.25 from pot
Raikkoboy: doesn't show hand 
*** SUMMARY ***
Total pot $0.25 | Rake $0 
Seat 1: fizruk5 folded before Flop (didn't bet)
Seat 3: BestAger folded before Flop (didn't bet)
Seat 4: Raikkoboy (button) collected ($0.25)
Seat 5: Gari Nerskiy (small blind) folded before Flop
Seat 6: Laker_Style (big blind) folded before Flop



PokerStars Hand #222949971142:  Hold'em No Limit ($0.05/$0.10 USD) - 2021/01/23 5:44:53 ET
Table 'Saito II' 6-max Seat #5 is the button
Seat 1: fizruk5 ($14.34 in chips) 
Seat 3: BestAger ($5.14 in chips) 
Seat 4: Raikkoboy ($12.23 in chips) 
Seat 5: Gari Nerskiy ($20.58 in chips) 
Seat 6: Laker_Style ($11.61 in chips) 
Laker_Style: posts small blind $0.05
fizruk5: posts big blind $0.10
Sheva26Rus: sits out 
*** HOLE CARDS ***
BestAger: folds 
Raikkoboy: folds 
Gari Nerskiy: raises $0.10 to $0.20
Laker_Style: folds 
fizruk5: calls $0.10
*** FLOP *** [Kh Ac Ts]
fizruk5: checks 
Gari Nerskiy: bets $0.18
fizruk5: folds 
Uncalled bet ($0.18) returned to Gari Nerskiy
Gari Nerskiy collected $0.43 from pot
Gari Nerskiy: doesn't show hand 
*** SUMMARY ***
Total pot $0.45 | Rake $0.02 
Board [Kh Ac Ts]
Seat 1: fizruk5 (big blind) folded on the Flop
Seat 3: BestAger folded before Flop (didn't bet)
Seat 4: Raikkoboy folded before Flop (didn't bet)
Seat 5: Gari Nerskiy (button) collected ($0.43)
Seat 6: Laker_Style (small blind) folded before Flop



PokerStars Hand #222949978549:  Hold'em No Limit ($0.05/$0.10 USD) - 2021/01/23 5:45:16 ET
Table 'Saito II' 6-max Seat #6 is the button
Seat 1: fizruk5 ($14.14 in chips) 
Seat 2: Sheva26Rus ($10 in chips) 
Seat 3: BestAger ($5.14 in chips) 
Seat 4: Raikkoboy ($12.23 in chips) 
Seat 5: Gari Nerskiy ($20.81 in chips) 
Seat 6: Laker_Style ($11.56 in chips) 
fizruk5: posts small blind $0.05
Sheva26Rus: posts big blind $0.10
*** HOLE CARDS ***
BestAger: folds 
Raikkoboy: folds 
Gari Nerskiy: folds 
Laker_Style: raises $0.15 to $0.25
fizruk5: folds 
Sheva26Rus: calls $0.15
*** FLOP *** [Td Tc 4s]
Sheva26Rus: checks 
Laker_Style: checks 
*** TURN *** [Td Tc 4s] [2h]
Sheva26Rus: checks 
Laker_Style: bets $0.40
Sheva26Rus: calls $0.40
*** RIVER *** [Td Tc 4s 2h] [6h]
Sheva26Rus: checks 
Laker_Style: bets $0.97
Sheva26Rus: calls $0.97
*** SHOW DOWN ***
Laker_Style: shows [5d 8d] (a pair of Tens)
Sheva26Rus: shows [4c As] (two pair, Tens and Fours)
Sheva26Rus collected $3.14 from pot
*** SUMMARY ***
Total pot $3.29 | Rake $0.15 
Board [Td Tc 4s 2h 6h]
Seat 1: fizruk5 (small blind) folded before Flop
Seat 2: Sheva26Rus (big blind) showed [4c As] and won ($3.14) with two pair, Tens and Fours
Seat 3: BestAger folded before Flop (didn't bet)
Seat 4: Raikkoboy folded before Flop (didn't bet)
Seat 5: Gari Nerskiy folded before Flop (didn't bet)
Seat 6: Laker_Style (button) showed [5d 8d] and lost with a pair of Tens



PokerStars Hand #222949990599:  Hold'em No Limit ($0.05/$0.10 USD) - 2021/01/23 5:45:54 ET
Table 'Saito II' 6-max Seat #1 is the button
Seat 1: fizruk5 ($14.09 in chips) 
Seat 2: Sheva26Rus ($11.52 in chips) 
Seat 3: BestAger ($5.14 in chips) 
Seat 4: Raikkoboy ($12.23 in chips) 
Seat 5: Gari Nerskiy ($20.81 in chips) 
Seat 6: Laker_Style ($10 in chips) 
Sheva26Rus: posts small blind $0.05
BestAger: posts big blind $0.10
*** HOLE CARDS ***
Raikkoboy: folds 
Gari Nerskiy: folds 
Laker_Style: folds 
fizruk5: raises $0.20 to $0.30
Sheva26Rus: folds 
BestAger: folds 
Uncalled bet ($0.20) returned to fizruk5
fizruk5 collected $0.25 from pot
fizruk5: doesn't show hand 
*** SUMMARY ***
Total pot $0.25 | Rake $0 
Seat 1: fizruk5 (button) collected ($0.25)
Seat 2: Sheva26Rus (small blind) folded before Flop
Seat 3: BestAger (big blind) folded before Flop
Seat 4: Raikkoboy folded before Flop (didn't bet)
Seat 5: Gari Nerskiy folded before Flop (didn't bet)
Seat 6: Laker_Style folded before Flop (didn't bet)



PokerStars Hand #222949998048:  Hold'em No Limit ($0.05/$0.10 USD) - 2021/01/23 5:46:18 ET
Table 'Saito II' 6-max Seat #2 is the button
Seat 1: fizruk5 ($14.24 in chips) 
Seat 2: Sheva26Rus ($11.47 in chips) 
Seat 3: BestAger ($5.04 in chips) 
Seat 4: Raikkoboy ($12.23 in chips) 
Seat 5: Gari Nerskiy ($20.81 in chips) 
Seat 6: Laker_Style ($10 in chips) 
BestAger: posts small blind $0.05
Raikkoboy: posts big blind $0.10
*** HOLE CARDS ***
Gari Nerskiy: folds 
Laker_Style: folds 
fizruk5: folds 
Sheva26Rus: folds 
BestAger: folds 
Uncalled bet ($0.05) returned to Raikkoboy
Raikkoboy collected $0.10 from pot
Raikkoboy: doesn't show hand 
*** SUMMARY ***
Total pot $0.10 | Rake $0 
Seat 1: fizruk5 folded before Flop (didn't bet)
Seat 2: Sheva26Rus (button) folded before Flop (didn't bet)
Seat 3: BestAger (small blind) folded before Flop
Seat 4: Raikkoboy (big blind) collected ($0.10)
Seat 5: Gari Nerskiy folded before Flop (didn't bet)
Seat 6: Laker_Style folded before Flop (didn't bet)



PokerStars Hand #222950001646:  Hold'em No Limit ($0.05/$0.10 USD) - 2021/01/23 5:46:29 ET
Table 'Saito II' 6-max Seat #3 is the button
Seat 1: fizruk5 ($14.24 in chips) 
Seat 2: Sheva26Rus ($11.47 in chips) 
Seat 3: BestAger ($4.99 in chips) 
Seat 4: Raikkoboy ($12.28 in chips) 
Seat 5: Gari Nerskiy ($20.81 in chips) 
Seat 6: Laker_Style ($10 in chips) 
Raikkoboy: posts small blind $0.05
Gari Nerskiy: posts big blind $0.10
*** HOLE CARDS ***
Laker_Style: folds 
fizruk5: folds 
Sheva26Rus: raises $0.15 to $0.25
BestAger: folds 
Raikkoboy: raises $0.65 to $0.90
Gari Nerskiy: folds 
Sheva26Rus: calls $0.65
*** FLOP *** [Jh 2h 8d]
Raikkoboy: bets $0.62
Sheva26Rus: raises $1.98 to $2.60
Raikkoboy: folds 
Uncalled bet ($1.98) returned to Sheva26Rus
Sheva26Rus collected $3 from pot
Sheva26Rus: doesn't show hand 
*** SUMMARY ***
Total pot $3.14 | Rake $0.14 
Board [Jh 2h 8d]
Seat 1: fizruk5 folded before Flop (didn't bet)
Seat 2: Sheva26Rus collected ($3)
Seat 3: BestAger (button) folded before Flop (didn't bet)
Seat 4: Raikkoboy (small blind) folded on the Flop
Seat 5: Gari Nerskiy (big blind) folded before Flop
Seat 6: Laker_Style folded before Flop (didn't bet)



PokerStars Hand #222950014004:  Hold'em No Limit ($0.05/$0.10 USD) - 2021/01/23 5:47:08 ET
Table 'Saito II' 6-max Seat #4 is the button
Seat 1: fizruk5 ($14.24 in chips) 
Seat 2: Sheva26Rus ($12.95 in chips) 
Seat 3: BestAger ($4.99 in chips) 
Seat 4: Raikkoboy ($10.76 in chips) 
Seat 5: Gari Nerskiy ($20.71 in chips) 
Seat 6: Laker_Style ($10 in chips) 
Gari Nerskiy: posts small blind $0.05
Laker_Style: posts big blind $0.10
*** HOLE CARDS ***
fizruk5: folds 
Sheva26Rus: folds 
BestAger: folds 
Raikkoboy: folds 
Gari Nerskiy: folds 
Uncalled bet ($0.05) returned to Laker_Style
Laker_Style collected $0.10 from pot
Laker_Style: doesn't show hand 
*** SUMMARY ***
Total pot $0.10 | Rake $0 
Seat 1: fizruk5 folded before Flop (didn't bet)
Seat 2: Sheva26Rus folded before Flop (didn't bet)
Seat 3: BestAger folded before Flop (didn't bet)
Seat 4: Raikkoboy (button) folded before Flop (didn't bet)
Seat 5: Gari Nerskiy (small blind) folded before Flop
Seat 6: Laker_Style (big blind) collected ($0.10)



PokerStars Hand #222950017749:  Hold'em No Limit ($0.05/$0.10 USD) - 2021/01/23 5:47:20 ET
Table 'Saito II' 6-max Seat #5 is the button
Seat 1: fizruk5 ($14.24 in chips) 
Seat 2: Sheva26Rus ($12.95 in chips) 
Seat 3: BestAger ($4.99 in chips) 
Seat 4: Raikkoboy ($10.76 in chips) 
Seat 5: Gari Nerskiy ($20.66 in chips) 
Seat 6: Laker_Style ($10.05 in chips) 
Laker_Style: posts small blind $0.05
fizruk5: posts big blind $0.10
*** HOLE CARDS ***
Sheva26Rus: folds 
BestAger: folds 
Raikkoboy: folds 
Gari Nerskiy: raises $0.10 to $0.20
Laker_Style: folds 
fizruk5: calls $0.10
*** FLOP *** [Ts Tc Th]
fizruk5: checks 
Gari Nerskiy: bets $0.12
fizruk5: calls $0.12
*** TURN *** [Ts Tc Th] [7c]
fizruk5: checks 
Gari Nerskiy: bets $0.41
fizruk5: calls $0.41
*** RIVER *** [Ts Tc Th 7c] [4s]
fizruk5: checks 
Gari Nerskiy: checks 
*** SHOW DOWN ***
fizruk5: shows [Jc 9h] (three of a kind, Tens)
Gari Nerskiy: shows [Ac Qc] (three of a kind, Tens - Ace kicker)
Gari Nerskiy collected $1.44 from pot
*** SUMMARY ***
Total pot $1.51 | Rake $0.07 
Board [Ts Tc Th 7c 4s]
Seat 1: fizruk5 (big blind) showed [Jc 9h] and lost with three of a kind, Tens
Seat 2: Sheva26Rus folded before Flop (didn't bet)
Seat 3: BestAger folded before Flop (didn't bet)
Seat 4: Raikkoboy folded before Flop (didn't bet)
Seat 5: Gari Nerskiy (button) showed [Ac Qc] and won ($1.44) with three of a kind, Tens
Seat 6: Laker_Style (small blind) folded before Flop



PokerStars Hand #222950033940:  Hold'em No Limit ($0.05/$0.10 USD) - 2021/01/23 5:48:11 ET
Table 'Saito II' 6-max Seat #6 is the button
Seat 1: fizruk5 ($13.51 in chips) 
Seat 2: Sheva26Rus ($12.95 in chips) 
Seat 3: BestAger ($4.99 in chips) 
Seat 4: Raikkoboy ($10.76 in chips) 
Seat 5: Gari Nerskiy ($21.37 in chips) 
Seat 6: Laker_Style ($10 in chips) 
fizruk5: posts small blind $0.05
Sheva26Rus: posts big blind $0.10
*** HOLE CARDS ***
BestAger: raises $0.20 to $0.30
Raikkoboy: folds 
Gari Nerskiy: folds 
Laker_Style: folds 
fizruk5: folds 
Sheva26Rus: folds 
Uncalled bet ($0.20) returned to BestAger
BestAger collected $0.25 from pot
BestAger: doesn't show hand 
*** SUMMARY ***
Total pot $0.25 | Rake $0 
Seat 1: fizruk5 (small blind) folded before Flop
Seat 2: Sheva26Rus (big blind) folded before Flop
Seat 3: BestAger collected ($0.25)
Seat 4: Raikkoboy folded before Flop (didn't bet)
Seat 5: Gari Nerskiy folded before Flop (didn't bet)
Seat 6: Laker_Style (button) folded before Flop (didn't bet)



PokerStars Hand #222950039574:  Hold'em No Limit ($0.05/$0.10 USD) - 2021/01/23 5:48:29 ET
Table 'Saito II' 6-max Seat #1 is the button
Seat 1: fizruk5 ($13.46 in chips) 
Seat 2: Sheva26Rus ($12.85 in chips) 
Seat 3: BestAger ($5.14 in chips) 
Seat 4: Raikkoboy ($10.76 in chips) 
Seat 5: Gari Nerskiy ($21.37 in chips) 
Seat 6: Laker_Style ($10 in chips) 
Sheva26Rus: posts small blind $0.05
BestAger: posts big blind $0.10
*** HOLE CARDS ***
Raikkoboy: folds 
Gari Nerskiy: folds 
Laker_Style: folds 
fizruk5: folds 
Sheva26Rus: folds 
Uncalled bet ($0.05) returned to BestAger
BestAger collected $0.10 from pot
BestAger: doesn't show hand 
*** SUMMARY ***
Total pot $0.10 | Rake $0 
Seat 1: fizruk5 (button) folded before Flop (didn't bet)
Seat 2: Sheva26Rus (small blind) folded before Flop
Seat 3: BestAger (big blind) collected ($0.10)
Seat 4: Raikkoboy folded before Flop (didn't bet)
Seat 5: Gari Nerskiy folded before Flop (didn't bet)
Seat 6: Laker_Style folded before Flop (didn't bet)



PokerStars Hand #222950042140:  Hold'em No Limit ($0.05/$0.10 USD) - 2021/01/23 5:48:37 ET
Table 'Saito II' 6-max Seat #2 is the button
Seat 1: fizruk5 ($13.46 in chips) 
Seat 2: Sheva26Rus ($12.80 in chips) 
Seat 3: BestAger ($5.19 in chips) 
Seat 4: Raikkoboy ($10.76 in chips) 
Seat 5: Gari Nerskiy ($21.37 in chips) 
Seat 6: Laker_Style ($10 in chips) 
BestAger: posts small blind $0.05
Raikkoboy: posts big blind $0.10
*** HOLE CARDS ***
Gari Nerskiy: raises $0.20 to $0.30
Laker_Style: folds 
fizruk5: folds 
Sheva26Rus: folds 
BestAger: folds 
Raikkoboy: calls $0.20
*** FLOP *** [8h 2c 2s]
Raikkoboy: checks 
Gari Nerskiy: checks 
*** TURN *** [8h 2c 2s] [As]
Raikkoboy: checks 
Gari Nerskiy: bets $0.38
Raikkoboy: folds 
Uncalled bet ($0.38) returned to Gari Nerskiy
Gari Nerskiy collected $0.62 from pot
Gari Nerskiy: doesn't show hand 
*** SUMMARY ***
Total pot $0.65 | Rake $0.03 
Board [8h 2c 2s As]
Seat 1: fizruk5 folded before Flop (didn't bet)
Seat 2: Sheva26Rus (button) folded before Flop (didn't bet)
Seat 3: BestAger (small blind) folded before Flop
Seat 4: Raikkoboy (big blind) folded on the Turn
Seat 5: Gari Nerskiy collected ($0.62)
Seat 6: Laker_Style folded before Flop (didn't bet)



PokerStars Hand #222950051792:  Hold'em No Limit ($0.05/$0.10 USD) - 2021/01/23 5:49:08 ET
Table 'Saito II' 6-max Seat #3 is the button
Seat 1: fizruk5 ($13.46 in chips) 
Seat 2: Sheva26Rus ($12.80 in chips) 
Seat 3: BestAger ($5.14 in chips) 
Seat 4: Raikkoboy ($10.46 in chips) 
Seat 5: Gari Nerskiy ($21.69 in chips) 
Seat 6: Laker_Style ($10 in chips) 
Raikkoboy: posts small blind $0.05
Gari Nerskiy: posts big blind $0.10
*** HOLE CARDS ***
Laker_Style: folds 
fizruk5: folds 
Sheva26Rus: folds 
BestAger: raises $0.20 to $0.30
Raikkoboy: folds 
Gari Nerskiy: calls $0.20
*** FLOP *** [5h 2s 2c]
Gari Nerskiy: checks 
BestAger: checks 
*** TURN *** [5h 2s 2c] [As]
Gari Nerskiy: checks 
BestAger: checks 
*** RIVER *** [5h 2s 2c As] [8s]
Gari Nerskiy: bets $0.50
BestAger: folds 
Uncalled bet ($0.50) returned to Gari Nerskiy
Gari Nerskiy collected $0.62 from pot
Gari Nerskiy: doesn't show hand 
*** SUMMARY ***
Total pot $0.65 | Rake $0.03 
Board [5h 2s 2c As 8s]
Seat 1: fizruk5 folded before Flop (didn't bet)
Seat 2: Sheva26Rus folded before Flop (didn't bet)
Seat 3: BestAger (button) folded on the River
Seat 4: Raikkoboy (small blind) folded before Flop
Seat 5: Gari Nerskiy (big blind) collected ($0.62)
Seat 6: Laker_Style folded before Flop (didn't bet)



PokerStars Hand #222950063807:  Hold'em No Limit ($0.05/$0.10 USD) - 2021/01/23 5:49:46 ET
Table 'Saito II' 6-max Seat #4 is the button
Seat 1: fizruk5 ($13.46 in chips) 
Seat 2: Sheva26Rus ($12.80 in chips) 
Seat 3: BestAger ($4.84 in chips) 
Seat 4: Raikkoboy ($10.41 in chips) 
Seat 5: Gari Nerskiy ($22.01 in chips) 
Seat 6: Laker_Style ($10 in chips) 
Gari Nerskiy: posts small blind $0.05
Laker_Style: posts big blind $0.10
*** HOLE CARDS ***
fizruk5: folds 
Sheva26Rus: folds 
BestAger: raises $0.20 to $0.30
Raikkoboy: folds 
Gari Nerskiy: folds 
Laker_Style: folds 
Uncalled bet ($0.20) returned to BestAger
BestAger collected $0.25 from pot
BestAger: doesn't show hand 
*** SUMMARY ***
Total pot $0.25 | Rake $0 
Seat 1: fizruk5 folded before Flop (didn't bet)
Seat 2: Sheva26Rus folded before Flop (didn't bet)
Seat 3: BestAger collected ($0.25)
Seat 4: Raikkoboy (button) folded before Flop (didn't bet)
Seat 5: Gari Nerskiy (small blind) folded before Flop
Seat 6: Laker_Style (big blind) folded before Flop



PokerStars Hand #222950069967:  Hold'em No Limit ($0.05/$0.10 USD) - 2021/01/23 5:50:05 ET
Table 'Saito II' 6-max Seat #5 is the button
Seat 1: fizruk5 ($13.46 in chips) 
Seat 2: Sheva26Rus ($12.80 in chips) 
Seat 3: BestAger ($4.99 in chips) 
Seat 4: Raikkoboy ($10.41 in chips) 
Seat 5: Gari Nerskiy ($21.96 in chips) 
Seat 6: Laker_Style ($10 in chips) 
Laker_Style: posts small blind $0.05
fizruk5: posts big blind $0.10
*** HOLE CARDS ***
Sheva26Rus: folds 
BestAger: folds 
Raikkoboy: folds 
Gari Nerskiy: raises $0.20 to $0.30
Laker_Style: calls $0.25
fizruk5: folds 
*** FLOP *** [9c Td 7d]
Laker_Style: checks 
Gari Nerskiy: checks 
*** TURN *** [9c Td 7d] [6c]
Laker_Style: checks 
Gari Nerskiy: checks 
*** RIVER *** [9c Td 7d 6c] [Kd]
Laker_Style: checks 
Gari Nerskiy: bets $0.42
Laker_Style: folds 
Uncalled bet ($0.42) returned to Gari Nerskiy
Gari Nerskiy collected $0.67 from pot
Gari Nerskiy: doesn't show hand 
*** SUMMARY ***
Total pot $0.70 | Rake $0.03 
Board [9c Td 7d 6c Kd]
Seat 1: fizruk5 (big blind) folded before Flop
Seat 2: Sheva26Rus folded before Flop (didn't bet)
Seat 3: BestAger folded before Flop (didn't bet)
Seat 4: Raikkoboy folded before Flop (didn't bet)
Seat 5: Gari Nerskiy (button) collected ($0.67)
Seat 6: Laker_Style (small blind) folded on the River



PokerStars Hand #222950093289:  Hold'em No Limit ($0.05/$0.10 USD) - 2021/01/23 5:51:19 ET
Table 'Saito II' 6-max Seat #6 is the button
Seat 1: fizruk5 ($13.36 in chips) 
Seat 2: Sheva26Rus ($12.80 in chips) 
Seat 3: BestAger ($4.99 in chips) 
Seat 4: Raikkoboy ($10.41 in chips) 
Seat 5: Gari Nerskiy ($22.33 in chips) 
Seat 6: Laker_Style ($10 in chips) 
fizruk5: posts small blind $0.05
Sheva26Rus: posts big blind $0.10
*** HOLE CARDS ***
BestAger: raises $0.20 to $0.30
Raikkoboy: folds 
Gari Nerskiy: folds 
Laker_Style: calls $0.30
fizruk5: folds 
Sheva26Rus: folds 
*** FLOP *** [9h Ac 5d]
BestAger: bets $0.30
Laker_Style: calls $0.30
*** TURN *** [9h Ac 5d] [3s]
BestAger: bets $0.50
Laker_Style: folds 
Uncalled bet ($0.50) returned to BestAger
BestAger collected $1.29 from pot
BestAger: doesn't show hand 
*** SUMMARY ***
Total pot $1.35 | Rake $0.06 
Board [9h Ac 5d 3s]
Seat 1: fizruk5 (small blind) folded before Flop
Seat 2: Sheva26Rus (big blind) folded before Flop
Seat 3: BestAger collected ($1.29)
Seat 4: Raikkoboy folded before Flop (didn't bet)
Seat 5: Gari Nerskiy folded before Flop (didn't bet)
Seat 6: Laker_Style (button) folded on the Turn



PokerStars Hand #222950114504:  Hold'em No Limit ($0.05/$0.10 USD) - 2021/01/23 5:52:27 ET
Table 'Saito II' 6-max Seat #1 is the button
Seat 1: fizruk5 ($13.31 in chips) 
Seat 2: Sheva26Rus ($12.70 in chips) 
Seat 3: BestAger ($5.68 in chips) 
Seat 4: Raikkoboy ($10.41 in chips) 
Seat 6: Laker_Style ($10 in chips) 
Sheva26Rus: posts small blind $0.05
BestAger: posts big blind $0.10
*** HOLE CARDS ***
Raikkoboy: folds 
Laker_Style: folds 
fizruk5: folds 
Sheva26Rus: folds 
Uncalled bet ($0.05) returned to BestAger
BestAger collected $0.10 from pot
BestAger: doesn't show hand 
*** SUMMARY ***
Total pot $0.10 | Rake $0 
Seat 1: fizruk5 (button) folded before Flop (didn't bet)
Seat 2: Sheva26Rus (small blind) folded before Flop
Seat 3: BestAger (big blind) collected ($0.10)
Seat 4: Raikkoboy folded before Flop (didn't bet)
Seat 6: Laker_Style folded before Flop (didn't bet)



PokerStars Hand #222950118417:  Hold'em No Limit ($0.05/$0.10 USD) - 2021/01/23 5:52:39 ET
Table 'Saito II' 6-max Seat #2 is the button
Seat 1: fizruk5 ($13.31 in chips) 
Seat 2: Sheva26Rus ($12.65 in chips) 
Seat 3: BestAger ($5.73 in chips) 
Seat 4: Raikkoboy ($10.41 in chips) 
Seat 6: Laker_Style ($10 in chips) 
BestAger: posts small blind $0.05
Raikkoboy: posts big blind $0.10
*** HOLE CARDS ***
Laker_Style: folds 
fizruk5: folds 
Sheva26Rus: folds 
BestAger: folds 
Uncalled bet ($0.05) returned to Raikkoboy
Raikkoboy collected $0.10 from pot
Raikkoboy: doesn't show hand 
*** SUMMARY ***
Total pot $0.10 | Rake $0 
Seat 1: fizruk5 folded before Flop (didn't bet)
Seat 2: Sheva26Rus (button) folded before Flop (didn't bet)
Seat 3: BestAger (small blind) folded before Flop
Seat 4: Raikkoboy (big blind) collected ($0.10)
Seat 6: Laker_Style folded before Flop (didn't bet)



PokerStars Hand #222950122369:  Hold'em No Limit ($0.05/$0.10 USD) - 2021/01/23 5:52:52 ET
Table 'Saito II' 6-max Seat #3 is the button
Seat 1: fizruk5 ($13.31 in chips) 
Seat 2: Sheva26Rus ($12.65 in chips) 
Seat 3: BestAger ($5.68 in chips) 
Seat 4: Raikkoboy ($10.46 in chips) 
Seat 6: Laker_Style ($10 in chips) 
Raikkoboy: posts small blind $0.05
Laker_Style: posts big blind $0.10
*** HOLE CARDS ***
fizruk5: folds 
Sheva26Rus: folds 
BestAger: folds 
Raikkoboy: raises $0.30 to $0.40
Laker_Style: folds 
Uncalled bet ($0.30) returned to Raikkoboy
Raikkoboy collected $0.20 from pot
Raikkoboy: doesn't show hand 
*** SUMMARY ***
Total pot $0.20 | Rake $0 
Seat 1: fizruk5 folded before Flop (didn't bet)
Seat 2: Sheva26Rus folded before Flop (didn't bet)
Seat 3: BestAger (button) folded before Flop (didn't bet)
Seat 4: Raikkoboy (small blind) collected ($0.20)
Seat 6: Laker_Style (big blind) folded before Flop



PokerStars Hand #222950125513:  Hold'em No Limit ($0.05/$0.10 USD) - 2021/01/23 5:53:02 ET
Table 'Saito II' 6-max Seat #4 is the button
Seat 2: Sheva26Rus ($12.65 in chips) 
Seat 3: BestAger ($5.68 in chips) 
Seat 4: Raikkoboy ($10.56 in chips) 
Seat 6: Laker_Style ($10 in chips) 
Laker_Style: posts small blind $0.05
fizruk5: is sitting out 
Sheva26Rus: posts big blind $0.10
*** HOLE CARDS ***
BestAger: raises $0.20 to $0.30
Raikkoboy: folds 
fizruk5 leaves the table
Chrysk2 joins the table at seat #1 
Laker_Style: folds 
Sheva26Rus: calls $0.20
*** FLOP *** [8s Kc Jd]
Sheva26Rus: checks 
BestAger: bets $0.60
Sheva26Rus: folds 
Uncalled bet ($0.60) returned to BestAger
BestAger collected $0.62 from pot
BestAger: doesn't show hand 
*** SUMMARY ***
Total pot $0.65 | Rake $0.03 
Board [8s Kc Jd]
Seat 2: Sheva26Rus (big blind) folded on the Flop
Seat 3: BestAger collected ($0.62)
Seat 4: Raikkoboy (button) folded before Flop (didn't bet)
Seat 6: Laker_Style (small blind) folded before Flop



PokerStars Hand #222950139001:  Hold'em No Limit ($0.05/$0.10 USD) - 2021/01/23 5:53:44 ET
Table 'Saito II' 6-max Seat #6 is the button
Seat 2: Sheva26Rus ($12.35 in chips) 
Seat 3: BestAger ($6 in chips) 
Seat 4: Raikkoboy ($10.56 in chips) 
Seat 6: Laker_Style ($10 in chips) 
Sheva26Rus: posts small blind $0.05
BestAger: posts big blind $0.10
*** HOLE CARDS ***
Raikkoboy: raises $0.14 to $0.24
Laker_Style: calls $0.24
Sheva26Rus: raises $1.06 to $1.30
BestAger: folds 
Raikkoboy: folds 
Laker_Style: calls $1.06
*** FLOP *** [7c 8h 4c]
Sheva26Rus: bets $1.83
Laker_Style: folds 
Uncalled bet ($1.83) returned to Sheva26Rus
Sheva26Rus collected $2.81 from pot
Sheva26Rus: doesn't show hand 
*** SUMMARY ***
Total pot $2.94 | Rake $0.13 
Board [7c 8h 4c]
Seat 2: Sheva26Rus (small blind) collected ($2.81)
Seat 3: BestAger (big blind) folded before Flop
Seat 4: Raikkoboy folded before Flop
Seat 6: Laker_Style (button) folded on the Flop



PokerStars Hand #222950152534:  Hold'em No Limit ($0.05/$0.10 USD) - 2021/01/23 5:54:27 ET
Table 'Saito II' 6-max Seat #2 is the button
Seat 1: Chrysk2 ($10 in chips) 
Seat 2: Sheva26Rus ($13.86 in chips) 
Seat 3: BestAger ($5.90 in chips) 
Seat 4: Raikkoboy ($10.32 in chips) 
Seat 6: Laker_Style ($10 in chips) 
BestAger: posts small blind $0.05
Raikkoboy: posts big blind $0.10
Chrysk2: posts big blind $0.10
*** HOLE CARDS ***
Laker_Style: folds 
Chrysk2: checks 
Sheva26Rus: folds 
BestAger: calls $0.05
Raikkoboy: checks 
*** FLOP *** [Td Jc Qs]
BestAger: bets $0.10
Raikkoboy: calls $0.10
Chrysk2: folds 
*** TURN *** [Td Jc Qs] [Tc]
BestAger: bets $0.10
Raikkoboy: raises $0.48 to $0.58
BestAger: folds 
Uncalled bet ($0.48) returned to Raikkoboy
Raikkoboy collected $0.67 from pot
Raikkoboy: doesn't show hand 
*** SUMMARY ***
Total pot $0.70 | Rake $0.03 
Board [Td Jc Qs Tc]
Seat 1: Chrysk2 folded on the Flop (didn't bet)
Seat 2: Sheva26Rus (button) folded before Flop (didn't bet)
Seat 3: BestAger (small blind) folded on the Turn
Seat 4: Raikkoboy (big blind) collected ($0.67)
Seat 6: Laker_Style folded before Flop (didn't bet)



PokerStars Hand #222950166266:  Hold'em No Limit ($0.05/$0.10 USD) - 2021/01/23 5:55:11 ET
Table 'Saito II' 6-max Seat #3 is the button
Seat 1: Chrysk2 ($9.90 in chips) 
Seat 2: Sheva26Rus ($13.86 in chips) 
Seat 3: BestAger ($5.60 in chips) 
Seat 4: Raikkoboy ($10.69 in chips) 
Seat 6: Laker_Style ($10 in chips) 
Raikkoboy: posts small blind $0.05
Laker_Style: posts big blind $0.10
*** HOLE CARDS ***
Chrysk2: folds 
Sheva26Rus: folds 
BestAger: folds 
Raikkoboy: folds 
Uncalled bet ($0.05) returned to Laker_Style
Laker_Style collected $0.10 from pot
Laker_Style: doesn't show hand 
*** SUMMARY ***
Total pot $0.10 | Rake $0 
Seat 1: Chrysk2 folded before Flop (didn't bet)
Seat 2: Sheva26Rus folded before Flop (didn't bet)
Seat 3: BestAger (button) folded before Flop (didn't bet)
Seat 4: Raikkoboy (small blind) folded before Flop
Seat 6: Laker_Style (big blind) collected ($0.10)



PokerStars Hand #222950168631:  Hold'em No Limit ($0.05/$0.10 USD) - 2021/01/23 5:55:20 ET
Table 'Saito II' 6-max Seat #4 is the button
Seat 1: Chrysk2 ($9.90 in chips) 
Seat 2: Sheva26Rus ($13.86 in chips) 
Seat 3: BestAger ($5.60 in chips) 
Seat 4: Raikkoboy ($10.64 in chips) 
Seat 6: Laker_Style ($10.05 in chips) 
Laker_Style: posts small blind $0.05
Chrysk2: posts big blind $0.10
*** HOLE CARDS ***
Sheva26Rus: folds 
BestAger: raises $0.20 to $0.30
Raikkoboy: folds 
Laker_Style: folds 
Chrysk2: folds 
Uncalled bet ($0.20) returned to BestAger
BestAger collected $0.25 from pot
BestAger: doesn't show hand 
*** SUMMARY ***
Total pot $0.25 | Rake $0 
Seat 1: Chrysk2 (big blind) folded before Flop
Seat 2: Sheva26Rus folded before Flop (didn't bet)
Seat 3: BestAger collected ($0.25)
Seat 4: Raikkoboy (button) folded before Flop (didn't bet)
Seat 6: Laker_Style (small blind) folded before Flop



PokerStars Hand #222950176946:  Hold'em No Limit ($0.05/$0.10 USD) - 2021/01/23 5:55:50 ET
Table 'Saito II' 6-max Seat #6 is the button
Seat 1: Chrysk2 ($9.80 in chips) 
Seat 2: Sheva26Rus ($13.86 in chips) 
Seat 3: BestAger ($5.75 in chips) 
Seat 4: Raikkoboy ($10.64 in chips) 
Seat 6: Laker_Style ($10 in chips) 
Chrysk2: posts small blind $0.05
Sheva26Rus: posts big blind $0.10
*** HOLE CARDS ***
BestAger: folds 
Raikkoboy: raises $0.14 to $0.24
Laker_Style: folds 
Chrysk2: folds 
Sheva26Rus: calls $0.14
*** FLOP *** [Th Ts Ks]
Sheva26Rus: checks 
Raikkoboy: bets $0.17
Sheva26Rus: calls $0.17
*** TURN *** [Th Ts Ks] [Jh]
Sheva26Rus: checks 
Raikkoboy: checks 
*** RIVER *** [Th Ts Ks Jh] [4s]
Sheva26Rus: checks 
Raikkoboy: checks 
*** SHOW DOWN ***
Sheva26Rus: shows [Qs Jc] (two pair, Jacks and Tens)
Raikkoboy: mucks hand 
Sheva26Rus collected $0.83 from pot
*** SUMMARY ***
Total pot $0.87 | Rake $0.04 
Board [Th Ts Ks Jh 4s]
Seat 1: Chrysk2 (small blind) folded before Flop
Seat 2: Sheva26Rus (big blind) showed [Qs Jc] and won ($0.83) with two pair, Jacks and Tens
Seat 3: BestAger folded before Flop (didn't bet)
Seat 4: Raikkoboy mucked
Seat 6: Laker_Style (button) folded before Flop (didn't bet)



PokerStars Hand #222950191835:  Hold'em No Limit ($0.05/$0.10 USD) - 2021/01/23 5:56:44 ET
Table 'Saito II' 6-max Seat #1 is the button
Seat 1: Chrysk2 ($9.75 in chips) 
Seat 2: Sheva26Rus ($14.28 in chips) 
Seat 3: BestAger ($5.75 in chips) 
Seat 4: Raikkoboy ($10.23 in chips) 
Seat 6: Laker_Style ($10 in chips) 
Sheva26Rus: posts small blind $0.05
BestAger: posts big blind $0.10
*** HOLE CARDS ***
Raikkoboy: folds 
Laker_Style: raises $0.20 to $0.30
Chrysk2: folds 
Sheva26Rus: folds 
BestAger: calls $0.20
*** FLOP *** [Td 5c Qh]
BestAger: bets $0.30
Laker_Style: calls $0.30
*** TURN *** [Td 5c Qh] [3d]
BestAger: bets $0.50
Laker_Style: calls $0.50
*** RIVER *** [Td 5c Qh 3d] [2h]
BestAger: bets $0.40
Laker_Style: calls $0.40
*** SHOW DOWN ***
BestAger: shows [Tc Ad] (a pair of Tens)
Laker_Style: shows [Js Jh] (a pair of Jacks)
Laker_Style collected $2.91 from pot
*** SUMMARY ***
Total pot $3.05 | Rake $0.14 
Board [Td 5c Qh 3d 2h]
Seat 1: Chrysk2 (button) folded before Flop (didn't bet)
Seat 2: Sheva26Rus (small blind) folded before Flop
Seat 3: BestAger (big blind) showed [Tc Ad] and lost with a pair of Tens
Seat 4: Raikkoboy folded before Flop (didn't bet)
Seat 6: Laker_Style showed [Js Jh] and won ($2.91) with a pair of Jacks



PokerStars Hand #222950204318:  Hold'em No Limit ($0.05/$0.10 USD) - 2021/01/23 5:57:30 ET
Table 'Saito II' 6-max Seat #2 is the button
Seat 1: Chrysk2 ($9.75 in chips) 
Seat 2: Sheva26Rus ($14.23 in chips) 
Seat 3: BestAger ($4.25 in chips) 
Seat 4: Raikkoboy ($10.23 in chips) 
Seat 6: Laker_Style ($11.41 in chips) 
BestAger: posts small blind $0.05
Raikkoboy: posts big blind $0.10
Gari Nerskiy: sits out 
*** HOLE CARDS ***
Laker_Style: folds 
Chrysk2: folds 
Sheva26Rus: folds 
BestAger: raises $0.20 to $0.30
Raikkoboy: calls $0.20
*** FLOP *** [Ah 2d 6h]
BestAger: bets $0.30
Raikkoboy: calls $0.30
*** TURN *** [Ah 2d 6h] [6s]
BestAger: bets $1
Raikkoboy: folds 
Uncalled bet ($1) returned to BestAger
BestAger collected $1.15 from pot
BestAger: doesn't show hand 
*** SUMMARY ***
Total pot $1.20 | Rake $0.05 
Board [Ah 2d 6h 6s]
Seat 1: Chrysk2 folded before Flop (didn't bet)
Seat 2: Sheva26Rus (button) folded before Flop (didn't bet)
Seat 3: BestAger (small blind) collected ($1.15)
Seat 4: Raikkoboy (big blind) folded on the Turn
Seat 6: Laker_Style folded before Flop (didn't bet)



PokerStars Hand #222950213416:  Hold'em No Limit ($0.05/$0.10 USD) - 2021/01/23 5:58:02 ET
Table 'Saito II' 6-max Seat #3 is the button
Seat 1: Chrysk2 ($9.75 in chips) 
Seat 2: Sheva26Rus ($14.23 in chips) 
Seat 3: BestAger ($4.80 in chips) 
Seat 4: Raikkoboy ($10 in chips) 
Seat 5: Gari Nerskiy ($22.33 in chips) 
Seat 6: Laker_Style ($11.41 in chips) 
Raikkoboy: posts small blind $0.05
Gari Nerskiy: posts big blind $0.10
*** HOLE CARDS ***
Laker_Style: folds 
Chrysk2: folds 
Sheva26Rus: folds 
BestAger: raises $0.20 to $0.30
Raikkoboy: folds 
Gari Nerskiy: calls $0.20
*** FLOP *** [8h Qd 3h]
Gari Nerskiy: checks 
BestAger: bets $0.30
Gari Nerskiy: folds 
Uncalled bet ($0.30) returned to BestAger
BestAger collected $0.62 from pot
BestAger: doesn't show hand 
*** SUMMARY ***
Total pot $0.65 | Rake $0.03 
Board [8h Qd 3h]
Seat 1: Chrysk2 folded before Flop (didn't bet)
Seat 2: Sheva26Rus folded before Flop (didn't bet)
Seat 3: BestAger (button) collected ($0.62)
Seat 4: Raikkoboy (small blind) folded before Flop
Seat 5: Gari Nerskiy (big blind) folded on the Flop
Seat 6: Laker_Style folded before Flop (didn't bet)



PokerStars Hand #222950223028:  Hold'em No Limit ($0.05/$0.10 USD) - 2021/01/23 5:58:37 ET
Table 'Saito II' 6-max Seat #4 is the button
Seat 1: Chrysk2 ($10 in chips) 
Seat 2: Sheva26Rus ($14.23 in chips) 
Seat 3: BestAger ($5.12 in chips) 
Seat 4: Raikkoboy ($10 in chips) 
Seat 5: Gari Nerskiy ($22.03 in chips) 
Seat 6: Laker_Style ($11.41 in chips) 
Gari Nerskiy: posts small blind $0.05
Laker_Style: posts big blind $0.10
*** HOLE CARDS ***
Chrysk2: raises $0.20 to $0.30
Sheva26Rus: folds 
BestAger: calls $0.30
Raikkoboy: folds 
Gari Nerskiy: folds 
Laker_Style: folds 
*** FLOP *** [Kh 8s 5c]
Chrysk2: checks 
BestAger: checks 
*** TURN *** [Kh 8s 5c] [Ad]
Chrysk2: bets $0.24
BestAger: calls $0.24
*** RIVER *** [Kh 8s 5c Ad] [3h]
Chrysk2: checks 
BestAger: checks 
*** SHOW DOWN ***
Chrysk2: shows [8d 9d] (a pair of Eights)
BestAger: mucks hand 
Chrysk2 collected $1.17 from pot
*** SUMMARY ***
Total pot $1.23 | Rake $0.06 
Board [Kh 8s 5c Ad 3h]
Seat 1: Chrysk2 showed [8d 9d] and won ($1.17) with a pair of Eights
Seat 2: Sheva26Rus folded before Flop (didn't bet)
Seat 3: BestAger mucked
Seat 4: Raikkoboy (button) folded before Flop (didn't bet)
Seat 5: Gari Nerskiy (small blind) folded before Flop
Seat 6: Laker_Style (big blind) folded before Flop



PokerStars Hand #222950232226:  Hold'em No Limit ($0.05/$0.10 USD) - 2021/01/23 5:59:10 ET
Table 'Saito II' 6-max Seat #5 is the button
Seat 1: Chrysk2 ($10.63 in chips) 
Seat 2: Sheva26Rus ($14.23 in chips) 
Seat 3: BestAger ($4.58 in chips) 
Seat 4: Raikkoboy ($10 in chips) 
Seat 5: Gari Nerskiy ($21.98 in chips) 
Seat 6: Laker_Style ($11.31 in chips) 
Laker_Style: posts small blind $0.05
Chrysk2: posts big blind $0.10
*** HOLE CARDS ***
Sheva26Rus: folds 
BestAger: folds 
Raikkoboy: folds 
Gari Nerskiy: raises $0.10 to $0.20
Laker_Style: folds 
Chrysk2: calls $0.10
*** FLOP *** [Kd 8d Kh]
Chrysk2: checks 
Gari Nerskiy: checks 
*** TURN *** [Kd 8d Kh] [7d]
Chrysk2: checks 
Gari Nerskiy: bets $0.18
Chrysk2: folds 
Uncalled bet ($0.18) returned to Gari Nerskiy
Gari Nerskiy collected $0.43 from pot
Gari Nerskiy: doesn't show hand 
*** SUMMARY ***
Total pot $0.45 | Rake $0.02 
Board [Kd 8d Kh 7d]
Seat 1: Chrysk2 (big blind) folded on the Turn
Seat 2: Sheva26Rus folded before Flop (didn't bet)
Seat 3: BestAger folded before Flop (didn't bet)
Seat 4: Raikkoboy folded before Flop (didn't bet)
Seat 5: Gari Nerskiy (button) collected ($0.43)
Seat 6: Laker_Style (small blind) folded before Flop



PokerStars Hand #222950239337:  Hold'em No Limit ($0.05/$0.10 USD) - 2021/01/23 5:59:36 ET
Table 'Saito II' 6-max Seat #6 is the button
Seat 1: Chrysk2 ($10.43 in chips) 
Seat 2: Sheva26Rus ($14.23 in chips) 
Seat 3: BestAger ($4.58 in chips) 
Seat 4: Raikkoboy ($10 in chips) 
Seat 5: Gari Nerskiy ($22.21 in chips) 
Seat 6: Laker_Style ($11.26 in chips) 
Chrysk2: posts small blind $0.05
Sheva26Rus: posts big blind $0.10
*** HOLE CARDS ***
BestAger: folds 
Raikkoboy: folds 
Gari Nerskiy: folds 
Laker_Style: folds 
Chrysk2: folds 
Uncalled bet ($0.05) returned to Sheva26Rus
Sheva26Rus collected $0.10 from pot
Sheva26Rus: doesn't show hand 
*** SUMMARY ***
Total pot $0.10 | Rake $0 
Seat 1: Chrysk2 (small blind) folded before Flop
Seat 2: Sheva26Rus (big blind) collected ($0.10)
Seat 3: BestAger folded before Flop (didn't bet)
Seat 4: Raikkoboy folded before Flop (didn't bet)
Seat 5: Gari Nerskiy folded before Flop (didn't bet)
Seat 6: Laker_Style (button) folded before Flop (didn't bet)



PokerStars Hand #222950241963:  Hold'em No Limit ($0.05/$0.10 USD) - 2021/01/23 5:59:45 ET
Table 'Saito II' 6-max Seat #1 is the button
Seat 1: Chrysk2 ($10.38 in chips) 
Seat 2: Sheva26Rus ($14.28 in chips) 
Seat 3: BestAger ($4.58 in chips) 
Seat 4: Raikkoboy ($10 in chips) 
Seat 5: Gari Nerskiy ($22.21 in chips) 
Seat 6: Laker_Style ($11.26 in chips) 
Sheva26Rus: posts small blind $0.05
BestAger: posts big blind $0.10
*** HOLE CARDS ***
Raikkoboy: folds 
Gari Nerskiy: folds 
Laker_Style: raises $0.20 to $0.30
Chrysk2: folds 
Sheva26Rus: folds 
BestAger: raises $0.40 to $0.70
Laker_Style: calls $0.40
*** FLOP *** [3s 9d 4h]
BestAger: bets $0.50
Laker_Style: calls $0.50
*** TURN *** [3s 9d 4h] [4s]
BestAger: bets $0.80
Laker_Style: calls $0.80
*** RIVER *** [3s 9d 4h 4s] [5s]
BestAger: checks 
Laker_Style: checks 
*** SHOW DOWN ***
BestAger: shows [Th Ac] (a pair of Fours)
Laker_Style: shows [8h 8c] (two pair, Eights and Fours)
Laker_Style collected $3.87 from pot
*** SUMMARY ***
Total pot $4.05 | Rake $0.18 
Board [3s 9d 4h 4s 5s]
Seat 1: Chrysk2 (button) folded before Flop (didn't bet)
Seat 2: Sheva26Rus (small blind) folded before Flop
Seat 3: BestAger (big blind) showed [Th Ac] and lost with a pair of Fours
Seat 4: Raikkoboy folded before Flop (didn't bet)
Seat 5: Gari Nerskiy folded before Flop (didn't bet)
Seat 6: Laker_Style showed [8h 8c] and won ($3.87) with two pair, Eights and Fours



PokerStars Hand #222950256455:  Hold'em No Limit ($0.05/$0.10 USD) - 2021/01/23 6:00:36 ET
Table 'Saito II' 6-max Seat #2 is the button
Seat 1: Chrysk2 ($10.38 in chips) 
Seat 2: Sheva26Rus ($14.23 in chips) 
Seat 3: BestAger ($2.58 in chips) 
Seat 4: Raikkoboy ($10 in chips) 
Seat 5: Gari Nerskiy ($22.21 in chips) 
Seat 6: Laker_Style ($13.13 in chips) 
BestAger: posts small blind $0.05
Raikkoboy: posts big blind $0.10
*** HOLE CARDS ***
Gari Nerskiy: folds 
Laker_Style: folds 
Chrysk2: raises $0.20 to $0.30
Sheva26Rus: folds 
BestAger: raises $0.50 to $0.80
Raikkoboy: folds 
Chrysk2: calls $0.50
*** FLOP *** [5d 3d 5c]
BestAger: bets $1.78 and is all-in
Chrysk2: folds 
Uncalled bet ($1.78) returned to BestAger
BestAger collected $1.62 from pot
BestAger: doesn't show hand 
*** SUMMARY ***
Total pot $1.70 | Rake $0.08 
Board [5d 3d 5c]
Seat 1: Chrysk2 folded on the Flop
Seat 2: Sheva26Rus (button) folded before Flop (didn't bet)
Seat 3: BestAger (small blind) collected ($1.62)
Seat 4: Raikkoboy (big blind) folded before Flop
Seat 5: Gari Nerskiy folded before Flop (didn't bet)
Seat 6: Laker_Style folded before Flop (didn't bet)



PokerStars Hand #222950263347:  Hold'em No Limit ($0.05/$0.10 USD) - 2021/01/23 6:00:59 ET
Table 'Saito II' 6-max Seat #3 is the button
Seat 1: Chrysk2 ($9.58 in chips) 
Seat 2: Sheva26Rus ($14.23 in chips) 
Seat 3: BestAger ($3.40 in chips) 
Seat 4: Raikkoboy ($10 in chips) 
Seat 5: Gari Nerskiy ($22.21 in chips) 
Seat 6: Laker_Style ($13.13 in chips) 
Raikkoboy: posts small blind $0.05
Gari Nerskiy: posts big blind $0.10
*** HOLE CARDS ***
Laker_Style: folds 
Chrysk2: raises $0.20 to $0.30
Sheva26Rus: calls $0.30
BestAger: calls $0.30
Raikkoboy: folds 
Gari Nerskiy: folds 
*** FLOP *** [Kc 3h Jd]
Chrysk2: checks 
Sheva26Rus: checks 
BestAger: bets $0.30
Chrysk2: calls $0.30
Sheva26Rus: calls $0.30
*** TURN *** [Kc 3h Jd] [Ad]
Chrysk2: checks 
Sheva26Rus: checks 
BestAger: checks 
*** RIVER *** [Kc 3h Jd Ad] [7h]
Chrysk2: checks 
Sheva26Rus: checks 
BestAger: checks 
*** SHOW DOWN ***
Chrysk2: shows [9h 9c] (a pair of Nines)
Sheva26Rus: shows [Qs Ks] (a pair of Kings)
BestAger: mucks hand 
Sheva26Rus collected $1.86 from pot
*** SUMMARY ***
Total pot $1.95 | Rake $0.09 
Board [Kc 3h Jd Ad 7h]
Seat 1: Chrysk2 showed [9h 9c] and lost with a pair of Nines
Seat 2: Sheva26Rus showed [Qs Ks] and won ($1.86) with a pair of Kings
Seat 3: BestAger (button) mucked
Seat 4: Raikkoboy (small blind) folded before Flop
Seat 5: Gari Nerskiy (big blind) folded before Flop
Seat 6: Laker_Style folded before Flop (didn't bet)



PokerStars Hand #222950315945:  Hold'em No Limit ($0.05/$0.10 USD) - 2021/01/23 6:03:43 ET
Table 'Saito II' 6-max Seat #1 is the button
Seat 1: Chrysk2 ($9.25 in chips) 
Seat 2: Sheva26Rus ($15.61 in chips) 
Seat 3: BestAger ($3.25 in chips) 
Seat 4: Raikkoboy ($10 in chips) 
Seat 5: Gari Nerskiy ($22.06 in chips) 
Seat 6: Laker_Style ($12.73 in chips) 
Sheva26Rus: posts small blind $0.05
BestAger: posts big blind $0.10
*** HOLE CARDS ***
Raikkoboy: raises $0.14 to $0.24
Gari Nerskiy: folds 
Laker_Style: calls $0.24
Chrysk2: raises $0.86 to $1.10
Sheva26Rus: folds 
BestAger: folds 
Raikkoboy: folds 
Laker_Style: folds 
Uncalled bet ($0.86) returned to Chrysk2
Chrysk2 collected $0.87 from pot
Chrysk2: doesn't show hand 
*** SUMMARY ***
Total pot $0.87 | Rake $0 
Seat 1: Chrysk2 (button) collected ($0.87)
Seat 2: Sheva26Rus (small blind) folded before Flop
Seat 3: BestAger (big blind) folded before Flop
Seat 4: Raikkoboy folded before Flop
Seat 5: Gari Nerskiy folded before Flop (didn't bet)
Seat 6: Laker_Style folded before Flop



PokerStars Hand #222950331800:  Hold'em No Limit ($0.05/$0.10 USD) - 2021/01/23 6:04:32 ET
Table 'Saito II' 6-max Seat #2 is the button
Seat 1: Chrysk2 ($10 in chips) 
Seat 2: Sheva26Rus ($15.56 in chips) 
Seat 3: BestAger ($3.15 in chips) 
Seat 4: Raikkoboy ($10 in chips) 
Seat 5: Gari Nerskiy ($22.06 in chips) 
Seat 6: Laker_Style ($12.49 in chips) 
BestAger: posts small blind $0.05
Raikkoboy: posts big blind $0.10
*** HOLE CARDS ***
Gari Nerskiy: folds 
Laker_Style: folds 
Chrysk2: folds 
Sheva26Rus: raises $0.15 to $0.25
BestAger: folds 
Raikkoboy: calls $0.15
*** FLOP *** [Tc 2d 7s]
Raikkoboy: checks 
Sheva26Rus: bets $0.19
Raikkoboy: calls $0.19
*** TURN *** [Tc 2d 7s] [2c]
Raikkoboy: checks 
Sheva26Rus: bets $0.76
Raikkoboy: folds 
Uncalled bet ($0.76) returned to Sheva26Rus
Sheva26Rus collected $0.89 from pot
Sheva26Rus: doesn't show hand 
*** SUMMARY ***
Total pot $0.93 | Rake $0.04 
Board [Tc 2d 7s 2c]
Seat 1: Chrysk2 folded before Flop (didn't bet)
Seat 2: Sheva26Rus (button) collected ($0.89)
Seat 3: BestAger (small blind) folded before Flop
Seat 4: Raikkoboy (big blind) folded on the Turn
Seat 5: Gari Nerskiy folded before Flop (didn't bet)
Seat 6: Laker_Style folded before Flop (didn't bet)



PokerStars Hand #222950342065:  Hold'em No Limit ($0.05/$0.10 USD) - 2021/01/23 6:05:04 ET
Table 'Saito II' 6-max Seat #3 is the button
Seat 1: Chrysk2 ($10 in chips) 
Seat 2: Sheva26Rus ($16.01 in chips) 
Seat 3: BestAger ($3.10 in chips) 
Seat 4: Raikkoboy ($10 in chips) 
Seat 5: Gari Nerskiy ($22.06 in chips) 
Seat 6: Laker_Style ($12.49 in chips) 
Raikkoboy: posts small blind $0.05
Gari Nerskiy: posts big blind $0.10
*** HOLE CARDS ***
Laker_Style: folds 
Chrysk2: folds 
Sheva26Rus: folds 
BestAger: folds 
Raikkoboy: raises $0.30 to $0.40
Gari Nerskiy: folds 
Uncalled bet ($0.30) returned to Raikkoboy
Raikkoboy collected $0.20 from pot
Raikkoboy: doesn't show hand 
*** SUMMARY ***
Total pot $0.20 | Rake $0 
Seat 1: Chrysk2 folded before Flop (didn't bet)
Seat 2: Sheva26Rus folded before Flop (didn't bet)
Seat 3: BestAger (button) folded before Flop (didn't bet)
Seat 4: Raikkoboy (small blind) collected ($0.20)
Seat 5: Gari Nerskiy (big blind) folded before Flop
Seat 6: Laker_Style folded before Flop (didn't bet)



PokerStars Hand #222950349614:  Hold'em No Limit ($0.05/$0.10 USD) - 2021/01/23 6:05:28 ET
Table 'Saito II' 6-max Seat #4 is the button
Seat 1: Chrysk2 ($10 in chips) 
Seat 2: Sheva26Rus ($16.01 in chips) 
Seat 3: BestAger ($3.10 in chips) 
Seat 4: Raikkoboy ($10.10 in chips) 
Seat 5: Gari Nerskiy ($21.96 in chips) 
Seat 6: Laker_Style ($12.49 in chips) 
Gari Nerskiy: posts small blind $0.05
Laker_Style: posts big blind $0.10
*** HOLE CARDS ***
Chrysk2: folds 
Sheva26Rus: folds 
BestAger: folds 
Raikkoboy: raises $0.14 to $0.24
Gari Nerskiy: raises $1.01 to $1.25
Laker_Style: folds 
Raikkoboy: raises $1.55 to $2.80
Gari Nerskiy: folds 
Uncalled bet ($1.55) returned to Raikkoboy
Raikkoboy collected $2.60 from pot
Raikkoboy: doesn't show hand 
*** SUMMARY ***
Total pot $2.60 | Rake $0 
Seat 1: Chrysk2 folded before Flop (didn't bet)
Seat 2: Sheva26Rus folded before Flop (didn't bet)
Seat 3: BestAger folded before Flop (didn't bet)
Seat 4: Raikkoboy (button) collected ($2.60)
Seat 5: Gari Nerskiy (small blind) folded before Flop
Seat 6: Laker_Style (big blind) folded before Flop



PokerStars Hand #222950363505:  Hold'em No Limit ($0.05/$0.10 USD) - 2021/01/23 6:06:11 ET
Table 'Saito II' 6-max Seat #5 is the button
Seat 1: Chrysk2 ($10 in chips) 
Seat 2: Sheva26Rus ($16.01 in chips) 
Seat 3: BestAger ($3.10 in chips) 
Seat 4: Raikkoboy ($11.45 in chips) 
Seat 5: Gari Nerskiy ($20.71 in chips) 
Seat 6: Laker_Style ($12.39 in chips) 
Laker_Style: posts small blind $0.05
Chrysk2: posts big blind $0.10
*** HOLE CARDS ***
Sheva26Rus: folds 
BestAger: raises $0.20 to $0.30
Raikkoboy: folds 
Gari Nerskiy: folds 
Laker_Style: folds 
Chrysk2: folds 
Uncalled bet ($0.20) returned to BestAger
BestAger collected $0.25 from pot
BestAger: doesn't show hand 
*** SUMMARY ***
Total pot $0.25 | Rake $0 
Seat 1: Chrysk2 (big blind) folded before Flop
Seat 2: Sheva26Rus folded before Flop (didn't bet)
Seat 3: BestAger collected ($0.25)
Seat 4: Raikkoboy folded before Flop (didn't bet)
Seat 5: Gari Nerskiy (button) folded before Flop (didn't bet)
Seat 6: Laker_Style (small blind) folded before Flop



PokerStars Hand #222950369076:  Hold'em No Limit ($0.05/$0.10 USD) - 2021/01/23 6:06:28 ET
Table 'Saito II' 6-max Seat #6 is the button
Seat 1: Chrysk2 ($9.90 in chips) 
Seat 2: Sheva26Rus ($16.01 in chips) 
Seat 3: BestAger ($3.25 in chips) 
Seat 4: Raikkoboy ($11.45 in chips) 
Seat 5: Gari Nerskiy ($20.71 in chips) 
Seat 6: Laker_Style ($12.34 in chips) 
Chrysk2: posts small blind $0.05
Sheva26Rus: posts big blind $0.10
*** HOLE CARDS ***
BestAger: folds 
Raikkoboy: folds 
Gari Nerskiy: folds 
Laker_Style: folds 
Chrysk2: folds 
Uncalled bet ($0.05) returned to Sheva26Rus
Sheva26Rus collected $0.10 from pot
Sheva26Rus: doesn't show hand 
*** SUMMARY ***
Total pot $0.10 | Rake $0 
Seat 1: Chrysk2 (small blind) folded before Flop
Seat 2: Sheva26Rus (big blind) collected ($0.10)
Seat 3: BestAger folded before Flop (didn't bet)
Seat 4: Raikkoboy folded before Flop (didn't bet)
Seat 5: Gari Nerskiy folded before Flop (didn't bet)
Seat 6: Laker_Style (button) folded before Flop (didn't bet)



PokerStars Hand #222950373214:  Hold'em No Limit ($0.05/$0.10 USD) - 2021/01/23 6:06:41 ET
Table 'Saito II' 6-max Seat #1 is the button
Seat 1: Chrysk2 ($9.85 in chips) 
Seat 2: Sheva26Rus ($16.06 in chips) 
Seat 3: BestAger ($3.25 in chips) 
Seat 4: Raikkoboy ($11.45 in chips) 
Seat 5: Gari Nerskiy ($20.71 in chips) 
Seat 6: Laker_Style ($12.34 in chips) 
Sheva26Rus: posts small blind $0.05
BestAger: posts big blind $0.10
*** HOLE CARDS ***
Raikkoboy: raises $0.14 to $0.24
Gari Nerskiy: folds 
Laker_Style: folds 
Chrysk2: raises $0.66 to $0.90
Sheva26Rus: folds 
BestAger: folds 
Raikkoboy: raises $1.60 to $2.50
Chrysk2: calls $1.60
*** FLOP *** [Ac 3d Js]
Raikkoboy: bets $1.27
Chrysk2: calls $1.27
*** TURN *** [Ac 3d Js] [8c]
Raikkoboy: bets $2.33
Chrysk2: folds 
Uncalled bet ($2.33) returned to Raikkoboy
Raikkoboy collected $7.34 from pot
Raikkoboy: doesn't show hand 
*** SUMMARY ***
Total pot $7.69 | Rake $0.35 
Board [Ac 3d Js 8c]
Seat 1: Chrysk2 (button) folded on the Turn
Seat 2: Sheva26Rus (small blind) folded before Flop
Seat 3: BestAger (big blind) folded before Flop
Seat 4: Raikkoboy collected ($7.34)
Seat 5: Gari Nerskiy folded before Flop (didn't bet)
Seat 6: Laker_Style folded before Flop (didn't bet)



PokerStars Hand #222950393442:  Hold'em No Limit ($0.05/$0.10 USD) - 2021/01/23 6:07:43 ET
Table 'Saito II' 6-max Seat #2 is the button
Seat 1: Chrysk2 ($6.08 in chips) 
Seat 2: Sheva26Rus ($16.01 in chips) 
Seat 3: BestAger ($3.15 in chips) 
Seat 4: Raikkoboy ($15.02 in chips) 
Seat 5: Gari Nerskiy ($20.71 in chips) 
Seat 6: Laker_Style ($12.34 in chips) 
BestAger: posts small blind $0.05
Raikkoboy: posts big blind $0.10
*** HOLE CARDS ***
Gari Nerskiy: folds 
Laker_Style: folds 
Chrysk2: folds 
Sheva26Rus: raises $0.15 to $0.25
Chrysk2 leaves the table
BestAger: calls $0.20
Raikkoboy: folds 
*** FLOP *** [9d Th 2h]
poseidoporunbot joins the table at seat #1 
BestAger: checks 
Sheva26Rus: checks 
*** TURN *** [9d Th 2h] [Jc]
BestAger: bets $0.80
Sheva26Rus: folds 
Uncalled bet ($0.80) returned to BestAger
BestAger collected $0.57 from pot
BestAger: doesn't show hand 
*** SUMMARY ***
Total pot $0.60 | Rake $0.03 
Board [9d Th 2h Jc]
Seat 1: Chrysk2 folded before Flop (didn't bet)
Seat 2: Sheva26Rus (button) folded on the Turn
Seat 3: BestAger (small blind) collected ($0.57)
Seat 4: Raikkoboy (big blind) folded before Flop
Seat 5: Gari Nerskiy folded before Flop (didn't bet)
Seat 6: Laker_Style folded before Flop (didn't bet)



PokerStars Hand #222950406355:  Hold'em No Limit ($0.05/$0.10 USD) - 2021/01/23 6:08:23 ET
Table 'Saito II' 6-max Seat #3 is the button
Seat 2: Sheva26Rus ($15.76 in chips) 
Seat 3: BestAger ($3.47 in chips) 
Seat 4: Raikkoboy ($14.92 in chips) 
Seat 5: Gari Nerskiy ($20.71 in chips) 
Seat 6: Laker_Style ($12.34 in chips) 
Raikkoboy: posts small blind $0.05
Gari Nerskiy: posts big blind $0.10
poseidoporunbot: sits out 
*** HOLE CARDS ***
Laker_Style: folds 
Sheva26Rus: folds 
BestAger: folds 
Raikkoboy: folds 
Uncalled bet ($0.05) returned to Gari Nerskiy
Gari Nerskiy collected $0.10 from pot
Gari Nerskiy: doesn't show hand 
*** SUMMARY ***
Total pot $0.10 | Rake $0 
Seat 2: Sheva26Rus folded before Flop (didn't bet)
Seat 3: BestAger (button) folded before Flop (didn't bet)
Seat 4: Raikkoboy (small blind) folded before Flop
Seat 5: Gari Nerskiy (big blind) collected ($0.10)
Seat 6: Laker_Style folded before Flop (didn't bet)



PokerStars Hand #222950408584:  Hold'em No Limit ($0.05/$0.10 USD) - 2021/01/23 6:08:30 ET
Table 'Saito II' 6-max Seat #4 is the button
Seat 2: Sheva26Rus ($15.76 in chips) 
Seat 3: BestAger ($3.47 in chips) 
Seat 4: Raikkoboy ($14.87 in chips) 
Seat 5: Gari Nerskiy ($20.76 in chips) 
Seat 6: Laker_Style ($12.34 in chips) 
Gari Nerskiy: posts small blind $0.05
Laker_Style: posts big blind $0.10
poseidoporunbot: sits out 
*** HOLE CARDS ***
Sheva26Rus: folds 
BestAger: folds 
Raikkoboy: raises $0.14 to $0.24
Gari Nerskiy: raises $1.01 to $1.25
Laker_Style: folds 
Raikkoboy: folds 
Uncalled bet ($1.01) returned to Gari Nerskiy
Gari Nerskiy collected $0.58 from pot
Gari Nerskiy: doesn't show hand 
*** SUMMARY ***
Total pot $0.58 | Rake $0 
Seat 2: Sheva26Rus folded before Flop (didn't bet)
Seat 3: BestAger folded before Flop (didn't bet)
Seat 4: Raikkoboy (button) folded before Flop
Seat 5: Gari Nerskiy (small blind) collected ($0.58)
Seat 6: Laker_Style (big blind) folded before Flop



PokerStars Hand #222950414236:  Hold'em No Limit ($0.05/$0.10 USD) - 2021/01/23 6:08:47 ET
Table 'Saito II' 6-max Seat #5 is the button
Seat 1: poseidoporunbot ($10 in chips) 
Seat 2: Sheva26Rus ($15.76 in chips) 
Seat 3: BestAger ($3.47 in chips) 
Seat 4: Raikkoboy ($14.63 in chips) 
Seat 5: Gari Nerskiy ($21.10 in chips) 
Seat 6: Laker_Style ($12.24 in chips) 
Laker_Style: posts small blind $0.05
poseidoporunbot: posts big blind $0.10
*** HOLE CARDS ***
Sheva26Rus: folds 
BestAger: raises $0.20 to $0.30
Raikkoboy: folds 
Gari Nerskiy: calls $0.30
Laker_Style: folds 
poseidoporunbot: folds 
*** FLOP *** [Js 3c Qh]
BestAger: bets $0.40
Gari Nerskiy: raises $0.80 to $1.20
BestAger: calls $0.80
*** TURN *** [Js 3c Qh] [Jc]
BestAger: checks 
Gari Nerskiy: checks 
*** RIVER *** [Js 3c Qh Jc] [6h]
BestAger: checks 
Gari Nerskiy: checks 
*** SHOW DOWN ***
BestAger: shows [5h Ah] (a pair of Jacks)
Gari Nerskiy: mucks hand 
BestAger collected $3.01 from pot
*** SUMMARY ***
Total pot $3.15 | Rake $0.14 
Board [Js 3c Qh Jc 6h]
Seat 1: poseidoporunbot (big blind) folded before Flop
Seat 2: Sheva26Rus folded before Flop (didn't bet)
Seat 3: BestAger showed [5h Ah] and won ($3.01) with a pair of Jacks
Seat 4: Raikkoboy folded before Flop (didn't bet)
Seat 5: Gari Nerskiy (button) mucked
Seat 6: Laker_Style (small blind) folded before Flop



PokerStars Hand #222950427649:  Hold'em No Limit ($0.05/$0.10 USD) - 2021/01/23 6:09:28 ET
Table 'Saito II' 6-max Seat #6 is the button
Seat 1: poseidoporunbot ($10 in chips) 
Seat 2: Sheva26Rus ($15.76 in chips) 
Seat 3: BestAger ($4.98 in chips) 
Seat 4: Raikkoboy ($14.63 in chips) 
Seat 5: Gari Nerskiy ($19.60 in chips) 
Seat 6: Laker_Style ($12.19 in chips) 
poseidoporunbot: posts small blind $0.05
Sheva26Rus: posts big blind $0.10
*** HOLE CARDS ***
BestAger: folds 
Raikkoboy: folds 
Gari Nerskiy: raises $0.15 to $0.25
Laker_Style: folds 
poseidoporunbot: folds 
Sheva26Rus: raises $0.85 to $1.10
Gari Nerskiy: calls $0.85
*** FLOP *** [Jc 6d 8s]
Sheva26Rus: checks 
Gari Nerskiy: checks 
*** TURN *** [Jc 6d 8s] [5s]
Sheva26Rus: checks 
Gari Nerskiy: checks 
*** RIVER *** [Jc 6d 8s 5s] [3c]
Sheva26Rus: checks 
Gari Nerskiy: checks 
*** SHOW DOWN ***
Sheva26Rus: shows [Qc Ad] (high card Ace)
Gari Nerskiy: shows [Kc Ah] (high card Ace - King kicker)
Gari Nerskiy collected $2.15 from pot
*** SUMMARY ***
Total pot $2.25 | Rake $0.10 
Board [Jc 6d 8s 5s 3c]
Seat 1: poseidoporunbot (small blind) folded before Flop
Seat 2: Sheva26Rus (big blind) showed [Qc Ad] and lost with high card Ace
Seat 3: BestAger folded before Flop (didn't bet)
Seat 4: Raikkoboy folded before Flop (didn't bet)
Seat 5: Gari Nerskiy showed [Kc Ah] and won ($2.15) with high card Ace
Seat 6: Laker_Style (button) folded before Flop (didn't bet)



PokerStars Hand #222950445806:  Hold'em No Limit ($0.05/$0.10 USD) - 2021/01/23 6:10:23 ET
Table 'Saito II' 6-max Seat #1 is the button
Seat 1: poseidoporunbot ($10 in chips) 
Seat 2: Sheva26Rus ($14.66 in chips) 
Seat 3: BestAger ($4.98 in chips) 
Seat 4: Raikkoboy ($14.63 in chips) 
Seat 5: Gari Nerskiy ($20.65 in chips) 
Seat 6: Laker_Style ($12.19 in chips) 
Sheva26Rus: posts small blind $0.05
BestAger: posts big blind $0.10
*** HOLE CARDS ***
Raikkoboy: folds 
Gari Nerskiy: folds 
Raikkoboy leaves the table
Laker_Style: raises $0.20 to $0.30
poseidoporunbot: folds 
Sheva26Rus: folds 
BestAger: calls $0.20
*** FLOP *** [Th 2h 4c]
BestAger: bets $0.20
Laker_Style: raises $0.60 to $0.80
BestAger: calls $0.60
*** TURN *** [Th 2h 4c] [3s]
BestAger: bets $0.20
Laker_Style: raises $1.75 to $1.95
BestAger: folds 
Uncalled bet ($1.75) returned to Laker_Style
Laker_Style collected $2.53 from pot
Laker_Style: doesn't show hand 
*** SUMMARY ***
Total pot $2.65 | Rake $0.12 
Board [Th 2h 4c 3s]
Seat 1: poseidoporunbot (button) folded before Flop (didn't bet)
Seat 2: Sheva26Rus (small blind) folded before Flop
Seat 3: BestAger (big blind) folded on the Turn
Seat 4: Raikkoboy folded before Flop (didn't bet)
Seat 5: Gari Nerskiy folded before Flop (didn't bet)
Seat 6: Laker_Style collected ($2.53)



PokerStars Hand #222950458544:  Hold'em No Limit ($0.05/$0.10 USD) - 2021/01/23 6:11:02 ET
Table 'Saito II' 6-max Seat #2 is the button
Seat 1: poseidoporunbot ($10 in chips) 
Seat 2: Sheva26Rus ($14.61 in chips) 
Seat 3: BestAger ($3.68 in chips) 
Seat 5: Gari Nerskiy ($20.65 in chips) 
Seat 6: Laker_Style ($13.42 in chips) 
BestAger: posts small blind $0.05
Gari Nerskiy: posts big blind $0.10
*** HOLE CARDS ***
Laker_Style: folds 
poseidoporunbot: folds 
Sheva26Rus: folds 
BestAger: folds 
Uncalled bet ($0.05) returned to Gari Nerskiy
Gari Nerskiy collected $0.10 from pot
Gari Nerskiy: doesn't show hand 
*** SUMMARY ***
Total pot $0.10 | Rake $0 
Seat 1: poseidoporunbot folded before Flop (didn't bet)
Seat 2: Sheva26Rus (button) folded before Flop (didn't bet)
Seat 3: BestAger (small blind) folded before Flop
Seat 5: Gari Nerskiy (big blind) collected ($0.10)
Seat 6: Laker_Style folded before Flop (didn't bet)



PokerStars Hand #222950461645:  Hold'em No Limit ($0.05/$0.10 USD) - 2021/01/23 6:11:12 ET
Table 'Saito II' 6-max Seat #3 is the button
Seat 1: poseidoporunbot ($10 in chips) 
Seat 2: Sheva26Rus ($14.61 in chips) 
Seat 3: BestAger ($3.63 in chips) 
Seat 5: Gari Nerskiy ($20.70 in chips) 
Seat 6: Laker_Style ($13.42 in chips) 
Gari Nerskiy: posts small blind $0.05
Laker_Style: posts big blind $0.10
*** HOLE CARDS ***
poseidoporunbot: folds 
Sheva26Rus: raises $0.15 to $0.25
BestAger: raises $0.65 to $0.90
Gari Nerskiy: folds 
Laker_Style: folds 
Sheva26Rus: raises $13.71 to $14.61 and is all-in
BestAger: calls $2.73 and is all-in
Uncalled bet ($10.98) returned to Sheva26Rus
Jesus Ololo joins the table at seat #4 
BestAger has timed out
*** FLOP *** [4d 3s Qc]
*** TURN *** [4d 3s Qc] [Ts]
*** RIVER *** [4d 3s Qc Ts] [As]
*** SHOW DOWN ***
Sheva26Rus: shows [Qh Qd] (three of a kind, Queens)
BestAger: shows [Ad Kh] (a pair of Aces)
Sheva26Rus collected $7.08 from pot
*** SUMMARY ***
Total pot $7.41 | Rake $0.33 
Board [4d 3s Qc Ts As]
Seat 1: poseidoporunbot folded before Flop (didn't bet)
Seat 2: Sheva26Rus showed [Qh Qd] and won ($7.08) with three of a kind, Queens
Seat 3: BestAger (button) showed [Ad Kh] and lost with a pair of Aces
Seat 5: Gari Nerskiy (small blind) folded before Flop
Seat 6: Laker_Style (big blind) folded before Flop



PokerStars Hand #222950479773:  Hold'em No Limit ($0.05/$0.10 USD) - 2021/01/23 6:12:08 ET
Table 'Saito II' 6-max Seat #5 is the button
Seat 1: poseidoporunbot ($10 in chips) 
Seat 2: Sheva26Rus ($18.06 in chips) 
Seat 5: Gari Nerskiy ($20.65 in chips) 
Seat 6: Laker_Style ($13.32 in chips) 
Laker_Style: posts small blind $0.05
poseidoporunbot: posts big blind $0.10
Jesus Ololo: sits out 
*** HOLE CARDS ***
Sheva26Rus: folds 
Gari Nerskiy: raises $0.10 to $0.20
Laker_Style: folds 
poseidoporunbot: raises $1 to $1.20
Gari Nerskiy: folds 
Uncalled bet ($1) returned to poseidoporunbot
poseidoporunbot collected $0.45 from pot
*** SUMMARY ***
Total pot $0.45 | Rake $0 
Seat 1: poseidoporunbot (big blind) collected ($0.45)
Seat 2: Sheva26Rus folded before Flop (didn't bet)
Seat 5: Gari Nerskiy (button) folded before Flop
Seat 6: Laker_Style (small blind) folded before Flop



PokerStars Hand #222950488245:  Hold'em No Limit ($0.05/$0.10 USD) - 2021/01/23 6:12:34 ET
Table 'Saito II' 6-max Seat #6 is the button
Seat 1: poseidoporunbot ($10.25 in chips) 
Seat 2: Sheva26Rus ($18.06 in chips) 
Seat 3: BestAger ($10 in chips) 
Seat 5: Gari Nerskiy ($20.45 in chips) 
Seat 6: Laker_Style ($13.27 in chips) 
poseidoporunbot: posts small blind $0.05
Sheva26Rus: posts big blind $0.10
Jesus Ololo: sits out 
*** HOLE CARDS ***
BestAger: folds 
Gari Nerskiy: folds 
Laker_Style: folds 
poseidoporunbot: folds 
Uncalled bet ($0.05) returned to Sheva26Rus
Sheva26Rus collected $0.10 from pot
Sheva26Rus: doesn't show hand 
*** SUMMARY ***
Total pot $0.10 | Rake $0 
Seat 1: poseidoporunbot (small blind) folded before Flop
Seat 2: Sheva26Rus (big blind) collected ($0.10)
Seat 3: BestAger folded before Flop (didn't bet)
Seat 5: Gari Nerskiy folded before Flop (didn't bet)
Seat 6: Laker_Style (button) folded before Flop (didn't bet)



PokerStars Hand #222950492975:  Hold'em No Limit ($0.05/$0.10 USD) - 2021/01/23 6:12:49 ET
Table 'Saito II' 6-max Seat #1 is the button
Seat 1: poseidoporunbot ($10.20 in chips) 
Seat 2: Sheva26Rus ($18.11 in chips) 
Seat 3: BestAger ($10 in chips) 
Seat 5: Gari Nerskiy ($20.45 in chips) 
Seat 6: Laker_Style ($13.27 in chips) 
Sheva26Rus: posts small blind $0.05
BestAger: posts big blind $0.10
Jesus Ololo: sits out 
*** HOLE CARDS ***
Gari Nerskiy: folds 
Laker_Style: folds 
poseidoporunbot: folds 
Sheva26Rus: folds 
Uncalled bet ($0.05) returned to BestAger
BestAger collected $0.10 from pot
BestAger: doesn't show hand 
*** SUMMARY ***
Total pot $0.10 | Rake $0 
Seat 1: poseidoporunbot (button) folded before Flop (didn't bet)
Seat 2: Sheva26Rus (small blind) folded before Flop
Seat 3: BestAger (big blind) collected ($0.10)
Seat 5: Gari Nerskiy folded before Flop (didn't bet)
Seat 6: Laker_Style folded before Flop (didn't bet)



PokerStars Hand #222950497274:  Hold'em No Limit ($0.05/$0.10 USD) - 2021/01/23 6:13:02 ET
Table 'Saito II' 6-max Seat #2 is the button
Seat 1: poseidoporunbot ($10.20 in chips) 
Seat 2: Sheva26Rus ($18.06 in chips) 
Seat 3: BestAger ($10.05 in chips) 
Seat 4: Jesus Ololo ($10 in chips) 
Seat 5: Gari Nerskiy ($20.45 in chips) 
Seat 6: Laker_Style ($13.27 in chips) 
BestAger: posts small blind $0.05
Jesus Ololo: posts big blind $0.10
*** HOLE CARDS ***
Gari Nerskiy: folds 
Laker_Style: folds 
poseidoporunbot: folds 
Sheva26Rus: raises $0.15 to $0.25
BestAger: calls $0.20
Jesus Ololo: raises $1.05 to $1.30
Sheva26Rus: folds 
BestAger: calls $1.05
*** FLOP *** [6h 4s 2h]
BestAger: bets $0.30
Jesus Ololo: raises $1.30 to $1.60
BestAger: calls $1.30
*** TURN *** [6h 4s 2h] [6s]
BestAger: bets $7.15 and is all-in
Jesus Ololo: folds 
Uncalled bet ($7.15) returned to BestAger
BestAger collected $5.78 from pot
BestAger: doesn't show hand 
*** SUMMARY ***
Total pot $6.05 | Rake $0.27 
Board [6h 4s 2h 6s]
Seat 1: poseidoporunbot folded before Flop (didn't bet)
Seat 2: Sheva26Rus (button) folded before Flop
Seat 3: BestAger (small blind) collected ($5.78)
Seat 4: Jesus Ololo (big blind) folded on the Turn
Seat 5: Gari Nerskiy folded before Flop (didn't bet)
Seat 6: Laker_Style folded before Flop (didn't bet)



PokerStars Hand #222950513358:  Hold'em No Limit ($0.05/$0.10 USD) - 2021/01/23 6:13:52 ET
Table 'Saito II' 6-max Seat #3 is the button
Seat 1: poseidoporunbot ($10.20 in chips) 
Seat 2: Sheva26Rus ($17.81 in chips) 
Seat 3: BestAger ($12.93 in chips) 
Seat 4: Jesus Ololo ($10 in chips) 
Seat 5: Gari Nerskiy ($20.45 in chips) 
Seat 6: Laker_Style ($13.27 in chips) 
Jesus Ololo: posts small blind $0.05
Gari Nerskiy: posts big blind $0.10
*** HOLE CARDS ***
Laker_Style: folds 
poseidoporunbot: folds 
Sheva26Rus: folds 
BestAger: folds 
Jesus Ololo: raises $0.20 to $0.30
Gari Nerskiy: calls $0.20
*** FLOP *** [9d 7d Tc]
Jesus Ololo: bets $0.31
Gari Nerskiy: folds 
Uncalled bet ($0.31) returned to Jesus Ololo
Jesus Ololo collected $0.57 from pot
*** SUMMARY ***
Total pot $0.60 | Rake $0.03 
Board [9d 7d Tc]
Seat 1: poseidoporunbot folded before Flop (didn't bet)
Seat 2: Sheva26Rus folded before Flop (didn't bet)
Seat 3: BestAger (button) folded before Flop (didn't bet)
Seat 4: Jesus Ololo (small blind) collected ($0.57)
Seat 5: Gari Nerskiy (big blind) folded on the Flop
Seat 6: Laker_Style folded before Flop (didn't bet)



PokerStars Hand #222950522914:  Hold'em No Limit ($0.05/$0.10 USD) - 2021/01/23 6:14:21 ET
Table 'Saito II' 6-max Seat #4 is the button
Seat 1: poseidoporunbot ($10.20 in chips) 
Seat 2: Sheva26Rus ($17.81 in chips) 
Seat 3: BestAger ($12.93 in chips) 
Seat 4: Jesus Ololo ($10.27 in chips) 
Seat 5: Gari Nerskiy ($20.15 in chips) 
Seat 6: Laker_Style ($13.27 in chips) 
Gari Nerskiy: posts small blind $0.05
Laker_Style: posts big blind $0.10
*** HOLE CARDS ***
poseidoporunbot: folds 
Sheva26Rus: folds 
BestAger: folds 
Jesus Ololo: raises $0.15 to $0.25
Gari Nerskiy: raises $1 to $1.25
Laker_Style: folds 
Jesus Ololo: folds 
Uncalled bet ($1) returned to Gari Nerskiy
Gari Nerskiy collected $0.60 from pot
Gari Nerskiy: doesn't show hand 
*** SUMMARY ***
Total pot $0.60 | Rake $0 
Seat 1: poseidoporunbot folded before Flop (didn't bet)
Seat 2: Sheva26Rus folded before Flop (didn't bet)
Seat 3: BestAger folded before Flop (didn't bet)
Seat 4: Jesus Ololo (button) folded before Flop
Seat 5: Gari Nerskiy (small blind) collected ($0.60)
Seat 6: Laker_Style (big blind) folded before Flop



PokerStars Hand #222950529935:  Hold'em No Limit ($0.05/$0.10 USD) - 2021/01/23 6:14:43 ET
Table 'Saito II' 6-max Seat #5 is the button
Seat 1: poseidoporunbot ($10.20 in chips) 
Seat 2: Sheva26Rus ($17.81 in chips) 
Seat 3: BestAger ($12.93 in chips) 
Seat 4: Jesus Ololo ($10.02 in chips) 
Seat 5: Gari Nerskiy ($20.50 in chips) 
Seat 6: Laker_Style ($13.17 in chips) 
Laker_Style: posts small blind $0.05
poseidoporunbot: posts big blind $0.10
*** HOLE CARDS ***
Sheva26Rus: folds 
BestAger: raises $0.20 to $0.30
Jesus Ololo: folds 
Gari Nerskiy: folds 
Laker_Style: folds 
poseidoporunbot: folds 
Uncalled bet ($0.20) returned to BestAger
BestAger collected $0.25 from pot
BestAger: doesn't show hand 
*** SUMMARY ***
Total pot $0.25 | Rake $0 
Seat 1: poseidoporunbot (big blind) folded before Flop
Seat 2: Sheva26Rus folded before Flop (didn't bet)
Seat 3: BestAger collected ($0.25)
Seat 4: Jesus Ololo folded before Flop (didn't bet)
Seat 5: Gari Nerskiy (button) folded before Flop (didn't bet)
Seat 6: Laker_Style (small blind) folded before Flop



PokerStars Hand #222950535796:  Hold'em No Limit ($0.05/$0.10 USD) - 2021/01/23 6:15:01 ET
Table 'Saito II' 6-max Seat #6 is the button
Seat 1: poseidoporunbot ($10.10 in chips) 
Seat 2: Sheva26Rus ($17.81 in chips) 
Seat 3: BestAger ($13.08 in chips) 
Seat 4: Jesus Ololo ($10.02 in chips) 
Seat 5: Gari Nerskiy ($20.50 in chips) 
Seat 6: Laker_Style ($13.12 in chips) 
poseidoporunbot: posts small blind $0.05
Sheva26Rus: posts big blind $0.10
*** HOLE CARDS ***
BestAger: folds 
Jesus Ololo: raises $0.15 to $0.25
Gari Nerskiy: folds 
Laker_Style: folds 
poseidoporunbot: folds 
Sheva26Rus: folds 
Uncalled bet ($0.15) returned to Jesus Ololo
Jesus Ololo collected $0.25 from pot
*** SUMMARY ***
Total pot $0.25 | Rake $0 
Seat 1: poseidoporunbot (small blind) folded before Flop
Seat 2: Sheva26Rus (big blind) folded before Flop
Seat 3: BestAger folded before Flop (didn't bet)
Seat 4: Jesus Ololo collected ($0.25)
Seat 5: Gari Nerskiy folded before Flop (didn't bet)
Seat 6: Laker_Style (button) folded before Flop (didn't bet)



PokerStars Hand #222950543152:  Hold'em No Limit ($0.05/$0.10 USD) - 2021/01/23 6:15:23 ET
Table 'Saito II' 6-max Seat #1 is the button
Seat 1: poseidoporunbot ($10.05 in chips) 
Seat 2: Sheva26Rus ($17.71 in chips) 
Seat 3: BestAger ($13.08 in chips) 
Seat 4: Jesus Ololo ($10.17 in chips) 
Seat 5: Gari Nerskiy ($20.50 in chips) 
Seat 6: Laker_Style ($13.12 in chips) 
Sheva26Rus: posts small blind $0.05
BestAger: posts big blind $0.10
*** HOLE CARDS ***
Jesus Ololo: folds 
Gari Nerskiy: folds 
Laker_Style: folds 
poseidoporunbot: folds 
Sheva26Rus: folds 
Uncalled bet ($0.05) returned to BestAger
BestAger collected $0.10 from pot
BestAger: doesn't show hand 
*** SUMMARY ***
Total pot $0.10 | Rake $0 
Seat 1: poseidoporunbot (button) folded before Flop (didn't bet)
Seat 2: Sheva26Rus (small blind) folded before Flop
Seat 3: BestAger (big blind) collected ($0.10)
Seat 4: Jesus Ololo folded before Flop (didn't bet)
Seat 5: Gari Nerskiy folded before Flop (didn't bet)
Seat 6: Laker_Style folded before Flop (didn't bet)



PokerStars Hand #222950546247:  Hold'em No Limit ($0.05/$0.10 USD) - 2021/01/23 6:15:32 ET
Table 'Saito II' 6-max Seat #2 is the button
Seat 1: poseidoporunbot ($10.05 in chips) 
Seat 2: Sheva26Rus ($17.66 in chips) 
Seat 3: BestAger ($13.13 in chips) 
Seat 4: Jesus Ololo ($10.17 in chips) 
Seat 5: Gari Nerskiy ($20.50 in chips) 
Seat 6: Laker_Style ($13.12 in chips) 
BestAger: posts small blind $0.05
Jesus Ololo: posts big blind $0.10
*** HOLE CARDS ***
Gari Nerskiy: folds 
Laker_Style: folds 
poseidoporunbot: folds 
Sheva26Rus: folds 
BestAger: raises $0.10 to $0.20
Jesus Ololo: calls $0.10
*** FLOP *** [6h 2s Jc]
BestAger: bets $0.30
Jesus Ololo: folds 
Uncalled bet ($0.30) returned to BestAger
BestAger collected $0.38 from pot
BestAger: doesn't show hand 
*** SUMMARY ***
Total pot $0.40 | Rake $0.02 
Board [6h 2s Jc]
Seat 1: poseidoporunbot folded before Flop (didn't bet)
Seat 2: Sheva26Rus (button) folded before Flop (didn't bet)
Seat 3: BestAger (small blind) collected ($0.38)
Seat 4: Jesus Ololo (big blind) folded on the Flop
Seat 5: Gari Nerskiy folded before Flop (didn't bet)
Seat 6: Laker_Style folded before Flop (didn't bet)



PokerStars Hand #222950553030:  Hold'em No Limit ($0.05/$0.10 USD) - 2021/01/23 6:15:53 ET
Table 'Saito II' 6-max Seat #3 is the button
Seat 1: poseidoporunbot ($10.05 in chips) 
Seat 2: Sheva26Rus ($17.66 in chips) 
Seat 3: BestAger ($13.31 in chips) 
Seat 4: Jesus Ololo ($10 in chips) 
Seat 5: Gari Nerskiy ($20.50 in chips) 
Seat 6: Laker_Style ($13.12 in chips) 
Jesus Ololo: posts small blind $0.05
Gari Nerskiy: posts big blind $0.10
*** HOLE CARDS ***
Laker_Style: folds 
poseidoporunbot: folds 
Sheva26Rus: folds 
BestAger: folds 
Jesus Ololo: raises $0.20 to $0.30
Gari Nerskiy: folds 
Uncalled bet ($0.20) returned to Jesus Ololo
Jesus Ololo collected $0.20 from pot
*** SUMMARY ***
Total pot $0.20 | Rake $0 
Seat 1: poseidoporunbot folded before Flop (didn't bet)
Seat 2: Sheva26Rus folded before Flop (didn't bet)
Seat 3: BestAger (button) folded before Flop (didn't bet)
Seat 4: Jesus Ololo (small blind) collected ($0.20)
Seat 5: Gari Nerskiy (big blind) folded before Flop
Seat 6: Laker_Style folded before Flop (didn't bet)



PokerStars Hand #222950557064:  Hold'em No Limit ($0.05/$0.10 USD) - 2021/01/23 6:16:06 ET
Table 'Saito II' 6-max Seat #4 is the button
Seat 1: poseidoporunbot ($10.05 in chips) 
Seat 2: Sheva26Rus ($17.66 in chips) 
Seat 3: BestAger ($13.31 in chips) 
Seat 4: Jesus Ololo ($10.10 in chips) 
Seat 5: Gari Nerskiy ($20.40 in chips) 
Seat 6: Laker_Style ($13.12 in chips) 
Gari Nerskiy: posts small blind $0.05
Laker_Style: posts big blind $0.10
*** HOLE CARDS ***
poseidoporunbot: folds 
Sheva26Rus: folds 
BestAger: folds 
Jesus Ololo: folds 
Gari Nerskiy: raises $0.20 to $0.30
Laker_Style: folds 
Uncalled bet ($0.20) returned to Gari Nerskiy
Gari Nerskiy collected $0.20 from pot
Gari Nerskiy: doesn't show hand 
*** SUMMARY ***
Total pot $0.20 | Rake $0 
Seat 1: poseidoporunbot folded before Flop (didn't bet)
Seat 2: Sheva26Rus folded before Flop (didn't bet)
Seat 3: BestAger folded before Flop (didn't bet)
Seat 4: Jesus Ololo (button) folded before Flop (didn't bet)
Seat 5: Gari Nerskiy (small blind) collected ($0.20)
Seat 6: Laker_Style (big blind) folded before Flop



PokerStars Hand #222950567203:  Hold'em No Limit ($0.05/$0.10 USD) - 2021/01/23 6:16:37 ET
Table 'Saito II' 6-max Seat #5 is the button
Seat 2: Sheva26Rus ($17.66 in chips) 
Seat 3: BestAger ($13.31 in chips) 
Seat 4: Jesus Ololo ($10.10 in chips) 
Seat 5: Gari Nerskiy ($20.50 in chips) 
Seat 6: Laker_Style ($13.02 in chips) 
Laker_Style: posts small blind $0.05
poseidoporunbot: is sitting out 
Sheva26Rus: posts big blind $0.10
*** HOLE CARDS ***
BestAger: folds 
Jesus Ololo: raises $0.15 to $0.25
poseidoporunbot leaves the table
Gari Nerskiy: folds 
benlondon148 joins the table at seat #1 
Laker_Style: folds 
Sheva26Rus: folds 
Uncalled bet ($0.15) returned to Jesus Ololo
Jesus Ololo collected $0.25 from pot
*** SUMMARY ***
Total pot $0.25 | Rake $0 
Seat 2: Sheva26Rus (big blind) folded before Flop
Seat 3: BestAger folded before Flop (didn't bet)
Seat 4: Jesus Ololo collected ($0.25)
Seat 5: Gari Nerskiy (button) folded before Flop (didn't bet)
Seat 6: Laker_Style (small blind) folded before Flop



PokerStars Hand #222950573111:  Hold'em No Limit ($0.05/$0.10 USD) - 2021/01/23 6:16:55 ET
Table 'Saito II' 6-max Seat #6 is the button
Seat 2: Sheva26Rus ($17.56 in chips) 
Seat 3: BestAger ($13.31 in chips) 
Seat 4: Jesus Ololo ($10.25 in chips) 
Seat 5: Gari Nerskiy ($20.50 in chips) 
Seat 6: Laker_Style ($12.97 in chips) 
Sheva26Rus: posts small blind $0.05
BestAger: posts big blind $0.10
*** HOLE CARDS ***
Jesus Ololo: folds 
Gari Nerskiy: folds 
Laker_Style: raises $0.15 to $0.25
Sheva26Rus: folds 
BestAger: calls $0.15
*** FLOP *** [Ad 4c Td]
BestAger: checks 
Laker_Style: bets $0.27
BestAger: folds 
Uncalled bet ($0.27) returned to Laker_Style
Laker_Style collected $0.53 from pot
Laker_Style: doesn't show hand 
*** SUMMARY ***
Total pot $0.55 | Rake $0.02 
Board [Ad 4c Td]
Seat 2: Sheva26Rus (small blind) folded before Flop
Seat 3: BestAger (big blind) folded on the Flop
Seat 4: Jesus Ololo folded before Flop (didn't bet)
Seat 5: Gari Nerskiy folded before Flop (didn't bet)
Seat 6: Laker_Style (button) collected ($0.53)



PokerStars Hand #222950583035:  Hold'em No Limit ($0.05/$0.10 USD) - 2021/01/23 6:17:25 ET
Table 'Saito II' 6-max Seat #2 is the button
Seat 1: benlondon148 ($10 in chips) 
Seat 2: Sheva26Rus ($17.51 in chips) 
Seat 3: BestAger ($13.06 in chips) 
Seat 4: Jesus Ololo ($10.25 in chips) 
Seat 5: Gari Nerskiy ($20.50 in chips) 
Seat 6: Laker_Style ($13.25 in chips) 
BestAger: posts small blind $0.05
Jesus Ololo: posts big blind $0.10
benlondon148: posts big blind $0.10
*** HOLE CARDS ***
Gari Nerskiy: raises $0.45 to $0.55
Laker_Style: folds 
benlondon148: calls $0.45
Sheva26Rus: folds 
BestAger: folds 
Jesus Ololo: folds 
*** FLOP *** [5s 3h Th]
Gari Nerskiy: bets $0.51
benlondon148: folds 
Uncalled bet ($0.51) returned to Gari Nerskiy
Gari Nerskiy collected $1.19 from pot
Gari Nerskiy: doesn't show hand 
*** SUMMARY ***
Total pot $1.25 | Rake $0.06 
Board [5s 3h Th]
Seat 1: benlondon148 folded on the Flop
Seat 2: Sheva26Rus (button) folded before Flop (didn't bet)
Seat 3: BestAger (small blind) folded before Flop
Seat 4: Jesus Ololo (big blind) folded before Flop
Seat 5: Gari Nerskiy collected ($1.19)
Seat 6: Laker_Style folded before Flop (didn't bet)



PokerStars Hand #222950592395:  Hold'em No Limit ($0.05/$0.10 USD) - 2021/01/23 6:17:54 ET
Table 'Saito II' 6-max Seat #3 is the button
Seat 1: benlondon148 ($9.45 in chips) 
Seat 2: Sheva26Rus ($17.51 in chips) 
Seat 3: BestAger ($13.01 in chips) 
Seat 4: Jesus Ololo ($10.15 in chips) 
Seat 5: Gari Nerskiy ($21.14 in chips) 
Seat 6: Laker_Style ($13.25 in chips) 
Jesus Ololo: posts small blind $0.05
Gari Nerskiy: posts big blind $0.10
*** HOLE CARDS ***
Laker_Style: folds 
benlondon148: folds 
Sheva26Rus: folds 
BestAger: folds 
Jesus Ololo: raises $0.20 to $0.30
Gari Nerskiy: raises $0.95 to $1.25
Jesus Ololo: folds 
Uncalled bet ($0.95) returned to Gari Nerskiy
Gari Nerskiy collected $0.60 from pot
Gari Nerskiy: doesn't show hand 
*** SUMMARY ***
Total pot $0.60 | Rake $0 
Seat 1: benlondon148 folded before Flop (didn't bet)
Seat 2: Sheva26Rus folded before Flop (didn't bet)
Seat 3: BestAger (button) folded before Flop (didn't bet)
Seat 4: Jesus Ololo (small blind) folded before Flop
Seat 5: Gari Nerskiy (big blind) collected ($0.60)
Seat 6: Laker_Style folded before Flop (didn't bet)



PokerStars Hand #222950602261:  Hold'em No Limit ($0.05/$0.10 USD) - 2021/01/23 6:18:24 ET
Table 'Saito II' 6-max Seat #4 is the button
Seat 1: benlondon148 ($9.45 in chips) 
Seat 2: Sheva26Rus ($17.51 in chips) 
Seat 3: BestAger ($13.01 in chips) 
Seat 4: Jesus Ololo ($10 in chips) 
Seat 5: Gari Nerskiy ($21.44 in chips) 
Seat 6: Laker_Style ($13.25 in chips) 
Gari Nerskiy: posts small blind $0.05
Laker_Style: posts big blind $0.10
*** HOLE CARDS ***
benlondon148: calls $0.10
Sheva26Rus: folds 
BestAger: folds 
Jesus Ololo: raises $0.30 to $0.40
Gari Nerskiy: raises $1.05 to $1.45
Laker_Style: folds 
benlondon148: calls $1.35
Jesus Ololo: folds 
*** FLOP *** [9c 7h Ad]
Gari Nerskiy: bets $0.94
benlondon148: raises $0.94 to $1.88
Gari Nerskiy: folds 
Uncalled bet ($0.94) returned to benlondon148
benlondon148 collected $5.04 from pot
benlondon148: doesn't show hand 
*** SUMMARY ***
Total pot $5.28 | Rake $0.24 
Board [9c 7h Ad]
Seat 1: benlondon148 collected ($5.04)
Seat 2: Sheva26Rus folded before Flop (didn't bet)
Seat 3: BestAger folded before Flop (didn't bet)
Seat 4: Jesus Ololo (button) folded before Flop
Seat 5: Gari Nerskiy (small blind) folded on the Flop
Seat 6: Laker_Style (big blind) folded before Flop



PokerStars Hand #222950618181:  Hold'em No Limit ($0.05/$0.10 USD) - 2021/01/23 6:19:13 ET
Table 'Saito II' 6-max Seat #5 is the button
Seat 1: benlondon148 ($12.10 in chips) 
Seat 2: Sheva26Rus ($17.51 in chips) 
Seat 3: BestAger ($13.01 in chips) 
Seat 4: Jesus Ololo ($10 in chips) 
Seat 5: Gari Nerskiy ($19.05 in chips) 
Seat 6: Laker_Style ($13.15 in chips) 
Laker_Style: posts small blind $0.05
benlondon148: posts big blind $0.10
*** HOLE CARDS ***
Sheva26Rus: folds 
BestAger: folds 
Jesus Ololo: folds 
Gari Nerskiy: raises $0.10 to $0.20
Laker_Style: folds 
benlondon148: calls $0.10
*** FLOP *** [5s Qh As]
benlondon148: checks 
Gari Nerskiy: bets $0.12
benlondon148: folds 
Uncalled bet ($0.12) returned to Gari Nerskiy
Gari Nerskiy collected $0.43 from pot
Gari Nerskiy: doesn't show hand 
*** SUMMARY ***
Total pot $0.45 | Rake $0.02 
Board [5s Qh As]
Seat 1: benlondon148 (big blind) folded on the Flop
Seat 2: Sheva26Rus folded before Flop (didn't bet)
Seat 3: BestAger folded before Flop (didn't bet)
Seat 4: Jesus Ololo folded before Flop (didn't bet)
Seat 5: Gari Nerskiy (button) collected ($0.43)
Seat 6: Laker_Style (small blind) folded before Flop



PokerStars Hand #222950626761:  Hold'em No Limit ($0.05/$0.10 USD) - 2021/01/23 6:19:39 ET
Table 'Saito II' 6-max Seat #6 is the button
Seat 1: benlondon148 ($11.90 in chips) 
Seat 2: Sheva26Rus ($17.51 in chips) 
Seat 3: BestAger ($13.01 in chips) 
Seat 4: Jesus Ololo ($10 in chips) 
Seat 5: Gari Nerskiy ($19.28 in chips) 
Seat 6: Laker_Style ($13.10 in chips) 
benlondon148: posts small blind $0.05
Sheva26Rus: posts big blind $0.10
*** HOLE CARDS ***
BestAger: folds 
Jesus Ololo: folds 
Gari Nerskiy: folds 
Laker_Style: raises $0.15 to $0.25
benlondon148: raises $1.75 to $2
Sheva26Rus: folds 
Laker_Style: folds 
Uncalled bet ($1.75) returned to benlondon148
benlondon148 collected $0.60 from pot
benlondon148: doesn't show hand 
*** SUMMARY ***
Total pot $0.60 | Rake $0 
Seat 1: benlondon148 (small blind) collected ($0.60)
Seat 2: Sheva26Rus (big blind) folded before Flop
Seat 3: BestAger folded before Flop (didn't bet)
Seat 4: Jesus Ololo folded before Flop (didn't bet)
Seat 5: Gari Nerskiy folded before Flop (didn't bet)
Seat 6: Laker_Style (button) folded before Flop



PokerStars Hand #222950637194:  Hold'em No Limit ($0.05/$0.10 USD) - 2021/01/23 6:20:11 ET
Table 'Saito II' 6-max Seat #1 is the button
Seat 1: benlondon148 ($12.25 in chips) 
Seat 2: Sheva26Rus ($17.41 in chips) 
Seat 3: BestAger ($13.01 in chips) 
Seat 4: Jesus Ololo ($10 in chips) 
Seat 5: Gari Nerskiy ($19.28 in chips) 
Seat 6: Laker_Style ($12.85 in chips) 
Sheva26Rus: posts small blind $0.05
BestAger: posts big blind $0.10
*** HOLE CARDS ***
Jesus Ololo: folds 
Gari Nerskiy: raises $0.15 to $0.25
Laker_Style: folds 
benlondon148: folds 
Sheva26Rus: folds 
BestAger: calls $0.15
*** FLOP *** [4c 5h Qh]
BestAger: bets $0.30
Gari Nerskiy: folds 
Uncalled bet ($0.30) returned to BestAger
BestAger collected $0.53 from pot
BestAger: doesn't show hand 
*** SUMMARY ***
Total pot $0.55 | Rake $0.02 
Board [4c 5h Qh]
Seat 1: benlondon148 (button) folded before Flop (didn't bet)
Seat 2: Sheva26Rus (small blind) folded before Flop
Seat 3: BestAger (big blind) collected ($0.53)
Seat 4: Jesus Ololo folded before Flop (didn't bet)
Seat 5: Gari Nerskiy folded on the Flop
Seat 6: Laker_Style folded before Flop (didn't bet)



PokerStars Hand #222950646139:  Hold'em No Limit ($0.05/$0.10 USD) - 2021/01/23 6:20:37 ET
Table 'Saito II' 6-max Seat #2 is the button
Seat 1: benlondon148 ($12.25 in chips) 
Seat 2: Sheva26Rus ($17.36 in chips) 
Seat 3: BestAger ($13.29 in chips) 
Seat 4: Jesus Ololo ($10 in chips) 
Seat 5: Gari Nerskiy ($19.03 in chips) 
Seat 6: Laker_Style ($12.85 in chips) 
BestAger: posts small blind $0.05
Jesus Ololo: posts big blind $0.10
*** HOLE CARDS ***
Gari Nerskiy: folds 
Laker_Style: folds 
benlondon148: calls $0.10
Sheva26Rus: folds 
BestAger: folds 
Jesus Ololo: checks 
*** FLOP *** [Kh 5s Kd]
Jesus Ololo: checks 
benlondon148: bets $1.10
Jesus Ololo: folds 
Uncalled bet ($1.10) returned to benlondon148
benlondon148 collected $0.24 from pot
benlondon148: doesn't show hand 
*** SUMMARY ***
Total pot $0.25 | Rake $0.01 
Board [Kh 5s Kd]
Seat 1: benlondon148 collected ($0.24)
Seat 2: Sheva26Rus (button) folded before Flop (didn't bet)
Seat 3: BestAger (small blind) folded before Flop
Seat 4: Jesus Ololo (big blind) folded on the Flop
Seat 5: Gari Nerskiy folded before Flop (didn't bet)
Seat 6: Laker_Style folded before Flop (didn't bet)



PokerStars Hand #222950653523:  Hold'em No Limit ($0.05/$0.10 USD) - 2021/01/23 6:21:00 ET
Table 'Saito II' 6-max Seat #3 is the button
Seat 1: benlondon148 ($12.39 in chips) 
Seat 2: Sheva26Rus ($17.36 in chips) 
Seat 3: BestAger ($13.24 in chips) 
Seat 4: Jesus Ololo ($10 in chips) 
Seat 5: Gari Nerskiy ($19.03 in chips) 
Seat 6: Laker_Style ($12.85 in chips) 
Jesus Ololo: posts small blind $0.05
Gari Nerskiy: posts big blind $0.10
*** HOLE CARDS ***
Laker_Style: folds 
benlondon148: folds 
Sheva26Rus: folds 
BestAger: raises $0.10 to $0.20
Jesus Ololo: folds 
Gari Nerskiy: folds 
Uncalled bet ($0.10) returned to BestAger
BestAger collected $0.25 from pot
BestAger: doesn't show hand 
*** SUMMARY ***
Total pot $0.25 | Rake $0 
Seat 1: benlondon148 folded before Flop (didn't bet)
Seat 2: Sheva26Rus folded before Flop (didn't bet)
Seat 3: BestAger (button) collected ($0.25)
Seat 4: Jesus Ololo (small blind) folded before Flop
Seat 5: Gari Nerskiy (big blind) folded before Flop
Seat 6: Laker_Style folded before Flop (didn't bet)



PokerStars Hand #222950659747:  Hold'em No Limit ($0.05/$0.10 USD) - 2021/01/23 6:21:19 ET
Table 'Saito II' 6-max Seat #4 is the button
Seat 1: benlondon148 ($12.39 in chips) 
Seat 2: Sheva26Rus ($17.36 in chips) 
Seat 3: BestAger ($13.39 in chips) 
Seat 4: Jesus Ololo ($10 in chips) 
Seat 5: Gari Nerskiy ($18.93 in chips) 
Seat 6: Laker_Style ($12.85 in chips) 
Gari Nerskiy: posts small blind $0.05
Laker_Style: posts big blind $0.10
*** HOLE CARDS ***
benlondon148: calls $0.10
Sheva26Rus: folds 
BestAger: folds 
Jesus Ololo: folds 
Gari Nerskiy: folds 
Laker_Style: checks 
*** FLOP *** [8s Ad 7s]
Laker_Style: checks 
benlondon148: checks 
*** TURN *** [8s Ad 7s] [Qs]
Laker_Style: checks 
benlondon148: bets $4
Laker_Style: folds 
Uncalled bet ($4) returned to benlondon148
benlondon148 collected $0.24 from pot
benlondon148: doesn't show hand 
*** SUMMARY ***
Total pot $0.25 | Rake $0.01 
Board [8s Ad 7s Qs]
Seat 1: benlondon148 collected ($0.24)
Seat 2: Sheva26Rus folded before Flop (didn't bet)
Seat 3: BestAger folded before Flop (didn't bet)
Seat 4: Jesus Ololo (button) folded before Flop (didn't bet)
Seat 5: Gari Nerskiy (small blind) folded before Flop
Seat 6: Laker_Style (big blind) folded on the Turn



PokerStars Hand #222950677677:  Hold'em No Limit ($0.05/$0.10 USD) - 2021/01/23 6:22:13 ET
Table 'Saito II' 6-max Seat #5 is the button
Seat 1: benlondon148 ($12.53 in chips) 
Seat 2: Sheva26Rus ($17.36 in chips) 
Seat 3: BestAger ($13.39 in chips) 
Seat 4: Jesus Ololo ($10 in chips) 
Seat 5: Gari Nerskiy ($18.88 in chips) 
Seat 6: Laker_Style ($12.75 in chips) 
Laker_Style: posts small blind $0.05
benlondon148: posts big blind $0.10
*** HOLE CARDS ***
Sheva26Rus: folds 
BestAger: folds 
Jesus Ololo: folds 
Gari Nerskiy: raises $0.15 to $0.25
Laker_Style: folds 
benlondon148: calls $0.15
*** FLOP *** [3h Qs 7d]
benlondon148: checks 
Gari Nerskiy: bets $0.15
benlondon148: folds 
Uncalled bet ($0.15) returned to Gari Nerskiy
Gari Nerskiy collected $0.53 from pot
Gari Nerskiy: doesn't show hand 
*** SUMMARY ***
Total pot $0.55 | Rake $0.02 
Board [3h Qs 7d]
Seat 1: benlondon148 (big blind) folded on the Flop
Seat 2: Sheva26Rus folded before Flop (didn't bet)
Seat 3: BestAger folded before Flop (didn't bet)
Seat 4: Jesus Ololo folded before Flop (didn't bet)
Seat 5: Gari Nerskiy (button) collected ($0.53)
Seat 6: Laker_Style (small blind) folded before Flop



PokerStars Hand #222950687378:  Hold'em No Limit ($0.05/$0.10 USD) - 2021/01/23 6:22:43 ET
Table 'Saito II' 6-max Seat #6 is the button
Seat 1: benlondon148 ($12.28 in chips) 
Seat 2: Sheva26Rus ($17.36 in chips) 
Seat 3: BestAger ($13.39 in chips) 
Seat 4: Jesus Ololo ($10 in chips) 
Seat 5: Gari Nerskiy ($19.16 in chips) 
Seat 6: Laker_Style ($12.70 in chips) 
benlondon148: posts small blind $0.05
Sheva26Rus: posts big blind $0.10
*** HOLE CARDS ***
BestAger: folds 
Jesus Ololo: folds 
Gari Nerskiy: raises $0.15 to $0.25
Laker_Style: folds 
benlondon148: raises $0.15 to $0.40
Sheva26Rus: raises $1.60 to $2
Gari Nerskiy: folds 
benlondon148: calls $1.60
*** FLOP *** [7s Qs Jh]
benlondon148: bets $0.60
Sheva26Rus: raises $14.76 to $15.36 and is all-in
benlondon148: folds 
Uncalled bet ($14.76) returned to Sheva26Rus
Sheva26Rus collected $5.20 from pot
Sheva26Rus: doesn't show hand 
*** SUMMARY ***
Total pot $5.45 | Rake $0.25 
Board [7s Qs Jh]
Seat 1: benlondon148 (small blind) folded on the Flop
Seat 2: Sheva26Rus (big blind) collected ($5.20)
Seat 3: BestAger folded before Flop (didn't bet)
Seat 4: Jesus Ololo folded before Flop (didn't bet)
Seat 5: Gari Nerskiy folded before Flop
Seat 6: Laker_Style (button) folded before Flop (didn't bet)



PokerStars Hand #222950700729:  Hold'em No Limit ($0.05/$0.10 USD) - 2021/01/23 6:23:23 ET
Table 'Saito II' 6-max Seat #1 is the button
Seat 1: benlondon148 ($9.68 in chips) 
Seat 2: Sheva26Rus ($19.96 in chips) 
Seat 3: BestAger ($13.39 in chips) 
Seat 4: Jesus Ololo ($10 in chips) 
Seat 5: Gari Nerskiy ($18.91 in chips) 
Seat 6: Laker_Style ($12.70 in chips) 
Sheva26Rus: posts small blind $0.05
BestAger: posts big blind $0.10
*** HOLE CARDS ***
Jesus Ololo: folds 
Gari Nerskiy: folds 
Laker_Style: folds 
benlondon148: calls $0.10
Sheva26Rus: folds 
BestAger: raises $0.20 to $0.30
benlondon148: raises $2.80 to $3.10
BestAger: calls $2.80
*** FLOP *** [8d 7d Ac]
BestAger: bets $2.30
benlondon148: calls $2.30
*** TURN *** [8d 7d Ac] [Jd]
BestAger: bets $7.99 and is all-in
benlondon148: calls $4.28 and is all-in
Uncalled bet ($3.71) returned to BestAger
benlondon148 has timed out
*** RIVER *** [8d 7d Ac Jd] [Js]
*** SHOW DOWN ***
BestAger: shows [Ah Qd] (two pair, Aces and Jacks)
benlondon148: shows [Qc Qs] (two pair, Queens and Jacks)
BestAger cashed out the hand for $17.94 | Cash Out Fee $0.18
*** SUMMARY ***
Total pot $19.41 | Rake $0.87 
Board [8d 7d Ac Jd Js]
Seat 1: benlondon148 (button) showed [Qc Qs] and lost with two pair, Queens and Jacks
Seat 2: Sheva26Rus (small blind) folded before Flop
Seat 3: BestAger (big blind) showed [Ah Qd] and won ($18.54) with two pair, Aces and Jacks (pot not awarded as player cashed out)
Seat 4: Jesus Ololo folded before Flop (didn't bet)
Seat 5: Gari Nerskiy folded before Flop (didn't bet)
Seat 6: Laker_Style folded before Flop (didn't bet)



PokerStars Hand #222950720551:  Hold'em No Limit ($0.05/$0.10 USD) - 2021/01/23 6:24:23 ET
Table 'Saito II' 6-max Seat #2 is the button
Seat 2: Sheva26Rus ($19.91 in chips) 
Seat 3: BestAger ($21.65 in chips) 
Seat 4: Jesus Ololo ($10 in chips) 
Seat 5: Gari Nerskiy ($18.91 in chips) 
Seat 6: Laker_Style ($12.70 in chips) 
BestAger: posts small blind $0.05
Jesus Ololo: posts big blind $0.10
*** HOLE CARDS ***
Gari Nerskiy: folds 
Laker_Style: folds 
Sheva26Rus: folds 
BestAger: raises $0.10 to $0.20
Jesus Ololo: folds 
Uncalled bet ($0.10) returned to BestAger
BestAger collected $0.20 from pot
BestAger: doesn't show hand 
*** SUMMARY ***
Total pot $0.20 | Rake $0 
Seat 2: Sheva26Rus (button) folded before Flop (didn't bet)
Seat 3: BestAger (small blind) collected ($0.20)
Seat 4: Jesus Ololo (big blind) folded before Flop
Seat 5: Gari Nerskiy folded before Flop (didn't bet)
Seat 6: Laker_Style folded before Flop (didn't bet)



PokerStars Hand #222950723800:  Hold'em No Limit ($0.05/$0.10 USD) - 2021/01/23 6:24:32 ET
Table 'Saito II' 6-max Seat #3 is the button
Seat 1: benlondon148 ($9.70 in chips) 
Seat 2: Sheva26Rus ($19.91 in chips) 
Seat 3: BestAger ($21.75 in chips) 
Seat 4: Jesus Ololo ($10 in chips) 
Seat 5: Gari Nerskiy ($18.91 in chips) 
Seat 6: Laker_Style ($12.70 in chips) 
Jesus Ololo: posts small blind $0.05
Gari Nerskiy: posts big blind $0.10
*** HOLE CARDS ***
Laker_Style: folds 
benlondon148: folds 
Sheva26Rus: raises $0.15 to $0.25
BestAger: folds 
Jesus Ololo: folds 
Gari Nerskiy: folds 
Uncalled bet ($0.15) returned to Sheva26Rus
Sheva26Rus collected $0.25 from pot
Sheva26Rus: doesn't show hand 
*** SUMMARY ***
Total pot $0.25 | Rake $0 
Seat 1: benlondon148 folded before Flop (didn't bet)
Seat 2: Sheva26Rus collected ($0.25)
Seat 3: BestAger (button) folded before Flop (didn't bet)
Seat 4: Jesus Ololo (small blind) folded before Flop
Seat 5: Gari Nerskiy (big blind) folded before Flop
Seat 6: Laker_Style folded before Flop (didn't bet)



PokerStars Hand #222950729238:  Hold'em No Limit ($0.05/$0.10 USD) - 2021/01/23 6:24:49 ET
Table 'Saito II' 6-max Seat #4 is the button
Seat 1: benlondon148 ($9.70 in chips) 
Seat 2: Sheva26Rus ($20.06 in chips) 
Seat 3: BestAger ($21.75 in chips) 
Seat 4: Jesus Ololo ($10 in chips) 
Seat 5: Gari Nerskiy ($18.81 in chips) 
Seat 6: Laker_Style ($12.70 in chips) 
Gari Nerskiy: posts small blind $0.05
Laker_Style: posts big blind $0.10
*** HOLE CARDS ***
benlondon148 has timed out
benlondon148: folds 
Sheva26Rus: raises $0.20 to $0.30
BestAger: folds 
Jesus Ololo: folds 
Gari Nerskiy: folds 
Laker_Style: folds 
Uncalled bet ($0.20) returned to Sheva26Rus
Sheva26Rus collected $0.25 from pot
Sheva26Rus: doesn't show hand 
*** SUMMARY ***
Total pot $0.25 | Rake $0 
Seat 1: benlondon148 folded before Flop (didn't bet)
Seat 2: Sheva26Rus collected ($0.25)
Seat 3: BestAger folded before Flop (didn't bet)
Seat 4: Jesus Ololo (button) folded before Flop (didn't bet)
Seat 5: Gari Nerskiy (small blind) folded before Flop
Seat 6: Laker_Style (big blind) folded before Flop



PokerStars Hand #222950736633:  Hold'em No Limit ($0.05/$0.10 USD) - 2021/01/23 6:25:11 ET
Table 'Saito II' 6-max Seat #5 is the button
Seat 1: benlondon148 ($9.70 in chips) 
Seat 2: Sheva26Rus ($20.21 in chips) 
Seat 3: BestAger ($21.75 in chips) 
Seat 4: Jesus Ololo ($10 in chips) 
Seat 5: Gari Nerskiy ($18.76 in chips) 
Seat 6: Laker_Style ($12.60 in chips) 
Laker_Style: posts small blind $0.05
benlondon148: posts big blind $0.10
*** HOLE CARDS ***
Sheva26Rus: folds 
BestAger: folds 
Jesus Ololo: folds 
Gari Nerskiy: folds 
Laker_Style: raises $0.20 to $0.30
benlondon148: raises $0.20 to $0.50
Laker_Style: calls $0.20
*** FLOP *** [9h 5h Ad]
Laker_Style: checks 
benlondon148: bets $0.10
Laker_Style: calls $0.10
*** TURN *** [9h 5h Ad] [Js]
Laker_Style: checks 
benlondon148: checks 
*** RIVER *** [9h 5h Ad Js] [8c]
Laker_Style: checks 
benlondon148: checks 
*** SHOW DOWN ***
Laker_Style: shows [4c Ah] (a pair of Aces)
benlondon148: mucks hand 
Laker_Style collected $1.15 from pot
*** SUMMARY ***
Total pot $1.20 | Rake $0.05 
Board [9h 5h Ad Js 8c]
Seat 1: benlondon148 (big blind) mucked
Seat 2: Sheva26Rus folded before Flop (didn't bet)
Seat 3: BestAger folded before Flop (didn't bet)
Seat 4: Jesus Ololo folded before Flop (didn't bet)
Seat 5: Gari Nerskiy (button) folded before Flop (didn't bet)
Seat 6: Laker_Style (small blind) showed [4c Ah] and won ($1.15) with a pair of Aces



PokerStars Hand #222950756395:  Hold'em No Limit ($0.05/$0.10 USD) - 2021/01/23 6:26:10 ET
Table 'Saito II' 6-max Seat #6 is the button
Seat 1: benlondon148 ($9.10 in chips) 
Seat 2: Sheva26Rus ($20.21 in chips) 
Seat 3: BestAger ($21.75 in chips) 
Seat 4: Jesus Ololo ($10 in chips) 
Seat 5: Gari Nerskiy ($18.76 in chips) 
Seat 6: Laker_Style ($13.15 in chips) 
benlondon148: posts small blind $0.05
Sheva26Rus: posts big blind $0.10
*** HOLE CARDS ***
BestAger: folds 
Jesus Ololo: folds 
Gari Nerskiy: raises $0.15 to $0.25
Laker_Style: folds 
benlondon148: folds 
Sheva26Rus: folds 
Uncalled bet ($0.15) returned to Gari Nerskiy
Gari Nerskiy collected $0.25 from pot
Gari Nerskiy: doesn't show hand 
*** SUMMARY ***
Total pot $0.25 | Rake $0 
Seat 1: benlondon148 (small blind) folded before Flop
Seat 2: Sheva26Rus (big blind) folded before Flop
Seat 3: BestAger folded before Flop (didn't bet)
Seat 4: Jesus Ololo folded before Flop (didn't bet)
Seat 5: Gari Nerskiy collected ($0.25)
Seat 6: Laker_Style (button) folded before Flop (didn't bet)



PokerStars Hand #222950761947:  Hold'em No Limit ($0.05/$0.10 USD) - 2021/01/23 6:26:27 ET
Table 'Saito II' 6-max Seat #1 is the button
Seat 1: benlondon148 ($9.05 in chips) 
Seat 2: Sheva26Rus ($20.11 in chips) 
Seat 3: BestAger ($21.75 in chips) 
Seat 4: Jesus Ololo ($10 in chips) 
Seat 5: Gari Nerskiy ($18.91 in chips) 
Seat 6: Laker_Style ($13.15 in chips) 
Sheva26Rus: posts small blind $0.05
BestAger: posts big blind $0.10
*** HOLE CARDS ***
Jesus Ololo: folds 
Gari Nerskiy: folds 
Laker_Style: folds 
benlondon148: folds 
Sheva26Rus: folds 
Uncalled bet ($0.05) returned to BestAger
BestAger collected $0.10 from pot
BestAger: doesn't show hand 
*** SUMMARY ***
Total pot $0.10 | Rake $0 
Seat 1: benlondon148 (button) folded before Flop (didn't bet)
Seat 2: Sheva26Rus (small blind) folded before Flop
Seat 3: BestAger (big blind) collected ($0.10)
Seat 4: Jesus Ololo folded before Flop (didn't bet)
Seat 5: Gari Nerskiy folded before Flop (didn't bet)
Seat 6: Laker_Style folded before Flop (didn't bet)



PokerStars Hand #222950766460:  Hold'em No Limit ($0.05/$0.10 USD) - 2021/01/23 6:26:40 ET
Table 'Saito II' 6-max Seat #2 is the button
Seat 1: benlondon148 ($9.05 in chips) 
Seat 2: Sheva26Rus ($20.06 in chips) 
Seat 3: BestAger ($21.80 in chips) 
Seat 4: Jesus Ololo ($10 in chips) 
Seat 5: Gari Nerskiy ($18.91 in chips) 
Seat 6: Laker_Style ($13.15 in chips) 
BestAger: posts small blind $0.05
Jesus Ololo: posts big blind $0.10
*** HOLE CARDS ***
Gari Nerskiy: folds 
Laker_Style: folds 
benlondon148: folds 
Sheva26Rus: folds 
BestAger: folds 
Uncalled bet ($0.05) returned to Jesus Ololo
Jesus Ololo collected $0.10 from pot
*** SUMMARY ***
Total pot $0.10 | Rake $0 
Seat 1: benlondon148 folded before Flop (didn't bet)
Seat 2: Sheva26Rus (button) folded before Flop (didn't bet)
Seat 3: BestAger (small blind) folded before Flop
Seat 4: Jesus Ololo (big blind) collected ($0.10)
Seat 5: Gari Nerskiy folded before Flop (didn't bet)
Seat 6: Laker_Style folded before Flop (didn't bet)



PokerStars Hand #222950769263:  Hold'em No Limit ($0.05/$0.10 USD) - 2021/01/23 6:26:49 ET
Table 'Saito II' 6-max Seat #3 is the button
Seat 1: benlondon148 ($9.05 in chips) 
Seat 2: Sheva26Rus ($20.06 in chips) 
Seat 3: BestAger ($21.75 in chips) 
Seat 4: Jesus Ololo ($10.05 in chips) 
Seat 5: Gari Nerskiy ($18.91 in chips) 
Seat 6: Laker_Style ($13.15 in chips) 
Jesus Ololo: posts small blind $0.05
Gari Nerskiy: posts big blind $0.10
*** HOLE CARDS ***
Laker_Style: folds 
benlondon148: calls $0.10
Sheva26Rus: folds 
BestAger: folds 
Jesus Ololo: folds 
Gari Nerskiy: checks 
*** FLOP *** [2s 6h 3h]
Gari Nerskiy: checks 
benlondon148: checks 
*** TURN *** [2s 6h 3h] [9h]
Gari Nerskiy: checks 
benlondon148: checks 
*** RIVER *** [2s 6h 3h 9h] [5h]
Gari Nerskiy: checks 
benlondon148: checks 
*** SHOW DOWN ***
Gari Nerskiy: shows [Qd Ks] (high card King)
benlondon148: shows [Td Ah] (a flush, Ace high)
benlondon148 collected $0.24 from pot
*** SUMMARY ***
Total pot $0.25 | Rake $0.01 
Board [2s 6h 3h 9h 5h]
Seat 1: benlondon148 showed [Td Ah] and won ($0.24) with a flush, Ace high
Seat 2: Sheva26Rus folded before Flop (didn't bet)
Seat 3: BestAger (button) folded before Flop (didn't bet)
Seat 4: Jesus Ololo (small blind) folded before Flop
Seat 5: Gari Nerskiy (big blind) showed [Qd Ks] and lost with high card King
Seat 6: Laker_Style folded before Flop (didn't bet)



PokerStars Hand #222950778687:  Hold'em No Limit ($0.05/$0.10 USD) - 2021/01/23 6:27:17 ET
Table 'Saito II' 6-max Seat #4 is the button
Seat 1: benlondon148 ($9.19 in chips) 
Seat 2: Sheva26Rus ($20.06 in chips) 
Seat 3: BestAger ($21.75 in chips) 
Seat 4: Jesus Ololo ($10 in chips) 
Seat 5: Gari Nerskiy ($18.81 in chips) 
Seat 6: Laker_Style ($13.15 in chips) 
Gari Nerskiy: posts small blind $0.05
Laker_Style: posts big blind $0.10
*** HOLE CARDS ***
benlondon148: folds 
Sheva26Rus: folds 
BestAger: raises $0.10 to $0.20
Jesus Ololo: folds 
Gari Nerskiy: raises $1.05 to $1.25
Laker_Style: folds 
BestAger: folds 
Uncalled bet ($1.05) returned to Gari Nerskiy
Gari Nerskiy collected $0.50 from pot
Gari Nerskiy: doesn't show hand 
*** SUMMARY ***
Total pot $0.50 | Rake $0 
Seat 1: benlondon148 folded before Flop (didn't bet)
Seat 2: Sheva26Rus folded before Flop (didn't bet)
Seat 3: BestAger folded before Flop
Seat 4: Jesus Ololo (button) folded before Flop (didn't bet)
Seat 5: Gari Nerskiy (small blind) collected ($0.50)
Seat 6: Laker_Style (big blind) folded before Flop



PokerStars Hand #222950788647:  Hold'em No Limit ($0.05/$0.10 USD) - 2021/01/23 6:27:47 ET
Table 'Saito II' 6-max Seat #5 is the button
Seat 1: benlondon148 ($9.19 in chips) 
Seat 2: Sheva26Rus ($20.06 in chips) 
Seat 3: BestAger ($21.55 in chips) 
Seat 4: Jesus Ololo ($10 in chips) 
Seat 5: Gari Nerskiy ($19.11 in chips) 
Seat 6: Laker_Style ($13.05 in chips) 
Laker_Style: posts small blind $0.05
benlondon148: posts big blind $0.10
*** HOLE CARDS ***
Sheva26Rus: folds 
BestAger: folds 
Jesus Ololo: raises $0.15 to $0.25
Gari Nerskiy: folds 
Laker_Style: folds 
benlondon148: calls $0.15
*** FLOP *** [9h Qc 7c]
benlondon148: checks 
Jesus Ololo: bets $0.29
benlondon148: folds 
Uncalled bet ($0.29) returned to Jesus Ololo
Jesus Ololo collected $0.53 from pot
*** SUMMARY ***
Total pot $0.55 | Rake $0.02 
Board [9h Qc 7c]
Seat 1: benlondon148 (big blind) folded on the Flop
Seat 2: Sheva26Rus folded before Flop (didn't bet)
Seat 3: BestAger folded before Flop (didn't bet)
Seat 4: Jesus Ololo collected ($0.53)
Seat 5: Gari Nerskiy (button) folded before Flop (didn't bet)
Seat 6: Laker_Style (small blind) folded before Flop



PokerStars Hand #222950804635:  Hold'em No Limit ($0.05/$0.10 USD) - 2021/01/23 6:28:35 ET
Table 'Saito II' 6-max Seat #6 is the button
Seat 1: benlondon148 ($8.94 in chips) 
Seat 2: Sheva26Rus ($20.06 in chips) 
Seat 3: BestAger ($21.55 in chips) 
Seat 4: Jesus Ololo ($10.28 in chips) 
Seat 5: Gari Nerskiy ($19.11 in chips) 
Seat 6: Laker_Style ($13 in chips) 
benlondon148: posts small blind $0.05
Sheva26Rus: posts big blind $0.10
*** HOLE CARDS ***
BestAger: folds 
Jesus Ololo: folds 
Gari Nerskiy: folds 
Laker_Style: folds 
benlondon148: calls $0.05
Sheva26Rus: checks 
*** FLOP *** [7d 6s 5h]
benlondon148: bets $0.10
Sheva26Rus: calls $0.10
*** TURN *** [7d 6s 5h] [2c]
benlondon148: bets $1.70
Sheva26Rus: folds 
Uncalled bet ($1.70) returned to benlondon148
benlondon148 collected $0.38 from pot
benlondon148: doesn't show hand 
*** SUMMARY ***
Total pot $0.40 | Rake $0.02 
Board [7d 6s 5h 2c]
Seat 1: benlondon148 (small blind) collected ($0.38)
Seat 2: Sheva26Rus (big blind) folded on the Turn
Seat 3: BestAger folded before Flop (didn't bet)
Seat 4: Jesus Ololo folded before Flop (didn't bet)
Seat 5: Gari Nerskiy folded before Flop (didn't bet)
Seat 6: Laker_Style (button) folded before Flop (didn't bet)



PokerStars Hand #222950817157:  Hold'em No Limit ($0.05/$0.10 USD) - 2021/01/23 6:29:13 ET
Table 'Saito II' 6-max Seat #1 is the button
Seat 1: benlondon148 ($9.12 in chips) 
Seat 2: Sheva26Rus ($19.86 in chips) 
Seat 3: BestAger ($21.55 in chips) 
Seat 4: Jesus Ololo ($10.28 in chips) 
Seat 5: Gari Nerskiy ($19.11 in chips) 
Seat 6: Laker_Style ($13 in chips) 
Sheva26Rus: posts small blind $0.05
BestAger: posts big blind $0.10
*** HOLE CARDS ***
Jesus Ololo: folds 
Gari Nerskiy: raises $0.15 to $0.25
Laker_Style: folds 
benlondon148: folds 
Sheva26Rus: calls $0.20
BestAger: folds 
*** FLOP *** [3h 7c Ad]
Sheva26Rus: checks 
Gari Nerskiy: bets $0.17
Sheva26Rus: raises $0.77 to $0.94
Gari Nerskiy: calls $0.77
*** TURN *** [3h 7c Ad] [Jh]
Sheva26Rus: bets $2.01
Gari Nerskiy: folds 
Uncalled bet ($2.01) returned to Sheva26Rus
Sheva26Rus collected $2.37 from pot
Sheva26Rus: doesn't show hand 
*** SUMMARY ***
Total pot $2.48 | Rake $0.11 
Board [3h 7c Ad Jh]
Seat 1: benlondon148 (button) folded before Flop (didn't bet)
Seat 2: Sheva26Rus (small blind) collected ($2.37)
Seat 3: BestAger (big blind) folded before Flop
Seat 4: Jesus Ololo folded before Flop (didn't bet)
Seat 5: Gari Nerskiy folded on the Turn
Seat 6: Laker_Style folded before Flop (didn't bet)



PokerStars Hand #222950838046:  Hold'em No Limit ($0.05/$0.10 USD) - 2021/01/23 6:30:15 ET
Table 'Saito II' 6-max Seat #2 is the button
Seat 1: benlondon148 ($9.12 in chips) 
Seat 2: Sheva26Rus ($21.04 in chips) 
Seat 3: BestAger ($21.45 in chips) 
Seat 4: Jesus Ololo ($10.28 in chips) 
Seat 5: Gari Nerskiy ($17.92 in chips) 
Seat 6: Laker_Style ($13 in chips) 
BestAger: posts small blind $0.05
Jesus Ololo: posts big blind $0.10
*** HOLE CARDS ***
Gari Nerskiy: folds 
Laker_Style: folds 
benlondon148: folds 
Sheva26Rus: raises $0.15 to $0.25
BestAger: folds 
Jesus Ololo: folds 
Uncalled bet ($0.15) returned to Sheva26Rus
Sheva26Rus collected $0.25 from pot
Sheva26Rus: doesn't show hand 
*** SUMMARY ***
Total pot $0.25 | Rake $0 
Seat 1: benlondon148 folded before Flop (didn't bet)
Seat 2: Sheva26Rus (button) collected ($0.25)
Seat 3: BestAger (small blind) folded before Flop
Seat 4: Jesus Ololo (big blind) folded before Flop
Seat 5: Gari Nerskiy folded before Flop (didn't bet)
Seat 6: Laker_Style folded before Flop (didn't bet)



PokerStars Hand #222950842701:  Hold'em No Limit ($0.05/$0.10 USD) - 2021/01/23 6:30:29 ET
Table 'Saito II' 6-max Seat #3 is the button
Seat 1: benlondon148 ($9.12 in chips) 
Seat 2: Sheva26Rus ($21.19 in chips) 
Seat 3: BestAger ($21.40 in chips) 
Seat 4: Jesus Ololo ($10.18 in chips) 
Seat 5: Gari Nerskiy ($17.92 in chips) 
Seat 6: Laker_Style ($13 in chips) 
Jesus Ololo: posts small blind $0.05
Gari Nerskiy: posts big blind $0.10
*** HOLE CARDS ***
Laker_Style: folds 
benlondon148: calls $0.10
Sheva26Rus: folds 
BestAger: folds 
Jesus Ololo: calls $0.05
Gari Nerskiy: checks 
*** FLOP *** [2c Qs 4s]
Jesus Ololo: checks 
Gari Nerskiy: checks 
benlondon148: checks 
*** TURN *** [2c Qs 4s] [6s]
Jesus Ololo: bets $0.16
Gari Nerskiy: calls $0.16
benlondon148: raises $0.94 to $1.10
Jesus Ololo: calls $0.94
Gari Nerskiy: folds 
*** RIVER *** [2c Qs 4s 6s] [2h]
Jesus Ololo: checks 
benlondon148: bets $0.10
Jesus Ololo: calls $0.10
*** SHOW DOWN ***
benlondon148: shows [Qd Ks] (two pair, Queens and Deuces)
Jesus Ololo: mucks hand 
benlondon148 collected $2.73 from pot
*** SUMMARY ***
Total pot $2.86 | Rake $0.13 
Board [2c Qs 4s 6s 2h]
Seat 1: benlondon148 showed [Qd Ks] and won ($2.73) with two pair, Queens and Deuces
Seat 2: Sheva26Rus folded before Flop (didn't bet)
Seat 3: BestAger (button) folded before Flop (didn't bet)
Seat 4: Jesus Ololo (small blind) mucked
Seat 5: Gari Nerskiy (big blind) folded on the Turn
Seat 6: Laker_Style folded before Flop (didn't bet)



PokerStars Hand #222950867315:  Hold'em No Limit ($0.05/$0.10 USD) - 2021/01/23 6:31:42 ET
Table 'Saito II' 6-max Seat #4 is the button
Seat 1: benlondon148 ($10.55 in chips) 
Seat 2: Sheva26Rus ($21.19 in chips) 
Seat 3: BestAger ($21.40 in chips) 
Seat 4: Jesus Ololo ($10 in chips) 
Seat 5: Gari Nerskiy ($17.66 in chips) 
Seat 6: Laker_Style ($13 in chips) 
Gari Nerskiy: posts small blind $0.05
Laker_Style: posts big blind $0.10
*** HOLE CARDS ***
benlondon148: folds 
Sheva26Rus: folds 
BestAger: folds 
Jesus Ololo: raises $0.15 to $0.25
Gari Nerskiy: folds 
Laker_Style: folds 
Uncalled bet ($0.15) returned to Jesus Ololo
Jesus Ololo collected $0.25 from pot
*** SUMMARY ***
Total pot $0.25 | Rake $0 
Seat 1: benlondon148 folded before Flop (didn't bet)
Seat 2: Sheva26Rus folded before Flop (didn't bet)
Seat 3: BestAger folded before Flop (didn't bet)
Seat 4: Jesus Ololo (button) collected ($0.25)
Seat 5: Gari Nerskiy (small blind) folded before Flop
Seat 6: Laker_Style (big blind) folded before Flop



PokerStars Hand #222950873138:  Hold'em No Limit ($0.05/$0.10 USD) - 2021/01/23 6:31:59 ET
Table 'Saito II' 6-max Seat #5 is the button
Seat 1: benlondon148 ($10.55 in chips) 
Seat 2: Sheva26Rus ($21.19 in chips) 
Seat 3: BestAger ($21.40 in chips) 
Seat 4: Jesus Ololo ($10.15 in chips) 
Seat 5: Gari Nerskiy ($17.61 in chips) 
Seat 6: Laker_Style ($12.90 in chips) 
Laker_Style: posts small blind $0.05
benlondon148: posts big blind $0.10
*** HOLE CARDS ***
Sheva26Rus: folds 
BestAger: folds 
Jesus Ololo: folds 
Gari Nerskiy: raises $0.10 to $0.20
Laker_Style: raises $0.54 to $0.74
benlondon148: folds 
Gari Nerskiy: folds 
Uncalled bet ($0.54) returned to Laker_Style
Laker_Style collected $0.50 from pot
Laker_Style: doesn't show hand 
*** SUMMARY ***
Total pot $0.50 | Rake $0 
Seat 1: benlondon148 (big blind) folded before Flop
Seat 2: Sheva26Rus folded before Flop (didn't bet)
Seat 3: BestAger folded before Flop (didn't bet)
Seat 4: Jesus Ololo folded before Flop (didn't bet)
Seat 5: Gari Nerskiy (button) folded before Flop
Seat 6: Laker_Style (small blind) collected ($0.50)



PokerStars Hand #222950884813:  Hold'em No Limit ($0.05/$0.10 USD) - 2021/01/23 6:32:34 ET
Table 'Saito II' 6-max Seat #6 is the button
Seat 1: benlondon148 ($10.45 in chips) 
Seat 2: Sheva26Rus ($21.19 in chips) 
Seat 3: BestAger ($21.40 in chips) 
Seat 4: Jesus Ololo ($10.15 in chips) 
Seat 5: Gari Nerskiy ($17.41 in chips) 
Seat 6: Laker_Style ($13.20 in chips) 
benlondon148: posts small blind $0.05
Sheva26Rus: posts big blind $0.10
*** HOLE CARDS ***
BestAger: folds 
Jesus Ololo: raises $0.15 to $0.25
Gari Nerskiy: folds 
Laker_Style: folds 
benlondon148: folds 
Sheva26Rus: folds 
Uncalled bet ($0.15) returned to Jesus Ololo
Jesus Ololo collected $0.25 from pot
*** SUMMARY ***
Total pot $0.25 | Rake $0 
Seat 1: benlondon148 (small blind) folded before Flop
Seat 2: Sheva26Rus (big blind) folded before Flop
Seat 3: BestAger folded before Flop (didn't bet)
Seat 4: Jesus Ololo collected ($0.25)
Seat 5: Gari Nerskiy folded before Flop (didn't bet)
Seat 6: Laker_Style (button) folded before Flop (didn't bet)



PokerStars Hand #222950893638:  Hold'em No Limit ($0.05/$0.10 USD) - 2021/01/23 6:33:00 ET
Table 'Saito II' 6-max Seat #1 is the button
Seat 1: benlondon148 ($10.40 in chips) 
Seat 2: Sheva26Rus ($21.09 in chips) 
Seat 3: BestAger ($21.40 in chips) 
Seat 4: Jesus Ololo ($10.30 in chips) 
Seat 5: Gari Nerskiy ($17.41 in chips) 
Seat 6: Laker_Style ($13.20 in chips) 
Sheva26Rus: posts small blind $0.05
BestAger: posts big blind $0.10
*** HOLE CARDS ***
Jesus Ololo: folds 
Gari Nerskiy: folds 
Laker_Style: folds 
benlondon148: folds 
Sheva26Rus: raises $0.20 to $0.30
BestAger: folds 
Uncalled bet ($0.20) returned to Sheva26Rus
Sheva26Rus collected $0.20 from pot
Sheva26Rus: doesn't show hand 
*** SUMMARY ***
Total pot $0.20 | Rake $0 
Seat 1: benlondon148 (button) folded before Flop (didn't bet)
Seat 2: Sheva26Rus (small blind) collected ($0.20)
Seat 3: BestAger (big blind) folded before Flop
Seat 4: Jesus Ololo folded before Flop (didn't bet)
Seat 5: Gari Nerskiy folded before Flop (didn't bet)
Seat 6: Laker_Style folded before Flop (didn't bet)



PokerStars Hand #222950898191:  Hold'em No Limit ($0.05/$0.10 USD) - 2021/01/23 6:33:14 ET
Table 'Saito II' 6-max Seat #2 is the button
Seat 1: benlondon148 ($10.40 in chips) 
Seat 2: Sheva26Rus ($21.19 in chips) 
Seat 3: BestAger ($21.30 in chips) 
Seat 4: Jesus Ololo ($10.30 in chips) 
Seat 5: Gari Nerskiy ($17.41 in chips) 
Seat 6: Laker_Style ($13.20 in chips) 
BestAger: posts small blind $0.05
Jesus Ololo: posts big blind $0.10
*** HOLE CARDS ***
Gari Nerskiy: folds 
Laker_Style: folds 
benlondon148: calls $0.10
Sheva26Rus: folds 
BestAger: folds 
Jesus Ololo: checks 
*** FLOP *** [8c 2c 2s]
Jesus Ololo: checks 
benlondon148: checks 
*** TURN *** [8c 2c 2s] [Ts]
Jesus Ololo: checks 
benlondon148: checks 
*** RIVER *** [8c 2c 2s Ts] [Ah]
Jesus Ololo: bets $0.20
benlondon148: raises $2.30 to $2.50
Jesus Ololo: calls $2.30
*** SHOW DOWN ***
benlondon148: shows [Jc Ks] (a pair of Deuces)
Jesus Ololo: shows [8s Ac] (two pair, Aces and Eights)
Jesus Ololo collected $5.01 from pot
*** SUMMARY ***
Total pot $5.25 | Rake $0.24 
Board [8c 2c 2s Ts Ah]
Seat 1: benlondon148 showed [Jc Ks] and lost with a pair of Deuces
Seat 2: Sheva26Rus (button) folded before Flop (didn't bet)
Seat 3: BestAger (small blind) folded before Flop
Seat 4: Jesus Ololo (big blind) showed [8s Ac] and won ($5.01) with two pair, Aces and Eights
Seat 5: Gari Nerskiy folded before Flop (didn't bet)
Seat 6: Laker_Style folded before Flop (didn't bet)



PokerStars Hand #222950914461:  Hold'em No Limit ($0.05/$0.10 USD) - 2021/01/23 6:34:02 ET
Table 'Saito II' 6-max Seat #3 is the button
Seat 1: benlondon148 ($7.80 in chips) 
Seat 2: Sheva26Rus ($21.19 in chips) 
Seat 3: BestAger ($21.25 in chips) 
Seat 4: Jesus Ololo ($12.71 in chips) 
Seat 5: Gari Nerskiy ($17.41 in chips) 
Seat 6: Laker_Style ($13.20 in chips) 
Jesus Ololo: posts small blind $0.05
Gari Nerskiy: posts big blind $0.10
*** HOLE CARDS ***
Laker_Style: folds 
benlondon148: folds 
Sheva26Rus: folds 
BestAger: raises $0.20 to $0.30
Jesus Ololo: folds 
Gari Nerskiy: calls $0.20
*** FLOP *** [3c Jd Ac]
Gari Nerskiy: checks 
BestAger: checks 
*** TURN *** [3c Jd Ac] [Qh]
Gari Nerskiy: bets $0.38
BestAger: folds 
Uncalled bet ($0.38) returned to Gari Nerskiy
Gari Nerskiy collected $0.62 from pot
Gari Nerskiy: doesn't show hand 
*** SUMMARY ***
Total pot $0.65 | Rake $0.03 
Board [3c Jd Ac Qh]
Seat 1: benlondon148 folded before Flop (didn't bet)
Seat 2: Sheva26Rus folded before Flop (didn't bet)
Seat 3: BestAger (button) folded on the Turn
Seat 4: Jesus Ololo (small blind) folded before Flop
Seat 5: Gari Nerskiy (big blind) collected ($0.62)
Seat 6: Laker_Style folded before Flop (didn't bet)



PokerStars Hand #222950925860:  Hold'em No Limit ($0.05/$0.10 USD) - 2021/01/23 6:34:36 ET
Table 'Saito II' 6-max Seat #4 is the button
Seat 1: benlondon148 ($7.80 in chips) 
Seat 2: Sheva26Rus ($21.19 in chips) 
Seat 3: BestAger ($20.95 in chips) 
Seat 4: Jesus Ololo ($12.66 in chips) 
Seat 5: Gari Nerskiy ($17.73 in chips) 
Gari Nerskiy: posts small blind $0.05
Laker_Style: is sitting out 
benlondon148: posts big blind $0.10
*** HOLE CARDS ***
Laker_Style leaves the table
Sheva26Rus: raises $0.20 to $0.30
BestAger: folds 
Jesus Ololo: folds 
Gari Nerskiy: folds 
benlondon148: calls $0.20
*** FLOP *** [Ts 8d Qh]
benlondon148: bets $0.10
Sheva26Rus: raises $0.53 to $0.63
benlondon148: calls $0.53
*** TURN *** [Ts 8d Qh] [9d]
benlondon148: checks 
Sheva26Rus: bets $1.18
benlondon148: calls $1.18
*** RIVER *** [Ts 8d Qh 9d] [2d]
benlondon148: bets $1.90
Sheva26Rus: folds 
Uncalled bet ($1.90) returned to benlondon148
benlondon148 collected $4.08 from pot
benlondon148: doesn't show hand 
*** SUMMARY ***
Total pot $4.27 | Rake $0.19 
Board [Ts 8d Qh 9d 2d]
Seat 1: benlondon148 (big blind) collected ($4.08)
Seat 2: Sheva26Rus folded on the River
Seat 3: BestAger folded before Flop (didn't bet)
Seat 4: Jesus Ololo (button) folded before Flop (didn't bet)
Seat 5: Gari Nerskiy (small blind) folded before Flop



PokerStars Hand #222950943247:  Hold'em No Limit ($0.05/$0.10 USD) - 2021/01/23 6:35:27 ET
Table 'Saito II' 6-max Seat #5 is the button
Seat 1: benlondon148 ($9.77 in chips) 
Seat 3: BestAger ($20.95 in chips) 
Seat 4: Jesus Ololo ($12.66 in chips) 
Seat 5: Gari Nerskiy ($17.68 in chips) 
benlondon148: posts small blind $0.05
Sheva26Rus: is sitting out 
BestAger: posts big blind $0.10
*** HOLE CARDS ***
Sheva26Rus leaves the table
Jesus Ololo: folds 
Gari Nerskiy: folds 
benlondon148: calls $0.05
1920kbps joins the table at seat #6 
BestAger: checks 
*** FLOP *** [6h 6s 4c]
benlondon148: checks 
Artemka0055 joins the table at seat #2 
BestAger: checks 
*** TURN *** [6h 6s 4c] [As]
benlondon148: checks 
BestAger: checks 
*** RIVER *** [6h 6s 4c As] [Ac]
benlondon148: checks 
BestAger: checks 
*** SHOW DOWN ***
benlondon148: shows [Qd Jd] (two pair, Aces and Sixes)
BestAger: mucks hand 
benlondon148 collected $0.19 from pot
1920kbps leaves the table
*** SUMMARY ***
Total pot $0.20 | Rake $0.01 
Board [6h 6s 4c As Ac]
Seat 1: benlondon148 (small blind) showed [Qd Jd] and won ($0.19) with two pair, Aces and Sixes
Seat 3: BestAger (big blind) mucked
Seat 4: Jesus Ololo folded before Flop (didn't bet)
Seat 5: Gari Nerskiy (button) folded before Flop (didn't bet)



PokerStars Hand #222950952626:  Hold'em No Limit ($0.05/$0.10 USD) - 2021/01/23 6:35:56 ET
Table 'Saito II' 6-max Seat #1 is the button
Seat 1: benlondon148 ($9.86 in chips) 
Seat 3: BestAger ($20.85 in chips) 
Seat 4: Jesus Ololo ($12.66 in chips) 
Seat 5: Gari Nerskiy ($17.68 in chips) 
BestAger: posts small blind $0.05
Jesus Ololo: posts big blind $0.10
*** HOLE CARDS ***
Gari Nerskiy: folds 
benlondon148: calls $0.10
BestAger: raises $0.20 to $0.30
Jesus Ololo: folds 
benlondon148: raises $0.20 to $0.50
BestAger: calls $0.20
*** FLOP *** [4s 9h Th]
BestAger: bets $0.20
jorgeebanks joins the table at seat #6 
benlondon148: raises $0.20 to $0.40
BestAger: folds 
Uncalled bet ($0.20) returned to benlondon148
benlondon148 collected $1.43 from pot
benlondon148: doesn't show hand 
*** SUMMARY ***
Total pot $1.50 | Rake $0.07 
Board [4s 9h Th]
Seat 1: benlondon148 (button) collected ($1.43)
Seat 3: BestAger (small blind) folded on the Flop
Seat 4: Jesus Ololo (big blind) folded before Flop
Seat 5: Gari Nerskiy folded before Flop (didn't bet)



PokerStars Hand #222950962645:  Hold'em No Limit ($0.05/$0.10 USD) - 2021/01/23 6:36:25 ET
Table 'Saito II' 6-max Seat #3 is the button
Seat 1: benlondon148 ($10.59 in chips) 
Seat 3: BestAger ($20.15 in chips) 
Seat 4: Jesus Ololo ($12.56 in chips) 
Seat 5: Gari Nerskiy ($17.68 in chips) 
Jesus Ololo: posts small blind $0.05
Gari Nerskiy: posts big blind $0.10
jorgeebanks: sits out 
Artemka0055: sits out 
*** HOLE CARDS ***
benlondon148: folds 
BestAger: raises $0.20 to $0.30
Jesus Ololo: folds 
Gari Nerskiy: folds 
Uncalled bet ($0.20) returned to BestAger
BestAger collected $0.25 from pot
BestAger: doesn't show hand 
*** SUMMARY ***
Total pot $0.25 | Rake $0 
Seat 1: benlondon148 folded before Flop (didn't bet)
Seat 3: BestAger (button) collected ($0.25)
Seat 4: Jesus Ololo (small blind) folded before Flop
Seat 5: Gari Nerskiy (big blind) folded before Flop



PokerStars Hand #222950967307:  Hold'em No Limit ($0.05/$0.10 USD) - 2021/01/23 6:36:39 ET
Table 'Saito II' 6-max Seat #4 is the button
Seat 1: benlondon148 ($10.59 in chips) 
Seat 3: BestAger ($20.30 in chips) 
Seat 4: Jesus Ololo ($12.51 in chips) 
Seat 5: Gari Nerskiy ($17.58 in chips) 
Seat 6: jorgeebanks ($10 in chips) 
Gari Nerskiy: posts small blind $0.05
jorgeebanks: posts big blind $0.10
Artemka0055: sits out 
*** HOLE CARDS ***
benlondon148: folds 
BestAger: folds 
Jesus Ololo: raises $0.15 to $0.25
Gari Nerskiy: folds 
jorgeebanks: folds 
Uncalled bet ($0.15) returned to Jesus Ololo
Jesus Ololo collected $0.25 from pot
*** SUMMARY ***
Total pot $0.25 | Rake $0 
Seat 1: benlondon148 folded before Flop (didn't bet)
Seat 3: BestAger folded before Flop (didn't bet)
Seat 4: Jesus Ololo (button) collected ($0.25)
Seat 5: Gari Nerskiy (small blind) folded before Flop
Seat 6: jorgeebanks (big blind) folded before Flop



PokerStars Hand #222950971293:  Hold'em No Limit ($0.05/$0.10 USD) - 2021/01/23 6:36:51 ET
Table 'Saito II' 6-max Seat #5 is the button
Seat 1: benlondon148 ($10.59 in chips) 
Seat 3: BestAger ($20.30 in chips) 
Seat 4: Jesus Ololo ($12.66 in chips) 
Seat 5: Gari Nerskiy ($17.53 in chips) 
Seat 6: jorgeebanks ($9.90 in chips) 
jorgeebanks: posts small blind $0.05
benlondon148: posts big blind $0.10
Artemka0055: sits out 
*** HOLE CARDS ***
BestAger: raises $0.20 to $0.30
Jesus Ololo: raises $0.60 to $0.90
Gari Nerskiy: folds 
jorgeebanks: folds 
benlondon148: folds 
BestAger: raises $19.40 to $20.30 and is all-in
Jesus Ololo: folds 
Uncalled bet ($19.40) returned to BestAger
BestAger collected $1.95 from pot
BestAger: doesn't show hand 
*** SUMMARY ***
Total pot $1.95 | Rake $0 
Seat 1: benlondon148 (big blind) folded before Flop
Seat 3: BestAger collected ($1.95)
Seat 4: Jesus Ololo folded before Flop
Seat 5: Gari Nerskiy (button) folded before Flop (didn't bet)
Seat 6: jorgeebanks (small blind) folded before Flop



PokerStars Hand #222950978574:  Hold'em No Limit ($0.05/$0.10 USD) - 2021/01/23 6:37:13 ET
Table 'Saito II' 6-max Seat #6 is the button
Seat 1: benlondon148 ($10.49 in chips) 
Seat 2: Artemka0055 ($10 in chips) 
Seat 3: BestAger ($21.35 in chips) 
Seat 4: Jesus Ololo ($11.76 in chips) 
Seat 5: Gari Nerskiy ($17.53 in chips) 
Seat 6: jorgeebanks ($9.85 in chips) 
benlondon148: posts small blind $0.05
Artemka0055: posts big blind $0.10
*** HOLE CARDS ***
BestAger: folds 
Jesus Ololo: folds 
Gari Nerskiy: folds 
jorgeebanks: folds 
benlondon148: folds 
Uncalled bet ($0.05) returned to Artemka0055
Artemka0055 collected $0.10 from pot
*** SUMMARY ***
Total pot $0.10 | Rake $0 
Seat 1: benlondon148 (small blind) folded before Flop
Seat 2: Artemka0055 (big blind) collected ($0.10)
Seat 3: BestAger folded before Flop (didn't bet)
Seat 4: Jesus Ololo folded before Flop (didn't bet)
Seat 5: Gari Nerskiy folded before Flop (didn't bet)
Seat 6: jorgeebanks (button) folded before Flop (didn't bet)



PokerStars Hand #222950982688:  Hold'em No Limit ($0.05/$0.10 USD) - 2021/01/23 6:37:25 ET
Table 'Saito II' 6-max Seat #1 is the button
Seat 1: benlondon148 ($10.44 in chips) 
Seat 2: Artemka0055 ($10.05 in chips) 
Seat 3: BestAger ($21.35 in chips) 
Seat 4: Jesus Ololo ($11.76 in chips) 
Seat 5: Gari Nerskiy ($17.53 in chips) 
Seat 6: jorgeebanks ($9.85 in chips) 
Artemka0055: posts small blind $0.05
BestAger: posts big blind $0.10
*** HOLE CARDS ***
Jesus Ololo: folds 
Gari Nerskiy: folds 
jorgeebanks: folds 
benlondon148: folds 
Artemka0055: raises $0.20 to $0.30
BestAger: folds 
Uncalled bet ($0.20) returned to Artemka0055
Artemka0055 collected $0.20 from pot
*** SUMMARY ***
Total pot $0.20 | Rake $0 
Seat 1: benlondon148 (button) folded before Flop (didn't bet)
Seat 2: Artemka0055 (small blind) collected ($0.20)
Seat 3: BestAger (big blind) folded before Flop
Seat 4: Jesus Ololo folded before Flop (didn't bet)
Seat 5: Gari Nerskiy folded before Flop (didn't bet)
Seat 6: jorgeebanks folded before Flop (didn't bet)



PokerStars Hand #222950986177:  Hold'em No Limit ($0.05/$0.10 USD) - 2021/01/23 6:37:35 ET
Table 'Saito II' 6-max Seat #2 is the button
Seat 1: benlondon148 ($10.44 in chips) 
Seat 2: Artemka0055 ($10.15 in chips) 
Seat 3: BestAger ($21.25 in chips) 
Seat 4: Jesus Ololo ($11.76 in chips) 
Seat 5: Gari Nerskiy ($17.53 in chips) 
Seat 6: jorgeebanks ($9.85 in chips) 
BestAger: posts small blind $0.05
Jesus Ololo: posts big blind $0.10
*** HOLE CARDS ***
Gari Nerskiy: folds 
jorgeebanks: folds 
benlondon148: folds 
Artemka0055: folds 
BestAger: folds 
Uncalled bet ($0.05) returned to Jesus Ololo
Jesus Ololo collected $0.10 from pot
*** SUMMARY ***
Total pot $0.10 | Rake $0 
Seat 1: benlondon148 folded before Flop (didn't bet)
Seat 2: Artemka0055 (button) folded before Flop (didn't bet)
Seat 3: BestAger (small blind) folded before Flop
Seat 4: Jesus Ololo (big blind) collected ($0.10)
Seat 5: Gari Nerskiy folded before Flop (didn't bet)
Seat 6: jorgeebanks folded before Flop (didn't bet)



PokerStars Hand #222950989044:  Hold'em No Limit ($0.05/$0.10 USD) - 2021/01/23 6:37:44 ET
Table 'Saito II' 6-max Seat #3 is the button
Seat 1: benlondon148 ($10.44 in chips) 
Seat 2: Artemka0055 ($10.15 in chips) 
Seat 3: BestAger ($21.20 in chips) 
Seat 4: Jesus Ololo ($11.81 in chips) 
Seat 5: Gari Nerskiy ($17.53 in chips) 
Seat 6: jorgeebanks ($9.85 in chips) 
Jesus Ololo: posts small blind $0.05
Gari Nerskiy: posts big blind $0.10
*** HOLE CARDS ***
jorgeebanks: raises $0.10 to $0.20
benlondon148: folds 
Artemka0055: raises $0.60 to $0.80
BestAger: folds 
Jesus Ololo: folds 
Gari Nerskiy: folds 
jorgeebanks: folds 
Uncalled bet ($0.60) returned to Artemka0055
Artemka0055 collected $0.55 from pot
*** SUMMARY ***
Total pot $0.55 | Rake $0 
Seat 1: benlondon148 folded before Flop (didn't bet)
Seat 2: Artemka0055 collected ($0.55)
Seat 3: BestAger (button) folded before Flop (didn't bet)
Seat 4: Jesus Ololo (small blind) folded before Flop
Seat 5: Gari Nerskiy (big blind) folded before Flop
Seat 6: jorgeebanks folded before Flop



PokerStars Hand #222950996086:  Hold'em No Limit ($0.05/$0.10 USD) - 2021/01/23 6:38:04 ET
Table 'Saito II' 6-max Seat #4 is the button
Seat 1: benlondon148 ($10.44 in chips) 
Seat 2: Artemka0055 ($10.50 in chips) 
Seat 3: BestAger ($21.20 in chips) 
Seat 4: Jesus Ololo ($11.76 in chips) 
Seat 5: Gari Nerskiy ($17.43 in chips) 
Seat 6: jorgeebanks ($9.65 in chips) 
Gari Nerskiy: posts small blind $0.05
jorgeebanks: posts big blind $0.10
*** HOLE CARDS ***
benlondon148: calls $0.10
Artemka0055: raises $0.30 to $0.40
BestAger: folds 
Jesus Ololo: folds 
Gari Nerskiy: folds 
jorgeebanks: folds 
benlondon148: calls $0.30
*** FLOP *** [Td 7d Qs]
benlondon148: checks 
Artemka0055: checks 
*** TURN *** [Td 7d Qs] [5h]
benlondon148: checks 
Artemka0055: bets $0.40
benlondon148: calls $0.40
*** RIVER *** [Td 7d Qs 5h] [As]
benlondon148: checks 
Artemka0055: bets $1
benlondon148: folds 
Uncalled bet ($1) returned to Artemka0055
Artemka0055 collected $1.67 from pot
*** SUMMARY ***
Total pot $1.75 | Rake $0.08 
Board [Td 7d Qs 5h As]
Seat 1: benlondon148 folded on the River
Seat 2: Artemka0055 collected ($1.67)
Seat 3: BestAger folded before Flop (didn't bet)
Seat 4: Jesus Ololo (button) folded before Flop (didn't bet)
Seat 5: Gari Nerskiy (small blind) folded before Flop
Seat 6: jorgeebanks (big blind) folded before Flop



PokerStars Hand #222951013304:  Hold'em No Limit ($0.05/$0.10 USD) - 2021/01/23 6:38:55 ET
Table 'Saito II' 6-max Seat #5 is the button
Seat 1: benlondon148 ($9.64 in chips) 
Seat 2: Artemka0055 ($11.37 in chips) 
Seat 3: BestAger ($21.20 in chips) 
Seat 4: Jesus Ololo ($11.76 in chips) 
Seat 5: Gari Nerskiy ($17.38 in chips) 
Seat 6: jorgeebanks ($9.55 in chips) 
jorgeebanks: posts small blind $0.05
benlondon148: posts big blind $0.10
*** HOLE CARDS ***
Artemka0055: raises $0.20 to $0.30
BestAger: folds 
Jesus Ololo: folds 
Gari Nerskiy: folds 
jorgeebanks: calls $0.25
benlondon148: folds 
*** FLOP *** [Qd 9d 8d]
jorgeebanks: checks 
Artemka0055: bets $0.30
jorgeebanks: folds 
Uncalled bet ($0.30) returned to Artemka0055
Artemka0055 collected $0.67 from pot
*** SUMMARY ***
Total pot $0.70 | Rake $0.03 
Board [Qd 9d 8d]
Seat 1: benlondon148 (big blind) folded before Flop
Seat 2: Artemka0055 collected ($0.67)
Seat 3: BestAger folded before Flop (didn't bet)
Seat 4: Jesus Ololo folded before Flop (didn't bet)
Seat 5: Gari Nerskiy (button) folded before Flop (didn't bet)
Seat 6: jorgeebanks (small blind) folded on the Flop



PokerStars Hand #222951021655:  Hold'em No Limit ($0.05/$0.10 USD) - 2021/01/23 6:39:19 ET
Table 'Saito II' 6-max Seat #6 is the button
Seat 1: benlondon148 ($9.54 in chips) 
Seat 3: BestAger ($21.20 in chips) 
Seat 4: Jesus Ololo ($11.76 in chips) 
Seat 5: Gari Nerskiy ($17.38 in chips) 
Seat 6: jorgeebanks ($9.25 in chips) 
benlondon148: posts small blind $0.05
Artemka0055: is sitting out 
BestAger: posts big blind $0.10
*** HOLE CARDS ***
Jesus Ololo: raises $0.15 to $0.25
Artemka0055 leaves the table
Gari Nerskiy: folds 
JB87878 joins the table at seat #2 
jorgeebanks: folds 
benlondon148: calls $0.20
BestAger: calls $0.15
*** FLOP *** [6s 4d Ks]
benlondon148: bets $0.10
BestAger: folds 
Jesus Ololo: calls $0.10
*** TURN *** [6s 4d Ks] [9c]
benlondon148: bets $1.80
Jesus Ololo: folds 
Uncalled bet ($1.80) returned to benlondon148
benlondon148 collected $0.91 from pot
benlondon148: doesn't show hand 
*** SUMMARY ***
Total pot $0.95 | Rake $0.04 
Board [6s 4d Ks 9c]
Seat 1: benlondon148 (small blind) collected ($0.91)
Seat 3: BestAger (big blind) folded on the Flop
Seat 4: Jesus Ololo folded on the Turn
Seat 5: Gari Nerskiy folded before Flop (didn't bet)
Seat 6: jorgeebanks (button) folded before Flop (didn't bet)



PokerStars Hand #222951034436:  Hold'em No Limit ($0.05/$0.10 USD) - 2021/01/23 6:39:57 ET
Table 'Saito II' 6-max Seat #1 is the button
Seat 1: benlondon148 ($10.10 in chips) 
Seat 3: BestAger ($20.95 in chips) 
Seat 4: Jesus Ololo ($11.41 in chips) 
Seat 5: Gari Nerskiy ($17.38 in chips) 
Seat 6: jorgeebanks ($9.25 in chips) 
BestAger: posts small blind $0.05
Jesus Ololo: posts big blind $0.10
*** HOLE CARDS ***
Gari Nerskiy: raises $0.20 to $0.30
jorgeebanks: folds 
benlondon148: folds 
BestAger: calls $0.25
Jesus Ololo: folds 
*** FLOP *** [Qd Kh 8h]
BestAger: checks 
Gari Nerskiy: checks 
*** TURN *** [Qd Kh 8h] [3d]
BestAger: checks 
Gari Nerskiy: checks 
*** RIVER *** [Qd Kh 8h 3d] [9d]
BestAger: checks 
Gari Nerskiy: checks 
*** SHOW DOWN ***
BestAger: shows [Tc Jh] (a straight, Nine to King)
Gari Nerskiy: mucks hand 
BestAger collected $0.67 from pot
*** SUMMARY ***
Total pot $0.70 | Rake $0.03 
Board [Qd Kh 8h 3d 9d]
Seat 1: benlondon148 (button) folded before Flop (didn't bet)
Seat 3: BestAger (small blind) showed [Tc Jh] and won ($0.67) with a straight, Nine to King
Seat 4: Jesus Ololo (big blind) folded before Flop
Seat 5: Gari Nerskiy mucked
Seat 6: jorgeebanks folded before Flop (didn't bet)



PokerStars Hand #222951047682:  Hold'em No Limit ($0.05/$0.10 USD) - 2021/01/23 6:40:36 ET
Table 'Saito II' 6-max Seat #3 is the button
Seat 1: benlondon148 ($10.10 in chips) 
Seat 2: JB87878 ($10 in chips) 
Seat 3: BestAger ($21.32 in chips) 
Seat 4: Jesus Ololo ($11.31 in chips) 
Seat 5: Gari Nerskiy ($17.08 in chips) 
Seat 6: jorgeebanks ($9.25 in chips) 
Jesus Ololo: posts small blind $0.05
Gari Nerskiy: posts big blind $0.10
JB87878: posts big blind $0.10
*** HOLE CARDS ***
jorgeebanks: folds 
benlondon148: folds 
JB87878: checks 
BestAger: folds 
Jesus Ololo: folds 
Gari Nerskiy: checks 
*** FLOP *** [Ac Js 8h]
Gari Nerskiy: checks 
JB87878: bets $0.10
Gari Nerskiy: calls $0.10
*** TURN *** [Ac Js 8h] [Ad]
Gari Nerskiy: checks 
JB87878: bets $0.10
Gari Nerskiy: calls $0.10
*** RIVER *** [Ac Js 8h Ad] [Td]
Gari Nerskiy: checks 
JB87878: bets $0.31
Gari Nerskiy: calls $0.31
*** SHOW DOWN ***
JB87878: shows [4d Jc] (two pair, Aces and Jacks)
Gari Nerskiy: mucks hand 
JB87878 collected $1.21 from pot
*** SUMMARY ***
Total pot $1.27 | Rake $0.06 
Board [Ac Js 8h Ad Td]
Seat 1: benlondon148 folded before Flop (didn't bet)
Seat 2: JB87878 showed [4d Jc] and won ($1.21) with two pair, Aces and Jacks
Seat 3: BestAger (button) folded before Flop (didn't bet)
Seat 4: Jesus Ololo (small blind) folded before Flop
Seat 5: Gari Nerskiy (big blind) mucked
Seat 6: jorgeebanks folded before Flop (didn't bet)



PokerStars Hand #222951063501:  Hold'em No Limit ($0.05/$0.10 USD) - 2021/01/23 6:41:23 ET
Table 'Saito II' 6-max Seat #4 is the button
Seat 1: benlondon148 ($10.10 in chips) 
Seat 2: JB87878 ($10.60 in chips) 
Seat 3: BestAger ($21.32 in chips) 
Seat 4: Jesus Ololo ($11.26 in chips) 
Seat 5: Gari Nerskiy ($16.47 in chips) 
Seat 6: jorgeebanks ($9.25 in chips) 
Gari Nerskiy: posts small blind $0.05
jorgeebanks: posts big blind $0.10
*** HOLE CARDS ***
benlondon148: calls $0.10
JB87878: calls $0.10
BestAger: folds 
Jesus Ololo: folds 
Gari Nerskiy: folds 
jorgeebanks: checks 
*** FLOP *** [9h Ah Ad]
jorgeebanks: checks 
benlondon148: bets $0.10
JB87878: folds 
jorgeebanks: folds 
Uncalled bet ($0.10) returned to benlondon148
benlondon148 collected $0.33 from pot
benlondon148: doesn't show hand 
*** SUMMARY ***
Total pot $0.35 | Rake $0.02 
Board [9h Ah Ad]
Seat 1: benlondon148 collected ($0.33)
Seat 2: JB87878 folded on the Flop
Seat 3: BestAger folded before Flop (didn't bet)
Seat 4: Jesus Ololo (button) folded before Flop (didn't bet)
Seat 5: Gari Nerskiy (small blind) folded before Flop
Seat 6: jorgeebanks (big blind) folded on the Flop



PokerStars Hand #222951071773:  Hold'em No Limit ($0.05/$0.10 USD) - 2021/01/23 6:41:47 ET
Table 'Saito II' 6-max Seat #5 is the button
Seat 1: benlondon148 ($10.33 in chips) 
Seat 2: JB87878 ($10.50 in chips) 
Seat 3: BestAger ($21.32 in chips) 
Seat 4: Jesus Ololo ($11.26 in chips) 
Seat 5: Gari Nerskiy ($16.42 in chips) 
Seat 6: jorgeebanks ($9.15 in chips) 
jorgeebanks: posts small blind $0.05
benlondon148: posts big blind $0.10
*** HOLE CARDS ***
JB87878: folds 
BestAger: folds 
Jesus Ololo: folds 
Gari Nerskiy: raises $0.10 to $0.20
jorgeebanks: calls $0.15
benlondon148: calls $0.10
*** FLOP *** [6c 5h Ts]
jorgeebanks: checks 
benlondon148: checks 
Gari Nerskiy: checks 
*** TURN *** [6c 5h Ts] [9c]
jorgeebanks: bets $0.29
benlondon148: raises $0.29 to $0.58
Gari Nerskiy: folds 
jorgeebanks: folds 
Uncalled bet ($0.29) returned to benlondon148
benlondon148 collected $1.13 from pot
benlondon148: doesn't show hand 
*** SUMMARY ***
Total pot $1.18 | Rake $0.05 
Board [6c 5h Ts 9c]
Seat 1: benlondon148 (big blind) collected ($1.13)
Seat 2: JB87878 folded before Flop (didn't bet)
Seat 3: BestAger folded before Flop (didn't bet)
Seat 4: Jesus Ololo folded before Flop (didn't bet)
Seat 5: Gari Nerskiy (button) folded on the Turn
Seat 6: jorgeebanks (small blind) folded on the Turn



PokerStars Hand #222951084577:  Hold'em No Limit ($0.05/$0.10 USD) - 2021/01/23 6:42:25 ET
Table 'Saito II' 6-max Seat #1 is the button
Seat 1: benlondon148 ($10.97 in chips) 
Seat 2: JB87878 ($10.50 in chips) 
Seat 3: BestAger ($21.32 in chips) 
Seat 4: Jesus Ololo ($11.26 in chips) 
Seat 5: Gari Nerskiy ($16.22 in chips) 
jorgeebanks leaves the table
JB87878: posts small blind $0.05
BestAger: posts big blind $0.10
*** HOLE CARDS ***
Jesus Ololo: raises $0.15 to $0.25
Gari Nerskiy: folds 
benlondon148: folds 
JB87878: folds 
BestAger: folds 
Uncalled bet ($0.15) returned to Jesus Ololo
Jesus Ololo collected $0.25 from pot
*** SUMMARY ***
Total pot $0.25 | Rake $0 
Seat 1: benlondon148 (button) folded before Flop (didn't bet)
Seat 2: JB87878 (small blind) folded before Flop
Seat 3: BestAger (big blind) folded before Flop
Seat 4: Jesus Ololo collected ($0.25)
Seat 5: Gari Nerskiy folded before Flop (didn't bet)



PokerStars Hand #222951089979:  Hold'em No Limit ($0.05/$0.10 USD) - 2021/01/23 6:42:41 ET
Table 'Saito II' 6-max Seat #2 is the button
Seat 1: benlondon148 ($10.97 in chips) 
Seat 2: JB87878 ($10.45 in chips) 
Seat 3: BestAger ($21.22 in chips) 
Seat 4: Jesus Ololo ($11.41 in chips) 
Seat 5: Gari Nerskiy ($16.22 in chips) 
BestAger: posts small blind $0.05
Jesus Ololo: posts big blind $0.10
*** HOLE CARDS ***
Gari Nerskiy: folds 
benlondon148: calls $0.10
JB87878: calls $0.10
BestAger: folds 
Jesus Ololo: checks 
*** FLOP *** [2c 8h 9d]
Jesus Ololo: checks 
Quatrehuith joins the table at seat #6 
benlondon148: bets $0.10
JB87878: calls $0.10
Jesus Ololo: calls $0.10
*** TURN *** [2c 8h 9d] [4d]
Jesus Ololo: checks 
benlondon148: bets $0.10
JB87878: raises $0.10 to $0.20
Jesus Ololo: raises $0.84 to $1.04
benlondon148: raises $0.84 to $1.88
JB87878: folds 
Jesus Ololo: raises $9.33 to $11.21 and is all-in
benlondon148: folds 
Uncalled bet ($9.33) returned to Jesus Ololo
Jesus Ololo collected $4.40 from pot
*** SUMMARY ***
Total pot $4.61 | Rake $0.21 
Board [2c 8h 9d 4d]
Seat 1: benlondon148 folded on the Turn
Seat 2: JB87878 (button) folded on the Turn
Seat 3: BestAger (small blind) folded before Flop
Seat 4: Jesus Ololo (big blind) collected ($4.40)
Seat 5: Gari Nerskiy folded before Flop (didn't bet)



PokerStars Hand #222951111315:  Hold'em No Limit ($0.05/$0.10 USD) - 2021/01/23 6:43:43 ET
Table 'Saito II' 6-max Seat #3 is the button
Seat 1: benlondon148 ($8.89 in chips) 
Seat 2: JB87878 ($10.05 in chips) 
Seat 3: BestAger ($21.17 in chips) 
Seat 4: Jesus Ololo ($13.73 in chips) 
Seat 5: Gari Nerskiy ($16.22 in chips) 
Jesus Ololo: posts small blind $0.05
Gari Nerskiy: posts big blind $0.10
Quatrehuith: sits out 
*** HOLE CARDS ***
benlondon148: folds 
JB87878: folds 
BestAger: raises $0.10 to $0.20
Jesus Ololo: folds 
Gari Nerskiy: folds 
Uncalled bet ($0.10) returned to BestAger
BestAger collected $0.25 from pot
BestAger: doesn't show hand 
*** SUMMARY ***
Total pot $0.25 | Rake $0 
Seat 1: benlondon148 folded before Flop (didn't bet)
Seat 2: JB87878 folded before Flop (didn't bet)
Seat 3: BestAger (button) collected ($0.25)
Seat 4: Jesus Ololo (small blind) folded before Flop
Seat 5: Gari Nerskiy (big blind) folded before Flop



PokerStars Hand #222951117735:  Hold'em No Limit ($0.05/$0.10 USD) - 2021/01/23 6:44:01 ET
Table 'Saito II' 6-max Seat #4 is the button
Seat 1: benlondon148 ($8.89 in chips) 
Seat 2: JB87878 ($10.05 in chips) 
Seat 3: BestAger ($21.32 in chips) 
Seat 4: Jesus Ololo ($13.68 in chips) 
Seat 5: Gari Nerskiy ($16.12 in chips) 
Seat 6: Quatrehuith ($10 in chips) 
Gari Nerskiy: posts small blind $0.05
Quatrehuith: posts big blind $0.10
*** HOLE CARDS ***
benlondon148: calls $0.10
JB87878: folds 
BestAger: raises $0.20 to $0.30
Jesus Ololo: calls $0.30
Gari Nerskiy: folds 
Quatrehuith: calls $0.20
benlondon148: calls $0.20
*** FLOP *** [Jh Qd Ah]
Quatrehuith: checks 
benlondon148: checks 
BestAger: checks 
Jesus Ololo: bets $0.65
Quatrehuith: calls $0.65
benlondon148: folds 
BestAger: folds 
*** TURN *** [Jh Qd Ah] [Ts]
Quatrehuith: checks 
Jesus Ololo: bets $0.85
Quatrehuith: raises $1.61 to $2.46
Jesus Ololo: calls $1.61
*** RIVER *** [Jh Qd Ah Ts] [2h]
Quatrehuith: checks 
Jesus Ololo: checks 
*** SHOW DOWN ***
Quatrehuith: shows [Kc Jc] (a straight, Ten to Ace)
Jesus Ololo: mucks hand 
Quatrehuith collected $7.13 from pot
*** SUMMARY ***
Total pot $7.47 | Rake $0.34 
Board [Jh Qd Ah Ts 2h]
Seat 1: benlondon148 folded on the Flop
Seat 2: JB87878 folded before Flop (didn't bet)
Seat 3: BestAger folded on the Flop
Seat 4: Jesus Ololo (button) mucked
Seat 5: Gari Nerskiy (small blind) folded before Flop
Seat 6: Quatrehuith (big blind) showed [Kc Jc] and won ($7.13) with a straight, Ten to Ace



PokerStars Hand #222951142524:  Hold'em No Limit ($0.05/$0.10 USD) - 2021/01/23 6:45:13 ET
Table 'Saito II' 6-max Seat #5 is the button
Seat 1: benlondon148 ($8.59 in chips) 
Seat 2: JB87878 ($10.05 in chips) 
Seat 3: BestAger ($21.02 in chips) 
Seat 4: Jesus Ololo ($10.27 in chips) 
Seat 5: Gari Nerskiy ($16.07 in chips) 
Seat 6: Quatrehuith ($13.72 in chips) 
Quatrehuith: posts small blind $0.05
benlondon148: posts big blind $0.10
*** HOLE CARDS ***
JB87878: calls $0.10
BestAger: folds 
Jesus Ololo: folds 
Gari Nerskiy: folds 
Quatrehuith: folds 
benlondon148: checks 
*** FLOP *** [2c 4h 4c]
benlondon148: checks 
JB87878: bets $0.10
benlondon148: folds 
Uncalled bet ($0.10) returned to JB87878
JB87878 collected $0.24 from pot
JB87878: doesn't show hand 
*** SUMMARY ***
Total pot $0.25 | Rake $0.01 
Board [2c 4h 4c]
Seat 1: benlondon148 (big blind) folded on the Flop
Seat 2: JB87878 collected ($0.24)
Seat 3: BestAger folded before Flop (didn't bet)
Seat 4: Jesus Ololo folded before Flop (didn't bet)
Seat 5: Gari Nerskiy (button) folded before Flop (didn't bet)
Seat 6: Quatrehuith (small blind) folded before Flop



PokerStars Hand #222951152031:  Hold'em No Limit ($0.05/$0.10 USD) - 2021/01/23 6:45:41 ET
Table 'Saito II' 6-max Seat #6 is the button
Seat 1: benlondon148 ($8.49 in chips) 
Seat 2: JB87878 ($10.19 in chips) 
Seat 3: BestAger ($21.02 in chips) 
Seat 4: Jesus Ololo ($10.27 in chips) 
Seat 5: Gari Nerskiy ($16.07 in chips) 
Seat 6: Quatrehuith ($13.67 in chips) 
benlondon148: posts small blind $0.05
JB87878: posts big blind $0.10
*** HOLE CARDS ***
BestAger: raises $0.10 to $0.20
Jesus Ololo: folds 
Gari Nerskiy: folds 
Quatrehuith: folds 
benlondon148: folds 
JB87878: folds 
Uncalled bet ($0.10) returned to BestAger
BestAger collected $0.25 from pot
BestAger: doesn't show hand 
*** SUMMARY ***
Total pot $0.25 | Rake $0 
Seat 1: benlondon148 (small blind) folded before Flop
Seat 2: JB87878 (big blind) folded before Flop
Seat 3: BestAger collected ($0.25)
Seat 4: Jesus Ololo folded before Flop (didn't bet)
Seat 5: Gari Nerskiy folded before Flop (didn't bet)
Seat 6: Quatrehuith (button) folded before Flop (didn't bet)



PokerStars Hand #222951155492:  Hold'em No Limit ($0.05/$0.10 USD) - 2021/01/23 6:45:50 ET
Table 'Saito II' 6-max Seat #1 is the button
Seat 1: benlondon148 ($8.44 in chips) 
Seat 2: JB87878 ($10.09 in chips) 
Seat 3: BestAger ($21.17 in chips) 
Seat 4: Jesus Ololo ($10.27 in chips) 
Seat 5: Gari Nerskiy ($16.07 in chips) 
Seat 6: Quatrehuith ($13.67 in chips) 
JB87878: posts small blind $0.05
BestAger: posts big blind $0.10
*** HOLE CARDS ***
Jesus Ololo: folds 
Gari Nerskiy: folds 
Quatrehuith: raises $0.15 to $0.25
benlondon148: folds 
JB87878: folds 
BestAger: calls $0.15
*** FLOP *** [3d 8d Ac]
BestAger: checks 
Quatrehuith: checks 
*** TURN *** [3d 8d Ac] [As]
BestAger: checks 
Quatrehuith: checks 
*** RIVER *** [3d 8d Ac As] [6d]
BestAger: checks 
Quatrehuith: bets $0.10
BestAger: folds 
Uncalled bet ($0.10) returned to Quatrehuith
Quatrehuith collected $0.53 from pot
Quatrehuith: doesn't show hand 
*** SUMMARY ***
Total pot $0.55 | Rake $0.02 
Board [3d 8d Ac As 6d]
Seat 1: benlondon148 (button) folded before Flop (didn't bet)
Seat 2: JB87878 (small blind) folded before Flop
Seat 3: BestAger (big blind) folded on the River
Seat 4: Jesus Ololo folded before Flop (didn't bet)
Seat 5: Gari Nerskiy folded before Flop (didn't bet)
Seat 6: Quatrehuith collected ($0.53)



PokerStars Hand #222951168677:  Hold'em No Limit ($0.05/$0.10 USD) - 2021/01/23 6:46:28 ET
Table 'Saito II' 6-max Seat #2 is the button
Seat 1: benlondon148 ($8.44 in chips) 
Seat 2: JB87878 ($10.04 in chips) 
Seat 3: BestAger ($20.92 in chips) 
Seat 4: Jesus Ololo ($10.27 in chips) 
Seat 5: Gari Nerskiy ($16.07 in chips) 
Seat 6: Quatrehuith ($13.95 in chips) 
BestAger: posts small blind $0.05
Jesus Ololo: posts big blind $0.10
*** HOLE CARDS ***
Gari Nerskiy: folds 
Quatrehuith: folds 
benlondon148: folds 
JB87878: folds 
BestAger: folds 
Uncalled bet ($0.05) returned to Jesus Ololo
Jesus Ololo collected $0.10 from pot
*** SUMMARY ***
Total pot $0.10 | Rake $0 
Seat 1: benlondon148 folded before Flop (didn't bet)
Seat 2: JB87878 (button) folded before Flop (didn't bet)
Seat 3: BestAger (small blind) folded before Flop
Seat 4: Jesus Ololo (big blind) collected ($0.10)
Seat 5: Gari Nerskiy folded before Flop (didn't bet)
Seat 6: Quatrehuith folded before Flop (didn't bet)



PokerStars Hand #222951172151:  Hold'em No Limit ($0.05/$0.10 USD) - 2021/01/23 6:46:39 ET
Table 'Saito II' 6-max Seat #3 is the button
Seat 1: benlondon148 ($8.44 in chips) 
Seat 2: JB87878 ($10.04 in chips) 
Seat 3: BestAger ($20.87 in chips) 
Seat 4: Jesus Ololo ($10.32 in chips) 
Seat 5: Gari Nerskiy ($16.07 in chips) 
Seat 6: Quatrehuith ($13.95 in chips) 
Jesus Ololo: posts small blind $0.05
Gari Nerskiy: posts big blind $0.10
*** HOLE CARDS ***
Quatrehuith: raises $0.20 to $0.30
benlondon148: calls $0.30
JB87878: calls $0.30
BestAger: calls $0.30
Jesus Ololo: calls $0.25
Gari Nerskiy: folds 
*** FLOP *** [8h 7h 9d]
Jesus Ololo: checks 
Quatrehuith: bets $1.40
benlondon148: folds 
JB87878: folds 
BestAger: folds 
Jesus Ololo: folds 
Uncalled bet ($1.40) returned to Quatrehuith
Quatrehuith collected $1.53 from pot
Quatrehuith: doesn't show hand 
*** SUMMARY ***
Total pot $1.60 | Rake $0.07 
Board [8h 7h 9d]
Seat 1: benlondon148 folded on the Flop
Seat 2: JB87878 folded on the Flop
Seat 3: BestAger (button) folded on the Flop
Seat 4: Jesus Ololo (small blind) folded on the Flop
Seat 5: Gari Nerskiy (big blind) folded before Flop
Seat 6: Quatrehuith collected ($1.53)



PokerStars Hand #222951183217:  Hold'em No Limit ($0.05/$0.10 USD) - 2021/01/23 6:47:10 ET
Table 'Saito II' 6-max Seat #4 is the button
Seat 1: benlondon148 ($8.14 in chips) 
Seat 2: JB87878 ($9.74 in chips) 
Seat 3: BestAger ($20.57 in chips) 
Seat 4: Jesus Ololo ($10.02 in chips) 
Seat 5: Gari Nerskiy ($15.97 in chips) 
Seat 6: Quatrehuith ($15.18 in chips) 
Gari Nerskiy: posts small blind $0.05
Quatrehuith: posts big blind $0.10
*** HOLE CARDS ***
benlondon148: folds 
JB87878: calls $0.10
BestAger: folds 
Jesus Ololo: folds 
Gari Nerskiy: folds 
Quatrehuith: checks 
*** FLOP *** [Ac Td 4c]
Quatrehuith: checks 
JB87878: bets $0.10
Quatrehuith: folds 
Uncalled bet ($0.10) returned to JB87878
JB87878 collected $0.24 from pot
JB87878: doesn't show hand 
*** SUMMARY ***
Total pot $0.25 | Rake $0.01 
Board [Ac Td 4c]
Seat 1: benlondon148 folded before Flop (didn't bet)
Seat 2: JB87878 collected ($0.24)
Seat 3: BestAger folded before Flop (didn't bet)
Seat 4: Jesus Ololo (button) folded before Flop (didn't bet)
Seat 5: Gari Nerskiy (small blind) folded before Flop
Seat 6: Quatrehuith (big blind) folded on the Flop



PokerStars Hand #222951192519:  Hold'em No Limit ($0.05/$0.10 USD) - 2021/01/23 6:47:37 ET
Table 'Saito II' 6-max Seat #5 is the button
Seat 1: benlondon148 ($8.14 in chips) 
Seat 2: JB87878 ($9.88 in chips) 
Seat 3: BestAger ($20.57 in chips) 
Seat 4: Jesus Ololo ($10.02 in chips) 
Seat 5: Gari Nerskiy ($15.92 in chips) 
Seat 6: Quatrehuith ($15.08 in chips) 
Quatrehuith: posts small blind $0.05
benlondon148: posts big blind $0.10
*** HOLE CARDS ***
JB87878: folds 
BestAger: raises $0.20 to $0.30
Jesus Ololo: calls $0.30
Gari Nerskiy: folds 
Quatrehuith: raises $1.10 to $1.40
benlondon148: folds 
BestAger: folds 
Jesus Ololo: calls $1.10
*** FLOP *** [4c Qd 5h]
Quatrehuith: bets $1.19
Jesus Ololo: folds 
Uncalled bet ($1.19) returned to Quatrehuith
Quatrehuith collected $3.06 from pot
Quatrehuith: doesn't show hand 
*** SUMMARY ***
Total pot $3.20 | Rake $0.14 
Board [4c Qd 5h]
Seat 1: benlondon148 (big blind) folded before Flop
Seat 2: JB87878 folded before Flop (didn't bet)
Seat 3: BestAger folded before Flop
Seat 4: Jesus Ololo folded on the Flop
Seat 5: Gari Nerskiy (button) folded before Flop (didn't bet)
Seat 6: Quatrehuith (small blind) collected ($3.06)



PokerStars Hand #222951205835:  Hold'em No Limit ($0.05/$0.10 USD) - 2021/01/23 6:48:15 ET
Table 'Saito II' 6-max Seat #6 is the button
Seat 1: benlondon148 ($8.04 in chips) 
Seat 2: JB87878 ($9.88 in chips) 
Seat 3: BestAger ($20.27 in chips) 
Seat 4: Jesus Ololo ($10 in chips) 
Seat 5: Gari Nerskiy ($15.92 in chips) 
Seat 6: Quatrehuith ($16.74 in chips) 
benlondon148: posts small blind $0.05
JB87878: posts big blind $0.10
*** HOLE CARDS ***
BestAger: raises $0.10 to $0.20
Jesus Ololo: folds 
Gari Nerskiy: folds 
Quatrehuith: folds 
benlondon148: folds 
JB87878: calls $0.10
*** FLOP *** [3d Kd 5c]
JB87878: bets $0.10
BestAger: calls $0.10
*** TURN *** [3d Kd 5c] [4c]
JB87878: bets $0.10
BestAger: calls $0.10
*** RIVER *** [3d Kd 5c 4c] [Js]
JB87878: bets $0.40
BestAger: folds 
Uncalled bet ($0.40) returned to JB87878
JB87878 collected $0.81 from pot
JB87878: doesn't show hand 
*** SUMMARY ***
Total pot $0.85 | Rake $0.04 
Board [3d Kd 5c 4c Js]
Seat 1: benlondon148 (small blind) folded before Flop
Seat 2: JB87878 (big blind) collected ($0.81)
Seat 3: BestAger folded on the River
Seat 4: Jesus Ololo folded before Flop (didn't bet)
Seat 5: Gari Nerskiy folded before Flop (didn't bet)
Seat 6: Quatrehuith (button) folded before Flop (didn't bet)



PokerStars Hand #222951222458:  Hold'em No Limit ($0.05/$0.10 USD) - 2021/01/23 6:49:03 ET
Table 'Saito II' 6-max Seat #1 is the button
Seat 1: benlondon148 ($7.99 in chips) 
Seat 2: JB87878 ($10.29 in chips) 
Seat 3: BestAger ($19.87 in chips) 
Seat 4: Jesus Ololo ($10 in chips) 
Seat 5: Gari Nerskiy ($15.92 in chips) 
Seat 6: Quatrehuith ($16.74 in chips) 
JB87878: posts small blind $0.05
BestAger: posts big blind $0.10
*** HOLE CARDS ***
Jesus Ololo: folds 
Gari Nerskiy: folds 
Quatrehuith: folds 
benlondon148: calls $0.10
JB87878: calls $0.05
BestAger: checks 
*** FLOP *** [8s 8d Tc]
JB87878: bets $0.10
BestAger: folds 
benlondon148: calls $0.10
*** TURN *** [8s 8d Tc] [8c]
JB87878: bets $0.24
benlondon148: raises $0.24 to $0.48
JB87878: folds 
Uncalled bet ($0.24) returned to benlondon148
benlondon148 collected $0.94 from pot
benlondon148: doesn't show hand 
*** SUMMARY ***
Total pot $0.98 | Rake $0.04 
Board [8s 8d Tc 8c]
Seat 1: benlondon148 (button) collected ($0.94)
Seat 2: JB87878 (small blind) folded on the Turn
Seat 3: BestAger (big blind) folded on the Flop
Seat 4: Jesus Ololo folded before Flop (didn't bet)
Seat 5: Gari Nerskiy folded before Flop (didn't bet)
Seat 6: Quatrehuith folded before Flop (didn't bet)



PokerStars Hand #222951236332:  Hold'em No Limit ($0.05/$0.10 USD) - 2021/01/23 6:49:42 ET
Table 'Saito II' 6-max Seat #2 is the button
Seat 1: benlondon148 ($8.49 in chips) 
Seat 2: JB87878 ($9.85 in chips) 
Seat 3: BestAger ($19.77 in chips) 
Seat 4: Jesus Ololo ($10 in chips) 
Seat 5: Gari Nerskiy ($15.92 in chips) 
Seat 6: Quatrehuith ($16.74 in chips) 
BestAger: posts small blind $0.05
Jesus Ololo: posts big blind $0.10
*** HOLE CARDS ***
Gari Nerskiy: folds 
Quatrehuith: folds 
benlondon148: folds 
JB87878: calls $0.10
BestAger: folds 
Jesus Ololo: checks 
*** FLOP *** [3h 6d Qh]
Jesus Ololo: checks 
JB87878: bets $0.10
Jesus Ololo: folds 
Uncalled bet ($0.10) returned to JB87878
JB87878 collected $0.24 from pot
JB87878: doesn't show hand 
*** SUMMARY ***
Total pot $0.25 | Rake $0.01 
Board [3h 6d Qh]
Seat 1: benlondon148 folded before Flop (didn't bet)
Seat 2: JB87878 (button) collected ($0.24)
Seat 3: BestAger (small blind) folded before Flop
Seat 4: Jesus Ololo (big blind) folded on the Flop
Seat 5: Gari Nerskiy folded before Flop (didn't bet)
Seat 6: Quatrehuith folded before Flop (didn't bet)



PokerStars Hand #222951246933:  Hold'em No Limit ($0.05/$0.10 USD) - 2021/01/23 6:50:12 ET
Table 'Saito II' 6-max Seat #3 is the button
Seat 1: benlondon148 ($8.49 in chips) 
Seat 2: JB87878 ($9.99 in chips) 
Seat 3: BestAger ($19.72 in chips) 
Seat 4: Jesus Ololo ($10 in chips) 
Seat 5: Gari Nerskiy ($15.92 in chips) 
Seat 6: Quatrehuith ($16.74 in chips) 
Jesus Ololo: posts small blind $0.05
Gari Nerskiy: posts big blind $0.10
*** HOLE CARDS ***
Quatrehuith: folds 
benlondon148: folds 
JB87878: calls $0.10
BestAger: folds 
Jesus Ololo: calls $0.05
Gari Nerskiy: raises $0.10 to $0.20
JB87878: calls $0.10
Jesus Ololo: calls $0.10
*** FLOP *** [Kh 8c Kc]
Jesus Ololo: checks 
Gari Nerskiy: checks 
JB87878: checks 
*** TURN *** [Kh 8c Kc] [Ac]
Jesus Ololo: checks 
Gari Nerskiy: bets $0.35
JB87878: calls $0.35
Jesus Ololo: folds 
*** RIVER *** [Kh 8c Kc Ac] [6h]
Gari Nerskiy: bets $1
JB87878: raises $1 to $2
Gari Nerskiy: raises $13.37 to $15.37 and is all-in
JB87878: calls $7.44 and is all-in
Uncalled bet ($5.93) returned to Gari Nerskiy
*** SHOW DOWN ***
Gari Nerskiy: shows [8h 8d] (a full house, Eights full of Kings)
JB87878: shows [Js Kd] (three of a kind, Kings)
Gari Nerskiy collected $19.27 from pot
*** SUMMARY ***
Total pot $20.18 | Rake $0.91 
Board [Kh 8c Kc Ac 6h]
Seat 1: benlondon148 folded before Flop (didn't bet)
Seat 2: JB87878 showed [Js Kd] and lost with three of a kind, Kings
Seat 3: BestAger (button) folded before Flop (didn't bet)
Seat 4: Jesus Ololo (small blind) folded on the Turn
Seat 5: Gari Nerskiy (big blind) showed [8h 8d] and won ($19.27) with a full house, Eights full of Kings
Seat 6: Quatrehuith folded before Flop (didn't bet)



PokerStars Hand #222951265239:  Hold'em No Limit ($0.05/$0.10 USD) - 2021/01/23 6:51:05 ET
Table 'Saito II' 6-max Seat #4 is the button
Seat 1: benlondon148 ($8.49 in chips) 
Seat 3: BestAger ($19.72 in chips) 
Seat 4: Jesus Ololo ($10 in chips) 
Seat 5: Gari Nerskiy ($25.20 in chips) 
Seat 6: Quatrehuith ($16.74 in chips) 
Gari Nerskiy: posts small blind $0.05
Quatrehuith: posts big blind $0.10
*** HOLE CARDS ***
benlondon148: calls $0.10
BestAger: folds 
Jesus Ololo: calls $0.10
Gari Nerskiy: calls $0.05
Quatrehuith: checks 
*** FLOP *** [9h 7h 3s]
Gari Nerskiy: checks 
JB87878 leaves the table
Quatrehuith: checks 
Viten'kA83 joins the table at seat #2 
benlondon148: checks 
Jesus Ololo: checks 
*** TURN *** [9h 7h 3s] [6h]
Gari Nerskiy: bets $0.24
Quatrehuith: calls $0.24
benlondon148: folds 
Jesus Ololo: folds 
*** RIVER *** [9h 7h 3s 6h] [4c]
Gari Nerskiy: checks 
Quatrehuith: checks 
*** SHOW DOWN ***
Gari Nerskiy: shows [9s 7d] (two pair, Nines and Sevens)
Quatrehuith: mucks hand 
Gari Nerskiy collected $0.84 from pot
*** SUMMARY ***
Total pot $0.88 | Rake $0.04 
Board [9h 7h 3s 6h 4c]
Seat 1: benlondon148 folded on the Turn
Seat 3: BestAger folded before Flop (didn't bet)
Seat 4: Jesus Ololo (button) folded on the Turn
Seat 5: Gari Nerskiy (small blind) showed [9s 7d] and won ($0.84) with two pair, Nines and Sevens
Seat 6: Quatrehuith (big blind) mucked



PokerStars Hand #222951281795:  Hold'em No Limit ($0.05/$0.10 USD) - 2021/01/23 6:51:52 ET
Table 'Saito II' 6-max Seat #5 is the button
Seat 1: benlondon148 ($8.39 in chips) 
Seat 3: BestAger ($19.72 in chips) 
Seat 4: Jesus Ololo ($10 in chips) 
Seat 5: Gari Nerskiy ($25.70 in chips) 
Seat 6: Quatrehuith ($16.40 in chips) 
Quatrehuith: posts small blind $0.05
benlondon148: posts big blind $0.10
Viten'kA83: sits out 
*** HOLE CARDS ***
BestAger: folds 
Jesus Ololo: raises $0.15 to $0.25
Gari Nerskiy: folds 
Quatrehuith: folds 
benlondon148: calls $0.15
*** FLOP *** [2c 8s 6s]
benlondon148: checks 
Jesus Ololo: checks 
*** TURN *** [2c 8s 6s] [Th]
benlondon148: checks 
Jesus Ololo: checks 
*** RIVER *** [2c 8s 6s Th] [Qd]
benlondon148: checks 
Jesus Ololo: checks 
*** SHOW DOWN ***
benlondon148: shows [Ac Kc] (high card Ace)
Jesus Ololo: mucks hand 
benlondon148 collected $0.53 from pot
*** SUMMARY ***
Total pot $0.55 | Rake $0.02 
Board [2c 8s 6s Th Qd]
Seat 1: benlondon148 (big blind) showed [Ac Kc] and won ($0.53) with high card Ace
Seat 3: BestAger folded before Flop (didn't bet)
Seat 4: Jesus Ololo mucked
Seat 5: Gari Nerskiy (button) folded before Flop (didn't bet)
Seat 6: Quatrehuith (small blind) folded before Flop



PokerStars Hand #222951292435:  Hold'em No Limit ($0.05/$0.10 USD) - 2021/01/23 6:52:23 ET
Table 'Saito II' 6-max Seat #6 is the button
Seat 1: benlondon148 ($8.67 in chips) 
Seat 2: Viten'kA83 ($10 in chips) 
Seat 3: BestAger ($19.72 in chips) 
Seat 4: Jesus Ololo ($10 in chips) 
Seat 5: Gari Nerskiy ($25.70 in chips) 
Seat 6: Quatrehuith ($16.35 in chips) 
benlondon148: posts small blind $0.05
Viten'kA83: posts big blind $0.10
*** HOLE CARDS ***
BestAger: raises $0.20 to $0.30
Jesus Ololo: folds 
Gari Nerskiy: folds 
Quatrehuith: folds 
benlondon148: raises $0.20 to $0.50
Viten'kA83: folds 
BestAger: calls $0.20
*** FLOP *** [4s 3c 5c]
benlondon148: bets $0.10
BestAger: calls $0.10
*** TURN *** [4s 3c 5c] [6c]
benlondon148: bets $0.10
BestAger: raises $0.20 to $0.30
benlondon148: raises $0.20 to $0.50
BestAger: calls $0.20
*** RIVER *** [4s 3c 5c 6c] [3d]
benlondon148: bets $1.70
BestAger: calls $1.70
*** SHOW DOWN ***
benlondon148: shows [8c 8d] (two pair, Eights and Threes)
BestAger: mucks hand 
benlondon148 collected $5.44 from pot
*** SUMMARY ***
Total pot $5.70 | Rake $0.26 
Board [4s 3c 5c 6c 3d]
Seat 1: benlondon148 (small blind) showed [8c 8d] and won ($5.44) with two pair, Eights and Threes
Seat 2: Viten'kA83 (big blind) folded before Flop
Seat 3: BestAger mucked
Seat 4: Jesus Ololo folded before Flop (didn't bet)
Seat 5: Gari Nerskiy folded before Flop (didn't bet)
Seat 6: Quatrehuith (button) folded before Flop (didn't bet)



PokerStars Hand #222951315774:  Hold'em No Limit ($0.05/$0.10 USD) - 2021/01/23 6:53:30 ET
Table 'Saito II' 6-max Seat #1 is the button
Seat 1: benlondon148 ($11.31 in chips) 
Seat 2: Viten'kA83 ($10 in chips) 
Seat 3: BestAger ($16.92 in chips) 
Seat 4: Jesus Ololo ($10 in chips) 
Seat 5: Gari Nerskiy ($25.70 in chips) 
Seat 6: Quatrehuith ($16.35 in chips) 
Viten'kA83: posts small blind $0.05
BestAger: posts big blind $0.10
*** HOLE CARDS ***
Jesus Ololo: raises $0.15 to $0.25
Gari Nerskiy: folds 
Quatrehuith: folds 
benlondon148: folds 
Viten'kA83: folds 
BestAger: calls $0.15
*** FLOP *** [6s 4d 2d]
BestAger: bets $0.30
Jesus Ololo: folds 
Uncalled bet ($0.30) returned to BestAger
BestAger collected $0.53 from pot
BestAger: doesn't show hand 
*** SUMMARY ***
Total pot $0.55 | Rake $0.02 
Board [6s 4d 2d]
Seat 1: benlondon148 (button) folded before Flop (didn't bet)
Seat 2: Viten'kA83 (small blind) folded before Flop
Seat 3: BestAger (big blind) collected ($0.53)
Seat 4: Jesus Ololo folded on the Flop
Seat 5: Gari Nerskiy folded before Flop (didn't bet)
Seat 6: Quatrehuith folded before Flop (didn't bet)



PokerStars Hand #222951323614:  Hold'em No Limit ($0.05/$0.10 USD) - 2021/01/23 6:53:52 ET
Table 'Saito II' 6-max Seat #2 is the button
Seat 1: benlondon148 ($11.31 in chips) 
Seat 2: Viten'kA83 ($10 in chips) 
Seat 3: BestAger ($17.20 in chips) 
Seat 4: Jesus Ololo ($10 in chips) 
Seat 5: Gari Nerskiy ($25.70 in chips) 
Seat 6: Quatrehuith ($16.35 in chips) 
BestAger: posts small blind $0.05
Jesus Ololo: posts big blind $0.10
*** HOLE CARDS ***
Gari Nerskiy: folds 
Quatrehuith: folds 
benlondon148: folds 
Viten'kA83: raises $0.15 to $0.25
BestAger: folds 
Jesus Ololo: calls $0.15
*** FLOP *** [4c 4s 5c]
Jesus Ololo: checks 
Viten'kA83: bets $0.27
Jesus Ololo: calls $0.27
*** TURN *** [4c 4s 5c] [8s]
Jesus Ololo: checks 
Viten'kA83: bets $0.53
Jesus Ololo: calls $0.53
*** RIVER *** [4c 4s 5c 8s] [Kh]
Jesus Ololo: checks 
Viten'kA83: checks 
*** SHOW DOWN ***
Jesus Ololo: shows [2s 2d] (two pair, Fours and Deuces)
Viten'kA83: shows [3c 3d] (two pair, Fours and Threes)
Viten'kA83 collected $2.05 from pot
*** SUMMARY ***
Total pot $2.15 | Rake $0.10 
Board [4c 4s 5c 8s Kh]
Seat 1: benlondon148 folded before Flop (didn't bet)
Seat 2: Viten'kA83 (button) showed [3c 3d] and won ($2.05) with two pair, Fours and Threes
Seat 3: BestAger (small blind) folded before Flop
Seat 4: Jesus Ololo (big blind) showed [2s 2d] and lost with two pair, Fours and Deuces
Seat 5: Gari Nerskiy folded before Flop (didn't bet)
Seat 6: Quatrehuith folded before Flop (didn't bet)



PokerStars Hand #222951341487:  Hold'em No Limit ($0.05/$0.10 USD) - 2021/01/23 6:54:43 ET
Table 'Saito II' 6-max Seat #3 is the button
Seat 1: benlondon148 ($11.31 in chips) 
Seat 2: Viten'kA83 ($11 in chips) 
Seat 3: BestAger ($17.15 in chips) 
Seat 4: Jesus Ololo ($10 in chips) 
Seat 5: Gari Nerskiy ($25.70 in chips) 
Seat 6: Quatrehuith ($16.35 in chips) 
Jesus Ololo: posts small blind $0.05
Gari Nerskiy: posts big blind $0.10
*** HOLE CARDS ***
Quatrehuith: raises $0.20 to $0.30
benlondon148: folds 
Viten'kA83: folds 
BestAger: folds 
Jesus Ololo: folds 
Gari Nerskiy: folds 
Uncalled bet ($0.20) returned to Quatrehuith
Quatrehuith collected $0.25 from pot
Quatrehuith: doesn't show hand 
*** SUMMARY ***
Total pot $0.25 | Rake $0 
Seat 1: benlondon148 folded before Flop (didn't bet)
Seat 2: Viten'kA83 folded before Flop (didn't bet)
Seat 3: BestAger (button) folded before Flop (didn't bet)
Seat 4: Jesus Ololo (small blind) folded before Flop
Seat 5: Gari Nerskiy (big blind) folded before Flop
Seat 6: Quatrehuith collected ($0.25)



PokerStars Hand #222951347582:  Hold'em No Limit ($0.05/$0.10 USD) - 2021/01/23 6:55:00 ET
Table 'Saito II' 6-max Seat #4 is the button
Seat 1: benlondon148 ($11.31 in chips) 
Seat 2: Viten'kA83 ($11 in chips) 
Seat 3: BestAger ($17.15 in chips) 
Seat 4: Jesus Ololo ($10 in chips) 
Seat 5: Gari Nerskiy ($25.60 in chips) 
Seat 6: Quatrehuith ($16.50 in chips) 
Gari Nerskiy: posts small blind $0.05
Quatrehuith: posts big blind $0.10
*** HOLE CARDS ***
benlondon148: folds 
Viten'kA83: folds 
BestAger: raises $0.10 to $0.20
Jesus Ololo: folds 
Gari Nerskiy: folds 
Quatrehuith: folds 
Uncalled bet ($0.10) returned to BestAger
BestAger collected $0.25 from pot
BestAger: doesn't show hand 
*** SUMMARY ***
Total pot $0.25 | Rake $0 
Seat 1: benlondon148 folded before Flop (didn't bet)
Seat 2: Viten'kA83 folded before Flop (didn't bet)
Seat 3: BestAger collected ($0.25)
Seat 4: Jesus Ololo (button) folded before Flop (didn't bet)
Seat 5: Gari Nerskiy (small blind) folded before Flop
Seat 6: Quatrehuith (big blind) folded before Flop



PokerStars Hand #222951354593:  Hold'em No Limit ($0.05/$0.10 USD) - 2021/01/23 6:55:22 ET
Table 'Saito II' 6-max Seat #5 is the button
Seat 1: benlondon148 ($11.31 in chips) 
Seat 2: Viten'kA83 ($11 in chips) 
Seat 3: BestAger ($17.30 in chips) 
Seat 4: Jesus Ololo ($10 in chips) 
Seat 5: Gari Nerskiy ($25.55 in chips) 
Seat 6: Quatrehuith ($16.40 in chips) 
Quatrehuith: posts small blind $0.05
benlondon148: posts big blind $0.10
*** HOLE CARDS ***
Viten'kA83: folds 
BestAger: folds 
Jesus Ololo: folds 
Gari Nerskiy: raises $0.20 to $0.30
Quatrehuith: folds 
benlondon148: folds 
Uncalled bet ($0.20) returned to Gari Nerskiy
Gari Nerskiy collected $0.25 from pot
Gari Nerskiy: doesn't show hand 
*** SUMMARY ***
Total pot $0.25 | Rake $0 
Seat 1: benlondon148 (big blind) folded before Flop
Seat 2: Viten'kA83 folded before Flop (didn't bet)
Seat 3: BestAger folded before Flop (didn't bet)
Seat 4: Jesus Ololo folded before Flop (didn't bet)
Seat 5: Gari Nerskiy (button) collected ($0.25)
Seat 6: Quatrehuith (small blind) folded before Flop



PokerStars Hand #222951360256:  Hold'em No Limit ($0.05/$0.10 USD) - 2021/01/23 6:55:40 ET
Table 'Saito II' 6-max Seat #6 is the button
Seat 1: benlondon148 ($11.21 in chips) 
Seat 2: Viten'kA83 ($11 in chips) 
Seat 3: BestAger ($17.30 in chips) 
Seat 4: Jesus Ololo ($10 in chips) 
Seat 5: Gari Nerskiy ($25.70 in chips) 
Seat 6: Quatrehuith ($16.35 in chips) 
benlondon148: posts small blind $0.05
Viten'kA83: posts big blind $0.10
*** HOLE CARDS ***
BestAger: folds 
Jesus Ololo: folds 
Gari Nerskiy: raises $0.15 to $0.25
Quatrehuith: folds 
benlondon148: calls $0.20
Viten'kA83: folds 
*** FLOP *** [2c 5d Qd]
benlondon148: bets $0.80
Gari Nerskiy: calls $0.80
*** TURN *** [2c 5d Qd] [Th]
benlondon148: bets $0.50
Gari Nerskiy: calls $0.50
*** RIVER *** [2c 5d Qd Th] [6h]
benlondon148: bets $0.10
Gari Nerskiy: calls $0.10
*** SHOW DOWN ***
benlondon148: shows [Qh Kc] (a pair of Queens)
Gari Nerskiy: mucks hand 
benlondon148 collected $3.25 from pot
*** SUMMARY ***
Total pot $3.40 | Rake $0.15 
Board [2c 5d Qd Th 6h]
Seat 1: benlondon148 (small blind) showed [Qh Kc] and won ($3.25) with a pair of Queens
Seat 2: Viten'kA83 (big blind) folded before Flop
Seat 3: BestAger folded before Flop (didn't bet)
Seat 4: Jesus Ololo folded before Flop (didn't bet)
Seat 5: Gari Nerskiy mucked
Seat 6: Quatrehuith (button) folded before Flop (didn't bet)



PokerStars Hand #222951374508:  Hold'em No Limit ($0.05/$0.10 USD) - 2021/01/23 6:56:27 ET
Table 'Saito II' 6-max Seat #1 is the button
Seat 1: benlondon148 ($12.81 in chips) 
Seat 2: Viten'kA83 ($10.90 in chips) 
Seat 3: BestAger ($17.30 in chips) 
Seat 4: Jesus Ololo ($10 in chips) 
Seat 5: Gari Nerskiy ($24.05 in chips) 
Seat 6: Quatrehuith ($16.35 in chips) 
Viten'kA83: posts small blind $0.05
BestAger: posts big blind $0.10
*** HOLE CARDS ***
Jesus Ololo: folds 
Gari Nerskiy: folds 
Jesus Ololo leaves the table
Quatrehuith: raises $0.15 to $0.25
omithos joins the table at seat #4 
benlondon148: raises $0.15 to $0.40
Viten'kA83: folds 
BestAger: folds 
Quatrehuith: calls $0.15
*** FLOP *** [Ac Ad 3d]
Quatrehuith: checks 
benlondon148: bets $3.70
Quatrehuith: folds 
Uncalled bet ($3.70) returned to benlondon148
benlondon148 collected $0.91 from pot
benlondon148: doesn't show hand 
*** SUMMARY ***
Total pot $0.95 | Rake $0.04 
Board [Ac Ad 3d]
Seat 1: benlondon148 (button) collected ($0.91)
Seat 2: Viten'kA83 (small blind) folded before Flop
Seat 3: BestAger (big blind) folded before Flop
Seat 4: Jesus Ololo folded before Flop (didn't bet)
Seat 5: Gari Nerskiy folded before Flop (didn't bet)
Seat 6: Quatrehuith folded on the Flop



PokerStars Hand #222951381660:  Hold'em No Limit ($0.05/$0.10 USD) - 2021/01/23 6:56:51 ET
Table 'Saito II' 6-max Seat #2 is the button
Seat 1: benlondon148 ($13.32 in chips) 
Seat 2: Viten'kA83 ($10.85 in chips) 
Seat 3: BestAger ($17.20 in chips) 
Seat 4: omithos ($10 in chips) 
Seat 5: Gari Nerskiy ($24.05 in chips) 
Seat 6: Quatrehuith ($15.95 in chips) 
BestAger: posts small blind $0.05
omithos: posts big blind $0.10
*** HOLE CARDS ***
Gari Nerskiy: raises $0.20 to $0.30
Quatrehuith: folds 
benlondon148: folds 
Viten'kA83: folds 
BestAger: folds 
omithos: folds 
Uncalled bet ($0.20) returned to Gari Nerskiy
Gari Nerskiy collected $0.25 from pot
Gari Nerskiy: doesn't show hand 
*** SUMMARY ***
Total pot $0.25 | Rake $0 
Seat 1: benlondon148 folded before Flop (didn't bet)
Seat 2: Viten'kA83 (button) folded before Flop (didn't bet)
Seat 3: BestAger (small blind) folded before Flop
Seat 4: omithos (big blind) folded before Flop
Seat 5: Gari Nerskiy collected ($0.25)
Seat 6: Quatrehuith folded before Flop (didn't bet)



PokerStars Hand #222951387325:  Hold'em No Limit ($0.05/$0.10 USD) - 2021/01/23 6:57:09 ET
Table 'Saito II' 6-max Seat #3 is the button
Seat 1: benlondon148 ($13.32 in chips) 
Seat 2: Viten'kA83 ($10.85 in chips) 
Seat 3: BestAger ($17.15 in chips) 
Seat 4: omithos ($9.90 in chips) 
Seat 5: Gari Nerskiy ($24.20 in chips) 
Seat 6: Quatrehuith ($15.95 in chips) 
omithos: posts small blind $0.05
Gari Nerskiy: posts big blind $0.10
*** HOLE CARDS ***
Quatrehuith: raises $0.20 to $0.30
benlondon148: folds 
Viten'kA83: folds 
BestAger: calls $0.30
omithos: folds 
Gari Nerskiy: folds 
*** FLOP *** [4h 6s Jd]
Quatrehuith: checks 
BestAger: checks 
*** TURN *** [4h 6s Jd] [Ah]
Quatrehuith: bets $0.48
BestAger: calls $0.48
*** RIVER *** [4h 6s Jd Ah] [8d]
Quatrehuith: checks 
BestAger: checks 
*** SHOW DOWN ***
Quatrehuith: shows [7c Ac] (a pair of Aces)
BestAger: mucks hand 
Quatrehuith collected $1.63 from pot
*** SUMMARY ***
Total pot $1.71 | Rake $0.08 
Board [4h 6s Jd Ah 8d]
Seat 1: benlondon148 folded before Flop (didn't bet)
Seat 2: Viten'kA83 folded before Flop (didn't bet)
Seat 3: BestAger (button) mucked
Seat 4: omithos (small blind) folded before Flop
Seat 5: Gari Nerskiy (big blind) folded before Flop
Seat 6: Quatrehuith showed [7c Ac] and won ($1.63) with a pair of Aces



PokerStars Hand #222951395987:  Hold'em No Limit ($0.05/$0.10 USD) - 2021/01/23 6:57:38 ET
Table 'Saito II' 6-max Seat #4 is the button
Seat 1: benlondon148 ($13.32 in chips) 
Seat 2: Viten'kA83 ($10.85 in chips) 
Seat 3: BestAger ($16.37 in chips) 
Seat 4: omithos ($9.85 in chips) 
Seat 5: Gari Nerskiy ($24.10 in chips) 
Seat 6: Quatrehuith ($16.80 in chips) 
Gari Nerskiy: posts small blind $0.05
Quatrehuith: posts big blind $0.10
*** HOLE CARDS ***
benlondon148: folds 
benlondon148 is disconnected 
Viten'kA83: folds 
BestAger: raises $0.20 to $0.30
omithos: folds 
Gari Nerskiy: folds 
Quatrehuith: folds 
Uncalled bet ($0.20) returned to BestAger
BestAger collected $0.25 from pot
BestAger: doesn't show hand 
*** SUMMARY ***
Total pot $0.25 | Rake $0 
Seat 1: benlondon148 folded before Flop (didn't bet)
Seat 2: Viten'kA83 folded before Flop (didn't bet)
Seat 3: BestAger collected ($0.25)
Seat 4: omithos (button) folded before Flop (didn't bet)
Seat 5: Gari Nerskiy (small blind) folded before Flop
Seat 6: Quatrehuith (big blind) folded before Flop



PokerStars Hand #222951401239:  Hold'em No Limit ($0.05/$0.10 USD) - 2021/01/23 6:57:55 ET
Table 'Saito II' 6-max Seat #5 is the button
Seat 2: Viten'kA83 ($10.85 in chips) 
Seat 3: BestAger ($16.52 in chips) 
Seat 4: omithos ($9.85 in chips) 
Seat 5: Gari Nerskiy ($24.05 in chips) 
Seat 6: Quatrehuith ($16.70 in chips) 
Quatrehuith: posts small blind $0.05
benlondon148 has timed out while disconnected
benlondon148: is sitting out 
Viten'kA83: posts big blind $0.10
*** HOLE CARDS ***
BestAger: folds 
omithos: folds 
Gari Nerskiy: folds 
Quatrehuith: raises $0.20 to $0.30
Viten'kA83: folds 
Uncalled bet ($0.20) returned to Quatrehuith
Quatrehuith collected $0.20 from pot
Quatrehuith: doesn't show hand 
*** SUMMARY ***
Total pot $0.20 | Rake $0 
Seat 2: Viten'kA83 (big blind) folded before Flop
Seat 3: BestAger folded before Flop (didn't bet)
Seat 4: omithos folded before Flop (didn't bet)
Seat 5: Gari Nerskiy (button) folded before Flop (didn't bet)
Seat 6: Quatrehuith (small blind) collected ($0.20)



PokerStars Hand #222951409345:  Hold'em No Limit ($0.05/$0.10 USD) - 2021/01/23 6:58:22 ET
Table 'Saito II' 6-max Seat #6 is the button
Seat 2: Viten'kA83 ($10.75 in chips) 
Seat 3: BestAger ($16.52 in chips) 
Seat 4: omithos ($9.85 in chips) 
Seat 5: Gari Nerskiy ($24.05 in chips) 
Seat 6: Quatrehuith ($16.80 in chips) 
Viten'kA83: posts small blind $0.05
BestAger: posts big blind $0.10
*** HOLE CARDS ***
omithos: folds 
Gari Nerskiy: folds 
Quatrehuith: folds 
Viten'kA83: calls $0.05
BestAger: checks 
*** FLOP *** [Th 3h 7s]
Viten'kA83: checks 
BestAger: checks 
*** TURN *** [Th 3h 7s] [4d]
Viten'kA83: checks 
BestAger: bets $0.20
Viten'kA83: folds 
Uncalled bet ($0.20) returned to BestAger
BestAger collected $0.19 from pot
BestAger: doesn't show hand 
*** SUMMARY ***
Total pot $0.20 | Rake $0.01 
Board [Th 3h 7s 4d]
Seat 2: Viten'kA83 (small blind) folded on the Turn
Seat 3: BestAger (big blind) collected ($0.19)
Seat 4: omithos folded before Flop (didn't bet)
Seat 5: Gari Nerskiy folded before Flop (didn't bet)
Seat 6: Quatrehuith (button) folded before Flop (didn't bet)



PokerStars Hand #222951418616:  Hold'em No Limit ($0.05/$0.10 USD) - 2021/01/23 6:58:52 ET
Table 'Saito II' 6-max Seat #2 is the button
Seat 2: Viten'kA83 ($10.65 in chips) 
Seat 3: BestAger ($16.61 in chips) 
Seat 4: omithos ($9.85 in chips) 
Seat 5: Gari Nerskiy ($24.05 in chips) 
Seat 6: Quatrehuith ($16.80 in chips) 
BestAger: posts small blind $0.05
omithos: posts big blind $0.10
*** HOLE CARDS ***
Gari Nerskiy: raises $0.20 to $0.30
Quatrehuith: folds 
Viten'kA83: folds 
BestAger: calls $0.25
omithos: raises $0.90 to $1.20
Gari Nerskiy: calls $0.90
BestAger: calls $0.90
*** FLOP *** [4s 4c Ts]
BestAger: checks 
omithos: bets $1.89
Gari Nerskiy: folds 
BestAger: folds 
Uncalled bet ($1.89) returned to omithos
omithos collected $3.44 from pot
omithos: doesn't show hand 
*** SUMMARY ***
Total pot $3.60 | Rake $0.16 
Board [4s 4c Ts]
Seat 2: Viten'kA83 (button) folded before Flop (didn't bet)
Seat 3: BestAger (small blind) folded on the Flop
Seat 4: omithos (big blind) collected ($3.44)
Seat 5: Gari Nerskiy folded on the Flop
Seat 6: Quatrehuith folded before Flop (didn't bet)



PokerStars Hand #222951433422:  Hold'em No Limit ($0.05/$0.10 USD) - 2021/01/23 6:59:40 ET
Table 'Saito II' 6-max Seat #3 is the button
Seat 2: Viten'kA83 ($10.65 in chips) 
Seat 3: BestAger ($15.41 in chips) 
Seat 4: omithos ($12.09 in chips) 
Seat 5: Gari Nerskiy ($22.85 in chips) 
Seat 6: Quatrehuith ($16.80 in chips) 
omithos: posts small blind $0.05
Gari Nerskiy: posts big blind $0.10
*** HOLE CARDS ***
Quatrehuith: folds 
Viten'kA83: raises $0.20 to $0.30
BestAger: folds 
omithos: folds 
Gari Nerskiy: folds 
Uncalled bet ($0.20) returned to Viten'kA83
Viten'kA83 collected $0.25 from pot
Viten'kA83: doesn't show hand 
*** SUMMARY ***
Total pot $0.25 | Rake $0 
Seat 2: Viten'kA83 collected ($0.25)
Seat 3: BestAger (button) folded before Flop (didn't bet)
Seat 4: omithos (small blind) folded before Flop
Seat 5: Gari Nerskiy (big blind) folded before Flop
Seat 6: Quatrehuith folded before Flop (didn't bet)



PokerStars Hand #222951439440:  Hold'em No Limit ($0.05/$0.10 USD) - 2021/01/23 6:59:59 ET
Table 'Saito II' 6-max Seat #4 is the button
Seat 2: Viten'kA83 ($10.80 in chips) 
Seat 3: BestAger ($15.41 in chips) 
Seat 4: omithos ($12.04 in chips) 
Seat 5: Gari Nerskiy ($22.75 in chips) 
Seat 6: Quatrehuith ($16.80 in chips) 
Gari Nerskiy: posts small blind $0.05
Quatrehuith: posts big blind $0.10
*** HOLE CARDS ***
Viten'kA83: raises $0.20 to $0.30
BestAger: folds 
omithos: folds 
Gari Nerskiy: folds 
Quatrehuith: folds 
Uncalled bet ($0.20) returned to Viten'kA83
Viten'kA83 collected $0.25 from pot
Viten'kA83: doesn't show hand 
*** SUMMARY ***
Total pot $0.25 | Rake $0 
Seat 2: Viten'kA83 collected ($0.25)
Seat 3: BestAger folded before Flop (didn't bet)
Seat 4: omithos (button) folded before Flop (didn't bet)
Seat 5: Gari Nerskiy (small blind) folded before Flop
Seat 6: Quatrehuith (big blind) folded before Flop



PokerStars Hand #222951446147:  Hold'em No Limit ($0.05/$0.10 USD) - 2021/01/23 7:00:21 ET
Table 'Saito II' 6-max Seat #5 is the button
Seat 3: BestAger ($15.41 in chips) 
Seat 4: omithos ($12.04 in chips) 
Seat 5: Gari Nerskiy ($22.70 in chips) 
Seat 6: Quatrehuith ($16.70 in chips) 
Quatrehuith: posts small blind $0.05
Viten'kA83: is sitting out 
BestAger: posts big blind $0.10
*** HOLE CARDS ***
Viten'kA83 leaves the table
ivan2772ms joins the table at seat #2 
omithos: raises $0.20 to $0.30
Gari Nerskiy: folds 
Quatrehuith: folds 
BestAger: calls $0.20
*** FLOP *** [9h 3h 5d]
BestAger: checks 
omithos: checks 
*** TURN *** [9h 3h 5d] [Ad]
BestAger: checks 
omithos: bets $0.30
BestAger: calls $0.30
*** RIVER *** [9h 3h 5d Ad] [9s]
BestAger: checks 
omithos: checks 
*** SHOW DOWN ***
BestAger: shows [6d 8h] (a pair of Nines)
omithos: shows [2c 2d] (two pair, Nines and Deuces)
omithos collected $1.19 from pot
*** SUMMARY ***
Total pot $1.25 | Rake $0.06 
Board [9h 3h 5d Ad 9s]
Seat 3: BestAger (big blind) showed [6d 8h] and lost with a pair of Nines
Seat 4: omithos showed [2c 2d] and won ($1.19) with two pair, Nines and Deuces
Seat 5: Gari Nerskiy (button) folded before Flop (didn't bet)
Seat 6: Quatrehuith (small blind) folded before Flop



PokerStars Hand #222951464764:  Hold'em No Limit ($0.05/$0.10 USD) - 2021/01/23 7:01:17 ET
Table 'Saito II' 6-max Seat #6 is the button
Seat 3: BestAger ($14.81 in chips) 
Seat 4: omithos ($12.63 in chips) 
Seat 5: Gari Nerskiy ($22.70 in chips) 
Seat 6: Quatrehuith ($16.65 in chips) 
BestAger: posts small blind $0.05
omithos: posts big blind $0.10
*** HOLE CARDS ***
Gari Nerskiy: folds 
Quatrehuith: folds 
BestAger: raises $0.20 to $0.30
omithos: folds 
Uncalled bet ($0.20) returned to BestAger
BestAger collected $0.20 from pot
BestAger: doesn't show hand 
*** SUMMARY ***
Total pot $0.20 | Rake $0 
Seat 3: BestAger (small blind) collected ($0.20)
Seat 4: omithos (big blind) folded before Flop
Seat 5: Gari Nerskiy folded before Flop (didn't bet)
Seat 6: Quatrehuith (button) folded before Flop (didn't bet)



PokerStars Hand #222951469235:  Hold'em No Limit ($0.05/$0.10 USD) - 2021/01/23 7:01:30 ET
Table 'Saito II' 6-max Seat #3 is the button
Seat 3: BestAger ($14.91 in chips) 
Seat 4: omithos ($12.53 in chips) 
Seat 5: Gari Nerskiy ($22.70 in chips) 
Seat 6: Quatrehuith ($16.65 in chips) 
omithos: posts small blind $0.05
Gari Nerskiy: posts big blind $0.10
ivan2772ms: sits out 
*** HOLE CARDS ***
Quatrehuith: folds 
BestAger: folds 
omithos: raises $0.20 to $0.30
Gari Nerskiy: calls $0.20
*** FLOP *** [As Kh 6c]
omithos: bets $0.30
Gari Nerskiy: calls $0.30
*** TURN *** [As Kh 6c] [8d]
omithos: checks 
Gari Nerskiy: checks 
*** RIVER *** [As Kh 6c 8d] [2c]
omithos: checks 
Gari Nerskiy: checks 
*** SHOW DOWN ***
omithos: shows [Ks 9s] (a pair of Kings)
Gari Nerskiy: mucks hand 
omithos collected $1.15 from pot
*** SUMMARY ***
Total pot $1.20 | Rake $0.05 
Board [As Kh 6c 8d 2c]
Seat 3: BestAger (button) folded before Flop (didn't bet)
Seat 4: omithos (small blind) showed [Ks 9s] and won ($1.15) with a pair of Kings
Seat 5: Gari Nerskiy (big blind) mucked
Seat 6: Quatrehuith folded before Flop (didn't bet)



PokerStars Hand #222951482603:  Hold'em No Limit ($0.05/$0.10 USD) - 2021/01/23 7:02:08 ET
Table 'Saito II' 6-max Seat #4 is the button
Seat 3: BestAger ($14.91 in chips) 
Seat 4: omithos ($13.08 in chips) 
Seat 5: Gari Nerskiy ($22.10 in chips) 
Seat 6: Quatrehuith ($16.65 in chips) 
Gari Nerskiy: posts small blind $0.05
Quatrehuith: posts big blind $0.10
ivan2772ms: sits out 
*** HOLE CARDS ***
BestAger: folds 
omithos: folds 
Gari Nerskiy: folds 
Uncalled bet ($0.05) returned to Quatrehuith
Quatrehuith collected $0.10 from pot
Quatrehuith: doesn't show hand 
*** SUMMARY ***
Total pot $0.10 | Rake $0 
Seat 3: BestAger folded before Flop (didn't bet)
Seat 4: omithos (button) folded before Flop (didn't bet)
Seat 5: Gari Nerskiy (small blind) folded before Flop
Seat 6: Quatrehuith (big blind) collected ($0.10)



PokerStars Hand #222951486576:  Hold'em No Limit ($0.05/$0.10 USD) - 2021/01/23 7:02:20 ET
Table 'Saito II' 6-max Seat #5 is the button
Seat 2: ivan2772ms ($10 in chips) 
Seat 3: BestAger ($14.91 in chips) 
Seat 4: omithos ($13.08 in chips) 
Seat 5: Gari Nerskiy ($22.05 in chips) 
Seat 6: Quatrehuith ($16.70 in chips) 
Quatrehuith: posts small blind $0.05
ivan2772ms: posts big blind $0.10
*** HOLE CARDS ***
BestAger: folds 
omithos: folds 
Gari Nerskiy: folds 
Quatrehuith: raises $0.20 to $0.30
ivan2772ms: calls $0.20
*** FLOP *** [5h Kc Qs]
Quatrehuith: bets $0.22
ivan2772ms: folds 
Uncalled bet ($0.22) returned to Quatrehuith
Quatrehuith collected $0.57 from pot
Quatrehuith: doesn't show hand 
*** SUMMARY ***
Total pot $0.60 | Rake $0.03 
Board [5h Kc Qs]
Seat 2: ivan2772ms (big blind) folded on the Flop
Seat 3: BestAger folded before Flop (didn't bet)
Seat 4: omithos folded before Flop (didn't bet)
Seat 5: Gari Nerskiy (button) folded before Flop (didn't bet)
Seat 6: Quatrehuith (small blind) collected ($0.57)



PokerStars Hand #222951493823:  Hold'em No Limit ($0.05/$0.10 USD) - 2021/01/23 7:02:40 ET
Table 'Saito II' 6-max Seat #6 is the button
Seat 2: ivan2772ms ($10 in chips) 
Seat 3: BestAger ($14.91 in chips) 
Seat 4: omithos ($13.08 in chips) 
Seat 5: Gari Nerskiy ($22.05 in chips) 
Seat 6: Quatrehuith ($16.97 in chips) 
ivan2772ms: posts small blind $0.05
BestAger: posts big blind $0.10
*** HOLE CARDS ***
omithos: folds 
Gari Nerskiy: raises $0.15 to $0.25
Quatrehuith: folds 
ivan2772ms: folds 
BestAger: folds 
Uncalled bet ($0.15) returned to Gari Nerskiy
Gari Nerskiy collected $0.25 from pot
Gari Nerskiy: doesn't show hand 
*** SUMMARY ***
Total pot $0.25 | Rake $0 
Seat 2: ivan2772ms (small blind) folded before Flop
Seat 3: BestAger (big blind) folded before Flop
Seat 4: omithos folded before Flop (didn't bet)
Seat 5: Gari Nerskiy collected ($0.25)
Seat 6: Quatrehuith (button) folded before Flop (didn't bet)



PokerStars Hand #222951498876:  Hold'em No Limit ($0.05/$0.10 USD) - 2021/01/23 7:02:55 ET
Table 'Saito II' 6-max Seat #2 is the button
Seat 2: ivan2772ms ($9.95 in chips) 
Seat 3: BestAger ($14.81 in chips) 
Seat 4: omithos ($13.08 in chips) 
Seat 5: Gari Nerskiy ($22.20 in chips) 
Seat 6: Quatrehuith ($16.97 in chips) 
BestAger: posts small blind $0.05
omithos: posts big blind $0.10
*** HOLE CARDS ***
Gari Nerskiy: folds 
Quatrehuith: raises $0.15 to $0.25
ivan2772ms: folds 
BestAger: calls $0.20
omithos: calls $0.15
*** FLOP *** [Jc 9s 7s]
BestAger: bets $0.30
omithos: calls $0.30
Quatrehuith: folds 
*** TURN *** [Jc 9s 7s] [5c]
BestAger: bets $0.50
omithos: calls $0.50
*** RIVER *** [Jc 9s 7s 5c] [6s]
BestAger: bets $0.90
omithos: raises $3.15 to $4.05
BestAger: folds 
Uncalled bet ($3.15) returned to omithos
omithos collected $3.96 from pot
omithos: doesn't show hand 
*** SUMMARY ***
Total pot $4.15 | Rake $0.19 
Board [Jc 9s 7s 5c 6s]
Seat 2: ivan2772ms (button) folded before Flop (didn't bet)
Seat 3: BestAger (small blind) folded on the River
Seat 4: omithos (big blind) collected ($3.96)
Seat 5: Gari Nerskiy folded before Flop (didn't bet)
Seat 6: Quatrehuith folded on the Flop



PokerStars Hand #222951523820:  Hold'em No Limit ($0.05/$0.10 USD) - 2021/01/23 7:04:04 ET
Table 'Saito II' 6-max Seat #3 is the button
Seat 2: ivan2772ms ($9.95 in chips) 
Seat 3: BestAger ($12.86 in chips) 
Seat 4: omithos ($15.09 in chips) 
Seat 5: Gari Nerskiy ($22.20 in chips) 
Seat 6: Quatrehuith ($16.72 in chips) 
omithos: posts small blind $0.05
Gari Nerskiy: posts big blind $0.10
*** HOLE CARDS ***
Quatrehuith: folds 
ivan2772ms: folds 
BestAger: raises $0.10 to $0.20
omithos: folds 
Gari Nerskiy: calls $0.10
*** FLOP *** [3h 6d 3c]
Gari Nerskiy: checks 
BestAger: checks 
*** TURN *** [3h 6d 3c] [Jh]
Gari Nerskiy: checks 
BestAger: checks 
*** RIVER *** [3h 6d 3c Jh] [Qh]
Gari Nerskiy: checks 
BestAger: checks 
*** SHOW DOWN ***
Gari Nerskiy: shows [4h As] (a pair of Threes)
BestAger: mucks hand 
Gari Nerskiy collected $0.43 from pot
*** SUMMARY ***
Total pot $0.45 | Rake $0.02 
Board [3h 6d 3c Jh Qh]
Seat 2: ivan2772ms folded before Flop (didn't bet)
Seat 3: BestAger (button) mucked
Seat 4: omithos (small blind) folded before Flop
Seat 5: Gari Nerskiy (big blind) showed [4h As] and won ($0.43) with a pair of Threes
Seat 6: Quatrehuith folded before Flop (didn't bet)



PokerStars Hand #222951533056:  Hold'em No Limit ($0.05/$0.10 USD) - 2021/01/23 7:04:30 ET
Table 'Saito II' 6-max Seat #4 is the button
Seat 2: ivan2772ms ($9.95 in chips) 
Seat 3: BestAger ($12.66 in chips) 
Seat 4: omithos ($15.04 in chips) 
Seat 5: Gari Nerskiy ($22.43 in chips) 
Seat 6: Quatrehuith ($16.72 in chips) 
Gari Nerskiy: posts small blind $0.05
Quatrehuith: posts big blind $0.10
*** HOLE CARDS ***
ivan2772ms: folds 
BestAger: raises $0.10 to $0.20
omithos: raises $0.40 to $0.60
Gari Nerskiy: folds 
Quatrehuith: raises $1.60 to $2.20
BestAger: folds 
omithos: calls $1.60
*** FLOP *** [7c Kh 5h]
Quatrehuith: bets $1.10
omithos: calls $1.10
*** TURN *** [7c Kh 5h] [2s]
Quatrehuith: bets $3.90
omithos: folds 
Uncalled bet ($3.90) returned to Quatrehuith
Quatrehuith collected $6.54 from pot
Quatrehuith: doesn't show hand 
*** SUMMARY ***
Total pot $6.85 | Rake $0.31 
Board [7c Kh 5h 2s]
Seat 2: ivan2772ms folded before Flop (didn't bet)
Seat 3: BestAger folded before Flop
Seat 4: omithos (button) folded on the Turn
Seat 5: Gari Nerskiy (small blind) folded before Flop
Seat 6: Quatrehuith (big blind) collected ($6.54)



PokerStars Hand #222951558213:  Hold'em No Limit ($0.05/$0.10 USD) - 2021/01/23 7:05:41 ET
Table 'Saito II' 6-max Seat #5 is the button
Seat 1: benlondon148 ($13.32 in chips) 
Seat 3: BestAger ($12.46 in chips) 
Seat 4: omithos ($11.74 in chips) 
Seat 5: Gari Nerskiy ($22.38 in chips) 
Seat 6: Quatrehuith ($19.96 in chips) 
Quatrehuith: posts small blind $0.05
benlondon148: posts big blind $0.10
*** HOLE CARDS ***
BestAger: folds 
omithos: folds 
Gari Nerskiy: raises $0.10 to $0.20
Quatrehuith: folds 
benlondon148: calls $0.10
*** FLOP *** [Tc 8h Kc]
benlondon148: checks 
Gari Nerskiy: checks 
*** TURN *** [Tc 8h Kc] [4d]
benlondon148: checks 
Gari Nerskiy: checks 
*** RIVER *** [Tc 8h Kc 4d] [7s]
benlondon148: bets $2
Gari Nerskiy: folds 
Uncalled bet ($2) returned to benlondon148
benlondon148 collected $0.43 from pot
benlondon148: doesn't show hand 
*** SUMMARY ***
Total pot $0.45 | Rake $0.02 
Board [Tc 8h Kc 4d 7s]
Seat 1: benlondon148 (big blind) collected ($0.43)
Seat 3: BestAger folded before Flop (didn't bet)
Seat 4: omithos folded before Flop (didn't bet)
Seat 5: Gari Nerskiy (button) folded on the River
Seat 6: Quatrehuith (small blind) folded before Flop



PokerStars Hand #222951575040:  Hold'em No Limit ($0.05/$0.10 USD) - 2021/01/23 7:06:28 ET
Table 'Saito II' 6-max Seat #6 is the button
Seat 1: benlondon148 ($13.55 in chips) 
Seat 3: BestAger ($12.46 in chips) 
Seat 4: omithos ($11.74 in chips) 
Seat 5: Gari Nerskiy ($22.18 in chips) 
Seat 6: Quatrehuith ($19.91 in chips) 
benlondon148: posts small blind $0.05
BestAger: posts big blind $0.10
*** HOLE CARDS ***
omithos: folds 
Gari Nerskiy: folds 
Quatrehuith: folds 
benlondon148: calls $0.05
BestAger: checks 
*** FLOP *** [2h 7s Js]
benlondon148: bets $0.10
BestAger: folds 
Uncalled bet ($0.10) returned to benlondon148
benlondon148 collected $0.19 from pot
benlondon148: doesn't show hand 
*** SUMMARY ***
Total pot $0.20 | Rake $0.01 
Board [2h 7s Js]
Seat 1: benlondon148 (small blind) collected ($0.19)
Seat 3: BestAger (big blind) folded on the Flop
Seat 4: omithos folded before Flop (didn't bet)
Seat 5: Gari Nerskiy folded before Flop (didn't bet)
Seat 6: Quatrehuith (button) folded before Flop (didn't bet)



PokerStars Hand #222951580812:  Hold'em No Limit ($0.05/$0.10 USD) - 2021/01/23 7:06:44 ET
Table 'Saito II' 6-max Seat #1 is the button
Seat 1: benlondon148 ($13.64 in chips) 
Seat 3: BestAger ($12.36 in chips) 
Seat 6: Quatrehuith ($19.91 in chips) 
BestAger: posts small blind $0.05
omithos: is sitting out 
Quatrehuith: posts big blind $0.10
*** HOLE CARDS ***
benlondon148: calls $0.10
BestAger: raises $0.20 to $0.30
omithos leaves the table
Quatrehuith: folds 
benlondon148: calls $0.20
*** FLOP *** [9h Qd 7c]
BestAger: bets $0.30
benlondon148: folds 
Uncalled bet ($0.30) returned to BestAger
BestAger collected $0.67 from pot
BestAger: doesn't show hand 
*** SUMMARY ***
Total pot $0.70 | Rake $0.03 
Board [9h Qd 7c]
Seat 1: benlondon148 (button) folded on the Flop
Seat 3: BestAger (small blind) collected ($0.67)
Seat 6: Quatrehuith (big blind) folded before Flop



PokerStars Hand #222951589528:  Hold'em No Limit ($0.05/$0.10 USD) - 2021/01/23 7:07:08 ET
Table 'Saito II' 6-max Seat #3 is the button
Seat 1: benlondon148 ($13.34 in chips) 
Seat 3: BestAger ($12.73 in chips) 
Seat 6: Quatrehuith ($19.81 in chips) 
Quatrehuith: posts small blind $0.05
benlondon148: posts big blind $0.10
*** HOLE CARDS ***
BestAger: raises $0.20 to $0.30
Quatrehuith: folds 
benlondon148: folds 
Uncalled bet ($0.20) returned to BestAger
BestAger collected $0.25 from pot
BestAger: doesn't show hand 
*** SUMMARY ***
Total pot $0.25 | Rake $0 
Seat 1: benlondon148 (big blind) folded before Flop
Seat 3: BestAger (button) collected ($0.25)
Seat 6: Quatrehuith (small blind) folded before Flop



PokerStars Hand #222951593103:  Hold'em No Limit ($0.05/$0.10 USD) - 2021/01/23 7:07:18 ET
Table 'Saito II' 6-max Seat #1 is the button
Seat 1: benlondon148 ($13.24 in chips) 
Seat 3: BestAger ($12.88 in chips) 
benlondon148: posts small blind $0.05
BestAger: posts big blind $0.10
*** HOLE CARDS ***
Quatrehuith leaves the table
benlondon148: folds 
Uncalled bet ($0.05) returned to BestAger
BestAger collected $0.10 from pot
BestAger: doesn't show hand 
*** SUMMARY ***
Total pot $0.10 | Rake $0 
Seat 1: benlondon148 (button) (small blind) folded before Flop
Seat 3: BestAger (big blind) collected ($0.10)



PokerStars Hand #222951594936:  Hold'em No Limit ($0.05/$0.10 USD) - 2021/01/23 7:07:23 ET
Table 'Saito II' 6-max Seat #3 is the button
Seat 1: benlondon148 ($13.19 in chips) 
Seat 3: BestAger ($12.93 in chips) 
BestAger: posts small blind $0.05
benlondon148: posts big blind $0.10
*** HOLE CARDS ***
Quatrehuith joins the table at seat #4 
BestAger: raises $0.20 to $0.30
benlondon148: calls $0.20
*** FLOP *** [2c 2s Kd]
benlondon148: checks 
BestAger: checks 
*** TURN *** [2c 2s Kd] [7h]
benlondon148: checks 
BestAger: bets $0.20
benlondon148: folds 
Uncalled bet ($0.20) returned to BestAger
BestAger collected $0.57 from pot
BestAger: doesn't show hand 
*** SUMMARY ***
Total pot $0.60 | Rake $0.03 
Board [2c 2s Kd 7h]
Seat 1: benlondon148 (big blind) folded on the Turn
Seat 3: BestAger (button) (small blind) collected ($0.57)



PokerStars Hand #222951603141:  Hold'em No Limit ($0.05/$0.10 USD) - 2021/01/23 7:07:46 ET
Table 'Saito II' 6-max Seat #1 is the button
Seat 1: benlondon148 ($12.89 in chips) 
Seat 3: BestAger ($13.20 in chips) 
Seat 4: Quatrehuith ($19.76 in chips) 
BestAger: posts small blind $0.05
Quatrehuith: posts big blind $0.10
*** HOLE CARDS ***
benlondon148: calls $0.10
BestAger: raises $0.90 to $1
Quatrehuith: folds 
benlondon148: folds 
Uncalled bet ($0.90) returned to BestAger
BestAger collected $0.30 from pot
BestAger: doesn't show hand 
*** SUMMARY ***
Total pot $0.30 | Rake $0 
Seat 1: benlondon148 (button) folded before Flop
Seat 3: BestAger (small blind) collected ($0.30)
Seat 4: Quatrehuith (big blind) folded before Flop



PokerStars Hand #222951609397:  Hold'em No Limit ($0.05/$0.10 USD) - 2021/01/23 7:08:04 ET
Table 'Saito II' 6-max Seat #3 is the button
Seat 1: benlondon148 ($12.79 in chips) 
Seat 3: BestAger ($13.40 in chips) 
Seat 4: Quatrehuith ($19.66 in chips) 
Quatrehuith: posts small blind $0.05
benlondon148: posts big blind $0.10
ivan2772ms: sits out 
*** HOLE CARDS ***
BestAger: folds 
BestAger leaves the table
Quatrehuith: raises $0.20 to $0.30
benlondon148: folds 
Uncalled bet ($0.20) returned to Quatrehuith
Quatrehuith collected $0.20 from pot
Quatrehuith: doesn't show hand 
*** SUMMARY ***
Total pot $0.20 | Rake $0 
Seat 1: benlondon148 (big blind) folded before Flop
Seat 3: BestAger (button) folded before Flop (didn't bet)
Seat 4: Quatrehuith (small blind) collected ($0.20)



PokerStars Hand #222951612983:  Hold'em No Limit ($0.05/$0.10 USD) - 2021/01/23 7:08:14 ET
Table 'Saito II' 6-max Seat #4 is the button
Seat 1: benlondon148 ($12.69 in chips) 
Seat 2: ivan2772ms ($9.95 in chips) 
Seat 4: Quatrehuith ($19.76 in chips) 
benlondon148: posts small blind $0.05
Mrburns.daoc joins the table at seat #6 
ivan2772ms: posts big blind $0.10
*** HOLE CARDS ***
Quatrehuith: raises $0.15 to $0.25
benlondon148: folds 
ivan2772ms: folds 
Uncalled bet ($0.15) returned to Quatrehuith
Quatrehuith collected $0.25 from pot
Quatrehuith: doesn't show hand 
*** SUMMARY ***
Total pot $0.25 | Rake $0 
Seat 1: benlondon148 (small blind) folded before Flop
Seat 2: ivan2772ms (big blind) folded before Flop
Seat 4: Quatrehuith (button) collected ($0.25)



PokerStars Hand #222951617173:  Hold'em No Limit ($0.05/$0.10 USD) - 2021/01/23 7:08:25 ET
Table 'Saito II' 6-max Seat #1 is the button
Seat 1: benlondon148 ($12.64 in chips) 
Seat 2: ivan2772ms ($9.85 in chips) 
Seat 4: Quatrehuith ($19.91 in chips) 
ivan2772ms: posts small blind $0.05
Quatrehuith: posts big blind $0.10
Mrburns.daoc: sits out 
*** HOLE CARDS ***
guro aye1234 joins the table at seat #3 
benlondon148 has timed out
benlondon148: folds 
ivan2772ms: folds 
Uncalled bet ($0.05) returned to Quatrehuith
Quatrehuith collected $0.10 from pot
Quatrehuith: doesn't show hand 
*** SUMMARY ***
Total pot $0.10 | Rake $0 
Seat 1: benlondon148 (button) folded before Flop (didn't bet)
Seat 2: ivan2772ms (small blind) folded before Flop
Seat 4: Quatrehuith (big blind) collected ($0.10)



PokerStars Hand #222951622938:  Hold'em No Limit ($0.05/$0.10 USD) - 2021/01/23 7:08:41 ET
Table 'Saito II' 6-max Seat #2 is the button
Seat 2: ivan2772ms ($9.80 in chips) 
Seat 4: Quatrehuith ($19.96 in chips) 
Seat 6: Mrburns.daoc ($10 in chips) 
Quatrehuith: posts small blind $0.05
Mrburns.daoc: posts big blind $0.10
*** HOLE CARDS ***
ivan2772ms: raises $0.15 to $0.25
Quatrehuith: folds 
Mrburns.daoc: calls $0.15
*** FLOP *** [8c 5c 7h]
Mrburns.daoc: checks 
ivan2772ms: bets $0.16
Mrburns.daoc: folds 
Uncalled bet ($0.16) returned to ivan2772ms
ivan2772ms collected $0.53 from pot
Gari Nerskiy was removed from the table for failing to post
Gari Nerskiy leaves the table
ivan2772ms: doesn't show hand 
*** SUMMARY ***
Total pot $0.55 | Rake $0.02 
Board [8c 5c 7h]
Seat 2: ivan2772ms (button) collected ($0.53)
Seat 4: Quatrehuith (small blind) folded before Flop
Seat 6: Mrburns.daoc (big blind) folded on the Flop



PokerStars Hand #222951638129:  Hold'em No Limit ($0.05/$0.10 USD) - 2021/01/23 7:09:23 ET
Table 'Saito II' 6-max Seat #4 is the button
Seat 1: benlondon148 ($12.64 in chips) 
Seat 2: ivan2772ms ($10.08 in chips) 
Seat 4: Quatrehuith ($19.91 in chips) 
Seat 6: Mrburns.daoc ($10 in chips) 
Mrburns.daoc: posts small blind $0.05
Kostin_SS joins the table at seat #5 
benlondon148: posts big blind $0.10
guro aye1234: sits out 
*** HOLE CARDS ***
ivan2772ms: folds 
Quatrehuith: folds 
Mrburns.daoc: raises $0.24 to $0.34
benlondon148: folds 
Uncalled bet ($0.24) returned to Mrburns.daoc
Mrburns.daoc collected $0.20 from pot
Mrburns.daoc: doesn't show hand 
*** SUMMARY ***
Total pot $0.20 | Rake $0 
Seat 1: benlondon148 (big blind) folded before Flop
Seat 2: ivan2772ms folded before Flop (didn't bet)
Seat 4: Quatrehuith (button) folded before Flop (didn't bet)
Seat 6: Mrburns.daoc (small blind) collected ($0.20)



PokerStars Hand #222951648567:  Hold'em No Limit ($0.05/$0.10 USD) - 2021/01/23 7:09:52 ET
Table 'Saito II' 6-max Seat #6 is the button
Seat 1: benlondon148 ($12.54 in chips) 
Seat 3: guro aye1234 ($10 in chips) 
Seat 4: Quatrehuith ($19.91 in chips) 
Seat 6: Mrburns.daoc ($10.10 in chips) 
benlondon148: posts small blind $0.05
ivan2772ms: is sitting out 
guro aye1234: posts big blind $0.10
Kostin_SS: sits out 
*** HOLE CARDS ***
Quatrehuith: folds 
Mrburns.daoc: folds 
benlondon148: calls $0.05
guro aye1234: raises $0.30 to $0.40
benlondon148: calls $0.30
*** FLOP *** [2h 5s Jc]
benlondon148: checks 
guro aye1234: bets $0.50
benlondon148: raises $0.50 to $1
ivan2772ms leaves the table
guro aye1234: folds 
Uncalled bet ($0.50) returned to benlondon148
benlondon148 collected $1.72 from pot
benlondon148: doesn't show hand 
*** SUMMARY ***
Total pot $1.80 | Rake $0.08 
Board [2h 5s Jc]
Seat 1: benlondon148 (small blind) collected ($1.72)
Seat 3: guro aye1234 (big blind) folded on the Flop
Seat 4: Quatrehuith folded before Flop (didn't bet)
Seat 6: Mrburns.daoc (button) folded before Flop (didn't bet)



PokerStars Hand #222951665377:  Hold'em No Limit ($0.05/$0.10 USD) - 2021/01/23 7:10:39 ET
Table 'Saito II' 6-max Seat #1 is the button
Seat 1: benlondon148 ($13.36 in chips) 
Seat 3: guro aye1234 ($10 in chips) 
Seat 4: Quatrehuith ($19.91 in chips) 
Seat 6: Mrburns.daoc ($10.10 in chips) 
guro aye1234: posts small blind $0.05
Quatrehuith: posts big blind $0.10
Kostin_SS: sits out 
*** HOLE CARDS ***
ivan2772ms joins the table at seat #2 
Mrburns.daoc: folds 
benlondon148: folds 
ivan2772ms leaves the table
guro aye1234: raises $0.15 to $0.25
DalilaQ joins the table at seat #2 
Quatrehuith: folds 
Uncalled bet ($0.15) returned to guro aye1234
guro aye1234 collected $0.20 from pot
*** SUMMARY ***
Total pot $0.20 | Rake $0 
Seat 1: benlondon148 (button) folded before Flop (didn't bet)
Seat 3: guro aye1234 (small blind) collected ($0.20)
Seat 4: Quatrehuith (big blind) folded before Flop
Seat 6: Mrburns.daoc folded before Flop (didn't bet)



PokerStars Hand #222951669994:  Hold'em No Limit ($0.05/$0.10 USD) - 2021/01/23 7:10:51 ET
Table 'Saito II' 6-max Seat #3 is the button
Seat 1: benlondon148 ($13.36 in chips) 
Seat 3: guro aye1234 ($10.10 in chips) 
Seat 4: Quatrehuith ($19.81 in chips) 
Seat 5: Kostin_SS ($10 in chips) 
Seat 6: Mrburns.daoc ($10.10 in chips) 
Quatrehuith: posts small blind $0.05
Kostin_SS: posts big blind $0.10
DalilaQ: sits out 
*** HOLE CARDS ***
Mrburns.daoc: folds 
benlondon148: calls $0.10
guro aye1234: raises $0.30 to $0.40
Quatrehuith: folds 
Kostin_SS: folds 
benlondon148: calls $0.30
*** FLOP *** [7c 8d Ah]
benlondon148: bets $1.70
guro aye1234: folds 
Uncalled bet ($1.70) returned to benlondon148
benlondon148 collected $0.91 from pot
benlondon148: doesn't show hand 
*** SUMMARY ***
Total pot $0.95 | Rake $0.04 
Board [7c 8d Ah]
Seat 1: benlondon148 collected ($0.91)
Seat 3: guro aye1234 (button) folded on the Flop
Seat 4: Quatrehuith (small blind) folded before Flop
Seat 5: Kostin_SS (big blind) folded before Flop
Seat 6: Mrburns.daoc folded before Flop (didn't bet)



PokerStars Hand #222951686141:  Hold'em No Limit ($0.05/$0.10 USD) - 2021/01/23 7:11:35 ET
Table 'Saito II' 6-max Seat #4 is the button
Seat 1: benlondon148 ($13.87 in chips) 
Seat 3: guro aye1234 ($10 in chips) 
Seat 4: Quatrehuith ($19.76 in chips) 
Seat 5: Kostin_SS ($10 in chips) 
Seat 6: Mrburns.daoc ($10.10 in chips) 
Kostin_SS: posts small blind $0.05
Mrburns.daoc: posts big blind $0.10
DalilaQ: sits out 
*** HOLE CARDS ***
benlondon148: raises $0.10 to $0.20
guro aye1234: folds 
Quatrehuith: folds 
Kostin_SS: folds 
Mrburns.daoc: folds 
Uncalled bet ($0.10) returned to benlondon148
benlondon148 collected $0.25 from pot
benlondon148: doesn't show hand 
*** SUMMARY ***
Total pot $0.25 | Rake $0 
Seat 1: benlondon148 collected ($0.25)
Seat 3: guro aye1234 folded before Flop (didn't bet)
Seat 4: Quatrehuith (button) folded before Flop (didn't bet)
Seat 5: Kostin_SS (small blind) folded before Flop
Seat 6: Mrburns.daoc (big blind) folded before Flop



PokerStars Hand #222951689871:  Hold'em No Limit ($0.05/$0.10 USD) - 2021/01/23 7:11:45 ET
Table 'Saito II' 6-max Seat #5 is the button
Seat 1: benlondon148 ($14.02 in chips) 
Seat 3: guro aye1234 ($10 in chips) 
Seat 4: Quatrehuith ($19.76 in chips) 
Seat 5: Kostin_SS ($10 in chips) 
Seat 6: Mrburns.daoc ($10 in chips) 
Mrburns.daoc: posts small blind $0.05
benlondon148: posts big blind $0.10
DalilaQ: sits out 
*** HOLE CARDS ***
guro aye1234: folds 
Quatrehuith: folds 
Kostin_SS: raises $0.20 to $0.30
Mrburns.daoc: folds 
benlondon148: folds 
Uncalled bet ($0.20) returned to Kostin_SS
Kostin_SS collected $0.25 from pot
Kostin_SS: doesn't show hand 
*** SUMMARY ***
Total pot $0.25 | Rake $0 
Seat 1: benlondon148 (big blind) folded before Flop
Seat 3: guro aye1234 folded before Flop (didn't bet)
Seat 4: Quatrehuith folded before Flop (didn't bet)
Seat 5: Kostin_SS (button) collected ($0.25)
Seat 6: Mrburns.daoc (small blind) folded before Flop



PokerStars Hand #222951696251:  Hold'em No Limit ($0.05/$0.10 USD) - 2021/01/23 7:12:03 ET
Table 'Saito II' 6-max Seat #6 is the button
Seat 1: benlondon148 ($13.92 in chips) 
Seat 2: DalilaQ ($10 in chips) 
Seat 3: guro aye1234 ($10 in chips) 
Seat 4: Quatrehuith ($19.76 in chips) 
Seat 5: Kostin_SS ($10.15 in chips) 
Seat 6: Mrburns.daoc ($10 in chips) 
benlondon148: posts small blind $0.05
DalilaQ: posts big blind $0.10
*** HOLE CARDS ***
guro aye1234: folds 
Quatrehuith: folds 
Kostin_SS: folds 
Mrburns.daoc: raises $0.19 to $0.29
benlondon148: folds 
DalilaQ: folds 
Uncalled bet ($0.19) returned to Mrburns.daoc
Mrburns.daoc collected $0.25 from pot
Mrburns.daoc: doesn't show hand 
*** SUMMARY ***
Total pot $0.25 | Rake $0 
Seat 1: benlondon148 (small blind) folded before Flop
Seat 2: DalilaQ (big blind) folded before Flop
Seat 3: guro aye1234 folded before Flop (didn't bet)
Seat 4: Quatrehuith folded before Flop (didn't bet)
Seat 5: Kostin_SS folded before Flop (didn't bet)
Seat 6: Mrburns.daoc (button) collected ($0.25)



PokerStars Hand #222951770193:  Hold'em No Limit ($0.05/$0.10 USD) - 2021/01/23 7:15:00 ET
Table 'Saito II' 6-max Seat #5 is the button
Seat 1: toby602 ($10 in chips) 
Seat 2: DalilaQ ($9.85 in chips) 
Seat 3: guro aye1234 ($10 in chips) 
Seat 4: Quatrehuith ($16.86 in chips) 
Seat 5: Kostin_SS ($13.03 in chips) 
Seat 6: Mrburns.daoc ($10.05 in chips) 
Mrburns.daoc: posts small blind $0.05
toby602: posts big blind $0.10
*** HOLE CARDS ***
DalilaQ: folds 
guro aye1234: folds 
Quatrehuith: folds 
DalilaQ leaves the table
Kostin_SS: raises $0.20 to $0.30
Quatrehuith leaves the table
Mrburns.daoc: raises $0.90 to $1.20
toby602: raises $1.30 to $2.50
Kostin_SS: folds 
Mrburns.daoc: folds 
Uncalled bet ($1.30) returned to toby602
toby602 collected $2.70 from pot
toby602: doesn't show hand 
Last_Warr1or joins the table at seat #2 
*** SUMMARY ***
Total pot $2.70 | Rake $0 
Seat 1: toby602 (big blind) collected ($2.70)
Seat 2: DalilaQ folded before Flop (didn't bet)
Seat 3: guro aye1234 folded before Flop (didn't bet)
Seat 4: Quatrehuith folded before Flop (didn't bet)
Seat 5: Kostin_SS (button) folded before Flop
Seat 6: Mrburns.daoc (small blind) folded before Flop



PokerStars Hand #222951787307:  Hold'em No Limit ($0.05/$0.10 USD) - 2021/01/23 7:15:47 ET
Table 'Saito II' 6-max Seat #6 is the button
Seat 1: toby602 ($11.50 in chips) 
Seat 2: Last_Warr1or ($10 in chips) 
Seat 3: guro aye1234 ($10 in chips) 
Seat 5: Kostin_SS ($12.73 in chips) 
Seat 6: Mrburns.daoc ($10 in chips) 
toby602: posts small blind $0.05
Last_Warr1or: posts big blind $0.10
*** HOLE CARDS ***
guro aye1234: folds 
Kostin_SS: folds 
Mrburns.daoc: raises $0.19 to $0.29
toby602: folds 
Last_Warr1or: calls $0.19
*** FLOP *** [3h 9c 5s]
Last_Warr1or: checks 
Mrburns.daoc: checks 
*** TURN *** [3h 9c 5s] [Js]
Last_Warr1or: bets $0.30
Mrburns.daoc: folds 
Uncalled bet ($0.30) returned to Last_Warr1or
Last_Warr1or collected $0.60 from pot
*** SUMMARY ***
Total pot $0.63 | Rake $0.03 
Board [3h 9c 5s Js]
Seat 1: toby602 (small blind) folded before Flop
Seat 2: Last_Warr1or (big blind) collected ($0.60)
Seat 3: guro aye1234 folded before Flop (didn't bet)
Seat 5: Kostin_SS folded before Flop (didn't bet)
Seat 6: Mrburns.daoc (button) folded on the Turn



PokerStars Hand #222951809220:  Hold'em No Limit ($0.05/$0.10 USD) - 2021/01/23 7:16:47 ET
Table 'Saito II' 6-max Seat #1 is the button
Seat 1: toby602 ($11.45 in chips) 
Seat 2: Last_Warr1or ($10.31 in chips) 
Seat 3: guro aye1234 ($10 in chips) 
Seat 5: Kostin_SS ($12.73 in chips) 
Seat 6: Mrburns.daoc ($10 in chips) 
Last_Warr1or: posts small blind $0.05
guro aye1234: posts big blind $0.10
*** HOLE CARDS ***
Kostin_SS: raises $0.12 to $0.22
Mrburns.daoc: folds 
toby602: folds 
Last_Warr1or: raises $0.78 to $1
guro aye1234: folds 
Kostin_SS: calls $0.78
*** FLOP *** [Jh Ah As]
Last_Warr1or: checks 
Kostin_SS: checks 
*** TURN *** [Jh Ah As] [Ts]
Last_Warr1or: bets $1.01
Kostin_SS: folds 
Uncalled bet ($1.01) returned to Last_Warr1or
Last_Warr1or collected $2.01 from pot
*** SUMMARY ***
Total pot $2.10 | Rake $0.09 
Board [Jh Ah As Ts]
Seat 1: toby602 (button) folded before Flop (didn't bet)
Seat 2: Last_Warr1or (small blind) collected ($2.01)
Seat 3: guro aye1234 (big blind) folded before Flop
Seat 5: Kostin_SS folded on the Turn
Seat 6: Mrburns.daoc folded before Flop (didn't bet)



PokerStars Hand #222951830408:  Hold'em No Limit ($0.05/$0.10 USD) - 2021/01/23 7:17:44 ET
Table 'Saito II' 6-max Seat #2 is the button
Seat 1: toby602 ($11.45 in chips) 
Seat 2: Last_Warr1or ($11.32 in chips) 
Seat 3: guro aye1234 ($10 in chips) 
Seat 5: Kostin_SS ($11.73 in chips) 
Seat 6: Mrburns.daoc ($10 in chips) 
guro aye1234: posts small blind $0.05
Kostin_SS: posts big blind $0.10
*** HOLE CARDS ***
Mrburns.daoc: folds 
toby602: folds 
Last_Warr1or: folds 
guro aye1234: folds 
Uncalled bet ($0.05) returned to Kostin_SS
Kostin_SS collected $0.10 from pot
Kostin_SS: doesn't show hand 
*** SUMMARY ***
Total pot $0.10 | Rake $0 
Seat 1: toby602 folded before Flop (didn't bet)
Seat 2: Last_Warr1or (button) folded before Flop (didn't bet)
Seat 3: guro aye1234 (small blind) folded before Flop
Seat 5: Kostin_SS (big blind) collected ($0.10)
Seat 6: Mrburns.daoc folded before Flop (didn't bet)



PokerStars Hand #222951833014:  Hold'em No Limit ($0.05/$0.10 USD) - 2021/01/23 7:17:51 ET
Table 'Saito II' 6-max Seat #3 is the button
Seat 1: toby602 ($11.45 in chips) 
Seat 2: Last_Warr1or ($11.32 in chips) 
Seat 3: guro aye1234 ($10 in chips) 
Seat 5: Kostin_SS ($11.78 in chips) 
Seat 6: Mrburns.daoc ($10 in chips) 
Kostin_SS: posts small blind $0.05
Mrburns.daoc: posts big blind $0.10
*** HOLE CARDS ***
Lergik joins the table at seat #4 
toby602: raises $0.20 to $0.30
Last_Warr1or: folds 
Lergik leaves the table
guro aye1234: raises $0.60 to $0.90
Kostin_SS: folds 
Mrburns.daoc: folds 
toby602: calls $0.60
*** FLOP *** [8h Qc 9c]
kamiEEE joins the table at seat #4 
toby602: bets $1.86
guro aye1234: raises $1.86 to $3.72
toby602: raises $6.83 to $10.55 and is all-in
guro aye1234: calls $5.38 and is all-in
Uncalled bet ($1.45) returned to toby602
*** TURN *** [8h Qc 9c] [6s]
*** RIVER *** [8h Qc 9c 6s] [Ad]
*** SHOW DOWN ***
toby602: shows [Jc Qs] (a pair of Queens)
guro aye1234: shows [Jd Td] (a straight, Eight to Queen)
guro aye1234 collected $19.24 from pot
*** SUMMARY ***
Total pot $20.15 | Rake $0.91 
Board [8h Qc 9c 6s Ad]
Seat 1: toby602 showed [Jc Qs] and lost with a pair of Queens
Seat 2: Last_Warr1or folded before Flop (didn't bet)
Seat 3: guro aye1234 (button) showed [Jd Td] and won ($19.24) with a straight, Eight to Queen
Seat 5: Kostin_SS (small blind) folded before Flop
Seat 6: Mrburns.daoc (big blind) folded before Flop



PokerStars Hand #222951858323:  Hold'em No Limit ($0.05/$0.10 USD) - 2021/01/23 7:19:00 ET
Table 'Saito II' 6-max Seat #5 is the button
Seat 1: toby602 ($1.45 in chips) 
Seat 2: Last_Warr1or ($11.32 in chips) 
Seat 3: guro aye1234 ($19.24 in chips) 
Seat 5: Kostin_SS ($11.73 in chips) 
Seat 6: Mrburns.daoc ($10 in chips) 
Mrburns.daoc: posts small blind $0.05
toby602: posts big blind $0.10
kamiEEE: sits out 
*** HOLE CARDS ***
Last_Warr1or: folds 
guro aye1234: folds 
Kostin_SS: raises $0.20 to $0.30
Mrburns.daoc: folds 
toby602: raises $1.15 to $1.45 and is all-in
Kostin_SS: calls $1.15
*** FLOP *** [Jd Tc 5h]
*** TURN *** [Jd Tc 5h] [3d]
*** RIVER *** [Jd Tc 5h 3d] [3h]
*** SHOW DOWN ***
toby602: shows [As 4h] (a pair of Threes)
Kostin_SS: shows [Td 8d] (two pair, Tens and Threes)
Kostin_SS collected $2.82 from pot
*** SUMMARY ***
Total pot $2.95 | Rake $0.13 
Board [Jd Tc 5h 3d 3h]
Seat 1: toby602 (big blind) showed [As 4h] and lost with a pair of Threes
Seat 2: Last_Warr1or folded before Flop (didn't bet)
Seat 3: guro aye1234 folded before Flop (didn't bet)
Seat 5: Kostin_SS (button) showed [Td 8d] and won ($2.82) with two pair, Tens and Threes
Seat 6: Mrburns.daoc (small blind) folded before Flop



PokerStars Hand #222951868946:  Hold'em No Limit ($0.05/$0.10 USD) - 2021/01/23 7:19:29 ET
Table 'Saito II' 6-max Seat #6 is the button
Seat 2: Last_Warr1or ($11.32 in chips) 
Seat 4: kamiEEE ($8 in chips) 
Seat 5: Kostin_SS ($13.10 in chips) 
Seat 6: Mrburns.daoc ($10 in chips) 
Last_Warr1or: posts small blind $0.05
guro aye1234: is sitting out 
kamiEEE: posts big blind $0.10
*** HOLE CARDS ***
Kostin_SS: folds 
Mrburns.daoc: folds 
Last_Warr1or: folds 
Uncalled bet ($0.05) returned to kamiEEE
toby602 leaves the table
kamiEEE collected $0.10 from pot
kamiEEE: doesn't show hand 
*** SUMMARY ***
Total pot $0.10 | Rake $0 
Seat 2: Last_Warr1or (small blind) folded before Flop
Seat 4: kamiEEE (big blind) collected ($0.10)
Seat 5: Kostin_SS folded before Flop (didn't bet)
Seat 6: Mrburns.daoc (button) folded before Flop (didn't bet)



PokerStars Hand #222951872632:  Hold'em No Limit ($0.05/$0.10 USD) - 2021/01/23 7:19:39 ET
Table 'Saito II' 6-max Seat #2 is the button
Seat 2: Last_Warr1or ($11.27 in chips) 
Seat 4: kamiEEE ($8.05 in chips) 
Seat 5: Kostin_SS ($13.10 in chips) 
Seat 6: Mrburns.daoc ($10 in chips) 
kamiEEE: posts small blind $0.05
Kostin_SS: posts big blind $0.10
*** HOLE CARDS ***
Mrburns.daoc: folds 
Last_Warr1or: raises $0.15 to $0.25
kamiEEE: folds 
Kostin_SS: calls $0.15
*** FLOP *** [Ks 8s 2c]
Kostin_SS: checks 
guro aye1234 leaves the table
Last_Warr1or: bets $0.27
Kostin_SS: folds 
Uncalled bet ($0.27) returned to Last_Warr1or
Last_Warr1or collected $0.53 from pot
*** SUMMARY ***
Total pot $0.55 | Rake $0.02 
Board [Ks 8s 2c]
Seat 2: Last_Warr1or (button) collected ($0.53)
Seat 4: kamiEEE (small blind) folded before Flop
Seat 5: Kostin_SS (big blind) folded on the Flop
Seat 6: Mrburns.daoc folded before Flop (didn't bet)



PokerStars Hand #222951886994:  Hold'em No Limit ($0.05/$0.10 USD) - 2021/01/23 7:20:19 ET
Table 'Saito II' 6-max Seat #4 is the button
Seat 2: Last_Warr1or ($11.55 in chips) 
Seat 4: kamiEEE ($8 in chips) 
Seat 5: Kostin_SS ($12.85 in chips) 
Seat 6: Mrburns.daoc ($10 in chips) 
Kostin_SS: posts small blind $0.05
Mrburns.daoc: posts big blind $0.10
*** HOLE CARDS ***
Last_Warr1or: folds 
kamiEEE: folds 
Kostin_SS: folds 
Uncalled bet ($0.05) returned to Mrburns.daoc
Mrburns.daoc collected $0.10 from pot
Mrburns.daoc: doesn't show hand 
*** SUMMARY ***
Total pot $0.10 | Rake $0 
Seat 2: Last_Warr1or folded before Flop (didn't bet)
Seat 4: kamiEEE (button) folded before Flop (didn't bet)
Seat 5: Kostin_SS (small blind) folded before Flop
Seat 6: Mrburns.daoc (big blind) collected ($0.10)



PokerStars Hand #222951894755:  Hold'em No Limit ($0.05/$0.10 USD) - 2021/01/23 7:20:40 ET
Table 'Saito II' 6-max Seat #5 is the button
Seat 2: Last_Warr1or ($11.55 in chips) 
Seat 4: kamiEEE ($8 in chips) 
Seat 5: Kostin_SS ($12.80 in chips) 
Seat 6: Mrburns.daoc ($10.05 in chips) 
Mrburns.daoc: posts small blind $0.05
Last_Warr1or: posts big blind $0.10
*** HOLE CARDS ***
kamiEEE: folds 
Kostin_SS: folds 
Mrburns.daoc: folds 
Uncalled bet ($0.05) returned to Last_Warr1or
Last_Warr1or collected $0.10 from pot
*** SUMMARY ***
Total pot $0.10 | Rake $0 
Seat 2: Last_Warr1or (big blind) collected ($0.10)
Seat 4: kamiEEE folded before Flop (didn't bet)
Seat 5: Kostin_SS (button) folded before Flop (didn't bet)
Seat 6: Mrburns.daoc (small blind) folded before Flop



PokerStars Hand #222951899456:  Hold'em No Limit ($0.05/$0.10 USD) - 2021/01/23 7:20:53 ET
Table 'Saito II' 6-max Seat #6 is the button
Seat 2: Last_Warr1or ($11.60 in chips) 
Seat 4: kamiEEE ($8 in chips) 
Seat 5: Kostin_SS ($12.80 in chips) 
Seat 6: Mrburns.daoc ($10 in chips) 
Last_Warr1or: posts small blind $0.05
kamiEEE: posts big blind $0.10
*** HOLE CARDS ***
Kostin_SS: folds 
Mrburns.daoc: raises $0.19 to $0.29
Last_Warr1or: folds 
kamiEEE: folds 
Uncalled bet ($0.19) returned to Mrburns.daoc
Last_Warr1or leaves the table
Mrburns.daoc collected $0.25 from pot
Mrburns.daoc: doesn't show hand 
*** SUMMARY ***
Total pot $0.25 | Rake $0 
Seat 2: Last_Warr1or (small blind) folded before Flop
Seat 4: kamiEEE (big blind) folded before Flop
Seat 5: Kostin_SS folded before Flop (didn't bet)
Seat 6: Mrburns.daoc (button) collected ($0.25)



PokerStars Hand #222951903517:  Hold'em No Limit ($0.05/$0.10 USD) - 2021/01/23 7:21:04 ET
Table 'Saito II' 6-max Seat #5 is the button
Seat 4: kamiEEE ($7.90 in chips) 
Seat 5: Kostin_SS ($12.80 in chips) 
Kostin_SS: posts small blind $0.05
Mrburns.daoc: is sitting out 
kamiEEE: posts big blind $0.10
*** HOLE CARDS ***
Mrburns.daoc leaves the table
Kostin_SS: folds 
Uncalled bet ($0.05) returned to kamiEEE
kamiEEE collected $0.10 from pot
kamiEEE: doesn't show hand 
*** SUMMARY ***
Total pot $0.10 | Rake $0 
Seat 4: kamiEEE (big blind) collected ($0.10)
Seat 5: Kostin_SS (button) (small blind) folded before Flop



PokerStars Hand #222952003387:  Hold'em No Limit ($0.05/$0.10 USD) - 2021/01/23 7:25:35 ET
Table 'Saito II' 6-max Seat #2 is the button
Seat 2: SMNNKV13 ($4 in chips) 
Seat 3: vilemo20 ($10 in chips) 
SMNNKV13: posts small blind $0.05
vilemo20: posts big blind $0.10
*** HOLE CARDS ***
SMNNKV13: calls $0.05
vilemo20: checks 
*** FLOP *** [5c Qs 4s]
vilemo20: checks 
SMNNKV13: checks 
*** TURN *** [5c Qs 4s] [8c]
vilemo20: checks 
SMNNKV13: checks 
*** RIVER *** [5c Qs 4s 8c] [7s]
vilemo20: checks 
SMNNKV13: checks 
*** SHOW DOWN ***
vilemo20: shows [Jc 5d] (a pair of Fives)
SMNNKV13: mucks hand 
vilemo20 collected $0.19 from pot
*** SUMMARY ***
Total pot $0.20 | Rake $0.01 
Board [5c Qs 4s 8c 7s]
Seat 2: SMNNKV13 (button) (small blind) mucked
Seat 3: vilemo20 (big blind) showed [Jc 5d] and won ($0.19) with a pair of Fives



PokerStars Hand #222952013418:  Hold'em No Limit ($0.05/$0.10 USD) - 2021/01/23 7:26:03 ET
Table 'Saito II' 6-max Seat #3 is the button
Seat 2: SMNNKV13 ($3.90 in chips) 
Seat 3: vilemo20 ($10.09 in chips) 
vilemo20: posts small blind $0.05
SMNNKV13: posts big blind $0.10
*** HOLE CARDS ***
vilemo20: folds 
Uncalled bet ($0.05) returned to SMNNKV13
SMNNKV13 collected $0.10 from pot
SMNNKV13: doesn't show hand 
*** SUMMARY ***
Total pot $0.10 | Rake $0 
Seat 2: SMNNKV13 (big blind) collected ($0.10)
Seat 3: vilemo20 (button) (small blind) folded before Flop



PokerStars Hand #222952015233:  Hold'em No Limit ($0.05/$0.10 USD) - 2021/01/23 7:26:08 ET
Table 'Saito II' 6-max Seat #2 is the button
Seat 2: SMNNKV13 ($3.95 in chips) 
Seat 3: vilemo20 ($10.04 in chips) 
SMNNKV13: posts small blind $0.05
vilemo20: posts big blind $0.10
*** HOLE CARDS ***
SMNNKV13: calls $0.05
vilemo20: checks 
*** FLOP *** [As Ks 9c]
vilemo20: checks 
SMNNKV13: bets $0.10
vilemo20: calls $0.10
*** TURN *** [As Ks 9c] [Th]
vilemo20: checks 
SMNNKV13: bets $0.10
vilemo20: calls $0.10
*** RIVER *** [As Ks 9c Th] [7c]
vilemo20: checks 
SMNNKV13: checks 
*** SHOW DOWN ***
vilemo20: shows [6s 3s] (high card Ace)
SMNNKV13: shows [Qh 5s] (high card Ace - King+Queen kicker)
SMNNKV13 collected $0.57 from pot
*** SUMMARY ***
Total pot $0.60 | Rake $0.03 
Board [As Ks 9c Th 7c]
Seat 2: SMNNKV13 (button) (small blind) showed [Qh 5s] and won ($0.57) with high card Ace
Seat 3: vilemo20 (big blind) showed [6s 3s] and lost with high card Ace



PokerStars Hand #222952027616:  Hold'em No Limit ($0.05/$0.10 USD) - 2021/01/23 7:26:41 ET
Table 'Saito II' 6-max Seat #3 is the button
Seat 2: SMNNKV13 ($4.22 in chips) 
Seat 3: vilemo20 ($10 in chips) 
vilemo20: posts small blind $0.05
SMNNKV13: posts big blind $0.10
*** HOLE CARDS ***
vilemo20: folds 
Uncalled bet ($0.05) returned to SMNNKV13
SMNNKV13 collected $0.10 from pot
SMNNKV13: doesn't show hand 
*** SUMMARY ***
Total pot $0.10 | Rake $0 
Seat 2: SMNNKV13 (big blind) collected ($0.10)
Seat 3: vilemo20 (button) (small blind) folded before Flop



PokerStars Hand #222952029348:  Hold'em No Limit ($0.05/$0.10 USD) - 2021/01/23 7:26:46 ET
Table 'Saito II' 6-max Seat #2 is the button
Seat 2: SMNNKV13 ($4.27 in chips) 
Seat 3: vilemo20 ($10 in chips) 
SMNNKV13: posts small blind $0.05
vilemo20: posts big blind $0.10
*** HOLE CARDS ***
SMNNKV13: calls $0.05
vilemo20: checks 
*** FLOP *** [7c 2d As]
vilemo20: checks 
SMNNKV13: checks 
*** TURN *** [7c 2d As] [Tc]
vilemo20: checks 
SMNNKV13: checks 
*** RIVER *** [7c 2d As Tc] [7h]
vilemo20: checks 
SMNNKV13: bets $0.20
vilemo20: folds 
Uncalled bet ($0.20) returned to SMNNKV13
SMNNKV13 collected $0.19 from pot
SMNNKV13: doesn't show hand 
*** SUMMARY ***
Total pot $0.20 | Rake $0.01 
Board [7c 2d As Tc 7h]
Seat 2: SMNNKV13 (button) (small blind) collected ($0.19)
Seat 3: vilemo20 (big blind) folded on the River



PokerStars Hand #222952039076:  Hold'em No Limit ($0.05/$0.10 USD) - 2021/01/23 7:27:13 ET
Table 'Saito II' 6-max Seat #3 is the button
Seat 2: SMNNKV13 ($4.36 in chips) 
Seat 3: vilemo20 ($10 in chips) 
vilemo20: posts small blind $0.05
SMNNKV13: posts big blind $0.10
*** HOLE CARDS ***
vilemo20: raises $0.15 to $0.25
SMNNKV13: folds 
Uncalled bet ($0.15) returned to vilemo20
vilemo20 collected $0.20 from pot
vilemo20: doesn't show hand 
*** SUMMARY ***
Total pot $0.20 | Rake $0 
Seat 2: SMNNKV13 (big blind) folded before Flop
Seat 3: vilemo20 (button) (small blind) collected ($0.20)



PokerStars Hand #222952041812:  Hold'em No Limit ($0.05/$0.10 USD) - 2021/01/23 7:27:20 ET
Table 'Saito II' 6-max Seat #2 is the button
Seat 2: SMNNKV13 ($4.26 in chips) 
Seat 3: vilemo20 ($10.10 in chips) 
SMNNKV13: posts small blind $0.05
vilemo20: posts big blind $0.10
*** HOLE CARDS ***
SMNNKV13: calls $0.05
vilemo20: raises $0.15 to $0.25
SMNNKV13: folds 
Uncalled bet ($0.15) returned to vilemo20
vilemo20 collected $0.20 from pot
vilemo20: doesn't show hand 
*** SUMMARY ***
Total pot $0.20 | Rake $0 
Seat 2: SMNNKV13 (button) (small blind) folded before Flop
Seat 3: vilemo20 (big blind) collected ($0.20)



PokerStars Hand #222952046763:  Hold'em No Limit ($0.05/$0.10 USD) - 2021/01/23 7:27:34 ET
Table 'Saito II' 6-max Seat #3 is the button
Seat 2: SMNNKV13 ($4.16 in chips) 
Seat 3: vilemo20 ($10.20 in chips) 
vilemo20: posts small blind $0.05
SMNNKV13: posts big blind $0.10
*** HOLE CARDS ***
vilemo20: raises $0.15 to $0.25
SMNNKV13: calls $0.15
*** FLOP *** [8s 5h 2s]
SMNNKV13: bets $0.10
vilemo20: folds 
Uncalled bet ($0.10) returned to SMNNKV13
SMNNKV13 collected $0.48 from pot
SMNNKV13: doesn't show hand 
*** SUMMARY ***
Total pot $0.50 | Rake $0.02 
Board [8s 5h 2s]
Seat 2: SMNNKV13 (big blind) collected ($0.48)
Seat 3: vilemo20 (button) (small blind) folded on the Flop



PokerStars Hand #222952055732:  Hold'em No Limit ($0.05/$0.10 USD) - 2021/01/23 7:27:58 ET
Table 'Saito II' 6-max Seat #2 is the button
Seat 2: SMNNKV13 ($4.39 in chips) 
Seat 3: vilemo20 ($10 in chips) 
SMNNKV13: posts small blind $0.05
vilemo20: posts big blind $0.10
*** HOLE CARDS ***
SMNNKV13: calls $0.05
vilemo20: checks 
*** FLOP *** [8h 7s 6s]
vilemo20: checks 
SMNNKV13: checks 
*** TURN *** [8h 7s 6s] [5h]
vilemo20: checks 
SMNNKV13: bets $0.10
vilemo20: calls $0.10
*** RIVER *** [8h 7s 6s 5h] [Js]
vilemo20: checks 
SMNNKV13: bets $0.10
vilemo20: folds 
Uncalled bet ($0.10) returned to SMNNKV13
SMNNKV13 collected $0.38 from pot
SMNNKV13: doesn't show hand 
*** SUMMARY ***
Total pot $0.40 | Rake $0.02 
Board [8h 7s 6s 5h Js]
Seat 2: SMNNKV13 (button) (small blind) collected ($0.38)
Seat 3: vilemo20 (big blind) folded on the River



PokerStars Hand #222952064241:  Hold'em No Limit ($0.05/$0.10 USD) - 2021/01/23 7:28:21 ET
Table 'Saito II' 6-max Seat #3 is the button
Seat 2: SMNNKV13 ($4.57 in chips) 
Seat 3: vilemo20 ($10 in chips) 
vilemo20: posts small blind $0.05
SMNNKV13: posts big blind $0.10
*** HOLE CARDS ***
vilemo20: raises $0.15 to $0.25
SMNNKV13: calls $0.15
*** FLOP *** [Th 9c Jd]
SMNNKV13: checks 
vilemo20: checks 
*** TURN *** [Th 9c Jd] [6s]
SMNNKV13: checks 
vilemo20: bets $0.16
SMNNKV13: calls $0.16
*** RIVER *** [Th 9c Jd 6s] [8h]
Musiqsoulchi joins the table at seat #6 
SMNNKV13: bets $0.10
gor580 joins the table at seat #1 
vilemo20: raises $0.51 to $0.61
siblye joins the table at seat #4 
SMNNKV13: folds 
Uncalled bet ($0.51) returned to vilemo20
vilemo20 collected $0.97 from pot
vilemo20: doesn't show hand 
*** SUMMARY ***
Total pot $1.02 | Rake $0.05 
Board [Th 9c Jd 6s 8h]
Seat 2: SMNNKV13 (big blind) folded on the River
Seat 3: vilemo20 (button) (small blind) collected ($0.97)



PokerStars Hand #222952081776:  Hold'em No Limit ($0.05/$0.10 USD) - 2021/01/23 7:29:09 ET
Table 'Saito II' 6-max Seat #2 is the button
Seat 2: SMNNKV13 ($4.06 in chips) 
Seat 3: vilemo20 ($10.46 in chips) 
Seat 4: siblye ($9 in chips) 
vilemo20: posts small blind $0.05
siblye: posts big blind $0.10
Musiqsoulchi: sits out 
gor580: sits out 
*** HOLE CARDS ***
fukuchan2631 joins the table at seat #5 
SMNNKV13: calls $0.10
vilemo20: folds 
siblye: checks 
*** FLOP *** [7d Ad Tc]
siblye: checks 
SMNNKV13: checks 
*** TURN *** [7d Ad Tc] [4c]
siblye: checks 
SMNNKV13: checks 
*** RIVER *** [7d Ad Tc 4c] [9s]
siblye: checks 
SMNNKV13: bets $0.30
siblye: folds 
Uncalled bet ($0.30) returned to SMNNKV13
SMNNKV13 collected $0.24 from pot
SMNNKV13: doesn't show hand 
*** SUMMARY ***
Total pot $0.25 | Rake $0.01 
Board [7d Ad Tc 4c 9s]
Seat 2: SMNNKV13 (button) collected ($0.24)
Seat 3: vilemo20 (small blind) folded before Flop
Seat 4: siblye (big blind) folded on the River



PokerStars Hand #222952093095:  Hold'em No Limit ($0.05/$0.10 USD) - 2021/01/23 7:29:40 ET
Table 'Saito II' 6-max Seat #3 is the button
Seat 2: SMNNKV13 ($4.20 in chips) 
Seat 3: vilemo20 ($10.41 in chips) 
Seat 4: siblye ($8.90 in chips) 
Seat 5: fukuchan2631 ($5.03 in chips) 
siblye: posts small blind $0.05
fukuchan2631: posts big blind $0.10
Musiqsoulchi: sits out 
gor580: sits out 
*** HOLE CARDS ***
SMNNKV13: folds 
vilemo20: raises $0.15 to $0.25
siblye: folds 
fukuchan2631: calls $0.15
*** FLOP *** [Ts 2d 4c]
fukuchan2631: bets $0.20
vilemo20: folds 
Uncalled bet ($0.20) returned to fukuchan2631
fukuchan2631 collected $0.53 from pot
fukuchan2631: doesn't show hand 
*** SUMMARY ***
Total pot $0.55 | Rake $0.02 
Board [Ts 2d 4c]
Seat 2: SMNNKV13 folded before Flop (didn't bet)
Seat 3: vilemo20 (button) folded on the Flop
Seat 4: siblye (small blind) folded before Flop
Seat 5: fukuchan2631 (big blind) collected ($0.53)



PokerStars Hand #222952102201:  Hold'em No Limit ($0.05/$0.10 USD) - 2021/01/23 7:30:05 ET
Table 'Saito II' 6-max Seat #4 is the button
Seat 2: SMNNKV13 ($4.20 in chips) 
Seat 3: vilemo20 ($10.16 in chips) 
Seat 4: siblye ($8.85 in chips) 
Seat 5: fukuchan2631 ($5.31 in chips) 
Seat 6: Musiqsoulchi ($10 in chips) 
fukuchan2631: posts small blind $0.05
Musiqsoulchi: posts big blind $0.10
gor580: sits out 
*** HOLE CARDS ***
SMNNKV13: folds 
vilemo20: folds 
siblye: folds 
fukuchan2631: calls $0.05
Musiqsoulchi: checks 
*** FLOP *** [Qc Tc 6c]
fukuchan2631: checks 
Musiqsoulchi: checks 
*** TURN *** [Qc Tc 6c] [2d]
fukuchan2631: checks 
Musiqsoulchi: checks 
*** RIVER *** [Qc Tc 6c 2d] [4d]
fukuchan2631: checks 
Musiqsoulchi: checks 
*** SHOW DOWN ***
fukuchan2631: shows [7s 3d] (high card Queen)
Musiqsoulchi: shows [6h 5c] (a pair of Sixes)
Musiqsoulchi collected $0.19 from pot
*** SUMMARY ***
Total pot $0.20 | Rake $0.01 
Board [Qc Tc 6c 2d 4d]
Seat 2: SMNNKV13 folded before Flop (didn't bet)
Seat 3: vilemo20 folded before Flop (didn't bet)
Seat 4: siblye (button) folded before Flop (didn't bet)
Seat 5: fukuchan2631 (small blind) showed [7s 3d] and lost with high card Queen
Seat 6: Musiqsoulchi (big blind) showed [6h 5c] and won ($0.19) with a pair of Sixes



PokerStars Hand #222952113336:  Hold'em No Limit ($0.05/$0.10 USD) - 2021/01/23 7:30:34 ET
Table 'Saito II' 6-max Seat #5 is the button
Seat 1: gor580 ($10 in chips) 
Seat 2: SMNNKV13 ($4.20 in chips) 
Seat 3: vilemo20 ($10.16 in chips) 
Seat 4: siblye ($8.85 in chips) 
Seat 5: fukuchan2631 ($5.21 in chips) 
Seat 6: Musiqsoulchi ($10.09 in chips) 
Musiqsoulchi: posts small blind $0.05
gor580: posts big blind $0.10
*** HOLE CARDS ***
SMNNKV13: calls $0.10
vilemo20: folds 
siblye: folds 
fukuchan2631: calls $0.10
Musiqsoulchi: folds 
gor580: checks 
*** FLOP *** [3d Qd 9s]
gor580: checks 
SMNNKV13: checks 
fukuchan2631: bets $0.10
gor580: folds 
SMNNKV13: calls $0.10
*** TURN *** [3d Qd 9s] [5s]
SMNNKV13: checks 
fukuchan2631: bets $0.20
SMNNKV13: calls $0.20
*** RIVER *** [3d Qd 9s 5s] [Kh]
SMNNKV13: checks 
fukuchan2631: checks 
*** SHOW DOWN ***
SMNNKV13: shows [Jh Jc] (a pair of Jacks)
fukuchan2631: mucks hand 
SMNNKV13 collected $0.91 from pot
*** SUMMARY ***
Total pot $0.95 | Rake $0.04 
Board [3d Qd 9s 5s Kh]
Seat 1: gor580 (big blind) folded on the Flop
Seat 2: SMNNKV13 showed [Jh Jc] and won ($0.91) with a pair of Jacks
Seat 3: vilemo20 folded before Flop (didn't bet)
Seat 4: siblye folded before Flop (didn't bet)
Seat 5: fukuchan2631 (button) mucked
Seat 6: Musiqsoulchi (small blind) folded before Flop



PokerStars Hand #222952133226:  Hold'em No Limit ($0.05/$0.10 USD) - 2021/01/23 7:31:29 ET
Table 'Saito II' 6-max Seat #6 is the button
Seat 1: gor580 ($10 in chips) 
Seat 2: SMNNKV13 ($4.71 in chips) 
Seat 3: vilemo20 ($10.16 in chips) 
Seat 4: siblye ($8.85 in chips) 
Seat 5: fukuchan2631 ($4.81 in chips) 
Seat 6: Musiqsoulchi ($10.04 in chips) 
gor580: posts small blind $0.05
SMNNKV13: posts big blind $0.10
*** HOLE CARDS ***
vilemo20: folds 
siblye: folds 
fukuchan2631: raises $0.20 to $0.30
Musiqsoulchi: calls $0.30
gor580: folds 
SMNNKV13: calls $0.20
*** FLOP *** [8h 7d 3s]
SMNNKV13: checks 
fukuchan2631: bets $0.50
Musiqsoulchi: folds 
SMNNKV13: calls $0.50
*** TURN *** [8h 7d 3s] [4s]
SMNNKV13: checks 
fukuchan2631: bets $1
SMNNKV13: calls $1
*** RIVER *** [8h 7d 3s 4s] [5c]
SMNNKV13: checks 
fukuchan2631: checks 
*** SHOW DOWN ***
SMNNKV13: shows [Tc Th] (a pair of Tens)
fukuchan2631: mucks hand 
SMNNKV13 collected $3.77 from pot
*** SUMMARY ***
Total pot $3.95 | Rake $0.18 
Board [8h 7d 3s 4s 5c]
Seat 1: gor580 (small blind) folded before Flop
Seat 2: SMNNKV13 (big blind) showed [Tc Th] and won ($3.77) with a pair of Tens
Seat 3: vilemo20 folded before Flop (didn't bet)
Seat 4: siblye folded before Flop (didn't bet)
Seat 5: fukuchan2631 mucked
Seat 6: Musiqsoulchi (button) folded on the Flop



PokerStars Hand #222952152814:  Hold'em No Limit ($0.05/$0.10 USD) - 2021/01/23 7:32:22 ET
Table 'Saito II' 6-max Seat #1 is the button
Seat 1: gor580 ($10 in chips) 
Seat 2: SMNNKV13 ($6.68 in chips) 
Seat 3: vilemo20 ($10.16 in chips) 
Seat 4: siblye ($8.85 in chips) 
Seat 5: fukuchan2631 ($3.01 in chips) 
Seat 6: Musiqsoulchi ($9.74 in chips) 
SMNNKV13: posts small blind $0.05
vilemo20: posts big blind $0.10
*** HOLE CARDS ***
siblye: raises $0.20 to $0.30
fukuchan2631: calls $0.30
Musiqsoulchi: folds 
gor580: folds 
SMNNKV13: folds 
vilemo20: folds 
*** FLOP *** [7h 7d Jh]
siblye: bets $0.36
fukuchan2631: calls $0.36
*** TURN *** [7h 7d Jh] [Kh]
siblye: bets $0.70
fukuchan2631: folds 
Uncalled bet ($0.70) returned to siblye
siblye collected $1.40 from pot
siblye: doesn't show hand 
*** SUMMARY ***
Total pot $1.47 | Rake $0.07 
Board [7h 7d Jh Kh]
Seat 1: gor580 (button) folded before Flop (didn't bet)
Seat 2: SMNNKV13 (small blind) folded before Flop
Seat 3: vilemo20 (big blind) folded before Flop
Seat 4: siblye collected ($1.40)
Seat 5: fukuchan2631 folded on the Turn
Seat 6: Musiqsoulchi folded before Flop (didn't bet)



PokerStars Hand #222952162203:  Hold'em No Limit ($0.05/$0.10 USD) - 2021/01/23 7:32:47 ET
Table 'Saito II' 6-max Seat #3 is the button
Seat 1: gor580 ($10 in chips) 
Seat 3: vilemo20 ($10.06 in chips) 
Seat 4: siblye ($9.59 in chips) 
Seat 5: fukuchan2631 ($2.35 in chips) 
Seat 6: Musiqsoulchi ($9.74 in chips) 
siblye: posts small blind $0.05
fukuchan2631: posts big blind $0.10
*** HOLE CARDS ***
Musiqsoulchi: raises $0.20 to $0.30
gor580: folds 
vilemo20: folds 
siblye: folds 
fukuchan2631: calls $0.20
*** FLOP *** [Ac Qs 6c]
fukuchan2631: checks 
Musiqsoulchi: checks 
*** TURN *** [Ac Qs 6c] [8s]
fukuchan2631: checks 
Musiqsoulchi: bets $0.30
fukuchan2631: calls $0.30
*** RIVER *** [Ac Qs 6c 8s] [2h]
fukuchan2631: checks 
Musiqsoulchi: checks 
*** SHOW DOWN ***
fukuchan2631: shows [Kd 6h] (a pair of Sixes)
Musiqsoulchi: shows [Jc Js] (a pair of Jacks)
Musiqsoulchi collected $1.19 from pot
*** SUMMARY ***
Total pot $1.25 | Rake $0.06 
Board [Ac Qs 6c 8s 2h]
Seat 1: gor580 folded before Flop (didn't bet)
Seat 3: vilemo20 (button) folded before Flop (didn't bet)
Seat 4: siblye (small blind) folded before Flop
Seat 5: fukuchan2631 (big blind) showed [Kd 6h] and lost with a pair of Sixes
Seat 6: Musiqsoulchi showed [Jc Js] and won ($1.19) with a pair of Jacks



PokerStars Hand #222952173613:  Hold'em No Limit ($0.05/$0.10 USD) - 2021/01/23 7:33:18 ET
Table 'Saito II' 6-max Seat #4 is the button
Seat 1: gor580 ($10 in chips) 
Seat 3: vilemo20 ($10.06 in chips) 
Seat 4: siblye ($9.54 in chips) 
Seat 5: fukuchan2631 ($1.75 in chips) 
Seat 6: Musiqsoulchi ($10.33 in chips) 
fukuchan2631: posts small blind $0.05
Musiqsoulchi: posts big blind $0.10
*** HOLE CARDS ***
gor580: folds 
vilemo20: folds 
siblye: folds 
fukuchan2631: raises $0.20 to $0.30
Musiqsoulchi: calls $0.20
*** FLOP *** [8h Js 5h]
fukuchan2631: bets $0.30
Musiqsoulchi: calls $0.30
*** TURN *** [8h Js 5h] [4s]
fukuchan2631: bets $0.50
Musiqsoulchi: calls $0.50
*** RIVER *** [8h Js 5h 4s] [Ad]
fukuchan2631: bets $0.65 and is all-in
Musiqsoulchi: folds 
Uncalled bet ($0.65) returned to fukuchan2631
fukuchan2631 collected $2.10 from pot
fukuchan2631: doesn't show hand 
*** SUMMARY ***
Total pot $2.20 | Rake $0.10 
Board [8h Js 5h 4s Ad]
Seat 1: gor580 folded before Flop (didn't bet)
Seat 3: vilemo20 folded before Flop (didn't bet)
Seat 4: siblye (button) folded before Flop (didn't bet)
Seat 5: fukuchan2631 (small blind) collected ($2.10)
Seat 6: Musiqsoulchi (big blind) folded on the River



PokerStars Hand #222952185962:  Hold'em No Limit ($0.05/$0.10 USD) - 2021/01/23 7:33:51 ET
Table 'Saito II' 6-max Seat #5 is the button
Seat 1: gor580 ($10 in chips) 
Seat 2: SMNNKV13 ($6.63 in chips) 
Seat 3: vilemo20 ($10.06 in chips) 
Seat 4: siblye ($9.54 in chips) 
Seat 5: fukuchan2631 ($2.75 in chips) 
Seat 6: Musiqsoulchi ($9.23 in chips) 
Musiqsoulchi: posts small blind $0.05
gor580: posts big blind $0.10
*** HOLE CARDS ***
SMNNKV13: folds 
vilemo20: folds 
siblye: raises $0.20 to $0.30
fukuchan2631: folds 
Musiqsoulchi: folds 
gor580: folds 
Uncalled bet ($0.20) returned to siblye
siblye collected $0.25 from pot
siblye: doesn't show hand 
*** SUMMARY ***
Total pot $0.25 | Rake $0 
Seat 1: gor580 (big blind) folded before Flop
Seat 2: SMNNKV13 folded before Flop (didn't bet)
Seat 3: vilemo20 folded before Flop (didn't bet)
Seat 4: siblye collected ($0.25)
Seat 5: fukuchan2631 (button) folded before Flop (didn't bet)
Seat 6: Musiqsoulchi (small blind) folded before Flop



PokerStars Hand #222952202945:  Hold'em No Limit ($0.05/$0.10 USD) - 2021/01/23 7:34:37 ET
Table 'Saito II' 6-max Seat #6 is the button
Seat 1: gor580 ($10 in chips) 
Seat 2: SMNNKV13 ($6.63 in chips) 
Seat 3: vilemo20 ($10.06 in chips) 
Seat 4: siblye ($9.69 in chips) 
Seat 5: fukuchan2631 ($2.75 in chips) 
Seat 6: Musiqsoulchi ($9.18 in chips) 
gor580: posts small blind $0.05
SMNNKV13: posts big blind $0.10
*** HOLE CARDS ***
vilemo20: folds 
siblye: folds 
fukuchan2631: folds 
Musiqsoulchi: folds 
gor580: raises $0.20 to $0.30
SMNNKV13: folds 
Uncalled bet ($0.20) returned to gor580
gor580 collected $0.20 from pot
gor580: doesn't show hand 
*** SUMMARY ***
Total pot $0.20 | Rake $0 
Seat 1: gor580 (small blind) collected ($0.20)
Seat 2: SMNNKV13 (big blind) folded before Flop
Seat 3: vilemo20 folded before Flop (didn't bet)
Seat 4: siblye folded before Flop (didn't bet)
Seat 5: fukuchan2631 folded before Flop (didn't bet)
Seat 6: Musiqsoulchi (button) folded before Flop (didn't bet)



PokerStars Hand #222952211155:  Hold'em No Limit ($0.05/$0.10 USD) - 2021/01/23 7:34:59 ET
Table 'Saito II' 6-max Seat #1 is the button
Seat 1: gor580 ($10.10 in chips) 
Seat 2: SMNNKV13 ($6.53 in chips) 
Seat 3: vilemo20 ($10.06 in chips) 
Seat 4: siblye ($9.69 in chips) 
Seat 5: fukuchan2631 ($2.75 in chips) 
Seat 6: Musiqsoulchi ($9.18 in chips) 
SMNNKV13: posts small blind $0.05
vilemo20: posts big blind $0.10
*** HOLE CARDS ***
siblye: folds 
fukuchan2631: raises $0.20 to $0.30
Musiqsoulchi: raises $0.60 to $0.90
gor580: folds 
SMNNKV13: folds 
vilemo20: folds 
fukuchan2631: calls $0.60
*** FLOP *** [5d 8s 8c]
fukuchan2631: checks 
Musiqsoulchi: bets $8.28 and is all-in
fukuchan2631: folds 
Uncalled bet ($8.28) returned to Musiqsoulchi
Musiqsoulchi collected $1.86 from pot
Musiqsoulchi: doesn't show hand 
*** SUMMARY ***
Total pot $1.95 | Rake $0.09 
Board [5d 8s 8c]
Seat 1: gor580 (button) folded before Flop (didn't bet)
Seat 2: SMNNKV13 (small blind) folded before Flop
Seat 3: vilemo20 (big blind) folded before Flop
Seat 4: siblye folded before Flop (didn't bet)
Seat 5: fukuchan2631 folded on the Flop
Seat 6: Musiqsoulchi collected ($1.86)



PokerStars Hand #222952222802:  Hold'em No Limit ($0.05/$0.10 USD) - 2021/01/23 7:35:31 ET
Table 'Saito II' 6-max Seat #2 is the button
Seat 1: gor580 ($10.10 in chips) 
Seat 2: SMNNKV13 ($6.48 in chips) 
Seat 3: vilemo20 ($10 in chips) 
Seat 4: siblye ($9.69 in chips) 
Seat 5: fukuchan2631 ($1.85 in chips) 
Seat 6: Musiqsoulchi ($10.14 in chips) 
vilemo20: posts small blind $0.05
siblye: posts big blind $0.10
*** HOLE CARDS ***
fukuchan2631: raises $0.20 to $0.30
Musiqsoulchi: folds 
gor580: folds 
SMNNKV13: folds 
vilemo20: raises $0.70 to $1
siblye: folds 
fukuchan2631: raises $0.85 to $1.85 and is all-in
vilemo20: calls $0.85
*** FLOP *** [Jd 4c 3s]
*** TURN *** [Jd 4c 3s] [6h]
*** RIVER *** [Jd 4c 3s 6h] [3d]
*** SHOW DOWN ***
vilemo20: shows [Qh Ac] (a pair of Threes)
fukuchan2631: shows [2h Ah] (a pair of Threes - lower kicker)
vilemo20 collected $3.63 from pot
*** SUMMARY ***
Total pot $3.80 | Rake $0.17 
Board [Jd 4c 3s 6h 3d]
Seat 1: gor580 folded before Flop (didn't bet)
Seat 2: SMNNKV13 (button) folded before Flop (didn't bet)
Seat 3: vilemo20 (small blind) showed [Qh Ac] and won ($3.63) with a pair of Threes
Seat 4: siblye (big blind) folded before Flop
Seat 5: fukuchan2631 showed [2h Ah] and lost with a pair of Threes
Seat 6: Musiqsoulchi folded before Flop (didn't bet)



PokerStars Hand #222952236920:  Hold'em No Limit ($0.05/$0.10 USD) - 2021/01/23 7:36:08 ET
Table 'Saito II' 6-max Seat #3 is the button
Seat 1: gor580 ($10.10 in chips) 
Seat 2: SMNNKV13 ($6.48 in chips) 
Seat 3: vilemo20 ($11.78 in chips) 
Seat 4: siblye ($9.59 in chips) 
Seat 6: Musiqsoulchi ($10.14 in chips) 
siblye: posts small blind $0.05
Musiqsoulchi: posts big blind $0.10
*** HOLE CARDS ***
gor580: folds 
SMNNKV13: calls $0.10
fukuchan2631 leaves the table
vilemo20: folds 
siblye: folds 
magdal28 joins the table at seat #5 
Musiqsoulchi: checks 
*** FLOP *** [8d 3c 7c]
Musiqsoulchi: checks 
SMNNKV13: bets $0.10
Musiqsoulchi: folds 
Uncalled bet ($0.10) returned to SMNNKV13
SMNNKV13 collected $0.24 from pot
SMNNKV13: doesn't show hand 
*** SUMMARY ***
Total pot $0.25 | Rake $0.01 
Board [8d 3c 7c]
Seat 1: gor580 folded before Flop (didn't bet)
Seat 2: SMNNKV13 collected ($0.24)
Seat 3: vilemo20 (button) folded before Flop (didn't bet)
Seat 4: siblye (small blind) folded before Flop
Seat 6: Musiqsoulchi (big blind) folded on the Flop



PokerStars Hand #222952249089:  Hold'em No Limit ($0.05/$0.10 USD) - 2021/01/23 7:36:41 ET
Table 'Saito II' 6-max Seat #4 is the button
Seat 1: gor580 ($10.10 in chips) 
Seat 2: SMNNKV13 ($6.62 in chips) 
Seat 3: vilemo20 ($11.78 in chips) 
Seat 4: siblye ($9.54 in chips) 
Seat 6: Musiqsoulchi ($10.04 in chips) 
Musiqsoulchi: posts small blind $0.05
gor580: posts big blind $0.10
*** HOLE CARDS ***
SMNNKV13: calls $0.10
vilemo20: raises $0.30 to $0.40
siblye: calls $0.40
Musiqsoulchi: folds 
gor580: folds 
SMNNKV13: calls $0.30
*** FLOP *** [8h 8s 2d]
SMNNKV13: checks 
vilemo20: bets $0.50
siblye: calls $0.50
SMNNKV13: calls $0.50
*** TURN *** [8h 8s 2d] [7s]
SMNNKV13: checks 
vilemo20: bets $1.05
siblye: calls $1.05
SMNNKV13: calls $1.05
*** RIVER *** [8h 8s 2d 7s] [6d]
SMNNKV13: checks 
vilemo20: checks 
siblye: bets $2.87
SMNNKV13: calls $2.87
vilemo20: folds 
*** SHOW DOWN ***
siblye: shows [9d Td] (a straight, Six to Ten)
SMNNKV13: mucks hand 
siblye collected $11.21 from pot
*** SUMMARY ***
Total pot $11.74 | Rake $0.53 
Board [8h 8s 2d 7s 6d]
Seat 1: gor580 (big blind) folded before Flop
Seat 2: SMNNKV13 mucked
Seat 3: vilemo20 folded on the River
Seat 4: siblye (button) showed [9d Td] and won ($11.21) with a straight, Six to Ten
Seat 6: Musiqsoulchi (small blind) folded before Flop



PokerStars Hand #222952281344:  Hold'em No Limit ($0.05/$0.10 USD) - 2021/01/23 7:38:07 ET
Table 'Saito II' 6-max Seat #6 is the button
Seat 1: gor580 ($10 in chips) 
Seat 2: SMNNKV13 ($1.80 in chips) 
Seat 3: vilemo20 ($10 in chips) 
Seat 4: siblye ($15.93 in chips) 
Seat 6: Musiqsoulchi ($9.99 in chips) 
gor580: posts small blind $0.05
SMNNKV13: posts big blind $0.10
magdal28: sits out 
*** HOLE CARDS ***
vilemo20: folds 
siblye: folds 
Musiqsoulchi: raises $0.10 to $0.20
gor580: calls $0.15
SMNNKV13: calls $0.10
*** FLOP *** [3c 9d 2h]
gor580: checks 
SMNNKV13: checks 
Musiqsoulchi: bets $0.20
gor580: folds 
SMNNKV13: calls $0.20
*** TURN *** [3c 9d 2h] [5s]
SMNNKV13: checks 
Musiqsoulchi: checks 
*** RIVER *** [3c 9d 2h 5s] [Kc]
SMNNKV13: bets $0.10
Musiqsoulchi: calls $0.10
*** SHOW DOWN ***
SMNNKV13: shows [6s Ac] (high card Ace)
Musiqsoulchi: shows [9c Qd] (a pair of Nines)
Musiqsoulchi collected $1.15 from pot
*** SUMMARY ***
Total pot $1.20 | Rake $0.05 
Board [3c 9d 2h 5s Kc]
Seat 1: gor580 (small blind) folded on the Flop
Seat 2: SMNNKV13 (big blind) showed [6s Ac] and lost with high card Ace
Seat 3: vilemo20 folded before Flop (didn't bet)
Seat 4: siblye folded before Flop (didn't bet)
Seat 6: Musiqsoulchi (button) showed [9c Qd] and won ($1.15) with a pair of Nines



PokerStars Hand #222952302916:  Hold'em No Limit ($0.05/$0.10 USD) - 2021/01/23 7:39:04 ET
Table 'Saito II' 6-max Seat #1 is the button
Seat 1: gor580 ($10 in chips) 
Seat 2: SMNNKV13 ($1.30 in chips) 
Seat 3: vilemo20 ($10 in chips) 
Seat 4: siblye ($15.93 in chips) 
Seat 6: Musiqsoulchi ($10.64 in chips) 
SMNNKV13: posts small blind $0.05
vilemo20: posts big blind $0.10
magdal28: sits out 
*** HOLE CARDS ***
siblye: folds 
Musiqsoulchi: calls $0.10
gor580: folds 
SMNNKV13: calls $0.05
vilemo20: checks 
*** FLOP *** [7d 3h 9c]
SMNNKV13: checks 
vilemo20: checks 
Musiqsoulchi: checks 
*** TURN *** [7d 3h 9c] [Kh]
SMNNKV13: checks 
vilemo20: checks 
Musiqsoulchi: bets $0.10
SMNNKV13: folds 
vilemo20: folds 
Uncalled bet ($0.10) returned to Musiqsoulchi
Musiqsoulchi collected $0.29 from pot
Musiqsoulchi: doesn't show hand 
*** SUMMARY ***
Total pot $0.30 | Rake $0.01 
Board [7d 3h 9c Kh]
Seat 1: gor580 (button) folded before Flop (didn't bet)
Seat 2: SMNNKV13 (small blind) folded on the Turn
Seat 3: vilemo20 (big blind) folded on the Turn
Seat 4: siblye folded before Flop (didn't bet)
Seat 6: Musiqsoulchi collected ($0.29)



PokerStars Hand #222952316551:  Hold'em No Limit ($0.05/$0.10 USD) - 2021/01/23 7:39:40 ET
Table 'Saito II' 6-max Seat #2 is the button
Seat 1: gor580 ($10 in chips) 
Seat 2: SMNNKV13 ($1.20 in chips) 
Seat 3: vilemo20 ($10 in chips) 
Seat 4: siblye ($15.93 in chips) 
Seat 6: Musiqsoulchi ($10.83 in chips) 
vilemo20: posts small blind $0.05
siblye: posts big blind $0.10
magdal28: sits out 
*** HOLE CARDS ***
Musiqsoulchi: folds 
gor580: folds 
SMNNKV13: folds 
vilemo20: folds 
Uncalled bet ($0.05) returned to siblye
siblye collected $0.10 from pot
siblye: doesn't show hand 
*** SUMMARY ***
Total pot $0.10 | Rake $0 
Seat 1: gor580 folded before Flop (didn't bet)
Seat 2: SMNNKV13 (button) folded before Flop (didn't bet)
Seat 3: vilemo20 (small blind) folded before Flop
Seat 4: siblye (big blind) collected ($0.10)
Seat 6: Musiqsoulchi folded before Flop (didn't bet)



PokerStars Hand #222952319552:  Hold'em No Limit ($0.05/$0.10 USD) - 2021/01/23 7:39:48 ET
Table 'Saito II' 6-max Seat #3 is the button
Seat 1: gor580 ($10 in chips) 
Seat 2: SMNNKV13 ($1.20 in chips) 
Seat 3: vilemo20 ($10 in chips) 
Seat 4: siblye ($15.98 in chips) 
Seat 5: magdal28 ($10 in chips) 
Seat 6: Musiqsoulchi ($10.83 in chips) 
siblye: posts small blind $0.05
magdal28: posts big blind $0.10
*** HOLE CARDS ***
Musiqsoulchi has timed out
Musiqsoulchi: folds 
gor580: raises $0.14 to $0.24
SMNNKV13: folds 
vilemo20: calls $0.24
siblye: folds 
magdal28: folds 
*** FLOP *** [7h 2d 4c]
gor580: checks 
vilemo20: bets $0.31
gor580: calls $0.31
*** TURN *** [7h 2d 4c] [Kc]
gor580: checks 
vilemo20: checks 
*** RIVER *** [7h 2d 4c Kc] [6c]
gor580: bets $0.71
vilemo20: folds 
Uncalled bet ($0.71) returned to gor580
gor580 collected $1.19 from pot
gor580: doesn't show hand 
*** SUMMARY ***
Total pot $1.25 | Rake $0.06 
Board [7h 2d 4c Kc 6c]
Seat 1: gor580 collected ($1.19)
Seat 2: SMNNKV13 folded before Flop (didn't bet)
Seat 3: vilemo20 (button) folded on the River
Seat 4: siblye (small blind) folded before Flop
Seat 5: magdal28 (big blind) folded before Flop
Seat 6: Musiqsoulchi folded before Flop (didn't bet)



PokerStars Hand #222952347118:  Hold'em No Limit ($0.05/$0.10 USD) - 2021/01/23 7:41:01 ET
Table 'Saito II' 6-max Seat #4 is the button
Seat 1: gor580 ($10.64 in chips) 
Seat 2: SMNNKV13 ($1.20 in chips) 
Seat 3: vilemo20 ($10 in chips) 
Seat 4: siblye ($15.93 in chips) 
Seat 5: magdal28 ($10 in chips) 
Seat 6: Musiqsoulchi ($10.83 in chips) 
magdal28: posts small blind $0.05
Musiqsoulchi: posts big blind $0.10
*** HOLE CARDS ***
gor580: folds 
SMNNKV13: folds 
vilemo20: folds 
siblye: raises $0.20 to $0.30
magdal28: raises $0.70 to $1
Musiqsoulchi: folds 
siblye: calls $0.70
*** FLOP *** [Qs As Ad]
magdal28: checks 
siblye: bets $1.01
magdal28: folds 
Uncalled bet ($1.01) returned to siblye
siblye collected $2.01 from pot
siblye: doesn't show hand 
*** SUMMARY ***
Total pot $2.10 | Rake $0.09 
Board [Qs As Ad]
Seat 1: gor580 folded before Flop (didn't bet)
Seat 2: SMNNKV13 folded before Flop (didn't bet)
Seat 3: vilemo20 folded before Flop (didn't bet)
Seat 4: siblye (button) collected ($2.01)
Seat 5: magdal28 (small blind) folded on the Flop
Seat 6: Musiqsoulchi (big blind) folded before Flop



PokerStars Hand #222952362184:  Hold'em No Limit ($0.05/$0.10 USD) - 2021/01/23 7:41:41 ET
Table 'Saito II' 6-max Seat #5 is the button
Seat 1: gor580 ($10.64 in chips) 
Seat 2: SMNNKV13 ($1.20 in chips) 
Seat 3: vilemo20 ($10 in chips) 
Seat 4: siblye ($16.94 in chips) 
Seat 5: magdal28 ($10 in chips) 
Seat 6: Musiqsoulchi ($10.73 in chips) 
Musiqsoulchi: posts small blind $0.05
gor580: posts big blind $0.10
*** HOLE CARDS ***
SMNNKV13: folds 
vilemo20: folds 
siblye: folds 
magdal28: folds 
Musiqsoulchi: calls $0.05
gor580: checks 
*** FLOP *** [5s Jc Kh]
Musiqsoulchi: checks 
gor580: bets $0.13
Musiqsoulchi: folds 
Uncalled bet ($0.13) returned to gor580
gor580 collected $0.19 from pot
gor580: doesn't show hand 
*** SUMMARY ***
Total pot $0.20 | Rake $0.01 
Board [5s Jc Kh]
Seat 1: gor580 (big blind) collected ($0.19)
Seat 2: SMNNKV13 folded before Flop (didn't bet)
Seat 3: vilemo20 folded before Flop (didn't bet)
Seat 4: siblye folded before Flop (didn't bet)
Seat 5: magdal28 (button) folded before Flop (didn't bet)
Seat 6: Musiqsoulchi (small blind) folded on the Flop



PokerStars Hand #222952371791:  Hold'em No Limit ($0.05/$0.10 USD) - 2021/01/23 7:42:06 ET
Table 'Saito II' 6-max Seat #6 is the button
Seat 1: gor580 ($10.73 in chips) 
Seat 2: SMNNKV13 ($1.20 in chips) 
Seat 3: vilemo20 ($10 in chips) 
Seat 4: siblye ($16.94 in chips) 
Seat 5: magdal28 ($10 in chips) 
Seat 6: Musiqsoulchi ($10.63 in chips) 
gor580: posts small blind $0.05
SMNNKV13: posts big blind $0.10
*** HOLE CARDS ***
vilemo20: folds 
siblye: folds 
magdal28: folds 
Musiqsoulchi: folds 
gor580: folds 
Uncalled bet ($0.05) returned to SMNNKV13
SMNNKV13 collected $0.10 from pot
SMNNKV13: doesn't show hand 
*** SUMMARY ***
Total pot $0.10 | Rake $0 
Seat 1: gor580 (small blind) folded before Flop
Seat 2: SMNNKV13 (big blind) collected ($0.10)
Seat 3: vilemo20 folded before Flop (didn't bet)
Seat 4: siblye folded before Flop (didn't bet)
Seat 5: magdal28 folded before Flop (didn't bet)
Seat 6: Musiqsoulchi (button) folded before Flop (didn't bet)



PokerStars Hand #222952374952:  Hold'em No Limit ($0.05/$0.10 USD) - 2021/01/23 7:42:15 ET
Table 'Saito II' 6-max Seat #1 is the button
Seat 1: gor580 ($10.68 in chips) 
Seat 2: SMNNKV13 ($1.25 in chips) 
Seat 3: vilemo20 ($10 in chips) 
Seat 4: siblye ($16.94 in chips) 
Seat 5: magdal28 ($10 in chips) 
Seat 6: Musiqsoulchi ($10.63 in chips) 
SMNNKV13: posts small blind $0.05
vilemo20: posts big blind $0.10
*** HOLE CARDS ***
siblye: raises $0.20 to $0.30
magdal28: folds 
Musiqsoulchi: folds 
gor580: folds 
SMNNKV13: folds 
vilemo20: folds 
Uncalled bet ($0.20) returned to siblye
siblye collected $0.25 from pot
siblye: doesn't show hand 
*** SUMMARY ***
Total pot $0.25 | Rake $0 
Seat 1: gor580 (button) folded before Flop (didn't bet)
Seat 2: SMNNKV13 (small blind) folded before Flop
Seat 3: vilemo20 (big blind) folded before Flop
Seat 4: siblye collected ($0.25)
Seat 5: magdal28 folded before Flop (didn't bet)
Seat 6: Musiqsoulchi folded before Flop (didn't bet)



PokerStars Hand #222953604963:  Hold'em No Limit ($0.05/$0.10 USD) - 2021/01/23 8:33:18 ET
Table 'Saito II' 6-max Seat #2 is the button
Seat 2: Tyoma_Kovach ($10 in chips) 
Seat 4: jayzz6 ($19.89 in chips) 
Seat 6: Enricola ($32.17 in chips) 
jayzz6: posts small blind $0.05
Enricola: posts big blind $0.10
*** HOLE CARDS ***
Tyoma_Kovach: folds 
jayzz6: raises $0.20 to $0.30
Enricola: calls $0.20
*** FLOP *** [9h Qc Th]
jayzz6: checks 
Enricola: bets $0.29
jayzz6: calls $0.29
*** TURN *** [9h Qc Th] [2d]
jayzz6: checks 
Enricola: checks 
*** RIVER *** [9h Qc Th 2d] [8s]
jayzz6: checks 
Enricola: checks 
*** SHOW DOWN ***
jayzz6: shows [2c Kc] (a pair of Deuces)
Enricola: mucks hand 
jayzz6 collected $1.13 from pot
*** SUMMARY ***
Total pot $1.18 | Rake $0.05 
Board [9h Qc Th 2d 8s]
Seat 2: Tyoma_Kovach (button) folded before Flop (didn't bet)
Seat 4: jayzz6 (small blind) showed [2c Kc] and won ($1.13) with a pair of Deuces
Seat 6: Enricola (big blind) mucked



PokerStars Hand #222953618312:  Hold'em No Limit ($0.05/$0.10 USD) - 2021/01/23 8:33:48 ET
Table 'Saito II' 6-max Seat #4 is the button
Seat 2: Tyoma_Kovach ($10 in chips) 
Seat 4: jayzz6 ($20.43 in chips) 
Seat 6: Enricola ($31.58 in chips) 
Enricola: posts small blind $0.05
Tyoma_Kovach: posts big blind $0.10
*** HOLE CARDS ***
jayzz6: folds 
Enricola: folds 
Uncalled bet ($0.05) returned to Tyoma_Kovach
Tyoma_Kovach collected $0.10 from pot
Tyoma_Kovach: doesn't show hand 
*** SUMMARY ***
Total pot $0.10 | Rake $0 
Seat 2: Tyoma_Kovach (big blind) collected ($0.10)
Seat 4: jayzz6 (button) folded before Flop (didn't bet)
Seat 6: Enricola (small blind) folded before Flop



PokerStars Hand #222952378735:  Hold'em No Limit ($0.05/$0.10 USD) - 2021/01/23 7:42:25 ET
Table 'Saito II' 6-max Seat #2 is the button
Seat 1: gor580 ($10.68 in chips) 
Seat 2: SMNNKV13 ($1.20 in chips) 
Seat 3: vilemo20 ($10 in chips) 
Seat 4: siblye ($17.09 in chips) 
Seat 5: magdal28 ($10 in chips) 
Seat 6: Musiqsoulchi ($10.63 in chips) 
vilemo20: posts small blind $0.05
siblye: posts big blind $0.10
*** HOLE CARDS ***
magdal28: folds 
Musiqsoulchi has timed out
Musiqsoulchi: folds 
gor580: folds 
SMNNKV13: folds 
Musiqsoulchi leaves the table
vilemo20: folds 
Uncalled bet ($0.05) returned to siblye
siblye collected $0.10 from pot
siblye: doesn't show hand 
*** SUMMARY ***
Total pot $0.10 | Rake $0 
Seat 1: gor580 folded before Flop (didn't bet)
Seat 2: SMNNKV13 (button) folded before Flop (didn't bet)
Seat 3: vilemo20 (small blind) folded before Flop
Seat 4: siblye (big blind) collected ($0.10)
Seat 5: magdal28 folded before Flop (didn't bet)
Seat 6: Musiqsoulchi folded before Flop (didn't bet)



PokerStars Hand #222953620478:  Hold'em No Limit ($0.05/$0.10 USD) - 2021/01/23 8:33:53 ET
Table 'Saito II' 6-max Seat #6 is the button
Seat 2: Tyoma_Kovach ($10.05 in chips) 
Seat 4: jayzz6 ($20.43 in chips) 
Seat 6: Enricola ($31.53 in chips) 
Tyoma_Kovach: posts small blind $0.05
jayzz6: posts big blind $0.10
*** HOLE CARDS ***
Enricola: raises $0.25 to $0.35
Tyoma_Kovach: folds 
jayzz6: folds 
Uncalled bet ($0.25) returned to Enricola
Enricola collected $0.25 from pot
Enricola: doesn't show hand 
*** SUMMARY ***
Total pot $0.25 | Rake $0 
Seat 2: Tyoma_Kovach (small blind) folded before Flop
Seat 4: jayzz6 (big blind) folded before Flop
Seat 6: Enricola (button) collected ($0.25)



PokerStars Hand #222952387172:  Hold'em No Limit ($0.05/$0.10 USD) - 2021/01/23 7:42:47 ET
Table 'Saito II' 6-max Seat #3 is the button
Seat 1: gor580 ($10.68 in chips) 
Seat 2: SMNNKV13 ($1.20 in chips) 
Seat 3: vilemo20 ($10 in chips) 
Seat 4: siblye ($17.14 in chips) 
Seat 5: magdal28 ($10 in chips) 
siblye: posts small blind $0.05
magdal28: posts big blind $0.10
*** HOLE CARDS ***
gor580: folds 
SMNNKV13: folds 
vilemo20: folds 
siblye: folds 
Uncalled bet ($0.05) returned to magdal28
magdal28 collected $0.10 from pot
magdal28: doesn't show hand 
*** SUMMARY ***
Total pot $0.10 | Rake $0 
Seat 1: gor580 folded before Flop (didn't bet)
Seat 2: SMNNKV13 folded before Flop (didn't bet)
Seat 3: vilemo20 (button) folded before Flop (didn't bet)
Seat 4: siblye (small blind) folded before Flop
Seat 5: magdal28 (big blind) collected ($0.10)



PokerStars Hand #222953624787:  Hold'em No Limit ($0.05/$0.10 USD) - 2021/01/23 8:34:03 ET
Table 'Saito II' 6-max Seat #2 is the button
Seat 2: Tyoma_Kovach ($10 in chips) 
Seat 4: jayzz6 ($20.33 in chips) 
Seat 6: Enricola ($31.68 in chips) 
jayzz6: posts small blind $0.05
Enricola: posts big blind $0.10
*** HOLE CARDS ***
Tyoma_Kovach: raises $0.15 to $0.25
jayzz6: folds 
Enricola: calls $0.15
*** FLOP *** [Jc Qd 4c]
Enricola: checks 
sigu0540 joins the table at seat #1 
Tyoma_Kovach: bets $0.17
Enricola: calls $0.17
*** TURN *** [Jc Qd 4c] [3h]
Enricola: checks 
Tyoma_Kovach: bets $0.64
Enricola: calls $0.64
*** RIVER *** [Jc Qd 4c 3h] [8s]
Enricola: checks 
Tyoma_Kovach: checks 
*** SHOW DOWN ***
Enricola: shows [2d 2s] (a pair of Deuces)
Tyoma_Kovach: shows [Qs 9s] (a pair of Queens)
Tyoma_Kovach collected $2.07 from pot
*** SUMMARY ***
Total pot $2.17 | Rake $0.10 
Board [Jc Qd 4c 3h 8s]
Seat 2: Tyoma_Kovach (button) showed [Qs 9s] and won ($2.07) with a pair of Queens
Seat 4: jayzz6 (small blind) folded before Flop
Seat 6: Enricola (big blind) showed [2d 2s] and lost with a pair of Deuces



PokerStars Hand #222952390206:  Hold'em No Limit ($0.05/$0.10 USD) - 2021/01/23 7:42:55 ET
Table 'Saito II' 6-max Seat #4 is the button
Seat 1: gor580 ($10.68 in chips) 
Seat 2: SMNNKV13 ($1.20 in chips) 
Seat 3: vilemo20 ($10 in chips) 
Seat 4: siblye ($17.09 in chips) 
Seat 5: magdal28 ($10.05 in chips) 
magdal28: posts small blind $0.05
gor580: posts big blind $0.10
*** HOLE CARDS ***
Smertobro joins the table at seat #6 
SMNNKV13: folds 
vilemo20: folds 
siblye: raises $0.20 to $0.30
magdal28: calls $0.25
gor580: folds 
*** FLOP *** [5s Jc 3c]
Smertobro leaves the table
magdal28: checks 
siblye: checks 
*** TURN *** [5s Jc 3c] [Qs]
magdal28: checks 
siblye: checks 
*** RIVER *** [5s Jc 3c Qs] [5d]
magdal28: checks 
siblye: bets $0.34
magdal28: folds 
Uncalled bet ($0.34) returned to siblye
siblye collected $0.67 from pot
siblye: doesn't show hand 
*** SUMMARY ***
Total pot $0.70 | Rake $0.03 
Board [5s Jc 3c Qs 5d]
Seat 1: gor580 (big blind) folded before Flop
Seat 2: SMNNKV13 folded before Flop (didn't bet)
Seat 3: vilemo20 folded before Flop (didn't bet)
Seat 4: siblye (button) collected ($0.67)
Seat 5: magdal28 (small blind) folded on the River



PokerStars Hand #222953641969:  Hold'em No Limit ($0.05/$0.10 USD) - 2021/01/23 8:34:41 ET
Table 'Saito II' 6-max Seat #4 is the button
Seat 1: sigu0540 ($10 in chips) 
Seat 2: Tyoma_Kovach ($11.01 in chips) 
Seat 4: jayzz6 ($20.28 in chips) 
Seat 6: Enricola ($30.62 in chips) 
Enricola: posts small blind $0.05
sigu0540: posts big blind $0.10
*** HOLE CARDS ***
Tyoma_Kovach: folds 
meirenxingde leaves the table
jayzz6: folds 
Enricola: raises $0.20 to $0.30
sigu0540: raises $0.60 to $0.90
Enricola: calls $0.60
*** FLOP *** [7c 7d 5d]
Enricola: checks 
sigu0540: bets $0.65
Enricola: calls $0.65
*** TURN *** [7c 7d 5d] [2d]
Enricola: checks 
sigu0540: bets $1.25
Enricola: folds 
Uncalled bet ($1.25) returned to sigu0540
sigu0540 collected $2.96 from pot
sigu0540: doesn't show hand 
*** SUMMARY ***
Total pot $3.10 | Rake $0.14 
Board [7c 7d 5d 2d]
Seat 1: sigu0540 (big blind) collected ($2.96)
Seat 2: Tyoma_Kovach folded before Flop (didn't bet)
Seat 4: jayzz6 (button) folded before Flop (didn't bet)
Seat 6: Enricola (small blind) folded on the Turn



PokerStars Hand #222952406175:  Hold'em No Limit ($0.05/$0.10 USD) - 2021/01/23 7:43:37 ET
Table 'Saito II' 6-max Seat #5 is the button
Seat 1: gor580 ($10.58 in chips) 
Seat 2: SMNNKV13 ($1.20 in chips) 
Seat 3: vilemo20 ($10 in chips) 
Seat 4: siblye ($17.46 in chips) 
Seat 5: magdal28 ($10 in chips) 
gor580: posts small blind $0.05
SMNNKV13: posts big blind $0.10
*** HOLE CARDS ***
vilemo20: folds 
siblye: calls $0.10
magdal28: folds 
gor580: folds 
SMNNKV13: checks 
*** FLOP *** [Ad 6h 8c]
Edgarlucky joins the table at seat #6 
SMNNKV13: checks 
siblye: bets $0.10
SMNNKV13: calls $0.10
*** TURN *** [Ad 6h 8c] [Kc]
SMNNKV13: checks 
siblye: bets $0.22
SMNNKV13: folds 
Uncalled bet ($0.22) returned to siblye
siblye collected $0.43 from pot
siblye: doesn't show hand 
*** SUMMARY ***
Total pot $0.45 | Rake $0.02 
Board [Ad 6h 8c Kc]
Seat 1: gor580 (small blind) folded before Flop
Seat 2: SMNNKV13 (big blind) folded on the Turn
Seat 3: vilemo20 folded before Flop (didn't bet)
Seat 4: siblye collected ($0.43)
Seat 5: magdal28 (button) folded before Flop (didn't bet)



PokerStars Hand #222953662939:  Hold'em No Limit ($0.05/$0.10 USD) - 2021/01/23 8:35:28 ET
Table 'Saito II' 6-max Seat #6 is the button
Seat 1: sigu0540 ($11.41 in chips) 
Seat 2: Tyoma_Kovach ($11.01 in chips) 
Seat 4: jayzz6 ($20.28 in chips) 
Seat 6: Enricola ($29.07 in chips) 
sigu0540: posts small blind $0.05
Tyoma_Kovach: posts big blind $0.10
*** HOLE CARDS ***
jayzz6: folds 
Enricola: raises $0.25 to $0.35
sigu0540: calls $0.30
Tyoma_Kovach: folds 
*** FLOP *** [Qh Ac 8s]
sigu0540: checks 
Enricola: bets $0.50
sigu0540: raises $0.88 to $1.38
Enricola: calls $0.88
*** TURN *** [Qh Ac 8s] [3c]
sigu0540: bets $1.70
Enricola: calls $1.70
*** RIVER *** [Qh Ac 8s 3c] [5s]
sigu0540: bets $7.98 and is all-in
SERG244 joins the table at seat #3 
Enricola: folds 
Uncalled bet ($7.98) returned to sigu0540
sigu0540 collected $6.65 from pot
sigu0540: doesn't show hand 
Jesus Ololo joins the table at seat #5 
*** SUMMARY ***
Total pot $6.96 | Rake $0.31 
Board [Qh Ac 8s 3c 5s]
Seat 1: sigu0540 (small blind) collected ($6.65)
Seat 2: Tyoma_Kovach (big blind) folded before Flop
Seat 4: jayzz6 folded before Flop (didn't bet)
Seat 6: Enricola (button) folded on the River



PokerStars Hand #222952420951:  Hold'em No Limit ($0.05/$0.10 USD) - 2021/01/23 7:44:16 ET
Table 'Saito II' 6-max Seat #1 is the button
Seat 1: gor580 ($10.53 in chips) 
Seat 2: SMNNKV13 ($1 in chips) 
Seat 3: vilemo20 ($10 in chips) 
Seat 4: siblye ($17.69 in chips) 
Seat 5: magdal28 ($10 in chips) 
SMNNKV13: posts small blind $0.05
vilemo20: posts big blind $0.10
Edgarlucky: sits out 
*** HOLE CARDS ***
siblye: folds 
magdal28: raises $0.15 to $0.25
gor580: folds 
SMNNKV13: calls $0.20
vilemo20: folds 
*** FLOP *** [Jc 3h 8d]
SMNNKV13: checks 
magdal28: bets $0.30
Edgarlucky leaves the table
SMNNKV13: calls $0.30
*** TURN *** [Jc 3h 8d] [2h]
SMNNKV13: checks 
magdal28: bets $0.60
SMNNKV13: folds 
Uncalled bet ($0.60) returned to magdal28
magdal28 collected $1.15 from pot
magdal28: doesn't show hand 
*** SUMMARY ***
Total pot $1.20 | Rake $0.05 
Board [Jc 3h 8d 2h]
Seat 1: gor580 (button) folded before Flop (didn't bet)
Seat 2: SMNNKV13 (small blind) folded on the Turn
Seat 3: vilemo20 (big blind) folded before Flop
Seat 4: siblye folded before Flop (didn't bet)
Seat 5: magdal28 collected ($1.15)



PokerStars Hand #222953687369:  Hold'em No Limit ($0.05/$0.10 USD) - 2021/01/23 8:36:23 ET
Table 'Saito II' 6-max Seat #1 is the button
Seat 1: sigu0540 ($14.63 in chips) 
Seat 2: Tyoma_Kovach ($10.91 in chips) 
Seat 3: SERG244 ($10 in chips) 
Seat 4: jayzz6 ($20.28 in chips) 
Seat 6: Enricola ($25.64 in chips) 
Tyoma_Kovach: posts small blind $0.05
SERG244: posts big blind $0.10
Jesus Ololo: sits out 
*** HOLE CARDS ***
jayzz6 has timed out
jayzz6: folds 
Enricola: folds 
sigu0540: raises $0.15 to $0.25
Tyoma_Kovach: folds 
SERG244: calls $0.15
*** FLOP *** [8d Jd 7c]
SERG244: checks 
sigu0540: checks 
*** TURN *** [8d Jd 7c] [3h]
SERG244: bets $0.35
sigu0540: folds 
Uncalled bet ($0.35) returned to SERG244
SERG244 collected $0.53 from pot
SERG244: doesn't show hand 
*** SUMMARY ***
Total pot $0.55 | Rake $0.02 
Board [8d Jd 7c 3h]
Seat 1: sigu0540 (button) folded on the Turn
Seat 2: Tyoma_Kovach (small blind) folded before Flop
Seat 3: SERG244 (big blind) collected ($0.53)
Seat 4: jayzz6 folded before Flop (didn't bet)
Seat 6: Enricola folded before Flop (didn't bet)



PokerStars Hand #222952438100:  Hold'em No Limit ($0.05/$0.10 USD) - 2021/01/23 7:45:01 ET
Table 'Saito II' 6-max Seat #2 is the button
Seat 1: gor580 ($10.53 in chips) 
Seat 2: SMNNKV13 ($0.45 in chips) 
Seat 3: vilemo20 ($10 in chips) 
Seat 4: siblye ($17.69 in chips) 
Seat 5: magdal28 ($10.60 in chips) 
vilemo20: posts small blind $0.05
siblye: posts big blind $0.10
*** HOLE CARDS ***
magdal28: raises $0.15 to $0.25
gor580: folds 
SMNNKV13: folds 
vilemo20: folds 
siblye: folds 
Uncalled bet ($0.15) returned to magdal28
magdal28 collected $0.25 from pot
magdal28: doesn't show hand 
*** SUMMARY ***
Total pot $0.25 | Rake $0 
Seat 1: gor580 folded before Flop (didn't bet)
Seat 2: SMNNKV13 (button) folded before Flop (didn't bet)
Seat 3: vilemo20 (small blind) folded before Flop
Seat 4: siblye (big blind) folded before Flop
Seat 5: magdal28 collected ($0.25)



PokerStars Hand #222953702942:  Hold'em No Limit ($0.05/$0.10 USD) - 2021/01/23 8:36:58 ET
Table 'Saito II' 6-max Seat #2 is the button
Seat 1: sigu0540 ($14.38 in chips) 
Seat 2: Tyoma_Kovach ($10.86 in chips) 
Seat 3: SERG244 ($10.28 in chips) 
Seat 5: Jesus Ololo ($10 in chips) 
Seat 6: Enricola ($25.64 in chips) 
SERG244: posts small blind $0.05
Jesus Ololo: posts big blind $0.10
*** HOLE CARDS ***
Enricola: raises $0.25 to $0.35
sigu0540: folds 
Tyoma_Kovach: folds 
SERG244: folds 
Jesus Ololo: calls $0.25
*** FLOP *** [Kc 9s 9c]
Jesus Ololo: checks 
Enricola: bets $0.40
Jesus Ololo: calls $0.40
*** TURN *** [Kc 9s 9c] [6s]
Jesus Ololo: checks 
Enricola: bets $0.90
Jesus Ololo: calls $0.90
*** RIVER *** [Kc 9s 9c 6s] [Kh]
Jesus Ololo: checks 
Enricola: bets $2
Jesus Ololo: folds 
Uncalled bet ($2) returned to Enricola
Enricola collected $3.20 from pot
Enricola: doesn't show hand 
*** SUMMARY ***
Total pot $3.35 | Rake $0.15 
Board [Kc 9s 9c 6s Kh]
Seat 1: sigu0540 folded before Flop (didn't bet)
Seat 2: Tyoma_Kovach (button) folded before Flop (didn't bet)
Seat 3: SERG244 (small blind) folded before Flop
Seat 5: Jesus Ololo (big blind) folded on the River
Seat 6: Enricola collected ($3.20)



PokerStars Hand #222952444071:  Hold'em No Limit ($0.05/$0.10 USD) - 2021/01/23 7:45:16 ET
Table 'Saito II' 6-max Seat #3 is the button
Seat 1: gor580 ($10.53 in chips) 
Seat 2: SMNNKV13 ($0.45 in chips) 
Seat 3: vilemo20 ($10 in chips) 
Seat 4: siblye ($17.59 in chips) 
Seat 5: magdal28 ($10.75 in chips) 
siblye: posts small blind $0.05
magdal28: posts big blind $0.10
*** HOLE CARDS ***
gor580: folds 
täng joins the table at seat #6 
SMNNKV13: folds 
vilemo20: folds 
siblye: folds 
Uncalled bet ($0.05) returned to magdal28
magdal28 collected $0.10 from pot
magdal28: doesn't show hand 
*** SUMMARY ***
Total pot $0.10 | Rake $0 
Seat 1: gor580 folded before Flop (didn't bet)
Seat 2: SMNNKV13 folded before Flop (didn't bet)
Seat 3: vilemo20 (button) folded before Flop (didn't bet)
Seat 4: siblye (small blind) folded before Flop
Seat 5: magdal28 (big blind) collected ($0.10)



PokerStars Hand #222953716897:  Hold'em No Limit ($0.05/$0.10 USD) - 2021/01/23 8:37:29 ET
Table 'Saito II' 6-max Seat #3 is the button
Seat 1: sigu0540 ($14.38 in chips) 
Seat 2: Tyoma_Kovach ($10.86 in chips) 
Seat 3: SERG244 ($10.23 in chips) 
Seat 5: Jesus Ololo ($10 in chips) 
Seat 6: Enricola ($27.19 in chips) 
Jesus Ololo: posts small blind $0.05
Enricola: posts big blind $0.10
*** HOLE CARDS ***
sigu0540: folds 
Tyoma_Kovach: raises $0.18 to $0.28
SERG244: folds 
Jesus Ololo: calls $0.23
Enricola: calls $0.18
*** FLOP *** [9s Jh 5h]
Jesus Ololo: checks 
Enricola: checks 
Tyoma_Kovach: checks 
*** TURN *** [9s Jh 5h] [3h]
Jesus Ololo: checks 
Enricola: checks 
Tyoma_Kovach: checks 
*** RIVER *** [9s Jh 5h 3h] [2h]
Jesus Ololo: checks 
Enricola: bets $0.40
Tyoma_Kovach: folds 
Jesus Ololo: folds 
Uncalled bet ($0.40) returned to Enricola
Enricola collected $0.80 from pot
Enricola: doesn't show hand 
*** SUMMARY ***
Total pot $0.84 | Rake $0.04 
Board [9s Jh 5h 3h 2h]
Seat 1: sigu0540 folded before Flop (didn't bet)
Seat 2: Tyoma_Kovach folded on the River
Seat 3: SERG244 (button) folded before Flop (didn't bet)
Seat 5: Jesus Ololo (small blind) folded on the River
Seat 6: Enricola (big blind) collected ($0.80)



PokerStars Hand #222952448121:  Hold'em No Limit ($0.05/$0.10 USD) - 2021/01/23 7:45:26 ET
Table 'Saito II' 6-max Seat #4 is the button
Seat 1: gor580 ($10.53 in chips) 
Seat 2: SMNNKV13 ($0.45 in chips) 
Seat 3: vilemo20 ($10 in chips) 
Seat 4: siblye ($17.54 in chips) 
Seat 5: magdal28 ($10.80 in chips) 
Seat 6: täng ($5 in chips) 
magdal28: posts small blind $0.05
täng: posts big blind $0.10
*** HOLE CARDS ***
gor580: folds 
SMNNKV13: folds 
vilemo20: folds 
siblye: folds 
magdal28: raises $0.15 to $0.25
täng: folds 
Uncalled bet ($0.15) returned to magdal28
magdal28 collected $0.20 from pot
magdal28: doesn't show hand 
*** SUMMARY ***
Total pot $0.20 | Rake $0 
Seat 1: gor580 folded before Flop (didn't bet)
Seat 2: SMNNKV13 folded before Flop (didn't bet)
Seat 3: vilemo20 folded before Flop (didn't bet)
Seat 4: siblye (button) folded before Flop (didn't bet)
Seat 5: magdal28 (small blind) collected ($0.20)
Seat 6: täng (big blind) folded before Flop



PokerStars Hand #222953730770:  Hold'em No Limit ($0.05/$0.10 USD) - 2021/01/23 8:38:01 ET
Table 'Saito II' 6-max Seat #5 is the button
Seat 1: sigu0540 ($14.38 in chips) 
Seat 2: Tyoma_Kovach ($10.58 in chips) 
Seat 3: SERG244 ($10.23 in chips) 
Seat 5: Jesus Ololo ($10 in chips) 
Seat 6: Enricola ($27.71 in chips) 
Enricola: posts small blind $0.05
sigu0540: posts big blind $0.10
*** HOLE CARDS ***
Tyoma_Kovach: folds 
SERG244: folds 
Jesus Ololo: folds 
Enricola: raises $0.20 to $0.30
sigu0540: calls $0.20
*** FLOP *** [Ac 9c 3c]
Enricola: bets $0.29
jayzz6 leaves the table
sigu0540: calls $0.29
*** TURN *** [Ac 9c 3c] [Qd]
Enricola: bets $0.57
sigu0540: calls $0.57
*** RIVER *** [Ac 9c 3c Qd] [6h]
Enricola: bets $2.22
sigu0540: calls $2.22
*** SHOW DOWN ***
Enricola: shows [Jd Kh] (high card Ace)
sigu0540: shows [Qs 3s] (two pair, Queens and Threes)
sigu0540 collected $6.46 from pot
*** SUMMARY ***
Total pot $6.76 | Rake $0.30 
Board [Ac 9c 3c Qd 6h]
Seat 1: sigu0540 (big blind) showed [Qs 3s] and won ($6.46) with two pair, Queens and Threes
Seat 2: Tyoma_Kovach folded before Flop (didn't bet)
Seat 3: SERG244 folded before Flop (didn't bet)
Seat 5: Jesus Ololo (button) folded before Flop (didn't bet)
Seat 6: Enricola (small blind) showed [Jd Kh] and lost with high card Ace



PokerStars Hand #222952456005:  Hold'em No Limit ($0.05/$0.10 USD) - 2021/01/23 7:45:47 ET
Table 'Saito II' 6-max Seat #5 is the button
Seat 1: gor580 ($10.53 in chips) 
Seat 2: SMNNKV13 ($0.45 in chips) 
Seat 3: vilemo20 ($10 in chips) 
Seat 4: siblye ($17.54 in chips) 
Seat 5: magdal28 ($10.90 in chips) 
Seat 6: täng ($4.90 in chips) 
täng: posts small blind $0.05
gor580: posts big blind $0.10
*** HOLE CARDS ***
SMNNKV13: folds 
vilemo20: raises $0.20 to $0.30
siblye: folds 
magdal28: folds 
täng: calls $0.25
gor580: folds 
*** FLOP *** [7s 2h Jh]
täng: checks 
vilemo20: checks 
*** TURN *** [7s 2h Jh] [2d]
täng: checks 
vilemo20: bets $0.35
täng: folds 
Uncalled bet ($0.35) returned to vilemo20
vilemo20 collected $0.67 from pot
vilemo20: doesn't show hand 
*** SUMMARY ***
Total pot $0.70 | Rake $0.03 
Board [7s 2h Jh 2d]
Seat 1: gor580 (big blind) folded before Flop
Seat 2: SMNNKV13 folded before Flop (didn't bet)
Seat 3: vilemo20 collected ($0.67)
Seat 4: siblye folded before Flop (didn't bet)
Seat 5: magdal28 (button) folded before Flop (didn't bet)
Seat 6: täng (small blind) folded on the Turn



PokerStars Hand #222953743578:  Hold'em No Limit ($0.05/$0.10 USD) - 2021/01/23 8:38:30 ET
Table 'Saito II' 6-max Seat #6 is the button
Seat 1: sigu0540 ($17.46 in chips) 
Seat 2: Tyoma_Kovach ($10.58 in chips) 
Seat 3: SERG244 ($10.23 in chips) 
Seat 5: Jesus Ololo ($10 in chips) 
Seat 6: Enricola ($24.33 in chips) 
sigu0540: posts small blind $0.05
Tyoma_Kovach: posts big blind $0.10
*** HOLE CARDS ***
SERG244: raises $0.16 to $0.26
Jesus Ololo: folds 
Enricola: folds 
Onestop4u joins the table at seat #4 
sigu0540: folds 
Tyoma_Kovach: calls $0.16
*** FLOP *** [7d Qd 7c]
Tyoma_Kovach: checks 
SERG244: checks 
*** TURN *** [7d Qd 7c] [9c]
Tyoma_Kovach: checks 
SERG244: bets $0.36
Tyoma_Kovach: calls $0.36
*** RIVER *** [7d Qd 7c 9c] [6d]
Tyoma_Kovach: checks 
SERG244: bets $0.82
Tyoma_Kovach: calls $0.82
*** SHOW DOWN ***
SERG244: shows [Jh Kd] (a pair of Sevens)
Tyoma_Kovach: shows [4d 3d] (a flush, Queen high)
Tyoma_Kovach collected $2.80 from pot
*** SUMMARY ***
Total pot $2.93 | Rake $0.13 
Board [7d Qd 7c 9c 6d]
Seat 1: sigu0540 (small blind) folded before Flop
Seat 2: Tyoma_Kovach (big blind) showed [4d 3d] and won ($2.80) with a flush, Queen high
Seat 3: SERG244 showed [Jh Kd] and lost with a pair of Sevens
Seat 5: Jesus Ololo folded before Flop (didn't bet)
Seat 6: Enricola (button) folded before Flop (didn't bet)



PokerStars Hand #222952470876:  Hold'em No Limit ($0.05/$0.10 USD) - 2021/01/23 7:46:26 ET
Table 'Saito II' 6-max Seat #6 is the button
Seat 1: gor580 ($10.43 in chips) 
Seat 2: SMNNKV13 ($0.45 in chips) 
Seat 3: vilemo20 ($10.37 in chips) 
Seat 4: siblye ($17.54 in chips) 
Seat 5: magdal28 ($10.90 in chips) 
Seat 6: täng ($4.60 in chips) 
gor580: posts small blind $0.05
SMNNKV13: posts big blind $0.10
*** HOLE CARDS ***
vilemo20: folds 
vilemo20 leaves the table
siblye: raises $0.20 to $0.30
magdal28: folds 
täng: folds 
gor580: folds 
SMNNKV13: calls $0.20
*** FLOP *** [Kd 2h 5d]
SMNNKV13: bets $0.15 and is all-in
siblye: calls $0.15
*** TURN *** [Kd 2h 5d] [Js]
*** RIVER *** [Kd 2h 5d Js] [Td]
*** SHOW DOWN ***
SMNNKV13: shows [5s 8s] (a pair of Fives)
siblye: shows [3d 4d] (a flush, King high)
siblye collected $0.91 from pot
*** SUMMARY ***
Total pot $0.95 | Rake $0.04 
Board [Kd 2h 5d Js Td]
Seat 1: gor580 (small blind) folded before Flop
Seat 2: SMNNKV13 (big blind) showed [5s 8s] and lost with a pair of Fives
Seat 3: vilemo20 folded before Flop (didn't bet)
Seat 4: siblye showed [3d 4d] and won ($0.91) with a flush, King high
Seat 5: magdal28 folded before Flop (didn't bet)
Seat 6: täng (button) folded before Flop (didn't bet)



PokerStars Hand #222953761096:  Hold'em No Limit ($0.05/$0.10 USD) - 2021/01/23 8:39:09 ET
Table 'Saito II' 6-max Seat #1 is the button
Seat 1: sigu0540 ($17.41 in chips) 
Seat 2: Tyoma_Kovach ($11.94 in chips) 
Seat 3: SERG244 ($10 in chips) 
Seat 5: Jesus Ololo ($10 in chips) 
Seat 6: Enricola ($24.33 in chips) 
Tyoma_Kovach: posts small blind $0.05
SERG244: posts big blind $0.10
Onestop4u: sits out 
*** HOLE CARDS ***
Jesus Ololo: folds 
Enricola: raises $0.25 to $0.35
sigu0540: folds 
Tyoma_Kovach: folds 
SERG244: folds 
Uncalled bet ($0.25) returned to Enricola
Enricola collected $0.25 from pot
Enricola: doesn't show hand 
*** SUMMARY ***
Total pot $0.25 | Rake $0 
Seat 1: sigu0540 (button) folded before Flop (didn't bet)
Seat 2: Tyoma_Kovach (small blind) folded before Flop
Seat 3: SERG244 (big blind) folded before Flop
Seat 5: Jesus Ololo folded before Flop (didn't bet)
Seat 6: Enricola collected ($0.25)



PokerStars Hand #222952484167:  Hold'em No Limit ($0.05/$0.10 USD) - 2021/01/23 7:47:00 ET
Table 'Saito II' 6-max Seat #1 is the button
Seat 1: gor580 ($10.38 in chips) 
Seat 4: siblye ($18 in chips) 
Seat 5: magdal28 ($10.90 in chips) 
Seat 6: täng ($4.60 in chips) 
siblye: posts small blind $0.05
magdal28: posts big blind $0.10
*** HOLE CARDS ***
täng: raises $0.20 to $0.30
gor580: folds 
siblye: folds 
magdal28: folds 
Uncalled bet ($0.20) returned to täng
täng collected $0.25 from pot
täng: doesn't show hand 
*** SUMMARY ***
Total pot $0.25 | Rake $0 
Seat 1: gor580 (button) folded before Flop (didn't bet)
Seat 4: siblye (small blind) folded before Flop
Seat 5: magdal28 (big blind) folded before Flop
Seat 6: täng collected ($0.25)



PokerStars Hand #222953766585:  Hold'em No Limit ($0.05/$0.10 USD) - 2021/01/23 8:39:21 ET
Table 'Saito II' 6-max Seat #2 is the button
Seat 1: sigu0540 ($17.41 in chips) 
Seat 2: Tyoma_Kovach ($11.89 in chips) 
Seat 3: SERG244 ($10 in chips) 
Seat 4: Onestop4u ($10 in chips) 
Seat 5: Jesus Ololo ($10 in chips) 
Seat 6: Enricola ($24.48 in chips) 
SERG244: posts small blind $0.05
Onestop4u: posts big blind $0.10
*** HOLE CARDS ***
Jesus Ololo: folds 
Enricola: raises $0.25 to $0.35
sigu0540: folds 
Tyoma_Kovach: calls $0.35
SERG244: folds 
Onestop4u: calls $0.25
*** FLOP *** [As Ah 3h]
sigu0540 leaves the table
Onestop4u: checks 
Enricola: bets $0.60
Tyoma_Kovach: folds 
Onestop4u: calls $0.60
*** TURN *** [As Ah 3h] [8c]
Onestop4u: checks 
Enricola: bets $1.10
Onestop4u: raises $1.10 to $2.20
Enricola: calls $1.10
*** RIVER *** [As Ah 3h 8c] [Jc]
Onestop4u: bets $6.40
Enricola: folds 
Uncalled bet ($6.40) returned to Onestop4u
Onestop4u collected $6.40 from pot
Onestop4u: doesn't show hand 
*** SUMMARY ***
Total pot $6.70 | Rake $0.30 
Board [As Ah 3h 8c Jc]
Seat 1: sigu0540 folded before Flop (didn't bet)
Seat 2: Tyoma_Kovach (button) folded on the Flop
Seat 3: SERG244 (small blind) folded before Flop
Seat 4: Onestop4u (big blind) collected ($6.40)
Seat 5: Jesus Ololo folded before Flop (didn't bet)
Seat 6: Enricola folded on the River



PokerStars Hand #222952487919:  Hold'em No Limit ($0.05/$0.10 USD) - 2021/01/23 7:47:10 ET
Table 'Saito II' 6-max Seat #4 is the button
Seat 1: gor580 ($10.38 in chips) 
Seat 4: siblye ($17.95 in chips) 
Seat 5: magdal28 ($10.80 in chips) 
Seat 6: täng ($4.75 in chips) 
magdal28: posts small blind $0.05
täng: posts big blind $0.10
*** HOLE CARDS ***
gor580: folds 
SMNNKV13 leaves the table
siblye: folds 
magdal28: folds 
Uncalled bet ($0.05) returned to täng
täng collected $0.10 from pot
täng: doesn't show hand 
*** SUMMARY ***
Total pot $0.10 | Rake $0 
Seat 1: gor580 folded before Flop (didn't bet)
Seat 4: siblye (button) folded before Flop (didn't bet)
Seat 5: magdal28 (small blind) folded before Flop
Seat 6: täng (big blind) collected ($0.10)



PokerStars Hand #222953784171:  Hold'em No Limit ($0.05/$0.10 USD) - 2021/01/23 8:40:00 ET
Table 'Saito II' 6-max Seat #3 is the button
Seat 2: Tyoma_Kovach ($11.54 in chips) 
Seat 3: SERG244 ($10 in chips) 
Seat 4: Onestop4u ($13.25 in chips) 
Seat 5: Jesus Ololo ($10 in chips) 
Seat 6: Enricola ($21.33 in chips) 
Onestop4u: posts small blind $0.05
Jesus Ololo: posts big blind $0.10
*** HOLE CARDS ***
Enricola: raises $0.25 to $0.35
Tyoma_Kovach: folds 
SERG244: folds 
manuell1996 joins the table at seat #1 
Onestop4u: folds 
Jesus Ololo: calls $0.25
*** FLOP *** [6h 4d 4s]
Jesus Ololo: checks 
Enricola: bets $0.36
Jesus Ololo: folds 
Uncalled bet ($0.36) returned to Enricola
Enricola collected $0.72 from pot
Enricola: doesn't show hand 
*** SUMMARY ***
Total pot $0.75 | Rake $0.03 
Board [6h 4d 4s]
Seat 2: Tyoma_Kovach folded before Flop (didn't bet)
Seat 3: SERG244 (button) folded before Flop (didn't bet)
Seat 4: Onestop4u (small blind) folded before Flop
Seat 5: Jesus Ololo (big blind) folded on the Flop
Seat 6: Enricola collected ($0.72)



PokerStars Hand #222952490788:  Hold'em No Limit ($0.05/$0.10 USD) - 2021/01/23 7:47:18 ET
Table 'Saito II' 6-max Seat #6 is the button
Seat 5: magdal28 ($10.75 in chips) 
Seat 6: täng ($4.80 in chips) 
täng: posts small blind $0.05
gor580: is sitting out 
siblye: is sitting out 
magdal28: posts big blind $0.10
*** HOLE CARDS ***
gor580 leaves the table
täng: folds 
Uncalled bet ($0.05) returned to magdal28
magdal28 collected $0.10 from pot
magdal28: doesn't show hand 
*** SUMMARY ***
Total pot $0.10 | Rake $0 
Seat 5: magdal28 (big blind) collected ($0.10)
Seat 6: täng (button) (small blind) folded before Flop



PokerStars Hand #222953792252:  Hold'em No Limit ($0.05/$0.10 USD) - 2021/01/23 8:40:18 ET
Table 'Saito II' 6-max Seat #4 is the button
Seat 1: manuell1996 ($10 in chips) 
Seat 2: Tyoma_Kovach ($11.54 in chips) 
Seat 3: SERG244 ($10 in chips) 
Seat 4: Onestop4u ($13.20 in chips) 
Seat 5: Jesus Ololo ($10 in chips) 
Seat 6: Enricola ($21.70 in chips) 
Jesus Ololo: posts small blind $0.05
Enricola: posts big blind $0.10
manuell1996: posts big blind $0.10
*** HOLE CARDS ***
manuell1996: checks 
Tyoma_Kovach: folds 
SERG244: folds 
Onestop4u: folds 
Jesus Ololo: calls $0.05
Enricola: raises $0.30 to $0.40
manuell1996: folds 
Jesus Ololo: calls $0.30
*** FLOP *** [Ah 6s 3c]
Jesus Ololo: checks 
Enricola: bets $0.86
Jesus Ololo: folds 
Uncalled bet ($0.86) returned to Enricola
Enricola collected $0.86 from pot
Enricola: doesn't show hand 
*** SUMMARY ***
Total pot $0.90 | Rake $0.04 
Board [Ah 6s 3c]
Seat 1: manuell1996 folded before Flop (didn't bet)
Seat 2: Tyoma_Kovach folded before Flop (didn't bet)
Seat 3: SERG244 folded before Flop (didn't bet)
Seat 4: Onestop4u (button) folded before Flop (didn't bet)
Seat 5: Jesus Ololo (small blind) folded on the Flop
Seat 6: Enricola (big blind) collected ($0.86)



PokerStars Hand #222952492920:  Hold'em No Limit ($0.05/$0.10 USD) - 2021/01/23 7:47:23 ET
Table 'Saito II' 6-max Seat #5 is the button
Seat 5: magdal28 ($10.80 in chips) 
Seat 6: täng ($4.75 in chips) 
magdal28: posts small blind $0.05
täng: posts big blind $0.10
*** HOLE CARDS ***
magdal28: folds 
Uncalled bet ($0.05) returned to täng
täng collected $0.10 from pot
täng: doesn't show hand 
*** SUMMARY ***
Total pot $0.10 | Rake $0 
Seat 5: magdal28 (button) (small blind) folded before Flop
Seat 6: täng (big blind) collected ($0.10)



PokerStars Hand #222953800651:  Hold'em No Limit ($0.05/$0.10 USD) - 2021/01/23 8:40:37 ET
Table 'Saito II' 6-max Seat #5 is the button
Seat 1: manuell1996 ($9.90 in chips) 
Seat 2: Tyoma_Kovach ($11.54 in chips) 
Seat 3: SERG244 ($10 in chips) 
Seat 4: Onestop4u ($13.20 in chips) 
Seat 5: Jesus Ololo ($10 in chips) 
Seat 6: Enricola ($22.16 in chips) 
Enricola: posts small blind $0.05
manuell1996: posts big blind $0.10
*** HOLE CARDS ***
Tyoma_Kovach: folds 
SERG244: folds 
Onestop4u: raises $0.10 to $0.20
Jesus Ololo: folds 
Enricola: folds 
manuell1996: folds 
Uncalled bet ($0.10) returned to Onestop4u
Onestop4u collected $0.25 from pot
Onestop4u: doesn't show hand 
*** SUMMARY ***
Total pot $0.25 | Rake $0 
Seat 1: manuell1996 (big blind) folded before Flop
Seat 2: Tyoma_Kovach folded before Flop (didn't bet)
Seat 3: SERG244 folded before Flop (didn't bet)
Seat 4: Onestop4u collected ($0.25)
Seat 5: Jesus Ololo (button) folded before Flop (didn't bet)
Seat 6: Enricola (small blind) folded before Flop



PokerStars Hand #222952499543:  Hold'em No Limit ($0.05/$0.10 USD) - 2021/01/23 7:47:40 ET
Table 'Saito II' 6-max Seat #6 is the button
Seat 1: Nickh147 ($10 in chips) 
Seat 6: täng ($4.80 in chips) 
täng: posts small blind $0.05
Nickh147: posts big blind $0.10
*** HOLE CARDS ***
täng: folds 
Uncalled bet ($0.05) returned to Nickh147
Nickh147 collected $0.10 from pot
Nickh147: doesn't show hand 
*** SUMMARY ***
Total pot $0.10 | Rake $0 
Seat 1: Nickh147 (big blind) collected ($0.10)
Seat 6: täng (button) (small blind) folded before Flop



PokerStars Hand #222953806148:  Hold'em No Limit ($0.05/$0.10 USD) - 2021/01/23 8:40:49 ET
Table 'Saito II' 6-max Seat #6 is the button
Seat 1: manuell1996 ($9.80 in chips) 
Seat 2: Tyoma_Kovach ($11.54 in chips) 
Seat 3: SERG244 ($10 in chips) 
Seat 4: Onestop4u ($13.35 in chips) 
Seat 5: Jesus Ololo ($10 in chips) 
Seat 6: Enricola ($22.11 in chips) 
manuell1996: posts small blind $0.05
Tyoma_Kovach: posts big blind $0.10
*** HOLE CARDS ***
SERG244: folds 
Onestop4u: calls $0.10
Jesus Ololo: folds 
Enricola: raises $0.40 to $0.50
manuell1996: folds 
Tyoma_Kovach: folds 
Onestop4u: calls $0.40
*** FLOP *** [Ks 3h 9h]
Onestop4u: checks 
Enricola: bets $1.10
Onestop4u: folds 
Uncalled bet ($1.10) returned to Enricola
Enricola collected $1.10 from pot
Enricola: doesn't show hand 
*** SUMMARY ***
Total pot $1.15 | Rake $0.05 
Board [Ks 3h 9h]
Seat 1: manuell1996 (small blind) folded before Flop
Seat 2: Tyoma_Kovach (big blind) folded before Flop
Seat 3: SERG244 folded before Flop (didn't bet)
Seat 4: Onestop4u folded on the Flop
Seat 5: Jesus Ololo folded before Flop (didn't bet)
Seat 6: Enricola (button) collected ($1.10)



PokerStars Hand #222952501641:  Hold'em No Limit ($0.05/$0.10 USD) - 2021/01/23 7:47:46 ET
Table 'Saito II' 6-max Seat #1 is the button
Seat 1: Nickh147 ($10.05 in chips) 
Seat 6: täng ($4.75 in chips) 
Nickh147: posts small blind $0.05
täng: posts big blind $0.10
*** HOLE CARDS ***
Nickh147: raises $0.14 to $0.24
täng: folds 
Uncalled bet ($0.14) returned to Nickh147
cruxua joins the table at seat #2 
Nickh147 collected $0.20 from pot
Nickh147: doesn't show hand 
*** SUMMARY ***
Total pot $0.20 | Rake $0 
Seat 1: Nickh147 (button) (small blind) collected ($0.20)
Seat 6: täng (big blind) folded before Flop



PokerStars Hand #222953817323:  Hold'em No Limit ($0.05/$0.10 USD) - 2021/01/23 8:41:14 ET
Table 'Saito II' 6-max Seat #1 is the button
Seat 1: manuell1996 ($9.75 in chips) 
Seat 2: Tyoma_Kovach ($11.44 in chips) 
Seat 3: SERG244 ($10 in chips) 
Seat 4: Onestop4u ($12.85 in chips) 
Seat 5: Jesus Ololo ($10 in chips) 
Seat 6: Enricola ($22.71 in chips) 
Tyoma_Kovach: posts small blind $0.05
SERG244: posts big blind $0.10
*** HOLE CARDS ***
Onestop4u: calls $0.10
Jesus Ololo: folds 
Enricola: folds 
manuell1996: folds 
Tyoma_Kovach: raises $0.40 to $0.50
SERG244: raises $0.90 to $1.40
Onestop4u: folds 
Tyoma_Kovach: folds 
Uncalled bet ($0.90) returned to SERG244
SERG244 collected $1.10 from pot
SERG244: doesn't show hand 
*** SUMMARY ***
Total pot $1.10 | Rake $0 
Seat 1: manuell1996 (button) folded before Flop (didn't bet)
Seat 2: Tyoma_Kovach (small blind) folded before Flop
Seat 3: SERG244 (big blind) collected ($1.10)
Seat 4: Onestop4u folded before Flop
Seat 5: Jesus Ololo folded before Flop (didn't bet)
Seat 6: Enricola folded before Flop (didn't bet)



PokerStars Hand #222952504774:  Hold'em No Limit ($0.05/$0.10 USD) - 2021/01/23 7:47:54 ET
Table 'Saito II' 6-max Seat #6 is the button
Seat 1: Nickh147 ($10.15 in chips) 
Seat 2: cruxua ($10 in chips) 
Seat 6: täng ($4.65 in chips) 
Nickh147: posts small blind $0.05
cruxua: posts big blind $0.10
*** HOLE CARDS ***
täng: raises $0.20 to $0.30
Nickh147: folds 
cruxua: folds 
Uncalled bet ($0.20) returned to täng
täng collected $0.25 from pot
täng: doesn't show hand 
*** SUMMARY ***
Total pot $0.25 | Rake $0 
Seat 1: Nickh147 (small blind) folded before Flop
Seat 2: cruxua (big blind) folded before Flop
Seat 6: täng (button) collected ($0.25)



PokerStars Hand #222953827877:  Hold'em No Limit ($0.05/$0.10 USD) - 2021/01/23 8:41:38 ET
Table 'Saito II' 6-max Seat #2 is the button
Seat 1: manuell1996 ($9.75 in chips) 
Seat 2: Tyoma_Kovach ($10.94 in chips) 
Seat 3: SERG244 ($10.60 in chips) 
Seat 4: Onestop4u ($12.75 in chips) 
Seat 5: Jesus Ololo ($10 in chips) 
Seat 6: Enricola ($22.71 in chips) 
SERG244: posts small blind $0.05
Onestop4u: posts big blind $0.10
*** HOLE CARDS ***
Jesus Ololo: raises $0.15 to $0.25
Enricola: folds 
manuell1996: folds 
manuell1996 leaves the table
Tyoma_Kovach: folds 
SERG244: folds 
Onestop4u: folds 
Uncalled bet ($0.15) returned to Jesus Ololo
Jesus Ololo collected $0.25 from pot
*** SUMMARY ***
Total pot $0.25 | Rake $0 
Seat 1: manuell1996 folded before Flop (didn't bet)
Seat 2: Tyoma_Kovach (button) folded before Flop (didn't bet)
Seat 3: SERG244 (small blind) folded before Flop
Seat 4: Onestop4u (big blind) folded before Flop
Seat 5: Jesus Ololo collected ($0.25)
Seat 6: Enricola folded before Flop (didn't bet)



PokerStars Hand #222952508858:  Hold'em No Limit ($0.05/$0.10 USD) - 2021/01/23 7:48:05 ET
Table 'Saito II' 6-max Seat #1 is the button
Seat 1: Nickh147 ($10.10 in chips) 
Seat 2: cruxua ($10 in chips) 
Seat 6: täng ($4.80 in chips) 
cruxua: posts small blind $0.05
täng: posts big blind $0.10
*** HOLE CARDS ***
Nickh147: raises $0.11 to $0.21
cruxua: folds 
täng: folds 
Uncalled bet ($0.11) returned to Nickh147
Nickh147 collected $0.25 from pot
Nickh147: doesn't show hand 
*** SUMMARY ***
Total pot $0.25 | Rake $0 
Seat 1: Nickh147 (button) collected ($0.25)
Seat 2: cruxua (small blind) folded before Flop
Seat 6: täng (big blind) folded before Flop



PokerStars Hand #222953833437:  Hold'em No Limit ($0.05/$0.10 USD) - 2021/01/23 8:41:50 ET
Table 'Saito II' 6-max Seat #3 is the button
Seat 2: Tyoma_Kovach ($10.94 in chips) 
Seat 3: SERG244 ($10.55 in chips) 
Seat 4: Onestop4u ($12.65 in chips) 
Seat 5: Jesus Ololo ($10.15 in chips) 
Seat 6: Enricola ($22.71 in chips) 
Onestop4u: posts small blind $0.05
Jesus Ololo: posts big blind $0.10
*** HOLE CARDS ***
Enricola: raises $0.25 to $0.35
Tyoma_Kovach: raises $0.77 to $1.12
SERG244: folds 
Onestop4u: folds 
Jesus Ololo: folds 
Enricola: calls $0.77
*** FLOP *** [8c 3s 2h]
Enricola: checks 
Tyoma_Kovach: bets $0.75
Enricola: calls $0.75
*** TURN *** [8c 3s 2h] [Kc]
Enricola: checks 
Tyoma_Kovach: bets $2.07
Enricola: folds 
Uncalled bet ($2.07) returned to Tyoma_Kovach
Tyoma_Kovach collected $3.71 from pot
Tyoma_Kovach: doesn't show hand 
*** SUMMARY ***
Total pot $3.89 | Rake $0.18 
Board [8c 3s 2h Kc]
Seat 2: Tyoma_Kovach collected ($3.71)
Seat 3: SERG244 (button) folded before Flop (didn't bet)
Seat 4: Onestop4u (small blind) folded before Flop
Seat 5: Jesus Ololo (big blind) folded before Flop
Seat 6: Enricola folded on the Turn



PokerStars Hand #222952514469:  Hold'em No Limit ($0.05/$0.10 USD) - 2021/01/23 7:48:19 ET
Table 'Saito II' 6-max Seat #2 is the button
Seat 1: Nickh147 ($10.25 in chips) 
Seat 2: cruxua ($10 in chips) 
Seat 6: täng ($4.70 in chips) 
täng: posts small blind $0.05
Nickh147: posts big blind $0.10
*** HOLE CARDS ***
cruxua: raises $0.15 to $0.25
täng: folds 
YuYuYu777 joins the table at seat #3 
Lergik joins the table at seat #5 
Lergik leaves the table
Nickh147: calls $0.15
*** FLOP *** [6s Ks 7d]
Nickh147: checks 
Lergik joins the table at seat #5 
Lergik leaves the table
cruxua: bets $0.35
KingBiscuitT joins the table at seat #5 
Nickh147: raises $0.44 to $0.79
cruxua: folds 
Uncalled bet ($0.44) returned to Nickh147
Nickh147 collected $1.19 from pot
Nickh147: doesn't show hand 
*** SUMMARY ***
Total pot $1.25 | Rake $0.06 
Board [6s Ks 7d]
Seat 1: Nickh147 (big blind) collected ($1.19)
Seat 2: cruxua (button) folded on the Flop
Seat 6: täng (small blind) folded before Flop



PokerStars Hand #222953847923:  Hold'em No Limit ($0.05/$0.10 USD) - 2021/01/23 8:42:19 ET
Table 'Saito II' 6-max Seat #4 is the button
Seat 2: Tyoma_Kovach ($12.78 in chips) 
Seat 3: SERG244 ($10.55 in chips) 
Seat 4: Onestop4u ($12.60 in chips) 
Seat 5: Jesus Ololo ($10.05 in chips) 
Seat 6: Enricola ($20.84 in chips) 
Jesus Ololo: posts small blind $0.05
Enricola: posts big blind $0.10
*** HOLE CARDS ***
Tyoma_Kovach: folds 
SERG244: folds 
Onestop4u: folds 
Jesus Ololo: folds 
Uncalled bet ($0.05) returned to Enricola
Enricola collected $0.10 from pot
Enricola: doesn't show hand 
Mr.KlonkAlot joins the table at seat #1 
*** SUMMARY ***
Total pot $0.10 | Rake $0 
Seat 2: Tyoma_Kovach folded before Flop (didn't bet)
Seat 3: SERG244 folded before Flop (didn't bet)
Seat 4: Onestop4u (button) folded before Flop (didn't bet)
Seat 5: Jesus Ololo (small blind) folded before Flop
Seat 6: Enricola (big blind) collected ($0.10)



PokerStars Hand #222952526682:  Hold'em No Limit ($0.05/$0.10 USD) - 2021/01/23 7:48:52 ET
Table 'Saito II' 6-max Seat #6 is the button
Seat 1: Nickh147 ($10.84 in chips) 
Seat 3: YuYuYu777 ($10 in chips) 
Seat 6: täng ($4.65 in chips) 
Nickh147: posts small blind $0.05
cruxua: is sitting out 
YuYuYu777: posts big blind $0.10
KingBiscuitT: sits out 
*** HOLE CARDS ***
täng: folds 
Nickh147: folds 
Uncalled bet ($0.05) returned to YuYuYu777
YuYuYu777 collected $0.10 from pot
YuYuYu777: doesn't show hand 
*** SUMMARY ***
Total pot $0.10 | Rake $0 
Seat 1: Nickh147 (small blind) folded before Flop
Seat 3: YuYuYu777 (big blind) collected ($0.10)
Seat 6: täng (button) folded before Flop (didn't bet)



PokerStars Hand #222953852105:  Hold'em No Limit ($0.05/$0.10 USD) - 2021/01/23 8:42:29 ET
Table 'Saito II' 6-max Seat #5 is the button
Seat 1: Mr.KlonkAlot ($10 in chips) 
Seat 2: Tyoma_Kovach ($12.78 in chips) 
Seat 3: SERG244 ($10.55 in chips) 
Seat 4: Onestop4u ($12.60 in chips) 
Seat 5: Jesus Ololo ($10 in chips) 
Seat 6: Enricola ($20.89 in chips) 
Enricola: posts small blind $0.05
Mr.KlonkAlot: posts big blind $0.10
*** HOLE CARDS ***
Tyoma_Kovach: folds 
SERG244: raises $0.16 to $0.26
Onestop4u: folds 
Jesus Ololo: calls $0.26
Enricola: folds 
Mr.KlonkAlot: calls $0.16
*** FLOP *** [9c Kh Jc]
Mr.KlonkAlot: checks 
SERG244: checks 
Jesus Ololo: checks 
*** TURN *** [9c Kh Jc] [2h]
Mr.KlonkAlot: checks 
SERG244: checks 
Jesus Ololo: checks 
*** RIVER *** [9c Kh Jc 2h] [6c]
Mr.KlonkAlot: checks 
SERG244: checks 
Jesus Ololo: checks 
*** SHOW DOWN ***
Mr.KlonkAlot: shows [9d 7s] (a pair of Nines)
SERG244: mucks hand 
Jesus Ololo: mucks hand 
Mr.KlonkAlot collected $0.79 from pot
*** SUMMARY ***
Total pot $0.83 | Rake $0.04 
Board [9c Kh Jc 2h 6c]
Seat 1: Mr.KlonkAlot (big blind) showed [9d 7s] and won ($0.79) with a pair of Nines
Seat 2: Tyoma_Kovach folded before Flop (didn't bet)
Seat 3: SERG244 mucked
Seat 4: Onestop4u folded before Flop (didn't bet)
Seat 5: Jesus Ololo (button) mucked
Seat 6: Enricola (small blind) folded before Flop



PokerStars Hand #222952530147:  Hold'em No Limit ($0.05/$0.10 USD) - 2021/01/23 7:49:00 ET
Table 'Saito II' 6-max Seat #1 is the button
Seat 1: Nickh147 ($10.79 in chips) 
Seat 3: YuYuYu777 ($10.05 in chips) 
Seat 5: KingBiscuitT ($10 in chips) 
Seat 6: täng ($4.65 in chips) 
YuYuYu777: posts small blind $0.05
KingBiscuitT: posts big blind $0.10
*** HOLE CARDS ***
cruxua leaves the table
ivan2772ms joins the table at seat #2 
täng has timed out
täng: folds 
Nickh147: folds 
YuYuYu777: raises $0.20 to $0.30
KingBiscuitT: folds 
Uncalled bet ($0.20) returned to YuYuYu777
YuYuYu777 collected $0.20 from pot
YuYuYu777: doesn't show hand 
*** SUMMARY ***
Total pot $0.20 | Rake $0 
Seat 1: Nickh147 (button) folded before Flop (didn't bet)
Seat 3: YuYuYu777 (small blind) collected ($0.20)
Seat 5: KingBiscuitT (big blind) folded before Flop
Seat 6: täng folded before Flop (didn't bet)



PokerStars Hand #222953875952:  Hold'em No Limit ($0.05/$0.10 USD) - 2021/01/23 8:43:22 ET
Table 'Saito II' 6-max Seat #6 is the button
Seat 1: Mr.KlonkAlot ($10.53 in chips) 
Seat 2: Tyoma_Kovach ($12.78 in chips) 
Seat 3: SERG244 ($10.29 in chips) 
Seat 4: Onestop4u ($12.60 in chips) 
Seat 5: Jesus Ololo ($10 in chips) 
Seat 6: Enricola ($20.84 in chips) 
Mr.KlonkAlot: posts small blind $0.05
Tyoma_Kovach: posts big blind $0.10
*** HOLE CARDS ***
SERG244: folds 
Onestop4u: folds 
Jesus Ololo: folds 
Enricola: folds 
Mr.KlonkAlot: folds 
Uncalled bet ($0.05) returned to Tyoma_Kovach
Tyoma_Kovach collected $0.10 from pot
Tyoma_Kovach: doesn't show hand 
*** SUMMARY ***
Total pot $0.10 | Rake $0 
Seat 1: Mr.KlonkAlot (small blind) folded before Flop
Seat 2: Tyoma_Kovach (big blind) collected ($0.10)
Seat 3: SERG244 folded before Flop (didn't bet)
Seat 4: Onestop4u folded before Flop (didn't bet)
Seat 5: Jesus Ololo folded before Flop (didn't bet)
Seat 6: Enricola (button) folded before Flop (didn't bet)



PokerStars Hand #222952536018:  Hold'em No Limit ($0.05/$0.10 USD) - 2021/01/23 7:49:16 ET
Table 'Saito II' 6-max Seat #3 is the button
Seat 1: Nickh147 ($10.79 in chips) 
Seat 3: YuYuYu777 ($10.15 in chips) 
Seat 5: KingBiscuitT ($10 in chips) 
KingBiscuitT: posts small blind $0.05
Nickh147: posts big blind $0.10
ivan2772ms: sits out 
*** HOLE CARDS ***
YuYuYu777: raises $0.20 to $0.30
KingBiscuitT: folds 
Nickh147: folds 
Uncalled bet ($0.20) returned to YuYuYu777
YuYuYu777 collected $0.25 from pot
YuYuYu777: doesn't show hand 
*** SUMMARY ***
Total pot $0.25 | Rake $0 
Seat 1: Nickh147 (big blind) folded before Flop
Seat 3: YuYuYu777 (button) collected ($0.25)
Seat 5: KingBiscuitT (small blind) folded before Flop



PokerStars Hand #222954264324:  Hold'em No Limit ($0.05/$0.10 USD) - 2021/01/23 8:58:02 ET
Table 'Saito II' 6-max Seat #2 is the button
Seat 1: Mr.KlonkAlot ($15.35 in chips) 
Seat 2: Tyoma_Kovach ($12.65 in chips) 
Seat 3: SERG244 ($16.69 in chips) 
Seat 4: Onestop4u ($4.49 in chips) 
Seat 5: xulfster ($10 in chips) 
SERG244: posts small blind $0.05
Onestop4u: posts big blind $0.10
JackieACEE: sits out 
*** HOLE CARDS ***
xulfster: raises $0.15 to $0.25
Mr.KlonkAlot: calls $0.25
Tyoma_Kovach: folds 
SERG244: folds 
Onestop4u: calls $0.15
*** FLOP *** [5s Qs Ah]
Onestop4u: checks 
xulfster: bets $0.70
Mr.KlonkAlot: raises $1.08 to $1.78
Onestop4u: folds 
xulfster: raises $4.32 to $6.10
Mr.KlonkAlot: calls $4.32
*** TURN *** [5s Qs Ah] [3d]
xulfster: bets $3.65 and is all-in
Mr.KlonkAlot: calls $3.65
*** RIVER *** [5s Qs Ah 3d] [2d]
*** SHOW DOWN ***
xulfster: shows [Qc Ad] (two pair, Aces and Queens)
Mr.KlonkAlot: shows [Ac Ks] (a pair of Aces)
xulfster collected $19.39 from pot
*** SUMMARY ***
Total pot $20.30 | Rake $0.91 
Board [5s Qs Ah 3d 2d]
Seat 1: Mr.KlonkAlot showed [Ac Ks] and lost with a pair of Aces
Seat 2: Tyoma_Kovach (button) folded before Flop (didn't bet)
Seat 3: SERG244 (small blind) folded before Flop
Seat 4: Onestop4u (big blind) folded on the Flop
Seat 5: xulfster showed [Qc Ad] and won ($19.39) with two pair, Aces and Queens



PokerStars Hand #222952539667:  Hold'em No Limit ($0.05/$0.10 USD) - 2021/01/23 7:49:25 ET
Table 'Saito II' 6-max Seat #5 is the button
Seat 1: Nickh147 ($10.69 in chips) 
Seat 2: ivan2772ms ($10.08 in chips) 
Seat 3: YuYuYu777 ($10.30 in chips) 
Seat 5: KingBiscuitT ($10 in chips) 
Nickh147: posts small blind $0.05
ivan2772ms: posts big blind $0.10
*** HOLE CARDS ***
YuYuYu777: raises $0.20 to $0.30
KingBiscuitT: folds 
Nickh147: folds 
ivan2772ms: folds 
Uncalled bet ($0.20) returned to YuYuYu777
YuYuYu777 collected $0.25 from pot
YuYuYu777: doesn't show hand 
*** SUMMARY ***
Total pot $0.25 | Rake $0 
Seat 1: Nickh147 (small blind) folded before Flop
Seat 2: ivan2772ms (big blind) folded before Flop
Seat 3: YuYuYu777 collected ($0.25)
Seat 5: KingBiscuitT (button) folded before Flop (didn't bet)



PokerStars Hand #222954288015:  Hold'em No Limit ($0.05/$0.10 USD) - 2021/01/23 8:59:07 ET
Table 'Saito II' 6-max Seat #3 is the button
Seat 1: Mr.KlonkAlot ($5.35 in chips) 
Seat 2: Tyoma_Kovach ($12.65 in chips) 
Seat 3: SERG244 ($16.64 in chips) 
Seat 4: Onestop4u ($4.24 in chips) 
Seat 5: xulfster ($19.39 in chips) 
Onestop4u: posts small blind $0.05
xulfster: posts big blind $0.10
JackieACEE: sits out 
*** HOLE CARDS ***
Mr.KlonkAlot: folds 
Tyoma_Kovach: raises $0.18 to $0.28
SERG244: raises $0.65 to $0.93
Onestop4u: folds 
JackieACEE is disconnected 
xulfster: folds 
Tyoma_Kovach: folds 
Uncalled bet ($0.65) returned to SERG244
SERG244 collected $0.71 from pot
SERG244: doesn't show hand 
*** SUMMARY ***
Total pot $0.71 | Rake $0 
Seat 1: Mr.KlonkAlot folded before Flop (didn't bet)
Seat 2: Tyoma_Kovach folded before Flop
Seat 3: SERG244 (button) collected ($0.71)
Seat 4: Onestop4u (small blind) folded before Flop
Seat 5: xulfster (big blind) folded before Flop



PokerStars Hand #222952545260:  Hold'em No Limit ($0.05/$0.10 USD) - 2021/01/23 7:49:40 ET
Table 'Saito II' 6-max Seat #1 is the button
Seat 1: Nickh147 ($10.64 in chips) 
Seat 2: ivan2772ms ($9.98 in chips) 
Seat 3: YuYuYu777 ($10.45 in chips) 
Seat 5: KingBiscuitT ($10 in chips) 
ivan2772ms: posts small blind $0.05
YuYuYu777: posts big blind $0.10
*** HOLE CARDS ***
KingBiscuitT: folds 
Nickh147: raises $0.11 to $0.21
ivan2772ms: raises $0.69 to $0.90
YuYuYu777: folds 
täng leaves the table
Nickh147: folds 
Uncalled bet ($0.69) returned to ivan2772ms
ivan2772ms collected $0.52 from pot
ivan2772ms: doesn't show hand 
*** SUMMARY ***
Total pot $0.52 | Rake $0 
Seat 1: Nickh147 (button) folded before Flop
Seat 2: ivan2772ms (small blind) collected ($0.52)
Seat 3: YuYuYu777 (big blind) folded before Flop
Seat 5: KingBiscuitT folded before Flop (didn't bet)



PokerStars Hand #222954296177:  Hold'em No Limit ($0.05/$0.10 USD) - 2021/01/23 8:59:30 ET
Table 'Saito II' 6-max Seat #4 is the button
Seat 2: Tyoma_Kovach ($12.37 in chips) 
Seat 3: SERG244 ($17.07 in chips) 
Seat 4: Onestop4u ($4.19 in chips) 
Seat 5: xulfster ($19.29 in chips) 
xulfster: posts small blind $0.05
JackieACEE has timed out while disconnected
JackieACEE: is sitting out 
Mr.KlonkAlot: is sitting out 
Tyoma_Kovach: posts big blind $0.10
*** HOLE CARDS ***
SERG244: folds 
Onestop4u: calls $0.10
Mr.KlonkAlot leaves the table
xulfster: folds 
Tyoma_Kovach: checks 
*** FLOP *** [5c 8c As]
Tyoma_Kovach: checks 
Onestop4u: checks 
*** TURN *** [5c 8c As] [2d]
Tyoma_Kovach: checks 
ivan2772ms joins the table at seat #1 
Onestop4u: checks 
*** RIVER *** [5c 8c As 2d] [Tc]
Tyoma_Kovach: checks 
Onestop4u: checks 
*** SHOW DOWN ***
Tyoma_Kovach: shows [3s 7d] (high card Ace)
Onestop4u: shows [6d Kd] (high card Ace - King kicker)
Onestop4u collected $0.24 from pot
*** SUMMARY ***
Total pot $0.25 | Rake $0.01 
Board [5c 8c As 2d Tc]
Seat 2: Tyoma_Kovach (big blind) showed [3s 7d] and lost with high card Ace
Seat 3: SERG244 folded before Flop (didn't bet)
Seat 4: Onestop4u (button) showed [6d Kd] and won ($0.24) with high card Ace
Seat 5: xulfster (small blind) folded before Flop



PokerStars Hand #222952551857:  Hold'em No Limit ($0.05/$0.10 USD) - 2021/01/23 7:49:57 ET
Table 'Saito II' 6-max Seat #2 is the button
Seat 1: Nickh147 ($10.43 in chips) 
Seat 2: ivan2772ms ($10.29 in chips) 
Seat 3: YuYuYu777 ($10.35 in chips) 
Seat 5: KingBiscuitT ($10 in chips) 
YuYuYu777: posts small blind $0.05
KingBiscuitT: posts big blind $0.10
*** HOLE CARDS ***
Nickh147: folds 
ivan2772ms: folds 
YuYuYu777: folds 
Uncalled bet ($0.05) returned to KingBiscuitT
KingBiscuitT collected $0.10 from pot
siblye was removed from the table for failing to post
siblye leaves the table
KingBiscuitT: doesn't show hand 
Enricola joins the table at seat #6 
*** SUMMARY ***
Total pot $0.10 | Rake $0 
Seat 1: Nickh147 folded before Flop (didn't bet)
Seat 2: ivan2772ms (button) folded before Flop (didn't bet)
Seat 3: YuYuYu777 (small blind) folded before Flop
Seat 5: KingBiscuitT (big blind) collected ($0.10)



PokerStars Hand #222954309030:  Hold'em No Limit ($0.05/$0.10 USD) - 2021/01/23 9:00:04 ET
Table 'Saito II' 6-max Seat #5 is the button
Seat 2: Tyoma_Kovach ($12.27 in chips) 
Seat 3: SERG244 ($17.07 in chips) 
Seat 4: Onestop4u ($4.33 in chips) 
Seat 5: xulfster ($19.24 in chips) 
Tyoma_Kovach: posts small blind $0.05
SERG244: posts big blind $0.10
*** HOLE CARDS ***
Onestop4u: folds 
xulfster: folds 
Tyoma_Kovach: folds 
Uncalled bet ($0.05) returned to SERG244
SERG244 collected $0.10 from pot
SERG244: doesn't show hand 
*** SUMMARY ***
Total pot $0.10 | Rake $0 
Seat 2: Tyoma_Kovach (small blind) folded before Flop
Seat 3: SERG244 (big blind) collected ($0.10)
Seat 4: Onestop4u folded before Flop (didn't bet)
Seat 5: xulfster (button) folded before Flop (didn't bet)



PokerStars Hand #222952554350:  Hold'em No Limit ($0.05/$0.10 USD) - 2021/01/23 7:50:03 ET
Table 'Saito II' 6-max Seat #3 is the button
Seat 1: Nickh147 ($10.43 in chips) 
Seat 2: ivan2772ms ($10.29 in chips) 
Seat 3: YuYuYu777 ($10.30 in chips) 
Seat 5: KingBiscuitT ($10.05 in chips) 
Seat 6: Enricola ($10 in chips) 
KingBiscuitT: posts small blind $0.05
Enricola: posts big blind $0.10
*** HOLE CARDS ***
Nickh147: raises $0.14 to $0.24
ivan2772ms: folds 
YuYuYu777: folds 
KingBiscuitT: folds 
Enricola: calls $0.14
*** FLOP *** [4d Qh 5d]
Enricola: checks 
Nickh147: bets $0.30
Enricola: raises $0.40 to $0.70
Nickh147: calls $0.40
*** TURN *** [4d Qh 5d] [6s]
Enricola: bets $1.84
Nickh147: calls $1.84
*** RIVER *** [4d Qh 5d 6s] [Ad]
Enricola: bets $5.36
jayzz6 joins the table at seat #4 
Nickh147: raises $2.29 to $7.65 and is all-in
Enricola: folds 
Uncalled bet ($2.29) returned to Nickh147
Nickh147 collected $15.60 from pot
Nickh147: doesn't show hand 
*** SUMMARY ***
Total pot $16.33 | Rake $0.73 
Board [4d Qh 5d 6s Ad]
Seat 1: Nickh147 collected ($15.60)
Seat 2: ivan2772ms folded before Flop (didn't bet)
Seat 3: YuYuYu777 (button) folded before Flop (didn't bet)
Seat 5: KingBiscuitT (small blind) folded before Flop
Seat 6: Enricola (big blind) folded on the River



PokerStars Hand #222954312014:  Hold'em No Limit ($0.05/$0.10 USD) - 2021/01/23 9:00:12 ET
Table 'Saito II' 6-max Seat #2 is the button
Seat 2: Tyoma_Kovach ($12.22 in chips) 
Seat 3: SERG244 ($17.12 in chips) 
Seat 4: Onestop4u ($4.33 in chips) 
Seat 5: xulfster ($19.24 in chips) 
SERG244: posts small blind $0.05
Onestop4u: posts big blind $0.10
ivan2772ms: sits out 
*** HOLE CARDS ***
xulfster: folds 
Tyoma_Kovach: folds 
SERG244: folds 
Uncalled bet ($0.05) returned to Onestop4u
Onestop4u collected $0.10 from pot
Onestop4u: doesn't show hand 
*** SUMMARY ***
Total pot $0.10 | Rake $0 
Seat 2: Tyoma_Kovach (button) folded before Flop (didn't bet)
Seat 3: SERG244 (small blind) folded before Flop
Seat 4: Onestop4u (big blind) collected ($0.10)
Seat 5: xulfster folded before Flop (didn't bet)



PokerStars Hand #222952579891:  Hold'em No Limit ($0.05/$0.10 USD) - 2021/01/23 7:51:10 ET
Table 'Saito II' 6-max Seat #5 is the button
Seat 2: ivan2772ms ($10.29 in chips) 
Seat 3: YuYuYu777 ($10.30 in chips) 
Seat 5: KingBiscuitT ($10 in chips) 
Seat 6: Enricola ($1.86 in chips) 
Enricola: posts small blind $0.05
Nickh147: is sitting out 
ivan2772ms: posts big blind $0.10
jayzz6: sits out 
*** HOLE CARDS ***
YuYuYu777: raises $0.20 to $0.30
KingBiscuitT: folds 
Enricola: calls $0.25
ivan2772ms: folds 
*** FLOP *** [6h Tc 9h]
Enricola: checks 
YuYuYu777: bets $0.34
Enricola: folds 
Uncalled bet ($0.34) returned to YuYuYu777
YuYuYu777 collected $0.67 from pot
YuYuYu777: doesn't show hand 
*** SUMMARY ***
Total pot $0.70 | Rake $0.03 
Board [6h Tc 9h]
Seat 2: ivan2772ms (big blind) folded before Flop
Seat 3: YuYuYu777 collected ($0.67)
Seat 5: KingBiscuitT (button) folded before Flop (didn't bet)
Seat 6: Enricola (small blind) folded on the Flop



PokerStars Hand #222954314324:  Hold'em No Limit ($0.05/$0.10 USD) - 2021/01/23 9:00:18 ET
Table 'Saito II' 6-max Seat #3 is the button
Seat 2: Tyoma_Kovach ($12.22 in chips) 
Seat 3: SERG244 ($17.07 in chips) 
Seat 4: Onestop4u ($4.38 in chips) 
Seat 6: JackieACEE ($10 in chips) 
Onestop4u: posts small blind $0.05
xulfster: is sitting out 
JackieACEE: posts big blind $0.10
ivan2772ms: sits out 
*** HOLE CARDS ***
Tyoma_Kovach: folds 
xulfster leaves the table
SERG244: raises $0.16 to $0.26
Onestop4u: folds 
JackieACEE: raises $0.24 to $0.50
SERG244: calls $0.24
*** FLOP *** [2s 9s 6s]
JackieACEE: checks 
SERG244: checks 
*** TURN *** [2s 9s 6s] [5s]
Artemka0055 joins the table at seat #5 
JackieACEE: checks 
SERG244: checks 
*** RIVER *** [2s 9s 6s 5s] [4h]
JackieACEE: checks 
Artemka0055 leaves the table
SERG244: checks 
*** SHOW DOWN ***
JackieACEE: shows [Kc Ah] (high card Ace)
SERG244: shows [7s 8c] (a flush, Nine high)
SERG244 collected $1 from pot
*** SUMMARY ***
Total pot $1.05 | Rake $0.05 
Board [2s 9s 6s 5s 4h]
Seat 2: Tyoma_Kovach folded before Flop (didn't bet)
Seat 3: SERG244 (button) showed [7s 8c] and won ($1) with a flush, Nine high
Seat 4: Onestop4u (small blind) folded before Flop
Seat 6: JackieACEE (big blind) showed [Kc Ah] and lost with high card Ace



PokerStars Hand #222952586980:  Hold'em No Limit ($0.05/$0.10 USD) - 2021/01/23 7:51:28 ET
Table 'Saito II' 6-max Seat #6 is the button
Seat 2: ivan2772ms ($10.19 in chips) 
Seat 3: YuYuYu777 ($10.67 in chips) 
Seat 5: KingBiscuitT ($10 in chips) 
Seat 6: Enricola ($1.56 in chips) 
ivan2772ms: posts small blind $0.05
YuYuYu777: posts big blind $0.10
jayzz6: sits out 
*** HOLE CARDS ***
KingBiscuitT: folds 
Enricola: folds 
ivan2772ms: folds 
Uncalled bet ($0.05) returned to YuYuYu777
YuYuYu777 collected $0.10 from pot
YuYuYu777: doesn't show hand 
*** SUMMARY ***
Total pot $0.10 | Rake $0 
Seat 2: ivan2772ms (small blind) folded before Flop
Seat 3: YuYuYu777 (big blind) collected ($0.10)
Seat 5: KingBiscuitT folded before Flop (didn't bet)
Seat 6: Enricola (button) folded before Flop (didn't bet)



PokerStars Hand #222952589781:  Hold'em No Limit ($0.05/$0.10 USD) - 2021/01/23 7:51:36 ET
Table 'Saito II' 6-max Seat #2 is the button
Seat 2: ivan2772ms ($10.14 in chips) 
Seat 3: YuYuYu777 ($10.72 in chips) 
Seat 4: jayzz6 ($10 in chips) 
Seat 5: KingBiscuitT ($10 in chips) 
Seat 6: Enricola ($1.56 in chips) 
YuYuYu777: posts small blind $0.05
jayzz6: posts big blind $0.10
*** HOLE CARDS ***
Nickh147 leaves the table
KingBiscuitT: folds 
Enricola: folds 
ivan2772ms: folds 
YuYuYu777: folds 
Uncalled bet ($0.05) returned to jayzz6
jayzz6 collected $0.10 from pot
jayzz6: doesn't show hand 
*** SUMMARY ***
Total pot $0.10 | Rake $0 
Seat 2: ivan2772ms (button) folded before Flop (didn't bet)
Seat 3: YuYuYu777 (small blind) folded before Flop
Seat 4: jayzz6 (big blind) collected ($0.10)
Seat 5: KingBiscuitT folded before Flop (didn't bet)
Seat 6: Enricola folded before Flop (didn't bet)



PokerStars Hand #222954332666:  Hold'em No Limit ($0.05/$0.10 USD) - 2021/01/23 9:01:04 ET
Table 'Saito II' 6-max Seat #4 is the button
Seat 1: ivan2772ms ($10.05 in chips) 
Seat 2: Tyoma_Kovach ($12.22 in chips) 
Seat 3: SERG244 ($17.57 in chips) 
Seat 4: Onestop4u ($4.33 in chips) 
Seat 6: JackieACEE ($9.50 in chips) 
JackieACEE: posts small blind $0.05
ivan2772ms: posts big blind $0.10
*** HOLE CARDS ***
Tyoma_Kovach: folds 
SERG244: folds 
Onestop4u: calls $0.10
JackieACEE is disconnected 
Willishoveandbb joins the table at seat #5 
JackieACEE has timed out while disconnected
JackieACEE: folds 
ivan2772ms: checks 
*** FLOP *** [3d 7c 2c]
ivan2772ms: checks 
Onestop4u: checks 
*** TURN *** [3d 7c 2c] [9h]
ivan2772ms: checks 
Onestop4u: checks 
*** RIVER *** [3d 7c 2c 9h] [Jh]
ivan2772ms: checks 
Onestop4u: checks 
*** SHOW DOWN ***
ivan2772ms: shows [3h 5h] (a pair of Threes)
Onestop4u: mucks hand 
ivan2772ms collected $0.24 from pot
*** SUMMARY ***
Total pot $0.25 | Rake $0.01 
Board [3d 7c 2c 9h Jh]
Seat 1: ivan2772ms (big blind) showed [3h 5h] and won ($0.24) with a pair of Threes
Seat 2: Tyoma_Kovach folded before Flop (didn't bet)
Seat 3: SERG244 folded before Flop (didn't bet)
Seat 4: Onestop4u (button) mucked
Seat 6: JackieACEE (small blind) folded before Flop



PokerStars Hand #222954360551:  Hold'em No Limit ($0.05/$0.10 USD) - 2021/01/23 9:01:59 ET
Table 'Saito II' 6-max Seat #1 is the button
Seat 1: ivan2772ms ($10.19 in chips) 
Seat 2: Tyoma_Kovach ($12.22 in chips) 
Seat 3: SERG244 ($17.57 in chips) 
Seat 4: Onestop4u ($4.23 in chips) 
Tyoma_Kovach: posts small blind $0.05
SERG244: posts big blind $0.10
Willishoveandbb: sits out 
*** HOLE CARDS ***
Onestop4u: raises $0.10 to $0.20
ivan2772ms: folds 
Tyoma_Kovach: folds 
SERG244: folds 
Uncalled bet ($0.10) returned to Onestop4u
Onestop4u collected $0.25 from pot
Onestop4u: doesn't show hand 
*** SUMMARY ***
Total pot $0.25 | Rake $0 
Seat 1: ivan2772ms (button) folded before Flop (didn't bet)
Seat 2: Tyoma_Kovach (small blind) folded before Flop
Seat 3: SERG244 (big blind) folded before Flop
Seat 4: Onestop4u collected ($0.25)



PokerStars Hand #222952592894:  Hold'em No Limit ($0.05/$0.10 USD) - 2021/01/23 7:51:44 ET
Table 'Saito II' 6-max Seat #3 is the button
Seat 2: ivan2772ms ($10.14 in chips) 
Seat 3: YuYuYu777 ($10.67 in chips) 
Seat 4: jayzz6 ($10.05 in chips) 
Seat 5: KingBiscuitT ($10 in chips) 
Seat 6: Enricola ($10 in chips) 
jayzz6: posts small blind $0.05
KingBiscuitT: posts big blind $0.10
*** HOLE CARDS ***
Enricola: raises $0.25 to $0.35
ivan2772ms: folds 
YuYuYu777: folds 
notzukau joins the table at seat #1 
jayzz6: calls $0.30
KingBiscuitT: folds 
*** FLOP *** [Ad 2d Qc]
jayzz6: checks 
Enricola: bets $0.70
jayzz6: calls $0.70
*** TURN *** [Ad 2d Qc] [Kc]
jayzz6: checks 
Enricola: bets $2.10
jayzz6: folds 
Uncalled bet ($2.10) returned to Enricola
Enricola collected $2.10 from pot
Enricola: doesn't show hand 
*** SUMMARY ***
Total pot $2.20 | Rake $0.10 
Board [Ad 2d Qc Kc]
Seat 2: ivan2772ms folded before Flop (didn't bet)
Seat 3: YuYuYu777 (button) folded before Flop (didn't bet)
Seat 4: jayzz6 (small blind) folded on the Turn
Seat 5: KingBiscuitT (big blind) folded before Flop
Seat 6: Enricola collected ($2.10)



PokerStars Hand #222954364449:  Hold'em No Limit ($0.05/$0.10 USD) - 2021/01/23 9:02:08 ET
Table 'Saito II' 6-max Seat #2 is the button
Seat 1: ivan2772ms ($10.19 in chips) 
Seat 2: Tyoma_Kovach ($12.17 in chips) 
Seat 3: SERG244 ($17.47 in chips) 
Seat 4: Onestop4u ($4.38 in chips) 
SERG244: posts small blind $0.05
Onestop4u: posts big blind $0.10
Willishoveandbb: sits out 
*** HOLE CARDS ***
ivan2772ms: folds 
Tyoma_Kovach: raises $0.15 to $0.25
SERG244: folds 
Onestop4u: calls $0.15
*** FLOP *** [Ac Jc As]
Onestop4u: checks 
Tyoma_Kovach: bets $0.17
Onestop4u: folds 
Uncalled bet ($0.17) returned to Tyoma_Kovach
Tyoma_Kovach collected $0.53 from pot
Tyoma_Kovach: doesn't show hand 
*** SUMMARY ***
Total pot $0.55 | Rake $0.02 
Board [Ac Jc As]
Seat 1: ivan2772ms folded before Flop (didn't bet)
Seat 2: Tyoma_Kovach (button) collected ($0.53)
Seat 3: SERG244 (small blind) folded before Flop
Seat 4: Onestop4u (big blind) folded on the Flop



PokerStars Hand #222952613174:  Hold'em No Limit ($0.05/$0.10 USD) - 2021/01/23 7:52:36 ET
Table 'Saito II' 6-max Seat #4 is the button
Seat 2: ivan2772ms ($10.14 in chips) 
Seat 3: YuYuYu777 ($10.67 in chips) 
Seat 4: jayzz6 ($10 in chips) 
Seat 5: KingBiscuitT ($10 in chips) 
Seat 6: Enricola ($11.05 in chips) 
KingBiscuitT: posts small blind $0.05
Enricola: posts big blind $0.10
notzukau: sits out 
*** HOLE CARDS ***
ivan2772ms: folds 
YuYuYu777: folds 
jayzz6 has timed out
jayzz6: folds 
KingBiscuitT: raises $0.20 to $0.30
Enricola: calls $0.20
*** FLOP *** [9h 5h 2c]
KingBiscuitT: checks 
Enricola: bets $0.29
KingBiscuitT: folds 
Uncalled bet ($0.29) returned to Enricola
Enricola collected $0.57 from pot
Enricola: doesn't show hand 
*** SUMMARY ***
Total pot $0.60 | Rake $0.03 
Board [9h 5h 2c]
Seat 2: ivan2772ms folded before Flop (didn't bet)
Seat 3: YuYuYu777 folded before Flop (didn't bet)
Seat 4: jayzz6 (button) folded before Flop (didn't bet)
Seat 5: KingBiscuitT (small blind) folded on the Flop
Seat 6: Enricola (big blind) collected ($0.57)



PokerStars Hand #222954374391:  Hold'em No Limit ($0.05/$0.10 USD) - 2021/01/23 9:02:28 ET
Table 'Saito II' 6-max Seat #3 is the button
Seat 1: ivan2772ms ($10.19 in chips) 
Seat 2: Tyoma_Kovach ($12.45 in chips) 
Seat 3: SERG244 ($17.42 in chips) 
Seat 4: Onestop4u ($4.13 in chips) 
Seat 5: Willishoveandbb ($10 in chips) 
Onestop4u: posts small blind $0.05
Willishoveandbb: posts big blind $0.10
*** HOLE CARDS ***
ivan2772ms: folds 
Tyoma_Kovach: folds 
SERG244: raises $0.16 to $0.26
Onestop4u: raises $0.62 to $0.88
Willishoveandbb: folds 
JackieACEE is disconnected 
SERG244: folds 
Uncalled bet ($0.62) returned to Onestop4u
Onestop4u collected $0.62 from pot
Onestop4u: doesn't show hand 
*** SUMMARY ***
Total pot $0.62 | Rake $0 
Seat 1: ivan2772ms folded before Flop (didn't bet)
Seat 2: Tyoma_Kovach folded before Flop (didn't bet)
Seat 3: SERG244 (button) folded before Flop
Seat 4: Onestop4u (small blind) collected ($0.62)
Seat 5: Willishoveandbb (big blind) folded before Flop



PokerStars Hand #222952629732:  Hold'em No Limit ($0.05/$0.10 USD) - 2021/01/23 7:53:19 ET
Table 'Saito II' 6-max Seat #5 is the button
Seat 1: notzukau ($10 in chips) 
Seat 2: ivan2772ms ($10.14 in chips) 
Seat 3: YuYuYu777 ($10.67 in chips) 
Seat 5: KingBiscuitT ($10 in chips) 
Seat 6: Enricola ($11.32 in chips) 
Enricola: posts small blind $0.05
notzukau: posts big blind $0.10
*** HOLE CARDS ***
ivan2772ms: folds 
YuYuYu777: raises $0.20 to $0.30
KingBiscuitT: folds 
Enricola: folds 
notzukau: folds 
Uncalled bet ($0.20) returned to YuYuYu777
YuYuYu777 collected $0.25 from pot
YuYuYu777: doesn't show hand 
*** SUMMARY ***
Total pot $0.25 | Rake $0 
Seat 1: notzukau (big blind) folded before Flop
Seat 2: ivan2772ms folded before Flop (didn't bet)
Seat 3: YuYuYu777 collected ($0.25)
Seat 5: KingBiscuitT (button) folded before Flop (didn't bet)
Seat 6: Enricola (small blind) folded before Flop



PokerStars Hand #222954384724:  Hold'em No Limit ($0.05/$0.10 USD) - 2021/01/23 9:02:49 ET
Table 'Saito II' 6-max Seat #4 is the button
Seat 1: ivan2772ms ($10.19 in chips) 
Seat 2: Tyoma_Kovach ($12.45 in chips) 
Seat 3: SERG244 ($17.16 in chips) 
Seat 4: Onestop4u ($4.49 in chips) 
Seat 5: Willishoveandbb ($9.90 in chips) 
Willishoveandbb: posts small blind $0.05
ivan2772ms: posts big blind $0.10
*** HOLE CARDS ***
Tyoma_Kovach: folds 
SERG244: folds 
Onestop4u: folds 
Willishoveandbb: raises $0.15 to $0.25
ivan2772ms: calls $0.15
*** FLOP *** [Qc Th 4c]
Willishoveandbb: bets $0.33
ivan2772ms: calls $0.33
*** TURN *** [Qc Th 4c] [As]
Willishoveandbb: bets $0.77
ivan2772ms: calls $0.77
*** RIVER *** [Qc Th 4c As] [3s]
Willishoveandbb: bets $3.07
ivan2772ms: folds 
Uncalled bet ($3.07) returned to Willishoveandbb
Willishoveandbb collected $2.58 from pot
*** SUMMARY ***
Total pot $2.70 | Rake $0.12 
Board [Qc Th 4c As 3s]
Seat 1: ivan2772ms (big blind) folded on the River
Seat 2: Tyoma_Kovach folded before Flop (didn't bet)
Seat 3: SERG244 folded before Flop (didn't bet)
Seat 4: Onestop4u (button) folded before Flop (didn't bet)
Seat 5: Willishoveandbb (small blind) collected ($2.58)



PokerStars Hand #222952634355:  Hold'em No Limit ($0.05/$0.10 USD) - 2021/01/23 7:53:31 ET
Table 'Saito II' 6-max Seat #6 is the button
Seat 1: notzukau ($10 in chips) 
Seat 2: ivan2772ms ($10.14 in chips) 
Seat 3: YuYuYu777 ($10.82 in chips) 
Seat 4: jayzz6 ($10 in chips) 
Seat 5: KingBiscuitT ($10 in chips) 
Seat 6: Enricola ($11.27 in chips) 
notzukau: posts small blind $0.05
ivan2772ms: posts big blind $0.10
*** HOLE CARDS ***
YuYuYu777: raises $0.20 to $0.30
jayzz6: folds 
KingBiscuitT: folds 
Enricola: folds 
notzukau: folds 
ivan2772ms: folds 
Uncalled bet ($0.20) returned to YuYuYu777
YuYuYu777 collected $0.25 from pot
YuYuYu777: doesn't show hand 
*** SUMMARY ***
Total pot $0.25 | Rake $0 
Seat 1: notzukau (small blind) folded before Flop
Seat 2: ivan2772ms (big blind) folded before Flop
Seat 3: YuYuYu777 collected ($0.25)
Seat 4: jayzz6 folded before Flop (didn't bet)
Seat 5: KingBiscuitT folded before Flop (didn't bet)
Seat 6: Enricola (button) folded before Flop (didn't bet)



PokerStars Hand #222954398408:  Hold'em No Limit ($0.05/$0.10 USD) - 2021/01/23 9:03:18 ET
Table 'Saito II' 6-max Seat #5 is the button
Seat 1: ivan2772ms ($10 in chips) 
Seat 2: Tyoma_Kovach ($12.45 in chips) 
Seat 3: SERG244 ($17.16 in chips) 
Seat 4: Onestop4u ($4.49 in chips) 
Seat 5: Willishoveandbb ($11.13 in chips) 
ivan2772ms: posts small blind $0.05
Tyoma_Kovach: posts big blind $0.10
*** HOLE CARDS ***
SERG244: folds 
Onestop4u: calls $0.10
Willishoveandbb: raises $0.30 to $0.40
ivan2772ms: folds 
Tyoma_Kovach: folds 
Onestop4u: calls $0.30
*** FLOP *** [Ks 9d 4h]
Onestop4u: checks 
Willishoveandbb: bets $0.40
Onestop4u: folds 
Uncalled bet ($0.40) returned to Willishoveandbb
Willishoveandbb collected $0.91 from pot
*** SUMMARY ***
Total pot $0.95 | Rake $0.04 
Board [Ks 9d 4h]
Seat 1: ivan2772ms (small blind) folded before Flop
Seat 2: Tyoma_Kovach (big blind) folded before Flop
Seat 3: SERG244 folded before Flop (didn't bet)
Seat 4: Onestop4u folded on the Flop
Seat 5: Willishoveandbb (button) collected ($0.91)



PokerStars Hand #222952638228:  Hold'em No Limit ($0.05/$0.10 USD) - 2021/01/23 7:53:41 ET
Table 'Saito II' 6-max Seat #1 is the button
Seat 1: notzukau ($10 in chips) 
Seat 2: ivan2772ms ($10.04 in chips) 
Seat 3: YuYuYu777 ($10.97 in chips) 
Seat 4: jayzz6 ($10 in chips) 
Seat 5: KingBiscuitT ($10 in chips) 
Seat 6: Enricola ($11.27 in chips) 
ivan2772ms: posts small blind $0.05
YuYuYu777: posts big blind $0.10
*** HOLE CARDS ***
jayzz6: folds 
KingBiscuitT: folds 
Enricola: folds 
notzukau: raises $0.15 to $0.25
ivan2772ms: folds 
YuYuYu777: calls $0.15
*** FLOP *** [Qc 4h 4d]
YuYuYu777: checks 
notzukau: checks 
*** TURN *** [Qc 4h 4d] [4s]
YuYuYu777: checks 
notzukau: bets $0.37
YuYuYu777: calls $0.37
*** RIVER *** [Qc 4h 4d 4s] [6s]
YuYuYu777: checks 
notzukau: bets $0.98
YuYuYu777: calls $0.98
*** SHOW DOWN ***
notzukau: shows [5h Qh] (a full house, Fours full of Queens)
YuYuYu777: mucks hand 
notzukau collected $3.10 from pot
*** SUMMARY ***
Total pot $3.25 | Rake $0.15 
Board [Qc 4h 4d 4s 6s]
Seat 1: notzukau (button) showed [5h Qh] and won ($3.10) with a full house, Fours full of Queens
Seat 2: ivan2772ms (small blind) folded before Flop
Seat 3: YuYuYu777 (big blind) mucked
Seat 4: jayzz6 folded before Flop (didn't bet)
Seat 5: KingBiscuitT folded before Flop (didn't bet)
Seat 6: Enricola folded before Flop (didn't bet)



PokerStars Hand #222954405739:  Hold'em No Limit ($0.05/$0.10 USD) - 2021/01/23 9:03:33 ET
Table 'Saito II' 6-max Seat #1 is the button
Seat 1: ivan2772ms ($9.95 in chips) 
Seat 2: Tyoma_Kovach ($12.35 in chips) 
Seat 3: SERG244 ($17.16 in chips) 
Seat 4: Onestop4u ($4.09 in chips) 
Seat 5: Willishoveandbb ($11.64 in chips) 
Tyoma_Kovach: posts small blind $0.05
SERG244: posts big blind $0.10
*** HOLE CARDS ***
Onestop4u: folds 
Willishoveandbb: folds 
ivan2772ms: folds 
Tyoma_Kovach: raises $0.20 to $0.30
SERG244: folds 
Uncalled bet ($0.20) returned to Tyoma_Kovach
Tyoma_Kovach collected $0.20 from pot
Tyoma_Kovach: doesn't show hand 
*** SUMMARY ***
Total pot $0.20 | Rake $0 
Seat 1: ivan2772ms (button) folded before Flop (didn't bet)
Seat 2: Tyoma_Kovach (small blind) collected ($0.20)
Seat 3: SERG244 (big blind) folded before Flop
Seat 4: Onestop4u folded before Flop (didn't bet)
Seat 5: Willishoveandbb folded before Flop (didn't bet)



PokerStars Hand #222952649679:  Hold'em No Limit ($0.05/$0.10 USD) - 2021/01/23 7:54:11 ET
Table 'Saito II' 6-max Seat #2 is the button
Seat 1: notzukau ($11.50 in chips) 
Seat 2: ivan2772ms ($9.99 in chips) 
Seat 3: YuYuYu777 ($9.37 in chips) 
Seat 4: jayzz6 ($10 in chips) 
Seat 5: KingBiscuitT ($10 in chips) 
Seat 6: Enricola ($11.27 in chips) 
YuYuYu777: posts small blind $0.05
jayzz6: posts big blind $0.10
*** HOLE CARDS ***
KingBiscuitT: folds 
Enricola: folds 
notzukau: raises $0.15 to $0.25
ivan2772ms: folds 
YuYuYu777: folds 
jayzz6: folds 
Uncalled bet ($0.15) returned to notzukau
notzukau collected $0.25 from pot
notzukau: doesn't show hand 
*** SUMMARY ***
Total pot $0.25 | Rake $0 
Seat 1: notzukau collected ($0.25)
Seat 2: ivan2772ms (button) folded before Flop (didn't bet)
Seat 3: YuYuYu777 (small blind) folded before Flop
Seat 4: jayzz6 (big blind) folded before Flop
Seat 5: KingBiscuitT folded before Flop (didn't bet)
Seat 6: Enricola folded before Flop (didn't bet)



PokerStars Hand #222954413166:  Hold'em No Limit ($0.05/$0.10 USD) - 2021/01/23 9:03:48 ET
Table 'Saito II' 6-max Seat #2 is the button
Seat 1: ivan2772ms ($9.95 in chips) 
Seat 2: Tyoma_Kovach ($12.45 in chips) 
Seat 3: SERG244 ($17.06 in chips) 
Seat 4: Onestop4u ($4.09 in chips) 
Seat 5: Willishoveandbb ($11.64 in chips) 
SERG244: posts small blind $0.05
Onestop4u: posts big blind $0.10
*** HOLE CARDS ***
Willishoveandbb: folds 
ivan2772ms: folds 
Tyoma_Kovach: raises $0.15 to $0.25
SERG244: raises $0.68 to $0.93
JackieACEE is disconnected 
Onestop4u: folds 
Tyoma_Kovach: raises $1.53 to $2.46
SERG244: calls $1.53
*** FLOP *** [9d Jh 2s]
SERG244: checks 
Tyoma_Kovach: bets $1.58
SERG244: raises $13.02 to $14.60 and is all-in
Tyoma_Kovach: folds 
Uncalled bet ($13.02) returned to SERG244
SERG244 collected $7.81 from pot
SERG244: doesn't show hand 
*** SUMMARY ***
Total pot $8.18 | Rake $0.37 
Board [9d Jh 2s]
Seat 1: ivan2772ms folded before Flop (didn't bet)
Seat 2: Tyoma_Kovach (button) folded on the Flop
Seat 3: SERG244 (small blind) collected ($7.81)
Seat 4: Onestop4u (big blind) folded before Flop
Seat 5: Willishoveandbb folded before Flop (didn't bet)



PokerStars Hand #222952657988:  Hold'em No Limit ($0.05/$0.10 USD) - 2021/01/23 7:54:32 ET
Table 'Saito II' 6-max Seat #3 is the button
Seat 1: notzukau ($11.65 in chips) 
Seat 2: ivan2772ms ($9.99 in chips) 
Seat 3: YuYuYu777 ($9.32 in chips) 
Seat 4: jayzz6 ($10 in chips) 
Seat 5: KingBiscuitT ($10 in chips) 
Seat 6: Enricola ($11.27 in chips) 
jayzz6: posts small blind $0.05
KingBiscuitT: posts big blind $0.10
*** HOLE CARDS ***
Enricola: folds 
notzukau: folds 
ivan2772ms: folds 
YuYuYu777: raises $0.20 to $0.30
jayzz6: folds 
KingBiscuitT: raises $1.70 to $2
YuYuYu777: calls $1.70
*** FLOP *** [6c 2d 5s]
KingBiscuitT: bets $2.58
YuYuYu777: calls $2.58
*** TURN *** [6c 2d 5s] [Qs]
KingBiscuitT: bets $5.42 and is all-in
YuYuYu777: calls $4.74 and is all-in
Uncalled bet ($0.68) returned to KingBiscuitT
*** RIVER *** [6c 2d 5s Qs] [Jd]
*** SHOW DOWN ***
KingBiscuitT: shows [Jc Js] (three of a kind, Jacks)
YuYuYu777: shows [7s 7c] (a pair of Sevens)
KingBiscuitT collected $17.85 from pot
*** SUMMARY ***
Total pot $18.69 | Rake $0.84 
Board [6c 2d 5s Qs Jd]
Seat 1: notzukau folded before Flop (didn't bet)
Seat 2: ivan2772ms folded before Flop (didn't bet)
Seat 3: YuYuYu777 (button) showed [7s 7c] and lost with a pair of Sevens
Seat 4: jayzz6 (small blind) folded before Flop
Seat 5: KingBiscuitT (big blind) showed [Jc Js] and won ($17.85) with three of a kind, Jacks
Seat 6: Enricola folded before Flop (didn't bet)



PokerStars Hand #222954434207:  Hold'em No Limit ($0.05/$0.10 USD) - 2021/01/23 9:04:31 ET
Table 'Saito II' 6-max Seat #3 is the button
Seat 1: ivan2772ms ($9.95 in chips) 
Seat 2: Tyoma_Kovach ($10 in chips) 
Seat 3: SERG244 ($20.83 in chips) 
Seat 4: Onestop4u ($3.99 in chips) 
Seat 5: Willishoveandbb ($11.64 in chips) 
Onestop4u: posts small blind $0.05
Willishoveandbb: posts big blind $0.10
*** HOLE CARDS ***
ivan2772ms: folds 
Tyoma_Kovach: folds 
SERG244: folds 
Onestop4u: calls $0.05
Willishoveandbb: checks 
*** FLOP *** [3d 3s 4d]
Onestop4u: checks 
Willishoveandbb: bets $0.10
Onestop4u: folds 
Uncalled bet ($0.10) returned to Willishoveandbb
Willishoveandbb collected $0.19 from pot
*** SUMMARY ***
Total pot $0.20 | Rake $0.01 
Board [3d 3s 4d]
Seat 1: ivan2772ms folded before Flop (didn't bet)
Seat 2: Tyoma_Kovach folded before Flop (didn't bet)
Seat 3: SERG244 (button) folded before Flop (didn't bet)
Seat 4: Onestop4u (small blind) folded on the Flop
Seat 5: Willishoveandbb (big blind) collected ($0.19)



PokerStars Hand #222952675150:  Hold'em No Limit ($0.05/$0.10 USD) - 2021/01/23 7:55:18 ET
Table 'Saito II' 6-max Seat #4 is the button
Seat 1: notzukau ($11.65 in chips) 
Seat 2: ivan2772ms ($9.99 in chips) 
Seat 3: YuYuYu777 ($4 in chips) 
Seat 4: jayzz6 ($10 in chips) 
Seat 5: KingBiscuitT ($18.53 in chips) 
Seat 6: Enricola ($11.27 in chips) 
KingBiscuitT: posts small blind $0.05
Enricola: posts big blind $0.10
*** HOLE CARDS ***
notzukau: raises $0.15 to $0.25
ivan2772ms: folds 
YuYuYu777: calls $0.25
jayzz6: folds 
KingBiscuitT: folds 
Enricola: calls $0.15
*** FLOP *** [9s 2c 5c]
Enricola: checks 
notzukau: checks 
YuYuYu777: checks 
*** TURN *** [9s 2c 5c] [4s]
Enricola: bets $0.38
notzukau: calls $0.38
YuYuYu777: calls $0.38
*** RIVER *** [9s 2c 5c 4s] [4h]
Enricola: checks 
notzukau: checks 
YuYuYu777: bets $1.85
Enricola: folds 
notzukau: folds 
Uncalled bet ($1.85) returned to YuYuYu777
YuYuYu777 collected $1.85 from pot
YuYuYu777: doesn't show hand 
*** SUMMARY ***
Total pot $1.94 | Rake $0.09 
Board [9s 2c 5c 4s 4h]
Seat 1: notzukau folded on the River
Seat 2: ivan2772ms folded before Flop (didn't bet)
Seat 3: YuYuYu777 collected ($1.85)
Seat 4: jayzz6 (button) folded before Flop (didn't bet)
Seat 5: KingBiscuitT (small blind) folded before Flop
Seat 6: Enricola (big blind) folded on the River



PokerStars Hand #222954443177:  Hold'em No Limit ($0.05/$0.10 USD) - 2021/01/23 9:04:49 ET
Table 'Saito II' 6-max Seat #4 is the button
Seat 1: ivan2772ms ($9.95 in chips) 
Seat 2: Tyoma_Kovach ($10 in chips) 
Seat 3: SERG244 ($20.83 in chips) 
Seat 4: Onestop4u ($3.89 in chips) 
Seat 5: Willishoveandbb ($11.73 in chips) 
Willishoveandbb: posts small blind $0.05
ivan2772ms: posts big blind $0.10
*** HOLE CARDS ***
JackieACEE leaves the table
Tyoma_Kovach: raises $0.20 to $0.30
SERG244: folds 
Onestop4u: calls $0.30
Willishoveandbb: folds 
ivan2772ms: calls $0.20
*** FLOP *** [Qc Ac 6d]
ivan2772ms: checks 
Tyoma_Kovach: bets $0.30
Onestop4u: calls $0.30
ivan2772ms: folds 
*** TURN *** [Qc Ac 6d] [Jc]
Tyoma_Kovach: checks 
Onestop4u: checks 
*** RIVER *** [Qc Ac 6d Jc] [8s]
Tyoma_Kovach: bets $1.11
Onestop4u: folds 
Uncalled bet ($1.11) returned to Tyoma_Kovach
Tyoma_Kovach collected $1.48 from pot
Tyoma_Kovach: doesn't show hand 
Jesus Ololo joins the table at seat #6 
*** SUMMARY ***
Total pot $1.55 | Rake $0.07 
Board [Qc Ac 6d Jc 8s]
Seat 1: ivan2772ms (big blind) folded on the Flop
Seat 2: Tyoma_Kovach collected ($1.48)
Seat 3: SERG244 folded before Flop (didn't bet)
Seat 4: Onestop4u (button) folded on the River
Seat 5: Willishoveandbb (small blind) folded before Flop



PokerStars Hand #222952693487:  Hold'em No Limit ($0.05/$0.10 USD) - 2021/01/23 7:56:14 ET
Table 'Saito II' 6-max Seat #5 is the button
Seat 1: notzukau ($11.02 in chips) 
Seat 2: ivan2772ms ($9.99 in chips) 
Seat 3: YuYuYu777 ($10 in chips) 
Seat 4: jayzz6 ($10 in chips) 
Seat 5: KingBiscuitT ($18.48 in chips) 
Seat 6: Enricola ($10.64 in chips) 
Enricola: posts small blind $0.05
notzukau: posts big blind $0.10
*** HOLE CARDS ***
ivan2772ms: folds 
YuYuYu777: raises $0.20 to $0.30
jayzz6: folds 
KingBiscuitT: folds 
Enricola: folds 
notzukau: folds 
Uncalled bet ($0.20) returned to YuYuYu777
YuYuYu777 collected $0.25 from pot
YuYuYu777: doesn't show hand 
*** SUMMARY ***
Total pot $0.25 | Rake $0 
Seat 1: notzukau (big blind) folded before Flop
Seat 2: ivan2772ms folded before Flop (didn't bet)
Seat 3: YuYuYu777 collected ($0.25)
Seat 4: jayzz6 folded before Flop (didn't bet)
Seat 5: KingBiscuitT (button) folded before Flop (didn't bet)
Seat 6: Enricola (small blind) folded before Flop



PokerStars Hand #222954460079:  Hold'em No Limit ($0.05/$0.10 USD) - 2021/01/23 9:05:24 ET
Table 'Saito II' 6-max Seat #5 is the button
Seat 1: ivan2772ms ($10 in chips) 
Seat 2: Tyoma_Kovach ($10.88 in chips) 
Seat 3: SERG244 ($20.83 in chips) 
Seat 4: Onestop4u ($3.29 in chips) 
Seat 5: Willishoveandbb ($11.68 in chips) 
ivan2772ms: posts small blind $0.05
Tyoma_Kovach: posts big blind $0.10
*** HOLE CARDS ***
SERG244: folds 
Onestop4u: calls $0.10
Willishoveandbb: folds 
ivan2772ms: folds 
Tyoma_Kovach: checks 
*** FLOP *** [9c Td Qs]
Tyoma_Kovach: checks 
Onestop4u: checks 
*** TURN *** [9c Td Qs] [As]
Tyoma_Kovach: checks 
Onestop4u: checks 
*** RIVER *** [9c Td Qs As] [Qc]
Tyoma_Kovach: checks 
Onestop4u: bets $0.20
Tyoma_Kovach: calls $0.20
*** SHOW DOWN ***
Onestop4u: shows [7d 5d] (a pair of Queens)
Tyoma_Kovach: shows [Ts 4c] (two pair, Queens and Tens)
Tyoma_Kovach collected $0.62 from pot
*** SUMMARY ***
Total pot $0.65 | Rake $0.03 
Board [9c Td Qs As Qc]
Seat 1: ivan2772ms (small blind) folded before Flop
Seat 2: Tyoma_Kovach (big blind) showed [Ts 4c] and won ($0.62) with two pair, Queens and Tens
Seat 3: SERG244 folded before Flop (didn't bet)
Seat 4: Onestop4u showed [7d 5d] and lost with a pair of Queens
Seat 5: Willishoveandbb (button) folded before Flop (didn't bet)



PokerStars Hand #222952697437:  Hold'em No Limit ($0.05/$0.10 USD) - 2021/01/23 7:56:26 ET
Table 'Saito II' 6-max Seat #6 is the button
Seat 1: notzukau ($10.92 in chips) 
Seat 2: ivan2772ms ($9.99 in chips) 
Seat 3: YuYuYu777 ($10.15 in chips) 
Seat 4: jayzz6 ($10 in chips) 
Seat 5: KingBiscuitT ($18.48 in chips) 
Seat 6: Enricola ($10.59 in chips) 
notzukau: posts small blind $0.05
ivan2772ms: posts big blind $0.10
*** HOLE CARDS ***
YuYuYu777: raises $0.20 to $0.30
jayzz6: folds 
KingBiscuitT: folds 
Enricola: folds 
notzukau: folds 
ivan2772ms: calls $0.20
*** FLOP *** [Jc 6d Kh]
ivan2772ms: checks 
YuYuYu777: checks 
*** TURN *** [Jc 6d Kh] [Jh]
ivan2772ms: checks 
YuYuYu777: checks 
*** RIVER *** [Jc 6d Kh Jh] [Tc]
ivan2772ms: bets $0.47
YuYuYu777: folds 
Uncalled bet ($0.47) returned to ivan2772ms
ivan2772ms collected $0.62 from pot
ivan2772ms: doesn't show hand 
*** SUMMARY ***
Total pot $0.65 | Rake $0.03 
Board [Jc 6d Kh Jh Tc]
Seat 1: notzukau (small blind) folded before Flop
Seat 2: ivan2772ms (big blind) collected ($0.62)
Seat 3: YuYuYu777 folded on the River
Seat 4: jayzz6 folded before Flop (didn't bet)
Seat 5: KingBiscuitT folded before Flop (didn't bet)
Seat 6: Enricola (button) folded before Flop (didn't bet)



PokerStars Hand #222954480535:  Hold'em No Limit ($0.05/$0.10 USD) - 2021/01/23 9:06:06 ET
Table 'Saito II' 6-max Seat #1 is the button
Seat 1: ivan2772ms ($9.95 in chips) 
Seat 2: Tyoma_Kovach ($11.20 in chips) 
Seat 3: SERG244 ($20.83 in chips) 
Seat 4: Onestop4u ($2.99 in chips) 
Seat 5: Willishoveandbb ($11.68 in chips) 
Tyoma_Kovach: posts small blind $0.05
SERG244: posts big blind $0.10
Jesus Ololo: sits out 
*** HOLE CARDS ***
Onestop4u: folds 
Willishoveandbb: folds 
ivan2772ms: folds 
Tyoma_Kovach: folds 
Uncalled bet ($0.05) returned to SERG244
SERG244 collected $0.10 from pot
SERG244: doesn't show hand 
*** SUMMARY ***
Total pot $0.10 | Rake $0 
Seat 1: ivan2772ms (button) folded before Flop (didn't bet)
Seat 2: Tyoma_Kovach (small blind) folded before Flop
Seat 3: SERG244 (big blind) collected ($0.10)
Seat 4: Onestop4u folded before Flop (didn't bet)
Seat 5: Willishoveandbb folded before Flop (didn't bet)



PokerStars Hand #222952705156:  Hold'em No Limit ($0.05/$0.10 USD) - 2021/01/23 7:56:50 ET
Table 'Saito II' 6-max Seat #1 is the button
Seat 1: notzukau ($10.87 in chips) 
Seat 2: ivan2772ms ($10.31 in chips) 
Seat 3: YuYuYu777 ($9.85 in chips) 
Seat 4: jayzz6 ($10 in chips) 
Seat 5: KingBiscuitT ($18.48 in chips) 
Seat 6: Enricola ($10.59 in chips) 
ivan2772ms: posts small blind $0.05
YuYuYu777: posts big blind $0.10
*** HOLE CARDS ***
jayzz6: folds 
KingBiscuitT: folds 
Enricola: folds 
notzukau: raises $0.15 to $0.25
ivan2772ms: folds 
YuYuYu777: raises $0.55 to $0.80
notzukau: calls $0.55
*** FLOP *** [5d 2h 4s]
YuYuYu777: checks 
notzukau: checks 
*** TURN *** [5d 2h 4s] [Jc]
YuYuYu777: checks 
notzukau: bets $1.26
YuYuYu777: folds 
Uncalled bet ($1.26) returned to notzukau
notzukau collected $1.58 from pot
notzukau: doesn't show hand 
*** SUMMARY ***
Total pot $1.65 | Rake $0.07 
Board [5d 2h 4s Jc]
Seat 1: notzukau (button) collected ($1.58)
Seat 2: ivan2772ms (small blind) folded before Flop
Seat 3: YuYuYu777 (big blind) folded on the Turn
Seat 4: jayzz6 folded before Flop (didn't bet)
Seat 5: KingBiscuitT folded before Flop (didn't bet)
Seat 6: Enricola folded before Flop (didn't bet)



PokerStars Hand #222954486412:  Hold'em No Limit ($0.05/$0.10 USD) - 2021/01/23 9:06:18 ET
Table 'Saito II' 6-max Seat #2 is the button
Seat 1: ivan2772ms ($9.95 in chips) 
Seat 2: Tyoma_Kovach ($11.15 in chips) 
Seat 3: SERG244 ($20.88 in chips) 
Seat 4: Onestop4u ($2.99 in chips) 
Seat 5: Willishoveandbb ($11.68 in chips) 
SERG244: posts small blind $0.05
Onestop4u: posts big blind $0.10
Jesus Ololo: sits out 
*** HOLE CARDS ***
Willishoveandbb: raises $0.15 to $0.25
ivan2772ms: folds 
Tyoma_Kovach: folds 
SERG244: folds 
Onestop4u: calls $0.15
*** FLOP *** [Ac 2s 9h]
Onestop4u: checks 
Willishoveandbb: bets $0.23
Onestop4u: folds 
Uncalled bet ($0.23) returned to Willishoveandbb
Willishoveandbb collected $0.53 from pot
*** SUMMARY ***
Total pot $0.55 | Rake $0.02 
Board [Ac 2s 9h]
Seat 1: ivan2772ms folded before Flop (didn't bet)
Seat 2: Tyoma_Kovach (button) folded before Flop (didn't bet)
Seat 3: SERG244 (small blind) folded before Flop
Seat 4: Onestop4u (big blind) folded on the Flop
Seat 5: Willishoveandbb collected ($0.53)



PokerStars Hand #222952713731:  Hold'em No Limit ($0.05/$0.10 USD) - 2021/01/23 7:57:16 ET
Table 'Saito II' 6-max Seat #2 is the button
Seat 1: notzukau ($11.65 in chips) 
Seat 2: ivan2772ms ($10.26 in chips) 
Seat 3: YuYuYu777 ($9.05 in chips) 
Seat 4: jayzz6 ($10 in chips) 
Seat 5: KingBiscuitT ($18.48 in chips) 
Seat 6: Enricola ($10.59 in chips) 
YuYuYu777: posts small blind $0.05
jayzz6: posts big blind $0.10
*** HOLE CARDS ***
KingBiscuitT: folds 
Enricola: folds 
notzukau: raises $0.15 to $0.25
ivan2772ms: folds 
YuYuYu777: folds 
jayzz6: folds 
Uncalled bet ($0.15) returned to notzukau
notzukau collected $0.25 from pot
notzukau: doesn't show hand 
*** SUMMARY ***
Total pot $0.25 | Rake $0 
Seat 1: notzukau collected ($0.25)
Seat 2: ivan2772ms (button) folded before Flop (didn't bet)
Seat 3: YuYuYu777 (small blind) folded before Flop
Seat 4: jayzz6 (big blind) folded before Flop
Seat 5: KingBiscuitT folded before Flop (didn't bet)
Seat 6: Enricola folded before Flop (didn't bet)



PokerStars Hand #222954493848:  Hold'em No Limit ($0.05/$0.10 USD) - 2021/01/23 9:06:33 ET
Table 'Saito II' 6-max Seat #3 is the button
Seat 1: ivan2772ms ($9.95 in chips) 
Seat 2: Tyoma_Kovach ($11.15 in chips) 
Seat 3: SERG244 ($20.83 in chips) 
Seat 4: Onestop4u ($2.74 in chips) 
Seat 5: Willishoveandbb ($11.96 in chips) 
Onestop4u: posts small blind $0.05
Willishoveandbb: posts big blind $0.10
Jesus Ololo: sits out 
*** HOLE CARDS ***
ivan2772ms: folds 
Tyoma_Kovach: raises $0.18 to $0.28
SERG244: folds 
Onestop4u: folds 
Willishoveandbb: folds 
Uncalled bet ($0.18) returned to Tyoma_Kovach
Tyoma_Kovach collected $0.25 from pot
Tyoma_Kovach: doesn't show hand 
*** SUMMARY ***
Total pot $0.25 | Rake $0 
Seat 1: ivan2772ms folded before Flop (didn't bet)
Seat 2: Tyoma_Kovach collected ($0.25)
Seat 3: SERG244 (button) folded before Flop (didn't bet)
Seat 4: Onestop4u (small blind) folded before Flop
Seat 5: Willishoveandbb (big blind) folded before Flop



PokerStars Hand #222952719284:  Hold'em No Limit ($0.05/$0.10 USD) - 2021/01/23 7:57:33 ET
Table 'Saito II' 6-max Seat #3 is the button
Seat 1: notzukau ($11.80 in chips) 
Seat 2: ivan2772ms ($10.26 in chips) 
Seat 3: YuYuYu777 ($9 in chips) 
Seat 4: jayzz6 ($10 in chips) 
Seat 5: KingBiscuitT ($18.48 in chips) 
Seat 6: Enricola ($10.59 in chips) 
jayzz6: posts small blind $0.05
KingBiscuitT: posts big blind $0.10
*** HOLE CARDS ***
Enricola: raises $0.25 to $0.35
notzukau: folds 
ivan2772ms: folds 
YuYuYu777: calls $0.35
jayzz6: folds 
KingBiscuitT: folds 
*** FLOP *** [3c 8c 7h]
Enricola: bets $0.81
YuYuYu777: raises $7.84 to $8.65 and is all-in
Enricola: calls $7.84
*** TURN *** [3c 8c 7h] [6h]
*** RIVER *** [3c 8c 7h 6h] [9c]
*** SHOW DOWN ***
Enricola: shows [9s 6s] (two pair, Nines and Sixes)
YuYuYu777: shows [4h 3s] (a pair of Threes)
Enricola collected $17.33 from pot
*** SUMMARY ***
Total pot $18.15 | Rake $0.82 
Board [3c 8c 7h 6h 9c]
Seat 1: notzukau folded before Flop (didn't bet)
Seat 2: ivan2772ms folded before Flop (didn't bet)
Seat 3: YuYuYu777 (button) showed [4h 3s] and lost with a pair of Threes
Seat 4: jayzz6 (small blind) folded before Flop
Seat 5: KingBiscuitT (big blind) folded before Flop
Seat 6: Enricola showed [9s 6s] and won ($17.33) with two pair, Nines and Sixes



PokerStars Hand #222954498312:  Hold'em No Limit ($0.05/$0.10 USD) - 2021/01/23 9:06:42 ET
Table 'Saito II' 6-max Seat #4 is the button
Seat 1: ivan2772ms ($9.95 in chips) 
Seat 2: Tyoma_Kovach ($11.30 in chips) 
Seat 3: SERG244 ($20.83 in chips) 
Seat 4: Onestop4u ($2.69 in chips) 
Seat 5: Willishoveandbb ($11.86 in chips) 
Seat 6: Jesus Ololo ($13.06 in chips) 
Willishoveandbb: posts small blind $0.05
Jesus Ololo: posts big blind $0.10
*** HOLE CARDS ***
ivan2772ms: folds 
Tyoma_Kovach: folds 
SERG244: folds 
Onestop4u: raises $0.10 to $0.20
Willishoveandbb: calls $0.15
Jesus Ololo: folds 
*** FLOP *** [2s 2d 8c]
Willishoveandbb: checks 
Onestop4u: bets $0.50
Willishoveandbb: folds 
Uncalled bet ($0.50) returned to Onestop4u
Onestop4u collected $0.48 from pot
Onestop4u: doesn't show hand 
*** SUMMARY ***
Total pot $0.50 | Rake $0.02 
Board [2s 2d 8c]
Seat 1: ivan2772ms folded before Flop (didn't bet)
Seat 2: Tyoma_Kovach folded before Flop (didn't bet)
Seat 3: SERG244 folded before Flop (didn't bet)
Seat 4: Onestop4u (button) collected ($0.48)
Seat 5: Willishoveandbb (small blind) folded on the Flop
Seat 6: Jesus Ololo (big blind) folded before Flop



PokerStars Hand #222952728223:  Hold'em No Limit ($0.05/$0.10 USD) - 2021/01/23 7:58:00 ET
Table 'Saito II' 6-max Seat #4 is the button
Seat 1: notzukau ($11.80 in chips) 
Seat 2: ivan2772ms ($10.26 in chips) 
Seat 3: YuYuYu777 ($4 in chips) 
Seat 4: jayzz6 ($10 in chips) 
Seat 5: KingBiscuitT ($18.38 in chips) 
Seat 6: Enricola ($18.92 in chips) 
KingBiscuitT: posts small blind $0.05
Enricola: posts big blind $0.10
*** HOLE CARDS ***
notzukau: folds 
ivan2772ms: folds 
YuYuYu777: folds 
YuYuYu777 leaves the table
father here joins the table at seat #3 
jayzz6 has timed out
jayzz6: folds 
KingBiscuitT: raises $0.20 to $0.30
Enricola: calls $0.20
*** FLOP *** [7d Ah 3h]
KingBiscuitT: bets $0.38
Enricola: calls $0.38
*** TURN *** [7d Ah 3h] [Ad]
KingBiscuitT: checks 
Enricola: bets $0.65
KingBiscuitT: folds 
Uncalled bet ($0.65) returned to Enricola
Enricola collected $1.30 from pot
Enricola: doesn't show hand 
*** SUMMARY ***
Total pot $1.36 | Rake $0.06 
Board [7d Ah 3h Ad]
Seat 1: notzukau folded before Flop (didn't bet)
Seat 2: ivan2772ms folded before Flop (didn't bet)
Seat 3: YuYuYu777 folded before Flop (didn't bet)
Seat 4: jayzz6 (button) folded before Flop (didn't bet)
Seat 5: KingBiscuitT (small blind) folded on the Turn
Seat 6: Enricola (big blind) collected ($1.30)



PokerStars Hand #222954508372:  Hold'em No Limit ($0.05/$0.10 USD) - 2021/01/23 9:07:03 ET
Table 'Saito II' 6-max Seat #5 is the button
Seat 1: ivan2772ms ($9.95 in chips) 
Seat 2: Tyoma_Kovach ($11.30 in chips) 
Seat 3: SERG244 ($20.83 in chips) 
Seat 4: Onestop4u ($2.97 in chips) 
Seat 5: Willishoveandbb ($11.66 in chips) 
Seat 6: Jesus Ololo ($12.96 in chips) 
Jesus Ololo: posts small blind $0.05
ivan2772ms: posts big blind $0.10
*** HOLE CARDS ***
Tyoma_Kovach: folds 
SERG244: folds 
Onestop4u: calls $0.10
Willishoveandbb: raises $0.30 to $0.40
Jesus Ololo: folds 
ivan2772ms: folds 
Onestop4u: folds 
Uncalled bet ($0.30) returned to Willishoveandbb
Willishoveandbb collected $0.35 from pot
*** SUMMARY ***
Total pot $0.35 | Rake $0 
Seat 1: ivan2772ms (big blind) folded before Flop
Seat 2: Tyoma_Kovach folded before Flop (didn't bet)
Seat 3: SERG244 folded before Flop (didn't bet)
Seat 4: Onestop4u folded before Flop
Seat 5: Willishoveandbb (button) collected ($0.35)
Seat 6: Jesus Ololo (small blind) folded before Flop



PokerStars Hand #222952739126:  Hold'em No Limit ($0.05/$0.10 USD) - 2021/01/23 7:58:34 ET
Table 'Saito II' 6-max Seat #5 is the button
Seat 1: notzukau ($11.80 in chips) 
Seat 2: ivan2772ms ($10.26 in chips) 
Seat 4: jayzz6 ($10 in chips) 
Seat 5: KingBiscuitT ($17.70 in chips) 
Seat 6: Enricola ($19.54 in chips) 
Enricola: posts small blind $0.05
notzukau: posts big blind $0.10
father here: sits out 
*** HOLE CARDS ***
ivan2772ms: raises $0.20 to $0.30
jayzz6: folds 
KingBiscuitT: folds 
Enricola: folds 
notzukau: calls $0.20
*** FLOP *** [Td 2s 7d]
notzukau: checks 
ivan2772ms: bets $0.47
notzukau: folds 
Uncalled bet ($0.47) returned to ivan2772ms
ivan2772ms collected $0.62 from pot
ivan2772ms: doesn't show hand 
*** SUMMARY ***
Total pot $0.65 | Rake $0.03 
Board [Td 2s 7d]
Seat 1: notzukau (big blind) folded on the Flop
Seat 2: ivan2772ms collected ($0.62)
Seat 4: jayzz6 folded before Flop (didn't bet)
Seat 5: KingBiscuitT (button) folded before Flop (didn't bet)
Seat 6: Enricola (small blind) folded before Flop



PokerStars Hand #222954514481:  Hold'em No Limit ($0.05/$0.10 USD) - 2021/01/23 9:07:15 ET
Table 'Saito II' 6-max Seat #6 is the button
Seat 1: ivan2772ms ($9.85 in chips) 
Seat 2: Tyoma_Kovach ($11.30 in chips) 
Seat 3: SERG244 ($20.83 in chips) 
Seat 4: Onestop4u ($2.87 in chips) 
Seat 5: Willishoveandbb ($11.91 in chips) 
Seat 6: Jesus Ololo ($12.91 in chips) 
ivan2772ms: posts small blind $0.05
Tyoma_Kovach: posts big blind $0.10
*** HOLE CARDS ***
SERG244: folds 
Onestop4u: calls $0.10
Willishoveandbb: raises $0.30 to $0.40
Jesus Ololo: calls $0.40
ivan2772ms: folds 
Tyoma_Kovach: folds 
Onestop4u: calls $0.30
*** FLOP *** [5d 9h 8d]
Onestop4u: checks 
Willishoveandbb: bets $1
Jesus Ololo: folds 
Onestop4u: folds 
Uncalled bet ($1) returned to Willishoveandbb
Willishoveandbb collected $1.29 from pot
*** SUMMARY ***
Total pot $1.35 | Rake $0.06 
Board [5d 9h 8d]
Seat 1: ivan2772ms (small blind) folded before Flop
Seat 2: Tyoma_Kovach (big blind) folded before Flop
Seat 3: SERG244 folded before Flop (didn't bet)
Seat 4: Onestop4u folded on the Flop
Seat 5: Willishoveandbb collected ($1.29)
Seat 6: Jesus Ololo (button) folded on the Flop



PokerStars Hand #222952749068:  Hold'em No Limit ($0.05/$0.10 USD) - 2021/01/23 7:59:04 ET
Table 'Saito II' 6-max Seat #6 is the button
Seat 1: notzukau ($11.50 in chips) 
Seat 2: ivan2772ms ($10.58 in chips) 
Seat 4: jayzz6 ($10 in chips) 
Seat 5: KingBiscuitT ($17.70 in chips) 
Seat 6: Enricola ($19.49 in chips) 
notzukau: posts small blind $0.05
ivan2772ms: posts big blind $0.10
father here: sits out 
*** HOLE CARDS ***
jayzz6: folds 
KingBiscuitT: folds 
Enricola: folds 
notzukau: folds 
Uncalled bet ($0.05) returned to ivan2772ms
ivan2772ms collected $0.10 from pot
ivan2772ms: doesn't show hand 
*** SUMMARY ***
Total pot $0.10 | Rake $0 
Seat 1: notzukau (small blind) folded before Flop
Seat 2: ivan2772ms (big blind) collected ($0.10)
Seat 4: jayzz6 folded before Flop (didn't bet)
Seat 5: KingBiscuitT folded before Flop (didn't bet)
Seat 6: Enricola (button) folded before Flop (didn't bet)



PokerStars Hand #222954527887:  Hold'em No Limit ($0.05/$0.10 USD) - 2021/01/23 9:07:42 ET
Table 'Saito II' 6-max Seat #1 is the button
Seat 1: ivan2772ms ($9.80 in chips) 
Seat 2: Tyoma_Kovach ($11.20 in chips) 
Seat 3: SERG244 ($20.83 in chips) 
Seat 4: Onestop4u ($2.47 in chips) 
Seat 5: Willishoveandbb ($12.80 in chips) 
Seat 6: Jesus Ololo ($12.51 in chips) 
Tyoma_Kovach: posts small blind $0.05
SERG244: posts big blind $0.10
*** HOLE CARDS ***
Onestop4u: folds 
Willishoveandbb: raises $0.15 to $0.25
Jesus Ololo: folds 
ivan2772ms: folds 
Tyoma_Kovach: folds 
SERG244: folds 
Uncalled bet ($0.15) returned to Willishoveandbb
Willishoveandbb collected $0.25 from pot
*** SUMMARY ***
Total pot $0.25 | Rake $0 
Seat 1: ivan2772ms (button) folded before Flop (didn't bet)
Seat 2: Tyoma_Kovach (small blind) folded before Flop
Seat 3: SERG244 (big blind) folded before Flop
Seat 4: Onestop4u folded before Flop (didn't bet)
Seat 5: Willishoveandbb collected ($0.25)
Seat 6: Jesus Ololo folded before Flop (didn't bet)



PokerStars Hand #222952750668:  Hold'em No Limit ($0.05/$0.10 USD) - 2021/01/23 7:59:09 ET
Table 'Saito II' 6-max Seat #1 is the button
Seat 1: notzukau ($11.45 in chips) 
Seat 2: ivan2772ms ($10.63 in chips) 
Seat 3: father here ($10 in chips) 
Seat 4: jayzz6 ($10 in chips) 
Seat 5: KingBiscuitT ($17.70 in chips) 
Seat 6: Enricola ($19.49 in chips) 
ivan2772ms: posts small blind $0.05
father here: posts big blind $0.10
*** HOLE CARDS ***
jayzz6: raises $0.20 to $0.30
KingBiscuitT: folds 
Enricola: folds 
notzukau: folds 
ivan2772ms: folds 
father here: folds 
Uncalled bet ($0.20) returned to jayzz6
jayzz6 collected $0.25 from pot
jayzz6: doesn't show hand 
*** SUMMARY ***
Total pot $0.25 | Rake $0 
Seat 1: notzukau (button) folded before Flop (didn't bet)
Seat 2: ivan2772ms (small blind) folded before Flop
Seat 3: father here (big blind) folded before Flop
Seat 4: jayzz6 collected ($0.25)
Seat 5: KingBiscuitT folded before Flop (didn't bet)
Seat 6: Enricola folded before Flop (didn't bet)



PokerStars Hand #222954537029:  Hold'em No Limit ($0.05/$0.10 USD) - 2021/01/23 9:08:01 ET
Table 'Saito II' 6-max Seat #2 is the button
Seat 1: ivan2772ms ($9.80 in chips) 
Seat 2: Tyoma_Kovach ($11.15 in chips) 
Seat 3: SERG244 ($20.73 in chips) 
Seat 4: Onestop4u ($2.47 in chips) 
Seat 5: Willishoveandbb ($12.95 in chips) 
Seat 6: Jesus Ololo ($12.51 in chips) 
SERG244: posts small blind $0.05
Onestop4u: posts big blind $0.10
*** HOLE CARDS ***
Willishoveandbb: folds 
Jesus Ololo: raises $0.15 to $0.25
ivan2772ms: folds 
Tyoma_Kovach: folds 
SERG244: folds 
Onestop4u: calls $0.15
*** FLOP *** [6c 4s Jh]
Onestop4u: bets $0.30
Jesus Ololo: folds 
Uncalled bet ($0.30) returned to Onestop4u
Onestop4u collected $0.53 from pot
Onestop4u: doesn't show hand 
*** SUMMARY ***
Total pot $0.55 | Rake $0.02 
Board [6c 4s Jh]
Seat 1: ivan2772ms folded before Flop (didn't bet)
Seat 2: Tyoma_Kovach (button) folded before Flop (didn't bet)
Seat 3: SERG244 (small blind) folded before Flop
Seat 4: Onestop4u (big blind) collected ($0.53)
Seat 5: Willishoveandbb folded before Flop (didn't bet)
Seat 6: Jesus Ololo folded on the Flop



PokerStars Hand #222952756210:  Hold'em No Limit ($0.05/$0.10 USD) - 2021/01/23 7:59:26 ET
Table 'Saito II' 6-max Seat #2 is the button
Seat 1: notzukau ($11.45 in chips) 
Seat 2: ivan2772ms ($10.58 in chips) 
Seat 3: father here ($10 in chips) 
Seat 4: jayzz6 ($10.15 in chips) 
Seat 5: KingBiscuitT ($17.70 in chips) 
Seat 6: Enricola ($19.49 in chips) 
father here: posts small blind $0.05
jayzz6: posts big blind $0.10
*** HOLE CARDS ***
KingBiscuitT: folds 
Enricola: folds 
notzukau: folds 
ivan2772ms: folds 
father here: raises $0.10 to $0.20
jayzz6: folds 
Uncalled bet ($0.10) returned to father here
father here collected $0.20 from pot
*** SUMMARY ***
Total pot $0.20 | Rake $0 
Seat 1: notzukau folded before Flop (didn't bet)
Seat 2: ivan2772ms (button) folded before Flop (didn't bet)
Seat 3: father here (small blind) collected ($0.20)
Seat 4: jayzz6 (big blind) folded before Flop
Seat 5: KingBiscuitT folded before Flop (didn't bet)
Seat 6: Enricola folded before Flop (didn't bet)



PokerStars Hand #222954547905:  Hold'em No Limit ($0.05/$0.10 USD) - 2021/01/23 9:08:23 ET
Table 'Saito II' 6-max Seat #3 is the button
Seat 1: ivan2772ms ($9.80 in chips) 
Seat 2: Tyoma_Kovach ($11.15 in chips) 
Seat 3: SERG244 ($20.68 in chips) 
Seat 4: Onestop4u ($2.75 in chips) 
Seat 5: Willishoveandbb ($12.95 in chips) 
Seat 6: Jesus Ololo ($12.26 in chips) 
Onestop4u: posts small blind $0.05
Willishoveandbb: posts big blind $0.10
*** HOLE CARDS ***
Jesus Ololo: raises $0.15 to $0.25
ivan2772ms: folds 
Tyoma_Kovach: folds 
SERG244: folds 
Onestop4u: raises $0.60 to $0.85
Willishoveandbb: folds 
Jesus Ololo: folds 
Uncalled bet ($0.60) returned to Onestop4u
Onestop4u collected $0.60 from pot
Onestop4u: doesn't show hand 
*** SUMMARY ***
Total pot $0.60 | Rake $0 
Seat 1: ivan2772ms folded before Flop (didn't bet)
Seat 2: Tyoma_Kovach folded before Flop (didn't bet)
Seat 3: SERG244 (button) folded before Flop (didn't bet)
Seat 4: Onestop4u (small blind) collected ($0.60)
Seat 5: Willishoveandbb (big blind) folded before Flop
Seat 6: Jesus Ololo folded before Flop



PokerStars Hand #222952761080:  Hold'em No Limit ($0.05/$0.10 USD) - 2021/01/23 7:59:41 ET
Table 'Saito II' 6-max Seat #3 is the button
Seat 1: notzukau ($11.45 in chips) 
Seat 2: ivan2772ms ($10.58 in chips) 
Seat 3: father here ($10.10 in chips) 
Seat 4: jayzz6 ($10.05 in chips) 
Seat 5: KingBiscuitT ($17.70 in chips) 
Seat 6: Enricola ($19.49 in chips) 
jayzz6: posts small blind $0.05
KingBiscuitT: posts big blind $0.10
*** HOLE CARDS ***
Enricola: raises $0.25 to $0.35
notzukau: folds 
ivan2772ms: raises $0.65 to $1
father here: folds 
jayzz6: folds 
KingBiscuitT: folds 
Enricola: calls $0.65
*** FLOP *** [Qs 9h 7d]
Enricola: checks 
ivan2772ms: checks 
*** TURN *** [Qs 9h 7d] [8c]
Enricola: bets $0.10
ivan2772ms: calls $0.10
*** RIVER *** [Qs 9h 7d 8c] [9c]
Enricola: bets $1.12
ivan2772ms: folds 
Uncalled bet ($1.12) returned to Enricola
Enricola collected $2.24 from pot
Enricola: doesn't show hand 
*** SUMMARY ***
Total pot $2.35 | Rake $0.11 
Board [Qs 9h 7d 8c 9c]
Seat 1: notzukau folded before Flop (didn't bet)
Seat 2: ivan2772ms folded on the River
Seat 3: father here (button) folded before Flop (didn't bet)
Seat 4: jayzz6 (small blind) folded before Flop
Seat 5: KingBiscuitT (big blind) folded before Flop
Seat 6: Enricola collected ($2.24)



PokerStars Hand #222954555066:  Hold'em No Limit ($0.05/$0.10 USD) - 2021/01/23 9:08:37 ET
Table 'Saito II' 6-max Seat #4 is the button
Seat 1: ivan2772ms ($9.80 in chips) 
Seat 2: Tyoma_Kovach ($11.15 in chips) 
Seat 3: SERG244 ($20.68 in chips) 
Seat 4: Onestop4u ($3.10 in chips) 
Seat 5: Willishoveandbb ($12.85 in chips) 
Seat 6: Jesus Ololo ($12.01 in chips) 
Willishoveandbb: posts small blind $0.05
Jesus Ololo: posts big blind $0.10
*** HOLE CARDS ***
ivan2772ms: folds 
Tyoma_Kovach: folds 
SERG244: folds 
Onestop4u: folds 
Willishoveandbb: calls $0.05
Jesus Ololo: checks 
*** FLOP *** [7h 2d Kd]
Willishoveandbb: bets $0.10
Jesus Ololo: calls $0.10
*** TURN *** [7h 2d Kd] [Ad]
Willishoveandbb: bets $0.10
Jesus Ololo: calls $0.10
*** RIVER *** [7h 2d Kd Ad] [7s]
Willishoveandbb: bets $0.68
Jesus Ololo: folds 
Uncalled bet ($0.68) returned to Willishoveandbb
Willishoveandbb collected $0.57 from pot
*** SUMMARY ***
Total pot $0.60 | Rake $0.03 
Board [7h 2d Kd Ad 7s]
Seat 1: ivan2772ms folded before Flop (didn't bet)
Seat 2: Tyoma_Kovach folded before Flop (didn't bet)
Seat 3: SERG244 folded before Flop (didn't bet)
Seat 4: Onestop4u (button) folded before Flop (didn't bet)
Seat 5: Willishoveandbb (small blind) collected ($0.57)
Seat 6: Jesus Ololo (big blind) folded on the River



PokerStars Hand #222952776699:  Hold'em No Limit ($0.05/$0.10 USD) - 2021/01/23 8:00:27 ET
Table 'Saito II' 6-max Seat #4 is the button
Seat 1: notzukau ($11.45 in chips) 
Seat 2: ivan2772ms ($10 in chips) 
Seat 3: father here ($10.10 in chips) 
Seat 4: jayzz6 ($10 in chips) 
Seat 5: KingBiscuitT ($17.60 in chips) 
Seat 6: Enricola ($20.63 in chips) 
KingBiscuitT: posts small blind $0.05
Enricola: posts big blind $0.10
*** HOLE CARDS ***
notzukau: folds 
ivan2772ms: folds 
father here: folds 
jayzz6: raises $0.15 to $0.25
KingBiscuitT: folds 
Enricola: folds 
Uncalled bet ($0.15) returned to jayzz6
jayzz6 collected $0.25 from pot
jayzz6: doesn't show hand 
*** SUMMARY ***
Total pot $0.25 | Rake $0 
Seat 1: notzukau folded before Flop (didn't bet)
Seat 2: ivan2772ms folded before Flop (didn't bet)
Seat 3: father here folded before Flop (didn't bet)
Seat 4: jayzz6 (button) collected ($0.25)
Seat 5: KingBiscuitT (small blind) folded before Flop
Seat 6: Enricola (big blind) folded before Flop



PokerStars Hand #222954570713:  Hold'em No Limit ($0.05/$0.10 USD) - 2021/01/23 9:09:09 ET
Table 'Saito II' 6-max Seat #5 is the button
Seat 1: ivan2772ms ($9.80 in chips) 
Seat 2: Tyoma_Kovach ($11.15 in chips) 
Seat 3: SERG244 ($20.68 in chips) 
Seat 4: Onestop4u ($3.10 in chips) 
Seat 5: Willishoveandbb ($13.12 in chips) 
Seat 6: Jesus Ololo ($11.71 in chips) 
Jesus Ololo: posts small blind $0.05
ivan2772ms: posts big blind $0.10
*** HOLE CARDS ***
Tyoma_Kovach: folds 
SERG244: raises $0.16 to $0.26
Onestop4u: folds 
Willishoveandbb: folds 
Jesus Ololo: folds 
ivan2772ms: raises $0.94 to $1.20
SERG244: folds 
Uncalled bet ($0.94) returned to ivan2772ms
ivan2772ms collected $0.57 from pot
ivan2772ms: doesn't show hand 
*** SUMMARY ***
Total pot $0.57 | Rake $0 
Seat 1: ivan2772ms (big blind) collected ($0.57)
Seat 2: Tyoma_Kovach folded before Flop (didn't bet)
Seat 3: SERG244 folded before Flop
Seat 4: Onestop4u folded before Flop (didn't bet)
Seat 5: Willishoveandbb (button) folded before Flop (didn't bet)
Seat 6: Jesus Ololo (small blind) folded before Flop



PokerStars Hand #222952780765:  Hold'em No Limit ($0.05/$0.10 USD) - 2021/01/23 8:00:40 ET
Table 'Saito II' 6-max Seat #5 is the button
Seat 1: notzukau ($11.45 in chips) 
Seat 2: ivan2772ms ($10 in chips) 
Seat 3: father here ($10.10 in chips) 
Seat 4: jayzz6 ($10.15 in chips) 
Seat 5: KingBiscuitT ($17.55 in chips) 
Seat 6: Enricola ($20.53 in chips) 
Enricola: posts small blind $0.05
notzukau: posts big blind $0.10
*** HOLE CARDS ***
ivan2772ms: folds 
father here: folds 
jayzz6: folds 
KingBiscuitT: raises $0.15 to $0.25
Enricola: raises $0.60 to $0.85
notzukau: folds 
KingBiscuitT: folds 
Uncalled bet ($0.60) returned to Enricola
Enricola collected $0.60 from pot
Enricola: doesn't show hand 
*** SUMMARY ***
Total pot $0.60 | Rake $0 
Seat 1: notzukau (big blind) folded before Flop
Seat 2: ivan2772ms folded before Flop (didn't bet)
Seat 3: father here folded before Flop (didn't bet)
Seat 4: jayzz6 folded before Flop (didn't bet)
Seat 5: KingBiscuitT (button) folded before Flop
Seat 6: Enricola (small blind) collected ($0.60)



PokerStars Hand #222954583508:  Hold'em No Limit ($0.05/$0.10 USD) - 2021/01/23 9:09:35 ET
Table 'Saito II' 6-max Seat #6 is the button
Seat 1: ivan2772ms ($10.11 in chips) 
Seat 2: Tyoma_Kovach ($11.15 in chips) 
Seat 3: SERG244 ($20.42 in chips) 
Seat 4: Onestop4u ($3.10 in chips) 
Seat 5: Willishoveandbb ($13.12 in chips) 
Seat 6: Jesus Ololo ($11.66 in chips) 
ivan2772ms: posts small blind $0.05
Tyoma_Kovach: posts big blind $0.10
*** HOLE CARDS ***
SERG244: folds 
Onestop4u: calls $0.10
Willishoveandbb: folds 
Jesus Ololo: raises $0.30 to $0.40
ivan2772ms: folds 
Tyoma_Kovach: folds 
Onestop4u: calls $0.30
*** FLOP *** [5s 4h 4d]
Onestop4u: checks 
Jesus Ololo: checks 
*** TURN *** [5s 4h 4d] [6d]
Onestop4u: checks 
Jesus Ololo: checks 
*** RIVER *** [5s 4h 4d 6d] [4c]
Onestop4u: checks 
Jesus Ololo: checks 
*** SHOW DOWN ***
Onestop4u: shows [Qd Ts] (three of a kind, Fours)
Jesus Ololo: shows [Th Kd] (three of a kind, Fours - King kicker)
Jesus Ololo collected $0.91 from pot
*** SUMMARY ***
Total pot $0.95 | Rake $0.04 
Board [5s 4h 4d 6d 4c]
Seat 1: ivan2772ms (small blind) folded before Flop
Seat 2: Tyoma_Kovach (big blind) folded before Flop
Seat 3: SERG244 folded before Flop (didn't bet)
Seat 4: Onestop4u showed [Qd Ts] and lost with three of a kind, Fours
Seat 5: Willishoveandbb folded before Flop (didn't bet)
Seat 6: Jesus Ololo (button) showed [Th Kd] and won ($0.91) with three of a kind, Fours



PokerStars Hand #222952787814:  Hold'em No Limit ($0.05/$0.10 USD) - 2021/01/23 8:00:59 ET
Table 'Saito II' 6-max Seat #6 is the button
Seat 1: notzukau ($11.35 in chips) 
Seat 2: ivan2772ms ($10 in chips) 
Seat 3: father here ($10.10 in chips) 
Seat 4: jayzz6 ($10.15 in chips) 
Seat 5: KingBiscuitT ($17.30 in chips) 
Seat 6: Enricola ($20.88 in chips) 
notzukau: posts small blind $0.05
ivan2772ms: posts big blind $0.10
*** HOLE CARDS ***
father here: folds 
jayzz6: folds 
KingBiscuitT: raises $0.15 to $0.25
Enricola: folds 
notzukau: folds 
ivan2772ms: calls $0.15
*** FLOP *** [2h 5d Qd]
ivan2772ms: checks 
KingBiscuitT: bets $0.30
ivan2772ms: folds 
Uncalled bet ($0.30) returned to KingBiscuitT
KingBiscuitT collected $0.53 from pot
KingBiscuitT: doesn't show hand 
*** SUMMARY ***
Total pot $0.55 | Rake $0.02 
Board [2h 5d Qd]
Seat 1: notzukau (small blind) folded before Flop
Seat 2: ivan2772ms (big blind) folded on the Flop
Seat 3: father here folded before Flop (didn't bet)
Seat 4: jayzz6 folded before Flop (didn't bet)
Seat 5: KingBiscuitT collected ($0.53)
Seat 6: Enricola (button) folded before Flop (didn't bet)



PokerStars Hand #222954596768:  Hold'em No Limit ($0.05/$0.10 USD) - 2021/01/23 9:10:02 ET
Table 'Saito II' 6-max Seat #1 is the button
Seat 1: ivan2772ms ($10.06 in chips) 
Seat 2: Tyoma_Kovach ($11.05 in chips) 
Seat 4: Onestop4u ($2.70 in chips) 
Seat 5: Willishoveandbb ($13.12 in chips) 
Seat 6: Jesus Ololo ($12.17 in chips) 
Tyoma_Kovach: posts small blind $0.05
SERG244: is sitting out 
Onestop4u: posts big blind $0.10
*** HOLE CARDS ***
Willishoveandbb: folds 
Jesus Ololo: folds 
ivan2772ms: folds 
Tyoma_Kovach: folds 
Uncalled bet ($0.05) returned to Onestop4u
Onestop4u collected $0.10 from pot
Onestop4u: doesn't show hand 
*** SUMMARY ***
Total pot $0.10 | Rake $0 
Seat 1: ivan2772ms (button) folded before Flop (didn't bet)
Seat 2: Tyoma_Kovach (small blind) folded before Flop
Seat 4: Onestop4u (big blind) collected ($0.10)
Seat 5: Willishoveandbb folded before Flop (didn't bet)
Seat 6: Jesus Ololo folded before Flop (didn't bet)



PokerStars Hand #222952801305:  Hold'em No Limit ($0.05/$0.10 USD) - 2021/01/23 8:01:35 ET
Table 'Saito II' 6-max Seat #1 is the button
Seat 1: notzukau ($11.30 in chips) 
Seat 2: ivan2772ms ($10 in chips) 
Seat 3: father here ($10.10 in chips) 
Seat 4: jayzz6 ($10.15 in chips) 
Seat 5: KingBiscuitT ($17.58 in chips) 
Seat 6: Enricola ($20.88 in chips) 
ivan2772ms: posts small blind $0.05
father here: posts big blind $0.10
*** HOLE CARDS ***
jayzz6: folds 
KingBiscuitT: folds 
Enricola: raises $0.20 to $0.30
notzukau: folds 
ivan2772ms: folds 
father here: folds 
Uncalled bet ($0.20) returned to Enricola
Enricola collected $0.25 from pot
Enricola: doesn't show hand 
*** SUMMARY ***
Total pot $0.25 | Rake $0 
Seat 1: notzukau (button) folded before Flop (didn't bet)
Seat 2: ivan2772ms (small blind) folded before Flop
Seat 3: father here (big blind) folded before Flop
Seat 4: jayzz6 folded before Flop (didn't bet)
Seat 5: KingBiscuitT folded before Flop (didn't bet)
Seat 6: Enricola collected ($0.25)



PokerStars Hand #222954602050:  Hold'em No Limit ($0.05/$0.10 USD) - 2021/01/23 9:10:13 ET
Table 'Saito II' 6-max Seat #2 is the button
Seat 1: ivan2772ms ($10.06 in chips) 
Seat 2: Tyoma_Kovach ($11 in chips) 
Seat 4: Onestop4u ($2.75 in chips) 
Seat 5: Willishoveandbb ($13.12 in chips) 
Seat 6: Jesus Ololo ($12.17 in chips) 
Onestop4u: posts small blind $0.05
Willishoveandbb: posts big blind $0.10
*** HOLE CARDS ***
Jesus Ololo: folds 
ivan2772ms: raises $0.20 to $0.30
Tyoma_Kovach: folds 
Onestop4u: folds 
Willishoveandbb: calls $0.20
*** FLOP *** [Qd 2d 2c]
Willishoveandbb: checks 
ivan2772ms: bets $0.20
Willishoveandbb: calls $0.20
*** TURN *** [Qd 2d 2c] [6h]
Willishoveandbb: checks 
ivan2772ms: bets $0.75
Willishoveandbb: folds 
Uncalled bet ($0.75) returned to ivan2772ms
ivan2772ms collected $1 from pot
ivan2772ms: doesn't show hand 
*** SUMMARY ***
Total pot $1.05 | Rake $0.05 
Board [Qd 2d 2c 6h]
Seat 1: ivan2772ms collected ($1)
Seat 2: Tyoma_Kovach (button) folded before Flop (didn't bet)
Seat 4: Onestop4u (small blind) folded before Flop
Seat 5: Willishoveandbb (big blind) folded on the Turn
Seat 6: Jesus Ololo folded before Flop (didn't bet)



PokerStars Hand #222952806359:  Hold'em No Limit ($0.05/$0.10 USD) - 2021/01/23 8:01:48 ET
Table 'Saito II' 6-max Seat #2 is the button
Seat 1: notzukau ($11.30 in chips) 
Seat 2: ivan2772ms ($9.95 in chips) 
Seat 3: father here ($10 in chips) 
Seat 4: jayzz6 ($10.15 in chips) 
Seat 5: KingBiscuitT ($17.58 in chips) 
Seat 6: Enricola ($21.03 in chips) 
father here: posts small blind $0.05
jayzz6: posts big blind $0.10
*** HOLE CARDS ***
KingBiscuitT: folds 
Enricola: raises $0.25 to $0.35
notzukau: folds 
ivan2772ms: folds 
father here: folds 
jayzz6: folds 
Uncalled bet ($0.25) returned to Enricola
Enricola collected $0.25 from pot
Enricola: doesn't show hand 
*** SUMMARY ***
Total pot $0.25 | Rake $0 
Seat 1: notzukau folded before Flop (didn't bet)
Seat 2: ivan2772ms (button) folded before Flop (didn't bet)
Seat 3: father here (small blind) folded before Flop
Seat 4: jayzz6 (big blind) folded before Flop
Seat 5: KingBiscuitT folded before Flop (didn't bet)
Seat 6: Enricola collected ($0.25)



PokerStars Hand #222954614469:  Hold'em No Limit ($0.05/$0.10 USD) - 2021/01/23 9:10:38 ET
Table 'Saito II' 6-max Seat #4 is the button
Seat 1: ivan2772ms ($10.56 in chips) 
Seat 2: Tyoma_Kovach ($11 in chips) 
Seat 4: Onestop4u ($2.70 in chips) 
Seat 5: Willishoveandbb ($12.62 in chips) 
Seat 6: Jesus Ololo ($12.17 in chips) 
Willishoveandbb: posts small blind $0.05
Jesus Ololo: posts big blind $0.10
*** HOLE CARDS ***
ivan2772ms: folds 
Tyoma_Kovach: raises $0.18 to $0.28
Onestop4u: folds 
Willishoveandbb: calls $0.23
Jesus Ololo: folds 
*** FLOP *** [9s As 7s]
Willishoveandbb: checks 
Tyoma_Kovach: bets $0.21
Willishoveandbb: folds 
Uncalled bet ($0.21) returned to Tyoma_Kovach
Tyoma_Kovach collected $0.63 from pot
Tyoma_Kovach: doesn't show hand 
*** SUMMARY ***
Total pot $0.66 | Rake $0.03 
Board [9s As 7s]
Seat 1: ivan2772ms folded before Flop (didn't bet)
Seat 2: Tyoma_Kovach collected ($0.63)
Seat 4: Onestop4u (button) folded before Flop (didn't bet)
Seat 5: Willishoveandbb (small blind) folded on the Flop
Seat 6: Jesus Ololo (big blind) folded before Flop



PokerStars Hand #222952813309:  Hold'em No Limit ($0.05/$0.10 USD) - 2021/01/23 8:02:06 ET
Table 'Saito II' 6-max Seat #3 is the button
Seat 1: notzukau ($11.30 in chips) 
Seat 2: ivan2772ms ($9.95 in chips) 
Seat 3: father here ($10 in chips) 
Seat 4: jayzz6 ($10.05 in chips) 
Seat 5: KingBiscuitT ($17.58 in chips) 
Seat 6: Enricola ($21.18 in chips) 
jayzz6: posts small blind $0.05
KingBiscuitT: posts big blind $0.10
*** HOLE CARDS ***
Enricola: folds 
notzukau: folds 
ivan2772ms: folds 
father here: folds 
jayzz6: folds 
Uncalled bet ($0.05) returned to KingBiscuitT
KingBiscuitT collected $0.10 from pot
KingBiscuitT: doesn't show hand 
*** SUMMARY ***
Total pot $0.10 | Rake $0 
Seat 1: notzukau folded before Flop (didn't bet)
Seat 2: ivan2772ms folded before Flop (didn't bet)
Seat 3: father here (button) folded before Flop (didn't bet)
Seat 4: jayzz6 (small blind) folded before Flop
Seat 5: KingBiscuitT (big blind) collected ($0.10)
Seat 6: Enricola folded before Flop (didn't bet)



PokerStars Hand #222954622239:  Hold'em No Limit ($0.05/$0.10 USD) - 2021/01/23 9:10:53 ET
Table 'Saito II' 6-max Seat #5 is the button
Seat 1: ivan2772ms ($10.56 in chips) 
Seat 2: Tyoma_Kovach ($11.35 in chips) 
Seat 4: Onestop4u ($2.70 in chips) 
Seat 5: Willishoveandbb ($12.34 in chips) 
Seat 6: Jesus Ololo ($12.07 in chips) 
Jesus Ololo: posts small blind $0.05
ivan2772ms: posts big blind $0.10
*** HOLE CARDS ***
Tyoma_Kovach: folds 
Onestop4u: raises $0.25 to $0.35
Willishoveandbb: folds 
Jesus Ololo: folds 
ivan2772ms: folds 
Uncalled bet ($0.25) returned to Onestop4u
Onestop4u collected $0.25 from pot
Onestop4u: doesn't show hand 
*** SUMMARY ***
Total pot $0.25 | Rake $0 
Seat 1: ivan2772ms (big blind) folded before Flop
Seat 2: Tyoma_Kovach folded before Flop (didn't bet)
Seat 4: Onestop4u collected ($0.25)
Seat 5: Willishoveandbb (button) folded before Flop (didn't bet)
Seat 6: Jesus Ololo (small blind) folded before Flop



PokerStars Hand #222952824290:  Hold'em No Limit ($0.05/$0.10 USD) - 2021/01/23 8:02:22 ET
Table 'Saito II' 6-max Seat #4 is the button
Seat 1: notzukau ($11.30 in chips) 
Seat 2: ivan2772ms ($9.95 in chips) 
Seat 3: father here ($10 in chips) 
Seat 4: jayzz6 ($10 in chips) 
Seat 5: KingBiscuitT ($17.63 in chips) 
Seat 6: Enricola ($21.18 in chips) 
KingBiscuitT: posts small blind $0.05
Enricola: posts big blind $0.10
*** HOLE CARDS ***
notzukau: raises $0.15 to $0.25
ivan2772ms: folds 
father here: calls $0.25
jayzz6: raises $0.75 to $1
KingBiscuitT: folds 
Enricola: folds 
notzukau: raises $1.90 to $2.90
father here: folds 
jayzz6: calls $1.90
*** FLOP *** [3c 2d 3h]
notzukau: bets $2.01
jayzz6: folds 
Uncalled bet ($2.01) returned to notzukau
notzukau collected $5.92 from pot
notzukau: doesn't show hand 
*** SUMMARY ***
Total pot $6.20 | Rake $0.28 
Board [3c 2d 3h]
Seat 1: notzukau collected ($5.92)
Seat 2: ivan2772ms folded before Flop (didn't bet)
Seat 3: father here folded before Flop
Seat 4: jayzz6 (button) folded on the Flop
Seat 5: KingBiscuitT (small blind) folded before Flop
Seat 6: Enricola (big blind) folded before Flop



PokerStars Hand #222954627362:  Hold'em No Limit ($0.05/$0.10 USD) - 2021/01/23 9:11:04 ET
Table 'Saito II' 6-max Seat #6 is the button
Seat 1: ivan2772ms ($10.46 in chips) 
Seat 2: Tyoma_Kovach ($11.35 in chips) 
Seat 4: Onestop4u ($2.85 in chips) 
Seat 5: Willishoveandbb ($12.34 in chips) 
Seat 6: Jesus Ololo ($12.02 in chips) 
ivan2772ms: posts small blind $0.05
Tyoma_Kovach: posts big blind $0.10
*** HOLE CARDS ***
Onestop4u: folds 
Willishoveandbb: folds 
Jesus Ololo: folds 
ivan2772ms: folds 
Uncalled bet ($0.05) returned to Tyoma_Kovach
Tyoma_Kovach collected $0.10 from pot
Tyoma_Kovach: doesn't show hand 
*** SUMMARY ***
Total pot $0.10 | Rake $0 
Seat 1: ivan2772ms (small blind) folded before Flop
Seat 2: Tyoma_Kovach (big blind) collected ($0.10)
Seat 4: Onestop4u folded before Flop (didn't bet)
Seat 5: Willishoveandbb folded before Flop (didn't bet)
Seat 6: Jesus Ololo (button) folded before Flop (didn't bet)



PokerStars Hand #222952843451:  Hold'em No Limit ($0.05/$0.10 USD) - 2021/01/23 8:03:11 ET
Table 'Saito II' 6-max Seat #5 is the button
Seat 1: notzukau ($14.32 in chips) 
Seat 2: ivan2772ms ($9.95 in chips) 
Seat 3: father here ($10 in chips) 
Seat 4: jayzz6 ($10 in chips) 
Seat 5: KingBiscuitT ($17.58 in chips) 
Seat 6: Enricola ($21.08 in chips) 
Enricola: posts small blind $0.05
notzukau: posts big blind $0.10
*** HOLE CARDS ***
ivan2772ms: folds 
father here: folds 
jayzz6: folds 
KingBiscuitT: raises $0.15 to $0.25
Enricola: raises $0.60 to $0.85
notzukau: folds 
KingBiscuitT: folds 
Uncalled bet ($0.60) returned to Enricola
Enricola collected $0.60 from pot
Enricola: doesn't show hand 
*** SUMMARY ***
Total pot $0.60 | Rake $0 
Seat 1: notzukau (big blind) folded before Flop
Seat 2: ivan2772ms folded before Flop (didn't bet)
Seat 3: father here folded before Flop (didn't bet)
Seat 4: jayzz6 folded before Flop (didn't bet)
Seat 5: KingBiscuitT (button) folded before Flop
Seat 6: Enricola (small blind) collected ($0.60)



PokerStars Hand #222954631097:  Hold'em No Limit ($0.05/$0.10 USD) - 2021/01/23 9:11:11 ET
Table 'Saito II' 6-max Seat #1 is the button
Seat 1: ivan2772ms ($10.41 in chips) 
Seat 2: Tyoma_Kovach ($11.40 in chips) 
Seat 4: Onestop4u ($2.85 in chips) 
Seat 5: Willishoveandbb ($12.34 in chips) 
Seat 6: Jesus Ololo ($12.02 in chips) 
Tyoma_Kovach: posts small blind $0.05
Onestop4u: posts big blind $0.10
*** HOLE CARDS ***
Willishoveandbb: folds 
Jesus Ololo: folds 
ivan2772ms: folds 
Tyoma_Kovach: raises $0.20 to $0.30
Onestop4u: folds 
Uncalled bet ($0.20) returned to Tyoma_Kovach
Tyoma_Kovach collected $0.20 from pot
Tyoma_Kovach: doesn't show hand 
*** SUMMARY ***
Total pot $0.20 | Rake $0 
Seat 1: ivan2772ms (button) folded before Flop (didn't bet)
Seat 2: Tyoma_Kovach (small blind) collected ($0.20)
Seat 4: Onestop4u (big blind) folded before Flop
Seat 5: Willishoveandbb folded before Flop (didn't bet)
Seat 6: Jesus Ololo folded before Flop (didn't bet)



PokerStars Hand #222952853208:  Hold'em No Limit ($0.05/$0.10 USD) - 2021/01/23 8:03:35 ET
Table 'Saito II' 6-max Seat #6 is the button
Seat 1: notzukau ($14.22 in chips) 
Seat 2: ivan2772ms ($9.95 in chips) 
Seat 3: father here ($10 in chips) 
Seat 4: jayzz6 ($10 in chips) 
Seat 5: KingBiscuitT ($17.33 in chips) 
Seat 6: Enricola ($21.43 in chips) 
notzukau: posts small blind $0.05
ivan2772ms: posts big blind $0.10
*** HOLE CARDS ***
father here: folds 
jayzz6: folds 
KingBiscuitT: raises $0.15 to $0.25
Enricola: folds 
notzukau: folds 
father here leaves the table
ivan2772ms: folds 
Uncalled bet ($0.15) returned to KingBiscuitT
KingBiscuitT collected $0.25 from pot
KingBiscuitT: doesn't show hand 
*** SUMMARY ***
Total pot $0.25 | Rake $0 
Seat 1: notzukau (small blind) folded before Flop
Seat 2: ivan2772ms (big blind) folded before Flop
Seat 3: father here folded before Flop (didn't bet)
Seat 4: jayzz6 folded before Flop (didn't bet)
Seat 5: KingBiscuitT collected ($0.25)
Seat 6: Enricola (button) folded before Flop (didn't bet)



PokerStars Hand #222954635992:  Hold'em No Limit ($0.05/$0.10 USD) - 2021/01/23 9:11:21 ET
Table 'Saito II' 6-max Seat #2 is the button
Seat 1: ivan2772ms ($10.41 in chips) 
Seat 2: Tyoma_Kovach ($11.50 in chips) 
Seat 4: Onestop4u ($2.75 in chips) 
Seat 5: Willishoveandbb ($12.34 in chips) 
Seat 6: Jesus Ololo ($12.02 in chips) 
Onestop4u: posts small blind $0.05
Willishoveandbb: posts big blind $0.10
*** HOLE CARDS ***
Jesus Ololo: raises $0.15 to $0.25
ivan2772ms: folds 
Tyoma_Kovach: calls $0.25
Onestop4u: calls $0.20
Willishoveandbb: raises $0.95 to $1.20
Jesus Ololo: calls $0.95
Tyoma_Kovach: folds 
Onestop4u: calls $0.95
*** FLOP *** [Tc Td 5c]
Onestop4u: checks 
Willishoveandbb: bets $1.62
Jesus Ololo: folds 
Onestop4u: folds 
Uncalled bet ($1.62) returned to Willishoveandbb
Willishoveandbb collected $3.68 from pot
*** SUMMARY ***
Total pot $3.85 | Rake $0.17 
Board [Tc Td 5c]
Seat 1: ivan2772ms folded before Flop (didn't bet)
Seat 2: Tyoma_Kovach (button) folded before Flop
Seat 4: Onestop4u (small blind) folded on the Flop
Seat 5: Willishoveandbb (big blind) collected ($3.68)
Seat 6: Jesus Ololo folded on the Flop



PokerStars Hand #222952859444:  Hold'em No Limit ($0.05/$0.10 USD) - 2021/01/23 8:03:51 ET
Table 'Saito II' 6-max Seat #1 is the button
Seat 1: notzukau ($14.17 in chips) 
Seat 2: ivan2772ms ($9.85 in chips) 
Seat 4: jayzz6 ($10 in chips) 
Seat 5: KingBiscuitT ($17.48 in chips) 
Seat 6: Enricola ($21.43 in chips) 
ivan2772ms: posts small blind $0.05
jayzz6: posts big blind $0.10
*** HOLE CARDS ***
KingBiscuitT: folds 
Enricola: folds 
notzukau: raises $0.15 to $0.25
ivan2772ms: folds 
jayzz6: calls $0.15
*** FLOP *** [8d Qh 5d]
jayzz6: checks 
Nail224 joins the table at seat #3 
notzukau: bets $0.14
jayzz6: calls $0.14
*** TURN *** [8d Qh 5d] [4s]
jayzz6: checks 
notzukau: checks 
*** RIVER *** [8d Qh 5d 4s] [8c]
jayzz6: bets $0.43
notzukau: folds 
Uncalled bet ($0.43) returned to jayzz6
jayzz6 collected $0.79 from pot
jayzz6: doesn't show hand 
*** SUMMARY ***
Total pot $0.83 | Rake $0.04 
Board [8d Qh 5d 4s 8c]
Seat 1: notzukau (button) folded on the River
Seat 2: ivan2772ms (small blind) folded before Flop
Seat 4: jayzz6 (big blind) collected ($0.79)
Seat 5: KingBiscuitT folded before Flop (didn't bet)
Seat 6: Enricola folded before Flop (didn't bet)



PokerStars Hand #222954655637:  Hold'em No Limit ($0.05/$0.10 USD) - 2021/01/23 9:12:01 ET
Table 'Saito II' 6-max Seat #4 is the button
Seat 1: ivan2772ms ($10.41 in chips) 
Seat 2: Tyoma_Kovach ($11.25 in chips) 
Seat 4: Onestop4u ($1.55 in chips) 
Seat 5: Willishoveandbb ($14.82 in chips) 
Seat 6: Jesus Ololo ($10.82 in chips) 
Willishoveandbb: posts small blind $0.05
Jesus Ololo: posts big blind $0.10
*** HOLE CARDS ***
ivan2772ms: folds 
Tyoma_Kovach: folds 
Onestop4u: calls $0.10
Willishoveandbb: folds 
Jesus Ololo: checks 
*** FLOP *** [Ac 4d As]
Jesus Ololo: checks 
Onestop4u: checks 
*** TURN *** [Ac 4d As] [5c]
Jesus Ololo: checks 
Onestop4u: bets $0.20
Jesus Ololo: folds 
Uncalled bet ($0.20) returned to Onestop4u
Onestop4u collected $0.24 from pot
Onestop4u: doesn't show hand 
*** SUMMARY ***
Total pot $0.25 | Rake $0.01 
Board [Ac 4d As 5c]
Seat 1: ivan2772ms folded before Flop (didn't bet)
Seat 2: Tyoma_Kovach folded before Flop (didn't bet)
Seat 4: Onestop4u (button) collected ($0.24)
Seat 5: Willishoveandbb (small blind) folded before Flop
Seat 6: Jesus Ololo (big blind) folded on the Turn



PokerStars Hand #222952883324:  Hold'em No Limit ($0.05/$0.10 USD) - 2021/01/23 8:04:50 ET
Table 'Saito II' 6-max Seat #2 is the button
Seat 1: notzukau ($13.78 in chips) 
Seat 2: ivan2772ms ($9.80 in chips) 
Seat 4: jayzz6 ($10.40 in chips) 
Seat 5: KingBiscuitT ($17.48 in chips) 
Seat 6: Enricola ($21.43 in chips) 
jayzz6: posts small blind $0.05
KingBiscuitT: posts big blind $0.10
*** HOLE CARDS ***
Enricola: raises $0.25 to $0.35
notzukau: folds 
ivan2772ms: folds 
jayzz6: folds 
KingBiscuitT: raises $1.85 to $2.20
Enricola: folds 
Uncalled bet ($1.85) returned to KingBiscuitT
KingBiscuitT collected $0.75 from pot
KingBiscuitT: doesn't show hand 
*** SUMMARY ***
Total pot $0.75 | Rake $0 
Seat 1: notzukau folded before Flop (didn't bet)
Seat 2: ivan2772ms (button) folded before Flop (didn't bet)
Seat 4: jayzz6 (small blind) folded before Flop
Seat 5: KingBiscuitT (big blind) collected ($0.75)
Seat 6: Enricola folded before Flop



PokerStars Hand #222954665277:  Hold'em No Limit ($0.05/$0.10 USD) - 2021/01/23 9:12:20 ET
Table 'Saito II' 6-max Seat #5 is the button
Seat 1: ivan2772ms ($10.41 in chips) 
Seat 2: Tyoma_Kovach ($11.25 in chips) 
Seat 4: Onestop4u ($1.69 in chips) 
Seat 5: Willishoveandbb ($14.77 in chips) 
Seat 6: Jesus Ololo ($10.72 in chips) 
Jesus Ololo: posts small blind $0.05
ivan2772ms: posts big blind $0.10
*** HOLE CARDS ***
Tyoma_Kovach: folds 
Onestop4u: raises $0.25 to $0.35
Willishoveandbb: calls $0.35
Jesus Ololo: folds 
ivan2772ms: folds 
*** FLOP *** [Th As 6d]
Onestop4u: bets $0.80
Willishoveandbb: folds 
Uncalled bet ($0.80) returned to Onestop4u
Onestop4u collected $0.81 from pot
Onestop4u: doesn't show hand 
*** SUMMARY ***
Total pot $0.85 | Rake $0.04 
Board [Th As 6d]
Seat 1: ivan2772ms (big blind) folded before Flop
Seat 2: Tyoma_Kovach folded before Flop (didn't bet)
Seat 4: Onestop4u collected ($0.81)
Seat 5: Willishoveandbb (button) folded on the Flop
Seat 6: Jesus Ololo (small blind) folded before Flop



PokerStars Hand #222952894466:  Hold'em No Limit ($0.05/$0.10 USD) - 2021/01/23 8:05:18 ET
Table 'Saito II' 6-max Seat #4 is the button
Seat 1: notzukau ($13.78 in chips) 
Seat 2: ivan2772ms ($9.80 in chips) 
Seat 3: Nail224 ($4 in chips) 
Seat 4: jayzz6 ($10.35 in chips) 
Seat 5: KingBiscuitT ($17.88 in chips) 
Seat 6: Enricola ($21.08 in chips) 
KingBiscuitT: posts small blind $0.05
Enricola: posts big blind $0.10
Nail224: posts big blind $0.10
*** HOLE CARDS ***
notzukau: folds 
ivan2772ms: raises $0.35 to $0.45
Nail224: folds 
jayzz6: folds 
KingBiscuitT: folds 
Enricola: folds 
Uncalled bet ($0.35) returned to ivan2772ms
ivan2772ms collected $0.35 from pot
ivan2772ms: doesn't show hand 
*** SUMMARY ***
Total pot $0.35 | Rake $0 
Seat 1: notzukau folded before Flop (didn't bet)
Seat 2: ivan2772ms collected ($0.35)
Seat 3: Nail224 folded before Flop (didn't bet)
Seat 4: jayzz6 (button) folded before Flop (didn't bet)
Seat 5: KingBiscuitT (small blind) folded before Flop
Seat 6: Enricola (big blind) folded before Flop



PokerStars Hand #222954678245:  Hold'em No Limit ($0.05/$0.10 USD) - 2021/01/23 9:12:46 ET
Table 'Saito II' 6-max Seat #6 is the button
Seat 1: ivan2772ms ($10.31 in chips) 
Seat 2: Tyoma_Kovach ($11.25 in chips) 
Seat 4: Onestop4u ($2.15 in chips) 
Seat 5: Willishoveandbb ($14.42 in chips) 
Seat 6: Jesus Ololo ($10.67 in chips) 
ivan2772ms: posts small blind $0.05
Tyoma_Kovach: posts big blind $0.10
*** HOLE CARDS ***
Onestop4u: folds 
Willishoveandbb: raises $0.15 to $0.25
Jesus Ololo: folds 
ivan2772ms: folds 
Tyoma_Kovach: calls $0.15
*** FLOP *** [7c Jd 5s]
Tyoma_Kovach: checks 
Willishoveandbb: bets $0.20
Tyoma_Kovach: calls $0.20
*** TURN *** [7c Jd 5s] [5h]
Tyoma_Kovach: checks 
Willishoveandbb: checks 
*** RIVER *** [7c Jd 5s 5h] [5c]
Tyoma_Kovach: checks 
Willishoveandbb: bets $1
Tyoma_Kovach: calls $1
*** SHOW DOWN ***
Willishoveandbb: shows [Qd Ah] (three of a kind, Fives)
Tyoma_Kovach: shows [6d 6c] (a full house, Fives full of Sixes)
Tyoma_Kovach collected $2.82 from pot
*** SUMMARY ***
Total pot $2.95 | Rake $0.13 
Board [7c Jd 5s 5h 5c]
Seat 1: ivan2772ms (small blind) folded before Flop
Seat 2: Tyoma_Kovach (big blind) showed [6d 6c] and won ($2.82) with a full house, Fives full of Sixes
Seat 4: Onestop4u folded before Flop (didn't bet)
Seat 5: Willishoveandbb showed [Qd Ah] and lost with three of a kind, Fives
Seat 6: Jesus Ololo (button) folded before Flop (didn't bet)



PokerStars Hand #222952902264:  Hold'em No Limit ($0.05/$0.10 USD) - 2021/01/23 8:05:37 ET
Table 'Saito II' 6-max Seat #5 is the button
Seat 1: notzukau ($13.78 in chips) 
Seat 2: ivan2772ms ($10.05 in chips) 
Seat 3: Nail224 ($3.90 in chips) 
Seat 4: jayzz6 ($10.35 in chips) 
Seat 5: KingBiscuitT ($17.83 in chips) 
Seat 6: Enricola ($20.98 in chips) 
Enricola: posts small blind $0.05
notzukau: posts big blind $0.10
*** HOLE CARDS ***
ivan2772ms: folds 
Nail224: calls $0.10
jayzz6 has timed out
jayzz6: folds 
KingBiscuitT: folds 
Enricola: folds 
notzukau: checks 
*** FLOP *** [Kh 8s 4s]
notzukau: checks 
Nail224: checks 
*** TURN *** [Kh 8s 4s] [7s]
notzukau: bets $0.19
Nail224: calls $0.19
*** RIVER *** [Kh 8s 4s 7s] [Jd]
notzukau: checks 
Nail224: bets $0.60
notzukau: folds 
Uncalled bet ($0.60) returned to Nail224
Nail224 collected $0.60 from pot
Nail224: doesn't show hand 
*** SUMMARY ***
Total pot $0.63 | Rake $0.03 
Board [Kh 8s 4s 7s Jd]
Seat 1: notzukau (big blind) folded on the River
Seat 2: ivan2772ms folded before Flop (didn't bet)
Seat 3: Nail224 collected ($0.60)
Seat 4: jayzz6 folded before Flop (didn't bet)
Seat 5: KingBiscuitT (button) folded before Flop (didn't bet)
Seat 6: Enricola (small blind) folded before Flop



PokerStars Hand #222954702495:  Hold'em No Limit ($0.05/$0.10 USD) - 2021/01/23 9:13:35 ET
Table 'Saito II' 6-max Seat #1 is the button
Seat 1: ivan2772ms ($10.26 in chips) 
Seat 2: Tyoma_Kovach ($12.62 in chips) 
Seat 3: SERG244 ($20.42 in chips) 
Seat 4: Onestop4u ($2.15 in chips) 
Seat 5: Willishoveandbb ($12.97 in chips) 
Seat 6: Jesus Ololo ($10.67 in chips) 
Tyoma_Kovach: posts small blind $0.05
SERG244: posts big blind $0.10
*** HOLE CARDS ***
Onestop4u: folds 
Willishoveandbb: folds 
Jesus Ololo: folds 
ivan2772ms: folds 
Tyoma_Kovach: raises $0.20 to $0.30
SERG244: calls $0.20
*** FLOP *** [5d 7s Qs]
Tyoma_Kovach: bets $0.19
SERG244: folds 
Uncalled bet ($0.19) returned to Tyoma_Kovach
Tyoma_Kovach collected $0.57 from pot
Tyoma_Kovach: doesn't show hand 
*** SUMMARY ***
Total pot $0.60 | Rake $0.03 
Board [5d 7s Qs]
Seat 1: ivan2772ms (button) folded before Flop (didn't bet)
Seat 2: Tyoma_Kovach (small blind) collected ($0.57)
Seat 3: SERG244 (big blind) folded on the Flop
Seat 4: Onestop4u folded before Flop (didn't bet)
Seat 5: Willishoveandbb folded before Flop (didn't bet)
Seat 6: Jesus Ololo folded before Flop (didn't bet)



PokerStars Hand #222952922118:  Hold'em No Limit ($0.05/$0.10 USD) - 2021/01/23 8:06:27 ET
Table 'Saito II' 6-max Seat #6 is the button
Seat 1: notzukau ($13.49 in chips) 
Seat 3: Nail224 ($4.21 in chips) 
Seat 4: jayzz6 ($10.35 in chips) 
Seat 5: KingBiscuitT ($17.83 in chips) 
Seat 6: Enricola ($20.93 in chips) 
notzukau: posts small blind $0.05
Nail224: posts big blind $0.10
*** HOLE CARDS ***
jayzz6: folds 
KingBiscuitT: folds 
Enricola: raises $0.25 to $0.35
notzukau: folds 
Nail224: calls $0.25
*** FLOP *** [2d 3c 6s]
Nail224: checks 
Enricola: bets $0.72
Nail224: folds 
Uncalled bet ($0.72) returned to Enricola
Enricola collected $0.72 from pot
Enricola: doesn't show hand 
*** SUMMARY ***
Total pot $0.75 | Rake $0.03 
Board [2d 3c 6s]
Seat 1: notzukau (small blind) folded before Flop
Seat 3: Nail224 (big blind) folded on the Flop
Seat 4: jayzz6 folded before Flop (didn't bet)
Seat 5: KingBiscuitT folded before Flop (didn't bet)
Seat 6: Enricola (button) collected ($0.72)



PokerStars Hand #222954712877:  Hold'em No Limit ($0.05/$0.10 USD) - 2021/01/23 9:13:55 ET
Table 'Saito II' 6-max Seat #2 is the button
Seat 1: ivan2772ms ($10.26 in chips) 
Seat 2: Tyoma_Kovach ($12.89 in chips) 
Seat 3: SERG244 ($20.12 in chips) 
Seat 4: Onestop4u ($2.15 in chips) 
Seat 5: Willishoveandbb ($12.97 in chips) 
Seat 6: Jesus Ololo ($10.67 in chips) 
SERG244: posts small blind $0.05
Onestop4u: posts big blind $0.10
*** HOLE CARDS ***
Willishoveandbb: folds 
Jesus Ololo: folds 
ivan2772ms: folds 
Tyoma_Kovach: raises $0.15 to $0.25
SERG244: folds 
Onestop4u: calls $0.15
*** FLOP *** [Kc 6h 9d]
Onestop4u: bets $0.10
Tyoma_Kovach: calls $0.10
*** TURN *** [Kc 6h 9d] [Js]
Onestop4u: bets $0.40
Tyoma_Kovach: calls $0.40
*** RIVER *** [Kc 6h 9d Js] [Ad]
Onestop4u: checks 
Tyoma_Kovach: bets $1.97
Onestop4u: calls $1.40 and is all-in
Uncalled bet ($0.57) returned to Tyoma_Kovach
*** SHOW DOWN ***
Tyoma_Kovach: shows [Qs Td] (a straight, Ten to Ace)
Onestop4u: shows [Kh 4c] (a pair of Kings)
Tyoma_Kovach collected $4.15 from pot
*** SUMMARY ***
Total pot $4.35 | Rake $0.20 
Board [Kc 6h 9d Js Ad]
Seat 1: ivan2772ms folded before Flop (didn't bet)
Seat 2: Tyoma_Kovach (button) showed [Qs Td] and won ($4.15) with a straight, Ten to Ace
Seat 3: SERG244 (small blind) folded before Flop
Seat 4: Onestop4u (big blind) showed [Kh 4c] and lost with a pair of Kings
Seat 5: Willishoveandbb folded before Flop (didn't bet)
Seat 6: Jesus Ololo folded before Flop (didn't bet)



PokerStars Hand #222952932785:  Hold'em No Limit ($0.05/$0.10 USD) - 2021/01/23 8:06:53 ET
Table 'Saito II' 6-max Seat #1 is the button
Seat 1: notzukau ($13.44 in chips) 
Seat 3: Nail224 ($3.86 in chips) 
Seat 4: jayzz6 ($10.35 in chips) 
Seat 5: KingBiscuitT ($17.83 in chips) 
Seat 6: Enricola ($21.30 in chips) 
Nail224: posts small blind $0.05
jayzz6: posts big blind $0.10
*** HOLE CARDS ***
KingBiscuitT: folds 
Enricola: folds 
notzukau: folds 
Nail224: calls $0.05
jayzz6: checks 
*** FLOP *** [Kh Ts 9s]
Nail224: checks 
jayzz6: checks 
*** TURN *** [Kh Ts 9s] [8c]
Nail224: checks 
jayzz6: checks 
*** RIVER *** [Kh Ts 9s 8c] [Tc]
Nail224: checks 
jayzz6: checks 
*** SHOW DOWN ***
Nail224: shows [5c 2c] (a pair of Tens)
jayzz6: shows [Ad 7s] (a pair of Tens - Ace kicker)
jayzz6 collected $0.19 from pot
*** SUMMARY ***
Total pot $0.20 | Rake $0.01 
Board [Kh Ts 9s 8c Tc]
Seat 1: notzukau (button) folded before Flop (didn't bet)
Seat 3: Nail224 (small blind) showed [5c 2c] and lost with a pair of Tens
Seat 4: jayzz6 (big blind) showed [Ad 7s] and won ($0.19) with a pair of Tens
Seat 5: KingBiscuitT folded before Flop (didn't bet)
Seat 6: Enricola folded before Flop (didn't bet)



PokerStars Hand #222954735883:  Hold'em No Limit ($0.05/$0.10 USD) - 2021/01/23 9:14:41 ET
Table 'Saito II' 6-max Seat #3 is the button
Seat 1: ivan2772ms ($10.26 in chips) 
Seat 2: Tyoma_Kovach ($14.89 in chips) 
Seat 3: SERG244 ($20.07 in chips) 
Seat 5: Willishoveandbb ($12.97 in chips) 
Seat 6: Jesus Ololo ($10.67 in chips) 
Willishoveandbb: posts small blind $0.05
Jesus Ololo: posts big blind $0.10
*** HOLE CARDS ***
ivan2772ms: folds 
Tyoma_Kovach: folds 
SERG244: folds 
Willishoveandbb: raises $0.15 to $0.25
Jesus Ololo: calls $0.15
*** FLOP *** [5d 9h 2h]
Onestop4u leaves the table
Willishoveandbb: bets $0.21
Jesus Ololo: folds 
Uncalled bet ($0.21) returned to Willishoveandbb
Willishoveandbb collected $0.48 from pot
*** SUMMARY ***
Total pot $0.50 | Rake $0.02 
Board [5d 9h 2h]
Seat 1: ivan2772ms folded before Flop (didn't bet)
Seat 2: Tyoma_Kovach folded before Flop (didn't bet)
Seat 3: SERG244 (button) folded before Flop (didn't bet)
Seat 5: Willishoveandbb (small blind) collected ($0.48)
Seat 6: Jesus Ololo (big blind) folded on the Flop



PokerStars Hand #222952943112:  Hold'em No Limit ($0.05/$0.10 USD) - 2021/01/23 8:07:19 ET
Table 'Saito II' 6-max Seat #3 is the button
Seat 1: notzukau ($13.44 in chips) 
Seat 3: Nail224 ($3.76 in chips) 
Seat 4: jayzz6 ($10.44 in chips) 
Seat 5: KingBiscuitT ($17.83 in chips) 
Seat 6: Enricola ($21.30 in chips) 
jayzz6: posts small blind $0.05
KingBiscuitT: posts big blind $0.10
*** HOLE CARDS ***
Enricola: folds 
notzukau: folds 
Nail224: folds 
jayzz6: raises $0.20 to $0.30
KingBiscuitT: raises $0.60 to $0.90
jayzz6: raises $1.60 to $2.50
KingBiscuitT: folds 
Uncalled bet ($1.60) returned to jayzz6
jayzz6 collected $1.80 from pot
jayzz6: doesn't show hand 
*** SUMMARY ***
Total pot $1.80 | Rake $0 
Seat 1: notzukau folded before Flop (didn't bet)
Seat 3: Nail224 (button) folded before Flop (didn't bet)
Seat 4: jayzz6 (small blind) collected ($1.80)
Seat 5: KingBiscuitT (big blind) folded before Flop
Seat 6: Enricola folded before Flop (didn't bet)



PokerStars Hand #222954748449:  Hold'em No Limit ($0.05/$0.10 USD) - 2021/01/23 9:15:06 ET
Table 'Saito II' 6-max Seat #5 is the button
Seat 1: ivan2772ms ($10.26 in chips) 
Seat 2: Tyoma_Kovach ($14.89 in chips) 
Seat 3: SERG244 ($20.07 in chips) 
Seat 5: Willishoveandbb ($13.20 in chips) 
Seat 6: Jesus Ololo ($10.42 in chips) 
Jesus Ololo: posts small blind $0.05
ivan2772ms: posts big blind $0.10
*** HOLE CARDS ***
Tyoma_Kovach: raises $0.20 to $0.30
SERG244: folds 
Willishoveandbb: folds 
Jesus Ololo: folds 
ivan2772ms: calls $0.20
*** FLOP *** [5c 5s 4h]
ivan2772ms: checks 
vietor201 joins the table at seat #4 
Tyoma_Kovach: bets $0.31
ivan2772ms: calls $0.31
*** TURN *** [5c 5s 4h] [Qc]
ivan2772ms: checks 
Tyoma_Kovach: bets $0.40
ivan2772ms: folds 
Uncalled bet ($0.40) returned to Tyoma_Kovach
Tyoma_Kovach collected $1.21 from pot
Tyoma_Kovach: doesn't show hand 
*** SUMMARY ***
Total pot $1.27 | Rake $0.06 
Board [5c 5s 4h Qc]
Seat 1: ivan2772ms (big blind) folded on the Turn
Seat 2: Tyoma_Kovach collected ($1.21)
Seat 3: SERG244 folded before Flop (didn't bet)
Seat 5: Willishoveandbb (button) folded before Flop (didn't bet)
Seat 6: Jesus Ololo (small blind) folded before Flop



PokerStars Hand #222952957335:  Hold'em No Limit ($0.05/$0.10 USD) - 2021/01/23 8:07:54 ET
Table 'Saito II' 6-max Seat #4 is the button
Seat 1: notzukau ($13.44 in chips) 
Seat 3: Nail224 ($3.76 in chips) 
Seat 4: jayzz6 ($11.34 in chips) 
Seat 5: KingBiscuitT ($16.93 in chips) 
Seat 6: Enricola ($21.30 in chips) 
KingBiscuitT: posts small blind $0.05
Enricola: posts big blind $0.10
*** HOLE CARDS ***
notzukau: raises $0.15 to $0.25
Nail224: folds 
jayzz6: folds 
KingBiscuitT: folds 
Enricola: folds 
Uncalled bet ($0.15) returned to notzukau
notzukau collected $0.25 from pot
notzukau: doesn't show hand 
*** SUMMARY ***
Total pot $0.25 | Rake $0 
Seat 1: notzukau collected ($0.25)
Seat 3: Nail224 folded before Flop (didn't bet)
Seat 4: jayzz6 (button) folded before Flop (didn't bet)
Seat 5: KingBiscuitT (small blind) folded before Flop
Seat 6: Enricola (big blind) folded before Flop



PokerStars Hand #222954765966:  Hold'em No Limit ($0.05/$0.10 USD) - 2021/01/23 9:15:42 ET
Table 'Saito II' 6-max Seat #6 is the button
Seat 1: ivan2772ms ($10 in chips) 
Seat 2: Tyoma_Kovach ($15.49 in chips) 
Seat 3: SERG244 ($20.07 in chips) 
Seat 5: Willishoveandbb ($13.20 in chips) 
Seat 6: Jesus Ololo ($10.37 in chips) 
ivan2772ms: posts small blind $0.05
Tyoma_Kovach: posts big blind $0.10
vietor201: sits out 
*** HOLE CARDS ***
SERG244: folds 
Willishoveandbb: folds 
Jesus Ololo: folds 
ivan2772ms: folds 
Uncalled bet ($0.05) returned to Tyoma_Kovach
Tyoma_Kovach collected $0.10 from pot
Tyoma_Kovach: doesn't show hand 
*** SUMMARY ***
Total pot $0.10 | Rake $0 
Seat 1: ivan2772ms (small blind) folded before Flop
Seat 2: Tyoma_Kovach (big blind) collected ($0.10)
Seat 3: SERG244 folded before Flop (didn't bet)
Seat 5: Willishoveandbb folded before Flop (didn't bet)
Seat 6: Jesus Ololo (button) folded before Flop (didn't bet)



PokerStars Hand #222952962182:  Hold'em No Limit ($0.05/$0.10 USD) - 2021/01/23 8:08:06 ET
Table 'Saito II' 6-max Seat #5 is the button
Seat 1: notzukau ($13.59 in chips) 
Seat 3: Nail224 ($3.76 in chips) 
Seat 4: jayzz6 ($11.34 in chips) 
Seat 5: KingBiscuitT ($16.88 in chips) 
Seat 6: Enricola ($21.20 in chips) 
Enricola: posts small blind $0.05
notzukau: posts big blind $0.10
*** HOLE CARDS ***
Nail224: folds 
jayzz6: folds 
KingBiscuitT: raises $0.15 to $0.25
Enricola: raises $0.60 to $0.85
notzukau: folds 
KingBiscuitT: raises $1.65 to $2.50
Enricola: calls $1.65
*** FLOP *** [5c 8h Ah]
Enricola: checks 
KingBiscuitT: checks 
*** TURN *** [5c 8h Ah] [7s]
Enricola: checks 
KingBiscuitT: checks 
*** RIVER *** [5c 8h Ah 7s] [7d]
Enricola: checks 
KingBiscuitT: bets $1.46
Enricola: calls $1.46
*** SHOW DOWN ***
KingBiscuitT: shows [Ac Th] (two pair, Aces and Sevens)
Enricola: mucks hand 
KingBiscuitT collected $7.66 from pot
*** SUMMARY ***
Total pot $8.02 | Rake $0.36 
Board [5c 8h Ah 7s 7d]
Seat 1: notzukau (big blind) folded before Flop
Seat 3: Nail224 folded before Flop (didn't bet)
Seat 4: jayzz6 folded before Flop (didn't bet)
Seat 5: KingBiscuitT (button) showed [Ac Th] and won ($7.66) with two pair, Aces and Sevens
Seat 6: Enricola (small blind) mucked



PokerStars Hand #222954769998:  Hold'em No Limit ($0.05/$0.10 USD) - 2021/01/23 9:15:50 ET
Table 'Saito II' 6-max Seat #1 is the button
Seat 1: ivan2772ms ($9.95 in chips) 
Seat 2: Tyoma_Kovach ($15.54 in chips) 
Seat 3: SERG244 ($20.07 in chips) 
Seat 4: vietor201 ($8 in chips) 
Seat 5: Willishoveandbb ($13.20 in chips) 
Seat 6: Jesus Ololo ($10.37 in chips) 
Tyoma_Kovach: posts small blind $0.05
SERG244: posts big blind $0.10
vietor201: posts big blind $0.10
*** HOLE CARDS ***
vietor201: checks 
Willishoveandbb: folds 
Jesus Ololo: folds 
ivan2772ms: folds 
Tyoma_Kovach: folds 
SERG244: checks 
*** FLOP *** [9h 5h Jh]
SERG244: checks 
vietor201: checks 
*** TURN *** [9h 5h Jh] [3s]
SERG244: bets $0.16
vietor201: folds 
Uncalled bet ($0.16) returned to SERG244
SERG244 collected $0.24 from pot
SERG244: doesn't show hand 
*** SUMMARY ***
Total pot $0.25 | Rake $0.01 
Board [9h 5h Jh 3s]
Seat 1: ivan2772ms (button) folded before Flop (didn't bet)
Seat 2: Tyoma_Kovach (small blind) folded before Flop
Seat 3: SERG244 (big blind) collected ($0.24)
Seat 4: vietor201 folded on the Turn (didn't bet)
Seat 5: Willishoveandbb folded before Flop (didn't bet)
Seat 6: Jesus Ololo folded before Flop (didn't bet)



PokerStars Hand #222952979956:  Hold'em No Limit ($0.05/$0.10 USD) - 2021/01/23 8:08:49 ET
Table 'Saito II' 6-max Seat #6 is the button
Seat 1: notzukau ($13.49 in chips) 
Seat 3: Nail224 ($3.76 in chips) 
Seat 4: jayzz6 ($11.34 in chips) 
Seat 5: KingBiscuitT ($20.58 in chips) 
Seat 6: Enricola ($17.24 in chips) 
notzukau: posts small blind $0.05
Nail224: posts big blind $0.10
*** HOLE CARDS ***
jayzz6: raises $0.20 to $0.30
KingBiscuitT: folds 
Enricola: folds 
notzukau: folds 
Nail224: calls $0.20
*** FLOP *** [4s Kd 7c]
Nail224: checks 
jayzz6: checks 
*** TURN *** [4s Kd 7c] [4d]
Nail224: checks 
jayzz6: bets $0.20
Nail224: calls $0.20
*** RIVER *** [4s Kd 7c 4d] [9c]
Nail224: checks 
jayzz6: bets $0.33
Nail224: calls $0.33
*** SHOW DOWN ***
jayzz6: shows [Qc Qd] (two pair, Queens and Fours)
Nail224: mucks hand 
jayzz6 collected $1.63 from pot
*** SUMMARY ***
Total pot $1.71 | Rake $0.08 
Board [4s Kd 7c 4d 9c]
Seat 1: notzukau (small blind) folded before Flop
Seat 3: Nail224 (big blind) mucked
Seat 4: jayzz6 showed [Qc Qd] and won ($1.63) with two pair, Queens and Fours
Seat 5: KingBiscuitT folded before Flop (didn't bet)
Seat 6: Enricola (button) folded before Flop (didn't bet)



PokerStars Hand #222954780124:  Hold'em No Limit ($0.05/$0.10 USD) - 2021/01/23 9:16:10 ET
Table 'Saito II' 6-max Seat #2 is the button
Seat 1: ivan2772ms ($9.95 in chips) 
Seat 2: Tyoma_Kovach ($15.49 in chips) 
Seat 3: SERG244 ($20.21 in chips) 
Seat 4: vietor201 ($7.90 in chips) 
Seat 5: Willishoveandbb ($13.20 in chips) 
Seat 6: Jesus Ololo ($10.37 in chips) 
SERG244: posts small blind $0.05
vietor201: posts big blind $0.10
*** HOLE CARDS ***
Willishoveandbb: folds 
Jesus Ololo: folds 
ivan2772ms: raises $0.20 to $0.30
Tyoma_Kovach: folds 
SERG244: folds 
vietor201: calls $0.20
*** FLOP *** [4h 4c 7d]
vietor201: checks 
ivan2772ms: bets $0.20
vietor201: raises $1.02 to $1.22
ivan2772ms: folds 
Uncalled bet ($1.02) returned to vietor201
vietor201 collected $1 from pot
vietor201: doesn't show hand 
*** SUMMARY ***
Total pot $1.05 | Rake $0.05 
Board [4h 4c 7d]
Seat 1: ivan2772ms folded on the Flop
Seat 2: Tyoma_Kovach (button) folded before Flop (didn't bet)
Seat 3: SERG244 (small blind) folded before Flop
Seat 4: vietor201 (big blind) collected ($1)
Seat 5: Willishoveandbb folded before Flop (didn't bet)
Seat 6: Jesus Ololo folded before Flop (didn't bet)



PokerStars Hand #222952996447:  Hold'em No Limit ($0.05/$0.10 USD) - 2021/01/23 8:09:30 ET
Table 'Saito II' 6-max Seat #1 is the button
Seat 1: notzukau ($13.44 in chips) 
Seat 3: Nail224 ($2.93 in chips) 
Seat 4: jayzz6 ($12.14 in chips) 
Seat 5: KingBiscuitT ($20.58 in chips) 
Seat 6: Enricola ($17.24 in chips) 
Nail224: posts small blind $0.05
jayzz6: posts big blind $0.10
*** HOLE CARDS ***
KingBiscuitT: raises $0.40 to $0.50
Enricola: folds 
notzukau: folds 
Nail224: folds 
jayzz6: calls $0.40
*** FLOP *** [Ks 7s 3c]
jayzz6: checks 
KingBiscuitT: bets $0.67
jayzz6: folds 
Uncalled bet ($0.67) returned to KingBiscuitT
KingBiscuitT collected $1 from pot
KingBiscuitT: doesn't show hand 
*** SUMMARY ***
Total pot $1.05 | Rake $0.05 
Board [Ks 7s 3c]
Seat 1: notzukau (button) folded before Flop (didn't bet)
Seat 3: Nail224 (small blind) folded before Flop
Seat 4: jayzz6 (big blind) folded on the Flop
Seat 5: KingBiscuitT collected ($1)
Seat 6: Enricola folded before Flop (didn't bet)



PokerStars Hand #222953013381:  Hold'em No Limit ($0.05/$0.10 USD) - 2021/01/23 8:10:11 ET
Table 'Saito II' 6-max Seat #3 is the button
Seat 1: notzukau ($13.44 in chips) 
Seat 3: Nail224 ($2.88 in chips) 
Seat 4: jayzz6 ($11.64 in chips) 
Seat 5: KingBiscuitT ($21.08 in chips) 
Seat 6: Enricola ($17.24 in chips) 
jayzz6: posts small blind $0.05
KingBiscuitT: posts big blind $0.10
*** HOLE CARDS ***
Enricola: folds 
notzukau: folds 
Nail224: folds 
jayzz6: folds 
Uncalled bet ($0.05) returned to KingBiscuitT
KingBiscuitT collected $0.10 from pot
KingBiscuitT: doesn't show hand 
*** SUMMARY ***
Total pot $0.10 | Rake $0 
Seat 1: notzukau folded before Flop (didn't bet)
Seat 3: Nail224 (button) folded before Flop (didn't bet)
Seat 4: jayzz6 (small blind) folded before Flop
Seat 5: KingBiscuitT (big blind) collected ($0.10)
Seat 6: Enricola folded before Flop (didn't bet)



PokerStars Hand #222954792600:  Hold'em No Limit ($0.05/$0.10 USD) - 2021/01/23 9:16:35 ET
Table 'Saito II' 6-max Seat #3 is the button
Seat 1: ivan2772ms ($10 in chips) 
Seat 2: Tyoma_Kovach ($15.49 in chips) 
Seat 3: SERG244 ($20.16 in chips) 
Seat 4: vietor201 ($8.40 in chips) 
Seat 5: Willishoveandbb ($13.20 in chips) 
Seat 6: Jesus Ololo ($10.37 in chips) 
vietor201: posts small blind $0.05
Willishoveandbb: posts big blind $0.10
*** HOLE CARDS ***
Jesus Ololo: folds 
ivan2772ms: folds 
Tyoma_Kovach: folds 
SERG244: folds 
vietor201: folds 
Uncalled bet ($0.05) returned to Willishoveandbb
Willishoveandbb collected $0.10 from pot
*** SUMMARY ***
Total pot $0.10 | Rake $0 
Seat 1: ivan2772ms folded before Flop (didn't bet)
Seat 2: Tyoma_Kovach folded before Flop (didn't bet)
Seat 3: SERG244 (button) folded before Flop (didn't bet)
Seat 4: vietor201 (small blind) folded before Flop
Seat 5: Willishoveandbb (big blind) collected ($0.10)
Seat 6: Jesus Ololo folded before Flop (didn't bet)



PokerStars Hand #222953017378:  Hold'em No Limit ($0.05/$0.10 USD) - 2021/01/23 8:10:21 ET
Table 'Saito II' 6-max Seat #4 is the button
Seat 1: notzukau ($13.44 in chips) 
Seat 3: Nail224 ($2.88 in chips) 
Seat 4: jayzz6 ($11.59 in chips) 
Seat 5: KingBiscuitT ($21.13 in chips) 
Seat 6: Enricola ($17.24 in chips) 
KingBiscuitT: posts small blind $0.05
Enricola: posts big blind $0.10
*** HOLE CARDS ***
notzukau: folds 
Nail224: folds 
notzukau leaves the table
jayzz6: folds 
KingBiscuitT: raises $0.15 to $0.25
Enricola: raises $0.15 to $0.40
KingBiscuitT: calls $0.15
*** FLOP *** [Jh 6c 5h]
KingBiscuitT: checks 
Enricola: bets $0.38
KingBiscuitT: folds 
Uncalled bet ($0.38) returned to Enricola
Enricola collected $0.76 from pot
Enricola: doesn't show hand 
*** SUMMARY ***
Total pot $0.80 | Rake $0.04 
Board [Jh 6c 5h]
Seat 1: notzukau folded before Flop (didn't bet)
Seat 3: Nail224 folded before Flop (didn't bet)
Seat 4: jayzz6 (button) folded before Flop (didn't bet)
Seat 5: KingBiscuitT (small blind) folded on the Flop
Seat 6: Enricola (big blind) collected ($0.76)



PokerStars Hand #222954798752:  Hold'em No Limit ($0.05/$0.10 USD) - 2021/01/23 9:16:47 ET
Table 'Saito II' 6-max Seat #4 is the button
Seat 1: ivan2772ms ($10 in chips) 
Seat 2: Tyoma_Kovach ($15.49 in chips) 
Seat 3: SERG244 ($20.16 in chips) 
Seat 4: vietor201 ($8.35 in chips) 
Seat 5: Willishoveandbb ($13.25 in chips) 
Seat 6: Jesus Ololo ($10.37 in chips) 
Willishoveandbb: posts small blind $0.05
Jesus Ololo: posts big blind $0.10
*** HOLE CARDS ***
ivan2772ms: folds 
Tyoma_Kovach: folds 
SERG244: folds 
vietor201: calls $0.10
Willishoveandbb: folds 
Jesus Ololo: checks 
*** FLOP *** [Qd 2s 5h]
Jesus Ololo: checks 
vietor201: checks 
*** TURN *** [Qd 2s 5h] [9c]
Jesus Ololo: checks 
vietor201: bets $0.10
Jesus Ololo: calls $0.10
*** RIVER *** [Qd 2s 5h 9c] [Kc]
Jesus Ololo: checks 
vietor201: bets $0.10
Jesus Ololo: calls $0.10
*** SHOW DOWN ***
vietor201: shows [Ad 9d] (a pair of Nines)
Jesus Ololo: mucks hand 
vietor201 collected $0.62 from pot
*** SUMMARY ***
Total pot $0.65 | Rake $0.03 
Board [Qd 2s 5h 9c Kc]
Seat 1: ivan2772ms folded before Flop (didn't bet)
Seat 2: Tyoma_Kovach folded before Flop (didn't bet)
Seat 3: SERG244 folded before Flop (didn't bet)
Seat 4: vietor201 (button) showed [Ad 9d] and won ($0.62) with a pair of Nines
Seat 5: Willishoveandbb (small blind) folded before Flop
Seat 6: Jesus Ololo (big blind) mucked



PokerStars Hand #222953026065:  Hold'em No Limit ($0.05/$0.10 USD) - 2021/01/23 8:10:42 ET
Table 'Saito II' 6-max Seat #5 is the button
Seat 3: Nail224 ($2.88 in chips) 
Seat 4: jayzz6 ($11.59 in chips) 
Seat 5: KingBiscuitT ($20.73 in chips) 
Seat 6: Enricola ($17.60 in chips) 
Enricola: posts small blind $0.05
Nail224: posts big blind $0.10
*** HOLE CARDS ***
jayzz6: folds 
KingBiscuitT: raises $0.15 to $0.25
Enricola: raises $0.60 to $0.85
Nail224: calls $0.75
father here joins the table at seat #1 
KingBiscuitT: calls $0.60
*** FLOP *** [Kh Ah As]
Enricola: checks 
Nail224: bets $0.10
KingBiscuitT: folds 
Enricola: calls $0.10
*** TURN *** [Kh Ah As] [2h]
Enricola: checks 
Nail224: checks 
*** RIVER *** [Kh Ah As 2h] [Qh]
Enricola: bets $2.63
Nail224: folds 
Uncalled bet ($2.63) returned to Enricola
Enricola collected $2.63 from pot
Enricola: doesn't show hand 
*** SUMMARY ***
Total pot $2.75 | Rake $0.12 
Board [Kh Ah As 2h Qh]
Seat 3: Nail224 (big blind) folded on the River
Seat 4: jayzz6 folded before Flop (didn't bet)
Seat 5: KingBiscuitT (button) folded on the Flop
Seat 6: Enricola (small blind) collected ($2.63)



PokerStars Hand #222954816471:  Hold'em No Limit ($0.05/$0.10 USD) - 2021/01/23 9:17:23 ET
Table 'Saito II' 6-max Seat #5 is the button
Seat 1: ivan2772ms ($10 in chips) 
Seat 2: Tyoma_Kovach ($15.49 in chips) 
Seat 3: SERG244 ($20.16 in chips) 
Seat 4: vietor201 ($8.67 in chips) 
Seat 5: Willishoveandbb ($13.20 in chips) 
Seat 6: Jesus Ololo ($10.07 in chips) 
Jesus Ololo: posts small blind $0.05
ivan2772ms: posts big blind $0.10
*** HOLE CARDS ***
Tyoma_Kovach: folds 
SERG244: folds 
vietor201: folds 
Willishoveandbb: folds 
Jesus Ololo: folds 
Uncalled bet ($0.05) returned to ivan2772ms
ivan2772ms collected $0.10 from pot
ivan2772ms: doesn't show hand 
*** SUMMARY ***
Total pot $0.10 | Rake $0 
Seat 1: ivan2772ms (big blind) collected ($0.10)
Seat 2: Tyoma_Kovach folded before Flop (didn't bet)
Seat 3: SERG244 folded before Flop (didn't bet)
Seat 4: vietor201 folded before Flop (didn't bet)
Seat 5: Willishoveandbb (button) folded before Flop (didn't bet)
Seat 6: Jesus Ololo (small blind) folded before Flop



PokerStars Hand #222953042487:  Hold'em No Limit ($0.05/$0.10 USD) - 2021/01/23 8:11:23 ET
Table 'Saito II' 6-max Seat #6 is the button
Seat 3: Nail224 ($1.93 in chips) 
Seat 4: jayzz6 ($11.59 in chips) 
Seat 5: KingBiscuitT ($19.88 in chips) 
Seat 6: Enricola ($19.28 in chips) 
Nail224: posts small blind $0.05
jayzz6: posts big blind $0.10
*** HOLE CARDS ***
KingBiscuitT: raises $0.15 to $0.25
Enricola: folds 
Nail224: folds 
jayzz6: folds 
Uncalled bet ($0.15) returned to KingBiscuitT
KingBiscuitT collected $0.25 from pot
KingBiscuitT: doesn't show hand 
*** SUMMARY ***
Total pot $0.25 | Rake $0 
Seat 3: Nail224 (small blind) folded before Flop
Seat 4: jayzz6 (big blind) folded before Flop
Seat 5: KingBiscuitT collected ($0.25)
Seat 6: Enricola (button) folded before Flop (didn't bet)



PokerStars Hand #222954823208:  Hold'em No Limit ($0.05/$0.10 USD) - 2021/01/23 9:17:37 ET
Table 'Saito II' 6-max Seat #6 is the button
Seat 1: ivan2772ms ($10.05 in chips) 
Seat 2: Tyoma_Kovach ($15.49 in chips) 
Seat 3: SERG244 ($20.16 in chips) 
Seat 4: vietor201 ($8.67 in chips) 
Seat 5: Willishoveandbb ($13.20 in chips) 
Seat 6: Jesus Ololo ($10.02 in chips) 
ivan2772ms: posts small blind $0.05
Tyoma_Kovach: posts big blind $0.10
*** HOLE CARDS ***
SERG244: folds 
vietor201: folds 
Willishoveandbb: raises $0.15 to $0.25
Jesus Ololo: folds 
ivan2772ms: raises $0.65 to $0.90
Tyoma_Kovach: folds 
Willishoveandbb: folds 
Uncalled bet ($0.65) returned to ivan2772ms
ivan2772ms collected $0.60 from pot
ivan2772ms: doesn't show hand 
*** SUMMARY ***
Total pot $0.60 | Rake $0 
Seat 1: ivan2772ms (small blind) collected ($0.60)
Seat 2: Tyoma_Kovach (big blind) folded before Flop
Seat 3: SERG244 folded before Flop (didn't bet)
Seat 4: vietor201 folded before Flop (didn't bet)
Seat 5: Willishoveandbb folded before Flop
Seat 6: Jesus Ololo (button) folded before Flop (didn't bet)



PokerStars Hand #222953046382:  Hold'em No Limit ($0.05/$0.10 USD) - 2021/01/23 8:11:32 ET
Table 'Saito II' 6-max Seat #3 is the button
Seat 3: Nail224 ($1.88 in chips) 
Seat 4: jayzz6 ($11.49 in chips) 
Seat 5: KingBiscuitT ($20.03 in chips) 
Seat 6: Enricola ($19.28 in chips) 
jayzz6: posts small blind $0.05
KingBiscuitT: posts big blind $0.10
father here: sits out 
*** HOLE CARDS ***
Enricola: raises $0.25 to $0.35
Nail224: calls $0.35
jayzz6: folds 
KingBiscuitT: folds 
*** FLOP *** [2h Ah Jh]
Enricola: bets $0.70
Nail224: calls $0.70
*** TURN *** [2h Ah Jh] [3s]
Enricola: bets $2.15
Nail224: calls $0.83 and is all-in
Uncalled bet ($1.32) returned to Enricola
*** RIVER *** [2h Ah Jh 3s] [6c]
*** SHOW DOWN ***
Enricola: shows [Ks 8s] (high card Ace)
Nail224: shows [8c Kh] (high card Ace)
Enricola collected $1.87 from pot
Nail224 collected $1.86 from pot
*** SUMMARY ***
Total pot $3.91 | Rake $0.18 
Board [2h Ah Jh 3s 6c]
Seat 3: Nail224 (button) showed [8c Kh] and won ($1.86) with high card Ace
Seat 4: jayzz6 (small blind) folded before Flop
Seat 5: KingBiscuitT (big blind) folded before Flop
Seat 6: Enricola showed [Ks 8s] and won ($1.87) with high card Ace



PokerStars Hand #222954831425:  Hold'em No Limit ($0.05/$0.10 USD) - 2021/01/23 9:17:53 ET
Table 'Saito II' 6-max Seat #1 is the button
Seat 1: ivan2772ms ($10.40 in chips) 
Seat 2: Tyoma_Kovach ($15.39 in chips) 
Seat 3: SERG244 ($20.16 in chips) 
Seat 4: vietor201 ($8.67 in chips) 
Seat 5: Willishoveandbb ($12.95 in chips) 
Seat 6: Jesus Ololo ($10.02 in chips) 
Tyoma_Kovach: posts small blind $0.05
SERG244: posts big blind $0.10
*** HOLE CARDS ***
vietor201: raises $0.10 to $0.20
Willishoveandbb: raises $0.60 to $0.80
Jesus Ololo: folds 
ivan2772ms: folds 
Tyoma_Kovach: folds 
SERG244: folds 
vietor201: calls $0.60
*** FLOP *** [6s Th Kd]
vietor201: checks 
Willishoveandbb: bets $0.52
vietor201: calls $0.52
*** TURN *** [6s Th Kd] [Ac]
vietor201: checks 
Willishoveandbb: bets $1.17
vietor201: calls $1.17
*** RIVER *** [6s Th Kd Ac] [4s]
vietor201: checks 
Willishoveandbb: bets $3.38
vietor201: calls $3.38
*** SHOW DOWN ***
Willishoveandbb: shows [Kh Kc] (three of a kind, Kings)
vietor201: mucks hand 
Willishoveandbb collected $11.35 from pot
*** SUMMARY ***
Total pot $11.89 | Rake $0.54 
Board [6s Th Kd Ac 4s]
Seat 1: ivan2772ms (button) folded before Flop (didn't bet)
Seat 2: Tyoma_Kovach (small blind) folded before Flop
Seat 3: SERG244 (big blind) folded before Flop
Seat 4: vietor201 mucked
Seat 5: Willishoveandbb showed [Kh Kc] and won ($11.35) with three of a kind, Kings
Seat 6: Jesus Ololo folded before Flop (didn't bet)



PokerStars Hand #222954848217:  Hold'em No Limit ($0.05/$0.10 USD) - 2021/01/23 9:18:27 ET
Table 'Saito II' 6-max Seat #2 is the button
Seat 1: ivan2772ms ($10.40 in chips) 
Seat 2: Tyoma_Kovach ($15.34 in chips) 
Seat 3: SERG244 ($20.06 in chips) 
Seat 4: vietor201 ($2.80 in chips) 
Seat 5: Willishoveandbb ($18.43 in chips) 
Seat 6: Jesus Ololo ($10.02 in chips) 
SERG244: posts small blind $0.05
vietor201: posts big blind $0.10
*** HOLE CARDS ***
Willishoveandbb: folds 
Jesus Ololo: raises $0.15 to $0.25
ivan2772ms: folds 
Tyoma_Kovach: folds 
SERG244: folds 
vietor201: raises $2.55 to $2.80 and is all-in
Jesus Ololo: folds 
Uncalled bet ($2.55) returned to vietor201
vietor201 collected $0.55 from pot
vietor201: doesn't show hand 
*** SUMMARY ***
Total pot $0.55 | Rake $0 
Seat 1: ivan2772ms folded before Flop (didn't bet)
Seat 2: Tyoma_Kovach (button) folded before Flop (didn't bet)
Seat 3: SERG244 (small blind) folded before Flop
Seat 4: vietor201 (big blind) collected ($0.55)
Seat 5: Willishoveandbb folded before Flop (didn't bet)
Seat 6: Jesus Ololo folded before Flop



PokerStars Hand #222953064324:  Hold'em No Limit ($0.05/$0.10 USD) - 2021/01/23 8:12:16 ET
Table 'Saito II' 6-max Seat #4 is the button
Seat 3: Nail224 ($1.86 in chips) 
Seat 4: jayzz6 ($11.44 in chips) 
Seat 5: KingBiscuitT ($19.93 in chips) 
Seat 6: Enricola ($19.27 in chips) 
KingBiscuitT: posts small blind $0.05
Enricola: posts big blind $0.10
father here: sits out 
*** HOLE CARDS ***
Nail224: calls $0.10
jayzz6: folds 
KingBiscuitT: raises $0.60 to $0.70
Enricola: folds 
Nail224: calls $0.60
*** FLOP *** [3c 3h 3d]
KingBiscuitT: bets $0.95
Nail224: calls $0.95
*** TURN *** [3c 3h 3d] [Tc]
KingBiscuitT: bets $4.88
Nail224: calls $0.21 and is all-in
Uncalled bet ($4.67) returned to KingBiscuitT
*** RIVER *** [3c 3h 3d Tc] [2s]
*** SHOW DOWN ***
KingBiscuitT: shows [Ks Kh] (a full house, Threes full of Kings)
Nail224: shows [Kc 4s] (three of a kind, Threes)
KingBiscuitT collected $3.65 from pot
Nail224 cashed out the hand for $0.04
*** SUMMARY ***
Total pot $3.82 | Rake $0.17 
Board [3c 3h 3d Tc 2s]
Seat 3: Nail224 showed [Kc 4s] and lost with three of a kind, Threes (cashed out).
Seat 4: jayzz6 (button) folded before Flop (didn't bet)
Seat 5: KingBiscuitT (small blind) showed [Ks Kh] and won ($3.65) with a full house, Threes full of Kings
Seat 6: Enricola (big blind) folded before Flop



PokerStars Hand #222953077435:  Hold'em No Limit ($0.05/$0.10 USD) - 2021/01/23 8:12:48 ET
Table 'Saito II' 6-max Seat #5 is the button
Seat 1: father here ($10 in chips) 
Seat 4: jayzz6 ($11.44 in chips) 
Seat 5: KingBiscuitT ($21.72 in chips) 
Seat 6: Enricola ($19.17 in chips) 
Enricola: posts small blind $0.05
father here: posts big blind $0.10
*** HOLE CARDS ***
jayzz6: raises $0.15 to $0.25
KingBiscuitT: folds 
Enricola: folds 
father here: calls $0.15
*** FLOP *** [Ks 3s 4s]
Nail224 leaves the table
father here: checks 
jayzz6: bets $0.29
father here: folds 
Uncalled bet ($0.29) returned to jayzz6
jayzz6 collected $0.53 from pot
jayzz6: doesn't show hand 
*** SUMMARY ***
Total pot $0.55 | Rake $0.02 
Board [Ks 3s 4s]
Seat 1: father here (big blind) folded on the Flop
Seat 4: jayzz6 collected ($0.53)
Seat 5: KingBiscuitT (button) folded before Flop (didn't bet)
Seat 6: Enricola (small blind) folded before Flop



PokerStars Hand #222954858128:  Hold'em No Limit ($0.05/$0.10 USD) - 2021/01/23 9:18:46 ET
Table 'Saito II' 6-max Seat #3 is the button
Seat 1: ivan2772ms ($10.40 in chips) 
Seat 2: Tyoma_Kovach ($15.34 in chips) 
Seat 3: SERG244 ($20.01 in chips) 
Seat 4: vietor201 ($3.10 in chips) 
Seat 5: Willishoveandbb ($18.43 in chips) 
Seat 6: Jesus Ololo ($10 in chips) 
vietor201: posts small blind $0.05
Willishoveandbb: posts big blind $0.10
*** HOLE CARDS ***
Jesus Ololo: raises $0.15 to $0.25
ivan2772ms: folds 
Tyoma_Kovach: folds 
SERG244: folds 
vietor201: folds 
Willishoveandbb: folds 
Uncalled bet ($0.15) returned to Jesus Ololo
Jesus Ololo collected $0.25 from pot
*** SUMMARY ***
Total pot $0.25 | Rake $0 
Seat 1: ivan2772ms folded before Flop (didn't bet)
Seat 2: Tyoma_Kovach folded before Flop (didn't bet)
Seat 3: SERG244 (button) folded before Flop (didn't bet)
Seat 4: vietor201 (small blind) folded before Flop
Seat 5: Willishoveandbb (big blind) folded before Flop
Seat 6: Jesus Ololo collected ($0.25)



PokerStars Hand #222953091284:  Hold'em No Limit ($0.05/$0.10 USD) - 2021/01/23 8:13:21 ET
Table 'Saito II' 6-max Seat #6 is the button
Seat 1: father here ($10 in chips) 
Seat 4: jayzz6 ($11.72 in chips) 
Seat 5: KingBiscuitT ($21.72 in chips) 
Seat 6: Enricola ($19.12 in chips) 
father here: posts small blind $0.05
jayzz6: posts big blind $0.10
*** HOLE CARDS ***
KingBiscuitT: raises $0.15 to $0.25
Enricola: folds 
meirenxingde joins the table at seat #3 
father here: folds 
jayzz6: folds 
Uncalled bet ($0.15) returned to KingBiscuitT
KingBiscuitT collected $0.25 from pot
ivan2772ms was removed from the table for failing to post
ivan2772ms leaves the table
KingBiscuitT: doesn't show hand 
*** SUMMARY ***
Total pot $0.25 | Rake $0 
Seat 1: father here (small blind) folded before Flop
Seat 4: jayzz6 (big blind) folded before Flop
Seat 5: KingBiscuitT collected ($0.25)
Seat 6: Enricola (button) folded before Flop (didn't bet)



PokerStars Hand #222954861926:  Hold'em No Limit ($0.05/$0.10 USD) - 2021/01/23 9:18:54 ET
Table 'Saito II' 6-max Seat #4 is the button
Seat 1: ivan2772ms ($10.40 in chips) 
Seat 2: Tyoma_Kovach ($15.34 in chips) 
Seat 3: SERG244 ($20.01 in chips) 
Seat 4: vietor201 ($3.05 in chips) 
Seat 5: Willishoveandbb ($18.33 in chips) 
Seat 6: Jesus Ololo ($10.15 in chips) 
Willishoveandbb: posts small blind $0.05
Jesus Ololo: posts big blind $0.10
*** HOLE CARDS ***
ivan2772ms: folds 
Tyoma_Kovach: folds 
SERG244: folds 
vietor201: folds 
Willishoveandbb: calls $0.05
Jesus Ololo: checks 
*** FLOP *** [7c Kd Ah]
Willishoveandbb: bets $0.10
Jesus Ololo: folds 
Uncalled bet ($0.10) returned to Willishoveandbb
Willishoveandbb collected $0.19 from pot
*** SUMMARY ***
Total pot $0.20 | Rake $0.01 
Board [7c Kd Ah]
Seat 1: ivan2772ms folded before Flop (didn't bet)
Seat 2: Tyoma_Kovach folded before Flop (didn't bet)
Seat 3: SERG244 folded before Flop (didn't bet)
Seat 4: vietor201 (button) folded before Flop (didn't bet)
Seat 5: Willishoveandbb (small blind) collected ($0.19)
Seat 6: Jesus Ololo (big blind) folded on the Flop



PokerStars Hand #222953096074:  Hold'em No Limit ($0.05/$0.10 USD) - 2021/01/23 8:13:33 ET
Table 'Saito II' 6-max Seat #1 is the button
Seat 1: father here ($10 in chips) 
Seat 4: jayzz6 ($11.62 in chips) 
Seat 5: KingBiscuitT ($21.87 in chips) 
Seat 6: Enricola ($19.12 in chips) 
jayzz6: posts small blind $0.05
KingBiscuitT: posts big blind $0.10
*** HOLE CARDS ***
Enricola: folds 
father here: raises $0.20 to $0.30
jayzz6: folds 
KingBiscuitT: folds 
Uncalled bet ($0.20) returned to father here
father here collected $0.25 from pot
*** SUMMARY ***
Total pot $0.25 | Rake $0 
Seat 1: father here (button) collected ($0.25)
Seat 4: jayzz6 (small blind) folded before Flop
Seat 5: KingBiscuitT (big blind) folded before Flop
Seat 6: Enricola folded before Flop (didn't bet)



PokerStars Hand #222954871828:  Hold'em No Limit ($0.05/$0.10 USD) - 2021/01/23 9:19:14 ET
Table 'Saito II' 6-max Seat #5 is the button
Seat 1: ivan2772ms ($10.40 in chips) 
Seat 2: Tyoma_Kovach ($15.34 in chips) 
Seat 3: SERG244 ($20.01 in chips) 
Seat 4: vietor201 ($3.05 in chips) 
Seat 5: Willishoveandbb ($18.42 in chips) 
Seat 6: Jesus Ololo ($10.05 in chips) 
Jesus Ololo: posts small blind $0.05
ivan2772ms: posts big blind $0.10
*** HOLE CARDS ***
Tyoma_Kovach: folds 
SERG244: raises $0.16 to $0.26
vietor201: folds 
Willishoveandbb: folds 
Jesus Ololo: folds 
ivan2772ms: raises $0.94 to $1.20
SERG244: folds 
Uncalled bet ($0.94) returned to ivan2772ms
ivan2772ms collected $0.57 from pot
ivan2772ms: doesn't show hand 
*** SUMMARY ***
Total pot $0.57 | Rake $0 
Seat 1: ivan2772ms (big blind) collected ($0.57)
Seat 2: Tyoma_Kovach folded before Flop (didn't bet)
Seat 3: SERG244 folded before Flop
Seat 4: vietor201 folded before Flop (didn't bet)
Seat 5: Willishoveandbb (button) folded before Flop (didn't bet)
Seat 6: Jesus Ololo (small blind) folded before Flop



PokerStars Hand #222953105480:  Hold'em No Limit ($0.05/$0.10 USD) - 2021/01/23 8:13:56 ET
Table 'Saito II' 6-max Seat #4 is the button
Seat 1: father here ($10.15 in chips) 
Seat 4: jayzz6 ($11.57 in chips) 
Seat 5: KingBiscuitT ($21.77 in chips) 
Seat 6: Enricola ($19.12 in chips) 
KingBiscuitT: posts small blind $0.05
Enricola: posts big blind $0.10
meirenxingde: sits out 
*** HOLE CARDS ***
Tyoma_Kovach joins the table at seat #2 
father here: raises $0.20 to $0.30
jayzz6: folds 
KingBiscuitT: folds 
Enricola: raises $0.65 to $0.95
father here: folds 
Uncalled bet ($0.65) returned to Enricola
Enricola collected $0.65 from pot
Enricola: doesn't show hand 
*** SUMMARY ***
Total pot $0.65 | Rake $0 
Seat 1: father here folded before Flop
Seat 4: jayzz6 (button) folded before Flop (didn't bet)
Seat 5: KingBiscuitT (small blind) folded before Flop
Seat 6: Enricola (big blind) collected ($0.65)



PokerStars Hand #222954881683:  Hold'em No Limit ($0.05/$0.10 USD) - 2021/01/23 9:19:34 ET
Table 'Saito II' 6-max Seat #6 is the button
Seat 1: ivan2772ms ($10.71 in chips) 
Seat 2: Tyoma_Kovach ($15.34 in chips) 
Seat 3: SERG244 ($19.75 in chips) 
Seat 4: vietor201 ($3.05 in chips) 
Seat 5: Willishoveandbb ($18.42 in chips) 
Seat 6: Jesus Ololo ($10 in chips) 
ivan2772ms: posts small blind $0.05
Tyoma_Kovach: posts big blind $0.10
*** HOLE CARDS ***
SERG244: folds 
vietor201: folds 
Willishoveandbb: folds 
Jesus Ololo: folds 
ivan2772ms: folds 
Uncalled bet ($0.05) returned to Tyoma_Kovach
Tyoma_Kovach collected $0.10 from pot
Tyoma_Kovach: doesn't show hand 
*** SUMMARY ***
Total pot $0.10 | Rake $0 
Seat 1: ivan2772ms (small blind) folded before Flop
Seat 2: Tyoma_Kovach (big blind) collected ($0.10)
Seat 3: SERG244 folded before Flop (didn't bet)
Seat 4: vietor201 folded before Flop (didn't bet)
Seat 5: Willishoveandbb folded before Flop (didn't bet)
Seat 6: Jesus Ololo (button) folded before Flop (didn't bet)



PokerStars Hand #222953114440:  Hold'em No Limit ($0.05/$0.10 USD) - 2021/01/23 8:14:18 ET
Table 'Saito II' 6-max Seat #5 is the button
Seat 1: father here ($10 in chips) 
Seat 4: jayzz6 ($11.57 in chips) 
Seat 5: KingBiscuitT ($21.72 in chips) 
Seat 6: Enricola ($19.47 in chips) 
Enricola: posts small blind $0.05
father here: posts big blind $0.10
Tyoma_Kovach: sits out 
meirenxingde: sits out 
*** HOLE CARDS ***
jayzz6: raises $0.15 to $0.25
KingBiscuitT: raises $0.65 to $0.90
Enricola: folds 
father here: raises $9.10 to $10 and is all-in
jayzz6: folds 
KingBiscuitT: folds 
Uncalled bet ($9.10) returned to father here
father here collected $2.10 from pot
*** SUMMARY ***
Total pot $2.10 | Rake $0 
Seat 1: father here (big blind) collected ($2.10)
Seat 4: jayzz6 folded before Flop
Seat 5: KingBiscuitT (button) folded before Flop
Seat 6: Enricola (small blind) folded before Flop



PokerStars Hand #222954885894:  Hold'em No Limit ($0.05/$0.10 USD) - 2021/01/23 9:19:42 ET
Table 'Saito II' 6-max Seat #1 is the button
Seat 1: ivan2772ms ($10.66 in chips) 
Seat 2: Tyoma_Kovach ($15.39 in chips) 
Seat 3: SERG244 ($19.75 in chips) 
Seat 4: vietor201 ($3.05 in chips) 
Seat 5: Willishoveandbb ($18.42 in chips) 
Seat 6: Jesus Ololo ($10 in chips) 
Tyoma_Kovach: posts small blind $0.05
SERG244: posts big blind $0.10
*** HOLE CARDS ***
vietor201: calls $0.10
Willishoveandbb: folds 
Jesus Ololo: folds 
ivan2772ms: raises $0.35 to $0.45
Tyoma_Kovach: folds 
SERG244: raises $0.85 to $1.30
vietor201: folds 
ivan2772ms: folds 
Uncalled bet ($0.85) returned to SERG244
SERG244 collected $1.05 from pot
SERG244: doesn't show hand 
*** SUMMARY ***
Total pot $1.05 | Rake $0 
Seat 1: ivan2772ms (button) folded before Flop
Seat 2: Tyoma_Kovach (small blind) folded before Flop
Seat 3: SERG244 (big blind) collected ($1.05)
Seat 4: vietor201 folded before Flop
Seat 5: Willishoveandbb folded before Flop (didn't bet)
Seat 6: Jesus Ololo folded before Flop (didn't bet)



PokerStars Hand #222953128305:  Hold'em No Limit ($0.05/$0.10 USD) - 2021/01/23 8:14:52 ET
Table 'Saito II' 6-max Seat #6 is the button
Seat 1: father here ($11.20 in chips) 
Seat 2: Tyoma_Kovach ($10 in chips) 
Seat 4: jayzz6 ($11.32 in chips) 
Seat 5: KingBiscuitT ($20.82 in chips) 
Seat 6: Enricola ($19.42 in chips) 
father here: posts small blind $0.05
Tyoma_Kovach: posts big blind $0.10
meirenxingde: sits out 
*** HOLE CARDS ***
jayzz6: raises $0.20 to $0.30
KingBiscuitT: folds 
Enricola: folds 
father here: folds 
Tyoma_Kovach: folds 
Uncalled bet ($0.20) returned to jayzz6
jayzz6 collected $0.25 from pot
*** SUMMARY ***
Total pot $0.25 | Rake $0 
Seat 1: father here (small blind) folded before Flop
Seat 2: Tyoma_Kovach (big blind) folded before Flop
Seat 4: jayzz6 collected ($0.25)
Seat 5: KingBiscuitT folded before Flop (didn't bet)
Seat 6: Enricola (button) folded before Flop (didn't bet)



PokerStars Hand #222954895888:  Hold'em No Limit ($0.05/$0.10 USD) - 2021/01/23 9:20:02 ET
Table 'Saito II' 6-max Seat #2 is the button
Seat 1: ivan2772ms ($10.21 in chips) 
Seat 2: Tyoma_Kovach ($15.34 in chips) 
Seat 3: SERG244 ($20.35 in chips) 
Seat 4: vietor201 ($2.95 in chips) 
Seat 5: Willishoveandbb ($18.42 in chips) 
Seat 6: Jesus Ololo ($10 in chips) 
SERG244: posts small blind $0.05
vietor201: posts big blind $0.10
*** HOLE CARDS ***
Willishoveandbb: folds 
Jesus Ololo: raises $0.15 to $0.25
ivan2772ms: folds 
Tyoma_Kovach: folds 
SERG244: folds 
vietor201: folds 
Uncalled bet ($0.15) returned to Jesus Ololo
Jesus Ololo collected $0.25 from pot
*** SUMMARY ***
Total pot $0.25 | Rake $0 
Seat 1: ivan2772ms folded before Flop (didn't bet)
Seat 2: Tyoma_Kovach (button) folded before Flop (didn't bet)
Seat 3: SERG244 (small blind) folded before Flop
Seat 4: vietor201 (big blind) folded before Flop
Seat 5: Willishoveandbb folded before Flop (didn't bet)
Seat 6: Jesus Ololo collected ($0.25)



PokerStars Hand #222954901518:  Hold'em No Limit ($0.05/$0.10 USD) - 2021/01/23 9:20:13 ET
Table 'Saito II' 6-max Seat #3 is the button
Seat 1: ivan2772ms ($10.21 in chips) 
Seat 2: Tyoma_Kovach ($15.34 in chips) 
Seat 3: SERG244 ($20.30 in chips) 
Seat 4: vietor201 ($2.85 in chips) 
Seat 5: Willishoveandbb ($18.42 in chips) 
Seat 6: Jesus Ololo ($10.15 in chips) 
vietor201: posts small blind $0.05
Willishoveandbb: posts big blind $0.10
*** HOLE CARDS ***
Jesus Ololo: folds 
ivan2772ms: raises $0.20 to $0.30
Tyoma_Kovach: folds 
SERG244: folds 
vietor201: folds 
Willishoveandbb: folds 
Uncalled bet ($0.20) returned to ivan2772ms
ivan2772ms collected $0.25 from pot
ivan2772ms: doesn't show hand 
*** SUMMARY ***
Total pot $0.25 | Rake $0 
Seat 1: ivan2772ms collected ($0.25)
Seat 2: Tyoma_Kovach folded before Flop (didn't bet)
Seat 3: SERG244 (button) folded before Flop (didn't bet)
Seat 4: vietor201 (small blind) folded before Flop
Seat 5: Willishoveandbb (big blind) folded before Flop
Seat 6: Jesus Ololo folded before Flop (didn't bet)



PokerStars Hand #222953133902:  Hold'em No Limit ($0.05/$0.10 USD) - 2021/01/23 8:15:05 ET
Table 'Saito II' 6-max Seat #1 is the button
Seat 1: father here ($11.15 in chips) 
Seat 2: Tyoma_Kovach ($10 in chips) 
Seat 3: meirenxingde ($10 in chips) 
Seat 4: jayzz6 ($11.47 in chips) 
Seat 5: KingBiscuitT ($20.82 in chips) 
Seat 6: Enricola ($19.42 in chips) 
Tyoma_Kovach: posts small blind $0.05
meirenxingde: posts big blind $0.10
*** HOLE CARDS ***
jayzz6: folds 
KingBiscuitT: folds 
Enricola: folds 
father here: raises $0.25 to $0.35
Tyoma_Kovach: folds 
meirenxingde: folds 
Uncalled bet ($0.25) returned to father here
father here collected $0.25 from pot
*** SUMMARY ***
Total pot $0.25 | Rake $0 
Seat 1: father here (button) collected ($0.25)
Seat 2: Tyoma_Kovach (small blind) folded before Flop
Seat 3: meirenxingde (big blind) folded before Flop
Seat 4: jayzz6 folded before Flop (didn't bet)
Seat 5: KingBiscuitT folded before Flop (didn't bet)
Seat 6: Enricola folded before Flop (didn't bet)



PokerStars Hand #222953142521:  Hold'em No Limit ($0.05/$0.10 USD) - 2021/01/23 8:15:26 ET
Table 'Saito II' 6-max Seat #2 is the button
Seat 1: father here ($11.30 in chips) 
Seat 2: Tyoma_Kovach ($10 in chips) 
Seat 3: meirenxingde ($9.90 in chips) 
Seat 4: jayzz6 ($11.47 in chips) 
Seat 5: KingBiscuitT ($20.82 in chips) 
Seat 6: Enricola ($19.42 in chips) 
meirenxingde: posts small blind $0.05
jayzz6: posts big blind $0.10
*** HOLE CARDS ***
KingBiscuitT: folds 
Enricola: raises $0.25 to $0.35
father here: folds 
Tyoma_Kovach: calls $0.35
meirenxingde: folds 
jayzz6: calls $0.25
*** FLOP *** [Jd 6c 4s]
jayzz6: checks 
Enricola: bets $0.70
Tyoma_Kovach: folds 
jayzz6: calls $0.70
*** TURN *** [Jd 6c 4s] [Ad]
jayzz6: checks 
Enricola: bets $2
jayzz6: calls $2
*** RIVER *** [Jd 6c 4s Ad] [Th]
jayzz6: checks 
Enricola: bets $6.21
jayzz6: raises $2.21 to $8.42 and is all-in
Enricola: calls $2.21
*** SHOW DOWN ***
jayzz6: shows [Jh Ah] (two pair, Aces and Jacks)
Enricola: shows [Kh Qs] (a straight, Ten to Ace)
Enricola collected $22.29 from pot
*** SUMMARY ***
Total pot $23.34 | Rake $1.05 
Board [Jd 6c 4s Ad Th]
Seat 1: father here folded before Flop (didn't bet)
Seat 2: Tyoma_Kovach (button) folded on the Flop
Seat 3: meirenxingde (small blind) folded before Flop
Seat 4: jayzz6 (big blind) showed [Jh Ah] and lost with two pair, Aces and Jacks
Seat 5: KingBiscuitT folded before Flop (didn't bet)
Seat 6: Enricola showed [Kh Qs] and won ($22.29) with a straight, Ten to Ace



PokerStars Hand #222954914593:  Hold'em No Limit ($0.05/$0.10 USD) - 2021/01/23 9:20:39 ET
Table 'Saito II' 6-max Seat #4 is the button
Seat 1: ivan2772ms ($10.36 in chips) 
Seat 2: Tyoma_Kovach ($15.34 in chips) 
Seat 3: SERG244 ($20.30 in chips) 
Seat 4: vietor201 ($2.80 in chips) 
Seat 5: Willishoveandbb ($18.32 in chips) 
Seat 6: Jesus Ololo ($10.15 in chips) 
Willishoveandbb: posts small blind $0.05
Jesus Ololo: posts big blind $0.10
*** HOLE CARDS ***
ivan2772ms: folds 
Tyoma_Kovach: folds 
SERG244: folds 
vietor201: calls $0.10
Willishoveandbb: calls $0.05
Jesus Ololo: checks 
*** FLOP *** [2c Kd 8h]
Willishoveandbb: checks 
Jesus Ololo: checks 
vietor201: checks 
*** TURN *** [2c Kd 8h] [5h]
Willishoveandbb: bets $0.10
Jesus Ololo: folds 
vietor201: calls $0.10
*** RIVER *** [2c Kd 8h 5h] [9h]
Willishoveandbb: bets $0.10
vietor201: calls $0.10
*** SHOW DOWN ***
Willishoveandbb: shows [8s 7h] (a pair of Eights)
vietor201: mucks hand 
Willishoveandbb collected $0.67 from pot
*** SUMMARY ***
Total pot $0.70 | Rake $0.03 
Board [2c Kd 8h 5h 9h]
Seat 1: ivan2772ms folded before Flop (didn't bet)
Seat 2: Tyoma_Kovach folded before Flop (didn't bet)
Seat 3: SERG244 folded before Flop (didn't bet)
Seat 4: vietor201 (button) mucked
Seat 5: Willishoveandbb (small blind) showed [8s 7h] and won ($0.67) with a pair of Eights
Seat 6: Jesus Ololo (big blind) folded on the Turn



PokerStars Hand #222953165644:  Hold'em No Limit ($0.05/$0.10 USD) - 2021/01/23 8:16:22 ET
Table 'Saito II' 6-max Seat #3 is the button
Seat 1: father here ($11.30 in chips) 
Seat 2: Tyoma_Kovach ($10 in chips) 
Seat 3: meirenxingde ($9.85 in chips) 
Seat 4: jayzz6 ($10 in chips) 
Seat 5: KingBiscuitT ($20.82 in chips) 
Seat 6: Enricola ($30.24 in chips) 
jayzz6: posts small blind $0.05
KingBiscuitT: posts big blind $0.10
*** HOLE CARDS ***
Enricola: raises $0.25 to $0.35
father here: folds 
Tyoma_Kovach: raises $0.77 to $1.12
meirenxingde: folds 
jayzz6: folds 
KingBiscuitT: folds 
Enricola: calls $0.77
*** FLOP *** [As 7d 8d]
Enricola: checks 
Tyoma_Kovach: bets $0.75
Enricola: folds 
Uncalled bet ($0.75) returned to Tyoma_Kovach
Tyoma_Kovach collected $2.28 from pot
Tyoma_Kovach: doesn't show hand 
*** SUMMARY ***
Total pot $2.39 | Rake $0.11 
Board [As 7d 8d]
Seat 1: father here folded before Flop (didn't bet)
Seat 2: Tyoma_Kovach collected ($2.28)
Seat 3: meirenxingde (button) folded before Flop (didn't bet)
Seat 4: jayzz6 (small blind) folded before Flop
Seat 5: KingBiscuitT (big blind) folded before Flop
Seat 6: Enricola folded on the Flop



PokerStars Hand #222954925968:  Hold'em No Limit ($0.05/$0.10 USD) - 2021/01/23 9:21:02 ET
Table 'Saito II' 6-max Seat #5 is the button
Seat 1: ivan2772ms ($10.36 in chips) 
Seat 2: Tyoma_Kovach ($15.34 in chips) 
Seat 3: SERG244 ($20.30 in chips) 
Seat 4: vietor201 ($2.50 in chips) 
Seat 5: Willishoveandbb ($18.69 in chips) 
Seat 6: Jesus Ololo ($10.05 in chips) 
Jesus Ololo: posts small blind $0.05
ivan2772ms: posts big blind $0.10
*** HOLE CARDS ***
Tyoma_Kovach: folds 
SERG244: raises $0.16 to $0.26
vietor201: folds 
Willishoveandbb: folds 
Jesus Ololo: folds 
ivan2772ms: folds 
Uncalled bet ($0.16) returned to SERG244
SERG244 collected $0.25 from pot
SERG244: doesn't show hand 
*** SUMMARY ***
Total pot $0.25 | Rake $0 
Seat 1: ivan2772ms (big blind) folded before Flop
Seat 2: Tyoma_Kovach folded before Flop (didn't bet)
Seat 3: SERG244 collected ($0.25)
Seat 4: vietor201 folded before Flop (didn't bet)
Seat 5: Willishoveandbb (button) folded before Flop (didn't bet)
Seat 6: Jesus Ololo (small blind) folded before Flop



PokerStars Hand #222953176762:  Hold'em No Limit ($0.05/$0.10 USD) - 2021/01/23 8:16:49 ET
Table 'Saito II' 6-max Seat #4 is the button
Seat 1: father here ($11.30 in chips) 
Seat 2: Tyoma_Kovach ($11.16 in chips) 
Seat 3: meirenxingde ($9.85 in chips) 
Seat 4: jayzz6 ($10 in chips) 
Seat 5: KingBiscuitT ($20.72 in chips) 
Seat 6: Enricola ($29.12 in chips) 
KingBiscuitT: posts small blind $0.05
Enricola: posts big blind $0.10
*** HOLE CARDS ***
father here: folds 
Tyoma_Kovach: folds 
father here leaves the table
meirenxingde: raises $0.20 to $0.30
jayzz6: folds 
KingBiscuitT: folds 
Enricola: folds 
Uncalled bet ($0.20) returned to meirenxingde
meirenxingde collected $0.25 from pot
meirenxingde: doesn't show hand 
*** SUMMARY ***
Total pot $0.25 | Rake $0 
Seat 1: father here folded before Flop (didn't bet)
Seat 2: Tyoma_Kovach folded before Flop (didn't bet)
Seat 3: meirenxingde collected ($0.25)
Seat 4: jayzz6 (button) folded before Flop (didn't bet)
Seat 5: KingBiscuitT (small blind) folded before Flop
Seat 6: Enricola (big blind) folded before Flop



PokerStars Hand #222954930562:  Hold'em No Limit ($0.05/$0.10 USD) - 2021/01/23 9:21:11 ET
Table 'Saito II' 6-max Seat #6 is the button
Seat 1: ivan2772ms ($10.26 in chips) 
Seat 2: Tyoma_Kovach ($15.34 in chips) 
Seat 3: SERG244 ($20.45 in chips) 
Seat 4: vietor201 ($2.50 in chips) 
Seat 5: Willishoveandbb ($18.69 in chips) 
Seat 6: Jesus Ololo ($10 in chips) 
ivan2772ms: posts small blind $0.05
Tyoma_Kovach: posts big blind $0.10
*** HOLE CARDS ***
SERG244: folds 
vietor201: calls $0.10
Willishoveandbb: folds 
Jesus Ololo: folds 
ivan2772ms: folds 
Tyoma_Kovach: checks 
*** FLOP *** [Qd Td 4s]
Tyoma_Kovach: checks 
vietor201: checks 
*** TURN *** [Qd Td 4s] [Tc]
Tyoma_Kovach: checks 
vietor201: checks 
*** RIVER *** [Qd Td 4s Tc] [4h]
Tyoma_Kovach: checks 
vietor201: checks 
*** SHOW DOWN ***
Tyoma_Kovach: shows [5s Ac] (two pair, Tens and Fours)
vietor201: mucks hand 
Tyoma_Kovach collected $0.24 from pot
*** SUMMARY ***
Total pot $0.25 | Rake $0.01 
Board [Qd Td 4s Tc 4h]
Seat 1: ivan2772ms (small blind) folded before Flop
Seat 2: Tyoma_Kovach (big blind) showed [5s Ac] and won ($0.24) with two pair, Tens and Fours
Seat 3: SERG244 folded before Flop (didn't bet)
Seat 4: vietor201 mucked
Seat 5: Willishoveandbb folded before Flop (didn't bet)
Seat 6: Jesus Ololo (button) folded before Flop (didn't bet)



PokerStars Hand #222953180628:  Hold'em No Limit ($0.05/$0.10 USD) - 2021/01/23 8:16:58 ET
Table 'Saito II' 6-max Seat #5 is the button
Seat 2: Tyoma_Kovach ($11.16 in chips) 
Seat 3: meirenxingde ($10 in chips) 
Seat 4: jayzz6 ($10 in chips) 
Seat 5: KingBiscuitT ($20.67 in chips) 
Seat 6: Enricola ($29.02 in chips) 
Enricola: posts small blind $0.05
Tyoma_Kovach: posts big blind $0.10
*** HOLE CARDS ***
meirenxingde: folds 
jayzz6: raises $0.15 to $0.25
KingBiscuitT: folds 
Enricola: calls $0.20
Tyoma_Kovach: calls $0.15
*** FLOP *** [2d Qc Qs]
Enricola: checks 
Tyoma_Kovach: checks 
arissanel joins the table at seat #1 
jayzz6: checks 
*** TURN *** [2d Qc Qs] [As]
Enricola: checks 
Tyoma_Kovach: checks 
jayzz6: bets $0.40
Enricola: calls $0.40
Tyoma_Kovach: folds 
*** RIVER *** [2d Qc Qs As] [Ac]
Enricola: checks 
jayzz6: bets $0.90
Enricola: folds 
Uncalled bet ($0.90) returned to jayzz6
jayzz6 collected $1.48 from pot
jayzz6: doesn't show hand 
*** SUMMARY ***
Total pot $1.55 | Rake $0.07 
Board [2d Qc Qs As Ac]
Seat 2: Tyoma_Kovach (big blind) folded on the Turn
Seat 3: meirenxingde folded before Flop (didn't bet)
Seat 4: jayzz6 collected ($1.48)
Seat 5: KingBiscuitT (button) folded before Flop (didn't bet)
Seat 6: Enricola (small blind) folded on the River



PokerStars Hand #222954943331:  Hold'em No Limit ($0.05/$0.10 USD) - 2021/01/23 9:21:37 ET
Table 'Saito II' 6-max Seat #1 is the button
Seat 1: ivan2772ms ($10.21 in chips) 
Seat 2: Tyoma_Kovach ($15.48 in chips) 
Seat 3: SERG244 ($20.45 in chips) 
Seat 4: vietor201 ($2.40 in chips) 
Seat 5: Willishoveandbb ($18.69 in chips) 
Seat 6: Jesus Ololo ($10 in chips) 
Tyoma_Kovach: posts small blind $0.05
SERG244: posts big blind $0.10
*** HOLE CARDS ***
vietor201: raises $0.20 to $0.30
Willishoveandbb: folds 
Jesus Ololo: folds 
ivan2772ms: folds 
Tyoma_Kovach: folds 
SERG244: folds 
Uncalled bet ($0.20) returned to vietor201
vietor201 collected $0.25 from pot
vietor201: doesn't show hand 
*** SUMMARY ***
Total pot $0.25 | Rake $0 
Seat 1: ivan2772ms (button) folded before Flop (didn't bet)
Seat 2: Tyoma_Kovach (small blind) folded before Flop
Seat 3: SERG244 (big blind) folded before Flop
Seat 4: vietor201 collected ($0.25)
Seat 5: Willishoveandbb folded before Flop (didn't bet)
Seat 6: Jesus Ololo folded before Flop (didn't bet)



PokerStars Hand #222953199813:  Hold'em No Limit ($0.05/$0.10 USD) - 2021/01/23 8:17:44 ET
Table 'Saito II' 6-max Seat #6 is the button
Seat 2: Tyoma_Kovach ($10.91 in chips) 
Seat 3: meirenxingde ($10 in chips) 
Seat 4: jayzz6 ($10.83 in chips) 
Seat 5: KingBiscuitT ($20.67 in chips) 
Seat 6: Enricola ($28.37 in chips) 
Tyoma_Kovach: posts small blind $0.05
meirenxingde: posts big blind $0.10
*** HOLE CARDS ***
jayzz6: folds 
KingBiscuitT: folds 
Enricola: folds 
Tyoma_Kovach: folds 
Uncalled bet ($0.05) returned to meirenxingde
meirenxingde collected $0.10 from pot
meirenxingde: doesn't show hand 
*** SUMMARY ***
Total pot $0.10 | Rake $0 
Seat 2: Tyoma_Kovach (small blind) folded before Flop
Seat 3: meirenxingde (big blind) collected ($0.10)
Seat 4: jayzz6 folded before Flop (didn't bet)
Seat 5: KingBiscuitT folded before Flop (didn't bet)
Seat 6: Enricola (button) folded before Flop (didn't bet)



PokerStars Hand #222954950240:  Hold'em No Limit ($0.05/$0.10 USD) - 2021/01/23 9:21:50 ET
Table 'Saito II' 6-max Seat #2 is the button
Seat 1: ivan2772ms ($10.21 in chips) 
Seat 2: Tyoma_Kovach ($15.43 in chips) 
Seat 3: SERG244 ($20.35 in chips) 
Seat 4: vietor201 ($2.55 in chips) 
Seat 5: Willishoveandbb ($18.69 in chips) 
Seat 6: Jesus Ololo ($10 in chips) 
SERG244: posts small blind $0.05
vietor201: posts big blind $0.10
*** HOLE CARDS ***
Willishoveandbb: raises $0.15 to $0.25
Jesus Ololo: folds 
ivan2772ms: folds 
Tyoma_Kovach: folds 
SERG244: raises $0.68 to $0.93
vietor201: folds 
Willishoveandbb: folds 
Uncalled bet ($0.68) returned to SERG244
SERG244 collected $0.60 from pot
SERG244: doesn't show hand 
*** SUMMARY ***
Total pot $0.60 | Rake $0 
Seat 1: ivan2772ms folded before Flop (didn't bet)
Seat 2: Tyoma_Kovach (button) folded before Flop (didn't bet)
Seat 3: SERG244 (small blind) collected ($0.60)
Seat 4: vietor201 (big blind) folded before Flop
Seat 5: Willishoveandbb folded before Flop
Seat 6: Jesus Ololo folded before Flop (didn't bet)



PokerStars Hand #222953204090:  Hold'em No Limit ($0.05/$0.10 USD) - 2021/01/23 8:17:54 ET
Table 'Saito II' 6-max Seat #2 is the button
Seat 1: arissanel ($10 in chips) 
Seat 2: Tyoma_Kovach ($10.86 in chips) 
Seat 3: meirenxingde ($10.05 in chips) 
Seat 4: jayzz6 ($10.83 in chips) 
Seat 5: KingBiscuitT ($20.67 in chips) 
Seat 6: Enricola ($28.37 in chips) 
meirenxingde: posts small blind $0.05
jayzz6: posts big blind $0.10
arissanel: posts big blind $0.10
*** HOLE CARDS ***
KingBiscuitT: folds 
Enricola: folds 
arissanel: checks 
Tyoma_Kovach: raises $0.35 to $0.45
meirenxingde: folds 
jayzz6: folds 
arissanel: folds 
Uncalled bet ($0.35) returned to Tyoma_Kovach
Tyoma_Kovach collected $0.35 from pot
Tyoma_Kovach: doesn't show hand 
*** SUMMARY ***
Total pot $0.35 | Rake $0 
Seat 1: arissanel folded before Flop (didn't bet)
Seat 2: Tyoma_Kovach (button) collected ($0.35)
Seat 3: meirenxingde (small blind) folded before Flop
Seat 4: jayzz6 (big blind) folded before Flop
Seat 5: KingBiscuitT folded before Flop (didn't bet)
Seat 6: Enricola folded before Flop (didn't bet)



PokerStars Hand #222954959079:  Hold'em No Limit ($0.05/$0.10 USD) - 2021/01/23 9:22:08 ET
Table 'Saito II' 6-max Seat #3 is the button
Seat 1: ivan2772ms ($10.21 in chips) 
Seat 2: Tyoma_Kovach ($15.43 in chips) 
Seat 3: SERG244 ($20.70 in chips) 
Seat 4: vietor201 ($2.45 in chips) 
Seat 5: Willishoveandbb ($18.44 in chips) 
Seat 6: Jesus Ololo ($10 in chips) 
vietor201: posts small blind $0.05
Willishoveandbb: posts big blind $0.10
*** HOLE CARDS ***
Jesus Ololo: folds 
ivan2772ms: raises $0.20 to $0.30
Tyoma_Kovach: folds 
SERG244: folds 
vietor201: folds 
Willishoveandbb: calls $0.20
*** FLOP *** [Js 9d Ks]
Willishoveandbb: checks 
ivan2772ms: bets $0.20
Willishoveandbb: folds 
Uncalled bet ($0.20) returned to ivan2772ms
ivan2772ms collected $0.62 from pot
ivan2772ms: doesn't show hand 
*** SUMMARY ***
Total pot $0.65 | Rake $0.03 
Board [Js 9d Ks]
Seat 1: ivan2772ms collected ($0.62)
Seat 2: Tyoma_Kovach folded before Flop (didn't bet)
Seat 3: SERG244 (button) folded before Flop (didn't bet)
Seat 4: vietor201 (small blind) folded before Flop
Seat 5: Willishoveandbb (big blind) folded on the Flop
Seat 6: Jesus Ololo folded before Flop (didn't bet)



PokerStars Hand #222954970846:  Hold'em No Limit ($0.05/$0.10 USD) - 2021/01/23 9:22:31 ET
Table 'Saito II' 6-max Seat #4 is the button
Seat 1: ivan2772ms ($10.53 in chips) 
Seat 2: Tyoma_Kovach ($15.43 in chips) 
Seat 3: SERG244 ($20.70 in chips) 
Seat 4: vietor201 ($2.40 in chips) 
Seat 5: Willishoveandbb ($18.14 in chips) 
Seat 6: Jesus Ololo ($10 in chips) 
Willishoveandbb: posts small blind $0.05
Jesus Ololo: posts big blind $0.10
*** HOLE CARDS ***
ivan2772ms: raises $0.20 to $0.30
Tyoma_Kovach: folds 
SERG244: folds 
vietor201: folds 
Willishoveandbb: raises $0.90 to $1.20
Jesus Ololo: folds 
ivan2772ms: calls $0.90
*** FLOP *** [8d 5d 9c]
Willishoveandbb: bets $2.84
ivan2772ms: folds 
Uncalled bet ($2.84) returned to Willishoveandbb
Willishoveandbb collected $2.39 from pot
*** SUMMARY ***
Total pot $2.50 | Rake $0.11 
Board [8d 5d 9c]
Seat 1: ivan2772ms folded on the Flop
Seat 2: Tyoma_Kovach folded before Flop (didn't bet)
Seat 3: SERG244 folded before Flop (didn't bet)
Seat 4: vietor201 (button) folded before Flop (didn't bet)
Seat 5: Willishoveandbb (small blind) collected ($2.39)
Seat 6: Jesus Ololo (big blind) folded before Flop



PokerStars Hand #222953212832:  Hold'em No Limit ($0.05/$0.10 USD) - 2021/01/23 8:18:15 ET
Table 'Saito II' 6-max Seat #3 is the button
Seat 1: arissanel ($10 in chips) 
Seat 2: Tyoma_Kovach ($11.11 in chips) 
Seat 3: meirenxingde ($10 in chips) 
Seat 4: jayzz6 ($10.73 in chips) 
Seat 5: KingBiscuitT ($20.67 in chips) 
Seat 6: Enricola ($28.37 in chips) 
jayzz6: posts small blind $0.05
KingBiscuitT: posts big blind $0.10
*** HOLE CARDS ***
Enricola: folds 
arissanel: folds 
Tyoma_Kovach: folds 
meirenxingde: raises $0.20 to $0.30
jayzz6: raises $0.90 to $1.20
KingBiscuitT: folds 
meirenxingde: calls $0.90
*** FLOP *** [4c Ah 7c]
jayzz6: bets $1.10
meirenxingde: raises $2 to $3.10
jayzz6: folds 
Uncalled bet ($2) returned to meirenxingde
meirenxingde collected $4.49 from pot
meirenxingde: doesn't show hand 
*** SUMMARY ***
Total pot $4.70 | Rake $0.21 
Board [4c Ah 7c]
Seat 1: arissanel folded before Flop (didn't bet)
Seat 2: Tyoma_Kovach folded before Flop (didn't bet)
Seat 3: meirenxingde (button) collected ($4.49)
Seat 4: jayzz6 (small blind) folded on the Flop
Seat 5: KingBiscuitT (big blind) folded before Flop
Seat 6: Enricola folded before Flop (didn't bet)



PokerStars Hand #222953233843:  Hold'em No Limit ($0.05/$0.10 USD) - 2021/01/23 8:19:04 ET
Table 'Saito II' 6-max Seat #4 is the button
Seat 1: arissanel ($10 in chips) 
Seat 2: Tyoma_Kovach ($11.11 in chips) 
Seat 3: meirenxingde ($12.19 in chips) 
Seat 4: jayzz6 ($10 in chips) 
Seat 5: KingBiscuitT ($20.57 in chips) 
Seat 6: Enricola ($28.37 in chips) 
KingBiscuitT: posts small blind $0.05
Enricola: posts big blind $0.10
*** HOLE CARDS ***
arissanel: raises $0.15 to $0.25
Tyoma_Kovach: folds 
meirenxingde: folds 
jayzz6: folds 
KingBiscuitT: folds 
Enricola: raises $0.55 to $0.80
arissanel: calls $0.55
*** FLOP *** [6d 9d Th]
Enricola: bets $0.90
arissanel: folds 
Uncalled bet ($0.90) returned to Enricola
Enricola collected $1.58 from pot
Enricola: doesn't show hand 
*** SUMMARY ***
Total pot $1.65 | Rake $0.07 
Board [6d 9d Th]
Seat 1: arissanel folded on the Flop
Seat 2: Tyoma_Kovach folded before Flop (didn't bet)
Seat 3: meirenxingde folded before Flop (didn't bet)
Seat 4: jayzz6 (button) folded before Flop (didn't bet)
Seat 5: KingBiscuitT (small blind) folded before Flop
Seat 6: Enricola (big blind) collected ($1.58)



PokerStars Hand #222954985812:  Hold'em No Limit ($0.05/$0.10 USD) - 2021/01/23 9:23:01 ET
Table 'Saito II' 6-max Seat #5 is the button
Seat 1: ivan2772ms ($10 in chips) 
Seat 2: Tyoma_Kovach ($15.43 in chips) 
Seat 3: SERG244 ($20.70 in chips) 
Seat 4: vietor201 ($2.40 in chips) 
Seat 5: Willishoveandbb ($19.33 in chips) 
Seat 6: Jesus Ololo ($10 in chips) 
Jesus Ololo: posts small blind $0.05
ivan2772ms: posts big blind $0.10
*** HOLE CARDS ***
Tyoma_Kovach: folds 
SERG244: folds 
vietor201: folds 
Willishoveandbb: folds 
Jesus Ololo: folds 
Uncalled bet ($0.05) returned to ivan2772ms
ivan2772ms collected $0.10 from pot
ivan2772ms: doesn't show hand 
*** SUMMARY ***
Total pot $0.10 | Rake $0 
Seat 1: ivan2772ms (big blind) collected ($0.10)
Seat 2: Tyoma_Kovach folded before Flop (didn't bet)
Seat 3: SERG244 folded before Flop (didn't bet)
Seat 4: vietor201 folded before Flop (didn't bet)
Seat 5: Willishoveandbb (button) folded before Flop (didn't bet)
Seat 6: Jesus Ololo (small blind) folded before Flop



PokerStars Hand #222953245418:  Hold'em No Limit ($0.05/$0.10 USD) - 2021/01/23 8:19:32 ET
Table 'Saito II' 6-max Seat #5 is the button
Seat 1: arissanel ($10 in chips) 
Seat 2: Tyoma_Kovach ($11.11 in chips) 
Seat 3: meirenxingde ($12.19 in chips) 
Seat 4: jayzz6 ($10 in chips) 
Seat 5: KingBiscuitT ($20.52 in chips) 
Seat 6: Enricola ($29.15 in chips) 
Enricola: posts small blind $0.05
arissanel: posts big blind $0.10
*** HOLE CARDS ***
Tyoma_Kovach: folds 
meirenxingde: folds 
jayzz6: raises $0.15 to $0.25
KingBiscuitT: folds 
Enricola: folds 
arissanel: folds 
Uncalled bet ($0.15) returned to jayzz6
jayzz6 collected $0.25 from pot
jayzz6: doesn't show hand 
*** SUMMARY ***
Total pot $0.25 | Rake $0 
Seat 1: arissanel (big blind) folded before Flop
Seat 2: Tyoma_Kovach folded before Flop (didn't bet)
Seat 3: meirenxingde folded before Flop (didn't bet)
Seat 4: jayzz6 collected ($0.25)
Seat 5: KingBiscuitT (button) folded before Flop (didn't bet)
Seat 6: Enricola (small blind) folded before Flop



PokerStars Hand #222954991012:  Hold'em No Limit ($0.05/$0.10 USD) - 2021/01/23 9:23:11 ET
Table 'Saito II' 6-max Seat #6 is the button
Seat 1: ivan2772ms ($10.05 in chips) 
Seat 2: Tyoma_Kovach ($15.43 in chips) 
Seat 3: SERG244 ($20.70 in chips) 
Seat 4: vietor201 ($2.40 in chips) 
Seat 5: Willishoveandbb ($19.33 in chips) 
Seat 6: Jesus Ololo ($10 in chips) 
ivan2772ms: posts small blind $0.05
Tyoma_Kovach: posts big blind $0.10
*** HOLE CARDS ***
SERG244: folds 
vietor201: folds 
Willishoveandbb: folds 
Jesus Ololo: folds 
ivan2772ms: raises $0.20 to $0.30
Tyoma_Kovach: calls $0.20
*** FLOP *** [Ah 5c Qd]
ivan2772ms: bets $0.17
Tyoma_Kovach: calls $0.17
*** TURN *** [Ah 5c Qd] [Jd]
ivan2772ms: checks 
Tyoma_Kovach: checks 
*** RIVER *** [Ah 5c Qd Jd] [4h]
ivan2772ms: checks 
Tyoma_Kovach: checks 
*** SHOW DOWN ***
ivan2772ms: shows [3c 3s] (a pair of Threes)
Tyoma_Kovach: shows [7h 5h] (a pair of Fives)
Tyoma_Kovach collected $0.90 from pot
*** SUMMARY ***
Total pot $0.94 | Rake $0.04 
Board [Ah 5c Qd Jd 4h]
Seat 1: ivan2772ms (small blind) showed [3c 3s] and lost with a pair of Threes
Seat 2: Tyoma_Kovach (big blind) showed [7h 5h] and won ($0.90) with a pair of Fives
Seat 3: SERG244 folded before Flop (didn't bet)
Seat 4: vietor201 folded before Flop (didn't bet)
Seat 5: Willishoveandbb folded before Flop (didn't bet)
Seat 6: Jesus Ololo (button) folded before Flop (didn't bet)



PokerStars Hand #222953251021:  Hold'em No Limit ($0.05/$0.10 USD) - 2021/01/23 8:19:46 ET
Table 'Saito II' 6-max Seat #6 is the button
Seat 1: arissanel ($10 in chips) 
Seat 2: Tyoma_Kovach ($11.11 in chips) 
Seat 3: meirenxingde ($12.19 in chips) 
Seat 4: jayzz6 ($10.15 in chips) 
Seat 5: KingBiscuitT ($20.52 in chips) 
Seat 6: Enricola ($29.10 in chips) 
arissanel: posts small blind $0.05
Tyoma_Kovach: posts big blind $0.10
*** HOLE CARDS ***
meirenxingde: raises $0.20 to $0.30
jayzz6: folds 
KingBiscuitT: calls $0.30
Enricola: folds 
arissanel: folds 
Tyoma_Kovach: folds 
*** FLOP *** [7h 6h 3c]
meirenxingde: checks 
KingBiscuitT: checks 
*** TURN *** [7h 6h 3c] [As]
meirenxingde: bets $0.36
KingBiscuitT: folds 
Uncalled bet ($0.36) returned to meirenxingde
meirenxingde collected $0.72 from pot
meirenxingde: doesn't show hand 
*** SUMMARY ***
Total pot $0.75 | Rake $0.03 
Board [7h 6h 3c As]
Seat 1: arissanel (small blind) folded before Flop
Seat 2: Tyoma_Kovach (big blind) folded before Flop
Seat 3: meirenxingde collected ($0.72)
Seat 4: jayzz6 folded before Flop (didn't bet)
Seat 5: KingBiscuitT folded on the Turn
Seat 6: Enricola (button) folded before Flop (didn't bet)



PokerStars Hand #222955008109:  Hold'em No Limit ($0.05/$0.10 USD) - 2021/01/23 9:23:46 ET
Table 'Saito II' 6-max Seat #1 is the button
Seat 1: ivan2772ms ($10 in chips) 
Seat 2: Tyoma_Kovach ($15.86 in chips) 
Seat 4: vietor201 ($2.40 in chips) 
Seat 5: Willishoveandbb ($19.33 in chips) 
Seat 6: Jesus Ololo ($10 in chips) 
Tyoma_Kovach: posts small blind $0.05
SERG244: is sitting out 
vietor201: posts big blind $0.10
*** HOLE CARDS ***
Willishoveandbb: folds 
SERG244 leaves the table
Jesus Ololo: raises $0.15 to $0.25
crankthatsoulja joins the table at seat #3 
ivan2772ms: folds 
Tyoma_Kovach: folds 
vietor201: calls $0.15
*** FLOP *** [4s 7s Qs]
vietor201: bets $0.53
Jesus Ololo: raises $2.17 to $2.70
vietor201: calls $1.62 and is all-in
Uncalled bet ($0.55) returned to Jesus Ololo
*** TURN *** [4s 7s Qs] [Kh]
*** RIVER *** [4s 7s Qs Kh] [Ah]
*** SHOW DOWN ***
vietor201: shows [Qd 2d] (a pair of Queens)
Jesus Ololo: shows [Ad Qc] (two pair, Aces and Queens)
Jesus Ololo collected $4.63 from pot
*** SUMMARY ***
Total pot $4.85 | Rake $0.22 
Board [4s 7s Qs Kh Ah]
Seat 1: ivan2772ms (button) folded before Flop (didn't bet)
Seat 2: Tyoma_Kovach (small blind) folded before Flop
Seat 4: vietor201 (big blind) showed [Qd 2d] and lost with a pair of Queens
Seat 5: Willishoveandbb folded before Flop (didn't bet)
Seat 6: Jesus Ololo showed [Ad Qc] and won ($4.63) with two pair, Aces and Queens



PokerStars Hand #222953269174:  Hold'em No Limit ($0.05/$0.10 USD) - 2021/01/23 8:20:28 ET
Table 'Saito II' 6-max Seat #1 is the button
Seat 1: arissanel ($10 in chips) 
Seat 2: Tyoma_Kovach ($11.01 in chips) 
Seat 3: meirenxingde ($12.61 in chips) 
Seat 4: jayzz6 ($10.15 in chips) 
Seat 5: KingBiscuitT ($20.22 in chips) 
Seat 6: Enricola ($29.10 in chips) 
Tyoma_Kovach: posts small blind $0.05
meirenxingde: posts big blind $0.10
*** HOLE CARDS ***
jayzz6: folds 
KingBiscuitT: raises $0.12 to $0.22
Enricola: folds 
arissanel: folds 
Tyoma_Kovach: folds 
meirenxingde: folds 
Uncalled bet ($0.12) returned to KingBiscuitT
KingBiscuitT collected $0.25 from pot
KingBiscuitT: doesn't show hand 
*** SUMMARY ***
Total pot $0.25 | Rake $0 
Seat 1: arissanel (button) folded before Flop (didn't bet)
Seat 2: Tyoma_Kovach (small blind) folded before Flop
Seat 3: meirenxingde (big blind) folded before Flop
Seat 4: jayzz6 folded before Flop (didn't bet)
Seat 5: KingBiscuitT collected ($0.25)
Seat 6: Enricola folded before Flop (didn't bet)



PokerStars Hand #222955028725:  Hold'em No Limit ($0.05/$0.10 USD) - 2021/01/23 9:24:27 ET
Table 'Saito II' 6-max Seat #2 is the button
Seat 1: ivan2772ms ($10 in chips) 
Seat 2: Tyoma_Kovach ($15.81 in chips) 
Seat 5: Willishoveandbb ($19.33 in chips) 
Seat 6: Jesus Ololo ($12.23 in chips) 
Willishoveandbb: posts small blind $0.05
Jesus Ololo: posts big blind $0.10
*** HOLE CARDS ***
ivan2772ms: folds 
Tyoma_Kovach: raises $0.15 to $0.25
vietor201 leaves the table
Willishoveandbb: folds 
Jesus Ololo: folds 
Uncalled bet ($0.15) returned to Tyoma_Kovach
Tyoma_Kovach collected $0.25 from pot
Tyoma_Kovach: doesn't show hand 
*** SUMMARY ***
Total pot $0.25 | Rake $0 
Seat 1: ivan2772ms folded before Flop (didn't bet)
Seat 2: Tyoma_Kovach (button) collected ($0.25)
Seat 5: Willishoveandbb (small blind) folded before Flop
Seat 6: Jesus Ololo (big blind) folded before Flop



PokerStars Hand #222953277796:  Hold'em No Limit ($0.05/$0.10 USD) - 2021/01/23 8:20:48 ET
Table 'Saito II' 6-max Seat #2 is the button
Seat 1: arissanel ($10 in chips) 
Seat 2: Tyoma_Kovach ($10.96 in chips) 
Seat 3: meirenxingde ($12.51 in chips) 
Seat 4: jayzz6 ($10.15 in chips) 
Seat 5: KingBiscuitT ($20.37 in chips) 
Seat 6: Enricola ($29.10 in chips) 
meirenxingde: posts small blind $0.05
jayzz6: posts big blind $0.10
*** HOLE CARDS ***
KingBiscuitT: folds 
Enricola: folds 
arissanel: raises $0.15 to $0.25
Tyoma_Kovach: folds 
meirenxingde: calls $0.20
jayzz6: calls $0.15
*** FLOP *** [Kc Ac 9h]
meirenxingde: checks 
jayzz6: checks 
arissanel: checks 
*** TURN *** [Kc Ac 9h] [6h]
meirenxingde: checks 
jayzz6: checks 
arissanel: checks 
*** RIVER *** [Kc Ac 9h 6h] [4d]
meirenxingde: checks 
jayzz6: bets $0.50
arissanel: folds 
meirenxingde: folds 
Uncalled bet ($0.50) returned to jayzz6
jayzz6 collected $0.72 from pot
jayzz6: doesn't show hand 
*** SUMMARY ***
Total pot $0.75 | Rake $0.03 
Board [Kc Ac 9h 6h 4d]
Seat 1: arissanel folded on the River
Seat 2: Tyoma_Kovach (button) folded before Flop (didn't bet)
Seat 3: meirenxingde (small blind) folded on the River
Seat 4: jayzz6 (big blind) collected ($0.72)
Seat 5: KingBiscuitT folded before Flop (didn't bet)
Seat 6: Enricola folded before Flop (didn't bet)



PokerStars Hand #222955033405:  Hold'em No Limit ($0.05/$0.10 USD) - 2021/01/23 9:24:37 ET
Table 'Saito II' 6-max Seat #5 is the button
Seat 2: Tyoma_Kovach ($15.96 in chips) 
Seat 3: crankthatsoulja ($5 in chips) 
Seat 5: Willishoveandbb ($19.28 in chips) 
Seat 6: Jesus Ololo ($12.13 in chips) 
Jesus Ololo: posts small blind $0.05
Tyoma_Kovach: posts big blind $0.10
crankthatsoulja: posts big blind $0.10
*** HOLE CARDS ***
crankthatsoulja: checks 
Willishoveandbb: folds 
ivan2772ms leaves the table
Smithers-Jones joins the table at seat #4 
Jesus Ololo: folds 
Tyoma_Kovach: checks 
*** FLOP *** [4s 6c 6d]
Tyoma_Kovach: checks 
crankthatsoulja: bets $0.40
omarcho9300 joins the table at seat #1 
Tyoma_Kovach: folds 
Uncalled bet ($0.40) returned to crankthatsoulja
crankthatsoulja collected $0.24 from pot
crankthatsoulja: doesn't show hand 
*** SUMMARY ***
Total pot $0.25 | Rake $0.01 
Board [4s 6c 6d]
Seat 2: Tyoma_Kovach (big blind) folded on the Flop
Seat 3: crankthatsoulja collected ($0.24)
Seat 5: Willishoveandbb (button) folded before Flop (didn't bet)
Seat 6: Jesus Ololo (small blind) folded before Flop



PokerStars Hand #222953299844:  Hold'em No Limit ($0.05/$0.10 USD) - 2021/01/23 8:21:39 ET
Table 'Saito II' 6-max Seat #3 is the button
Seat 1: arissanel ($10 in chips) 
Seat 2: Tyoma_Kovach ($10.96 in chips) 
Seat 3: meirenxingde ($12.26 in chips) 
Seat 4: jayzz6 ($10.62 in chips) 
Seat 5: KingBiscuitT ($20.37 in chips) 
Seat 6: Enricola ($29.10 in chips) 
jayzz6: posts small blind $0.05
KingBiscuitT: posts big blind $0.10
*** HOLE CARDS ***
Enricola: raises $0.25 to $0.35
arissanel: folds 
Tyoma_Kovach: folds 
meirenxingde: calls $0.35
jayzz6: folds 
KingBiscuitT: calls $0.25
*** FLOP *** [5h Ad 5d]
KingBiscuitT: checks 
Enricola: bets $0.70
meirenxingde: calls $0.70
KingBiscuitT: folds 
*** TURN *** [5h Ad 5d] [2s]
Enricola: bets $2.39
meirenxingde: calls $2.39
*** RIVER *** [5h Ad 5d 2s] [4h]
Enricola: checks 
meirenxingde: bets $3.48
Enricola: folds 
Uncalled bet ($3.48) returned to meirenxingde
meirenxingde collected $6.95 from pot
meirenxingde: doesn't show hand 
*** SUMMARY ***
Total pot $7.28 | Rake $0.33 
Board [5h Ad 5d 2s 4h]
Seat 1: arissanel folded before Flop (didn't bet)
Seat 2: Tyoma_Kovach folded before Flop (didn't bet)
Seat 3: meirenxingde (button) collected ($6.95)
Seat 4: jayzz6 (small blind) folded before Flop
Seat 5: KingBiscuitT (big blind) folded on the Flop
Seat 6: Enricola folded on the River



PokerStars Hand #222955041983:  Hold'em No Limit ($0.05/$0.10 USD) - 2021/01/23 9:24:54 ET
Table 'Saito II' 6-max Seat #6 is the button
Seat 2: Tyoma_Kovach ($15.86 in chips) 
Seat 3: crankthatsoulja ($5.14 in chips) 
Seat 5: Willishoveandbb ($19.28 in chips) 
Seat 6: Jesus Ololo ($12.08 in chips) 
Tyoma_Kovach: posts small blind $0.05
crankthatsoulja: posts big blind $0.10
Smithers-Jones: sits out 
*** HOLE CARDS ***
Willishoveandbb: folds 
Jesus Ololo: folds 
Tyoma_Kovach: folds 
Uncalled bet ($0.05) returned to crankthatsoulja
crankthatsoulja collected $0.10 from pot
crankthatsoulja: doesn't show hand 
*** SUMMARY ***
Total pot $0.10 | Rake $0 
Seat 2: Tyoma_Kovach (small blind) folded before Flop
Seat 3: crankthatsoulja (big blind) collected ($0.10)
Seat 5: Willishoveandbb folded before Flop (didn't bet)
Seat 6: Jesus Ololo (button) folded before Flop (didn't bet)



PokerStars Hand #222955045634:  Hold'em No Limit ($0.05/$0.10 USD) - 2021/01/23 9:25:02 ET
Table 'Saito II' 6-max Seat #2 is the button
Seat 2: Tyoma_Kovach ($15.81 in chips) 
Seat 3: crankthatsoulja ($5.19 in chips) 
Seat 4: Smithers-Jones ($10 in chips) 
Seat 5: Willishoveandbb ($19.28 in chips) 
Seat 6: Jesus Ololo ($12.08 in chips) 
crankthatsoulja: posts small blind $0.05
Smithers-Jones: posts big blind $0.10
omarcho9300: sits out 
*** HOLE CARDS ***
Willishoveandbb: raises $0.15 to $0.25
Jesus Ololo: folds 
Tyoma_Kovach: folds 
crankthatsoulja: folds 
Smithers-Jones: folds 
Uncalled bet ($0.15) returned to Willishoveandbb
Willishoveandbb collected $0.25 from pot
*** SUMMARY ***
Total pot $0.25 | Rake $0 
Seat 2: Tyoma_Kovach (button) folded before Flop (didn't bet)
Seat 3: crankthatsoulja (small blind) folded before Flop
Seat 4: Smithers-Jones (big blind) folded before Flop
Seat 5: Willishoveandbb collected ($0.25)
Seat 6: Jesus Ololo folded before Flop (didn't bet)



PokerStars Hand #222955051933:  Hold'em No Limit ($0.05/$0.10 USD) - 2021/01/23 9:25:14 ET
Table 'Saito II' 6-max Seat #3 is the button
Seat 1: omarcho9300 ($10 in chips) 
Seat 2: Tyoma_Kovach ($15.81 in chips) 
Seat 3: crankthatsoulja ($5.14 in chips) 
Seat 4: Smithers-Jones ($9.90 in chips) 
Smithers-Jones: posts small blind $0.05
Willishoveandbb: is sitting out 
Jesus Ololo: is sitting out 
omarcho9300: posts big blind $0.10
*** HOLE CARDS ***
Tyoma_Kovach: folds 
crankthatsoulja: folds 
Smithers-Jones: calls $0.05
omarcho9300: checks 
*** FLOP *** [7c 5d 2h]
Smithers-Jones: bets $0.10
omarcho9300: calls $0.10
*** TURN *** [7c 5d 2h] [Jh]
Smithers-Jones: bets $0.10
omarcho9300: calls $0.10
*** RIVER *** [7c 5d 2h Jh] [3d]
Smithers-Jones: checks 
omarcho9300: checks 
*** SHOW DOWN ***
Smithers-Jones: shows [2c Ad] (a pair of Deuces)
omarcho9300: shows [3h 2s] (two pair, Threes and Deuces)
omarcho9300 collected $0.57 from pot
*** SUMMARY ***
Total pot $0.60 | Rake $0.03 
Board [7c 5d 2h Jh 3d]
Seat 1: omarcho9300 (big blind) showed [3h 2s] and won ($0.57) with two pair, Threes and Deuces
Seat 2: Tyoma_Kovach folded before Flop (didn't bet)
Seat 3: crankthatsoulja (button) folded before Flop (didn't bet)
Seat 4: Smithers-Jones (small blind) showed [2c Ad] and lost with a pair of Deuces



PokerStars Hand #222955074171:  Hold'em No Limit ($0.05/$0.10 USD) - 2021/01/23 9:25:59 ET
Table 'Saito II' 6-max Seat #4 is the button
Seat 1: omarcho9300 ($10.27 in chips) 
Seat 2: Tyoma_Kovach ($15.81 in chips) 
Seat 3: crankthatsoulja ($5.14 in chips) 
Seat 4: Smithers-Jones ($9.60 in chips) 
omarcho9300: posts small blind $0.05
Tyoma_Kovach: posts big blind $0.10
*** HOLE CARDS ***
crankthatsoulja: calls $0.10
Smithers-Jones: folds 
omarcho9300: raises $0.40 to $0.50
Tyoma_Kovach: folds 
crankthatsoulja: folds 
Uncalled bet ($0.40) returned to omarcho9300
omarcho9300 collected $0.30 from pot
omarcho9300: doesn't show hand 
*** SUMMARY ***
Total pot $0.30 | Rake $0 
Seat 1: omarcho9300 (small blind) collected ($0.30)
Seat 2: Tyoma_Kovach (big blind) folded before Flop
Seat 3: crankthatsoulja folded before Flop
Seat 4: Smithers-Jones (button) folded before Flop (didn't bet)



PokerStars Hand #222955086780:  Hold'em No Limit ($0.05/$0.10 USD) - 2021/01/23 9:26:25 ET
Table 'Saito II' 6-max Seat #1 is the button
Seat 1: omarcho9300 ($10.47 in chips) 
Seat 2: Tyoma_Kovach ($15.71 in chips) 
Seat 3: crankthatsoulja ($5.04 in chips) 
Seat 4: Smithers-Jones ($9.60 in chips) 
Tyoma_Kovach: posts small blind $0.05
crankthatsoulja: posts big blind $0.10
*** HOLE CARDS ***
Smithers-Jones: folds 
omarcho9300: folds 
Tyoma_Kovach: folds 
Uncalled bet ($0.05) returned to crankthatsoulja
crankthatsoulja collected $0.10 from pot
crankthatsoulja: doesn't show hand 
*** SUMMARY ***
Total pot $0.10 | Rake $0 
Seat 1: omarcho9300 (button) folded before Flop (didn't bet)
Seat 2: Tyoma_Kovach (small blind) folded before Flop
Seat 3: crankthatsoulja (big blind) collected ($0.10)
Seat 4: Smithers-Jones folded before Flop (didn't bet)



PokerStars Hand #222955089568:  Hold'em No Limit ($0.05/$0.10 USD) - 2021/01/23 9:26:31 ET
Table 'Saito II' 6-max Seat #2 is the button
Seat 1: omarcho9300 ($10.47 in chips) 
Seat 2: Tyoma_Kovach ($15.66 in chips) 
Seat 3: crankthatsoulja ($5.09 in chips) 
Seat 4: Smithers-Jones ($9.60 in chips) 
crankthatsoulja: posts small blind $0.05
Smithers-Jones: posts big blind $0.10
*** HOLE CARDS ***
omarcho9300: raises $0.20 to $0.30
Tyoma_Kovach: folds 
crankthatsoulja: folds 
Smithers-Jones: folds 
Uncalled bet ($0.20) returned to omarcho9300
omarcho9300 collected $0.25 from pot
omarcho9300: doesn't show hand 
*** SUMMARY ***
Total pot $0.25 | Rake $0 
Seat 1: omarcho9300 collected ($0.25)
Seat 2: Tyoma_Kovach (button) folded before Flop (didn't bet)
Seat 3: crankthatsoulja (small blind) folded before Flop
Seat 4: Smithers-Jones (big blind) folded before Flop



PokerStars Hand #222955094716:  Hold'em No Limit ($0.05/$0.10 USD) - 2021/01/23 9:26:41 ET
Table 'Saito II' 6-max Seat #3 is the button
Seat 1: omarcho9300 ($10.62 in chips) 
Seat 2: Tyoma_Kovach ($15.66 in chips) 
Seat 3: crankthatsoulja ($5.04 in chips) 
Seat 4: Smithers-Jones ($9.50 in chips) 
Smithers-Jones: posts small blind $0.05
omarcho9300: posts big blind $0.10
*** HOLE CARDS ***
Tyoma_Kovach: folds 
crankthatsoulja: folds 
Smithers-Jones: calls $0.05
omarcho9300: checks 
*** FLOP *** [Kc 6d Qd]
Smithers-Jones: checks 
omarcho9300: checks 
*** TURN *** [Kc 6d Qd] [Qs]
Smithers-Jones: bets $0.10
omarcho9300: folds 
Uncalled bet ($0.10) returned to Smithers-Jones
Smithers-Jones collected $0.19 from pot
*** SUMMARY ***
Total pot $0.20 | Rake $0.01 
Board [Kc 6d Qd Qs]
Seat 1: omarcho9300 (big blind) folded on the Turn
Seat 2: Tyoma_Kovach folded before Flop (didn't bet)
Seat 3: crankthatsoulja (button) folded before Flop (didn't bet)
Seat 4: Smithers-Jones (small blind) collected ($0.19)



PokerStars Hand #222955113229:  Hold'em No Limit ($0.05/$0.10 USD) - 2021/01/23 9:27:19 ET
Table 'Saito II' 6-max Seat #4 is the button
Seat 1: omarcho9300 ($10.52 in chips) 
Seat 2: Tyoma_Kovach ($15.66 in chips) 
Seat 3: crankthatsoulja ($5.04 in chips) 
Seat 4: Smithers-Jones ($9.59 in chips) 
omarcho9300: posts small blind $0.05
Tyoma_Kovach: posts big blind $0.10
*** HOLE CARDS ***
crankthatsoulja: folds 
Smithers-Jones: calls $0.10
omarcho9300: folds 
Tyoma_Kovach: checks 
*** FLOP *** [3d 2h 9c]
Tyoma_Kovach: checks 
Smithers-Jones: checks 
*** TURN *** [3d 2h 9c] [6d]
Tyoma_Kovach: checks 
Smithers-Jones: checks 
*** RIVER *** [3d 2h 9c 6d] [Jh]
Tyoma_Kovach: checks 
Smithers-Jones: bets $0.12
Tyoma_Kovach: calls $0.12
*** SHOW DOWN ***
Smithers-Jones: shows [9d Qd] (a pair of Nines)
Tyoma_Kovach: mucks hand 
Smithers-Jones collected $0.47 from pot
*** SUMMARY ***
Total pot $0.49 | Rake $0.02 
Board [3d 2h 9c 6d Jh]
Seat 1: omarcho9300 (small blind) folded before Flop
Seat 2: Tyoma_Kovach (big blind) mucked
Seat 3: crankthatsoulja folded before Flop (didn't bet)
Seat 4: Smithers-Jones (button) showed [9d Qd] and won ($0.47) with a pair of Nines



PokerStars Hand #222955131604:  Hold'em No Limit ($0.05/$0.10 USD) - 2021/01/23 9:27:56 ET
Table 'Saito II' 6-max Seat #1 is the button
Seat 1: omarcho9300 ($10.47 in chips) 
Seat 2: Tyoma_Kovach ($15.44 in chips) 
Seat 3: crankthatsoulja ($5.04 in chips) 
Seat 4: Smithers-Jones ($9.84 in chips) 
Tyoma_Kovach: posts small blind $0.05
crankthatsoulja: posts big blind $0.10
*** HOLE CARDS ***
Smithers-Jones: folds 
omarcho9300: folds 
Tyoma_Kovach: folds 
Uncalled bet ($0.05) returned to crankthatsoulja
crankthatsoulja collected $0.10 from pot
crankthatsoulja: doesn't show hand 
*** SUMMARY ***
Total pot $0.10 | Rake $0 
Seat 1: omarcho9300 (button) folded before Flop (didn't bet)
Seat 2: Tyoma_Kovach (small blind) folded before Flop
Seat 3: crankthatsoulja (big blind) collected ($0.10)
Seat 4: Smithers-Jones folded before Flop (didn't bet)



PokerStars Hand #222955143252:  Hold'em No Limit ($0.05/$0.10 USD) - 2021/01/23 9:28:06 ET
Table 'Saito II' 6-max Seat #2 is the button
Seat 1: omarcho9300 ($10.47 in chips) 
Seat 2: Tyoma_Kovach ($15.39 in chips) 
Seat 3: crankthatsoulja ($5.09 in chips) 
Seat 4: Smithers-Jones ($9.84 in chips) 
crankthatsoulja: posts small blind $0.05
Smithers-Jones: posts big blind $0.10
*** HOLE CARDS ***
omarcho9300: folds 
Tyoma_Kovach: folds 
crankthatsoulja: calls $0.05
Smithers-Jones: checks 
*** FLOP *** [7d Ts 9c]
crankthatsoulja: checks 
Smithers-Jones: checks 
*** TURN *** [7d Ts 9c] [8s]
crankthatsoulja: bets $0.50
Smithers-Jones: calls $0.50
*** RIVER *** [7d Ts 9c 8s] [6d]
crankthatsoulja: checks 
Smithers-Jones: checks 
*** SHOW DOWN ***
crankthatsoulja: shows [3c 4c] (a straight, Six to Ten)
Smithers-Jones: shows [6s Ad] (a straight, Six to Ten)
crankthatsoulja collected $0.58 from pot
Smithers-Jones collected $0.57 from pot
*** SUMMARY ***
Total pot $1.20 | Rake $0.05 
Board [7d Ts 9c 8s 6d]
Seat 1: omarcho9300 folded before Flop (didn't bet)
Seat 2: Tyoma_Kovach (button) folded before Flop (didn't bet)
Seat 3: crankthatsoulja (small blind) showed [3c 4c] and won ($0.58) with a straight, Six to Ten
Seat 4: Smithers-Jones (big blind) showed [6s Ad] and won ($0.57) with a straight, Six to Ten



PokerStars Hand #222955168648:  Hold'em No Limit ($0.05/$0.10 USD) - 2021/01/23 9:28:57 ET
Table 'Saito II' 6-max Seat #3 is the button
Seat 1: omarcho9300 ($10.47 in chips) 
Seat 2: Tyoma_Kovach ($15.39 in chips) 
Seat 3: crankthatsoulja ($5.07 in chips) 
Seat 4: Smithers-Jones ($9.81 in chips) 
Smithers-Jones: posts small blind $0.05
omarcho9300: posts big blind $0.10
*** HOLE CARDS ***
Tyoma_Kovach: folds 
crankthatsoulja: calls $0.10
Smithers-Jones: raises $0.10 to $0.20
omarcho9300: folds 
Jesus Ololo leaves the table
crankthatsoulja: calls $0.10
*** FLOP *** [2d 5h 9h]
Smithers-Jones: bets $0.10
crankthatsoulja: folds 
Uncalled bet ($0.10) returned to Smithers-Jones
Smithers-Jones collected $0.48 from pot
*** SUMMARY ***
Total pot $0.50 | Rake $0.02 
Board [2d 5h 9h]
Seat 1: omarcho9300 (big blind) folded before Flop
Seat 2: Tyoma_Kovach folded before Flop (didn't bet)
Seat 3: crankthatsoulja (button) folded on the Flop
Seat 4: Smithers-Jones (small blind) collected ($0.48)



PokerStars Hand #222955181418:  Hold'em No Limit ($0.05/$0.10 USD) - 2021/01/23 9:29:23 ET
Table 'Saito II' 6-max Seat #4 is the button
Seat 1: omarcho9300 ($10.37 in chips) 
Seat 2: Tyoma_Kovach ($15.39 in chips) 
Seat 3: crankthatsoulja ($4.87 in chips) 
Seat 4: Smithers-Jones ($10.09 in chips) 
omarcho9300: posts small blind $0.05
Tyoma_Kovach: posts big blind $0.10
*** HOLE CARDS ***
xulfster joins the table at seat #6 
crankthatsoulja: calls $0.10
Smithers-Jones: folds 
omarcho9300: folds 
Tyoma_Kovach: raises $0.36 to $0.46
crankthatsoulja: calls $0.36
*** FLOP *** [Kh 5h Tc]
Tyoma_Kovach: bets $0.47
crankthatsoulja: raises $0.47 to $0.94
Tyoma_Kovach: calls $0.47
*** TURN *** [Kh 5h Tc] [3c]
Tyoma_Kovach: checks 
crankthatsoulja: bets $0.40
Tyoma_Kovach: raises $4.68 to $5.08
crankthatsoulja: calls $3.07 and is all-in
Uncalled bet ($1.61) returned to Tyoma_Kovach
omarcho9300 was removed from the table for failing to post
omarcho9300 leaves the table
*** RIVER *** [Kh 5h Tc 3c] [8h]
*** SHOW DOWN ***
Tyoma_Kovach: shows [Qh Kd] (a pair of Kings)
crankthatsoulja: shows [Jd Ks] (a pair of Kings - lower kicker)
Tyoma_Kovach collected $9.35 from pot
*** SUMMARY ***
Total pot $9.79 | Rake $0.44 
Board [Kh 5h Tc 3c 8h]
Seat 1: omarcho9300 (small blind) folded before Flop
Seat 2: Tyoma_Kovach (big blind) showed [Qh Kd] and won ($9.35) with a pair of Kings
Seat 3: crankthatsoulja showed [Jd Ks] and lost with a pair of Kings
Seat 4: Smithers-Jones (button) folded before Flop (didn't bet)



PokerStars Hand #222955214407:  Hold'em No Limit ($0.05/$0.10 USD) - 2021/01/23 9:30:29 ET
Table 'Saito II' 6-max Seat #2 is the button
Seat 2: Tyoma_Kovach ($19.87 in chips) 
Seat 4: Smithers-Jones ($10.09 in chips) 
Seat 6: xulfster ($19.24 in chips) 
Smithers-Jones: posts small blind $0.05
xulfster: posts big blind $0.10
*** HOLE CARDS ***
Tyoma_Kovach: raises $0.15 to $0.25
Smithers-Jones: folds 
Hermit628 joins the table at seat #1 
xulfster: folds 
Uncalled bet ($0.15) returned to Tyoma_Kovach
crankthatsoulja leaves the table
Tyoma_Kovach collected $0.25 from pot
Willishoveandbb was removed from the table for failing to post
Willishoveandbb leaves the table
Tyoma_Kovach: doesn't show hand 
*** SUMMARY ***
Total pot $0.25 | Rake $0 
Seat 2: Tyoma_Kovach (button) collected ($0.25)
Seat 4: Smithers-Jones (small blind) folded before Flop
Seat 6: xulfster (big blind) folded before Flop



PokerStars Hand #222955218523:  Hold'em No Limit ($0.05/$0.10 USD) - 2021/01/23 9:30:37 ET
Table 'Saito II' 6-max Seat #4 is the button
Seat 1: Hermit628 ($10 in chips) 
Seat 2: Tyoma_Kovach ($20.02 in chips) 
Seat 4: Smithers-Jones ($10.04 in chips) 
Seat 6: xulfster ($19.14 in chips) 
xulfster: posts small blind $0.05
Hermit628: posts big blind $0.10
*** HOLE CARDS ***
Tyoma_Kovach: folds 
Smithers-Jones: folds 
xulfster: raises $0.20 to $0.30
Hermit628: folds 
Uncalled bet ($0.20) returned to xulfster
xulfster collected $0.20 from pot
*** SUMMARY ***
Total pot $0.20 | Rake $0 
Seat 1: Hermit628 (big blind) folded before Flop
Seat 2: Tyoma_Kovach folded before Flop (didn't bet)
Seat 4: Smithers-Jones (button) folded before Flop (didn't bet)
Seat 6: xulfster (small blind) collected ($0.20)



PokerStars Hand #222955224386:  Hold'em No Limit ($0.05/$0.10 USD) - 2021/01/23 9:30:49 ET
Table 'Saito II' 6-max Seat #6 is the button
Seat 2: Tyoma_Kovach ($20.02 in chips) 
Seat 4: Smithers-Jones ($10.04 in chips) 
Seat 6: xulfster ($19.24 in chips) 
Tyoma_Kovach: posts small blind $0.05
Smithers-Jones: posts big blind $0.10
*** HOLE CARDS ***
Hermit628 leaves the table
Klemqaa joins the table at seat #3 
densamara_63 joins the table at seat #5 
xulfster has timed out
xulfster: folds 
Tyoma_Kovach: folds 
Uncalled bet ($0.05) returned to Smithers-Jones
Smithers-Jones collected $0.10 from pot
*** SUMMARY ***
Total pot $0.10 | Rake $0 
Seat 2: Tyoma_Kovach (small blind) folded before Flop
Seat 4: Smithers-Jones (big blind) collected ($0.10)
Seat 6: xulfster (button) folded before Flop (didn't bet)



PokerStars Hand #222955231654:  Hold'em No Limit ($0.05/$0.10 USD) - 2021/01/23 9:31:04 ET
Table 'Saito II' 6-max Seat #2 is the button
Seat 2: Tyoma_Kovach ($19.97 in chips) 
Seat 4: Smithers-Jones ($10.09 in chips) 
Seat 5: densamara_63 ($10 in chips) 
Seat 6: xulfster ($19.24 in chips) 
Smithers-Jones: posts small blind $0.05
densamara_63: posts big blind $0.10
*** HOLE CARDS ***
Kalle_2509 joins the table at seat #1 
xulfster: folds 
Tyoma_Kovach: raises $0.15 to $0.25
Smithers-Jones: folds 
densamara_63: folds 
Uncalled bet ($0.15) returned to Tyoma_Kovach
Tyoma_Kovach collected $0.25 from pot
Tyoma_Kovach: doesn't show hand 
*** SUMMARY ***
Total pot $0.25 | Rake $0 
Seat 2: Tyoma_Kovach (button) collected ($0.25)
Seat 4: Smithers-Jones (small blind) folded before Flop
Seat 5: densamara_63 (big blind) folded before Flop
Seat 6: xulfster folded before Flop (didn't bet)



PokerStars Hand #222955236558:  Hold'em No Limit ($0.05/$0.10 USD) - 2021/01/23 9:31:13 ET
Table 'Saito II' 6-max Seat #4 is the button
Seat 1: Kalle_2509 ($6.60 in chips) 
Seat 2: Tyoma_Kovach ($20.12 in chips) 
Seat 4: Smithers-Jones ($10.04 in chips) 
Seat 5: densamara_63 ($10 in chips) 
densamara_63: posts small blind $0.05
xulfster: is sitting out 
xulfster leaves the table
Kalle_2509: posts big blind $0.10
Klemqaa: sits out 
*** HOLE CARDS ***
Tyoma_Kovach: folds 
arxontas21 joins the table at seat #6 
Smithers-Jones: calls $0.10
densamara_63: folds 
Kalle_2509: checks 
*** FLOP *** [7h 9s 9c]
Kalle_2509: checks 
Smithers-Jones: bets $0.12
Kalle_2509: calls $0.12
*** TURN *** [7h 9s 9c] [Tc]
Kalle_2509: checks 
Smithers-Jones: bets $0.47
Kalle_2509: calls $0.47
*** RIVER *** [7h 9s 9c Tc] [Ks]
Kalle_2509: bets $0.69
Smithers-Jones: folds 
Uncalled bet ($0.69) returned to Kalle_2509
Kalle_2509 collected $1.37 from pot
Kalle_2509: doesn't show hand 
*** SUMMARY ***
Total pot $1.43 | Rake $0.06 
Board [7h 9s 9c Tc Ks]
Seat 1: Kalle_2509 (big blind) collected ($1.37)
Seat 2: Tyoma_Kovach folded before Flop (didn't bet)
Seat 4: Smithers-Jones (button) folded on the River
Seat 5: densamara_63 (small blind) folded before Flop



PokerStars Hand #222955265148:  Hold'em No Limit ($0.05/$0.10 USD) - 2021/01/23 9:32:09 ET
Table 'Saito II' 6-max Seat #5 is the button
Seat 1: Kalle_2509 ($7.28 in chips) 
Seat 2: Tyoma_Kovach ($20.12 in chips) 
Seat 4: Smithers-Jones ($9.35 in chips) 
Seat 5: densamara_63 ($10 in chips) 
Kalle_2509: posts small blind $0.05
Tyoma_Kovach: posts big blind $0.10
Klemqaa: sits out 
*** HOLE CARDS ***
Smithers-Jones: folds 
densamara_63: folds 
Kalle_2509: calls $0.05
Tyoma_Kovach: checks 
*** FLOP *** [7c 5h 8d]
Kalle_2509: bets $0.10
Tyoma_Kovach: calls $0.10
*** TURN *** [7c 5h 8d] [Th]
Kalle_2509: bets $0.10
Tyoma_Kovach: calls $0.10
*** RIVER *** [7c 5h 8d Th] [Td]
Kalle_2509: bets $0.57
Tyoma_Kovach: folds 
Uncalled bet ($0.57) returned to Kalle_2509
Kalle_2509 collected $0.57 from pot
Kalle_2509: doesn't show hand 
*** SUMMARY ***
Total pot $0.60 | Rake $0.03 
Board [7c 5h 8d Th Td]
Seat 1: Kalle_2509 (small blind) collected ($0.57)
Seat 2: Tyoma_Kovach (big blind) folded on the River
Seat 4: Smithers-Jones folded before Flop (didn't bet)
Seat 5: densamara_63 (button) folded before Flop (didn't bet)



PokerStars Hand #222955286661:  Hold'em No Limit ($0.05/$0.10 USD) - 2021/01/23 9:32:52 ET
Table 'Saito II' 6-max Seat #1 is the button
Seat 1: Kalle_2509 ($7.55 in chips) 
Seat 2: Tyoma_Kovach ($19.82 in chips) 
Seat 3: Klemqaa ($10 in chips) 
Seat 4: Smithers-Jones ($9.35 in chips) 
Seat 5: densamara_63 ($10 in chips) 
Seat 6: arxontas21 ($10 in chips) 
Tyoma_Kovach: posts small blind $0.05
Klemqaa: posts big blind $0.10
arxontas21: posts big blind $0.10
*** HOLE CARDS ***
Smithers-Jones: folds 
densamara_63: raises $0.30 to $0.40
arxontas21: calls $0.30
Kalle_2509: folds 
Tyoma_Kovach: folds 
Klemqaa: folds 
*** FLOP *** [7s Ac 7c]
densamara_63: checks 
arxontas21: checks 
*** TURN *** [7s Ac 7c] [3c]
densamara_63: bets $0.76
arxontas21: folds 
Uncalled bet ($0.76) returned to densamara_63
densamara_63 collected $0.91 from pot
*** SUMMARY ***
Total pot $0.95 | Rake $0.04 
Board [7s Ac 7c 3c]
Seat 1: Kalle_2509 (button) folded before Flop (didn't bet)
Seat 2: Tyoma_Kovach (small blind) folded before Flop
Seat 3: Klemqaa (big blind) folded before Flop
Seat 4: Smithers-Jones folded before Flop (didn't bet)
Seat 5: densamara_63 collected ($0.91)
Seat 6: arxontas21 folded on the Turn



PokerStars Hand #222955303994:  Hold'em No Limit ($0.05/$0.10 USD) - 2021/01/23 9:33:26 ET
Table 'Saito II' 6-max Seat #2 is the button
Seat 1: Kalle_2509 ($7.55 in chips) 
Seat 2: Tyoma_Kovach ($19.77 in chips) 
Seat 3: Klemqaa ($10 in chips) 
Seat 4: Smithers-Jones ($9.35 in chips) 
Seat 5: densamara_63 ($10.51 in chips) 
Seat 6: arxontas21 ($9.60 in chips) 
Klemqaa: posts small blind $0.05
Smithers-Jones: posts big blind $0.10
*** HOLE CARDS ***
densamara_63: folds 
arxontas21: raises $0.20 to $0.30
Kalle_2509: folds 
Tyoma_Kovach: folds 
Klemqaa: folds 
Smithers-Jones: folds 
Uncalled bet ($0.20) returned to arxontas21
Smithers-Jones leaves the table
arxontas21 collected $0.25 from pot
arxontas21: doesn't show hand 
*** SUMMARY ***
Total pot $0.25 | Rake $0 
Seat 1: Kalle_2509 folded before Flop (didn't bet)
Seat 2: Tyoma_Kovach (button) folded before Flop (didn't bet)
Seat 3: Klemqaa (small blind) folded before Flop
Seat 4: Smithers-Jones (big blind) folded before Flop
Seat 5: densamara_63 folded before Flop (didn't bet)
Seat 6: arxontas21 collected ($0.25)



PokerStars Hand #222955312509:  Hold'em No Limit ($0.05/$0.10 USD) - 2021/01/23 9:33:43 ET
Table 'Saito II' 6-max Seat #3 is the button
Seat 1: Kalle_2509 ($7.55 in chips) 
Seat 2: Tyoma_Kovach ($19.77 in chips) 
Seat 3: Klemqaa ($10 in chips) 
Seat 5: densamara_63 ($10.51 in chips) 
Seat 6: arxontas21 ($9.75 in chips) 
densamara_63: posts small blind $0.05
arxontas21: posts big blind $0.10
*** HOLE CARDS ***
Kalle_2509: calls $0.10
Tyoma_Kovach: folds 
Klemqaa: folds 
densamara_63: folds 
cleiton-005 joins the table at seat #4 
arxontas21: raises $0.20 to $0.30
Kalle_2509: calls $0.20
*** FLOP *** [5c Ts 6h]
arxontas21: bets $0.31
Kalle_2509: folds 
Uncalled bet ($0.31) returned to arxontas21
arxontas21 collected $0.62 from pot
arxontas21: doesn't show hand 
*** SUMMARY ***
Total pot $0.65 | Rake $0.03 
Board [5c Ts 6h]
Seat 1: Kalle_2509 folded on the Flop
Seat 2: Tyoma_Kovach folded before Flop (didn't bet)
Seat 3: Klemqaa (button) folded before Flop (didn't bet)
Seat 5: densamara_63 (small blind) folded before Flop
Seat 6: arxontas21 (big blind) collected ($0.62)



PokerStars Hand #222955325062:  Hold'em No Limit ($0.05/$0.10 USD) - 2021/01/23 9:34:08 ET
Table 'Saito II' 6-max Seat #5 is the button
Seat 1: Kalle_2509 ($7.25 in chips) 
Seat 2: Tyoma_Kovach ($19.77 in chips) 
Seat 3: Klemqaa ($10 in chips) 
Seat 4: cleiton-005 ($5 in chips) 
Seat 5: densamara_63 ($10.46 in chips) 
Seat 6: arxontas21 ($10.07 in chips) 
arxontas21: posts small blind $0.05
Kalle_2509: posts big blind $0.10
cleiton-005: posts big blind $0.10
*** HOLE CARDS ***
Tyoma_Kovach: folds 
Klemqaa: folds 
cleiton-005: raises $0.10 to $0.20
densamara_63: folds 
arxontas21: calls $0.15
Kalle_2509: calls $0.10
*** FLOP *** [4h 8s 9c]
arxontas21: bets $0.57
Kalle_2509: folds 
cleiton-005: folds 
Uncalled bet ($0.57) returned to arxontas21
arxontas21 collected $0.57 from pot
arxontas21: doesn't show hand 
*** SUMMARY ***
Total pot $0.60 | Rake $0.03 
Board [4h 8s 9c]
Seat 1: Kalle_2509 (big blind) folded on the Flop
Seat 2: Tyoma_Kovach folded before Flop (didn't bet)
Seat 3: Klemqaa folded before Flop (didn't bet)
Seat 4: cleiton-005 folded on the Flop
Seat 5: densamara_63 (button) folded before Flop (didn't bet)
Seat 6: arxontas21 (small blind) collected ($0.57)



PokerStars Hand #222955335923:  Hold'em No Limit ($0.05/$0.10 USD) - 2021/01/23 9:34:30 ET
Table 'Saito II' 6-max Seat #6 is the button
Seat 1: Kalle_2509 ($7.05 in chips) 
Seat 2: Tyoma_Kovach ($19.77 in chips) 
Seat 3: Klemqaa ($10 in chips) 
Seat 4: cleiton-005 ($4.80 in chips) 
Seat 5: densamara_63 ($10.46 in chips) 
Seat 6: arxontas21 ($10.44 in chips) 
Kalle_2509: posts small blind $0.05
Tyoma_Kovach: posts big blind $0.10
*** HOLE CARDS ***
Klemqaa: folds 
cleiton-005: folds 
densamara_63: folds 
arxontas21: raises $0.20 to $0.30
Kalle_2509: folds 
Tyoma_Kovach: calls $0.20
*** FLOP *** [Ah 6d 3c]
Tyoma_Kovach: checks 
arxontas21: bets $0.62
Tyoma_Kovach: folds 
Uncalled bet ($0.62) returned to arxontas21
arxontas21 collected $0.62 from pot
arxontas21: doesn't show hand 
*** SUMMARY ***
Total pot $0.65 | Rake $0.03 
Board [Ah 6d 3c]
Seat 1: Kalle_2509 (small blind) folded before Flop
Seat 2: Tyoma_Kovach (big blind) folded on the Flop
Seat 3: Klemqaa folded before Flop (didn't bet)
Seat 4: cleiton-005 folded before Flop (didn't bet)
Seat 5: densamara_63 folded before Flop (didn't bet)
Seat 6: arxontas21 (button) collected ($0.62)



PokerStars Hand #222955348593:  Hold'em No Limit ($0.05/$0.10 USD) - 2021/01/23 9:34:55 ET
Table 'Saito II' 6-max Seat #1 is the button
Seat 1: Kalle_2509 ($7 in chips) 
Seat 2: Tyoma_Kovach ($19.47 in chips) 
Seat 3: Klemqaa ($10 in chips) 
Seat 4: cleiton-005 ($4.80 in chips) 
Seat 5: densamara_63 ($10.46 in chips) 
Seat 6: arxontas21 ($10.76 in chips) 
Tyoma_Kovach: posts small blind $0.05
Klemqaa: posts big blind $0.10
*** HOLE CARDS ***
cleiton-005: folds 
densamara_63: raises $0.20 to $0.30
arxontas21: calls $0.30
Kalle_2509: folds 
Tyoma_Kovach: folds 
Klemqaa: folds 
*** FLOP *** [5d 8h Ts]
densamara_63: bets $0.43
arxontas21: folds 
Uncalled bet ($0.43) returned to densamara_63
densamara_63 collected $0.72 from pot
*** SUMMARY ***
Total pot $0.75 | Rake $0.03 
Board [5d 8h Ts]
Seat 1: Kalle_2509 (button) folded before Flop (didn't bet)
Seat 2: Tyoma_Kovach (small blind) folded before Flop
Seat 3: Klemqaa (big blind) folded before Flop
Seat 4: cleiton-005 folded before Flop (didn't bet)
Seat 5: densamara_63 collected ($0.72)
Seat 6: arxontas21 folded on the Flop



PokerStars Hand #222955360461:  Hold'em No Limit ($0.05/$0.10 USD) - 2021/01/23 9:35:18 ET
Table 'Saito II' 6-max Seat #2 is the button
Seat 1: Kalle_2509 ($7 in chips) 
Seat 2: Tyoma_Kovach ($19.42 in chips) 
Seat 3: Klemqaa ($10 in chips) 
Seat 4: cleiton-005 ($4.80 in chips) 
Seat 5: densamara_63 ($10.88 in chips) 
Seat 6: arxontas21 ($10.46 in chips) 
Klemqaa: posts small blind $0.05
cleiton-005: posts big blind $0.10
*** HOLE CARDS ***
densamara_63: folds 
arxontas21: raises $0.20 to $0.30
Kalle_2509: folds 
densamara_63 leaves the table
Tyoma_Kovach: folds 
Klemqaa: folds 
cleiton-005: folds 
Uncalled bet ($0.20) returned to arxontas21
arxontas21 collected $0.25 from pot
arxontas21: doesn't show hand 
*** SUMMARY ***
Total pot $0.25 | Rake $0 
Seat 1: Kalle_2509 folded before Flop (didn't bet)
Seat 2: Tyoma_Kovach (button) folded before Flop (didn't bet)
Seat 3: Klemqaa (small blind) folded before Flop
Seat 4: cleiton-005 (big blind) folded before Flop
Seat 5: densamara_63 folded before Flop (didn't bet)
Seat 6: arxontas21 collected ($0.25)



PokerStars Hand #222955366605:  Hold'em No Limit ($0.05/$0.10 USD) - 2021/01/23 9:35:30 ET
Table 'Saito II' 6-max Seat #3 is the button
Seat 1: Kalle_2509 ($7 in chips) 
Seat 2: Tyoma_Kovach ($19.42 in chips) 
Seat 3: Klemqaa ($10 in chips) 
Seat 4: cleiton-005 ($4.70 in chips) 
Seat 6: arxontas21 ($10.61 in chips) 
cleiton-005: posts small blind $0.05
arxontas21: posts big blind $0.10
*** HOLE CARDS ***
Kalle_2509: folds 
Tyoma_Kovach: folds 
Klemqaa: folds 
cleiton-005: calls $0.05
arxontas21: checks 
*** FLOP *** [Td Qc 6s]
cleiton-005: checks 
gazsam2000 joins the table at seat #5 
arxontas21: bets $0.19
cleiton-005: folds 
Uncalled bet ($0.19) returned to arxontas21
arxontas21 collected $0.19 from pot
arxontas21: doesn't show hand 
*** SUMMARY ***
Total pot $0.20 | Rake $0.01 
Board [Td Qc 6s]
Seat 1: Kalle_2509 folded before Flop (didn't bet)
Seat 2: Tyoma_Kovach folded before Flop (didn't bet)
Seat 3: Klemqaa (button) folded before Flop (didn't bet)
Seat 4: cleiton-005 (small blind) folded on the Flop
Seat 6: arxontas21 (big blind) collected ($0.19)



PokerStars Hand #222955375989:  Hold'em No Limit ($0.05/$0.10 USD) - 2021/01/23 9:35:49 ET
Table 'Saito II' 6-max Seat #4 is the button
Seat 1: Kalle_2509 ($7 in chips) 
Seat 2: Tyoma_Kovach ($19.42 in chips) 
Seat 3: Klemqaa ($10 in chips) 
Seat 4: cleiton-005 ($4.60 in chips) 
Seat 6: arxontas21 ($10.70 in chips) 
arxontas21: posts small blind $0.05
Kalle_2509: posts big blind $0.10
*** HOLE CARDS ***
Tyoma_Kovach: raises $0.20 to $0.30
Klemqaa: folds 
cleiton-005: folds 
arxontas21: calls $0.25
Kalle_2509: calls $0.20
*** FLOP *** [Ad 5d 2h]
arxontas21: checks 
Kalle_2509: bets $0.50
Tyoma_Kovach: calls $0.50
arxontas21: calls $0.50
*** TURN *** [Ad 5d 2h] [6h]
arxontas21: checks 
Kalle_2509: bets $2.29
Tyoma_Kovach: folds 
arxontas21: folds 
Uncalled bet ($2.29) returned to Kalle_2509
Kalle_2509 collected $2.29 from pot
Kalle_2509: doesn't show hand 
*** SUMMARY ***
Total pot $2.40 | Rake $0.11 
Board [Ad 5d 2h 6h]
Seat 1: Kalle_2509 (big blind) collected ($2.29)
Seat 2: Tyoma_Kovach folded on the Turn
Seat 3: Klemqaa folded before Flop (didn't bet)
Seat 4: cleiton-005 (button) folded before Flop (didn't bet)
Seat 6: arxontas21 (small blind) folded on the Turn



PokerStars Hand #222955400583:  Hold'em No Limit ($0.05/$0.10 USD) - 2021/01/23 9:36:38 ET
Table 'Saito II' 6-max Seat #6 is the button
Seat 1: Kalle_2509 ($8.49 in chips) 
Seat 2: Tyoma_Kovach ($18.62 in chips) 
Seat 3: Klemqaa ($10 in chips) 
Seat 4: cleiton-005 ($4.60 in chips) 
Seat 6: arxontas21 ($9.90 in chips) 
Kalle_2509: posts small blind $0.05
Tyoma_Kovach: posts big blind $0.10
gazsam2000: sits out 
*** HOLE CARDS ***
Klemqaa: folds 
cleiton-005: raises $0.10 to $0.20
arxontas21: calls $0.20
Kalle_2509: folds 
Tyoma_Kovach: calls $0.10
*** FLOP *** [8c Ah Qs]
Tyoma_Kovach: checks 
cleiton-005: checks 
arxontas21: bets $0.31
Tyoma_Kovach: folds 
cleiton-005: calls $0.31
*** TURN *** [8c Ah Qs] [Js]
cleiton-005: checks 
arxontas21: checks 
*** RIVER *** [8c Ah Qs Js] [2s]
cleiton-005: checks 
arxontas21: checks 
*** SHOW DOWN ***
cleiton-005: shows [Kc Qh] (a pair of Queens)
arxontas21: mucks hand 
cleiton-005 collected $1.21 from pot
*** SUMMARY ***
Total pot $1.27 | Rake $0.06 
Board [8c Ah Qs Js 2s]
Seat 1: Kalle_2509 (small blind) folded before Flop
Seat 2: Tyoma_Kovach (big blind) folded on the Flop
Seat 3: Klemqaa folded before Flop (didn't bet)
Seat 4: cleiton-005 showed [Kc Qh] and won ($1.21) with a pair of Queens
Seat 6: arxontas21 (button) mucked



PokerStars Hand #222955420060:  Hold'em No Limit ($0.05/$0.10 USD) - 2021/01/23 9:37:17 ET
Table 'Saito II' 6-max Seat #1 is the button
Seat 1: Kalle_2509 ($8.44 in chips) 
Seat 2: Tyoma_Kovach ($18.42 in chips) 
Seat 3: Klemqaa ($10 in chips) 
Seat 4: cleiton-005 ($5.30 in chips) 
Seat 6: arxontas21 ($9.39 in chips) 
Tyoma_Kovach: posts small blind $0.05
Klemqaa: posts big blind $0.10
gazsam2000: sits out 
*** HOLE CARDS ***
cleiton-005: raises $0.10 to $0.20
arxontas21: calls $0.20
Kalle_2509: calls $0.20
Tyoma_Kovach: calls $0.15
Klemqaa: folds 
*** FLOP *** [6c 9h 4s]
Tyoma_Kovach: checks 
cleiton-005: checks 
arxontas21: bets $0.86
Kalle_2509: folds 
Tyoma_Kovach: folds 
cleiton-005: folds 
Uncalled bet ($0.86) returned to arxontas21
arxontas21 collected $0.86 from pot
arxontas21: doesn't show hand 
*** SUMMARY ***
Total pot $0.90 | Rake $0.04 
Board [6c 9h 4s]
Seat 1: Kalle_2509 (button) folded on the Flop
Seat 2: Tyoma_Kovach (small blind) folded on the Flop
Seat 3: Klemqaa (big blind) folded before Flop
Seat 4: cleiton-005 folded on the Flop
Seat 6: arxontas21 collected ($0.86)



PokerStars Hand #222955434082:  Hold'em No Limit ($0.05/$0.10 USD) - 2021/01/23 9:37:45 ET
Table 'Saito II' 6-max Seat #2 is the button
Seat 2: Tyoma_Kovach ($18.22 in chips) 
Seat 3: Klemqaa ($10 in chips) 
Seat 4: cleiton-005 ($5.10 in chips) 
Seat 6: arxontas21 ($10.05 in chips) 
Klemqaa: posts small blind $0.05
cleiton-005: posts big blind $0.10
gazsam2000: sits out 
*** HOLE CARDS ***
arxontas21: raises $0.20 to $0.30
Tyoma_Kovach: folds 
Klemqaa: folds 
cleiton-005: calls $0.20
*** FLOP *** [8s 4d 5c]
cleiton-005: checks 
arxontas21: bets $0.62
cleiton-005: folds 
Uncalled bet ($0.62) returned to arxontas21
arxontas21 collected $0.62 from pot
arxontas21: doesn't show hand 
Kalle_2509 leaves the table
*** SUMMARY ***
Total pot $0.65 | Rake $0.03 
Board [8s 4d 5c]
Seat 2: Tyoma_Kovach (button) folded before Flop (didn't bet)
Seat 3: Klemqaa (small blind) folded before Flop
Seat 4: cleiton-005 (big blind) folded on the Flop
Seat 6: arxontas21 collected ($0.62)



PokerStars Hand #222955443916:  Hold'em No Limit ($0.05/$0.10 USD) - 2021/01/23 9:38:05 ET
Table 'Saito II' 6-max Seat #3 is the button
Seat 2: Tyoma_Kovach ($18.22 in chips) 
Seat 3: Klemqaa ($10 in chips) 
Seat 4: cleiton-005 ($4.80 in chips) 
Seat 5: gazsam2000 ($10 in chips) 
Seat 6: arxontas21 ($10.37 in chips) 
cleiton-005: posts small blind $0.05
gazsam2000: posts big blind $0.10
*** HOLE CARDS ***
arxontas21: folds 
Tyoma_Kovach: raises $0.18 to $0.28
Klemqaa: folds 
cleiton-005: folds 
gazsam2000: folds 
Uncalled bet ($0.18) returned to Tyoma_Kovach
Tyoma_Kovach collected $0.25 from pot
Tyoma_Kovach: doesn't show hand 
gazsam2000 leaves the table
*** SUMMARY ***
Total pot $0.25 | Rake $0 
Seat 2: Tyoma_Kovach collected ($0.25)
Seat 3: Klemqaa (button) folded before Flop (didn't bet)
Seat 4: cleiton-005 (small blind) folded before Flop
Seat 5: gazsam2000 (big blind) folded before Flop
Seat 6: arxontas21 folded before Flop (didn't bet)



PokerStars Hand #222955448966:  Hold'em No Limit ($0.05/$0.10 USD) - 2021/01/23 9:38:15 ET
Table 'Saito II' 6-max Seat #4 is the button
Seat 2: Tyoma_Kovach ($18.37 in chips) 
Seat 3: Klemqaa ($10 in chips) 
Seat 4: cleiton-005 ($4.75 in chips) 
Seat 6: arxontas21 ($10.37 in chips) 
arxontas21: posts small blind $0.05
Tyoma_Kovach: posts big blind $0.10
*** HOLE CARDS ***
Klemqaa: folds 
cleiton-005: raises $0.10 to $0.20
arxontas21: folds 
Tyoma_Kovach: folds 
Uncalled bet ($0.10) returned to cleiton-005
gazsam2000 joins the table at seat #1 
cleiton-005 collected $0.25 from pot
cleiton-005: doesn't show hand 
*** SUMMARY ***
Total pot $0.25 | Rake $0 
Seat 2: Tyoma_Kovach (big blind) folded before Flop
Seat 3: Klemqaa folded before Flop (didn't bet)
Seat 4: cleiton-005 (button) collected ($0.25)
Seat 6: arxontas21 (small blind) folded before Flop



PokerStars Hand #222955452232:  Hold'em No Limit ($0.05/$0.10 USD) - 2021/01/23 9:38:21 ET
Table 'Saito II' 6-max Seat #6 is the button
Seat 2: Tyoma_Kovach ($18.27 in chips) 
Seat 3: Klemqaa ($10 in chips) 
Seat 4: cleiton-005 ($4.90 in chips) 
Seat 6: arxontas21 ($10.32 in chips) 
Tyoma_Kovach: posts small blind $0.05
Klemqaa: posts big blind $0.10
*** HOLE CARDS ***
cleiton-005: folds 
free Atheist joins the table at seat #5 
arxontas21: raises $0.20 to $0.30
Tyoma_Kovach: folds 
Klemqaa: raises $0.65 to $0.95
arxontas21: calls $0.65
*** FLOP *** [9c 4h 2s]
Klemqaa: bets $1.02
arxontas21: calls $1.02
*** TURN *** [9c 4h 2s] [6d]
Klemqaa: bets $1.80
arxontas21: calls $1.80
*** RIVER *** [9c 4h 2s 6d] [3s]
Klemqaa: checks 
arxontas21: checks 
*** SHOW DOWN ***
Klemqaa: shows [Ts Ks] (high card King)
arxontas21: shows [8h 6h] (a pair of Sixes)
arxontas21 collected $7.25 from pot
*** SUMMARY ***
Total pot $7.59 | Rake $0.34 
Board [9c 4h 2s 6d 3s]
Seat 2: Tyoma_Kovach (small blind) folded before Flop
Seat 3: Klemqaa (big blind) showed [Ts Ks] and lost with high card King
Seat 4: cleiton-005 folded before Flop (didn't bet)
Seat 6: arxontas21 (button) showed [8h 6h] and won ($7.25) with a pair of Sixes



PokerStars Hand #222955470133:  Hold'em No Limit ($0.05/$0.10 USD) - 2021/01/23 9:38:57 ET
Table 'Saito II' 6-max Seat #2 is the button
Seat 2: Tyoma_Kovach ($18.22 in chips) 
Seat 3: Klemqaa ($10 in chips) 
Seat 4: cleiton-005 ($4.90 in chips) 
Seat 5: free Atheist ($10 in chips) 
Seat 6: arxontas21 ($13.80 in chips) 
Klemqaa: posts small blind $0.05
cleiton-005: posts big blind $0.10
free Atheist: posts big blind $0.10
gazsam2000: sits out 
*** HOLE CARDS ***
free Atheist: checks 
arxontas21: folds 
Tyoma_Kovach: folds 
Klemqaa: folds 
cleiton-005: checks 
*** FLOP *** [Ac 3d 7s]
arxontas21 leaves the table
cleiton-005: bets $0.10
free Atheist: folds 
Uncalled bet ($0.10) returned to cleiton-005
cleiton-005 collected $0.24 from pot
cleiton-005: doesn't show hand 
*** SUMMARY ***
Total pot $0.25 | Rake $0.01 
Board [Ac 3d 7s]
Seat 2: Tyoma_Kovach (button) folded before Flop (didn't bet)
Seat 3: Klemqaa (small blind) folded before Flop
Seat 4: cleiton-005 (big blind) collected ($0.24)
Seat 5: free Atheist folded on the Flop (didn't bet)
Seat 6: arxontas21 folded before Flop (didn't bet)



PokerStars Hand #222955477777:  Hold'em No Limit ($0.05/$0.10 USD) - 2021/01/23 9:39:12 ET
Table 'Saito II' 6-max Seat #3 is the button
Seat 2: Tyoma_Kovach ($18.22 in chips) 
Seat 3: Klemqaa ($10 in chips) 
Seat 4: cleiton-005 ($5.04 in chips) 
Seat 5: free Atheist ($9.90 in chips) 
cleiton-005: posts small blind $0.05
free Atheist: posts big blind $0.10
gazsam2000: sits out 
*** HOLE CARDS ***
Tyoma_Kovach: folds 
Klemqaa: raises $0.15 to $0.25
cleiton-005: folds 
Gissbon joins the table at seat #6 
free Atheist: folds 
Uncalled bet ($0.15) returned to Klemqaa
Klemqaa collected $0.25 from pot
Klemqaa: doesn't show hand 
*** SUMMARY ***
Total pot $0.25 | Rake $0 
Seat 2: Tyoma_Kovach folded before Flop (didn't bet)
Seat 3: Klemqaa (button) collected ($0.25)
Seat 4: cleiton-005 (small blind) folded before Flop
Seat 5: free Atheist (big blind) folded before Flop



PokerStars Hand #222955483812:  Hold'em No Limit ($0.05/$0.10 USD) - 2021/01/23 9:39:24 ET
Table 'Saito II' 6-max Seat #4 is the button
Seat 1: gazsam2000 ($10 in chips) 
Seat 2: Tyoma_Kovach ($18.22 in chips) 
Seat 3: Klemqaa ($10.15 in chips) 
Seat 4: cleiton-005 ($4.99 in chips) 
Seat 5: free Atheist ($9.80 in chips) 
free Atheist: posts small blind $0.05
gazsam2000: posts big blind $0.10
*** HOLE CARDS ***
Tyoma_Kovach: folds 
Klemqaa: folds 
cleiton-005: calls $0.10
free Atheist: calls $0.05
gazsam2000: checks 
*** FLOP *** [Ks 2c 8h]
free Atheist: checks 
gazsam2000: bets $0.29
cleiton-005: folds 
free Atheist: folds 
Uncalled bet ($0.29) returned to gazsam2000
gazsam2000 collected $0.29 from pot
gazsam2000: doesn't show hand 
*** SUMMARY ***
Total pot $0.30 | Rake $0.01 
Board [Ks 2c 8h]
Seat 1: gazsam2000 (big blind) collected ($0.29)
Seat 2: Tyoma_Kovach folded before Flop (didn't bet)
Seat 3: Klemqaa folded before Flop (didn't bet)
Seat 4: cleiton-005 (button) folded on the Flop
Seat 5: free Atheist (small blind) folded on the Flop



PokerStars Hand #222955496289:  Hold'em No Limit ($0.05/$0.10 USD) - 2021/01/23 9:39:49 ET
Table 'Saito II' 6-max Seat #5 is the button
Seat 1: gazsam2000 ($10.19 in chips) 
Seat 2: Tyoma_Kovach ($18.22 in chips) 
Seat 3: Klemqaa ($10.15 in chips) 
Seat 4: cleiton-005 ($4.89 in chips) 
Seat 5: free Atheist ($9.70 in chips) 
gazsam2000: posts small blind $0.05
Tyoma_Kovach: posts big blind $0.10
*** HOLE CARDS ***
Klemqaa: folds 
cleiton-005: calls $0.10
free Atheist: folds 
gazsam2000: raises $0.50 to $0.60
Tyoma_Kovach: folds 
cleiton-005: calls $0.50
*** FLOP *** [2s Td 9s]
gazsam2000: bets $0.90
cleiton-005: folds 
Uncalled bet ($0.90) returned to gazsam2000
gazsam2000 collected $1.24 from pot
gazsam2000: doesn't show hand 
*** SUMMARY ***
Total pot $1.30 | Rake $0.06 
Board [2s Td 9s]
Seat 1: gazsam2000 (small blind) collected ($1.24)
Seat 2: Tyoma_Kovach (big blind) folded before Flop
Seat 3: Klemqaa folded before Flop (didn't bet)
Seat 4: cleiton-005 folded on the Flop
Seat 5: free Atheist (button) folded before Flop (didn't bet)



PokerStars Hand #222955509101:  Hold'em No Limit ($0.05/$0.10 USD) - 2021/01/23 9:40:14 ET
Table 'Saito II' 6-max Seat #1 is the button
Seat 1: gazsam2000 ($10.83 in chips) 
Seat 2: Tyoma_Kovach ($18.12 in chips) 
Seat 3: Klemqaa ($10.15 in chips) 
Seat 4: cleiton-005 ($4.29 in chips) 
Seat 5: free Atheist ($9.70 in chips) 
Tyoma_Kovach: posts small blind $0.05
Klemqaa: posts big blind $0.10
Gissbon: sits out 
*** HOLE CARDS ***
cleiton-005: calls $0.10
free Atheist: calls $0.10
gazsam2000: folds 
Tyoma_Kovach: folds 
Klemqaa: checks 
*** FLOP *** [7c 3h 2s]
Klemqaa: checks 
cleiton-005: checks 
free Atheist: checks 
*** TURN *** [7c 3h 2s] [Ac]
Klemqaa: bets $0.21
cleiton-005: calls $0.21
free Atheist: calls $0.21
*** RIVER *** [7c 3h 2s Ac] [Ah]
Klemqaa: bets $0.61
cleiton-005: folds 
free Atheist: folds 
Uncalled bet ($0.61) returned to Klemqaa
Klemqaa collected $0.94 from pot
Klemqaa: doesn't show hand 
*** SUMMARY ***
Total pot $0.98 | Rake $0.04 
Board [7c 3h 2s Ac Ah]
Seat 1: gazsam2000 (button) folded before Flop (didn't bet)
Seat 2: Tyoma_Kovach (small blind) folded before Flop
Seat 3: Klemqaa (big blind) collected ($0.94)
Seat 4: cleiton-005 folded on the River
Seat 5: free Atheist folded on the River



PokerStars Hand #222955524285:  Hold'em No Limit ($0.05/$0.10 USD) - 2021/01/23 9:40:44 ET
Table 'Saito II' 6-max Seat #2 is the button
Seat 1: gazsam2000 ($10.83 in chips) 
Seat 2: Tyoma_Kovach ($18.07 in chips) 
Seat 3: Klemqaa ($10.78 in chips) 
Seat 4: cleiton-005 ($3.98 in chips) 
Seat 5: free Atheist ($9.39 in chips) 
Klemqaa: posts small blind $0.05
cleiton-005: posts big blind $0.10
Gissbon: sits out 
*** HOLE CARDS ***
free Atheist: calls $0.10
gazsam2000: folds 
Tyoma_Kovach: folds 
Klemqaa: folds 
cleiton-005: checks 
*** FLOP *** [As Qd 6s]
cleiton-005: checks 
free Atheist: checks 
*** TURN *** [As Qd 6s] [Tc]
cleiton-005: checks 
free Atheist: bets $0.24
cleiton-005: calls $0.24
*** RIVER *** [As Qd 6s Tc] [9s]
cleiton-005: checks 
free Atheist: bets $0.35
cleiton-005: calls $0.35
*** SHOW DOWN ***
free Atheist: shows [Ad Jc] (a pair of Aces)
cleiton-005: mucks hand 
free Atheist collected $1.37 from pot
*** SUMMARY ***
Total pot $1.43 | Rake $0.06 
Board [As Qd 6s Tc 9s]
Seat 1: gazsam2000 folded before Flop (didn't bet)
Seat 2: Tyoma_Kovach (button) folded before Flop (didn't bet)
Seat 3: Klemqaa (small blind) folded before Flop
Seat 4: cleiton-005 (big blind) mucked
Seat 5: free Atheist showed [Ad Jc] and won ($1.37) with a pair of Aces



PokerStars Hand #222955539275:  Hold'em No Limit ($0.05/$0.10 USD) - 2021/01/23 9:41:14 ET
Table 'Saito II' 6-max Seat #3 is the button
Seat 1: gazsam2000 ($10.83 in chips) 
Seat 2: Tyoma_Kovach ($18.07 in chips) 
Seat 3: Klemqaa ($10.73 in chips) 
Seat 4: cleiton-005 ($3.29 in chips) 
Seat 5: free Atheist ($10.07 in chips) 
cleiton-005: posts small blind $0.05
free Atheist: posts big blind $0.10
Gissbon: sits out 
*** HOLE CARDS ***
gazsam2000: folds 
Tyoma_Kovach: folds 
Klemqaa: folds 
cleiton-005: calls $0.05
free Atheist: checks 
*** FLOP *** [9c 8c Ts]
cleiton-005: checks 
free Atheist: bets $0.10
cleiton-005: folds 
Uncalled bet ($0.10) returned to free Atheist
free Atheist collected $0.19 from pot
free Atheist: doesn't show hand 
*** SUMMARY ***
Total pot $0.20 | Rake $0.01 
Board [9c 8c Ts]
Seat 1: gazsam2000 folded before Flop (didn't bet)
Seat 2: Tyoma_Kovach folded before Flop (didn't bet)
Seat 3: Klemqaa (button) folded before Flop (didn't bet)
Seat 4: cleiton-005 (small blind) folded on the Flop
Seat 5: free Atheist (big blind) collected ($0.19)



PokerStars Hand #222955547432:  Hold'em No Limit ($0.05/$0.10 USD) - 2021/01/23 9:41:30 ET
Table 'Saito II' 6-max Seat #4 is the button
Seat 1: gazsam2000 ($10.83 in chips) 
Seat 2: Tyoma_Kovach ($18.07 in chips) 
Seat 3: Klemqaa ($10.73 in chips) 
Seat 4: cleiton-005 ($3.19 in chips) 
Seat 5: free Atheist ($10.16 in chips) 
Seat 6: Gissbon ($10 in chips) 
free Atheist: posts small blind $0.05
Gissbon: posts big blind $0.10
*** HOLE CARDS ***
gazsam2000: folds 
Tyoma_Kovach: folds 
Klemqaa: raises $0.20 to $0.30
cleiton-005: raises $0.20 to $0.50
free Atheist: calls $0.45
Gissbon: folds 
Klemqaa: raises $3.05 to $3.55
cleiton-005: calls $2.69 and is all-in
free Atheist: calls $3.05
*** FLOP *** [7h 3c 5h]
free Atheist: checks 
Klemqaa: bets $7.18 and is all-in
free Atheist: calls $6.61 and is all-in
Uncalled bet ($0.57) returned to Klemqaa
*** TURN *** [7h 3c 5h] [Th]
*** RIVER *** [7h 3c 5h Th] [Kh]
*** SHOW DOWN ***
free Atheist: shows [Jh Jc] (a flush, King high)
Klemqaa: shows [Ks Kc] (three of a kind, Kings)
free Atheist collected $13.32 from side pot
cleiton-005: shows [8d 8s] (a pair of Eights)
free Atheist collected $9.23 from main pot
cleiton-005 cashed out the hand for $0.99 | Cash Out Fee $0.01
*** SUMMARY ***
Total pot $23.61 Main pot $9.23. Side pot $13.32. | Rake $1.06 
Board [7h 3c 5h Th Kh]
Seat 1: gazsam2000 folded before Flop (didn't bet)
Seat 2: Tyoma_Kovach folded before Flop (didn't bet)
Seat 3: Klemqaa showed [Ks Kc] and lost with three of a kind, Kings
Seat 4: cleiton-005 (button) showed [8d 8s] and lost with a pair of Eights (cashed out).
Seat 5: free Atheist (small blind) showed [Jh Jc] and won ($22.55) with a flush, King high
Seat 6: Gissbon (big blind) folded before Flop



PokerStars Hand #222955570920:  Hold'em No Limit ($0.05/$0.10 USD) - 2021/01/23 9:42:17 ET
Table 'Saito II' 6-max Seat #5 is the button
Seat 1: gazsam2000 ($10.83 in chips) 
Seat 2: Tyoma_Kovach ($18.07 in chips) 
Seat 3: Klemqaa ($10 in chips) 
Seat 4: cleiton-005 ($0.99 in chips) 
Seat 5: free Atheist ($22.55 in chips) 
Seat 6: Gissbon ($10 in chips) 
Gissbon: posts small blind $0.05
gazsam2000: posts big blind $0.10
*** HOLE CARDS ***
Tyoma_Kovach: folds 
Klemqaa: folds 
cleiton-005: raises $0.89 to $0.99 and is all-in
free Atheist: folds 
Gissbon: folds 
gazsam2000: calls $0.89
*** FLOP *** [Qs 5c Js]
*** TURN *** [Qs 5c Js] [3h]
*** RIVER *** [Qs 5c Js 3h] [7c]
*** SHOW DOWN ***
gazsam2000: shows [4h 4d] (a pair of Fours)
cleiton-005: shows [Ad Qc] (a pair of Queens)
cleiton-005 cashed out the hand for $0.88 | Cash Out Fee $0.01
*** SUMMARY ***
Total pot $2.03 | Rake $0.09 
Board [Qs 5c Js 3h 7c]
Seat 1: gazsam2000 (big blind) showed [4h 4d] and lost with a pair of Fours
Seat 2: Tyoma_Kovach folded before Flop (didn't bet)
Seat 3: Klemqaa folded before Flop (didn't bet)
Seat 4: cleiton-005 showed [Ad Qc] and won ($1.94) with a pair of Queens (pot not awarded as player cashed out)
Seat 5: free Atheist (button) folded before Flop (didn't bet)
Seat 6: Gissbon (small blind) folded before Flop



PokerStars Hand #222955581322:  Hold'em No Limit ($0.05/$0.10 USD) - 2021/01/23 9:42:37 ET
Table 'Saito II' 6-max Seat #6 is the button
Seat 1: gazsam2000 ($10 in chips) 
Seat 2: Tyoma_Kovach ($18.07 in chips) 
Seat 3: Klemqaa ($10 in chips) 
Seat 4: cleiton-005 ($0.88 in chips) 
Seat 5: free Atheist ($22.55 in chips) 
Seat 6: Gissbon ($10 in chips) 
gazsam2000: posts small blind $0.05
Tyoma_Kovach: posts big blind $0.10
*** HOLE CARDS ***
Klemqaa: folds 
cleiton-005: folds 
free Atheist: folds 
Gissbon: raises $0.15 to $0.25
gazsam2000: folds 
Tyoma_Kovach: calls $0.15
*** FLOP *** [7c 3d 7s]
Tyoma_Kovach: checks 
Gissbon: bets $0.13
Tyoma_Kovach: calls $0.13
*** TURN *** [7c 3d 7s] [5c]
Tyoma_Kovach: checks 
Gissbon: checks 
*** RIVER *** [7c 3d 7s 5c] [Jc]
Tyoma_Kovach: checks 
Gissbon: checks 
*** SHOW DOWN ***
Tyoma_Kovach: shows [5h 5d] (a full house, Fives full of Sevens)
Gissbon: mucks hand 
Tyoma_Kovach collected $0.77 from pot
*** SUMMARY ***
Total pot $0.81 | Rake $0.04 
Board [7c 3d 7s 5c Jc]
Seat 1: gazsam2000 (small blind) folded before Flop
Seat 2: Tyoma_Kovach (big blind) showed [5h 5d] and won ($0.77) with a full house, Fives full of Sevens
Seat 3: Klemqaa folded before Flop (didn't bet)
Seat 4: cleiton-005 folded before Flop (didn't bet)
Seat 5: free Atheist folded before Flop (didn't bet)
Seat 6: Gissbon (button) mucked



PokerStars Hand #222955612686:  Hold'em No Limit ($0.05/$0.10 USD) - 2021/01/23 9:43:40 ET
Table 'Saito II' 6-max Seat #1 is the button
Seat 1: gazsam2000 ($10 in chips) 
Seat 2: Tyoma_Kovach ($18.46 in chips) 
Seat 3: Klemqaa ($10 in chips) 
Seat 4: cleiton-005 ($0.88 in chips) 
Seat 5: free Atheist ($22.55 in chips) 
Seat 6: Gissbon ($10 in chips) 
Tyoma_Kovach: posts small blind $0.05
Klemqaa: posts big blind $0.10
*** HOLE CARDS ***
cleiton-005: raises $0.10 to $0.20
free Atheist: folds 
Gissbon: folds 
gazsam2000: folds 
Tyoma_Kovach: folds 
Klemqaa: folds 
Uncalled bet ($0.10) returned to cleiton-005
cleiton-005 collected $0.25 from pot
cleiton-005: doesn't show hand 
*** SUMMARY ***
Total pot $0.25 | Rake $0 
Seat 1: gazsam2000 (button) folded before Flop (didn't bet)
Seat 2: Tyoma_Kovach (small blind) folded before Flop
Seat 3: Klemqaa (big blind) folded before Flop
Seat 4: cleiton-005 collected ($0.25)
Seat 5: free Atheist folded before Flop (didn't bet)
Seat 6: Gissbon folded before Flop (didn't bet)



PokerStars Hand #222957333413:  Hold'em No Limit ($0.05/$0.10 USD) - 2021/01/23 10:38:38 ET
Table 'Saito II' 6-max Seat #1 is the button
Seat 1: JoaquinBueno ($10 in chips) 
Seat 2: andmats ($4.36 in chips) 
Seat 3: balisstica ($12.37 in chips) 
Seat 4: densyl111 ($3.62 in chips) 
Seat 5: stardrakee ($11.73 in chips) 
andmats: posts small blind $0.05
balisstica: posts big blind $0.10
*** HOLE CARDS ***
densyl111: folds 
stardrakee: raises $0.15 to $0.25
JoaquinBueno: calls $0.25
andmats: calls $0.20
balisstica: raises $1.45 to $1.70
stardrakee: folds 
JoaquinBueno: folds 
andmats: folds 
Uncalled bet ($1.45) returned to balisstica
balisstica collected $1 from pot
balisstica: doesn't show hand 
*** SUMMARY ***
Total pot $1 | Rake $0 
Seat 1: JoaquinBueno (button) folded before Flop
Seat 2: andmats (small blind) folded before Flop
Seat 3: balisstica (big blind) collected ($1)
Seat 4: densyl111 folded before Flop (didn't bet)
Seat 5: stardrakee folded before Flop



PokerStars Hand #222957363075:  Hold'em No Limit ($0.05/$0.10 USD) - 2021/01/23 10:39:32 ET
Table 'Saito II' 6-max Seat #2 is the button
Seat 1: JoaquinBueno ($10 in chips) 
Seat 2: andmats ($4.11 in chips) 
Seat 3: balisstica ($13.12 in chips) 
Seat 4: densyl111 ($3.62 in chips) 
Seat 5: stardrakee ($11.48 in chips) 
balisstica: posts small blind $0.05
densyl111: posts big blind $0.10
SERG244: sits out 
*** HOLE CARDS ***
stardrakee: folds 
JoaquinBueno: raises $0.20 to $0.30
andmats: folds 
balisstica: folds 
densyl111: folds 
Uncalled bet ($0.20) returned to JoaquinBueno
JoaquinBueno collected $0.25 from pot
JoaquinBueno: doesn't show hand 
*** SUMMARY ***
Total pot $0.25 | Rake $0 
Seat 1: JoaquinBueno collected ($0.25)
Seat 2: andmats (button) folded before Flop (didn't bet)
Seat 3: balisstica (small blind) folded before Flop
Seat 4: densyl111 (big blind) folded before Flop
Seat 5: stardrakee folded before Flop (didn't bet)



PokerStars Hand #222957369525:  Hold'em No Limit ($0.05/$0.10 USD) - 2021/01/23 10:39:44 ET
Table 'Saito II' 6-max Seat #3 is the button
Seat 1: JoaquinBueno ($10.15 in chips) 
Seat 2: andmats ($4.11 in chips) 
Seat 3: balisstica ($13.07 in chips) 
Seat 4: densyl111 ($3.52 in chips) 
Seat 5: stardrakee ($11.48 in chips) 
densyl111: posts small blind $0.05
stardrakee: posts big blind $0.10
SERG244: sits out 
*** HOLE CARDS ***
JoaquinBueno: raises $0.20 to $0.30
andmats: raises $0.80 to $1.10
balisstica: folds 
densyl111: folds 
stardrakee: folds 
JoaquinBueno: raises $9.05 to $10.15 and is all-in
andmats: calls $3.01 and is all-in
Uncalled bet ($6.04) returned to JoaquinBueno
*** FLOP *** [Qs Jc Tc]
*** TURN *** [Qs Jc Tc] [Qc]
*** RIVER *** [Qs Jc Tc Qc] [Td]
*** SHOW DOWN ***
JoaquinBueno: shows [Ks Kh] (two pair, Kings and Queens)
andmats: shows [As Jh] (two pair, Queens and Jacks)
JoaquinBueno collected $7.99 from pot
*** SUMMARY ***
Total pot $8.37 | Rake $0.38 
Board [Qs Jc Tc Qc Td]
Seat 1: JoaquinBueno showed [Ks Kh] and won ($7.99) with two pair, Kings and Queens
Seat 2: andmats showed [As Jh] and lost with two pair, Queens and Jacks
Seat 3: balisstica (button) folded before Flop (didn't bet)
Seat 4: densyl111 (small blind) folded before Flop
Seat 5: stardrakee (big blind) folded before Flop



PokerStars Hand #222957390923:  Hold'em No Limit ($0.05/$0.10 USD) - 2021/01/23 10:40:23 ET
Table 'Saito II' 6-max Seat #4 is the button
Seat 1: JoaquinBueno ($14.03 in chips) 
Seat 3: balisstica ($13.07 in chips) 
Seat 4: densyl111 ($3.47 in chips) 
Seat 5: stardrakee ($11.38 in chips) 
Seat 6: SERG244 ($21.38 in chips) 
stardrakee: posts small blind $0.05
SERG244: posts big blind $0.10
*** HOLE CARDS ***
JoaquinBueno: folds 
balisstica: raises $0.20 to $0.30
densyl111: folds 
stardrakee: folds 
SERG244: folds 
Uncalled bet ($0.20) returned to balisstica
balisstica collected $0.25 from pot
balisstica: doesn't show hand 
andmats leaves the table
*** SUMMARY ***
Total pot $0.25 | Rake $0 
Seat 1: JoaquinBueno folded before Flop (didn't bet)
Seat 3: balisstica collected ($0.25)
Seat 4: densyl111 (button) folded before Flop (didn't bet)
Seat 5: stardrakee (small blind) folded before Flop
Seat 6: SERG244 (big blind) folded before Flop



PokerStars Hand #222957395792:  Hold'em No Limit ($0.05/$0.10 USD) - 2021/01/23 10:40:32 ET
Table 'Saito II' 6-max Seat #5 is the button
Seat 1: JoaquinBueno ($14.03 in chips) 
Seat 3: balisstica ($13.22 in chips) 
Seat 4: densyl111 ($3.47 in chips) 
Seat 5: stardrakee ($11.33 in chips) 
Seat 6: SERG244 ($21.28 in chips) 
SERG244: posts small blind $0.05
JoaquinBueno: posts big blind $0.10
*** HOLE CARDS ***
balisstica: folds 
densyl111 has timed out
densyl111: folds 
stardrakee: folds 
SERG244: folds 
Uncalled bet ($0.05) returned to JoaquinBueno
JoaquinBueno collected $0.10 from pot
JoaquinBueno: doesn't show hand 
*** SUMMARY ***
Total pot $0.10 | Rake $0 
Seat 1: JoaquinBueno (big blind) collected ($0.10)
Seat 3: balisstica folded before Flop (didn't bet)
Seat 4: densyl111 folded before Flop (didn't bet)
Seat 5: stardrakee (button) folded before Flop (didn't bet)
Seat 6: SERG244 (small blind) folded before Flop



PokerStars Hand #222957404224:  Hold'em No Limit ($0.05/$0.10 USD) - 2021/01/23 10:40:47 ET
Table 'Saito II' 6-max Seat #6 is the button
Seat 1: JoaquinBueno ($14.08 in chips) 
Seat 3: balisstica ($13.22 in chips) 
Seat 5: stardrakee ($11.33 in chips) 
Seat 6: SERG244 ($21.23 in chips) 
JoaquinBueno: posts small blind $0.05
balisstica: posts big blind $0.10
*** HOLE CARDS ***
stardrakee: folds 
witchdocta00 joins the table at seat #2 
SERG244: raises $0.16 to $0.26
JoaquinBueno: folds 
balisstica: folds 
Uncalled bet ($0.16) returned to SERG244
SERG244 collected $0.25 from pot
SERG244: doesn't show hand 
*** SUMMARY ***
Total pot $0.25 | Rake $0 
Seat 1: JoaquinBueno (small blind) folded before Flop
Seat 3: balisstica (big blind) folded before Flop
Seat 5: stardrakee folded before Flop (didn't bet)
Seat 6: SERG244 (button) collected ($0.25)



PokerStars Hand #222957414841:  Hold'em No Limit ($0.05/$0.10 USD) - 2021/01/23 10:41:06 ET
Table 'Saito II' 6-max Seat #1 is the button
Seat 1: JoaquinBueno ($14.03 in chips) 
Seat 3: balisstica ($13.12 in chips) 
Seat 4: densyl111 ($3.47 in chips) 
Seat 5: stardrakee ($11.33 in chips) 
Seat 6: SERG244 ($21.38 in chips) 
balisstica: posts small blind $0.05
densyl111: posts big blind $0.10
*** HOLE CARDS ***
stardrakee: folds 
SERG244: folds 
JoaquinBueno: folds 
balisstica: folds 
Uncalled bet ($0.05) returned to densyl111
densyl111 collected $0.10 from pot
densyl111: doesn't show hand 
*** SUMMARY ***
Total pot $0.10 | Rake $0 
Seat 1: JoaquinBueno (button) folded before Flop (didn't bet)
Seat 3: balisstica (small blind) folded before Flop
Seat 4: densyl111 (big blind) collected ($0.10)
Seat 5: stardrakee folded before Flop (didn't bet)
Seat 6: SERG244 folded before Flop (didn't bet)



PokerStars Hand #222957423101:  Hold'em No Limit ($0.05/$0.10 USD) - 2021/01/23 10:41:21 ET
Table 'Saito II' 6-max Seat #3 is the button
Seat 1: JoaquinBueno ($14.03 in chips) 
Seat 3: balisstica ($13.07 in chips) 
Seat 4: densyl111 ($3.52 in chips) 
Seat 5: stardrakee ($11.33 in chips) 
Seat 6: SERG244 ($21.38 in chips) 
densyl111: posts small blind $0.05
stardrakee: posts big blind $0.10
witchdocta00: sits out 
*** HOLE CARDS ***
SERG244: folds 
JoaquinBueno: folds 
balisstica: folds 
densyl111: folds 
Uncalled bet ($0.05) returned to stardrakee
stardrakee collected $0.10 from pot
stardrakee: doesn't show hand 
*** SUMMARY ***
Total pot $0.10 | Rake $0 
Seat 1: JoaquinBueno folded before Flop (didn't bet)
Seat 3: balisstica (button) folded before Flop (didn't bet)
Seat 4: densyl111 (small blind) folded before Flop
Seat 5: stardrakee (big blind) collected ($0.10)
Seat 6: SERG244 folded before Flop (didn't bet)



PokerStars Hand #222957431021:  Hold'em No Limit ($0.05/$0.10 USD) - 2021/01/23 10:41:35 ET
Table 'Saito II' 6-max Seat #4 is the button
Seat 1: JoaquinBueno ($14.03 in chips) 
Seat 3: balisstica ($13.07 in chips) 
Seat 4: densyl111 ($3.47 in chips) 
Seat 5: stardrakee ($11.38 in chips) 
Seat 6: SERG244 ($21.38 in chips) 
stardrakee: posts small blind $0.05
SERG244: posts big blind $0.10
witchdocta00: sits out 
*** HOLE CARDS ***
JoaquinBueno: folds 
balisstica: folds 
densyl111 has timed out
densyl111: folds 
stardrakee: raises $0.20 to $0.30
SERG244: folds 
Uncalled bet ($0.20) returned to stardrakee
stardrakee collected $0.20 from pot
stardrakee: doesn't show hand 
*** SUMMARY ***
Total pot $0.20 | Rake $0 
Seat 1: JoaquinBueno folded before Flop (didn't bet)
Seat 3: balisstica folded before Flop (didn't bet)
Seat 4: densyl111 (button) folded before Flop (didn't bet)
Seat 5: stardrakee (small blind) collected ($0.20)
Seat 6: SERG244 (big blind) folded before Flop



PokerStars Hand #222957442624:  Hold'em No Limit ($0.05/$0.10 USD) - 2021/01/23 10:41:56 ET
Table 'Saito II' 6-max Seat #5 is the button
Seat 1: JoaquinBueno ($14.03 in chips) 
Seat 3: balisstica ($13.07 in chips) 
Seat 4: densyl111 ($3.47 in chips) 
Seat 5: stardrakee ($11.48 in chips) 
Seat 6: SERG244 ($21.28 in chips) 
SERG244: posts small blind $0.05
JoaquinBueno: posts big blind $0.10
witchdocta00: sits out 
*** HOLE CARDS ***
balisstica: raises $0.20 to $0.30
densyl111: folds 
stardrakee: folds 
SERG244: folds 
JoaquinBueno: raises $0.70 to $1
balisstica: folds 
Uncalled bet ($0.70) returned to JoaquinBueno
JoaquinBueno collected $0.65 from pot
JoaquinBueno: doesn't show hand 
*** SUMMARY ***
Total pot $0.65 | Rake $0 
Seat 1: JoaquinBueno (big blind) collected ($0.65)
Seat 3: balisstica folded before Flop
Seat 4: densyl111 folded before Flop (didn't bet)
Seat 5: stardrakee (button) folded before Flop (didn't bet)
Seat 6: SERG244 (small blind) folded before Flop



PokerStars Hand #222955940226:  Hold'em No Limit ($0.05/$0.10 USD) - 2021/01/23 9:54:10 ET
Table 'Saito II' 6-max Seat #5 is the button
Seat 1: gazsam2000 ($14.28 in chips) 
Seat 2: Tyoma_Kovach ($16.77 in chips) 
Seat 3: Klemqaa ($10 in chips) 
Seat 4: alVatroos ($10 in chips) 
Seat 5: free Atheist ($20.75 in chips) 
Seat 6: Gissbon ($11.56 in chips) 
Gissbon: posts small blind $0.05
gazsam2000: posts big blind $0.10
*** HOLE CARDS ***
Tyoma_Kovach: folds 
Klemqaa: folds 
alVatroos: folds 
free Atheist: folds 
Gissbon: folds 
Uncalled bet ($0.05) returned to gazsam2000
gazsam2000 collected $0.10 from pot
gazsam2000: doesn't show hand 
*** SUMMARY ***
Total pot $0.10 | Rake $0 
Seat 1: gazsam2000 (big blind) collected ($0.10)
Seat 2: Tyoma_Kovach folded before Flop (didn't bet)
Seat 3: Klemqaa folded before Flop (didn't bet)
Seat 4: alVatroos folded before Flop (didn't bet)
Seat 5: free Atheist (button) folded before Flop (didn't bet)
Seat 6: Gissbon (small blind) folded before Flop



PokerStars Hand #222955944481:  Hold'em No Limit ($0.05/$0.10 USD) - 2021/01/23 9:54:18 ET
Table 'Saito II' 6-max Seat #6 is the button
Seat 1: gazsam2000 ($14.33 in chips) 
Seat 2: Tyoma_Kovach ($16.77 in chips) 
Seat 3: Klemqaa ($10 in chips) 
Seat 4: alVatroos ($10 in chips) 
Seat 5: free Atheist ($20.75 in chips) 
Seat 6: Gissbon ($11.51 in chips) 
gazsam2000: posts small blind $0.05
Tyoma_Kovach: posts big blind $0.10
*** HOLE CARDS ***
Klemqaa: folds 
alVatroos: folds 
free Atheist: calls $0.10
Gissbon: folds 
gazsam2000: raises $0.50 to $0.60
Tyoma_Kovach: folds 
free Atheist: folds 
Uncalled bet ($0.50) returned to gazsam2000
gazsam2000 collected $0.30 from pot
gazsam2000: doesn't show hand 
*** SUMMARY ***
Total pot $0.30 | Rake $0 
Seat 1: gazsam2000 (small blind) collected ($0.30)
Seat 2: Tyoma_Kovach (big blind) folded before Flop
Seat 3: Klemqaa folded before Flop (didn't bet)
Seat 4: alVatroos folded before Flop (didn't bet)
Seat 5: free Atheist folded before Flop
Seat 6: Gissbon (button) folded before Flop (didn't bet)



PokerStars Hand #222955952702:  Hold'em No Limit ($0.05/$0.10 USD) - 2021/01/23 9:54:34 ET
Table 'Saito II' 6-max Seat #1 is the button
Seat 1: gazsam2000 ($14.53 in chips) 
Seat 2: Tyoma_Kovach ($16.67 in chips) 
Seat 3: Klemqaa ($10 in chips) 
Seat 4: alVatroos ($10 in chips) 
Seat 5: free Atheist ($20.65 in chips) 
Seat 6: Gissbon ($11.51 in chips) 
Tyoma_Kovach: posts small blind $0.05
Klemqaa: posts big blind $0.10
*** HOLE CARDS ***
alVatroos: folds 
free Atheist: folds 
Gissbon: raises $0.15 to $0.25
gazsam2000: raises $0.75 to $1
Tyoma_Kovach: folds 
Klemqaa: folds 
Gissbon: folds 
Uncalled bet ($0.75) returned to gazsam2000
gazsam2000 collected $0.65 from pot
gazsam2000: doesn't show hand 
*** SUMMARY ***
Total pot $0.65 | Rake $0 
Seat 1: gazsam2000 (button) collected ($0.65)
Seat 2: Tyoma_Kovach (small blind) folded before Flop
Seat 3: Klemqaa (big blind) folded before Flop
Seat 4: alVatroos folded before Flop (didn't bet)
Seat 5: free Atheist folded before Flop (didn't bet)
Seat 6: Gissbon folded before Flop



PokerStars Hand #222955961029:  Hold'em No Limit ($0.05/$0.10 USD) - 2021/01/23 9:54:50 ET
Table 'Saito II' 6-max Seat #2 is the button
Seat 1: gazsam2000 ($14.93 in chips) 
Seat 2: Tyoma_Kovach ($16.62 in chips) 
Seat 3: Klemqaa ($10 in chips) 
Seat 5: free Atheist ($20.65 in chips) 
Seat 6: Gissbon ($11.26 in chips) 
Klemqaa: posts small blind $0.05
alVatroos: is sitting out 
free Atheist: posts big blind $0.10
*** HOLE CARDS ***
Gissbon: raises $0.15 to $0.25
gazsam2000: folds 
Tyoma_Kovach: folds 
Klemqaa: folds 
free Atheist: folds 
Uncalled bet ($0.15) returned to Gissbon
Gissbon collected $0.25 from pot
Gissbon: doesn't show hand 
*** SUMMARY ***
Total pot $0.25 | Rake $0 
Seat 1: gazsam2000 folded before Flop (didn't bet)
Seat 2: Tyoma_Kovach (button) folded before Flop (didn't bet)
Seat 3: Klemqaa (small blind) folded before Flop
Seat 5: free Atheist (big blind) folded before Flop
Seat 6: Gissbon collected ($0.25)



PokerStars Hand #222955968072:  Hold'em No Limit ($0.05/$0.10 USD) - 2021/01/23 9:55:04 ET
Table 'Saito II' 6-max Seat #3 is the button
Seat 2: Tyoma_Kovach ($16.62 in chips) 
Seat 3: Klemqaa ($10 in chips) 
Seat 5: free Atheist ($20.55 in chips) 
free Atheist: posts small blind $0.05
Gissbon: is sitting out 
gazsam2000: is sitting out 
Tyoma_Kovach: posts big blind $0.10
*** HOLE CARDS ***
Gissbon leaves the table
Klemqaa: raises $0.15 to $0.25
free Atheist: folds 
gazsam2000 leaves the table
Tyoma_Kovach: calls $0.15
*** FLOP *** [3d Qh Tc]
Tyoma_Kovach: checks 
alVatroos leaves the table
Klemqaa: bets $0.29
Tyoma_Kovach: calls $0.29
*** TURN *** [3d Qh Tc] [8c]
Tyoma_Kovach: checks 
Klemqaa: bets $0.50
Tyoma_Kovach: calls $0.50
*** RIVER *** [3d Qh Tc 8c] [7c]
Tyoma_Kovach: checks 
Klemqaa: checks 
*** SHOW DOWN ***
Tyoma_Kovach: shows [Ac Jh] (high card Ace)
Klemqaa: shows [7h 9h] (a pair of Sevens)
Klemqaa collected $2.03 from pot
*** SUMMARY ***
Total pot $2.13 | Rake $0.10 
Board [3d Qh Tc 8c 7c]
Seat 2: Tyoma_Kovach (big blind) showed [Ac Jh] and lost with high card Ace
Seat 3: Klemqaa (button) showed [7h 9h] and won ($2.03) with a pair of Sevens
Seat 5: free Atheist (small blind) folded before Flop



PokerStars Hand #222955983395:  Hold'em No Limit ($0.05/$0.10 USD) - 2021/01/23 9:55:42 ET
Table 'Saito II' 6-max Seat #5 is the button
Seat 2: Tyoma_Kovach ($15.58 in chips) 
Seat 3: Klemqaa ($10.99 in chips) 
Seat 5: free Atheist ($20.50 in chips) 
Tyoma_Kovach: posts small blind $0.05
Klemqaa: posts big blind $0.10
*** HOLE CARDS ***
free Atheist: folds 
Tyoma_Kovach: folds 
Uncalled bet ($0.05) returned to Klemqaa
Klemqaa collected $0.10 from pot
Klemqaa: doesn't show hand 
*** SUMMARY ***
Total pot $0.10 | Rake $0 
Seat 2: Tyoma_Kovach (small blind) folded before Flop
Seat 3: Klemqaa (big blind) collected ($0.10)
Seat 5: free Atheist (button) folded before Flop (didn't bet)



PokerStars Hand #222955987178:  Hold'em No Limit ($0.05/$0.10 USD) - 2021/01/23 9:55:52 ET
Table 'Saito II' 6-max Seat #2 is the button
Seat 2: Tyoma_Kovach ($15.53 in chips) 
Seat 3: Klemqaa ($11.04 in chips) 
Seat 5: free Atheist ($20.50 in chips) 
Klemqaa: posts small blind $0.05
free Atheist: posts big blind $0.10
*** HOLE CARDS ***
Tyoma_Kovach: raises $0.15 to $0.25
Klemqaa: folds 
free Atheist: folds 
Uncalled bet ($0.15) returned to Tyoma_Kovach
Tyoma_Kovach collected $0.25 from pot
Tyoma_Kovach: doesn't show hand 
*** SUMMARY ***
Total pot $0.25 | Rake $0 
Seat 2: Tyoma_Kovach (button) collected ($0.25)
Seat 3: Klemqaa (small blind) folded before Flop
Seat 5: free Atheist (big blind) folded before Flop



PokerStars Hand #222955990222:  Hold'em No Limit ($0.05/$0.10 USD) - 2021/01/23 9:55:59 ET
Table 'Saito II' 6-max Seat #3 is the button
Seat 2: Tyoma_Kovach ($15.68 in chips) 
Seat 3: Klemqaa ($10.99 in chips) 
Seat 5: free Atheist ($20.40 in chips) 
free Atheist: posts small blind $0.05
Tyoma_Kovach: posts big blind $0.10
*** HOLE CARDS ***
Klemqaa: folds 
free Atheist: folds 
Uncalled bet ($0.05) returned to Tyoma_Kovach
Tyoma_Kovach collected $0.10 from pot
Tyoma_Kovach: doesn't show hand 
*** SUMMARY ***
Total pot $0.10 | Rake $0 
Seat 2: Tyoma_Kovach (big blind) collected ($0.10)
Seat 3: Klemqaa (button) folded before Flop (didn't bet)
Seat 5: free Atheist (small blind) folded before Flop



PokerStars Hand #222955993028:  Hold'em No Limit ($0.05/$0.10 USD) - 2021/01/23 9:56:06 ET
Table 'Saito II' 6-max Seat #2 is the button
Seat 2: Tyoma_Kovach ($15.73 in chips) 
Seat 5: free Atheist ($20.35 in chips) 
Tyoma_Kovach: posts small blind $0.05
Klemqaa: is sitting out 
free Atheist: posts big blind $0.10
*** HOLE CARDS ***
Tyoma_Kovach: raises $0.15 to $0.25
free Atheist: calls $0.15
*** FLOP *** [2h 4h 5d]
free Atheist: bets $0.48
Tyoma_Kovach: folds 
Uncalled bet ($0.48) returned to free Atheist
free Atheist collected $0.48 from pot
free Atheist: doesn't show hand 
*** SUMMARY ***
Total pot $0.50 | Rake $0.02 
Board [2h 4h 5d]
Seat 2: Tyoma_Kovach (button) (small blind) folded on the Flop
Seat 5: free Atheist (big blind) collected ($0.48)



PokerStars Hand #222956000466:  Hold'em No Limit ($0.05/$0.10 USD) - 2021/01/23 9:56:25 ET
Table 'Saito II' 6-max Seat #5 is the button
Seat 2: Tyoma_Kovach ($15.48 in chips) 
Seat 5: free Atheist ($20.58 in chips) 
free Atheist: posts small blind $0.05
Tyoma_Kovach: posts big blind $0.10
*** HOLE CARDS ***
free Atheist: calls $0.05
Tyoma_Kovach: checks 
*** FLOP *** [3c 4h Jh]
Tyoma_Kovach: checks 
free Atheist: checks 
*** TURN *** [3c 4h Jh] [As]
Tyoma_Kovach: checks 
free Atheist: checks 
*** RIVER *** [3c 4h Jh As] [7d]
Tyoma_Kovach: checks 
free Atheist: checks 
*** SHOW DOWN ***
Tyoma_Kovach: shows [9h Ks] (high card Ace)
free Atheist: shows [8s 8h] (a pair of Eights)
Klemqaa leaves the table
free Atheist collected $0.19 from pot
*** SUMMARY ***
Total pot $0.20 | Rake $0.01 
Board [3c 4h Jh As 7d]
Seat 2: Tyoma_Kovach (big blind) showed [9h Ks] and lost with high card Ace
Seat 5: free Atheist (button) (small blind) showed [8s 8h] and won ($0.19) with a pair of Eights



PokerStars Hand #222956006289:  Hold'em No Limit ($0.05/$0.10 USD) - 2021/01/23 9:56:39 ET
Table 'Saito II' 6-max Seat #2 is the button
Seat 2: Tyoma_Kovach ($15.38 in chips) 
Seat 5: free Atheist ($20.67 in chips) 
Tyoma_Kovach: posts small blind $0.05
free Atheist: posts big blind $0.10
*** HOLE CARDS ***
Tyoma_Kovach: folds 
Uncalled bet ($0.05) returned to free Atheist
free Atheist collected $0.10 from pot
free Atheist: doesn't show hand 
*** SUMMARY ***
Total pot $0.10 | Rake $0 
Seat 2: Tyoma_Kovach (button) (small blind) folded before Flop
Seat 5: free Atheist (big blind) collected ($0.10)



PokerStars Hand #222956007687:  Hold'em No Limit ($0.05/$0.10 USD) - 2021/01/23 9:56:43 ET
Table 'Saito II' 6-max Seat #5 is the button
Seat 2: Tyoma_Kovach ($15.33 in chips) 
Seat 5: free Atheist ($20.72 in chips) 
free Atheist: posts small blind $0.05
Tyoma_Kovach: posts big blind $0.10
*** HOLE CARDS ***
free Atheist: folds 
Uncalled bet ($0.05) returned to Tyoma_Kovach
Tyoma_Kovach collected $0.10 from pot
Tyoma_Kovach: doesn't show hand 
*** SUMMARY ***
Total pot $0.10 | Rake $0 
Seat 2: Tyoma_Kovach (big blind) collected ($0.10)
Seat 5: free Atheist (button) (small blind) folded before Flop



PokerStars Hand #222956009201:  Hold'em No Limit ($0.05/$0.10 USD) - 2021/01/23 9:56:46 ET
Table 'Saito II' 6-max Seat #2 is the button
Seat 2: Tyoma_Kovach ($15.38 in chips) 
Seat 5: free Atheist ($20.67 in chips) 
Tyoma_Kovach: posts small blind $0.05
free Atheist: posts big blind $0.10
*** HOLE CARDS ***
Tyoma_Kovach: raises $0.15 to $0.25
free Atheist: folds 
Uncalled bet ($0.15) returned to Tyoma_Kovach
Tyoma_Kovach collected $0.20 from pot
Tyoma_Kovach: doesn't show hand 
*** SUMMARY ***
Total pot $0.20 | Rake $0 
Seat 2: Tyoma_Kovach (button) (small blind) collected ($0.20)
Seat 5: free Atheist (big blind) folded before Flop



PokerStars Hand #222956011269:  Hold'em No Limit ($0.05/$0.10 USD) - 2021/01/23 9:56:52 ET
Table 'Saito II' 6-max Seat #5 is the button
Seat 2: Tyoma_Kovach ($15.48 in chips) 
Seat 5: free Atheist ($20.57 in chips) 
free Atheist: posts small blind $0.05
Tyoma_Kovach: posts big blind $0.10
*** HOLE CARDS ***
free Atheist: calls $0.05
Tyoma_Kovach: checks 
*** FLOP *** [Tc 2d Ad]
Tyoma_Kovach: checks 
free Atheist: bets $0.19
Tyoma_Kovach: folds 
Uncalled bet ($0.19) returned to free Atheist
free Atheist collected $0.19 from pot
free Atheist: doesn't show hand 
*** SUMMARY ***
Total pot $0.20 | Rake $0.01 
Board [Tc 2d Ad]
Seat 2: Tyoma_Kovach (big blind) folded on the Flop
Seat 5: free Atheist (button) (small blind) collected ($0.19)



PokerStars Hand #222956015091:  Hold'em No Limit ($0.05/$0.10 USD) - 2021/01/23 9:57:01 ET
Table 'Saito II' 6-max Seat #2 is the button
Seat 2: Tyoma_Kovach ($15.38 in chips) 
Seat 5: free Atheist ($20.66 in chips) 
Tyoma_Kovach: posts small blind $0.05
free Atheist: posts big blind $0.10
*** HOLE CARDS ***
Tyoma_Kovach: folds 
Uncalled bet ($0.05) returned to free Atheist
free Atheist collected $0.10 from pot
free Atheist: doesn't show hand 
*** SUMMARY ***
Total pot $0.10 | Rake $0 
Seat 2: Tyoma_Kovach (button) (small blind) folded before Flop
Seat 5: free Atheist (big blind) collected ($0.10)



PokerStars Hand #222956017063:  Hold'em No Limit ($0.05/$0.10 USD) - 2021/01/23 9:57:06 ET
Table 'Saito II' 6-max Seat #5 is the button
Seat 2: Tyoma_Kovach ($15.33 in chips) 
Seat 5: free Atheist ($20.71 in chips) 
free Atheist: posts small blind $0.05
Tyoma_Kovach: posts big blind $0.10
*** HOLE CARDS ***
free Atheist: folds 
Uncalled bet ($0.05) returned to Tyoma_Kovach
Tyoma_Kovach collected $0.10 from pot
Tyoma_Kovach: doesn't show hand 
*** SUMMARY ***
Total pot $0.10 | Rake $0 
Seat 2: Tyoma_Kovach (big blind) collected ($0.10)
Seat 5: free Atheist (button) (small blind) folded before Flop



PokerStars Hand #222956018851:  Hold'em No Limit ($0.05/$0.10 USD) - 2021/01/23 9:57:10 ET
Table 'Saito II' 6-max Seat #2 is the button
Seat 2: Tyoma_Kovach ($15.38 in chips) 
Seat 5: free Atheist ($20.66 in chips) 
Tyoma_Kovach: posts small blind $0.05
free Atheist: posts big blind $0.10
*** HOLE CARDS ***
Tyoma_Kovach: folds 
Uncalled bet ($0.05) returned to free Atheist
free Atheist collected $0.10 from pot
free Atheist: doesn't show hand 
*** SUMMARY ***
Total pot $0.10 | Rake $0 
Seat 2: Tyoma_Kovach (button) (small blind) folded before Flop
Seat 5: free Atheist (big blind) collected ($0.10)



PokerStars Hand #222956020437:  Hold'em No Limit ($0.05/$0.10 USD) - 2021/01/23 9:57:14 ET
Table 'Saito II' 6-max Seat #5 is the button
Seat 2: Tyoma_Kovach ($15.33 in chips) 
Seat 5: free Atheist ($20.71 in chips) 
free Atheist: posts small blind $0.05
Tyoma_Kovach: posts big blind $0.10
*** HOLE CARDS ***
free Atheist: raises $0.10 to $0.20
Tyoma_Kovach: raises $0.70 to $0.90
densyl111 joins the table at seat #4 
free Atheist: folds 
Uncalled bet ($0.70) returned to Tyoma_Kovach
Tyoma_Kovach collected $0.40 from pot
Tyoma_Kovach: doesn't show hand 
*** SUMMARY ***
Total pot $0.40 | Rake $0 
Seat 2: Tyoma_Kovach (big blind) collected ($0.40)
Seat 5: free Atheist (button) (small blind) folded before Flop



PokerStars Hand #222956024896:  Hold'em No Limit ($0.05/$0.10 USD) - 2021/01/23 9:57:25 ET
Table 'Saito II' 6-max Seat #5 is the button
Seat 2: Tyoma_Kovach ($15.53 in chips) 
Seat 4: densyl111 ($8 in chips) 
Seat 5: free Atheist ($20.51 in chips) 
Tyoma_Kovach: posts small blind $0.05
densyl111: posts big blind $0.10
*** HOLE CARDS ***
free Atheist: folds 
free Atheist leaves the table
Tyoma_Kovach: folds 
Uncalled bet ($0.05) returned to densyl111
densyl111 collected $0.10 from pot
densyl111: doesn't show hand 
*** SUMMARY ***
Total pot $0.10 | Rake $0 
Seat 2: Tyoma_Kovach (small blind) folded before Flop
Seat 4: densyl111 (big blind) collected ($0.10)
Seat 5: free Atheist (button) folded before Flop (didn't bet)



PokerStars Hand #222956027831:  Hold'em No Limit ($0.05/$0.10 USD) - 2021/01/23 9:57:32 ET
Table 'Saito II' 6-max Seat #4 is the button
Seat 2: Tyoma_Kovach ($15.48 in chips) 
Seat 4: densyl111 ($8.05 in chips) 
densyl111: posts small blind $0.05
Tyoma_Kovach: posts big blind $0.10
*** HOLE CARDS ***
densyl111: raises $0.20 to $0.30
Tyoma_Kovach: folds 
Uncalled bet ($0.20) returned to densyl111
densyl111 collected $0.20 from pot
densyl111: doesn't show hand 
*** SUMMARY ***
Total pot $0.20 | Rake $0 
Seat 2: Tyoma_Kovach (big blind) folded before Flop
Seat 4: densyl111 (button) (small blind) collected ($0.20)



PokerStars Hand #222956032044:  Hold'em No Limit ($0.05/$0.10 USD) - 2021/01/23 9:57:43 ET
Table 'Saito II' 6-max Seat #2 is the button
Seat 2: Tyoma_Kovach ($15.38 in chips) 
Seat 4: densyl111 ($8.15 in chips) 
Tyoma_Kovach: posts small blind $0.05
densyl111: posts big blind $0.10
*** HOLE CARDS ***
Tyoma_Kovach: raises $0.15 to $0.25
stardrakee joins the table at seat #5 
densyl111: folds 
Uncalled bet ($0.15) returned to Tyoma_Kovach
Tyoma_Kovach collected $0.20 from pot
Tyoma_Kovach: doesn't show hand 
*** SUMMARY ***
Total pot $0.20 | Rake $0 
Seat 2: Tyoma_Kovach (button) (small blind) collected ($0.20)
Seat 4: densyl111 (big blind) folded before Flop



PokerStars Hand #222956036132:  Hold'em No Limit ($0.05/$0.10 USD) - 2021/01/23 9:57:53 ET
Table 'Saito II' 6-max Seat #4 is the button
Seat 2: Tyoma_Kovach ($15.48 in chips) 
Seat 4: densyl111 ($8.05 in chips) 
densyl111: posts small blind $0.05
Tyoma_Kovach: posts big blind $0.10
*** HOLE CARDS ***
densyl111: calls $0.05
Tyoma_Kovach: checks 
*** FLOP *** [9s 7h Jh]
Tyoma_Kovach: checks 
densyl111: checks 
*** TURN *** [9s 7h Jh] [7c]
Tyoma_Kovach: bets $0.10
densyl111: folds 
Uncalled bet ($0.10) returned to Tyoma_Kovach
Tyoma_Kovach collected $0.19 from pot
Tyoma_Kovach: doesn't show hand 
*** SUMMARY ***
Total pot $0.20 | Rake $0.01 
Board [9s 7h Jh 7c]
Seat 2: Tyoma_Kovach (big blind) collected ($0.19)
Seat 4: densyl111 (button) (small blind) folded on the Turn



PokerStars Hand #222956046373:  Hold'em No Limit ($0.05/$0.10 USD) - 2021/01/23 9:58:18 ET
Table 'Saito II' 6-max Seat #2 is the button
Seat 2: Tyoma_Kovach ($15.57 in chips) 
Seat 4: densyl111 ($7.95 in chips) 
Tyoma_Kovach: posts small blind $0.05
densyl111: posts big blind $0.10
*** HOLE CARDS ***
Tyoma_Kovach: folds 
Uncalled bet ($0.05) returned to densyl111
densyl111 collected $0.10 from pot
densyl111: doesn't show hand 
*** SUMMARY ***
Total pot $0.10 | Rake $0 
Seat 2: Tyoma_Kovach (button) (small blind) folded before Flop
Seat 4: densyl111 (big blind) collected ($0.10)



PokerStars Hand #222956048898:  Hold'em No Limit ($0.05/$0.10 USD) - 2021/01/23 9:58:28 ET
Table 'Saito II' 6-max Seat #4 is the button
Seat 2: Tyoma_Kovach ($15.52 in chips) 
Seat 4: densyl111 ($8 in chips) 
*Gleb*2 joins the table at seat #1 
densyl111: posts small blind $0.05
Tyoma_Kovach: posts big blind $0.10
*** HOLE CARDS ***
densyl111: folds 
Uncalled bet ($0.05) returned to Tyoma_Kovach
Tyoma_Kovach collected $0.10 from pot
Tyoma_Kovach: doesn't show hand 
*** SUMMARY ***
Total pot $0.10 | Rake $0 
Seat 2: Tyoma_Kovach (big blind) collected ($0.10)
Seat 4: densyl111 (button) (small blind) folded before Flop



PokerStars Hand #222956051751:  Hold'em No Limit ($0.05/$0.10 USD) - 2021/01/23 9:58:33 ET
Table 'Saito II' 6-max Seat #2 is the button
Seat 1: *Gleb*2 ($8 in chips) 
Seat 2: Tyoma_Kovach ($15.57 in chips) 
Seat 4: densyl111 ($7.95 in chips) 
densyl111: posts small blind $0.05
*Gleb*2: posts big blind $0.10
*** HOLE CARDS ***
Tyoma_Kovach: raises $0.15 to $0.25
densyl111: calls $0.20
*Gleb*2: calls $0.15
*** FLOP *** [Qc Ad 8s]
densyl111: checks 
*Gleb*2: bets $0.20
Tyoma_Kovach: calls $0.20
densyl111: folds 
*** TURN *** [Qc Ad 8s] [Th]
*Gleb*2: checks 
Tyoma_Kovach: checks 
*** RIVER *** [Qc Ad 8s Th] [5s]
*Gleb*2: bets $0.30
balisstica joins the table at seat #3 
aleks2272 joins the table at seat #6 
Tyoma_Kovach: calls $0.30
*** SHOW DOWN ***
*Gleb*2: shows [2c 8c] (a pair of Eights)
Tyoma_Kovach: shows [Jc Js] (a pair of Jacks)
Tyoma_Kovach collected $1.67 from pot
*** SUMMARY ***
Total pot $1.75 | Rake $0.08 
Board [Qc Ad 8s Th 5s]
Seat 1: *Gleb*2 (big blind) showed [2c 8c] and lost with a pair of Eights
Seat 2: Tyoma_Kovach (button) showed [Jc Js] and won ($1.67) with a pair of Jacks
Seat 4: densyl111 (small blind) folded on the Flop



PokerStars Hand #222956070732:  Hold'em No Limit ($0.05/$0.10 USD) - 2021/01/23 9:59:19 ET
Table 'Saito II' 6-max Seat #4 is the button
Seat 1: *Gleb*2 ($7.25 in chips) 
Seat 2: Tyoma_Kovach ($16.49 in chips) 
Seat 4: densyl111 ($7.70 in chips) 
*Gleb*2: posts small blind $0.05
Tyoma_Kovach: posts big blind $0.10
balisstica: sits out 
*** HOLE CARDS ***
densyl111: raises $0.20 to $0.30
*Gleb*2: calls $0.25
Tyoma_Kovach: calls $0.20
*** FLOP *** [Td 4d Th]
*Gleb*2: checks 
Tyoma_Kovach: checks 
densyl111: checks 
*** TURN *** [Td 4d Th] [2h]
*Gleb*2: checks 
Tyoma_Kovach: bets $0.65
densyl111: folds 
*Gleb*2: folds 
Uncalled bet ($0.65) returned to Tyoma_Kovach
Tyoma_Kovach collected $0.86 from pot
Tyoma_Kovach: doesn't show hand 
*** SUMMARY ***
Total pot $0.90 | Rake $0.04 
Board [Td 4d Th 2h]
Seat 1: *Gleb*2 (small blind) folded on the Turn
Seat 2: Tyoma_Kovach (big blind) collected ($0.86)
Seat 4: densyl111 (button) folded on the Turn



PokerStars Hand #222956083484:  Hold'em No Limit ($0.05/$0.10 USD) - 2021/01/23 9:59:50 ET
Table 'Saito II' 6-max Seat #1 is the button
Seat 1: *Gleb*2 ($6.95 in chips) 
Seat 2: Tyoma_Kovach ($17.05 in chips) 
Seat 3: balisstica ($10 in chips) 
Seat 4: densyl111 ($7.40 in chips) 
Seat 6: aleks2272 ($8 in chips) 
Tyoma_Kovach: posts small blind $0.05
balisstica: posts big blind $0.10
aleks2272: posts big blind $0.10
*** HOLE CARDS ***
densyl111: folds 
aleks2272: checks 
*Gleb*2: folds 
Tyoma_Kovach: folds 
balisstica: checks 
*** FLOP *** [Kc 9c 2d]
balisstica: checks 
aleks2272: bets $0.24
balisstica: calls $0.24
*** TURN *** [Kc 9c 2d] [As]
balisstica: checks 
aleks2272: checks 
*** RIVER *** [Kc 9c 2d As] [Kh]
balisstica: checks 
aleks2272: bets $0.70
balisstica: raises $1.30 to $2
aleks2272: folds 
Uncalled bet ($1.30) returned to balisstica
balisstica collected $2.03 from pot
balisstica: doesn't show hand 
*** SUMMARY ***
Total pot $2.13 | Rake $0.10 
Board [Kc 9c 2d As Kh]
Seat 1: *Gleb*2 (button) folded before Flop (didn't bet)
Seat 2: Tyoma_Kovach (small blind) folded before Flop
Seat 3: balisstica (big blind) collected ($2.03)
Seat 4: densyl111 folded before Flop (didn't bet)
Seat 6: aleks2272 folded on the River



PokerStars Hand #222956108444:  Hold'em No Limit ($0.05/$0.10 USD) - 2021/01/23 10:00:50 ET
Table 'Saito II' 6-max Seat #2 is the button
Seat 1: *Gleb*2 ($6.95 in chips) 
Seat 2: Tyoma_Kovach ($17 in chips) 
Seat 3: balisstica ($10.99 in chips) 
Seat 4: densyl111 ($7.40 in chips) 
Seat 6: aleks2272 ($6.96 in chips) 
balisstica: posts small blind $0.05
densyl111: posts big blind $0.10
stardrakee: sits out 
*** HOLE CARDS ***
aleks2272: calls $0.10
*Gleb*2 has timed out
*Gleb*2: folds 
Tyoma_Kovach: folds 
balisstica: folds 
densyl111: raises $0.20 to $0.30
aleks2272: calls $0.20
*** FLOP *** [Qh Kc Qd]
densyl111: checks 
aleks2272: checks 
*** TURN *** [Qh Kc Qd] [9s]
densyl111: checks 
aleks2272: checks 
*** RIVER *** [Qh Kc Qd 9s] [9c]
densyl111: bets $0.30
aleks2272: raises $1.22 to $1.52
densyl111: folds 
Uncalled bet ($1.22) returned to aleks2272
aleks2272 collected $1.19 from pot
aleks2272: doesn't show hand 
*** SUMMARY ***
Total pot $1.25 | Rake $0.06 
Board [Qh Kc Qd 9s 9c]
Seat 1: *Gleb*2 folded before Flop (didn't bet)
Seat 2: Tyoma_Kovach (button) folded before Flop (didn't bet)
Seat 3: balisstica (small blind) folded before Flop
Seat 4: densyl111 (big blind) folded on the River
Seat 6: aleks2272 collected ($1.19)



PokerStars Hand #222956133281:  Hold'em No Limit ($0.05/$0.10 USD) - 2021/01/23 10:01:43 ET
Table 'Saito II' 6-max Seat #3 is the button
Seat 1: *Gleb*2 ($6.95 in chips) 
Seat 2: Tyoma_Kovach ($17 in chips) 
Seat 3: balisstica ($10.94 in chips) 
Seat 4: densyl111 ($6.80 in chips) 
Seat 5: stardrakee ($10 in chips) 
Seat 6: aleks2272 ($7.55 in chips) 
densyl111: posts small blind $0.05
stardrakee: posts big blind $0.10
*** HOLE CARDS ***
aleks2272: calls $0.10
*Gleb*2: folds 
Tyoma_Kovach: folds 
balisstica: folds 
densyl111: calls $0.05
stardrakee: raises $0.40 to $0.50
aleks2272: calls $0.40
densyl111: calls $0.40
*** FLOP *** [3s Kd 9s]
densyl111: checks 
stardrakee: bets $1
aleks2272: folds 
densyl111: folds 
Uncalled bet ($1) returned to stardrakee
stardrakee collected $1.43 from pot
stardrakee: doesn't show hand 
*** SUMMARY ***
Total pot $1.50 | Rake $0.07 
Board [3s Kd 9s]
Seat 1: *Gleb*2 folded before Flop (didn't bet)
Seat 2: Tyoma_Kovach folded before Flop (didn't bet)
Seat 3: balisstica (button) folded before Flop (didn't bet)
Seat 4: densyl111 (small blind) folded on the Flop
Seat 5: stardrakee (big blind) collected ($1.43)
Seat 6: aleks2272 folded on the Flop



PokerStars Hand #222956148587:  Hold'em No Limit ($0.05/$0.10 USD) - 2021/01/23 10:02:13 ET
Table 'Saito II' 6-max Seat #4 is the button
Seat 1: *Gleb*2 ($6.95 in chips) 
Seat 2: Tyoma_Kovach ($17 in chips) 
Seat 3: balisstica ($10.94 in chips) 
Seat 4: densyl111 ($6.30 in chips) 
Seat 5: stardrakee ($10.93 in chips) 
Seat 6: aleks2272 ($7.05 in chips) 
stardrakee: posts small blind $0.05
aleks2272: posts big blind $0.10
*** HOLE CARDS ***
*Gleb*2: folds 
Tyoma_Kovach: folds 
balisstica has timed out
balisstica: folds 
densyl111 has timed out
densyl111: folds 
stardrakee: folds 
Uncalled bet ($0.05) returned to aleks2272
aleks2272 collected $0.10 from pot
aleks2272: doesn't show hand 
*** SUMMARY ***
Total pot $0.10 | Rake $0 
Seat 1: *Gleb*2 folded before Flop (didn't bet)
Seat 2: Tyoma_Kovach folded before Flop (didn't bet)
Seat 3: balisstica folded before Flop (didn't bet)
Seat 4: densyl111 (button) folded before Flop (didn't bet)
Seat 5: stardrakee (small blind) folded before Flop
Seat 6: aleks2272 (big blind) collected ($0.10)



PokerStars Hand #222956164751:  Hold'em No Limit ($0.05/$0.10 USD) - 2021/01/23 10:02:46 ET
Table 'Saito II' 6-max Seat #5 is the button
Seat 1: *Gleb*2 ($6.95 in chips) 
Seat 2: Tyoma_Kovach ($17 in chips) 
Seat 3: balisstica ($10.94 in chips) 
Seat 4: densyl111 ($6.30 in chips) 
Seat 5: stardrakee ($10.88 in chips) 
Seat 6: aleks2272 ($7.10 in chips) 
aleks2272: posts small blind $0.05
*Gleb*2: posts big blind $0.10
*** HOLE CARDS ***
Tyoma_Kovach: folds 
balisstica: folds 
densyl111: folds 
stardrakee: raises $0.15 to $0.25
aleks2272: folds 
*Gleb*2: raises $0.35 to $0.60
stardrakee: calls $0.35
*** FLOP *** [6s 3d 9d]
*Gleb*2: checks 
stardrakee: bets $0.63
*Gleb*2: calls $0.63
*** TURN *** [6s 3d 9d] [2s]
*Gleb*2: checks 
stardrakee: checks 
*** RIVER *** [6s 3d 9d 2s] [5h]
*Gleb*2: bets $1.40
stardrakee: calls $1.40
*** SHOW DOWN ***
*Gleb*2: shows [Ah Kd] (high card Ace)
stardrakee: shows [Jh Jd] (a pair of Jacks)
stardrakee collected $5.07 from pot
*** SUMMARY ***
Total pot $5.31 | Rake $0.24 
Board [6s 3d 9d 2s 5h]
Seat 1: *Gleb*2 (big blind) showed [Ah Kd] and lost with high card Ace
Seat 2: Tyoma_Kovach folded before Flop (didn't bet)
Seat 3: balisstica folded before Flop (didn't bet)
Seat 4: densyl111 folded before Flop (didn't bet)
Seat 5: stardrakee (button) showed [Jh Jd] and won ($5.07) with a pair of Jacks
Seat 6: aleks2272 (small blind) folded before Flop



PokerStars Hand #222956203393:  Hold'em No Limit ($0.05/$0.10 USD) - 2021/01/23 10:03:49 ET
Table 'Saito II' 6-max Seat #6 is the button
Seat 1: *Gleb*2 ($4.32 in chips) 
Seat 2: Tyoma_Kovach ($17 in chips) 
Seat 3: balisstica ($10.94 in chips) 
Seat 4: densyl111 ($6.30 in chips) 
Seat 5: stardrakee ($13.32 in chips) 
Seat 6: aleks2272 ($7.05 in chips) 
*Gleb*2: posts small blind $0.05
Tyoma_Kovach: posts big blind $0.10
*** HOLE CARDS ***
balisstica: folds 
densyl111: raises $0.10 to $0.20
stardrakee: folds 
aleks2272: calls $0.20
*Gleb*2: raises $0.40 to $0.60
Tyoma_Kovach: folds 
densyl111: calls $0.40
aleks2272: calls $0.40
*** FLOP *** [4h 7d 8c]
*Gleb*2: checks 
densyl111: checks 
aleks2272: checks 
*** TURN *** [4h 7d 8c] [5h]
*Gleb*2: bets $0.70
densyl111: calls $0.70
aleks2272: calls $0.70
*** RIVER *** [4h 7d 8c 5h] [2d]
*Gleb*2: bets $0.10
densyl111: calls $0.10
aleks2272: raises $4.12 to $4.22
*Gleb*2: calls $2.92 and is all-in
densyl111: folds 
Uncalled bet ($1.20) returned to aleks2272
*** SHOW DOWN ***
aleks2272: shows [3d Ah] (a straight, Ace to Five)
*Gleb*2: shows [Kh Kd] (a pair of Kings)
aleks2272 collected $9.68 from pot
*** SUMMARY ***
Total pot $10.14 | Rake $0.46 
Board [4h 7d 8c 5h 2d]
Seat 1: *Gleb*2 (small blind) showed [Kh Kd] and lost with a pair of Kings
Seat 2: Tyoma_Kovach (big blind) folded before Flop
Seat 3: balisstica folded before Flop (didn't bet)
Seat 4: densyl111 folded on the River
Seat 5: stardrakee folded before Flop (didn't bet)
Seat 6: aleks2272 (button) showed [3d Ah] and won ($9.68) with a straight, Ace to Five



PokerStars Hand #222956244555:  Hold'em No Limit ($0.05/$0.10 USD) - 2021/01/23 10:05:08 ET
Table 'Saito II' 6-max Seat #2 is the button
Seat 2: Tyoma_Kovach ($16.90 in chips) 
Seat 3: balisstica ($10.94 in chips) 
Seat 4: densyl111 ($4.90 in chips) 
Seat 5: stardrakee ($13.32 in chips) 
Seat 6: aleks2272 ($12.41 in chips) 
balisstica: posts small blind $0.05
densyl111: posts big blind $0.10
*** HOLE CARDS ***
stardrakee: folds 
aleks2272: folds 
Tyoma_Kovach: raises $0.15 to $0.25
*Gleb*2 leaves the table
balisstica: folds 
casimiro124 joins the table at seat #1 
densyl111: calls $0.15
*** FLOP *** [Ah Jd Th]
densyl111: checks 
Tyoma_Kovach: bets $0.17
densyl111: folds 
Uncalled bet ($0.17) returned to Tyoma_Kovach
Tyoma_Kovach collected $0.53 from pot
Tyoma_Kovach: doesn't show hand 
*** SUMMARY ***
Total pot $0.55 | Rake $0.02 
Board [Ah Jd Th]
Seat 2: Tyoma_Kovach (button) collected ($0.53)
Seat 3: balisstica (small blind) folded before Flop
Seat 4: densyl111 (big blind) folded on the Flop
Seat 5: stardrakee folded before Flop (didn't bet)
Seat 6: aleks2272 folded before Flop (didn't bet)



PokerStars Hand #222956269801:  Hold'em No Limit ($0.05/$0.10 USD) - 2021/01/23 10:05:56 ET
Table 'Saito II' 6-max Seat #3 is the button
Seat 2: Tyoma_Kovach ($17.18 in chips) 
Seat 3: balisstica ($10.89 in chips) 
Seat 4: densyl111 ($4.65 in chips) 
Seat 5: stardrakee ($13.32 in chips) 
Seat 6: aleks2272 ($12.41 in chips) 
densyl111: posts small blind $0.05
stardrakee: posts big blind $0.10
casimiro124: sits out 
*** HOLE CARDS ***
aleks2272: folds 
Tyoma_Kovach: folds 
balisstica: raises $0.15 to $0.25
densyl111: calls $0.20
stardrakee: folds 
*** FLOP *** [6c 2s 4h]
densyl111: checks 
balisstica: bets $0.19
densyl111: raises $4.21 to $4.40 and is all-in
balisstica: folds 
Uncalled bet ($4.21) returned to densyl111
densyl111 collected $0.94 from pot
*** SUMMARY ***
Total pot $0.98 | Rake $0.04 
Board [6c 2s 4h]
Seat 2: Tyoma_Kovach folded before Flop (didn't bet)
Seat 3: balisstica (button) folded on the Flop
Seat 4: densyl111 (small blind) collected ($0.94)
Seat 5: stardrakee (big blind) folded before Flop
Seat 6: aleks2272 folded before Flop (didn't bet)



PokerStars Hand #222956284500:  Hold'em No Limit ($0.05/$0.10 USD) - 2021/01/23 10:06:24 ET
Table 'Saito II' 6-max Seat #4 is the button
Seat 2: Tyoma_Kovach ($17.18 in chips) 
Seat 3: balisstica ($10.45 in chips) 
Seat 4: densyl111 ($5.15 in chips) 
Seat 5: stardrakee ($13.22 in chips) 
Seat 6: aleks2272 ($12.41 in chips) 
stardrakee: posts small blind $0.05
aleks2272: posts big blind $0.10
casimiro124: sits out 
*** HOLE CARDS ***
Tyoma_Kovach: folds 
balisstica: folds 
densyl111 has timed out
densyl111: folds 
stardrakee: folds 
Uncalled bet ($0.05) returned to aleks2272
aleks2272 collected $0.10 from pot
aleks2272: doesn't show hand 
*** SUMMARY ***
Total pot $0.10 | Rake $0 
Seat 2: Tyoma_Kovach folded before Flop (didn't bet)
Seat 3: balisstica folded before Flop (didn't bet)
Seat 4: densyl111 (button) folded before Flop (didn't bet)
Seat 5: stardrakee (small blind) folded before Flop
Seat 6: aleks2272 (big blind) collected ($0.10)



PokerStars Hand #222956293917:  Hold'em No Limit ($0.05/$0.10 USD) - 2021/01/23 10:06:42 ET
Table 'Saito II' 6-max Seat #5 is the button
Seat 1: casimiro124 ($10 in chips) 
Seat 2: Tyoma_Kovach ($17.18 in chips) 
Seat 3: balisstica ($10.45 in chips) 
Seat 5: stardrakee ($13.17 in chips) 
Seat 6: aleks2272 ($12.46 in chips) 
aleks2272: posts small blind $0.05
casimiro124: posts big blind $0.10
*** HOLE CARDS ***
Tyoma_Kovach: folds 
balisstica has timed out
balisstica: folds 
stardrakee: folds 
aleks2272: raises $0.20 to $0.30
casimiro124: folds 
Uncalled bet ($0.20) returned to aleks2272
aleks2272 collected $0.20 from pot
aleks2272: doesn't show hand 
*** SUMMARY ***
Total pot $0.20 | Rake $0 
Seat 1: casimiro124 (big blind) folded before Flop
Seat 2: Tyoma_Kovach folded before Flop (didn't bet)
Seat 3: balisstica folded before Flop (didn't bet)
Seat 5: stardrakee (button) folded before Flop (didn't bet)
Seat 6: aleks2272 (small blind) collected ($0.20)



PokerStars Hand #222956306319:  Hold'em No Limit ($0.05/$0.10 USD) - 2021/01/23 10:07:05 ET
Table 'Saito II' 6-max Seat #6 is the button
Seat 1: casimiro124 ($10 in chips) 
Seat 2: Tyoma_Kovach ($17.18 in chips) 
Seat 3: balisstica ($10.45 in chips) 
Seat 4: densyl111 ($5.15 in chips) 
Seat 5: stardrakee ($13.17 in chips) 
Seat 6: aleks2272 ($12.56 in chips) 
casimiro124: posts small blind $0.05
Tyoma_Kovach: posts big blind $0.10
*** HOLE CARDS ***
balisstica: folds 
densyl111 has timed out
densyl111: folds 
stardrakee: folds 
aleks2272: raises $0.25 to $0.35
casimiro124: folds 
Tyoma_Kovach: folds 
Uncalled bet ($0.25) returned to aleks2272
aleks2272 collected $0.25 from pot
aleks2272: doesn't show hand 
*** SUMMARY ***
Total pot $0.25 | Rake $0 
Seat 1: casimiro124 (small blind) folded before Flop
Seat 2: Tyoma_Kovach (big blind) folded before Flop
Seat 3: balisstica folded before Flop (didn't bet)
Seat 4: densyl111 folded before Flop (didn't bet)
Seat 5: stardrakee folded before Flop (didn't bet)
Seat 6: aleks2272 (button) collected ($0.25)



PokerStars Hand #222956318638:  Hold'em No Limit ($0.05/$0.10 USD) - 2021/01/23 10:07:29 ET
Table 'Saito II' 6-max Seat #1 is the button
Seat 1: casimiro124 ($10 in chips) 
Seat 2: Tyoma_Kovach ($17.08 in chips) 
Seat 3: balisstica ($10.45 in chips) 
Seat 5: stardrakee ($13.17 in chips) 
Seat 6: aleks2272 ($12.71 in chips) 
Tyoma_Kovach: posts small blind $0.05
balisstica: posts big blind $0.10
*** HOLE CARDS ***
stardrakee: folds 
aleks2272: folds 
casimiro124: raises $0.15 to $0.25
Tyoma_Kovach: folds 
balisstica: folds 
Uncalled bet ($0.15) returned to casimiro124
casimiro124 collected $0.25 from pot
casimiro124: doesn't show hand 
*** SUMMARY ***
Total pot $0.25 | Rake $0 
Seat 1: casimiro124 (button) collected ($0.25)
Seat 2: Tyoma_Kovach (small blind) folded before Flop
Seat 3: balisstica (big blind) folded before Flop
Seat 5: stardrakee folded before Flop (didn't bet)
Seat 6: aleks2272 folded before Flop (didn't bet)



PokerStars Hand #222956330284:  Hold'em No Limit ($0.05/$0.10 USD) - 2021/01/23 10:07:51 ET
Table 'Saito II' 6-max Seat #2 is the button
Seat 1: casimiro124 ($10.15 in chips) 
Seat 2: Tyoma_Kovach ($17.03 in chips) 
Seat 3: balisstica ($10.35 in chips) 
Seat 4: densyl111 ($5.15 in chips) 
Seat 5: stardrakee ($13.17 in chips) 
Seat 6: aleks2272 ($12.71 in chips) 
balisstica: posts small blind $0.05
densyl111: posts big blind $0.10
*** HOLE CARDS ***
stardrakee: folds 
aleks2272: folds 
casimiro124: raises $0.15 to $0.25
Tyoma_Kovach: folds 
balisstica: folds 
densyl111: calls $0.15
*** FLOP *** [7c 4h Th]
densyl111: checks 
casimiro124: checks 
*** TURN *** [7c 4h Th] [8c]
densyl111: bets $0.53
casimiro124: folds 
Uncalled bet ($0.53) returned to densyl111
densyl111 collected $0.53 from pot
*** SUMMARY ***
Total pot $0.55 | Rake $0.02 
Board [7c 4h Th 8c]
Seat 1: casimiro124 folded on the Turn
Seat 2: Tyoma_Kovach (button) folded before Flop (didn't bet)
Seat 3: balisstica (small blind) folded before Flop
Seat 4: densyl111 (big blind) collected ($0.53)
Seat 5: stardrakee folded before Flop (didn't bet)
Seat 6: aleks2272 folded before Flop (didn't bet)



PokerStars Hand #222956350699:  Hold'em No Limit ($0.05/$0.10 USD) - 2021/01/23 10:08:31 ET
Table 'Saito II' 6-max Seat #3 is the button
Seat 1: casimiro124 ($10 in chips) 
Seat 2: Tyoma_Kovach ($17.03 in chips) 
Seat 3: balisstica ($10.30 in chips) 
Seat 4: densyl111 ($5.43 in chips) 
Seat 5: stardrakee ($13.17 in chips) 
Seat 6: aleks2272 ($12.71 in chips) 
densyl111: posts small blind $0.05
stardrakee: posts big blind $0.10
*** HOLE CARDS ***
aleks2272: folds 
casimiro124: folds 
Tyoma_Kovach: folds 
balisstica: raises $0.15 to $0.25
densyl111: folds 
stardrakee: raises $0.75 to $1
balisstica: folds 
Uncalled bet ($0.75) returned to stardrakee
stardrakee collected $0.55 from pot
stardrakee: doesn't show hand 
*** SUMMARY ***
Total pot $0.55 | Rake $0 
Seat 1: casimiro124 folded before Flop (didn't bet)
Seat 2: Tyoma_Kovach folded before Flop (didn't bet)
Seat 3: balisstica (button) folded before Flop
Seat 4: densyl111 (small blind) folded before Flop
Seat 5: stardrakee (big blind) collected ($0.55)
Seat 6: aleks2272 folded before Flop (didn't bet)



PokerStars Hand #222956363912:  Hold'em No Limit ($0.05/$0.10 USD) - 2021/01/23 10:08:56 ET
Table 'Saito II' 6-max Seat #4 is the button
Seat 1: casimiro124 ($10 in chips) 
Seat 2: Tyoma_Kovach ($17.03 in chips) 
Seat 3: balisstica ($10.05 in chips) 
Seat 4: densyl111 ($5.38 in chips) 
Seat 5: stardrakee ($13.47 in chips) 
Seat 6: aleks2272 ($12.71 in chips) 
stardrakee: posts small blind $0.05
aleks2272: posts big blind $0.10
*** HOLE CARDS ***
casimiro124: folds 
Tyoma_Kovach: folds 
balisstica: raises $0.20 to $0.30
densyl111: folds 
stardrakee: folds 
aleks2272: calls $0.20
*** FLOP *** [As 2d 9c]
aleks2272: checks 
balisstica: bets $0.31
aleks2272: folds 
Uncalled bet ($0.31) returned to balisstica
balisstica collected $0.62 from pot
balisstica: doesn't show hand 
*** SUMMARY ***
Total pot $0.65 | Rake $0.03 
Board [As 2d 9c]
Seat 1: casimiro124 folded before Flop (didn't bet)
Seat 2: Tyoma_Kovach folded before Flop (didn't bet)
Seat 3: balisstica collected ($0.62)
Seat 4: densyl111 (button) folded before Flop (didn't bet)
Seat 5: stardrakee (small blind) folded before Flop
Seat 6: aleks2272 (big blind) folded on the Flop



PokerStars Hand #222956382997:  Hold'em No Limit ($0.05/$0.10 USD) - 2021/01/23 10:09:33 ET
Table 'Saito II' 6-max Seat #5 is the button
Seat 1: casimiro124 ($10 in chips) 
Seat 2: Tyoma_Kovach ($17.03 in chips) 
Seat 3: balisstica ($10.37 in chips) 
Seat 4: densyl111 ($5.38 in chips) 
Seat 5: stardrakee ($13.42 in chips) 
Seat 6: aleks2272 ($12.41 in chips) 
aleks2272: posts small blind $0.05
casimiro124: posts big blind $0.10
*** HOLE CARDS ***
Tyoma_Kovach: folds 
balisstica: folds 
densyl111: calls $0.10
stardrakee: folds 
aleks2272: folds 
casimiro124: checks 
*** FLOP *** [Qc Th Qh]
casimiro124: checks 
densyl111: checks 
*** TURN *** [Qc Th Qh] [4c]
casimiro124: checks 
densyl111 has timed out
densyl111: checks 
*** RIVER *** [Qc Th Qh 4c] [Jd]
casimiro124: checks 
densyl111: checks 
*** SHOW DOWN ***
casimiro124: shows [4d 6c] (two pair, Queens and Fours)
densyl111: shows [5d 4h] (two pair, Queens and Fours)
casimiro124 collected $0.12 from pot
densyl111 collected $0.12 from pot
*** SUMMARY ***
Total pot $0.25 | Rake $0.01 
Board [Qc Th Qh 4c Jd]
Seat 1: casimiro124 (big blind) showed [4d 6c] and won ($0.12) with two pair, Queens and Fours
Seat 2: Tyoma_Kovach folded before Flop (didn't bet)
Seat 3: balisstica folded before Flop (didn't bet)
Seat 4: densyl111 showed [5d 4h] and won ($0.12) with two pair, Queens and Fours
Seat 5: stardrakee (button) folded before Flop (didn't bet)
Seat 6: aleks2272 (small blind) folded before Flop



PokerStars Hand #222956415626:  Hold'em No Limit ($0.05/$0.10 USD) - 2021/01/23 10:10:35 ET
Table 'Saito II' 6-max Seat #6 is the button
Seat 1: casimiro124 ($10.02 in chips) 
Seat 2: Tyoma_Kovach ($17.03 in chips) 
Seat 3: balisstica ($10.37 in chips) 
Seat 4: densyl111 ($5.40 in chips) 
Seat 5: stardrakee ($13.42 in chips) 
Seat 6: aleks2272 ($12.36 in chips) 
casimiro124: posts small blind $0.05
Tyoma_Kovach: posts big blind $0.10
*** HOLE CARDS ***
balisstica: folds 
densyl111: raises $0.10 to $0.20
stardrakee: folds 
aleks2272 has timed out
aleks2272: folds 
casimiro124: folds 
Tyoma_Kovach: calls $0.10
*** FLOP *** [3c 3d Qs]
Tyoma_Kovach: checks 
densyl111: checks 
*** TURN *** [3c 3d Qs] [8c]
Tyoma_Kovach: bets $0.32
densyl111: folds 
Uncalled bet ($0.32) returned to Tyoma_Kovach
Tyoma_Kovach collected $0.43 from pot
Tyoma_Kovach: doesn't show hand 
*** SUMMARY ***
Total pot $0.45 | Rake $0.02 
Board [3c 3d Qs 8c]
Seat 1: casimiro124 (small blind) folded before Flop
Seat 2: Tyoma_Kovach (big blind) collected ($0.43)
Seat 3: balisstica folded before Flop (didn't bet)
Seat 4: densyl111 folded on the Turn
Seat 5: stardrakee folded before Flop (didn't bet)
Seat 6: aleks2272 (button) folded before Flop (didn't bet)



PokerStars Hand #222956440067:  Hold'em No Limit ($0.05/$0.10 USD) - 2021/01/23 10:11:21 ET
Table 'Saito II' 6-max Seat #1 is the button
Seat 1: casimiro124 ($10 in chips) 
Seat 2: Tyoma_Kovach ($17.26 in chips) 
Seat 3: balisstica ($10.37 in chips) 
Seat 4: densyl111 ($5.20 in chips) 
Seat 5: stardrakee ($13.42 in chips) 
Tyoma_Kovach: posts small blind $0.05
balisstica: posts big blind $0.10
*** HOLE CARDS ***
densyl111: raises $0.10 to $0.20
stardrakee: folds 
casimiro124: folds 
Tyoma_Kovach: calls $0.15
balisstica: raises $0.40 to $0.60
densyl111: calls $0.40
Tyoma_Kovach: calls $0.40
*** FLOP *** [5s 9s 6d]
Tyoma_Kovach: checks 
balisstica: checks 
densyl111: checks 
*** TURN *** [5s 9s 6d] [3c]
Tyoma_Kovach: checks 
balisstica: checks 
densyl111: checks 
*** RIVER *** [5s 9s 6d 3c] [8h]
Tyoma_Kovach: checks 
balisstica: checks 
densyl111: bets $1.72
Tyoma_Kovach: folds 
balisstica: folds 
Uncalled bet ($1.72) returned to densyl111
densyl111 collected $1.72 from pot
densyl111: doesn't show hand 
*** SUMMARY ***
Total pot $1.80 | Rake $0.08 
Board [5s 9s 6d 3c 8h]
Seat 1: casimiro124 (button) folded before Flop (didn't bet)
Seat 2: Tyoma_Kovach (small blind) folded on the River
Seat 3: balisstica (big blind) folded on the River
Seat 4: densyl111 collected ($1.72)
Seat 5: stardrakee folded before Flop (didn't bet)



PokerStars Hand #222956485122:  Hold'em No Limit ($0.05/$0.10 USD) - 2021/01/23 10:12:46 ET
Table 'Saito II' 6-max Seat #2 is the button
Seat 1: casimiro124 ($10 in chips) 
Seat 2: Tyoma_Kovach ($16.66 in chips) 
Seat 3: balisstica ($10 in chips) 
Seat 4: densyl111 ($6.32 in chips) 
Seat 5: stardrakee ($13.42 in chips) 
balisstica: posts small blind $0.05
densyl111: posts big blind $0.10
*** HOLE CARDS ***
stardrakee: folds 
casimiro124: folds 
Tyoma_Kovach: raises $0.15 to $0.25
balisstica: folds 
densyl111: calls $0.15
*** FLOP *** [Tc Ac Ah]
densyl111 has timed out
densyl111: checks 
Tyoma_Kovach: bets $0.17
densyl111: folds 
Uncalled bet ($0.17) returned to Tyoma_Kovach
Tyoma_Kovach collected $0.53 from pot
Tyoma_Kovach: doesn't show hand 
*** SUMMARY ***
Total pot $0.55 | Rake $0.02 
Board [Tc Ac Ah]
Seat 1: casimiro124 folded before Flop (didn't bet)
Seat 2: Tyoma_Kovach (button) collected ($0.53)
Seat 3: balisstica (small blind) folded before Flop
Seat 4: densyl111 (big blind) folded on the Flop
Seat 5: stardrakee folded before Flop (didn't bet)



PokerStars Hand #222956505772:  Hold'em No Limit ($0.05/$0.10 USD) - 2021/01/23 10:13:25 ET
Table 'Saito II' 6-max Seat #3 is the button
Seat 1: casimiro124 ($10 in chips) 
Seat 2: Tyoma_Kovach ($16.94 in chips) 
Seat 3: balisstica ($10 in chips) 
Seat 4: densyl111 ($6.07 in chips) 
Seat 5: stardrakee ($13.42 in chips) 
densyl111: posts small blind $0.05
stardrakee: posts big blind $0.10
*** HOLE CARDS ***
casimiro124: folds 
Tyoma_Kovach: folds 
balisstica: folds 
densyl111: raises $0.20 to $0.30
stardrakee: folds 
Uncalled bet ($0.20) returned to densyl111
densyl111 collected $0.20 from pot
densyl111: doesn't show hand 
*** SUMMARY ***
Total pot $0.20 | Rake $0 
Seat 1: casimiro124 folded before Flop (didn't bet)
Seat 2: Tyoma_Kovach folded before Flop (didn't bet)
Seat 3: balisstica (button) folded before Flop (didn't bet)
Seat 4: densyl111 (small blind) collected ($0.20)
Seat 5: stardrakee (big blind) folded before Flop



PokerStars Hand #222956512059:  Hold'em No Limit ($0.05/$0.10 USD) - 2021/01/23 10:13:37 ET
Table 'Saito II' 6-max Seat #4 is the button
Seat 1: casimiro124 ($10 in chips) 
Seat 2: Tyoma_Kovach ($16.94 in chips) 
Seat 3: balisstica ($10 in chips) 
Seat 4: densyl111 ($6.17 in chips) 
Seat 5: stardrakee ($13.32 in chips) 
stardrakee: posts small blind $0.05
casimiro124: posts big blind $0.10
*** HOLE CARDS ***
Tyoma_Kovach: raises $0.20 to $0.30
balisstica: folds 
densyl111 has timed out
densyl111: folds 
stardrakee: folds 
casimiro124: calls $0.20
*** FLOP *** [Ah 7c 2d]
casimiro124: checks 
Tyoma_Kovach: checks 
*** TURN *** [Ah 7c 2d] [5d]
casimiro124: checks 
Tyoma_Kovach: bets $0.47
casimiro124: folds 
Uncalled bet ($0.47) returned to Tyoma_Kovach
Tyoma_Kovach collected $0.62 from pot
Tyoma_Kovach: doesn't show hand 
*** SUMMARY ***
Total pot $0.65 | Rake $0.03 
Board [Ah 7c 2d 5d]
Seat 1: casimiro124 (big blind) folded on the Turn
Seat 2: Tyoma_Kovach collected ($0.62)
Seat 3: balisstica folded before Flop (didn't bet)
Seat 4: densyl111 (button) folded before Flop (didn't bet)
Seat 5: stardrakee (small blind) folded before Flop



PokerStars Hand #222956545018:  Hold'em No Limit ($0.05/$0.10 USD) - 2021/01/23 10:14:39 ET
Table 'Saito II' 6-max Seat #5 is the button
Seat 1: casimiro124 ($10 in chips) 
Seat 2: Tyoma_Kovach ($17.26 in chips) 
Seat 3: balisstica ($10 in chips) 
Seat 4: densyl111 ($6.17 in chips) 
Seat 5: stardrakee ($13.27 in chips) 
casimiro124: posts small blind $0.05
Tyoma_Kovach: posts big blind $0.10
*** HOLE CARDS ***
balisstica: folds 
densyl111: raises $0.10 to $0.20
stardrakee: raises $0.50 to $0.70
casimiro124: folds 
Tyoma_Kovach: folds 
densyl111: calls $0.50
*** FLOP *** [6s 2c As]
densyl111: checks 
stardrakee: bets $0.78
densyl111: folds 
Uncalled bet ($0.78) returned to stardrakee
stardrakee collected $1.48 from pot
stardrakee: doesn't show hand 
*** SUMMARY ***
Total pot $1.55 | Rake $0.07 
Board [6s 2c As]
Seat 1: casimiro124 (small blind) folded before Flop
Seat 2: Tyoma_Kovach (big blind) folded before Flop
Seat 3: balisstica folded before Flop (didn't bet)
Seat 4: densyl111 folded on the Flop
Seat 5: stardrakee (button) collected ($1.48)



PokerStars Hand #222956565178:  Hold'em No Limit ($0.05/$0.10 USD) - 2021/01/23 10:15:17 ET
Table 'Saito II' 6-max Seat #1 is the button
Seat 1: casimiro124 ($10 in chips) 
Seat 2: Tyoma_Kovach ($17.16 in chips) 
Seat 3: balisstica ($10 in chips) 
Seat 4: densyl111 ($5.47 in chips) 
Seat 5: stardrakee ($14.05 in chips) 
Seat 6: aleks2272 ($12.36 in chips) 
Tyoma_Kovach: posts small blind $0.05
balisstica: posts big blind $0.10
aleks2272: posts small & big blinds $0.15
*** HOLE CARDS ***
densyl111: folds 
stardrakee: folds 
aleks2272: checks 
casimiro124: raises $0.50 to $0.60
Tyoma_Kovach: folds 
balisstica: folds 
aleks2272: calls $0.50
*** FLOP *** [Qh 6c 9s]
aleks2272: checks 
casimiro124: bets $1.05
aleks2272: folds 
Uncalled bet ($1.05) returned to casimiro124
casimiro124 collected $1.34 from pot
casimiro124: doesn't show hand 
*** SUMMARY ***
Total pot $1.40 | Rake $0.06 
Board [Qh 6c 9s]
Seat 1: casimiro124 (button) collected ($1.34)
Seat 2: Tyoma_Kovach (small blind) folded before Flop
Seat 3: balisstica (big blind) folded before Flop
Seat 4: densyl111 folded before Flop (didn't bet)
Seat 5: stardrakee folded before Flop (didn't bet)
Seat 6: aleks2272 folded on the Flop



PokerStars Hand #222956587298:  Hold'em No Limit ($0.05/$0.10 USD) - 2021/01/23 10:15:58 ET
Table 'Saito II' 6-max Seat #2 is the button
Seat 1: casimiro124 ($10.74 in chips) 
Seat 2: Tyoma_Kovach ($17.11 in chips) 
Seat 3: balisstica ($10 in chips) 
Seat 4: densyl111 ($5.47 in chips) 
Seat 5: stardrakee ($14.05 in chips) 
Seat 6: aleks2272 ($11.71 in chips) 
balisstica: posts small blind $0.05
densyl111: posts big blind $0.10
*** HOLE CARDS ***
stardrakee: folds 
aleks2272: calls $0.10
casimiro124: folds 
Tyoma_Kovach: folds 
balisstica: folds 
densyl111: checks 
*** FLOP *** [4c Ah Kd]
densyl111: bets $0.10
aleks2272: calls $0.10
*** TURN *** [4c Ah Kd] [6s]
densyl111: bets $0.10
aleks2272: raises $0.63 to $0.73
densyl111: folds 
Uncalled bet ($0.63) returned to aleks2272
aleks2272 collected $0.62 from pot
aleks2272: doesn't show hand 
*** SUMMARY ***
Total pot $0.65 | Rake $0.03 
Board [4c Ah Kd 6s]
Seat 1: casimiro124 folded before Flop (didn't bet)
Seat 2: Tyoma_Kovach (button) folded before Flop (didn't bet)
Seat 3: balisstica (small blind) folded before Flop
Seat 4: densyl111 (big blind) folded on the Turn
Seat 5: stardrakee folded before Flop (didn't bet)
Seat 6: aleks2272 collected ($0.62)



PokerStars Hand #222956609404:  Hold'em No Limit ($0.05/$0.10 USD) - 2021/01/23 10:16:39 ET
Table 'Saito II' 6-max Seat #3 is the button
Seat 1: casimiro124 ($10.74 in chips) 
Seat 2: Tyoma_Kovach ($17.11 in chips) 
Seat 3: balisstica ($10 in chips) 
Seat 4: densyl111 ($5.17 in chips) 
Seat 5: stardrakee ($14.05 in chips) 
Seat 6: aleks2272 ($12.03 in chips) 
densyl111: posts small blind $0.05
stardrakee: posts big blind $0.10
*** HOLE CARDS ***
aleks2272: folds 
casimiro124: folds 
Tyoma_Kovach: folds 
balisstica: folds 
densyl111: raises $0.10 to $0.20
stardrakee: folds 
Uncalled bet ($0.10) returned to densyl111
densyl111 collected $0.20 from pot
densyl111: doesn't show hand 
*** SUMMARY ***
Total pot $0.20 | Rake $0 
Seat 1: casimiro124 folded before Flop (didn't bet)
Seat 2: Tyoma_Kovach folded before Flop (didn't bet)
Seat 3: balisstica (button) folded before Flop (didn't bet)
Seat 4: densyl111 (small blind) collected ($0.20)
Seat 5: stardrakee (big blind) folded before Flop
Seat 6: aleks2272 folded before Flop (didn't bet)



PokerStars Hand #222956618387:  Hold'em No Limit ($0.05/$0.10 USD) - 2021/01/23 10:16:56 ET
Table 'Saito II' 6-max Seat #4 is the button
Seat 1: casimiro124 ($10.74 in chips) 
Seat 2: Tyoma_Kovach ($17.11 in chips) 
Seat 3: balisstica ($10 in chips) 
Seat 4: densyl111 ($5.27 in chips) 
Seat 5: stardrakee ($13.95 in chips) 
Seat 6: aleks2272 ($12.03 in chips) 
stardrakee: posts small blind $0.05
aleks2272: posts big blind $0.10
*** HOLE CARDS ***
casimiro124: folds 
Tyoma_Kovach: folds 
balisstica: folds 
densyl111: folds 
stardrakee: raises $0.20 to $0.30
aleks2272: folds 
Uncalled bet ($0.20) returned to stardrakee
stardrakee collected $0.20 from pot
stardrakee: doesn't show hand 
*** SUMMARY ***
Total pot $0.20 | Rake $0 
Seat 1: casimiro124 folded before Flop (didn't bet)
Seat 2: Tyoma_Kovach folded before Flop (didn't bet)
Seat 3: balisstica folded before Flop (didn't bet)
Seat 4: densyl111 (button) folded before Flop (didn't bet)
Seat 5: stardrakee (small blind) collected ($0.20)
Seat 6: aleks2272 (big blind) folded before Flop



PokerStars Hand #222956625392:  Hold'em No Limit ($0.05/$0.10 USD) - 2021/01/23 10:17:09 ET
Table 'Saito II' 6-max Seat #5 is the button
Seat 1: casimiro124 ($10.74 in chips) 
Seat 2: Tyoma_Kovach ($17.11 in chips) 
Seat 3: balisstica ($10 in chips) 
Seat 4: densyl111 ($5.27 in chips) 
Seat 5: stardrakee ($14.05 in chips) 
Seat 6: aleks2272 ($11.93 in chips) 
aleks2272: posts small blind $0.05
casimiro124: posts big blind $0.10
*** HOLE CARDS ***
Tyoma_Kovach: folds 
balisstica: folds 
densyl111: folds 
stardrakee: folds 
aleks2272: raises $0.20 to $0.30
casimiro124: folds 
Uncalled bet ($0.20) returned to aleks2272
aleks2272 collected $0.20 from pot
aleks2272: doesn't show hand 
*** SUMMARY ***
Total pot $0.20 | Rake $0 
Seat 1: casimiro124 (big blind) folded before Flop
Seat 2: Tyoma_Kovach folded before Flop (didn't bet)
Seat 3: balisstica folded before Flop (didn't bet)
Seat 4: densyl111 folded before Flop (didn't bet)
Seat 5: stardrakee (button) folded before Flop (didn't bet)
Seat 6: aleks2272 (small blind) collected ($0.20)



PokerStars Hand #222956637482:  Hold'em No Limit ($0.05/$0.10 USD) - 2021/01/23 10:17:32 ET
Table 'Saito II' 6-max Seat #6 is the button
Seat 1: casimiro124 ($10.64 in chips) 
Seat 2: Tyoma_Kovach ($17.11 in chips) 
Seat 3: balisstica ($10 in chips) 
Seat 4: densyl111 ($5.27 in chips) 
Seat 5: stardrakee ($14.05 in chips) 
Seat 6: aleks2272 ($12.03 in chips) 
casimiro124: posts small blind $0.05
Tyoma_Kovach: posts big blind $0.10
*** HOLE CARDS ***
balisstica: folds 
densyl111: folds 
stardrakee: raises $0.15 to $0.25
aleks2272: calls $0.25
casimiro124: calls $0.20
Tyoma_Kovach: folds 
*** FLOP *** [9d 7h 5d]
casimiro124: checks 
stardrakee: checks 
aleks2272: bets $0.81
casimiro124: folds 
stardrakee: folds 
Uncalled bet ($0.81) returned to aleks2272
aleks2272 collected $0.81 from pot
aleks2272: doesn't show hand 
*** SUMMARY ***
Total pot $0.85 | Rake $0.04 
Board [9d 7h 5d]
Seat 1: casimiro124 (small blind) folded on the Flop
Seat 2: Tyoma_Kovach (big blind) folded before Flop
Seat 3: balisstica folded before Flop (didn't bet)
Seat 4: densyl111 folded before Flop (didn't bet)
Seat 5: stardrakee folded on the Flop
Seat 6: aleks2272 (button) collected ($0.81)



PokerStars Hand #222956656601:  Hold'em No Limit ($0.05/$0.10 USD) - 2021/01/23 10:18:08 ET
Table 'Saito II' 6-max Seat #1 is the button
Seat 1: casimiro124 ($10.39 in chips) 
Seat 2: Tyoma_Kovach ($17.01 in chips) 
Seat 3: balisstica ($10 in chips) 
Seat 4: densyl111 ($5.27 in chips) 
Seat 5: stardrakee ($13.80 in chips) 
Seat 6: aleks2272 ($12.59 in chips) 
Tyoma_Kovach: posts small blind $0.05
balisstica: posts big blind $0.10
*** HOLE CARDS ***
densyl111: folds 
stardrakee: folds 
aleks2272: folds 
casimiro124: raises $0.15 to $0.25
Tyoma_Kovach: folds 
balisstica: folds 
Uncalled bet ($0.15) returned to casimiro124
casimiro124 collected $0.25 from pot
casimiro124: doesn't show hand 
*** SUMMARY ***
Total pot $0.25 | Rake $0 
Seat 1: casimiro124 (button) collected ($0.25)
Seat 2: Tyoma_Kovach (small blind) folded before Flop
Seat 3: balisstica (big blind) folded before Flop
Seat 4: densyl111 folded before Flop (didn't bet)
Seat 5: stardrakee folded before Flop (didn't bet)
Seat 6: aleks2272 folded before Flop (didn't bet)



PokerStars Hand #222956669204:  Hold'em No Limit ($0.05/$0.10 USD) - 2021/01/23 10:18:31 ET
Table 'Saito II' 6-max Seat #2 is the button
Seat 1: casimiro124 ($10.54 in chips) 
Seat 2: Tyoma_Kovach ($16.96 in chips) 
Seat 3: balisstica ($10 in chips) 
Seat 4: densyl111 ($5.27 in chips) 
Seat 5: stardrakee ($13.80 in chips) 
Seat 6: aleks2272 ($12.59 in chips) 
balisstica: posts small blind $0.05
densyl111: posts big blind $0.10
*** HOLE CARDS ***
stardrakee: folds 
aleks2272: folds 
casimiro124: raises $0.15 to $0.25
Tyoma_Kovach: folds 
balisstica: folds 
densyl111: calls $0.15
*** FLOP *** [5h 2c 8h]
densyl111: checks 
casimiro124: checks 
*** TURN *** [5h 2c 8h] [3d]
densyl111: bets $0.53
casimiro124: folds 
Uncalled bet ($0.53) returned to densyl111
densyl111 collected $0.53 from pot
densyl111: doesn't show hand 
*** SUMMARY ***
Total pot $0.55 | Rake $0.02 
Board [5h 2c 8h 3d]
Seat 1: casimiro124 folded on the Turn
Seat 2: Tyoma_Kovach (button) folded before Flop (didn't bet)
Seat 3: balisstica (small blind) folded before Flop
Seat 4: densyl111 (big blind) collected ($0.53)
Seat 5: stardrakee folded before Flop (didn't bet)
Seat 6: aleks2272 folded before Flop (didn't bet)



PokerStars Hand #222956688346:  Hold'em No Limit ($0.05/$0.10 USD) - 2021/01/23 10:19:07 ET
Table 'Saito II' 6-max Seat #3 is the button
Seat 1: casimiro124 ($10.29 in chips) 
Seat 2: Tyoma_Kovach ($16.96 in chips) 
Seat 3: balisstica ($10 in chips) 
Seat 4: densyl111 ($5.55 in chips) 
Seat 5: stardrakee ($13.80 in chips) 
Seat 6: aleks2272 ($12.59 in chips) 
densyl111: posts small blind $0.05
stardrakee: posts big blind $0.10
*** HOLE CARDS ***
aleks2272: folds 
casimiro124: folds 
Tyoma_Kovach: raises $0.18 to $0.28
balisstica: raises $0.62 to $0.90
densyl111: folds 
stardrakee: folds 
Tyoma_Kovach: folds 
Uncalled bet ($0.62) returned to balisstica
balisstica collected $0.71 from pot
balisstica: doesn't show hand 
*** SUMMARY ***
Total pot $0.71 | Rake $0 
Seat 1: casimiro124 folded before Flop (didn't bet)
Seat 2: Tyoma_Kovach folded before Flop
Seat 3: balisstica (button) collected ($0.71)
Seat 4: densyl111 (small blind) folded before Flop
Seat 5: stardrakee (big blind) folded before Flop
Seat 6: aleks2272 folded before Flop (didn't bet)



PokerStars Hand #222956697817:  Hold'em No Limit ($0.05/$0.10 USD) - 2021/01/23 10:19:25 ET
Table 'Saito II' 6-max Seat #4 is the button
Seat 1: casimiro124 ($10.29 in chips) 
Seat 2: Tyoma_Kovach ($16.68 in chips) 
Seat 3: balisstica ($10.43 in chips) 
Seat 4: densyl111 ($5.50 in chips) 
Seat 5: stardrakee ($13.70 in chips) 
Seat 6: aleks2272 ($12.59 in chips) 
stardrakee: posts small blind $0.05
aleks2272: posts big blind $0.10
*** HOLE CARDS ***
casimiro124: raises $0.20 to $0.30
Tyoma_Kovach: folds 
balisstica: folds 
densyl111: folds 
stardrakee: folds 
aleks2272: calls $0.20
*** FLOP *** [6s 3s Tc]
aleks2272: checks 
casimiro124: bets $0.40
aleks2272: calls $0.40
*** TURN *** [6s 3s Tc] [Jh]
aleks2272: checks 
casimiro124: bets $1.10
aleks2272: raises $1.10 to $2.20
casimiro124: raises $3.06 to $5.26
aleks2272: raises $6.63 to $11.89 and is all-in
casimiro124: calls $4.33 and is all-in
Uncalled bet ($2.30) returned to aleks2272
*** RIVER *** [6s 3s Tc Jh] [5s]
*** SHOW DOWN ***
aleks2272: shows [7s Js] (a flush, Jack high)
casimiro124: shows [Jc Jd] (three of a kind, Jacks)
aleks2272 collected $19.70 from pot
*** SUMMARY ***
Total pot $20.63 | Rake $0.93 
Board [6s 3s Tc Jh 5s]
Seat 1: casimiro124 showed [Jc Jd] and lost with three of a kind, Jacks
Seat 2: Tyoma_Kovach folded before Flop (didn't bet)
Seat 3: balisstica folded before Flop (didn't bet)
Seat 4: densyl111 (button) folded before Flop (didn't bet)
Seat 5: stardrakee (small blind) folded before Flop
Seat 6: aleks2272 (big blind) showed [7s Js] and won ($19.70) with a flush, Jack high



PokerStars Hand #222956742944:  Hold'em No Limit ($0.05/$0.10 USD) - 2021/01/23 10:20:49 ET
Table 'Saito II' 6-max Seat #5 is the button
Seat 1: casimiro124 ($10 in chips) 
Seat 2: Tyoma_Kovach ($16.68 in chips) 
Seat 3: balisstica ($10.43 in chips) 
Seat 4: densyl111 ($5.50 in chips) 
Seat 5: stardrakee ($13.65 in chips) 
Seat 6: aleks2272 ($22 in chips) 
aleks2272: posts small blind $0.05
casimiro124: posts big blind $0.10
*** HOLE CARDS ***
Tyoma_Kovach: folds 
balisstica: folds 
densyl111: folds 
stardrakee: folds 
aleks2272: calls $0.05
casimiro124: raises $0.30 to $0.40
aleks2272: calls $0.30
*** FLOP *** [6h Qh 7d]
aleks2272: checks 
casimiro124: bets $0.40
aleks2272: calls $0.40
*** TURN *** [6h Qh 7d] [6s]
aleks2272: checks 
casimiro124: checks 
*** RIVER *** [6h Qh 7d 6s] [Jd]
aleks2272: bets $1.53
casimiro124: folds 
Uncalled bet ($1.53) returned to aleks2272
aleks2272 collected $1.53 from pot
aleks2272: doesn't show hand 
*** SUMMARY ***
Total pot $1.60 | Rake $0.07 
Board [6h Qh 7d 6s Jd]
Seat 1: casimiro124 (big blind) folded on the River
Seat 2: Tyoma_Kovach folded before Flop (didn't bet)
Seat 3: balisstica folded before Flop (didn't bet)
Seat 4: densyl111 folded before Flop (didn't bet)
Seat 5: stardrakee (button) folded before Flop (didn't bet)
Seat 6: aleks2272 (small blind) collected ($1.53)



PokerStars Hand #222956765217:  Hold'em No Limit ($0.05/$0.10 USD) - 2021/01/23 10:21:30 ET
Table 'Saito II' 6-max Seat #6 is the button
Seat 1: casimiro124 ($10 in chips) 
Seat 2: Tyoma_Kovach ($16.68 in chips) 
Seat 3: balisstica ($10.43 in chips) 
Seat 4: densyl111 ($5.50 in chips) 
Seat 5: stardrakee ($13.65 in chips) 
Seat 6: aleks2272 ($22.73 in chips) 
casimiro124: posts small blind $0.05
Tyoma_Kovach: posts big blind $0.10
*** HOLE CARDS ***
balisstica: folds 
densyl111 has timed out
densyl111: folds 
stardrakee: raises $0.15 to $0.25
aleks2272: calls $0.25
casimiro124: raises $1.15 to $1.40
Tyoma_Kovach: folds 
stardrakee: folds 
aleks2272: folds 
Uncalled bet ($1.15) returned to casimiro124
casimiro124 collected $0.85 from pot
casimiro124: doesn't show hand 
*** SUMMARY ***
Total pot $0.85 | Rake $0 
Seat 1: casimiro124 (small blind) collected ($0.85)
Seat 2: Tyoma_Kovach (big blind) folded before Flop
Seat 3: balisstica folded before Flop (didn't bet)
Seat 4: densyl111 folded before Flop (didn't bet)
Seat 5: stardrakee folded before Flop
Seat 6: aleks2272 (button) folded before Flop



PokerStars Hand #222956790909:  Hold'em No Limit ($0.05/$0.10 USD) - 2021/01/23 10:22:18 ET
Table 'Saito II' 6-max Seat #1 is the button
Seat 1: casimiro124 ($10.60 in chips) 
Seat 2: Tyoma_Kovach ($16.58 in chips) 
Seat 3: balisstica ($10.43 in chips) 
Seat 5: stardrakee ($13.40 in chips) 
Seat 6: aleks2272 ($22.48 in chips) 
Tyoma_Kovach: posts small blind $0.05
balisstica: posts big blind $0.10
*** HOLE CARDS ***
stardrakee: folds 
aleks2272: folds 
casimiro124: raises $0.15 to $0.25
Tyoma_Kovach: folds 
balisstica: folds 
Uncalled bet ($0.15) returned to casimiro124
casimiro124 collected $0.25 from pot
casimiro124: doesn't show hand 
*** SUMMARY ***
Total pot $0.25 | Rake $0 
Seat 1: casimiro124 (button) collected ($0.25)
Seat 2: Tyoma_Kovach (small blind) folded before Flop
Seat 3: balisstica (big blind) folded before Flop
Seat 5: stardrakee folded before Flop (didn't bet)
Seat 6: aleks2272 folded before Flop (didn't bet)



PokerStars Hand #222956799138:  Hold'em No Limit ($0.05/$0.10 USD) - 2021/01/23 10:22:33 ET
Table 'Saito II' 6-max Seat #2 is the button
Seat 1: casimiro124 ($10.75 in chips) 
Seat 2: Tyoma_Kovach ($16.53 in chips) 
Seat 3: balisstica ($10.33 in chips) 
Seat 4: densyl111 ($5.50 in chips) 
Seat 5: stardrakee ($13.40 in chips) 
Seat 6: aleks2272 ($22.48 in chips) 
balisstica: posts small blind $0.05
densyl111: posts big blind $0.10
*** HOLE CARDS ***
stardrakee: folds 
aleks2272: folds 
casimiro124: folds 
Tyoma_Kovach: raises $0.15 to $0.25
balisstica: folds 
densyl111: calls $0.15
*** FLOP *** [Kh 8c 7d]
densyl111: checks 
Tyoma_Kovach: checks 
*** TURN *** [Kh 8c 7d] [Kc]
densyl111: checks 
Tyoma_Kovach: bets $0.17
densyl111: folds 
Uncalled bet ($0.17) returned to Tyoma_Kovach
Tyoma_Kovach collected $0.53 from pot
Tyoma_Kovach: doesn't show hand 
*** SUMMARY ***
Total pot $0.55 | Rake $0.02 
Board [Kh 8c 7d Kc]
Seat 1: casimiro124 folded before Flop (didn't bet)
Seat 2: Tyoma_Kovach (button) collected ($0.53)
Seat 3: balisstica (small blind) folded before Flop
Seat 4: densyl111 (big blind) folded on the Turn
Seat 5: stardrakee folded before Flop (didn't bet)
Seat 6: aleks2272 folded before Flop (didn't bet)



PokerStars Hand #222956826180:  Hold'em No Limit ($0.05/$0.10 USD) - 2021/01/23 10:23:23 ET
Table 'Saito II' 6-max Seat #3 is the button
Seat 1: casimiro124 ($10.75 in chips) 
Seat 2: Tyoma_Kovach ($16.81 in chips) 
Seat 3: balisstica ($10.28 in chips) 
Seat 4: densyl111 ($5.25 in chips) 
Seat 5: stardrakee ($13.40 in chips) 
Seat 6: aleks2272 ($22.48 in chips) 
densyl111: posts small blind $0.05
stardrakee: posts big blind $0.10
*** HOLE CARDS ***
aleks2272 has timed out
aleks2272: folds 
casimiro124: folds 
Tyoma_Kovach: folds 
balisstica: raises $0.15 to $0.25
densyl111: folds 
stardrakee: raises $0.75 to $1
balisstica: folds 
Uncalled bet ($0.75) returned to stardrakee
stardrakee collected $0.55 from pot
stardrakee: doesn't show hand 
*** SUMMARY ***
Total pot $0.55 | Rake $0 
Seat 1: casimiro124 folded before Flop (didn't bet)
Seat 2: Tyoma_Kovach folded before Flop (didn't bet)
Seat 3: balisstica (button) folded before Flop
Seat 4: densyl111 (small blind) folded before Flop
Seat 5: stardrakee (big blind) collected ($0.55)
Seat 6: aleks2272 folded before Flop (didn't bet)



PokerStars Hand #222956840369:  Hold'em No Limit ($0.05/$0.10 USD) - 2021/01/23 10:23:50 ET
Table 'Saito II' 6-max Seat #4 is the button
Seat 1: casimiro124 ($10.75 in chips) 
Seat 2: Tyoma_Kovach ($16.81 in chips) 
Seat 3: balisstica ($10.03 in chips) 
Seat 4: densyl111 ($5.20 in chips) 
Seat 5: stardrakee ($13.70 in chips) 
Seat 6: aleks2272 ($22.48 in chips) 
stardrakee: posts small blind $0.05
aleks2272: posts big blind $0.10
*** HOLE CARDS ***
casimiro124: folds 
Tyoma_Kovach: raises $0.20 to $0.30
balisstica: folds 
densyl111: calls $0.30
stardrakee: folds 
aleks2272: folds 
*** FLOP *** [Kh Qs 6s]
Tyoma_Kovach: bets $0.48
densyl111: folds 
Uncalled bet ($0.48) returned to Tyoma_Kovach
Tyoma_Kovach collected $0.72 from pot
Tyoma_Kovach: doesn't show hand 
*** SUMMARY ***
Total pot $0.75 | Rake $0.03 
Board [Kh Qs 6s]
Seat 1: casimiro124 folded before Flop (didn't bet)
Seat 2: Tyoma_Kovach collected ($0.72)
Seat 3: balisstica folded before Flop (didn't bet)
Seat 4: densyl111 (button) folded on the Flop
Seat 5: stardrakee (small blind) folded before Flop
Seat 6: aleks2272 (big blind) folded before Flop



PokerStars Hand #222956857448:  Hold'em No Limit ($0.05/$0.10 USD) - 2021/01/23 10:24:21 ET
Table 'Saito II' 6-max Seat #5 is the button
Seat 1: casimiro124 ($10.75 in chips) 
Seat 2: Tyoma_Kovach ($17.23 in chips) 
Seat 3: balisstica ($10.03 in chips) 
Seat 4: densyl111 ($4.90 in chips) 
Seat 5: stardrakee ($13.65 in chips) 
Seat 6: aleks2272 ($22.38 in chips) 
aleks2272: posts small blind $0.05
casimiro124: posts big blind $0.10
*** HOLE CARDS ***
Tyoma_Kovach: folds 
balisstica: folds 
densyl111: raises $0.10 to $0.20
stardrakee: calls $0.20
aleks2272: calls $0.15
casimiro124: folds 
*** FLOP *** [Kd 8h 5s]
aleks2272: checks 
densyl111: checks 
stardrakee: bets $0.36
aleks2272: calls $0.36
densyl111: folds 
*** TURN *** [Kd 8h 5s] [Ac]
aleks2272: bets $1.36
stardrakee: folds 
Uncalled bet ($1.36) returned to aleks2272
aleks2272 collected $1.36 from pot
aleks2272: doesn't show hand 
*** SUMMARY ***
Total pot $1.42 | Rake $0.06 
Board [Kd 8h 5s Ac]
Seat 1: casimiro124 (big blind) folded before Flop
Seat 2: Tyoma_Kovach folded before Flop (didn't bet)
Seat 3: balisstica folded before Flop (didn't bet)
Seat 4: densyl111 folded on the Flop
Seat 5: stardrakee (button) folded on the Turn
Seat 6: aleks2272 (small blind) collected ($1.36)



PokerStars Hand #222956884825:  Hold'em No Limit ($0.05/$0.10 USD) - 2021/01/23 10:25:12 ET
Table 'Saito II' 6-max Seat #6 is the button
Seat 1: casimiro124 ($10.65 in chips) 
Seat 2: Tyoma_Kovach ($17.23 in chips) 
Seat 3: balisstica ($10.03 in chips) 
Seat 4: densyl111 ($4.70 in chips) 
Seat 5: stardrakee ($13.09 in chips) 
Seat 6: aleks2272 ($23.18 in chips) 
casimiro124: posts small blind $0.05
Tyoma_Kovach: posts big blind $0.10
*** HOLE CARDS ***
balisstica: folds 
densyl111 has timed out
densyl111: folds 
stardrakee: raises $0.15 to $0.25
aleks2272: folds 
aleks2272 leaves the table
casimiro124: folds 
Tyoma_Kovach: folds 
Uncalled bet ($0.15) returned to stardrakee
stardrakee collected $0.25 from pot
stardrakee: doesn't show hand 
*** SUMMARY ***
Total pot $0.25 | Rake $0 
Seat 1: casimiro124 (small blind) folded before Flop
Seat 2: Tyoma_Kovach (big blind) folded before Flop
Seat 3: balisstica folded before Flop (didn't bet)
Seat 4: densyl111 folded before Flop (didn't bet)
Seat 5: stardrakee collected ($0.25)
Seat 6: aleks2272 (button) folded before Flop (didn't bet)



PokerStars Hand #222956897572:  Hold'em No Limit ($0.05/$0.10 USD) - 2021/01/23 10:25:35 ET
Table 'Saito II' 6-max Seat #1 is the button
Seat 1: casimiro124 ($10.60 in chips) 
Seat 2: Tyoma_Kovach ($17.13 in chips) 
Seat 3: balisstica ($10.03 in chips) 
Seat 4: densyl111 ($4.70 in chips) 
Seat 5: stardrakee ($13.24 in chips) 
Tyoma_Kovach: posts small blind $0.05
balisstica: posts big blind $0.10
*** HOLE CARDS ***
densyl111: raises $0.20 to $0.30
stardrakee: folds 
casimiro124: folds 
Tyoma_Kovach: calls $0.25
balisstica: calls $0.20
*** FLOP *** [9c 5s Qh]
Tyoma_Kovach: checks 
balisstica: checks 
densyl111: checks 
*** TURN *** [9c 5s Qh] [3c]
Tyoma_Kovach: checks 
balisstica: checks 
densyl111: checks 
*** RIVER *** [9c 5s Qh 3c] [Tc]
Tyoma_Kovach: checks 
balisstica: checks 
densyl111: checks 
*** SHOW DOWN ***
Tyoma_Kovach: shows [As Js] (high card Ace)
balisstica: shows [2s 2d] (a pair of Deuces)
densyl111: mucks hand 
balisstica collected $0.86 from pot
*** SUMMARY ***
Total pot $0.90 | Rake $0.04 
Board [9c 5s Qh 3c Tc]
Seat 1: casimiro124 (button) folded before Flop (didn't bet)
Seat 2: Tyoma_Kovach (small blind) showed [As Js] and lost with high card Ace
Seat 3: balisstica (big blind) showed [2s 2d] and won ($0.86) with a pair of Deuces
Seat 4: densyl111 mucked
Seat 5: stardrakee folded before Flop (didn't bet)



PokerStars Hand #222956916253:  Hold'em No Limit ($0.05/$0.10 USD) - 2021/01/23 10:26:09 ET
Table 'Saito II' 6-max Seat #2 is the button
Seat 1: casimiro124 ($10.60 in chips) 
Seat 2: Tyoma_Kovach ($16.83 in chips) 
Seat 3: balisstica ($10.59 in chips) 
Seat 4: densyl111 ($4.40 in chips) 
Seat 5: stardrakee ($13.24 in chips) 
balisstica: posts small blind $0.05
densyl111: posts big blind $0.10
*** HOLE CARDS ***
stardrakee: folds 
casimiro124: folds 
Tyoma_Kovach: folds 
balisstica: raises $0.20 to $0.30
densyl111: raises $0.60 to $0.90
balisstica: folds 
Uncalled bet ($0.60) returned to densyl111
densyl111 collected $0.60 from pot
densyl111: doesn't show hand 
*** SUMMARY ***
Total pot $0.60 | Rake $0 
Seat 1: casimiro124 folded before Flop (didn't bet)
Seat 2: Tyoma_Kovach (button) folded before Flop (didn't bet)
Seat 3: balisstica (small blind) folded before Flop
Seat 4: densyl111 (big blind) collected ($0.60)
Seat 5: stardrakee folded before Flop (didn't bet)



PokerStars Hand #222956926088:  Hold'em No Limit ($0.05/$0.10 USD) - 2021/01/23 10:26:28 ET
Table 'Saito II' 6-max Seat #3 is the button
Seat 1: casimiro124 ($10.60 in chips) 
Seat 2: Tyoma_Kovach ($16.83 in chips) 
Seat 3: balisstica ($10.29 in chips) 
Seat 4: densyl111 ($4.70 in chips) 
Seat 5: stardrakee ($13.24 in chips) 
densyl111: posts small blind $0.05
stardrakee: posts big blind $0.10
*** HOLE CARDS ***
casimiro124: folds 
Tyoma_Kovach: folds 
balisstica: raises $0.15 to $0.25
densyl111: calls $0.20
stardrakee: folds 
*** FLOP *** [2d Th 4h]
densyl111: bets $0.29
casimiro124 leaves the table
balisstica: calls $0.29
*** TURN *** [2d Th 4h] [2c]
densyl111: bets $0.30
balisstica: raises $0.90 to $1.20
densyl111: calls $0.90
*** RIVER *** [2d Th 4h 2c] [Qh]
densyl111: bets $0.30
SERG244 joins the table at seat #6 
balisstica: raises $3.30 to $3.60
densyl111: folds 
Uncalled bet ($3.30) returned to balisstica
balisstica collected $3.99 from pot
balisstica: doesn't show hand 
*** SUMMARY ***
Total pot $4.18 | Rake $0.19 
Board [2d Th 4h 2c Qh]
Seat 1: casimiro124 folded before Flop (didn't bet)
Seat 2: Tyoma_Kovach folded before Flop (didn't bet)
Seat 3: balisstica (button) collected ($3.99)
Seat 4: densyl111 (small blind) folded on the River
Seat 5: stardrakee (big blind) folded before Flop



PokerStars Hand #222956949174:  Hold'em No Limit ($0.05/$0.10 USD) - 2021/01/23 10:27:10 ET
Table 'Saito II' 6-max Seat #4 is the button
Seat 2: Tyoma_Kovach ($16.83 in chips) 
Seat 3: balisstica ($12.24 in chips) 
Seat 4: densyl111 ($2.66 in chips) 
Seat 5: stardrakee ($13.14 in chips) 
Seat 6: SERG244 ($20.70 in chips) 
stardrakee: posts small blind $0.05
SERG244: posts big blind $0.10
*** HOLE CARDS ***
Tyoma_Kovach: folds 
balisstica: folds 
densyl111 has timed out
densyl111: folds 
stardrakee: folds 
Uncalled bet ($0.05) returned to SERG244
SERG244 collected $0.10 from pot
SERG244: doesn't show hand 
*** SUMMARY ***
Total pot $0.10 | Rake $0 
Seat 2: Tyoma_Kovach folded before Flop (didn't bet)
Seat 3: balisstica folded before Flop (didn't bet)
Seat 4: densyl111 (button) folded before Flop (didn't bet)
Seat 5: stardrakee (small blind) folded before Flop
Seat 6: SERG244 (big blind) collected ($0.10)



PokerStars Hand #222956960751:  Hold'em No Limit ($0.05/$0.10 USD) - 2021/01/23 10:27:31 ET
Table 'Saito II' 6-max Seat #5 is the button
Seat 3: balisstica ($12.24 in chips) 
Seat 5: stardrakee ($13.09 in chips) 
Seat 6: SERG244 ($20.75 in chips) 
SERG244: posts small blind $0.05
Tyoma_Kovach: is sitting out 
balisstica: posts big blind $0.10
*** HOLE CARDS ***
stardrakee: folds 
Tyoma_Kovach leaves the table
SERG244: raises $0.16 to $0.26
balisstica: folds 
Uncalled bet ($0.16) returned to SERG244
SERG244 collected $0.20 from pot
SERG244: doesn't show hand 
*** SUMMARY ***
Total pot $0.20 | Rake $0 
Seat 3: balisstica (big blind) folded before Flop
Seat 5: stardrakee (button) folded before Flop (didn't bet)
Seat 6: SERG244 (small blind) collected ($0.20)



PokerStars Hand #222956971069:  Hold'em No Limit ($0.05/$0.10 USD) - 2021/01/23 10:27:50 ET
Table 'Saito II' 6-max Seat #6 is the button
Seat 3: balisstica ($12.14 in chips) 
Seat 4: densyl111 ($2.66 in chips) 
Seat 5: stardrakee ($13.09 in chips) 
Seat 6: SERG244 ($20.85 in chips) 
balisstica: posts small blind $0.05
densyl111: posts big blind $0.10
*** HOLE CARDS ***
stardrakee: folds 
SERG244: folds 
balisstica: folds 
Uncalled bet ($0.05) returned to densyl111
densyl111 collected $0.10 from pot
densyl111: doesn't show hand 
*** SUMMARY ***
Total pot $0.10 | Rake $0 
Seat 3: balisstica (small blind) folded before Flop
Seat 4: densyl111 (big blind) collected ($0.10)
Seat 5: stardrakee folded before Flop (didn't bet)
Seat 6: SERG244 (button) folded before Flop (didn't bet)



PokerStars Hand #222956974777:  Hold'em No Limit ($0.05/$0.10 USD) - 2021/01/23 10:27:57 ET
Table 'Saito II' 6-max Seat #3 is the button
Seat 3: balisstica ($12.09 in chips) 
Seat 4: densyl111 ($2.71 in chips) 
Seat 5: stardrakee ($13.09 in chips) 
Seat 6: SERG244 ($20.85 in chips) 
densyl111: posts small blind $0.05
stardrakee: posts big blind $0.10
*** HOLE CARDS ***
SERG244: raises $0.16 to $0.26
balisstica: raises $0.34 to $0.60
densyl111: folds 
stardrakee: folds 
SERG244: folds 
Uncalled bet ($0.34) returned to balisstica
balisstica collected $0.67 from pot
balisstica: doesn't show hand 
*** SUMMARY ***
Total pot $0.67 | Rake $0 
Seat 3: balisstica (button) collected ($0.67)
Seat 4: densyl111 (small blind) folded before Flop
Seat 5: stardrakee (big blind) folded before Flop
Seat 6: SERG244 folded before Flop



PokerStars Hand #222956987244:  Hold'em No Limit ($0.05/$0.10 USD) - 2021/01/23 10:28:20 ET
Table 'Saito II' 6-max Seat #4 is the button
Seat 3: balisstica ($12.50 in chips) 
Seat 4: densyl111 ($2.66 in chips) 
Seat 5: stardrakee ($12.99 in chips) 
Seat 6: SERG244 ($20.59 in chips) 
stardrakee: posts small blind $0.05
SERG244: posts big blind $0.10
*** HOLE CARDS ***
balisstica: folds 
densyl111: raises $0.20 to $0.30
stardrakee: folds 
SERG244: folds 
Uncalled bet ($0.20) returned to densyl111
densyl111 collected $0.25 from pot
densyl111: doesn't show hand 
*** SUMMARY ***
Total pot $0.25 | Rake $0 
Seat 3: balisstica folded before Flop (didn't bet)
Seat 4: densyl111 (button) collected ($0.25)
Seat 5: stardrakee (small blind) folded before Flop
Seat 6: SERG244 (big blind) folded before Flop



PokerStars Hand #222956993692:  Hold'em No Limit ($0.05/$0.10 USD) - 2021/01/23 10:28:32 ET
Table 'Saito II' 6-max Seat #5 is the button
Seat 3: balisstica ($12.50 in chips) 
Seat 4: densyl111 ($2.81 in chips) 
Seat 5: stardrakee ($12.94 in chips) 
Seat 6: SERG244 ($20.49 in chips) 
SERG244: posts small blind $0.05
balisstica: posts big blind $0.10
*** HOLE CARDS ***
densyl111: calls $0.10
stardrakee: raises $0.25 to $0.35
JoaquinBueno joins the table at seat #1 
SERG244: folds 
balisstica: folds 
densyl111: calls $0.25
*** FLOP *** [7c 5d Qh]
densyl111: bets $2.46 and is all-in
stardrakee: folds 
Uncalled bet ($2.46) returned to densyl111
densyl111 collected $0.81 from pot
densyl111: doesn't show hand 
*** SUMMARY ***
Total pot $0.85 | Rake $0.04 
Board [7c 5d Qh]
Seat 3: balisstica (big blind) folded before Flop
Seat 4: densyl111 collected ($0.81)
Seat 5: stardrakee (button) folded on the Flop
Seat 6: SERG244 (small blind) folded before Flop



PokerStars Hand #222957017044:  Hold'em No Limit ($0.05/$0.10 USD) - 2021/01/23 10:29:14 ET
Table 'Saito II' 6-max Seat #6 is the button
Seat 3: balisstica ($12.40 in chips) 
Seat 4: densyl111 ($3.27 in chips) 
Seat 5: stardrakee ($12.59 in chips) 
Seat 6: SERG244 ($20.44 in chips) 
balisstica: posts small blind $0.05
densyl111: posts big blind $0.10
*** HOLE CARDS ***
stardrakee: folds 
SERG244: folds 
balisstica: folds 
Uncalled bet ($0.05) returned to densyl111
densyl111 collected $0.10 from pot
densyl111: doesn't show hand 
*** SUMMARY ***
Total pot $0.10 | Rake $0 
Seat 3: balisstica (small blind) folded before Flop
Seat 4: densyl111 (big blind) collected ($0.10)
Seat 5: stardrakee folded before Flop (didn't bet)
Seat 6: SERG244 (button) folded before Flop (didn't bet)



PokerStars Hand #222957023602:  Hold'em No Limit ($0.05/$0.10 USD) - 2021/01/23 10:29:27 ET
Table 'Saito II' 6-max Seat #3 is the button
Seat 3: balisstica ($12.35 in chips) 
Seat 4: densyl111 ($3.32 in chips) 
Seat 5: stardrakee ($12.59 in chips) 
Seat 6: SERG244 ($20.44 in chips) 
densyl111: posts small blind $0.05
stardrakee: posts big blind $0.10
JoaquinBueno: sits out 
*** HOLE CARDS ***
SERG244: folds 
balisstica: raises $0.15 to $0.25
densyl111: calls $0.20
stardrakee: folds 
*** FLOP *** [Qh Td 8c]
densyl111: checks 
balisstica: bets $0.19
densyl111: folds 
Uncalled bet ($0.19) returned to balisstica
balisstica collected $0.57 from pot
balisstica: doesn't show hand 
*** SUMMARY ***
Total pot $0.60 | Rake $0.03 
Board [Qh Td 8c]
Seat 3: balisstica (button) collected ($0.57)
Seat 4: densyl111 (small blind) folded on the Flop
Seat 5: stardrakee (big blind) folded before Flop
Seat 6: SERG244 folded before Flop (didn't bet)



PokerStars Hand #222957039804:  Hold'em No Limit ($0.05/$0.10 USD) - 2021/01/23 10:29:56 ET
Table 'Saito II' 6-max Seat #4 is the button
Seat 3: balisstica ($12.67 in chips) 
Seat 4: densyl111 ($3.07 in chips) 
Seat 5: stardrakee ($12.49 in chips) 
Seat 6: SERG244 ($20.44 in chips) 
stardrakee: posts small blind $0.05
SERG244: posts big blind $0.10
JoaquinBueno: sits out 
*** HOLE CARDS ***
balisstica: folds 
densyl111: raises $0.10 to $0.20
stardrakee: folds 
SERG244: calls $0.10
*** FLOP *** [8h Qd 6s]
SERG244: checks 
densyl111: checks 
*** TURN *** [8h Qd 6s] [6h]
andmats joins the table at seat #2 
SERG244: checks 
densyl111: checks 
*** RIVER *** [8h Qd 6s 6h] [9h]
SERG244: checks 
densyl111: checks 
*** SHOW DOWN ***
SERG244: shows [3h 3c] (two pair, Sixes and Threes)
densyl111: mucks hand 
SERG244 collected $0.43 from pot
*** SUMMARY ***
Total pot $0.45 | Rake $0.02 
Board [8h Qd 6s 6h 9h]
Seat 3: balisstica folded before Flop (didn't bet)
Seat 4: densyl111 (button) mucked
Seat 5: stardrakee (small blind) folded before Flop
Seat 6: SERG244 (big blind) showed [3h 3c] and won ($0.43) with two pair, Sixes and Threes



PokerStars Hand #222957071646:  Hold'em No Limit ($0.05/$0.10 USD) - 2021/01/23 10:30:55 ET
Table 'Saito II' 6-max Seat #5 is the button
Seat 1: JoaquinBueno ($10 in chips) 
Seat 3: balisstica ($12.67 in chips) 
Seat 4: densyl111 ($2.87 in chips) 
Seat 5: stardrakee ($12.44 in chips) 
Seat 6: SERG244 ($20.67 in chips) 
SERG244: posts small blind $0.05
JoaquinBueno: posts big blind $0.10
andmats: sits out 
*** HOLE CARDS ***
balisstica: folds 
densyl111: raises $0.20 to $0.30
stardrakee: folds 
SERG244: folds 
JoaquinBueno: calls $0.20
*** FLOP *** [Qh 6s 7h]
JoaquinBueno: checks 
densyl111: checks 
*** TURN *** [Qh 6s 7h] [8s]
JoaquinBueno: checks 
densyl111: checks 
*** RIVER *** [Qh 6s 7h 8s] [8c]
JoaquinBueno: bets $0.20
densyl111: calls $0.20
*** SHOW DOWN ***
JoaquinBueno: shows [2c 2s] (two pair, Eights and Deuces)
densyl111: shows [5d 5s] (two pair, Eights and Fives)
densyl111 collected $1 from pot
*** SUMMARY ***
Total pot $1.05 | Rake $0.05 
Board [Qh 6s 7h 8s 8c]
Seat 1: JoaquinBueno (big blind) showed [2c 2s] and lost with two pair, Eights and Deuces
Seat 3: balisstica folded before Flop (didn't bet)
Seat 4: densyl111 showed [5d 5s] and won ($1) with two pair, Eights and Fives
Seat 5: stardrakee (button) folded before Flop (didn't bet)
Seat 6: SERG244 (small blind) folded before Flop



PokerStars Hand #222957096683:  Hold'em No Limit ($0.05/$0.10 USD) - 2021/01/23 10:31:28 ET
Table 'Saito II' 6-max Seat #6 is the button
Seat 1: JoaquinBueno ($10 in chips) 
Seat 2: andmats ($4 in chips) 
Seat 3: balisstica ($12.67 in chips) 
Seat 4: densyl111 ($3.37 in chips) 
Seat 5: stardrakee ($12.44 in chips) 
Seat 6: SERG244 ($20.62 in chips) 
JoaquinBueno: posts small blind $0.05
andmats: posts big blind $0.10
*** HOLE CARDS ***
balisstica: folds 
densyl111: raises $0.20 to $0.30
stardrakee: folds 
SERG244: calls $0.30
JoaquinBueno: folds 
andmats: calls $0.20
*** FLOP *** [Jd 9d 7d]
andmats: checks 
densyl111: checks 
SERG244: bets $0.46
andmats: folds 
densyl111: folds 
Uncalled bet ($0.46) returned to SERG244
SERG244 collected $0.91 from pot
SERG244: doesn't show hand 
*** SUMMARY ***
Total pot $0.95 | Rake $0.04 
Board [Jd 9d 7d]
Seat 1: JoaquinBueno (small blind) folded before Flop
Seat 2: andmats (big blind) folded on the Flop
Seat 3: balisstica folded before Flop (didn't bet)
Seat 4: densyl111 folded on the Flop
Seat 5: stardrakee folded before Flop (didn't bet)
Seat 6: SERG244 (button) collected ($0.91)



PokerStars Hand #222957120877:  Hold'em No Limit ($0.05/$0.10 USD) - 2021/01/23 10:32:12 ET
Table 'Saito II' 6-max Seat #1 is the button
Seat 1: JoaquinBueno ($10 in chips) 
Seat 2: andmats ($3.70 in chips) 
Seat 3: balisstica ($12.67 in chips) 
Seat 4: densyl111 ($3.07 in chips) 
Seat 5: stardrakee ($12.44 in chips) 
Seat 6: SERG244 ($21.23 in chips) 
andmats: posts small blind $0.05
balisstica: posts big blind $0.10
*** HOLE CARDS ***
densyl111 has timed out
densyl111: folds 
stardrakee: raises $0.15 to $0.25
SERG244: folds 
JoaquinBueno: raises $0.75 to $1
andmats: folds 
balisstica: folds 
stardrakee: folds 
Uncalled bet ($0.75) returned to JoaquinBueno
JoaquinBueno collected $0.65 from pot
JoaquinBueno: doesn't show hand 
*** SUMMARY ***
Total pot $0.65 | Rake $0 
Seat 1: JoaquinBueno (button) collected ($0.65)
Seat 2: andmats (small blind) folded before Flop
Seat 3: balisstica (big blind) folded before Flop
Seat 4: densyl111 folded before Flop (didn't bet)
Seat 5: stardrakee folded before Flop
Seat 6: SERG244 folded before Flop (didn't bet)



PokerStars Hand #222957147767:  Hold'em No Limit ($0.05/$0.10 USD) - 2021/01/23 10:33:01 ET
Table 'Saito II' 6-max Seat #2 is the button
Seat 1: JoaquinBueno ($10.40 in chips) 
Seat 2: andmats ($3.65 in chips) 
Seat 3: balisstica ($12.57 in chips) 
Seat 4: densyl111 ($3.07 in chips) 
Seat 5: stardrakee ($12.19 in chips) 
Seat 6: SERG244 ($21.23 in chips) 
balisstica: posts small blind $0.05
densyl111: posts big blind $0.10
*** HOLE CARDS ***
stardrakee: folds 
SERG244: raises $0.16 to $0.26
JoaquinBueno: folds 
andmats: folds 
balisstica: folds 
densyl111: folds 
Uncalled bet ($0.16) returned to SERG244
SERG244 collected $0.25 from pot
SERG244: doesn't show hand 
*** SUMMARY ***
Total pot $0.25 | Rake $0 
Seat 1: JoaquinBueno folded before Flop (didn't bet)
Seat 2: andmats (button) folded before Flop (didn't bet)
Seat 3: balisstica (small blind) folded before Flop
Seat 4: densyl111 (big blind) folded before Flop
Seat 5: stardrakee folded before Flop (didn't bet)
Seat 6: SERG244 collected ($0.25)



PokerStars Hand #222957158803:  Hold'em No Limit ($0.05/$0.10 USD) - 2021/01/23 10:33:21 ET
Table 'Saito II' 6-max Seat #3 is the button
Seat 1: JoaquinBueno ($10.40 in chips) 
Seat 2: andmats ($3.65 in chips) 
Seat 3: balisstica ($12.52 in chips) 
Seat 4: densyl111 ($2.97 in chips) 
Seat 5: stardrakee ($12.19 in chips) 
Seat 6: SERG244 ($21.38 in chips) 
densyl111: posts small blind $0.05
stardrakee: posts big blind $0.10
*** HOLE CARDS ***
SERG244: folds 
JoaquinBueno: folds 
andmats: calls $0.10
balisstica: folds 
densyl111: calls $0.05
stardrakee: checks 
*** FLOP *** [6c Ks 5s]
densyl111: checks 
stardrakee: bets $0.21
andmats: folds 
densyl111: folds 
Uncalled bet ($0.21) returned to stardrakee
stardrakee collected $0.29 from pot
stardrakee: doesn't show hand 
*** SUMMARY ***
Total pot $0.30 | Rake $0.01 
Board [6c Ks 5s]
Seat 1: JoaquinBueno folded before Flop (didn't bet)
Seat 2: andmats folded on the Flop
Seat 3: balisstica (button) folded before Flop (didn't bet)
Seat 4: densyl111 (small blind) folded on the Flop
Seat 5: stardrakee (big blind) collected ($0.29)
Seat 6: SERG244 folded before Flop (didn't bet)



PokerStars Hand #222957179722:  Hold'em No Limit ($0.05/$0.10 USD) - 2021/01/23 10:33:59 ET
Table 'Saito II' 6-max Seat #4 is the button
Seat 1: JoaquinBueno ($10.40 in chips) 
Seat 2: andmats ($3.55 in chips) 
Seat 3: balisstica ($12.52 in chips) 
Seat 4: densyl111 ($2.87 in chips) 
Seat 5: stardrakee ($12.38 in chips) 
Seat 6: SERG244 ($21.38 in chips) 
stardrakee: posts small blind $0.05
SERG244: posts big blind $0.10
*** HOLE CARDS ***
JoaquinBueno has timed out
JoaquinBueno: folds 
andmats: folds 
balisstica: folds 
densyl111: raises $0.30 to $0.40
stardrakee: folds 
SERG244: folds 
Uncalled bet ($0.30) returned to densyl111
densyl111 collected $0.25 from pot
densyl111: doesn't show hand 
*** SUMMARY ***
Total pot $0.25 | Rake $0 
Seat 1: JoaquinBueno folded before Flop (didn't bet)
Seat 2: andmats folded before Flop (didn't bet)
Seat 3: balisstica folded before Flop (didn't bet)
Seat 4: densyl111 (button) collected ($0.25)
Seat 5: stardrakee (small blind) folded before Flop
Seat 6: SERG244 (big blind) folded before Flop



PokerStars Hand #222957194004:  Hold'em No Limit ($0.05/$0.10 USD) - 2021/01/23 10:34:25 ET
Table 'Saito II' 6-max Seat #5 is the button
Seat 1: JoaquinBueno ($10.40 in chips) 
Seat 2: andmats ($3.55 in chips) 
Seat 3: balisstica ($12.52 in chips) 
Seat 4: densyl111 ($3.02 in chips) 
Seat 5: stardrakee ($12.33 in chips) 
Seat 6: SERG244 ($21.28 in chips) 
SERG244: posts small blind $0.05
JoaquinBueno: posts big blind $0.10
*** HOLE CARDS ***
andmats: folds 
balisstica: folds 
densyl111 has timed out
densyl111: folds 
stardrakee: folds 
SERG244: raises $0.16 to $0.26
JoaquinBueno: folds 
Uncalled bet ($0.16) returned to SERG244
SERG244 collected $0.20 from pot
SERG244: doesn't show hand 
*** SUMMARY ***
Total pot $0.20 | Rake $0 
Seat 1: JoaquinBueno (big blind) folded before Flop
Seat 2: andmats folded before Flop (didn't bet)
Seat 3: balisstica folded before Flop (didn't bet)
Seat 4: densyl111 folded before Flop (didn't bet)
Seat 5: stardrakee (button) folded before Flop (didn't bet)
Seat 6: SERG244 (small blind) collected ($0.20)



PokerStars Hand #222957207754:  Hold'em No Limit ($0.05/$0.10 USD) - 2021/01/23 10:34:50 ET
Table 'Saito II' 6-max Seat #6 is the button
Seat 1: JoaquinBueno ($10.30 in chips) 
Seat 2: andmats ($3.55 in chips) 
Seat 3: balisstica ($12.52 in chips) 
Seat 5: stardrakee ($12.33 in chips) 
Seat 6: SERG244 ($21.38 in chips) 
JoaquinBueno: posts small blind $0.05
andmats: posts big blind $0.10
*** HOLE CARDS ***
balisstica: folds 
stardrakee: folds 
SERG244: folds 
JoaquinBueno: raises $0.20 to $0.30
andmats: calls $0.20
*** FLOP *** [As Ts Kd]
JoaquinBueno: checks 
andmats: bets $3.25 and is all-in
JoaquinBueno: folds 
Uncalled bet ($3.25) returned to andmats
andmats collected $0.57 from pot
andmats: doesn't show hand 
*** SUMMARY ***
Total pot $0.60 | Rake $0.03 
Board [As Ts Kd]
Seat 1: JoaquinBueno (small blind) folded on the Flop
Seat 2: andmats (big blind) collected ($0.57)
Seat 3: balisstica folded before Flop (didn't bet)
Seat 5: stardrakee folded before Flop (didn't bet)
Seat 6: SERG244 (button) folded before Flop (didn't bet)



PokerStars Hand #222957220408:  Hold'em No Limit ($0.05/$0.10 USD) - 2021/01/23 10:35:13 ET
Table 'Saito II' 6-max Seat #1 is the button
Seat 1: JoaquinBueno ($10 in chips) 
Seat 2: andmats ($3.82 in chips) 
Seat 3: balisstica ($12.52 in chips) 
Seat 4: densyl111 ($3.02 in chips) 
Seat 5: stardrakee ($12.33 in chips) 
Seat 6: SERG244 ($21.38 in chips) 
andmats: posts small blind $0.05
balisstica: posts big blind $0.10
*** HOLE CARDS ***
densyl111: calls $0.10
stardrakee: folds 
SERG244: folds 
JoaquinBueno: raises $0.30 to $0.40
andmats: folds 
balisstica: folds 
densyl111: calls $0.30
*** FLOP *** [6h 7d Td]
densyl111: bets $2.62 and is all-in
JoaquinBueno: folds 
Uncalled bet ($2.62) returned to densyl111
densyl111 collected $0.91 from pot
densyl111: doesn't show hand 
*** SUMMARY ***
Total pot $0.95 | Rake $0.04 
Board [6h 7d Td]
Seat 1: JoaquinBueno (button) folded on the Flop
Seat 2: andmats (small blind) folded before Flop
Seat 3: balisstica (big blind) folded before Flop
Seat 4: densyl111 collected ($0.91)
Seat 5: stardrakee folded before Flop (didn't bet)
Seat 6: SERG244 folded before Flop (didn't bet)



PokerStars Hand #222957244740:  Hold'em No Limit ($0.05/$0.10 USD) - 2021/01/23 10:35:58 ET
Table 'Saito II' 6-max Seat #2 is the button
Seat 1: JoaquinBueno ($10 in chips) 
Seat 2: andmats ($3.77 in chips) 
Seat 3: balisstica ($12.42 in chips) 
Seat 4: densyl111 ($3.53 in chips) 
Seat 5: stardrakee ($12.33 in chips) 
Seat 6: SERG244 ($21.38 in chips) 
balisstica: posts small blind $0.05
densyl111: posts big blind $0.10
*** HOLE CARDS ***
stardrakee: raises $0.15 to $0.25
SERG244: folds 
JoaquinBueno: folds 
andmats: folds 
balisstica: folds 
densyl111: calls $0.15
*** FLOP *** [Js 5s 3h]
densyl111: checks 
stardrakee: checks 
*** TURN *** [Js 5s 3h] [2c]
densyl111: bets $0.10
stardrakee: calls $0.10
*** RIVER *** [Js 5s 3h 2c] [5h]
densyl111: bets $0.10
stardrakee: calls $0.10
*** SHOW DOWN ***
densyl111: shows [Ad Th] (a pair of Fives)
stardrakee: mucks hand 
densyl111 collected $0.91 from pot
*** SUMMARY ***
Total pot $0.95 | Rake $0.04 
Board [Js 5s 3h 2c 5h]
Seat 1: JoaquinBueno folded before Flop (didn't bet)
Seat 2: andmats (button) folded before Flop (didn't bet)
Seat 3: balisstica (small blind) folded before Flop
Seat 4: densyl111 (big blind) showed [Ad Th] and won ($0.91) with a pair of Fives
Seat 5: stardrakee mucked
Seat 6: SERG244 folded before Flop (didn't bet)



PokerStars Hand #222957271065:  Hold'em No Limit ($0.05/$0.10 USD) - 2021/01/23 10:36:45 ET
Table 'Saito II' 6-max Seat #3 is the button
Seat 1: JoaquinBueno ($10 in chips) 
Seat 2: andmats ($3.77 in chips) 
Seat 3: balisstica ($12.37 in chips) 
Seat 4: densyl111 ($3.99 in chips) 
Seat 5: stardrakee ($11.88 in chips) 
Seat 6: SERG244 ($21.38 in chips) 
densyl111: posts small blind $0.05
stardrakee: posts big blind $0.10
*** HOLE CARDS ***
SERG244: folds 
JoaquinBueno: folds 
andmats: raises $0.10 to $0.20
balisstica: folds 
densyl111: calls $0.15
stardrakee: folds 
*** FLOP *** [2h Qh 9s]
densyl111: checks 
andmats: bets $0.10
densyl111: calls $0.10
*** TURN *** [2h Qh 9s] [7c]
densyl111: checks 
andmats: bets $0.10
densyl111: calls $0.10
*** RIVER *** [2h Qh 9s 7c] [2s]
densyl111: checks 
andmats: bets $0.10
densyl111: folds 
Uncalled bet ($0.10) returned to andmats
andmats collected $0.86 from pot
andmats: doesn't show hand 
*** SUMMARY ***
Total pot $0.90 | Rake $0.04 
Board [2h Qh 9s 7c 2s]
Seat 1: JoaquinBueno folded before Flop (didn't bet)
Seat 2: andmats collected ($0.86)
Seat 3: balisstica (button) folded before Flop (didn't bet)
Seat 4: densyl111 (small blind) folded on the River
Seat 5: stardrakee (big blind) folded before Flop
Seat 6: SERG244 folded before Flop (didn't bet)



PokerStars Hand #222957292000:  Hold'em No Limit ($0.05/$0.10 USD) - 2021/01/23 10:37:23 ET
Table 'Saito II' 6-max Seat #4 is the button
Seat 1: JoaquinBueno ($10 in chips) 
Seat 2: andmats ($4.23 in chips) 
Seat 3: balisstica ($12.37 in chips) 
Seat 4: densyl111 ($3.59 in chips) 
Seat 5: stardrakee ($11.78 in chips) 
stardrakee: posts small blind $0.05
SERG244: is sitting out 
JoaquinBueno: posts big blind $0.10
*** HOLE CARDS ***
andmats: calls $0.10
balisstica has timed out
balisstica: folds 
densyl111: calls $0.10
stardrakee: folds 
JoaquinBueno: checks 
*** FLOP *** [2c 2s 3d]
JoaquinBueno: checks 
andmats: checks 
densyl111: bets $0.20
JoaquinBueno: folds 
andmats: folds 
Uncalled bet ($0.20) returned to densyl111
densyl111 collected $0.33 from pot
densyl111: doesn't show hand 
*** SUMMARY ***
Total pot $0.35 | Rake $0.02 
Board [2c 2s 3d]
Seat 1: JoaquinBueno (big blind) folded on the Flop
Seat 2: andmats folded on the Flop
Seat 3: balisstica folded before Flop (didn't bet)
Seat 4: densyl111 (button) collected ($0.33)
Seat 5: stardrakee (small blind) folded before Flop



PokerStars Hand #222957319167:  Hold'em No Limit ($0.05/$0.10 USD) - 2021/01/23 10:38:12 ET
Table 'Saito II' 6-max Seat #5 is the button
Seat 1: JoaquinBueno ($10 in chips) 
Seat 2: andmats ($4.13 in chips) 
Seat 3: balisstica ($12.37 in chips) 
Seat 4: densyl111 ($3.82 in chips) 
Seat 5: stardrakee ($11.73 in chips) 
JoaquinBueno: posts small blind $0.05
andmats: posts big blind $0.10
*** HOLE CARDS ***
balisstica: folds 
densyl111: raises $0.10 to $0.20
stardrakee: folds 
JoaquinBueno: folds 
andmats: calls $0.10
*** FLOP *** [5h Qh Ts]
andmats: bets $0.21
densyl111: folds 
Uncalled bet ($0.21) returned to andmats
andmats collected $0.43 from pot
andmats: doesn't show hand 
*** SUMMARY ***
Total pot $0.45 | Rake $0.02 
Board [5h Qh Ts]
Seat 1: JoaquinBueno (small blind) folded before Flop
Seat 2: andmats (big blind) collected ($0.43)
Seat 3: balisstica folded before Flop (didn't bet)
Seat 4: densyl111 folded on the Flop
Seat 5: stardrakee (button) folded before Flop (didn't bet)



PokerStars Hand #222955618026:  Hold'em No Limit ($0.05/$0.10 USD) - 2021/01/23 9:43:51 ET
Table 'Saito II' 6-max Seat #2 is the button
Seat 1: gazsam2000 ($10 in chips) 
Seat 2: Tyoma_Kovach ($18.41 in chips) 
Seat 3: Klemqaa ($10 in chips) 
Seat 4: cleiton-005 ($1.03 in chips) 
Seat 5: free Atheist ($22.55 in chips) 
Seat 6: Gissbon ($10 in chips) 
Klemqaa: posts small blind $0.05
cleiton-005: posts big blind $0.10
*** HOLE CARDS ***
free Atheist: folds 
Gissbon: raises $0.15 to $0.25
gazsam2000: folds 
Tyoma_Kovach: folds 
Klemqaa: folds 
cleiton-005: raises $0.15 to $0.40
Gissbon: folds 
Uncalled bet ($0.15) returned to cleiton-005
cleiton-005 collected $0.55 from pot
cleiton-005: doesn't show hand 
*** SUMMARY ***
Total pot $0.55 | Rake $0 
Seat 1: gazsam2000 folded before Flop (didn't bet)
Seat 2: Tyoma_Kovach (button) folded before Flop (didn't bet)
Seat 3: Klemqaa (small blind) folded before Flop
Seat 4: cleiton-005 (big blind) collected ($0.55)
Seat 5: free Atheist folded before Flop (didn't bet)
Seat 6: Gissbon folded before Flop



PokerStars Hand #222955629073:  Hold'em No Limit ($0.05/$0.10 USD) - 2021/01/23 9:44:13 ET
Table 'Saito II' 6-max Seat #3 is the button
Seat 1: gazsam2000 ($10 in chips) 
Seat 2: Tyoma_Kovach ($18.41 in chips) 
Seat 3: Klemqaa ($10 in chips) 
Seat 4: cleiton-005 ($1.33 in chips) 
Seat 5: free Atheist ($22.55 in chips) 
Seat 6: Gissbon ($10 in chips) 
cleiton-005: posts small blind $0.05
free Atheist: posts big blind $0.10
*** HOLE CARDS ***
Gissbon: folds 
gazsam2000: folds 
Tyoma_Kovach: raises $0.18 to $0.28
Klemqaa: folds 
cleiton-005: calls $0.23
free Atheist: folds 
*** FLOP *** [Ac 9h 8d]
cleiton-005: checks 
Tyoma_Kovach: checks 
*** TURN *** [Ac 9h 8d] [2c]
cleiton-005: checks 
Tyoma_Kovach: bets $0.21
cleiton-005: folds 
Uncalled bet ($0.21) returned to Tyoma_Kovach
Tyoma_Kovach collected $0.63 from pot
Tyoma_Kovach: doesn't show hand 
*** SUMMARY ***
Total pot $0.66 | Rake $0.03 
Board [Ac 9h 8d 2c]
Seat 1: gazsam2000 folded before Flop (didn't bet)
Seat 2: Tyoma_Kovach collected ($0.63)
Seat 3: Klemqaa (button) folded before Flop (didn't bet)
Seat 4: cleiton-005 (small blind) folded on the Turn
Seat 5: free Atheist (big blind) folded before Flop
Seat 6: Gissbon folded before Flop (didn't bet)



PokerStars Hand #222955640771:  Hold'em No Limit ($0.05/$0.10 USD) - 2021/01/23 9:44:36 ET
Table 'Saito II' 6-max Seat #4 is the button
Seat 1: gazsam2000 ($10 in chips) 
Seat 2: Tyoma_Kovach ($18.76 in chips) 
Seat 3: Klemqaa ($10 in chips) 
Seat 4: cleiton-005 ($1.05 in chips) 
Seat 5: free Atheist ($22.45 in chips) 
Seat 6: Gissbon ($10 in chips) 
free Atheist: posts small blind $0.05
Gissbon: posts big blind $0.10
*** HOLE CARDS ***
gazsam2000: folds 
Tyoma_Kovach: folds 
Klemqaa: folds 
cleiton-005: calls $0.10
free Atheist: calls $0.05
Gissbon: checks 
*** FLOP *** [5s 8c Qh]
free Atheist: checks 
Gissbon: checks 
cleiton-005: checks 
*** TURN *** [5s 8c Qh] [2h]
free Atheist: checks 
Gissbon: bets $0.23
cleiton-005: folds 
free Atheist: folds 
Uncalled bet ($0.23) returned to Gissbon
Gissbon collected $0.29 from pot
Gissbon: doesn't show hand 
*** SUMMARY ***
Total pot $0.30 | Rake $0.01 
Board [5s 8c Qh 2h]
Seat 1: gazsam2000 folded before Flop (didn't bet)
Seat 2: Tyoma_Kovach folded before Flop (didn't bet)
Seat 3: Klemqaa folded before Flop (didn't bet)
Seat 4: cleiton-005 (button) folded on the Turn
Seat 5: free Atheist (small blind) folded on the Turn
Seat 6: Gissbon (big blind) collected ($0.29)



PokerStars Hand #222955657803:  Hold'em No Limit ($0.05/$0.10 USD) - 2021/01/23 9:45:10 ET
Table 'Saito II' 6-max Seat #5 is the button
Seat 1: gazsam2000 ($10 in chips) 
Seat 2: Tyoma_Kovach ($18.76 in chips) 
Seat 3: Klemqaa ($10 in chips) 
Seat 4: cleiton-005 ($0.95 in chips) 
Seat 5: free Atheist ($22.35 in chips) 
Seat 6: Gissbon ($10.19 in chips) 
Gissbon: posts small blind $0.05
gazsam2000: posts big blind $0.10
*** HOLE CARDS ***
Tyoma_Kovach: raises $0.20 to $0.30
Klemqaa: calls $0.30
cleiton-005: raises $0.20 to $0.50
free Atheist: folds 
Gissbon: folds 
gazsam2000: folds 
Tyoma_Kovach: raises $1.67 to $2.17
Klemqaa: folds 
cleiton-005: calls $0.45 and is all-in
Uncalled bet ($1.22) returned to Tyoma_Kovach
*** FLOP *** [4s 5h Jh]
*** TURN *** [4s 5h Jh] [5d]
*** RIVER *** [4s 5h Jh 5d] [7s]
*** SHOW DOWN ***
Tyoma_Kovach: shows [Qs Ac] (a pair of Fives)
cleiton-005: shows [7d 7h] (a full house, Sevens full of Fives)
cleiton-005 cashed out the hand for $1.22 | Cash Out Fee $0.01
*** SUMMARY ***
Total pot $2.35 | Rake $0.11 
Board [4s 5h Jh 5d 7s]
Seat 1: gazsam2000 (big blind) folded before Flop
Seat 2: Tyoma_Kovach showed [Qs Ac] and lost with a pair of Fives
Seat 3: Klemqaa folded before Flop
Seat 4: cleiton-005 showed [7d 7h] and won ($2.24) with a full house, Sevens full of Fives (pot not awarded as player cashed out)
Seat 5: free Atheist (button) folded before Flop (didn't bet)
Seat 6: Gissbon (small blind) folded before Flop



PokerStars Hand #222955669940:  Hold'em No Limit ($0.05/$0.10 USD) - 2021/01/23 9:45:34 ET
Table 'Saito II' 6-max Seat #6 is the button
Seat 1: gazsam2000 ($10 in chips) 
Seat 2: Tyoma_Kovach ($17.81 in chips) 
Seat 3: Klemqaa ($10 in chips) 
Seat 4: cleiton-005 ($1.22 in chips) 
Seat 5: free Atheist ($22.35 in chips) 
Seat 6: Gissbon ($10.14 in chips) 
gazsam2000: posts small blind $0.05
Tyoma_Kovach: posts big blind $0.10
*** HOLE CARDS ***
Klemqaa: raises $0.20 to $0.30
cleiton-005: folds 
free Atheist: folds 
Gissbon: folds 
gazsam2000: folds 
Tyoma_Kovach: folds 
Uncalled bet ($0.20) returned to Klemqaa
Klemqaa collected $0.25 from pot
Klemqaa: doesn't show hand 
*** SUMMARY ***
Total pot $0.25 | Rake $0 
Seat 1: gazsam2000 (small blind) folded before Flop
Seat 2: Tyoma_Kovach (big blind) folded before Flop
Seat 3: Klemqaa collected ($0.25)
Seat 4: cleiton-005 folded before Flop (didn't bet)
Seat 5: free Atheist folded before Flop (didn't bet)
Seat 6: Gissbon (button) folded before Flop (didn't bet)



PokerStars Hand #222955675798:  Hold'em No Limit ($0.05/$0.10 USD) - 2021/01/23 9:45:46 ET
Table 'Saito II' 6-max Seat #1 is the button
Seat 1: gazsam2000 ($10 in chips) 
Seat 2: Tyoma_Kovach ($17.71 in chips) 
Seat 3: Klemqaa ($10.15 in chips) 
Seat 4: cleiton-005 ($1.22 in chips) 
Seat 5: free Atheist ($22.35 in chips) 
Seat 6: Gissbon ($10.14 in chips) 
Tyoma_Kovach: posts small blind $0.05
Klemqaa: posts big blind $0.10
*** HOLE CARDS ***
cleiton-005: calls $0.10
free Atheist: folds 
Gissbon: folds 
gazsam2000: folds 
Tyoma_Kovach: calls $0.05
Klemqaa: checks 
*** FLOP *** [8c Jc Qd]
Tyoma_Kovach: checks 
Klemqaa: checks 
cleiton-005: bets $0.10
Tyoma_Kovach: raises $0.65 to $0.75
Klemqaa: folds 
cleiton-005: raises $0.37 to $1.12 and is all-in
Tyoma_Kovach: calls $0.37
*** TURN *** [8c Jc Qd] [5d]
*** RIVER *** [8c Jc Qd 5d] [3c]
*** SHOW DOWN ***
Tyoma_Kovach: shows [8h Jh] (two pair, Jacks and Eights)
cleiton-005: shows [Qc 5c] (a flush, Queen high)
cleiton-005 collected $2.43 from pot
*** SUMMARY ***
Total pot $2.54 | Rake $0.11 
Board [8c Jc Qd 5d 3c]
Seat 1: gazsam2000 (button) folded before Flop (didn't bet)
Seat 2: Tyoma_Kovach (small blind) showed [8h Jh] and lost with two pair, Jacks and Eights
Seat 3: Klemqaa (big blind) folded on the Flop
Seat 4: cleiton-005 showed [Qc 5c] and won ($2.43) with a flush, Queen high
Seat 5: free Atheist folded before Flop (didn't bet)
Seat 6: Gissbon folded before Flop (didn't bet)



PokerStars Hand #222955698010:  Hold'em No Limit ($0.05/$0.10 USD) - 2021/01/23 9:46:29 ET
Table 'Saito II' 6-max Seat #2 is the button
Seat 1: gazsam2000 ($10 in chips) 
Seat 2: Tyoma_Kovach ($16.49 in chips) 
Seat 3: Klemqaa ($10.05 in chips) 
Seat 4: cleiton-005 ($2.43 in chips) 
Seat 5: free Atheist ($22.35 in chips) 
Seat 6: Gissbon ($10.14 in chips) 
Klemqaa: posts small blind $0.05
cleiton-005: posts big blind $0.10
*** HOLE CARDS ***
free Atheist: calls $0.10
Gissbon: folds 
gazsam2000: folds 
Tyoma_Kovach: folds 
Klemqaa: folds 
cleiton-005: checks 
*** FLOP *** [9d 7h 2s]
cleiton-005: checks 
free Atheist: checks 
*** TURN *** [9d 7h 2s] [4h]
cleiton-005: checks 
free Atheist: checks 
*** RIVER *** [9d 7h 2s 4h] [8h]
cleiton-005: checks 
free Atheist: checks 
*** SHOW DOWN ***
cleiton-005: shows [Td As] (high card Ace)
free Atheist: mucks hand 
cleiton-005 collected $0.24 from pot
*** SUMMARY ***
Total pot $0.25 | Rake $0.01 
Board [9d 7h 2s 4h 8h]
Seat 1: gazsam2000 folded before Flop (didn't bet)
Seat 2: Tyoma_Kovach (button) folded before Flop (didn't bet)
Seat 3: Klemqaa (small blind) folded before Flop
Seat 4: cleiton-005 (big blind) showed [Td As] and won ($0.24) with high card Ace
Seat 5: free Atheist mucked
Seat 6: Gissbon folded before Flop (didn't bet)



PokerStars Hand #222955711216:  Hold'em No Limit ($0.05/$0.10 USD) - 2021/01/23 9:46:55 ET
Table 'Saito II' 6-max Seat #3 is the button
Seat 1: gazsam2000 ($10 in chips) 
Seat 2: Tyoma_Kovach ($16.49 in chips) 
Seat 3: Klemqaa ($10 in chips) 
Seat 4: cleiton-005 ($2.57 in chips) 
Seat 5: free Atheist ($22.25 in chips) 
Seat 6: Gissbon ($10.14 in chips) 
cleiton-005: posts small blind $0.05
free Atheist: posts big blind $0.10
*** HOLE CARDS ***
Gissbon: raises $0.15 to $0.25
gazsam2000: folds 
Tyoma_Kovach: folds 
Klemqaa: folds 
cleiton-005: calls $0.20
free Atheist: folds 
*** FLOP *** [Th Qd Kh]
cleiton-005: checks 
Gissbon: checks 
*** TURN *** [Th Qd Kh] [6s]
cleiton-005: checks 
Gissbon: checks 
*** RIVER *** [Th Qd Kh 6s] [Kd]
cleiton-005: checks 
Gissbon: checks 
*** SHOW DOWN ***
cleiton-005: shows [7h 8h] (a pair of Kings)
Gissbon: shows [9c 9d] (two pair, Kings and Nines)
Gissbon collected $0.57 from pot
*** SUMMARY ***
Total pot $0.60 | Rake $0.03 
Board [Th Qd Kh 6s Kd]
Seat 1: gazsam2000 folded before Flop (didn't bet)
Seat 2: Tyoma_Kovach folded before Flop (didn't bet)
Seat 3: Klemqaa (button) folded before Flop (didn't bet)
Seat 4: cleiton-005 (small blind) showed [7h 8h] and lost with a pair of Kings
Seat 5: free Atheist (big blind) folded before Flop
Seat 6: Gissbon showed [9c 9d] and won ($0.57) with two pair, Kings and Nines



PokerStars Hand #222955726288:  Hold'em No Limit ($0.05/$0.10 USD) - 2021/01/23 9:47:25 ET
Table 'Saito II' 6-max Seat #4 is the button
Seat 1: gazsam2000 ($10 in chips) 
Seat 2: Tyoma_Kovach ($16.49 in chips) 
Seat 3: Klemqaa ($10 in chips) 
Seat 4: cleiton-005 ($2.32 in chips) 
Seat 5: free Atheist ($22.15 in chips) 
Seat 6: Gissbon ($10.46 in chips) 
free Atheist: posts small blind $0.05
Gissbon: posts big blind $0.10
*** HOLE CARDS ***
gazsam2000: folds 
Tyoma_Kovach: folds 
Klemqaa: folds 
cleiton-005: calls $0.10
free Atheist: calls $0.05
Gissbon: checks 
*** FLOP *** [3h Kd 8c]
free Atheist: checks 
Gissbon: checks 
cleiton-005: bets $0.10
free Atheist: folds 
Gissbon: calls $0.10
*** TURN *** [3h Kd 8c] [8s]
Gissbon: checks 
cleiton-005: bets $0.10
Gissbon: folds 
Uncalled bet ($0.10) returned to cleiton-005
cleiton-005 collected $0.48 from pot
cleiton-005: doesn't show hand 
*** SUMMARY ***
Total pot $0.50 | Rake $0.02 
Board [3h Kd 8c 8s]
Seat 1: gazsam2000 folded before Flop (didn't bet)
Seat 2: Tyoma_Kovach folded before Flop (didn't bet)
Seat 3: Klemqaa folded before Flop (didn't bet)
Seat 4: cleiton-005 (button) collected ($0.48)
Seat 5: free Atheist (small blind) folded on the Flop
Seat 6: Gissbon (big blind) folded on the Turn



PokerStars Hand #222955745724:  Hold'em No Limit ($0.05/$0.10 USD) - 2021/01/23 9:48:03 ET
Table 'Saito II' 6-max Seat #5 is the button
Seat 1: gazsam2000 ($10 in chips) 
Seat 2: Tyoma_Kovach ($16.49 in chips) 
Seat 3: Klemqaa ($10 in chips) 
Seat 4: cleiton-005 ($2.60 in chips) 
Seat 5: free Atheist ($22.05 in chips) 
Seat 6: Gissbon ($10.26 in chips) 
Gissbon: posts small blind $0.05
gazsam2000: posts big blind $0.10
*** HOLE CARDS ***
Tyoma_Kovach: folds 
Klemqaa: folds 
cleiton-005: raises $0.10 to $0.20
free Atheist: folds 
Gissbon: folds 
gazsam2000: folds 
Uncalled bet ($0.10) returned to cleiton-005
cleiton-005 collected $0.25 from pot
cleiton-005: doesn't show hand 
*** SUMMARY ***
Total pot $0.25 | Rake $0 
Seat 1: gazsam2000 (big blind) folded before Flop
Seat 2: Tyoma_Kovach folded before Flop (didn't bet)
Seat 3: Klemqaa folded before Flop (didn't bet)
Seat 4: cleiton-005 collected ($0.25)
Seat 5: free Atheist (button) folded before Flop (didn't bet)
Seat 6: Gissbon (small blind) folded before Flop



PokerStars Hand #222955749635:  Hold'em No Limit ($0.05/$0.10 USD) - 2021/01/23 9:48:10 ET
Table 'Saito II' 6-max Seat #6 is the button
Seat 1: gazsam2000 ($10 in chips) 
Seat 2: Tyoma_Kovach ($16.49 in chips) 
Seat 3: Klemqaa ($10 in chips) 
Seat 4: cleiton-005 ($2.75 in chips) 
Seat 5: free Atheist ($22.05 in chips) 
Seat 6: Gissbon ($10.21 in chips) 
gazsam2000: posts small blind $0.05
Tyoma_Kovach: posts big blind $0.10
*** HOLE CARDS ***
Klemqaa: folds 
cleiton-005: folds 
free Atheist: folds 
Gissbon: folds 
gazsam2000: folds 
Uncalled bet ($0.05) returned to Tyoma_Kovach
Tyoma_Kovach collected $0.10 from pot
Tyoma_Kovach: doesn't show hand 
*** SUMMARY ***
Total pot $0.10 | Rake $0 
Seat 1: gazsam2000 (small blind) folded before Flop
Seat 2: Tyoma_Kovach (big blind) collected ($0.10)
Seat 3: Klemqaa folded before Flop (didn't bet)
Seat 4: cleiton-005 folded before Flop (didn't bet)
Seat 5: free Atheist folded before Flop (didn't bet)
Seat 6: Gissbon (button) folded before Flop (didn't bet)



PokerStars Hand #222957481812:  Hold'em No Limit ($0.05/$0.10 USD) - 2021/01/23 10:43:08 ET
Table 'Saito II' 6-max Seat #1 is the button
Seat 1: JoaquinBueno ($14.33 in chips) 
Seat 2: witchdocta00 ($3.90 in chips) 
Seat 3: balisstica ($12.77 in chips) 
Seat 4: densyl111 ($3.47 in chips) 
Seat 5: stardrakee ($11.63 in chips) 
Seat 6: SERG244 ($21.23 in chips) 
witchdocta00: posts small blind $0.05
balisstica: posts big blind $0.10
*** HOLE CARDS ***
densyl111: folds 
stardrakee: raises $0.15 to $0.25
SERG244: raises $0.68 to $0.93
JoaquinBueno: folds 
witchdocta00: folds 
balisstica: folds 
stardrakee: folds 
Uncalled bet ($0.68) returned to SERG244
SERG244 collected $0.65 from pot
SERG244: doesn't show hand 
*** SUMMARY ***
Total pot $0.65 | Rake $0 
Seat 1: JoaquinBueno (button) folded before Flop (didn't bet)
Seat 2: witchdocta00 (small blind) folded before Flop
Seat 3: balisstica (big blind) folded before Flop
Seat 4: densyl111 folded before Flop (didn't bet)
Seat 5: stardrakee folded before Flop
Seat 6: SERG244 collected ($0.65)



PokerStars Hand #222957501249:  Hold'em No Limit ($0.05/$0.10 USD) - 2021/01/23 10:43:43 ET
Table 'Saito II' 6-max Seat #2 is the button
Seat 1: JoaquinBueno ($14.33 in chips) 
Seat 2: witchdocta00 ($3.85 in chips) 
Seat 3: balisstica ($12.67 in chips) 
Seat 4: densyl111 ($3.47 in chips) 
Seat 5: stardrakee ($11.38 in chips) 
Seat 6: SERG244 ($21.63 in chips) 
balisstica: posts small blind $0.05
densyl111: posts big blind $0.10
*** HOLE CARDS ***
stardrakee: folds 
SERG244: folds 
JoaquinBueno: folds 
witchdocta00: folds 
balisstica: folds 
Uncalled bet ($0.05) returned to densyl111
densyl111 collected $0.10 from pot
densyl111: doesn't show hand 
*** SUMMARY ***
Total pot $0.10 | Rake $0 
Seat 1: JoaquinBueno folded before Flop (didn't bet)
Seat 2: witchdocta00 (button) folded before Flop (didn't bet)
Seat 3: balisstica (small blind) folded before Flop
Seat 4: densyl111 (big blind) collected ($0.10)
Seat 5: stardrakee folded before Flop (didn't bet)
Seat 6: SERG244 folded before Flop (didn't bet)



PokerStars Hand #222957512469:  Hold'em No Limit ($0.05/$0.10 USD) - 2021/01/23 10:44:03 ET
Table 'Saito II' 6-max Seat #3 is the button
Seat 1: JoaquinBueno ($14.33 in chips) 
Seat 2: witchdocta00 ($3.85 in chips) 
Seat 3: balisstica ($12.62 in chips) 
Seat 4: densyl111 ($3.52 in chips) 
Seat 5: stardrakee ($11.38 in chips) 
Seat 6: SERG244 ($21.63 in chips) 
densyl111: posts small blind $0.05
stardrakee: posts big blind $0.10
*** HOLE CARDS ***
SERG244: folds 
JoaquinBueno: folds 
witchdocta00: folds 
balisstica: folds 
densyl111: raises $0.20 to $0.30
stardrakee: folds 
Uncalled bet ($0.20) returned to densyl111
densyl111 collected $0.20 from pot
densyl111: doesn't show hand 
*** SUMMARY ***
Total pot $0.20 | Rake $0 
Seat 1: JoaquinBueno folded before Flop (didn't bet)
Seat 2: witchdocta00 folded before Flop (didn't bet)
Seat 3: balisstica (button) folded before Flop (didn't bet)
Seat 4: densyl111 (small blind) collected ($0.20)
Seat 5: stardrakee (big blind) folded before Flop
Seat 6: SERG244 folded before Flop (didn't bet)



PokerStars Hand #222957523002:  Hold'em No Limit ($0.05/$0.10 USD) - 2021/01/23 10:44:22 ET
Table 'Saito II' 6-max Seat #4 is the button
Seat 1: JoaquinBueno ($14.33 in chips) 
Seat 2: witchdocta00 ($3.85 in chips) 
Seat 3: balisstica ($12.62 in chips) 
Seat 4: densyl111 ($3.62 in chips) 
Seat 5: stardrakee ($11.28 in chips) 
Seat 6: SERG244 ($21.63 in chips) 
stardrakee: posts small blind $0.05
SERG244: posts big blind $0.10
*** HOLE CARDS ***
JoaquinBueno: folds 
witchdocta00: calls $0.10
balisstica: folds 
densyl111: calls $0.10
stardrakee: raises $0.40 to $0.50
SERG244: folds 
witchdocta00: folds 
densyl111: calls $0.40
*** FLOP *** [5h 2h 5c]
stardrakee: checks 
densyl111: checks 
*** TURN *** [5h 2h 5c] [9h]
stardrakee: checks 
densyl111: bets $0.58
stardrakee: folds 
Uncalled bet ($0.58) returned to densyl111
densyl111 collected $1.15 from pot
densyl111: doesn't show hand 
*** SUMMARY ***
Total pot $1.20 | Rake $0.05 
Board [5h 2h 5c 9h]
Seat 1: JoaquinBueno folded before Flop (didn't bet)
Seat 2: witchdocta00 folded before Flop
Seat 3: balisstica folded before Flop (didn't bet)
Seat 4: densyl111 (button) collected ($1.15)
Seat 5: stardrakee (small blind) folded on the Turn
Seat 6: SERG244 (big blind) folded before Flop



PokerStars Hand #222957551389:  Hold'em No Limit ($0.05/$0.10 USD) - 2021/01/23 10:45:13 ET
Table 'Saito II' 6-max Seat #5 is the button
Seat 1: JoaquinBueno ($14.33 in chips) 
Seat 2: witchdocta00 ($3.75 in chips) 
Seat 3: balisstica ($12.62 in chips) 
Seat 4: densyl111 ($4.27 in chips) 
Seat 5: stardrakee ($10.78 in chips) 
Seat 6: SERG244 ($21.53 in chips) 
SERG244: posts small blind $0.05
JoaquinBueno: posts big blind $0.10
*** HOLE CARDS ***
witchdocta00: calls $0.10
balisstica: raises $0.40 to $0.50
densyl111: folds 
stardrakee: folds 
SERG244: folds 
JoaquinBueno: folds 
witchdocta00: folds 
Uncalled bet ($0.40) returned to balisstica
balisstica collected $0.35 from pot
balisstica: doesn't show hand 
*** SUMMARY ***
Total pot $0.35 | Rake $0 
Seat 1: JoaquinBueno (big blind) folded before Flop
Seat 2: witchdocta00 folded before Flop
Seat 3: balisstica collected ($0.35)
Seat 4: densyl111 folded before Flop (didn't bet)
Seat 5: stardrakee (button) folded before Flop (didn't bet)
Seat 6: SERG244 (small blind) folded before Flop



PokerStars Hand #222957575264:  Hold'em No Limit ($0.05/$0.10 USD) - 2021/01/23 10:45:56 ET
Table 'Saito II' 6-max Seat #6 is the button
Seat 1: JoaquinBueno ($14.23 in chips) 
Seat 2: witchdocta00 ($3.65 in chips) 
Seat 3: balisstica ($12.87 in chips) 
Seat 4: densyl111 ($4.27 in chips) 
Seat 5: stardrakee ($10.78 in chips) 
Seat 6: SERG244 ($21.48 in chips) 
JoaquinBueno: posts small blind $0.05
witchdocta00: posts big blind $0.10
*** HOLE CARDS ***
balisstica: raises $0.20 to $0.30
densyl111: calls $0.30
stardrakee: folds 
SERG244: folds 
JoaquinBueno: folds 
witchdocta00: folds 
*** FLOP *** [3h Ts 9d]
balisstica: bets $0.24
densyl111: calls $0.24
*** TURN *** [3h Ts 9d] [Qc]
balisstica: checks 
densyl111: checks 
*** RIVER *** [3h Ts 9d Qc] [Td]
balisstica: checks 
densyl111: checks 
*** SHOW DOWN ***
balisstica: shows [Kh Ah] (a pair of Tens)
densyl111: mucks hand 
balisstica collected $1.17 from pot
*** SUMMARY ***
Total pot $1.23 | Rake $0.06 
Board [3h Ts 9d Qc Td]
Seat 1: JoaquinBueno (small blind) folded before Flop
Seat 2: witchdocta00 (big blind) folded before Flop
Seat 3: balisstica showed [Kh Ah] and won ($1.17) with a pair of Tens
Seat 4: densyl111 mucked
Seat 5: stardrakee folded before Flop (didn't bet)
Seat 6: SERG244 (button) folded before Flop (didn't bet)



PokerStars Hand #222957597470:  Hold'em No Limit ($0.05/$0.10 USD) - 2021/01/23 10:46:36 ET
Table 'Saito II' 6-max Seat #1 is the button
Seat 1: JoaquinBueno ($14.18 in chips) 
Seat 2: witchdocta00 ($3.55 in chips) 
Seat 3: balisstica ($13.50 in chips) 
Seat 4: densyl111 ($3.73 in chips) 
Seat 5: stardrakee ($10.78 in chips) 
Seat 6: SERG244 ($21.48 in chips) 
witchdocta00: posts small blind $0.05
balisstica: posts big blind $0.10
*** HOLE CARDS ***
densyl111 has timed out
densyl111: folds 
stardrakee: folds 
SERG244: folds 
JoaquinBueno: folds 
witchdocta00: folds 
Uncalled bet ($0.05) returned to balisstica
balisstica collected $0.10 from pot
balisstica: doesn't show hand 
*** SUMMARY ***
Total pot $0.10 | Rake $0 
Seat 1: JoaquinBueno (button) folded before Flop (didn't bet)
Seat 2: witchdocta00 (small blind) folded before Flop
Seat 3: balisstica (big blind) collected ($0.10)
Seat 4: densyl111 folded before Flop (didn't bet)
Seat 5: stardrakee folded before Flop (didn't bet)
Seat 6: SERG244 folded before Flop (didn't bet)



PokerStars Hand #222957606711:  Hold'em No Limit ($0.05/$0.10 USD) - 2021/01/23 10:46:52 ET
Table 'Saito II' 6-max Seat #2 is the button
Seat 1: JoaquinBueno ($14.18 in chips) 
Seat 2: witchdocta00 ($3.50 in chips) 
Seat 3: balisstica ($13.55 in chips) 
Seat 5: stardrakee ($10.78 in chips) 
Seat 6: SERG244 ($21.48 in chips) 
balisstica: posts small blind $0.05
stardrakee: posts big blind $0.10
*** HOLE CARDS ***
SERG244: raises $0.16 to $0.26
JoaquinBueno: folds 
witchdocta00: folds 
balisstica: folds 
stardrakee: folds 
Uncalled bet ($0.16) returned to SERG244
SERG244 collected $0.25 from pot
SERG244: doesn't show hand 
*** SUMMARY ***
Total pot $0.25 | Rake $0 
Seat 1: JoaquinBueno folded before Flop (didn't bet)
Seat 2: witchdocta00 (button) folded before Flop (didn't bet)
Seat 3: balisstica (small blind) folded before Flop
Seat 5: stardrakee (big blind) folded before Flop
Seat 6: SERG244 collected ($0.25)



PokerStars Hand #222957611065:  Hold'em No Limit ($0.05/$0.10 USD) - 2021/01/23 10:47:00 ET
Table 'Saito II' 6-max Seat #3 is the button
Seat 1: JoaquinBueno ($14.18 in chips) 
Seat 2: witchdocta00 ($3.50 in chips) 
Seat 3: balisstica ($13.50 in chips) 
Seat 5: stardrakee ($10.68 in chips) 
Seat 6: SERG244 ($21.63 in chips) 
stardrakee: posts small blind $0.05
SERG244: posts big blind $0.10
*** HOLE CARDS ***
JoaquinBueno: raises $0.20 to $0.30
witchdocta00: folds 
balisstica: raises $0.60 to $0.90
stardrakee: folds 
SERG244: raises $1.15 to $2.05
JoaquinBueno: folds 
balisstica: folds 
Uncalled bet ($1.15) returned to SERG244
SERG244 collected $2.15 from pot
SERG244: doesn't show hand 
*** SUMMARY ***
Total pot $2.15 | Rake $0 
Seat 1: JoaquinBueno folded before Flop
Seat 2: witchdocta00 folded before Flop (didn't bet)
Seat 3: balisstica (button) folded before Flop
Seat 5: stardrakee (small blind) folded before Flop
Seat 6: SERG244 (big blind) collected ($2.15)



PokerStars Hand #222957627099:  Hold'em No Limit ($0.05/$0.10 USD) - 2021/01/23 10:47:29 ET
Table 'Saito II' 6-max Seat #5 is the button
Seat 1: JoaquinBueno ($13.88 in chips) 
Seat 2: witchdocta00 ($3.50 in chips) 
Seat 3: balisstica ($12.60 in chips) 
Seat 5: stardrakee ($10.63 in chips) 
Seat 6: SERG244 ($22.88 in chips) 
SERG244: posts small blind $0.05
JoaquinBueno: posts big blind $0.10
densyl111: sits out 
*** HOLE CARDS ***
witchdocta00: raises $0.20 to $0.30
balisstica: folds 
stardrakee: folds 
SERG244: folds 
JoaquinBueno: folds 
Uncalled bet ($0.20) returned to witchdocta00
witchdocta00 collected $0.25 from pot
witchdocta00: doesn't show hand 
*** SUMMARY ***
Total pot $0.25 | Rake $0 
Seat 1: JoaquinBueno (big blind) folded before Flop
Seat 2: witchdocta00 collected ($0.25)
Seat 3: balisstica folded before Flop (didn't bet)
Seat 5: stardrakee (button) folded before Flop (didn't bet)
Seat 6: SERG244 (small blind) folded before Flop



PokerStars Hand #222957637441:  Hold'em No Limit ($0.05/$0.10 USD) - 2021/01/23 10:47:48 ET
Table 'Saito II' 6-max Seat #6 is the button
Seat 1: JoaquinBueno ($13.78 in chips) 
Seat 2: witchdocta00 ($3.65 in chips) 
Seat 3: balisstica ($12.60 in chips) 
Seat 4: densyl111 ($3.73 in chips) 
Seat 5: stardrakee ($10.63 in chips) 
Seat 6: SERG244 ($22.83 in chips) 
JoaquinBueno: posts small blind $0.05
witchdocta00: posts big blind $0.10
densyl111: posts small & big blinds $0.15
*** HOLE CARDS ***
balisstica: folds 
densyl111: raises $0.30 to $0.40
stardrakee: folds 
SERG244: folds 
JoaquinBueno: folds 
witchdocta00: folds 
Uncalled bet ($0.30) returned to densyl111
densyl111 collected $0.30 from pot
densyl111: doesn't show hand 
*** SUMMARY ***
Total pot $0.30 | Rake $0 
Seat 1: JoaquinBueno (small blind) folded before Flop
Seat 2: witchdocta00 (big blind) folded before Flop
Seat 3: balisstica folded before Flop (didn't bet)
Seat 4: densyl111 collected ($0.30)
Seat 5: stardrakee folded before Flop (didn't bet)
Seat 6: SERG244 (button) folded before Flop (didn't bet)



PokerStars Hand #222957646863:  Hold'em No Limit ($0.05/$0.10 USD) - 2021/01/23 10:48:05 ET
Table 'Saito II' 6-max Seat #1 is the button
Seat 1: JoaquinBueno ($13.73 in chips) 
Seat 2: witchdocta00 ($3.55 in chips) 
Seat 3: balisstica ($12.60 in chips) 
Seat 4: densyl111 ($3.88 in chips) 
Seat 5: stardrakee ($10.63 in chips) 
Seat 6: SERG244 ($22.83 in chips) 
witchdocta00: posts small blind $0.05
balisstica: posts big blind $0.10
*** HOLE CARDS ***
densyl111: folds 
stardrakee: raises $0.15 to $0.25
SERG244: folds 
JoaquinBueno: folds 
witchdocta00: folds 
balisstica: folds 
Uncalled bet ($0.15) returned to stardrakee
stardrakee collected $0.25 from pot
stardrakee: doesn't show hand 
*** SUMMARY ***
Total pot $0.25 | Rake $0 
Seat 1: JoaquinBueno (button) folded before Flop (didn't bet)
Seat 2: witchdocta00 (small blind) folded before Flop
Seat 3: balisstica (big blind) folded before Flop
Seat 4: densyl111 folded before Flop (didn't bet)
Seat 5: stardrakee collected ($0.25)
Seat 6: SERG244 folded before Flop (didn't bet)



PokerStars Hand #222957655623:  Hold'em No Limit ($0.05/$0.10 USD) - 2021/01/23 10:48:20 ET
Table 'Saito II' 6-max Seat #2 is the button
Seat 1: JoaquinBueno ($13.73 in chips) 
Seat 2: witchdocta00 ($3.50 in chips) 
Seat 3: balisstica ($12.50 in chips) 
Seat 4: densyl111 ($3.88 in chips) 
Seat 5: stardrakee ($10.78 in chips) 
Seat 6: SERG244 ($22.83 in chips) 
balisstica: posts small blind $0.05
densyl111: posts big blind $0.10
*** HOLE CARDS ***
stardrakee: folds 
SERG244: raises $0.16 to $0.26
JoaquinBueno: folds 
witchdocta00: folds 
balisstica: folds 
densyl111: folds 
Uncalled bet ($0.16) returned to SERG244
SERG244 collected $0.25 from pot
SERG244: doesn't show hand 
*** SUMMARY ***
Total pot $0.25 | Rake $0 
Seat 1: JoaquinBueno folded before Flop (didn't bet)
Seat 2: witchdocta00 (button) folded before Flop (didn't bet)
Seat 3: balisstica (small blind) folded before Flop
Seat 4: densyl111 (big blind) folded before Flop
Seat 5: stardrakee folded before Flop (didn't bet)
Seat 6: SERG244 collected ($0.25)



PokerStars Hand #222957664830:  Hold'em No Limit ($0.05/$0.10 USD) - 2021/01/23 10:48:37 ET
Table 'Saito II' 6-max Seat #3 is the button
Seat 1: JoaquinBueno ($13.73 in chips) 
Seat 2: witchdocta00 ($3.50 in chips) 
Seat 3: balisstica ($12.45 in chips) 
Seat 4: densyl111 ($3.78 in chips) 
Seat 5: stardrakee ($10.78 in chips) 
Seat 6: SERG244 ($22.98 in chips) 
densyl111: posts small blind $0.05
stardrakee: posts big blind $0.10
*** HOLE CARDS ***
SERG244: folds 
JoaquinBueno: folds 
witchdocta00: calls $0.10
balisstica: folds 
densyl111: calls $0.05
stardrakee: checks 
*** FLOP *** [9c Jd Td]
densyl111: checks 
stardrakee: checks 
witchdocta00: bets $0.20
densyl111: folds 
stardrakee: folds 
Uncalled bet ($0.20) returned to witchdocta00
witchdocta00 collected $0.29 from pot
witchdocta00: doesn't show hand 
*** SUMMARY ***
Total pot $0.30 | Rake $0.01 
Board [9c Jd Td]
Seat 1: JoaquinBueno folded before Flop (didn't bet)
Seat 2: witchdocta00 collected ($0.29)
Seat 3: balisstica (button) folded before Flop (didn't bet)
Seat 4: densyl111 (small blind) folded on the Flop
Seat 5: stardrakee (big blind) folded on the Flop
Seat 6: SERG244 folded before Flop (didn't bet)



PokerStars Hand #222957688379:  Hold'em No Limit ($0.05/$0.10 USD) - 2021/01/23 10:49:19 ET
Table 'Saito II' 6-max Seat #4 is the button
Seat 1: JoaquinBueno ($13.73 in chips) 
Seat 2: witchdocta00 ($3.69 in chips) 
Seat 3: balisstica ($12.45 in chips) 
Seat 4: densyl111 ($3.68 in chips) 
Seat 5: stardrakee ($10.68 in chips) 
Seat 6: SERG244 ($22.98 in chips) 
stardrakee: posts small blind $0.05
SERG244: posts big blind $0.10
*** HOLE CARDS ***
JoaquinBueno: raises $0.20 to $0.30
witchdocta00: folds 
balisstica: raises $0.60 to $0.90
densyl111: folds 
stardrakee: folds 
SERG244: folds 
JoaquinBueno: calls $0.60
*** FLOP *** [2d 3d 7d]
JoaquinBueno: checks 
balisstica: checks 
*** TURN *** [2d 3d 7d] [7c]
JoaquinBueno: bets $0.93
balisstica: calls $0.93
*** RIVER *** [2d 3d 7d 7c] [4c]
JoaquinBueno: checks 
balisstica: checks 
*** SHOW DOWN ***
JoaquinBueno: shows [As Th] (a pair of Sevens)
balisstica: shows [Qs Qd] (two pair, Queens and Sevens)
balisstica collected $3.64 from pot
*** SUMMARY ***
Total pot $3.81 | Rake $0.17 
Board [2d 3d 7d 7c 4c]
Seat 1: JoaquinBueno showed [As Th] and lost with a pair of Sevens
Seat 2: witchdocta00 folded before Flop (didn't bet)
Seat 3: balisstica showed [Qs Qd] and won ($3.64) with two pair, Queens and Sevens
Seat 4: densyl111 (button) folded before Flop (didn't bet)
Seat 5: stardrakee (small blind) folded before Flop
Seat 6: SERG244 (big blind) folded before Flop



PokerStars Hand #222957714045:  Hold'em No Limit ($0.05/$0.10 USD) - 2021/01/23 10:50:05 ET
Table 'Saito II' 6-max Seat #5 is the button
Seat 1: JoaquinBueno ($11.90 in chips) 
Seat 2: witchdocta00 ($3.69 in chips) 
Seat 3: balisstica ($14.26 in chips) 
Seat 4: densyl111 ($3.68 in chips) 
Seat 5: stardrakee ($10.63 in chips) 
Seat 6: SERG244 ($22.88 in chips) 
SERG244: posts small blind $0.05
JoaquinBueno: posts big blind $0.10
*** HOLE CARDS ***
witchdocta00: folds 
balisstica: folds 
densyl111: raises $0.10 to $0.20
stardrakee: folds 
SERG244: folds 
JoaquinBueno: folds 
Uncalled bet ($0.10) returned to densyl111
densyl111 collected $0.25 from pot
densyl111: doesn't show hand 
*** SUMMARY ***
Total pot $0.25 | Rake $0 
Seat 1: JoaquinBueno (big blind) folded before Flop
Seat 2: witchdocta00 folded before Flop (didn't bet)
Seat 3: balisstica folded before Flop (didn't bet)
Seat 4: densyl111 collected ($0.25)
Seat 5: stardrakee (button) folded before Flop (didn't bet)
Seat 6: SERG244 (small blind) folded before Flop



PokerStars Hand #222957724587:  Hold'em No Limit ($0.05/$0.10 USD) - 2021/01/23 10:50:24 ET
Table 'Saito II' 6-max Seat #6 is the button
Seat 1: JoaquinBueno ($11.80 in chips) 
Seat 2: witchdocta00 ($3.69 in chips) 
Seat 3: balisstica ($14.26 in chips) 
Seat 4: densyl111 ($3.83 in chips) 
Seat 5: stardrakee ($10.63 in chips) 
Seat 6: SERG244 ($22.83 in chips) 
JoaquinBueno: posts small blind $0.05
witchdocta00: posts big blind $0.10
*** HOLE CARDS ***
balisstica: folds 
densyl111 has timed out
densyl111: folds 
stardrakee: folds 
SERG244: folds 
JoaquinBueno: folds 
Uncalled bet ($0.05) returned to witchdocta00
witchdocta00 collected $0.10 from pot
witchdocta00: doesn't show hand 
*** SUMMARY ***
Total pot $0.10 | Rake $0 
Seat 1: JoaquinBueno (small blind) folded before Flop
Seat 2: witchdocta00 (big blind) collected ($0.10)
Seat 3: balisstica folded before Flop (didn't bet)
Seat 4: densyl111 folded before Flop (didn't bet)
Seat 5: stardrakee folded before Flop (didn't bet)
Seat 6: SERG244 (button) folded before Flop (didn't bet)



PokerStars Hand #222957735998:  Hold'em No Limit ($0.05/$0.10 USD) - 2021/01/23 10:50:45 ET
Table 'Saito II' 6-max Seat #1 is the button
Seat 1: JoaquinBueno ($11.75 in chips) 
Seat 2: witchdocta00 ($3.74 in chips) 
Seat 3: balisstica ($14.26 in chips) 
Seat 4: densyl111 ($3.83 in chips) 
Seat 5: stardrakee ($10.63 in chips) 
Seat 6: SERG244 ($22.83 in chips) 
witchdocta00: posts small blind $0.05
balisstica: posts big blind $0.10
*** HOLE CARDS ***
densyl111: calls $0.10
stardrakee: folds 
SERG244: folds 
JoaquinBueno: folds 
witchdocta00: calls $0.05
balisstica: raises $0.30 to $0.40
densyl111: calls $0.30
witchdocta00: folds 
*** FLOP *** [7c 3s 4s]
balisstica: checks 
densyl111: checks 
*** TURN *** [7c 3s 4s] [4c]
balisstica: checks 
densyl111: checks 
*** RIVER *** [7c 3s 4s 4c] [Tc]
balisstica: checks 
densyl111: bets $0.43
balisstica: folds 
Uncalled bet ($0.43) returned to densyl111
densyl111 collected $0.86 from pot
densyl111: doesn't show hand 
*** SUMMARY ***
Total pot $0.90 | Rake $0.04 
Board [7c 3s 4s 4c Tc]
Seat 1: JoaquinBueno (button) folded before Flop (didn't bet)
Seat 2: witchdocta00 (small blind) folded before Flop
Seat 3: balisstica (big blind) folded on the River
Seat 4: densyl111 collected ($0.86)
Seat 5: stardrakee folded before Flop (didn't bet)
Seat 6: SERG244 folded before Flop (didn't bet)



PokerStars Hand #222957760862:  Hold'em No Limit ($0.05/$0.10 USD) - 2021/01/23 10:51:30 ET
Table 'Saito II' 6-max Seat #2 is the button
Seat 1: JoaquinBueno ($11.75 in chips) 
Seat 2: witchdocta00 ($3.64 in chips) 
Seat 3: balisstica ($13.86 in chips) 
Seat 4: densyl111 ($4.29 in chips) 
Seat 5: stardrakee ($10.63 in chips) 
Seat 6: SERG244 ($22.83 in chips) 
balisstica: posts small blind $0.05
densyl111: posts big blind $0.10
*** HOLE CARDS ***
stardrakee: folds 
SERG244: folds 
JoaquinBueno: raises $0.20 to $0.30
witchdocta00: calls $0.30
balisstica: folds 
densyl111: calls $0.20
*** FLOP *** [As 5d 9d]
densyl111: checks 
JoaquinBueno: bets $0.46
witchdocta00: calls $0.46
densyl111: folds 
*** TURN *** [As 5d 9d] [Kc]
JoaquinBueno: checks 
witchdocta00: bets $2.88 and is all-in
JoaquinBueno: calls $2.88
*** RIVER *** [As 5d 9d Kc] [8d]
*** SHOW DOWN ***
JoaquinBueno: shows [7d Ad] (a flush, Ace high)
witchdocta00: shows [8c Ah] (two pair, Aces and Eights)
JoaquinBueno collected $7.29 from pot
*** SUMMARY ***
Total pot $7.63 | Rake $0.34 
Board [As 5d 9d Kc 8d]
Seat 1: JoaquinBueno showed [7d Ad] and won ($7.29) with a flush, Ace high
Seat 2: witchdocta00 (button) showed [8c Ah] and lost with two pair, Aces and Eights
Seat 3: balisstica (small blind) folded before Flop
Seat 4: densyl111 (big blind) folded on the Flop
Seat 5: stardrakee folded before Flop (didn't bet)
Seat 6: SERG244 folded before Flop (didn't bet)



PokerStars Hand #222957790452:  Hold'em No Limit ($0.05/$0.10 USD) - 2021/01/23 10:52:23 ET
Table 'Saito II' 6-max Seat #3 is the button
Seat 1: JoaquinBueno ($15.40 in chips) 
Seat 3: balisstica ($13.81 in chips) 
Seat 4: densyl111 ($3.99 in chips) 
Seat 5: stardrakee ($10.63 in chips) 
Seat 6: SERG244 ($22.83 in chips) 
densyl111: posts small blind $0.05
stardrakee: posts big blind $0.10
*** HOLE CARDS ***
SERG244: raises $0.16 to $0.26
witchdocta00 leaves the table
JoaquinBueno: folds 
rafaelzoccoler joins the table at seat #2 
balisstica: raises $0.49 to $0.75
densyl111: folds 
stardrakee: folds 
SERG244: calls $0.49
*** FLOP *** [Ks Qs 4h]
SERG244: checks 
balisstica: bets $0.79
SERG244: calls $0.79
*** TURN *** [Ks Qs 4h] [4c]
SERG244: checks 
balisstica: bets $2.31
SERG244: folds 
Uncalled bet ($2.31) returned to balisstica
balisstica collected $3.08 from pot
balisstica: doesn't show hand 
*** SUMMARY ***
Total pot $3.23 | Rake $0.15 
Board [Ks Qs 4h 4c]
Seat 1: JoaquinBueno folded before Flop (didn't bet)
Seat 3: balisstica (button) collected ($3.08)
Seat 4: densyl111 (small blind) folded before Flop
Seat 5: stardrakee (big blind) folded before Flop
Seat 6: SERG244 folded on the Turn



PokerStars Hand #222957818407:  Hold'em No Limit ($0.05/$0.10 USD) - 2021/01/23 10:53:14 ET
Table 'Saito II' 6-max Seat #4 is the button
Seat 1: JoaquinBueno ($15.40 in chips) 
Seat 3: balisstica ($15.35 in chips) 
Seat 4: densyl111 ($3.94 in chips) 
Seat 5: stardrakee ($10.53 in chips) 
Seat 6: SERG244 ($21.29 in chips) 
stardrakee: posts small blind $0.05
SERG244: posts big blind $0.10
rafaelzoccoler: sits out 
*** HOLE CARDS ***
JoaquinBueno: folds 
balisstica: folds 
densyl111: raises $0.20 to $0.30
stardrakee: raises $0.90 to $1.20
SERG244: folds 
densyl111: calls $0.90
*** FLOP *** [Qs 9c Kc]
stardrakee: bets $1
densyl111: raises $1.74 to $2.74 and is all-in
stardrakee: calls $1.74
*** TURN *** [Qs 9c Kc] [As]
*** RIVER *** [Qs 9c Kc As] [2h]
*** SHOW DOWN ***
stardrakee: shows [Ah Ks] (two pair, Aces and Kings)
densyl111: shows [Qc Jc] (a pair of Queens)
stardrakee collected $7.62 from pot
*** SUMMARY ***
Total pot $7.98 | Rake $0.36 
Board [Qs 9c Kc As 2h]
Seat 1: JoaquinBueno folded before Flop (didn't bet)
Seat 3: balisstica folded before Flop (didn't bet)
Seat 4: densyl111 (button) showed [Qc Jc] and lost with a pair of Queens
Seat 5: stardrakee (small blind) showed [Ah Ks] and won ($7.62) with two pair, Aces and Kings
Seat 6: SERG244 (big blind) folded before Flop



PokerStars Hand #222957852107:  Hold'em No Limit ($0.05/$0.10 USD) - 2021/01/23 10:54:16 ET
Table 'Saito II' 6-max Seat #5 is the button
Seat 1: JoaquinBueno ($15.40 in chips) 
Seat 3: balisstica ($15.35 in chips) 
Seat 5: stardrakee ($14.21 in chips) 
Seat 6: SERG244 ($21.19 in chips) 
SERG244: posts small blind $0.05
JoaquinBueno: posts big blind $0.10
rafaelzoccoler: sits out 
*** HOLE CARDS ***
balisstica: raises $0.20 to $0.30
stardrakee: folds 
SERG244: folds 
densyl111 leaves the table
JoaquinBueno: calls $0.20
*** FLOP *** [4d 5h 4s]
JoaquinBueno: checks 
balisstica: checks 
*** TURN *** [4d 5h 4s] [4h]
stardrakee leaves the table
JoaquinBueno: bets $0.20
balisstica: calls $0.20
*** RIVER *** [4d 5h 4s 4h] [2c]
JoaquinBueno: bets $0.75
balisstica: calls $0.75
*** SHOW DOWN ***
JoaquinBueno: shows [Jd 9h] (three of a kind, Fours)
balisstica: shows [Ac 3c] (a straight, Ace to Five)
balisstica collected $2.44 from pot
*** SUMMARY ***
Total pot $2.55 | Rake $0.11 
Board [4d 5h 4s 4h 2c]
Seat 1: JoaquinBueno (big blind) showed [Jd 9h] and lost with three of a kind, Fours
Seat 3: balisstica showed [Ac 3c] and won ($2.44) with a straight, Ace to Five
Seat 5: stardrakee (button) folded before Flop (didn't bet)
Seat 6: SERG244 (small blind) folded before Flop



PokerStars Hand #222957866559:  Hold'em No Limit ($0.05/$0.10 USD) - 2021/01/23 10:54:42 ET
Table 'Saito II' 6-max Seat #6 is the button
Seat 1: JoaquinBueno ($14.15 in chips) 
Seat 2: rafaelzoccoler ($8 in chips) 
Seat 3: balisstica ($16.54 in chips) 
Seat 6: SERG244 ($21.14 in chips) 
JoaquinBueno: posts small blind $0.05
rafaelzoccoler: posts big blind $0.10
*** HOLE CARDS ***
balisstica: folds 
SERG244: folds 
JoaquinBueno: raises $0.20 to $0.30
rafaelzoccoler: calls $0.20
*** FLOP *** [7h Th Ad]
JoaquinBueno: checks 
rafaelzoccoler: bets $0.20
JoaquinBueno: calls $0.20
*** TURN *** [7h Th Ad] [7c]
JoaquinBueno: checks 
rafaelzoccoler: bets $0.50
JoaquinBueno: folds 
Uncalled bet ($0.50) returned to rafaelzoccoler
rafaelzoccoler collected $0.96 from pot
rafaelzoccoler: doesn't show hand 
*** SUMMARY ***
Total pot $1 | Rake $0.04 
Board [7h Th Ad 7c]
Seat 1: JoaquinBueno (small blind) folded on the Turn
Seat 2: rafaelzoccoler (big blind) collected ($0.96)
Seat 3: balisstica folded before Flop (didn't bet)
Seat 6: SERG244 (button) folded before Flop (didn't bet)



PokerStars Hand #222957882897:  Hold'em No Limit ($0.05/$0.10 USD) - 2021/01/23 10:55:13 ET
Table 'Saito II' 6-max Seat #1 is the button
Seat 1: JoaquinBueno ($13.65 in chips) 
Seat 2: rafaelzoccoler ($8.46 in chips) 
Seat 3: balisstica ($16.54 in chips) 
Seat 6: SERG244 ($21.14 in chips) 
rafaelzoccoler: posts small blind $0.05
balisstica: posts big blind $0.10
*** HOLE CARDS ***
SERG244: folds 
JoaquinBueno: raises $0.15 to $0.25
rafaelzoccoler: calls $0.20
balisstica: folds 
*** FLOP *** [9h 2h Td]
rafaelzoccoler: checks 
JoaquinBueno: bets $0.29
rafaelzoccoler: folds 
Uncalled bet ($0.29) returned to JoaquinBueno
JoaquinBueno collected $0.57 from pot
JoaquinBueno: doesn't show hand 
*** SUMMARY ***
Total pot $0.60 | Rake $0.03 
Board [9h 2h Td]
Seat 1: JoaquinBueno (button) collected ($0.57)
Seat 2: rafaelzoccoler (small blind) folded on the Flop
Seat 3: balisstica (big blind) folded before Flop
Seat 6: SERG244 folded before Flop (didn't bet)



PokerStars Hand #222957893036:  Hold'em No Limit ($0.05/$0.10 USD) - 2021/01/23 10:55:36 ET
Table 'Saito II' 6-max Seat #2 is the button
Seat 1: JoaquinBueno ($13.97 in chips) 
Seat 2: rafaelzoccoler ($8.21 in chips) 
Seat 3: balisstica ($16.44 in chips) 
JJOOKKEER 77 joins the table at seat #4 
balisstica: posts small blind $0.05
SERG244: is sitting out 
JoaquinBueno: posts big blind $0.10
*** HOLE CARDS ***
rafaelzoccoler: folds 
balisstica: folds 
Uncalled bet ($0.05) returned to JoaquinBueno
JoaquinBueno collected $0.10 from pot
JoaquinBueno: doesn't show hand 
*** SUMMARY ***
Total pot $0.10 | Rake $0 
Seat 1: JoaquinBueno (big blind) collected ($0.10)
Seat 2: rafaelzoccoler (button) folded before Flop (didn't bet)
Seat 3: balisstica (small blind) folded before Flop



PokerStars Hand #222957897157:  Hold'em No Limit ($0.05/$0.10 USD) - 2021/01/23 10:55:46 ET
Table 'Saito II' 6-max Seat #3 is the button
Seat 1: JoaquinBueno ($14.02 in chips) 
Seat 2: rafaelzoccoler ($8.21 in chips) 
Seat 3: balisstica ($16.39 in chips) 
JoaquinBueno: posts small blind $0.05
rafaelzoccoler: posts big blind $0.10
*** HOLE CARDS ***
balisstica: folds 
JoaquinBueno: folds 
Uncalled bet ($0.05) returned to rafaelzoccoler
rafaelzoccoler collected $0.10 from pot
rafaelzoccoler: doesn't show hand 
*** SUMMARY ***
Total pot $0.10 | Rake $0 
Seat 1: JoaquinBueno (small blind) folded before Flop
Seat 2: rafaelzoccoler (big blind) collected ($0.10)
Seat 3: balisstica (button) folded before Flop (didn't bet)



PokerStars Hand #222957902383:  Hold'em No Limit ($0.05/$0.10 USD) - 2021/01/23 10:55:58 ET
Table 'Saito II' 6-max Seat #1 is the button
Seat 1: JoaquinBueno ($13.97 in chips) 
Seat 2: rafaelzoccoler ($8.26 in chips) 
Seat 3: balisstica ($16.39 in chips) 
rafaelzoccoler: posts small blind $0.05
balisstica: posts big blind $0.10
JJOOKKEER 77: sits out 
*** HOLE CARDS ***
pearseman657 joins the table at seat #5 
JoaquinBueno: folds 
rafaelzoccoler: raises $0.10 to $0.20
balisstica: folds 
Uncalled bet ($0.10) returned to rafaelzoccoler
rafaelzoccoler collected $0.20 from pot
rafaelzoccoler: doesn't show hand 
*** SUMMARY ***
Total pot $0.20 | Rake $0 
Seat 1: JoaquinBueno (button) folded before Flop (didn't bet)
Seat 2: rafaelzoccoler (small blind) collected ($0.20)
Seat 3: balisstica (big blind) folded before Flop



PokerStars Hand #222957918483:  Hold'em No Limit ($0.05/$0.10 USD) - 2021/01/23 10:56:35 ET
Table 'Saito II' 6-max Seat #2 is the button
Seat 1: JoaquinBueno ($13.97 in chips) 
Seat 2: rafaelzoccoler ($8.36 in chips) 
Seat 3: balisstica ($16.29 in chips) 
Seat 4: JJOOKKEER 77 ($4 in chips) 
Seat 5: pearseman657 ($10 in chips) 
balisstica: posts small blind $0.05
JJOOKKEER 77: posts big blind $0.10
pearseman657: posts big blind $0.10
*** HOLE CARDS ***
pearseman657: raises $0.25 to $0.35
JoaquinBueno: folds 
rafaelzoccoler: folds 
balisstica: folds 
JJOOKKEER 77: folds 
Uncalled bet ($0.25) returned to pearseman657
pearseman657 collected $0.25 from pot
pearseman657: doesn't show hand 
*** SUMMARY ***
Total pot $0.25 | Rake $0 
Seat 1: JoaquinBueno folded before Flop (didn't bet)
Seat 2: rafaelzoccoler (button) folded before Flop (didn't bet)
Seat 3: balisstica (small blind) folded before Flop
Seat 4: JJOOKKEER 77 (big blind) folded before Flop
Seat 5: pearseman657 collected ($0.25)



PokerStars Hand #222957925073:  Hold'em No Limit ($0.05/$0.10 USD) - 2021/01/23 10:56:50 ET
Table 'Saito II' 6-max Seat #3 is the button
Seat 1: JoaquinBueno ($13.97 in chips) 
Seat 2: rafaelzoccoler ($8.36 in chips) 
Seat 3: balisstica ($16.24 in chips) 
Seat 4: JJOOKKEER 77 ($3.90 in chips) 
Seat 5: pearseman657 ($10.15 in chips) 
JJOOKKEER 77: posts small blind $0.05
pearseman657: posts big blind $0.10
*** HOLE CARDS ***
JoaquinBueno: raises $0.20 to $0.30
rafaelzoccoler: folds 
balisstica has timed out
balisstica: folds 
JJOOKKEER 77: folds 
pearseman657: calls $0.20
*** FLOP *** [Kc Jh 7s]
pearseman657: checks 
JoaquinBueno: bets $0.31
pearseman657: raises $0.31 to $0.62
JoaquinBueno: raises $0.38 to $1
pearseman657: folds 
Uncalled bet ($0.38) returned to JoaquinBueno
JoaquinBueno collected $1.80 from pot
JoaquinBueno: doesn't show hand 
*** SUMMARY ***
Total pot $1.89 | Rake $0.09 
Board [Kc Jh 7s]
Seat 1: JoaquinBueno collected ($1.80)
Seat 2: rafaelzoccoler folded before Flop (didn't bet)
Seat 3: balisstica (button) folded before Flop (didn't bet)
Seat 4: JJOOKKEER 77 (small blind) folded before Flop
Seat 5: pearseman657 (big blind) folded on the Flop



PokerStars Hand #222957947137:  Hold'em No Limit ($0.05/$0.10 USD) - 2021/01/23 10:57:40 ET
Table 'Saito II' 6-max Seat #4 is the button
Seat 1: JoaquinBueno ($14.85 in chips) 
Seat 2: rafaelzoccoler ($8.36 in chips) 
Seat 3: balisstica ($16.24 in chips) 
Seat 4: JJOOKKEER 77 ($3.85 in chips) 
Seat 5: pearseman657 ($9.23 in chips) 
pearseman657: posts small blind $0.05
JoaquinBueno: posts big blind $0.10
*** HOLE CARDS ***
rafaelzoccoler: folds 
balisstica: folds 
JJOOKKEER 77: folds 
pearseman657: folds 
Uncalled bet ($0.05) returned to JoaquinBueno
JoaquinBueno collected $0.10 from pot
JoaquinBueno: doesn't show hand 
*** SUMMARY ***
Total pot $0.10 | Rake $0 
Seat 1: JoaquinBueno (big blind) collected ($0.10)
Seat 2: rafaelzoccoler folded before Flop (didn't bet)
Seat 3: balisstica folded before Flop (didn't bet)
Seat 4: JJOOKKEER 77 (button) folded before Flop (didn't bet)
Seat 5: pearseman657 (small blind) folded before Flop



PokerStars Hand #222957951911:  Hold'em No Limit ($0.05/$0.10 USD) - 2021/01/23 10:57:51 ET
Table 'Saito II' 6-max Seat #5 is the button
Seat 1: JoaquinBueno ($14.90 in chips) 
Seat 2: rafaelzoccoler ($8.36 in chips) 
Seat 3: balisstica ($16.24 in chips) 
Seat 4: JJOOKKEER 77 ($3.85 in chips) 
Seat 5: pearseman657 ($9.18 in chips) 
JoaquinBueno: posts small blind $0.05
rafaelzoccoler: posts big blind $0.10
*** HOLE CARDS ***
balisstica: folds 
JJOOKKEER 77: raises $0.20 to $0.30
pearseman657: calls $0.30
JoaquinBueno: calls $0.25
rafaelzoccoler: folds 
*** FLOP *** [Jd 7h Ts]
JoaquinBueno: checks 
JJOOKKEER 77: bets $0.40
pearseman657: calls $0.40
JoaquinBueno: calls $0.40
*** TURN *** [Jd 7h Ts] [7d]
JoaquinBueno: checks 
JJOOKKEER 77: checks 
pearseman657: checks 
*** RIVER *** [Jd 7h Ts 7d] [8s]
JoaquinBueno: bets $1
JJOOKKEER 77: folds 
pearseman657: calls $1
*** SHOW DOWN ***
JoaquinBueno: shows [9h Qh] (a straight, Eight to Queen)
pearseman657: mucks hand 
JoaquinBueno collected $4.01 from pot
*** SUMMARY ***
Total pot $4.20 | Rake $0.19 
Board [Jd 7h Ts 7d 8s]
Seat 1: JoaquinBueno (small blind) showed [9h Qh] and won ($4.01) with a straight, Eight to Queen
Seat 2: rafaelzoccoler (big blind) folded before Flop
Seat 3: balisstica folded before Flop (didn't bet)
Seat 4: JJOOKKEER 77 folded on the River
Seat 5: pearseman657 (button) mucked



PokerStars Hand #222957981294:  Hold'em No Limit ($0.05/$0.10 USD) - 2021/01/23 10:58:55 ET
Table 'Saito II' 6-max Seat #1 is the button
Seat 1: JoaquinBueno ($17.21 in chips) 
Seat 2: rafaelzoccoler ($8.26 in chips) 
Seat 3: balisstica ($16.24 in chips) 
Seat 4: JJOOKKEER 77 ($3.15 in chips) 
Seat 5: pearseman657 ($7.48 in chips) 
rafaelzoccoler: posts small blind $0.05
balisstica: posts big blind $0.10
*** HOLE CARDS ***
JJOOKKEER 77: folds 
pearseman657: folds 
JoaquinBueno: folds 
rafaelzoccoler: calls $0.05
balisstica: checks 
*** FLOP *** [Js 6s Qs]
rafaelzoccoler: checks 
balisstica: checks 
*** TURN *** [Js 6s Qs] [Kd]
rafaelzoccoler: checks 
balisstica: checks 
*** RIVER *** [Js 6s Qs Kd] [Jd]
rafaelzoccoler: checks 
balisstica: checks 
*** SHOW DOWN ***
rafaelzoccoler: shows [4h 2s] (a pair of Jacks)
balisstica: shows [6h 4s] (two pair, Jacks and Sixes)
balisstica collected $0.19 from pot
*** SUMMARY ***
Total pot $0.20 | Rake $0.01 
Board [Js 6s Qs Kd Jd]
Seat 1: JoaquinBueno (button) folded before Flop (didn't bet)
Seat 2: rafaelzoccoler (small blind) showed [4h 2s] and lost with a pair of Jacks
Seat 3: balisstica (big blind) showed [6h 4s] and won ($0.19) with two pair, Jacks and Sixes
Seat 4: JJOOKKEER 77 folded before Flop (didn't bet)
Seat 5: pearseman657 folded before Flop (didn't bet)



PokerStars Hand #222958013860:  Hold'em No Limit ($0.05/$0.10 USD) - 2021/01/23 11:00:09 ET
Table 'Saito II' 6-max Seat #2 is the button
Seat 1: JoaquinBueno ($17.21 in chips) 
Seat 2: rafaelzoccoler ($8.16 in chips) 
Seat 3: balisstica ($16.33 in chips) 
Seat 4: JJOOKKEER 77 ($3.15 in chips) 
Seat 5: pearseman657 ($10 in chips) 
balisstica: posts small blind $0.05
JJOOKKEER 77: posts big blind $0.10
SERG244: sits out 
*** HOLE CARDS ***
pearseman657: folds 
JoaquinBueno: raises $0.20 to $0.30
rafaelzoccoler: raises $0.20 to $0.50
balisstica: folds 
JJOOKKEER 77: raises $2.65 to $3.15 and is all-in
JoaquinBueno: calls $2.85
rafaelzoccoler: calls $2.65
*** FLOP *** [3s 8h Ah]
balisstica leaves the table
SERG244 leaves the table
JoaquinBueno: checks 
rafaelzoccoler: bets $2
JoaquinBueno: folds 
Uncalled bet ($2) returned to rafaelzoccoler
*** TURN *** [3s 8h Ah] [2d]
katalloo joins the table at seat #6 
*** RIVER *** [3s 8h Ah 2d] [Qs]
*** SHOW DOWN ***
JJOOKKEER 77: shows [Qh Qc] (three of a kind, Queens)
rafaelzoccoler: shows [Kh Jh] (high card Ace)
JJOOKKEER 77 cashed out the hand for $5.10 | Cash Out Fee $0.05
*** SUMMARY ***
Total pot $9.50 | Rake $0.43 
Board [3s 8h Ah 2d Qs]
Seat 1: JoaquinBueno folded on the Flop
Seat 2: rafaelzoccoler (button) showed [Kh Jh] and lost with high card Ace
Seat 3: balisstica (small blind) folded before Flop
Seat 4: JJOOKKEER 77 (big blind) showed [Qh Qc] and won ($9.07) with three of a kind, Queens (pot not awarded as player cashed out)
Seat 5: pearseman657 folded before Flop (didn't bet)



PokerStars Hand #222958034116:  Hold'em No Limit ($0.05/$0.10 USD) - 2021/01/23 11:00:52 ET
Table 'Saito II' 6-max Seat #4 is the button
Seat 1: JoaquinBueno ($14.06 in chips) 
Seat 2: rafaelzoccoler ($5.01 in chips) 
Seat 4: JJOOKKEER 77 ($5.10 in chips) 
Seat 5: pearseman657 ($10 in chips) 
Seat 6: katalloo ($10 in chips) 
pearseman657: posts small blind $0.05
katalloo: posts big blind $0.10
*** HOLE CARDS ***
JoaquinBueno: folds 
rafaelzoccoler: folds 
JJOOKKEER 77: raises $0.10 to $0.20
SERG244 joins the table at seat #3 
pearseman657: folds 
katalloo: folds 
Uncalled bet ($0.10) returned to JJOOKKEER 77
JJOOKKEER 77 collected $0.25 from pot
*** SUMMARY ***
Total pot $0.25 | Rake $0 
Seat 1: JoaquinBueno folded before Flop (didn't bet)
Seat 2: rafaelzoccoler folded before Flop (didn't bet)
Seat 4: JJOOKKEER 77 (button) collected ($0.25)
Seat 5: pearseman657 (small blind) folded before Flop
Seat 6: katalloo (big blind) folded before Flop



PokerStars Hand #222958045097:  Hold'em No Limit ($0.05/$0.10 USD) - 2021/01/23 11:01:14 ET
Table 'Saito II' 6-max Seat #5 is the button
Seat 1: JoaquinBueno ($14.06 in chips) 
Seat 2: rafaelzoccoler ($5.01 in chips) 
Seat 4: JJOOKKEER 77 ($5.25 in chips) 
Seat 5: pearseman657 ($9.95 in chips) 
Seat 6: katalloo ($10 in chips) 
katalloo: posts small blind $0.05
JoaquinBueno: posts big blind $0.10
SERG244: sits out 
*** HOLE CARDS ***
rafaelzoccoler: calls $0.10
JJOOKKEER 77: calls $0.10
pearseman657: folds 
katalloo: folds 
JoaquinBueno: checks 
*** FLOP *** [3h 9s Qc]
JoaquinBueno: checks 
rafaelzoccoler: checks 
JJOOKKEER 77: checks 
*** TURN *** [3h 9s Qc] [4h]
JoaquinBueno: checks 
rafaelzoccoler: checks 
JJOOKKEER 77: bets $0.33
JoaquinBueno: calls $0.33
rafaelzoccoler: folds 
*** RIVER *** [3h 9s Qc 4h] [3d]
JoaquinBueno: checks 
JJOOKKEER 77: checks 
*** SHOW DOWN ***
JoaquinBueno: shows [9c 5c] (two pair, Nines and Threes)
JJOOKKEER 77: mucks hand 
JoaquinBueno collected $0.96 from pot
*** SUMMARY ***
Total pot $1.01 | Rake $0.05 
Board [3h 9s Qc 4h 3d]
Seat 1: JoaquinBueno (big blind) showed [9c 5c] and won ($0.96) with two pair, Nines and Threes
Seat 2: rafaelzoccoler folded on the Turn
Seat 4: JJOOKKEER 77 mucked
Seat 5: pearseman657 (button) folded before Flop (didn't bet)
Seat 6: katalloo (small blind) folded before Flop



PokerStars Hand #222958070076:  Hold'em No Limit ($0.05/$0.10 USD) - 2021/01/23 11:02:01 ET
Table 'Saito II' 6-max Seat #6 is the button
Seat 1: JoaquinBueno ($14.59 in chips) 
Seat 2: rafaelzoccoler ($4.91 in chips) 
Seat 4: JJOOKKEER 77 ($4.82 in chips) 
Seat 5: pearseman657 ($9.95 in chips) 
Seat 6: katalloo ($10 in chips) 
JoaquinBueno: posts small blind $0.05
rafaelzoccoler: posts big blind $0.10
SERG244: sits out 
*** HOLE CARDS ***
JJOOKKEER 77: folds 
pearseman657: raises $0.10 to $0.20
katalloo: calls $0.20
JoaquinBueno: calls $0.15
rafaelzoccoler: calls $0.10
*** FLOP *** [3h 2h 5d]
JoaquinBueno: checks 
rafaelzoccoler: bets $0.20
pearseman657: calls $0.20
katalloo: calls $0.20
JoaquinBueno: calls $0.20
*** TURN *** [3h 2h 5d] [9d]
JoaquinBueno: checks 
rafaelzoccoler: bets $0.50
pearseman657: folds 
katalloo: raises $1.34 to $1.84
JoaquinBueno: folds 
rafaelzoccoler: calls $1.34
*** RIVER *** [3h 2h 5d 9d] [Kd]
rafaelzoccoler: checks 
katalloo: checks 
*** SHOW DOWN ***
rafaelzoccoler: shows [Ad 6h] (high card Ace)
katalloo: shows [9h Qh] (a pair of Nines)
katalloo collected $5.04 from pot
*** SUMMARY ***
Total pot $5.28 | Rake $0.24 
Board [3h 2h 5d 9d Kd]
Seat 1: JoaquinBueno (small blind) folded on the Turn
Seat 2: rafaelzoccoler (big blind) showed [Ad 6h] and lost with high card Ace
Seat 4: JJOOKKEER 77 folded before Flop (didn't bet)
Seat 5: pearseman657 folded on the Turn
Seat 6: katalloo (button) showed [9h Qh] and won ($5.04) with a pair of Nines



PokerStars Hand #222958107254:  Hold'em No Limit ($0.05/$0.10 USD) - 2021/01/23 11:03:11 ET
Table 'Saito II' 6-max Seat #1 is the button
Seat 1: JoaquinBueno ($14.19 in chips) 
Seat 2: rafaelzoccoler ($2.67 in chips) 
Seat 3: SERG244 ($21.14 in chips) 
Seat 4: JJOOKKEER 77 ($4.82 in chips) 
Seat 5: pearseman657 ($9.55 in chips) 
Seat 6: katalloo ($12.80 in chips) 
rafaelzoccoler: posts small blind $0.05
SERG244: posts big blind $0.10
*** HOLE CARDS ***
JJOOKKEER 77: folds 
pearseman657: raises $0.25 to $0.35
katalloo: folds 
JoaquinBueno: folds 
rafaelzoccoler: calls $0.30
SERG244: calls $0.25
*** FLOP *** [2d Ts 5d]
rafaelzoccoler: bets $0.50
SERG244: calls $0.50
pearseman657: raises $2.50 to $3
rafaelzoccoler: calls $1.82 and is all-in
SERG244: raises $17.79 to $20.79 and is all-in
pearseman657: folds 
Uncalled bet ($17.79) returned to SERG244
*** TURN *** [2d Ts 5d] [5c]
*** RIVER *** [2d Ts 5d 5c] [9s]
*** SHOW DOWN ***
SERG244: shows [4d 3d] (a pair of Fives)
SERG244 collected $1.30 from side pot
rafaelzoccoler: shows [5s As] (three of a kind, Fives)
rafaelzoccoler collected $7.65 from main pot
*** SUMMARY ***
Total pot $9.37 Main pot $7.65. Side pot $1.30. | Rake $0.42 
Board [2d Ts 5d 5c 9s]
Seat 1: JoaquinBueno (button) folded before Flop (didn't bet)
Seat 2: rafaelzoccoler (small blind) showed [5s As] and won ($7.65) with three of a kind, Fives
Seat 3: SERG244 (big blind) showed [4d 3d] and won ($1.30) with a pair of Fives
Seat 4: JJOOKKEER 77 folded before Flop (didn't bet)
Seat 5: pearseman657 folded on the Flop
Seat 6: katalloo folded before Flop (didn't bet)



PokerStars Hand #222958146562:  Hold'em No Limit ($0.05/$0.10 USD) - 2021/01/23 11:04:17 ET
Table 'Saito II' 6-max Seat #2 is the button
Seat 1: JoaquinBueno ($14.19 in chips) 
Seat 2: rafaelzoccoler ($7.65 in chips) 
Seat 3: SERG244 ($19.09 in chips) 
Seat 4: JJOOKKEER 77 ($4.82 in chips) 
Seat 5: pearseman657 ($6.20 in chips) 
Seat 6: katalloo ($12.80 in chips) 
SERG244: posts small blind $0.05
JJOOKKEER 77: posts big blind $0.10
*** HOLE CARDS ***
pearseman657: raises $0.25 to $0.35
katalloo: folds 
JoaquinBueno: folds 
rafaelzoccoler: folds 
SERG244: folds 
JJOOKKEER 77: folds 
Uncalled bet ($0.25) returned to pearseman657
pearseman657 collected $0.25 from pot
pearseman657: doesn't show hand 
*** SUMMARY ***
Total pot $0.25 | Rake $0 
Seat 1: JoaquinBueno folded before Flop (didn't bet)
Seat 2: rafaelzoccoler (button) folded before Flop (didn't bet)
Seat 3: SERG244 (small blind) folded before Flop
Seat 4: JJOOKKEER 77 (big blind) folded before Flop
Seat 5: pearseman657 collected ($0.25)
Seat 6: katalloo folded before Flop (didn't bet)



PokerStars Hand #222958156261:  Hold'em No Limit ($0.05/$0.10 USD) - 2021/01/23 11:04:34 ET
Table 'Saito II' 6-max Seat #3 is the button
Seat 1: JoaquinBueno ($14.19 in chips) 
Seat 2: rafaelzoccoler ($7.65 in chips) 
Seat 3: SERG244 ($19.04 in chips) 
Seat 4: JJOOKKEER 77 ($4.72 in chips) 
Seat 5: pearseman657 ($10 in chips) 
Seat 6: katalloo ($12.80 in chips) 
JJOOKKEER 77: posts small blind $0.05
pearseman657: posts big blind $0.10
*** HOLE CARDS ***
katalloo: raises $0.20 to $0.30
JoaquinBueno: folds 
rafaelzoccoler: folds 
SERG244: folds 
JJOOKKEER 77: folds 
pearseman657: folds 
Uncalled bet ($0.20) returned to katalloo
katalloo collected $0.25 from pot
katalloo: doesn't show hand 
*** SUMMARY ***
Total pot $0.25 | Rake $0 
Seat 1: JoaquinBueno folded before Flop (didn't bet)
Seat 2: rafaelzoccoler folded before Flop (didn't bet)
Seat 3: SERG244 (button) folded before Flop (didn't bet)
Seat 4: JJOOKKEER 77 (small blind) folded before Flop
Seat 5: pearseman657 (big blind) folded before Flop
Seat 6: katalloo collected ($0.25)



PokerStars Hand #222958163423:  Hold'em No Limit ($0.05/$0.10 USD) - 2021/01/23 11:04:46 ET
Table 'Saito II' 6-max Seat #4 is the button
Seat 1: JoaquinBueno ($14.19 in chips) 
Seat 2: rafaelzoccoler ($7.65 in chips) 
Seat 3: SERG244 ($19.04 in chips) 
Seat 4: JJOOKKEER 77 ($4.67 in chips) 
Seat 5: pearseman657 ($9.90 in chips) 
Seat 6: katalloo ($12.95 in chips) 
pearseman657: posts small blind $0.05
katalloo: posts big blind $0.10
*** HOLE CARDS ***
JoaquinBueno: folds 
rafaelzoccoler: calls $0.10
SERG244: folds 
JJOOKKEER 77: folds 
pearseman657: folds 
katalloo: checks 
*** FLOP *** [6c 7h 9d]
katalloo: checks 
rafaelzoccoler: bets $0.50
katalloo: folds 
Uncalled bet ($0.50) returned to rafaelzoccoler
rafaelzoccoler collected $0.24 from pot
rafaelzoccoler: doesn't show hand 
*** SUMMARY ***
Total pot $0.25 | Rake $0.01 
Board [6c 7h 9d]
Seat 1: JoaquinBueno folded before Flop (didn't bet)
Seat 2: rafaelzoccoler collected ($0.24)
Seat 3: SERG244 folded before Flop (didn't bet)
Seat 4: JJOOKKEER 77 (button) folded before Flop (didn't bet)
Seat 5: pearseman657 (small blind) folded before Flop
Seat 6: katalloo (big blind) folded on the Flop



PokerStars Hand #222958178027:  Hold'em No Limit ($0.05/$0.10 USD) - 2021/01/23 11:05:11 ET
Table 'Saito II' 6-max Seat #5 is the button
Seat 1: JoaquinBueno ($14.19 in chips) 
Seat 2: rafaelzoccoler ($7.79 in chips) 
Seat 3: SERG244 ($19.04 in chips) 
Seat 4: JJOOKKEER 77 ($4.67 in chips) 
Seat 5: pearseman657 ($9.85 in chips) 
Seat 6: katalloo ($12.85 in chips) 
katalloo: posts small blind $0.05
JoaquinBueno: posts big blind $0.10
*** HOLE CARDS ***
rafaelzoccoler: raises $0.10 to $0.20
SERG244: folds 
JJOOKKEER 77: folds 
pearseman657: folds 
katalloo: folds 
JoaquinBueno: folds 
Uncalled bet ($0.10) returned to rafaelzoccoler
rafaelzoccoler collected $0.25 from pot
rafaelzoccoler: doesn't show hand 
*** SUMMARY ***
Total pot $0.25 | Rake $0 
Seat 1: JoaquinBueno (big blind) folded before Flop
Seat 2: rafaelzoccoler collected ($0.25)
Seat 3: SERG244 folded before Flop (didn't bet)
Seat 4: JJOOKKEER 77 folded before Flop (didn't bet)
Seat 5: pearseman657 (button) folded before Flop (didn't bet)
Seat 6: katalloo (small blind) folded before Flop



PokerStars Hand #222958185979:  Hold'em No Limit ($0.05/$0.10 USD) - 2021/01/23 11:05:25 ET
Table 'Saito II' 6-max Seat #6 is the button
Seat 1: JoaquinBueno ($14.09 in chips) 
Seat 2: rafaelzoccoler ($7.94 in chips) 
Seat 3: SERG244 ($19.04 in chips) 
Seat 4: JJOOKKEER 77 ($4.67 in chips) 
Seat 5: pearseman657 ($9.85 in chips) 
Seat 6: katalloo ($12.80 in chips) 
JoaquinBueno: posts small blind $0.05
rafaelzoccoler: posts big blind $0.10
*** HOLE CARDS ***
SERG244: folds 
JJOOKKEER 77: folds 
pearseman657: folds 
katalloo: folds 
JoaquinBueno: folds 
Uncalled bet ($0.05) returned to rafaelzoccoler
rafaelzoccoler collected $0.10 from pot
rafaelzoccoler: doesn't show hand 
*** SUMMARY ***
Total pot $0.10 | Rake $0 
Seat 1: JoaquinBueno (small blind) folded before Flop
Seat 2: rafaelzoccoler (big blind) collected ($0.10)
Seat 3: SERG244 folded before Flop (didn't bet)
Seat 4: JJOOKKEER 77 folded before Flop (didn't bet)
Seat 5: pearseman657 folded before Flop (didn't bet)
Seat 6: katalloo (button) folded before Flop (didn't bet)



PokerStars Hand #222958193384:  Hold'em No Limit ($0.05/$0.10 USD) - 2021/01/23 11:05:37 ET
Table 'Saito II' 6-max Seat #1 is the button
Seat 1: JoaquinBueno ($14.04 in chips) 
Seat 2: rafaelzoccoler ($7.99 in chips) 
Seat 3: SERG244 ($19.04 in chips) 
Seat 4: JJOOKKEER 77 ($4.67 in chips) 
Seat 5: pearseman657 ($9.85 in chips) 
Seat 6: katalloo ($12.80 in chips) 
rafaelzoccoler: posts small blind $0.05
SERG244: posts big blind $0.10
*** HOLE CARDS ***
JJOOKKEER 77: folds 
pearseman657: raises $0.25 to $0.35
katalloo: folds 
JoaquinBueno: folds 
rafaelzoccoler: folds 
SERG244: folds 
Uncalled bet ($0.25) returned to pearseman657
pearseman657 collected $0.25 from pot
pearseman657: doesn't show hand 
*** SUMMARY ***
Total pot $0.25 | Rake $0 
Seat 1: JoaquinBueno (button) folded before Flop (didn't bet)
Seat 2: rafaelzoccoler (small blind) folded before Flop
Seat 3: SERG244 (big blind) folded before Flop
Seat 4: JJOOKKEER 77 folded before Flop (didn't bet)
Seat 5: pearseman657 collected ($0.25)
Seat 6: katalloo folded before Flop (didn't bet)



PokerStars Hand #222958204254:  Hold'em No Limit ($0.05/$0.10 USD) - 2021/01/23 11:05:56 ET
Table 'Saito II' 6-max Seat #2 is the button
Seat 1: JoaquinBueno ($14.04 in chips) 
Seat 2: rafaelzoccoler ($7.94 in chips) 
Seat 3: SERG244 ($18.94 in chips) 
Seat 4: JJOOKKEER 77 ($4.67 in chips) 
Seat 5: pearseman657 ($10 in chips) 
Seat 6: katalloo ($12.80 in chips) 
SERG244: posts small blind $0.05
JJOOKKEER 77: posts big blind $0.10
*** HOLE CARDS ***
pearseman657: folds 
katalloo: folds 
JoaquinBueno: folds 
rafaelzoccoler: folds 
SERG244: folds 
Uncalled bet ($0.05) returned to JJOOKKEER 77
JJOOKKEER 77 collected $0.10 from pot
*** SUMMARY ***
Total pot $0.10 | Rake $0 
Seat 1: JoaquinBueno folded before Flop (didn't bet)
Seat 2: rafaelzoccoler (button) folded before Flop (didn't bet)
Seat 3: SERG244 (small blind) folded before Flop
Seat 4: JJOOKKEER 77 (big blind) collected ($0.10)
Seat 5: pearseman657 folded before Flop (didn't bet)
Seat 6: katalloo folded before Flop (didn't bet)



PokerStars Hand #222958214518:  Hold'em No Limit ($0.05/$0.10 USD) - 2021/01/23 11:06:13 ET
Table 'Saito II' 6-max Seat #3 is the button
Seat 1: JoaquinBueno ($14.04 in chips) 
Seat 2: rafaelzoccoler ($7.94 in chips) 
Seat 3: SERG244 ($18.89 in chips) 
Seat 4: JJOOKKEER 77 ($4.72 in chips) 
Seat 5: pearseman657 ($10 in chips) 
Seat 6: katalloo ($12.80 in chips) 
JJOOKKEER 77: posts small blind $0.05
pearseman657: posts big blind $0.10
*** HOLE CARDS ***
katalloo: folds 
JoaquinBueno: folds 
rafaelzoccoler: calls $0.10
SERG244: raises $0.50 to $0.60
JJOOKKEER 77: folds 
pearseman657: calls $0.50
rafaelzoccoler: folds 
*** FLOP *** [3h Ah 3c]
pearseman657: checks 
SERG244: checks 
*** TURN *** [3h Ah 3c] [3d]
pearseman657: bets $1.29
SERG244: calls $1.29
*** RIVER *** [3h Ah 3c 3d] [Qs]
pearseman657: bets $1.88
SERG244: raises $15.12 to $17 and is all-in
pearseman657: calls $6.23 and is all-in
Uncalled bet ($8.89) returned to SERG244
*** SHOW DOWN ***
SERG244: shows [As Ac] (a full house, Aces full of Threes)
pearseman657: shows [2c 2d] (a full house, Threes full of Deuces)
SERG244 collected $19.24 from pot
*** SUMMARY ***
Total pot $20.15 | Rake $0.91 
Board [3h Ah 3c 3d Qs]
Seat 1: JoaquinBueno folded before Flop (didn't bet)
Seat 2: rafaelzoccoler folded before Flop
Seat 3: SERG244 (button) showed [As Ac] and won ($19.24) with a full house, Aces full of Threes
Seat 4: JJOOKKEER 77 (small blind) folded before Flop
Seat 5: pearseman657 (big blind) showed [2c 2d] and lost with a full house, Threes full of Deuces
Seat 6: katalloo folded before Flop (didn't bet)



PokerStars Hand #222958246724:  Hold'em No Limit ($0.05/$0.10 USD) - 2021/01/23 11:07:07 ET
Table 'Saito II' 6-max Seat #4 is the button
Seat 1: JoaquinBueno ($14.04 in chips) 
Seat 2: rafaelzoccoler ($7.84 in chips) 
Seat 3: SERG244 ($28.13 in chips) 
Seat 4: JJOOKKEER 77 ($4.67 in chips) 
Seat 6: katalloo ($12.80 in chips) 
katalloo: posts small blind $0.05
JoaquinBueno: posts big blind $0.10
*** HOLE CARDS ***
rafaelzoccoler: folds 
SERG244: raises $0.16 to $0.26
JJOOKKEER 77: folds 
katalloo: folds 
JoaquinBueno: folds 
Uncalled bet ($0.16) returned to SERG244
SERG244 collected $0.25 from pot
SERG244: doesn't show hand 
*** SUMMARY ***
Total pot $0.25 | Rake $0 
Seat 1: JoaquinBueno (big blind) folded before Flop
Seat 2: rafaelzoccoler folded before Flop (didn't bet)
Seat 3: SERG244 collected ($0.25)
Seat 4: JJOOKKEER 77 (button) folded before Flop (didn't bet)
Seat 6: katalloo (small blind) folded before Flop



PokerStars Hand #222958256590:  Hold'em No Limit ($0.05/$0.10 USD) - 2021/01/23 11:07:24 ET
Table 'Saito II' 6-max Seat #6 is the button
Seat 1: JoaquinBueno ($13.94 in chips) 
Seat 2: rafaelzoccoler ($7.84 in chips) 
Seat 3: SERG244 ($28.28 in chips) 
Seat 4: JJOOKKEER 77 ($4.67 in chips) 
Seat 5: pearseman657 ($10 in chips) 
Seat 6: katalloo ($12.75 in chips) 
JoaquinBueno: posts small blind $0.05
rafaelzoccoler: posts big blind $0.10
pearseman657: posts small blind $0.05
*** HOLE CARDS ***
SERG244: raises $0.31 to $0.41
JJOOKKEER 77: folds 
pearseman657: folds 
katalloo: folds 
JoaquinBueno: folds 
rafaelzoccoler: calls $0.31
*** FLOP *** [9h 2s 4d]
rafaelzoccoler: checks 
SERG244: bets $0.44
rafaelzoccoler: folds 
Uncalled bet ($0.44) returned to SERG244
SERG244 collected $0.88 from pot
SERG244: doesn't show hand 
*** SUMMARY ***
Total pot $0.92 | Rake $0.04 
Board [9h 2s 4d]
Seat 1: JoaquinBueno (small blind) folded before Flop
Seat 2: rafaelzoccoler (big blind) folded on the Flop
Seat 3: SERG244 collected ($0.88)
Seat 4: JJOOKKEER 77 folded before Flop (didn't bet)
Seat 5: pearseman657 folded before Flop (didn't bet)
Seat 6: katalloo (button) folded before Flop (didn't bet)



PokerStars Hand #222958279679:  Hold'em No Limit ($0.05/$0.10 USD) - 2021/01/23 11:08:03 ET
Table 'Saito II' 6-max Seat #1 is the button
Seat 1: JoaquinBueno ($13.89 in chips) 
Seat 2: rafaelzoccoler ($7.43 in chips) 
Seat 3: SERG244 ($28.75 in chips) 
Seat 4: JJOOKKEER 77 ($4.67 in chips) 
Seat 5: pearseman657 ($9.95 in chips) 
Seat 6: katalloo ($12.75 in chips) 
rafaelzoccoler: posts small blind $0.05
SERG244: posts big blind $0.10
*** HOLE CARDS ***
JJOOKKEER 77: folds 
pearseman657: raises $0.25 to $0.35
katalloo: folds 
JoaquinBueno: calls $0.35
rafaelzoccoler: folds 
SERG244: folds 
*** FLOP *** [Kh 2h 9s]
pearseman657: bets $0.81
JoaquinBueno: folds 
Uncalled bet ($0.81) returned to pearseman657
pearseman657 collected $0.81 from pot
pearseman657: doesn't show hand 
*** SUMMARY ***
Total pot $0.85 | Rake $0.04 
Board [Kh 2h 9s]
Seat 1: JoaquinBueno (button) folded on the Flop
Seat 2: rafaelzoccoler (small blind) folded before Flop
Seat 3: SERG244 (big blind) folded before Flop
Seat 4: JJOOKKEER 77 folded before Flop (didn't bet)
Seat 5: pearseman657 collected ($0.81)
Seat 6: katalloo folded before Flop (didn't bet)



PokerStars Hand #222958302186:  Hold'em No Limit ($0.05/$0.10 USD) - 2021/01/23 11:08:40 ET
Table 'Saito II' 6-max Seat #2 is the button
Seat 1: JoaquinBueno ($13.54 in chips) 
Seat 2: rafaelzoccoler ($7.38 in chips) 
Seat 3: SERG244 ($28.65 in chips) 
Seat 4: JJOOKKEER 77 ($4.67 in chips) 
Seat 5: pearseman657 ($10.41 in chips) 
Seat 6: katalloo ($12.75 in chips) 
SERG244: posts small blind $0.05
JJOOKKEER 77: posts big blind $0.10
*** HOLE CARDS ***
pearseman657: calls $0.10
katalloo: folds 
JoaquinBueno: folds 
rafaelzoccoler: folds 
SERG244: calls $0.05
JJOOKKEER 77: checks 
*** FLOP *** [6h 8d Ks]
SERG244: checks 
JJOOKKEER 77: checks 
pearseman657: bets $0.29
SERG244: folds 
JJOOKKEER 77: folds 
Uncalled bet ($0.29) returned to pearseman657
pearseman657 collected $0.29 from pot
pearseman657: doesn't show hand 
*** SUMMARY ***
Total pot $0.30 | Rake $0.01 
Board [6h 8d Ks]
Seat 1: JoaquinBueno folded before Flop (didn't bet)
Seat 2: rafaelzoccoler (button) folded before Flop (didn't bet)
Seat 3: SERG244 (small blind) folded on the Flop
Seat 4: JJOOKKEER 77 (big blind) folded on the Flop
Seat 5: pearseman657 collected ($0.29)
Seat 6: katalloo folded before Flop (didn't bet)



PokerStars Hand #222958326016:  Hold'em No Limit ($0.05/$0.10 USD) - 2021/01/23 11:09:20 ET
Table 'Saito II' 6-max Seat #3 is the button
Seat 1: JoaquinBueno ($13.54 in chips) 
Seat 2: rafaelzoccoler ($7.38 in chips) 
Seat 3: SERG244 ($28.55 in chips) 
Seat 4: JJOOKKEER 77 ($4.57 in chips) 
Seat 5: pearseman657 ($10.60 in chips) 
Seat 6: katalloo ($12.75 in chips) 
JJOOKKEER 77: posts small blind $0.05
pearseman657: posts big blind $0.10
*** HOLE CARDS ***
katalloo: folds 
JoaquinBueno: folds 
rafaelzoccoler: folds 
SERG244: folds 
JJOOKKEER 77: calls $0.05
pearseman657: raises $0.20 to $0.30
JJOOKKEER 77: calls $0.20
*** FLOP *** [2s Ks 7c]
JJOOKKEER 77: checks 
pearseman657: bets $0.57
JJOOKKEER 77: folds 
Uncalled bet ($0.57) returned to pearseman657
pearseman657 collected $0.57 from pot
pearseman657: doesn't show hand 
*** SUMMARY ***
Total pot $0.60 | Rake $0.03 
Board [2s Ks 7c]
Seat 1: JoaquinBueno folded before Flop (didn't bet)
Seat 2: rafaelzoccoler folded before Flop (didn't bet)
Seat 3: SERG244 (button) folded before Flop (didn't bet)
Seat 4: JJOOKKEER 77 (small blind) folded on the Flop
Seat 5: pearseman657 (big blind) collected ($0.57)
Seat 6: katalloo folded before Flop (didn't bet)



PokerStars Hand #222958343439:  Hold'em No Limit ($0.05/$0.10 USD) - 2021/01/23 11:09:49 ET
Table 'Saito II' 6-max Seat #4 is the button
Seat 1: JoaquinBueno ($13.54 in chips) 
Seat 2: rafaelzoccoler ($7.38 in chips) 
Seat 3: SERG244 ($28.55 in chips) 
Seat 4: JJOOKKEER 77 ($4.27 in chips) 
Seat 5: pearseman657 ($10.87 in chips) 
Seat 6: katalloo ($12.75 in chips) 
pearseman657: posts small blind $0.05
katalloo: posts big blind $0.10
*** HOLE CARDS ***
JoaquinBueno: folds 
rafaelzoccoler: folds 
SERG244: raises $0.16 to $0.26
JJOOKKEER 77: folds 
pearseman657: folds 
katalloo: folds 
Uncalled bet ($0.16) returned to SERG244
SERG244 collected $0.25 from pot
SERG244: doesn't show hand 
*** SUMMARY ***
Total pot $0.25 | Rake $0 
Seat 1: JoaquinBueno folded before Flop (didn't bet)
Seat 2: rafaelzoccoler folded before Flop (didn't bet)
Seat 3: SERG244 collected ($0.25)
Seat 4: JJOOKKEER 77 (button) folded before Flop (didn't bet)
Seat 5: pearseman657 (small blind) folded before Flop
Seat 6: katalloo (big blind) folded before Flop



PokerStars Hand #222958351864:  Hold'em No Limit ($0.05/$0.10 USD) - 2021/01/23 11:10:03 ET
Table 'Saito II' 6-max Seat #5 is the button
Seat 1: JoaquinBueno ($13.54 in chips) 
Seat 2: rafaelzoccoler ($7.38 in chips) 
Seat 3: SERG244 ($28.70 in chips) 
Seat 4: JJOOKKEER 77 ($4.27 in chips) 
Seat 5: pearseman657 ($10.82 in chips) 
Seat 6: katalloo ($12.65 in chips) 
katalloo: posts small blind $0.05
JoaquinBueno: posts big blind $0.10
*** HOLE CARDS ***
rafaelzoccoler: folds 
SERG244: folds 
JJOOKKEER 77: folds 
pearseman657: folds 
katalloo: raises $0.15 to $0.25
JoaquinBueno: raises $0.75 to $1
katalloo: folds 
Uncalled bet ($0.75) returned to JoaquinBueno
JoaquinBueno collected $0.50 from pot
JoaquinBueno: doesn't show hand 
*** SUMMARY ***
Total pot $0.50 | Rake $0 
Seat 1: JoaquinBueno (big blind) collected ($0.50)
Seat 2: rafaelzoccoler folded before Flop (didn't bet)
Seat 3: SERG244 folded before Flop (didn't bet)
Seat 4: JJOOKKEER 77 folded before Flop (didn't bet)
Seat 5: pearseman657 (button) folded before Flop (didn't bet)
Seat 6: katalloo (small blind) folded before Flop



PokerStars Hand #222958371605:  Hold'em No Limit ($0.05/$0.10 USD) - 2021/01/23 11:10:36 ET
Table 'Saito II' 6-max Seat #6 is the button
Seat 1: JoaquinBueno ($13.79 in chips) 
Seat 2: rafaelzoccoler ($7.38 in chips) 
Seat 3: SERG244 ($28.70 in chips) 
Seat 4: JJOOKKEER 77 ($4.27 in chips) 
Seat 5: pearseman657 ($10.82 in chips) 
Seat 6: katalloo ($12.40 in chips) 
JoaquinBueno: posts small blind $0.05
rafaelzoccoler: posts big blind $0.10
*** HOLE CARDS ***
SERG244: raises $0.16 to $0.26
JJOOKKEER 77: folds 
pearseman657 has timed out
pearseman657: folds 
katalloo: folds 
JoaquinBueno: folds 
rafaelzoccoler: calls $0.16
*** FLOP *** [8h 2d Jd]
rafaelzoccoler: checks 
SERG244: checks 
*** TURN *** [8h 2d Jd] [3h]
rafaelzoccoler: bets $0.20
SERG244: raises $0.40 to $0.60
rafaelzoccoler: calls $0.40
*** RIVER *** [8h 2d Jd 3h] [Ts]
rafaelzoccoler: checks 
SERG244: checks 
*** SHOW DOWN ***
rafaelzoccoler: shows [Qh 9h] (a straight, Eight to Queen)
SERG244: mucks hand 
rafaelzoccoler collected $1.69 from pot
*** SUMMARY ***
Total pot $1.77 | Rake $0.08 
Board [8h 2d Jd 3h Ts]
Seat 1: JoaquinBueno (small blind) folded before Flop
Seat 2: rafaelzoccoler (big blind) showed [Qh 9h] and won ($1.69) with a straight, Eight to Queen
Seat 3: SERG244 mucked
Seat 4: JJOOKKEER 77 folded before Flop (didn't bet)
Seat 5: pearseman657 folded before Flop (didn't bet)
Seat 6: katalloo (button) folded before Flop (didn't bet)



PokerStars Hand #222958406157:  Hold'em No Limit ($0.05/$0.10 USD) - 2021/01/23 11:11:34 ET
Table 'Saito II' 6-max Seat #1 is the button
Seat 1: JoaquinBueno ($13.74 in chips) 
Seat 2: rafaelzoccoler ($8.21 in chips) 
Seat 3: SERG244 ($27.84 in chips) 
Seat 4: JJOOKKEER 77 ($4.27 in chips) 
Seat 6: katalloo ($12.40 in chips) 
rafaelzoccoler: posts small blind $0.05
SERG244: posts big blind $0.10
*** HOLE CARDS ***
JJOOKKEER 77: folds 
katalloo: raises $0.15 to $0.25
JoaquinBueno: folds 
rafaelzoccoler: folds 
SERG244: calls $0.15
*** FLOP *** [2s 7c Jc]
SERG244: checks 
katalloo: bets $0.35
SERG244: folds 
Uncalled bet ($0.35) returned to katalloo
katalloo collected $0.53 from pot
katalloo: doesn't show hand 
*** SUMMARY ***
Total pot $0.55 | Rake $0.02 
Board [2s 7c Jc]
Seat 1: JoaquinBueno (button) folded before Flop (didn't bet)
Seat 2: rafaelzoccoler (small blind) folded before Flop
Seat 3: SERG244 (big blind) folded on the Flop
Seat 4: JJOOKKEER 77 folded before Flop (didn't bet)
Seat 6: katalloo collected ($0.53)



PokerStars Hand #222958425367:  Hold'em No Limit ($0.05/$0.10 USD) - 2021/01/23 11:12:06 ET
Table 'Saito II' 6-max Seat #2 is the button
Seat 1: JoaquinBueno ($13.74 in chips) 
Seat 2: rafaelzoccoler ($8.16 in chips) 
Seat 3: SERG244 ($27.59 in chips) 
Seat 4: JJOOKKEER 77 ($4.27 in chips) 
Seat 6: katalloo ($12.68 in chips) 
SERG244: posts small blind $0.05
JJOOKKEER 77: posts big blind $0.10
*** HOLE CARDS ***
katalloo: raises $0.20 to $0.30
JoaquinBueno: folds 
rafaelzoccoler: folds 
SERG244: folds 
JJOOKKEER 77: folds 
Uncalled bet ($0.20) returned to katalloo
katalloo collected $0.25 from pot
katalloo: doesn't show hand 
*** SUMMARY ***
Total pot $0.25 | Rake $0 
Seat 1: JoaquinBueno folded before Flop (didn't bet)
Seat 2: rafaelzoccoler (button) folded before Flop (didn't bet)
Seat 3: SERG244 (small blind) folded before Flop
Seat 4: JJOOKKEER 77 (big blind) folded before Flop
Seat 6: katalloo collected ($0.25)



PokerStars Hand #222958437289:  Hold'em No Limit ($0.05/$0.10 USD) - 2021/01/23 11:12:25 ET
Table 'Saito II' 6-max Seat #3 is the button
Seat 1: JoaquinBueno ($13.74 in chips) 
Seat 2: rafaelzoccoler ($8.16 in chips) 
Seat 3: SERG244 ($27.54 in chips) 
Seat 4: JJOOKKEER 77 ($4.17 in chips) 
JJOOKKEER 77: posts small blind $0.05
katalloo: is sitting out 
JoaquinBueno: posts big blind $0.10
*** HOLE CARDS ***
katalloo leaves the table
rafaelzoccoler: raises $0.10 to $0.20
SERG244: folds 
Hamilton_TD joins the table at seat #6 
JJOOKKEER 77: folds 
JoaquinBueno: folds 
Uncalled bet ($0.10) returned to rafaelzoccoler
rafaelzoccoler collected $0.25 from pot
rafaelzoccoler: doesn't show hand 
*** SUMMARY ***
Total pot $0.25 | Rake $0 
Seat 1: JoaquinBueno (big blind) folded before Flop
Seat 2: rafaelzoccoler collected ($0.25)
Seat 3: SERG244 (button) folded before Flop (didn't bet)
Seat 4: JJOOKKEER 77 (small blind) folded before Flop



PokerStars Hand #222958446573:  Hold'em No Limit ($0.05/$0.10 USD) - 2021/01/23 11:12:41 ET
Table 'Saito II' 6-max Seat #4 is the button
Seat 1: JoaquinBueno ($13.64 in chips) 
Seat 2: rafaelzoccoler ($8.31 in chips) 
Seat 3: SERG244 ($27.54 in chips) 
Seat 4: JJOOKKEER 77 ($4.12 in chips) 
JoaquinBueno: posts small blind $0.05
rafaelzoccoler: posts big blind $0.10
*** HOLE CARDS ***
SERG244: folds 
JJOOKKEER 77: raises $0.20 to $0.30
JoaquinBueno: folds 
rafaelzoccoler: calls $0.20
*** FLOP *** [9c 7s 7c]
rafaelzoccoler: checks 
JJOOKKEER 77: bets $0.30
rafaelzoccoler: folds 
Uncalled bet ($0.30) returned to JJOOKKEER 77
JJOOKKEER 77 collected $0.62 from pot
*** SUMMARY ***
Total pot $0.65 | Rake $0.03 
Board [9c 7s 7c]
Seat 1: JoaquinBueno (small blind) folded before Flop
Seat 2: rafaelzoccoler (big blind) folded on the Flop
Seat 3: SERG244 folded before Flop (didn't bet)
Seat 4: JJOOKKEER 77 (button) collected ($0.62)



PokerStars Hand #222958461527:  Hold'em No Limit ($0.05/$0.10 USD) - 2021/01/23 11:13:06 ET
Table 'Saito II' 6-max Seat #1 is the button
Seat 1: JoaquinBueno ($13.59 in chips) 
Seat 2: rafaelzoccoler ($8.01 in chips) 
Seat 3: SERG244 ($27.54 in chips) 
Seat 4: JJOOKKEER 77 ($4.44 in chips) 
rafaelzoccoler: posts small blind $0.05
SERG244: posts big blind $0.10
Hamilton_TD: sits out 
*** HOLE CARDS ***
JJOOKKEER 77: folds 
JoaquinBueno: folds 
rafaelzoccoler: calls $0.05
SERG244: checks 
*** FLOP *** [Kh Th 9h]
rafaelzoccoler: checks 
SERG244: checks 
*** TURN *** [Kh Th 9h] [5h]
rafaelzoccoler: checks 
SERG244: checks 
*** RIVER *** [Kh Th 9h 5h] [2s]
rafaelzoccoler: checks 
SERG244: checks 
*** SHOW DOWN ***
rafaelzoccoler: shows [4s 7c] (high card King)
SERG244: shows [Jd 2d] (a pair of Deuces)
SERG244 collected $0.19 from pot
*** SUMMARY ***
Total pot $0.20 | Rake $0.01 
Board [Kh Th 9h 5h 2s]
Seat 1: JoaquinBueno (button) folded before Flop (didn't bet)
Seat 2: rafaelzoccoler (small blind) showed [4s 7c] and lost with high card King
Seat 3: SERG244 (big blind) showed [Jd 2d] and won ($0.19) with a pair of Deuces
Seat 4: JJOOKKEER 77 folded before Flop (didn't bet)



PokerStars Hand #222958483204:  Hold'em No Limit ($0.05/$0.10 USD) - 2021/01/23 11:13:34 ET
Table 'Saito II' 6-max Seat #2 is the button
Seat 1: JoaquinBueno ($13.59 in chips) 
Seat 2: rafaelzoccoler ($7.91 in chips) 
Seat 3: SERG244 ($27.63 in chips) 
Seat 4: JJOOKKEER 77 ($4.44 in chips) 
SERG244: posts small blind $0.05
JJOOKKEER 77: posts big blind $0.10
Hamilton_TD: sits out 
*** HOLE CARDS ***
JoaquinBueno: raises $0.20 to $0.30
rafaelzoccoler: folds 
SERG244: folds 
JJOOKKEER 77: folds 
Uncalled bet ($0.20) returned to JoaquinBueno
JoaquinBueno collected $0.25 from pot
JoaquinBueno: doesn't show hand 
*** SUMMARY ***
Total pot $0.25 | Rake $0 
Seat 1: JoaquinBueno collected ($0.25)
Seat 2: rafaelzoccoler (button) folded before Flop (didn't bet)
Seat 3: SERG244 (small blind) folded before Flop
Seat 4: JJOOKKEER 77 (big blind) folded before Flop



PokerStars Hand #222958490097:  Hold'em No Limit ($0.05/$0.10 USD) - 2021/01/23 11:13:46 ET
Table 'Saito II' 6-max Seat #3 is the button
Seat 1: JoaquinBueno ($13.74 in chips) 
Seat 2: rafaelzoccoler ($7.91 in chips) 
Seat 3: SERG244 ($27.58 in chips) 
Seat 4: JJOOKKEER 77 ($4.34 in chips) 
Seat 6: Hamilton_TD ($10 in chips) 
JJOOKKEER 77: posts small blind $0.05
Hamilton_TD: posts big blind $0.10
*** HOLE CARDS ***
JoaquinBueno: folds 
rafaelzoccoler: calls $0.10
SERG244: folds 
JJOOKKEER 77: calls $0.05
Hamilton_TD: checks 
*** FLOP *** [9s Js Ah]
JJOOKKEER 77: checks 
Hamilton_TD: checks 
rafaelzoccoler: bets $0.20
JJOOKKEER 77: folds 
Hamilton_TD: folds 
Uncalled bet ($0.20) returned to rafaelzoccoler
rafaelzoccoler collected $0.29 from pot
rafaelzoccoler: doesn't show hand 
*** SUMMARY ***
Total pot $0.30 | Rake $0.01 
Board [9s Js Ah]
Seat 1: JoaquinBueno folded before Flop (didn't bet)
Seat 2: rafaelzoccoler collected ($0.29)
Seat 3: SERG244 (button) folded before Flop (didn't bet)
Seat 4: JJOOKKEER 77 (small blind) folded on the Flop
Seat 6: Hamilton_TD (big blind) folded on the Flop



PokerStars Hand #222958508317:  Hold'em No Limit ($0.05/$0.10 USD) - 2021/01/23 11:14:16 ET
Table 'Saito II' 6-max Seat #4 is the button
Seat 1: JoaquinBueno ($13.74 in chips) 
Seat 2: rafaelzoccoler ($8.10 in chips) 
Seat 3: SERG244 ($27.58 in chips) 
Seat 4: JJOOKKEER 77 ($4.24 in chips) 
Seat 6: Hamilton_TD ($10 in chips) 
Hamilton_TD: posts small blind $0.05
JoaquinBueno: posts big blind $0.10
*** HOLE CARDS ***
rafaelzoccoler: folds 
SERG244: raises $0.16 to $0.26
JJOOKKEER 77: folds 
Hamilton_TD: folds 
JoaquinBueno: folds 
Uncalled bet ($0.16) returned to SERG244
SERG244 collected $0.25 from pot
SERG244: doesn't show hand 
*** SUMMARY ***
Total pot $0.25 | Rake $0 
Seat 1: JoaquinBueno (big blind) folded before Flop
Seat 2: rafaelzoccoler folded before Flop (didn't bet)
Seat 3: SERG244 collected ($0.25)
Seat 4: JJOOKKEER 77 (button) folded before Flop (didn't bet)
Seat 6: Hamilton_TD (small blind) folded before Flop



PokerStars Hand #222958515934:  Hold'em No Limit ($0.05/$0.10 USD) - 2021/01/23 11:14:28 ET
Table 'Saito II' 6-max Seat #6 is the button
Seat 1: JoaquinBueno ($13.64 in chips) 
Seat 2: rafaelzoccoler ($8.10 in chips) 
Seat 3: SERG244 ($27.73 in chips) 
Seat 4: JJOOKKEER 77 ($4.24 in chips) 
Seat 6: Hamilton_TD ($10 in chips) 
JoaquinBueno: posts small blind $0.05
rafaelzoccoler: posts big blind $0.10
*** HOLE CARDS ***
SERG244: raises $0.16 to $0.26
JJOOKKEER 77: folds 
Hamilton_TD: folds 
JoaquinBueno: folds 
rafaelzoccoler: raises $0.24 to $0.50
SERG244: calls $0.24
*** FLOP *** [Ks 8c Jh]
rafaelzoccoler: checks 
SERG244: checks 
*** TURN *** [Ks 8c Jh] [6c]
rafaelzoccoler: bets $0.50
SERG244: folds 
Uncalled bet ($0.50) returned to rafaelzoccoler
rafaelzoccoler collected $1 from pot
rafaelzoccoler: doesn't show hand 
*** SUMMARY ***
Total pot $1.05 | Rake $0.05 
Board [Ks 8c Jh 6c]
Seat 1: JoaquinBueno (small blind) folded before Flop
Seat 2: rafaelzoccoler (big blind) collected ($1)
Seat 3: SERG244 folded on the Turn
Seat 4: JJOOKKEER 77 folded before Flop (didn't bet)
Seat 6: Hamilton_TD (button) folded before Flop (didn't bet)



PokerStars Hand #222958533356:  Hold'em No Limit ($0.05/$0.10 USD) - 2021/01/23 11:14:57 ET
Table 'Saito II' 6-max Seat #1 is the button
Seat 1: JoaquinBueno ($13.59 in chips) 
Seat 2: rafaelzoccoler ($8.60 in chips) 
Seat 3: SERG244 ($27.23 in chips) 
Seat 4: JJOOKKEER 77 ($4.24 in chips) 
Seat 6: Hamilton_TD ($10 in chips) 
rafaelzoccoler: posts small blind $0.05
SERG244: posts big blind $0.10
*** HOLE CARDS ***
JJOOKKEER 77: raises $0.20 to $0.30
Hamilton_TD: folds 
JoaquinBueno: folds 
rafaelzoccoler: folds 
SERG244: folds 
Uncalled bet ($0.20) returned to JJOOKKEER 77
JJOOKKEER 77 collected $0.25 from pot
*** SUMMARY ***
Total pot $0.25 | Rake $0 
Seat 1: JoaquinBueno (button) folded before Flop (didn't bet)
Seat 2: rafaelzoccoler (small blind) folded before Flop
Seat 3: SERG244 (big blind) folded before Flop
Seat 4: JJOOKKEER 77 collected ($0.25)
Seat 6: Hamilton_TD folded before Flop (didn't bet)



PokerStars Hand #222958540758:  Hold'em No Limit ($0.05/$0.10 USD) - 2021/01/23 11:15:10 ET
Table 'Saito II' 6-max Seat #2 is the button
Seat 1: JoaquinBueno ($13.59 in chips) 
Seat 2: rafaelzoccoler ($8.55 in chips) 
Seat 3: SERG244 ($27.13 in chips) 
Seat 4: JJOOKKEER 77 ($4.39 in chips) 
Seat 6: Hamilton_TD ($10 in chips) 
SERG244: posts small blind $0.05
JJOOKKEER 77: posts big blind $0.10
*** HOLE CARDS ***
Hamilton_TD: folds 
JoaquinBueno: folds 
rafaelzoccoler: folds 
SERG244: folds 
Uncalled bet ($0.05) returned to JJOOKKEER 77
JJOOKKEER 77 collected $0.10 from pot
*** SUMMARY ***
Total pot $0.10 | Rake $0 
Seat 1: JoaquinBueno folded before Flop (didn't bet)
Seat 2: rafaelzoccoler (button) folded before Flop (didn't bet)
Seat 3: SERG244 (small blind) folded before Flop
Seat 4: JJOOKKEER 77 (big blind) collected ($0.10)
Seat 6: Hamilton_TD folded before Flop (didn't bet)



PokerStars Hand #222958545502:  Hold'em No Limit ($0.05/$0.10 USD) - 2021/01/23 11:15:17 ET
Table 'Saito II' 6-max Seat #3 is the button
Seat 1: JoaquinBueno ($13.59 in chips) 
Seat 2: rafaelzoccoler ($8.55 in chips) 
Seat 3: SERG244 ($27.08 in chips) 
Seat 4: JJOOKKEER 77 ($4.44 in chips) 
Seat 6: Hamilton_TD ($10 in chips) 
JJOOKKEER 77: posts small blind $0.05
Hamilton_TD: posts big blind $0.10
*** HOLE CARDS ***
JoaquinBueno: folds 
rafaelzoccoler: folds 
SERG244: raises $0.16 to $0.26
JJOOKKEER 77: folds 
Hamilton_TD: calls $0.16
*** FLOP *** [2d 6c 3d]
Hamilton_TD: checks 
SERG244: checks 
*** TURN *** [2d 6c 3d] [6h]
Hamilton_TD: checks 
SERG244: bets $0.36
Hamilton_TD: calls $0.36
*** RIVER *** [2d 6c 3d 6h] [Ts]
Hamilton_TD: checks 
SERG244: checks 
*** SHOW DOWN ***
Hamilton_TD: shows [7d As] (a pair of Sixes)
SERG244: shows [2h Ah] (two pair, Sixes and Deuces)
SERG244 collected $1.23 from pot
*** SUMMARY ***
Total pot $1.29 | Rake $0.06 
Board [2d 6c 3d 6h Ts]
Seat 1: JoaquinBueno folded before Flop (didn't bet)
Seat 2: rafaelzoccoler folded before Flop (didn't bet)
Seat 3: SERG244 (button) showed [2h Ah] and won ($1.23) with two pair, Sixes and Deuces
Seat 4: JJOOKKEER 77 (small blind) folded before Flop
Seat 6: Hamilton_TD (big blind) showed [7d As] and lost with a pair of Sixes



PokerStars Hand #222958564779:  Hold'em No Limit ($0.05/$0.10 USD) - 2021/01/23 11:15:49 ET
Table 'Saito II' 6-max Seat #4 is the button
Seat 1: JoaquinBueno ($13.59 in chips) 
Seat 2: rafaelzoccoler ($8.55 in chips) 
Seat 3: SERG244 ($27.69 in chips) 
Seat 4: JJOOKKEER 77 ($4.39 in chips) 
Seat 6: Hamilton_TD ($10 in chips) 
Hamilton_TD: posts small blind $0.05
JoaquinBueno: posts big blind $0.10
*** HOLE CARDS ***
rafaelzoccoler: folds 
SERG244: folds 
JJOOKKEER 77: raises $0.10 to $0.20
Hamilton_TD: folds 
JoaquinBueno: calls $0.10
*** FLOP *** [3d Td 2d]
JoaquinBueno: checks 
JJOOKKEER 77: bets $0.20
JoaquinBueno: folds 
Uncalled bet ($0.20) returned to JJOOKKEER 77
JJOOKKEER 77 collected $0.43 from pot
*** SUMMARY ***
Total pot $0.45 | Rake $0.02 
Board [3d Td 2d]
Seat 1: JoaquinBueno (big blind) folded on the Flop
Seat 2: rafaelzoccoler folded before Flop (didn't bet)
Seat 3: SERG244 folded before Flop (didn't bet)
Seat 4: JJOOKKEER 77 (button) collected ($0.43)
Seat 6: Hamilton_TD (small blind) folded before Flop



PokerStars Hand #222958580008:  Hold'em No Limit ($0.05/$0.10 USD) - 2021/01/23 11:16:15 ET
Table 'Saito II' 6-max Seat #6 is the button
Seat 1: JoaquinBueno ($13.39 in chips) 
Seat 2: rafaelzoccoler ($8.55 in chips) 
Seat 3: SERG244 ($27.69 in chips) 
Seat 4: JJOOKKEER 77 ($4.62 in chips) 
Seat 6: Hamilton_TD ($10 in chips) 
JoaquinBueno: posts small blind $0.05
rafaelzoccoler: posts big blind $0.10
pearseman657: sits out 
*** HOLE CARDS ***
SERG244: folds 
JJOOKKEER 77: folds 
Hamilton_TD: folds 
JoaquinBueno: raises $0.20 to $0.30
rafaelzoccoler: calls $0.20
*** FLOP *** [8s 5d 6s]
JoaquinBueno: bets $0.29
rafaelzoccoler: calls $0.29
*** TURN *** [8s 5d 6s] [3d]
JoaquinBueno: checks 
rafaelzoccoler: bets $0.50
JoaquinBueno: folds 
Uncalled bet ($0.50) returned to rafaelzoccoler
rafaelzoccoler collected $1.13 from pot
rafaelzoccoler: doesn't show hand 
*** SUMMARY ***
Total pot $1.18 | Rake $0.05 
Board [8s 5d 6s 3d]
Seat 1: JoaquinBueno (small blind) folded on the Turn
Seat 2: rafaelzoccoler (big blind) collected ($1.13)
Seat 3: SERG244 folded before Flop (didn't bet)
Seat 4: JJOOKKEER 77 folded before Flop (didn't bet)
Seat 6: Hamilton_TD (button) folded before Flop (didn't bet)



PokerStars Hand #222958598967:  Hold'em No Limit ($0.05/$0.10 USD) - 2021/01/23 11:16:46 ET
Table 'Saito II' 6-max Seat #1 is the button
Seat 1: JoaquinBueno ($12.80 in chips) 
Seat 2: rafaelzoccoler ($9.09 in chips) 
Seat 3: SERG244 ($27.69 in chips) 
Seat 4: JJOOKKEER 77 ($4.62 in chips) 
Seat 5: pearseman657 ($10.82 in chips) 
Seat 6: Hamilton_TD ($10 in chips) 
rafaelzoccoler: posts small blind $0.05
SERG244: posts big blind $0.10
pearseman657: posts small & big blinds $0.15
*** HOLE CARDS ***
JJOOKKEER 77: folds 
pearseman657: raises $0.30 to $0.40
Hamilton_TD: folds 
JoaquinBueno: folds 
rafaelzoccoler: calls $0.35
SERG244: folds 
*** FLOP *** [6h 9s Jd]
rafaelzoccoler: checks 
pearseman657: bets $0.91
rafaelzoccoler: calls $0.91
*** TURN *** [6h 9s Jd] [Qc]
rafaelzoccoler: checks 
pearseman657: checks 
*** RIVER *** [6h 9s Jd Qc] [8s]
rafaelzoccoler: bets $1
pearseman657: folds 
Uncalled bet ($1) returned to rafaelzoccoler
rafaelzoccoler collected $2.65 from pot
rafaelzoccoler: doesn't show hand 
*** SUMMARY ***
Total pot $2.77 | Rake $0.12 
Board [6h 9s Jd Qc 8s]
Seat 1: JoaquinBueno (button) folded before Flop (didn't bet)
Seat 2: rafaelzoccoler (small blind) collected ($2.65)
Seat 3: SERG244 (big blind) folded before Flop
Seat 4: JJOOKKEER 77 folded before Flop (didn't bet)
Seat 5: pearseman657 folded on the River
Seat 6: Hamilton_TD folded before Flop (didn't bet)



PokerStars Hand #222958619636:  Hold'em No Limit ($0.05/$0.10 USD) - 2021/01/23 11:17:21 ET
Table 'Saito II' 6-max Seat #2 is the button
Seat 1: JoaquinBueno ($12.80 in chips) 
Seat 2: rafaelzoccoler ($10.43 in chips) 
Seat 3: SERG244 ($27.59 in chips) 
Seat 4: JJOOKKEER 77 ($4.62 in chips) 
Seat 5: pearseman657 ($9.46 in chips) 
Seat 6: Hamilton_TD ($10 in chips) 
SERG244: posts small blind $0.05
JJOOKKEER 77: posts big blind $0.10
*** HOLE CARDS ***
pearseman657: raises $0.25 to $0.35
Hamilton_TD: folds 
JoaquinBueno: folds 
rafaelzoccoler: folds 
SERG244: folds 
JJOOKKEER 77: folds 
Uncalled bet ($0.25) returned to pearseman657
pearseman657 collected $0.25 from pot
pearseman657: doesn't show hand 
*** SUMMARY ***
Total pot $0.25 | Rake $0 
Seat 1: JoaquinBueno folded before Flop (didn't bet)
Seat 2: rafaelzoccoler (button) folded before Flop (didn't bet)
Seat 3: SERG244 (small blind) folded before Flop
Seat 4: JJOOKKEER 77 (big blind) folded before Flop
Seat 5: pearseman657 collected ($0.25)
Seat 6: Hamilton_TD folded before Flop (didn't bet)



PokerStars Hand #222958631263:  Hold'em No Limit ($0.05/$0.10 USD) - 2021/01/23 11:17:40 ET
Table 'Saito II' 6-max Seat #3 is the button
Seat 1: JoaquinBueno ($12.80 in chips) 
Seat 2: rafaelzoccoler ($10.43 in chips) 
Seat 3: SERG244 ($27.54 in chips) 
Seat 4: JJOOKKEER 77 ($4.52 in chips) 
Seat 5: pearseman657 ($9.61 in chips) 
Seat 6: Hamilton_TD ($10 in chips) 
JJOOKKEER 77: posts small blind $0.05
pearseman657: posts big blind $0.10
*** HOLE CARDS ***
Hamilton_TD: folds 
JoaquinBueno: folds 
rafaelzoccoler: folds 
SERG244: folds 
JJOOKKEER 77: calls $0.05
pearseman657: checks 
*** FLOP *** [2d Ac 2h]
JJOOKKEER 77: checks 
pearseman657: checks 
*** TURN *** [2d Ac 2h] [Kh]
JJOOKKEER 77: bets $0.10
pearseman657: folds 
Uncalled bet ($0.10) returned to JJOOKKEER 77
JJOOKKEER 77 collected $0.19 from pot
*** SUMMARY ***
Total pot $0.20 | Rake $0.01 
Board [2d Ac 2h Kh]
Seat 1: JoaquinBueno folded before Flop (didn't bet)
Seat 2: rafaelzoccoler folded before Flop (didn't bet)
Seat 3: SERG244 (button) folded before Flop (didn't bet)
Seat 4: JJOOKKEER 77 (small blind) collected ($0.19)
Seat 5: pearseman657 (big blind) folded on the Turn
Seat 6: Hamilton_TD folded before Flop (didn't bet)



PokerStars Hand #222958646973:  Hold'em No Limit ($0.05/$0.10 USD) - 2021/01/23 11:18:06 ET
Table 'Saito II' 6-max Seat #4 is the button
Seat 1: JoaquinBueno ($12.80 in chips) 
Seat 2: rafaelzoccoler ($10.43 in chips) 
Seat 3: SERG244 ($27.54 in chips) 
Seat 4: JJOOKKEER 77 ($4.61 in chips) 
Seat 5: pearseman657 ($9.51 in chips) 
Seat 6: Hamilton_TD ($10 in chips) 
pearseman657: posts small blind $0.05
Hamilton_TD: posts big blind $0.10
*** HOLE CARDS ***
JoaquinBueno: folds 
rafaelzoccoler: calls $0.10
SERG244: folds 
JJOOKKEER 77: folds 
pearseman657: calls $0.05
Hamilton_TD: checks 
*** FLOP *** [7s 4c 9s]
pearseman657: checks 
Hamilton_TD: checks 
rafaelzoccoler: checks 
*** TURN *** [7s 4c 9s] [8c]
pearseman657: bets $0.29
Hamilton_TD: folds 
rafaelzoccoler: calls $0.29
*** RIVER *** [7s 4c 9s 8c] [5s]
pearseman657: bets $0.84
rafaelzoccoler: folds 
Uncalled bet ($0.84) returned to pearseman657
pearseman657 collected $0.84 from pot
pearseman657: doesn't show hand 
*** SUMMARY ***
Total pot $0.88 | Rake $0.04 
Board [7s 4c 9s 8c 5s]
Seat 1: JoaquinBueno folded before Flop (didn't bet)
Seat 2: rafaelzoccoler folded on the River
Seat 3: SERG244 folded before Flop (didn't bet)
Seat 4: JJOOKKEER 77 (button) folded before Flop (didn't bet)
Seat 5: pearseman657 (small blind) collected ($0.84)
Seat 6: Hamilton_TD (big blind) folded on the Turn



PokerStars Hand #222958672833:  Hold'em No Limit ($0.05/$0.10 USD) - 2021/01/23 11:18:49 ET
Table 'Saito II' 6-max Seat #5 is the button
Seat 1: JoaquinBueno ($12.80 in chips) 
Seat 2: rafaelzoccoler ($10.04 in chips) 
Seat 3: SERG244 ($27.54 in chips) 
Seat 4: JJOOKKEER 77 ($4.61 in chips) 
Seat 5: pearseman657 ($9.96 in chips) 
Seat 6: Hamilton_TD ($10 in chips) 
Hamilton_TD: posts small blind $0.05
JoaquinBueno: posts big blind $0.10
*** HOLE CARDS ***
rafaelzoccoler: folds 
SERG244: folds 
JJOOKKEER 77: folds 
pearseman657: folds 
Hamilton_TD: raises $0.15 to $0.25
JoaquinBueno: folds 
Uncalled bet ($0.15) returned to Hamilton_TD
Hamilton_TD collected $0.20 from pot
*** SUMMARY ***
Total pot $0.20 | Rake $0 
Seat 1: JoaquinBueno (big blind) folded before Flop
Seat 2: rafaelzoccoler folded before Flop (didn't bet)
Seat 3: SERG244 folded before Flop (didn't bet)
Seat 4: JJOOKKEER 77 folded before Flop (didn't bet)
Seat 5: pearseman657 (button) folded before Flop (didn't bet)
Seat 6: Hamilton_TD (small blind) collected ($0.20)



PokerStars Hand #222958682476:  Hold'em No Limit ($0.05/$0.10 USD) - 2021/01/23 11:19:05 ET
Table 'Saito II' 6-max Seat #6 is the button
Seat 1: JoaquinBueno ($12.70 in chips) 
Seat 2: rafaelzoccoler ($10.04 in chips) 
Seat 3: SERG244 ($27.54 in chips) 
Seat 4: JJOOKKEER 77 ($4.61 in chips) 
Seat 5: pearseman657 ($9.96 in chips) 
Seat 6: Hamilton_TD ($10.10 in chips) 
JoaquinBueno: posts small blind $0.05
rafaelzoccoler: posts big blind $0.10
*** HOLE CARDS ***
SERG244: folds 
JJOOKKEER 77: raises $0.20 to $0.30
pearseman657: calls $0.30
Hamilton_TD: folds 
JoaquinBueno: folds 
rafaelzoccoler: calls $0.20
*** FLOP *** [Ac 3s 9h]
rafaelzoccoler: checks 
JJOOKKEER 77: checks 
pearseman657: checks 
*** TURN *** [Ac 3s 9h] [5h]
rafaelzoccoler: bets $0.30
JJOOKKEER 77: raises $0.80 to $1.10
pearseman657: folds 
rafaelzoccoler: folds 
Uncalled bet ($0.80) returned to JJOOKKEER 77
JJOOKKEER 77 collected $1.48 from pot
*** SUMMARY ***
Total pot $1.55 | Rake $0.07 
Board [Ac 3s 9h 5h]
Seat 1: JoaquinBueno (small blind) folded before Flop
Seat 2: rafaelzoccoler (big blind) folded on the Turn
Seat 3: SERG244 folded before Flop (didn't bet)
Seat 4: JJOOKKEER 77 collected ($1.48)
Seat 5: pearseman657 folded on the Turn
Seat 6: Hamilton_TD (button) folded before Flop (didn't bet)



PokerStars Hand #222958723696:  Hold'em No Limit ($0.05/$0.10 USD) - 2021/01/23 11:20:13 ET
Table 'Saito II' 6-max Seat #1 is the button
Seat 1: JoaquinBueno ($12.65 in chips) 
Seat 2: rafaelzoccoler ($9.44 in chips) 
Seat 3: SERG244 ($27.54 in chips) 
Seat 4: JJOOKKEER 77 ($5.49 in chips) 
Seat 5: pearseman657 ($9.66 in chips) 
Seat 6: Hamilton_TD ($10.10 in chips) 
rafaelzoccoler: posts small blind $0.05
SERG244: posts big blind $0.10
*** HOLE CARDS ***
JJOOKKEER 77: folds 
pearseman657: raises $0.25 to $0.35
Hamilton_TD: folds 
JoaquinBueno: folds 
rafaelzoccoler: raises $0.25 to $0.60
SERG244: calls $0.50
pearseman657: calls $0.25
*** FLOP *** [4c 9h 2h]
rafaelzoccoler: bets $1
SERG244: folds 
pearseman657: calls $1
*** TURN *** [4c 9h 2h] [Ah]
rafaelzoccoler: bets $2.10
pearseman657: calls $2.10
*** RIVER *** [4c 9h 2h Ah] [5h]
rafaelzoccoler: checks 
pearseman657: bets $5.96 and is all-in
rafaelzoccoler: folds 
Uncalled bet ($5.96) returned to pearseman657
pearseman657 collected $7.64 from pot
pearseman657: doesn't show hand 
*** SUMMARY ***
Total pot $8 | Rake $0.36 
Board [4c 9h 2h Ah 5h]
Seat 1: JoaquinBueno (button) folded before Flop (didn't bet)
Seat 2: rafaelzoccoler (small blind) folded on the River
Seat 3: SERG244 (big blind) folded on the Flop
Seat 4: JJOOKKEER 77 folded before Flop (didn't bet)
Seat 5: pearseman657 collected ($7.64)
Seat 6: Hamilton_TD folded before Flop (didn't bet)



PokerStars Hand #222958756323:  Hold'em No Limit ($0.05/$0.10 USD) - 2021/01/23 11:21:07 ET
Table 'Saito II' 6-max Seat #2 is the button
Seat 1: JoaquinBueno ($12.65 in chips) 
Seat 2: rafaelzoccoler ($5.74 in chips) 
Seat 3: SERG244 ($26.94 in chips) 
Seat 4: JJOOKKEER 77 ($5.49 in chips) 
Seat 5: pearseman657 ($13.60 in chips) 
Seat 6: Hamilton_TD ($10.10 in chips) 
SERG244: posts small blind $0.05
JJOOKKEER 77: posts big blind $0.10
*** HOLE CARDS ***
pearseman657: folds 
Hamilton_TD: folds 
JoaquinBueno: raises $0.20 to $0.30
rafaelzoccoler: calls $0.30
SERG244: calls $0.25
JJOOKKEER 77: calls $0.20
*** FLOP *** [Jc 6s 9s]
SERG244: checks 
JJOOKKEER 77: checks 
JoaquinBueno: bets $0.58
rafaelzoccoler: calls $0.58
SERG244: folds 
JJOOKKEER 77: folds 
*** TURN *** [Jc 6s 9s] [Js]
JoaquinBueno: checks 
rafaelzoccoler: checks 
*** RIVER *** [Jc 6s 9s Js] [Ah]
JoaquinBueno: checks 
rafaelzoccoler: checks 
*** SHOW DOWN ***
JoaquinBueno: shows [7d 8d] (a pair of Jacks)
rafaelzoccoler: shows [Tc 7c] (a pair of Jacks - Ace+Ten kicker)
rafaelzoccoler collected $2.25 from pot
*** SUMMARY ***
Total pot $2.36 | Rake $0.11 
Board [Jc 6s 9s Js Ah]
Seat 1: JoaquinBueno showed [7d 8d] and lost with a pair of Jacks
Seat 2: rafaelzoccoler (button) showed [Tc 7c] and won ($2.25) with a pair of Jacks
Seat 3: SERG244 (small blind) folded on the Flop
Seat 4: JJOOKKEER 77 (big blind) folded on the Flop
Seat 5: pearseman657 folded before Flop (didn't bet)
Seat 6: Hamilton_TD folded before Flop (didn't bet)



PokerStars Hand #222958787635:  Hold'em No Limit ($0.05/$0.10 USD) - 2021/01/23 11:21:58 ET
Table 'Saito II' 6-max Seat #3 is the button
Seat 1: JoaquinBueno ($11.77 in chips) 
Seat 2: rafaelzoccoler ($7.11 in chips) 
Seat 3: SERG244 ($26.64 in chips) 
Seat 4: JJOOKKEER 77 ($5.19 in chips) 
Seat 5: pearseman657 ($13.60 in chips) 
Seat 6: Hamilton_TD ($10.10 in chips) 
JJOOKKEER 77: posts small blind $0.05
pearseman657: posts big blind $0.10
*** HOLE CARDS ***
Hamilton_TD: raises $0.15 to $0.25
JoaquinBueno: folds 
rafaelzoccoler: raises $0.15 to $0.40
SERG244: folds 
JJOOKKEER 77: folds 
pearseman657: folds 
Hamilton_TD: calls $0.15
*** FLOP *** [6h As 8d]
Hamilton_TD: checks 
rafaelzoccoler: checks 
*** TURN *** [6h As 8d] [Ad]
Hamilton_TD: checks 
rafaelzoccoler: checks 
*** RIVER *** [6h As 8d Ad] [Kh]
Hamilton_TD: checks 
rafaelzoccoler: bets $0.30
Hamilton_TD: folds 
Uncalled bet ($0.30) returned to rafaelzoccoler
rafaelzoccoler collected $0.91 from pot
rafaelzoccoler: doesn't show hand 
*** SUMMARY ***
Total pot $0.95 | Rake $0.04 
Board [6h As 8d Ad Kh]
Seat 1: JoaquinBueno folded before Flop (didn't bet)
Seat 2: rafaelzoccoler collected ($0.91)
Seat 3: SERG244 (button) folded before Flop (didn't bet)
Seat 4: JJOOKKEER 77 (small blind) folded before Flop
Seat 5: pearseman657 (big blind) folded before Flop
Seat 6: Hamilton_TD folded on the River



PokerStars Hand #222958811447:  Hold'em No Limit ($0.05/$0.10 USD) - 2021/01/23 11:22:38 ET
Table 'Saito II' 6-max Seat #4 is the button
Seat 1: JoaquinBueno ($11.77 in chips) 
Seat 2: rafaelzoccoler ($7.62 in chips) 
Seat 3: SERG244 ($26.64 in chips) 
Seat 4: JJOOKKEER 77 ($5.14 in chips) 
Seat 5: pearseman657 ($13.50 in chips) 
Seat 6: Hamilton_TD ($10 in chips) 
pearseman657: posts small blind $0.05
Hamilton_TD: posts big blind $0.10
*** HOLE CARDS ***
JoaquinBueno: folds 
rafaelzoccoler: folds 
SERG244: folds 
JJOOKKEER 77: folds 
pearseman657: folds 
Uncalled bet ($0.05) returned to Hamilton_TD
Hamilton_TD collected $0.10 from pot
*** SUMMARY ***
Total pot $0.10 | Rake $0 
Seat 1: JoaquinBueno folded before Flop (didn't bet)
Seat 2: rafaelzoccoler folded before Flop (didn't bet)
Seat 3: SERG244 folded before Flop (didn't bet)
Seat 4: JJOOKKEER 77 (button) folded before Flop (didn't bet)
Seat 5: pearseman657 (small blind) folded before Flop
Seat 6: Hamilton_TD (big blind) collected ($0.10)



PokerStars Hand #222958816706:  Hold'em No Limit ($0.05/$0.10 USD) - 2021/01/23 11:22:46 ET
Table 'Saito II' 6-max Seat #5 is the button
Seat 1: JoaquinBueno ($11.77 in chips) 
Seat 2: rafaelzoccoler ($7.62 in chips) 
Seat 3: SERG244 ($26.64 in chips) 
Seat 4: JJOOKKEER 77 ($5.14 in chips) 
Seat 5: pearseman657 ($13.45 in chips) 
Seat 6: Hamilton_TD ($10.05 in chips) 
Hamilton_TD: posts small blind $0.05
JoaquinBueno: posts big blind $0.10
*** HOLE CARDS ***
rafaelzoccoler: folds 
SERG244: raises $0.16 to $0.26
JJOOKKEER 77: folds 
pearseman657: folds 
Hamilton_TD: folds 
JoaquinBueno: folds 
Uncalled bet ($0.16) returned to SERG244
SERG244 collected $0.25 from pot
SERG244: doesn't show hand 
*** SUMMARY ***
Total pot $0.25 | Rake $0 
Seat 1: JoaquinBueno (big blind) folded before Flop
Seat 2: rafaelzoccoler folded before Flop (didn't bet)
Seat 3: SERG244 collected ($0.25)
Seat 4: JJOOKKEER 77 folded before Flop (didn't bet)
Seat 5: pearseman657 (button) folded before Flop (didn't bet)
Seat 6: Hamilton_TD (small blind) folded before Flop



PokerStars Hand #222958827375:  Hold'em No Limit ($0.05/$0.10 USD) - 2021/01/23 11:23:04 ET
Table 'Saito II' 6-max Seat #6 is the button
Seat 1: JoaquinBueno ($11.67 in chips) 
Seat 2: rafaelzoccoler ($7.62 in chips) 
Seat 3: SERG244 ($26.79 in chips) 
Seat 4: JJOOKKEER 77 ($5.14 in chips) 
Seat 5: pearseman657 ($13.45 in chips) 
Seat 6: Hamilton_TD ($10 in chips) 
JoaquinBueno: posts small blind $0.05
rafaelzoccoler: posts big blind $0.10
*** HOLE CARDS ***
SERG244: folds 
JJOOKKEER 77: raises $0.10 to $0.20
pearseman657: folds 
Hamilton_TD: folds 
JoaquinBueno: folds 
rafaelzoccoler: folds 
Uncalled bet ($0.10) returned to JJOOKKEER 77
JJOOKKEER 77 collected $0.25 from pot
*** SUMMARY ***
Total pot $0.25 | Rake $0 
Seat 1: JoaquinBueno (small blind) folded before Flop
Seat 2: rafaelzoccoler (big blind) folded before Flop
Seat 3: SERG244 folded before Flop (didn't bet)
Seat 4: JJOOKKEER 77 collected ($0.25)
Seat 5: pearseman657 folded before Flop (didn't bet)
Seat 6: Hamilton_TD (button) folded before Flop (didn't bet)



PokerStars Hand #222958833550:  Hold'em No Limit ($0.05/$0.10 USD) - 2021/01/23 11:23:14 ET
Table 'Saito II' 6-max Seat #1 is the button
Seat 1: JoaquinBueno ($11.62 in chips) 
Seat 2: rafaelzoccoler ($7.52 in chips) 
Seat 3: SERG244 ($26.79 in chips) 
Seat 4: JJOOKKEER 77 ($5.29 in chips) 
Seat 5: pearseman657 ($13.45 in chips) 
Seat 6: Hamilton_TD ($10 in chips) 
rafaelzoccoler: posts small blind $0.05
SERG244: posts big blind $0.10
*** HOLE CARDS ***
JJOOKKEER 77: folds 
pearseman657: raises $0.25 to $0.35
Hamilton_TD: calls $0.35
JoaquinBueno: folds 
rafaelzoccoler: folds 
SERG244: folds 
*** FLOP *** [3c Td Kc]
pearseman657: checks 
Hamilton_TD: checks 
*** TURN *** [3c Td Kc] [2d]
pearseman657: checks 
Hamilton_TD: bets $0.28
pearseman657: calls $0.28
*** RIVER *** [3c Td Kc 2d] [Qc]
pearseman657: checks 
Hamilton_TD: checks 
*** SHOW DOWN ***
pearseman657: shows [5s 5c] (a pair of Fives)
Hamilton_TD: shows [8c 8s] (a pair of Eights)
Hamilton_TD collected $1.35 from pot
*** SUMMARY ***
Total pot $1.41 | Rake $0.06 
Board [3c Td Kc 2d Qc]
Seat 1: JoaquinBueno (button) folded before Flop (didn't bet)
Seat 2: rafaelzoccoler (small blind) folded before Flop
Seat 3: SERG244 (big blind) folded before Flop
Seat 4: JJOOKKEER 77 folded before Flop (didn't bet)
Seat 5: pearseman657 showed [5s 5c] and lost with a pair of Fives
Seat 6: Hamilton_TD showed [8c 8s] and won ($1.35) with a pair of Eights



PokerStars Hand #222958860800:  Hold'em No Limit ($0.05/$0.10 USD) - 2021/01/23 11:23:59 ET
Table 'Saito II' 6-max Seat #2 is the button
Seat 1: JoaquinBueno ($11.62 in chips) 
Seat 2: rafaelzoccoler ($7.47 in chips) 
Seat 3: SERG244 ($26.69 in chips) 
Seat 4: JJOOKKEER 77 ($5.29 in chips) 
Seat 5: pearseman657 ($12.82 in chips) 
Seat 6: Hamilton_TD ($10.72 in chips) 
SERG244: posts small blind $0.05
JJOOKKEER 77: posts big blind $0.10
*** HOLE CARDS ***
pearseman657: folds 
Hamilton_TD: folds 
JoaquinBueno: raises $0.20 to $0.30
rafaelzoccoler: raises $0.20 to $0.50
SERG244: folds 
JJOOKKEER 77: folds 
JoaquinBueno: calls $0.20
*** FLOP *** [7s Th 4d]
JoaquinBueno: checks 
rafaelzoccoler: bets $0.50
JoaquinBueno: calls $0.50
*** TURN *** [7s Th 4d] [Jh]
JoaquinBueno: checks 
rafaelzoccoler: bets $1.50
JoaquinBueno: calls $1.50
*** RIVER *** [7s Th 4d Jh] [5c]
JoaquinBueno: checks 
rafaelzoccoler: bets $4.97 and is all-in
JoaquinBueno: calls $4.97
*** SHOW DOWN ***
rafaelzoccoler: shows [Ac Kc] (high card Ace)
JoaquinBueno: shows [9c Tc] (a pair of Tens)
JoaquinBueno collected $14.41 from pot
*** SUMMARY ***
Total pot $15.09 | Rake $0.68 
Board [7s Th 4d Jh 5c]
Seat 1: JoaquinBueno showed [9c Tc] and won ($14.41) with a pair of Tens
Seat 2: rafaelzoccoler (button) showed [Ac Kc] and lost with high card Ace
Seat 3: SERG244 (small blind) folded before Flop
Seat 4: JJOOKKEER 77 (big blind) folded before Flop
Seat 5: pearseman657 folded before Flop (didn't bet)
Seat 6: Hamilton_TD folded before Flop (didn't bet)



PokerStars Hand #222958909294:  Hold'em No Limit ($0.05/$0.10 USD) - 2021/01/23 11:25:19 ET
Table 'Saito II' 6-max Seat #3 is the button
Seat 1: JoaquinBueno ($18.56 in chips) 
Seat 3: SERG244 ($26.64 in chips) 
Seat 4: JJOOKKEER 77 ($5.19 in chips) 
Seat 5: pearseman657 ($12.82 in chips) 
Seat 6: Hamilton_TD ($10.72 in chips) 
JJOOKKEER 77: posts small blind $0.05
pearseman657: posts big blind $0.10
*** HOLE CARDS ***
Hamilton_TD: folds 
JoaquinBueno: folds 
SERG244: folds 
JJOOKKEER 77: folds 
Uncalled bet ($0.05) returned to pearseman657
pearseman657 collected $0.10 from pot
pearseman657: doesn't show hand 
*** SUMMARY ***
Total pot $0.10 | Rake $0 
Seat 1: JoaquinBueno folded before Flop (didn't bet)
Seat 3: SERG244 (button) folded before Flop (didn't bet)
Seat 4: JJOOKKEER 77 (small blind) folded before Flop
Seat 5: pearseman657 (big blind) collected ($0.10)
Seat 6: Hamilton_TD folded before Flop (didn't bet)



PokerStars Hand #222958915864:  Hold'em No Limit ($0.05/$0.10 USD) - 2021/01/23 11:25:30 ET
Table 'Saito II' 6-max Seat #4 is the button
Seat 1: JoaquinBueno ($18.56 in chips) 
Seat 3: SERG244 ($26.64 in chips) 
Seat 4: JJOOKKEER 77 ($5.14 in chips) 
Seat 5: pearseman657 ($12.87 in chips) 
Seat 6: Hamilton_TD ($10.72 in chips) 
pearseman657: posts small blind $0.05
Hamilton_TD: posts big blind $0.10
*** HOLE CARDS ***
JoaquinBueno: folds 
SERG244: raises $0.16 to $0.26
JJOOKKEER 77: calls $0.26
pearseman657: raises $0.94 to $1.20
Hamilton_TD: folds 
SERG244: folds 
JJOOKKEER 77: folds 
Uncalled bet ($0.94) returned to pearseman657
pearseman657 collected $0.88 from pot
pearseman657: doesn't show hand 
*** SUMMARY ***
Total pot $0.88 | Rake $0 
Seat 1: JoaquinBueno folded before Flop (didn't bet)
Seat 3: SERG244 folded before Flop
Seat 4: JJOOKKEER 77 (button) folded before Flop
Seat 5: pearseman657 (small blind) collected ($0.88)
Seat 6: Hamilton_TD (big blind) folded before Flop



PokerStars Hand #222958925010:  Hold'em No Limit ($0.05/$0.10 USD) - 2021/01/23 11:25:45 ET
Table 'Saito II' 6-max Seat #5 is the button
Seat 1: JoaquinBueno ($18.56 in chips) 
Seat 3: SERG244 ($26.38 in chips) 
Seat 4: JJOOKKEER 77 ($4.88 in chips) 
Seat 5: pearseman657 ($13.49 in chips) 
Seat 6: Hamilton_TD ($10.62 in chips) 
Hamilton_TD: posts small blind $0.05
JoaquinBueno: posts big blind $0.10
*** HOLE CARDS ***
SERG244: raises $0.16 to $0.26
JJOOKKEER 77: folds 
pearseman657: calls $0.26
Hamilton_TD: folds 
JoaquinBueno: folds 
*** FLOP *** [2s Ac 7d]
SERG244: bets $0.43
pearseman657: folds 
Uncalled bet ($0.43) returned to SERG244
SERG244 collected $0.64 from pot
SERG244: doesn't show hand 
*** SUMMARY ***
Total pot $0.67 | Rake $0.03 
Board [2s Ac 7d]
Seat 1: JoaquinBueno (big blind) folded before Flop
Seat 3: SERG244 collected ($0.64)
Seat 4: JJOOKKEER 77 folded before Flop (didn't bet)
Seat 5: pearseman657 (button) folded on the Flop
Seat 6: Hamilton_TD (small blind) folded before Flop



PokerStars Hand #222958935116:  Hold'em No Limit ($0.05/$0.10 USD) - 2021/01/23 11:26:01 ET
Table 'Saito II' 6-max Seat #6 is the button
Seat 1: JoaquinBueno ($18.46 in chips) 
Seat 3: SERG244 ($26.76 in chips) 
Seat 4: JJOOKKEER 77 ($4.88 in chips) 
Seat 5: pearseman657 ($13.23 in chips) 
Seat 6: Hamilton_TD ($10.57 in chips) 
JoaquinBueno: posts small blind $0.05
SERG244: posts big blind $0.10
*** HOLE CARDS ***
JJOOKKEER 77: folds 
pearseman657: raises $0.25 to $0.35
Hamilton_TD: folds 
JoaquinBueno: folds 
SERG244: folds 
Uncalled bet ($0.25) returned to pearseman657
pearseman657 collected $0.25 from pot
pearseman657: doesn't show hand 
*** SUMMARY ***
Total pot $0.25 | Rake $0 
Seat 1: JoaquinBueno (small blind) folded before Flop
Seat 3: SERG244 (big blind) folded before Flop
Seat 4: JJOOKKEER 77 folded before Flop (didn't bet)
Seat 5: pearseman657 collected ($0.25)
Seat 6: Hamilton_TD (button) folded before Flop (didn't bet)



PokerStars Hand #222958940244:  Hold'em No Limit ($0.05/$0.10 USD) - 2021/01/23 11:26:10 ET
Table 'Saito II' 6-max Seat #1 is the button
Seat 1: JoaquinBueno ($18.41 in chips) 
Seat 3: SERG244 ($26.66 in chips) 
Seat 4: JJOOKKEER 77 ($4.88 in chips) 
Seat 5: pearseman657 ($13.38 in chips) 
Seat 6: Hamilton_TD ($10.57 in chips) 
SERG244: posts small blind $0.05
JJOOKKEER 77: posts big blind $0.10
*** HOLE CARDS ***
pearseman657: raises $0.25 to $0.35
Hamilton_TD: folds 
JoaquinBueno: folds 
SERG244: folds 
JJOOKKEER 77: folds 
Uncalled bet ($0.25) returned to pearseman657
pearseman657 collected $0.25 from pot
rafaelzoccoler leaves the table
pearseman657: doesn't show hand 
*** SUMMARY ***
Total pot $0.25 | Rake $0 
Seat 1: JoaquinBueno (button) folded before Flop (didn't bet)
Seat 3: SERG244 (small blind) folded before Flop
Seat 4: JJOOKKEER 77 (big blind) folded before Flop
Seat 5: pearseman657 collected ($0.25)
Seat 6: Hamilton_TD folded before Flop (didn't bet)



PokerStars Hand #222958946068:  Hold'em No Limit ($0.05/$0.10 USD) - 2021/01/23 11:26:19 ET
Table 'Saito II' 6-max Seat #3 is the button
Seat 1: JoaquinBueno ($18.41 in chips) 
Seat 3: SERG244 ($26.61 in chips) 
Seat 4: JJOOKKEER 77 ($4.78 in chips) 
Seat 5: pearseman657 ($13.53 in chips) 
Seat 6: Hamilton_TD ($10.57 in chips) 
JJOOKKEER 77: posts small blind $0.05
pearseman657: posts big blind $0.10
*** HOLE CARDS ***
Hamilton_TD: raises $0.20 to $0.30
JoaquinBueno: folds 
SERG244: folds 
JJOOKKEER 77: folds 
pearseman657: folds 
Uncalled bet ($0.20) returned to Hamilton_TD
Hamilton_TD collected $0.25 from pot
*** SUMMARY ***
Total pot $0.25 | Rake $0 
Seat 1: JoaquinBueno folded before Flop (didn't bet)
Seat 3: SERG244 (button) folded before Flop (didn't bet)
Seat 4: JJOOKKEER 77 (small blind) folded before Flop
Seat 5: pearseman657 (big blind) folded before Flop
Seat 6: Hamilton_TD collected ($0.25)



PokerStars Hand #222958952351:  Hold'em No Limit ($0.05/$0.10 USD) - 2021/01/23 11:26:30 ET
Table 'Saito II' 6-max Seat #4 is the button
Seat 1: JoaquinBueno ($18.41 in chips) 
Seat 3: SERG244 ($26.61 in chips) 
Seat 4: JJOOKKEER 77 ($4.73 in chips) 
Seat 5: pearseman657 ($13.43 in chips) 
Seat 6: Hamilton_TD ($10.72 in chips) 
pearseman657: posts small blind $0.05
Hamilton_TD: posts big blind $0.10
*** HOLE CARDS ***
JoaquinBueno: folds 
smart.toddis joins the table at seat #2 
SERG244: raises $0.16 to $0.26
JJOOKKEER 77: folds 
pearseman657: calls $0.21
Hamilton_TD: folds 
*** FLOP *** [4h As 9d]
pearseman657: checks 
SERG244: checks 
*** TURN *** [4h As 9d] [Qs]
pearseman657: bets $0.59
SERG244: calls $0.59
*** RIVER *** [4h As 9d Qs] [4c]
pearseman657: checks 
SERG244: bets $0.60
pearseman657: folds 
Uncalled bet ($0.60) returned to SERG244
SERG244 collected $1.72 from pot
SERG244: doesn't show hand 
*** SUMMARY ***
Total pot $1.80 | Rake $0.08 
Board [4h As 9d Qs 4c]
Seat 1: JoaquinBueno folded before Flop (didn't bet)
Seat 3: SERG244 collected ($1.72)
Seat 4: JJOOKKEER 77 (button) folded before Flop (didn't bet)
Seat 5: pearseman657 (small blind) folded on the River
Seat 6: Hamilton_TD (big blind) folded before Flop



PokerStars Hand #222958972921:  Hold'em No Limit ($0.05/$0.10 USD) - 2021/01/23 11:26:59 ET
Table 'Saito II' 6-max Seat #5 is the button
Seat 1: JoaquinBueno ($18.41 in chips) 
Seat 2: smart.toddis ($4 in chips) 
Seat 3: SERG244 ($27.48 in chips) 
Seat 4: JJOOKKEER 77 ($4.73 in chips) 
Seat 5: pearseman657 ($12.58 in chips) 
Seat 6: Hamilton_TD ($10.62 in chips) 
Hamilton_TD: posts small blind $0.05
JoaquinBueno: posts big blind $0.10
smart.toddis: posts big blind $0.10
*** HOLE CARDS ***
smart.toddis: checks 
SERG244: folds 
JJOOKKEER 77: raises $0.20 to $0.30
pearseman657: folds 
Hamilton_TD: folds 
JoaquinBueno: folds 
smart.toddis: calls $0.20
*** FLOP *** [Qc 5s Kc]
smart.toddis: checks 
JJOOKKEER 77: checks 
*** TURN *** [Qc 5s Kc] [Kh]
smart.toddis: bets $0.72
JJOOKKEER 77: folds 
Uncalled bet ($0.72) returned to smart.toddis
smart.toddis collected $0.72 from pot
smart.toddis: doesn't show hand 
*** SUMMARY ***
Total pot $0.75 | Rake $0.03 
Board [Qc 5s Kc Kh]
Seat 1: JoaquinBueno (big blind) folded before Flop
Seat 2: smart.toddis collected ($0.72)
Seat 3: SERG244 folded before Flop (didn't bet)
Seat 4: JJOOKKEER 77 folded on the Turn
Seat 5: pearseman657 (button) folded before Flop (didn't bet)
Seat 6: Hamilton_TD (small blind) folded before Flop



PokerStars Hand #222958989125:  Hold'em No Limit ($0.05/$0.10 USD) - 2021/01/23 11:27:25 ET
Table 'Saito II' 6-max Seat #6 is the button
Seat 1: JoaquinBueno ($18.31 in chips) 
Seat 2: smart.toddis ($4.42 in chips) 
Seat 3: SERG244 ($27.48 in chips) 
Seat 4: JJOOKKEER 77 ($4.43 in chips) 
Seat 5: pearseman657 ($12.58 in chips) 
Seat 6: Hamilton_TD ($10.57 in chips) 
JoaquinBueno: posts small blind $0.05
smart.toddis: posts big blind $0.10
*** HOLE CARDS ***
SERG244: folds 
JJOOKKEER 77: raises $0.20 to $0.30
pearseman657: calls $0.30
Hamilton_TD: folds 
JoaquinBueno: calls $0.25
smart.toddis: folds 
*** FLOP *** [5c Qc Kh]
JoaquinBueno: checks 
JJOOKKEER 77: checks 
pearseman657: bets $0.96
JoaquinBueno: folds 
JJOOKKEER 77: folds 
Uncalled bet ($0.96) returned to pearseman657
pearseman657 collected $0.96 from pot
pearseman657: doesn't show hand 
*** SUMMARY ***
Total pot $1 | Rake $0.04 
Board [5c Qc Kh]
Seat 1: JoaquinBueno (small blind) folded on the Flop
Seat 2: smart.toddis (big blind) folded before Flop
Seat 3: SERG244 folded before Flop (didn't bet)
Seat 4: JJOOKKEER 77 folded on the Flop
Seat 5: pearseman657 collected ($0.96)
Seat 6: Hamilton_TD (button) folded before Flop (didn't bet)



PokerStars Hand #222959009391:  Hold'em No Limit ($0.05/$0.10 USD) - 2021/01/23 11:27:58 ET
Table 'Saito II' 6-max Seat #1 is the button
Seat 1: JoaquinBueno ($18.01 in chips) 
Seat 2: smart.toddis ($4.32 in chips) 
Seat 3: SERG244 ($27.48 in chips) 
Seat 4: JJOOKKEER 77 ($4.13 in chips) 
Seat 5: pearseman657 ($13.24 in chips) 
Seat 6: Hamilton_TD ($10.57 in chips) 
smart.toddis: posts small blind $0.05
SERG244: posts big blind $0.10
*** HOLE CARDS ***
JJOOKKEER 77: folds 
pearseman657: folds 
Hamilton_TD: folds 
JoaquinBueno: folds 
smart.toddis: calls $0.05
SERG244: checks 
*** FLOP *** [Qd As 7h]
smart.toddis: checks 
SERG244: checks 
*** TURN *** [Qd As 7h] [3s]
smart.toddis: bets $0.10
SERG244: folds 
Uncalled bet ($0.10) returned to smart.toddis
smart.toddis collected $0.19 from pot
smart.toddis: doesn't show hand 
*** SUMMARY ***
Total pot $0.20 | Rake $0.01 
Board [Qd As 7h 3s]
Seat 1: JoaquinBueno (button) folded before Flop (didn't bet)
Seat 2: smart.toddis (small blind) collected ($0.19)
Seat 3: SERG244 (big blind) folded on the Turn
Seat 4: JJOOKKEER 77 folded before Flop (didn't bet)
Seat 5: pearseman657 folded before Flop (didn't bet)
Seat 6: Hamilton_TD folded before Flop (didn't bet)



PokerStars Hand #222959040578:  Hold'em No Limit ($0.05/$0.10 USD) - 2021/01/23 11:28:49 ET
Table 'Saito II' 6-max Seat #2 is the button
Seat 1: JoaquinBueno ($18.01 in chips) 
Seat 2: smart.toddis ($4.41 in chips) 
Seat 3: SERG244 ($27.38 in chips) 
Seat 4: JJOOKKEER 77 ($4.13 in chips) 
Seat 5: pearseman657 ($13.24 in chips) 
Seat 6: Hamilton_TD ($10.57 in chips) 
SERG244: posts small blind $0.05
JJOOKKEER 77: posts big blind $0.10
*** HOLE CARDS ***
pearseman657 has timed out
pearseman657: folds 
Hamilton_TD: folds 
JoaquinBueno: raises $0.20 to $0.30
smart.toddis: folds 
SERG244: folds 
JJOOKKEER 77: folds 
Uncalled bet ($0.20) returned to JoaquinBueno
JoaquinBueno collected $0.25 from pot
JoaquinBueno: doesn't show hand 
*** SUMMARY ***
Total pot $0.25 | Rake $0 
Seat 1: JoaquinBueno collected ($0.25)
Seat 2: smart.toddis (button) folded before Flop (didn't bet)
Seat 3: SERG244 (small blind) folded before Flop
Seat 4: JJOOKKEER 77 (big blind) folded before Flop
Seat 5: pearseman657 folded before Flop (didn't bet)
Seat 6: Hamilton_TD folded before Flop (didn't bet)



PokerStars Hand #222959062156:  Hold'em No Limit ($0.05/$0.10 USD) - 2021/01/23 11:29:25 ET
Table 'Saito II' 6-max Seat #3 is the button
Seat 1: JoaquinBueno ($18.16 in chips) 
Seat 2: smart.toddis ($4.41 in chips) 
Seat 3: SERG244 ($27.33 in chips) 
Seat 4: JJOOKKEER 77 ($4.03 in chips) 
Seat 5: pearseman657 ($13.24 in chips) 
Seat 6: Hamilton_TD ($10.57 in chips) 
JJOOKKEER 77: posts small blind $0.05
pearseman657: posts big blind $0.10
*** HOLE CARDS ***
Hamilton_TD: folds 
JoaquinBueno: folds 
smart.toddis: calls $0.10
SERG244: folds 
JJOOKKEER 77: folds 
pearseman657: checks 
*** FLOP *** [9h 5h Td]
pearseman657: checks 
smart.toddis: bets $0.12
pearseman657: calls $0.12
*** TURN *** [9h 5h Td] [7h]
pearseman657: checks 
smart.toddis: bets $0.47
pearseman657: calls $0.47
*** RIVER *** [9h 5h Td 7h] [As]
pearseman657: checks 
smart.toddis: bets $0.68
pearseman657: calls $0.68
*** SHOW DOWN ***
smart.toddis: shows [Kd Kh] (a pair of Kings)
pearseman657: mucks hand 
smart.toddis collected $2.66 from pot
*** SUMMARY ***
Total pot $2.79 | Rake $0.13 
Board [9h 5h Td 7h As]
Seat 1: JoaquinBueno folded before Flop (didn't bet)
Seat 2: smart.toddis showed [Kd Kh] and won ($2.66) with a pair of Kings
Seat 3: SERG244 (button) folded before Flop (didn't bet)
Seat 4: JJOOKKEER 77 (small blind) folded before Flop
Seat 5: pearseman657 (big blind) mucked
Seat 6: Hamilton_TD folded before Flop (didn't bet)



PokerStars Hand #222959083087:  Hold'em No Limit ($0.05/$0.10 USD) - 2021/01/23 11:29:57 ET
Table 'Saito II' 6-max Seat #4 is the button
Seat 1: JoaquinBueno ($18.16 in chips) 
Seat 2: smart.toddis ($5.70 in chips) 
Seat 3: SERG244 ($27.33 in chips) 
Seat 4: JJOOKKEER 77 ($3.98 in chips) 
Seat 5: pearseman657 ($11.87 in chips) 
Seat 6: Hamilton_TD ($10.57 in chips) 
pearseman657: posts small blind $0.05
Hamilton_TD: posts big blind $0.10
*** HOLE CARDS ***
JoaquinBueno: folds 
smart.toddis: folds 
SERG244: folds 
JJOOKKEER 77: raises $0.20 to $0.30
pearseman657: folds 
Hamilton_TD: folds 
Uncalled bet ($0.20) returned to JJOOKKEER 77
JJOOKKEER 77 collected $0.25 from pot
*** SUMMARY ***
Total pot $0.25 | Rake $0 
Seat 1: JoaquinBueno folded before Flop (didn't bet)
Seat 2: smart.toddis folded before Flop (didn't bet)
Seat 3: SERG244 folded before Flop (didn't bet)
Seat 4: JJOOKKEER 77 (button) collected ($0.25)
Seat 5: pearseman657 (small blind) folded before Flop
Seat 6: Hamilton_TD (big blind) folded before Flop



PokerStars Hand #222959090336:  Hold'em No Limit ($0.05/$0.10 USD) - 2021/01/23 11:30:08 ET
Table 'Saito II' 6-max Seat #5 is the button
Seat 1: JoaquinBueno ($18.16 in chips) 
Seat 2: smart.toddis ($5.70 in chips) 
Seat 3: SERG244 ($27.33 in chips) 
Seat 4: JJOOKKEER 77 ($4.13 in chips) 
Seat 5: pearseman657 ($11.82 in chips) 
Seat 6: Hamilton_TD ($10.47 in chips) 
Hamilton_TD: posts small blind $0.05
JoaquinBueno: posts big blind $0.10
*** HOLE CARDS ***
smart.toddis: folds 
SERG244: raises $0.16 to $0.26
JJOOKKEER 77: folds 
pearseman657: calls $0.26
Hamilton_TD: folds 
JoaquinBueno: folds 
*** FLOP *** [Qd Js 7d]
SERG244: checks 
pearseman657: bets $0.64
SERG244: calls $0.64
*** TURN *** [Qd Js 7d] [Qc]
SERG244: checks 
pearseman657: checks 
*** RIVER *** [Qd Js 7d Qc] [Jd]
SERG244: checks 
pearseman657: checks 
*** SHOW DOWN ***
SERG244: shows [9h Jh] (a full house, Jacks full of Queens)
pearseman657: mucks hand 
SERG244 collected $1.86 from pot
*** SUMMARY ***
Total pot $1.95 | Rake $0.09 
Board [Qd Js 7d Qc Jd]
Seat 1: JoaquinBueno (big blind) folded before Flop
Seat 2: smart.toddis folded before Flop (didn't bet)
Seat 3: SERG244 showed [9h Jh] and won ($1.86) with a full house, Jacks full of Queens
Seat 4: JJOOKKEER 77 folded before Flop (didn't bet)
Seat 5: pearseman657 (button) mucked
Seat 6: Hamilton_TD (small blind) folded before Flop



PokerStars Hand #222959112169:  Hold'em No Limit ($0.05/$0.10 USD) - 2021/01/23 11:30:44 ET
Table 'Saito II' 6-max Seat #6 is the button
Seat 1: JoaquinBueno ($18.06 in chips) 
Seat 2: smart.toddis ($5.70 in chips) 
Seat 3: SERG244 ($28.29 in chips) 
Seat 4: JJOOKKEER 77 ($4.13 in chips) 
Seat 5: pearseman657 ($10.92 in chips) 
Seat 6: Hamilton_TD ($10.42 in chips) 
JoaquinBueno: posts small blind $0.05
smart.toddis: posts big blind $0.10
*** HOLE CARDS ***
SERG244: folds 
JJOOKKEER 77: raises $0.20 to $0.30
pearseman657: folds 
Hamilton_TD: folds 
JoaquinBueno: folds 
smart.toddis: calls $0.20
*** FLOP *** [Jd Ah Kd]
smart.toddis: checks 
JJOOKKEER 77: checks 
*** TURN *** [Jd Ah Kd] [7d]
smart.toddis: bets $0.10
JJOOKKEER 77: calls $0.10
*** RIVER *** [Jd Ah Kd 7d] [Jc]
smart.toddis: bets $0.10
JJOOKKEER 77: calls $0.10
*** SHOW DOWN ***
smart.toddis: shows [7h 5c] (two pair, Jacks and Sevens)
JJOOKKEER 77: shows [Qc Qd] (two pair, Queens and Jacks)
JJOOKKEER 77 collected $1 from pot
*** SUMMARY ***
Total pot $1.05 | Rake $0.05 
Board [Jd Ah Kd 7d Jc]
Seat 1: JoaquinBueno (small blind) folded before Flop
Seat 2: smart.toddis (big blind) showed [7h 5c] and lost with two pair, Jacks and Sevens
Seat 3: SERG244 folded before Flop (didn't bet)
Seat 4: JJOOKKEER 77 showed [Qc Qd] and won ($1) with two pair, Queens and Jacks
Seat 5: pearseman657 folded before Flop (didn't bet)
Seat 6: Hamilton_TD (button) folded before Flop (didn't bet)



PokerStars Hand #222959139274:  Hold'em No Limit ($0.05/$0.10 USD) - 2021/01/23 11:31:28 ET
Table 'Saito II' 6-max Seat #1 is the button
Seat 1: JoaquinBueno ($18.01 in chips) 
Seat 2: smart.toddis ($5.20 in chips) 
Seat 3: SERG244 ($28.29 in chips) 
Seat 4: JJOOKKEER 77 ($4.63 in chips) 
Seat 5: pearseman657 ($10.92 in chips) 
Seat 6: Hamilton_TD ($10.42 in chips) 
smart.toddis: posts small blind $0.05
SERG244: posts big blind $0.10
*** HOLE CARDS ***
JJOOKKEER 77: calls $0.10
pearseman657: raises $0.35 to $0.45
Hamilton_TD: folds 
JoaquinBueno: folds 
smart.toddis: folds 
SERG244: folds 
JJOOKKEER 77: folds 
Uncalled bet ($0.35) returned to pearseman657
pearseman657 collected $0.35 from pot
pearseman657: doesn't show hand 
*** SUMMARY ***
Total pot $0.35 | Rake $0 
Seat 1: JoaquinBueno (button) folded before Flop (didn't bet)
Seat 2: smart.toddis (small blind) folded before Flop
Seat 3: SERG244 (big blind) folded before Flop
Seat 4: JJOOKKEER 77 folded before Flop
Seat 5: pearseman657 collected ($0.35)
Seat 6: Hamilton_TD folded before Flop (didn't bet)



PokerStars Hand #222959150787:  Hold'em No Limit ($0.05/$0.10 USD) - 2021/01/23 11:31:47 ET
Table 'Saito II' 6-max Seat #2 is the button
Seat 1: JoaquinBueno ($18.01 in chips) 
Seat 2: smart.toddis ($5.15 in chips) 
Seat 3: SERG244 ($28.19 in chips) 
Seat 4: JJOOKKEER 77 ($4.53 in chips) 
Seat 5: pearseman657 ($11.17 in chips) 
Seat 6: Hamilton_TD ($10.42 in chips) 
SERG244: posts small blind $0.05
JJOOKKEER 77: posts big blind $0.10
*** HOLE CARDS ***
pearseman657: calls $0.10
Hamilton_TD: folds 
JoaquinBueno: folds 
smart.toddis: folds 
SERG244: folds 
JJOOKKEER 77: raises $0.20 to $0.30
pearseman657: calls $0.20
*** FLOP *** [6d 3d Kd]
JJOOKKEER 77: bets $0.30
pearseman657: raises $0.30 to $0.60
JJOOKKEER 77: calls $0.30
*** TURN *** [6d 3d Kd] [Js]
JJOOKKEER 77: checks 
pearseman657: bets $1.77
JJOOKKEER 77: raises $1.86 to $3.63 and is all-in
pearseman657: calls $1.86
*** RIVER *** [6d 3d Kd Js] [3h]
*** SHOW DOWN ***
JJOOKKEER 77: shows [Ks Qd] (two pair, Kings and Threes)
pearseman657: shows [Td 8d] (a flush, King high)
pearseman657 collected $8.70 from pot
*** SUMMARY ***
Total pot $9.11 | Rake $0.41 
Board [6d 3d Kd Js 3h]
Seat 1: JoaquinBueno folded before Flop (didn't bet)
Seat 2: smart.toddis (button) folded before Flop (didn't bet)
Seat 3: SERG244 (small blind) folded before Flop
Seat 4: JJOOKKEER 77 (big blind) showed [Ks Qd] and lost with two pair, Kings and Threes
Seat 5: pearseman657 showed [Td 8d] and won ($8.70) with a flush, King high
Seat 6: Hamilton_TD folded before Flop (didn't bet)



PokerStars Hand #222959186037:  Hold'em No Limit ($0.05/$0.10 USD) - 2021/01/23 11:32:44 ET
Table 'Saito II' 6-max Seat #3 is the button
Seat 1: JoaquinBueno ($18.01 in chips) 
Seat 2: smart.toddis ($5.15 in chips) 
Seat 3: SERG244 ($28.14 in chips) 
Seat 5: pearseman657 ($15.34 in chips) 
Seat 6: Hamilton_TD ($10.42 in chips) 
pearseman657: posts small blind $0.05
Hamilton_TD: posts big blind $0.10
*** HOLE CARDS ***
JoaquinBueno: raises $0.15 to $0.25
smart.toddis: folds 
SERG244: folds 
pearseman657: raises $0.60 to $0.85
Hamilton_TD: folds 
JoaquinBueno: folds 
Uncalled bet ($0.60) returned to pearseman657
pearseman657 collected $0.60 from pot
pearseman657: doesn't show hand 
*** SUMMARY ***
Total pot $0.60 | Rake $0 
Seat 1: JoaquinBueno folded before Flop
Seat 2: smart.toddis folded before Flop (didn't bet)
Seat 3: SERG244 (button) folded before Flop (didn't bet)
Seat 5: pearseman657 (small blind) collected ($0.60)
Seat 6: Hamilton_TD (big blind) folded before Flop



PokerStars Hand #222959194820:  Hold'em No Limit ($0.05/$0.10 USD) - 2021/01/23 11:32:58 ET
Table 'Saito II' 6-max Seat #5 is the button
Seat 2: smart.toddis ($5.15 in chips) 
Seat 3: SERG244 ($28.14 in chips) 
Seat 5: pearseman657 ($15.69 in chips) 
Seat 6: Hamilton_TD ($10.32 in chips) 
Hamilton_TD: posts small blind $0.05
JoaquinBueno: is sitting out 
smart.toddis: posts big blind $0.10
JJOOKKEER 77: sits out 
*** HOLE CARDS ***
SERG244: folds 
JoaquinBueno leaves the table
pearseman657: folds 
Hamilton_TD: folds 
Uncalled bet ($0.05) returned to smart.toddis
smart.toddis collected $0.10 from pot
smart.toddis: doesn't show hand 
*** SUMMARY ***
Total pot $0.10 | Rake $0 
Seat 2: smart.toddis (big blind) collected ($0.10)
Seat 3: SERG244 folded before Flop (didn't bet)
Seat 5: pearseman657 (button) folded before Flop (didn't bet)
Seat 6: Hamilton_TD (small blind) folded before Flop



PokerStars Hand #222959199286:  Hold'em No Limit ($0.05/$0.10 USD) - 2021/01/23 11:33:05 ET
Table 'Saito II' 6-max Seat #6 is the button
Seat 2: smart.toddis ($5.20 in chips) 
Seat 3: SERG244 ($28.14 in chips) 
Seat 5: pearseman657 ($15.69 in chips) 
Seat 6: Hamilton_TD ($10.27 in chips) 
smart.toddis: posts small blind $0.05
SERG244: posts big blind $0.10
JJOOKKEER 77: sits out 
*** HOLE CARDS ***
pearseman657: folds 
Hamilton_TD: folds 
rotundul joins the table at seat #1 
smart.toddis: calls $0.05
SERG244: checks 
*** FLOP *** [Kd 7c 6s]
smart.toddis: checks 
SERG244: checks 
*** TURN *** [Kd 7c 6s] [Qc]
smart.toddis: checks 
SERG244: bets $0.21
smart.toddis: folds 
Uncalled bet ($0.21) returned to SERG244
SERG244 collected $0.19 from pot
SERG244: doesn't show hand 
*** SUMMARY ***
Total pot $0.20 | Rake $0.01 
Board [Kd 7c 6s Qc]
Seat 2: smart.toddis (small blind) folded on the Turn
Seat 3: SERG244 (big blind) collected ($0.19)
Seat 5: pearseman657 folded before Flop (didn't bet)
Seat 6: Hamilton_TD (button) folded before Flop (didn't bet)



PokerStars Hand #222959218784:  Hold'em No Limit ($0.05/$0.10 USD) - 2021/01/23 11:33:37 ET
Table 'Saito II' 6-max Seat #2 is the button
Seat 2: smart.toddis ($5.10 in chips) 
Seat 3: SERG244 ($28.23 in chips) 
Seat 4: JJOOKKEER 77 ($4 in chips) 
Seat 5: pearseman657 ($15.69 in chips) 
Seat 6: Hamilton_TD ($10.27 in chips) 
SERG244: posts small blind $0.05
JJOOKKEER 77: posts big blind $0.10
rotundul: sits out 
*** HOLE CARDS ***
pearseman657: raises $0.25 to $0.35
Hamilton_TD: folds 
smart.toddis: calls $0.35
SERG244: folds 
JJOOKKEER 77: raises $3.65 to $4 and is all-in
pearseman657: folds 
smart.toddis: folds 
Uncalled bet ($3.65) returned to JJOOKKEER 77
JJOOKKEER 77 collected $1.10 from pot
*** SUMMARY ***
Total pot $1.10 | Rake $0 
Seat 2: smart.toddis (button) folded before Flop
Seat 3: SERG244 (small blind) folded before Flop
Seat 4: JJOOKKEER 77 (big blind) collected ($1.10)
Seat 5: pearseman657 folded before Flop
Seat 6: Hamilton_TD folded before Flop (didn't bet)



PokerStars Hand #222959233554:  Hold'em No Limit ($0.05/$0.10 USD) - 2021/01/23 11:34:01 ET
Table 'Saito II' 6-max Seat #3 is the button
Seat 2: smart.toddis ($4.75 in chips) 
Seat 3: SERG244 ($28.18 in chips) 
Seat 4: JJOOKKEER 77 ($4.75 in chips) 
Seat 5: pearseman657 ($15.34 in chips) 
Seat 6: Hamilton_TD ($10.27 in chips) 
JJOOKKEER 77: posts small blind $0.05
pearseman657: posts big blind $0.10
rotundul: sits out 
*** HOLE CARDS ***
Hamilton_TD: folds 
smart.toddis: folds 
SERG244: folds 
JJOOKKEER 77: folds 
Uncalled bet ($0.05) returned to pearseman657
pearseman657 collected $0.10 from pot
pearseman657: doesn't show hand 
*** SUMMARY ***
Total pot $0.10 | Rake $0 
Seat 2: smart.toddis folded before Flop (didn't bet)
Seat 3: SERG244 (button) folded before Flop (didn't bet)
Seat 4: JJOOKKEER 77 (small blind) folded before Flop
Seat 5: pearseman657 (big blind) collected ($0.10)
Seat 6: Hamilton_TD folded before Flop (didn't bet)



PokerStars Hand #222959237925:  Hold'em No Limit ($0.05/$0.10 USD) - 2021/01/23 11:34:08 ET
Table 'Saito II' 6-max Seat #4 is the button
Seat 2: smart.toddis ($4.75 in chips) 
Seat 3: SERG244 ($28.18 in chips) 
Seat 4: JJOOKKEER 77 ($4.70 in chips) 
Seat 5: pearseman657 ($15.39 in chips) 
Seat 6: Hamilton_TD ($10.27 in chips) 
pearseman657: posts small blind $0.05
Hamilton_TD: posts big blind $0.10
rotundul: sits out 
*** HOLE CARDS ***
smart.toddis: folds 
SERG244: folds 
JJOOKKEER 77: folds 
pearseman657: folds 
Uncalled bet ($0.05) returned to Hamilton_TD
Hamilton_TD collected $0.10 from pot
*** SUMMARY ***
Total pot $0.10 | Rake $0 
Seat 2: smart.toddis folded before Flop (didn't bet)
Seat 3: SERG244 folded before Flop (didn't bet)
Seat 4: JJOOKKEER 77 (button) folded before Flop (didn't bet)
Seat 5: pearseman657 (small blind) folded before Flop
Seat 6: Hamilton_TD (big blind) collected ($0.10)



PokerStars Hand #222959244449:  Hold'em No Limit ($0.05/$0.10 USD) - 2021/01/23 11:34:19 ET
Table 'Saito II' 6-max Seat #5 is the button
Seat 1: rotundul ($10 in chips) 
Seat 2: smart.toddis ($4.75 in chips) 
Seat 3: SERG244 ($28.18 in chips) 
Seat 4: JJOOKKEER 77 ($4.70 in chips) 
Seat 5: pearseman657 ($15.34 in chips) 
Seat 6: Hamilton_TD ($10.32 in chips) 
Hamilton_TD: posts small blind $0.05
rotundul: posts big blind $0.10
*** HOLE CARDS ***
smart.toddis: calls $0.10
SERG244: folds 
JJOOKKEER 77: folds 
pearseman657: folds 
Hamilton_TD: calls $0.05
rotundul: checks 
*** FLOP *** [6d 7c Ah]
Hamilton_TD: checks 
rotundul: checks 
smart.toddis: checks 
*** TURN *** [6d 7c Ah] [4d]
Hamilton_TD: checks 
rotundul: checks 
smart.toddis: checks 
*** RIVER *** [6d 7c Ah 4d] [7h]
Hamilton_TD: checks 
rotundul: checks 
smart.toddis: checks 
*** SHOW DOWN ***
Hamilton_TD: shows [8s Qs] (a pair of Sevens)
rotundul: mucks hand 
smart.toddis: shows [5d 5c] (two pair, Sevens and Fives)
smart.toddis collected $0.29 from pot
*** SUMMARY ***
Total pot $0.30 | Rake $0.01 
Board [6d 7c Ah 4d 7h]
Seat 1: rotundul (big blind) mucked
Seat 2: smart.toddis showed [5d 5c] and won ($0.29) with two pair, Sevens and Fives
Seat 3: SERG244 folded before Flop (didn't bet)
Seat 4: JJOOKKEER 77 folded before Flop (didn't bet)
Seat 5: pearseman657 (button) folded before Flop (didn't bet)
Seat 6: Hamilton_TD (small blind) showed [8s Qs] and lost with a pair of Sevens



PokerStars Hand #222959270466:  Hold'em No Limit ($0.05/$0.10 USD) - 2021/01/23 11:34:53 ET
Table 'Saito II' 6-max Seat #6 is the button
Seat 1: rotundul ($10 in chips) 
Seat 2: smart.toddis ($4.94 in chips) 
Seat 3: SERG244 ($28.18 in chips) 
Seat 4: JJOOKKEER 77 ($4.70 in chips) 
Seat 5: pearseman657 ($15.34 in chips) 
Seat 6: Hamilton_TD ($10.22 in chips) 
rotundul: posts small blind $0.05
smart.toddis: posts big blind $0.10
*** HOLE CARDS ***
SERG244: raises $0.16 to $0.26
JJOOKKEER 77: folds 
pearseman657: folds 
Hamilton_TD: folds 
rotundul: folds 
smart.toddis: folds 
Uncalled bet ($0.16) returned to SERG244
SERG244 collected $0.25 from pot
SERG244: doesn't show hand 
*** SUMMARY ***
Total pot $0.25 | Rake $0 
Seat 1: rotundul (small blind) folded before Flop
Seat 2: smart.toddis (big blind) folded before Flop
Seat 3: SERG244 collected ($0.25)
Seat 4: JJOOKKEER 77 folded before Flop (didn't bet)
Seat 5: pearseman657 folded before Flop (didn't bet)
Seat 6: Hamilton_TD (button) folded before Flop (didn't bet)



PokerStars Hand #222959284021:  Hold'em No Limit ($0.05/$0.10 USD) - 2021/01/23 11:35:15 ET
Table 'Saito II' 6-max Seat #1 is the button
Seat 1: rotundul ($10 in chips) 
Seat 2: smart.toddis ($4.84 in chips) 
Seat 3: SERG244 ($28.33 in chips) 
Seat 4: JJOOKKEER 77 ($4.70 in chips) 
Seat 5: pearseman657 ($15.34 in chips) 
Seat 6: Hamilton_TD ($10.22 in chips) 
smart.toddis: posts small blind $0.05
SERG244: posts big blind $0.10
*** HOLE CARDS ***
JJOOKKEER 77: folds 
pearseman657: folds 
Hamilton_TD: folds 
rotundul: raises $0.15 to $0.25
smart.toddis: folds 
SERG244: calls $0.15
*** FLOP *** [4h 2c 4d]
SERG244: checks 
rotundul: bets $0.21
SERG244: raises $0.71 to $0.92
rotundul: calls $0.71
*** TURN *** [4h 2c 4d] [Ad]
SERG244: bets $1.52
rotundul: calls $1.52
*** RIVER *** [4h 2c 4d Ad] [Jh]
SERG244: bets $2.60
rotundul: folds 
Uncalled bet ($2.60) returned to SERG244
SERG244 collected $5.19 from pot
SERG244: doesn't show hand 
*** SUMMARY ***
Total pot $5.43 | Rake $0.24 
Board [4h 2c 4d Ad Jh]
Seat 1: rotundul (button) folded on the River
Seat 2: smart.toddis (small blind) folded before Flop
Seat 3: SERG244 (big blind) collected ($5.19)
Seat 4: JJOOKKEER 77 folded before Flop (didn't bet)
Seat 5: pearseman657 folded before Flop (didn't bet)
Seat 6: Hamilton_TD folded before Flop (didn't bet)



PokerStars Hand #222959328209:  Hold'em No Limit ($0.05/$0.10 USD) - 2021/01/23 11:36:27 ET
Table 'Saito II' 6-max Seat #2 is the button
Seat 1: rotundul ($10 in chips) 
Seat 2: smart.toddis ($4.79 in chips) 
Seat 3: SERG244 ($30.83 in chips) 
Seat 4: JJOOKKEER 77 ($4.70 in chips) 
Seat 5: pearseman657 ($15.34 in chips) 
Seat 6: Hamilton_TD ($10.22 in chips) 
SERG244: posts small blind $0.05
JJOOKKEER 77: posts big blind $0.10
*** HOLE CARDS ***
pearseman657: folds 
Hamilton_TD: raises $0.20 to $0.30
rotundul: folds 
smart.toddis: calls $0.30
SERG244: folds 
JJOOKKEER 77: calls $0.20
*** FLOP *** [Td 9s 9d]
JJOOKKEER 77: checks 
Hamilton_TD: bets $0.50
smart.toddis: raises $3.99 to $4.49 and is all-in
JJOOKKEER 77: calls $4.40 and is all-in
Hamilton_TD: folds 
Uncalled bet ($0.09) returned to smart.toddis
*** TURN *** [Td 9s 9d] [5c]
*** RIVER *** [Td 9s 9d 5c] [Ks]
*** SHOW DOWN ***
JJOOKKEER 77: shows [9c 6c] (three of a kind, Nines)
smart.toddis: shows [Tc Qd] (two pair, Tens and Nines)
JJOOKKEER 77 cashed out the hand for $8.19 | Cash Out Fee $0.08
*** SUMMARY ***
Total pot $10.25 | Rake $0.46 
Board [Td 9s 9d 5c Ks]
Seat 1: rotundul folded before Flop (didn't bet)
Seat 2: smart.toddis (button) showed [Tc Qd] and lost with two pair, Tens and Nines
Seat 3: SERG244 (small blind) folded before Flop
Seat 4: JJOOKKEER 77 (big blind) showed [9c 6c] and won ($9.79) with three of a kind, Nines (pot not awarded as player cashed out)
Seat 5: pearseman657 folded before Flop (didn't bet)
Seat 6: Hamilton_TD folded on the Flop



PokerStars Hand #222959361606:  Hold'em No Limit ($0.05/$0.10 USD) - 2021/01/23 11:37:21 ET
Table 'Saito II' 6-max Seat #3 is the button
Seat 1: rotundul ($10 in chips) 
Seat 3: SERG244 ($30.78 in chips) 
Seat 4: JJOOKKEER 77 ($8.19 in chips) 
Seat 5: pearseman657 ($15.34 in chips) 
Seat 6: Hamilton_TD ($10 in chips) 
JJOOKKEER 77: posts small blind $0.05
pearseman657: posts big blind $0.10
*** HOLE CARDS ***
Hamilton_TD: folds 
rotundul: folds 
SERG244: raises $0.16 to $0.26
smart.toddis is disconnected 
JJOOKKEER 77: raises $0.54 to $0.80
pearseman657: folds 
SERG244: folds 
Uncalled bet ($0.54) returned to JJOOKKEER 77
JJOOKKEER 77 collected $0.62 from pot
*** SUMMARY ***
Total pot $0.62 | Rake $0 
Seat 1: rotundul folded before Flop (didn't bet)
Seat 3: SERG244 (button) folded before Flop
Seat 4: JJOOKKEER 77 (small blind) collected ($0.62)
Seat 5: pearseman657 (big blind) folded before Flop
Seat 6: Hamilton_TD folded before Flop (didn't bet)



PokerStars Hand #222959376099:  Hold'em No Limit ($0.05/$0.10 USD) - 2021/01/23 11:37:45 ET
Table 'Saito II' 6-max Seat #4 is the button
Seat 1: rotundul ($10 in chips) 
Seat 3: SERG244 ($30.52 in chips) 
Seat 4: JJOOKKEER 77 ($8.55 in chips) 
Seat 5: pearseman657 ($15.24 in chips) 
Seat 6: Hamilton_TD ($10 in chips) 
pearseman657: posts small blind $0.05
Hamilton_TD: posts big blind $0.10
*** HOLE CARDS ***
rotundul: folds 
SERG244: folds 
JJOOKKEER 77: raises $0.20 to $0.30
pearseman657: folds 
Hamilton_TD: folds 
Uncalled bet ($0.20) returned to JJOOKKEER 77
JJOOKKEER 77 collected $0.25 from pot
*** SUMMARY ***
Total pot $0.25 | Rake $0 
Seat 1: rotundul folded before Flop (didn't bet)
Seat 3: SERG244 folded before Flop (didn't bet)
Seat 4: JJOOKKEER 77 (button) collected ($0.25)
Seat 5: pearseman657 (small blind) folded before Flop
Seat 6: Hamilton_TD (big blind) folded before Flop



PokerStars Hand #222959389434:  Hold'em No Limit ($0.05/$0.10 USD) - 2021/01/23 11:38:06 ET
Table 'Saito II' 6-max Seat #5 is the button
Seat 1: rotundul ($10 in chips) 
Seat 3: SERG244 ($30.52 in chips) 
Seat 4: JJOOKKEER 77 ($8.70 in chips) 
Seat 5: pearseman657 ($15.19 in chips) 
Seat 6: Hamilton_TD ($10 in chips) 
Hamilton_TD: posts small blind $0.05
rotundul: posts big blind $0.10
*** HOLE CARDS ***
SERG244: folds 
JJOOKKEER 77: folds 
pearseman657: raises $0.25 to $0.35
Hamilton_TD: folds 
rotundul: calls $0.25
*** FLOP *** [As Jh 8s]
rotundul: checks 
pearseman657: bets $0.72
rotundul: folds 
Uncalled bet ($0.72) returned to pearseman657
pearseman657 collected $0.72 from pot
pearseman657: doesn't show hand 
*** SUMMARY ***
Total pot $0.75 | Rake $0.03 
Board [As Jh 8s]
Seat 1: rotundul (big blind) folded on the Flop
Seat 3: SERG244 folded before Flop (didn't bet)
Seat 4: JJOOKKEER 77 folded before Flop (didn't bet)
Seat 5: pearseman657 (button) collected ($0.72)
Seat 6: Hamilton_TD (small blind) folded before Flop



PokerStars Hand #222959402367:  Hold'em No Limit ($0.05/$0.10 USD) - 2021/01/23 11:38:28 ET
Table 'Saito II' 6-max Seat #6 is the button
Seat 1: rotundul ($10 in chips) 
Seat 3: SERG244 ($30.52 in chips) 
Seat 4: JJOOKKEER 77 ($8.70 in chips) 
Seat 5: pearseman657 ($15.56 in chips) 
Seat 6: Hamilton_TD ($10 in chips) 
rotundul: posts small blind $0.05
SERG244: posts big blind $0.10
*** HOLE CARDS ***
JJOOKKEER 77: folds 
pearseman657: folds 
Hamilton_TD: folds 
JJOOKKEER 77 leaves the table
rotundul: folds 
Uncalled bet ($0.05) returned to SERG244
SERG244 collected $0.10 from pot
SERG244: doesn't show hand 
*** SUMMARY ***
Total pot $0.10 | Rake $0 
Seat 1: rotundul (small blind) folded before Flop
Seat 3: SERG244 (big blind) collected ($0.10)
Seat 4: JJOOKKEER 77 folded before Flop (didn't bet)
Seat 5: pearseman657 folded before Flop (didn't bet)
Seat 6: Hamilton_TD (button) folded before Flop (didn't bet)



PokerStars Hand #222959408195:  Hold'em No Limit ($0.05/$0.10 USD) - 2021/01/23 11:38:37 ET
Table 'Saito II' 6-max Seat #1 is the button
Seat 1: rotundul ($10 in chips) 
Seat 3: SERG244 ($30.57 in chips) 
Seat 5: pearseman657 ($15.56 in chips) 
Seat 6: Hamilton_TD ($10 in chips) 
SERG244: posts small blind $0.05
pearseman657: posts big blind $0.10
*** HOLE CARDS ***
mecha0117 joins the table at seat #4 
Hamilton_TD: folds 
rotundul: folds 
SERG244: raises $0.16 to $0.26
pearseman657: folds 
Uncalled bet ($0.16) returned to SERG244
SERG244 collected $0.20 from pot
SERG244: doesn't show hand 
*** SUMMARY ***
Total pot $0.20 | Rake $0 
Seat 1: rotundul (button) folded before Flop (didn't bet)
Seat 3: SERG244 (small blind) collected ($0.20)
Seat 5: pearseman657 (big blind) folded before Flop
Seat 6: Hamilton_TD folded before Flop (didn't bet)



PokerStars Hand #222959413305:  Hold'em No Limit ($0.05/$0.10 USD) - 2021/01/23 11:38:46 ET
Table 'Saito II' 6-max Seat #3 is the button
Seat 1: rotundul ($10 in chips) 
Seat 3: SERG244 ($30.67 in chips) 
Seat 5: pearseman657 ($15.46 in chips) 
Seat 6: Hamilton_TD ($10 in chips) 
pearseman657: posts small blind $0.05
Hamilton_TD: posts big blind $0.10
*** HOLE CARDS ***
rotundul: folds 
SERG244: folds 
pearseman657: calls $0.05
Hamilton_TD: checks 
*** FLOP *** [Ac 8s Ts]
pearseman657: bets $0.10
Hamilton_TD: calls $0.10
*** TURN *** [Ac 8s Ts] [7h]
pearseman657: checks 
Hamilton_TD: checks 
*** RIVER *** [Ac 8s Ts 7h] [2c]
pearseman657: checks 
Hamilton_TD: checks 
*** SHOW DOWN ***
pearseman657: shows [Jd 2d] (a pair of Deuces)
Hamilton_TD: shows [4s 8d] (a pair of Eights)
Hamilton_TD collected $0.38 from pot
*** SUMMARY ***
Total pot $0.40 | Rake $0.02 
Board [Ac 8s Ts 7h 2c]
Seat 1: rotundul folded before Flop (didn't bet)
Seat 3: SERG244 (button) folded before Flop (didn't bet)
Seat 5: pearseman657 (small blind) showed [Jd 2d] and lost with a pair of Deuces
Seat 6: Hamilton_TD (big blind) showed [4s 8d] and won ($0.38) with a pair of Eights



PokerStars Hand #222959428110:  Hold'em No Limit ($0.05/$0.10 USD) - 2021/01/23 11:39:10 ET
Table 'Saito II' 6-max Seat #5 is the button
Seat 1: rotundul ($10 in chips) 
Seat 3: SERG244 ($30.67 in chips) 
Seat 5: pearseman657 ($15.26 in chips) 
Seat 6: Hamilton_TD ($10.18 in chips) 
Hamilton_TD: posts small blind $0.05
rotundul: posts big blind $0.10
mecha0117: sits out 
*** HOLE CARDS ***
SERG244: folds 
pearseman657: folds 
Hamilton_TD: raises $0.15 to $0.25
rotundul: calls $0.15
*** FLOP *** [Ad 3d Ks]
Hamilton_TD: bets $0.26
rotundul: calls $0.26
*** TURN *** [Ad 3d Ks] [4s]
Hamilton_TD: checks 
rotundul: checks 
*** RIVER *** [Ad 3d Ks 4s] [5d]
Hamilton_TD: checks 
rotundul: bets $0.81
Hamilton_TD: folds 
Uncalled bet ($0.81) returned to rotundul
rotundul collected $0.97 from pot
rotundul: doesn't show hand 
*** SUMMARY ***
Total pot $1.02 | Rake $0.05 
Board [Ad 3d Ks 4s 5d]
Seat 1: rotundul (big blind) collected ($0.97)
Seat 3: SERG244 folded before Flop (didn't bet)
Seat 5: pearseman657 (button) folded before Flop (didn't bet)
Seat 6: Hamilton_TD (small blind) folded on the River



PokerStars Hand #222959466262:  Hold'em No Limit ($0.05/$0.10 USD) - 2021/01/23 11:40:12 ET
Table 'Saito II' 6-max Seat #6 is the button
Seat 1: rotundul ($10.46 in chips) 
Seat 3: SERG244 ($30.67 in chips) 
Seat 5: pearseman657 ($15.26 in chips) 
Seat 6: Hamilton_TD ($10 in chips) 
rotundul: posts small blind $0.05
SERG244: posts big blind $0.10
mecha0117: sits out 
*** HOLE CARDS ***
pearseman657: folds 
Hamilton_TD: raises $0.15 to $0.25
rotundul: folds 
SERG244: raises $0.85 to $1.10
Hamilton_TD: folds 
Uncalled bet ($0.85) returned to SERG244
SERG244 collected $0.55 from pot
SERG244: doesn't show hand 
*** SUMMARY ***
Total pot $0.55 | Rake $0 
Seat 1: rotundul (small blind) folded before Flop
Seat 3: SERG244 (big blind) collected ($0.55)
Seat 5: pearseman657 folded before Flop (didn't bet)
Seat 6: Hamilton_TD (button) folded before Flop



PokerStars Hand #222959475377:  Hold'em No Limit ($0.05/$0.10 USD) - 2021/01/23 11:40:27 ET
Table 'Saito II' 6-max Seat #1 is the button
Seat 1: rotundul ($10.41 in chips) 
Seat 3: SERG244 ($30.97 in chips) 
Seat 4: mecha0117 ($8 in chips) 
Seat 5: pearseman657 ($15.26 in chips) 
Seat 6: Hamilton_TD ($10 in chips) 
SERG244: posts small blind $0.05
mecha0117: posts big blind $0.10
*** HOLE CARDS ***
pearseman657: raises $0.25 to $0.35
Hamilton_TD: folds 
rotundul: folds 
SERG244: folds 
mecha0117: folds 
Uncalled bet ($0.25) returned to pearseman657
pearseman657 collected $0.25 from pot
pearseman657: doesn't show hand 
*** SUMMARY ***
Total pot $0.25 | Rake $0 
Seat 1: rotundul (button) folded before Flop (didn't bet)
Seat 3: SERG244 (small blind) folded before Flop
Seat 4: mecha0117 (big blind) folded before Flop
Seat 5: pearseman657 collected ($0.25)
Seat 6: Hamilton_TD folded before Flop (didn't bet)



PokerStars Hand #222959487226:  Hold'em No Limit ($0.05/$0.10 USD) - 2021/01/23 11:40:46 ET
Table 'Saito II' 6-max Seat #3 is the button
Seat 1: rotundul ($10.41 in chips) 
Seat 3: SERG244 ($30.92 in chips) 
Seat 4: mecha0117 ($8 in chips) 
Seat 5: pearseman657 ($15.41 in chips) 
Seat 6: Hamilton_TD ($10 in chips) 
mecha0117: posts small blind $0.05
pearseman657: posts big blind $0.10
*** HOLE CARDS ***
Hamilton_TD: folds 
rotundul: raises $0.15 to $0.25
SERG244: folds 
mecha0117: folds 
pearseman657: calls $0.15
*** FLOP *** [5s Jh 8d]
pearseman657: checks 
rotundul: bets $0.45
pearseman657: calls $0.45
*** TURN *** [5s Jh 8d] [Kc]
pearseman657: checks 
rotundul: bets $1.16
pearseman657: calls $1.16
*** RIVER *** [5s Jh 8d Kc] [5d]
pearseman657: checks 
rotundul: bets $2.55
pearseman657: calls $2.55
*** SHOW DOWN ***
rotundul: shows [Jd Ah] (two pair, Jacks and Fives)
pearseman657: mucks hand 
rotundul collected $8.47 from pot
*** SUMMARY ***
Total pot $8.87 | Rake $0.40 
Board [5s Jh 8d Kc 5d]
Seat 1: rotundul showed [Jd Ah] and won ($8.47) with two pair, Jacks and Fives
Seat 3: SERG244 (button) folded before Flop (didn't bet)
Seat 4: mecha0117 (small blind) folded before Flop
Seat 5: pearseman657 (big blind) mucked
Seat 6: Hamilton_TD folded before Flop (didn't bet)



PokerStars Hand #222959524621:  Hold'em No Limit ($0.05/$0.10 USD) - 2021/01/23 11:41:47 ET
Table 'Saito II' 6-max Seat #4 is the button
Seat 1: rotundul ($14.47 in chips) 
Seat 3: SERG244 ($30.92 in chips) 
Seat 4: mecha0117 ($8 in chips) 
Seat 5: pearseman657 ($11 in chips) 
Seat 6: Hamilton_TD ($10 in chips) 
pearseman657: posts small blind $0.05
Hamilton_TD: posts big blind $0.10
*** HOLE CARDS ***
rotundul: folds 
SERG244: raises $0.16 to $0.26
mecha0117: folds 
pearseman657: folds 
Hamilton_TD: raises $0.74 to $1
SERG244: raises $29.92 to $30.92 and is all-in
Hamilton_TD: folds 
Uncalled bet ($29.92) returned to SERG244
SERG244 collected $2.05 from pot
SERG244: doesn't show hand 
*** SUMMARY ***
Total pot $2.05 | Rake $0 
Seat 1: rotundul folded before Flop (didn't bet)
Seat 3: SERG244 collected ($2.05)
Seat 4: mecha0117 (button) folded before Flop (didn't bet)
Seat 5: pearseman657 (small blind) folded before Flop
Seat 6: Hamilton_TD (big blind) folded before Flop



PokerStars Hand #222959543212:  Hold'em No Limit ($0.05/$0.10 USD) - 2021/01/23 11:42:17 ET
Table 'Saito II' 6-max Seat #5 is the button
Seat 1: rotundul ($14.47 in chips) 
Seat 3: SERG244 ($31.97 in chips) 
Seat 4: mecha0117 ($8 in chips) 
Seat 5: pearseman657 ($10.95 in chips) 
Seat 6: Hamilton_TD ($10 in chips) 
Hamilton_TD: posts small blind $0.05
rotundul: posts big blind $0.10
*** HOLE CARDS ***
SERG244: folds 
mecha0117: folds 
pearseman657: folds 
Hamilton_TD: raises $0.15 to $0.25
rotundul: calls $0.15
*** FLOP *** [9h 4s 2h]
Hamilton_TD: checks 
rotundul: bets $0.40
Hamilton_TD: folds 
Uncalled bet ($0.40) returned to rotundul
rotundul collected $0.48 from pot
rotundul: doesn't show hand 
*** SUMMARY ***
Total pot $0.50 | Rake $0.02 
Board [9h 4s 2h]
Seat 1: rotundul (big blind) collected ($0.48)
Seat 3: SERG244 folded before Flop (didn't bet)
Seat 4: mecha0117 folded before Flop (didn't bet)
Seat 5: pearseman657 (button) folded before Flop (didn't bet)
Seat 6: Hamilton_TD (small blind) folded on the Flop



PokerStars Hand #222959567299:  Hold'em No Limit ($0.05/$0.10 USD) - 2021/01/23 11:42:56 ET
Table 'Saito II' 6-max Seat #6 is the button
Seat 1: rotundul ($14.70 in chips) 
Seat 3: SERG244 ($31.97 in chips) 
Seat 4: mecha0117 ($8 in chips) 
Seat 5: pearseman657 ($10.95 in chips) 
Seat 6: Hamilton_TD ($10 in chips) 
rotundul: posts small blind $0.05
SERG244: posts big blind $0.10
*** HOLE CARDS ***
mecha0117: folds 
pearseman657: calls $0.10
Hamilton_TD: folds 
rotundul: calls $0.05
SERG244: raises $0.50 to $0.60
pearseman657: folds 
rotundul: folds 
Uncalled bet ($0.50) returned to SERG244
SERG244 collected $0.30 from pot
SERG244: doesn't show hand 
*** SUMMARY ***
Total pot $0.30 | Rake $0 
Seat 1: rotundul (small blind) folded before Flop
Seat 3: SERG244 (big blind) collected ($0.30)
Seat 4: mecha0117 folded before Flop (didn't bet)
Seat 5: pearseman657 folded before Flop
Seat 6: Hamilton_TD (button) folded before Flop (didn't bet)



PokerStars Hand #222959579623:  Hold'em No Limit ($0.05/$0.10 USD) - 2021/01/23 11:43:16 ET
Table 'Saito II' 6-max Seat #1 is the button
Seat 1: rotundul ($14.60 in chips) 
Seat 3: SERG244 ($32.17 in chips) 
Seat 4: mecha0117 ($8 in chips) 
Seat 5: pearseman657 ($10.85 in chips) 
Seat 6: Hamilton_TD ($10 in chips) 
SERG244: posts small blind $0.05
mecha0117: posts big blind $0.10
*** HOLE CARDS ***
pearseman657: folds 
Hamilton_TD: folds 
rotundul: folds 
SERG244: raises $0.10 to $0.20
mecha0117: calls $0.10
*** FLOP *** [6s 3h 4s]
SERG244: checks 
mecha0117: bets $0.38
SERG244: folds 
Uncalled bet ($0.38) returned to mecha0117
mecha0117 collected $0.38 from pot
mecha0117: doesn't show hand 
*** SUMMARY ***
Total pot $0.40 | Rake $0.02 
Board [6s 3h 4s]
Seat 1: rotundul (button) folded before Flop (didn't bet)
Seat 3: SERG244 (small blind) folded on the Flop
Seat 4: mecha0117 (big blind) collected ($0.38)
Seat 5: pearseman657 folded before Flop (didn't bet)
Seat 6: Hamilton_TD folded before Flop (didn't bet)



PokerStars Hand #222959606813:  Hold'em No Limit ($0.05/$0.10 USD) - 2021/01/23 11:44:00 ET
Table 'Saito II' 6-max Seat #3 is the button
Seat 1: rotundul ($14.60 in chips) 
Seat 3: SERG244 ($31.97 in chips) 
Seat 4: mecha0117 ($8.18 in chips) 
Seat 5: pearseman657 ($10.85 in chips) 
Seat 6: Hamilton_TD ($10 in chips) 
mecha0117: posts small blind $0.05
pearseman657: posts big blind $0.10
*** HOLE CARDS ***
Hamilton_TD: raises $0.20 to $0.30
rotundul: folds 
SERG244: folds 
mecha0117: folds 
pearseman657: folds 
Uncalled bet ($0.20) returned to Hamilton_TD
Hamilton_TD collected $0.25 from pot
*** SUMMARY ***
Total pot $0.25 | Rake $0 
Seat 1: rotundul folded before Flop (didn't bet)
Seat 3: SERG244 (button) folded before Flop (didn't bet)
Seat 4: mecha0117 (small blind) folded before Flop
Seat 5: pearseman657 (big blind) folded before Flop
Seat 6: Hamilton_TD collected ($0.25)



PokerStars Hand #222959615652:  Hold'em No Limit ($0.05/$0.10 USD) - 2021/01/23 11:44:15 ET
Table 'Saito II' 6-max Seat #4 is the button
Seat 1: rotundul ($14.60 in chips) 
Seat 3: SERG244 ($31.97 in chips) 
Seat 4: mecha0117 ($8.13 in chips) 
Seat 5: pearseman657 ($10.75 in chips) 
Seat 6: Hamilton_TD ($10.15 in chips) 
pearseman657: posts small blind $0.05
Hamilton_TD: posts big blind $0.10
*** HOLE CARDS ***
rotundul: folds 
SERG244: raises $0.16 to $0.26
mecha0117: folds 
pearseman657: folds 
Hamilton_TD: raises $0.74 to $1
SERG244: folds 
Uncalled bet ($0.74) returned to Hamilton_TD
Hamilton_TD collected $0.57 from pot
*** SUMMARY ***
Total pot $0.57 | Rake $0 
Seat 1: rotundul folded before Flop (didn't bet)
Seat 3: SERG244 folded before Flop
Seat 4: mecha0117 (button) folded before Flop (didn't bet)
Seat 5: pearseman657 (small blind) folded before Flop
Seat 6: Hamilton_TD (big blind) collected ($0.57)



PokerStars Hand #222959627689:  Hold'em No Limit ($0.05/$0.10 USD) - 2021/01/23 11:44:34 ET
Table 'Saito II' 6-max Seat #5 is the button
Seat 1: rotundul ($14.60 in chips) 
Seat 3: SERG244 ($31.71 in chips) 
Seat 4: mecha0117 ($8.13 in chips) 
Seat 5: pearseman657 ($10.70 in chips) 
Seat 6: Hamilton_TD ($10.46 in chips) 
Hamilton_TD: posts small blind $0.05
rotundul: posts big blind $0.10
*** HOLE CARDS ***
SERG244: raises $0.16 to $0.26
mecha0117: folds 
pearseman657: folds 
Hamilton_TD: raises $0.74 to $1
rotundul: folds 
SERG244: calls $0.74
*** FLOP *** [8d Ad 7d]
Hamilton_TD: bets $1.10
SERG244: calls $1.10
*** TURN *** [8d Ad 7d] [8h]
Hamilton_TD: checks 
SERG244: bets $1.44
Hamilton_TD: raises $6.92 to $8.36 and is all-in
pearseman657 leaves the table
SERG244: calls $6.92
*** RIVER *** [8d Ad 7d 8h] [9s]
*** SHOW DOWN ***
Hamilton_TD: shows [Ah Qd] (two pair, Aces and Eights)
SERG244: shows [Ac Kc] (two pair, Aces and Eights - King kicker)
SERG244 cashed out the hand for $13.77 | Cash Out Fee $0.14
*** SUMMARY ***
Total pot $21.02 | Rake $0.95 
Board [8d Ad 7d 8h 9s]
Seat 1: rotundul (big blind) folded before Flop
Seat 3: SERG244 showed [Ac Kc] and won ($20.07) with two pair, Aces and Eights (pot not awarded as player cashed out)
Seat 4: mecha0117 folded before Flop (didn't bet)
Seat 5: pearseman657 (button) folded before Flop (didn't bet)
Seat 6: Hamilton_TD (small blind) showed [Ah Qd] and lost with two pair, Aces and Eights



PokerStars Hand #222959677317:  Hold'em No Limit ($0.05/$0.10 USD) - 2021/01/23 11:45:54 ET
Table 'Saito II' 6-max Seat #6 is the button
Seat 1: rotundul ($14.50 in chips) 
Seat 3: SERG244 ($35.02 in chips) 
Seat 4: mecha0117 ($8.13 in chips) 
Seat 6: Hamilton_TD ($10 in chips) 
rotundul: posts small blind $0.05
SERG244: posts big blind $0.10
*** HOLE CARDS ***
mecha0117: raises $0.20 to $0.30
Hamilton_TD: folds 
rotundul: folds 
SERG244: calls $0.20
*** FLOP *** [4s 5d Qd]
SERG244: checks 
mecha0117: bets $0.40
SERG244: folds 
Uncalled bet ($0.40) returned to mecha0117
mecha0117 collected $0.62 from pot
smart.toddis was removed from the table for failing to post
smart.toddis leaves the table
mecha0117: doesn't show hand 
*** SUMMARY ***
Total pot $0.65 | Rake $0.03 
Board [4s 5d Qd]
Seat 1: rotundul (small blind) folded before Flop
Seat 3: SERG244 (big blind) folded on the Flop
Seat 4: mecha0117 collected ($0.62)
Seat 6: Hamilton_TD (button) folded before Flop (didn't bet)



PokerStars Hand #222959692479:  Hold'em No Limit ($0.05/$0.10 USD) - 2021/01/23 11:46:19 ET
Table 'Saito II' 6-max Seat #1 is the button
Seat 1: rotundul ($14.45 in chips) 
Seat 3: SERG244 ($34.72 in chips) 
Seat 4: mecha0117 ($8.45 in chips) 
Seat 6: Hamilton_TD ($10 in chips) 
SERG244: posts small blind $0.05
mecha0117: posts big blind $0.10
*** HOLE CARDS ***
Hamilton_TD: folds 
rotundul: raises $0.15 to $0.25
SERG244: folds 
CallLightning joins the table at seat #5 
mecha0117: folds 
Uncalled bet ($0.15) returned to rotundul
rotundul collected $0.25 from pot
rotundul: doesn't show hand 
DiskoDancer joins the table at seat #2 
*** SUMMARY ***
Total pot $0.25 | Rake $0 
Seat 1: rotundul (button) collected ($0.25)
Seat 3: SERG244 (small blind) folded before Flop
Seat 4: mecha0117 (big blind) folded before Flop
Seat 6: Hamilton_TD folded before Flop (didn't bet)



PokerStars Hand #222959699616:  Hold'em No Limit ($0.05/$0.10 USD) - 2021/01/23 11:46:30 ET
Table 'Saito II' 6-max Seat #3 is the button
Seat 1: rotundul ($14.60 in chips) 
Seat 3: SERG244 ($34.67 in chips) 
Seat 4: mecha0117 ($8.35 in chips) 
Seat 5: CallLightning ($8 in chips) 
Seat 6: Hamilton_TD ($10 in chips) 
mecha0117: posts small blind $0.05
CallLightning: posts big blind $0.10
DiskoDancer: sits out 
*** HOLE CARDS ***
Hamilton_TD: folds 
rotundul: folds 
SERG244: folds 
mecha0117: raises $0.20 to $0.30
CallLightning: folds 
Uncalled bet ($0.20) returned to mecha0117
mecha0117 collected $0.20 from pot
mecha0117: doesn't show hand 
*** SUMMARY ***
Total pot $0.20 | Rake $0 
Seat 1: rotundul folded before Flop (didn't bet)
Seat 3: SERG244 (button) folded before Flop (didn't bet)
Seat 4: mecha0117 (small blind) collected ($0.20)
Seat 5: CallLightning (big blind) folded before Flop
Seat 6: Hamilton_TD folded before Flop (didn't bet)



PokerStars Hand #222959707945:  Hold'em No Limit ($0.05/$0.10 USD) - 2021/01/23 11:46:43 ET
Table 'Saito II' 6-max Seat #4 is the button
Seat 1: rotundul ($14.60 in chips) 
Seat 3: SERG244 ($34.67 in chips) 
Seat 4: mecha0117 ($8.45 in chips) 
Seat 5: CallLightning ($7.90 in chips) 
Seat 6: Hamilton_TD ($10 in chips) 
CallLightning: posts small blind $0.05
Hamilton_TD: posts big blind $0.10
DiskoDancer: sits out 
*** HOLE CARDS ***
rotundul: folds 
SERG244: raises $0.16 to $0.26
DiskoDancer leaves the table
mecha0117: folds 
CallLightning: folds 
Hamilton_TD: folds 
Uncalled bet ($0.16) returned to SERG244
SERG244 collected $0.25 from pot
SERG244: doesn't show hand 
*** SUMMARY ***
Total pot $0.25 | Rake $0 
Seat 1: rotundul folded before Flop (didn't bet)
Seat 3: SERG244 collected ($0.25)
Seat 4: mecha0117 (button) folded before Flop (didn't bet)
Seat 5: CallLightning (small blind) folded before Flop
Seat 6: Hamilton_TD (big blind) folded before Flop



PokerStars Hand #222959716251:  Hold'em No Limit ($0.05/$0.10 USD) - 2021/01/23 11:46:57 ET
Table 'Saito II' 6-max Seat #5 is the button
Seat 3: SERG244 ($34.82 in chips) 
Seat 4: mecha0117 ($8.45 in chips) 
Seat 5: CallLightning ($7.85 in chips) 
Seat 6: Hamilton_TD ($10 in chips) 
Hamilton_TD: posts small blind $0.05
rotundul: is sitting out 
SERG244: posts big blind $0.10
*** HOLE CARDS ***
mecha0117: raises $0.20 to $0.30
CallLightning: folds 
Hamilton_TD: folds 
SERG244: calls $0.20
*** FLOP *** [As 2c 9s]
SERG244: checks 
mecha0117: checks 
*** TURN *** [As 2c 9s] [4c]
ahmet_vs joins the table at seat #2 
SERG244: checks 
mecha0117: bets $0.31
SERG244: calls $0.31
*** RIVER *** [As 2c 9s 4c] [Jd]
SERG244: checks 
mecha0117: bets $1.50
SERG244: folds 
Uncalled bet ($1.50) returned to mecha0117
mecha0117 collected $1.21 from pot
mecha0117: doesn't show hand 
*** SUMMARY ***
Total pot $1.27 | Rake $0.06 
Board [As 2c 9s 4c Jd]
Seat 3: SERG244 (big blind) folded on the River
Seat 4: mecha0117 collected ($1.21)
Seat 5: CallLightning (button) folded before Flop (didn't bet)
Seat 6: Hamilton_TD (small blind) folded before Flop



PokerStars Hand #222959745078:  Hold'em No Limit ($0.05/$0.10 USD) - 2021/01/23 11:47:44 ET
Table 'Saito II' 6-max Seat #6 is the button
Seat 3: SERG244 ($34.21 in chips) 
Seat 4: mecha0117 ($9.05 in chips) 
Seat 5: CallLightning ($7.85 in chips) 
Seat 6: Hamilton_TD ($10 in chips) 
SERG244: posts small blind $0.05
mecha0117: posts big blind $0.10
*** HOLE CARDS ***
CallLightning: folds 
Hamilton_TD: raises $0.15 to $0.25
SERG244: folds 
mecha0117: calls $0.15
*** FLOP *** [5s 6h 3s]
mecha0117: checks 
Hamilton_TD: bets $0.37
mecha0117: raises $0.83 to $1.20
Hamilton_TD: raises $8.55 to $9.75 and is all-in
mecha0117: calls $7.60 and is all-in
Uncalled bet ($0.95) returned to Hamilton_TD
*** TURN *** [5s 6h 3s] [4h]
*** RIVER *** [5s 6h 3s 4h] [As]
*** SHOW DOWN ***
mecha0117: shows [4d 2d] (a straight, Deuce to Six)
Hamilton_TD: shows [Ts Th] (a pair of Tens)
mecha0117 collected $17.33 from pot
*** SUMMARY ***
Total pot $18.15 | Rake $0.82 
Board [5s 6h 3s 4h As]
Seat 3: SERG244 (small blind) folded before Flop
Seat 4: mecha0117 (big blind) showed [4d 2d] and won ($17.33) with a straight, Deuce to Six
Seat 5: CallLightning folded before Flop (didn't bet)
Seat 6: Hamilton_TD (button) showed [Ts Th] and lost with a pair of Tens



PokerStars Hand #222959772185:  Hold'em No Limit ($0.05/$0.10 USD) - 2021/01/23 11:48:28 ET
Table 'Saito II' 6-max Seat #3 is the button
Seat 3: SERG244 ($34.16 in chips) 
Seat 4: mecha0117 ($17.33 in chips) 
Seat 5: CallLightning ($7.85 in chips) 
Seat 6: Hamilton_TD ($10 in chips) 
mecha0117: posts small blind $0.05
CallLightning: posts big blind $0.10
ahmet_vs: sits out 
*** HOLE CARDS ***
Hamilton_TD: folds 
SERG244: raises $0.16 to $0.26
mecha0117: folds 
CallLightning: raises $0.64 to $0.90
SERG244: calls $0.64
*** FLOP *** [Jh 8d 7d]
CallLightning: bets $0.89
SERG244: calls $0.89
*** TURN *** [Jh 8d 7d] [Jc]
CallLightning: checks 
SERG244: bets $2.31
rotundul leaves the table
CallLightning: folds 
Uncalled bet ($2.31) returned to SERG244
SERG244 collected $3.47 from pot
SERG244: doesn't show hand 
*** SUMMARY ***
Total pot $3.63 | Rake $0.16 
Board [Jh 8d 7d Jc]
Seat 3: SERG244 (button) collected ($3.47)
Seat 4: mecha0117 (small blind) folded before Flop
Seat 5: CallLightning (big blind) folded on the Turn
Seat 6: Hamilton_TD folded before Flop (didn't bet)



PokerStars Hand #222959802435:  Hold'em No Limit ($0.05/$0.10 USD) - 2021/01/23 11:49:16 ET
Table 'Saito II' 6-max Seat #4 is the button
Seat 3: SERG244 ($35.84 in chips) 
Seat 4: mecha0117 ($17.28 in chips) 
Seat 5: CallLightning ($6.06 in chips) 
Seat 6: Hamilton_TD ($10 in chips) 
CallLightning: posts small blind $0.05
Hamilton_TD: posts big blind $0.10
ahmet_vs: sits out 
*** HOLE CARDS ***
SERG244: folds 
mecha0117: folds 
CallLightning: folds 
Uncalled bet ($0.05) returned to Hamilton_TD
Hamilton_TD collected $0.10 from pot
*** SUMMARY ***
Total pot $0.10 | Rake $0 
Seat 3: SERG244 folded before Flop (didn't bet)
Seat 4: mecha0117 (button) folded before Flop (didn't bet)
Seat 5: CallLightning (small blind) folded before Flop
Seat 6: Hamilton_TD (big blind) collected ($0.10)



PokerStars Hand #222959807113:  Hold'em No Limit ($0.05/$0.10 USD) - 2021/01/23 11:49:24 ET
Table 'Saito II' 6-max Seat #5 is the button
Seat 2: ahmet_vs ($10 in chips) 
Seat 3: SERG244 ($35.84 in chips) 
Seat 4: mecha0117 ($17.28 in chips) 
Seat 5: CallLightning ($6.01 in chips) 
Seat 6: Hamilton_TD ($10.05 in chips) 
Hamilton_TD: posts small blind $0.05
ahmet_vs: posts big blind $0.10
*** HOLE CARDS ***
SERG244: folds 
mecha0117: folds 
CallLightning: folds 
Hamilton_TD: folds 
Uncalled bet ($0.05) returned to ahmet_vs
ahmet_vs collected $0.10 from pot
ahmet_vs: doesn't show hand 
*** SUMMARY ***
Total pot $0.10 | Rake $0 
Seat 2: ahmet_vs (big blind) collected ($0.10)
Seat 3: SERG244 folded before Flop (didn't bet)
Seat 4: mecha0117 folded before Flop (didn't bet)
Seat 5: CallLightning (button) folded before Flop (didn't bet)
Seat 6: Hamilton_TD (small blind) folded before Flop



PokerStars Hand #222959811309:  Hold'em No Limit ($0.05/$0.10 USD) - 2021/01/23 11:49:30 ET
Table 'Saito II' 6-max Seat #6 is the button
Seat 2: ahmet_vs ($10.05 in chips) 
Seat 4: mecha0117 ($17.28 in chips) 
Seat 5: CallLightning ($6.01 in chips) 
Seat 6: Hamilton_TD ($10 in chips) 
ahmet_vs: posts small blind $0.05
SERG244: is sitting out 
mecha0117: posts big blind $0.10
*** HOLE CARDS ***
CallLightning: folds 
Hamilton_TD: raises $0.15 to $0.25
ahmet_vs: folds 
mecha0117: folds 
Uncalled bet ($0.15) returned to Hamilton_TD
Hamilton_TD collected $0.25 from pot
*** SUMMARY ***
Total pot $0.25 | Rake $0 
Seat 2: ahmet_vs (small blind) folded before Flop
Seat 4: mecha0117 (big blind) folded before Flop
Seat 5: CallLightning folded before Flop (didn't bet)
Seat 6: Hamilton_TD (button) collected ($0.25)



PokerStars Hand #222959819001:  Hold'em No Limit ($0.05/$0.10 USD) - 2021/01/23 11:49:43 ET
Table 'Saito II' 6-max Seat #2 is the button
Seat 2: ahmet_vs ($10 in chips) 
Seat 4: mecha0117 ($17.18 in chips) 
Seat 5: CallLightning ($6.01 in chips) 
Seat 6: Hamilton_TD ($10.15 in chips) 
mecha0117: posts small blind $0.05
CallLightning: posts big blind $0.10
*** HOLE CARDS ***
Hamilton_TD: raises $0.15 to $0.25
ahmet_vs: folds 
mecha0117: folds 
CallLightning: calls $0.15
*** FLOP *** [7h 3d 9s]
CallLightning: checks 
katalloo joins the table at seat #1 
Hamilton_TD: checks 
*** TURN *** [7h 3d 9s] [8s]
CallLightning: bets $0.30
Hamilton_TD: folds 
Uncalled bet ($0.30) returned to CallLightning
CallLightning collected $0.53 from pot
CallLightning: doesn't show hand 
*** SUMMARY ***
Total pot $0.55 | Rake $0.02 
Board [7h 3d 9s 8s]
Seat 2: ahmet_vs (button) folded before Flop (didn't bet)
Seat 4: mecha0117 (small blind) folded before Flop
Seat 5: CallLightning (big blind) collected ($0.53)
Seat 6: Hamilton_TD folded on the Turn



PokerStars Hand #222959836301:  Hold'em No Limit ($0.05/$0.10 USD) - 2021/01/23 11:50:11 ET
Table 'Saito II' 6-max Seat #4 is the button
Seat 2: ahmet_vs ($10 in chips) 
Seat 4: mecha0117 ($17.13 in chips) 
Seat 5: CallLightning ($6.29 in chips) 
Seat 6: Hamilton_TD ($10 in chips) 
CallLightning: posts small blind $0.05
Hamilton_TD: posts big blind $0.10
katalloo: sits out 
*** HOLE CARDS ***
ahmet_vs: folds 
mecha0117: folds 
CallLightning: raises $0.20 to $0.30
Hamilton_TD: calls $0.20
*** FLOP *** [5d 5s Qc]
CallLightning: checks 
Hamilton_TD: bets $0.31
CallLightning: calls $0.31
*** TURN *** [5d 5s Qc] [2h]
CallLightning: checks 
Hamilton_TD: bets $0.55
CallLightning: calls $0.55
*** RIVER *** [5d 5s Qc 2h] [2c]
SERG244 leaves the table
CallLightning: checks 
Hamilton_TD: checks 
*** SHOW DOWN ***
CallLightning: shows [Jd Ad] (two pair, Fives and Deuces)
Hamilton_TD: shows [9c 9h] (two pair, Nines and Fives)
Hamilton_TD collected $2.22 from pot
*** SUMMARY ***
Total pot $2.32 | Rake $0.10 
Board [5d 5s Qc 2h 2c]
Seat 2: ahmet_vs folded before Flop (didn't bet)
Seat 4: mecha0117 (button) folded before Flop (didn't bet)
Seat 5: CallLightning (small blind) showed [Jd Ad] and lost with two pair, Fives and Deuces
Seat 6: Hamilton_TD (big blind) showed [9c 9h] and won ($2.22) with two pair, Nines and Fives



PokerStars Hand #222959852537:  Hold'em No Limit ($0.05/$0.10 USD) - 2021/01/23 11:50:37 ET
Table 'Saito II' 6-max Seat #5 is the button
Seat 1: katalloo ($12.83 in chips) 
Seat 2: ahmet_vs ($10 in chips) 
Seat 4: mecha0117 ($17.13 in chips) 
Seat 5: CallLightning ($5.13 in chips) 
Seat 6: Hamilton_TD ($11.06 in chips) 
Hamilton_TD: posts small blind $0.05
katalloo: posts big blind $0.10
*** HOLE CARDS ***
ahmet_vs: raises $0.15 to $0.25
mecha0117: folds 
CallLightning: folds 
Hamilton_TD: folds 
katalloo: folds 
Uncalled bet ($0.15) returned to ahmet_vs
ahmet_vs collected $0.25 from pot
ahmet_vs: doesn't show hand 
*** SUMMARY ***
Total pot $0.25 | Rake $0 
Seat 1: katalloo (big blind) folded before Flop
Seat 2: ahmet_vs collected ($0.25)
Seat 4: mecha0117 folded before Flop (didn't bet)
Seat 5: CallLightning (button) folded before Flop (didn't bet)
Seat 6: Hamilton_TD (small blind) folded before Flop



PokerStars Hand #222959858628:  Hold'em No Limit ($0.05/$0.10 USD) - 2021/01/23 11:50:47 ET
Table 'Saito II' 6-max Seat #6 is the button
Seat 1: katalloo ($12.73 in chips) 
Seat 2: ahmet_vs ($10.15 in chips) 
Seat 4: mecha0117 ($17.13 in chips) 
Seat 5: CallLightning ($5.13 in chips) 
Seat 6: Hamilton_TD ($11.01 in chips) 
katalloo: posts small blind $0.05
ahmet_vs: posts big blind $0.10
*** HOLE CARDS ***
mecha0117: folds 
CallLightning: folds 
Hamilton_TD: folds 
katalloo: raises $0.15 to $0.25
ahmet_vs: folds 
Uncalled bet ($0.15) returned to katalloo
katalloo collected $0.20 from pot
katalloo: doesn't show hand 
*** SUMMARY ***
Total pot $0.20 | Rake $0 
Seat 1: katalloo (small blind) collected ($0.20)
Seat 2: ahmet_vs (big blind) folded before Flop
Seat 4: mecha0117 folded before Flop (didn't bet)
Seat 5: CallLightning folded before Flop (didn't bet)
Seat 6: Hamilton_TD (button) folded before Flop (didn't bet)



PokerStars Hand #222959993675:  Hold'em No Limit ($0.05/$0.10 USD) - 2021/01/23 11:54:16 ET
Table 'Saito II' 6-max Seat #1 is the button
Seat 1: katalloo ($12.68 in chips) 
Seat 2: ahmet_vs ($10 in chips) 
Seat 3: stucjones ($5.50 in chips) 
Seat 4: mecha0117 ($25.99 in chips) 
Seat 5: CallLightning ($10.36 in chips) 
Seat 6: Hamilton_TD ($11.14 in chips) 
ahmet_vs: posts small blind $0.05
stucjones: posts big blind $0.10
*** HOLE CARDS ***
mecha0117: folds 
CallLightning: folds 
Hamilton_TD: raises $0.20 to $0.30
katalloo: folds 
ahmet_vs: folds 
stucjones: folds 
Uncalled bet ($0.20) returned to Hamilton_TD
Hamilton_TD collected $0.25 from pot
*** SUMMARY ***
Total pot $0.25 | Rake $0 
Seat 1: katalloo (button) folded before Flop (didn't bet)
Seat 2: ahmet_vs (small blind) folded before Flop
Seat 3: stucjones (big blind) folded before Flop
Seat 4: mecha0117 folded before Flop (didn't bet)
Seat 5: CallLightning folded before Flop (didn't bet)
Seat 6: Hamilton_TD collected ($0.25)



PokerStars Hand #222960001324:  Hold'em No Limit ($0.05/$0.10 USD) - 2021/01/23 11:54:28 ET
Table 'Saito II' 6-max Seat #2 is the button
Seat 1: katalloo ($12.68 in chips) 
Seat 2: ahmet_vs ($10 in chips) 
Seat 3: stucjones ($5.40 in chips) 
Seat 4: mecha0117 ($25.99 in chips) 
Seat 5: CallLightning ($10.36 in chips) 
Seat 6: Hamilton_TD ($11.29 in chips) 
stucjones: posts small blind $0.05
mecha0117: posts big blind $0.10
*** HOLE CARDS ***
CallLightning: raises $0.20 to $0.30
Hamilton_TD: folds 
katalloo: folds 
ahmet_vs: folds 
stucjones: calls $0.25
mecha0117: folds 
*** FLOP *** [4h Kc 8d]
stucjones: checks 
CallLightning: bets $0.30
stucjones: folds 
Uncalled bet ($0.30) returned to CallLightning
CallLightning collected $0.67 from pot
CallLightning: doesn't show hand 
*** SUMMARY ***
Total pot $0.70 | Rake $0.03 
Board [4h Kc 8d]
Seat 1: katalloo folded before Flop (didn't bet)
Seat 2: ahmet_vs (button) folded before Flop (didn't bet)
Seat 3: stucjones (small blind) folded on the Flop
Seat 4: mecha0117 (big blind) folded before Flop
Seat 5: CallLightning collected ($0.67)
Seat 6: Hamilton_TD folded before Flop (didn't bet)



PokerStars Hand #222960016151:  Hold'em No Limit ($0.05/$0.10 USD) - 2021/01/23 11:54:52 ET
Table 'Saito II' 6-max Seat #3 is the button
Seat 1: katalloo ($12.68 in chips) 
Seat 2: ahmet_vs ($10 in chips) 
Seat 3: stucjones ($5.10 in chips) 
Seat 4: mecha0117 ($25.89 in chips) 
Seat 5: CallLightning ($10.73 in chips) 
Seat 6: Hamilton_TD ($11.29 in chips) 
mecha0117: posts small blind $0.05
CallLightning: posts big blind $0.10
*** HOLE CARDS ***
Hamilton_TD: folds 
katalloo: folds 
ahmet_vs: folds 
stucjones: folds 
mecha0117: calls $0.05
CallLightning: raises $0.30 to $0.40
mecha0117: folds 
Uncalled bet ($0.30) returned to CallLightning
CallLightning collected $0.20 from pot
CallLightning: doesn't show hand 
*** SUMMARY ***
Total pot $0.20 | Rake $0 
Seat 1: katalloo folded before Flop (didn't bet)
Seat 2: ahmet_vs folded before Flop (didn't bet)
Seat 3: stucjones (button) folded before Flop (didn't bet)
Seat 4: mecha0117 (small blind) folded before Flop
Seat 5: CallLightning (big blind) collected ($0.20)
Seat 6: Hamilton_TD folded before Flop (didn't bet)



PokerStars Hand #222960027947:  Hold'em No Limit ($0.05/$0.10 USD) - 2021/01/23 11:55:13 ET
Table 'Saito II' 6-max Seat #4 is the button
Seat 1: katalloo ($12.68 in chips) 
Seat 2: ahmet_vs ($10 in chips) 
Seat 3: stucjones ($5.10 in chips) 
Seat 4: mecha0117 ($25.79 in chips) 
Seat 5: CallLightning ($10.83 in chips) 
Seat 6: Hamilton_TD ($11.29 in chips) 
CallLightning: posts small blind $0.05
Hamilton_TD: posts big blind $0.10
*** HOLE CARDS ***
katalloo: folds 
ahmet_vs: folds 
stucjones: raises $0.20 to $0.30
mecha0117: folds 
CallLightning: folds 
Hamilton_TD: folds 
Uncalled bet ($0.20) returned to stucjones
stucjones collected $0.25 from pot
stucjones: doesn't show hand 
*** SUMMARY ***
Total pot $0.25 | Rake $0 
Seat 1: katalloo folded before Flop (didn't bet)
Seat 2: ahmet_vs folded before Flop (didn't bet)
Seat 3: stucjones collected ($0.25)
Seat 4: mecha0117 (button) folded before Flop (didn't bet)
Seat 5: CallLightning (small blind) folded before Flop
Seat 6: Hamilton_TD (big blind) folded before Flop



PokerStars Hand #222960034456:  Hold'em No Limit ($0.05/$0.10 USD) - 2021/01/23 11:55:27 ET
Table 'Saito II' 6-max Seat #5 is the button
Seat 2: ahmet_vs ($10 in chips) 
Seat 3: stucjones ($5.25 in chips) 
Seat 4: mecha0117 ($25.79 in chips) 
Seat 5: CallLightning ($10.78 in chips) 
Seat 6: Hamilton_TD ($11.19 in chips) 
Hamilton_TD: posts small blind $0.05
katalloo: is sitting out 
ahmet_vs: posts big blind $0.10
*** HOLE CARDS ***
stucjones: calls $0.10
mecha0117: raises $0.30 to $0.40
CallLightning: raises $0.90 to $1.30
Hamilton_TD: folds 
ahmet_vs: folds 
stucjones: folds 
mecha0117: calls $0.90
*** FLOP *** [4s 9d 9h]
mecha0117: checks 
CallLightning: checks 
*** TURN *** [4s 9d 9h] [Td]
mecha0117: bets $1.36
CallLightning: calls $1.36
*** RIVER *** [4s 9d 9h Td] [5h]
mecha0117: checks 
CallLightning: checks 
*** SHOW DOWN ***
mecha0117: shows [Jc Jh] (two pair, Jacks and Nines)
CallLightning: mucks hand 
mecha0117 collected $5.32 from pot
*** SUMMARY ***
Total pot $5.57 | Rake $0.25 
Board [4s 9d 9h Td 5h]
Seat 2: ahmet_vs (big blind) folded before Flop
Seat 3: stucjones folded before Flop
Seat 4: mecha0117 showed [Jc Jh] and won ($5.32) with two pair, Jacks and Nines
Seat 5: CallLightning (button) mucked
Seat 6: Hamilton_TD (small blind) folded before Flop



PokerStars Hand #222960056640:  Hold'em No Limit ($0.05/$0.10 USD) - 2021/01/23 11:56:15 ET
Table 'Saito II' 6-max Seat #6 is the button
Seat 2: ahmet_vs ($10 in chips) 
Seat 3: stucjones ($5.15 in chips) 
Seat 4: mecha0117 ($28.45 in chips) 
Seat 5: CallLightning ($8.12 in chips) 
Seat 6: Hamilton_TD ($11.14 in chips) 
ahmet_vs: posts small blind $0.05
stucjones: posts big blind $0.10
*** HOLE CARDS ***
mecha0117: folds 
katalloo leaves the table
CallLightning: raises $0.20 to $0.30
Hamilton_TD: folds 
ahmet_vs: folds 
stucjones: folds 
Uncalled bet ($0.20) returned to CallLightning
CallLightning collected $0.25 from pot
CallLightning: doesn't show hand 
*** SUMMARY ***
Total pot $0.25 | Rake $0 
Seat 2: ahmet_vs (small blind) folded before Flop
Seat 3: stucjones (big blind) folded before Flop
Seat 4: mecha0117 folded before Flop (didn't bet)
Seat 5: CallLightning collected ($0.25)
Seat 6: Hamilton_TD (button) folded before Flop (didn't bet)



PokerStars Hand #222960062509:  Hold'em No Limit ($0.05/$0.10 USD) - 2021/01/23 11:56:27 ET
Table 'Saito II' 6-max Seat #2 is the button
Seat 2: ahmet_vs ($10 in chips) 
Seat 3: stucjones ($5.05 in chips) 
Seat 4: mecha0117 ($28.45 in chips) 
Seat 5: CallLightning ($8.27 in chips) 
Seat 6: Hamilton_TD ($11.14 in chips) 
stucjones: posts small blind $0.05
mecha0117: posts big blind $0.10
*** HOLE CARDS ***
CallLightning: folds 
Hamilton_TD: folds 
ahmet_vs: folds 
stucjones: raises $0.20 to $0.30
iansuf joins the table at seat #1 
mecha0117: calls $0.20
*** FLOP *** [Jd 8s Ah]
stucjones: bets $0.20
mecha0117: calls $0.20
*** TURN *** [Jd 8s Ah] [Qh]
stucjones: bets $0.20
mecha0117: raises $1 to $1.20
stucjones: folds 
Uncalled bet ($1) returned to mecha0117
mecha0117 collected $1.34 from pot
mecha0117: doesn't show hand 
*** SUMMARY ***
Total pot $1.40 | Rake $0.06 
Board [Jd 8s Ah Qh]
Seat 2: ahmet_vs (button) folded before Flop (didn't bet)
Seat 3: stucjones (small blind) folded on the Turn
Seat 4: mecha0117 (big blind) collected ($1.34)
Seat 5: CallLightning folded before Flop (didn't bet)
Seat 6: Hamilton_TD folded before Flop (didn't bet)



PokerStars Hand #222960080724:  Hold'em No Limit ($0.05/$0.10 USD) - 2021/01/23 11:57:07 ET
Table 'Saito II' 6-max Seat #3 is the button
Seat 1: iansuf ($10 in chips) 
Seat 2: ahmet_vs ($10 in chips) 
Seat 3: stucjones ($4.35 in chips) 
Seat 4: mecha0117 ($29.09 in chips) 
Seat 5: CallLightning ($8.27 in chips) 
Seat 6: Hamilton_TD ($11.14 in chips) 
mecha0117: posts small blind $0.05
CallLightning: posts big blind $0.10
iansuf: posts big blind $0.10
*** HOLE CARDS ***
Hamilton_TD: folds 
iansuf: raises $0.10 to $0.20
ahmet_vs: folds 
stucjones: folds 
mecha0117: folds 
CallLightning: calls $0.10
*** FLOP *** [9s 8s Jc]
CallLightning: checks 
iansuf: bets $0.40
CallLightning: folds 
Uncalled bet ($0.40) returned to iansuf
iansuf collected $0.43 from pot
iansuf: doesn't show hand 
*** SUMMARY ***
Total pot $0.45 | Rake $0.02 
Board [9s 8s Jc]
Seat 1: iansuf collected ($0.43)
Seat 2: ahmet_vs folded before Flop (didn't bet)
Seat 3: stucjones (button) folded before Flop (didn't bet)
Seat 4: mecha0117 (small blind) folded before Flop
Seat 5: CallLightning (big blind) folded on the Flop
Seat 6: Hamilton_TD folded before Flop (didn't bet)



PokerStars Hand #222960099508:  Hold'em No Limit ($0.05/$0.10 USD) - 2021/01/23 11:57:47 ET
Table 'Saito II' 6-max Seat #4 is the button
Seat 1: iansuf ($10.23 in chips) 
Seat 2: ahmet_vs ($10 in chips) 
Seat 3: stucjones ($4.35 in chips) 
Seat 4: mecha0117 ($29.04 in chips) 
Seat 5: CallLightning ($8.07 in chips) 
Seat 6: Hamilton_TD ($11.14 in chips) 
CallLightning: posts small blind $0.05
Hamilton_TD: posts big blind $0.10
*** HOLE CARDS ***
iansuf: raises $0.10 to $0.20
ahmet_vs: folds 
stucjones: calls $0.20
mecha0117: folds 
CallLightning: calls $0.15
Hamilton_TD: folds 
*** FLOP *** [9c 4h Jc]
CallLightning: checks 
iansuf: bets $0.60
stucjones: calls $0.60
CallLightning: calls $0.60
*** TURN *** [9c 4h Jc] [6s]
CallLightning: checks 
iansuf: bets $3
stucjones: folds 
CallLightning: calls $3
*** RIVER *** [9c 4h Jc 6s] [3d]
CallLightning: checks 
iansuf: bets $3
CallLightning: folds 
Uncalled bet ($3) returned to iansuf
iansuf collected $8.12 from pot
iansuf: doesn't show hand 
*** SUMMARY ***
Total pot $8.50 | Rake $0.38 
Board [9c 4h Jc 6s 3d]
Seat 1: iansuf collected ($8.12)
Seat 2: ahmet_vs folded before Flop (didn't bet)
Seat 3: stucjones folded on the Turn
Seat 4: mecha0117 (button) folded before Flop (didn't bet)
Seat 5: CallLightning (small blind) folded on the River
Seat 6: Hamilton_TD (big blind) folded before Flop



PokerStars Hand #222960122675:  Hold'em No Limit ($0.05/$0.10 USD) - 2021/01/23 11:58:36 ET
Table 'Saito II' 6-max Seat #5 is the button
Seat 1: iansuf ($14.55 in chips) 
Seat 2: ahmet_vs ($10 in chips) 
Seat 3: stucjones ($3.55 in chips) 
Seat 4: mecha0117 ($29.04 in chips) 
Seat 5: CallLightning ($4.27 in chips) 
Seat 6: Hamilton_TD ($11.04 in chips) 
Hamilton_TD: posts small blind $0.05
iansuf: posts big blind $0.10
*** HOLE CARDS ***
ahmet_vs: folds 
stucjones: raises $0.10 to $0.20
mecha0117: folds 
CallLightning: calls $0.20
Hamilton_TD: folds 
iansuf: folds 
*** FLOP *** [5d Ac Qd]
stucjones: checks 
CallLightning: checks 
*** TURN *** [5d Ac Qd] [4c]
stucjones: bets $0.20
CallLightning: raises $0.60 to $0.80
stucjones: calls $0.60
*** RIVER *** [5d Ac Qd 4c] [7h]
stucjones: checks 
CallLightning: bets $3.27 and is all-in
stucjones: calls $2.55 and is all-in
Uncalled bet ($0.72) returned to CallLightning
*** SHOW DOWN ***
CallLightning: shows [Ah 4s] (two pair, Aces and Fours)
stucjones: shows [Ad Kh] (a pair of Aces)
CallLightning collected $6.92 from pot
*** SUMMARY ***
Total pot $7.25 | Rake $0.33 
Board [5d Ac Qd 4c 7h]
Seat 1: iansuf (big blind) folded before Flop
Seat 2: ahmet_vs folded before Flop (didn't bet)
Seat 3: stucjones showed [Ad Kh] and lost with a pair of Aces
Seat 4: mecha0117 folded before Flop (didn't bet)
Seat 5: CallLightning (button) showed [Ah 4s] and won ($6.92) with two pair, Aces and Fours
Seat 6: Hamilton_TD (small blind) folded before Flop



PokerStars Hand #222960138682:  Hold'em No Limit ($0.05/$0.10 USD) - 2021/01/23 11:59:09 ET
Table 'Saito II' 6-max Seat #6 is the button
Seat 1: iansuf ($14.45 in chips) 
Seat 2: ahmet_vs ($10 in chips) 
Seat 4: mecha0117 ($29.04 in chips) 
Seat 5: CallLightning ($7.64 in chips) 
Seat 6: Hamilton_TD ($10.99 in chips) 
iansuf: posts small blind $0.05
ahmet_vs: posts big blind $0.10
*** HOLE CARDS ***
mecha0117: folds 
CallLightning: folds 
Hamilton_TD: folds 
iansuf: calls $0.05
ahmet_vs: checks 
*** FLOP *** [Th 6d Qs]
iansuf: checks 
ahmet_vs: bets $0.10
iansuf: folds 
Uncalled bet ($0.10) returned to ahmet_vs
ahmet_vs collected $0.19 from pot
ahmet_vs: doesn't show hand 
*** SUMMARY ***
Total pot $0.20 | Rake $0.01 
Board [Th 6d Qs]
Seat 1: iansuf (small blind) folded on the Flop
Seat 2: ahmet_vs (big blind) collected ($0.19)
Seat 4: mecha0117 folded before Flop (didn't bet)
Seat 5: CallLightning folded before Flop (didn't bet)
Seat 6: Hamilton_TD (button) folded before Flop (didn't bet)



PokerStars Hand #222960154084:  Hold'em No Limit ($0.05/$0.10 USD) - 2021/01/23 11:59:42 ET
Table 'Saito II' 6-max Seat #1 is the button
Seat 1: iansuf ($14.35 in chips) 
Seat 2: ahmet_vs ($10.09 in chips) 
Seat 4: mecha0117 ($29.04 in chips) 
Seat 5: CallLightning ($7.64 in chips) 
Seat 6: Hamilton_TD ($10.99 in chips) 
ahmet_vs: posts small blind $0.05
mecha0117: posts big blind $0.10
*** HOLE CARDS ***
CallLightning: folds 
Hamilton_TD: raises $0.20 to $0.30
iansuf: folds 
ahmet_vs: raises $0.80 to $1.10
mecha0117: folds 
Hamilton_TD: folds 
Uncalled bet ($0.80) returned to ahmet_vs
ahmet_vs collected $0.70 from pot
ahmet_vs: doesn't show hand 
*** SUMMARY ***
Total pot $0.70 | Rake $0 
Seat 1: iansuf (button) folded before Flop (didn't bet)
Seat 2: ahmet_vs (small blind) collected ($0.70)
Seat 4: mecha0117 (big blind) folded before Flop
Seat 5: CallLightning folded before Flop (didn't bet)
Seat 6: Hamilton_TD folded before Flop



PokerStars Hand #222960166730:  Hold'em No Limit ($0.05/$0.10 USD) - 2021/01/23 12:00:08 ET
Table 'Saito II' 6-max Seat #2 is the button
Seat 1: iansuf ($14.35 in chips) 
Seat 2: ahmet_vs ($10.49 in chips) 
Seat 4: mecha0117 ($28.94 in chips) 
Seat 5: CallLightning ($7.64 in chips) 
Seat 6: Hamilton_TD ($10.69 in chips) 
mecha0117: posts small blind $0.05
CallLightning: posts big blind $0.10
*** HOLE CARDS ***
Hamilton_TD: folds 
iansuf: raises $0.10 to $0.20
ahmet_vs: raises $0.50 to $0.70
mecha0117: folds 
CallLightning: folds 
iansuf: folds 
Uncalled bet ($0.50) returned to ahmet_vs
ahmet_vs collected $0.55 from pot
ahmet_vs: doesn't show hand 
*** SUMMARY ***
Total pot $0.55 | Rake $0 
Seat 1: iansuf folded before Flop
Seat 2: ahmet_vs (button) collected ($0.55)
Seat 4: mecha0117 (small blind) folded before Flop
Seat 5: CallLightning (big blind) folded before Flop
Seat 6: Hamilton_TD folded before Flop (didn't bet)



PokerStars Hand #222960179799:  Hold'em No Limit ($0.05/$0.10 USD) - 2021/01/23 12:00:34 ET
Table 'Saito II' 6-max Seat #4 is the button
Seat 1: iansuf ($14.15 in chips) 
Seat 2: ahmet_vs ($10.84 in chips) 
Seat 4: mecha0117 ($28.89 in chips) 
Seat 5: CallLightning ($7.54 in chips) 
Seat 6: Hamilton_TD ($10.69 in chips) 
CallLightning: posts small blind $0.05
Hamilton_TD: posts big blind $0.10
*** HOLE CARDS ***
iansuf: folds 
ahmet_vs: folds 
stucjones leaves the table
mecha0117: raises $0.20 to $0.30
CallLightning: raises $0.60 to $0.90
DimaLesnoy joins the table at seat #3 
Hamilton_TD: folds 
mecha0117: folds 
Uncalled bet ($0.60) returned to CallLightning
CallLightning collected $0.70 from pot
CallLightning: doesn't show hand 
*** SUMMARY ***
Total pot $0.70 | Rake $0 
Seat 1: iansuf folded before Flop (didn't bet)
Seat 2: ahmet_vs folded before Flop (didn't bet)
Seat 4: mecha0117 (button) folded before Flop
Seat 5: CallLightning (small blind) collected ($0.70)
Seat 6: Hamilton_TD (big blind) folded before Flop



PokerStars Hand #222960200961:  Hold'em No Limit ($0.05/$0.10 USD) - 2021/01/23 12:00:59 ET
Table 'Saito II' 6-max Seat #5 is the button
Seat 1: iansuf ($14.15 in chips) 
Seat 2: ahmet_vs ($10.84 in chips) 
Seat 4: mecha0117 ($28.59 in chips) 
Seat 5: CallLightning ($7.94 in chips) 
Seat 6: Hamilton_TD ($10.59 in chips) 
Hamilton_TD: posts small blind $0.05
iansuf: posts big blind $0.10
DimaLesnoy: sits out 
*** HOLE CARDS ***
ahmet_vs: folds 
mecha0117: folds 
CallLightning: folds 
Hamilton_TD: folds 
Uncalled bet ($0.05) returned to iansuf
iansuf collected $0.10 from pot
iansuf: doesn't show hand 
*** SUMMARY ***
Total pot $0.10 | Rake $0 
Seat 1: iansuf (big blind) collected ($0.10)
Seat 2: ahmet_vs folded before Flop (didn't bet)
Seat 4: mecha0117 folded before Flop (didn't bet)
Seat 5: CallLightning (button) folded before Flop (didn't bet)
Seat 6: Hamilton_TD (small blind) folded before Flop



PokerStars Hand #222960210203:  Hold'em No Limit ($0.05/$0.10 USD) - 2021/01/23 12:01:15 ET
Table 'Saito II' 6-max Seat #6 is the button
Seat 1: iansuf ($14.20 in chips) 
Seat 2: ahmet_vs ($10.84 in chips) 
Seat 4: mecha0117 ($28.59 in chips) 
Seat 5: CallLightning ($7.94 in chips) 
Seat 6: Hamilton_TD ($10.54 in chips) 
iansuf: posts small blind $0.05
ahmet_vs: posts big blind $0.10
DimaLesnoy: sits out 
*** HOLE CARDS ***
mecha0117: folds 
CallLightning: raises $0.20 to $0.30
Hamilton_TD: calls $0.30
iansuf: folds 
ahmet_vs: folds 
*** FLOP *** [3h Th 7c]
CallLightning: bets $0.30
Hamilton_TD: calls $0.30
*** TURN *** [3h Th 7c] [Kc]
CallLightning: bets $1.40
Hamilton_TD: raises $8.54 to $9.94 and is all-in
CallLightning: calls $5.94 and is all-in
Uncalled bet ($2.60) returned to Hamilton_TD
*** RIVER *** [3h Th 7c Kc] [6h]
*** SHOW DOWN ***
CallLightning: shows [9c Jc] (high card King)
Hamilton_TD: shows [Ks 7s] (two pair, Kings and Sevens)
Hamilton_TD collected $15.31 from pot
*** SUMMARY ***
Total pot $16.03 | Rake $0.72 
Board [3h Th 7c Kc 6h]
Seat 1: iansuf (small blind) folded before Flop
Seat 2: ahmet_vs (big blind) folded before Flop
Seat 4: mecha0117 folded before Flop (didn't bet)
Seat 5: CallLightning showed [9c Jc] and lost with high card King
Seat 6: Hamilton_TD (button) showed [Ks 7s] and won ($15.31) with two pair, Kings and Sevens



PokerStars Hand #222960235619:  Hold'em No Limit ($0.05/$0.10 USD) - 2021/01/23 12:01:58 ET
Table 'Saito II' 6-max Seat #1 is the button
Seat 1: iansuf ($14.15 in chips) 
Seat 2: ahmet_vs ($10.74 in chips) 
Seat 3: DimaLesnoy ($10 in chips) 
Seat 4: mecha0117 ($28.59 in chips) 
Seat 6: Hamilton_TD ($17.91 in chips) 
ahmet_vs: posts small blind $0.05
DimaLesnoy: posts big blind $0.10
*** HOLE CARDS ***
CallLightning leaves the table
mecha0117: folds 
Hamilton_TD: folds 
iansuf: raises $0.20 to $0.30
ahmet_vs: folds 
DimaLesnoy: folds 
Uncalled bet ($0.20) returned to iansuf
iansuf collected $0.25 from pot
iansuf: doesn't show hand 
*** SUMMARY ***
Total pot $0.25 | Rake $0 
Seat 1: iansuf (button) collected ($0.25)
Seat 2: ahmet_vs (small blind) folded before Flop
Seat 3: DimaLesnoy (big blind) folded before Flop
Seat 4: mecha0117 folded before Flop (didn't bet)
Seat 6: Hamilton_TD folded before Flop (didn't bet)



PokerStars Hand #222960244382:  Hold'em No Limit ($0.05/$0.10 USD) - 2021/01/23 12:02:12 ET
Table 'Saito II' 6-max Seat #2 is the button
Seat 1: iansuf ($14.30 in chips) 
Seat 2: ahmet_vs ($10.69 in chips) 
Seat 3: DimaLesnoy ($10 in chips) 
Seat 4: mecha0117 ($28.59 in chips) 
Seat 6: Hamilton_TD ($17.91 in chips) 
DimaLesnoy: posts small blind $0.05
mecha0117: posts big blind $0.10
*** HOLE CARDS ***
Hamilton_TD: folds 
pudge.3096 joins the table at seat #5 
iansuf: folds 
ahmet_vs: folds 
DimaLesnoy: folds 
Uncalled bet ($0.05) returned to mecha0117
mecha0117 collected $0.10 from pot
mecha0117: doesn't show hand 
*** SUMMARY ***
Total pot $0.10 | Rake $0 
Seat 1: iansuf folded before Flop (didn't bet)
Seat 2: ahmet_vs (button) folded before Flop (didn't bet)
Seat 3: DimaLesnoy (small blind) folded before Flop
Seat 4: mecha0117 (big blind) collected ($0.10)
Seat 6: Hamilton_TD folded before Flop (didn't bet)



PokerStars Hand #222960250635:  Hold'em No Limit ($0.05/$0.10 USD) - 2021/01/23 12:02:23 ET
Table 'Saito II' 6-max Seat #3 is the button
Seat 1: iansuf ($14.30 in chips) 
Seat 2: ahmet_vs ($10.69 in chips) 
Seat 3: DimaLesnoy ($10 in chips) 
Seat 4: mecha0117 ($28.64 in chips) 
Seat 5: pudge.3096 ($10 in chips) 
Seat 6: Hamilton_TD ($17.91 in chips) 
mecha0117: posts small blind $0.05
pudge.3096: posts big blind $0.10
*** HOLE CARDS ***
Hamilton_TD: raises $0.20 to $0.30
iansuf: calls $0.30
ahmet_vs: folds 
DimaLesnoy: folds 
mecha0117: folds 
pudge.3096: folds 
*** FLOP *** [7s As Qs]
Hamilton_TD: bets $0.45
iansuf: folds 
Uncalled bet ($0.45) returned to Hamilton_TD
Hamilton_TD collected $0.72 from pot
*** SUMMARY ***
Total pot $0.75 | Rake $0.03 
Board [7s As Qs]
Seat 1: iansuf folded on the Flop
Seat 2: ahmet_vs folded before Flop (didn't bet)
Seat 3: DimaLesnoy (button) folded before Flop (didn't bet)
Seat 4: mecha0117 (small blind) folded before Flop
Seat 5: pudge.3096 (big blind) folded before Flop
Seat 6: Hamilton_TD collected ($0.72)



PokerStars Hand #222960269972:  Hold'em No Limit ($0.05/$0.10 USD) - 2021/01/23 12:02:54 ET
Table 'Saito II' 6-max Seat #4 is the button
Seat 1: iansuf ($14 in chips) 
Seat 2: ahmet_vs ($10.69 in chips) 
Seat 3: DimaLesnoy ($10 in chips) 
Seat 4: mecha0117 ($28.59 in chips) 
Seat 5: pudge.3096 ($10 in chips) 
Seat 6: Hamilton_TD ($18.33 in chips) 
pudge.3096: posts small blind $0.05
Hamilton_TD: posts big blind $0.10
*** HOLE CARDS ***
iansuf: calls $0.10
ahmet_vs: folds 
DimaLesnoy: folds 
mecha0117: folds 
pudge.3096: raises $0.40 to $0.50
Hamilton_TD: folds 
iansuf: raises $1 to $1.50
pudge.3096: folds 
Uncalled bet ($1) returned to iansuf
iansuf collected $1.10 from pot
iansuf: doesn't show hand 
*** SUMMARY ***
Total pot $1.10 | Rake $0 
Seat 1: iansuf collected ($1.10)
Seat 2: ahmet_vs folded before Flop (didn't bet)
Seat 3: DimaLesnoy folded before Flop (didn't bet)
Seat 4: mecha0117 (button) folded before Flop (didn't bet)
Seat 5: pudge.3096 (small blind) folded before Flop
Seat 6: Hamilton_TD (big blind) folded before Flop



PokerStars Hand #222960285599:  Hold'em No Limit ($0.05/$0.10 USD) - 2021/01/23 12:03:19 ET
Table 'Saito II' 6-max Seat #5 is the button
Seat 1: iansuf ($14.60 in chips) 
Seat 2: ahmet_vs ($10.69 in chips) 
Seat 3: DimaLesnoy ($10 in chips) 
Seat 4: mecha0117 ($28.59 in chips) 
Seat 5: pudge.3096 ($10 in chips) 
Seat 6: Hamilton_TD ($18.23 in chips) 
Hamilton_TD: posts small blind $0.05
iansuf: posts big blind $0.10
*** HOLE CARDS ***
ahmet_vs: folds 
DimaLesnoy: folds 
mecha0117: folds 
pudge.3096: raises $0.15 to $0.25
Hamilton_TD: raises $0.75 to $1
iansuf: folds 
pudge.3096: calls $0.75
*** FLOP *** [2s Jc Jd]
Hamilton_TD: bets $0.70
pudge.3096: calls $0.70
*** TURN *** [2s Jc Jd] [Ac]
Hamilton_TD: bets $1.17
pudge.3096: folds 
Uncalled bet ($1.17) returned to Hamilton_TD
Hamilton_TD collected $3.34 from pot
*** SUMMARY ***
Total pot $3.50 | Rake $0.16 
Board [2s Jc Jd Ac]
Seat 1: iansuf (big blind) folded before Flop
Seat 2: ahmet_vs folded before Flop (didn't bet)
Seat 3: DimaLesnoy folded before Flop (didn't bet)
Seat 4: mecha0117 folded before Flop (didn't bet)
Seat 5: pudge.3096 (button) folded on the Turn
Seat 6: Hamilton_TD (small blind) collected ($3.34)



PokerStars Hand #222960307544:  Hold'em No Limit ($0.05/$0.10 USD) - 2021/01/23 12:03:54 ET
Table 'Saito II' 6-max Seat #6 is the button
Seat 1: iansuf ($14.50 in chips) 
Seat 2: ahmet_vs ($10.69 in chips) 
Seat 3: DimaLesnoy ($10 in chips) 
Seat 4: mecha0117 ($28.59 in chips) 
Seat 5: pudge.3096 ($10 in chips) 
Seat 6: Hamilton_TD ($19.87 in chips) 
iansuf: posts small blind $0.05
ahmet_vs: posts big blind $0.10
*** HOLE CARDS ***
DimaLesnoy: folds 
mecha0117: raises $0.10 to $0.20
pudge.3096: folds 
Hamilton_TD: folds 
iansuf: calls $0.15
ahmet_vs: raises $1 to $1.20
mecha0117: folds 
iansuf: folds 
Uncalled bet ($1) returned to ahmet_vs
ahmet_vs collected $0.60 from pot
ahmet_vs: doesn't show hand 
*** SUMMARY ***
Total pot $0.60 | Rake $0 
Seat 1: iansuf (small blind) folded before Flop
Seat 2: ahmet_vs (big blind) collected ($0.60)
Seat 3: DimaLesnoy folded before Flop (didn't bet)
Seat 4: mecha0117 folded before Flop
Seat 5: pudge.3096 folded before Flop (didn't bet)
Seat 6: Hamilton_TD (button) folded before Flop (didn't bet)



PokerStars Hand #222960328530:  Hold'em No Limit ($0.05/$0.10 USD) - 2021/01/23 12:04:27 ET
Table 'Saito II' 6-max Seat #1 is the button
Seat 1: iansuf ($14.30 in chips) 
Seat 2: ahmet_vs ($11.09 in chips) 
Seat 3: DimaLesnoy ($10 in chips) 
Seat 4: mecha0117 ($28.39 in chips) 
Seat 5: pudge.3096 ($10 in chips) 
Seat 6: Hamilton_TD ($19.87 in chips) 
ahmet_vs: posts small blind $0.05
DimaLesnoy: posts big blind $0.10
*** HOLE CARDS ***
mecha0117: raises $0.10 to $0.20
pudge.3096: folds 
Hamilton_TD: calls $0.20
iansuf: folds 
iansuf leaves the table
Dosa994 joins the table at seat #1 
ahmet_vs: folds 
DimaLesnoy: folds 
*** FLOP *** [6c 6s Td]
mecha0117: checks 
Hamilton_TD: checks 
*** TURN *** [6c 6s Td] [Ks]
mecha0117: checks 
Hamilton_TD: checks 
*** RIVER *** [6c 6s Td Ks] [8h]
mecha0117: bets $0.26
Hamilton_TD: calls $0.26
*** SHOW DOWN ***
mecha0117: shows [Ts 9s] (two pair, Tens and Sixes)
Hamilton_TD: shows [Jc Kh] (two pair, Kings and Sixes)
Hamilton_TD collected $1.02 from pot
*** SUMMARY ***
Total pot $1.07 | Rake $0.05 
Board [6c 6s Td Ks 8h]
Seat 1: iansuf (button) folded before Flop (didn't bet)
Seat 2: ahmet_vs (small blind) folded before Flop
Seat 3: DimaLesnoy (big blind) folded before Flop
Seat 4: mecha0117 showed [Ts 9s] and lost with two pair, Tens and Sixes
Seat 5: pudge.3096 folded before Flop (didn't bet)
Seat 6: Hamilton_TD showed [Jc Kh] and won ($1.02) with two pair, Kings and Sixes



PokerStars Hand #222960361847:  Hold'em No Limit ($0.05/$0.10 USD) - 2021/01/23 12:05:20 ET
Table 'Saito II' 6-max Seat #2 is the button
Seat 2: ahmet_vs ($11.04 in chips) 
Seat 3: DimaLesnoy ($10 in chips) 
Seat 4: mecha0117 ($27.93 in chips) 
Seat 5: pudge.3096 ($10 in chips) 
Seat 6: Hamilton_TD ($20.43 in chips) 
DimaLesnoy: posts small blind $0.05
mecha0117: posts big blind $0.10
Dosa994: sits out 
*** HOLE CARDS ***
pudge.3096: folds 
Hamilton_TD: folds 
ahmet_vs: raises $0.15 to $0.25
DimaLesnoy: folds 
mecha0117: folds 
Uncalled bet ($0.15) returned to ahmet_vs
ahmet_vs collected $0.25 from pot
ahmet_vs: doesn't show hand 
*** SUMMARY ***
Total pot $0.25 | Rake $0 
Seat 2: ahmet_vs (button) collected ($0.25)
Seat 3: DimaLesnoy (small blind) folded before Flop
Seat 4: mecha0117 (big blind) folded before Flop
Seat 5: pudge.3096 folded before Flop (didn't bet)
Seat 6: Hamilton_TD folded before Flop (didn't bet)



PokerStars Hand #222960383572:  Hold'em No Limit ($0.05/$0.10 USD) - 2021/01/23 12:05:55 ET
Table 'Saito II' 6-max Seat #3 is the button
Seat 2: ahmet_vs ($11.19 in chips) 
Seat 3: DimaLesnoy ($10 in chips) 
Seat 4: mecha0117 ($27.83 in chips) 
Seat 5: pudge.3096 ($10 in chips) 
Seat 6: Hamilton_TD ($20.43 in chips) 
mecha0117: posts small blind $0.05
pudge.3096: posts big blind $0.10
Dosa994: sits out 
*** HOLE CARDS ***
Hamilton_TD: folds 
ahmet_vs: folds 
DimaLesnoy has timed out
DimaLesnoy: folds 
mecha0117: raises $0.20 to $0.30
pudge.3096: folds 
Uncalled bet ($0.20) returned to mecha0117
mecha0117 collected $0.20 from pot
mecha0117: doesn't show hand 
*** SUMMARY ***
Total pot $0.20 | Rake $0 
Seat 2: ahmet_vs folded before Flop (didn't bet)
Seat 3: DimaLesnoy (button) folded before Flop (didn't bet)
Seat 4: mecha0117 (small blind) collected ($0.20)
Seat 5: pudge.3096 (big blind) folded before Flop
Seat 6: Hamilton_TD folded before Flop (didn't bet)



PokerStars Hand #222960400262:  Hold'em No Limit ($0.05/$0.10 USD) - 2021/01/23 12:06:21 ET
Table 'Saito II' 6-max Seat #4 is the button
Seat 2: ahmet_vs ($11.19 in chips) 
Seat 4: mecha0117 ($27.93 in chips) 
Seat 5: pudge.3096 ($10 in chips) 
Seat 6: Hamilton_TD ($20.43 in chips) 
pudge.3096: posts small blind $0.05
Hamilton_TD: posts big blind $0.10
Dosa994: sits out 
*** HOLE CARDS ***
ahmet_vs: folds 
mecha0117 has timed out
mecha0117: folds 
pudge.3096: raises $0.15 to $0.25
Hamilton_TD: calls $0.15
*** FLOP *** [2s 5c 2c]
pudge.3096: bets $0.15
Hamilton_TD: calls $0.15
*** TURN *** [2s 5c 2c] [6s]
pudge.3096: checks 
Hamilton_TD: bets $0.40
pudge.3096: calls $0.40
*** RIVER *** [2s 5c 2c 6s] [Qh]
pudge.3096: checks 
Hamilton_TD: bets $1.10
pudge.3096: folds 
Uncalled bet ($1.10) returned to Hamilton_TD
Hamilton_TD collected $1.53 from pot
*** SUMMARY ***
Total pot $1.60 | Rake $0.07 
Board [2s 5c 2c 6s Qh]
Seat 2: ahmet_vs folded before Flop (didn't bet)
Seat 4: mecha0117 (button) folded before Flop (didn't bet)
Seat 5: pudge.3096 (small blind) folded on the River
Seat 6: Hamilton_TD (big blind) collected ($1.53)



PokerStars Hand #222960436220:  Hold'em No Limit ($0.05/$0.10 USD) - 2021/01/23 12:07:18 ET
Table 'Saito II' 6-max Seat #5 is the button
Seat 1: Dosa994 ($8 in chips) 
Seat 2: ahmet_vs ($11.19 in chips) 
Seat 3: DimaLesnoy ($10 in chips) 
Seat 4: mecha0117 ($27.93 in chips) 
Seat 5: pudge.3096 ($10 in chips) 
Seat 6: Hamilton_TD ($21.16 in chips) 
Hamilton_TD: posts small blind $0.05
Dosa994: posts big blind $0.10
*** HOLE CARDS ***
ahmet_vs: folds 
DimaLesnoy: folds 
mecha0117: folds 
pudge.3096: raises $0.15 to $0.25
Hamilton_TD: folds 
Dosa994: folds 
Uncalled bet ($0.15) returned to pudge.3096
pudge.3096 collected $0.25 from pot
pudge.3096: doesn't show hand 
*** SUMMARY ***
Total pot $0.25 | Rake $0 
Seat 1: Dosa994 (big blind) folded before Flop
Seat 2: ahmet_vs folded before Flop (didn't bet)
Seat 3: DimaLesnoy folded before Flop (didn't bet)
Seat 4: mecha0117 folded before Flop (didn't bet)
Seat 5: pudge.3096 (button) collected ($0.25)
Seat 6: Hamilton_TD (small blind) folded before Flop



PokerStars Hand #222960444178:  Hold'em No Limit ($0.05/$0.10 USD) - 2021/01/23 12:07:30 ET
Table 'Saito II' 6-max Seat #6 is the button
Seat 1: Dosa994 ($7.90 in chips) 
Seat 3: DimaLesnoy ($10 in chips) 
Seat 4: mecha0117 ($27.93 in chips) 
Seat 5: pudge.3096 ($10.15 in chips) 
Seat 6: Hamilton_TD ($21.11 in chips) 
Dosa994: posts small blind $0.05
ahmet_vs: is sitting out 
DimaLesnoy: posts big blind $0.10
*** HOLE CARDS ***
ahmet_vs leaves the table
mecha0117: folds 
pudge.3096: folds 
Hamilton_TD: folds 
Dosa994: calls $0.05
pudge.3096 leaves the table
DimaLesnoy: checks 
*** FLOP *** [5d As 4s]
densamara_63 joins the table at seat #2 
Dosa994: bets $0.20
DimaLesnoy: folds 
Uncalled bet ($0.20) returned to Dosa994
Dosa994 collected $0.19 from pot
Dosa994: doesn't show hand 
*** SUMMARY ***
Total pot $0.20 | Rake $0.01 
Board [5d As 4s]
Seat 1: Dosa994 (small blind) collected ($0.19)
Seat 3: DimaLesnoy (big blind) folded on the Flop
Seat 4: mecha0117 folded before Flop (didn't bet)
Seat 5: pudge.3096 folded before Flop (didn't bet)
Seat 6: Hamilton_TD (button) folded before Flop (didn't bet)



PokerStars Hand #222960461535:  Hold'em No Limit ($0.05/$0.10 USD) - 2021/01/23 12:07:58 ET
Table 'Saito II' 6-max Seat #1 is the button
Seat 1: Dosa994 ($7.99 in chips) 
Seat 3: DimaLesnoy ($10 in chips) 
Seat 4: mecha0117 ($27.93 in chips) 
Seat 6: Hamilton_TD ($21.11 in chips) 
DimaLesnoy: posts small blind $0.05
mecha0117: posts big blind $0.10
*** HOLE CARDS ***
Hamilton_TD: folds 
Dosa994: calls $0.10
DimaLesnoy: folds 
mecha0117: checks 
*** FLOP *** [6h 5s Qd]
mecha0117: checks 
Dosa994: checks 
*** TURN *** [6h 5s Qd] [4s]
mecha0117: bets $0.24
Dosa994: folds 
Uncalled bet ($0.24) returned to mecha0117
mecha0117 collected $0.24 from pot
mecha0117: doesn't show hand 
*** SUMMARY ***
Total pot $0.25 | Rake $0.01 
Board [6h 5s Qd 4s]
Seat 1: Dosa994 (button) folded on the Turn
Seat 3: DimaLesnoy (small blind) folded before Flop
Seat 4: mecha0117 (big blind) collected ($0.24)
Seat 6: Hamilton_TD folded before Flop (didn't bet)



PokerStars Hand #222960479141:  Hold'em No Limit ($0.05/$0.10 USD) - 2021/01/23 12:08:26 ET
Table 'Saito II' 6-max Seat #3 is the button
Seat 1: Dosa994 ($7.89 in chips) 
Seat 3: DimaLesnoy ($10 in chips) 
Seat 4: mecha0117 ($28.07 in chips) 
Seat 6: Hamilton_TD ($21.11 in chips) 
mecha0117: posts small blind $0.05
Hamilton_TD: posts big blind $0.10
densamara_63: sits out 
*** HOLE CARDS ***
Dosa994: raises $0.10 to $0.20
DimaLesnoy: calls $0.20
mecha0117: folds 
Hamilton_TD: calls $0.10
*** FLOP *** [8s Jh 6c]
Hamilton_TD: checks 
Dosa994: checks 
DimaLesnoy: bets $0.27
Hamilton_TD: calls $0.27
Dosa994: folds 
*** TURN *** [8s Jh 6c] [As]
Hamilton_TD: checks 
dfranssens joins the table at seat #5 
DimaLesnoy: checks 
*** RIVER *** [8s Jh 6c As] [9h]
Hamilton_TD: checks 
DimaLesnoy: bets $0.81
Hamilton_TD: folds 
Uncalled bet ($0.81) returned to DimaLesnoy
DimaLesnoy collected $1.14 from pot
DimaLesnoy: doesn't show hand 
*** SUMMARY ***
Total pot $1.19 | Rake $0.05 
Board [8s Jh 6c As 9h]
Seat 1: Dosa994 folded on the Flop
Seat 3: DimaLesnoy (button) collected ($1.14)
Seat 4: mecha0117 (small blind) folded before Flop
Seat 6: Hamilton_TD (big blind) folded on the River



PokerStars Hand #222960510761:  Hold'em No Limit ($0.05/$0.10 USD) - 2021/01/23 12:09:16 ET
Table 'Saito II' 6-max Seat #4 is the button
Seat 1: Dosa994 ($7.69 in chips) 
Seat 3: DimaLesnoy ($10.67 in chips) 
Seat 4: mecha0117 ($28.02 in chips) 
Seat 6: Hamilton_TD ($20.64 in chips) 
Hamilton_TD: posts small blind $0.05
Dosa994: posts big blind $0.10
densamara_63: sits out 
*** HOLE CARDS ***
DimaLesnoy: folds 
mecha0117: folds 
Hamilton_TD: raises $0.15 to $0.25
Dosa994: folds 
Uncalled bet ($0.15) returned to Hamilton_TD
Hamilton_TD collected $0.20 from pot
*** SUMMARY ***
Total pot $0.20 | Rake $0 
Seat 1: Dosa994 (big blind) folded before Flop
Seat 3: DimaLesnoy folded before Flop (didn't bet)
Seat 4: mecha0117 (button) folded before Flop (didn't bet)
Seat 6: Hamilton_TD (small blind) collected ($0.20)



PokerStars Hand #222960516359:  Hold'em No Limit ($0.05/$0.10 USD) - 2021/01/23 12:09:25 ET
Table 'Saito II' 6-max Seat #6 is the button
Seat 1: Dosa994 ($7.59 in chips) 
Seat 2: densamara_63 ($10 in chips) 
Seat 3: DimaLesnoy ($10.67 in chips) 
Seat 4: mecha0117 ($28.02 in chips) 
Seat 6: Hamilton_TD ($20.74 in chips) 
Dosa994: posts small blind $0.05
densamara_63: posts big blind $0.10
dfranssens: sits out 
*** HOLE CARDS ***
DimaLesnoy: folds 
mecha0117: folds 
Hamilton_TD: folds 
Dosa994: calls $0.05
densamara_63: raises $0.20 to $0.30
Dosa994: folds 
Uncalled bet ($0.20) returned to densamara_63
densamara_63 collected $0.20 from pot
*** SUMMARY ***
Total pot $0.20 | Rake $0 
Seat 1: Dosa994 (small blind) folded before Flop
Seat 2: densamara_63 (big blind) collected ($0.20)
Seat 3: DimaLesnoy folded before Flop (didn't bet)
Seat 4: mecha0117 folded before Flop (didn't bet)
Seat 6: Hamilton_TD (button) folded before Flop (didn't bet)



PokerStars Hand #222960532686:  Hold'em No Limit ($0.05/$0.10 USD) - 2021/01/23 12:09:51 ET
Table 'Saito II' 6-max Seat #1 is the button
Seat 1: Dosa994 ($7.49 in chips) 
Seat 2: densamara_63 ($10.10 in chips) 
Seat 3: DimaLesnoy ($10.67 in chips) 
Seat 4: mecha0117 ($28.02 in chips) 
Seat 6: Hamilton_TD ($20.74 in chips) 
densamara_63: posts small blind $0.05
DimaLesnoy: posts big blind $0.10
dfranssens: sits out 
*** HOLE CARDS ***
mecha0117: folds 
Hamilton_TD: folds 
Dosa994: calls $0.10
densamara_63: raises $0.20 to $0.30
DimaLesnoy: folds 
Dosa994: folds 
Uncalled bet ($0.20) returned to densamara_63
densamara_63 collected $0.30 from pot
*** SUMMARY ***
Total pot $0.30 | Rake $0 
Seat 1: Dosa994 (button) folded before Flop
Seat 2: densamara_63 (small blind) collected ($0.30)
Seat 3: DimaLesnoy (big blind) folded before Flop
Seat 4: mecha0117 folded before Flop (didn't bet)
Seat 6: Hamilton_TD folded before Flop (didn't bet)



PokerStars Hand #222960543661:  Hold'em No Limit ($0.05/$0.10 USD) - 2021/01/23 12:10:08 ET
Table 'Saito II' 6-max Seat #2 is the button
Seat 1: Dosa994 ($7.39 in chips) 
Seat 2: densamara_63 ($10.30 in chips) 
Seat 3: DimaLesnoy ($10.57 in chips) 
Seat 4: mecha0117 ($28.02 in chips) 
Seat 6: Hamilton_TD ($20.74 in chips) 
DimaLesnoy: posts small blind $0.05
mecha0117: posts big blind $0.10
dfranssens: sits out 
*** HOLE CARDS ***
Hamilton_TD: folds 
Dosa994: folds 
densamara_63: raises $0.20 to $0.30
DimaLesnoy: folds 
mecha0117: calls $0.20
*** FLOP *** [7d 8c 7c]
mecha0117: checks 
densamara_63: bets $0.37
mecha0117: calls $0.37
*** TURN *** [7d 8c 7c] [5c]
mecha0117: checks 
densamara_63: bets $1.10
mecha0117: calls $1.10
*** RIVER *** [7d 8c 7c 5c] [7h]
mecha0117: checks 
densamara_63: checks 
*** SHOW DOWN ***
mecha0117: shows [3h Ac] (three of a kind, Sevens)
densamara_63: shows [2s As] (three of a kind, Sevens)
mecha0117 collected $1.72 from pot
densamara_63 collected $1.71 from pot
*** SUMMARY ***
Total pot $3.59 | Rake $0.16 
Board [7d 8c 7c 5c 7h]
Seat 1: Dosa994 folded before Flop (didn't bet)
Seat 2: densamara_63 (button) showed [2s As] and won ($1.71) with three of a kind, Sevens
Seat 3: DimaLesnoy (small blind) folded before Flop
Seat 4: mecha0117 (big blind) showed [3h Ac] and won ($1.72) with three of a kind, Sevens
Seat 6: Hamilton_TD folded before Flop (didn't bet)



PokerStars Hand #222960589245:  Hold'em No Limit ($0.05/$0.10 USD) - 2021/01/23 12:11:21 ET
Table 'Saito II' 6-max Seat #3 is the button
Seat 1: Dosa994 ($7.39 in chips) 
Seat 2: densamara_63 ($10.24 in chips) 
Seat 3: DimaLesnoy ($10.52 in chips) 
Seat 4: mecha0117 ($27.97 in chips) 
Seat 5: dfranssens ($8 in chips) 
Seat 6: Hamilton_TD ($20.74 in chips) 
mecha0117: posts small blind $0.05
dfranssens: posts big blind $0.10
*** HOLE CARDS ***
Hamilton_TD: folds 
Dosa994: calls $0.10
densamara_63: folds 
DimaLesnoy: folds 
mecha0117: calls $0.05
dfranssens: checks 
*** FLOP *** [7s Ac 2h]
mecha0117: bets $0.10
dfranssens: folds 
Dosa994: calls $0.10
*** TURN *** [7s Ac 2h] [Jh]
mecha0117: bets $0.24
Dosa994: calls $0.24
*** RIVER *** [7s Ac 2h Jh] [2d]
mecha0117: checks 
Dosa994: bets $0.40
mecha0117: calls $0.40
*** SHOW DOWN ***
Dosa994: shows [5d 7c] (two pair, Sevens and Deuces)
mecha0117: shows [9h Ah] (two pair, Aces and Deuces)
mecha0117 collected $1.70 from pot
*** SUMMARY ***
Total pot $1.78 | Rake $0.08 
Board [7s Ac 2h Jh 2d]
Seat 1: Dosa994 showed [5d 7c] and lost with two pair, Sevens and Deuces
Seat 2: densamara_63 folded before Flop (didn't bet)
Seat 3: DimaLesnoy (button) folded before Flop (didn't bet)
Seat 4: mecha0117 (small blind) showed [9h Ah] and won ($1.70) with two pair, Aces and Deuces
Seat 5: dfranssens (big blind) folded on the Flop
Seat 6: Hamilton_TD folded before Flop (didn't bet)



PokerStars Hand #222960614373:  Hold'em No Limit ($0.05/$0.10 USD) - 2021/01/23 12:12:00 ET
Table 'Saito II' 6-max Seat #4 is the button
Seat 1: Dosa994 ($6.55 in chips) 
Seat 2: densamara_63 ($10.24 in chips) 
Seat 3: DimaLesnoy ($10.52 in chips) 
Seat 4: mecha0117 ($28.83 in chips) 
Seat 5: dfranssens ($7.90 in chips) 
Seat 6: Hamilton_TD ($20.74 in chips) 
dfranssens: posts small blind $0.05
Hamilton_TD: posts big blind $0.10
*** HOLE CARDS ***
Dosa994: calls $0.10
densamara_63: folds 
DimaLesnoy: folds 
mecha0117: folds 
dfranssens: folds 
Hamilton_TD: checks 
*** FLOP *** [Ac 5h Kc]
Hamilton_TD: checks 
Dosa994: bets $0.20
Hamilton_TD: folds 
Uncalled bet ($0.20) returned to Dosa994
Dosa994 collected $0.24 from pot
Dosa994: doesn't show hand 
*** SUMMARY ***
Total pot $0.25 | Rake $0.01 
Board [Ac 5h Kc]
Seat 1: Dosa994 collected ($0.24)
Seat 2: densamara_63 folded before Flop (didn't bet)
Seat 3: DimaLesnoy folded before Flop (didn't bet)
Seat 4: mecha0117 (button) folded before Flop (didn't bet)
Seat 5: dfranssens (small blind) folded before Flop
Seat 6: Hamilton_TD (big blind) folded on the Flop



PokerStars Hand #222960629852:  Hold'em No Limit ($0.05/$0.10 USD) - 2021/01/23 12:12:25 ET
Table 'Saito II' 6-max Seat #5 is the button
Seat 1: Dosa994 ($6.69 in chips) 
Seat 2: densamara_63 ($10.24 in chips) 
Seat 3: DimaLesnoy ($10.52 in chips) 
Seat 4: mecha0117 ($28.83 in chips) 
Seat 5: dfranssens ($7.85 in chips) 
Seat 6: Hamilton_TD ($20.64 in chips) 
Hamilton_TD: posts small blind $0.05
Dosa994: posts big blind $0.10
*** HOLE CARDS ***
densamara_63: folds 
DimaLesnoy: folds 
mecha0117: folds 
dfranssens: raises $0.20 to $0.30
Hamilton_TD: folds 
Dosa994: calls $0.20
*** FLOP *** [8s 5d 8h]
Dosa994: bets $0.20
dfranssens: folds 
Uncalled bet ($0.20) returned to Dosa994
Dosa994 collected $0.62 from pot
Dosa994: doesn't show hand 
*** SUMMARY ***
Total pot $0.65 | Rake $0.03 
Board [8s 5d 8h]
Seat 1: Dosa994 (big blind) collected ($0.62)
Seat 2: densamara_63 folded before Flop (didn't bet)
Seat 3: DimaLesnoy folded before Flop (didn't bet)
Seat 4: mecha0117 folded before Flop (didn't bet)
Seat 5: dfranssens (button) folded on the Flop
Seat 6: Hamilton_TD (small blind) folded before Flop



PokerStars Hand #222960642884:  Hold'em No Limit ($0.05/$0.10 USD) - 2021/01/23 12:12:45 ET
Table 'Saito II' 6-max Seat #6 is the button
Seat 1: Dosa994 ($7.01 in chips) 
Seat 2: densamara_63 ($10.24 in chips) 
Seat 3: DimaLesnoy ($10.52 in chips) 
Seat 4: mecha0117 ($28.83 in chips) 
Seat 5: dfranssens ($7.55 in chips) 
Seat 6: Hamilton_TD ($20.59 in chips) 
Dosa994: posts small blind $0.05
densamara_63: posts big blind $0.10
*** HOLE CARDS ***
DimaLesnoy: raises $0.20 to $0.30
mecha0117: folds 
dfranssens: folds 
Hamilton_TD: folds 
Dosa994: folds 
densamara_63: folds 
Uncalled bet ($0.20) returned to DimaLesnoy
DimaLesnoy collected $0.25 from pot
DimaLesnoy: doesn't show hand 
*** SUMMARY ***
Total pot $0.25 | Rake $0 
Seat 1: Dosa994 (small blind) folded before Flop
Seat 2: densamara_63 (big blind) folded before Flop
Seat 3: DimaLesnoy collected ($0.25)
Seat 4: mecha0117 folded before Flop (didn't bet)
Seat 5: dfranssens folded before Flop (didn't bet)
Seat 6: Hamilton_TD (button) folded before Flop (didn't bet)



PokerStars Hand #222960653672:  Hold'em No Limit ($0.05/$0.10 USD) - 2021/01/23 12:13:03 ET
Table 'Saito II' 6-max Seat #1 is the button
Seat 1: Dosa994 ($6.96 in chips) 
Seat 2: densamara_63 ($10.14 in chips) 
Seat 3: DimaLesnoy ($10.67 in chips) 
Seat 4: mecha0117 ($28.83 in chips) 
Seat 5: dfranssens ($7.55 in chips) 
Seat 6: Hamilton_TD ($20.59 in chips) 
densamara_63: posts small blind $0.05
DimaLesnoy: posts big blind $0.10
*** HOLE CARDS ***
mecha0117: raises $0.10 to $0.20
dfranssens: folds 
Hamilton_TD: folds 
Dosa994: folds 
densamara_63: calls $0.15
DimaLesnoy: folds 
*** FLOP *** [3d 2c 9d]
densamara_63: bets $0.29
mecha0117: raises $0.61 to $0.90
densamara_63: calls $0.61
*** TURN *** [3d 2c 9d] [Qh]
densamara_63: checks 
mecha0117: bets $2
densamara_63: folds 
Uncalled bet ($2) returned to mecha0117
mecha0117 collected $2.20 from pot
mecha0117: doesn't show hand 
*** SUMMARY ***
Total pot $2.30 | Rake $0.10 
Board [3d 2c 9d Qh]
Seat 1: Dosa994 (button) folded before Flop (didn't bet)
Seat 2: densamara_63 (small blind) folded on the Turn
Seat 3: DimaLesnoy (big blind) folded before Flop
Seat 4: mecha0117 collected ($2.20)
Seat 5: dfranssens folded before Flop (didn't bet)
Seat 6: Hamilton_TD folded before Flop (didn't bet)



PokerStars Hand #222960697896:  Hold'em No Limit ($0.05/$0.10 USD) - 2021/01/23 12:14:11 ET
Table 'Saito II' 6-max Seat #2 is the button
Seat 1: Dosa994 ($6.96 in chips) 
Seat 2: densamara_63 ($10 in chips) 
Seat 3: DimaLesnoy ($10.57 in chips) 
Seat 4: mecha0117 ($29.93 in chips) 
Seat 5: dfranssens ($7.55 in chips) 
Seat 6: Hamilton_TD ($20.59 in chips) 
DimaLesnoy: posts small blind $0.05
mecha0117: posts big blind $0.10
*** HOLE CARDS ***
dfranssens: raises $0.40 to $0.50
Hamilton_TD: folds 
Dosa994: folds 
densamara_63: folds 
DimaLesnoy: folds 
mecha0117: folds 
Uncalled bet ($0.40) returned to dfranssens
dfranssens collected $0.25 from pot
dfranssens: doesn't show hand 
*** SUMMARY ***
Total pot $0.25 | Rake $0 
Seat 1: Dosa994 folded before Flop (didn't bet)
Seat 2: densamara_63 (button) folded before Flop (didn't bet)
Seat 3: DimaLesnoy (small blind) folded before Flop
Seat 4: mecha0117 (big blind) folded before Flop
Seat 5: dfranssens collected ($0.25)
Seat 6: Hamilton_TD folded before Flop (didn't bet)



PokerStars Hand #222960708551:  Hold'em No Limit ($0.05/$0.10 USD) - 2021/01/23 12:14:28 ET
Table 'Saito II' 6-max Seat #3 is the button
Seat 1: Dosa994 ($6.96 in chips) 
Seat 2: densamara_63 ($10 in chips) 
Seat 3: DimaLesnoy ($10.52 in chips) 
Seat 4: mecha0117 ($29.83 in chips) 
Seat 5: dfranssens ($7.70 in chips) 
Seat 6: Hamilton_TD ($20.59 in chips) 
mecha0117: posts small blind $0.05
dfranssens: posts big blind $0.10
*** HOLE CARDS ***
Hamilton_TD: folds 
Dosa994: calls $0.10
densamara_63: raises $0.30 to $0.40
DimaLesnoy: folds 
mecha0117: folds 
dfranssens: folds 
Dosa994: raises $0.30 to $0.70
densamara_63: raises $0.60 to $1.30
Dosa994: calls $0.60
*** FLOP *** [Qh 6c 8c]
Dosa994: bets $0.50
densamara_63: calls $0.50
*** TURN *** [Qh 6c 8c] [9h]
Dosa994: bets $5.16 and is all-in
densamara_63: calls $5.16
*** RIVER *** [Qh 6c 8c 9h] [2c]
*** SHOW DOWN ***
Dosa994: shows [Qd Ah] (a pair of Queens)
densamara_63: shows [Qs As] (a pair of Queens)
Dosa994 collected $6.72 from pot
densamara_63 collected $6.72 from pot
*** SUMMARY ***
Total pot $14.07 | Rake $0.63 
Board [Qh 6c 8c 9h 2c]
Seat 1: Dosa994 showed [Qd Ah] and won ($6.72) with a pair of Queens
Seat 2: densamara_63 showed [Qs As] and won ($6.72) with a pair of Queens
Seat 3: DimaLesnoy (button) folded before Flop (didn't bet)
Seat 4: mecha0117 (small blind) folded before Flop
Seat 5: dfranssens (big blind) folded before Flop
Seat 6: Hamilton_TD folded before Flop (didn't bet)



PokerStars Hand #222960731981:  Hold'em No Limit ($0.05/$0.10 USD) - 2021/01/23 12:15:05 ET
Table 'Saito II' 6-max Seat #4 is the button
Seat 1: Dosa994 ($6.72 in chips) 
Seat 2: densamara_63 ($10 in chips) 
Seat 3: DimaLesnoy ($10.52 in chips) 
Seat 4: mecha0117 ($29.78 in chips) 
Seat 5: dfranssens ($7.60 in chips) 
dfranssens: posts small blind $0.05
Hamilton_TD: is sitting out 
Dosa994: posts big blind $0.10
*** HOLE CARDS ***
Hamilton_TD leaves the table
densamara_63: folds 
DimaLesnoy: folds 
DIMON_ua_11 joins the table at seat #6 
mecha0117: raises $0.20 to $0.30
dfranssens: folds 
Dosa994: folds 
Uncalled bet ($0.20) returned to mecha0117
mecha0117 collected $0.25 from pot
mecha0117: doesn't show hand 
*** SUMMARY ***
Total pot $0.25 | Rake $0 
Seat 1: Dosa994 (big blind) folded before Flop
Seat 2: densamara_63 folded before Flop (didn't bet)
Seat 3: DimaLesnoy folded before Flop (didn't bet)
Seat 4: mecha0117 (button) collected ($0.25)
Seat 5: dfranssens (small blind) folded before Flop



PokerStars Hand #222960739260:  Hold'em No Limit ($0.05/$0.10 USD) - 2021/01/23 12:15:17 ET
Table 'Saito II' 6-max Seat #5 is the button
Seat 1: Dosa994 ($6.62 in chips) 
Seat 2: densamara_63 ($10 in chips) 
Seat 3: DimaLesnoy ($10.52 in chips) 
Seat 4: mecha0117 ($29.93 in chips) 
Seat 5: dfranssens ($7.55 in chips) 
Dosa994: posts small blind $0.05
densamara_63: posts big blind $0.10
*** HOLE CARDS ***
DimaLesnoy: folds 
mecha0117: folds 
dfranssens: raises $0.20 to $0.30
Dosa994: folds 
densamara_63: folds 
Uncalled bet ($0.20) returned to dfranssens
dfranssens collected $0.25 from pot
dfranssens: doesn't show hand 
*** SUMMARY ***
Total pot $0.25 | Rake $0 
Seat 1: Dosa994 (small blind) folded before Flop
Seat 2: densamara_63 (big blind) folded before Flop
Seat 3: DimaLesnoy folded before Flop (didn't bet)
Seat 4: mecha0117 folded before Flop (didn't bet)
Seat 5: dfranssens (button) collected ($0.25)



PokerStars Hand #222960751508:  Hold'em No Limit ($0.05/$0.10 USD) - 2021/01/23 12:15:36 ET
Table 'Saito II' 6-max Seat #2 is the button
Seat 2: densamara_63 ($10 in chips) 
Seat 3: DimaLesnoy ($10.52 in chips) 
Seat 4: mecha0117 ($29.93 in chips) 
Seat 5: dfranssens ($7.70 in chips) 
DimaLesnoy: posts small blind $0.05
mecha0117: posts big blind $0.10
DIMON_ua_11: sits out 
*** HOLE CARDS ***
Dosa994 leaves the table
dfranssens: folds 
densamara_63: raises $0.12 to $0.22
DimaLesnoy: raises $0.54 to $0.76
mecha0117: folds 
densamara_63: calls $0.54
*** FLOP *** [Jc Jd Ah]
DimaLesnoy: checks 
densamara_63: bets $0.54
DimaLesnoy: calls $0.54
*** TURN *** [Jc Jd Ah] [7d]
DimaLesnoy: checks 
densamara_63: bets $2.14
DimaLesnoy: folds 
Uncalled bet ($2.14) returned to densamara_63
densamara_63 collected $2.58 from pot
*** SUMMARY ***
Total pot $2.70 | Rake $0.12 
Board [Jc Jd Ah 7d]
Seat 2: densamara_63 (button) collected ($2.58)
Seat 3: DimaLesnoy (small blind) folded on the Turn
Seat 4: mecha0117 (big blind) folded before Flop
Seat 5: dfranssens folded before Flop (didn't bet)



PokerStars Hand #222960778560:  Hold'em No Limit ($0.05/$0.10 USD) - 2021/01/23 12:16:19 ET
Table 'Saito II' 6-max Seat #3 is the button
Seat 2: densamara_63 ($11.28 in chips) 
Seat 3: DimaLesnoy ($10 in chips) 
Seat 4: mecha0117 ($29.83 in chips) 
Seat 5: dfranssens ($7.70 in chips) 
mecha0117: posts small blind $0.05
dfranssens: posts big blind $0.10
DIMON_ua_11: sits out 
*** HOLE CARDS ***
densamara_63: raises $0.17 to $0.27
DimaLesnoy: folds 
mecha0117: folds 
dfranssens: folds 
Uncalled bet ($0.17) returned to densamara_63
densamara_63 collected $0.25 from pot
*** SUMMARY ***
Total pot $0.25 | Rake $0 
Seat 2: densamara_63 collected ($0.25)
Seat 3: DimaLesnoy (button) folded before Flop (didn't bet)
Seat 4: mecha0117 (small blind) folded before Flop
Seat 5: dfranssens (big blind) folded before Flop



PokerStars Hand #222960786800:  Hold'em No Limit ($0.05/$0.10 USD) - 2021/01/23 12:16:32 ET
Table 'Saito II' 6-max Seat #4 is the button
Seat 2: densamara_63 ($11.43 in chips) 
Seat 3: DimaLesnoy ($10 in chips) 
Seat 4: mecha0117 ($29.78 in chips) 
Seat 5: dfranssens ($7.60 in chips) 
Seat 6: DIMON_ua_11 ($8 in chips) 
dfranssens: posts small blind $0.05
DIMON_ua_11: posts big blind $0.10
*** HOLE CARDS ***
densamara_63: folds 
DimaLesnoy: folds 
mecha0117: raises $0.20 to $0.30
dfranssens: folds 
JuniorRRT joins the table at seat #1 
DIMON_ua_11: folds 
Uncalled bet ($0.20) returned to mecha0117
mecha0117 collected $0.25 from pot
mecha0117: doesn't show hand 
*** SUMMARY ***
Total pot $0.25 | Rake $0 
Seat 2: densamara_63 folded before Flop (didn't bet)
Seat 3: DimaLesnoy folded before Flop (didn't bet)
Seat 4: mecha0117 (button) collected ($0.25)
Seat 5: dfranssens (small blind) folded before Flop
Seat 6: DIMON_ua_11 (big blind) folded before Flop



PokerStars Hand #222960800587:  Hold'em No Limit ($0.05/$0.10 USD) - 2021/01/23 12:16:53 ET
Table 'Saito II' 6-max Seat #5 is the button
Seat 1: JuniorRRT ($10 in chips) 
Seat 2: densamara_63 ($11.43 in chips) 
Seat 3: DimaLesnoy ($10 in chips) 
Seat 4: mecha0117 ($29.93 in chips) 
Seat 5: dfranssens ($7.55 in chips) 
Seat 6: DIMON_ua_11 ($7.90 in chips) 
DIMON_ua_11: posts small blind $0.05
JuniorRRT: posts big blind $0.10
*** HOLE CARDS ***
densamara_63: folds 
DimaLesnoy: folds 
mecha0117: raises $0.20 to $0.30
dfranssens: folds 
DIMON_ua_11: raises $0.60 to $0.90
JuniorRRT: folds 
mecha0117: calls $0.60
*** FLOP *** [9h 4d Jh]
DIMON_ua_11: checks 
mecha0117: bets $1.50
DIMON_ua_11: folds 
Uncalled bet ($1.50) returned to mecha0117
mecha0117 collected $1.81 from pot
mecha0117: doesn't show hand 
*** SUMMARY ***
Total pot $1.90 | Rake $0.09 
Board [9h 4d Jh]
Seat 1: JuniorRRT (big blind) folded before Flop
Seat 2: densamara_63 folded before Flop (didn't bet)
Seat 3: DimaLesnoy folded before Flop (didn't bet)
Seat 4: mecha0117 collected ($1.81)
Seat 5: dfranssens (button) folded before Flop (didn't bet)
Seat 6: DIMON_ua_11 (small blind) folded on the Flop



PokerStars Hand #222960839389:  Hold'em No Limit ($0.05/$0.10 USD) - 2021/01/23 12:17:54 ET
Table 'Saito II' 6-max Seat #6 is the button
Seat 1: JuniorRRT ($10 in chips) 
Seat 2: densamara_63 ($11.43 in chips) 
Seat 3: DimaLesnoy ($10 in chips) 
Seat 4: mecha0117 ($30.84 in chips) 
Seat 5: dfranssens ($7.55 in chips) 
Seat 6: DIMON_ua_11 ($7 in chips) 
JuniorRRT: posts small blind $0.05
densamara_63: posts big blind $0.10
*** HOLE CARDS ***
DimaLesnoy: folds 
mecha0117: folds 
dfranssens: folds 
DIMON_ua_11: raises $0.20 to $0.30
JuniorRRT: folds 
densamara_63: folds 
Uncalled bet ($0.20) returned to DIMON_ua_11
DIMON_ua_11 collected $0.25 from pot
DIMON_ua_11: doesn't show hand 
*** SUMMARY ***
Total pot $0.25 | Rake $0 
Seat 1: JuniorRRT (small blind) folded before Flop
Seat 2: densamara_63 (big blind) folded before Flop
Seat 3: DimaLesnoy folded before Flop (didn't bet)
Seat 4: mecha0117 folded before Flop (didn't bet)
Seat 5: dfranssens folded before Flop (didn't bet)
Seat 6: DIMON_ua_11 (button) collected ($0.25)



PokerStars Hand #222960851836:  Hold'em No Limit ($0.05/$0.10 USD) - 2021/01/23 12:18:11 ET
Table 'Saito II' 6-max Seat #1 is the button
Seat 1: JuniorRRT ($10 in chips) 
Seat 2: densamara_63 ($11.33 in chips) 
Seat 3: DimaLesnoy ($10 in chips) 
Seat 4: mecha0117 ($30.84 in chips) 
Seat 5: dfranssens ($7.55 in chips) 
Seat 6: DIMON_ua_11 ($7.15 in chips) 
densamara_63: posts small blind $0.05
DimaLesnoy: posts big blind $0.10
*** HOLE CARDS ***
mecha0117: folds 
dfranssens: folds 
DIMON_ua_11: folds 
JuniorRRT: folds 
densamara_63: folds 
Uncalled bet ($0.05) returned to DimaLesnoy
DimaLesnoy collected $0.10 from pot
DimaLesnoy: doesn't show hand 
*** SUMMARY ***
Total pot $0.10 | Rake $0 
Seat 1: JuniorRRT (button) folded before Flop (didn't bet)
Seat 2: densamara_63 (small blind) folded before Flop
Seat 3: DimaLesnoy (big blind) collected ($0.10)
Seat 4: mecha0117 folded before Flop (didn't bet)
Seat 5: dfranssens folded before Flop (didn't bet)
Seat 6: DIMON_ua_11 folded before Flop (didn't bet)



PokerStars Hand #222960857069:  Hold'em No Limit ($0.05/$0.10 USD) - 2021/01/23 12:18:19 ET
Table 'Saito II' 6-max Seat #2 is the button
Seat 1: JuniorRRT ($10 in chips) 
Seat 2: densamara_63 ($11.28 in chips) 
Seat 3: DimaLesnoy ($10.05 in chips) 
Seat 4: mecha0117 ($30.84 in chips) 
Seat 5: dfranssens ($7.55 in chips) 
Seat 6: DIMON_ua_11 ($7.15 in chips) 
DimaLesnoy: posts small blind $0.05
mecha0117: posts big blind $0.10
*** HOLE CARDS ***
dfranssens: folds 
DIMON_ua_11: folds 
JuniorRRT: folds 
densamara_63: folds 
DimaLesnoy: folds 
Uncalled bet ($0.05) returned to mecha0117
mecha0117 collected $0.10 from pot
mecha0117: doesn't show hand 
*** SUMMARY ***
Total pot $0.10 | Rake $0 
Seat 1: JuniorRRT folded before Flop (didn't bet)
Seat 2: densamara_63 (button) folded before Flop (didn't bet)
Seat 3: DimaLesnoy (small blind) folded before Flop
Seat 4: mecha0117 (big blind) collected ($0.10)
Seat 5: dfranssens folded before Flop (didn't bet)
Seat 6: DIMON_ua_11 folded before Flop (didn't bet)



PokerStars Hand #222960864061:  Hold'em No Limit ($0.05/$0.10 USD) - 2021/01/23 12:18:31 ET
Table 'Saito II' 6-max Seat #3 is the button
Seat 1: JuniorRRT ($10 in chips) 
Seat 2: densamara_63 ($11.28 in chips) 
Seat 3: DimaLesnoy ($10 in chips) 
Seat 4: mecha0117 ($30.89 in chips) 
Seat 5: dfranssens ($7.55 in chips) 
Seat 6: DIMON_ua_11 ($7.15 in chips) 
mecha0117: posts small blind $0.05
dfranssens: posts big blind $0.10
*** HOLE CARDS ***
DIMON_ua_11: folds 
JuniorRRT: folds 
densamara_63: folds 
DimaLesnoy: folds 
mecha0117: calls $0.05
dfranssens: checks 
*** FLOP *** [9h 3d 8h]
mecha0117: checks 
dfranssens: checks 
*** TURN *** [9h 3d 8h] [3c]
mecha0117: bets $0.19
dfranssens: folds 
Uncalled bet ($0.19) returned to mecha0117
mecha0117 collected $0.19 from pot
mecha0117: doesn't show hand 
*** SUMMARY ***
Total pot $0.20 | Rake $0.01 
Board [9h 3d 8h 3c]
Seat 1: JuniorRRT folded before Flop (didn't bet)
Seat 2: densamara_63 folded before Flop (didn't bet)
Seat 3: DimaLesnoy (button) folded before Flop (didn't bet)
Seat 4: mecha0117 (small blind) collected ($0.19)
Seat 5: dfranssens (big blind) folded on the Turn
Seat 6: DIMON_ua_11 folded before Flop (didn't bet)



PokerStars Hand #222960884266:  Hold'em No Limit ($0.05/$0.10 USD) - 2021/01/23 12:19:02 ET
Table 'Saito II' 6-max Seat #4 is the button
Seat 1: JuniorRRT ($10 in chips) 
Seat 2: densamara_63 ($11.28 in chips) 
Seat 3: DimaLesnoy ($10 in chips) 
Seat 4: mecha0117 ($30.98 in chips) 
Seat 5: dfranssens ($7.45 in chips) 
Seat 6: DIMON_ua_11 ($7.15 in chips) 
dfranssens: posts small blind $0.05
DIMON_ua_11: posts big blind $0.10
*** HOLE CARDS ***
JuniorRRT: folds 
JuniorRRT leaves the table
densamara_63: folds 
DimaLesnoy: folds 
mecha0117: folds 
dfranssens: folds 
Uncalled bet ($0.05) returned to DIMON_ua_11
DIMON_ua_11 collected $0.10 from pot
DIMON_ua_11: doesn't show hand 
*** SUMMARY ***
Total pot $0.10 | Rake $0 
Seat 1: JuniorRRT folded before Flop (didn't bet)
Seat 2: densamara_63 folded before Flop (didn't bet)
Seat 3: DimaLesnoy folded before Flop (didn't bet)
Seat 4: mecha0117 (button) folded before Flop (didn't bet)
Seat 5: dfranssens (small blind) folded before Flop
Seat 6: DIMON_ua_11 (big blind) collected ($0.10)



PokerStars Hand #222960889434:  Hold'em No Limit ($0.05/$0.10 USD) - 2021/01/23 12:19:11 ET
Table 'Saito II' 6-max Seat #5 is the button
Seat 2: densamara_63 ($11.28 in chips) 
Seat 3: DimaLesnoy ($10 in chips) 
Seat 4: mecha0117 ($30.98 in chips) 
Seat 5: dfranssens ($7.40 in chips) 
Seat 6: DIMON_ua_11 ($7.20 in chips) 
DIMON_ua_11: posts small blind $0.05
densamara_63: posts big blind $0.10
*** HOLE CARDS ***
SrPan89 joins the table at seat #1 
DimaLesnoy: folds 
mecha0117: folds 
dfranssens: folds 
DIMON_ua_11: folds 
Uncalled bet ($0.05) returned to densamara_63
densamara_63 collected $0.10 from pot
*** SUMMARY ***
Total pot $0.10 | Rake $0 
Seat 2: densamara_63 (big blind) collected ($0.10)
Seat 3: DimaLesnoy folded before Flop (didn't bet)
Seat 4: mecha0117 folded before Flop (didn't bet)
Seat 5: dfranssens (button) folded before Flop (didn't bet)
Seat 6: DIMON_ua_11 (small blind) folded before Flop



PokerStars Hand #222960896293:  Hold'em No Limit ($0.05/$0.10 USD) - 2021/01/23 12:19:22 ET
Table 'Saito II' 6-max Seat #6 is the button
Seat 2: densamara_63 ($11.33 in chips) 
Seat 3: DimaLesnoy ($10 in chips) 
Seat 4: mecha0117 ($30.98 in chips) 
Seat 5: dfranssens ($7.40 in chips) 
Seat 6: DIMON_ua_11 ($7.15 in chips) 
densamara_63: posts small blind $0.05
DimaLesnoy: posts big blind $0.10
*** HOLE CARDS ***
mecha0117: folds 
dfranssens has timed out
dfranssens: folds 
DIMON_ua_11: folds 
densamara_63: folds 
Uncalled bet ($0.05) returned to DimaLesnoy
DimaLesnoy collected $0.10 from pot
DimaLesnoy: doesn't show hand 
*** SUMMARY ***
Total pot $0.10 | Rake $0 
Seat 2: densamara_63 (small blind) folded before Flop
Seat 3: DimaLesnoy (big blind) collected ($0.10)
Seat 4: mecha0117 folded before Flop (didn't bet)
Seat 5: dfranssens folded before Flop (didn't bet)
Seat 6: DIMON_ua_11 (button) folded before Flop (didn't bet)



PokerStars Hand #222960907997:  Hold'em No Limit ($0.05/$0.10 USD) - 2021/01/23 12:19:40 ET
Table 'Saito II' 6-max Seat #2 is the button
Seat 2: densamara_63 ($11.28 in chips) 
Seat 3: DimaLesnoy ($10.05 in chips) 
Seat 4: mecha0117 ($30.98 in chips) 
Seat 6: DIMON_ua_11 ($7.15 in chips) 
DimaLesnoy: posts small blind $0.05
mecha0117: posts big blind $0.10
SrPan89: sits out 
*** HOLE CARDS ***
DIMON_ua_11: folds 
densamara_63: raises $0.17 to $0.27
DimaLesnoy: raises $0.64 to $0.91
mecha0117: folds 
densamara_63: calls $0.64
*** FLOP *** [8h 6d 5s]
DimaLesnoy: checks 
densamara_63: bets $0.64
DimaLesnoy: calls $0.64
*** TURN *** [8h 6d 5s] [9h]
DimaLesnoy: checks 
densamara_63: bets $2.54
DimaLesnoy: calls $2.54
*** RIVER *** [8h 6d 5s 9h] [4d]
DimaLesnoy: checks 
densamara_63: bets $7.19 and is all-in
DimaLesnoy: folds 
Uncalled bet ($7.19) returned to densamara_63
densamara_63 collected $7.91 from pot
*** SUMMARY ***
Total pot $8.28 | Rake $0.37 
Board [8h 6d 5s 9h 4d]
Seat 2: densamara_63 (button) collected ($7.91)
Seat 3: DimaLesnoy (small blind) folded on the River
Seat 4: mecha0117 (big blind) folded before Flop
Seat 6: DIMON_ua_11 folded before Flop (didn't bet)



PokerStars Hand #222960965611:  Hold'em No Limit ($0.05/$0.10 USD) - 2021/01/23 12:21:11 ET
Table 'Saito II' 6-max Seat #3 is the button
Seat 2: densamara_63 ($15.10 in chips) 
Seat 3: DimaLesnoy ($10 in chips) 
Seat 4: mecha0117 ($30.88 in chips) 
Seat 5: dfranssens ($7.40 in chips) 
Seat 6: DIMON_ua_11 ($7.15 in chips) 
mecha0117: posts small blind $0.05
dfranssens: posts big blind $0.10
SrPan89: sits out 
*** HOLE CARDS ***
DIMON_ua_11: folds 
densamara_63: folds 
DimaLesnoy: folds 
mecha0117: calls $0.05
dfranssens: checks 
*** FLOP *** [6h Qc 2d]
mecha0117: checks 
dfranssens: checks 
*** TURN *** [6h Qc 2d] [5c]
mecha0117: bets $0.19
dfranssens: folds 
Uncalled bet ($0.19) returned to mecha0117
mecha0117 collected $0.19 from pot
mecha0117: doesn't show hand 
densamara_63 leaves the table
*** SUMMARY ***
Total pot $0.20 | Rake $0.01 
Board [6h Qc 2d 5c]
Seat 2: densamara_63 folded before Flop (didn't bet)
Seat 3: DimaLesnoy (button) folded before Flop (didn't bet)
Seat 4: mecha0117 (small blind) collected ($0.19)
Seat 5: dfranssens (big blind) folded on the Turn
Seat 6: DIMON_ua_11 folded before Flop (didn't bet)



PokerStars Hand #222960986243:  Hold'em No Limit ($0.05/$0.10 USD) - 2021/01/23 12:21:44 ET
Table 'Saito II' 6-max Seat #4 is the button
Seat 3: DimaLesnoy ($10 in chips) 
Seat 4: mecha0117 ($30.97 in chips) 
Seat 5: dfranssens ($7.30 in chips) 
Seat 6: DIMON_ua_11 ($7.15 in chips) 
dfranssens: posts small blind $0.05
DIMON_ua_11: posts big blind $0.10
SrPan89: sits out 
*** HOLE CARDS ***
DimaLesnoy: folds 
mecha0117: raises $0.20 to $0.30
dfranssens: folds 
senej joins the table at seat #2 
DIMON_ua_11: folds 
Uncalled bet ($0.20) returned to mecha0117
mecha0117 collected $0.25 from pot
mecha0117: doesn't show hand 
*** SUMMARY ***
Total pot $0.25 | Rake $0 
Seat 3: DimaLesnoy folded before Flop (didn't bet)
Seat 4: mecha0117 (button) collected ($0.25)
Seat 5: dfranssens (small blind) folded before Flop
Seat 6: DIMON_ua_11 (big blind) folded before Flop



PokerStars Hand #222960996854:  Hold'em No Limit ($0.05/$0.10 USD) - 2021/01/23 12:22:01 ET
Table 'Saito II' 6-max Seat #5 is the button
Seat 1: SrPan89 ($10 in chips) 
Seat 3: DimaLesnoy ($10 in chips) 
Seat 4: mecha0117 ($31.12 in chips) 
Seat 5: dfranssens ($7.25 in chips) 
Seat 6: DIMON_ua_11 ($7.05 in chips) 
DIMON_ua_11: posts small blind $0.05
SrPan89: posts big blind $0.10
senej: sits out 
*** HOLE CARDS ***
DimaLesnoy: folds 
mecha0117: folds 
dfranssens: folds 
DIMON_ua_11: raises $0.20 to $0.30
SrPan89: calls $0.20
*** FLOP *** [4d 2s 7d]
DIMON_ua_11: bets $0.37
SrPan89: calls $0.37
*** TURN *** [4d 2s 7d] [2d]
DIMON_ua_11: bets $0.50
SrPan89: calls $0.50
*** RIVER *** [4d 2s 7d 2d] [Ks]
DIMON_ua_11: checks 
SrPan89: bets $1.12
DIMON_ua_11: folds 
Uncalled bet ($1.12) returned to SrPan89
SrPan89 collected $2.23 from pot
SrPan89: doesn't show hand 
*** SUMMARY ***
Total pot $2.34 | Rake $0.11 
Board [4d 2s 7d 2d Ks]
Seat 1: SrPan89 (big blind) collected ($2.23)
Seat 3: DimaLesnoy folded before Flop (didn't bet)
Seat 4: mecha0117 folded before Flop (didn't bet)
Seat 5: dfranssens (button) folded before Flop (didn't bet)
Seat 6: DIMON_ua_11 (small blind) folded on the River



PokerStars Hand #222961025308:  Hold'em No Limit ($0.05/$0.10 USD) - 2021/01/23 12:22:46 ET
Table 'Saito II' 6-max Seat #6 is the button
Seat 1: SrPan89 ($11.06 in chips) 
Seat 2: senej ($10 in chips) 
Seat 3: DimaLesnoy ($10 in chips) 
Seat 4: mecha0117 ($31.12 in chips) 
Seat 5: dfranssens ($7.25 in chips) 
Seat 6: DIMON_ua_11 ($5.88 in chips) 
SrPan89: posts small blind $0.05
senej: posts big blind $0.10
*** HOLE CARDS ***
DimaLesnoy: folds 
mecha0117: folds 
dfranssens: raises $0.20 to $0.30
DIMON_ua_11: folds 
SrPan89: folds 
senej: folds 
Uncalled bet ($0.20) returned to dfranssens
dfranssens collected $0.25 from pot
dfranssens: doesn't show hand 
*** SUMMARY ***
Total pot $0.25 | Rake $0 
Seat 1: SrPan89 (small blind) folded before Flop
Seat 2: senej (big blind) folded before Flop
Seat 3: DimaLesnoy folded before Flop (didn't bet)
Seat 4: mecha0117 folded before Flop (didn't bet)
Seat 5: dfranssens collected ($0.25)
Seat 6: DIMON_ua_11 (button) folded before Flop (didn't bet)



PokerStars Hand #222961032462:  Hold'em No Limit ($0.05/$0.10 USD) - 2021/01/23 12:22:57 ET
Table 'Saito II' 6-max Seat #1 is the button
Seat 1: SrPan89 ($11.01 in chips) 
Seat 2: senej ($10 in chips) 
Seat 3: DimaLesnoy ($10 in chips) 
Seat 4: mecha0117 ($31.12 in chips) 
Seat 5: dfranssens ($7.40 in chips) 
Seat 6: DIMON_ua_11 ($5.88 in chips) 
senej: posts small blind $0.05
DimaLesnoy: posts big blind $0.10
*** HOLE CARDS ***
mecha0117: folds 
dfranssens: raises $0.30 to $0.40
DIMON_ua_11: folds 
SrPan89: folds 
senej: folds 
DimaLesnoy: folds 
Uncalled bet ($0.30) returned to dfranssens
dfranssens collected $0.25 from pot
dfranssens: doesn't show hand 
*** SUMMARY ***
Total pot $0.25 | Rake $0 
Seat 1: SrPan89 (button) folded before Flop (didn't bet)
Seat 2: senej (small blind) folded before Flop
Seat 3: DimaLesnoy (big blind) folded before Flop
Seat 4: mecha0117 folded before Flop (didn't bet)
Seat 5: dfranssens collected ($0.25)
Seat 6: DIMON_ua_11 folded before Flop (didn't bet)



PokerStars Hand #222961041794:  Hold'em No Limit ($0.05/$0.10 USD) - 2021/01/23 12:23:12 ET
Table 'Saito II' 6-max Seat #2 is the button
Seat 1: SrPan89 ($11.01 in chips) 
Seat 2: senej ($10 in chips) 
Seat 3: DimaLesnoy ($10 in chips) 
Seat 4: mecha0117 ($31.12 in chips) 
Seat 5: dfranssens ($7.55 in chips) 
Seat 6: DIMON_ua_11 ($5.88 in chips) 
DimaLesnoy: posts small blind $0.05
mecha0117: posts big blind $0.10
*** HOLE CARDS ***
dfranssens: raises $0.30 to $0.40
DIMON_ua_11: folds 
SrPan89: folds 
senej: folds 
DimaLesnoy: folds 
mecha0117: raises $1 to $1.40
dfranssens: calls $1
*** FLOP *** [Tc 5h 6s]
mecha0117: bets $0.80
dfranssens: calls $0.80
*** TURN *** [Tc 5h 6s] [7h]
mecha0117: bets $28.92 and is all-in
dfranssens: calls $5.35 and is all-in
Uncalled bet ($23.57) returned to mecha0117
*** RIVER *** [Tc 5h 6s 7h] [7s]
*** SHOW DOWN ***
mecha0117: shows [Kd Kh] (two pair, Kings and Sevens)
dfranssens: shows [Jh Ah] (a pair of Sevens)
mecha0117 collected $14.47 from pot
*** SUMMARY ***
Total pot $15.15 | Rake $0.68 
Board [Tc 5h 6s 7h 7s]
Seat 1: SrPan89 folded before Flop (didn't bet)
Seat 2: senej (button) folded before Flop (didn't bet)
Seat 3: DimaLesnoy (small blind) folded before Flop
Seat 4: mecha0117 (big blind) showed [Kd Kh] and won ($14.47) with two pair, Kings and Sevens
Seat 5: dfranssens showed [Jh Ah] and lost with a pair of Sevens
Seat 6: DIMON_ua_11 folded before Flop (didn't bet)



PokerStars Hand #222961069131:  Hold'em No Limit ($0.05/$0.10 USD) - 2021/01/23 12:23:54 ET
Table 'Saito II' 6-max Seat #3 is the button
Seat 1: SrPan89 ($11.01 in chips) 
Seat 2: senej ($10 in chips) 
Seat 3: DimaLesnoy ($10 in chips) 
Seat 4: mecha0117 ($38.04 in chips) 
Seat 5: dfranssens ($4 in chips) 
Seat 6: DIMON_ua_11 ($5.88 in chips) 
mecha0117: posts small blind $0.05
dfranssens: posts big blind $0.10
*** HOLE CARDS ***
DIMON_ua_11: folds 
SrPan89: folds 
senej: folds 
DimaLesnoy: folds 
mecha0117: raises $0.20 to $0.30
dfranssens: calls $0.20
*** FLOP *** [Ad 2d 6h]
mecha0117: checks 
dfranssens: bets $0.30
mecha0117: calls $0.30
*** TURN *** [Ad 2d 6h] [Tc]
mecha0117: checks 
dfranssens: bets $0.40
mecha0117: calls $0.40
*** RIVER *** [Ad 2d 6h Tc] [Ts]
mecha0117: checks 
dfranssens: bets $1.91
mecha0117: folds 
Uncalled bet ($1.91) returned to dfranssens
dfranssens collected $1.91 from pot
dfranssens: doesn't show hand 
*** SUMMARY ***
Total pot $2 | Rake $0.09 
Board [Ad 2d 6h Tc Ts]
Seat 1: SrPan89 folded before Flop (didn't bet)
Seat 2: senej folded before Flop (didn't bet)
Seat 3: DimaLesnoy (button) folded before Flop (didn't bet)
Seat 4: mecha0117 (small blind) folded on the River
Seat 5: dfranssens (big blind) collected ($1.91)
Seat 6: DIMON_ua_11 folded before Flop (didn't bet)



PokerStars Hand #222961111153:  Hold'em No Limit ($0.05/$0.10 USD) - 2021/01/23 12:24:48 ET
Table 'Saito II' 6-max Seat #4 is the button
Seat 1: SrPan89 ($11.01 in chips) 
Seat 2: senej ($10 in chips) 
Seat 3: DimaLesnoy ($10 in chips) 
Seat 4: mecha0117 ($37.04 in chips) 
Seat 5: dfranssens ($4.91 in chips) 
Seat 6: DIMON_ua_11 ($5.88 in chips) 
dfranssens: posts small blind $0.05
DIMON_ua_11: posts big blind $0.10
*** HOLE CARDS ***
SrPan89: folds 
senej: folds 
DimaLesnoy: raises $0.15 to $0.25
mecha0117: folds 
dfranssens: folds 
DIMON_ua_11: folds 
Uncalled bet ($0.15) returned to DimaLesnoy
dfranssens leaves the table
DimaLesnoy collected $0.25 from pot
DimaLesnoy: doesn't show hand 
*** SUMMARY ***
Total pot $0.25 | Rake $0 
Seat 1: SrPan89 folded before Flop (didn't bet)
Seat 2: senej folded before Flop (didn't bet)
Seat 3: DimaLesnoy collected ($0.25)
Seat 4: mecha0117 (button) folded before Flop (didn't bet)
Seat 5: dfranssens (small blind) folded before Flop
Seat 6: DIMON_ua_11 (big blind) folded before Flop



PokerStars Hand #222961119803:  Hold'em No Limit ($0.05/$0.10 USD) - 2021/01/23 12:25:02 ET
Table 'Saito II' 6-max Seat #6 is the button
Seat 1: SrPan89 ($11.01 in chips) 
Seat 2: senej ($10 in chips) 
Seat 3: DimaLesnoy ($10.15 in chips) 
Seat 4: mecha0117 ($37.04 in chips) 
Seat 6: DIMON_ua_11 ($5.78 in chips) 
SrPan89: posts small blind $0.05
senej: posts big blind $0.10
*** HOLE CARDS ***
DimaLesnoy: folds 
mecha0117: folds 
Vaha379 joins the table at seat #5 
DIMON_ua_11: raises $0.20 to $0.30
SrPan89: folds 
senej: folds 
Uncalled bet ($0.20) returned to DIMON_ua_11
DIMON_ua_11 collected $0.25 from pot
DIMON_ua_11: doesn't show hand 
*** SUMMARY ***
Total pot $0.25 | Rake $0 
Seat 1: SrPan89 (small blind) folded before Flop
Seat 2: senej (big blind) folded before Flop
Seat 3: DimaLesnoy folded before Flop (didn't bet)
Seat 4: mecha0117 folded before Flop (didn't bet)
Seat 6: DIMON_ua_11 (button) collected ($0.25)



PokerStars Hand #222961129180:  Hold'em No Limit ($0.05/$0.10 USD) - 2021/01/23 12:25:16 ET
Table 'Saito II' 6-max Seat #1 is the button
Seat 1: SrPan89 ($10.96 in chips) 
Seat 2: senej ($10 in chips) 
Seat 3: DimaLesnoy ($10.15 in chips) 
Seat 4: mecha0117 ($37.04 in chips) 
Seat 6: DIMON_ua_11 ($5.93 in chips) 
senej: posts small blind $0.05
DimaLesnoy: posts big blind $0.10
Vaha379: sits out 
*** HOLE CARDS ***
mecha0117: raises $0.10 to $0.20
DIMON_ua_11: folds 
SrPan89: folds 
senej: folds 
DimaLesnoy: calls $0.10
*** FLOP *** [5c 2h 5s]
DimaLesnoy: checks 
mecha0117: bets $0.10
DimaLesnoy: calls $0.10
*** TURN *** [5c 2h 5s] [2s]
DimaLesnoy: checks 
mecha0117: bets $0.10
DimaLesnoy: calls $0.10
*** RIVER *** [5c 2h 5s 2s] [Ah]
DimaLesnoy: checks 
mecha0117: bets $0.60
DimaLesnoy: calls $0.60
*** SHOW DOWN ***
mecha0117: shows [Td Js] (two pair, Fives and Deuces)
DimaLesnoy: shows [Ts As] (two pair, Aces and Fives)
DimaLesnoy collected $1.96 from pot
*** SUMMARY ***
Total pot $2.05 | Rake $0.09 
Board [5c 2h 5s 2s Ah]
Seat 1: SrPan89 (button) folded before Flop (didn't bet)
Seat 2: senej (small blind) folded before Flop
Seat 3: DimaLesnoy (big blind) showed [Ts As] and won ($1.96) with two pair, Aces and Fives
Seat 4: mecha0117 showed [Td Js] and lost with two pair, Fives and Deuces
Seat 6: DIMON_ua_11 folded before Flop (didn't bet)



PokerStars Hand #222961163941:  Hold'em No Limit ($0.05/$0.10 USD) - 2021/01/23 12:26:10 ET
Table 'Saito II' 6-max Seat #2 is the button
Seat 1: SrPan89 ($10.96 in chips) 
Seat 2: senej ($10 in chips) 
Seat 3: DimaLesnoy ($11.11 in chips) 
Seat 4: mecha0117 ($36.04 in chips) 
Seat 6: DIMON_ua_11 ($5.93 in chips) 
DimaLesnoy: posts small blind $0.05
mecha0117: posts big blind $0.10
Vaha379: sits out 
*** HOLE CARDS ***
DIMON_ua_11: folds 
SrPan89: folds 
senej: raises $0.20 to $0.30
DimaLesnoy: raises $0.70 to $1
mecha0117: folds 
senej: folds 
Uncalled bet ($0.70) returned to DimaLesnoy
DimaLesnoy collected $0.70 from pot
DimaLesnoy: doesn't show hand 
*** SUMMARY ***
Total pot $0.70 | Rake $0 
Seat 1: SrPan89 folded before Flop (didn't bet)
Seat 2: senej (button) folded before Flop
Seat 3: DimaLesnoy (small blind) collected ($0.70)
Seat 4: mecha0117 (big blind) folded before Flop
Seat 6: DIMON_ua_11 folded before Flop (didn't bet)



PokerStars Hand #222961175757:  Hold'em No Limit ($0.05/$0.10 USD) - 2021/01/23 12:26:28 ET
Table 'Saito II' 6-max Seat #3 is the button
Seat 1: SrPan89 ($10.96 in chips) 
Seat 2: senej ($10 in chips) 
Seat 3: DimaLesnoy ($11.51 in chips) 
Seat 4: mecha0117 ($35.94 in chips) 
Seat 5: Vaha379 ($10 in chips) 
Seat 6: DIMON_ua_11 ($5.93 in chips) 
mecha0117: posts small blind $0.05
Vaha379: posts big blind $0.10
*** HOLE CARDS ***
DIMON_ua_11: folds 
SrPan89: raises $0.30 to $0.40
senej: folds 
DimaLesnoy: folds 
mecha0117: folds 
Vaha379: folds 
Uncalled bet ($0.30) returned to SrPan89
SrPan89 collected $0.25 from pot
SrPan89: doesn't show hand 
*** SUMMARY ***
Total pot $0.25 | Rake $0 
Seat 1: SrPan89 collected ($0.25)
Seat 2: senej folded before Flop (didn't bet)
Seat 3: DimaLesnoy (button) folded before Flop (didn't bet)
Seat 4: mecha0117 (small blind) folded before Flop
Seat 5: Vaha379 (big blind) folded before Flop
Seat 6: DIMON_ua_11 folded before Flop (didn't bet)



PokerStars Hand #222961190776:  Hold'em No Limit ($0.05/$0.10 USD) - 2021/01/23 12:26:51 ET
Table 'Saito II' 6-max Seat #4 is the button
Seat 1: SrPan89 ($11.11 in chips) 
Seat 2: senej ($10 in chips) 
Seat 3: DimaLesnoy ($11.51 in chips) 
Seat 4: mecha0117 ($35.89 in chips) 
Seat 5: Vaha379 ($9.90 in chips) 
Seat 6: DIMON_ua_11 ($5.93 in chips) 
Vaha379: posts small blind $0.05
DIMON_ua_11: posts big blind $0.10
*** HOLE CARDS ***
SrPan89: raises $0.15 to $0.25
senej: folds 
DimaLesnoy: folds 
mecha0117: folds 
Vaha379: folds 
DIMON_ua_11: folds 
Uncalled bet ($0.15) returned to SrPan89
SrPan89 collected $0.25 from pot
SrPan89: doesn't show hand 
*** SUMMARY ***
Total pot $0.25 | Rake $0 
Seat 1: SrPan89 collected ($0.25)
Seat 2: senej folded before Flop (didn't bet)
Seat 3: DimaLesnoy folded before Flop (didn't bet)
Seat 4: mecha0117 (button) folded before Flop (didn't bet)
Seat 5: Vaha379 (small blind) folded before Flop
Seat 6: DIMON_ua_11 (big blind) folded before Flop



PokerStars Hand #222961209773:  Hold'em No Limit ($0.05/$0.10 USD) - 2021/01/23 12:27:20 ET
Table 'Saito II' 6-max Seat #5 is the button
Seat 1: SrPan89 ($11.26 in chips) 
Seat 2: senej ($10 in chips) 
Seat 3: DimaLesnoy ($11.51 in chips) 
Seat 4: mecha0117 ($35.89 in chips) 
Seat 5: Vaha379 ($9.85 in chips) 
Seat 6: DIMON_ua_11 ($5.83 in chips) 
DIMON_ua_11: posts small blind $0.05
SrPan89: posts big blind $0.10
*** HOLE CARDS ***
senej: folds 
DimaLesnoy: folds 
mecha0117: folds 
Vaha379: raises $0.20 to $0.30
DIMON_ua_11: folds 
SrPan89: folds 
Uncalled bet ($0.20) returned to Vaha379
Vaha379 collected $0.25 from pot
Vaha379: doesn't show hand 
*** SUMMARY ***
Total pot $0.25 | Rake $0 
Seat 1: SrPan89 (big blind) folded before Flop
Seat 2: senej folded before Flop (didn't bet)
Seat 3: DimaLesnoy folded before Flop (didn't bet)
Seat 4: mecha0117 folded before Flop (didn't bet)
Seat 5: Vaha379 (button) collected ($0.25)
Seat 6: DIMON_ua_11 (small blind) folded before Flop



PokerStars Hand #222961218586:  Hold'em No Limit ($0.05/$0.10 USD) - 2021/01/23 12:27:33 ET
Table 'Saito II' 6-max Seat #6 is the button
Seat 1: SrPan89 ($11.16 in chips) 
Seat 2: senej ($10 in chips) 
Seat 3: DimaLesnoy ($11.51 in chips) 
Seat 4: mecha0117 ($35.89 in chips) 
Seat 5: Vaha379 ($10 in chips) 
Seat 6: DIMON_ua_11 ($5.78 in chips) 
SrPan89: posts small blind $0.05
senej: posts big blind $0.10
*** HOLE CARDS ***
DimaLesnoy: folds 
mecha0117: raises $0.10 to $0.20
Vaha379: folds 
DIMON_ua_11: folds 
SrPan89: folds 
senej: folds 
Uncalled bet ($0.10) returned to mecha0117
mecha0117 collected $0.25 from pot
mecha0117: doesn't show hand 
*** SUMMARY ***
Total pot $0.25 | Rake $0 
Seat 1: SrPan89 (small blind) folded before Flop
Seat 2: senej (big blind) folded before Flop
Seat 3: DimaLesnoy folded before Flop (didn't bet)
Seat 4: mecha0117 collected ($0.25)
Seat 5: Vaha379 folded before Flop (didn't bet)
Seat 6: DIMON_ua_11 (button) folded before Flop (didn't bet)



PokerStars Hand #222961230023:  Hold'em No Limit ($0.05/$0.10 USD) - 2021/01/23 12:27:51 ET
Table 'Saito II' 6-max Seat #1 is the button
Seat 1: SrPan89 ($11.11 in chips) 
Seat 2: senej ($10 in chips) 
Seat 3: DimaLesnoy ($11.51 in chips) 
Seat 4: mecha0117 ($36.04 in chips) 
Seat 5: Vaha379 ($10 in chips) 
Seat 6: DIMON_ua_11 ($5.78 in chips) 
senej: posts small blind $0.05
DimaLesnoy: posts big blind $0.10
*** HOLE CARDS ***
mecha0117: folds 
Vaha379: raises $0.20 to $0.30
DIMON_ua_11: folds 
SrPan89: folds 
senej: folds 
DimaLesnoy: folds 
Uncalled bet ($0.20) returned to Vaha379
Vaha379 collected $0.25 from pot
Vaha379: doesn't show hand 
*** SUMMARY ***
Total pot $0.25 | Rake $0 
Seat 1: SrPan89 (button) folded before Flop (didn't bet)
Seat 2: senej (small blind) folded before Flop
Seat 3: DimaLesnoy (big blind) folded before Flop
Seat 4: mecha0117 folded before Flop (didn't bet)
Seat 5: Vaha379 collected ($0.25)
Seat 6: DIMON_ua_11 folded before Flop (didn't bet)



PokerStars Hand #222961240199:  Hold'em No Limit ($0.05/$0.10 USD) - 2021/01/23 12:28:07 ET
Table 'Saito II' 6-max Seat #2 is the button
Seat 1: SrPan89 ($11.11 in chips) 
Seat 2: senej ($10 in chips) 
Seat 3: DimaLesnoy ($11.41 in chips) 
Seat 4: mecha0117 ($36.04 in chips) 
Seat 5: Vaha379 ($10.15 in chips) 
Seat 6: DIMON_ua_11 ($5.78 in chips) 
DimaLesnoy: posts small blind $0.05
mecha0117: posts big blind $0.10
*** HOLE CARDS ***
Vaha379: folds 
DIMON_ua_11: folds 
SrPan89: raises $0.15 to $0.25
senej: folds 
DimaLesnoy: folds 
mecha0117: folds 
Uncalled bet ($0.15) returned to SrPan89
SrPan89 collected $0.25 from pot
SrPan89: doesn't show hand 
*** SUMMARY ***
Total pot $0.25 | Rake $0 
Seat 1: SrPan89 collected ($0.25)
Seat 2: senej (button) folded before Flop (didn't bet)
Seat 3: DimaLesnoy (small blind) folded before Flop
Seat 4: mecha0117 (big blind) folded before Flop
Seat 5: Vaha379 folded before Flop (didn't bet)
Seat 6: DIMON_ua_11 folded before Flop (didn't bet)



PokerStars Hand #222961251051:  Hold'em No Limit ($0.05/$0.10 USD) - 2021/01/23 12:28:23 ET
Table 'Saito II' 6-max Seat #3 is the button
Seat 1: SrPan89 ($11.26 in chips) 
Seat 2: senej ($10 in chips) 
Seat 3: DimaLesnoy ($11.36 in chips) 
Seat 4: mecha0117 ($35.94 in chips) 
Seat 5: Vaha379 ($10.15 in chips) 
Seat 6: DIMON_ua_11 ($5.78 in chips) 
mecha0117: posts small blind $0.05
Vaha379: posts big blind $0.10
*** HOLE CARDS ***
DIMON_ua_11: folds 
SrPan89: folds 
senej: folds 
DimaLesnoy: folds 
mecha0117: folds 
Uncalled bet ($0.05) returned to Vaha379
Vaha379 collected $0.10 from pot
Vaha379: doesn't show hand 
*** SUMMARY ***
Total pot $0.10 | Rake $0 
Seat 1: SrPan89 folded before Flop (didn't bet)
Seat 2: senej folded before Flop (didn't bet)
Seat 3: DimaLesnoy (button) folded before Flop (didn't bet)
Seat 4: mecha0117 (small blind) folded before Flop
Seat 5: Vaha379 (big blind) collected ($0.10)
Seat 6: DIMON_ua_11 folded before Flop (didn't bet)



PokerStars Hand #222961265144:  Hold'em No Limit ($0.05/$0.10 USD) - 2021/01/23 12:28:45 ET
Table 'Saito II' 6-max Seat #4 is the button
Seat 1: SrPan89 ($11.26 in chips) 
Seat 2: senej ($10 in chips) 
Seat 3: DimaLesnoy ($11.36 in chips) 
Seat 4: mecha0117 ($35.89 in chips) 
Seat 5: Vaha379 ($10.20 in chips) 
Seat 6: DIMON_ua_11 ($5.78 in chips) 
Vaha379: posts small blind $0.05
DIMON_ua_11: posts big blind $0.10
*** HOLE CARDS ***
SrPan89: folds 
SrPan89 leaves the table
senej: folds 
perespell joins the table at seat #1 
DimaLesnoy: raises $0.15 to $0.25
mecha0117: folds 
Vaha379: folds 
DIMON_ua_11: calls $0.15
*** FLOP *** [4d 7d Ah]
DIMON_ua_11: bets $0.27
DimaLesnoy: folds 
Uncalled bet ($0.27) returned to DIMON_ua_11
DIMON_ua_11 collected $0.53 from pot
DIMON_ua_11: doesn't show hand 
*** SUMMARY ***
Total pot $0.55 | Rake $0.02 
Board [4d 7d Ah]
Seat 1: SrPan89 folded before Flop (didn't bet)
Seat 2: senej folded before Flop (didn't bet)
Seat 3: DimaLesnoy folded on the Flop
Seat 4: mecha0117 (button) folded before Flop (didn't bet)
Seat 5: Vaha379 (small blind) folded before Flop
Seat 6: DIMON_ua_11 (big blind) collected ($0.53)



PokerStars Hand #222961284809:  Hold'em No Limit ($0.05/$0.10 USD) - 2021/01/23 12:29:15 ET
Table 'Saito II' 6-max Seat #5 is the button
Seat 1: perespell ($10 in chips) 
Seat 2: senej ($10 in chips) 
Seat 3: DimaLesnoy ($11.11 in chips) 
Seat 4: mecha0117 ($35.89 in chips) 
Seat 5: Vaha379 ($10.15 in chips) 
Seat 6: DIMON_ua_11 ($6.06 in chips) 
DIMON_ua_11: posts small blind $0.05
perespell: posts big blind $0.10
*** HOLE CARDS ***
senej: folds 
DimaLesnoy: folds 
mecha0117: folds 
Vaha379: folds 
DIMON_ua_11: folds 
Uncalled bet ($0.05) returned to perespell
perespell collected $0.10 from pot
perespell: doesn't show hand 
*** SUMMARY ***
Total pot $0.10 | Rake $0 
Seat 1: perespell (big blind) collected ($0.10)
Seat 2: senej folded before Flop (didn't bet)
Seat 3: DimaLesnoy folded before Flop (didn't bet)
Seat 4: mecha0117 folded before Flop (didn't bet)
Seat 5: Vaha379 (button) folded before Flop (didn't bet)
Seat 6: DIMON_ua_11 (small blind) folded before Flop



PokerStars Hand #222961293521:  Hold'em No Limit ($0.05/$0.10 USD) - 2021/01/23 12:29:29 ET
Table 'Saito II' 6-max Seat #6 is the button
Seat 1: perespell ($10.05 in chips) 
Seat 2: senej ($10 in chips) 
Seat 3: DimaLesnoy ($11.11 in chips) 
Seat 4: mecha0117 ($35.89 in chips) 
Seat 5: Vaha379 ($10.15 in chips) 
Seat 6: DIMON_ua_11 ($6.01 in chips) 
perespell: posts small blind $0.05
senej: posts big blind $0.10
*** HOLE CARDS ***
DimaLesnoy: folds 
mecha0117: folds 
Vaha379: raises $0.20 to $0.30
DIMON_ua_11: folds 
perespell: folds 
senej: folds 
Uncalled bet ($0.20) returned to Vaha379
Vaha379 collected $0.25 from pot
Vaha379: doesn't show hand 
*** SUMMARY ***
Total pot $0.25 | Rake $0 
Seat 1: perespell (small blind) folded before Flop
Seat 2: senej (big blind) folded before Flop
Seat 3: DimaLesnoy folded before Flop (didn't bet)
Seat 4: mecha0117 folded before Flop (didn't bet)
Seat 5: Vaha379 collected ($0.25)
Seat 6: DIMON_ua_11 (button) folded before Flop (didn't bet)



PokerStars Hand #222961304685:  Hold'em No Limit ($0.05/$0.10 USD) - 2021/01/23 12:29:46 ET
Table 'Saito II' 6-max Seat #1 is the button
Seat 1: perespell ($10 in chips) 
Seat 2: senej ($10 in chips) 
Seat 3: DimaLesnoy ($11.11 in chips) 
Seat 4: mecha0117 ($35.89 in chips) 
Seat 5: Vaha379 ($10.30 in chips) 
Seat 6: DIMON_ua_11 ($6.01 in chips) 
senej: posts small blind $0.05
DimaLesnoy: posts big blind $0.10
*** HOLE CARDS ***
mecha0117: raises $0.10 to $0.20
Vaha379: folds 
DIMON_ua_11: calls $0.20
perespell: folds 
senej: folds 
DimaLesnoy: folds 
*** FLOP *** [3c 8c Ts]
mecha0117: checks 
DIMON_ua_11: bets $0.40
mecha0117: calls $0.40
*** TURN *** [3c 8c Ts] [Kd]
mecha0117: checks 
DIMON_ua_11: checks 
*** RIVER *** [3c 8c Ts Kd] [2s]
mecha0117: checks 
DIMON_ua_11: checks 
*** SHOW DOWN ***
mecha0117: shows [7d 7h] (a pair of Sevens)
DIMON_ua_11: shows [9d 9s] (a pair of Nines)
DIMON_ua_11 collected $1.29 from pot
*** SUMMARY ***
Total pot $1.35 | Rake $0.06 
Board [3c 8c Ts Kd 2s]
Seat 1: perespell (button) folded before Flop (didn't bet)
Seat 2: senej (small blind) folded before Flop
Seat 3: DimaLesnoy (big blind) folded before Flop
Seat 4: mecha0117 showed [7d 7h] and lost with a pair of Sevens
Seat 5: Vaha379 folded before Flop (didn't bet)
Seat 6: DIMON_ua_11 showed [9d 9s] and won ($1.29) with a pair of Nines



PokerStars Hand #222961335656:  Hold'em No Limit ($0.05/$0.10 USD) - 2021/01/23 12:30:33 ET
Table 'Saito II' 6-max Seat #2 is the button
Seat 1: perespell ($10 in chips) 
Seat 2: senej ($10 in chips) 
Seat 3: DimaLesnoy ($11.01 in chips) 
Seat 5: Vaha379 ($10.30 in chips) 
Seat 6: DIMON_ua_11 ($6.70 in chips) 
DimaLesnoy: posts small blind $0.05
mecha0117: is sitting out 
Vaha379: posts big blind $0.10
*** HOLE CARDS ***
DIMON_ua_11: folds 
perespell: folds 
senej: folds 
DimaLesnoy: folds 
Uncalled bet ($0.05) returned to Vaha379
Vaha379 collected $0.10 from pot
Vaha379: doesn't show hand 
*** SUMMARY ***
Total pot $0.10 | Rake $0 
Seat 1: perespell folded before Flop (didn't bet)
Seat 2: senej (button) folded before Flop (didn't bet)
Seat 3: DimaLesnoy (small blind) folded before Flop
Seat 5: Vaha379 (big blind) collected ($0.10)
Seat 6: DIMON_ua_11 folded before Flop (didn't bet)



PokerStars Hand #222961340721:  Hold'em No Limit ($0.05/$0.10 USD) - 2021/01/23 12:30:41 ET
Table 'Saito II' 6-max Seat #3 is the button
Seat 1: perespell ($10 in chips) 
Seat 2: senej ($10 in chips) 
Seat 3: DimaLesnoy ($10.96 in chips) 
Seat 5: Vaha379 ($10.35 in chips) 
Seat 6: DIMON_ua_11 ($6.70 in chips) 
Vaha379: posts small blind $0.05
DIMON_ua_11: posts big blind $0.10
*** HOLE CARDS ***
mecha0117 leaves the table
perespell: folds 
senej: raises $0.20 to $0.30
DimaLesnoy: folds 
Vaha379: folds 
DIMON_ua_11: raises $0.70 to $1
senej: calls $0.70
*** FLOP *** [2c Qh 7s]
DIMON_ua_11: bets $1.96
senej: folds 
Uncalled bet ($1.96) returned to DIMON_ua_11
DIMON_ua_11 collected $1.96 from pot
DIMON_ua_11: doesn't show hand 
*** SUMMARY ***
Total pot $2.05 | Rake $0.09 
Board [2c Qh 7s]
Seat 1: perespell folded before Flop (didn't bet)
Seat 2: senej folded on the Flop
Seat 3: DimaLesnoy (button) folded before Flop (didn't bet)
Seat 5: Vaha379 (small blind) folded before Flop
Seat 6: DIMON_ua_11 (big blind) collected ($1.96)



PokerStars Hand #222961360022:  Hold'em No Limit ($0.05/$0.10 USD) - 2021/01/23 12:31:10 ET
Table 'Saito II' 6-max Seat #5 is the button
Seat 1: perespell ($10 in chips) 
Seat 2: senej ($10 in chips) 
Seat 3: DimaLesnoy ($10.96 in chips) 
Seat 5: Vaha379 ($10.30 in chips) 
perespell: posts small blind $0.05
senej: posts big blind $0.10
*** HOLE CARDS ***
Faya1993 joins the table at seat #4 
DimaLesnoy: folds 
Vaha379: folds 
perespell: raises $0.15 to $0.25
senej: folds 
Uncalled bet ($0.15) returned to perespell
perespell collected $0.20 from pot
perespell: doesn't show hand 
*** SUMMARY ***
Total pot $0.20 | Rake $0 
Seat 1: perespell (small blind) collected ($0.20)
Seat 2: senej (big blind) folded before Flop
Seat 3: DimaLesnoy folded before Flop (didn't bet)
Seat 5: Vaha379 (button) folded before Flop (didn't bet)



PokerStars Hand #222961375838:  Hold'em No Limit ($0.05/$0.10 USD) - 2021/01/23 12:31:33 ET
Table 'Saito II' 6-max Seat #1 is the button
Seat 1: perespell ($10.10 in chips) 
Seat 2: senej ($10 in chips) 
Seat 3: DimaLesnoy ($10.96 in chips) 
Seat 5: Vaha379 ($10.30 in chips) 
senej: posts small blind $0.05
DimaLesnoy: posts big blind $0.10
Faya1993: sits out 
*** HOLE CARDS ***
Vaha379: folds 
perespell: folds 
senej: raises $0.20 to $0.30
DimaLesnoy: folds 
Uncalled bet ($0.20) returned to senej
senej collected $0.20 from pot
senej: doesn't show hand 
*** SUMMARY ***
Total pot $0.20 | Rake $0 
Seat 1: perespell (button) folded before Flop (didn't bet)
Seat 2: senej (small blind) collected ($0.20)
Seat 3: DimaLesnoy (big blind) folded before Flop
Seat 5: Vaha379 folded before Flop (didn't bet)



PokerStars Hand #222961387750:  Hold'em No Limit ($0.05/$0.10 USD) - 2021/01/23 12:31:51 ET
Table 'Saito II' 6-max Seat #2 is the button
Seat 1: perespell ($10.10 in chips) 
Seat 2: senej ($10.10 in chips) 
Seat 3: DimaLesnoy ($10.86 in chips) 
Seat 4: Faya1993 ($10 in chips) 
Seat 5: Vaha379 ($10.30 in chips) 
DimaLesnoy: posts small blind $0.05
Faya1993: posts big blind $0.10
*** HOLE CARDS ***
Vaha379: raises $0.20 to $0.30
perespell: folds 
senej: folds 
DimaLesnoy: folds 
Faya1993: folds 
Uncalled bet ($0.20) returned to Vaha379
Vaha379 collected $0.25 from pot
Vaha379: doesn't show hand 
*** SUMMARY ***
Total pot $0.25 | Rake $0 
Seat 1: perespell folded before Flop (didn't bet)
Seat 2: senej (button) folded before Flop (didn't bet)
Seat 3: DimaLesnoy (small blind) folded before Flop
Seat 4: Faya1993 (big blind) folded before Flop
Seat 5: Vaha379 collected ($0.25)



PokerStars Hand #222961398011:  Hold'em No Limit ($0.05/$0.10 USD) - 2021/01/23 12:32:06 ET
Table 'Saito II' 6-max Seat #3 is the button
Seat 1: perespell ($10.10 in chips) 
Seat 2: senej ($10.10 in chips) 
Seat 3: DimaLesnoy ($10.81 in chips) 
Seat 4: Faya1993 ($9.90 in chips) 
Seat 5: Vaha379 ($10.45 in chips) 
Faya1993: posts small blind $0.05
Vaha379: posts big blind $0.10
*** HOLE CARDS ***
perespell: folds 
senej: raises $0.20 to $0.30
DimaLesnoy: folds 
Faya1993: folds 
Vaha379: folds 
Uncalled bet ($0.20) returned to senej
senej collected $0.25 from pot
senej: doesn't show hand 
*** SUMMARY ***
Total pot $0.25 | Rake $0 
Seat 1: perespell folded before Flop (didn't bet)
Seat 2: senej collected ($0.25)
Seat 3: DimaLesnoy (button) folded before Flop (didn't bet)
Seat 4: Faya1993 (small blind) folded before Flop
Seat 5: Vaha379 (big blind) folded before Flop



PokerStars Hand #222961412117:  Hold'em No Limit ($0.05/$0.10 USD) - 2021/01/23 12:32:28 ET
Table 'Saito II' 6-max Seat #4 is the button
Seat 1: perespell ($10.10 in chips) 
Seat 2: senej ($10.25 in chips) 
Seat 3: DimaLesnoy ($10.81 in chips) 
Seat 4: Faya1993 ($9.85 in chips) 
Seat 5: Vaha379 ($10.35 in chips) 
Seat 6: DIMON_ua_11 ($7.66 in chips) 
Vaha379: posts small blind $0.05
DIMON_ua_11: posts big blind $0.10
*** HOLE CARDS ***
perespell: raises $0.15 to $0.25
senej: raises $0.65 to $0.90
DimaLesnoy: folds 
Faya1993: folds 
Vaha379: folds 
DIMON_ua_11: folds 
perespell: folds 
Uncalled bet ($0.65) returned to senej
senej collected $0.65 from pot
senej: doesn't show hand 
*** SUMMARY ***
Total pot $0.65 | Rake $0 
Seat 1: perespell folded before Flop
Seat 2: senej collected ($0.65)
Seat 3: DimaLesnoy folded before Flop (didn't bet)
Seat 4: Faya1993 (button) folded before Flop (didn't bet)
Seat 5: Vaha379 (small blind) folded before Flop
Seat 6: DIMON_ua_11 (big blind) folded before Flop



PokerStars Hand #222961430208:  Hold'em No Limit ($0.05/$0.10 USD) - 2021/01/23 12:32:55 ET
Table 'Saito II' 6-max Seat #5 is the button
Seat 1: perespell ($10 in chips) 
Seat 2: senej ($10.65 in chips) 
Seat 3: DimaLesnoy ($10.81 in chips) 
Seat 4: Faya1993 ($9.85 in chips) 
Seat 5: Vaha379 ($10.30 in chips) 
Seat 6: DIMON_ua_11 ($7.56 in chips) 
DIMON_ua_11: posts small blind $0.05
perespell: posts big blind $0.10
*** HOLE CARDS ***
senej: folds 
DimaLesnoy: raises $0.20 to $0.30
Faya1993: calls $0.30
Vaha379: folds 
DIMON_ua_11: folds 
perespell: calls $0.20
*** FLOP *** [Js Tc Qh]
perespell: checks 
DimaLesnoy: bets $0.65
Faya1993: calls $0.65
perespell: folds 
*** TURN *** [Js Tc Qh] [Qs]
DimaLesnoy: bets $2
Faya1993: calls $2
*** RIVER *** [Js Tc Qh Qs] [5h]
DimaLesnoy: bets $1.67
Faya1993: raises $1.67 to $3.34
DimaLesnoy: raises $4.52 to $7.86 and is all-in
Faya1993: calls $3.56 and is all-in
Uncalled bet ($0.96) returned to DimaLesnoy
*** SHOW DOWN ***
DimaLesnoy: shows [Jd Qc] (a full house, Queens full of Jacks)
Faya1993: shows [Kc Kd] (two pair, Kings and Queens)
DimaLesnoy collected $19.15 from pot
*** SUMMARY ***
Total pot $20.05 | Rake $0.90 
Board [Js Tc Qh Qs 5h]
Seat 1: perespell (big blind) folded on the Flop
Seat 2: senej folded before Flop (didn't bet)
Seat 3: DimaLesnoy showed [Jd Qc] and won ($19.15) with a full house, Queens full of Jacks
Seat 4: Faya1993 showed [Kc Kd] and lost with two pair, Kings and Queens
Seat 5: Vaha379 (button) folded before Flop (didn't bet)
Seat 6: DIMON_ua_11 (small blind) folded before Flop



PokerStars Hand #222961458467:  Hold'em No Limit ($0.05/$0.10 USD) - 2021/01/23 12:33:37 ET
Table 'Saito II' 6-max Seat #1 is the button
Seat 1: perespell ($10 in chips) 
Seat 2: senej ($10.65 in chips) 
Seat 3: DimaLesnoy ($20.11 in chips) 
Seat 5: Vaha379 ($10.30 in chips) 
senej: posts small blind $0.05
DimaLesnoy: posts big blind $0.10
*** HOLE CARDS ***
Vaha379: folds 
perespell: folds 
senej: folds 
Uncalled bet ($0.05) returned to DimaLesnoy
DimaLesnoy collected $0.10 from pot
DimaLesnoy: doesn't show hand 
*** SUMMARY ***
Total pot $0.10 | Rake $0 
Seat 1: perespell (button) folded before Flop (didn't bet)
Seat 2: senej (small blind) folded before Flop
Seat 3: DimaLesnoy (big blind) collected ($0.10)
Seat 5: Vaha379 folded before Flop (didn't bet)



PokerStars Hand #222961463556:  Hold'em No Limit ($0.05/$0.10 USD) - 2021/01/23 12:33:45 ET
Table 'Saito II' 6-max Seat #2 is the button
Seat 1: perespell ($10 in chips) 
Seat 2: senej ($10.60 in chips) 
Seat 3: DimaLesnoy ($20.16 in chips) 
Seat 5: Vaha379 ($10.30 in chips) 
DimaLesnoy: posts small blind $0.05
Vaha379: posts big blind $0.10
*** HOLE CARDS ***
perespell: folds 
senej: folds 
DimaLesnoy: raises $0.20 to $0.30
Vaha379: raises $0.70 to $1
DimaLesnoy: folds 
Uncalled bet ($0.70) returned to Vaha379
Vaha379 collected $0.60 from pot
Vaha379: doesn't show hand 
*** SUMMARY ***
Total pot $0.60 | Rake $0 
Seat 1: perespell folded before Flop (didn't bet)
Seat 2: senej (button) folded before Flop (didn't bet)
Seat 3: DimaLesnoy (small blind) folded before Flop
Seat 5: Vaha379 (big blind) collected ($0.60)



PokerStars Hand #222961472378:  Hold'em No Limit ($0.05/$0.10 USD) - 2021/01/23 12:33:58 ET
Table 'Saito II' 6-max Seat #3 is the button
Seat 1: perespell ($10 in chips) 
Seat 2: senej ($10.60 in chips) 
Seat 3: DimaLesnoy ($19.86 in chips) 
Seat 5: Vaha379 ($10.60 in chips) 
Vaha379: posts small blind $0.05
perespell: posts big blind $0.10
*** HOLE CARDS ***
senej: folds 
DIMON_ua_11 leaves the table
DimaLesnoy: folds 
flushinAA joins the table at seat #6 
Faya1993 is disconnected 
Vaha379: folds 
Uncalled bet ($0.05) returned to perespell
perespell collected $0.10 from pot
perespell: doesn't show hand 
*** SUMMARY ***
Total pot $0.10 | Rake $0 
Seat 1: perespell (big blind) collected ($0.10)
Seat 2: senej folded before Flop (didn't bet)
Seat 3: DimaLesnoy (button) folded before Flop (didn't bet)
Seat 5: Vaha379 (small blind) folded before Flop



PokerStars Hand #222961499624:  Hold'em No Limit ($0.05/$0.10 USD) - 2021/01/23 12:34:38 ET
Table 'Saito II' 6-max Seat #5 is the button
Seat 1: perespell ($10.05 in chips) 
Seat 2: senej ($10.60 in chips) 
Seat 3: DimaLesnoy ($19.86 in chips) 
Seat 5: Vaha379 ($10.55 in chips) 
perespell: posts small blind $0.05
senej: posts big blind $0.10
*** HOLE CARDS ***
DimaLesnoy: folds 
Vaha379: folds 
perespell: raises $0.15 to $0.25
senej: folds 
Uncalled bet ($0.15) returned to perespell
perespell collected $0.20 from pot
perespell: doesn't show hand 
*** SUMMARY ***
Total pot $0.20 | Rake $0 
Seat 1: perespell (small blind) collected ($0.20)
Seat 2: senej (big blind) folded before Flop
Seat 3: DimaLesnoy folded before Flop (didn't bet)
Seat 5: Vaha379 (button) folded before Flop (didn't bet)



PokerStars Hand #222961510425:  Hold'em No Limit ($0.05/$0.10 USD) - 2021/01/23 12:34:55 ET
Table 'Saito II' 6-max Seat #1 is the button
Seat 1: perespell ($10.15 in chips) 
Seat 2: senej ($10.50 in chips) 
Seat 3: DimaLesnoy ($19.86 in chips) 
Seat 5: Vaha379 ($10.55 in chips) 
senej: posts small blind $0.05
DimaLesnoy: posts big blind $0.10
flushinAA: sits out 
*** HOLE CARDS ***
Vaha379: folds 
perespell: raises $0.15 to $0.25
senej: calls $0.20
DimaLesnoy: folds 
*** FLOP *** [8h 3h 2d]
senej: checks 
perespell: bets $0.29
senej: calls $0.29
*** TURN *** [8h 3h 2d] [9h]
senej: checks 
perespell: checks 
*** RIVER *** [8h 3h 2d 9h] [Tc]
senej: checks 
perespell: bets $0.86
senej: raises $2.34 to $3.20
perespell: folds 
Uncalled bet ($2.34) returned to senej
senej collected $2.77 from pot
senej: doesn't show hand 
*** SUMMARY ***
Total pot $2.90 | Rake $0.13 
Board [8h 3h 2d 9h Tc]
Seat 1: perespell (button) folded on the River
Seat 2: senej (small blind) collected ($2.77)
Seat 3: DimaLesnoy (big blind) folded before Flop
Seat 5: Vaha379 folded before Flop (didn't bet)



PokerStars Hand #222961550199:  Hold'em No Limit ($0.05/$0.10 USD) - 2021/01/23 12:35:54 ET
Table 'Saito II' 6-max Seat #2 is the button
Seat 1: perespell ($10 in chips) 
Seat 2: senej ($11.87 in chips) 
Seat 3: DimaLesnoy ($19.76 in chips) 
Seat 5: Vaha379 ($10.55 in chips) 
DimaLesnoy: posts small blind $0.05
Vaha379: posts big blind $0.10
flushinAA: sits out 
*** HOLE CARDS ***
perespell: raises $0.15 to $0.25
senej: folds 
DimaLesnoy: folds 
Vaha379: calls $0.15
*** FLOP *** [3s 8s Td]
Vaha379: checks 
perespell: checks 
*** TURN *** [3s 8s Td] [Ah]
Vaha379: checks 
perespell: checks 
*** RIVER *** [3s 8s Td Ah] [6s]
Vaha379: checks 
perespell: checks 
*** SHOW DOWN ***
Vaha379: shows [Th Jc] (a pair of Tens)
perespell: mucks hand 
Vaha379 collected $0.53 from pot
*** SUMMARY ***
Total pot $0.55 | Rake $0.02 
Board [3s 8s Td Ah 6s]
Seat 1: perespell mucked
Seat 2: senej (button) folded before Flop (didn't bet)
Seat 3: DimaLesnoy (small blind) folded before Flop
Seat 5: Vaha379 (big blind) showed [Th Jc] and won ($0.53) with a pair of Tens



PokerStars Hand #222961564490:  Hold'em No Limit ($0.05/$0.10 USD) - 2021/01/23 12:36:15 ET
Table 'Saito II' 6-max Seat #3 is the button
Seat 1: perespell ($10 in chips) 
Seat 2: senej ($11.87 in chips) 
Seat 3: DimaLesnoy ($19.71 in chips) 
Seat 5: Vaha379 ($10.83 in chips) 
Seat 6: flushinAA ($6 in chips) 
Vaha379: posts small blind $0.05
flushinAA: posts big blind $0.10
*** HOLE CARDS ***
perespell: folds 
senej: folds 
DimaLesnoy: folds 
Vaha379: raises $0.20 to $0.30
flushinAA: folds 
Uncalled bet ($0.20) returned to Vaha379
Vaha379 collected $0.20 from pot
Vaha379: doesn't show hand 
*** SUMMARY ***
Total pot $0.20 | Rake $0 
Seat 1: perespell folded before Flop (didn't bet)
Seat 2: senej folded before Flop (didn't bet)
Seat 3: DimaLesnoy (button) folded before Flop (didn't bet)
Seat 5: Vaha379 (small blind) collected ($0.20)
Seat 6: flushinAA (big blind) folded before Flop



PokerStars Hand #222961572838:  Hold'em No Limit ($0.05/$0.10 USD) - 2021/01/23 12:36:28 ET
Table 'Saito II' 6-max Seat #5 is the button
Seat 1: perespell ($10 in chips) 
Seat 2: senej ($11.87 in chips) 
Seat 3: DimaLesnoy ($19.71 in chips) 
Seat 5: Vaha379 ($10.93 in chips) 
Seat 6: flushinAA ($5.90 in chips) 
flushinAA: posts small blind $0.05
perespell: posts big blind $0.10
*** HOLE CARDS ***
senej: raises $0.20 to $0.30
DimaLesnoy: folds 
Vaha379: folds 
flushinAA: calls $0.25
perespell: folds 
*** FLOP *** [6c 5h 9s]
flushinAA: checks 
senej: bets $0.45
flushinAA: calls $0.45
*** TURN *** [6c 5h 9s] [As]
flushinAA: checks 
senej: bets $1.02
flushinAA: folds 
Uncalled bet ($1.02) returned to senej
senej collected $1.53 from pot
senej: doesn't show hand 
*** SUMMARY ***
Total pot $1.60 | Rake $0.07 
Board [6c 5h 9s As]
Seat 1: perespell (big blind) folded before Flop
Seat 2: senej collected ($1.53)
Seat 3: DimaLesnoy folded before Flop (didn't bet)
Seat 5: Vaha379 (button) folded before Flop (didn't bet)
Seat 6: flushinAA (small blind) folded on the Turn



PokerStars Hand #222961588377:  Hold'em No Limit ($0.05/$0.10 USD) - 2021/01/23 12:36:51 ET
Table 'Saito II' 6-max Seat #6 is the button
Seat 1: perespell ($10 in chips) 
Seat 2: senej ($12.65 in chips) 
Seat 3: DimaLesnoy ($19.71 in chips) 
Seat 5: Vaha379 ($10.93 in chips) 
Seat 6: flushinAA ($5.15 in chips) 
perespell: posts small blind $0.05
senej: posts big blind $0.10
*** HOLE CARDS ***
DimaLesnoy: folds 
Vaha379: folds 
flushinAA: raises $0.10 to $0.20
perespell: folds 
senej: folds 
Uncalled bet ($0.10) returned to flushinAA
flushinAA collected $0.25 from pot
flushinAA: doesn't show hand 
*** SUMMARY ***
Total pot $0.25 | Rake $0 
Seat 1: perespell (small blind) folded before Flop
Seat 2: senej (big blind) folded before Flop
Seat 3: DimaLesnoy folded before Flop (didn't bet)
Seat 5: Vaha379 folded before Flop (didn't bet)
Seat 6: flushinAA (button) collected ($0.25)



PokerStars Hand #222961593589:  Hold'em No Limit ($0.05/$0.10 USD) - 2021/01/23 12:36:59 ET
Table 'Saito II' 6-max Seat #1 is the button
Seat 1: perespell ($10 in chips) 
Seat 2: senej ($12.55 in chips) 
Seat 3: DimaLesnoy ($19.71 in chips) 
Seat 5: Vaha379 ($10.93 in chips) 
Seat 6: flushinAA ($5.30 in chips) 
senej: posts small blind $0.05
DimaLesnoy: posts big blind $0.10
*** HOLE CARDS ***
Vaha379: folds 
flushinAA: folds 
perespell: raises $0.15 to $0.25
senej: folds 
DimaLesnoy: raises $0.65 to $0.90
perespell: folds 
Uncalled bet ($0.65) returned to DimaLesnoy
DimaLesnoy collected $0.55 from pot
DimaLesnoy: doesn't show hand 
*** SUMMARY ***
Total pot $0.55 | Rake $0 
Seat 1: perespell (button) folded before Flop
Seat 2: senej (small blind) folded before Flop
Seat 3: DimaLesnoy (big blind) collected ($0.55)
Seat 5: Vaha379 folded before Flop (didn't bet)
Seat 6: flushinAA folded before Flop (didn't bet)



PokerStars Hand #222961603627:  Hold'em No Limit ($0.05/$0.10 USD) - 2021/01/23 12:37:14 ET
Table 'Saito II' 6-max Seat #2 is the button
Seat 1: perespell ($10 in chips) 
Seat 2: senej ($12.50 in chips) 
Seat 3: DimaLesnoy ($20.01 in chips) 
Seat 5: Vaha379 ($10.93 in chips) 
Seat 6: flushinAA ($5.30 in chips) 
DimaLesnoy: posts small blind $0.05
Vaha379: posts big blind $0.10
*** HOLE CARDS ***
flushinAA: folds 
perespell: raises $0.15 to $0.25
senej: calls $0.25
DimaLesnoy: folds 
Vaha379: folds 
*** FLOP *** [4h 7d Qd]
perespell: checks 
senej: bets $0.41
perespell: folds 
Uncalled bet ($0.41) returned to senej
senej collected $0.62 from pot
senej: doesn't show hand 
*** SUMMARY ***
Total pot $0.65 | Rake $0.03 
Board [4h 7d Qd]
Seat 1: perespell folded on the Flop
Seat 2: senej (button) collected ($0.62)
Seat 3: DimaLesnoy (small blind) folded before Flop
Seat 5: Vaha379 (big blind) folded before Flop
Seat 6: flushinAA folded before Flop (didn't bet)



PokerStars Hand #222961624413:  Hold'em No Limit ($0.05/$0.10 USD) - 2021/01/23 12:37:45 ET
Table 'Saito II' 6-max Seat #3 is the button
Seat 1: perespell ($10 in chips) 
Seat 2: senej ($12.87 in chips) 
Seat 3: DimaLesnoy ($19.96 in chips) 
Seat 5: Vaha379 ($10.83 in chips) 
Seat 6: flushinAA ($5.30 in chips) 
Vaha379: posts small blind $0.05
flushinAA: posts big blind $0.10
*** HOLE CARDS ***
perespell: folds 
senej: folds 
DimaLesnoy: raises $0.12 to $0.22
Vaha379: folds 
flushinAA: calls $0.12
*** FLOP *** [2d 4h 9c]
flushinAA: checks 
DimaLesnoy: checks 
*** TURN *** [2d 4h 9c] [Ad]
flushinAA: checks 
DimaLesnoy: bets $0.13
flushinAA: folds 
Uncalled bet ($0.13) returned to DimaLesnoy
DimaLesnoy collected $0.47 from pot
DimaLesnoy: doesn't show hand 
*** SUMMARY ***
Total pot $0.49 | Rake $0.02 
Board [2d 4h 9c Ad]
Seat 1: perespell folded before Flop (didn't bet)
Seat 2: senej folded before Flop (didn't bet)
Seat 3: DimaLesnoy (button) collected ($0.47)
Seat 5: Vaha379 (small blind) folded before Flop
Seat 6: flushinAA (big blind) folded on the Turn



PokerStars Hand #222961662265:  Hold'em No Limit ($0.05/$0.10 USD) - 2021/01/23 12:38:41 ET
Table 'Saito II' 6-max Seat #5 is the button
Seat 1: perespell ($10 in chips) 
Seat 2: senej ($12.87 in chips) 
Seat 3: DimaLesnoy ($20.21 in chips) 
Seat 5: Vaha379 ($10.78 in chips) 
Seat 6: flushinAA ($5.08 in chips) 
flushinAA: posts small blind $0.05
perespell: posts big blind $0.10
*** HOLE CARDS ***
senej: raises $0.20 to $0.30
DimaLesnoy: folds 
Vaha379: calls $0.30
flushinAA: folds 
perespell: folds 
*** FLOP *** [Kh 7s 8c]
senej: bets $0.48
Vaha379: calls $0.48
*** TURN *** [Kh 7s 8c] [7d]
senej: bets $1.09
Vaha379: folds 
Uncalled bet ($1.09) returned to senej
senej collected $1.63 from pot
senej: doesn't show hand 
*** SUMMARY ***
Total pot $1.71 | Rake $0.08 
Board [Kh 7s 8c 7d]
Seat 1: perespell (big blind) folded before Flop
Seat 2: senej collected ($1.63)
Seat 3: DimaLesnoy folded before Flop (didn't bet)
Seat 5: Vaha379 (button) folded on the Turn
Seat 6: flushinAA (small blind) folded before Flop



PokerStars Hand #222961683016:  Hold'em No Limit ($0.05/$0.10 USD) - 2021/01/23 12:39:12 ET
Table 'Saito II' 6-max Seat #6 is the button
Seat 1: perespell ($10 in chips) 
Seat 2: senej ($13.72 in chips) 
Seat 3: DimaLesnoy ($20.21 in chips) 
Seat 5: Vaha379 ($10 in chips) 
Seat 6: flushinAA ($5.03 in chips) 
perespell: posts small blind $0.05
senej: posts big blind $0.10
*** HOLE CARDS ***
DimaLesnoy: folds 
Vaha379: raises $0.20 to $0.30
flushinAA: calls $0.30
perespell: folds 
senej: folds 
*** FLOP *** [5c 7c 9c]
Vaha379: checks 
flushinAA: bets $0.36
Vaha379: calls $0.36
*** TURN *** [5c 7c 9c] [4c]
Vaha379: checks 
flushinAA: bets $0.70
Vaha379: folds 
Uncalled bet ($0.70) returned to flushinAA
flushinAA collected $1.40 from pot
flushinAA: doesn't show hand 
*** SUMMARY ***
Total pot $1.47 | Rake $0.07 
Board [5c 7c 9c 4c]
Seat 1: perespell (small blind) folded before Flop
Seat 2: senej (big blind) folded before Flop
Seat 3: DimaLesnoy folded before Flop (didn't bet)
Seat 5: Vaha379 folded on the Turn
Seat 6: flushinAA (button) collected ($1.40)



PokerStars Hand #222961708896:  Hold'em No Limit ($0.05/$0.10 USD) - 2021/01/23 12:39:50 ET
Table 'Saito II' 6-max Seat #1 is the button
Seat 1: perespell ($10 in chips) 
Seat 2: senej ($13.62 in chips) 
Seat 3: DimaLesnoy ($20.21 in chips) 
Seat 5: Vaha379 ($9.34 in chips) 
Seat 6: flushinAA ($5.77 in chips) 
senej: posts small blind $0.05
DimaLesnoy: posts big blind $0.10
*** HOLE CARDS ***
Vaha379: folds 
flushinAA: raises $0.10 to $0.20
perespell: folds 
senej: folds 
DimaLesnoy: calls $0.10
*** FLOP *** [9d 7h Kh]
DimaLesnoy: checks 
flushinAA: checks 
*** TURN *** [9d 7h Kh] [4d]
DimaLesnoy: checks 
flushinAA: checks 
*** RIVER *** [9d 7h Kh 4d] [Ac]
DimaLesnoy: checks 
flushinAA: bets $0.30
DimaLesnoy: folds 
Uncalled bet ($0.30) returned to flushinAA
flushinAA collected $0.43 from pot
flushinAA: doesn't show hand 
*** SUMMARY ***
Total pot $0.45 | Rake $0.02 
Board [9d 7h Kh 4d Ac]
Seat 1: perespell (button) folded before Flop (didn't bet)
Seat 2: senej (small blind) folded before Flop
Seat 3: DimaLesnoy (big blind) folded on the River
Seat 5: Vaha379 folded before Flop (didn't bet)
Seat 6: flushinAA collected ($0.43)



PokerStars Hand #222961727416:  Hold'em No Limit ($0.05/$0.10 USD) - 2021/01/23 12:40:18 ET
Table 'Saito II' 6-max Seat #2 is the button
Seat 1: perespell ($10 in chips) 
Seat 2: senej ($13.57 in chips) 
Seat 3: DimaLesnoy ($20.01 in chips) 
Seat 5: Vaha379 ($10 in chips) 
Seat 6: flushinAA ($6 in chips) 
DimaLesnoy: posts small blind $0.05
Vaha379: posts big blind $0.10
*** HOLE CARDS ***
flushinAA: folds 
perespell: folds 
senej: raises $0.20 to $0.30
DimaLesnoy: folds 
Vaha379: folds 
Uncalled bet ($0.20) returned to senej
senej collected $0.25 from pot
Faya1993 was removed from the table for failing to post
Faya1993 leaves the table
senej: doesn't show hand 
*** SUMMARY ***
Total pot $0.25 | Rake $0 
Seat 1: perespell folded before Flop (didn't bet)
Seat 2: senej (button) collected ($0.25)
Seat 3: DimaLesnoy (small blind) folded before Flop
Seat 5: Vaha379 (big blind) folded before Flop
Seat 6: flushinAA folded before Flop (didn't bet)



PokerStars Hand #222961735123:  Hold'em No Limit ($0.05/$0.10 USD) - 2021/01/23 12:40:29 ET
Table 'Saito II' 6-max Seat #3 is the button
Seat 1: perespell ($10 in chips) 
Seat 2: senej ($13.72 in chips) 
Seat 3: DimaLesnoy ($19.96 in chips) 
Seat 5: Vaha379 ($9.90 in chips) 
Seat 6: flushinAA ($6 in chips) 
Vaha379: posts small blind $0.05
flushinAA: posts big blind $0.10
*** HOLE CARDS ***
perespell: raises $0.15 to $0.25
senej: folds 
DimaLesnoy: calls $0.25
Vaha379: folds 
flushinAA: calls $0.15
*** FLOP *** [8c 4d 9h]
flushinAA: checks 
perespell: checks 
DimaLesnoy: checks 
*** TURN *** [8c 4d 9h] [2s]
flushinAA: checks 
perespell: checks 
Aquansk joins the table at seat #4 
DimaLesnoy: checks 
*** RIVER *** [8c 4d 9h 2s] [9d]
flushinAA: checks 
perespell: checks 
DimaLesnoy: checks 
*** SHOW DOWN ***
flushinAA: shows [2c 6c] (two pair, Nines and Deuces)
perespell: mucks hand 
DimaLesnoy: shows [5h 5d] (two pair, Nines and Fives)
DimaLesnoy collected $0.76 from pot
*** SUMMARY ***
Total pot $0.80 | Rake $0.04 
Board [8c 4d 9h 2s 9d]
Seat 1: perespell mucked
Seat 2: senej folded before Flop (didn't bet)
Seat 3: DimaLesnoy (button) showed [5h 5d] and won ($0.76) with two pair, Nines and Fives
Seat 5: Vaha379 (small blind) folded before Flop
Seat 6: flushinAA (big blind) showed [2c 6c] and lost with two pair, Nines and Deuces



PokerStars Hand #222961767109:  Hold'em No Limit ($0.05/$0.10 USD) - 2021/01/23 12:41:17 ET
Table 'Saito II' 6-max Seat #5 is the button
Seat 1: perespell ($10 in chips) 
Seat 2: senej ($13.72 in chips) 
Seat 3: DimaLesnoy ($20.47 in chips) 
Seat 4: Aquansk ($5.71 in chips) 
Seat 5: Vaha379 ($9.85 in chips) 
Seat 6: flushinAA ($5.75 in chips) 
flushinAA: posts small blind $0.05
perespell: posts big blind $0.10
Aquansk: posts big blind $0.10
*** HOLE CARDS ***
senej: raises $0.20 to $0.30
DimaLesnoy: folds 
Aquansk: calls $0.20
Vaha379: folds 
flushinAA: folds 
perespell: folds 
*** FLOP *** [5s 6d 9c]
senej: bets $0.48
Aquansk: folds 
Uncalled bet ($0.48) returned to senej
senej collected $0.72 from pot
senej: doesn't show hand 
*** SUMMARY ***
Total pot $0.75 | Rake $0.03 
Board [5s 6d 9c]
Seat 1: perespell (big blind) folded before Flop
Seat 2: senej collected ($0.72)
Seat 3: DimaLesnoy folded before Flop (didn't bet)
Seat 4: Aquansk folded on the Flop
Seat 5: Vaha379 (button) folded before Flop (didn't bet)
Seat 6: flushinAA (small blind) folded before Flop



PokerStars Hand #222961788948:  Hold'em No Limit ($0.05/$0.10 USD) - 2021/01/23 12:41:49 ET
Table 'Saito II' 6-max Seat #6 is the button
Seat 1: perespell ($10 in chips) 
Seat 2: senej ($14.14 in chips) 
Seat 3: DimaLesnoy ($20.47 in chips) 
Seat 4: Aquansk ($5.41 in chips) 
Seat 5: Vaha379 ($10 in chips) 
Seat 6: flushinAA ($5.70 in chips) 
perespell: posts small blind $0.05
senej: posts big blind $0.10
*** HOLE CARDS ***
DimaLesnoy: folds 
Aquansk: folds 
Vaha379: folds 
flushinAA: raises $0.10 to $0.20
perespell: folds 
senej: folds 
Uncalled bet ($0.10) returned to flushinAA
flushinAA collected $0.25 from pot
flushinAA: doesn't show hand 
*** SUMMARY ***
Total pot $0.25 | Rake $0 
Seat 1: perespell (small blind) folded before Flop
Seat 2: senej (big blind) folded before Flop
Seat 3: DimaLesnoy folded before Flop (didn't bet)
Seat 4: Aquansk folded before Flop (didn't bet)
Seat 5: Vaha379 folded before Flop (didn't bet)
Seat 6: flushinAA (button) collected ($0.25)



PokerStars Hand #222964011487:  Hold'em No Limit ($0.05/$0.10 USD) - 2021/01/23 13:35:03 ET
Table 'Saito II' 6-max Seat #4 is the button
Seat 4: Nordic2154 ($10.30 in chips) 
Seat 5: pondax ($10 in chips) 
Nordic2154: posts small blind $0.05
pondax: posts big blind $0.10
*** HOLE CARDS ***
Nordic2154: folds 
Uncalled bet ($0.05) returned to pondax
pondax collected $0.10 from pot
pondax: doesn't show hand 
*** SUMMARY ***
Total pot $0.10 | Rake $0 
Seat 4: Nordic2154 (button) (small blind) folded before Flop
Seat 5: pondax (big blind) collected ($0.10)



PokerStars Hand #222964016389:  Hold'em No Limit ($0.05/$0.10 USD) - 2021/01/23 13:35:10 ET
Table 'Saito II' 6-max Seat #5 is the button
Seat 4: Nordic2154 ($10.25 in chips) 
Seat 5: pondax ($10.05 in chips) 
pondax: posts small blind $0.05
Nordic2154: posts big blind $0.10
*** HOLE CARDS ***
pondax: folds 
Uncalled bet ($0.05) returned to Nordic2154
Nordic2154 collected $0.10 from pot
Nordic2154: doesn't show hand 
*** SUMMARY ***
Total pot $0.10 | Rake $0 
Seat 4: Nordic2154 (big blind) collected ($0.10)
Seat 5: pondax (button) (small blind) folded before Flop



PokerStars Hand #222964027162:  Hold'em No Limit ($0.05/$0.10 USD) - 2021/01/23 13:35:23 ET
Table 'Saito II' 6-max Seat #4 is the button
Seat 4: Nordic2154 ($10.30 in chips) 
Seat 5: pondax ($10 in chips) 
Nordic2154: posts small blind $0.05
pondax: posts big blind $0.10
*** HOLE CARDS ***
Nordic2154: raises $0.15 to $0.25
pondax: folds 
Uncalled bet ($0.15) returned to Nordic2154
Nordic2154 collected $0.20 from pot
Nordic2154: doesn't show hand 
*** SUMMARY ***
Total pot $0.20 | Rake $0 
Seat 4: Nordic2154 (button) (small blind) collected ($0.20)
Seat 5: pondax (big blind) folded before Flop



PokerStars Hand #222961798715:  Hold'em No Limit ($0.05/$0.10 USD) - 2021/01/23 12:42:04 ET
Table 'Saito II' 6-max Seat #1 is the button
Seat 1: perespell ($10 in chips) 
Seat 2: senej ($14.04 in chips) 
Seat 3: DimaLesnoy ($20.47 in chips) 
Seat 4: Aquansk ($5.41 in chips) 
Seat 5: Vaha379 ($10 in chips) 
Seat 6: flushinAA ($5.85 in chips) 
senej: posts small blind $0.05
DimaLesnoy: posts big blind $0.10
*** HOLE CARDS ***
Aquansk: calls $0.10
Vaha379: folds 
flushinAA: calls $0.10
perespell: folds 
senej: folds 
DimaLesnoy: raises $0.50 to $0.60
Aquansk: calls $0.50
flushinAA: calls $0.50
*** FLOP *** [6s 6d 4d]
DimaLesnoy: checks 
Aquansk: bets $0.20
flushinAA: folds 
DimaLesnoy: calls $0.20
*** TURN *** [6s 6d 4d] [8h]
DimaLesnoy: checks 
Aquansk: bets $1.07
DimaLesnoy: folds 
Uncalled bet ($1.07) returned to Aquansk
Aquansk collected $2.15 from pot
Aquansk: doesn't show hand 
*** SUMMARY ***
Total pot $2.25 | Rake $0.10 
Board [6s 6d 4d 8h]
Seat 1: perespell (button) folded before Flop (didn't bet)
Seat 2: senej (small blind) folded before Flop
Seat 3: DimaLesnoy (big blind) folded on the Turn
Seat 4: Aquansk collected ($2.15)
Seat 5: Vaha379 folded before Flop (didn't bet)
Seat 6: flushinAA folded on the Flop



PokerStars Hand #222961829390:  Hold'em No Limit ($0.05/$0.10 USD) - 2021/01/23 12:42:49 ET
Table 'Saito II' 6-max Seat #2 is the button
Seat 1: perespell ($10 in chips) 
Seat 2: senej ($13.99 in chips) 
Seat 3: DimaLesnoy ($19.67 in chips) 
Seat 4: Aquansk ($6.76 in chips) 
Seat 5: Vaha379 ($10 in chips) 
Seat 6: flushinAA ($5.25 in chips) 
DimaLesnoy: posts small blind $0.05
Aquansk: posts big blind $0.10
*** HOLE CARDS ***
Vaha379: folds 
flushinAA: raises $0.10 to $0.20
perespell: folds 
senej: folds 
DimaLesnoy: folds 
Aquansk: calls $0.10
*** FLOP *** [Kh 5c Js]
Aquansk: checks 
flushinAA: bets $0.30
Aquansk: folds 
Uncalled bet ($0.30) returned to flushinAA
flushinAA collected $0.43 from pot
flushinAA: doesn't show hand 
*** SUMMARY ***
Total pot $0.45 | Rake $0.02 
Board [Kh 5c Js]
Seat 1: perespell folded before Flop (didn't bet)
Seat 2: senej (button) folded before Flop (didn't bet)
Seat 3: DimaLesnoy (small blind) folded before Flop
Seat 4: Aquansk (big blind) folded on the Flop
Seat 5: Vaha379 folded before Flop (didn't bet)
Seat 6: flushinAA collected ($0.43)



PokerStars Hand #222961851166:  Hold'em No Limit ($0.05/$0.10 USD) - 2021/01/23 12:43:22 ET
Table 'Saito II' 6-max Seat #3 is the button
Seat 1: perespell ($10 in chips) 
Seat 2: senej ($13.99 in chips) 
Seat 3: DimaLesnoy ($19.62 in chips) 
Seat 4: Aquansk ($6.56 in chips) 
Seat 5: Vaha379 ($10 in chips) 
Seat 6: flushinAA ($5.48 in chips) 
Aquansk: posts small blind $0.05
Vaha379: posts big blind $0.10
*** HOLE CARDS ***
flushinAA: folds 
perespell: folds 
senej: folds 
DimaLesnoy: folds 
Aquansk: calls $0.05
Vaha379: checks 
*** FLOP *** [6c 9s 2s]
Aquansk: bets $0.10
Vaha379: calls $0.10
*** TURN *** [6c 9s 2s] [Qh]
Aquansk: bets $0.10
Vaha379: folds 
Uncalled bet ($0.10) returned to Aquansk
Aquansk collected $0.38 from pot
Aquansk: doesn't show hand 
*** SUMMARY ***
Total pot $0.40 | Rake $0.02 
Board [6c 9s 2s Qh]
Seat 1: perespell folded before Flop (didn't bet)
Seat 2: senej folded before Flop (didn't bet)
Seat 3: DimaLesnoy (button) folded before Flop (didn't bet)
Seat 4: Aquansk (small blind) collected ($0.38)
Seat 5: Vaha379 (big blind) folded on the Turn
Seat 6: flushinAA folded before Flop (didn't bet)



PokerStars Hand #222961869669:  Hold'em No Limit ($0.05/$0.10 USD) - 2021/01/23 12:43:49 ET
Table 'Saito II' 6-max Seat #4 is the button
Seat 1: perespell ($10 in chips) 
Seat 2: senej ($13.99 in chips) 
Seat 3: DimaLesnoy ($19.62 in chips) 
Seat 4: Aquansk ($6.74 in chips) 
Seat 5: Vaha379 ($9.80 in chips) 
Seat 6: flushinAA ($5.48 in chips) 
Vaha379: posts small blind $0.05
flushinAA: posts big blind $0.10
*** HOLE CARDS ***
perespell: folds 
senej: folds 
DimaLesnoy: raises $0.15 to $0.25
Aquansk: folds 
Vaha379: raises $0.60 to $0.85
flushinAA: folds 
DimaLesnoy: calls $0.60
*** FLOP *** [6c 3s 4h]
Vaha379: checks 
DimaLesnoy: checks 
*** TURN *** [6c 3s 4h] [8c]
Vaha379: bets $0.96
DimaLesnoy: calls $0.96
*** RIVER *** [6c 3s 4h 8c] [3c]
Vaha379: bets $1.60
DimaLesnoy: calls $1.60
*** SHOW DOWN ***
Vaha379: shows [Qh Jd] (a pair of Threes)
DimaLesnoy: shows [Kc Tc] (a flush, King high)
DimaLesnoy collected $6.61 from pot
*** SUMMARY ***
Total pot $6.92 | Rake $0.31 
Board [6c 3s 4h 8c 3c]
Seat 1: perespell folded before Flop (didn't bet)
Seat 2: senej folded before Flop (didn't bet)
Seat 3: DimaLesnoy showed [Kc Tc] and won ($6.61) with a flush, King high
Seat 4: Aquansk (button) folded before Flop (didn't bet)
Seat 5: Vaha379 (small blind) showed [Qh Jd] and lost with a pair of Threes
Seat 6: flushinAA (big blind) folded before Flop



PokerStars Hand #222961913286:  Hold'em No Limit ($0.05/$0.10 USD) - 2021/01/23 12:44:54 ET
Table 'Saito II' 6-max Seat #5 is the button
Seat 1: perespell ($10 in chips) 
Seat 2: senej ($13.99 in chips) 
Seat 3: DimaLesnoy ($22.82 in chips) 
Seat 4: Aquansk ($6.74 in chips) 
Seat 5: Vaha379 ($6.39 in chips) 
Seat 6: flushinAA ($5.38 in chips) 
flushinAA: posts small blind $0.05
perespell: posts big blind $0.10
*** HOLE CARDS ***
senej: folds 
DimaLesnoy: raises $0.20 to $0.30
Aquansk: folds 
Vaha379: folds 
Vaha379 leaves the table
flushinAA: folds 
perespell: folds 
Uncalled bet ($0.20) returned to DimaLesnoy
firstandsole joins the table at seat #5 
DimaLesnoy collected $0.25 from pot
DimaLesnoy: doesn't show hand 
*** SUMMARY ***
Total pot $0.25 | Rake $0 
Seat 1: perespell (big blind) folded before Flop
Seat 2: senej folded before Flop (didn't bet)
Seat 3: DimaLesnoy collected ($0.25)
Seat 4: Aquansk folded before Flop (didn't bet)
Seat 5: Vaha379 (button) folded before Flop (didn't bet)
Seat 6: flushinAA (small blind) folded before Flop



PokerStars Hand #222961926132:  Hold'em No Limit ($0.05/$0.10 USD) - 2021/01/23 12:45:13 ET
Table 'Saito II' 6-max Seat #6 is the button
Seat 1: perespell ($10 in chips) 
Seat 2: senej ($13.99 in chips) 
Seat 3: DimaLesnoy ($22.97 in chips) 
Seat 4: Aquansk ($6.74 in chips) 
Seat 6: flushinAA ($5.33 in chips) 
perespell: posts small blind $0.05
senej: posts big blind $0.10
firstandsole: sits out 
*** HOLE CARDS ***
DimaLesnoy has timed out
DimaLesnoy: folds 
Aquansk: calls $0.10
flushinAA: folds 
perespell: folds 
senej: checks 
*** FLOP *** [5h 2h 4d]
senej: checks 
Aquansk: bets $0.10
senej: calls $0.10
*** TURN *** [5h 2h 4d] [Ac]
senej: checks 
Aquansk: bets $0.10
senej: folds 
Uncalled bet ($0.10) returned to Aquansk
Aquansk collected $0.43 from pot
Aquansk: doesn't show hand 
*** SUMMARY ***
Total pot $0.45 | Rake $0.02 
Board [5h 2h 4d Ac]
Seat 1: perespell (small blind) folded before Flop
Seat 2: senej (big blind) folded on the Turn
Seat 3: DimaLesnoy folded before Flop (didn't bet)
Seat 4: Aquansk collected ($0.43)
Seat 6: flushinAA (button) folded before Flop (didn't bet)



PokerStars Hand #222961953733:  Hold'em No Limit ($0.05/$0.10 USD) - 2021/01/23 12:45:54 ET
Table 'Saito II' 6-max Seat #1 is the button
Seat 1: perespell ($10 in chips) 
Seat 2: senej ($13.79 in chips) 
Seat 3: DimaLesnoy ($22.97 in chips) 
Seat 4: Aquansk ($6.97 in chips) 
Seat 6: flushinAA ($5.33 in chips) 
senej: posts small blind $0.05
DimaLesnoy: posts big blind $0.10
firstandsole: sits out 
*** HOLE CARDS ***
Aquansk: folds 
flushinAA: folds 
perespell: folds 
senej: raises $0.20 to $0.30
DimaLesnoy: calls $0.20
*** FLOP *** [8h 4s Ac]
senej: bets $0.43
DimaLesnoy: calls $0.43
*** TURN *** [8h 4s Ac] [Td]
senej: bets $1.04
DimaLesnoy: folds 
Uncalled bet ($1.04) returned to senej
senej collected $1.39 from pot
senej: doesn't show hand 
*** SUMMARY ***
Total pot $1.46 | Rake $0.07 
Board [8h 4s Ac Td]
Seat 1: perespell (button) folded before Flop (didn't bet)
Seat 2: senej (small blind) collected ($1.39)
Seat 3: DimaLesnoy (big blind) folded on the Turn
Seat 4: Aquansk folded before Flop (didn't bet)
Seat 6: flushinAA folded before Flop (didn't bet)



PokerStars Hand #222961990670:  Hold'em No Limit ($0.05/$0.10 USD) - 2021/01/23 12:46:48 ET
Table 'Saito II' 6-max Seat #2 is the button
Seat 1: perespell ($10 in chips) 
Seat 2: senej ($14.45 in chips) 
Seat 3: DimaLesnoy ($22.24 in chips) 
Seat 4: Aquansk ($6.97 in chips) 
Seat 6: flushinAA ($5.33 in chips) 
DimaLesnoy: posts small blind $0.05
Aquansk: posts big blind $0.10
firstandsole: sits out 
*** HOLE CARDS ***
flushinAA: folds 
perespell: raises $0.15 to $0.25
senej: raises $0.65 to $0.90
DimaLesnoy: folds 
Aquansk: folds 
perespell: calls $0.65
*** FLOP *** [6d 3h 6s]
perespell: checks 
senej: bets $1.10
perespell: folds 
Uncalled bet ($1.10) returned to senej
senej collected $1.86 from pot
senej: doesn't show hand 
*** SUMMARY ***
Total pot $1.95 | Rake $0.09 
Board [6d 3h 6s]
Seat 1: perespell folded on the Flop
Seat 2: senej (button) collected ($1.86)
Seat 3: DimaLesnoy (small blind) folded before Flop
Seat 4: Aquansk (big blind) folded before Flop
Seat 6: flushinAA folded before Flop (didn't bet)



PokerStars Hand #222962025593:  Hold'em No Limit ($0.05/$0.10 USD) - 2021/01/23 12:47:40 ET
Table 'Saito II' 6-max Seat #3 is the button
Seat 1: perespell ($10 in chips) 
Seat 2: senej ($15.41 in chips) 
Seat 3: DimaLesnoy ($22.19 in chips) 
Seat 4: Aquansk ($6.87 in chips) 
Seat 5: firstandsole ($10 in chips) 
Seat 6: flushinAA ($5.33 in chips) 
Aquansk: posts small blind $0.05
firstandsole: posts big blind $0.10
*** HOLE CARDS ***
flushinAA: raises $0.10 to $0.20
perespell: folds 
senej: folds 
DimaLesnoy: folds 
Aquansk: calls $0.15
firstandsole: raises $0.70 to $0.90
flushinAA: calls $0.70
Aquansk: folds 
*** FLOP *** [3s 7s Jh]
firstandsole: bets $0.73
flushinAA: calls $0.73
*** TURN *** [3s 7s Jh] [4s]
firstandsole: checks 
flushinAA: bets $1.30
firstandsole: raises $7.07 to $8.37 and is all-in
flushinAA: folds 
Uncalled bet ($7.07) returned to firstandsole
firstandsole collected $5.79 from pot
firstandsole: doesn't show hand 
*** SUMMARY ***
Total pot $6.06 | Rake $0.27 
Board [3s 7s Jh 4s]
Seat 1: perespell folded before Flop (didn't bet)
Seat 2: senej folded before Flop (didn't bet)
Seat 3: DimaLesnoy (button) folded before Flop (didn't bet)
Seat 4: Aquansk (small blind) folded before Flop
Seat 5: firstandsole (big blind) collected ($5.79)
Seat 6: flushinAA folded on the Turn



PokerStars Hand #222962071539:  Hold'em No Limit ($0.05/$0.10 USD) - 2021/01/23 12:48:49 ET
Table 'Saito II' 6-max Seat #4 is the button
Seat 1: perespell ($10 in chips) 
Seat 2: senej ($15.41 in chips) 
Seat 3: DimaLesnoy ($22.19 in chips) 
Seat 4: Aquansk ($6.67 in chips) 
Seat 5: firstandsole ($12.86 in chips) 
Seat 6: flushinAA ($2.40 in chips) 
firstandsole: posts small blind $0.05
flushinAA: posts big blind $0.10
*** HOLE CARDS ***
perespell: raises $0.15 to $0.25
senej: folds 
DimaLesnoy: calls $0.25
Aquansk: calls $0.25
firstandsole: raises $0.95 to $1.20
flushinAA: folds 
perespell: calls $0.95
DimaLesnoy: folds 
Aquansk: folds 
*** FLOP *** [Jc 2d 7d]
firstandsole: bets $1.40
perespell: calls $1.40
*** TURN *** [Jc 2d 7d] [3d]
firstandsole: bets $2.50
perespell: calls $2.50
*** RIVER *** [Jc 2d 7d 3d] [2h]
firstandsole: checks 
perespell: checks 
*** SHOW DOWN ***
firstandsole: shows [Ah Kd] (a pair of Deuces)
perespell: shows [Td Tc] (two pair, Tens and Deuces)
perespell collected $10.31 from pot
*** SUMMARY ***
Total pot $10.80 | Rake $0.49 
Board [Jc 2d 7d 3d 2h]
Seat 1: perespell showed [Td Tc] and won ($10.31) with two pair, Tens and Deuces
Seat 2: senej folded before Flop (didn't bet)
Seat 3: DimaLesnoy folded before Flop
Seat 4: Aquansk (button) folded before Flop
Seat 5: firstandsole (small blind) showed [Ah Kd] and lost with a pair of Deuces
Seat 6: flushinAA (big blind) folded before Flop



PokerStars Hand #222962129904:  Hold'em No Limit ($0.05/$0.10 USD) - 2021/01/23 12:50:15 ET
Table 'Saito II' 6-max Seat #5 is the button
Seat 1: perespell ($15.21 in chips) 
Seat 2: senej ($15.41 in chips) 
Seat 3: DimaLesnoy ($21.94 in chips) 
Seat 4: Aquansk ($6.42 in chips) 
Seat 5: firstandsole ($10 in chips) 
Seat 6: flushinAA ($2.30 in chips) 
flushinAA: posts small blind $0.05
perespell: posts big blind $0.10
*** HOLE CARDS ***
senej: folds 
DimaLesnoy: folds 
Aquansk: folds 
firstandsole: folds 
flushinAA: raises $0.20 to $0.30
perespell: folds 
Uncalled bet ($0.20) returned to flushinAA
flushinAA collected $0.20 from pot
flushinAA: doesn't show hand 
*** SUMMARY ***
Total pot $0.20 | Rake $0 
Seat 1: perespell (big blind) folded before Flop
Seat 2: senej folded before Flop (didn't bet)
Seat 3: DimaLesnoy folded before Flop (didn't bet)
Seat 4: Aquansk folded before Flop (didn't bet)
Seat 5: firstandsole (button) folded before Flop (didn't bet)
Seat 6: flushinAA (small blind) collected ($0.20)



PokerStars Hand #222962142790:  Hold'em No Limit ($0.05/$0.10 USD) - 2021/01/23 12:50:34 ET
Table 'Saito II' 6-max Seat #6 is the button
Seat 1: perespell ($15.11 in chips) 
Seat 2: senej ($15.41 in chips) 
Seat 3: DimaLesnoy ($21.94 in chips) 
Seat 4: Aquansk ($6.42 in chips) 
Seat 5: firstandsole ($10 in chips) 
Seat 6: flushinAA ($2.40 in chips) 
perespell: posts small blind $0.05
senej: posts big blind $0.10
*** HOLE CARDS ***
DimaLesnoy: folds 
Aquansk: calls $0.10
firstandsole: folds 
flushinAA: folds 
perespell: raises $0.40 to $0.50
senej: folds 
Aquansk: calls $0.40
*** FLOP *** [8c 2h 7s]
perespell: bets $0.45
Aquansk: calls $0.45
*** TURN *** [8c 2h 7s] [Kc]
perespell: bets $1.35
Aquansk: raises $1.35 to $2.70
perespell: raises $11.46 to $14.16 and is all-in
Aquansk: calls $2.77 and is all-in
Uncalled bet ($8.69) returned to perespell
*** RIVER *** [8c 2h 7s Kc] [6h]
*** SHOW DOWN ***
perespell: shows [Ah As] (a pair of Aces)
Aquansk: shows [Ks Th] (a pair of Kings)
perespell collected $12.36 from pot
*** SUMMARY ***
Total pot $12.94 | Rake $0.58 
Board [8c 2h 7s Kc 6h]
Seat 1: perespell (small blind) showed [Ah As] and won ($12.36) with a pair of Aces
Seat 2: senej (big blind) folded before Flop
Seat 3: DimaLesnoy folded before Flop (didn't bet)
Seat 4: Aquansk showed [Ks Th] and lost with a pair of Kings
Seat 5: firstandsole folded before Flop (didn't bet)
Seat 6: flushinAA (button) folded before Flop (didn't bet)



PokerStars Hand #222962180903:  Hold'em No Limit ($0.05/$0.10 USD) - 2021/01/23 12:51:30 ET
Table 'Saito II' 6-max Seat #1 is the button
Seat 1: perespell ($21.05 in chips) 
Seat 2: senej ($15.31 in chips) 
Seat 3: DimaLesnoy ($21.94 in chips) 
Seat 5: firstandsole ($10 in chips) 
Seat 6: flushinAA ($2.40 in chips) 
senej: posts small blind $0.05
DimaLesnoy: posts big blind $0.10
*** HOLE CARDS ***
firstandsole: folds 
flushinAA: raises $0.10 to $0.20
perespell: raises $0.50 to $0.70
senej: folds 
DimaLesnoy: folds 
flushinAA: raises $1.70 to $2.40 and is all-in
perespell: folds 
Uncalled bet ($1.70) returned to flushinAA
flushinAA collected $1.55 from pot
flushinAA: doesn't show hand 
*** SUMMARY ***
Total pot $1.55 | Rake $0 
Seat 1: perespell (button) folded before Flop
Seat 2: senej (small blind) folded before Flop
Seat 3: DimaLesnoy (big blind) folded before Flop
Seat 5: firstandsole folded before Flop (didn't bet)
Seat 6: flushinAA collected ($1.55)



PokerStars Hand #222962204031:  Hold'em No Limit ($0.05/$0.10 USD) - 2021/01/23 12:52:04 ET
Table 'Saito II' 6-max Seat #2 is the button
Seat 1: perespell ($20.35 in chips) 
Seat 2: senej ($15.26 in chips) 
Seat 3: DimaLesnoy ($21.84 in chips) 
Seat 4: Aquansk ($10 in chips) 
Seat 5: firstandsole ($10 in chips) 
Seat 6: flushinAA ($3.25 in chips) 
DimaLesnoy: posts small blind $0.05
Aquansk: posts big blind $0.10
*** HOLE CARDS ***
firstandsole: folds 
flushinAA: folds 
perespell: raises $0.15 to $0.25
senej: folds 
DimaLesnoy: folds 
Aquansk: calls $0.15
*** FLOP *** [8d 4s 7h]
Aquansk: checks 
perespell: checks 
*** TURN *** [8d 4s 7h] [9d]
Aquansk: bets $0.10
perespell: folds 
Uncalled bet ($0.10) returned to Aquansk
Aquansk collected $0.53 from pot
Aquansk: doesn't show hand 
*** SUMMARY ***
Total pot $0.55 | Rake $0.02 
Board [8d 4s 7h 9d]
Seat 1: perespell folded on the Turn
Seat 2: senej (button) folded before Flop (didn't bet)
Seat 3: DimaLesnoy (small blind) folded before Flop
Seat 4: Aquansk (big blind) collected ($0.53)
Seat 5: firstandsole folded before Flop (didn't bet)
Seat 6: flushinAA folded before Flop (didn't bet)



PokerStars Hand #222962226433:  Hold'em No Limit ($0.05/$0.10 USD) - 2021/01/23 12:52:38 ET
Table 'Saito II' 6-max Seat #3 is the button
Seat 1: perespell ($20.10 in chips) 
Seat 2: senej ($15.26 in chips) 
Seat 3: DimaLesnoy ($21.79 in chips) 
Seat 4: Aquansk ($10.28 in chips) 
Seat 5: firstandsole ($10 in chips) 
Seat 6: flushinAA ($3.25 in chips) 
Aquansk: posts small blind $0.05
firstandsole: posts big blind $0.10
*** HOLE CARDS ***
flushinAA: raises $0.10 to $0.20
perespell: folds 
senej: folds 
DimaLesnoy: folds 
Aquansk: calls $0.15
firstandsole: folds 
*** FLOP *** [Kc 9s 4c]
Aquansk: checks 
flushinAA: checks 
*** TURN *** [Kc 9s 4c] [Qs]
Aquansk: checks 
flushinAA: bets $0.24
Aquansk: folds 
Uncalled bet ($0.24) returned to flushinAA
flushinAA collected $0.48 from pot
flushinAA: doesn't show hand 
*** SUMMARY ***
Total pot $0.50 | Rake $0.02 
Board [Kc 9s 4c Qs]
Seat 1: perespell folded before Flop (didn't bet)
Seat 2: senej folded before Flop (didn't bet)
Seat 3: DimaLesnoy (button) folded before Flop (didn't bet)
Seat 4: Aquansk (small blind) folded on the Turn
Seat 5: firstandsole (big blind) folded before Flop
Seat 6: flushinAA collected ($0.48)



PokerStars Hand #222962260450:  Hold'em No Limit ($0.05/$0.10 USD) - 2021/01/23 12:53:19 ET
Table 'Saito II' 6-max Seat #4 is the button
Seat 1: perespell ($20.10 in chips) 
Seat 2: senej ($15.26 in chips) 
Seat 3: DimaLesnoy ($21.79 in chips) 
Seat 4: Aquansk ($10.08 in chips) 
Seat 5: firstandsole ($10 in chips) 
Seat 6: flushinAA ($3.53 in chips) 
firstandsole: posts small blind $0.05
flushinAA: posts big blind $0.10
*** HOLE CARDS ***
perespell: folds 
senej: folds 
DimaLesnoy: raises $0.15 to $0.25
Aquansk: folds 
firstandsole: folds 
flushinAA: folds 
Uncalled bet ($0.15) returned to DimaLesnoy
DimaLesnoy collected $0.25 from pot
DimaLesnoy: doesn't show hand 
*** SUMMARY ***
Total pot $0.25 | Rake $0 
Seat 1: perespell folded before Flop (didn't bet)
Seat 2: senej folded before Flop (didn't bet)
Seat 3: DimaLesnoy collected ($0.25)
Seat 4: Aquansk (button) folded before Flop (didn't bet)
Seat 5: firstandsole (small blind) folded before Flop
Seat 6: flushinAA (big blind) folded before Flop



PokerStars Hand #222962274693:  Hold'em No Limit ($0.05/$0.10 USD) - 2021/01/23 12:53:40 ET
Table 'Saito II' 6-max Seat #5 is the button
Seat 1: perespell ($20.10 in chips) 
Seat 2: senej ($15.26 in chips) 
Seat 3: DimaLesnoy ($21.94 in chips) 
Seat 4: Aquansk ($10.08 in chips) 
Seat 5: firstandsole ($10 in chips) 
Seat 6: flushinAA ($3.43 in chips) 
flushinAA: posts small blind $0.05
perespell: posts big blind $0.10
*** HOLE CARDS ***
senej: folds 
DimaLesnoy: folds 
Aquansk: folds 
firstandsole: raises $0.20 to $0.30
flushinAA: folds 
perespell: calls $0.20
*** FLOP *** [7c 7s 5c]
perespell: checks 
firstandsole: bets $0.49
perespell: folds 
Uncalled bet ($0.49) returned to firstandsole
firstandsole collected $0.62 from pot
firstandsole: doesn't show hand 
*** SUMMARY ***
Total pot $0.65 | Rake $0.03 
Board [7c 7s 5c]
Seat 1: perespell (big blind) folded on the Flop
Seat 2: senej folded before Flop (didn't bet)
Seat 3: DimaLesnoy folded before Flop (didn't bet)
Seat 4: Aquansk folded before Flop (didn't bet)
Seat 5: firstandsole (button) collected ($0.62)
Seat 6: flushinAA (small blind) folded before Flop



PokerStars Hand #222962301115:  Hold'em No Limit ($0.05/$0.10 USD) - 2021/01/23 12:54:19 ET
Table 'Saito II' 6-max Seat #6 is the button
Seat 1: perespell ($19.80 in chips) 
Seat 2: senej ($15.26 in chips) 
Seat 3: DimaLesnoy ($21.94 in chips) 
Seat 4: Aquansk ($10.08 in chips) 
Seat 5: firstandsole ($10.32 in chips) 
Seat 6: flushinAA ($3.38 in chips) 
perespell: posts small blind $0.05
senej: posts big blind $0.10
*** HOLE CARDS ***
DimaLesnoy has timed out
DimaLesnoy: folds 
Aquansk: folds 
firstandsole: folds 
flushinAA: folds 
perespell: folds 
Uncalled bet ($0.05) returned to senej
senej collected $0.10 from pot
senej: doesn't show hand 
*** SUMMARY ***
Total pot $0.10 | Rake $0 
Seat 1: perespell (small blind) folded before Flop
Seat 2: senej (big blind) collected ($0.10)
Seat 3: DimaLesnoy folded before Flop (didn't bet)
Seat 4: Aquansk folded before Flop (didn't bet)
Seat 5: firstandsole folded before Flop (didn't bet)
Seat 6: flushinAA (button) folded before Flop (didn't bet)



PokerStars Hand #222962316410:  Hold'em No Limit ($0.05/$0.10 USD) - 2021/01/23 12:54:42 ET
Table 'Saito II' 6-max Seat #1 is the button
Seat 1: perespell ($19.75 in chips) 
Seat 2: senej ($15.31 in chips) 
Seat 4: Aquansk ($10.08 in chips) 
Seat 5: firstandsole ($10.32 in chips) 
Seat 6: flushinAA ($3.38 in chips) 
senej: posts small blind $0.05
Aquansk: posts big blind $0.10
*** HOLE CARDS ***
firstandsole: folds 
flushinAA: folds 
perespell: raises $0.15 to $0.25
senej: calls $0.20
Aquansk: calls $0.15
*** FLOP *** [Qh 5c 6c]
senej: checks 
Aquansk: checks 
perespell: checks 
*** TURN *** [Qh 5c 6c] [6d]
senej: checks 
Aquansk: bets $0.10
perespell: folds 
senej: folds 
Uncalled bet ($0.10) returned to Aquansk
Aquansk collected $0.72 from pot
Aquansk: doesn't show hand 
*** SUMMARY ***
Total pot $0.75 | Rake $0.03 
Board [Qh 5c 6c 6d]
Seat 1: perespell (button) folded on the Turn
Seat 2: senej (small blind) folded on the Turn
Seat 4: Aquansk (big blind) collected ($0.72)
Seat 5: firstandsole folded before Flop (didn't bet)
Seat 6: flushinAA folded before Flop (didn't bet)



PokerStars Hand #222962343822:  Hold'em No Limit ($0.05/$0.10 USD) - 2021/01/23 12:55:28 ET
Table 'Saito II' 6-max Seat #2 is the button
Seat 1: perespell ($19.50 in chips) 
Seat 2: senej ($15.06 in chips) 
Seat 4: Aquansk ($10.55 in chips) 
Seat 5: firstandsole ($10.32 in chips) 
Seat 6: flushinAA ($3.38 in chips) 
Aquansk: posts small blind $0.05
firstandsole: posts big blind $0.10
*** HOLE CARDS ***
flushinAA: raises $0.10 to $0.20
perespell: folds 
senej: folds 
Aquansk: calls $0.15
firstandsole: folds 
*** FLOP *** [4s 8h 5s]
Aquansk: checks 
flushinAA: bets $0.30
Aquansk: calls $0.30
*** TURN *** [4s 8h 5s] [9d]
Aquansk: checks 
flushinAA: bets $1.05
Aquansk: calls $1.05
*** RIVER *** [4s 8h 5s 9d] [Qh]
Aquansk: checks 
flushinAA: bets $1.83 and is all-in
Aquansk: folds 
Uncalled bet ($1.83) returned to flushinAA
flushinAA collected $3.06 from pot
flushinAA: doesn't show hand 
*** SUMMARY ***
Total pot $3.20 | Rake $0.14 
Board [4s 8h 5s 9d Qh]
Seat 1: perespell folded before Flop (didn't bet)
Seat 2: senej (button) folded before Flop (didn't bet)
Seat 4: Aquansk (small blind) folded on the River
Seat 5: firstandsole (big blind) folded before Flop
Seat 6: flushinAA collected ($3.06)



PokerStars Hand #222962386061:  Hold'em No Limit ($0.05/$0.10 USD) - 2021/01/23 12:56:54 ET
Table 'Saito II' 6-max Seat #4 is the button
Seat 1: perespell ($19.50 in chips) 
Seat 2: senej ($15.06 in chips) 
Seat 4: Aquansk ($9 in chips) 
Seat 5: firstandsole ($10.22 in chips) 
Seat 6: flushinAA ($4.89 in chips) 
firstandsole: posts small blind $0.05
flushinAA: posts big blind $0.10
*** HOLE CARDS ***
perespell: folds 
senej: raises $0.20 to $0.30
Aquansk: calls $0.30
firstandsole: folds 
flushinAA: calls $0.20
*** FLOP *** [Ac 2d 2h]
flushinAA: checks 
senej: checks 
Aquansk: checks 
*** TURN *** [Ac 2d 2h] [4d]
flushinAA: checks 
senej: checks 
Aquansk: bets $0.20
flushinAA: folds 
senej: calls $0.20
*** RIVER *** [Ac 2d 2h 4d] [As]
senej: checks 
Aquansk: bets $0.64
senej: folds 
Uncalled bet ($0.64) returned to Aquansk
Aquansk collected $1.29 from pot
Aquansk: doesn't show hand 
*** SUMMARY ***
Total pot $1.35 | Rake $0.06 
Board [Ac 2d 2h 4d As]
Seat 1: perespell folded before Flop (didn't bet)
Seat 2: senej folded on the River
Seat 4: Aquansk (button) collected ($1.29)
Seat 5: firstandsole (small blind) folded before Flop
Seat 6: flushinAA (big blind) folded on the Turn



PokerStars Hand #222962408029:  Hold'em No Limit ($0.05/$0.10 USD) - 2021/01/23 12:57:38 ET
Table 'Saito II' 6-max Seat #5 is the button
Seat 1: perespell ($19.50 in chips) 
Seat 2: senej ($14.56 in chips) 
Seat 4: Aquansk ($9.79 in chips) 
Seat 5: firstandsole ($10.17 in chips) 
Seat 6: flushinAA ($4.59 in chips) 
flushinAA: posts small blind $0.05
perespell: posts big blind $0.10
*** HOLE CARDS ***
senej: folds 
Aquansk: calls $0.10
firstandsole: folds 
flushinAA: calls $0.05
perespell: checks 
*** FLOP *** [Ac Ks 2h]
flushinAA: checks 
perespell: checks 
Aquansk: bets $0.10
flushinAA: folds 
perespell: folds 
Uncalled bet ($0.10) returned to Aquansk
Aquansk collected $0.29 from pot
Aquansk: doesn't show hand 
*** SUMMARY ***
Total pot $0.30 | Rake $0.01 
Board [Ac Ks 2h]
Seat 1: perespell (big blind) folded on the Flop
Seat 2: senej folded before Flop (didn't bet)
Seat 4: Aquansk collected ($0.29)
Seat 5: firstandsole (button) folded before Flop (didn't bet)
Seat 6: flushinAA (small blind) folded on the Flop



PokerStars Hand #222962420952:  Hold'em No Limit ($0.05/$0.10 USD) - 2021/01/23 12:58:04 ET
Table 'Saito II' 6-max Seat #6 is the button
Seat 1: perespell ($19.40 in chips) 
Seat 2: senej ($14.56 in chips) 
Seat 4: Aquansk ($9.98 in chips) 
Seat 5: firstandsole ($10.17 in chips) 
Seat 6: flushinAA ($4.49 in chips) 
perespell: posts small blind $0.05
senej: posts big blind $0.10
*** HOLE CARDS ***
Aquansk: calls $0.10
firstandsole: folds 
flushinAA: folds 
perespell: calls $0.05
senej: checks 
*** FLOP *** [Js Kh 5s]
perespell: checks 
senej: checks 
Aquansk: checks 
*** TURN *** [Js Kh 5s] [Ah]
perespell: checks 
senej: checks 
Aquansk: bets $0.10
perespell: calls $0.10
senej: folds 
*** RIVER *** [Js Kh 5s Ah] [6d]
DimaLesnoy is disconnected 
perespell: checks 
Aquansk: bets $0.20
perespell: calls $0.20
*** SHOW DOWN ***
Aquansk: shows [Ad 2d] (a pair of Aces)
perespell: shows [Ac 8d] (a pair of Aces - King+Jack+Eight kicker)
perespell collected $0.86 from pot
*** SUMMARY ***
Total pot $0.90 | Rake $0.04 
Board [Js Kh 5s Ah 6d]
Seat 1: perespell (small blind) showed [Ac 8d] and won ($0.86) with a pair of Aces
Seat 2: senej (big blind) folded on the Turn
Seat 4: Aquansk showed [Ad 2d] and lost with a pair of Aces
Seat 5: firstandsole folded before Flop (didn't bet)
Seat 6: flushinAA (button) folded before Flop (didn't bet)



PokerStars Hand #222962440416:  Hold'em No Limit ($0.05/$0.10 USD) - 2021/01/23 12:58:43 ET
Table 'Saito II' 6-max Seat #1 is the button
Seat 1: perespell ($19.86 in chips) 
Seat 2: senej ($14.46 in chips) 
Seat 4: Aquansk ($9.58 in chips) 
Seat 5: firstandsole ($10.17 in chips) 
Seat 6: flushinAA ($4.49 in chips) 
senej: posts small blind $0.05
Aquansk: posts big blind $0.10
*** HOLE CARDS ***
firstandsole: folds 
flushinAA: raises $0.10 to $0.20
perespell: calls $0.20
senej: folds 
Aquansk: calls $0.10
*** FLOP *** [2c Qc 4h]
Aquansk: checks 
flushinAA: checks 
perespell: checks 
*** TURN *** [2c Qc 4h] [5d]
Aquansk: bets $0.10
flushinAA: calls $0.10
perespell: raises $0.40 to $0.50
Aquansk: calls $0.40
flushinAA: folds 
*** RIVER *** [2c Qc 4h 5d] [4c]
Aquansk: checks 
perespell: bets $0.75
Aquansk: raises $0.75 to $1.50
perespell: calls $0.75
*** SHOW DOWN ***
Aquansk: shows [4d 3c] (three of a kind, Fours)
perespell: mucks hand 
Aquansk collected $4.54 from pot
*** SUMMARY ***
Total pot $4.75 | Rake $0.21 
Board [2c Qc 4h 5d 4c]
Seat 1: perespell (button) mucked
Seat 2: senej (small blind) folded before Flop
Seat 4: Aquansk (big blind) showed [4d 3c] and won ($4.54) with three of a kind, Fours
Seat 5: firstandsole folded before Flop (didn't bet)
Seat 6: flushinAA folded on the Turn



PokerStars Hand #222962473043:  Hold'em No Limit ($0.05/$0.10 USD) - 2021/01/23 12:59:48 ET
Table 'Saito II' 6-max Seat #2 is the button
Seat 1: perespell ($17.66 in chips) 
Seat 2: senej ($14.41 in chips) 
Seat 4: Aquansk ($11.92 in chips) 
Seat 5: firstandsole ($10.17 in chips) 
Seat 6: flushinAA ($4.19 in chips) 
Aquansk: posts small blind $0.05
firstandsole: posts big blind $0.10
*** HOLE CARDS ***
flushinAA: folds 
perespell: raises $0.15 to $0.25
senej: folds 
Aquansk: calls $0.20
firstandsole: raises $1.15 to $1.40
perespell: folds 
Aquansk: folds 
Uncalled bet ($1.15) returned to firstandsole
firstandsole collected $0.75 from pot
firstandsole: doesn't show hand 
*** SUMMARY ***
Total pot $0.75 | Rake $0 
Seat 1: perespell folded before Flop
Seat 2: senej (button) folded before Flop (didn't bet)
Seat 4: Aquansk (small blind) folded before Flop
Seat 5: firstandsole (big blind) collected ($0.75)
Seat 6: flushinAA folded before Flop (didn't bet)



PokerStars Hand #222962493467:  Hold'em No Limit ($0.05/$0.10 USD) - 2021/01/23 13:00:27 ET
Table 'Saito II' 6-max Seat #4 is the button
Seat 1: perespell ($17.41 in chips) 
Seat 2: senej ($14.41 in chips) 
Seat 4: Aquansk ($11.67 in chips) 
Seat 5: firstandsole ($10.67 in chips) 
firstandsole: posts small blind $0.05
flushinAA: is sitting out 
perespell: posts big blind $0.10
*** HOLE CARDS ***
senej: folds 
Aquansk: folds 
firstandsole: folds 
Uncalled bet ($0.05) returned to perespell
perespell collected $0.10 from pot
perespell: doesn't show hand 
*** SUMMARY ***
Total pot $0.10 | Rake $0 
Seat 1: perespell (big blind) collected ($0.10)
Seat 2: senej folded before Flop (didn't bet)
Seat 4: Aquansk (button) folded before Flop (didn't bet)
Seat 5: firstandsole (small blind) folded before Flop



PokerStars Hand #222962499238:  Hold'em No Limit ($0.05/$0.10 USD) - 2021/01/23 13:00:38 ET
Table 'Saito II' 6-max Seat #5 is the button
Seat 1: perespell ($17.46 in chips) 
Seat 2: senej ($14.41 in chips) 
Seat 4: Aquansk ($11.67 in chips) 
Seat 5: firstandsole ($10.62 in chips) 
perespell: posts small blind $0.05
senej: posts big blind $0.10
*** HOLE CARDS ***
Aquansk: calls $0.10
firstandsole: folds 
perespell: folds 
senej: checks 
*** FLOP *** [6d 9h Qs]
senej: checks 
Aquansk: bets $0.10
senej: folds 
Uncalled bet ($0.10) returned to Aquansk
Aquansk collected $0.24 from pot
Aquansk: doesn't show hand 
*** SUMMARY ***
Total pot $0.25 | Rake $0.01 
Board [6d 9h Qs]
Seat 1: perespell (small blind) folded before Flop
Seat 2: senej (big blind) folded on the Flop
Seat 4: Aquansk collected ($0.24)
Seat 5: firstandsole (button) folded before Flop (didn't bet)



PokerStars Hand #222962506743:  Hold'em No Limit ($0.05/$0.10 USD) - 2021/01/23 13:00:52 ET
Table 'Saito II' 6-max Seat #1 is the button
Seat 1: perespell ($17.41 in chips) 
Seat 2: senej ($14.31 in chips) 
Seat 4: Aquansk ($11.81 in chips) 
Seat 5: firstandsole ($10.62 in chips) 
senej: posts small blind $0.05
Aquansk: posts big blind $0.10
*** HOLE CARDS ***
firstandsole: folds 
perespell: folds 
senej: folds 
Uncalled bet ($0.05) returned to Aquansk
Aquansk collected $0.10 from pot
Aquansk: doesn't show hand 
*** SUMMARY ***
Total pot $0.10 | Rake $0 
Seat 1: perespell (button) folded before Flop (didn't bet)
Seat 2: senej (small blind) folded before Flop
Seat 4: Aquansk (big blind) collected ($0.10)
Seat 5: firstandsole folded before Flop (didn't bet)



PokerStars Hand #222962509597:  Hold'em No Limit ($0.05/$0.10 USD) - 2021/01/23 13:00:57 ET
Table 'Saito II' 6-max Seat #2 is the button
Seat 1: perespell ($17.41 in chips) 
Seat 2: senej ($14.26 in chips) 
Seat 4: Aquansk ($11.86 in chips) 
Seat 5: firstandsole ($10.62 in chips) 
Aquansk: posts small blind $0.05
firstandsole: posts big blind $0.10
*** HOLE CARDS ***
perespell: folds 
senej: raises $0.20 to $0.30
Aquansk: folds 
firstandsole: folds 
Uncalled bet ($0.20) returned to senej
senej collected $0.25 from pot
senej: doesn't show hand 
*** SUMMARY ***
Total pot $0.25 | Rake $0 
Seat 1: perespell folded before Flop (didn't bet)
Seat 2: senej (button) collected ($0.25)
Seat 4: Aquansk (small blind) folded before Flop
Seat 5: firstandsole (big blind) folded before Flop



PokerStars Hand #222962518636:  Hold'em No Limit ($0.05/$0.10 USD) - 2021/01/23 13:01:12 ET
Table 'Saito II' 6-max Seat #4 is the button
Seat 1: perespell ($17.41 in chips) 
Seat 2: senej ($14.41 in chips) 
Seat 4: Aquansk ($11.81 in chips) 
Seat 5: firstandsole ($10.52 in chips) 
firstandsole: posts small blind $0.05
perespell: posts big blind $0.10
*** HOLE CARDS ***
senej: folds 
Aquansk: calls $0.10
firstandsole: raises $0.30 to $0.40
perespell: folds 
Aquansk: calls $0.30
*** FLOP *** [2d 6s Th]
firstandsole: bets $0.50
Aquansk: folds 
Uncalled bet ($0.50) returned to firstandsole
firstandsole collected $0.86 from pot
firstandsole: doesn't show hand 
*** SUMMARY ***
Total pot $0.90 | Rake $0.04 
Board [2d 6s Th]
Seat 1: perespell (big blind) folded before Flop
Seat 2: senej folded before Flop (didn't bet)
Seat 4: Aquansk (button) folded on the Flop
Seat 5: firstandsole (small blind) collected ($0.86)



PokerStars Hand #222962548193:  Hold'em No Limit ($0.05/$0.10 USD) - 2021/01/23 13:02:00 ET
Table 'Saito II' 6-max Seat #5 is the button
Seat 1: perespell ($17.31 in chips) 
Seat 2: senej ($14.41 in chips) 
Seat 4: Aquansk ($11.41 in chips) 
Seat 5: firstandsole ($10.98 in chips) 
perespell: posts small blind $0.05
senej: posts big blind $0.10
*** HOLE CARDS ***
Aquansk: folds 
firstandsole: folds 
perespell: folds 
Uncalled bet ($0.05) returned to senej
senej collected $0.10 from pot
senej: doesn't show hand 
*** SUMMARY ***
Total pot $0.10 | Rake $0 
Seat 1: perespell (small blind) folded before Flop
Seat 2: senej (big blind) collected ($0.10)
Seat 4: Aquansk folded before Flop (didn't bet)
Seat 5: firstandsole (button) folded before Flop (didn't bet)



PokerStars Hand #222962553633:  Hold'em No Limit ($0.05/$0.10 USD) - 2021/01/23 13:02:08 ET
Table 'Saito II' 6-max Seat #1 is the button
Seat 1: perespell ($17.26 in chips) 
Seat 2: senej ($14.46 in chips) 
Seat 4: Aquansk ($11.41 in chips) 
Seat 5: firstandsole ($10.98 in chips) 
senej: posts small blind $0.05
Aquansk: posts big blind $0.10
*** HOLE CARDS ***
firstandsole: folds 
perespell: folds 
senej: folds 
Uncalled bet ($0.05) returned to Aquansk
Aquansk collected $0.10 from pot
DimaLesnoy was removed from the table for failing to post
DimaLesnoy leaves the table
Aquansk: doesn't show hand 
*** SUMMARY ***
Total pot $0.10 | Rake $0 
Seat 1: perespell (button) folded before Flop (didn't bet)
Seat 2: senej (small blind) folded before Flop
Seat 4: Aquansk (big blind) collected ($0.10)
Seat 5: firstandsole folded before Flop (didn't bet)



PokerStars Hand #222962559444:  Hold'em No Limit ($0.05/$0.10 USD) - 2021/01/23 13:02:17 ET
Table 'Saito II' 6-max Seat #2 is the button
Seat 1: perespell ($17.26 in chips) 
Seat 2: senej ($14.41 in chips) 
Seat 4: Aquansk ($11.46 in chips) 
Aquansk: posts small blind $0.05
firstandsole: is sitting out 
perespell: posts big blind $0.10
*** HOLE CARDS ***
uterkrm.ua joins the table at seat #3 
senej: raises $0.20 to $0.30
Aquansk: folds 
perespell: folds 
Uncalled bet ($0.20) returned to senej
uterkrm.ua leaves the table
senej collected $0.25 from pot
senej: doesn't show hand 
*** SUMMARY ***
Total pot $0.25 | Rake $0 
Seat 1: perespell (big blind) folded before Flop
Seat 2: senej (button) collected ($0.25)
Seat 4: Aquansk (small blind) folded before Flop



PokerStars Hand #222962598513:  Hold'em No Limit ($0.05/$0.10 USD) - 2021/01/23 13:03:15 ET
Table 'Saito II' 6-max Seat #2 is the button
Seat 1: perespell ($16.76 in chips) 
Seat 2: senej ($15.02 in chips) 
Seat 4: Aquansk ($11.31 in chips) 
Seat 5: firstandsole ($10.98 in chips) 
Aquansk: posts small blind $0.05
firstandsole: posts big blind $0.10
*** HOLE CARDS ***
perespell: folds 
senej: folds 
Aquansk: calls $0.05
firstandsole: checks 
*** FLOP *** [8s 6h 5c]
Aquansk: checks 
firstandsole: bets $0.24
Aquansk: calls $0.24
*** TURN *** [8s 6h 5c] [9c]
Aquansk: checks 
firstandsole: checks 
*** RIVER *** [8s 6h 5c 9c] [6d]
Aquansk: checks 
firstandsole: checks 
*** SHOW DOWN ***
Aquansk: shows [Td 9d] (two pair, Nines and Sixes)
firstandsole: mucks hand 
Aquansk collected $0.65 from pot
*** SUMMARY ***
Total pot $0.68 | Rake $0.03 
Board [8s 6h 5c 9c 6d]
Seat 1: perespell folded before Flop (didn't bet)
Seat 2: senej (button) folded before Flop (didn't bet)
Seat 4: Aquansk (small blind) showed [Td 9d] and won ($0.65) with two pair, Nines and Sixes
Seat 5: firstandsole (big blind) mucked



PokerStars Hand #222962638308:  Hold'em No Limit ($0.05/$0.10 USD) - 2021/01/23 13:04:13 ET
Table 'Saito II' 6-max Seat #4 is the button
Seat 1: perespell ($16.76 in chips) 
Seat 2: senej ($15.02 in chips) 
Seat 3: Gibilan8584 ($8 in chips) 
Seat 4: Aquansk ($11.62 in chips) 
Seat 5: firstandsole ($10.64 in chips) 
firstandsole: posts small blind $0.05
perespell: posts big blind $0.10
Gibilan8584: posts big blind $0.10
*** HOLE CARDS ***
senej: folds 
Gibilan8584: checks 
Aquansk: raises $0.20 to $0.30
firstandsole: folds 
perespell: calls $0.20
Gibilan8584: calls $0.20
*** FLOP *** [7h 7s 9d]
perespell: checks 
Gibilan8584: bets $0.50
Aquansk: folds 
perespell: folds 
Uncalled bet ($0.50) returned to Gibilan8584
Gibilan8584 collected $0.91 from pot
flushinAA was removed from the table for failing to post
flushinAA leaves the table
Gibilan8584: doesn't show hand 
*** SUMMARY ***
Total pot $0.95 | Rake $0.04 
Board [7h 7s 9d]
Seat 1: perespell (big blind) folded on the Flop
Seat 2: senej folded before Flop (didn't bet)
Seat 3: Gibilan8584 collected ($0.91)
Seat 4: Aquansk (button) folded on the Flop
Seat 5: firstandsole (small blind) folded before Flop



PokerStars Hand #222962666870:  Hold'em No Limit ($0.05/$0.10 USD) - 2021/01/23 13:04:55 ET
Table 'Saito II' 6-max Seat #5 is the button
Seat 1: perespell ($16.46 in chips) 
Seat 2: senej ($15.02 in chips) 
Seat 3: Gibilan8584 ($8.61 in chips) 
Seat 4: Aquansk ($11.32 in chips) 
Seat 5: firstandsole ($10.59 in chips) 
perespell: posts small blind $0.05
senej: posts big blind $0.10
*** HOLE CARDS ***
Gibilan8584: calls $0.10
Aquansk: calls $0.10
firstandsole: folds 
perespell: folds 
senej: checks 
*** FLOP *** [Kh Ks Js]
magdal28 joins the table at seat #6 
senej: checks 
Gibilan8584: checks 
Aquansk: bets $0.10
senej: folds 
Gibilan8584: calls $0.10
*** TURN *** [Kh Ks Js] [2d]
Gibilan8584: checks 
Aquansk: bets $0.26
Gibilan8584: calls $0.26
*** RIVER *** [Kh Ks Js 2d] [5d]
Gibilan8584: checks 
Aquansk: checks 
*** SHOW DOWN ***
Gibilan8584: shows [5s 4c] (two pair, Kings and Fives)
Aquansk: mucks hand 
Gibilan8584 collected $1.02 from pot
*** SUMMARY ***
Total pot $1.07 | Rake $0.05 
Board [Kh Ks Js 2d 5d]
Seat 1: perespell (small blind) folded before Flop
Seat 2: senej (big blind) folded on the Flop
Seat 3: Gibilan8584 showed [5s 4c] and won ($1.02) with two pair, Kings and Fives
Seat 4: Aquansk mucked
Seat 5: firstandsole (button) folded before Flop (didn't bet)



PokerStars Hand #222962694264:  Hold'em No Limit ($0.05/$0.10 USD) - 2021/01/23 13:05:34 ET
Table 'Saito II' 6-max Seat #1 is the button
Seat 1: perespell ($16.41 in chips) 
Seat 2: senej ($14.92 in chips) 
Seat 3: Gibilan8584 ($9.17 in chips) 
Seat 4: Aquansk ($10.86 in chips) 
Seat 5: firstandsole ($10.59 in chips) 
senej: posts small blind $0.05
Gibilan8584: posts big blind $0.10
magdal28: sits out 
*** HOLE CARDS ***
Aquansk: calls $0.10
firstandsole: folds 
perespell: folds 
senej: folds 
Gibilan8584: checks 
*** FLOP *** [5s 9s 7c]
Gibilan8584: checks 
Aquansk: bets $0.10
Gibilan8584: calls $0.10
*** TURN *** [5s 9s 7c] [6d]
Gibilan8584: checks 
Aquansk: bets $0.20
Gibilan8584: calls $0.20
*** RIVER *** [5s 9s 7c 6d] [5c]
Gibilan8584: checks 
Aquansk: bets $0.40
Gibilan8584: folds 
Uncalled bet ($0.40) returned to Aquansk
Aquansk collected $0.81 from pot
Aquansk: doesn't show hand 
*** SUMMARY ***
Total pot $0.85 | Rake $0.04 
Board [5s 9s 7c 6d 5c]
Seat 1: perespell (button) folded before Flop (didn't bet)
Seat 2: senej (small blind) folded before Flop
Seat 3: Gibilan8584 (big blind) folded on the River
Seat 4: Aquansk collected ($0.81)
Seat 5: firstandsole folded before Flop (didn't bet)



PokerStars Hand #222962723971:  Hold'em No Limit ($0.05/$0.10 USD) - 2021/01/23 13:06:17 ET
Table 'Saito II' 6-max Seat #2 is the button
Seat 1: perespell ($16.41 in chips) 
Seat 2: senej ($14.87 in chips) 
Seat 3: Gibilan8584 ($8.77 in chips) 
Seat 4: Aquansk ($11.27 in chips) 
Seat 5: firstandsole ($10.59 in chips) 
Gibilan8584: posts small blind $0.05
Aquansk: posts big blind $0.10
magdal28: sits out 
*** HOLE CARDS ***
firstandsole has timed out
firstandsole: folds 
perespell: folds 
senej: folds 
Gibilan8584: calls $0.05
Aquansk: checks 
*** FLOP *** [4c Ac 6s]
Gibilan8584: checks 
Aquansk: checks 
*** TURN *** [4c Ac 6s] [Td]
Gibilan8584: checks 
Aquansk: bets $0.10
Gibilan8584: calls $0.10
*** RIVER *** [4c Ac 6s Td] [9s]
Gibilan8584: checks 
Aquansk: checks 
*** SHOW DOWN ***
Gibilan8584: shows [Jc Ts] (a pair of Tens)
Aquansk: mucks hand 
Gibilan8584 collected $0.38 from pot
*** SUMMARY ***
Total pot $0.40 | Rake $0.02 
Board [4c Ac 6s Td 9s]
Seat 1: perespell folded before Flop (didn't bet)
Seat 2: senej (button) folded before Flop (didn't bet)
Seat 3: Gibilan8584 (small blind) showed [Jc Ts] and won ($0.38) with a pair of Tens
Seat 4: Aquansk (big blind) mucked
Seat 5: firstandsole folded before Flop (didn't bet)



PokerStars Hand #222962756828:  Hold'em No Limit ($0.05/$0.10 USD) - 2021/01/23 13:07:05 ET
Table 'Saito II' 6-max Seat #3 is the button
Seat 1: perespell ($16.41 in chips) 
Seat 2: senej ($14.87 in chips) 
Seat 3: Gibilan8584 ($8.95 in chips) 
Seat 4: Aquansk ($11.07 in chips) 
Seat 5: firstandsole ($10.59 in chips) 
Aquansk: posts small blind $0.05
firstandsole: posts big blind $0.10
magdal28: sits out 
*** HOLE CARDS ***
perespell: folds 
senej: folds 
Gibilan8584: calls $0.10
Aquansk: calls $0.05
firstandsole: checks 
*** FLOP *** [7s As 4h]
Aquansk: checks 
firstandsole: checks 
Gibilan8584: checks 
*** TURN *** [7s As 4h] [2c]
Aquansk: checks 
firstandsole: checks 
Gibilan8584: checks 
*** RIVER *** [7s As 4h 2c] [Ts]
Aquansk: checks 
firstandsole: checks 
Gibilan8584: checks 
*** SHOW DOWN ***
Aquansk: shows [9s 8c] (high card Ace)
firstandsole: shows [2d 5h] (a pair of Deuces)
Gibilan8584: shows [3h 3d] (a pair of Threes)
Gibilan8584 collected $0.29 from pot
*** SUMMARY ***
Total pot $0.30 | Rake $0.01 
Board [7s As 4h 2c Ts]
Seat 1: perespell folded before Flop (didn't bet)
Seat 2: senej folded before Flop (didn't bet)
Seat 3: Gibilan8584 (button) showed [3h 3d] and won ($0.29) with a pair of Threes
Seat 4: Aquansk (small blind) showed [9s 8c] and lost with high card Ace
Seat 5: firstandsole (big blind) showed [2d 5h] and lost with a pair of Deuces



PokerStars Hand #222962799565:  Hold'em No Limit ($0.05/$0.10 USD) - 2021/01/23 13:08:07 ET
Table 'Saito II' 6-max Seat #4 is the button
Seat 1: perespell ($16.41 in chips) 
Seat 2: senej ($14.87 in chips) 
Seat 3: Gibilan8584 ($9.14 in chips) 
Seat 4: Aquansk ($10.97 in chips) 
Seat 5: firstandsole ($10.49 in chips) 
Seat 6: magdal28 ($10 in chips) 
firstandsole: posts small blind $0.05
magdal28: posts big blind $0.10
*** HOLE CARDS ***
perespell: folds 
senej: raises $0.20 to $0.30
Gibilan8584: calls $0.30
Aquansk: folds 
firstandsole: folds 
magdal28: calls $0.20
*** FLOP *** [Qd 7d Jh]
magdal28: checks 
senej: checks 
Gibilan8584: checks 
*** TURN *** [Qd 7d Jh] [2d]
magdal28: bets $0.55
senej: folds 
Gibilan8584: calls $0.55
*** RIVER *** [Qd 7d Jh 2d] [As]
magdal28: bets $1.18
Gibilan8584: folds 
Uncalled bet ($1.18) returned to magdal28
magdal28 collected $1.96 from pot
magdal28: doesn't show hand 
*** SUMMARY ***
Total pot $2.05 | Rake $0.09 
Board [Qd 7d Jh 2d As]
Seat 1: perespell folded before Flop (didn't bet)
Seat 2: senej folded on the Turn
Seat 3: Gibilan8584 folded on the River
Seat 4: Aquansk (button) folded before Flop (didn't bet)
Seat 5: firstandsole (small blind) folded before Flop
Seat 6: magdal28 (big blind) collected ($1.96)



PokerStars Hand #222962839264:  Hold'em No Limit ($0.05/$0.10 USD) - 2021/01/23 13:09:05 ET
Table 'Saito II' 6-max Seat #5 is the button
Seat 2: senej ($14.57 in chips) 
Seat 3: Gibilan8584 ($8.29 in chips) 
Seat 4: Aquansk ($10.97 in chips) 
Seat 5: firstandsole ($10.44 in chips) 
Seat 6: magdal28 ($11.11 in chips) 
magdal28: posts small blind $0.05
perespell: is sitting out 
senej: posts big blind $0.10
*** HOLE CARDS ***
Gibilan8584: raises $0.10 to $0.20
Aquansk: calls $0.20
firstandsole: folds 
magdal28: calls $0.15
senej: folds 
*** FLOP *** [6s Ts Js]
magdal28: checks 
Gibilan8584: bets $0.50
Aquansk: calls $0.50
magdal28: folds 
*** TURN *** [6s Ts Js] [5d]
Gibilan8584: bets $0.70
Aquansk: calls $0.70
*** RIVER *** [6s Ts Js 5d] [2s]
Gibilan8584: bets $0.60
Aquansk: calls $0.60
*** SHOW DOWN ***
Gibilan8584: shows [8h Jd] (a pair of Jacks)
Aquansk: shows [6d 6c] (three of a kind, Sixes)
Aquansk collected $4.11 from pot
*** SUMMARY ***
Total pot $4.30 | Rake $0.19 
Board [6s Ts Js 5d 2s]
Seat 2: senej (big blind) folded before Flop
Seat 3: Gibilan8584 showed [8h Jd] and lost with a pair of Jacks
Seat 4: Aquansk showed [6d 6c] and won ($4.11) with three of a kind, Sixes
Seat 5: firstandsole (button) folded before Flop (didn't bet)
Seat 6: magdal28 (small blind) folded on the Flop



PokerStars Hand #222962889661:  Hold'em No Limit ($0.05/$0.10 USD) - 2021/01/23 13:10:18 ET
Table 'Saito II' 6-max Seat #6 is the button
Seat 2: senej ($14.47 in chips) 
Seat 3: Gibilan8584 ($6.29 in chips) 
Seat 4: Aquansk ($13.08 in chips) 
Seat 5: firstandsole ($10.44 in chips) 
Seat 6: magdal28 ($10.91 in chips) 
senej: posts small blind $0.05
Gibilan8584: posts big blind $0.10
*** HOLE CARDS ***
Aquansk: folds 
firstandsole: raises $0.20 to $0.30
magdal28: folds 
senej: folds 
Gibilan8584: calls $0.20
*** FLOP *** [Ah 9c 2d]
Gibilan8584: checks 
firstandsole: bets $0.30
Gibilan8584: calls $0.30
*** TURN *** [Ah 9c 2d] [4c]
Aquansk leaves the table
Gibilan8584: checks 
firstandsole: checks 
*** RIVER *** [Ah 9c 2d 4c] [6c]
Gibilan8584: checks 
firstandsole: checks 
Nordic2154 joins the table at seat #4 
*** SHOW DOWN ***
Gibilan8584: shows [2s Td] (a pair of Deuces)
firstandsole: mucks hand 
Gibilan8584 collected $1.19 from pot
*** SUMMARY ***
Total pot $1.25 | Rake $0.06 
Board [Ah 9c 2d 4c 6c]
Seat 2: senej (small blind) folded before Flop
Seat 3: Gibilan8584 (big blind) showed [2s Td] and won ($1.19) with a pair of Deuces
Seat 4: Aquansk folded before Flop (didn't bet)
Seat 5: firstandsole mucked
Seat 6: magdal28 (button) folded before Flop (didn't bet)



PokerStars Hand #222962912610:  Hold'em No Limit ($0.05/$0.10 USD) - 2021/01/23 13:10:51 ET
Table 'Saito II' 6-max Seat #2 is the button
Seat 2: senej ($14.42 in chips) 
Seat 3: Gibilan8584 ($6.88 in chips) 
Seat 4: Nordic2154 ($10 in chips) 
Seat 5: firstandsole ($10 in chips) 
Seat 6: magdal28 ($10.91 in chips) 
Gibilan8584: posts small blind $0.05
Nordic2154: posts big blind $0.10
*** HOLE CARDS ***
firstandsole: raises $0.20 to $0.30
magdal28: raises $0.70 to $1
senej: folds 
Gibilan8584: calls $0.95
Nordic2154: folds 
firstandsole: calls $0.70
*** FLOP *** [Ts 6d 8h]
Gibilan8584: checks 
firstandsole: checks 
magdal28: checks 
*** TURN *** [Ts 6d 8h] [Js]
Gibilan8584: checks 
firstandsole: bets $1.20
magdal28: calls $1.20
Gibilan8584: folds 
*** RIVER *** [Ts 6d 8h Js] [7h]
firstandsole: bets $7.80 and is all-in
magdal28: folds 
Uncalled bet ($7.80) returned to firstandsole
firstandsole collected $5.25 from pot
firstandsole: doesn't show hand 
*** SUMMARY ***
Total pot $5.50 | Rake $0.25 
Board [Ts 6d 8h Js 7h]
Seat 2: senej (button) folded before Flop (didn't bet)
Seat 3: Gibilan8584 (small blind) folded on the Turn
Seat 4: Nordic2154 (big blind) folded before Flop
Seat 5: firstandsole collected ($5.25)
Seat 6: magdal28 folded on the River



PokerStars Hand #222962970205:  Hold'em No Limit ($0.05/$0.10 USD) - 2021/01/23 13:12:15 ET
Table 'Saito II' 6-max Seat #3 is the button
Seat 2: senej ($14.42 in chips) 
Seat 3: Gibilan8584 ($5.88 in chips) 
Seat 4: Nordic2154 ($10 in chips) 
Seat 5: firstandsole ($13.05 in chips) 
Seat 6: magdal28 ($10 in chips) 
Nordic2154: posts small blind $0.05
firstandsole: posts big blind $0.10
*** HOLE CARDS ***
magdal28: folds 
senej: folds 
Gibilan8584: calls $0.10
Nordic2154: calls $0.05
firstandsole: checks 
*** FLOP *** [5s Qh 8s]
Nordic2154: checks 
firstandsole: checks 
Gibilan8584: checks 
*** TURN *** [5s Qh 8s] [7h]
Nordic2154: bets $0.19
firstandsole: calls $0.19
Gibilan8584: calls $0.19
*** RIVER *** [5s Qh 8s 7h] [Ah]
Nordic2154: checks 
firstandsole: checks 
senej leaves the table
Gibilan8584: checks 
*** SHOW DOWN ***
Nordic2154: shows [Td 9d] (high card Ace)
firstandsole: shows [8h Jc] (a pair of Eights)
Gibilan8584: mucks hand 
firstandsole collected $0.83 from pot
*** SUMMARY ***
Total pot $0.87 | Rake $0.04 
Board [5s Qh 8s 7h Ah]
Seat 2: senej folded before Flop (didn't bet)
Seat 3: Gibilan8584 (button) mucked
Seat 4: Nordic2154 (small blind) showed [Td 9d] and lost with high card Ace
Seat 5: firstandsole (big blind) showed [8h Jc] and won ($0.83) with a pair of Eights
Seat 6: magdal28 folded before Flop (didn't bet)



PokerStars Hand #222963012411:  Hold'em No Limit ($0.05/$0.10 USD) - 2021/01/23 13:13:17 ET
Table 'Saito II' 6-max Seat #4 is the button
Seat 3: Gibilan8584 ($5.59 in chips) 
Seat 4: Nordic2154 ($10 in chips) 
Seat 5: firstandsole ($13.59 in chips) 
Seat 6: magdal28 ($10 in chips) 
firstandsole: posts small blind $0.05
magdal28: posts big blind $0.10
*** HOLE CARDS ***
Gibilan8584: raises $0.10 to $0.20
Nordic2154: folds 
firstandsole: folds 
magdal28: raises $0.60 to $0.80
Gibilan8584: calls $0.60
*** FLOP *** [6s 7c Qc]
magdal28: bets $0.82
Gibilan8584: calls $0.82
*** TURN *** [6s 7c Qc] [9h]
magdal28: checks 
Gibilan8584: bets $3.97 and is all-in
magdal28: calls $3.97
*** RIVER *** [6s 7c Qc 9h] [Ah]
*** SHOW DOWN ***
magdal28: shows [Jh Qh] (a pair of Queens)
Gibilan8584: shows [Jc 9d] (a pair of Nines)
magdal28 collected $10.72 from pot
Gibilan8584 cashed out the hand for $0.48
*** SUMMARY ***
Total pot $11.23 | Rake $0.51 
Board [6s 7c Qc 9h Ah]
Seat 3: Gibilan8584 showed [Jc 9d] and lost with a pair of Nines (cashed out).
Seat 4: Nordic2154 (button) folded before Flop (didn't bet)
Seat 5: firstandsole (small blind) folded before Flop
Seat 6: magdal28 (big blind) showed [Jh Qh] and won ($10.72) with a pair of Queens



PokerStars Hand #222963054796:  Hold'em No Limit ($0.05/$0.10 USD) - 2021/01/23 13:14:19 ET
Table 'Saito II' 6-max Seat #5 is the button
Seat 3: Gibilan8584 ($0.48 in chips) 
Seat 4: Nordic2154 ($10 in chips) 
Seat 5: firstandsole ($13.54 in chips) 
Seat 6: magdal28 ($15.13 in chips) 
magdal28: posts small blind $0.05
Gibilan8584: posts big blind $0.10
*** HOLE CARDS ***
Nordic2154: folds 
firstandsole: folds 
magdal28: raises $0.15 to $0.25
Gibilan8584: raises $0.15 to $0.40
magdal28: raises $0.15 to $0.55
Gibilan8584: calls $0.08 and is all-in
Uncalled bet ($0.07) returned to magdal28
*** FLOP *** [8d Qc 7c]
*** TURN *** [8d Qc 7c] [Qd]
*** RIVER *** [8d Qc 7c Qd] [Kd]
*** SHOW DOWN ***
magdal28: shows [Td Th] (two pair, Queens and Tens)
Gibilan8584: shows [9h 8c] (two pair, Queens and Eights)
magdal28 collected $0.92 from pot
*** SUMMARY ***
Total pot $0.96 | Rake $0.04 
Board [8d Qc 7c Qd Kd]
Seat 3: Gibilan8584 (big blind) showed [9h 8c] and lost with two pair, Queens and Eights
Seat 4: Nordic2154 folded before Flop (didn't bet)
Seat 5: firstandsole (button) folded before Flop (didn't bet)
Seat 6: magdal28 (small blind) showed [Td Th] and won ($0.92) with two pair, Queens and Tens



PokerStars Hand #222963080233:  Hold'em No Limit ($0.05/$0.10 USD) - 2021/01/23 13:14:57 ET
Table 'Saito II' 6-max Seat #6 is the button
Seat 4: Nordic2154 ($10 in chips) 
Seat 5: firstandsole ($13.54 in chips) 
Seat 6: magdal28 ($15.57 in chips) 
Nordic2154: posts small blind $0.05
firstandsole: posts big blind $0.10
*** HOLE CARDS ***
magdal28: folds 
Nordic2154: raises $0.15 to $0.25
firstandsole: folds 
Uncalled bet ($0.15) returned to Nordic2154
Nordic2154 collected $0.20 from pot
Nordic2154: doesn't show hand 
*** SUMMARY ***
Total pot $0.20 | Rake $0 
Seat 4: Nordic2154 (small blind) collected ($0.20)
Seat 5: firstandsole (big blind) folded before Flop
Seat 6: magdal28 (button) folded before Flop (didn't bet)



PokerStars Hand #222963094814:  Hold'em No Limit ($0.05/$0.10 USD) - 2021/01/23 13:15:06 ET
Table 'Saito II' 6-max Seat #4 is the button
Seat 3: Gibilan8584 ($10 in chips) 
Seat 4: Nordic2154 ($10.10 in chips) 
Seat 5: firstandsole ($13.44 in chips) 
Seat 6: magdal28 ($15.57 in chips) 
firstandsole: posts small blind $0.05
magdal28: posts big blind $0.10
Gibilan8584: posts small blind $0.05
*** HOLE CARDS ***
Gibilan8584: calls $0.10
Nordic2154: folds 
firstandsole: raises $0.20 to $0.30
magdal28: folds 
Gibilan8584: calls $0.20
*** FLOP *** [7d 9s Ah]
firstandsole: bets $0.40
Gibilan8584: folds 
Uncalled bet ($0.40) returned to firstandsole
firstandsole collected $0.72 from pot
firstandsole: doesn't show hand 
*** SUMMARY ***
Total pot $0.75 | Rake $0.03 
Board [7d 9s Ah]
Seat 3: Gibilan8584 folded on the Flop
Seat 4: Nordic2154 (button) folded before Flop (didn't bet)
Seat 5: firstandsole (small blind) collected ($0.72)
Seat 6: magdal28 (big blind) folded before Flop



PokerStars Hand #222963122106:  Hold'em No Limit ($0.05/$0.10 USD) - 2021/01/23 13:15:42 ET
Table 'Saito II' 6-max Seat #5 is the button
Seat 3: Gibilan8584 ($9.65 in chips) 
Seat 4: Nordic2154 ($10.10 in chips) 
Seat 5: firstandsole ($13.86 in chips) 
Seat 6: magdal28 ($15.47 in chips) 
magdal28: posts small blind $0.05
Gibilan8584: posts big blind $0.10
*** HOLE CARDS ***
Nordic2154: folds 
firstandsole: raises $0.20 to $0.30
magdal28: folds 
Gibilan8584: calls $0.20
*** FLOP *** [Kh Ah 5d]
Gibilan8584: checks 
firstandsole: bets $0.24
Gibilan8584: calls $0.24
*** TURN *** [Kh Ah 5d] [7s]
Gibilan8584: checks 
firstandsole: bets $1.40
Gibilan8584: calls $1.40
*** RIVER *** [Kh Ah 5d 7s] [2c]
Gibilan8584: checks 
firstandsole: bets $11.92 and is all-in
Gibilan8584: folds 
Uncalled bet ($11.92) returned to firstandsole
firstandsole collected $3.75 from pot
firstandsole: doesn't show hand 
*** SUMMARY ***
Total pot $3.93 | Rake $0.18 
Board [Kh Ah 5d 7s 2c]
Seat 3: Gibilan8584 (big blind) folded on the River
Seat 4: Nordic2154 folded before Flop (didn't bet)
Seat 5: firstandsole (button) collected ($3.75)
Seat 6: magdal28 (small blind) folded before Flop



PokerStars Hand #222963155928:  Hold'em No Limit ($0.05/$0.10 USD) - 2021/01/23 13:16:28 ET
Table 'Saito II' 6-max Seat #6 is the button
Seat 3: Gibilan8584 ($7.71 in chips) 
Seat 4: Nordic2154 ($10.10 in chips) 
Seat 5: firstandsole ($15.67 in chips) 
Seat 6: magdal28 ($15.42 in chips) 
Gibilan8584: posts small blind $0.05
Nordic2154: posts big blind $0.10
*** HOLE CARDS ***
firstandsole: raises $0.20 to $0.30
magdal28: folds 
CnidTT joins the table at seat #2 
Gibilan8584: calls $0.25
Nordic2154: folds 
*** FLOP *** [4h Kc 4c]
Gibilan8584: checks 
firstandsole: checks 
*** TURN *** [4h Kc 4c] [2h]
Gibilan8584: checks 
firstandsole: bets $0.40
Gibilan8584: raises $0.40 to $0.80
firstandsole: calls $0.40
*** RIVER *** [4h Kc 4c 2h] [Ad]
Gibilan8584: checks 
firstandsole: checks 
*** SHOW DOWN ***
Gibilan8584: shows [Jh 2c] (two pair, Fours and Deuces)
firstandsole: shows [9c 9s] (two pair, Nines and Fours)
firstandsole collected $2.20 from pot
*** SUMMARY ***
Total pot $2.30 | Rake $0.10 
Board [4h Kc 4c 2h Ad]
Seat 3: Gibilan8584 (small blind) showed [Jh 2c] and lost with two pair, Fours and Deuces
Seat 4: Nordic2154 (big blind) folded before Flop
Seat 5: firstandsole showed [9c 9s] and won ($2.20) with two pair, Nines and Fours
Seat 6: magdal28 (button) folded before Flop (didn't bet)



PokerStars Hand #222963193423:  Hold'em No Limit ($0.05/$0.10 USD) - 2021/01/23 13:17:08 ET
Table 'Saito II' 6-max Seat #3 is the button
Seat 3: Gibilan8584 ($6.61 in chips) 
Seat 4: Nordic2154 ($10 in chips) 
Seat 6: magdal28 ($15.42 in chips) 
Nordic2154: posts small blind $0.05
firstandsole: is sitting out 
magdal28: posts big blind $0.10
CnidTT: sits out 
*** HOLE CARDS ***
Gibilan8584: calls $0.10
Nordic2154: folds 
firstandsole leaves the table
magdal28: raises $0.30 to $0.40
Gibilan8584: calls $0.30
*** FLOP *** [Tc Td 3c]
magdal28: bets $0.42
Gibilan8584: calls $0.42
*** TURN *** [Tc Td 3c] [Qd]
magdal28: checks 
NJGT4 joins the table at seat #5 
Gibilan8584: checks 
*** RIVER *** [Tc Td 3c Qd] [Kd]
magdal28: checks 
Gibilan8584: bets $0.70
magdal28: calls $0.70
*** SHOW DOWN ***
Gibilan8584: shows [4d Qs] (two pair, Queens and Tens)
magdal28: mucks hand 
Gibilan8584 collected $2.95 from pot
*** SUMMARY ***
Total pot $3.09 | Rake $0.14 
Board [Tc Td 3c Qd Kd]
Seat 3: Gibilan8584 (button) showed [4d Qs] and won ($2.95) with two pair, Queens and Tens
Seat 4: Nordic2154 (small blind) folded before Flop
Seat 6: magdal28 (big blind) mucked



PokerStars Hand #222963225916:  Hold'em No Limit ($0.05/$0.10 USD) - 2021/01/23 13:17:52 ET
Table 'Saito II' 6-max Seat #4 is the button
Seat 2: CnidTT ($10 in chips) 
Seat 3: Gibilan8584 ($8.04 in chips) 
Seat 4: Nordic2154 ($10 in chips) 
Seat 6: magdal28 ($13.90 in chips) 
magdal28: posts small blind $0.05
CnidTT: posts big blind $0.10
*** HOLE CARDS ***
Gibilan8584: raises $0.10 to $0.20
Nordic2154: calls $0.20
magdal28: folds 
CnidTT: calls $0.10
*** FLOP *** [3h 4d As]
CnidTT: checks 
Gibilan8584: bets $0.40
Nordic2154: folds 
CnidTT: folds 
Uncalled bet ($0.40) returned to Gibilan8584
Gibilan8584 collected $0.62 from pot
perespell was removed from the table for failing to post
perespell leaves the table
Gibilan8584: doesn't show hand 
*** SUMMARY ***
Total pot $0.65 | Rake $0.03 
Board [3h 4d As]
Seat 2: CnidTT (big blind) folded on the Flop
Seat 3: Gibilan8584 collected ($0.62)
Seat 4: Nordic2154 (button) folded on the Flop
Seat 6: magdal28 (small blind) folded before Flop



PokerStars Hand #222963244861:  Hold'em No Limit ($0.05/$0.10 USD) - 2021/01/23 13:18:17 ET
Table 'Saito II' 6-max Seat #6 is the button
Seat 2: CnidTT ($10 in chips) 
Seat 3: Gibilan8584 ($8.46 in chips) 
Seat 4: Nordic2154 ($10 in chips) 
Seat 5: NJGT4 ($6.01 in chips) 
Seat 6: magdal28 ($13.85 in chips) 
CnidTT: posts small blind $0.05
Gibilan8584: posts big blind $0.10
NJGT4: posts big blind $0.10
*** HOLE CARDS ***
Nordic2154: folds 
NJGT4: checks 
magdal28: folds 
CnidTT: folds 
Gibilan8584: checks 
*** FLOP *** [5h 5c 8s]
Gibilan8584: checks 
mysliwiec82 joins the table at seat #1 
NJGT4: bets $0.50
Gibilan8584: calls $0.50
*** TURN *** [5h 5c 8s] [9s]
Gibilan8584: checks 
NJGT4: checks 
*** RIVER *** [5h 5c 8s 9s] [6h]
Gibilan8584: checks 
NJGT4: bets $0.70
Gibilan8584: calls $0.70
*** SHOW DOWN ***
NJGT4: shows [2h 4s] (a pair of Fives)
Gibilan8584: shows [3c 6d] (two pair, Sixes and Fives)
Gibilan8584 collected $2.53 from pot
*** SUMMARY ***
Total pot $2.65 | Rake $0.12 
Board [5h 5c 8s 9s 6h]
Seat 2: CnidTT (small blind) folded before Flop
Seat 3: Gibilan8584 (big blind) showed [3c 6d] and won ($2.53) with two pair, Sixes and Fives
Seat 4: Nordic2154 folded before Flop (didn't bet)
Seat 5: NJGT4 showed [2h 4s] and lost with a pair of Fives
Seat 6: magdal28 (button) folded before Flop (didn't bet)



PokerStars Hand #222963268961:  Hold'em No Limit ($0.05/$0.10 USD) - 2021/01/23 13:18:49 ET
Table 'Saito II' 6-max Seat #2 is the button
Seat 2: CnidTT ($10 in chips) 
Seat 3: Gibilan8584 ($9.69 in chips) 
Seat 4: Nordic2154 ($10 in chips) 
Seat 5: NJGT4 ($4.71 in chips) 
Seat 6: magdal28 ($13.85 in chips) 
Gibilan8584: posts small blind $0.05
Nordic2154: posts big blind $0.10
mysliwiec82: sits out 
*** HOLE CARDS ***
NJGT4: calls $0.10
magdal28: folds 
CnidTT: raises $0.30 to $0.40
Gibilan8584: calls $0.35
Nordic2154: folds 
NJGT4: calls $0.30
*** FLOP *** [Ac 6s 3c]
Gibilan8584: checks 
NJGT4: checks 
CnidTT: bets $0.41
Gibilan8584: calls $0.41
NJGT4: folds 
*** TURN *** [Ac 6s 3c] [Kd]
Gibilan8584: checks 
CnidTT: checks 
*** RIVER *** [Ac 6s 3c Kd] [Kc]
Gibilan8584: checks 
CnidTT: bets $1.52
Gibilan8584: folds 
Uncalled bet ($1.52) returned to CnidTT
CnidTT collected $2.02 from pot
CnidTT: doesn't show hand 
*** SUMMARY ***
Total pot $2.12 | Rake $0.10 
Board [Ac 6s 3c Kd Kc]
Seat 2: CnidTT (button) collected ($2.02)
Seat 3: Gibilan8584 (small blind) folded on the River
Seat 4: Nordic2154 (big blind) folded before Flop
Seat 5: NJGT4 folded on the Flop
Seat 6: magdal28 folded before Flop (didn't bet)



PokerStars Hand #222963307634:  Hold'em No Limit ($0.05/$0.10 USD) - 2021/01/23 13:19:41 ET
Table 'Saito II' 6-max Seat #3 is the button
Seat 2: CnidTT ($11.21 in chips) 
Seat 3: Gibilan8584 ($8.88 in chips) 
Seat 4: Nordic2154 ($10 in chips) 
Seat 5: NJGT4 ($4.31 in chips) 
Seat 6: magdal28 ($13.85 in chips) 
Nordic2154: posts small blind $0.05
NJGT4: posts big blind $0.10
mysliwiec82: sits out 
*** HOLE CARDS ***
magdal28: folds 
CnidTT: folds 
Gibilan8584: calls $0.10
Nordic2154: calls $0.05
NJGT4: checks 
*** FLOP *** [Jc Kd 2s]
Nordic2154: checks 
NJGT4: bets $0.50
Gibilan8584: calls $0.50
Nordic2154: folds 
*** TURN *** [Jc Kd 2s] [Ad]
NJGT4: bets $2
Gibilan8584: folds 
Uncalled bet ($2) returned to NJGT4
NJGT4 collected $1.24 from pot
NJGT4: doesn't show hand 
*** SUMMARY ***
Total pot $1.30 | Rake $0.06 
Board [Jc Kd 2s Ad]
Seat 2: CnidTT folded before Flop (didn't bet)
Seat 3: Gibilan8584 (button) folded on the Turn
Seat 4: Nordic2154 (small blind) folded on the Flop
Seat 5: NJGT4 (big blind) collected ($1.24)
Seat 6: magdal28 folded before Flop (didn't bet)



PokerStars Hand #222963334007:  Hold'em No Limit ($0.05/$0.10 USD) - 2021/01/23 13:20:16 ET
Table 'Saito II' 6-max Seat #4 is the button
Seat 2: CnidTT ($11.21 in chips) 
Seat 3: Gibilan8584 ($8.28 in chips) 
Seat 4: Nordic2154 ($10 in chips) 
Seat 5: NJGT4 ($4.95 in chips) 
Seat 6: magdal28 ($13.85 in chips) 
NJGT4: posts small blind $0.05
magdal28: posts big blind $0.10
mysliwiec82: sits out 
*** HOLE CARDS ***
CnidTT: folds 
Gibilan8584: calls $0.10
Nordic2154: folds 
NJGT4: raises $0.40 to $0.50
magdal28: raises $1.10 to $1.60
Gibilan8584: folds 
NJGT4: calls $1.10
*** FLOP *** [Kc 6h Ad]
NJGT4: checks 
magdal28: bets $1.64
NJGT4: raises $1.71 to $3.35 and is all-in
magdal28: calls $1.71
*** TURN *** [Kc 6h Ad] [4d]
*** RIVER *** [Kc 6h Ad 4d] [8d]
*** SHOW DOWN ***
NJGT4: shows [Ac Tc] (a pair of Aces)
magdal28: shows [Ah Ks] (two pair, Aces and Kings)
magdal28 collected $9.55 from pot
*** SUMMARY ***
Total pot $10 | Rake $0.45 
Board [Kc 6h Ad 4d 8d]
Seat 2: CnidTT folded before Flop (didn't bet)
Seat 3: Gibilan8584 folded before Flop
Seat 4: Nordic2154 (button) folded before Flop (didn't bet)
Seat 5: NJGT4 (small blind) showed [Ac Tc] and lost with a pair of Aces
Seat 6: magdal28 (big blind) showed [Ah Ks] and won ($9.55) with two pair, Aces and Kings



PokerStars Hand #222963377373:  Hold'em No Limit ($0.05/$0.10 USD) - 2021/01/23 13:21:14 ET
Table 'Saito II' 6-max Seat #6 is the button
Seat 2: CnidTT ($11.21 in chips) 
Seat 3: Gibilan8584 ($8.18 in chips) 
Seat 4: Nordic2154 ($10 in chips) 
Seat 6: magdal28 ($18.45 in chips) 
CnidTT: posts small blind $0.05
Gibilan8584: posts big blind $0.10
*** HOLE CARDS ***
Nordic2154: folds 
magdal28: folds 
NJGT4 leaves the table
CnidTT: raises $0.20 to $0.30
Gibilan8584: calls $0.20
*** FLOP *** [As Jh 3s]
CnidTT: checks 
Gibilan8584: checks 
*** TURN *** [As Jh 3s] [7h]
CnidTT: checks 
Gibilan8584: checks 
*** RIVER *** [As Jh 3s 7h] [5s]
CnidTT: checks 
Gibilan8584: bets $0.70
CnidTT: folds 
Uncalled bet ($0.70) returned to Gibilan8584
Gibilan8584 collected $0.57 from pot
Gibilan8584: doesn't show hand 
*** SUMMARY ***
Total pot $0.60 | Rake $0.03 
Board [As Jh 3s 7h 5s]
Seat 2: CnidTT (small blind) folded on the River
Seat 3: Gibilan8584 (big blind) collected ($0.57)
Seat 4: Nordic2154 folded before Flop (didn't bet)
Seat 6: magdal28 (button) folded before Flop (didn't bet)



PokerStars Hand #222963404443:  Hold'em No Limit ($0.05/$0.10 USD) - 2021/01/23 13:21:50 ET
Table 'Saito II' 6-max Seat #2 is the button
Seat 2: CnidTT ($10.91 in chips) 
Seat 3: Gibilan8584 ($8.45 in chips) 
Seat 4: Nordic2154 ($10 in chips) 
Seat 6: magdal28 ($18.45 in chips) 
Gibilan8584: posts small blind $0.05
Nordic2154: posts big blind $0.10
mysliwiec82: sits out 
*** HOLE CARDS ***
magdal28: folds 
CnidTT: folds 
Gibilan8584: calls $0.05
Nordic2154: raises $0.30 to $0.40
Gibilan8584: calls $0.30
*** FLOP *** [4h 8s 3c]
Gibilan8584: checks 
Nordic2154: bets $0.25
Gibilan8584: calls $0.25
*** TURN *** [4h 8s 3c] [Jh]
Gibilan8584: checks 
Nordic2154: checks 
*** RIVER *** [4h 8s 3c Jh] [3d]
Calde-Rum joins the table at seat #5 
Gibilan8584: checks 
Nordic2154: checks 
*** SHOW DOWN ***
Gibilan8584: shows [2d Ks] (a pair of Threes)
Nordic2154: shows [Kc Qd] (a pair of Threes - King+Queen kicker)
Nordic2154 collected $1.24 from pot
*** SUMMARY ***
Total pot $1.30 | Rake $0.06 
Board [4h 8s 3c Jh 3d]
Seat 2: CnidTT (button) folded before Flop (didn't bet)
Seat 3: Gibilan8584 (small blind) showed [2d Ks] and lost with a pair of Threes
Seat 4: Nordic2154 (big blind) showed [Kc Qd] and won ($1.24) with a pair of Threes
Seat 6: magdal28 folded before Flop (didn't bet)



PokerStars Hand #222963444593:  Hold'em No Limit ($0.05/$0.10 USD) - 2021/01/23 13:22:43 ET
Table 'Saito II' 6-max Seat #3 is the button
Seat 2: CnidTT ($10.91 in chips) 
Seat 3: Gibilan8584 ($7.80 in chips) 
Seat 4: Nordic2154 ($10.59 in chips) 
Seat 5: Calde-Rum ($10 in chips) 
Seat 6: magdal28 ($18.45 in chips) 
Nordic2154: posts small blind $0.05
Calde-Rum: posts big blind $0.10
mysliwiec82: sits out 
*** HOLE CARDS ***
magdal28: folds 
CnidTT: folds 
Gibilan8584: calls $0.10
Nordic2154: folds 
Calde-Rum: checks 
*** FLOP *** [4d 2h Qc]
Calde-Rum: checks 
Gibilan8584: checks 
*** TURN *** [4d 2h Qc] [Qd]
Calde-Rum: bets $0.10
Gibilan8584: calls $0.10
*** RIVER *** [4d 2h Qc Qd] [5s]
Calde-Rum: checks 
Gibilan8584: checks 
*** SHOW DOWN ***
Calde-Rum: shows [2c 3c] (two pair, Queens and Deuces)
Gibilan8584: mucks hand 
Calde-Rum collected $0.43 from pot
*** SUMMARY ***
Total pot $0.45 | Rake $0.02 
Board [4d 2h Qc Qd 5s]
Seat 2: CnidTT folded before Flop (didn't bet)
Seat 3: Gibilan8584 (button) mucked
Seat 4: Nordic2154 (small blind) folded before Flop
Seat 5: Calde-Rum (big blind) showed [2c 3c] and won ($0.43) with two pair, Queens and Deuces
Seat 6: magdal28 folded before Flop (didn't bet)



PokerStars Hand #222963471778:  Hold'em No Limit ($0.05/$0.10 USD) - 2021/01/23 13:23:19 ET
Table 'Saito II' 6-max Seat #4 is the button
Seat 2: CnidTT ($10.91 in chips) 
Seat 3: Gibilan8584 ($7.60 in chips) 
Seat 4: Nordic2154 ($10.54 in chips) 
Seat 5: Calde-Rum ($10.23 in chips) 
Seat 6: magdal28 ($18.45 in chips) 
Calde-Rum: posts small blind $0.05
magdal28: posts big blind $0.10
mysliwiec82: sits out 
*** HOLE CARDS ***
CnidTT: folds 
Gibilan8584: calls $0.10
Nordic2154: folds 
Calde-Rum: folds 
magdal28: checks 
*** FLOP *** [Kd 5h Td]
magdal28: checks 
Gibilan8584: checks 
*** TURN *** [Kd 5h Td] [3s]
magdal28: checks 
Gibilan8584: checks 
*** RIVER *** [Kd 5h Td 3s] [Ts]
magdal28: checks 
Gibilan8584: folds [Qh 9c]
magdal28 collected $0.24 from pot
magdal28: doesn't show hand 
*** SUMMARY ***
Total pot $0.25 | Rake $0.01 
Board [Kd 5h Td 3s Ts]
Seat 2: CnidTT folded before Flop (didn't bet)
Seat 3: Gibilan8584 folded on the River
Seat 4: Nordic2154 (button) folded before Flop (didn't bet)
Seat 5: Calde-Rum (small blind) folded before Flop
Seat 6: magdal28 (big blind) collected ($0.24)



PokerStars Hand #222963517212:  Hold'em No Limit ($0.05/$0.10 USD) - 2021/01/23 13:24:19 ET
Table 'Saito II' 6-max Seat #5 is the button
Seat 1: mysliwiec82 ($10 in chips) 
Seat 2: CnidTT ($10.91 in chips) 
Seat 3: Gibilan8584 ($7.50 in chips) 
Seat 4: Nordic2154 ($10.54 in chips) 
Seat 5: Calde-Rum ($10.18 in chips) 
Seat 6: magdal28 ($18.59 in chips) 
magdal28: posts small blind $0.05
mysliwiec82: posts big blind $0.10
*** HOLE CARDS ***
CnidTT: folds 
Gibilan8584: calls $0.10
Nordic2154: folds 
Calde-Rum: folds 
magdal28: folds 
mysliwiec82: checks 
*** FLOP *** [8d Qh Qs]
mysliwiec82: checks 
Gibilan8584: checks 
*** TURN *** [8d Qh Qs] [9d]
mysliwiec82: checks 
Gibilan8584: checks 
*** RIVER *** [8d Qh Qs 9d] [Ks]
mysliwiec82: checks 
Gibilan8584: checks 
*** SHOW DOWN ***
mysliwiec82: shows [2s 4h] (a pair of Queens)
Gibilan8584: shows [3h Ac] (a pair of Queens - Ace kicker)
Gibilan8584 collected $0.24 from pot
*** SUMMARY ***
Total pot $0.25 | Rake $0.01 
Board [8d Qh Qs 9d Ks]
Seat 1: mysliwiec82 (big blind) showed [2s 4h] and lost with a pair of Queens
Seat 2: CnidTT folded before Flop (didn't bet)
Seat 3: Gibilan8584 showed [3h Ac] and won ($0.24) with a pair of Queens
Seat 4: Nordic2154 folded before Flop (didn't bet)
Seat 5: Calde-Rum (button) folded before Flop (didn't bet)
Seat 6: magdal28 (small blind) folded before Flop



PokerStars Hand #222963536835:  Hold'em No Limit ($0.05/$0.10 USD) - 2021/01/23 13:24:45 ET
Table 'Saito II' 6-max Seat #6 is the button
Seat 1: mysliwiec82 ($10 in chips) 
Seat 2: CnidTT ($10.91 in chips) 
Seat 3: Gibilan8584 ($7.64 in chips) 
Seat 4: Nordic2154 ($10.54 in chips) 
Seat 5: Calde-Rum ($10.18 in chips) 
Seat 6: magdal28 ($18.54 in chips) 
mysliwiec82: posts small blind $0.05
CnidTT: posts big blind $0.10
*** HOLE CARDS ***
Gibilan8584: calls $0.10
Nordic2154: folds 
Calde-Rum: raises $0.40 to $0.50
magdal28: folds 
mysliwiec82: folds 
CnidTT: folds 
Gibilan8584: calls $0.40
*** FLOP *** [Tc Qh Ac]
Gibilan8584: checks 
Calde-Rum: bets $0.36
Gibilan8584: folds 
Uncalled bet ($0.36) returned to Calde-Rum
Calde-Rum collected $1.10 from pot
Calde-Rum: doesn't show hand 
*** SUMMARY ***
Total pot $1.15 | Rake $0.05 
Board [Tc Qh Ac]
Seat 1: mysliwiec82 (small blind) folded before Flop
Seat 2: CnidTT (big blind) folded before Flop
Seat 3: Gibilan8584 folded on the Flop
Seat 4: Nordic2154 folded before Flop (didn't bet)
Seat 5: Calde-Rum collected ($1.10)
Seat 6: magdal28 (button) folded before Flop (didn't bet)



PokerStars Hand #222963558541:  Hold'em No Limit ($0.05/$0.10 USD) - 2021/01/23 13:25:14 ET
Table 'Saito II' 6-max Seat #1 is the button
Seat 1: mysliwiec82 ($10 in chips) 
Seat 2: CnidTT ($10.81 in chips) 
Seat 3: Gibilan8584 ($7.14 in chips) 
Seat 4: Nordic2154 ($10.54 in chips) 
Seat 5: Calde-Rum ($10.78 in chips) 
Seat 6: magdal28 ($18.54 in chips) 
CnidTT: posts small blind $0.05
Gibilan8584: posts big blind $0.10
*** HOLE CARDS ***
Nordic2154: raises $0.15 to $0.25
Calde-Rum: folds 
magdal28: folds 
mysliwiec82: folds 
CnidTT: folds 
Gibilan8584: calls $0.15
*** FLOP *** [Qs 4s 9s]
Gibilan8584: checks 
Nordic2154: bets $0.35
Gibilan8584: folds 
Uncalled bet ($0.35) returned to Nordic2154
Nordic2154 collected $0.53 from pot
Nordic2154: doesn't show hand 
*** SUMMARY ***
Total pot $0.55 | Rake $0.02 
Board [Qs 4s 9s]
Seat 1: mysliwiec82 (button) folded before Flop (didn't bet)
Seat 2: CnidTT (small blind) folded before Flop
Seat 3: Gibilan8584 (big blind) folded on the Flop
Seat 4: Nordic2154 collected ($0.53)
Seat 5: Calde-Rum folded before Flop (didn't bet)
Seat 6: magdal28 folded before Flop (didn't bet)



PokerStars Hand #222963579088:  Hold'em No Limit ($0.05/$0.10 USD) - 2021/01/23 13:25:41 ET
Table 'Saito II' 6-max Seat #2 is the button
Seat 1: mysliwiec82 ($10 in chips) 
Seat 2: CnidTT ($10.76 in chips) 
Seat 3: Gibilan8584 ($6.89 in chips) 
Seat 4: Nordic2154 ($10.82 in chips) 
Seat 5: Calde-Rum ($10.78 in chips) 
Seat 6: magdal28 ($18.54 in chips) 
Gibilan8584: posts small blind $0.05
Nordic2154: posts big blind $0.10
*** HOLE CARDS ***
Calde-Rum: folds 
magdal28: folds 
mysliwiec82: raises $0.20 to $0.30
CnidTT: folds 
Gibilan8584: calls $0.25
Nordic2154: folds 
*** FLOP *** [Qs 2s 3s]
Gibilan8584: checks 
mysliwiec82: bets $0.67
Gibilan8584: calls $0.67
*** TURN *** [Qs 2s 3s] [7s]
Gibilan8584: checks 
mysliwiec82: checks 
*** RIVER *** [Qs 2s 3s 7s] [Tc]
Gibilan8584: checks 
mysliwiec82: checks 
*** SHOW DOWN ***
Gibilan8584: shows [6s 4s] (a flush, Queen high)
mysliwiec82: mucks hand 
Gibilan8584 collected $1.95 from pot
*** SUMMARY ***
Total pot $2.04 | Rake $0.09 
Board [Qs 2s 3s 7s Tc]
Seat 1: mysliwiec82 mucked
Seat 2: CnidTT (button) folded before Flop (didn't bet)
Seat 3: Gibilan8584 (small blind) showed [6s 4s] and won ($1.95) with a flush, Queen high
Seat 4: Nordic2154 (big blind) folded before Flop
Seat 5: Calde-Rum folded before Flop (didn't bet)
Seat 6: magdal28 folded before Flop (didn't bet)



PokerStars Hand #222963607559:  Hold'em No Limit ($0.05/$0.10 USD) - 2021/01/23 13:26:18 ET
Table 'Saito II' 6-max Seat #3 is the button
Seat 1: mysliwiec82 ($10 in chips) 
Seat 2: CnidTT ($10.76 in chips) 
Seat 3: Gibilan8584 ($7.87 in chips) 
Seat 4: Nordic2154 ($10.72 in chips) 
Seat 5: Calde-Rum ($10.78 in chips) 
Seat 6: magdal28 ($18.54 in chips) 
Nordic2154: posts small blind $0.05
Calde-Rum: posts big blind $0.10
*** HOLE CARDS ***
magdal28: folds 
mysliwiec82: folds 
CnidTT: folds 
Gibilan8584: calls $0.10
Nordic2154: folds 
Calde-Rum: raises $0.40 to $0.50
Gibilan8584: calls $0.40
*** FLOP *** [3h 4h 6c]
Calde-Rum: bets $0.25
Gibilan8584: calls $0.25
*** TURN *** [3h 4h 6c] [2h]
Calde-Rum: checks 
Gibilan8584: bets $0.50
Calde-Rum: calls $0.50
*** RIVER *** [3h 4h 6c 2h] [5c]
Calde-Rum: checks 
Gibilan8584: bets $0.70
Calde-Rum: calls $0.70
*** SHOW DOWN ***
Gibilan8584: shows [2c 3c] (a straight, Deuce to Six)
Calde-Rum: shows [6s 5s] (a straight, Deuce to Six)
Calde-Rum collected $1.89 from pot
Gibilan8584 collected $1.88 from pot
*** SUMMARY ***
Total pot $3.95 | Rake $0.18 
Board [3h 4h 6c 2h 5c]
Seat 1: mysliwiec82 folded before Flop (didn't bet)
Seat 2: CnidTT folded before Flop (didn't bet)
Seat 3: Gibilan8584 (button) showed [2c 3c] and won ($1.88) with a straight, Deuce to Six
Seat 4: Nordic2154 (small blind) folded before Flop
Seat 5: Calde-Rum (big blind) showed [6s 5s] and won ($1.89) with a straight, Deuce to Six
Seat 6: magdal28 folded before Flop (didn't bet)



PokerStars Hand #222963637750:  Hold'em No Limit ($0.05/$0.10 USD) - 2021/01/23 13:26:58 ET
Table 'Saito II' 6-max Seat #4 is the button
Seat 1: mysliwiec82 ($10 in chips) 
Seat 2: CnidTT ($10.76 in chips) 
Seat 3: Gibilan8584 ($7.80 in chips) 
Seat 4: Nordic2154 ($10.67 in chips) 
Seat 5: Calde-Rum ($10.72 in chips) 
Seat 6: magdal28 ($18.54 in chips) 
Calde-Rum: posts small blind $0.05
magdal28: posts big blind $0.10
*** HOLE CARDS ***
mysliwiec82: folds 
CnidTT: folds 
Gibilan8584: raises $0.10 to $0.20
Nordic2154: folds 
Calde-Rum: folds 
magdal28: calls $0.10
*** FLOP *** [5h Jd As]
magdal28: checks 
Gibilan8584: checks 
*** TURN *** [5h Jd As] [Th]
magdal28: bets $0.26
Gibilan8584: calls $0.26
*** RIVER *** [5h Jd As Th] [2h]
magdal28: checks 
Gibilan8584: bets $0.50
magdal28: folds 
Uncalled bet ($0.50) returned to Gibilan8584
Gibilan8584 collected $0.93 from pot
Gibilan8584: doesn't show hand 
*** SUMMARY ***
Total pot $0.97 | Rake $0.04 
Board [5h Jd As Th 2h]
Seat 1: mysliwiec82 folded before Flop (didn't bet)
Seat 2: CnidTT folded before Flop (didn't bet)
Seat 3: Gibilan8584 collected ($0.93)
Seat 4: Nordic2154 (button) folded before Flop (didn't bet)
Seat 5: Calde-Rum (small blind) folded before Flop
Seat 6: magdal28 (big blind) folded on the River



PokerStars Hand #222963672535:  Hold'em No Limit ($0.05/$0.10 USD) - 2021/01/23 13:27:44 ET
Table 'Saito II' 6-max Seat #5 is the button
Seat 1: mysliwiec82 ($10 in chips) 
Seat 2: CnidTT ($10.76 in chips) 
Seat 3: Gibilan8584 ($8.27 in chips) 
Seat 4: Nordic2154 ($10.67 in chips) 
Seat 5: Calde-Rum ($10.67 in chips) 
Seat 6: magdal28 ($18.08 in chips) 
magdal28: posts small blind $0.05
mysliwiec82: posts big blind $0.10
*** HOLE CARDS ***
CnidTT: folds 
Gibilan8584: calls $0.10
Nordic2154: folds 
Calde-Rum: folds 
magdal28: folds 
mysliwiec82: checks 
*** FLOP *** [9d 8s 7c]
mysliwiec82: checks 
Gibilan8584: checks 
*** TURN *** [9d 8s 7c] [3d]
mysliwiec82: checks 
Gibilan8584: checks 
*** RIVER *** [9d 8s 7c 3d] [Qh]
mysliwiec82: checks 
Gibilan8584: checks 
*** SHOW DOWN ***
mysliwiec82: shows [4c 5c] (high card Queen)
Gibilan8584: shows [As 3c] (a pair of Threes)
Gibilan8584 collected $0.24 from pot
*** SUMMARY ***
Total pot $0.25 | Rake $0.01 
Board [9d 8s 7c 3d Qh]
Seat 1: mysliwiec82 (big blind) showed [4c 5c] and lost with high card Queen
Seat 2: CnidTT folded before Flop (didn't bet)
Seat 3: Gibilan8584 showed [As 3c] and won ($0.24) with a pair of Threes
Seat 4: Nordic2154 folded before Flop (didn't bet)
Seat 5: Calde-Rum (button) folded before Flop (didn't bet)
Seat 6: magdal28 (small blind) folded before Flop



PokerStars Hand #222963688006:  Hold'em No Limit ($0.05/$0.10 USD) - 2021/01/23 13:28:05 ET
Table 'Saito II' 6-max Seat #6 is the button
Seat 1: mysliwiec82 ($10 in chips) 
Seat 2: CnidTT ($10.76 in chips) 
Seat 3: Gibilan8584 ($8.41 in chips) 
Seat 4: Nordic2154 ($10.67 in chips) 
Seat 5: Calde-Rum ($10.67 in chips) 
Seat 6: magdal28 ($18.03 in chips) 
mysliwiec82: posts small blind $0.05
CnidTT: posts big blind $0.10
*** HOLE CARDS ***
Gibilan8584: calls $0.10
Nordic2154: folds 
Calde-Rum: folds 
magdal28: folds 
mysliwiec82: raises $0.30 to $0.40
CnidTT: folds 
Gibilan8584: folds 
Uncalled bet ($0.30) returned to mysliwiec82
mysliwiec82 collected $0.30 from pot
*** SUMMARY ***
Total pot $0.30 | Rake $0 
Seat 1: mysliwiec82 (small blind) collected ($0.30)
Seat 2: CnidTT (big blind) folded before Flop
Seat 3: Gibilan8584 folded before Flop
Seat 4: Nordic2154 folded before Flop (didn't bet)
Seat 5: Calde-Rum folded before Flop (didn't bet)
Seat 6: magdal28 (button) folded before Flop (didn't bet)



PokerStars Hand #222963706869:  Hold'em No Limit ($0.05/$0.10 USD) - 2021/01/23 13:28:30 ET
Table 'Saito II' 6-max Seat #1 is the button
Seat 1: mysliwiec82 ($10.20 in chips) 
Seat 2: CnidTT ($10.66 in chips) 
Seat 3: Gibilan8584 ($8.31 in chips) 
Seat 4: Nordic2154 ($10.67 in chips) 
Seat 5: Calde-Rum ($10.67 in chips) 
Seat 6: magdal28 ($18.03 in chips) 
CnidTT: posts small blind $0.05
Gibilan8584: posts big blind $0.10
*** HOLE CARDS ***
Nordic2154: folds 
Calde-Rum: folds 
magdal28: folds 
mysliwiec82: folds 
CnidTT: folds 
Uncalled bet ($0.05) returned to Gibilan8584
Gibilan8584 collected $0.10 from pot
Gibilan8584: doesn't show hand 
*** SUMMARY ***
Total pot $0.10 | Rake $0 
Seat 1: mysliwiec82 (button) folded before Flop (didn't bet)
Seat 2: CnidTT (small blind) folded before Flop
Seat 3: Gibilan8584 (big blind) collected ($0.10)
Seat 4: Nordic2154 folded before Flop (didn't bet)
Seat 5: Calde-Rum folded before Flop (didn't bet)
Seat 6: magdal28 folded before Flop (didn't bet)



PokerStars Hand #222963715531:  Hold'em No Limit ($0.05/$0.10 USD) - 2021/01/23 13:28:41 ET
Table 'Saito II' 6-max Seat #2 is the button
Seat 1: mysliwiec82 ($10.20 in chips) 
Seat 2: CnidTT ($10.61 in chips) 
Seat 3: Gibilan8584 ($8.36 in chips) 
Seat 4: Nordic2154 ($10.67 in chips) 
Seat 5: Calde-Rum ($10.67 in chips) 
Seat 6: magdal28 ($18.03 in chips) 
Gibilan8584: posts small blind $0.05
Nordic2154: posts big blind $0.10
*** HOLE CARDS ***
Calde-Rum: folds 
magdal28: folds 
mysliwiec82: folds 
CnidTT: folds 
Gibilan8584: calls $0.05
Nordic2154: checks 
*** FLOP *** [Kh 9c Ad]
Gibilan8584: checks 
Nordic2154: checks 
*** TURN *** [Kh 9c Ad] [2s]
Gibilan8584: checks 
Nordic2154: bets $0.10
Gibilan8584: calls $0.10
*** RIVER *** [Kh 9c Ad 2s] [4d]
Gibilan8584: checks 
Nordic2154: bets $10.47 and is all-in
Gibilan8584: folds [8c Th]
Uncalled bet ($10.47) returned to Nordic2154
Nordic2154 collected $0.38 from pot
Nordic2154: doesn't show hand 
*** SUMMARY ***
Total pot $0.40 | Rake $0.02 
Board [Kh 9c Ad 2s 4d]
Seat 1: mysliwiec82 folded before Flop (didn't bet)
Seat 2: CnidTT (button) folded before Flop (didn't bet)
Seat 3: Gibilan8584 (small blind) folded on the River
Seat 4: Nordic2154 (big blind) collected ($0.38)
Seat 5: Calde-Rum folded before Flop (didn't bet)
Seat 6: magdal28 folded before Flop (didn't bet)



PokerStars Hand #222963746658:  Hold'em No Limit ($0.05/$0.10 USD) - 2021/01/23 13:29:22 ET
Table 'Saito II' 6-max Seat #3 is the button
Seat 1: mysliwiec82 ($10.20 in chips) 
Seat 2: CnidTT ($10.61 in chips) 
Seat 3: Gibilan8584 ($8.16 in chips) 
Seat 4: Nordic2154 ($10.85 in chips) 
Seat 5: Calde-Rum ($10.67 in chips) 
Seat 6: magdal28 ($18.03 in chips) 
Nordic2154: posts small blind $0.05
Calde-Rum: posts big blind $0.10
*** HOLE CARDS ***
magdal28: folds 
mysliwiec82: folds 
CnidTT: folds 
Gibilan8584: calls $0.10
Nordic2154: calls $0.05
Calde-Rum: checks 
*** FLOP *** [9d Jh 6s]
Nordic2154: checks 
Calde-Rum: checks 
Gibilan8584: bets $0.30
Nordic2154: folds 
Calde-Rum: folds 
Uncalled bet ($0.30) returned to Gibilan8584
Gibilan8584 collected $0.29 from pot
Gibilan8584: doesn't show hand 
*** SUMMARY ***
Total pot $0.30 | Rake $0.01 
Board [9d Jh 6s]
Seat 1: mysliwiec82 folded before Flop (didn't bet)
Seat 2: CnidTT folded before Flop (didn't bet)
Seat 3: Gibilan8584 (button) collected ($0.29)
Seat 4: Nordic2154 (small blind) folded on the Flop
Seat 5: Calde-Rum (big blind) folded on the Flop
Seat 6: magdal28 folded before Flop (didn't bet)



PokerStars Hand #222963775292:  Hold'em No Limit ($0.05/$0.10 USD) - 2021/01/23 13:30:01 ET
Table 'Saito II' 6-max Seat #4 is the button
Seat 1: mysliwiec82 ($10.20 in chips) 
Seat 2: CnidTT ($10.61 in chips) 
Seat 3: Gibilan8584 ($8.35 in chips) 
Seat 4: Nordic2154 ($10.75 in chips) 
Seat 5: Calde-Rum ($10.57 in chips) 
Seat 6: magdal28 ($18.03 in chips) 
Calde-Rum: posts small blind $0.05
magdal28: posts big blind $0.10
*** HOLE CARDS ***
mysliwiec82: raises $0.20 to $0.30
CnidTT: folds 
Gibilan8584: folds 
Nordic2154: folds 
Calde-Rum: folds 
magdal28: folds 
Uncalled bet ($0.20) returned to mysliwiec82
mysliwiec82 collected $0.25 from pot
*** SUMMARY ***
Total pot $0.25 | Rake $0 
Seat 1: mysliwiec82 collected ($0.25)
Seat 2: CnidTT folded before Flop (didn't bet)
Seat 3: Gibilan8584 folded before Flop (didn't bet)
Seat 4: Nordic2154 (button) folded before Flop (didn't bet)
Seat 5: Calde-Rum (small blind) folded before Flop
Seat 6: magdal28 (big blind) folded before Flop



PokerStars Hand #222963792367:  Hold'em No Limit ($0.05/$0.10 USD) - 2021/01/23 13:30:22 ET
Table 'Saito II' 6-max Seat #5 is the button
Seat 1: mysliwiec82 ($10.35 in chips) 
Seat 2: CnidTT ($10.61 in chips) 
Seat 3: Gibilan8584 ($8.35 in chips) 
Seat 4: Nordic2154 ($10.75 in chips) 
Seat 5: Calde-Rum ($10.52 in chips) 
Seat 6: magdal28 ($17.93 in chips) 
magdal28: posts small blind $0.05
mysliwiec82: posts big blind $0.10
*** HOLE CARDS ***
CnidTT: folds 
Gibilan8584: calls $0.10
Nordic2154: folds 
Calde-Rum: raises $0.40 to $0.50
magdal28: folds 
mysliwiec82: calls $0.40
Gibilan8584: calls $0.40
*** FLOP *** [Th 3h 7d]
mysliwiec82: checks 
Gibilan8584: checks 
Calde-Rum: bets $0.74
mysliwiec82: folds 
Gibilan8584: folds 
Uncalled bet ($0.74) returned to Calde-Rum
Calde-Rum collected $1.48 from pot
Calde-Rum: doesn't show hand 
*** SUMMARY ***
Total pot $1.55 | Rake $0.07 
Board [Th 3h 7d]
Seat 1: mysliwiec82 (big blind) folded on the Flop
Seat 2: CnidTT folded before Flop (didn't bet)
Seat 3: Gibilan8584 folded on the Flop
Seat 4: Nordic2154 folded before Flop (didn't bet)
Seat 5: Calde-Rum (button) collected ($1.48)
Seat 6: magdal28 (small blind) folded before Flop



PokerStars Hand #222963813970:  Hold'em No Limit ($0.05/$0.10 USD) - 2021/01/23 13:30:50 ET
Table 'Saito II' 6-max Seat #6 is the button
Seat 1: mysliwiec82 ($10 in chips) 
Seat 2: CnidTT ($10.61 in chips) 
Seat 3: Gibilan8584 ($7.85 in chips) 
Seat 4: Nordic2154 ($10.75 in chips) 
Seat 5: Calde-Rum ($11.50 in chips) 
Seat 6: magdal28 ($17.88 in chips) 
mysliwiec82: posts small blind $0.05
CnidTT: posts big blind $0.10
*** HOLE CARDS ***
Gibilan8584: calls $0.10
Nordic2154: folds 
Calde-Rum: folds 
magdal28: folds 
mysliwiec82: calls $0.05
CnidTT: checks 
*** FLOP *** [Qd Js 3h]
mysliwiec82: checks 
CnidTT: checks 
Gibilan8584: bets $0.30
mysliwiec82: folds 
CnidTT: folds 
Uncalled bet ($0.30) returned to Gibilan8584
Gibilan8584 collected $0.29 from pot
Gibilan8584: doesn't show hand 
*** SUMMARY ***
Total pot $0.30 | Rake $0.01 
Board [Qd Js 3h]
Seat 1: mysliwiec82 (small blind) folded on the Flop
Seat 2: CnidTT (big blind) folded on the Flop
Seat 3: Gibilan8584 collected ($0.29)
Seat 4: Nordic2154 folded before Flop (didn't bet)
Seat 5: Calde-Rum folded before Flop (didn't bet)
Seat 6: magdal28 (button) folded before Flop (didn't bet)



PokerStars Hand #222963839700:  Hold'em No Limit ($0.05/$0.10 USD) - 2021/01/23 13:31:23 ET
Table 'Saito II' 6-max Seat #1 is the button
Seat 1: mysliwiec82 ($10 in chips) 
Seat 2: CnidTT ($10.51 in chips) 
Seat 3: Gibilan8584 ($8.04 in chips) 
Seat 4: Nordic2154 ($10.75 in chips) 
Seat 5: Calde-Rum ($11.50 in chips) 
Seat 6: magdal28 ($17.88 in chips) 
CnidTT: posts small blind $0.05
Gibilan8584: posts big blind $0.10
*** HOLE CARDS ***
Nordic2154: raises $0.15 to $0.25
Calde-Rum: folds 
magdal28: folds 
mysliwiec82: folds 
CnidTT: folds 
Gibilan8584: folds 
Uncalled bet ($0.15) returned to Nordic2154
Nordic2154 collected $0.25 from pot
Nordic2154: doesn't show hand 
*** SUMMARY ***
Total pot $0.25 | Rake $0 
Seat 1: mysliwiec82 (button) folded before Flop (didn't bet)
Seat 2: CnidTT (small blind) folded before Flop
Seat 3: Gibilan8584 (big blind) folded before Flop
Seat 4: Nordic2154 collected ($0.25)
Seat 5: Calde-Rum folded before Flop (didn't bet)
Seat 6: magdal28 folded before Flop (didn't bet)



PokerStars Hand #222963852377:  Hold'em No Limit ($0.05/$0.10 USD) - 2021/01/23 13:31:39 ET
Table 'Saito II' 6-max Seat #2 is the button
Seat 1: mysliwiec82 ($10 in chips) 
Seat 2: CnidTT ($10.46 in chips) 
Seat 3: Gibilan8584 ($7.94 in chips) 
Seat 4: Nordic2154 ($10.90 in chips) 
Seat 5: Calde-Rum ($11.50 in chips) 
Seat 6: magdal28 ($17.88 in chips) 
Gibilan8584: posts small blind $0.05
Nordic2154: posts big blind $0.10
*** HOLE CARDS ***
Calde-Rum: folds 
magdal28: raises $0.15 to $0.25
mysliwiec82: folds 
CnidTT: folds 
Gibilan8584: calls $0.20
Nordic2154: calls $0.15
*** FLOP *** [6s 4s 2d]
Gibilan8584: checks 
Nordic2154: bets $0.35
magdal28: raises $0.74 to $1.09
Gibilan8584: calls $1.09
Nordic2154: folds 
*** TURN *** [6s 4s 2d] [4c]
Gibilan8584: checks 
magdal28: bets $1.88
Gibilan8584: calls $1.88
*** RIVER *** [6s 4s 2d 4c] [2c]
Gibilan8584: checks 
magdal28: checks 
*** SHOW DOWN ***
Gibilan8584: shows [6c Qh] (two pair, Sixes and Fours)
magdal28: shows [9s 9c] (two pair, Nines and Fours)
magdal28 collected $6.72 from pot
*** SUMMARY ***
Total pot $7.04 | Rake $0.32 
Board [6s 4s 2d 4c 2c]
Seat 1: mysliwiec82 folded before Flop (didn't bet)
Seat 2: CnidTT (button) folded before Flop (didn't bet)
Seat 3: Gibilan8584 (small blind) showed [6c Qh] and lost with two pair, Sixes and Fours
Seat 4: Nordic2154 (big blind) folded on the Flop
Seat 5: Calde-Rum folded before Flop (didn't bet)
Seat 6: magdal28 showed [9s 9c] and won ($6.72) with two pair, Nines and Fours



PokerStars Hand #222963911878:  Hold'em No Limit ($0.05/$0.10 USD) - 2021/01/23 13:32:55 ET
Table 'Saito II' 6-max Seat #3 is the button
Seat 1: mysliwiec82 ($10 in chips) 
Seat 2: CnidTT ($10.46 in chips) 
Seat 3: Gibilan8584 ($4.72 in chips) 
Seat 4: Nordic2154 ($10.30 in chips) 
Seat 5: Calde-Rum ($11.50 in chips) 
Seat 6: magdal28 ($21.38 in chips) 
Nordic2154: posts small blind $0.05
Calde-Rum: posts big blind $0.10
*** HOLE CARDS ***
magdal28: folds 
mysliwiec82: raises $0.20 to $0.30
CnidTT: folds 
Gibilan8584: calls $0.30
Nordic2154: folds 
Calde-Rum: folds 
*** FLOP *** [Td 9h 5d]
Calde-Rum was removed from the table for failing to post
Calde-Rum leaves the table
pondax joins the table at seat #5 
mysliwiec82: bets $0.48
Gibilan8584: calls $0.48
*** TURN *** [Td 9h 5d] [9s]
mysliwiec82: bets $0.82
Gibilan8584: calls $0.82
*** RIVER *** [Td 9h 5d 9s] [Js]
mysliwiec82: checks 
Gibilan8584: checks 
*** SHOW DOWN ***
mysliwiec82: shows [Ad Qd] (a pair of Nines)
Gibilan8584: mucks hand 
mysliwiec82 collected $3.20 from pot
*** SUMMARY ***
Total pot $3.35 | Rake $0.15 
Board [Td 9h 5d 9s Js]
Seat 1: mysliwiec82 showed [Ad Qd] and won ($3.20) with a pair of Nines
Seat 2: CnidTT folded before Flop (didn't bet)
Seat 3: Gibilan8584 (button) mucked
Seat 4: Nordic2154 (small blind) folded before Flop
Seat 5: Calde-Rum (big blind) folded before Flop
Seat 6: magdal28 folded before Flop (didn't bet)



PokerStars Hand #222963942924:  Hold'em No Limit ($0.05/$0.10 USD) - 2021/01/23 13:33:35 ET
Table 'Saito II' 6-max Seat #4 is the button
Seat 1: mysliwiec82 ($11.60 in chips) 
Seat 2: CnidTT ($10.46 in chips) 
Seat 3: Gibilan8584 ($3.12 in chips) 
Seat 4: Nordic2154 ($10.25 in chips) 
Seat 6: magdal28 ($21.38 in chips) 
magdal28: posts small blind $0.05
mysliwiec82: posts big blind $0.10
*** HOLE CARDS ***
CnidTT: folds 
Gibilan8584: calls $0.10
Nordic2154: folds 
magdal28: raises $0.30 to $0.40
mysliwiec82: folds 
Gibilan8584: calls $0.30
*** FLOP *** [7c 4h 8d]
magdal28: bets $0.45
Gibilan8584: calls $0.45
*** TURN *** [7c 4h 8d] [9h]
magdal28: checks 
Gibilan8584: checks 
*** RIVER *** [7c 4h 8d 9h] [8c]
magdal28: bets $1.24
Gibilan8584: raises $1.03 to $2.27 and is all-in
magdal28: calls $1.03
*** SHOW DOWN ***
Gibilan8584: shows [6h 6s] (two pair, Eights and Sixes)
magdal28: shows [8s As] (three of a kind, Eights)
magdal28 collected $6.05 from pot
*** SUMMARY ***
Total pot $6.34 | Rake $0.29 
Board [7c 4h 8d 9h 8c]
Seat 1: mysliwiec82 (big blind) folded before Flop
Seat 2: CnidTT folded before Flop (didn't bet)
Seat 3: Gibilan8584 showed [6h 6s] and lost with two pair, Eights and Sixes
Seat 4: Nordic2154 (button) folded before Flop (didn't bet)
Seat 6: magdal28 (small blind) showed [8s As] and won ($6.05) with three of a kind, Eights



PokerStars Hand #222963982218:  Hold'em No Limit ($0.05/$0.10 USD) - 2021/01/23 13:34:26 ET
Table 'Saito II' 6-max Seat #6 is the button
Seat 1: mysliwiec82 ($11.50 in chips) 
Seat 2: CnidTT ($10.46 in chips) 
Seat 4: Nordic2154 ($10.25 in chips) 
Seat 6: magdal28 ($24.31 in chips) 
mysliwiec82: posts small blind $0.05
CnidTT: posts big blind $0.10
pondax: sits out 
*** HOLE CARDS ***
Nordic2154: raises $0.15 to $0.25
magdal28: folds 
mysliwiec82: folds 
CnidTT: folds 
Uncalled bet ($0.15) returned to Nordic2154
Nordic2154 collected $0.25 from pot
Nordic2154: doesn't show hand 
*** SUMMARY ***
Total pot $0.25 | Rake $0 
Seat 1: mysliwiec82 (small blind) folded before Flop
Seat 2: CnidTT (big blind) folded before Flop
Seat 4: Nordic2154 collected ($0.25)
Seat 6: magdal28 (button) folded before Flop (didn't bet)



PokerStars Hand #222963991683:  Hold'em No Limit ($0.05/$0.10 USD) - 2021/01/23 13:34:38 ET
Table 'Saito II' 6-max Seat #1 is the button
Seat 1: mysliwiec82 ($11.45 in chips) 
Seat 2: CnidTT ($10.36 in chips) 
Seat 4: Nordic2154 ($10.40 in chips) 
Seat 6: magdal28 ($24.31 in chips) 
CnidTT: posts small blind $0.05
Nordic2154: posts big blind $0.10
Gibilan8584 leaves the table
pondax: sits out 
*** HOLE CARDS ***
magdal28: folds 
mysliwiec82: folds 
CnidTT: raises $0.20 to $0.30
Nordic2154: folds 
Uncalled bet ($0.20) returned to CnidTT
mysliwiec82 leaves the table
CnidTT collected $0.20 from pot
CnidTT: doesn't show hand 
*** SUMMARY ***
Total pot $0.20 | Rake $0 
Seat 1: mysliwiec82 (button) folded before Flop (didn't bet)
Seat 2: CnidTT (small blind) collected ($0.20)
Seat 4: Nordic2154 (big blind) folded before Flop
Seat 6: magdal28 folded before Flop (didn't bet)



PokerStars Hand #222964000823:  Hold'em No Limit ($0.05/$0.10 USD) - 2021/01/23 13:34:49 ET
Table 'Saito II' 6-max Seat #2 is the button
Seat 2: CnidTT ($10.46 in chips) 
Seat 4: Nordic2154 ($10.30 in chips) 
Seat 5: pondax ($10 in chips) 
Seat 6: magdal28 ($24.31 in chips) 
Nordic2154: posts small blind $0.05
pondax: posts big blind $0.10
*** HOLE CARDS ***
magdal28: raises $0.15 to $0.25
CnidTT: folds 
Nordic2154: folds 
pondax: folds 
Uncalled bet ($0.15) returned to magdal28
magdal28 collected $0.25 from pot
magdal28: doesn't show hand 
*** SUMMARY ***
Total pot $0.25 | Rake $0 
Seat 2: CnidTT (button) folded before Flop (didn't bet)
Seat 4: Nordic2154 (small blind) folded before Flop
Seat 5: pondax (big blind) folded before Flop
Seat 6: magdal28 collected ($0.25)



PokerStars Hand #222964007359:  Hold'em No Limit ($0.05/$0.10 USD) - 2021/01/23 13:34:58 ET
Table 'Saito II' 6-max Seat #5 is the button
Seat 4: Nordic2154 ($10.25 in chips) 
Seat 5: pondax ($9.90 in chips) 
pondax: posts small blind $0.05
magdal28: is sitting out 
magdal28 leaves the table
CnidTT: is sitting out 
CnidTT leaves the table
Nordic2154: posts big blind $0.10
*** HOLE CARDS ***
pondax: folds 
Uncalled bet ($0.05) returned to Nordic2154
Nordic2154 collected $0.10 from pot
Nordic2154: doesn't show hand 
*** SUMMARY ***
Total pot $0.10 | Rake $0 
Seat 4: Nordic2154 (big blind) collected ($0.10)
Seat 5: pondax (button) (small blind) folded before Flop



