PokerStars Hand #222964980639:  Hold'em No Limit ($0.05/$0.10 USD) - 2021/01/23 13:56:27 ET
Table 'Merope IV' 6-max Seat #2 is the button
Seat 1: uterkrm.ua ($10 in chips) 
Seat 2: chupendos001 ($4.10 in chips) 
Seat 6: xiled90 ($10 in chips) 
xiled90: posts small blind $0.05
uterkrm.ua: posts big blind $0.10
*** HOLE CARDS ***
chupendos001: raises $0.10 to $0.20
xiled90: folds 
uterkrm.ua: calls $0.10
*** FLOP *** [7h 2d Ks]
uterkrm.ua: checks 
chupendos001: bets $0.43
uterkrm.ua: folds 
Uncalled bet ($0.43) returned to chupendos001
chupendos001 collected $0.43 from pot
chupendos001: doesn't show hand 
*** SUMMARY ***
Total pot $0.45 | Rake $0.02 
Board [7h 2d Ks]
Seat 1: uterkrm.ua (big blind) folded on the Flop
Seat 2: chupendos001 (button) collected ($0.43)
Seat 6: xiled90 (small blind) folded before Flop



PokerStars Hand #222964991577:  Hold'em No Limit ($0.05/$0.10 USD) - 2021/01/23 13:56:49 ET
Table 'Merope IV' 6-max Seat #6 is the button
Seat 1: uterkrm.ua ($10 in chips) 
Seat 2: chupendos001 ($4.33 in chips) 
Seat 3: Zsavito ($7.93 in chips) 
Seat 6: xiled90 ($10 in chips) 
uterkrm.ua: posts small blind $0.05
chupendos001: posts big blind $0.10
Zsavito: posts big blind $0.10
Oleg032: sits out 
skakalec90: sits out 
*** HOLE CARDS ***
Zsavito: checks 
xiled90: folds 
uterkrm.ua: calls $0.05
chupendos001: raises $0.30 to $0.40
Zsavito: folds 
uterkrm.ua: folds 
Uncalled bet ($0.30) returned to chupendos001
chupendos001 collected $0.30 from pot
chupendos001: doesn't show hand 
*** SUMMARY ***
Total pot $0.30 | Rake $0 
Seat 1: uterkrm.ua (small blind) folded before Flop
Seat 2: chupendos001 (big blind) collected ($0.30)
Seat 3: Zsavito folded before Flop (didn't bet)
Seat 6: xiled90 (button) folded before Flop (didn't bet)



PokerStars Hand #222965001402:  Hold'em No Limit ($0.05/$0.10 USD) - 2021/01/23 13:57:10 ET
Table 'Merope IV' 6-max Seat #1 is the button
Seat 1: uterkrm.ua ($10 in chips) 
Seat 2: chupendos001 ($4.53 in chips) 
Seat 3: Zsavito ($7.83 in chips) 
Seat 6: xiled90 ($10 in chips) 
chupendos001: posts small blind $0.05
Zsavito: posts big blind $0.10
Oleg032: sits out 
skakalec90: sits out 
*** HOLE CARDS ***
xiled90: folds 
uterkrm.ua: raises $0.20 to $0.30
chupendos001: folds 
Zsavito: folds 
Uncalled bet ($0.20) returned to uterkrm.ua
uterkrm.ua collected $0.25 from pot
uterkrm.ua: doesn't show hand 
*** SUMMARY ***
Total pot $0.25 | Rake $0 
Seat 1: uterkrm.ua (button) collected ($0.25)
Seat 2: chupendos001 (small blind) folded before Flop
Seat 3: Zsavito (big blind) folded before Flop
Seat 6: xiled90 folded before Flop (didn't bet)



PokerStars Hand #222965007243:  Hold'em No Limit ($0.05/$0.10 USD) - 2021/01/23 13:57:22 ET
Table 'Merope IV' 6-max Seat #2 is the button
Seat 1: uterkrm.ua ($10.15 in chips) 
Seat 2: chupendos001 ($4.48 in chips) 
Seat 3: Zsavito ($7.73 in chips) 
Seat 4: Oleg032 ($10 in chips) 
Seat 6: xiled90 ($10 in chips) 
Zsavito: posts small blind $0.05
Oleg032: posts big blind $0.10
skakalec90: sits out 
*** HOLE CARDS ***
xiled90: folds 
uterkrm.ua: folds 
chupendos001: raises $0.10 to $0.20
Zsavito: calls $0.15
Oleg032: folds 
*** FLOP *** [3d Jc 2h]
Zsavito: checks 
chupendos001: bets $0.20
Zsavito: calls $0.20
*** TURN *** [3d Jc 2h] [5s]
Zsavito: checks 
chupendos001: bets $0.86
Zsavito: calls $0.86
*** RIVER *** [3d Jc 2h 5s] [4d]
Zsavito: checks 
chupendos001: bets $1.30
Zsavito: folds 
Uncalled bet ($1.30) returned to chupendos001
chupendos001 collected $2.50 from pot
chupendos001: doesn't show hand 
*** SUMMARY ***
Total pot $2.62 | Rake $0.12 
Board [3d Jc 2h 5s 4d]
Seat 1: uterkrm.ua folded before Flop (didn't bet)
Seat 2: chupendos001 (button) collected ($2.50)
Seat 3: Zsavito (small blind) folded on the River
Seat 4: Oleg032 (big blind) folded before Flop
Seat 6: xiled90 folded before Flop (didn't bet)



PokerStars Hand #222965044583:  Hold'em No Limit ($0.05/$0.10 USD) - 2021/01/23 13:58:38 ET
Table 'Merope IV' 6-max Seat #3 is the button
Seat 1: uterkrm.ua ($10.15 in chips) 
Seat 2: chupendos001 ($5.72 in chips) 
Seat 3: Zsavito ($6.47 in chips) 
Seat 4: Oleg032 ($10 in chips) 
Seat 5: skakalec90 ($10 in chips) 
Seat 6: xiled90 ($10 in chips) 
Oleg032: posts small blind $0.05
skakalec90: posts big blind $0.10
*** HOLE CARDS ***
xiled90: folds 
uterkrm.ua: folds 
chupendos001: folds 
Zsavito: raises $0.10 to $0.20
Oleg032: folds 
skakalec90: folds 
Uncalled bet ($0.10) returned to Zsavito
Zsavito collected $0.25 from pot
Zsavito: doesn't show hand 
*** SUMMARY ***
Total pot $0.25 | Rake $0 
Seat 1: uterkrm.ua folded before Flop (didn't bet)
Seat 2: chupendos001 folded before Flop (didn't bet)
Seat 3: Zsavito (button) collected ($0.25)
Seat 4: Oleg032 (small blind) folded before Flop
Seat 5: skakalec90 (big blind) folded before Flop
Seat 6: xiled90 folded before Flop (didn't bet)



PokerStars Hand #222965050779:  Hold'em No Limit ($0.05/$0.10 USD) - 2021/01/23 13:58:50 ET
Table 'Merope IV' 6-max Seat #4 is the button
Seat 1: uterkrm.ua ($10.15 in chips) 
Seat 2: chupendos001 ($5.72 in chips) 
Seat 3: Zsavito ($6.62 in chips) 
Seat 4: Oleg032 ($10 in chips) 
Seat 5: skakalec90 ($10 in chips) 
Seat 6: xiled90 ($10 in chips) 
skakalec90: posts small blind $0.05
xiled90: posts big blind $0.10
*** HOLE CARDS ***
uterkrm.ua: folds 
chupendos001: raises $0.10 to $0.20
Zsavito: calls $0.20
Oleg032: folds 
skakalec90: folds 
xiled90: folds 
*** FLOP *** [Kd Ac 4d]
chupendos001: checks 
Zsavito: bets $0.26
chupendos001: calls $0.26
*** TURN *** [Kd Ac 4d] [9d]
chupendos001: checks 
Zsavito: checks 
*** RIVER *** [Kd Ac 4d 9d] [3h]
chupendos001: checks 
Zsavito: bets $1.12
chupendos001: calls $1.12
*** SHOW DOWN ***
Zsavito: shows [Jd 8d] (a flush, King high)
chupendos001: mucks hand 
Zsavito collected $3.16 from pot
*** SUMMARY ***
Total pot $3.31 | Rake $0.15 
Board [Kd Ac 4d 9d 3h]
Seat 1: uterkrm.ua folded before Flop (didn't bet)
Seat 2: chupendos001 mucked
Seat 3: Zsavito showed [Jd 8d] and won ($3.16) with a flush, King high
Seat 4: Oleg032 (button) folded before Flop (didn't bet)
Seat 5: skakalec90 (small blind) folded before Flop
Seat 6: xiled90 (big blind) folded before Flop



PokerStars Hand #222965073066:  Hold'em No Limit ($0.05/$0.10 USD) - 2021/01/23 13:59:36 ET
Table 'Merope IV' 6-max Seat #5 is the button
Seat 1: uterkrm.ua ($10.15 in chips) 
Seat 2: chupendos001 ($4.14 in chips) 
Seat 3: Zsavito ($8.20 in chips) 
Seat 4: Oleg032 ($10 in chips) 
Seat 5: skakalec90 ($10 in chips) 
Seat 6: xiled90 ($10 in chips) 
xiled90: posts small blind $0.05
uterkrm.ua: posts big blind $0.10
*** HOLE CARDS ***
chupendos001: calls $0.10
Zsavito: folds 
Oleg032: raises $0.15 to $0.25
skakalec90: folds 
xiled90: folds 
uterkrm.ua: calls $0.15
chupendos001: raises $0.55 to $0.80
Oleg032: calls $0.55
uterkrm.ua: folds 
*** FLOP *** [7c Jh 2s]
chupendos001: bets $0.91
Oleg032: folds 
Uncalled bet ($0.91) returned to chupendos001
chupendos001 collected $1.81 from pot
chupendos001: doesn't show hand 
*** SUMMARY ***
Total pot $1.90 | Rake $0.09 
Board [7c Jh 2s]
Seat 1: uterkrm.ua (big blind) folded before Flop
Seat 2: chupendos001 collected ($1.81)
Seat 3: Zsavito folded before Flop (didn't bet)
Seat 4: Oleg032 folded on the Flop
Seat 5: skakalec90 (button) folded before Flop (didn't bet)
Seat 6: xiled90 (small blind) folded before Flop



PokerStars Hand #222965091699:  Hold'em No Limit ($0.05/$0.10 USD) - 2021/01/23 14:00:12 ET
Table 'Merope IV' 6-max Seat #6 is the button
Seat 1: uterkrm.ua ($10 in chips) 
Seat 2: chupendos001 ($5.15 in chips) 
Seat 3: Zsavito ($8.20 in chips) 
Seat 4: Oleg032 ($10 in chips) 
Seat 5: skakalec90 ($10 in chips) 
Seat 6: xiled90 ($10 in chips) 
uterkrm.ua: posts small blind $0.05
chupendos001: posts big blind $0.10
*** HOLE CARDS ***
Zsavito: folds 
Oleg032: folds 
skakalec90: raises $0.20 to $0.30
xiled90: calls $0.30
uterkrm.ua: folds 
chupendos001: raises $0.50 to $0.80
skakalec90: raises $1.70 to $2.50
xiled90: folds 
chupendos001: calls $1.70
*** FLOP *** [Th Qd 6c]
chupendos001: checks 
skakalec90: checks 
*** TURN *** [Th Qd 6c] [Ks]
chupendos001: bets $0.10
skakalec90: calls $0.10
*** RIVER *** [Th Qd 6c Ks] [5s]
chupendos001: bets $0.10
skakalec90: raises $1.40 to $1.50
chupendos001: folds 
Uncalled bet ($1.40) returned to skakalec90
skakalec90 collected $5.49 from pot
skakalec90: doesn't show hand 
*** SUMMARY ***
Total pot $5.75 | Rake $0.26 
Board [Th Qd 6c Ks 5s]
Seat 1: uterkrm.ua (small blind) folded before Flop
Seat 2: chupendos001 (big blind) folded on the River
Seat 3: Zsavito folded before Flop (didn't bet)
Seat 4: Oleg032 folded before Flop (didn't bet)
Seat 5: skakalec90 collected ($5.49)
Seat 6: xiled90 (button) folded before Flop



PokerStars Hand #222965121046:  Hold'em No Limit ($0.05/$0.10 USD) - 2021/01/23 14:01:05 ET
Table 'Merope IV' 6-max Seat #1 is the button
Seat 1: uterkrm.ua ($10 in chips) 
Seat 2: chupendos001 ($2.45 in chips) 
Seat 3: Zsavito ($8.20 in chips) 
Seat 4: Oleg032 ($10 in chips) 
Seat 5: skakalec90 ($12.79 in chips) 
Seat 6: xiled90 ($10 in chips) 
chupendos001: posts small blind $0.05
Zsavito: posts big blind $0.10
*** HOLE CARDS ***
Oleg032: folds 
skakalec90: folds 
xiled90: raises $0.20 to $0.30
uterkrm.ua: folds 
chupendos001: raises $2.15 to $2.45 and is all-in
Zsavito: folds 
xiled90: folds 
Uncalled bet ($2.15) returned to chupendos001
chupendos001 collected $0.70 from pot
chupendos001: doesn't show hand 
*** SUMMARY ***
Total pot $0.70 | Rake $0 
Seat 1: uterkrm.ua (button) folded before Flop (didn't bet)
Seat 2: chupendos001 (small blind) collected ($0.70)
Seat 3: Zsavito (big blind) folded before Flop
Seat 4: Oleg032 folded before Flop (didn't bet)
Seat 5: skakalec90 folded before Flop (didn't bet)
Seat 6: xiled90 folded before Flop



PokerStars Hand #222965136589:  Hold'em No Limit ($0.05/$0.10 USD) - 2021/01/23 14:01:28 ET
Table 'Merope IV' 6-max Seat #2 is the button
Seat 1: uterkrm.ua ($10 in chips) 
Seat 2: chupendos001 ($2.85 in chips) 
Seat 3: Zsavito ($8.10 in chips) 
Seat 4: Oleg032 ($10 in chips) 
Seat 5: skakalec90 ($12.79 in chips) 
Seat 6: xiled90 ($10 in chips) 
Zsavito: posts small blind $0.05
Oleg032: posts big blind $0.10
*** HOLE CARDS ***
skakalec90: folds 
xiled90: folds 
uterkrm.ua: raises $0.20 to $0.30
chupendos001: calls $0.30
Zsavito: calls $0.25
Oleg032: calls $0.20
*** FLOP *** [2h 9d Js]
Zsavito: checks 
Oleg032: checks 
uterkrm.ua: checks 
chupendos001: checks 
*** TURN *** [2h 9d Js] [Kc]
Zsavito: checks 
Oleg032: checks 
uterkrm.ua: checks 
chupendos001: bets $0.30
Zsavito: raises $0.70 to $1
Oleg032: folds 
uterkrm.ua: folds 
chupendos001: calls $0.70
*** RIVER *** [2h 9d Js Kc] [Qd]
Zsavito: checks 
chupendos001: bets $1.55 and is all-in
Zsavito: calls $1.55
*** SHOW DOWN ***
chupendos001: shows [Kh 8c] (a pair of Kings)
Zsavito: shows [Jh Kd] (two pair, Kings and Jacks)
Zsavito collected $6.02 from pot
*** SUMMARY ***
Total pot $6.30 | Rake $0.28 
Board [2h 9d Js Kc Qd]
Seat 1: uterkrm.ua folded on the Turn
Seat 2: chupendos001 (button) showed [Kh 8c] and lost with a pair of Kings
Seat 3: Zsavito (small blind) showed [Jh Kd] and won ($6.02) with two pair, Kings and Jacks
Seat 4: Oleg032 (big blind) folded on the Turn
Seat 5: skakalec90 folded before Flop (didn't bet)
Seat 6: xiled90 folded before Flop (didn't bet)



PokerStars Hand #222965218931:  Hold'em No Limit ($0.05/$0.10 USD) - 2021/01/23 14:03:09 ET
Table 'Merope IV' 6-max Seat #3 is the button
Seat 1: uterkrm.ua ($10 in chips) 
Seat 3: Zsavito ($11.27 in chips) 
Seat 4: Oleg032 ($10 in chips) 
Seat 5: skakalec90 ($12.79 in chips) 
Seat 6: xiled90 ($10 in chips) 
Oleg032: posts small blind $0.05
skakalec90: posts big blind $0.10
*** HOLE CARDS ***
xiled90: folds 
uterkrm.ua: folds 
chupendos001 leaves the table
Zsavito: calls $0.10
Oleg032: folds 
skakalec90: checks 
*** FLOP *** [Jd 6c Qh]
skakalec90: checks 
Zsavito: checks 
*** TURN *** [Jd 6c Qh] [Ad]
skakalec90: checks 
Zsavito: checks 
*** RIVER *** [Jd 6c Qh Ad] [Jc]
skakalec90: checks 
Zsavito: checks 
*** SHOW DOWN ***
skakalec90: shows [4h 9s] (a pair of Jacks)
Zsavito: shows [Kh 5d] (a pair of Jacks - Ace+King kicker)
Zsavito collected $0.24 from pot
*** SUMMARY ***
Total pot $0.25 | Rake $0.01 
Board [Jd 6c Qh Ad Jc]
Seat 1: uterkrm.ua folded before Flop (didn't bet)
Seat 3: Zsavito (button) showed [Kh 5d] and won ($0.24) with a pair of Jacks
Seat 4: Oleg032 (small blind) folded before Flop
Seat 5: skakalec90 (big blind) showed [4h 9s] and lost with a pair of Jacks
Seat 6: xiled90 folded before Flop (didn't bet)



PokerStars Hand #222965240495:  Hold'em No Limit ($0.05/$0.10 USD) - 2021/01/23 14:03:37 ET
Table 'Merope IV' 6-max Seat #4 is the button
Seat 1: uterkrm.ua ($10 in chips) 
Seat 3: Zsavito ($11.41 in chips) 
Seat 4: Oleg032 ($10 in chips) 
Seat 5: skakalec90 ($12.69 in chips) 
Seat 6: xiled90 ($10 in chips) 
skakalec90: posts small blind $0.05
xiled90: posts big blind $0.10
*** HOLE CARDS ***
LonSGtn joins the table at seat #2 
uterkrm.ua: folds 
Zsavito: folds 
Oleg032: raises $0.15 to $0.25
skakalec90: folds 
xiled90: calls $0.15
*** FLOP *** [Tc Qd Ac]
xiled90: checks 
Oleg032: bets $0.40
xiled90: calls $0.40
*** TURN *** [Tc Qd Ac] [8d]
xiled90: checks 
Oleg032: bets $0.97
xiled90: folds 
Uncalled bet ($0.97) returned to Oleg032
Oleg032 collected $1.29 from pot
Oleg032: doesn't show hand 
*** SUMMARY ***
Total pot $1.35 | Rake $0.06 
Board [Tc Qd Ac 8d]
Seat 1: uterkrm.ua folded before Flop (didn't bet)
Seat 3: Zsavito folded before Flop (didn't bet)
Seat 4: Oleg032 (button) collected ($1.29)
Seat 5: skakalec90 (small blind) folded before Flop
Seat 6: xiled90 (big blind) folded on the Turn



PokerStars Hand #222965274517:  Hold'em No Limit ($0.05/$0.10 USD) - 2021/01/23 14:04:20 ET
Table 'Merope IV' 6-max Seat #5 is the button
Seat 2: LonSGtn ($4 in chips) 
Seat 3: Zsavito ($11.41 in chips) 
Seat 4: Oleg032 ($10.64 in chips) 
Seat 5: skakalec90 ($12.64 in chips) 
Seat 6: xiled90 ($10 in chips) 
xiled90: posts small blind $0.05
uterkrm.ua: is sitting out 
LonSGtn: posts big blind $0.10
*** HOLE CARDS ***
Zsavito: folds 
Oleg032: folds 
skakalec90: folds 
xiled90: raises $0.20 to $0.30
LonSGtn: calls $0.20
*** FLOP *** [4h 8h 9d]
xiled90: bets $0.50
LonSGtn: folds 
Uncalled bet ($0.50) returned to xiled90
xiled90 collected $0.57 from pot
xiled90: doesn't show hand 
*** SUMMARY ***
Total pot $0.60 | Rake $0.03 
Board [4h 8h 9d]
Seat 2: LonSGtn (big blind) folded on the Flop
Seat 3: Zsavito folded before Flop (didn't bet)
Seat 4: Oleg032 folded before Flop (didn't bet)
Seat 5: skakalec90 (button) folded before Flop (didn't bet)
Seat 6: xiled90 (small blind) collected ($0.57)



PokerStars Hand #222965295683:  Hold'em No Limit ($0.05/$0.10 USD) - 2021/01/23 14:04:47 ET
Table 'Merope IV' 6-max Seat #6 is the button
Seat 2: LonSGtn ($3.70 in chips) 
Seat 3: Zsavito ($11.41 in chips) 
Seat 4: Oleg032 ($10.64 in chips) 
Seat 5: skakalec90 ($12.64 in chips) 
Seat 6: xiled90 ($10.27 in chips) 
LonSGtn: posts small blind $0.05
Zsavito: posts big blind $0.10
*** HOLE CARDS ***
Oleg032: folds 
skakalec90: folds 
xiled90: raises $0.15 to $0.25
LonSGtn: folds 
Zsavito: calls $0.15
*** FLOP *** [9s 6c 3c]
Zsavito: checks 
xiled90: checks 
*** TURN *** [9s 6c 3c] [Kd]
Zsavito: checks 
xiled90: bets $0.37
Zsavito: raises $0.67 to $1.04
xiled90: folds 
Uncalled bet ($0.67) returned to Zsavito
Zsavito collected $1.23 from pot
Zsavito: doesn't show hand 
*** SUMMARY ***
Total pot $1.29 | Rake $0.06 
Board [9s 6c 3c Kd]
Seat 2: LonSGtn (small blind) folded before Flop
Seat 3: Zsavito (big blind) collected ($1.23)
Seat 4: Oleg032 folded before Flop (didn't bet)
Seat 5: skakalec90 folded before Flop (didn't bet)
Seat 6: xiled90 (button) folded on the Turn



PokerStars Hand #222965336465:  Hold'em No Limit ($0.05/$0.10 USD) - 2021/01/23 14:05:38 ET
Table 'Merope IV' 6-max Seat #2 is the button
Seat 2: LonSGtn ($3.65 in chips) 
Seat 3: Zsavito ($12.02 in chips) 
Seat 4: Oleg032 ($10.64 in chips) 
Seat 5: skakalec90 ($12.64 in chips) 
Seat 6: xiled90 ($10 in chips) 
Zsavito: posts small blind $0.05
Oleg032: posts big blind $0.10
*** HOLE CARDS ***
skakalec90: folds 
xiled90: folds 
LonSGtn: calls $0.10
Zsavito: calls $0.05
Oleg032: checks 
*** FLOP *** [5c 2c 8h]
Zsavito: checks 
Oleg032: checks 
LonSGtn: checks 
*** TURN *** [5c 2c 8h] [4d]
Zsavito: checks 
Oleg032: checks 
LonSGtn: checks 
*** RIVER *** [5c 2c 8h 4d] [3h]
Zsavito: checks 
Oleg032: bets $0.38
LonSGtn: raises $0.38 to $0.76
Zsavito: folds 
Oleg032: raises $4.08 to $4.84
LonSGtn: calls $2.79 and is all-in
Uncalled bet ($1.29) returned to Oleg032
*** SHOW DOWN ***
Oleg032: shows [Js 6s] (a straight, Deuce to Six)
LonSGtn: shows [As 6d] (a straight, Deuce to Six)
Oleg032 collected $3.54 from pot
LonSGtn collected $3.53 from pot
*** SUMMARY ***
Total pot $7.40 | Rake $0.33 
Board [5c 2c 8h 4d 3h]
Seat 2: LonSGtn (button) showed [As 6d] and won ($3.53) with a straight, Deuce to Six
Seat 3: Zsavito (small blind) folded on the River
Seat 4: Oleg032 (big blind) showed [Js 6s] and won ($3.54) with a straight, Deuce to Six
Seat 5: skakalec90 folded before Flop (didn't bet)
Seat 6: xiled90 folded before Flop (didn't bet)



PokerStars Hand #222965407088:  Hold'em No Limit ($0.05/$0.10 USD) - 2021/01/23 14:07:07 ET
Table 'Merope IV' 6-max Seat #3 is the button
Seat 2: LonSGtn ($3.53 in chips) 
Seat 3: Zsavito ($11.92 in chips) 
Seat 4: Oleg032 ($10.53 in chips) 
Seat 5: skakalec90 ($12.64 in chips) 
Seat 6: xiled90 ($10 in chips) 
Oleg032: posts small blind $0.05
skakalec90: posts big blind $0.10
*** HOLE CARDS ***
xiled90: folds 
LonSGtn: folds 
Zsavito: folds 
Oleg032: raises $0.20 to $0.30
skakalec90: folds 
Uncalled bet ($0.20) returned to Oleg032
Oleg032 collected $0.20 from pot
Oleg032: doesn't show hand 
*** SUMMARY ***
Total pot $0.20 | Rake $0 
Seat 2: LonSGtn folded before Flop (didn't bet)
Seat 3: Zsavito (button) folded before Flop (didn't bet)
Seat 4: Oleg032 (small blind) collected ($0.20)
Seat 5: skakalec90 (big blind) folded before Flop
Seat 6: xiled90 folded before Flop (didn't bet)



PokerStars Hand #222965416234:  Hold'em No Limit ($0.05/$0.10 USD) - 2021/01/23 14:07:19 ET
Table 'Merope IV' 6-max Seat #4 is the button
Seat 2: LonSGtn ($3.53 in chips) 
Seat 3: Zsavito ($11.92 in chips) 
Seat 4: Oleg032 ($10.63 in chips) 
Seat 5: skakalec90 ($12.54 in chips) 
Seat 6: xiled90 ($10 in chips) 
skakalec90: posts small blind $0.05
xiled90: posts big blind $0.10
*** HOLE CARDS ***
LonSGtn: folds 
Zsavito: folds 
Oleg032: raises $0.15 to $0.25
skakalec90: folds 
xiled90: folds 
Uncalled bet ($0.15) returned to Oleg032
Oleg032 collected $0.25 from pot
Oleg032: doesn't show hand 
*** SUMMARY ***
Total pot $0.25 | Rake $0 
Seat 2: LonSGtn folded before Flop (didn't bet)
Seat 3: Zsavito folded before Flop (didn't bet)
Seat 4: Oleg032 (button) collected ($0.25)
Seat 5: skakalec90 (small blind) folded before Flop
Seat 6: xiled90 (big blind) folded before Flop



PokerStars Hand #222965423724:  Hold'em No Limit ($0.05/$0.10 USD) - 2021/01/23 14:07:28 ET
Table 'Merope IV' 6-max Seat #5 is the button
Seat 2: LonSGtn ($3.53 in chips) 
Seat 3: Zsavito ($11.92 in chips) 
Seat 4: Oleg032 ($10.78 in chips) 
Seat 5: skakalec90 ($12.49 in chips) 
Seat 6: xiled90 ($10 in chips) 
xiled90: posts small blind $0.05
LonSGtn: posts big blind $0.10
*** HOLE CARDS ***
Zsavito: raises $0.10 to $0.20
Oleg032: folds 
skakalec90: folds 
xiled90: folds 
LonSGtn: folds 
Uncalled bet ($0.10) returned to Zsavito
Zsavito collected $0.25 from pot
Zsavito: doesn't show hand 
*** SUMMARY ***
Total pot $0.25 | Rake $0 
Seat 2: LonSGtn (big blind) folded before Flop
Seat 3: Zsavito collected ($0.25)
Seat 4: Oleg032 folded before Flop (didn't bet)
Seat 5: skakalec90 (button) folded before Flop (didn't bet)
Seat 6: xiled90 (small blind) folded before Flop



PokerStars Hand #222965432760:  Hold'em No Limit ($0.05/$0.10 USD) - 2021/01/23 14:07:40 ET
Table 'Merope IV' 6-max Seat #6 is the button
Seat 2: LonSGtn ($3.43 in chips) 
Seat 3: Zsavito ($12.07 in chips) 
Seat 4: Oleg032 ($10.78 in chips) 
Seat 5: skakalec90 ($12.49 in chips) 
Seat 6: xiled90 ($10 in chips) 
LonSGtn: posts small blind $0.05
Zsavito: posts big blind $0.10
*** HOLE CARDS ***
Oleg032: folds 
uterkrm.ua leaves the table
skakalec90: folds 
xiled90: folds 
LonSGtn: calls $0.05
Zsavito: checks 
*** FLOP *** [2d 5d Ac]
LonSGtn: bets $0.10
Zsavito: calls $0.10
*** TURN *** [2d 5d Ac] [9h]
LonSGtn: bets $0.19
Zsavito: calls $0.19
*** RIVER *** [2d 5d Ac 9h] [Qd]
LonSGtn: bets $0.77
Zsavito: folds 
Uncalled bet ($0.77) returned to LonSGtn
LonSGtn collected $0.74 from pot
LonSGtn: doesn't show hand 
*** SUMMARY ***
Total pot $0.78 | Rake $0.04 
Board [2d 5d Ac 9h Qd]
Seat 2: LonSGtn (small blind) collected ($0.74)
Seat 3: Zsavito (big blind) folded on the River
Seat 4: Oleg032 folded before Flop (didn't bet)
Seat 5: skakalec90 folded before Flop (didn't bet)
Seat 6: xiled90 (button) folded before Flop (didn't bet)



PokerStars Hand #222965466930:  Hold'em No Limit ($0.05/$0.10 USD) - 2021/01/23 14:08:23 ET
Table 'Merope IV' 6-max Seat #2 is the button
Seat 2: LonSGtn ($3.78 in chips) 
Seat 3: Zsavito ($11.68 in chips) 
Seat 4: Oleg032 ($10.78 in chips) 
Seat 5: skakalec90 ($12.49 in chips) 
Seat 6: xiled90 ($10 in chips) 
Zsavito: posts small blind $0.05
Oleg032: posts big blind $0.10
*** HOLE CARDS ***
skakalec90: folds 
xiled90: raises $0.20 to $0.30
LonSGtn: folds 
ueltavares joins the table at seat #1 
Zsavito: folds 
Oleg032: folds 
Uncalled bet ($0.20) returned to xiled90
xiled90 collected $0.25 from pot
xiled90: doesn't show hand 
*** SUMMARY ***
Total pot $0.25 | Rake $0 
Seat 2: LonSGtn (button) folded before Flop (didn't bet)
Seat 3: Zsavito (small blind) folded before Flop
Seat 4: Oleg032 (big blind) folded before Flop
Seat 5: skakalec90 folded before Flop (didn't bet)
Seat 6: xiled90 collected ($0.25)



PokerStars Hand #222965482784:  Hold'em No Limit ($0.05/$0.10 USD) - 2021/01/23 14:08:42 ET
Table 'Merope IV' 6-max Seat #3 is the button
Seat 2: LonSGtn ($3.78 in chips) 
Seat 3: Zsavito ($11.63 in chips) 
Seat 4: Oleg032 ($10.68 in chips) 
Seat 5: skakalec90 ($12.49 in chips) 
Seat 6: xiled90 ($10.15 in chips) 
Oleg032: posts small blind $0.05
skakalec90: posts big blind $0.10
ueltavares: sits out 
*** HOLE CARDS ***
xiled90: folds 
LonSGtn: folds 
Zsavito: raises $0.20 to $0.30
Oleg032: folds 
skakalec90: calls $0.20
*** FLOP *** [7h Ac 2h]
skakalec90: checks 
Zsavito: checks 
*** TURN *** [7h Ac 2h] [3c]
skakalec90: bets $0.30
Zsavito: raises $0.60 to $0.90
skakalec90: calls $0.60
*** RIVER *** [7h Ac 2h 3c] [5d]
skakalec90: checks 
Zsavito: checks 
*** SHOW DOWN ***
skakalec90: shows [Tc 8c] (high card Ace)
Zsavito: shows [9c As] (a pair of Aces)
Zsavito collected $2.34 from pot
*** SUMMARY ***
Total pot $2.45 | Rake $0.11 
Board [7h Ac 2h 3c 5d]
Seat 2: LonSGtn folded before Flop (didn't bet)
Seat 3: Zsavito (button) showed [9c As] and won ($2.34) with a pair of Aces
Seat 4: Oleg032 (small blind) folded before Flop
Seat 5: skakalec90 (big blind) showed [Tc 8c] and lost with high card Ace
Seat 6: xiled90 folded before Flop (didn't bet)



PokerStars Hand #222965515435:  Hold'em No Limit ($0.05/$0.10 USD) - 2021/01/23 14:09:23 ET
Table 'Merope IV' 6-max Seat #4 is the button
Seat 1: ueltavares ($7 in chips) 
Seat 2: LonSGtn ($3.78 in chips) 
Seat 3: Zsavito ($12.77 in chips) 
Seat 4: Oleg032 ($10.63 in chips) 
Seat 5: skakalec90 ($11.29 in chips) 
Seat 6: xiled90 ($10.15 in chips) 
skakalec90: posts small blind $0.05
xiled90: posts big blind $0.10
ueltavares: posts big blind $0.10
*** HOLE CARDS ***
ueltavares: checks 
LonSGtn: raises $0.10 to $0.20
Zsavito: calls $0.20
Oleg032: folds 
skakalec90: folds 
xiled90: calls $0.10
ueltavares: calls $0.10
*** FLOP *** [4h 5d 9h]
xiled90: checks 
ueltavares: bets $0.81
LonSGtn: folds 
Zsavito: folds 
xiled90: folds 
Uncalled bet ($0.81) returned to ueltavares
ueltavares collected $0.81 from pot
ueltavares: doesn't show hand 
*** SUMMARY ***
Total pot $0.85 | Rake $0.04 
Board [4h 5d 9h]
Seat 1: ueltavares collected ($0.81)
Seat 2: LonSGtn folded on the Flop
Seat 3: Zsavito folded on the Flop
Seat 4: Oleg032 (button) folded before Flop (didn't bet)
Seat 5: skakalec90 (small blind) folded before Flop
Seat 6: xiled90 (big blind) folded on the Flop



PokerStars Hand #222965537614:  Hold'em No Limit ($0.05/$0.10 USD) - 2021/01/23 14:09:52 ET
Table 'Merope IV' 6-max Seat #5 is the button
Seat 1: ueltavares ($7.61 in chips) 
Seat 2: LonSGtn ($3.58 in chips) 
Seat 3: Zsavito ($12.57 in chips) 
Seat 4: Oleg032 ($10.63 in chips) 
Seat 5: skakalec90 ($11.24 in chips) 
Seat 6: xiled90 ($10 in chips) 
xiled90: posts small blind $0.05
ueltavares: posts big blind $0.10
*** HOLE CARDS ***
LonSGtn: folds 
Zsavito: raises $0.10 to $0.20
Oleg032: folds 
skakalec90: folds 
xiled90: folds 
ueltavares: calls $0.10
*** FLOP *** [Ts 5d 9s]
ueltavares: checks 
Zsavito: bets $0.20
ueltavares: calls $0.20
*** TURN *** [Ts 5d 9s] [Tc]
ueltavares: checks 
Zsavito: checks 
*** RIVER *** [Ts 5d 9s Tc] [Qs]
ueltavares: bets $0.81
Zsavito: calls $0.81
*** SHOW DOWN ***
ueltavares: shows [3s 8c] (a pair of Tens)
Zsavito: shows [9d Kd] (two pair, Tens and Nines)
Zsavito collected $2.36 from pot
*** SUMMARY ***
Total pot $2.47 | Rake $0.11 
Board [Ts 5d 9s Tc Qs]
Seat 1: ueltavares (big blind) showed [3s 8c] and lost with a pair of Tens
Seat 2: LonSGtn folded before Flop (didn't bet)
Seat 3: Zsavito showed [9d Kd] and won ($2.36) with two pair, Tens and Nines
Seat 4: Oleg032 folded before Flop (didn't bet)
Seat 5: skakalec90 (button) folded before Flop (didn't bet)
Seat 6: xiled90 (small blind) folded before Flop



PokerStars Hand #222965579291:  Hold'em No Limit ($0.05/$0.10 USD) - 2021/01/23 14:10:45 ET
Table 'Merope IV' 6-max Seat #6 is the button
Seat 2: LonSGtn ($3.58 in chips) 
Seat 3: Zsavito ($13.72 in chips) 
Seat 4: Oleg032 ($10.63 in chips) 
Seat 5: skakalec90 ($11.24 in chips) 
Seat 6: xiled90 ($10 in chips) 
LonSGtn: posts small blind $0.05
Zsavito: posts big blind $0.10
*** HOLE CARDS ***
Oleg032: folds 
ueltavares leaves the table
skakalec90: folds 
xiled90: folds 
LonSGtn: raises $0.10 to $0.20
Zsavito: calls $0.10
*** FLOP *** [5s Qs 3s]
LonSGtn: bets $0.19
burrocsorte joins the table at seat #1 
Zsavito: calls $0.19
*** TURN *** [5s Qs 3s] [Ad]
LonSGtn: bets $0.37
Zsavito: calls $0.37
*** RIVER *** [5s Qs 3s Ad] [2s]
LonSGtn: bets $1.45
Zsavito: folds 
Uncalled bet ($1.45) returned to LonSGtn
LonSGtn collected $1.45 from pot
LonSGtn: doesn't show hand 
*** SUMMARY ***
Total pot $1.52 | Rake $0.07 
Board [5s Qs 3s Ad 2s]
Seat 2: LonSGtn (small blind) collected ($1.45)
Seat 3: Zsavito (big blind) folded on the River
Seat 4: Oleg032 folded before Flop (didn't bet)
Seat 5: skakalec90 folded before Flop (didn't bet)
Seat 6: xiled90 (button) folded before Flop (didn't bet)



PokerStars Hand #222965609911:  Hold'em No Limit ($0.05/$0.10 USD) - 2021/01/23 14:11:24 ET
Table 'Merope IV' 6-max Seat #2 is the button
Seat 1: burrocsorte ($10 in chips) 
Seat 2: LonSGtn ($4.27 in chips) 
Seat 3: Zsavito ($12.96 in chips) 
Seat 4: Oleg032 ($10.63 in chips) 
Seat 5: skakalec90 ($11.24 in chips) 
Seat 6: xiled90 ($10 in chips) 
Zsavito: posts small blind $0.05
Oleg032: posts big blind $0.10
burrocsorte: posts big blind $0.10
*** HOLE CARDS ***
skakalec90: raises $0.20 to $0.30
xiled90: folds 
burrocsorte: raises $0.20 to $0.50
LonSGtn: folds 
Zsavito: folds 
Oleg032: folds 
skakalec90: calls $0.20
*** FLOP *** [9s 4c Qh]
skakalec90: checks 
burrocsorte: bets $0.55
skakalec90: folds 
Uncalled bet ($0.55) returned to burrocsorte
burrocsorte collected $1.10 from pot
burrocsorte: doesn't show hand 
*** SUMMARY ***
Total pot $1.15 | Rake $0.05 
Board [9s 4c Qh]
Seat 1: burrocsorte collected ($1.10)
Seat 2: LonSGtn (button) folded before Flop (didn't bet)
Seat 3: Zsavito (small blind) folded before Flop
Seat 4: Oleg032 (big blind) folded before Flop
Seat 5: skakalec90 folded on the Flop
Seat 6: xiled90 folded before Flop (didn't bet)



PokerStars Hand #222965632439:  Hold'em No Limit ($0.05/$0.10 USD) - 2021/01/23 14:11:52 ET
Table 'Merope IV' 6-max Seat #3 is the button
Seat 1: burrocsorte ($10.60 in chips) 
Seat 2: LonSGtn ($4.27 in chips) 
Seat 3: Zsavito ($12.91 in chips) 
Seat 4: Oleg032 ($10.53 in chips) 
Seat 5: skakalec90 ($10.74 in chips) 
Seat 6: xiled90 ($10 in chips) 
Oleg032: posts small blind $0.05
skakalec90: posts big blind $0.10
*** HOLE CARDS ***
xiled90: folds 
burrocsorte: folds 
LonSGtn: folds 
Zsavito: raises $0.20 to $0.30
Oleg032: folds 
skakalec90: folds 
Uncalled bet ($0.20) returned to Zsavito
Zsavito collected $0.25 from pot
Zsavito: doesn't show hand 
*** SUMMARY ***
Total pot $0.25 | Rake $0 
Seat 1: burrocsorte folded before Flop (didn't bet)
Seat 2: LonSGtn folded before Flop (didn't bet)
Seat 3: Zsavito (button) collected ($0.25)
Seat 4: Oleg032 (small blind) folded before Flop
Seat 5: skakalec90 (big blind) folded before Flop
Seat 6: xiled90 folded before Flop (didn't bet)



PokerStars Hand #222966272857:  Hold'em No Limit ($0.05/$0.10 USD) - 2021/01/23 14:25:18 ET
Table 'Merope IV' 6-max Seat #4 is the button
Seat 1: burrocsorte ($11.12 in chips) 
Seat 2: LonSGtn ($5.44 in chips) 
Seat 3: 0nix770 ($10.15 in chips) 
Seat 4: Oleg032 ($10.41 in chips) 
Seat 5: skakalec90 ($10.34 in chips) 
Seat 6: xiled90 ($10.32 in chips) 
skakalec90: posts small blind $0.05
xiled90: posts big blind $0.10
*** HOLE CARDS ***
burrocsorte: folds 
LonSGtn: raises $0.10 to $0.20
0nix770: folds 
Oleg032: calls $0.20
skakalec90: folds 
xiled90: folds 
*** FLOP *** [3d 7s 5c]
LonSGtn: checks 
Oleg032: checks 
*** TURN *** [3d 7s 5c] [Ks]
LonSGtn: bets $0.10
Oleg032: calls $0.10
*** RIVER *** [3d 7s 5c Ks] [7h]
LonSGtn: bets $0.20
Oleg032: calls $0.20
*** SHOW DOWN ***
LonSGtn: shows [Ad 9h] (a pair of Sevens)
Oleg032: shows [As 3s] (two pair, Sevens and Threes)
Oleg032 collected $1.10 from pot
*** SUMMARY ***
Total pot $1.15 | Rake $0.05 
Board [3d 7s 5c Ks 7h]
Seat 1: burrocsorte folded before Flop (didn't bet)
Seat 2: LonSGtn showed [Ad 9h] and lost with a pair of Sevens
Seat 3: 0nix770 folded before Flop (didn't bet)
Seat 4: Oleg032 (button) showed [As 3s] and won ($1.10) with two pair, Sevens and Threes
Seat 5: skakalec90 (small blind) folded before Flop
Seat 6: xiled90 (big blind) folded before Flop



PokerStars Hand #222966297045:  Hold'em No Limit ($0.05/$0.10 USD) - 2021/01/23 14:25:49 ET
Table 'Merope IV' 6-max Seat #5 is the button
Seat 1: burrocsorte ($11.12 in chips) 
Seat 2: LonSGtn ($4.94 in chips) 
Seat 3: 0nix770 ($10.15 in chips) 
Seat 4: Oleg032 ($11.01 in chips) 
Seat 5: skakalec90 ($10.29 in chips) 
Seat 6: xiled90 ($10.22 in chips) 
xiled90: posts small blind $0.05
burrocsorte: posts big blind $0.10
*** HOLE CARDS ***
LonSGtn: folds 
0nix770: folds 
Oleg032: raises $0.15 to $0.25
skakalec90: folds 
xiled90: folds 
burrocsorte: calls $0.15
*** FLOP *** [Jh 7h 6s]
burrocsorte: checks 
Oleg032: checks 
*** TURN *** [Jh 7h 6s] [As]
burrocsorte: bets $0.27
Oleg032: folds 
Uncalled bet ($0.27) returned to burrocsorte
burrocsorte collected $0.53 from pot
burrocsorte: doesn't show hand 
*** SUMMARY ***
Total pot $0.55 | Rake $0.02 
Board [Jh 7h 6s As]
Seat 1: burrocsorte (big blind) collected ($0.53)
Seat 2: LonSGtn folded before Flop (didn't bet)
Seat 3: 0nix770 folded before Flop (didn't bet)
Seat 4: Oleg032 folded on the Turn
Seat 5: skakalec90 (button) folded before Flop (didn't bet)
Seat 6: xiled90 (small blind) folded before Flop



PokerStars Hand #222966327620:  Hold'em No Limit ($0.05/$0.10 USD) - 2021/01/23 14:26:29 ET
Table 'Merope IV' 6-max Seat #6 is the button
Seat 1: burrocsorte ($11.40 in chips) 
Seat 2: LonSGtn ($4.94 in chips) 
Seat 3: 0nix770 ($10.15 in chips) 
Seat 4: Oleg032 ($10.76 in chips) 
Seat 5: skakalec90 ($10.29 in chips) 
Seat 6: xiled90 ($10.17 in chips) 
burrocsorte: posts small blind $0.05
LonSGtn: posts big blind $0.10
*** HOLE CARDS ***
0nix770: folds 
Oleg032: raises $0.15 to $0.25
skakalec90: folds 
xiled90: folds 
burrocsorte: folds 
LonSGtn: folds 
Uncalled bet ($0.15) returned to Oleg032
Oleg032 collected $0.25 from pot
Oleg032: doesn't show hand 
*** SUMMARY ***
Total pot $0.25 | Rake $0 
Seat 1: burrocsorte (small blind) folded before Flop
Seat 2: LonSGtn (big blind) folded before Flop
Seat 3: 0nix770 folded before Flop (didn't bet)
Seat 4: Oleg032 collected ($0.25)
Seat 5: skakalec90 folded before Flop (didn't bet)
Seat 6: xiled90 (button) folded before Flop (didn't bet)



PokerStars Hand #222966347946:  Hold'em No Limit ($0.05/$0.10 USD) - 2021/01/23 14:26:55 ET
Table 'Merope IV' 6-max Seat #1 is the button
Seat 1: burrocsorte ($11.35 in chips) 
Seat 2: LonSGtn ($4.84 in chips) 
Seat 4: Oleg032 ($10.91 in chips) 
Seat 5: skakalec90 ($10.29 in chips) 
Seat 6: xiled90 ($10.17 in chips) 
LonSGtn: posts small blind $0.05
0nix770: is sitting out 
Oleg032: posts big blind $0.10
*** HOLE CARDS ***
0nix770 leaves the table
skakalec90: raises $0.20 to $0.30
xiled90: folds 
burrocsorte: calls $0.30
LonSGtn: calls $0.25
willmig joins the table at seat #3 
Oleg032: folds 
*** FLOP *** [Ac 4c 2c]
LonSGtn: checks 
skakalec90: checks 
burrocsorte: checks 
*** TURN *** [Ac 4c 2c] [3c]
LonSGtn: checks 
skakalec90: checks 
burrocsorte: bets $0.20
LonSGtn: folds 
skakalec90: folds 
Uncalled bet ($0.20) returned to burrocsorte
burrocsorte collected $0.96 from pot
burrocsorte: doesn't show hand 
*** SUMMARY ***
Total pot $1 | Rake $0.04 
Board [Ac 4c 2c 3c]
Seat 1: burrocsorte (button) collected ($0.96)
Seat 2: LonSGtn (small blind) folded on the Turn
Seat 4: Oleg032 (big blind) folded before Flop
Seat 5: skakalec90 folded on the Turn
Seat 6: xiled90 folded before Flop (didn't bet)



PokerStars Hand #222966382175:  Hold'em No Limit ($0.05/$0.10 USD) - 2021/01/23 14:27:32 ET
Table 'Merope IV' 6-max Seat #2 is the button
Seat 1: burrocsorte ($12.01 in chips) 
Seat 2: LonSGtn ($4.54 in chips) 
Seat 4: Oleg032 ($10.81 in chips) 
Seat 5: skakalec90 ($10 in chips) 
Seat 6: xiled90 ($10.17 in chips) 
Oleg032: posts small blind $0.05
skakalec90: posts big blind $0.10
*** HOLE CARDS ***
xiled90: folds 
burrocsorte: folds 
LonSGtn: folds 
Oleg032: raises $0.20 to $0.30
skakalec90: calls $0.20
*** FLOP *** [2d Ts 4c]
Oleg032: bets $0.19
skakalec90: folds 
Uncalled bet ($0.19) returned to Oleg032
Oleg032 collected $0.57 from pot
Oleg032: doesn't show hand 
*** SUMMARY ***
Total pot $0.60 | Rake $0.03 
Board [2d Ts 4c]
Seat 1: burrocsorte folded before Flop (didn't bet)
Seat 2: LonSGtn (button) folded before Flop (didn't bet)
Seat 4: Oleg032 (small blind) collected ($0.57)
Seat 5: skakalec90 (big blind) folded on the Flop
Seat 6: xiled90 folded before Flop (didn't bet)



PokerStars Hand #222966397443:  Hold'em No Limit ($0.05/$0.10 USD) - 2021/01/23 14:27:52 ET
Table 'Merope IV' 6-max Seat #4 is the button
Seat 1: burrocsorte ($12.01 in chips) 
Seat 3: willmig ($10 in chips) 
Seat 4: Oleg032 ($11.08 in chips) 
Seat 5: skakalec90 ($10 in chips) 
Seat 6: xiled90 ($10.17 in chips) 
skakalec90: posts small blind $0.05
xiled90: posts big blind $0.10
willmig: posts big blind $0.10
*** HOLE CARDS ***
burrocsorte: folds 
willmig has timed out
willmig: checks 
Oleg032: raises $0.15 to $0.25
skakalec90: folds 
LonSGtn is disconnected 
xiled90: calls $0.15
willmig: folds 
*** FLOP *** [Jd 2d 6h]
xiled90: checks 
Oleg032: bets $0.20
xiled90: folds 
Uncalled bet ($0.20) returned to Oleg032
Oleg032 collected $0.62 from pot
Oleg032: doesn't show hand 
*** SUMMARY ***
Total pot $0.65 | Rake $0.03 
Board [Jd 2d 6h]
Seat 1: burrocsorte folded before Flop (didn't bet)
Seat 3: willmig folded before Flop (didn't bet)
Seat 4: Oleg032 (button) collected ($0.62)
Seat 5: skakalec90 (small blind) folded before Flop
Seat 6: xiled90 (big blind) folded on the Flop



PokerStars Hand #222966449099:  Hold'em No Limit ($0.05/$0.10 USD) - 2021/01/23 14:28:59 ET
Table 'Merope IV' 6-max Seat #5 is the button
Seat 1: burrocsorte ($12.01 in chips) 
Seat 3: willmig ($9.90 in chips) 
Seat 4: Oleg032 ($11.45 in chips) 
Seat 5: skakalec90 ($10 in chips) 
Seat 6: xiled90 ($10 in chips) 
xiled90: posts small blind $0.05
burrocsorte: posts big blind $0.10
*** HOLE CARDS ***
willmig has timed out
willmig: folds 
Oleg032: folds 
skakalec90: folds 
xiled90: folds 
Uncalled bet ($0.05) returned to burrocsorte
burrocsorte collected $0.10 from pot
burrocsorte: doesn't show hand 
*** SUMMARY ***
Total pot $0.10 | Rake $0 
Seat 1: burrocsorte (big blind) collected ($0.10)
Seat 3: willmig folded before Flop (didn't bet)
Seat 4: Oleg032 folded before Flop (didn't bet)
Seat 5: skakalec90 (button) folded before Flop (didn't bet)
Seat 6: xiled90 (small blind) folded before Flop



PokerStars Hand #222966462871:  Hold'em No Limit ($0.05/$0.10 USD) - 2021/01/23 14:29:17 ET
Table 'Merope IV' 6-max Seat #6 is the button
Seat 1: burrocsorte ($12.06 in chips) 
Seat 3: willmig ($9.90 in chips) 
Seat 4: Oleg032 ($11.45 in chips) 
Seat 5: skakalec90 ($10 in chips) 
Seat 6: xiled90 ($10 in chips) 
burrocsorte: posts small blind $0.05
willmig: posts big blind $0.10
*** HOLE CARDS ***
Oleg032: folds 
skakalec90: folds 
xiled90: raises $0.15 to $0.25
burrocsorte: folds 
willmig: folds 
Uncalled bet ($0.15) returned to xiled90
xiled90 collected $0.25 from pot
xiled90: doesn't show hand 
*** SUMMARY ***
Total pot $0.25 | Rake $0 
Seat 1: burrocsorte (small blind) folded before Flop
Seat 3: willmig (big blind) folded before Flop
Seat 4: Oleg032 folded before Flop (didn't bet)
Seat 5: skakalec90 folded before Flop (didn't bet)
Seat 6: xiled90 (button) collected ($0.25)



PokerStars Hand #222966472413:  Hold'em No Limit ($0.05/$0.10 USD) - 2021/01/23 14:29:29 ET
Table 'Merope IV' 6-max Seat #1 is the button
Seat 1: burrocsorte ($12.01 in chips) 
Seat 3: willmig ($9.80 in chips) 
Seat 4: Oleg032 ($11.45 in chips) 
Seat 5: skakalec90 ($10 in chips) 
Seat 6: xiled90 ($10.15 in chips) 
willmig: posts small blind $0.05
Oleg032: posts big blind $0.10
*** HOLE CARDS ***
skakalec90: folds 
xiled90: raises $0.20 to $0.30
burrocsorte: folds 
willmig: folds 
Oleg032: calls $0.20
*** FLOP *** [Ac 7h 6h]
Oleg032: checks 
xiled90: bets $0.31
Oleg032: folds 
Uncalled bet ($0.31) returned to xiled90
xiled90 collected $0.62 from pot
xiled90: doesn't show hand 
*** SUMMARY ***
Total pot $0.65 | Rake $0.03 
Board [Ac 7h 6h]
Seat 1: burrocsorte (button) folded before Flop (didn't bet)
Seat 3: willmig (small blind) folded before Flop
Seat 4: Oleg032 (big blind) folded on the Flop
Seat 5: skakalec90 folded before Flop (didn't bet)
Seat 6: xiled90 collected ($0.62)



PokerStars Hand #222966488454:  Hold'em No Limit ($0.05/$0.10 USD) - 2021/01/23 14:29:50 ET
Table 'Merope IV' 6-max Seat #3 is the button
Seat 1: burrocsorte ($12.01 in chips) 
Seat 2: LonSGtn ($4.54 in chips) 
Seat 3: willmig ($9.75 in chips) 
Seat 4: Oleg032 ($11.15 in chips) 
Seat 5: skakalec90 ($10 in chips) 
Seat 6: xiled90 ($10.47 in chips) 
Oleg032: posts small blind $0.05
skakalec90: posts big blind $0.10
LonSGtn: posts small & big blinds $0.15
*** HOLE CARDS ***
xiled90: folds 
burrocsorte: folds 
LonSGtn: raises $0.10 to $0.20
willmig: folds 
Oleg032: calls $0.15
skakalec90: folds 
*** FLOP *** [Kh 2d 7h]
Oleg032: checks 
LonSGtn: bets $0.26
Oleg032: folds 
Uncalled bet ($0.26) returned to LonSGtn
LonSGtn collected $0.53 from pot
LonSGtn: doesn't show hand 
*** SUMMARY ***
Total pot $0.55 | Rake $0.02 
Board [Kh 2d 7h]
Seat 1: burrocsorte folded before Flop (didn't bet)
Seat 2: LonSGtn collected ($0.53)
Seat 3: willmig (button) folded before Flop (didn't bet)
Seat 4: Oleg032 (small blind) folded on the Flop
Seat 5: skakalec90 (big blind) folded before Flop
Seat 6: xiled90 folded before Flop (didn't bet)



PokerStars Hand #222966515854:  Hold'em No Limit ($0.05/$0.10 USD) - 2021/01/23 14:30:13 ET
Table 'Merope IV' 6-max Seat #4 is the button
Seat 1: burrocsorte ($12.01 in chips) 
Seat 2: LonSGtn ($4.82 in chips) 
Seat 3: willmig ($9.75 in chips) 
Seat 4: Oleg032 ($10.95 in chips) 
Seat 5: skakalec90 ($10 in chips) 
Seat 6: xiled90 ($10.47 in chips) 
skakalec90: posts small blind $0.05
xiled90: posts big blind $0.10
*** HOLE CARDS ***
burrocsorte: raises $0.20 to $0.30
LonSGtn: calls $0.30
willmig: calls $0.30
Oleg032: folds 
skakalec90: folds 
xiled90: folds 
*** FLOP *** [5d 9h Kd]
burrocsorte: checks 
LonSGtn: checks 
willmig: checks 
*** TURN *** [5d 9h Kd] [3h]
burrocsorte: checks 
LonSGtn: bets $0.50
willmig: calls $0.50
burrocsorte: folds 
*** RIVER *** [5d 9h Kd 3h] [8h]
LonSGtn: bets $0.98
willmig: folds 
Uncalled bet ($0.98) returned to LonSGtn
LonSGtn collected $1.96 from pot
LonSGtn: doesn't show hand 
*** SUMMARY ***
Total pot $2.05 | Rake $0.09 
Board [5d 9h Kd 3h 8h]
Seat 1: burrocsorte folded on the Turn
Seat 2: LonSGtn collected ($1.96)
Seat 3: willmig folded on the River
Seat 4: Oleg032 (button) folded before Flop (didn't bet)
Seat 5: skakalec90 (small blind) folded before Flop
Seat 6: xiled90 (big blind) folded before Flop



PokerStars Hand #222966548342:  Hold'em No Limit ($0.05/$0.10 USD) - 2021/01/23 14:30:55 ET
Table 'Merope IV' 6-max Seat #5 is the button
Seat 1: burrocsorte ($11.71 in chips) 
Seat 2: LonSGtn ($5.98 in chips) 
Seat 3: willmig ($8.95 in chips) 
Seat 4: Oleg032 ($10.95 in chips) 
Seat 5: skakalec90 ($10 in chips) 
Seat 6: xiled90 ($10.37 in chips) 
xiled90: posts small blind $0.05
burrocsorte: posts big blind $0.10
*** HOLE CARDS ***
LonSGtn: folds 
willmig: raises $0.20 to $0.30
Oleg032: calls $0.30
skakalec90: folds 
xiled90: folds 
burrocsorte: raises $0.40 to $0.70
willmig: calls $0.40
Oleg032: calls $0.40
*** FLOP *** [4c 8c 8s]
burrocsorte: checks 
willmig: checks 
Oleg032: bets $0.68
burrocsorte: folds 
willmig: raises $0.68 to $1.36
Oleg032: calls $0.68
*** TURN *** [4c 8c 8s] [7h]
willmig: checks 
Oleg032: checks 
*** RIVER *** [4c 8c 8s 7h] [Ad]
willmig: bets $6.89 and is all-in
Oleg032: folds 
Uncalled bet ($6.89) returned to willmig
willmig collected $4.65 from pot
*** SUMMARY ***
Total pot $4.87 | Rake $0.22 
Board [4c 8c 8s 7h Ad]
Seat 1: burrocsorte (big blind) folded on the Flop
Seat 2: LonSGtn folded before Flop (didn't bet)
Seat 3: willmig collected ($4.65)
Seat 4: Oleg032 folded on the River
Seat 5: skakalec90 (button) folded before Flop (didn't bet)
Seat 6: xiled90 (small blind) folded before Flop



PokerStars Hand #222966591395:  Hold'em No Limit ($0.05/$0.10 USD) - 2021/01/23 14:31:49 ET
Table 'Merope IV' 6-max Seat #6 is the button
Seat 1: burrocsorte ($11.01 in chips) 
Seat 2: LonSGtn ($5.98 in chips) 
Seat 3: willmig ($11.54 in chips) 
Seat 4: Oleg032 ($10 in chips) 
Seat 5: skakalec90 ($10 in chips) 
Seat 6: xiled90 ($10.32 in chips) 
burrocsorte: posts small blind $0.05
LonSGtn: posts big blind $0.10
*** HOLE CARDS ***
willmig: folds 
Oleg032: folds 
skakalec90: folds 
xiled90: folds 
burrocsorte: raises $0.20 to $0.30
LonSGtn: calls $0.20
*** FLOP *** [3h Jh Ts]
burrocsorte: bets $0.29
LonSGtn: calls $0.29
*** TURN *** [3h Jh Ts] [9s]
burrocsorte: bets $0.57
LonSGtn: calls $0.57
*** RIVER *** [3h Jh Ts 9s] [5h]
burrocsorte: checks 
LonSGtn: checks 
*** SHOW DOWN ***
burrocsorte: shows [Ac 9c] (a pair of Nines)
LonSGtn: shows [7c Jc] (a pair of Jacks)
LonSGtn collected $2.22 from pot
*** SUMMARY ***
Total pot $2.32 | Rake $0.10 
Board [3h Jh Ts 9s 5h]
Seat 1: burrocsorte (small blind) showed [Ac 9c] and lost with a pair of Nines
Seat 2: LonSGtn (big blind) showed [7c Jc] and won ($2.22) with a pair of Jacks
Seat 3: willmig folded before Flop (didn't bet)
Seat 4: Oleg032 folded before Flop (didn't bet)
Seat 5: skakalec90 folded before Flop (didn't bet)
Seat 6: xiled90 (button) folded before Flop (didn't bet)



PokerStars Hand #222966617371:  Hold'em No Limit ($0.05/$0.10 USD) - 2021/01/23 14:32:23 ET
Table 'Merope IV' 6-max Seat #1 is the button
Seat 1: burrocsorte ($9.85 in chips) 
Seat 2: LonSGtn ($7.04 in chips) 
Seat 3: willmig ($11.54 in chips) 
Seat 4: Oleg032 ($10 in chips) 
Seat 5: skakalec90 ($10 in chips) 
Seat 6: xiled90 ($10.32 in chips) 
LonSGtn: posts small blind $0.05
willmig: posts big blind $0.10
*** HOLE CARDS ***
Oleg032: folds 
skakalec90: folds 
xiled90: folds 
burrocsorte: folds 
LonSGtn: calls $0.05
willmig: checks 
*** FLOP *** [Ts As Td]
LonSGtn: bets $0.10
willmig: raises $0.20 to $0.30
LonSGtn: calls $0.20
*** TURN *** [Ts As Td] [3c]
LonSGtn: checks 
willmig: bets $0.38
LonSGtn: folds 
Uncalled bet ($0.38) returned to willmig
willmig collected $0.76 from pot
*** SUMMARY ***
Total pot $0.80 | Rake $0.04 
Board [Ts As Td 3c]
Seat 1: burrocsorte (button) folded before Flop (didn't bet)
Seat 2: LonSGtn (small blind) folded on the Turn
Seat 3: willmig (big blind) collected ($0.76)
Seat 4: Oleg032 folded before Flop (didn't bet)
Seat 5: skakalec90 folded before Flop (didn't bet)
Seat 6: xiled90 folded before Flop (didn't bet)



PokerStars Hand #222966638893:  Hold'em No Limit ($0.05/$0.10 USD) - 2021/01/23 14:32:50 ET
Table 'Merope IV' 6-max Seat #2 is the button
Seat 1: burrocsorte ($9.85 in chips) 
Seat 2: LonSGtn ($6.64 in chips) 
Seat 3: willmig ($11.90 in chips) 
Seat 4: Oleg032 ($10 in chips) 
Seat 5: skakalec90 ($10 in chips) 
Seat 6: xiled90 ($10.32 in chips) 
willmig: posts small blind $0.05
Oleg032: posts big blind $0.10
*** HOLE CARDS ***
skakalec90: folds 
xiled90: folds 
burrocsorte: folds 
LonSGtn: raises $0.10 to $0.20
willmig: raises $0.60 to $0.80
Oleg032: folds 
LonSGtn: calls $0.60
*** FLOP *** [2c 6d 8s]
willmig: checks 
LonSGtn: checks 
*** TURN *** [2c 6d 8s] [2h]
willmig: bets $0.81
LonSGtn: folds 
Uncalled bet ($0.81) returned to willmig
willmig collected $1.62 from pot
*** SUMMARY ***
Total pot $1.70 | Rake $0.08 
Board [2c 6d 8s 2h]
Seat 1: burrocsorte folded before Flop (didn't bet)
Seat 2: LonSGtn (button) folded on the Turn
Seat 3: willmig (small blind) collected ($1.62)
Seat 4: Oleg032 (big blind) folded before Flop
Seat 5: skakalec90 folded before Flop (didn't bet)
Seat 6: xiled90 folded before Flop (didn't bet)



PokerStars Hand #222966660891:  Hold'em No Limit ($0.05/$0.10 USD) - 2021/01/23 14:33:18 ET
Table 'Merope IV' 6-max Seat #3 is the button
Seat 1: burrocsorte ($9.85 in chips) 
Seat 2: LonSGtn ($5.84 in chips) 
Seat 3: willmig ($12.72 in chips) 
Seat 4: Oleg032 ($10 in chips) 
Seat 5: skakalec90 ($10 in chips) 
Seat 6: xiled90 ($10.32 in chips) 
Oleg032: posts small blind $0.05
skakalec90: posts big blind $0.10
*** HOLE CARDS ***
xiled90: folds 
burrocsorte: folds 
LonSGtn: raises $0.10 to $0.20
willmig: folds 
Oleg032: folds 
skakalec90: folds 
Uncalled bet ($0.10) returned to LonSGtn
LonSGtn collected $0.25 from pot
LonSGtn: doesn't show hand 
*** SUMMARY ***
Total pot $0.25 | Rake $0 
Seat 1: burrocsorte folded before Flop (didn't bet)
Seat 2: LonSGtn collected ($0.25)
Seat 3: willmig (button) folded before Flop (didn't bet)
Seat 4: Oleg032 (small blind) folded before Flop
Seat 5: skakalec90 (big blind) folded before Flop
Seat 6: xiled90 folded before Flop (didn't bet)



PokerStars Hand #222966674687:  Hold'em No Limit ($0.05/$0.10 USD) - 2021/01/23 14:33:35 ET
Table 'Merope IV' 6-max Seat #4 is the button
Seat 1: burrocsorte ($9.85 in chips) 
Seat 2: LonSGtn ($5.99 in chips) 
Seat 3: willmig ($12.72 in chips) 
Seat 4: Oleg032 ($10 in chips) 
Seat 5: skakalec90 ($10 in chips) 
Seat 6: xiled90 ($10.32 in chips) 
skakalec90: posts small blind $0.05
xiled90: posts big blind $0.10
*** HOLE CARDS ***
burrocsorte: folds 
LonSGtn: folds 
willmig: raises $0.20 to $0.30
Oleg032: folds 
skakalec90: folds 
xiled90: folds 
Uncalled bet ($0.20) returned to willmig
willmig collected $0.25 from pot
*** SUMMARY ***
Total pot $0.25 | Rake $0 
Seat 1: burrocsorte folded before Flop (didn't bet)
Seat 2: LonSGtn folded before Flop (didn't bet)
Seat 3: willmig collected ($0.25)
Seat 4: Oleg032 (button) folded before Flop (didn't bet)
Seat 5: skakalec90 (small blind) folded before Flop
Seat 6: xiled90 (big blind) folded before Flop



PokerStars Hand #222966691022:  Hold'em No Limit ($0.05/$0.10 USD) - 2021/01/23 14:33:56 ET
Table 'Merope IV' 6-max Seat #5 is the button
Seat 1: burrocsorte ($9.85 in chips) 
Seat 2: LonSGtn ($5.99 in chips) 
Seat 3: willmig ($12.87 in chips) 
Seat 4: Oleg032 ($10 in chips) 
Seat 5: skakalec90 ($10 in chips) 
Seat 6: xiled90 ($10.22 in chips) 
xiled90: posts small blind $0.05
burrocsorte: posts big blind $0.10
*** HOLE CARDS ***
LonSGtn has timed out
LonSGtn: folds 
willmig: folds 
Oleg032: folds 
skakalec90: raises $0.20 to $0.30
xiled90: folds 
burrocsorte: folds 
Uncalled bet ($0.20) returned to skakalec90
skakalec90 collected $0.25 from pot
skakalec90: doesn't show hand 
*** SUMMARY ***
Total pot $0.25 | Rake $0 
Seat 1: burrocsorte (big blind) folded before Flop
Seat 2: LonSGtn folded before Flop (didn't bet)
Seat 3: willmig folded before Flop (didn't bet)
Seat 4: Oleg032 folded before Flop (didn't bet)
Seat 5: skakalec90 (button) collected ($0.25)
Seat 6: xiled90 (small blind) folded before Flop



PokerStars Hand #222966714856:  Hold'em No Limit ($0.05/$0.10 USD) - 2021/01/23 14:34:27 ET
Table 'Merope IV' 6-max Seat #6 is the button
Seat 1: burrocsorte ($9.75 in chips) 
Seat 2: LonSGtn ($5.99 in chips) 
Seat 3: willmig ($12.87 in chips) 
Seat 4: Oleg032 ($10 in chips) 
Seat 5: skakalec90 ($10.15 in chips) 
Seat 6: xiled90 ($10.17 in chips) 
burrocsorte: posts small blind $0.05
LonSGtn: posts big blind $0.10
*** HOLE CARDS ***
willmig: folds 
Oleg032: folds 
skakalec90: folds 
xiled90: raises $0.15 to $0.25
burrocsorte: folds 
LonSGtn: calls $0.15
*** FLOP *** [7d 9d Tc]
burrocsorte leaves the table
LonSGtn: checks 
xiled90: bets $0.27
LonSGtn: calls $0.27
*** TURN *** [7d 9d Tc] [6d]
LonSGtn: checks 
xiled90: checks 
*** RIVER *** [7d 9d Tc 6d] [Kh]
LonSGtn: bets $0.62
xiled90: folds 
Uncalled bet ($0.62) returned to LonSGtn
LonSGtn collected $1.04 from pot
LonSGtn: doesn't show hand 
*** SUMMARY ***
Total pot $1.09 | Rake $0.05 
Board [7d 9d Tc 6d Kh]
Seat 1: burrocsorte (small blind) folded before Flop
Seat 2: LonSGtn (big blind) collected ($1.04)
Seat 3: willmig folded before Flop (didn't bet)
Seat 4: Oleg032 folded before Flop (didn't bet)
Seat 5: skakalec90 folded before Flop (didn't bet)
Seat 6: xiled90 (button) folded on the River



PokerStars Hand #222966741759:  Hold'em No Limit ($0.05/$0.10 USD) - 2021/01/23 14:35:01 ET
Table 'Merope IV' 6-max Seat #2 is the button
Seat 2: LonSGtn ($6.51 in chips) 
Seat 3: willmig ($12.87 in chips) 
Seat 4: Oleg032 ($10 in chips) 
Seat 5: skakalec90 ($10.15 in chips) 
Seat 6: xiled90 ($10 in chips) 
willmig: posts small blind $0.05
Oleg032: posts big blind $0.10
*** HOLE CARDS ***
skakalec90: folds 
xiled90: raises $0.20 to $0.30
Zambodi500 joins the table at seat #1 
LonSGtn: calls $0.30
willmig: folds 
Oleg032: folds 
*** FLOP *** [As Js 4h]
xiled90: bets $0.24
LonSGtn: calls $0.24
*** TURN *** [As Js 4h] [9h]
xiled90: checks 
LonSGtn: checks 
*** RIVER *** [As Js 4h 9h] [8h]
xiled90: bets $1
LonSGtn: folds 
Uncalled bet ($1) returned to xiled90
xiled90 collected $1.17 from pot
xiled90: doesn't show hand 
*** SUMMARY ***
Total pot $1.23 | Rake $0.06 
Board [As Js 4h 9h 8h]
Seat 2: LonSGtn (button) folded on the River
Seat 3: willmig (small blind) folded before Flop
Seat 4: Oleg032 (big blind) folded before Flop
Seat 5: skakalec90 folded before Flop (didn't bet)
Seat 6: xiled90 collected ($1.17)



PokerStars Hand #222966771752:  Hold'em No Limit ($0.05/$0.10 USD) - 2021/01/23 14:35:40 ET
Table 'Merope IV' 6-max Seat #3 is the button
Seat 2: LonSGtn ($5.97 in chips) 
Seat 3: willmig ($12.82 in chips) 
Seat 4: Oleg032 ($10 in chips) 
Seat 5: skakalec90 ($10.15 in chips) 
Seat 6: xiled90 ($10.63 in chips) 
Oleg032: posts small blind $0.05
skakalec90: posts big blind $0.10
Zambodi500: sits out 
*** HOLE CARDS ***
xiled90: raises $0.20 to $0.30
LonSGtn: folds 
willmig: calls $0.30
Oleg032: folds 
skakalec90: calls $0.20
*** FLOP *** [Tc Jc 3c]
skakalec90: checks 
xiled90: checks 
willmig: bets $0.45
skakalec90: folds 
xiled90: folds 
Uncalled bet ($0.45) returned to willmig
willmig collected $0.91 from pot
*** SUMMARY ***
Total pot $0.95 | Rake $0.04 
Board [Tc Jc 3c]
Seat 2: LonSGtn folded before Flop (didn't bet)
Seat 3: willmig (button) collected ($0.91)
Seat 4: Oleg032 (small blind) folded before Flop
Seat 5: skakalec90 (big blind) folded on the Flop
Seat 6: xiled90 folded on the Flop



PokerStars Hand #222966803903:  Hold'em No Limit ($0.05/$0.10 USD) - 2021/01/23 14:36:21 ET
Table 'Merope IV' 6-max Seat #4 is the button
Seat 2: LonSGtn ($5.97 in chips) 
Seat 3: willmig ($13.43 in chips) 
Seat 4: Oleg032 ($10 in chips) 
Seat 5: skakalec90 ($10 in chips) 
Seat 6: xiled90 ($10.33 in chips) 
skakalec90: posts small blind $0.05
xiled90: posts big blind $0.10
Zambodi500: sits out 
*** HOLE CARDS ***
LonSGtn: folds 
willmig: folds 
Oleg032: raises $0.15 to $0.25
skakalec90: calls $0.20
xiled90: folds 
*** FLOP *** [5h 6d 8d]
skakalec90: checks 
Oleg032: bets $0.29
skakalec90: calls $0.29
*** TURN *** [5h 6d 8d] [2h]
skakalec90: checks 
Oleg032: bets $0.57
skakalec90: calls $0.57
*** RIVER *** [5h 6d 8d 2h] [9c]
skakalec90: checks 
Oleg032: checks 
*** SHOW DOWN ***
skakalec90: shows [7h 8h] (a straight, Five to Nine)
Oleg032: mucks hand 
skakalec90 collected $2.22 from pot
*** SUMMARY ***
Total pot $2.32 | Rake $0.10 
Board [5h 6d 8d 2h 9c]
Seat 2: LonSGtn folded before Flop (didn't bet)
Seat 3: willmig folded before Flop (didn't bet)
Seat 4: Oleg032 (button) mucked
Seat 5: skakalec90 (small blind) showed [7h 8h] and won ($2.22) with a straight, Five to Nine
Seat 6: xiled90 (big blind) folded before Flop



PokerStars Hand #222966835894:  Hold'em No Limit ($0.05/$0.10 USD) - 2021/01/23 14:37:01 ET
Table 'Merope IV' 6-max Seat #5 is the button
Seat 1: Zambodi500 ($10 in chips) 
Seat 2: LonSGtn ($5.97 in chips) 
Seat 3: willmig ($13.43 in chips) 
Seat 4: Oleg032 ($10 in chips) 
Seat 5: skakalec90 ($11.11 in chips) 
Seat 6: xiled90 ($10.23 in chips) 
xiled90: posts small blind $0.05
Zambodi500: posts big blind $0.10
*** HOLE CARDS ***
LonSGtn: folds 
willmig: folds 
Oleg032: folds 
skakalec90: folds 
xiled90: folds 
Uncalled bet ($0.05) returned to Zambodi500
Zambodi500 collected $0.10 from pot
*** SUMMARY ***
Total pot $0.10 | Rake $0 
Seat 1: Zambodi500 (big blind) collected ($0.10)
Seat 2: LonSGtn folded before Flop (didn't bet)
Seat 3: willmig folded before Flop (didn't bet)
Seat 4: Oleg032 folded before Flop (didn't bet)
Seat 5: skakalec90 (button) folded before Flop (didn't bet)
Seat 6: xiled90 (small blind) folded before Flop



PokerStars Hand #222966853881:  Hold'em No Limit ($0.05/$0.10 USD) - 2021/01/23 14:37:24 ET
Table 'Merope IV' 6-max Seat #6 is the button
Seat 1: Zambodi500 ($10.05 in chips) 
Seat 2: LonSGtn ($5.97 in chips) 
Seat 3: willmig ($13.43 in chips) 
Seat 4: Oleg032 ($10 in chips) 
Seat 5: skakalec90 ($11.11 in chips) 
Seat 6: xiled90 ($10.18 in chips) 
Zambodi500: posts small blind $0.05
LonSGtn: posts big blind $0.10
*** HOLE CARDS ***
willmig: raises $0.10 to $0.20
Oleg032: raises $0.50 to $0.70
skakalec90: folds 
xiled90: folds 
Zambodi500: folds 
LonSGtn: calls $0.60
willmig: raises $12.73 to $13.43 and is all-in
Oleg032: folds 
LonSGtn: calls $5.27 and is all-in
Uncalled bet ($7.46) returned to willmig
*** FLOP *** [Ac 8s 5c]
*** TURN *** [Ac 8s 5c] [As]
*** RIVER *** [Ac 8s 5c As] [9s]
*** SHOW DOWN ***
LonSGtn: shows [Td Ts] (two pair, Aces and Tens)
willmig: shows [8c 8h] (a full house, Eights full of Aces)
willmig collected $12.12 from pot
*** SUMMARY ***
Total pot $12.69 | Rake $0.57 
Board [Ac 8s 5c As 9s]
Seat 1: Zambodi500 (small blind) folded before Flop
Seat 2: LonSGtn (big blind) showed [Td Ts] and lost with two pair, Aces and Tens
Seat 3: willmig showed [8c 8h] and won ($12.12) with a full house, Eights full of Aces
Seat 4: Oleg032 folded before Flop
Seat 5: skakalec90 folded before Flop (didn't bet)
Seat 6: xiled90 (button) folded before Flop (didn't bet)



PokerStars Hand #222966884400:  Hold'em No Limit ($0.05/$0.10 USD) - 2021/01/23 14:38:03 ET
Table 'Merope IV' 6-max Seat #1 is the button
Seat 1: Zambodi500 ($10 in chips) 
Seat 3: willmig ($19.58 in chips) 
Seat 4: Oleg032 ($10 in chips) 
Seat 5: skakalec90 ($11.11 in chips) 
Seat 6: xiled90 ($10.18 in chips) 
willmig: posts small blind $0.05
Oleg032: posts big blind $0.10
*** HOLE CARDS ***
skakalec90: folds 
xiled90: folds 
LonSGtn leaves the table
Zambodi500: raises $0.15 to $0.25
willmig: folds 
Oleg032: folds 
Uncalled bet ($0.15) returned to Zambodi500
Zambodi500 collected $0.25 from pot
*** SUMMARY ***
Total pot $0.25 | Rake $0 
Seat 1: Zambodi500 (button) collected ($0.25)
Seat 3: willmig (small blind) folded before Flop
Seat 4: Oleg032 (big blind) folded before Flop
Seat 5: skakalec90 folded before Flop (didn't bet)
Seat 6: xiled90 folded before Flop (didn't bet)



PokerStars Hand #222966894216:  Hold'em No Limit ($0.05/$0.10 USD) - 2021/01/23 14:38:16 ET
Table 'Merope IV' 6-max Seat #3 is the button
Seat 1: Zambodi500 ($10.15 in chips) 
Seat 3: willmig ($19.53 in chips) 
Seat 4: Oleg032 ($10 in chips) 
Seat 5: skakalec90 ($11.11 in chips) 
Seat 6: xiled90 ($10.18 in chips) 
Oleg032: posts small blind $0.05
skakalec90: posts big blind $0.10
*** HOLE CARDS ***
Hamilton_TD joins the table at seat #2 
xiled90: folds 
Zambodi500: folds 
willmig: folds 
Oleg032: folds 
Uncalled bet ($0.05) returned to skakalec90
skakalec90 collected $0.10 from pot
skakalec90: doesn't show hand 
*** SUMMARY ***
Total pot $0.10 | Rake $0 
Seat 1: Zambodi500 folded before Flop (didn't bet)
Seat 3: willmig (button) folded before Flop (didn't bet)
Seat 4: Oleg032 (small blind) folded before Flop
Seat 5: skakalec90 (big blind) collected ($0.10)
Seat 6: xiled90 folded before Flop (didn't bet)



PokerStars Hand #222966907732:  Hold'em No Limit ($0.05/$0.10 USD) - 2021/01/23 14:38:33 ET
Table 'Merope IV' 6-max Seat #4 is the button
Seat 1: Zambodi500 ($10.15 in chips) 
Seat 3: willmig ($19.53 in chips) 
Seat 4: Oleg032 ($10 in chips) 
Seat 5: skakalec90 ($11.16 in chips) 
Seat 6: xiled90 ($10.18 in chips) 
skakalec90: posts small blind $0.05
xiled90: posts big blind $0.10
Hamilton_TD: sits out 
*** HOLE CARDS ***
Zambodi500: raises $0.20 to $0.30
willmig: folds 
willmig leaves the table
Oleg032: folds 
skakalec90: folds 
xiled90: folds 
Uncalled bet ($0.20) returned to Zambodi500
Zambodi500 collected $0.25 from pot
*** SUMMARY ***
Total pot $0.25 | Rake $0 
Seat 1: Zambodi500 collected ($0.25)
Seat 3: willmig folded before Flop (didn't bet)
Seat 4: Oleg032 (button) folded before Flop (didn't bet)
Seat 5: skakalec90 (small blind) folded before Flop
Seat 6: xiled90 (big blind) folded before Flop



PokerStars Hand #222966926666:  Hold'em No Limit ($0.05/$0.10 USD) - 2021/01/23 14:38:58 ET
Table 'Merope IV' 6-max Seat #5 is the button
Seat 1: Zambodi500 ($10.30 in chips) 
Seat 4: Oleg032 ($10 in chips) 
Seat 5: skakalec90 ($11.11 in chips) 
Seat 6: xiled90 ($10.08 in chips) 
xiled90: posts small blind $0.05
Zambodi500: posts big blind $0.10
Hamilton_TD: sits out 
*** HOLE CARDS ***
Pipser222 joins the table at seat #3 
Oleg032: folds 
skakalec90: raises $0.20 to $0.30
xiled90: folds 
Zambodi500: folds 
Uncalled bet ($0.20) returned to skakalec90
skakalec90 collected $0.25 from pot
skakalec90: doesn't show hand 
*** SUMMARY ***
Total pot $0.25 | Rake $0 
Seat 1: Zambodi500 (big blind) folded before Flop
Seat 4: Oleg032 folded before Flop (didn't bet)
Seat 5: skakalec90 (button) collected ($0.25)
Seat 6: xiled90 (small blind) folded before Flop



PokerStars Hand #222966937620:  Hold'em No Limit ($0.05/$0.10 USD) - 2021/01/23 14:39:11 ET
Table 'Merope IV' 6-max Seat #6 is the button
Seat 1: Zambodi500 ($10.20 in chips) 
Seat 2: Hamilton_TD ($10 in chips) 
Seat 4: Oleg032 ($10 in chips) 
Seat 5: skakalec90 ($11.26 in chips) 
Seat 6: xiled90 ($10.03 in chips) 
Zambodi500: posts small blind $0.05
Hamilton_TD: posts big blind $0.10
Pipser222: sits out 
*** HOLE CARDS ***
Oleg032: folds 
skakalec90: raises $0.20 to $0.30
xiled90: folds 
Zambodi500: folds 
Hamilton_TD: folds 
Uncalled bet ($0.20) returned to skakalec90
skakalec90 collected $0.25 from pot
skakalec90: doesn't show hand 
*** SUMMARY ***
Total pot $0.25 | Rake $0 
Seat 1: Zambodi500 (small blind) folded before Flop
Seat 2: Hamilton_TD (big blind) folded before Flop
Seat 4: Oleg032 folded before Flop (didn't bet)
Seat 5: skakalec90 collected ($0.25)
Seat 6: xiled90 (button) folded before Flop (didn't bet)



PokerStars Hand #222966947645:  Hold'em No Limit ($0.05/$0.10 USD) - 2021/01/23 14:39:24 ET
Table 'Merope IV' 6-max Seat #1 is the button
Seat 1: Zambodi500 ($10.15 in chips) 
Seat 2: Hamilton_TD ($10 in chips) 
Seat 3: Pipser222 ($10 in chips) 
Seat 4: Oleg032 ($10 in chips) 
Seat 5: skakalec90 ($11.41 in chips) 
Seat 6: xiled90 ($10.03 in chips) 
Hamilton_TD: posts small blind $0.05
Pipser222: posts big blind $0.10
*** HOLE CARDS ***
Oleg032: raises $0.15 to $0.25
skakalec90: folds 
xiled90: folds 
Zambodi500: raises $0.50 to $0.75
Hamilton_TD: folds 
Pipser222: folds 
Oleg032: folds 
Uncalled bet ($0.50) returned to Zambodi500
Zambodi500 collected $0.65 from pot
*** SUMMARY ***
Total pot $0.65 | Rake $0 
Seat 1: Zambodi500 (button) collected ($0.65)
Seat 2: Hamilton_TD (small blind) folded before Flop
Seat 3: Pipser222 (big blind) folded before Flop
Seat 4: Oleg032 folded before Flop
Seat 5: skakalec90 folded before Flop (didn't bet)
Seat 6: xiled90 folded before Flop (didn't bet)



PokerStars Hand #222966968134:  Hold'em No Limit ($0.05/$0.10 USD) - 2021/01/23 14:39:50 ET
Table 'Merope IV' 6-max Seat #2 is the button
Seat 1: Zambodi500 ($10.55 in chips) 
Seat 2: Hamilton_TD ($10 in chips) 
Seat 3: Pipser222 ($10 in chips) 
Seat 4: Oleg032 ($10 in chips) 
Seat 5: skakalec90 ($11.41 in chips) 
Seat 6: xiled90 ($10.03 in chips) 
Pipser222: posts small blind $0.05
Oleg032: posts big blind $0.10
*** HOLE CARDS ***
skakalec90: folds 
xiled90: folds 
Zambodi500: raises $0.15 to $0.25
Hamilton_TD: folds 
Hamilton_TD was removed from the table for failing to post
Hamilton_TD leaves the table
Pipser222: folds 
PhilJahnz joins the table at seat #2 
Oleg032: folds 
Uncalled bet ($0.15) returned to Zambodi500
Zambodi500 collected $0.25 from pot
*** SUMMARY ***
Total pot $0.25 | Rake $0 
Seat 1: Zambodi500 collected ($0.25)
Seat 2: Hamilton_TD (button) folded before Flop (didn't bet)
Seat 3: Pipser222 (small blind) folded before Flop
Seat 4: Oleg032 (big blind) folded before Flop
Seat 5: skakalec90 folded before Flop (didn't bet)
Seat 6: xiled90 folded before Flop (didn't bet)



PokerStars Hand #222966981707:  Hold'em No Limit ($0.05/$0.10 USD) - 2021/01/23 14:40:08 ET
Table 'Merope IV' 6-max Seat #3 is the button
Seat 1: Zambodi500 ($10.70 in chips) 
Seat 3: Pipser222 ($10 in chips) 
Seat 4: Oleg032 ($10 in chips) 
Seat 5: skakalec90 ($11.41 in chips) 
Seat 6: xiled90 ($10.03 in chips) 
Oleg032: posts small blind $0.05
skakalec90: posts big blind $0.10
PhilJahnz: sits out 
*** HOLE CARDS ***
xiled90: folds 
Zambodi500: folds 
Pipser222: folds 
Oleg032: folds 
Uncalled bet ($0.05) returned to skakalec90
skakalec90 collected $0.10 from pot
skakalec90: doesn't show hand 
*** SUMMARY ***
Total pot $0.10 | Rake $0 
Seat 1: Zambodi500 folded before Flop (didn't bet)
Seat 3: Pipser222 (button) folded before Flop (didn't bet)
Seat 4: Oleg032 (small blind) folded before Flop
Seat 5: skakalec90 (big blind) collected ($0.10)
Seat 6: xiled90 folded before Flop (didn't bet)



PokerStars Hand #222966989692:  Hold'em No Limit ($0.05/$0.10 USD) - 2021/01/23 14:40:18 ET
Table 'Merope IV' 6-max Seat #4 is the button
Seat 1: Zambodi500 ($10.70 in chips) 
Seat 3: Pipser222 ($10 in chips) 
Seat 4: Oleg032 ($10 in chips) 
Seat 5: skakalec90 ($11.46 in chips) 
Seat 6: xiled90 ($10.03 in chips) 
skakalec90: posts small blind $0.05
xiled90: posts big blind $0.10
PhilJahnz: sits out 
*** HOLE CARDS ***
Zambodi500: folds 
Pipser222: folds 
Oleg032: folds 
skakalec90: folds 
Uncalled bet ($0.05) returned to xiled90
xiled90 collected $0.10 from pot
xiled90: doesn't show hand 
*** SUMMARY ***
Total pot $0.10 | Rake $0 
Seat 1: Zambodi500 folded before Flop (didn't bet)
Seat 3: Pipser222 folded before Flop (didn't bet)
Seat 4: Oleg032 (button) folded before Flop (didn't bet)
Seat 5: skakalec90 (small blind) folded before Flop
Seat 6: xiled90 (big blind) collected ($0.10)



PokerStars Hand #222966996865:  Hold'em No Limit ($0.05/$0.10 USD) - 2021/01/23 14:40:27 ET
Table 'Merope IV' 6-max Seat #5 is the button
Seat 1: Zambodi500 ($10.70 in chips) 
Seat 3: Pipser222 ($10 in chips) 
Seat 4: Oleg032 ($10 in chips) 
Seat 5: skakalec90 ($11.41 in chips) 
Seat 6: xiled90 ($10.08 in chips) 
xiled90: posts small blind $0.05
Zambodi500: posts big blind $0.10
PhilJahnz: sits out 
*** HOLE CARDS ***
Pipser222: folds 
Oleg032: raises $0.15 to $0.25
skakalec90: folds 
xiled90: calls $0.20
Zambodi500: folds 
*** FLOP *** [8d Qd 9d]
xiled90: checks 
Oleg032: checks 
*** TURN *** [8d Qd 9d] [Js]
xiled90: checks 
Oleg032: checks 
*** RIVER *** [8d Qd 9d Js] [Tc]
xiled90: checks 
Oleg032: checks 
*** SHOW DOWN ***
xiled90: shows [3c 3s] (a straight, Eight to Queen)
Oleg032: shows [7c 7h] (a straight, Eight to Queen)
xiled90 collected $0.29 from pot
Oleg032 collected $0.28 from pot
*** SUMMARY ***
Total pot $0.60 | Rake $0.03 
Board [8d Qd 9d Js Tc]
Seat 1: Zambodi500 (big blind) folded before Flop
Seat 3: Pipser222 folded before Flop (didn't bet)
Seat 4: Oleg032 showed [7c 7h] and won ($0.28) with a straight, Eight to Queen
Seat 5: skakalec90 (button) folded before Flop (didn't bet)
Seat 6: xiled90 (small blind) showed [3c 3s] and won ($0.29) with a straight, Eight to Queen



PokerStars Hand #222967022883:  Hold'em No Limit ($0.05/$0.10 USD) - 2021/01/23 14:41:00 ET
Table 'Merope IV' 6-max Seat #6 is the button
Seat 1: Zambodi500 ($10.60 in chips) 
Seat 2: PhilJahnz ($10 in chips) 
Seat 3: Pipser222 ($10 in chips) 
Seat 4: Oleg032 ($10.03 in chips) 
Seat 5: skakalec90 ($11.41 in chips) 
Seat 6: xiled90 ($10.12 in chips) 
Zambodi500: posts small blind $0.05
PhilJahnz: posts big blind $0.10
*** HOLE CARDS ***
Pipser222: folds 
Oleg032: folds 
skakalec90: folds 
xiled90: folds 
Zambodi500: folds 
Uncalled bet ($0.05) returned to PhilJahnz
PhilJahnz collected $0.10 from pot
PhilJahnz: doesn't show hand 
*** SUMMARY ***
Total pot $0.10 | Rake $0 
Seat 1: Zambodi500 (small blind) folded before Flop
Seat 2: PhilJahnz (big blind) collected ($0.10)
Seat 3: Pipser222 folded before Flop (didn't bet)
Seat 4: Oleg032 folded before Flop (didn't bet)
Seat 5: skakalec90 folded before Flop (didn't bet)
Seat 6: xiled90 (button) folded before Flop (didn't bet)



PokerStars Hand #222967033743:  Hold'em No Limit ($0.05/$0.10 USD) - 2021/01/23 14:41:14 ET
Table 'Merope IV' 6-max Seat #1 is the button
Seat 1: Zambodi500 ($10.55 in chips) 
Seat 2: PhilJahnz ($10.05 in chips) 
Seat 3: Pipser222 ($10 in chips) 
Seat 4: Oleg032 ($10.03 in chips) 
Seat 5: skakalec90 ($11.41 in chips) 
Seat 6: xiled90 ($10.12 in chips) 
PhilJahnz: posts small blind $0.05
Pipser222: posts big blind $0.10
*** HOLE CARDS ***
Oleg032: folds 
skakalec90: folds 
xiled90: folds 
Zambodi500: raises $0.15 to $0.25
PhilJahnz: folds 
Pipser222: folds 
Uncalled bet ($0.15) returned to Zambodi500
Zambodi500 collected $0.25 from pot
*** SUMMARY ***
Total pot $0.25 | Rake $0 
Seat 1: Zambodi500 (button) collected ($0.25)
Seat 2: PhilJahnz (small blind) folded before Flop
Seat 3: Pipser222 (big blind) folded before Flop
Seat 4: Oleg032 folded before Flop (didn't bet)
Seat 5: skakalec90 folded before Flop (didn't bet)
Seat 6: xiled90 folded before Flop (didn't bet)



PokerStars Hand #222967045491:  Hold'em No Limit ($0.05/$0.10 USD) - 2021/01/23 14:41:29 ET
Table 'Merope IV' 6-max Seat #2 is the button
Seat 1: Zambodi500 ($10.70 in chips) 
Seat 2: PhilJahnz ($10 in chips) 
Seat 3: Pipser222 ($10 in chips) 
Seat 4: Oleg032 ($10.03 in chips) 
Seat 5: skakalec90 ($11.41 in chips) 
Seat 6: xiled90 ($10.12 in chips) 
Pipser222: posts small blind $0.05
Oleg032: posts big blind $0.10
*** HOLE CARDS ***
skakalec90: folds 
xiled90: folds 
Zambodi500: folds 
PhilJahnz: calls $0.10
Pipser222: folds 
Oleg032: checks 
*** FLOP *** [Js 5c 3d]
Oleg032: checks 
PhilJahnz: bets $0.20
Oleg032: folds 
Uncalled bet ($0.20) returned to PhilJahnz
PhilJahnz collected $0.24 from pot
PhilJahnz: doesn't show hand 
*** SUMMARY ***
Total pot $0.25 | Rake $0.01 
Board [Js 5c 3d]
Seat 1: Zambodi500 folded before Flop (didn't bet)
Seat 2: PhilJahnz (button) collected ($0.24)
Seat 3: Pipser222 (small blind) folded before Flop
Seat 4: Oleg032 (big blind) folded on the Flop
Seat 5: skakalec90 folded before Flop (didn't bet)
Seat 6: xiled90 folded before Flop (didn't bet)



PokerStars Hand #222967059902:  Hold'em No Limit ($0.05/$0.10 USD) - 2021/01/23 14:41:48 ET
Table 'Merope IV' 6-max Seat #3 is the button
Seat 1: Zambodi500 ($10.70 in chips) 
Seat 2: PhilJahnz ($10.14 in chips) 
Seat 3: Pipser222 ($10 in chips) 
Seat 4: Oleg032 ($10 in chips) 
Seat 5: skakalec90 ($11.41 in chips) 
Seat 6: xiled90 ($10.12 in chips) 
Oleg032: posts small blind $0.05
skakalec90: posts big blind $0.10
*** HOLE CARDS ***
xiled90: folds 
Zambodi500: folds 
PhilJahnz: folds 
Pipser222: raises $0.17 to $0.27
Oleg032: folds 
skakalec90: folds 
Uncalled bet ($0.17) returned to Pipser222
Pipser222 collected $0.25 from pot
Pipser222: doesn't show hand 
*** SUMMARY ***
Total pot $0.25 | Rake $0 
Seat 1: Zambodi500 folded before Flop (didn't bet)
Seat 2: PhilJahnz folded before Flop (didn't bet)
Seat 3: Pipser222 (button) collected ($0.25)
Seat 4: Oleg032 (small blind) folded before Flop
Seat 5: skakalec90 (big blind) folded before Flop
Seat 6: xiled90 folded before Flop (didn't bet)



PokerStars Hand #222968669332:  Hold'em No Limit ($0.05/$0.10 USD) - 2021/01/23 15:16:42 ET
Table 'Merope IV' 6-max Seat #4 is the button
Seat 1: Leandra1808 ($15.74 in chips) 
Seat 2: 0TheMouse0 ($10.10 in chips) 
Seat 3: Pipser222 ($14.63 in chips) 
Seat 4: Oleg032 ($10.46 in chips) 
Seat 5: skakalec90 ($10.82 in chips) 
Seat 6: Kaluga_Denny ($4.30 in chips) 
skakalec90: posts small blind $0.05
Kaluga_Denny: posts big blind $0.10
*** HOLE CARDS ***
Leandra1808: calls $0.10
0TheMouse0: folds 
Pipser222: folds 
Oleg032: folds 
skakalec90: folds 
Kaluga_Denny: checks 
*** FLOP *** [4c 2c 8s]
Kaluga_Denny: checks 
Leandra1808: checks 
*** TURN *** [4c 2c 8s] [2h]
Kaluga_Denny: checks 
Leandra1808: bets $1
Kaluga_Denny: folds 
Uncalled bet ($1) returned to Leandra1808
Leandra1808 collected $0.24 from pot
Leandra1808: doesn't show hand 
*** SUMMARY ***
Total pot $0.25 | Rake $0.01 
Board [4c 2c 8s 2h]
Seat 1: Leandra1808 collected ($0.24)
Seat 2: 0TheMouse0 folded before Flop (didn't bet)
Seat 3: Pipser222 folded before Flop (didn't bet)
Seat 4: Oleg032 (button) folded before Flop (didn't bet)
Seat 5: skakalec90 (small blind) folded before Flop
Seat 6: Kaluga_Denny (big blind) folded on the Turn



PokerStars Hand #222968697735:  Hold'em No Limit ($0.05/$0.10 USD) - 2021/01/23 15:17:15 ET
Table 'Merope IV' 6-max Seat #5 is the button
Seat 1: Leandra1808 ($15.88 in chips) 
Seat 2: 0TheMouse0 ($10.10 in chips) 
Seat 3: Pipser222 ($14.63 in chips) 
Seat 4: Oleg032 ($10.46 in chips) 
Seat 5: skakalec90 ($10.77 in chips) 
Seat 6: Kaluga_Denny ($4.20 in chips) 
Kaluga_Denny: posts small blind $0.05
Leandra1808: posts big blind $0.10
*** HOLE CARDS ***
0TheMouse0: folds 
Pipser222: folds 
Oleg032: folds 
skakalec90: folds 
Kaluga_Denny: folds 
Uncalled bet ($0.05) returned to Leandra1808
Leandra1808 collected $0.10 from pot
Leandra1808: doesn't show hand 
*** SUMMARY ***
Total pot $0.10 | Rake $0 
Seat 1: Leandra1808 (big blind) collected ($0.10)
Seat 2: 0TheMouse0 folded before Flop (didn't bet)
Seat 3: Pipser222 folded before Flop (didn't bet)
Seat 4: Oleg032 folded before Flop (didn't bet)
Seat 5: skakalec90 (button) folded before Flop (didn't bet)
Seat 6: Kaluga_Denny (small blind) folded before Flop



PokerStars Hand #222968704384:  Hold'em No Limit ($0.05/$0.10 USD) - 2021/01/23 15:17:23 ET
Table 'Merope IV' 6-max Seat #6 is the button
Seat 1: Leandra1808 ($15.93 in chips) 
Seat 2: 0TheMouse0 ($10.10 in chips) 
Seat 3: Pipser222 ($14.63 in chips) 
Seat 4: Oleg032 ($10.46 in chips) 
Seat 5: skakalec90 ($10.77 in chips) 
Seat 6: Kaluga_Denny ($4.15 in chips) 
Leandra1808: posts small blind $0.05
0TheMouse0: posts big blind $0.10
*** HOLE CARDS ***
Pipser222: folds 
Oleg032: folds 
skakalec90: folds 
Kaluga_Denny: folds 
Leandra1808: raises $0.10 to $0.20
0TheMouse0: folds 
Uncalled bet ($0.10) returned to Leandra1808
Leandra1808 collected $0.20 from pot
Leandra1808: doesn't show hand 
*** SUMMARY ***
Total pot $0.20 | Rake $0 
Seat 1: Leandra1808 (small blind) collected ($0.20)
Seat 2: 0TheMouse0 (big blind) folded before Flop
Seat 3: Pipser222 folded before Flop (didn't bet)
Seat 4: Oleg032 folded before Flop (didn't bet)
Seat 5: skakalec90 folded before Flop (didn't bet)
Seat 6: Kaluga_Denny (button) folded before Flop (didn't bet)



PokerStars Hand #222968717720:  Hold'em No Limit ($0.05/$0.10 USD) - 2021/01/23 15:17:39 ET
Table 'Merope IV' 6-max Seat #1 is the button
Seat 1: Leandra1808 ($16.03 in chips) 
Seat 2: 0TheMouse0 ($10 in chips) 
Seat 3: Pipser222 ($14.63 in chips) 
Seat 4: Oleg032 ($10.46 in chips) 
Seat 5: skakalec90 ($10.77 in chips) 
Seat 6: Kaluga_Denny ($4.15 in chips) 
0TheMouse0: posts small blind $0.05
Pipser222: posts big blind $0.10
*** HOLE CARDS ***
Oleg032: folds 
skakalec90: folds 
Kaluga_Denny: folds 
Leandra1808: raises $0.10 to $0.20
0TheMouse0: raises $0.70 to $0.90
Pipser222: raises $2 to $2.90
Leandra1808: folds 
0TheMouse0: folds 
Uncalled bet ($2) returned to Pipser222
Pipser222 collected $2 from pot
Pipser222: doesn't show hand 
*** SUMMARY ***
Total pot $2 | Rake $0 
Seat 1: Leandra1808 (button) folded before Flop
Seat 2: 0TheMouse0 (small blind) folded before Flop
Seat 3: Pipser222 (big blind) collected ($2)
Seat 4: Oleg032 folded before Flop (didn't bet)
Seat 5: skakalec90 folded before Flop (didn't bet)
Seat 6: Kaluga_Denny folded before Flop (didn't bet)



PokerStars Hand #222968746440:  Hold'em No Limit ($0.05/$0.10 USD) - 2021/01/23 15:18:12 ET
Table 'Merope IV' 6-max Seat #2 is the button
Seat 1: Leandra1808 ($15.83 in chips) 
Seat 2: 0TheMouse0 ($10 in chips) 
Seat 3: Pipser222 ($15.73 in chips) 
Seat 4: Oleg032 ($10.46 in chips) 
Seat 5: skakalec90 ($10.77 in chips) 
Seat 6: Kaluga_Denny ($4.15 in chips) 
Pipser222: posts small blind $0.05
Oleg032: posts big blind $0.10
*** HOLE CARDS ***
skakalec90: folds 
Kaluga_Denny: folds 
Leandra1808: calls $0.10
0TheMouse0: folds 
Pipser222: calls $0.05
Oleg032: checks 
*** FLOP *** [6s Jd 4c]
Pipser222: bets $0.10
Oleg032: folds 
Leandra1808: raises $0.49 to $0.59
Pipser222: folds 
Uncalled bet ($0.49) returned to Leandra1808
Leandra1808 collected $0.48 from pot
Leandra1808: doesn't show hand 
*** SUMMARY ***
Total pot $0.50 | Rake $0.02 
Board [6s Jd 4c]
Seat 1: Leandra1808 collected ($0.48)
Seat 2: 0TheMouse0 (button) folded before Flop (didn't bet)
Seat 3: Pipser222 (small blind) folded on the Flop
Seat 4: Oleg032 (big blind) folded on the Flop
Seat 5: skakalec90 folded before Flop (didn't bet)
Seat 6: Kaluga_Denny folded before Flop (didn't bet)



PokerStars Hand #222968772523:  Hold'em No Limit ($0.05/$0.10 USD) - 2021/01/23 15:18:43 ET
Table 'Merope IV' 6-max Seat #3 is the button
Seat 1: Leandra1808 ($16.11 in chips) 
Seat 2: 0TheMouse0 ($10 in chips) 
Seat 3: Pipser222 ($15.53 in chips) 
Seat 4: Oleg032 ($10.36 in chips) 
Seat 5: skakalec90 ($10.77 in chips) 
Seat 6: Kaluga_Denny ($4.15 in chips) 
Oleg032: posts small blind $0.05
skakalec90: posts big blind $0.10
*** HOLE CARDS ***
Kaluga_Denny: folds 
Leandra1808: folds 
0TheMouse0: folds 
Pipser222: raises $0.17 to $0.27
Oleg032: folds 
skakalec90: folds 
Uncalled bet ($0.17) returned to Pipser222
Pipser222 collected $0.25 from pot
Pipser222: doesn't show hand 
*** SUMMARY ***
Total pot $0.25 | Rake $0 
Seat 1: Leandra1808 folded before Flop (didn't bet)
Seat 2: 0TheMouse0 folded before Flop (didn't bet)
Seat 3: Pipser222 (button) collected ($0.25)
Seat 4: Oleg032 (small blind) folded before Flop
Seat 5: skakalec90 (big blind) folded before Flop
Seat 6: Kaluga_Denny folded before Flop (didn't bet)



PokerStars Hand #222968793071:  Hold'em No Limit ($0.05/$0.10 USD) - 2021/01/23 15:19:07 ET
Table 'Merope IV' 6-max Seat #4 is the button
Seat 1: Leandra1808 ($16.11 in chips) 
Seat 2: 0TheMouse0 ($10 in chips) 
Seat 3: Pipser222 ($15.68 in chips) 
Seat 4: Oleg032 ($10.31 in chips) 
Seat 5: skakalec90 ($10.67 in chips) 
Seat 6: Kaluga_Denny ($4.15 in chips) 
skakalec90: posts small blind $0.05
Kaluga_Denny: posts big blind $0.10
*** HOLE CARDS ***
Leandra1808: calls $0.10
0TheMouse0: folds 
Pipser222: folds 
Oleg032: folds 
skakalec90: folds 
Kaluga_Denny: checks 
*** FLOP *** [Jd Qd 8s]
Kaluga_Denny: checks 
Leandra1808: checks 
*** TURN *** [Jd Qd 8s] [3d]
Kaluga_Denny: bets $0.10
Leandra1808: calls $0.10
*** RIVER *** [Jd Qd 8s 3d] [9s]
Kaluga_Denny: checks 
Leandra1808: checks 
*** SHOW DOWN ***
Kaluga_Denny: shows [Qh Js] (two pair, Queens and Jacks)
Leandra1808: mucks hand 
Kaluga_Denny collected $0.43 from pot
*** SUMMARY ***
Total pot $0.45 | Rake $0.02 
Board [Jd Qd 8s 3d 9s]
Seat 1: Leandra1808 mucked
Seat 2: 0TheMouse0 folded before Flop (didn't bet)
Seat 3: Pipser222 folded before Flop (didn't bet)
Seat 4: Oleg032 (button) folded before Flop (didn't bet)
Seat 5: skakalec90 (small blind) folded before Flop
Seat 6: Kaluga_Denny (big blind) showed [Qh Js] and won ($0.43) with two pair, Queens and Jacks



PokerStars Hand #222968812687:  Hold'em No Limit ($0.05/$0.10 USD) - 2021/01/23 15:19:30 ET
Table 'Merope IV' 6-max Seat #5 is the button
Seat 1: Leandra1808 ($15.91 in chips) 
Seat 2: 0TheMouse0 ($10 in chips) 
Seat 3: Pipser222 ($15.68 in chips) 
Seat 4: Oleg032 ($10.31 in chips) 
Seat 5: skakalec90 ($10.62 in chips) 
Seat 6: Kaluga_Denny ($4.38 in chips) 
Kaluga_Denny: posts small blind $0.05
Leandra1808: posts big blind $0.10
*** HOLE CARDS ***
0TheMouse0: folds 
Pipser222: raises $0.17 to $0.27
Oleg032: folds 
skakalec90: folds 
Kaluga_Denny: folds 
Leandra1808: raises $0.83 to $1.10
Pipser222: folds 
Uncalled bet ($0.83) returned to Leandra1808
Leandra1808 collected $0.59 from pot
Leandra1808: doesn't show hand 
*** SUMMARY ***
Total pot $0.59 | Rake $0 
Seat 1: Leandra1808 (big blind) collected ($0.59)
Seat 2: 0TheMouse0 folded before Flop (didn't bet)
Seat 3: Pipser222 folded before Flop
Seat 4: Oleg032 folded before Flop (didn't bet)
Seat 5: skakalec90 (button) folded before Flop (didn't bet)
Seat 6: Kaluga_Denny (small blind) folded before Flop



PokerStars Hand #222968837219:  Hold'em No Limit ($0.05/$0.10 USD) - 2021/01/23 15:19:59 ET
Table 'Merope IV' 6-max Seat #6 is the button
Seat 1: Leandra1808 ($16.23 in chips) 
Seat 2: 0TheMouse0 ($10 in chips) 
Seat 3: Pipser222 ($15.41 in chips) 
Seat 4: Oleg032 ($10.31 in chips) 
Seat 5: skakalec90 ($10.62 in chips) 
Seat 6: Kaluga_Denny ($4.33 in chips) 
Leandra1808: posts small blind $0.05
0TheMouse0: posts big blind $0.10
*** HOLE CARDS ***
Pipser222: folds 
Oleg032: folds 
skakalec90: folds 
Kaluga_Denny: folds 
Leandra1808: raises $0.10 to $0.20
0TheMouse0: folds 
Uncalled bet ($0.10) returned to Leandra1808
Leandra1808 collected $0.20 from pot
Leandra1808: doesn't show hand 
*** SUMMARY ***
Total pot $0.20 | Rake $0 
Seat 1: Leandra1808 (small blind) collected ($0.20)
Seat 2: 0TheMouse0 (big blind) folded before Flop
Seat 3: Pipser222 folded before Flop (didn't bet)
Seat 4: Oleg032 folded before Flop (didn't bet)
Seat 5: skakalec90 folded before Flop (didn't bet)
Seat 6: Kaluga_Denny (button) folded before Flop (didn't bet)



PokerStars Hand #222968848671:  Hold'em No Limit ($0.05/$0.10 USD) - 2021/01/23 15:20:12 ET
Table 'Merope IV' 6-max Seat #1 is the button
Seat 1: Leandra1808 ($16.33 in chips) 
Seat 2: 0TheMouse0 ($10 in chips) 
Seat 3: Pipser222 ($15.41 in chips) 
Seat 4: Oleg032 ($10.31 in chips) 
Seat 5: skakalec90 ($10.62 in chips) 
Seat 6: Kaluga_Denny ($4.33 in chips) 
0TheMouse0: posts small blind $0.05
Pipser222: posts big blind $0.10
*** HOLE CARDS ***
Oleg032: folds 
skakalec90: raises $0.20 to $0.30
Kaluga_Denny: folds 
Leandra1808: folds 
0TheMouse0: folds 
Pipser222: folds 
Uncalled bet ($0.20) returned to skakalec90
skakalec90 collected $0.25 from pot
skakalec90: doesn't show hand 
*** SUMMARY ***
Total pot $0.25 | Rake $0 
Seat 1: Leandra1808 (button) folded before Flop (didn't bet)
Seat 2: 0TheMouse0 (small blind) folded before Flop
Seat 3: Pipser222 (big blind) folded before Flop
Seat 4: Oleg032 folded before Flop (didn't bet)
Seat 5: skakalec90 collected ($0.25)
Seat 6: Kaluga_Denny folded before Flop (didn't bet)



PokerStars Hand #222968863584:  Hold'em No Limit ($0.05/$0.10 USD) - 2021/01/23 15:20:29 ET
Table 'Merope IV' 6-max Seat #2 is the button
Seat 1: Leandra1808 ($16.33 in chips) 
Seat 2: 0TheMouse0 ($10 in chips) 
Seat 3: Pipser222 ($15.31 in chips) 
Seat 4: Oleg032 ($10.31 in chips) 
Seat 5: skakalec90 ($10.77 in chips) 
Seat 6: Kaluga_Denny ($4.33 in chips) 
Pipser222: posts small blind $0.05
Oleg032: posts big blind $0.10
*** HOLE CARDS ***
skakalec90: folds 
Kaluga_Denny: calls $0.10
Leandra1808: raises $0.20 to $0.30
0TheMouse0: raises $0.95 to $1.25
Pipser222: folds 
Oleg032: folds 
Kaluga_Denny: folds 
Leandra1808: calls $0.95
*** FLOP *** [4h 8s Jd]
Leandra1808: checks 
0TheMouse0: bets $1.32
Leandra1808: folds 
Uncalled bet ($1.32) returned to 0TheMouse0
0TheMouse0 collected $2.63 from pot
0TheMouse0: doesn't show hand 
*** SUMMARY ***
Total pot $2.75 | Rake $0.12 
Board [4h 8s Jd]
Seat 1: Leandra1808 folded on the Flop
Seat 2: 0TheMouse0 (button) collected ($2.63)
Seat 3: Pipser222 (small blind) folded before Flop
Seat 4: Oleg032 (big blind) folded before Flop
Seat 5: skakalec90 folded before Flop (didn't bet)
Seat 6: Kaluga_Denny folded before Flop



PokerStars Hand #222968898438:  Hold'em No Limit ($0.05/$0.10 USD) - 2021/01/23 15:21:10 ET
Table 'Merope IV' 6-max Seat #3 is the button
Seat 1: Leandra1808 ($15.08 in chips) 
Seat 2: 0TheMouse0 ($11.38 in chips) 
Seat 3: Pipser222 ($15.26 in chips) 
Seat 4: Oleg032 ($10.21 in chips) 
Seat 5: skakalec90 ($10.77 in chips) 
Seat 6: Kaluga_Denny ($4.23 in chips) 
Oleg032: posts small blind $0.05
skakalec90: posts big blind $0.10
*** HOLE CARDS ***
Kaluga_Denny: folds 
Leandra1808: calls $0.10
0TheMouse0: raises $0.35 to $0.45
Pipser222: folds 
Oleg032: calls $0.40
skakalec90: folds 
Leandra1808: calls $0.35
*** FLOP *** [3c 7c 5h]
Oleg032: checks 
Leandra1808: bets $1.38
0TheMouse0: folds 
Oleg032: calls $1.38
*** TURN *** [3c 7c 5h] [Ad]
Oleg032: checks 
Leandra1808: checks 
*** RIVER *** [3c 7c 5h Ad] [5s]
Oleg032: checks 
Leandra1808: checks 
*** SHOW DOWN ***
Oleg032: shows [6s 6h] (two pair, Sixes and Fives)
Leandra1808: mucks hand 
Oleg032 collected $4.02 from pot
*** SUMMARY ***
Total pot $4.21 | Rake $0.19 
Board [3c 7c 5h Ad 5s]
Seat 1: Leandra1808 mucked
Seat 2: 0TheMouse0 folded on the Flop
Seat 3: Pipser222 (button) folded before Flop (didn't bet)
Seat 4: Oleg032 (small blind) showed [6s 6h] and won ($4.02) with two pair, Sixes and Fives
Seat 5: skakalec90 (big blind) folded before Flop
Seat 6: Kaluga_Denny folded before Flop (didn't bet)



PokerStars Hand #222968944582:  Hold'em No Limit ($0.05/$0.10 USD) - 2021/01/23 15:22:03 ET
Table 'Merope IV' 6-max Seat #4 is the button
Seat 1: Leandra1808 ($13.25 in chips) 
Seat 2: 0TheMouse0 ($10.93 in chips) 
Seat 3: Pipser222 ($15.26 in chips) 
Seat 4: Oleg032 ($12.40 in chips) 
Seat 5: skakalec90 ($10.67 in chips) 
Seat 6: Kaluga_Denny ($4.23 in chips) 
skakalec90: posts small blind $0.05
Kaluga_Denny: posts big blind $0.10
*** HOLE CARDS ***
Leandra1808: raises $0.20 to $0.30
0TheMouse0: folds 
Pipser222: folds 
Oleg032: folds 
skakalec90: folds 
Kaluga_Denny: folds 
Uncalled bet ($0.20) returned to Leandra1808
Leandra1808 collected $0.25 from pot
Leandra1808: doesn't show hand 
*** SUMMARY ***
Total pot $0.25 | Rake $0 
Seat 1: Leandra1808 collected ($0.25)
Seat 2: 0TheMouse0 folded before Flop (didn't bet)
Seat 3: Pipser222 folded before Flop (didn't bet)
Seat 4: Oleg032 (button) folded before Flop (didn't bet)
Seat 5: skakalec90 (small blind) folded before Flop
Seat 6: Kaluga_Denny (big blind) folded before Flop



PokerStars Hand #222967074835:  Hold'em No Limit ($0.05/$0.10 USD) - 2021/01/23 14:42:07 ET
Table 'Merope IV' 6-max Seat #4 is the button
Seat 1: Zambodi500 ($10.70 in chips) 
Seat 2: PhilJahnz ($10.14 in chips) 
Seat 3: Pipser222 ($10.15 in chips) 
Seat 4: Oleg032 ($10 in chips) 
Seat 5: skakalec90 ($11.31 in chips) 
Seat 6: xiled90 ($10.12 in chips) 
skakalec90: posts small blind $0.05
xiled90: posts big blind $0.10
*** HOLE CARDS ***
Zambodi500: folds 
PhilJahnz: calls $0.10
Pipser222: folds 
Oleg032: raises $0.15 to $0.25
skakalec90: folds 
xiled90: folds 
PhilJahnz: calls $0.15
*** FLOP *** [2c 5s 8h]
PhilJahnz: bets $0.30
Oleg032: calls $0.30
*** TURN *** [2c 5s 8h] [Th]
PhilJahnz: checks 
Oleg032: checks 
*** RIVER *** [2c 5s 8h Th] [5h]
PhilJahnz: checks 
Oleg032: checks 
*** SHOW DOWN ***
PhilJahnz: shows [Qd 8d] (two pair, Eights and Fives)
Oleg032: mucks hand 
PhilJahnz collected $1.19 from pot
*** SUMMARY ***
Total pot $1.25 | Rake $0.06 
Board [2c 5s 8h Th 5h]
Seat 1: Zambodi500 folded before Flop (didn't bet)
Seat 2: PhilJahnz showed [Qd 8d] and won ($1.19) with two pair, Eights and Fives
Seat 3: Pipser222 folded before Flop (didn't bet)
Seat 4: Oleg032 (button) mucked
Seat 5: skakalec90 (small blind) folded before Flop
Seat 6: xiled90 (big blind) folded before Flop



PokerStars Hand #222967104662:  Hold'em No Limit ($0.05/$0.10 USD) - 2021/01/23 14:42:45 ET
Table 'Merope IV' 6-max Seat #5 is the button
Seat 1: Zambodi500 ($10.70 in chips) 
Seat 2: PhilJahnz ($10.78 in chips) 
Seat 3: Pipser222 ($10.15 in chips) 
Seat 4: Oleg032 ($10 in chips) 
Seat 5: skakalec90 ($11.26 in chips) 
Seat 6: xiled90 ($10.02 in chips) 
xiled90: posts small blind $0.05
Zambodi500: posts big blind $0.10
*** HOLE CARDS ***
PhilJahnz: folds 
Pipser222: folds 
Oleg032: folds 
skakalec90: folds 
xiled90: folds 
Uncalled bet ($0.05) returned to Zambodi500
Zambodi500 collected $0.10 from pot
*** SUMMARY ***
Total pot $0.10 | Rake $0 
Seat 1: Zambodi500 (big blind) collected ($0.10)
Seat 2: PhilJahnz folded before Flop (didn't bet)
Seat 3: Pipser222 folded before Flop (didn't bet)
Seat 4: Oleg032 folded before Flop (didn't bet)
Seat 5: skakalec90 (button) folded before Flop (didn't bet)
Seat 6: xiled90 (small blind) folded before Flop



PokerStars Hand #222967112507:  Hold'em No Limit ($0.05/$0.10 USD) - 2021/01/23 14:42:55 ET
Table 'Merope IV' 6-max Seat #6 is the button
Seat 1: Zambodi500 ($10.75 in chips) 
Seat 2: PhilJahnz ($10.78 in chips) 
Seat 3: Pipser222 ($10.15 in chips) 
Seat 4: Oleg032 ($10 in chips) 
Seat 5: skakalec90 ($11.26 in chips) 
Seat 6: xiled90 ($10 in chips) 
Zambodi500: posts small blind $0.05
PhilJahnz: posts big blind $0.10
*** HOLE CARDS ***
Pipser222: raises $0.17 to $0.27
Oleg032: folds 
skakalec90: folds 
xiled90: folds 
Zambodi500: folds 
PhilJahnz: folds 
Uncalled bet ($0.17) returned to Pipser222
Pipser222 collected $0.25 from pot
Pipser222: doesn't show hand 
*** SUMMARY ***
Total pot $0.25 | Rake $0 
Seat 1: Zambodi500 (small blind) folded before Flop
Seat 2: PhilJahnz (big blind) folded before Flop
Seat 3: Pipser222 collected ($0.25)
Seat 4: Oleg032 folded before Flop (didn't bet)
Seat 5: skakalec90 folded before Flop (didn't bet)
Seat 6: xiled90 (button) folded before Flop (didn't bet)



PokerStars Hand #222967124730:  Hold'em No Limit ($0.05/$0.10 USD) - 2021/01/23 14:43:11 ET
Table 'Merope IV' 6-max Seat #1 is the button
Seat 1: Zambodi500 ($10.70 in chips) 
Seat 2: PhilJahnz ($10.68 in chips) 
Seat 3: Pipser222 ($10.30 in chips) 
Seat 4: Oleg032 ($10 in chips) 
Seat 5: skakalec90 ($11.26 in chips) 
Seat 6: xiled90 ($10 in chips) 
PhilJahnz: posts small blind $0.05
Pipser222: posts big blind $0.10
*** HOLE CARDS ***
Oleg032: folds 
skakalec90: raises $0.20 to $0.30
xiled90: folds 
Zambodi500: raises $0.60 to $0.90
PhilJahnz: folds 
Pipser222: folds 
skakalec90: calls $0.60
*** FLOP *** [9h 2s 6h]
skakalec90: checks 
Zambodi500: bets $1.02
skakalec90: folds 
Uncalled bet ($1.02) returned to Zambodi500
Zambodi500 collected $1.86 from pot
*** SUMMARY ***
Total pot $1.95 | Rake $0.09 
Board [9h 2s 6h]
Seat 1: Zambodi500 (button) collected ($1.86)
Seat 2: PhilJahnz (small blind) folded before Flop
Seat 3: Pipser222 (big blind) folded before Flop
Seat 4: Oleg032 folded before Flop (didn't bet)
Seat 5: skakalec90 folded on the Flop
Seat 6: xiled90 folded before Flop (didn't bet)



PokerStars Hand #222967143085:  Hold'em No Limit ($0.05/$0.10 USD) - 2021/01/23 14:43:34 ET
Table 'Merope IV' 6-max Seat #2 is the button
Seat 1: Zambodi500 ($11.66 in chips) 
Seat 2: PhilJahnz ($10.63 in chips) 
Seat 3: Pipser222 ($10.20 in chips) 
Seat 4: Oleg032 ($10 in chips) 
Seat 5: skakalec90 ($10.36 in chips) 
Seat 6: xiled90 ($10 in chips) 
Pipser222: posts small blind $0.05
Oleg032: posts big blind $0.10
*** HOLE CARDS ***
skakalec90: folds 
xiled90: folds 
Zambodi500: raises $0.15 to $0.25
PhilJahnz: calls $0.25
Pipser222: folds 
Oleg032: folds 
*** FLOP *** [4s 3s 2d]
Zambodi500: bets $0.34
PhilJahnz: raises $0.34 to $0.68
Zambodi500: folds 
Uncalled bet ($0.34) returned to PhilJahnz
PhilJahnz collected $1.27 from pot
PhilJahnz: doesn't show hand 
*** SUMMARY ***
Total pot $1.33 | Rake $0.06 
Board [4s 3s 2d]
Seat 1: Zambodi500 folded on the Flop
Seat 2: PhilJahnz (button) collected ($1.27)
Seat 3: Pipser222 (small blind) folded before Flop
Seat 4: Oleg032 (big blind) folded before Flop
Seat 5: skakalec90 folded before Flop (didn't bet)
Seat 6: xiled90 folded before Flop (didn't bet)



PokerStars Hand #222967173376:  Hold'em No Limit ($0.05/$0.10 USD) - 2021/01/23 14:44:13 ET
Table 'Merope IV' 6-max Seat #3 is the button
Seat 1: Zambodi500 ($11.07 in chips) 
Seat 2: PhilJahnz ($11.31 in chips) 
Seat 3: Pipser222 ($10.15 in chips) 
Seat 4: Oleg032 ($10 in chips) 
Seat 5: skakalec90 ($10.36 in chips) 
Seat 6: xiled90 ($10 in chips) 
Oleg032: posts small blind $0.05
skakalec90: posts big blind $0.10
*** HOLE CARDS ***
xiled90: folds 
Zambodi500: folds 
PhilJahnz: folds 
Pipser222: folds 
Oleg032: raises $0.20 to $0.30
skakalec90: folds 
Uncalled bet ($0.20) returned to Oleg032
Oleg032 collected $0.20 from pot
PhilJahnz leaves the table
Oleg032: doesn't show hand 
*** SUMMARY ***
Total pot $0.20 | Rake $0 
Seat 1: Zambodi500 folded before Flop (didn't bet)
Seat 2: PhilJahnz folded before Flop (didn't bet)
Seat 3: Pipser222 (button) folded before Flop (didn't bet)
Seat 4: Oleg032 (small blind) collected ($0.20)
Seat 5: skakalec90 (big blind) folded before Flop
Seat 6: xiled90 folded before Flop (didn't bet)



PokerStars Hand #222967183108:  Hold'em No Limit ($0.05/$0.10 USD) - 2021/01/23 14:44:25 ET
Table 'Merope IV' 6-max Seat #4 is the button
Seat 1: Zambodi500 ($11.07 in chips) 
Seat 3: Pipser222 ($10.15 in chips) 
Seat 4: Oleg032 ($10.10 in chips) 
Seat 5: skakalec90 ($10.26 in chips) 
Seat 6: xiled90 ($10 in chips) 
skakalec90: posts small blind $0.05
xiled90: posts big blind $0.10
*** HOLE CARDS ***
0TheMouse0 joins the table at seat #2 
Zambodi500: folds 
Pipser222: folds 
Oleg032: folds 
skakalec90: raises $0.10 to $0.20
xiled90: folds 
Uncalled bet ($0.10) returned to skakalec90
skakalec90 collected $0.20 from pot
skakalec90: doesn't show hand 
*** SUMMARY ***
Total pot $0.20 | Rake $0 
Seat 1: Zambodi500 folded before Flop (didn't bet)
Seat 3: Pipser222 folded before Flop (didn't bet)
Seat 4: Oleg032 (button) folded before Flop (didn't bet)
Seat 5: skakalec90 (small blind) collected ($0.20)
Seat 6: xiled90 (big blind) folded before Flop



PokerStars Hand #222967195272:  Hold'em No Limit ($0.05/$0.10 USD) - 2021/01/23 14:44:41 ET
Table 'Merope IV' 6-max Seat #5 is the button
Seat 1: Zambodi500 ($11.07 in chips) 
Seat 3: Pipser222 ($10.15 in chips) 
Seat 4: Oleg032 ($10.10 in chips) 
Seat 5: skakalec90 ($10.36 in chips) 
Seat 6: xiled90 ($10 in chips) 
xiled90: posts small blind $0.05
Zambodi500: posts big blind $0.10
0TheMouse0: sits out 
*** HOLE CARDS ***
Pipser222: folds 
Oleg032: raises $0.15 to $0.25
skakalec90: folds 
xiled90: folds 
Zambodi500: folds 
Uncalled bet ($0.15) returned to Oleg032
Oleg032 collected $0.25 from pot
Oleg032: doesn't show hand 
*** SUMMARY ***
Total pot $0.25 | Rake $0 
Seat 1: Zambodi500 (big blind) folded before Flop
Seat 3: Pipser222 folded before Flop (didn't bet)
Seat 4: Oleg032 collected ($0.25)
Seat 5: skakalec90 (button) folded before Flop (didn't bet)
Seat 6: xiled90 (small blind) folded before Flop



PokerStars Hand #222967205577:  Hold'em No Limit ($0.05/$0.10 USD) - 2021/01/23 14:44:54 ET
Table 'Merope IV' 6-max Seat #6 is the button
Seat 1: Zambodi500 ($10.97 in chips) 
Seat 2: 0TheMouse0 ($10 in chips) 
Seat 3: Pipser222 ($10.15 in chips) 
Seat 4: Oleg032 ($10.25 in chips) 
Seat 5: skakalec90 ($10.36 in chips) 
Seat 6: xiled90 ($10 in chips) 
Zambodi500: posts small blind $0.05
0TheMouse0: posts big blind $0.10
*** HOLE CARDS ***
Pipser222: folds 
Oleg032: raises $0.15 to $0.25
skakalec90: folds 
xiled90: folds 
Zambodi500: folds 
0TheMouse0: folds 
Uncalled bet ($0.15) returned to Oleg032
Oleg032 collected $0.25 from pot
Oleg032: doesn't show hand 
*** SUMMARY ***
Total pot $0.25 | Rake $0 
Seat 1: Zambodi500 (small blind) folded before Flop
Seat 2: 0TheMouse0 (big blind) folded before Flop
Seat 3: Pipser222 folded before Flop (didn't bet)
Seat 4: Oleg032 collected ($0.25)
Seat 5: skakalec90 folded before Flop (didn't bet)
Seat 6: xiled90 (button) folded before Flop (didn't bet)



PokerStars Hand #222967223083:  Hold'em No Limit ($0.05/$0.10 USD) - 2021/01/23 14:45:16 ET
Table 'Merope IV' 6-max Seat #1 is the button
Seat 1: Zambodi500 ($10.92 in chips) 
Seat 2: 0TheMouse0 ($10 in chips) 
Seat 3: Pipser222 ($10.15 in chips) 
Seat 4: Oleg032 ($10.40 in chips) 
Seat 5: skakalec90 ($10.36 in chips) 
Seat 6: xiled90 ($10 in chips) 
0TheMouse0: posts small blind $0.05
Pipser222: posts big blind $0.10
*** HOLE CARDS ***
Oleg032: raises $0.15 to $0.25
skakalec90: folds 
xiled90: folds 
Zambodi500: folds 
0TheMouse0: folds 
Pipser222: folds 
Uncalled bet ($0.15) returned to Oleg032
Oleg032 collected $0.25 from pot
Oleg032: doesn't show hand 
*** SUMMARY ***
Total pot $0.25 | Rake $0 
Seat 1: Zambodi500 (button) folded before Flop (didn't bet)
Seat 2: 0TheMouse0 (small blind) folded before Flop
Seat 3: Pipser222 (big blind) folded before Flop
Seat 4: Oleg032 collected ($0.25)
Seat 5: skakalec90 folded before Flop (didn't bet)
Seat 6: xiled90 folded before Flop (didn't bet)



PokerStars Hand #222967232057:  Hold'em No Limit ($0.05/$0.10 USD) - 2021/01/23 14:45:28 ET
Table 'Merope IV' 6-max Seat #2 is the button
Seat 1: Zambodi500 ($10.92 in chips) 
Seat 2: 0TheMouse0 ($10 in chips) 
Seat 3: Pipser222 ($10.05 in chips) 
Seat 4: Oleg032 ($10.55 in chips) 
Seat 5: skakalec90 ($10.36 in chips) 
Seat 6: xiled90 ($10 in chips) 
Pipser222: posts small blind $0.05
Oleg032: posts big blind $0.10
*** HOLE CARDS ***
skakalec90: folds 
xiled90: folds 
Zambodi500: folds 
0TheMouse0: folds 
Pipser222: raises $0.17 to $0.27
Oleg032: raises $0.63 to $0.90
Pipser222: folds 
Uncalled bet ($0.63) returned to Oleg032
Oleg032 collected $0.54 from pot
Oleg032: doesn't show hand 
*** SUMMARY ***
Total pot $0.54 | Rake $0 
Seat 1: Zambodi500 folded before Flop (didn't bet)
Seat 2: 0TheMouse0 (button) folded before Flop (didn't bet)
Seat 3: Pipser222 (small blind) folded before Flop
Seat 4: Oleg032 (big blind) collected ($0.54)
Seat 5: skakalec90 folded before Flop (didn't bet)
Seat 6: xiled90 folded before Flop (didn't bet)



PokerStars Hand #222967257803:  Hold'em No Limit ($0.05/$0.10 USD) - 2021/01/23 14:46:01 ET
Table 'Merope IV' 6-max Seat #3 is the button
Seat 1: Zambodi500 ($10.92 in chips) 
Seat 2: 0TheMouse0 ($10 in chips) 
Seat 3: Pipser222 ($10 in chips) 
Seat 4: Oleg032 ($10.82 in chips) 
Seat 5: skakalec90 ($10.36 in chips) 
Seat 6: xiled90 ($10 in chips) 
Oleg032: posts small blind $0.05
skakalec90: posts big blind $0.10
*** HOLE CARDS ***
xiled90: raises $0.20 to $0.30
Zambodi500: folds 
0TheMouse0: folds 
Pipser222: folds 
Oleg032: raises $0.70 to $1
skakalec90: folds 
xiled90: folds 
Uncalled bet ($0.70) returned to Oleg032
Oleg032 collected $0.70 from pot
Oleg032: doesn't show hand 
*** SUMMARY ***
Total pot $0.70 | Rake $0 
Seat 1: Zambodi500 folded before Flop (didn't bet)
Seat 2: 0TheMouse0 folded before Flop (didn't bet)
Seat 3: Pipser222 (button) folded before Flop (didn't bet)
Seat 4: Oleg032 (small blind) collected ($0.70)
Seat 5: skakalec90 (big blind) folded before Flop
Seat 6: xiled90 folded before Flop



PokerStars Hand #222967273533:  Hold'em No Limit ($0.05/$0.10 USD) - 2021/01/23 14:46:22 ET
Table 'Merope IV' 6-max Seat #4 is the button
Seat 1: Zambodi500 ($10.92 in chips) 
Seat 2: 0TheMouse0 ($10 in chips) 
Seat 3: Pipser222 ($10 in chips) 
Seat 4: Oleg032 ($11.22 in chips) 
Seat 5: skakalec90 ($10.26 in chips) 
skakalec90: posts small blind $0.05
xiled90: is sitting out 
Zambodi500: posts big blind $0.10
*** HOLE CARDS ***
xiled90 leaves the table
0TheMouse0: folds 
Pipser222: folds 
Oleg032: raises $0.15 to $0.25
skakalec90: folds 
Zambodi500: folds 
Uncalled bet ($0.15) returned to Oleg032
Oleg032 collected $0.25 from pot
Oleg032: doesn't show hand 
*** SUMMARY ***
Total pot $0.25 | Rake $0 
Seat 1: Zambodi500 (big blind) folded before Flop
Seat 2: 0TheMouse0 folded before Flop (didn't bet)
Seat 3: Pipser222 folded before Flop (didn't bet)
Seat 4: Oleg032 (button) collected ($0.25)
Seat 5: skakalec90 (small blind) folded before Flop



PokerStars Hand #222967287032:  Hold'em No Limit ($0.05/$0.10 USD) - 2021/01/23 14:46:39 ET
Table 'Merope IV' 6-max Seat #5 is the button
Seat 1: Zambodi500 ($10.82 in chips) 
Seat 2: 0TheMouse0 ($10 in chips) 
Seat 3: Pipser222 ($10 in chips) 
Seat 4: Oleg032 ($11.37 in chips) 
Seat 5: skakalec90 ($10.21 in chips) 
Zambodi500: posts small blind $0.05
0TheMouse0: posts big blind $0.10
*** HOLE CARDS ***
Pipser222: folds 
Oleg032: folds 
skakalec90: raises $0.10 to $0.20
alex-zacapa joins the table at seat #6 
Zambodi500: raises $0.60 to $0.80
0TheMouse0: folds 
skakalec90: folds 
Uncalled bet ($0.60) returned to Zambodi500
Zambodi500 collected $0.50 from pot
*** SUMMARY ***
Total pot $0.50 | Rake $0 
Seat 1: Zambodi500 (small blind) collected ($0.50)
Seat 2: 0TheMouse0 (big blind) folded before Flop
Seat 3: Pipser222 folded before Flop (didn't bet)
Seat 4: Oleg032 folded before Flop (didn't bet)
Seat 5: skakalec90 (button) folded before Flop



PokerStars Hand #222967309222:  Hold'em No Limit ($0.05/$0.10 USD) - 2021/01/23 14:47:08 ET
Table 'Merope IV' 6-max Seat #1 is the button
Seat 1: Zambodi500 ($11.12 in chips) 
Seat 2: 0TheMouse0 ($10 in chips) 
Seat 3: Pipser222 ($10 in chips) 
Seat 4: Oleg032 ($11.37 in chips) 
Seat 5: skakalec90 ($10.01 in chips) 
0TheMouse0: posts small blind $0.05
Pipser222: posts big blind $0.10
alex-zacapa: sits out 
*** HOLE CARDS ***
Oleg032: folds 
skakalec90: raises $0.20 to $0.30
Zambodi500: folds 
0TheMouse0: folds 
Pipser222: calls $0.20
*** FLOP *** [9d 6h Jc]
Pipser222: bets $0.40
skakalec90: folds 
Uncalled bet ($0.40) returned to Pipser222
Pipser222 collected $0.62 from pot
Pipser222: doesn't show hand 
*** SUMMARY ***
Total pot $0.65 | Rake $0.03 
Board [9d 6h Jc]
Seat 1: Zambodi500 (button) folded before Flop (didn't bet)
Seat 2: 0TheMouse0 (small blind) folded before Flop
Seat 3: Pipser222 (big blind) collected ($0.62)
Seat 4: Oleg032 folded before Flop (didn't bet)
Seat 5: skakalec90 folded on the Flop



PokerStars Hand #222967327549:  Hold'em No Limit ($0.05/$0.10 USD) - 2021/01/23 14:47:31 ET
Table 'Merope IV' 6-max Seat #2 is the button
Seat 1: Zambodi500 ($11.12 in chips) 
Seat 2: 0TheMouse0 ($10 in chips) 
Seat 3: Pipser222 ($10.32 in chips) 
Seat 4: Oleg032 ($11.37 in chips) 
Seat 5: skakalec90 ($10 in chips) 
Pipser222: posts small blind $0.05
Oleg032: posts big blind $0.10
alex-zacapa: sits out 
*** HOLE CARDS ***
skakalec90: raises $0.20 to $0.30
Zambodi500: folds 
0TheMouse0: folds 
Pipser222: calls $0.25
Oleg032: folds 
*** FLOP *** [Kc Tc 3c]
Pipser222: checks 
skakalec90: checks 
*** TURN *** [Kc Tc 3c] [9c]
Pipser222: checks 
skakalec90: checks 
*** RIVER *** [Kc Tc 3c 9c] [Ac]
Pipser222: checks 
skakalec90: checks 
*** SHOW DOWN ***
Pipser222: shows [7s 7h] (a flush, Ace high)
skakalec90: shows [5s As] (a flush, Ace high)
Pipser222 collected $0.34 from pot
skakalec90 collected $0.33 from pot
*** SUMMARY ***
Total pot $0.70 | Rake $0.03 
Board [Kc Tc 3c 9c Ac]
Seat 1: Zambodi500 folded before Flop (didn't bet)
Seat 2: 0TheMouse0 (button) folded before Flop (didn't bet)
Seat 3: Pipser222 (small blind) showed [7s 7h] and won ($0.34) with a flush, Ace high
Seat 4: Oleg032 (big blind) folded before Flop
Seat 5: skakalec90 showed [5s As] and won ($0.33) with a flush, Ace high



PokerStars Hand #222967353207:  Hold'em No Limit ($0.05/$0.10 USD) - 2021/01/23 14:48:04 ET
Table 'Merope IV' 6-max Seat #3 is the button
Seat 1: Zambodi500 ($11.12 in chips) 
Seat 2: 0TheMouse0 ($10 in chips) 
Seat 3: Pipser222 ($10.36 in chips) 
Seat 4: Oleg032 ($11.27 in chips) 
Seat 5: skakalec90 ($10.03 in chips) 
Oleg032: posts small blind $0.05
skakalec90: posts big blind $0.10
alex-zacapa: sits out 
*** HOLE CARDS ***
Zambodi500: folds 
0TheMouse0: raises $0.15 to $0.25
Pipser222: folds 
Oleg032: folds 
skakalec90: calls $0.15
*** FLOP *** [Kd Ks 8s]
skakalec90: checks 
0TheMouse0: bets $0.17
skakalec90: folds 
Uncalled bet ($0.17) returned to 0TheMouse0
0TheMouse0 collected $0.53 from pot
0TheMouse0: doesn't show hand 
*** SUMMARY ***
Total pot $0.55 | Rake $0.02 
Board [Kd Ks 8s]
Seat 1: Zambodi500 folded before Flop (didn't bet)
Seat 2: 0TheMouse0 collected ($0.53)
Seat 3: Pipser222 (button) folded before Flop (didn't bet)
Seat 4: Oleg032 (small blind) folded before Flop
Seat 5: skakalec90 (big blind) folded on the Flop



PokerStars Hand #222967374401:  Hold'em No Limit ($0.05/$0.10 USD) - 2021/01/23 14:48:32 ET
Table 'Merope IV' 6-max Seat #4 is the button
Seat 1: Zambodi500 ($11.12 in chips) 
Seat 2: 0TheMouse0 ($10.28 in chips) 
Seat 3: Pipser222 ($10.36 in chips) 
Seat 4: Oleg032 ($11.22 in chips) 
Seat 5: skakalec90 ($10 in chips) 
Seat 6: alex-zacapa ($10 in chips) 
skakalec90: posts small blind $0.05
alex-zacapa: posts big blind $0.10
*** HOLE CARDS ***
Zambodi500: folds 
0TheMouse0: folds 
Pipser222: raises $0.17 to $0.27
Oleg032: folds 
skakalec90: folds 
alex-zacapa: folds 
Uncalled bet ($0.17) returned to Pipser222
Pipser222 collected $0.25 from pot
Pipser222: doesn't show hand 
*** SUMMARY ***
Total pot $0.25 | Rake $0 
Seat 1: Zambodi500 folded before Flop (didn't bet)
Seat 2: 0TheMouse0 folded before Flop (didn't bet)
Seat 3: Pipser222 collected ($0.25)
Seat 4: Oleg032 (button) folded before Flop (didn't bet)
Seat 5: skakalec90 (small blind) folded before Flop
Seat 6: alex-zacapa (big blind) folded before Flop



PokerStars Hand #222967385831:  Hold'em No Limit ($0.05/$0.10 USD) - 2021/01/23 14:48:46 ET
Table 'Merope IV' 6-max Seat #5 is the button
Seat 1: Zambodi500 ($11.12 in chips) 
Seat 2: 0TheMouse0 ($10.28 in chips) 
Seat 3: Pipser222 ($10.51 in chips) 
Seat 4: Oleg032 ($11.22 in chips) 
Seat 5: skakalec90 ($10 in chips) 
Seat 6: alex-zacapa ($9.90 in chips) 
alex-zacapa: posts small blind $0.05
Zambodi500: posts big blind $0.10
*** HOLE CARDS ***
0TheMouse0: folds 
Pipser222: raises $0.17 to $0.27
Oleg032: calls $0.27
skakalec90: folds 
alex-zacapa: folds 
Zambodi500: folds 
*** FLOP *** [5s 7h 5c]
Pipser222: checks 
Oleg032: checks 
*** TURN *** [5s 7h 5c] [Ah]
Pipser222: bets $0.40
Oleg032: calls $0.40
*** RIVER *** [5s 7h 5c Ah] [Td]
Pipser222: checks 
Oleg032: checks 
*** SHOW DOWN ***
Pipser222: shows [Qc Ac] (two pair, Aces and Fives)
Oleg032: mucks hand 
Pipser222 collected $1.42 from pot
*** SUMMARY ***
Total pot $1.49 | Rake $0.07 
Board [5s 7h 5c Ah Td]
Seat 1: Zambodi500 (big blind) folded before Flop
Seat 2: 0TheMouse0 folded before Flop (didn't bet)
Seat 3: Pipser222 showed [Qc Ac] and won ($1.42) with two pair, Aces and Fives
Seat 4: Oleg032 mucked
Seat 5: skakalec90 (button) folded before Flop (didn't bet)
Seat 6: alex-zacapa (small blind) folded before Flop



PokerStars Hand #222967419672:  Hold'em No Limit ($0.05/$0.10 USD) - 2021/01/23 14:49:30 ET
Table 'Merope IV' 6-max Seat #6 is the button
Seat 1: Zambodi500 ($11.02 in chips) 
Seat 2: 0TheMouse0 ($10.28 in chips) 
Seat 3: Pipser222 ($11.26 in chips) 
Seat 4: Oleg032 ($10.55 in chips) 
Seat 5: skakalec90 ($10 in chips) 
Seat 6: alex-zacapa ($9.85 in chips) 
Zambodi500: posts small blind $0.05
0TheMouse0: posts big blind $0.10
*** HOLE CARDS ***
Pipser222: raises $0.17 to $0.27
Oleg032: folds 
skakalec90: folds 
alex-zacapa: folds 
Zambodi500: folds 
0TheMouse0: folds 
Uncalled bet ($0.17) returned to Pipser222
Pipser222 collected $0.25 from pot
Pipser222: doesn't show hand 
*** SUMMARY ***
Total pot $0.25 | Rake $0 
Seat 1: Zambodi500 (small blind) folded before Flop
Seat 2: 0TheMouse0 (big blind) folded before Flop
Seat 3: Pipser222 collected ($0.25)
Seat 4: Oleg032 folded before Flop (didn't bet)
Seat 5: skakalec90 folded before Flop (didn't bet)
Seat 6: alex-zacapa (button) folded before Flop (didn't bet)



PokerStars Hand #222967429413:  Hold'em No Limit ($0.05/$0.10 USD) - 2021/01/23 14:49:43 ET
Table 'Merope IV' 6-max Seat #1 is the button
Seat 1: Zambodi500 ($10.97 in chips) 
Seat 2: 0TheMouse0 ($10.18 in chips) 
Seat 3: Pipser222 ($11.41 in chips) 
Seat 4: Oleg032 ($10.55 in chips) 
Seat 5: skakalec90 ($10 in chips) 
Seat 6: alex-zacapa ($9.85 in chips) 
0TheMouse0: posts small blind $0.05
Pipser222: posts big blind $0.10
*** HOLE CARDS ***
Oleg032: folds 
skakalec90: folds 
alex-zacapa: folds 
Zambodi500: raises $0.15 to $0.25
0TheMouse0: folds 
Pipser222: folds 
Uncalled bet ($0.15) returned to Zambodi500
Zambodi500 collected $0.25 from pot
*** SUMMARY ***
Total pot $0.25 | Rake $0 
Seat 1: Zambodi500 (button) collected ($0.25)
Seat 2: 0TheMouse0 (small blind) folded before Flop
Seat 3: Pipser222 (big blind) folded before Flop
Seat 4: Oleg032 folded before Flop (didn't bet)
Seat 5: skakalec90 folded before Flop (didn't bet)
Seat 6: alex-zacapa folded before Flop (didn't bet)



PokerStars Hand #222967438083:  Hold'em No Limit ($0.05/$0.10 USD) - 2021/01/23 14:49:54 ET
Table 'Merope IV' 6-max Seat #2 is the button
Seat 1: Zambodi500 ($11.12 in chips) 
Seat 2: 0TheMouse0 ($10.13 in chips) 
Seat 3: Pipser222 ($11.31 in chips) 
Seat 4: Oleg032 ($10.55 in chips) 
Seat 5: skakalec90 ($10 in chips) 
Seat 6: alex-zacapa ($9.85 in chips) 
Pipser222: posts small blind $0.05
Oleg032: posts big blind $0.10
*** HOLE CARDS ***
skakalec90: folds 
alex-zacapa: raises $0.10 to $0.20
Zambodi500: folds 
0TheMouse0: folds 
Pipser222: calls $0.15
Oleg032: raises $0.75 to $0.95
alex-zacapa: folds 
Pipser222: folds 
Uncalled bet ($0.75) returned to Oleg032
Oleg032 collected $0.60 from pot
Oleg032: doesn't show hand 
*** SUMMARY ***
Total pot $0.60 | Rake $0 
Seat 1: Zambodi500 folded before Flop (didn't bet)
Seat 2: 0TheMouse0 (button) folded before Flop (didn't bet)
Seat 3: Pipser222 (small blind) folded before Flop
Seat 4: Oleg032 (big blind) collected ($0.60)
Seat 5: skakalec90 folded before Flop (didn't bet)
Seat 6: alex-zacapa folded before Flop



PokerStars Hand #222967455877:  Hold'em No Limit ($0.05/$0.10 USD) - 2021/01/23 14:50:17 ET
Table 'Merope IV' 6-max Seat #3 is the button
Seat 1: Zambodi500 ($11.12 in chips) 
Seat 2: 0TheMouse0 ($10.13 in chips) 
Seat 3: Pipser222 ($11.11 in chips) 
Seat 4: Oleg032 ($10.95 in chips) 
Seat 5: skakalec90 ($10 in chips) 
Seat 6: alex-zacapa ($9.65 in chips) 
Oleg032: posts small blind $0.05
skakalec90: posts big blind $0.10
*** HOLE CARDS ***
alex-zacapa: folds 
Zambodi500: folds 
0TheMouse0: raises $0.15 to $0.25
Pipser222: folds 
Oleg032: folds 
skakalec90: calls $0.15
*** FLOP *** [3d 4s 6h]
skakalec90: checks 
0TheMouse0: bets $0.37
skakalec90: folds 
Uncalled bet ($0.37) returned to 0TheMouse0
0TheMouse0 collected $0.53 from pot
0TheMouse0: doesn't show hand 
*** SUMMARY ***
Total pot $0.55 | Rake $0.02 
Board [3d 4s 6h]
Seat 1: Zambodi500 folded before Flop (didn't bet)
Seat 2: 0TheMouse0 collected ($0.53)
Seat 3: Pipser222 (button) folded before Flop (didn't bet)
Seat 4: Oleg032 (small blind) folded before Flop
Seat 5: skakalec90 (big blind) folded on the Flop
Seat 6: alex-zacapa folded before Flop (didn't bet)



PokerStars Hand #222967471452:  Hold'em No Limit ($0.05/$0.10 USD) - 2021/01/23 14:50:37 ET
Table 'Merope IV' 6-max Seat #4 is the button
Seat 1: Zambodi500 ($11.12 in chips) 
Seat 2: 0TheMouse0 ($10.41 in chips) 
Seat 3: Pipser222 ($11.11 in chips) 
Seat 4: Oleg032 ($10.90 in chips) 
Seat 5: skakalec90 ($10 in chips) 
Seat 6: alex-zacapa ($9.65 in chips) 
skakalec90: posts small blind $0.05
alex-zacapa: posts big blind $0.10
*** HOLE CARDS ***
Zambodi500: folds 
0TheMouse0: folds 
Pipser222: folds 
Oleg032: folds 
skakalec90: raises $0.20 to $0.30
alex-zacapa: folds 
Uncalled bet ($0.20) returned to skakalec90
skakalec90 collected $0.20 from pot
skakalec90: doesn't show hand 
*** SUMMARY ***
Total pot $0.20 | Rake $0 
Seat 1: Zambodi500 folded before Flop (didn't bet)
Seat 2: 0TheMouse0 folded before Flop (didn't bet)
Seat 3: Pipser222 folded before Flop (didn't bet)
Seat 4: Oleg032 (button) folded before Flop (didn't bet)
Seat 5: skakalec90 (small blind) collected ($0.20)
Seat 6: alex-zacapa (big blind) folded before Flop



PokerStars Hand #222967482004:  Hold'em No Limit ($0.05/$0.10 USD) - 2021/01/23 14:50:51 ET
Table 'Merope IV' 6-max Seat #5 is the button
Seat 1: Zambodi500 ($11.12 in chips) 
Seat 2: 0TheMouse0 ($10.41 in chips) 
Seat 3: Pipser222 ($11.11 in chips) 
Seat 4: Oleg032 ($10.90 in chips) 
Seat 5: skakalec90 ($10.10 in chips) 
Seat 6: alex-zacapa ($9.55 in chips) 
alex-zacapa: posts small blind $0.05
Zambodi500: posts big blind $0.10
*** HOLE CARDS ***
0TheMouse0: folds 
Pipser222: folds 
Oleg032: folds 
skakalec90: folds 
alex-zacapa: folds 
Uncalled bet ($0.05) returned to Zambodi500
Zambodi500 collected $0.10 from pot
*** SUMMARY ***
Total pot $0.10 | Rake $0 
Seat 1: Zambodi500 (big blind) collected ($0.10)
Seat 2: 0TheMouse0 folded before Flop (didn't bet)
Seat 3: Pipser222 folded before Flop (didn't bet)
Seat 4: Oleg032 folded before Flop (didn't bet)
Seat 5: skakalec90 (button) folded before Flop (didn't bet)
Seat 6: alex-zacapa (small blind) folded before Flop



PokerStars Hand #222967492903:  Hold'em No Limit ($0.05/$0.10 USD) - 2021/01/23 14:51:05 ET
Table 'Merope IV' 6-max Seat #6 is the button
Seat 1: Zambodi500 ($11.17 in chips) 
Seat 2: 0TheMouse0 ($10.41 in chips) 
Seat 3: Pipser222 ($11.11 in chips) 
Seat 4: Oleg032 ($10.90 in chips) 
Seat 5: skakalec90 ($10.10 in chips) 
Seat 6: alex-zacapa ($9.50 in chips) 
Zambodi500: posts small blind $0.05
0TheMouse0: posts big blind $0.10
*** HOLE CARDS ***
Pipser222: raises $0.17 to $0.27
Oleg032: folds 
skakalec90: folds 
alex-zacapa: calls $0.27
Zambodi500: folds 
0TheMouse0: folds 
*** FLOP *** [4h 5c Qh]
Pipser222: bets $0.40
alex-zacapa: folds 
Uncalled bet ($0.40) returned to Pipser222
Pipser222 collected $0.66 from pot
Pipser222: doesn't show hand 
*** SUMMARY ***
Total pot $0.69 | Rake $0.03 
Board [4h 5c Qh]
Seat 1: Zambodi500 (small blind) folded before Flop
Seat 2: 0TheMouse0 (big blind) folded before Flop
Seat 3: Pipser222 collected ($0.66)
Seat 4: Oleg032 folded before Flop (didn't bet)
Seat 5: skakalec90 folded before Flop (didn't bet)
Seat 6: alex-zacapa (button) folded on the Flop



PokerStars Hand #222967516824:  Hold'em No Limit ($0.05/$0.10 USD) - 2021/01/23 14:51:36 ET
Table 'Merope IV' 6-max Seat #1 is the button
Seat 1: Zambodi500 ($11.12 in chips) 
Seat 2: 0TheMouse0 ($10.31 in chips) 
Seat 3: Pipser222 ($11.50 in chips) 
Seat 4: Oleg032 ($10.90 in chips) 
Seat 5: skakalec90 ($10.10 in chips) 
Seat 6: alex-zacapa ($9.23 in chips) 
0TheMouse0: posts small blind $0.05
Pipser222: posts big blind $0.10
*** HOLE CARDS ***
Oleg032: folds 
skakalec90: folds 
alex-zacapa: folds 
Zambodi500: raises $0.15 to $0.25
0TheMouse0: folds 
Pipser222: calls $0.15
*** FLOP *** [Ks 4d 9s]
Pipser222: bets $0.30
Zambodi500: folds 
Uncalled bet ($0.30) returned to Pipser222
Pipser222 collected $0.53 from pot
Pipser222: doesn't show hand 
*** SUMMARY ***
Total pot $0.55 | Rake $0.02 
Board [Ks 4d 9s]
Seat 1: Zambodi500 (button) folded on the Flop
Seat 2: 0TheMouse0 (small blind) folded before Flop
Seat 3: Pipser222 (big blind) collected ($0.53)
Seat 4: Oleg032 folded before Flop (didn't bet)
Seat 5: skakalec90 folded before Flop (didn't bet)
Seat 6: alex-zacapa folded before Flop (didn't bet)



PokerStars Hand #222967540565:  Hold'em No Limit ($0.05/$0.10 USD) - 2021/01/23 14:52:07 ET
Table 'Merope IV' 6-max Seat #2 is the button
Seat 1: Zambodi500 ($10.87 in chips) 
Seat 2: 0TheMouse0 ($10.26 in chips) 
Seat 3: Pipser222 ($11.78 in chips) 
Seat 4: Oleg032 ($10.90 in chips) 
Seat 5: skakalec90 ($10.10 in chips) 
Seat 6: alex-zacapa ($9.23 in chips) 
Pipser222: posts small blind $0.05
Oleg032: posts big blind $0.10
*** HOLE CARDS ***
skakalec90: folds 
alex-zacapa: folds 
Zambodi500: raises $0.15 to $0.25
0TheMouse0: folds 
Pipser222: folds 
Oleg032: calls $0.15
*** FLOP *** [2d 9d 6h]
Oleg032: checks 
Zambodi500: checks 
*** TURN *** [2d 9d 6h] [7d]
Oleg032: bets $0.36
Zambodi500: calls $0.36
*** RIVER *** [2d 9d 6h 7d] [Kd]
Oleg032: checks 
Zambodi500: bets $0.67
Oleg032: folds 
Uncalled bet ($0.67) returned to Zambodi500
Zambodi500 collected $1.21 from pot
*** SUMMARY ***
Total pot $1.27 | Rake $0.06 
Board [2d 9d 6h 7d Kd]
Seat 1: Zambodi500 collected ($1.21)
Seat 2: 0TheMouse0 (button) folded before Flop (didn't bet)
Seat 3: Pipser222 (small blind) folded before Flop
Seat 4: Oleg032 (big blind) folded on the River
Seat 5: skakalec90 folded before Flop (didn't bet)
Seat 6: alex-zacapa folded before Flop (didn't bet)



PokerStars Hand #222967584638:  Hold'em No Limit ($0.05/$0.10 USD) - 2021/01/23 14:53:04 ET
Table 'Merope IV' 6-max Seat #3 is the button
Seat 1: Zambodi500 ($11.47 in chips) 
Seat 2: 0TheMouse0 ($10.26 in chips) 
Seat 3: Pipser222 ($11.73 in chips) 
Seat 4: Oleg032 ($10.29 in chips) 
Seat 5: skakalec90 ($10.10 in chips) 
Seat 6: alex-zacapa ($9.23 in chips) 
Oleg032: posts small blind $0.05
skakalec90: posts big blind $0.10
*** HOLE CARDS ***
alex-zacapa: raises $0.20 to $0.30
Zambodi500: raises $0.60 to $0.90
0TheMouse0: folds 
Pipser222: folds 
Oleg032: folds 
skakalec90: folds 
alex-zacapa: calls $0.60
*** FLOP *** [Ac 2d 6s]
alex-zacapa: checks 
Zambodi500: bets $1.02
alex-zacapa: folds 
Uncalled bet ($1.02) returned to Zambodi500
Zambodi500 collected $1.86 from pot
*** SUMMARY ***
Total pot $1.95 | Rake $0.09 
Board [Ac 2d 6s]
Seat 1: Zambodi500 collected ($1.86)
Seat 2: 0TheMouse0 folded before Flop (didn't bet)
Seat 3: Pipser222 (button) folded before Flop (didn't bet)
Seat 4: Oleg032 (small blind) folded before Flop
Seat 5: skakalec90 (big blind) folded before Flop
Seat 6: alex-zacapa folded on the Flop



PokerStars Hand #222967621167:  Hold'em No Limit ($0.05/$0.10 USD) - 2021/01/23 14:53:44 ET
Table 'Merope IV' 6-max Seat #4 is the button
Seat 1: Zambodi500 ($12.43 in chips) 
Seat 2: 0TheMouse0 ($10.26 in chips) 
Seat 3: Pipser222 ($11.73 in chips) 
Seat 4: Oleg032 ($10.24 in chips) 
Seat 5: skakalec90 ($10 in chips) 
Seat 6: alex-zacapa ($8.33 in chips) 
skakalec90: posts small blind $0.05
alex-zacapa: posts big blind $0.10
*** HOLE CARDS ***
Zambodi500: folds 
0TheMouse0: folds 
Pipser222: folds 
Oleg032: folds 
skakalec90: folds 
Uncalled bet ($0.05) returned to alex-zacapa
alex-zacapa collected $0.10 from pot
alex-zacapa: doesn't show hand 
*** SUMMARY ***
Total pot $0.10 | Rake $0 
Seat 1: Zambodi500 folded before Flop (didn't bet)
Seat 2: 0TheMouse0 folded before Flop (didn't bet)
Seat 3: Pipser222 folded before Flop (didn't bet)
Seat 4: Oleg032 (button) folded before Flop (didn't bet)
Seat 5: skakalec90 (small blind) folded before Flop
Seat 6: alex-zacapa (big blind) collected ($0.10)



PokerStars Hand #222967630815:  Hold'em No Limit ($0.05/$0.10 USD) - 2021/01/23 14:53:56 ET
Table 'Merope IV' 6-max Seat #5 is the button
Seat 1: Zambodi500 ($12.43 in chips) 
Seat 2: 0TheMouse0 ($10.26 in chips) 
Seat 3: Pipser222 ($11.73 in chips) 
Seat 4: Oleg032 ($10.24 in chips) 
Seat 5: skakalec90 ($10 in chips) 
Seat 6: alex-zacapa ($8.38 in chips) 
alex-zacapa: posts small blind $0.05
Zambodi500: posts big blind $0.10
*** HOLE CARDS ***
0TheMouse0: folds 
Pipser222: raises $0.17 to $0.27
Oleg032: folds 
skakalec90: folds 
alex-zacapa: calls $0.22
Zambodi500: folds 
*** FLOP *** [9d As 7h]
alex-zacapa: checks 
Pipser222: checks 
*** TURN *** [9d As 7h] [Qd]
alex-zacapa: bets $0.61
Pipser222: folds 
Uncalled bet ($0.61) returned to alex-zacapa
alex-zacapa collected $0.61 from pot
alex-zacapa: doesn't show hand 
*** SUMMARY ***
Total pot $0.64 | Rake $0.03 
Board [9d As 7h Qd]
Seat 1: Zambodi500 (big blind) folded before Flop
Seat 2: 0TheMouse0 folded before Flop (didn't bet)
Seat 3: Pipser222 folded on the Turn
Seat 4: Oleg032 folded before Flop (didn't bet)
Seat 5: skakalec90 (button) folded before Flop (didn't bet)
Seat 6: alex-zacapa (small blind) collected ($0.61)



PokerStars Hand #222967651224:  Hold'em No Limit ($0.05/$0.10 USD) - 2021/01/23 14:54:23 ET
Table 'Merope IV' 6-max Seat #6 is the button
Seat 1: Zambodi500 ($12.33 in chips) 
Seat 2: 0TheMouse0 ($10.26 in chips) 
Seat 3: Pipser222 ($11.46 in chips) 
Seat 4: Oleg032 ($10.24 in chips) 
Seat 5: skakalec90 ($10 in chips) 
Seat 6: alex-zacapa ($8.72 in chips) 
Zambodi500: posts small blind $0.05
0TheMouse0: posts big blind $0.10
*** HOLE CARDS ***
Pipser222: raises $0.17 to $0.27
Oleg032: folds 
skakalec90: folds 
alex-zacapa: folds 
Zambodi500: folds 
0TheMouse0: folds 
Uncalled bet ($0.17) returned to Pipser222
Pipser222 collected $0.25 from pot
Pipser222: doesn't show hand 
*** SUMMARY ***
Total pot $0.25 | Rake $0 
Seat 1: Zambodi500 (small blind) folded before Flop
Seat 2: 0TheMouse0 (big blind) folded before Flop
Seat 3: Pipser222 collected ($0.25)
Seat 4: Oleg032 folded before Flop (didn't bet)
Seat 5: skakalec90 folded before Flop (didn't bet)
Seat 6: alex-zacapa (button) folded before Flop (didn't bet)



PokerStars Hand #222967664227:  Hold'em No Limit ($0.05/$0.10 USD) - 2021/01/23 14:54:39 ET
Table 'Merope IV' 6-max Seat #1 is the button
Seat 1: Zambodi500 ($12.28 in chips) 
Seat 2: 0TheMouse0 ($10.16 in chips) 
Seat 3: Pipser222 ($11.61 in chips) 
Seat 4: Oleg032 ($10.24 in chips) 
Seat 5: skakalec90 ($10 in chips) 
Seat 6: alex-zacapa ($8.72 in chips) 
0TheMouse0: posts small blind $0.05
Pipser222: posts big blind $0.10
*** HOLE CARDS ***
Oleg032: folds 
skakalec90: folds 
alex-zacapa: folds 
Zambodi500: folds 
0TheMouse0: folds 
Uncalled bet ($0.05) returned to Pipser222
Pipser222 collected $0.10 from pot
Pipser222: doesn't show hand 
*** SUMMARY ***
Total pot $0.10 | Rake $0 
Seat 1: Zambodi500 (button) folded before Flop (didn't bet)
Seat 2: 0TheMouse0 (small blind) folded before Flop
Seat 3: Pipser222 (big blind) collected ($0.10)
Seat 4: Oleg032 folded before Flop (didn't bet)
Seat 5: skakalec90 folded before Flop (didn't bet)
Seat 6: alex-zacapa folded before Flop (didn't bet)



PokerStars Hand #222967681011:  Hold'em No Limit ($0.05/$0.10 USD) - 2021/01/23 14:55:01 ET
Table 'Merope IV' 6-max Seat #2 is the button
Seat 1: Zambodi500 ($12.28 in chips) 
Seat 2: 0TheMouse0 ($10.11 in chips) 
Seat 3: Pipser222 ($11.66 in chips) 
Seat 4: Oleg032 ($10.24 in chips) 
Seat 5: skakalec90 ($10 in chips) 
Seat 6: alex-zacapa ($8.72 in chips) 
Pipser222: posts small blind $0.05
Oleg032: posts big blind $0.10
*** HOLE CARDS ***
skakalec90: raises $0.20 to $0.30
alex-zacapa: folds 
Zambodi500: folds 
0TheMouse0: folds 
Pipser222: folds 
Oleg032: folds 
Uncalled bet ($0.20) returned to skakalec90
skakalec90 collected $0.25 from pot
skakalec90: doesn't show hand 
*** SUMMARY ***
Total pot $0.25 | Rake $0 
Seat 1: Zambodi500 folded before Flop (didn't bet)
Seat 2: 0TheMouse0 (button) folded before Flop (didn't bet)
Seat 3: Pipser222 (small blind) folded before Flop
Seat 4: Oleg032 (big blind) folded before Flop
Seat 5: skakalec90 collected ($0.25)
Seat 6: alex-zacapa folded before Flop (didn't bet)



PokerStars Hand #222967691595:  Hold'em No Limit ($0.05/$0.10 USD) - 2021/01/23 14:55:18 ET
Table 'Merope IV' 6-max Seat #3 is the button
Seat 1: Zambodi500 ($12.28 in chips) 
Seat 2: 0TheMouse0 ($10.11 in chips) 
Seat 3: Pipser222 ($11.61 in chips) 
Seat 4: Oleg032 ($10.14 in chips) 
Seat 5: skakalec90 ($10.15 in chips) 
Seat 6: alex-zacapa ($8.72 in chips) 
Oleg032: posts small blind $0.05
skakalec90: posts big blind $0.10
*** HOLE CARDS ***
alex-zacapa: raises $0.20 to $0.30
Zambodi500: folds 
0TheMouse0: folds 
Pipser222: folds 
Oleg032: folds 
skakalec90: folds 
Uncalled bet ($0.20) returned to alex-zacapa
alex-zacapa collected $0.25 from pot
alex-zacapa: doesn't show hand 
*** SUMMARY ***
Total pot $0.25 | Rake $0 
Seat 1: Zambodi500 folded before Flop (didn't bet)
Seat 2: 0TheMouse0 folded before Flop (didn't bet)
Seat 3: Pipser222 (button) folded before Flop (didn't bet)
Seat 4: Oleg032 (small blind) folded before Flop
Seat 5: skakalec90 (big blind) folded before Flop
Seat 6: alex-zacapa collected ($0.25)



PokerStars Hand #222967698424:  Hold'em No Limit ($0.05/$0.10 USD) - 2021/01/23 14:55:31 ET
Table 'Merope IV' 6-max Seat #4 is the button
Seat 1: Zambodi500 ($12.28 in chips) 
Seat 2: 0TheMouse0 ($10.11 in chips) 
Seat 3: Pipser222 ($11.61 in chips) 
Seat 4: Oleg032 ($10.09 in chips) 
Seat 5: skakalec90 ($10.05 in chips) 
Seat 6: alex-zacapa ($8.87 in chips) 
skakalec90: posts small blind $0.05
alex-zacapa: posts big blind $0.10
*** HOLE CARDS ***
Zambodi500 has timed out
Zambodi500: folds 
0TheMouse0: folds 
Pipser222: folds 
Oleg032: folds 
skakalec90: folds 
Uncalled bet ($0.05) returned to alex-zacapa
alex-zacapa collected $0.10 from pot
alex-zacapa: doesn't show hand 
*** SUMMARY ***
Total pot $0.10 | Rake $0 
Seat 1: Zambodi500 folded before Flop (didn't bet)
Seat 2: 0TheMouse0 folded before Flop (didn't bet)
Seat 3: Pipser222 folded before Flop (didn't bet)
Seat 4: Oleg032 (button) folded before Flop (didn't bet)
Seat 5: skakalec90 (small blind) folded before Flop
Seat 6: alex-zacapa (big blind) collected ($0.10)



PokerStars Hand #222967709165:  Hold'em No Limit ($0.05/$0.10 USD) - 2021/01/23 14:55:51 ET
Table 'Merope IV' 6-max Seat #5 is the button
Seat 1: Zambodi500 ($12.28 in chips) 
Seat 2: 0TheMouse0 ($10.11 in chips) 
Seat 3: Pipser222 ($11.61 in chips) 
Seat 4: Oleg032 ($10.09 in chips) 
Seat 5: skakalec90 ($10 in chips) 
Seat 6: alex-zacapa ($8.92 in chips) 
alex-zacapa: posts small blind $0.05
Zambodi500: posts big blind $0.10
*** HOLE CARDS ***
0TheMouse0: folds 
Pipser222: folds 
Oleg032: folds 
skakalec90: folds 
alex-zacapa: calls $0.05
Zambodi500: checks 
*** FLOP *** [4s 5d 6c]
alex-zacapa: checks 
Zambodi500: bets $0.14
alex-zacapa: calls $0.14
*** TURN *** [4s 5d 6c] [Jd]
alex-zacapa: checks 
Zambodi500: bets $0.25
alex-zacapa: calls $0.25
*** RIVER *** [4s 5d 6c Jd] [2h]
alex-zacapa: checks 
Zambodi500: checks 
*** SHOW DOWN ***
alex-zacapa: shows [8s 7s] (a straight, Four to Eight)
Zambodi500: mucks hand 
alex-zacapa collected $0.94 from pot
*** SUMMARY ***
Total pot $0.98 | Rake $0.04 
Board [4s 5d 6c Jd 2h]
Seat 1: Zambodi500 (big blind) mucked
Seat 2: 0TheMouse0 folded before Flop (didn't bet)
Seat 3: Pipser222 folded before Flop (didn't bet)
Seat 4: Oleg032 folded before Flop (didn't bet)
Seat 5: skakalec90 (button) folded before Flop (didn't bet)
Seat 6: alex-zacapa (small blind) showed [8s 7s] and won ($0.94) with a straight, Four to Eight



PokerStars Hand #222967741496:  Hold'em No Limit ($0.05/$0.10 USD) - 2021/01/23 14:56:52 ET
Table 'Merope IV' 6-max Seat #6 is the button
Seat 1: Zambodi500 ($11.79 in chips) 
Seat 2: 0TheMouse0 ($10.11 in chips) 
Seat 3: Pipser222 ($11.61 in chips) 
Seat 4: Oleg032 ($10.09 in chips) 
Seat 5: skakalec90 ($10 in chips) 
Seat 6: alex-zacapa ($9.37 in chips) 
Zambodi500: posts small blind $0.05
0TheMouse0: posts big blind $0.10
*** HOLE CARDS ***
Pipser222: folds 
Oleg032: folds 
skakalec90: raises $0.20 to $0.30
alex-zacapa: folds 
Zambodi500: raises $0.90 to $1.20
0TheMouse0: folds 
skakalec90: folds 
Uncalled bet ($0.90) returned to Zambodi500
Zambodi500 collected $0.70 from pot
Zambodi500: doesn't show hand 
*** SUMMARY ***
Total pot $0.70 | Rake $0 
Seat 1: Zambodi500 (small blind) collected ($0.70)
Seat 2: 0TheMouse0 (big blind) folded before Flop
Seat 3: Pipser222 folded before Flop (didn't bet)
Seat 4: Oleg032 folded before Flop (didn't bet)
Seat 5: skakalec90 folded before Flop
Seat 6: alex-zacapa (button) folded before Flop (didn't bet)



PokerStars Hand #222967750734:  Hold'em No Limit ($0.05/$0.10 USD) - 2021/01/23 14:57:09 ET
Table 'Merope IV' 6-max Seat #1 is the button
Seat 1: Zambodi500 ($12.19 in chips) 
Seat 2: 0TheMouse0 ($10.01 in chips) 
Seat 3: Pipser222 ($11.61 in chips) 
Seat 4: Oleg032 ($10.09 in chips) 
Seat 5: skakalec90 ($10 in chips) 
Seat 6: alex-zacapa ($9.37 in chips) 
0TheMouse0: posts small blind $0.05
Pipser222: posts big blind $0.10
*** HOLE CARDS ***
Oleg032: folds 
skakalec90: raises $0.20 to $0.30
alex-zacapa: folds 
Zambodi500: folds 
0TheMouse0: raises $0.95 to $1.25
Pipser222: folds 
skakalec90: folds 
Uncalled bet ($0.95) returned to 0TheMouse0
0TheMouse0 collected $0.70 from pot
0TheMouse0: doesn't show hand 
*** SUMMARY ***
Total pot $0.70 | Rake $0 
Seat 1: Zambodi500 (button) folded before Flop (didn't bet)
Seat 2: 0TheMouse0 (small blind) collected ($0.70)
Seat 3: Pipser222 (big blind) folded before Flop
Seat 4: Oleg032 folded before Flop (didn't bet)
Seat 5: skakalec90 folded before Flop
Seat 6: alex-zacapa folded before Flop (didn't bet)



PokerStars Hand #222967768312:  Hold'em No Limit ($0.05/$0.10 USD) - 2021/01/23 14:57:42 ET
Table 'Merope IV' 6-max Seat #2 is the button
Seat 1: Zambodi500 ($12.19 in chips) 
Seat 2: 0TheMouse0 ($10.41 in chips) 
Seat 3: Pipser222 ($11.51 in chips) 
Seat 4: Oleg032 ($10.09 in chips) 
Seat 5: skakalec90 ($10 in chips) 
Seat 6: alex-zacapa ($9.37 in chips) 
Pipser222: posts small blind $0.05
Oleg032: posts big blind $0.10
*** HOLE CARDS ***
skakalec90: folds 
alex-zacapa: folds 
Zambodi500: folds 
0TheMouse0: raises $0.15 to $0.25
Pipser222: folds 
Oleg032: calls $0.15
*** FLOP *** [7s 2c 5c]
Oleg032: checks 
0TheMouse0: checks 
*** TURN *** [7s 2c 5c] [As]
Oleg032: checks 
0TheMouse0: checks 
*** RIVER *** [7s 2c 5c As] [Td]
Oleg032: checks 
0TheMouse0: bets $0.37
Oleg032: folds 
Uncalled bet ($0.37) returned to 0TheMouse0
0TheMouse0 collected $0.53 from pot
0TheMouse0: doesn't show hand 
*** SUMMARY ***
Total pot $0.55 | Rake $0.02 
Board [7s 2c 5c As Td]
Seat 1: Zambodi500 folded before Flop (didn't bet)
Seat 2: 0TheMouse0 (button) collected ($0.53)
Seat 3: Pipser222 (small blind) folded before Flop
Seat 4: Oleg032 (big blind) folded on the River
Seat 5: skakalec90 folded before Flop (didn't bet)
Seat 6: alex-zacapa folded before Flop (didn't bet)



PokerStars Hand #222967788409:  Hold'em No Limit ($0.05/$0.10 USD) - 2021/01/23 14:58:20 ET
Table 'Merope IV' 6-max Seat #3 is the button
Seat 1: Zambodi500 ($12.19 in chips) 
Seat 2: 0TheMouse0 ($10.69 in chips) 
Seat 3: Pipser222 ($11.46 in chips) 
Seat 4: Oleg032 ($10 in chips) 
Seat 5: skakalec90 ($10 in chips) 
Seat 6: alex-zacapa ($9.37 in chips) 
Oleg032: posts small blind $0.05
skakalec90: posts big blind $0.10
*** HOLE CARDS ***
alex-zacapa: folds 
Zambodi500: folds 
0TheMouse0: raises $0.15 to $0.25
Pipser222: folds 
Oleg032: folds 
skakalec90: folds 
Uncalled bet ($0.15) returned to 0TheMouse0
0TheMouse0 collected $0.25 from pot
0TheMouse0: doesn't show hand 
*** SUMMARY ***
Total pot $0.25 | Rake $0 
Seat 1: Zambodi500 folded before Flop (didn't bet)
Seat 2: 0TheMouse0 collected ($0.25)
Seat 3: Pipser222 (button) folded before Flop (didn't bet)
Seat 4: Oleg032 (small blind) folded before Flop
Seat 5: skakalec90 (big blind) folded before Flop
Seat 6: alex-zacapa folded before Flop (didn't bet)



PokerStars Hand #222967797860:  Hold'em No Limit ($0.05/$0.10 USD) - 2021/01/23 14:58:37 ET
Table 'Merope IV' 6-max Seat #4 is the button
Seat 1: Zambodi500 ($12.19 in chips) 
Seat 2: 0TheMouse0 ($10.84 in chips) 
Seat 3: Pipser222 ($11.46 in chips) 
Seat 4: Oleg032 ($10 in chips) 
Seat 5: skakalec90 ($10 in chips) 
Seat 6: alex-zacapa ($9.37 in chips) 
skakalec90: posts small blind $0.05
alex-zacapa: posts big blind $0.10
*** HOLE CARDS ***
Zambodi500: folds 
0TheMouse0: folds 
Pipser222: folds 
Oleg032: raises $0.15 to $0.25
skakalec90: folds 
alex-zacapa: folds 
Uncalled bet ($0.15) returned to Oleg032
Oleg032 collected $0.25 from pot
Oleg032: doesn't show hand 
*** SUMMARY ***
Total pot $0.25 | Rake $0 
Seat 1: Zambodi500 folded before Flop (didn't bet)
Seat 2: 0TheMouse0 folded before Flop (didn't bet)
Seat 3: Pipser222 folded before Flop (didn't bet)
Seat 4: Oleg032 (button) collected ($0.25)
Seat 5: skakalec90 (small blind) folded before Flop
Seat 6: alex-zacapa (big blind) folded before Flop



PokerStars Hand #222967803780:  Hold'em No Limit ($0.05/$0.10 USD) - 2021/01/23 14:58:49 ET
Table 'Merope IV' 6-max Seat #5 is the button
Seat 2: 0TheMouse0 ($10.84 in chips) 
Seat 3: Pipser222 ($11.46 in chips) 
Seat 4: Oleg032 ($10.15 in chips) 
Seat 5: skakalec90 ($10 in chips) 
Seat 6: alex-zacapa ($9.27 in chips) 
alex-zacapa: posts small blind $0.05
Zambodi500: is sitting out 
0TheMouse0: posts big blind $0.10
*** HOLE CARDS ***
Pipser222: folds 
Zambodi500 leaves the table
Oleg032: folds 
skakalec90: raises $0.20 to $0.30
alex-zacapa: folds 
0TheMouse0: folds 
Uncalled bet ($0.20) returned to skakalec90
skakalec90 collected $0.25 from pot
skakalec90: doesn't show hand 
*** SUMMARY ***
Total pot $0.25 | Rake $0 
Seat 2: 0TheMouse0 (big blind) folded before Flop
Seat 3: Pipser222 folded before Flop (didn't bet)
Seat 4: Oleg032 folded before Flop (didn't bet)
Seat 5: skakalec90 (button) collected ($0.25)
Seat 6: alex-zacapa (small blind) folded before Flop



PokerStars Hand #222967808549:  Hold'em No Limit ($0.05/$0.10 USD) - 2021/01/23 14:58:57 ET
Table 'Merope IV' 6-max Seat #6 is the button
Seat 2: 0TheMouse0 ($10.74 in chips) 
Seat 3: Pipser222 ($11.46 in chips) 
Seat 4: Oleg032 ($10.15 in chips) 
Seat 5: skakalec90 ($10.15 in chips) 
Seat 6: alex-zacapa ($9.22 in chips) 
0TheMouse0: posts small blind $0.05
Pipser222: posts big blind $0.10
*** HOLE CARDS ***
Oleg032: folds 
skakalec90: raises $0.20 to $0.30
alex-zacapa: calls $0.30
0TheMouse0: folds 
Pipser222: folds 
*** FLOP *** [Kd 4d Qd]
skakalec90: checks 
alex-zacapa: checks 
*** TURN *** [Kd 4d Qd] [Ac]
Leandra1808 joins the table at seat #1 
skakalec90: bets $0.36
alex-zacapa: calls $0.36
*** RIVER *** [Kd 4d Qd Ac] [5h]
skakalec90: checks 
alex-zacapa: checks 
*** SHOW DOWN ***
skakalec90: shows [Jc Qh] (a pair of Queens)
alex-zacapa: shows [Ah Td] (a pair of Aces)
alex-zacapa collected $1.40 from pot
*** SUMMARY ***
Total pot $1.47 | Rake $0.07 
Board [Kd 4d Qd Ac 5h]
Seat 2: 0TheMouse0 (small blind) folded before Flop
Seat 3: Pipser222 (big blind) folded before Flop
Seat 4: Oleg032 folded before Flop (didn't bet)
Seat 5: skakalec90 showed [Jc Qh] and lost with a pair of Queens
Seat 6: alex-zacapa (button) showed [Ah Td] and won ($1.40) with a pair of Aces



PokerStars Hand #222967823022:  Hold'em No Limit ($0.05/$0.10 USD) - 2021/01/23 14:59:25 ET
Table 'Merope IV' 6-max Seat #2 is the button
Seat 1: Leandra1808 ($8 in chips) 
Seat 2: 0TheMouse0 ($10.69 in chips) 
Seat 3: Pipser222 ($11.36 in chips) 
Seat 4: Oleg032 ($10.15 in chips) 
Seat 5: skakalec90 ($10 in chips) 
Seat 6: alex-zacapa ($9.96 in chips) 
Pipser222: posts small blind $0.05
Oleg032: posts big blind $0.10
Leandra1808: posts big blind $0.10
*** HOLE CARDS ***
skakalec90: folds 
alex-zacapa: folds 
Leandra1808: checks 
0TheMouse0: raises $0.40 to $0.50
Pipser222: folds 
Oleg032: calls $0.40
Leandra1808: calls $0.40
*** FLOP *** [Js Kd 9d]
Oleg032: checks 
Leandra1808: checks 
0TheMouse0: checks 
*** TURN *** [Js Kd 9d] [5s]
Oleg032: bets $0.74
Leandra1808: calls $0.74
0TheMouse0: folds 
*** RIVER *** [Js Kd 9d 5s] [6h]
Oleg032: bets $1.45
Leandra1808: raises $1.45 to $2.90
Oleg032: calls $1.45
*** SHOW DOWN ***
Leandra1808: shows [Qs Td] (a straight, Nine to King)
Oleg032: mucks hand 
Leandra1808 collected $8.43 from pot
*** SUMMARY ***
Total pot $8.83 | Rake $0.40 
Board [Js Kd 9d 5s 6h]
Seat 1: Leandra1808 showed [Qs Td] and won ($8.43) with a straight, Nine to King
Seat 2: 0TheMouse0 (button) folded on the Turn
Seat 3: Pipser222 (small blind) folded before Flop
Seat 4: Oleg032 (big blind) mucked
Seat 5: skakalec90 folded before Flop (didn't bet)
Seat 6: alex-zacapa folded before Flop (didn't bet)



PokerStars Hand #222967870692:  Hold'em No Limit ($0.05/$0.10 USD) - 2021/01/23 15:00:49 ET
Table 'Merope IV' 6-max Seat #3 is the button
Seat 1: Leandra1808 ($12.29 in chips) 
Seat 2: 0TheMouse0 ($10.19 in chips) 
Seat 3: Pipser222 ($11.31 in chips) 
Seat 4: Oleg032 ($10 in chips) 
Seat 5: skakalec90 ($10 in chips) 
Seat 6: alex-zacapa ($9.96 in chips) 
Oleg032: posts small blind $0.05
skakalec90: posts big blind $0.10
*** HOLE CARDS ***
alex-zacapa: raises $0.10 to $0.20
Leandra1808: folds 
0TheMouse0: folds 
Pipser222: folds 
Oleg032: folds 
skakalec90: folds 
Uncalled bet ($0.10) returned to alex-zacapa
alex-zacapa collected $0.25 from pot
alex-zacapa: doesn't show hand 
*** SUMMARY ***
Total pot $0.25 | Rake $0 
Seat 1: Leandra1808 folded before Flop (didn't bet)
Seat 2: 0TheMouse0 folded before Flop (didn't bet)
Seat 3: Pipser222 (button) folded before Flop (didn't bet)
Seat 4: Oleg032 (small blind) folded before Flop
Seat 5: skakalec90 (big blind) folded before Flop
Seat 6: alex-zacapa collected ($0.25)



PokerStars Hand #222967882426:  Hold'em No Limit ($0.05/$0.10 USD) - 2021/01/23 15:01:07 ET
Table 'Merope IV' 6-max Seat #4 is the button
Seat 1: Leandra1808 ($12.29 in chips) 
Seat 2: 0TheMouse0 ($10.19 in chips) 
Seat 3: Pipser222 ($11.31 in chips) 
Seat 4: Oleg032 ($10 in chips) 
Seat 5: skakalec90 ($10 in chips) 
Seat 6: alex-zacapa ($10.11 in chips) 
skakalec90: posts small blind $0.05
alex-zacapa: posts big blind $0.10
*** HOLE CARDS ***
Leandra1808: raises $0.10 to $0.20
0TheMouse0: folds 
Pipser222: folds 
Oleg032: folds 
skakalec90: folds 
alex-zacapa: folds 
Uncalled bet ($0.10) returned to Leandra1808
Leandra1808 collected $0.25 from pot
Leandra1808: doesn't show hand 
*** SUMMARY ***
Total pot $0.25 | Rake $0 
Seat 1: Leandra1808 collected ($0.25)
Seat 2: 0TheMouse0 folded before Flop (didn't bet)
Seat 3: Pipser222 folded before Flop (didn't bet)
Seat 4: Oleg032 (button) folded before Flop (didn't bet)
Seat 5: skakalec90 (small blind) folded before Flop
Seat 6: alex-zacapa (big blind) folded before Flop



PokerStars Hand #222967896024:  Hold'em No Limit ($0.05/$0.10 USD) - 2021/01/23 15:01:22 ET
Table 'Merope IV' 6-max Seat #5 is the button
Seat 1: Leandra1808 ($12.44 in chips) 
Seat 2: 0TheMouse0 ($10.19 in chips) 
Seat 3: Pipser222 ($11.31 in chips) 
Seat 4: Oleg032 ($10 in chips) 
Seat 5: skakalec90 ($10 in chips) 
Seat 6: alex-zacapa ($10.01 in chips) 
alex-zacapa: posts small blind $0.05
Leandra1808: posts big blind $0.10
*** HOLE CARDS ***
0TheMouse0: folds 
Pipser222: folds 
Oleg032: folds 
skakalec90: raises $0.20 to $0.30
alex-zacapa: folds 
Leandra1808: folds 
Uncalled bet ($0.20) returned to skakalec90
skakalec90 collected $0.25 from pot
skakalec90: doesn't show hand 
*** SUMMARY ***
Total pot $0.25 | Rake $0 
Seat 1: Leandra1808 (big blind) folded before Flop
Seat 2: 0TheMouse0 folded before Flop (didn't bet)
Seat 3: Pipser222 folded before Flop (didn't bet)
Seat 4: Oleg032 folded before Flop (didn't bet)
Seat 5: skakalec90 (button) collected ($0.25)
Seat 6: alex-zacapa (small blind) folded before Flop



PokerStars Hand #222967902652:  Hold'em No Limit ($0.05/$0.10 USD) - 2021/01/23 15:01:32 ET
Table 'Merope IV' 6-max Seat #6 is the button
Seat 1: Leandra1808 ($12.34 in chips) 
Seat 2: 0TheMouse0 ($10.19 in chips) 
Seat 3: Pipser222 ($11.31 in chips) 
Seat 5: skakalec90 ($10.15 in chips) 
Seat 6: alex-zacapa ($9.96 in chips) 
Leandra1808: posts small blind $0.05
0TheMouse0: posts big blind $0.10
*** HOLE CARDS ***
Pipser222: folds 
skakalec90: folds 
alex-zacapa: folds 
Leandra1808: folds 
Uncalled bet ($0.05) returned to 0TheMouse0
0TheMouse0 collected $0.10 from pot
0TheMouse0: doesn't show hand 
*** SUMMARY ***
Total pot $0.10 | Rake $0 
Seat 1: Leandra1808 (small blind) folded before Flop
Seat 2: 0TheMouse0 (big blind) collected ($0.10)
Seat 3: Pipser222 folded before Flop (didn't bet)
Seat 5: skakalec90 folded before Flop (didn't bet)
Seat 6: alex-zacapa (button) folded before Flop (didn't bet)



PokerStars Hand #222967916105:  Hold'em No Limit ($0.05/$0.10 USD) - 2021/01/23 15:01:44 ET
Table 'Merope IV' 6-max Seat #1 is the button
Seat 1: Leandra1808 ($12.29 in chips) 
Seat 2: 0TheMouse0 ($10.24 in chips) 
Seat 3: Pipser222 ($11.31 in chips) 
Seat 5: skakalec90 ($10.15 in chips) 
Seat 6: alex-zacapa ($9.96 in chips) 
0TheMouse0: posts small blind $0.05
Pipser222: posts big blind $0.10
*** HOLE CARDS ***
skakalec90: folds 
alex-zacapa: folds 
Leandra1808: folds 
0TheMouse0: folds 
Uncalled bet ($0.05) returned to Pipser222
Pipser222 collected $0.10 from pot
Pipser222: doesn't show hand 
*** SUMMARY ***
Total pot $0.10 | Rake $0 
Seat 1: Leandra1808 (button) folded before Flop (didn't bet)
Seat 2: 0TheMouse0 (small blind) folded before Flop
Seat 3: Pipser222 (big blind) collected ($0.10)
Seat 5: skakalec90 folded before Flop (didn't bet)
Seat 6: alex-zacapa folded before Flop (didn't bet)



PokerStars Hand #222967920656:  Hold'em No Limit ($0.05/$0.10 USD) - 2021/01/23 15:01:50 ET
Table 'Merope IV' 6-max Seat #2 is the button
Seat 1: Leandra1808 ($12.29 in chips) 
Seat 2: 0TheMouse0 ($10.19 in chips) 
Seat 3: Pipser222 ($11.36 in chips) 
Seat 5: skakalec90 ($10.15 in chips) 
Seat 6: alex-zacapa ($9.96 in chips) 
Pipser222: posts small blind $0.05
skakalec90: posts big blind $0.10
*** HOLE CARDS ***
alex-zacapa: folds 
Leandra1808: calls $0.10
0TheMouse0 has timed out
0TheMouse0: folds 
Pipser222: folds 
skakalec90: checks 
*** FLOP *** [3c 2h Kd]
skakalec90: bets $0.12
Leandra1808: folds 
Uncalled bet ($0.12) returned to skakalec90
skakalec90 collected $0.24 from pot
skakalec90: doesn't show hand 
*** SUMMARY ***
Total pot $0.25 | Rake $0.01 
Board [3c 2h Kd]
Seat 1: Leandra1808 folded on the Flop
Seat 2: 0TheMouse0 (button) folded before Flop (didn't bet)
Seat 3: Pipser222 (small blind) folded before Flop
Seat 5: skakalec90 (big blind) collected ($0.24)
Seat 6: alex-zacapa folded before Flop (didn't bet)



PokerStars Hand #222967938193:  Hold'em No Limit ($0.05/$0.10 USD) - 2021/01/23 15:02:14 ET
Table 'Merope IV' 6-max Seat #3 is the button
Seat 1: Leandra1808 ($12.19 in chips) 
Seat 3: Pipser222 ($11.31 in chips) 
Seat 5: skakalec90 ($10.29 in chips) 
Seat 6: alex-zacapa ($9.96 in chips) 
skakalec90: posts small blind $0.05
alex-zacapa: posts big blind $0.10
*** HOLE CARDS ***
Leandra1808: calls $0.10
Pipser222 has timed out
Pipser222: folds 
skakalec90: raises $0.20 to $0.30
alex-zacapa: folds 
Leandra1808: calls $0.20
*** FLOP *** [2d 8d Th]
skakalec90: checks 
Leandra1808: checks 
*** TURN *** [2d 8d Th] [Jh]
skakalec90: checks 
Leandra1808: bets $0.67
skakalec90: folds 
Uncalled bet ($0.67) returned to Leandra1808
Leandra1808 collected $0.67 from pot
Leandra1808: doesn't show hand 
*** SUMMARY ***
Total pot $0.70 | Rake $0.03 
Board [2d 8d Th Jh]
Seat 1: Leandra1808 collected ($0.67)
Seat 3: Pipser222 (button) folded before Flop (didn't bet)
Seat 5: skakalec90 (small blind) folded on the Turn
Seat 6: alex-zacapa (big blind) folded before Flop



PokerStars Hand #222967972118:  Hold'em No Limit ($0.05/$0.10 USD) - 2021/01/23 15:02:58 ET
Table 'Merope IV' 6-max Seat #5 is the button
Seat 1: Leandra1808 ($12.56 in chips) 
Seat 2: 0TheMouse0 ($10.19 in chips) 
Seat 3: Pipser222 ($11.31 in chips) 
Seat 5: skakalec90 ($10 in chips) 
Seat 6: alex-zacapa ($9.86 in chips) 
alex-zacapa: posts small blind $0.05
Leandra1808: posts big blind $0.10
*** HOLE CARDS ***
0TheMouse0: folds 
Pipser222: raises $0.17 to $0.27
skakalec90: folds 
alex-zacapa: folds 
Leandra1808: calls $0.17
*** FLOP *** [9c 7s 4s]
Leandra1808: checks 
Pipser222: bets $0.28
Leandra1808: calls $0.28
*** TURN *** [9c 7s 4s] [Ks]
Leandra1808: checks 
Pipser222: checks 
*** RIVER *** [9c 7s 4s Ks] [Tc]
Leandra1808: bets $1.10
Pipser222: calls $1.10
*** SHOW DOWN ***
Leandra1808: shows [As 2d] (high card Ace)
Pipser222: shows [Td 7d] (two pair, Tens and Sevens)
Pipser222 collected $3.20 from pot
*** SUMMARY ***
Total pot $3.35 | Rake $0.15 
Board [9c 7s 4s Ks Tc]
Seat 1: Leandra1808 (big blind) showed [As 2d] and lost with high card Ace
Seat 2: 0TheMouse0 folded before Flop (didn't bet)
Seat 3: Pipser222 showed [Td 7d] and won ($3.20) with two pair, Tens and Sevens
Seat 5: skakalec90 (button) folded before Flop (didn't bet)
Seat 6: alex-zacapa (small blind) folded before Flop



PokerStars Hand #222968004167:  Hold'em No Limit ($0.05/$0.10 USD) - 2021/01/23 15:03:37 ET
Table 'Merope IV' 6-max Seat #6 is the button
Seat 1: Leandra1808 ($10.91 in chips) 
Seat 2: 0TheMouse0 ($10.19 in chips) 
Seat 3: Pipser222 ($12.86 in chips) 
Seat 5: skakalec90 ($10 in chips) 
Seat 6: alex-zacapa ($9.81 in chips) 
Leandra1808: posts small blind $0.05
0TheMouse0: posts big blind $0.10
Oleg032: sits out 
*** HOLE CARDS ***
Pipser222: folds 
skakalec90: folds 
alex-zacapa: folds 
Leandra1808: folds 
Uncalled bet ($0.05) returned to 0TheMouse0
0TheMouse0 collected $0.10 from pot
0TheMouse0: doesn't show hand 
*** SUMMARY ***
Total pot $0.10 | Rake $0 
Seat 1: Leandra1808 (small blind) folded before Flop
Seat 2: 0TheMouse0 (big blind) collected ($0.10)
Seat 3: Pipser222 folded before Flop (didn't bet)
Seat 5: skakalec90 folded before Flop (didn't bet)
Seat 6: alex-zacapa (button) folded before Flop (didn't bet)



PokerStars Hand #222968010234:  Hold'em No Limit ($0.05/$0.10 USD) - 2021/01/23 15:03:44 ET
Table 'Merope IV' 6-max Seat #1 is the button
Seat 1: Leandra1808 ($10.86 in chips) 
Seat 2: 0TheMouse0 ($10.24 in chips) 
Seat 3: Pipser222 ($12.86 in chips) 
Seat 5: skakalec90 ($10 in chips) 
Seat 6: alex-zacapa ($9.81 in chips) 
0TheMouse0: posts small blind $0.05
Pipser222: posts big blind $0.10
Oleg032: sits out 
*** HOLE CARDS ***
skakalec90: folds 
alex-zacapa: folds 
Leandra1808 has timed out
Leandra1808: folds 
0TheMouse0: raises $0.20 to $0.30
Pipser222: folds 
Uncalled bet ($0.20) returned to 0TheMouse0
0TheMouse0 collected $0.20 from pot
0TheMouse0: doesn't show hand 
*** SUMMARY ***
Total pot $0.20 | Rake $0 
Seat 1: Leandra1808 (button) folded before Flop (didn't bet)
Seat 2: 0TheMouse0 (small blind) collected ($0.20)
Seat 3: Pipser222 (big blind) folded before Flop
Seat 5: skakalec90 folded before Flop (didn't bet)
Seat 6: alex-zacapa folded before Flop (didn't bet)



PokerStars Hand #222968028925:  Hold'em No Limit ($0.05/$0.10 USD) - 2021/01/23 15:04:07 ET
Table 'Merope IV' 6-max Seat #2 is the button
Seat 1: Leandra1808 ($10.86 in chips) 
Seat 2: 0TheMouse0 ($10.34 in chips) 
Seat 3: Pipser222 ($12.76 in chips) 
Seat 4: Oleg032 ($10 in chips) 
Seat 5: skakalec90 ($10 in chips) 
Seat 6: alex-zacapa ($9.81 in chips) 
Pipser222: posts small blind $0.05
Oleg032: posts big blind $0.10
*** HOLE CARDS ***
skakalec90: folds 
alex-zacapa: raises $0.20 to $0.30
Leandra1808: calls $0.30
0TheMouse0: folds 
Pipser222: folds 
Oleg032: folds 
*** FLOP *** [Ts Jd 8h]
alex-zacapa: bets $0.36
Leandra1808: calls $0.36
*** TURN *** [Ts Jd 8h] [Js]
alex-zacapa: checks 
Leandra1808: checks 
*** RIVER *** [Ts Jd 8h Js] [Th]
alex-zacapa: bets $0.70
Leandra1808: calls $0.70
*** SHOW DOWN ***
alex-zacapa: shows [8s 8d] (a full house, Eights full of Jacks)
Leandra1808: mucks hand 
alex-zacapa collected $2.74 from pot
*** SUMMARY ***
Total pot $2.87 | Rake $0.13 
Board [Ts Jd 8h Js Th]
Seat 1: Leandra1808 mucked
Seat 2: 0TheMouse0 (button) folded before Flop (didn't bet)
Seat 3: Pipser222 (small blind) folded before Flop
Seat 4: Oleg032 (big blind) folded before Flop
Seat 5: skakalec90 folded before Flop (didn't bet)
Seat 6: alex-zacapa showed [8s 8d] and won ($2.74) with a full house, Eights full of Jacks



PokerStars Hand #222968064014:  Hold'em No Limit ($0.05/$0.10 USD) - 2021/01/23 15:04:50 ET
Table 'Merope IV' 6-max Seat #3 is the button
Seat 1: Leandra1808 ($9.50 in chips) 
Seat 2: 0TheMouse0 ($10.34 in chips) 
Seat 3: Pipser222 ($12.71 in chips) 
Seat 4: Oleg032 ($10 in chips) 
Seat 5: skakalec90 ($10 in chips) 
Seat 6: alex-zacapa ($11.19 in chips) 
Oleg032: posts small blind $0.05
skakalec90: posts big blind $0.10
*** HOLE CARDS ***
alex-zacapa: folds 
Leandra1808: folds 
0TheMouse0: folds 
Pipser222: folds 
Oleg032: raises $0.20 to $0.30
skakalec90: folds 
Uncalled bet ($0.20) returned to Oleg032
Oleg032 collected $0.20 from pot
Oleg032: doesn't show hand 
*** SUMMARY ***
Total pot $0.20 | Rake $0 
Seat 1: Leandra1808 folded before Flop (didn't bet)
Seat 2: 0TheMouse0 folded before Flop (didn't bet)
Seat 3: Pipser222 (button) folded before Flop (didn't bet)
Seat 4: Oleg032 (small blind) collected ($0.20)
Seat 5: skakalec90 (big blind) folded before Flop
Seat 6: alex-zacapa folded before Flop (didn't bet)



PokerStars Hand #222968078201:  Hold'em No Limit ($0.05/$0.10 USD) - 2021/01/23 15:05:07 ET
Table 'Merope IV' 6-max Seat #4 is the button
Seat 1: Leandra1808 ($9.50 in chips) 
Seat 2: 0TheMouse0 ($10.34 in chips) 
Seat 3: Pipser222 ($12.71 in chips) 
Seat 4: Oleg032 ($10.10 in chips) 
Seat 5: skakalec90 ($10 in chips) 
Seat 6: alex-zacapa ($11.19 in chips) 
skakalec90: posts small blind $0.05
alex-zacapa: posts big blind $0.10
*** HOLE CARDS ***
Leandra1808: folds 
0TheMouse0: folds 
Pipser222: raises $0.17 to $0.27
Oleg032: folds 
skakalec90: calls $0.22
alex-zacapa: folds 
*** FLOP *** [Qc 6c Kh]
skakalec90: checks 
Pipser222: bets $0.40
skakalec90: folds 
Uncalled bet ($0.40) returned to Pipser222
Pipser222 collected $0.61 from pot
Pipser222: doesn't show hand 
*** SUMMARY ***
Total pot $0.64 | Rake $0.03 
Board [Qc 6c Kh]
Seat 1: Leandra1808 folded before Flop (didn't bet)
Seat 2: 0TheMouse0 folded before Flop (didn't bet)
Seat 3: Pipser222 collected ($0.61)
Seat 4: Oleg032 (button) folded before Flop (didn't bet)
Seat 5: skakalec90 (small blind) folded on the Flop
Seat 6: alex-zacapa (big blind) folded before Flop



PokerStars Hand #222968104316:  Hold'em No Limit ($0.05/$0.10 USD) - 2021/01/23 15:05:39 ET
Table 'Merope IV' 6-max Seat #5 is the button
Seat 1: Leandra1808 ($9.50 in chips) 
Seat 2: 0TheMouse0 ($10.34 in chips) 
Seat 3: Pipser222 ($13.05 in chips) 
Seat 4: Oleg032 ($10.10 in chips) 
Seat 5: skakalec90 ($10 in chips) 
Seat 6: alex-zacapa ($11.09 in chips) 
alex-zacapa: posts small blind $0.05
Leandra1808: posts big blind $0.10
*** HOLE CARDS ***
0TheMouse0: folds 
Pipser222: raises $0.17 to $0.27
Oleg032: folds 
skakalec90: folds 
alex-zacapa: calls $0.22
Leandra1808: calls $0.17
*** FLOP *** [5h 8d 2c]
alex-zacapa: bets $0.77
Leandra1808: calls $0.77
Pipser222: folds 
*** TURN *** [5h 8d 2c] [Td]
alex-zacapa: bets $2.24
Leandra1808: calls $2.24
*** RIVER *** [5h 8d 2c Td] [4s]
alex-zacapa: bets $3.26
Leandra1808: raises $2.96 to $6.22 and is all-in
alex-zacapa: calls $2.96
*** SHOW DOWN ***
Leandra1808: shows [Qh Qs] (a pair of Queens)
alex-zacapa: shows [8s 6s] (a pair of Eights)
Leandra1808 collected $18.40 from pot
*** SUMMARY ***
Total pot $19.27 | Rake $0.87 
Board [5h 8d 2c Td 4s]
Seat 1: Leandra1808 (big blind) showed [Qh Qs] and won ($18.40) with a pair of Queens
Seat 2: 0TheMouse0 folded before Flop (didn't bet)
Seat 3: Pipser222 folded on the Flop
Seat 4: Oleg032 folded before Flop (didn't bet)
Seat 5: skakalec90 (button) folded before Flop (didn't bet)
Seat 6: alex-zacapa (small blind) showed [8s 6s] and lost with a pair of Eights



PokerStars Hand #222968150384:  Hold'em No Limit ($0.05/$0.10 USD) - 2021/01/23 15:06:33 ET
Table 'Merope IV' 6-max Seat #6 is the button
Seat 1: Leandra1808 ($18.40 in chips) 
Seat 2: 0TheMouse0 ($10.34 in chips) 
Seat 3: Pipser222 ($12.78 in chips) 
Seat 4: Oleg032 ($10.10 in chips) 
Seat 5: skakalec90 ($10 in chips) 
Seat 6: alex-zacapa ($1.59 in chips) 
Leandra1808: posts small blind $0.05
0TheMouse0: posts big blind $0.10
*** HOLE CARDS ***
Pipser222: folds 
Oleg032: folds 
skakalec90: folds 
alex-zacapa: folds 
Leandra1808: calls $0.05
0TheMouse0: checks 
*** FLOP *** [Qs 9s 3d]
alex-zacapa leaves the table
Leandra1808: checks 
0TheMouse0: checks 
*** TURN *** [Qs 9s 3d] [Jd]
Leandra1808: checks 
Kaluga_Denny joins the table at seat #6 
0TheMouse0: checks 
*** RIVER *** [Qs 9s 3d Jd] [Th]
Leandra1808: checks 
0TheMouse0: checks 
*** SHOW DOWN ***
Leandra1808: shows [4c 5d] (high card Queen)
0TheMouse0: shows [5h Js] (a pair of Jacks)
0TheMouse0 collected $0.19 from pot
*** SUMMARY ***
Total pot $0.20 | Rake $0.01 
Board [Qs 9s 3d Jd Th]
Seat 1: Leandra1808 (small blind) showed [4c 5d] and lost with high card Queen
Seat 2: 0TheMouse0 (big blind) showed [5h Js] and won ($0.19) with a pair of Jacks
Seat 3: Pipser222 folded before Flop (didn't bet)
Seat 4: Oleg032 folded before Flop (didn't bet)
Seat 5: skakalec90 folded before Flop (didn't bet)
Seat 6: alex-zacapa (button) folded before Flop (didn't bet)



PokerStars Hand #222968175826:  Hold'em No Limit ($0.05/$0.10 USD) - 2021/01/23 15:07:04 ET
Table 'Merope IV' 6-max Seat #1 is the button
Seat 1: Leandra1808 ($18.30 in chips) 
Seat 2: 0TheMouse0 ($10.43 in chips) 
Seat 3: Pipser222 ($12.78 in chips) 
Seat 4: Oleg032 ($10.10 in chips) 
Seat 5: skakalec90 ($10 in chips) 
Seat 6: Kaluga_Denny ($4 in chips) 
0TheMouse0: posts small blind $0.05
Pipser222: posts big blind $0.10
Kaluga_Denny: posts big blind $0.10
*** HOLE CARDS ***
Oleg032: folds 
skakalec90: folds 
Kaluga_Denny: checks 
Leandra1808: raises $0.10 to $0.20
0TheMouse0: folds 
Pipser222: calls $0.10
Kaluga_Denny: calls $0.10
*** FLOP *** [3h Jc 5s]
Pipser222: checks 
Kaluga_Denny: checks 
Leandra1808: checks 
*** TURN *** [3h Jc 5s] [2d]
Pipser222: checks 
Kaluga_Denny: bets $0.10
Leandra1808: folds 
Pipser222: calls $0.10
*** RIVER *** [3h Jc 5s 2d] [8s]
Pipser222: checks 
Kaluga_Denny: bets $0.10
Pipser222: calls $0.10
*** SHOW DOWN ***
Kaluga_Denny: shows [Qd 3d] (a pair of Threes)
Pipser222: shows [8c As] (a pair of Eights)
Pipser222 collected $1 from pot
*** SUMMARY ***
Total pot $1.05 | Rake $0.05 
Board [3h Jc 5s 2d 8s]
Seat 1: Leandra1808 (button) folded on the Turn
Seat 2: 0TheMouse0 (small blind) folded before Flop
Seat 3: Pipser222 (big blind) showed [8c As] and won ($1) with a pair of Eights
Seat 4: Oleg032 folded before Flop (didn't bet)
Seat 5: skakalec90 folded before Flop (didn't bet)
Seat 6: Kaluga_Denny showed [Qd 3d] and lost with a pair of Threes



PokerStars Hand #222968236142:  Hold'em No Limit ($0.05/$0.10 USD) - 2021/01/23 15:08:16 ET
Table 'Merope IV' 6-max Seat #2 is the button
Seat 1: Leandra1808 ($18.10 in chips) 
Seat 2: 0TheMouse0 ($10.38 in chips) 
Seat 3: Pipser222 ($13.38 in chips) 
Seat 4: Oleg032 ($10.10 in chips) 
Seat 5: skakalec90 ($10 in chips) 
Seat 6: Kaluga_Denny ($3.60 in chips) 
Pipser222: posts small blind $0.05
Oleg032: posts big blind $0.10
*** HOLE CARDS ***
skakalec90: folds 
Kaluga_Denny: folds 
Leandra1808: raises $0.10 to $0.20
0TheMouse0: folds 
Pipser222: folds 
Oleg032: folds 
Uncalled bet ($0.10) returned to Leandra1808
Leandra1808 collected $0.25 from pot
Leandra1808: doesn't show hand 
*** SUMMARY ***
Total pot $0.25 | Rake $0 
Seat 1: Leandra1808 collected ($0.25)
Seat 2: 0TheMouse0 (button) folded before Flop (didn't bet)
Seat 3: Pipser222 (small blind) folded before Flop
Seat 4: Oleg032 (big blind) folded before Flop
Seat 5: skakalec90 folded before Flop (didn't bet)
Seat 6: Kaluga_Denny folded before Flop (didn't bet)



PokerStars Hand #222968249975:  Hold'em No Limit ($0.05/$0.10 USD) - 2021/01/23 15:08:32 ET
Table 'Merope IV' 6-max Seat #3 is the button
Seat 1: Leandra1808 ($18.25 in chips) 
Seat 2: 0TheMouse0 ($10.38 in chips) 
Seat 3: Pipser222 ($13.33 in chips) 
Seat 4: Oleg032 ($10 in chips) 
Seat 5: skakalec90 ($10 in chips) 
Seat 6: Kaluga_Denny ($3.60 in chips) 
Oleg032: posts small blind $0.05
skakalec90: posts big blind $0.10
*** HOLE CARDS ***
Kaluga_Denny: calls $0.10
Leandra1808: calls $0.10
0TheMouse0: folds 
Pipser222: folds 
Oleg032: raises $0.20 to $0.30
skakalec90: calls $0.20
Kaluga_Denny: calls $0.20
Leandra1808: calls $0.20
*** FLOP *** [8d 5d 2d]
Oleg032: bets $0.77
skakalec90: folds 
Kaluga_Denny: folds 
Leandra1808: folds 
Uncalled bet ($0.77) returned to Oleg032
Oleg032 collected $1.15 from pot
Oleg032: doesn't show hand 
*** SUMMARY ***
Total pot $1.20 | Rake $0.05 
Board [8d 5d 2d]
Seat 1: Leandra1808 folded on the Flop
Seat 2: 0TheMouse0 folded before Flop (didn't bet)
Seat 3: Pipser222 (button) folded before Flop (didn't bet)
Seat 4: Oleg032 (small blind) collected ($1.15)
Seat 5: skakalec90 (big blind) folded on the Flop
Seat 6: Kaluga_Denny folded on the Flop



PokerStars Hand #222968274857:  Hold'em No Limit ($0.05/$0.10 USD) - 2021/01/23 15:09:02 ET
Table 'Merope IV' 6-max Seat #4 is the button
Seat 1: Leandra1808 ($17.95 in chips) 
Seat 2: 0TheMouse0 ($10.38 in chips) 
Seat 3: Pipser222 ($13.33 in chips) 
Seat 4: Oleg032 ($10.85 in chips) 
Seat 5: skakalec90 ($10 in chips) 
Seat 6: Kaluga_Denny ($3.30 in chips) 
skakalec90: posts small blind $0.05
Kaluga_Denny: posts big blind $0.10
*** HOLE CARDS ***
Leandra1808: folds 
0TheMouse0: folds 
Pipser222: folds 
Oleg032: folds 
skakalec90: folds 
Uncalled bet ($0.05) returned to Kaluga_Denny
Kaluga_Denny collected $0.10 from pot
Kaluga_Denny: doesn't show hand 
*** SUMMARY ***
Total pot $0.10 | Rake $0 
Seat 1: Leandra1808 folded before Flop (didn't bet)
Seat 2: 0TheMouse0 folded before Flop (didn't bet)
Seat 3: Pipser222 folded before Flop (didn't bet)
Seat 4: Oleg032 (button) folded before Flop (didn't bet)
Seat 5: skakalec90 (small blind) folded before Flop
Seat 6: Kaluga_Denny (big blind) collected ($0.10)



PokerStars Hand #222968282568:  Hold'em No Limit ($0.05/$0.10 USD) - 2021/01/23 15:09:11 ET
Table 'Merope IV' 6-max Seat #5 is the button
Seat 1: Leandra1808 ($17.95 in chips) 
Seat 2: 0TheMouse0 ($10.38 in chips) 
Seat 3: Pipser222 ($13.33 in chips) 
Seat 4: Oleg032 ($10.85 in chips) 
Seat 5: skakalec90 ($10 in chips) 
Seat 6: Kaluga_Denny ($3.35 in chips) 
Kaluga_Denny: posts small blind $0.05
Leandra1808: posts big blind $0.10
*** HOLE CARDS ***
0TheMouse0: folds 
Pipser222: folds 
Oleg032: folds 
skakalec90: raises $0.20 to $0.30
Kaluga_Denny: calls $0.25
Leandra1808: raises $0.20 to $0.50
skakalec90: calls $0.20
Kaluga_Denny: calls $0.20
*** FLOP *** [Kh 2h 3h]
Kaluga_Denny: checks 
Leandra1808: checks 
skakalec90: checks 
*** TURN *** [Kh 2h 3h] [Qc]
Kaluga_Denny: checks 
Leandra1808: bets $1.43
skakalec90: calls $1.43
Kaluga_Denny: folds 
*** RIVER *** [Kh 2h 3h Qc] [7c]
Leandra1808: checks 
skakalec90: checks 
*** SHOW DOWN ***
Leandra1808: shows [5d Jd] (high card King)
skakalec90: shows [Qd Ks] (two pair, Kings and Queens)
skakalec90 collected $4.16 from pot
*** SUMMARY ***
Total pot $4.36 | Rake $0.20 
Board [Kh 2h 3h Qc 7c]
Seat 1: Leandra1808 (big blind) showed [5d Jd] and lost with high card King
Seat 2: 0TheMouse0 folded before Flop (didn't bet)
Seat 3: Pipser222 folded before Flop (didn't bet)
Seat 4: Oleg032 folded before Flop (didn't bet)
Seat 5: skakalec90 (button) showed [Qd Ks] and won ($4.16) with two pair, Kings and Queens
Seat 6: Kaluga_Denny (small blind) folded on the Turn



PokerStars Hand #222968319968:  Hold'em No Limit ($0.05/$0.10 USD) - 2021/01/23 15:09:56 ET
Table 'Merope IV' 6-max Seat #6 is the button
Seat 1: Leandra1808 ($16.02 in chips) 
Seat 2: 0TheMouse0 ($10.38 in chips) 
Seat 3: Pipser222 ($13.33 in chips) 
Seat 4: Oleg032 ($10.85 in chips) 
Seat 5: skakalec90 ($12.23 in chips) 
Seat 6: Kaluga_Denny ($2.85 in chips) 
Leandra1808: posts small blind $0.05
0TheMouse0: posts big blind $0.10
*** HOLE CARDS ***
Pipser222: folds 
Oleg032: folds 
skakalec90: folds 
Kaluga_Denny: calls $0.10
Leandra1808: raises $0.10 to $0.20
0TheMouse0: calls $0.10
Kaluga_Denny: calls $0.10
*** FLOP *** [Ks Qh 8c]
Leandra1808: bets $0.57
0TheMouse0: folds 
Kaluga_Denny: folds 
Uncalled bet ($0.57) returned to Leandra1808
Leandra1808 collected $0.57 from pot
Leandra1808: doesn't show hand 
*** SUMMARY ***
Total pot $0.60 | Rake $0.03 
Board [Ks Qh 8c]
Seat 1: Leandra1808 (small blind) collected ($0.57)
Seat 2: 0TheMouse0 (big blind) folded on the Flop
Seat 3: Pipser222 folded before Flop (didn't bet)
Seat 4: Oleg032 folded before Flop (didn't bet)
Seat 5: skakalec90 folded before Flop (didn't bet)
Seat 6: Kaluga_Denny (button) folded on the Flop



PokerStars Hand #222968341094:  Hold'em No Limit ($0.05/$0.10 USD) - 2021/01/23 15:10:21 ET
Table 'Merope IV' 6-max Seat #1 is the button
Seat 1: Leandra1808 ($16.39 in chips) 
Seat 2: 0TheMouse0 ($10.18 in chips) 
Seat 3: Pipser222 ($13.33 in chips) 
Seat 4: Oleg032 ($10.85 in chips) 
Seat 5: skakalec90 ($12.23 in chips) 
Seat 6: Kaluga_Denny ($2.65 in chips) 
0TheMouse0: posts small blind $0.05
Pipser222: posts big blind $0.10
*** HOLE CARDS ***
Oleg032: folds 
skakalec90: folds 
Kaluga_Denny: folds 
Leandra1808: calls $0.10
0TheMouse0: folds 
Pipser222: raises $0.40 to $0.50
Leandra1808: calls $0.40
*** FLOP *** [7c 7h Td]
Pipser222: checks 
Leandra1808: bets $1
Pipser222: raises $1.50 to $2.50
Leandra1808: folds 
Uncalled bet ($1.50) returned to Pipser222
Pipser222 collected $2.91 from pot
Pipser222: doesn't show hand 
*** SUMMARY ***
Total pot $3.05 | Rake $0.14 
Board [7c 7h Td]
Seat 1: Leandra1808 (button) folded on the Flop
Seat 2: 0TheMouse0 (small blind) folded before Flop
Seat 3: Pipser222 (big blind) collected ($2.91)
Seat 4: Oleg032 folded before Flop (didn't bet)
Seat 5: skakalec90 folded before Flop (didn't bet)
Seat 6: Kaluga_Denny folded before Flop (didn't bet)



PokerStars Hand #222968375993:  Hold'em No Limit ($0.05/$0.10 USD) - 2021/01/23 15:11:02 ET
Table 'Merope IV' 6-max Seat #2 is the button
Seat 1: Leandra1808 ($14.89 in chips) 
Seat 2: 0TheMouse0 ($10.13 in chips) 
Seat 3: Pipser222 ($14.74 in chips) 
Seat 4: Oleg032 ($10.85 in chips) 
Seat 5: skakalec90 ($12.23 in chips) 
Seat 6: Kaluga_Denny ($2.65 in chips) 
Pipser222: posts small blind $0.05
Oleg032: posts big blind $0.10
*** HOLE CARDS ***
skakalec90: folds 
Kaluga_Denny: calls $0.10
Leandra1808: folds 
0TheMouse0: folds 
Pipser222: folds 
Oleg032: raises $0.25 to $0.35
Kaluga_Denny: folds 
Uncalled bet ($0.25) returned to Oleg032
Oleg032 collected $0.25 from pot
Oleg032: doesn't show hand 
*** SUMMARY ***
Total pot $0.25 | Rake $0 
Seat 1: Leandra1808 folded before Flop (didn't bet)
Seat 2: 0TheMouse0 (button) folded before Flop (didn't bet)
Seat 3: Pipser222 (small blind) folded before Flop
Seat 4: Oleg032 (big blind) collected ($0.25)
Seat 5: skakalec90 folded before Flop (didn't bet)
Seat 6: Kaluga_Denny folded before Flop



PokerStars Hand #222968391672:  Hold'em No Limit ($0.05/$0.10 USD) - 2021/01/23 15:11:21 ET
Table 'Merope IV' 6-max Seat #3 is the button
Seat 1: Leandra1808 ($14.89 in chips) 
Seat 2: 0TheMouse0 ($10.13 in chips) 
Seat 3: Pipser222 ($14.69 in chips) 
Seat 4: Oleg032 ($11 in chips) 
Seat 5: skakalec90 ($12.23 in chips) 
Seat 6: Kaluga_Denny ($2.55 in chips) 
Oleg032: posts small blind $0.05
skakalec90: posts big blind $0.10
*** HOLE CARDS ***
Kaluga_Denny: folds 
Leandra1808: folds 
0TheMouse0: folds 
Pipser222: folds 
Oleg032: folds 
Uncalled bet ($0.05) returned to skakalec90
skakalec90 collected $0.10 from pot
skakalec90: doesn't show hand 
*** SUMMARY ***
Total pot $0.10 | Rake $0 
Seat 1: Leandra1808 folded before Flop (didn't bet)
Seat 2: 0TheMouse0 folded before Flop (didn't bet)
Seat 3: Pipser222 (button) folded before Flop (didn't bet)
Seat 4: Oleg032 (small blind) folded before Flop
Seat 5: skakalec90 (big blind) collected ($0.10)
Seat 6: Kaluga_Denny folded before Flop (didn't bet)



PokerStars Hand #222968403631:  Hold'em No Limit ($0.05/$0.10 USD) - 2021/01/23 15:11:35 ET
Table 'Merope IV' 6-max Seat #4 is the button
Seat 2: 0TheMouse0 ($10.13 in chips) 
Seat 3: Pipser222 ($14.69 in chips) 
Seat 4: Oleg032 ($10.95 in chips) 
Seat 5: skakalec90 ($12.28 in chips) 
Seat 6: Kaluga_Denny ($2.55 in chips) 
skakalec90: posts small blind $0.05
Kaluga_Denny: posts big blind $0.10
*** HOLE CARDS ***
Leandra1808 is disconnected 
0TheMouse0: folds 
Pipser222: folds 
Oleg032: raises $0.15 to $0.25
skakalec90: folds 
Kaluga_Denny: folds 
Uncalled bet ($0.15) returned to Oleg032
Oleg032 collected $0.25 from pot
Oleg032: doesn't show hand 
*** SUMMARY ***
Total pot $0.25 | Rake $0 
Seat 2: 0TheMouse0 folded before Flop (didn't bet)
Seat 3: Pipser222 folded before Flop (didn't bet)
Seat 4: Oleg032 (button) collected ($0.25)
Seat 5: skakalec90 (small blind) folded before Flop
Seat 6: Kaluga_Denny (big blind) folded before Flop



PokerStars Hand #222968411860:  Hold'em No Limit ($0.05/$0.10 USD) - 2021/01/23 15:11:45 ET
Table 'Merope IV' 6-max Seat #5 is the button
Seat 2: 0TheMouse0 ($10.13 in chips) 
Seat 3: Pipser222 ($14.69 in chips) 
Seat 4: Oleg032 ($11.10 in chips) 
Seat 5: skakalec90 ($12.23 in chips) 
Seat 6: Kaluga_Denny ($2.45 in chips) 
Kaluga_Denny: posts small blind $0.05
0TheMouse0: posts big blind $0.10
*** HOLE CARDS ***
Pipser222: folds 
Oleg032: folds 
skakalec90: folds 
Kaluga_Denny: calls $0.05
0TheMouse0: raises $0.15 to $0.25
Kaluga_Denny: calls $0.15
*** FLOP *** [8s Qc Qd]
Kaluga_Denny: checks 
0TheMouse0: bets $0.16
Kaluga_Denny: calls $0.16
*** TURN *** [8s Qc Qd] [9c]
Kaluga_Denny: checks 
0TheMouse0: bets $0.65
Kaluga_Denny: folds 
Uncalled bet ($0.65) returned to 0TheMouse0
0TheMouse0 collected $0.78 from pot
0TheMouse0: doesn't show hand 
*** SUMMARY ***
Total pot $0.82 | Rake $0.04 
Board [8s Qc Qd 9c]
Seat 2: 0TheMouse0 (big blind) collected ($0.78)
Seat 3: Pipser222 folded before Flop (didn't bet)
Seat 4: Oleg032 folded before Flop (didn't bet)
Seat 5: skakalec90 (button) folded before Flop (didn't bet)
Seat 6: Kaluga_Denny (small blind) folded on the Turn



PokerStars Hand #222968443466:  Hold'em No Limit ($0.05/$0.10 USD) - 2021/01/23 15:12:15 ET
Table 'Merope IV' 6-max Seat #6 is the button
Seat 2: 0TheMouse0 ($10.50 in chips) 
Seat 3: Pipser222 ($14.69 in chips) 
Seat 4: Oleg032 ($11.10 in chips) 
Seat 5: skakalec90 ($12.23 in chips) 
Seat 6: Kaluga_Denny ($2.04 in chips) 
0TheMouse0: posts small blind $0.05
Pipser222: posts big blind $0.10
*** HOLE CARDS ***
Oleg032: folds 
skakalec90: folds 
Kaluga_Denny: calls $0.10
0TheMouse0: folds 
Pipser222: checks 
*** FLOP *** [9d 7d 3h]
Pipser222: checks 
Kaluga_Denny: checks 
*** TURN *** [9d 7d 3h] [As]
Pipser222: checks 
Kaluga_Denny: checks 
*** RIVER *** [9d 7d 3h As] [Td]
Pipser222: bets $0.10
Kaluga_Denny: raises $0.20 to $0.30
Pipser222: calls $0.20
*** SHOW DOWN ***
Kaluga_Denny: shows [Ts Ac] (two pair, Aces and Tens)
Pipser222: shows [8d Jh] (a straight, Seven to Jack)
Pipser222 collected $0.81 from pot
*** SUMMARY ***
Total pot $0.85 | Rake $0.04 
Board [9d 7d 3h As Td]
Seat 2: 0TheMouse0 (small blind) folded before Flop
Seat 3: Pipser222 (big blind) showed [8d Jh] and won ($0.81) with a straight, Seven to Jack
Seat 4: Oleg032 folded before Flop (didn't bet)
Seat 5: skakalec90 folded before Flop (didn't bet)
Seat 6: Kaluga_Denny (button) showed [Ts Ac] and lost with two pair, Aces and Tens



PokerStars Hand #222968467290:  Hold'em No Limit ($0.05/$0.10 USD) - 2021/01/23 15:12:43 ET
Table 'Merope IV' 6-max Seat #2 is the button
Seat 1: Leandra1808 ($14.89 in chips) 
Seat 2: 0TheMouse0 ($10.45 in chips) 
Seat 3: Pipser222 ($15.10 in chips) 
Seat 4: Oleg032 ($11.10 in chips) 
Seat 5: skakalec90 ($12.23 in chips) 
Seat 6: Kaluga_Denny ($1.64 in chips) 
Pipser222: posts small blind $0.05
Oleg032: posts big blind $0.10
Leandra1808 is disconnected 
Leandra1808 is connected 
Leandra1808: posts small & big blinds $0.15
*** HOLE CARDS ***
skakalec90: folds 
Kaluga_Denny: calls $0.10
Leandra1808: checks 
0TheMouse0 is disconnected 
0TheMouse0 has timed out while being disconnected
0TheMouse0: folds 
Pipser222: folds 
Oleg032: checks 
*** FLOP *** [Js 7h Th]
Oleg032: checks 
Kaluga_Denny: checks 
Leandra1808: checks 
*** TURN *** [Js 7h Th] [2h]
Oleg032: checks 
Kaluga_Denny: checks 
Leandra1808: bets $0.38
Oleg032: folds 
Kaluga_Denny: folds 
Uncalled bet ($0.38) returned to Leandra1808
Leandra1808 collected $0.38 from pot
Leandra1808: doesn't show hand 
*** SUMMARY ***
Total pot $0.40 | Rake $0.02 
Board [Js 7h Th 2h]
Seat 1: Leandra1808 collected ($0.38)
Seat 2: 0TheMouse0 (button) folded before Flop (didn't bet)
Seat 3: Pipser222 (small blind) folded before Flop
Seat 4: Oleg032 (big blind) folded on the Turn
Seat 5: skakalec90 folded before Flop (didn't bet)
Seat 6: Kaluga_Denny folded on the Turn



PokerStars Hand #222968518617:  Hold'em No Limit ($0.05/$0.10 USD) - 2021/01/23 15:13:44 ET
Table 'Merope IV' 6-max Seat #3 is the button
Seat 2: 0TheMouse0 ($10.45 in chips) 
Seat 3: Pipser222 ($15.05 in chips) 
Seat 4: Oleg032 ($11 in chips) 
Seat 5: skakalec90 ($12.23 in chips) 
Seat 6: Kaluga_Denny ($1.54 in chips) 
Oleg032: posts small blind $0.05
skakalec90: posts big blind $0.10
*** HOLE CARDS ***
Kaluga_Denny: calls $0.10
0TheMouse0: folds 
Pipser222: folds 
Oleg032: folds 
Leandra1808 is disconnected 
skakalec90: checks 
*** FLOP *** [Ac 9s 6c]
skakalec90: checks 
Kaluga_Denny: bets $0.10
skakalec90: folds 
Uncalled bet ($0.10) returned to Kaluga_Denny
Kaluga_Denny collected $0.24 from pot
Kaluga_Denny: doesn't show hand 
*** SUMMARY ***
Total pot $0.25 | Rake $0.01 
Board [Ac 9s 6c]
Seat 2: 0TheMouse0 folded before Flop (didn't bet)
Seat 3: Pipser222 (button) folded before Flop (didn't bet)
Seat 4: Oleg032 (small blind) folded before Flop
Seat 5: skakalec90 (big blind) folded on the Flop
Seat 6: Kaluga_Denny collected ($0.24)



PokerStars Hand #222968534109:  Hold'em No Limit ($0.05/$0.10 USD) - 2021/01/23 15:14:03 ET
Table 'Merope IV' 6-max Seat #4 is the button
Seat 2: 0TheMouse0 ($10.45 in chips) 
Seat 3: Pipser222 ($15.05 in chips) 
Seat 4: Oleg032 ($10.95 in chips) 
Seat 5: skakalec90 ($12.13 in chips) 
Seat 6: Kaluga_Denny ($1.68 in chips) 
skakalec90: posts small blind $0.05
Kaluga_Denny: posts big blind $0.10
*** HOLE CARDS ***
0TheMouse0: folds 
Pipser222: raises $0.17 to $0.27
Oleg032: folds 
skakalec90: raises $0.64 to $0.91
Kaluga_Denny: folds 
Pipser222: folds 
Uncalled bet ($0.64) returned to skakalec90
skakalec90 collected $0.64 from pot
skakalec90: doesn't show hand 
*** SUMMARY ***
Total pot $0.64 | Rake $0 
Seat 2: 0TheMouse0 folded before Flop (didn't bet)
Seat 3: Pipser222 folded before Flop
Seat 4: Oleg032 (button) folded before Flop (didn't bet)
Seat 5: skakalec90 (small blind) collected ($0.64)
Seat 6: Kaluga_Denny (big blind) folded before Flop



PokerStars Hand #222968550298:  Hold'em No Limit ($0.05/$0.10 USD) - 2021/01/23 15:14:22 ET
Table 'Merope IV' 6-max Seat #5 is the button
Seat 2: 0TheMouse0 ($10.45 in chips) 
Seat 3: Pipser222 ($14.78 in chips) 
Seat 4: Oleg032 ($10.95 in chips) 
Seat 5: skakalec90 ($12.50 in chips) 
Seat 6: Kaluga_Denny ($1.58 in chips) 
Kaluga_Denny: posts small blind $0.05
0TheMouse0: posts big blind $0.10
*** HOLE CARDS ***
Pipser222: folds 
Oleg032: folds 
skakalec90: raises $0.20 to $0.30
Kaluga_Denny: calls $0.25
0TheMouse0: raises $1.15 to $1.45
skakalec90: raises $3.15 to $4.60
Kaluga_Denny: calls $1.28 and is all-in
0TheMouse0: folds 
Uncalled bet ($3.02) returned to skakalec90
*** FLOP *** [5s 8d 2s]
*** TURN *** [5s 8d 2s] [Ts]
*** RIVER *** [5s 8d 2s Ts] [Kh]
*** SHOW DOWN ***
Kaluga_Denny: shows [Tc 8c] (two pair, Tens and Eights)
skakalec90: shows [Ah Ad] (a pair of Aces)
Kaluga_Denny collected $4.40 from pot
*** SUMMARY ***
Total pot $4.61 | Rake $0.21 
Board [5s 8d 2s Ts Kh]
Seat 2: 0TheMouse0 (big blind) folded before Flop
Seat 3: Pipser222 folded before Flop (didn't bet)
Seat 4: Oleg032 folded before Flop (didn't bet)
Seat 5: skakalec90 (button) showed [Ah Ad] and lost with a pair of Aces
Seat 6: Kaluga_Denny (small blind) showed [Tc 8c] and won ($4.40) with two pair, Tens and Eights



PokerStars Hand #222968584016:  Hold'em No Limit ($0.05/$0.10 USD) - 2021/01/23 15:15:03 ET
Table 'Merope IV' 6-max Seat #6 is the button
Seat 2: 0TheMouse0 ($10 in chips) 
Seat 3: Pipser222 ($14.78 in chips) 
Seat 4: Oleg032 ($10.95 in chips) 
Seat 5: skakalec90 ($10.92 in chips) 
Seat 6: Kaluga_Denny ($4.40 in chips) 
0TheMouse0: posts small blind $0.05
Pipser222: posts big blind $0.10
*** HOLE CARDS ***
Oleg032: folds 
skakalec90: folds 
Kaluga_Denny: folds 
0TheMouse0: raises $0.20 to $0.30
Pipser222: folds 
Uncalled bet ($0.20) returned to 0TheMouse0
0TheMouse0 collected $0.20 from pot
0TheMouse0: doesn't show hand 
*** SUMMARY ***
Total pot $0.20 | Rake $0 
Seat 2: 0TheMouse0 (small blind) collected ($0.20)
Seat 3: Pipser222 (big blind) folded before Flop
Seat 4: Oleg032 folded before Flop (didn't bet)
Seat 5: skakalec90 folded before Flop (didn't bet)
Seat 6: Kaluga_Denny (button) folded before Flop (didn't bet)



PokerStars Hand #222968596203:  Hold'em No Limit ($0.05/$0.10 USD) - 2021/01/23 15:15:16 ET
Table 'Merope IV' 6-max Seat #2 is the button
Seat 1: Leandra1808 ($15.12 in chips) 
Seat 2: 0TheMouse0 ($10.10 in chips) 
Seat 3: Pipser222 ($14.68 in chips) 
Seat 4: Oleg032 ($10.95 in chips) 
Seat 5: skakalec90 ($10.92 in chips) 
Seat 6: Kaluga_Denny ($4.40 in chips) 
Pipser222: posts small blind $0.05
Oleg032: posts big blind $0.10
Leandra1808: posts small & big blinds $0.15
*** HOLE CARDS ***
skakalec90: folds 
Kaluga_Denny: folds 
Leandra1808: checks 
0TheMouse0: folds 
Pipser222: folds 
Oleg032: checks 
*** FLOP *** [Kh Th Jc]
Oleg032: checks 
Leandra1808: checks 
*** TURN *** [Kh Th Jc] [3s]
Oleg032: bets $0.19
Leandra1808: calls $0.19
*** RIVER *** [Kh Th Jc 3s] [6d]
Oleg032: checks 
Leandra1808: checks 
*** SHOW DOWN ***
Oleg032: shows [Kd 8d] (a pair of Kings)
Leandra1808: mucks hand 
Oleg032 collected $0.65 from pot
*** SUMMARY ***
Total pot $0.68 | Rake $0.03 
Board [Kh Th Jc 3s 6d]
Seat 1: Leandra1808 mucked
Seat 2: 0TheMouse0 (button) folded before Flop (didn't bet)
Seat 3: Pipser222 (small blind) folded before Flop
Seat 4: Oleg032 (big blind) showed [Kd 8d] and won ($0.65) with a pair of Kings
Seat 5: skakalec90 folded before Flop (didn't bet)
Seat 6: Kaluga_Denny folded before Flop (didn't bet)



PokerStars Hand #222968632933:  Hold'em No Limit ($0.05/$0.10 USD) - 2021/01/23 15:15:59 ET
Table 'Merope IV' 6-max Seat #3 is the button
Seat 1: Leandra1808 ($14.78 in chips) 
Seat 2: 0TheMouse0 ($10.10 in chips) 
Seat 3: Pipser222 ($14.63 in chips) 
Seat 4: Oleg032 ($11.31 in chips) 
Seat 5: skakalec90 ($10.92 in chips) 
Seat 6: Kaluga_Denny ($4.40 in chips) 
Oleg032: posts small blind $0.05
skakalec90: posts big blind $0.10
*** HOLE CARDS ***
Kaluga_Denny: calls $0.10
Leandra1808: raises $0.10 to $0.20
0TheMouse0: folds 
Pipser222: folds 
Oleg032: raises $0.65 to $0.85
skakalec90: folds 
Kaluga_Denny: folds 
Leandra1808: calls $0.65
*** FLOP *** [5c 4c 6c]
Oleg032: checks 
Leandra1808: checks 
*** TURN *** [5c 4c 6c] [Th]
Oleg032: checks 
Leandra1808: bets $1.81
Oleg032: folds 
Uncalled bet ($1.81) returned to Leandra1808
Leandra1808 collected $1.81 from pot
Leandra1808: doesn't show hand 
*** SUMMARY ***
Total pot $1.90 | Rake $0.09 
Board [5c 4c 6c Th]
Seat 1: Leandra1808 collected ($1.81)
Seat 2: 0TheMouse0 folded before Flop (didn't bet)
Seat 3: Pipser222 (button) folded before Flop (didn't bet)
Seat 4: Oleg032 (small blind) folded on the Turn
Seat 5: skakalec90 (big blind) folded before Flop
Seat 6: Kaluga_Denny folded before Flop



PokerStars Hand #222971926629:  Hold'em No Limit ($0.05/$0.10 USD) - 2021/01/23 16:22:15 ET
Table 'Merope IV' 6-max Seat #6 is the button
Seat 1: Marsel89176 ($12.40 in chips) 
Seat 3: kimdim60 ($10.15 in chips) 
Seat 5: skakalec90 ($15.76 in chips) 
Seat 6: Kaluga_Denny ($4.13 in chips) 
Marsel89176: posts small blind $0.05
ganryu76: is sitting out 
kimdim60: posts big blind $0.10
*** HOLE CARDS ***
skakalec90: folds 
Kaluga_Denny: calls $0.10
Marsel89176: folds 
kimdim60: checks 
*** FLOP *** [Jc Tc 7h]
kimdim60: bets $0.18
Kaluga_Denny: calls $0.18
*** TURN *** [Jc Tc 7h] [7s]
kimdim60: checks 
Kaluga_Denny: checks 
*** RIVER *** [Jc Tc 7h 7s] [3s]
kimdim60: checks 
Kaluga_Denny: checks 
*** SHOW DOWN ***
kimdim60: shows [9s 4d] (a pair of Sevens)
Kaluga_Denny: shows [9d Qd] (a pair of Sevens - Queen kicker)
Kaluga_Denny collected $0.58 from pot
*** SUMMARY ***
Total pot $0.61 | Rake $0.03 
Board [Jc Tc 7h 7s 3s]
Seat 1: Marsel89176 (small blind) folded before Flop
Seat 3: kimdim60 (big blind) showed [9s 4d] and lost with a pair of Sevens
Seat 5: skakalec90 folded before Flop (didn't bet)
Seat 6: Kaluga_Denny (button) showed [9d Qd] and won ($0.58) with a pair of Sevens



PokerStars Hand #222971950541:  Hold'em No Limit ($0.05/$0.10 USD) - 2021/01/23 16:22:43 ET
Table 'Merope IV' 6-max Seat #1 is the button
Seat 1: Marsel89176 ($12.35 in chips) 
Seat 3: kimdim60 ($10 in chips) 
Seat 5: skakalec90 ($15.76 in chips) 
Seat 6: Kaluga_Denny ($4.43 in chips) 
kimdim60: posts small blind $0.05
skakalec90: posts big blind $0.10
*** HOLE CARDS ***
Kaluga_Denny: folds 
Marsel89176: raises $0.15 to $0.25
ganryu76 leaves the table
kimdim60: raises $0.75 to $1
skakalec90: folds 
Marsel89176: calls $0.75
*** FLOP *** [5d Jc 4d]
kimdim60: bets $0.60
Marsel89176: folds 
Uncalled bet ($0.60) returned to kimdim60
kimdim60 collected $2.01 from pot
*** SUMMARY ***
Total pot $2.10 | Rake $0.09 
Board [5d Jc 4d]
Seat 1: Marsel89176 (button) folded on the Flop
Seat 3: kimdim60 (small blind) collected ($2.01)
Seat 5: skakalec90 (big blind) folded before Flop
Seat 6: Kaluga_Denny folded before Flop (didn't bet)



PokerStars Hand #222971981481:  Hold'em No Limit ($0.05/$0.10 USD) - 2021/01/23 16:23:11 ET
Table 'Merope IV' 6-max Seat #3 is the button
Seat 1: Marsel89176 ($11.35 in chips) 
Seat 3: kimdim60 ($11.01 in chips) 
Seat 5: skakalec90 ($15.66 in chips) 
Seat 6: Kaluga_Denny ($4.43 in chips) 
skakalec90: posts small blind $0.05
Kaluga_Denny: posts big blind $0.10
*** HOLE CARDS ***
Marsel89176: raises $0.20 to $0.30
kimdim60: raises $0.75 to $1.05
skakalec90: folds 
Kaluga_Denny: folds 
GMusk joins the table at seat #2 
Marsel89176: raises $2.15 to $3.20
kimdim60: folds 
Uncalled bet ($2.15) returned to Marsel89176
Marsel89176 collected $2.25 from pot
Marsel89176: doesn't show hand 
*** SUMMARY ***
Total pot $2.25 | Rake $0 
Seat 1: Marsel89176 collected ($2.25)
Seat 3: kimdim60 (button) folded before Flop
Seat 5: skakalec90 (small blind) folded before Flop
Seat 6: Kaluga_Denny (big blind) folded before Flop



PokerStars Hand #222972004547:  Hold'em No Limit ($0.05/$0.10 USD) - 2021/01/23 16:23:38 ET
Table 'Merope IV' 6-max Seat #5 is the button
Seat 2: GMusk ($8 in chips) 
Seat 3: kimdim60 ($10 in chips) 
Seat 5: skakalec90 ($15.61 in chips) 
Seat 6: Kaluga_Denny ($4.33 in chips) 
Kaluga_Denny: posts small blind $0.05
Marsel89176: is sitting out 
GMusk: posts big blind $0.10
*** HOLE CARDS ***
kimdim60: folds 
Marsel89176 leaves the table
ganryu76 joins the table at seat #1 
skakalec90: raises $0.20 to $0.30
Kaluga_Denny: folds 
Superyugo1979 joins the table at seat #4 
GMusk: calls $0.20
*** FLOP *** [Qs Qc 5c]
GMusk: checks 
skakalec90: bets $0.31
GMusk: folds 
Uncalled bet ($0.31) returned to skakalec90
skakalec90 collected $0.62 from pot
skakalec90: doesn't show hand 
*** SUMMARY ***
Total pot $0.65 | Rake $0.03 
Board [Qs Qc 5c]
Seat 2: GMusk (big blind) folded on the Flop
Seat 3: kimdim60 folded before Flop (didn't bet)
Seat 5: skakalec90 (button) collected ($0.62)
Seat 6: Kaluga_Denny (small blind) folded before Flop



PokerStars Hand #222972028058:  Hold'em No Limit ($0.05/$0.10 USD) - 2021/01/23 16:24:06 ET
Table 'Merope IV' 6-max Seat #6 is the button
Seat 2: GMusk ($7.70 in chips) 
Seat 3: kimdim60 ($10 in chips) 
Seat 4: Superyugo1979 ($4.63 in chips) 
Seat 5: skakalec90 ($15.93 in chips) 
Seat 6: Kaluga_Denny ($4.28 in chips) 
GMusk: posts small blind $0.05
kimdim60: posts big blind $0.10
Superyugo1979: posts big blind $0.10
*** HOLE CARDS ***
Superyugo1979: checks 
skakalec90: raises $0.20 to $0.30
Kaluga_Denny: folds 
GMusk: folds 
kimdim60: folds 
Superyugo1979: calls $0.20
*** FLOP *** [8h Jc 8d]
Superyugo1979: checks 
skakalec90: checks 
*** TURN *** [8h Jc 8d] [9c]
Superyugo1979: checks 
skakalec90: checks 
*** RIVER *** [8h Jc 8d 9c] [9s]
Superyugo1979: checks 
skakalec90: checks 
*** SHOW DOWN ***
Superyugo1979: shows [4s 2h] (two pair, Nines and Eights)
skakalec90: shows [Qc Ah] (two pair, Nines and Eights - Ace kicker)
skakalec90 collected $0.72 from pot
*** SUMMARY ***
Total pot $0.75 | Rake $0.03 
Board [8h Jc 8d 9c 9s]
Seat 2: GMusk (small blind) folded before Flop
Seat 3: kimdim60 (big blind) folded before Flop
Seat 4: Superyugo1979 showed [4s 2h] and lost with two pair, Nines and Eights
Seat 5: skakalec90 showed [Qc Ah] and won ($0.72) with two pair, Nines and Eights
Seat 6: Kaluga_Denny (button) folded before Flop (didn't bet)



PokerStars Hand #222972057741:  Hold'em No Limit ($0.05/$0.10 USD) - 2021/01/23 16:24:41 ET
Table 'Merope IV' 6-max Seat #2 is the button
Seat 2: GMusk ($7.65 in chips) 
Seat 3: kimdim60 ($10 in chips) 
Seat 4: Superyugo1979 ($4.33 in chips) 
Seat 5: skakalec90 ($16.35 in chips) 
Seat 6: Kaluga_Denny ($4.28 in chips) 
kimdim60: posts small blind $0.05
Superyugo1979: posts big blind $0.10
ganryu76: sits out 
*** HOLE CARDS ***
skakalec90: folds 
Kaluga_Denny: folds 
GMusk: folds 
kimdim60: folds 
Uncalled bet ($0.05) returned to Superyugo1979
Superyugo1979 collected $0.10 from pot
Superyugo1979: doesn't show hand 
*** SUMMARY ***
Total pot $0.10 | Rake $0 
Seat 2: GMusk (button) folded before Flop (didn't bet)
Seat 3: kimdim60 (small blind) folded before Flop
Seat 4: Superyugo1979 (big blind) collected ($0.10)
Seat 5: skakalec90 folded before Flop (didn't bet)
Seat 6: Kaluga_Denny folded before Flop (didn't bet)



PokerStars Hand #222972070836:  Hold'em No Limit ($0.05/$0.10 USD) - 2021/01/23 16:24:56 ET
Table 'Merope IV' 6-max Seat #3 is the button
Seat 2: GMusk ($7.65 in chips) 
Seat 3: kimdim60 ($10 in chips) 
Seat 4: Superyugo1979 ($4.38 in chips) 
Seat 5: skakalec90 ($16.35 in chips) 
Seat 6: Kaluga_Denny ($4.28 in chips) 
Superyugo1979: posts small blind $0.05
skakalec90: posts big blind $0.10
ganryu76: sits out 
*** HOLE CARDS ***
Kaluga_Denny: folds 
GMusk: raises $0.10 to $0.20
kimdim60: folds 
Superyugo1979: calls $0.15
skakalec90: calls $0.10
*** FLOP *** [8d Kc 6s]
Superyugo1979: bets $0.57
skakalec90: folds 
GMusk: calls $0.57
*** TURN *** [8d Kc 6s] [9c]
Superyugo1979: bets $3.61 and is all-in
GMusk: calls $3.61
*** RIVER *** [8d Kc 6s 9c] [7c]
*** SHOW DOWN ***
Superyugo1979: shows [Kd 9h] (two pair, Kings and Nines)
GMusk: shows [Ks 7s] (two pair, Kings and Sevens)
Superyugo1979 collected $8.56 from pot
*** SUMMARY ***
Total pot $8.96 | Rake $0.40 
Board [8d Kc 6s 9c 7c]
Seat 2: GMusk showed [Ks 7s] and lost with two pair, Kings and Sevens
Seat 3: kimdim60 (button) folded before Flop (didn't bet)
Seat 4: Superyugo1979 (small blind) showed [Kd 9h] and won ($8.56) with two pair, Kings and Nines
Seat 5: skakalec90 (big blind) folded on the Flop
Seat 6: Kaluga_Denny folded before Flop (didn't bet)



PokerStars Hand #222972108548:  Hold'em No Limit ($0.05/$0.10 USD) - 2021/01/23 16:25:41 ET
Table 'Merope IV' 6-max Seat #4 is the button
Seat 2: GMusk ($3.27 in chips) 
Seat 3: kimdim60 ($10 in chips) 
Seat 4: Superyugo1979 ($8.56 in chips) 
Seat 5: skakalec90 ($16.15 in chips) 
Seat 6: Kaluga_Denny ($4.28 in chips) 
skakalec90: posts small blind $0.05
Kaluga_Denny: posts big blind $0.10
ganryu76: sits out 
*** HOLE CARDS ***
GMusk: calls $0.10
kimdim60: folds 
Superyugo1979: calls $0.10
skakalec90: folds 
Kaluga_Denny: checks 
*** FLOP *** [7c Qs 9d]
Kaluga_Denny: checks 
GMusk: checks 
Superyugo1979: checks 
*** TURN *** [7c Qs 9d] [3d]
Kaluga_Denny: checks 
GMusk: bets $0.20
Superyugo1979: folds 
Kaluga_Denny: folds 
Uncalled bet ($0.20) returned to GMusk
GMusk collected $0.33 from pot
*** SUMMARY ***
Total pot $0.35 | Rake $0.02 
Board [7c Qs 9d 3d]
Seat 2: GMusk collected ($0.33)
Seat 3: kimdim60 folded before Flop (didn't bet)
Seat 4: Superyugo1979 (button) folded on the Turn
Seat 5: skakalec90 (small blind) folded before Flop
Seat 6: Kaluga_Denny (big blind) folded on the Turn



PokerStars Hand #222972137914:  Hold'em No Limit ($0.05/$0.10 USD) - 2021/01/23 16:26:15 ET
Table 'Merope IV' 6-max Seat #5 is the button
Seat 1: ganryu76 ($13.54 in chips) 
Seat 2: GMusk ($3.50 in chips) 
Seat 3: kimdim60 ($10 in chips) 
Seat 4: Superyugo1979 ($8.46 in chips) 
Seat 5: skakalec90 ($16.10 in chips) 
Seat 6: Kaluga_Denny ($4.18 in chips) 
Kaluga_Denny: posts small blind $0.05
ganryu76: posts big blind $0.10
*** HOLE CARDS ***
GMusk: folds 
kimdim60: folds 
Superyugo1979: folds 
skakalec90: raises $0.10 to $0.20
Kaluga_Denny: folds 
ganryu76: raises $0.60 to $0.80
skakalec90: folds 
Uncalled bet ($0.60) returned to ganryu76
ganryu76 collected $0.45 from pot
ganryu76: doesn't show hand 
*** SUMMARY ***
Total pot $0.45 | Rake $0 
Seat 1: ganryu76 (big blind) collected ($0.45)
Seat 2: GMusk folded before Flop (didn't bet)
Seat 3: kimdim60 folded before Flop (didn't bet)
Seat 4: Superyugo1979 folded before Flop (didn't bet)
Seat 5: skakalec90 (button) folded before Flop
Seat 6: Kaluga_Denny (small blind) folded before Flop



PokerStars Hand #222972154867:  Hold'em No Limit ($0.05/$0.10 USD) - 2021/01/23 16:26:35 ET
Table 'Merope IV' 6-max Seat #6 is the button
Seat 1: ganryu76 ($13.79 in chips) 
Seat 2: GMusk ($3.50 in chips) 
Seat 3: kimdim60 ($10 in chips) 
Seat 4: Superyugo1979 ($8.46 in chips) 
Seat 5: skakalec90 ($15.90 in chips) 
Seat 6: Kaluga_Denny ($4.13 in chips) 
ganryu76: posts small blind $0.05
GMusk: posts big blind $0.10
*** HOLE CARDS ***
kimdim60: folds 
Superyugo1979: folds 
skakalec90: raises $0.20 to $0.30
Kaluga_Denny: calls $0.30
ganryu76: folds 
GMusk: folds 
*** FLOP *** [Tc Qs 7d]
skakalec90: checks 
Kaluga_Denny: checks 
*** TURN *** [Tc Qs 7d] [Jd]
skakalec90: checks 
Kaluga_Denny: checks 
*** RIVER *** [Tc Qs 7d Jd] [Ah]
skakalec90: checks 
Kaluga_Denny: checks 
*** SHOW DOWN ***
skakalec90: shows [9s 9d] (a pair of Nines)
Kaluga_Denny: shows [Jh Ac] (two pair, Aces and Jacks)
Kaluga_Denny collected $0.72 from pot
*** SUMMARY ***
Total pot $0.75 | Rake $0.03 
Board [Tc Qs 7d Jd Ah]
Seat 1: ganryu76 (small blind) folded before Flop
Seat 2: GMusk (big blind) folded before Flop
Seat 3: kimdim60 folded before Flop (didn't bet)
Seat 4: Superyugo1979 folded before Flop (didn't bet)
Seat 5: skakalec90 showed [9s 9d] and lost with a pair of Nines
Seat 6: Kaluga_Denny (button) showed [Jh Ac] and won ($0.72) with two pair, Aces and Jacks



PokerStars Hand #222972177610:  Hold'em No Limit ($0.05/$0.10 USD) - 2021/01/23 16:27:02 ET
Table 'Merope IV' 6-max Seat #1 is the button
Seat 1: ganryu76 ($13.74 in chips) 
Seat 2: GMusk ($3.40 in chips) 
Seat 3: kimdim60 ($10 in chips) 
Seat 4: Superyugo1979 ($8.46 in chips) 
Seat 5: skakalec90 ($15.60 in chips) 
Seat 6: Kaluga_Denny ($4.55 in chips) 
GMusk: posts small blind $0.05
kimdim60: posts big blind $0.10
*** HOLE CARDS ***
Superyugo1979: folds 
skakalec90: folds 
Kaluga_Denny: folds 
ganryu76: raises $0.15 to $0.25
GMusk: calls $0.20
kimdim60: folds 
*** FLOP *** [Ac Tc 5c]
GMusk: checks 
ganryu76: bets $0.43
GMusk: folds 
Uncalled bet ($0.43) returned to ganryu76
ganryu76 collected $0.57 from pot
ganryu76: doesn't show hand 
*** SUMMARY ***
Total pot $0.60 | Rake $0.03 
Board [Ac Tc 5c]
Seat 1: ganryu76 (button) collected ($0.57)
Seat 2: GMusk (small blind) folded on the Flop
Seat 3: kimdim60 (big blind) folded before Flop
Seat 4: Superyugo1979 folded before Flop (didn't bet)
Seat 5: skakalec90 folded before Flop (didn't bet)
Seat 6: Kaluga_Denny folded before Flop (didn't bet)



PokerStars Hand #222972212027:  Hold'em No Limit ($0.05/$0.10 USD) - 2021/01/23 16:27:42 ET
Table 'Merope IV' 6-max Seat #2 is the button
Seat 1: ganryu76 ($14.06 in chips) 
Seat 2: GMusk ($3.15 in chips) 
Seat 3: kimdim60 ($10 in chips) 
Seat 4: Superyugo1979 ($8.46 in chips) 
Seat 5: skakalec90 ($15.60 in chips) 
Seat 6: Kaluga_Denny ($4.55 in chips) 
kimdim60: posts small blind $0.05
Superyugo1979: posts big blind $0.10
*** HOLE CARDS ***
skakalec90: folds 
Kaluga_Denny: calls $0.10
ganryu76: folds 
GMusk: raises $0.20 to $0.30
kimdim60: folds 
Superyugo1979: calls $0.20
Kaluga_Denny: calls $0.20
*** FLOP *** [2d Ah Kd]
Superyugo1979: checks 
Kaluga_Denny: checks 
GMusk: bets $0.30
Superyugo1979: folds 
Kaluga_Denny: calls $0.30
*** TURN *** [2d Ah Kd] [5h]
Kaluga_Denny: checks 
GMusk: bets $0.30
Kaluga_Denny: calls $0.30
*** RIVER *** [2d Ah Kd 5h] [Qh]
Kaluga_Denny: checks 
GMusk: checks 
*** SHOW DOWN ***
Kaluga_Denny: shows [Qc Ad] (two pair, Aces and Queens)
GMusk: mucks hand 
Kaluga_Denny collected $2.05 from pot
*** SUMMARY ***
Total pot $2.15 | Rake $0.10 
Board [2d Ah Kd 5h Qh]
Seat 1: ganryu76 folded before Flop (didn't bet)
Seat 2: GMusk (button) mucked
Seat 3: kimdim60 (small blind) folded before Flop
Seat 4: Superyugo1979 (big blind) folded on the Flop
Seat 5: skakalec90 folded before Flop (didn't bet)
Seat 6: Kaluga_Denny showed [Qc Ad] and won ($2.05) with two pair, Aces and Queens



PokerStars Hand #222972246372:  Hold'em No Limit ($0.05/$0.10 USD) - 2021/01/23 16:28:23 ET
Table 'Merope IV' 6-max Seat #3 is the button
Seat 1: ganryu76 ($14.06 in chips) 
Seat 2: GMusk ($2.25 in chips) 
Seat 3: kimdim60 ($10 in chips) 
Seat 4: Superyugo1979 ($8.16 in chips) 
Seat 5: skakalec90 ($15.60 in chips) 
Seat 6: Kaluga_Denny ($5.70 in chips) 
Superyugo1979: posts small blind $0.05
skakalec90: posts big blind $0.10
*** HOLE CARDS ***
Kaluga_Denny: calls $0.10
ganryu76: raises $0.30 to $0.40
GMusk: raises $1.85 to $2.25 and is all-in
kimdim60: folds 
Superyugo1979: folds 
skakalec90: folds 
Kaluga_Denny: folds 
ganryu76: calls $1.85
GMusk has timed out
*** FLOP *** [Jd 7h 7d]
*** TURN *** [Jd 7h 7d] [Kc]
*** RIVER *** [Jd 7h 7d Kc] [2s]
*** SHOW DOWN ***
ganryu76: shows [Kd Qd] (two pair, Kings and Sevens)
GMusk: shows [8s 8d] (two pair, Eights and Sevens)
ganryu76 collected $4.54 from pot
*** SUMMARY ***
Total pot $4.75 | Rake $0.21 
Board [Jd 7h 7d Kc 2s]
Seat 1: ganryu76 showed [Kd Qd] and won ($4.54) with two pair, Kings and Sevens
Seat 2: GMusk showed [8s 8d] and lost with two pair, Eights and Sevens
Seat 3: kimdim60 (button) folded before Flop (didn't bet)
Seat 4: Superyugo1979 (small blind) folded before Flop
Seat 5: skakalec90 (big blind) folded before Flop
Seat 6: Kaluga_Denny folded before Flop



PokerStars Hand #222972285146:  Hold'em No Limit ($0.05/$0.10 USD) - 2021/01/23 16:29:09 ET
Table 'Merope IV' 6-max Seat #4 is the button
Seat 1: ganryu76 ($16.35 in chips) 
Seat 3: kimdim60 ($10 in chips) 
Seat 4: Superyugo1979 ($8.11 in chips) 
Seat 5: skakalec90 ($15.50 in chips) 
Seat 6: Kaluga_Denny ($5.60 in chips) 
skakalec90: posts small blind $0.05
Kaluga_Denny: posts big blind $0.10
*** HOLE CARDS ***
ganryu76: folds 
kimdim60: raises $0.16 to $0.26
Superyugo1979: calls $0.26
GMusk leaves the table
skakalec90: folds 
Kaluga_Denny: calls $0.16
*** FLOP *** [Kd 3c 5c]
genad joins the table at seat #2 
Kaluga_Denny: checks 
kimdim60: checks 
Superyugo1979: bets $0.39
Kaluga_Denny: folds 
kimdim60: folds 
Uncalled bet ($0.39) returned to Superyugo1979
Superyugo1979 collected $0.79 from pot
Superyugo1979: doesn't show hand 
*** SUMMARY ***
Total pot $0.83 | Rake $0.04 
Board [Kd 3c 5c]
Seat 1: ganryu76 folded before Flop (didn't bet)
Seat 3: kimdim60 folded on the Flop
Seat 4: Superyugo1979 (button) collected ($0.79)
Seat 5: skakalec90 (small blind) folded before Flop
Seat 6: Kaluga_Denny (big blind) folded on the Flop



PokerStars Hand #222972306756:  Hold'em No Limit ($0.05/$0.10 USD) - 2021/01/23 16:29:34 ET
Table 'Merope IV' 6-max Seat #5 is the button
Seat 1: ganryu76 ($16.35 in chips) 
Seat 3: kimdim60 ($10 in chips) 
Seat 4: Superyugo1979 ($8.64 in chips) 
Seat 5: skakalec90 ($15.45 in chips) 
Seat 6: Kaluga_Denny ($5.34 in chips) 
Kaluga_Denny: posts small blind $0.05
ganryu76: posts big blind $0.10
genad: sits out 
*** HOLE CARDS ***
kimdim60: folds 
Superyugo1979: raises $0.10 to $0.20
skakalec90: folds 
Kaluga_Denny: calls $0.15
ganryu76: folds 
*** FLOP *** [6h Ks Tc]
Kaluga_Denny: checks 
Superyugo1979: bets $0.50
Kaluga_Denny: folds 
Uncalled bet ($0.50) returned to Superyugo1979
Superyugo1979 collected $0.48 from pot
Superyugo1979: doesn't show hand 
*** SUMMARY ***
Total pot $0.50 | Rake $0.02 
Board [6h Ks Tc]
Seat 1: ganryu76 (big blind) folded before Flop
Seat 3: kimdim60 folded before Flop (didn't bet)
Seat 4: Superyugo1979 collected ($0.48)
Seat 5: skakalec90 (button) folded before Flop (didn't bet)
Seat 6: Kaluga_Denny (small blind) folded on the Flop



PokerStars Hand #222972340093:  Hold'em No Limit ($0.05/$0.10 USD) - 2021/01/23 16:30:13 ET
Table 'Merope IV' 6-max Seat #6 is the button
Seat 1: ganryu76 ($16.25 in chips) 
Seat 2: genad ($10 in chips) 
Seat 3: kimdim60 ($10 in chips) 
Seat 4: Superyugo1979 ($8.92 in chips) 
Seat 5: skakalec90 ($15.45 in chips) 
Seat 6: Kaluga_Denny ($5.14 in chips) 
ganryu76: posts small blind $0.05
genad: posts big blind $0.10
*** HOLE CARDS ***
kimdim60: folds 
Superyugo1979: calls $0.10
skakalec90: folds 
Kaluga_Denny: calls $0.10
ganryu76: folds 
genad: checks 
*** FLOP *** [6h 5c 3d]
genad: checks 
Superyugo1979: checks 
Kaluga_Denny: checks 
*** TURN *** [6h 5c 3d] [5s]
genad: bets $0.25
Superyugo1979: folds 
Kaluga_Denny: folds 
Uncalled bet ($0.25) returned to genad
genad collected $0.33 from pot
genad: doesn't show hand 
*** SUMMARY ***
Total pot $0.35 | Rake $0.02 
Board [6h 5c 3d 5s]
Seat 1: ganryu76 (small blind) folded before Flop
Seat 2: genad (big blind) collected ($0.33)
Seat 3: kimdim60 folded before Flop (didn't bet)
Seat 4: Superyugo1979 folded on the Turn
Seat 5: skakalec90 folded before Flop (didn't bet)
Seat 6: Kaluga_Denny (button) folded on the Turn



PokerStars Hand #222972398184:  Hold'em No Limit ($0.05/$0.10 USD) - 2021/01/23 16:31:17 ET
Table 'Merope IV' 6-max Seat #1 is the button
Seat 1: ganryu76 ($16.20 in chips) 
Seat 2: genad ($10.23 in chips) 
Seat 3: kimdim60 ($10 in chips) 
Seat 4: Superyugo1979 ($8.82 in chips) 
Seat 5: skakalec90 ($15.45 in chips) 
Seat 6: Kaluga_Denny ($5.04 in chips) 
genad: posts small blind $0.05
kimdim60: posts big blind $0.10
*** HOLE CARDS ***
Superyugo1979: folds 
skakalec90: folds 
Kaluga_Denny: folds 
ganryu76: folds 
genad: folds 
Uncalled bet ($0.05) returned to kimdim60
kimdim60 collected $0.10 from pot
kimdim60: doesn't show hand 
*** SUMMARY ***
Total pot $0.10 | Rake $0 
Seat 1: ganryu76 (button) folded before Flop (didn't bet)
Seat 2: genad (small blind) folded before Flop
Seat 3: kimdim60 (big blind) collected ($0.10)
Seat 4: Superyugo1979 folded before Flop (didn't bet)
Seat 5: skakalec90 folded before Flop (didn't bet)
Seat 6: Kaluga_Denny folded before Flop (didn't bet)



PokerStars Hand #222972967191:  Hold'em No Limit ($0.05/$0.10 USD) - 2021/01/23 16:42:26 ET
Table 'Merope IV' 6-max Seat #5 is the button
Seat 1: SrPan89 ($10 in chips) 
Seat 2: genad ($11.44 in chips) 
Seat 3: 69LU58CA69 ($13.68 in chips) 
Seat 4: ignaciospc ($10 in chips) 
Seat 5: skakalec90 ($14.99 in chips) 
SrPan89: posts small blind $0.05
genad: posts big blind $0.10
*** HOLE CARDS ***
69LU58CA69: calls $0.10
ignaciospc: folds 
skakalec90: folds 
SrPan89: folds 
genad: raises $0.40 to $0.50
69LU58CA69: calls $0.40
*** FLOP *** [2s 2d 9s]
genad: checks 
69LU58CA69: bets $1
genad: calls $1
*** TURN *** [2s 2d 9s] [3s]
genad: checks 
69LU58CA69: bets $1.50
genad: calls $1.50
*** RIVER *** [2s 2d 9s 3s] [Ad]
genad: checks 
69LU58CA69: bets $2.50
genad: raises $5.94 to $8.44 and is all-in
69LU58CA69: folds 
Uncalled bet ($5.94) returned to genad
genad collected $10.55 from pot
genad: doesn't show hand 
*** SUMMARY ***
Total pot $11.05 | Rake $0.50 
Board [2s 2d 9s 3s Ad]
Seat 1: SrPan89 (small blind) folded before Flop
Seat 2: genad (big blind) collected ($10.55)
Seat 3: 69LU58CA69 folded on the River
Seat 4: ignaciospc folded before Flop (didn't bet)
Seat 5: skakalec90 (button) folded before Flop (didn't bet)



PokerStars Hand #222973063331:  Hold'em No Limit ($0.05/$0.10 USD) - 2021/01/23 16:44:23 ET
Table 'Merope IV' 6-max Seat #1 is the button
Seat 1: SrPan89 ($10 in chips) 
Seat 2: genad ($16.49 in chips) 
Seat 3: 69LU58CA69 ($8.18 in chips) 
Seat 4: ignaciospc ($10 in chips) 
Seat 5: skakalec90 ($14.99 in chips) 
genad: posts small blind $0.05
69LU58CA69: posts big blind $0.10
Just_Million: sits out 
*** HOLE CARDS ***
ignaciospc: folds 
skakalec90: folds 
SrPan89: folds 
genad: raises $0.20 to $0.30
69LU58CA69: calls $0.20
*** FLOP *** [6h 4h Kh]
genad: bets $0.20
69LU58CA69: calls $0.20
*** TURN *** [6h 4h Kh] [6d]
genad: checks 
69LU58CA69: checks 
*** RIVER *** [6h 4h Kh 6d] [Td]
genad: checks 
69LU58CA69: checks 
*** SHOW DOWN ***
genad: shows [Qd Kd] (two pair, Kings and Sixes)
69LU58CA69: mucks hand 
genad collected $0.96 from pot
*** SUMMARY ***
Total pot $1 | Rake $0.04 
Board [6h 4h Kh 6d Td]
Seat 1: SrPan89 (button) folded before Flop (didn't bet)
Seat 2: genad (small blind) showed [Qd Kd] and won ($0.96) with two pair, Kings and Sixes
Seat 3: 69LU58CA69 (big blind) mucked
Seat 4: ignaciospc folded before Flop (didn't bet)
Seat 5: skakalec90 folded before Flop (didn't bet)



PokerStars Hand #222973087940:  Hold'em No Limit ($0.05/$0.10 USD) - 2021/01/23 16:44:53 ET
Table 'Merope IV' 6-max Seat #2 is the button
Seat 1: SrPan89 ($10 in chips) 
Seat 2: genad ($16.95 in chips) 
Seat 3: 69LU58CA69 ($7.68 in chips) 
Seat 4: ignaciospc ($10 in chips) 
Seat 5: skakalec90 ($14.99 in chips) 
69LU58CA69: posts small blind $0.05
ignaciospc: posts big blind $0.10
Just_Million: sits out 
*** HOLE CARDS ***
skakalec90: folds 
SrPan89: folds 
genad: raises $0.15 to $0.25
69LU58CA69: folds 
ignaciospc: folds 
Uncalled bet ($0.15) returned to genad
genad collected $0.25 from pot
genad: doesn't show hand 
*** SUMMARY ***
Total pot $0.25 | Rake $0 
Seat 1: SrPan89 folded before Flop (didn't bet)
Seat 2: genad (button) collected ($0.25)
Seat 3: 69LU58CA69 (small blind) folded before Flop
Seat 4: ignaciospc (big blind) folded before Flop
Seat 5: skakalec90 folded before Flop (didn't bet)



PokerStars Hand #222973096812:  Hold'em No Limit ($0.05/$0.10 USD) - 2021/01/23 16:45:04 ET
Table 'Merope IV' 6-max Seat #3 is the button
Seat 1: SrPan89 ($10 in chips) 
Seat 2: genad ($17.10 in chips) 
Seat 3: 69LU58CA69 ($7.63 in chips) 
Seat 4: ignaciospc ($10 in chips) 
Seat 5: skakalec90 ($14.99 in chips) 
ignaciospc: posts small blind $0.05
skakalec90: posts big blind $0.10
Just_Million: sits out 
*** HOLE CARDS ***
SrPan89: folds 
genad: raises $0.15 to $0.25
69LU58CA69: raises $0.65 to $0.90
ignaciospc: folds 
skakalec90: folds 
genad: folds 
Uncalled bet ($0.65) returned to 69LU58CA69
69LU58CA69 collected $0.65 from pot
69LU58CA69: doesn't show hand 
*** SUMMARY ***
Total pot $0.65 | Rake $0 
Seat 1: SrPan89 folded before Flop (didn't bet)
Seat 2: genad folded before Flop
Seat 3: 69LU58CA69 (button) collected ($0.65)
Seat 4: ignaciospc (small blind) folded before Flop
Seat 5: skakalec90 (big blind) folded before Flop



PokerStars Hand #222973107110:  Hold'em No Limit ($0.05/$0.10 USD) - 2021/01/23 16:45:16 ET
Table 'Merope IV' 6-max Seat #4 is the button
Seat 1: SrPan89 ($10 in chips) 
Seat 2: genad ($16.85 in chips) 
Seat 3: 69LU58CA69 ($8.03 in chips) 
Seat 4: ignaciospc ($10 in chips) 
Seat 5: skakalec90 ($14.89 in chips) 
Seat 6: Just_Million ($10 in chips) 
skakalec90: posts small blind $0.05
Just_Million: posts big blind $0.10
*** HOLE CARDS ***
SrPan89: folds 
genad: folds 
69LU58CA69: raises $0.20 to $0.30
ignaciospc: folds 
skakalec90: folds 
Just_Million: calls $0.20
*** FLOP *** [7c 7h Ac]
Just_Million: checks 
69LU58CA69: bets $0.55
Just_Million: calls $0.55
*** TURN *** [7c 7h Ac] [Qs]
Just_Million: checks 
69LU58CA69: checks 
*** RIVER *** [7c 7h Ac Qs] [Kd]
Just_Million: checks 
69LU58CA69: bets $1.20
Just_Million: calls $1.20
*** SHOW DOWN ***
69LU58CA69: shows [5s 8s] (a pair of Sevens)
Just_Million: shows [Ah 5h] (two pair, Aces and Sevens)
Just_Million collected $3.96 from pot
*** SUMMARY ***
Total pot $4.15 | Rake $0.19 
Board [7c 7h Ac Qs Kd]
Seat 1: SrPan89 folded before Flop (didn't bet)
Seat 2: genad folded before Flop (didn't bet)
Seat 3: 69LU58CA69 showed [5s 8s] and lost with a pair of Sevens
Seat 4: ignaciospc (button) folded before Flop (didn't bet)
Seat 5: skakalec90 (small blind) folded before Flop
Seat 6: Just_Million (big blind) showed [Ah 5h] and won ($3.96) with two pair, Aces and Sevens



PokerStars Hand #222973161475:  Hold'em No Limit ($0.05/$0.10 USD) - 2021/01/23 16:46:22 ET
Table 'Merope IV' 6-max Seat #5 is the button
Seat 1: SrPan89 ($10 in chips) 
Seat 2: genad ($16.85 in chips) 
Seat 3: 69LU58CA69 ($5.98 in chips) 
Seat 4: ignaciospc ($10 in chips) 
Seat 5: skakalec90 ($14.84 in chips) 
Seat 6: Just_Million ($11.91 in chips) 
Just_Million: posts small blind $0.05
SrPan89: posts big blind $0.10
*** HOLE CARDS ***
genad: folds 
69LU58CA69: folds 
ignaciospc: folds 
skakalec90: raises $0.10 to $0.20
Just_Million: folds 
SrPan89: folds 
Uncalled bet ($0.10) returned to skakalec90
skakalec90 collected $0.25 from pot
skakalec90: doesn't show hand 
*** SUMMARY ***
Total pot $0.25 | Rake $0 
Seat 1: SrPan89 (big blind) folded before Flop
Seat 2: genad folded before Flop (didn't bet)
Seat 3: 69LU58CA69 folded before Flop (didn't bet)
Seat 4: ignaciospc folded before Flop (didn't bet)
Seat 5: skakalec90 (button) collected ($0.25)
Seat 6: Just_Million (small blind) folded before Flop



PokerStars Hand #222973177089:  Hold'em No Limit ($0.05/$0.10 USD) - 2021/01/23 16:46:40 ET
Table 'Merope IV' 6-max Seat #6 is the button
Seat 1: SrPan89 ($10 in chips) 
Seat 2: genad ($16.85 in chips) 
Seat 3: 69LU58CA69 ($5.98 in chips) 
Seat 4: ignaciospc ($10 in chips) 
Seat 5: skakalec90 ($14.99 in chips) 
Seat 6: Just_Million ($11.86 in chips) 
SrPan89: posts small blind $0.05
genad: posts big blind $0.10
*** HOLE CARDS ***
69LU58CA69: folds 
ignaciospc: folds 
skakalec90: folds 
Just_Million: raises $0.10 to $0.20
SrPan89: raises $0.80 to $1
genad: folds 
Just_Million: raises $1.20 to $2.20
SrPan89: folds 
Uncalled bet ($1.20) returned to Just_Million
Just_Million collected $2.10 from pot
Just_Million: doesn't show hand 
*** SUMMARY ***
Total pot $2.10 | Rake $0 
Seat 1: SrPan89 (small blind) folded before Flop
Seat 2: genad (big blind) folded before Flop
Seat 3: 69LU58CA69 folded before Flop (didn't bet)
Seat 4: ignaciospc folded before Flop (didn't bet)
Seat 5: skakalec90 folded before Flop (didn't bet)
Seat 6: Just_Million (button) collected ($2.10)



PokerStars Hand #222973210760:  Hold'em No Limit ($0.05/$0.10 USD) - 2021/01/23 16:47:21 ET
Table 'Merope IV' 6-max Seat #1 is the button
Seat 1: SrPan89 ($10 in chips) 
Seat 2: genad ($16.75 in chips) 
Seat 3: 69LU58CA69 ($6.87 in chips) 
Seat 4: ignaciospc ($10 in chips) 
Seat 5: skakalec90 ($14.99 in chips) 
Seat 6: Just_Million ($12.96 in chips) 
genad: posts small blind $0.05
69LU58CA69: posts big blind $0.10
*** HOLE CARDS ***
ignaciospc: folds 
skakalec90: raises $0.20 to $0.30
Just_Million: folds 
SrPan89: folds 
genad: calls $0.25
69LU58CA69: raises $0.60 to $0.90
skakalec90: folds 
genad: calls $0.60
*** FLOP *** [2h 6h 7s]
genad: checks 
69LU58CA69: checks 
*** TURN *** [2h 6h 7s] [4d]
genad: checks 
69LU58CA69: bets $0.50
genad: calls $0.50
*** RIVER *** [2h 6h 7s 4d] [3c]
genad: checks 
69LU58CA69: bets $1
genad: calls $1
*** SHOW DOWN ***
69LU58CA69: shows [Kd Kh] (a pair of Kings)
genad: mucks hand 
69LU58CA69 collected $4.87 from pot
*** SUMMARY ***
Total pot $5.10 | Rake $0.23 
Board [2h 6h 7s 4d 3c]
Seat 1: SrPan89 (button) folded before Flop (didn't bet)
Seat 2: genad (small blind) mucked
Seat 3: 69LU58CA69 (big blind) showed [Kd Kh] and won ($4.87) with a pair of Kings
Seat 4: ignaciospc folded before Flop (didn't bet)
Seat 5: skakalec90 folded before Flop
Seat 6: Just_Million folded before Flop (didn't bet)



PokerStars Hand #222973260000:  Hold'em No Limit ($0.05/$0.10 USD) - 2021/01/23 16:48:20 ET
Table 'Merope IV' 6-max Seat #2 is the button
Seat 1: SrPan89 ($10 in chips) 
Seat 2: genad ($14.35 in chips) 
Seat 3: 69LU58CA69 ($9.34 in chips) 
Seat 4: ignaciospc ($10 in chips) 
Seat 5: skakalec90 ($14.69 in chips) 
Seat 6: Just_Million ($12.96 in chips) 
69LU58CA69: posts small blind $0.05
ignaciospc: posts big blind $0.10
*** HOLE CARDS ***
skakalec90: folds 
Just_Million: folds 
SrPan89: folds 
genad: folds 
69LU58CA69: raises $0.20 to $0.30
ignaciospc: folds 
Uncalled bet ($0.20) returned to 69LU58CA69
69LU58CA69 collected $0.20 from pot
69LU58CA69: doesn't show hand 
*** SUMMARY ***
Total pot $0.20 | Rake $0 
Seat 1: SrPan89 folded before Flop (didn't bet)
Seat 2: genad (button) folded before Flop (didn't bet)
Seat 3: 69LU58CA69 (small blind) collected ($0.20)
Seat 4: ignaciospc (big blind) folded before Flop
Seat 5: skakalec90 folded before Flop (didn't bet)
Seat 6: Just_Million folded before Flop (didn't bet)



PokerStars Hand #222973268151:  Hold'em No Limit ($0.05/$0.10 USD) - 2021/01/23 16:48:29 ET
Table 'Merope IV' 6-max Seat #3 is the button
Seat 1: SrPan89 ($10 in chips) 
Seat 2: genad ($14.35 in chips) 
Seat 3: 69LU58CA69 ($9.44 in chips) 
Seat 4: ignaciospc ($10 in chips) 
Seat 5: skakalec90 ($14.69 in chips) 
Seat 6: Just_Million ($12.96 in chips) 
ignaciospc: posts small blind $0.05
skakalec90: posts big blind $0.10
*** HOLE CARDS ***
Just_Million: folds 
SrPan89: folds 
genad: folds 
69LU58CA69: calls $0.10
ignaciospc: folds 
skakalec90: checks 
*** FLOP *** [Th 9h 4c]
skakalec90: checks 
69LU58CA69: bets $0.20
skakalec90: folds 
Uncalled bet ($0.20) returned to 69LU58CA69
69LU58CA69 collected $0.24 from pot
69LU58CA69: doesn't show hand 
*** SUMMARY ***
Total pot $0.25 | Rake $0.01 
Board [Th 9h 4c]
Seat 1: SrPan89 folded before Flop (didn't bet)
Seat 2: genad folded before Flop (didn't bet)
Seat 3: 69LU58CA69 (button) collected ($0.24)
Seat 4: ignaciospc (small blind) folded before Flop
Seat 5: skakalec90 (big blind) folded on the Flop
Seat 6: Just_Million folded before Flop (didn't bet)



PokerStars Hand #222973289547:  Hold'em No Limit ($0.05/$0.10 USD) - 2021/01/23 16:48:55 ET
Table 'Merope IV' 6-max Seat #4 is the button
Seat 2: genad ($14.35 in chips) 
Seat 3: 69LU58CA69 ($9.58 in chips) 
Seat 4: ignaciospc ($10 in chips) 
Seat 5: skakalec90 ($14.59 in chips) 
skakalec90: posts small blind $0.05
Just_Million: is sitting out 
SrPan89: is sitting out 
genad: posts big blind $0.10
*** HOLE CARDS ***
Just_Million leaves the table
SrPan89 leaves the table
69LU58CA69: calls $0.10
ignaciospc: raises $0.40 to $0.50
skakalec90: folds 
genad: folds 
69LU58CA69: calls $0.40
*** FLOP *** [Qd As Td]
69LU58CA69: checks 
ignaciospc: bets $0.40
69LU58CA69: calls $0.40
*** TURN *** [Qd As Td] [2c]
RAIM2020 joins the table at seat #6 
69LU58CA69: bets $0.60
Felix UA777 joins the table at seat #1 
ignaciospc: folds 
Uncalled bet ($0.60) returned to 69LU58CA69
69LU58CA69 collected $1.86 from pot
69LU58CA69: doesn't show hand 
*** SUMMARY ***
Total pot $1.95 | Rake $0.09 
Board [Qd As Td 2c]
Seat 2: genad (big blind) folded before Flop
Seat 3: 69LU58CA69 collected ($1.86)
Seat 4: ignaciospc (button) folded on the Turn
Seat 5: skakalec90 (small blind) folded before Flop



PokerStars Hand #222973319205:  Hold'em No Limit ($0.05/$0.10 USD) - 2021/01/23 16:49:29 ET
Table 'Merope IV' 6-max Seat #5 is the button
Seat 2: genad ($14.25 in chips) 
Seat 3: 69LU58CA69 ($10.54 in chips) 
Seat 4: ignaciospc ($10 in chips) 
Seat 5: skakalec90 ($14.54 in chips) 
genad: posts small blind $0.05
69LU58CA69: posts big blind $0.10
*** HOLE CARDS ***
ignaciospc: folds 
skakalec90: folds 
genad: folds 
Uncalled bet ($0.05) returned to 69LU58CA69
69LU58CA69 collected $0.10 from pot
69LU58CA69: doesn't show hand 
*** SUMMARY ***
Total pot $0.10 | Rake $0 
Seat 2: genad (small blind) folded before Flop
Seat 3: 69LU58CA69 (big blind) collected ($0.10)
Seat 4: ignaciospc folded before Flop (didn't bet)
Seat 5: skakalec90 (button) folded before Flop (didn't bet)



PokerStars Hand #222973324115:  Hold'em No Limit ($0.05/$0.10 USD) - 2021/01/23 16:49:35 ET
Table 'Merope IV' 6-max Seat #2 is the button
Seat 2: genad ($14.20 in chips) 
Seat 3: 69LU58CA69 ($10.59 in chips) 
Seat 4: ignaciospc ($10 in chips) 
Seat 5: skakalec90 ($14.54 in chips) 
69LU58CA69: posts small blind $0.05
ignaciospc: posts big blind $0.10
RAIM2020: sits out 
Felix UA777: sits out 
*** HOLE CARDS ***
skakalec90: raises $0.20 to $0.30
genad: folds 
69LU58CA69: calls $0.25
ignaciospc: folds 
*** FLOP *** [Ah 7d Td]
69LU58CA69: checks 
skakalec90: bets $0.34
69LU58CA69: raises $0.66 to $1
skakalec90: calls $0.66
*** TURN *** [Ah 7d Td] [6s]
69LU58CA69: bets $0.40
skakalec90: calls $0.40
*** RIVER *** [Ah 7d Td 6s] [7s]
69LU58CA69: bets $0.90
skakalec90: folds 
Uncalled bet ($0.90) returned to 69LU58CA69
69LU58CA69 collected $3.34 from pot
69LU58CA69: doesn't show hand 
*** SUMMARY ***
Total pot $3.50 | Rake $0.16 
Board [Ah 7d Td 6s 7s]
Seat 2: genad (button) folded before Flop (didn't bet)
Seat 3: 69LU58CA69 (small blind) collected ($3.34)
Seat 4: ignaciospc (big blind) folded before Flop
Seat 5: skakalec90 folded on the River



PokerStars Hand #222973364153:  Hold'em No Limit ($0.05/$0.10 USD) - 2021/01/23 16:50:23 ET
Table 'Merope IV' 6-max Seat #3 is the button
Seat 2: genad ($14.20 in chips) 
Seat 3: 69LU58CA69 ($12.23 in chips) 
Seat 4: ignaciospc ($10 in chips) 
Seat 5: skakalec90 ($12.84 in chips) 
ignaciospc: posts small blind $0.05
skakalec90: posts big blind $0.10
RAIM2020: sits out 
Felix UA777: sits out 
*** HOLE CARDS ***
genad: raises $0.20 to $0.30
69LU58CA69: folds 
ignaciospc: folds 
skakalec90: folds 
Uncalled bet ($0.20) returned to genad
genad collected $0.25 from pot
genad: doesn't show hand 
*** SUMMARY ***
Total pot $0.25 | Rake $0 
Seat 2: genad collected ($0.25)
Seat 3: 69LU58CA69 (button) folded before Flop (didn't bet)
Seat 4: ignaciospc (small blind) folded before Flop
Seat 5: skakalec90 (big blind) folded before Flop



PokerStars Hand #222973374811:  Hold'em No Limit ($0.05/$0.10 USD) - 2021/01/23 16:50:36 ET
Table 'Merope IV' 6-max Seat #4 is the button
Seat 2: genad ($14.35 in chips) 
Seat 3: 69LU58CA69 ($12.23 in chips) 
Seat 4: ignaciospc ($10 in chips) 
Seat 5: skakalec90 ($12.74 in chips) 
Seat 6: RAIM2020 ($10 in chips) 
skakalec90: posts small blind $0.05
RAIM2020: posts big blind $0.10
Felix UA777: sits out 
*** HOLE CARDS ***
genad: folds 
69LU58CA69: folds 
ignaciospc: folds 
skakalec90: raises $0.20 to $0.30
RAIM2020: folds 
Uncalled bet ($0.20) returned to skakalec90
skakalec90 collected $0.20 from pot
skakalec90: doesn't show hand 
*** SUMMARY ***
Total pot $0.20 | Rake $0 
Seat 2: genad folded before Flop (didn't bet)
Seat 3: 69LU58CA69 folded before Flop (didn't bet)
Seat 4: ignaciospc (button) folded before Flop (didn't bet)
Seat 5: skakalec90 (small blind) collected ($0.20)
Seat 6: RAIM2020 (big blind) folded before Flop



PokerStars Hand #222973384821:  Hold'em No Limit ($0.05/$0.10 USD) - 2021/01/23 16:50:48 ET
Table 'Merope IV' 6-max Seat #5 is the button
Seat 1: Felix UA777 ($10 in chips) 
Seat 2: genad ($14.35 in chips) 
Seat 3: 69LU58CA69 ($12.23 in chips) 
Seat 4: ignaciospc ($10 in chips) 
Seat 5: skakalec90 ($12.84 in chips) 
Seat 6: RAIM2020 ($9.90 in chips) 
RAIM2020: posts small blind $0.05
Felix UA777: posts big blind $0.10
*** HOLE CARDS ***
genad: folds 
69LU58CA69: raises $0.20 to $0.30
ignaciospc: folds 
skakalec90: folds 
RAIM2020: folds 
Felix UA777: folds 
Uncalled bet ($0.20) returned to 69LU58CA69
69LU58CA69 collected $0.25 from pot
69LU58CA69: doesn't show hand 
*** SUMMARY ***
Total pot $0.25 | Rake $0 
Seat 1: Felix UA777 (big blind) folded before Flop
Seat 2: genad folded before Flop (didn't bet)
Seat 3: 69LU58CA69 collected ($0.25)
Seat 4: ignaciospc folded before Flop (didn't bet)
Seat 5: skakalec90 (button) folded before Flop (didn't bet)
Seat 6: RAIM2020 (small blind) folded before Flop



PokerStars Hand #222973395063:  Hold'em No Limit ($0.05/$0.10 USD) - 2021/01/23 16:51:00 ET
Table 'Merope IV' 6-max Seat #6 is the button
Seat 1: Felix UA777 ($10 in chips) 
Seat 2: genad ($14.35 in chips) 
Seat 3: 69LU58CA69 ($12.38 in chips) 
Seat 4: ignaciospc ($10 in chips) 
Seat 5: skakalec90 ($12.84 in chips) 
Seat 6: RAIM2020 ($10 in chips) 
Felix UA777: posts small blind $0.05
genad: posts big blind $0.10
*** HOLE CARDS ***
69LU58CA69: folds 
ignaciospc: folds 
skakalec90: folds 
RAIM2020: calls $0.10
Felix UA777: folds 
genad: raises $0.35 to $0.45
RAIM2020: calls $0.35
*** FLOP *** [Ks Js 4s]
genad: checks 
RAIM2020: bets $0.91
genad: folds 
Uncalled bet ($0.91) returned to RAIM2020
RAIM2020 collected $0.91 from pot
RAIM2020: doesn't show hand 
*** SUMMARY ***
Total pot $0.95 | Rake $0.04 
Board [Ks Js 4s]
Seat 1: Felix UA777 (small blind) folded before Flop
Seat 2: genad (big blind) folded on the Flop
Seat 3: 69LU58CA69 folded before Flop (didn't bet)
Seat 4: ignaciospc folded before Flop (didn't bet)
Seat 5: skakalec90 folded before Flop (didn't bet)
Seat 6: RAIM2020 (button) collected ($0.91)



PokerStars Hand #222973432093:  Hold'em No Limit ($0.05/$0.10 USD) - 2021/01/23 16:51:44 ET
Table 'Merope IV' 6-max Seat #1 is the button
Seat 1: Felix UA777 ($10 in chips) 
Seat 2: genad ($13.90 in chips) 
Seat 3: 69LU58CA69 ($12.38 in chips) 
Seat 4: ignaciospc ($10 in chips) 
Seat 5: skakalec90 ($12.84 in chips) 
Seat 6: RAIM2020 ($10.46 in chips) 
genad: posts small blind $0.05
69LU58CA69: posts big blind $0.10
*** HOLE CARDS ***
ignaciospc: folds 
skakalec90: folds 
RAIM2020: raises $0.50 to $0.60
Felix UA777: calls $0.60
genad: folds 
69LU58CA69: calls $0.50
*** FLOP *** [2h 5c Qd]
69LU58CA69: bets $0.60
RAIM2020: calls $0.60
Felix UA777: calls $0.60
*** TURN *** [2h 5c Qd] [5s]
69LU58CA69: checks 
RAIM2020: bets $3.49
Felix UA777: folds 
69LU58CA69: folds 
Uncalled bet ($3.49) returned to RAIM2020
RAIM2020 collected $3.49 from pot
RAIM2020: doesn't show hand 
*** SUMMARY ***
Total pot $3.65 | Rake $0.16 
Board [2h 5c Qd 5s]
Seat 1: Felix UA777 (button) folded on the Turn
Seat 2: genad (small blind) folded before Flop
Seat 3: 69LU58CA69 (big blind) folded on the Turn
Seat 4: ignaciospc folded before Flop (didn't bet)
Seat 5: skakalec90 folded before Flop (didn't bet)
Seat 6: RAIM2020 collected ($3.49)



PokerStars Hand #222973488822:  Hold'em No Limit ($0.05/$0.10 USD) - 2021/01/23 16:52:52 ET
Table 'Merope IV' 6-max Seat #2 is the button
Seat 1: Felix UA777 ($10 in chips) 
Seat 2: genad ($13.85 in chips) 
Seat 3: 69LU58CA69 ($11.18 in chips) 
Seat 4: ignaciospc ($10 in chips) 
Seat 5: skakalec90 ($12.84 in chips) 
Seat 6: RAIM2020 ($12.75 in chips) 
69LU58CA69: posts small blind $0.05
ignaciospc: posts big blind $0.10
*** HOLE CARDS ***
skakalec90: folds 
RAIM2020: folds 
Felix UA777: folds 
genad: raises $0.20 to $0.30
69LU58CA69: calls $0.25
ignaciospc: folds 
*** FLOP *** [Ah Qd Ks]
69LU58CA69: bets $0.67
genad: calls $0.67
*** TURN *** [Ah Qd Ks] [4h]
69LU58CA69: checks 
genad: checks 
*** RIVER *** [Ah Qd Ks 4h] [Kd]
69LU58CA69: bets $1.20
genad: calls $1.20
*** SHOW DOWN ***
69LU58CA69: shows [5h 5d] (two pair, Kings and Fives)
genad: shows [Ad Jd] (two pair, Aces and Kings)
genad collected $4.24 from pot
*** SUMMARY ***
Total pot $4.44 | Rake $0.20 
Board [Ah Qd Ks 4h Kd]
Seat 1: Felix UA777 folded before Flop (didn't bet)
Seat 2: genad (button) showed [Ad Jd] and won ($4.24) with two pair, Aces and Kings
Seat 3: 69LU58CA69 (small blind) showed [5h 5d] and lost with two pair, Kings and Fives
Seat 4: ignaciospc (big blind) folded before Flop
Seat 5: skakalec90 folded before Flop (didn't bet)
Seat 6: RAIM2020 folded before Flop (didn't bet)



PokerStars Hand #222973529665:  Hold'em No Limit ($0.05/$0.10 USD) - 2021/01/23 16:53:41 ET
Table 'Merope IV' 6-max Seat #3 is the button
Seat 1: Felix UA777 ($10 in chips) 
Seat 2: genad ($15.92 in chips) 
Seat 3: 69LU58CA69 ($9.01 in chips) 
Seat 4: ignaciospc ($10 in chips) 
Seat 5: skakalec90 ($12.84 in chips) 
Seat 6: RAIM2020 ($12.75 in chips) 
ignaciospc: posts small blind $0.05
skakalec90: posts big blind $0.10
*** HOLE CARDS ***
RAIM2020: raises $0.30 to $0.40
Felix UA777: folds 
genad: folds 
69LU58CA69: raises $0.80 to $1.20
ignaciospc: folds 
skakalec90: folds 
RAIM2020: calls $0.80
*** FLOP *** [2d Kd 9d]
RAIM2020: checks 
69LU58CA69: bets $1
RAIM2020: calls $1
*** TURN *** [2d Kd 9d] [Qh]
RAIM2020: checks 
69LU58CA69: bets $2
RAIM2020: folds 
Uncalled bet ($2) returned to 69LU58CA69
69LU58CA69 collected $4.35 from pot
69LU58CA69: doesn't show hand 
*** SUMMARY ***
Total pot $4.55 | Rake $0.20 
Board [2d Kd 9d Qh]
Seat 1: Felix UA777 folded before Flop (didn't bet)
Seat 2: genad folded before Flop (didn't bet)
Seat 3: 69LU58CA69 (button) collected ($4.35)
Seat 4: ignaciospc (small blind) folded before Flop
Seat 5: skakalec90 (big blind) folded before Flop
Seat 6: RAIM2020 folded on the Turn



PokerStars Hand #222973571591:  Hold'em No Limit ($0.05/$0.10 USD) - 2021/01/23 16:54:32 ET
Table 'Merope IV' 6-max Seat #4 is the button
Seat 1: Felix UA777 ($10 in chips) 
Seat 2: genad ($15.92 in chips) 
Seat 3: 69LU58CA69 ($11.16 in chips) 
Seat 4: ignaciospc ($10 in chips) 
Seat 5: skakalec90 ($12.74 in chips) 
Seat 6: RAIM2020 ($10.55 in chips) 
skakalec90: posts small blind $0.05
RAIM2020: posts big blind $0.10
*** HOLE CARDS ***
Felix UA777: folds 
genad: raises $0.15 to $0.25
69LU58CA69: calls $0.25
ignaciospc: folds 
skakalec90: folds 
RAIM2020: raises $0.15 to $0.40
genad: calls $0.15
69LU58CA69: calls $0.15
*** FLOP *** [2c 4s Ks]
RAIM2020: bets $1.19
genad: calls $1.19
69LU58CA69: folds 
*** TURN *** [2c 4s Ks] [4h]
RAIM2020: bets $3.47
genad: calls $3.47
*** RIVER *** [2c 4s Ks 4h] [Qc]
RAIM2020: checks 
genad: bets $10.86 and is all-in
RAIM2020: folds 
Uncalled bet ($10.86) returned to genad
genad collected $10.09 from pot
genad: doesn't show hand 
*** SUMMARY ***
Total pot $10.57 | Rake $0.48 
Board [2c 4s Ks 4h Qc]
Seat 1: Felix UA777 folded before Flop (didn't bet)
Seat 2: genad collected ($10.09)
Seat 3: 69LU58CA69 folded on the Flop
Seat 4: ignaciospc (button) folded before Flop (didn't bet)
Seat 5: skakalec90 (small blind) folded before Flop
Seat 6: RAIM2020 (big blind) folded on the River



PokerStars Hand #222973624866:  Hold'em No Limit ($0.05/$0.10 USD) - 2021/01/23 16:55:48 ET
Table 'Merope IV' 6-max Seat #5 is the button
Seat 1: Felix UA777 ($10 in chips) 
Seat 2: genad ($20.95 in chips) 
Seat 3: 69LU58CA69 ($10.76 in chips) 
Seat 4: ignaciospc ($10 in chips) 
Seat 5: skakalec90 ($12.69 in chips) 
Seat 6: RAIM2020 ($5.49 in chips) 
RAIM2020: posts small blind $0.05
Felix UA777: posts big blind $0.10
*** HOLE CARDS ***
genad: folds 
69LU58CA69: folds 
ignaciospc: folds 
skakalec90: raises $0.20 to $0.30
RAIM2020: folds 
Felix UA777: calls $0.20
*** FLOP *** [Td As 8d]
Felix UA777: checks 
skakalec90: checks 
*** TURN *** [Td As 8d] [5d]
Felix UA777: bets $0.35
skakalec90: folds 
Uncalled bet ($0.35) returned to Felix UA777
Felix UA777 collected $0.62 from pot
Felix UA777: doesn't show hand 
*** SUMMARY ***
Total pot $0.65 | Rake $0.03 
Board [Td As 8d 5d]
Seat 1: Felix UA777 (big blind) collected ($0.62)
Seat 2: genad folded before Flop (didn't bet)
Seat 3: 69LU58CA69 folded before Flop (didn't bet)
Seat 4: ignaciospc folded before Flop (didn't bet)
Seat 5: skakalec90 (button) folded on the Turn
Seat 6: RAIM2020 (small blind) folded before Flop



PokerStars Hand #222973645968:  Hold'em No Limit ($0.05/$0.10 USD) - 2021/01/23 16:56:25 ET
Table 'Merope IV' 6-max Seat #6 is the button
Seat 1: Felix UA777 ($10.32 in chips) 
Seat 2: genad ($20.95 in chips) 
Seat 3: 69LU58CA69 ($10.76 in chips) 
Seat 4: ignaciospc ($10 in chips) 
Seat 5: skakalec90 ($12.39 in chips) 
Seat 6: RAIM2020 ($10 in chips) 
Felix UA777: posts small blind $0.05
genad: posts big blind $0.10
*** HOLE CARDS ***
69LU58CA69: raises $0.20 to $0.30
ignaciospc: folds 
skakalec90: folds 
RAIM2020: folds 
Felix UA777: folds 
genad: folds 
Uncalled bet ($0.20) returned to 69LU58CA69
69LU58CA69 collected $0.25 from pot
69LU58CA69: doesn't show hand 
*** SUMMARY ***
Total pot $0.25 | Rake $0 
Seat 1: Felix UA777 (small blind) folded before Flop
Seat 2: genad (big blind) folded before Flop
Seat 3: 69LU58CA69 collected ($0.25)
Seat 4: ignaciospc folded before Flop (didn't bet)
Seat 5: skakalec90 folded before Flop (didn't bet)
Seat 6: RAIM2020 (button) folded before Flop (didn't bet)



PokerStars Hand #222973652137:  Hold'em No Limit ($0.05/$0.10 USD) - 2021/01/23 16:56:36 ET
Table 'Merope IV' 6-max Seat #1 is the button
Seat 1: Felix UA777 ($10.27 in chips) 
Seat 2: genad ($20.85 in chips) 
Seat 3: 69LU58CA69 ($10.91 in chips) 
Seat 4: ignaciospc ($10 in chips) 
Seat 5: skakalec90 ($12.39 in chips) 
Seat 6: RAIM2020 ($10 in chips) 
genad: posts small blind $0.05
69LU58CA69: posts big blind $0.10
*** HOLE CARDS ***
ignaciospc: raises $0.20 to $0.30
skakalec90: calls $0.30
RAIM2020: folds 
Felix UA777: folds 
genad: calls $0.25
69LU58CA69: calls $0.20
*** FLOP *** [2s 9d 5s]
genad: checks 
69LU58CA69: checks 
ignaciospc: bets $0.38
skakalec90: folds 
genad: calls $0.38
69LU58CA69: calls $0.38
*** TURN *** [2s 9d 5s] [8h]
genad: checks 
69LU58CA69: checks 
ignaciospc: checks 
*** RIVER *** [2s 9d 5s 8h] [Jc]
genad: checks 
69LU58CA69: checks 
ignaciospc: checks 
*** SHOW DOWN ***
genad: shows [9c Kc] (a pair of Nines)
69LU58CA69: mucks hand 
ignaciospc: mucks hand 
genad collected $2.23 from pot
*** SUMMARY ***
Total pot $2.34 | Rake $0.11 
Board [2s 9d 5s 8h Jc]
Seat 1: Felix UA777 (button) folded before Flop (didn't bet)
Seat 2: genad (small blind) showed [9c Kc] and won ($2.23) with a pair of Nines
Seat 3: 69LU58CA69 (big blind) mucked
Seat 4: ignaciospc mucked
Seat 5: skakalec90 folded on the Flop
Seat 6: RAIM2020 folded before Flop (didn't bet)



PokerStars Hand #222973696967:  Hold'em No Limit ($0.05/$0.10 USD) - 2021/01/23 16:57:54 ET
Table 'Merope IV' 6-max Seat #2 is the button
Seat 1: Felix UA777 ($10.27 in chips) 
Seat 2: genad ($22.40 in chips) 
Seat 3: 69LU58CA69 ($10.23 in chips) 
Seat 4: ignaciospc ($10 in chips) 
Seat 5: skakalec90 ($12.09 in chips) 
Seat 6: RAIM2020 ($10 in chips) 
69LU58CA69: posts small blind $0.05
ignaciospc: posts big blind $0.10
*** HOLE CARDS ***
skakalec90: folds 
RAIM2020: folds 
Felix UA777: folds 
genad: folds 
69LU58CA69: calls $0.05
ignaciospc: raises $0.40 to $0.50
69LU58CA69: folds 
Uncalled bet ($0.40) returned to ignaciospc
ignaciospc collected $0.20 from pot
ignaciospc: doesn't show hand 
*** SUMMARY ***
Total pot $0.20 | Rake $0 
Seat 1: Felix UA777 folded before Flop (didn't bet)
Seat 2: genad (button) folded before Flop (didn't bet)
Seat 3: 69LU58CA69 (small blind) folded before Flop
Seat 4: ignaciospc (big blind) collected ($0.20)
Seat 5: skakalec90 folded before Flop (didn't bet)
Seat 6: RAIM2020 folded before Flop (didn't bet)



PokerStars Hand #222973708616:  Hold'em No Limit ($0.05/$0.10 USD) - 2021/01/23 16:58:14 ET
Table 'Merope IV' 6-max Seat #3 is the button
Seat 1: Felix UA777 ($10.27 in chips) 
Seat 2: genad ($22.40 in chips) 
Seat 3: 69LU58CA69 ($10.13 in chips) 
Seat 4: ignaciospc ($10.10 in chips) 
Seat 5: skakalec90 ($12.09 in chips) 
Seat 6: RAIM2020 ($10 in chips) 
ignaciospc: posts small blind $0.05
skakalec90: posts big blind $0.10
*** HOLE CARDS ***
RAIM2020: folds 
Felix UA777: folds 
genad: raises $0.15 to $0.25
69LU58CA69: folds 
ignaciospc: folds 
skakalec90: folds 
Uncalled bet ($0.15) returned to genad
genad collected $0.25 from pot
genad: doesn't show hand 
*** SUMMARY ***
Total pot $0.25 | Rake $0 
Seat 1: Felix UA777 folded before Flop (didn't bet)
Seat 2: genad collected ($0.25)
Seat 3: 69LU58CA69 (button) folded before Flop (didn't bet)
Seat 4: ignaciospc (small blind) folded before Flop
Seat 5: skakalec90 (big blind) folded before Flop
Seat 6: RAIM2020 folded before Flop (didn't bet)



PokerStars Hand #222973714045:  Hold'em No Limit ($0.05/$0.10 USD) - 2021/01/23 16:58:23 ET
Table 'Merope IV' 6-max Seat #4 is the button
Seat 1: Felix UA777 ($10.27 in chips) 
Seat 2: genad ($22.55 in chips) 
Seat 3: 69LU58CA69 ($10.13 in chips) 
Seat 4: ignaciospc ($10.05 in chips) 
Seat 5: skakalec90 ($11.99 in chips) 
Seat 6: RAIM2020 ($10 in chips) 
skakalec90: posts small blind $0.05
RAIM2020: posts big blind $0.10
*** HOLE CARDS ***
Felix UA777: folds 
genad: raises $0.15 to $0.25
69LU58CA69: calls $0.25
ignaciospc: folds 
skakalec90: folds 
RAIM2020: calls $0.15
*** FLOP *** [Ad 9s Td]
RAIM2020: bets $0.76
genad: calls $0.76
69LU58CA69: calls $0.76
*** TURN *** [Ad 9s Td] [Ks]
RAIM2020: bets $2.94
genad: folds 
69LU58CA69: folds 
Uncalled bet ($2.94) returned to RAIM2020
RAIM2020 collected $2.94 from pot
RAIM2020: doesn't show hand 
*** SUMMARY ***
Total pot $3.08 | Rake $0.14 
Board [Ad 9s Td Ks]
Seat 1: Felix UA777 folded before Flop (didn't bet)
Seat 2: genad folded on the Turn
Seat 3: 69LU58CA69 folded on the Turn
Seat 4: ignaciospc (button) folded before Flop (didn't bet)
Seat 5: skakalec90 (small blind) folded before Flop
Seat 6: RAIM2020 (big blind) collected ($2.94)



PokerStars Hand #222973735695:  Hold'em No Limit ($0.05/$0.10 USD) - 2021/01/23 16:59:01 ET
Table 'Merope IV' 6-max Seat #5 is the button
Seat 1: Felix UA777 ($10.27 in chips) 
Seat 2: genad ($21.54 in chips) 
Seat 3: 69LU58CA69 ($9.12 in chips) 
Seat 4: ignaciospc ($10.05 in chips) 
Seat 5: skakalec90 ($11.94 in chips) 
Seat 6: RAIM2020 ($11.93 in chips) 
RAIM2020: posts small blind $0.05
Felix UA777: posts big blind $0.10
*** HOLE CARDS ***
genad: folds 
69LU58CA69: calls $0.10
ignaciospc: raises $0.40 to $0.50
skakalec90: folds 
RAIM2020: folds 
Felix UA777: folds 
69LU58CA69: calls $0.40
*** FLOP *** [Tc 7h 7s]
69LU58CA69: bets $1
ignaciospc: folds 
Uncalled bet ($1) returned to 69LU58CA69
69LU58CA69 collected $1.10 from pot
69LU58CA69: doesn't show hand 
*** SUMMARY ***
Total pot $1.15 | Rake $0.05 
Board [Tc 7h 7s]
Seat 1: Felix UA777 (big blind) folded before Flop
Seat 2: genad folded before Flop (didn't bet)
Seat 3: 69LU58CA69 collected ($1.10)
Seat 4: ignaciospc folded on the Flop
Seat 5: skakalec90 (button) folded before Flop (didn't bet)
Seat 6: RAIM2020 (small blind) folded before Flop



PokerStars Hand #222973754198:  Hold'em No Limit ($0.05/$0.10 USD) - 2021/01/23 16:59:32 ET
Table 'Merope IV' 6-max Seat #6 is the button
Seat 1: Felix UA777 ($10.17 in chips) 
Seat 2: genad ($21.54 in chips) 
Seat 3: 69LU58CA69 ($9.72 in chips) 
Seat 4: ignaciospc ($10 in chips) 
Seat 5: skakalec90 ($11.94 in chips) 
Seat 6: RAIM2020 ($11.88 in chips) 
Felix UA777: posts small blind $0.05
genad: posts big blind $0.10
*** HOLE CARDS ***
69LU58CA69: folds 
ignaciospc: folds 
skakalec90: raises $0.20 to $0.30
RAIM2020: folds 
Felix UA777: folds 
genad: folds 
Uncalled bet ($0.20) returned to skakalec90
skakalec90 collected $0.25 from pot
skakalec90: doesn't show hand 
*** SUMMARY ***
Total pot $0.25 | Rake $0 
Seat 1: Felix UA777 (small blind) folded before Flop
Seat 2: genad (big blind) folded before Flop
Seat 3: 69LU58CA69 folded before Flop (didn't bet)
Seat 4: ignaciospc folded before Flop (didn't bet)
Seat 5: skakalec90 collected ($0.25)
Seat 6: RAIM2020 (button) folded before Flop (didn't bet)



PokerStars Hand #222973764339:  Hold'em No Limit ($0.05/$0.10 USD) - 2021/01/23 16:59:50 ET
Table 'Merope IV' 6-max Seat #1 is the button
Seat 1: Felix UA777 ($10.12 in chips) 
Seat 2: genad ($21.44 in chips) 
Seat 3: 69LU58CA69 ($9.72 in chips) 
Seat 4: ignaciospc ($10 in chips) 
Seat 5: skakalec90 ($12.09 in chips) 
Seat 6: RAIM2020 ($11.88 in chips) 
genad: posts small blind $0.05
69LU58CA69: posts big blind $0.10
*** HOLE CARDS ***
ignaciospc: raises $0.20 to $0.30
skakalec90: folds 
RAIM2020: raises $0.20 to $0.50
Felix UA777: folds 
genad: folds 
69LU58CA69: folds 
ignaciospc: calls $0.20
*** FLOP *** [8h 7s 3h]
ignaciospc: checks 
RAIM2020: bets $1.10
ignaciospc: folds 
Uncalled bet ($1.10) returned to RAIM2020
RAIM2020 collected $1.10 from pot
RAIM2020: doesn't show hand 
*** SUMMARY ***
Total pot $1.15 | Rake $0.05 
Board [8h 7s 3h]
Seat 1: Felix UA777 (button) folded before Flop (didn't bet)
Seat 2: genad (small blind) folded before Flop
Seat 3: 69LU58CA69 (big blind) folded before Flop
Seat 4: ignaciospc folded on the Flop
Seat 5: skakalec90 folded before Flop (didn't bet)
Seat 6: RAIM2020 collected ($1.10)



PokerStars Hand #222973777469:  Hold'em No Limit ($0.05/$0.10 USD) - 2021/01/23 17:00:12 ET
Table 'Merope IV' 6-max Seat #2 is the button
Seat 1: Felix UA777 ($10.12 in chips) 
Seat 2: genad ($21.39 in chips) 
Seat 3: 69LU58CA69 ($9.62 in chips) 
Seat 5: skakalec90 ($12.09 in chips) 
Seat 6: RAIM2020 ($12.48 in chips) 
69LU58CA69: posts small blind $0.05
ignaciospc: is sitting out 
skakalec90: posts big blind $0.10
*** HOLE CARDS ***
ignaciospc leaves the table
RAIM2020: folds 
Felix UA777: folds 
genad: raises $0.15 to $0.25
69LU58CA69: raises $0.55 to $0.80
skakalec90: folds 
Contempe joins the table at seat #4 
genad: folds 
Uncalled bet ($0.55) returned to 69LU58CA69
69LU58CA69 collected $0.60 from pot
69LU58CA69: doesn't show hand 
*** SUMMARY ***
Total pot $0.60 | Rake $0 
Seat 1: Felix UA777 folded before Flop (didn't bet)
Seat 2: genad (button) folded before Flop
Seat 3: 69LU58CA69 (small blind) collected ($0.60)
Seat 5: skakalec90 (big blind) folded before Flop
Seat 6: RAIM2020 folded before Flop (didn't bet)



PokerStars Hand #222973792142:  Hold'em No Limit ($0.05/$0.10 USD) - 2021/01/23 17:00:34 ET
Table 'Merope IV' 6-max Seat #3 is the button
Seat 1: Felix UA777 ($10.12 in chips) 
Seat 2: genad ($21.14 in chips) 
Seat 3: 69LU58CA69 ($9.97 in chips) 
Seat 5: skakalec90 ($11.99 in chips) 
Seat 6: RAIM2020 ($12.48 in chips) 
skakalec90: posts small blind $0.05
RAIM2020: posts big blind $0.10
*** HOLE CARDS ***
Felix UA777: raises $0.17 to $0.27
genad: folds 
69LU58CA69: calls $0.27
skakalec90: calls $0.22
RAIM2020: folds 
*** FLOP *** [8h 8c 3h]
skakalec90: checks 
Felix UA777: checks 
69LU58CA69: bets $0.70
skakalec90: folds 
Felix UA777: calls $0.70
*** TURN *** [8h 8c 3h] [2c]
Felix UA777: checks 
69LU58CA69: bets $1
Felix UA777: calls $1
*** RIVER *** [8h 8c 3h 2c] [3c]
Felix UA777: checks 
69LU58CA69: checks 
*** SHOW DOWN ***
Felix UA777: shows [7c 7d] (two pair, Eights and Sevens)
69LU58CA69: mucks hand 
Felix UA777 collected $4.12 from pot
*** SUMMARY ***
Total pot $4.31 | Rake $0.19 
Board [8h 8c 3h 2c 3c]
Seat 1: Felix UA777 showed [7c 7d] and won ($4.12) with two pair, Eights and Sevens
Seat 2: genad folded before Flop (didn't bet)
Seat 3: 69LU58CA69 (button) mucked
Seat 5: skakalec90 (small blind) folded on the Flop
Seat 6: RAIM2020 (big blind) folded before Flop



PokerStars Hand #222973841905:  Hold'em No Limit ($0.05/$0.10 USD) - 2021/01/23 17:01:42 ET
Table 'Merope IV' 6-max Seat #5 is the button
Seat 1: Felix UA777 ($12.27 in chips) 
Seat 2: genad ($21.14 in chips) 
Seat 3: 69LU58CA69 ($8 in chips) 
Seat 5: skakalec90 ($11.72 in chips) 
Seat 6: RAIM2020 ($12.38 in chips) 
RAIM2020: posts small blind $0.05
Felix UA777: posts big blind $0.10
Contempe: sits out 
*** HOLE CARDS ***
genad: folds 
69LU58CA69: raises $0.30 to $0.40
skakalec90: folds 
RAIM2020: folds 
Felix UA777: folds 
Uncalled bet ($0.30) returned to 69LU58CA69
69LU58CA69 collected $0.25 from pot
69LU58CA69: doesn't show hand 
*** SUMMARY ***
Total pot $0.25 | Rake $0 
Seat 1: Felix UA777 (big blind) folded before Flop
Seat 2: genad folded before Flop (didn't bet)
Seat 3: 69LU58CA69 collected ($0.25)
Seat 5: skakalec90 (button) folded before Flop (didn't bet)
Seat 6: RAIM2020 (small blind) folded before Flop



PokerStars Hand #222973867419:  Hold'em No Limit ($0.05/$0.10 USD) - 2021/01/23 17:02:13 ET
Table 'Merope IV' 6-max Seat #6 is the button
Seat 1: Felix UA777 ($12.17 in chips) 
Seat 2: genad ($21.14 in chips) 
Seat 3: 69LU58CA69 ($8.15 in chips) 
Seat 5: skakalec90 ($11.72 in chips) 
Seat 6: RAIM2020 ($12.33 in chips) 
Felix UA777: posts small blind $0.05
genad: posts big blind $0.10
Contempe: sits out 
*** HOLE CARDS ***
69LU58CA69: calls $0.10
skakalec90: raises $0.20 to $0.30
RAIM2020: folds 
Felix UA777: folds 
genad: calls $0.20
69LU58CA69: calls $0.20
*** FLOP *** [2h Ks 6d]
genad: checks 
69LU58CA69: checks 
skakalec90: checks 
*** TURN *** [2h Ks 6d] [Kc]
genad: checks 
69LU58CA69: bets $0.30
skakalec90: folds 
genad: calls $0.30
*** RIVER *** [2h Ks 6d Kc] [Td]
genad: checks 
69LU58CA69: checks 
*** SHOW DOWN ***
genad: shows [Js Jd] (two pair, Kings and Jacks)
69LU58CA69: mucks hand 
genad collected $1.48 from pot
*** SUMMARY ***
Total pot $1.55 | Rake $0.07 
Board [2h Ks 6d Kc Td]
Seat 1: Felix UA777 (small blind) folded before Flop
Seat 2: genad (big blind) showed [Js Jd] and won ($1.48) with two pair, Kings and Jacks
Seat 3: 69LU58CA69 mucked
Seat 5: skakalec90 folded on the Turn
Seat 6: RAIM2020 (button) folded before Flop (didn't bet)



PokerStars Hand #222973898771:  Hold'em No Limit ($0.05/$0.10 USD) - 2021/01/23 17:02:52 ET
Table 'Merope IV' 6-max Seat #1 is the button
Seat 1: Felix UA777 ($12.12 in chips) 
Seat 2: genad ($22.02 in chips) 
Seat 3: 69LU58CA69 ($7.55 in chips) 
Seat 5: skakalec90 ($11.42 in chips) 
Seat 6: RAIM2020 ($12.33 in chips) 
genad: posts small blind $0.05
69LU58CA69: posts big blind $0.10
Contempe: sits out 
*** HOLE CARDS ***
skakalec90: folds 
RAIM2020: raises $0.20 to $0.30
Felix UA777: raises $0.64 to $0.94
genad: folds 
69LU58CA69: folds 
RAIM2020: calls $0.64
*** FLOP *** [6c 9c 9d]
RAIM2020: bets $1.94
Felix UA777: folds 
Uncalled bet ($1.94) returned to RAIM2020
RAIM2020 collected $1.94 from pot
RAIM2020: doesn't show hand 
*** SUMMARY ***
Total pot $2.03 | Rake $0.09 
Board [6c 9c 9d]
Seat 1: Felix UA777 (button) folded on the Flop
Seat 2: genad (small blind) folded before Flop
Seat 3: 69LU58CA69 (big blind) folded before Flop
Seat 5: skakalec90 folded before Flop (didn't bet)
Seat 6: RAIM2020 collected ($1.94)



PokerStars Hand #222973933396:  Hold'em No Limit ($0.05/$0.10 USD) - 2021/01/23 17:03:33 ET
Table 'Merope IV' 6-max Seat #2 is the button
Seat 1: Felix UA777 ($11.18 in chips) 
Seat 2: genad ($21.97 in chips) 
Seat 3: 69LU58CA69 ($7.45 in chips) 
Seat 4: Contempe ($10 in chips) 
Seat 5: skakalec90 ($11.42 in chips) 
Seat 6: RAIM2020 ($13.33 in chips) 
69LU58CA69: posts small blind $0.05
Contempe: posts big blind $0.10
*** HOLE CARDS ***
skakalec90: folds 
RAIM2020: folds 
Felix UA777: raises $0.17 to $0.27
genad: folds 
69LU58CA69: calls $0.22
Contempe: calls $0.17
*** FLOP *** [4c Qs Qh]
69LU58CA69: bets $0.87
Contempe: folds 
Felix UA777: calls $0.87
*** TURN *** [4c Qs Qh] [Ac]
69LU58CA69: bets $2
Felix UA777 has timed out
Felix UA777: folds 
Uncalled bet ($2) returned to 69LU58CA69
69LU58CA69 collected $2.44 from pot
69LU58CA69: doesn't show hand 
*** SUMMARY ***
Total pot $2.55 | Rake $0.11 
Board [4c Qs Qh Ac]
Seat 1: Felix UA777 folded on the Turn
Seat 2: genad (button) folded before Flop (didn't bet)
Seat 3: 69LU58CA69 (small blind) collected ($2.44)
Seat 4: Contempe (big blind) folded on the Flop
Seat 5: skakalec90 folded before Flop (didn't bet)
Seat 6: RAIM2020 folded before Flop (didn't bet)



PokerStars Hand #222974014845:  Hold'em No Limit ($0.05/$0.10 USD) - 2021/01/23 17:04:46 ET
Table 'Merope IV' 6-max Seat #3 is the button
Seat 1: Felix UA777 ($10.04 in chips) 
Seat 2: genad ($21.97 in chips) 
Seat 3: 69LU58CA69 ($8.75 in chips) 
Seat 4: Contempe ($10 in chips) 
Seat 5: skakalec90 ($11.42 in chips) 
Seat 6: RAIM2020 ($13.33 in chips) 
Contempe: posts small blind $0.05
skakalec90: posts big blind $0.10
*** HOLE CARDS ***
RAIM2020: folds 
Felix UA777: folds 
genad: folds 
69LU58CA69: calls $0.10
Contempe: calls $0.05
skakalec90: checks 
*** FLOP *** [8c Jc Tc]
Contempe: bets $0.25
skakalec90: folds 
69LU58CA69: calls $0.25
*** TURN *** [8c Jc Tc] [6d]
Contempe: bets $0.50
69LU58CA69: calls $0.50
*** RIVER *** [8c Jc Tc 6d] [9h]
Contempe: checks 
69LU58CA69: bets $2.22
Contempe: folds 
Uncalled bet ($2.22) returned to 69LU58CA69
69LU58CA69 collected $1.72 from pot
69LU58CA69: doesn't show hand 
*** SUMMARY ***
Total pot $1.80 | Rake $0.08 
Board [8c Jc Tc 6d 9h]
Seat 1: Felix UA777 folded before Flop (didn't bet)
Seat 2: genad folded before Flop (didn't bet)
Seat 3: 69LU58CA69 (button) collected ($1.72)
Seat 4: Contempe (small blind) folded on the River
Seat 5: skakalec90 (big blind) folded on the Flop
Seat 6: RAIM2020 folded before Flop (didn't bet)



PokerStars Hand #222974096549:  Hold'em No Limit ($0.05/$0.10 USD) - 2021/01/23 17:06:24 ET
Table 'Merope IV' 6-max Seat #4 is the button
Seat 1: Felix UA777 ($10.04 in chips) 
Seat 2: genad ($21.97 in chips) 
Seat 3: 69LU58CA69 ($9.62 in chips) 
Seat 4: Contempe ($10 in chips) 
Seat 5: skakalec90 ($11.32 in chips) 
Seat 6: RAIM2020 ($13.33 in chips) 
skakalec90: posts small blind $0.05
RAIM2020: posts big blind $0.10
*** HOLE CARDS ***
Felix UA777: folds 
genad: raises $0.15 to $0.25
69LU58CA69: calls $0.25
Contempe: calls $0.25
skakalec90: folds 
RAIM2020: folds 
*** FLOP *** [Ks 3s 6c]
genad: checks 
69LU58CA69: bets $0.30
Contempe: calls $0.30
genad: folds 
*** TURN *** [Ks 3s 6c] [8c]
69LU58CA69: bets $0.30
Contempe: calls $0.30
*** RIVER *** [Ks 3s 6c 8c] [2d]
69LU58CA69: bets $0.30
Contempe: raises $1 to $1.30
69LU58CA69: calls $1
*** SHOW DOWN ***
Contempe: shows [Tc As] (high card Ace)
69LU58CA69: shows [9c Kh] (a pair of Kings)
69LU58CA69 collected $4.49 from pot
*** SUMMARY ***
Total pot $4.70 | Rake $0.21 
Board [Ks 3s 6c 8c 2d]
Seat 1: Felix UA777 folded before Flop (didn't bet)
Seat 2: genad folded on the Flop
Seat 3: 69LU58CA69 showed [9c Kh] and won ($4.49) with a pair of Kings
Seat 4: Contempe (button) showed [Tc As] and lost with high card Ace
Seat 5: skakalec90 (small blind) folded before Flop
Seat 6: RAIM2020 (big blind) folded before Flop



PokerStars Hand #222974150647:  Hold'em No Limit ($0.05/$0.10 USD) - 2021/01/23 17:07:29 ET
Table 'Merope IV' 6-max Seat #5 is the button
Seat 1: Felix UA777 ($10.04 in chips) 
Seat 2: genad ($21.72 in chips) 
Seat 3: 69LU58CA69 ($11.96 in chips) 
Seat 4: Contempe ($10 in chips) 
Seat 5: skakalec90 ($11.27 in chips) 
Seat 6: RAIM2020 ($13.23 in chips) 
RAIM2020: posts small blind $0.05
Felix UA777: posts big blind $0.10
*** HOLE CARDS ***
genad: raises $0.15 to $0.25
69LU58CA69: calls $0.25
Contempe: folds 
skakalec90: folds 
RAIM2020: calls $0.20
Felix UA777: folds 
*** FLOP *** [3h 2h 8c]
RAIM2020: checks 
genad: checks 
69LU58CA69: checks 
*** TURN *** [3h 2h 8c] [3d]
RAIM2020: checks 
genad: bets $0.41
69LU58CA69: calls $0.41
RAIM2020: folds 
*** RIVER *** [3h 2h 8c 3d] [8d]
genad: checks 
69LU58CA69: checks 
*** SHOW DOWN ***
genad: shows [Ad As] (two pair, Aces and Eights)
69LU58CA69: mucks hand 
genad collected $1.59 from pot
*** SUMMARY ***
Total pot $1.67 | Rake $0.08 
Board [3h 2h 8c 3d 8d]
Seat 1: Felix UA777 (big blind) folded before Flop
Seat 2: genad showed [Ad As] and won ($1.59) with two pair, Aces and Eights
Seat 3: 69LU58CA69 mucked
Seat 4: Contempe folded before Flop (didn't bet)
Seat 5: skakalec90 (button) folded before Flop (didn't bet)
Seat 6: RAIM2020 (small blind) folded on the Turn



PokerStars Hand #222974188027:  Hold'em No Limit ($0.05/$0.10 USD) - 2021/01/23 17:08:14 ET
Table 'Merope IV' 6-max Seat #6 is the button
Seat 1: Felix UA777 ($10 in chips) 
Seat 2: genad ($22.65 in chips) 
Seat 3: 69LU58CA69 ($11.30 in chips) 
Seat 4: Contempe ($10 in chips) 
Seat 5: skakalec90 ($11.27 in chips) 
Seat 6: RAIM2020 ($12.98 in chips) 
Felix UA777: posts small blind $0.05
genad: posts big blind $0.10
*** HOLE CARDS ***
69LU58CA69: folds 
Contempe: raises $0.20 to $0.30
skakalec90: folds 
RAIM2020: folds 
Felix UA777: folds 
genad: raises $0.70 to $1
Contempe: folds 
Uncalled bet ($0.70) returned to genad
genad collected $0.65 from pot
genad: doesn't show hand 
*** SUMMARY ***
Total pot $0.65 | Rake $0 
Seat 1: Felix UA777 (small blind) folded before Flop
Seat 2: genad (big blind) collected ($0.65)
Seat 3: 69LU58CA69 folded before Flop (didn't bet)
Seat 4: Contempe folded before Flop
Seat 5: skakalec90 folded before Flop (didn't bet)
Seat 6: RAIM2020 (button) folded before Flop (didn't bet)



PokerStars Hand #222974215316:  Hold'em No Limit ($0.05/$0.10 USD) - 2021/01/23 17:08:46 ET
Table 'Merope IV' 6-max Seat #1 is the button
Seat 1: Felix UA777 ($10 in chips) 
Seat 2: genad ($23 in chips) 
Seat 3: 69LU58CA69 ($11.30 in chips) 
Seat 4: Contempe ($10 in chips) 
Seat 5: skakalec90 ($11.27 in chips) 
Seat 6: RAIM2020 ($12.98 in chips) 
genad: posts small blind $0.05
69LU58CA69: posts big blind $0.10
*** HOLE CARDS ***
Contempe: folds 
skakalec90: folds 
RAIM2020: raises $0.20 to $0.30
Felix UA777: folds 
genad: folds 
69LU58CA69: calls $0.20
*** FLOP *** [2s 9h 9c]
69LU58CA69: bets $0.40
RAIM2020: calls $0.40
*** TURN *** [2s 9h 9c] [Tc]
69LU58CA69: bets $0.50
RAIM2020: calls $0.50
*** RIVER *** [2s 9h 9c Tc] [7h]
69LU58CA69: bets $1.10
RAIM2020: folds 
Uncalled bet ($1.10) returned to 69LU58CA69
69LU58CA69 collected $2.34 from pot
69LU58CA69: doesn't show hand 
*** SUMMARY ***
Total pot $2.45 | Rake $0.11 
Board [2s 9h 9c Tc 7h]
Seat 1: Felix UA777 (button) folded before Flop (didn't bet)
Seat 2: genad (small blind) folded before Flop
Seat 3: 69LU58CA69 (big blind) collected ($2.34)
Seat 4: Contempe folded before Flop (didn't bet)
Seat 5: skakalec90 folded before Flop (didn't bet)
Seat 6: RAIM2020 folded on the River



PokerStars Hand #222974262587:  Hold'em No Limit ($0.05/$0.10 USD) - 2021/01/23 17:09:44 ET
Table 'Merope IV' 6-max Seat #2 is the button
Seat 1: Felix UA777 ($10 in chips) 
Seat 2: genad ($22.95 in chips) 
Seat 3: 69LU58CA69 ($12.44 in chips) 
Seat 4: Contempe ($10 in chips) 
Seat 5: skakalec90 ($11.27 in chips) 
Seat 6: RAIM2020 ($11.78 in chips) 
69LU58CA69: posts small blind $0.05
Contempe: posts big blind $0.10
*** HOLE CARDS ***
skakalec90: folds 
RAIM2020: raises $0.20 to $0.30
Felix UA777: folds 
genad: folds 
69LU58CA69: calls $0.25
Contempe: folds 
*** FLOP *** [2h Jc 8s]
69LU58CA69: checks 
RAIM2020: checks 
*** TURN *** [2h Jc 8s] [6c]
69LU58CA69: bets $0.30
RAIM2020: calls $0.30
*** RIVER *** [2h Jc 8s 6c] [8c]
69LU58CA69: bets $0.80
RAIM2020: calls $0.80
*** SHOW DOWN ***
69LU58CA69: shows [6d 7d] (two pair, Eights and Sixes)
RAIM2020: mucks hand 
69LU58CA69 collected $2.77 from pot
*** SUMMARY ***
Total pot $2.90 | Rake $0.13 
Board [2h Jc 8s 6c 8c]
Seat 1: Felix UA777 folded before Flop (didn't bet)
Seat 2: genad (button) folded before Flop (didn't bet)
Seat 3: 69LU58CA69 (small blind) showed [6d 7d] and won ($2.77) with two pair, Eights and Sixes
Seat 4: Contempe (big blind) folded before Flop
Seat 5: skakalec90 folded before Flop (didn't bet)
Seat 6: RAIM2020 mucked



PokerStars Hand #222974295448:  Hold'em No Limit ($0.05/$0.10 USD) - 2021/01/23 17:10:23 ET
Table 'Merope IV' 6-max Seat #3 is the button
Seat 1: Felix UA777 ($10 in chips) 
Seat 2: genad ($22.95 in chips) 
Seat 3: 69LU58CA69 ($13.81 in chips) 
Seat 4: Contempe ($10 in chips) 
Seat 5: skakalec90 ($11.27 in chips) 
Seat 6: RAIM2020 ($10.38 in chips) 
Contempe: posts small blind $0.05
skakalec90: posts big blind $0.10
*** HOLE CARDS ***
RAIM2020: raises $0.10 to $0.20
Felix UA777: folds 
genad: folds 
69LU58CA69: raises $0.60 to $0.80
Contempe: folds 
skakalec90: folds 
RAIM2020: calls $0.60
*** FLOP *** [Jh 2d 7d]
RAIM2020: checks 
69LU58CA69: checks 
*** TURN *** [Jh 2d 7d] [6c]
RAIM2020: checks 
69LU58CA69: bets $0.80
RAIM2020: calls $0.80
*** RIVER *** [Jh 2d 7d 6c] [7c]
RAIM2020: bets $3.20
69LU58CA69: folds 
Uncalled bet ($3.20) returned to RAIM2020
RAIM2020 collected $3.20 from pot
RAIM2020: doesn't show hand 
*** SUMMARY ***
Total pot $3.35 | Rake $0.15 
Board [Jh 2d 7d 6c 7c]
Seat 1: Felix UA777 folded before Flop (didn't bet)
Seat 2: genad folded before Flop (didn't bet)
Seat 3: 69LU58CA69 (button) folded on the River
Seat 4: Contempe (small blind) folded before Flop
Seat 5: skakalec90 (big blind) folded before Flop
Seat 6: RAIM2020 collected ($3.20)



PokerStars Hand #222974350909:  Hold'em No Limit ($0.05/$0.10 USD) - 2021/01/23 17:11:30 ET
Table 'Merope IV' 6-max Seat #4 is the button
Seat 1: Felix UA777 ($10 in chips) 
Seat 2: genad ($22.95 in chips) 
Seat 3: 69LU58CA69 ($12.21 in chips) 
Seat 4: Contempe ($10 in chips) 
Seat 5: skakalec90 ($11.17 in chips) 
Seat 6: RAIM2020 ($11.98 in chips) 
skakalec90: posts small blind $0.05
RAIM2020: posts big blind $0.10
*** HOLE CARDS ***
Felix UA777: folds 
genad: folds 
69LU58CA69: folds 
Contempe: folds 
skakalec90: folds 
Uncalled bet ($0.05) returned to RAIM2020
RAIM2020 collected $0.10 from pot
RAIM2020: doesn't show hand 
*** SUMMARY ***
Total pot $0.10 | Rake $0 
Seat 1: Felix UA777 folded before Flop (didn't bet)
Seat 2: genad folded before Flop (didn't bet)
Seat 3: 69LU58CA69 folded before Flop (didn't bet)
Seat 4: Contempe (button) folded before Flop (didn't bet)
Seat 5: skakalec90 (small blind) folded before Flop
Seat 6: RAIM2020 (big blind) collected ($0.10)



PokerStars Hand #222974359175:  Hold'em No Limit ($0.05/$0.10 USD) - 2021/01/23 17:11:40 ET
Table 'Merope IV' 6-max Seat #5 is the button
Seat 1: Felix UA777 ($10 in chips) 
Seat 2: genad ($22.95 in chips) 
Seat 3: 69LU58CA69 ($12.21 in chips) 
Seat 4: Contempe ($10 in chips) 
Seat 5: skakalec90 ($11.12 in chips) 
Seat 6: RAIM2020 ($12.03 in chips) 
RAIM2020: posts small blind $0.05
Felix UA777: posts big blind $0.10
*** HOLE CARDS ***
genad: folds 
69LU58CA69: folds 
Contempe: raises $0.20 to $0.30
skakalec90: folds 
RAIM2020: calls $0.25
Felix UA777: folds 
*** FLOP *** [Td 4s Jh]
RAIM2020: bets $0.67
Contempe: calls $0.67
*** TURN *** [Td 4s Jh] [3h]
RAIM2020: checks 
Contempe: bets $0.90
RAIM2020: calls $0.90
*** RIVER *** [Td 4s Jh 3h] [5d]
RAIM2020: checks 
Contempe: checks 
*** SHOW DOWN ***
RAIM2020: shows [9s Th] (a pair of Tens)
Contempe: mucks hand 
RAIM2020 collected $3.67 from pot
*** SUMMARY ***
Total pot $3.84 | Rake $0.17 
Board [Td 4s Jh 3h 5d]
Seat 1: Felix UA777 (big blind) folded before Flop
Seat 2: genad folded before Flop (didn't bet)
Seat 3: 69LU58CA69 folded before Flop (didn't bet)
Seat 4: Contempe mucked
Seat 5: skakalec90 (button) folded before Flop (didn't bet)
Seat 6: RAIM2020 (small blind) showed [9s Th] and won ($3.67) with a pair of Tens



PokerStars Hand #222974407117:  Hold'em No Limit ($0.05/$0.10 USD) - 2021/01/23 17:12:38 ET
Table 'Merope IV' 6-max Seat #6 is the button
Seat 1: Felix UA777 ($10 in chips) 
Seat 2: genad ($22.95 in chips) 
Seat 3: 69LU58CA69 ($12.21 in chips) 
Seat 4: Contempe ($10 in chips) 
Seat 5: skakalec90 ($11.12 in chips) 
Seat 6: RAIM2020 ($13.83 in chips) 
Felix UA777: posts small blind $0.05
genad: posts big blind $0.10
*** HOLE CARDS ***
69LU58CA69 has timed out
69LU58CA69: folds 
Contempe: calls $0.10
skakalec90: raises $0.20 to $0.30
RAIM2020: calls $0.30
Felix UA777: folds 
genad: folds 
Contempe: raises $1.05 to $1.35
skakalec90: folds 
RAIM2020: calls $1.05
*** FLOP *** [3d 7c Ks]
Contempe: checks 
RAIM2020: checks 
*** TURN *** [3d 7c Ks] [8d]
Contempe: bets $1.05
RAIM2020: calls $1.05
*** RIVER *** [3d 7c Ks 8d] [5d]
Contempe: checks 
RAIM2020: bets $5.01
Contempe: calls $5.01
*** SHOW DOWN ***
RAIM2020: shows [Ts Jh] (high card King)
Contempe: shows [Ad Kc] (a pair of Kings)
Contempe collected $14.58 from pot
*** SUMMARY ***
Total pot $15.27 | Rake $0.69 
Board [3d 7c Ks 8d 5d]
Seat 1: Felix UA777 (small blind) folded before Flop
Seat 2: genad (big blind) folded before Flop
Seat 3: 69LU58CA69 folded before Flop (didn't bet)
Seat 4: Contempe showed [Ad Kc] and won ($14.58) with a pair of Kings
Seat 5: skakalec90 folded before Flop
Seat 6: RAIM2020 (button) showed [Ts Jh] and lost with high card King



PokerStars Hand #222974456365:  Hold'em No Limit ($0.05/$0.10 USD) - 2021/01/23 17:13:38 ET
Table 'Merope IV' 6-max Seat #1 is the button
Seat 1: Felix UA777 ($10 in chips) 
Seat 2: genad ($22.85 in chips) 
Seat 3: 69LU58CA69 ($12.21 in chips) 
Seat 4: Contempe ($17.17 in chips) 
Seat 5: skakalec90 ($10.82 in chips) 
Seat 6: RAIM2020 ($6.42 in chips) 
genad: posts small blind $0.05
69LU58CA69: posts big blind $0.10
*** HOLE CARDS ***
Contempe: folds 
skakalec90: folds 
RAIM2020: raises $0.10 to $0.20
Felix UA777: folds 
genad: folds 
69LU58CA69: raises $0.40 to $0.60
RAIM2020: calls $0.40
*** FLOP *** [Qc Jc 5c]
69LU58CA69: bets $0.60
RAIM2020: folds 
Uncalled bet ($0.60) returned to 69LU58CA69
69LU58CA69 collected $1.19 from pot
69LU58CA69: doesn't show hand 
*** SUMMARY ***
Total pot $1.25 | Rake $0.06 
Board [Qc Jc 5c]
Seat 1: Felix UA777 (button) folded before Flop (didn't bet)
Seat 2: genad (small blind) folded before Flop
Seat 3: 69LU58CA69 (big blind) collected ($1.19)
Seat 4: Contempe folded before Flop (didn't bet)
Seat 5: skakalec90 folded before Flop (didn't bet)
Seat 6: RAIM2020 folded on the Flop



PokerStars Hand #222974490243:  Hold'em No Limit ($0.05/$0.10 USD) - 2021/01/23 17:14:19 ET
Table 'Merope IV' 6-max Seat #2 is the button
Seat 1: Felix UA777 ($10 in chips) 
Seat 2: genad ($22.80 in chips) 
Seat 3: 69LU58CA69 ($12.80 in chips) 
Seat 4: Contempe ($17.17 in chips) 
Seat 5: skakalec90 ($10.82 in chips) 
Seat 6: RAIM2020 ($8.88 in chips) 
69LU58CA69: posts small blind $0.05
Contempe: posts big blind $0.10
*** HOLE CARDS ***
skakalec90: folds 
RAIM2020: calls $0.10
Felix UA777: raises $0.30 to $0.40
genad: raises $0.80 to $1.20
69LU58CA69: folds 
Contempe: folds 
RAIM2020: calls $1.10
Felix UA777: calls $0.80
*** FLOP *** [3h Qh 6d]
RAIM2020: checks 
Felix UA777: checks 
genad: bets $1.40
RAIM2020: folds 
Felix UA777 has timed out
Felix UA777: folds 
Uncalled bet ($1.40) returned to genad
genad collected $3.58 from pot
genad: doesn't show hand 
*** SUMMARY ***
Total pot $3.75 | Rake $0.17 
Board [3h Qh 6d]
Seat 1: Felix UA777 folded on the Flop
Seat 2: genad (button) collected ($3.58)
Seat 3: 69LU58CA69 (small blind) folded before Flop
Seat 4: Contempe (big blind) folded before Flop
Seat 5: skakalec90 folded before Flop (didn't bet)
Seat 6: RAIM2020 folded on the Flop



PokerStars Hand #222974562775:  Hold'em No Limit ($0.05/$0.10 USD) - 2021/01/23 17:15:47 ET
Table 'Merope IV' 6-max Seat #3 is the button
Seat 1: Felix UA777 ($10 in chips) 
Seat 2: genad ($25.18 in chips) 
Seat 3: 69LU58CA69 ($12.75 in chips) 
Seat 4: Contempe ($17.07 in chips) 
Seat 5: skakalec90 ($10.82 in chips) 
Seat 6: RAIM2020 ($7.68 in chips) 
Contempe: posts small blind $0.05
skakalec90: posts big blind $0.10
*** HOLE CARDS ***
RAIM2020: raises $0.10 to $0.20
Felix UA777 has timed out
Felix UA777: folds 
genad: folds 
69LU58CA69: folds 
Contempe: folds 
skakalec90: calls $0.10
*** FLOP *** [5h Qs 5c]
skakalec90: checks 
RAIM2020: checks 
*** TURN *** [5h Qs 5c] [Qc]
skakalec90: checks 
RAIM2020: bets $0.43
skakalec90: folds 
Uncalled bet ($0.43) returned to RAIM2020
RAIM2020 collected $0.43 from pot
RAIM2020: doesn't show hand 
*** SUMMARY ***
Total pot $0.45 | Rake $0.02 
Board [5h Qs 5c Qc]
Seat 1: Felix UA777 folded before Flop (didn't bet)
Seat 2: genad folded before Flop (didn't bet)
Seat 3: 69LU58CA69 (button) folded before Flop (didn't bet)
Seat 4: Contempe (small blind) folded before Flop
Seat 5: skakalec90 (big blind) folded on the Turn
Seat 6: RAIM2020 collected ($0.43)



PokerStars Hand #222974595865:  Hold'em No Limit ($0.05/$0.10 USD) - 2021/01/23 17:16:27 ET
Table 'Merope IV' 6-max Seat #4 is the button
Seat 1: Felix UA777 ($10 in chips) 
Seat 2: genad ($25.18 in chips) 
Seat 3: 69LU58CA69 ($12.75 in chips) 
Seat 4: Contempe ($17.02 in chips) 
Seat 5: skakalec90 ($10.62 in chips) 
Seat 6: RAIM2020 ($7.91 in chips) 
skakalec90: posts small blind $0.05
RAIM2020: posts big blind $0.10
*** HOLE CARDS ***
Felix UA777: folds 
genad: folds 
69LU58CA69: folds 
Contempe: folds 
skakalec90: folds 
Uncalled bet ($0.05) returned to RAIM2020
RAIM2020 collected $0.10 from pot
RAIM2020: doesn't show hand 
*** SUMMARY ***
Total pot $0.10 | Rake $0 
Seat 1: Felix UA777 folded before Flop (didn't bet)
Seat 2: genad folded before Flop (didn't bet)
Seat 3: 69LU58CA69 folded before Flop (didn't bet)
Seat 4: Contempe (button) folded before Flop (didn't bet)
Seat 5: skakalec90 (small blind) folded before Flop
Seat 6: RAIM2020 (big blind) collected ($0.10)



PokerStars Hand #222974602155:  Hold'em No Limit ($0.05/$0.10 USD) - 2021/01/23 17:16:35 ET
Table 'Merope IV' 6-max Seat #5 is the button
Seat 1: Felix UA777 ($10 in chips) 
Seat 2: genad ($25.18 in chips) 
Seat 3: 69LU58CA69 ($12.75 in chips) 
Seat 4: Contempe ($17.02 in chips) 
Seat 5: skakalec90 ($10.57 in chips) 
Seat 6: RAIM2020 ($7.96 in chips) 
RAIM2020: posts small blind $0.05
Felix UA777: posts big blind $0.10
*** HOLE CARDS ***
genad: folds 
69LU58CA69: calls $0.10
Contempe: raises $0.25 to $0.35
skakalec90: folds 
RAIM2020: calls $0.30
Felix UA777: folds 
69LU58CA69: calls $0.25
*** FLOP *** [Qs 6c Js]
RAIM2020: checks 
69LU58CA69: checks 
Contempe: bets $0.65
RAIM2020: folds 
69LU58CA69: folds 
Uncalled bet ($0.65) returned to Contempe
Contempe collected $1.10 from pot
*** SUMMARY ***
Total pot $1.15 | Rake $0.05 
Board [Qs 6c Js]
Seat 1: Felix UA777 (big blind) folded before Flop
Seat 2: genad folded before Flop (didn't bet)
Seat 3: 69LU58CA69 folded on the Flop
Seat 4: Contempe collected ($1.10)
Seat 5: skakalec90 (button) folded before Flop (didn't bet)
Seat 6: RAIM2020 (small blind) folded on the Flop



PokerStars Hand #222974641440:  Hold'em No Limit ($0.05/$0.10 USD) - 2021/01/23 17:17:22 ET
Table 'Merope IV' 6-max Seat #6 is the button
Seat 1: Felix UA777 ($10 in chips) 
Seat 2: genad ($25.18 in chips) 
Seat 3: 69LU58CA69 ($12.40 in chips) 
Seat 4: Contempe ($17.77 in chips) 
Seat 5: skakalec90 ($10.57 in chips) 
Seat 6: RAIM2020 ($7.61 in chips) 
Felix UA777: posts small blind $0.05
genad: posts big blind $0.10
*** HOLE CARDS ***
69LU58CA69: folds 
Contempe: folds 
skakalec90: folds 
RAIM2020: folds 
Felix UA777: folds 
Uncalled bet ($0.05) returned to genad
genad collected $0.10 from pot
genad: doesn't show hand 
*** SUMMARY ***
Total pot $0.10 | Rake $0 
Seat 1: Felix UA777 (small blind) folded before Flop
Seat 2: genad (big blind) collected ($0.10)
Seat 3: 69LU58CA69 folded before Flop (didn't bet)
Seat 4: Contempe folded before Flop (didn't bet)
Seat 5: skakalec90 folded before Flop (didn't bet)
Seat 6: RAIM2020 (button) folded before Flop (didn't bet)



PokerStars Hand #222974654007:  Hold'em No Limit ($0.05/$0.10 USD) - 2021/01/23 17:17:38 ET
Table 'Merope IV' 6-max Seat #1 is the button
Seat 1: Felix UA777 ($10 in chips) 
Seat 2: genad ($25.23 in chips) 
Seat 3: 69LU58CA69 ($12.40 in chips) 
Seat 4: Contempe ($17.77 in chips) 
Seat 5: skakalec90 ($10.57 in chips) 
Seat 6: RAIM2020 ($7.61 in chips) 
genad: posts small blind $0.05
69LU58CA69: posts big blind $0.10
*** HOLE CARDS ***
Contempe: folds 
skakalec90: folds 
RAIM2020: calls $0.10
Felix UA777: folds 
genad: folds 
69LU58CA69: checks 
*** FLOP *** [5d 5s 4c]
69LU58CA69: checks 
RAIM2020: checks 
*** TURN *** [5d 5s 4c] [9c]
69LU58CA69: checks 
RAIM2020: bets $0.24
69LU58CA69: folds 
Uncalled bet ($0.24) returned to RAIM2020
RAIM2020 collected $0.24 from pot
RAIM2020: doesn't show hand 
*** SUMMARY ***
Total pot $0.25 | Rake $0.01 
Board [5d 5s 4c 9c]
Seat 1: Felix UA777 (button) folded before Flop (didn't bet)
Seat 2: genad (small blind) folded before Flop
Seat 3: 69LU58CA69 (big blind) folded on the Turn
Seat 4: Contempe folded before Flop (didn't bet)
Seat 5: skakalec90 folded before Flop (didn't bet)
Seat 6: RAIM2020 collected ($0.24)



PokerStars Hand #222974683077:  Hold'em No Limit ($0.05/$0.10 USD) - 2021/01/23 17:18:13 ET
Table 'Merope IV' 6-max Seat #2 is the button
Seat 1: Felix UA777 ($10 in chips) 
Seat 2: genad ($25.18 in chips) 
Seat 3: 69LU58CA69 ($12.30 in chips) 
Seat 4: Contempe ($17.77 in chips) 
Seat 5: skakalec90 ($10.57 in chips) 
Seat 6: RAIM2020 ($7.75 in chips) 
69LU58CA69: posts small blind $0.05
Contempe: posts big blind $0.10
*** HOLE CARDS ***
skakalec90: folds 
RAIM2020: raises $0.20 to $0.30
Felix UA777: raises $0.64 to $0.94
genad: folds 
69LU58CA69: folds 
Contempe: folds 
RAIM2020: raises $0.64 to $1.58
Felix UA777: calls $0.64
*** FLOP *** [Kd 4h Ts]
RAIM2020: bets $3.16
Felix UA777: folds 
Uncalled bet ($3.16) returned to RAIM2020
RAIM2020 collected $3.16 from pot
RAIM2020: doesn't show hand 
*** SUMMARY ***
Total pot $3.31 | Rake $0.15 
Board [Kd 4h Ts]
Seat 1: Felix UA777 folded on the Flop
Seat 2: genad (button) folded before Flop (didn't bet)
Seat 3: 69LU58CA69 (small blind) folded before Flop
Seat 4: Contempe (big blind) folded before Flop
Seat 5: skakalec90 folded before Flop (didn't bet)
Seat 6: RAIM2020 collected ($3.16)



PokerStars Hand #222974718167:  Hold'em No Limit ($0.05/$0.10 USD) - 2021/01/23 17:18:56 ET
Table 'Merope IV' 6-max Seat #3 is the button
Seat 1: Felix UA777 ($10 in chips) 
Seat 2: genad ($25.18 in chips) 
Seat 3: 69LU58CA69 ($12.25 in chips) 
Seat 4: Contempe ($17.67 in chips) 
Seat 5: skakalec90 ($10.57 in chips) 
Seat 6: RAIM2020 ($9.33 in chips) 
Contempe: posts small blind $0.05
skakalec90: posts big blind $0.10
*** HOLE CARDS ***
RAIM2020: folds 
Felix UA777: folds 
genad: raises $0.15 to $0.25
69LU58CA69: calls $0.25
Contempe: folds 
skakalec90: folds 
*** FLOP *** [Ks 9c 6d]
genad: bets $0.20
69LU58CA69: calls $0.20
*** TURN *** [Ks 9c 6d] [3h]
genad: bets $0.67
69LU58CA69: calls $0.67
*** RIVER *** [Ks 9c 6d 3h] [Qh]
genad: checks 
69LU58CA69: checks 
*** SHOW DOWN ***
genad: shows [7d Kd] (a pair of Kings)
69LU58CA69: shows [7s Kc] (a pair of Kings)
genad collected $1.14 from pot
69LU58CA69 collected $1.14 from pot
*** SUMMARY ***
Total pot $2.39 | Rake $0.11 
Board [Ks 9c 6d 3h Qh]
Seat 1: Felix UA777 folded before Flop (didn't bet)
Seat 2: genad showed [7d Kd] and won ($1.14) with a pair of Kings
Seat 3: 69LU58CA69 (button) showed [7s Kc] and won ($1.14) with a pair of Kings
Seat 4: Contempe (small blind) folded before Flop
Seat 5: skakalec90 (big blind) folded before Flop
Seat 6: RAIM2020 folded before Flop (didn't bet)



PokerStars Hand #222974765066:  Hold'em No Limit ($0.05/$0.10 USD) - 2021/01/23 17:19:53 ET
Table 'Merope IV' 6-max Seat #4 is the button
Seat 1: Felix UA777 ($10 in chips) 
Seat 2: genad ($25.20 in chips) 
Seat 3: 69LU58CA69 ($12.27 in chips) 
Seat 4: Contempe ($17.62 in chips) 
Seat 5: skakalec90 ($10.47 in chips) 
Seat 6: RAIM2020 ($9.33 in chips) 
skakalec90: posts small blind $0.05
RAIM2020: posts big blind $0.10
*** HOLE CARDS ***
Felix UA777: folds 
genad: folds 
69LU58CA69: folds 
Contempe: folds 
skakalec90: folds 
Uncalled bet ($0.05) returned to RAIM2020
RAIM2020 collected $0.10 from pot
RAIM2020: doesn't show hand 
*** SUMMARY ***
Total pot $0.10 | Rake $0 
Seat 1: Felix UA777 folded before Flop (didn't bet)
Seat 2: genad folded before Flop (didn't bet)
Seat 3: 69LU58CA69 folded before Flop (didn't bet)
Seat 4: Contempe (button) folded before Flop (didn't bet)
Seat 5: skakalec90 (small blind) folded before Flop
Seat 6: RAIM2020 (big blind) collected ($0.10)



PokerStars Hand #222974776722:  Hold'em No Limit ($0.05/$0.10 USD) - 2021/01/23 17:20:08 ET
Table 'Merope IV' 6-max Seat #5 is the button
Seat 1: Felix UA777 ($10 in chips) 
Seat 2: genad ($25.20 in chips) 
Seat 3: 69LU58CA69 ($12.27 in chips) 
Seat 4: Contempe ($17.62 in chips) 
Seat 5: skakalec90 ($10.42 in chips) 
Seat 6: RAIM2020 ($9.38 in chips) 
RAIM2020: posts small blind $0.05
Felix UA777: posts big blind $0.10
*** HOLE CARDS ***
genad: folds 
69LU58CA69: calls $0.10
Contempe: folds 
skakalec90: raises $0.20 to $0.30
RAIM2020: calls $0.25
Felix UA777: folds 
69LU58CA69: calls $0.20
*** FLOP *** [6c 4h 5c]
RAIM2020: checks 
69LU58CA69: bets $0.30
skakalec90: folds 
RAIM2020: calls $0.30
*** TURN *** [6c 4h 5c] [Qc]
RAIM2020: bets $1.53
69LU58CA69: calls $1.53
*** RIVER *** [6c 4h 5c Qc] [Jd]
RAIM2020: checks 
69LU58CA69: checks 
*** SHOW DOWN ***
RAIM2020: shows [Kd Tc] (high card King)
69LU58CA69: shows [7c 6s] (a pair of Sixes)
69LU58CA69 collected $4.45 from pot
*** SUMMARY ***
Total pot $4.66 | Rake $0.21 
Board [6c 4h 5c Qc Jd]
Seat 1: Felix UA777 (big blind) folded before Flop
Seat 2: genad folded before Flop (didn't bet)
Seat 3: 69LU58CA69 showed [7c 6s] and won ($4.45) with a pair of Sixes
Seat 4: Contempe folded before Flop (didn't bet)
Seat 5: skakalec90 (button) folded on the Flop
Seat 6: RAIM2020 (small blind) showed [Kd Tc] and lost with high card King



PokerStars Hand #222974812839:  Hold'em No Limit ($0.05/$0.10 USD) - 2021/01/23 17:20:52 ET
Table 'Merope IV' 6-max Seat #6 is the button
Seat 1: Felix UA777 ($10 in chips) 
Seat 2: genad ($25.20 in chips) 
Seat 3: 69LU58CA69 ($14.59 in chips) 
Seat 4: Contempe ($17.62 in chips) 
Seat 5: skakalec90 ($10.12 in chips) 
Seat 6: RAIM2020 ($7.25 in chips) 
Felix UA777: posts small blind $0.05
genad: posts big blind $0.10
*** HOLE CARDS ***
69LU58CA69: calls $0.10
Contempe: folds 
skakalec90: folds 
RAIM2020: calls $0.10
Felix UA777: folds 
genad: checks 
*** FLOP *** [7d 7h 6h]
genad: checks 
69LU58CA69: checks 
RAIM2020: bets $0.33
genad: folds 
69LU58CA69: calls $0.33
*** TURN *** [7d 7h 6h] [4d]
69LU58CA69: bets $0.60
RAIM2020: raises $2.16 to $2.76
69LU58CA69: raises $3.24 to $6
RAIM2020: raises $0.82 to $6.82 and is all-in
69LU58CA69: calls $0.82
*** RIVER *** [7d 7h 6h 4d] [Ts]
*** SHOW DOWN ***
69LU58CA69: shows [Tc 7c] (a full house, Sevens full of Tens)
RAIM2020: shows [8d 5d] (a straight, Four to Eight)
69LU58CA69 collected $13.99 from pot
*** SUMMARY ***
Total pot $14.65 | Rake $0.66 
Board [7d 7h 6h 4d Ts]
Seat 1: Felix UA777 (small blind) folded before Flop
Seat 2: genad (big blind) folded on the Flop
Seat 3: 69LU58CA69 showed [Tc 7c] and won ($13.99) with a full house, Sevens full of Tens
Seat 4: Contempe folded before Flop (didn't bet)
Seat 5: skakalec90 folded before Flop (didn't bet)
Seat 6: RAIM2020 (button) showed [8d 5d] and lost with a straight, Four to Eight



PokerStars Hand #222974857349:  Hold'em No Limit ($0.05/$0.10 USD) - 2021/01/23 17:21:47 ET
Table 'Merope IV' 6-max Seat #1 is the button
Seat 1: Felix UA777 ($10 in chips) 
Seat 2: genad ($25.10 in chips) 
Seat 3: 69LU58CA69 ($21.33 in chips) 
Seat 4: Contempe ($17.62 in chips) 
Seat 5: skakalec90 ($10.12 in chips) 
genad: posts small blind $0.05
69LU58CA69: posts big blind $0.10
*** HOLE CARDS ***
Contempe: folds 
skakalec90: raises $0.20 to $0.30
Felix UA777: raises $0.64 to $0.94
genad: folds 
69LU58CA69: folds 
skakalec90: calls $0.64
*** FLOP *** [As 7d Qs]
skakalec90: checks 
Felix UA777: checks 
*** TURN *** [As 7d Qs] [6h]
skakalec90: bets $1
RAIM2020 leaves the table
Felix UA777: calls $1
*** RIVER *** [As 7d Qs 6h] [Jd]
skakalec90: checks 
and 07335 joins the table at seat #6 
Felix UA777: checks 
*** SHOW DOWN ***
skakalec90: shows [Kd Ac] (a pair of Aces)
Felix UA777: mucks hand 
skakalec90 collected $3.85 from pot
*** SUMMARY ***
Total pot $4.03 | Rake $0.18 
Board [As 7d Qs 6h Jd]
Seat 1: Felix UA777 (button) mucked
Seat 2: genad (small blind) folded before Flop
Seat 3: 69LU58CA69 (big blind) folded before Flop
Seat 4: Contempe folded before Flop (didn't bet)
Seat 5: skakalec90 showed [Kd Ac] and won ($3.85) with a pair of Aces



PokerStars Hand #222974897914:  Hold'em No Limit ($0.05/$0.10 USD) - 2021/01/23 17:22:37 ET
Table 'Merope IV' 6-max Seat #2 is the button
Seat 1: Felix UA777 ($10 in chips) 
Seat 2: genad ($25.05 in chips) 
Seat 3: 69LU58CA69 ($21.23 in chips) 
Seat 4: Contempe ($17.62 in chips) 
Seat 5: skakalec90 ($12.03 in chips) 
69LU58CA69: posts small blind $0.05
Contempe: posts big blind $0.10
*** HOLE CARDS ***
skakalec90: folds 
Felix UA777: folds 
genad: raises $0.15 to $0.25
69LU58CA69: folds 
and 07335 leaves the table
Contempe: folds 
Uncalled bet ($0.15) returned to genad
genad collected $0.25 from pot
genad: doesn't show hand 
*** SUMMARY ***
Total pot $0.25 | Rake $0 
Seat 1: Felix UA777 folded before Flop (didn't bet)
Seat 2: genad (button) collected ($0.25)
Seat 3: 69LU58CA69 (small blind) folded before Flop
Seat 4: Contempe (big blind) folded before Flop
Seat 5: skakalec90 folded before Flop (didn't bet)



PokerStars Hand #222974909105:  Hold'em No Limit ($0.05/$0.10 USD) - 2021/01/23 17:22:50 ET
Table 'Merope IV' 6-max Seat #3 is the button
Seat 1: Felix UA777 ($10 in chips) 
Seat 2: genad ($25.20 in chips) 
Seat 3: 69LU58CA69 ($21.18 in chips) 
Seat 4: Contempe ($17.52 in chips) 
Seat 5: skakalec90 ($12.03 in chips) 
Contempe: posts small blind $0.05
skakalec90: posts big blind $0.10
*** HOLE CARDS ***
Felix UA777: folds 
Megabite11 joins the table at seat #6 
genad: folds 
69LU58CA69: calls $0.10
Contempe: folds 
skakalec90: checks 
*** FLOP *** [3c 4s 5s]
skakalec90: checks 
69LU58CA69: checks 
*** TURN *** [3c 4s 5s] [Tc]
skakalec90: checks 
69LU58CA69: checks 
*** RIVER *** [3c 4s 5s Tc] [7h]
skakalec90: checks 
69LU58CA69: checks 
*** SHOW DOWN ***
skakalec90: shows [3d 2c] (a pair of Threes)
69LU58CA69: mucks hand 
skakalec90 collected $0.24 from pot
*** SUMMARY ***
Total pot $0.25 | Rake $0.01 
Board [3c 4s 5s Tc 7h]
Seat 1: Felix UA777 folded before Flop (didn't bet)
Seat 2: genad folded before Flop (didn't bet)
Seat 3: 69LU58CA69 (button) mucked
Seat 4: Contempe (small blind) folded before Flop
Seat 5: skakalec90 (big blind) showed [3d 2c] and won ($0.24) with a pair of Threes



PokerStars Hand #222974933095:  Hold'em No Limit ($0.05/$0.10 USD) - 2021/01/23 17:23:20 ET
Table 'Merope IV' 6-max Seat #4 is the button
Seat 1: Felix UA777 ($10 in chips) 
Seat 2: genad ($25.20 in chips) 
Seat 3: 69LU58CA69 ($21.08 in chips) 
Seat 4: Contempe ($17.47 in chips) 
Seat 5: skakalec90 ($12.17 in chips) 
Seat 6: Megabite11 ($10 in chips) 
skakalec90: posts small blind $0.05
Megabite11: posts big blind $0.10
*** HOLE CARDS ***
Felix UA777: folds 
genad: folds 
69LU58CA69: folds 
Contempe: folds 
skakalec90: folds 
Uncalled bet ($0.05) returned to Megabite11
Megabite11 collected $0.10 from pot
Megabite11: doesn't show hand 
*** SUMMARY ***
Total pot $0.10 | Rake $0 
Seat 1: Felix UA777 folded before Flop (didn't bet)
Seat 2: genad folded before Flop (didn't bet)
Seat 3: 69LU58CA69 folded before Flop (didn't bet)
Seat 4: Contempe (button) folded before Flop (didn't bet)
Seat 5: skakalec90 (small blind) folded before Flop
Seat 6: Megabite11 (big blind) collected ($0.10)



PokerStars Hand #222974941698:  Hold'em No Limit ($0.05/$0.10 USD) - 2021/01/23 17:23:30 ET
Table 'Merope IV' 6-max Seat #5 is the button
Seat 1: Felix UA777 ($10 in chips) 
Seat 2: genad ($25.20 in chips) 
Seat 3: 69LU58CA69 ($21.08 in chips) 
Seat 4: Contempe ($17.47 in chips) 
Seat 5: skakalec90 ($12.12 in chips) 
Seat 6: Megabite11 ($10.05 in chips) 
Megabite11: posts small blind $0.05
Felix UA777: posts big blind $0.10
*** HOLE CARDS ***
genad: folds 
69LU58CA69: folds 
Contempe: folds 
skakalec90: raises $0.20 to $0.30
Megabite11: raises $0.80 to $1.10
Felix UA777: folds 
skakalec90: folds 
Uncalled bet ($0.80) returned to Megabite11
Megabite11 collected $0.70 from pot
Megabite11: doesn't show hand 
*** SUMMARY ***
Total pot $0.70 | Rake $0 
Seat 1: Felix UA777 (big blind) folded before Flop
Seat 2: genad folded before Flop (didn't bet)
Seat 3: 69LU58CA69 folded before Flop (didn't bet)
Seat 4: Contempe folded before Flop (didn't bet)
Seat 5: skakalec90 (button) folded before Flop
Seat 6: Megabite11 (small blind) collected ($0.70)



PokerStars Hand #222974961991:  Hold'em No Limit ($0.05/$0.10 USD) - 2021/01/23 17:23:55 ET
Table 'Merope IV' 6-max Seat #6 is the button
Seat 1: Felix UA777 ($10 in chips) 
Seat 2: genad ($25.20 in chips) 
Seat 3: 69LU58CA69 ($21.08 in chips) 
Seat 4: Contempe ($17.47 in chips) 
Seat 5: skakalec90 ($11.82 in chips) 
Seat 6: Megabite11 ($10.45 in chips) 
Felix UA777: posts small blind $0.05
genad: posts big blind $0.10
*** HOLE CARDS ***
69LU58CA69: calls $0.10
Contempe: folds 
skakalec90: folds 
Megabite11: raises $0.30 to $0.40
Felix UA777: folds 
genad: folds 
69LU58CA69: calls $0.30
*** FLOP *** [As Jd Jc]
69LU58CA69: checks 
Megabite11: bets $0.30
69LU58CA69: calls $0.30
*** TURN *** [As Jd Jc] [Td]
69LU58CA69: checks 
Megabite11: checks 
*** RIVER *** [As Jd Jc Td] [5h]
69LU58CA69: bets $0.50
Megabite11: folds 
Uncalled bet ($0.50) returned to 69LU58CA69
69LU58CA69 collected $1.48 from pot
69LU58CA69: doesn't show hand 
*** SUMMARY ***
Total pot $1.55 | Rake $0.07 
Board [As Jd Jc Td 5h]
Seat 1: Felix UA777 (small blind) folded before Flop
Seat 2: genad (big blind) folded before Flop
Seat 3: 69LU58CA69 collected ($1.48)
Seat 4: Contempe folded before Flop (didn't bet)
Seat 5: skakalec90 folded before Flop (didn't bet)
Seat 6: Megabite11 (button) folded on the River



PokerStars Hand #222975022130:  Hold'em No Limit ($0.05/$0.10 USD) - 2021/01/23 17:25:10 ET
Table 'Merope IV' 6-max Seat #1 is the button
Seat 1: Felix UA777 ($10 in chips) 
Seat 2: genad ($25.10 in chips) 
Seat 3: 69LU58CA69 ($21.86 in chips) 
Seat 4: Contempe ($17.47 in chips) 
Seat 5: skakalec90 ($11.82 in chips) 
Seat 6: Megabite11 ($10 in chips) 
genad: posts small blind $0.05
69LU58CA69: posts big blind $0.10
*** HOLE CARDS ***
Contempe: raises $0.20 to $0.30
skakalec90: folds 
Megabite11: folds 
Felix UA777: folds 
genad: calls $0.25
69LU58CA69: calls $0.20
*** FLOP *** [4h 3d 9d]
genad: checks 
69LU58CA69: bets $0.40
Contempe: calls $0.40
genad: calls $0.40
*** TURN *** [4h 3d 9d] [6h]
genad: checks 
69LU58CA69: bets $0.65
Contempe: folds 
genad: folds 
Uncalled bet ($0.65) returned to 69LU58CA69
69LU58CA69 collected $2.01 from pot
69LU58CA69: doesn't show hand 
*** SUMMARY ***
Total pot $2.10 | Rake $0.09 
Board [4h 3d 9d 6h]
Seat 1: Felix UA777 (button) folded before Flop (didn't bet)
Seat 2: genad (small blind) folded on the Turn
Seat 3: 69LU58CA69 (big blind) collected ($2.01)
Seat 4: Contempe folded on the Turn
Seat 5: skakalec90 folded before Flop (didn't bet)
Seat 6: Megabite11 folded before Flop (didn't bet)



PokerStars Hand #222975077865:  Hold'em No Limit ($0.05/$0.10 USD) - 2021/01/23 17:26:20 ET
Table 'Merope IV' 6-max Seat #2 is the button
Seat 1: Felix UA777 ($10 in chips) 
Seat 2: genad ($24.40 in chips) 
Seat 3: 69LU58CA69 ($23.17 in chips) 
Seat 4: Contempe ($16.77 in chips) 
Seat 5: skakalec90 ($11.82 in chips) 
Seat 6: Megabite11 ($10 in chips) 
69LU58CA69: posts small blind $0.05
Contempe: posts big blind $0.10
*** HOLE CARDS ***
skakalec90: folds 
Megabite11: raises $0.12 to $0.22
Felix UA777: folds 
genad: raises $0.58 to $0.80
69LU58CA69: folds 
Contempe: folds 
Megabite11: folds 
Uncalled bet ($0.58) returned to genad
genad collected $0.59 from pot
genad: doesn't show hand 
*** SUMMARY ***
Total pot $0.59 | Rake $0 
Seat 1: Felix UA777 folded before Flop (didn't bet)
Seat 2: genad (button) collected ($0.59)
Seat 3: 69LU58CA69 (small blind) folded before Flop
Seat 4: Contempe (big blind) folded before Flop
Seat 5: skakalec90 folded before Flop (didn't bet)
Seat 6: Megabite11 folded before Flop



PokerStars Hand #222975099223:  Hold'em No Limit ($0.05/$0.10 USD) - 2021/01/23 17:26:46 ET
Table 'Merope IV' 6-max Seat #3 is the button
Seat 1: Felix UA777 ($10 in chips) 
Seat 2: genad ($24.77 in chips) 
Seat 3: 69LU58CA69 ($23.12 in chips) 
Seat 4: Contempe ($16.67 in chips) 
Seat 5: skakalec90 ($11.82 in chips) 
Seat 6: Megabite11 ($10 in chips) 
Contempe: posts small blind $0.05
skakalec90: posts big blind $0.10
*** HOLE CARDS ***
Megabite11: folds 
Felix UA777: folds 
genad: folds 
69LU58CA69: raises $0.10 to $0.20
Contempe: folds 
skakalec90: folds 
Uncalled bet ($0.10) returned to 69LU58CA69
69LU58CA69 collected $0.25 from pot
69LU58CA69: doesn't show hand 
*** SUMMARY ***
Total pot $0.25 | Rake $0 
Seat 1: Felix UA777 folded before Flop (didn't bet)
Seat 2: genad folded before Flop (didn't bet)
Seat 3: 69LU58CA69 (button) collected ($0.25)
Seat 4: Contempe (small blind) folded before Flop
Seat 5: skakalec90 (big blind) folded before Flop
Seat 6: Megabite11 folded before Flop (didn't bet)



PokerStars Hand #222975115859:  Hold'em No Limit ($0.05/$0.10 USD) - 2021/01/23 17:27:07 ET
Table 'Merope IV' 6-max Seat #4 is the button
Seat 1: Felix UA777 ($10 in chips) 
Seat 2: genad ($24.77 in chips) 
Seat 3: 69LU58CA69 ($23.27 in chips) 
Seat 4: Contempe ($16.62 in chips) 
Seat 5: skakalec90 ($11.72 in chips) 
Seat 6: Megabite11 ($10 in chips) 
skakalec90: posts small blind $0.05
Megabite11: posts big blind $0.10
*** HOLE CARDS ***
Felix UA777: folds 
genad: folds 
69LU58CA69 has timed out
69LU58CA69: folds 
Contempe: raises $0.20 to $0.30
skakalec90: folds 
Megabite11: folds 
Uncalled bet ($0.20) returned to Contempe
Contempe collected $0.25 from pot
*** SUMMARY ***
Total pot $0.25 | Rake $0 
Seat 1: Felix UA777 folded before Flop (didn't bet)
Seat 2: genad folded before Flop (didn't bet)
Seat 3: 69LU58CA69 folded before Flop (didn't bet)
Seat 4: Contempe (button) collected ($0.25)
Seat 5: skakalec90 (small blind) folded before Flop
Seat 6: Megabite11 (big blind) folded before Flop



PokerStars Hand #222975135188:  Hold'em No Limit ($0.05/$0.10 USD) - 2021/01/23 17:27:31 ET
Table 'Merope IV' 6-max Seat #5 is the button
Seat 1: Felix UA777 ($10 in chips) 
Seat 2: genad ($24.77 in chips) 
Seat 3: 69LU58CA69 ($23.27 in chips) 
Seat 4: Contempe ($16.77 in chips) 
Seat 5: skakalec90 ($11.67 in chips) 
Seat 6: Megabite11 ($10 in chips) 
Megabite11: posts small blind $0.05
Felix UA777: posts big blind $0.10
*** HOLE CARDS ***
genad: folds 
69LU58CA69: raises $0.20 to $0.30
Contempe: calls $0.30
skakalec90: folds 
Megabite11: folds 
Felix UA777: calls $0.20
*** FLOP *** [Tc Ks 3h]
Felix UA777: checks 
69LU58CA69: bets $0.50
Contempe: raises $0.90 to $1.40
Felix UA777: folds 
69LU58CA69: calls $0.90
*** TURN *** [Tc Ks 3h] [7s]
69LU58CA69: checks 
Contempe: bets $1.45
69LU58CA69: folds 
Uncalled bet ($1.45) returned to Contempe
Contempe collected $3.58 from pot
*** SUMMARY ***
Total pot $3.75 | Rake $0.17 
Board [Tc Ks 3h 7s]
Seat 1: Felix UA777 (big blind) folded on the Flop
Seat 2: genad folded before Flop (didn't bet)
Seat 3: 69LU58CA69 folded on the Turn
Seat 4: Contempe collected ($3.58)
Seat 5: skakalec90 (button) folded before Flop (didn't bet)
Seat 6: Megabite11 (small blind) folded before Flop



PokerStars Hand #222975194429:  Hold'em No Limit ($0.05/$0.10 USD) - 2021/01/23 17:28:42 ET
Table 'Merope IV' 6-max Seat #6 is the button
Seat 1: Felix UA777 ($10 in chips) 
Seat 2: genad ($24.77 in chips) 
Seat 3: 69LU58CA69 ($21.57 in chips) 
Seat 4: Contempe ($18.65 in chips) 
Seat 5: skakalec90 ($11.67 in chips) 
Seat 6: Megabite11 ($10 in chips) 
Felix UA777: posts small blind $0.05
genad: posts big blind $0.10
*** HOLE CARDS ***
69LU58CA69: calls $0.10
Contempe: calls $0.10
skakalec90: raises $0.20 to $0.30
Megabite11: folds 
Felix UA777: folds 
genad: folds 
69LU58CA69: calls $0.20
Contempe: calls $0.20
*** FLOP *** [5d Ad 7s]
69LU58CA69: bets $0.30
Contempe: folds 
skakalec90: calls $0.30
*** TURN *** [5d Ad 7s] [Qh]
69LU58CA69: bets $0.60
skakalec90: calls $0.60
*** RIVER *** [5d Ad 7s Qh] [Jh]
69LU58CA69: bets $0.70
skakalec90: calls $0.70
*** SHOW DOWN ***
69LU58CA69: shows [5s 6d] (a pair of Fives)
skakalec90: shows [As Kd] (a pair of Aces)
skakalec90 collected $4.06 from pot
*** SUMMARY ***
Total pot $4.25 | Rake $0.19 
Board [5d Ad 7s Qh Jh]
Seat 1: Felix UA777 (small blind) folded before Flop
Seat 2: genad (big blind) folded before Flop
Seat 3: 69LU58CA69 showed [5s 6d] and lost with a pair of Fives
Seat 4: Contempe folded on the Flop
Seat 5: skakalec90 showed [As Kd] and won ($4.06) with a pair of Aces
Seat 6: Megabite11 (button) folded before Flop (didn't bet)



PokerStars Hand #222975231153:  Hold'em No Limit ($0.05/$0.10 USD) - 2021/01/23 17:29:28 ET
Table 'Merope IV' 6-max Seat #1 is the button
Seat 1: Felix UA777 ($10 in chips) 
Seat 2: genad ($24.67 in chips) 
Seat 3: 69LU58CA69 ($19.67 in chips) 
Seat 4: Contempe ($18.35 in chips) 
Seat 5: skakalec90 ($13.83 in chips) 
Seat 6: Megabite11 ($10 in chips) 
genad: posts small blind $0.05
69LU58CA69: posts big blind $0.10
*** HOLE CARDS ***
Contempe: folds 
skakalec90: folds 
Megabite11: folds 
Felix UA777: folds 
genad: folds 
Uncalled bet ($0.05) returned to 69LU58CA69
69LU58CA69 collected $0.10 from pot
69LU58CA69: doesn't show hand 
*** SUMMARY ***
Total pot $0.10 | Rake $0 
Seat 1: Felix UA777 (button) folded before Flop (didn't bet)
Seat 2: genad (small blind) folded before Flop
Seat 3: 69LU58CA69 (big blind) collected ($0.10)
Seat 4: Contempe folded before Flop (didn't bet)
Seat 5: skakalec90 folded before Flop (didn't bet)
Seat 6: Megabite11 folded before Flop (didn't bet)



PokerStars Hand #222975241825:  Hold'em No Limit ($0.05/$0.10 USD) - 2021/01/23 17:29:41 ET
Table 'Merope IV' 6-max Seat #2 is the button
Seat 1: Felix UA777 ($10 in chips) 
Seat 2: genad ($24.62 in chips) 
Seat 3: 69LU58CA69 ($19.72 in chips) 
Seat 4: Contempe ($18.35 in chips) 
Seat 5: skakalec90 ($13.83 in chips) 
Seat 6: Megabite11 ($10 in chips) 
69LU58CA69: posts small blind $0.05
Contempe: posts big blind $0.10
*** HOLE CARDS ***
skakalec90: folds 
Megabite11: folds 
Felix UA777: folds 
genad: raises $0.15 to $0.25
69LU58CA69: calls $0.20
Contempe: folds 
*** FLOP *** [8d 4h 4c]
69LU58CA69: bets $0.40
genad: calls $0.40
*** TURN *** [8d 4h 4c] [Ah]
69LU58CA69: bets $0.70
genad: calls $0.70
*** RIVER *** [8d 4h 4c Ah] [8h]
69LU58CA69: bets $1.30
genad: calls $1.30
*** SHOW DOWN ***
69LU58CA69: shows [Kd Jc] (two pair, Eights and Fours)
genad: shows [Ac 6d] (two pair, Aces and Eights)
genad collected $5.16 from pot
*** SUMMARY ***
Total pot $5.40 | Rake $0.24 
Board [8d 4h 4c Ah 8h]
Seat 1: Felix UA777 folded before Flop (didn't bet)
Seat 2: genad (button) showed [Ac 6d] and won ($5.16) with two pair, Aces and Eights
Seat 3: 69LU58CA69 (small blind) showed [Kd Jc] and lost with two pair, Eights and Fours
Seat 4: Contempe (big blind) folded before Flop
Seat 5: skakalec90 folded before Flop (didn't bet)
Seat 6: Megabite11 folded before Flop (didn't bet)



PokerStars Hand #222975297223:  Hold'em No Limit ($0.05/$0.10 USD) - 2021/01/23 17:30:51 ET
Table 'Merope IV' 6-max Seat #3 is the button
Seat 1: Felix UA777 ($10 in chips) 
Seat 2: genad ($27.13 in chips) 
Seat 3: 69LU58CA69 ($17.07 in chips) 
Seat 4: Contempe ($18.25 in chips) 
Seat 5: skakalec90 ($13.83 in chips) 
Seat 6: Megabite11 ($10 in chips) 
Contempe: posts small blind $0.05
skakalec90: posts big blind $0.10
*** HOLE CARDS ***
Megabite11: folds 
Felix UA777: folds 
genad: raises $0.15 to $0.25
69LU58CA69: folds 
69LU58CA69 leaves the table
Contempe: calls $0.20
skakalec90: folds 
*** FLOP *** [9h 3s 8c]
korti24 joins the table at seat #3 
Contempe: checks 
genad: bets $0.29
Contempe: folds 
Uncalled bet ($0.29) returned to genad
genad collected $0.57 from pot
genad: doesn't show hand 
*** SUMMARY ***
Total pot $0.60 | Rake $0.03 
Board [9h 3s 8c]
Seat 1: Felix UA777 folded before Flop (didn't bet)
Seat 2: genad collected ($0.57)
Seat 3: 69LU58CA69 (button) folded before Flop (didn't bet)
Seat 4: Contempe (small blind) folded on the Flop
Seat 5: skakalec90 (big blind) folded before Flop
Seat 6: Megabite11 folded before Flop (didn't bet)



PokerStars Hand #222975331606:  Hold'em No Limit ($0.05/$0.10 USD) - 2021/01/23 17:31:35 ET
Table 'Merope IV' 6-max Seat #4 is the button
Seat 1: Felix UA777 ($10 in chips) 
Seat 2: genad ($27.45 in chips) 
Seat 3: korti24 ($10 in chips) 
Seat 4: Contempe ($18 in chips) 
Seat 5: skakalec90 ($13.73 in chips) 
Seat 6: Megabite11 ($10 in chips) 
skakalec90: posts small blind $0.05
Megabite11: posts big blind $0.10
korti24: posts big blind $0.10
*** HOLE CARDS ***
Felix UA777: folds 
genad: folds 
korti24: checks 
Contempe: raises $0.25 to $0.35
skakalec90: calls $0.30
Megabite11: folds 
korti24: folds 
*** FLOP *** [Kc 3h 9s]
skakalec90: checks 
Contempe: bets $0.47
skakalec90: calls $0.47
*** TURN *** [Kc 3h 9s] [2s]
skakalec90: checks 
Contempe: bets $0.97
skakalec90: raises $2.03 to $3
Contempe: folds 
Uncalled bet ($2.03) returned to skakalec90
skakalec90 collected $3.61 from pot
skakalec90: doesn't show hand 
*** SUMMARY ***
Total pot $3.78 | Rake $0.17 
Board [Kc 3h 9s 2s]
Seat 1: Felix UA777 folded before Flop (didn't bet)
Seat 2: genad folded before Flop (didn't bet)
Seat 3: korti24 folded before Flop (didn't bet)
Seat 4: Contempe (button) folded on the Turn
Seat 5: skakalec90 (small blind) collected ($3.61)
Seat 6: Megabite11 (big blind) folded before Flop



PokerStars Hand #222975388628:  Hold'em No Limit ($0.05/$0.10 USD) - 2021/01/23 17:32:47 ET
Table 'Merope IV' 6-max Seat #5 is the button
Seat 1: Felix UA777 ($10 in chips) 
Seat 2: genad ($27.45 in chips) 
Seat 3: korti24 ($9.90 in chips) 
Seat 4: Contempe ($16.21 in chips) 
Seat 5: skakalec90 ($15.55 in chips) 
Seat 6: Megabite11 ($10 in chips) 
Megabite11: posts small blind $0.05
Felix UA777: posts big blind $0.10
*** HOLE CARDS ***
genad: folds 
korti24: folds 
Contempe: folds 
skakalec90: raises $0.20 to $0.30
Megabite11: folds 
Felix UA777: raises $0.75 to $1.05
skakalec90: folds 
Uncalled bet ($0.75) returned to Felix UA777
Felix UA777 collected $0.65 from pot
Felix UA777: doesn't show hand 
*** SUMMARY ***
Total pot $0.65 | Rake $0 
Seat 1: Felix UA777 (big blind) collected ($0.65)
Seat 2: genad folded before Flop (didn't bet)
Seat 3: korti24 folded before Flop (didn't bet)
Seat 4: Contempe folded before Flop (didn't bet)
Seat 5: skakalec90 (button) folded before Flop
Seat 6: Megabite11 (small blind) folded before Flop



PokerStars Hand #222975416041:  Hold'em No Limit ($0.05/$0.10 USD) - 2021/01/23 17:33:22 ET
Table 'Merope IV' 6-max Seat #6 is the button
Seat 1: Felix UA777 ($10.35 in chips) 
Seat 2: genad ($27.45 in chips) 
Seat 3: korti24 ($9.90 in chips) 
Seat 4: Contempe ($16.21 in chips) 
Seat 5: skakalec90 ($15.25 in chips) 
Seat 6: Megabite11 ($10 in chips) 
Felix UA777: posts small blind $0.05
genad: posts big blind $0.10
*** HOLE CARDS ***
korti24: folds 
Contempe: folds 
skakalec90: raises $0.20 to $0.30
Megabite11: folds 
Felix UA777: folds 
genad: folds 
Uncalled bet ($0.20) returned to skakalec90
skakalec90 collected $0.25 from pot
skakalec90: doesn't show hand 
*** SUMMARY ***
Total pot $0.25 | Rake $0 
Seat 1: Felix UA777 (small blind) folded before Flop
Seat 2: genad (big blind) folded before Flop
Seat 3: korti24 folded before Flop (didn't bet)
Seat 4: Contempe folded before Flop (didn't bet)
Seat 5: skakalec90 collected ($0.25)
Seat 6: Megabite11 (button) folded before Flop (didn't bet)



PokerStars Hand #222975436233:  Hold'em No Limit ($0.05/$0.10 USD) - 2021/01/23 17:33:48 ET
Table 'Merope IV' 6-max Seat #1 is the button
Seat 1: Felix UA777 ($10.30 in chips) 
Seat 2: genad ($27.35 in chips) 
Seat 3: korti24 ($9.90 in chips) 
Seat 4: Contempe ($16.21 in chips) 
Seat 5: skakalec90 ($15.40 in chips) 
Seat 6: Megabite11 ($10 in chips) 
genad: posts small blind $0.05
korti24: posts big blind $0.10
*** HOLE CARDS ***
Contempe: folds 
skakalec90: folds 
Megabite11: raises $0.12 to $0.22
Felix UA777: folds 
genad: folds 
korti24: folds 
Uncalled bet ($0.12) returned to Megabite11
Megabite11 collected $0.25 from pot
Megabite11: doesn't show hand 
Contempe leaves the table
*** SUMMARY ***
Total pot $0.25 | Rake $0 
Seat 1: Felix UA777 (button) folded before Flop (didn't bet)
Seat 2: genad (small blind) folded before Flop
Seat 3: korti24 (big blind) folded before Flop
Seat 4: Contempe folded before Flop (didn't bet)
Seat 5: skakalec90 folded before Flop (didn't bet)
Seat 6: Megabite11 collected ($0.25)



PokerStars Hand #222975452352:  Hold'em No Limit ($0.05/$0.10 USD) - 2021/01/23 17:34:08 ET
Table 'Merope IV' 6-max Seat #2 is the button
Seat 1: Felix UA777 ($10.30 in chips) 
Seat 2: genad ($27.30 in chips) 
Seat 3: korti24 ($9.80 in chips) 
Seat 5: skakalec90 ($15.40 in chips) 
Seat 6: Megabite11 ($10.15 in chips) 
korti24: posts small blind $0.05
skakalec90: posts big blind $0.10
*** HOLE CARDS ***
Megabite11: raises $0.12 to $0.22
Felix UA777: folds 
genad: folds 
korti24: folds 
skakalec90: folds 
Uncalled bet ($0.12) returned to Megabite11
Megabite11 collected $0.25 from pot
Megabite11: doesn't show hand 
*** SUMMARY ***
Total pot $0.25 | Rake $0 
Seat 1: Felix UA777 folded before Flop (didn't bet)
Seat 2: genad (button) folded before Flop (didn't bet)
Seat 3: korti24 (small blind) folded before Flop
Seat 5: skakalec90 (big blind) folded before Flop
Seat 6: Megabite11 collected ($0.25)



PokerStars Hand #222975463336:  Hold'em No Limit ($0.05/$0.10 USD) - 2021/01/23 17:34:22 ET
Table 'Merope IV' 6-max Seat #3 is the button
Seat 1: Felix UA777 ($10.30 in chips) 
Seat 2: genad ($27.30 in chips) 
Seat 3: korti24 ($9.75 in chips) 
Seat 5: skakalec90 ($15.30 in chips) 
Seat 6: Megabite11 ($10.30 in chips) 
skakalec90: posts small blind $0.05
Megabite11: posts big blind $0.10
*** HOLE CARDS ***
Felix UA777: folds 
genad: raises $0.15 to $0.25
korti24: folds 
skakalec90: calls $0.20
Megabite11: folds 
*** FLOP *** [Qs Ac 6d]
skakalec90: bets $0.29
genad: calls $0.29
*** TURN *** [Qs Ac 6d] [4h]
skakalec90: bets $0.50
Romadon joins the table at seat #4 
genad: folds 
Uncalled bet ($0.50) returned to skakalec90
skakalec90 collected $1.13 from pot
skakalec90: doesn't show hand 
*** SUMMARY ***
Total pot $1.18 | Rake $0.05 
Board [Qs Ac 6d 4h]
Seat 1: Felix UA777 folded before Flop (didn't bet)
Seat 2: genad folded on the Turn
Seat 3: korti24 (button) folded before Flop (didn't bet)
Seat 5: skakalec90 (small blind) collected ($1.13)
Seat 6: Megabite11 (big blind) folded before Flop



PokerStars Hand #222975484785:  Hold'em No Limit ($0.05/$0.10 USD) - 2021/01/23 17:34:50 ET
Table 'Merope IV' 6-max Seat #5 is the button
Seat 3: korti24 ($9.75 in chips) 
Seat 5: skakalec90 ($15.89 in chips) 
Seat 6: Megabite11 ($10.20 in chips) 
Megabite11: posts small blind $0.05
Felix UA777: is sitting out 
genad: is sitting out 
korti24: posts big blind $0.10
Romadon: sits out 
*** HOLE CARDS ***
skakalec90: folds 
Megabite11: folds 
Uncalled bet ($0.05) returned to korti24
korti24 collected $0.10 from pot
korti24: doesn't show hand 
*** SUMMARY ***
Total pot $0.10 | Rake $0 
Seat 3: korti24 (big blind) collected ($0.10)
Seat 5: skakalec90 (button) folded before Flop (didn't bet)
Seat 6: Megabite11 (small blind) folded before Flop



PokerStars Hand #222975489514:  Hold'em No Limit ($0.05/$0.10 USD) - 2021/01/23 17:34:56 ET
Table 'Merope IV' 6-max Seat #6 is the button
Seat 3: korti24 ($9.80 in chips) 
Seat 4: Romadon ($6.91 in chips) 
Seat 5: skakalec90 ($15.89 in chips) 
Seat 6: Megabite11 ($10.15 in chips) 
korti24: posts small blind $0.05
genad leaves the table
Romadon: posts big blind $0.10
*** HOLE CARDS ***
skakalec90: folds 
Megabite11: folds 
Felix UA777 leaves the table
korti24: calls $0.05
Romadon: checks 
*** FLOP *** [2s 3d Kd]
korti24: bets $0.10
Romadon: calls $0.10
*** TURN *** [2s 3d Kd] [7c]
korti24: bets $0.40
Romadon: folds 
Uncalled bet ($0.40) returned to korti24
korti24 collected $0.38 from pot
korti24: doesn't show hand 
*** SUMMARY ***
Total pot $0.40 | Rake $0.02 
Board [2s 3d Kd 7c]
Seat 3: korti24 (small blind) collected ($0.38)
Seat 4: Romadon (big blind) folded on the Turn
Seat 5: skakalec90 folded before Flop (didn't bet)
Seat 6: Megabite11 (button) folded before Flop (didn't bet)



PokerStars Hand #222975535168:  Hold'em No Limit ($0.05/$0.10 USD) - 2021/01/23 17:35:42 ET
Table 'Merope IV' 6-max Seat #3 is the button
Seat 3: korti24 ($9.98 in chips) 
Seat 4: Romadon ($6.71 in chips) 
Seat 5: skakalec90 ($15.89 in chips) 
Seat 6: Megabite11 ($10.15 in chips) 
Romadon: posts small blind $0.05
skakalec90: posts big blind $0.10
*** HOLE CARDS ***
Megabite11: folds 
korti24: raises $0.10 to $0.20
Romadon: calls $0.15
skakalec90: calls $0.10
*** FLOP *** [2h Tc Td]
Romadon: bets $0.28
skakalec90: folds 
korti24: folds 
Uncalled bet ($0.28) returned to Romadon
Romadon collected $0.57 from pot
Romadon: doesn't show hand 
*** SUMMARY ***
Total pot $0.60 | Rake $0.03 
Board [2h Tc Td]
Seat 3: korti24 (button) folded on the Flop
Seat 4: Romadon (small blind) collected ($0.57)
Seat 5: skakalec90 (big blind) folded on the Flop
Seat 6: Megabite11 folded before Flop (didn't bet)



PokerStars Hand #222975549574:  Hold'em No Limit ($0.05/$0.10 USD) - 2021/01/23 17:36:01 ET
Table 'Merope IV' 6-max Seat #4 is the button
Seat 3: korti24 ($9.78 in chips) 
Seat 4: Romadon ($7.08 in chips) 
Seat 5: skakalec90 ($15.69 in chips) 
Seat 6: Megabite11 ($10.15 in chips) 
skakalec90: posts small blind $0.05
Megabite11: posts big blind $0.10
*** HOLE CARDS ***
korti24: folds 
Romadon: raises $0.20 to $0.30
skakalec90: folds 
Megabite11: folds 
Uncalled bet ($0.20) returned to Romadon
Romadon collected $0.25 from pot
Romadon: doesn't show hand 
*** SUMMARY ***
Total pot $0.25 | Rake $0 
Seat 3: korti24 folded before Flop (didn't bet)
Seat 4: Romadon (button) collected ($0.25)
Seat 5: skakalec90 (small blind) folded before Flop
Seat 6: Megabite11 (big blind) folded before Flop



PokerStars Hand #222975561301:  Hold'em No Limit ($0.05/$0.10 USD) - 2021/01/23 17:36:16 ET
Table 'Merope IV' 6-max Seat #5 is the button
Seat 3: korti24 ($9.78 in chips) 
Seat 4: Romadon ($7.23 in chips) 
Seat 5: skakalec90 ($15.64 in chips) 
Seat 6: Megabite11 ($10.05 in chips) 
Megabite11: posts small blind $0.05
korti24: posts big blind $0.10
*** HOLE CARDS ***
Romadon: calls $0.10
skakalec90: raises $0.20 to $0.30
Megabite11: folds 
korti24: folds 
Romadon: calls $0.20
*** FLOP *** [7h Jc Jh]
Romadon: checks 
skakalec90: checks 
*** TURN *** [7h Jc Jh] [6s]
Romadon: bets $0.36
skakalec90: folds 
Uncalled bet ($0.36) returned to Romadon
Romadon collected $0.72 from pot
Romadon: doesn't show hand 
*** SUMMARY ***
Total pot $0.75 | Rake $0.03 
Board [7h Jc Jh 6s]
Seat 3: korti24 (big blind) folded before Flop
Seat 4: Romadon collected ($0.72)
Seat 5: skakalec90 (button) folded on the Turn
Seat 6: Megabite11 (small blind) folded before Flop



PokerStars Hand #222975587162:  Hold'em No Limit ($0.05/$0.10 USD) - 2021/01/23 17:36:49 ET
Table 'Merope IV' 6-max Seat #6 is the button
Seat 3: korti24 ($9.68 in chips) 
Seat 4: Romadon ($7.65 in chips) 
Seat 5: skakalec90 ($15.34 in chips) 
Seat 6: Megabite11 ($10 in chips) 
korti24: posts small blind $0.05
Romadon: posts big blind $0.10
*** HOLE CARDS ***
skakalec90: folds 
Megabite11: folds 
korti24: folds 
Uncalled bet ($0.05) returned to Romadon
Romadon collected $0.10 from pot
Romadon: doesn't show hand 
*** SUMMARY ***
Total pot $0.10 | Rake $0 
Seat 3: korti24 (small blind) folded before Flop
Seat 4: Romadon (big blind) collected ($0.10)
Seat 5: skakalec90 folded before Flop (didn't bet)
Seat 6: Megabite11 (button) folded before Flop (didn't bet)



PokerStars Hand #222975591508:  Hold'em No Limit ($0.05/$0.10 USD) - 2021/01/23 17:36:55 ET
Table 'Merope IV' 6-max Seat #3 is the button
Seat 3: korti24 ($9.63 in chips) 
Seat 4: Romadon ($7.70 in chips) 
Seat 6: Megabite11 ($10 in chips) 
Romadon: posts small blind $0.05
skakalec90: is sitting out 
Megabite11: posts big blind $0.10
*** HOLE CARDS ***
skakalec90 leaves the table
korti24: raises $0.10 to $0.20
Romadon: calls $0.15
Nicover4 joins the table at seat #1 
Megabite11: calls $0.10
*** FLOP *** [3c 8s 2c]
Vecherov joins the table at seat #5 
xiled90 joins the table at seat #2 
Romadon: checks 
Megabite11: checks 
korti24: checks 
*** TURN *** [3c 8s 2c] [7h]
Romadon: bets $0.28
Megabite11: calls $0.28
korti24: folds 
*** RIVER *** [3c 8s 2c 7h] [Qd]
Romadon: bets $0.65
Megabite11: folds 
Uncalled bet ($0.65) returned to Romadon
Romadon collected $1.11 from pot
Romadon: doesn't show hand 
*** SUMMARY ***
Total pot $1.16 | Rake $0.05 
Board [3c 8s 2c 7h Qd]
Seat 3: korti24 (button) folded on the Turn
Seat 4: Romadon (small blind) collected ($1.11)
Seat 6: Megabite11 (big blind) folded on the River



PokerStars Hand #222975642393:  Hold'em No Limit ($0.05/$0.10 USD) - 2021/01/23 17:38:01 ET
Table 'Merope IV' 6-max Seat #4 is the button
Seat 1: Nicover4 ($10 in chips) 
Seat 3: korti24 ($9.43 in chips) 
Seat 4: Romadon ($8.33 in chips) 
Seat 6: Megabite11 ($10 in chips) 
Megabite11: posts small blind $0.05
Nicover4: posts big blind $0.10
xiled90: sits out 
*** HOLE CARDS ***
korti24: folds 
Romadon: raises $0.10 to $0.20
Megabite11: folds 
Nicover4: calls $0.10
*** FLOP *** [Kh 4h 6s]
Nicover4: checks 
Romadon: checks 
*** TURN *** [Kh 4h 6s] [8d]
Nicover4: checks 
Romadon: bets $0.31
Nicover4: folds 
Uncalled bet ($0.31) returned to Romadon
Romadon collected $0.43 from pot
Romadon: doesn't show hand 
*** SUMMARY ***
Total pot $0.45 | Rake $0.02 
Board [Kh 4h 6s 8d]
Seat 1: Nicover4 (big blind) folded on the Turn
Seat 3: korti24 folded before Flop (didn't bet)
Seat 4: Romadon (button) collected ($0.43)
Seat 6: Megabite11 (small blind) folded before Flop



PokerStars Hand #222975679516:  Hold'em No Limit ($0.05/$0.10 USD) - 2021/01/23 17:38:50 ET
Table 'Merope IV' 6-max Seat #6 is the button
Seat 1: Nicover4 ($10 in chips) 
Seat 2: xiled90 ($10 in chips) 
Seat 3: korti24 ($9.43 in chips) 
Seat 4: Romadon ($8.56 in chips) 
Seat 6: Megabite11 ($10 in chips) 
Nicover4: posts small blind $0.05
xiled90: posts big blind $0.10
Vecherov: sits out 
*** HOLE CARDS ***
korti24: folds 
Romadon: folds 
Megabite11: raises $0.12 to $0.22
Nicover4: folds 
xiled90: calls $0.12
*** FLOP *** [4s 6h Qc]
xiled90: checks 
Megabite11: bets $0.16
xiled90: folds 
Uncalled bet ($0.16) returned to Megabite11
Megabite11 collected $0.47 from pot
Megabite11: doesn't show hand 
*** SUMMARY ***
Total pot $0.49 | Rake $0.02 
Board [4s 6h Qc]
Seat 1: Nicover4 (small blind) folded before Flop
Seat 2: xiled90 (big blind) folded on the Flop
Seat 3: korti24 folded before Flop (didn't bet)
Seat 4: Romadon folded before Flop (didn't bet)
Seat 6: Megabite11 (button) collected ($0.47)



PokerStars Hand #222975707847:  Hold'em No Limit ($0.05/$0.10 USD) - 2021/01/23 17:39:26 ET
Table 'Merope IV' 6-max Seat #1 is the button
Seat 1: Nicover4 ($10 in chips) 
Seat 2: xiled90 ($10 in chips) 
Seat 3: korti24 ($9.43 in chips) 
Seat 4: Romadon ($8.56 in chips) 
Seat 6: Megabite11 ($10.25 in chips) 
xiled90: posts small blind $0.05
korti24: posts big blind $0.10
Vecherov: sits out 
*** HOLE CARDS ***
Romadon: folds 
Megabite11: raises $0.12 to $0.22
Nicover4: folds 
xiled90: folds 
korti24: folds 
Uncalled bet ($0.12) returned to Megabite11
Megabite11 collected $0.25 from pot
Megabite11: doesn't show hand 
*** SUMMARY ***
Total pot $0.25 | Rake $0 
Seat 1: Nicover4 (button) folded before Flop (didn't bet)
Seat 2: xiled90 (small blind) folded before Flop
Seat 3: korti24 (big blind) folded before Flop
Seat 4: Romadon folded before Flop (didn't bet)
Seat 6: Megabite11 collected ($0.25)



PokerStars Hand #222975720411:  Hold'em No Limit ($0.05/$0.10 USD) - 2021/01/23 17:39:43 ET
Table 'Merope IV' 6-max Seat #2 is the button
Seat 1: Nicover4 ($10 in chips) 
Seat 2: xiled90 ($10 in chips) 
Seat 3: korti24 ($9.33 in chips) 
Seat 4: Romadon ($8.56 in chips) 
Seat 6: Megabite11 ($10.40 in chips) 
korti24: posts small blind $0.05
Romadon: posts big blind $0.10
Vecherov: sits out 
*** HOLE CARDS ***
Megabite11: folds 
Nicover4: folds 
xiled90: folds 
korti24: folds 
Uncalled bet ($0.05) returned to Romadon
Romadon collected $0.10 from pot
Romadon: doesn't show hand 
*** SUMMARY ***
Total pot $0.10 | Rake $0 
Seat 1: Nicover4 folded before Flop (didn't bet)
Seat 2: xiled90 (button) folded before Flop (didn't bet)
Seat 3: korti24 (small blind) folded before Flop
Seat 4: Romadon (big blind) collected ($0.10)
Seat 6: Megabite11 folded before Flop (didn't bet)



PokerStars Hand #222975732233:  Hold'em No Limit ($0.05/$0.10 USD) - 2021/01/23 17:39:58 ET
Table 'Merope IV' 6-max Seat #3 is the button
Seat 1: Nicover4 ($10 in chips) 
Seat 2: xiled90 ($10 in chips) 
Seat 3: korti24 ($9.28 in chips) 
Seat 4: Romadon ($8.61 in chips) 
Seat 5: Vecherov ($10 in chips) 
Seat 6: Megabite11 ($10.40 in chips) 
Romadon: posts small blind $0.05
Vecherov: posts big blind $0.10
*** HOLE CARDS ***
Megabite11: raises $0.12 to $0.22
Nicover4: folds 
xiled90: folds 
korti24: calls $0.22
Romadon: raises $0.56 to $0.78
Vecherov: folds 
Megabite11: folds 
korti24: folds 
Uncalled bet ($0.56) returned to Romadon
Romadon collected $0.76 from pot
Romadon: doesn't show hand 
*** SUMMARY ***
Total pot $0.76 | Rake $0 
Seat 1: Nicover4 folded before Flop (didn't bet)
Seat 2: xiled90 folded before Flop (didn't bet)
Seat 3: korti24 (button) folded before Flop
Seat 4: Romadon (small blind) collected ($0.76)
Seat 5: Vecherov (big blind) folded before Flop
Seat 6: Megabite11 folded before Flop



PokerStars Hand #222975751121:  Hold'em No Limit ($0.05/$0.10 USD) - 2021/01/23 17:40:23 ET
Table 'Merope IV' 6-max Seat #4 is the button
Seat 1: Nicover4 ($10 in chips) 
Seat 2: xiled90 ($10 in chips) 
Seat 3: korti24 ($9.06 in chips) 
Seat 4: Romadon ($9.15 in chips) 
Seat 5: Vecherov ($10 in chips) 
Seat 6: Megabite11 ($10.18 in chips) 
Vecherov: posts small blind $0.05
Megabite11: posts big blind $0.10
*** HOLE CARDS ***
Nicover4: folds 
xiled90: folds 
korti24: folds 
Romadon: raises $0.20 to $0.30
Vecherov: folds 
Megabite11: raises $0.70 to $1
Romadon: folds 
Uncalled bet ($0.70) returned to Megabite11
Megabite11 collected $0.65 from pot
Megabite11: doesn't show hand 
*** SUMMARY ***
Total pot $0.65 | Rake $0 
Seat 1: Nicover4 folded before Flop (didn't bet)
Seat 2: xiled90 folded before Flop (didn't bet)
Seat 3: korti24 folded before Flop (didn't bet)
Seat 4: Romadon (button) folded before Flop
Seat 5: Vecherov (small blind) folded before Flop
Seat 6: Megabite11 (big blind) collected ($0.65)



PokerStars Hand #222975775049:  Hold'em No Limit ($0.05/$0.10 USD) - 2021/01/23 17:40:54 ET
Table 'Merope IV' 6-max Seat #5 is the button
Seat 1: Nicover4 ($10 in chips) 
Seat 2: xiled90 ($10 in chips) 
Seat 3: korti24 ($9.06 in chips) 
Seat 4: Romadon ($8.85 in chips) 
Seat 5: Vecherov ($10 in chips) 
Seat 6: Megabite11 ($10.53 in chips) 
Megabite11: posts small blind $0.05
Nicover4: posts big blind $0.10
*** HOLE CARDS ***
xiled90: folds 
korti24: folds 
Romadon: folds 
Vecherov: raises $0.15 to $0.25
Megabite11: folds 
Nicover4: calls $0.15
*** FLOP *** [Kh 8h 5c]
Nicover4: checks 
Vecherov: bets $0.30
Nicover4: folds 
Uncalled bet ($0.30) returned to Vecherov
Vecherov collected $0.53 from pot
Vecherov: doesn't show hand 
*** SUMMARY ***
Total pot $0.55 | Rake $0.02 
Board [Kh 8h 5c]
Seat 1: Nicover4 (big blind) folded on the Flop
Seat 2: xiled90 folded before Flop (didn't bet)
Seat 3: korti24 folded before Flop (didn't bet)
Seat 4: Romadon folded before Flop (didn't bet)
Seat 5: Vecherov (button) collected ($0.53)
Seat 6: Megabite11 (small blind) folded before Flop



PokerStars Hand #222975810875:  Hold'em No Limit ($0.05/$0.10 USD) - 2021/01/23 17:41:41 ET
Table 'Merope IV' 6-max Seat #6 is the button
Seat 1: Nicover4 ($10 in chips) 
Seat 2: xiled90 ($10 in chips) 
Seat 3: korti24 ($9.06 in chips) 
Seat 4: Romadon ($8.85 in chips) 
Seat 5: Vecherov ($10.28 in chips) 
Seat 6: Megabite11 ($10.48 in chips) 
Nicover4: posts small blind $0.05
xiled90: posts big blind $0.10
*** HOLE CARDS ***
korti24: folds 
Romadon: folds 
Vecherov: raises $0.20 to $0.30
Megabite11: folds 
Nicover4: folds 
xiled90: folds 
Uncalled bet ($0.20) returned to Vecherov
Vecherov collected $0.25 from pot
Vecherov: doesn't show hand 
*** SUMMARY ***
Total pot $0.25 | Rake $0 
Seat 1: Nicover4 (small blind) folded before Flop
Seat 2: xiled90 (big blind) folded before Flop
Seat 3: korti24 folded before Flop (didn't bet)
Seat 4: Romadon folded before Flop (didn't bet)
Seat 5: Vecherov collected ($0.25)
Seat 6: Megabite11 (button) folded before Flop (didn't bet)



PokerStars Hand #222975821830:  Hold'em No Limit ($0.05/$0.10 USD) - 2021/01/23 17:41:55 ET
Table 'Merope IV' 6-max Seat #1 is the button
Seat 1: Nicover4 ($9.95 in chips) 
Seat 2: xiled90 ($10 in chips) 
Seat 3: korti24 ($9.06 in chips) 
Seat 4: Romadon ($8.85 in chips) 
Seat 5: Vecherov ($10.43 in chips) 
Seat 6: Megabite11 ($10.48 in chips) 
xiled90: posts small blind $0.05
korti24: posts big blind $0.10
*** HOLE CARDS ***
Romadon: folds 
Vecherov: raises $0.20 to $0.30
Megabite11: folds 
Nicover4: folds 
xiled90: folds 
korti24: folds 
Uncalled bet ($0.20) returned to Vecherov
Vecherov collected $0.25 from pot
Vecherov: doesn't show hand 
*** SUMMARY ***
Total pot $0.25 | Rake $0 
Seat 1: Nicover4 (button) folded before Flop (didn't bet)
Seat 2: xiled90 (small blind) folded before Flop
Seat 3: korti24 (big blind) folded before Flop
Seat 4: Romadon folded before Flop (didn't bet)
Seat 5: Vecherov collected ($0.25)
Seat 6: Megabite11 folded before Flop (didn't bet)



PokerStars Hand #222976083807:  Hold'em No Limit ($0.05/$0.10 USD) - 2021/01/23 17:47:42 ET
Table 'Merope IV' 6-max Seat #6 is the button
Seat 1: Nicover4 ($10.07 in chips) 
Seat 2: ojeriza ($10 in chips) 
Seat 3: paulyscrackers ($9.90 in chips) 
Seat 4: Romadon ($7.77 in chips) 
Seat 5: attilakorte ($11.26 in chips) 
Seat 6: Megabite11 ($12.99 in chips) 
Nicover4: posts small blind $0.05
ojeriza: posts big blind $0.10
*** HOLE CARDS ***
paulyscrackers: raises $0.20 to $0.30
Romadon: calls $0.30
attilakorte: raises $0.90 to $1.20
Megabite11: folds 
Nicover4: folds 
ojeriza: folds 
paulyscrackers: calls $0.90
Romadon: raises $6.57 to $7.77 and is all-in
attilakorte: raises $3.49 to $11.26 and is all-in
paulyscrackers: folds 
Uncalled bet ($3.49) returned to attilakorte
*** FLOP *** [As 6c 8d]
*** TURN *** [As 6c 8d] [6s]
*** RIVER *** [As 6c 8d 6s] [Tc]
*** SHOW DOWN ***
Romadon: shows [Jh 9h] (a pair of Sixes)
attilakorte: shows [Ks Kh] (two pair, Kings and Sixes)
attilakorte collected $16.13 from pot
*** SUMMARY ***
Total pot $16.89 | Rake $0.76 
Board [As 6c 8d 6s Tc]
Seat 1: Nicover4 (small blind) folded before Flop
Seat 2: ojeriza (big blind) folded before Flop
Seat 3: paulyscrackers folded before Flop
Seat 4: Romadon showed [Jh 9h] and lost with a pair of Sixes
Seat 5: attilakorte showed [Ks Kh] and won ($16.13) with two pair, Kings and Sixes
Seat 6: Megabite11 (button) folded before Flop (didn't bet)



PokerStars Hand #222976141184:  Hold'em No Limit ($0.05/$0.10 USD) - 2021/01/23 17:48:59 ET
Table 'Merope IV' 6-max Seat #1 is the button
Seat 1: Nicover4 ($10.02 in chips) 
Seat 2: ojeriza ($10 in chips) 
Seat 3: paulyscrackers ($8.70 in chips) 
Seat 5: attilakorte ($19.62 in chips) 
Seat 6: Megabite11 ($12.99 in chips) 
ojeriza: posts small blind $0.05
paulyscrackers: posts big blind $0.10
*** HOLE CARDS ***
attilakorte: folds 
Megabite11: folds 
Romadon leaves the table
Nicover4: folds 
ojeriza: folds 
Uncalled bet ($0.05) returned to paulyscrackers
paulyscrackers collected $0.10 from pot
*** SUMMARY ***
Total pot $0.10 | Rake $0 
Seat 1: Nicover4 (button) folded before Flop (didn't bet)
Seat 2: ojeriza (small blind) folded before Flop
Seat 3: paulyscrackers (big blind) collected ($0.10)
Seat 5: attilakorte folded before Flop (didn't bet)
Seat 6: Megabite11 folded before Flop (didn't bet)



PokerStars Hand #222976153281:  Hold'em No Limit ($0.05/$0.10 USD) - 2021/01/23 17:49:16 ET
Table 'Merope IV' 6-max Seat #2 is the button
Seat 1: Nicover4 ($10.02 in chips) 
Seat 2: ojeriza ($10 in chips) 
Seat 3: paulyscrackers ($8.75 in chips) 
Seat 5: attilakorte ($19.62 in chips) 
Seat 6: Megabite11 ($12.99 in chips) 
paulyscrackers: posts small blind $0.05
attilakorte: posts big blind $0.10
*** HOLE CARDS ***
Megabite11: folds 
66Robo joins the table at seat #4 
Nicover4: folds 
ojeriza: folds 
paulyscrackers: calls $0.05
attilakorte: checks 
*** FLOP *** [8c 5c 4s]
paulyscrackers: bets $0.10
attilakorte: raises $0.20 to $0.30
paulyscrackers: calls $0.20
*** TURN *** [8c 5c 4s] [5h]
paulyscrackers: checks 
attilakorte: checks 
*** RIVER *** [8c 5c 4s 5h] [Ts]
paulyscrackers: checks 
attilakorte: bets $0.40
paulyscrackers: folds 
Uncalled bet ($0.40) returned to attilakorte
attilakorte collected $0.76 from pot
attilakorte: doesn't show hand 
*** SUMMARY ***
Total pot $0.80 | Rake $0.04 
Board [8c 5c 4s 5h Ts]
Seat 1: Nicover4 folded before Flop (didn't bet)
Seat 2: ojeriza (button) folded before Flop (didn't bet)
Seat 3: paulyscrackers (small blind) folded on the River
Seat 5: attilakorte (big blind) collected ($0.76)
Seat 6: Megabite11 folded before Flop (didn't bet)



PokerStars Hand #222976196464:  Hold'em No Limit ($0.05/$0.10 USD) - 2021/01/23 17:50:14 ET
Table 'Merope IV' 6-max Seat #3 is the button
Seat 1: Nicover4 ($10.02 in chips) 
Seat 2: ojeriza ($10 in chips) 
Seat 3: paulyscrackers ($8.35 in chips) 
Seat 5: attilakorte ($19.98 in chips) 
Seat 6: Megabite11 ($12.99 in chips) 
attilakorte: posts small blind $0.05
Megabite11: posts big blind $0.10
*** HOLE CARDS ***
Nicover4: folds 
ojeriza: folds 
paulyscrackers: calls $0.10
attilakorte: folds 
Megabite11: checks 
*** FLOP *** [Js 7c 9d]
Megabite11: checks 
paulyscrackers: checks 
*** TURN *** [Js 7c 9d] [Ac]
Megabite11: checks 
paulyscrackers: bets $0.12
Megabite11: calls $0.12
*** RIVER *** [Js 7c 9d Ac] [4s]
Megabite11: checks 
paulyscrackers: bets $0.20
Megabite11: raises $0.40 to $0.60
paulyscrackers: folds 
Uncalled bet ($0.40) returned to Megabite11
Megabite11 collected $0.85 from pot
Megabite11: doesn't show hand 
*** SUMMARY ***
Total pot $0.89 | Rake $0.04 
Board [Js 7c 9d Ac 4s]
Seat 1: Nicover4 folded before Flop (didn't bet)
Seat 2: ojeriza folded before Flop (didn't bet)
Seat 3: paulyscrackers (button) folded on the River
Seat 5: attilakorte (small blind) folded before Flop
Seat 6: Megabite11 (big blind) collected ($0.85)



PokerStars Hand #222976270199:  Hold'em No Limit ($0.05/$0.10 USD) - 2021/01/23 17:51:55 ET
Table 'Merope IV' 6-max Seat #5 is the button
Seat 1: Nicover4 ($10.02 in chips) 
Seat 2: ojeriza ($10 in chips) 
Seat 3: paulyscrackers ($7.93 in chips) 
Seat 4: 66Robo ($5 in chips) 
Seat 5: attilakorte ($19.93 in chips) 
Seat 6: Megabite11 ($13.42 in chips) 
Megabite11: posts small blind $0.05
Nicover4: posts big blind $0.10
66Robo: posts big blind $0.10
*** HOLE CARDS ***
ojeriza: folds 
paulyscrackers: folds 
66Robo: checks 
attilakorte: folds 
Megabite11: raises $0.30 to $0.40
Nicover4: folds 
66Robo: calls $0.30
*** FLOP *** [Kd 9c Qd]
Megabite11: bets $0.28
66Robo: calls $0.28
*** TURN *** [Kd 9c Qd] [Td]
Megabite11: checks 
66Robo: bets $0.50
Megabite11: calls $0.50
*** RIVER *** [Kd 9c Qd Td] [3c]
Megabite11: checks 
66Robo: bets $1
Megabite11: raises $11.24 to $12.24 and is all-in
66Robo: calls $2.82 and is all-in
Uncalled bet ($8.42) returned to Megabite11
*** SHOW DOWN ***
Megabite11: shows [Ad 7d] (a flush, Ace high)
66Robo: shows [Jh 9h] (a straight, Nine to King)
Megabite11 collected $9.65 from pot
*** SUMMARY ***
Total pot $10.10 | Rake $0.45 
Board [Kd 9c Qd Td 3c]
Seat 1: Nicover4 (big blind) folded before Flop
Seat 2: ojeriza folded before Flop (didn't bet)
Seat 3: paulyscrackers folded before Flop (didn't bet)
Seat 4: 66Robo showed [Jh 9h] and lost with a straight, Nine to King
Seat 5: attilakorte (button) folded before Flop (didn't bet)
Seat 6: Megabite11 (small blind) showed [Ad 7d] and won ($9.65) with a flush, Ace high



PokerStars Hand #222976344490:  Hold'em No Limit ($0.05/$0.10 USD) - 2021/01/23 17:53:38 ET
Table 'Merope IV' 6-max Seat #6 is the button
Seat 1: Nicover4 ($9.92 in chips) 
Seat 2: ojeriza ($10 in chips) 
Seat 3: paulyscrackers ($7.93 in chips) 
Seat 5: attilakorte ($19.93 in chips) 
Seat 6: Megabite11 ($18.07 in chips) 
Nicover4: posts small blind $0.05
ojeriza: posts big blind $0.10
*** HOLE CARDS ***
paulyscrackers: folds 
attilakorte: folds 
Megabite11: folds 
Nicover4: folds 
Uncalled bet ($0.05) returned to ojeriza
ojeriza collected $0.10 from pot
ojeriza: doesn't show hand 
*** SUMMARY ***
Total pot $0.10 | Rake $0 
Seat 1: Nicover4 (small blind) folded before Flop
Seat 2: ojeriza (big blind) collected ($0.10)
Seat 3: paulyscrackers folded before Flop (didn't bet)
Seat 5: attilakorte folded before Flop (didn't bet)
Seat 6: Megabite11 (button) folded before Flop (didn't bet)



PokerStars Hand #222976359517:  Hold'em No Limit ($0.05/$0.10 USD) - 2021/01/23 17:53:58 ET
Table 'Merope IV' 6-max Seat #1 is the button
Seat 1: Nicover4 ($9.87 in chips) 
Seat 2: ojeriza ($10.05 in chips) 
Seat 3: paulyscrackers ($7.93 in chips) 
Seat 4: 66Robo ($5 in chips) 
Seat 5: attilakorte ($19.93 in chips) 
Seat 6: Megabite11 ($18.07 in chips) 
ojeriza: posts small blind $0.05
paulyscrackers: posts big blind $0.10
*** HOLE CARDS ***
66Robo: calls $0.10
attilakorte: folds 
Megabite11: calls $0.10
Nicover4: folds 
ojeriza: folds 
paulyscrackers: checks 
*** FLOP *** [Kd 7s Ks]
paulyscrackers: checks 
66Robo: bets $0.10
Megabite11: folds 
paulyscrackers: folds 
Uncalled bet ($0.10) returned to 66Robo
66Robo collected $0.33 from pot
66Robo: doesn't show hand 
*** SUMMARY ***
Total pot $0.35 | Rake $0.02 
Board [Kd 7s Ks]
Seat 1: Nicover4 (button) folded before Flop (didn't bet)
Seat 2: ojeriza (small blind) folded before Flop
Seat 3: paulyscrackers (big blind) folded on the Flop
Seat 4: 66Robo collected ($0.33)
Seat 5: attilakorte folded before Flop (didn't bet)
Seat 6: Megabite11 folded on the Flop



PokerStars Hand #222976378825:  Hold'em No Limit ($0.05/$0.10 USD) - 2021/01/23 17:54:25 ET
Table 'Merope IV' 6-max Seat #2 is the button
Seat 1: Nicover4 ($9.87 in chips) 
Seat 2: ojeriza ($10 in chips) 
Seat 3: paulyscrackers ($7.83 in chips) 
Seat 4: 66Robo ($5.23 in chips) 
Seat 5: attilakorte ($19.93 in chips) 
Seat 6: Megabite11 ($17.97 in chips) 
paulyscrackers: posts small blind $0.05
66Robo: posts big blind $0.10
*** HOLE CARDS ***
attilakorte: folds 
Megabite11: raises $0.12 to $0.22
Nicover4: folds 
ojeriza: folds 
paulyscrackers: folds 
66Robo: calls $0.12
*** FLOP *** [Tc Qs 7s]
66Robo: checks 
Megabite11: bets $0.16
66Robo: folds 
Uncalled bet ($0.16) returned to Megabite11
Megabite11 collected $0.47 from pot
Megabite11: doesn't show hand 
*** SUMMARY ***
Total pot $0.49 | Rake $0.02 
Board [Tc Qs 7s]
Seat 1: Nicover4 folded before Flop (didn't bet)
Seat 2: ojeriza (button) folded before Flop (didn't bet)
Seat 3: paulyscrackers (small blind) folded before Flop
Seat 4: 66Robo (big blind) folded on the Flop
Seat 5: attilakorte folded before Flop (didn't bet)
Seat 6: Megabite11 collected ($0.47)



PokerStars Hand #222976397591:  Hold'em No Limit ($0.05/$0.10 USD) - 2021/01/23 17:54:51 ET
Table 'Merope IV' 6-max Seat #3 is the button
Seat 1: Nicover4 ($9.87 in chips) 
Seat 2: ojeriza ($10 in chips) 
Seat 3: paulyscrackers ($7.78 in chips) 
Seat 4: 66Robo ($5.01 in chips) 
Seat 5: attilakorte ($19.93 in chips) 
Seat 6: Megabite11 ($18.22 in chips) 
66Robo: posts small blind $0.05
attilakorte: posts big blind $0.10
*** HOLE CARDS ***
Megabite11: folds 
Nicover4: folds 
ojeriza: raises $0.18 to $0.28
paulyscrackers: folds 
66Robo: calls $0.23
attilakorte: calls $0.18
*** FLOP *** [2s 5h Qc]
66Robo: bets $0.20
attilakorte: calls $0.20
ojeriza: folds 
*** TURN *** [2s 5h Qc] [Js]
66Robo: bets $0.20
attilakorte: calls $0.20
*** RIVER *** [2s 5h Qc Js] [9s]
66Robo: bets $0.50
attilakorte: folds 
Uncalled bet ($0.50) returned to 66Robo
66Robo collected $1.57 from pot
66Robo: doesn't show hand 
*** SUMMARY ***
Total pot $1.64 | Rake $0.07 
Board [2s 5h Qc Js 9s]
Seat 1: Nicover4 folded before Flop (didn't bet)
Seat 2: ojeriza folded on the Flop
Seat 3: paulyscrackers (button) folded before Flop (didn't bet)
Seat 4: 66Robo (small blind) collected ($1.57)
Seat 5: attilakorte (big blind) folded on the River
Seat 6: Megabite11 folded before Flop (didn't bet)



PokerStars Hand #222976424848:  Hold'em No Limit ($0.05/$0.10 USD) - 2021/01/23 17:55:36 ET
Table 'Merope IV' 6-max Seat #4 is the button
Seat 1: Nicover4 ($9.87 in chips) 
Seat 2: ojeriza ($10 in chips) 
Seat 3: paulyscrackers ($7.78 in chips) 
Seat 4: 66Robo ($5.90 in chips) 
Seat 5: attilakorte ($19.25 in chips) 
Seat 6: Megabite11 ($18.22 in chips) 
attilakorte: posts small blind $0.05
Megabite11: posts big blind $0.10
*** HOLE CARDS ***
Nicover4: raises $0.20 to $0.30
ojeriza: folds 
paulyscrackers: folds 
66Robo: calls $0.30
attilakorte: folds 
Megabite11: calls $0.20
*** FLOP *** [8h 3s Kh]
Megabite11: checks 
Nicover4: checks 
66Robo: checks 
*** TURN *** [8h 3s Kh] [2d]
Megabite11: bets $0.53
Nicover4: folds 
66Robo: folds 
Uncalled bet ($0.53) returned to Megabite11
Megabite11 collected $0.91 from pot
Megabite11: doesn't show hand 
*** SUMMARY ***
Total pot $0.95 | Rake $0.04 
Board [8h 3s Kh 2d]
Seat 1: Nicover4 folded on the Turn
Seat 2: ojeriza folded before Flop (didn't bet)
Seat 3: paulyscrackers folded before Flop (didn't bet)
Seat 4: 66Robo (button) folded on the Turn
Seat 5: attilakorte (small blind) folded before Flop
Seat 6: Megabite11 (big blind) collected ($0.91)



PokerStars Hand #222976446549:  Hold'em No Limit ($0.05/$0.10 USD) - 2021/01/23 17:56:17 ET
Table 'Merope IV' 6-max Seat #5 is the button
Seat 1: Nicover4 ($9.57 in chips) 
Seat 2: ojeriza ($10 in chips) 
Seat 3: paulyscrackers ($7.78 in chips) 
Seat 4: 66Robo ($5.60 in chips) 
Seat 5: attilakorte ($19.20 in chips) 
Seat 6: Megabite11 ($18.83 in chips) 
Megabite11: posts small blind $0.05
Nicover4: posts big blind $0.10
*** HOLE CARDS ***
ojeriza: folds 
paulyscrackers: folds 
66Robo: folds 
attilakorte: folds 
Megabite11: raises $0.20 to $0.30
Nicover4: folds 
Uncalled bet ($0.20) returned to Megabite11
Megabite11 collected $0.20 from pot
Megabite11: doesn't show hand 
*** SUMMARY ***
Total pot $0.20 | Rake $0 
Seat 1: Nicover4 (big blind) folded before Flop
Seat 2: ojeriza folded before Flop (didn't bet)
Seat 3: paulyscrackers folded before Flop (didn't bet)
Seat 4: 66Robo folded before Flop (didn't bet)
Seat 5: attilakorte (button) folded before Flop (didn't bet)
Seat 6: Megabite11 (small blind) collected ($0.20)



PokerStars Hand #222976454347:  Hold'em No Limit ($0.05/$0.10 USD) - 2021/01/23 17:56:32 ET
Table 'Merope IV' 6-max Seat #6 is the button
Seat 1: Nicover4 ($9.47 in chips) 
Seat 2: ojeriza ($10 in chips) 
Seat 3: paulyscrackers ($7.78 in chips) 
Seat 4: 66Robo ($5.60 in chips) 
Seat 5: attilakorte ($19.20 in chips) 
Seat 6: Megabite11 ($18.93 in chips) 
Nicover4: posts small blind $0.05
ojeriza: posts big blind $0.10
*** HOLE CARDS ***
paulyscrackers: folds 
66Robo: folds 
attilakorte: raises $0.12 to $0.22
Megabite11: raises $0.48 to $0.70
Nicover4: folds 
ojeriza: folds 
attilakorte: folds 
Uncalled bet ($0.48) returned to Megabite11
Megabite11 collected $0.59 from pot
Megabite11: doesn't show hand 
*** SUMMARY ***
Total pot $0.59 | Rake $0 
Seat 1: Nicover4 (small blind) folded before Flop
Seat 2: ojeriza (big blind) folded before Flop
Seat 3: paulyscrackers folded before Flop (didn't bet)
Seat 4: 66Robo folded before Flop (didn't bet)
Seat 5: attilakorte folded before Flop
Seat 6: Megabite11 (button) collected ($0.59)



PokerStars Hand #222976472954:  Hold'em No Limit ($0.05/$0.10 USD) - 2021/01/23 17:57:07 ET
Table 'Merope IV' 6-max Seat #1 is the button
Seat 1: Nicover4 ($9.42 in chips) 
Seat 2: ojeriza ($10 in chips) 
Seat 3: paulyscrackers ($7.78 in chips) 
Seat 4: 66Robo ($5.60 in chips) 
Seat 5: attilakorte ($18.98 in chips) 
Seat 6: Megabite11 ($19.30 in chips) 
ojeriza: posts small blind $0.05
paulyscrackers: posts big blind $0.10
*** HOLE CARDS ***
66Robo: calls $0.10
attilakorte: folds 
Megabite11: folds 
Nicover4: folds 
ojeriza: folds 
paulyscrackers: checks 
*** FLOP *** [Kh 7d 3c]
paulyscrackers: bets $0.10
66Robo: calls $0.10
*** TURN *** [Kh 7d 3c] [8h]
paulyscrackers: bets $0.20
66Robo: calls $0.20
*** RIVER *** [Kh 7d 3c 8h] [4h]
paulyscrackers: checks 
66Robo: checks 
*** SHOW DOWN ***
paulyscrackers: shows [7s Th] (a pair of Sevens)
66Robo: shows [Jh Jc] (a pair of Jacks)
66Robo collected $0.81 from pot
*** SUMMARY ***
Total pot $0.85 | Rake $0.04 
Board [Kh 7d 3c 8h 4h]
Seat 1: Nicover4 (button) folded before Flop (didn't bet)
Seat 2: ojeriza (small blind) folded before Flop
Seat 3: paulyscrackers (big blind) showed [7s Th] and lost with a pair of Sevens
Seat 4: 66Robo showed [Jh Jc] and won ($0.81) with a pair of Jacks
Seat 5: attilakorte folded before Flop (didn't bet)
Seat 6: Megabite11 folded before Flop (didn't bet)



PokerStars Hand #222976493688:  Hold'em No Limit ($0.05/$0.10 USD) - 2021/01/23 17:57:46 ET
Table 'Merope IV' 6-max Seat #2 is the button
Seat 1: Nicover4 ($9.42 in chips) 
Seat 2: ojeriza ($10 in chips) 
Seat 3: paulyscrackers ($7.38 in chips) 
Seat 4: 66Robo ($6.01 in chips) 
Seat 5: attilakorte ($18.98 in chips) 
Seat 6: Megabite11 ($19.30 in chips) 
paulyscrackers: posts small blind $0.05
66Robo: posts big blind $0.10
*** HOLE CARDS ***
attilakorte: folds 
Megabite11: raises $0.12 to $0.22
Nicover4: folds 
ojeriza: folds 
paulyscrackers: calls $0.17
66Robo: calls $0.12
*** FLOP *** [3c Ac 2d]
paulyscrackers: checks 
66Robo: checks 
Megabite11: checks 
*** TURN *** [3c Ac 2d] [7d]
paulyscrackers: bets $0.10
66Robo: raises $0.40 to $0.50
Megabite11: folds 
paulyscrackers: folds 
Uncalled bet ($0.40) returned to 66Robo
66Robo collected $0.82 from pot
66Robo: doesn't show hand 
*** SUMMARY ***
Total pot $0.86 | Rake $0.04 
Board [3c Ac 2d 7d]
Seat 1: Nicover4 folded before Flop (didn't bet)
Seat 2: ojeriza (button) folded before Flop (didn't bet)
Seat 3: paulyscrackers (small blind) folded on the Turn
Seat 4: 66Robo (big blind) collected ($0.82)
Seat 5: attilakorte folded before Flop (didn't bet)
Seat 6: Megabite11 folded on the Turn



PokerStars Hand #222976525137:  Hold'em No Limit ($0.05/$0.10 USD) - 2021/01/23 17:58:45 ET
Table 'Merope IV' 6-max Seat #3 is the button
Seat 1: Nicover4 ($9.42 in chips) 
Seat 2: ojeriza ($10 in chips) 
Seat 3: paulyscrackers ($7.06 in chips) 
Seat 4: 66Robo ($6.51 in chips) 
Seat 5: attilakorte ($18.98 in chips) 
Seat 6: Megabite11 ($19.08 in chips) 
66Robo: posts small blind $0.05
attilakorte: posts big blind $0.10
*** HOLE CARDS ***
Megabite11: folds 
Nicover4: folds 
ojeriza: raises $0.18 to $0.28
paulyscrackers: calls $0.28
66Robo: folds 
attilakorte: folds 
*** FLOP *** [Kd 2h Ks]
ojeriza: bets $0.22
paulyscrackers: raises $0.22 to $0.44
ojeriza: raises $0.84 to $1.28
paulyscrackers: folds 
Uncalled bet ($0.84) returned to ojeriza
ojeriza collected $1.52 from pot
ojeriza: doesn't show hand 
*** SUMMARY ***
Total pot $1.59 | Rake $0.07 
Board [Kd 2h Ks]
Seat 1: Nicover4 folded before Flop (didn't bet)
Seat 2: ojeriza collected ($1.52)
Seat 3: paulyscrackers (button) folded on the Flop
Seat 4: 66Robo (small blind) folded before Flop
Seat 5: attilakorte (big blind) folded before Flop
Seat 6: Megabite11 folded before Flop (didn't bet)



PokerStars Hand #222976544839:  Hold'em No Limit ($0.05/$0.10 USD) - 2021/01/23 17:59:22 ET
Table 'Merope IV' 6-max Seat #4 is the button
Seat 1: Nicover4 ($9.42 in chips) 
Seat 2: ojeriza ($10.80 in chips) 
Seat 3: paulyscrackers ($6.34 in chips) 
Seat 4: 66Robo ($6.46 in chips) 
Seat 5: attilakorte ($18.88 in chips) 
Seat 6: Megabite11 ($19.08 in chips) 
attilakorte: posts small blind $0.05
Megabite11: posts big blind $0.10
*** HOLE CARDS ***
Nicover4: folds 
ojeriza: folds 
paulyscrackers: folds 
paulyscrackers leaves the table
66Robo: calls $0.10
attilakorte: folds 
Megabite11: checks 
*** FLOP *** [Js Kc 6d]
Elviskochito joins the table at seat #3 
Megabite11: checks 
66Robo: checks 
*** TURN *** [Js Kc 6d] [7s]
Megabite11: checks 
66Robo: bets $0.10
Megabite11: calls $0.10
*** RIVER *** [Js Kc 6d 7s] [Kh]
Megabite11: checks 
66Robo: bets $0.20
Megabite11: folds 
Uncalled bet ($0.20) returned to 66Robo
66Robo collected $0.43 from pot
66Robo: doesn't show hand 
*** SUMMARY ***
Total pot $0.45 | Rake $0.02 
Board [Js Kc 6d 7s Kh]
Seat 1: Nicover4 folded before Flop (didn't bet)
Seat 2: ojeriza folded before Flop (didn't bet)
Seat 3: paulyscrackers folded before Flop (didn't bet)
Seat 4: 66Robo (button) collected ($0.43)
Seat 5: attilakorte (small blind) folded before Flop
Seat 6: Megabite11 (big blind) folded on the River



PokerStars Hand #222976583853:  Hold'em No Limit ($0.05/$0.10 USD) - 2021/01/23 18:00:25 ET
Table 'Merope IV' 6-max Seat #5 is the button
Seat 1: Nicover4 ($9.42 in chips) 
Seat 2: ojeriza ($10.80 in chips) 
Seat 4: 66Robo ($6.69 in chips) 
Seat 5: attilakorte ($18.83 in chips) 
Seat 6: Megabite11 ($18.88 in chips) 
Megabite11: posts small blind $0.05
Nicover4: posts big blind $0.10
Elviskochito: sits out 
*** HOLE CARDS ***
ojeriza: folds 
66Robo: calls $0.10
attilakorte: folds 
Megabite11: raises $0.30 to $0.40
Nicover4: folds 
66Robo: calls $0.30
*** FLOP *** [6c 5c 2c]
Megabite11: checks 
66Robo: bets $0.40
Megabite11: folds 
Uncalled bet ($0.40) returned to 66Robo
66Robo collected $0.86 from pot
66Robo: doesn't show hand 
*** SUMMARY ***
Total pot $0.90 | Rake $0.04 
Board [6c 5c 2c]
Seat 1: Nicover4 (big blind) folded before Flop
Seat 2: ojeriza folded before Flop (didn't bet)
Seat 4: 66Robo collected ($0.86)
Seat 5: attilakorte (button) folded before Flop (didn't bet)
Seat 6: Megabite11 (small blind) folded on the Flop



PokerStars Hand #222976603905:  Hold'em No Limit ($0.05/$0.10 USD) - 2021/01/23 18:00:58 ET
Table 'Merope IV' 6-max Seat #6 is the button
Seat 1: Nicover4 ($9.32 in chips) 
Seat 2: ojeriza ($10.80 in chips) 
Seat 4: 66Robo ($7.15 in chips) 
Seat 5: attilakorte ($18.83 in chips) 
Seat 6: Megabite11 ($18.48 in chips) 
Nicover4: posts small blind $0.05
ojeriza: posts big blind $0.10
Elviskochito: sits out 
*** HOLE CARDS ***
66Robo: calls $0.10
attilakorte: folds 
Megabite11: folds 
Nicover4: calls $0.05
ojeriza: checks 
*** FLOP *** [7d 9c 2h]
Nicover4: checks 
ojeriza: checks 
66Robo: checks 
*** TURN *** [7d 9c 2h] [8d]
Nicover4: bets $0.22
ojeriza: folds 
66Robo: folds 
Uncalled bet ($0.22) returned to Nicover4
Nicover4 collected $0.29 from pot
Nicover4: doesn't show hand 
*** SUMMARY ***
Total pot $0.30 | Rake $0.01 
Board [7d 9c 2h 8d]
Seat 1: Nicover4 (small blind) collected ($0.29)
Seat 2: ojeriza (big blind) folded on the Turn
Seat 4: 66Robo folded on the Turn
Seat 5: attilakorte folded before Flop (didn't bet)
Seat 6: Megabite11 (button) folded before Flop (didn't bet)



PokerStars Hand #222976625151:  Hold'em No Limit ($0.05/$0.10 USD) - 2021/01/23 18:01:31 ET
Table 'Merope IV' 6-max Seat #1 is the button
Seat 1: Nicover4 ($9.51 in chips) 
Seat 2: ojeriza ($10.70 in chips) 
Seat 3: Elviskochito ($10 in chips) 
Seat 4: 66Robo ($7.05 in chips) 
Seat 5: attilakorte ($18.83 in chips) 
Seat 6: Megabite11 ($18.48 in chips) 
ojeriza: posts small blind $0.05
Elviskochito: posts big blind $0.10
*** HOLE CARDS ***
66Robo: calls $0.10
attilakorte: folds 
Megabite11: raises $0.30 to $0.40
Nicover4: folds 
ojeriza: folds 
Elviskochito: folds 
66Robo: calls $0.30
*** FLOP *** [3c Js Qc]
66Robo: checks 
Megabite11: bets $0.30
66Robo: folds 
Uncalled bet ($0.30) returned to Megabite11
Megabite11 collected $0.91 from pot
Megabite11: doesn't show hand 
*** SUMMARY ***
Total pot $0.95 | Rake $0.04 
Board [3c Js Qc]
Seat 1: Nicover4 (button) folded before Flop (didn't bet)
Seat 2: ojeriza (small blind) folded before Flop
Seat 3: Elviskochito (big blind) folded before Flop
Seat 4: 66Robo folded on the Flop
Seat 5: attilakorte folded before Flop (didn't bet)
Seat 6: Megabite11 collected ($0.91)



PokerStars Hand #222976644885:  Hold'em No Limit ($0.05/$0.10 USD) - 2021/01/23 18:02:00 ET
Table 'Merope IV' 6-max Seat #2 is the button
Seat 1: Nicover4 ($9.51 in chips) 
Seat 2: ojeriza ($10.65 in chips) 
Seat 3: Elviskochito ($10 in chips) 
Seat 4: 66Robo ($6.65 in chips) 
Seat 5: attilakorte ($18.83 in chips) 
Seat 6: Megabite11 ($18.99 in chips) 
Elviskochito: posts small blind $0.05
66Robo: posts big blind $0.10
*** HOLE CARDS ***
attilakorte: folds 
Megabite11: folds 
Nicover4: folds 
ojeriza: folds 
Elviskochito: folds 
Uncalled bet ($0.05) returned to 66Robo
66Robo collected $0.10 from pot
66Robo: doesn't show hand 
*** SUMMARY ***
Total pot $0.10 | Rake $0 
Seat 1: Nicover4 folded before Flop (didn't bet)
Seat 2: ojeriza (button) folded before Flop (didn't bet)
Seat 3: Elviskochito (small blind) folded before Flop
Seat 4: 66Robo (big blind) collected ($0.10)
Seat 5: attilakorte folded before Flop (didn't bet)
Seat 6: Megabite11 folded before Flop (didn't bet)



PokerStars Hand #222976654200:  Hold'em No Limit ($0.05/$0.10 USD) - 2021/01/23 18:02:15 ET
Table 'Merope IV' 6-max Seat #3 is the button
Seat 1: Nicover4 ($9.51 in chips) 
Seat 2: ojeriza ($10.65 in chips) 
Seat 3: Elviskochito ($10 in chips) 
Seat 4: 66Robo ($6.70 in chips) 
Seat 5: attilakorte ($18.83 in chips) 
Seat 6: Megabite11 ($18.99 in chips) 
66Robo: posts small blind $0.05
attilakorte: posts big blind $0.10
*** HOLE CARDS ***
Megabite11: folds 
Nicover4: folds 
ojeriza: folds 
Elviskochito: folds 
66Robo: calls $0.05
attilakorte: checks 
*** FLOP *** [3s 9h 8s]
66Robo: bets $0.10
attilakorte: folds 
Uncalled bet ($0.10) returned to 66Robo
66Robo collected $0.19 from pot
66Robo: doesn't show hand 
*** SUMMARY ***
Total pot $0.20 | Rake $0.01 
Board [3s 9h 8s]
Seat 1: Nicover4 folded before Flop (didn't bet)
Seat 2: ojeriza folded before Flop (didn't bet)
Seat 3: Elviskochito (button) folded before Flop (didn't bet)
Seat 4: 66Robo (small blind) collected ($0.19)
Seat 5: attilakorte (big blind) folded on the Flop
Seat 6: Megabite11 folded before Flop (didn't bet)



PokerStars Hand #222976670807:  Hold'em No Limit ($0.05/$0.10 USD) - 2021/01/23 18:02:39 ET
Table 'Merope IV' 6-max Seat #4 is the button
Seat 1: Nicover4 ($9.51 in chips) 
Seat 2: ojeriza ($10.65 in chips) 
Seat 3: Elviskochito ($10 in chips) 
Seat 4: 66Robo ($6.79 in chips) 
Seat 5: attilakorte ($18.73 in chips) 
Seat 6: Megabite11 ($18.99 in chips) 
attilakorte: posts small blind $0.05
Megabite11: posts big blind $0.10
*** HOLE CARDS ***
Nicover4: folds 
ojeriza: folds 
Elviskochito: folds 
66Robo: calls $0.10
attilakorte: folds 
Megabite11: checks 
*** FLOP *** [Ad 6s 2d]
Megabite11: checks 
66Robo: checks 
*** TURN *** [Ad 6s 2d] [4c]
Megabite11: checks 
66Robo: bets $0.10
Megabite11: folds 
Uncalled bet ($0.10) returned to 66Robo
66Robo collected $0.24 from pot
66Robo: doesn't show hand 
*** SUMMARY ***
Total pot $0.25 | Rake $0.01 
Board [Ad 6s 2d 4c]
Seat 1: Nicover4 folded before Flop (didn't bet)
Seat 2: ojeriza folded before Flop (didn't bet)
Seat 3: Elviskochito folded before Flop (didn't bet)
Seat 4: 66Robo (button) collected ($0.24)
Seat 5: attilakorte (small blind) folded before Flop
Seat 6: Megabite11 (big blind) folded on the Turn



PokerStars Hand #222976703575:  Hold'em No Limit ($0.05/$0.10 USD) - 2021/01/23 18:03:25 ET
Table 'Merope IV' 6-max Seat #5 is the button
Seat 1: Nicover4 ($9.51 in chips) 
Seat 2: ojeriza ($10.65 in chips) 
Seat 3: Elviskochito ($10 in chips) 
Seat 4: 66Robo ($6.93 in chips) 
Seat 5: attilakorte ($18.68 in chips) 
Seat 6: Megabite11 ($18.89 in chips) 
Megabite11: posts small blind $0.05
Nicover4: posts big blind $0.10
*** HOLE CARDS ***
ojeriza: raises $0.22 to $0.32
Elviskochito: folds 
66Robo: calls $0.32
attilakorte: folds 
Megabite11: folds 
Nicover4: folds 
*** FLOP *** [5h 2s Th]
ojeriza: checks 
66Robo: checks 
*** TURN *** [5h 2s Th] [5s]
ojeriza: checks 
66Robo: bets $0.10
ojeriza: calls $0.10
*** RIVER *** [5h 2s Th 5s] [Jd]
ojeriza: checks 
66Robo: bets $0.30
ojeriza: folds 
Uncalled bet ($0.30) returned to 66Robo
66Robo collected $0.95 from pot
66Robo: doesn't show hand 
*** SUMMARY ***
Total pot $0.99 | Rake $0.04 
Board [5h 2s Th 5s Jd]
Seat 1: Nicover4 (big blind) folded before Flop
Seat 2: ojeriza folded on the River
Seat 3: Elviskochito folded before Flop (didn't bet)
Seat 4: 66Robo collected ($0.95)
Seat 5: attilakorte (button) folded before Flop (didn't bet)
Seat 6: Megabite11 (small blind) folded before Flop



PokerStars Hand #222976741250:  Hold'em No Limit ($0.05/$0.10 USD) - 2021/01/23 18:04:18 ET
Table 'Merope IV' 6-max Seat #6 is the button
Seat 1: Nicover4 ($9.41 in chips) 
Seat 2: ojeriza ($10.23 in chips) 
Seat 3: Elviskochito ($10 in chips) 
Seat 4: 66Robo ($7.46 in chips) 
Seat 5: attilakorte ($18.68 in chips) 
Seat 6: Megabite11 ($18.84 in chips) 
Nicover4: posts small blind $0.05
ojeriza: posts big blind $0.10
*** HOLE CARDS ***
Elviskochito: folds 
66Robo: calls $0.10
attilakorte: folds 
Megabite11: folds 
Nicover4: folds 
ojeriza: checks 
*** FLOP *** [2s 2c Ac]
ojeriza: checks 
66Robo: bets $0.10
ojeriza: folds 
Uncalled bet ($0.10) returned to 66Robo
66Robo collected $0.24 from pot
66Robo: doesn't show hand 
*** SUMMARY ***
Total pot $0.25 | Rake $0.01 
Board [2s 2c Ac]
Seat 1: Nicover4 (small blind) folded before Flop
Seat 2: ojeriza (big blind) folded on the Flop
Seat 3: Elviskochito folded before Flop (didn't bet)
Seat 4: 66Robo collected ($0.24)
Seat 5: attilakorte folded before Flop (didn't bet)
Seat 6: Megabite11 (button) folded before Flop (didn't bet)



PokerStars Hand #222976761321:  Hold'em No Limit ($0.05/$0.10 USD) - 2021/01/23 18:04:46 ET
Table 'Merope IV' 6-max Seat #1 is the button
Seat 1: Nicover4 ($9.36 in chips) 
Seat 2: ojeriza ($10.13 in chips) 
Seat 3: Elviskochito ($10 in chips) 
Seat 4: 66Robo ($7.60 in chips) 
Seat 5: attilakorte ($18.68 in chips) 
Seat 6: Megabite11 ($18.84 in chips) 
ojeriza: posts small blind $0.05
Elviskochito: posts big blind $0.10
*** HOLE CARDS ***
66Robo: calls $0.10
attilakorte: folds 
Megabite11: folds 
Nicover4: folds 
ojeriza: folds 
Elviskochito: raises $0.40 to $0.50
66Robo: calls $0.40
*** FLOP *** [8d 4s Kd]
Elviskochito: bets $0.50
66Robo: folds 
Uncalled bet ($0.50) returned to Elviskochito
Elviskochito collected $1 from pot
*** SUMMARY ***
Total pot $1.05 | Rake $0.05 
Board [8d 4s Kd]
Seat 1: Nicover4 (button) folded before Flop (didn't bet)
Seat 2: ojeriza (small blind) folded before Flop
Seat 3: Elviskochito (big blind) collected ($1)
Seat 4: 66Robo folded on the Flop
Seat 5: attilakorte folded before Flop (didn't bet)
Seat 6: Megabite11 folded before Flop (didn't bet)



PokerStars Hand #222976781343:  Hold'em No Limit ($0.05/$0.10 USD) - 2021/01/23 18:05:14 ET
Table 'Merope IV' 6-max Seat #2 is the button
Seat 1: Nicover4 ($9.36 in chips) 
Seat 2: ojeriza ($10.08 in chips) 
Seat 3: Elviskochito ($10.50 in chips) 
Seat 4: 66Robo ($7.10 in chips) 
Seat 5: attilakorte ($18.68 in chips) 
Seat 6: Megabite11 ($18.84 in chips) 
Elviskochito: posts small blind $0.05
66Robo: posts big blind $0.10
*** HOLE CARDS ***
attilakorte: folds 
Megabite11: folds 
Nicover4: folds 
ojeriza: raises $0.16 to $0.26
Elviskochito: folds 
66Robo: calls $0.16
*** FLOP *** [Kd 5c Qs]
66Robo: bets $0.20
ojeriza: calls $0.20
*** TURN *** [Kd 5c Qs] [4h]
66Robo: bets $0.30
ojeriza: raises $0.83 to $1.13
66Robo: calls $0.83
*** RIVER *** [Kd 5c Qs 4h] [Ts]
66Robo: bets $0.50
ojeriza: raises $2.20 to $2.70
66Robo: folds 
Uncalled bet ($2.20) returned to ojeriza
ojeriza collected $4.04 from pot
ojeriza: doesn't show hand 
*** SUMMARY ***
Total pot $4.23 | Rake $0.19 
Board [Kd 5c Qs 4h Ts]
Seat 1: Nicover4 folded before Flop (didn't bet)
Seat 2: ojeriza (button) collected ($4.04)
Seat 3: Elviskochito (small blind) folded before Flop
Seat 4: 66Robo (big blind) folded on the River
Seat 5: attilakorte folded before Flop (didn't bet)
Seat 6: Megabite11 folded before Flop (didn't bet)



PokerStars Hand #222976811144:  Hold'em No Limit ($0.05/$0.10 USD) - 2021/01/23 18:05:56 ET
Table 'Merope IV' 6-max Seat #3 is the button
Seat 1: Nicover4 ($9.36 in chips) 
Seat 2: ojeriza ($12.03 in chips) 
Seat 3: Elviskochito ($10.45 in chips) 
Seat 4: 66Robo ($5.01 in chips) 
Seat 5: attilakorte ($18.68 in chips) 
Seat 6: Megabite11 ($18.84 in chips) 
66Robo: posts small blind $0.05
attilakorte: posts big blind $0.10
*** HOLE CARDS ***
Megabite11: folds 
Nicover4: folds 
ojeriza: folds 
Elviskochito: raises $0.15 to $0.25
66Robo: calls $0.20
attilakorte: folds 
*** FLOP *** [Qs 6c Kd]
66Robo: bets $0.20
Elviskochito: calls $0.20
*** TURN *** [Qs 6c Kd] [Kh]
66Robo: bets $0.30
Elviskochito: folds 
Uncalled bet ($0.30) returned to 66Robo
66Robo collected $0.96 from pot
66Robo: doesn't show hand 
*** SUMMARY ***
Total pot $1 | Rake $0.04 
Board [Qs 6c Kd Kh]
Seat 1: Nicover4 folded before Flop (didn't bet)
Seat 2: ojeriza folded before Flop (didn't bet)
Seat 3: Elviskochito (button) folded on the Turn
Seat 4: 66Robo (small blind) collected ($0.96)
Seat 5: attilakorte (big blind) folded before Flop
Seat 6: Megabite11 folded before Flop (didn't bet)



PokerStars Hand #222976828904:  Hold'em No Limit ($0.05/$0.10 USD) - 2021/01/23 18:06:21 ET
Table 'Merope IV' 6-max Seat #4 is the button
Seat 1: Nicover4 ($9.36 in chips) 
Seat 2: ojeriza ($12.03 in chips) 
Seat 3: Elviskochito ($10 in chips) 
Seat 4: 66Robo ($5.52 in chips) 
Seat 5: attilakorte ($18.58 in chips) 
Seat 6: Megabite11 ($18.84 in chips) 
attilakorte: posts small blind $0.05
Megabite11: posts big blind $0.10
*** HOLE CARDS ***
Nicover4: folds 
ojeriza: folds 
Elviskochito: folds 
66Robo: calls $0.10
attilakorte: folds 
Megabite11: checks 
*** FLOP *** [Kc Ah Ad]
Megabite11: checks 
66Robo: checks 
*** TURN *** [Kc Ah Ad] [Ts]
Megabite11: checks 
66Robo: checks 
*** RIVER *** [Kc Ah Ad Ts] [5s]
Megabite11: checks 
66Robo: checks 
*** SHOW DOWN ***
Megabite11: shows [Qc 2d] (a pair of Aces)
66Robo: mucks hand 
Megabite11 collected $0.24 from pot
*** SUMMARY ***
Total pot $0.25 | Rake $0.01 
Board [Kc Ah Ad Ts 5s]
Seat 1: Nicover4 folded before Flop (didn't bet)
Seat 2: ojeriza folded before Flop (didn't bet)
Seat 3: Elviskochito folded before Flop (didn't bet)
Seat 4: 66Robo (button) mucked
Seat 5: attilakorte (small blind) folded before Flop
Seat 6: Megabite11 (big blind) showed [Qc 2d] and won ($0.24) with a pair of Aces



PokerStars Hand #222976866161:  Hold'em No Limit ($0.05/$0.10 USD) - 2021/01/23 18:07:14 ET
Table 'Merope IV' 6-max Seat #5 is the button
Seat 1: Nicover4 ($9.36 in chips) 
Seat 2: ojeriza ($12.03 in chips) 
Seat 3: Elviskochito ($10 in chips) 
Seat 4: 66Robo ($5.42 in chips) 
Seat 5: attilakorte ($18.53 in chips) 
Seat 6: Megabite11 ($18.98 in chips) 
Megabite11: posts small blind $0.05
Nicover4: posts big blind $0.10
*** HOLE CARDS ***
ojeriza: folds 
Elviskochito: folds 
66Robo: calls $0.10
attilakorte has timed out
attilakorte: folds 
Megabite11: calls $0.05
Nicover4: checks 
*** FLOP *** [2h 7c Tc]
Megabite11: checks 
Nicover4: checks 
66Robo: checks 
*** TURN *** [2h 7c Tc] [7h]
Megabite11: checks 
Nicover4: checks 
66Robo: bets $0.20
Megabite11: folds 
Nicover4: folds 
Uncalled bet ($0.20) returned to 66Robo
66Robo collected $0.29 from pot
66Robo: doesn't show hand 
*** SUMMARY ***
Total pot $0.30 | Rake $0.01 
Board [2h 7c Tc 7h]
Seat 1: Nicover4 (big blind) folded on the Turn
Seat 2: ojeriza folded before Flop (didn't bet)
Seat 3: Elviskochito folded before Flop (didn't bet)
Seat 4: 66Robo collected ($0.29)
Seat 5: attilakorte (button) folded before Flop (didn't bet)
Seat 6: Megabite11 (small blind) folded on the Turn



PokerStars Hand #222976913249:  Hold'em No Limit ($0.05/$0.10 USD) - 2021/01/23 18:08:22 ET
Table 'Merope IV' 6-max Seat #6 is the button
Seat 1: Nicover4 ($9.26 in chips) 
Seat 2: ojeriza ($12.03 in chips) 
Seat 3: Elviskochito ($10 in chips) 
Seat 4: 66Robo ($5.61 in chips) 
Seat 5: attilakorte ($18.53 in chips) 
Seat 6: Megabite11 ($18.88 in chips) 
Nicover4: posts small blind $0.05
ojeriza: posts big blind $0.10
*** HOLE CARDS ***
Elviskochito: folds 
66Robo: calls $0.10
attilakorte: calls $0.10
Megabite11: raises $0.40 to $0.50
Nicover4: folds 
ojeriza: folds 
66Robo: folds 
attilakorte: folds 
Uncalled bet ($0.40) returned to Megabite11
Megabite11 collected $0.45 from pot
Megabite11: doesn't show hand 
*** SUMMARY ***
Total pot $0.45 | Rake $0 
Seat 1: Nicover4 (small blind) folded before Flop
Seat 2: ojeriza (big blind) folded before Flop
Seat 3: Elviskochito folded before Flop (didn't bet)
Seat 4: 66Robo folded before Flop
Seat 5: attilakorte folded before Flop
Seat 6: Megabite11 (button) collected ($0.45)



PokerStars Hand #222976937522:  Hold'em No Limit ($0.05/$0.10 USD) - 2021/01/23 18:08:57 ET
Table 'Merope IV' 6-max Seat #1 is the button
Seat 1: Nicover4 ($9.21 in chips) 
Seat 2: ojeriza ($11.93 in chips) 
Seat 3: Elviskochito ($10 in chips) 
Seat 4: 66Robo ($5.51 in chips) 
Seat 5: attilakorte ($18.43 in chips) 
Seat 6: Megabite11 ($19.23 in chips) 
ojeriza: posts small blind $0.05
Elviskochito: posts big blind $0.10
*** HOLE CARDS ***
66Robo: calls $0.10
attilakorte: raises $0.30 to $0.40
Megabite11: folds 
Nicover4: folds 
ojeriza: folds 
Elviskochito: folds 
66Robo: calls $0.30
*** FLOP *** [2s 5s Jd]
66Robo: bets $0.20
attilakorte: raises $0.20 to $0.40
66Robo: calls $0.20
*** TURN *** [2s 5s Jd] [4s]
66Robo: bets $0.50
attilakorte: calls $0.50
*** RIVER *** [2s 5s Jd 4s] [Qc]
66Robo: checks 
attilakorte: bets $1.37
66Robo: folds 
Uncalled bet ($1.37) returned to attilakorte
attilakorte collected $2.63 from pot
attilakorte: doesn't show hand 
*** SUMMARY ***
Total pot $2.75 | Rake $0.12 
Board [2s 5s Jd 4s Qc]
Seat 1: Nicover4 (button) folded before Flop (didn't bet)
Seat 2: ojeriza (small blind) folded before Flop
Seat 3: Elviskochito (big blind) folded before Flop
Seat 4: 66Robo folded on the River
Seat 5: attilakorte collected ($2.63)
Seat 6: Megabite11 folded before Flop (didn't bet)



PokerStars Hand #222976977472:  Hold'em No Limit ($0.05/$0.10 USD) - 2021/01/23 18:09:46 ET
Table 'Merope IV' 6-max Seat #2 is the button
Seat 1: Nicover4 ($9.21 in chips) 
Seat 2: ojeriza ($11.88 in chips) 
Seat 3: Elviskochito ($10 in chips) 
Seat 4: 66Robo ($4.21 in chips) 
Seat 5: attilakorte ($19.76 in chips) 
Seat 6: Megabite11 ($19.23 in chips) 
Elviskochito: posts small blind $0.05
66Robo: posts big blind $0.10
*** HOLE CARDS ***
attilakorte: folds 
Megabite11: raises $0.12 to $0.22
Nicover4: folds 
ojeriza: folds 
Elviskochito: folds 
66Robo: calls $0.12
*** FLOP *** [Tc Ts 4s]
66Robo: checks 
Megabite11: bets $0.16
66Robo: calls $0.16
*** TURN *** [Tc Ts 4s] [7d]
66Robo: bets $0.30
Megabite11: folds 
Uncalled bet ($0.30) returned to 66Robo
66Robo collected $0.77 from pot
66Robo: doesn't show hand 
*** SUMMARY ***
Total pot $0.81 | Rake $0.04 
Board [Tc Ts 4s 7d]
Seat 1: Nicover4 folded before Flop (didn't bet)
Seat 2: ojeriza (button) folded before Flop (didn't bet)
Seat 3: Elviskochito (small blind) folded before Flop
Seat 4: 66Robo (big blind) collected ($0.77)
Seat 5: attilakorte folded before Flop (didn't bet)
Seat 6: Megabite11 folded on the Turn



PokerStars Hand #222977011107:  Hold'em No Limit ($0.05/$0.10 USD) - 2021/01/23 18:10:26 ET
Table 'Merope IV' 6-max Seat #3 is the button
Seat 1: Nicover4 ($9.21 in chips) 
Seat 2: ojeriza ($11.88 in chips) 
Seat 3: Elviskochito ($10 in chips) 
Seat 4: 66Robo ($4.60 in chips) 
Seat 5: attilakorte ($19.76 in chips) 
Seat 6: Megabite11 ($18.85 in chips) 
66Robo: posts small blind $0.05
attilakorte: posts big blind $0.10
*** HOLE CARDS ***
Megabite11: folds 
Nicover4: folds 
ojeriza: folds 
Elviskochito: raises $0.15 to $0.25
Nicover4 leaves the table
66Robo: folds 
attilakorte: folds 
Uncalled bet ($0.15) returned to Elviskochito
Elviskochito collected $0.25 from pot
*** SUMMARY ***
Total pot $0.25 | Rake $0 
Seat 1: Nicover4 folded before Flop (didn't bet)
Seat 2: ojeriza folded before Flop (didn't bet)
Seat 3: Elviskochito (button) collected ($0.25)
Seat 4: 66Robo (small blind) folded before Flop
Seat 5: attilakorte (big blind) folded before Flop
Seat 6: Megabite11 folded before Flop (didn't bet)



PokerStars Hand #222977021503:  Hold'em No Limit ($0.05/$0.10 USD) - 2021/01/23 18:10:41 ET
Table 'Merope IV' 6-max Seat #4 is the button
Seat 2: ojeriza ($11.88 in chips) 
Seat 3: Elviskochito ($10.15 in chips) 
Seat 4: 66Robo ($4.55 in chips) 
Seat 5: attilakorte ($19.66 in chips) 
Seat 6: Megabite11 ($18.85 in chips) 
attilakorte: posts small blind $0.05
Megabite11: posts big blind $0.10
*** HOLE CARDS ***
ojeriza: folds 
Elviskochito: folds 
66Robo: calls $0.10
attilakorte: raises $0.30 to $0.40
Megabite11: folds 
mackm60 joins the table at seat #1 
66Robo: calls $0.30
*** FLOP *** [Jc As Qd]
attilakorte: checks 
66Robo: bets $0.50
attilakorte: calls $0.50
*** TURN *** [Jc As Qd] [9c]
attilakorte: checks 
66Robo: bets $1.60
attilakorte: folds 
Uncalled bet ($1.60) returned to 66Robo
66Robo collected $1.81 from pot
66Robo: doesn't show hand 
*** SUMMARY ***
Total pot $1.90 | Rake $0.09 
Board [Jc As Qd 9c]
Seat 2: ojeriza folded before Flop (didn't bet)
Seat 3: Elviskochito folded before Flop (didn't bet)
Seat 4: 66Robo (button) collected ($1.81)
Seat 5: attilakorte (small blind) folded on the Turn
Seat 6: Megabite11 (big blind) folded before Flop



PokerStars Hand #222977065344:  Hold'em No Limit ($0.05/$0.10 USD) - 2021/01/23 18:11:44 ET
Table 'Merope IV' 6-max Seat #5 is the button
Seat 1: mackm60 ($5.20 in chips) 
Seat 2: ojeriza ($11.88 in chips) 
Seat 3: Elviskochito ($10.15 in chips) 
Seat 4: 66Robo ($5.46 in chips) 
Seat 5: attilakorte ($18.76 in chips) 
Seat 6: Megabite11 ($18.75 in chips) 
Megabite11: posts small blind $0.05
mackm60: posts big blind $0.10
*** HOLE CARDS ***
ojeriza: raises $0.22 to $0.32
Elviskochito: folds 
66Robo: calls $0.32
attilakorte: folds 
Megabite11: folds 
mackm60: calls $0.22
*** FLOP *** [Qh 8h 3d]
mackm60: bets $0.48
ojeriza: folds 
66Robo: folds 
Uncalled bet ($0.48) returned to mackm60
mackm60 collected $0.96 from pot
mackm60: doesn't show hand 
*** SUMMARY ***
Total pot $1.01 | Rake $0.05 
Board [Qh 8h 3d]
Seat 1: mackm60 (big blind) collected ($0.96)
Seat 2: ojeriza folded on the Flop
Seat 3: Elviskochito folded before Flop (didn't bet)
Seat 4: 66Robo folded on the Flop
Seat 5: attilakorte (button) folded before Flop (didn't bet)
Seat 6: Megabite11 (small blind) folded before Flop



PokerStars Hand #222977088645:  Hold'em No Limit ($0.05/$0.10 USD) - 2021/01/23 18:12:18 ET
Table 'Merope IV' 6-max Seat #6 is the button
Seat 1: mackm60 ($5.84 in chips) 
Seat 2: ojeriza ($11.56 in chips) 
Seat 3: Elviskochito ($10.15 in chips) 
Seat 4: 66Robo ($5.14 in chips) 
Seat 5: attilakorte ($18.76 in chips) 
Seat 6: Megabite11 ($18.70 in chips) 
mackm60: posts small blind $0.05
ojeriza: posts big blind $0.10
*** HOLE CARDS ***
Elviskochito: raises $0.20 to $0.30
66Robo: calls $0.30
attilakorte: calls $0.30
Megabite11: folds 
mackm60 has timed out
mackm60: folds 
ojeriza: folds 
*** FLOP *** [5s 5c 8h]
Elviskochito: checks 
66Robo: bets $0.30
attilakorte: folds 
Elviskochito: folds 
Uncalled bet ($0.30) returned to 66Robo
66Robo collected $1 from pot
66Robo: doesn't show hand 
*** SUMMARY ***
Total pot $1.05 | Rake $0.05 
Board [5s 5c 8h]
Seat 1: mackm60 (small blind) folded before Flop
Seat 2: ojeriza (big blind) folded before Flop
Seat 3: Elviskochito folded on the Flop
Seat 4: 66Robo collected ($1)
Seat 5: attilakorte folded on the Flop
Seat 6: Megabite11 (button) folded before Flop (didn't bet)



PokerStars Hand #222977126988:  Hold'em No Limit ($0.05/$0.10 USD) - 2021/01/23 18:13:14 ET
Table 'Merope IV' 6-max Seat #1 is the button
Seat 1: mackm60 ($5.79 in chips) 
Seat 2: ojeriza ($11.46 in chips) 
Seat 3: Elviskochito ($10 in chips) 
Seat 4: 66Robo ($5.84 in chips) 
Seat 5: attilakorte ($18.46 in chips) 
Seat 6: Megabite11 ($18.70 in chips) 
ojeriza: posts small blind $0.05
Elviskochito: posts big blind $0.10
*** HOLE CARDS ***
66Robo: calls $0.10
attilakorte: folds 
Megabite11: folds 
mackm60: folds 
ojeriza: folds 
Elviskochito: checks 
*** FLOP *** [Qc 6h Qh]
Elviskochito: checks 
66Robo: checks 
*** TURN *** [Qc 6h Qh] [Tc]
Elviskochito: bets $0.22
66Robo: folds 
Uncalled bet ($0.22) returned to Elviskochito
Elviskochito collected $0.24 from pot
*** SUMMARY ***
Total pot $0.25 | Rake $0.01 
Board [Qc 6h Qh Tc]
Seat 1: mackm60 (button) folded before Flop (didn't bet)
Seat 2: ojeriza (small blind) folded before Flop
Seat 3: Elviskochito (big blind) collected ($0.24)
Seat 4: 66Robo folded on the Turn
Seat 5: attilakorte folded before Flop (didn't bet)
Seat 6: Megabite11 folded before Flop (didn't bet)



PokerStars Hand #222977142706:  Hold'em No Limit ($0.05/$0.10 USD) - 2021/01/23 18:13:37 ET
Table 'Merope IV' 6-max Seat #2 is the button
Seat 1: mackm60 ($5.79 in chips) 
Seat 2: ojeriza ($11.41 in chips) 
Seat 3: Elviskochito ($10.14 in chips) 
Seat 4: 66Robo ($5.74 in chips) 
Seat 5: attilakorte ($18.46 in chips) 
Seat 6: Megabite11 ($18.70 in chips) 
Elviskochito: posts small blind $0.05
66Robo: posts big blind $0.10
*** HOLE CARDS ***
attilakorte: folds 
Megabite11: folds 
mackm60: calls $0.10
ojeriza: folds 
Elviskochito: raises $0.40 to $0.50
66Robo: folds 
mackm60: folds 
Uncalled bet ($0.40) returned to Elviskochito
Elviskochito collected $0.30 from pot
*** SUMMARY ***
Total pot $0.30 | Rake $0 
Seat 1: mackm60 folded before Flop
Seat 2: ojeriza (button) folded before Flop (didn't bet)
Seat 3: Elviskochito (small blind) collected ($0.30)
Seat 4: 66Robo (big blind) folded before Flop
Seat 5: attilakorte folded before Flop (didn't bet)
Seat 6: Megabite11 folded before Flop (didn't bet)



PokerStars Hand #222977157369:  Hold'em No Limit ($0.05/$0.10 USD) - 2021/01/23 18:13:58 ET
Table 'Merope IV' 6-max Seat #3 is the button
Seat 1: mackm60 ($5.69 in chips) 
Seat 2: ojeriza ($11.41 in chips) 
Seat 3: Elviskochito ($10.34 in chips) 
Seat 4: 66Robo ($5.64 in chips) 
Seat 5: attilakorte ($18.46 in chips) 
Seat 6: Megabite11 ($18.70 in chips) 
66Robo: posts small blind $0.05
attilakorte: posts big blind $0.10
*** HOLE CARDS ***
Megabite11: folds 
mackm60: folds 
ojeriza: folds 
Elviskochito: raises $0.15 to $0.25
66Robo: calls $0.20
attilakorte: folds 
*** FLOP *** [3d 2h 2c]
66Robo: bets $0.20
Elviskochito: folds 
Uncalled bet ($0.20) returned to 66Robo
66Robo collected $0.57 from pot
66Robo: doesn't show hand 
*** SUMMARY ***
Total pot $0.60 | Rake $0.03 
Board [3d 2h 2c]
Seat 1: mackm60 folded before Flop (didn't bet)
Seat 2: ojeriza folded before Flop (didn't bet)
Seat 3: Elviskochito (button) folded on the Flop
Seat 4: 66Robo (small blind) collected ($0.57)
Seat 5: attilakorte (big blind) folded before Flop
Seat 6: Megabite11 folded before Flop (didn't bet)



PokerStars Hand #222977173453:  Hold'em No Limit ($0.05/$0.10 USD) - 2021/01/23 18:14:21 ET
Table 'Merope IV' 6-max Seat #4 is the button
Seat 1: mackm60 ($5.69 in chips) 
Seat 2: ojeriza ($11.41 in chips) 
Seat 3: Elviskochito ($10.09 in chips) 
Seat 4: 66Robo ($5.96 in chips) 
Seat 5: attilakorte ($18.36 in chips) 
Seat 6: Megabite11 ($18.70 in chips) 
attilakorte: posts small blind $0.05
Megabite11: posts big blind $0.10
*** HOLE CARDS ***
mackm60: folds 
ojeriza: folds 
Elviskochito: folds 
66Robo: folds 
attilakorte: folds 
Uncalled bet ($0.05) returned to Megabite11
Megabite11 collected $0.10 from pot
Megabite11: doesn't show hand 
*** SUMMARY ***
Total pot $0.10 | Rake $0 
Seat 1: mackm60 folded before Flop (didn't bet)
Seat 2: ojeriza folded before Flop (didn't bet)
Seat 3: Elviskochito folded before Flop (didn't bet)
Seat 4: 66Robo (button) folded before Flop (didn't bet)
Seat 5: attilakorte (small blind) folded before Flop
Seat 6: Megabite11 (big blind) collected ($0.10)



PokerStars Hand #222977179957:  Hold'em No Limit ($0.05/$0.10 USD) - 2021/01/23 18:14:31 ET
Table 'Merope IV' 6-max Seat #5 is the button
Seat 1: mackm60 ($5.69 in chips) 
Seat 2: ojeriza ($11.41 in chips) 
Seat 3: Elviskochito ($10.09 in chips) 
Seat 4: 66Robo ($5.96 in chips) 
Seat 5: attilakorte ($18.31 in chips) 
Seat 6: Megabite11 ($18.75 in chips) 
Megabite11: posts small blind $0.05
mackm60: posts big blind $0.10
*** HOLE CARDS ***
ojeriza: folds 
Elviskochito: folds 
66Robo: calls $0.10
attilakorte: folds 
Megabite11: raises $0.30 to $0.40
mackm60: folds 
66Robo: calls $0.30
*** FLOP *** [2c Jd Ad]
Megabite11: checks 
66Robo: bets $0.40
Megabite11: folds 
Uncalled bet ($0.40) returned to 66Robo
66Robo collected $0.86 from pot
66Robo: doesn't show hand 
*** SUMMARY ***
Total pot $0.90 | Rake $0.04 
Board [2c Jd Ad]
Seat 1: mackm60 (big blind) folded before Flop
Seat 2: ojeriza folded before Flop (didn't bet)
Seat 3: Elviskochito folded before Flop (didn't bet)
Seat 4: 66Robo collected ($0.86)
Seat 5: attilakorte (button) folded before Flop (didn't bet)
Seat 6: Megabite11 (small blind) folded on the Flop



PokerStars Hand #222977205505:  Hold'em No Limit ($0.05/$0.10 USD) - 2021/01/23 18:15:08 ET
Table 'Merope IV' 6-max Seat #6 is the button
Seat 1: mackm60 ($5.59 in chips) 
Seat 2: ojeriza ($11.41 in chips) 
Seat 3: Elviskochito ($10.09 in chips) 
Seat 4: 66Robo ($6.42 in chips) 
Seat 5: attilakorte ($18.31 in chips) 
Seat 6: Megabite11 ($18.35 in chips) 
mackm60: posts small blind $0.05
ojeriza: posts big blind $0.10
*** HOLE CARDS ***
Elviskochito: folds 
66Robo: calls $0.10
attilakorte: folds 
Megabite11: folds 
mackm60: folds 
ojeriza: checks 
*** FLOP *** [3h 5s 6c]
ojeriza: checks 
66Robo: checks 
*** TURN *** [3h 5s 6c] [4c]
ojeriza: checks 
66Robo: bets $0.30
ojeriza: calls $0.30
*** RIVER *** [3h 5s 6c 4c] [Ts]
ojeriza: checks 
66Robo: bets $0.50
ojeriza: calls $0.50
*** SHOW DOWN ***
66Robo: shows [Ah 7d] (a straight, Three to Seven)
ojeriza: mucks hand 
66Robo collected $1.77 from pot
*** SUMMARY ***
Total pot $1.85 | Rake $0.08 
Board [3h 5s 6c 4c Ts]
Seat 1: mackm60 (small blind) folded before Flop
Seat 2: ojeriza (big blind) mucked
Seat 3: Elviskochito folded before Flop (didn't bet)
Seat 4: 66Robo showed [Ah 7d] and won ($1.77) with a straight, Three to Seven
Seat 5: attilakorte folded before Flop (didn't bet)
Seat 6: Megabite11 (button) folded before Flop (didn't bet)



PokerStars Hand #222977240699:  Hold'em No Limit ($0.05/$0.10 USD) - 2021/01/23 18:16:00 ET
Table 'Merope IV' 6-max Seat #1 is the button
Seat 1: mackm60 ($5.54 in chips) 
Seat 2: ojeriza ($10.51 in chips) 
Seat 3: Elviskochito ($10.09 in chips) 
Seat 4: 66Robo ($7.29 in chips) 
Seat 5: attilakorte ($18.31 in chips) 
Seat 6: Megabite11 ($18.35 in chips) 
ojeriza: posts small blind $0.05
Elviskochito: posts big blind $0.10
*** HOLE CARDS ***
66Robo: folds 
attilakorte: folds 
Megabite11: folds 
mackm60: calls $0.10
ojeriza: folds 
Elviskochito: checks 
*** FLOP *** [8d 2h 9c]
Elviskochito: checks 
mackm60: bets $0.12
Elviskochito: calls $0.12
*** TURN *** [8d 2h 9c] [Jh]
Elviskochito: checks 
mackm60: bets $0.23
Elviskochito: folds 
Uncalled bet ($0.23) returned to mackm60
mackm60 collected $0.47 from pot
mackm60: doesn't show hand 
*** SUMMARY ***
Total pot $0.49 | Rake $0.02 
Board [8d 2h 9c Jh]
Seat 1: mackm60 (button) collected ($0.47)
Seat 2: ojeriza (small blind) folded before Flop
Seat 3: Elviskochito (big blind) folded on the Turn
Seat 4: 66Robo folded before Flop (didn't bet)
Seat 5: attilakorte folded before Flop (didn't bet)
Seat 6: Megabite11 folded before Flop (didn't bet)



PokerStars Hand #222977273284:  Hold'em No Limit ($0.05/$0.10 USD) - 2021/01/23 18:16:48 ET
Table 'Merope IV' 6-max Seat #2 is the button
Seat 1: mackm60 ($5.79 in chips) 
Seat 2: ojeriza ($10.46 in chips) 
Seat 3: Elviskochito ($10 in chips) 
Seat 4: 66Robo ($7.29 in chips) 
Seat 5: attilakorte ($18.31 in chips) 
Seat 6: Megabite11 ($18.35 in chips) 
Elviskochito: posts small blind $0.05
66Robo: posts big blind $0.10
*** HOLE CARDS ***
attilakorte: folds 
Megabite11: folds 
mackm60: folds 
ojeriza: folds 
Elviskochito: folds 
Uncalled bet ($0.05) returned to 66Robo
66Robo collected $0.10 from pot
66Robo: doesn't show hand 
*** SUMMARY ***
Total pot $0.10 | Rake $0 
Seat 1: mackm60 folded before Flop (didn't bet)
Seat 2: ojeriza (button) folded before Flop (didn't bet)
Seat 3: Elviskochito (small blind) folded before Flop
Seat 4: 66Robo (big blind) collected ($0.10)
Seat 5: attilakorte folded before Flop (didn't bet)
Seat 6: Megabite11 folded before Flop (didn't bet)



PokerStars Hand #222977283768:  Hold'em No Limit ($0.05/$0.10 USD) - 2021/01/23 18:17:04 ET
Table 'Merope IV' 6-max Seat #3 is the button
Seat 1: mackm60 ($5.79 in chips) 
Seat 2: ojeriza ($10.46 in chips) 
Seat 3: Elviskochito ($10 in chips) 
Seat 4: 66Robo ($7.34 in chips) 
Seat 5: attilakorte ($18.31 in chips) 
Seat 6: Megabite11 ($18.35 in chips) 
66Robo: posts small blind $0.05
attilakorte: posts big blind $0.10
*** HOLE CARDS ***
Megabite11: folds 
mackm60 has timed out
mackm60: folds 
ojeriza: folds 
Elviskochito: folds 
66Robo: calls $0.05
attilakorte: checks 
*** FLOP *** [Js 9c Td]
66Robo: bets $0.20
attilakorte: folds 
Uncalled bet ($0.20) returned to 66Robo
66Robo collected $0.19 from pot
66Robo: doesn't show hand 
*** SUMMARY ***
Total pot $0.20 | Rake $0.01 
Board [Js 9c Td]
Seat 1: mackm60 folded before Flop (didn't bet)
Seat 2: ojeriza folded before Flop (didn't bet)
Seat 3: Elviskochito (button) folded before Flop (didn't bet)
Seat 4: 66Robo (small blind) collected ($0.19)
Seat 5: attilakorte (big blind) folded on the Flop
Seat 6: Megabite11 folded before Flop (didn't bet)



PokerStars Hand #222977311102:  Hold'em No Limit ($0.05/$0.10 USD) - 2021/01/23 18:17:44 ET
Table 'Merope IV' 6-max Seat #4 is the button
Seat 1: mackm60 ($5.79 in chips) 
Seat 2: ojeriza ($10.46 in chips) 
Seat 3: Elviskochito ($10 in chips) 
Seat 4: 66Robo ($7.43 in chips) 
Seat 5: attilakorte ($18.21 in chips) 
Seat 6: Megabite11 ($18.35 in chips) 
attilakorte: posts small blind $0.05
Megabite11: posts big blind $0.10
*** HOLE CARDS ***
mackm60: folds 
ojeriza: raises $0.20 to $0.30
Elviskochito: folds 
66Robo: calls $0.30
attilakorte: folds 
Megabite11: folds 
*** FLOP *** [9d 7h Tc]
ojeriza: checks 
66Robo: checks 
*** TURN *** [9d 7h Tc] [6c]
ojeriza: checks 
66Robo: bets $0.10
ojeriza: calls $0.10
*** RIVER *** [9d 7h Tc 6c] [2s]
ojeriza: checks 
66Robo: bets $0.20
ojeriza: calls $0.20
*** SHOW DOWN ***
66Robo: shows [4s 6s] (a pair of Sixes)
ojeriza: mucks hand 
66Robo collected $1.29 from pot
*** SUMMARY ***
Total pot $1.35 | Rake $0.06 
Board [9d 7h Tc 6c 2s]
Seat 1: mackm60 folded before Flop (didn't bet)
Seat 2: ojeriza mucked
Seat 3: Elviskochito folded before Flop (didn't bet)
Seat 4: 66Robo (button) showed [4s 6s] and won ($1.29) with a pair of Sixes
Seat 5: attilakorte (small blind) folded before Flop
Seat 6: Megabite11 (big blind) folded before Flop



PokerStars Hand #222977339605:  Hold'em No Limit ($0.05/$0.10 USD) - 2021/01/23 18:18:26 ET
Table 'Merope IV' 6-max Seat #5 is the button
Seat 1: mackm60 ($5.79 in chips) 
Seat 2: ojeriza ($10 in chips) 
Seat 3: Elviskochito ($10 in chips) 
Seat 4: 66Robo ($8.12 in chips) 
Seat 5: attilakorte ($18.16 in chips) 
Seat 6: Megabite11 ($18.25 in chips) 
Megabite11: posts small blind $0.05
mackm60: posts big blind $0.10
*** HOLE CARDS ***
ojeriza: folds 
Elviskochito: folds 
66Robo: calls $0.10
attilakorte: folds 
Megabite11: folds 
mackm60: checks 
*** FLOP *** [5c 3c 6c]
mackm60: bets $0.10
66Robo: calls $0.10
*** TURN *** [5c 3c 6c] [8h]
mackm60: bets $0.21
66Robo: folds 
Uncalled bet ($0.21) returned to mackm60
mackm60 collected $0.43 from pot
mackm60: doesn't show hand 
*** SUMMARY ***
Total pot $0.45 | Rake $0.02 
Board [5c 3c 6c 8h]
Seat 1: mackm60 (big blind) collected ($0.43)
Seat 2: ojeriza folded before Flop (didn't bet)
Seat 3: Elviskochito folded before Flop (didn't bet)
Seat 4: 66Robo folded on the Turn
Seat 5: attilakorte (button) folded before Flop (didn't bet)
Seat 6: Megabite11 (small blind) folded before Flop



PokerStars Hand #222977369637:  Hold'em No Limit ($0.05/$0.10 USD) - 2021/01/23 18:19:11 ET
Table 'Merope IV' 6-max Seat #6 is the button
Seat 1: mackm60 ($6.02 in chips) 
Seat 2: ojeriza ($10 in chips) 
Seat 3: Elviskochito ($10 in chips) 
Seat 4: 66Robo ($7.92 in chips) 
Seat 5: attilakorte ($18.16 in chips) 
Seat 6: Megabite11 ($18.20 in chips) 
mackm60: posts small blind $0.05
ojeriza: posts big blind $0.10
*** HOLE CARDS ***
Elviskochito: folds 
66Robo: calls $0.10
attilakorte: folds 
Megabite11: folds 
mackm60: calls $0.05
ojeriza: checks 
*** FLOP *** [Js 7s 5h]
mackm60: checks 
ojeriza: bets $0.22
66Robo: calls $0.22
mackm60: folds 
*** TURN *** [Js 7s 5h] [6h]
ojeriza: bets $0.71
66Robo: folds 
Uncalled bet ($0.71) returned to ojeriza
ojeriza collected $0.71 from pot
ojeriza: doesn't show hand 
*** SUMMARY ***
Total pot $0.74 | Rake $0.03 
Board [Js 7s 5h 6h]
Seat 1: mackm60 (small blind) folded on the Flop
Seat 2: ojeriza (big blind) collected ($0.71)
Seat 3: Elviskochito folded before Flop (didn't bet)
Seat 4: 66Robo folded on the Turn
Seat 5: attilakorte folded before Flop (didn't bet)
Seat 6: Megabite11 (button) folded before Flop (didn't bet)



PokerStars Hand #222977393689:  Hold'em No Limit ($0.05/$0.10 USD) - 2021/01/23 18:19:47 ET
Table 'Merope IV' 6-max Seat #1 is the button
Seat 1: mackm60 ($5.92 in chips) 
Seat 2: ojeriza ($10.39 in chips) 
Seat 3: Elviskochito ($10 in chips) 
Seat 4: 66Robo ($7.60 in chips) 
Seat 5: attilakorte ($18.16 in chips) 
Seat 6: Megabite11 ($18.20 in chips) 
ojeriza: posts small blind $0.05
Elviskochito: posts big blind $0.10
*** HOLE CARDS ***
66Robo: folds 
attilakorte: folds 
Megabite11: raises $0.12 to $0.22
mackm60: folds 
ojeriza: folds 
Elviskochito: folds 
Uncalled bet ($0.12) returned to Megabite11
Megabite11 collected $0.25 from pot
Megabite11: doesn't show hand 
*** SUMMARY ***
Total pot $0.25 | Rake $0 
Seat 1: mackm60 (button) folded before Flop (didn't bet)
Seat 2: ojeriza (small blind) folded before Flop
Seat 3: Elviskochito (big blind) folded before Flop
Seat 4: 66Robo folded before Flop (didn't bet)
Seat 5: attilakorte folded before Flop (didn't bet)
Seat 6: Megabite11 collected ($0.25)



PokerStars Hand #222977400853:  Hold'em No Limit ($0.05/$0.10 USD) - 2021/01/23 18:19:58 ET
Table 'Merope IV' 6-max Seat #2 is the button
Seat 1: mackm60 ($5.92 in chips) 
Seat 2: ojeriza ($10.34 in chips) 
Seat 3: Elviskochito ($10 in chips) 
Seat 4: 66Robo ($7.60 in chips) 
Seat 5: attilakorte ($18.16 in chips) 
Seat 6: Megabite11 ($18.35 in chips) 
Elviskochito: posts small blind $0.05
66Robo: posts big blind $0.10
*** HOLE CARDS ***
attilakorte: folds 
Megabite11: folds 
mackm60: raises $0.20 to $0.30
ojeriza: folds 
Elviskochito: folds 
66Robo: calls $0.20
*** FLOP *** [Kd 6s 4c]
66Robo: checks 
mackm60: bets $0.31
66Robo: folds 
Uncalled bet ($0.31) returned to mackm60
mackm60 collected $0.62 from pot
mackm60: doesn't show hand 
*** SUMMARY ***
Total pot $0.65 | Rake $0.03 
Board [Kd 6s 4c]
Seat 1: mackm60 collected ($0.62)
Seat 2: ojeriza (button) folded before Flop (didn't bet)
Seat 3: Elviskochito (small blind) folded before Flop
Seat 4: 66Robo (big blind) folded on the Flop
Seat 5: attilakorte folded before Flop (didn't bet)
Seat 6: Megabite11 folded before Flop (didn't bet)



PokerStars Hand #222977420348:  Hold'em No Limit ($0.05/$0.10 USD) - 2021/01/23 18:20:27 ET
Table 'Merope IV' 6-max Seat #3 is the button
Seat 1: mackm60 ($6.24 in chips) 
Seat 2: ojeriza ($10.34 in chips) 
Seat 3: Elviskochito ($10 in chips) 
Seat 5: attilakorte ($18.16 in chips) 
Seat 6: Megabite11 ($18.35 in chips) 
attilakorte: posts small blind $0.05
Megabite11: posts big blind $0.10
*** HOLE CARDS ***
mackm60: folds 
66Robo leaves the table
ojeriza: folds 
Elviskochito: raises $0.15 to $0.25
attilakorte: folds 
Nealy_Godz joins the table at seat #4 
Megabite11: folds 
Uncalled bet ($0.15) returned to Elviskochito
Elviskochito collected $0.25 from pot
*** SUMMARY ***
Total pot $0.25 | Rake $0 
Seat 1: mackm60 folded before Flop (didn't bet)
Seat 2: ojeriza folded before Flop (didn't bet)
Seat 3: Elviskochito (button) collected ($0.25)
Seat 5: attilakorte (small blind) folded before Flop
Seat 6: Megabite11 (big blind) folded before Flop



PokerStars Hand #222977431795:  Hold'em No Limit ($0.05/$0.10 USD) - 2021/01/23 18:20:44 ET
Table 'Merope IV' 6-max Seat #5 is the button
Seat 1: mackm60 ($6.24 in chips) 
Seat 2: ojeriza ($10.34 in chips) 
Seat 3: Elviskochito ($10.15 in chips) 
Seat 5: attilakorte ($18.11 in chips) 
Seat 6: Megabite11 ($18.25 in chips) 
Megabite11: posts small blind $0.05
mackm60: posts big blind $0.10
Nealy_Godz: sits out 
*** HOLE CARDS ***
ojeriza: folds 
Elviskochito: raises $0.20 to $0.30
attilakorte: calls $0.30
Megabite11: raises $1.20 to $1.50
mackm60: folds 
Elviskochito: folds 
attilakorte: calls $1.20
*** FLOP *** [4d Kd 9s]
Elviskochito leaves the table
Megabite11: bets $1.07
attilakorte: calls $1.07
*** TURN *** [4d Kd 9s] [4c]
shavarun joins the table at seat #3 
Megabite11: checks 
attilakorte: checks 
*** RIVER *** [4d Kd 9s 4c] [2d]
Megabite11: checks 
attilakorte: bets $1.85
Megabite11: folds 
Uncalled bet ($1.85) returned to attilakorte
attilakorte collected $5.29 from pot
attilakorte: doesn't show hand 
*** SUMMARY ***
Total pot $5.54 | Rake $0.25 
Board [4d Kd 9s 4c 2d]
Seat 1: mackm60 (big blind) folded before Flop
Seat 2: ojeriza folded before Flop (didn't bet)
Seat 3: Elviskochito folded before Flop
Seat 5: attilakorte (button) collected ($5.29)
Seat 6: Megabite11 (small blind) folded on the River



PokerStars Hand #222977528548:  Hold'em No Limit ($0.05/$0.10 USD) - 2021/01/23 18:22:57 ET
Table 'Merope IV' 6-max Seat #6 is the button
Seat 1: mackm60 ($6.14 in chips) 
Seat 3: shavarun ($4 in chips) 
Seat 5: attilakorte ($20.83 in chips) 
Seat 6: Megabite11 ($15.68 in chips) 
mackm60: posts small blind $0.05
ojeriza: is sitting out 
shavarun: posts big blind $0.10
Nealy_Godz: sits out 
*** HOLE CARDS ***
attilakorte: folds 
Megabite11: folds 
mackm60: raises $0.20 to $0.30
shavarun: folds 
Uncalled bet ($0.20) returned to mackm60
mackm60 collected $0.20 from pot
mackm60: doesn't show hand 
*** SUMMARY ***
Total pot $0.20 | Rake $0 
Seat 1: mackm60 (small blind) collected ($0.20)
Seat 3: shavarun (big blind) folded before Flop
Seat 5: attilakorte folded before Flop (didn't bet)
Seat 6: Megabite11 (button) folded before Flop (didn't bet)



PokerStars Hand #222977535344:  Hold'em No Limit ($0.05/$0.10 USD) - 2021/01/23 18:23:08 ET
Table 'Merope IV' 6-max Seat #1 is the button
Seat 1: mackm60 ($6.24 in chips) 
Seat 3: shavarun ($10 in chips) 
Seat 4: Nealy_Godz ($10 in chips) 
Seat 5: attilakorte ($20.83 in chips) 
Seat 6: Megabite11 ($15.68 in chips) 
shavarun: posts small blind $0.05
Nealy_Godz: posts big blind $0.10
*** HOLE CARDS ***
attilakorte: folds 
Megabite11: folds 
ojeriza leaves the table
mackm60: raises $0.20 to $0.30
shavarun: folds 
Nealy_Godz: calls $0.20
*** FLOP *** [8d 3h 4s]
Nealy_Godz: checks 
mackm60: bets $0.31
Nealy_Godz: folds 
Uncalled bet ($0.31) returned to mackm60
mackm60 collected $0.62 from pot
mackm60: doesn't show hand 
*** SUMMARY ***
Total pot $0.65 | Rake $0.03 
Board [8d 3h 4s]
Seat 1: mackm60 (button) collected ($0.62)
Seat 3: shavarun (small blind) folded before Flop
Seat 4: Nealy_Godz (big blind) folded on the Flop
Seat 5: attilakorte folded before Flop (didn't bet)
Seat 6: Megabite11 folded before Flop (didn't bet)



PokerStars Hand #222977555804:  Hold'em No Limit ($0.05/$0.10 USD) - 2021/01/23 18:23:39 ET
Table 'Merope IV' 6-max Seat #3 is the button
Seat 1: mackm60 ($6.56 in chips) 
Seat 3: shavarun ($10 in chips) 
Seat 4: Nealy_Godz ($10 in chips) 
Seat 5: attilakorte ($20.83 in chips) 
Seat 6: Megabite11 ($15.68 in chips) 
Nealy_Godz: posts small blind $0.05
attilakorte: posts big blind $0.10
*** HOLE CARDS ***
Megabite11: folds 
mackm60: calls $0.10
shavarun: folds 
Nealy_Godz: folds 
attilakorte: checks 
*** FLOP *** [2s Qc 6c]
attilakorte: checks 
BluffMeThrice joins the table at seat #2 
mackm60: checks 
*** TURN *** [2s Qc 6c] [2c]
attilakorte: checks 
mackm60: checks 
*** RIVER *** [2s Qc 6c 2c] [Ad]
attilakorte: checks 
mackm60: bets $0.24
attilakorte: folds 
Uncalled bet ($0.24) returned to mackm60
mackm60 collected $0.24 from pot
mackm60: doesn't show hand 
*** SUMMARY ***
Total pot $0.25 | Rake $0.01 
Board [2s Qc 6c 2c Ad]
Seat 1: mackm60 collected ($0.24)
Seat 3: shavarun (button) folded before Flop (didn't bet)
Seat 4: Nealy_Godz (small blind) folded before Flop
Seat 5: attilakorte (big blind) folded on the River
Seat 6: Megabite11 folded before Flop (didn't bet)



PokerStars Hand #222977597307:  Hold'em No Limit ($0.05/$0.10 USD) - 2021/01/23 18:24:42 ET
Table 'Merope IV' 6-max Seat #4 is the button
Seat 1: mackm60 ($6.70 in chips) 
Seat 3: shavarun ($10 in chips) 
Seat 4: Nealy_Godz ($10 in chips) 
Seat 5: attilakorte ($20.73 in chips) 
attilakorte: posts small blind $0.05
Megabite11: is sitting out 
mackm60: posts big blind $0.10
BluffMeThrice: sits out 
*** HOLE CARDS ***
shavarun: raises $0.15 to $0.25
Nealy_Godz: folds 
attilakorte: folds 
mackm60: calls $0.15
*** FLOP *** [Qc 6c Js]
mackm60: bets $0.26
shavarun: folds 
Uncalled bet ($0.26) returned to mackm60
mackm60 collected $0.53 from pot
mackm60: doesn't show hand 
*** SUMMARY ***
Total pot $0.55 | Rake $0.02 
Board [Qc 6c Js]
Seat 1: mackm60 (big blind) collected ($0.53)
Seat 3: shavarun folded on the Flop
Seat 4: Nealy_Godz (button) folded before Flop (didn't bet)
Seat 5: attilakorte (small blind) folded before Flop



PokerStars Hand #222977609752:  Hold'em No Limit ($0.05/$0.10 USD) - 2021/01/23 18:25:01 ET
Table 'Merope IV' 6-max Seat #5 is the button
Seat 1: mackm60 ($6.98 in chips) 
Seat 2: BluffMeThrice ($10 in chips) 
Seat 3: shavarun ($10 in chips) 
Seat 4: Nealy_Godz ($10 in chips) 
Seat 5: attilakorte ($20.68 in chips) 
mackm60: posts small blind $0.05
BluffMeThrice: posts big blind $0.10
*** HOLE CARDS ***
shavarun: folds 
Nealy_Godz: folds 
attilakorte: folds 
mackm60: folds 
Uncalled bet ($0.05) returned to BluffMeThrice
BluffMeThrice collected $0.10 from pot
BluffMeThrice: doesn't show hand 
*** SUMMARY ***
Total pot $0.10 | Rake $0 
Seat 1: mackm60 (small blind) folded before Flop
Seat 2: BluffMeThrice (big blind) collected ($0.10)
Seat 3: shavarun folded before Flop (didn't bet)
Seat 4: Nealy_Godz folded before Flop (didn't bet)
Seat 5: attilakorte (button) folded before Flop (didn't bet)



PokerStars Hand #222977624013:  Hold'em No Limit ($0.05/$0.10 USD) - 2021/01/23 18:25:23 ET
Table 'Merope IV' 6-max Seat #1 is the button
Seat 1: mackm60 ($6.93 in chips) 
Seat 2: BluffMeThrice ($10.05 in chips) 
Seat 3: shavarun ($10 in chips) 
Seat 4: Nealy_Godz ($10 in chips) 
Seat 5: attilakorte ($20.68 in chips) 
BluffMeThrice: posts small blind $0.05
shavarun: posts big blind $0.10
*** HOLE CARDS ***
Nealy_Godz: raises $0.20 to $0.30
Megabite11 leaves the table
attilakorte: folds 
mackm60: folds 
BluffMeThrice: folds 
shavarun: folds 
Uncalled bet ($0.20) returned to Nealy_Godz
Nealy_Godz collected $0.25 from pot
Nealy_Godz: doesn't show hand 
*** SUMMARY ***
Total pot $0.25 | Rake $0 
Seat 1: mackm60 (button) folded before Flop (didn't bet)
Seat 2: BluffMeThrice (small blind) folded before Flop
Seat 3: shavarun (big blind) folded before Flop
Seat 4: Nealy_Godz collected ($0.25)
Seat 5: attilakorte folded before Flop (didn't bet)



PokerStars Hand #222977638519:  Hold'em No Limit ($0.05/$0.10 USD) - 2021/01/23 18:25:45 ET
Table 'Merope IV' 6-max Seat #2 is the button
Seat 1: mackm60 ($6.93 in chips) 
Seat 2: BluffMeThrice ($10 in chips) 
Seat 3: shavarun ($10 in chips) 
Seat 4: Nealy_Godz ($10.15 in chips) 
Seat 5: attilakorte ($20.68 in chips) 
shavarun: posts small blind $0.05
Nealy_Godz: posts big blind $0.10
*** HOLE CARDS ***
attilakorte: raises $0.12 to $0.22
mackm60: raises $0.22 to $0.44
BluffMeThrice: folds 
shavarun: folds 
Nealy_Godz: folds 
attilakorte: calls $0.22
*** FLOP *** [3c 9s Th]
attilakorte: checks 
mackm60: bets $0.49
attilakorte: folds 
Uncalled bet ($0.49) returned to mackm60
mackm60 collected $0.98 from pot
mackm60: doesn't show hand 
*** SUMMARY ***
Total pot $1.03 | Rake $0.05 
Board [3c 9s Th]
Seat 1: mackm60 collected ($0.98)
Seat 2: BluffMeThrice (button) folded before Flop (didn't bet)
Seat 3: shavarun (small blind) folded before Flop
Seat 4: Nealy_Godz (big blind) folded before Flop
Seat 5: attilakorte folded on the Flop



PokerStars Hand #222977662611:  Hold'em No Limit ($0.05/$0.10 USD) - 2021/01/23 18:26:22 ET
Table 'Merope IV' 6-max Seat #3 is the button
Seat 1: mackm60 ($7.47 in chips) 
Seat 2: BluffMeThrice ($10 in chips) 
Seat 3: shavarun ($10 in chips) 
Seat 4: Nealy_Godz ($10.05 in chips) 
Nealy_Godz: posts small blind $0.05
attilakorte: is sitting out 
mackm60: posts big blind $0.10
*** HOLE CARDS ***
BluffMeThrice: folds 
attilakorte leaves the table
shavarun: folds 
Nealy_Godz: folds 
Uncalled bet ($0.05) returned to mackm60
mackm60 collected $0.10 from pot
mackm60: doesn't show hand 
*** SUMMARY ***
Total pot $0.10 | Rake $0 
Seat 1: mackm60 (big blind) collected ($0.10)
Seat 2: BluffMeThrice folded before Flop (didn't bet)
Seat 3: shavarun (button) folded before Flop (didn't bet)
Seat 4: Nealy_Godz (small blind) folded before Flop



PokerStars Hand #222977666806:  Hold'em No Limit ($0.05/$0.10 USD) - 2021/01/23 18:26:29 ET
Table 'Merope IV' 6-max Seat #4 is the button
Seat 1: mackm60 ($7.52 in chips) 
Seat 2: BluffMeThrice ($10 in chips) 
Seat 3: shavarun ($10 in chips) 
Seat 4: Nealy_Godz ($10 in chips) 
mackm60: posts small blind $0.05
BluffMeThrice: posts big blind $0.10
*** HOLE CARDS ***
shavarun: folds 
Nealy_Godz: folds 
mackm60: folds 
Uncalled bet ($0.05) returned to BluffMeThrice
BluffMeThrice collected $0.10 from pot
BluffMeThrice: doesn't show hand 
*** SUMMARY ***
Total pot $0.10 | Rake $0 
Seat 1: mackm60 (small blind) folded before Flop
Seat 2: BluffMeThrice (big blind) collected ($0.10)
Seat 3: shavarun folded before Flop (didn't bet)
Seat 4: Nealy_Godz (button) folded before Flop (didn't bet)



PokerStars Hand #222977673159:  Hold'em No Limit ($0.05/$0.10 USD) - 2021/01/23 18:26:38 ET
Table 'Merope IV' 6-max Seat #1 is the button
Seat 1: mackm60 ($7.47 in chips) 
Seat 2: BluffMeThrice ($10.05 in chips) 
Seat 3: shavarun ($10 in chips) 
Seat 4: Nealy_Godz ($10 in chips) 
BluffMeThrice: posts small blind $0.05
shavarun: posts big blind $0.10
*** HOLE CARDS ***
Nealy_Godz: folds 
mackm60: raises $0.20 to $0.30
BluffMeThrice: folds 
TrickyTrev31 joins the table at seat #5 
shavarun: calls $0.20
*** FLOP *** [Ac Jh 4s]
shavarun: checks 
mackm60: bets $0.62
shavarun: folds 
Uncalled bet ($0.62) returned to mackm60
mackm60 collected $0.62 from pot
mackm60: doesn't show hand 
*** SUMMARY ***
Total pot $0.65 | Rake $0.03 
Board [Ac Jh 4s]
Seat 1: mackm60 (button) collected ($0.62)
Seat 2: BluffMeThrice (small blind) folded before Flop
Seat 3: shavarun (big blind) folded on the Flop
Seat 4: Nealy_Godz folded before Flop (didn't bet)



PokerStars Hand #222977685324:  Hold'em No Limit ($0.05/$0.10 USD) - 2021/01/23 18:26:57 ET
Table 'Merope IV' 6-max Seat #2 is the button
Seat 1: mackm60 ($7.79 in chips) 
Seat 2: BluffMeThrice ($10 in chips) 
Seat 3: shavarun ($10 in chips) 
Seat 4: Nealy_Godz ($10 in chips) 
shavarun: posts small blind $0.05
Nealy_Godz: posts big blind $0.10
TrickyTrev31: sits out 
*** HOLE CARDS ***
mackm60 has timed out
mackm60: folds 
NFinta joins the table at seat #6 
BluffMeThrice: raises $0.20 to $0.30
shavarun: calls $0.25
Nealy_Godz: folds 
*** FLOP *** [9s As 9c]
shavarun: checks 
BluffMeThrice: checks 
*** TURN *** [9s As 9c] [7d]
shavarun: checks 
BluffMeThrice: checks 
*** RIVER *** [9s As 9c 7d] [Kh]
shavarun: checks 
BluffMeThrice: bets $0.33
shavarun: folds 
Uncalled bet ($0.33) returned to BluffMeThrice
BluffMeThrice collected $0.67 from pot
BluffMeThrice: doesn't show hand 
*** SUMMARY ***
Total pot $0.70 | Rake $0.03 
Board [9s As 9c 7d Kh]
Seat 1: mackm60 folded before Flop (didn't bet)
Seat 2: BluffMeThrice (button) collected ($0.67)
Seat 3: shavarun (small blind) folded on the River
Seat 4: Nealy_Godz (big blind) folded before Flop



PokerStars Hand #222977713715:  Hold'em No Limit ($0.05/$0.10 USD) - 2021/01/23 18:27:40 ET
Table 'Merope IV' 6-max Seat #3 is the button
Seat 1: mackm60 ($7.79 in chips) 
Seat 2: BluffMeThrice ($10.37 in chips) 
Seat 3: shavarun ($10 in chips) 
Seat 4: Nealy_Godz ($10 in chips) 
Seat 5: TrickyTrev31 ($10 in chips) 
Nealy_Godz: posts small blind $0.05
TrickyTrev31: posts big blind $0.10
NFinta: sits out 
*** HOLE CARDS ***
mackm60: calls $0.10
BluffMeThrice: folds 
shavarun: raises $0.30 to $0.40
Nealy_Godz: folds 
TrickyTrev31: folds 
mackm60: calls $0.30
*** FLOP *** [4d 5h 3c]
mackm60: checks 
shavarun: checks 
*** TURN *** [4d 5h 3c] [Jd]
mackm60: bets $0.45
shavarun: folds 
Uncalled bet ($0.45) returned to mackm60
mackm60 collected $0.91 from pot
mackm60: doesn't show hand 
*** SUMMARY ***
Total pot $0.95 | Rake $0.04 
Board [4d 5h 3c Jd]
Seat 1: mackm60 collected ($0.91)
Seat 2: BluffMeThrice folded before Flop (didn't bet)
Seat 3: shavarun (button) folded on the Turn
Seat 4: Nealy_Godz (small blind) folded before Flop
Seat 5: TrickyTrev31 (big blind) folded before Flop



PokerStars Hand #222977745043:  Hold'em No Limit ($0.05/$0.10 USD) - 2021/01/23 18:28:28 ET
Table 'Merope IV' 6-max Seat #4 is the button
Seat 1: mackm60 ($8.30 in chips) 
Seat 2: BluffMeThrice ($10.37 in chips) 
Seat 3: shavarun ($10 in chips) 
Seat 4: Nealy_Godz ($10 in chips) 
Seat 5: TrickyTrev31 ($9.90 in chips) 
Seat 6: NFinta ($10 in chips) 
TrickyTrev31: posts small blind $0.05
NFinta: posts big blind $0.10
*** HOLE CARDS ***
mackm60: folds 
BluffMeThrice: raises $0.15 to $0.25
shavarun: folds 
Nealy_Godz: folds 
TrickyTrev31: folds 
NFinta: folds 
Uncalled bet ($0.15) returned to BluffMeThrice
BluffMeThrice collected $0.25 from pot
BluffMeThrice: doesn't show hand 
*** SUMMARY ***
Total pot $0.25 | Rake $0 
Seat 1: mackm60 folded before Flop (didn't bet)
Seat 2: BluffMeThrice collected ($0.25)
Seat 3: shavarun folded before Flop (didn't bet)
Seat 4: Nealy_Godz (button) folded before Flop (didn't bet)
Seat 5: TrickyTrev31 (small blind) folded before Flop
Seat 6: NFinta (big blind) folded before Flop



PokerStars Hand #222977756652:  Hold'em No Limit ($0.05/$0.10 USD) - 2021/01/23 18:28:46 ET
Table 'Merope IV' 6-max Seat #5 is the button
Seat 1: mackm60 ($8.30 in chips) 
Seat 2: BluffMeThrice ($10.52 in chips) 
Seat 3: shavarun ($10 in chips) 
Seat 4: Nealy_Godz ($10 in chips) 
Seat 5: TrickyTrev31 ($9.85 in chips) 
Seat 6: NFinta ($9.90 in chips) 
NFinta: posts small blind $0.05
mackm60: posts big blind $0.10
*** HOLE CARDS ***
BluffMeThrice: raises $0.20 to $0.30
shavarun: folds 
Nealy_Godz: folds 
TrickyTrev31: folds 
NFinta: folds 
mackm60 has timed out
mackm60: folds 
Uncalled bet ($0.20) returned to BluffMeThrice
BluffMeThrice collected $0.25 from pot
BluffMeThrice: doesn't show hand 
*** SUMMARY ***
Total pot $0.25 | Rake $0 
Seat 1: mackm60 (big blind) folded before Flop
Seat 2: BluffMeThrice collected ($0.25)
Seat 3: shavarun folded before Flop (didn't bet)
Seat 4: Nealy_Godz folded before Flop (didn't bet)
Seat 5: TrickyTrev31 (button) folded before Flop (didn't bet)
Seat 6: NFinta (small blind) folded before Flop



PokerStars Hand #222977782537:  Hold'em No Limit ($0.05/$0.10 USD) - 2021/01/23 18:29:26 ET
Table 'Merope IV' 6-max Seat #6 is the button
Seat 2: BluffMeThrice ($10.67 in chips) 
Seat 3: shavarun ($10 in chips) 
Seat 4: Nealy_Godz ($10 in chips) 
Seat 5: TrickyTrev31 ($9.85 in chips) 
Seat 6: NFinta ($9.85 in chips) 
BluffMeThrice: posts small blind $0.05
shavarun: posts big blind $0.10
*** HOLE CARDS ***
Nealy_Godz: folds 
TrickyTrev31: raises $0.20 to $0.30
NFinta: folds 
BluffMeThrice: folds 
shavarun: calls $0.20
*** FLOP *** [Qc 3c 8s]
shavarun: checks 
TrickyTrev31: bets $0.30
shavarun: calls $0.30
*** TURN *** [Qc 3c 8s] [Qs]
shavarun: checks 
TrickyTrev31: bets $0.60
shavarun: calls $0.60
*** RIVER *** [Qc 3c 8s Qs] [Ts]
shavarun: bets $0.94
TrickyTrev31: raises $0.94 to $1.88
shavarun: folds 
Uncalled bet ($0.94) returned to TrickyTrev31
TrickyTrev31 collected $4.14 from pot
TrickyTrev31: doesn't show hand 
*** SUMMARY ***
Total pot $4.33 | Rake $0.19 
Board [Qc 3c 8s Qs Ts]
Seat 2: BluffMeThrice (small blind) folded before Flop
Seat 3: shavarun (big blind) folded on the River
Seat 4: Nealy_Godz folded before Flop (didn't bet)
Seat 5: TrickyTrev31 collected ($4.14)
Seat 6: NFinta (button) folded before Flop (didn't bet)



PokerStars Hand #222977817913:  Hold'em No Limit ($0.05/$0.10 USD) - 2021/01/23 18:30:20 ET
Table 'Merope IV' 6-max Seat #2 is the button
Seat 1: mackm60 ($8.20 in chips) 
Seat 2: BluffMeThrice ($10.62 in chips) 
Seat 3: shavarun ($10 in chips) 
Seat 4: Nealy_Godz ($10 in chips) 
Seat 5: TrickyTrev31 ($11.85 in chips) 
Seat 6: NFinta ($9.85 in chips) 
shavarun: posts small blind $0.05
Nealy_Godz: posts big blind $0.10
mackm60: posts small blind $0.05
*** HOLE CARDS ***
TrickyTrev31: folds 
NFinta: folds 
mackm60: raises $0.20 to $0.30
BluffMeThrice: calls $0.30
shavarun: folds 
Nealy_Godz: folds 
*** FLOP *** [Qd 6s 9s]
mackm60: bets $0.38
BluffMeThrice: raises $1.52 to $1.90
mackm60: folds 
Uncalled bet ($1.52) returned to BluffMeThrice
BluffMeThrice collected $1.49 from pot
BluffMeThrice: doesn't show hand 
*** SUMMARY ***
Total pot $1.56 | Rake $0.07 
Board [Qd 6s 9s]
Seat 1: mackm60 folded on the Flop
Seat 2: BluffMeThrice (button) collected ($1.49)
Seat 3: shavarun (small blind) folded before Flop
Seat 4: Nealy_Godz (big blind) folded before Flop
Seat 5: TrickyTrev31 folded before Flop (didn't bet)
Seat 6: NFinta folded before Flop (didn't bet)



PokerStars Hand #222977842634:  Hold'em No Limit ($0.05/$0.10 USD) - 2021/01/23 18:30:58 ET
Table 'Merope IV' 6-max Seat #3 is the button
Seat 1: mackm60 ($7.47 in chips) 
Seat 2: BluffMeThrice ($11.43 in chips) 
Seat 3: shavarun ($10 in chips) 
Seat 4: Nealy_Godz ($10 in chips) 
Seat 5: TrickyTrev31 ($11.85 in chips) 
Seat 6: NFinta ($9.85 in chips) 
Nealy_Godz: posts small blind $0.05
TrickyTrev31: posts big blind $0.10
*** HOLE CARDS ***
NFinta: folds 
mackm60: folds 
BluffMeThrice: folds 
shavarun: folds 
Nealy_Godz: folds 
Uncalled bet ($0.05) returned to TrickyTrev31
TrickyTrev31 collected $0.10 from pot
TrickyTrev31: doesn't show hand 
*** SUMMARY ***
Total pot $0.10 | Rake $0 
Seat 1: mackm60 folded before Flop (didn't bet)
Seat 2: BluffMeThrice folded before Flop (didn't bet)
Seat 3: shavarun (button) folded before Flop (didn't bet)
Seat 4: Nealy_Godz (small blind) folded before Flop
Seat 5: TrickyTrev31 (big blind) collected ($0.10)
Seat 6: NFinta folded before Flop (didn't bet)



PokerStars Hand #222977848161:  Hold'em No Limit ($0.05/$0.10 USD) - 2021/01/23 18:31:07 ET
Table 'Merope IV' 6-max Seat #4 is the button
Seat 1: mackm60 ($7.47 in chips) 
Seat 2: BluffMeThrice ($11.43 in chips) 
Seat 3: shavarun ($10 in chips) 
Seat 4: Nealy_Godz ($10 in chips) 
Seat 5: TrickyTrev31 ($11.90 in chips) 
Seat 6: NFinta ($9.85 in chips) 
TrickyTrev31: posts small blind $0.05
NFinta: posts big blind $0.10
*** HOLE CARDS ***
mackm60 has timed out
mackm60: folds 
BluffMeThrice: raises $0.20 to $0.30
shavarun: folds 
Nealy_Godz: folds 
TrickyTrev31: folds 
NFinta: folds 
Uncalled bet ($0.20) returned to BluffMeThrice
BluffMeThrice collected $0.25 from pot
BluffMeThrice: doesn't show hand 
*** SUMMARY ***
Total pot $0.25 | Rake $0 
Seat 1: mackm60 folded before Flop (didn't bet)
Seat 2: BluffMeThrice collected ($0.25)
Seat 3: shavarun folded before Flop (didn't bet)
Seat 4: Nealy_Godz (button) folded before Flop (didn't bet)
Seat 5: TrickyTrev31 (small blind) folded before Flop
Seat 6: NFinta (big blind) folded before Flop



PokerStars Hand #222977865937:  Hold'em No Limit ($0.05/$0.10 USD) - 2021/01/23 18:31:34 ET
Table 'Merope IV' 6-max Seat #5 is the button
Seat 1: mackm60 ($7.47 in chips) 
Seat 2: BluffMeThrice ($11.58 in chips) 
Seat 3: shavarun ($10 in chips) 
Seat 4: Nealy_Godz ($10 in chips) 
Seat 5: TrickyTrev31 ($11.85 in chips) 
Seat 6: NFinta ($9.75 in chips) 
NFinta: posts small blind $0.05
mackm60: posts big blind $0.10
*** HOLE CARDS ***
BluffMeThrice: folds 
shavarun: raises $0.15 to $0.25
Nealy_Godz: folds 
TrickyTrev31: folds 
NFinta: raises $0.15 to $0.40
mackm60: calls $0.30
shavarun: raises $9.60 to $10 and is all-in
NFinta: folds 
mackm60: folds 
Uncalled bet ($9.60) returned to shavarun
shavarun collected $1.20 from pot
shavarun: doesn't show hand 
*** SUMMARY ***
Total pot $1.20 | Rake $0 
Seat 1: mackm60 (big blind) folded before Flop
Seat 2: BluffMeThrice folded before Flop (didn't bet)
Seat 3: shavarun collected ($1.20)
Seat 4: Nealy_Godz folded before Flop (didn't bet)
Seat 5: TrickyTrev31 (button) folded before Flop (didn't bet)
Seat 6: NFinta (small blind) folded before Flop



PokerStars Hand #222977885017:  Hold'em No Limit ($0.05/$0.10 USD) - 2021/01/23 18:32:03 ET
Table 'Merope IV' 6-max Seat #6 is the button
Seat 1: mackm60 ($7.07 in chips) 
Seat 2: BluffMeThrice ($11.58 in chips) 
Seat 3: shavarun ($10.80 in chips) 
Seat 4: Nealy_Godz ($10 in chips) 
Seat 5: TrickyTrev31 ($11.85 in chips) 
Seat 6: NFinta ($9.35 in chips) 
mackm60: posts small blind $0.05
BluffMeThrice: posts big blind $0.10
*** HOLE CARDS ***
shavarun: folds 
Nealy_Godz: folds 
TrickyTrev31: calls $0.10
NFinta: raises $0.10 to $0.20
mackm60: folds 
BluffMeThrice: calls $0.10
TrickyTrev31: calls $0.10
*** FLOP *** [3c 5c 8c]
BluffMeThrice: checks 
TrickyTrev31: bets $0.20
NFinta: folds 
BluffMeThrice: folds 
Uncalled bet ($0.20) returned to TrickyTrev31
TrickyTrev31 collected $0.62 from pot
TrickyTrev31: doesn't show hand 
*** SUMMARY ***
Total pot $0.65 | Rake $0.03 
Board [3c 5c 8c]
Seat 1: mackm60 (small blind) folded before Flop
Seat 2: BluffMeThrice (big blind) folded on the Flop
Seat 3: shavarun folded before Flop (didn't bet)
Seat 4: Nealy_Godz folded before Flop (didn't bet)
Seat 5: TrickyTrev31 collected ($0.62)
Seat 6: NFinta (button) folded on the Flop



PokerStars Hand #222977912346:  Hold'em No Limit ($0.05/$0.10 USD) - 2021/01/23 18:32:44 ET
Table 'Merope IV' 6-max Seat #1 is the button
Seat 1: mackm60 ($7.02 in chips) 
Seat 2: BluffMeThrice ($11.38 in chips) 
Seat 3: shavarun ($10.80 in chips) 
Seat 4: Nealy_Godz ($10 in chips) 
Seat 5: TrickyTrev31 ($12.27 in chips) 
Seat 6: NFinta ($9.15 in chips) 
BluffMeThrice: posts small blind $0.05
shavarun: posts big blind $0.10
*** HOLE CARDS ***
Nealy_Godz: folds 
TrickyTrev31 has timed out
TrickyTrev31: folds 
NFinta: folds 
mackm60: folds 
BluffMeThrice: raises $0.10 to $0.20
shavarun: folds 
Uncalled bet ($0.10) returned to BluffMeThrice
BluffMeThrice collected $0.20 from pot
BluffMeThrice: doesn't show hand 
*** SUMMARY ***
Total pot $0.20 | Rake $0 
Seat 1: mackm60 (button) folded before Flop (didn't bet)
Seat 2: BluffMeThrice (small blind) collected ($0.20)
Seat 3: shavarun (big blind) folded before Flop
Seat 4: Nealy_Godz folded before Flop (didn't bet)
Seat 5: TrickyTrev31 folded before Flop (didn't bet)
Seat 6: NFinta folded before Flop (didn't bet)



PokerStars Hand #222977928022:  Hold'em No Limit ($0.05/$0.10 USD) - 2021/01/23 18:33:08 ET
Table 'Merope IV' 6-max Seat #2 is the button
Seat 1: mackm60 ($7.02 in chips) 
Seat 2: BluffMeThrice ($11.48 in chips) 
Seat 3: shavarun ($10.70 in chips) 
Seat 4: Nealy_Godz ($10 in chips) 
Seat 5: TrickyTrev31 ($12.27 in chips) 
Seat 6: NFinta ($9.15 in chips) 
shavarun: posts small blind $0.05
Nealy_Godz: posts big blind $0.10
*** HOLE CARDS ***
TrickyTrev31: folds 
NFinta: folds 
mackm60: calls $0.10
BluffMeThrice: calls $0.10
shavarun: calls $0.05
Nealy_Godz: checks 
*** FLOP *** [6s Kd 9h]
shavarun: checks 
Nealy_Godz: checks 
mackm60: checks 
BluffMeThrice: checks 
*** TURN *** [6s Kd 9h] [8s]
shavarun: checks 
Nealy_Godz: checks 
mackm60: bets $0.38
BluffMeThrice: folds 
shavarun: calls $0.38
Nealy_Godz: folds 
*** RIVER *** [6s Kd 9h 8s] [6h]
shavarun: checks 
mackm60: checks 
*** SHOW DOWN ***
shavarun: shows [7h 7d] (two pair, Sevens and Sixes)
mackm60: shows [8d As] (two pair, Eights and Sixes)
mackm60 collected $1.11 from pot
*** SUMMARY ***
Total pot $1.16 | Rake $0.05 
Board [6s Kd 9h 8s 6h]
Seat 1: mackm60 showed [8d As] and won ($1.11) with two pair, Eights and Sixes
Seat 2: BluffMeThrice (button) folded on the Turn
Seat 3: shavarun (small blind) showed [7h 7d] and lost with two pair, Sevens and Sixes
Seat 4: Nealy_Godz (big blind) folded on the Turn
Seat 5: TrickyTrev31 folded before Flop (didn't bet)
Seat 6: NFinta folded before Flop (didn't bet)



PokerStars Hand #222977964386:  Hold'em No Limit ($0.05/$0.10 USD) - 2021/01/23 18:34:04 ET
Table 'Merope IV' 6-max Seat #3 is the button
Seat 1: mackm60 ($7.65 in chips) 
Seat 2: BluffMeThrice ($11.38 in chips) 
Seat 3: shavarun ($10.22 in chips) 
Seat 4: Nealy_Godz ($10 in chips) 
Seat 5: TrickyTrev31 ($12.27 in chips) 
Seat 6: NFinta ($9.15 in chips) 
Nealy_Godz: posts small blind $0.05
TrickyTrev31: posts big blind $0.10
*** HOLE CARDS ***
NFinta: folds 
mackm60: folds 
BluffMeThrice: folds 
shavarun: folds 
Nealy_Godz: folds 
Uncalled bet ($0.05) returned to TrickyTrev31
TrickyTrev31 collected $0.10 from pot
TrickyTrev31: doesn't show hand 
*** SUMMARY ***
Total pot $0.10 | Rake $0 
Seat 1: mackm60 folded before Flop (didn't bet)
Seat 2: BluffMeThrice folded before Flop (didn't bet)
Seat 3: shavarun (button) folded before Flop (didn't bet)
Seat 4: Nealy_Godz (small blind) folded before Flop
Seat 5: TrickyTrev31 (big blind) collected ($0.10)
Seat 6: NFinta folded before Flop (didn't bet)



PokerStars Hand #222977977604:  Hold'em No Limit ($0.05/$0.10 USD) - 2021/01/23 18:34:24 ET
Table 'Merope IV' 6-max Seat #4 is the button
Seat 1: mackm60 ($7.65 in chips) 
Seat 2: BluffMeThrice ($11.38 in chips) 
Seat 3: shavarun ($10.22 in chips) 
Seat 4: Nealy_Godz ($10 in chips) 
Seat 5: TrickyTrev31 ($12.32 in chips) 
Seat 6: NFinta ($9.15 in chips) 
TrickyTrev31: posts small blind $0.05
NFinta: posts big blind $0.10
*** HOLE CARDS ***
mackm60 has timed out
mackm60: folds 
BluffMeThrice: folds 
shavarun: raises $0.15 to $0.25
Nealy_Godz: folds 
TrickyTrev31: folds 
NFinta: folds 
Uncalled bet ($0.15) returned to shavarun
shavarun collected $0.25 from pot
shavarun: doesn't show hand 
*** SUMMARY ***
Total pot $0.25 | Rake $0 
Seat 1: mackm60 folded before Flop (didn't bet)
Seat 2: BluffMeThrice folded before Flop (didn't bet)
Seat 3: shavarun collected ($0.25)
Seat 4: Nealy_Godz (button) folded before Flop (didn't bet)
Seat 5: TrickyTrev31 (small blind) folded before Flop
Seat 6: NFinta (big blind) folded before Flop



PokerStars Hand #222977990433:  Hold'em No Limit ($0.05/$0.10 USD) - 2021/01/23 18:34:43 ET
Table 'Merope IV' 6-max Seat #5 is the button
Seat 1: mackm60 ($7.65 in chips) 
Seat 2: BluffMeThrice ($11.38 in chips) 
Seat 3: shavarun ($10.37 in chips) 
Seat 4: Nealy_Godz ($10 in chips) 
Seat 5: TrickyTrev31 ($12.27 in chips) 
Seat 6: NFinta ($9.05 in chips) 
NFinta: posts small blind $0.05
mackm60: posts big blind $0.10
*** HOLE CARDS ***
BluffMeThrice: folds 
shavarun has timed out
shavarun: folds 
Nealy_Godz: folds 
TrickyTrev31: folds 
NFinta: raises $0.30 to $0.40
mackm60: calls $0.30
*** FLOP *** [Kd 3s 2s]
NFinta: bets $0.40
mackm60: calls $0.40
*** TURN *** [Kd 3s 2s] [Ah]
NFinta: bets $0.30
mackm60: raises $1.07 to $1.37
NFinta: raises $1.07 to $2.44
mackm60: raises $4.41 to $6.85 and is all-in
NFinta: calls $4.41
*** RIVER *** [Kd 3s 2s Ah] [9d]
*** SHOW DOWN ***
NFinta: shows [As Jc] (a pair of Aces)
mackm60: shows [3d 3c] (three of a kind, Threes)
mackm60 collected $14.61 from pot
*** SUMMARY ***
Total pot $15.30 | Rake $0.69 
Board [Kd 3s 2s Ah 9d]
Seat 1: mackm60 (big blind) showed [3d 3c] and won ($14.61) with three of a kind, Threes
Seat 2: BluffMeThrice folded before Flop (didn't bet)
Seat 3: shavarun folded before Flop (didn't bet)
Seat 4: Nealy_Godz folded before Flop (didn't bet)
Seat 5: TrickyTrev31 (button) folded before Flop (didn't bet)
Seat 6: NFinta (small blind) showed [As Jc] and lost with a pair of Aces



PokerStars Hand #222978033704:  Hold'em No Limit ($0.05/$0.10 USD) - 2021/01/23 18:35:50 ET
Table 'Merope IV' 6-max Seat #6 is the button
Seat 1: mackm60 ($14.61 in chips) 
Seat 2: BluffMeThrice ($11.38 in chips) 
Seat 3: shavarun ($10.37 in chips) 
Seat 4: Nealy_Godz ($10 in chips) 
Seat 5: TrickyTrev31 ($12.27 in chips) 
Seat 6: NFinta ($1.40 in chips) 
mackm60: posts small blind $0.05
BluffMeThrice: posts big blind $0.10
*** HOLE CARDS ***
shavarun: folds 
Nealy_Godz has timed out
Nealy_Godz: folds 
TrickyTrev31: calls $0.10
NFinta: folds 
NFinta leaves the table
mackm60: calls $0.05
BluffMeThrice: checks 
*** FLOP *** [2s Ad 5s]
mackm60: bets $0.10
KiraLasVegas joins the table at seat #6 
BluffMeThrice: folds 
TrickyTrev31: raises $0.20 to $0.30
mackm60: calls $0.20
*** TURN *** [2s Ad 5s] [9h]
mackm60: checks 
TrickyTrev31: checks 
*** RIVER *** [2s Ad 5s 9h] [5h]
mackm60: bets $0.43
TrickyTrev31: calls $0.43
*** SHOW DOWN ***
mackm60: shows [Qc 2c] (two pair, Fives and Deuces)
TrickyTrev31: shows [Kc 9d] (two pair, Nines and Fives)
TrickyTrev31 collected $1.68 from pot
*** SUMMARY ***
Total pot $1.76 | Rake $0.08 
Board [2s Ad 5s 9h 5h]
Seat 1: mackm60 (small blind) showed [Qc 2c] and lost with two pair, Fives and Deuces
Seat 2: BluffMeThrice (big blind) folded on the Flop
Seat 3: shavarun folded before Flop (didn't bet)
Seat 4: Nealy_Godz folded before Flop (didn't bet)
Seat 5: TrickyTrev31 showed [Kc 9d] and won ($1.68) with two pair, Nines and Fives
Seat 6: NFinta (button) folded before Flop (didn't bet)



PokerStars Hand #222978094107:  Hold'em No Limit ($0.05/$0.10 USD) - 2021/01/23 18:37:23 ET
Table 'Merope IV' 6-max Seat #1 is the button
Seat 1: mackm60 ($13.78 in chips) 
Seat 2: BluffMeThrice ($11.28 in chips) 
Seat 3: shavarun ($10.37 in chips) 
Seat 4: Nealy_Godz ($10 in chips) 
Seat 5: TrickyTrev31 ($13.12 in chips) 
BluffMeThrice: posts small blind $0.05
shavarun: posts big blind $0.10
KiraLasVegas: sits out 
*** HOLE CARDS ***
Nealy_Godz: folds 
TrickyTrev31: calls $0.10
mackm60: calls $0.10
BluffMeThrice: folds 
shavarun: raises $0.50 to $0.60
TrickyTrev31: calls $0.50
mackm60: calls $0.50
*** FLOP *** [5h Ah Th]
shavarun: bets $0.58
TrickyTrev31: calls $0.58
mackm60: folds 
*** TURN *** [5h Ah Th] [6d]
shavarun: checks 
TrickyTrev31: bets $0.50
shavarun: calls $0.50
*** RIVER *** [5h Ah Th 6d] [4s]
shavarun: checks 
TrickyTrev31: bets $3.83
shavarun: folds 
Uncalled bet ($3.83) returned to TrickyTrev31
TrickyTrev31 collected $3.83 from pot
TrickyTrev31: doesn't show hand 
*** SUMMARY ***
Total pot $4.01 | Rake $0.18 
Board [5h Ah Th 6d 4s]
Seat 1: mackm60 (button) folded on the Flop
Seat 2: BluffMeThrice (small blind) folded before Flop
Seat 3: shavarun (big blind) folded on the River
Seat 4: Nealy_Godz folded before Flop (didn't bet)
Seat 5: TrickyTrev31 collected ($3.83)



PokerStars Hand #222978137213:  Hold'em No Limit ($0.05/$0.10 USD) - 2021/01/23 18:38:30 ET
Table 'Merope IV' 6-max Seat #2 is the button
Seat 1: mackm60 ($13.18 in chips) 
Seat 2: BluffMeThrice ($11.23 in chips) 
Seat 3: shavarun ($10 in chips) 
Seat 4: Nealy_Godz ($10 in chips) 
Seat 5: TrickyTrev31 ($15.27 in chips) 
shavarun: posts small blind $0.05
Nealy_Godz: posts big blind $0.10
KiraLasVegas: sits out 
*** HOLE CARDS ***
TrickyTrev31: raises $0.20 to $0.30
mackm60: calls $0.30
BluffMeThrice: raises $0.55 to $0.85
shavarun: folds 
Nealy_Godz: folds 
TrickyTrev31: calls $0.55
mackm60: folds 
*** FLOP *** [8d 2h 5s]
TrickyTrev31: checks 
BluffMeThrice: bets $2.05
TrickyTrev31: folds 
Uncalled bet ($2.05) returned to BluffMeThrice
BluffMeThrice collected $2.05 from pot
BluffMeThrice: doesn't show hand 
*** SUMMARY ***
Total pot $2.15 | Rake $0.10 
Board [8d 2h 5s]
Seat 1: mackm60 folded before Flop
Seat 2: BluffMeThrice (button) collected ($2.05)
Seat 3: shavarun (small blind) folded before Flop
Seat 4: Nealy_Godz (big blind) folded before Flop
Seat 5: TrickyTrev31 folded on the Flop



PokerStars Hand #222978160291:  Hold'em No Limit ($0.05/$0.10 USD) - 2021/01/23 18:39:06 ET
Table 'Merope IV' 6-max Seat #3 is the button
Seat 1: mackm60 ($12.88 in chips) 
Seat 2: BluffMeThrice ($12.43 in chips) 
Seat 3: shavarun ($10 in chips) 
Seat 4: Nealy_Godz ($10 in chips) 
Seat 5: TrickyTrev31 ($14.42 in chips) 
Nealy_Godz: posts small blind $0.05
TrickyTrev31: posts big blind $0.10
KiraLasVegas: sits out 
*** HOLE CARDS ***
mackm60: folds 
BluffMeThrice: folds 
shavarun: folds 
Nealy_Godz: folds 
Uncalled bet ($0.05) returned to TrickyTrev31
TrickyTrev31 collected $0.10 from pot
TrickyTrev31: doesn't show hand 
*** SUMMARY ***
Total pot $0.10 | Rake $0 
Seat 1: mackm60 folded before Flop (didn't bet)
Seat 2: BluffMeThrice folded before Flop (didn't bet)
Seat 3: shavarun (button) folded before Flop (didn't bet)
Seat 4: Nealy_Godz (small blind) folded before Flop
Seat 5: TrickyTrev31 (big blind) collected ($0.10)



PokerStars Hand #222978164587:  Hold'em No Limit ($0.05/$0.10 USD) - 2021/01/23 18:39:13 ET
Table 'Merope IV' 6-max Seat #4 is the button
Seat 1: mackm60 ($12.88 in chips) 
Seat 2: BluffMeThrice ($12.43 in chips) 
Seat 3: shavarun ($10 in chips) 
Seat 4: Nealy_Godz ($10 in chips) 
Seat 5: TrickyTrev31 ($14.47 in chips) 
Seat 6: KiraLasVegas ($10 in chips) 
TrickyTrev31: posts small blind $0.05
KiraLasVegas: posts big blind $0.10
*** HOLE CARDS ***
mackm60: folds 
BluffMeThrice: folds 
shavarun: raises $0.15 to $0.25
Nealy_Godz: folds 
TrickyTrev31: folds 
KiraLasVegas: calls $0.15
*** FLOP *** [5h 3s Td]
KiraLasVegas: checks 
shavarun: checks 
*** TURN *** [5h 3s Td] [6c]
KiraLasVegas: bets $0.19
shavarun: calls $0.19
*** RIVER *** [5h 3s Td 6c] [Kd]
KiraLasVegas: bets $0.58
shavarun: folds 
Uncalled bet ($0.58) returned to KiraLasVegas
KiraLasVegas collected $0.89 from pot
KiraLasVegas: doesn't show hand 
*** SUMMARY ***
Total pot $0.93 | Rake $0.04 
Board [5h 3s Td 6c Kd]
Seat 1: mackm60 folded before Flop (didn't bet)
Seat 2: BluffMeThrice folded before Flop (didn't bet)
Seat 3: shavarun folded on the River
Seat 4: Nealy_Godz (button) folded before Flop (didn't bet)
Seat 5: TrickyTrev31 (small blind) folded before Flop
Seat 6: KiraLasVegas (big blind) collected ($0.89)



PokerStars Hand #222978201926:  Hold'em No Limit ($0.05/$0.10 USD) - 2021/01/23 18:40:11 ET
Table 'Merope IV' 6-max Seat #5 is the button
Seat 1: mackm60 ($12.88 in chips) 
Seat 2: BluffMeThrice ($12.43 in chips) 
Seat 3: shavarun ($10 in chips) 
Seat 4: Nealy_Godz ($10 in chips) 
Seat 5: TrickyTrev31 ($14.42 in chips) 
Seat 6: KiraLasVegas ($10.45 in chips) 
KiraLasVegas: posts small blind $0.05
mackm60: posts big blind $0.10
*** HOLE CARDS ***
BluffMeThrice: folds 
shavarun: raises $0.15 to $0.25
Nealy_Godz: folds 
TrickyTrev31: folds 
KiraLasVegas: folds 
mackm60: folds 
Uncalled bet ($0.15) returned to shavarun
shavarun collected $0.25 from pot
shavarun: doesn't show hand 
*** SUMMARY ***
Total pot $0.25 | Rake $0 
Seat 1: mackm60 (big blind) folded before Flop
Seat 2: BluffMeThrice folded before Flop (didn't bet)
Seat 3: shavarun collected ($0.25)
Seat 4: Nealy_Godz folded before Flop (didn't bet)
Seat 5: TrickyTrev31 (button) folded before Flop (didn't bet)
Seat 6: KiraLasVegas (small blind) folded before Flop



PokerStars Hand #222978211455:  Hold'em No Limit ($0.05/$0.10 USD) - 2021/01/23 18:40:26 ET
Table 'Merope IV' 6-max Seat #6 is the button
Seat 1: mackm60 ($12.78 in chips) 
Seat 2: BluffMeThrice ($12.43 in chips) 
Seat 3: shavarun ($10.15 in chips) 
Seat 4: Nealy_Godz ($10 in chips) 
Seat 5: TrickyTrev31 ($14.42 in chips) 
Seat 6: KiraLasVegas ($10.40 in chips) 
mackm60: posts small blind $0.05
BluffMeThrice: posts big blind $0.10
*** HOLE CARDS ***
shavarun: folds 
Nealy_Godz: folds 
TrickyTrev31: calls $0.10
KiraLasVegas: folds 
mackm60: calls $0.05
BluffMeThrice: raises $0.20 to $0.30
TrickyTrev31: calls $0.20
mackm60: calls $0.20
*** FLOP *** [Js 4d 6d]
mackm60: checks 
BluffMeThrice: bets $0.43
TrickyTrev31: calls $0.43
mackm60: calls $0.43
*** TURN *** [Js 4d 6d] [Qc]
mackm60: checks 
BluffMeThrice: bets $1.04
TrickyTrev31: calls $1.04
mackm60: folds 
*** RIVER *** [Js 4d 6d Qc] [8c]
BluffMeThrice: checks 
TrickyTrev31: checks 
*** SHOW DOWN ***
BluffMeThrice: shows [Ad 7d] (high card Ace)
TrickyTrev31: shows [8d 9d] (a pair of Eights)
TrickyTrev31 collected $4.08 from pot
*** SUMMARY ***
Total pot $4.27 | Rake $0.19 
Board [Js 4d 6d Qc 8c]
Seat 1: mackm60 (small blind) folded on the Turn
Seat 2: BluffMeThrice (big blind) showed [Ad 7d] and lost with high card Ace
Seat 3: shavarun folded before Flop (didn't bet)
Seat 4: Nealy_Godz folded before Flop (didn't bet)
Seat 5: TrickyTrev31 showed [8d 9d] and won ($4.08) with a pair of Eights
Seat 6: KiraLasVegas (button) folded before Flop (didn't bet)



PokerStars Hand #222978286432:  Hold'em No Limit ($0.05/$0.10 USD) - 2021/01/23 18:42:10 ET
Table 'Merope IV' 6-max Seat #1 is the button
Seat 1: mackm60 ($12.05 in chips) 
Seat 2: BluffMeThrice ($10.66 in chips) 
Seat 3: shavarun ($10.15 in chips) 
Seat 4: Nealy_Godz ($10 in chips) 
Seat 5: TrickyTrev31 ($16.73 in chips) 
Seat 6: KiraLasVegas ($10.40 in chips) 
BluffMeThrice: posts small blind $0.05
shavarun: posts big blind $0.10
*** HOLE CARDS ***
Nealy_Godz: folds 
TrickyTrev31: folds 
KiraLasVegas: folds 
mackm60: raises $0.20 to $0.30
BluffMeThrice: folds 
shavarun: folds 
Uncalled bet ($0.20) returned to mackm60
mackm60 collected $0.25 from pot
mackm60: doesn't show hand 
*** SUMMARY ***
Total pot $0.25 | Rake $0 
Seat 1: mackm60 (button) collected ($0.25)
Seat 2: BluffMeThrice (small blind) folded before Flop
Seat 3: shavarun (big blind) folded before Flop
Seat 4: Nealy_Godz folded before Flop (didn't bet)
Seat 5: TrickyTrev31 folded before Flop (didn't bet)
Seat 6: KiraLasVegas folded before Flop (didn't bet)



PokerStars Hand #222978297628:  Hold'em No Limit ($0.05/$0.10 USD) - 2021/01/23 18:42:28 ET
Table 'Merope IV' 6-max Seat #2 is the button
Seat 1: mackm60 ($12.20 in chips) 
Seat 2: BluffMeThrice ($10.61 in chips) 
Seat 3: shavarun ($10.05 in chips) 
Seat 4: Nealy_Godz ($10 in chips) 
Seat 5: TrickyTrev31 ($16.73 in chips) 
Seat 6: KiraLasVegas ($10.40 in chips) 
shavarun: posts small blind $0.05
Nealy_Godz: posts big blind $0.10
*** HOLE CARDS ***
TrickyTrev31: folds 
KiraLasVegas has timed out
KiraLasVegas: folds 
mackm60: calls $0.10
BluffMeThrice: folds 
shavarun: calls $0.05
Nealy_Godz: checks 
*** FLOP *** [5d 3c Qc]
shavarun: checks 
Nealy_Godz: bets $0.15
mackm60: raises $0.30 to $0.45
shavarun: calls $0.45
Nealy_Godz: calls $0.30
*** TURN *** [5d 3c Qc] [9h]
shavarun: checks 
Nealy_Godz: checks 
mackm60: bets $1.58
shavarun: folds 
Nealy_Godz: folds 
Uncalled bet ($1.58) returned to mackm60
mackm60 collected $1.58 from pot
mackm60: doesn't show hand 
*** SUMMARY ***
Total pot $1.65 | Rake $0.07 
Board [5d 3c Qc 9h]
Seat 1: mackm60 collected ($1.58)
Seat 2: BluffMeThrice (button) folded before Flop (didn't bet)
Seat 3: shavarun (small blind) folded on the Turn
Seat 4: Nealy_Godz (big blind) folded on the Turn
Seat 5: TrickyTrev31 folded before Flop (didn't bet)
Seat 6: KiraLasVegas folded before Flop (didn't bet)



PokerStars Hand #222978344935:  Hold'em No Limit ($0.05/$0.10 USD) - 2021/01/23 18:43:43 ET
Table 'Merope IV' 6-max Seat #3 is the button
Seat 1: mackm60 ($13.23 in chips) 
Seat 2: BluffMeThrice ($10.61 in chips) 
Seat 3: shavarun ($10 in chips) 
Seat 4: Nealy_Godz ($10 in chips) 
Seat 5: TrickyTrev31 ($16.73 in chips) 
Seat 6: KiraLasVegas ($10.40 in chips) 
Nealy_Godz: posts small blind $0.05
TrickyTrev31: posts big blind $0.10
*** HOLE CARDS ***
KiraLasVegas: raises $0.20 to $0.30
mackm60: folds 
BluffMeThrice: folds 
shavarun: calls $0.30
Nealy_Godz: folds 
TrickyTrev31: calls $0.20
*** FLOP *** [Qd Qc 9d]
TrickyTrev31: checks 
KiraLasVegas: checks 
shavarun: checks 
*** TURN *** [Qd Qc 9d] [Kc]
TrickyTrev31: checks 
KiraLasVegas: bets $0.59
shavarun: folds 
TrickyTrev31: calls $0.59
*** RIVER *** [Qd Qc 9d Kc] [5h]
TrickyTrev31: checks 
KiraLasVegas: bets $1.62
TrickyTrev31: folds 
Uncalled bet ($1.62) returned to KiraLasVegas
KiraLasVegas collected $2.03 from pot
KiraLasVegas: doesn't show hand 
*** SUMMARY ***
Total pot $2.13 | Rake $0.10 
Board [Qd Qc 9d Kc 5h]
Seat 1: mackm60 folded before Flop (didn't bet)
Seat 2: BluffMeThrice folded before Flop (didn't bet)
Seat 3: shavarun (button) folded on the Turn
Seat 4: Nealy_Godz (small blind) folded before Flop
Seat 5: TrickyTrev31 (big blind) folded on the River
Seat 6: KiraLasVegas collected ($2.03)



PokerStars Hand #222978384378:  Hold'em No Limit ($0.05/$0.10 USD) - 2021/01/23 18:44:45 ET
Table 'Merope IV' 6-max Seat #4 is the button
Seat 1: mackm60 ($13.23 in chips) 
Seat 2: BluffMeThrice ($10.61 in chips) 
Seat 3: shavarun ($10 in chips) 
Seat 4: Nealy_Godz ($10 in chips) 
Seat 5: TrickyTrev31 ($15.84 in chips) 
Seat 6: KiraLasVegas ($11.54 in chips) 
TrickyTrev31: posts small blind $0.05
KiraLasVegas: posts big blind $0.10
*** HOLE CARDS ***
mackm60 has timed out
mackm60: folds 
BluffMeThrice: folds 
shavarun: folds 
Nealy_Godz: raises $0.20 to $0.30
TrickyTrev31: folds 
KiraLasVegas: folds 
Uncalled bet ($0.20) returned to Nealy_Godz
Nealy_Godz collected $0.25 from pot
Nealy_Godz: doesn't show hand 
*** SUMMARY ***
Total pot $0.25 | Rake $0 
Seat 1: mackm60 folded before Flop (didn't bet)
Seat 2: BluffMeThrice folded before Flop (didn't bet)
Seat 3: shavarun folded before Flop (didn't bet)
Seat 4: Nealy_Godz (button) collected ($0.25)
Seat 5: TrickyTrev31 (small blind) folded before Flop
Seat 6: KiraLasVegas (big blind) folded before Flop



PokerStars Hand #222978397595:  Hold'em No Limit ($0.05/$0.10 USD) - 2021/01/23 18:45:06 ET
Table 'Merope IV' 6-max Seat #5 is the button
Seat 1: mackm60 ($13.23 in chips) 
Seat 2: BluffMeThrice ($10.61 in chips) 
Seat 3: shavarun ($10 in chips) 
Seat 4: Nealy_Godz ($10.15 in chips) 
Seat 5: TrickyTrev31 ($15.79 in chips) 
Seat 6: KiraLasVegas ($11.44 in chips) 
KiraLasVegas: posts small blind $0.05
mackm60: posts big blind $0.10
*** HOLE CARDS ***
BluffMeThrice has timed out
BluffMeThrice: folds 
shavarun: folds 
Nealy_Godz: folds 
TrickyTrev31: folds 
KiraLasVegas: folds 
Uncalled bet ($0.05) returned to mackm60
mackm60 collected $0.10 from pot
mackm60: doesn't show hand 
*** SUMMARY ***
Total pot $0.10 | Rake $0 
Seat 1: mackm60 (big blind) collected ($0.10)
Seat 2: BluffMeThrice folded before Flop (didn't bet)
Seat 3: shavarun folded before Flop (didn't bet)
Seat 4: Nealy_Godz folded before Flop (didn't bet)
Seat 5: TrickyTrev31 (button) folded before Flop (didn't bet)
Seat 6: KiraLasVegas (small blind) folded before Flop



PokerStars Hand #222978407446:  Hold'em No Limit ($0.05/$0.10 USD) - 2021/01/23 18:45:22 ET
Table 'Merope IV' 6-max Seat #6 is the button
Seat 1: mackm60 ($13.28 in chips) 
Seat 2: BluffMeThrice ($10.61 in chips) 
Seat 3: shavarun ($10 in chips) 
Seat 4: Nealy_Godz ($10.15 in chips) 
Seat 5: TrickyTrev31 ($15.79 in chips) 
Seat 6: KiraLasVegas ($11.39 in chips) 
mackm60: posts small blind $0.05
BluffMeThrice: posts big blind $0.10
*** HOLE CARDS ***
shavarun: folds 
Nealy_Godz: folds 
TrickyTrev31: folds 
KiraLasVegas: raises $0.15 to $0.25
mackm60: calls $0.20
BluffMeThrice: folds 
*** FLOP *** [3d 8d Kh]
mackm60: checks 
KiraLasVegas: bets $0.20
mackm60: folds 
Uncalled bet ($0.20) returned to KiraLasVegas
KiraLasVegas collected $0.57 from pot
KiraLasVegas: doesn't show hand 
*** SUMMARY ***
Total pot $0.60 | Rake $0.03 
Board [3d 8d Kh]
Seat 1: mackm60 (small blind) folded on the Flop
Seat 2: BluffMeThrice (big blind) folded before Flop
Seat 3: shavarun folded before Flop (didn't bet)
Seat 4: Nealy_Godz folded before Flop (didn't bet)
Seat 5: TrickyTrev31 folded before Flop (didn't bet)
Seat 6: KiraLasVegas (button) collected ($0.57)



PokerStars Hand #222978425969:  Hold'em No Limit ($0.05/$0.10 USD) - 2021/01/23 18:45:51 ET
Table 'Merope IV' 6-max Seat #1 is the button
Seat 1: mackm60 ($13.03 in chips) 
Seat 2: BluffMeThrice ($10.51 in chips) 
Seat 3: shavarun ($10 in chips) 
Seat 4: Nealy_Godz ($10.15 in chips) 
Seat 5: TrickyTrev31 ($15.79 in chips) 
Seat 6: KiraLasVegas ($11.71 in chips) 
BluffMeThrice: posts small blind $0.05
shavarun: posts big blind $0.10
*** HOLE CARDS ***
Nealy_Godz: folds 
TrickyTrev31: folds 
KiraLasVegas: folds 
mackm60: calls $0.10
BluffMeThrice: folds 
shavarun: checks 
*** FLOP *** [2h Jd 8c]
shavarun: checks 
mackm60: checks 
*** TURN *** [2h Jd 8c] [Js]
shavarun: checks 
mackm60: checks 
*** RIVER *** [2h Jd 8c Js] [Ah]
shavarun: checks 
mackm60: checks 
*** SHOW DOWN ***
shavarun: shows [Qd 6s] (a pair of Jacks)
mackm60: mucks hand 
shavarun collected $0.24 from pot
*** SUMMARY ***
Total pot $0.25 | Rake $0.01 
Board [2h Jd 8c Js Ah]
Seat 1: mackm60 (button) mucked
Seat 2: BluffMeThrice (small blind) folded before Flop
Seat 3: shavarun (big blind) showed [Qd 6s] and won ($0.24) with a pair of Jacks
Seat 4: Nealy_Godz folded before Flop (didn't bet)
Seat 5: TrickyTrev31 folded before Flop (didn't bet)
Seat 6: KiraLasVegas folded before Flop (didn't bet)



PokerStars Hand #222978463924:  Hold'em No Limit ($0.05/$0.10 USD) - 2021/01/23 18:46:53 ET
Table 'Merope IV' 6-max Seat #2 is the button
Seat 1: mackm60 ($12.93 in chips) 
Seat 2: BluffMeThrice ($10.46 in chips) 
Seat 3: shavarun ($10.14 in chips) 
Seat 4: Nealy_Godz ($10.15 in chips) 
Seat 5: TrickyTrev31 ($15.79 in chips) 
Seat 6: KiraLasVegas ($11.71 in chips) 
shavarun: posts small blind $0.05
Nealy_Godz: posts big blind $0.10
*** HOLE CARDS ***
TrickyTrev31: folds 
KiraLasVegas: folds 
mackm60: folds 
BluffMeThrice: folds 
shavarun: folds 
Uncalled bet ($0.05) returned to Nealy_Godz
Nealy_Godz collected $0.10 from pot
Nealy_Godz: doesn't show hand 
*** SUMMARY ***
Total pot $0.10 | Rake $0 
Seat 1: mackm60 folded before Flop (didn't bet)
Seat 2: BluffMeThrice (button) folded before Flop (didn't bet)
Seat 3: shavarun (small blind) folded before Flop
Seat 4: Nealy_Godz (big blind) collected ($0.10)
Seat 5: TrickyTrev31 folded before Flop (didn't bet)
Seat 6: KiraLasVegas folded before Flop (didn't bet)



PokerStars Hand #222978474917:  Hold'em No Limit ($0.05/$0.10 USD) - 2021/01/23 18:47:10 ET
Table 'Merope IV' 6-max Seat #3 is the button
Seat 1: mackm60 ($12.93 in chips) 
Seat 2: BluffMeThrice ($10.46 in chips) 
Seat 3: shavarun ($10.09 in chips) 
Seat 4: Nealy_Godz ($10.20 in chips) 
Seat 5: TrickyTrev31 ($15.79 in chips) 
Seat 6: KiraLasVegas ($11.71 in chips) 
Nealy_Godz: posts small blind $0.05
TrickyTrev31: posts big blind $0.10
*** HOLE CARDS ***
KiraLasVegas: folds 
mackm60: folds 
mackm60 leaves the table
BluffMeThrice: raises $0.25 to $0.35
shavarun: folds 
Nealy_Godz: folds 
TrickyTrev31: calls $0.25
*** FLOP *** [Qs 3h 8h]
TrickyTrev31: checks 
BluffMeThrice: bets $0.72
TrickyTrev31: folds 
Uncalled bet ($0.72) returned to BluffMeThrice
BluffMeThrice collected $0.72 from pot
BluffMeThrice: doesn't show hand 
*** SUMMARY ***
Total pot $0.75 | Rake $0.03 
Board [Qs 3h 8h]
Seat 1: mackm60 folded before Flop (didn't bet)
Seat 2: BluffMeThrice collected ($0.72)
Seat 3: shavarun (button) folded before Flop (didn't bet)
Seat 4: Nealy_Godz (small blind) folded before Flop
Seat 5: TrickyTrev31 (big blind) folded on the Flop
Seat 6: KiraLasVegas folded before Flop (didn't bet)



PokerStars Hand #222978495523:  Hold'em No Limit ($0.05/$0.10 USD) - 2021/01/23 18:47:43 ET
Table 'Merope IV' 6-max Seat #4 is the button
Seat 2: BluffMeThrice ($10.83 in chips) 
Seat 3: shavarun ($10.09 in chips) 
Seat 4: Nealy_Godz ($10.15 in chips) 
Seat 5: TrickyTrev31 ($15.44 in chips) 
Seat 6: KiraLasVegas ($11.71 in chips) 
TrickyTrev31: posts small blind $0.05
KiraLasVegas: posts big blind $0.10
*** HOLE CARDS ***
EasySteavy joins the table at seat #1 
BluffMeThrice: folds 
shavarun: folds 
Nealy_Godz: folds 
TrickyTrev31: calls $0.05
KiraLasVegas: raises $0.30 to $0.40
TrickyTrev31: calls $0.30
*** FLOP *** [5h 9s Qc]
TrickyTrev31: checks 
KiraLasVegas: checks 
*** TURN *** [5h 9s Qc] [8s]
TrickyTrev31: bets $0.30
KiraLasVegas: folds 
Uncalled bet ($0.30) returned to TrickyTrev31
TrickyTrev31 collected $0.76 from pot
TrickyTrev31: doesn't show hand 
*** SUMMARY ***
Total pot $0.80 | Rake $0.04 
Board [5h 9s Qc 8s]
Seat 2: BluffMeThrice folded before Flop (didn't bet)
Seat 3: shavarun folded before Flop (didn't bet)
Seat 4: Nealy_Godz (button) folded before Flop (didn't bet)
Seat 5: TrickyTrev31 (small blind) collected ($0.76)
Seat 6: KiraLasVegas (big blind) folded on the Turn



PokerStars Hand #222978523875:  Hold'em No Limit ($0.05/$0.10 USD) - 2021/01/23 18:48:29 ET
Table 'Merope IV' 6-max Seat #5 is the button
Seat 1: EasySteavy ($10 in chips) 
Seat 2: BluffMeThrice ($10.83 in chips) 
Seat 3: shavarun ($10.09 in chips) 
Seat 4: Nealy_Godz ($10.15 in chips) 
Seat 5: TrickyTrev31 ($15.80 in chips) 
Seat 6: KiraLasVegas ($11.31 in chips) 
KiraLasVegas: posts small blind $0.05
EasySteavy: posts big blind $0.10
*** HOLE CARDS ***
BluffMeThrice: raises $0.10 to $0.20
shavarun: folds 
Nealy_Godz: folds 
TrickyTrev31: folds 
KiraLasVegas: folds 
Nealy_Godz leaves the table
EasySteavy: calls $0.10
*** FLOP *** [3h 3s 2h]
EasySteavy: checks 
BluffMeThrice: bets $0.21
EasySteavy: folds 
Uncalled bet ($0.21) returned to BluffMeThrice
sportivu13 joins the table at seat #4 
BluffMeThrice collected $0.43 from pot
BluffMeThrice: doesn't show hand 
*** SUMMARY ***
Total pot $0.45 | Rake $0.02 
Board [3h 3s 2h]
Seat 1: EasySteavy (big blind) folded on the Flop
Seat 2: BluffMeThrice collected ($0.43)
Seat 3: shavarun folded before Flop (didn't bet)
Seat 4: Nealy_Godz folded before Flop (didn't bet)
Seat 5: TrickyTrev31 (button) folded before Flop (didn't bet)
Seat 6: KiraLasVegas (small blind) folded before Flop



PokerStars Hand #222978555270:  Hold'em No Limit ($0.05/$0.10 USD) - 2021/01/23 18:49:15 ET
Table 'Merope IV' 6-max Seat #6 is the button
Seat 1: EasySteavy ($9.80 in chips) 
Seat 2: BluffMeThrice ($11.06 in chips) 
Seat 3: shavarun ($10.09 in chips) 
Seat 5: TrickyTrev31 ($15.80 in chips) 
Seat 6: KiraLasVegas ($11.26 in chips) 
EasySteavy: posts small blind $0.05
BluffMeThrice: posts big blind $0.10
sportivu13: sits out 
*** HOLE CARDS ***
shavarun: folds 
shavarun leaves the table
TrickyTrev31: folds 
KiraLasVegas: folds 
ALL-IN0074 joins the table at seat #3 
EasySteavy: folds 
Uncalled bet ($0.05) returned to BluffMeThrice
BluffMeThrice collected $0.10 from pot
*** SUMMARY ***
Total pot $0.10 | Rake $0 
Seat 1: EasySteavy (small blind) folded before Flop
Seat 2: BluffMeThrice (big blind) collected ($0.10)
Seat 3: shavarun folded before Flop (didn't bet)
Seat 5: TrickyTrev31 folded before Flop (didn't bet)
Seat 6: KiraLasVegas (button) folded before Flop (didn't bet)



PokerStars Hand #222978565440:  Hold'em No Limit ($0.05/$0.10 USD) - 2021/01/23 18:49:32 ET
Table 'Merope IV' 6-max Seat #1 is the button
Seat 1: EasySteavy ($9.75 in chips) 
Seat 2: BluffMeThrice ($11.11 in chips) 
Seat 3: ALL-IN0074 ($10 in chips) 
Seat 5: TrickyTrev31 ($15.80 in chips) 
Seat 6: KiraLasVegas ($11.26 in chips) 
BluffMeThrice: posts small blind $0.05
ALL-IN0074: posts big blind $0.10
sportivu13: sits out 
*** HOLE CARDS ***
TrickyTrev31: raises $0.20 to $0.30
KiraLasVegas: folds 
EasySteavy: raises $0.20 to $0.50
BluffMeThrice: folds 
ALL-IN0074: raises $1.30 to $1.80
TrickyTrev31: folds 
EasySteavy: folds 
Uncalled bet ($1.30) returned to ALL-IN0074
ALL-IN0074 collected $1.35 from pot
ALL-IN0074: doesn't show hand 
*** SUMMARY ***
Total pot $1.35 | Rake $0 
Seat 1: EasySteavy (button) folded before Flop
Seat 2: BluffMeThrice (small blind) folded before Flop
Seat 3: ALL-IN0074 (big blind) collected ($1.35)
Seat 5: TrickyTrev31 folded before Flop
Seat 6: KiraLasVegas folded before Flop (didn't bet)



PokerStars Hand #222978597552:  Hold'em No Limit ($0.05/$0.10 USD) - 2021/01/23 18:50:24 ET
Table 'Merope IV' 6-max Seat #2 is the button
Seat 1: EasySteavy ($9.25 in chips) 
Seat 2: BluffMeThrice ($11.06 in chips) 
Seat 3: ALL-IN0074 ($10.85 in chips) 
Seat 4: sportivu13 ($10 in chips) 
Seat 5: TrickyTrev31 ($15.50 in chips) 
Seat 6: KiraLasVegas ($11.26 in chips) 
ALL-IN0074: posts small blind $0.05
sportivu13: posts big blind $0.10
*** HOLE CARDS ***
TrickyTrev31: calls $0.10
KiraLasVegas: folds 
EasySteavy: folds 
BluffMeThrice: folds 
ALL-IN0074: raises $0.40 to $0.50
sportivu13: folds 
TrickyTrev31: calls $0.40
*** FLOP *** [3h Kh 8h]
ALL-IN0074: checks 
TrickyTrev31: bets $0.50
ALL-IN0074: calls $0.50
*** TURN *** [3h Kh 8h] [Jc]
ALL-IN0074: checks 
TrickyTrev31: checks 
*** RIVER *** [3h Kh 8h Jc] [Td]
ALL-IN0074: checks 
TrickyTrev31: bets $1.01
ALL-IN0074: calls $1.01
*** SHOW DOWN ***
TrickyTrev31: shows [5s 6s] (high card King)
ALL-IN0074: shows [Ah Ks] (a pair of Kings)
ALL-IN0074 collected $3.93 from pot
*** SUMMARY ***
Total pot $4.12 | Rake $0.19 
Board [3h Kh 8h Jc Td]
Seat 1: EasySteavy folded before Flop (didn't bet)
Seat 2: BluffMeThrice (button) folded before Flop (didn't bet)
Seat 3: ALL-IN0074 (small blind) showed [Ah Ks] and won ($3.93) with a pair of Kings
Seat 4: sportivu13 (big blind) folded before Flop
Seat 5: TrickyTrev31 showed [5s 6s] and lost with high card King
Seat 6: KiraLasVegas folded before Flop (didn't bet)



PokerStars Hand #222978634473:  Hold'em No Limit ($0.05/$0.10 USD) - 2021/01/23 18:51:25 ET
Table 'Merope IV' 6-max Seat #3 is the button
Seat 1: EasySteavy ($10 in chips) 
Seat 2: BluffMeThrice ($11.06 in chips) 
Seat 3: ALL-IN0074 ($12.77 in chips) 
Seat 4: sportivu13 ($10 in chips) 
Seat 6: KiraLasVegas ($11.26 in chips) 
sportivu13: posts small blind $0.05
KiraLasVegas: posts big blind $0.10
*** HOLE CARDS ***
EasySteavy has timed out
EasySteavy: folds 
BluffMeThrice: folds 
ALL-IN0074: folds 
sportivu13: raises $0.19 to $0.29
KiraLasVegas: calls $0.19
*** FLOP *** [6s 7d 4s]
sportivu13: checks 
KiraLasVegas: checks 
*** TURN *** [6s 7d 4s] [3s]
sportivu13: checks 
KiraLasVegas: checks 
*** RIVER *** [6s 7d 4s 3s] [3d]
sportivu13: checks 
KiraLasVegas: checks 
*** SHOW DOWN ***
sportivu13: shows [Ac Qc] (a pair of Threes)
KiraLasVegas: mucks hand 
sportivu13 collected $0.55 from pot
*** SUMMARY ***
Total pot $0.58 | Rake $0.03 
Board [6s 7d 4s 3s 3d]
Seat 1: EasySteavy folded before Flop (didn't bet)
Seat 2: BluffMeThrice folded before Flop (didn't bet)
Seat 3: ALL-IN0074 (button) folded before Flop (didn't bet)
Seat 4: sportivu13 (small blind) showed [Ac Qc] and won ($0.55) with a pair of Threes
Seat 6: KiraLasVegas (big blind) mucked



PokerStars Hand #222978657193:  Hold'em No Limit ($0.05/$0.10 USD) - 2021/01/23 18:52:03 ET
Table 'Merope IV' 6-max Seat #4 is the button
Seat 1: EasySteavy ($10 in chips) 
Seat 2: BluffMeThrice ($11.06 in chips) 
Seat 3: ALL-IN0074 ($12.77 in chips) 
Seat 4: sportivu13 ($10.26 in chips) 
Seat 6: KiraLasVegas ($10.97 in chips) 
KiraLasVegas: posts small blind $0.05
EasySteavy: posts big blind $0.10
*** HOLE CARDS ***
BluffMeThrice: folds 
ALL-IN0074: raises $0.15 to $0.25
sportivu13: folds 
KiraLasVegas: folds 
EasySteavy: folds 
Uncalled bet ($0.15) returned to ALL-IN0074
ALL-IN0074 collected $0.25 from pot
ALL-IN0074: doesn't show hand 
*** SUMMARY ***
Total pot $0.25 | Rake $0 
Seat 1: EasySteavy (big blind) folded before Flop
Seat 2: BluffMeThrice folded before Flop (didn't bet)
Seat 3: ALL-IN0074 collected ($0.25)
Seat 4: sportivu13 (button) folded before Flop (didn't bet)
Seat 6: KiraLasVegas (small blind) folded before Flop



PokerStars Hand #222978666995:  Hold'em No Limit ($0.05/$0.10 USD) - 2021/01/23 18:52:19 ET
Table 'Merope IV' 6-max Seat #6 is the button
Seat 1: EasySteavy ($9.90 in chips) 
Seat 2: BluffMeThrice ($11.06 in chips) 
Seat 3: ALL-IN0074 ($12.92 in chips) 
Seat 4: sportivu13 ($10.26 in chips) 
Seat 6: KiraLasVegas ($10.92 in chips) 
EasySteavy: posts small blind $0.05
BluffMeThrice: posts big blind $0.10
*** HOLE CARDS ***
ALL-IN0074: folds 
sportivu13: folds 
KiraLasVegas: folds 
EasySteavy: raises $0.20 to $0.30
BluffMeThrice: folds 
Uncalled bet ($0.20) returned to EasySteavy
EasySteavy collected $0.20 from pot
EasySteavy: doesn't show hand 
*** SUMMARY ***
Total pot $0.20 | Rake $0 
Seat 1: EasySteavy (small blind) collected ($0.20)
Seat 2: BluffMeThrice (big blind) folded before Flop
Seat 3: ALL-IN0074 folded before Flop (didn't bet)
Seat 4: sportivu13 folded before Flop (didn't bet)
Seat 6: KiraLasVegas (button) folded before Flop (didn't bet)



PokerStars Hand #222978676012:  Hold'em No Limit ($0.05/$0.10 USD) - 2021/01/23 18:52:34 ET
Table 'Merope IV' 6-max Seat #1 is the button
Seat 1: EasySteavy ($10 in chips) 
Seat 2: BluffMeThrice ($10.96 in chips) 
Seat 3: ALL-IN0074 ($12.92 in chips) 
Seat 4: sportivu13 ($10.26 in chips) 
Seat 6: KiraLasVegas ($10.92 in chips) 
BluffMeThrice: posts small blind $0.05
ALL-IN0074: posts big blind $0.10
TrickyTrev31: sits out 
*** HOLE CARDS ***
sportivu13: folds 
KiraLasVegas: folds 
EasySteavy: raises $0.20 to $0.30
BluffMeThrice: folds 
ALL-IN0074: folds 
Uncalled bet ($0.20) returned to EasySteavy
EasySteavy collected $0.25 from pot
EasySteavy: doesn't show hand 
*** SUMMARY ***
Total pot $0.25 | Rake $0 
Seat 1: EasySteavy (button) collected ($0.25)
Seat 2: BluffMeThrice (small blind) folded before Flop
Seat 3: ALL-IN0074 (big blind) folded before Flop
Seat 4: sportivu13 folded before Flop (didn't bet)
Seat 6: KiraLasVegas folded before Flop (didn't bet)



PokerStars Hand #222978685449:  Hold'em No Limit ($0.05/$0.10 USD) - 2021/01/23 18:52:50 ET
Table 'Merope IV' 6-max Seat #2 is the button
Seat 1: EasySteavy ($10.15 in chips) 
Seat 2: BluffMeThrice ($10.91 in chips) 
Seat 3: ALL-IN0074 ($12.82 in chips) 
Seat 4: sportivu13 ($10.26 in chips) 
Seat 6: KiraLasVegas ($10.92 in chips) 
ALL-IN0074: posts small blind $0.05
sportivu13: posts big blind $0.10
TrickyTrev31: sits out 
*** HOLE CARDS ***
KiraLasVegas: folds 
EasySteavy: folds 
BluffMeThrice: raises $0.10 to $0.20
ALL-IN0074: folds 
sportivu13: folds 
Uncalled bet ($0.10) returned to BluffMeThrice
BluffMeThrice collected $0.25 from pot
BluffMeThrice: doesn't show hand 
*** SUMMARY ***
Total pot $0.25 | Rake $0 
Seat 1: EasySteavy folded before Flop (didn't bet)
Seat 2: BluffMeThrice (button) collected ($0.25)
Seat 3: ALL-IN0074 (small blind) folded before Flop
Seat 4: sportivu13 (big blind) folded before Flop
Seat 6: KiraLasVegas folded before Flop (didn't bet)



PokerStars Hand #222978693779:  Hold'em No Limit ($0.05/$0.10 USD) - 2021/01/23 18:53:03 ET
Table 'Merope IV' 6-max Seat #3 is the button
Seat 1: EasySteavy ($10.15 in chips) 
Seat 2: BluffMeThrice ($11.06 in chips) 
Seat 3: ALL-IN0074 ($12.77 in chips) 
Seat 4: sportivu13 ($10.16 in chips) 
Seat 5: TrickyTrev31 ($13.49 in chips) 
Seat 6: KiraLasVegas ($10.92 in chips) 
sportivu13: posts small blind $0.05
TrickyTrev31: posts big blind $0.10
*** HOLE CARDS ***
KiraLasVegas: folds 
EasySteavy: raises $0.20 to $0.30
BluffMeThrice: folds 
ALL-IN0074: folds 
sportivu13: folds 
TrickyTrev31: calls $0.20
*** FLOP *** [9c Qd 4s]
TrickyTrev31: checks 
EasySteavy: bets $0.31
TrickyTrev31: calls $0.31
*** TURN *** [9c Qd 4s] [6s]
TrickyTrev31: checks 
EasySteavy: bets $0.91
TrickyTrev31: folds 
Uncalled bet ($0.91) returned to EasySteavy
EasySteavy collected $1.21 from pot
EasySteavy: doesn't show hand 
*** SUMMARY ***
Total pot $1.27 | Rake $0.06 
Board [9c Qd 4s 6s]
Seat 1: EasySteavy collected ($1.21)
Seat 2: BluffMeThrice folded before Flop (didn't bet)
Seat 3: ALL-IN0074 (button) folded before Flop (didn't bet)
Seat 4: sportivu13 (small blind) folded before Flop
Seat 5: TrickyTrev31 (big blind) folded on the Turn
Seat 6: KiraLasVegas folded before Flop (didn't bet)



PokerStars Hand #222978733534:  Hold'em No Limit ($0.05/$0.10 USD) - 2021/01/23 18:54:10 ET
Table 'Merope IV' 6-max Seat #4 is the button
Seat 1: EasySteavy ($10.75 in chips) 
Seat 2: BluffMeThrice ($11.06 in chips) 
Seat 3: ALL-IN0074 ($12.77 in chips) 
Seat 4: sportivu13 ($10.11 in chips) 
Seat 5: TrickyTrev31 ($12.88 in chips) 
Seat 6: KiraLasVegas ($10.92 in chips) 
TrickyTrev31: posts small blind $0.05
KiraLasVegas: posts big blind $0.10
*** HOLE CARDS ***
EasySteavy: folds 
BluffMeThrice: folds 
ALL-IN0074: raises $0.15 to $0.25
sportivu13: folds 
TrickyTrev31: folds 
KiraLasVegas: folds 
Uncalled bet ($0.15) returned to ALL-IN0074
ALL-IN0074 collected $0.25 from pot
ALL-IN0074: doesn't show hand 
*** SUMMARY ***
Total pot $0.25 | Rake $0 
Seat 1: EasySteavy folded before Flop (didn't bet)
Seat 2: BluffMeThrice folded before Flop (didn't bet)
Seat 3: ALL-IN0074 collected ($0.25)
Seat 4: sportivu13 (button) folded before Flop (didn't bet)
Seat 5: TrickyTrev31 (small blind) folded before Flop
Seat 6: KiraLasVegas (big blind) folded before Flop



PokerStars Hand #222978743329:  Hold'em No Limit ($0.05/$0.10 USD) - 2021/01/23 18:54:26 ET
Table 'Merope IV' 6-max Seat #5 is the button
Seat 1: EasySteavy ($10.75 in chips) 
Seat 2: BluffMeThrice ($11.06 in chips) 
Seat 3: ALL-IN0074 ($12.92 in chips) 
Seat 4: sportivu13 ($10.11 in chips) 
Seat 5: TrickyTrev31 ($12.83 in chips) 
Seat 6: KiraLasVegas ($10.82 in chips) 
KiraLasVegas: posts small blind $0.05
EasySteavy: posts big blind $0.10
*** HOLE CARDS ***
BluffMeThrice: raises $0.20 to $0.30
ALL-IN0074: folds 
sportivu13: folds 
TrickyTrev31: calls $0.30
KiraLasVegas: folds 
EasySteavy: calls $0.20
*** FLOP *** [5d Ad 7s]
EasySteavy: checks 
BluffMeThrice: bets $0.91
TrickyTrev31: folds 
EasySteavy: calls $0.91
*** TURN *** [5d Ad 7s] [Js]
EasySteavy: checks 
BluffMeThrice: bets $2.65
EasySteavy: folds 
Uncalled bet ($2.65) returned to BluffMeThrice
BluffMeThrice collected $2.65 from pot
BluffMeThrice: doesn't show hand 
*** SUMMARY ***
Total pot $2.77 | Rake $0.12 
Board [5d Ad 7s Js]
Seat 1: EasySteavy (big blind) folded on the Turn
Seat 2: BluffMeThrice collected ($2.65)
Seat 3: ALL-IN0074 folded before Flop (didn't bet)
Seat 4: sportivu13 folded before Flop (didn't bet)
Seat 5: TrickyTrev31 (button) folded on the Flop
Seat 6: KiraLasVegas (small blind) folded before Flop



PokerStars Hand #222978772325:  Hold'em No Limit ($0.05/$0.10 USD) - 2021/01/23 18:55:16 ET
Table 'Merope IV' 6-max Seat #6 is the button
Seat 1: EasySteavy ($9.54 in chips) 
Seat 2: BluffMeThrice ($12.50 in chips) 
Seat 3: ALL-IN0074 ($12.92 in chips) 
Seat 4: sportivu13 ($10.11 in chips) 
Seat 5: TrickyTrev31 ($12.53 in chips) 
Seat 6: KiraLasVegas ($10.77 in chips) 
EasySteavy: posts small blind $0.05
BluffMeThrice: posts big blind $0.10
*** HOLE CARDS ***
ALL-IN0074: folds 
sportivu13: folds 
TrickyTrev31: folds 
KiraLasVegas: folds 
EasySteavy: raises $0.20 to $0.30
BluffMeThrice: folds 
Uncalled bet ($0.20) returned to EasySteavy
EasySteavy collected $0.20 from pot
EasySteavy: doesn't show hand 
*** SUMMARY ***
Total pot $0.20 | Rake $0 
Seat 1: EasySteavy (small blind) collected ($0.20)
Seat 2: BluffMeThrice (big blind) folded before Flop
Seat 3: ALL-IN0074 folded before Flop (didn't bet)
Seat 4: sportivu13 folded before Flop (didn't bet)
Seat 5: TrickyTrev31 folded before Flop (didn't bet)
Seat 6: KiraLasVegas (button) folded before Flop (didn't bet)



PokerStars Hand #222978782521:  Hold'em No Limit ($0.05/$0.10 USD) - 2021/01/23 18:55:39 ET
Table 'Merope IV' 6-max Seat #1 is the button
Seat 1: EasySteavy ($9.64 in chips) 
Seat 2: BluffMeThrice ($12.40 in chips) 
Seat 3: ALL-IN0074 ($12.92 in chips) 
Seat 4: sportivu13 ($10.11 in chips) 
Seat 5: TrickyTrev31 ($12.53 in chips) 
Seat 6: KiraLasVegas ($10.77 in chips) 
BluffMeThrice: posts small blind $0.05
ALL-IN0074: posts big blind $0.10
*** HOLE CARDS ***
sportivu13: folds 
TrickyTrev31: folds 
KiraLasVegas: raises $0.20 to $0.30
EasySteavy: folds 
BluffMeThrice: calls $0.25
ALL-IN0074: calls $0.20
*** FLOP *** [Ah 3s 3d]
BluffMeThrice: checks 
ALL-IN0074: checks 
KiraLasVegas: bets $0.43
BluffMeThrice: folds 
ALL-IN0074: folds 
Uncalled bet ($0.43) returned to KiraLasVegas
KiraLasVegas collected $0.86 from pot
KiraLasVegas: doesn't show hand 
*** SUMMARY ***
Total pot $0.90 | Rake $0.04 
Board [Ah 3s 3d]
Seat 1: EasySteavy (button) folded before Flop (didn't bet)
Seat 2: BluffMeThrice (small blind) folded on the Flop
Seat 3: ALL-IN0074 (big blind) folded on the Flop
Seat 4: sportivu13 folded before Flop (didn't bet)
Seat 5: TrickyTrev31 folded before Flop (didn't bet)
Seat 6: KiraLasVegas collected ($0.86)



PokerStars Hand #222978804499:  Hold'em No Limit ($0.05/$0.10 USD) - 2021/01/23 18:56:29 ET
Table 'Merope IV' 6-max Seat #2 is the button
Seat 1: EasySteavy ($9.64 in chips) 
Seat 2: BluffMeThrice ($12.10 in chips) 
Seat 3: ALL-IN0074 ($12.62 in chips) 
Seat 4: sportivu13 ($10.11 in chips) 
Seat 5: TrickyTrev31 ($12.53 in chips) 
Seat 6: KiraLasVegas ($11.33 in chips) 
ALL-IN0074: posts small blind $0.05
sportivu13: posts big blind $0.10
*** HOLE CARDS ***
TrickyTrev31: calls $0.10
KiraLasVegas: folds 
EasySteavy: folds 
BluffMeThrice: raises $0.35 to $0.45
ALL-IN0074: folds 
sportivu13: calls $0.35
TrickyTrev31: calls $0.35
*** FLOP *** [4c 6h 9h]
sportivu13: checks 
TrickyTrev31: bets $1.34
BluffMeThrice: folds 
sportivu13: calls $1.34
*** TURN *** [4c 6h 9h] [6c]
sportivu13: checks 
TrickyTrev31: bets $3.90
sportivu13: raises $4.42 to $8.32 and is all-in
TrickyTrev31: calls $4.42
TrickyTrev31 has timed out
*** RIVER *** [4c 6h 9h 6c] [Tc]
*** SHOW DOWN ***
sportivu13: shows [7c 8c] (a flush, Ten high)
TrickyTrev31: shows [9c Ks] (two pair, Nines and Sixes)
sportivu13 collected $19.79 from pot
*** SUMMARY ***
Total pot $20.72 | Rake $0.93 
Board [4c 6h 9h 6c Tc]
Seat 1: EasySteavy folded before Flop (didn't bet)
Seat 2: BluffMeThrice (button) folded on the Flop
Seat 3: ALL-IN0074 (small blind) folded before Flop
Seat 4: sportivu13 (big blind) showed [7c 8c] and won ($19.79) with a flush, Ten high
Seat 5: TrickyTrev31 showed [9c Ks] and lost with two pair, Nines and Sixes
Seat 6: KiraLasVegas folded before Flop (didn't bet)



PokerStars Hand #222978837677:  Hold'em No Limit ($0.05/$0.10 USD) - 2021/01/23 18:57:44 ET
Table 'Merope IV' 6-max Seat #3 is the button
Seat 1: EasySteavy ($9.64 in chips) 
Seat 2: BluffMeThrice ($11.65 in chips) 
Seat 3: ALL-IN0074 ($12.57 in chips) 
Seat 4: sportivu13 ($19.79 in chips) 
Seat 5: TrickyTrev31 ($2.42 in chips) 
Seat 6: KiraLasVegas ($11.33 in chips) 
sportivu13: posts small blind $0.05
TrickyTrev31: posts big blind $0.10
*** HOLE CARDS ***
KiraLasVegas: folds 
EasySteavy: raises $0.20 to $0.30
BluffMeThrice: folds 
ALL-IN0074: folds 
sportivu13: folds 
TrickyTrev31: raises $2.12 to $2.42 and is all-in
EasySteavy: calls $2.12
*** FLOP *** [Qs 5h 5s]
*** TURN *** [Qs 5h 5s] [6c]
*** RIVER *** [Qs 5h 5s 6c] [9s]
*** SHOW DOWN ***
TrickyTrev31: shows [Kc Ah] (a pair of Fives)
EasySteavy: shows [Jh Ac] (a pair of Fives - lower kicker)
TrickyTrev31 collected $4.67 from pot
*** SUMMARY ***
Total pot $4.89 | Rake $0.22 
Board [Qs 5h 5s 6c 9s]
Seat 1: EasySteavy showed [Jh Ac] and lost with a pair of Fives
Seat 2: BluffMeThrice folded before Flop (didn't bet)
Seat 3: ALL-IN0074 (button) folded before Flop (didn't bet)
Seat 4: sportivu13 (small blind) folded before Flop
Seat 5: TrickyTrev31 (big blind) showed [Kc Ah] and won ($4.67) with a pair of Fives
Seat 6: KiraLasVegas folded before Flop (didn't bet)



PokerStars Hand #222978852694:  Hold'em No Limit ($0.05/$0.10 USD) - 2021/01/23 18:58:18 ET
Table 'Merope IV' 6-max Seat #4 is the button
Seat 1: EasySteavy ($7.22 in chips) 
Seat 2: BluffMeThrice ($11.65 in chips) 
Seat 3: ALL-IN0074 ($12.57 in chips) 
Seat 4: sportivu13 ($19.74 in chips) 
Seat 5: TrickyTrev31 ($4.67 in chips) 
Seat 6: KiraLasVegas ($11.33 in chips) 
TrickyTrev31: posts small blind $0.05
KiraLasVegas: posts big blind $0.10
*** HOLE CARDS ***
EasySteavy: raises $0.20 to $0.30
BluffMeThrice: raises $0.75 to $1.05
ALL-IN0074: folds 
sportivu13: folds 
TrickyTrev31: folds 
KiraLasVegas: folds 
EasySteavy is disconnected 
EasySteavy is connected 
EasySteavy: folds 
Uncalled bet ($0.75) returned to BluffMeThrice
BluffMeThrice collected $0.75 from pot
BluffMeThrice: doesn't show hand 
*** SUMMARY ***
Total pot $0.75 | Rake $0 
Seat 1: EasySteavy folded before Flop
Seat 2: BluffMeThrice collected ($0.75)
Seat 3: ALL-IN0074 folded before Flop (didn't bet)
Seat 4: sportivu13 (button) folded before Flop (didn't bet)
Seat 5: TrickyTrev31 (small blind) folded before Flop
Seat 6: KiraLasVegas (big blind) folded before Flop



PokerStars Hand #222978870094:  Hold'em No Limit ($0.05/$0.10 USD) - 2021/01/23 18:58:57 ET
Table 'Merope IV' 6-max Seat #5 is the button
Seat 1: EasySteavy ($6.92 in chips) 
Seat 2: BluffMeThrice ($12.10 in chips) 
Seat 3: ALL-IN0074 ($12.57 in chips) 
Seat 4: sportivu13 ($19.74 in chips) 
Seat 5: TrickyTrev31 ($4.62 in chips) 
Seat 6: KiraLasVegas ($11.23 in chips) 
KiraLasVegas: posts small blind $0.05
EasySteavy: posts big blind $0.10
*** HOLE CARDS ***
BluffMeThrice: folds 
ALL-IN0074: folds 
sportivu13: folds 
TrickyTrev31: calls $0.10
KiraLasVegas: folds 
EasySteavy: raises $0.45 to $0.55
TrickyTrev31: calls $0.45
*** FLOP *** [9d Qs Jh]
EasySteavy: checks 
TrickyTrev31: bets $1.10
EasySteavy: folds 
Uncalled bet ($1.10) returned to TrickyTrev31
TrickyTrev31 collected $1.10 from pot
TrickyTrev31: doesn't show hand 
*** SUMMARY ***
Total pot $1.15 | Rake $0.05 
Board [9d Qs Jh]
Seat 1: EasySteavy (big blind) folded on the Flop
Seat 2: BluffMeThrice folded before Flop (didn't bet)
Seat 3: ALL-IN0074 folded before Flop (didn't bet)
Seat 4: sportivu13 folded before Flop (didn't bet)
Seat 5: TrickyTrev31 (button) collected ($1.10)
Seat 6: KiraLasVegas (small blind) folded before Flop



PokerStars Hand #222978887992:  Hold'em No Limit ($0.05/$0.10 USD) - 2021/01/23 18:59:37 ET
Table 'Merope IV' 6-max Seat #6 is the button
Seat 1: EasySteavy ($6.37 in chips) 
Seat 2: BluffMeThrice ($12.10 in chips) 
Seat 3: ALL-IN0074 ($12.57 in chips) 
Seat 4: sportivu13 ($19.74 in chips) 
Seat 5: TrickyTrev31 ($5.17 in chips) 
Seat 6: KiraLasVegas ($11.18 in chips) 
EasySteavy: posts small blind $0.05
BluffMeThrice: posts big blind $0.10
*** HOLE CARDS ***
ALL-IN0074: folds 
sportivu13: folds 
TrickyTrev31: folds 
KiraLasVegas: folds 
EasySteavy: folds 
Uncalled bet ($0.05) returned to BluffMeThrice
BluffMeThrice collected $0.10 from pot
BluffMeThrice: doesn't show hand 
*** SUMMARY ***
Total pot $0.10 | Rake $0 
Seat 1: EasySteavy (small blind) folded before Flop
Seat 2: BluffMeThrice (big blind) collected ($0.10)
Seat 3: ALL-IN0074 folded before Flop (didn't bet)
Seat 4: sportivu13 folded before Flop (didn't bet)
Seat 5: TrickyTrev31 folded before Flop (didn't bet)
Seat 6: KiraLasVegas (button) folded before Flop (didn't bet)



PokerStars Hand #222978894085:  Hold'em No Limit ($0.05/$0.10 USD) - 2021/01/23 18:59:50 ET
Table 'Merope IV' 6-max Seat #1 is the button
Seat 1: EasySteavy ($6.32 in chips) 
Seat 2: BluffMeThrice ($12.15 in chips) 
Seat 3: ALL-IN0074 ($12.57 in chips) 
Seat 4: sportivu13 ($19.74 in chips) 
Seat 5: TrickyTrev31 ($5.17 in chips) 
Seat 6: KiraLasVegas ($11.18 in chips) 
BluffMeThrice: posts small blind $0.05
ALL-IN0074: posts big blind $0.10
*** HOLE CARDS ***
sportivu13: folds 
TrickyTrev31: folds 
KiraLasVegas: folds 
EasySteavy: folds 
BluffMeThrice: folds 
Uncalled bet ($0.05) returned to ALL-IN0074
ALL-IN0074 collected $0.10 from pot
ALL-IN0074: doesn't show hand 
*** SUMMARY ***
Total pot $0.10 | Rake $0 
Seat 1: EasySteavy (button) folded before Flop (didn't bet)
Seat 2: BluffMeThrice (small blind) folded before Flop
Seat 3: ALL-IN0074 (big blind) collected ($0.10)
Seat 4: sportivu13 folded before Flop (didn't bet)
Seat 5: TrickyTrev31 folded before Flop (didn't bet)
Seat 6: KiraLasVegas folded before Flop (didn't bet)



PokerStars Hand #222978900499:  Hold'em No Limit ($0.05/$0.10 USD) - 2021/01/23 19:00:05 ET
Table 'Merope IV' 6-max Seat #2 is the button
Seat 1: EasySteavy ($6.32 in chips) 
Seat 2: BluffMeThrice ($12.10 in chips) 
Seat 3: ALL-IN0074 ($12.62 in chips) 
Seat 4: sportivu13 ($19.74 in chips) 
Seat 5: TrickyTrev31 ($5.17 in chips) 
Seat 6: KiraLasVegas ($11.18 in chips) 
ALL-IN0074: posts small blind $0.05
sportivu13: posts big blind $0.10
*** HOLE CARDS ***
TrickyTrev31: folds 
KiraLasVegas: folds 
EasySteavy: raises $0.20 to $0.30
BluffMeThrice: calls $0.30
ALL-IN0074: folds 
sportivu13: folds 
*** FLOP *** [9c 8c Ts]
EasySteavy: bets $0.56
BluffMeThrice: calls $0.56
*** TURN *** [9c 8c Ts] [Js]
EasySteavy: checks 
BluffMeThrice: bets $1.79
EasySteavy: calls $1.79
*** RIVER *** [9c 8c Ts Js] [3s]
EasySteavy: checks 
BluffMeThrice: checks 
*** SHOW DOWN ***
EasySteavy: shows [9d 9h] (three of a kind, Nines)
BluffMeThrice: mucks hand 
EasySteavy collected $5.20 from pot
*** SUMMARY ***
Total pot $5.45 | Rake $0.25 
Board [9c 8c Ts Js 3s]
Seat 1: EasySteavy showed [9d 9h] and won ($5.20) with three of a kind, Nines
Seat 2: BluffMeThrice (button) mucked
Seat 3: ALL-IN0074 (small blind) folded before Flop
Seat 4: sportivu13 (big blind) folded before Flop
Seat 5: TrickyTrev31 folded before Flop (didn't bet)
Seat 6: KiraLasVegas folded before Flop (didn't bet)



PokerStars Hand #222978931291:  Hold'em No Limit ($0.05/$0.10 USD) - 2021/01/23 19:01:05 ET
Table 'Merope IV' 6-max Seat #3 is the button
Seat 1: EasySteavy ($8.87 in chips) 
Seat 2: BluffMeThrice ($9.45 in chips) 
Seat 3: ALL-IN0074 ($12.57 in chips) 
Seat 4: sportivu13 ($19.64 in chips) 
Seat 5: TrickyTrev31 ($5.17 in chips) 
Seat 6: KiraLasVegas ($11.18 in chips) 
sportivu13: posts small blind $0.05
TrickyTrev31: posts big blind $0.10
*** HOLE CARDS ***
KiraLasVegas: folds 
EasySteavy: raises $0.20 to $0.30
BluffMeThrice: calls $0.30
ALL-IN0074: folds 
sportivu13: calls $0.25
TrickyTrev31: folds 
*** FLOP *** [Js 2h 3h]
sportivu13: checks 
EasySteavy: checks 
BluffMeThrice: bets $0.96
sportivu13: folds 
EasySteavy: folds 
Uncalled bet ($0.96) returned to BluffMeThrice
BluffMeThrice collected $0.96 from pot
BluffMeThrice: doesn't show hand 
*** SUMMARY ***
Total pot $1 | Rake $0.04 
Board [Js 2h 3h]
Seat 1: EasySteavy folded on the Flop
Seat 2: BluffMeThrice collected ($0.96)
Seat 3: ALL-IN0074 (button) folded before Flop (didn't bet)
Seat 4: sportivu13 (small blind) folded on the Flop
Seat 5: TrickyTrev31 (big blind) folded before Flop
Seat 6: KiraLasVegas folded before Flop (didn't bet)



PokerStars Hand #222978955382:  Hold'em No Limit ($0.05/$0.10 USD) - 2021/01/23 19:01:49 ET
Table 'Merope IV' 6-max Seat #4 is the button
Seat 1: EasySteavy ($8.57 in chips) 
Seat 2: BluffMeThrice ($10.11 in chips) 
Seat 3: ALL-IN0074 ($12.57 in chips) 
Seat 4: sportivu13 ($19.34 in chips) 
Seat 5: TrickyTrev31 ($5.07 in chips) 
Seat 6: KiraLasVegas ($11.18 in chips) 
TrickyTrev31: posts small blind $0.05
KiraLasVegas: posts big blind $0.10
*** HOLE CARDS ***
EasySteavy: folds 
BluffMeThrice: raises $0.25 to $0.35
ALL-IN0074: folds 
sportivu13: folds 
TrickyTrev31: calls $0.30
KiraLasVegas: calls $0.25
*** FLOP *** [4c 8d Ac]
TrickyTrev31: checks 
KiraLasVegas: checks 
BluffMeThrice: checks 
*** TURN *** [4c 8d Ac] [5s]
TrickyTrev31: checks 
KiraLasVegas: checks 
BluffMeThrice: checks 
*** RIVER *** [4c 8d Ac 5s] [7s]
EasySteavy is disconnected 
TrickyTrev31: bets $1
KiraLasVegas: folds 
BluffMeThrice: raises $1.50 to $2.50
TrickyTrev31: raises $2.22 to $4.72 and is all-in
BluffMeThrice: calls $2.22
*** SHOW DOWN ***
TrickyTrev31: shows [8h 7d] (two pair, Eights and Sevens)
BluffMeThrice: shows [6d 6s] (a straight, Four to Eight)
BluffMeThrice collected $10.02 from pot
*** SUMMARY ***
Total pot $10.49 | Rake $0.47 
Board [4c 8d Ac 5s 7s]
Seat 1: EasySteavy folded before Flop (didn't bet)
Seat 2: BluffMeThrice showed [6d 6s] and won ($10.02) with a straight, Four to Eight
Seat 3: ALL-IN0074 folded before Flop (didn't bet)
Seat 4: sportivu13 (button) folded before Flop (didn't bet)
Seat 5: TrickyTrev31 (small blind) showed [8h 7d] and lost with two pair, Eights and Sevens
Seat 6: KiraLasVegas (big blind) folded on the River



PokerStars Hand #222979000769:  Hold'em No Limit ($0.05/$0.10 USD) - 2021/01/23 19:03:07 ET
Table 'Merope IV' 6-max Seat #6 is the button
Seat 1: EasySteavy ($8.57 in chips) 
Seat 2: BluffMeThrice ($15.06 in chips) 
Seat 3: ALL-IN0074 ($12.57 in chips) 
Seat 4: sportivu13 ($19.34 in chips) 
Seat 6: KiraLasVegas ($10.83 in chips) 
EasySteavy: posts small blind $0.05
BluffMeThrice: posts big blind $0.10
*** HOLE CARDS ***
ALL-IN0074: folds 
sportivu13: folds 
KiraLasVegas: raises $0.15 to $0.25
TrickyTrev31 leaves the table
Mammouth joins the table at seat #5 
EasySteavy: folds 
BluffMeThrice: folds 
Uncalled bet ($0.15) returned to KiraLasVegas
KiraLasVegas collected $0.25 from pot
KiraLasVegas: doesn't show hand 
*** SUMMARY ***
Total pot $0.25 | Rake $0 
Seat 1: EasySteavy (small blind) folded before Flop
Seat 2: BluffMeThrice (big blind) folded before Flop
Seat 3: ALL-IN0074 folded before Flop (didn't bet)
Seat 4: sportivu13 folded before Flop (didn't bet)
Seat 6: KiraLasVegas (button) collected ($0.25)



PokerStars Hand #222979009485:  Hold'em No Limit ($0.05/$0.10 USD) - 2021/01/23 19:03:22 ET
Table 'Merope IV' 6-max Seat #1 is the button
Seat 1: EasySteavy ($8.52 in chips) 
Seat 2: BluffMeThrice ($14.96 in chips) 
Seat 5: Mammouth ($10 in chips) 
Seat 6: KiraLasVegas ($10.98 in chips) 
BluffMeThrice: posts small blind $0.05
ALL-IN0074 has timed out
ALL-IN0074: is sitting out 
sportivu13: is sitting out 
sportivu13 leaves the table
Mammouth: posts big blind $0.10
*** HOLE CARDS ***
KiraLasVegas: folds 
Wangritter13 joins the table at seat #4 
EasySteavy: raises $0.20 to $0.30
BluffMeThrice: folds 
Mammouth: folds 
Uncalled bet ($0.20) returned to EasySteavy
Mammouth was removed from the table for failing to post
Mammouth leaves the table
EasySteavy collected $0.25 from pot
EasySteavy: doesn't show hand 
*** SUMMARY ***
Total pot $0.25 | Rake $0 
Seat 1: EasySteavy (button) collected ($0.25)
Seat 2: BluffMeThrice (small blind) folded before Flop
Seat 5: Mammouth (big blind) folded before Flop
Seat 6: KiraLasVegas folded before Flop (didn't bet)



PokerStars Hand #222979021649:  Hold'em No Limit ($0.05/$0.10 USD) - 2021/01/23 19:03:43 ET
Table 'Merope IV' 6-max Seat #2 is the button
Seat 1: EasySteavy ($8.67 in chips) 
Seat 2: BluffMeThrice ($14.91 in chips) 
Seat 6: KiraLasVegas ($10.98 in chips) 
KiraLasVegas: posts small blind $0.05
EasySteavy: posts big blind $0.10
*** HOLE CARDS ***
BluffMeThrice: folds 
KiraLasVegas: folds 
Uncalled bet ($0.05) returned to EasySteavy
EasySteavy collected $0.10 from pot
EasySteavy: doesn't show hand 
*** SUMMARY ***
Total pot $0.10 | Rake $0 
Seat 1: EasySteavy (big blind) collected ($0.10)
Seat 2: BluffMeThrice (button) folded before Flop (didn't bet)
Seat 6: KiraLasVegas (small blind) folded before Flop



PokerStars Hand #222979025204:  Hold'em No Limit ($0.05/$0.10 USD) - 2021/01/23 19:03:49 ET
Table 'Merope IV' 6-max Seat #6 is the button
Seat 1: EasySteavy ($8.72 in chips) 
Seat 2: BluffMeThrice ($14.91 in chips) 
Seat 4: Wangritter13 ($10 in chips) 
Seat 6: KiraLasVegas ($10.93 in chips) 
EasySteavy: posts small blind $0.05
BluffMeThrice: posts big blind $0.10
ALL-IN0074: sits out 
Wangritter13: posts big blind $0.10
*** HOLE CARDS ***
Wangritter13: checks 
KiraLasVegas: folds 
EasySteavy: folds 
BluffMeThrice: raises $0.25 to $0.35
Wangritter13: folds 
Uncalled bet ($0.25) returned to BluffMeThrice
BluffMeThrice collected $0.25 from pot
BluffMeThrice: doesn't show hand 
*** SUMMARY ***
Total pot $0.25 | Rake $0 
Seat 1: EasySteavy (small blind) folded before Flop
Seat 2: BluffMeThrice (big blind) collected ($0.25)
Seat 4: Wangritter13 folded before Flop (didn't bet)
Seat 6: KiraLasVegas (button) folded before Flop (didn't bet)



PokerStars Hand #222979033608:  Hold'em No Limit ($0.05/$0.10 USD) - 2021/01/23 19:04:04 ET
Table 'Merope IV' 6-max Seat #1 is the button
Seat 1: EasySteavy ($8.67 in chips) 
Seat 2: BluffMeThrice ($15.06 in chips) 
Seat 3: ALL-IN0074 ($12.57 in chips) 
Seat 4: Wangritter13 ($9.90 in chips) 
Seat 6: KiraLasVegas ($10.93 in chips) 
BluffMeThrice: posts small blind $0.05
ALL-IN0074: posts big blind $0.10
*** HOLE CARDS ***
Wangritter13: folds 
KiraLasVegas: raises $0.15 to $0.25
mike301220 joins the table at seat #5 
EasySteavy: folds 
BluffMeThrice: calls $0.20
ALL-IN0074: folds 
*** FLOP *** [5c Kd Qs]
BluffMeThrice: checks 
KiraLasVegas: bets $0.20
BluffMeThrice: folds 
Uncalled bet ($0.20) returned to KiraLasVegas
KiraLasVegas collected $0.57 from pot
KiraLasVegas: doesn't show hand 
*** SUMMARY ***
Total pot $0.60 | Rake $0.03 
Board [5c Kd Qs]
Seat 1: EasySteavy (button) folded before Flop (didn't bet)
Seat 2: BluffMeThrice (small blind) folded on the Flop
Seat 3: ALL-IN0074 (big blind) folded before Flop
Seat 4: Wangritter13 folded before Flop (didn't bet)
Seat 6: KiraLasVegas collected ($0.57)



PokerStars Hand #222979049385:  Hold'em No Limit ($0.05/$0.10 USD) - 2021/01/23 19:04:31 ET
Table 'Merope IV' 6-max Seat #2 is the button
Seat 1: EasySteavy ($8.67 in chips) 
Seat 2: BluffMeThrice ($14.81 in chips) 
Seat 3: ALL-IN0074 ($12.47 in chips) 
Seat 4: Wangritter13 ($9.90 in chips) 
Seat 6: KiraLasVegas ($11.25 in chips) 
ALL-IN0074: posts small blind $0.05
Wangritter13: posts big blind $0.10
mike301220: sits out 
*** HOLE CARDS ***
KiraLasVegas: folds 
EasySteavy: folds 
BluffMeThrice: folds 
ALL-IN0074: raises $0.20 to $0.30
Wangritter13: folds 
Uncalled bet ($0.20) returned to ALL-IN0074
ALL-IN0074 collected $0.20 from pot
ALL-IN0074: doesn't show hand 
*** SUMMARY ***
Total pot $0.20 | Rake $0 
Seat 1: EasySteavy folded before Flop (didn't bet)
Seat 2: BluffMeThrice (button) folded before Flop (didn't bet)
Seat 3: ALL-IN0074 (small blind) collected ($0.20)
Seat 4: Wangritter13 (big blind) folded before Flop
Seat 6: KiraLasVegas folded before Flop (didn't bet)



PokerStars Hand #222979058536:  Hold'em No Limit ($0.05/$0.10 USD) - 2021/01/23 19:04:47 ET
Table 'Merope IV' 6-max Seat #3 is the button
Seat 1: EasySteavy ($8.67 in chips) 
Seat 2: BluffMeThrice ($14.81 in chips) 
Seat 3: ALL-IN0074 ($12.57 in chips) 
Seat 4: Wangritter13 ($9.80 in chips) 
Seat 5: mike301220 ($4 in chips) 
Seat 6: KiraLasVegas ($11.25 in chips) 
Wangritter13: posts small blind $0.05
mike301220: posts big blind $0.10
*** HOLE CARDS ***
KiraLasVegas: folds 
EasySteavy: folds 
BluffMeThrice: raises $0.20 to $0.30
ALL-IN0074: folds 
Wangritter13: folds 
mike301220: folds 
Uncalled bet ($0.20) returned to BluffMeThrice
BluffMeThrice collected $0.25 from pot
BluffMeThrice: doesn't show hand 
*** SUMMARY ***
Total pot $0.25 | Rake $0 
Seat 1: EasySteavy folded before Flop (didn't bet)
Seat 2: BluffMeThrice collected ($0.25)
Seat 3: ALL-IN0074 (button) folded before Flop (didn't bet)
Seat 4: Wangritter13 (small blind) folded before Flop
Seat 5: mike301220 (big blind) folded before Flop
Seat 6: KiraLasVegas folded before Flop (didn't bet)



PokerStars Hand #222979082083:  Hold'em No Limit ($0.05/$0.10 USD) - 2021/01/23 19:05:14 ET
Table 'Merope IV' 6-max Seat #4 is the button
Seat 1: EasySteavy ($8.67 in chips) 
Seat 2: BluffMeThrice ($14.96 in chips) 
Seat 3: ALL-IN0074 ($12.57 in chips) 
Seat 4: Wangritter13 ($9.75 in chips) 
Seat 5: mike301220 ($3.90 in chips) 
Seat 6: KiraLasVegas ($11.25 in chips) 
mike301220: posts small blind $0.05
KiraLasVegas: posts big blind $0.10
*** HOLE CARDS ***
EasySteavy: folds 
BluffMeThrice: raises $0.20 to $0.30
ALL-IN0074: folds 
Wangritter13: calls $0.30
mike301220: raises $1 to $1.30
KiraLasVegas: folds 
BluffMeThrice: folds 
Wangritter13: raises $8.45 to $9.75 and is all-in
mike301220: folds 
Uncalled bet ($8.45) returned to Wangritter13
Wangritter13 collected $3 from pot
Wangritter13: doesn't show hand 
*** SUMMARY ***
Total pot $3 | Rake $0 
Seat 1: EasySteavy folded before Flop (didn't bet)
Seat 2: BluffMeThrice folded before Flop
Seat 3: ALL-IN0074 folded before Flop (didn't bet)
Seat 4: Wangritter13 (button) collected ($3)
Seat 5: mike301220 (small blind) folded before Flop
Seat 6: KiraLasVegas (big blind) folded before Flop



PokerStars Hand #222979102982:  Hold'em No Limit ($0.05/$0.10 USD) - 2021/01/23 19:05:50 ET
Table 'Merope IV' 6-max Seat #5 is the button
Seat 1: EasySteavy ($8.67 in chips) 
Seat 2: BluffMeThrice ($14.66 in chips) 
Seat 3: ALL-IN0074 ($12.57 in chips) 
Seat 4: Wangritter13 ($11.45 in chips) 
Seat 5: mike301220 ($2.60 in chips) 
Seat 6: KiraLasVegas ($11.15 in chips) 
KiraLasVegas: posts small blind $0.05
EasySteavy: posts big blind $0.10
*** HOLE CARDS ***
BluffMeThrice: folds 
ALL-IN0074: folds 
Wangritter13: folds 
mike301220: folds 
KiraLasVegas: folds 
Uncalled bet ($0.05) returned to EasySteavy
EasySteavy collected $0.10 from pot
EasySteavy: doesn't show hand 
*** SUMMARY ***
Total pot $0.10 | Rake $0 
Seat 1: EasySteavy (big blind) collected ($0.10)
Seat 2: BluffMeThrice folded before Flop (didn't bet)
Seat 3: ALL-IN0074 folded before Flop (didn't bet)
Seat 4: Wangritter13 folded before Flop (didn't bet)
Seat 5: mike301220 (button) folded before Flop (didn't bet)
Seat 6: KiraLasVegas (small blind) folded before Flop



PokerStars Hand #222979115731:  Hold'em No Limit ($0.05/$0.10 USD) - 2021/01/23 19:06:13 ET
Table 'Merope IV' 6-max Seat #6 is the button
Seat 1: EasySteavy ($8.72 in chips) 
Seat 2: BluffMeThrice ($14.66 in chips) 
Seat 3: ALL-IN0074 ($12.57 in chips) 
Seat 4: Wangritter13 ($11.45 in chips) 
Seat 5: mike301220 ($2.60 in chips) 
Seat 6: KiraLasVegas ($11.10 in chips) 
EasySteavy: posts small blind $0.05
BluffMeThrice: posts big blind $0.10
*** HOLE CARDS ***
ALL-IN0074: folds 
Wangritter13: raises $0.20 to $0.30
mike301220: calls $0.30
KiraLasVegas: raises $1.20 to $1.50
EasySteavy: folds 
BluffMeThrice: folds 
Wangritter13: folds 
mike301220: calls $1.20
*** FLOP *** [3d 7d 4d]
mike301220: bets $1.10 and is all-in
KiraLasVegas: calls $1.10
*** TURN *** [3d 7d 4d] [8d]
*** RIVER *** [3d 7d 4d 8d] [2h]
*** SHOW DOWN ***
mike301220: shows [2c Ah] (a pair of Deuces)
KiraLasVegas: shows [Kh As] (high card Ace)
mike301220 collected $5.40 from pot
*** SUMMARY ***
Total pot $5.65 | Rake $0.25 
Board [3d 7d 4d 8d 2h]
Seat 1: EasySteavy (small blind) folded before Flop
Seat 2: BluffMeThrice (big blind) folded before Flop
Seat 3: ALL-IN0074 folded before Flop (didn't bet)
Seat 4: Wangritter13 folded before Flop
Seat 5: mike301220 showed [2c Ah] and won ($5.40) with a pair of Deuces
Seat 6: KiraLasVegas (button) showed [Kh As] and lost with high card Ace



PokerStars Hand #222979146973:  Hold'em No Limit ($0.05/$0.10 USD) - 2021/01/23 19:07:06 ET
Table 'Merope IV' 6-max Seat #1 is the button
Seat 1: EasySteavy ($8.67 in chips) 
Seat 2: BluffMeThrice ($14.56 in chips) 
Seat 3: ALL-IN0074 ($12.57 in chips) 
Seat 4: Wangritter13 ($11.15 in chips) 
Seat 5: mike301220 ($5.40 in chips) 
Seat 6: KiraLasVegas ($10 in chips) 
BluffMeThrice: posts small blind $0.05
ALL-IN0074: posts big blind $0.10
*** HOLE CARDS ***
Wangritter13: folds 
mike301220: raises $0.25 to $0.35
KiraLasVegas: folds 
EasySteavy: raises $0.85 to $1.20
BluffMeThrice: folds 
ALL-IN0074: folds 
mike301220: folds 
Uncalled bet ($0.85) returned to EasySteavy
EasySteavy collected $0.85 from pot
EasySteavy: doesn't show hand 
*** SUMMARY ***
Total pot $0.85 | Rake $0 
Seat 1: EasySteavy (button) collected ($0.85)
Seat 2: BluffMeThrice (small blind) folded before Flop
Seat 3: ALL-IN0074 (big blind) folded before Flop
Seat 4: Wangritter13 folded before Flop (didn't bet)
Seat 5: mike301220 folded before Flop
Seat 6: KiraLasVegas folded before Flop (didn't bet)



PokerStars Hand #222979175928:  Hold'em No Limit ($0.05/$0.10 USD) - 2021/01/23 19:07:41 ET
Table 'Merope IV' 6-max Seat #2 is the button
Seat 1: EasySteavy ($9.17 in chips) 
Seat 2: BluffMeThrice ($14.51 in chips) 
Seat 3: ALL-IN0074 ($12.47 in chips) 
Seat 4: Wangritter13 ($11.15 in chips) 
Seat 5: mike301220 ($5.05 in chips) 
Seat 6: KiraLasVegas ($10 in chips) 
ALL-IN0074: posts small blind $0.05
Wangritter13: posts big blind $0.10
*** HOLE CARDS ***
mike301220: folds 
KiraLasVegas: folds 
EasySteavy: raises $0.20 to $0.30
BluffMeThrice: raises $0.40 to $0.70
ALL-IN0074: folds 
Wangritter13: calls $0.60
EasySteavy: calls $0.40
*** FLOP *** [8d 4s 5h]
Wangritter13: checks 
EasySteavy: checks 
BluffMeThrice: checks 
*** TURN *** [8d 4s 5h] [Qd]
Wangritter13: bets $0.92
EasySteavy: folds 
mike301220 leaves the table
BluffMeThrice: raises $1.52 to $2.44
Wangritter13: folds 
Uncalled bet ($1.52) returned to BluffMeThrice
BluffMeThrice collected $3.81 from pot
BluffMeThrice: doesn't show hand 
*** SUMMARY ***
Total pot $3.99 | Rake $0.18 
Board [8d 4s 5h Qd]
Seat 1: EasySteavy folded on the Turn
Seat 2: BluffMeThrice (button) collected ($3.81)
Seat 3: ALL-IN0074 (small blind) folded before Flop
Seat 4: Wangritter13 (big blind) folded on the Turn
Seat 5: mike301220 folded before Flop (didn't bet)
Seat 6: KiraLasVegas folded before Flop (didn't bet)



PokerStars Hand #222979208575:  Hold'em No Limit ($0.05/$0.10 USD) - 2021/01/23 19:08:39 ET
Table 'Merope IV' 6-max Seat #3 is the button
Seat 1: EasySteavy ($8.47 in chips) 
Seat 2: BluffMeThrice ($16.70 in chips) 
Seat 3: ALL-IN0074 ($12.42 in chips) 
Seat 4: Wangritter13 ($9.53 in chips) 
Wangritter13: posts small blind $0.05
KiraLasVegas: is sitting out 
EasySteavy: posts big blind $0.10
*** HOLE CARDS ***
BluffMeThrice: raises $0.20 to $0.30
ALL-IN0074: folds 
Wangritter13: calls $0.25
EasySteavy: folds 
*** FLOP *** [Ts 8c Jc]
Wangritter13: checks 
BluffMeThrice: checks 
*** TURN *** [Ts 8c Jc] [Jh]
Wangritter13: bets $0.33
BluffMeThrice: raises $0.67 to $1
Wangritter13: calls $0.67
*** RIVER *** [Ts 8c Jc Jh] [Ac]
KiraLasVegas leaves the table
Wangritter13: checks 
BluffMeThrice: checks 
*** SHOW DOWN ***
Wangritter13: shows [Qs 8s] (two pair, Jacks and Eights)
BluffMeThrice: mucks hand 
Wangritter13 collected $2.58 from pot
*** SUMMARY ***
Total pot $2.70 | Rake $0.12 
Board [Ts 8c Jc Jh Ac]
Seat 1: EasySteavy (big blind) folded before Flop
Seat 2: BluffMeThrice mucked
Seat 3: ALL-IN0074 (button) folded before Flop (didn't bet)
Seat 4: Wangritter13 (small blind) showed [Qs 8s] and won ($2.58) with two pair, Jacks and Eights



PokerStars Hand #222979228300:  Hold'em No Limit ($0.05/$0.10 USD) - 2021/01/23 19:09:14 ET
Table 'Merope IV' 6-max Seat #4 is the button
Seat 1: EasySteavy ($8.37 in chips) 
Seat 2: BluffMeThrice ($15.40 in chips) 
Seat 3: ALL-IN0074 ($12.42 in chips) 
Seat 4: Wangritter13 ($10.81 in chips) 
EasySteavy: posts small blind $0.05
BluffMeThrice: posts big blind $0.10
*** HOLE CARDS ***
ALL-IN0074: folds 
Wangritter13: folds 
EasySteavy: folds 
Uncalled bet ($0.05) returned to BluffMeThrice
BluffMeThrice collected $0.10 from pot
BluffMeThrice: doesn't show hand 
*** SUMMARY ***
Total pot $0.10 | Rake $0 
Seat 1: EasySteavy (small blind) folded before Flop
Seat 2: BluffMeThrice (big blind) collected ($0.10)
Seat 3: ALL-IN0074 folded before Flop (didn't bet)
Seat 4: Wangritter13 (button) folded before Flop (didn't bet)



PokerStars Hand #222979237211:  Hold'em No Limit ($0.05/$0.10 USD) - 2021/01/23 19:09:30 ET
Table 'Merope IV' 6-max Seat #1 is the button
Seat 1: EasySteavy ($8.32 in chips) 
Seat 2: BluffMeThrice ($15.45 in chips) 
Seat 3: ALL-IN0074 ($12.42 in chips) 
Seat 4: Wangritter13 ($10.81 in chips) 
BluffMeThrice: posts small blind $0.05
ALL-IN0074: posts big blind $0.10
*** HOLE CARDS ***
Wangritter13: calls $0.10
EasySteavy: raises $0.45 to $0.55
BluffMeThrice: raises $1 to $1.55
ALL-IN0074: folds 
Wangritter13: folds 
EasySteavy: calls $1
*** FLOP *** [3h Jh 2d]
BluffMeThrice: checks 
EasySteavy: bets $1.57
BluffMeThrice: raises $12.33 to $13.90 and is all-in
EasySteavy: calls $5.20 and is all-in
Uncalled bet ($7.13) returned to BluffMeThrice
*** TURN *** [3h Jh 2d] [5c]
*** RIVER *** [3h Jh 2d 5c] [2c]
*** SHOW DOWN ***
BluffMeThrice: shows [Kc Kd] (two pair, Kings and Deuces)
EasySteavy: shows [Ah Qs] (a pair of Deuces)
BluffMeThrice collected $16.08 from pot
*** SUMMARY ***
Total pot $16.84 | Rake $0.76 
Board [3h Jh 2d 5c 2c]
Seat 1: EasySteavy (button) showed [Ah Qs] and lost with a pair of Deuces
Seat 2: BluffMeThrice (small blind) showed [Kc Kd] and won ($16.08) with two pair, Kings and Deuces
Seat 3: ALL-IN0074 (big blind) folded before Flop
Seat 4: Wangritter13 folded before Flop



PokerStars Hand #222979265723:  Hold'em No Limit ($0.05/$0.10 USD) - 2021/01/23 19:10:20 ET
Table 'Merope IV' 6-max Seat #2 is the button
Seat 2: BluffMeThrice ($23.21 in chips) 
Seat 3: ALL-IN0074 ($12.32 in chips) 
Seat 4: Wangritter13 ($10.71 in chips) 
ALL-IN0074: posts small blind $0.05
Wangritter13: posts big blind $0.10
*** HOLE CARDS ***
BluffMeThrice: raises $0.20 to $0.30
ALL-IN0074: folds 
Wangritter13: folds 
Uncalled bet ($0.20) returned to BluffMeThrice
BluffMeThrice collected $0.25 from pot
BluffMeThrice: doesn't show hand 
*** SUMMARY ***
Total pot $0.25 | Rake $0 
Seat 2: BluffMeThrice (button) collected ($0.25)
Seat 3: ALL-IN0074 (small blind) folded before Flop
Seat 4: Wangritter13 (big blind) folded before Flop



PokerStars Hand #222979271659:  Hold'em No Limit ($0.05/$0.10 USD) - 2021/01/23 19:10:31 ET
Table 'Merope IV' 6-max Seat #3 is the button
Seat 1: EasySteavy ($10 in chips) 
Seat 2: BluffMeThrice ($23.36 in chips) 
Seat 3: ALL-IN0074 ($12.27 in chips) 
Seat 4: Wangritter13 ($10.61 in chips) 
Wangritter13: posts small blind $0.05
EasySteavy: posts big blind $0.10
*** HOLE CARDS ***
BluffMeThrice: folds 
ALL-IN0074: raises $0.15 to $0.25
chris.nomf joins the table at seat #6 
Wangritter13: calls $0.20
Black021 joins the table at seat #5 
EasySteavy: calls $0.15
*** FLOP *** [9s 4s Td]
Wangritter13: checks 
EasySteavy is disconnected 
EasySteavy is connected 
EasySteavy has timed out
EasySteavy: checks 
ALL-IN0074: checks 
*** TURN *** [9s 4s Td] [7d]
Wangritter13: checks 
EasySteavy: bets $0.46
ALL-IN0074: folds 
Wangritter13: folds 
Uncalled bet ($0.46) returned to EasySteavy
EasySteavy collected $0.72 from pot
EasySteavy: doesn't show hand 
*** SUMMARY ***
Total pot $0.75 | Rake $0.03 
Board [9s 4s Td 7d]
Seat 1: EasySteavy (big blind) collected ($0.72)
Seat 2: BluffMeThrice folded before Flop (didn't bet)
Seat 3: ALL-IN0074 (button) folded on the Turn
Seat 4: Wangritter13 (small blind) folded on the Turn



PokerStars Hand #222979314807:  Hold'em No Limit ($0.05/$0.10 USD) - 2021/01/23 19:11:48 ET
Table 'Merope IV' 6-max Seat #4 is the button
Seat 1: EasySteavy ($10.47 in chips) 
Seat 2: BluffMeThrice ($23.36 in chips) 
Seat 3: ALL-IN0074 ($12.02 in chips) 
Seat 4: Wangritter13 ($10.36 in chips) 
EasySteavy: posts small blind $0.05
BluffMeThrice: posts big blind $0.10
*** HOLE CARDS ***
ALL-IN0074: folds 
Wangritter13: folds 
EasySteavy: folds 
Uncalled bet ($0.05) returned to BluffMeThrice
BluffMeThrice collected $0.10 from pot
BluffMeThrice: doesn't show hand 
Black021 leaves the table
*** SUMMARY ***
Total pot $0.10 | Rake $0 
Seat 1: EasySteavy (small blind) folded before Flop
Seat 2: BluffMeThrice (big blind) collected ($0.10)
Seat 3: ALL-IN0074 folded before Flop (didn't bet)
Seat 4: Wangritter13 (button) folded before Flop (didn't bet)



PokerStars Hand #222979322051:  Hold'em No Limit ($0.05/$0.10 USD) - 2021/01/23 19:12:00 ET
Table 'Merope IV' 6-max Seat #1 is the button
Seat 1: EasySteavy ($10.42 in chips) 
Seat 2: BluffMeThrice ($23.41 in chips) 
Seat 3: ALL-IN0074 ($12.02 in chips) 
Seat 4: Wangritter13 ($10.36 in chips) 
BluffMeThrice: posts small blind $0.05
ALL-IN0074: posts big blind $0.10
chris.nomf: sits out 
*** HOLE CARDS ***
Wangritter13: folds 
EasySteavy: raises $0.20 to $0.30
BluffMeThrice: folds 
ALL-IN0074: folds 
Uncalled bet ($0.20) returned to EasySteavy
EasySteavy collected $0.25 from pot
EasySteavy: doesn't show hand 
*** SUMMARY ***
Total pot $0.25 | Rake $0 
Seat 1: EasySteavy (button) collected ($0.25)
Seat 2: BluffMeThrice (small blind) folded before Flop
Seat 3: ALL-IN0074 (big blind) folded before Flop
Seat 4: Wangritter13 folded before Flop (didn't bet)



PokerStars Hand #222979329524:  Hold'em No Limit ($0.05/$0.10 USD) - 2021/01/23 19:12:14 ET
Table 'Merope IV' 6-max Seat #2 is the button
Seat 1: EasySteavy ($10.57 in chips) 
Seat 2: BluffMeThrice ($23.36 in chips) 
Seat 3: ALL-IN0074 ($11.92 in chips) 
Seat 4: Wangritter13 ($10.36 in chips) 
ALL-IN0074: posts small blind $0.05
Wangritter13: posts big blind $0.10
chris.nomf: sits out 
*** HOLE CARDS ***
EasySteavy: folds 
BluffMeThrice: raises $0.10 to $0.20
ALL-IN0074: raises $0.70 to $0.90
Wangritter13: folds 
BluffMeThrice: folds 
Uncalled bet ($0.70) returned to ALL-IN0074
ALL-IN0074 collected $0.50 from pot
*** SUMMARY ***
Total pot $0.50 | Rake $0 
Seat 1: EasySteavy folded before Flop (didn't bet)
Seat 2: BluffMeThrice (button) folded before Flop
Seat 3: ALL-IN0074 (small blind) collected ($0.50)
Seat 4: Wangritter13 (big blind) folded before Flop



PokerStars Hand #222979345753:  Hold'em No Limit ($0.05/$0.10 USD) - 2021/01/23 19:12:43 ET
Table 'Merope IV' 6-max Seat #3 is the button
Seat 1: EasySteavy ($10.57 in chips) 
Seat 2: BluffMeThrice ($23.16 in chips) 
Seat 3: ALL-IN0074 ($12.22 in chips) 
Seat 4: Wangritter13 ($10.26 in chips) 
Seat 6: chris.nomf ($10 in chips) 
Wangritter13: posts small blind $0.05
chris.nomf: posts big blind $0.10
*** HOLE CARDS ***
Indangeriam joins the table at seat #5 
EasySteavy: folds 
BluffMeThrice: folds 
ALL-IN0074: folds 
Wangritter13: raises $0.10 to $0.20
chris.nomf: folds 
Uncalled bet ($0.10) returned to Wangritter13
Wangritter13 collected $0.20 from pot
Wangritter13: doesn't show hand 
*** SUMMARY ***
Total pot $0.20 | Rake $0 
Seat 1: EasySteavy folded before Flop (didn't bet)
Seat 2: BluffMeThrice folded before Flop (didn't bet)
Seat 3: ALL-IN0074 (button) folded before Flop (didn't bet)
Seat 4: Wangritter13 (small blind) collected ($0.20)
Seat 6: chris.nomf (big blind) folded before Flop



PokerStars Hand #222979355798:  Hold'em No Limit ($0.05/$0.10 USD) - 2021/01/23 19:13:01 ET
Table 'Merope IV' 6-max Seat #4 is the button
Seat 1: EasySteavy ($10.57 in chips) 
Seat 2: BluffMeThrice ($23.16 in chips) 
Seat 3: ALL-IN0074 ($12.22 in chips) 
Seat 4: Wangritter13 ($10.36 in chips) 
Seat 6: chris.nomf ($9.90 in chips) 
chris.nomf: posts small blind $0.05
EasySteavy: posts big blind $0.10
*** HOLE CARDS ***
BluffMeThrice: raises $0.20 to $0.30
ALL-IN0074: folds 
Wangritter13: folds 
chris.nomf: folds 
EasySteavy: folds 
Uncalled bet ($0.20) returned to BluffMeThrice
BluffMeThrice collected $0.25 from pot
BluffMeThrice: doesn't show hand 
*** SUMMARY ***
Total pot $0.25 | Rake $0 
Seat 1: EasySteavy (big blind) folded before Flop
Seat 2: BluffMeThrice collected ($0.25)
Seat 3: ALL-IN0074 folded before Flop (didn't bet)
Seat 4: Wangritter13 (button) folded before Flop (didn't bet)
Seat 6: chris.nomf (small blind) folded before Flop



PokerStars Hand #222979367127:  Hold'em No Limit ($0.05/$0.10 USD) - 2021/01/23 19:13:22 ET
Table 'Merope IV' 6-max Seat #6 is the button
Seat 1: EasySteavy ($10.47 in chips) 
Seat 2: BluffMeThrice ($23.31 in chips) 
Seat 3: ALL-IN0074 ($12.22 in chips) 
Seat 4: Wangritter13 ($10.36 in chips) 
Seat 6: chris.nomf ($9.85 in chips) 
EasySteavy: posts small blind $0.05
BluffMeThrice: posts big blind $0.10
Indangeriam: sits out 
*** HOLE CARDS ***
ALL-IN0074: folds 
Wangritter13: raises $0.10 to $0.20
chris.nomf: calls $0.20
EasySteavy: folds 
BluffMeThrice: raises $0.30 to $0.50
Wangritter13: calls $0.30
chris.nomf: calls $0.30
*** FLOP *** [5c 6d Qd]
BluffMeThrice: bets $0.74
Wangritter13: calls $0.74
chris.nomf: folds 
*** TURN *** [5c 6d Qd] [8c]
BluffMeThrice: bets $2.89
Wangritter13: folds 
Uncalled bet ($2.89) returned to BluffMeThrice
BluffMeThrice collected $2.89 from pot
*** SUMMARY ***
Total pot $3.03 | Rake $0.14 
Board [5c 6d Qd 8c]
Seat 1: EasySteavy (small blind) folded before Flop
Seat 2: BluffMeThrice (big blind) collected ($2.89)
Seat 3: ALL-IN0074 folded before Flop (didn't bet)
Seat 4: Wangritter13 folded on the Turn
Seat 6: chris.nomf (button) folded on the Flop



PokerStars Hand #222979389818:  Hold'em No Limit ($0.05/$0.10 USD) - 2021/01/23 19:14:03 ET
Table 'Merope IV' 6-max Seat #1 is the button
Seat 1: EasySteavy ($10.42 in chips) 
Seat 3: ALL-IN0074 ($12.22 in chips) 
Seat 4: Wangritter13 ($9.12 in chips) 
Seat 6: chris.nomf ($10 in chips) 
BluffMeThrice has timed out
BluffMeThrice: is sitting out 
ALL-IN0074: posts small blind $0.05
Wangritter13: posts big blind $0.10
Indangeriam: sits out 
*** HOLE CARDS ***
BluffMeThrice is disconnected 
chris.nomf: raises $0.20 to $0.30
EasySteavy: calls $0.30
ALL-IN0074: folds 
Wangritter13: folds 
*** FLOP *** [2c 8c Kc]
chris.nomf: bets $0.40
EasySteavy: folds 
Uncalled bet ($0.40) returned to chris.nomf
chris.nomf collected $0.72 from pot
*** SUMMARY ***
Total pot $0.75 | Rake $0.03 
Board [2c 8c Kc]
Seat 1: EasySteavy (button) folded on the Flop
Seat 3: ALL-IN0074 (small blind) folded before Flop
Seat 4: Wangritter13 (big blind) folded before Flop
Seat 6: chris.nomf collected ($0.72)



PokerStars Hand #222979409188:  Hold'em No Limit ($0.05/$0.10 USD) - 2021/01/23 19:14:38 ET
Table 'Merope IV' 6-max Seat #3 is the button
Seat 1: EasySteavy ($10.12 in chips) 
Seat 3: ALL-IN0074 ($12.17 in chips) 
Seat 4: Wangritter13 ($9.02 in chips) 
Seat 5: Indangeriam ($10 in chips) 
Seat 6: chris.nomf ($10.42 in chips) 
Wangritter13: posts small blind $0.05
Indangeriam: posts big blind $0.10
BluffMeThrice: sits out 
*** HOLE CARDS ***
chris.nomf: folds 
EasySteavy: folds 
ALL-IN0074: raises $0.15 to $0.25
Wangritter13: folds 
Indangeriam: folds 
Uncalled bet ($0.15) returned to ALL-IN0074
ALL-IN0074 collected $0.25 from pot
ALL-IN0074: doesn't show hand 
*** SUMMARY ***
Total pot $0.25 | Rake $0 
Seat 1: EasySteavy folded before Flop (didn't bet)
Seat 3: ALL-IN0074 (button) collected ($0.25)
Seat 4: Wangritter13 (small blind) folded before Flop
Seat 5: Indangeriam (big blind) folded before Flop
Seat 6: chris.nomf folded before Flop (didn't bet)



PokerStars Hand #222979417240:  Hold'em No Limit ($0.05/$0.10 USD) - 2021/01/23 19:14:53 ET
Table 'Merope IV' 6-max Seat #4 is the button
Seat 1: EasySteavy ($10.12 in chips) 
Seat 2: BluffMeThrice ($24.96 in chips) 
Seat 3: ALL-IN0074 ($12.32 in chips) 
Seat 4: Wangritter13 ($8.97 in chips) 
Seat 5: Indangeriam ($10 in chips) 
Seat 6: chris.nomf ($10.42 in chips) 
Indangeriam: posts small blind $0.05
chris.nomf: posts big blind $0.10
BluffMeThrice: posts small blind $0.05
*** HOLE CARDS ***
EasySteavy: folds 
BluffMeThrice: folds 
ALL-IN0074: folds 
Wangritter13: folds 
Indangeriam: folds 
Uncalled bet ($0.05) returned to chris.nomf
chris.nomf collected $0.15 from pot
chris.nomf: doesn't show hand 
*** SUMMARY ***
Total pot $0.15 | Rake $0 
Seat 1: EasySteavy folded before Flop (didn't bet)
Seat 2: BluffMeThrice folded before Flop (didn't bet)
Seat 3: ALL-IN0074 folded before Flop (didn't bet)
Seat 4: Wangritter13 (button) folded before Flop (didn't bet)
Seat 5: Indangeriam (small blind) folded before Flop
Seat 6: chris.nomf (big blind) collected ($0.15)



PokerStars Hand #222979429590:  Hold'em No Limit ($0.05/$0.10 USD) - 2021/01/23 19:15:15 ET
Table 'Merope IV' 6-max Seat #5 is the button
Seat 1: EasySteavy ($10.12 in chips) 
Seat 2: BluffMeThrice ($24.91 in chips) 
Seat 3: ALL-IN0074 ($12.32 in chips) 
Seat 4: Wangritter13 ($8.97 in chips) 
Seat 5: Indangeriam ($10 in chips) 
Seat 6: chris.nomf ($10.52 in chips) 
chris.nomf: posts small blind $0.05
EasySteavy: posts big blind $0.10
*** HOLE CARDS ***
BluffMeThrice: raises $0.20 to $0.30
ALL-IN0074: folds 
Wangritter13: calls $0.30
Indangeriam: calls $0.30
chris.nomf: folds 
EasySteavy: calls $0.20
*** FLOP *** [Jd 3s Ks]
EasySteavy: checks 
BluffMeThrice: bets $0.39
Wangritter13: folds 
Indangeriam: folds 
EasySteavy: calls $0.39
*** TURN *** [Jd 3s Ks] [4c]
EasySteavy: checks 
BluffMeThrice: checks 
*** RIVER *** [Jd 3s Ks 4c] [7h]
EasySteavy: checks 
BluffMeThrice: checks 
*** SHOW DOWN ***
EasySteavy: shows [4s 5s] (a pair of Fours)
BluffMeThrice: mucks hand 
EasySteavy collected $1.94 from pot
*** SUMMARY ***
Total pot $2.03 | Rake $0.09 
Board [Jd 3s Ks 4c 7h]
Seat 1: EasySteavy (big blind) showed [4s 5s] and won ($1.94) with a pair of Fours
Seat 2: BluffMeThrice mucked
Seat 3: ALL-IN0074 folded before Flop (didn't bet)
Seat 4: Wangritter13 folded on the Flop
Seat 5: Indangeriam (button) folded on the Flop
Seat 6: chris.nomf (small blind) folded before Flop



PokerStars Hand #222979458863:  Hold'em No Limit ($0.05/$0.10 USD) - 2021/01/23 19:16:08 ET
Table 'Merope IV' 6-max Seat #6 is the button
Seat 1: EasySteavy ($11.37 in chips) 
Seat 2: BluffMeThrice ($24.22 in chips) 
Seat 3: ALL-IN0074 ($12.32 in chips) 
Seat 4: Wangritter13 ($8.67 in chips) 
Seat 5: Indangeriam ($10 in chips) 
Seat 6: chris.nomf ($10.47 in chips) 
EasySteavy: posts small blind $0.05
BluffMeThrice: posts big blind $0.10
*** HOLE CARDS ***
ALL-IN0074: folds 
Wangritter13: folds 
Indangeriam: folds 
chris.nomf: folds 
EasySteavy: folds 
Uncalled bet ($0.05) returned to BluffMeThrice
BluffMeThrice collected $0.10 from pot
BluffMeThrice: doesn't show hand 
*** SUMMARY ***
Total pot $0.10 | Rake $0 
Seat 1: EasySteavy (small blind) folded before Flop
Seat 2: BluffMeThrice (big blind) collected ($0.10)
Seat 3: ALL-IN0074 folded before Flop (didn't bet)
Seat 4: Wangritter13 folded before Flop (didn't bet)
Seat 5: Indangeriam folded before Flop (didn't bet)
Seat 6: chris.nomf (button) folded before Flop (didn't bet)



PokerStars Hand #222979466332:  Hold'em No Limit ($0.05/$0.10 USD) - 2021/01/23 19:16:22 ET
Table 'Merope IV' 6-max Seat #1 is the button
Seat 1: EasySteavy ($11.32 in chips) 
Seat 2: BluffMeThrice ($24.27 in chips) 
Seat 3: ALL-IN0074 ($12.32 in chips) 
Seat 4: Wangritter13 ($8.67 in chips) 
Seat 5: Indangeriam ($10 in chips) 
Seat 6: chris.nomf ($10.47 in chips) 
BluffMeThrice: posts small blind $0.05
ALL-IN0074: posts big blind $0.10
*** HOLE CARDS ***
Wangritter13: folds 
Indangeriam: folds 
chris.nomf: folds 
EasySteavy: folds 
BluffMeThrice: raises $0.20 to $0.30
ALL-IN0074: folds 
Uncalled bet ($0.20) returned to BluffMeThrice
BluffMeThrice collected $0.20 from pot
BluffMeThrice: doesn't show hand 
*** SUMMARY ***
Total pot $0.20 | Rake $0 
Seat 1: EasySteavy (button) folded before Flop (didn't bet)
Seat 2: BluffMeThrice (small blind) collected ($0.20)
Seat 3: ALL-IN0074 (big blind) folded before Flop
Seat 4: Wangritter13 folded before Flop (didn't bet)
Seat 5: Indangeriam folded before Flop (didn't bet)
Seat 6: chris.nomf folded before Flop (didn't bet)



PokerStars Hand #222979478738:  Hold'em No Limit ($0.05/$0.10 USD) - 2021/01/23 19:16:44 ET
Table 'Merope IV' 6-max Seat #2 is the button
Seat 1: EasySteavy ($11.32 in chips) 
Seat 2: BluffMeThrice ($24.37 in chips) 
Seat 3: ALL-IN0074 ($12.22 in chips) 
Seat 4: Wangritter13 ($8.67 in chips) 
Seat 5: Indangeriam ($10 in chips) 
Seat 6: chris.nomf ($10.47 in chips) 
ALL-IN0074: posts small blind $0.05
Wangritter13: posts big blind $0.10
*** HOLE CARDS ***
Indangeriam: folds 
chris.nomf: folds 
EasySteavy: raises $0.20 to $0.30
BluffMeThrice: folds 
ALL-IN0074: folds 
Wangritter13: folds 
Uncalled bet ($0.20) returned to EasySteavy
EasySteavy collected $0.25 from pot
EasySteavy: doesn't show hand 
*** SUMMARY ***
Total pot $0.25 | Rake $0 
Seat 1: EasySteavy collected ($0.25)
Seat 2: BluffMeThrice (button) folded before Flop (didn't bet)
Seat 3: ALL-IN0074 (small blind) folded before Flop
Seat 4: Wangritter13 (big blind) folded before Flop
Seat 5: Indangeriam folded before Flop (didn't bet)
Seat 6: chris.nomf folded before Flop (didn't bet)



PokerStars Hand #222979488037:  Hold'em No Limit ($0.05/$0.10 USD) - 2021/01/23 19:17:01 ET
Table 'Merope IV' 6-max Seat #3 is the button
Seat 1: EasySteavy ($11.47 in chips) 
Seat 2: BluffMeThrice ($24.37 in chips) 
Seat 3: ALL-IN0074 ($12.17 in chips) 
Seat 4: Wangritter13 ($8.57 in chips) 
Seat 5: Indangeriam ($10 in chips) 
Seat 6: chris.nomf ($10.47 in chips) 
Wangritter13: posts small blind $0.05
Indangeriam: posts big blind $0.10
*** HOLE CARDS ***
chris.nomf: folds 
EasySteavy: folds 
BluffMeThrice: folds 
BluffMeThrice leaves the table
ALL-IN0074: raises $0.15 to $0.25
Wangritter13: calls $0.20
Indangeriam: folds 
*** FLOP *** [8c 4d 8s]
Wangritter13: checks 
ALL-IN0074: bets $0.30
Wangritter13: folds 
Uncalled bet ($0.30) returned to ALL-IN0074
ALL-IN0074 collected $0.57 from pot
ALL-IN0074: doesn't show hand 
*** SUMMARY ***
Total pot $0.60 | Rake $0.03 
Board [8c 4d 8s]
Seat 1: EasySteavy folded before Flop (didn't bet)
Seat 2: BluffMeThrice folded before Flop (didn't bet)
Seat 3: ALL-IN0074 (button) collected ($0.57)
Seat 4: Wangritter13 (small blind) folded on the Flop
Seat 5: Indangeriam (big blind) folded before Flop
Seat 6: chris.nomf folded before Flop (didn't bet)



PokerStars Hand #222979501326:  Hold'em No Limit ($0.05/$0.10 USD) - 2021/01/23 19:17:26 ET
Table 'Merope IV' 6-max Seat #4 is the button
Seat 1: EasySteavy ($11.47 in chips) 
Seat 3: ALL-IN0074 ($12.49 in chips) 
Seat 4: Wangritter13 ($8.32 in chips) 
Seat 5: Indangeriam ($10 in chips) 
Seat 6: chris.nomf ($10.47 in chips) 
Indangeriam: posts small blind $0.05
chris.nomf: posts big blind $0.10
*** HOLE CARDS ***
EasySteavy: folds 
ALL-IN0074: folds 
Wangritter13: folds 
Indangeriam: raises $0.20 to $0.30
chris.nomf: folds 
Uncalled bet ($0.20) returned to Indangeriam
Indangeriam collected $0.20 from pot
Indangeriam: doesn't show hand 
*** SUMMARY ***
Total pot $0.20 | Rake $0 
Seat 1: EasySteavy folded before Flop (didn't bet)
Seat 3: ALL-IN0074 folded before Flop (didn't bet)
Seat 4: Wangritter13 (button) folded before Flop (didn't bet)
Seat 5: Indangeriam (small blind) collected ($0.20)
Seat 6: chris.nomf (big blind) folded before Flop



PokerStars Hand #222979509543:  Hold'em No Limit ($0.05/$0.10 USD) - 2021/01/23 19:17:41 ET
Table 'Merope IV' 6-max Seat #5 is the button
Seat 1: EasySteavy ($11.47 in chips) 
Seat 3: ALL-IN0074 ($12.49 in chips) 
Seat 4: Wangritter13 ($8.32 in chips) 
Seat 5: Indangeriam ($10.10 in chips) 
Seat 6: chris.nomf ($10.37 in chips) 
chris.nomf: posts small blind $0.05
EasySteavy: posts big blind $0.10
*** HOLE CARDS ***
ALL-IN0074: folds 
Wangritter13: raises $0.25 to $0.35
Indangeriam: folds 
chris.nomf: folds 
EasySteavy: folds 
Uncalled bet ($0.25) returned to Wangritter13
Wangritter13 collected $0.25 from pot
Wangritter13: doesn't show hand 
*** SUMMARY ***
Total pot $0.25 | Rake $0 
Seat 1: EasySteavy (big blind) folded before Flop
Seat 3: ALL-IN0074 folded before Flop (didn't bet)
Seat 4: Wangritter13 collected ($0.25)
Seat 5: Indangeriam (button) folded before Flop (didn't bet)
Seat 6: chris.nomf (small blind) folded before Flop



PokerStars Hand #222979517841:  Hold'em No Limit ($0.05/$0.10 USD) - 2021/01/23 19:17:56 ET
Table 'Merope IV' 6-max Seat #6 is the button
Seat 1: EasySteavy ($11.37 in chips) 
Seat 3: ALL-IN0074 ($12.49 in chips) 
Seat 4: Wangritter13 ($8.47 in chips) 
Seat 5: Indangeriam ($10.10 in chips) 
Seat 6: chris.nomf ($10.32 in chips) 
EasySteavy: posts small blind $0.05
ALL-IN0074: posts big blind $0.10
*** HOLE CARDS ***
Wangritter13: calls $0.10
Indangeriam: folds 
chris.nomf: folds 
EasySteavy: folds 
ALL-IN0074: checks 
*** FLOP *** [7h Kh Qc]
ALL-IN0074: checks 
Wangritter13: bets $0.22
ALL-IN0074: folds 
Uncalled bet ($0.22) returned to Wangritter13
Wangritter13 collected $0.24 from pot
Wangritter13: doesn't show hand 
*** SUMMARY ***
Total pot $0.25 | Rake $0.01 
Board [7h Kh Qc]
Seat 1: EasySteavy (small blind) folded before Flop
Seat 3: ALL-IN0074 (big blind) folded on the Flop
Seat 4: Wangritter13 collected ($0.24)
Seat 5: Indangeriam folded before Flop (didn't bet)
Seat 6: chris.nomf (button) folded before Flop (didn't bet)



PokerStars Hand #222979907384:  Hold'em No Limit ($0.05/$0.10 USD) - 2021/01/23 19:30:06 ET
Table 'Merope IV' 6-max Seat #4 is the button
Seat 2: Chrysk2 ($9.60 in chips) 
Seat 3: ALL-IN0074 ($11.74 in chips) 
Seat 4: Wangritter13 ($11.52 in chips) 
Seat 5: Indangeriam ($10 in chips) 
Seat 6: chris.nomf ($10.57 in chips) 
Indangeriam: posts small blind $0.05
chris.nomf: posts big blind $0.10
KiraLasVegas: sits out 
*** HOLE CARDS ***
Chrysk2: folds 
ALL-IN0074: folds 
Wangritter13: raises $0.10 to $0.20
Indangeriam: folds 
chris.nomf: calls $0.10
*** FLOP *** [5s 6d 8c]
chris.nomf: checks 
Wangritter13: bets $0.21
chris.nomf: calls $0.21
*** TURN *** [5s 6d 8c] [7s]
chris.nomf: checks 
Wangritter13: checks 
*** RIVER *** [5s 6d 8c 7s] [7d]
chris.nomf: bets $0.60
Wangritter13: calls $0.60
*** SHOW DOWN ***
chris.nomf: shows [Ac 5h] (two pair, Sevens and Fives)
Wangritter13: shows [4s 4c] (a straight, Four to Eight)
Wangritter13 collected $1.98 from pot
*** SUMMARY ***
Total pot $2.07 | Rake $0.09 
Board [5s 6d 8c 7s 7d]
Seat 2: Chrysk2 folded before Flop (didn't bet)
Seat 3: ALL-IN0074 folded before Flop (didn't bet)
Seat 4: Wangritter13 (button) showed [4s 4c] and won ($1.98) with a straight, Four to Eight
Seat 5: Indangeriam (small blind) folded before Flop
Seat 6: chris.nomf (big blind) showed [Ac 5h] and lost with two pair, Sevens and Fives



PokerStars Hand #222979929342:  Hold'em No Limit ($0.05/$0.10 USD) - 2021/01/23 19:30:48 ET
Table 'Merope IV' 6-max Seat #5 is the button
Seat 1: KiraLasVegas ($10 in chips) 
Seat 2: Chrysk2 ($10 in chips) 
Seat 3: ALL-IN0074 ($11.74 in chips) 
Seat 4: Wangritter13 ($12.49 in chips) 
Seat 5: Indangeriam ($10 in chips) 
Seat 6: chris.nomf ($9.56 in chips) 
chris.nomf: posts small blind $0.05
KiraLasVegas: posts big blind $0.10
*** HOLE CARDS ***
Chrysk2: folds 
ALL-IN0074: folds 
Wangritter13: calls $0.10
Indangeriam: folds 
chris.nomf: folds 
KiraLasVegas: checks 
*** FLOP *** [4s 8s 4c]
KiraLasVegas: checks 
Wangritter13: checks 
*** TURN *** [4s 8s 4c] [9d]
KiraLasVegas: bets $0.10
Wangritter13: calls $0.10
*** RIVER *** [4s 8s 4c 9d] [2c]
KiraLasVegas: bets $0.10
Wangritter13: folds 
Uncalled bet ($0.10) returned to KiraLasVegas
KiraLasVegas collected $0.43 from pot
KiraLasVegas: doesn't show hand 
*** SUMMARY ***
Total pot $0.45 | Rake $0.02 
Board [4s 8s 4c 9d 2c]
Seat 1: KiraLasVegas (big blind) collected ($0.43)
Seat 2: Chrysk2 folded before Flop (didn't bet)
Seat 3: ALL-IN0074 folded before Flop (didn't bet)
Seat 4: Wangritter13 folded on the River
Seat 5: Indangeriam (button) folded before Flop (didn't bet)
Seat 6: chris.nomf (small blind) folded before Flop



PokerStars Hand #222979952399:  Hold'em No Limit ($0.05/$0.10 USD) - 2021/01/23 19:31:33 ET
Table 'Merope IV' 6-max Seat #6 is the button
Seat 1: KiraLasVegas ($10.23 in chips) 
Seat 2: Chrysk2 ($10 in chips) 
Seat 3: ALL-IN0074 ($11.74 in chips) 
Seat 4: Wangritter13 ($12.29 in chips) 
Seat 5: Indangeriam ($10 in chips) 
Seat 6: chris.nomf ($10 in chips) 
KiraLasVegas: posts small blind $0.05
Chrysk2: posts big blind $0.10
*** HOLE CARDS ***
ALL-IN0074: folds 
Wangritter13: raises $0.20 to $0.30
Indangeriam: folds 
chris.nomf: folds 
KiraLasVegas: folds 
Chrysk2: folds 
Uncalled bet ($0.20) returned to Wangritter13
Wangritter13 collected $0.25 from pot
Wangritter13: doesn't show hand 
*** SUMMARY ***
Total pot $0.25 | Rake $0 
Seat 1: KiraLasVegas (small blind) folded before Flop
Seat 2: Chrysk2 (big blind) folded before Flop
Seat 3: ALL-IN0074 folded before Flop (didn't bet)
Seat 4: Wangritter13 collected ($0.25)
Seat 5: Indangeriam folded before Flop (didn't bet)
Seat 6: chris.nomf (button) folded before Flop (didn't bet)



PokerStars Hand #222979964371:  Hold'em No Limit ($0.05/$0.10 USD) - 2021/01/23 19:31:56 ET
Table 'Merope IV' 6-max Seat #1 is the button
Seat 1: KiraLasVegas ($10.18 in chips) 
Seat 2: Chrysk2 ($9.90 in chips) 
Seat 3: ALL-IN0074 ($11.74 in chips) 
Seat 4: Wangritter13 ($12.44 in chips) 
Seat 5: Indangeriam ($10 in chips) 
Seat 6: chris.nomf ($10 in chips) 
Chrysk2: posts small blind $0.05
ALL-IN0074: posts big blind $0.10
*** HOLE CARDS ***
Wangritter13: folds 
Indangeriam: raises $0.20 to $0.30
chris.nomf: folds 
KiraLasVegas: folds 
Chrysk2: folds 
ALL-IN0074: folds 
Uncalled bet ($0.20) returned to Indangeriam
Indangeriam collected $0.25 from pot
Indangeriam: doesn't show hand 
*** SUMMARY ***
Total pot $0.25 | Rake $0 
Seat 1: KiraLasVegas (button) folded before Flop (didn't bet)
Seat 2: Chrysk2 (small blind) folded before Flop
Seat 3: ALL-IN0074 (big blind) folded before Flop
Seat 4: Wangritter13 folded before Flop (didn't bet)
Seat 5: Indangeriam collected ($0.25)
Seat 6: chris.nomf folded before Flop (didn't bet)



PokerStars Hand #222979970707:  Hold'em No Limit ($0.05/$0.10 USD) - 2021/01/23 19:32:08 ET
Table 'Merope IV' 6-max Seat #2 is the button
Seat 1: KiraLasVegas ($10.18 in chips) 
Seat 2: Chrysk2 ($9.85 in chips) 
Seat 3: ALL-IN0074 ($11.64 in chips) 
Seat 4: Wangritter13 ($12.44 in chips) 
Seat 5: Indangeriam ($10.15 in chips) 
Seat 6: chris.nomf ($10 in chips) 
ALL-IN0074: posts small blind $0.05
Wangritter13: posts big blind $0.10
*** HOLE CARDS ***
Indangeriam: folds 
chris.nomf: raises $0.20 to $0.30
KiraLasVegas: folds 
Chrysk2: folds 
ALL-IN0074: folds 
Wangritter13: calls $0.20
*** FLOP *** [5c 2s 4s]
Wangritter13: checks 
chris.nomf: checks 
*** TURN *** [5c 2s 4s] [Qs]
Wangritter13: checks 
chris.nomf: bets $0.62
Wangritter13: calls $0.62
*** RIVER *** [5c 2s 4s Qs] [6h]
Wangritter13: bets $0.80
chris.nomf: folds 
Uncalled bet ($0.80) returned to Wangritter13
Wangritter13 collected $1.80 from pot
Wangritter13: doesn't show hand 
*** SUMMARY ***
Total pot $1.89 | Rake $0.09 
Board [5c 2s 4s Qs 6h]
Seat 1: KiraLasVegas folded before Flop (didn't bet)
Seat 2: Chrysk2 (button) folded before Flop (didn't bet)
Seat 3: ALL-IN0074 (small blind) folded before Flop
Seat 4: Wangritter13 (big blind) collected ($1.80)
Seat 5: Indangeriam folded before Flop (didn't bet)
Seat 6: chris.nomf folded on the River



PokerStars Hand #222980002579:  Hold'em No Limit ($0.05/$0.10 USD) - 2021/01/23 19:32:55 ET
Table 'Merope IV' 6-max Seat #3 is the button
Seat 1: KiraLasVegas ($10.18 in chips) 
Seat 2: Chrysk2 ($9.85 in chips) 
Seat 3: ALL-IN0074 ($11.59 in chips) 
Seat 4: Wangritter13 ($13.32 in chips) 
Seat 5: Indangeriam ($10.15 in chips) 
Seat 6: chris.nomf ($9.08 in chips) 
Wangritter13: posts small blind $0.05
Indangeriam: posts big blind $0.10
*** HOLE CARDS ***
chris.nomf: folds 
KiraLasVegas: raises $0.20 to $0.30
Chrysk2: folds 
ALL-IN0074: folds 
Wangritter13: folds 
Indangeriam: folds 
Uncalled bet ($0.20) returned to KiraLasVegas
KiraLasVegas collected $0.25 from pot
KiraLasVegas: doesn't show hand 
*** SUMMARY ***
Total pot $0.25 | Rake $0 
Seat 1: KiraLasVegas collected ($0.25)
Seat 2: Chrysk2 folded before Flop (didn't bet)
Seat 3: ALL-IN0074 (button) folded before Flop (didn't bet)
Seat 4: Wangritter13 (small blind) folded before Flop
Seat 5: Indangeriam (big blind) folded before Flop
Seat 6: chris.nomf folded before Flop (didn't bet)



PokerStars Hand #222980012181:  Hold'em No Limit ($0.05/$0.10 USD) - 2021/01/23 19:33:13 ET
Table 'Merope IV' 6-max Seat #4 is the button
Seat 1: KiraLasVegas ($10.33 in chips) 
Seat 2: Chrysk2 ($9.85 in chips) 
Seat 3: ALL-IN0074 ($11.59 in chips) 
Seat 4: Wangritter13 ($13.27 in chips) 
Seat 5: Indangeriam ($10.05 in chips) 
Seat 6: chris.nomf ($10 in chips) 
Indangeriam: posts small blind $0.05
chris.nomf: posts big blind $0.10
*** HOLE CARDS ***
KiraLasVegas: folds 
Chrysk2: folds 
ALL-IN0074 has timed out
ALL-IN0074: folds 
Wangritter13: calls $0.10
Indangeriam: folds 
chris.nomf: checks 
*** FLOP *** [Tc 6s 3c]
chris.nomf: checks 
Wangritter13: checks 
*** TURN *** [Tc 6s 3c] [9c]
chris.nomf: checks 
KiraLasVegas was removed from the table for failing to post
KiraLasVegas leaves the table
Wangritter13: bets $0.12
chris.nomf: calls $0.12
*** RIVER *** [Tc 6s 3c 9c] [Kh]
chris.nomf: checks 
Wangritter13: bets $0.47
chris.nomf: folds 
Uncalled bet ($0.47) returned to Wangritter13
Wangritter13 collected $0.47 from pot
Wangritter13: doesn't show hand 
*** SUMMARY ***
Total pot $0.49 | Rake $0.02 
Board [Tc 6s 3c 9c Kh]
Seat 1: KiraLasVegas folded before Flop (didn't bet)
Seat 2: Chrysk2 folded before Flop (didn't bet)
Seat 3: ALL-IN0074 folded before Flop (didn't bet)
Seat 4: Wangritter13 (button) collected ($0.47)
Seat 5: Indangeriam (small blind) folded before Flop
Seat 6: chris.nomf (big blind) folded on the River



PokerStars Hand #222980034108:  Hold'em No Limit ($0.05/$0.10 USD) - 2021/01/23 19:33:57 ET
Table 'Merope IV' 6-max Seat #5 is the button
Seat 2: Chrysk2 ($9.85 in chips) 
Seat 3: ALL-IN0074 ($11.59 in chips) 
Seat 4: Wangritter13 ($13.52 in chips) 
Seat 5: Indangeriam ($10 in chips) 
Seat 6: chris.nomf ($9.78 in chips) 
chris.nomf: posts small blind $0.05
Chrysk2: posts big blind $0.10
*** HOLE CARDS ***
ALL-IN0074: raises $0.20 to $0.30
Wangritter13: calls $0.30
Indangeriam: raises $0.60 to $0.90
lnfIame joins the table at seat #1 
chris.nomf: folds 
Chrysk2: raises $2.30 to $3.20
ALL-IN0074: folds 
Wangritter13: folds 
Indangeriam: folds 
Uncalled bet ($2.30) returned to Chrysk2
Chrysk2 collected $2.45 from pot
Chrysk2: doesn't show hand 
*** SUMMARY ***
Total pot $2.45 | Rake $0 
Seat 2: Chrysk2 (big blind) collected ($2.45)
Seat 3: ALL-IN0074 folded before Flop
Seat 4: Wangritter13 folded before Flop
Seat 5: Indangeriam (button) folded before Flop
Seat 6: chris.nomf (small blind) folded before Flop



PokerStars Hand #222980078420:  Hold'em No Limit ($0.05/$0.10 USD) - 2021/01/23 19:35:25 ET
Table 'Merope IV' 6-max Seat #6 is the button
Seat 2: Chrysk2 ($11.40 in chips) 
Seat 3: ALL-IN0074 ($11.29 in chips) 
Seat 4: Wangritter13 ($13.22 in chips) 
Seat 5: Indangeriam ($10 in chips) 
Seat 6: chris.nomf ($10 in chips) 
Chrysk2: posts small blind $0.05
ALL-IN0074: posts big blind $0.10
*** HOLE CARDS ***
Wangritter13: calls $0.10
Indangeriam: folds 
chris.nomf: calls $0.10
Chrysk2: folds 
ALL-IN0074: checks 
*** FLOP *** [Ad Qc 4c]
ALL-IN0074: checks 
Wangritter13: checks 
chris.nomf: checks 
*** TURN *** [Ad Qc 4c] [2h]
ALL-IN0074: checks 
Wangritter13: checks 
chris.nomf: checks 
*** RIVER *** [Ad Qc 4c 2h] [Ts]
ALL-IN0074: checks 
Wangritter13: checks 
chris.nomf: bets $0.33
ALL-IN0074: folds 
Wangritter13: folds 
Uncalled bet ($0.33) returned to chris.nomf
chris.nomf collected $0.33 from pot
chris.nomf: doesn't show hand 
*** SUMMARY ***
Total pot $0.35 | Rake $0.02 
Board [Ad Qc 4c 2h Ts]
Seat 2: Chrysk2 (small blind) folded before Flop
Seat 3: ALL-IN0074 (big blind) folded on the River
Seat 4: Wangritter13 folded on the River
Seat 5: Indangeriam folded before Flop (didn't bet)
Seat 6: chris.nomf (button) collected ($0.33)



PokerStars Hand #222980098492:  Hold'em No Limit ($0.05/$0.10 USD) - 2021/01/23 19:36:04 ET
Table 'Merope IV' 6-max Seat #2 is the button
Seat 2: Chrysk2 ($11.35 in chips) 
Seat 3: ALL-IN0074 ($11.19 in chips) 
Seat 4: Wangritter13 ($13.12 in chips) 
Seat 5: Indangeriam ($10 in chips) 
Seat 6: chris.nomf ($10.23 in chips) 
ALL-IN0074: posts small blind $0.05
Wangritter13: posts big blind $0.10
lnfIame: sits out 
*** HOLE CARDS ***
Indangeriam: folds 
chris.nomf: folds 
Chrysk2: raises $0.20 to $0.30
ALL-IN0074: folds 
Wangritter13: folds 
Uncalled bet ($0.20) returned to Chrysk2
Chrysk2 collected $0.25 from pot
Chrysk2: doesn't show hand 
*** SUMMARY ***
Total pot $0.25 | Rake $0 
Seat 2: Chrysk2 (button) collected ($0.25)
Seat 3: ALL-IN0074 (small blind) folded before Flop
Seat 4: Wangritter13 (big blind) folded before Flop
Seat 5: Indangeriam folded before Flop (didn't bet)
Seat 6: chris.nomf folded before Flop (didn't bet)



PokerStars Hand #222980104979:  Hold'em No Limit ($0.05/$0.10 USD) - 2021/01/23 19:36:17 ET
Table 'Merope IV' 6-max Seat #3 is the button
Seat 2: Chrysk2 ($11.50 in chips) 
Seat 3: ALL-IN0074 ($11.14 in chips) 
Seat 4: Wangritter13 ($13.02 in chips) 
Seat 5: Indangeriam ($10 in chips) 
Seat 6: chris.nomf ($10.23 in chips) 
Wangritter13: posts small blind $0.05
Indangeriam: posts big blind $0.10
lnfIame: sits out 
*** HOLE CARDS ***
chris.nomf: folds 
Chrysk2: folds 
ALL-IN0074: folds 
Wangritter13: folds 
Uncalled bet ($0.05) returned to Indangeriam
Indangeriam collected $0.10 from pot
Indangeriam: doesn't show hand 
*** SUMMARY ***
Total pot $0.10 | Rake $0 
Seat 2: Chrysk2 folded before Flop (didn't bet)
Seat 3: ALL-IN0074 (button) folded before Flop (didn't bet)
Seat 4: Wangritter13 (small blind) folded before Flop
Seat 5: Indangeriam (big blind) collected ($0.10)
Seat 6: chris.nomf folded before Flop (didn't bet)



PokerStars Hand #222980112390:  Hold'em No Limit ($0.05/$0.10 USD) - 2021/01/23 19:36:32 ET
Table 'Merope IV' 6-max Seat #4 is the button
Seat 2: Chrysk2 ($11.50 in chips) 
Seat 3: ALL-IN0074 ($11.14 in chips) 
Seat 4: Wangritter13 ($12.97 in chips) 
Seat 5: Indangeriam ($10.05 in chips) 
Seat 6: chris.nomf ($10.23 in chips) 
Indangeriam: posts small blind $0.05
chris.nomf: posts big blind $0.10
lnfIame: sits out 
*** HOLE CARDS ***
Chrysk2: folds 
ALL-IN0074: folds 
Wangritter13: folds 
Indangeriam: folds 
Uncalled bet ($0.05) returned to chris.nomf
chris.nomf collected $0.10 from pot
chris.nomf: doesn't show hand 
*** SUMMARY ***
Total pot $0.10 | Rake $0 
Seat 2: Chrysk2 folded before Flop (didn't bet)
Seat 3: ALL-IN0074 folded before Flop (didn't bet)
Seat 4: Wangritter13 (button) folded before Flop (didn't bet)
Seat 5: Indangeriam (small blind) folded before Flop
Seat 6: chris.nomf (big blind) collected ($0.10)



PokerStars Hand #222980117923:  Hold'em No Limit ($0.05/$0.10 USD) - 2021/01/23 19:36:43 ET
Table 'Merope IV' 6-max Seat #5 is the button
Seat 1: lnfIame ($10 in chips) 
Seat 2: Chrysk2 ($11.50 in chips) 
Seat 3: ALL-IN0074 ($11.14 in chips) 
Seat 4: Wangritter13 ($12.97 in chips) 
Seat 5: Indangeriam ($10 in chips) 
Seat 6: chris.nomf ($10.28 in chips) 
chris.nomf: posts small blind $0.05
lnfIame: posts big blind $0.10
*** HOLE CARDS ***
Chrysk2: raises $0.20 to $0.30
ALL-IN0074: folds 
Wangritter13: folds 
Indangeriam: folds 
chris.nomf: folds 
lnfIame: folds 
Uncalled bet ($0.20) returned to Chrysk2
Chrysk2 collected $0.25 from pot
Chrysk2: doesn't show hand 
*** SUMMARY ***
Total pot $0.25 | Rake $0 
Seat 1: lnfIame (big blind) folded before Flop
Seat 2: Chrysk2 collected ($0.25)
Seat 3: ALL-IN0074 folded before Flop (didn't bet)
Seat 4: Wangritter13 folded before Flop (didn't bet)
Seat 5: Indangeriam (button) folded before Flop (didn't bet)
Seat 6: chris.nomf (small blind) folded before Flop



PokerStars Hand #222980133803:  Hold'em No Limit ($0.05/$0.10 USD) - 2021/01/23 19:37:14 ET
Table 'Merope IV' 6-max Seat #6 is the button
Seat 1: lnfIame ($10 in chips) 
Seat 3: ALL-IN0074 ($11.14 in chips) 
Seat 4: Wangritter13 ($12.97 in chips) 
Seat 5: Indangeriam ($10 in chips) 
Seat 6: chris.nomf ($10.23 in chips) 
lnfIame: posts small blind $0.05
Chrysk2: is sitting out 
ALL-IN0074: posts big blind $0.10
*** HOLE CARDS ***
Wangritter13: folds 
Indangeriam: folds 
chris.nomf: raises $0.20 to $0.30
lnfIame: folds 
Chrysk2 leaves the table
ALL-IN0074: folds 
Uncalled bet ($0.20) returned to chris.nomf
chris.nomf collected $0.25 from pot
chris.nomf: doesn't show hand 
*** SUMMARY ***
Total pot $0.25 | Rake $0 
Seat 1: lnfIame (small blind) folded before Flop
Seat 3: ALL-IN0074 (big blind) folded before Flop
Seat 4: Wangritter13 folded before Flop (didn't bet)
Seat 5: Indangeriam folded before Flop (didn't bet)
Seat 6: chris.nomf (button) collected ($0.25)



PokerStars Hand #222980140699:  Hold'em No Limit ($0.05/$0.10 USD) - 2021/01/23 19:37:28 ET
Table 'Merope IV' 6-max Seat #1 is the button
Seat 1: lnfIame ($10 in chips) 
Seat 3: ALL-IN0074 ($11.04 in chips) 
Seat 4: Wangritter13 ($12.97 in chips) 
Seat 5: Indangeriam ($10 in chips) 
Seat 6: chris.nomf ($10.38 in chips) 
ALL-IN0074: posts small blind $0.05
EZEQUIEL.C10 joins the table at seat #2 
Wangritter13: posts big blind $0.10
*** HOLE CARDS ***
Indangeriam: folds 
chris.nomf: folds 
lnfIame: folds 
ALL-IN0074: raises $0.20 to $0.30
Wangritter13: folds 
Uncalled bet ($0.20) returned to ALL-IN0074
ALL-IN0074 collected $0.20 from pot
*** SUMMARY ***
Total pot $0.20 | Rake $0 
Seat 1: lnfIame (button) folded before Flop (didn't bet)
Seat 3: ALL-IN0074 (small blind) collected ($0.20)
Seat 4: Wangritter13 (big blind) folded before Flop
Seat 5: Indangeriam folded before Flop (didn't bet)
Seat 6: chris.nomf folded before Flop (didn't bet)



PokerStars Hand #222980150220:  Hold'em No Limit ($0.05/$0.10 USD) - 2021/01/23 19:37:47 ET
Table 'Merope IV' 6-max Seat #3 is the button
Seat 1: lnfIame ($10 in chips) 
Seat 3: ALL-IN0074 ($11.14 in chips) 
Seat 4: Wangritter13 ($12.87 in chips) 
Seat 5: Indangeriam ($10 in chips) 
Seat 6: chris.nomf ($10.38 in chips) 
Wangritter13: posts small blind $0.05
Indangeriam: posts big blind $0.10
EZEQUIEL.C10: sits out 
*** HOLE CARDS ***
chris.nomf: folds 
lnfIame: folds 
ALL-IN0074: folds 
Wangritter13: calls $0.05
Indangeriam: checks 
*** FLOP *** [8d 3d Jd]
Wangritter13: checks 
Indangeriam: checks 
*** TURN *** [8d 3d Jd] [Ks]
Wangritter13: checks 
Indangeriam: bets $0.19
Wangritter13: folds 
Uncalled bet ($0.19) returned to Indangeriam
Indangeriam collected $0.19 from pot
Indangeriam: doesn't show hand 
*** SUMMARY ***
Total pot $0.20 | Rake $0.01 
Board [8d 3d Jd Ks]
Seat 1: lnfIame folded before Flop (didn't bet)
Seat 3: ALL-IN0074 (button) folded before Flop (didn't bet)
Seat 4: Wangritter13 (small blind) folded on the Turn
Seat 5: Indangeriam (big blind) collected ($0.19)
Seat 6: chris.nomf folded before Flop (didn't bet)



PokerStars Hand #222980166992:  Hold'em No Limit ($0.05/$0.10 USD) - 2021/01/23 19:38:20 ET
Table 'Merope IV' 6-max Seat #4 is the button
Seat 1: lnfIame ($10 in chips) 
Seat 3: ALL-IN0074 ($11.14 in chips) 
Seat 4: Wangritter13 ($12.77 in chips) 
Seat 5: Indangeriam ($10.09 in chips) 
Seat 6: chris.nomf ($10.38 in chips) 
Indangeriam: posts small blind $0.05
chris.nomf: posts big blind $0.10
EZEQUIEL.C10: sits out 
*** HOLE CARDS ***
lnfIame: folds 
ALL-IN0074: raises $0.15 to $0.25
Wangritter13: calls $0.25
Indangeriam: folds 
chris.nomf: folds 
*** FLOP *** [Ac 4s 8s]
ALL-IN0074: checks 
Wangritter13: bets $0.31
ALL-IN0074: calls $0.31
*** TURN *** [Ac 4s 8s] [Kd]
ALL-IN0074: checks 
Wangritter13: bets $0.60
ALL-IN0074: raises $0.70 to $1.30
Wangritter13: calls $0.70
*** RIVER *** [Ac 4s 8s Kd] [2h]
ALL-IN0074: checks 
Wangritter13: checks 
*** SHOW DOWN ***
ALL-IN0074: shows [As 9c] (a pair of Aces)
Wangritter13: mucks hand 
ALL-IN0074 collected $3.70 from pot
*** SUMMARY ***
Total pot $3.87 | Rake $0.17 
Board [Ac 4s 8s Kd 2h]
Seat 1: lnfIame folded before Flop (didn't bet)
Seat 3: ALL-IN0074 showed [As 9c] and won ($3.70) with a pair of Aces
Seat 4: Wangritter13 (button) mucked
Seat 5: Indangeriam (small blind) folded before Flop
Seat 6: chris.nomf (big blind) folded before Flop



PokerStars Hand #222980204417:  Hold'em No Limit ($0.05/$0.10 USD) - 2021/01/23 19:39:35 ET
Table 'Merope IV' 6-max Seat #5 is the button
Seat 1: lnfIame ($10 in chips) 
Seat 3: ALL-IN0074 ($12.98 in chips) 
Seat 4: Wangritter13 ($10.91 in chips) 
Seat 5: Indangeriam ($10.04 in chips) 
Seat 6: chris.nomf ($10.28 in chips) 
chris.nomf: posts small blind $0.05
lnfIame: posts big blind $0.10
EZEQUIEL.C10: sits out 
*** HOLE CARDS ***
ALL-IN0074: folds 
Wangritter13: raises $0.10 to $0.20
Indangeriam: folds 
chris.nomf: folds 
lnfIame: calls $0.10
*** FLOP *** [5c Js Jc]
lnfIame: checks 
Wangritter13: bets $0.21
lnfIame: folds 
Uncalled bet ($0.21) returned to Wangritter13
Wangritter13 collected $0.43 from pot
Wangritter13: doesn't show hand 
*** SUMMARY ***
Total pot $0.45 | Rake $0.02 
Board [5c Js Jc]
Seat 1: lnfIame (big blind) folded on the Flop
Seat 3: ALL-IN0074 folded before Flop (didn't bet)
Seat 4: Wangritter13 collected ($0.43)
Seat 5: Indangeriam (button) folded before Flop (didn't bet)
Seat 6: chris.nomf (small blind) folded before Flop



PokerStars Hand #222980219705:  Hold'em No Limit ($0.05/$0.10 USD) - 2021/01/23 19:40:06 ET
Table 'Merope IV' 6-max Seat #6 is the button
Seat 1: lnfIame ($10 in chips) 
Seat 2: EZEQUIEL.C10 ($8 in chips) 
Seat 3: ALL-IN0074 ($12.98 in chips) 
Seat 4: Wangritter13 ($11.14 in chips) 
Seat 5: Indangeriam ($10.04 in chips) 
Seat 6: chris.nomf ($10.23 in chips) 
lnfIame: posts small blind $0.05
EZEQUIEL.C10: posts big blind $0.10
*** HOLE CARDS ***
ALL-IN0074: folds 
Wangritter13: raises $0.25 to $0.35
Indangeriam: folds 
chris.nomf: folds 
lnfIame: folds 
EZEQUIEL.C10: calls $0.25
*** FLOP *** [4d Tc 2c]
EZEQUIEL.C10: checks 
Wangritter13: bets $0.36
EZEQUIEL.C10: calls $0.36
*** TURN *** [4d Tc 2c] [Ks]
EZEQUIEL.C10: checks 
Wangritter13: bets $0.60
EZEQUIEL.C10: calls $0.60
*** RIVER *** [4d Tc 2c Ks] [5c]
EZEQUIEL.C10: checks 
Wangritter13: checks 
*** SHOW DOWN ***
EZEQUIEL.C10: shows [Qs Ts] (a pair of Tens)
Wangritter13: shows [Js Jc] (a pair of Jacks)
Wangritter13 collected $2.55 from pot
*** SUMMARY ***
Total pot $2.67 | Rake $0.12 
Board [4d Tc 2c Ks 5c]
Seat 1: lnfIame (small blind) folded before Flop
Seat 2: EZEQUIEL.C10 (big blind) showed [Qs Ts] and lost with a pair of Tens
Seat 3: ALL-IN0074 folded before Flop (didn't bet)
Seat 4: Wangritter13 showed [Js Jc] and won ($2.55) with a pair of Jacks
Seat 5: Indangeriam folded before Flop (didn't bet)
Seat 6: chris.nomf (button) folded before Flop (didn't bet)



PokerStars Hand #222980251373:  Hold'em No Limit ($0.05/$0.10 USD) - 2021/01/23 19:41:09 ET
Table 'Merope IV' 6-max Seat #1 is the button
Seat 1: lnfIame ($10 in chips) 
Seat 2: EZEQUIEL.C10 ($6.69 in chips) 
Seat 3: ALL-IN0074 ($12.98 in chips) 
Seat 4: Wangritter13 ($12.38 in chips) 
Seat 5: Indangeriam ($10.04 in chips) 
Seat 6: chris.nomf ($10.23 in chips) 
EZEQUIEL.C10: posts small blind $0.05
ALL-IN0074: posts big blind $0.10
*** HOLE CARDS ***
Wangritter13 has timed out
Wangritter13: folds 
Indangeriam: raises $0.20 to $0.30
chris.nomf: folds 
lnfIame: raises $0.60 to $0.90
EZEQUIEL.C10: folds 
ALL-IN0074: calls $0.80
Indangeriam: folds 
*** FLOP *** [Kd 2s 9s]
ALL-IN0074: checks 
lnfIame: checks 
*** TURN *** [Kd 2s 9s] [4h]
ALL-IN0074: checks 
lnfIame: bets $0.68
ALL-IN0074: folds 
Uncalled bet ($0.68) returned to lnfIame
lnfIame collected $2.05 from pot
lnfIame: doesn't show hand 
*** SUMMARY ***
Total pot $2.15 | Rake $0.10 
Board [Kd 2s 9s 4h]
Seat 1: lnfIame (button) collected ($2.05)
Seat 2: EZEQUIEL.C10 (small blind) folded before Flop
Seat 3: ALL-IN0074 (big blind) folded on the Turn
Seat 4: Wangritter13 folded before Flop (didn't bet)
Seat 5: Indangeriam folded before Flop
Seat 6: chris.nomf folded before Flop (didn't bet)



PokerStars Hand #222980285819:  Hold'em No Limit ($0.05/$0.10 USD) - 2021/01/23 19:42:19 ET
Table 'Merope IV' 6-max Seat #2 is the button
Seat 1: lnfIame ($11.15 in chips) 
Seat 2: EZEQUIEL.C10 ($6.64 in chips) 
Seat 3: ALL-IN0074 ($12.08 in chips) 
Seat 4: Wangritter13 ($12.38 in chips) 
Seat 5: Indangeriam ($10 in chips) 
Seat 6: chris.nomf ($10.23 in chips) 
ALL-IN0074: posts small blind $0.05
Wangritter13: posts big blind $0.10
*** HOLE CARDS ***
Indangeriam: folds 
chris.nomf: folds 
lnfIame: folds 
EZEQUIEL.C10: folds 
ALL-IN0074: raises $0.20 to $0.30
Wangritter13: calls $0.20
*** FLOP *** [Kc Tc Th]
ALL-IN0074: checks 
Wangritter13: checks 
*** TURN *** [Kc Tc Th] [8s]
ALL-IN0074: checks 
Wangritter13: checks 
*** RIVER *** [Kc Tc Th 8s] [2h]
ALL-IN0074: checks 
Wangritter13: checks 
*** SHOW DOWN ***
ALL-IN0074: shows [7s As] (a pair of Tens)
Wangritter13: mucks hand 
ALL-IN0074 collected $0.57 from pot
*** SUMMARY ***
Total pot $0.60 | Rake $0.03 
Board [Kc Tc Th 8s 2h]
Seat 1: lnfIame folded before Flop (didn't bet)
Seat 2: EZEQUIEL.C10 (button) folded before Flop (didn't bet)
Seat 3: ALL-IN0074 (small blind) showed [7s As] and won ($0.57) with a pair of Tens
Seat 4: Wangritter13 (big blind) mucked
Seat 5: Indangeriam folded before Flop (didn't bet)
Seat 6: chris.nomf folded before Flop (didn't bet)



PokerStars Hand #222980305818:  Hold'em No Limit ($0.05/$0.10 USD) - 2021/01/23 19:43:00 ET
Table 'Merope IV' 6-max Seat #4 is the button
Seat 1: lnfIame ($11.15 in chips) 
Seat 2: EZEQUIEL.C10 ($10 in chips) 
Seat 4: Wangritter13 ($12.08 in chips) 
Seat 5: Indangeriam ($10 in chips) 
Seat 6: chris.nomf ($10.23 in chips) 
Indangeriam: posts small blind $0.05
chris.nomf: posts big blind $0.10
*** HOLE CARDS ***
lnfIame: raises $0.15 to $0.25
EZEQUIEL.C10: folds 
Wangritter13: folds 
Indangeriam: folds 
chris.nomf: calls $0.15
*** FLOP *** [Ac Ad 9d]
chris.nomf: checks 
lnfIame: bets $0.20
chris.nomf: calls $0.20
*** TURN *** [Ac Ad 9d] [4d]
chris.nomf: checks 
lnfIame: bets $0.61
chris.nomf: calls $0.61
*** RIVER *** [Ac Ad 9d 4d] [Td]
chris.nomf: checks 
lnfIame: checks 
*** SHOW DOWN ***
chris.nomf: shows [8d 8c] (a flush, Ace high)
lnfIame: mucks hand 
chris.nomf collected $2.07 from pot
*** SUMMARY ***
Total pot $2.17 | Rake $0.10 
Board [Ac Ad 9d 4d Td]
Seat 1: lnfIame mucked
Seat 2: EZEQUIEL.C10 folded before Flop (didn't bet)
Seat 4: Wangritter13 (button) folded before Flop (didn't bet)
Seat 5: Indangeriam (small blind) folded before Flop
Seat 6: chris.nomf (big blind) showed [8d 8c] and won ($2.07) with a flush, Ace high



PokerStars Hand #222980324984:  Hold'em No Limit ($0.05/$0.10 USD) - 2021/01/23 19:43:39 ET
Table 'Merope IV' 6-max Seat #5 is the button
Seat 1: lnfIame ($10.09 in chips) 
Seat 2: EZEQUIEL.C10 ($10 in chips) 
Seat 4: Wangritter13 ($12.08 in chips) 
Seat 5: Indangeriam ($10 in chips) 
Seat 6: chris.nomf ($11.24 in chips) 
chris.nomf: posts small blind $0.05
lnfIame: posts big blind $0.10
*** HOLE CARDS ***
EZEQUIEL.C10: folds 
Wangritter13: raises $0.25 to $0.35
Indangeriam: folds 
Indangeriam leaves the table
chris.nomf: folds 
lnfIame: folds 
Uncalled bet ($0.25) returned to Wangritter13
Wangritter13 collected $0.25 from pot
Wangritter13: doesn't show hand 
*** SUMMARY ***
Total pot $0.25 | Rake $0 
Seat 1: lnfIame (big blind) folded before Flop
Seat 2: EZEQUIEL.C10 folded before Flop (didn't bet)
Seat 4: Wangritter13 collected ($0.25)
Seat 5: Indangeriam (button) folded before Flop (didn't bet)
Seat 6: chris.nomf (small blind) folded before Flop



PokerStars Hand #222981352535:  Hold'em No Limit ($0.05/$0.10 USD) - 2021/01/23 20:20:52 ET
Table 'Merope IV' 6-max Seat #2 is the button
Seat 1: alfaomegabet ($10 in chips) 
Seat 2: bigmamaa7 ($11.77 in chips) 
Seat 4: Wangritter13 ($19.38 in chips) 
Seat 5: VanCleef322 ($10.23 in chips) 
Seat 6: chris.nomf ($14.73 in chips) 
Wangritter13: posts small blind $0.05
VanCleef322: posts big blind $0.10
*** HOLE CARDS ***
chris.nomf: folds 
alfaomegabet: folds 
bigmamaa7: calls $0.10
Wangritter13: raises $0.20 to $0.30
VanCleef322: folds 
bigmamaa7: calls $0.20
*** FLOP *** [4s 7s 4c]
Wangritter13: checks 
bigmamaa7: bets $0.40
Wangritter13: folds 
Uncalled bet ($0.40) returned to bigmamaa7
bigmamaa7 collected $0.67 from pot
*** SUMMARY ***
Total pot $0.70 | Rake $0.03 
Board [4s 7s 4c]
Seat 1: alfaomegabet folded before Flop (didn't bet)
Seat 2: bigmamaa7 (button) collected ($0.67)
Seat 4: Wangritter13 (small blind) folded on the Flop
Seat 5: VanCleef322 (big blind) folded before Flop
Seat 6: chris.nomf folded before Flop (didn't bet)



PokerStars Hand #222980329966:  Hold'em No Limit ($0.05/$0.10 USD) - 2021/01/23 19:43:49 ET
Table 'Merope IV' 6-max Seat #6 is the button
Seat 1: lnfIame ($10 in chips) 
Seat 2: EZEQUIEL.C10 ($10 in chips) 
Seat 4: Wangritter13 ($12.23 in chips) 
Seat 6: chris.nomf ($11.19 in chips) 
lnfIame: posts small blind $0.05
EZEQUIEL.C10: posts big blind $0.10
*** HOLE CARDS ***
Wangritter13: folds 
chris.nomf: folds 
lnfIame: raises $0.15 to $0.25
EZEQUIEL.C10: calls $0.15
*** FLOP *** [5s 7c 6h]
lnfIame: bets $0.24
EZEQUIEL.C10: folds 
Uncalled bet ($0.24) returned to lnfIame
lnfIame collected $0.48 from pot
lnfIame: doesn't show hand 
*** SUMMARY ***
Total pot $0.50 | Rake $0.02 
Board [5s 7c 6h]
Seat 1: lnfIame (small blind) collected ($0.48)
Seat 2: EZEQUIEL.C10 (big blind) folded on the Flop
Seat 4: Wangritter13 folded before Flop (didn't bet)
Seat 6: chris.nomf (button) folded before Flop (didn't bet)



PokerStars Hand #222980342191:  Hold'em No Limit ($0.05/$0.10 USD) - 2021/01/23 19:44:14 ET
Table 'Merope IV' 6-max Seat #1 is the button
Seat 1: lnfIame ($10.23 in chips) 
Seat 2: EZEQUIEL.C10 ($9.75 in chips) 
Seat 4: Wangritter13 ($12.23 in chips) 
Seat 6: chris.nomf ($11.19 in chips) 
EZEQUIEL.C10: posts small blind $0.05
Wangritter13: posts big blind $0.10
*** HOLE CARDS ***
chris.nomf: folds 
lnfIame: raises $0.15 to $0.25
EZEQUIEL.C10: folds 
Wangritter13: folds 
Uncalled bet ($0.15) returned to lnfIame
lnfIame collected $0.25 from pot
lnfIame: doesn't show hand 
*** SUMMARY ***
Total pot $0.25 | Rake $0 
Seat 1: lnfIame (button) collected ($0.25)
Seat 2: EZEQUIEL.C10 (small blind) folded before Flop
Seat 4: Wangritter13 (big blind) folded before Flop
Seat 6: chris.nomf folded before Flop (didn't bet)



PokerStars Hand #222980347178:  Hold'em No Limit ($0.05/$0.10 USD) - 2021/01/23 19:44:24 ET
Table 'Merope IV' 6-max Seat #2 is the button
Seat 1: lnfIame ($10.38 in chips) 
Seat 2: EZEQUIEL.C10 ($9.70 in chips) 
Seat 4: Wangritter13 ($12.13 in chips) 
Seat 6: chris.nomf ($11.19 in chips) 
Wangritter13: posts small blind $0.05
chris.nomf: posts big blind $0.10
*** HOLE CARDS ***
lnfIame: folds 
EZEQUIEL.C10: folds 
Wangritter13: raises $0.20 to $0.30
ALL-IN0074 leaves the table
chris.nomf: folds 
Uncalled bet ($0.20) returned to Wangritter13
Wangritter13 collected $0.20 from pot
Wangritter13: doesn't show hand 
*** SUMMARY ***
Total pot $0.20 | Rake $0 
Seat 1: lnfIame folded before Flop (didn't bet)
Seat 2: EZEQUIEL.C10 (button) folded before Flop (didn't bet)
Seat 4: Wangritter13 (small blind) collected ($0.20)
Seat 6: chris.nomf (big blind) folded before Flop



PokerStars Hand #222980352412:  Hold'em No Limit ($0.05/$0.10 USD) - 2021/01/23 19:44:35 ET
Table 'Merope IV' 6-max Seat #4 is the button
Seat 1: lnfIame ($10.38 in chips) 
Seat 2: EZEQUIEL.C10 ($9.70 in chips) 
Seat 4: Wangritter13 ($12.23 in chips) 
Seat 6: chris.nomf ($11.09 in chips) 
chris.nomf: posts small blind $0.05
lnfIame: posts big blind $0.10
*** HOLE CARDS ***
EZEQUIEL.C10: folds 
Wangritter13: folds 
chris.nomf: folds 
Uncalled bet ($0.05) returned to lnfIame
lnfIame collected $0.10 from pot
lnfIame: doesn't show hand 
*** SUMMARY ***
Total pot $0.10 | Rake $0 
Seat 1: lnfIame (big blind) collected ($0.10)
Seat 2: EZEQUIEL.C10 folded before Flop (didn't bet)
Seat 4: Wangritter13 (button) folded before Flop (didn't bet)
Seat 6: chris.nomf (small blind) folded before Flop



PokerStars Hand #222980356213:  Hold'em No Limit ($0.05/$0.10 USD) - 2021/01/23 19:44:43 ET
Table 'Merope IV' 6-max Seat #6 is the button
Seat 1: lnfIame ($10.43 in chips) 
Seat 2: EZEQUIEL.C10 ($9.70 in chips) 
Seat 4: Wangritter13 ($12.23 in chips) 
Seat 6: chris.nomf ($11.04 in chips) 
lnfIame: posts small blind $0.05
EZEQUIEL.C10: posts big blind $0.10
*** HOLE CARDS ***
Wangritter13: calls $0.10
chris.nomf: folds 
lnfIame: folds 
EZEQUIEL.C10: checks 
*** FLOP *** [Qc Ah 9c]
EZEQUIEL.C10: checks 
Wangritter13: bets $0.12
EZEQUIEL.C10: folds 
Uncalled bet ($0.12) returned to Wangritter13
Wangritter13 collected $0.24 from pot
Wangritter13: doesn't show hand 
*** SUMMARY ***
Total pot $0.25 | Rake $0.01 
Board [Qc Ah 9c]
Seat 1: lnfIame (small blind) folded before Flop
Seat 2: EZEQUIEL.C10 (big blind) folded on the Flop
Seat 4: Wangritter13 collected ($0.24)
Seat 6: chris.nomf (button) folded before Flop (didn't bet)



PokerStars Hand #222980374206:  Hold'em No Limit ($0.05/$0.10 USD) - 2021/01/23 19:45:19 ET
Table 'Merope IV' 6-max Seat #1 is the button
Seat 1: lnfIame ($10.38 in chips) 
Seat 2: EZEQUIEL.C10 ($9.60 in chips) 
Seat 4: Wangritter13 ($12.37 in chips) 
Seat 6: chris.nomf ($11.04 in chips) 
EZEQUIEL.C10: posts small blind $0.05
Wangritter13: posts big blind $0.10
*** HOLE CARDS ***
chris.nomf: folds 
lnfIame: raises $0.15 to $0.25
EZEQUIEL.C10: raises $0.75 to $1
Wangritter13: folds 
alfredovga joins the table at seat #5 
lnfIame: calls $0.75
*** FLOP *** [Td 6d 6s]
wolverstine joins the table at seat #3 
EZEQUIEL.C10: bets $1.10
lnfIame: folds 
Uncalled bet ($1.10) returned to EZEQUIEL.C10
EZEQUIEL.C10 collected $2.01 from pot
EZEQUIEL.C10: doesn't show hand 
*** SUMMARY ***
Total pot $2.10 | Rake $0.09 
Board [Td 6d 6s]
Seat 1: lnfIame (button) folded on the Flop
Seat 2: EZEQUIEL.C10 (small blind) collected ($2.01)
Seat 4: Wangritter13 (big blind) folded before Flop
Seat 6: chris.nomf folded before Flop (didn't bet)



PokerStars Hand #222980412846:  Hold'em No Limit ($0.05/$0.10 USD) - 2021/01/23 19:46:39 ET
Table 'Merope IV' 6-max Seat #2 is the button
Seat 1: lnfIame ($10 in chips) 
Seat 2: EZEQUIEL.C10 ($10.61 in chips) 
Seat 4: Wangritter13 ($12.27 in chips) 
Seat 5: alfredovga ($10 in chips) 
Seat 6: chris.nomf ($11.04 in chips) 
Wangritter13: posts small blind $0.05
alfredovga: posts big blind $0.10
*** HOLE CARDS ***
chris.nomf: folds 
lnfIame: folds 
EZEQUIEL.C10: folds 
Wangritter13: folds 
Uncalled bet ($0.05) returned to alfredovga
alfredovga collected $0.10 from pot
alfredovga: doesn't show hand 
*** SUMMARY ***
Total pot $0.10 | Rake $0 
Seat 1: lnfIame folded before Flop (didn't bet)
Seat 2: EZEQUIEL.C10 (button) folded before Flop (didn't bet)
Seat 4: Wangritter13 (small blind) folded before Flop
Seat 5: alfredovga (big blind) collected ($0.10)
Seat 6: chris.nomf folded before Flop (didn't bet)



PokerStars Hand #222980418172:  Hold'em No Limit ($0.05/$0.10 USD) - 2021/01/23 19:46:50 ET
Table 'Merope IV' 6-max Seat #4 is the button
Seat 1: lnfIame ($10 in chips) 
Seat 2: EZEQUIEL.C10 ($10.61 in chips) 
Seat 4: Wangritter13 ($12.22 in chips) 
Seat 5: alfredovga ($10.05 in chips) 
Seat 6: chris.nomf ($11.04 in chips) 
alfredovga: posts small blind $0.05
chris.nomf: posts big blind $0.10
wolverstine: sits out 
*** HOLE CARDS ***
lnfIame: folds 
EZEQUIEL.C10: raises $0.20 to $0.30
Wangritter13: raises $0.55 to $0.85
alfredovga: folds 
chris.nomf: folds 
EZEQUIEL.C10: folds 
Uncalled bet ($0.55) returned to Wangritter13
Wangritter13 collected $0.75 from pot
Wangritter13: doesn't show hand 
*** SUMMARY ***
Total pot $0.75 | Rake $0 
Seat 1: lnfIame folded before Flop (didn't bet)
Seat 2: EZEQUIEL.C10 folded before Flop
Seat 4: Wangritter13 (button) collected ($0.75)
Seat 5: alfredovga (small blind) folded before Flop
Seat 6: chris.nomf (big blind) folded before Flop



PokerStars Hand #222980444214:  Hold'em No Limit ($0.05/$0.10 USD) - 2021/01/23 19:47:21 ET
Table 'Merope IV' 6-max Seat #5 is the button
Seat 1: lnfIame ($10 in chips) 
Seat 2: EZEQUIEL.C10 ($10.31 in chips) 
Seat 3: wolverstine ($8 in chips) 
Seat 4: Wangritter13 ($12.67 in chips) 
Seat 5: alfredovga ($10 in chips) 
Seat 6: chris.nomf ($10.94 in chips) 
chris.nomf: posts small blind $0.05
lnfIame: posts big blind $0.10
wolverstine: posts big blind $0.10
*** HOLE CARDS ***
EZEQUIEL.C10: folds 
wolverstine: checks 
Wangritter13: folds 
alfredovga: folds 
chris.nomf: calls $0.05
lnfIame: checks 
*** FLOP *** [As 6d Ts]
chris.nomf: checks 
lnfIame: bets $0.15
wolverstine: folds 
chris.nomf: folds 
Uncalled bet ($0.15) returned to lnfIame
lnfIame collected $0.29 from pot
lnfIame: doesn't show hand 
*** SUMMARY ***
Total pot $0.30 | Rake $0.01 
Board [As 6d Ts]
Seat 1: lnfIame (big blind) collected ($0.29)
Seat 2: EZEQUIEL.C10 folded before Flop (didn't bet)
Seat 3: wolverstine folded on the Flop (didn't bet)
Seat 4: Wangritter13 folded before Flop (didn't bet)
Seat 5: alfredovga (button) folded before Flop (didn't bet)
Seat 6: chris.nomf (small blind) folded on the Flop



PokerStars Hand #222980456806:  Hold'em No Limit ($0.05/$0.10 USD) - 2021/01/23 19:47:47 ET
Table 'Merope IV' 6-max Seat #6 is the button
Seat 1: lnfIame ($10.19 in chips) 
Seat 2: EZEQUIEL.C10 ($10.31 in chips) 
Seat 3: wolverstine ($7.90 in chips) 
Seat 4: Wangritter13 ($12.67 in chips) 
Seat 5: alfredovga ($10 in chips) 
Seat 6: chris.nomf ($10.84 in chips) 
lnfIame: posts small blind $0.05
EZEQUIEL.C10: posts big blind $0.10
*** HOLE CARDS ***
wolverstine: calls $0.10
Wangritter13: raises $0.25 to $0.35
alfredovga: calls $0.35
chris.nomf: folds 
lnfIame: folds 
EZEQUIEL.C10: folds 
wolverstine: calls $0.25
*** FLOP *** [4d Ah 6h]
wolverstine: checks 
Wangritter13: checks 
alfredovga: bets $1.10
wolverstine: folds 
Wangritter13: calls $1.10
*** TURN *** [4d Ah 6h] [7s]
Wangritter13: bets $1.42
alfredovga: calls $1.42
*** RIVER *** [4d Ah 6h 7s] [8d]
Wangritter13: bets $2.18
alfredovga: calls $2.18
*** SHOW DOWN ***
Wangritter13: shows [Jh Ac] (a pair of Aces)
alfredovga: shows [4h 8h] (two pair, Eights and Fours)
alfredovga collected $10.12 from pot
*** SUMMARY ***
Total pot $10.60 | Rake $0.48 
Board [4d Ah 6h 7s 8d]
Seat 1: lnfIame (small blind) folded before Flop
Seat 2: EZEQUIEL.C10 (big blind) folded before Flop
Seat 3: wolverstine folded on the Flop
Seat 4: Wangritter13 showed [Jh Ac] and lost with a pair of Aces
Seat 5: alfredovga showed [4h 8h] and won ($10.12) with two pair, Eights and Fours
Seat 6: chris.nomf (button) folded before Flop (didn't bet)



PokerStars Hand #222980492793:  Hold'em No Limit ($0.05/$0.10 USD) - 2021/01/23 19:49:01 ET
Table 'Merope IV' 6-max Seat #1 is the button
Seat 1: lnfIame ($10.14 in chips) 
Seat 2: EZEQUIEL.C10 ($10.21 in chips) 
Seat 3: wolverstine ($7.55 in chips) 
Seat 4: Wangritter13 ($7.62 in chips) 
Seat 5: alfredovga ($15.07 in chips) 
Seat 6: chris.nomf ($10.84 in chips) 
EZEQUIEL.C10: posts small blind $0.05
wolverstine: posts big blind $0.10
*** HOLE CARDS ***
Wangritter13: folds 
alfredovga: calls $0.10
chris.nomf: folds 
lnfIame: folds 
EZEQUIEL.C10: folds 
wolverstine: checks 
*** FLOP *** [9s Qc Ac]
wolverstine: checks 
alfredovga: bets $0.10
wolverstine: folds 
Uncalled bet ($0.10) returned to alfredovga
alfredovga collected $0.24 from pot
alfredovga: doesn't show hand 
*** SUMMARY ***
Total pot $0.25 | Rake $0.01 
Board [9s Qc Ac]
Seat 1: lnfIame (button) folded before Flop (didn't bet)
Seat 2: EZEQUIEL.C10 (small blind) folded before Flop
Seat 3: wolverstine (big blind) folded on the Flop
Seat 4: Wangritter13 folded before Flop (didn't bet)
Seat 5: alfredovga collected ($0.24)
Seat 6: chris.nomf folded before Flop (didn't bet)



PokerStars Hand #222980501721:  Hold'em No Limit ($0.05/$0.10 USD) - 2021/01/23 19:49:20 ET
Table 'Merope IV' 6-max Seat #2 is the button
Seat 1: lnfIame ($10.14 in chips) 
Seat 2: EZEQUIEL.C10 ($10.16 in chips) 
Seat 3: wolverstine ($7.45 in chips) 
Seat 4: Wangritter13 ($7.62 in chips) 
Seat 5: alfredovga ($15.21 in chips) 
Seat 6: chris.nomf ($10.84 in chips) 
wolverstine: posts small blind $0.05
Wangritter13: posts big blind $0.10
*** HOLE CARDS ***
alfredovga: folds 
chris.nomf: raises $0.20 to $0.30
lnfIame: folds 
EZEQUIEL.C10: folds 
wolverstine: folds 
Wangritter13: raises $0.45 to $0.75
chris.nomf: raises $2.15 to $2.90
Wangritter13: calls $2.15
*** FLOP *** [3c Ad 3d]
alfredovga leaves the table
Wangritter13: bets $4.72 and is all-in
chris.nomf: calls $4.72
sAsscha17 joins the table at seat #5 
*** TURN *** [3c Ad 3d] [8s]
*** RIVER *** [3c Ad 3d 8s] [Ac]
*** SHOW DOWN ***
Wangritter13: shows [Jh Ah] (a full house, Aces full of Threes)
chris.nomf: shows [Kd Ks] (two pair, Aces and Kings)
Wangritter13 collected $14.60 from pot
chris.nomf cashed out the hand for $1.87 | Cash Out Fee $0.02
*** SUMMARY ***
Total pot $15.29 | Rake $0.69 
Board [3c Ad 3d 8s Ac]
Seat 1: lnfIame folded before Flop (didn't bet)
Seat 2: EZEQUIEL.C10 (button) folded before Flop (didn't bet)
Seat 3: wolverstine (small blind) folded before Flop
Seat 4: Wangritter13 (big blind) showed [Jh Ah] and won ($14.60) with a full house, Aces full of Threes
Seat 5: alfredovga folded before Flop (didn't bet)
Seat 6: chris.nomf showed [Kd Ks] and lost with two pair, Aces and Kings (cashed out).



PokerStars Hand #222980520504:  Hold'em No Limit ($0.05/$0.10 USD) - 2021/01/23 19:49:59 ET
Table 'Merope IV' 6-max Seat #3 is the button
Seat 1: lnfIame ($10.14 in chips) 
Seat 2: EZEQUIEL.C10 ($10.16 in chips) 
Seat 3: wolverstine ($7.40 in chips) 
Seat 4: Wangritter13 ($14.60 in chips) 
Seat 5: sAsscha17 ($5.68 in chips) 
Seat 6: chris.nomf ($5.09 in chips) 
Wangritter13: posts small blind $0.05
sAsscha17: posts big blind $0.10
*** HOLE CARDS ***
chris.nomf: calls $0.10
lnfIame: raises $0.30 to $0.40
EZEQUIEL.C10: folds 
wolverstine: folds 
Wangritter13: folds 
sAsscha17: folds 
chris.nomf: calls $0.30
*** FLOP *** [Jd 7s 6h]
chris.nomf: checks 
lnfIame: bets $0.30
chris.nomf: calls $0.30
*** TURN *** [Jd 7s 6h] [5h]
chris.nomf: checks 
lnfIame: checks 
*** RIVER *** [Jd 7s 6h 5h] [Kd]
chris.nomf: checks 
lnfIame: bets $0.99
chris.nomf: folds 
Uncalled bet ($0.99) returned to lnfIame
lnfIame collected $1.48 from pot
lnfIame: doesn't show hand 
*** SUMMARY ***
Total pot $1.55 | Rake $0.07 
Board [Jd 7s 6h 5h Kd]
Seat 1: lnfIame collected ($1.48)
Seat 2: EZEQUIEL.C10 folded before Flop (didn't bet)
Seat 3: wolverstine (button) folded before Flop (didn't bet)
Seat 4: Wangritter13 (small blind) folded before Flop
Seat 5: sAsscha17 (big blind) folded before Flop
Seat 6: chris.nomf folded on the River



PokerStars Hand #222980554201:  Hold'em No Limit ($0.05/$0.10 USD) - 2021/01/23 19:51:10 ET
Table 'Merope IV' 6-max Seat #4 is the button
Seat 1: lnfIame ($10.92 in chips) 
Seat 2: EZEQUIEL.C10 ($10.16 in chips) 
Seat 3: wolverstine ($7.40 in chips) 
Seat 4: Wangritter13 ($14.55 in chips) 
Seat 5: sAsscha17 ($5.58 in chips) 
Seat 6: chris.nomf ($9.40 in chips) 
sAsscha17: posts small blind $0.05
chris.nomf: posts big blind $0.10
*** HOLE CARDS ***
lnfIame: folds 
EZEQUIEL.C10: raises $0.15 to $0.25
wolverstine: folds 
Wangritter13: folds 
sAsscha17: folds 
chris.nomf: folds 
Uncalled bet ($0.15) returned to EZEQUIEL.C10
EZEQUIEL.C10 collected $0.25 from pot
EZEQUIEL.C10: doesn't show hand 
*** SUMMARY ***
Total pot $0.25 | Rake $0 
Seat 1: lnfIame folded before Flop (didn't bet)
Seat 2: EZEQUIEL.C10 collected ($0.25)
Seat 3: wolverstine folded before Flop (didn't bet)
Seat 4: Wangritter13 (button) folded before Flop (didn't bet)
Seat 5: sAsscha17 (small blind) folded before Flop
Seat 6: chris.nomf (big blind) folded before Flop



PokerStars Hand #222980562284:  Hold'em No Limit ($0.05/$0.10 USD) - 2021/01/23 19:51:27 ET
Table 'Merope IV' 6-max Seat #5 is the button
Seat 1: lnfIame ($10.92 in chips) 
Seat 2: EZEQUIEL.C10 ($10.31 in chips) 
Seat 3: wolverstine ($7.40 in chips) 
Seat 4: Wangritter13 ($14.55 in chips) 
Seat 5: sAsscha17 ($5.53 in chips) 
Seat 6: chris.nomf ($9.30 in chips) 
chris.nomf: posts small blind $0.05
lnfIame: posts big blind $0.10
*** HOLE CARDS ***
EZEQUIEL.C10: folds 
wolverstine: folds 
Wangritter13: folds 
sAsscha17: folds 
chris.nomf: folds 
Uncalled bet ($0.05) returned to lnfIame
lnfIame collected $0.10 from pot
lnfIame: doesn't show hand 
*** SUMMARY ***
Total pot $0.10 | Rake $0 
Seat 1: lnfIame (big blind) collected ($0.10)
Seat 2: EZEQUIEL.C10 folded before Flop (didn't bet)
Seat 3: wolverstine folded before Flop (didn't bet)
Seat 4: Wangritter13 folded before Flop (didn't bet)
Seat 5: sAsscha17 (button) folded before Flop (didn't bet)
Seat 6: chris.nomf (small blind) folded before Flop



PokerStars Hand #222980568315:  Hold'em No Limit ($0.05/$0.10 USD) - 2021/01/23 19:51:40 ET
Table 'Merope IV' 6-max Seat #6 is the button
Seat 1: lnfIame ($10.97 in chips) 
Seat 2: EZEQUIEL.C10 ($10.31 in chips) 
Seat 3: wolverstine ($7.40 in chips) 
Seat 4: Wangritter13 ($14.55 in chips) 
Seat 5: sAsscha17 ($5.53 in chips) 
Seat 6: chris.nomf ($10 in chips) 
lnfIame: posts small blind $0.05
EZEQUIEL.C10: posts big blind $0.10
*** HOLE CARDS ***
wolverstine: folds 
Wangritter13: folds 
sAsscha17: folds 
chris.nomf: folds 
lnfIame: folds 
Uncalled bet ($0.05) returned to EZEQUIEL.C10
EZEQUIEL.C10 collected $0.10 from pot
EZEQUIEL.C10: doesn't show hand 
*** SUMMARY ***
Total pot $0.10 | Rake $0 
Seat 1: lnfIame (small blind) folded before Flop
Seat 2: EZEQUIEL.C10 (big blind) collected ($0.10)
Seat 3: wolverstine folded before Flop (didn't bet)
Seat 4: Wangritter13 folded before Flop (didn't bet)
Seat 5: sAsscha17 folded before Flop (didn't bet)
Seat 6: chris.nomf (button) folded before Flop (didn't bet)



PokerStars Hand #222980575059:  Hold'em No Limit ($0.05/$0.10 USD) - 2021/01/23 19:51:54 ET
Table 'Merope IV' 6-max Seat #1 is the button
Seat 1: lnfIame ($10.92 in chips) 
Seat 2: EZEQUIEL.C10 ($10.36 in chips) 
Seat 3: wolverstine ($7.40 in chips) 
Seat 4: Wangritter13 ($14.55 in chips) 
Seat 5: sAsscha17 ($5.53 in chips) 
Seat 6: chris.nomf ($10 in chips) 
EZEQUIEL.C10: posts small blind $0.05
wolverstine: posts big blind $0.10
*** HOLE CARDS ***
Wangritter13: folds 
sAsscha17: folds 
chris.nomf: folds 
lnfIame: raises $0.15 to $0.25
EZEQUIEL.C10: folds 
wolverstine: calls $0.15
*** FLOP *** [3d Th 8s]
wolverstine: checks 
lnfIame: checks 
*** TURN *** [3d Th 8s] [3c]
wolverstine: bets $0.27
lnfIame: folds 
Uncalled bet ($0.27) returned to wolverstine
wolverstine collected $0.53 from pot
wolverstine: doesn't show hand 
*** SUMMARY ***
Total pot $0.55 | Rake $0.02 
Board [3d Th 8s 3c]
Seat 1: lnfIame (button) folded on the Turn
Seat 2: EZEQUIEL.C10 (small blind) folded before Flop
Seat 3: wolverstine (big blind) collected ($0.53)
Seat 4: Wangritter13 folded before Flop (didn't bet)
Seat 5: sAsscha17 folded before Flop (didn't bet)
Seat 6: chris.nomf folded before Flop (didn't bet)



PokerStars Hand #222980589405:  Hold'em No Limit ($0.05/$0.10 USD) - 2021/01/23 19:52:25 ET
Table 'Merope IV' 6-max Seat #2 is the button
Seat 1: lnfIame ($10.67 in chips) 
Seat 2: EZEQUIEL.C10 ($10.31 in chips) 
Seat 3: wolverstine ($7.68 in chips) 
Seat 4: Wangritter13 ($14.55 in chips) 
Seat 5: sAsscha17 ($5.53 in chips) 
Seat 6: chris.nomf ($10 in chips) 
wolverstine: posts small blind $0.05
Wangritter13: posts big blind $0.10
*** HOLE CARDS ***
sAsscha17: folds 
chris.nomf: folds 
lnfIame: folds 
EZEQUIEL.C10: folds 
wolverstine: folds 
Uncalled bet ($0.05) returned to Wangritter13
Wangritter13 collected $0.10 from pot
Wangritter13: doesn't show hand 
*** SUMMARY ***
Total pot $0.10 | Rake $0 
Seat 1: lnfIame folded before Flop (didn't bet)
Seat 2: EZEQUIEL.C10 (button) folded before Flop (didn't bet)
Seat 3: wolverstine (small blind) folded before Flop
Seat 4: Wangritter13 (big blind) collected ($0.10)
Seat 5: sAsscha17 folded before Flop (didn't bet)
Seat 6: chris.nomf folded before Flop (didn't bet)



PokerStars Hand #222980593242:  Hold'em No Limit ($0.05/$0.10 USD) - 2021/01/23 19:52:33 ET
Table 'Merope IV' 6-max Seat #3 is the button
Seat 1: lnfIame ($10.67 in chips) 
Seat 2: EZEQUIEL.C10 ($10.31 in chips) 
Seat 3: wolverstine ($7.63 in chips) 
Seat 4: Wangritter13 ($14.60 in chips) 
Seat 5: sAsscha17 ($5.53 in chips) 
Seat 6: chris.nomf ($10 in chips) 
Wangritter13: posts small blind $0.05
sAsscha17: posts big blind $0.10
*** HOLE CARDS ***
chris.nomf: folds 
lnfIame: folds 
EZEQUIEL.C10: raises $0.20 to $0.30
wolverstine: folds 
Wangritter13: folds 
sAsscha17: folds 
Uncalled bet ($0.20) returned to EZEQUIEL.C10
EZEQUIEL.C10 collected $0.25 from pot
EZEQUIEL.C10: doesn't show hand 
*** SUMMARY ***
Total pot $0.25 | Rake $0 
Seat 1: lnfIame folded before Flop (didn't bet)
Seat 2: EZEQUIEL.C10 collected ($0.25)
Seat 3: wolverstine (button) folded before Flop (didn't bet)
Seat 4: Wangritter13 (small blind) folded before Flop
Seat 5: sAsscha17 (big blind) folded before Flop
Seat 6: chris.nomf folded before Flop (didn't bet)



PokerStars Hand #222980602500:  Hold'em No Limit ($0.05/$0.10 USD) - 2021/01/23 19:52:53 ET
Table 'Merope IV' 6-max Seat #4 is the button
Seat 1: lnfIame ($10.67 in chips) 
Seat 2: EZEQUIEL.C10 ($10.46 in chips) 
Seat 3: wolverstine ($7.63 in chips) 
Seat 4: Wangritter13 ($14.55 in chips) 
Seat 5: sAsscha17 ($5.43 in chips) 
Seat 6: chris.nomf ($10 in chips) 
sAsscha17: posts small blind $0.05
chris.nomf: posts big blind $0.10
*** HOLE CARDS ***
lnfIame: folds 
EZEQUIEL.C10: folds 
wolverstine: folds 
Wangritter13: folds 
sAsscha17: calls $0.05
chris.nomf: checks 
*** FLOP *** [Ts 3c Jd]
sAsscha17: bets $0.20
chris.nomf: folds 
Uncalled bet ($0.20) returned to sAsscha17
sAsscha17 collected $0.19 from pot
sAsscha17: doesn't show hand 
*** SUMMARY ***
Total pot $0.20 | Rake $0.01 
Board [Ts 3c Jd]
Seat 1: lnfIame folded before Flop (didn't bet)
Seat 2: EZEQUIEL.C10 folded before Flop (didn't bet)
Seat 3: wolverstine folded before Flop (didn't bet)
Seat 4: Wangritter13 (button) folded before Flop (didn't bet)
Seat 5: sAsscha17 (small blind) collected ($0.19)
Seat 6: chris.nomf (big blind) folded on the Flop



PokerStars Hand #222980616882:  Hold'em No Limit ($0.05/$0.10 USD) - 2021/01/23 19:53:23 ET
Table 'Merope IV' 6-max Seat #5 is the button
Seat 1: lnfIame ($10.67 in chips) 
Seat 2: EZEQUIEL.C10 ($10.46 in chips) 
Seat 3: wolverstine ($7.63 in chips) 
Seat 4: Wangritter13 ($14.55 in chips) 
Seat 5: sAsscha17 ($5.52 in chips) 
Seat 6: chris.nomf ($9.90 in chips) 
chris.nomf: posts small blind $0.05
lnfIame: posts big blind $0.10
*** HOLE CARDS ***
EZEQUIEL.C10: folds 
wolverstine: folds 
Wangritter13: raises $0.25 to $0.35
sAsscha17: calls $0.35
chris.nomf: folds 
lnfIame: folds 
*** FLOP *** [6c Kd 7h]
Wangritter13: checks 
sAsscha17: bets $0.30
Wangritter13: folds 
Uncalled bet ($0.30) returned to sAsscha17
sAsscha17 collected $0.81 from pot
sAsscha17: doesn't show hand 
*** SUMMARY ***
Total pot $0.85 | Rake $0.04 
Board [6c Kd 7h]
Seat 1: lnfIame (big blind) folded before Flop
Seat 2: EZEQUIEL.C10 folded before Flop (didn't bet)
Seat 3: wolverstine folded before Flop (didn't bet)
Seat 4: Wangritter13 folded on the Flop
Seat 5: sAsscha17 (button) collected ($0.81)
Seat 6: chris.nomf (small blind) folded before Flop



PokerStars Hand #222980632251:  Hold'em No Limit ($0.05/$0.10 USD) - 2021/01/23 19:53:56 ET
Table 'Merope IV' 6-max Seat #6 is the button
Seat 1: lnfIame ($10.57 in chips) 
Seat 2: EZEQUIEL.C10 ($10.46 in chips) 
Seat 3: wolverstine ($7.63 in chips) 
Seat 4: Wangritter13 ($14.20 in chips) 
Seat 5: sAsscha17 ($5.98 in chips) 
Seat 6: chris.nomf ($9.85 in chips) 
lnfIame: posts small blind $0.05
EZEQUIEL.C10: posts big blind $0.10
*** HOLE CARDS ***
wolverstine: raises $0.10 to $0.20
Wangritter13: folds 
sAsscha17: calls $0.20
chris.nomf: folds 
lnfIame: calls $0.15
EZEQUIEL.C10: folds 
*** FLOP *** [Qc Ah 4h]
lnfIame: checks 
wolverstine: bets $0.30
sAsscha17: calls $0.30
lnfIame: folds 
*** TURN *** [Qc Ah 4h] [Th]
wolverstine: checks 
sAsscha17: checks 
*** RIVER *** [Qc Ah 4h Th] [8s]
wolverstine: bets $0.62
sAsscha17: raises $2.48 to $3.10
wolverstine: calls $2.48
*** SHOW DOWN ***
sAsscha17: shows [Ad Tc] (two pair, Aces and Tens)
wolverstine: shows [9s Jc] (a straight, Eight to Queen)
wolverstine collected $7.16 from pot
*** SUMMARY ***
Total pot $7.50 | Rake $0.34 
Board [Qc Ah 4h Th 8s]
Seat 1: lnfIame (small blind) folded on the Flop
Seat 2: EZEQUIEL.C10 (big blind) folded before Flop
Seat 3: wolverstine showed [9s Jc] and won ($7.16) with a straight, Eight to Queen
Seat 4: Wangritter13 folded before Flop (didn't bet)
Seat 5: sAsscha17 showed [Ad Tc] and lost with two pair, Aces and Tens
Seat 6: chris.nomf (button) folded before Flop (didn't bet)



PokerStars Hand #222980658220:  Hold'em No Limit ($0.05/$0.10 USD) - 2021/01/23 19:54:51 ET
Table 'Merope IV' 6-max Seat #1 is the button
Seat 1: lnfIame ($10.37 in chips) 
Seat 2: EZEQUIEL.C10 ($10.36 in chips) 
Seat 3: wolverstine ($11.19 in chips) 
Seat 4: Wangritter13 ($14.20 in chips) 
Seat 5: sAsscha17 ($2.38 in chips) 
Seat 6: chris.nomf ($9.85 in chips) 
EZEQUIEL.C10: posts small blind $0.05
wolverstine: posts big blind $0.10
*** HOLE CARDS ***
Wangritter13: folds 
sAsscha17: folds 
chris.nomf: raises $0.20 to $0.30
lnfIame: folds 
EZEQUIEL.C10: folds 
wolverstine: calls $0.20
*** FLOP *** [4c 7d 8h]
wolverstine: bets $0.20
chris.nomf: calls $0.20
*** TURN *** [4c 7d 8h] [Jc]
wolverstine: checks 
chris.nomf: checks 
*** RIVER *** [4c 7d 8h Jc] [6s]
sAsscha17 leaves the table
wolverstine: bets $0.50
chris.nomf: folds 
Uncalled bet ($0.50) returned to wolverstine
wolverstine collected $1 from pot
wolverstine: doesn't show hand 
*** SUMMARY ***
Total pot $1.05 | Rake $0.05 
Board [4c 7d 8h Jc 6s]
Seat 1: lnfIame (button) folded before Flop (didn't bet)
Seat 2: EZEQUIEL.C10 (small blind) folded before Flop
Seat 3: wolverstine (big blind) collected ($1)
Seat 4: Wangritter13 folded before Flop (didn't bet)
Seat 5: sAsscha17 folded before Flop (didn't bet)
Seat 6: chris.nomf folded on the River



PokerStars Hand #222980671652:  Hold'em No Limit ($0.05/$0.10 USD) - 2021/01/23 19:55:24 ET
Table 'Merope IV' 6-max Seat #2 is the button
Seat 1: lnfIame ($10.37 in chips) 
Seat 2: EZEQUIEL.C10 ($10.31 in chips) 
Seat 3: wolverstine ($11.69 in chips) 
Seat 4: Wangritter13 ($14.20 in chips) 
Seat 6: chris.nomf ($9.35 in chips) 
wolverstine: posts small blind $0.05
Wangritter13: posts big blind $0.10
*** HOLE CARDS ***
chris.nomf: folds 
lnfIame: raises $0.15 to $0.25
EZEQUIEL.C10: folds 
wolverstine: folds 
Wangritter13: calls $0.15
*** FLOP *** [As 7c 5s]
Wangritter13: checks 
lnfIame: bets $0.20
Wangritter13: calls $0.20
*** TURN *** [As 7c 5s] [5d]
Wangritter13: checks 
lnfIame: checks 
*** RIVER *** [As 7c 5s 5d] [4h]
Wangritter13: bets $0.71
KiraLasVegas joins the table at seat #5 
lnfIame: folds 
Uncalled bet ($0.71) returned to Wangritter13
Wangritter13 collected $0.91 from pot
Wangritter13: doesn't show hand 
*** SUMMARY ***
Total pot $0.95 | Rake $0.04 
Board [As 7c 5s 5d 4h]
Seat 1: lnfIame folded on the River
Seat 2: EZEQUIEL.C10 (button) folded before Flop (didn't bet)
Seat 3: wolverstine (small blind) folded before Flop
Seat 4: Wangritter13 (big blind) collected ($0.91)
Seat 6: chris.nomf folded before Flop (didn't bet)



PokerStars Hand #222980685366:  Hold'em No Limit ($0.05/$0.10 USD) - 2021/01/23 19:56:02 ET
Table 'Merope IV' 6-max Seat #3 is the button
Seat 1: lnfIame ($10 in chips) 
Seat 2: EZEQUIEL.C10 ($10.31 in chips) 
Seat 3: wolverstine ($11.64 in chips) 
Seat 4: Wangritter13 ($14.66 in chips) 
Seat 5: KiraLasVegas ($10.33 in chips) 
Seat 6: chris.nomf ($10 in chips) 
Wangritter13: posts small blind $0.05
KiraLasVegas: posts big blind $0.10
*** HOLE CARDS ***
chris.nomf: folds 
lnfIame: folds 
EZEQUIEL.C10: folds 
wolverstine: raises $0.10 to $0.20
Wangritter13: calls $0.15
KiraLasVegas: calls $0.10
*** FLOP *** [2h 5d 4h]
Wangritter13: checks 
KiraLasVegas: checks 
wolverstine: bets $0.30
Wangritter13: calls $0.30
KiraLasVegas: calls $0.30
*** TURN *** [2h 5d 4h] [Ks]
Wangritter13: checks 
KiraLasVegas: checks 
wolverstine: checks 
*** RIVER *** [2h 5d 4h Ks] [6c]
Wangritter13: bets $0.93
KiraLasVegas: calls $0.93
wolverstine: folds 
*** SHOW DOWN ***
Wangritter13: shows [Qh 8h] (high card King)
KiraLasVegas: shows [Kc 3h] (a straight, Deuce to Six)
KiraLasVegas collected $3.21 from pot
*** SUMMARY ***
Total pot $3.36 | Rake $0.15 
Board [2h 5d 4h Ks 6c]
Seat 1: lnfIame folded before Flop (didn't bet)
Seat 2: EZEQUIEL.C10 folded before Flop (didn't bet)
Seat 3: wolverstine (button) folded on the River
Seat 4: Wangritter13 (small blind) showed [Qh 8h] and lost with high card King
Seat 5: KiraLasVegas (big blind) showed [Kc 3h] and won ($3.21) with a straight, Deuce to Six
Seat 6: chris.nomf folded before Flop (didn't bet)



PokerStars Hand #222980703879:  Hold'em No Limit ($0.05/$0.10 USD) - 2021/01/23 19:56:53 ET
Table 'Merope IV' 6-max Seat #4 is the button
Seat 1: lnfIame ($10 in chips) 
Seat 2: EZEQUIEL.C10 ($10.31 in chips) 
Seat 3: wolverstine ($11.14 in chips) 
Seat 4: Wangritter13 ($13.23 in chips) 
Seat 5: KiraLasVegas ($12.11 in chips) 
Seat 6: chris.nomf ($10 in chips) 
KiraLasVegas: posts small blind $0.05
chris.nomf: posts big blind $0.10
*** HOLE CARDS ***
lnfIame: folds 
EZEQUIEL.C10: folds 
wolverstine: folds 
Wangritter13: folds 
KiraLasVegas: folds 
Uncalled bet ($0.05) returned to chris.nomf
chris.nomf collected $0.10 from pot
chris.nomf: doesn't show hand 
*** SUMMARY ***
Total pot $0.10 | Rake $0 
Seat 1: lnfIame folded before Flop (didn't bet)
Seat 2: EZEQUIEL.C10 folded before Flop (didn't bet)
Seat 3: wolverstine folded before Flop (didn't bet)
Seat 4: Wangritter13 (button) folded before Flop (didn't bet)
Seat 5: KiraLasVegas (small blind) folded before Flop
Seat 6: chris.nomf (big blind) collected ($0.10)



PokerStars Hand #222980708152:  Hold'em No Limit ($0.05/$0.10 USD) - 2021/01/23 19:57:04 ET
Table 'Merope IV' 6-max Seat #5 is the button
Seat 1: lnfIame ($10 in chips) 
Seat 2: EZEQUIEL.C10 ($10.31 in chips) 
Seat 4: Wangritter13 ($13.23 in chips) 
Seat 5: KiraLasVegas ($12.06 in chips) 
Seat 6: chris.nomf ($10.05 in chips) 
chris.nomf: posts small blind $0.05
lnfIame: posts big blind $0.10
*** HOLE CARDS ***
EZEQUIEL.C10: raises $0.20 to $0.30
Wangritter13: folds 
KiraLasVegas: folds 
chris.nomf: folds 
lnfIame: folds 
Uncalled bet ($0.20) returned to EZEQUIEL.C10
EZEQUIEL.C10 collected $0.25 from pot
EZEQUIEL.C10: doesn't show hand 
*** SUMMARY ***
Total pot $0.25 | Rake $0 
Seat 1: lnfIame (big blind) folded before Flop
Seat 2: EZEQUIEL.C10 collected ($0.25)
Seat 4: Wangritter13 folded before Flop (didn't bet)
Seat 5: KiraLasVegas (button) folded before Flop (didn't bet)
Seat 6: chris.nomf (small blind) folded before Flop



PokerStars Hand #222980715892:  Hold'em No Limit ($0.05/$0.10 USD) - 2021/01/23 19:57:26 ET
Table 'Merope IV' 6-max Seat #6 is the button
Seat 1: lnfIame ($10 in chips) 
Seat 2: EZEQUIEL.C10 ($10.46 in chips) 
Seat 4: Wangritter13 ($13.23 in chips) 
Seat 5: KiraLasVegas ($12.06 in chips) 
Seat 6: chris.nomf ($10 in chips) 
lnfIame: posts small blind $0.05
EZEQUIEL.C10: posts big blind $0.10
*** HOLE CARDS ***
Wangritter13: raises $0.10 to $0.20
KiraLasVegas: folds 
chris.nomf: folds 
lnfIame: folds 
EZEQUIEL.C10: folds 
Uncalled bet ($0.10) returned to Wangritter13
Wangritter13 collected $0.25 from pot
Wangritter13: doesn't show hand 
*** SUMMARY ***
Total pot $0.25 | Rake $0 
Seat 1: lnfIame (small blind) folded before Flop
Seat 2: EZEQUIEL.C10 (big blind) folded before Flop
Seat 4: Wangritter13 collected ($0.25)
Seat 5: KiraLasVegas folded before Flop (didn't bet)
Seat 6: chris.nomf (button) folded before Flop (didn't bet)



PokerStars Hand #222980725803:  Hold'em No Limit ($0.05/$0.10 USD) - 2021/01/23 19:57:53 ET
Table 'Merope IV' 6-max Seat #1 is the button
Seat 1: lnfIame ($10 in chips) 
Seat 2: EZEQUIEL.C10 ($10.36 in chips) 
Seat 4: Wangritter13 ($13.38 in chips) 
Seat 5: KiraLasVegas ($12.06 in chips) 
Seat 6: chris.nomf ($10 in chips) 
EZEQUIEL.C10: posts small blind $0.05
Wangritter13: posts big blind $0.10
*** HOLE CARDS ***
KiraLasVegas: folds 
chris.nomf: raises $0.20 to $0.30
lnfIame: folds 
EZEQUIEL.C10: folds 
KiraLasVegas leaves the table
Wangritter13: folds 
Uncalled bet ($0.20) returned to chris.nomf
chris.nomf collected $0.25 from pot
chris.nomf: doesn't show hand 
*** SUMMARY ***
Total pot $0.25 | Rake $0 
Seat 1: lnfIame (button) folded before Flop (didn't bet)
Seat 2: EZEQUIEL.C10 (small blind) folded before Flop
Seat 4: Wangritter13 (big blind) folded before Flop
Seat 5: KiraLasVegas folded before Flop (didn't bet)
Seat 6: chris.nomf collected ($0.25)



PokerStars Hand #222980729841:  Hold'em No Limit ($0.05/$0.10 USD) - 2021/01/23 19:58:05 ET
Table 'Merope IV' 6-max Seat #2 is the button
Seat 1: lnfIame ($10 in chips) 
Seat 2: EZEQUIEL.C10 ($10.31 in chips) 
Seat 4: Wangritter13 ($13.28 in chips) 
Seat 6: chris.nomf ($10.15 in chips) 
Wangritter13: posts small blind $0.05
chris.nomf: posts big blind $0.10
*** HOLE CARDS ***
lnfIame: folds 
VanCleef322 joins the table at seat #5 
EZEQUIEL.C10: raises $0.20 to $0.30
Wangritter13: folds 
chris.nomf: folds 
Uncalled bet ($0.20) returned to EZEQUIEL.C10
EZEQUIEL.C10 collected $0.25 from pot
EZEQUIEL.C10: doesn't show hand 
*** SUMMARY ***
Total pot $0.25 | Rake $0 
Seat 1: lnfIame folded before Flop (didn't bet)
Seat 2: EZEQUIEL.C10 (button) collected ($0.25)
Seat 4: Wangritter13 (small blind) folded before Flop
Seat 6: chris.nomf (big blind) folded before Flop



PokerStars Hand #222980733095:  Hold'em No Limit ($0.05/$0.10 USD) - 2021/01/23 19:58:14 ET
Table 'Merope IV' 6-max Seat #4 is the button
Seat 1: lnfIame ($10 in chips) 
Seat 2: EZEQUIEL.C10 ($10.46 in chips) 
Seat 4: Wangritter13 ($13.23 in chips) 
Seat 6: chris.nomf ($10.05 in chips) 
chris.nomf: posts small blind $0.05
lnfIame: posts big blind $0.10
*** HOLE CARDS ***
EZEQUIEL.C10: folds 
Wangritter13: folds 
chris.nomf: calls $0.05
lnfIame: raises $0.30 to $0.40
chris.nomf: calls $0.30
*** FLOP *** [5h Ah 5s]
chris.nomf: checks 
lnfIame: bets $0.25
chris.nomf: folds 
Uncalled bet ($0.25) returned to lnfIame
lnfIame collected $0.76 from pot
lnfIame: doesn't show hand 
*** SUMMARY ***
Total pot $0.80 | Rake $0.04 
Board [5h Ah 5s]
Seat 1: lnfIame (big blind) collected ($0.76)
Seat 2: EZEQUIEL.C10 folded before Flop (didn't bet)
Seat 4: Wangritter13 (button) folded before Flop (didn't bet)
Seat 6: chris.nomf (small blind) folded on the Flop



PokerStars Hand #222980741295:  Hold'em No Limit ($0.05/$0.10 USD) - 2021/01/23 19:58:37 ET
Table 'Merope IV' 6-max Seat #6 is the button
Seat 1: lnfIame ($10.36 in chips) 
Seat 2: EZEQUIEL.C10 ($10.46 in chips) 
Seat 3: wolverstine ($11.14 in chips) 
Seat 4: Wangritter13 ($13.23 in chips) 
Seat 6: chris.nomf ($9.65 in chips) 
lnfIame: posts small blind $0.05
EZEQUIEL.C10: posts big blind $0.10
wolverstine: posts small & big blinds $0.15
VanCleef322: sits out 
*** HOLE CARDS ***
wolverstine: checks 
Wangritter13: folds 
chris.nomf: folds 
lnfIame: folds 
EZEQUIEL.C10: checks 
*** FLOP *** [Ac Ts Qc]
EZEQUIEL.C10: checks 
wolverstine: bets $0.15
EZEQUIEL.C10: folds 
Uncalled bet ($0.15) returned to wolverstine
wolverstine collected $0.29 from pot
wolverstine: doesn't show hand 
*** SUMMARY ***
Total pot $0.30 | Rake $0.01 
Board [Ac Ts Qc]
Seat 1: lnfIame (small blind) folded before Flop
Seat 2: EZEQUIEL.C10 (big blind) folded on the Flop
Seat 3: wolverstine collected ($0.29)
Seat 4: Wangritter13 folded before Flop (didn't bet)
Seat 6: chris.nomf (button) folded before Flop (didn't bet)



PokerStars Hand #222980753320:  Hold'em No Limit ($0.05/$0.10 USD) - 2021/01/23 19:59:10 ET
Table 'Merope IV' 6-max Seat #1 is the button
Seat 1: lnfIame ($10.31 in chips) 
Seat 2: EZEQUIEL.C10 ($10.36 in chips) 
Seat 3: wolverstine ($11.28 in chips) 
Seat 4: Wangritter13 ($13.23 in chips) 
Seat 6: chris.nomf ($10 in chips) 
EZEQUIEL.C10: posts small blind $0.05
wolverstine: posts big blind $0.10
VanCleef322: sits out 
*** HOLE CARDS ***
Wangritter13: raises $0.10 to $0.20
chris.nomf: calls $0.20
lnfIame: folds 
EZEQUIEL.C10: folds 
wolverstine: folds 
*** FLOP *** [Th 7c 6s]
Wangritter13: bets $0.30
chris.nomf: folds 
Uncalled bet ($0.30) returned to Wangritter13
Wangritter13 collected $0.53 from pot
Wangritter13: doesn't show hand 
*** SUMMARY ***
Total pot $0.55 | Rake $0.02 
Board [Th 7c 6s]
Seat 1: lnfIame (button) folded before Flop (didn't bet)
Seat 2: EZEQUIEL.C10 (small blind) folded before Flop
Seat 3: wolverstine (big blind) folded before Flop
Seat 4: Wangritter13 collected ($0.53)
Seat 6: chris.nomf folded on the Flop



PokerStars Hand #222980763486:  Hold'em No Limit ($0.05/$0.10 USD) - 2021/01/23 19:59:38 ET
Table 'Merope IV' 6-max Seat #2 is the button
Seat 1: lnfIame ($10.31 in chips) 
Seat 2: EZEQUIEL.C10 ($10.31 in chips) 
Seat 3: wolverstine ($11.18 in chips) 
Seat 4: Wangritter13 ($13.56 in chips) 
Seat 6: chris.nomf ($9.80 in chips) 
wolverstine: posts small blind $0.05
Wangritter13: posts big blind $0.10
VanCleef322: sits out 
*** HOLE CARDS ***
chris.nomf: folds 
lnfIame: folds 
EZEQUIEL.C10: folds 
wolverstine: folds 
Uncalled bet ($0.05) returned to Wangritter13
Wangritter13 collected $0.10 from pot
Wangritter13: doesn't show hand 
*** SUMMARY ***
Total pot $0.10 | Rake $0 
Seat 1: lnfIame folded before Flop (didn't bet)
Seat 2: EZEQUIEL.C10 (button) folded before Flop (didn't bet)
Seat 3: wolverstine (small blind) folded before Flop
Seat 4: Wangritter13 (big blind) collected ($0.10)
Seat 6: chris.nomf folded before Flop (didn't bet)



PokerStars Hand #222980766028:  Hold'em No Limit ($0.05/$0.10 USD) - 2021/01/23 19:59:44 ET
Table 'Merope IV' 6-max Seat #3 is the button
Seat 1: lnfIame ($10.31 in chips) 
Seat 2: EZEQUIEL.C10 ($10.31 in chips) 
Seat 3: wolverstine ($11.13 in chips) 
Seat 4: Wangritter13 ($13.61 in chips) 
Seat 5: VanCleef322 ($10 in chips) 
Seat 6: chris.nomf ($9.80 in chips) 
Wangritter13: posts small blind $0.05
VanCleef322: posts big blind $0.10
*** HOLE CARDS ***
chris.nomf: folds 
lnfIame: folds 
EZEQUIEL.C10: raises $0.20 to $0.30
wolverstine: folds 
Wangritter13: calls $0.25
VanCleef322: folds 
*** FLOP *** [9d 5s Td]
Wangritter13: checks 
EZEQUIEL.C10: checks 
*** TURN *** [9d 5s Td] [8c]
Wangritter13: bets $0.23
EZEQUIEL.C10: calls $0.23
*** RIVER *** [9d 5s Td 8c] [Jd]
Wangritter13: bets $0.45
EZEQUIEL.C10: calls $0.45
*** SHOW DOWN ***
Wangritter13: shows [Ad 4c] (high card Ace)
EZEQUIEL.C10: shows [7h 9h] (a straight, Seven to Jack)
EZEQUIEL.C10 collected $1.97 from pot
*** SUMMARY ***
Total pot $2.06 | Rake $0.09 
Board [9d 5s Td 8c Jd]
Seat 1: lnfIame folded before Flop (didn't bet)
Seat 2: EZEQUIEL.C10 showed [7h 9h] and won ($1.97) with a straight, Seven to Jack
Seat 3: wolverstine (button) folded before Flop (didn't bet)
Seat 4: Wangritter13 (small blind) showed [Ad 4c] and lost with high card Ace
Seat 5: VanCleef322 (big blind) folded before Flop
Seat 6: chris.nomf folded before Flop (didn't bet)



PokerStars Hand #222980793064:  Hold'em No Limit ($0.05/$0.10 USD) - 2021/01/23 20:00:52 ET
Table 'Merope IV' 6-max Seat #4 is the button
Seat 1: lnfIame ($10.31 in chips) 
Seat 2: EZEQUIEL.C10 ($11.30 in chips) 
Seat 3: wolverstine ($11.13 in chips) 
Seat 4: Wangritter13 ($12.63 in chips) 
Seat 5: VanCleef322 ($10 in chips) 
Seat 6: chris.nomf ($10 in chips) 
VanCleef322: posts small blind $0.05
chris.nomf: posts big blind $0.10
*** HOLE CARDS ***
lnfIame: folds 
EZEQUIEL.C10: folds 
wolverstine: raises $0.10 to $0.20
Wangritter13: folds 
VanCleef322: folds 
chris.nomf: folds 
Uncalled bet ($0.10) returned to wolverstine
wolverstine collected $0.25 from pot
wolverstine: doesn't show hand 
*** SUMMARY ***
Total pot $0.25 | Rake $0 
Seat 1: lnfIame folded before Flop (didn't bet)
Seat 2: EZEQUIEL.C10 folded before Flop (didn't bet)
Seat 3: wolverstine collected ($0.25)
Seat 4: Wangritter13 (button) folded before Flop (didn't bet)
Seat 5: VanCleef322 (small blind) folded before Flop
Seat 6: chris.nomf (big blind) folded before Flop



PokerStars Hand #222980797815:  Hold'em No Limit ($0.05/$0.10 USD) - 2021/01/23 20:01:03 ET
Table 'Merope IV' 6-max Seat #5 is the button
Seat 1: lnfIame ($10.31 in chips) 
Seat 2: EZEQUIEL.C10 ($11.30 in chips) 
Seat 3: wolverstine ($11.28 in chips) 
Seat 4: Wangritter13 ($12.63 in chips) 
Seat 5: VanCleef322 ($10 in chips) 
Seat 6: chris.nomf ($9.90 in chips) 
chris.nomf: posts small blind $0.05
lnfIame: posts big blind $0.10
*** HOLE CARDS ***
EZEQUIEL.C10: folds 
wolverstine: calls $0.10
Wangritter13: folds 
VanCleef322: raises $0.30 to $0.40
chris.nomf: folds 
lnfIame: folds 
wolverstine: folds 
Uncalled bet ($0.30) returned to VanCleef322
VanCleef322 collected $0.35 from pot
VanCleef322: doesn't show hand 
*** SUMMARY ***
Total pot $0.35 | Rake $0 
Seat 1: lnfIame (big blind) folded before Flop
Seat 2: EZEQUIEL.C10 folded before Flop (didn't bet)
Seat 3: wolverstine folded before Flop
Seat 4: Wangritter13 folded before Flop (didn't bet)
Seat 5: VanCleef322 (button) collected ($0.35)
Seat 6: chris.nomf (small blind) folded before Flop



PokerStars Hand #222980804134:  Hold'em No Limit ($0.05/$0.10 USD) - 2021/01/23 20:01:18 ET
Table 'Merope IV' 6-max Seat #6 is the button
Seat 1: lnfIame ($10.21 in chips) 
Seat 2: EZEQUIEL.C10 ($11.30 in chips) 
Seat 3: wolverstine ($11.18 in chips) 
Seat 4: Wangritter13 ($12.63 in chips) 
Seat 5: VanCleef322 ($10.25 in chips) 
Seat 6: chris.nomf ($9.85 in chips) 
lnfIame: posts small blind $0.05
EZEQUIEL.C10: posts big blind $0.10
*** HOLE CARDS ***
wolverstine: calls $0.10
Wangritter13: folds 
VanCleef322: folds 
chris.nomf: calls $0.10
lnfIame: folds 
EZEQUIEL.C10: raises $0.50 to $0.60
wolverstine: calls $0.50
chris.nomf: folds 
*** FLOP *** [Qh 3d 5h]
EZEQUIEL.C10: checks 
wolverstine: checks 
*** TURN *** [Qh 3d 5h] [6h]
EZEQUIEL.C10: checks 
wolverstine: checks 
*** RIVER *** [Qh 3d 5h 6h] [Js]
EZEQUIEL.C10: bets $0.60
wolverstine: calls $0.60
*** SHOW DOWN ***
EZEQUIEL.C10: shows [Kd Jd] (a pair of Jacks)
wolverstine: mucks hand 
EZEQUIEL.C10 collected $2.44 from pot
*** SUMMARY ***
Total pot $2.55 | Rake $0.11 
Board [Qh 3d 5h 6h Js]
Seat 1: lnfIame (small blind) folded before Flop
Seat 2: EZEQUIEL.C10 (big blind) showed [Kd Jd] and won ($2.44) with a pair of Jacks
Seat 3: wolverstine mucked
Seat 4: Wangritter13 folded before Flop (didn't bet)
Seat 5: VanCleef322 folded before Flop (didn't bet)
Seat 6: chris.nomf (button) folded before Flop



PokerStars Hand #222980828165:  Hold'em No Limit ($0.05/$0.10 USD) - 2021/01/23 20:02:11 ET
Table 'Merope IV' 6-max Seat #1 is the button
Seat 1: lnfIame ($10.16 in chips) 
Seat 2: EZEQUIEL.C10 ($12.54 in chips) 
Seat 3: wolverstine ($9.98 in chips) 
Seat 4: Wangritter13 ($12.63 in chips) 
Seat 5: VanCleef322 ($10.25 in chips) 
Seat 6: chris.nomf ($10 in chips) 
EZEQUIEL.C10: posts small blind $0.05
wolverstine: posts big blind $0.10
*** HOLE CARDS ***
Wangritter13: raises $0.10 to $0.20
VanCleef322: raises $0.50 to $0.70
chris.nomf: folds 
lnfIame: folds 
EZEQUIEL.C10: folds 
wolverstine: folds 
Wangritter13: folds 
Uncalled bet ($0.50) returned to VanCleef322
VanCleef322 collected $0.55 from pot
VanCleef322: doesn't show hand 
*** SUMMARY ***
Total pot $0.55 | Rake $0 
Seat 1: lnfIame (button) folded before Flop (didn't bet)
Seat 2: EZEQUIEL.C10 (small blind) folded before Flop
Seat 3: wolverstine (big blind) folded before Flop
Seat 4: Wangritter13 folded before Flop
Seat 5: VanCleef322 collected ($0.55)
Seat 6: chris.nomf folded before Flop (didn't bet)



PokerStars Hand #222980836539:  Hold'em No Limit ($0.05/$0.10 USD) - 2021/01/23 20:02:29 ET
Table 'Merope IV' 6-max Seat #2 is the button
Seat 1: lnfIame ($10.16 in chips) 
Seat 2: EZEQUIEL.C10 ($12.49 in chips) 
Seat 3: wolverstine ($9.88 in chips) 
Seat 4: Wangritter13 ($12.43 in chips) 
Seat 5: VanCleef322 ($10.60 in chips) 
Seat 6: chris.nomf ($10 in chips) 
wolverstine: posts small blind $0.05
Wangritter13: posts big blind $0.10
*** HOLE CARDS ***
VanCleef322: folds 
chris.nomf: folds 
lnfIame: folds 
EZEQUIEL.C10: raises $0.15 to $0.25
wolverstine: calls $0.20
Wangritter13: folds 
*** FLOP *** [Ah 9s 9h]
wolverstine: checks 
EZEQUIEL.C10: bets $0.20
wolverstine: folds 
Uncalled bet ($0.20) returned to EZEQUIEL.C10
EZEQUIEL.C10 collected $0.57 from pot
EZEQUIEL.C10: doesn't show hand 
*** SUMMARY ***
Total pot $0.60 | Rake $0.03 
Board [Ah 9s 9h]
Seat 1: lnfIame folded before Flop (didn't bet)
Seat 2: EZEQUIEL.C10 (button) collected ($0.57)
Seat 3: wolverstine (small blind) folded on the Flop
Seat 4: Wangritter13 (big blind) folded before Flop
Seat 5: VanCleef322 folded before Flop (didn't bet)
Seat 6: chris.nomf folded before Flop (didn't bet)



PokerStars Hand #222980850270:  Hold'em No Limit ($0.05/$0.10 USD) - 2021/01/23 20:03:00 ET
Table 'Merope IV' 6-max Seat #3 is the button
Seat 1: lnfIame ($10.16 in chips) 
Seat 2: EZEQUIEL.C10 ($12.81 in chips) 
Seat 3: wolverstine ($9.63 in chips) 
Seat 4: Wangritter13 ($12.33 in chips) 
Seat 5: VanCleef322 ($10.60 in chips) 
Seat 6: chris.nomf ($10 in chips) 
Wangritter13: posts small blind $0.05
VanCleef322: posts big blind $0.10
*** HOLE CARDS ***
chris.nomf: folds 
lnfIame: folds 
EZEQUIEL.C10: folds 
wolverstine: folds 
Wangritter13: calls $0.05
VanCleef322: raises $0.20 to $0.30
Wangritter13: calls $0.20
*** FLOP *** [Jh 8d Qc]
Wangritter13: checks 
VanCleef322: bets $0.29
Wangritter13: calls $0.29
*** TURN *** [Jh 8d Qc] [9d]
Wangritter13: checks 
VanCleef322: bets $0.75
Wangritter13: folds 
Uncalled bet ($0.75) returned to VanCleef322
VanCleef322 collected $1.13 from pot
VanCleef322: doesn't show hand 
*** SUMMARY ***
Total pot $1.18 | Rake $0.05 
Board [Jh 8d Qc 9d]
Seat 1: lnfIame folded before Flop (didn't bet)
Seat 2: EZEQUIEL.C10 folded before Flop (didn't bet)
Seat 3: wolverstine (button) folded before Flop (didn't bet)
Seat 4: Wangritter13 (small blind) folded on the Turn
Seat 5: VanCleef322 (big blind) collected ($1.13)
Seat 6: chris.nomf folded before Flop (didn't bet)



PokerStars Hand #222980866363:  Hold'em No Limit ($0.05/$0.10 USD) - 2021/01/23 20:03:28 ET
Table 'Merope IV' 6-max Seat #4 is the button
Seat 1: lnfIame ($10.16 in chips) 
Seat 2: EZEQUIEL.C10 ($12.81 in chips) 
Seat 3: wolverstine ($9.63 in chips) 
Seat 4: Wangritter13 ($11.74 in chips) 
Seat 5: VanCleef322 ($11.14 in chips) 
Seat 6: chris.nomf ($10 in chips) 
VanCleef322: posts small blind $0.05
chris.nomf: posts big blind $0.10
*** HOLE CARDS ***
lnfIame: folds 
EZEQUIEL.C10: folds 
wolverstine: folds 
Wangritter13: folds 
VanCleef322: raises $0.15 to $0.25
chris.nomf: folds 
Uncalled bet ($0.15) returned to VanCleef322
VanCleef322 collected $0.20 from pot
VanCleef322: doesn't show hand 
*** SUMMARY ***
Total pot $0.20 | Rake $0 
Seat 1: lnfIame folded before Flop (didn't bet)
Seat 2: EZEQUIEL.C10 folded before Flop (didn't bet)
Seat 3: wolverstine folded before Flop (didn't bet)
Seat 4: Wangritter13 (button) folded before Flop (didn't bet)
Seat 5: VanCleef322 (small blind) collected ($0.20)
Seat 6: chris.nomf (big blind) folded before Flop



PokerStars Hand #222980876885:  Hold'em No Limit ($0.05/$0.10 USD) - 2021/01/23 20:03:50 ET
Table 'Merope IV' 6-max Seat #5 is the button
Seat 1: lnfIame ($10.16 in chips) 
Seat 2: EZEQUIEL.C10 ($12.81 in chips) 
Seat 4: Wangritter13 ($11.74 in chips) 
Seat 5: VanCleef322 ($11.24 in chips) 
Seat 6: chris.nomf ($9.90 in chips) 
chris.nomf: posts small blind $0.05
lnfIame: posts big blind $0.10
*** HOLE CARDS ***
EZEQUIEL.C10: raises $0.20 to $0.30
Wangritter13: folds 
VanCleef322: folds 
chris.nomf: folds 
lnfIame: raises $0.70 to $1
EZEQUIEL.C10: calls $0.70
*** FLOP *** [Ks 4s 8h]
lnfIame: bets $1
EZEQUIEL.C10: calls $1
*** TURN *** [Ks 4s 8h] [4h]
lnfIame: bets $2
EZEQUIEL.C10: calls $2
*** RIVER *** [Ks 4s 8h 4h] [8d]
lnfIame: bets $6.16 and is all-in
EZEQUIEL.C10: folds 
Uncalled bet ($6.16) returned to lnfIame
lnfIame collected $7.69 from pot
lnfIame: doesn't show hand 
*** SUMMARY ***
Total pot $8.05 | Rake $0.36 
Board [Ks 4s 8h 4h 8d]
Seat 1: lnfIame (big blind) collected ($7.69)
Seat 2: EZEQUIEL.C10 folded on the River
Seat 4: Wangritter13 folded before Flop (didn't bet)
Seat 5: VanCleef322 (button) folded before Flop (didn't bet)
Seat 6: chris.nomf (small blind) folded before Flop



PokerStars Hand #222980909233:  Hold'em No Limit ($0.05/$0.10 USD) - 2021/01/23 20:04:47 ET
Table 'Merope IV' 6-max Seat #6 is the button
Seat 1: lnfIame ($13.85 in chips) 
Seat 2: EZEQUIEL.C10 ($8.81 in chips) 
Seat 3: wolverstine ($9.63 in chips) 
Seat 4: Wangritter13 ($11.74 in chips) 
Seat 5: VanCleef322 ($11.24 in chips) 
Seat 6: chris.nomf ($9.85 in chips) 
lnfIame: posts small blind $0.05
EZEQUIEL.C10: posts big blind $0.10
*** HOLE CARDS ***
wolverstine: raises $0.10 to $0.20
Wangritter13: calls $0.20
VanCleef322: folds 
chris.nomf: folds 
lnfIame: folds 
EZEQUIEL.C10: folds 
*** FLOP *** [Tc 3d 9s]
wolverstine: bets $0.30
Wangritter13: calls $0.30
*** TURN *** [Tc 3d 9s] [8d]
wolverstine: bets $0.60
Wangritter13: calls $0.60
*** RIVER *** [Tc 3d 9s 8d] [Jd]
wolverstine: bets $1.12
Wangritter13: raises $2.24 to $3.36
wolverstine: folds 
Uncalled bet ($2.24) returned to Wangritter13
Wangritter13 collected $4.38 from pot
Wangritter13: doesn't show hand 
*** SUMMARY ***
Total pot $4.59 | Rake $0.21 
Board [Tc 3d 9s 8d Jd]
Seat 1: lnfIame (small blind) folded before Flop
Seat 2: EZEQUIEL.C10 (big blind) folded before Flop
Seat 3: wolverstine folded on the River
Seat 4: Wangritter13 collected ($4.38)
Seat 5: VanCleef322 folded before Flop (didn't bet)
Seat 6: chris.nomf (button) folded before Flop (didn't bet)



PokerStars Hand #222980940108:  Hold'em No Limit ($0.05/$0.10 USD) - 2021/01/23 20:05:53 ET
Table 'Merope IV' 6-max Seat #1 is the button
Seat 1: lnfIame ($13.80 in chips) 
Seat 2: EZEQUIEL.C10 ($8.71 in chips) 
Seat 3: wolverstine ($7.41 in chips) 
Seat 4: Wangritter13 ($13.90 in chips) 
Seat 5: VanCleef322 ($11.24 in chips) 
Seat 6: chris.nomf ($9.85 in chips) 
EZEQUIEL.C10: posts small blind $0.05
wolverstine: posts big blind $0.10
*** HOLE CARDS ***
Wangritter13: folds 
VanCleef322: folds 
chris.nomf: raises $0.20 to $0.30
lnfIame: folds 
EZEQUIEL.C10: folds 
wolverstine: folds 
Uncalled bet ($0.20) returned to chris.nomf
chris.nomf collected $0.25 from pot
chris.nomf: doesn't show hand 
*** SUMMARY ***
Total pot $0.25 | Rake $0 
Seat 1: lnfIame (button) folded before Flop (didn't bet)
Seat 2: EZEQUIEL.C10 (small blind) folded before Flop
Seat 3: wolverstine (big blind) folded before Flop
Seat 4: Wangritter13 folded before Flop (didn't bet)
Seat 5: VanCleef322 folded before Flop (didn't bet)
Seat 6: chris.nomf collected ($0.25)



PokerStars Hand #222980948092:  Hold'em No Limit ($0.05/$0.10 USD) - 2021/01/23 20:06:11 ET
Table 'Merope IV' 6-max Seat #2 is the button
Seat 1: lnfIame ($13.80 in chips) 
Seat 2: EZEQUIEL.C10 ($8.66 in chips) 
Seat 3: wolverstine ($7.31 in chips) 
Seat 4: Wangritter13 ($13.90 in chips) 
Seat 5: VanCleef322 ($11.24 in chips) 
Seat 6: chris.nomf ($10 in chips) 
wolverstine: posts small blind $0.05
Wangritter13: posts big blind $0.10
*** HOLE CARDS ***
VanCleef322: folds 
chris.nomf: calls $0.10
lnfIame: folds 
EZEQUIEL.C10: folds 
wolverstine: raises $0.10 to $0.20
Wangritter13: calls $0.10
chris.nomf: calls $0.10
*** FLOP *** [4h 4s 7c]
wolverstine: checks 
Wangritter13: checks 
chris.nomf: bets $0.29
wolverstine: folds 
Wangritter13: calls $0.29
*** TURN *** [4h 4s 7c] [9c]
Wangritter13: checks 
chris.nomf: checks 
*** RIVER *** [4h 4s 7c 9c] [6c]
Wangritter13: bets $0.46
chris.nomf: calls $0.46
*** SHOW DOWN ***
Wangritter13: shows [4d Qd] (three of a kind, Fours)
chris.nomf: mucks hand 
Wangritter13 collected $2.01 from pot
*** SUMMARY ***
Total pot $2.10 | Rake $0.09 
Board [4h 4s 7c 9c 6c]
Seat 1: lnfIame folded before Flop (didn't bet)
Seat 2: EZEQUIEL.C10 (button) folded before Flop (didn't bet)
Seat 3: wolverstine (small blind) folded on the Flop
Seat 4: Wangritter13 (big blind) showed [4d Qd] and won ($2.01) with three of a kind, Fours
Seat 5: VanCleef322 folded before Flop (didn't bet)
Seat 6: chris.nomf mucked



PokerStars Hand #222980966576:  Hold'em No Limit ($0.05/$0.10 USD) - 2021/01/23 20:06:51 ET
Table 'Merope IV' 6-max Seat #3 is the button
Seat 1: lnfIame ($13.80 in chips) 
Seat 2: EZEQUIEL.C10 ($8.66 in chips) 
Seat 3: wolverstine ($7.11 in chips) 
Seat 4: Wangritter13 ($14.96 in chips) 
Seat 5: VanCleef322 ($11.24 in chips) 
Seat 6: chris.nomf ($9.05 in chips) 
Wangritter13: posts small blind $0.05
VanCleef322: posts big blind $0.10
*** HOLE CARDS ***
chris.nomf: folds 
lnfIame: raises $0.15 to $0.25
EZEQUIEL.C10: calls $0.25
wolverstine: folds 
Wangritter13: calls $0.20
VanCleef322: calls $0.15
*** FLOP *** [Ts Qd 7s]
Wangritter13: checks 
VanCleef322: checks 
lnfIame: checks 
EZEQUIEL.C10: checks 
*** TURN *** [Ts Qd 7s] [7c]
Wangritter13: checks 
VanCleef322: checks 
lnfIame: bets $0.50
EZEQUIEL.C10: folds 
Wangritter13: folds 
VanCleef322: folds 
Uncalled bet ($0.50) returned to lnfIame
lnfIame collected $0.96 from pot
lnfIame: doesn't show hand 
*** SUMMARY ***
Total pot $1 | Rake $0.04 
Board [Ts Qd 7s 7c]
Seat 1: lnfIame collected ($0.96)
Seat 2: EZEQUIEL.C10 folded on the Turn
Seat 3: wolverstine (button) folded before Flop (didn't bet)
Seat 4: Wangritter13 (small blind) folded on the Turn
Seat 5: VanCleef322 (big blind) folded on the Turn
Seat 6: chris.nomf folded before Flop (didn't bet)



PokerStars Hand #222981001431:  Hold'em No Limit ($0.05/$0.10 USD) - 2021/01/23 20:08:06 ET
Table 'Merope IV' 6-max Seat #4 is the button
Seat 1: lnfIame ($14.51 in chips) 
Seat 2: EZEQUIEL.C10 ($8.41 in chips) 
Seat 3: wolverstine ($7.11 in chips) 
Seat 4: Wangritter13 ($14.71 in chips) 
Seat 5: VanCleef322 ($10.99 in chips) 
Seat 6: chris.nomf ($10 in chips) 
VanCleef322: posts small blind $0.05
chris.nomf: posts big blind $0.10
*** HOLE CARDS ***
lnfIame: folds 
EZEQUIEL.C10: folds 
wolverstine: folds 
Wangritter13: folds 
VanCleef322: raises $0.15 to $0.25
chris.nomf: calls $0.15
*** FLOP *** [Kd Ah Th]
VanCleef322: checks 
chris.nomf: checks 
*** TURN *** [Kd Ah Th] [9d]
VanCleef322: bets $0.24
chris.nomf: calls $0.24
*** RIVER *** [Kd Ah Th 9d] [4s]
EZEQUIEL.C10 leaves the table
VanCleef322: checks 
chris.nomf: checks 
*** SHOW DOWN ***
VanCleef322: shows [Ac 5h] (a pair of Aces)
chris.nomf: mucks hand 
VanCleef322 collected $0.94 from pot
*** SUMMARY ***
Total pot $0.98 | Rake $0.04 
Board [Kd Ah Th 9d 4s]
Seat 1: lnfIame folded before Flop (didn't bet)
Seat 2: EZEQUIEL.C10 folded before Flop (didn't bet)
Seat 3: wolverstine folded before Flop (didn't bet)
Seat 4: Wangritter13 (button) folded before Flop (didn't bet)
Seat 5: VanCleef322 (small blind) showed [Ac 5h] and won ($0.94) with a pair of Aces
Seat 6: chris.nomf (big blind) mucked



PokerStars Hand #222981023670:  Hold'em No Limit ($0.05/$0.10 USD) - 2021/01/23 20:08:34 ET
Table 'Merope IV' 6-max Seat #5 is the button
Seat 1: lnfIame ($14.51 in chips) 
Seat 3: wolverstine ($7.11 in chips) 
Seat 4: Wangritter13 ($14.71 in chips) 
Seat 5: VanCleef322 ($11.44 in chips) 
Seat 6: chris.nomf ($9.51 in chips) 
chris.nomf: posts small blind $0.05
lnfIame: posts big blind $0.10
*** HOLE CARDS ***
wolverstine: folds 
Wangritter13: raises $0.10 to $0.20
VanCleef322: folds 
chris.nomf: folds 
lnfIame: calls $0.10
*** FLOP *** [7d Ts 3c]
lnfIame: checks 
Wangritter13: bets $0.21
lnfIame: folds 
Uncalled bet ($0.21) returned to Wangritter13
Wangritter13 collected $0.43 from pot
Wangritter13: doesn't show hand 
*** SUMMARY ***
Total pot $0.45 | Rake $0.02 
Board [7d Ts 3c]
Seat 1: lnfIame (big blind) folded on the Flop
Seat 3: wolverstine folded before Flop (didn't bet)
Seat 4: Wangritter13 collected ($0.43)
Seat 5: VanCleef322 (button) folded before Flop (didn't bet)
Seat 6: chris.nomf (small blind) folded before Flop



PokerStars Hand #222981036584:  Hold'em No Limit ($0.05/$0.10 USD) - 2021/01/23 20:09:02 ET
Table 'Merope IV' 6-max Seat #6 is the button
Seat 1: lnfIame ($14.31 in chips) 
Seat 3: wolverstine ($7.11 in chips) 
Seat 4: Wangritter13 ($14.94 in chips) 
Seat 5: VanCleef322 ($11.44 in chips) 
Seat 6: chris.nomf ($9.46 in chips) 
lnfIame: posts small blind $0.05
wolverstine: posts big blind $0.10
*** HOLE CARDS ***
Wangritter13: folds 
VanCleef322: folds 
chris.nomf: raises $0.20 to $0.30
lnfIame: folds 
wolverstine: calls $0.20
*** FLOP *** [7s Kh 3s]
wolverstine: checks 
chris.nomf: bets $0.31
wolverstine: folds 
Uncalled bet ($0.31) returned to chris.nomf
chris.nomf collected $0.62 from pot
chris.nomf: doesn't show hand 
*** SUMMARY ***
Total pot $0.65 | Rake $0.03 
Board [7s Kh 3s]
Seat 1: lnfIame (small blind) folded before Flop
Seat 3: wolverstine (big blind) folded on the Flop
Seat 4: Wangritter13 folded before Flop (didn't bet)
Seat 5: VanCleef322 folded before Flop (didn't bet)
Seat 6: chris.nomf (button) collected ($0.62)



PokerStars Hand #222981047407:  Hold'em No Limit ($0.05/$0.10 USD) - 2021/01/23 20:09:26 ET
Table 'Merope IV' 6-max Seat #1 is the button
Seat 1: lnfIame ($14.26 in chips) 
Seat 3: wolverstine ($6.81 in chips) 
Seat 4: Wangritter13 ($14.94 in chips) 
Seat 5: VanCleef322 ($11.44 in chips) 
Seat 6: chris.nomf ($9.78 in chips) 
wolverstine: posts small blind $0.05
Wangritter13: posts big blind $0.10
*** HOLE CARDS ***
VanCleef322: folds 
chris.nomf: raises $0.20 to $0.30
lnfIame: folds 
wolverstine: folds 
Wangritter13: calls $0.20
*** FLOP *** [Jh Kd 2h]
Wangritter13: checks 
chris.nomf: checks 
*** TURN *** [Jh Kd 2h] [9d]
Wangritter13: checks 
chris.nomf: checks 
*** RIVER *** [Jh Kd 2h 9d] [7c]
Wangritter13: checks 
chris.nomf: checks 
*** SHOW DOWN ***
Wangritter13: shows [4s 4h] (a pair of Fours)
chris.nomf: shows [Th Td] (a pair of Tens)
chris.nomf collected $0.62 from pot
*** SUMMARY ***
Total pot $0.65 | Rake $0.03 
Board [Jh Kd 2h 9d 7c]
Seat 1: lnfIame (button) folded before Flop (didn't bet)
Seat 3: wolverstine (small blind) folded before Flop
Seat 4: Wangritter13 (big blind) showed [4s 4h] and lost with a pair of Fours
Seat 5: VanCleef322 folded before Flop (didn't bet)
Seat 6: chris.nomf showed [Th Td] and won ($0.62) with a pair of Tens



PokerStars Hand #222981059569:  Hold'em No Limit ($0.05/$0.10 USD) - 2021/01/23 20:09:53 ET
Table 'Merope IV' 6-max Seat #3 is the button
Seat 1: lnfIame ($14.26 in chips) 
Seat 3: wolverstine ($6.76 in chips) 
Seat 4: Wangritter13 ($14.64 in chips) 
Seat 5: VanCleef322 ($11.44 in chips) 
Seat 6: chris.nomf ($10.10 in chips) 
Wangritter13: posts small blind $0.05
VanCleef322: posts big blind $0.10
*** HOLE CARDS ***
chris.nomf: folds 
lnfIame: folds 
wolverstine: folds 
Wangritter13: calls $0.05
VanCleef322: checks 
*** FLOP *** [Ac Ad 6h]
Stengel07 joins the table at seat #2 
Wangritter13: checks 
VanCleef322: checks 
*** TURN *** [Ac Ad 6h] [3h]
Wangritter13: checks 
VanCleef322: checks 
*** RIVER *** [Ac Ad 6h 3h] [2s]
Wangritter13: checks 
VanCleef322: checks 
*** SHOW DOWN ***
Wangritter13: shows [5h Kh] (a pair of Aces)
VanCleef322: mucks hand 
Wangritter13 collected $0.19 from pot
*** SUMMARY ***
Total pot $0.20 | Rake $0.01 
Board [Ac Ad 6h 3h 2s]
Seat 1: lnfIame folded before Flop (didn't bet)
Seat 3: wolverstine (button) folded before Flop (didn't bet)
Seat 4: Wangritter13 (small blind) showed [5h Kh] and won ($0.19) with a pair of Aces
Seat 5: VanCleef322 (big blind) mucked
Seat 6: chris.nomf folded before Flop (didn't bet)



PokerStars Hand #222981073280:  Hold'em No Limit ($0.05/$0.10 USD) - 2021/01/23 20:10:23 ET
Table 'Merope IV' 6-max Seat #4 is the button
Seat 1: lnfIame ($14.26 in chips) 
Seat 2: Stengel07 ($9.37 in chips) 
Seat 3: wolverstine ($6.76 in chips) 
Seat 4: Wangritter13 ($14.73 in chips) 
Seat 5: VanCleef322 ($11.34 in chips) 
Seat 6: chris.nomf ($10.10 in chips) 
VanCleef322: posts small blind $0.05
chris.nomf: posts big blind $0.10
Stengel07: posts big blind $0.10
*** HOLE CARDS ***
lnfIame: folds 
Stengel07: raises $0.10 to $0.20
wolverstine: folds 
Wangritter13: folds 
VanCleef322: folds 
chris.nomf: calls $0.10
*** FLOP *** [9s 5h 6c]
chris.nomf: checks 
Stengel07: bets $0.22
chris.nomf: calls $0.22
*** TURN *** [9s 5h 6c] [Qh]
chris.nomf: checks 
Stengel07: bets $0.43
chris.nomf: raises $0.86 to $1.29
Stengel07: raises $0.86 to $2.15
chris.nomf: folds 
Uncalled bet ($0.86) returned to Stengel07
Stengel07 collected $3.31 from pot
Stengel07: doesn't show hand 
*** SUMMARY ***
Total pot $3.47 | Rake $0.16 
Board [9s 5h 6c Qh]
Seat 1: lnfIame folded before Flop (didn't bet)
Seat 2: Stengel07 collected ($3.31)
Seat 3: wolverstine folded before Flop (didn't bet)
Seat 4: Wangritter13 (button) folded before Flop (didn't bet)
Seat 5: VanCleef322 (small blind) folded before Flop
Seat 6: chris.nomf (big blind) folded on the Turn



PokerStars Hand #222981087746:  Hold'em No Limit ($0.05/$0.10 USD) - 2021/01/23 20:10:55 ET
Table 'Merope IV' 6-max Seat #5 is the button
Seat 2: Stengel07 ($10.97 in chips) 
Seat 3: wolverstine ($6.76 in chips) 
Seat 4: Wangritter13 ($14.73 in chips) 
Seat 5: VanCleef322 ($11.29 in chips) 
Seat 6: chris.nomf ($8.39 in chips) 
chris.nomf: posts small blind $0.05
lnfIame: is sitting out 
Stengel07: posts big blind $0.10
*** HOLE CARDS ***
wolverstine: raises $0.10 to $0.20
Wangritter13: calls $0.20
VanCleef322: folds 
chris.nomf: raises $0.70 to $0.90
Stengel07: raises $0.70 to $1.60
wolverstine: folds 
Wangritter13: folds 
lnfIame leaves the table
chris.nomf: raises $6.79 to $8.39 and is all-in
Stengel07: calls $6.79
*** FLOP *** [Kh 6s Th]
alfaomegabet joins the table at seat #1 
*** TURN *** [Kh 6s Th] [2d]
*** RIVER *** [Kh 6s Th 2d] [6c]
*** SHOW DOWN ***
chris.nomf: shows [Ks Kd] (a full house, Kings full of Sixes)
Stengel07: shows [3s Ah] (a pair of Sixes)
chris.nomf collected $16.41 from pot
*** SUMMARY ***
Total pot $17.18 | Rake $0.77 
Board [Kh 6s Th 2d 6c]
Seat 2: Stengel07 (big blind) showed [3s Ah] and lost with a pair of Sixes
Seat 3: wolverstine folded before Flop
Seat 4: Wangritter13 folded before Flop
Seat 5: VanCleef322 (button) folded before Flop (didn't bet)
Seat 6: chris.nomf (small blind) showed [Ks Kd] and won ($16.41) with a full house, Kings full of Sixes



PokerStars Hand #222981102180:  Hold'em No Limit ($0.05/$0.10 USD) - 2021/01/23 20:11:27 ET
Table 'Merope IV' 6-max Seat #6 is the button
Seat 2: Stengel07 ($2.58 in chips) 
Seat 3: wolverstine ($6.56 in chips) 
Seat 4: Wangritter13 ($14.53 in chips) 
Seat 5: VanCleef322 ($11.29 in chips) 
Seat 6: chris.nomf ($16.41 in chips) 
Stengel07: posts small blind $0.05
wolverstine: posts big blind $0.10
*** HOLE CARDS ***
Wangritter13: raises $0.10 to $0.20
VanCleef322: raises $0.60 to $0.80
chris.nomf: folds 
Stengel07: calls $0.75
wolverstine: folds 
Wangritter13: calls $0.60
*** FLOP *** [8h 6h 2h]
Stengel07: bets $0.10
Wangritter13: folds 
VanCleef322: calls $0.10
*** TURN *** [8h 6h 2h] [5h]
Stengel07: bets $0.10
VanCleef322: calls $0.10
*** RIVER *** [8h 6h 2h 5h] [5c]
Stengel07: bets $1.58 and is all-in
VanCleef322: folds 
Uncalled bet ($1.58) returned to Stengel07
Stengel07 collected $2.77 from pot
Stengel07: doesn't show hand 
*** SUMMARY ***
Total pot $2.90 | Rake $0.13 
Board [8h 6h 2h 5h 5c]
Seat 2: Stengel07 (small blind) collected ($2.77)
Seat 3: wolverstine (big blind) folded before Flop
Seat 4: Wangritter13 folded on the Flop
Seat 5: VanCleef322 folded on the River
Seat 6: chris.nomf (button) folded before Flop (didn't bet)



PokerStars Hand #222981122554:  Hold'em No Limit ($0.05/$0.10 USD) - 2021/01/23 20:12:12 ET
Table 'Merope IV' 6-max Seat #2 is the button
Seat 2: Stengel07 ($4.35 in chips) 
Seat 3: wolverstine ($6.46 in chips) 
Seat 4: Wangritter13 ($13.73 in chips) 
Seat 5: VanCleef322 ($10.29 in chips) 
Seat 6: chris.nomf ($16.41 in chips) 
wolverstine: posts small blind $0.05
Wangritter13: posts big blind $0.10
alfaomegabet: sits out 
*** HOLE CARDS ***
VanCleef322: folds 
chris.nomf: raises $0.20 to $0.30
Stengel07: folds 
wolverstine: folds 
Wangritter13: folds 
Uncalled bet ($0.20) returned to chris.nomf
chris.nomf collected $0.25 from pot
chris.nomf: doesn't show hand 
*** SUMMARY ***
Total pot $0.25 | Rake $0 
Seat 2: Stengel07 (button) folded before Flop (didn't bet)
Seat 3: wolverstine (small blind) folded before Flop
Seat 4: Wangritter13 (big blind) folded before Flop
Seat 5: VanCleef322 folded before Flop (didn't bet)
Seat 6: chris.nomf collected ($0.25)



PokerStars Hand #222981127302:  Hold'em No Limit ($0.05/$0.10 USD) - 2021/01/23 20:12:23 ET
Table 'Merope IV' 6-max Seat #3 is the button
Seat 2: Stengel07 ($4.35 in chips) 
Seat 3: wolverstine ($6.41 in chips) 
Seat 4: Wangritter13 ($13.63 in chips) 
Seat 5: VanCleef322 ($10.29 in chips) 
Seat 6: chris.nomf ($16.56 in chips) 
Wangritter13: posts small blind $0.05
VanCleef322: posts big blind $0.10
alfaomegabet: sits out 
*** HOLE CARDS ***
chris.nomf: folds 
Stengel07: calls $0.10
wolverstine: folds 
Wangritter13: folds 
VanCleef322: checks 
*** FLOP *** [4d 7s 3h]
VanCleef322: checks 
Stengel07: bets $0.12
VanCleef322: calls $0.12
*** TURN *** [4d 7s 3h] [9c]
VanCleef322: checks 
Stengel07: bets $0.47
VanCleef322: folds 
Uncalled bet ($0.47) returned to Stengel07
Stengel07 collected $0.47 from pot
Stengel07: doesn't show hand 
*** SUMMARY ***
Total pot $0.49 | Rake $0.02 
Board [4d 7s 3h 9c]
Seat 2: Stengel07 collected ($0.47)
Seat 3: wolverstine (button) folded before Flop (didn't bet)
Seat 4: Wangritter13 (small blind) folded before Flop
Seat 5: VanCleef322 (big blind) folded on the Turn
Seat 6: chris.nomf folded before Flop (didn't bet)



PokerStars Hand #222981137992:  Hold'em No Limit ($0.05/$0.10 USD) - 2021/01/23 20:12:47 ET
Table 'Merope IV' 6-max Seat #4 is the button
Seat 2: Stengel07 ($4.60 in chips) 
Seat 3: wolverstine ($6.41 in chips) 
Seat 4: Wangritter13 ($13.58 in chips) 
Seat 5: VanCleef322 ($10.07 in chips) 
Seat 6: chris.nomf ($16.56 in chips) 
VanCleef322: posts small blind $0.05
chris.nomf: posts big blind $0.10
alfaomegabet: sits out 
*** HOLE CARDS ***
Stengel07: raises $0.10 to $0.20
wolverstine: folds 
Wangritter13: folds 
VanCleef322: folds 
chris.nomf: calls $0.10
*** FLOP *** [7c Ks 3h]
chris.nomf: checks 
Stengel07: bets $0.22
chris.nomf: calls $0.22
*** TURN *** [7c Ks 3h] [Ac]
chris.nomf: checks 
Stengel07: bets $0.85
chris.nomf: folds 
Uncalled bet ($0.85) returned to Stengel07
Stengel07 collected $0.85 from pot
Stengel07: doesn't show hand 
*** SUMMARY ***
Total pot $0.89 | Rake $0.04 
Board [7c Ks 3h Ac]
Seat 2: Stengel07 collected ($0.85)
Seat 3: wolverstine folded before Flop (didn't bet)
Seat 4: Wangritter13 (button) folded before Flop (didn't bet)
Seat 5: VanCleef322 (small blind) folded before Flop
Seat 6: chris.nomf (big blind) folded on the Turn



PokerStars Hand #222981154539:  Hold'em No Limit ($0.05/$0.10 USD) - 2021/01/23 20:13:24 ET
Table 'Merope IV' 6-max Seat #5 is the button
Seat 1: alfaomegabet ($10 in chips) 
Seat 2: Stengel07 ($5.03 in chips) 
Seat 3: wolverstine ($6.41 in chips) 
Seat 4: Wangritter13 ($13.58 in chips) 
Seat 5: VanCleef322 ($10.02 in chips) 
Seat 6: chris.nomf ($16.14 in chips) 
chris.nomf: posts small blind $0.05
alfaomegabet: posts big blind $0.10
*** HOLE CARDS ***
Stengel07: folds 
wolverstine: raises $0.10 to $0.20
Wangritter13: calls $0.20
VanCleef322: folds 
chris.nomf: calls $0.15
Stengel07 leaves the table
alfaomegabet: calls $0.10
*** FLOP *** [Qh Jd 2d]
chris.nomf: checks 
Invasione1 joins the table at seat #2 
alfaomegabet: checks 
wolverstine: bets $0.30
Wangritter13: calls $0.30
chris.nomf: calls $0.30
alfaomegabet: folds 
*** TURN *** [Qh Jd 2d] [Ad]
chris.nomf: checks 
wolverstine: checks 
Wangritter13: bets $0.30
chris.nomf: folds 
wolverstine: calls $0.30
*** RIVER *** [Qh Jd 2d Ad] [3h]
wolverstine: checks 
Wangritter13: bets $0.90
wolverstine: calls $0.90
*** SHOW DOWN ***
Wangritter13: shows [Qd 9d] (a flush, Ace high)
wolverstine: mucks hand 
Wangritter13 collected $3.92 from pot
*** SUMMARY ***
Total pot $4.10 | Rake $0.18 
Board [Qh Jd 2d Ad 3h]
Seat 1: alfaomegabet (big blind) folded on the Flop
Seat 2: Stengel07 folded before Flop (didn't bet)
Seat 3: wolverstine mucked
Seat 4: Wangritter13 showed [Qd 9d] and won ($3.92) with a flush, Ace high
Seat 5: VanCleef322 (button) folded before Flop (didn't bet)
Seat 6: chris.nomf (small blind) folded on the Turn



PokerStars Hand #222981182208:  Hold'em No Limit ($0.05/$0.10 USD) - 2021/01/23 20:14:25 ET
Table 'Merope IV' 6-max Seat #6 is the button
Seat 1: alfaomegabet ($10 in chips) 
Seat 2: Invasione1 ($7.57 in chips) 
Seat 3: wolverstine ($4.71 in chips) 
Seat 4: Wangritter13 ($15.80 in chips) 
Seat 5: VanCleef322 ($10.02 in chips) 
Seat 6: chris.nomf ($15.64 in chips) 
alfaomegabet: posts small blind $0.05
Invasione1: posts big blind $0.10
*** HOLE CARDS ***
wolverstine: folds 
Wangritter13: folds 
VanCleef322: folds 
chris.nomf: raises $0.10 to $0.20
alfaomegabet: folds 
Invasione1: calls $0.10
*** FLOP *** [2d Tc 5c]
Invasione1: checks 
chris.nomf: checks 
*** TURN *** [2d Tc 5c] [9h]
Invasione1: bets $0.28
chris.nomf: calls $0.28
*** RIVER *** [2d Tc 5c 9h] [As]
Invasione1: bets $0.48
chris.nomf: folds 
Uncalled bet ($0.48) returned to Invasione1
Invasione1 collected $0.96 from pot
Invasione1: doesn't show hand 
*** SUMMARY ***
Total pot $1.01 | Rake $0.05 
Board [2d Tc 5c 9h As]
Seat 1: alfaomegabet (small blind) folded before Flop
Seat 2: Invasione1 (big blind) collected ($0.96)
Seat 3: wolverstine folded before Flop (didn't bet)
Seat 4: Wangritter13 folded before Flop (didn't bet)
Seat 5: VanCleef322 folded before Flop (didn't bet)
Seat 6: chris.nomf (button) folded on the River



PokerStars Hand #222981201803:  Hold'em No Limit ($0.05/$0.10 USD) - 2021/01/23 20:15:09 ET
Table 'Merope IV' 6-max Seat #1 is the button
Seat 1: alfaomegabet ($10 in chips) 
Seat 2: Invasione1 ($8.05 in chips) 
Seat 3: wolverstine ($4.71 in chips) 
Seat 4: Wangritter13 ($15.80 in chips) 
Seat 5: VanCleef322 ($10.02 in chips) 
Seat 6: chris.nomf ($15.16 in chips) 
Invasione1: posts small blind $0.05
wolverstine: posts big blind $0.10
*** HOLE CARDS ***
Wangritter13: raises $0.20 to $0.30
VanCleef322: folds 
chris.nomf: calls $0.30
alfaomegabet: folds 
Invasione1: raises $1.30 to $1.60
wolverstine: folds 
Wangritter13: raises $14.20 to $15.80 and is all-in
chris.nomf: folds 
Invasione1: calls $6.45 and is all-in
Uncalled bet ($7.75) returned to Wangritter13
*** FLOP *** [4d Td 4h]
*** TURN *** [4d Td 4h] [6d]
*** RIVER *** [4d Td 4h 6d] [Kc]
*** SHOW DOWN ***
Invasione1: shows [Qc Ah] (a pair of Fours)
Wangritter13: shows [9d 9c] (two pair, Nines and Fours)
Wangritter13 collected $15.76 from pot
*** SUMMARY ***
Total pot $16.50 | Rake $0.74 
Board [4d Td 4h 6d Kc]
Seat 1: alfaomegabet (button) folded before Flop (didn't bet)
Seat 2: Invasione1 (small blind) showed [Qc Ah] and lost with a pair of Fours
Seat 3: wolverstine (big blind) folded before Flop
Seat 4: Wangritter13 showed [9d 9c] and won ($15.76) with two pair, Nines and Fours
Seat 5: VanCleef322 folded before Flop (didn't bet)
Seat 6: chris.nomf folded before Flop



PokerStars Hand #222981229450:  Hold'em No Limit ($0.05/$0.10 USD) - 2021/01/23 20:16:11 ET
Table 'Merope IV' 6-max Seat #3 is the button
Seat 1: alfaomegabet ($10 in chips) 
Seat 3: wolverstine ($4.61 in chips) 
Seat 4: Wangritter13 ($23.51 in chips) 
Seat 5: VanCleef322 ($10.02 in chips) 
Seat 6: chris.nomf ($14.86 in chips) 
Wangritter13: posts small blind $0.05
VanCleef322: posts big blind $0.10
*** HOLE CARDS ***
chris.nomf: raises $0.20 to $0.30
Invasione1 leaves the table
alfaomegabet: folds 
wolverstine: folds 
Wangritter13: calls $0.25
VanCleef322: folds 
*** FLOP *** [4c 8s Qh]
Wangritter13: checks 
chris.nomf: bets $0.34
Wangritter13: folds 
Uncalled bet ($0.34) returned to chris.nomf
chris.nomf collected $0.67 from pot
chris.nomf: doesn't show hand 
*** SUMMARY ***
Total pot $0.70 | Rake $0.03 
Board [4c 8s Qh]
Seat 1: alfaomegabet folded before Flop (didn't bet)
Seat 3: wolverstine (button) folded before Flop (didn't bet)
Seat 4: Wangritter13 (small blind) folded on the Flop
Seat 5: VanCleef322 (big blind) folded before Flop
Seat 6: chris.nomf collected ($0.67)



PokerStars Hand #222981238354:  Hold'em No Limit ($0.05/$0.10 USD) - 2021/01/23 20:16:31 ET
Table 'Merope IV' 6-max Seat #4 is the button
Seat 1: alfaomegabet ($10 in chips) 
Seat 3: wolverstine ($4.61 in chips) 
Seat 4: Wangritter13 ($23.21 in chips) 
Seat 5: VanCleef322 ($10 in chips) 
Seat 6: chris.nomf ($15.23 in chips) 
VanCleef322: posts small blind $0.05
chris.nomf: posts big blind $0.10
*** HOLE CARDS ***
alfaomegabet: folds 
wolverstine: raises $0.10 to $0.20
Wangritter13: folds 
VanCleef322: folds 
chris.nomf: folds 
Uncalled bet ($0.10) returned to wolverstine
wolverstine collected $0.25 from pot
wolverstine: doesn't show hand 
*** SUMMARY ***
Total pot $0.25 | Rake $0 
Seat 1: alfaomegabet folded before Flop (didn't bet)
Seat 3: wolverstine collected ($0.25)
Seat 4: Wangritter13 (button) folded before Flop (didn't bet)
Seat 5: VanCleef322 (small blind) folded before Flop
Seat 6: chris.nomf (big blind) folded before Flop



PokerStars Hand #222981243026:  Hold'em No Limit ($0.05/$0.10 USD) - 2021/01/23 20:16:42 ET
Table 'Merope IV' 6-max Seat #5 is the button
Seat 1: alfaomegabet ($10 in chips) 
Seat 3: wolverstine ($4.76 in chips) 
Seat 4: Wangritter13 ($23.21 in chips) 
Seat 5: VanCleef322 ($10 in chips) 
Seat 6: chris.nomf ($15.13 in chips) 
chris.nomf: posts small blind $0.05
alfaomegabet: posts big blind $0.10
*** HOLE CARDS ***
wolverstine: raises $0.10 to $0.20
Wangritter13: folds 
VanCleef322: folds 
bigmamaa7 joins the table at seat #2 
chris.nomf: folds 
alfaomegabet: folds 
Uncalled bet ($0.10) returned to wolverstine
wolverstine collected $0.25 from pot
wolverstine: doesn't show hand 
*** SUMMARY ***
Total pot $0.25 | Rake $0 
Seat 1: alfaomegabet (big blind) folded before Flop
Seat 3: wolverstine collected ($0.25)
Seat 4: Wangritter13 folded before Flop (didn't bet)
Seat 5: VanCleef322 (button) folded before Flop (didn't bet)
Seat 6: chris.nomf (small blind) folded before Flop



PokerStars Hand #222981249448:  Hold'em No Limit ($0.05/$0.10 USD) - 2021/01/23 20:16:56 ET
Table 'Merope IV' 6-max Seat #6 is the button
Seat 1: alfaomegabet ($10 in chips) 
Seat 2: bigmamaa7 ($8 in chips) 
Seat 3: wolverstine ($4.91 in chips) 
Seat 4: Wangritter13 ($23.21 in chips) 
Seat 5: VanCleef322 ($10 in chips) 
Seat 6: chris.nomf ($15.08 in chips) 
alfaomegabet: posts small blind $0.05
bigmamaa7: posts big blind $0.10
*** HOLE CARDS ***
wolverstine: folds 
Wangritter13: folds 
VanCleef322: raises $0.15 to $0.25
chris.nomf: folds 
alfaomegabet: folds 
bigmamaa7: calls $0.15
*** FLOP *** [6h 4h 2h]
bigmamaa7: checks 
VanCleef322: checks 
*** TURN *** [6h 4h 2h] [7h]
bigmamaa7: checks 
VanCleef322: bets $0.17
bigmamaa7: calls $0.17
*** RIVER *** [6h 4h 2h 7h] [Kc]
bigmamaa7: checks 
VanCleef322: checks 
*** SHOW DOWN ***
bigmamaa7: shows [Qh 5h] (a flush, Queen high)
VanCleef322: mucks hand 
bigmamaa7 collected $0.85 from pot
*** SUMMARY ***
Total pot $0.89 | Rake $0.04 
Board [6h 4h 2h 7h Kc]
Seat 1: alfaomegabet (small blind) folded before Flop
Seat 2: bigmamaa7 (big blind) showed [Qh 5h] and won ($0.85) with a flush, Queen high
Seat 3: wolverstine folded before Flop (didn't bet)
Seat 4: Wangritter13 folded before Flop (didn't bet)
Seat 5: VanCleef322 mucked
Seat 6: chris.nomf (button) folded before Flop (didn't bet)



PokerStars Hand #222981261788:  Hold'em No Limit ($0.05/$0.10 USD) - 2021/01/23 20:17:24 ET
Table 'Merope IV' 6-max Seat #1 is the button
Seat 1: alfaomegabet ($10 in chips) 
Seat 2: bigmamaa7 ($8.43 in chips) 
Seat 3: wolverstine ($4.91 in chips) 
Seat 4: Wangritter13 ($23.21 in chips) 
Seat 5: VanCleef322 ($10 in chips) 
Seat 6: chris.nomf ($15.08 in chips) 
bigmamaa7: posts small blind $0.05
wolverstine: posts big blind $0.10
*** HOLE CARDS ***
Wangritter13: raises $0.10 to $0.20
VanCleef322: folds 
chris.nomf: folds 
alfaomegabet: folds 
bigmamaa7: calls $0.15
wolverstine: folds 
*** FLOP *** [9h 2c 7s]
bigmamaa7: checks 
Wangritter13: bets $0.24
bigmamaa7: folds 
Uncalled bet ($0.24) returned to Wangritter13
Wangritter13 collected $0.48 from pot
Wangritter13: doesn't show hand 
*** SUMMARY ***
Total pot $0.50 | Rake $0.02 
Board [9h 2c 7s]
Seat 1: alfaomegabet (button) folded before Flop (didn't bet)
Seat 2: bigmamaa7 (small blind) folded on the Flop
Seat 3: wolverstine (big blind) folded before Flop
Seat 4: Wangritter13 collected ($0.48)
Seat 5: VanCleef322 folded before Flop (didn't bet)
Seat 6: chris.nomf folded before Flop (didn't bet)



PokerStars Hand #222981274033:  Hold'em No Limit ($0.05/$0.10 USD) - 2021/01/23 20:17:52 ET
Table 'Merope IV' 6-max Seat #2 is the button
Seat 1: alfaomegabet ($10 in chips) 
Seat 2: bigmamaa7 ($8.23 in chips) 
Seat 3: wolverstine ($4.81 in chips) 
Seat 4: Wangritter13 ($23.49 in chips) 
Seat 5: VanCleef322 ($10 in chips) 
Seat 6: chris.nomf ($15.08 in chips) 
wolverstine: posts small blind $0.05
Wangritter13: posts big blind $0.10
*** HOLE CARDS ***
VanCleef322: folds 
chris.nomf: folds 
alfaomegabet: folds 
bigmamaa7: raises $0.10 to $0.20
wolverstine: calls $0.15
Wangritter13: calls $0.10
*** FLOP *** [7h Kd Jc]
wolverstine: checks 
Wangritter13: checks 
bigmamaa7: bets $0.57
wolverstine: folds 
Wangritter13: folds 
Uncalled bet ($0.57) returned to bigmamaa7
bigmamaa7 collected $0.57 from pot
bigmamaa7: doesn't show hand 
*** SUMMARY ***
Total pot $0.60 | Rake $0.03 
Board [7h Kd Jc]
Seat 1: alfaomegabet folded before Flop (didn't bet)
Seat 2: bigmamaa7 (button) collected ($0.57)
Seat 3: wolverstine (small blind) folded on the Flop
Seat 4: Wangritter13 (big blind) folded on the Flop
Seat 5: VanCleef322 folded before Flop (didn't bet)
Seat 6: chris.nomf folded before Flop (didn't bet)



PokerStars Hand #222981282913:  Hold'em No Limit ($0.05/$0.10 USD) - 2021/01/23 20:18:12 ET
Table 'Merope IV' 6-max Seat #3 is the button
Seat 1: alfaomegabet ($10 in chips) 
Seat 2: bigmamaa7 ($8.60 in chips) 
Seat 3: wolverstine ($4.61 in chips) 
Seat 4: Wangritter13 ($23.29 in chips) 
Seat 5: VanCleef322 ($10 in chips) 
Seat 6: chris.nomf ($15.08 in chips) 
Wangritter13: posts small blind $0.05
VanCleef322: posts big blind $0.10
*** HOLE CARDS ***
chris.nomf: raises $0.20 to $0.30
alfaomegabet: folds 
bigmamaa7: folds 
wolverstine: calls $0.30
Wangritter13: calls $0.25
VanCleef322: folds 
*** FLOP *** [Kd 7d 4h]
Wangritter13: checks 
chris.nomf: checks 
wolverstine: checks 
*** TURN *** [Kd 7d 4h] [5h]
Wangritter13: bets $0.38
chris.nomf: folds 
wolverstine: calls $0.38
*** RIVER *** [Kd 7d 4h 5h] [Ah]
Wangritter13: bets $1.68
wolverstine: folds 
Uncalled bet ($1.68) returned to Wangritter13
Wangritter13 collected $1.68 from pot
Wangritter13: doesn't show hand 
*** SUMMARY ***
Total pot $1.76 | Rake $0.08 
Board [Kd 7d 4h 5h Ah]
Seat 1: alfaomegabet folded before Flop (didn't bet)
Seat 2: bigmamaa7 folded before Flop (didn't bet)
Seat 3: wolverstine (button) folded on the River
Seat 4: Wangritter13 (small blind) collected ($1.68)
Seat 5: VanCleef322 (big blind) folded before Flop
Seat 6: chris.nomf folded on the Turn



PokerStars Hand #222981300568:  Hold'em No Limit ($0.05/$0.10 USD) - 2021/01/23 20:18:53 ET
Table 'Merope IV' 6-max Seat #4 is the button
Seat 1: alfaomegabet ($10 in chips) 
Seat 2: bigmamaa7 ($8.60 in chips) 
Seat 3: wolverstine ($3.93 in chips) 
Seat 4: Wangritter13 ($24.29 in chips) 
Seat 5: VanCleef322 ($10 in chips) 
Seat 6: chris.nomf ($14.78 in chips) 
VanCleef322: posts small blind $0.05
chris.nomf: posts big blind $0.10
*** HOLE CARDS ***
alfaomegabet: folds 
bigmamaa7: folds 
wolverstine: folds 
Wangritter13: folds 
VanCleef322: raises $0.15 to $0.25
chris.nomf: calls $0.15
*** FLOP *** [4c 5c 9s]
VanCleef322: checks 
chris.nomf: checks 
*** TURN *** [4c 5c 9s] [9c]
VanCleef322: checks 
chris.nomf: checks 
*** RIVER *** [4c 5c 9s 9c] [8h]
VanCleef322: checks 
chris.nomf: checks 
*** SHOW DOWN ***
VanCleef322: shows [Kc Ah] (a pair of Nines)
chris.nomf: mucks hand 
VanCleef322 collected $0.48 from pot
*** SUMMARY ***
Total pot $0.50 | Rake $0.02 
Board [4c 5c 9s 9c 8h]
Seat 1: alfaomegabet folded before Flop (didn't bet)
Seat 2: bigmamaa7 folded before Flop (didn't bet)
Seat 3: wolverstine folded before Flop (didn't bet)
Seat 4: Wangritter13 (button) folded before Flop (didn't bet)
Seat 5: VanCleef322 (small blind) showed [Kc Ah] and won ($0.48) with a pair of Nines
Seat 6: chris.nomf (big blind) mucked



PokerStars Hand #222981309808:  Hold'em No Limit ($0.05/$0.10 USD) - 2021/01/23 20:19:14 ET
Table 'Merope IV' 6-max Seat #5 is the button
Seat 1: alfaomegabet ($10 in chips) 
Seat 2: bigmamaa7 ($8.60 in chips) 
Seat 3: wolverstine ($3.93 in chips) 
Seat 4: Wangritter13 ($24.29 in chips) 
Seat 5: VanCleef322 ($10.23 in chips) 
Seat 6: chris.nomf ($14.53 in chips) 
chris.nomf: posts small blind $0.05
alfaomegabet: posts big blind $0.10
*** HOLE CARDS ***
bigmamaa7: folds 
wolverstine: folds 
Wangritter13: calls $0.10
VanCleef322: folds 
chris.nomf: raises $0.30 to $0.40
alfaomegabet: folds 
Wangritter13: folds 
Uncalled bet ($0.30) returned to chris.nomf
chris.nomf collected $0.30 from pot
chris.nomf: doesn't show hand 
*** SUMMARY ***
Total pot $0.30 | Rake $0 
Seat 1: alfaomegabet (big blind) folded before Flop
Seat 2: bigmamaa7 folded before Flop (didn't bet)
Seat 3: wolverstine folded before Flop (didn't bet)
Seat 4: Wangritter13 folded before Flop
Seat 5: VanCleef322 (button) folded before Flop (didn't bet)
Seat 6: chris.nomf (small blind) collected ($0.30)



PokerStars Hand #222981320661:  Hold'em No Limit ($0.05/$0.10 USD) - 2021/01/23 20:19:39 ET
Table 'Merope IV' 6-max Seat #6 is the button
Seat 1: alfaomegabet ($10 in chips) 
Seat 2: bigmamaa7 ($8.60 in chips) 
Seat 3: wolverstine ($7.93 in chips) 
Seat 4: Wangritter13 ($24.19 in chips) 
Seat 5: VanCleef322 ($10.23 in chips) 
Seat 6: chris.nomf ($14.73 in chips) 
alfaomegabet: posts small blind $0.05
bigmamaa7: posts big blind $0.10
*** HOLE CARDS ***
wolverstine: raises $0.10 to $0.20
Wangritter13: calls $0.20
VanCleef322: folds 
chris.nomf: folds 
alfaomegabet: folds 
bigmamaa7: calls $0.10
*** FLOP *** [9d Tc Ts]
bigmamaa7: bets $0.10
wolverstine: calls $0.10
Wangritter13: calls $0.10
*** TURN *** [9d Tc Ts] [5h]
bigmamaa7: checks 
wolverstine: bets $0.91
Wangritter13: calls $0.91
bigmamaa7: folds 
*** RIVER *** [9d Tc Ts 5h] [4s]
wolverstine: bets $1.33
Wangritter13: folds 
Uncalled bet ($1.33) returned to wolverstine
wolverstine collected $2.65 from pot
wolverstine: doesn't show hand 
*** SUMMARY ***
Total pot $2.77 | Rake $0.12 
Board [9d Tc Ts 5h 4s]
Seat 1: alfaomegabet (small blind) folded before Flop
Seat 2: bigmamaa7 (big blind) folded on the Turn
Seat 3: wolverstine collected ($2.65)
Seat 4: Wangritter13 folded on the River
Seat 5: VanCleef322 folded before Flop (didn't bet)
Seat 6: chris.nomf (button) folded before Flop (didn't bet)



PokerStars Hand #222981335802:  Hold'em No Limit ($0.05/$0.10 USD) - 2021/01/23 20:20:14 ET
Table 'Merope IV' 6-max Seat #1 is the button
Seat 1: alfaomegabet ($10 in chips) 
Seat 2: bigmamaa7 ($8.30 in chips) 
Seat 3: wolverstine ($9.37 in chips) 
Seat 4: Wangritter13 ($22.98 in chips) 
Seat 5: VanCleef322 ($10.23 in chips) 
Seat 6: chris.nomf ($14.73 in chips) 
bigmamaa7: posts small blind $0.05
wolverstine: posts big blind $0.10
*** HOLE CARDS ***
Wangritter13: calls $0.10
VanCleef322: folds 
chris.nomf: folds 
alfaomegabet: folds 
bigmamaa7: raises $0.10 to $0.20
wolverstine: calls $0.10
Wangritter13: calls $0.10
*** FLOP *** [3h 6s 9d]
bigmamaa7: checks 
wolverstine: checks 
Wangritter13: checks 
*** TURN *** [3h 6s 9d] [Ad]
bigmamaa7: checks 
wolverstine: checks 
Wangritter13: bets $3.40
bigmamaa7: raises $4.70 to $8.10 and is all-in
wolverstine: folds 
Wangritter13: folds 
Uncalled bet ($4.70) returned to bigmamaa7
bigmamaa7 collected $7.07 from pot
bigmamaa7: doesn't show hand 
*** SUMMARY ***
Total pot $7.40 | Rake $0.33 
Board [3h 6s 9d Ad]
Seat 1: alfaomegabet (button) folded before Flop (didn't bet)
Seat 2: bigmamaa7 (small blind) collected ($7.07)
Seat 3: wolverstine (big blind) folded on the Turn
Seat 4: Wangritter13 folded on the Turn
Seat 5: VanCleef322 folded before Flop (didn't bet)
Seat 6: chris.nomf folded before Flop (didn't bet)



PokerStars Hand #222981368760:  Hold'em No Limit ($0.05/$0.10 USD) - 2021/01/23 20:21:29 ET
Table 'Merope IV' 6-max Seat #4 is the button
Seat 1: alfaomegabet ($10 in chips) 
Seat 2: bigmamaa7 ($12.14 in chips) 
Seat 4: Wangritter13 ($19.08 in chips) 
Seat 5: VanCleef322 ($10.13 in chips) 
Seat 6: chris.nomf ($14.73 in chips) 
VanCleef322: posts small blind $0.05
chris.nomf: posts big blind $0.10
*** HOLE CARDS ***
alfaomegabet: raises $0.20 to $0.30
bigmamaa7: calls $0.30
Wangritter13: folds 
VanCleef322: folds 
chris.nomf: folds 
*** FLOP *** [Jh 5h Ah]
alfaomegabet: checks 
bigmamaa7: checks 
*** TURN *** [Jh 5h Ah] [Tc]
alfaomegabet: bets $0.37
bigmamaa7: folds 
Uncalled bet ($0.37) returned to alfaomegabet
alfaomegabet collected $0.72 from pot
alfaomegabet: doesn't show hand 
*** SUMMARY ***
Total pot $0.75 | Rake $0.03 
Board [Jh 5h Ah Tc]
Seat 1: alfaomegabet collected ($0.72)
Seat 2: bigmamaa7 folded on the Turn
Seat 4: Wangritter13 (button) folded before Flop (didn't bet)
Seat 5: VanCleef322 (small blind) folded before Flop
Seat 6: chris.nomf (big blind) folded before Flop



PokerStars Hand #222981381085:  Hold'em No Limit ($0.05/$0.10 USD) - 2021/01/23 20:21:57 ET
Table 'Merope IV' 6-max Seat #5 is the button
Seat 1: alfaomegabet ($10.42 in chips) 
Seat 2: bigmamaa7 ($11.84 in chips) 
Seat 4: Wangritter13 ($19.08 in chips) 
Seat 5: VanCleef322 ($10.08 in chips) 
Seat 6: chris.nomf ($14.63 in chips) 
chris.nomf: posts small blind $0.05
alfaomegabet: posts big blind $0.10
*** HOLE CARDS ***
bigmamaa7: calls $0.10
Wangritter13: folds 
VanCleef322: folds 
chris.nomf: raises $0.30 to $0.40
alfaomegabet: folds 
bigmamaa7: calls $0.30
*** FLOP *** [Qc 4s 9c]
chris.nomf: checks 
bigmamaa7: checks 
*** TURN *** [Qc 4s 9c] [8d]
chris.nomf: checks 
bigmamaa7: checks 
*** RIVER *** [Qc 4s 9c 8d] [8c]
chris.nomf: bets $0.86
bigmamaa7: folds 
Uncalled bet ($0.86) returned to chris.nomf
chris.nomf collected $0.86 from pot
chris.nomf: doesn't show hand 
*** SUMMARY ***
Total pot $0.90 | Rake $0.04 
Board [Qc 4s 9c 8d 8c]
Seat 1: alfaomegabet (big blind) folded before Flop
Seat 2: bigmamaa7 folded on the River
Seat 4: Wangritter13 folded before Flop (didn't bet)
Seat 5: VanCleef322 (button) folded before Flop (didn't bet)
Seat 6: chris.nomf (small blind) collected ($0.86)



PokerStars Hand #222981394245:  Hold'em No Limit ($0.05/$0.10 USD) - 2021/01/23 20:22:27 ET
Table 'Merope IV' 6-max Seat #6 is the button
Seat 1: alfaomegabet ($10.32 in chips) 
Seat 2: bigmamaa7 ($11.44 in chips) 
Seat 4: Wangritter13 ($19.08 in chips) 
Seat 5: VanCleef322 ($10.08 in chips) 
Seat 6: chris.nomf ($15.09 in chips) 
alfaomegabet: posts small blind $0.05
bigmamaa7: posts big blind $0.10
*** HOLE CARDS ***
Wangritter13: folds 
VanCleef322: folds 
chris.nomf: raises $0.10 to $0.20
alfaomegabet: folds 
bigmamaa7: calls $0.10
*** FLOP *** [6d 9h Td]
bigmamaa7: checks 
chris.nomf: checks 
*** TURN *** [6d 9h Td] [4d]
bigmamaa7: bets $0.10
chris.nomf: folds 
Uncalled bet ($0.10) returned to bigmamaa7
bigmamaa7 collected $0.43 from pot
bigmamaa7: doesn't show hand 
*** SUMMARY ***
Total pot $0.45 | Rake $0.02 
Board [6d 9h Td 4d]
Seat 1: alfaomegabet (small blind) folded before Flop
Seat 2: bigmamaa7 (big blind) collected ($0.43)
Seat 4: Wangritter13 folded before Flop (didn't bet)
Seat 5: VanCleef322 folded before Flop (didn't bet)
Seat 6: chris.nomf (button) folded on the Turn



PokerStars Hand #222981406518:  Hold'em No Limit ($0.05/$0.10 USD) - 2021/01/23 20:22:55 ET
Table 'Merope IV' 6-max Seat #1 is the button
Seat 1: alfaomegabet ($10.27 in chips) 
Seat 2: bigmamaa7 ($11.67 in chips) 
Seat 4: Wangritter13 ($19.08 in chips) 
Seat 5: VanCleef322 ($10.08 in chips) 
Seat 6: chris.nomf ($14.89 in chips) 
bigmamaa7: posts small blind $0.05
Wangritter13: posts big blind $0.10
*** HOLE CARDS ***
VanCleef322: folds 
chris.nomf: raises $0.20 to $0.30
alfaomegabet: folds 
bigmamaa7: folds 
Wangritter13: calls $0.20
*** FLOP *** [Ts Kc Ad]
Wangritter13: checks 
chris.nomf: checks 
*** TURN *** [Ts Kc Ad] [5d]
Wangritter13: bets $0.31
chris.nomf: calls $0.31
*** RIVER *** [Ts Kc Ad 5d] [8s]
Wangritter13: bets $0.60
chris.nomf: calls $0.60
*** SHOW DOWN ***
Wangritter13: shows [5c Ac] (two pair, Aces and Fives)
chris.nomf: mucks hand 
Wangritter13 collected $2.36 from pot
*** SUMMARY ***
Total pot $2.47 | Rake $0.11 
Board [Ts Kc Ad 5d 8s]
Seat 1: alfaomegabet (button) folded before Flop (didn't bet)
Seat 2: bigmamaa7 (small blind) folded before Flop
Seat 4: Wangritter13 (big blind) showed [5c Ac] and won ($2.36) with two pair, Aces and Fives
Seat 5: VanCleef322 folded before Flop (didn't bet)
Seat 6: chris.nomf mucked



PokerStars Hand #222981430193:  Hold'em No Limit ($0.05/$0.10 USD) - 2021/01/23 20:23:44 ET
Table 'Merope IV' 6-max Seat #2 is the button
Seat 1: alfaomegabet ($10.27 in chips) 
Seat 2: bigmamaa7 ($11.62 in chips) 
Seat 4: Wangritter13 ($20.23 in chips) 
Seat 5: VanCleef322 ($10.08 in chips) 
Seat 6: chris.nomf ($13.68 in chips) 
Wangritter13: posts small blind $0.05
VanCleef322: posts big blind $0.10
*** HOLE CARDS ***
chris.nomf: folds 
alfaomegabet: folds 
bigmamaa7: calls $0.10
Wangritter13: calls $0.05
VanCleef322: checks 
*** FLOP *** [Kd 6h Js]
Wangritter13: checks 
VanCleef322: checks 
bigmamaa7: checks 
*** TURN *** [Kd 6h Js] [5c]
Wangritter13: checks 
VanCleef322: bets $0.22
bigmamaa7: folds 
Wangritter13: folds 
Uncalled bet ($0.22) returned to VanCleef322
VanCleef322 collected $0.29 from pot
VanCleef322: doesn't show hand 
*** SUMMARY ***
Total pot $0.30 | Rake $0.01 
Board [Kd 6h Js 5c]
Seat 1: alfaomegabet folded before Flop (didn't bet)
Seat 2: bigmamaa7 (button) folded on the Turn
Seat 4: Wangritter13 (small blind) folded on the Turn
Seat 5: VanCleef322 (big blind) collected ($0.29)
Seat 6: chris.nomf folded before Flop (didn't bet)



PokerStars Hand #222981441807:  Hold'em No Limit ($0.05/$0.10 USD) - 2021/01/23 20:24:11 ET
Table 'Merope IV' 6-max Seat #4 is the button
Seat 1: alfaomegabet ($10.27 in chips) 
Seat 2: bigmamaa7 ($11.52 in chips) 
Seat 3: wolverstine ($9.17 in chips) 
Seat 4: Wangritter13 ($20.13 in chips) 
Seat 5: VanCleef322 ($10.27 in chips) 
Seat 6: chris.nomf ($13.68 in chips) 
VanCleef322: posts small blind $0.05
chris.nomf: posts big blind $0.10
wolverstine: posts small & big blinds $0.15
*** HOLE CARDS ***
alfaomegabet: folds 
bigmamaa7: folds 
wolverstine: raises $0.20 to $0.30
Wangritter13: calls $0.30
VanCleef322: folds 
chris.nomf: folds 
*** FLOP *** [5c 3d 2c]
wolverstine: bets $0.30
Wangritter13: folds 
Uncalled bet ($0.30) returned to wolverstine
wolverstine collected $0.76 from pot
wolverstine: doesn't show hand 
*** SUMMARY ***
Total pot $0.80 | Rake $0.04 
Board [5c 3d 2c]
Seat 1: alfaomegabet folded before Flop (didn't bet)
Seat 2: bigmamaa7 folded before Flop (didn't bet)
Seat 3: wolverstine collected ($0.76)
Seat 4: Wangritter13 (button) folded on the Flop
Seat 5: VanCleef322 (small blind) folded before Flop
Seat 6: chris.nomf (big blind) folded before Flop



PokerStars Hand #222981454717:  Hold'em No Limit ($0.05/$0.10 USD) - 2021/01/23 20:24:40 ET
Table 'Merope IV' 6-max Seat #5 is the button
Seat 1: alfaomegabet ($10.27 in chips) 
Seat 2: bigmamaa7 ($11.52 in chips) 
Seat 3: wolverstine ($9.58 in chips) 
Seat 4: Wangritter13 ($19.83 in chips) 
Seat 5: VanCleef322 ($10.22 in chips) 
Seat 6: chris.nomf ($13.58 in chips) 
chris.nomf: posts small blind $0.05
alfaomegabet: posts big blind $0.10
*** HOLE CARDS ***
bigmamaa7: raises $0.10 to $0.20
wolverstine: calls $0.20
Wangritter13: folds 
VanCleef322: folds 
chris.nomf: folds 
alfaomegabet: folds 
*** FLOP *** [Qc As 7c]
bigmamaa7: checks 
wolverstine: bets $0.27
bigmamaa7: raises $0.27 to $0.54
wolverstine: calls $0.27
*** TURN *** [Qc As 7c] [Td]
bigmamaa7: bets $1.56
wolverstine: calls $1.56
*** RIVER *** [Qc As 7c Td] [Jc]
bigmamaa7: bets $4.54
wolverstine: folds 
Uncalled bet ($4.54) returned to bigmamaa7
bigmamaa7 collected $4.54 from pot
bigmamaa7: doesn't show hand 
*** SUMMARY ***
Total pot $4.75 | Rake $0.21 
Board [Qc As 7c Td Jc]
Seat 1: alfaomegabet (big blind) folded before Flop
Seat 2: bigmamaa7 collected ($4.54)
Seat 3: wolverstine folded on the River
Seat 4: Wangritter13 folded before Flop (didn't bet)
Seat 5: VanCleef322 (button) folded before Flop (didn't bet)
Seat 6: chris.nomf (small blind) folded before Flop



PokerStars Hand #222981471238:  Hold'em No Limit ($0.05/$0.10 USD) - 2021/01/23 20:25:17 ET
Table 'Merope IV' 6-max Seat #6 is the button
Seat 1: alfaomegabet ($10.17 in chips) 
Seat 2: bigmamaa7 ($13.76 in chips) 
Seat 3: wolverstine ($7.28 in chips) 
Seat 4: Wangritter13 ($19.83 in chips) 
Seat 5: VanCleef322 ($10.22 in chips) 
Seat 6: chris.nomf ($13.53 in chips) 
alfaomegabet: posts small blind $0.05
bigmamaa7: posts big blind $0.10
*** HOLE CARDS ***
wolverstine: folds 
Wangritter13: folds 
wolverstine leaves the table
VanCleef322: raises $0.15 to $0.25
chris.nomf: folds 
alfaomegabet: folds 
bigmamaa7: calls $0.15
*** FLOP *** [9s 5d 8s]
bigmamaa7: bets $0.10
VanCleef322: calls $0.10
*** TURN *** [9s 5d 8s] [2s]
bigmamaa7: checks 
VanCleef322: bets $0.35
bigmamaa7: folds 
Uncalled bet ($0.35) returned to VanCleef322
VanCleef322 collected $0.72 from pot
VanCleef322: doesn't show hand 
*** SUMMARY ***
Total pot $0.75 | Rake $0.03 
Board [9s 5d 8s 2s]
Seat 1: alfaomegabet (small blind) folded before Flop
Seat 2: bigmamaa7 (big blind) folded on the Turn
Seat 3: wolverstine folded before Flop (didn't bet)
Seat 4: Wangritter13 folded before Flop (didn't bet)
Seat 5: VanCleef322 collected ($0.72)
Seat 6: chris.nomf (button) folded before Flop (didn't bet)



PokerStars Hand #222981487853:  Hold'em No Limit ($0.05/$0.10 USD) - 2021/01/23 20:25:55 ET
Table 'Merope IV' 6-max Seat #1 is the button
Seat 1: alfaomegabet ($10.12 in chips) 
Seat 2: bigmamaa7 ($13.41 in chips) 
Seat 4: Wangritter13 ($19.83 in chips) 
Seat 5: VanCleef322 ($10.59 in chips) 
Seat 6: chris.nomf ($13.53 in chips) 
bigmamaa7: posts small blind $0.05
Wangritter13: posts big blind $0.10
*** HOLE CARDS ***
VanCleef322: folds 
chris.nomf has timed out
chris.nomf: folds 
alfaomegabet: folds 
bigmamaa7: raises $0.10 to $0.20
Wangritter13: calls $0.10
*** FLOP *** [8h Kc Th]
bigmamaa7: checks 
Wangritter13: checks 
*** TURN *** [8h Kc Th] [Ad]
bigmamaa7: checks 
Wangritter13: checks 
*** RIVER *** [8h Kc Th Ad] [4s]
Al7uut joins the table at seat #3 
bigmamaa7: checks 
Wangritter13: checks 
*** SHOW DOWN ***
bigmamaa7: shows [6d Qh] (high card Ace)
Wangritter13: shows [Js 8d] (a pair of Eights)
Wangritter13 collected $0.38 from pot
*** SUMMARY ***
Total pot $0.40 | Rake $0.02 
Board [8h Kc Th Ad 4s]
Seat 1: alfaomegabet (button) folded before Flop (didn't bet)
Seat 2: bigmamaa7 (small blind) showed [6d Qh] and lost with high card Ace
Seat 4: Wangritter13 (big blind) showed [Js 8d] and won ($0.38) with a pair of Eights
Seat 5: VanCleef322 folded before Flop (didn't bet)
Seat 6: chris.nomf folded before Flop (didn't bet)



PokerStars Hand #222981501880:  Hold'em No Limit ($0.05/$0.10 USD) - 2021/01/23 20:26:27 ET
Table 'Merope IV' 6-max Seat #2 is the button
Seat 1: alfaomegabet ($10.12 in chips) 
Seat 2: bigmamaa7 ($13.21 in chips) 
Seat 4: Wangritter13 ($20.01 in chips) 
Seat 5: VanCleef322 ($10.59 in chips) 
Seat 6: chris.nomf ($13.53 in chips) 
Wangritter13: posts small blind $0.05
VanCleef322: posts big blind $0.10
*** HOLE CARDS ***
chris.nomf: folds 
alfaomegabet: folds 
bigmamaa7: folds 
Wangritter13: folds 
Uncalled bet ($0.05) returned to VanCleef322
VanCleef322 collected $0.10 from pot
VanCleef322: doesn't show hand 
*** SUMMARY ***
Total pot $0.10 | Rake $0 
Seat 1: alfaomegabet folded before Flop (didn't bet)
Seat 2: bigmamaa7 (button) folded before Flop (didn't bet)
Seat 4: Wangritter13 (small blind) folded before Flop
Seat 5: VanCleef322 (big blind) collected ($0.10)
Seat 6: chris.nomf folded before Flop (didn't bet)



PokerStars Hand #222981506696:  Hold'em No Limit ($0.05/$0.10 USD) - 2021/01/23 20:26:38 ET
Table 'Merope IV' 6-max Seat #4 is the button
Seat 1: alfaomegabet ($10.12 in chips) 
Seat 2: bigmamaa7 ($13.21 in chips) 
Seat 4: Wangritter13 ($19.96 in chips) 
Seat 5: VanCleef322 ($10.64 in chips) 
Seat 6: chris.nomf ($13.53 in chips) 
VanCleef322: posts small blind $0.05
chris.nomf: posts big blind $0.10
Al7uut: sits out 
*** HOLE CARDS ***
alfaomegabet: folds 
bigmamaa7: raises $0.10 to $0.20
Wangritter13: calls $0.20
VanCleef322: folds 
chris.nomf: folds 
*** FLOP *** [Ah Qc 4d]
bigmamaa7: checks 
Wangritter13: checks 
*** TURN *** [Ah Qc 4d] [Kh]
bigmamaa7: checks 
Wangritter13: checks 
*** RIVER *** [Ah Qc 4d Kh] [6c]
bigmamaa7: bets $0.40
Wangritter13: calls $0.40
*** SHOW DOWN ***
bigmamaa7: shows [8s Jd] (high card Ace)
Wangritter13: shows [Qs 9c] (a pair of Queens)
Wangritter13 collected $1.29 from pot
*** SUMMARY ***
Total pot $1.35 | Rake $0.06 
Board [Ah Qc 4d Kh 6c]
Seat 1: alfaomegabet folded before Flop (didn't bet)
Seat 2: bigmamaa7 showed [8s Jd] and lost with high card Ace
Seat 4: Wangritter13 (button) showed [Qs 9c] and won ($1.29) with a pair of Queens
Seat 5: VanCleef322 (small blind) folded before Flop
Seat 6: chris.nomf (big blind) folded before Flop



PokerStars Hand #222981527268:  Hold'em No Limit ($0.05/$0.10 USD) - 2021/01/23 20:27:08 ET
Table 'Merope IV' 6-max Seat #5 is the button
Seat 1: alfaomegabet ($10.12 in chips) 
Seat 2: bigmamaa7 ($12.61 in chips) 
Seat 4: Wangritter13 ($20.65 in chips) 
Seat 5: VanCleef322 ($10.59 in chips) 
Seat 6: chris.nomf ($13.43 in chips) 
chris.nomf: posts small blind $0.05
alfaomegabet: posts big blind $0.10
Al7uut: sits out 
*** HOLE CARDS ***
bigmamaa7: folds 
Wangritter13: folds 
VanCleef322: folds 
chris.nomf: folds 
Uncalled bet ($0.05) returned to alfaomegabet
alfaomegabet collected $0.10 from pot
alfaomegabet: doesn't show hand 
*** SUMMARY ***
Total pot $0.10 | Rake $0 
Seat 1: alfaomegabet (big blind) collected ($0.10)
Seat 2: bigmamaa7 folded before Flop (didn't bet)
Seat 4: Wangritter13 folded before Flop (didn't bet)
Seat 5: VanCleef322 (button) folded before Flop (didn't bet)
Seat 6: chris.nomf (small blind) folded before Flop



PokerStars Hand #222981531109:  Hold'em No Limit ($0.05/$0.10 USD) - 2021/01/23 20:27:17 ET
Table 'Merope IV' 6-max Seat #6 is the button
Seat 1: alfaomegabet ($10.17 in chips) 
Seat 2: bigmamaa7 ($12.61 in chips) 
Seat 4: Wangritter13 ($20.65 in chips) 
Seat 5: VanCleef322 ($10.59 in chips) 
Seat 6: chris.nomf ($13.38 in chips) 
alfaomegabet: posts small blind $0.05
bigmamaa7: posts big blind $0.10
Al7uut: sits out 
*** HOLE CARDS ***
Wangritter13: raises $0.20 to $0.30
VanCleef322: folds 
chris.nomf: folds 
alfaomegabet: folds 
bigmamaa7 is disconnected 
bigmamaa7 has timed out while disconnected
bigmamaa7: folds 
Uncalled bet ($0.20) returned to Wangritter13
Wangritter13 collected $0.25 from pot
Wangritter13: doesn't show hand 
*** SUMMARY ***
Total pot $0.25 | Rake $0 
Seat 1: alfaomegabet (small blind) folded before Flop
Seat 2: bigmamaa7 (big blind) folded before Flop
Seat 4: Wangritter13 collected ($0.25)
Seat 5: VanCleef322 folded before Flop (didn't bet)
Seat 6: chris.nomf (button) folded before Flop (didn't bet)



PokerStars Hand #222981551425:  Hold'em No Limit ($0.05/$0.10 USD) - 2021/01/23 20:28:05 ET
Table 'Merope IV' 6-max Seat #1 is the button
Seat 1: alfaomegabet ($10.12 in chips) 
Seat 4: Wangritter13 ($20.80 in chips) 
Seat 5: VanCleef322 ($10.59 in chips) 
Seat 6: chris.nomf ($13.38 in chips) 
Wangritter13: posts small blind $0.05
VanCleef322: posts big blind $0.10
*** HOLE CARDS ***
chris.nomf: raises $0.20 to $0.30
alfaomegabet: folds 
Wangritter13: calls $0.25
VanCleef322: folds 
*** FLOP *** [7s 3d Kd]
Wangritter13: checks 
chris.nomf: bets $0.34
Wangritter13: folds 
Uncalled bet ($0.34) returned to chris.nomf
chris.nomf collected $0.67 from pot
chris.nomf: doesn't show hand 
*** SUMMARY ***
Total pot $0.70 | Rake $0.03 
Board [7s 3d Kd]
Seat 1: alfaomegabet (button) folded before Flop (didn't bet)
Seat 4: Wangritter13 (small blind) folded on the Flop
Seat 5: VanCleef322 (big blind) folded before Flop
Seat 6: chris.nomf collected ($0.67)



PokerStars Hand #222981559794:  Hold'em No Limit ($0.05/$0.10 USD) - 2021/01/23 20:28:24 ET
Table 'Merope IV' 6-max Seat #4 is the button
Seat 1: alfaomegabet ($10.12 in chips) 
Seat 4: Wangritter13 ($20.50 in chips) 
Seat 5: VanCleef322 ($10.49 in chips) 
Seat 6: chris.nomf ($13.75 in chips) 
VanCleef322: posts small blind $0.05
chris.nomf: posts big blind $0.10
bigmamaa7: sits out 
Al7uut: sits out 
*** HOLE CARDS ***
alfaomegabet: folds 
Wangritter13: folds 
VanCleef322: raises $0.15 to $0.25
chris.nomf: folds 
Uncalled bet ($0.15) returned to VanCleef322
VanCleef322 collected $0.20 from pot
VanCleef322: doesn't show hand 
*** SUMMARY ***
Total pot $0.20 | Rake $0 
Seat 1: alfaomegabet folded before Flop (didn't bet)
Seat 4: Wangritter13 (button) folded before Flop (didn't bet)
Seat 5: VanCleef322 (small blind) collected ($0.20)
Seat 6: chris.nomf (big blind) folded before Flop



PokerStars Hand #222981564551:  Hold'em No Limit ($0.05/$0.10 USD) - 2021/01/23 20:28:35 ET
Table 'Merope IV' 6-max Seat #5 is the button
Seat 1: alfaomegabet ($10.12 in chips) 
Seat 4: Wangritter13 ($20.50 in chips) 
Seat 5: VanCleef322 ($10.59 in chips) 
Seat 6: chris.nomf ($13.65 in chips) 
chris.nomf: posts small blind $0.05
alfaomegabet: posts big blind $0.10
bigmamaa7: sits out 
Al7uut: sits out 
*** HOLE CARDS ***
Wangritter13: calls $0.10
VanCleef322: folds 
chris.nomf: calls $0.05
alfaomegabet: checks 
*** FLOP *** [5s Js Kh]
chris.nomf: checks 
alfaomegabet: checks 
Wangritter13: bets $0.14
chris.nomf: raises $0.29 to $0.43
alfaomegabet: folds 
Wangritter13: folds 
Uncalled bet ($0.29) returned to chris.nomf
chris.nomf collected $0.55 from pot
chris.nomf: doesn't show hand 
*** SUMMARY ***
Total pot $0.58 | Rake $0.03 
Board [5s Js Kh]
Seat 1: alfaomegabet (big blind) folded on the Flop
Seat 4: Wangritter13 folded on the Flop
Seat 5: VanCleef322 (button) folded before Flop (didn't bet)
Seat 6: chris.nomf (small blind) collected ($0.55)



PokerStars Hand #222981587686:  Hold'em No Limit ($0.05/$0.10 USD) - 2021/01/23 20:29:29 ET
Table 'Merope IV' 6-max Seat #6 is the button
Seat 1: alfaomegabet ($10.02 in chips) 
Seat 2: bigmamaa7 ($12.51 in chips) 
Seat 4: Wangritter13 ($20.26 in chips) 
Seat 5: VanCleef322 ($10.59 in chips) 
Seat 6: chris.nomf ($13.96 in chips) 
alfaomegabet: posts small blind $0.05
bigmamaa7: posts big blind $0.10
Al7uut: sits out 
*** HOLE CARDS ***
Wangritter13: folds 
VanCleef322: folds 
chris.nomf: folds 
alfaomegabet: folds 
Uncalled bet ($0.05) returned to bigmamaa7
bigmamaa7 collected $0.10 from pot
bigmamaa7: doesn't show hand 
*** SUMMARY ***
Total pot $0.10 | Rake $0 
Seat 1: alfaomegabet (small blind) folded before Flop
Seat 2: bigmamaa7 (big blind) collected ($0.10)
Seat 4: Wangritter13 folded before Flop (didn't bet)
Seat 5: VanCleef322 folded before Flop (didn't bet)
Seat 6: chris.nomf (button) folded before Flop (didn't bet)



PokerStars Hand #222981590207:  Hold'em No Limit ($0.05/$0.10 USD) - 2021/01/23 20:29:35 ET
Table 'Merope IV' 6-max Seat #1 is the button
Seat 1: alfaomegabet ($10 in chips) 
Seat 2: bigmamaa7 ($12.56 in chips) 
Seat 3: Al7uut ($8 in chips) 
Seat 4: Wangritter13 ($20.26 in chips) 
Seat 5: VanCleef322 ($10.59 in chips) 
Seat 6: chris.nomf ($13.96 in chips) 
bigmamaa7: posts small blind $0.05
Al7uut: posts big blind $0.10
*** HOLE CARDS ***
Wangritter13: folds 
VanCleef322: raises $0.15 to $0.25
chris.nomf: folds 
alfaomegabet: calls $0.25
bigmamaa7: calls $0.20
Al7uut: calls $0.15
*** FLOP *** [4s 2d Qh]
bigmamaa7: checks 
Al7uut: checks 
VanCleef322: checks 
alfaomegabet: checks 
*** TURN *** [4s 2d Qh] [Qd]
bigmamaa7: checks 
Al7uut: checks 
VanCleef322: checks 
alfaomegabet: checks 
*** RIVER *** [4s 2d Qh Qd] [Qs]
bigmamaa7: checks 
Al7uut: checks 
VanCleef322: checks 
alfaomegabet: checks 
*** SHOW DOWN ***
bigmamaa7: shows [9d Jh] (three of a kind, Queens)
Al7uut: mucks hand 
VanCleef322: shows [7d Ah] (three of a kind, Queens - Ace kicker)
alfaomegabet: shows [Ks Ac] (three of a kind, Queens - Ace+King kicker)
alfaomegabet collected $0.96 from pot
*** SUMMARY ***
Total pot $1 | Rake $0.04 
Board [4s 2d Qh Qd Qs]
Seat 1: alfaomegabet (button) showed [Ks Ac] and won ($0.96) with three of a kind, Queens
Seat 2: bigmamaa7 (small blind) showed [9d Jh] and lost with three of a kind, Queens
Seat 3: Al7uut (big blind) mucked
Seat 4: Wangritter13 folded before Flop (didn't bet)
Seat 5: VanCleef322 showed [7d Ah] and lost with three of a kind, Queens
Seat 6: chris.nomf folded before Flop (didn't bet)



PokerStars Hand #222981611365:  Hold'em No Limit ($0.05/$0.10 USD) - 2021/01/23 20:30:24 ET
Table 'Merope IV' 6-max Seat #2 is the button
Seat 1: alfaomegabet ($10.71 in chips) 
Seat 2: bigmamaa7 ($12.31 in chips) 
Seat 3: Al7uut ($7.75 in chips) 
Seat 4: Wangritter13 ($20.26 in chips) 
Seat 5: VanCleef322 ($10.34 in chips) 
Seat 6: chris.nomf ($13.96 in chips) 
Al7uut: posts small blind $0.05
Wangritter13: posts big blind $0.10
*** HOLE CARDS ***
VanCleef322: folds 
chris.nomf: raises $0.20 to $0.30
alfaomegabet: folds 
bigmamaa7: calls $0.30
Al7uut: calls $0.25
Wangritter13: folds 
*** FLOP *** [Tc 4c 3h]
Al7uut: bets $0.40
chris.nomf: folds 
bigmamaa7: folds 
Uncalled bet ($0.40) returned to Al7uut
Al7uut collected $0.96 from pot
Al7uut: doesn't show hand 
*** SUMMARY ***
Total pot $1 | Rake $0.04 
Board [Tc 4c 3h]
Seat 1: alfaomegabet folded before Flop (didn't bet)
Seat 2: bigmamaa7 (button) folded on the Flop
Seat 3: Al7uut (small blind) collected ($0.96)
Seat 4: Wangritter13 (big blind) folded before Flop
Seat 5: VanCleef322 folded before Flop (didn't bet)
Seat 6: chris.nomf folded on the Flop



PokerStars Hand #222981623710:  Hold'em No Limit ($0.05/$0.10 USD) - 2021/01/23 20:30:53 ET
Table 'Merope IV' 6-max Seat #3 is the button
Seat 1: alfaomegabet ($10.71 in chips) 
Seat 2: bigmamaa7 ($12.01 in chips) 
Seat 3: Al7uut ($8.41 in chips) 
Seat 4: Wangritter13 ($20.16 in chips) 
Seat 5: VanCleef322 ($10.34 in chips) 
Seat 6: chris.nomf ($13.66 in chips) 
Wangritter13: posts small blind $0.05
VanCleef322: posts big blind $0.10
*** HOLE CARDS ***
chris.nomf: folds 
alfaomegabet: folds 
bigmamaa7: folds 
Al7uut: raises $0.10 to $0.20
Wangritter13: raises $0.40 to $0.60
VanCleef322: folds 
Al7uut: calls $0.40
*** FLOP *** [Ks Jc Kc]
Wangritter13: checks 
Al7uut: checks 
*** TURN *** [Ks Jc Kc] [6c]
Wangritter13: checks 
Al7uut: bets $0.80
Wangritter13: folds 
Uncalled bet ($0.80) returned to Al7uut
Al7uut collected $1.24 from pot
Al7uut: doesn't show hand 
*** SUMMARY ***
Total pot $1.30 | Rake $0.06 
Board [Ks Jc Kc 6c]
Seat 1: alfaomegabet folded before Flop (didn't bet)
Seat 2: bigmamaa7 folded before Flop (didn't bet)
Seat 3: Al7uut (button) collected ($1.24)
Seat 4: Wangritter13 (small blind) folded on the Turn
Seat 5: VanCleef322 (big blind) folded before Flop
Seat 6: chris.nomf folded before Flop (didn't bet)



PokerStars Hand #222981646045:  Hold'em No Limit ($0.05/$0.10 USD) - 2021/01/23 20:31:44 ET
Table 'Merope IV' 6-max Seat #4 is the button
Seat 1: alfaomegabet ($10.71 in chips) 
Seat 2: bigmamaa7 ($12.01 in chips) 
Seat 3: Al7uut ($9.05 in chips) 
Seat 4: Wangritter13 ($19.56 in chips) 
Seat 5: VanCleef322 ($10.24 in chips) 
Seat 6: chris.nomf ($13.66 in chips) 
VanCleef322: posts small blind $0.05
chris.nomf: posts big blind $0.10
*** HOLE CARDS ***
alfaomegabet: folds 
bigmamaa7 has timed out
bigmamaa7: folds 
Al7uut: raises $0.40 to $0.50
Wangritter13: folds 
VanCleef322: folds 
chris.nomf: folds 
Uncalled bet ($0.40) returned to Al7uut
Al7uut collected $0.25 from pot
Al7uut: doesn't show hand 
*** SUMMARY ***
Total pot $0.25 | Rake $0 
Seat 1: alfaomegabet folded before Flop (didn't bet)
Seat 2: bigmamaa7 folded before Flop (didn't bet)
Seat 3: Al7uut collected ($0.25)
Seat 4: Wangritter13 (button) folded before Flop (didn't bet)
Seat 5: VanCleef322 (small blind) folded before Flop
Seat 6: chris.nomf (big blind) folded before Flop



PokerStars Hand #222981658608:  Hold'em No Limit ($0.05/$0.10 USD) - 2021/01/23 20:32:13 ET
Table 'Merope IV' 6-max Seat #5 is the button
Seat 1: alfaomegabet ($10.71 in chips) 
Seat 2: bigmamaa7 ($12.01 in chips) 
Seat 3: Al7uut ($9.20 in chips) 
Seat 4: Wangritter13 ($19.56 in chips) 
Seat 5: VanCleef322 ($10.19 in chips) 
Seat 6: chris.nomf ($13.56 in chips) 
chris.nomf: posts small blind $0.05
alfaomegabet: posts big blind $0.10
*** HOLE CARDS ***
bigmamaa7: calls $0.10
Al7uut: raises $0.40 to $0.50
Wangritter13: folds 
VanCleef322: folds 
chris.nomf: calls $0.45
alfaomegabet: folds 
bigmamaa7: calls $0.40
*** FLOP *** [Js 5h 5s]
chris.nomf: checks 
bigmamaa7: checks 
Al7uut: bets $8.70 and is all-in
chris.nomf: folds 
bigmamaa7: calls $8.70
*** TURN *** [Js 5h 5s] [Qh]
*** RIVER *** [Js 5h 5s Qh] [6h]
*** SHOW DOWN ***
bigmamaa7: shows [3s 2s] (a pair of Fives)
Al7uut: shows [Kd Kc] (two pair, Kings and Fives)
Al7uut collected $18.14 from pot
*** SUMMARY ***
Total pot $19 | Rake $0.86 
Board [Js 5h 5s Qh 6h]
Seat 1: alfaomegabet (big blind) folded before Flop
Seat 2: bigmamaa7 showed [3s 2s] and lost with a pair of Fives
Seat 3: Al7uut showed [Kd Kc] and won ($18.14) with two pair, Kings and Fives
Seat 4: Wangritter13 folded before Flop (didn't bet)
Seat 5: VanCleef322 (button) folded before Flop (didn't bet)
Seat 6: chris.nomf (small blind) folded on the Flop



PokerStars Hand #222981676975:  Hold'em No Limit ($0.05/$0.10 USD) - 2021/01/23 20:32:56 ET
Table 'Merope IV' 6-max Seat #6 is the button
Seat 1: alfaomegabet ($10.61 in chips) 
Seat 2: bigmamaa7 ($2.81 in chips) 
Seat 3: Al7uut ($18.14 in chips) 
Seat 4: Wangritter13 ($19.56 in chips) 
Seat 5: VanCleef322 ($10.19 in chips) 
Seat 6: chris.nomf ($13.06 in chips) 
alfaomegabet: posts small blind $0.05
bigmamaa7: posts big blind $0.10
*** HOLE CARDS ***
Al7uut: raises $0.40 to $0.50
Wangritter13: folds 
VanCleef322: folds 
chris.nomf: folds 
alfaomegabet: folds 
bigmamaa7: folds 
Uncalled bet ($0.40) returned to Al7uut
bigmamaa7 leaves the table
Al7uut collected $0.25 from pot
Al7uut: doesn't show hand 
*** SUMMARY ***
Total pot $0.25 | Rake $0 
Seat 1: alfaomegabet (small blind) folded before Flop
Seat 2: bigmamaa7 (big blind) folded before Flop
Seat 3: Al7uut collected ($0.25)
Seat 4: Wangritter13 folded before Flop (didn't bet)
Seat 5: VanCleef322 folded before Flop (didn't bet)
Seat 6: chris.nomf (button) folded before Flop (didn't bet)



PokerStars Hand #222981684109:  Hold'em No Limit ($0.05/$0.10 USD) - 2021/01/23 20:33:13 ET
Table 'Merope IV' 6-max Seat #1 is the button
Seat 1: alfaomegabet ($10.56 in chips) 
Seat 3: Al7uut ($18.29 in chips) 
Seat 4: Wangritter13 ($19.56 in chips) 
Seat 5: VanCleef322 ($10.19 in chips) 
Seat 6: chris.nomf ($13.06 in chips) 
Al7uut: posts small blind $0.05
Wangritter13: posts big blind $0.10
*** HOLE CARDS ***
VanCleef322: folds 
chris.nomf: folds 
alfaomegabet: raises $0.20 to $0.30
Al7uut: raises $0.60 to $0.90
Wangritter13: folds 
xferjgb joins the table at seat #2 
alfaomegabet: folds 
Uncalled bet ($0.60) returned to Al7uut
Al7uut collected $0.70 from pot
Al7uut: doesn't show hand 
*** SUMMARY ***
Total pot $0.70 | Rake $0 
Seat 1: alfaomegabet (button) folded before Flop
Seat 3: Al7uut (small blind) collected ($0.70)
Seat 4: Wangritter13 (big blind) folded before Flop
Seat 5: VanCleef322 folded before Flop (didn't bet)
Seat 6: chris.nomf folded before Flop (didn't bet)



PokerStars Hand #222981690993:  Hold'em No Limit ($0.05/$0.10 USD) - 2021/01/23 20:33:29 ET
Table 'Merope IV' 6-max Seat #3 is the button
Seat 1: alfaomegabet ($10.26 in chips) 
Seat 3: Al7uut ($18.69 in chips) 
Seat 4: Wangritter13 ($19.46 in chips) 
Seat 5: VanCleef322 ($10.19 in chips) 
Seat 6: chris.nomf ($13.06 in chips) 
Wangritter13: posts small blind $0.05
VanCleef322: posts big blind $0.10
xferjgb: sits out 
*** HOLE CARDS ***
chris.nomf: raises $0.20 to $0.30
alfaomegabet: folds 
Al7uut: folds 
Wangritter13: folds 
VanCleef322: calls $0.20
*** FLOP *** [9s 8c 2s]
VanCleef322: checks 
chris.nomf: checks 
*** TURN *** [9s 8c 2s] [8h]
VanCleef322: bets $0.45
chris.nomf: calls $0.45
*** RIVER *** [9s 8c 2s 8h] [5c]
VanCleef322: bets $0.95
chris.nomf: folds 
Uncalled bet ($0.95) returned to VanCleef322
VanCleef322 collected $1.48 from pot
VanCleef322: doesn't show hand 
*** SUMMARY ***
Total pot $1.55 | Rake $0.07 
Board [9s 8c 2s 8h 5c]
Seat 1: alfaomegabet folded before Flop (didn't bet)
Seat 3: Al7uut (button) folded before Flop (didn't bet)
Seat 4: Wangritter13 (small blind) folded before Flop
Seat 5: VanCleef322 (big blind) collected ($1.48)
Seat 6: chris.nomf folded on the River



PokerStars Hand #222981705268:  Hold'em No Limit ($0.05/$0.10 USD) - 2021/01/23 20:34:01 ET
Table 'Merope IV' 6-max Seat #4 is the button
Seat 1: alfaomegabet ($10.26 in chips) 
Seat 3: Al7uut ($18.69 in chips) 
Seat 4: Wangritter13 ($19.41 in chips) 
Seat 5: VanCleef322 ($10.92 in chips) 
Seat 6: chris.nomf ($12.31 in chips) 
VanCleef322: posts small blind $0.05
chris.nomf: posts big blind $0.10
xferjgb: sits out 
*** HOLE CARDS ***
alfaomegabet: folds 
Al7uut: raises $0.20 to $0.30
Wangritter13: folds 
VanCleef322: folds 
chris.nomf: folds 
Uncalled bet ($0.20) returned to Al7uut
Al7uut collected $0.25 from pot
Al7uut: doesn't show hand 
*** SUMMARY ***
Total pot $0.25 | Rake $0 
Seat 1: alfaomegabet folded before Flop (didn't bet)
Seat 3: Al7uut collected ($0.25)
Seat 4: Wangritter13 (button) folded before Flop (didn't bet)
Seat 5: VanCleef322 (small blind) folded before Flop
Seat 6: chris.nomf (big blind) folded before Flop



PokerStars Hand #222981710626:  Hold'em No Limit ($0.05/$0.10 USD) - 2021/01/23 20:34:14 ET
Table 'Merope IV' 6-max Seat #5 is the button
Seat 1: alfaomegabet ($10.26 in chips) 
Seat 3: Al7uut ($18.84 in chips) 
Seat 4: Wangritter13 ($19.41 in chips) 
Seat 5: VanCleef322 ($10.87 in chips) 
Seat 6: chris.nomf ($12.21 in chips) 
chris.nomf: posts small blind $0.05
alfaomegabet: posts big blind $0.10
xferjgb: sits out 
*** HOLE CARDS ***
Al7uut: raises $0.40 to $0.50
Wangritter13: folds 
VanCleef322: folds 
chris.nomf: folds 
alfaomegabet: folds 
Uncalled bet ($0.40) returned to Al7uut
Al7uut collected $0.25 from pot
Al7uut: doesn't show hand 
*** SUMMARY ***
Total pot $0.25 | Rake $0 
Seat 1: alfaomegabet (big blind) folded before Flop
Seat 3: Al7uut collected ($0.25)
Seat 4: Wangritter13 folded before Flop (didn't bet)
Seat 5: VanCleef322 (button) folded before Flop (didn't bet)
Seat 6: chris.nomf (small blind) folded before Flop



PokerStars Hand #222981721697:  Hold'em No Limit ($0.05/$0.10 USD) - 2021/01/23 20:34:34 ET
Table 'Merope IV' 6-max Seat #6 is the button
Seat 1: alfaomegabet ($10.16 in chips) 
Seat 2: xferjgb ($6 in chips) 
Seat 3: Al7uut ($18.99 in chips) 
Seat 4: Wangritter13 ($19.41 in chips) 
Seat 5: VanCleef322 ($10.87 in chips) 
Seat 6: chris.nomf ($12.16 in chips) 
alfaomegabet: posts small blind $0.05
xferjgb: posts big blind $0.10
*** HOLE CARDS ***
Al7uut: raises $0.30 to $0.40
Wangritter13: folds 
VanCleef322: folds 
chris.nomf: folds 
alfaomegabet: folds 
xferjgb: raises $0.70 to $1.10
Al7uut: calls $0.70
*** FLOP *** [7s Qh 6d]
xferjgb: checks 
Al7uut: bets $0.60
xferjgb: calls $0.60
*** TURN *** [7s Qh 6d] [9d]
xferjgb: checks 
Al7uut: bets $17.29 and is all-in
xferjgb: folds 
Uncalled bet ($17.29) returned to Al7uut
Al7uut collected $3.29 from pot
Al7uut: doesn't show hand 
*** SUMMARY ***
Total pot $3.45 | Rake $0.16 
Board [7s Qh 6d 9d]
Seat 1: alfaomegabet (small blind) folded before Flop
Seat 2: xferjgb (big blind) folded on the Turn
Seat 3: Al7uut collected ($3.29)
Seat 4: Wangritter13 folded before Flop (didn't bet)
Seat 5: VanCleef322 folded before Flop (didn't bet)
Seat 6: chris.nomf (button) folded before Flop (didn't bet)



PokerStars Hand #222981747715:  Hold'em No Limit ($0.05/$0.10 USD) - 2021/01/23 20:35:34 ET
Table 'Merope IV' 6-max Seat #1 is the button
Seat 1: alfaomegabet ($10.11 in chips) 
Seat 2: xferjgb ($4.30 in chips) 
Seat 3: Al7uut ($20.58 in chips) 
Seat 4: Wangritter13 ($19.41 in chips) 
Seat 5: VanCleef322 ($10.87 in chips) 
Seat 6: chris.nomf ($12.16 in chips) 
xferjgb: posts small blind $0.05
Al7uut: posts big blind $0.10
*** HOLE CARDS ***
Wangritter13: folds 
VanCleef322: folds 
chris.nomf: raises $0.20 to $0.30
alfaomegabet: folds 
xferjgb: folds 
Al7uut: raises $0.40 to $0.70
chris.nomf: calls $0.40
*** FLOP *** [6s 9s 7s]
Al7uut: bets $0.80
chris.nomf: calls $0.80
*** TURN *** [6s 9s 7s] [Ad]
Al7uut: bets $1.40
chris.nomf: calls $1.40
*** RIVER *** [6s 9s 7s Ad] [6d]
Al7uut: checks 
chris.nomf: checks 
*** SHOW DOWN ***
Al7uut: shows [Js Tc] (a pair of Sixes)
chris.nomf: shows [Kh 9h] (two pair, Nines and Sixes)
chris.nomf collected $5.59 from pot
*** SUMMARY ***
Total pot $5.85 | Rake $0.26 
Board [6s 9s 7s Ad 6d]
Seat 1: alfaomegabet (button) folded before Flop (didn't bet)
Seat 2: xferjgb (small blind) folded before Flop
Seat 3: Al7uut (big blind) showed [Js Tc] and lost with a pair of Sixes
Seat 4: Wangritter13 folded before Flop (didn't bet)
Seat 5: VanCleef322 folded before Flop (didn't bet)
Seat 6: chris.nomf showed [Kh 9h] and won ($5.59) with two pair, Nines and Sixes



PokerStars Hand #222981768809:  Hold'em No Limit ($0.05/$0.10 USD) - 2021/01/23 20:36:24 ET
Table 'Merope IV' 6-max Seat #2 is the button
Seat 1: alfaomegabet ($10.11 in chips) 
Seat 2: xferjgb ($4.25 in chips) 
Seat 3: Al7uut ($17.68 in chips) 
Seat 4: Wangritter13 ($19.41 in chips) 
Seat 5: VanCleef322 ($10.87 in chips) 
Seat 6: chris.nomf ($14.85 in chips) 
Al7uut: posts small blind $0.05
Wangritter13: posts big blind $0.10
*** HOLE CARDS ***
VanCleef322: raises $0.15 to $0.25
chris.nomf: folds 
alfaomegabet: folds 
xferjgb: folds 
Al7uut: raises $0.15 to $0.40
Wangritter13: calls $0.30
VanCleef322: calls $0.15
*** FLOP *** [9s 9h 3d]
Al7uut: checks 
Wangritter13: checks 
VanCleef322: bets $0.38
Al7uut: folds 
Wangritter13: folds 
Uncalled bet ($0.38) returned to VanCleef322
VanCleef322 collected $1.15 from pot
VanCleef322: doesn't show hand 
*** SUMMARY ***
Total pot $1.20 | Rake $0.05 
Board [9s 9h 3d]
Seat 1: alfaomegabet folded before Flop (didn't bet)
Seat 2: xferjgb (button) folded before Flop (didn't bet)
Seat 3: Al7uut (small blind) folded on the Flop
Seat 4: Wangritter13 (big blind) folded on the Flop
Seat 5: VanCleef322 collected ($1.15)
Seat 6: chris.nomf folded before Flop (didn't bet)



PokerStars Hand #222981784573:  Hold'em No Limit ($0.05/$0.10 USD) - 2021/01/23 20:37:01 ET
Table 'Merope IV' 6-max Seat #3 is the button
Seat 1: alfaomegabet ($10.11 in chips) 
Seat 2: xferjgb ($4.25 in chips) 
Seat 3: Al7uut ($17.28 in chips) 
Seat 4: Wangritter13 ($19.01 in chips) 
Seat 5: VanCleef322 ($11.62 in chips) 
Seat 6: chris.nomf ($14.85 in chips) 
Wangritter13: posts small blind $0.05
VanCleef322: posts big blind $0.10
*** HOLE CARDS ***
chris.nomf: folds 
alfaomegabet: folds 
xferjgb: folds 
Al7uut: raises $0.30 to $0.40
Wangritter13: folds 
VanCleef322: folds 
Uncalled bet ($0.30) returned to Al7uut
Al7uut collected $0.25 from pot
Al7uut: doesn't show hand 
*** SUMMARY ***
Total pot $0.25 | Rake $0 
Seat 1: alfaomegabet folded before Flop (didn't bet)
Seat 2: xferjgb folded before Flop (didn't bet)
Seat 3: Al7uut (button) collected ($0.25)
Seat 4: Wangritter13 (small blind) folded before Flop
Seat 5: VanCleef322 (big blind) folded before Flop
Seat 6: chris.nomf folded before Flop (didn't bet)



PokerStars Hand #222981791142:  Hold'em No Limit ($0.05/$0.10 USD) - 2021/01/23 20:37:17 ET
Table 'Merope IV' 6-max Seat #4 is the button
Seat 1: alfaomegabet ($10.11 in chips) 
Seat 2: xferjgb ($4.25 in chips) 
Seat 3: Al7uut ($17.43 in chips) 
Seat 4: Wangritter13 ($18.96 in chips) 
Seat 5: VanCleef322 ($11.52 in chips) 
Seat 6: chris.nomf ($14.85 in chips) 
VanCleef322: posts small blind $0.05
chris.nomf: posts big blind $0.10
*** HOLE CARDS ***
alfaomegabet: folds 
xferjgb: calls $0.10
Al7uut: raises $0.30 to $0.40
Wangritter13: calls $0.40
VanCleef322: folds 
chris.nomf: folds 
xferjgb: calls $0.30
*** FLOP *** [Kd 6c 3s]
xferjgb: checks 
Al7uut: checks 
Wangritter13: checks 
*** TURN *** [Kd 6c 3s] [Ac]
xferjgb: checks 
Al7uut: bets $0.50
Wangritter13: calls $0.50
xferjgb: calls $0.50
*** RIVER *** [Kd 6c 3s Ac] [8h]
xferjgb: checks 
Al7uut: checks 
Wangritter13: bets $1.36
xferjgb: folds 
Al7uut: folds 
Uncalled bet ($1.36) returned to Wangritter13
Wangritter13 collected $2.72 from pot
Wangritter13: doesn't show hand 
*** SUMMARY ***
Total pot $2.85 | Rake $0.13 
Board [Kd 6c 3s Ac 8h]
Seat 1: alfaomegabet folded before Flop (didn't bet)
Seat 2: xferjgb folded on the River
Seat 3: Al7uut folded on the River
Seat 4: Wangritter13 (button) collected ($2.72)
Seat 5: VanCleef322 (small blind) folded before Flop
Seat 6: chris.nomf (big blind) folded before Flop



PokerStars Hand #222981816797:  Hold'em No Limit ($0.05/$0.10 USD) - 2021/01/23 20:38:18 ET
Table 'Merope IV' 6-max Seat #5 is the button
Seat 1: alfaomegabet ($10.11 in chips) 
Seat 2: xferjgb ($3.35 in chips) 
Seat 3: Al7uut ($16.53 in chips) 
Seat 4: Wangritter13 ($20.78 in chips) 
Seat 5: VanCleef322 ($11.47 in chips) 
Seat 6: chris.nomf ($14.75 in chips) 
chris.nomf: posts small blind $0.05
alfaomegabet: posts big blind $0.10
*** HOLE CARDS ***
xferjgb: folds 
Al7uut: raises $0.40 to $0.50
Wangritter13: folds 
VanCleef322: folds 
chris.nomf: folds 
alfaomegabet: folds 
Uncalled bet ($0.40) returned to Al7uut
Al7uut collected $0.25 from pot
Al7uut: doesn't show hand 
*** SUMMARY ***
Total pot $0.25 | Rake $0 
Seat 1: alfaomegabet (big blind) folded before Flop
Seat 2: xferjgb folded before Flop (didn't bet)
Seat 3: Al7uut collected ($0.25)
Seat 4: Wangritter13 folded before Flop (didn't bet)
Seat 5: VanCleef322 (button) folded before Flop (didn't bet)
Seat 6: chris.nomf (small blind) folded before Flop



PokerStars Hand #222981823015:  Hold'em No Limit ($0.05/$0.10 USD) - 2021/01/23 20:38:32 ET
Table 'Merope IV' 6-max Seat #6 is the button
Seat 1: alfaomegabet ($10.01 in chips) 
Seat 2: xferjgb ($3.35 in chips) 
Seat 3: Al7uut ($16.68 in chips) 
Seat 4: Wangritter13 ($20.78 in chips) 
Seat 5: VanCleef322 ($11.47 in chips) 
Seat 6: chris.nomf ($14.70 in chips) 
alfaomegabet: posts small blind $0.05
xferjgb: posts big blind $0.10
*** HOLE CARDS ***
Al7uut: folds 
Wangritter13: folds 
VanCleef322: folds 
chris.nomf has timed out
chris.nomf: folds 
alfaomegabet: raises $0.20 to $0.30
xferjgb: calls $0.20
*** FLOP *** [5c 9s 9h]
alfaomegabet: bets $0.19
xferjgb: calls $0.19
*** TURN *** [5c 9s 9h] [6s]
alfaomegabet: bets $0.72
xferjgb: folds 
Uncalled bet ($0.72) returned to alfaomegabet
alfaomegabet collected $0.94 from pot
alfaomegabet: doesn't show hand 
*** SUMMARY ***
Total pot $0.98 | Rake $0.04 
Board [5c 9s 9h 6s]
Seat 1: alfaomegabet (small blind) collected ($0.94)
Seat 2: xferjgb (big blind) folded on the Turn
Seat 3: Al7uut folded before Flop (didn't bet)
Seat 4: Wangritter13 folded before Flop (didn't bet)
Seat 5: VanCleef322 folded before Flop (didn't bet)
Seat 6: chris.nomf (button) folded before Flop (didn't bet)



PokerStars Hand #222981843631:  Hold'em No Limit ($0.05/$0.10 USD) - 2021/01/23 20:39:14 ET
Table 'Merope IV' 6-max Seat #1 is the button
Seat 1: alfaomegabet ($10.46 in chips) 
Seat 2: xferjgb ($2.86 in chips) 
Seat 3: Al7uut ($16.68 in chips) 
Seat 4: Wangritter13 ($20.78 in chips) 
Seat 5: VanCleef322 ($11.47 in chips) 
Seat 6: chris.nomf ($14.70 in chips) 
xferjgb: posts small blind $0.05
Al7uut: posts big blind $0.10
*** HOLE CARDS ***
Wangritter13: folds 
VanCleef322: folds 
chris.nomf: folds 
alfaomegabet: folds 
xferjgb: folds 
Uncalled bet ($0.05) returned to Al7uut
Al7uut collected $0.10 from pot
Al7uut: doesn't show hand 
*** SUMMARY ***
Total pot $0.10 | Rake $0 
Seat 1: alfaomegabet (button) folded before Flop (didn't bet)
Seat 2: xferjgb (small blind) folded before Flop
Seat 3: Al7uut (big blind) collected ($0.10)
Seat 4: Wangritter13 folded before Flop (didn't bet)
Seat 5: VanCleef322 folded before Flop (didn't bet)
Seat 6: chris.nomf folded before Flop (didn't bet)



PokerStars Hand #222981847022:  Hold'em No Limit ($0.05/$0.10 USD) - 2021/01/23 20:39:22 ET
Table 'Merope IV' 6-max Seat #2 is the button
Seat 1: alfaomegabet ($10.46 in chips) 
Seat 2: xferjgb ($2.81 in chips) 
Seat 3: Al7uut ($16.73 in chips) 
Seat 4: Wangritter13 ($20.78 in chips) 
Seat 5: VanCleef322 ($11.47 in chips) 
Seat 6: chris.nomf ($14.70 in chips) 
Al7uut: posts small blind $0.05
Wangritter13: posts big blind $0.10
*** HOLE CARDS ***
VanCleef322: folds 
chris.nomf: raises $0.20 to $0.30
alfaomegabet: folds 
xferjgb: folds 
Al7uut: calls $0.25
Wangritter13: calls $0.20
*** FLOP *** [5c 3c Ah]
Al7uut: bets $0.40
Wangritter13: folds 
chris.nomf: calls $0.40
*** TURN *** [5c 3c Ah] [Kh]
Al7uut: bets $0.40
chris.nomf: calls $0.40
*** RIVER *** [5c 3c Ah Kh] [7s]
Al7uut: bets $0.60
chris.nomf: calls $0.60
*** SHOW DOWN ***
Al7uut: shows [Js 2c] (high card Ace)
chris.nomf: shows [Jd As] (a pair of Aces)
chris.nomf collected $3.53 from pot
*** SUMMARY ***
Total pot $3.70 | Rake $0.17 
Board [5c 3c Ah Kh 7s]
Seat 1: alfaomegabet folded before Flop (didn't bet)
Seat 2: xferjgb (button) folded before Flop (didn't bet)
Seat 3: Al7uut (small blind) showed [Js 2c] and lost with high card Ace
Seat 4: Wangritter13 (big blind) folded on the Flop
Seat 5: VanCleef322 folded before Flop (didn't bet)
Seat 6: chris.nomf showed [Jd As] and won ($3.53) with a pair of Aces



PokerStars Hand #222981870065:  Hold'em No Limit ($0.05/$0.10 USD) - 2021/01/23 20:40:17 ET
Table 'Merope IV' 6-max Seat #3 is the button
Seat 1: alfaomegabet ($10.46 in chips) 
Seat 2: xferjgb ($2.81 in chips) 
Seat 3: Al7uut ($15.03 in chips) 
Seat 4: Wangritter13 ($20.48 in chips) 
Seat 5: VanCleef322 ($11.47 in chips) 
Seat 6: chris.nomf ($16.53 in chips) 
Wangritter13: posts small blind $0.05
VanCleef322: posts big blind $0.10
*** HOLE CARDS ***
chris.nomf: folds 
alfaomegabet: folds 
xferjgb: calls $0.10
Al7uut: raises $0.10 to $0.20
Wangritter13: calls $0.15
VanCleef322: calls $0.10
xferjgb: raises $2.61 to $2.81 and is all-in
Al7uut: calls $2.61
Wangritter13: calls $2.61
VanCleef322: folds 
*** FLOP *** [8h Ad 5h]
Wangritter13: checks 
Al7uut: bets $12.22 and is all-in
Wangritter13: folds 
Uncalled bet ($12.22) returned to Al7uut
*** TURN *** [8h Ad 5h] [Qh]
*** RIVER *** [8h Ad 5h Qh] [4h]
*** SHOW DOWN ***
xferjgb: shows [Jd Qc] (a pair of Queens)
Al7uut: shows [3s 2c] (a straight, Ace to Five)
Al7uut collected $8.24 from pot
*** SUMMARY ***
Total pot $8.63 | Rake $0.39 
Board [8h Ad 5h Qh 4h]
Seat 1: alfaomegabet folded before Flop (didn't bet)
Seat 2: xferjgb showed [Jd Qc] and lost with a pair of Queens
Seat 3: Al7uut (button) showed [3s 2c] and won ($8.24) with a straight, Ace to Five
Seat 4: Wangritter13 (small blind) folded on the Flop
Seat 5: VanCleef322 (big blind) folded before Flop
Seat 6: chris.nomf folded before Flop (didn't bet)



PokerStars Hand #222981891872:  Hold'em No Limit ($0.05/$0.10 USD) - 2021/01/23 20:41:08 ET
Table 'Merope IV' 6-max Seat #4 is the button
Seat 1: alfaomegabet ($10.46 in chips) 
Seat 3: Al7uut ($20.46 in chips) 
Seat 4: Wangritter13 ($17.67 in chips) 
Seat 5: VanCleef322 ($11.27 in chips) 
Seat 6: chris.nomf ($16.53 in chips) 
VanCleef322: posts small blind $0.05
chris.nomf: posts big blind $0.10
*** HOLE CARDS ***
alfaomegabet: folds 
Al7uut: raises $0.10 to $0.20
Wangritter13: calls $0.20
xferjgb leaves the table
VanCleef322: calls $0.15
chris.nomf: calls $0.10
*** FLOP *** [9d 3d 2s]
VanCleef322: checks 
chris.nomf: checks 
Al7uut: checks 
Wangritter13: checks 
*** TURN *** [9d 3d 2s] [5h]
VanCleef322: bets $0.25
chris.nomf: calls $0.25
Al7uut: calls $0.25
Wangritter13: folds 
*** RIVER *** [9d 3d 2s 5h] [4c]
VanCleef322: checks 
LimpinRabbit joins the table at seat #2 
chris.nomf: bets $0.74
Al7uut: folds 
VanCleef322: folds 
Uncalled bet ($0.74) returned to chris.nomf
chris.nomf collected $1.48 from pot
chris.nomf: doesn't show hand 
*** SUMMARY ***
Total pot $1.55 | Rake $0.07 
Board [9d 3d 2s 5h 4c]
Seat 1: alfaomegabet folded before Flop (didn't bet)
Seat 3: Al7uut folded on the River
Seat 4: Wangritter13 (button) folded on the Turn
Seat 5: VanCleef322 (small blind) folded on the River
Seat 6: chris.nomf (big blind) collected ($1.48)



PokerStars Hand #222981911363:  Hold'em No Limit ($0.05/$0.10 USD) - 2021/01/23 20:41:55 ET
Table 'Merope IV' 6-max Seat #5 is the button
Seat 1: alfaomegabet ($10.46 in chips) 
Seat 3: Al7uut ($20.01 in chips) 
Seat 4: Wangritter13 ($17.47 in chips) 
Seat 5: VanCleef322 ($10.82 in chips) 
Seat 6: chris.nomf ($17.56 in chips) 
chris.nomf: posts small blind $0.05
alfaomegabet: posts big blind $0.10
LimpinRabbit: sits out 
*** HOLE CARDS ***
Al7uut: raises $0.40 to $0.50
Wangritter13: folds 
VanCleef322: folds 
chris.nomf: folds 
alfaomegabet: folds 
Uncalled bet ($0.40) returned to Al7uut
Al7uut collected $0.25 from pot
Al7uut: doesn't show hand 
*** SUMMARY ***
Total pot $0.25 | Rake $0 
Seat 1: alfaomegabet (big blind) folded before Flop
Seat 3: Al7uut collected ($0.25)
Seat 4: Wangritter13 folded before Flop (didn't bet)
Seat 5: VanCleef322 (button) folded before Flop (didn't bet)
Seat 6: chris.nomf (small blind) folded before Flop



PokerStars Hand #222981917375:  Hold'em No Limit ($0.05/$0.10 USD) - 2021/01/23 20:42:09 ET
Table 'Merope IV' 6-max Seat #6 is the button
Seat 1: alfaomegabet ($10.36 in chips) 
Seat 2: LimpinRabbit ($10 in chips) 
Seat 3: Al7uut ($20.16 in chips) 
Seat 4: Wangritter13 ($17.47 in chips) 
Seat 5: VanCleef322 ($10.82 in chips) 
Seat 6: chris.nomf ($17.51 in chips) 
alfaomegabet: posts small blind $0.05
LimpinRabbit: posts big blind $0.10
*** HOLE CARDS ***
Al7uut: folds 
Wangritter13: folds 
VanCleef322: folds 
chris.nomf: folds 
alfaomegabet: raises $0.20 to $0.30
LimpinRabbit: folds 
Uncalled bet ($0.20) returned to alfaomegabet
alfaomegabet collected $0.20 from pot
alfaomegabet: doesn't show hand 
*** SUMMARY ***
Total pot $0.20 | Rake $0 
Seat 1: alfaomegabet (small blind) collected ($0.20)
Seat 2: LimpinRabbit (big blind) folded before Flop
Seat 3: Al7uut folded before Flop (didn't bet)
Seat 4: Wangritter13 folded before Flop (didn't bet)
Seat 5: VanCleef322 folded before Flop (didn't bet)
Seat 6: chris.nomf (button) folded before Flop (didn't bet)



PokerStars Hand #222981923708:  Hold'em No Limit ($0.05/$0.10 USD) - 2021/01/23 20:42:24 ET
Table 'Merope IV' 6-max Seat #1 is the button
Seat 1: alfaomegabet ($10.46 in chips) 
Seat 2: LimpinRabbit ($10 in chips) 
Seat 3: Al7uut ($20.16 in chips) 
Seat 4: Wangritter13 ($17.47 in chips) 
Seat 5: VanCleef322 ($10.82 in chips) 
Seat 6: chris.nomf ($17.51 in chips) 
LimpinRabbit: posts small blind $0.05
Al7uut: posts big blind $0.10
*** HOLE CARDS ***
Wangritter13: folds 
VanCleef322: folds 
chris.nomf: folds 
alfaomegabet: raises $0.20 to $0.30
LimpinRabbit: folds 
Al7uut: raises $0.20 to $0.50
alfaomegabet: calls $0.20
*** FLOP *** [Ac 5h 4c]
Al7uut: bets $0.10
alfaomegabet: calls $0.10
*** TURN *** [Ac 5h 4c] [4d]
Al7uut: checks 
alfaomegabet: bets $0.92
Al7uut: raises $0.92 to $1.84
alfaomegabet: calls $0.92
*** RIVER *** [Ac 5h 4c 4d] [Ks]
Al7uut: bets $1.20
alfaomegabet: calls $1.20
*** SHOW DOWN ***
Al7uut: shows [Ts 4s] (three of a kind, Fours)
alfaomegabet: mucks hand 
Al7uut collected $7 from pot
*** SUMMARY ***
Total pot $7.33 | Rake $0.33 
Board [Ac 5h 4c 4d Ks]
Seat 1: alfaomegabet (button) mucked
Seat 2: LimpinRabbit (small blind) folded before Flop
Seat 3: Al7uut (big blind) showed [Ts 4s] and won ($7) with three of a kind, Fours
Seat 4: Wangritter13 folded before Flop (didn't bet)
Seat 5: VanCleef322 folded before Flop (didn't bet)
Seat 6: chris.nomf folded before Flop (didn't bet)



PokerStars Hand #222982786023:  Hold'em No Limit ($0.05/$0.10 USD) - 2021/01/23 21:17:16 ET
Table 'Merope IV' 6-max Seat #6 is the button
Seat 1: alfaomegabet ($11.43 in chips) 
Seat 2: father here ($25.19 in chips) 
Seat 3: Maxfulltrick ($10.60 in chips) 
Seat 4: Wangritter13 ($30.04 in chips) 
Seat 5: sportivu13 ($10 in chips) 
Seat 6: Mr.Rilex ($10.22 in chips) 
alfaomegabet: posts small blind $0.05
father here: posts big blind $0.10
*** HOLE CARDS ***
Maxfulltrick: raises $0.15 to $0.25
Wangritter13: raises $0.35 to $0.60
sportivu13: folds 
Mr.Rilex: folds 
alfaomegabet: folds 
father here: folds 
Maxfulltrick: calls $0.35
*** FLOP *** [Tc Qs Kd]
Maxfulltrick: checks 
Wangritter13: checks 
*** TURN *** [Tc Qs Kd] [Th]
Maxfulltrick: bets $0.39
Wangritter13: calls $0.39
*** RIVER *** [Tc Qs Kd Th] [9c]
Maxfulltrick: checks 
Wangritter13: bets $0.91
Maxfulltrick: folds 
Uncalled bet ($0.91) returned to Wangritter13
Wangritter13 collected $2.03 from pot
Wangritter13: doesn't show hand 
*** SUMMARY ***
Total pot $2.13 | Rake $0.10 
Board [Tc Qs Kd Th 9c]
Seat 1: alfaomegabet (small blind) folded before Flop
Seat 2: father here (big blind) folded before Flop
Seat 3: Maxfulltrick folded on the River
Seat 4: Wangritter13 collected ($2.03)
Seat 5: sportivu13 folded before Flop (didn't bet)
Seat 6: Mr.Rilex (button) folded before Flop (didn't bet)



PokerStars Hand #222982805584:  Hold'em No Limit ($0.05/$0.10 USD) - 2021/01/23 21:18:04 ET
Table 'Merope IV' 6-max Seat #1 is the button
Seat 1: alfaomegabet ($11.38 in chips) 
Seat 2: father here ($25.09 in chips) 
Seat 3: Maxfulltrick ($10 in chips) 
Seat 4: Wangritter13 ($31.08 in chips) 
Seat 5: sportivu13 ($10 in chips) 
Seat 6: Mr.Rilex ($10.22 in chips) 
father here: posts small blind $0.05
Maxfulltrick: posts big blind $0.10
*** HOLE CARDS ***
Wangritter13: raises $0.25 to $0.35
sportivu13: folds 
Mr.Rilex: calls $0.35
alfaomegabet: folds 
father here: folds 
Maxfulltrick: folds 
*** FLOP *** [Jh Kh Jc]
Wangritter13: bets $0.40
Mr.Rilex: calls $0.40
*** TURN *** [Jh Kh Jc] [2d]
Wangritter13 is disconnected 
Wangritter13 has timed out while disconnected
Wangritter13: checks 
Mr.Rilex: bets $0.10
Wangritter13 has timed out while disconnected
Wangritter13: folds 
Uncalled bet ($0.10) returned to Mr.Rilex
Mr.Rilex collected $1.58 from pot
*** SUMMARY ***
Total pot $1.65 | Rake $0.07 
Board [Jh Kh Jc 2d]
Seat 1: alfaomegabet (button) folded before Flop (didn't bet)
Seat 2: father here (small blind) folded before Flop
Seat 3: Maxfulltrick (big blind) folded before Flop
Seat 4: Wangritter13 folded on the Turn
Seat 5: sportivu13 folded before Flop (didn't bet)
Seat 6: Mr.Rilex collected ($1.58)



PokerStars Hand #222982877571:  Hold'em No Limit ($0.05/$0.10 USD) - 2021/01/23 21:20:53 ET
Table 'Merope IV' 6-max Seat #2 is the button
Seat 1: alfaomegabet ($11.38 in chips) 
Seat 2: father here ($25.04 in chips) 
Seat 3: Maxfulltrick ($10 in chips) 
Seat 5: sportivu13 ($10 in chips) 
Seat 6: Mr.Rilex ($11.05 in chips) 
Maxfulltrick: posts small blind $0.05
sportivu13: posts big blind $0.10
*** HOLE CARDS ***
Mr.Rilex: folds 
alfaomegabet: raises $0.20 to $0.30
father here: folds 
Maxfulltrick: folds 
sportivu13: calls $0.20
*** FLOP *** [9d Kd Th]
sportivu13: checks 
alfaomegabet: checks 
*** TURN *** [9d Kd Th] [Js]
sportivu13: bets $0.54
alfaomegabet: folds 
Uncalled bet ($0.54) returned to sportivu13
sportivu13 collected $0.62 from pot
*** SUMMARY ***
Total pot $0.65 | Rake $0.03 
Board [9d Kd Th Js]
Seat 1: alfaomegabet folded on the Turn
Seat 2: father here (button) folded before Flop (didn't bet)
Seat 3: Maxfulltrick (small blind) folded before Flop
Seat 5: sportivu13 (big blind) collected ($0.62)
Seat 6: Mr.Rilex folded before Flop (didn't bet)



PokerStars Hand #222982891823:  Hold'em No Limit ($0.05/$0.10 USD) - 2021/01/23 21:21:29 ET
Table 'Merope IV' 6-max Seat #3 is the button
Seat 1: alfaomegabet ($11.08 in chips) 
Seat 2: father here ($25.04 in chips) 
Seat 3: Maxfulltrick ($10 in chips) 
Seat 5: sportivu13 ($10.32 in chips) 
Seat 6: Mr.Rilex ($11.05 in chips) 
sportivu13: posts small blind $0.05
Mr.Rilex: posts big blind $0.10
*** HOLE CARDS ***
alfaomegabet: folds 
father here: folds 
Maxfulltrick: folds 
sportivu13: folds 
Uncalled bet ($0.05) returned to Mr.Rilex
Mr.Rilex collected $0.10 from pot
*** SUMMARY ***
Total pot $0.10 | Rake $0 
Seat 1: alfaomegabet folded before Flop (didn't bet)
Seat 2: father here folded before Flop (didn't bet)
Seat 3: Maxfulltrick (button) folded before Flop (didn't bet)
Seat 5: sportivu13 (small blind) folded before Flop
Seat 6: Mr.Rilex (big blind) collected ($0.10)



PokerStars Hand #222982898416:  Hold'em No Limit ($0.05/$0.10 USD) - 2021/01/23 21:21:45 ET
Table 'Merope IV' 6-max Seat #5 is the button
Seat 1: alfaomegabet ($11.08 in chips) 
Seat 2: father here ($25.04 in chips) 
Seat 3: Maxfulltrick ($10 in chips) 
Seat 5: sportivu13 ($10.27 in chips) 
Seat 6: Mr.Rilex ($11.10 in chips) 
Mr.Rilex: posts small blind $0.05
alfaomegabet: posts big blind $0.10
*** HOLE CARDS ***
father here: folds 
Maxfulltrick: folds 
sportivu13: raises $0.19 to $0.29
Mr.Rilex: calls $0.24
alfaomegabet: folds 
*** FLOP *** [7s Js Jh]
Mr.Rilex: checks 
sportivu13: bets $0.34
Mr.Rilex: calls $0.34
*** TURN *** [7s Js Jh] [Tc]
Mr.Rilex: checks 
sportivu13: checks 
*** RIVER *** [7s Js Jh Tc] [5h]
Mr.Rilex: bets $0.65
sportivu13: calls $0.65
*** SHOW DOWN ***
Mr.Rilex: shows [Jc 2c] (three of a kind, Jacks)
sportivu13: mucks hand 
Mr.Rilex collected $2.54 from pot
*** SUMMARY ***
Total pot $2.66 | Rake $0.12 
Board [7s Js Jh Tc 5h]
Seat 1: alfaomegabet (big blind) folded before Flop
Seat 2: father here folded before Flop (didn't bet)
Seat 3: Maxfulltrick folded before Flop (didn't bet)
Seat 5: sportivu13 (button) mucked
Seat 6: Mr.Rilex (small blind) showed [Jc 2c] and won ($2.54) with three of a kind, Jacks



PokerStars Hand #222982923340:  Hold'em No Limit ($0.05/$0.10 USD) - 2021/01/23 21:22:48 ET
Table 'Merope IV' 6-max Seat #6 is the button
Seat 1: alfaomegabet ($10.98 in chips) 
Seat 2: father here ($25.04 in chips) 
Seat 3: Maxfulltrick ($10 in chips) 
Seat 4: Wangritter13 ($30.33 in chips) 
Seat 5: sportivu13 ($9.56 in chips) 
Seat 6: Mr.Rilex ($12.36 in chips) 
alfaomegabet: posts small blind $0.05
father here: posts big blind $0.10
Wangritter13: posts small & big blinds $0.15
*** HOLE CARDS ***
Maxfulltrick: raises $0.40 to $0.50
Wangritter13: folds 
sportivu13: calls $0.50
Mr.Rilex: folds 
alfaomegabet: folds 
father here: folds 
*** FLOP *** [Qs Ah 6s]
Maxfulltrick: bets $0.37
sportivu13: folds 
Uncalled bet ($0.37) returned to Maxfulltrick
Maxfulltrick collected $1.24 from pot
*** SUMMARY ***
Total pot $1.30 | Rake $0.06 
Board [Qs Ah 6s]
Seat 1: alfaomegabet (small blind) folded before Flop
Seat 2: father here (big blind) folded before Flop
Seat 3: Maxfulltrick collected ($1.24)
Seat 4: Wangritter13 folded before Flop (didn't bet)
Seat 5: sportivu13 folded on the Flop
Seat 6: Mr.Rilex (button) folded before Flop (didn't bet)



PokerStars Hand #222982948702:  Hold'em No Limit ($0.05/$0.10 USD) - 2021/01/23 21:23:34 ET
Table 'Merope IV' 6-max Seat #1 is the button
Seat 1: alfaomegabet ($10.93 in chips) 
Seat 2: father here ($24.94 in chips) 
Seat 3: Maxfulltrick ($10.74 in chips) 
Seat 4: Wangritter13 ($30.18 in chips) 
Seat 5: sportivu13 ($9.06 in chips) 
Seat 6: Mr.Rilex ($12.36 in chips) 
father here: posts small blind $0.05
Maxfulltrick: posts big blind $0.10
*** HOLE CARDS ***
Wangritter13: folds 
sportivu13: folds 
Mr.Rilex: folds 
alfaomegabet has timed out
alfaomegabet: folds 
father here: folds 
Uncalled bet ($0.05) returned to Maxfulltrick
Maxfulltrick collected $0.10 from pot
*** SUMMARY ***
Total pot $0.10 | Rake $0 
Seat 1: alfaomegabet (button) folded before Flop (didn't bet)
Seat 2: father here (small blind) folded before Flop
Seat 3: Maxfulltrick (big blind) collected ($0.10)
Seat 4: Wangritter13 folded before Flop (didn't bet)
Seat 5: sportivu13 folded before Flop (didn't bet)
Seat 6: Mr.Rilex folded before Flop (didn't bet)



PokerStars Hand #222982966157:  Hold'em No Limit ($0.05/$0.10 USD) - 2021/01/23 21:24:00 ET
Table 'Merope IV' 6-max Seat #2 is the button
Seat 1: alfaomegabet ($10.93 in chips) 
Seat 2: father here ($24.89 in chips) 
Seat 3: Maxfulltrick ($10.79 in chips) 
Seat 4: Wangritter13 ($30.18 in chips) 
Seat 5: sportivu13 ($9.06 in chips) 
Seat 6: Mr.Rilex ($12.36 in chips) 
Maxfulltrick: posts small blind $0.05
Wangritter13: posts big blind $0.10
*** HOLE CARDS ***
sportivu13: raises $0.19 to $0.29
Mr.Rilex: folds 
alfaomegabet: folds 
father here: folds 
Maxfulltrick: folds 
Wangritter13: calls $0.19
*** FLOP *** [As Jh 6c]
Wangritter13: checks 
sportivu13: checks 
*** TURN *** [As Jh 6c] [Jd]
Wangritter13: checks 
sportivu13: bets $0.52
Wangritter13: folds 
Uncalled bet ($0.52) returned to sportivu13
sportivu13 collected $0.60 from pot
*** SUMMARY ***
Total pot $0.63 | Rake $0.03 
Board [As Jh 6c Jd]
Seat 1: alfaomegabet folded before Flop (didn't bet)
Seat 2: father here (button) folded before Flop (didn't bet)
Seat 3: Maxfulltrick (small blind) folded before Flop
Seat 4: Wangritter13 (big blind) folded on the Turn
Seat 5: sportivu13 collected ($0.60)
Seat 6: Mr.Rilex folded before Flop (didn't bet)



PokerStars Hand #222982988142:  Hold'em No Limit ($0.05/$0.10 USD) - 2021/01/23 21:24:55 ET
Table 'Merope IV' 6-max Seat #3 is the button
Seat 1: alfaomegabet ($10.93 in chips) 
Seat 2: father here ($24.89 in chips) 
Seat 3: Maxfulltrick ($10.74 in chips) 
Seat 4: Wangritter13 ($29.89 in chips) 
Seat 5: sportivu13 ($9.37 in chips) 
Seat 6: Mr.Rilex ($12.36 in chips) 
Wangritter13: posts small blind $0.05
sportivu13: posts big blind $0.10
*** HOLE CARDS ***
Mr.Rilex: calls $0.10
alfaomegabet: folds 
father here: folds 
Maxfulltrick: folds 
Wangritter13: folds 
sportivu13: raises $0.32 to $0.42
Mr.Rilex: folds 
Uncalled bet ($0.32) returned to sportivu13
sportivu13 collected $0.25 from pot
*** SUMMARY ***
Total pot $0.25 | Rake $0 
Seat 1: alfaomegabet folded before Flop (didn't bet)
Seat 2: father here folded before Flop (didn't bet)
Seat 3: Maxfulltrick (button) folded before Flop (didn't bet)
Seat 4: Wangritter13 (small blind) folded before Flop
Seat 5: sportivu13 (big blind) collected ($0.25)
Seat 6: Mr.Rilex folded before Flop



PokerStars Hand #222983000154:  Hold'em No Limit ($0.05/$0.10 USD) - 2021/01/23 21:25:26 ET
Table 'Merope IV' 6-max Seat #4 is the button
Seat 1: alfaomegabet ($10.93 in chips) 
Seat 2: father here ($24.89 in chips) 
Seat 3: Maxfulltrick ($10.74 in chips) 
Seat 4: Wangritter13 ($29.84 in chips) 
Seat 5: sportivu13 ($9.52 in chips) 
Seat 6: Mr.Rilex ($12.26 in chips) 
sportivu13: posts small blind $0.05
Mr.Rilex: posts big blind $0.10
*** HOLE CARDS ***
alfaomegabet: folds 
father here: folds 
Maxfulltrick: folds 
Wangritter13: calls $0.10
sportivu13: folds 
Mr.Rilex: raises $0.20 to $0.30
Wangritter13: calls $0.20
*** FLOP *** [9c 3d 6s]
Mr.Rilex: bets $0.21
Wangritter13: raises $0.31 to $0.52
Mr.Rilex: calls $0.31
*** TURN *** [9c 3d 6s] [9s]
Mr.Rilex: checks 
Wangritter13: bets $0.30
Mr.Rilex: folds 
Uncalled bet ($0.30) returned to Wangritter13
Wangritter13 collected $1.61 from pot
Wangritter13: doesn't show hand 
*** SUMMARY ***
Total pot $1.69 | Rake $0.08 
Board [9c 3d 6s 9s]
Seat 1: alfaomegabet folded before Flop (didn't bet)
Seat 2: father here folded before Flop (didn't bet)
Seat 3: Maxfulltrick folded before Flop (didn't bet)
Seat 4: Wangritter13 (button) collected ($1.61)
Seat 5: sportivu13 (small blind) folded before Flop
Seat 6: Mr.Rilex (big blind) folded on the Turn



PokerStars Hand #222983029617:  Hold'em No Limit ($0.05/$0.10 USD) - 2021/01/23 21:26:40 ET
Table 'Merope IV' 6-max Seat #5 is the button
Seat 1: alfaomegabet ($10.93 in chips) 
Seat 2: father here ($24.89 in chips) 
Seat 3: Maxfulltrick ($10.74 in chips) 
Seat 4: Wangritter13 ($30.63 in chips) 
Seat 5: sportivu13 ($9.47 in chips) 
Seat 6: Mr.Rilex ($11.44 in chips) 
Mr.Rilex: posts small blind $0.05
alfaomegabet: posts big blind $0.10
*** HOLE CARDS ***
father here: folds 
Maxfulltrick: folds 
Wangritter13: calls $0.10
sportivu13: raises $0.32 to $0.42
Mr.Rilex: calls $0.37
alfaomegabet: folds 
Wangritter13: calls $0.32
*** FLOP *** [4h 3h 9h]
Mr.Rilex: bets $0.50
Wangritter13: folds 
sportivu13: calls $0.50
*** TURN *** [4h 3h 9h] [Td]
Mr.Rilex: bets $1
sportivu13: folds 
Uncalled bet ($1) returned to Mr.Rilex
Mr.Rilex collected $2.25 from pot
*** SUMMARY ***
Total pot $2.36 | Rake $0.11 
Board [4h 3h 9h Td]
Seat 1: alfaomegabet (big blind) folded before Flop
Seat 2: father here folded before Flop (didn't bet)
Seat 3: Maxfulltrick folded before Flop (didn't bet)
Seat 4: Wangritter13 folded on the Flop
Seat 5: sportivu13 (button) folded on the Turn
Seat 6: Mr.Rilex (small blind) collected ($2.25)



PokerStars Hand #222983050203:  Hold'em No Limit ($0.05/$0.10 USD) - 2021/01/23 21:27:33 ET
Table 'Merope IV' 6-max Seat #6 is the button
Seat 1: alfaomegabet ($10.83 in chips) 
Seat 2: father here ($24.89 in chips) 
Seat 3: Maxfulltrick ($10.74 in chips) 
Seat 4: Wangritter13 ($30.21 in chips) 
Seat 5: sportivu13 ($8.55 in chips) 
Seat 6: Mr.Rilex ($12.77 in chips) 
alfaomegabet: posts small blind $0.05
father here: posts big blind $0.10
*** HOLE CARDS ***
Maxfulltrick: folds 
Wangritter13: folds 
sportivu13: folds 
Mr.Rilex: raises $0.10 to $0.20
alfaomegabet: folds 
father here: calls $0.10
*** FLOP *** [7d Js 6d]
father here: checks 
Mr.Rilex: bets $0.21
father here: raises $0.49 to $0.70
Mr.Rilex: calls $0.49
*** TURN *** [7d Js 6d] [4h]
father here: bets $1.30
Mr.Rilex: calls $1.30
*** RIVER *** [7d Js 6d 4h] [4c]
father here: bets $3.20
Mr.Rilex: calls $3.20
*** SHOW DOWN ***
father here: shows [4d 8d] (three of a kind, Fours)
Mr.Rilex: mucks hand 
father here collected $10.36 from pot
*** SUMMARY ***
Total pot $10.85 | Rake $0.49 
Board [7d Js 6d 4h 4c]
Seat 1: alfaomegabet (small blind) folded before Flop
Seat 2: father here (big blind) showed [4d 8d] and won ($10.36) with three of a kind, Fours
Seat 3: Maxfulltrick folded before Flop (didn't bet)
Seat 4: Wangritter13 folded before Flop (didn't bet)
Seat 5: sportivu13 folded before Flop (didn't bet)
Seat 6: Mr.Rilex (button) mucked



PokerStars Hand #222983081069:  Hold'em No Limit ($0.05/$0.10 USD) - 2021/01/23 21:28:51 ET
Table 'Merope IV' 6-max Seat #1 is the button
Seat 1: alfaomegabet ($10.78 in chips) 
Seat 2: father here ($29.85 in chips) 
Seat 3: Maxfulltrick ($10.74 in chips) 
Seat 4: Wangritter13 ($30.21 in chips) 
Seat 5: sportivu13 ($8.55 in chips) 
Seat 6: Mr.Rilex ($7.37 in chips) 
father here: posts small blind $0.05
Maxfulltrick: posts big blind $0.10
*** HOLE CARDS ***
Wangritter13: raises $0.10 to $0.20
sportivu13: folds 
Mr.Rilex: folds 
alfaomegabet: folds 
father here: calls $0.15
Maxfulltrick: folds 
*** FLOP *** [Qc Kd Qs]
father here: checks 
Wangritter13: checks 
*** TURN *** [Qc Kd Qs] [Ad]
father here: checks 
Wangritter13: bets $0.24
father here: calls $0.24
*** RIVER *** [Qc Kd Qs Ad] [Ks]
father here: checks 
Wangritter13: checks 
*** SHOW DOWN ***
father here: shows [As 4s] (two pair, Aces and Kings)
Wangritter13: mucks hand 
father here collected $0.94 from pot
*** SUMMARY ***
Total pot $0.98 | Rake $0.04 
Board [Qc Kd Qs Ad Ks]
Seat 1: alfaomegabet (button) folded before Flop (didn't bet)
Seat 2: father here (small blind) showed [As 4s] and won ($0.94) with two pair, Aces and Kings
Seat 3: Maxfulltrick (big blind) folded before Flop
Seat 4: Wangritter13 mucked
Seat 5: sportivu13 folded before Flop (didn't bet)
Seat 6: Mr.Rilex folded before Flop (didn't bet)



PokerStars Hand #222983099453:  Hold'em No Limit ($0.05/$0.10 USD) - 2021/01/23 21:29:39 ET
Table 'Merope IV' 6-max Seat #2 is the button
Seat 1: alfaomegabet ($10.78 in chips) 
Seat 2: father here ($30.35 in chips) 
Seat 3: Maxfulltrick ($10.64 in chips) 
Seat 4: Wangritter13 ($29.77 in chips) 
Seat 5: sportivu13 ($10 in chips) 
Seat 6: Mr.Rilex ($7.37 in chips) 
Maxfulltrick: posts small blind $0.05
Wangritter13: posts big blind $0.10
*** HOLE CARDS ***
sportivu13: folds 
Mr.Rilex: folds 
alfaomegabet: raises $0.20 to $0.30
father here: folds 
Maxfulltrick: raises $0.60 to $0.90
Wangritter13: raises $28.87 to $29.77 and is all-in
alfaomegabet: folds 
Maxfulltrick: folds 
Uncalled bet ($28.87) returned to Wangritter13
Wangritter13 collected $2.10 from pot
Wangritter13: doesn't show hand 
*** SUMMARY ***
Total pot $2.10 | Rake $0 
Seat 1: alfaomegabet folded before Flop
Seat 2: father here (button) folded before Flop (didn't bet)
Seat 3: Maxfulltrick (small blind) folded before Flop
Seat 4: Wangritter13 (big blind) collected ($2.10)
Seat 5: sportivu13 folded before Flop (didn't bet)
Seat 6: Mr.Rilex folded before Flop (didn't bet)



PokerStars Hand #222983118135:  Hold'em No Limit ($0.05/$0.10 USD) - 2021/01/23 21:30:25 ET
Table 'Merope IV' 6-max Seat #3 is the button
Seat 1: alfaomegabet ($10.48 in chips) 
Seat 2: father here ($30.35 in chips) 
Seat 3: Maxfulltrick ($10 in chips) 
Seat 4: Wangritter13 ($30.97 in chips) 
Seat 6: Mr.Rilex ($7.37 in chips) 
Wangritter13: posts small blind $0.05
sportivu13: is sitting out 
sportivu13 leaves the table
Mr.Rilex: posts big blind $0.10
*** HOLE CARDS ***
alfaomegabet: folds 
father here: folds 
Maxfulltrick: folds 
Wangritter13: calls $0.05
Mr.Rilex: checks 
*** FLOP *** [4c Ad 8d]
Wangritter13: checks 
Mr.Rilex: checks 
*** TURN *** [4c Ad 8d] [3c]
Wangritter13: bets $0.19
Mr.Rilex: calls $0.19
*** RIVER *** [4c Ad 8d 3c] [Qd]
Wangritter13: bets $0.55
Mr.Rilex: calls $0.55
*** SHOW DOWN ***
Wangritter13: shows [5s 2d] (a straight, Ace to Five)
the_humster joins the table at seat #5 
Mr.Rilex: mucks hand 
Wangritter13 collected $1.60 from pot
*** SUMMARY ***
Total pot $1.68 | Rake $0.08 
Board [4c Ad 8d 3c Qd]
Seat 1: alfaomegabet folded before Flop (didn't bet)
Seat 2: father here folded before Flop (didn't bet)
Seat 3: Maxfulltrick (button) folded before Flop (didn't bet)
Seat 4: Wangritter13 (small blind) showed [5s 2d] and won ($1.60) with a straight, Ace to Five
Seat 6: Mr.Rilex (big blind) mucked



PokerStars Hand #222983136649:  Hold'em No Limit ($0.05/$0.10 USD) - 2021/01/23 21:31:13 ET
Table 'Merope IV' 6-max Seat #4 is the button
Seat 1: alfaomegabet ($10.48 in chips) 
Seat 2: father here ($30.35 in chips) 
Seat 3: Maxfulltrick ($10 in chips) 
Seat 4: Wangritter13 ($31.73 in chips) 
Seat 6: Mr.Rilex ($6.53 in chips) 
Mr.Rilex: posts small blind $0.05
alfaomegabet: posts big blind $0.10
*** HOLE CARDS ***
father here: folds 
Maxfulltrick: folds 
Wangritter13 has timed out
Wangritter13: folds 
Mr.Rilex: calls $0.05
alfaomegabet: checks 
*** FLOP *** [8c 6c Th]
Mr.Rilex: checks 
alfaomegabet: checks 
*** TURN *** [8c 6c Th] [Ad]
Mr.Rilex: checks 
alfaomegabet: checks 
*** RIVER *** [8c 6c Th Ad] [Tc]
Mr.Rilex: bets $0.10
alfaomegabet: folds 
Uncalled bet ($0.10) returned to Mr.Rilex
Mr.Rilex collected $0.19 from pot
*** SUMMARY ***
Total pot $0.20 | Rake $0.01 
Board [8c 6c Th Ad Tc]
Seat 1: alfaomegabet (big blind) folded on the River
Seat 2: father here folded before Flop (didn't bet)
Seat 3: Maxfulltrick folded before Flop (didn't bet)
Seat 4: Wangritter13 (button) folded before Flop (didn't bet)
Seat 6: Mr.Rilex (small blind) collected ($0.19)



PokerStars Hand #222983152526:  Hold'em No Limit ($0.05/$0.10 USD) - 2021/01/23 21:31:53 ET
Table 'Merope IV' 6-max Seat #6 is the button
Seat 1: alfaomegabet ($10.38 in chips) 
Seat 2: father here ($30.35 in chips) 
Seat 3: Maxfulltrick ($10 in chips) 
Seat 6: Mr.Rilex ($6.62 in chips) 
alfaomegabet: posts small blind $0.05
father here: posts big blind $0.10
the_humster: sits out 
*** HOLE CARDS ***
Maxfulltrick: folds 
Mr.Rilex: calls $0.10
Wangritter13 leaves the table
alfaomegabet: raises $0.40 to $0.50
father here: folds 
Mr.Rilex: folds 
Uncalled bet ($0.40) returned to alfaomegabet
alfaomegabet collected $0.30 from pot
alfaomegabet: doesn't show hand 
*** SUMMARY ***
Total pot $0.30 | Rake $0 
Seat 1: alfaomegabet (small blind) collected ($0.30)
Seat 2: father here (big blind) folded before Flop
Seat 3: Maxfulltrick folded before Flop (didn't bet)
Seat 6: Mr.Rilex (button) folded before Flop



PokerStars Hand #222983160720:  Hold'em No Limit ($0.05/$0.10 USD) - 2021/01/23 21:32:14 ET
Table 'Merope IV' 6-max Seat #1 is the button
Seat 1: alfaomegabet ($10.58 in chips) 
Seat 2: father here ($30.25 in chips) 
Seat 3: Maxfulltrick ($10 in chips) 
Seat 6: Mr.Rilex ($6.52 in chips) 
father here: posts small blind $0.05
Maxfulltrick: posts big blind $0.10
the_humster: sits out 
*** HOLE CARDS ***
Mr.Rilex: folds 
alfaomegabet: folds 
father here: raises $0.10 to $0.20
Maxfulltrick: folds 
Uncalled bet ($0.10) returned to father here
father here collected $0.20 from pot
*** SUMMARY ***
Total pot $0.20 | Rake $0 
Seat 1: alfaomegabet (button) folded before Flop (didn't bet)
Seat 2: father here (small blind) collected ($0.20)
Seat 3: Maxfulltrick (big blind) folded before Flop
Seat 6: Mr.Rilex folded before Flop (didn't bet)



PokerStars Hand #222983167526:  Hold'em No Limit ($0.05/$0.10 USD) - 2021/01/23 21:32:31 ET
Table 'Merope IV' 6-max Seat #2 is the button
Seat 1: alfaomegabet ($10.58 in chips) 
Seat 2: father here ($30.35 in chips) 
Seat 3: Maxfulltrick ($10 in chips) 
Seat 5: the_humster ($10 in chips) 
Seat 6: Mr.Rilex ($6.52 in chips) 
Maxfulltrick: posts small blind $0.05
the_humster: posts big blind $0.10
*** HOLE CARDS ***
Mr.Rilex: folds 
alfaomegabet: raises $0.20 to $0.30
father here: folds 
Maxfulltrick: folds 
the_humster: folds 
Uncalled bet ($0.20) returned to alfaomegabet
alfaomegabet collected $0.25 from pot
alfaomegabet: doesn't show hand 
*** SUMMARY ***
Total pot $0.25 | Rake $0 
Seat 1: alfaomegabet collected ($0.25)
Seat 2: father here (button) folded before Flop (didn't bet)
Seat 3: Maxfulltrick (small blind) folded before Flop
Seat 5: the_humster (big blind) folded before Flop
Seat 6: Mr.Rilex folded before Flop (didn't bet)



PokerStars Hand #222983176539:  Hold'em No Limit ($0.05/$0.10 USD) - 2021/01/23 21:32:54 ET
Table 'Merope IV' 6-max Seat #3 is the button
Seat 1: alfaomegabet ($10.73 in chips) 
Seat 2: father here ($30.35 in chips) 
Seat 3: Maxfulltrick ($10 in chips) 
Seat 5: the_humster ($10 in chips) 
Seat 6: Mr.Rilex ($6.52 in chips) 
the_humster: posts small blind $0.05
Mr.Rilex: posts big blind $0.10
*** HOLE CARDS ***
alfaomegabet: raises $0.20 to $0.30
father here: folds 
Maxfulltrick: folds 
the_humster: folds 
Mr.Rilex: folds 
Uncalled bet ($0.20) returned to alfaomegabet
alfaomegabet collected $0.25 from pot
alfaomegabet: doesn't show hand 
*** SUMMARY ***
Total pot $0.25 | Rake $0 
Seat 1: alfaomegabet collected ($0.25)
Seat 2: father here folded before Flop (didn't bet)
Seat 3: Maxfulltrick (button) folded before Flop (didn't bet)
Seat 5: the_humster (small blind) folded before Flop
Seat 6: Mr.Rilex (big blind) folded before Flop



PokerStars Hand #222983183537:  Hold'em No Limit ($0.05/$0.10 USD) - 2021/01/23 21:33:11 ET
Table 'Merope IV' 6-max Seat #5 is the button
Seat 1: alfaomegabet ($10.88 in chips) 
Seat 2: father here ($30.35 in chips) 
Seat 3: Maxfulltrick ($10 in chips) 
Seat 5: the_humster ($10 in chips) 
Seat 6: Mr.Rilex ($6.42 in chips) 
Mr.Rilex: posts small blind $0.05
alfaomegabet: posts big blind $0.10
*** HOLE CARDS ***
father here: raises $0.20 to $0.30
Maxfulltrick: folds 
the_humster: folds 
Mr.Rilex: calls $0.25
alfaomegabet: folds 
*** FLOP *** [6c Qc Jc]
Mr.Rilex: checks 
father here: checks 
*** TURN *** [6c Qc Jc] [Jh]
Mr.Rilex: bets $0.33
father here: folds 
Uncalled bet ($0.33) returned to Mr.Rilex
Mr.Rilex collected $0.67 from pot
*** SUMMARY ***
Total pot $0.70 | Rake $0.03 
Board [6c Qc Jc Jh]
Seat 1: alfaomegabet (big blind) folded before Flop
Seat 2: father here folded on the Turn
Seat 3: Maxfulltrick folded before Flop (didn't bet)
Seat 5: the_humster (button) folded before Flop (didn't bet)
Seat 6: Mr.Rilex (small blind) collected ($0.67)



PokerStars Hand #222983201403:  Hold'em No Limit ($0.05/$0.10 USD) - 2021/01/23 21:33:50 ET
Table 'Merope IV' 6-max Seat #6 is the button
Seat 1: alfaomegabet ($10.78 in chips) 
Seat 2: father here ($30.05 in chips) 
Seat 3: Maxfulltrick ($10 in chips) 
Seat 5: the_humster ($10 in chips) 
Seat 6: Mr.Rilex ($6.79 in chips) 
alfaomegabet: posts small blind $0.05
father here: posts big blind $0.10
*** HOLE CARDS ***
Maxfulltrick: folds 
the_humster: raises $0.20 to $0.30
Mr.Rilex: folds 
alfaomegabet: folds 
father here: folds 
Uncalled bet ($0.20) returned to the_humster
the_humster collected $0.25 from pot
the_humster: doesn't show hand 
*** SUMMARY ***
Total pot $0.25 | Rake $0 
Seat 1: alfaomegabet (small blind) folded before Flop
Seat 2: father here (big blind) folded before Flop
Seat 3: Maxfulltrick folded before Flop (didn't bet)
Seat 5: the_humster collected ($0.25)
Seat 6: Mr.Rilex (button) folded before Flop (didn't bet)



PokerStars Hand #222983207282:  Hold'em No Limit ($0.05/$0.10 USD) - 2021/01/23 21:34:05 ET
Table 'Merope IV' 6-max Seat #1 is the button
Seat 1: alfaomegabet ($10.73 in chips) 
Seat 2: father here ($29.95 in chips) 
Seat 3: Maxfulltrick ($10 in chips) 
Seat 5: the_humster ($10.15 in chips) 
Seat 6: Mr.Rilex ($6.79 in chips) 
father here: posts small blind $0.05
Maxfulltrick: posts big blind $0.10
*** HOLE CARDS ***
the_humster: folds 
Mr.Rilex: folds 
alfaomegabet: folds 
father here: folds 
Uncalled bet ($0.05) returned to Maxfulltrick
Maxfulltrick collected $0.10 from pot
*** SUMMARY ***
Total pot $0.10 | Rake $0 
Seat 1: alfaomegabet (button) folded before Flop (didn't bet)
Seat 2: father here (small blind) folded before Flop
Seat 3: Maxfulltrick (big blind) collected ($0.10)
Seat 5: the_humster folded before Flop (didn't bet)
Seat 6: Mr.Rilex folded before Flop (didn't bet)



PokerStars Hand #222983211991:  Hold'em No Limit ($0.05/$0.10 USD) - 2021/01/23 21:34:17 ET
Table 'Merope IV' 6-max Seat #2 is the button
Seat 1: alfaomegabet ($10.73 in chips) 
Seat 2: father here ($29.90 in chips) 
Seat 3: Maxfulltrick ($10.05 in chips) 
Seat 5: the_humster ($10.15 in chips) 
Seat 6: Mr.Rilex ($6.79 in chips) 
Maxfulltrick: posts small blind $0.05
the_humster: posts big blind $0.10
*** HOLE CARDS ***
Mr.Rilex: calls $0.10
alfaomegabet: folds 
father here: raises $0.35 to $0.45
Maxfulltrick: folds 
the_humster: folds 
GGR817 joins the table at seat #4 
Mr.Rilex: folds 
Uncalled bet ($0.35) returned to father here
father here collected $0.35 from pot
*** SUMMARY ***
Total pot $0.35 | Rake $0 
Seat 1: alfaomegabet folded before Flop (didn't bet)
Seat 2: father here (button) collected ($0.35)
Seat 3: Maxfulltrick (small blind) folded before Flop
Seat 5: the_humster (big blind) folded before Flop
Seat 6: Mr.Rilex folded before Flop



PokerStars Hand #222983219217:  Hold'em No Limit ($0.05/$0.10 USD) - 2021/01/23 21:34:36 ET
Table 'Merope IV' 6-max Seat #3 is the button
Seat 1: alfaomegabet ($10.73 in chips) 
Seat 2: father here ($30.15 in chips) 
Seat 3: Maxfulltrick ($10 in chips) 
Seat 5: the_humster ($10.05 in chips) 
Seat 6: Mr.Rilex ($6.69 in chips) 
the_humster: posts small blind $0.05
Mr.Rilex: posts big blind $0.10
*** HOLE CARDS ***
alfaomegabet: folds 
father here: folds 
Maxfulltrick: folds 
the_humster: raises $0.20 to $0.30
Mr.Rilex: folds 
Uncalled bet ($0.20) returned to the_humster
the_humster collected $0.20 from pot
the_humster: doesn't show hand 
*** SUMMARY ***
Total pot $0.20 | Rake $0 
Seat 1: alfaomegabet folded before Flop (didn't bet)
Seat 2: father here folded before Flop (didn't bet)
Seat 3: Maxfulltrick (button) folded before Flop (didn't bet)
Seat 5: the_humster (small blind) collected ($0.20)
Seat 6: Mr.Rilex (big blind) folded before Flop



PokerStars Hand #222983227460:  Hold'em No Limit ($0.05/$0.10 USD) - 2021/01/23 21:34:57 ET
Table 'Merope IV' 6-max Seat #5 is the button
Seat 1: alfaomegabet ($10.73 in chips) 
Seat 2: father here ($30.15 in chips) 
Seat 3: Maxfulltrick ($10 in chips) 
Seat 5: the_humster ($10.15 in chips) 
Seat 6: Mr.Rilex ($6.59 in chips) 
Mr.Rilex: posts small blind $0.05
alfaomegabet: posts big blind $0.10
GGR817: sits out 
*** HOLE CARDS ***
father here: folds 
Maxfulltrick: folds 
the_humster: folds 
Mr.Rilex: calls $0.05
alfaomegabet: raises $0.40 to $0.50
Mr.Rilex: folds 
Uncalled bet ($0.40) returned to alfaomegabet
alfaomegabet collected $0.20 from pot
alfaomegabet: doesn't show hand 
*** SUMMARY ***
Total pot $0.20 | Rake $0 
Seat 1: alfaomegabet (big blind) collected ($0.20)
Seat 2: father here folded before Flop (didn't bet)
Seat 3: Maxfulltrick folded before Flop (didn't bet)
Seat 5: the_humster (button) folded before Flop (didn't bet)
Seat 6: Mr.Rilex (small blind) folded before Flop



PokerStars Hand #222983239428:  Hold'em No Limit ($0.05/$0.10 USD) - 2021/01/23 21:35:27 ET
Table 'Merope IV' 6-max Seat #6 is the button
Seat 1: alfaomegabet ($10.83 in chips) 
Seat 2: father here ($30.15 in chips) 
Seat 3: Maxfulltrick ($10 in chips) 
Seat 5: the_humster ($10.15 in chips) 
Seat 6: Mr.Rilex ($6.49 in chips) 
alfaomegabet: posts small blind $0.05
father here: posts big blind $0.10
GGR817: sits out 
*** HOLE CARDS ***
Maxfulltrick: folds 
the_humster: folds 
Mr.Rilex: folds 
alfaomegabet: folds 
Uncalled bet ($0.05) returned to father here
father here collected $0.10 from pot
*** SUMMARY ***
Total pot $0.10 | Rake $0 
Seat 1: alfaomegabet (small blind) folded before Flop
Seat 2: father here (big blind) collected ($0.10)
Seat 3: Maxfulltrick folded before Flop (didn't bet)
Seat 5: the_humster folded before Flop (didn't bet)
Seat 6: Mr.Rilex (button) folded before Flop (didn't bet)



PokerStars Hand #222983244069:  Hold'em No Limit ($0.05/$0.10 USD) - 2021/01/23 21:35:38 ET
Table 'Merope IV' 6-max Seat #1 is the button
Seat 1: alfaomegabet ($10.78 in chips) 
Seat 2: father here ($30.20 in chips) 
Seat 3: Maxfulltrick ($10 in chips) 
Seat 5: the_humster ($10.15 in chips) 
Seat 6: Mr.Rilex ($6.49 in chips) 
father here: posts small blind $0.05
Maxfulltrick: posts big blind $0.10
GGR817: sits out 
*** HOLE CARDS ***
the_humster: folds 
Mr.Rilex: folds 
alfaomegabet: folds 
father here: folds 
Uncalled bet ($0.05) returned to Maxfulltrick
Maxfulltrick collected $0.10 from pot
*** SUMMARY ***
Total pot $0.10 | Rake $0 
Seat 1: alfaomegabet (button) folded before Flop (didn't bet)
Seat 2: father here (small blind) folded before Flop
Seat 3: Maxfulltrick (big blind) collected ($0.10)
Seat 5: the_humster folded before Flop (didn't bet)
Seat 6: Mr.Rilex folded before Flop (didn't bet)



PokerStars Hand #222983249421:  Hold'em No Limit ($0.05/$0.10 USD) - 2021/01/23 21:35:52 ET
Table 'Merope IV' 6-max Seat #2 is the button
Seat 1: alfaomegabet ($10.78 in chips) 
Seat 2: father here ($30.15 in chips) 
Seat 3: Maxfulltrick ($10.05 in chips) 
Seat 4: GGR817 ($10 in chips) 
Seat 5: the_humster ($10.15 in chips) 
Seat 6: Mr.Rilex ($6.49 in chips) 
Maxfulltrick: posts small blind $0.05
GGR817: posts big blind $0.10
*** HOLE CARDS ***
the_humster: folds 
Mr.Rilex: raises $0.20 to $0.30
alfaomegabet: folds 
father here: folds 
Maxfulltrick: folds 
GGR817: folds 
Uncalled bet ($0.20) returned to Mr.Rilex
Mr.Rilex collected $0.25 from pot
*** SUMMARY ***
Total pot $0.25 | Rake $0 
Seat 1: alfaomegabet folded before Flop (didn't bet)
Seat 2: father here (button) folded before Flop (didn't bet)
Seat 3: Maxfulltrick (small blind) folded before Flop
Seat 4: GGR817 (big blind) folded before Flop
Seat 5: the_humster folded before Flop (didn't bet)
Seat 6: Mr.Rilex collected ($0.25)



PokerStars Hand #222983256813:  Hold'em No Limit ($0.05/$0.10 USD) - 2021/01/23 21:36:10 ET
Table 'Merope IV' 6-max Seat #3 is the button
Seat 1: alfaomegabet ($10.78 in chips) 
Seat 2: father here ($30.15 in chips) 
Seat 3: Maxfulltrick ($10 in chips) 
Seat 4: GGR817 ($10 in chips) 
Seat 5: the_humster ($10.15 in chips) 
Seat 6: Mr.Rilex ($6.64 in chips) 
GGR817: posts small blind $0.05
the_humster: posts big blind $0.10
*** HOLE CARDS ***
Mr.Rilex: folds 
alfaomegabet: folds 
father here: folds 
Maxfulltrick: folds 
GGR817: folds 
Uncalled bet ($0.05) returned to the_humster
the_humster collected $0.10 from pot
the_humster: doesn't show hand 
*** SUMMARY ***
Total pot $0.10 | Rake $0 
Seat 1: alfaomegabet folded before Flop (didn't bet)
Seat 2: father here folded before Flop (didn't bet)
Seat 3: Maxfulltrick (button) folded before Flop (didn't bet)
Seat 4: GGR817 (small blind) folded before Flop
Seat 5: the_humster (big blind) collected ($0.10)
Seat 6: Mr.Rilex folded before Flop (didn't bet)



PokerStars Hand #222983263054:  Hold'em No Limit ($0.05/$0.10 USD) - 2021/01/23 21:36:26 ET
Table 'Merope IV' 6-max Seat #4 is the button
Seat 1: alfaomegabet ($10.78 in chips) 
Seat 2: father here ($30.15 in chips) 
Seat 3: Maxfulltrick ($10 in chips) 
Seat 4: GGR817 ($10 in chips) 
Seat 5: the_humster ($10.20 in chips) 
Seat 6: Mr.Rilex ($6.64 in chips) 
the_humster: posts small blind $0.05
Mr.Rilex: posts big blind $0.10
*** HOLE CARDS ***
alfaomegabet: folds 
father here: folds 
Maxfulltrick: raises $0.20 to $0.30
GGR817: folds 
the_humster: folds 
Mr.Rilex: folds 
Uncalled bet ($0.20) returned to Maxfulltrick
Maxfulltrick collected $0.25 from pot
*** SUMMARY ***
Total pot $0.25 | Rake $0 
Seat 1: alfaomegabet folded before Flop (didn't bet)
Seat 2: father here folded before Flop (didn't bet)
Seat 3: Maxfulltrick collected ($0.25)
Seat 4: GGR817 (button) folded before Flop (didn't bet)
Seat 5: the_humster (small blind) folded before Flop
Seat 6: Mr.Rilex (big blind) folded before Flop



PokerStars Hand #222983272200:  Hold'em No Limit ($0.05/$0.10 USD) - 2021/01/23 21:36:49 ET
Table 'Merope IV' 6-max Seat #5 is the button
Seat 1: alfaomegabet ($10.78 in chips) 
Seat 2: father here ($30.15 in chips) 
Seat 3: Maxfulltrick ($10.15 in chips) 
Seat 4: GGR817 ($10 in chips) 
Seat 5: the_humster ($10.15 in chips) 
Seat 6: Mr.Rilex ($6.54 in chips) 
Mr.Rilex: posts small blind $0.05
alfaomegabet: posts big blind $0.10
*** HOLE CARDS ***
father here: raises $0.20 to $0.30
Maxfulltrick: folds 
GGR817: folds 
the_humster: folds 
Mr.Rilex: calls $0.25
alfaomegabet: folds 
*** FLOP *** [As Qc Qd]
Mr.Rilex: bets $0.33
father here: folds 
Uncalled bet ($0.33) returned to Mr.Rilex
Mr.Rilex collected $0.67 from pot
*** SUMMARY ***
Total pot $0.70 | Rake $0.03 
Board [As Qc Qd]
Seat 1: alfaomegabet (big blind) folded before Flop
Seat 2: father here folded on the Flop
Seat 3: Maxfulltrick folded before Flop (didn't bet)
Seat 4: GGR817 folded before Flop (didn't bet)
Seat 5: the_humster (button) folded before Flop (didn't bet)
Seat 6: Mr.Rilex (small blind) collected ($0.67)



PokerStars Hand #222983285213:  Hold'em No Limit ($0.05/$0.10 USD) - 2021/01/23 21:37:22 ET
Table 'Merope IV' 6-max Seat #6 is the button
Seat 1: alfaomegabet ($10.68 in chips) 
Seat 2: father here ($29.85 in chips) 
Seat 3: Maxfulltrick ($10.15 in chips) 
Seat 4: GGR817 ($10 in chips) 
Seat 5: the_humster ($10.15 in chips) 
Seat 6: Mr.Rilex ($6.91 in chips) 
alfaomegabet: posts small blind $0.05
father here: posts big blind $0.10
*** HOLE CARDS ***
Maxfulltrick: folds 
GGR817: folds 
the_humster: raises $0.20 to $0.30
Mr.Rilex: folds 
alfaomegabet: folds 
father here: folds 
Uncalled bet ($0.20) returned to the_humster
the_humster collected $0.25 from pot
the_humster: doesn't show hand 
*** SUMMARY ***
Total pot $0.25 | Rake $0 
Seat 1: alfaomegabet (small blind) folded before Flop
Seat 2: father here (big blind) folded before Flop
Seat 3: Maxfulltrick folded before Flop (didn't bet)
Seat 4: GGR817 folded before Flop (didn't bet)
Seat 5: the_humster collected ($0.25)
Seat 6: Mr.Rilex (button) folded before Flop (didn't bet)



PokerStars Hand #222983291786:  Hold'em No Limit ($0.05/$0.10 USD) - 2021/01/23 21:37:39 ET
Table 'Merope IV' 6-max Seat #1 is the button
Seat 1: alfaomegabet ($10.63 in chips) 
Seat 2: father here ($29.75 in chips) 
Seat 3: Maxfulltrick ($10.15 in chips) 
Seat 4: GGR817 ($10 in chips) 
Seat 5: the_humster ($10.30 in chips) 
Seat 6: Mr.Rilex ($6.91 in chips) 
father here: posts small blind $0.05
Maxfulltrick: posts big blind $0.10
*** HOLE CARDS ***
GGR817: folds 
the_humster: folds 
Mr.Rilex: folds 
alfaomegabet: folds 
father here: folds 
Uncalled bet ($0.05) returned to Maxfulltrick
Maxfulltrick collected $0.10 from pot
alfaomegabet leaves the table
*** SUMMARY ***
Total pot $0.10 | Rake $0 
Seat 1: alfaomegabet (button) folded before Flop (didn't bet)
Seat 2: father here (small blind) folded before Flop
Seat 3: Maxfulltrick (big blind) collected ($0.10)
Seat 4: GGR817 folded before Flop (didn't bet)
Seat 5: the_humster folded before Flop (didn't bet)
Seat 6: Mr.Rilex folded before Flop (didn't bet)



PokerStars Hand #222983296431:  Hold'em No Limit ($0.05/$0.10 USD) - 2021/01/23 21:37:50 ET
Table 'Merope IV' 6-max Seat #2 is the button
Seat 2: father here ($29.70 in chips) 
Seat 3: Maxfulltrick ($10.20 in chips) 
Seat 4: GGR817 ($10 in chips) 
Seat 5: the_humster ($10.30 in chips) 
Seat 6: Mr.Rilex ($6.91 in chips) 
Maxfulltrick: posts small blind $0.05
GGR817: posts big blind $0.10
*** HOLE CARDS ***
the_humster: folds 
Mr.Rilex: folds 
the_humster leaves the table
father here: folds 
Maxfulltrick: folds 
Uncalled bet ($0.05) returned to GGR817
GGR817 collected $0.10 from pot
GGR817: doesn't show hand 
*** SUMMARY ***
Total pot $0.10 | Rake $0 
Seat 2: father here (button) folded before Flop (didn't bet)
Seat 3: Maxfulltrick (small blind) folded before Flop
Seat 4: GGR817 (big blind) collected ($0.10)
Seat 5: the_humster folded before Flop (didn't bet)
Seat 6: Mr.Rilex folded before Flop (didn't bet)



PokerStars Hand #222983303824:  Hold'em No Limit ($0.05/$0.10 USD) - 2021/01/23 21:38:01 ET
Table 'Merope IV' 6-max Seat #3 is the button
Seat 2: father here ($29.70 in chips) 
Seat 3: Maxfulltrick ($10.15 in chips) 
Seat 4: GGR817 ($10.05 in chips) 
Seat 6: Mr.Rilex ($6.91 in chips) 
GGR817: posts small blind $0.05
Mr.Rilex: posts big blind $0.10
*** HOLE CARDS ***
father here: raises $0.20 to $0.30
Maxfulltrick: raises $0.65 to $0.95
GGR817: folds 
Mr.Rilex: folds 
father here: raises $1.35 to $2.30
Maxfulltrick: calls $1.35
*** FLOP *** [8c Tc Qh]
father here: bets $27.40 and is all-in
Maxfulltrick: folds 
Uncalled bet ($27.40) returned to father here
father here collected $4.54 from pot
*** SUMMARY ***
Total pot $4.75 | Rake $0.21 
Board [8c Tc Qh]
Seat 2: father here collected ($4.54)
Seat 3: Maxfulltrick (button) folded on the Flop
Seat 4: GGR817 (small blind) folded before Flop
Seat 6: Mr.Rilex (big blind) folded before Flop



PokerStars Hand #222983327260:  Hold'em No Limit ($0.05/$0.10 USD) - 2021/01/23 21:39:01 ET
Table 'Merope IV' 6-max Seat #4 is the button
Seat 3: Maxfulltrick ($10 in chips) 
Seat 4: GGR817 ($10 in chips) 
Seat 6: Mr.Rilex ($6.81 in chips) 
Mr.Rilex: posts small blind $0.05
father here: is sitting out 
Maxfulltrick: posts big blind $0.10
*** HOLE CARDS ***
GGR817: raises $0.15 to $0.25
Mr.Rilex: folds 
Maxfulltrick: folds 
Uncalled bet ($0.15) returned to GGR817
GGR817 collected $0.25 from pot
GGR817: doesn't show hand 
*** SUMMARY ***
Total pot $0.25 | Rake $0 
Seat 3: Maxfulltrick (big blind) folded before Flop
Seat 4: GGR817 (button) collected ($0.25)
Seat 6: Mr.Rilex (small blind) folded before Flop



PokerStars Hand #222983333056:  Hold'em No Limit ($0.05/$0.10 USD) - 2021/01/23 21:39:16 ET
Table 'Merope IV' 6-max Seat #6 is the button
Seat 3: Maxfulltrick ($10 in chips) 
Seat 4: GGR817 ($10.15 in chips) 
Seat 6: Mr.Rilex ($6.76 in chips) 
Maxfulltrick: posts small blind $0.05
GGR817: posts big blind $0.10
*** HOLE CARDS ***
father here leaves the table
Mr.Rilex: calls $0.10
Maxfulltrick: folds 
GGR817: checks 
*** FLOP *** [Jd 5d Js]
GGR817: checks 
Mr.Rilex: checks 
*** TURN *** [Jd 5d Js] [8s]
GGR817: checks 
Mr.Rilex: checks 
*** RIVER *** [Jd 5d Js 8s] [Tc]
0nix770 joins the table at seat #1 
GGR817: checks 
Mr.Rilex: bets $0.10
GGR817: folds 
Uncalled bet ($0.10) returned to Mr.Rilex
Mr.Rilex collected $0.24 from pot
*** SUMMARY ***
Total pot $0.25 | Rake $0.01 
Board [Jd 5d Js 8s Tc]
Seat 3: Maxfulltrick (small blind) folded before Flop
Seat 4: GGR817 (big blind) folded on the River
Seat 6: Mr.Rilex (button) collected ($0.24)



PokerStars Hand #222983353347:  Hold'em No Limit ($0.05/$0.10 USD) - 2021/01/23 21:40:07 ET
Table 'Merope IV' 6-max Seat #3 is the button
Seat 3: Maxfulltrick ($10 in chips) 
Seat 4: GGR817 ($10.05 in chips) 
Seat 6: Mr.Rilex ($6.90 in chips) 
GGR817: posts small blind $0.05
Mr.Rilex: posts big blind $0.10
0nix770: sits out 
*** HOLE CARDS ***
Maxfulltrick: folds 
GGR817: raises $0.20 to $0.30
Mr.Rilex: folds 
Uncalled bet ($0.20) returned to GGR817
GGR817 collected $0.20 from pot
GGR817: doesn't show hand 
*** SUMMARY ***
Total pot $0.20 | Rake $0 
Seat 3: Maxfulltrick (button) folded before Flop (didn't bet)
Seat 4: GGR817 (small blind) collected ($0.20)
Seat 6: Mr.Rilex (big blind) folded before Flop



PokerStars Hand #222983357345:  Hold'em No Limit ($0.05/$0.10 USD) - 2021/01/23 21:40:17 ET
Table 'Merope IV' 6-max Seat #4 is the button
Seat 1: 0nix770 ($10 in chips) 
Seat 3: Maxfulltrick ($10 in chips) 
Seat 4: GGR817 ($10.15 in chips) 
Seat 6: Mr.Rilex ($6.80 in chips) 
Mr.Rilex: posts small blind $0.05
0nix770: posts big blind $0.10
*** HOLE CARDS ***
Maxfulltrick: folds 
GGR817: folds 
Mr.Rilex: calls $0.05
0nix770: checks 
*** FLOP *** [Qc 6s Qh]
A Gaf A joins the table at seat #2 
Mr.Rilex: checks 
0nix770: checks 
*** TURN *** [Qc 6s Qh] [4c]
Mr.Rilex: bets $0.10
0nix770: folds 
Uncalled bet ($0.10) returned to Mr.Rilex
Mr.Rilex collected $0.19 from pot
*** SUMMARY ***
Total pot $0.20 | Rake $0.01 
Board [Qc 6s Qh 4c]
Seat 1: 0nix770 (big blind) folded on the Turn
Seat 3: Maxfulltrick folded before Flop (didn't bet)
Seat 4: GGR817 (button) folded before Flop (didn't bet)
Seat 6: Mr.Rilex (small blind) collected ($0.19)



PokerStars Hand #222983368196:  Hold'em No Limit ($0.05/$0.10 USD) - 2021/01/23 21:40:45 ET
Table 'Merope IV' 6-max Seat #6 is the button
Seat 1: 0nix770 ($10 in chips) 
Seat 2: A Gaf A ($10 in chips) 
Seat 3: Maxfulltrick ($10 in chips) 
Seat 4: GGR817 ($10.15 in chips) 
Seat 6: Mr.Rilex ($6.89 in chips) 
0nix770: posts small blind $0.05
A Gaf A: posts big blind $0.10
*** HOLE CARDS ***
Maxfulltrick: folds 
GGR817: raises $0.20 to $0.30
Mr.Rilex: folds 
Do-Man22 joins the table at seat #5 
0nix770: folds 
A Gaf A: calls $0.20
*** FLOP *** [5h Js 4c]
A Gaf A: checks 
GGR817: bets $0.31
A Gaf A: calls $0.31
*** TURN *** [5h Js 4c] [8c]
Do-Man22 leaves the table
A Gaf A: checks 
GGR817: bets $0.91
A Gaf A: raises $2.27 to $3.18
Driverofpoker joins the table at seat #5 
GGR817: folds 
Uncalled bet ($2.27) returned to A Gaf A
A Gaf A collected $2.95 from pot
A Gaf A: doesn't show hand 
*** SUMMARY ***
Total pot $3.09 | Rake $0.14 
Board [5h Js 4c 8c]
Seat 1: 0nix770 (small blind) folded before Flop
Seat 2: A Gaf A (big blind) collected ($2.95)
Seat 3: Maxfulltrick folded before Flop (didn't bet)
Seat 4: GGR817 folded on the Turn
Seat 6: Mr.Rilex (button) folded before Flop (didn't bet)



PokerStars Hand #222983393641:  Hold'em No Limit ($0.05/$0.10 USD) - 2021/01/23 21:41:49 ET
Table 'Merope IV' 6-max Seat #1 is the button
Seat 1: 0nix770 ($10 in chips) 
Seat 2: A Gaf A ($11.43 in chips) 
Seat 3: Maxfulltrick ($10 in chips) 
Seat 4: GGR817 ($10 in chips) 
Seat 5: Driverofpoker ($8 in chips) 
Seat 6: Mr.Rilex ($6.89 in chips) 
A Gaf A: posts small blind $0.05
Maxfulltrick: posts big blind $0.10
Driverofpoker: posts big blind $0.10
*** HOLE CARDS ***
GGR817: raises $0.30 to $0.40
Driverofpoker: calls $0.30
Mr.Rilex: calls $0.40
0nix770: folds 
A Gaf A: folds 
Maxfulltrick: folds 
*** FLOP *** [Kd 8s Ts]
GGR817: checks 
Driverofpoker: checks 
Mr.Rilex: bets $0.64
GGR817: calls $0.64
Driverofpoker: calls $0.64
*** TURN *** [Kd 8s Ts] [3c]
GGR817: checks 
Driverofpoker: checks 
Mr.Rilex: bets $1.36
GGR817: calls $1.36
Driverofpoker: folds 
*** RIVER *** [Kd 8s Ts 3c] [7s]
GGR817: checks 
Mr.Rilex: bets $4.49 and is all-in
GGR817: calls $4.49
*** SHOW DOWN ***
Mr.Rilex: shows [2s 2c] (a pair of Deuces)
GGR817: shows [Qs Ks] (a flush, King high)
GGR817 collected $14.30 from pot
*** SUMMARY ***
Total pot $14.97 | Rake $0.67 
Board [Kd 8s Ts 3c 7s]
Seat 1: 0nix770 (button) folded before Flop (didn't bet)
Seat 2: A Gaf A (small blind) folded before Flop
Seat 3: Maxfulltrick (big blind) folded before Flop
Seat 4: GGR817 showed [Qs Ks] and won ($14.30) with a flush, King high
Seat 5: Driverofpoker folded on the Turn
Seat 6: Mr.Rilex showed [2s 2c] and lost with a pair of Deuces



PokerStars Hand #222983424357:  Hold'em No Limit ($0.05/$0.10 USD) - 2021/01/23 21:42:56 ET
Table 'Merope IV' 6-max Seat #2 is the button
Seat 1: 0nix770 ($10 in chips) 
Seat 2: A Gaf A ($11.38 in chips) 
Seat 3: Maxfulltrick ($10 in chips) 
Seat 4: GGR817 ($17.41 in chips) 
Seat 5: Driverofpoker ($6.96 in chips) 
Maxfulltrick: posts small blind $0.05
GGR817: posts big blind $0.10
*** HOLE CARDS ***
Driverofpoker: calls $0.10
0nix770: folds 
A Gaf A: folds 
Maxfulltrick: folds 
Mr.Rilex leaves the table
GGR817: checks 
*** FLOP *** [8d 2h 2s]
GGR817: checks 
Driverofpoker: checks 
*** TURN *** [8d 2h 2s] [Ks]
GGR817: checks 
Driverofpoker: bets $0.10
GGR817: folds 
Uncalled bet ($0.10) returned to Driverofpoker
Driverofpoker collected $0.24 from pot
Driverofpoker: doesn't show hand 
*** SUMMARY ***
Total pot $0.25 | Rake $0.01 
Board [8d 2h 2s Ks]
Seat 1: 0nix770 folded before Flop (didn't bet)
Seat 2: A Gaf A (button) folded before Flop (didn't bet)
Seat 3: Maxfulltrick (small blind) folded before Flop
Seat 4: GGR817 (big blind) folded on the Turn
Seat 5: Driverofpoker collected ($0.24)



PokerStars Hand #222983434332:  Hold'em No Limit ($0.05/$0.10 USD) - 2021/01/23 21:43:21 ET
Table 'Merope IV' 6-max Seat #3 is the button
Seat 1: 0nix770 ($10 in chips) 
Seat 2: A Gaf A ($11.38 in chips) 
Seat 3: Maxfulltrick ($10 in chips) 
Seat 4: GGR817 ($17.31 in chips) 
Seat 5: Driverofpoker ($7.10 in chips) 
GGR817: posts small blind $0.05
Driverofpoker: posts big blind $0.10
*** HOLE CARDS ***
0nix770: folds 
A Gaf A: folds 
Maxfulltrick: folds 
GGR817: folds 
Uncalled bet ($0.05) returned to Driverofpoker
Driverofpoker collected $0.10 from pot
Driverofpoker: doesn't show hand 
*** SUMMARY ***
Total pot $0.10 | Rake $0 
Seat 1: 0nix770 folded before Flop (didn't bet)
Seat 2: A Gaf A folded before Flop (didn't bet)
Seat 3: Maxfulltrick (button) folded before Flop (didn't bet)
Seat 4: GGR817 (small blind) folded before Flop
Seat 5: Driverofpoker (big blind) collected ($0.10)



PokerStars Hand #222983442624:  Hold'em No Limit ($0.05/$0.10 USD) - 2021/01/23 21:43:42 ET
Table 'Merope IV' 6-max Seat #4 is the button
Seat 1: 0nix770 ($10 in chips) 
Seat 2: A Gaf A ($11.38 in chips) 
Seat 3: Maxfulltrick ($10 in chips) 
Seat 4: GGR817 ($17.26 in chips) 
Seat 5: Driverofpoker ($7.15 in chips) 
Driverofpoker: posts small blind $0.05
0nix770: posts big blind $0.10
*** HOLE CARDS ***
A Gaf A: folds 
Maxfulltrick: folds 
GGR817: folds 
Driverofpoker: calls $0.05
0nix770: raises $0.30 to $0.40
Driverofpoker: calls $0.30
*** FLOP *** [7c Jd Ad]
Driverofpoker: checks 
0nix770: bets $0.30
Driverofpoker: folds 
Uncalled bet ($0.30) returned to 0nix770
0nix770 collected $0.76 from pot
0nix770: doesn't show hand 
*** SUMMARY ***
Total pot $0.80 | Rake $0.04 
Board [7c Jd Ad]
Seat 1: 0nix770 (big blind) collected ($0.76)
Seat 2: A Gaf A folded before Flop (didn't bet)
Seat 3: Maxfulltrick folded before Flop (didn't bet)
Seat 4: GGR817 (button) folded before Flop (didn't bet)
Seat 5: Driverofpoker (small blind) folded on the Flop



PokerStars Hand #222982290951:  Hold'em No Limit ($0.05/$0.10 USD) - 2021/01/23 20:57:14 ET
Table 'Merope IV' 6-max Seat #1 is the button
Seat 1: alfaomegabet ($10 in chips) 
Seat 2: LimpinRabbit ($11.38 in chips) 
Seat 3: Al7uut ($16.80 in chips) 
Seat 4: Wangritter13 ($19.56 in chips) 
Seat 5: VanCleef322 ($10 in chips) 
Seat 6: chris.nomf ($21.11 in chips) 
LimpinRabbit: posts small blind $0.05
Al7uut: posts big blind $0.10
*** HOLE CARDS ***
Wangritter13: folds 
VanCleef322: raises $0.15 to $0.25
chris.nomf: folds 
alfaomegabet: folds 
LimpinRabbit: folds 
Al7uut: raises $0.45 to $0.70
VanCleef322: calls $0.45
*** FLOP *** [Tc 6c Kd]
Al7uut: checks 
VanCleef322: checks 
*** TURN *** [Tc 6c Kd] [9h]
Al7uut: bets $0.10
VanCleef322: calls $0.10
*** RIVER *** [Tc 6c Kd 9h] [Ks]
Al7uut: bets $0.50
VanCleef322: calls $0.50
*** SHOW DOWN ***
Al7uut: shows [9d Ac] (two pair, Kings and Nines)
VanCleef322: mucks hand 
Al7uut collected $2.53 from pot
*** SUMMARY ***
Total pot $2.65 | Rake $0.12 
Board [Tc 6c Kd 9h Ks]
Seat 1: alfaomegabet (button) folded before Flop (didn't bet)
Seat 2: LimpinRabbit (small blind) folded before Flop
Seat 3: Al7uut (big blind) showed [9d Ac] and won ($2.53) with two pair, Kings and Nines
Seat 4: Wangritter13 folded before Flop (didn't bet)
Seat 5: VanCleef322 mucked
Seat 6: chris.nomf folded before Flop (didn't bet)



PokerStars Hand #222982306125:  Hold'em No Limit ($0.05/$0.10 USD) - 2021/01/23 20:58:02 ET
Table 'Merope IV' 6-max Seat #2 is the button
Seat 1: alfaomegabet ($10 in chips) 
Seat 2: LimpinRabbit ($11.33 in chips) 
Seat 3: Al7uut ($18.03 in chips) 
Seat 4: Wangritter13 ($19.56 in chips) 
Seat 5: VanCleef322 ($10 in chips) 
Seat 6: chris.nomf ($21.11 in chips) 
Al7uut: posts small blind $0.05
Wangritter13: posts big blind $0.10
*** HOLE CARDS ***
VanCleef322: folds 
chris.nomf: folds 
alfaomegabet: folds 
LimpinRabbit: folds 
Al7uut: calls $0.05
Wangritter13: checks 
*** FLOP *** [As 2d 4s]
Al7uut: bets $0.10
Wangritter13: folds 
Uncalled bet ($0.10) returned to Al7uut
Al7uut collected $0.19 from pot
Al7uut: doesn't show hand 
*** SUMMARY ***
Total pot $0.20 | Rake $0.01 
Board [As 2d 4s]
Seat 1: alfaomegabet folded before Flop (didn't bet)
Seat 2: LimpinRabbit (button) folded before Flop (didn't bet)
Seat 3: Al7uut (small blind) collected ($0.19)
Seat 4: Wangritter13 (big blind) folded on the Flop
Seat 5: VanCleef322 folded before Flop (didn't bet)
Seat 6: chris.nomf folded before Flop (didn't bet)



PokerStars Hand #222982314416:  Hold'em No Limit ($0.05/$0.10 USD) - 2021/01/23 20:58:28 ET
Table 'Merope IV' 6-max Seat #3 is the button
Seat 1: alfaomegabet ($10 in chips) 
Seat 2: LimpinRabbit ($11.33 in chips) 
Seat 3: Al7uut ($18.12 in chips) 
Seat 4: Wangritter13 ($19.46 in chips) 
Seat 5: VanCleef322 ($10 in chips) 
Seat 6: chris.nomf ($21.11 in chips) 
Wangritter13: posts small blind $0.05
VanCleef322: posts big blind $0.10
*** HOLE CARDS ***
chris.nomf: folds 
alfaomegabet: raises $0.20 to $0.30
LimpinRabbit: folds 
Al7uut: folds 
Wangritter13: folds 
VanCleef322: folds 
Uncalled bet ($0.20) returned to alfaomegabet
alfaomegabet collected $0.25 from pot
alfaomegabet: doesn't show hand 
*** SUMMARY ***
Total pot $0.25 | Rake $0 
Seat 1: alfaomegabet collected ($0.25)
Seat 2: LimpinRabbit folded before Flop (didn't bet)
Seat 3: Al7uut (button) folded before Flop (didn't bet)
Seat 4: Wangritter13 (small blind) folded before Flop
Seat 5: VanCleef322 (big blind) folded before Flop
Seat 6: chris.nomf folded before Flop (didn't bet)



PokerStars Hand #222982321739:  Hold'em No Limit ($0.05/$0.10 USD) - 2021/01/23 20:58:52 ET
Table 'Merope IV' 6-max Seat #4 is the button
Seat 1: alfaomegabet ($10.15 in chips) 
Seat 2: LimpinRabbit ($11.33 in chips) 
Seat 3: Al7uut ($18.12 in chips) 
Seat 4: Wangritter13 ($19.41 in chips) 
Seat 5: VanCleef322 ($10 in chips) 
Seat 6: chris.nomf ($21.11 in chips) 
VanCleef322: posts small blind $0.05
chris.nomf: posts big blind $0.10
*** HOLE CARDS ***
alfaomegabet: folds 
LimpinRabbit: folds 
Al7uut: calls $0.10
Wangritter13: calls $0.10
VanCleef322: calls $0.05
chris.nomf: checks 
*** FLOP *** [Ac Ts 7c]
VanCleef322: checks 
chris.nomf: checks 
Al7uut: checks 
Wangritter13: checks 
*** TURN *** [Ac Ts 7c] [Js]
VanCleef322: checks 
chris.nomf: bets $0.19
Al7uut: calls $0.19
Wangritter13: folds 
VanCleef322: calls $0.19
*** RIVER *** [Ac Ts 7c Js] [Jc]
VanCleef322: checks 
chris.nomf: checks 
Al7uut: checks 
*** SHOW DOWN ***
VanCleef322: shows [2h Ah] (two pair, Aces and Jacks)
chris.nomf: shows [As 2d] (two pair, Aces and Jacks)
Al7uut: mucks hand 
VanCleef322 collected $0.47 from pot
chris.nomf collected $0.46 from pot
*** SUMMARY ***
Total pot $0.97 | Rake $0.04 
Board [Ac Ts 7c Js Jc]
Seat 1: alfaomegabet folded before Flop (didn't bet)
Seat 2: LimpinRabbit folded before Flop (didn't bet)
Seat 3: Al7uut mucked
Seat 4: Wangritter13 (button) folded on the Turn
Seat 5: VanCleef322 (small blind) showed [2h Ah] and won ($0.47) with two pair, Aces and Jacks
Seat 6: chris.nomf (big blind) showed [As 2d] and won ($0.46) with two pair, Aces and Jacks



PokerStars Hand #222982335058:  Hold'em No Limit ($0.05/$0.10 USD) - 2021/01/23 20:59:34 ET
Table 'Merope IV' 6-max Seat #5 is the button
Seat 1: alfaomegabet ($10.15 in chips) 
Seat 2: LimpinRabbit ($11.33 in chips) 
Seat 3: Al7uut ($17.83 in chips) 
Seat 4: Wangritter13 ($19.31 in chips) 
Seat 5: VanCleef322 ($10.18 in chips) 
Seat 6: chris.nomf ($21.28 in chips) 
chris.nomf: posts small blind $0.05
alfaomegabet: posts big blind $0.10
*** HOLE CARDS ***
LimpinRabbit: folds 
Al7uut: calls $0.10
Wangritter13: calls $0.10
VanCleef322: raises $0.35 to $0.45
chris.nomf: folds 
alfaomegabet: raises $0.85 to $1.30
Al7uut: calls $1.20
Wangritter13: folds 
VanCleef322: folds 
*** FLOP *** [Jh Tc Jc]
alfaomegabet: checks 
Al7uut: bets $3
alfaomegabet: folds 
Uncalled bet ($3) returned to Al7uut
Al7uut collected $3.06 from pot
Al7uut: doesn't show hand 
*** SUMMARY ***
Total pot $3.20 | Rake $0.14 
Board [Jh Tc Jc]
Seat 1: alfaomegabet (big blind) folded on the Flop
Seat 2: LimpinRabbit folded before Flop (didn't bet)
Seat 3: Al7uut collected ($3.06)
Seat 4: Wangritter13 folded before Flop
Seat 5: VanCleef322 (button) folded before Flop
Seat 6: chris.nomf (small blind) folded before Flop



PokerStars Hand #222982352034:  Hold'em No Limit ($0.05/$0.10 USD) - 2021/01/23 21:00:25 ET
Table 'Merope IV' 6-max Seat #6 is the button
Seat 1: alfaomegabet ($10 in chips) 
Seat 2: LimpinRabbit ($11.33 in chips) 
Seat 3: Al7uut ($19.59 in chips) 
Seat 4: Wangritter13 ($19.21 in chips) 
Seat 5: VanCleef322 ($10 in chips) 
Seat 6: chris.nomf ($21.23 in chips) 
alfaomegabet: posts small blind $0.05
LimpinRabbit: posts big blind $0.10
*** HOLE CARDS ***
Al7uut: raises $0.10 to $0.20
Wangritter13: folds 
VanCleef322: folds 
chris.nomf: folds 
alfaomegabet: folds 
LimpinRabbit: folds 
Uncalled bet ($0.10) returned to Al7uut
Al7uut collected $0.25 from pot
Al7uut: doesn't show hand 
*** SUMMARY ***
Total pot $0.25 | Rake $0 
Seat 1: alfaomegabet (small blind) folded before Flop
Seat 2: LimpinRabbit (big blind) folded before Flop
Seat 3: Al7uut collected ($0.25)
Seat 4: Wangritter13 folded before Flop (didn't bet)
Seat 5: VanCleef322 folded before Flop (didn't bet)
Seat 6: chris.nomf (button) folded before Flop (didn't bet)



PokerStars Hand #222982359037:  Hold'em No Limit ($0.05/$0.10 USD) - 2021/01/23 21:00:45 ET
Table 'Merope IV' 6-max Seat #1 is the button
Seat 1: alfaomegabet ($10 in chips) 
Seat 2: LimpinRabbit ($11.23 in chips) 
Seat 3: Al7uut ($19.74 in chips) 
Seat 4: Wangritter13 ($19.21 in chips) 
Seat 5: VanCleef322 ($10 in chips) 
Seat 6: chris.nomf ($21.23 in chips) 
LimpinRabbit: posts small blind $0.05
Al7uut: posts big blind $0.10
*** HOLE CARDS ***
Wangritter13: folds 
VanCleef322: folds 
chris.nomf: calls $0.10
alfaomegabet: raises $0.40 to $0.50
LimpinRabbit: folds 
Al7uut: calls $0.40
chris.nomf: calls $0.40
*** FLOP *** [9h Jc 2s]
Al7uut: checks 
chris.nomf: checks 
alfaomegabet: checks 
*** TURN *** [9h Jc 2s] [4d]
Al7uut: checks 
chris.nomf: checks 
alfaomegabet: checks 
*** RIVER *** [9h Jc 2s 4d] [Ts]
Al7uut: bets $0.70
chris.nomf: folds 
alfaomegabet: raises $1.60 to $2.30
Al7uut: folds 
Uncalled bet ($1.60) returned to alfaomegabet
alfaomegabet collected $2.82 from pot
alfaomegabet: doesn't show hand 
*** SUMMARY ***
Total pot $2.95 | Rake $0.13 
Board [9h Jc 2s 4d Ts]
Seat 1: alfaomegabet (button) collected ($2.82)
Seat 2: LimpinRabbit (small blind) folded before Flop
Seat 3: Al7uut (big blind) folded on the River
Seat 4: Wangritter13 folded before Flop (didn't bet)
Seat 5: VanCleef322 folded before Flop (didn't bet)
Seat 6: chris.nomf folded on the River



PokerStars Hand #222982395961:  Hold'em No Limit ($0.05/$0.10 USD) - 2021/01/23 21:01:41 ET
Table 'Merope IV' 6-max Seat #2 is the button
Seat 1: alfaomegabet ($11.62 in chips) 
Seat 2: LimpinRabbit ($11.18 in chips) 
Seat 3: Al7uut ($18.54 in chips) 
Seat 4: Wangritter13 ($19.21 in chips) 
Seat 5: VanCleef322 ($10 in chips) 
Seat 6: chris.nomf ($20.73 in chips) 
Al7uut: posts small blind $0.05
Wangritter13: posts big blind $0.10
*** HOLE CARDS ***
VanCleef322: folds 
chris.nomf: folds 
alfaomegabet: folds 
LimpinRabbit: folds 
Al7uut: calls $0.05
Wangritter13: checks 
*** FLOP *** [Qd Th 5d]
Al7uut: bets $0.20
Wangritter13: folds 
Uncalled bet ($0.20) returned to Al7uut
Al7uut collected $0.19 from pot
Al7uut: doesn't show hand 
*** SUMMARY ***
Total pot $0.20 | Rake $0.01 
Board [Qd Th 5d]
Seat 1: alfaomegabet folded before Flop (didn't bet)
Seat 2: LimpinRabbit (button) folded before Flop (didn't bet)
Seat 3: Al7uut (small blind) collected ($0.19)
Seat 4: Wangritter13 (big blind) folded on the Flop
Seat 5: VanCleef322 folded before Flop (didn't bet)
Seat 6: chris.nomf folded before Flop (didn't bet)



PokerStars Hand #222982404812:  Hold'em No Limit ($0.05/$0.10 USD) - 2021/01/23 21:02:03 ET
Table 'Merope IV' 6-max Seat #3 is the button
Seat 1: alfaomegabet ($11.62 in chips) 
Seat 2: LimpinRabbit ($11.18 in chips) 
Seat 3: Al7uut ($18.63 in chips) 
Seat 4: Wangritter13 ($19.11 in chips) 
Seat 5: VanCleef322 ($10 in chips) 
Seat 6: chris.nomf ($20.73 in chips) 
Wangritter13: posts small blind $0.05
VanCleef322: posts big blind $0.10
*** HOLE CARDS ***
chris.nomf: raises $0.20 to $0.30
alfaomegabet: folds 
LimpinRabbit: folds 
Al7uut: raises $0.30 to $0.60
Wangritter13: folds 
VanCleef322: folds 
chris.nomf: calls $0.30
*** FLOP *** [Qs 9h Ah]
chris.nomf: checks 
Al7uut: bets $0.50
chris.nomf: calls $0.50
*** TURN *** [Qs 9h Ah] [8s]
chris.nomf: checks 
Al7uut: bets $0.50
chris.nomf: calls $0.50
*** RIVER *** [Qs 9h Ah 8s] [3s]
chris.nomf: checks 
Al7uut: checks 
*** SHOW DOWN ***
chris.nomf: shows [Ks Ac] (a pair of Aces)
Al7uut: mucks hand 
chris.nomf collected $3.20 from pot
*** SUMMARY ***
Total pot $3.35 | Rake $0.15 
Board [Qs 9h Ah 8s 3s]
Seat 1: alfaomegabet folded before Flop (didn't bet)
Seat 2: LimpinRabbit folded before Flop (didn't bet)
Seat 3: Al7uut (button) mucked
Seat 4: Wangritter13 (small blind) folded before Flop
Seat 5: VanCleef322 (big blind) folded before Flop
Seat 6: chris.nomf showed [Ks Ac] and won ($3.20) with a pair of Aces



PokerStars Hand #222982421362:  Hold'em No Limit ($0.05/$0.10 USD) - 2021/01/23 21:02:43 ET
Table 'Merope IV' 6-max Seat #4 is the button
Seat 1: alfaomegabet ($11.62 in chips) 
Seat 2: LimpinRabbit ($11.18 in chips) 
Seat 3: Al7uut ($17.03 in chips) 
Seat 4: Wangritter13 ($19.06 in chips) 
Seat 5: VanCleef322 ($10 in chips) 
Seat 6: chris.nomf ($22.33 in chips) 
VanCleef322: posts small blind $0.05
chris.nomf: posts big blind $0.10
*** HOLE CARDS ***
alfaomegabet: folds 
LimpinRabbit: folds 
Al7uut: raises $0.10 to $0.20
Wangritter13: folds 
VanCleef322: calls $0.15
chris.nomf: folds 
*** FLOP *** [4h Qs 3s]
VanCleef322: checks 
Al7uut: checks 
*** TURN *** [4h Qs 3s] [5s]
VanCleef322: checks 
Al7uut: checks 
*** RIVER *** [4h Qs 3s 5s] [4s]
VanCleef322: checks 
Al7uut: checks 
*** SHOW DOWN ***
VanCleef322: shows [Qd 6s] (a flush, Queen high)
Al7uut: mucks hand 
VanCleef322 collected $0.48 from pot
*** SUMMARY ***
Total pot $0.50 | Rake $0.02 
Board [4h Qs 3s 5s 4s]
Seat 1: alfaomegabet folded before Flop (didn't bet)
Seat 2: LimpinRabbit folded before Flop (didn't bet)
Seat 3: Al7uut mucked
Seat 4: Wangritter13 (button) folded before Flop (didn't bet)
Seat 5: VanCleef322 (small blind) showed [Qd 6s] and won ($0.48) with a flush, Queen high
Seat 6: chris.nomf (big blind) folded before Flop



PokerStars Hand #222982434060:  Hold'em No Limit ($0.05/$0.10 USD) - 2021/01/23 21:03:13 ET
Table 'Merope IV' 6-max Seat #5 is the button
Seat 1: alfaomegabet ($11.62 in chips) 
Seat 2: LimpinRabbit ($11.18 in chips) 
Seat 3: Al7uut ($16.83 in chips) 
Seat 4: Wangritter13 ($19.06 in chips) 
Seat 5: VanCleef322 ($10.28 in chips) 
Seat 6: chris.nomf ($22.23 in chips) 
chris.nomf: posts small blind $0.05
alfaomegabet: posts big blind $0.10
*** HOLE CARDS ***
LimpinRabbit: folds 
Al7uut: folds 
Wangritter13: folds 
VanCleef322: folds 
chris.nomf: folds 
Uncalled bet ($0.05) returned to alfaomegabet
alfaomegabet collected $0.10 from pot
alfaomegabet: doesn't show hand 
*** SUMMARY ***
Total pot $0.10 | Rake $0 
Seat 1: alfaomegabet (big blind) collected ($0.10)
Seat 2: LimpinRabbit folded before Flop (didn't bet)
Seat 3: Al7uut folded before Flop (didn't bet)
Seat 4: Wangritter13 folded before Flop (didn't bet)
Seat 5: VanCleef322 (button) folded before Flop (didn't bet)
Seat 6: chris.nomf (small blind) folded before Flop



PokerStars Hand #222982437211:  Hold'em No Limit ($0.05/$0.10 USD) - 2021/01/23 21:03:21 ET
Table 'Merope IV' 6-max Seat #6 is the button
Seat 1: alfaomegabet ($11.67 in chips) 
Seat 3: Al7uut ($16.83 in chips) 
Seat 4: Wangritter13 ($19.06 in chips) 
Seat 5: VanCleef322 ($10.28 in chips) 
Seat 6: chris.nomf ($22.18 in chips) 
alfaomegabet: posts small blind $0.05
LimpinRabbit: is sitting out 
Al7uut: posts big blind $0.10
*** HOLE CARDS ***
Wangritter13: raises $0.10 to $0.20
VanCleef322: folds 
LimpinRabbit leaves the table
chris.nomf: raises $0.40 to $0.60
alfaomegabet: folds 
Al7uut: calls $0.50
Wangritter13: calls $0.40
*** FLOP *** [3d 5s Ks]
Al7uut: checks 
Wangritter13: checks 
chris.nomf: bets $0.89
Al7uut: calls $0.89
Wangritter13: folds 
*** TURN *** [3d 5s Ks] [9s]
Al7uut: checks 
chris.nomf: checks 
*** RIVER *** [3d 5s Ks 9s] [2s]
Al7uut: bets $2.30
chris.nomf: folds 
Uncalled bet ($2.30) returned to Al7uut
Al7uut collected $3.47 from pot
Al7uut: doesn't show hand 
*** SUMMARY ***
Total pot $3.63 | Rake $0.16 
Board [3d 5s Ks 9s 2s]
Seat 1: alfaomegabet (small blind) folded before Flop
Seat 3: Al7uut (big blind) collected ($3.47)
Seat 4: Wangritter13 folded on the Flop
Seat 5: VanCleef322 folded before Flop (didn't bet)
Seat 6: chris.nomf (button) folded on the River



PokerStars Hand #222982467180:  Hold'em No Limit ($0.05/$0.10 USD) - 2021/01/23 21:04:33 ET
Table 'Merope IV' 6-max Seat #1 is the button
Seat 1: alfaomegabet ($11.62 in chips) 
Seat 3: Al7uut ($18.81 in chips) 
Seat 4: Wangritter13 ($18.46 in chips) 
Seat 5: VanCleef322 ($10.28 in chips) 
Seat 6: chris.nomf ($20.69 in chips) 
Al7uut: posts small blind $0.05
Wangritter13: posts big blind $0.10
*** HOLE CARDS ***
VanCleef322: folds 
chris.nomf: folds 
alfaomegabet: folds 
Al7uut: raises $0.10 to $0.20
Wangritter13: folds 
Uncalled bet ($0.10) returned to Al7uut
Al7uut collected $0.20 from pot
Al7uut: doesn't show hand 
*** SUMMARY ***
Total pot $0.20 | Rake $0 
Seat 1: alfaomegabet (button) folded before Flop (didn't bet)
Seat 3: Al7uut (small blind) collected ($0.20)
Seat 4: Wangritter13 (big blind) folded before Flop
Seat 5: VanCleef322 folded before Flop (didn't bet)
Seat 6: chris.nomf folded before Flop (didn't bet)



PokerStars Hand #222982471048:  Hold'em No Limit ($0.05/$0.10 USD) - 2021/01/23 21:04:42 ET
Table 'Merope IV' 6-max Seat #3 is the button
Seat 1: alfaomegabet ($11.62 in chips) 
Seat 3: Al7uut ($18.91 in chips) 
Seat 4: Wangritter13 ($18.36 in chips) 
Seat 5: VanCleef322 ($10.28 in chips) 
Seat 6: chris.nomf ($20.69 in chips) 
Wangritter13: posts small blind $0.05
VanCleef322: posts big blind $0.10
*** HOLE CARDS ***
chris.nomf: folds 
alfaomegabet: folds 
Al7uut: raises $0.80 to $0.90
Wangritter13: folds 
VanCleef322: folds 
Uncalled bet ($0.80) returned to Al7uut
Al7uut collected $0.25 from pot
Al7uut: doesn't show hand 
*** SUMMARY ***
Total pot $0.25 | Rake $0 
Seat 1: alfaomegabet folded before Flop (didn't bet)
Seat 3: Al7uut (button) collected ($0.25)
Seat 4: Wangritter13 (small blind) folded before Flop
Seat 5: VanCleef322 (big blind) folded before Flop
Seat 6: chris.nomf folded before Flop (didn't bet)



PokerStars Hand #222982477812:  Hold'em No Limit ($0.05/$0.10 USD) - 2021/01/23 21:04:59 ET
Table 'Merope IV' 6-max Seat #4 is the button
Seat 1: alfaomegabet ($11.62 in chips) 
Seat 3: Al7uut ($19.06 in chips) 
Seat 4: Wangritter13 ($18.31 in chips) 
Seat 5: VanCleef322 ($10.18 in chips) 
Seat 6: chris.nomf ($20.69 in chips) 
VanCleef322: posts small blind $0.05
chris.nomf: posts big blind $0.10
*** HOLE CARDS ***
alfaomegabet: folds 
Al7uut: raises $0.60 to $0.70
Wangritter13: calls $0.70
VanCleef322: folds 
chris.nomf: folds 
*** FLOP *** [Kh 3s Jc]
Al7uut: checks 
Wangritter13: checks 
*** TURN *** [Kh 3s Jc] [8c]
Al7uut: bets $0.30
Scootey123 joins the table at seat #2 
Wangritter13: raises $1.04 to $1.34
Al7uut: calls $1.04
*** RIVER *** [Kh 3s Jc 8c] [Ah]
Al7uut: bets $1.70
Scootey123 leaves the table
Wangritter13: folds 
Uncalled bet ($1.70) returned to Al7uut
Al7uut collected $4.04 from pot
Al7uut: doesn't show hand 
*** SUMMARY ***
Total pot $4.23 | Rake $0.19 
Board [Kh 3s Jc 8c Ah]
Seat 1: alfaomegabet folded before Flop (didn't bet)
Seat 3: Al7uut collected ($4.04)
Seat 4: Wangritter13 (button) folded on the River
Seat 5: VanCleef322 (small blind) folded before Flop
Seat 6: chris.nomf (big blind) folded before Flop



PokerStars Hand #222982496841:  Hold'em No Limit ($0.05/$0.10 USD) - 2021/01/23 21:05:45 ET
Table 'Merope IV' 6-max Seat #5 is the button
Seat 1: alfaomegabet ($11.62 in chips) 
Seat 3: Al7uut ($21.06 in chips) 
Seat 4: Wangritter13 ($16.27 in chips) 
Seat 5: VanCleef322 ($10.13 in chips) 
Seat 6: chris.nomf ($20.59 in chips) 
chris.nomf: posts small blind $0.05
alfaomegabet: posts big blind $0.10
*** HOLE CARDS ***
Al7uut: raises $0.40 to $0.50
Wangritter13: folds 
father here joins the table at seat #2 
VanCleef322: folds 
chris.nomf: folds 
alfaomegabet: folds 
Uncalled bet ($0.40) returned to Al7uut
Al7uut collected $0.25 from pot
Al7uut: doesn't show hand 
*** SUMMARY ***
Total pot $0.25 | Rake $0 
Seat 1: alfaomegabet (big blind) folded before Flop
Seat 3: Al7uut collected ($0.25)
Seat 4: Wangritter13 folded before Flop (didn't bet)
Seat 5: VanCleef322 (button) folded before Flop (didn't bet)
Seat 6: chris.nomf (small blind) folded before Flop



PokerStars Hand #222982507354:  Hold'em No Limit ($0.05/$0.10 USD) - 2021/01/23 21:06:10 ET
Table 'Merope IV' 6-max Seat #6 is the button
Seat 1: alfaomegabet ($11.52 in chips) 
Seat 2: father here ($10 in chips) 
Seat 3: Al7uut ($21.21 in chips) 
Seat 4: Wangritter13 ($16.27 in chips) 
Seat 5: VanCleef322 ($10.13 in chips) 
Seat 6: chris.nomf ($20.54 in chips) 
alfaomegabet: posts small blind $0.05
father here: posts big blind $0.10
*** HOLE CARDS ***
Al7uut: raises $0.10 to $0.20
Wangritter13: calls $0.20
VanCleef322: folds 
chris.nomf: folds 
alfaomegabet: folds 
father here: folds 
*** FLOP *** [8h Ts Jh]
Al7uut: bets $0.30
Wangritter13: folds 
Uncalled bet ($0.30) returned to Al7uut
Al7uut collected $0.53 from pot
Al7uut: doesn't show hand 
*** SUMMARY ***
Total pot $0.55 | Rake $0.02 
Board [8h Ts Jh]
Seat 1: alfaomegabet (small blind) folded before Flop
Seat 2: father here (big blind) folded before Flop
Seat 3: Al7uut collected ($0.53)
Seat 4: Wangritter13 folded on the Flop
Seat 5: VanCleef322 folded before Flop (didn't bet)
Seat 6: chris.nomf (button) folded before Flop (didn't bet)



PokerStars Hand #222982518568:  Hold'em No Limit ($0.05/$0.10 USD) - 2021/01/23 21:06:37 ET
Table 'Merope IV' 6-max Seat #1 is the button
Seat 1: alfaomegabet ($11.47 in chips) 
Seat 2: father here ($10 in chips) 
Seat 3: Al7uut ($21.54 in chips) 
Seat 4: Wangritter13 ($16.07 in chips) 
Seat 5: VanCleef322 ($10.13 in chips) 
Seat 6: chris.nomf ($20.54 in chips) 
father here: posts small blind $0.05
Al7uut: posts big blind $0.10
*** HOLE CARDS ***
Wangritter13: folds 
VanCleef322: folds 
chris.nomf: raises $0.20 to $0.30
alfaomegabet: folds 
father here: calls $0.25
Al7uut: calls $0.20
*** FLOP *** [Kh Jc 5d]
father here: checks 
Al7uut: checks 
chris.nomf: checks 
*** TURN *** [Kh Jc 5d] [4s]
father here: checks 
Al7uut: bets $0.16
chris.nomf: calls $0.16
father here: calls $0.16
*** RIVER *** [Kh Jc 5d 4s] [Qd]
father here: checks 
Al7uut: checks 
chris.nomf: checks 
*** SHOW DOWN ***
father here: shows [As Qs] (a pair of Queens)
Al7uut: mucks hand 
chris.nomf: mucks hand 
father here collected $1.32 from pot
*** SUMMARY ***
Total pot $1.38 | Rake $0.06 
Board [Kh Jc 5d 4s Qd]
Seat 1: alfaomegabet (button) folded before Flop (didn't bet)
Seat 2: father here (small blind) showed [As Qs] and won ($1.32) with a pair of Queens
Seat 3: Al7uut (big blind) mucked
Seat 4: Wangritter13 folded before Flop (didn't bet)
Seat 5: VanCleef322 folded before Flop (didn't bet)
Seat 6: chris.nomf mucked



PokerStars Hand #222982547976:  Hold'em No Limit ($0.05/$0.10 USD) - 2021/01/23 21:07:47 ET
Table 'Merope IV' 6-max Seat #2 is the button
Seat 1: alfaomegabet ($11.47 in chips) 
Seat 2: father here ($10.86 in chips) 
Seat 3: Al7uut ($21.08 in chips) 
Seat 4: Wangritter13 ($16.07 in chips) 
Seat 5: VanCleef322 ($10.13 in chips) 
Seat 6: chris.nomf ($20.08 in chips) 
Al7uut: posts small blind $0.05
Wangritter13: posts big blind $0.10
*** HOLE CARDS ***
VanCleef322: folds 
chris.nomf: raises $0.20 to $0.30
alfaomegabet: folds 
father here: calls $0.30
Al7uut: raises $0.20 to $0.50
Wangritter13: calls $0.40
chris.nomf: calls $0.20
father here: raises $10.36 to $10.86 and is all-in
Al7uut: calls $10.36
Wangritter13: folds 
chris.nomf: folds 
*** FLOP *** [3c 3h Td]
*** TURN *** [3c 3h Td] [9h]
*** RIVER *** [3c 3h Td 9h] [Kc]
*** SHOW DOWN ***
Al7uut: shows [5d 5c] (two pair, Fives and Threes)
father here: shows [Tc Th] (a full house, Tens full of Threes)
father here cashed out the hand for $17.38 | Cash Out Fee $0.18
*** SUMMARY ***
Total pot $22.72 | Rake $1.02 
Board [3c 3h Td 9h Kc]
Seat 1: alfaomegabet folded before Flop (didn't bet)
Seat 2: father here (button) showed [Tc Th] and won ($21.70) with a full house, Tens full of Threes (pot not awarded as player cashed out)
Seat 3: Al7uut (small blind) showed [5d 5c] and lost with two pair, Fives and Threes
Seat 4: Wangritter13 (big blind) folded before Flop
Seat 5: VanCleef322 folded before Flop (didn't bet)
Seat 6: chris.nomf folded before Flop



PokerStars Hand #222982563184:  Hold'em No Limit ($0.05/$0.10 USD) - 2021/01/23 21:08:24 ET
Table 'Merope IV' 6-max Seat #3 is the button
Seat 1: alfaomegabet ($11.47 in chips) 
Seat 2: father here ($17.38 in chips) 
Seat 3: Al7uut ($10.22 in chips) 
Seat 4: Wangritter13 ($15.57 in chips) 
Seat 5: VanCleef322 ($10.13 in chips) 
Seat 6: chris.nomf ($19.58 in chips) 
Wangritter13: posts small blind $0.05
VanCleef322: posts big blind $0.10
*** HOLE CARDS ***
chris.nomf: calls $0.10
alfaomegabet: folds 
father here: raises $0.30 to $0.40
Al7uut is disconnected 
Al7uut has timed out while being disconnected
Al7uut: folds 
Wangritter13: raises $15.17 to $15.57 and is all-in
VanCleef322: folds 
chris.nomf: folds 
father here: calls $15.17
*** FLOP *** [Qh 9d 5d]
*** TURN *** [Qh 9d 5d] [8s]
*** RIVER *** [Qh 9d 5d 8s] [4d]
*** SHOW DOWN ***
Wangritter13: shows [9c 9s] (three of a kind, Nines)
father here: shows [Kd Kc] (a pair of Kings)
Wangritter13 collected $29.93 from pot
father here cashed out the hand for $23.94 | Cash Out Fee $0.24
*** SUMMARY ***
Total pot $31.34 | Rake $1.41 
Board [Qh 9d 5d 8s 4d]
Seat 1: alfaomegabet folded before Flop (didn't bet)
Seat 2: father here showed [Kd Kc] and lost with a pair of Kings (cashed out).
Seat 3: Al7uut (button) folded before Flop (didn't bet)
Seat 4: Wangritter13 (small blind) showed [9c 9s] and won ($29.93) with three of a kind, Nines
Seat 5: VanCleef322 (big blind) folded before Flop
Seat 6: chris.nomf folded before Flop



PokerStars Hand #222982590068:  Hold'em No Limit ($0.05/$0.10 USD) - 2021/01/23 21:09:30 ET
Table 'Merope IV' 6-max Seat #4 is the button
Seat 1: alfaomegabet ($11.47 in chips) 
Seat 2: father here ($25.75 in chips) 
Seat 4: Wangritter13 ($29.93 in chips) 
Seat 5: VanCleef322 ($10.03 in chips) 
VanCleef322: posts small blind $0.05
chris.nomf: is sitting out 
alfaomegabet: posts big blind $0.10
*** HOLE CARDS ***
father here: folds 
Wangritter13: folds 
VanCleef322: raises $0.15 to $0.25
alfaomegabet: calls $0.15
*** FLOP *** [Ac Qd 8d]
VanCleef322: bets $0.20
alfaomegabet: folds 
Uncalled bet ($0.20) returned to VanCleef322
VanCleef322 collected $0.48 from pot
VanCleef322: doesn't show hand 
*** SUMMARY ***
Total pot $0.50 | Rake $0.02 
Board [Ac Qd 8d]
Seat 1: alfaomegabet (big blind) folded on the Flop
Seat 2: father here folded before Flop (didn't bet)
Seat 4: Wangritter13 (button) folded before Flop (didn't bet)
Seat 5: VanCleef322 (small blind) collected ($0.48)



PokerStars Hand #222982599696:  Hold'em No Limit ($0.05/$0.10 USD) - 2021/01/23 21:09:53 ET
Table 'Merope IV' 6-max Seat #5 is the button
Seat 1: alfaomegabet ($11.22 in chips) 
Seat 2: father here ($25.75 in chips) 
Seat 4: Wangritter13 ($29.93 in chips) 
Seat 5: VanCleef322 ($10.26 in chips) 
alfaomegabet: posts small blind $0.05
father here: posts big blind $0.10
*** HOLE CARDS ***
Wangritter13: folds 
VanCleef322: folds 
alfaomegabet: raises $0.20 to $0.30
father here: raises $0.60 to $0.90
alfaomegabet: folds 
Uncalled bet ($0.60) returned to father here
father here collected $0.60 from pot
*** SUMMARY ***
Total pot $0.60 | Rake $0 
Seat 1: alfaomegabet (small blind) folded before Flop
Seat 2: father here (big blind) collected ($0.60)
Seat 4: Wangritter13 folded before Flop (didn't bet)
Seat 5: VanCleef322 (button) folded before Flop (didn't bet)



PokerStars Hand #222982607887:  Hold'em No Limit ($0.05/$0.10 USD) - 2021/01/23 21:10:13 ET
Table 'Merope IV' 6-max Seat #1 is the button
Seat 1: alfaomegabet ($10.92 in chips) 
Seat 2: father here ($26.05 in chips) 
Seat 4: Wangritter13 ($29.93 in chips) 
Seat 5: VanCleef322 ($10.26 in chips) 
father here: posts small blind $0.05
Wangritter13: posts big blind $0.10
*** HOLE CARDS ***
VanCleef322: folds 
alfaomegabet: raises $0.20 to $0.30
father here: calls $0.25
Wangritter13: calls $0.20
*** FLOP *** [Jc 3h Ah]
father here: checks 
Wangritter13: checks 
alfaomegabet: bets $0.44
father here: folds 
Wangritter13: folds 
Uncalled bet ($0.44) returned to alfaomegabet
alfaomegabet collected $0.86 from pot
alfaomegabet: doesn't show hand 
*** SUMMARY ***
Total pot $0.90 | Rake $0.04 
Board [Jc 3h Ah]
Seat 1: alfaomegabet (button) collected ($0.86)
Seat 2: father here (small blind) folded on the Flop
Seat 4: Wangritter13 (big blind) folded on the Flop
Seat 5: VanCleef322 folded before Flop (didn't bet)



PokerStars Hand #222982624232:  Hold'em No Limit ($0.05/$0.10 USD) - 2021/01/23 21:10:52 ET
Table 'Merope IV' 6-max Seat #2 is the button
Seat 1: alfaomegabet ($11.48 in chips) 
Seat 2: father here ($25.75 in chips) 
Seat 4: Wangritter13 ($29.63 in chips) 
Wangritter13: posts small blind $0.05
VanCleef322: is sitting out 
VanCleef322 leaves the table
alfaomegabet: posts big blind $0.10
*** HOLE CARDS ***
father here: folds 
Wangritter13: raises $0.20 to $0.30
sportivu13 joins the table at seat #5 
alfaomegabet: folds 
Uncalled bet ($0.20) returned to Wangritter13
Wangritter13 collected $0.20 from pot
Wangritter13: doesn't show hand 
*** SUMMARY ***
Total pot $0.20 | Rake $0 
Seat 1: alfaomegabet (big blind) folded before Flop
Seat 2: father here (button) folded before Flop (didn't bet)
Seat 4: Wangritter13 (small blind) collected ($0.20)



PokerStars Hand #222982630151:  Hold'em No Limit ($0.05/$0.10 USD) - 2021/01/23 21:11:06 ET
Table 'Merope IV' 6-max Seat #4 is the button
Seat 1: alfaomegabet ($11.38 in chips) 
Seat 2: father here ($25.75 in chips) 
Seat 4: Wangritter13 ($29.73 in chips) 
alfaomegabet: posts small blind $0.05
father here: posts big blind $0.10
*** HOLE CARDS ***
Wangritter13: folds 
alfaomegabet: raises $0.20 to $0.30
father here: folds 
Uncalled bet ($0.20) returned to alfaomegabet
alfaomegabet collected $0.20 from pot
alfaomegabet: doesn't show hand 
*** SUMMARY ***
Total pot $0.20 | Rake $0 
Seat 1: alfaomegabet (small blind) collected ($0.20)
Seat 2: father here (big blind) folded before Flop
Seat 4: Wangritter13 (button) folded before Flop (didn't bet)



PokerStars Hand #222982634356:  Hold'em No Limit ($0.05/$0.10 USD) - 2021/01/23 21:11:17 ET
Table 'Merope IV' 6-max Seat #1 is the button
Seat 1: alfaomegabet ($11.48 in chips) 
Seat 2: father here ($25.65 in chips) 
Seat 4: Wangritter13 ($29.73 in chips) 
father here: posts small blind $0.05
Wangritter13: posts big blind $0.10
sportivu13: sits out 
*** HOLE CARDS ***
alfaomegabet: folds 
father here: folds 
Uncalled bet ($0.05) returned to Wangritter13
Wangritter13 collected $0.10 from pot
Wangritter13: doesn't show hand 
*** SUMMARY ***
Total pot $0.10 | Rake $0 
Seat 1: alfaomegabet (button) folded before Flop (didn't bet)
Seat 2: father here (small blind) folded before Flop
Seat 4: Wangritter13 (big blind) collected ($0.10)



PokerStars Hand #222982638303:  Hold'em No Limit ($0.05/$0.10 USD) - 2021/01/23 21:11:26 ET
Table 'Merope IV' 6-max Seat #2 is the button
Seat 1: alfaomegabet ($11.48 in chips) 
Seat 2: father here ($25.60 in chips) 
Seat 4: Wangritter13 ($29.78 in chips) 
Seat 5: sportivu13 ($10 in chips) 
Wangritter13: posts small blind $0.05
sportivu13: posts big blind $0.10
*** HOLE CARDS ***
alfaomegabet: folds 
father here: folds 
Wangritter13: folds 
Uncalled bet ($0.05) returned to sportivu13
sportivu13 collected $0.10 from pot
*** SUMMARY ***
Total pot $0.10 | Rake $0 
Seat 1: alfaomegabet folded before Flop (didn't bet)
Seat 2: father here (button) folded before Flop (didn't bet)
Seat 4: Wangritter13 (small blind) folded before Flop
Seat 5: sportivu13 (big blind) collected ($0.10)



PokerStars Hand #222982641774:  Hold'em No Limit ($0.05/$0.10 USD) - 2021/01/23 21:11:35 ET
Table 'Merope IV' 6-max Seat #4 is the button
Seat 1: alfaomegabet ($11.48 in chips) 
Seat 2: father here ($25.60 in chips) 
Seat 4: Wangritter13 ($29.73 in chips) 
Seat 5: sportivu13 ($10.05 in chips) 
sportivu13: posts small blind $0.05
alfaomegabet: posts big blind $0.10
*** HOLE CARDS ***
father here: folds 
Wangritter13: folds 
sportivu13: folds 
Uncalled bet ($0.05) returned to alfaomegabet
alfaomegabet collected $0.10 from pot
alfaomegabet: doesn't show hand 
*** SUMMARY ***
Total pot $0.10 | Rake $0 
Seat 1: alfaomegabet (big blind) collected ($0.10)
Seat 2: father here folded before Flop (didn't bet)
Seat 4: Wangritter13 (button) folded before Flop (didn't bet)
Seat 5: sportivu13 (small blind) folded before Flop



PokerStars Hand #222982644239:  Hold'em No Limit ($0.05/$0.10 USD) - 2021/01/23 21:11:40 ET
Table 'Merope IV' 6-max Seat #5 is the button
Seat 1: alfaomegabet ($11.53 in chips) 
Seat 2: father here ($25.60 in chips) 
Seat 4: Wangritter13 ($29.73 in chips) 
Seat 5: sportivu13 ($10 in chips) 
alfaomegabet: posts small blind $0.05
father here: posts big blind $0.10
*** HOLE CARDS ***
Wangritter13: calls $0.10
sportivu13: raises $0.30 to $0.40
alfaomegabet: folds 
father here: folds 
Wangritter13: folds 
Uncalled bet ($0.30) returned to sportivu13
sportivu13 collected $0.35 from pot
*** SUMMARY ***
Total pot $0.35 | Rake $0 
Seat 1: alfaomegabet (small blind) folded before Flop
Seat 2: father here (big blind) folded before Flop
Seat 4: Wangritter13 folded before Flop
Seat 5: sportivu13 (button) collected ($0.35)



PokerStars Hand #222982662955:  Hold'em No Limit ($0.05/$0.10 USD) - 2021/01/23 21:12:16 ET
Table 'Merope IV' 6-max Seat #1 is the button
Seat 1: alfaomegabet ($11.48 in chips) 
Seat 2: father here ($25.50 in chips) 
Seat 4: Wangritter13 ($29.63 in chips) 
Seat 5: sportivu13 ($10.25 in chips) 
father here: posts small blind $0.05
Wangritter13: posts big blind $0.10
*** HOLE CARDS ***
sportivu13: folds 
alfaomegabet: folds 
father here: folds 
Uncalled bet ($0.05) returned to Wangritter13
Wangritter13 collected $0.10 from pot
Wangritter13: doesn't show hand 
*** SUMMARY ***
Total pot $0.10 | Rake $0 
Seat 1: alfaomegabet (button) folded before Flop (didn't bet)
Seat 2: father here (small blind) folded before Flop
Seat 4: Wangritter13 (big blind) collected ($0.10)
Seat 5: sportivu13 folded before Flop (didn't bet)



PokerStars Hand #222982666513:  Hold'em No Limit ($0.05/$0.10 USD) - 2021/01/23 21:12:24 ET
Table 'Merope IV' 6-max Seat #2 is the button
Seat 1: alfaomegabet ($11.48 in chips) 
Seat 2: father here ($25.45 in chips) 
Seat 4: Wangritter13 ($29.68 in chips) 
Seat 5: sportivu13 ($10.25 in chips) 
Wangritter13: posts small blind $0.05
sportivu13: posts big blind $0.10
*** HOLE CARDS ***
alfaomegabet: folds 
father here: folds 
Wangritter13: folds 
Uncalled bet ($0.05) returned to sportivu13
sportivu13 collected $0.10 from pot
*** SUMMARY ***
Total pot $0.10 | Rake $0 
Seat 1: alfaomegabet folded before Flop (didn't bet)
Seat 2: father here (button) folded before Flop (didn't bet)
Seat 4: Wangritter13 (small blind) folded before Flop
Seat 5: sportivu13 (big blind) collected ($0.10)



PokerStars Hand #222983451532:  Hold'em No Limit ($0.05/$0.10 USD) - 2021/01/23 21:44:05 ET
Table 'Merope IV' 6-max Seat #5 is the button
Seat 1: 0nix770 ($10.36 in chips) 
Seat 2: A Gaf A ($11.38 in chips) 
Seat 3: Maxfulltrick ($10 in chips) 
Seat 4: GGR817 ($17.26 in chips) 
Seat 5: Driverofpoker ($6.75 in chips) 
0nix770: posts small blind $0.05
A Gaf A: posts big blind $0.10
*** HOLE CARDS ***
Maxfulltrick: folds 
GGR817: folds 
Driverofpoker: calls $0.10
0nix770: raises $0.30 to $0.40
A Gaf A: folds 
Driverofpoker: calls $0.30
*** FLOP *** [2c 5c 9d]
0nix770: checks 
Driverofpoker: bets $0.10
0nix770: calls $0.10
*** TURN *** [2c 5c 9d] [Kc]
Eddu_H6514 joins the table at seat #6 
0nix770: checks 
Driverofpoker: bets $0.10
0nix770: raises $0.60 to $0.70
Driverofpoker: raises $0.60 to $1.30
0nix770: calls $0.60
*** RIVER *** [2c 5c 9d Kc] [3c]
0nix770: checks 
Driverofpoker: bets $4.95 and is all-in
0nix770: calls $4.95
*** SHOW DOWN ***
Driverofpoker: shows [5d 5s] (three of a kind, Fives)
0nix770: shows [Qc Kh] (a flush, King high)
0nix770 collected $12.99 from pot
*** SUMMARY ***
Total pot $13.60 | Rake $0.61 
Board [2c 5c 9d Kc 3c]
Seat 1: 0nix770 (small blind) showed [Qc Kh] and won ($12.99) with a flush, King high
Seat 2: A Gaf A (big blind) folded before Flop
Seat 3: Maxfulltrick folded before Flop (didn't bet)
Seat 4: GGR817 folded before Flop (didn't bet)
Seat 5: Driverofpoker (button) showed [5d 5s] and lost with three of a kind, Fives



PokerStars Hand #222983467931:  Hold'em No Limit ($0.05/$0.10 USD) - 2021/01/23 21:44:48 ET
Table 'Merope IV' 6-max Seat #1 is the button
Seat 1: 0nix770 ($16.60 in chips) 
Seat 2: A Gaf A ($11.28 in chips) 
Seat 3: Maxfulltrick ($10 in chips) 
Seat 4: GGR817 ($17.26 in chips) 
A Gaf A: posts small blind $0.05
Maxfulltrick: posts big blind $0.10
Eddu_H6514: sits out 
*** HOLE CARDS ***
GGR817: folds 
0nix770: folds 
A Gaf A: raises $0.20 to $0.30
Maxfulltrick: folds 
Uncalled bet ($0.20) returned to A Gaf A
A Gaf A collected $0.20 from pot
A Gaf A: doesn't show hand 
*** SUMMARY ***
Total pot $0.20 | Rake $0 
Seat 1: 0nix770 (button) folded before Flop (didn't bet)
Seat 2: A Gaf A (small blind) collected ($0.20)
Seat 3: Maxfulltrick (big blind) folded before Flop
Seat 4: GGR817 folded before Flop (didn't bet)



PokerStars Hand #222983473088:  Hold'em No Limit ($0.05/$0.10 USD) - 2021/01/23 21:45:01 ET
Table 'Merope IV' 6-max Seat #2 is the button
Seat 1: 0nix770 ($16.60 in chips) 
Seat 2: A Gaf A ($11.38 in chips) 
Seat 3: Maxfulltrick ($10 in chips) 
Seat 4: GGR817 ($17.26 in chips) 
Maxfulltrick: posts small blind $0.05
GGR817: posts big blind $0.10
Driverofpoker leaves the table
Eddu_H6514: sits out 
*** HOLE CARDS ***
0nix770: raises $0.15 to $0.25
A Gaf A: folds 
A Gaf A leaves the table
Maxfulltrick: folds 
GGR817: folds 
Uncalled bet ($0.15) returned to 0nix770
0nix770 collected $0.25 from pot
0nix770: doesn't show hand 
*** SUMMARY ***
Total pot $0.25 | Rake $0 
Seat 1: 0nix770 collected ($0.25)
Seat 2: A Gaf A (button) folded before Flop (didn't bet)
Seat 3: Maxfulltrick (small blind) folded before Flop
Seat 4: GGR817 (big blind) folded before Flop



PokerStars Hand #222983480542:  Hold'em No Limit ($0.05/$0.10 USD) - 2021/01/23 21:45:20 ET
Table 'Merope IV' 6-max Seat #3 is the button
Seat 1: 0nix770 ($16.75 in chips) 
Seat 3: Maxfulltrick ($10 in chips) 
Seat 4: GGR817 ($17.16 in chips) 
Seat 6: Eddu_H6514 ($10 in chips) 
GGR817: posts small blind $0.05
Eddu_H6514: posts big blind $0.10
*** HOLE CARDS ***
0nix770: raises $0.15 to $0.25
Maxfulltrick: folds 
GGR817: folds 
Eddu_H6514: folds 
Uncalled bet ($0.15) returned to 0nix770
0nix770 collected $0.25 from pot
0nix770: doesn't show hand 
*** SUMMARY ***
Total pot $0.25 | Rake $0 
Seat 1: 0nix770 collected ($0.25)
Seat 3: Maxfulltrick (button) folded before Flop (didn't bet)
Seat 4: GGR817 (small blind) folded before Flop
Seat 6: Eddu_H6514 (big blind) folded before Flop



PokerStars Hand #222983486149:  Hold'em No Limit ($0.05/$0.10 USD) - 2021/01/23 21:45:34 ET
Table 'Merope IV' 6-max Seat #4 is the button
Seat 3: Maxfulltrick ($10 in chips) 
Seat 4: GGR817 ($17.11 in chips) 
Seat 6: Eddu_H6514 ($10 in chips) 
Eddu_H6514: posts small blind $0.05
0nix770: is sitting out 
0nix770 leaves the table
Maxfulltrick: posts big blind $0.10
*** HOLE CARDS ***
GGR817: folds 
Eddu_H6514: folds 
Uncalled bet ($0.05) returned to Maxfulltrick
Maxfulltrick collected $0.10 from pot
*** SUMMARY ***
Total pot $0.10 | Rake $0 
Seat 3: Maxfulltrick (big blind) collected ($0.10)
Seat 4: GGR817 (button) folded before Flop (didn't bet)
Seat 6: Eddu_H6514 (small blind) folded before Flop



PokerStars Hand #222983492297:  Hold'em No Limit ($0.05/$0.10 USD) - 2021/01/23 21:45:50 ET
Table 'Merope IV' 6-max Seat #6 is the button
Seat 3: Maxfulltrick ($10.05 in chips) 
Seat 4: GGR817 ($17.11 in chips) 
Seat 6: Eddu_H6514 ($10 in chips) 
Maxfulltrick: posts small blind $0.05
GGR817: posts big blind $0.10
*** HOLE CARDS ***
Eddu_H6514: folds 
Eddu_H6514 leaves the table
Maxfulltrick: folds 
Uncalled bet ($0.05) returned to GGR817
GGR817 collected $0.10 from pot
GGR817: doesn't show hand 
*** SUMMARY ***
Total pot $0.10 | Rake $0 
Seat 3: Maxfulltrick (small blind) folded before Flop
Seat 4: GGR817 (big blind) collected ($0.10)
Seat 6: Eddu_H6514 (button) folded before Flop (didn't bet)



PokerStars Hand #222983498811:  Hold'em No Limit ($0.05/$0.10 USD) - 2021/01/23 21:46:07 ET
Table 'Merope IV' 6-max Seat #4 is the button
Seat 3: Maxfulltrick ($10 in chips) 
Seat 4: GGR817 ($17.16 in chips) 
GGR817: posts small blind $0.05
Maxfulltrick: posts big blind $0.10
*** HOLE CARDS ***
GGR817: folds 
Uncalled bet ($0.05) returned to Maxfulltrick
Maxfulltrick collected $0.10 from pot
*** SUMMARY ***
Total pot $0.10 | Rake $0 
Seat 3: Maxfulltrick (big blind) collected ($0.10)
Seat 4: GGR817 (button) (small blind) folded before Flop



PokerStars Hand #222983500812:  Hold'em No Limit ($0.05/$0.10 USD) - 2021/01/23 21:46:12 ET
Table 'Merope IV' 6-max Seat #3 is the button
Seat 3: Maxfulltrick ($10.05 in chips) 
Seat 4: GGR817 ($17.11 in chips) 
Maxfulltrick: posts small blind $0.05
GGR817: posts big blind $0.10
*** HOLE CARDS ***
Maxfulltrick: folds 
Uncalled bet ($0.05) returned to GGR817
GGR817 collected $0.10 from pot
GGR817: doesn't show hand 
*** SUMMARY ***
Total pot $0.10 | Rake $0 
Seat 3: Maxfulltrick (button) (small blind) folded before Flop
Seat 4: GGR817 (big blind) collected ($0.10)



