PokerStars Hand #222968697104:  Hold'em No Limit ($0.05/$0.10 USD) - 2021/01/23 15:17:15 ET
Table 'Demoulina III' 6-max Seat #5 is the button
Seat 1: BazKaLT ($10 in chips) 
Seat 2: odvamp ($11.53 in chips) 
Seat 3: JamesKinder ($10.30 in chips) 
Seat 4: VIOLET 1998 ($9.25 in chips) 
Seat 5: vilemo20 ($10 in chips) 
Seat 6: quags30 ($15.34 in chips) 
quags30: posts small blind $0.05
BazKaLT: posts big blind $0.10
*** HOLE CARDS ***
odvamp: folds 
JamesKinder: raises $0.20 to $0.30
VIOLET 1998: folds 
vilemo20: folds 
quags30: raises $0.70 to $1
BazKaLT: folds 
JamesKinder: calls $0.70
*** FLOP *** [9d Kd Ks]
quags30: bets $1
JamesKinder: raises $1.50 to $2.50
quags30: calls $1.50
*** TURN *** [9d Kd Ks] [5c]
quags30: checks 
JamesKinder: bets $3.53
quags30: folds 
Uncalled bet ($3.53) returned to JamesKinder
JamesKinder collected $6.78 from pot
JamesKinder: doesn't show hand 
*** SUMMARY ***
Total pot $7.10 | Rake $0.32 
Board [9d Kd Ks 5c]
Seat 1: BazKaLT (big blind) folded before Flop
Seat 2: odvamp folded before Flop (didn't bet)
Seat 3: JamesKinder collected ($6.78)
Seat 4: VIOLET 1998 folded before Flop (didn't bet)
Seat 5: vilemo20 (button) folded before Flop (didn't bet)
Seat 6: quags30 (small blind) folded on the Turn



PokerStars Hand #222968757383:  Hold'em No Limit ($0.05/$0.10 USD) - 2021/01/23 15:18:25 ET
Table 'Demoulina III' 6-max Seat #6 is the button
Seat 1: BazKaLT ($10 in chips) 
Seat 2: odvamp ($11.53 in chips) 
Seat 3: JamesKinder ($13.58 in chips) 
Seat 4: VIOLET 1998 ($9.25 in chips) 
Seat 5: vilemo20 ($10 in chips) 
Seat 6: quags30 ($11.84 in chips) 
BazKaLT: posts small blind $0.05
odvamp: posts big blind $0.10
*** HOLE CARDS ***
JamesKinder: folds 
VIOLET 1998: raises $0.25 to $0.35
vilemo20: folds 
quags30: calls $0.35
BazKaLT: folds 
odvamp: raises $1.15 to $1.50
VIOLET 1998: calls $1.15
quags30: calls $1.15
*** FLOP *** [3d 7d 8h]
odvamp: bets $3
VIOLET 1998: folds 
quags30: folds 
Uncalled bet ($3) returned to odvamp
odvamp collected $4.35 from pot
odvamp: doesn't show hand 
*** SUMMARY ***
Total pot $4.55 | Rake $0.20 
Board [3d 7d 8h]
Seat 1: BazKaLT (small blind) folded before Flop
Seat 2: odvamp (big blind) collected ($4.35)
Seat 3: JamesKinder folded before Flop (didn't bet)
Seat 4: VIOLET 1998 folded on the Flop
Seat 5: vilemo20 folded before Flop (didn't bet)
Seat 6: quags30 (button) folded on the Flop



PokerStars Hand #222968791223:  Hold'em No Limit ($0.05/$0.10 USD) - 2021/01/23 15:19:05 ET
Table 'Demoulina III' 6-max Seat #1 is the button
Seat 1: BazKaLT ($10 in chips) 
Seat 2: odvamp ($14.38 in chips) 
Seat 3: JamesKinder ($13.58 in chips) 
Seat 4: VIOLET 1998 ($7.75 in chips) 
Seat 5: vilemo20 ($10 in chips) 
Seat 6: quags30 ($10.34 in chips) 
odvamp: posts small blind $0.05
JamesKinder: posts big blind $0.10
*** HOLE CARDS ***
VIOLET 1998: calls $0.10
vilemo20: folds 
quags30: folds 
BazKaLT: folds 
odvamp: folds 
JamesKinder: checks 
*** FLOP *** [Th Ts 9h]
JamesKinder: checks 
VIOLET 1998: bets $0.24
JamesKinder: calls $0.24
*** TURN *** [Th Ts 9h] [8d]
JamesKinder: checks 
VIOLET 1998: bets $0.90
JamesKinder: calls $0.90
*** RIVER *** [Th Ts 9h 8d] [9c]
JamesKinder: checks 
VIOLET 1998: checks 
*** SHOW DOWN ***
JamesKinder: shows [8h Jc] (two pair, Tens and Nines)
VIOLET 1998: shows [7h 6h] (a straight, Six to Ten)
VIOLET 1998 collected $2.42 from pot
*** SUMMARY ***
Total pot $2.53 | Rake $0.11 
Board [Th Ts 9h 8d 9c]
Seat 1: BazKaLT (button) folded before Flop (didn't bet)
Seat 2: odvamp (small blind) folded before Flop
Seat 3: JamesKinder (big blind) showed [8h Jc] and lost with two pair, Tens and Nines
Seat 4: VIOLET 1998 showed [7h 6h] and won ($2.42) with a straight, Six to Ten
Seat 5: vilemo20 folded before Flop (didn't bet)
Seat 6: quags30 folded before Flop (didn't bet)



PokerStars Hand #222968828954:  Hold'em No Limit ($0.05/$0.10 USD) - 2021/01/23 15:19:49 ET
Table 'Demoulina III' 6-max Seat #2 is the button
Seat 1: BazKaLT ($10 in chips) 
Seat 2: odvamp ($14.33 in chips) 
Seat 3: JamesKinder ($12.34 in chips) 
Seat 4: VIOLET 1998 ($8.93 in chips) 
Seat 5: vilemo20 ($10 in chips) 
JamesKinder: posts small blind $0.05
VIOLET 1998: posts big blind $0.10
*** HOLE CARDS ***
vilemo20: raises $0.20 to $0.30
BazKaLT: folds 
odvamp: folds 
JamesKinder: calls $0.25
VIOLET 1998: calls $0.20
*** FLOP *** [7h 8s 9d]
JamesKinder: bets $0.45
VIOLET 1998: calls $0.45
vilemo20: folds 
*** TURN *** [7h 8s 9d] [2d]
JamesKinder: bets $0.89
VIOLET 1998: calls $0.89
*** RIVER *** [7h 8s 9d 2d] [5d]
JamesKinder: checks 
VIOLET 1998: bets $1.71
JamesKinder: folds 
Uncalled bet ($1.71) returned to VIOLET 1998
VIOLET 1998 collected $3.42 from pot
VIOLET 1998: doesn't show hand 
*** SUMMARY ***
Total pot $3.58 | Rake $0.16 
Board [7h 8s 9d 2d 5d]
Seat 1: BazKaLT folded before Flop (didn't bet)
Seat 2: odvamp (button) folded before Flop (didn't bet)
Seat 3: JamesKinder (small blind) folded on the River
Seat 4: VIOLET 1998 (big blind) collected ($3.42)
Seat 5: vilemo20 folded on the Flop



PokerStars Hand #222968879927:  Hold'em No Limit ($0.05/$0.10 USD) - 2021/01/23 15:20:49 ET
Table 'Demoulina III' 6-max Seat #3 is the button
Seat 1: BazKaLT ($10 in chips) 
Seat 2: odvamp ($14.33 in chips) 
Seat 3: JamesKinder ($10.70 in chips) 
Seat 4: VIOLET 1998 ($10.71 in chips) 
Seat 5: vilemo20 ($10 in chips) 
VIOLET 1998: posts small blind $0.05
vilemo20: posts big blind $0.10
*** HOLE CARDS ***
BazKaLT: folds 
odvamp: folds 
JamesKinder: raises $0.20 to $0.30
VIOLET 1998: folds 
vilemo20: folds 
Uncalled bet ($0.20) returned to JamesKinder
JamesKinder collected $0.25 from pot
JamesKinder: doesn't show hand 
*** SUMMARY ***
Total pot $0.25 | Rake $0 
Seat 1: BazKaLT folded before Flop (didn't bet)
Seat 2: odvamp folded before Flop (didn't bet)
Seat 3: JamesKinder (button) collected ($0.25)
Seat 4: VIOLET 1998 (small blind) folded before Flop
Seat 5: vilemo20 (big blind) folded before Flop



PokerStars Hand #222968894769:  Hold'em No Limit ($0.05/$0.10 USD) - 2021/01/23 15:21:06 ET
Table 'Demoulina III' 6-max Seat #4 is the button
Seat 1: BazKaLT ($10 in chips) 
Seat 2: odvamp ($14.33 in chips) 
Seat 3: JamesKinder ($10.85 in chips) 
Seat 4: VIOLET 1998 ($10.66 in chips) 
Seat 5: vilemo20 ($10 in chips) 
vilemo20: posts small blind $0.05
BazKaLT: posts big blind $0.10
*** HOLE CARDS ***
odvamp: folds 
JamesKinder: folds 
VIOLET 1998: raises $0.25 to $0.35
vilemo20: folds 
BazKaLT: folds 
Uncalled bet ($0.25) returned to VIOLET 1998
VIOLET 1998 collected $0.25 from pot
VIOLET 1998: doesn't show hand 
*** SUMMARY ***
Total pot $0.25 | Rake $0 
Seat 1: BazKaLT (big blind) folded before Flop
Seat 2: odvamp folded before Flop (didn't bet)
Seat 3: JamesKinder folded before Flop (didn't bet)
Seat 4: VIOLET 1998 (button) collected ($0.25)
Seat 5: vilemo20 (small blind) folded before Flop



PokerStars Hand #222968903514:  Hold'em No Limit ($0.05/$0.10 USD) - 2021/01/23 15:21:16 ET
Table 'Demoulina III' 6-max Seat #5 is the button
Seat 1: BazKaLT ($10 in chips) 
Seat 2: odvamp ($14.33 in chips) 
Seat 3: JamesKinder ($10.85 in chips) 
Seat 4: VIOLET 1998 ($10.81 in chips) 
Seat 5: vilemo20 ($10 in chips) 
BazKaLT: posts small blind $0.05
odvamp: posts big blind $0.10
*** HOLE CARDS ***
JamesKinder: raises $0.20 to $0.30
VIOLET 1998: calls $0.30
vilemo20: folds 
BazKaLT: folds 
odvamp: folds 
*** FLOP *** [3s Kd 9d]
JamesKinder: checks 
VIOLET 1998: bets $0.72
JamesKinder: raises $0.98 to $1.70
VIOLET 1998: calls $0.98
*** TURN *** [3s Kd 9d] [Ks]
JamesKinder: checks 
VIOLET 1998: bets $1.98
JamesKinder: folds 
Uncalled bet ($1.98) returned to VIOLET 1998
VIOLET 1998 collected $3.96 from pot
VIOLET 1998: doesn't show hand 
*** SUMMARY ***
Total pot $4.15 | Rake $0.19 
Board [3s Kd 9d Ks]
Seat 1: BazKaLT (small blind) folded before Flop
Seat 2: odvamp (big blind) folded before Flop
Seat 3: JamesKinder folded on the Turn
Seat 4: VIOLET 1998 collected ($3.96)
Seat 5: vilemo20 (button) folded before Flop (didn't bet)



PokerStars Hand #222968929826:  Hold'em No Limit ($0.05/$0.10 USD) - 2021/01/23 15:21:46 ET
Table 'Demoulina III' 6-max Seat #1 is the button
Seat 1: BazKaLT ($10 in chips) 
Seat 2: odvamp ($14.23 in chips) 
Seat 3: JamesKinder ($8.85 in chips) 
Seat 4: VIOLET 1998 ($12.77 in chips) 
Seat 5: vilemo20 ($10 in chips) 
odvamp: posts small blind $0.05
JamesKinder: posts big blind $0.10
*** HOLE CARDS ***
VIOLET 1998: folds 
vilemo20: folds 
BazKaLT: folds 
odvamp: raises $0.20 to $0.30
JamesKinder: calls $0.20
*** FLOP *** [6h Tc 4d]
odvamp: checks 
JamesKinder: checks 
*** TURN *** [6h Tc 4d] [Ac]
odvamp: bets $0.30
JamesKinder: folds 
Uncalled bet ($0.30) returned to odvamp
odvamp collected $0.57 from pot
odvamp: doesn't show hand 
*** SUMMARY ***
Total pot $0.60 | Rake $0.03 
Board [6h Tc 4d Ac]
Seat 1: BazKaLT (button) folded before Flop (didn't bet)
Seat 2: odvamp (small blind) collected ($0.57)
Seat 3: JamesKinder (big blind) folded on the Turn
Seat 4: VIOLET 1998 folded before Flop (didn't bet)
Seat 5: vilemo20 folded before Flop (didn't bet)



PokerStars Hand #222968949711:  Hold'em No Limit ($0.05/$0.10 USD) - 2021/01/23 15:22:09 ET
Table 'Demoulina III' 6-max Seat #2 is the button
Seat 1: BazKaLT ($10 in chips) 
Seat 2: odvamp ($14.50 in chips) 
Seat 3: JamesKinder ($8.55 in chips) 
Seat 4: VIOLET 1998 ($12.77 in chips) 
Seat 5: vilemo20 ($10 in chips) 
JamesKinder: posts small blind $0.05
VIOLET 1998: posts big blind $0.10
*** HOLE CARDS ***
vilemo20: folds 
BazKaLT: folds 
odvamp: folds 
JamesKinder: raises $0.10 to $0.20
VIOLET 1998: calls $0.10
*** FLOP *** [9h 6h Kc]
JamesKinder: checks 
VIOLET 1998: checks 
*** TURN *** [9h 6h Kc] [Qh]
JamesKinder: bets $0.20
VIOLET 1998: folds 
Uncalled bet ($0.20) returned to JamesKinder
JamesKinder collected $0.38 from pot
JamesKinder: doesn't show hand 
*** SUMMARY ***
Total pot $0.40 | Rake $0.02 
Board [9h 6h Kc Qh]
Seat 1: BazKaLT folded before Flop (didn't bet)
Seat 2: odvamp (button) folded before Flop (didn't bet)
Seat 3: JamesKinder (small blind) collected ($0.38)
Seat 4: VIOLET 1998 (big blind) folded on the Turn
Seat 5: vilemo20 folded before Flop (didn't bet)



PokerStars Hand #222968968413:  Hold'em No Limit ($0.05/$0.10 USD) - 2021/01/23 15:22:31 ET
Table 'Demoulina III' 6-max Seat #3 is the button
Seat 1: BazKaLT ($10 in chips) 
Seat 2: odvamp ($14.50 in chips) 
Seat 3: JamesKinder ($8.73 in chips) 
Seat 4: VIOLET 1998 ($12.57 in chips) 
Seat 5: vilemo20 ($10 in chips) 
VIOLET 1998: posts small blind $0.05
vilemo20: posts big blind $0.10
*** HOLE CARDS ***
BazKaLT: folds 
odvamp: raises $0.20 to $0.30
JamesKinder: calls $0.30
VIOLET 1998: folds 
vilemo20: folds 
*** FLOP *** [8d 3c Js]
odvamp: bets $0.48
JamesKinder: raises $0.72 to $1.20
odvamp: calls $0.72
*** TURN *** [8d 3c Js] [Ts]
odvamp: bets $0.99
JamesKinder: calls $0.99
*** RIVER *** [8d 3c Js Ts] [4s]
odvamp: bets $1.65
JamesKinder: calls $1.65
*** SHOW DOWN ***
odvamp: shows [Kh Ks] (a pair of Kings)
JamesKinder: mucks hand 
odvamp collected $8.05 from pot
*** SUMMARY ***
Total pot $8.43 | Rake $0.38 
Board [8d 3c Js Ts 4s]
Seat 1: BazKaLT folded before Flop (didn't bet)
Seat 2: odvamp showed [Kh Ks] and won ($8.05) with a pair of Kings
Seat 3: JamesKinder (button) mucked
Seat 4: VIOLET 1998 (small blind) folded before Flop
Seat 5: vilemo20 (big blind) folded before Flop



PokerStars Hand #222968990895:  Hold'em No Limit ($0.05/$0.10 USD) - 2021/01/23 15:22:57 ET
Table 'Demoulina III' 6-max Seat #4 is the button
Seat 1: BazKaLT ($10 in chips) 
Seat 2: odvamp ($18.41 in chips) 
Seat 3: JamesKinder ($4.59 in chips) 
Seat 4: VIOLET 1998 ($12.52 in chips) 
Seat 5: vilemo20 ($10 in chips) 
vilemo20: posts small blind $0.05
BazKaLT: posts big blind $0.10
*** HOLE CARDS ***
odvamp: folds 
JamesKinder: folds 
VIOLET 1998: folds 
vilemo20: folds 
Uncalled bet ($0.05) returned to BazKaLT
BazKaLT collected $0.10 from pot
BazKaLT: doesn't show hand 
*** SUMMARY ***
Total pot $0.10 | Rake $0 
Seat 1: BazKaLT (big blind) collected ($0.10)
Seat 2: odvamp folded before Flop (didn't bet)
Seat 3: JamesKinder folded before Flop (didn't bet)
Seat 4: VIOLET 1998 (button) folded before Flop (didn't bet)
Seat 5: vilemo20 (small blind) folded before Flop



PokerStars Hand #222969000175:  Hold'em No Limit ($0.05/$0.10 USD) - 2021/01/23 15:23:07 ET
Table 'Demoulina III' 6-max Seat #5 is the button
Seat 1: BazKaLT ($10.05 in chips) 
Seat 2: odvamp ($18.41 in chips) 
Seat 3: JamesKinder ($4.59 in chips) 
Seat 4: VIOLET 1998 ($12.52 in chips) 
Seat 5: vilemo20 ($10 in chips) 
BazKaLT: posts small blind $0.05
odvamp: posts big blind $0.10
*** HOLE CARDS ***
JamesKinder: raises $0.20 to $0.30
VIOLET 1998: folds 
vilemo20: folds 
BazKaLT: folds 
odvamp: calls $0.20
*** FLOP *** [2d 7d Ks]
odvamp: checks 
JamesKinder: checks 
*** TURN *** [2d 7d Ks] [Ad]
odvamp: bets $0.30
JamesKinder: calls $0.30
*** RIVER *** [2d 7d Ks Ad] [5d]
odvamp: checks 
JamesKinder: bets $0.62
odvamp: folds 
Uncalled bet ($0.62) returned to JamesKinder
JamesKinder collected $1.19 from pot
JamesKinder: doesn't show hand 
*** SUMMARY ***
Total pot $1.25 | Rake $0.06 
Board [2d 7d Ks Ad 5d]
Seat 1: BazKaLT (small blind) folded before Flop
Seat 2: odvamp (big blind) folded on the River
Seat 3: JamesKinder collected ($1.19)
Seat 4: VIOLET 1998 folded before Flop (didn't bet)
Seat 5: vilemo20 (button) folded before Flop (didn't bet)



PokerStars Hand #222969021782:  Hold'em No Limit ($0.05/$0.10 USD) - 2021/01/23 15:23:33 ET
Table 'Demoulina III' 6-max Seat #1 is the button
Seat 1: BazKaLT ($10 in chips) 
Seat 2: odvamp ($17.81 in chips) 
Seat 3: JamesKinder ($5.18 in chips) 
Seat 4: VIOLET 1998 ($12.52 in chips) 
Seat 5: vilemo20 ($10 in chips) 
odvamp: posts small blind $0.05
JamesKinder: posts big blind $0.10
*** HOLE CARDS ***
VIOLET 1998: raises $0.25 to $0.35
vilemo20: folds 
BazKaLT: folds 
odvamp: calls $0.30
JamesKinder: folds 
*** FLOP *** [3d 4c Td]
odvamp: checks 
VIOLET 1998: bets $0.38
odvamp: calls $0.38
*** TURN *** [3d 4c Td] [Js]
odvamp: checks 
VIOLET 1998: bets $0.74
odvamp: folds 
Uncalled bet ($0.74) returned to VIOLET 1998
VIOLET 1998 collected $1.49 from pot
VIOLET 1998: doesn't show hand 
*** SUMMARY ***
Total pot $1.56 | Rake $0.07 
Board [3d 4c Td Js]
Seat 1: BazKaLT (button) folded before Flop (didn't bet)
Seat 2: odvamp (small blind) folded on the Turn
Seat 3: JamesKinder (big blind) folded before Flop
Seat 4: VIOLET 1998 collected ($1.49)
Seat 5: vilemo20 folded before Flop (didn't bet)



PokerStars Hand #222969044565:  Hold'em No Limit ($0.05/$0.10 USD) - 2021/01/23 15:23:59 ET
Table 'Demoulina III' 6-max Seat #2 is the button
Seat 1: BazKaLT ($10 in chips) 
Seat 2: odvamp ($17.08 in chips) 
Seat 3: JamesKinder ($5.08 in chips) 
Seat 4: VIOLET 1998 ($13.28 in chips) 
Seat 5: vilemo20 ($10 in chips) 
JamesKinder: posts small blind $0.05
VIOLET 1998: posts big blind $0.10
*** HOLE CARDS ***
vilemo20: folds 
BazKaLT: folds 
odvamp: folds 
JamesKinder: folds 
Uncalled bet ($0.05) returned to VIOLET 1998
VIOLET 1998 collected $0.10 from pot
VIOLET 1998: doesn't show hand 
*** SUMMARY ***
Total pot $0.10 | Rake $0 
Seat 1: BazKaLT folded before Flop (didn't bet)
Seat 2: odvamp (button) folded before Flop (didn't bet)
Seat 3: JamesKinder (small blind) folded before Flop
Seat 4: VIOLET 1998 (big blind) collected ($0.10)
Seat 5: vilemo20 folded before Flop (didn't bet)



PokerStars Hand #222969056779:  Hold'em No Limit ($0.05/$0.10 USD) - 2021/01/23 15:24:13 ET
Table 'Demoulina III' 6-max Seat #3 is the button
Seat 1: BazKaLT ($10 in chips) 
Seat 2: odvamp ($17.08 in chips) 
Seat 3: JamesKinder ($5.03 in chips) 
Seat 4: VIOLET 1998 ($13.33 in chips) 
Seat 5: vilemo20 ($10 in chips) 
VIOLET 1998: posts small blind $0.05
vilemo20: posts big blind $0.10
*** HOLE CARDS ***
BazKaLT: folds 
odvamp: folds 
JamesKinder: raises $0.20 to $0.30
VIOLET 1998: calls $0.25
vilemo20: folds 
*** FLOP *** [6h Kd Ah]
VIOLET 1998: checks 
JamesKinder: bets $0.20
VIOLET 1998: calls $0.20
*** TURN *** [6h Kd Ah] [8s]
VIOLET 1998: checks 
JamesKinder: bets $0.55
VIOLET 1998: calls $0.55
*** RIVER *** [6h Kd Ah 8s] [7c]
VIOLET 1998: checks 
JamesKinder: bets $1.58
VIOLET 1998: folds 
Uncalled bet ($1.58) returned to JamesKinder
JamesKinder collected $2.10 from pot
JamesKinder: doesn't show hand 
*** SUMMARY ***
Total pot $2.20 | Rake $0.10 
Board [6h Kd Ah 8s 7c]
Seat 1: BazKaLT folded before Flop (didn't bet)
Seat 2: odvamp folded before Flop (didn't bet)
Seat 3: JamesKinder (button) collected ($2.10)
Seat 4: VIOLET 1998 (small blind) folded on the River
Seat 5: vilemo20 (big blind) folded before Flop



PokerStars Hand #222969100155:  Hold'em No Limit ($0.05/$0.10 USD) - 2021/01/23 15:25:04 ET
Table 'Demoulina III' 6-max Seat #4 is the button
Seat 1: BazKaLT ($10 in chips) 
Seat 2: odvamp ($17.08 in chips) 
Seat 3: JamesKinder ($6.08 in chips) 
Seat 4: VIOLET 1998 ($12.28 in chips) 
Seat 5: vilemo20 ($10 in chips) 
vilemo20: posts small blind $0.05
BazKaLT: posts big blind $0.10
*** HOLE CARDS ***
odvamp: folds 
JamesKinder: folds 
VIOLET 1998: folds 
vilemo20: folds 
Uncalled bet ($0.05) returned to BazKaLT
BazKaLT collected $0.10 from pot
BazKaLT: doesn't show hand 
*** SUMMARY ***
Total pot $0.10 | Rake $0 
Seat 1: BazKaLT (big blind) collected ($0.10)
Seat 2: odvamp folded before Flop (didn't bet)
Seat 3: JamesKinder folded before Flop (didn't bet)
Seat 4: VIOLET 1998 (button) folded before Flop (didn't bet)
Seat 5: vilemo20 (small blind) folded before Flop



PokerStars Hand #222969106037:  Hold'em No Limit ($0.05/$0.10 USD) - 2021/01/23 15:25:11 ET
Table 'Demoulina III' 6-max Seat #5 is the button
Seat 1: BazKaLT ($10.05 in chips) 
Seat 2: odvamp ($17.08 in chips) 
Seat 3: JamesKinder ($6.08 in chips) 
Seat 4: VIOLET 1998 ($12.28 in chips) 
Seat 5: vilemo20 ($10 in chips) 
BazKaLT: posts small blind $0.05
odvamp: posts big blind $0.10
*** HOLE CARDS ***
JamesKinder: raises $0.20 to $0.30
VIOLET 1998: folds 
vilemo20: folds 
BazKaLT: folds 
odvamp: folds 
Uncalled bet ($0.20) returned to JamesKinder
JamesKinder collected $0.25 from pot
JamesKinder: doesn't show hand 
*** SUMMARY ***
Total pot $0.25 | Rake $0 
Seat 1: BazKaLT (small blind) folded before Flop
Seat 2: odvamp (big blind) folded before Flop
Seat 3: JamesKinder collected ($0.25)
Seat 4: VIOLET 1998 folded before Flop (didn't bet)
Seat 5: vilemo20 (button) folded before Flop (didn't bet)



PokerStars Hand #222969115404:  Hold'em No Limit ($0.05/$0.10 USD) - 2021/01/23 15:25:22 ET
Table 'Demoulina III' 6-max Seat #1 is the button
Seat 1: BazKaLT ($10 in chips) 
Seat 2: odvamp ($16.98 in chips) 
Seat 3: JamesKinder ($6.23 in chips) 
Seat 4: VIOLET 1998 ($12.28 in chips) 
Seat 5: vilemo20 ($10 in chips) 
odvamp: posts small blind $0.05
JamesKinder: posts big blind $0.10
*** HOLE CARDS ***
VIOLET 1998: folds 
vilemo20: folds 
BazKaLT: folds 
odvamp: raises $0.20 to $0.30
JamesKinder: calls $0.20
*** FLOP *** [4s 3c Js]
odvamp: bets $0.45
JamesKinder: folds 
Uncalled bet ($0.45) returned to odvamp
odvamp collected $0.57 from pot
odvamp: doesn't show hand 
*** SUMMARY ***
Total pot $0.60 | Rake $0.03 
Board [4s 3c Js]
Seat 1: BazKaLT (button) folded before Flop (didn't bet)
Seat 2: odvamp (small blind) collected ($0.57)
Seat 3: JamesKinder (big blind) folded on the Flop
Seat 4: VIOLET 1998 folded before Flop (didn't bet)
Seat 5: vilemo20 folded before Flop (didn't bet)



PokerStars Hand #222969133299:  Hold'em No Limit ($0.05/$0.10 USD) - 2021/01/23 15:25:43 ET
Table 'Demoulina III' 6-max Seat #3 is the button
Seat 1: BazKaLT ($10 in chips) 
Seat 3: JamesKinder ($5.93 in chips) 
Seat 4: VIOLET 1998 ($12.28 in chips) 
Seat 5: vilemo20 ($10 in chips) 
VIOLET 1998: posts small blind $0.05
vilemo20: posts big blind $0.10
*** HOLE CARDS ***
BazKaLT: folds 
JamesKinder: folds 
VIOLET 1998: calls $0.05
vilemo20: checks 
*** FLOP *** [Td 3c Th]
VIOLET 1998: checks 
vilemo20: checks 
*** TURN *** [Td 3c Th] [9s]
VIOLET 1998: checks 
vilemo20: checks 
*** RIVER *** [Td 3c Th 9s] [8d]
VIOLET 1998: bets $0.29
vilemo20: folds 
Uncalled bet ($0.29) returned to VIOLET 1998
VIOLET 1998 collected $0.19 from pot
VIOLET 1998: doesn't show hand 
*** SUMMARY ***
Total pot $0.20 | Rake $0.01 
Board [Td 3c Th 9s 8d]
Seat 1: BazKaLT folded before Flop (didn't bet)
Seat 3: JamesKinder (button) folded before Flop (didn't bet)
Seat 4: VIOLET 1998 (small blind) collected ($0.19)
Seat 5: vilemo20 (big blind) folded on the River



PokerStars Hand #222969160270:  Hold'em No Limit ($0.05/$0.10 USD) - 2021/01/23 15:26:14 ET
Table 'Demoulina III' 6-max Seat #4 is the button
Seat 1: BazKaLT ($10 in chips) 
Seat 3: JamesKinder ($5.93 in chips) 
Seat 4: VIOLET 1998 ($12.37 in chips) 
Seat 5: vilemo20 ($10 in chips) 
vilemo20: posts small blind $0.05
BazKaLT: posts big blind $0.10
*** HOLE CARDS ***
JamesKinder: raises $0.20 to $0.30
VIOLET 1998: calls $0.30
vilemo20: folds 
BazKaLT: folds 
*** FLOP *** [Jd Kh 4h]
JamesKinder: bets $0.37
VIOLET 1998: calls $0.37
*** TURN *** [Jd Kh 4h] [Kc]
JamesKinder: checks 
VIOLET 1998: checks 
*** RIVER *** [Jd Kh 4h Kc] [Qc]
JamesKinder: checks 
VIOLET 1998: checks 
*** SHOW DOWN ***
JamesKinder: shows [As 9c] (a pair of Kings)
VIOLET 1998: shows [Ad 6d] (a pair of Kings)
JamesKinder collected $0.71 from pot
VIOLET 1998 collected $0.71 from pot
quags30 was removed from the table for failing to post
quags30 leaves the table
*** SUMMARY ***
Total pot $1.49 | Rake $0.07 
Board [Jd Kh 4h Kc Qc]
Seat 1: BazKaLT (big blind) folded before Flop
Seat 3: JamesKinder showed [As 9c] and won ($0.71) with a pair of Kings
Seat 4: VIOLET 1998 (button) showed [Ad 6d] and won ($0.71) with a pair of Kings
Seat 5: vilemo20 (small blind) folded before Flop



PokerStars Hand #222969184088:  Hold'em No Limit ($0.05/$0.10 USD) - 2021/01/23 15:26:42 ET
Table 'Demoulina III' 6-max Seat #5 is the button
Seat 1: BazKaLT ($10 in chips) 
Seat 3: JamesKinder ($5.97 in chips) 
Seat 4: VIOLET 1998 ($12.41 in chips) 
Seat 5: vilemo20 ($10 in chips) 
BazKaLT: posts small blind $0.05
JamesKinder: posts big blind $0.10
*** HOLE CARDS ***
VIOLET 1998: folds 
vilemo20: folds 
BazKaLT: raises $0.15 to $0.25
namemattbark joins the table at seat #6 
JamesKinder: folds 
Uncalled bet ($0.15) returned to BazKaLT
BazKaLT collected $0.20 from pot
BazKaLT: doesn't show hand 
*** SUMMARY ***
Total pot $0.20 | Rake $0 
Seat 1: BazKaLT (small blind) collected ($0.20)
Seat 3: JamesKinder (big blind) folded before Flop
Seat 4: VIOLET 1998 folded before Flop (didn't bet)
Seat 5: vilemo20 (button) folded before Flop (didn't bet)



PokerStars Hand #222969197786:  Hold'em No Limit ($0.05/$0.10 USD) - 2021/01/23 15:26:58 ET
Table 'Demoulina III' 6-max Seat #1 is the button
Seat 1: BazKaLT ($10.10 in chips) 
Seat 3: JamesKinder ($5.87 in chips) 
Seat 4: VIOLET 1998 ($12.41 in chips) 
Seat 5: vilemo20 ($10 in chips) 
JamesKinder: posts small blind $0.05
VIOLET 1998: posts big blind $0.10
namemattbark: sits out 
*** HOLE CARDS ***
vilemo20: folds 
BazKaLT: raises $0.15 to $0.25
JamesKinder: folds 
VIOLET 1998: folds 
Uncalled bet ($0.15) returned to BazKaLT
BazKaLT collected $0.25 from pot
BazKaLT: doesn't show hand 
*** SUMMARY ***
Total pot $0.25 | Rake $0 
Seat 1: BazKaLT (button) collected ($0.25)
Seat 3: JamesKinder (small blind) folded before Flop
Seat 4: VIOLET 1998 (big blind) folded before Flop
Seat 5: vilemo20 folded before Flop (didn't bet)



PokerStars Hand #222969219018:  Hold'em No Limit ($0.05/$0.10 USD) - 2021/01/23 15:27:23 ET
Table 'Demoulina III' 6-max Seat #3 is the button
Seat 1: BazKaLT ($10.25 in chips) 
Seat 3: JamesKinder ($5.82 in chips) 
Seat 4: VIOLET 1998 ($12.31 in chips) 
Seat 5: vilemo20 ($10 in chips) 
VIOLET 1998: posts small blind $0.05
vilemo20: posts big blind $0.10
namemattbark: sits out 
*** HOLE CARDS ***
BazKaLT: raises $0.15 to $0.25
JamesKinder: folds 
VIOLET 1998: folds 
vilemo20: folds 
Uncalled bet ($0.15) returned to BazKaLT
BazKaLT collected $0.25 from pot
BazKaLT: doesn't show hand 
*** SUMMARY ***
Total pot $0.25 | Rake $0 
Seat 1: BazKaLT collected ($0.25)
Seat 3: JamesKinder (button) folded before Flop (didn't bet)
Seat 4: VIOLET 1998 (small blind) folded before Flop
Seat 5: vilemo20 (big blind) folded before Flop



PokerStars Hand #222969233549:  Hold'em No Limit ($0.05/$0.10 USD) - 2021/01/23 15:27:40 ET
Table 'Demoulina III' 6-max Seat #4 is the button
Seat 1: BazKaLT ($10.40 in chips) 
Seat 3: JamesKinder ($5.82 in chips) 
Seat 4: VIOLET 1998 ($12.26 in chips) 
Seat 5: vilemo20 ($10 in chips) 
Seat 6: namemattbark ($10 in chips) 
vilemo20: posts small blind $0.05
namemattbark: posts big blind $0.10
*** HOLE CARDS ***
BazKaLT: folds 
JamesKinder: folds 
VIOLET 1998: calls $0.10
vilemo20: folds 
namemattbark: raises $0.13 to $0.23
VIOLET 1998: calls $0.13
*** FLOP *** [Th Qs 3s]
namemattbark: bets $0.27
VIOLET 1998: calls $0.27
*** TURN *** [Th Qs 3s] [As]
namemattbark: bets $0.55
VIOLET 1998: calls $0.55
*** RIVER *** [Th Qs 3s As] [8c]
namemattbark: checks 
VIOLET 1998: bets $1.02
namemattbark: calls $1.02
*** SHOW DOWN ***
VIOLET 1998: shows [9c Jd] (a straight, Eight to Queen)
namemattbark: mucks hand 
VIOLET 1998 collected $4 from pot
*** SUMMARY ***
Total pot $4.19 | Rake $0.19 
Board [Th Qs 3s As 8c]
Seat 1: BazKaLT folded before Flop (didn't bet)
Seat 3: JamesKinder folded before Flop (didn't bet)
Seat 4: VIOLET 1998 (button) showed [9c Jd] and won ($4) with a straight, Eight to Queen
Seat 5: vilemo20 (small blind) folded before Flop
Seat 6: namemattbark (big blind) mucked



PokerStars Hand #222969268550:  Hold'em No Limit ($0.05/$0.10 USD) - 2021/01/23 15:28:21 ET
Table 'Demoulina III' 6-max Seat #5 is the button
Seat 1: BazKaLT ($10.40 in chips) 
Seat 3: JamesKinder ($5.82 in chips) 
Seat 4: VIOLET 1998 ($14.19 in chips) 
Seat 5: vilemo20 ($10 in chips) 
Seat 6: namemattbark ($7.93 in chips) 
namemattbark: posts small blind $0.05
BazKaLT: posts big blind $0.10
*** HOLE CARDS ***
JamesKinder: raises $0.20 to $0.30
VIOLET 1998: calls $0.30
vilemo20: folds 
namemattbark: folds 
BazKaLT: calls $0.20
*** FLOP *** [5h 8s 4h]
BazKaLT: checks 
JamesKinder: checks 
VIOLET 1998: checks 
*** TURN *** [5h 8s 4h] [3c]
BazKaLT: checks 
JamesKinder: checks 
VIOLET 1998: bets $0.45
BazKaLT: folds 
JamesKinder: calls $0.45
*** RIVER *** [5h 8s 4h 3c] [Kh]
JamesKinder: checks 
VIOLET 1998: checks 
*** SHOW DOWN ***
JamesKinder: shows [Ad Kd] (a pair of Kings)
VIOLET 1998: mucks hand 
JamesKinder collected $1.77 from pot
*** SUMMARY ***
Total pot $1.85 | Rake $0.08 
Board [5h 8s 4h 3c Kh]
Seat 1: BazKaLT (big blind) folded on the Turn
Seat 3: JamesKinder showed [Ad Kd] and won ($1.77) with a pair of Kings
Seat 4: VIOLET 1998 mucked
Seat 5: vilemo20 (button) folded before Flop (didn't bet)
Seat 6: namemattbark (small blind) folded before Flop



PokerStars Hand #222969300842:  Hold'em No Limit ($0.05/$0.10 USD) - 2021/01/23 15:28:58 ET
Table 'Demoulina III' 6-max Seat #6 is the button
Seat 1: BazKaLT ($10.10 in chips) 
Seat 3: JamesKinder ($6.84 in chips) 
Seat 4: VIOLET 1998 ($13.44 in chips) 
Seat 5: vilemo20 ($10 in chips) 
Seat 6: namemattbark ($10 in chips) 
BazKaLT: posts small blind $0.05
JamesKinder: posts big blind $0.10
*** HOLE CARDS ***
VIOLET 1998: calls $0.10
vilemo20: folds 
namemattbark: raises $0.13 to $0.23
BazKaLT: calls $0.18
JamesKinder: folds 
VIOLET 1998: calls $0.13
*** FLOP *** [Qh 2d 7s]
BazKaLT: checks 
VIOLET 1998: checks 
namemattbark: checks 
*** TURN *** [Qh 2d 7s] [Kh]
BazKaLT: bets $0.50
VIOLET 1998: folds 
namemattbark: calls $0.50
*** RIVER *** [Qh 2d 7s Kh] [Ac]
odvamp leaves the table
BazKaLT: bets $2.70
namemattbark: folds 
Uncalled bet ($2.70) returned to BazKaLT
BazKaLT collected $1.71 from pot
BazKaLT: doesn't show hand 
*** SUMMARY ***
Total pot $1.79 | Rake $0.08 
Board [Qh 2d 7s Kh Ac]
Seat 1: BazKaLT (small blind) collected ($1.71)
Seat 3: JamesKinder (big blind) folded before Flop
Seat 4: VIOLET 1998 folded on the Turn
Seat 5: vilemo20 folded before Flop (didn't bet)
Seat 6: namemattbark (button) folded on the River



PokerStars Hand #222969337647:  Hold'em No Limit ($0.05/$0.10 USD) - 2021/01/23 15:29:41 ET
Table 'Demoulina III' 6-max Seat #1 is the button
Seat 1: BazKaLT ($11.08 in chips) 
Seat 3: JamesKinder ($6.74 in chips) 
Seat 4: VIOLET 1998 ($13.21 in chips) 
Seat 5: vilemo20 ($10 in chips) 
Seat 6: namemattbark ($9.27 in chips) 
JamesKinder: posts small blind $0.05
VIOLET 1998: posts big blind $0.10
*** HOLE CARDS ***
vilemo20: folds 
namemattbark: folds 
BazKaLT: raises $0.15 to $0.25
JamesKinder: folds 
VIOLET 1998: calls $0.15
*** FLOP *** [7h 8d 7c]
VIOLET 1998: checks 
BazKaLT: bets $0.27
VIOLET 1998: calls $0.27
*** TURN *** [7h 8d 7c] [8h]
VIOLET 1998: bets $1.04
BazKaLT: calls $1.04
*** RIVER *** [7h 8d 7c 8h] [Kc]
VIOLET 1998: checks 
BazKaLT: checks 
*** SHOW DOWN ***
VIOLET 1998: shows [Ac 4h] (two pair, Eights and Sevens)
BazKaLT: shows [6h Ad] (two pair, Eights and Sevens)
VIOLET 1998 collected $1.52 from pot
BazKaLT collected $1.51 from pot
*** SUMMARY ***
Total pot $3.17 | Rake $0.14 
Board [7h 8d 7c 8h Kc]
Seat 1: BazKaLT (button) showed [6h Ad] and won ($1.51) with two pair, Eights and Sevens
Seat 3: JamesKinder (small blind) folded before Flop
Seat 4: VIOLET 1998 (big blind) showed [Ac 4h] and won ($1.52) with two pair, Eights and Sevens
Seat 5: vilemo20 folded before Flop (didn't bet)
Seat 6: namemattbark folded before Flop (didn't bet)



PokerStars Hand #222969372644:  Hold'em No Limit ($0.05/$0.10 USD) - 2021/01/23 15:30:21 ET
Table 'Demoulina III' 6-max Seat #3 is the button
Seat 1: BazKaLT ($11.03 in chips) 
Seat 3: JamesKinder ($6.69 in chips) 
Seat 4: VIOLET 1998 ($13.17 in chips) 
Seat 5: vilemo20 ($10 in chips) 
Seat 6: namemattbark ($9.27 in chips) 
VIOLET 1998: posts small blind $0.05
vilemo20: posts big blind $0.10
*** HOLE CARDS ***
namemattbark: folds 
BazKaLT: folds 
JamesKinder: raises $0.20 to $0.30
VIOLET 1998: folds 
vilemo20: folds 
Uncalled bet ($0.20) returned to JamesKinder
JamesKinder collected $0.25 from pot
JamesKinder: doesn't show hand 
*** SUMMARY ***
Total pot $0.25 | Rake $0 
Seat 1: BazKaLT folded before Flop (didn't bet)
Seat 3: JamesKinder (button) collected ($0.25)
Seat 4: VIOLET 1998 (small blind) folded before Flop
Seat 5: vilemo20 (big blind) folded before Flop
Seat 6: namemattbark folded before Flop (didn't bet)



PokerStars Hand #222969387398:  Hold'em No Limit ($0.05/$0.10 USD) - 2021/01/23 15:30:38 ET
Table 'Demoulina III' 6-max Seat #4 is the button
Seat 1: BazKaLT ($11.03 in chips) 
Seat 3: JamesKinder ($6.84 in chips) 
Seat 4: VIOLET 1998 ($13.12 in chips) 
Seat 5: vilemo20 ($10 in chips) 
Seat 6: namemattbark ($9.27 in chips) 
vilemo20: posts small blind $0.05
namemattbark: posts big blind $0.10
*** HOLE CARDS ***
BazKaLT: raises $0.15 to $0.25
JamesKinder: folds 
VIOLET 1998: calls $0.25
vilemo20: folds 
namemattbark: folds 
*** FLOP *** [3c Ks 6d]
BazKaLT: checks 
VIOLET 1998: bets $0.31
BazKaLT: calls $0.31
*** TURN *** [3c Ks 6d] [Kh]
BazKaLT: checks 
VIOLET 1998: bets $0.60
BazKaLT: raises $1.21 to $1.81
genad joins the table at seat #2 
VIOLET 1998: folds 
Uncalled bet ($1.21) returned to BazKaLT
BazKaLT collected $2.36 from pot
BazKaLT: doesn't show hand 
*** SUMMARY ***
Total pot $2.47 | Rake $0.11 
Board [3c Ks 6d Kh]
Seat 1: BazKaLT collected ($2.36)
Seat 3: JamesKinder folded before Flop (didn't bet)
Seat 4: VIOLET 1998 (button) folded on the Turn
Seat 5: vilemo20 (small blind) folded before Flop
Seat 6: namemattbark (big blind) folded before Flop



PokerStars Hand #222969422060:  Hold'em No Limit ($0.05/$0.10 USD) - 2021/01/23 15:31:06 ET
Table 'Demoulina III' 6-max Seat #5 is the button
Seat 1: BazKaLT ($12.23 in chips) 
Seat 3: JamesKinder ($6.84 in chips) 
Seat 4: VIOLET 1998 ($11.96 in chips) 
Seat 5: vilemo20 ($10 in chips) 
Seat 6: namemattbark ($9.17 in chips) 
namemattbark: posts small blind $0.05
BazKaLT: posts big blind $0.10
genad: sits out 
*** HOLE CARDS ***
JamesKinder: folds 
VIOLET 1998: raises $0.10 to $0.20
vilemo20: folds 
namemattbark: folds 
BazKaLT: calls $0.10
*** FLOP *** [6c 3s Kc]
BazKaLT: checks 
VIOLET 1998: bets $0.21
BazKaLT: raises $0.56 to $0.77
VIOLET 1998: calls $0.56
*** TURN *** [6c 3s Kc] [Td]
BazKaLT: bets $1.25
VIOLET 1998: calls $1.25
*** RIVER *** [6c 3s Kc Td] [4h]
BazKaLT: checks 
VIOLET 1998: bets $2.14
BazKaLT: folds 
Uncalled bet ($2.14) returned to VIOLET 1998
VIOLET 1998 collected $4.29 from pot
VIOLET 1998: doesn't show hand 
*** SUMMARY ***
Total pot $4.49 | Rake $0.20 
Board [6c 3s Kc Td 4h]
Seat 1: BazKaLT (big blind) folded on the River
Seat 3: JamesKinder folded before Flop (didn't bet)
Seat 4: VIOLET 1998 collected ($4.29)
Seat 5: vilemo20 (button) folded before Flop (didn't bet)
Seat 6: namemattbark (small blind) folded before Flop



PokerStars Hand #222969463078:  Hold'em No Limit ($0.05/$0.10 USD) - 2021/01/23 15:31:53 ET
Table 'Demoulina III' 6-max Seat #6 is the button
Seat 1: BazKaLT ($10.01 in chips) 
Seat 2: genad ($10 in chips) 
Seat 3: JamesKinder ($6.84 in chips) 
Seat 4: VIOLET 1998 ($14.03 in chips) 
Seat 5: vilemo20 ($10 in chips) 
Seat 6: namemattbark ($9.12 in chips) 
BazKaLT: posts small blind $0.05
genad: posts big blind $0.10
*** HOLE CARDS ***
JamesKinder: folds 
VIOLET 1998: folds 
vilemo20: folds 
namemattbark: folds 
BazKaLT: raises $0.15 to $0.25
genad: folds 
Uncalled bet ($0.15) returned to BazKaLT
BazKaLT collected $0.20 from pot
BazKaLT: doesn't show hand 
*** SUMMARY ***
Total pot $0.20 | Rake $0 
Seat 1: BazKaLT (small blind) collected ($0.20)
Seat 2: genad (big blind) folded before Flop
Seat 3: JamesKinder folded before Flop (didn't bet)
Seat 4: VIOLET 1998 folded before Flop (didn't bet)
Seat 5: vilemo20 folded before Flop (didn't bet)
Seat 6: namemattbark (button) folded before Flop (didn't bet)



PokerStars Hand #222969479956:  Hold'em No Limit ($0.05/$0.10 USD) - 2021/01/23 15:32:12 ET
Table 'Demoulina III' 6-max Seat #1 is the button
Seat 1: BazKaLT ($10.11 in chips) 
Seat 2: genad ($10 in chips) 
Seat 3: JamesKinder ($6.84 in chips) 
Seat 4: VIOLET 1998 ($14.03 in chips) 
Seat 5: vilemo20 ($10 in chips) 
Seat 6: namemattbark ($9.12 in chips) 
genad: posts small blind $0.05
JamesKinder: posts big blind $0.10
*** HOLE CARDS ***
VIOLET 1998: folds 
vilemo20: folds 
namemattbark: raises $0.13 to $0.23
BazKaLT: folds 
genad: folds 
JamesKinder: raises $0.67 to $0.90
namemattbark: calls $0.67
*** FLOP *** [8h 2d 9c]
JamesKinder: bets $0.92
namemattbark: calls $0.92
*** TURN *** [8h 2d 9c] [9d]
JamesKinder: checks 
namemattbark: checks 
*** RIVER *** [8h 2d 9c 9d] [5s]
JamesKinder: bets $1.06
namemattbark: calls $1.06
*** SHOW DOWN ***
JamesKinder: shows [4c 4h] (two pair, Nines and Fours)
namemattbark: mucks hand 
JamesKinder collected $5.55 from pot
*** SUMMARY ***
Total pot $5.81 | Rake $0.26 
Board [8h 2d 9c 9d 5s]
Seat 1: BazKaLT (button) folded before Flop (didn't bet)
Seat 2: genad (small blind) folded before Flop
Seat 3: JamesKinder (big blind) showed [4c 4h] and won ($5.55) with two pair, Nines and Fours
Seat 4: VIOLET 1998 folded before Flop (didn't bet)
Seat 5: vilemo20 folded before Flop (didn't bet)
Seat 6: namemattbark mucked



PokerStars Hand #222969510127:  Hold'em No Limit ($0.05/$0.10 USD) - 2021/01/23 15:32:47 ET
Table 'Demoulina III' 6-max Seat #2 is the button
Seat 1: BazKaLT ($10.11 in chips) 
Seat 2: genad ($10 in chips) 
Seat 3: JamesKinder ($9.51 in chips) 
Seat 4: VIOLET 1998 ($14.03 in chips) 
Seat 5: vilemo20 ($10 in chips) 
Seat 6: namemattbark ($6.24 in chips) 
JamesKinder: posts small blind $0.05
VIOLET 1998: posts big blind $0.10
*** HOLE CARDS ***
vilemo20: folds 
namemattbark: folds 
BazKaLT: folds 
genad: folds 
JamesKinder: raises $0.20 to $0.30
VIOLET 1998: folds 
Uncalled bet ($0.20) returned to JamesKinder
JamesKinder collected $0.20 from pot
JamesKinder: doesn't show hand 
*** SUMMARY ***
Total pot $0.20 | Rake $0 
Seat 1: BazKaLT folded before Flop (didn't bet)
Seat 2: genad (button) folded before Flop (didn't bet)
Seat 3: JamesKinder (small blind) collected ($0.20)
Seat 4: VIOLET 1998 (big blind) folded before Flop
Seat 5: vilemo20 folded before Flop (didn't bet)
Seat 6: namemattbark folded before Flop (didn't bet)



PokerStars Hand #222969521561:  Hold'em No Limit ($0.05/$0.10 USD) - 2021/01/23 15:33:01 ET
Table 'Demoulina III' 6-max Seat #3 is the button
Seat 1: BazKaLT ($10.11 in chips) 
Seat 2: genad ($10 in chips) 
Seat 3: JamesKinder ($9.61 in chips) 
Seat 4: VIOLET 1998 ($13.93 in chips) 
Seat 5: vilemo20 ($10 in chips) 
Seat 6: namemattbark ($8.50 in chips) 
VIOLET 1998: posts small blind $0.05
vilemo20: posts big blind $0.10
*** HOLE CARDS ***
namemattbark: folds 
BazKaLT: folds 
genad: folds 
JamesKinder: folds 
VIOLET 1998: calls $0.05
vilemo20: checks 
*** FLOP *** [3s Ac 8s]
VIOLET 1998: bets $0.39
vilemo20: folds 
Uncalled bet ($0.39) returned to VIOLET 1998
VIOLET 1998 collected $0.19 from pot
VIOLET 1998: doesn't show hand 
*** SUMMARY ***
Total pot $0.20 | Rake $0.01 
Board [3s Ac 8s]
Seat 1: BazKaLT folded before Flop (didn't bet)
Seat 2: genad folded before Flop (didn't bet)
Seat 3: JamesKinder (button) folded before Flop (didn't bet)
Seat 4: VIOLET 1998 (small blind) collected ($0.19)
Seat 5: vilemo20 (big blind) folded on the Flop
Seat 6: namemattbark folded before Flop (didn't bet)



PokerStars Hand #222969545555:  Hold'em No Limit ($0.05/$0.10 USD) - 2021/01/23 15:33:29 ET
Table 'Demoulina III' 6-max Seat #4 is the button
Seat 1: BazKaLT ($10.11 in chips) 
Seat 2: genad ($10 in chips) 
Seat 3: JamesKinder ($9.61 in chips) 
Seat 4: VIOLET 1998 ($14.02 in chips) 
Seat 5: vilemo20 ($10 in chips) 
Seat 6: namemattbark ($8.50 in chips) 
vilemo20: posts small blind $0.05
namemattbark: posts big blind $0.10
*** HOLE CARDS ***
BazKaLT: folds 
genad: folds 
JamesKinder: folds 
VIOLET 1998: folds 
vilemo20: folds 
Uncalled bet ($0.05) returned to namemattbark
namemattbark collected $0.10 from pot
namemattbark: doesn't show hand 
*** SUMMARY ***
Total pot $0.10 | Rake $0 
Seat 1: BazKaLT folded before Flop (didn't bet)
Seat 2: genad folded before Flop (didn't bet)
Seat 3: JamesKinder folded before Flop (didn't bet)
Seat 4: VIOLET 1998 (button) folded before Flop (didn't bet)
Seat 5: vilemo20 (small blind) folded before Flop
Seat 6: namemattbark (big blind) collected ($0.10)



PokerStars Hand #222969554638:  Hold'em No Limit ($0.05/$0.10 USD) - 2021/01/23 15:33:39 ET
Table 'Demoulina III' 6-max Seat #5 is the button
Seat 1: BazKaLT ($10.11 in chips) 
Seat 2: genad ($10 in chips) 
Seat 3: JamesKinder ($9.61 in chips) 
Seat 4: VIOLET 1998 ($14.02 in chips) 
Seat 5: vilemo20 ($10 in chips) 
Seat 6: namemattbark ($8.55 in chips) 
namemattbark: posts small blind $0.05
BazKaLT: posts big blind $0.10
*** HOLE CARDS ***
genad: folds 
JamesKinder: folds 
VIOLET 1998 has timed out
VIOLET 1998: folds 
vilemo20: raises $0.15 to $0.25
namemattbark: folds 
BazKaLT: folds 
Uncalled bet ($0.15) returned to vilemo20
vilemo20 collected $0.25 from pot
vilemo20: doesn't show hand 
*** SUMMARY ***
Total pot $0.25 | Rake $0 
Seat 1: BazKaLT (big blind) folded before Flop
Seat 2: genad folded before Flop (didn't bet)
Seat 3: JamesKinder folded before Flop (didn't bet)
Seat 4: VIOLET 1998 folded before Flop (didn't bet)
Seat 5: vilemo20 (button) collected ($0.25)
Seat 6: namemattbark (small blind) folded before Flop



PokerStars Hand #222969572649:  Hold'em No Limit ($0.05/$0.10 USD) - 2021/01/23 15:34:00 ET
Table 'Demoulina III' 6-max Seat #6 is the button
Seat 1: BazKaLT ($10.01 in chips) 
Seat 2: genad ($10 in chips) 
Seat 3: JamesKinder ($9.61 in chips) 
Seat 5: vilemo20 ($10.15 in chips) 
Seat 6: namemattbark ($8.50 in chips) 
BazKaLT: posts small blind $0.05
genad: posts big blind $0.10
*** HOLE CARDS ***
JamesKinder: folds 
vilemo20: folds 
namemattbark: folds 
BazKaLT: raises $0.15 to $0.25
genad: folds 
Uncalled bet ($0.15) returned to BazKaLT
BazKaLT collected $0.20 from pot
BazKaLT: doesn't show hand 
*** SUMMARY ***
Total pot $0.20 | Rake $0 
Seat 1: BazKaLT (small blind) collected ($0.20)
Seat 2: genad (big blind) folded before Flop
Seat 3: JamesKinder folded before Flop (didn't bet)
Seat 5: vilemo20 folded before Flop (didn't bet)
Seat 6: namemattbark (button) folded before Flop (didn't bet)



PokerStars Hand #222969583325:  Hold'em No Limit ($0.05/$0.10 USD) - 2021/01/23 15:34:12 ET
Table 'Demoulina III' 6-max Seat #1 is the button
Seat 1: BazKaLT ($10.11 in chips) 
Seat 2: genad ($10 in chips) 
Seat 3: JamesKinder ($9.61 in chips) 
Seat 5: vilemo20 ($10.15 in chips) 
Seat 6: namemattbark ($8.50 in chips) 
genad: posts small blind $0.05
JamesKinder: posts big blind $0.10
*** HOLE CARDS ***
vilemo20: folds 
namemattbark: folds 
BazKaLT: folds 
genad: raises $0.20 to $0.30
JamesKinder: raises $0.60 to $0.90
genad: folds 
Uncalled bet ($0.60) returned to JamesKinder
JamesKinder collected $0.60 from pot
JamesKinder: doesn't show hand 
*** SUMMARY ***
Total pot $0.60 | Rake $0 
Seat 1: BazKaLT (button) folded before Flop (didn't bet)
Seat 2: genad (small blind) folded before Flop
Seat 3: JamesKinder (big blind) collected ($0.60)
Seat 5: vilemo20 folded before Flop (didn't bet)
Seat 6: namemattbark folded before Flop (didn't bet)



PokerStars Hand #222969598750:  Hold'em No Limit ($0.05/$0.10 USD) - 2021/01/23 15:34:30 ET
Table 'Demoulina III' 6-max Seat #2 is the button
Seat 1: BazKaLT ($10.11 in chips) 
Seat 2: genad ($10 in chips) 
Seat 3: JamesKinder ($9.91 in chips) 
Seat 5: vilemo20 ($10.15 in chips) 
Seat 6: namemattbark ($8.50 in chips) 
JamesKinder: posts small blind $0.05
vilemo20: posts big blind $0.10
*** HOLE CARDS ***
namemattbark: folds 
BazKaLT: folds 
genad: folds 
JamesKinder: folds 
Uncalled bet ($0.05) returned to vilemo20
vilemo20 collected $0.10 from pot
vilemo20: doesn't show hand 
*** SUMMARY ***
Total pot $0.10 | Rake $0 
Seat 1: BazKaLT folded before Flop (didn't bet)
Seat 2: genad (button) folded before Flop (didn't bet)
Seat 3: JamesKinder (small blind) folded before Flop
Seat 5: vilemo20 (big blind) collected ($0.10)
Seat 6: namemattbark folded before Flop (didn't bet)



PokerStars Hand #222969604955:  Hold'em No Limit ($0.05/$0.10 USD) - 2021/01/23 15:34:38 ET
Table 'Demoulina III' 6-max Seat #3 is the button
Seat 1: BazKaLT ($10.11 in chips) 
Seat 2: genad ($10 in chips) 
Seat 3: JamesKinder ($9.86 in chips) 
Seat 5: vilemo20 ($10.20 in chips) 
Seat 6: namemattbark ($8.50 in chips) 
vilemo20: posts small blind $0.05
namemattbark: posts big blind $0.10
*** HOLE CARDS ***
BazKaLT: raises $0.15 to $0.25
genad: folds 
JamesKinder: folds 
vilemo20: folds 
namemattbark: folds 
Uncalled bet ($0.15) returned to BazKaLT
BazKaLT collected $0.25 from pot
BazKaLT: doesn't show hand 
*** SUMMARY ***
Total pot $0.25 | Rake $0 
Seat 1: BazKaLT collected ($0.25)
Seat 2: genad folded before Flop (didn't bet)
Seat 3: JamesKinder (button) folded before Flop (didn't bet)
Seat 5: vilemo20 (small blind) folded before Flop
Seat 6: namemattbark (big blind) folded before Flop



PokerStars Hand #222969613617:  Hold'em No Limit ($0.05/$0.10 USD) - 2021/01/23 15:34:48 ET
Table 'Demoulina III' 6-max Seat #5 is the button
Seat 1: BazKaLT ($10.26 in chips) 
Seat 2: genad ($10 in chips) 
Seat 3: JamesKinder ($9.86 in chips) 
Seat 5: vilemo20 ($10.15 in chips) 
Seat 6: namemattbark ($8.40 in chips) 
namemattbark: posts small blind $0.05
BazKaLT: posts big blind $0.10
VIOLET 1998: sits out 
*** HOLE CARDS ***
genad: raises $0.15 to $0.25
JamesKinder: raises $0.75 to $1
vilemo20: folds 
namemattbark: folds 
BazKaLT: folds 
genad: calls $0.75
*** FLOP *** [7c Qh Kh]
genad: checks 
JamesKinder: bets $1.07
genad: calls $1.07
*** TURN *** [7c Qh Kh] [7d]
genad: checks 
JamesKinder: bets $2.13
genad: folds 
Uncalled bet ($2.13) returned to JamesKinder
JamesKinder collected $4.10 from pot
JamesKinder: doesn't show hand 
*** SUMMARY ***
Total pot $4.29 | Rake $0.19 
Board [7c Qh Kh 7d]
Seat 1: BazKaLT (big blind) folded before Flop
Seat 2: genad folded on the Turn
Seat 3: JamesKinder collected ($4.10)
Seat 5: vilemo20 (button) folded before Flop (didn't bet)
Seat 6: namemattbark (small blind) folded before Flop



PokerStars Hand #222969659631:  Hold'em No Limit ($0.05/$0.10 USD) - 2021/01/23 15:35:40 ET
Table 'Demoulina III' 6-max Seat #6 is the button
Seat 1: BazKaLT ($10.16 in chips) 
Seat 2: genad ($10 in chips) 
Seat 3: JamesKinder ($11.89 in chips) 
Seat 5: vilemo20 ($10.15 in chips) 
Seat 6: namemattbark ($8.35 in chips) 
BazKaLT: posts small blind $0.05
genad: posts big blind $0.10
VIOLET 1998: sits out 
*** HOLE CARDS ***
JamesKinder: folds 
vilemo20: raises $0.20 to $0.30
namemattbark: folds 
BazKaLT: folds 
genad: folds 
Uncalled bet ($0.20) returned to vilemo20
vilemo20 collected $0.25 from pot
vilemo20: doesn't show hand 
*** SUMMARY ***
Total pot $0.25 | Rake $0 
Seat 1: BazKaLT (small blind) folded before Flop
Seat 2: genad (big blind) folded before Flop
Seat 3: JamesKinder folded before Flop (didn't bet)
Seat 5: vilemo20 collected ($0.25)
Seat 6: namemattbark (button) folded before Flop (didn't bet)



PokerStars Hand #222969667850:  Hold'em No Limit ($0.05/$0.10 USD) - 2021/01/23 15:35:49 ET
Table 'Demoulina III' 6-max Seat #1 is the button
Seat 1: BazKaLT ($10.11 in chips) 
Seat 2: genad ($10 in chips) 
Seat 3: JamesKinder ($11.89 in chips) 
Seat 5: vilemo20 ($10.30 in chips) 
Seat 6: namemattbark ($8.35 in chips) 
genad: posts small blind $0.05
JamesKinder: posts big blind $0.10
VIOLET 1998: sits out 
*** HOLE CARDS ***
vilemo20: folds 
namemattbark: raises $0.13 to $0.23
BazKaLT: folds 
genad: folds 
JamesKinder: calls $0.13
*** FLOP *** [6d Qc 6c]
JamesKinder: checks 
namemattbark: bets $0.37
JamesKinder: folds 
Uncalled bet ($0.37) returned to namemattbark
namemattbark collected $0.49 from pot
namemattbark: doesn't show hand 
*** SUMMARY ***
Total pot $0.51 | Rake $0.02 
Board [6d Qc 6c]
Seat 1: BazKaLT (button) folded before Flop (didn't bet)
Seat 2: genad (small blind) folded before Flop
Seat 3: JamesKinder (big blind) folded on the Flop
Seat 5: vilemo20 folded before Flop (didn't bet)
Seat 6: namemattbark collected ($0.49)



PokerStars Hand #222969686185:  Hold'em No Limit ($0.05/$0.10 USD) - 2021/01/23 15:36:11 ET
Table 'Demoulina III' 6-max Seat #2 is the button
Seat 1: BazKaLT ($10.11 in chips) 
Seat 2: genad ($10 in chips) 
Seat 3: JamesKinder ($11.66 in chips) 
Seat 4: VIOLET 1998 ($14.02 in chips) 
Seat 5: vilemo20 ($10.30 in chips) 
Seat 6: namemattbark ($8.61 in chips) 
JamesKinder: posts small blind $0.05
VIOLET 1998: posts big blind $0.10
*** HOLE CARDS ***
vilemo20: folds 
namemattbark: folds 
BazKaLT: folds 
genad: folds 
JamesKinder: folds 
Uncalled bet ($0.05) returned to VIOLET 1998
VIOLET 1998 collected $0.10 from pot
VIOLET 1998: doesn't show hand 
*** SUMMARY ***
Total pot $0.10 | Rake $0 
Seat 1: BazKaLT folded before Flop (didn't bet)
Seat 2: genad (button) folded before Flop (didn't bet)
Seat 3: JamesKinder (small blind) folded before Flop
Seat 4: VIOLET 1998 (big blind) collected ($0.10)
Seat 5: vilemo20 folded before Flop (didn't bet)
Seat 6: namemattbark folded before Flop (didn't bet)



PokerStars Hand #222969694553:  Hold'em No Limit ($0.05/$0.10 USD) - 2021/01/23 15:36:21 ET
Table 'Demoulina III' 6-max Seat #3 is the button
Seat 1: BazKaLT ($10.11 in chips) 
Seat 2: genad ($10 in chips) 
Seat 3: JamesKinder ($11.61 in chips) 
Seat 4: VIOLET 1998 ($14.07 in chips) 
Seat 5: vilemo20 ($10.30 in chips) 
Seat 6: namemattbark ($8.61 in chips) 
VIOLET 1998: posts small blind $0.05
vilemo20: posts big blind $0.10
*** HOLE CARDS ***
namemattbark: folds 
BazKaLT: folds 
genad: raises $0.15 to $0.25
JamesKinder: folds 
VIOLET 1998: calls $0.20
vilemo20: folds 
*** FLOP *** [As 3s Kc]
VIOLET 1998: bets $0.28
genad: folds 
Uncalled bet ($0.28) returned to VIOLET 1998
VIOLET 1998 collected $0.57 from pot
VIOLET 1998: doesn't show hand 
*** SUMMARY ***
Total pot $0.60 | Rake $0.03 
Board [As 3s Kc]
Seat 1: BazKaLT folded before Flop (didn't bet)
Seat 2: genad folded on the Flop
Seat 3: JamesKinder (button) folded before Flop (didn't bet)
Seat 4: VIOLET 1998 (small blind) collected ($0.57)
Seat 5: vilemo20 (big blind) folded before Flop
Seat 6: namemattbark folded before Flop (didn't bet)



PokerStars Hand #222969715527:  Hold'em No Limit ($0.05/$0.10 USD) - 2021/01/23 15:36:45 ET
Table 'Demoulina III' 6-max Seat #4 is the button
Seat 1: BazKaLT ($10.11 in chips) 
Seat 2: genad ($10 in chips) 
Seat 3: JamesKinder ($11.61 in chips) 
Seat 4: VIOLET 1998 ($14.39 in chips) 
Seat 5: vilemo20 ($10.20 in chips) 
Seat 6: namemattbark ($8.61 in chips) 
vilemo20: posts small blind $0.05
namemattbark: posts big blind $0.10
*** HOLE CARDS ***
BazKaLT: folds 
genad: folds 
JamesKinder: folds 
VIOLET 1998: raises $0.20 to $0.30
vilemo20: folds 
namemattbark: folds 
Uncalled bet ($0.20) returned to VIOLET 1998
VIOLET 1998 collected $0.25 from pot
VIOLET 1998: doesn't show hand 
*** SUMMARY ***
Total pot $0.25 | Rake $0 
Seat 1: BazKaLT folded before Flop (didn't bet)
Seat 2: genad folded before Flop (didn't bet)
Seat 3: JamesKinder folded before Flop (didn't bet)
Seat 4: VIOLET 1998 (button) collected ($0.25)
Seat 5: vilemo20 (small blind) folded before Flop
Seat 6: namemattbark (big blind) folded before Flop



PokerStars Hand #222969734998:  Hold'em No Limit ($0.05/$0.10 USD) - 2021/01/23 15:37:08 ET
Table 'Demoulina III' 6-max Seat #5 is the button
Seat 1: BazKaLT ($10.11 in chips) 
Seat 2: genad ($10 in chips) 
Seat 3: JamesKinder ($11.61 in chips) 
Seat 4: VIOLET 1998 ($14.54 in chips) 
Seat 5: vilemo20 ($10.15 in chips) 
Seat 6: namemattbark ($8.51 in chips) 
namemattbark: posts small blind $0.05
BazKaLT: posts big blind $0.10
*** HOLE CARDS ***
genad: folds 
JamesKinder: folds 
VIOLET 1998: calls $0.10
vilemo20: folds 
namemattbark: folds 
BazKaLT: raises $0.50 to $0.60
VIOLET 1998: folds 
Uncalled bet ($0.50) returned to BazKaLT
BazKaLT collected $0.25 from pot
BazKaLT: doesn't show hand 
*** SUMMARY ***
Total pot $0.25 | Rake $0 
Seat 1: BazKaLT (big blind) collected ($0.25)
Seat 2: genad folded before Flop (didn't bet)
Seat 3: JamesKinder folded before Flop (didn't bet)
Seat 4: VIOLET 1998 folded before Flop
Seat 5: vilemo20 (button) folded before Flop (didn't bet)
Seat 6: namemattbark (small blind) folded before Flop



PokerStars Hand #222969751651:  Hold'em No Limit ($0.05/$0.10 USD) - 2021/01/23 15:37:28 ET
Table 'Demoulina III' 6-max Seat #6 is the button
Seat 1: BazKaLT ($10.26 in chips) 
Seat 2: genad ($10 in chips) 
Seat 3: JamesKinder ($11.61 in chips) 
Seat 4: VIOLET 1998 ($14.44 in chips) 
Seat 5: vilemo20 ($10.15 in chips) 
Seat 6: namemattbark ($8.46 in chips) 
BazKaLT: posts small blind $0.05
genad: posts big blind $0.10
*** HOLE CARDS ***
JamesKinder: folds 
VIOLET 1998: folds 
vilemo20: folds 
namemattbark: folds 
BazKaLT: raises $0.15 to $0.25
genad: folds 
Uncalled bet ($0.15) returned to BazKaLT
BazKaLT collected $0.20 from pot
BazKaLT: doesn't show hand 
*** SUMMARY ***
Total pot $0.20 | Rake $0 
Seat 1: BazKaLT (small blind) collected ($0.20)
Seat 2: genad (big blind) folded before Flop
Seat 3: JamesKinder folded before Flop (didn't bet)
Seat 4: VIOLET 1998 folded before Flop (didn't bet)
Seat 5: vilemo20 folded before Flop (didn't bet)
Seat 6: namemattbark (button) folded before Flop (didn't bet)



PokerStars Hand #222969768029:  Hold'em No Limit ($0.05/$0.10 USD) - 2021/01/23 15:37:47 ET
Table 'Demoulina III' 6-max Seat #1 is the button
Seat 1: BazKaLT ($10.36 in chips) 
Seat 2: genad ($10 in chips) 
Seat 3: JamesKinder ($11.61 in chips) 
Seat 4: VIOLET 1998 ($14.44 in chips) 
Seat 5: vilemo20 ($10.15 in chips) 
Seat 6: namemattbark ($8.46 in chips) 
genad: posts small blind $0.05
JamesKinder: posts big blind $0.10
*** HOLE CARDS ***
VIOLET 1998: raises $0.20 to $0.30
vilemo20: folds 
namemattbark: calls $0.30
BazKaLT: folds 
genad: folds 
JamesKinder: calls $0.20
*** FLOP *** [4h 2d Js]
JamesKinder: checks 
VIOLET 1998: checks 
namemattbark: bets $0.50
JamesKinder: folds 
VIOLET 1998: calls $0.50
*** TURN *** [4h 2d Js] [6h]
VIOLET 1998: checks 
namemattbark: bets $1.02
VIOLET 1998: folds 
Uncalled bet ($1.02) returned to namemattbark
namemattbark collected $1.86 from pot
namemattbark: doesn't show hand 
*** SUMMARY ***
Total pot $1.95 | Rake $0.09 
Board [4h 2d Js 6h]
Seat 1: BazKaLT (button) folded before Flop (didn't bet)
Seat 2: genad (small blind) folded before Flop
Seat 3: JamesKinder (big blind) folded on the Flop
Seat 4: VIOLET 1998 folded on the Turn
Seat 5: vilemo20 folded before Flop (didn't bet)
Seat 6: namemattbark collected ($1.86)



PokerStars Hand #222969832012:  Hold'em No Limit ($0.05/$0.10 USD) - 2021/01/23 15:38:54 ET
Table 'Demoulina III' 6-max Seat #2 is the button
Seat 1: BazKaLT ($10.36 in chips) 
Seat 2: genad ($10 in chips) 
Seat 3: JamesKinder ($11.31 in chips) 
Seat 4: VIOLET 1998 ($13.64 in chips) 
Seat 5: vilemo20 ($10.15 in chips) 
Seat 6: namemattbark ($9.52 in chips) 
JamesKinder: posts small blind $0.05
VIOLET 1998: posts big blind $0.10
*** HOLE CARDS ***
vilemo20: folds 
namemattbark: folds 
BazKaLT: folds 
genad: folds 
JamesKinder: raises $0.10 to $0.20
VIOLET 1998: calls $0.10
*** FLOP *** [2d 5d 5s]
JamesKinder: checks 
VIOLET 1998: checks 
*** TURN *** [2d 5d 5s] [Kh]
JamesKinder: bets $0.20
VIOLET 1998: folds 
Uncalled bet ($0.20) returned to JamesKinder
JamesKinder collected $0.38 from pot
JamesKinder: doesn't show hand 
*** SUMMARY ***
Total pot $0.40 | Rake $0.02 
Board [2d 5d 5s Kh]
Seat 1: BazKaLT folded before Flop (didn't bet)
Seat 2: genad (button) folded before Flop (didn't bet)
Seat 3: JamesKinder (small blind) collected ($0.38)
Seat 4: VIOLET 1998 (big blind) folded on the Turn
Seat 5: vilemo20 folded before Flop (didn't bet)
Seat 6: namemattbark folded before Flop (didn't bet)



PokerStars Hand #222969852614:  Hold'em No Limit ($0.05/$0.10 USD) - 2021/01/23 15:39:18 ET
Table 'Demoulina III' 6-max Seat #3 is the button
Seat 1: BazKaLT ($10.36 in chips) 
Seat 2: genad ($10 in chips) 
Seat 3: JamesKinder ($11.49 in chips) 
Seat 4: VIOLET 1998 ($13.44 in chips) 
Seat 5: vilemo20 ($10.15 in chips) 
Seat 6: namemattbark ($9.52 in chips) 
VIOLET 1998: posts small blind $0.05
vilemo20: posts big blind $0.10
*** HOLE CARDS ***
namemattbark: folds 
BazKaLT: folds 
genad: folds 
JamesKinder: raises $0.20 to $0.30
VIOLET 1998: calls $0.25
vilemo20: folds 
*** FLOP *** [Qs 4d 2s]
VIOLET 1998: bets $0.67
JamesKinder: folds 
Uncalled bet ($0.67) returned to VIOLET 1998
VIOLET 1998 collected $0.67 from pot
VIOLET 1998: doesn't show hand 
*** SUMMARY ***
Total pot $0.70 | Rake $0.03 
Board [Qs 4d 2s]
Seat 1: BazKaLT folded before Flop (didn't bet)
Seat 2: genad folded before Flop (didn't bet)
Seat 3: JamesKinder (button) folded on the Flop
Seat 4: VIOLET 1998 (small blind) collected ($0.67)
Seat 5: vilemo20 (big blind) folded before Flop
Seat 6: namemattbark folded before Flop (didn't bet)



PokerStars Hand #222969876589:  Hold'em No Limit ($0.05/$0.10 USD) - 2021/01/23 15:39:47 ET
Table 'Demoulina III' 6-max Seat #4 is the button
Seat 1: BazKaLT ($10.36 in chips) 
Seat 2: genad ($10 in chips) 
Seat 3: JamesKinder ($11.19 in chips) 
Seat 4: VIOLET 1998 ($13.81 in chips) 
Seat 5: vilemo20 ($10.05 in chips) 
Seat 6: namemattbark ($9.52 in chips) 
vilemo20: posts small blind $0.05
namemattbark: posts big blind $0.10
*** HOLE CARDS ***
BazKaLT: folds 
genad: folds 
JamesKinder: folds 
VIOLET 1998: folds 
vilemo20: folds 
Uncalled bet ($0.05) returned to namemattbark
namemattbark collected $0.10 from pot
namemattbark: doesn't show hand 
*** SUMMARY ***
Total pot $0.10 | Rake $0 
Seat 1: BazKaLT folded before Flop (didn't bet)
Seat 2: genad folded before Flop (didn't bet)
Seat 3: JamesKinder folded before Flop (didn't bet)
Seat 4: VIOLET 1998 (button) folded before Flop (didn't bet)
Seat 5: vilemo20 (small blind) folded before Flop
Seat 6: namemattbark (big blind) collected ($0.10)



PokerStars Hand #222969882965:  Hold'em No Limit ($0.05/$0.10 USD) - 2021/01/23 15:39:54 ET
Table 'Demoulina III' 6-max Seat #5 is the button
Seat 1: BazKaLT ($10.36 in chips) 
Seat 2: genad ($10 in chips) 
Seat 3: JamesKinder ($11.19 in chips) 
Seat 4: VIOLET 1998 ($13.81 in chips) 
Seat 5: vilemo20 ($10 in chips) 
Seat 6: namemattbark ($9.57 in chips) 
namemattbark: posts small blind $0.05
BazKaLT: posts big blind $0.10
*** HOLE CARDS ***
genad: raises $0.15 to $0.25
JamesKinder: folds 
VIOLET 1998: folds 
vilemo20: folds 
namemattbark: folds 
BazKaLT: folds 
Uncalled bet ($0.15) returned to genad
genad collected $0.25 from pot
genad: doesn't show hand 
*** SUMMARY ***
Total pot $0.25 | Rake $0 
Seat 1: BazKaLT (big blind) folded before Flop
Seat 2: genad collected ($0.25)
Seat 3: JamesKinder folded before Flop (didn't bet)
Seat 4: VIOLET 1998 folded before Flop (didn't bet)
Seat 5: vilemo20 (button) folded before Flop (didn't bet)
Seat 6: namemattbark (small blind) folded before Flop



PokerStars Hand #222969901764:  Hold'em No Limit ($0.05/$0.10 USD) - 2021/01/23 15:40:17 ET
Table 'Demoulina III' 6-max Seat #6 is the button
Seat 1: BazKaLT ($10.26 in chips) 
Seat 2: genad ($10.15 in chips) 
Seat 3: JamesKinder ($11.19 in chips) 
Seat 4: VIOLET 1998 ($13.81 in chips) 
Seat 5: vilemo20 ($10 in chips) 
Seat 6: namemattbark ($9.52 in chips) 
BazKaLT: posts small blind $0.05
genad: posts big blind $0.10
*** HOLE CARDS ***
JamesKinder: folds 
VIOLET 1998 has timed out
VIOLET 1998: folds 
vilemo20: folds 
namemattbark: folds 
BazKaLT: raises $0.15 to $0.25
genad: folds 
Uncalled bet ($0.15) returned to BazKaLT
BazKaLT collected $0.20 from pot
BazKaLT: doesn't show hand 
*** SUMMARY ***
Total pot $0.20 | Rake $0 
Seat 1: BazKaLT (small blind) collected ($0.20)
Seat 2: genad (big blind) folded before Flop
Seat 3: JamesKinder folded before Flop (didn't bet)
Seat 4: VIOLET 1998 folded before Flop (didn't bet)
Seat 5: vilemo20 folded before Flop (didn't bet)
Seat 6: namemattbark (button) folded before Flop (didn't bet)



PokerStars Hand #222969920710:  Hold'em No Limit ($0.05/$0.10 USD) - 2021/01/23 15:40:39 ET
Table 'Demoulina III' 6-max Seat #1 is the button
Seat 1: BazKaLT ($10.36 in chips) 
Seat 2: genad ($10.05 in chips) 
Seat 3: JamesKinder ($11.19 in chips) 
Seat 4: VIOLET 1998 ($13.81 in chips) 
Seat 5: vilemo20 ($10 in chips) 
Seat 6: namemattbark ($9.52 in chips) 
genad: posts small blind $0.05
JamesKinder: posts big blind $0.10
*** HOLE CARDS ***
VIOLET 1998 has timed out
VIOLET 1998: folds 
vilemo20: folds 
namemattbark: folds 
BazKaLT: raises $0.15 to $0.25
genad: folds 
JamesKinder: folds 
Uncalled bet ($0.15) returned to BazKaLT
BazKaLT collected $0.25 from pot
BazKaLT: doesn't show hand 
*** SUMMARY ***
Total pot $0.25 | Rake $0 
Seat 1: BazKaLT (button) collected ($0.25)
Seat 2: genad (small blind) folded before Flop
Seat 3: JamesKinder (big blind) folded before Flop
Seat 4: VIOLET 1998 folded before Flop (didn't bet)
Seat 5: vilemo20 folded before Flop (didn't bet)
Seat 6: namemattbark folded before Flop (didn't bet)



PokerStars Hand #222969937798:  Hold'em No Limit ($0.05/$0.10 USD) - 2021/01/23 15:40:59 ET
Table 'Demoulina III' 6-max Seat #2 is the button
Seat 1: BazKaLT ($10.51 in chips) 
Seat 2: genad ($10 in chips) 
Seat 3: JamesKinder ($11.09 in chips) 
Seat 6: namemattbark ($9.52 in chips) 
JamesKinder: posts small blind $0.05
vilemo20: is sitting out 
namemattbark: posts big blind $0.10
*** HOLE CARDS ***
BazKaLT: folds 
genad: folds 
JamesKinder: folds 
Uncalled bet ($0.05) returned to namemattbark
namemattbark collected $0.10 from pot
namemattbark: doesn't show hand 
*** SUMMARY ***
Total pot $0.10 | Rake $0 
Seat 1: BazKaLT folded before Flop (didn't bet)
Seat 2: genad (button) folded before Flop (didn't bet)
Seat 3: JamesKinder (small blind) folded before Flop
Seat 6: namemattbark (big blind) collected ($0.10)



PokerStars Hand #222969945170:  Hold'em No Limit ($0.05/$0.10 USD) - 2021/01/23 15:41:08 ET
Table 'Demoulina III' 6-max Seat #3 is the button
Seat 2: genad ($10 in chips) 
Seat 3: JamesKinder ($11.04 in chips) 
Seat 6: namemattbark ($9.57 in chips) 
namemattbark: posts small blind $0.05
BazKaLT: is sitting out 
genad: posts big blind $0.10
*** HOLE CARDS ***
vilemo20 leaves the table
JamesKinder: folds 
namemattbark: folds 
Uncalled bet ($0.05) returned to genad
BazKaLT leaves the table
genad collected $0.10 from pot
genad: doesn't show hand 
*** SUMMARY ***
Total pot $0.10 | Rake $0 
Seat 2: genad (big blind) collected ($0.10)
Seat 3: JamesKinder (button) folded before Flop (didn't bet)
Seat 6: namemattbark (small blind) folded before Flop



PokerStars Hand #222969949514:  Hold'em No Limit ($0.05/$0.10 USD) - 2021/01/23 15:41:13 ET
Table 'Demoulina III' 6-max Seat #6 is the button
Seat 2: genad ($10.05 in chips) 
Seat 3: JamesKinder ($11.04 in chips) 
Seat 6: namemattbark ($9.52 in chips) 
genad: posts small blind $0.05
JamesKinder: posts big blind $0.10
*** HOLE CARDS ***
namemattbark: folds 
genad: folds 
Uncalled bet ($0.05) returned to JamesKinder
JamesKinder collected $0.10 from pot
JamesKinder: doesn't show hand 
*** SUMMARY ***
Total pot $0.10 | Rake $0 
Seat 2: genad (small blind) folded before Flop
Seat 3: JamesKinder (big blind) collected ($0.10)
Seat 6: namemattbark (button) folded before Flop (didn't bet)



PokerStars Hand #222969956569:  Hold'em No Limit ($0.05/$0.10 USD) - 2021/01/23 15:41:22 ET
Table 'Demoulina III' 6-max Seat #2 is the button
Seat 2: genad ($10 in chips) 
Seat 3: JamesKinder ($11.09 in chips) 
Seat 6: namemattbark ($9.52 in chips) 
JamesKinder: posts small blind $0.05
namemattbark: posts big blind $0.10
*** HOLE CARDS ***
genad: raises $0.15 to $0.25
JamesKinder: folds 
namemattbark: folds 
Uncalled bet ($0.15) returned to genad
genad collected $0.25 from pot
genad: doesn't show hand 
*** SUMMARY ***
Total pot $0.25 | Rake $0 
Seat 2: genad (button) collected ($0.25)
Seat 3: JamesKinder (small blind) folded before Flop
Seat 6: namemattbark (big blind) folded before Flop



PokerStars Hand #222969960872:  Hold'em No Limit ($0.05/$0.10 USD) - 2021/01/23 15:41:27 ET
Table 'Demoulina III' 6-max Seat #3 is the button
Seat 2: genad ($10.15 in chips) 
Seat 3: JamesKinder ($11.04 in chips) 
Seat 6: namemattbark ($9.42 in chips) 
namemattbark: posts small blind $0.05
genad: posts big blind $0.10
*** HOLE CARDS ***
JamesKinder: raises $0.20 to $0.30
namemattbark: folds 
genad: folds 
Uncalled bet ($0.20) returned to JamesKinder
JamesKinder collected $0.25 from pot
JamesKinder: doesn't show hand 
*** SUMMARY ***
Total pot $0.25 | Rake $0 
Seat 2: genad (big blind) folded before Flop
Seat 3: JamesKinder (button) collected ($0.25)
Seat 6: namemattbark (small blind) folded before Flop



PokerStars Hand #222969966126:  Hold'em No Limit ($0.05/$0.10 USD) - 2021/01/23 15:41:33 ET
Table 'Demoulina III' 6-max Seat #6 is the button
Seat 2: genad ($10.05 in chips) 
Seat 3: JamesKinder ($11.19 in chips) 
Seat 6: namemattbark ($9.37 in chips) 
genad: posts small blind $0.05
JamesKinder: posts big blind $0.10
VIOLET 1998: sits out 
*** HOLE CARDS ***
namemattbark: folds 
genad: folds 
Uncalled bet ($0.05) returned to JamesKinder
JamesKinder collected $0.10 from pot
JamesKinder: doesn't show hand 
*** SUMMARY ***
Total pot $0.10 | Rake $0 
Seat 2: genad (small blind) folded before Flop
Seat 3: JamesKinder (big blind) collected ($0.10)
Seat 6: namemattbark (button) folded before Flop (didn't bet)



PokerStars Hand #222969969662:  Hold'em No Limit ($0.05/$0.10 USD) - 2021/01/23 15:41:37 ET
Table 'Demoulina III' 6-max Seat #2 is the button
Seat 2: genad ($10 in chips) 
Seat 3: JamesKinder ($11.24 in chips) 
Seat 4: VIOLET 1998 ($13.81 in chips) 
Seat 6: namemattbark ($9.37 in chips) 
JamesKinder: posts small blind $0.05
VIOLET 1998: posts big blind $0.10
*** HOLE CARDS ***
namemattbark: raises $0.13 to $0.23
genad: folds 
JamesKinder: folds 
ATbr1 joins the table at seat #1 
VIOLET 1998: calls $0.13
*** FLOP *** [6h 6d 4s]
johnpsg joins the table at seat #5 
VIOLET 1998: checks 
namemattbark: bets $0.27
VIOLET 1998: calls $0.27
*** TURN *** [6h 6d 4s] [Ac]
VIOLET 1998: bets $0.50
namemattbark: folds 
Uncalled bet ($0.50) returned to VIOLET 1998
VIOLET 1998 collected $1 from pot
VIOLET 1998: doesn't show hand 
*** SUMMARY ***
Total pot $1.05 | Rake $0.05 
Board [6h 6d 4s Ac]
Seat 2: genad (button) folded before Flop (didn't bet)
Seat 3: JamesKinder (small blind) folded before Flop
Seat 4: VIOLET 1998 (big blind) collected ($1)
Seat 6: namemattbark folded on the Turn



PokerStars Hand #222969992942:  Hold'em No Limit ($0.05/$0.10 USD) - 2021/01/23 15:42:05 ET
Table 'Demoulina III' 6-max Seat #3 is the button
Seat 1: ATbr1 ($8 in chips) 
Seat 2: genad ($10 in chips) 
Seat 3: JamesKinder ($11.19 in chips) 
Seat 4: VIOLET 1998 ($14.31 in chips) 
Seat 5: johnpsg ($10 in chips) 
Seat 6: namemattbark ($8.87 in chips) 
VIOLET 1998: posts small blind $0.05
johnpsg: posts big blind $0.10
ATbr1: posts big blind $0.10
*** HOLE CARDS ***
namemattbark: folds 
ATbr1: checks 
genad: folds 
JamesKinder: raises $0.20 to $0.30
VIOLET 1998: calls $0.25
johnpsg: folds 
ATbr1: calls $0.20
*** FLOP *** [8c 4c 7h]
VIOLET 1998: checks 
ATbr1: checks 
JamesKinder: bets $0.50
VIOLET 1998: folds 
ATbr1: folds 
Uncalled bet ($0.50) returned to JamesKinder
JamesKinder collected $0.96 from pot
JamesKinder: doesn't show hand 
*** SUMMARY ***
Total pot $1 | Rake $0.04 
Board [8c 4c 7h]
Seat 1: ATbr1 folded on the Flop
Seat 2: genad folded before Flop (didn't bet)
Seat 3: JamesKinder (button) collected ($0.96)
Seat 4: VIOLET 1998 (small blind) folded on the Flop
Seat 5: johnpsg (big blind) folded before Flop
Seat 6: namemattbark folded before Flop (didn't bet)



PokerStars Hand #222970024379:  Hold'em No Limit ($0.05/$0.10 USD) - 2021/01/23 15:42:42 ET
Table 'Demoulina III' 6-max Seat #4 is the button
Seat 1: ATbr1 ($7.70 in chips) 
Seat 2: genad ($10 in chips) 
Seat 3: JamesKinder ($11.85 in chips) 
Seat 4: VIOLET 1998 ($14.01 in chips) 
Seat 5: johnpsg ($10 in chips) 
Seat 6: namemattbark ($8.87 in chips) 
johnpsg: posts small blind $0.05
namemattbark: posts big blind $0.10
*** HOLE CARDS ***
ATbr1: raises $0.10 to $0.20
genad: raises $0.50 to $0.70
JamesKinder: folds 
VIOLET 1998: folds 
johnpsg: folds 
namemattbark: folds 
ATbr1: calls $0.50
*** FLOP *** [8h Jc Kh]
ATbr1: checks 
genad: bets $0.99
ATbr1: folds 
Uncalled bet ($0.99) returned to genad
genad collected $1.48 from pot
genad: doesn't show hand 
*** SUMMARY ***
Total pot $1.55 | Rake $0.07 
Board [8h Jc Kh]
Seat 1: ATbr1 folded on the Flop
Seat 2: genad collected ($1.48)
Seat 3: JamesKinder folded before Flop (didn't bet)
Seat 4: VIOLET 1998 (button) folded before Flop (didn't bet)
Seat 5: johnpsg (small blind) folded before Flop
Seat 6: namemattbark (big blind) folded before Flop



PokerStars Hand #222970048641:  Hold'em No Limit ($0.05/$0.10 USD) - 2021/01/23 15:43:11 ET
Table 'Demoulina III' 6-max Seat #5 is the button
Seat 1: ATbr1 ($7 in chips) 
Seat 2: genad ($10.78 in chips) 
Seat 3: JamesKinder ($11.85 in chips) 
Seat 4: VIOLET 1998 ($14.01 in chips) 
Seat 5: johnpsg ($10 in chips) 
Seat 6: namemattbark ($8.77 in chips) 
namemattbark: posts small blind $0.05
ATbr1: posts big blind $0.10
*** HOLE CARDS ***
genad: raises $0.15 to $0.25
JamesKinder: folds 
VIOLET 1998: folds 
johnpsg: folds 
namemattbark: folds 
ATbr1: calls $0.15
*** FLOP *** [8s 2c 7s]
ATbr1: checks 
genad: bets $0.20
ATbr1: folds 
Uncalled bet ($0.20) returned to genad
genad collected $0.53 from pot
genad: doesn't show hand 
*** SUMMARY ***
Total pot $0.55 | Rake $0.02 
Board [8s 2c 7s]
Seat 1: ATbr1 (big blind) folded on the Flop
Seat 2: genad collected ($0.53)
Seat 3: JamesKinder folded before Flop (didn't bet)
Seat 4: VIOLET 1998 folded before Flop (didn't bet)
Seat 5: johnpsg (button) folded before Flop (didn't bet)
Seat 6: namemattbark (small blind) folded before Flop



PokerStars Hand #222970076754:  Hold'em No Limit ($0.05/$0.10 USD) - 2021/01/23 15:43:44 ET
Table 'Demoulina III' 6-max Seat #6 is the button
Seat 1: ATbr1 ($6.75 in chips) 
Seat 2: genad ($11.06 in chips) 
Seat 3: JamesKinder ($11.85 in chips) 
Seat 4: VIOLET 1998 ($14.01 in chips) 
Seat 5: johnpsg ($10 in chips) 
Seat 6: namemattbark ($8.72 in chips) 
ATbr1: posts small blind $0.05
genad: posts big blind $0.10
*** HOLE CARDS ***
JamesKinder: folds 
VIOLET 1998: calls $0.10
johnpsg: folds 
namemattbark: raises $0.13 to $0.23
ATbr1: folds 
genad: calls $0.13
VIOLET 1998: calls $0.13
*** FLOP *** [2c Qd 4s]
genad: checks 
VIOLET 1998: checks 
namemattbark: checks 
*** TURN *** [2c Qd 4s] [As]
genad: checks 
VIOLET 1998: checks 
namemattbark: bets $0.53
genad: folds 
VIOLET 1998: calls $0.53
*** RIVER *** [2c Qd 4s As] [3s]
VIOLET 1998: bets $1.72
namemattbark: calls $1.72
*** SHOW DOWN ***
VIOLET 1998: shows [3c 3d] (three of a kind, Threes)
namemattbark: mucks hand 
VIOLET 1998 collected $5 from pot
*** SUMMARY ***
Total pot $5.24 | Rake $0.24 
Board [2c Qd 4s As 3s]
Seat 1: ATbr1 (small blind) folded before Flop
Seat 2: genad (big blind) folded on the Turn
Seat 3: JamesKinder folded before Flop (didn't bet)
Seat 4: VIOLET 1998 showed [3c 3d] and won ($5) with three of a kind, Threes
Seat 5: johnpsg folded before Flop (didn't bet)
Seat 6: namemattbark (button) mucked



PokerStars Hand #222970114859:  Hold'em No Limit ($0.05/$0.10 USD) - 2021/01/23 15:44:29 ET
Table 'Demoulina III' 6-max Seat #1 is the button
Seat 1: ATbr1 ($6.70 in chips) 
Seat 2: genad ($10.83 in chips) 
Seat 3: JamesKinder ($11.85 in chips) 
Seat 4: VIOLET 1998 ($16.53 in chips) 
Seat 5: johnpsg ($10 in chips) 
Seat 6: namemattbark ($6.24 in chips) 
genad: posts small blind $0.05
JamesKinder: posts big blind $0.10
*** HOLE CARDS ***
VIOLET 1998: folds 
johnpsg: folds 
namemattbark: folds 
ATbr1: calls $0.10
genad: folds 
JamesKinder: checks 
*** FLOP *** [Tc Ah 5c]
JamesKinder: checks 
ATbr1: checks 
*** TURN *** [Tc Ah 5c] [Qd]
JamesKinder: bets $0.12
ATbr1: calls $0.12
*** RIVER *** [Tc Ah 5c Qd] [Qc]
JamesKinder: checks 
ATbr1: bets $0.50
JamesKinder: folds 
Uncalled bet ($0.50) returned to ATbr1
ATbr1 collected $0.47 from pot
ATbr1: doesn't show hand 
*** SUMMARY ***
Total pot $0.49 | Rake $0.02 
Board [Tc Ah 5c Qd Qc]
Seat 1: ATbr1 (button) collected ($0.47)
Seat 2: genad (small blind) folded before Flop
Seat 3: JamesKinder (big blind) folded on the River
Seat 4: VIOLET 1998 folded before Flop (didn't bet)
Seat 5: johnpsg folded before Flop (didn't bet)
Seat 6: namemattbark folded before Flop (didn't bet)



PokerStars Hand #222970156197:  Hold'em No Limit ($0.05/$0.10 USD) - 2021/01/23 15:45:19 ET
Table 'Demoulina III' 6-max Seat #2 is the button
Seat 1: ATbr1 ($6.95 in chips) 
Seat 2: genad ($10.78 in chips) 
Seat 3: JamesKinder ($11.63 in chips) 
Seat 4: VIOLET 1998 ($16.53 in chips) 
Seat 5: johnpsg ($10 in chips) 
Seat 6: namemattbark ($6.24 in chips) 
JamesKinder: posts small blind $0.05
VIOLET 1998: posts big blind $0.10
*** HOLE CARDS ***
johnpsg: raises $0.17 to $0.27
namemattbark: raises $0.69 to $0.96
ATbr1: folds 
genad: folds 
JamesKinder: folds 
VIOLET 1998: folds 
johnpsg: folds 
Uncalled bet ($0.69) returned to namemattbark
namemattbark collected $0.69 from pot
namemattbark: doesn't show hand 
*** SUMMARY ***
Total pot $0.69 | Rake $0 
Seat 1: ATbr1 folded before Flop (didn't bet)
Seat 2: genad (button) folded before Flop (didn't bet)
Seat 3: JamesKinder (small blind) folded before Flop
Seat 4: VIOLET 1998 (big blind) folded before Flop
Seat 5: johnpsg folded before Flop
Seat 6: namemattbark collected ($0.69)



PokerStars Hand #222970178814:  Hold'em No Limit ($0.05/$0.10 USD) - 2021/01/23 15:45:46 ET
Table 'Demoulina III' 6-max Seat #3 is the button
Seat 1: ATbr1 ($6.95 in chips) 
Seat 2: genad ($10.78 in chips) 
Seat 3: JamesKinder ($11.58 in chips) 
Seat 4: VIOLET 1998 ($16.43 in chips) 
Seat 5: johnpsg ($10 in chips) 
Seat 6: namemattbark ($6.66 in chips) 
VIOLET 1998: posts small blind $0.05
johnpsg: posts big blind $0.10
*** HOLE CARDS ***
namemattbark: folds 
ATbr1: calls $0.10
genad: folds 
JamesKinder: raises $0.20 to $0.30
VIOLET 1998: folds 
johnpsg: folds 
ATbr1: calls $0.20
*** FLOP *** [5s 6c 7h]
ATbr1: checks 
JamesKinder: bets $0.37
ATbr1: folds 
Uncalled bet ($0.37) returned to JamesKinder
JamesKinder collected $0.72 from pot
JamesKinder: doesn't show hand 
*** SUMMARY ***
Total pot $0.75 | Rake $0.03 
Board [5s 6c 7h]
Seat 1: ATbr1 folded on the Flop
Seat 2: genad folded before Flop (didn't bet)
Seat 3: JamesKinder (button) collected ($0.72)
Seat 4: VIOLET 1998 (small blind) folded before Flop
Seat 5: johnpsg (big blind) folded before Flop
Seat 6: namemattbark folded before Flop (didn't bet)



PokerStars Hand #222970201393:  Hold'em No Limit ($0.05/$0.10 USD) - 2021/01/23 15:46:12 ET
Table 'Demoulina III' 6-max Seat #4 is the button
Seat 1: ATbr1 ($6.65 in chips) 
Seat 2: genad ($10.78 in chips) 
Seat 3: JamesKinder ($12 in chips) 
Seat 4: VIOLET 1998 ($16.38 in chips) 
Seat 5: johnpsg ($10 in chips) 
Seat 6: namemattbark ($6.66 in chips) 
johnpsg: posts small blind $0.05
namemattbark: posts big blind $0.10
*** HOLE CARDS ***
ATbr1: calls $0.10
genad: folds 
JamesKinder: raises $0.20 to $0.30
VIOLET 1998: folds 
johnpsg: calls $0.25
namemattbark: folds 
ATbr1: calls $0.20
*** FLOP *** [Ad 6h 5c]
johnpsg: checks 
ATbr1: checks 
JamesKinder: bets $0.29
johnpsg: folds 
ATbr1: calls $0.29
*** TURN *** [Ad 6h 5c] [4d]
ATbr1: checks 
JamesKinder: checks 
*** RIVER *** [Ad 6h 5c 4d] [Qh]
ATbr1: checks 
JamesKinder: bets $0.45
ATbr1: folds 
Uncalled bet ($0.45) returned to JamesKinder
JamesKinder collected $1.51 from pot
JamesKinder: doesn't show hand 
*** SUMMARY ***
Total pot $1.58 | Rake $0.07 
Board [Ad 6h 5c 4d Qh]
Seat 1: ATbr1 folded on the River
Seat 2: genad folded before Flop (didn't bet)
Seat 3: JamesKinder collected ($1.51)
Seat 4: VIOLET 1998 (button) folded before Flop (didn't bet)
Seat 5: johnpsg (small blind) folded on the Flop
Seat 6: namemattbark (big blind) folded before Flop



PokerStars Hand #222970248031:  Hold'em No Limit ($0.05/$0.10 USD) - 2021/01/23 15:47:08 ET
Table 'Demoulina III' 6-max Seat #5 is the button
Seat 1: ATbr1 ($6.06 in chips) 
Seat 2: genad ($10.78 in chips) 
Seat 3: JamesKinder ($12.92 in chips) 
Seat 4: VIOLET 1998 ($16.38 in chips) 
Seat 5: johnpsg ($10 in chips) 
Seat 6: namemattbark ($6.56 in chips) 
namemattbark: posts small blind $0.05
ATbr1: posts big blind $0.10
*** HOLE CARDS ***
genad: folds 
JamesKinder: folds 
VIOLET 1998: raises $0.25 to $0.35
johnpsg: folds 
namemattbark: folds 
ATbr1: calls $0.25
*** FLOP *** [Ac Jd 2c]
ATbr1: checks 
VIOLET 1998: checks 
*** TURN *** [Ac Jd 2c] [Jc]
ATbr1: checks 
VIOLET 1998: checks 
*** RIVER *** [Ac Jd 2c Jc] [2h]
ATbr1: bets $0.70
VIOLET 1998: calls $0.70
*** SHOW DOWN ***
ATbr1: shows [9h Jh] (a full house, Jacks full of Deuces)
VIOLET 1998: mucks hand 
ATbr1 collected $2.05 from pot
*** SUMMARY ***
Total pot $2.15 | Rake $0.10 
Board [Ac Jd 2c Jc 2h]
Seat 1: ATbr1 (big blind) showed [9h Jh] and won ($2.05) with a full house, Jacks full of Deuces
Seat 2: genad folded before Flop (didn't bet)
Seat 3: JamesKinder folded before Flop (didn't bet)
Seat 4: VIOLET 1998 mucked
Seat 5: johnpsg (button) folded before Flop (didn't bet)
Seat 6: namemattbark (small blind) folded before Flop



PokerStars Hand #222970273608:  Hold'em No Limit ($0.05/$0.10 USD) - 2021/01/23 15:47:39 ET
Table 'Demoulina III' 6-max Seat #6 is the button
Seat 1: ATbr1 ($7.06 in chips) 
Seat 2: genad ($10.78 in chips) 
Seat 3: JamesKinder ($12.92 in chips) 
Seat 4: VIOLET 1998 ($15.33 in chips) 
Seat 5: johnpsg ($10 in chips) 
Seat 6: namemattbark ($6.51 in chips) 
ATbr1: posts small blind $0.05
genad: posts big blind $0.10
*** HOLE CARDS ***
JamesKinder: raises $0.20 to $0.30
VIOLET 1998: folds 
johnpsg: folds 
namemattbark: folds 
ATbr1: calls $0.25
genad: calls $0.20
*** FLOP *** [7h Kd 2s]
ATbr1: checks 
genad: checks 
JamesKinder: checks 
*** TURN *** [7h Kd 2s] [4s]
ATbr1: checks 
genad: checks 
JamesKinder: checks 
*** RIVER *** [7h Kd 2s 4s] [5c]
ATbr1: checks 
genad: checks 
JamesKinder: checks 
*** SHOW DOWN ***
ATbr1: shows [6h Jh] (high card King)
genad: shows [5s Qs] (a pair of Fives)
JamesKinder: mucks hand 
genad collected $0.86 from pot
*** SUMMARY ***
Total pot $0.90 | Rake $0.04 
Board [7h Kd 2s 4s 5c]
Seat 1: ATbr1 (small blind) showed [6h Jh] and lost with high card King
Seat 2: genad (big blind) showed [5s Qs] and won ($0.86) with a pair of Fives
Seat 3: JamesKinder mucked
Seat 4: VIOLET 1998 folded before Flop (didn't bet)
Seat 5: johnpsg folded before Flop (didn't bet)
Seat 6: namemattbark (button) folded before Flop (didn't bet)



PokerStars Hand #222970304945:  Hold'em No Limit ($0.05/$0.10 USD) - 2021/01/23 15:48:17 ET
Table 'Demoulina III' 6-max Seat #1 is the button
Seat 1: ATbr1 ($6.76 in chips) 
Seat 2: genad ($11.34 in chips) 
Seat 3: JamesKinder ($12.62 in chips) 
Seat 4: VIOLET 1998 ($15.33 in chips) 
Seat 5: johnpsg ($10 in chips) 
Seat 6: namemattbark ($6.51 in chips) 
genad: posts small blind $0.05
JamesKinder: posts big blind $0.10
*** HOLE CARDS ***
VIOLET 1998: raises $0.20 to $0.30
johnpsg: folds 
namemattbark: calls $0.30
ATbr1: calls $0.30
genad: folds 
JamesKinder: raises $0.80 to $1.10
VIOLET 1998: calls $0.80
namemattbark: calls $0.80
ATbr1: calls $0.80
*** FLOP *** [3d Qh Ad]
JamesKinder: checks 
VIOLET 1998: bets $3
namemattbark: calls $3
ATbr1: folds 
JamesKinder: folds 
*** TURN *** [3d Qh Ad] [4c]
VIOLET 1998: checks 
namemattbark: checks 
*** RIVER *** [3d Qh Ad 4c] [5d]
VIOLET 1998: bets $4.99
namemattbark: calls $2.41 and is all-in
Uncalled bet ($2.58) returned to VIOLET 1998
*** SHOW DOWN ***
VIOLET 1998: shows [Qc Ac] (two pair, Aces and Queens)
namemattbark: shows [2s As] (a straight, Ace to Five)
namemattbark collected $14.58 from pot
*** SUMMARY ***
Total pot $15.27 | Rake $0.69 
Board [3d Qh Ad 4c 5d]
Seat 1: ATbr1 (button) folded on the Flop
Seat 2: genad (small blind) folded before Flop
Seat 3: JamesKinder (big blind) folded on the Flop
Seat 4: VIOLET 1998 showed [Qc Ac] and lost with two pair, Aces and Queens
Seat 5: johnpsg folded before Flop (didn't bet)
Seat 6: namemattbark showed [2s As] and won ($14.58) with a straight, Ace to Five



PokerStars Hand #222970374672:  Hold'em No Limit ($0.05/$0.10 USD) - 2021/01/23 15:49:40 ET
Table 'Demoulina III' 6-max Seat #2 is the button
Seat 1: ATbr1 ($5.66 in chips) 
Seat 2: genad ($11.29 in chips) 
Seat 3: JamesKinder ($11.52 in chips) 
Seat 4: VIOLET 1998 ($8.82 in chips) 
Seat 5: johnpsg ($10 in chips) 
Seat 6: namemattbark ($14.58 in chips) 
JamesKinder: posts small blind $0.05
VIOLET 1998: posts big blind $0.10
*** HOLE CARDS ***
johnpsg: folds 
namemattbark: folds 
ATbr1: calls $0.10
genad: folds 
JamesKinder: folds 
VIOLET 1998: raises $0.25 to $0.35
ATbr1: calls $0.25
*** FLOP *** [As 2s 2h]
VIOLET 1998: bets $0.36
ATbr1: calls $0.36
*** TURN *** [As 2s 2h] [5d]
VIOLET 1998: bets $0.70
ATbr1: calls $0.70
*** RIVER *** [As 2s 2h 5d] [6h]
VIOLET 1998: checks 
ATbr1: bets $1.10
VIOLET 1998: calls $1.10
*** SHOW DOWN ***
ATbr1: shows [Ac 6c] (two pair, Aces and Sixes)
VIOLET 1998: mucks hand 
ATbr1 collected $4.84 from pot
*** SUMMARY ***
Total pot $5.07 | Rake $0.23 
Board [As 2s 2h 5d 6h]
Seat 1: ATbr1 showed [Ac 6c] and won ($4.84) with two pair, Aces and Sixes
Seat 2: genad (button) folded before Flop (didn't bet)
Seat 3: JamesKinder (small blind) folded before Flop
Seat 4: VIOLET 1998 (big blind) mucked
Seat 5: johnpsg folded before Flop (didn't bet)
Seat 6: namemattbark folded before Flop (didn't bet)



PokerStars Hand #222970442234:  Hold'em No Limit ($0.05/$0.10 USD) - 2021/01/23 15:51:02 ET
Table 'Demoulina III' 6-max Seat #3 is the button
Seat 1: ATbr1 ($7.99 in chips) 
Seat 2: genad ($11.29 in chips) 
Seat 3: JamesKinder ($11.47 in chips) 
Seat 4: VIOLET 1998 ($6.31 in chips) 
Seat 5: johnpsg ($10 in chips) 
Seat 6: namemattbark ($14.58 in chips) 
VIOLET 1998: posts small blind $0.05
johnpsg: posts big blind $0.10
*** HOLE CARDS ***
namemattbark: folds 
ATbr1: folds 
genad: folds 
JamesKinder: folds 
VIOLET 1998: raises $0.10 to $0.20
johnpsg: folds 
Uncalled bet ($0.10) returned to VIOLET 1998
VIOLET 1998 collected $0.20 from pot
VIOLET 1998: doesn't show hand 
*** SUMMARY ***
Total pot $0.20 | Rake $0 
Seat 1: ATbr1 folded before Flop (didn't bet)
Seat 2: genad folded before Flop (didn't bet)
Seat 3: JamesKinder (button) folded before Flop (didn't bet)
Seat 4: VIOLET 1998 (small blind) collected ($0.20)
Seat 5: johnpsg (big blind) folded before Flop
Seat 6: namemattbark folded before Flop (didn't bet)



PokerStars Hand #222970453611:  Hold'em No Limit ($0.05/$0.10 USD) - 2021/01/23 15:51:15 ET
Table 'Demoulina III' 6-max Seat #4 is the button
Seat 1: ATbr1 ($7.99 in chips) 
Seat 2: genad ($11.29 in chips) 
Seat 3: JamesKinder ($11.47 in chips) 
Seat 4: VIOLET 1998 ($6.41 in chips) 
Seat 5: johnpsg ($10 in chips) 
Seat 6: namemattbark ($14.58 in chips) 
johnpsg: posts small blind $0.05
namemattbark: posts big blind $0.10
*** HOLE CARDS ***
ATbr1: calls $0.10
genad: raises $0.30 to $0.40
JamesKinder: folds 
VIOLET 1998: calls $0.40
johnpsg: folds 
namemattbark: folds 
ATbr1: calls $0.30
*** FLOP *** [6h 4c Kc]
ATbr1: checks 
genad: checks 
VIOLET 1998: bets $0.64
ATbr1: folds 
genad: folds 
Uncalled bet ($0.64) returned to VIOLET 1998
VIOLET 1998 collected $1.29 from pot
VIOLET 1998: doesn't show hand 
*** SUMMARY ***
Total pot $1.35 | Rake $0.06 
Board [6h 4c Kc]
Seat 1: ATbr1 folded on the Flop
Seat 2: genad folded on the Flop
Seat 3: JamesKinder folded before Flop (didn't bet)
Seat 4: VIOLET 1998 (button) collected ($1.29)
Seat 5: johnpsg (small blind) folded before Flop
Seat 6: namemattbark (big blind) folded before Flop



PokerStars Hand #222970488108:  Hold'em No Limit ($0.05/$0.10 USD) - 2021/01/23 15:51:56 ET
Table 'Demoulina III' 6-max Seat #5 is the button
Seat 1: ATbr1 ($7.59 in chips) 
Seat 2: genad ($10.89 in chips) 
Seat 3: JamesKinder ($11.47 in chips) 
Seat 4: VIOLET 1998 ($7.30 in chips) 
Seat 5: johnpsg ($10 in chips) 
Seat 6: namemattbark ($14.48 in chips) 
namemattbark: posts small blind $0.05
ATbr1: posts big blind $0.10
*** HOLE CARDS ***
genad: folds 
JamesKinder: raises $0.20 to $0.30
VIOLET 1998: folds 
johnpsg: folds 
namemattbark: folds 
ATbr1: raises $0.20 to $0.50
JamesKinder: calls $0.20
*** FLOP *** [5h 3s 2h]
ATbr1: bets $0.50
JamesKinder: folds 
Uncalled bet ($0.50) returned to ATbr1
ATbr1 collected $1 from pot
ATbr1: doesn't show hand 
*** SUMMARY ***
Total pot $1.05 | Rake $0.05 
Board [5h 3s 2h]
Seat 1: ATbr1 (big blind) collected ($1)
Seat 2: genad folded before Flop (didn't bet)
Seat 3: JamesKinder folded on the Flop
Seat 4: VIOLET 1998 folded before Flop (didn't bet)
Seat 5: johnpsg (button) folded before Flop (didn't bet)
Seat 6: namemattbark (small blind) folded before Flop



PokerStars Hand #222970527607:  Hold'em No Limit ($0.05/$0.10 USD) - 2021/01/23 15:52:44 ET
Table 'Demoulina III' 6-max Seat #6 is the button
Seat 1: ATbr1 ($8.09 in chips) 
Seat 2: genad ($10.89 in chips) 
Seat 3: JamesKinder ($10.97 in chips) 
Seat 4: VIOLET 1998 ($7.30 in chips) 
Seat 5: johnpsg ($10 in chips) 
Seat 6: namemattbark ($14.43 in chips) 
ATbr1: posts small blind $0.05
genad: posts big blind $0.10
*** HOLE CARDS ***
JamesKinder: folds 
VIOLET 1998 has timed out
VIOLET 1998: folds 
johnpsg: folds 
namemattbark: folds 
ATbr1: raises $0.20 to $0.30
genad: folds 
Uncalled bet ($0.20) returned to ATbr1
ATbr1 collected $0.20 from pot
ATbr1: doesn't show hand 
*** SUMMARY ***
Total pot $0.20 | Rake $0 
Seat 1: ATbr1 (small blind) collected ($0.20)
Seat 2: genad (big blind) folded before Flop
Seat 3: JamesKinder folded before Flop (didn't bet)
Seat 4: VIOLET 1998 folded before Flop (didn't bet)
Seat 5: johnpsg folded before Flop (didn't bet)
Seat 6: namemattbark (button) folded before Flop (didn't bet)



PokerStars Hand #222970548557:  Hold'em No Limit ($0.05/$0.10 USD) - 2021/01/23 15:53:09 ET
Table 'Demoulina III' 6-max Seat #1 is the button
Seat 1: ATbr1 ($8.19 in chips) 
Seat 2: genad ($10.79 in chips) 
Seat 3: JamesKinder ($10.97 in chips) 
Seat 4: VIOLET 1998 ($7.30 in chips) 
Seat 5: johnpsg ($10 in chips) 
Seat 6: namemattbark ($14.43 in chips) 
genad: posts small blind $0.05
JamesKinder: posts big blind $0.10
*** HOLE CARDS ***
VIOLET 1998: calls $0.10
johnpsg: folds 
namemattbark: folds 
ATbr1: calls $0.10
genad: folds 
JamesKinder: checks 
*** FLOP *** [Jh Th 6h]
JamesKinder: checks 
VIOLET 1998: bets $0.33
ATbr1: calls $0.33
JamesKinder: folds 
*** TURN *** [Jh Th 6h] [3c]
VIOLET 1998: bets $0.48
ATbr1: calls $0.48
*** RIVER *** [Jh Th 6h 3c] [8d]
VIOLET 1998: checks 
ATbr1: checks 
*** SHOW DOWN ***
VIOLET 1998: shows [Qh Js] (a pair of Jacks)
ATbr1: mucks hand 
VIOLET 1998 collected $1.88 from pot
*** SUMMARY ***
Total pot $1.97 | Rake $0.09 
Board [Jh Th 6h 3c 8d]
Seat 1: ATbr1 (button) mucked
Seat 2: genad (small blind) folded before Flop
Seat 3: JamesKinder (big blind) folded on the Flop
Seat 4: VIOLET 1998 showed [Qh Js] and won ($1.88) with a pair of Jacks
Seat 5: johnpsg folded before Flop (didn't bet)
Seat 6: namemattbark folded before Flop (didn't bet)



PokerStars Hand #222970593585:  Hold'em No Limit ($0.05/$0.10 USD) - 2021/01/23 15:54:03 ET
Table 'Demoulina III' 6-max Seat #2 is the button
Seat 1: ATbr1 ($7.28 in chips) 
Seat 2: genad ($10.74 in chips) 
Seat 3: JamesKinder ($10.87 in chips) 
Seat 4: VIOLET 1998 ($8.27 in chips) 
Seat 5: johnpsg ($10 in chips) 
Seat 6: namemattbark ($14.43 in chips) 
JamesKinder: posts small blind $0.05
VIOLET 1998: posts big blind $0.10
*** HOLE CARDS ***
johnpsg: folds 
namemattbark: folds 
ATbr1: calls $0.10
genad: folds 
JamesKinder: raises $0.20 to $0.30
VIOLET 1998: calls $0.20
ATbr1: calls $0.20
*** FLOP *** [Qc 9d 2c]
JamesKinder: checks 
VIOLET 1998: bets $0.86
ATbr1: folds 
JamesKinder: calls $0.86
*** TURN *** [Qc 9d 2c] [5s]
JamesKinder: checks 
VIOLET 1998: bets $0.50
JamesKinder: calls $0.50
*** RIVER *** [Qc 9d 2c 5s] [5d]
JamesKinder: checks 
VIOLET 1998: checks 
*** SHOW DOWN ***
JamesKinder: shows [7c Ac] (a pair of Fives)
VIOLET 1998: shows [Jd Qh] (two pair, Queens and Fives)
VIOLET 1998 collected $3.46 from pot
*** SUMMARY ***
Total pot $3.62 | Rake $0.16 
Board [Qc 9d 2c 5s 5d]
Seat 1: ATbr1 folded on the Flop
Seat 2: genad (button) folded before Flop (didn't bet)
Seat 3: JamesKinder (small blind) showed [7c Ac] and lost with a pair of Fives
Seat 4: VIOLET 1998 (big blind) showed [Jd Qh] and won ($3.46) with two pair, Queens and Fives
Seat 5: johnpsg folded before Flop (didn't bet)
Seat 6: namemattbark folded before Flop (didn't bet)



PokerStars Hand #222970625482:  Hold'em No Limit ($0.05/$0.10 USD) - 2021/01/23 15:54:42 ET
Table 'Demoulina III' 6-max Seat #3 is the button
Seat 1: ATbr1 ($6.98 in chips) 
Seat 2: genad ($10.74 in chips) 
Seat 3: JamesKinder ($9.21 in chips) 
Seat 4: VIOLET 1998 ($10.07 in chips) 
Seat 5: johnpsg ($10 in chips) 
Seat 6: namemattbark ($14.43 in chips) 
VIOLET 1998: posts small blind $0.05
johnpsg: posts big blind $0.10
*** HOLE CARDS ***
namemattbark: raises $0.13 to $0.23
ATbr1: folds 
genad: folds 
JamesKinder: folds 
VIOLET 1998: folds 
johnpsg: folds 
Uncalled bet ($0.13) returned to namemattbark
VIOLET 1998 leaves the table
namemattbark collected $0.25 from pot
namemattbark: doesn't show hand 
*** SUMMARY ***
Total pot $0.25 | Rake $0 
Seat 1: ATbr1 folded before Flop (didn't bet)
Seat 2: genad folded before Flop (didn't bet)
Seat 3: JamesKinder (button) folded before Flop (didn't bet)
Seat 4: VIOLET 1998 (small blind) folded before Flop
Seat 5: johnpsg (big blind) folded before Flop
Seat 6: namemattbark collected ($0.25)



PokerStars Hand #222970645583:  Hold'em No Limit ($0.05/$0.10 USD) - 2021/01/23 15:55:06 ET
Table 'Demoulina III' 6-max Seat #5 is the button
Seat 1: ATbr1 ($6.98 in chips) 
Seat 2: genad ($10.74 in chips) 
Seat 3: JamesKinder ($9.21 in chips) 
Seat 5: johnpsg ($10 in chips) 
Seat 6: namemattbark ($14.58 in chips) 
namemattbark: posts small blind $0.05
ATbr1: posts big blind $0.10
*** HOLE CARDS ***
catchwatcher joins the table at seat #4 
genad: folds 
JamesKinder: folds 
johnpsg: folds 
namemattbark: raises $0.13 to $0.23
ATbr1: calls $0.13
*** FLOP *** [3c 4h 4c]
namemattbark: checks 
ATbr1: checks 
*** TURN *** [3c 4h 4c] [Qs]
namemattbark: checks 
ATbr1: checks 
*** RIVER *** [3c 4h 4c Qs] [Ts]
namemattbark: checks 
ATbr1: checks 
*** SHOW DOWN ***
namemattbark: shows [Kc Jh] (a pair of Fours)
ATbr1: mucks hand 
namemattbark collected $0.44 from pot
*** SUMMARY ***
Total pot $0.46 | Rake $0.02 
Board [3c 4h 4c Qs Ts]
Seat 1: ATbr1 (big blind) mucked
Seat 2: genad folded before Flop (didn't bet)
Seat 3: JamesKinder folded before Flop (didn't bet)
Seat 5: johnpsg (button) folded before Flop (didn't bet)
Seat 6: namemattbark (small blind) showed [Kc Jh] and won ($0.44) with a pair of Fours



PokerStars Hand #222970663648:  Hold'em No Limit ($0.05/$0.10 USD) - 2021/01/23 15:55:37 ET
Table 'Demoulina III' 6-max Seat #6 is the button
Seat 1: ATbr1 ($6.75 in chips) 
Seat 3: JamesKinder ($9.21 in chips) 
Seat 5: johnpsg ($10 in chips) 
Seat 6: namemattbark ($14.79 in chips) 
ATbr1: posts small blind $0.05
genad: is sitting out 
JamesKinder: posts big blind $0.10
catchwatcher: sits out 
*** HOLE CARDS ***
johnpsg: folds 
namemattbark: folds 
ATbr1: calls $0.05
JamesKinder: raises $0.20 to $0.30
ATbr1: calls $0.20
*** FLOP *** [7d Kh Ah]
ATbr1: checks 
JamesKinder: bets $0.30
ATbr1: folds 
Uncalled bet ($0.30) returned to JamesKinder
JamesKinder collected $0.57 from pot
JamesKinder: doesn't show hand 
*** SUMMARY ***
Total pot $0.60 | Rake $0.03 
Board [7d Kh Ah]
Seat 1: ATbr1 (small blind) folded on the Flop
Seat 3: JamesKinder (big blind) collected ($0.57)
Seat 5: johnpsg folded before Flop (didn't bet)
Seat 6: namemattbark (button) folded before Flop (didn't bet)



PokerStars Hand #222970674272:  Hold'em No Limit ($0.05/$0.10 USD) - 2021/01/23 15:55:56 ET
Table 'Demoulina III' 6-max Seat #1 is the button
Seat 1: ATbr1 ($6.45 in chips) 
Seat 3: JamesKinder ($9.48 in chips) 
Seat 4: catchwatcher ($8 in chips) 
Seat 5: johnpsg ($10 in chips) 
Seat 6: namemattbark ($14.79 in chips) 
JamesKinder: posts small blind $0.05
catchwatcher: posts big blind $0.10
*** HOLE CARDS ***
johnpsg: raises $0.17 to $0.27
namemattbark: folds 
ATbr1: calls $0.27
genad leaves the table
JamesKinder: raises $0.73 to $1
catchwatcher: calls $0.90
johnpsg: folds 
ATbr1: folds 
*** FLOP *** [Tc Ah 5h]
JamesKinder: bets $0.73
rogdor30 joins the table at seat #2 
catchwatcher: calls $0.73
*** TURN *** [Tc Ah 5h] [6h]
JamesKinder: checks 
catchwatcher: bets $3.82
JamesKinder: folds 
Uncalled bet ($3.82) returned to catchwatcher
catchwatcher collected $3.82 from pot
catchwatcher: doesn't show hand 
*** SUMMARY ***
Total pot $4 | Rake $0.18 
Board [Tc Ah 5h 6h]
Seat 1: ATbr1 (button) folded before Flop
Seat 3: JamesKinder (small blind) folded on the Turn
Seat 4: catchwatcher (big blind) collected ($3.82)
Seat 5: johnpsg folded before Flop
Seat 6: namemattbark folded before Flop (didn't bet)



PokerStars Hand #222970714990:  Hold'em No Limit ($0.05/$0.10 USD) - 2021/01/23 15:56:59 ET
Table 'Demoulina III' 6-max Seat #3 is the button
Seat 1: ATbr1 ($6.18 in chips) 
Seat 3: JamesKinder ($7.75 in chips) 
Seat 4: catchwatcher ($10.09 in chips) 
Seat 5: johnpsg ($10 in chips) 
Seat 6: namemattbark ($14.79 in chips) 
catchwatcher: posts small blind $0.05
johnpsg: posts big blind $0.10
rogdor30: sits out 
*** HOLE CARDS ***
namemattbark: folds 
ATbr1: calls $0.10
JamesKinder: folds 
catchwatcher: folds 
johnpsg: raises $0.30 to $0.40
ATbr1: calls $0.30
*** FLOP *** [9d 2c As]
johnpsg: bets $0.30
ATbr1: calls $0.30
*** TURN *** [9d 2c As] [Kc]
johnpsg: bets $0.69
ATbr1: raises $0.69 to $1.38
johnpsg: calls $0.69
*** RIVER *** [9d 2c As Kc] [Th]
johnpsg: checks 
ATbr1: bets $0.90
johnpsg: raises $7.02 to $7.92 and is all-in
ATbr1: calls $3.20 and is all-in
Uncalled bet ($3.82) returned to johnpsg
*** SHOW DOWN ***
johnpsg: shows [Kd Ad] (two pair, Aces and Kings)
ATbr1: shows [Ac Tc] (two pair, Aces and Tens)
johnpsg collected $11.85 from pot
*** SUMMARY ***
Total pot $12.41 | Rake $0.56 
Board [9d 2c As Kc Th]
Seat 1: ATbr1 showed [Ac Tc] and lost with two pair, Aces and Tens
Seat 3: JamesKinder (button) folded before Flop (didn't bet)
Seat 4: catchwatcher (small blind) folded before Flop
Seat 5: johnpsg (big blind) showed [Kd Ad] and won ($11.85) with two pair, Aces and Kings
Seat 6: namemattbark folded before Flop (didn't bet)



PokerStars Hand #222970751773:  Hold'em No Limit ($0.05/$0.10 USD) - 2021/01/23 15:58:04 ET
Table 'Demoulina III' 6-max Seat #4 is the button
Seat 3: JamesKinder ($7.75 in chips) 
Seat 4: catchwatcher ($10.04 in chips) 
Seat 5: johnpsg ($15.67 in chips) 
Seat 6: namemattbark ($14.79 in chips) 
johnpsg: posts small blind $0.05
namemattbark: posts big blind $0.10
rogdor30: sits out 
*** HOLE CARDS ***
JamesKinder: raises $0.20 to $0.30
ATbr1 leaves the table
catchwatcher: calls $0.30
johnpsg: folds 
cel1974 joins the table at seat #1 
namemattbark: folds 
*** FLOP *** [9h 4h 3s]
JamesKinder: checks 
catchwatcher: bets $0.72
JamesKinder: raises $0.98 to $1.70
catchwatcher: calls $0.98
*** TURN *** [9h 4h 3s] [Kc]
JamesKinder: checks 
namemattbark leaves the table
catchwatcher: checks 
*** RIVER *** [9h 4h 3s Kc] [8s]
JamesKinder: bets $1.19
kilativ7 joins the table at seat #6 
catchwatcher: calls $1.19
*** SHOW DOWN ***
JamesKinder: shows [Tc Ah] (high card Ace)
catchwatcher: shows [Td 9c] (a pair of Nines)
catchwatcher collected $6.24 from pot
*** SUMMARY ***
Total pot $6.53 | Rake $0.29 
Board [9h 4h 3s Kc 8s]
Seat 3: JamesKinder showed [Tc Ah] and lost with high card Ace
Seat 4: catchwatcher (button) showed [Td 9c] and won ($6.24) with a pair of Nines
Seat 5: johnpsg (small blind) folded before Flop
Seat 6: namemattbark (big blind) folded before Flop



PokerStars Hand #222970780290:  Hold'em No Limit ($0.05/$0.10 USD) - 2021/01/23 15:58:54 ET
Table 'Demoulina III' 6-max Seat #5 is the button
Seat 3: JamesKinder ($4.56 in chips) 
Seat 4: catchwatcher ($13.09 in chips) 
Seat 5: johnpsg ($15.62 in chips) 
JamesKinder: posts small blind $0.05
catchwatcher: posts big blind $0.10
*** HOLE CARDS ***
johnpsg: raises $0.13 to $0.23
JamesKinder: folds 
catchwatcher: calls $0.13
*** FLOP *** [Js 8h Ac]
catchwatcher: bets $0.49
johnpsg: calls $0.49
*** TURN *** [Js 8h Ac] [9d]
catchwatcher: bets $1.42
johnpsg: folds 
Uncalled bet ($1.42) returned to catchwatcher
catchwatcher collected $1.42 from pot
catchwatcher: doesn't show hand 
*** SUMMARY ***
Total pot $1.49 | Rake $0.07 
Board [Js 8h Ac 9d]
Seat 3: JamesKinder (small blind) folded before Flop
Seat 4: catchwatcher (big blind) collected ($1.42)
Seat 5: johnpsg (button) folded on the Turn



PokerStars Hand #222970808371:  Hold'em No Limit ($0.05/$0.10 USD) - 2021/01/23 15:59:43 ET
Table 'Demoulina III' 6-max Seat #3 is the button
Seat 3: JamesKinder ($4.51 in chips) 
Seat 4: catchwatcher ($13.79 in chips) 
Seat 5: johnpsg ($14.90 in chips) 
catchwatcher: posts small blind $0.05
johnpsg: posts big blind $0.10
kilativ7: sits out 
cel1974: sits out 
rogdor30: sits out 
*** HOLE CARDS ***
JamesKinder: raises $0.20 to $0.30
catchwatcher: folds 
johnpsg: calls $0.20
*** FLOP *** [As Jc Kh]
johnpsg: checks 
JamesKinder: bets $0.32
johnpsg: calls $0.32
*** TURN *** [As Jc Kh] [Qd]
johnpsg: checks 
JamesKinder: checks 
*** RIVER *** [As Jc Kh Qd] [3c]
johnpsg: checks 
JamesKinder: bets $1.23
rogdor30 leaves the table
johnpsg: folds 
Uncalled bet ($1.23) returned to JamesKinder
JamesKinder collected $1.23 from pot
JamesKinder: doesn't show hand 
*** SUMMARY ***
Total pot $1.29 | Rake $0.06 
Board [As Jc Kh Qd 3c]
Seat 3: JamesKinder (button) collected ($1.23)
Seat 4: catchwatcher (small blind) folded before Flop
Seat 5: johnpsg (big blind) folded on the River



PokerStars Hand #222970838009:  Hold'em No Limit ($0.05/$0.10 USD) - 2021/01/23 16:00:32 ET
Table 'Demoulina III' 6-max Seat #4 is the button
Seat 3: JamesKinder ($5.12 in chips) 
Seat 4: catchwatcher ($13.74 in chips) 
Seat 5: johnpsg ($14.28 in chips) 
Seat 6: kilativ7 ($10 in chips) 
johnpsg: posts small blind $0.05
kilativ7: posts big blind $0.10
cel1974: sits out 
*** HOLE CARDS ***
firstandsole joins the table at seat #2 
JamesKinder: raises $0.20 to $0.30
catchwatcher: calls $0.30
johnpsg: folds 
kilativ7: folds 
*** FLOP *** [Kd 4h Ah]
JamesKinder: bets $0.22
catchwatcher: raises $1.16 to $1.38
JamesKinder: calls $1.16
*** TURN *** [Kd 4h Ah] [5s]
JamesKinder: checks 
catchwatcher: checks 
*** RIVER *** [Kd 4h Ah 5s] [5c]
JamesKinder: bets $1.74
catchwatcher: calls $1.74
*** SHOW DOWN ***
JamesKinder: shows [2c Ad] (two pair, Aces and Fives)
catchwatcher: shows [Ac 6c] (two pair, Aces and Fives)
JamesKinder collected $3.34 from pot
catchwatcher collected $3.34 from pot
*** SUMMARY ***
Total pot $6.99 | Rake $0.31 
Board [Kd 4h Ah 5s 5c]
Seat 3: JamesKinder showed [2c Ad] and won ($3.34) with two pair, Aces and Fives
Seat 4: catchwatcher (button) showed [Ac 6c] and won ($3.34) with two pair, Aces and Fives
Seat 5: johnpsg (small blind) folded before Flop
Seat 6: kilativ7 (big blind) folded before Flop



PokerStars Hand #222970858136:  Hold'em No Limit ($0.05/$0.10 USD) - 2021/01/23 16:01:04 ET
Table 'Demoulina III' 6-max Seat #5 is the button
Seat 1: cel1974 ($10 in chips) 
Seat 3: JamesKinder ($5.04 in chips) 
Seat 4: catchwatcher ($13.66 in chips) 
Seat 5: johnpsg ($14.23 in chips) 
Seat 6: kilativ7 ($10 in chips) 
kilativ7: posts small blind $0.05
cel1974: posts big blind $0.10
firstandsole: sits out 
*** HOLE CARDS ***
JamesKinder: folds 
catchwatcher: folds 
johnpsg: raises $0.13 to $0.23
kilativ7: folds 
cel1974: folds 
Uncalled bet ($0.13) returned to johnpsg
johnpsg collected $0.25 from pot
johnpsg: doesn't show hand 
*** SUMMARY ***
Total pot $0.25 | Rake $0 
Seat 1: cel1974 (big blind) folded before Flop
Seat 3: JamesKinder folded before Flop (didn't bet)
Seat 4: catchwatcher folded before Flop (didn't bet)
Seat 5: johnpsg (button) collected ($0.25)
Seat 6: kilativ7 (small blind) folded before Flop



PokerStars Hand #222970873523:  Hold'em No Limit ($0.05/$0.10 USD) - 2021/01/23 16:01:26 ET
Table 'Demoulina III' 6-max Seat #6 is the button
Seat 1: cel1974 ($10 in chips) 
Seat 2: firstandsole ($10 in chips) 
Seat 3: JamesKinder ($5.04 in chips) 
Seat 4: catchwatcher ($13.66 in chips) 
Seat 5: johnpsg ($14.38 in chips) 
Seat 6: kilativ7 ($10 in chips) 
cel1974: posts small blind $0.05
firstandsole: posts big blind $0.10
*** HOLE CARDS ***
JamesKinder: folds 
catchwatcher: folds 
johnpsg: folds 
kilativ7: folds 
cel1974: folds 
Uncalled bet ($0.05) returned to firstandsole
firstandsole collected $0.10 from pot
firstandsole: doesn't show hand 
*** SUMMARY ***
Total pot $0.10 | Rake $0 
Seat 1: cel1974 (small blind) folded before Flop
Seat 2: firstandsole (big blind) collected ($0.10)
Seat 3: JamesKinder folded before Flop (didn't bet)
Seat 4: catchwatcher folded before Flop (didn't bet)
Seat 5: johnpsg folded before Flop (didn't bet)
Seat 6: kilativ7 (button) folded before Flop (didn't bet)



PokerStars Hand #222970881676:  Hold'em No Limit ($0.05/$0.10 USD) - 2021/01/23 16:01:37 ET
Table 'Demoulina III' 6-max Seat #1 is the button
Seat 1: cel1974 ($10 in chips) 
Seat 2: firstandsole ($10.05 in chips) 
Seat 3: JamesKinder ($5.04 in chips) 
Seat 4: catchwatcher ($13.66 in chips) 
Seat 5: johnpsg ($14.38 in chips) 
Seat 6: kilativ7 ($10 in chips) 
firstandsole: posts small blind $0.05
JamesKinder: posts big blind $0.10
*** HOLE CARDS ***
catchwatcher: raises $0.20 to $0.30
johnpsg: calls $0.30
kilativ7: calls $0.30
cel1974: calls $0.30
firstandsole: calls $0.25
JamesKinder: folds 
*** FLOP *** [4c 7d Kh]
firstandsole: checks 
catchwatcher: bets $1.53
johnpsg: folds 
kilativ7: folds 
cel1974: folds 
firstandsole: folds 
Uncalled bet ($1.53) returned to catchwatcher
catchwatcher collected $1.53 from pot
catchwatcher: doesn't show hand 
*** SUMMARY ***
Total pot $1.60 | Rake $0.07 
Board [4c 7d Kh]
Seat 1: cel1974 (button) folded on the Flop
Seat 2: firstandsole (small blind) folded on the Flop
Seat 3: JamesKinder (big blind) folded before Flop
Seat 4: catchwatcher collected ($1.53)
Seat 5: johnpsg folded on the Flop
Seat 6: kilativ7 folded on the Flop



PokerStars Hand #222970919372:  Hold'em No Limit ($0.05/$0.10 USD) - 2021/01/23 16:02:26 ET
Table 'Demoulina III' 6-max Seat #2 is the button
Seat 1: cel1974 ($10 in chips) 
Seat 2: firstandsole ($10 in chips) 
Seat 3: JamesKinder ($4.94 in chips) 
Seat 4: catchwatcher ($14.89 in chips) 
Seat 5: johnpsg ($14.08 in chips) 
Seat 6: kilativ7 ($10 in chips) 
JamesKinder: posts small blind $0.05
catchwatcher: posts big blind $0.10
*** HOLE CARDS ***
johnpsg: folds 
kilativ7: folds 
cel1974: raises $0.20 to $0.30
firstandsole: folds 
JamesKinder: folds 
catchwatcher: calls $0.20
*** FLOP *** [7c Kd 3h]
catchwatcher: checks 
cel1974: bets $0.47
catchwatcher: folds 
Uncalled bet ($0.47) returned to cel1974
cel1974 collected $0.62 from pot
cel1974: doesn't show hand 
*** SUMMARY ***
Total pot $0.65 | Rake $0.03 
Board [7c Kd 3h]
Seat 1: cel1974 collected ($0.62)
Seat 2: firstandsole (button) folded before Flop (didn't bet)
Seat 3: JamesKinder (small blind) folded before Flop
Seat 4: catchwatcher (big blind) folded on the Flop
Seat 5: johnpsg folded before Flop (didn't bet)
Seat 6: kilativ7 folded before Flop (didn't bet)



PokerStars Hand #222970952995:  Hold'em No Limit ($0.05/$0.10 USD) - 2021/01/23 16:03:08 ET
Table 'Demoulina III' 6-max Seat #3 is the button
Seat 1: cel1974 ($10.32 in chips) 
Seat 2: firstandsole ($10 in chips) 
Seat 3: JamesKinder ($4.89 in chips) 
Seat 4: catchwatcher ($14.59 in chips) 
Seat 5: johnpsg ($14.08 in chips) 
Seat 6: kilativ7 ($10 in chips) 
catchwatcher: posts small blind $0.05
johnpsg: posts big blind $0.10
*** HOLE CARDS ***
kilativ7: folds 
cel1974: raises $0.20 to $0.30
firstandsole: folds 
JamesKinder: calls $0.30
catchwatcher: folds 
johnpsg: folds 
*** FLOP *** [9s 4c 5s]
cel1974: checks 
JamesKinder: checks 
*** TURN *** [9s 4c 5s] [5h]
cel1974: bets $0.48
JamesKinder: folds 
Uncalled bet ($0.48) returned to cel1974
cel1974 collected $0.72 from pot
cel1974: doesn't show hand 
*** SUMMARY ***
Total pot $0.75 | Rake $0.03 
Board [9s 4c 5s 5h]
Seat 1: cel1974 collected ($0.72)
Seat 2: firstandsole folded before Flop (didn't bet)
Seat 3: JamesKinder (button) folded on the Turn
Seat 4: catchwatcher (small blind) folded before Flop
Seat 5: johnpsg (big blind) folded before Flop
Seat 6: kilativ7 folded before Flop (didn't bet)



PokerStars Hand #222970991430:  Hold'em No Limit ($0.05/$0.10 USD) - 2021/01/23 16:03:55 ET
Table 'Demoulina III' 6-max Seat #4 is the button
Seat 1: cel1974 ($10.74 in chips) 
Seat 2: firstandsole ($10 in chips) 
Seat 3: JamesKinder ($4.59 in chips) 
Seat 4: catchwatcher ($14.54 in chips) 
Seat 5: johnpsg ($13.98 in chips) 
Seat 6: kilativ7 ($10 in chips) 
johnpsg: posts small blind $0.05
kilativ7: posts big blind $0.10
*** HOLE CARDS ***
cel1974: folds 
firstandsole: folds 
JamesKinder: folds 
catchwatcher: folds 
johnpsg: raises $0.15 to $0.25
kilativ7: calls $0.15
*** FLOP *** [Kd 7s 2d]
johnpsg: checks 
kilativ7: bets $0.26
johnpsg: calls $0.26
*** TURN *** [Kd 7s 2d] [Ac]
johnpsg: checks 
kilativ7: bets $0.73
johnpsg: calls $0.73
*** RIVER *** [Kd 7s 2d Ac] [4s]
johnpsg: checks 
kilativ7: bets $1.55
johnpsg: folds 
Uncalled bet ($1.55) returned to kilativ7
kilativ7 collected $2.37 from pot
kilativ7: doesn't show hand 
*** SUMMARY ***
Total pot $2.48 | Rake $0.11 
Board [Kd 7s 2d Ac 4s]
Seat 1: cel1974 folded before Flop (didn't bet)
Seat 2: firstandsole folded before Flop (didn't bet)
Seat 3: JamesKinder folded before Flop (didn't bet)
Seat 4: catchwatcher (button) folded before Flop (didn't bet)
Seat 5: johnpsg (small blind) folded on the River
Seat 6: kilativ7 (big blind) collected ($2.37)



PokerStars Hand #222971054360:  Hold'em No Limit ($0.05/$0.10 USD) - 2021/01/23 16:05:10 ET
Table 'Demoulina III' 6-max Seat #5 is the button
Seat 1: cel1974 ($10.74 in chips) 
Seat 2: firstandsole ($10 in chips) 
Seat 3: JamesKinder ($4.59 in chips) 
Seat 4: catchwatcher ($14.54 in chips) 
Seat 5: johnpsg ($12.74 in chips) 
Seat 6: kilativ7 ($11.13 in chips) 
kilativ7: posts small blind $0.05
cel1974: posts big blind $0.10
*** HOLE CARDS ***
firstandsole has timed out
firstandsole: folds 
JamesKinder: folds 
catchwatcher: raises $0.20 to $0.30
johnpsg: folds 
kilativ7: folds 
cel1974: folds 
Uncalled bet ($0.20) returned to catchwatcher
catchwatcher collected $0.25 from pot
catchwatcher: doesn't show hand 
*** SUMMARY ***
Total pot $0.25 | Rake $0 
Seat 1: cel1974 (big blind) folded before Flop
Seat 2: firstandsole folded before Flop (didn't bet)
Seat 3: JamesKinder folded before Flop (didn't bet)
Seat 4: catchwatcher collected ($0.25)
Seat 5: johnpsg (button) folded before Flop (didn't bet)
Seat 6: kilativ7 (small blind) folded before Flop



PokerStars Hand #222971073552:  Hold'em No Limit ($0.05/$0.10 USD) - 2021/01/23 16:05:33 ET
Table 'Demoulina III' 6-max Seat #6 is the button
Seat 1: cel1974 ($10.64 in chips) 
Seat 2: firstandsole ($10 in chips) 
Seat 3: JamesKinder ($4.59 in chips) 
Seat 4: catchwatcher ($14.69 in chips) 
Seat 5: johnpsg ($12.74 in chips) 
Seat 6: kilativ7 ($11.08 in chips) 
cel1974: posts small blind $0.05
firstandsole: posts big blind $0.10
*** HOLE CARDS ***
JamesKinder: raises $0.20 to $0.30
catchwatcher: calls $0.30
johnpsg: raises $0.90 to $1.20
kilativ7: folds 
cel1974: folds 
firstandsole: folds 
JamesKinder: calls $0.90
catchwatcher: folds 
*** FLOP *** [6h 5c 6s]
JamesKinder: bets $0.82
johnpsg: calls $0.82
*** TURN *** [6h 5c 6s] [9c]
JamesKinder: checks 
johnpsg: bets $2.15
JamesKinder: raises $0.42 to $2.57 and is all-in
johnpsg: calls $0.42
*** RIVER *** [6h 5c 6s 9c] [7c]
*** SHOW DOWN ***
JamesKinder: shows [Ah Kd] (a pair of Sixes)
johnpsg: shows [Jc Jd] (two pair, Jacks and Sixes)
johnpsg collected $9.20 from pot
*** SUMMARY ***
Total pot $9.63 | Rake $0.43 
Board [6h 5c 6s 9c 7c]
Seat 1: cel1974 (small blind) folded before Flop
Seat 2: firstandsole (big blind) folded before Flop
Seat 3: JamesKinder showed [Ah Kd] and lost with a pair of Sixes
Seat 4: catchwatcher folded before Flop
Seat 5: johnpsg showed [Jc Jd] and won ($9.20) with two pair, Jacks and Sixes
Seat 6: kilativ7 (button) folded before Flop (didn't bet)



PokerStars Hand #222971117835:  Hold'em No Limit ($0.05/$0.10 USD) - 2021/01/23 16:06:26 ET
Table 'Demoulina III' 6-max Seat #1 is the button
Seat 1: cel1974 ($10.59 in chips) 
Seat 2: firstandsole ($10 in chips) 
Seat 4: catchwatcher ($14.39 in chips) 
Seat 5: johnpsg ($17.35 in chips) 
Seat 6: kilativ7 ($11.08 in chips) 
firstandsole: posts small blind $0.05
catchwatcher: posts big blind $0.10
*** HOLE CARDS ***
johnpsg: folds 
kilativ7: raises $0.15 to $0.25
JamesKinder leaves the table
cel1974: folds 
firstandsole: raises $0.75 to $1
catchwatcher: folds 
kilativ7: calls $0.75
*** FLOP *** [Qc Jh 3c]
firstandsole: bets $1.40
Mighty_Rams joins the table at seat #3 
kilativ7: folds 
Uncalled bet ($1.40) returned to firstandsole
firstandsole collected $2.01 from pot
firstandsole: doesn't show hand 
*** SUMMARY ***
Total pot $2.10 | Rake $0.09 
Board [Qc Jh 3c]
Seat 1: cel1974 (button) folded before Flop (didn't bet)
Seat 2: firstandsole (small blind) collected ($2.01)
Seat 4: catchwatcher (big blind) folded before Flop
Seat 5: johnpsg folded before Flop (didn't bet)
Seat 6: kilativ7 folded on the Flop



PokerStars Hand #222971147519:  Hold'em No Limit ($0.05/$0.10 USD) - 2021/01/23 16:07:02 ET
Table 'Demoulina III' 6-max Seat #2 is the button
Seat 1: cel1974 ($10.59 in chips) 
Seat 2: firstandsole ($11.01 in chips) 
Seat 4: catchwatcher ($14.29 in chips) 
Seat 5: johnpsg ($17.35 in chips) 
Seat 6: kilativ7 ($10.08 in chips) 
catchwatcher: posts small blind $0.05
johnpsg: posts big blind $0.10
*** HOLE CARDS ***
kilativ7: folds 
cel1974: folds 
firstandsole: folds 
catchwatcher: raises $0.10 to $0.20
johnpsg: folds 
Uncalled bet ($0.10) returned to catchwatcher
catchwatcher collected $0.20 from pot
catchwatcher: doesn't show hand 
*** SUMMARY ***
Total pot $0.20 | Rake $0 
Seat 1: cel1974 folded before Flop (didn't bet)
Seat 2: firstandsole (button) folded before Flop (didn't bet)
Seat 4: catchwatcher (small blind) collected ($0.20)
Seat 5: johnpsg (big blind) folded before Flop
Seat 6: kilativ7 folded before Flop (didn't bet)



PokerStars Hand #222971157481:  Hold'em No Limit ($0.05/$0.10 USD) - 2021/01/23 16:07:14 ET
Table 'Demoulina III' 6-max Seat #4 is the button
Seat 1: cel1974 ($10.59 in chips) 
Seat 2: firstandsole ($11.01 in chips) 
Seat 3: Mighty_Rams ($10 in chips) 
Seat 4: catchwatcher ($14.39 in chips) 
Seat 5: johnpsg ($17.25 in chips) 
Seat 6: kilativ7 ($10.08 in chips) 
johnpsg: posts small blind $0.05
kilativ7: posts big blind $0.10
Mighty_Rams: posts big blind $0.10
*** HOLE CARDS ***
cel1974: folds 
firstandsole: folds 
Mighty_Rams: checks 
catchwatcher: raises $0.10 to $0.20
johnpsg: folds 
kilativ7: folds 
Mighty_Rams: calls $0.10
*** FLOP *** [Ac Qd 9s]
Mighty_Rams: bets $0.20
catchwatcher: raises $0.93 to $1.13
Mighty_Rams: calls $0.93
*** TURN *** [Ac Qd 9s] [9c]
Mighty_Rams: checks 
catchwatcher: checks 
*** RIVER *** [Ac Qd 9s 9c] [4d]
Mighty_Rams: bets $0.80
catchwatcher: folds 
Uncalled bet ($0.80) returned to Mighty_Rams
Mighty_Rams collected $2.68 from pot
*** SUMMARY ***
Total pot $2.81 | Rake $0.13 
Board [Ac Qd 9s 9c 4d]
Seat 1: cel1974 folded before Flop (didn't bet)
Seat 2: firstandsole folded before Flop (didn't bet)
Seat 3: Mighty_Rams collected ($2.68)
Seat 4: catchwatcher (button) folded on the River
Seat 5: johnpsg (small blind) folded before Flop
Seat 6: kilativ7 (big blind) folded before Flop



PokerStars Hand #222971206546:  Hold'em No Limit ($0.05/$0.10 USD) - 2021/01/23 16:08:13 ET
Table 'Demoulina III' 6-max Seat #5 is the button
Seat 1: cel1974 ($10.59 in chips) 
Seat 2: firstandsole ($11.01 in chips) 
Seat 3: Mighty_Rams ($11.35 in chips) 
Seat 4: catchwatcher ($13.06 in chips) 
Seat 5: johnpsg ($17.20 in chips) 
Seat 6: kilativ7 ($10 in chips) 
kilativ7: posts small blind $0.05
cel1974: posts big blind $0.10
*** HOLE CARDS ***
firstandsole: folds 
Mighty_Rams: folds 
catchwatcher: raises $0.10 to $0.20
johnpsg: folds 
kilativ7: folds 
cel1974: folds 
Uncalled bet ($0.10) returned to catchwatcher
catchwatcher collected $0.25 from pot
catchwatcher: doesn't show hand 
*** SUMMARY ***
Total pot $0.25 | Rake $0 
Seat 1: cel1974 (big blind) folded before Flop
Seat 2: firstandsole folded before Flop (didn't bet)
Seat 3: Mighty_Rams folded before Flop (didn't bet)
Seat 4: catchwatcher collected ($0.25)
Seat 5: johnpsg (button) folded before Flop (didn't bet)
Seat 6: kilativ7 (small blind) folded before Flop



PokerStars Hand #222971758241:  Hold'em No Limit ($0.05/$0.10 USD) - 2021/01/23 16:19:00 ET
Table 'Demoulina III' 6-max Seat #4 is the button
Seat 1: cel1974 ($10 in chips) 
Seat 2: firstandsole ($10.26 in chips) 
Seat 3: Mighty_Rams ($12.28 in chips) 
Seat 4: catchwatcher ($16.34 in chips) 
Seat 5: johnpsg ($15.33 in chips) 
Seat 6: kilativ7 ($10.37 in chips) 
johnpsg: posts small blind $0.05
kilativ7: posts big blind $0.10
*** HOLE CARDS ***
cel1974: folds 
firstandsole: folds 
Mighty_Rams: calls $0.10
catchwatcher: folds 
johnpsg: calls $0.05
kilativ7: checks 
*** FLOP *** [5h Jh Ad]
johnpsg: checks 
kilativ7: bets $0.16
Mighty_Rams: folds 
johnpsg: calls $0.16
*** TURN *** [5h Jh Ad] [Ah]
johnpsg: checks 
kilativ7: bets $0.32
johnpsg: calls $0.32
*** RIVER *** [5h Jh Ad Ah] [4d]
johnpsg: checks 
kilativ7: checks 
*** SHOW DOWN ***
johnpsg: shows [Th 8h] (a flush, Ace high)
kilativ7: mucks hand 
johnpsg collected $1.20 from pot
*** SUMMARY ***
Total pot $1.26 | Rake $0.06 
Board [5h Jh Ad Ah 4d]
Seat 1: cel1974 folded before Flop (didn't bet)
Seat 2: firstandsole folded before Flop (didn't bet)
Seat 3: Mighty_Rams folded on the Flop
Seat 4: catchwatcher (button) folded before Flop (didn't bet)
Seat 5: johnpsg (small blind) showed [Th 8h] and won ($1.20) with a flush, Ace high
Seat 6: kilativ7 (big blind) mucked



PokerStars Hand #222971795822:  Hold'em No Limit ($0.05/$0.10 USD) - 2021/01/23 16:19:43 ET
Table 'Demoulina III' 6-max Seat #5 is the button
Seat 1: cel1974 ($10 in chips) 
Seat 2: firstandsole ($10.26 in chips) 
Seat 3: Mighty_Rams ($12.18 in chips) 
Seat 4: catchwatcher ($16.34 in chips) 
Seat 5: johnpsg ($15.95 in chips) 
Seat 6: kilativ7 ($10 in chips) 
kilativ7: posts small blind $0.05
cel1974: posts big blind $0.10
*** HOLE CARDS ***
firstandsole: raises $0.20 to $0.30
Mighty_Rams: folds 
catchwatcher: folds 
johnpsg: folds 
kilativ7: folds 
cel1974: folds 
Uncalled bet ($0.20) returned to firstandsole
firstandsole collected $0.25 from pot
firstandsole: doesn't show hand 
*** SUMMARY ***
Total pot $0.25 | Rake $0 
Seat 1: cel1974 (big blind) folded before Flop
Seat 2: firstandsole collected ($0.25)
Seat 3: Mighty_Rams folded before Flop (didn't bet)
Seat 4: catchwatcher folded before Flop (didn't bet)
Seat 5: johnpsg (button) folded before Flop (didn't bet)
Seat 6: kilativ7 (small blind) folded before Flop



PokerStars Hand #222971813753:  Hold'em No Limit ($0.05/$0.10 USD) - 2021/01/23 16:20:04 ET
Table 'Demoulina III' 6-max Seat #6 is the button
Seat 1: cel1974 ($10 in chips) 
Seat 2: firstandsole ($10.41 in chips) 
Seat 3: Mighty_Rams ($12.18 in chips) 
Seat 4: catchwatcher ($16.34 in chips) 
Seat 5: johnpsg ($15.95 in chips) 
Seat 6: kilativ7 ($10 in chips) 
cel1974: posts small blind $0.05
firstandsole: posts big blind $0.10
*** HOLE CARDS ***
Mighty_Rams: folds 
catchwatcher: raises $0.10 to $0.20
johnpsg: folds 
kilativ7: folds 
cel1974: folds 
firstandsole: calls $0.10
*** FLOP *** [Js 7s Ad]
firstandsole: checks 
catchwatcher: checks 
*** TURN *** [Js 7s Ad] [Td]
firstandsole: bets $0.55
catchwatcher: calls $0.55
*** RIVER *** [Js 7s Ad Td] [7h]
firstandsole: bets $2.20
catchwatcher: folds 
Uncalled bet ($2.20) returned to firstandsole
firstandsole collected $1.48 from pot
firstandsole: doesn't show hand 
*** SUMMARY ***
Total pot $1.55 | Rake $0.07 
Board [Js 7s Ad Td 7h]
Seat 1: cel1974 (small blind) folded before Flop
Seat 2: firstandsole (big blind) collected ($1.48)
Seat 3: Mighty_Rams folded before Flop (didn't bet)
Seat 4: catchwatcher folded on the River
Seat 5: johnpsg folded before Flop (didn't bet)
Seat 6: kilativ7 (button) folded before Flop (didn't bet)



PokerStars Hand #222971857740:  Hold'em No Limit ($0.05/$0.10 USD) - 2021/01/23 16:20:55 ET
Table 'Demoulina III' 6-max Seat #1 is the button
Seat 1: cel1974 ($10 in chips) 
Seat 2: firstandsole ($11.14 in chips) 
Seat 3: Mighty_Rams ($12.18 in chips) 
Seat 4: catchwatcher ($15.59 in chips) 
Seat 5: johnpsg ($15.95 in chips) 
Seat 6: kilativ7 ($10 in chips) 
firstandsole: posts small blind $0.05
Mighty_Rams: posts big blind $0.10
*** HOLE CARDS ***
catchwatcher: folds 
johnpsg: folds 
kilativ7: raises $0.15 to $0.25
cel1974: calls $0.25
firstandsole: folds 
Mighty_Rams: calls $0.15
*** FLOP *** [2s 8c As]
Mighty_Rams: checks 
kilativ7: bets $0.50
cel1974: folds 
Mighty_Rams: folds 
Uncalled bet ($0.50) returned to kilativ7
kilativ7 collected $0.76 from pot
kilativ7: doesn't show hand 
*** SUMMARY ***
Total pot $0.80 | Rake $0.04 
Board [2s 8c As]
Seat 1: cel1974 (button) folded on the Flop
Seat 2: firstandsole (small blind) folded before Flop
Seat 3: Mighty_Rams (big blind) folded on the Flop
Seat 4: catchwatcher folded before Flop (didn't bet)
Seat 5: johnpsg folded before Flop (didn't bet)
Seat 6: kilativ7 collected ($0.76)



PokerStars Hand #222971889588:  Hold'em No Limit ($0.05/$0.10 USD) - 2021/01/23 16:21:32 ET
Table 'Demoulina III' 6-max Seat #2 is the button
Seat 1: cel1974 ($10 in chips) 
Seat 2: firstandsole ($11.09 in chips) 
Seat 3: Mighty_Rams ($11.93 in chips) 
Seat 4: catchwatcher ($15.59 in chips) 
Seat 5: johnpsg ($15.95 in chips) 
Seat 6: kilativ7 ($10.51 in chips) 
Mighty_Rams: posts small blind $0.05
catchwatcher: posts big blind $0.10
*** HOLE CARDS ***
johnpsg: raises $0.17 to $0.27
kilativ7: folds 
cel1974: folds 
firstandsole: folds 
Mighty_Rams: calls $0.22
catchwatcher: calls $0.17
*** FLOP *** [Jh 9d 6s]
Mighty_Rams: checks 
catchwatcher: bets $0.77
johnpsg: folds 
Mighty_Rams: calls $0.77
*** TURN *** [Jh 9d 6s] [2c]
Mighty_Rams: checks 
catchwatcher: bets $2.24
Mighty_Rams: folds [Ad]
Uncalled bet ($2.24) returned to catchwatcher
catchwatcher collected $2.24 from pot
catchwatcher: doesn't show hand 
*** SUMMARY ***
Total pot $2.35 | Rake $0.11 
Board [Jh 9d 6s 2c]
Seat 1: cel1974 folded before Flop (didn't bet)
Seat 2: firstandsole (button) folded before Flop (didn't bet)
Seat 3: Mighty_Rams (small blind) folded on the Turn
Seat 4: catchwatcher (big blind) collected ($2.24)
Seat 5: johnpsg folded on the Flop
Seat 6: kilativ7 folded before Flop (didn't bet)



PokerStars Hand #222971928006:  Hold'em No Limit ($0.05/$0.10 USD) - 2021/01/23 16:22:17 ET
Table 'Demoulina III' 6-max Seat #3 is the button
Seat 1: cel1974 ($10 in chips) 
Seat 2: firstandsole ($11.09 in chips) 
Seat 3: Mighty_Rams ($10.89 in chips) 
Seat 4: catchwatcher ($16.79 in chips) 
Seat 5: johnpsg ($15.68 in chips) 
Seat 6: kilativ7 ($10.51 in chips) 
catchwatcher: posts small blind $0.05
johnpsg: posts big blind $0.10
*** HOLE CARDS ***
kilativ7: raises $0.20 to $0.30
cel1974: folds 
firstandsole: folds 
Mighty_Rams: folds 
catchwatcher: calls $0.25
johnpsg: folds 
*** FLOP *** [7s Th 9d]
catchwatcher: checks 
kilativ7: checks 
*** TURN *** [7s Th 9d] [Ac]
catchwatcher: bets $0.67
kilativ7: folds 
Uncalled bet ($0.67) returned to catchwatcher
catchwatcher collected $0.67 from pot
catchwatcher: doesn't show hand 
*** SUMMARY ***
Total pot $0.70 | Rake $0.03 
Board [7s Th 9d Ac]
Seat 1: cel1974 folded before Flop (didn't bet)
Seat 2: firstandsole folded before Flop (didn't bet)
Seat 3: Mighty_Rams (button) folded before Flop (didn't bet)
Seat 4: catchwatcher (small blind) collected ($0.67)
Seat 5: johnpsg (big blind) folded before Flop
Seat 6: kilativ7 folded on the Turn



PokerStars Hand #222971953134:  Hold'em No Limit ($0.05/$0.10 USD) - 2021/01/23 16:22:46 ET
Table 'Demoulina III' 6-max Seat #4 is the button
Seat 1: cel1974 ($10 in chips) 
Seat 2: firstandsole ($11.09 in chips) 
Seat 3: Mighty_Rams ($10.89 in chips) 
Seat 4: catchwatcher ($17.16 in chips) 
Seat 5: johnpsg ($15.58 in chips) 
Seat 6: kilativ7 ($10.21 in chips) 
johnpsg: posts small blind $0.05
kilativ7: posts big blind $0.10
*** HOLE CARDS ***
cel1974: folds 
firstandsole: folds 
Mighty_Rams: calls $0.10
catchwatcher: calls $0.10
johnpsg: folds 
kilativ7: checks 
*** FLOP *** [Js 3c 2d]
kilativ7: checks 
Mighty_Rams: checks 
catchwatcher: checks 
*** TURN *** [Js 3c 2d] [7d]
kilativ7: bets $0.18
Mighty_Rams: folds 
catchwatcher: calls $0.18
*** RIVER *** [Js 3c 2d 7d] [Td]
kilativ7: checks 
catchwatcher: checks 
*** SHOW DOWN ***
kilativ7: shows [8h 8d] (a pair of Eights)
catchwatcher: mucks hand 
kilativ7 collected $0.68 from pot
*** SUMMARY ***
Total pot $0.71 | Rake $0.03 
Board [Js 3c 2d 7d Td]
Seat 1: cel1974 folded before Flop (didn't bet)
Seat 2: firstandsole folded before Flop (didn't bet)
Seat 3: Mighty_Rams folded on the Turn
Seat 4: catchwatcher (button) mucked
Seat 5: johnpsg (small blind) folded before Flop
Seat 6: kilativ7 (big blind) showed [8h 8d] and won ($0.68) with a pair of Eights



PokerStars Hand #222971999633:  Hold'em No Limit ($0.05/$0.10 USD) - 2021/01/23 16:23:32 ET
Table 'Demoulina III' 6-max Seat #5 is the button
Seat 1: cel1974 ($10 in chips) 
Seat 2: firstandsole ($11.09 in chips) 
Seat 3: Mighty_Rams ($10.79 in chips) 
Seat 4: catchwatcher ($16.88 in chips) 
Seat 5: johnpsg ($15.53 in chips) 
Seat 6: kilativ7 ($10.61 in chips) 
kilativ7: posts small blind $0.05
cel1974: posts big blind $0.10
*** HOLE CARDS ***
firstandsole: raises $0.20 to $0.30
Mighty_Rams: folds 
catchwatcher: folds 
johnpsg: calls $0.30
kilativ7: folds 
cel1974: folds 
*** FLOP *** [2c Qc Td]
firstandsole: bets $0.57
johnpsg: calls $0.57
*** TURN *** [2c Qc Td] [As]
firstandsole: checks 
johnpsg: bets $0.90
firstandsole: calls $0.90
*** RIVER *** [2c Qc Td As] [5d]
firstandsole: checks 
johnpsg: bets $1.90
firstandsole: calls $1.90
*** SHOW DOWN ***
johnpsg: shows [Th Ts] (three of a kind, Tens)
firstandsole: mucks hand 
johnpsg collected $7.15 from pot
*** SUMMARY ***
Total pot $7.49 | Rake $0.34 
Board [2c Qc Td As 5d]
Seat 1: cel1974 (big blind) folded before Flop
Seat 2: firstandsole mucked
Seat 3: Mighty_Rams folded before Flop (didn't bet)
Seat 4: catchwatcher folded before Flop (didn't bet)
Seat 5: johnpsg (button) showed [Th Ts] and won ($7.15) with three of a kind, Tens
Seat 6: kilativ7 (small blind) folded before Flop



PokerStars Hand #222972049710:  Hold'em No Limit ($0.05/$0.10 USD) - 2021/01/23 16:24:31 ET
Table 'Demoulina III' 6-max Seat #6 is the button
Seat 1: cel1974 ($10 in chips) 
Seat 2: firstandsole ($10 in chips) 
Seat 3: Mighty_Rams ($10.79 in chips) 
Seat 5: johnpsg ($19.01 in chips) 
Seat 6: kilativ7 ($10.56 in chips) 
cel1974: posts small blind $0.05
firstandsole: posts big blind $0.10
*** HOLE CARDS ***
Mighty_Rams: calls $0.10
johnpsg: folds 
kilativ7: folds 
cel1974: folds 
firstandsole: checks 
*** FLOP *** [4h 5d Ts]
firstandsole: checks 
Mighty_Rams: checks 
*** TURN *** [4h 5d Ts] [Qc]
firstandsole: bets $0.24
Mighty_Rams: folds 
Uncalled bet ($0.24) returned to firstandsole
firstandsole collected $0.24 from pot
firstandsole: doesn't show hand 
*** SUMMARY ***
Total pot $0.25 | Rake $0.01 
Board [4h 5d Ts Qc]
Seat 1: cel1974 (small blind) folded before Flop
Seat 2: firstandsole (big blind) collected ($0.24)
Seat 3: Mighty_Rams folded on the Turn
Seat 5: johnpsg folded before Flop (didn't bet)
Seat 6: kilativ7 (button) folded before Flop (didn't bet)



PokerStars Hand #222972077997:  Hold'em No Limit ($0.05/$0.10 USD) - 2021/01/23 16:25:04 ET
Table 'Demoulina III' 6-max Seat #1 is the button
Seat 1: cel1974 ($10 in chips) 
Seat 2: firstandsole ($10.14 in chips) 
Seat 3: Mighty_Rams ($10.69 in chips) 
Seat 4: catchwatcher ($16.88 in chips) 
Seat 5: johnpsg ($19.01 in chips) 
Seat 6: kilativ7 ($10.56 in chips) 
firstandsole: posts small blind $0.05
Mighty_Rams: posts big blind $0.10
*** HOLE CARDS ***
catchwatcher: folds 
johnpsg: folds 
kilativ7: folds 
cel1974: folds 
firstandsole: folds 
Uncalled bet ($0.05) returned to Mighty_Rams
Mighty_Rams collected $0.10 from pot
*** SUMMARY ***
Total pot $0.10 | Rake $0 
Seat 1: cel1974 (button) folded before Flop (didn't bet)
Seat 2: firstandsole (small blind) folded before Flop
Seat 3: Mighty_Rams (big blind) collected ($0.10)
Seat 4: catchwatcher folded before Flop (didn't bet)
Seat 5: johnpsg folded before Flop (didn't bet)
Seat 6: kilativ7 folded before Flop (didn't bet)



PokerStars Hand #222972091872:  Hold'em No Limit ($0.05/$0.10 USD) - 2021/01/23 16:25:21 ET
Table 'Demoulina III' 6-max Seat #2 is the button
Seat 1: cel1974 ($10 in chips) 
Seat 2: firstandsole ($10.09 in chips) 
Seat 3: Mighty_Rams ($10.74 in chips) 
Seat 4: catchwatcher ($16.88 in chips) 
Seat 5: johnpsg ($19.01 in chips) 
Seat 6: kilativ7 ($10.56 in chips) 
Mighty_Rams: posts small blind $0.05
catchwatcher: posts big blind $0.10
*** HOLE CARDS ***
johnpsg: folds 
kilativ7: raises $0.20 to $0.30
cel1974: folds 
firstandsole: raises $0.70 to $1
Mighty_Rams: folds 
catchwatcher: folds 
kilativ7: folds 
Uncalled bet ($0.70) returned to firstandsole
firstandsole collected $0.75 from pot
firstandsole: doesn't show hand 
*** SUMMARY ***
Total pot $0.75 | Rake $0 
Seat 1: cel1974 folded before Flop (didn't bet)
Seat 2: firstandsole (button) collected ($0.75)
Seat 3: Mighty_Rams (small blind) folded before Flop
Seat 4: catchwatcher (big blind) folded before Flop
Seat 5: johnpsg folded before Flop (didn't bet)
Seat 6: kilativ7 folded before Flop



PokerStars Hand #222972108412:  Hold'em No Limit ($0.05/$0.10 USD) - 2021/01/23 16:25:40 ET
Table 'Demoulina III' 6-max Seat #3 is the button
Seat 1: cel1974 ($10 in chips) 
Seat 2: firstandsole ($10.54 in chips) 
Seat 3: Mighty_Rams ($10.69 in chips) 
Seat 4: catchwatcher ($16.78 in chips) 
Seat 5: johnpsg ($19.01 in chips) 
Seat 6: kilativ7 ($10.26 in chips) 
catchwatcher: posts small blind $0.05
johnpsg: posts big blind $0.10
*** HOLE CARDS ***
kilativ7: folds 
cel1974: raises $0.20 to $0.30
firstandsole: folds 
Mighty_Rams: folds 
catchwatcher: calls $0.25
johnpsg: folds 
*** FLOP *** [7s 6d 4s]
catchwatcher: bets $0.67
cel1974: folds 
Uncalled bet ($0.67) returned to catchwatcher
catchwatcher collected $0.67 from pot
catchwatcher: doesn't show hand 
*** SUMMARY ***
Total pot $0.70 | Rake $0.03 
Board [7s 6d 4s]
Seat 1: cel1974 folded on the Flop
Seat 2: firstandsole folded before Flop (didn't bet)
Seat 3: Mighty_Rams (button) folded before Flop (didn't bet)
Seat 4: catchwatcher (small blind) collected ($0.67)
Seat 5: johnpsg (big blind) folded before Flop
Seat 6: kilativ7 folded before Flop (didn't bet)



PokerStars Hand #222972150814:  Hold'em No Limit ($0.05/$0.10 USD) - 2021/01/23 16:26:30 ET
Table 'Demoulina III' 6-max Seat #4 is the button
Seat 1: cel1974 ($10 in chips) 
Seat 2: firstandsole ($10.54 in chips) 
Seat 3: Mighty_Rams ($10.69 in chips) 
Seat 4: catchwatcher ($17.15 in chips) 
Seat 5: johnpsg ($18.91 in chips) 
Seat 6: kilativ7 ($10.26 in chips) 
johnpsg: posts small blind $0.05
kilativ7: posts big blind $0.10
*** HOLE CARDS ***
cel1974: folds 
firstandsole: folds 
Mighty_Rams: folds 
catchwatcher: folds 
johnpsg: raises $0.15 to $0.25
kilativ7: raises $0.55 to $0.80
johnpsg: folds 
Uncalled bet ($0.55) returned to kilativ7
kilativ7 collected $0.50 from pot
kilativ7: doesn't show hand 
*** SUMMARY ***
Total pot $0.50 | Rake $0 
Seat 1: cel1974 folded before Flop (didn't bet)
Seat 2: firstandsole folded before Flop (didn't bet)
Seat 3: Mighty_Rams folded before Flop (didn't bet)
Seat 4: catchwatcher (button) folded before Flop (didn't bet)
Seat 5: johnpsg (small blind) folded before Flop
Seat 6: kilativ7 (big blind) collected ($0.50)



PokerStars Hand #222972179661:  Hold'em No Limit ($0.05/$0.10 USD) - 2021/01/23 16:27:04 ET
Table 'Demoulina III' 6-max Seat #5 is the button
Seat 1: cel1974 ($10 in chips) 
Seat 2: firstandsole ($10.54 in chips) 
Seat 3: Mighty_Rams ($10.69 in chips) 
Seat 4: catchwatcher ($17.15 in chips) 
Seat 5: johnpsg ($18.66 in chips) 
Seat 6: kilativ7 ($10.51 in chips) 
kilativ7: posts small blind $0.05
cel1974: posts big blind $0.10
*** HOLE CARDS ***
firstandsole: folds 
Mighty_Rams: folds 
catchwatcher: raises $0.10 to $0.20
johnpsg: calls $0.20
kilativ7: calls $0.15
cel1974: folds 
*** FLOP *** [Tc 6s 5d]
kilativ7: checks 
catchwatcher: bets $0.67
johnpsg: calls $0.67
kilativ7: folds 
*** TURN *** [Tc 6s 5d] [Ts]
catchwatcher: bets $1.95
johnpsg: calls $1.95
*** RIVER *** [Tc 6s 5d Ts] [9c]
catchwatcher: bets $5.67
johnpsg: calls $5.67
*** SHOW DOWN ***
catchwatcher: shows [Th Ks] (three of a kind, Tens)
johnpsg: mucks hand 
catchwatcher collected $16.50 from pot
*** SUMMARY ***
Total pot $17.28 | Rake $0.78 
Board [Tc 6s 5d Ts 9c]
Seat 1: cel1974 (big blind) folded before Flop
Seat 2: firstandsole folded before Flop (didn't bet)
Seat 3: Mighty_Rams folded before Flop (didn't bet)
Seat 4: catchwatcher showed [Th Ks] and won ($16.50) with three of a kind, Tens
Seat 5: johnpsg (button) mucked
Seat 6: kilativ7 (small blind) folded on the Flop



PokerStars Hand #222972223976:  Hold'em No Limit ($0.05/$0.10 USD) - 2021/01/23 16:27:57 ET
Table 'Demoulina III' 6-max Seat #6 is the button
Seat 1: cel1974 ($10 in chips) 
Seat 2: firstandsole ($10.54 in chips) 
Seat 3: Mighty_Rams ($10.69 in chips) 
Seat 4: catchwatcher ($25.16 in chips) 
Seat 5: johnpsg ($10.17 in chips) 
Seat 6: kilativ7 ($10.31 in chips) 
cel1974: posts small blind $0.05
firstandsole: posts big blind $0.10
*** HOLE CARDS ***
Mighty_Rams: folds 
catchwatcher: raises $0.10 to $0.20
johnpsg: folds 
kilativ7: folds 
cel1974: calls $0.15
firstandsole: folds 
*** FLOP *** [2h Ad 2c]
cel1974: checks 
catchwatcher: bets $0.48
cel1974: calls $0.48
*** TURN *** [2h Ad 2c] [3s]
cel1974: checks 
catchwatcher: checks 
*** RIVER *** [2h Ad 2c 3s] [7d]
cel1974: bets $0.70
catchwatcher: calls $0.70
*** SHOW DOWN ***
cel1974: shows [Ts Th] (two pair, Tens and Deuces)
catchwatcher: shows [6d Ah] (two pair, Aces and Deuces)
catchwatcher collected $2.73 from pot
*** SUMMARY ***
Total pot $2.86 | Rake $0.13 
Board [2h Ad 2c 3s 7d]
Seat 1: cel1974 (small blind) showed [Ts Th] and lost with two pair, Tens and Deuces
Seat 2: firstandsole (big blind) folded before Flop
Seat 3: Mighty_Rams folded before Flop (didn't bet)
Seat 4: catchwatcher showed [6d Ah] and won ($2.73) with two pair, Aces and Deuces
Seat 5: johnpsg folded before Flop (didn't bet)
Seat 6: kilativ7 (button) folded before Flop (didn't bet)



PokerStars Hand #222972258445:  Hold'em No Limit ($0.05/$0.10 USD) - 2021/01/23 16:28:37 ET
Table 'Demoulina III' 6-max Seat #1 is the button
Seat 1: cel1974 ($10 in chips) 
Seat 2: firstandsole ($10.44 in chips) 
Seat 3: Mighty_Rams ($10.69 in chips) 
Seat 4: catchwatcher ($26.51 in chips) 
Seat 5: johnpsg ($10.17 in chips) 
Seat 6: kilativ7 ($10.31 in chips) 
firstandsole: posts small blind $0.05
Mighty_Rams: posts big blind $0.10
*** HOLE CARDS ***
catchwatcher: folds 
johnpsg: folds 
kilativ7: folds 
cel1974: folds 
firstandsole: raises $0.20 to $0.30
Mighty_Rams: calls $0.20
*** FLOP *** [Kd 6c 6s]
firstandsole: bets $0.22
Mighty_Rams: folds 
Uncalled bet ($0.22) returned to firstandsole
firstandsole collected $0.57 from pot
firstandsole: doesn't show hand 
*** SUMMARY ***
Total pot $0.60 | Rake $0.03 
Board [Kd 6c 6s]
Seat 1: cel1974 (button) folded before Flop (didn't bet)
Seat 2: firstandsole (small blind) collected ($0.57)
Seat 3: Mighty_Rams (big blind) folded on the Flop
Seat 4: catchwatcher folded before Flop (didn't bet)
Seat 5: johnpsg folded before Flop (didn't bet)
Seat 6: kilativ7 folded before Flop (didn't bet)



PokerStars Hand #222972272886:  Hold'em No Limit ($0.05/$0.10 USD) - 2021/01/23 16:28:54 ET
Table 'Demoulina III' 6-max Seat #2 is the button
Seat 1: cel1974 ($10 in chips) 
Seat 2: firstandsole ($10.71 in chips) 
Seat 3: Mighty_Rams ($10.39 in chips) 
Seat 4: catchwatcher ($26.51 in chips) 
Seat 5: johnpsg ($10.17 in chips) 
Seat 6: kilativ7 ($10.31 in chips) 
Mighty_Rams: posts small blind $0.05
catchwatcher: posts big blind $0.10
*** HOLE CARDS ***
johnpsg: folds 
kilativ7: raises $0.20 to $0.30
cel1974: folds 
firstandsole: folds 
Mighty_Rams: raises $0.30 to $0.60
catchwatcher: calls $0.50
kilativ7: calls $0.30
*** FLOP *** [6s 9s Tc]
Mighty_Rams: checks 
catchwatcher: bets $1.72
kilativ7: folds 
Mighty_Rams: folds 
Uncalled bet ($1.72) returned to catchwatcher
catchwatcher collected $1.72 from pot
catchwatcher: doesn't show hand 
*** SUMMARY ***
Total pot $1.80 | Rake $0.08 
Board [6s 9s Tc]
Seat 1: cel1974 folded before Flop (didn't bet)
Seat 2: firstandsole (button) folded before Flop (didn't bet)
Seat 3: Mighty_Rams (small blind) folded on the Flop
Seat 4: catchwatcher (big blind) collected ($1.72)
Seat 5: johnpsg folded before Flop (didn't bet)
Seat 6: kilativ7 folded on the Flop



PokerStars Hand #222972323841:  Hold'em No Limit ($0.05/$0.10 USD) - 2021/01/23 16:29:54 ET
Table 'Demoulina III' 6-max Seat #3 is the button
Seat 1: cel1974 ($10 in chips) 
Seat 2: firstandsole ($10.71 in chips) 
Seat 3: Mighty_Rams ($9.79 in chips) 
Seat 4: catchwatcher ($27.63 in chips) 
Seat 5: johnpsg ($10.17 in chips) 
Seat 6: kilativ7 ($10 in chips) 
catchwatcher: posts small blind $0.05
johnpsg: posts big blind $0.10
*** HOLE CARDS ***
kilativ7: folds 
cel1974: raises $0.20 to $0.30
firstandsole has timed out
firstandsole: folds 
Mighty_Rams: calls $0.30
catchwatcher: folds 
johnpsg: folds 
*** FLOP *** [2h 9h 8d]
cel1974: bets $0.54
Mighty_Rams: folds 
Uncalled bet ($0.54) returned to cel1974
cel1974 collected $0.72 from pot
cel1974: doesn't show hand 
*** SUMMARY ***
Total pot $0.75 | Rake $0.03 
Board [2h 9h 8d]
Seat 1: cel1974 collected ($0.72)
Seat 2: firstandsole folded before Flop (didn't bet)
Seat 3: Mighty_Rams (button) folded on the Flop
Seat 4: catchwatcher (small blind) folded before Flop
Seat 5: johnpsg (big blind) folded before Flop
Seat 6: kilativ7 folded before Flop (didn't bet)



PokerStars Hand #222972361131:  Hold'em No Limit ($0.05/$0.10 USD) - 2021/01/23 16:30:38 ET
Table 'Demoulina III' 6-max Seat #4 is the button
Seat 1: cel1974 ($10.42 in chips) 
Seat 2: firstandsole ($10.71 in chips) 
Seat 3: Mighty_Rams ($9.49 in chips) 
Seat 4: catchwatcher ($27.58 in chips) 
Seat 5: johnpsg ($10.07 in chips) 
Seat 6: kilativ7 ($10 in chips) 
johnpsg: posts small blind $0.05
kilativ7: posts big blind $0.10
*** HOLE CARDS ***
cel1974: raises $0.20 to $0.30
firstandsole: folds 
Mighty_Rams: raises $0.20 to $0.50
catchwatcher: folds 
johnpsg: folds 
kilativ7: folds 
cel1974: raises $9.92 to $10.42 and is all-in
Mighty_Rams: folds 
Uncalled bet ($9.92) returned to cel1974
cel1974 collected $1.15 from pot
cel1974: doesn't show hand 
*** SUMMARY ***
Total pot $1.15 | Rake $0 
Seat 1: cel1974 collected ($1.15)
Seat 2: firstandsole folded before Flop (didn't bet)
Seat 3: Mighty_Rams folded before Flop
Seat 4: catchwatcher (button) folded before Flop (didn't bet)
Seat 5: johnpsg (small blind) folded before Flop
Seat 6: kilativ7 (big blind) folded before Flop



PokerStars Hand #222972404350:  Hold'em No Limit ($0.05/$0.10 USD) - 2021/01/23 16:31:24 ET
Table 'Demoulina III' 6-max Seat #5 is the button
Seat 1: cel1974 ($11.07 in chips) 
Seat 2: firstandsole ($10.71 in chips) 
Seat 3: Mighty_Rams ($8.99 in chips) 
Seat 4: catchwatcher ($27.58 in chips) 
Seat 5: johnpsg ($10.02 in chips) 
Seat 6: kilativ7 ($10 in chips) 
kilativ7: posts small blind $0.05
cel1974: posts big blind $0.10
*** HOLE CARDS ***
firstandsole: folds 
Mighty_Rams: folds 
catchwatcher: raises $0.10 to $0.20
johnpsg: folds 
kilativ7: folds 
cel1974: folds 
Uncalled bet ($0.10) returned to catchwatcher
catchwatcher collected $0.25 from pot
catchwatcher: doesn't show hand 
*** SUMMARY ***
Total pot $0.25 | Rake $0 
Seat 1: cel1974 (big blind) folded before Flop
Seat 2: firstandsole folded before Flop (didn't bet)
Seat 3: Mighty_Rams folded before Flop (didn't bet)
Seat 4: catchwatcher collected ($0.25)
Seat 5: johnpsg (button) folded before Flop (didn't bet)
Seat 6: kilativ7 (small blind) folded before Flop



PokerStars Hand #222972416168:  Hold'em No Limit ($0.05/$0.10 USD) - 2021/01/23 16:31:38 ET
Table 'Demoulina III' 6-max Seat #6 is the button
Seat 1: cel1974 ($10.97 in chips) 
Seat 2: firstandsole ($10.71 in chips) 
Seat 3: Mighty_Rams ($8.99 in chips) 
Seat 4: catchwatcher ($27.73 in chips) 
Seat 5: johnpsg ($10.02 in chips) 
Seat 6: kilativ7 ($10 in chips) 
cel1974: posts small blind $0.05
firstandsole: posts big blind $0.10
*** HOLE CARDS ***
Mighty_Rams: folds 
catchwatcher: folds 
johnpsg: raises $0.15 to $0.25
kilativ7: folds 
cel1974: folds 
firstandsole: folds 
Uncalled bet ($0.15) returned to johnpsg
johnpsg collected $0.25 from pot
johnpsg: doesn't show hand 
*** SUMMARY ***
Total pot $0.25 | Rake $0 
Seat 1: cel1974 (small blind) folded before Flop
Seat 2: firstandsole (big blind) folded before Flop
Seat 3: Mighty_Rams folded before Flop (didn't bet)
Seat 4: catchwatcher folded before Flop (didn't bet)
Seat 5: johnpsg collected ($0.25)
Seat 6: kilativ7 (button) folded before Flop (didn't bet)



PokerStars Hand #222972433768:  Hold'em No Limit ($0.05/$0.10 USD) - 2021/01/23 16:31:58 ET
Table 'Demoulina III' 6-max Seat #1 is the button
Seat 1: cel1974 ($10.92 in chips) 
Seat 2: firstandsole ($10.61 in chips) 
Seat 3: Mighty_Rams ($8.99 in chips) 
Seat 4: catchwatcher ($27.73 in chips) 
Seat 5: johnpsg ($10.17 in chips) 
Seat 6: kilativ7 ($10 in chips) 
firstandsole: posts small blind $0.05
Mighty_Rams: posts big blind $0.10
*** HOLE CARDS ***
catchwatcher: folds 
johnpsg: folds 
kilativ7: raises $0.15 to $0.25
cel1974: folds 
firstandsole: folds 
Mighty_Rams: calls $0.15
*** FLOP *** [4c 4h 6c]
Mighty_Rams: bets $0.20
kilativ7: calls $0.20
*** TURN *** [4c 4h 6c] [Jh]
Mighty_Rams: bets $0.30
kilativ7: calls $0.30
*** RIVER *** [4c 4h 6c Jh] [2h]
Mighty_Rams: bets $0.30
kilativ7: calls $0.30
*** SHOW DOWN ***
Mighty_Rams: shows [Kc 6h] (two pair, Sixes and Fours)
kilativ7: mucks hand 
Mighty_Rams collected $2.05 from pot
*** SUMMARY ***
Total pot $2.15 | Rake $0.10 
Board [4c 4h 6c Jh 2h]
Seat 1: cel1974 (button) folded before Flop (didn't bet)
Seat 2: firstandsole (small blind) folded before Flop
Seat 3: Mighty_Rams (big blind) showed [Kc 6h] and won ($2.05) with two pair, Sixes and Fours
Seat 4: catchwatcher folded before Flop (didn't bet)
Seat 5: johnpsg folded before Flop (didn't bet)
Seat 6: kilativ7 mucked



PokerStars Hand #222972461274:  Hold'em No Limit ($0.05/$0.10 USD) - 2021/01/23 16:32:31 ET
Table 'Demoulina III' 6-max Seat #2 is the button
Seat 1: cel1974 ($10.92 in chips) 
Seat 2: firstandsole ($10.56 in chips) 
Seat 3: Mighty_Rams ($9.99 in chips) 
Seat 4: catchwatcher ($27.73 in chips) 
Seat 5: johnpsg ($10.17 in chips) 
Seat 6: kilativ7 ($10 in chips) 
Mighty_Rams: posts small blind $0.05
catchwatcher: posts big blind $0.10
*** HOLE CARDS ***
johnpsg: folds 
kilativ7: folds 
cel1974: folds 
firstandsole: raises $0.20 to $0.30
Mighty_Rams: folds 
catchwatcher: calls $0.20
*** FLOP *** [2c 4d 6h]
catchwatcher: bets $0.62
firstandsole: folds 
Uncalled bet ($0.62) returned to catchwatcher
catchwatcher collected $0.62 from pot
catchwatcher: doesn't show hand 
*** SUMMARY ***
Total pot $0.65 | Rake $0.03 
Board [2c 4d 6h]
Seat 1: cel1974 folded before Flop (didn't bet)
Seat 2: firstandsole (button) folded on the Flop
Seat 3: Mighty_Rams (small blind) folded before Flop
Seat 4: catchwatcher (big blind) collected ($0.62)
Seat 5: johnpsg folded before Flop (didn't bet)
Seat 6: kilativ7 folded before Flop (didn't bet)



PokerStars Hand #222972479763:  Hold'em No Limit ($0.05/$0.10 USD) - 2021/01/23 16:32:53 ET
Table 'Demoulina III' 6-max Seat #3 is the button
Seat 1: cel1974 ($10.92 in chips) 
Seat 2: firstandsole ($10.26 in chips) 
Seat 3: Mighty_Rams ($9.94 in chips) 
Seat 4: catchwatcher ($28.05 in chips) 
Seat 5: johnpsg ($10.17 in chips) 
Seat 6: kilativ7 ($10 in chips) 
catchwatcher: posts small blind $0.05
johnpsg: posts big blind $0.10
*** HOLE CARDS ***
kilativ7: folds 
cel1974: folds 
firstandsole: folds 
Mighty_Rams: folds 
catchwatcher: folds 
Uncalled bet ($0.05) returned to johnpsg
johnpsg collected $0.10 from pot
johnpsg: doesn't show hand 
*** SUMMARY ***
Total pot $0.10 | Rake $0 
Seat 1: cel1974 folded before Flop (didn't bet)
Seat 2: firstandsole folded before Flop (didn't bet)
Seat 3: Mighty_Rams (button) folded before Flop (didn't bet)
Seat 4: catchwatcher (small blind) folded before Flop
Seat 5: johnpsg (big blind) collected ($0.10)
Seat 6: kilativ7 folded before Flop (didn't bet)



PokerStars Hand #222972489088:  Hold'em No Limit ($0.05/$0.10 USD) - 2021/01/23 16:33:04 ET
Table 'Demoulina III' 6-max Seat #4 is the button
Seat 1: cel1974 ($10.92 in chips) 
Seat 2: firstandsole ($10.26 in chips) 
Seat 3: Mighty_Rams ($9.94 in chips) 
Seat 4: catchwatcher ($28 in chips) 
Seat 5: johnpsg ($10.22 in chips) 
Seat 6: kilativ7 ($10 in chips) 
johnpsg: posts small blind $0.05
kilativ7: posts big blind $0.10
*** HOLE CARDS ***
cel1974: raises $0.20 to $0.30
firstandsole: folds 
Mighty_Rams: folds 
catchwatcher: calls $0.30
johnpsg: folds 
kilativ7: folds 
*** FLOP *** [Kc 9h 2d]
cel1974: checks 
catchwatcher: bets $0.72
cel1974: raises $1.62 to $2.34
catchwatcher: raises $5.40 to $7.74
cel1974: raises $2.88 to $10.62 and is all-in
catchwatcher: calls $2.88
*** TURN *** [Kc 9h 2d] [Qh]
*** RIVER *** [Kc 9h 2d Qh] [4d]
*** SHOW DOWN ***
cel1974: shows [Kh Ks] (three of a kind, Kings)
catchwatcher: shows [2h 2c] (three of a kind, Deuces)
cel1974 collected $21 from pot
*** SUMMARY ***
Total pot $21.99 | Rake $0.99 
Board [Kc 9h 2d Qh 4d]
Seat 1: cel1974 showed [Kh Ks] and won ($21) with three of a kind, Kings
Seat 2: firstandsole folded before Flop (didn't bet)
Seat 3: Mighty_Rams folded before Flop (didn't bet)
Seat 4: catchwatcher (button) showed [2h 2c] and lost with three of a kind, Deuces
Seat 5: johnpsg (small blind) folded before Flop
Seat 6: kilativ7 (big blind) folded before Flop



PokerStars Hand #222972541542:  Hold'em No Limit ($0.05/$0.10 USD) - 2021/01/23 16:34:06 ET
Table 'Demoulina III' 6-max Seat #5 is the button
Seat 1: cel1974 ($21 in chips) 
Seat 2: firstandsole ($10.26 in chips) 
Seat 3: Mighty_Rams ($9.94 in chips) 
Seat 4: catchwatcher ($17.08 in chips) 
Seat 5: johnpsg ($10.17 in chips) 
Seat 6: kilativ7 ($10 in chips) 
kilativ7: posts small blind $0.05
cel1974: posts big blind $0.10
*** HOLE CARDS ***
firstandsole: folds 
Mighty_Rams: folds 
catchwatcher: folds 
johnpsg: folds 
kilativ7: folds 
Uncalled bet ($0.05) returned to cel1974
cel1974 collected $0.10 from pot
cel1974: doesn't show hand 
*** SUMMARY ***
Total pot $0.10 | Rake $0 
Seat 1: cel1974 (big blind) collected ($0.10)
Seat 2: firstandsole folded before Flop (didn't bet)
Seat 3: Mighty_Rams folded before Flop (didn't bet)
Seat 4: catchwatcher folded before Flop (didn't bet)
Seat 5: johnpsg (button) folded before Flop (didn't bet)
Seat 6: kilativ7 (small blind) folded before Flop



PokerStars Hand #222972549139:  Hold'em No Limit ($0.05/$0.10 USD) - 2021/01/23 16:34:15 ET
Table 'Demoulina III' 6-max Seat #6 is the button
Seat 1: cel1974 ($21.05 in chips) 
Seat 2: firstandsole ($10.26 in chips) 
Seat 3: Mighty_Rams ($9.94 in chips) 
Seat 4: catchwatcher ($17.08 in chips) 
Seat 5: johnpsg ($10.17 in chips) 
Seat 6: kilativ7 ($10 in chips) 
cel1974: posts small blind $0.05
firstandsole: posts big blind $0.10
*** HOLE CARDS ***
Mighty_Rams: calls $0.10
catchwatcher: raises $0.10 to $0.20
johnpsg: folds 
kilativ7: calls $0.20
cel1974: folds 
firstandsole: raises $1.15 to $1.35
Mighty_Rams: folds 
catchwatcher: calls $1.15
kilativ7: folds 
*** FLOP *** [As 3d Qh]
firstandsole: bets $1.20
catchwatcher: folds 
Uncalled bet ($1.20) returned to firstandsole
firstandsole collected $2.91 from pot
firstandsole: doesn't show hand 
*** SUMMARY ***
Total pot $3.05 | Rake $0.14 
Board [As 3d Qh]
Seat 1: cel1974 (small blind) folded before Flop
Seat 2: firstandsole (big blind) collected ($2.91)
Seat 3: Mighty_Rams folded before Flop
Seat 4: catchwatcher folded on the Flop
Seat 5: johnpsg folded before Flop (didn't bet)
Seat 6: kilativ7 (button) folded before Flop



PokerStars Hand #222972579862:  Hold'em No Limit ($0.05/$0.10 USD) - 2021/01/23 16:34:52 ET
Table 'Demoulina III' 6-max Seat #1 is the button
Seat 1: cel1974 ($21 in chips) 
Seat 2: firstandsole ($11.82 in chips) 
Seat 3: Mighty_Rams ($9.84 in chips) 
Seat 4: catchwatcher ($15.73 in chips) 
Seat 5: johnpsg ($10.17 in chips) 
Seat 6: kilativ7 ($10 in chips) 
firstandsole: posts small blind $0.05
Mighty_Rams: posts big blind $0.10
*** HOLE CARDS ***
catchwatcher: raises $0.10 to $0.20
johnpsg: folds 
kilativ7: calls $0.20
cel1974: calls $0.20
firstandsole: folds 
Mighty_Rams: calls $0.10
*** FLOP *** [Ac 2s 7c]
Mighty_Rams: checks 
catchwatcher: bets $0.81
kilativ7: folds 
cel1974: folds 
Mighty_Rams: calls $0.81
*** TURN *** [Ac 2s 7c] [3h]
Mighty_Rams: checks 
catchwatcher: bets $2.36
Mighty_Rams: calls $2.36
*** RIVER *** [Ac 2s 7c 3h] [9h]
Mighty_Rams: checks 
catchwatcher: checks 
*** SHOW DOWN ***
Mighty_Rams: shows [6c Kc] (high card Ace)
catchwatcher: shows [As Js] (a pair of Aces)
catchwatcher collected $6.87 from pot
*** SUMMARY ***
Total pot $7.19 | Rake $0.32 
Board [Ac 2s 7c 3h 9h]
Seat 1: cel1974 (button) folded on the Flop
Seat 2: firstandsole (small blind) folded before Flop
Seat 3: Mighty_Rams (big blind) showed [6c Kc] and lost with high card Ace
Seat 4: catchwatcher showed [As Js] and won ($6.87) with a pair of Aces
Seat 5: johnpsg folded before Flop (didn't bet)
Seat 6: kilativ7 folded on the Flop



PokerStars Hand #222972628484:  Hold'em No Limit ($0.05/$0.10 USD) - 2021/01/23 16:35:50 ET
Table 'Demoulina III' 6-max Seat #2 is the button
Seat 1: cel1974 ($20.80 in chips) 
Seat 2: firstandsole ($11.77 in chips) 
Seat 3: Mighty_Rams ($6.47 in chips) 
Seat 4: catchwatcher ($19.23 in chips) 
Seat 5: johnpsg ($10.17 in chips) 
Seat 6: kilativ7 ($10 in chips) 
Mighty_Rams: posts small blind $0.05
catchwatcher: posts big blind $0.10
*** HOLE CARDS ***
johnpsg: folds 
kilativ7: folds 
cel1974: folds 
firstandsole: folds 
Mighty_Rams: calls $0.05
catchwatcher: checks 
*** FLOP *** [2c Jd 4d]
Mighty_Rams: checks 
catchwatcher: checks 
*** TURN *** [2c Jd 4d] [Ah]
Mighty_Rams: bets $0.20
catchwatcher: folds 
Uncalled bet ($0.20) returned to Mighty_Rams
Mighty_Rams collected $0.19 from pot
*** SUMMARY ***
Total pot $0.20 | Rake $0.01 
Board [2c Jd 4d Ah]
Seat 1: cel1974 folded before Flop (didn't bet)
Seat 2: firstandsole (button) folded before Flop (didn't bet)
Seat 3: Mighty_Rams (small blind) collected ($0.19)
Seat 4: catchwatcher (big blind) folded on the Turn
Seat 5: johnpsg folded before Flop (didn't bet)
Seat 6: kilativ7 folded before Flop (didn't bet)



PokerStars Hand #222972644976:  Hold'em No Limit ($0.05/$0.10 USD) - 2021/01/23 16:36:09 ET
Table 'Demoulina III' 6-max Seat #3 is the button
Seat 1: cel1974 ($20.80 in chips) 
Seat 2: firstandsole ($11.77 in chips) 
Seat 3: Mighty_Rams ($6.56 in chips) 
Seat 4: catchwatcher ($19.13 in chips) 
Seat 5: johnpsg ($10.17 in chips) 
Seat 6: kilativ7 ($10 in chips) 
catchwatcher: posts small blind $0.05
johnpsg: posts big blind $0.10
*** HOLE CARDS ***
kilativ7: folds 
cel1974: folds 
kilativ7 leaves the table
firstandsole: raises $0.20 to $0.30
Mighty_Rams: folds 
catchwatcher: folds 
johnpsg: folds 
Uncalled bet ($0.20) returned to firstandsole
firstandsole collected $0.25 from pot
firstandsole: doesn't show hand 
*** SUMMARY ***
Total pot $0.25 | Rake $0 
Seat 1: cel1974 folded before Flop (didn't bet)
Seat 2: firstandsole collected ($0.25)
Seat 3: Mighty_Rams (button) folded before Flop (didn't bet)
Seat 4: catchwatcher (small blind) folded before Flop
Seat 5: johnpsg (big blind) folded before Flop
Seat 6: kilativ7 folded before Flop (didn't bet)



PokerStars Hand #222972655867:  Hold'em No Limit ($0.05/$0.10 USD) - 2021/01/23 16:36:22 ET
Table 'Demoulina III' 6-max Seat #4 is the button
Seat 1: cel1974 ($20.80 in chips) 
Seat 2: firstandsole ($11.92 in chips) 
Seat 3: Mighty_Rams ($6.56 in chips) 
Seat 4: catchwatcher ($19.08 in chips) 
Seat 5: johnpsg ($10.07 in chips) 
johnpsg: posts small blind $0.05
cel1974: posts big blind $0.10
*** HOLE CARDS ***
firstandsole: folds 
Mighty_Rams: folds 
LuckyTatia joins the table at seat #6 
catchwatcher: raises $0.10 to $0.20
johnpsg: folds 
cel1974: folds 
Uncalled bet ($0.10) returned to catchwatcher
catchwatcher collected $0.25 from pot
catchwatcher: doesn't show hand 
*** SUMMARY ***
Total pot $0.25 | Rake $0 
Seat 1: cel1974 (big blind) folded before Flop
Seat 2: firstandsole folded before Flop (didn't bet)
Seat 3: Mighty_Rams folded before Flop (didn't bet)
Seat 4: catchwatcher (button) collected ($0.25)
Seat 5: johnpsg (small blind) folded before Flop



PokerStars Hand #222972666301:  Hold'em No Limit ($0.05/$0.10 USD) - 2021/01/23 16:36:35 ET
Table 'Demoulina III' 6-max Seat #5 is the button
Seat 1: cel1974 ($20.70 in chips) 
Seat 2: firstandsole ($11.92 in chips) 
Seat 3: Mighty_Rams ($6.56 in chips) 
Seat 4: catchwatcher ($19.23 in chips) 
Seat 5: johnpsg ($10.02 in chips) 
cel1974: posts small blind $0.05
firstandsole: posts big blind $0.10
*** HOLE CARDS ***
Mighty_Rams: folds 
catchwatcher: folds 
johnpsg: folds 
cel1974: folds 
Uncalled bet ($0.05) returned to firstandsole
firstandsole collected $0.10 from pot
firstandsole: doesn't show hand 
*** SUMMARY ***
Total pot $0.10 | Rake $0 
Seat 1: cel1974 (small blind) folded before Flop
Seat 2: firstandsole (big blind) collected ($0.10)
Seat 3: Mighty_Rams folded before Flop (didn't bet)
Seat 4: catchwatcher folded before Flop (didn't bet)
Seat 5: johnpsg (button) folded before Flop (didn't bet)



PokerStars Hand #222972676807:  Hold'em No Limit ($0.05/$0.10 USD) - 2021/01/23 16:36:47 ET
Table 'Demoulina III' 6-max Seat #1 is the button
Seat 1: cel1974 ($20.65 in chips) 
Seat 2: firstandsole ($11.97 in chips) 
Seat 3: Mighty_Rams ($6.56 in chips) 
Seat 4: catchwatcher ($19.23 in chips) 
Seat 5: johnpsg ($10.02 in chips) 
firstandsole: posts small blind $0.05
Mighty_Rams: posts big blind $0.10
LuckyTatia: sits out 
*** HOLE CARDS ***
catchwatcher: folds 
johnpsg: folds 
cel1974: folds 
firstandsole: folds 
Uncalled bet ($0.05) returned to Mighty_Rams
Mighty_Rams collected $0.10 from pot
*** SUMMARY ***
Total pot $0.10 | Rake $0 
Seat 1: cel1974 (button) folded before Flop (didn't bet)
Seat 2: firstandsole (small blind) folded before Flop
Seat 3: Mighty_Rams (big blind) collected ($0.10)
Seat 4: catchwatcher folded before Flop (didn't bet)
Seat 5: johnpsg folded before Flop (didn't bet)



PokerStars Hand #222972683851:  Hold'em No Limit ($0.05/$0.10 USD) - 2021/01/23 16:36:56 ET
Table 'Demoulina III' 6-max Seat #2 is the button
Seat 1: cel1974 ($20.65 in chips) 
Seat 2: firstandsole ($11.92 in chips) 
Seat 3: Mighty_Rams ($6.61 in chips) 
Seat 4: catchwatcher ($19.23 in chips) 
Seat 5: johnpsg ($10.02 in chips) 
Mighty_Rams: posts small blind $0.05
catchwatcher: posts big blind $0.10
LuckyTatia: sits out 
*** HOLE CARDS ***
johnpsg: raises $0.17 to $0.27
cel1974: folds 
firstandsole: calls $0.27
Mighty_Rams: folds 
catchwatcher: raises $0.86 to $1.13
johnpsg: folds 
firstandsole: calls $0.86
*** FLOP *** [Ac Jc 6h]
catchwatcher: checks 
firstandsole: checks 
*** TURN *** [Ac Jc 6h] [7h]
catchwatcher: checks 
firstandsole: bets $2.46
catchwatcher: calls $2.46
*** RIVER *** [Ac Jc 6h 7h] [8h]
catchwatcher: checks 
firstandsole: bets $8.33 and is all-in
catchwatcher: folds 
Uncalled bet ($8.33) returned to firstandsole
firstandsole collected $7.16 from pot
firstandsole: doesn't show hand 
*** SUMMARY ***
Total pot $7.50 | Rake $0.34 
Board [Ac Jc 6h 7h 8h]
Seat 1: cel1974 folded before Flop (didn't bet)
Seat 2: firstandsole (button) collected ($7.16)
Seat 3: Mighty_Rams (small blind) folded before Flop
Seat 4: catchwatcher (big blind) folded on the River
Seat 5: johnpsg folded before Flop



PokerStars Hand #222972725069:  Hold'em No Limit ($0.05/$0.10 USD) - 2021/01/23 16:37:45 ET
Table 'Demoulina III' 6-max Seat #3 is the button
Seat 1: cel1974 ($20.65 in chips) 
Seat 2: firstandsole ($15.49 in chips) 
Seat 3: Mighty_Rams ($6.56 in chips) 
Seat 4: catchwatcher ($15.64 in chips) 
Seat 5: johnpsg ($10 in chips) 
catchwatcher: posts small blind $0.05
johnpsg: posts big blind $0.10
LuckyTatia: sits out 
*** HOLE CARDS ***
cel1974: raises $0.20 to $0.30
firstandsole: folds 
Mighty_Rams: folds 
catchwatcher: folds 
johnpsg: calls $0.20
*** FLOP *** [Ac 5h Ad]
catchwatcher leaves the table
johnpsg: checks 
cel1974: bets $0.35
bilavych joins the table at seat #4 
johnpsg: folds 
Uncalled bet ($0.35) returned to cel1974
cel1974 collected $0.62 from pot
cel1974: doesn't show hand 
*** SUMMARY ***
Total pot $0.65 | Rake $0.03 
Board [Ac 5h Ad]
Seat 1: cel1974 collected ($0.62)
Seat 2: firstandsole folded before Flop (didn't bet)
Seat 3: Mighty_Rams (button) folded before Flop (didn't bet)
Seat 4: catchwatcher (small blind) folded before Flop
Seat 5: johnpsg (big blind) folded on the Flop



PokerStars Hand #222972756324:  Hold'em No Limit ($0.05/$0.10 USD) - 2021/01/23 16:38:22 ET
Table 'Demoulina III' 6-max Seat #5 is the button
Seat 1: cel1974 ($20.97 in chips) 
Seat 2: firstandsole ($15.49 in chips) 
Seat 3: Mighty_Rams ($6.56 in chips) 
Seat 5: johnpsg ($10 in chips) 
cel1974: posts small blind $0.05
firstandsole: posts big blind $0.10
bilavych: sits out 
*** HOLE CARDS ***
Mighty_Rams: calls $0.10
johnpsg: folds 
cel1974: folds 
firstandsole: raises $0.20 to $0.30
Mighty_Rams: calls $0.20
*** FLOP *** [Qd 9c Js]
firstandsole: checks 
Mighty_Rams: bets $0.20
firstandsole: folds 
Uncalled bet ($0.20) returned to Mighty_Rams
Mighty_Rams collected $0.62 from pot
*** SUMMARY ***
Total pot $0.65 | Rake $0.03 
Board [Qd 9c Js]
Seat 1: cel1974 (small blind) folded before Flop
Seat 2: firstandsole (big blind) folded on the Flop
Seat 3: Mighty_Rams collected ($0.62)
Seat 5: johnpsg (button) folded before Flop (didn't bet)



PokerStars Hand #222972776752:  Hold'em No Limit ($0.05/$0.10 USD) - 2021/01/23 16:38:47 ET
Table 'Demoulina III' 6-max Seat #1 is the button
Seat 1: cel1974 ($20.92 in chips) 
Seat 2: firstandsole ($15.19 in chips) 
Seat 3: Mighty_Rams ($6.88 in chips) 
Seat 5: johnpsg ($10 in chips) 
firstandsole: posts small blind $0.05
Mighty_Rams: posts big blind $0.10
bilavych: sits out 
LuckyTatia: sits out 
*** HOLE CARDS ***
johnpsg: folds 
cel1974: raises $0.10 to $0.20
firstandsole: folds 
Mighty_Rams: calls $0.10
*** FLOP *** [Qs 6d Jc]
Mighty_Rams: bets $0.10
cel1974: calls $0.10
*** TURN *** [Qs 6d Jc] [Ts]
Mighty_Rams: checks 
cel1974: bets $0.31
Mighty_Rams: folds 
Uncalled bet ($0.31) returned to cel1974
cel1974 collected $0.62 from pot
cel1974: doesn't show hand 
*** SUMMARY ***
Total pot $0.65 | Rake $0.03 
Board [Qs 6d Jc Ts]
Seat 1: cel1974 (button) collected ($0.62)
Seat 2: firstandsole (small blind) folded before Flop
Seat 3: Mighty_Rams (big blind) folded on the Turn
Seat 5: johnpsg folded before Flop (didn't bet)



PokerStars Hand #222972811237:  Hold'em No Limit ($0.05/$0.10 USD) - 2021/01/23 16:39:29 ET
Table 'Demoulina III' 6-max Seat #2 is the button
Seat 1: cel1974 ($21.24 in chips) 
Seat 2: firstandsole ($15.14 in chips) 
Seat 3: Mighty_Rams ($6.58 in chips) 
Seat 4: bilavych ($8 in chips) 
Seat 5: johnpsg ($10 in chips) 
Mighty_Rams: posts small blind $0.05
bilavych: posts big blind $0.10
LuckyTatia: sits out 
*** HOLE CARDS ***
johnpsg: folds 
cel1974: folds 
firstandsole: raises $0.20 to $0.30
Mighty_Rams: calls $0.25
bilavych: folds 
*** FLOP *** [Qs 2c 3c]
Mighty_Rams: bets $0.34
firstandsole: calls $0.34
*** TURN *** [Qs 2c 3c] [9d]
Mighty_Rams: bets $0.30
firstandsole: calls $0.30
*** RIVER *** [Qs 2c 3c 9d] [As]
Mighty_Rams: bets $0.30
firstandsole: raises $0.60 to $0.90
Mighty_Rams: calls $0.60
*** SHOW DOWN ***
firstandsole: shows [4h Ah] (a pair of Aces)
Mighty_Rams: mucks hand 
firstandsole collected $3.61 from pot
*** SUMMARY ***
Total pot $3.78 | Rake $0.17 
Board [Qs 2c 3c 9d As]
Seat 1: cel1974 folded before Flop (didn't bet)
Seat 2: firstandsole (button) showed [4h Ah] and won ($3.61) with a pair of Aces
Seat 3: Mighty_Rams (small blind) mucked
Seat 4: bilavych (big blind) folded before Flop
Seat 5: johnpsg folded before Flop (didn't bet)



PokerStars Hand #222972851798:  Hold'em No Limit ($0.05/$0.10 USD) - 2021/01/23 16:40:06 ET
Table 'Demoulina III' 6-max Seat #3 is the button
Seat 1: cel1974 ($21.24 in chips) 
Seat 2: firstandsole ($16.91 in chips) 
Seat 3: Mighty_Rams ($4.74 in chips) 
Seat 4: bilavych ($7.90 in chips) 
Seat 5: johnpsg ($10 in chips) 
bilavych: posts small blind $0.05
johnpsg: posts big blind $0.10
LuckyTatia: sits out 
*** HOLE CARDS ***
cel1974: folds 
firstandsole: raises $0.20 to $0.30
Mighty_Rams: folds 
bilavych: calls $0.25
johnpsg: calls $0.20
*** FLOP *** [8s 4s 6c]
bilavych: bets $0.30
johnpsg: folds 
firstandsole: calls $0.30
*** TURN *** [8s 4s 6c] [8d]
bilavych: bets $0.40
firstandsole: calls $0.40
*** RIVER *** [8s 4s 6c 8d] [3c]
bilavych: bets $0.50
firstandsole: calls $0.50
*** SHOW DOWN ***
bilavych: shows [8c Qh] (three of a kind, Eights)
firstandsole: mucks hand 
bilavych collected $3.15 from pot
*** SUMMARY ***
Total pot $3.30 | Rake $0.15 
Board [8s 4s 6c 8d 3c]
Seat 1: cel1974 folded before Flop (didn't bet)
Seat 2: firstandsole mucked
Seat 3: Mighty_Rams (button) folded before Flop (didn't bet)
Seat 4: bilavych (small blind) showed [8c Qh] and won ($3.15) with three of a kind, Eights
Seat 5: johnpsg (big blind) folded on the Flop



PokerStars Hand #222972923066:  Hold'em No Limit ($0.05/$0.10 USD) - 2021/01/23 16:41:32 ET
Table 'Demoulina III' 6-max Seat #4 is the button
Seat 1: cel1974 ($21.24 in chips) 
Seat 2: firstandsole ($15.41 in chips) 
Seat 3: Mighty_Rams ($4.74 in chips) 
Seat 4: bilavych ($9.55 in chips) 
Seat 5: johnpsg ($10 in chips) 
Seat 6: LuckyTatia ($10 in chips) 
johnpsg: posts small blind $0.05
LuckyTatia: posts big blind $0.10
*** HOLE CARDS ***
cel1974: folds 
firstandsole: raises $0.20 to $0.30
Mighty_Rams: calls $0.30
bilavych: calls $0.30
johnpsg: folds 
LuckyTatia: calls $0.20
*** FLOP *** [7c 3h 9s]
LuckyTatia: checks 
firstandsole: bets $0.45
Mighty_Rams: folds 
bilavych: folds 
LuckyTatia: folds 
Uncalled bet ($0.45) returned to firstandsole
firstandsole collected $1.19 from pot
firstandsole: doesn't show hand 
*** SUMMARY ***
Total pot $1.25 | Rake $0.06 
Board [7c 3h 9s]
Seat 1: cel1974 folded before Flop (didn't bet)
Seat 2: firstandsole collected ($1.19)
Seat 3: Mighty_Rams folded on the Flop
Seat 4: bilavych (button) folded on the Flop
Seat 5: johnpsg (small blind) folded before Flop
Seat 6: LuckyTatia (big blind) folded on the Flop



PokerStars Hand #222972948489:  Hold'em No Limit ($0.05/$0.10 USD) - 2021/01/23 16:42:03 ET
Table 'Demoulina III' 6-max Seat #5 is the button
Seat 1: cel1974 ($21.24 in chips) 
Seat 2: firstandsole ($16.30 in chips) 
Seat 3: Mighty_Rams ($4.44 in chips) 
Seat 4: bilavych ($9.25 in chips) 
Seat 5: johnpsg ($10 in chips) 
Seat 6: LuckyTatia ($10 in chips) 
LuckyTatia: posts small blind $0.05
cel1974: posts big blind $0.10
*** HOLE CARDS ***
firstandsole: folds 
Mighty_Rams: folds 
bilavych: calls $0.10
johnpsg: folds 
LuckyTatia: calls $0.05
cel1974: checks 
*** FLOP *** [8d Ac Qh]
LuckyTatia: checks 
cel1974: checks 
bilavych: checks 
*** TURN *** [8d Ac Qh] [6h]
LuckyTatia: checks 
cel1974: bets $0.19
bilavych: calls $0.19
LuckyTatia: calls $0.19
*** RIVER *** [8d Ac Qh 6h] [Qd]
LuckyTatia: checks 
cel1974: bets $0.56
bilavych: folds 
LuckyTatia: folds 
Uncalled bet ($0.56) returned to cel1974
cel1974 collected $0.83 from pot
cel1974: doesn't show hand 
*** SUMMARY ***
Total pot $0.87 | Rake $0.04 
Board [8d Ac Qh 6h Qd]
Seat 1: cel1974 (big blind) collected ($0.83)
Seat 2: firstandsole folded before Flop (didn't bet)
Seat 3: Mighty_Rams folded before Flop (didn't bet)
Seat 4: bilavych folded on the River
Seat 5: johnpsg (button) folded before Flop (didn't bet)
Seat 6: LuckyTatia (small blind) folded on the River



PokerStars Hand #222972997520:  Hold'em No Limit ($0.05/$0.10 USD) - 2021/01/23 16:43:03 ET
Table 'Demoulina III' 6-max Seat #6 is the button
Seat 1: cel1974 ($21.78 in chips) 
Seat 2: firstandsole ($16.30 in chips) 
Seat 3: Mighty_Rams ($4.44 in chips) 
Seat 4: bilavych ($8.96 in chips) 
Seat 5: johnpsg ($10 in chips) 
Seat 6: LuckyTatia ($10 in chips) 
cel1974: posts small blind $0.05
firstandsole: posts big blind $0.10
*** HOLE CARDS ***
Mighty_Rams: calls $0.10
bilavych: folds 
johnpsg: folds 
LuckyTatia: folds 
cel1974: folds 
firstandsole: checks 
*** FLOP *** [5d 6d Ad]
firstandsole: checks 
Mighty_Rams: checks 
*** TURN *** [5d 6d Ad] [Th]
firstandsole: bets $0.19
Mighty_Rams: calls $0.19
*** RIVER *** [5d 6d Ad Th] [6h]
firstandsole: checks 
Mighty_Rams: bets $0.30
firstandsole: folds 
Uncalled bet ($0.30) returned to Mighty_Rams
Mighty_Rams collected $0.60 from pot
*** SUMMARY ***
Total pot $0.63 | Rake $0.03 
Board [5d 6d Ad Th 6h]
Seat 1: cel1974 (small blind) folded before Flop
Seat 2: firstandsole (big blind) folded on the River
Seat 3: Mighty_Rams collected ($0.60)
Seat 4: bilavych folded before Flop (didn't bet)
Seat 5: johnpsg folded before Flop (didn't bet)
Seat 6: LuckyTatia (button) folded before Flop (didn't bet)



PokerStars Hand #222973898104:  Hold'em No Limit ($0.05/$0.10 USD) - 2021/01/23 17:02:51 ET
Table 'Demoulina III' 6-max Seat #3 is the button
Seat 1: Kaczka96 ($9.69 in chips) 
Seat 3: Mighty_Rams ($3.94 in chips) 
Seat 4: GraemeDR ($11.23 in chips) 
Seat 5: johnpsg ($10 in chips) 
Seat 6: eanil ($14.86 in chips) 
GraemeDR: posts small blind $0.05
johnpsg: posts big blind $0.10
*** HOLE CARDS ***
eanil: folds 
Kaczka96: folds 
Mighty_Rams: folds 
GraemeDR: raises $0.20 to $0.30
johnpsg: calls $0.20
*** FLOP *** [Ks 9s As]
GraemeDR: checks 
johnpsg: checks 
*** TURN *** [Ks 9s As] [4c]
GraemeDR: bets $0.29
johnpsg: folds 
Uncalled bet ($0.29) returned to GraemeDR
GraemeDR collected $0.57 from pot
GraemeDR: doesn't show hand 
*** SUMMARY ***
Total pot $0.60 | Rake $0.03 
Board [Ks 9s As 4c]
Seat 1: Kaczka96 folded before Flop (didn't bet)
Seat 3: Mighty_Rams (button) folded before Flop (didn't bet)
Seat 4: GraemeDR (small blind) collected ($0.57)
Seat 5: johnpsg (big blind) folded on the Turn
Seat 6: eanil folded before Flop (didn't bet)



PokerStars Hand #222973920525:  Hold'em No Limit ($0.05/$0.10 USD) - 2021/01/23 17:03:18 ET
Table 'Demoulina III' 6-max Seat #4 is the button
Seat 1: Kaczka96 ($9.69 in chips) 
Seat 3: Mighty_Rams ($3.94 in chips) 
Seat 4: GraemeDR ($11.50 in chips) 
Seat 5: johnpsg ($10 in chips) 
Seat 6: eanil ($14.86 in chips) 
johnpsg: posts small blind $0.05
eanil: posts big blind $0.10
*** HOLE CARDS ***
Kaczka96: calls $0.10
Mighty_Rams: calls $0.10
GraemeDR: folds 
johnpsg: calls $0.05
eanil: checks 
*** FLOP *** [5c Ah Qd]
johnpsg: checks 
eanil: checks 
Kaczka96: bets $0.10
Mighty_Rams: calls $0.10
johnpsg: folds 
eanil: folds 
*** TURN *** [5c Ah Qd] [8d]
Kaczka96: bets $0.29
Mighty_Rams: calls $0.29
*** RIVER *** [5c Ah Qd 8d] [7c]
Kaczka96: checks 
Mighty_Rams: checks 
*** SHOW DOWN ***
Kaczka96: shows [Ad 6h] (a pair of Aces)
Mighty_Rams: mucks hand 
Kaczka96 collected $1.13 from pot
*** SUMMARY ***
Total pot $1.18 | Rake $0.05 
Board [5c Ah Qd 8d 7c]
Seat 1: Kaczka96 showed [Ad 6h] and won ($1.13) with a pair of Aces
Seat 3: Mighty_Rams mucked
Seat 4: GraemeDR (button) folded before Flop (didn't bet)
Seat 5: johnpsg (small blind) folded on the Flop
Seat 6: eanil (big blind) folded on the Flop



PokerStars Hand #222973963735:  Hold'em No Limit ($0.05/$0.10 USD) - 2021/01/23 17:03:57 ET
Table 'Demoulina III' 6-max Seat #5 is the button
Seat 1: Kaczka96 ($10.33 in chips) 
Seat 3: Mighty_Rams ($3.45 in chips) 
Seat 4: GraemeDR ($11.50 in chips) 
Seat 5: johnpsg ($10 in chips) 
Seat 6: eanil ($14.76 in chips) 
eanil: posts small blind $0.05
Kaczka96: posts big blind $0.10
*** HOLE CARDS ***
Mighty_Rams: folds 
GraemeDR: folds 
johnpsg: raises $0.13 to $0.23
eanil: raises $0.57 to $0.80
Kaczka96: folds 
johnpsg: calls $0.57
*** FLOP *** [Tc 6d 5h]
eanil: bets $0.53
johnpsg: calls $0.53
*** TURN *** [Tc 6d 5h] [5d]
eanil: checks 
johnpsg: bets $1.32
eanil: folds 
Uncalled bet ($1.32) returned to johnpsg
johnpsg collected $2.64 from pot
johnpsg: doesn't show hand 
*** SUMMARY ***
Total pot $2.76 | Rake $0.12 
Board [Tc 6d 5h 5d]
Seat 1: Kaczka96 (big blind) folded before Flop
Seat 3: Mighty_Rams folded before Flop (didn't bet)
Seat 4: GraemeDR folded before Flop (didn't bet)
Seat 5: johnpsg (button) collected ($2.64)
Seat 6: eanil (small blind) folded on the Turn



PokerStars Hand #222974014238:  Hold'em No Limit ($0.05/$0.10 USD) - 2021/01/23 17:04:45 ET
Table 'Demoulina III' 6-max Seat #6 is the button
Seat 1: Kaczka96 ($10.23 in chips) 
Seat 3: Mighty_Rams ($3.45 in chips) 
Seat 4: GraemeDR ($11.50 in chips) 
Seat 5: johnpsg ($11.31 in chips) 
Seat 6: eanil ($13.43 in chips) 
Kaczka96: posts small blind $0.05
Mighty_Rams: posts big blind $0.10
*** HOLE CARDS ***
GraemeDR: folds 
johnpsg: folds 
eanil has timed out
eanil: folds 
Kaczka96: raises $0.10 to $0.20
Mighty_Rams: calls $0.10
*** FLOP *** [Jc 5d 7h]
Kaczka96: bets $0.19
Mighty_Rams: calls $0.19
*** TURN *** [Jc 5d 7h] [2h]
Kaczka96: checks 
Mighty_Rams: checks 
*** RIVER *** [Jc 5d 7h 2h] [5s]
Kaczka96: bets $0.74
Mighty_Rams: raises $0.76 to $1.50
Kaczka96: calls $0.76
*** SHOW DOWN ***
Mighty_Rams: shows [5c Kd] (three of a kind, Fives)
Kaczka96: mucks hand 
Mighty_Rams collected $3.61 from pot
*** SUMMARY ***
Total pot $3.78 | Rake $0.17 
Board [Jc 5d 7h 2h 5s]
Seat 1: Kaczka96 (small blind) mucked
Seat 3: Mighty_Rams (big blind) showed [5c Kd] and won ($3.61) with three of a kind, Fives
Seat 4: GraemeDR folded before Flop (didn't bet)
Seat 5: johnpsg folded before Flop (didn't bet)
Seat 6: eanil (button) folded before Flop (didn't bet)



PokerStars Hand #222974058900:  Hold'em No Limit ($0.05/$0.10 USD) - 2021/01/23 17:05:39 ET
Table 'Demoulina III' 6-max Seat #1 is the button
Seat 1: Kaczka96 ($8.34 in chips) 
Seat 3: Mighty_Rams ($5.17 in chips) 
Seat 4: GraemeDR ($11.50 in chips) 
Seat 5: johnpsg ($11.31 in chips) 
Seat 6: eanil ($13.43 in chips) 
Mighty_Rams: posts small blind $0.05
GraemeDR: posts big blind $0.10
*** HOLE CARDS ***
johnpsg: folds 
eanil: raises $0.15 to $0.25
Kaczka96: folds 
Mighty_Rams: folds 
GraemeDR: calls $0.15
*** FLOP *** [4h 4c 3c]
GraemeDR: checks 
eanil: bets $0.29
GraemeDR: raises $0.71 to $1
eanil: calls $0.71
*** TURN *** [4h 4c 3c] [2h]
GraemeDR: bets $1.80
eanil: calls $1.80
*** RIVER *** [4h 4c 3c 2h] [Ah]
GraemeDR: bets $2.90
eanil: calls $2.90
*** SHOW DOWN ***
GraemeDR: shows [Tc 9d] (a pair of Fours)
eanil: shows [Ac Qc] (two pair, Aces and Fours)
eanil collected $11.41 from pot
*** SUMMARY ***
Total pot $11.95 | Rake $0.54 
Board [4h 4c 3c 2h Ah]
Seat 1: Kaczka96 (button) folded before Flop (didn't bet)
Seat 3: Mighty_Rams (small blind) folded before Flop
Seat 4: GraemeDR (big blind) showed [Tc 9d] and lost with a pair of Fours
Seat 5: johnpsg folded before Flop (didn't bet)
Seat 6: eanil showed [Ac Qc] and won ($11.41) with two pair, Aces and Fours



PokerStars Hand #222974101593:  Hold'em No Limit ($0.05/$0.10 USD) - 2021/01/23 17:06:30 ET
Table 'Demoulina III' 6-max Seat #3 is the button
Seat 1: Kaczka96 ($8.34 in chips) 
Seat 3: Mighty_Rams ($5.12 in chips) 
Seat 4: GraemeDR ($10 in chips) 
Seat 5: johnpsg ($11.31 in chips) 
Seat 6: eanil ($18.89 in chips) 
GraemeDR: posts small blind $0.05
johnpsg: posts big blind $0.10
*** HOLE CARDS ***
eanil: raises $0.15 to $0.25
Kaczka96: folds 
Mighty_Rams: folds 
GraemeDR: folds 
johnpsg: calls $0.15
*** FLOP *** [8d 4s 6c]
johnpsg: checks 
eanil: bets $0.17
johnpsg: calls $0.17
*** TURN *** [8d 4s 6c] [Td]
johnpsg: checks 
eanil: checks 
*** RIVER *** [8d 4s 6c Td] [4c]
johnpsg: checks 
eanil: checks 
*** SHOW DOWN ***
johnpsg: shows [Ah 6h] (two pair, Sixes and Fours)
eanil: mucks hand 
johnpsg collected $0.85 from pot
*** SUMMARY ***
Total pot $0.89 | Rake $0.04 
Board [8d 4s 6c Td 4c]
Seat 1: Kaczka96 folded before Flop (didn't bet)
Seat 3: Mighty_Rams (button) folded before Flop (didn't bet)
Seat 4: GraemeDR (small blind) folded before Flop
Seat 5: johnpsg (big blind) showed [Ah 6h] and won ($0.85) with two pair, Sixes and Fours
Seat 6: eanil mucked



PokerStars Hand #222974127135:  Hold'em No Limit ($0.05/$0.10 USD) - 2021/01/23 17:07:01 ET
Table 'Demoulina III' 6-max Seat #4 is the button
Seat 1: Kaczka96 ($8.34 in chips) 
Seat 3: Mighty_Rams ($5.12 in chips) 
Seat 4: GraemeDR ($10 in chips) 
Seat 5: johnpsg ($11.74 in chips) 
Seat 6: eanil ($18.47 in chips) 
johnpsg: posts small blind $0.05
eanil: posts big blind $0.10
*** HOLE CARDS ***
Kaczka96: raises $0.10 to $0.20
Mighty_Rams: folds 
GraemeDR: folds 
johnpsg: folds 
eanil: calls $0.10
*** FLOP *** [8s 8c Jc]
eanil: checks 
Kaczka96: bets $0.10
eanil: raises $0.20 to $0.30
Kaczka96: calls $0.20
*** TURN *** [8s 8c Jc] [9c]
eanil: bets $0.72
Kaczka96: calls $0.72
*** RIVER *** [8s 8c Jc 9c] [Tc]
eanil: checks 
Kaczka96: bets $7.12 and is all-in
eanil: folds 
Uncalled bet ($7.12) returned to Kaczka96
Kaczka96 collected $2.38 from pot
Kaczka96: doesn't show hand 
*** SUMMARY ***
Total pot $2.49 | Rake $0.11 
Board [8s 8c Jc 9c Tc]
Seat 1: Kaczka96 collected ($2.38)
Seat 3: Mighty_Rams folded before Flop (didn't bet)
Seat 4: GraemeDR (button) folded before Flop (didn't bet)
Seat 5: johnpsg (small blind) folded before Flop
Seat 6: eanil (big blind) folded on the River



PokerStars Hand #222974159645:  Hold'em No Limit ($0.05/$0.10 USD) - 2021/01/23 17:07:40 ET
Table 'Demoulina III' 6-max Seat #5 is the button
Seat 1: Kaczka96 ($9.50 in chips) 
Seat 3: Mighty_Rams ($5.12 in chips) 
Seat 4: GraemeDR ($10 in chips) 
Seat 5: johnpsg ($11.69 in chips) 
Seat 6: eanil ($17.25 in chips) 
eanil: posts small blind $0.05
Kaczka96: posts big blind $0.10
*** HOLE CARDS ***
Mighty_Rams: calls $0.10
GraemeDR: folds 
johnpsg: folds 
eanil: folds 
Kaczka96: checks 
*** FLOP *** [6h 4h 7s]
Kaczka96: bets $0.10
Mighty_Rams: calls $0.10
*** TURN *** [6h 4h 7s] [Tc]
Kaczka96: bets $0.43
Mighty_Rams: calls $0.43
*** RIVER *** [6h 4h 7s Tc] [Kc]
Kaczka96: checks 
Mighty_Rams: bets $0.60
Kaczka96: calls $0.60
*** SHOW DOWN ***
Mighty_Rams: shows [Js 8d] (high card King)
Kaczka96: shows [6d Th] (two pair, Tens and Sixes)
Kaczka96 collected $2.40 from pot
*** SUMMARY ***
Total pot $2.51 | Rake $0.11 
Board [6h 4h 7s Tc Kc]
Seat 1: Kaczka96 (big blind) showed [6d Th] and won ($2.40) with two pair, Tens and Sixes
Seat 3: Mighty_Rams showed [Js 8d] and lost with high card King
Seat 4: GraemeDR folded before Flop (didn't bet)
Seat 5: johnpsg (button) folded before Flop (didn't bet)
Seat 6: eanil (small blind) folded before Flop



PokerStars Hand #222974219140:  Hold'em No Limit ($0.05/$0.10 USD) - 2021/01/23 17:08:51 ET
Table 'Demoulina III' 6-max Seat #6 is the button
Seat 1: Kaczka96 ($10.67 in chips) 
Seat 3: Mighty_Rams ($3.89 in chips) 
Seat 4: GraemeDR ($10 in chips) 
Seat 5: johnpsg ($11.69 in chips) 
Seat 6: eanil ($17.20 in chips) 
Kaczka96: posts small blind $0.05
Mighty_Rams: posts big blind $0.10
*** HOLE CARDS ***
GraemeDR: folds 
johnpsg: folds 
eanil: folds 
Kaczka96: calls $0.05
Mighty_Rams: checks 
*** FLOP *** [Ah Jd 6c]
Kaczka96: checks 
Mighty_Rams: bets $0.19
Kaczka96: folds 
Uncalled bet ($0.19) returned to Mighty_Rams
Mighty_Rams collected $0.19 from pot
*** SUMMARY ***
Total pot $0.20 | Rake $0.01 
Board [Ah Jd 6c]
Seat 1: Kaczka96 (small blind) folded on the Flop
Seat 3: Mighty_Rams (big blind) collected ($0.19)
Seat 4: GraemeDR folded before Flop (didn't bet)
Seat 5: johnpsg folded before Flop (didn't bet)
Seat 6: eanil (button) folded before Flop (didn't bet)



PokerStars Hand #222974241566:  Hold'em No Limit ($0.05/$0.10 USD) - 2021/01/23 17:09:18 ET
Table 'Demoulina III' 6-max Seat #1 is the button
Seat 1: Kaczka96 ($10.57 in chips) 
Seat 3: Mighty_Rams ($3.98 in chips) 
Seat 4: GraemeDR ($10 in chips) 
Seat 5: johnpsg ($11.69 in chips) 
Seat 6: eanil ($17.20 in chips) 
Mighty_Rams: posts small blind $0.05
GraemeDR: posts big blind $0.10
*** HOLE CARDS ***
johnpsg: folds 
eanil: folds 
Kaczka96: raises $0.10 to $0.20
Mighty_Rams: raises $0.30 to $0.50
GraemeDR: calls $0.40
Kaczka96: calls $0.30
*** FLOP *** [Qd 6s Td]
Mighty_Rams: checks 
GraemeDR: bets $1.07
Kaczka96: folds 
Mighty_Rams: calls $1.07
*** TURN *** [Qd 6s Td] [5s]
Mighty_Rams: checks 
GraemeDR: checks 
*** RIVER *** [Qd 6s Td 5s] [3h]
Mighty_Rams: bets $1.21
GraemeDR: calls $1.21
*** SHOW DOWN ***
Mighty_Rams: shows [Ac Kc] (high card Ace)
GraemeDR: shows [7h 6h] (a pair of Sixes)
GraemeDR collected $5.79 from pot
*** SUMMARY ***
Total pot $6.06 | Rake $0.27 
Board [Qd 6s Td 5s 3h]
Seat 1: Kaczka96 (button) folded on the Flop
Seat 3: Mighty_Rams (small blind) showed [Ac Kc] and lost with high card Ace
Seat 4: GraemeDR (big blind) showed [7h 6h] and won ($5.79) with a pair of Sixes
Seat 5: johnpsg folded before Flop (didn't bet)
Seat 6: eanil folded before Flop (didn't bet)



PokerStars Hand #222974278973:  Hold'em No Limit ($0.05/$0.10 USD) - 2021/01/23 17:10:03 ET
Table 'Demoulina III' 6-max Seat #3 is the button
Seat 1: Kaczka96 ($10.07 in chips) 
Seat 3: Mighty_Rams ($1.20 in chips) 
Seat 4: GraemeDR ($13.01 in chips) 
Seat 5: johnpsg ($11.69 in chips) 
Seat 6: eanil ($17.20 in chips) 
GraemeDR: posts small blind $0.05
johnpsg: posts big blind $0.10
*** HOLE CARDS ***
eanil: folds 
Kaczka96: folds 
Mighty_Rams: calls $0.10
GraemeDR: raises $0.40 to $0.50
johnpsg: folds 
Mighty_Rams: folds 
Uncalled bet ($0.40) returned to GraemeDR
GraemeDR collected $0.30 from pot
GraemeDR: doesn't show hand 
*** SUMMARY ***
Total pot $0.30 | Rake $0 
Seat 1: Kaczka96 folded before Flop (didn't bet)
Seat 3: Mighty_Rams (button) folded before Flop
Seat 4: GraemeDR (small blind) collected ($0.30)
Seat 5: johnpsg (big blind) folded before Flop
Seat 6: eanil folded before Flop (didn't bet)



PokerStars Hand #222974293913:  Hold'em No Limit ($0.05/$0.10 USD) - 2021/01/23 17:10:21 ET
Table 'Demoulina III' 6-max Seat #4 is the button
Seat 1: Kaczka96 ($10.07 in chips) 
Seat 3: Mighty_Rams ($1.10 in chips) 
Seat 4: GraemeDR ($13.21 in chips) 
Seat 5: johnpsg ($11.59 in chips) 
Seat 6: eanil ($17.20 in chips) 
johnpsg: posts small blind $0.05
eanil: posts big blind $0.10
*** HOLE CARDS ***
Kaczka96: folds 
Mighty_Rams: raises $1 to $1.10 and is all-in
GraemeDR: folds 
johnpsg: folds 
eanil: folds 
Uncalled bet ($1) returned to Mighty_Rams
Mighty_Rams collected $0.25 from pot
*** SUMMARY ***
Total pot $0.25 | Rake $0 
Seat 1: Kaczka96 folded before Flop (didn't bet)
Seat 3: Mighty_Rams collected ($0.25)
Seat 4: GraemeDR (button) folded before Flop (didn't bet)
Seat 5: johnpsg (small blind) folded before Flop
Seat 6: eanil (big blind) folded before Flop



PokerStars Hand #222974307444:  Hold'em No Limit ($0.05/$0.10 USD) - 2021/01/23 17:10:37 ET
Table 'Demoulina III' 6-max Seat #5 is the button
Seat 1: Kaczka96 ($10.07 in chips) 
Seat 3: Mighty_Rams ($1.25 in chips) 
Seat 4: GraemeDR ($13.21 in chips) 
Seat 5: johnpsg ($11.54 in chips) 
Seat 6: eanil ($17.10 in chips) 
eanil: posts small blind $0.05
Kaczka96: posts big blind $0.10
*** HOLE CARDS ***
Mighty_Rams: calls $0.10
GraemeDR: folds 
johnpsg: folds 
eanil: raises $0.30 to $0.40
Kaczka96: calls $0.30
Mighty_Rams: calls $0.30
*** FLOP *** [Tc 2d Qd]
eanil: bets $0.30
Kaczka96: raises $0.30 to $0.60
Mighty_Rams: folds 
eanil: calls $0.30
*** TURN *** [Tc 2d Qd] [4h]
eanil: checks 
Kaczka96: checks 
*** RIVER *** [Tc 2d Qd 4h] [3d]
eanil: checks 
Kaczka96: bets $9.07 and is all-in
eanil: folds [Qh]
Uncalled bet ($9.07) returned to Kaczka96
Kaczka96 collected $2.29 from pot
Kaczka96: doesn't show hand 
*** SUMMARY ***
Total pot $2.40 | Rake $0.11 
Board [Tc 2d Qd 4h 3d]
Seat 1: Kaczka96 (big blind) collected ($2.29)
Seat 3: Mighty_Rams folded on the Flop
Seat 4: GraemeDR folded before Flop (didn't bet)
Seat 5: johnpsg (button) folded before Flop (didn't bet)
Seat 6: eanil (small blind) folded on the River



PokerStars Hand #222974344551:  Hold'em No Limit ($0.05/$0.10 USD) - 2021/01/23 17:11:22 ET
Table 'Demoulina III' 6-max Seat #6 is the button
Seat 1: Kaczka96 ($11.36 in chips) 
Seat 3: Mighty_Rams ($0.85 in chips) 
Seat 4: GraemeDR ($13.21 in chips) 
Seat 5: johnpsg ($11.54 in chips) 
Seat 6: eanil ($16.10 in chips) 
Kaczka96: posts small blind $0.05
Mighty_Rams: posts big blind $0.10
*** HOLE CARDS ***
GraemeDR: folds 
johnpsg: folds 
eanil: raises $0.15 to $0.25
Kaczka96: calls $0.20
Mighty_Rams: folds 
*** FLOP *** [3s Kh As]
Kaczka96: bets $0.57
eanil: calls $0.57
*** TURN *** [3s Kh As] [4c]
Kaczka96: bets $1.66
eanil: calls $1.66
*** RIVER *** [3s Kh As 4c] [Ts]
Kaczka96: checks 
eanil: checks 
*** SHOW DOWN ***
Kaczka96: shows [4d Ac] (two pair, Aces and Fours)
eanil: mucks hand 
Kaczka96 collected $4.83 from pot
firstandsole was removed from the table for failing to post
firstandsole leaves the table
*** SUMMARY ***
Total pot $5.06 | Rake $0.23 
Board [3s Kh As 4c Ts]
Seat 1: Kaczka96 (small blind) showed [4d Ac] and won ($4.83) with two pair, Aces and Fours
Seat 3: Mighty_Rams (big blind) folded before Flop
Seat 4: GraemeDR folded before Flop (didn't bet)
Seat 5: johnpsg folded before Flop (didn't bet)
Seat 6: eanil (button) mucked



PokerStars Hand #222974379898:  Hold'em No Limit ($0.05/$0.10 USD) - 2021/01/23 17:12:05 ET
Table 'Demoulina III' 6-max Seat #1 is the button
Seat 1: Kaczka96 ($13.71 in chips) 
Seat 3: Mighty_Rams ($0.75 in chips) 
Seat 4: GraemeDR ($13.21 in chips) 
Seat 5: johnpsg ($11.54 in chips) 
Seat 6: eanil ($13.62 in chips) 
Mighty_Rams: posts small blind $0.05
GraemeDR: posts big blind $0.10
*** HOLE CARDS ***
johnpsg: folds 
eanil: folds 
Kaczka96: folds 
Mighty_Rams: calls $0.05
GraemeDR: checks 
*** FLOP *** [5h Kh 3h]
Mighty_Rams: checks 
Zimniy joins the table at seat #2 
GraemeDR: checks 
*** TURN *** [5h Kh 3h] [7c]
Mighty_Rams: checks 
GraemeDR: bets $0.10
Mighty_Rams: raises $0.20 to $0.30
GraemeDR: calls $0.20
*** RIVER *** [5h Kh 3h 7c] [9d]
Mighty_Rams: bets $0.35 and is all-in
GraemeDR: calls $0.35
*** SHOW DOWN ***
Mighty_Rams: shows [Th 8h] (a flush, King high)
GraemeDR: shows [4s 7s] (a pair of Sevens)
Mighty_Rams collected $1.43 from pot
*** SUMMARY ***
Total pot $1.50 | Rake $0.07 
Board [5h Kh 3h 7c 9d]
Seat 1: Kaczka96 (button) folded before Flop (didn't bet)
Seat 3: Mighty_Rams (small blind) showed [Th 8h] and won ($1.43) with a flush, King high
Seat 4: GraemeDR (big blind) showed [4s 7s] and lost with a pair of Sevens
Seat 5: johnpsg folded before Flop (didn't bet)
Seat 6: eanil folded before Flop (didn't bet)



PokerStars Hand #222974407729:  Hold'em No Limit ($0.05/$0.10 USD) - 2021/01/23 17:12:38 ET
Table 'Demoulina III' 6-max Seat #3 is the button
Seat 1: Kaczka96 ($13.71 in chips) 
Seat 3: Mighty_Rams ($1.43 in chips) 
Seat 4: GraemeDR ($12.46 in chips) 
Seat 5: johnpsg ($11.54 in chips) 
Seat 6: eanil ($13.62 in chips) 
GraemeDR: posts small blind $0.05
johnpsg: posts big blind $0.10
Zimniy: sits out 
*** HOLE CARDS ***
eanil: raises $0.15 to $0.25
Kaczka96: folds 
Mighty_Rams: folds 
GraemeDR: raises $0.75 to $1
johnpsg: folds 
eanil: calls $0.75
*** FLOP *** [6h Qd Jh]
GraemeDR: bets $1.51
eanil: folds 
Uncalled bet ($1.51) returned to GraemeDR
GraemeDR collected $2.01 from pot
GraemeDR: doesn't show hand 
*** SUMMARY ***
Total pot $2.10 | Rake $0.09 
Board [6h Qd Jh]
Seat 1: Kaczka96 folded before Flop (didn't bet)
Seat 3: Mighty_Rams (button) folded before Flop (didn't bet)
Seat 4: GraemeDR (small blind) collected ($2.01)
Seat 5: johnpsg (big blind) folded before Flop
Seat 6: eanil folded on the Flop



PokerStars Hand #222974448265:  Hold'em No Limit ($0.05/$0.10 USD) - 2021/01/23 17:13:28 ET
Table 'Demoulina III' 6-max Seat #4 is the button
Seat 1: Kaczka96 ($13.71 in chips) 
Seat 3: Mighty_Rams ($1.43 in chips) 
Seat 4: GraemeDR ($13.47 in chips) 
Seat 5: johnpsg ($11.44 in chips) 
johnpsg: posts small blind $0.05
eanil: is sitting out 
Kaczka96: posts big blind $0.10
Zimniy: sits out 
*** HOLE CARDS ***
Mighty_Rams: folds 
eanil leaves the table
GraemeDR: folds 
johnpsg: raises $0.15 to $0.25
Kaczka96: calls $0.15
*** FLOP *** [Js 4h 8s]
johnpsg: checks 
Kaczka96: checks 
*** TURN *** [Js 4h 8s] [5c]
johnpsg: checks 
Kaczka96: bets $0.10
Homermckinley77 joins the table at seat #6 
johnpsg: folds 
Uncalled bet ($0.10) returned to Kaczka96
Kaczka96 collected $0.48 from pot
Kaczka96: doesn't show hand 
*** SUMMARY ***
Total pot $0.50 | Rake $0.02 
Board [Js 4h 8s 5c]
Seat 1: Kaczka96 (big blind) collected ($0.48)
Seat 3: Mighty_Rams folded before Flop (didn't bet)
Seat 4: GraemeDR (button) folded before Flop (didn't bet)
Seat 5: johnpsg (small blind) folded on the Turn



PokerStars Hand #222974474604:  Hold'em No Limit ($0.05/$0.10 USD) - 2021/01/23 17:14:00 ET
Table 'Demoulina III' 6-max Seat #5 is the button
Seat 1: Kaczka96 ($13.94 in chips) 
Seat 2: Zimniy ($10 in chips) 
Seat 3: Mighty_Rams ($1.43 in chips) 
Seat 4: GraemeDR ($13.47 in chips) 
Seat 5: johnpsg ($11.19 in chips) 
Kaczka96: posts small blind $0.05
Zimniy: posts big blind $0.10
*** HOLE CARDS ***
Mighty_Rams: calls $0.10
GraemeDR: folds 
johnpsg: calls $0.10
Kaczka96: calls $0.05
Zimniy: checks 
*** FLOP *** [7c 9d Qc]
Kaczka96: bets $0.10
Zimniy: folds 
Mighty_Rams: calls $0.10
johnpsg: folds 
*** TURN *** [7c 9d Qc] [5h]
Kaczka96: checks 
Mighty_Rams: checks 
*** RIVER *** [7c 9d Qc 5h] [6d]
Kaczka96: bets $0.57
Mighty_Rams: calls $0.57
*** SHOW DOWN ***
Kaczka96: shows [5d 8s] (a straight, Five to Nine)
Mighty_Rams: mucks hand 
Kaczka96 collected $1.66 from pot
*** SUMMARY ***
Total pot $1.74 | Rake $0.08 
Board [7c 9d Qc 5h 6d]
Seat 1: Kaczka96 (small blind) showed [5d 8s] and won ($1.66) with a straight, Five to Nine
Seat 2: Zimniy (big blind) folded on the Flop
Seat 3: Mighty_Rams mucked
Seat 4: GraemeDR folded before Flop (didn't bet)
Seat 5: johnpsg (button) folded on the Flop



PokerStars Hand #222974520920:  Hold'em No Limit ($0.05/$0.10 USD) - 2021/01/23 17:14:56 ET
Table 'Demoulina III' 6-max Seat #1 is the button
Seat 1: Kaczka96 ($14.83 in chips) 
Seat 2: Zimniy ($10 in chips) 
Seat 3: Mighty_Rams ($0.66 in chips) 
Seat 4: GraemeDR ($13.47 in chips) 
Seat 5: johnpsg ($11.09 in chips) 
Seat 6: Homermckinley77 ($5 in chips) 
Zimniy: posts small blind $0.05
Mighty_Rams: posts big blind $0.10
Homermckinley77: posts big blind $0.10
*** HOLE CARDS ***
GraemeDR: folds 
johnpsg: raises $0.30 to $0.40
Homermckinley77: folds 
Kaczka96: folds 
Zimniy: folds 
Mighty_Rams: calls $0.30
*** FLOP *** [2s Qh Qs]
Mighty_Rams: checks 
johnpsg: bets $0.30
Mighty_Rams: folds 
Uncalled bet ($0.30) returned to johnpsg
johnpsg collected $0.91 from pot
johnpsg: doesn't show hand 
*** SUMMARY ***
Total pot $0.95 | Rake $0.04 
Board [2s Qh Qs]
Seat 1: Kaczka96 (button) folded before Flop (didn't bet)
Seat 2: Zimniy (small blind) folded before Flop
Seat 3: Mighty_Rams (big blind) folded on the Flop
Seat 4: GraemeDR folded before Flop (didn't bet)
Seat 5: johnpsg collected ($0.91)
Seat 6: Homermckinley77 folded before Flop (didn't bet)



PokerStars Hand #222974542248:  Hold'em No Limit ($0.05/$0.10 USD) - 2021/01/23 17:15:22 ET
Table 'Demoulina III' 6-max Seat #2 is the button
Seat 1: Kaczka96 ($14.83 in chips) 
Seat 2: Zimniy ($10 in chips) 
Seat 3: Mighty_Rams ($0.26 in chips) 
Seat 4: GraemeDR ($13.47 in chips) 
Seat 5: johnpsg ($11.60 in chips) 
Seat 6: Homermckinley77 ($4.90 in chips) 
Mighty_Rams: posts small blind $0.05
GraemeDR: posts big blind $0.10
*** HOLE CARDS ***
johnpsg: folds 
Homermckinley77: folds 
Kaczka96: raises $0.10 to $0.20
Zimniy: folds 
Mighty_Rams: raises $0.06 to $0.26 and is all-in
GraemeDR: calls $0.16
Kaczka96: calls $0.06
*** FLOP *** [Jd As 5h]
GraemeDR: checks 
Kaczka96: checks 
*** TURN *** [Jd As 5h] [4d]
GraemeDR: checks 
Kaczka96: checks 
*** RIVER *** [Jd As 5h 4d] [Ts]
GraemeDR: checks 
Kaczka96: checks 
*** SHOW DOWN ***
Mighty_Rams: shows [Ad Ah] (three of a kind, Aces)
GraemeDR: mucks hand 
Kaczka96: mucks hand 
Mighty_Rams collected $0.74 from pot
*** SUMMARY ***
Total pot $0.78 | Rake $0.04 
Board [Jd As 5h 4d Ts]
Seat 1: Kaczka96 mucked
Seat 2: Zimniy (button) folded before Flop (didn't bet)
Seat 3: Mighty_Rams (small blind) showed [Ad Ah] and won ($0.74) with three of a kind, Aces
Seat 4: GraemeDR (big blind) mucked
Seat 5: johnpsg folded before Flop (didn't bet)
Seat 6: Homermckinley77 folded before Flop (didn't bet)



PokerStars Hand #222974583212:  Hold'em No Limit ($0.05/$0.10 USD) - 2021/01/23 17:16:12 ET
Table 'Demoulina III' 6-max Seat #3 is the button
Seat 1: Kaczka96 ($14.57 in chips) 
Seat 2: Zimniy ($10 in chips) 
Seat 3: Mighty_Rams ($0.74 in chips) 
Seat 4: GraemeDR ($13.21 in chips) 
Seat 5: johnpsg ($11.60 in chips) 
Seat 6: Homermckinley77 ($4.90 in chips) 
GraemeDR: posts small blind $0.05
johnpsg: posts big blind $0.10
*** HOLE CARDS ***
Homermckinley77: calls $0.10
Kaczka96: folds 
Zimniy: folds 
Mighty_Rams: folds 
GraemeDR: folds 
johnpsg: checks 
*** FLOP *** [Ah Qd 7h]
johnpsg: checks 
Homermckinley77: checks 
*** TURN *** [Ah Qd 7h] [3c]
johnpsg: checks 
Homermckinley77: checks 
*** RIVER *** [Ah Qd 7h 3c] [9h]
johnpsg: checks 
Homermckinley77: checks 
*** SHOW DOWN ***
johnpsg: shows [8h Ks] (high card Ace)
Homermckinley77: mucks hand 
johnpsg collected $0.24 from pot
*** SUMMARY ***
Total pot $0.25 | Rake $0.01 
Board [Ah Qd 7h 3c 9h]
Seat 1: Kaczka96 folded before Flop (didn't bet)
Seat 2: Zimniy folded before Flop (didn't bet)
Seat 3: Mighty_Rams (button) folded before Flop (didn't bet)
Seat 4: GraemeDR (small blind) folded before Flop
Seat 5: johnpsg (big blind) showed [8h Ks] and won ($0.24) with high card Ace
Seat 6: Homermckinley77 mucked



PokerStars Hand #222974613613:  Hold'em No Limit ($0.05/$0.10 USD) - 2021/01/23 17:16:49 ET
Table 'Demoulina III' 6-max Seat #4 is the button
Seat 1: Kaczka96 ($14.57 in chips) 
Seat 2: Zimniy ($10 in chips) 
Seat 3: Mighty_Rams ($0.74 in chips) 
Seat 4: GraemeDR ($13.16 in chips) 
Seat 5: johnpsg ($11.74 in chips) 
Seat 6: Homermckinley77 ($4.80 in chips) 
johnpsg: posts small blind $0.05
Homermckinley77: posts big blind $0.10
*** HOLE CARDS ***
Kaczka96: raises $0.10 to $0.20
Zimniy: folds 
Mighty_Rams: folds 
GraemeDR: folds 
johnpsg: folds 
Homermckinley77: folds 
Uncalled bet ($0.10) returned to Kaczka96
Kaczka96 collected $0.25 from pot
Kaczka96: doesn't show hand 
*** SUMMARY ***
Total pot $0.25 | Rake $0 
Seat 1: Kaczka96 collected ($0.25)
Seat 2: Zimniy folded before Flop (didn't bet)
Seat 3: Mighty_Rams folded before Flop (didn't bet)
Seat 4: GraemeDR (button) folded before Flop (didn't bet)
Seat 5: johnpsg (small blind) folded before Flop
Seat 6: Homermckinley77 (big blind) folded before Flop



PokerStars Hand #222974640494:  Hold'em No Limit ($0.05/$0.10 USD) - 2021/01/23 17:17:21 ET
Table 'Demoulina III' 6-max Seat #5 is the button
Seat 1: Kaczka96 ($14.72 in chips) 
Seat 2: Zimniy ($10 in chips) 
Seat 3: Mighty_Rams ($0.74 in chips) 
Seat 4: GraemeDR ($13.16 in chips) 
Seat 5: johnpsg ($11.69 in chips) 
Seat 6: Homermckinley77 ($4.70 in chips) 
Homermckinley77: posts small blind $0.05
Kaczka96: posts big blind $0.10
*** HOLE CARDS ***
Zimniy: folds 
Mighty_Rams: folds 
GraemeDR: raises $0.25 to $0.35
johnpsg: folds 
Homermckinley77: calls $0.30
Kaczka96: calls $0.25
*** FLOP *** [Ac Kd 3s]
Homermckinley77: checks 
Kaczka96: checks 
GraemeDR: bets $0.60
Homermckinley77: calls $0.60
Kaczka96: folds 
*** TURN *** [Ac Kd 3s] [3h]
Homermckinley77: checks 
GraemeDR: bets $1.29
Homermckinley77: folds 
Uncalled bet ($1.29) returned to GraemeDR
GraemeDR collected $2.15 from pot
GraemeDR: doesn't show hand 
*** SUMMARY ***
Total pot $2.25 | Rake $0.10 
Board [Ac Kd 3s 3h]
Seat 1: Kaczka96 (big blind) folded on the Flop
Seat 2: Zimniy folded before Flop (didn't bet)
Seat 3: Mighty_Rams folded before Flop (didn't bet)
Seat 4: GraemeDR collected ($2.15)
Seat 5: johnpsg (button) folded before Flop (didn't bet)
Seat 6: Homermckinley77 (small blind) folded on the Turn



PokerStars Hand #222974675638:  Hold'em No Limit ($0.05/$0.10 USD) - 2021/01/23 17:18:04 ET
Table 'Demoulina III' 6-max Seat #6 is the button
Seat 1: Kaczka96 ($14.37 in chips) 
Seat 2: Zimniy ($10 in chips) 
Seat 3: Mighty_Rams ($0.74 in chips) 
Seat 4: GraemeDR ($14.36 in chips) 
Seat 5: johnpsg ($11.69 in chips) 
Seat 6: Homermckinley77 ($3.75 in chips) 
Kaczka96: posts small blind $0.05
Zimniy: posts big blind $0.10
*** HOLE CARDS ***
Mighty_Rams: folds 
GraemeDR: folds 
johnpsg: folds 
Homermckinley77: calls $0.10
Kaczka96: calls $0.05
Zimniy: checks 
*** FLOP *** [Tc Kd As]
Kaczka96: bets $0.29
Zimniy: folds 
Homermckinley77: calls $0.29
*** TURN *** [Tc Kd As] [Th]
Kaczka96: checks 
Homermckinley77: checks 
*** RIVER *** [Tc Kd As Th] [8h]
Kaczka96: checks 
Homermckinley77: checks 
*** SHOW DOWN ***
Kaczka96: shows [8d Qs] (two pair, Tens and Eights)
Homermckinley77: shows [Ad Qh] (two pair, Aces and Tens)
Homermckinley77 collected $0.84 from pot
*** SUMMARY ***
Total pot $0.88 | Rake $0.04 
Board [Tc Kd As Th 8h]
Seat 1: Kaczka96 (small blind) showed [8d Qs] and lost with two pair, Tens and Eights
Seat 2: Zimniy (big blind) folded on the Flop
Seat 3: Mighty_Rams folded before Flop (didn't bet)
Seat 4: GraemeDR folded before Flop (didn't bet)
Seat 5: johnpsg folded before Flop (didn't bet)
Seat 6: Homermckinley77 (button) showed [Ad Qh] and won ($0.84) with two pair, Aces and Tens



PokerStars Hand #222974731113:  Hold'em No Limit ($0.05/$0.10 USD) - 2021/01/23 17:19:11 ET
Table 'Demoulina III' 6-max Seat #1 is the button
Seat 1: Kaczka96 ($13.98 in chips) 
Seat 2: Zimniy ($10 in chips) 
Seat 3: Mighty_Rams ($0.74 in chips) 
Seat 4: GraemeDR ($14.36 in chips) 
Seat 5: johnpsg ($11.69 in chips) 
Seat 6: Homermckinley77 ($4.20 in chips) 
Zimniy: posts small blind $0.05
Mighty_Rams: posts big blind $0.10
*** HOLE CARDS ***
GraemeDR: folds 
johnpsg: folds 
Homermckinley77: calls $0.10
Kaczka96: folds 
Zimniy: folds 
Mighty_Rams: checks 
*** FLOP *** [Ts 3h Jc]
Mighty_Rams: checks 
Homermckinley77: bets $0.10
Mighty_Rams: calls $0.10
*** TURN *** [Ts 3h Jc] [Qd]
Mighty_Rams: bets $0.54 and is all-in
Homermckinley77: calls $0.54
*** RIVER *** [Ts 3h Jc Qd] [2h]
*** SHOW DOWN ***
Mighty_Rams: shows [8h Qh] (a pair of Queens)
Homermckinley77: shows [Kc 8d] (high card King)
Mighty_Rams collected $1.46 from pot
*** SUMMARY ***
Total pot $1.53 | Rake $0.07 
Board [Ts 3h Jc Qd 2h]
Seat 1: Kaczka96 (button) folded before Flop (didn't bet)
Seat 2: Zimniy (small blind) folded before Flop
Seat 3: Mighty_Rams (big blind) showed [8h Qh] and won ($1.46) with a pair of Queens
Seat 4: GraemeDR folded before Flop (didn't bet)
Seat 5: johnpsg folded before Flop (didn't bet)
Seat 6: Homermckinley77 showed [Kc 8d] and lost with high card King



PokerStars Hand #222974772741:  Hold'em No Limit ($0.05/$0.10 USD) - 2021/01/23 17:20:03 ET
Table 'Demoulina III' 6-max Seat #2 is the button
Seat 1: Kaczka96 ($13.98 in chips) 
Seat 2: Zimniy ($10 in chips) 
Seat 3: Mighty_Rams ($1.46 in chips) 
Seat 4: GraemeDR ($14.36 in chips) 
Seat 5: johnpsg ($11.69 in chips) 
Seat 6: Homermckinley77 ($3.46 in chips) 
Mighty_Rams: posts small blind $0.05
GraemeDR: posts big blind $0.10
*** HOLE CARDS ***
johnpsg: raises $0.17 to $0.27
Homermckinley77: calls $0.27
Kaczka96: folds 
Zimniy: folds 
Mighty_Rams: folds 
GraemeDR: folds 
*** FLOP *** [5c As Jd]
johnpsg: checks 
Homermckinley77: checks 
*** TURN *** [5c As Jd] [Ks]
johnpsg: checks 
Homermckinley77: bets $0.10
johnpsg: folds 
Uncalled bet ($0.10) returned to Homermckinley77
Homermckinley77 collected $0.66 from pot
Homermckinley77: doesn't show hand 
*** SUMMARY ***
Total pot $0.69 | Rake $0.03 
Board [5c As Jd Ks]
Seat 1: Kaczka96 folded before Flop (didn't bet)
Seat 2: Zimniy (button) folded before Flop (didn't bet)
Seat 3: Mighty_Rams (small blind) folded before Flop
Seat 4: GraemeDR (big blind) folded before Flop
Seat 5: johnpsg folded on the Turn
Seat 6: Homermckinley77 collected ($0.66)



PokerStars Hand #222974813144:  Hold'em No Limit ($0.05/$0.10 USD) - 2021/01/23 17:20:52 ET
Table 'Demoulina III' 6-max Seat #3 is the button
Seat 1: Kaczka96 ($13.98 in chips) 
Seat 2: Zimniy ($10 in chips) 
Seat 3: Mighty_Rams ($1.41 in chips) 
Seat 4: GraemeDR ($14.26 in chips) 
Seat 5: johnpsg ($11.42 in chips) 
Seat 6: Homermckinley77 ($3.85 in chips) 
GraemeDR: posts small blind $0.05
johnpsg: posts big blind $0.10
*** HOLE CARDS ***
Homermckinley77: folds 
Kaczka96: calls $0.10
Zimniy: folds 
Mighty_Rams: calls $0.10
GraemeDR: folds 
johnpsg: checks 
*** FLOP *** [Kh Jd 2h]
johnpsg: checks 
Kaczka96: bets $0.10
Mighty_Rams: calls $0.10
johnpsg: folds 
*** TURN *** [Kh Jd 2h] [Jh]
Kaczka96: bets $0.10
Mighty_Rams: calls $0.10
*** RIVER *** [Kh Jd 2h Jh] [8s]
Kaczka96: bets $1.20
Mighty_Rams: folds 
Uncalled bet ($1.20) returned to Kaczka96
Kaczka96 collected $0.72 from pot
Kaczka96: doesn't show hand 
*** SUMMARY ***
Total pot $0.75 | Rake $0.03 
Board [Kh Jd 2h Jh 8s]
Seat 1: Kaczka96 collected ($0.72)
Seat 2: Zimniy folded before Flop (didn't bet)
Seat 3: Mighty_Rams (button) folded on the River
Seat 4: GraemeDR (small blind) folded before Flop
Seat 5: johnpsg (big blind) folded on the Flop
Seat 6: Homermckinley77 folded before Flop (didn't bet)



PokerStars Hand #222974856740:  Hold'em No Limit ($0.05/$0.10 USD) - 2021/01/23 17:21:46 ET
Table 'Demoulina III' 6-max Seat #4 is the button
Seat 1: Kaczka96 ($14.40 in chips) 
Seat 2: Zimniy ($10 in chips) 
Seat 3: Mighty_Rams ($1.11 in chips) 
Seat 4: GraemeDR ($14.21 in chips) 
Seat 5: johnpsg ($11.32 in chips) 
Seat 6: Homermckinley77 ($3.85 in chips) 
johnpsg: posts small blind $0.05
Homermckinley77: posts big blind $0.10
*** HOLE CARDS ***
Kaczka96: folds 
Zimniy: folds 
Mighty_Rams has timed out
Mighty_Rams: folds 
GraemeDR: folds 
johnpsg: folds 
Uncalled bet ($0.05) returned to Homermckinley77
Homermckinley77 collected $0.10 from pot
Homermckinley77: doesn't show hand 
*** SUMMARY ***
Total pot $0.10 | Rake $0 
Seat 1: Kaczka96 folded before Flop (didn't bet)
Seat 2: Zimniy folded before Flop (didn't bet)
Seat 3: Mighty_Rams folded before Flop (didn't bet)
Seat 4: GraemeDR (button) folded before Flop (didn't bet)
Seat 5: johnpsg (small blind) folded before Flop
Seat 6: Homermckinley77 (big blind) collected ($0.10)



PokerStars Hand #222974877833:  Hold'em No Limit ($0.05/$0.10 USD) - 2021/01/23 17:22:12 ET
Table 'Demoulina III' 6-max Seat #5 is the button
Seat 1: Kaczka96 ($14.40 in chips) 
Seat 2: Zimniy ($10 in chips) 
Seat 4: GraemeDR ($14.21 in chips) 
Seat 5: johnpsg ($11.27 in chips) 
Seat 6: Homermckinley77 ($3.90 in chips) 
Homermckinley77: posts small blind $0.05
Kaczka96: posts big blind $0.10
*** HOLE CARDS ***
Zimniy: folds 
GraemeDR: raises $0.20 to $0.30
johnpsg: folds 
Homermckinley77: folds 
Kaczka96: folds 
Uncalled bet ($0.20) returned to GraemeDR
GraemeDR collected $0.25 from pot
GraemeDR: doesn't show hand 
*** SUMMARY ***
Total pot $0.25 | Rake $0 
Seat 1: Kaczka96 (big blind) folded before Flop
Seat 2: Zimniy folded before Flop (didn't bet)
Seat 4: GraemeDR collected ($0.25)
Seat 5: johnpsg (button) folded before Flop (didn't bet)
Seat 6: Homermckinley77 (small blind) folded before Flop



PokerStars Hand #222974888853:  Hold'em No Limit ($0.05/$0.10 USD) - 2021/01/23 17:22:26 ET
Table 'Demoulina III' 6-max Seat #6 is the button
Seat 1: Kaczka96 ($14.30 in chips) 
Seat 2: Zimniy ($10 in chips) 
Seat 3: Mighty_Rams ($1.11 in chips) 
Seat 4: GraemeDR ($14.36 in chips) 
Seat 5: johnpsg ($11.27 in chips) 
Seat 6: Homermckinley77 ($3.85 in chips) 
Kaczka96: posts small blind $0.05
Zimniy: posts big blind $0.10
*** HOLE CARDS ***
Mighty_Rams: folds 
GraemeDR: raises $0.25 to $0.35
johnpsg: folds 
Homermckinley77: calls $0.35
Kaczka96: folds 
Zimniy: folds 
*** FLOP *** [As Ks 5d]
GraemeDR: bets $0.49
Homermckinley77: folds 
Uncalled bet ($0.49) returned to GraemeDR
GraemeDR collected $0.81 from pot
GraemeDR: doesn't show hand 
*** SUMMARY ***
Total pot $0.85 | Rake $0.04 
Board [As Ks 5d]
Seat 1: Kaczka96 (small blind) folded before Flop
Seat 2: Zimniy (big blind) folded before Flop
Seat 3: Mighty_Rams folded before Flop (didn't bet)
Seat 4: GraemeDR collected ($0.81)
Seat 5: johnpsg folded before Flop (didn't bet)
Seat 6: Homermckinley77 (button) folded on the Flop



PokerStars Hand #222974910847:  Hold'em No Limit ($0.05/$0.10 USD) - 2021/01/23 17:22:52 ET
Table 'Demoulina III' 6-max Seat #1 is the button
Seat 1: Kaczka96 ($14.25 in chips) 
Seat 2: Zimniy ($10 in chips) 
Seat 3: Mighty_Rams ($1.11 in chips) 
Seat 4: GraemeDR ($14.82 in chips) 
Seat 5: johnpsg ($11.27 in chips) 
Seat 6: Homermckinley77 ($3.50 in chips) 
Zimniy: posts small blind $0.05
Mighty_Rams: posts big blind $0.10
*** HOLE CARDS ***
GraemeDR: folds 
johnpsg: folds 
Homermckinley77: calls $0.10
Kaczka96: folds 
Zimniy: folds 
Mighty_Rams: checks 
*** FLOP *** [Td Ts Ks]
Mighty_Rams: checks 
Homermckinley77: checks 
*** TURN *** [Td Ts Ks] [9c]
Mighty_Rams: checks 
Homermckinley77: checks 
*** RIVER *** [Td Ts Ks 9c] [As]
Mighty_Rams: bets $0.12
Homermckinley77: calls $0.12
*** SHOW DOWN ***
Mighty_Rams: shows [2s 5c] (a pair of Tens)
Homermckinley77: shows [Ac Jd] (two pair, Aces and Tens)
Homermckinley77 collected $0.47 from pot
*** SUMMARY ***
Total pot $0.49 | Rake $0.02 
Board [Td Ts Ks 9c As]
Seat 1: Kaczka96 (button) folded before Flop (didn't bet)
Seat 2: Zimniy (small blind) folded before Flop
Seat 3: Mighty_Rams (big blind) showed [2s 5c] and lost with a pair of Tens
Seat 4: GraemeDR folded before Flop (didn't bet)
Seat 5: johnpsg folded before Flop (didn't bet)
Seat 6: Homermckinley77 showed [Ac Jd] and won ($0.47) with two pair, Aces and Tens



PokerStars Hand #222974953804:  Hold'em No Limit ($0.05/$0.10 USD) - 2021/01/23 17:23:45 ET
Table 'Demoulina III' 6-max Seat #2 is the button
Seat 1: Kaczka96 ($14.25 in chips) 
Seat 2: Zimniy ($10 in chips) 
Seat 3: Mighty_Rams ($0.89 in chips) 
Seat 4: GraemeDR ($14.82 in chips) 
Seat 5: johnpsg ($11.27 in chips) 
Seat 6: Homermckinley77 ($3.75 in chips) 
Mighty_Rams: posts small blind $0.05
GraemeDR: posts big blind $0.10
*** HOLE CARDS ***
johnpsg: folds 
Homermckinley77: folds 
Kaczka96: calls $0.10
Zimniy: folds 
Mighty_Rams: folds 
GraemeDR: checks 
*** FLOP *** [Kh Ac 8d]
GraemeDR: checks 
Kaczka96: bets $0.24
GraemeDR: folds 
Uncalled bet ($0.24) returned to Kaczka96
Kaczka96 collected $0.24 from pot
Kaczka96: doesn't show hand 
*** SUMMARY ***
Total pot $0.25 | Rake $0.01 
Board [Kh Ac 8d]
Seat 1: Kaczka96 collected ($0.24)
Seat 2: Zimniy (button) folded before Flop (didn't bet)
Seat 3: Mighty_Rams (small blind) folded before Flop
Seat 4: GraemeDR (big blind) folded on the Flop
Seat 5: johnpsg folded before Flop (didn't bet)
Seat 6: Homermckinley77 folded before Flop (didn't bet)



PokerStars Hand #222974973628:  Hold'em No Limit ($0.05/$0.10 USD) - 2021/01/23 17:24:10 ET
Table 'Demoulina III' 6-max Seat #3 is the button
Seat 1: Kaczka96 ($14.39 in chips) 
Seat 2: Zimniy ($10 in chips) 
Seat 3: Mighty_Rams ($0.84 in chips) 
Seat 4: GraemeDR ($14.72 in chips) 
Seat 5: johnpsg ($11.27 in chips) 
Seat 6: Homermckinley77 ($3.75 in chips) 
GraemeDR: posts small blind $0.05
johnpsg: posts big blind $0.10
*** HOLE CARDS ***
Homermckinley77: calls $0.10
Kaczka96: folds 
Zimniy: folds 
Mighty_Rams: calls $0.10
GraemeDR: folds 
johnpsg: checks 
*** FLOP *** [5s Ad 6d]
johnpsg: checks 
Homermckinley77: bets $0.10
Mighty_Rams: folds 
johnpsg: calls $0.10
*** TURN *** [5s Ad 6d] [5h]
johnpsg: checks 
Homermckinley77: bets $0.10
johnpsg: calls $0.10
*** RIVER *** [5s Ad 6d 5h] [4h]
johnpsg: checks 
Homermckinley77: bets $0.10
johnpsg: calls $0.10
*** SHOW DOWN ***
Homermckinley77: shows [Th Jc] (a pair of Fives)
johnpsg: shows [Td 4d] (two pair, Fives and Fours)
johnpsg collected $0.91 from pot
*** SUMMARY ***
Total pot $0.95 | Rake $0.04 
Board [5s Ad 6d 5h 4h]
Seat 1: Kaczka96 folded before Flop (didn't bet)
Seat 2: Zimniy folded before Flop (didn't bet)
Seat 3: Mighty_Rams (button) folded on the Flop
Seat 4: GraemeDR (small blind) folded before Flop
Seat 5: johnpsg (big blind) showed [Td 4d] and won ($0.91) with two pair, Fives and Fours
Seat 6: Homermckinley77 showed [Th Jc] and lost with a pair of Fives



PokerStars Hand #222975003000:  Hold'em No Limit ($0.05/$0.10 USD) - 2021/01/23 17:24:46 ET
Table 'Demoulina III' 6-max Seat #4 is the button
Seat 1: Kaczka96 ($14.39 in chips) 
Seat 2: Zimniy ($10 in chips) 
Seat 3: Mighty_Rams ($0.74 in chips) 
Seat 4: GraemeDR ($14.67 in chips) 
Seat 5: johnpsg ($11.78 in chips) 
Seat 6: Homermckinley77 ($3.35 in chips) 
johnpsg: posts small blind $0.05
Homermckinley77: posts big blind $0.10
*** HOLE CARDS ***
Kaczka96: raises $0.10 to $0.20
Zimniy: folds 
Mighty_Rams: calls $0.20
GraemeDR: calls $0.20
johnpsg: folds 
Homermckinley77: folds 
*** FLOP *** [8d 3s Tc]
Kaczka96: checks 
Homermckinley77 leaves the table
Mighty_Rams: checks 
GraemeDR: checks 
*** TURN *** [8d 3s Tc] [4c]
prs420 joins the table at seat #6 
Kaczka96: bets $0.10
Mighty_Rams: folds 
GraemeDR: raises $0.20 to $0.30
Kaczka96: calls $0.20
*** RIVER *** [8d 3s Tc 4c] [Qd]
Kaczka96: checks 
GraemeDR: bets $0.60
Kaczka96: folds 
Uncalled bet ($0.60) returned to GraemeDR
GraemeDR collected $1.29 from pot
GraemeDR: doesn't show hand 
*** SUMMARY ***
Total pot $1.35 | Rake $0.06 
Board [8d 3s Tc 4c Qd]
Seat 1: Kaczka96 folded on the River
Seat 2: Zimniy folded before Flop (didn't bet)
Seat 3: Mighty_Rams folded on the Turn
Seat 4: GraemeDR (button) collected ($1.29)
Seat 5: johnpsg (small blind) folded before Flop
Seat 6: Homermckinley77 (big blind) folded before Flop



PokerStars Hand #222975045919:  Hold'em No Limit ($0.05/$0.10 USD) - 2021/01/23 17:25:40 ET
Table 'Demoulina III' 6-max Seat #5 is the button
Seat 1: Kaczka96 ($13.89 in chips) 
Seat 2: Zimniy ($10 in chips) 
Seat 3: Mighty_Rams ($0.54 in chips) 
Seat 4: GraemeDR ($15.46 in chips) 
Seat 5: johnpsg ($11.73 in chips) 
Kaczka96: posts small blind $0.05
Zimniy: posts big blind $0.10
*** HOLE CARDS ***
Mighty_Rams: raises $0.44 to $0.54 and is all-in
GraemeDR: folds 
johnpsg: folds 
Kaczka96: calls $0.49
Zimniy: folds 
*** FLOP *** [Jd Jc 3c]
*** TURN *** [Jd Jc 3c] [4d]
*** RIVER *** [Jd Jc 3c 4d] [Qh]
*** SHOW DOWN ***
Kaczka96: shows [3h Ad] (two pair, Jacks and Threes)
Mighty_Rams: shows [As Qs] (two pair, Queens and Jacks)
Mighty_Rams collected $1.13 from pot
*** SUMMARY ***
Total pot $1.18 | Rake $0.05 
Board [Jd Jc 3c 4d Qh]
Seat 1: Kaczka96 (small blind) showed [3h Ad] and lost with two pair, Jacks and Threes
Seat 2: Zimniy (big blind) folded before Flop
Seat 3: Mighty_Rams showed [As Qs] and won ($1.13) with two pair, Queens and Jacks
Seat 4: GraemeDR folded before Flop (didn't bet)
Seat 5: johnpsg (button) folded before Flop (didn't bet)



PokerStars Hand #222975076152:  Hold'em No Limit ($0.05/$0.10 USD) - 2021/01/23 17:26:18 ET
Table 'Demoulina III' 6-max Seat #1 is the button
Seat 1: Kaczka96 ($13.35 in chips) 
Seat 2: Zimniy ($10 in chips) 
Seat 3: Mighty_Rams ($1.13 in chips) 
Seat 4: GraemeDR ($15.46 in chips) 
Seat 5: johnpsg ($11.73 in chips) 
Seat 6: prs420 ($8 in chips) 
Zimniy: posts small blind $0.05
Mighty_Rams: posts big blind $0.10
prs420: posts big blind $0.10
*** HOLE CARDS ***
GraemeDR: raises $0.25 to $0.35
johnpsg: folds 
prs420: calls $0.25
Kaczka96: folds 
Zimniy: folds 
Mighty_Rams: folds 
*** FLOP *** [8c 3c Qd]
GraemeDR: bets $0.61
prs420: folds 
Uncalled bet ($0.61) returned to GraemeDR
GraemeDR collected $0.81 from pot
GraemeDR: doesn't show hand 
Kaczka96 leaves the table
*** SUMMARY ***
Total pot $0.85 | Rake $0.04 
Board [8c 3c Qd]
Seat 1: Kaczka96 (button) folded before Flop (didn't bet)
Seat 2: Zimniy (small blind) folded before Flop
Seat 3: Mighty_Rams (big blind) folded before Flop
Seat 4: GraemeDR collected ($0.81)
Seat 5: johnpsg folded before Flop (didn't bet)
Seat 6: prs420 folded on the Flop



PokerStars Hand #222975093776:  Hold'em No Limit ($0.05/$0.10 USD) - 2021/01/23 17:26:40 ET
Table 'Demoulina III' 6-max Seat #2 is the button
Seat 2: Zimniy ($10 in chips) 
Seat 3: Mighty_Rams ($1.03 in chips) 
Seat 4: GraemeDR ($15.92 in chips) 
Seat 5: johnpsg ($11.73 in chips) 
Seat 6: prs420 ($7.65 in chips) 
Mighty_Rams: posts small blind $0.05
GraemeDR: posts big blind $0.10
*** HOLE CARDS ***
johnpsg: folds 
prs420: folds 
Zimniy: folds 
schatz9999 joins the table at seat #1 
Mighty_Rams: calls $0.05
GraemeDR: raises $0.30 to $0.40
Mighty_Rams: calls $0.30
*** FLOP *** [Qd As 7h]
Mighty_Rams: checks 
GraemeDR: bets $0.76
Mighty_Rams: calls $0.63 and is all-in
Uncalled bet ($0.13) returned to GraemeDR
*** TURN *** [Qd As 7h] [Js]
*** RIVER *** [Qd As 7h Js] [2c]
*** SHOW DOWN ***
Mighty_Rams: shows [7c 6c] (a pair of Sevens)
GraemeDR: shows [9s Kd] (high card Ace)
Mighty_Rams cashed out the hand for $1.48 | Cash Out Fee $0.01
*** SUMMARY ***
Total pot $2.06 | Rake $0.09 
Board [Qd As 7h Js 2c]
Seat 2: Zimniy (button) folded before Flop (didn't bet)
Seat 3: Mighty_Rams (small blind) showed [7c 6c] and won ($1.97) with a pair of Sevens (pot not awarded as player cashed out)
Seat 4: GraemeDR (big blind) showed [9s Kd] and lost with high card Ace
Seat 5: johnpsg folded before Flop (didn't bet)
Seat 6: prs420 folded before Flop (didn't bet)



PokerStars Hand #222975128786:  Hold'em No Limit ($0.05/$0.10 USD) - 2021/01/23 17:27:23 ET
Table 'Demoulina III' 6-max Seat #3 is the button
Seat 1: schatz9999 ($4 in chips) 
Seat 2: Zimniy ($10 in chips) 
Seat 3: Mighty_Rams ($1.48 in chips) 
Seat 4: GraemeDR ($14.89 in chips) 
Seat 5: johnpsg ($11.73 in chips) 
Seat 6: prs420 ($7.65 in chips) 
GraemeDR: posts small blind $0.05
johnpsg: posts big blind $0.10
schatz9999: posts big blind $0.10
*** HOLE CARDS ***
prs420: folds 
schatz9999: checks 
Zimniy: folds 
Mighty_Rams: calls $0.10
GraemeDR: folds 
johnpsg: checks 
*** FLOP *** [Tc 5h 9s]
johnpsg: checks 
schatz9999: checks 
Mighty_Rams: checks 
*** TURN *** [Tc 5h 9s] [6h]
johnpsg: checks 
schatz9999: checks 
Mighty_Rams: checks 
*** RIVER *** [Tc 5h 9s 6h] [Ts]
johnpsg: checks 
schatz9999: checks 
Mighty_Rams: checks 
*** SHOW DOWN ***
johnpsg: shows [3s 4c] (a pair of Tens)
schatz9999: shows [9c Qs] (two pair, Tens and Nines)
Mighty_Rams: mucks hand 
schatz9999 collected $0.33 from pot
*** SUMMARY ***
Total pot $0.35 | Rake $0.02 
Board [Tc 5h 9s 6h Ts]
Seat 1: schatz9999 showed [9c Qs] and won ($0.33) with two pair, Tens and Nines
Seat 2: Zimniy folded before Flop (didn't bet)
Seat 3: Mighty_Rams (button) mucked
Seat 4: GraemeDR (small blind) folded before Flop
Seat 5: johnpsg (big blind) showed [3s 4c] and lost with a pair of Tens
Seat 6: prs420 folded before Flop (didn't bet)



PokerStars Hand #222975183183:  Hold'em No Limit ($0.05/$0.10 USD) - 2021/01/23 17:28:28 ET
Table 'Demoulina III' 6-max Seat #4 is the button
Seat 1: schatz9999 ($4.23 in chips) 
Seat 2: Zimniy ($10 in chips) 
Seat 3: Mighty_Rams ($1.38 in chips) 
Seat 4: GraemeDR ($14.84 in chips) 
Seat 5: johnpsg ($11.63 in chips) 
Seat 6: prs420 ($7.65 in chips) 
johnpsg: posts small blind $0.05
prs420: posts big blind $0.10
*** HOLE CARDS ***
schatz9999: calls $0.10
Zimniy: raises $0.30 to $0.40
Mighty_Rams: folds 
GraemeDR: folds 
johnpsg: folds 
prs420: folds 
schatz9999: calls $0.30
*** FLOP *** [9d 6s Jh]
schatz9999: checks 
Zimniy: checks 
*** TURN *** [9d 6s Jh] [2s]
schatz9999: checks 
Zimniy: checks 
*** RIVER *** [9d 6s Jh 2s] [8c]
schatz9999: checks 
Zimniy: checks 
*** SHOW DOWN ***
schatz9999: shows [Qh 9s] (a pair of Nines)
Zimniy: mucks hand 
schatz9999 collected $0.91 from pot
*** SUMMARY ***
Total pot $0.95 | Rake $0.04 
Board [9d 6s Jh 2s 8c]
Seat 1: schatz9999 showed [Qh 9s] and won ($0.91) with a pair of Nines
Seat 2: Zimniy mucked
Seat 3: Mighty_Rams folded before Flop (didn't bet)
Seat 4: GraemeDR (button) folded before Flop (didn't bet)
Seat 5: johnpsg (small blind) folded before Flop
Seat 6: prs420 (big blind) folded before Flop



PokerStars Hand #222975226240:  Hold'em No Limit ($0.05/$0.10 USD) - 2021/01/23 17:29:22 ET
Table 'Demoulina III' 6-max Seat #5 is the button
Seat 1: schatz9999 ($4.74 in chips) 
Seat 2: Zimniy ($10 in chips) 
Seat 3: Mighty_Rams ($1.38 in chips) 
Seat 4: GraemeDR ($14.84 in chips) 
Seat 5: johnpsg ($11.58 in chips) 
Seat 6: prs420 ($7.55 in chips) 
prs420: posts small blind $0.05
schatz9999: posts big blind $0.10
*** HOLE CARDS ***
Zimniy: folds 
Mighty_Rams: folds 
GraemeDR: raises $0.20 to $0.30
johnpsg: folds 
prs420: calls $0.25
schatz9999: folds 
*** FLOP *** [9c 2c As]
prs420: checks 
GraemeDR: bets $0.40
prs420: folds 
Uncalled bet ($0.40) returned to GraemeDR
GraemeDR collected $0.67 from pot
GraemeDR: doesn't show hand 
*** SUMMARY ***
Total pot $0.70 | Rake $0.03 
Board [9c 2c As]
Seat 1: schatz9999 (big blind) folded before Flop
Seat 2: Zimniy folded before Flop (didn't bet)
Seat 3: Mighty_Rams folded before Flop (didn't bet)
Seat 4: GraemeDR collected ($0.67)
Seat 5: johnpsg (button) folded before Flop (didn't bet)
Seat 6: prs420 (small blind) folded on the Flop



PokerStars Hand #222975245967:  Hold'em No Limit ($0.05/$0.10 USD) - 2021/01/23 17:29:47 ET
Table 'Demoulina III' 6-max Seat #6 is the button
Seat 1: schatz9999 ($4.64 in chips) 
Seat 2: Zimniy ($10 in chips) 
Seat 3: Mighty_Rams ($1.38 in chips) 
Seat 4: GraemeDR ($15.21 in chips) 
Seat 5: johnpsg ($11.58 in chips) 
Seat 6: prs420 ($7.25 in chips) 
schatz9999: posts small blind $0.05
Zimniy: posts big blind $0.10
*** HOLE CARDS ***
Mighty_Rams: folds 
GraemeDR: folds 
johnpsg: folds 
prs420: calls $0.10
schatz9999: calls $0.05
Zimniy: checks 
*** FLOP *** [8c Qs Th]
schatz9999: checks 
Zimniy: checks 
prs420: checks 
*** TURN *** [8c Qs Th] [5c]
schatz9999: checks 
Zimniy: bets $0.19
prs420: folds 
schatz9999: calls $0.19
*** RIVER *** [8c Qs Th 5c] [2d]
schatz9999: checks 
Zimniy: checks 
*** SHOW DOWN ***
schatz9999: shows [Td Kh] (a pair of Tens)
Zimniy: mucks hand 
schatz9999 collected $0.65 from pot
*** SUMMARY ***
Total pot $0.68 | Rake $0.03 
Board [8c Qs Th 5c 2d]
Seat 1: schatz9999 (small blind) showed [Td Kh] and won ($0.65) with a pair of Tens
Seat 2: Zimniy (big blind) mucked
Seat 3: Mighty_Rams folded before Flop (didn't bet)
Seat 4: GraemeDR folded before Flop (didn't bet)
Seat 5: johnpsg folded before Flop (didn't bet)
Seat 6: prs420 (button) folded on the Turn



PokerStars Hand #222975274532:  Hold'em No Limit ($0.05/$0.10 USD) - 2021/01/23 17:30:23 ET
Table 'Demoulina III' 6-max Seat #1 is the button
Seat 1: schatz9999 ($5 in chips) 
Seat 2: Zimniy ($10 in chips) 
Seat 3: Mighty_Rams ($1.38 in chips) 
Seat 4: GraemeDR ($15.21 in chips) 
Seat 5: johnpsg ($11.58 in chips) 
Seat 6: prs420 ($7.15 in chips) 
Zimniy: posts small blind $0.05
Mighty_Rams: posts big blind $0.10
*** HOLE CARDS ***
GraemeDR: folds 
johnpsg: raises $0.17 to $0.27
prs420: calls $0.27
schatz9999: folds 
Zimniy: calls $0.22
Mighty_Rams: folds 
*** FLOP *** [Td Js Jd]
Zimniy: checks 
johnpsg: checks 
prs420: checks 
*** TURN *** [Td Js Jd] [Qh]
Zimniy: checks 
johnpsg: bets $0.44
prs420: calls $0.44
Zimniy: folds 
*** RIVER *** [Td Js Jd Qh] [Qs]
johnpsg: checks 
prs420: bets $1.71
johnpsg: folds 
Uncalled bet ($1.71) returned to prs420
prs420 collected $1.71 from pot
prs420: doesn't show hand 
*** SUMMARY ***
Total pot $1.79 | Rake $0.08 
Board [Td Js Jd Qh Qs]
Seat 1: schatz9999 (button) folded before Flop (didn't bet)
Seat 2: Zimniy (small blind) folded on the Turn
Seat 3: Mighty_Rams (big blind) folded before Flop
Seat 4: GraemeDR folded before Flop (didn't bet)
Seat 5: johnpsg folded on the River
Seat 6: prs420 collected ($1.71)



PokerStars Hand #222975316250:  Hold'em No Limit ($0.05/$0.10 USD) - 2021/01/23 17:31:15 ET
Table 'Demoulina III' 6-max Seat #2 is the button
Seat 1: schatz9999 ($5 in chips) 
Seat 2: Zimniy ($10 in chips) 
Seat 3: Mighty_Rams ($1.28 in chips) 
Seat 5: johnpsg ($10.87 in chips) 
Seat 6: prs420 ($8.15 in chips) 
Mighty_Rams: posts small blind $0.05
GraemeDR: is sitting out 
johnpsg: posts big blind $0.10
*** HOLE CARDS ***
prs420: calls $0.10
schatz9999: calls $0.10
Zimniy: folds 
Mighty_Rams: folds 
johnpsg: checks 
*** FLOP *** [5s Qc Ac]
johnpsg: checks 
prs420: checks 
schatz9999: checks 
*** TURN *** [5s Qc Ac] [6c]
johnpsg: checks 
prs420: checks 
schatz9999: checks 
*** RIVER *** [5s Qc Ac 6c] [4c]
johnpsg: checks 
prs420: checks 
schatz9999: checks 
*** SHOW DOWN ***
johnpsg: shows [5h 2s] (a pair of Fives)
prs420: mucks hand 
schatz9999: mucks hand 
johnpsg collected $0.33 from pot
*** SUMMARY ***
Total pot $0.35 | Rake $0.02 
Board [5s Qc Ac 6c 4c]
Seat 1: schatz9999 mucked
Seat 2: Zimniy (button) folded before Flop (didn't bet)
Seat 3: Mighty_Rams (small blind) folded before Flop
Seat 5: johnpsg (big blind) showed [5h 2s] and won ($0.33) with a pair of Fives
Seat 6: prs420 mucked



PokerStars Hand #222975346738:  Hold'em No Limit ($0.05/$0.10 USD) - 2021/01/23 17:31:54 ET
Table 'Demoulina III' 6-max Seat #3 is the button
Seat 1: schatz9999 ($4.90 in chips) 
Seat 2: Zimniy ($10 in chips) 
Seat 3: Mighty_Rams ($1.23 in chips) 
Seat 5: johnpsg ($11.10 in chips) 
Seat 6: prs420 ($8.05 in chips) 
johnpsg: posts small blind $0.05
prs420: posts big blind $0.10
*** HOLE CARDS ***
GraemeDR leaves the table
schatz9999: folds 
Zimniy: folds 
marcin116 joins the table at seat #4 
Mighty_Rams: folds 
johnpsg: folds 
Uncalled bet ($0.05) returned to prs420
prs420 collected $0.10 from pot
prs420: doesn't show hand 
*** SUMMARY ***
Total pot $0.10 | Rake $0 
Seat 1: schatz9999 folded before Flop (didn't bet)
Seat 2: Zimniy folded before Flop (didn't bet)
Seat 3: Mighty_Rams (button) folded before Flop (didn't bet)
Seat 5: johnpsg (small blind) folded before Flop
Seat 6: prs420 (big blind) collected ($0.10)



PokerStars Hand #222975358353:  Hold'em No Limit ($0.05/$0.10 USD) - 2021/01/23 17:32:09 ET
Table 'Demoulina III' 6-max Seat #5 is the button
Seat 1: schatz9999 ($4.90 in chips) 
Seat 2: Zimniy ($10 in chips) 
Seat 3: Mighty_Rams ($1.23 in chips) 
Seat 5: johnpsg ($11.05 in chips) 
Seat 6: prs420 ($8.10 in chips) 
prs420: posts small blind $0.05
schatz9999: posts big blind $0.10
marcin116: sits out 
*** HOLE CARDS ***
Zimniy: folds 
Mighty_Rams: calls $0.10
johnpsg: folds 
prs420: calls $0.05
schatz9999: checks 
*** FLOP *** [6c 5h 6d]
prs420: checks 
schatz9999: checks 
Mighty_Rams: checks 
*** TURN *** [6c 5h 6d] [Th]
prs420: checks 
schatz9999: checks 
Mighty_Rams: checks 
*** RIVER *** [6c 5h 6d Th] [7h]
prs420: checks 
schatz9999: checks 
Mighty_Rams: checks 
*** SHOW DOWN ***
prs420: shows [9d Kc] (a pair of Sixes)
schatz9999: shows [9c 5d] (two pair, Sixes and Fives)
Mighty_Rams: mucks hand 
schatz9999 collected $0.29 from pot
*** SUMMARY ***
Total pot $0.30 | Rake $0.01 
Board [6c 5h 6d Th 7h]
Seat 1: schatz9999 (big blind) showed [9c 5d] and won ($0.29) with two pair, Sixes and Fives
Seat 2: Zimniy folded before Flop (didn't bet)
Seat 3: Mighty_Rams mucked
Seat 5: johnpsg (button) folded before Flop (didn't bet)
Seat 6: prs420 (small blind) showed [9d Kc] and lost with a pair of Sixes



PokerStars Hand #222975408522:  Hold'em No Limit ($0.05/$0.10 USD) - 2021/01/23 17:33:13 ET
Table 'Demoulina III' 6-max Seat #6 is the button
Seat 1: schatz9999 ($5.09 in chips) 
Seat 2: Zimniy ($10 in chips) 
Seat 3: Mighty_Rams ($1.13 in chips) 
Seat 5: johnpsg ($11.05 in chips) 
Seat 6: prs420 ($8 in chips) 
schatz9999: posts small blind $0.05
Zimniy: posts big blind $0.10
marcin116: sits out 
*** HOLE CARDS ***
Mighty_Rams: raises $1.03 to $1.13 and is all-in
johnpsg: folds 
prs420: folds 
schatz9999: folds 
Zimniy: folds 
Uncalled bet ($1.03) returned to Mighty_Rams
Mighty_Rams collected $0.25 from pot
*** SUMMARY ***
Total pot $0.25 | Rake $0 
Seat 1: schatz9999 (small blind) folded before Flop
Seat 2: Zimniy (big blind) folded before Flop
Seat 3: Mighty_Rams collected ($0.25)
Seat 5: johnpsg folded before Flop (didn't bet)
Seat 6: prs420 (button) folded before Flop (didn't bet)



PokerStars Hand #222975421243:  Hold'em No Limit ($0.05/$0.10 USD) - 2021/01/23 17:33:29 ET
Table 'Demoulina III' 6-max Seat #1 is the button
Seat 1: schatz9999 ($5.04 in chips) 
Seat 2: Zimniy ($10 in chips) 
Seat 3: Mighty_Rams ($1.28 in chips) 
Seat 5: johnpsg ($11.05 in chips) 
Seat 6: prs420 ($8 in chips) 
Zimniy: posts small blind $0.05
Mighty_Rams: posts big blind $0.10
marcin116: sits out 
*** HOLE CARDS ***
johnpsg: folds 
prs420: calls $0.10
schatz9999: calls $0.10
Zimniy: folds 
Mighty_Rams: checks 
*** FLOP *** [Td 2h Qc]
Mighty_Rams: checks 
prs420: checks 
schatz9999: bets $0.10
Mighty_Rams: folds 
prs420: calls $0.10
*** TURN *** [Td 2h Qc] [Qh]
prs420: checks 
schatz9999: bets $0.10
prs420: calls $0.10
*** RIVER *** [Td 2h Qc Qh] [7c]
prs420: checks 
schatz9999: bets $0.50
prs420: folds 
Uncalled bet ($0.50) returned to schatz9999
schatz9999 collected $0.72 from pot
schatz9999: doesn't show hand 
*** SUMMARY ***
Total pot $0.75 | Rake $0.03 
Board [Td 2h Qc Qh 7c]
Seat 1: schatz9999 (button) collected ($0.72)
Seat 2: Zimniy (small blind) folded before Flop
Seat 3: Mighty_Rams (big blind) folded on the Flop
Seat 5: johnpsg folded before Flop (didn't bet)
Seat 6: prs420 folded on the River



PokerStars Hand #222975456815:  Hold'em No Limit ($0.05/$0.10 USD) - 2021/01/23 17:34:14 ET
Table 'Demoulina III' 6-max Seat #2 is the button
Seat 1: schatz9999 ($5.46 in chips) 
Seat 2: Zimniy ($10 in chips) 
Seat 3: Mighty_Rams ($1.18 in chips) 
Seat 4: marcin116 ($10 in chips) 
Seat 5: johnpsg ($11.05 in chips) 
Seat 6: prs420 ($7.70 in chips) 
Mighty_Rams: posts small blind $0.05
marcin116: posts big blind $0.10
*** HOLE CARDS ***
johnpsg: folds 
prs420: folds 
schatz9999: calls $0.10
Zimniy: raises $0.30 to $0.40
Mighty_Rams: folds 
marcin116: folds 
schatz9999: folds 
Uncalled bet ($0.30) returned to Zimniy
Zimniy collected $0.35 from pot
Zimniy: doesn't show hand 
*** SUMMARY ***
Total pot $0.35 | Rake $0 
Seat 1: schatz9999 folded before Flop
Seat 2: Zimniy (button) collected ($0.35)
Seat 3: Mighty_Rams (small blind) folded before Flop
Seat 4: marcin116 (big blind) folded before Flop
Seat 5: johnpsg folded before Flop (didn't bet)
Seat 6: prs420 folded before Flop (didn't bet)



PokerStars Hand #222975471536:  Hold'em No Limit ($0.05/$0.10 USD) - 2021/01/23 17:34:33 ET
Table 'Demoulina III' 6-max Seat #3 is the button
Seat 1: schatz9999 ($5.36 in chips) 
Seat 2: Zimniy ($10.25 in chips) 
Seat 3: Mighty_Rams ($1.13 in chips) 
Seat 4: marcin116 ($10 in chips) 
Seat 5: johnpsg ($11.05 in chips) 
Seat 6: prs420 ($7.70 in chips) 
marcin116: posts small blind $0.05
johnpsg: posts big blind $0.10
*** HOLE CARDS ***
prs420: calls $0.10
schatz9999: folds 
Zimniy: folds 
Mighty_Rams: calls $0.10
marcin116: raises $0.40 to $0.50
johnpsg: folds 
prs420: calls $0.40
Mighty_Rams: folds 
*** FLOP *** [5d 2c 4h]
marcin116: checks 
prs420: bets $1.15
marcin116: folds 
Uncalled bet ($1.15) returned to prs420
prs420 collected $1.15 from pot
prs420: doesn't show hand 
*** SUMMARY ***
Total pot $1.20 | Rake $0.05 
Board [5d 2c 4h]
Seat 1: schatz9999 folded before Flop (didn't bet)
Seat 2: Zimniy folded before Flop (didn't bet)
Seat 3: Mighty_Rams (button) folded before Flop
Seat 4: marcin116 (small blind) folded on the Flop
Seat 5: johnpsg (big blind) folded before Flop
Seat 6: prs420 collected ($1.15)



PokerStars Hand #222975493189:  Hold'em No Limit ($0.05/$0.10 USD) - 2021/01/23 17:35:00 ET
Table 'Demoulina III' 6-max Seat #4 is the button
Seat 1: schatz9999 ($5.36 in chips) 
Seat 2: Zimniy ($10.25 in chips) 
Seat 3: Mighty_Rams ($1.03 in chips) 
Seat 4: marcin116 ($10 in chips) 
Seat 5: johnpsg ($10.95 in chips) 
Seat 6: prs420 ($8.35 in chips) 
johnpsg: posts small blind $0.05
prs420: posts big blind $0.10
*** HOLE CARDS ***
schatz9999: calls $0.10
Zimniy: raises $0.30 to $0.40
Mighty_Rams: folds 
marcin116: calls $0.40
johnpsg: folds 
prs420: raises $0.85 to $1.25
schatz9999: calls $1.15
Zimniy: calls $0.85
marcin116: calls $0.85
*** FLOP *** [7h 3h 9s]
prs420: bets $4.82
schatz9999: folds 
Zimniy: folds 
marcin116: raises $3.93 to $8.75 and is all-in
prs420: calls $2.28 and is all-in
Uncalled bet ($1.65) returned to marcin116
*** TURN *** [7h 3h 9s] [2d]
*** RIVER *** [7h 3h 9s 2d] [Jh]
*** SHOW DOWN ***
prs420: shows [Qh Qs] (a pair of Queens)
marcin116: shows [4h 6h] (a flush, Jack high)
marcin116 collected $18.38 from pot
*** SUMMARY ***
Total pot $19.25 | Rake $0.87 
Board [7h 3h 9s 2d Jh]
Seat 1: schatz9999 folded on the Flop
Seat 2: Zimniy folded on the Flop
Seat 3: Mighty_Rams folded before Flop (didn't bet)
Seat 4: marcin116 (button) showed [4h 6h] and won ($18.38) with a flush, Jack high
Seat 5: johnpsg (small blind) folded before Flop
Seat 6: prs420 (big blind) showed [Qh Qs] and lost with a pair of Queens



PokerStars Hand #222975557487:  Hold'em No Limit ($0.05/$0.10 USD) - 2021/01/23 17:36:11 ET
Table 'Demoulina III' 6-max Seat #5 is the button
Seat 1: schatz9999 ($4.11 in chips) 
Seat 2: Zimniy ($10 in chips) 
Seat 3: Mighty_Rams ($1.03 in chips) 
Seat 4: marcin116 ($20.03 in chips) 
Seat 5: johnpsg ($10.90 in chips) 
schatz9999: posts small blind $0.05
Zimniy: posts big blind $0.10
*** HOLE CARDS ***
Mighty_Rams: calls $0.10
marcin116: folds 
prs420 leaves the table
johnpsg: folds 
schatz9999: folds 
Zimniy: checks 
*** FLOP *** [Qh 4h 5h]
CelioRocha joins the table at seat #6 
Zimniy: checks 
Mighty_Rams: checks 
*** TURN *** [Qh 4h 5h] [9c]
CelioRocha leaves the table
Zimniy: bets $0.15
Mighty_Rams: calls $0.15
*** RIVER *** [Qh 4h 5h 9c] [Qd]
Zimniy: checks 
Mighty_Rams: checks 
*** SHOW DOWN ***
Zimniy: shows [8h Ts] (a pair of Queens)
Mighty_Rams: shows [7h Ad] (a pair of Queens - Ace kicker)
Mighty_Rams collected $0.53 from pot
*** SUMMARY ***
Total pot $0.55 | Rake $0.02 
Board [Qh 4h 5h 9c Qd]
Seat 1: schatz9999 (small blind) folded before Flop
Seat 2: Zimniy (big blind) showed [8h Ts] and lost with a pair of Queens
Seat 3: Mighty_Rams showed [7h Ad] and won ($0.53) with a pair of Queens
Seat 4: marcin116 folded before Flop (didn't bet)
Seat 5: johnpsg (button) folded before Flop (didn't bet)



PokerStars Hand #222975594069:  Hold'em No Limit ($0.05/$0.10 USD) - 2021/01/23 17:36:58 ET
Table 'Demoulina III' 6-max Seat #1 is the button
Seat 1: schatz9999 ($4.06 in chips) 
Seat 2: Zimniy ($10 in chips) 
Seat 3: Mighty_Rams ($1.31 in chips) 
Seat 4: marcin116 ($20.03 in chips) 
Seat 5: johnpsg ($10.90 in chips) 
Zimniy: posts small blind $0.05
Mighty_Rams: posts big blind $0.10
*** HOLE CARDS ***
marcin116: raises $0.25 to $0.35
johnpsg: folds 
schatz9999: folds 
I_Not_Alone joins the table at seat #6 
Zimniy: folds 
Mighty_Rams: calls $0.25
*** FLOP *** [Kd Js 7s]
Mighty_Rams: checks 
marcin116: checks 
*** TURN *** [Kd Js 7s] [Qs]
Mighty_Rams: checks 
marcin116: checks 
*** RIVER *** [Kd Js 7s Qs] [4c]
Mighty_Rams: bets $0.20
marcin116: folds 
Uncalled bet ($0.20) returned to Mighty_Rams
Mighty_Rams collected $0.72 from pot
*** SUMMARY ***
Total pot $0.75 | Rake $0.03 
Board [Kd Js 7s Qs 4c]
Seat 1: schatz9999 (button) folded before Flop (didn't bet)
Seat 2: Zimniy (small blind) folded before Flop
Seat 3: Mighty_Rams (big blind) collected ($0.72)
Seat 4: marcin116 folded on the River
Seat 5: johnpsg folded before Flop (didn't bet)



PokerStars Hand #222975627170:  Hold'em No Limit ($0.05/$0.10 USD) - 2021/01/23 17:37:41 ET
Table 'Demoulina III' 6-max Seat #2 is the button
Seat 1: schatz9999 ($4.06 in chips) 
Seat 2: Zimniy ($10 in chips) 
Seat 3: Mighty_Rams ($1.68 in chips) 
Seat 4: marcin116 ($19.68 in chips) 
Seat 5: johnpsg ($10.90 in chips) 
Mighty_Rams: posts small blind $0.05
marcin116: posts big blind $0.10
I_Not_Alone: sits out 
*** HOLE CARDS ***
johnpsg: folds 
schatz9999: folds 
Zimniy: raises $0.15 to $0.25
Mighty_Rams: calls $0.20
marcin116: calls $0.15
*** FLOP *** [3d 7c Ah]
Mighty_Rams: bets $0.20
marcin116: folds 
Zimniy: raises $0.37 to $0.57
Mighty_Rams: raises $0.86 to $1.43 and is all-in
Zimniy: calls $0.86
*** TURN *** [3d 7c Ah] [As]
*** RIVER *** [3d 7c Ah As] [7s]
*** SHOW DOWN ***
Mighty_Rams: shows [7h Ad] (a full house, Aces full of Sevens)
Zimniy: shows [Ac Jc] (a full house, Aces full of Sevens)
Zimniy collected $1.72 from pot
Mighty_Rams cashed out the hand for $2.73 | Cash Out Fee $0.03
*** SUMMARY ***
Total pot $3.61 | Rake $0.16 
Board [3d 7c Ah As 7s]
Seat 1: schatz9999 folded before Flop (didn't bet)
Seat 2: Zimniy (button) showed [Ac Jc] and won ($1.72) with a full house, Aces full of Sevens
Seat 3: Mighty_Rams (small blind) showed [7h Ad] and won ($1.73) with a full house, Aces full of Sevens (pot not awarded as player cashed out)
Seat 4: marcin116 (big blind) folded on the Flop
Seat 5: johnpsg folded before Flop (didn't bet)



PokerStars Hand #222975666518:  Hold'em No Limit ($0.05/$0.10 USD) - 2021/01/23 17:38:33 ET
Table 'Demoulina III' 6-max Seat #3 is the button
Seat 1: schatz9999 ($4.06 in chips) 
Seat 2: Zimniy ($10.04 in chips) 
Seat 3: Mighty_Rams ($2.73 in chips) 
Seat 4: marcin116 ($19.43 in chips) 
Seat 5: johnpsg ($10.90 in chips) 
marcin116: posts small blind $0.05
johnpsg: posts big blind $0.10
I_Not_Alone: sits out 
*** HOLE CARDS ***
schatz9999: folds 
Zimniy: folds 
Mighty_Rams: folds 
marcin116: raises $0.25 to $0.35
johnpsg: folds 
Uncalled bet ($0.25) returned to marcin116
marcin116 collected $0.20 from pot
marcin116: doesn't show hand 
*** SUMMARY ***
Total pot $0.20 | Rake $0 
Seat 1: schatz9999 folded before Flop (didn't bet)
Seat 2: Zimniy folded before Flop (didn't bet)
Seat 3: Mighty_Rams (button) folded before Flop (didn't bet)
Seat 4: marcin116 (small blind) collected ($0.20)
Seat 5: johnpsg (big blind) folded before Flop



PokerStars Hand #222975691916:  Hold'em No Limit ($0.05/$0.10 USD) - 2021/01/23 17:39:06 ET
Table 'Demoulina III' 6-max Seat #4 is the button
Seat 1: schatz9999 ($4.06 in chips) 
Seat 2: Zimniy ($10.04 in chips) 
Seat 3: Mighty_Rams ($2.73 in chips) 
Seat 4: marcin116 ($19.53 in chips) 
Seat 5: johnpsg ($10.80 in chips) 
Seat 6: I_Not_Alone ($10 in chips) 
johnpsg: posts small blind $0.05
I_Not_Alone: posts big blind $0.10
*** HOLE CARDS ***
schatz9999: calls $0.10
Zimniy: folds 
Mighty_Rams: folds 
marcin116: raises $0.35 to $0.45
johnpsg: folds 
I_Not_Alone: folds 
schatz9999: calls $0.35
*** FLOP *** [5c Kc Ks]
schatz9999: checks 
marcin116: checks 
*** TURN *** [5c Kc Ks] [6d]
schatz9999: checks 
marcin116: checks 
*** RIVER *** [5c Kc Ks 6d] [5h]
schatz9999: checks 
marcin116: checks 
*** SHOW DOWN ***
schatz9999: shows [Qh 8h] (two pair, Kings and Fives)
marcin116: mucks hand 
schatz9999 collected $1 from pot
*** SUMMARY ***
Total pot $1.05 | Rake $0.05 
Board [5c Kc Ks 6d 5h]
Seat 1: schatz9999 showed [Qh 8h] and won ($1) with two pair, Kings and Fives
Seat 2: Zimniy folded before Flop (didn't bet)
Seat 3: Mighty_Rams folded before Flop (didn't bet)
Seat 4: marcin116 (button) mucked
Seat 5: johnpsg (small blind) folded before Flop
Seat 6: I_Not_Alone (big blind) folded before Flop



PokerStars Hand #222975736025:  Hold'em No Limit ($0.05/$0.10 USD) - 2021/01/23 17:40:03 ET
Table 'Demoulina III' 6-max Seat #5 is the button
Seat 1: schatz9999 ($4.61 in chips) 
Seat 2: Zimniy ($10.04 in chips) 
Seat 3: Mighty_Rams ($2.73 in chips) 
Seat 4: marcin116 ($19.08 in chips) 
Seat 5: johnpsg ($10.75 in chips) 
Seat 6: I_Not_Alone ($10 in chips) 
I_Not_Alone: posts small blind $0.05
schatz9999: posts big blind $0.10
*** HOLE CARDS ***
Zimniy: raises $0.15 to $0.25
Mighty_Rams: folds 
marcin116: calls $0.25
johnpsg: folds 
I_Not_Alone: folds 
schatz9999: folds 
*** FLOP *** [8h Jc Th]
Zimniy: bets $0.41
marcin116: folds 
Uncalled bet ($0.41) returned to Zimniy
Zimniy collected $0.62 from pot
Zimniy: doesn't show hand 
*** SUMMARY ***
Total pot $0.65 | Rake $0.03 
Board [8h Jc Th]
Seat 1: schatz9999 (big blind) folded before Flop
Seat 2: Zimniy collected ($0.62)
Seat 3: Mighty_Rams folded before Flop (didn't bet)
Seat 4: marcin116 folded on the Flop
Seat 5: johnpsg (button) folded before Flop (didn't bet)
Seat 6: I_Not_Alone (small blind) folded before Flop



PokerStars Hand #222975754497:  Hold'em No Limit ($0.05/$0.10 USD) - 2021/01/23 17:40:27 ET
Table 'Demoulina III' 6-max Seat #6 is the button
Seat 1: schatz9999 ($4.51 in chips) 
Seat 3: Mighty_Rams ($2.73 in chips) 
Seat 4: marcin116 ($18.83 in chips) 
Seat 5: johnpsg ($10.75 in chips) 
Seat 6: I_Not_Alone ($10 in chips) 
schatz9999: posts small blind $0.05
Mighty_Rams: posts big blind $0.10
*** HOLE CARDS ***
marcin116: folds 
rioma10 joins the table at seat #2 
johnpsg: folds 
I_Not_Alone: raises $0.15 to $0.25
schatz9999: calls $0.20
Mighty_Rams: calls $0.15
*** FLOP *** [Tc 8s Ah]
schatz9999: checks 
Mighty_Rams: checks 
I_Not_Alone: checks 
*** TURN *** [Tc 8s Ah] [Td]
schatz9999: bets $0.10
Mighty_Rams: calls $0.10
I_Not_Alone: raises $0.52 to $0.62
schatz9999: calls $0.52
Mighty_Rams: folds 
*** RIVER *** [Tc 8s Ah Td] [2c]
schatz9999: checks 
I_Not_Alone: bets $1.50
schatz9999: folds 
Uncalled bet ($1.50) returned to I_Not_Alone
I_Not_Alone collected $2 from pot
I_Not_Alone: doesn't show hand 
*** SUMMARY ***
Total pot $2.09 | Rake $0.09 
Board [Tc 8s Ah Td 2c]
Seat 1: schatz9999 (small blind) folded on the River
Seat 3: Mighty_Rams (big blind) folded on the Turn
Seat 4: marcin116 folded before Flop (didn't bet)
Seat 5: johnpsg folded before Flop (didn't bet)
Seat 6: I_Not_Alone (button) collected ($2)



PokerStars Hand #222975811175:  Hold'em No Limit ($0.05/$0.10 USD) - 2021/01/23 17:41:41 ET
Table 'Demoulina III' 6-max Seat #1 is the button
Seat 1: schatz9999 ($3.64 in chips) 
Seat 3: Mighty_Rams ($2.38 in chips) 
Seat 4: marcin116 ($18.83 in chips) 
Seat 5: johnpsg ($10.75 in chips) 
Seat 6: I_Not_Alone ($11.13 in chips) 
Mighty_Rams: posts small blind $0.05
marcin116: posts big blind $0.10
*** HOLE CARDS ***
johnpsg: folds 
I_Not_Alone: raises $0.15 to $0.25
schatz9999: calls $0.25
Mighty_Rams: calls $0.20
marcin116: folds 
*** FLOP *** [As Jh 4d]
Mighty_Rams: checks 
I_Not_Alone: checks 
schatz9999: checks 
*** TURN *** [As Jh 4d] [Ac]
Mighty_Rams: checks 
I_Not_Alone: checks 
schatz9999: checks 
*** RIVER *** [As Jh 4d Ac] [Js]
Mighty_Rams: checks 
I_Not_Alone: checks 
schatz9999: checks 
*** SHOW DOWN ***
Mighty_Rams: shows [Qd 7d] (two pair, Aces and Jacks)
I_Not_Alone: mucks hand 
schatz9999: shows [Qh 5h] (two pair, Aces and Jacks)
Mighty_Rams collected $0.41 from pot
schatz9999 collected $0.40 from pot
*** SUMMARY ***
Total pot $0.85 | Rake $0.04 
Board [As Jh 4d Ac Js]
Seat 1: schatz9999 (button) showed [Qh 5h] and won ($0.40) with two pair, Aces and Jacks
Seat 3: Mighty_Rams (small blind) showed [Qd 7d] and won ($0.41) with two pair, Aces and Jacks
Seat 4: marcin116 (big blind) folded before Flop
Seat 5: johnpsg folded before Flop (didn't bet)
Seat 6: I_Not_Alone mucked



PokerStars Hand #222975839272:  Hold'em No Limit ($0.05/$0.10 USD) - 2021/01/23 17:42:18 ET
Table 'Demoulina III' 6-max Seat #3 is the button
Seat 1: schatz9999 ($3.79 in chips) 
Seat 3: Mighty_Rams ($2.54 in chips) 
Seat 4: marcin116 ($18.73 in chips) 
Seat 5: johnpsg ($10.75 in chips) 
Seat 6: I_Not_Alone ($10.88 in chips) 
marcin116: posts small blind $0.05
johnpsg: posts big blind $0.10
rioma10: sits out 
*** HOLE CARDS ***
I_Not_Alone: folds 
schatz9999: calls $0.10
Mighty_Rams: calls $0.10
marcin116: raises $0.40 to $0.50
johnpsg: folds 
schatz9999: calls $0.40
Mighty_Rams: folds 
*** FLOP *** [Jc Td 4d]
marcin116: checks 
schatz9999: checks 
*** TURN *** [Jc Td 4d] [7c]
marcin116: checks 
schatz9999: checks 
*** RIVER *** [Jc Td 4d 7c] [Ks]
marcin116: checks 
schatz9999: checks 
*** SHOW DOWN ***
marcin116: shows [3d 3s] (a pair of Threes)
schatz9999: shows [Kd 9h] (a pair of Kings)
schatz9999 collected $1.15 from pot
*** SUMMARY ***
Total pot $1.20 | Rake $0.05 
Board [Jc Td 4d 7c Ks]
Seat 1: schatz9999 showed [Kd 9h] and won ($1.15) with a pair of Kings
Seat 3: Mighty_Rams (button) folded before Flop
Seat 4: marcin116 (small blind) showed [3d 3s] and lost with a pair of Threes
Seat 5: johnpsg (big blind) folded before Flop
Seat 6: I_Not_Alone folded before Flop (didn't bet)



PokerStars Hand #222975873197:  Hold'em No Limit ($0.05/$0.10 USD) - 2021/01/23 17:43:02 ET
Table 'Demoulina III' 6-max Seat #4 is the button
Seat 1: schatz9999 ($4.44 in chips) 
Seat 3: Mighty_Rams ($2.44 in chips) 
Seat 4: marcin116 ($18.23 in chips) 
Seat 5: johnpsg ($10.65 in chips) 
Seat 6: I_Not_Alone ($10.88 in chips) 
johnpsg: posts small blind $0.05
I_Not_Alone: posts big blind $0.10
rioma10: sits out 
*** HOLE CARDS ***
schatz9999: folds 
Mighty_Rams: folds 
marcin116: raises $0.25 to $0.35
johnpsg: folds 
I_Not_Alone: folds 
Uncalled bet ($0.25) returned to marcin116
marcin116 collected $0.25 from pot
marcin116: doesn't show hand 
*** SUMMARY ***
Total pot $0.25 | Rake $0 
Seat 1: schatz9999 folded before Flop (didn't bet)
Seat 3: Mighty_Rams folded before Flop (didn't bet)
Seat 4: marcin116 (button) collected ($0.25)
Seat 5: johnpsg (small blind) folded before Flop
Seat 6: I_Not_Alone (big blind) folded before Flop



PokerStars Hand #222978048348:  Hold'em No Limit ($0.05/$0.10 USD) - 2021/01/23 18:36:12 ET
Table 'Demoulina III' 6-max Seat #4 is the button
Seat 2: maxthebest99 ($4.92 in chips) 
Seat 3: RoN Navi ($13.43 in chips) 
Seat 4: marcin116 ($24.91 in chips) 
Seat 5: YuYuYu777 ($7.12 in chips) 
Seat 6: Zimniy ($10.20 in chips) 
YuYuYu777: posts small blind $0.05
Zimniy: posts big blind $0.10
zebaztravez: sits out 
*** HOLE CARDS ***
maxthebest99: folds 
RoN Navi has timed out
RoN Navi: folds 
marcin116: raises $0.25 to $0.35
YuYuYu777: calls $0.30
Zimniy: folds 
*** FLOP *** [Kd 2d 9d]
YuYuYu777: checks 
marcin116: checks 
*** TURN *** [Kd 2d 9d] [Kh]
YuYuYu777: bets $0.38
marcin116: folds 
Uncalled bet ($0.38) returned to YuYuYu777
YuYuYu777 collected $0.76 from pot
YuYuYu777: doesn't show hand 
*** SUMMARY ***
Total pot $0.80 | Rake $0.04 
Board [Kd 2d 9d Kh]
Seat 2: maxthebest99 folded before Flop (didn't bet)
Seat 3: RoN Navi folded before Flop (didn't bet)
Seat 4: marcin116 (button) folded on the Turn
Seat 5: YuYuYu777 (small blind) collected ($0.76)
Seat 6: Zimniy (big blind) folded before Flop



PokerStars Hand #222978073125:  Hold'em No Limit ($0.05/$0.10 USD) - 2021/01/23 18:36:51 ET
Table 'Demoulina III' 6-max Seat #5 is the button
Seat 1: zebaztravez ($10 in chips) 
Seat 2: maxthebest99 ($4.92 in chips) 
Seat 3: RoN Navi ($13.43 in chips) 
Seat 4: marcin116 ($24.56 in chips) 
Seat 5: YuYuYu777 ($7.53 in chips) 
Seat 6: Zimniy ($10.10 in chips) 
Zimniy: posts small blind $0.05
zebaztravez: posts big blind $0.10
*** HOLE CARDS ***
maxthebest99: folds 
RoN Navi: raises $0.15 to $0.25
marcin116: folds 
YuYuYu777: calls $0.25
Zimniy: folds 
zebaztravez: folds 
*** FLOP *** [3d 5h 9s]
RoN Navi: checks 
YuYuYu777: bets $0.62
RoN Navi: folds 
Uncalled bet ($0.62) returned to YuYuYu777
YuYuYu777 collected $0.62 from pot
YuYuYu777: doesn't show hand 
*** SUMMARY ***
Total pot $0.65 | Rake $0.03 
Board [3d 5h 9s]
Seat 1: zebaztravez (big blind) folded before Flop
Seat 2: maxthebest99 folded before Flop (didn't bet)
Seat 3: RoN Navi folded on the Flop
Seat 4: marcin116 folded before Flop (didn't bet)
Seat 5: YuYuYu777 (button) collected ($0.62)
Seat 6: Zimniy (small blind) folded before Flop



PokerStars Hand #222978097119:  Hold'em No Limit ($0.05/$0.10 USD) - 2021/01/23 18:37:28 ET
Table 'Demoulina III' 6-max Seat #6 is the button
Seat 1: zebaztravez ($10 in chips) 
Seat 2: maxthebest99 ($4.92 in chips) 
Seat 3: RoN Navi ($13.18 in chips) 
Seat 4: marcin116 ($24.56 in chips) 
Seat 5: YuYuYu777 ($7.90 in chips) 
Seat 6: Zimniy ($10.05 in chips) 
zebaztravez: posts small blind $0.05
maxthebest99: posts big blind $0.10
*** HOLE CARDS ***
RoN Navi: raises $0.15 to $0.25
marcin116: folds 
YuYuYu777: folds 
Zimniy: folds 
zebaztravez: folds 
maxthebest99: folds 
Uncalled bet ($0.15) returned to RoN Navi
RoN Navi collected $0.25 from pot
*** SUMMARY ***
Total pot $0.25 | Rake $0 
Seat 1: zebaztravez (small blind) folded before Flop
Seat 2: maxthebest99 (big blind) folded before Flop
Seat 3: RoN Navi collected ($0.25)
Seat 4: marcin116 folded before Flop (didn't bet)
Seat 5: YuYuYu777 folded before Flop (didn't bet)
Seat 6: Zimniy (button) folded before Flop (didn't bet)



PokerStars Hand #222978109701:  Hold'em No Limit ($0.05/$0.10 USD) - 2021/01/23 18:37:47 ET
Table 'Demoulina III' 6-max Seat #1 is the button
Seat 1: zebaztravez ($10 in chips) 
Seat 2: maxthebest99 ($4.82 in chips) 
Seat 3: RoN Navi ($13.33 in chips) 
Seat 4: marcin116 ($24.56 in chips) 
Seat 5: YuYuYu777 ($7.90 in chips) 
Seat 6: Zimniy ($10.05 in chips) 
maxthebest99: posts small blind $0.05
RoN Navi: posts big blind $0.10
*** HOLE CARDS ***
marcin116: raises $0.25 to $0.35
YuYuYu777: folds 
Zimniy: folds 
zebaztravez: folds 
maxthebest99: calls $0.30
RoN Navi: folds 
*** FLOP *** [8h Jd 6c]
maxthebest99: checks 
marcin116: bets $0.57
maxthebest99: folds 
Uncalled bet ($0.57) returned to marcin116
marcin116 collected $0.76 from pot
marcin116: doesn't show hand 
*** SUMMARY ***
Total pot $0.80 | Rake $0.04 
Board [8h Jd 6c]
Seat 1: zebaztravez (button) folded before Flop (didn't bet)
Seat 2: maxthebest99 (small blind) folded on the Flop
Seat 3: RoN Navi (big blind) folded before Flop
Seat 4: marcin116 collected ($0.76)
Seat 5: YuYuYu777 folded before Flop (didn't bet)
Seat 6: Zimniy folded before Flop (didn't bet)



PokerStars Hand #222978131799:  Hold'em No Limit ($0.05/$0.10 USD) - 2021/01/23 18:38:22 ET
Table 'Demoulina III' 6-max Seat #2 is the button
Seat 1: zebaztravez ($10 in chips) 
Seat 2: maxthebest99 ($4.47 in chips) 
Seat 3: RoN Navi ($13.23 in chips) 
Seat 5: YuYuYu777 ($7.90 in chips) 
Seat 6: Zimniy ($10.05 in chips) 
RoN Navi: posts small blind $0.05
marcin116: is sitting out 
marcin116 leaves the table
YuYuYu777: posts big blind $0.10
*** HOLE CARDS ***
Zimniy: folds 
zebaztravez: raises $0.20 to $0.30
maxthebest99: folds 
RoN Navi: folds 
betfair21 joins the table at seat #4 
YuYuYu777: folds 
Uncalled bet ($0.20) returned to zebaztravez
zebaztravez collected $0.25 from pot
zebaztravez: doesn't show hand 
*** SUMMARY ***
Total pot $0.25 | Rake $0 
Seat 1: zebaztravez collected ($0.25)
Seat 2: maxthebest99 (button) folded before Flop (didn't bet)
Seat 3: RoN Navi (small blind) folded before Flop
Seat 5: YuYuYu777 (big blind) folded before Flop
Seat 6: Zimniy folded before Flop (didn't bet)



PokerStars Hand #222978140801:  Hold'em No Limit ($0.05/$0.10 USD) - 2021/01/23 18:38:36 ET
Table 'Demoulina III' 6-max Seat #3 is the button
Seat 1: zebaztravez ($10.15 in chips) 
Seat 2: maxthebest99 ($4.47 in chips) 
Seat 3: RoN Navi ($13.18 in chips) 
Seat 5: YuYuYu777 ($7.80 in chips) 
Seat 6: Zimniy ($10.05 in chips) 
YuYuYu777: posts small blind $0.05
Zimniy: posts big blind $0.10
*** HOLE CARDS ***
zebaztravez: folds 
maxthebest99: raises $0.10 to $0.20
RoN Navi: folds 
YuYuYu777: folds 
Zimniy: folds 
Uncalled bet ($0.10) returned to maxthebest99
maxthebest99 collected $0.25 from pot
maxthebest99: doesn't show hand 
*** SUMMARY ***
Total pot $0.25 | Rake $0 
Seat 1: zebaztravez folded before Flop (didn't bet)
Seat 2: maxthebest99 collected ($0.25)
Seat 3: RoN Navi (button) folded before Flop (didn't bet)
Seat 5: YuYuYu777 (small blind) folded before Flop
Seat 6: Zimniy (big blind) folded before Flop



PokerStars Hand #222978147329:  Hold'em No Limit ($0.05/$0.10 USD) - 2021/01/23 18:38:46 ET
Table 'Demoulina III' 6-max Seat #5 is the button
Seat 1: zebaztravez ($10.15 in chips) 
Seat 2: maxthebest99 ($4.62 in chips) 
Seat 3: RoN Navi ($13.18 in chips) 
Seat 5: YuYuYu777 ($7.75 in chips) 
Seat 6: Zimniy ($10 in chips) 
Zimniy: posts small blind $0.05
zebaztravez: posts big blind $0.10
*** HOLE CARDS ***
maxthebest99: folds 
RoN Navi: raises $0.15 to $0.25
YuYuYu777: raises $0.65 to $0.90
Zimniy: folds 
zebaztravez: folds 
RoN Navi: folds 
Uncalled bet ($0.65) returned to YuYuYu777
YuYuYu777 collected $0.65 from pot
YuYuYu777: doesn't show hand 
*** SUMMARY ***
Total pot $0.65 | Rake $0 
Seat 1: zebaztravez (big blind) folded before Flop
Seat 2: maxthebest99 folded before Flop (didn't bet)
Seat 3: RoN Navi folded before Flop
Seat 5: YuYuYu777 (button) collected ($0.65)
Seat 6: Zimniy (small blind) folded before Flop



PokerStars Hand #222978160967:  Hold'em No Limit ($0.05/$0.10 USD) - 2021/01/23 18:39:08 ET
Table 'Demoulina III' 6-max Seat #6 is the button
Seat 1: zebaztravez ($10.05 in chips) 
Seat 2: maxthebest99 ($4.62 in chips) 
Seat 3: RoN Navi ($12.93 in chips) 
Seat 5: YuYuYu777 ($8.15 in chips) 
Seat 6: Zimniy ($10 in chips) 
zebaztravez: posts small blind $0.05
maxthebest99: posts big blind $0.10
*** HOLE CARDS ***
RoN Navi: folds 
YuYuYu777: folds 
Zimniy: folds 
zebaztravez: raises $0.20 to $0.30
maxthebest99: folds 
Uncalled bet ($0.20) returned to zebaztravez
zebaztravez collected $0.20 from pot
zebaztravez: doesn't show hand 
*** SUMMARY ***
Total pot $0.20 | Rake $0 
Seat 1: zebaztravez (small blind) collected ($0.20)
Seat 2: maxthebest99 (big blind) folded before Flop
Seat 3: RoN Navi folded before Flop (didn't bet)
Seat 5: YuYuYu777 folded before Flop (didn't bet)
Seat 6: Zimniy (button) folded before Flop (didn't bet)



PokerStars Hand #222978168109:  Hold'em No Limit ($0.05/$0.10 USD) - 2021/01/23 18:39:19 ET
Table 'Demoulina III' 6-max Seat #1 is the button
Seat 1: zebaztravez ($10.15 in chips) 
Seat 2: maxthebest99 ($4.52 in chips) 
Seat 3: RoN Navi ($12.93 in chips) 
Seat 5: YuYuYu777 ($8.15 in chips) 
Seat 6: Zimniy ($10 in chips) 
maxthebest99: posts small blind $0.05
RoN Navi: posts big blind $0.10
*** HOLE CARDS ***
YuYuYu777: folds 
Zimniy: folds 
zebaztravez: folds 
maxthebest99: raises $0.10 to $0.20
RoN Navi: calls $0.10
*** FLOP *** [8h 8c 4d]
maxthebest99: bets $0.10
RoN Navi: folds 
Uncalled bet ($0.10) returned to maxthebest99
maxthebest99 collected $0.38 from pot
maxthebest99: doesn't show hand 
*** SUMMARY ***
Total pot $0.40 | Rake $0.02 
Board [8h 8c 4d]
Seat 1: zebaztravez (button) folded before Flop (didn't bet)
Seat 2: maxthebest99 (small blind) collected ($0.38)
Seat 3: RoN Navi (big blind) folded on the Flop
Seat 5: YuYuYu777 folded before Flop (didn't bet)
Seat 6: Zimniy folded before Flop (didn't bet)



PokerStars Hand #222978183788:  Hold'em No Limit ($0.05/$0.10 USD) - 2021/01/23 18:39:43 ET
Table 'Demoulina III' 6-max Seat #2 is the button
Seat 1: zebaztravez ($10.15 in chips) 
Seat 2: maxthebest99 ($4.70 in chips) 
Seat 3: RoN Navi ($12.73 in chips) 
Seat 5: YuYuYu777 ($8.15 in chips) 
Seat 6: Zimniy ($10 in chips) 
RoN Navi: posts small blind $0.05
YuYuYu777: posts big blind $0.10
*** HOLE CARDS ***
Zimniy: folds 
zebaztravez: folds 
maxthebest99: folds 
RoN Navi: raises $0.15 to $0.25
YuYuYu777: raises $0.50 to $0.75
betfair21 leaves the table
RoN Navi: calls $0.50
*** FLOP *** [4s Qc 9c]
RoN Navi: checks 
YuYuYu777: checks 
*** TURN *** [4s Qc 9c] [8h]
RoN Navi: bets $0.50
YuYuYu777: calls $0.50
*** RIVER *** [4s Qc 9c 8h] [Th]
RoN Navi: checks 
YuYuYu777: bets $1.79
RoN Navi: folds 
Uncalled bet ($1.79) returned to YuYuYu777
YuYuYu777 collected $2.39 from pot
YuYuYu777: doesn't show hand 
*** SUMMARY ***
Total pot $2.50 | Rake $0.11 
Board [4s Qc 9c 8h Th]
Seat 1: zebaztravez folded before Flop (didn't bet)
Seat 2: maxthebest99 (button) folded before Flop (didn't bet)
Seat 3: RoN Navi (small blind) folded on the River
Seat 5: YuYuYu777 (big blind) collected ($2.39)
Seat 6: Zimniy folded before Flop (didn't bet)



PokerStars Hand #222978224535:  Hold'em No Limit ($0.05/$0.10 USD) - 2021/01/23 18:40:47 ET
Table 'Demoulina III' 6-max Seat #3 is the button
Seat 1: zebaztravez ($10.15 in chips) 
Seat 2: maxthebest99 ($4.70 in chips) 
Seat 3: RoN Navi ($11.48 in chips) 
Seat 5: YuYuYu777 ($9.29 in chips) 
Seat 6: Zimniy ($10 in chips) 
YuYuYu777: posts small blind $0.05
Zimniy: posts big blind $0.10
*** HOLE CARDS ***
zebaztravez: raises $0.20 to $0.30
maxthebest99: folds 
RoN Navi: folds 
YuYuYu777: folds 
Zimniy: folds 
Uncalled bet ($0.20) returned to zebaztravez
zebaztravez collected $0.25 from pot
zebaztravez: doesn't show hand 
*** SUMMARY ***
Total pot $0.25 | Rake $0 
Seat 1: zebaztravez collected ($0.25)
Seat 2: maxthebest99 folded before Flop (didn't bet)
Seat 3: RoN Navi (button) folded before Flop (didn't bet)
Seat 5: YuYuYu777 (small blind) folded before Flop
Seat 6: Zimniy (big blind) folded before Flop



PokerStars Hand #222978231782:  Hold'em No Limit ($0.05/$0.10 USD) - 2021/01/23 18:40:58 ET
Table 'Demoulina III' 6-max Seat #5 is the button
Seat 1: zebaztravez ($10.30 in chips) 
Seat 2: maxthebest99 ($4.70 in chips) 
Seat 3: RoN Navi ($11.48 in chips) 
Seat 5: YuYuYu777 ($9.24 in chips) 
Seat 6: Zimniy ($10 in chips) 
Zimniy: posts small blind $0.05
zebaztravez: posts big blind $0.10
*** HOLE CARDS ***
maxthebest99: folds 
RoN Navi: folds 
YuYuYu777: raises $0.20 to $0.30
sAsscha17 joins the table at seat #4 
Zimniy: folds 
zebaztravez: folds 
Uncalled bet ($0.20) returned to YuYuYu777
YuYuYu777 collected $0.25 from pot
YuYuYu777: doesn't show hand 
*** SUMMARY ***
Total pot $0.25 | Rake $0 
Seat 1: zebaztravez (big blind) folded before Flop
Seat 2: maxthebest99 folded before Flop (didn't bet)
Seat 3: RoN Navi folded before Flop (didn't bet)
Seat 5: YuYuYu777 (button) collected ($0.25)
Seat 6: Zimniy (small blind) folded before Flop



PokerStars Hand #222978243490:  Hold'em No Limit ($0.05/$0.10 USD) - 2021/01/23 18:41:17 ET
Table 'Demoulina III' 6-max Seat #6 is the button
Seat 1: zebaztravez ($10.20 in chips) 
Seat 2: maxthebest99 ($4.70 in chips) 
Seat 3: RoN Navi ($11.48 in chips) 
Seat 5: YuYuYu777 ($9.39 in chips) 
Seat 6: Zimniy ($10 in chips) 
zebaztravez: posts small blind $0.05
maxthebest99: posts big blind $0.10
sAsscha17: sits out 
*** HOLE CARDS ***
RoN Navi: folds 
YuYuYu777: raises $0.20 to $0.30
Zimniy: folds 
zebaztravez: folds 
maxthebest99: folds 
Uncalled bet ($0.20) returned to YuYuYu777
YuYuYu777 collected $0.25 from pot
YuYuYu777: doesn't show hand 
*** SUMMARY ***
Total pot $0.25 | Rake $0 
Seat 1: zebaztravez (small blind) folded before Flop
Seat 2: maxthebest99 (big blind) folded before Flop
Seat 3: RoN Navi folded before Flop (didn't bet)
Seat 5: YuYuYu777 collected ($0.25)
Seat 6: Zimniy (button) folded before Flop (didn't bet)



PokerStars Hand #222978256317:  Hold'em No Limit ($0.05/$0.10 USD) - 2021/01/23 18:41:37 ET
Table 'Demoulina III' 6-max Seat #1 is the button
Seat 1: zebaztravez ($10.15 in chips) 
Seat 2: maxthebest99 ($4.60 in chips) 
Seat 3: RoN Navi ($11.48 in chips) 
Seat 4: sAsscha17 ($5.84 in chips) 
Seat 5: YuYuYu777 ($9.54 in chips) 
Seat 6: Zimniy ($10 in chips) 
maxthebest99: posts small blind $0.05
RoN Navi: posts big blind $0.10
sAsscha17: posts big blind $0.10
*** HOLE CARDS ***
sAsscha17: checks 
YuYuYu777: folds 
Zimniy: raises $0.30 to $0.40
zebaztravez: folds 
maxthebest99: folds 
RoN Navi: folds 
sAsscha17: folds 
Uncalled bet ($0.30) returned to Zimniy
sAsscha17 leaves the table
Zimniy collected $0.35 from pot
Zimniy: doesn't show hand 
*** SUMMARY ***
Total pot $0.35 | Rake $0 
Seat 1: zebaztravez (button) folded before Flop (didn't bet)
Seat 2: maxthebest99 (small blind) folded before Flop
Seat 3: RoN Navi (big blind) folded before Flop
Seat 4: sAsscha17 folded before Flop (didn't bet)
Seat 5: YuYuYu777 folded before Flop (didn't bet)
Seat 6: Zimniy collected ($0.35)



PokerStars Hand #222978284323:  Hold'em No Limit ($0.05/$0.10 USD) - 2021/01/23 18:42:06 ET
Table 'Demoulina III' 6-max Seat #2 is the button
Seat 1: zebaztravez ($10.15 in chips) 
Seat 2: maxthebest99 ($4.55 in chips) 
Seat 3: RoN Navi ($11.38 in chips) 
Seat 5: YuYuYu777 ($9.54 in chips) 
Seat 6: Zimniy ($10.25 in chips) 
RoN Navi: posts small blind $0.05
YuYuYu777: posts big blind $0.10
*** HOLE CARDS ***
Zimniy: raises $0.20 to $0.30
zebaztravez: folds 
maxthebest99: folds 
RoN Navi: folds 
YuYuYu777: folds 
Uncalled bet ($0.20) returned to Zimniy
Zimniy collected $0.25 from pot
Zimniy: doesn't show hand 
*** SUMMARY ***
Total pot $0.25 | Rake $0 
Seat 1: zebaztravez folded before Flop (didn't bet)
Seat 2: maxthebest99 (button) folded before Flop (didn't bet)
Seat 3: RoN Navi (small blind) folded before Flop
Seat 5: YuYuYu777 (big blind) folded before Flop
Seat 6: Zimniy collected ($0.25)



PokerStars Hand #222978297276:  Hold'em No Limit ($0.05/$0.10 USD) - 2021/01/23 18:42:27 ET
Table 'Demoulina III' 6-max Seat #3 is the button
Seat 1: zebaztravez ($10.15 in chips) 
Seat 2: maxthebest99 ($4.55 in chips) 
Seat 3: RoN Navi ($11.33 in chips) 
Seat 5: YuYuYu777 ($9.44 in chips) 
Seat 6: Zimniy ($10.40 in chips) 
YuYuYu777: posts small blind $0.05
Zimniy: posts big blind $0.10
*** HOLE CARDS ***
Hofnarren joins the table at seat #4 
zebaztravez: folds 
maxthebest99: folds 
RoN Navi: folds 
YuYuYu777: raises $0.20 to $0.30
Zimniy: folds 
Uncalled bet ($0.20) returned to YuYuYu777
YuYuYu777 collected $0.20 from pot
YuYuYu777: doesn't show hand 
*** SUMMARY ***
Total pot $0.20 | Rake $0 
Seat 1: zebaztravez folded before Flop (didn't bet)
Seat 2: maxthebest99 folded before Flop (didn't bet)
Seat 3: RoN Navi (button) folded before Flop (didn't bet)
Seat 5: YuYuYu777 (small blind) collected ($0.20)
Seat 6: Zimniy (big blind) folded before Flop



PokerStars Hand #222978309026:  Hold'em No Limit ($0.05/$0.10 USD) - 2021/01/23 18:42:46 ET
Table 'Demoulina III' 6-max Seat #5 is the button
Seat 1: zebaztravez ($10.15 in chips) 
Seat 2: maxthebest99 ($4.55 in chips) 
Seat 3: RoN Navi ($11.33 in chips) 
Seat 4: Hofnarren ($10 in chips) 
Seat 5: YuYuYu777 ($9.54 in chips) 
Seat 6: Zimniy ($10.30 in chips) 
Zimniy: posts small blind $0.05
zebaztravez: posts big blind $0.10
Hofnarren: posts big blind $0.10
*** HOLE CARDS ***
maxthebest99: folds 
RoN Navi: folds 
Hofnarren: checks 
YuYuYu777: folds 
Zimniy: folds 
zebaztravez: checks 
*** FLOP *** [7h 2h Js]
zebaztravez: checks 
Hofnarren: bets $0.12
zebaztravez: folds 
Uncalled bet ($0.12) returned to Hofnarren
Hofnarren collected $0.24 from pot
Hofnarren: doesn't show hand 
*** SUMMARY ***
Total pot $0.25 | Rake $0.01 
Board [7h 2h Js]
Seat 1: zebaztravez (big blind) folded on the Flop
Seat 2: maxthebest99 folded before Flop (didn't bet)
Seat 3: RoN Navi folded before Flop (didn't bet)
Seat 4: Hofnarren collected ($0.24)
Seat 5: YuYuYu777 (button) folded before Flop (didn't bet)
Seat 6: Zimniy (small blind) folded before Flop



PokerStars Hand #222978324047:  Hold'em No Limit ($0.05/$0.10 USD) - 2021/01/23 18:43:10 ET
Table 'Demoulina III' 6-max Seat #6 is the button
Seat 1: zebaztravez ($10.05 in chips) 
Seat 2: maxthebest99 ($4.55 in chips) 
Seat 3: RoN Navi ($11.33 in chips) 
Seat 4: Hofnarren ($10.14 in chips) 
Seat 5: YuYuYu777 ($9.54 in chips) 
Seat 6: Zimniy ($10.25 in chips) 
zebaztravez: posts small blind $0.05
maxthebest99: posts big blind $0.10
*** HOLE CARDS ***
RoN Navi: folds 
Hofnarren: raises $0.25 to $0.35
YuYuYu777: folds 
Zimniy: folds 
zebaztravez: folds 
maxthebest99: folds 
Uncalled bet ($0.25) returned to Hofnarren
Hofnarren collected $0.25 from pot
Hofnarren: doesn't show hand 
*** SUMMARY ***
Total pot $0.25 | Rake $0 
Seat 1: zebaztravez (small blind) folded before Flop
Seat 2: maxthebest99 (big blind) folded before Flop
Seat 3: RoN Navi folded before Flop (didn't bet)
Seat 4: Hofnarren collected ($0.25)
Seat 5: YuYuYu777 folded before Flop (didn't bet)
Seat 6: Zimniy (button) folded before Flop (didn't bet)



PokerStars Hand #222978339891:  Hold'em No Limit ($0.05/$0.10 USD) - 2021/01/23 18:43:35 ET
Table 'Demoulina III' 6-max Seat #1 is the button
Seat 1: zebaztravez ($10 in chips) 
Seat 2: maxthebest99 ($4.45 in chips) 
Seat 3: RoN Navi ($11.33 in chips) 
Seat 4: Hofnarren ($10.29 in chips) 
Seat 5: YuYuYu777 ($9.54 in chips) 
Seat 6: Zimniy ($10.25 in chips) 
maxthebest99: posts small blind $0.05
RoN Navi: posts big blind $0.10
*** HOLE CARDS ***
Hofnarren: raises $0.20 to $0.30
YuYuYu777: folds 
Zimniy: folds 
zebaztravez: raises $0.60 to $0.90
maxthebest99: folds 
RoN Navi: folds 
Hofnarren: calls $0.60
*** FLOP *** [Qd 6h 3h]
Hofnarren: checks 
zebaztravez: bets $0.60
Hofnarren: folds 
Uncalled bet ($0.60) returned to zebaztravez
zebaztravez collected $1.86 from pot
zebaztravez: doesn't show hand 
*** SUMMARY ***
Total pot $1.95 | Rake $0.09 
Board [Qd 6h 3h]
Seat 1: zebaztravez (button) collected ($1.86)
Seat 2: maxthebest99 (small blind) folded before Flop
Seat 3: RoN Navi (big blind) folded before Flop
Seat 4: Hofnarren folded on the Flop
Seat 5: YuYuYu777 folded before Flop (didn't bet)
Seat 6: Zimniy folded before Flop (didn't bet)



PokerStars Hand #222978364493:  Hold'em No Limit ($0.05/$0.10 USD) - 2021/01/23 18:44:14 ET
Table 'Demoulina III' 6-max Seat #2 is the button
Seat 1: zebaztravez ($10.96 in chips) 
Seat 2: maxthebest99 ($4.40 in chips) 
Seat 3: RoN Navi ($11.23 in chips) 
Seat 4: Hofnarren ($9.39 in chips) 
Seat 5: YuYuYu777 ($9.54 in chips) 
Seat 6: Zimniy ($10.25 in chips) 
RoN Navi: posts small blind $0.05
Hofnarren: posts big blind $0.10
*** HOLE CARDS ***
YuYuYu777: folds 
Zimniy: folds 
zebaztravez: folds 
maxthebest99: folds 
RoN Navi: raises $0.15 to $0.25
Hofnarren: calls $0.15
*** FLOP *** [Td 6c Ah]
RoN Navi: bets $0.24
Hofnarren: calls $0.24
*** TURN *** [Td 6c Ah] [8s]
RoN Navi: bets $0.47
Hofnarren: calls $0.47
*** RIVER *** [Td 6c Ah 8s] [2h]
RoN Navi: bets $0.92
Hofnarren: folds 
Uncalled bet ($0.92) returned to RoN Navi
RoN Navi collected $1.83 from pot
*** SUMMARY ***
Total pot $1.92 | Rake $0.09 
Board [Td 6c Ah 8s 2h]
Seat 1: zebaztravez folded before Flop (didn't bet)
Seat 2: maxthebest99 (button) folded before Flop (didn't bet)
Seat 3: RoN Navi (small blind) collected ($1.83)
Seat 4: Hofnarren (big blind) folded on the River
Seat 5: YuYuYu777 folded before Flop (didn't bet)
Seat 6: Zimniy folded before Flop (didn't bet)



PokerStars Hand #222978400882:  Hold'em No Limit ($0.05/$0.10 USD) - 2021/01/23 18:45:11 ET
Table 'Demoulina III' 6-max Seat #3 is the button
Seat 1: zebaztravez ($10.96 in chips) 
Seat 2: maxthebest99 ($4.40 in chips) 
Seat 3: RoN Navi ($12.10 in chips) 
Seat 4: Hofnarren ($8.43 in chips) 
Seat 5: YuYuYu777 ($9.54 in chips) 
Seat 6: Zimniy ($10.25 in chips) 
Hofnarren: posts small blind $0.05
YuYuYu777: posts big blind $0.10
*** HOLE CARDS ***
Zimniy: folds 
zebaztravez: folds 
maxthebest99: folds 
RoN Navi: raises $0.15 to $0.25
Hofnarren: calls $0.20
YuYuYu777: folds 
*** FLOP *** [3d Tc Th]
Hofnarren: checks 
RoN Navi: checks 
*** TURN *** [3d Tc Th] [3c]
Hofnarren: checks 
RoN Navi: checks 
*** RIVER *** [3d Tc Th 3c] [4c]
Hofnarren: bets $0.57
RoN Navi: folds 
Uncalled bet ($0.57) returned to Hofnarren
Hofnarren collected $0.57 from pot
Hofnarren: doesn't show hand 
*** SUMMARY ***
Total pot $0.60 | Rake $0.03 
Board [3d Tc Th 3c 4c]
Seat 1: zebaztravez folded before Flop (didn't bet)
Seat 2: maxthebest99 folded before Flop (didn't bet)
Seat 3: RoN Navi (button) folded on the River
Seat 4: Hofnarren (small blind) collected ($0.57)
Seat 5: YuYuYu777 (big blind) folded before Flop
Seat 6: Zimniy folded before Flop (didn't bet)



PokerStars Hand #222978434659:  Hold'em No Limit ($0.05/$0.10 USD) - 2021/01/23 18:46:06 ET
Table 'Demoulina III' 6-max Seat #4 is the button
Seat 1: zebaztravez ($10.96 in chips) 
Seat 2: maxthebest99 ($4.40 in chips) 
Seat 3: RoN Navi ($11.85 in chips) 
Seat 4: Hofnarren ($8.75 in chips) 
Seat 5: YuYuYu777 ($9.44 in chips) 
Seat 6: Zimniy ($10.25 in chips) 
YuYuYu777: posts small blind $0.05
Zimniy: posts big blind $0.10
*** HOLE CARDS ***
zebaztravez: folds 
maxthebest99: folds 
RoN Navi: folds 
Hofnarren: folds 
YuYuYu777: folds 
Uncalled bet ($0.05) returned to Zimniy
Zimniy collected $0.10 from pot
Zimniy: doesn't show hand 
*** SUMMARY ***
Total pot $0.10 | Rake $0 
Seat 1: zebaztravez folded before Flop (didn't bet)
Seat 2: maxthebest99 folded before Flop (didn't bet)
Seat 3: RoN Navi folded before Flop (didn't bet)
Seat 4: Hofnarren (button) folded before Flop (didn't bet)
Seat 5: YuYuYu777 (small blind) folded before Flop
Seat 6: Zimniy (big blind) collected ($0.10)



PokerStars Hand #222978443616:  Hold'em No Limit ($0.05/$0.10 USD) - 2021/01/23 18:46:20 ET
Table 'Demoulina III' 6-max Seat #5 is the button
Seat 1: zebaztravez ($10.96 in chips) 
Seat 2: maxthebest99 ($4.40 in chips) 
Seat 3: RoN Navi ($11.85 in chips) 
Seat 4: Hofnarren ($8.75 in chips) 
Seat 5: YuYuYu777 ($9.39 in chips) 
Seat 6: Zimniy ($10.30 in chips) 
Zimniy: posts small blind $0.05
zebaztravez: posts big blind $0.10
*** HOLE CARDS ***
maxthebest99: folds 
RoN Navi: folds 
Hofnarren: calls $0.10
YuYuYu777: raises $0.20 to $0.30
Zimniy: folds 
zebaztravez: folds 
Hofnarren: calls $0.20
*** FLOP *** [Tc Td Js]
Hofnarren: bets $0.72
YuYuYu777: folds 
Uncalled bet ($0.72) returned to Hofnarren
Hofnarren collected $0.72 from pot
Hofnarren: doesn't show hand 
*** SUMMARY ***
Total pot $0.75 | Rake $0.03 
Board [Tc Td Js]
Seat 1: zebaztravez (big blind) folded before Flop
Seat 2: maxthebest99 folded before Flop (didn't bet)
Seat 3: RoN Navi folded before Flop (didn't bet)
Seat 4: Hofnarren collected ($0.72)
Seat 5: YuYuYu777 (button) folded on the Flop
Seat 6: Zimniy (small blind) folded before Flop



PokerStars Hand #222978467995:  Hold'em No Limit ($0.05/$0.10 USD) - 2021/01/23 18:46:59 ET
Table 'Demoulina III' 6-max Seat #6 is the button
Seat 1: zebaztravez ($10.86 in chips) 
Seat 2: maxthebest99 ($4.40 in chips) 
Seat 3: RoN Navi ($11.85 in chips) 
Seat 4: Hofnarren ($9.17 in chips) 
Seat 5: YuYuYu777 ($9.09 in chips) 
Seat 6: Zimniy ($10.25 in chips) 
zebaztravez: posts small blind $0.05
maxthebest99: posts big blind $0.10
*** HOLE CARDS ***
RoN Navi: folds 
Hofnarren: folds 
YuYuYu777: raises $0.20 to $0.30
Zimniy: folds 
zebaztravez: folds 
maxthebest99: calls $0.20
*** FLOP *** [6d Qs Qh]
maxthebest99: checks 
YuYuYu777: checks 
*** TURN *** [6d Qs Qh] [Kd]
maxthebest99: bets $0.20
YuYuYu777: calls $0.20
*** RIVER *** [6d Qs Qh Kd] [7h]
maxthebest99: bets $0.40
YuYuYu777: raises $1.80 to $2.20
maxthebest99: raises $1.70 to $3.90 and is all-in
YuYuYu777: folds 
Uncalled bet ($1.70) returned to maxthebest99
maxthebest99 collected $5.20 from pot
maxthebest99: doesn't show hand 
*** SUMMARY ***
Total pot $5.45 | Rake $0.25 
Board [6d Qs Qh Kd 7h]
Seat 1: zebaztravez (small blind) folded before Flop
Seat 2: maxthebest99 (big blind) collected ($5.20)
Seat 3: RoN Navi folded before Flop (didn't bet)
Seat 4: Hofnarren folded before Flop (didn't bet)
Seat 5: YuYuYu777 folded on the River
Seat 6: Zimniy (button) folded before Flop (didn't bet)



PokerStars Hand #222978512140:  Hold'em No Limit ($0.05/$0.10 USD) - 2021/01/23 18:48:10 ET
Table 'Demoulina III' 6-max Seat #1 is the button
Seat 1: zebaztravez ($10.81 in chips) 
Seat 2: maxthebest99 ($6.90 in chips) 
Seat 3: RoN Navi ($11.85 in chips) 
Seat 4: Hofnarren ($9.17 in chips) 
Seat 5: YuYuYu777 ($6.39 in chips) 
Seat 6: Zimniy ($10.25 in chips) 
maxthebest99: posts small blind $0.05
RoN Navi: posts big blind $0.10
*** HOLE CARDS ***
Hofnarren: calls $0.10
YuYuYu777: calls $0.10
Zimniy: raises $0.35 to $0.45
zebaztravez: folds 
maxthebest99: calls $0.40
RoN Navi: folds 
Hofnarren: calls $0.35
YuYuYu777: calls $0.35
*** FLOP *** [3d 7c 4s]
maxthebest99: checks 
Hofnarren: checks 
YuYuYu777: checks 
Zimniy: checks 
*** TURN *** [3d 7c 4s] [Jc]
maxthebest99: checks 
Hofnarren: bets $0.10
YuYuYu777: calls $0.10
Zimniy: calls $0.10
maxthebest99: calls $0.10
*** RIVER *** [3d 7c 4s Jc] [2c]
maxthebest99: bets $1.20
Hofnarren: folds 
YuYuYu777: folds 
Zimniy: folds 
Uncalled bet ($1.20) returned to maxthebest99
maxthebest99 collected $2.20 from pot
maxthebest99: doesn't show hand 
*** SUMMARY ***
Total pot $2.30 | Rake $0.10 
Board [3d 7c 4s Jc 2c]
Seat 1: zebaztravez (button) folded before Flop (didn't bet)
Seat 2: maxthebest99 (small blind) collected ($2.20)
Seat 3: RoN Navi (big blind) folded before Flop
Seat 4: Hofnarren folded on the River
Seat 5: YuYuYu777 folded on the River
Seat 6: Zimniy folded on the River



PokerStars Hand #222978566796:  Hold'em No Limit ($0.05/$0.10 USD) - 2021/01/23 18:49:34 ET
Table 'Demoulina III' 6-max Seat #2 is the button
Seat 1: zebaztravez ($10.81 in chips) 
Seat 2: maxthebest99 ($8.55 in chips) 
Seat 3: RoN Navi ($11.75 in chips) 
Seat 4: Hofnarren ($8.62 in chips) 
Seat 5: YuYuYu777 ($9.45 in chips) 
Seat 6: Zimniy ($10 in chips) 
RoN Navi: posts small blind $0.05
Hofnarren: posts big blind $0.10
*** HOLE CARDS ***
YuYuYu777: raises $0.20 to $0.30
Zimniy: raises $0.60 to $0.90
zebaztravez: folds 
maxthebest99: folds 
RoN Navi: folds 
Hofnarren: folds 
YuYuYu777: calls $0.60
*** FLOP *** [5h 3d 6h]
YuYuYu777: checks 
Zimniy: bets $1.40
YuYuYu777: raises $7.15 to $8.55 and is all-in
Zimniy: calls $7.15
*** TURN *** [5h 3d 6h] [Ks]
*** RIVER *** [5h 3d 6h Ks] [8s]
*** SHOW DOWN ***
YuYuYu777: shows [5c 4c] (a pair of Fives)
Zimniy: shows [Td Ts] (a pair of Tens)
Zimniy collected $18.19 from pot
*** SUMMARY ***
Total pot $19.05 | Rake $0.86 
Board [5h 3d 6h Ks 8s]
Seat 1: zebaztravez folded before Flop (didn't bet)
Seat 2: maxthebest99 (button) folded before Flop (didn't bet)
Seat 3: RoN Navi (small blind) folded before Flop
Seat 4: Hofnarren (big blind) folded before Flop
Seat 5: YuYuYu777 showed [5c 4c] and lost with a pair of Fives
Seat 6: Zimniy showed [Td Ts] and won ($18.19) with a pair of Tens



PokerStars Hand #222978595770:  Hold'em No Limit ($0.05/$0.10 USD) - 2021/01/23 18:50:21 ET
Table 'Demoulina III' 6-max Seat #3 is the button
Seat 1: zebaztravez ($10.81 in chips) 
Seat 2: maxthebest99 ($8.55 in chips) 
Seat 3: RoN Navi ($11.70 in chips) 
Seat 4: Hofnarren ($8.52 in chips) 
Seat 6: Zimniy ($18.74 in chips) 
Hofnarren: posts small blind $0.05
Zimniy: posts big blind $0.10
*** HOLE CARDS ***
YuYuYu777 leaves the table
zebaztravez: raises $0.20 to $0.30
maxthebest99: folds 
RoN Navi: folds 
Hofnarren: folds 
SkyTaurus joins the table at seat #5 
Zimniy: folds 
Uncalled bet ($0.20) returned to zebaztravez
zebaztravez collected $0.25 from pot
zebaztravez: doesn't show hand 
*** SUMMARY ***
Total pot $0.25 | Rake $0 
Seat 1: zebaztravez collected ($0.25)
Seat 2: maxthebest99 folded before Flop (didn't bet)
Seat 3: RoN Navi (button) folded before Flop (didn't bet)
Seat 4: Hofnarren (small blind) folded before Flop
Seat 6: Zimniy (big blind) folded before Flop



PokerStars Hand #222978608066:  Hold'em No Limit ($0.05/$0.10 USD) - 2021/01/23 18:50:42 ET
Table 'Demoulina III' 6-max Seat #4 is the button
Seat 1: zebaztravez ($10.96 in chips) 
Seat 2: maxthebest99 ($8.55 in chips) 
Seat 3: RoN Navi ($11.70 in chips) 
Seat 4: Hofnarren ($8.47 in chips) 
Seat 6: Zimniy ($18.64 in chips) 
Zimniy: posts small blind $0.05
zebaztravez: posts big blind $0.10
*** HOLE CARDS ***
maxthebest99: folds 
RoN Navi: folds 
Hofnarren: calls $0.10
Zimniy: folds 
zebaztravez: checks 
*** FLOP *** [4d 3s 3c]
zebaztravez: checks 
Hofnarren: checks 
*** TURN *** [4d 3s 3c] [Qd]
zebaztravez: checks 
Hofnarren: checks 
*** RIVER *** [4d 3s 3c Qd] [9d]
zebaztravez: checks 
Hofnarren: checks 
*** SHOW DOWN ***
zebaztravez: shows [5c 9h] (two pair, Nines and Threes)
Hofnarren: shows [Td 9s] (two pair, Nines and Threes)
zebaztravez collected $0.12 from pot
Hofnarren collected $0.12 from pot
*** SUMMARY ***
Total pot $0.25 | Rake $0.01 
Board [4d 3s 3c Qd 9d]
Seat 1: zebaztravez (big blind) showed [5c 9h] and won ($0.12) with two pair, Nines and Threes
Seat 2: maxthebest99 folded before Flop (didn't bet)
Seat 3: RoN Navi folded before Flop (didn't bet)
Seat 4: Hofnarren (button) showed [Td 9s] and won ($0.12) with two pair, Nines and Threes
Seat 6: Zimniy (small blind) folded before Flop



PokerStars Hand #222978626615:  Hold'em No Limit ($0.05/$0.10 USD) - 2021/01/23 18:51:12 ET
Table 'Demoulina III' 6-max Seat #6 is the button
Seat 1: zebaztravez ($10.98 in chips) 
Seat 2: maxthebest99 ($8.55 in chips) 
Seat 3: RoN Navi ($11.70 in chips) 
Seat 4: Hofnarren ($8.49 in chips) 
Seat 6: Zimniy ($18.59 in chips) 
zebaztravez: posts small blind $0.05
maxthebest99: posts big blind $0.10
SkyTaurus: sits out 
*** HOLE CARDS ***
RoN Navi: folds 
Hofnarren: folds 
Zimniy: folds 
zebaztravez: folds 
Uncalled bet ($0.05) returned to maxthebest99
maxthebest99 collected $0.10 from pot
maxthebest99: doesn't show hand 
*** SUMMARY ***
Total pot $0.10 | Rake $0 
Seat 1: zebaztravez (small blind) folded before Flop
Seat 2: maxthebest99 (big blind) collected ($0.10)
Seat 3: RoN Navi folded before Flop (didn't bet)
Seat 4: Hofnarren folded before Flop (didn't bet)
Seat 6: Zimniy (button) folded before Flop (didn't bet)



PokerStars Hand #222978633970:  Hold'em No Limit ($0.05/$0.10 USD) - 2021/01/23 18:51:24 ET
Table 'Demoulina III' 6-max Seat #1 is the button
Seat 1: zebaztravez ($10.93 in chips) 
Seat 2: maxthebest99 ($8.60 in chips) 
Seat 3: RoN Navi ($11.70 in chips) 
Seat 4: Hofnarren ($8.49 in chips) 
Seat 6: Zimniy ($18.59 in chips) 
maxthebest99: posts small blind $0.05
RoN Navi: posts big blind $0.10
SkyTaurus: sits out 
*** HOLE CARDS ***
Hofnarren: calls $0.10
Zimniy: folds 
zebaztravez: raises $0.30 to $0.40
maxthebest99: folds 
RoN Navi: folds 
Hofnarren: calls $0.30
*** FLOP *** [6c 5h 4h]
Hofnarren: checks 
zebaztravez: checks 
*** TURN *** [6c 5h 4h] [Qc]
Hofnarren: bets $0.46
zebaztravez: calls $0.46
*** RIVER *** [6c 5h 4h Qc] [Qd]
Hofnarren: checks 
zebaztravez: checks 
*** SHOW DOWN ***
Hofnarren: shows [Ts Jh] (a pair of Queens)
zebaztravez: shows [4c Ac] (two pair, Queens and Fours)
zebaztravez collected $1.79 from pot
*** SUMMARY ***
Total pot $1.87 | Rake $0.08 
Board [6c 5h 4h Qc Qd]
Seat 1: zebaztravez (button) showed [4c Ac] and won ($1.79) with two pair, Queens and Fours
Seat 2: maxthebest99 (small blind) folded before Flop
Seat 3: RoN Navi (big blind) folded before Flop
Seat 4: Hofnarren showed [Ts Jh] and lost with a pair of Queens
Seat 6: Zimniy folded before Flop (didn't bet)



PokerStars Hand #222978669913:  Hold'em No Limit ($0.05/$0.10 USD) - 2021/01/23 18:52:24 ET
Table 'Demoulina III' 6-max Seat #2 is the button
Seat 1: zebaztravez ($11.86 in chips) 
Seat 2: maxthebest99 ($8.55 in chips) 
Seat 3: RoN Navi ($11.60 in chips) 
Seat 4: Hofnarren ($7.63 in chips) 
Seat 6: Zimniy ($18.59 in chips) 
RoN Navi: posts small blind $0.05
Hofnarren: posts big blind $0.10
SkyTaurus: sits out 
*** HOLE CARDS ***
Zimniy: folds 
zebaztravez: folds 
maxthebest99: calls $0.10
RoN Navi: folds 
Hofnarren: checks 
*** FLOP *** [8c 5s Kd]
Hofnarren: checks 
maxthebest99: bets $0.10
Hofnarren: calls $0.10
*** TURN *** [8c 5s Kd] [2h]
Hofnarren: checks 
maxthebest99: checks 
*** RIVER *** [8c 5s Kd 2h] [2d]
Hofnarren: checks 
maxthebest99: bets $0.10
Hofnarren: calls $0.10
*** SHOW DOWN ***
maxthebest99: shows [Qc 3c] (a pair of Deuces)
Hofnarren: shows [5h Ah] (two pair, Fives and Deuces)
Hofnarren collected $0.62 from pot
*** SUMMARY ***
Total pot $0.65 | Rake $0.03 
Board [8c 5s Kd 2h 2d]
Seat 1: zebaztravez folded before Flop (didn't bet)
Seat 2: maxthebest99 (button) showed [Qc 3c] and lost with a pair of Deuces
Seat 3: RoN Navi (small blind) folded before Flop
Seat 4: Hofnarren (big blind) showed [5h Ah] and won ($0.62) with two pair, Fives and Deuces
Seat 6: Zimniy folded before Flop (didn't bet)



PokerStars Hand #222978689251:  Hold'em No Limit ($0.05/$0.10 USD) - 2021/01/23 18:52:56 ET
Table 'Demoulina III' 6-max Seat #3 is the button
Seat 1: zebaztravez ($11.86 in chips) 
Seat 2: maxthebest99 ($8.25 in chips) 
Seat 3: RoN Navi ($11.55 in chips) 
Seat 4: Hofnarren ($7.95 in chips) 
Seat 5: SkyTaurus ($10 in chips) 
Seat 6: Zimniy ($18.59 in chips) 
Hofnarren: posts small blind $0.05
SkyTaurus: posts big blind $0.10
*** HOLE CARDS ***
Zimniy: folds 
zebaztravez: folds 
maxthebest99: calls $0.10
RoN Navi: calls $0.10
Hofnarren: calls $0.05
SkyTaurus: checks 
*** FLOP *** [8s Ah 8d]
Hofnarren: checks 
SkyTaurus: checks 
maxthebest99: checks 
RoN Navi: checks 
*** TURN *** [8s Ah 8d] [Ac]
Hofnarren: checks 
SkyTaurus: checks 
maxthebest99: checks 
RoN Navi: checks 
*** RIVER *** [8s Ah 8d Ac] [7s]
Hofnarren: checks 
SkyTaurus: checks 
maxthebest99: checks 
RoN Navi: checks 
*** SHOW DOWN ***
Hofnarren: shows [3d 6h] (two pair, Aces and Eights)
SkyTaurus: shows [3s Qc] (two pair, Aces and Eights - Queen kicker)
maxthebest99: mucks hand 
RoN Navi: mucks hand 
SkyTaurus collected $0.38 from pot
*** SUMMARY ***
Total pot $0.40 | Rake $0.02 
Board [8s Ah 8d Ac 7s]
Seat 1: zebaztravez folded before Flop (didn't bet)
Seat 2: maxthebest99 mucked
Seat 3: RoN Navi (button) mucked
Seat 4: Hofnarren (small blind) showed [3d 6h] and lost with two pair, Aces and Eights
Seat 5: SkyTaurus (big blind) showed [3s Qc] and won ($0.38) with two pair, Aces and Eights
Seat 6: Zimniy folded before Flop (didn't bet)



PokerStars Hand #222978717417:  Hold'em No Limit ($0.05/$0.10 USD) - 2021/01/23 18:53:43 ET
Table 'Demoulina III' 6-max Seat #4 is the button
Seat 1: zebaztravez ($11.86 in chips) 
Seat 2: maxthebest99 ($8.15 in chips) 
Seat 3: RoN Navi ($11.45 in chips) 
Seat 4: Hofnarren ($7.85 in chips) 
Seat 5: SkyTaurus ($10.28 in chips) 
Seat 6: Zimniy ($18.59 in chips) 
SkyTaurus: posts small blind $0.05
Zimniy: posts big blind $0.10
*** HOLE CARDS ***
zebaztravez: folds 
maxthebest99: raises $0.20 to $0.30
RoN Navi: folds 
Hofnarren: folds 
SkyTaurus: folds 
Zimniy: folds 
Uncalled bet ($0.20) returned to maxthebest99
maxthebest99 collected $0.25 from pot
maxthebest99: doesn't show hand 
*** SUMMARY ***
Total pot $0.25 | Rake $0 
Seat 1: zebaztravez folded before Flop (didn't bet)
Seat 2: maxthebest99 collected ($0.25)
Seat 3: RoN Navi folded before Flop (didn't bet)
Seat 4: Hofnarren (button) folded before Flop (didn't bet)
Seat 5: SkyTaurus (small blind) folded before Flop
Seat 6: Zimniy (big blind) folded before Flop



PokerStars Hand #222978729275:  Hold'em No Limit ($0.05/$0.10 USD) - 2021/01/23 18:54:03 ET
Table 'Demoulina III' 6-max Seat #5 is the button
Seat 1: zebaztravez ($11.86 in chips) 
Seat 2: maxthebest99 ($8.30 in chips) 
Seat 3: RoN Navi ($11.45 in chips) 
Seat 4: Hofnarren ($7.85 in chips) 
Seat 5: SkyTaurus ($10.23 in chips) 
Seat 6: Zimniy ($18.49 in chips) 
Zimniy: posts small blind $0.05
zebaztravez: posts big blind $0.10
*** HOLE CARDS ***
maxthebest99: folds 
RoN Navi: raises $0.15 to $0.25
Hofnarren: folds 
SkyTaurus: folds 
Zimniy: folds 
zebaztravez: calls $0.15
*** FLOP *** [4h 4s Ks]
zebaztravez: checks 
RoN Navi: bets $0.27
zebaztravez: calls $0.27
*** TURN *** [4h 4s Ks] [Th]
zebaztravez: checks 
RoN Navi: bets $0.52
zebaztravez: raises $1.38 to $1.90
RoN Navi: folds 
Uncalled bet ($1.38) returned to zebaztravez
zebaztravez collected $2.03 from pot
zebaztravez: doesn't show hand 
*** SUMMARY ***
Total pot $2.13 | Rake $0.10 
Board [4h 4s Ks Th]
Seat 1: zebaztravez (big blind) collected ($2.03)
Seat 2: maxthebest99 folded before Flop (didn't bet)
Seat 3: RoN Navi folded on the Turn
Seat 4: Hofnarren folded before Flop (didn't bet)
Seat 5: SkyTaurus (button) folded before Flop (didn't bet)
Seat 6: Zimniy (small blind) folded before Flop



PokerStars Hand #222978770408:  Hold'em No Limit ($0.05/$0.10 USD) - 2021/01/23 18:55:12 ET
Table 'Demoulina III' 6-max Seat #6 is the button
Seat 1: zebaztravez ($12.85 in chips) 
Seat 2: maxthebest99 ($8.30 in chips) 
Seat 3: RoN Navi ($10.41 in chips) 
Seat 4: Hofnarren ($7.85 in chips) 
Seat 5: SkyTaurus ($10.23 in chips) 
Seat 6: Zimniy ($18.44 in chips) 
zebaztravez: posts small blind $0.05
maxthebest99: posts big blind $0.10
*** HOLE CARDS ***
RoN Navi: folds 
Hofnarren: calls $0.10
SkyTaurus: folds 
Zimniy: folds 
zebaztravez: folds 
maxthebest99: checks 
*** FLOP *** [Kh Qc 7d]
maxthebest99: bets $0.20
Hofnarren: calls $0.20
*** TURN *** [Kh Qc 7d] [3h]
maxthebest99: bets $0.20
Hofnarren: folds 
Uncalled bet ($0.20) returned to maxthebest99
maxthebest99 collected $0.62 from pot
maxthebest99: doesn't show hand 
*** SUMMARY ***
Total pot $0.65 | Rake $0.03 
Board [Kh Qc 7d 3h]
Seat 1: zebaztravez (small blind) folded before Flop
Seat 2: maxthebest99 (big blind) collected ($0.62)
Seat 3: RoN Navi folded before Flop (didn't bet)
Seat 4: Hofnarren folded on the Turn
Seat 5: SkyTaurus folded before Flop (didn't bet)
Seat 6: Zimniy (button) folded before Flop (didn't bet)



PokerStars Hand #222978784678:  Hold'em No Limit ($0.05/$0.10 USD) - 2021/01/23 18:55:44 ET
Table 'Demoulina III' 6-max Seat #1 is the button
Seat 1: zebaztravez ($12.80 in chips) 
Seat 2: maxthebest99 ($8.62 in chips) 
Seat 3: RoN Navi ($10.41 in chips) 
Seat 4: Hofnarren ($7.55 in chips) 
Seat 5: SkyTaurus ($10.23 in chips) 
Seat 6: Zimniy ($18.44 in chips) 
maxthebest99: posts small blind $0.05
RoN Navi: posts big blind $0.10
*** HOLE CARDS ***
Hofnarren: folds 
SkyTaurus: folds 
Zimniy: folds 
zebaztravez: raises $0.16 to $0.26
maxthebest99: folds 
RoN Navi: folds 
Uncalled bet ($0.16) returned to zebaztravez
zebaztravez collected $0.25 from pot
zebaztravez: doesn't show hand 
*** SUMMARY ***
Total pot $0.25 | Rake $0 
Seat 1: zebaztravez (button) collected ($0.25)
Seat 2: maxthebest99 (small blind) folded before Flop
Seat 3: RoN Navi (big blind) folded before Flop
Seat 4: Hofnarren folded before Flop (didn't bet)
Seat 5: SkyTaurus folded before Flop (didn't bet)
Seat 6: Zimniy folded before Flop (didn't bet)



PokerStars Hand #222978791060:  Hold'em No Limit ($0.05/$0.10 USD) - 2021/01/23 18:55:59 ET
Table 'Demoulina III' 6-max Seat #2 is the button
Seat 1: zebaztravez ($12.95 in chips) 
Seat 2: maxthebest99 ($8.57 in chips) 
Seat 3: RoN Navi ($10.31 in chips) 
Seat 4: Hofnarren ($7.55 in chips) 
Seat 5: SkyTaurus ($10.23 in chips) 
Seat 6: Zimniy ($18.44 in chips) 
RoN Navi: posts small blind $0.05
Hofnarren: posts big blind $0.10
*** HOLE CARDS ***
SkyTaurus: folds 
Zimniy: folds 
zebaztravez: folds 
maxthebest99: calls $0.10
RoN Navi: folds 
Hofnarren: checks 
*** FLOP *** [8s Ac 2d]
Hofnarren: checks 
maxthebest99: bets $0.10
Hofnarren: folds 
Uncalled bet ($0.10) returned to maxthebest99
maxthebest99 collected $0.24 from pot
maxthebest99: doesn't show hand 
*** SUMMARY ***
Total pot $0.25 | Rake $0.01 
Board [8s Ac 2d]
Seat 1: zebaztravez folded before Flop (didn't bet)
Seat 2: maxthebest99 (button) collected ($0.24)
Seat 3: RoN Navi (small blind) folded before Flop
Seat 4: Hofnarren (big blind) folded on the Flop
Seat 5: SkyTaurus folded before Flop (didn't bet)
Seat 6: Zimniy folded before Flop (didn't bet)



PokerStars Hand #222978801141:  Hold'em No Limit ($0.05/$0.10 USD) - 2021/01/23 18:56:21 ET
Table 'Demoulina III' 6-max Seat #3 is the button
Seat 1: zebaztravez ($12.95 in chips) 
Seat 2: maxthebest99 ($8.71 in chips) 
Seat 3: RoN Navi ($10.26 in chips) 
Seat 4: Hofnarren ($7.45 in chips) 
Seat 5: SkyTaurus ($10.23 in chips) 
Seat 6: Zimniy ($18.44 in chips) 
Hofnarren: posts small blind $0.05
SkyTaurus: posts big blind $0.10
*** HOLE CARDS ***
Zimniy has timed out
Zimniy: folds 
zebaztravez: folds 
maxthebest99: calls $0.10
RoN Navi: folds 
Hofnarren: calls $0.05
SkyTaurus: raises $0.60 to $0.70
maxthebest99: folds 
Hofnarren: calls $0.60
*** FLOP *** [7h Kc 5s]
Hofnarren: checks 
SkyTaurus: bets $1
Hofnarren: folds 
Uncalled bet ($1) returned to SkyTaurus
SkyTaurus collected $1.43 from pot
*** SUMMARY ***
Total pot $1.50 | Rake $0.07 
Board [7h Kc 5s]
Seat 1: zebaztravez folded before Flop (didn't bet)
Seat 2: maxthebest99 folded before Flop
Seat 3: RoN Navi (button) folded before Flop (didn't bet)
Seat 4: Hofnarren (small blind) folded on the Flop
Seat 5: SkyTaurus (big blind) collected ($1.43)
Seat 6: Zimniy folded before Flop (didn't bet)



PokerStars Hand #222978821885:  Hold'em No Limit ($0.05/$0.10 USD) - 2021/01/23 18:57:08 ET
Table 'Demoulina III' 6-max Seat #4 is the button
Seat 1: zebaztravez ($12.95 in chips) 
Seat 2: maxthebest99 ($8.61 in chips) 
Seat 3: RoN Navi ($10.26 in chips) 
Seat 4: Hofnarren ($6.75 in chips) 
Seat 5: SkyTaurus ($10.96 in chips) 
Seat 6: Zimniy ($18.44 in chips) 
SkyTaurus: posts small blind $0.05
Zimniy: posts big blind $0.10
*** HOLE CARDS ***
zebaztravez: folds 
maxthebest99: folds 
RoN Navi: raises $0.15 to $0.25
Hofnarren: folds 
SkyTaurus: folds 
Zimniy: folds 
Uncalled bet ($0.15) returned to RoN Navi
RoN Navi collected $0.25 from pot
*** SUMMARY ***
Total pot $0.25 | Rake $0 
Seat 1: zebaztravez folded before Flop (didn't bet)
Seat 2: maxthebest99 folded before Flop (didn't bet)
Seat 3: RoN Navi collected ($0.25)
Seat 4: Hofnarren (button) folded before Flop (didn't bet)
Seat 5: SkyTaurus (small blind) folded before Flop
Seat 6: Zimniy (big blind) folded before Flop



PokerStars Hand #222978832282:  Hold'em No Limit ($0.05/$0.10 USD) - 2021/01/23 18:57:32 ET
Table 'Demoulina III' 6-max Seat #5 is the button
Seat 1: zebaztravez ($12.95 in chips) 
Seat 2: maxthebest99 ($8.61 in chips) 
Seat 3: RoN Navi ($10.41 in chips) 
Seat 4: Hofnarren ($6.75 in chips) 
Seat 5: SkyTaurus ($10.91 in chips) 
Seat 6: Zimniy ($18.34 in chips) 
Zimniy: posts small blind $0.05
zebaztravez: posts big blind $0.10
*** HOLE CARDS ***
maxthebest99: folds 
RoN Navi: folds 
Hofnarren: raises $0.20 to $0.30
SkyTaurus: folds 
Zimniy: folds 
zebaztravez: folds 
Uncalled bet ($0.20) returned to Hofnarren
Hofnarren collected $0.25 from pot
Hofnarren: doesn't show hand 
*** SUMMARY ***
Total pot $0.25 | Rake $0 
Seat 1: zebaztravez (big blind) folded before Flop
Seat 2: maxthebest99 folded before Flop (didn't bet)
Seat 3: RoN Navi folded before Flop (didn't bet)
Seat 4: Hofnarren collected ($0.25)
Seat 5: SkyTaurus (button) folded before Flop (didn't bet)
Seat 6: Zimniy (small blind) folded before Flop



PokerStars Hand #222978844478:  Hold'em No Limit ($0.05/$0.10 USD) - 2021/01/23 18:57:59 ET
Table 'Demoulina III' 6-max Seat #6 is the button
Seat 1: zebaztravez ($12.85 in chips) 
Seat 2: maxthebest99 ($8.61 in chips) 
Seat 3: RoN Navi ($10.41 in chips) 
Seat 4: Hofnarren ($6.90 in chips) 
Seat 5: SkyTaurus ($10.91 in chips) 
Seat 6: Zimniy ($18.29 in chips) 
zebaztravez: posts small blind $0.05
maxthebest99: posts big blind $0.10
*** HOLE CARDS ***
RoN Navi: folds 
Hofnarren: folds 
SkyTaurus: folds 
Zimniy: raises $0.15 to $0.25
zebaztravez: raises $0.75 to $1
maxthebest99: folds 
Zimniy: folds 
Uncalled bet ($0.75) returned to zebaztravez
zebaztravez collected $0.60 from pot
zebaztravez: doesn't show hand 
*** SUMMARY ***
Total pot $0.60 | Rake $0 
Seat 1: zebaztravez (small blind) collected ($0.60)
Seat 2: maxthebest99 (big blind) folded before Flop
Seat 3: RoN Navi folded before Flop (didn't bet)
Seat 4: Hofnarren folded before Flop (didn't bet)
Seat 5: SkyTaurus folded before Flop (didn't bet)
Seat 6: Zimniy (button) folded before Flop



PokerStars Hand #222978855632:  Hold'em No Limit ($0.05/$0.10 USD) - 2021/01/23 18:58:24 ET
Table 'Demoulina III' 6-max Seat #1 is the button
Seat 1: zebaztravez ($13.20 in chips) 
Seat 2: maxthebest99 ($8.51 in chips) 
Seat 3: RoN Navi ($10.41 in chips) 
Seat 4: Hofnarren ($6.90 in chips) 
Seat 5: SkyTaurus ($10.91 in chips) 
Seat 6: Zimniy ($18.04 in chips) 
maxthebest99: posts small blind $0.05
RoN Navi: posts big blind $0.10
*** HOLE CARDS ***
Hofnarren: folds 
SkyTaurus: folds 
Zimniy: folds 
zebaztravez: folds 
maxthebest99: raises $0.20 to $0.30
RoN Navi: folds 
Uncalled bet ($0.20) returned to maxthebest99
maxthebest99 collected $0.20 from pot
maxthebest99: doesn't show hand 
*** SUMMARY ***
Total pot $0.20 | Rake $0 
Seat 1: zebaztravez (button) folded before Flop (didn't bet)
Seat 2: maxthebest99 (small blind) collected ($0.20)
Seat 3: RoN Navi (big blind) folded before Flop
Seat 4: Hofnarren folded before Flop (didn't bet)
Seat 5: SkyTaurus folded before Flop (didn't bet)
Seat 6: Zimniy folded before Flop (didn't bet)



PokerStars Hand #222978866833:  Hold'em No Limit ($0.05/$0.10 USD) - 2021/01/23 18:58:49 ET
Table 'Demoulina III' 6-max Seat #2 is the button
Seat 1: zebaztravez ($13.20 in chips) 
Seat 2: maxthebest99 ($8.61 in chips) 
Seat 3: RoN Navi ($10.31 in chips) 
Seat 4: Hofnarren ($6.90 in chips) 
Seat 5: SkyTaurus ($10.91 in chips) 
Seat 6: Zimniy ($18.04 in chips) 
RoN Navi: posts small blind $0.05
Hofnarren: posts big blind $0.10
*** HOLE CARDS ***
SkyTaurus: folds 
Zimniy: folds 
zebaztravez: folds 
maxthebest99: calls $0.10
RoN Navi: folds 
Hofnarren: checks 
*** FLOP *** [7h 2h 5h]
Hofnarren: checks 
maxthebest99: bets $0.10
Hofnarren: folds 
Uncalled bet ($0.10) returned to maxthebest99
maxthebest99 collected $0.24 from pot
maxthebest99: doesn't show hand 
*** SUMMARY ***
Total pot $0.25 | Rake $0.01 
Board [7h 2h 5h]
Seat 1: zebaztravez folded before Flop (didn't bet)
Seat 2: maxthebest99 (button) collected ($0.24)
Seat 3: RoN Navi (small blind) folded before Flop
Seat 4: Hofnarren (big blind) folded on the Flop
Seat 5: SkyTaurus folded before Flop (didn't bet)
Seat 6: Zimniy folded before Flop (didn't bet)



PokerStars Hand #222978878147:  Hold'em No Limit ($0.05/$0.10 USD) - 2021/01/23 18:59:15 ET
Table 'Demoulina III' 6-max Seat #3 is the button
Seat 1: zebaztravez ($13.20 in chips) 
Seat 2: maxthebest99 ($8.75 in chips) 
Seat 3: RoN Navi ($10.26 in chips) 
Seat 4: Hofnarren ($6.80 in chips) 
Seat 5: SkyTaurus ($10.91 in chips) 
Seat 6: Zimniy ($18.04 in chips) 
Hofnarren: posts small blind $0.05
SkyTaurus: posts big blind $0.10
*** HOLE CARDS ***
Zimniy: folds 
zebaztravez: folds 
maxthebest99: folds 
RoN Navi: folds 
Hofnarren: calls $0.05
SkyTaurus: raises $0.22 to $0.32
Hofnarren: folds 
Uncalled bet ($0.22) returned to SkyTaurus
SkyTaurus collected $0.20 from pot
*** SUMMARY ***
Total pot $0.20 | Rake $0 
Seat 1: zebaztravez folded before Flop (didn't bet)
Seat 2: maxthebest99 folded before Flop (didn't bet)
Seat 3: RoN Navi (button) folded before Flop (didn't bet)
Seat 4: Hofnarren (small blind) folded before Flop
Seat 5: SkyTaurus (big blind) collected ($0.20)
Seat 6: Zimniy folded before Flop (didn't bet)



PokerStars Hand #222978887515:  Hold'em No Limit ($0.05/$0.10 USD) - 2021/01/23 18:59:36 ET
Table 'Demoulina III' 6-max Seat #4 is the button
Seat 1: zebaztravez ($13.20 in chips) 
Seat 2: maxthebest99 ($8.75 in chips) 
Seat 3: RoN Navi ($10.26 in chips) 
Seat 4: Hofnarren ($6.70 in chips) 
Seat 5: SkyTaurus ($11.01 in chips) 
Seat 6: Zimniy ($18.04 in chips) 
SkyTaurus: posts small blind $0.05
Zimniy: posts big blind $0.10
*** HOLE CARDS ***
zebaztravez: raises $0.20 to $0.30
maxthebest99: folds 
RoN Navi: folds 
Hofnarren: calls $0.30
SkyTaurus: folds 
Zimniy: folds 
*** FLOP *** [6s Jh 4c]
zebaztravez: bets $0.22
Hofnarren: raises $1.16 to $1.38
zebaztravez: folds 
Uncalled bet ($1.16) returned to Hofnarren
Hofnarren collected $1.14 from pot
Hofnarren: doesn't show hand 
*** SUMMARY ***
Total pot $1.19 | Rake $0.05 
Board [6s Jh 4c]
Seat 1: zebaztravez folded on the Flop
Seat 2: maxthebest99 folded before Flop (didn't bet)
Seat 3: RoN Navi folded before Flop (didn't bet)
Seat 4: Hofnarren (button) collected ($1.14)
Seat 5: SkyTaurus (small blind) folded before Flop
Seat 6: Zimniy (big blind) folded before Flop



PokerStars Hand #222978902810:  Hold'em No Limit ($0.05/$0.10 USD) - 2021/01/23 19:00:10 ET
Table 'Demoulina III' 6-max Seat #5 is the button
Seat 1: zebaztravez ($12.68 in chips) 
Seat 2: maxthebest99 ($8.75 in chips) 
Seat 3: RoN Navi ($10.26 in chips) 
Seat 4: Hofnarren ($7.32 in chips) 
Seat 5: SkyTaurus ($10.96 in chips) 
Seat 6: Zimniy ($17.94 in chips) 
Zimniy: posts small blind $0.05
zebaztravez: posts big blind $0.10
*** HOLE CARDS ***
maxthebest99: folds 
RoN Navi: folds 
Hofnarren has timed out
Hofnarren: folds 
SkyTaurus: folds 
Zimniy: folds 
Uncalled bet ($0.05) returned to zebaztravez
zebaztravez collected $0.10 from pot
zebaztravez: doesn't show hand 
*** SUMMARY ***
Total pot $0.10 | Rake $0 
Seat 1: zebaztravez (big blind) collected ($0.10)
Seat 2: maxthebest99 folded before Flop (didn't bet)
Seat 3: RoN Navi folded before Flop (didn't bet)
Seat 4: Hofnarren folded before Flop (didn't bet)
Seat 5: SkyTaurus (button) folded before Flop (didn't bet)
Seat 6: Zimniy (small blind) folded before Flop



PokerStars Hand #222978912729:  Hold'em No Limit ($0.05/$0.10 USD) - 2021/01/23 19:00:30 ET
Table 'Demoulina III' 6-max Seat #6 is the button
Seat 1: zebaztravez ($12.73 in chips) 
Seat 2: maxthebest99 ($8.75 in chips) 
Seat 3: RoN Navi ($10.26 in chips) 
Seat 5: SkyTaurus ($10.96 in chips) 
Seat 6: Zimniy ($17.89 in chips) 
zebaztravez: posts small blind $0.05
maxthebest99: posts big blind $0.10
*** HOLE CARDS ***
RoN Navi: folds 
SkyTaurus: folds 
Zimniy: folds 
zebaztravez: raises $0.20 to $0.30
maxthebest99: raises $0.30 to $0.60
zebaztravez: folds 
Uncalled bet ($0.30) returned to maxthebest99
maxthebest99 collected $0.60 from pot
maxthebest99: doesn't show hand 
*** SUMMARY ***
Total pot $0.60 | Rake $0 
Seat 1: zebaztravez (small blind) folded before Flop
Seat 2: maxthebest99 (big blind) collected ($0.60)
Seat 3: RoN Navi folded before Flop (didn't bet)
Seat 5: SkyTaurus folded before Flop (didn't bet)
Seat 6: Zimniy (button) folded before Flop (didn't bet)



PokerStars Hand #222978928992:  Hold'em No Limit ($0.05/$0.10 USD) - 2021/01/23 19:01:01 ET
Table 'Demoulina III' 6-max Seat #1 is the button
Seat 1: zebaztravez ($12.43 in chips) 
Seat 2: maxthebest99 ($9.05 in chips) 
Seat 3: RoN Navi ($10.26 in chips) 
Seat 4: Hofnarren ($7.32 in chips) 
Seat 5: SkyTaurus ($10.96 in chips) 
Seat 6: Zimniy ($17.89 in chips) 
maxthebest99: posts small blind $0.05
RoN Navi: posts big blind $0.10
*** HOLE CARDS ***
Hofnarren: calls $0.10
SkyTaurus: folds 
Zimniy: folds 
zebaztravez: raises $0.30 to $0.40
maxthebest99: folds 
RoN Navi: folds 
Hofnarren: folds 
Uncalled bet ($0.30) returned to zebaztravez
zebaztravez collected $0.35 from pot
zebaztravez: doesn't show hand 
*** SUMMARY ***
Total pot $0.35 | Rake $0 
Seat 1: zebaztravez (button) collected ($0.35)
Seat 2: maxthebest99 (small blind) folded before Flop
Seat 3: RoN Navi (big blind) folded before Flop
Seat 4: Hofnarren folded before Flop
Seat 5: SkyTaurus folded before Flop (didn't bet)
Seat 6: Zimniy folded before Flop (didn't bet)



PokerStars Hand #222978937500:  Hold'em No Limit ($0.05/$0.10 USD) - 2021/01/23 19:01:17 ET
Table 'Demoulina III' 6-max Seat #2 is the button
Seat 1: zebaztravez ($12.68 in chips) 
Seat 2: maxthebest99 ($9 in chips) 
Seat 3: RoN Navi ($10.16 in chips) 
Seat 4: Hofnarren ($7.22 in chips) 
Seat 5: SkyTaurus ($10.96 in chips) 
Seat 6: Zimniy ($17.89 in chips) 
RoN Navi: posts small blind $0.05
Hofnarren: posts big blind $0.10
*** HOLE CARDS ***
SkyTaurus: folds 
Zimniy: raises $0.20 to $0.30
zebaztravez: calls $0.30
maxthebest99: folds 
RoN Navi: raises $0.60 to $0.90
Hofnarren: folds 
Zimniy: calls $0.60
zebaztravez: calls $0.60
*** FLOP *** [7s 9h 8s]
RoN Navi: checks 
Zimniy: checks 
zebaztravez: bets $2
RoN Navi: folds 
Zimniy: folds 
Uncalled bet ($2) returned to zebaztravez
zebaztravez collected $2.67 from pot
zebaztravez: doesn't show hand 
*** SUMMARY ***
Total pot $2.80 | Rake $0.13 
Board [7s 9h 8s]
Seat 1: zebaztravez collected ($2.67)
Seat 2: maxthebest99 (button) folded before Flop (didn't bet)
Seat 3: RoN Navi (small blind) folded on the Flop
Seat 4: Hofnarren (big blind) folded before Flop
Seat 5: SkyTaurus folded before Flop (didn't bet)
Seat 6: Zimniy folded on the Flop



PokerStars Hand #222978972997:  Hold'em No Limit ($0.05/$0.10 USD) - 2021/01/23 19:02:19 ET
Table 'Demoulina III' 6-max Seat #3 is the button
Seat 1: zebaztravez ($14.45 in chips) 
Seat 2: maxthebest99 ($9 in chips) 
Seat 3: RoN Navi ($10 in chips) 
Seat 4: Hofnarren ($7.12 in chips) 
Seat 5: SkyTaurus ($10.96 in chips) 
Seat 6: Zimniy ($16.99 in chips) 
Hofnarren: posts small blind $0.05
SkyTaurus: posts big blind $0.10
*** HOLE CARDS ***
Zimniy: raises $0.15 to $0.25
zebaztravez: folds 
maxthebest99: folds 
RoN Navi: raises $0.50 to $0.75
Hofnarren: folds 
SkyTaurus: folds 
Zimniy: folds 
Uncalled bet ($0.50) returned to RoN Navi
RoN Navi collected $0.65 from pot
*** SUMMARY ***
Total pot $0.65 | Rake $0 
Seat 1: zebaztravez folded before Flop (didn't bet)
Seat 2: maxthebest99 folded before Flop (didn't bet)
Seat 3: RoN Navi (button) collected ($0.65)
Seat 4: Hofnarren (small blind) folded before Flop
Seat 5: SkyTaurus (big blind) folded before Flop
Seat 6: Zimniy folded before Flop



PokerStars Hand #222978984172:  Hold'em No Limit ($0.05/$0.10 USD) - 2021/01/23 19:02:38 ET
Table 'Demoulina III' 6-max Seat #4 is the button
Seat 1: zebaztravez ($14.45 in chips) 
Seat 2: maxthebest99 ($9 in chips) 
Seat 3: RoN Navi ($10.40 in chips) 
Seat 4: Hofnarren ($7.07 in chips) 
Seat 5: SkyTaurus ($10.86 in chips) 
SkyTaurus: posts small blind $0.05
Zimniy: is sitting out 
zebaztravez: posts big blind $0.10
*** HOLE CARDS ***
maxthebest99: folds 
RoN Navi: folds 
Hofnarren: folds 
SkyTaurus: raises $0.20 to $0.30
zebaztravez: calls $0.20
*** FLOP *** [9c 7d 8s]
Zimniy leaves the table
SkyTaurus: checks 
zebaztravez: checks 
*** TURN *** [9c 7d 8s] [Jd]
SkyTaurus: checks 
Freedom4all3 joins the table at seat #6 
zebaztravez: checks 
*** RIVER *** [9c 7d 8s Jd] [2s]
SkyTaurus: checks 
zebaztravez: checks 
*** SHOW DOWN ***
SkyTaurus: shows [As 7s] (a pair of Sevens)
zebaztravez: mucks hand 
SkyTaurus collected $0.57 from pot
*** SUMMARY ***
Total pot $0.60 | Rake $0.03 
Board [9c 7d 8s Jd 2s]
Seat 1: zebaztravez (big blind) mucked
Seat 2: maxthebest99 folded before Flop (didn't bet)
Seat 3: RoN Navi folded before Flop (didn't bet)
Seat 4: Hofnarren (button) folded before Flop (didn't bet)
Seat 5: SkyTaurus (small blind) showed [As 7s] and won ($0.57) with a pair of Sevens



PokerStars Hand #222979002227:  Hold'em No Limit ($0.05/$0.10 USD) - 2021/01/23 19:03:09 ET
Table 'Demoulina III' 6-max Seat #5 is the button
Seat 1: zebaztravez ($14.15 in chips) 
Seat 2: maxthebest99 ($9 in chips) 
Seat 3: RoN Navi ($10.40 in chips) 
Seat 4: Hofnarren ($7.07 in chips) 
Seat 5: SkyTaurus ($11.13 in chips) 
zebaztravez: posts small blind $0.05
maxthebest99: posts big blind $0.10
*** HOLE CARDS ***
RoN Navi: folds 
Hofnarren has timed out
Hofnarren: folds 
SkyTaurus: raises $0.15 to $0.25
zebaztravez: folds 
maxthebest99: folds 
Uncalled bet ($0.15) returned to SkyTaurus
SkyTaurus collected $0.25 from pot
*** SUMMARY ***
Total pot $0.25 | Rake $0 
Seat 1: zebaztravez (small blind) folded before Flop
Seat 2: maxthebest99 (big blind) folded before Flop
Seat 3: RoN Navi folded before Flop (didn't bet)
Seat 4: Hofnarren folded before Flop (didn't bet)
Seat 5: SkyTaurus (button) collected ($0.25)



PokerStars Hand #222979016418:  Hold'em No Limit ($0.05/$0.10 USD) - 2021/01/23 19:03:34 ET
Table 'Demoulina III' 6-max Seat #1 is the button
Seat 1: zebaztravez ($14.10 in chips) 
Seat 2: maxthebest99 ($8.90 in chips) 
Seat 3: RoN Navi ($10.40 in chips) 
Seat 5: SkyTaurus ($11.28 in chips) 
maxthebest99: posts small blind $0.05
RoN Navi: posts big blind $0.10
Freedom4all3: sits out 
*** HOLE CARDS ***
SkyTaurus: folds 
Hofnarren leaves the table
zebaztravez: raises $0.16 to $0.26
maxthebest99: folds 
RoN Navi: folds 
Uncalled bet ($0.16) returned to zebaztravez
zebaztravez collected $0.25 from pot
zebaztravez: doesn't show hand 
*** SUMMARY ***
Total pot $0.25 | Rake $0 
Seat 1: zebaztravez (button) collected ($0.25)
Seat 2: maxthebest99 (small blind) folded before Flop
Seat 3: RoN Navi (big blind) folded before Flop
Seat 5: SkyTaurus folded before Flop (didn't bet)



PokerStars Hand #222979030463:  Hold'em No Limit ($0.05/$0.10 USD) - 2021/01/23 19:03:58 ET
Table 'Demoulina III' 6-max Seat #2 is the button
Seat 1: zebaztravez ($14.25 in chips) 
Seat 2: maxthebest99 ($8.85 in chips) 
Seat 3: RoN Navi ($10.30 in chips) 
Seat 5: SkyTaurus ($11.28 in chips) 
RoN Navi: posts small blind $0.05
SkyTaurus: posts big blind $0.10
Freedom4all3: sits out 
*** HOLE CARDS ***
zebaztravez: folds 
zacoz joins the table at seat #4 
maxthebest99: raises $0.10 to $0.20
RoN Navi: folds 
SkyTaurus: folds 
Uncalled bet ($0.10) returned to maxthebest99
maxthebest99 collected $0.25 from pot
maxthebest99: doesn't show hand 
*** SUMMARY ***
Total pot $0.25 | Rake $0 
Seat 1: zebaztravez folded before Flop (didn't bet)
Seat 2: maxthebest99 (button) collected ($0.25)
Seat 3: RoN Navi (small blind) folded before Flop
Seat 5: SkyTaurus (big blind) folded before Flop



PokerStars Hand #222979040156:  Hold'em No Limit ($0.05/$0.10 USD) - 2021/01/23 19:04:15 ET
Table 'Demoulina III' 6-max Seat #3 is the button
Seat 1: zebaztravez ($14.25 in chips) 
Seat 2: maxthebest99 ($9 in chips) 
Seat 3: RoN Navi ($10.25 in chips) 
Seat 5: SkyTaurus ($11.18 in chips) 
Seat 6: Freedom4all3 ($10 in chips) 
SkyTaurus: posts small blind $0.05
Freedom4all3: posts big blind $0.10
*** HOLE CARDS ***
zebaztravez: folds 
maxthebest99: calls $0.10
RoN Navi: calls $0.10
SkyTaurus: folds 
Freedom4all3: checks 
*** FLOP *** [Ts 6s 5d]
Freedom4all3: bets $0.16
maxthebest99: folds 
RoN Navi: folds 
Uncalled bet ($0.16) returned to Freedom4all3
Freedom4all3 collected $0.33 from pot
Freedom4all3: doesn't show hand 
*** SUMMARY ***
Total pot $0.35 | Rake $0.02 
Board [Ts 6s 5d]
Seat 1: zebaztravez folded before Flop (didn't bet)
Seat 2: maxthebest99 folded on the Flop
Seat 3: RoN Navi (button) folded on the Flop
Seat 5: SkyTaurus (small blind) folded before Flop
Seat 6: Freedom4all3 (big blind) collected ($0.33)



PokerStars Hand #222979053968:  Hold'em No Limit ($0.05/$0.10 USD) - 2021/01/23 19:04:39 ET
Table 'Demoulina III' 6-max Seat #5 is the button
Seat 1: zebaztravez ($14.25 in chips) 
Seat 2: maxthebest99 ($8.90 in chips) 
Seat 3: RoN Navi ($10.15 in chips) 
Seat 5: SkyTaurus ($11.13 in chips) 
Seat 6: Freedom4all3 ($10.23 in chips) 
Freedom4all3: posts small blind $0.05
zebaztravez: posts big blind $0.10
zacoz: sits out 
*** HOLE CARDS ***
maxthebest99: folds 
RoN Navi: raises $0.15 to $0.25
SkyTaurus: raises $0.55 to $0.80
Freedom4all3: folds 
zebaztravez: folds 
RoN Navi: folds 
Uncalled bet ($0.55) returned to SkyTaurus
SkyTaurus collected $0.65 from pot
*** SUMMARY ***
Total pot $0.65 | Rake $0 
Seat 1: zebaztravez (big blind) folded before Flop
Seat 2: maxthebest99 folded before Flop (didn't bet)
Seat 3: RoN Navi folded before Flop
Seat 5: SkyTaurus (button) collected ($0.65)
Seat 6: Freedom4all3 (small blind) folded before Flop



PokerStars Hand #222979075026:  Hold'em No Limit ($0.05/$0.10 USD) - 2021/01/23 19:05:03 ET
Table 'Demoulina III' 6-max Seat #6 is the button
Seat 1: zebaztravez ($14.15 in chips) 
Seat 2: maxthebest99 ($8.90 in chips) 
Seat 3: RoN Navi ($10 in chips) 
Seat 5: SkyTaurus ($11.53 in chips) 
Seat 6: Freedom4all3 ($10.18 in chips) 
zebaztravez: posts small blind $0.05
maxthebest99: posts big blind $0.10
zacoz: sits out 
*** HOLE CARDS ***
RoN Navi: folds 
SkyTaurus: raises $0.20 to $0.30
Freedom4all3: folds 
zebaztravez: raises $0.70 to $1
maxthebest99: folds 
SkyTaurus: raises $1.35 to $2.35
zebaztravez: folds 
Uncalled bet ($1.35) returned to SkyTaurus
SkyTaurus collected $2.10 from pot
RoN Navi leaves the table
*** SUMMARY ***
Total pot $2.10 | Rake $0 
Seat 1: zebaztravez (small blind) folded before Flop
Seat 2: maxthebest99 (big blind) folded before Flop
Seat 3: RoN Navi folded before Flop (didn't bet)
Seat 5: SkyTaurus collected ($2.10)
Seat 6: Freedom4all3 (button) folded before Flop (didn't bet)



PokerStars Hand #222979089556:  Hold'em No Limit ($0.05/$0.10 USD) - 2021/01/23 19:05:27 ET
Table 'Demoulina III' 6-max Seat #1 is the button
Seat 1: zebaztravez ($13.15 in chips) 
Seat 2: maxthebest99 ($8.80 in chips) 
Seat 4: zacoz ($10 in chips) 
Seat 5: SkyTaurus ($12.63 in chips) 
Seat 6: Freedom4all3 ($10.18 in chips) 
maxthebest99: posts small blind $0.05
zacoz: posts big blind $0.10
*** HOLE CARDS ***
SkyTaurus: folds 
Freedom4all3: folds 
zebaztravez: raises $0.16 to $0.26
maxthebest99: folds 
barbos2 joins the table at seat #3 
zacoz: folds 
Uncalled bet ($0.16) returned to zebaztravez
zebaztravez collected $0.25 from pot
zebaztravez: doesn't show hand 
*** SUMMARY ***
Total pot $0.25 | Rake $0 
Seat 1: zebaztravez (button) collected ($0.25)
Seat 2: maxthebest99 (small blind) folded before Flop
Seat 4: zacoz (big blind) folded before Flop
Seat 5: SkyTaurus folded before Flop (didn't bet)
Seat 6: Freedom4all3 folded before Flop (didn't bet)



PokerStars Hand #222979100256:  Hold'em No Limit ($0.05/$0.10 USD) - 2021/01/23 19:05:46 ET
Table 'Demoulina III' 6-max Seat #2 is the button
Seat 1: zebaztravez ($13.30 in chips) 
Seat 2: maxthebest99 ($8.75 in chips) 
Seat 4: zacoz ($10 in chips) 
Seat 5: SkyTaurus ($12.63 in chips) 
Seat 6: Freedom4all3 ($10.18 in chips) 
zacoz: posts small blind $0.05
SkyTaurus: posts big blind $0.10
*** HOLE CARDS ***
Freedom4all3: folds 
zebaztravez: folds 
maxthebest99: calls $0.10
zacoz: calls $0.05
SkyTaurus: checks 
*** FLOP *** [Qc Ah 7d]
zacoz: checks 
SkyTaurus: checks 
maxthebest99: bets $0.20
zacoz: folds 
SkyTaurus: folds 
Uncalled bet ($0.20) returned to maxthebest99
maxthebest99 collected $0.29 from pot
maxthebest99: doesn't show hand 
*** SUMMARY ***
Total pot $0.30 | Rake $0.01 
Board [Qc Ah 7d]
Seat 1: zebaztravez folded before Flop (didn't bet)
Seat 2: maxthebest99 (button) collected ($0.29)
Seat 4: zacoz (small blind) folded on the Flop
Seat 5: SkyTaurus (big blind) folded on the Flop
Seat 6: Freedom4all3 folded before Flop (didn't bet)



PokerStars Hand #222979113422:  Hold'em No Limit ($0.05/$0.10 USD) - 2021/01/23 19:06:09 ET
Table 'Demoulina III' 6-max Seat #4 is the button
Seat 1: zebaztravez ($13.30 in chips) 
Seat 2: maxthebest99 ($8.94 in chips) 
Seat 4: zacoz ($10 in chips) 
Seat 5: SkyTaurus ($12.53 in chips) 
Seat 6: Freedom4all3 ($10.18 in chips) 
SkyTaurus: posts small blind $0.05
Freedom4all3: posts big blind $0.10
barbos2: sits out 
*** HOLE CARDS ***
zebaztravez: folds 
maxthebest99: raises $0.10 to $0.20
zacoz: raises $0.30 to $0.50
SkyTaurus: folds 
Freedom4all3: folds 
maxthebest99: calls $0.30
*** FLOP *** [3c Kd Ah]
maxthebest99: checks 
zacoz: bets $0.70
maxthebest99: folds 
Uncalled bet ($0.70) returned to zacoz
zacoz collected $1.10 from pot
zacoz: doesn't show hand 
*** SUMMARY ***
Total pot $1.15 | Rake $0.05 
Board [3c Kd Ah]
Seat 1: zebaztravez folded before Flop (didn't bet)
Seat 2: maxthebest99 folded on the Flop
Seat 4: zacoz (button) collected ($1.10)
Seat 5: SkyTaurus (small blind) folded before Flop
Seat 6: Freedom4all3 (big blind) folded before Flop



PokerStars Hand #222979130843:  Hold'em No Limit ($0.05/$0.10 USD) - 2021/01/23 19:06:38 ET
Table 'Demoulina III' 6-max Seat #5 is the button
Seat 1: zebaztravez ($13.30 in chips) 
Seat 2: maxthebest99 ($8.44 in chips) 
Seat 4: zacoz ($10.60 in chips) 
Seat 5: SkyTaurus ($12.48 in chips) 
Seat 6: Freedom4all3 ($10.08 in chips) 
Freedom4all3: posts small blind $0.05
zebaztravez: posts big blind $0.10
barbos2: sits out 
*** HOLE CARDS ***
maxthebest99: folds 
zacoz: folds 
SkyTaurus: raises $0.15 to $0.25
Freedom4all3: folds 
zebaztravez: folds 
Uncalled bet ($0.15) returned to SkyTaurus
SkyTaurus collected $0.25 from pot
*** SUMMARY ***
Total pot $0.25 | Rake $0 
Seat 1: zebaztravez (big blind) folded before Flop
Seat 2: maxthebest99 folded before Flop (didn't bet)
Seat 4: zacoz folded before Flop (didn't bet)
Seat 5: SkyTaurus (button) collected ($0.25)
Seat 6: Freedom4all3 (small blind) folded before Flop



PokerStars Hand #222979141887:  Hold'em No Limit ($0.05/$0.10 USD) - 2021/01/23 19:06:57 ET
Table 'Demoulina III' 6-max Seat #6 is the button
Seat 1: zebaztravez ($13.20 in chips) 
Seat 2: maxthebest99 ($8.44 in chips) 
Seat 4: zacoz ($10.60 in chips) 
Seat 5: SkyTaurus ($12.63 in chips) 
Seat 6: Freedom4all3 ($10.03 in chips) 
zebaztravez: posts small blind $0.05
maxthebest99: posts big blind $0.10
barbos2: sits out 
*** HOLE CARDS ***
zacoz: folds 
SkyTaurus: folds 
Freedom4all3: raises $0.20 to $0.30
zebaztravez: folds 
maxthebest99: folds 
Uncalled bet ($0.20) returned to Freedom4all3
Freedom4all3 collected $0.25 from pot
Freedom4all3: doesn't show hand 
*** SUMMARY ***
Total pot $0.25 | Rake $0 
Seat 1: zebaztravez (small blind) folded before Flop
Seat 2: maxthebest99 (big blind) folded before Flop
Seat 4: zacoz folded before Flop (didn't bet)
Seat 5: SkyTaurus folded before Flop (didn't bet)
Seat 6: Freedom4all3 (button) collected ($0.25)



PokerStars Hand #222979148764:  Hold'em No Limit ($0.05/$0.10 USD) - 2021/01/23 19:07:09 ET
Table 'Demoulina III' 6-max Seat #1 is the button
Seat 1: zebaztravez ($13.15 in chips) 
Seat 2: maxthebest99 ($8.34 in chips) 
Seat 3: barbos2 ($10 in chips) 
Seat 4: zacoz ($10.60 in chips) 
Seat 5: SkyTaurus ($12.63 in chips) 
Seat 6: Freedom4all3 ($10.18 in chips) 
maxthebest99: posts small blind $0.05
barbos2: posts big blind $0.10
*** HOLE CARDS ***
zacoz: folds 
SkyTaurus: raises $0.20 to $0.30
Freedom4all3: folds 
zebaztravez: folds 
maxthebest99: folds 
barbos2: folds 
Uncalled bet ($0.20) returned to SkyTaurus
SkyTaurus collected $0.25 from pot
*** SUMMARY ***
Total pot $0.25 | Rake $0 
Seat 1: zebaztravez (button) folded before Flop (didn't bet)
Seat 2: maxthebest99 (small blind) folded before Flop
Seat 3: barbos2 (big blind) folded before Flop
Seat 4: zacoz folded before Flop (didn't bet)
Seat 5: SkyTaurus collected ($0.25)
Seat 6: Freedom4all3 folded before Flop (didn't bet)



PokerStars Hand #222979171943:  Hold'em No Limit ($0.05/$0.10 USD) - 2021/01/23 19:07:34 ET
Table 'Demoulina III' 6-max Seat #2 is the button
Seat 1: zebaztravez ($13.15 in chips) 
Seat 2: maxthebest99 ($8.29 in chips) 
Seat 3: barbos2 ($10 in chips) 
Seat 5: SkyTaurus ($12.78 in chips) 
Seat 6: Freedom4all3 ($10.18 in chips) 
barbos2: posts small blind $0.05
zacoz: is sitting out 
SkyTaurus: posts big blind $0.10
*** HOLE CARDS ***
Freedom4all3: folds 
zebaztravez: folds 
maxthebest99: calls $0.10
barbos2: folds 
SkyTaurus: checks 
*** FLOP *** [6s Th Kc]
SkyTaurus: checks 
maxthebest99: bets $0.20
SkyTaurus: folds 
Uncalled bet ($0.20) returned to maxthebest99
maxthebest99 collected $0.24 from pot
maxthebest99: doesn't show hand 
*** SUMMARY ***
Total pot $0.25 | Rake $0.01 
Board [6s Th Kc]
Seat 1: zebaztravez folded before Flop (didn't bet)
Seat 2: maxthebest99 (button) collected ($0.24)
Seat 3: barbos2 (small blind) folded before Flop
Seat 5: SkyTaurus (big blind) folded on the Flop
Seat 6: Freedom4all3 folded before Flop (didn't bet)



PokerStars Hand #222979182317:  Hold'em No Limit ($0.05/$0.10 USD) - 2021/01/23 19:07:52 ET
Table 'Demoulina III' 6-max Seat #3 is the button
Seat 1: zebaztravez ($13.15 in chips) 
Seat 2: maxthebest99 ($8.43 in chips) 
Seat 3: barbos2 ($10 in chips) 
Seat 5: SkyTaurus ($12.68 in chips) 
Seat 6: Freedom4all3 ($10.18 in chips) 
SkyTaurus: posts small blind $0.05
Freedom4all3: posts big blind $0.10
*** HOLE CARDS ***
zebaztravez: folds 
maxthebest99: folds 
barbos2: raises $0.20 to $0.30
SkyTaurus: folds 
Freedom4all3: raises $0.65 to $0.95
zacoz leaves the table
barbos2: raises $1.55 to $2.50
Freedom4all3: folds 
Uncalled bet ($1.55) returned to barbos2
barbos2 collected $1.95 from pot
barbos2: doesn't show hand 
*** SUMMARY ***
Total pot $1.95 | Rake $0 
Seat 1: zebaztravez folded before Flop (didn't bet)
Seat 2: maxthebest99 folded before Flop (didn't bet)
Seat 3: barbos2 (button) collected ($1.95)
Seat 5: SkyTaurus (small blind) folded before Flop
Seat 6: Freedom4all3 (big blind) folded before Flop



PokerStars Hand #222979203697:  Hold'em No Limit ($0.05/$0.10 USD) - 2021/01/23 19:08:30 ET
Table 'Demoulina III' 6-max Seat #5 is the button
Seat 1: zebaztravez ($13.15 in chips) 
Seat 2: maxthebest99 ($8.43 in chips) 
Seat 3: barbos2 ($11 in chips) 
Seat 5: SkyTaurus ($12.63 in chips) 
Seat 6: Freedom4all3 ($9.23 in chips) 
Freedom4all3: posts small blind $0.05
zebaztravez: posts big blind $0.10
*** HOLE CARDS ***
maxthebest99: calls $0.10
barbos2: raises $0.20 to $0.30
SkyTaurus: folds 
Marauder777 joins the table at seat #4 
Freedom4all3: folds 
zebaztravez: folds 
maxthebest99: folds 
Uncalled bet ($0.20) returned to barbos2
barbos2 collected $0.35 from pot
barbos2: doesn't show hand 
*** SUMMARY ***
Total pot $0.35 | Rake $0 
Seat 1: zebaztravez (big blind) folded before Flop
Seat 2: maxthebest99 folded before Flop
Seat 3: barbos2 collected ($0.35)
Seat 5: SkyTaurus (button) folded before Flop (didn't bet)
Seat 6: Freedom4all3 (small blind) folded before Flop



PokerStars Hand #222979213480:  Hold'em No Limit ($0.05/$0.10 USD) - 2021/01/23 19:08:47 ET
Table 'Demoulina III' 6-max Seat #6 is the button
Seat 1: zebaztravez ($13.05 in chips) 
Seat 2: maxthebest99 ($8.33 in chips) 
Seat 3: barbos2 ($11.25 in chips) 
Seat 5: SkyTaurus ($12.63 in chips) 
Seat 6: Freedom4all3 ($9.95 in chips) 
zebaztravez: posts small blind $0.05
maxthebest99: posts big blind $0.10
Marauder777: sits out 
*** HOLE CARDS ***
barbos2: folds 
SkyTaurus: folds 
Freedom4all3: raises $0.20 to $0.30
zebaztravez: folds 
maxthebest99: folds 
Uncalled bet ($0.20) returned to Freedom4all3
Freedom4all3 collected $0.25 from pot
Freedom4all3: doesn't show hand 
*** SUMMARY ***
Total pot $0.25 | Rake $0 
Seat 1: zebaztravez (small blind) folded before Flop
Seat 2: maxthebest99 (big blind) folded before Flop
Seat 3: barbos2 folded before Flop (didn't bet)
Seat 5: SkyTaurus folded before Flop (didn't bet)
Seat 6: Freedom4all3 (button) collected ($0.25)



PokerStars Hand #222979222350:  Hold'em No Limit ($0.05/$0.10 USD) - 2021/01/23 19:09:03 ET
Table 'Demoulina III' 6-max Seat #1 is the button
Seat 1: zebaztravez ($13 in chips) 
Seat 2: maxthebest99 ($8.23 in chips) 
Seat 3: barbos2 ($11.25 in chips) 
Seat 5: SkyTaurus ($12.63 in chips) 
Seat 6: Freedom4all3 ($10.10 in chips) 
maxthebest99: posts small blind $0.05
barbos2: posts big blind $0.10
*** HOLE CARDS ***
SkyTaurus: folds 
Freedom4all3: folds 
zebaztravez: raises $0.16 to $0.26
maxthebest99: folds 
barbos2: calls $0.16
*** FLOP *** [3h 5c 4c]
barbos2: checks 
zebaztravez: checks 
*** TURN *** [3h 5c 4c] [4h]
barbos2: bets $0.54
zebaztravez: calls $0.54
*** RIVER *** [3h 5c 4c 4h] [8s]
barbos2: bets $1.10
zebaztravez: folds 
Uncalled bet ($1.10) returned to barbos2
barbos2 collected $1.58 from pot
barbos2: doesn't show hand 
*** SUMMARY ***
Total pot $1.65 | Rake $0.07 
Board [3h 5c 4c 4h 8s]
Seat 1: zebaztravez (button) folded on the River
Seat 2: maxthebest99 (small blind) folded before Flop
Seat 3: barbos2 (big blind) collected ($1.58)
Seat 5: SkyTaurus folded before Flop (didn't bet)
Seat 6: Freedom4all3 folded before Flop (didn't bet)



PokerStars Hand #222979254674:  Hold'em No Limit ($0.05/$0.10 USD) - 2021/01/23 19:10:01 ET
Table 'Demoulina III' 6-max Seat #2 is the button
Seat 1: zebaztravez ($12.20 in chips) 
Seat 2: maxthebest99 ($8.18 in chips) 
Seat 3: barbos2 ($12.03 in chips) 
Seat 5: SkyTaurus ($12.63 in chips) 
Seat 6: Freedom4all3 ($10.10 in chips) 
barbos2: posts small blind $0.05
SkyTaurus: posts big blind $0.10
*** HOLE CARDS ***
Freedom4all3: folds 
zebaztravez: raises $0.20 to $0.30
maxthebest99: folds 
barbos2: folds 
SkyTaurus: folds 
Uncalled bet ($0.20) returned to zebaztravez
zebaztravez collected $0.25 from pot
zebaztravez: doesn't show hand 
*** SUMMARY ***
Total pot $0.25 | Rake $0 
Seat 1: zebaztravez collected ($0.25)
Seat 2: maxthebest99 (button) folded before Flop (didn't bet)
Seat 3: barbos2 (small blind) folded before Flop
Seat 5: SkyTaurus (big blind) folded before Flop
Seat 6: Freedom4all3 folded before Flop (didn't bet)



PokerStars Hand #222979260398:  Hold'em No Limit ($0.05/$0.10 USD) - 2021/01/23 19:10:11 ET
Table 'Demoulina III' 6-max Seat #3 is the button
Seat 1: zebaztravez ($12.35 in chips) 
Seat 2: maxthebest99 ($8.18 in chips) 
Seat 3: barbos2 ($11.98 in chips) 
Seat 5: SkyTaurus ($12.53 in chips) 
Seat 6: Freedom4all3 ($10.10 in chips) 
SkyTaurus: posts small blind $0.05
Freedom4all3: posts big blind $0.10
*** HOLE CARDS ***
zebaztravez: folds 
maxthebest99: calls $0.10
barbos2: folds 
SkyTaurus: folds 
Freedom4all3: checks 
*** FLOP *** [9d Kc 9h]
Freedom4all3: checks 
maxthebest99: bets $0.20
Freedom4all3: folds 
Uncalled bet ($0.20) returned to maxthebest99
maxthebest99 collected $0.24 from pot
maxthebest99: doesn't show hand 
*** SUMMARY ***
Total pot $0.25 | Rake $0.01 
Board [9d Kc 9h]
Seat 1: zebaztravez folded before Flop (didn't bet)
Seat 2: maxthebest99 collected ($0.24)
Seat 3: barbos2 (button) folded before Flop (didn't bet)
Seat 5: SkyTaurus (small blind) folded before Flop
Seat 6: Freedom4all3 (big blind) folded on the Flop



PokerStars Hand #222979271505:  Hold'em No Limit ($0.05/$0.10 USD) - 2021/01/23 19:10:31 ET
Table 'Demoulina III' 6-max Seat #5 is the button
Seat 1: zebaztravez ($12.35 in chips) 
Seat 2: maxthebest99 ($8.32 in chips) 
Seat 3: barbos2 ($11.98 in chips) 
Seat 5: SkyTaurus ($12.48 in chips) 
Seat 6: Freedom4all3 ($10 in chips) 
Freedom4all3: posts small blind $0.05
zebaztravez: posts big blind $0.10
*** HOLE CARDS ***
maxthebest99: folds 
barbos2: raises $0.20 to $0.30
SkyTaurus: folds 
Freedom4all3: calls $0.25
zebaztravez: calls $0.20
*** FLOP *** [6h 2d Jd]
Freedom4all3: checks 
zebaztravez: checks 
barbos2: bets $0.28
Freedom4all3: calls $0.28
zebaztravez: folds 
*** TURN *** [6h 2d Jd] [5h]
Freedom4all3: checks 
barbos2: bets $1.70
Freedom4all3: folds 
Uncalled bet ($1.70) returned to barbos2
barbos2 collected $1.39 from pot
barbos2: doesn't show hand 
*** SUMMARY ***
Total pot $1.46 | Rake $0.07 
Board [6h 2d Jd 5h]
Seat 1: zebaztravez (big blind) folded on the Flop
Seat 2: maxthebest99 folded before Flop (didn't bet)
Seat 3: barbos2 collected ($1.39)
Seat 5: SkyTaurus (button) folded before Flop (didn't bet)
Seat 6: Freedom4all3 (small blind) folded on the Turn



PokerStars Hand #222979302388:  Hold'em No Limit ($0.05/$0.10 USD) - 2021/01/23 19:11:25 ET
Table 'Demoulina III' 6-max Seat #6 is the button
Seat 1: zebaztravez ($12.05 in chips) 
Seat 2: maxthebest99 ($8.32 in chips) 
Seat 3: barbos2 ($12.79 in chips) 
Seat 5: SkyTaurus ($12.48 in chips) 
Seat 6: Freedom4all3 ($9.42 in chips) 
zebaztravez: posts small blind $0.05
maxthebest99: posts big blind $0.10
*** HOLE CARDS ***
barbos2: raises $0.20 to $0.30
Marauder777 leaves the table
SkyTaurus: folds 
Freedom4all3: calls $0.30
zebaztravez: folds 
maxthebest99: calls $0.20
*** FLOP *** [3d 3s 6s]
maxthebest99: checks 
barbos2: checks 
Freedom4all3: checks 
*** TURN *** [3d 3s 6s] [2h]
maxthebest99: bets $0.50
barbos2: raises $0.50 to $1
Freedom4all3: folds 
maxthebest99: calls $0.50
*** RIVER *** [3d 3s 6s 2h] [Jh]
maxthebest99: checks 
barbos2: checks 
*** SHOW DOWN ***
maxthebest99: shows [5s 2s] (two pair, Threes and Deuces)
barbos2: shows [7h 7d] (two pair, Sevens and Threes)
nuikak joins the table at seat #4 
barbos2 collected $2.82 from pot
*** SUMMARY ***
Total pot $2.95 | Rake $0.13 
Board [3d 3s 6s 2h Jh]
Seat 1: zebaztravez (small blind) folded before Flop
Seat 2: maxthebest99 (big blind) showed [5s 2s] and lost with two pair, Threes and Deuces
Seat 3: barbos2 showed [7h 7d] and won ($2.82) with two pair, Sevens and Threes
Seat 5: SkyTaurus folded before Flop (didn't bet)
Seat 6: Freedom4all3 (button) folded on the Turn



PokerStars Hand #222979326109:  Hold'em No Limit ($0.05/$0.10 USD) - 2021/01/23 19:12:08 ET
Table 'Demoulina III' 6-max Seat #1 is the button
Seat 1: zebaztravez ($12 in chips) 
Seat 2: maxthebest99 ($7.02 in chips) 
Seat 3: barbos2 ($14.31 in chips) 
Seat 5: SkyTaurus ($12.48 in chips) 
Seat 6: Freedom4all3 ($9.70 in chips) 
maxthebest99: posts small blind $0.05
barbos2: posts big blind $0.10
nuikak: sits out 
*** HOLE CARDS ***
SkyTaurus: folds 
Freedom4all3: folds 
zebaztravez: raises $0.16 to $0.26
maxthebest99: calls $0.21
barbos2: folds 
*** FLOP *** [Kc 8s 3d]
maxthebest99: checks 
zebaztravez: checks 
*** TURN *** [Kc 8s 3d] [8c]
maxthebest99: bets $0.40
zebaztravez: calls $0.40
*** RIVER *** [Kc 8s 3d 8c] [Jd]
maxthebest99: bets $0.50
zebaztravez: calls $0.50
*** SHOW DOWN ***
maxthebest99: shows [6c Td] (a pair of Eights)
zebaztravez: shows [9s 9c] (two pair, Nines and Eights)
zebaztravez collected $2.31 from pot
*** SUMMARY ***
Total pot $2.42 | Rake $0.11 
Board [Kc 8s 3d 8c Jd]
Seat 1: zebaztravez (button) showed [9s 9c] and won ($2.31) with two pair, Nines and Eights
Seat 2: maxthebest99 (small blind) showed [6c Td] and lost with a pair of Eights
Seat 3: barbos2 (big blind) folded before Flop
Seat 5: SkyTaurus folded before Flop (didn't bet)
Seat 6: Freedom4all3 folded before Flop (didn't bet)



PokerStars Hand #222979352508:  Hold'em No Limit ($0.05/$0.10 USD) - 2021/01/23 19:12:55 ET
Table 'Demoulina III' 6-max Seat #2 is the button
Seat 1: zebaztravez ($13.15 in chips) 
Seat 2: maxthebest99 ($5.86 in chips) 
Seat 3: barbos2 ($14.21 in chips) 
Seat 4: nuikak ($10 in chips) 
Seat 5: SkyTaurus ($12.48 in chips) 
Seat 6: Freedom4all3 ($9.70 in chips) 
barbos2: posts small blind $0.05
nuikak: posts big blind $0.10
*** HOLE CARDS ***
SkyTaurus: folds 
Freedom4all3: folds 
zebaztravez: raises $0.20 to $0.30
maxthebest99: folds 
barbos2: folds 
nuikak: calls $0.20
*** FLOP *** [4c Ah Qc]
nuikak: checks 
zebaztravez: checks 
*** TURN *** [4c Ah Qc] [5h]
nuikak: bets $0.31
zebaztravez: calls $0.31
*** RIVER *** [4c Ah Qc 5h] [4d]
nuikak: checks 
zebaztravez: checks 
*** SHOW DOWN ***
nuikak: shows [Jd Qd] (two pair, Queens and Fours)
zebaztravez: shows [8h Qh] (two pair, Queens and Fours)
nuikak collected $0.61 from pot
zebaztravez collected $0.60 from pot
*** SUMMARY ***
Total pot $1.27 | Rake $0.06 
Board [4c Ah Qc 5h 4d]
Seat 1: zebaztravez showed [8h Qh] and won ($0.60) with two pair, Queens and Fours
Seat 2: maxthebest99 (button) folded before Flop (didn't bet)
Seat 3: barbos2 (small blind) folded before Flop
Seat 4: nuikak (big blind) showed [Jd Qd] and won ($0.61) with two pair, Queens and Fours
Seat 5: SkyTaurus folded before Flop (didn't bet)
Seat 6: Freedom4all3 folded before Flop (didn't bet)



PokerStars Hand #222979380182:  Hold'em No Limit ($0.05/$0.10 USD) - 2021/01/23 19:13:45 ET
Table 'Demoulina III' 6-max Seat #3 is the button
Seat 1: zebaztravez ($13.14 in chips) 
Seat 2: maxthebest99 ($5.86 in chips) 
Seat 3: barbos2 ($14.16 in chips) 
Seat 4: nuikak ($10 in chips) 
Seat 5: SkyTaurus ($12.48 in chips) 
Seat 6: Freedom4all3 ($10 in chips) 
nuikak: posts small blind $0.05
SkyTaurus: posts big blind $0.10
*** HOLE CARDS ***
Freedom4all3: folds 
zebaztravez: folds 
maxthebest99: folds 
barbos2: folds 
nuikak: folds 
Uncalled bet ($0.05) returned to SkyTaurus
SkyTaurus collected $0.10 from pot
*** SUMMARY ***
Total pot $0.10 | Rake $0 
Seat 1: zebaztravez folded before Flop (didn't bet)
Seat 2: maxthebest99 folded before Flop (didn't bet)
Seat 3: barbos2 (button) folded before Flop (didn't bet)
Seat 4: nuikak (small blind) folded before Flop
Seat 5: SkyTaurus (big blind) collected ($0.10)
Seat 6: Freedom4all3 folded before Flop (didn't bet)



PokerStars Hand #222979387528:  Hold'em No Limit ($0.05/$0.10 USD) - 2021/01/23 19:13:58 ET
Table 'Demoulina III' 6-max Seat #4 is the button
Seat 1: zebaztravez ($13.14 in chips) 
Seat 2: maxthebest99 ($5.86 in chips) 
Seat 3: barbos2 ($14.16 in chips) 
Seat 4: nuikak ($9.95 in chips) 
Seat 5: SkyTaurus ($12.53 in chips) 
Seat 6: Freedom4all3 ($10 in chips) 
SkyTaurus: posts small blind $0.05
Freedom4all3: posts big blind $0.10
*** HOLE CARDS ***
zebaztravez: folds 
maxthebest99: folds 
barbos2: folds 
nuikak: raises $0.20 to $0.30
SkyTaurus: folds 
Freedom4all3: folds 
Uncalled bet ($0.20) returned to nuikak
nuikak collected $0.25 from pot
nuikak: doesn't show hand 
*** SUMMARY ***
Total pot $0.25 | Rake $0 
Seat 1: zebaztravez folded before Flop (didn't bet)
Seat 2: maxthebest99 folded before Flop (didn't bet)
Seat 3: barbos2 folded before Flop (didn't bet)
Seat 4: nuikak (button) collected ($0.25)
Seat 5: SkyTaurus (small blind) folded before Flop
Seat 6: Freedom4all3 (big blind) folded before Flop



PokerStars Hand #222979399498:  Hold'em No Limit ($0.05/$0.10 USD) - 2021/01/23 19:14:20 ET
Table 'Demoulina III' 6-max Seat #5 is the button
Seat 1: zebaztravez ($13.14 in chips) 
Seat 2: maxthebest99 ($5.86 in chips) 
Seat 3: barbos2 ($14.16 in chips) 
Seat 4: nuikak ($10.10 in chips) 
Seat 5: SkyTaurus ($12.48 in chips) 
Seat 6: Freedom4all3 ($9.90 in chips) 
Freedom4all3: posts small blind $0.05
zebaztravez: posts big blind $0.10
*** HOLE CARDS ***
maxthebest99: folds 
barbos2: folds 
nuikak: raises $0.20 to $0.30
SkyTaurus: folds 
Freedom4all3: calls $0.25
zebaztravez: calls $0.20
*** FLOP *** [9h 5c 7s]
Freedom4all3: checks 
zebaztravez: checks 
nuikak: checks 
*** TURN *** [9h 5c 7s] [Ks]
Freedom4all3: checks 
zebaztravez: checks 
nuikak: checks 
*** RIVER *** [9h 5c 7s Ks] [9s]
Freedom4all3: checks 
zebaztravez: checks 
nuikak: checks 
*** SHOW DOWN ***
Freedom4all3: shows [Qc Th] (a pair of Nines)
zebaztravez: shows [Jd Qd] (a pair of Nines - King+Queen+Jack kicker)
nuikak: shows [4h 4c] (two pair, Nines and Fours)
nuikak collected $0.86 from pot
*** SUMMARY ***
Total pot $0.90 | Rake $0.04 
Board [9h 5c 7s Ks 9s]
Seat 1: zebaztravez (big blind) showed [Jd Qd] and lost with a pair of Nines
Seat 2: maxthebest99 folded before Flop (didn't bet)
Seat 3: barbos2 folded before Flop (didn't bet)
Seat 4: nuikak showed [4h 4c] and won ($0.86) with two pair, Nines and Fours
Seat 5: SkyTaurus (button) folded before Flop (didn't bet)
Seat 6: Freedom4all3 (small blind) showed [Qc Th] and lost with a pair of Nines



PokerStars Hand #222979431348:  Hold'em No Limit ($0.05/$0.10 USD) - 2021/01/23 19:15:18 ET
Table 'Demoulina III' 6-max Seat #6 is the button
Seat 1: zebaztravez ($12.84 in chips) 
Seat 2: maxthebest99 ($5.86 in chips) 
Seat 3: barbos2 ($14.16 in chips) 
Seat 4: nuikak ($10.66 in chips) 
Seat 5: SkyTaurus ($12.48 in chips) 
Seat 6: Freedom4all3 ($9.60 in chips) 
zebaztravez: posts small blind $0.05
maxthebest99: posts big blind $0.10
*** HOLE CARDS ***
barbos2: raises $0.15 to $0.25
nuikak: folds 
SkyTaurus: raises $0.55 to $0.80
Freedom4all3: folds 
zebaztravez: folds 
maxthebest99: folds 
barbos2: folds 
Uncalled bet ($0.55) returned to SkyTaurus
SkyTaurus collected $0.65 from pot
*** SUMMARY ***
Total pot $0.65 | Rake $0 
Seat 1: zebaztravez (small blind) folded before Flop
Seat 2: maxthebest99 (big blind) folded before Flop
Seat 3: barbos2 folded before Flop
Seat 4: nuikak folded before Flop (didn't bet)
Seat 5: SkyTaurus collected ($0.65)
Seat 6: Freedom4all3 (button) folded before Flop (didn't bet)



PokerStars Hand #222979444383:  Hold'em No Limit ($0.05/$0.10 USD) - 2021/01/23 19:15:42 ET
Table 'Demoulina III' 6-max Seat #1 is the button
Seat 1: zebaztravez ($12.79 in chips) 
Seat 2: maxthebest99 ($5.76 in chips) 
Seat 3: barbos2 ($13.91 in chips) 
Seat 4: nuikak ($10.66 in chips) 
Seat 5: SkyTaurus ($12.88 in chips) 
Seat 6: Freedom4all3 ($9.60 in chips) 
maxthebest99: posts small blind $0.05
barbos2: posts big blind $0.10
*** HOLE CARDS ***
nuikak: folds 
SkyTaurus: raises $0.20 to $0.30
Freedom4all3: folds 
zebaztravez: folds 
maxthebest99: folds 
barbos2: folds 
Uncalled bet ($0.20) returned to SkyTaurus
SkyTaurus collected $0.25 from pot
*** SUMMARY ***
Total pot $0.25 | Rake $0 
Seat 1: zebaztravez (button) folded before Flop (didn't bet)
Seat 2: maxthebest99 (small blind) folded before Flop
Seat 3: barbos2 (big blind) folded before Flop
Seat 4: nuikak folded before Flop (didn't bet)
Seat 5: SkyTaurus collected ($0.25)
Seat 6: Freedom4all3 folded before Flop (didn't bet)



PokerStars Hand #222979456633:  Hold'em No Limit ($0.05/$0.10 USD) - 2021/01/23 19:16:04 ET
Table 'Demoulina III' 6-max Seat #2 is the button
Seat 1: zebaztravez ($12.79 in chips) 
Seat 2: maxthebest99 ($5.71 in chips) 
Seat 3: barbos2 ($13.81 in chips) 
Seat 4: nuikak ($10.66 in chips) 
Seat 5: SkyTaurus ($13.03 in chips) 
Seat 6: Freedom4all3 ($9.60 in chips) 
barbos2: posts small blind $0.05
nuikak: posts big blind $0.10
*** HOLE CARDS ***
SkyTaurus: folds 
Freedom4all3: folds 
zebaztravez: folds 
maxthebest99: raises $0.10 to $0.20
barbos2: folds 
nuikak: folds 
Uncalled bet ($0.10) returned to maxthebest99
maxthebest99 collected $0.25 from pot
maxthebest99: doesn't show hand 
*** SUMMARY ***
Total pot $0.25 | Rake $0 
Seat 1: zebaztravez folded before Flop (didn't bet)
Seat 2: maxthebest99 (button) collected ($0.25)
Seat 3: barbos2 (small blind) folded before Flop
Seat 4: nuikak (big blind) folded before Flop
Seat 5: SkyTaurus folded before Flop (didn't bet)
Seat 6: Freedom4all3 folded before Flop (didn't bet)



PokerStars Hand #222979470025:  Hold'em No Limit ($0.05/$0.10 USD) - 2021/01/23 19:16:28 ET
Table 'Demoulina III' 6-max Seat #3 is the button
Seat 1: zebaztravez ($12.79 in chips) 
Seat 2: maxthebest99 ($5.86 in chips) 
Seat 3: barbos2 ($13.76 in chips) 
Seat 4: nuikak ($10.56 in chips) 
Seat 5: SkyTaurus ($13.03 in chips) 
Seat 6: Freedom4all3 ($9.60 in chips) 
nuikak: posts small blind $0.05
SkyTaurus: posts big blind $0.10
*** HOLE CARDS ***
Freedom4all3: folds 
zebaztravez: folds 
maxthebest99: folds 
barbos2: raises $0.20 to $0.30
nuikak: folds 
SkyTaurus: raises $1 to $1.30
barbos2: folds 
Uncalled bet ($1) returned to SkyTaurus
SkyTaurus collected $0.65 from pot
*** SUMMARY ***
Total pot $0.65 | Rake $0 
Seat 1: zebaztravez folded before Flop (didn't bet)
Seat 2: maxthebest99 folded before Flop (didn't bet)
Seat 3: barbos2 (button) folded before Flop
Seat 4: nuikak (small blind) folded before Flop
Seat 5: SkyTaurus (big blind) collected ($0.65)
Seat 6: Freedom4all3 folded before Flop (didn't bet)



PokerStars Hand #222979484919:  Hold'em No Limit ($0.05/$0.10 USD) - 2021/01/23 19:16:56 ET
Table 'Demoulina III' 6-max Seat #4 is the button
Seat 1: zebaztravez ($12.79 in chips) 
Seat 2: maxthebest99 ($5.86 in chips) 
Seat 3: barbos2 ($13.46 in chips) 
Seat 4: nuikak ($10.51 in chips) 
Seat 5: SkyTaurus ($13.38 in chips) 
Seat 6: Freedom4all3 ($10 in chips) 
SkyTaurus: posts small blind $0.05
Freedom4all3: posts big blind $0.10
*** HOLE CARDS ***
zebaztravez: folds 
maxthebest99: calls $0.10
barbos2: folds 
nuikak: folds 
SkyTaurus: raises $0.50 to $0.60
Freedom4all3: folds 
maxthebest99: folds 
Uncalled bet ($0.50) returned to SkyTaurus
SkyTaurus collected $0.30 from pot
*** SUMMARY ***
Total pot $0.30 | Rake $0 
Seat 1: zebaztravez folded before Flop (didn't bet)
Seat 2: maxthebest99 folded before Flop
Seat 3: barbos2 folded before Flop (didn't bet)
Seat 4: nuikak (button) folded before Flop (didn't bet)
Seat 5: SkyTaurus (small blind) collected ($0.30)
Seat 6: Freedom4all3 (big blind) folded before Flop



PokerStars Hand #222979493971:  Hold'em No Limit ($0.05/$0.10 USD) - 2021/01/23 19:17:12 ET
Table 'Demoulina III' 6-max Seat #5 is the button
Seat 1: zebaztravez ($12.79 in chips) 
Seat 2: maxthebest99 ($5.76 in chips) 
Seat 3: barbos2 ($13.46 in chips) 
Seat 4: nuikak ($10.51 in chips) 
Seat 5: SkyTaurus ($13.58 in chips) 
Seat 6: Freedom4all3 ($9.90 in chips) 
Freedom4all3: posts small blind $0.05
zebaztravez: posts big blind $0.10
*** HOLE CARDS ***
maxthebest99: folds 
barbos2: folds 
nuikak: folds 
SkyTaurus: folds 
Freedom4all3: raises $0.20 to $0.30
zebaztravez: folds 
Uncalled bet ($0.20) returned to Freedom4all3
Freedom4all3 collected $0.20 from pot
Freedom4all3: doesn't show hand 
*** SUMMARY ***
Total pot $0.20 | Rake $0 
Seat 1: zebaztravez (big blind) folded before Flop
Seat 2: maxthebest99 folded before Flop (didn't bet)
Seat 3: barbos2 folded before Flop (didn't bet)
Seat 4: nuikak folded before Flop (didn't bet)
Seat 5: SkyTaurus (button) folded before Flop (didn't bet)
Seat 6: Freedom4all3 (small blind) collected ($0.20)



PokerStars Hand #222979505145:  Hold'em No Limit ($0.05/$0.10 USD) - 2021/01/23 19:17:33 ET
Table 'Demoulina III' 6-max Seat #6 is the button
Seat 1: zebaztravez ($12.69 in chips) 
Seat 2: maxthebest99 ($5.76 in chips) 
Seat 3: barbos2 ($13.46 in chips) 
Seat 4: nuikak ($10.51 in chips) 
Seat 5: SkyTaurus ($13.58 in chips) 
Seat 6: Freedom4all3 ($10 in chips) 
zebaztravez: posts small blind $0.05
maxthebest99: posts big blind $0.10
*** HOLE CARDS ***
barbos2: folds 
nuikak: raises $0.20 to $0.30
SkyTaurus: folds 
Freedom4all3: folds 
zebaztravez: folds 
maxthebest99: folds 
Uncalled bet ($0.20) returned to nuikak
nuikak collected $0.25 from pot
nuikak: doesn't show hand 
*** SUMMARY ***
Total pot $0.25 | Rake $0 
Seat 1: zebaztravez (small blind) folded before Flop
Seat 2: maxthebest99 (big blind) folded before Flop
Seat 3: barbos2 folded before Flop (didn't bet)
Seat 4: nuikak collected ($0.25)
Seat 5: SkyTaurus folded before Flop (didn't bet)
Seat 6: Freedom4all3 (button) folded before Flop (didn't bet)



PokerStars Hand #222979513922:  Hold'em No Limit ($0.05/$0.10 USD) - 2021/01/23 19:17:49 ET
Table 'Demoulina III' 6-max Seat #1 is the button
Seat 1: zebaztravez ($12.64 in chips) 
Seat 2: maxthebest99 ($5.66 in chips) 
Seat 3: barbos2 ($13.46 in chips) 
Seat 4: nuikak ($10.66 in chips) 
Seat 5: SkyTaurus ($13.58 in chips) 
Seat 6: Freedom4all3 ($10 in chips) 
maxthebest99: posts small blind $0.05
barbos2: posts big blind $0.10
*** HOLE CARDS ***
nuikak: folds 
SkyTaurus: folds 
Freedom4all3: raises $0.20 to $0.30
zebaztravez: folds 
maxthebest99: calls $0.25
barbos2: folds 
*** FLOP *** [5h 4s 4h]
maxthebest99: bets $0.30
Freedom4all3: calls $0.30
*** TURN *** [5h 4s 4h] [2h]
maxthebest99: bets $0.30
Freedom4all3: calls $0.30
*** RIVER *** [5h 4s 4h 2h] [Kd]
maxthebest99: bets $0.50
Freedom4all3: calls $0.50
*** SHOW DOWN ***
maxthebest99: shows [5s Ks] (two pair, Kings and Fives)
Freedom4all3: mucks hand 
maxthebest99 collected $2.77 from pot
*** SUMMARY ***
Total pot $2.90 | Rake $0.13 
Board [5h 4s 4h 2h Kd]
Seat 1: zebaztravez (button) folded before Flop (didn't bet)
Seat 2: maxthebest99 (small blind) showed [5s Ks] and won ($2.77) with two pair, Kings and Fives
Seat 3: barbos2 (big blind) folded before Flop
Seat 4: nuikak folded before Flop (didn't bet)
Seat 5: SkyTaurus folded before Flop (didn't bet)
Seat 6: Freedom4all3 mucked



PokerStars Hand #222979707183:  Hold'em No Limit ($0.05/$0.10 USD) - 2021/01/23 19:23:50 ET
Table 'Demoulina III' 6-max Seat #3 is the button
Seat 1: zebaztravez ($14.07 in chips) 
Seat 2: maxthebest99 ($6.67 in chips) 
Seat 3: barbos2 ($13.01 in chips) 
Seat 4: nuikak ($10.26 in chips) 
Seat 5: SkyTaurus ($11.19 in chips) 
Seat 6: Freedom4all3 ($11.70 in chips) 
nuikak: posts small blind $0.05
SkyTaurus: posts big blind $0.10
*** HOLE CARDS ***
Freedom4all3: folds 
zebaztravez: folds 
maxthebest99: raises $0.20 to $0.30
barbos2: folds 
nuikak: folds 
SkyTaurus: raises $0.90 to $1.20
maxthebest99: calls $0.90
*** FLOP *** [4h 8h 7s]
SkyTaurus: bets $1.29
maxthebest99: calls $1.29
*** TURN *** [4h 8h 7s] [6c]
SkyTaurus: bets $7.30
maxthebest99: calls $4.18 and is all-in
Uncalled bet ($3.12) returned to SkyTaurus
*** RIVER *** [4h 8h 7s 6c] [Js]
*** SHOW DOWN ***
SkyTaurus: shows [Ad As] (a pair of Aces)
maxthebest99: shows [Th Td] (a pair of Tens)
SkyTaurus collected $12.79 from pot
maxthebest99 cashed out the hand for $2.30 | Cash Out Fee $0.02
*** SUMMARY ***
Total pot $13.39 | Rake $0.60 
Board [4h 8h 7s 6c Js]
Seat 1: zebaztravez folded before Flop (didn't bet)
Seat 2: maxthebest99 showed [Th Td] and lost with a pair of Tens (cashed out).
Seat 3: barbos2 (button) folded before Flop (didn't bet)
Seat 4: nuikak (small blind) folded before Flop
Seat 5: SkyTaurus (big blind) showed [Ad As] and won ($12.79) with a pair of Aces
Seat 6: Freedom4all3 folded before Flop (didn't bet)



PokerStars Hand #222979745731:  Hold'em No Limit ($0.05/$0.10 USD) - 2021/01/23 19:25:03 ET
Table 'Demoulina III' 6-max Seat #4 is the button
Seat 1: zebaztravez ($14.07 in chips) 
Seat 2: maxthebest99 ($2.30 in chips) 
Seat 3: barbos2 ($13.01 in chips) 
Seat 4: nuikak ($10.21 in chips) 
Seat 5: SkyTaurus ($17.31 in chips) 
Seat 6: Freedom4all3 ($11.70 in chips) 
SkyTaurus: posts small blind $0.05
Freedom4all3: posts big blind $0.10
*** HOLE CARDS ***
zebaztravez: folds 
maxthebest99: calls $0.10
barbos2: folds 
nuikak: folds 
SkyTaurus: folds 
Freedom4all3: checks 
*** FLOP *** [3c 3h 9c]
Freedom4all3: bets $0.12
maxthebest99: folds 
Uncalled bet ($0.12) returned to Freedom4all3
Freedom4all3 collected $0.24 from pot
Freedom4all3: doesn't show hand 
*** SUMMARY ***
Total pot $0.25 | Rake $0.01 
Board [3c 3h 9c]
Seat 1: zebaztravez folded before Flop (didn't bet)
Seat 2: maxthebest99 folded on the Flop
Seat 3: barbos2 folded before Flop (didn't bet)
Seat 4: nuikak (button) folded before Flop (didn't bet)
Seat 5: SkyTaurus (small blind) folded before Flop
Seat 6: Freedom4all3 (big blind) collected ($0.24)



PokerStars Hand #222979756615:  Hold'em No Limit ($0.05/$0.10 USD) - 2021/01/23 19:25:23 ET
Table 'Demoulina III' 6-max Seat #5 is the button
Seat 1: zebaztravez ($14.07 in chips) 
Seat 2: maxthebest99 ($2.20 in chips) 
Seat 3: barbos2 ($13.01 in chips) 
Seat 4: nuikak ($10.21 in chips) 
Seat 5: SkyTaurus ($17.26 in chips) 
Seat 6: Freedom4all3 ($11.84 in chips) 
Freedom4all3: posts small blind $0.05
zebaztravez: posts big blind $0.10
*** HOLE CARDS ***
maxthebest99: folds 
barbos2: raises $0.15 to $0.25
nuikak: folds 
SkyTaurus: folds 
Freedom4all3: folds 
zebaztravez: folds 
Uncalled bet ($0.15) returned to barbos2
barbos2 collected $0.25 from pot
barbos2: doesn't show hand 
*** SUMMARY ***
Total pot $0.25 | Rake $0 
Seat 1: zebaztravez (big blind) folded before Flop
Seat 2: maxthebest99 folded before Flop (didn't bet)
Seat 3: barbos2 collected ($0.25)
Seat 4: nuikak folded before Flop (didn't bet)
Seat 5: SkyTaurus (button) folded before Flop (didn't bet)
Seat 6: Freedom4all3 (small blind) folded before Flop



PokerStars Hand #222979765406:  Hold'em No Limit ($0.05/$0.10 USD) - 2021/01/23 19:25:40 ET
Table 'Demoulina III' 6-max Seat #6 is the button
Seat 1: zebaztravez ($13.97 in chips) 
Seat 2: maxthebest99 ($2.20 in chips) 
Seat 3: barbos2 ($13.16 in chips) 
Seat 4: nuikak ($10.21 in chips) 
Seat 5: SkyTaurus ($17.26 in chips) 
Seat 6: Freedom4all3 ($11.79 in chips) 
zebaztravez: posts small blind $0.05
maxthebest99: posts big blind $0.10
*** HOLE CARDS ***
barbos2: raises $0.20 to $0.30
nuikak: folds 
SkyTaurus: folds 
Freedom4all3: folds 
zebaztravez: folds 
maxthebest99: folds 
Uncalled bet ($0.20) returned to barbos2
barbos2 collected $0.25 from pot
barbos2: doesn't show hand 
*** SUMMARY ***
Total pot $0.25 | Rake $0 
Seat 1: zebaztravez (small blind) folded before Flop
Seat 2: maxthebest99 (big blind) folded before Flop
Seat 3: barbos2 collected ($0.25)
Seat 4: nuikak folded before Flop (didn't bet)
Seat 5: SkyTaurus folded before Flop (didn't bet)
Seat 6: Freedom4all3 (button) folded before Flop (didn't bet)



PokerStars Hand #222979773791:  Hold'em No Limit ($0.05/$0.10 USD) - 2021/01/23 19:25:56 ET
Table 'Demoulina III' 6-max Seat #1 is the button
Seat 1: zebaztravez ($13.92 in chips) 
Seat 2: maxthebest99 ($2.10 in chips) 
Seat 3: barbos2 ($13.31 in chips) 
Seat 4: nuikak ($10.21 in chips) 
Seat 5: SkyTaurus ($17.26 in chips) 
Seat 6: Freedom4all3 ($11.79 in chips) 
maxthebest99: posts small blind $0.05
barbos2: posts big blind $0.10
*** HOLE CARDS ***
nuikak: folds 
SkyTaurus: raises $0.20 to $0.30
Freedom4all3: calls $0.30
zebaztravez: folds 
maxthebest99: folds 
barbos2: folds 
*** FLOP *** [As Kc 2s]
SkyTaurus: bets $0.40
Freedom4all3: calls $0.40
*** TURN *** [As Kc 2s] [Ks]
SkyTaurus: checks 
Freedom4all3: checks 
*** RIVER *** [As Kc 2s Ks] [4d]
SkyTaurus: bets $0.65
Freedom4all3: calls $0.65
*** SHOW DOWN ***
SkyTaurus: shows [Jd Ac] (two pair, Aces and Kings)
Freedom4all3: shows [Ts 8s] (a flush, Ace high)
Freedom4all3 collected $2.72 from pot
*** SUMMARY ***
Total pot $2.85 | Rake $0.13 
Board [As Kc 2s Ks 4d]
Seat 1: zebaztravez (button) folded before Flop (didn't bet)
Seat 2: maxthebest99 (small blind) folded before Flop
Seat 3: barbos2 (big blind) folded before Flop
Seat 4: nuikak folded before Flop (didn't bet)
Seat 5: SkyTaurus showed [Jd Ac] and lost with two pair, Aces and Kings
Seat 6: Freedom4all3 showed [Ts 8s] and won ($2.72) with a flush, Ace high



PokerStars Hand #222979801404:  Hold'em No Limit ($0.05/$0.10 USD) - 2021/01/23 19:26:48 ET
Table 'Demoulina III' 6-max Seat #2 is the button
Seat 1: zebaztravez ($13.92 in chips) 
Seat 2: maxthebest99 ($2.05 in chips) 
Seat 3: barbos2 ($13.21 in chips) 
Seat 4: nuikak ($10.21 in chips) 
Seat 5: SkyTaurus ($15.91 in chips) 
Seat 6: Freedom4all3 ($13.16 in chips) 
barbos2: posts small blind $0.05
nuikak: posts big blind $0.10
*** HOLE CARDS ***
SkyTaurus: folds 
Freedom4all3: folds 
zebaztravez: folds 
maxthebest99: folds 
barbos2: raises $0.15 to $0.25
nuikak: folds 
Uncalled bet ($0.15) returned to barbos2
barbos2 collected $0.20 from pot
barbos2: doesn't show hand 
*** SUMMARY ***
Total pot $0.20 | Rake $0 
Seat 1: zebaztravez folded before Flop (didn't bet)
Seat 2: maxthebest99 (button) folded before Flop (didn't bet)
Seat 3: barbos2 (small blind) collected ($0.20)
Seat 4: nuikak (big blind) folded before Flop
Seat 5: SkyTaurus folded before Flop (didn't bet)
Seat 6: Freedom4all3 folded before Flop (didn't bet)



PokerStars Hand #222979816866:  Hold'em No Limit ($0.05/$0.10 USD) - 2021/01/23 19:27:13 ET
Table 'Demoulina III' 6-max Seat #3 is the button
Seat 1: zebaztravez ($13.92 in chips) 
Seat 2: maxthebest99 ($2.05 in chips) 
Seat 3: barbos2 ($13.31 in chips) 
Seat 4: nuikak ($10.11 in chips) 
Seat 5: SkyTaurus ($15.91 in chips) 
Seat 6: Freedom4all3 ($13.16 in chips) 
nuikak: posts small blind $0.05
SkyTaurus: posts big blind $0.10
*** HOLE CARDS ***
Freedom4all3: folds 
zebaztravez: folds 
maxthebest99: raises $0.20 to $0.30
barbos2: folds 
nuikak: folds 
SkyTaurus: folds 
Uncalled bet ($0.20) returned to maxthebest99
maxthebest99 collected $0.25 from pot
maxthebest99: doesn't show hand 
*** SUMMARY ***
Total pot $0.25 | Rake $0 
Seat 1: zebaztravez folded before Flop (didn't bet)
Seat 2: maxthebest99 collected ($0.25)
Seat 3: barbos2 (button) folded before Flop (didn't bet)
Seat 4: nuikak (small blind) folded before Flop
Seat 5: SkyTaurus (big blind) folded before Flop
Seat 6: Freedom4all3 folded before Flop (didn't bet)



PokerStars Hand #222979823496:  Hold'em No Limit ($0.05/$0.10 USD) - 2021/01/23 19:27:25 ET
Table 'Demoulina III' 6-max Seat #4 is the button
Seat 1: zebaztravez ($13.92 in chips) 
Seat 2: maxthebest99 ($2.20 in chips) 
Seat 3: barbos2 ($13.31 in chips) 
Seat 4: nuikak ($10.06 in chips) 
Seat 5: SkyTaurus ($15.81 in chips) 
Seat 6: Freedom4all3 ($13.16 in chips) 
SkyTaurus: posts small blind $0.05
Freedom4all3: posts big blind $0.10
*** HOLE CARDS ***
zebaztravez: folds 
maxthebest99: folds 
barbos2: folds 
nuikak: folds 
SkyTaurus: folds 
Uncalled bet ($0.05) returned to Freedom4all3
Freedom4all3 collected $0.10 from pot
Freedom4all3: doesn't show hand 
*** SUMMARY ***
Total pot $0.10 | Rake $0 
Seat 1: zebaztravez folded before Flop (didn't bet)
Seat 2: maxthebest99 folded before Flop (didn't bet)
Seat 3: barbos2 folded before Flop (didn't bet)
Seat 4: nuikak (button) folded before Flop (didn't bet)
Seat 5: SkyTaurus (small blind) folded before Flop
Seat 6: Freedom4all3 (big blind) collected ($0.10)



PokerStars Hand #222979831080:  Hold'em No Limit ($0.05/$0.10 USD) - 2021/01/23 19:27:40 ET
Table 'Demoulina III' 6-max Seat #5 is the button
Seat 1: zebaztravez ($13.92 in chips) 
Seat 2: maxthebest99 ($2.20 in chips) 
Seat 3: barbos2 ($13.31 in chips) 
Seat 4: nuikak ($10.06 in chips) 
Seat 5: SkyTaurus ($15.76 in chips) 
Seat 6: Freedom4all3 ($13.21 in chips) 
Freedom4all3: posts small blind $0.05
zebaztravez: posts big blind $0.10
*** HOLE CARDS ***
maxthebest99: calls $0.10
barbos2: folds 
nuikak: calls $0.10
SkyTaurus: folds 
Freedom4all3: folds 
zebaztravez: checks 
*** FLOP *** [Td Jh 5d]
zebaztravez: checks 
maxthebest99: bets $0.20
nuikak: folds 
zebaztravez: folds 
Uncalled bet ($0.20) returned to maxthebest99
maxthebest99 collected $0.33 from pot
maxthebest99: doesn't show hand 
*** SUMMARY ***
Total pot $0.35 | Rake $0.02 
Board [Td Jh 5d]
Seat 1: zebaztravez (big blind) folded on the Flop
Seat 2: maxthebest99 collected ($0.33)
Seat 3: barbos2 folded before Flop (didn't bet)
Seat 4: nuikak folded on the Flop
Seat 5: SkyTaurus (button) folded before Flop (didn't bet)
Seat 6: Freedom4all3 (small blind) folded before Flop



PokerStars Hand #222979841211:  Hold'em No Limit ($0.05/$0.10 USD) - 2021/01/23 19:27:59 ET
Table 'Demoulina III' 6-max Seat #6 is the button
Seat 1: zebaztravez ($13.82 in chips) 
Seat 2: maxthebest99 ($2.43 in chips) 
Seat 3: barbos2 ($13.31 in chips) 
Seat 4: nuikak ($9.96 in chips) 
Seat 5: SkyTaurus ($15.76 in chips) 
Seat 6: Freedom4all3 ($13.16 in chips) 
zebaztravez: posts small blind $0.05
maxthebest99: posts big blind $0.10
*** HOLE CARDS ***
barbos2: raises $0.20 to $0.30
nuikak: folds 
SkyTaurus: folds 
Freedom4all3: folds 
zebaztravez: folds 
maxthebest99: calls $0.20
*** FLOP *** [8d Ks 3d]
maxthebest99: bets $0.30
barbos2: calls $0.30
*** TURN *** [8d Ks 3d] [2d]
maxthebest99: bets $0.60
barbos2: calls $0.60
*** RIVER *** [8d Ks 3d 2d] [Qh]
maxthebest99: bets $1.23 and is all-in
barbos2: calls $1.23
*** SHOW DOWN ***
maxthebest99: shows [Kh Jd] (a pair of Kings)
barbos2: shows [Ad 5d] (a flush, Ace high)
barbos2 collected $4.69 from pot
*** SUMMARY ***
Total pot $4.91 | Rake $0.22 
Board [8d Ks 3d 2d Qh]
Seat 1: zebaztravez (small blind) folded before Flop
Seat 2: maxthebest99 (big blind) showed [Kh Jd] and lost with a pair of Kings
Seat 3: barbos2 showed [Ad 5d] and won ($4.69) with a flush, Ace high
Seat 4: nuikak folded before Flop (didn't bet)
Seat 5: SkyTaurus folded before Flop (didn't bet)
Seat 6: Freedom4all3 (button) folded before Flop (didn't bet)



PokerStars Hand #222979865404:  Hold'em No Limit ($0.05/$0.10 USD) - 2021/01/23 19:28:45 ET
Table 'Demoulina III' 6-max Seat #1 is the button
Seat 1: zebaztravez ($13.77 in chips) 
Seat 3: barbos2 ($15.57 in chips) 
Seat 4: nuikak ($9.96 in chips) 
Seat 5: SkyTaurus ($15.76 in chips) 
Seat 6: Freedom4all3 ($13.16 in chips) 
barbos2: posts small blind $0.05
nuikak: posts big blind $0.10
*** HOLE CARDS ***
SkyTaurus: folds 
Freedom4all3: folds 
zebaztravez: raises $0.16 to $0.26
barbos2: folds 
maxthebest99 leaves the table
nuikak: folds 
Uncalled bet ($0.16) returned to zebaztravez
zebaztravez collected $0.25 from pot
zebaztravez: doesn't show hand 
*** SUMMARY ***
Total pot $0.25 | Rake $0 
Seat 1: zebaztravez (button) collected ($0.25)
Seat 3: barbos2 (small blind) folded before Flop
Seat 4: nuikak (big blind) folded before Flop
Seat 5: SkyTaurus folded before Flop (didn't bet)
Seat 6: Freedom4all3 folded before Flop (didn't bet)



PokerStars Hand #222979872704:  Hold'em No Limit ($0.05/$0.10 USD) - 2021/01/23 19:28:59 ET
Table 'Demoulina III' 6-max Seat #3 is the button
Seat 1: zebaztravez ($13.92 in chips) 
Seat 3: barbos2 ($15.52 in chips) 
Seat 4: nuikak ($9.86 in chips) 
Seat 5: SkyTaurus ($15.76 in chips) 
Seat 6: Freedom4all3 ($13.16 in chips) 
nuikak: posts small blind $0.05
SkyTaurus: posts big blind $0.10
*** HOLE CARDS ***
Freedom4all3: folds 
zebaztravez: folds 
barbos2: folds 
nuikak: folds 
Uncalled bet ($0.05) returned to SkyTaurus
SkyTaurus collected $0.10 from pot
*** SUMMARY ***
Total pot $0.10 | Rake $0 
Seat 1: zebaztravez folded before Flop (didn't bet)
Seat 3: barbos2 (button) folded before Flop (didn't bet)
Seat 4: nuikak (small blind) folded before Flop
Seat 5: SkyTaurus (big blind) collected ($0.10)
Seat 6: Freedom4all3 folded before Flop (didn't bet)



PokerStars Hand #222979878268:  Hold'em No Limit ($0.05/$0.10 USD) - 2021/01/23 19:29:10 ET
Table 'Demoulina III' 6-max Seat #4 is the button
Seat 1: zebaztravez ($13.92 in chips) 
Seat 3: barbos2 ($15.52 in chips) 
Seat 4: nuikak ($9.81 in chips) 
Seat 5: SkyTaurus ($15.81 in chips) 
Seat 6: Freedom4all3 ($13.16 in chips) 
SkyTaurus: posts small blind $0.05
Freedom4all3: posts big blind $0.10
*** HOLE CARDS ***
zebaztravez: folds 
barbos2: folds 
KiraLasVegas joins the table at seat #2 
nuikak: folds 
SkyTaurus: raises $0.20 to $0.30
Freedom4all3: calls $0.20
*** FLOP *** [5c 5h 6s]
SkyTaurus: bets $0.19
Freedom4all3: calls $0.19
*** TURN *** [5c 5h 6s] [Jc]
SkyTaurus: bets $0.31
Freedom4all3: calls $0.31
*** RIVER *** [5c 5h 6s Jc] [4d]
SkyTaurus: checks 
Freedom4all3: checks 
*** SHOW DOWN ***
SkyTaurus: shows [8d Jd] (two pair, Jacks and Fives)
Freedom4all3: mucks hand 
SkyTaurus collected $1.53 from pot
*** SUMMARY ***
Total pot $1.60 | Rake $0.07 
Board [5c 5h 6s Jc 4d]
Seat 1: zebaztravez folded before Flop (didn't bet)
Seat 3: barbos2 folded before Flop (didn't bet)
Seat 4: nuikak (button) folded before Flop (didn't bet)
Seat 5: SkyTaurus (small blind) showed [8d Jd] and won ($1.53) with two pair, Jacks and Fives
Seat 6: Freedom4all3 (big blind) mucked



PokerStars Hand #222979896955:  Hold'em No Limit ($0.05/$0.10 USD) - 2021/01/23 19:29:46 ET
Table 'Demoulina III' 6-max Seat #5 is the button
Seat 1: zebaztravez ($13.92 in chips) 
Seat 3: barbos2 ($15.52 in chips) 
Seat 4: nuikak ($9.81 in chips) 
Seat 5: SkyTaurus ($16.54 in chips) 
Seat 6: Freedom4all3 ($12.36 in chips) 
Freedom4all3: posts small blind $0.05
zebaztravez: posts big blind $0.10
KiraLasVegas: sits out 
*** HOLE CARDS ***
barbos2: folds 
nuikak: folds 
SkyTaurus: raises $0.15 to $0.25
Freedom4all3: folds 
zebaztravez: folds 
Uncalled bet ($0.15) returned to SkyTaurus
SkyTaurus collected $0.25 from pot
*** SUMMARY ***
Total pot $0.25 | Rake $0 
Seat 1: zebaztravez (big blind) folded before Flop
Seat 3: barbos2 folded before Flop (didn't bet)
Seat 4: nuikak folded before Flop (didn't bet)
Seat 5: SkyTaurus (button) collected ($0.25)
Seat 6: Freedom4all3 (small blind) folded before Flop



PokerStars Hand #222979903402:  Hold'em No Limit ($0.05/$0.10 USD) - 2021/01/23 19:29:58 ET
Table 'Demoulina III' 6-max Seat #6 is the button
Seat 1: zebaztravez ($13.82 in chips) 
Seat 2: KiraLasVegas ($10 in chips) 
Seat 3: barbos2 ($15.52 in chips) 
Seat 4: nuikak ($9.81 in chips) 
Seat 5: SkyTaurus ($16.69 in chips) 
Seat 6: Freedom4all3 ($12.31 in chips) 
zebaztravez: posts small blind $0.05
KiraLasVegas: posts big blind $0.10
*** HOLE CARDS ***
barbos2: folds 
nuikak: folds 
SkyTaurus: raises $0.20 to $0.30
Freedom4all3: folds 
zebaztravez: folds 
KiraLasVegas: folds 
Uncalled bet ($0.20) returned to SkyTaurus
SkyTaurus collected $0.25 from pot
*** SUMMARY ***
Total pot $0.25 | Rake $0 
Seat 1: zebaztravez (small blind) folded before Flop
Seat 2: KiraLasVegas (big blind) folded before Flop
Seat 3: barbos2 folded before Flop (didn't bet)
Seat 4: nuikak folded before Flop (didn't bet)
Seat 5: SkyTaurus collected ($0.25)
Seat 6: Freedom4all3 (button) folded before Flop (didn't bet)



PokerStars Hand #222979911879:  Hold'em No Limit ($0.05/$0.10 USD) - 2021/01/23 19:30:14 ET
Table 'Demoulina III' 6-max Seat #1 is the button
Seat 1: zebaztravez ($13.77 in chips) 
Seat 2: KiraLasVegas ($10 in chips) 
Seat 5: SkyTaurus ($16.84 in chips) 
Seat 6: Freedom4all3 ($12.31 in chips) 
KiraLasVegas: posts small blind $0.05
barbos2: is sitting out 
barbos2 leaves the table
nuikak: is sitting out 
SkyTaurus: posts big blind $0.10
*** HOLE CARDS ***
Freedom4all3: folds 
zebaztravez: folds 
KiraLasVegas: folds 
Uncalled bet ($0.05) returned to SkyTaurus
nuikak leaves the table
SkyTaurus collected $0.10 from pot
*** SUMMARY ***
Total pot $0.10 | Rake $0 
Seat 1: zebaztravez (button) folded before Flop (didn't bet)
Seat 2: KiraLasVegas (small blind) folded before Flop
Seat 5: SkyTaurus (big blind) collected ($0.10)
Seat 6: Freedom4all3 folded before Flop (didn't bet)



PokerStars Hand #222979916010:  Hold'em No Limit ($0.05/$0.10 USD) - 2021/01/23 19:30:22 ET
Table 'Demoulina III' 6-max Seat #2 is the button
Seat 1: zebaztravez ($13.77 in chips) 
Seat 2: KiraLasVegas ($10 in chips) 
Seat 5: SkyTaurus ($16.89 in chips) 
Seat 6: Freedom4all3 ($12.31 in chips) 
SkyTaurus: posts small blind $0.05
Freedom4all3: posts big blind $0.10
*** HOLE CARDS ***
zebaztravez: folds 
KiraLasVegas: raises $0.15 to $0.25
SkyTaurus: folds 
Gintaras20 joins the table at seat #4 
Freedom4all3: folds 
Uncalled bet ($0.15) returned to KiraLasVegas
KiraLasVegas collected $0.25 from pot
KiraLasVegas: doesn't show hand 
*** SUMMARY ***
Total pot $0.25 | Rake $0 
Seat 1: zebaztravez folded before Flop (didn't bet)
Seat 2: KiraLasVegas (button) collected ($0.25)
Seat 5: SkyTaurus (small blind) folded before Flop
Seat 6: Freedom4all3 (big blind) folded before Flop



PokerStars Hand #222979920785:  Hold'em No Limit ($0.05/$0.10 USD) - 2021/01/23 19:30:32 ET
Table 'Demoulina III' 6-max Seat #5 is the button
Seat 1: zebaztravez ($13.77 in chips) 
Seat 2: KiraLasVegas ($10.15 in chips) 
Seat 5: SkyTaurus ($16.84 in chips) 
Seat 6: Freedom4all3 ($12.21 in chips) 
Freedom4all3: posts small blind $0.05
zebaztravez: posts big blind $0.10
Gintaras20: sits out 
*** HOLE CARDS ***
KiraLasVegas: folds 
SkyTaurus: raises $0.15 to $0.25
KiraLasVegas leaves the table
Freedom4all3: folds 
zebaztravez: folds 
Uncalled bet ($0.15) returned to SkyTaurus
SkyTaurus collected $0.25 from pot
*** SUMMARY ***
Total pot $0.25 | Rake $0 
Seat 1: zebaztravez (big blind) folded before Flop
Seat 2: KiraLasVegas folded before Flop (didn't bet)
Seat 5: SkyTaurus (button) collected ($0.25)
Seat 6: Freedom4all3 (small blind) folded before Flop



PokerStars Hand #222979927068:  Hold'em No Limit ($0.05/$0.10 USD) - 2021/01/23 19:30:44 ET
Table 'Demoulina III' 6-max Seat #6 is the button
Seat 1: zebaztravez ($13.67 in chips) 
Seat 4: Gintaras20 ($9.86 in chips) 
Seat 5: SkyTaurus ($16.99 in chips) 
Seat 6: Freedom4all3 ($12.16 in chips) 
zebaztravez: posts small blind $0.05
Gintaras20: posts big blind $0.10
*** HOLE CARDS ***
SkyTaurus: folds 
Freedom4all3: folds 
zebaztravez: raises $0.20 to $0.30
Gintaras20: folds 
Uncalled bet ($0.20) returned to zebaztravez
zebaztravez collected $0.20 from pot
zebaztravez: doesn't show hand 
*** SUMMARY ***
Total pot $0.20 | Rake $0 
Seat 1: zebaztravez (small blind) collected ($0.20)
Seat 4: Gintaras20 (big blind) folded before Flop
Seat 5: SkyTaurus folded before Flop (didn't bet)
Seat 6: Freedom4all3 (button) folded before Flop (didn't bet)



PokerStars Hand #222979932069:  Hold'em No Limit ($0.05/$0.10 USD) - 2021/01/23 19:30:53 ET
Table 'Demoulina III' 6-max Seat #4 is the button
Seat 4: Gintaras20 ($9.76 in chips) 
Seat 5: SkyTaurus ($16.99 in chips) 
Seat 6: Freedom4all3 ($12.16 in chips) 
SkyTaurus: posts small blind $0.05
Freedom4all3: posts big blind $0.10
*** HOLE CARDS ***
Gintaras20: raises $0.15 to $0.25
zebaztravez leaves the table
SkyTaurus: folds 
Freedom4all3: calls $0.15
*** FLOP *** [9d 4h Th]
Freedom4all3: bets $0.26
Gintaras20: folds 
Uncalled bet ($0.26) returned to Freedom4all3
Freedom4all3 collected $0.53 from pot
Freedom4all3: doesn't show hand 
*** SUMMARY ***
Total pot $0.55 | Rake $0.02 
Board [9d 4h Th]
Seat 4: Gintaras20 (button) folded on the Flop
Seat 5: SkyTaurus (small blind) folded before Flop
Seat 6: Freedom4all3 (big blind) collected ($0.53)



PokerStars Hand #222979940137:  Hold'em No Limit ($0.05/$0.10 USD) - 2021/01/23 19:31:09 ET
Table 'Demoulina III' 6-max Seat #5 is the button
Seat 4: Gintaras20 ($9.51 in chips) 
Seat 5: SkyTaurus ($16.94 in chips) 
Seat 6: Freedom4all3 ($12.44 in chips) 
Freedom4all3: posts small blind $0.05
Gintaras20: posts big blind $0.10
*** HOLE CARDS ***
SkyTaurus: raises $0.15 to $0.25
Freedom4all3: calls $0.20
Gintaras20: raises $0.85 to $1.10
SkyTaurus: folds 
Freedom4all3: folds 
Uncalled bet ($0.85) returned to Gintaras20
Gintaras20 collected $0.75 from pot
Gintaras20: doesn't show hand 
*** SUMMARY ***
Total pot $0.75 | Rake $0 
Seat 4: Gintaras20 (big blind) collected ($0.75)
Seat 5: SkyTaurus (button) folded before Flop
Seat 6: Freedom4all3 (small blind) folded before Flop



PokerStars Hand #222979949255:  Hold'em No Limit ($0.05/$0.10 USD) - 2021/01/23 19:31:27 ET
Table 'Demoulina III' 6-max Seat #6 is the button
Seat 4: Gintaras20 ($10.01 in chips) 
Seat 5: SkyTaurus ($16.69 in chips) 
Seat 6: Freedom4all3 ($12.19 in chips) 
Gintaras20: posts small blind $0.05
SkyTaurus: posts big blind $0.10
*** HOLE CARDS ***
Freedom4all3: raises $0.20 to $0.30
Gintaras20: folds 
Bossen124 joins the table at seat #1 
SkyTaurus: folds 
Uncalled bet ($0.20) returned to Freedom4all3
Freedom4all3 collected $0.25 from pot
Freedom4all3: doesn't show hand 
*** SUMMARY ***
Total pot $0.25 | Rake $0 
Seat 4: Gintaras20 (small blind) folded before Flop
Seat 5: SkyTaurus (big blind) folded before Flop
Seat 6: Freedom4all3 (button) collected ($0.25)



PokerStars Hand #222979955314:  Hold'em No Limit ($0.05/$0.10 USD) - 2021/01/23 19:31:38 ET
Table 'Demoulina III' 6-max Seat #4 is the button
Seat 4: Gintaras20 ($9.96 in chips) 
Seat 5: SkyTaurus ($16.59 in chips) 
Seat 6: Freedom4all3 ($12.34 in chips) 
SkyTaurus: posts small blind $0.05
Freedom4all3: posts big blind $0.10
Bossen124: sits out 
*** HOLE CARDS ***
Gintaras20: raises $0.15 to $0.25
toxa910212 joins the table at seat #2 
SkyTaurus: raises $0.75 to $1
Freedom4all3: folds 
Gintaras20: calls $0.75
*** FLOP *** [Ks Qd Qc]
bfindon joins the table at seat #3 
SkyTaurus: checks 
Gintaras20: checks 
*** TURN *** [Ks Qd Qc] [4d]
SkyTaurus: bets $0.50
Gintaras20: folds 
Uncalled bet ($0.50) returned to SkyTaurus
SkyTaurus collected $2.01 from pot
*** SUMMARY ***
Total pot $2.10 | Rake $0.09 
Board [Ks Qd Qc 4d]
Seat 4: Gintaras20 (button) folded on the Turn
Seat 5: SkyTaurus (small blind) collected ($2.01)
Seat 6: Freedom4all3 (big blind) folded before Flop



PokerStars Hand #222979981870:  Hold'em No Limit ($0.05/$0.10 USD) - 2021/01/23 19:32:14 ET
Table 'Demoulina III' 6-max Seat #5 is the button
Seat 1: Bossen124 ($6.70 in chips) 
Seat 3: bfindon ($5 in chips) 
Seat 4: Gintaras20 ($8.96 in chips) 
Seat 5: SkyTaurus ($17.60 in chips) 
Seat 6: Freedom4all3 ($12.24 in chips) 
Freedom4all3: posts small blind $0.05
Bossen124: posts big blind $0.10
toxa910212: sits out 
bfindon: posts big blind $0.10
*** HOLE CARDS ***
bfindon: checks 
Gintaras20: folds 
SkyTaurus: folds 
Freedom4all3: folds 
Bossen124: checks 
*** FLOP *** [Tc 4s 6s]
Bossen124: checks 
bfindon: checks 
*** TURN *** [Tc 4s 6s] [Jd]
Bossen124: checks 
bfindon: checks 
*** RIVER *** [Tc 4s 6s Jd] [8d]
Bossen124: checks 
bfindon: bets $0.12
Bossen124: folds 
Uncalled bet ($0.12) returned to bfindon
bfindon collected $0.24 from pot
bfindon: doesn't show hand 
*** SUMMARY ***
Total pot $0.25 | Rake $0.01 
Board [Tc 4s 6s Jd 8d]
Seat 1: Bossen124 (big blind) folded on the River
Seat 3: bfindon collected ($0.24)
Seat 4: Gintaras20 folded before Flop (didn't bet)
Seat 5: SkyTaurus (button) folded before Flop (didn't bet)
Seat 6: Freedom4all3 (small blind) folded before Flop



PokerStars Hand #222979999465:  Hold'em No Limit ($0.05/$0.10 USD) - 2021/01/23 19:32:49 ET
Table 'Demoulina III' 6-max Seat #6 is the button
Seat 1: Bossen124 ($6.60 in chips) 
Seat 2: toxa910212 ($10 in chips) 
Seat 3: bfindon ($5.14 in chips) 
Seat 4: Gintaras20 ($8.96 in chips) 
Seat 5: SkyTaurus ($17.60 in chips) 
Seat 6: Freedom4all3 ($12.19 in chips) 
Bossen124: posts small blind $0.05
toxa910212: posts big blind $0.10
*** HOLE CARDS ***
bfindon: calls $0.10
Gintaras20: raises $0.15 to $0.25
SkyTaurus: folds 
Freedom4all3: folds 
Bossen124: folds 
toxa910212: folds 
bfindon: calls $0.15
*** FLOP *** [Qs 9d 3d]
bfindon: checks 
Gintaras20: bets $0.47
bfindon: folds 
Uncalled bet ($0.47) returned to Gintaras20
Gintaras20 collected $0.62 from pot
Gintaras20: doesn't show hand 
*** SUMMARY ***
Total pot $0.65 | Rake $0.03 
Board [Qs 9d 3d]
Seat 1: Bossen124 (small blind) folded before Flop
Seat 2: toxa910212 (big blind) folded before Flop
Seat 3: bfindon folded on the Flop
Seat 4: Gintaras20 collected ($0.62)
Seat 5: SkyTaurus folded before Flop (didn't bet)
Seat 6: Freedom4all3 (button) folded before Flop (didn't bet)



PokerStars Hand #222980013056:  Hold'em No Limit ($0.05/$0.10 USD) - 2021/01/23 19:33:15 ET
Table 'Demoulina III' 6-max Seat #1 is the button
Seat 1: Bossen124 ($6.55 in chips) 
Seat 2: toxa910212 ($10 in chips) 
Seat 3: bfindon ($4.89 in chips) 
Seat 4: Gintaras20 ($9.33 in chips) 
Seat 5: SkyTaurus ($17.60 in chips) 
Seat 6: Freedom4all3 ($12.19 in chips) 
toxa910212: posts small blind $0.05
bfindon: posts big blind $0.10
*** HOLE CARDS ***
Gintaras20: raises $0.15 to $0.25
SkyTaurus: folds 
Freedom4all3: folds 
Bossen124: folds 
toxa910212: folds 
bfindon: folds 
Uncalled bet ($0.15) returned to Gintaras20
Gintaras20 collected $0.25 from pot
Gintaras20: doesn't show hand 
*** SUMMARY ***
Total pot $0.25 | Rake $0 
Seat 1: Bossen124 (button) folded before Flop (didn't bet)
Seat 2: toxa910212 (small blind) folded before Flop
Seat 3: bfindon (big blind) folded before Flop
Seat 4: Gintaras20 collected ($0.25)
Seat 5: SkyTaurus folded before Flop (didn't bet)
Seat 6: Freedom4all3 folded before Flop (didn't bet)



PokerStars Hand #222980020377:  Hold'em No Limit ($0.05/$0.10 USD) - 2021/01/23 19:33:30 ET
Table 'Demoulina III' 6-max Seat #2 is the button
Seat 1: Bossen124 ($6.55 in chips) 
Seat 2: toxa910212 ($10 in chips) 
Seat 3: bfindon ($4.79 in chips) 
Seat 4: Gintaras20 ($9.48 in chips) 
Seat 5: SkyTaurus ($17.60 in chips) 
Seat 6: Freedom4all3 ($12.19 in chips) 
bfindon: posts small blind $0.05
Gintaras20: posts big blind $0.10
*** HOLE CARDS ***
SkyTaurus: folds 
Freedom4all3: folds 
Bossen124: raises $0.20 to $0.30
toxa910212: calls $0.30
bfindon: folds 
Gintaras20: calls $0.20
*** FLOP *** [7s Qh 6c]
Gintaras20: checks 
Bossen124: checks 
toxa910212: bets $0.46
Gintaras20: calls $0.46
Bossen124: folds 
*** TURN *** [7s Qh 6c] [9c]
Gintaras20: checks 
toxa910212: checks 
*** RIVER *** [7s Qh 6c 9c] [4d]
Gintaras20: bets $1.80
toxa910212: folds 
Uncalled bet ($1.80) returned to Gintaras20
Gintaras20 collected $1.79 from pot
Gintaras20: doesn't show hand 
*** SUMMARY ***
Total pot $1.87 | Rake $0.08 
Board [7s Qh 6c 9c 4d]
Seat 1: Bossen124 folded on the Flop
Seat 2: toxa910212 (button) folded on the River
Seat 3: bfindon (small blind) folded before Flop
Seat 4: Gintaras20 (big blind) collected ($1.79)
Seat 5: SkyTaurus folded before Flop (didn't bet)
Seat 6: Freedom4all3 folded before Flop (didn't bet)



PokerStars Hand #222980041496:  Hold'em No Limit ($0.05/$0.10 USD) - 2021/01/23 19:34:11 ET
Table 'Demoulina III' 6-max Seat #3 is the button
Seat 1: Bossen124 ($6.25 in chips) 
Seat 2: toxa910212 ($10 in chips) 
Seat 3: bfindon ($4.74 in chips) 
Seat 4: Gintaras20 ($10.51 in chips) 
Seat 5: SkyTaurus ($17.60 in chips) 
Seat 6: Freedom4all3 ($12.19 in chips) 
Gintaras20: posts small blind $0.05
SkyTaurus: posts big blind $0.10
*** HOLE CARDS ***
Freedom4all3: folds 
Bossen124: calls $0.10
toxa910212: folds 
bfindon: calls $0.10
Gintaras20: folds 
SkyTaurus: raises $0.70 to $0.80
Bossen124: folds 
bfindon: calls $0.70
*** FLOP *** [Ts 5h Qd]
SkyTaurus: bets $1.17
bfindon: folds 
Uncalled bet ($1.17) returned to SkyTaurus
SkyTaurus collected $1.67 from pot
*** SUMMARY ***
Total pot $1.75 | Rake $0.08 
Board [Ts 5h Qd]
Seat 1: Bossen124 folded before Flop
Seat 2: toxa910212 folded before Flop (didn't bet)
Seat 3: bfindon (button) folded on the Flop
Seat 4: Gintaras20 (small blind) folded before Flop
Seat 5: SkyTaurus (big blind) collected ($1.67)
Seat 6: Freedom4all3 folded before Flop (didn't bet)



PokerStars Hand #222980058809:  Hold'em No Limit ($0.05/$0.10 USD) - 2021/01/23 19:34:46 ET
Table 'Demoulina III' 6-max Seat #4 is the button
Seat 1: Bossen124 ($6.15 in chips) 
Seat 2: toxa910212 ($10 in chips) 
Seat 3: bfindon ($3.94 in chips) 
Seat 4: Gintaras20 ($10.46 in chips) 
Seat 5: SkyTaurus ($18.47 in chips) 
Seat 6: Freedom4all3 ($12.19 in chips) 
SkyTaurus: posts small blind $0.05
Freedom4all3: posts big blind $0.10
*** HOLE CARDS ***
Bossen124: folds 
toxa910212: folds 
bfindon: calls $0.10
Gintaras20: folds 
SkyTaurus: folds 
Freedom4all3: checks 
*** FLOP *** [Jh 3s Kd]
Freedom4all3: checks 
bfindon: bets $0.10
Freedom4all3: folds 
Uncalled bet ($0.10) returned to bfindon
bfindon collected $0.24 from pot
bfindon: doesn't show hand 
*** SUMMARY ***
Total pot $0.25 | Rake $0.01 
Board [Jh 3s Kd]
Seat 1: Bossen124 folded before Flop (didn't bet)
Seat 2: toxa910212 folded before Flop (didn't bet)
Seat 3: bfindon collected ($0.24)
Seat 4: Gintaras20 (button) folded before Flop (didn't bet)
Seat 5: SkyTaurus (small blind) folded before Flop
Seat 6: Freedom4all3 (big blind) folded on the Flop



PokerStars Hand #222980069397:  Hold'em No Limit ($0.05/$0.10 USD) - 2021/01/23 19:35:07 ET
Table 'Demoulina III' 6-max Seat #5 is the button
Seat 1: Bossen124 ($6.15 in chips) 
Seat 2: toxa910212 ($10 in chips) 
Seat 3: bfindon ($4.08 in chips) 
Seat 4: Gintaras20 ($10.46 in chips) 
Seat 5: SkyTaurus ($18.42 in chips) 
Seat 6: Freedom4all3 ($12.09 in chips) 
Freedom4all3: posts small blind $0.05
Bossen124: posts big blind $0.10
*** HOLE CARDS ***
toxa910212: raises $0.15 to $0.25
bfindon: calls $0.25
Gintaras20: folds 
SkyTaurus: folds 
Freedom4all3: calls $0.20
Bossen124: folds 
*** FLOP *** [4s Ts 9c]
Freedom4all3: checks 
toxa910212: checks 
bfindon: bets $0.81
Freedom4all3: folds 
toxa910212: folds 
Uncalled bet ($0.81) returned to bfindon
bfindon collected $0.81 from pot
bfindon: doesn't show hand 
*** SUMMARY ***
Total pot $0.85 | Rake $0.04 
Board [4s Ts 9c]
Seat 1: Bossen124 (big blind) folded before Flop
Seat 2: toxa910212 folded on the Flop
Seat 3: bfindon collected ($0.81)
Seat 4: Gintaras20 folded before Flop (didn't bet)
Seat 5: SkyTaurus (button) folded before Flop (didn't bet)
Seat 6: Freedom4all3 (small blind) folded on the Flop



PokerStars Hand #222980086527:  Hold'em No Limit ($0.05/$0.10 USD) - 2021/01/23 19:35:41 ET
Table 'Demoulina III' 6-max Seat #6 is the button
Seat 1: Bossen124 ($6.05 in chips) 
Seat 2: toxa910212 ($10 in chips) 
Seat 3: bfindon ($4.64 in chips) 
Seat 4: Gintaras20 ($10.46 in chips) 
Seat 5: SkyTaurus ($18.42 in chips) 
Seat 6: Freedom4all3 ($11.84 in chips) 
Bossen124: posts small blind $0.05
toxa910212: posts big blind $0.10
*** HOLE CARDS ***
bfindon: folds 
Gintaras20: folds 
SkyTaurus: folds 
Freedom4all3: raises $0.20 to $0.30
Bossen124: folds 
toxa910212: folds 
Uncalled bet ($0.20) returned to Freedom4all3
Freedom4all3 collected $0.25 from pot
Freedom4all3: doesn't show hand 
*** SUMMARY ***
Total pot $0.25 | Rake $0 
Seat 1: Bossen124 (small blind) folded before Flop
Seat 2: toxa910212 (big blind) folded before Flop
Seat 3: bfindon folded before Flop (didn't bet)
Seat 4: Gintaras20 folded before Flop (didn't bet)
Seat 5: SkyTaurus folded before Flop (didn't bet)
Seat 6: Freedom4all3 (button) collected ($0.25)



PokerStars Hand #222980091812:  Hold'em No Limit ($0.05/$0.10 USD) - 2021/01/23 19:35:51 ET
Table 'Demoulina III' 6-max Seat #1 is the button
Seat 1: Bossen124 ($6 in chips) 
Seat 2: toxa910212 ($10 in chips) 
Seat 3: bfindon ($4.64 in chips) 
Seat 4: Gintaras20 ($10.46 in chips) 
Seat 5: SkyTaurus ($18.42 in chips) 
Seat 6: Freedom4all3 ($11.99 in chips) 
toxa910212: posts small blind $0.05
bfindon: posts big blind $0.10
*** HOLE CARDS ***
Gintaras20: raises $0.15 to $0.25
SkyTaurus: folds 
Freedom4all3: folds 
Bossen124: calls $0.25
toxa910212: folds 
bfindon: calls $0.15
*** FLOP *** [7d Jd Ks]
bfindon: bets $0.38
Gintaras20: folds 
Bossen124: raises $0.76 to $1.14
bfindon: calls $0.76
*** TURN *** [7d Jd Ks] [5c]
bfindon: checks 
Bossen124: checks 
*** RIVER *** [7d Jd Ks 5c] [Qd]
bfindon: checks 
Bossen124: checks 
*** SHOW DOWN ***
bfindon: shows [Qh Ts] (a pair of Queens)
Bossen124: shows [Th Qs] (a pair of Queens)
bfindon collected $1.47 from pot
Bossen124 collected $1.47 from pot
*** SUMMARY ***
Total pot $3.08 | Rake $0.14 
Board [7d Jd Ks 5c Qd]
Seat 1: Bossen124 (button) showed [Th Qs] and won ($1.47) with a pair of Queens
Seat 2: toxa910212 (small blind) folded before Flop
Seat 3: bfindon (big blind) showed [Qh Ts] and won ($1.47) with a pair of Queens
Seat 4: Gintaras20 folded on the Flop
Seat 5: SkyTaurus folded before Flop (didn't bet)
Seat 6: Freedom4all3 folded before Flop (didn't bet)



PokerStars Hand #222980115973:  Hold'em No Limit ($0.05/$0.10 USD) - 2021/01/23 19:36:39 ET
Table 'Demoulina III' 6-max Seat #2 is the button
Seat 1: Bossen124 ($6.08 in chips) 
Seat 2: toxa910212 ($10 in chips) 
Seat 3: bfindon ($4.72 in chips) 
Seat 4: Gintaras20 ($10.21 in chips) 
Seat 5: SkyTaurus ($18.42 in chips) 
Seat 6: Freedom4all3 ($11.99 in chips) 
bfindon: posts small blind $0.05
Gintaras20: posts big blind $0.10
*** HOLE CARDS ***
SkyTaurus: folds 
Freedom4all3: folds 
Bossen124: calls $0.10
toxa910212: folds 
bfindon: calls $0.05
Gintaras20: checks 
*** FLOP *** [8h 6d 4s]
bfindon: bets $0.10
Gintaras20: calls $0.10
Bossen124: calls $0.10
*** TURN *** [8h 6d 4s] [Qs]
bfindon: bets $0.29
Gintaras20: raises $0.71 to $1
Bossen124: raises $4.88 to $5.88 and is all-in
bfindon: folds 
Gintaras20: calls $4.88
*** RIVER *** [8h 6d 4s Qs] [2c]
*** SHOW DOWN ***
Gintaras20: shows [4h Qh] (two pair, Queens and Fours)
Bossen124: shows [Kc Ks] (a pair of Kings)
Gintaras20 collected $12.08 from pot
*** SUMMARY ***
Total pot $12.65 | Rake $0.57 
Board [8h 6d 4s Qs 2c]
Seat 1: Bossen124 showed [Kc Ks] and lost with a pair of Kings
Seat 2: toxa910212 (button) folded before Flop (didn't bet)
Seat 3: bfindon (small blind) folded on the Turn
Seat 4: Gintaras20 (big blind) showed [4h Qh] and won ($12.08) with two pair, Queens and Fours
Seat 5: SkyTaurus folded before Flop (didn't bet)
Seat 6: Freedom4all3 folded before Flop (didn't bet)



PokerStars Hand #222980144043:  Hold'em No Limit ($0.05/$0.10 USD) - 2021/01/23 19:37:35 ET
Table 'Demoulina III' 6-max Seat #3 is the button
Seat 2: toxa910212 ($10 in chips) 
Seat 3: bfindon ($4.23 in chips) 
Seat 4: Gintaras20 ($16.21 in chips) 
Seat 5: SkyTaurus ($18.42 in chips) 
Seat 6: Freedom4all3 ($11.99 in chips) 
Gintaras20: posts small blind $0.05
SkyTaurus: posts big blind $0.10
*** HOLE CARDS ***
Freedom4all3: folds 
Bossen124 leaves the table
toxa910212: folds 
bfindon: folds 
Gintaras20: raises $0.15 to $0.25
SkyTaurus: calls $0.15
*** FLOP *** [2s Qc 4s]
Gintaras20: bets $0.24
SkyTaurus: folds 
Uncalled bet ($0.24) returned to Gintaras20
Gintaras20 collected $0.48 from pot
Gintaras20: doesn't show hand 
*** SUMMARY ***
Total pot $0.50 | Rake $0.02 
Board [2s Qc 4s]
Seat 2: toxa910212 folded before Flop (didn't bet)
Seat 3: bfindon (button) folded before Flop (didn't bet)
Seat 4: Gintaras20 (small blind) collected ($0.48)
Seat 5: SkyTaurus (big blind) folded on the Flop
Seat 6: Freedom4all3 folded before Flop (didn't bet)



PokerStars Hand #222980155882:  Hold'em No Limit ($0.05/$0.10 USD) - 2021/01/23 19:37:58 ET
Table 'Demoulina III' 6-max Seat #4 is the button
Seat 2: toxa910212 ($10 in chips) 
Seat 3: bfindon ($4.23 in chips) 
Seat 4: Gintaras20 ($16.44 in chips) 
Seat 5: SkyTaurus ($18.17 in chips) 
Seat 6: Freedom4all3 ($11.99 in chips) 
SkyTaurus: posts small blind $0.05
Freedom4all3: posts big blind $0.10
*** HOLE CARDS ***
toxa910212: folds 
bfindon: folds 
Gintaras20: folds 
Tilinimus007 joins the table at seat #1 
SkyTaurus: raises $0.20 to $0.30
Freedom4all3: folds 
Uncalled bet ($0.20) returned to SkyTaurus
SkyTaurus collected $0.20 from pot
*** SUMMARY ***
Total pot $0.20 | Rake $0 
Seat 2: toxa910212 folded before Flop (didn't bet)
Seat 3: bfindon folded before Flop (didn't bet)
Seat 4: Gintaras20 (button) folded before Flop (didn't bet)
Seat 5: SkyTaurus (small blind) collected ($0.20)
Seat 6: Freedom4all3 (big blind) folded before Flop



PokerStars Hand #222980161768:  Hold'em No Limit ($0.05/$0.10 USD) - 2021/01/23 19:38:10 ET
Table 'Demoulina III' 6-max Seat #5 is the button
Seat 1: Tilinimus007 ($10 in chips) 
Seat 2: toxa910212 ($10 in chips) 
Seat 3: bfindon ($4.23 in chips) 
Seat 4: Gintaras20 ($16.44 in chips) 
Seat 5: SkyTaurus ($18.27 in chips) 
Seat 6: Freedom4all3 ($11.89 in chips) 
Freedom4all3: posts small blind $0.05
Tilinimus007: posts big blind $0.10
*** HOLE CARDS ***
toxa910212: raises $0.20 to $0.30
bfindon: folds 
Gintaras20: folds 
SkyTaurus: folds 
Freedom4all3: folds 
Tilinimus007: calls $0.20
*** FLOP *** [Ts 5h Tc]
Tilinimus007: checks 
toxa910212: bets $0.40
Tilinimus007: calls $0.40
*** TURN *** [Ts 5h Tc] [7d]
Tilinimus007: checks 
toxa910212: bets $0.70
Tilinimus007: raises $0.90 to $1.60
toxa910212: calls $0.90
*** RIVER *** [Ts 5h Tc 7d] [8d]
Tilinimus007: checks 
toxa910212: checks 
*** SHOW DOWN ***
Tilinimus007: shows [Ac 4h] (a pair of Tens)
toxa910212: shows [Ad Td] (three of a kind, Tens)
toxa910212 collected $4.44 from pot
*** SUMMARY ***
Total pot $4.65 | Rake $0.21 
Board [Ts 5h Tc 7d 8d]
Seat 1: Tilinimus007 (big blind) showed [Ac 4h] and lost with a pair of Tens
Seat 2: toxa910212 showed [Ad Td] and won ($4.44) with three of a kind, Tens
Seat 3: bfindon folded before Flop (didn't bet)
Seat 4: Gintaras20 folded before Flop (didn't bet)
Seat 5: SkyTaurus (button) folded before Flop (didn't bet)
Seat 6: Freedom4all3 (small blind) folded before Flop



PokerStars Hand #222980188211:  Hold'em No Limit ($0.05/$0.10 USD) - 2021/01/23 19:39:02 ET
Table 'Demoulina III' 6-max Seat #6 is the button
Seat 1: Tilinimus007 ($10 in chips) 
Seat 2: toxa910212 ($12.14 in chips) 
Seat 3: bfindon ($4.23 in chips) 
Seat 4: Gintaras20 ($16.44 in chips) 
Seat 5: SkyTaurus ($18.27 in chips) 
Seat 6: Freedom4all3 ($11.84 in chips) 
Tilinimus007: posts small blind $0.05
toxa910212: posts big blind $0.10
*** HOLE CARDS ***
bfindon: calls $0.10
Gintaras20: folds 
SkyTaurus: folds 
Freedom4all3: folds 
Tilinimus007: folds 
toxa910212: checks 
*** FLOP *** [3d Qs Ks]
toxa910212: checks 
bfindon: checks 
*** TURN *** [3d Qs Ks] [5c]
toxa910212: checks 
bfindon: bets $0.10
toxa910212: folds 
Uncalled bet ($0.10) returned to bfindon
bfindon collected $0.24 from pot
bfindon: doesn't show hand 
*** SUMMARY ***
Total pot $0.25 | Rake $0.01 
Board [3d Qs Ks 5c]
Seat 1: Tilinimus007 (small blind) folded before Flop
Seat 2: toxa910212 (big blind) folded on the Turn
Seat 3: bfindon collected ($0.24)
Seat 4: Gintaras20 folded before Flop (didn't bet)
Seat 5: SkyTaurus folded before Flop (didn't bet)
Seat 6: Freedom4all3 (button) folded before Flop (didn't bet)



PokerStars Hand #222980199267:  Hold'em No Limit ($0.05/$0.10 USD) - 2021/01/23 19:39:25 ET
Table 'Demoulina III' 6-max Seat #1 is the button
Seat 1: Tilinimus007 ($10 in chips) 
Seat 2: toxa910212 ($12.04 in chips) 
Seat 3: bfindon ($4.37 in chips) 
Seat 4: Gintaras20 ($16.44 in chips) 
Seat 5: SkyTaurus ($18.27 in chips) 
Seat 6: Freedom4all3 ($11.84 in chips) 
toxa910212: posts small blind $0.05
bfindon: posts big blind $0.10
*** HOLE CARDS ***
Gintaras20: raises $0.15 to $0.25
SkyTaurus: raises $0.55 to $0.80
Freedom4all3: folds 
Tilinimus007: folds 
toxa910212: folds 
bfindon: folds 
Gintaras20: folds 
Uncalled bet ($0.55) returned to SkyTaurus
SkyTaurus collected $0.65 from pot
*** SUMMARY ***
Total pot $0.65 | Rake $0 
Seat 1: Tilinimus007 (button) folded before Flop (didn't bet)
Seat 2: toxa910212 (small blind) folded before Flop
Seat 3: bfindon (big blind) folded before Flop
Seat 4: Gintaras20 folded before Flop
Seat 5: SkyTaurus collected ($0.65)
Seat 6: Freedom4all3 folded before Flop (didn't bet)



PokerStars Hand #222980206277:  Hold'em No Limit ($0.05/$0.10 USD) - 2021/01/23 19:39:39 ET
Table 'Demoulina III' 6-max Seat #2 is the button
Seat 1: Tilinimus007 ($10 in chips) 
Seat 2: toxa910212 ($11.99 in chips) 
Seat 3: bfindon ($4.27 in chips) 
Seat 4: Gintaras20 ($16.19 in chips) 
Seat 5: SkyTaurus ($18.67 in chips) 
Seat 6: Freedom4all3 ($11.84 in chips) 
bfindon: posts small blind $0.05
Gintaras20: posts big blind $0.10
*** HOLE CARDS ***
SkyTaurus: folds 
Freedom4all3: folds 
Tilinimus007: folds 
toxa910212: raises $0.11 to $0.21
bfindon: folds 
Gintaras20: calls $0.11
*** FLOP *** [6s Ah 5c]
Gintaras20: checks 
toxa910212: bets $0.23
Gintaras20: calls $0.23
*** TURN *** [6s Ah 5c] [As]
Gintaras20: checks 
toxa910212: checks 
*** RIVER *** [6s Ah 5c As] [8h]
Gintaras20: bets $0.67
toxa910212: calls $0.67
*** SHOW DOWN ***
Gintaras20: shows [7h 8s] (two pair, Aces and Eights)
toxa910212: shows [9h Ac] (three of a kind, Aces)
toxa910212 collected $2.17 from pot
*** SUMMARY ***
Total pot $2.27 | Rake $0.10 
Board [6s Ah 5c As 8h]
Seat 1: Tilinimus007 folded before Flop (didn't bet)
Seat 2: toxa910212 (button) showed [9h Ac] and won ($2.17) with three of a kind, Aces
Seat 3: bfindon (small blind) folded before Flop
Seat 4: Gintaras20 (big blind) showed [7h 8s] and lost with two pair, Aces and Eights
Seat 5: SkyTaurus folded before Flop (didn't bet)
Seat 6: Freedom4all3 folded before Flop (didn't bet)



PokerStars Hand #222980220846:  Hold'em No Limit ($0.05/$0.10 USD) - 2021/01/23 19:40:08 ET
Table 'Demoulina III' 6-max Seat #3 is the button
Seat 1: Tilinimus007 ($10 in chips) 
Seat 2: toxa910212 ($13.05 in chips) 
Seat 3: bfindon ($4.22 in chips) 
Seat 4: Gintaras20 ($15.08 in chips) 
Seat 5: SkyTaurus ($18.67 in chips) 
Seat 6: Freedom4all3 ($11.84 in chips) 
Gintaras20: posts small blind $0.05
SkyTaurus: posts big blind $0.10
*** HOLE CARDS ***
Freedom4all3: raises $0.20 to $0.30
Tilinimus007: folds 
toxa910212: folds 
bfindon: calls $0.30
Gintaras20: folds 
SkyTaurus: folds 
*** FLOP *** [Qc 4h 7s]
Freedom4all3: bets $0.36
bfindon: folds 
Uncalled bet ($0.36) returned to Freedom4all3
Freedom4all3 collected $0.72 from pot
Freedom4all3: doesn't show hand 
*** SUMMARY ***
Total pot $0.75 | Rake $0.03 
Board [Qc 4h 7s]
Seat 1: Tilinimus007 folded before Flop (didn't bet)
Seat 2: toxa910212 folded before Flop (didn't bet)
Seat 3: bfindon (button) folded on the Flop
Seat 4: Gintaras20 (small blind) folded before Flop
Seat 5: SkyTaurus (big blind) folded before Flop
Seat 6: Freedom4all3 collected ($0.72)



PokerStars Hand #222980232030:  Hold'em No Limit ($0.05/$0.10 USD) - 2021/01/23 19:40:31 ET
Table 'Demoulina III' 6-max Seat #4 is the button
Seat 1: Tilinimus007 ($10 in chips) 
Seat 2: toxa910212 ($13.05 in chips) 
Seat 3: bfindon ($3.92 in chips) 
Seat 4: Gintaras20 ($15.03 in chips) 
Seat 5: SkyTaurus ($18.57 in chips) 
Seat 6: Freedom4all3 ($12.26 in chips) 
SkyTaurus: posts small blind $0.05
Freedom4all3: posts big blind $0.10
*** HOLE CARDS ***
Tilinimus007: folds 
toxa910212: folds 
bfindon: calls $0.10
Gintaras20: folds 
SkyTaurus: calls $0.05
Freedom4all3: raises $0.30 to $0.40
bfindon: calls $0.30
SkyTaurus: folds 
*** FLOP *** [7c 5c 7h]
Freedom4all3: bets $0.43
bfindon: calls $0.43
*** TURN *** [7c 5c 7h] [6s]
Freedom4all3: bets $0.84
bfindon: raises $2.25 to $3.09 and is all-in
Freedom4all3: folds 
Uncalled bet ($2.25) returned to bfindon
bfindon collected $3.29 from pot
bfindon: doesn't show hand 
*** SUMMARY ***
Total pot $3.44 | Rake $0.15 
Board [7c 5c 7h 6s]
Seat 1: Tilinimus007 folded before Flop (didn't bet)
Seat 2: toxa910212 folded before Flop (didn't bet)
Seat 3: bfindon collected ($3.29)
Seat 4: Gintaras20 (button) folded before Flop (didn't bet)
Seat 5: SkyTaurus (small blind) folded before Flop
Seat 6: Freedom4all3 (big blind) folded on the Turn



PokerStars Hand #222980252245:  Hold'em No Limit ($0.05/$0.10 USD) - 2021/01/23 19:41:11 ET
Table 'Demoulina III' 6-max Seat #5 is the button
Seat 1: Tilinimus007 ($10 in chips) 
Seat 2: toxa910212 ($13.05 in chips) 
Seat 3: bfindon ($5.54 in chips) 
Seat 4: Gintaras20 ($15.03 in chips) 
Seat 5: SkyTaurus ($18.47 in chips) 
Seat 6: Freedom4all3 ($10.59 in chips) 
Freedom4all3: posts small blind $0.05
Tilinimus007: posts big blind $0.10
*** HOLE CARDS ***
toxa910212: folds 
bfindon: folds 
Gintaras20: folds 
SkyTaurus: folds 
Freedom4all3: raises $0.20 to $0.30
Tilinimus007: raises $0.60 to $0.90
Freedom4all3: calls $0.60
*** FLOP *** [4s 5d 4d]
Freedom4all3: checks 
Tilinimus007: bets $0.89
Freedom4all3: calls $0.89
*** TURN *** [4s 5d 4d] [Kc]
Freedom4all3: checks 
Tilinimus007: bets $2.63
Freedom4all3: folds 
Uncalled bet ($2.63) returned to Tilinimus007
Tilinimus007 collected $3.42 from pot
Tilinimus007: doesn't show hand 
*** SUMMARY ***
Total pot $3.58 | Rake $0.16 
Board [4s 5d 4d Kc]
Seat 1: Tilinimus007 (big blind) collected ($3.42)
Seat 2: toxa910212 folded before Flop (didn't bet)
Seat 3: bfindon folded before Flop (didn't bet)
Seat 4: Gintaras20 folded before Flop (didn't bet)
Seat 5: SkyTaurus (button) folded before Flop (didn't bet)
Seat 6: Freedom4all3 (small blind) folded on the Turn



PokerStars Hand #222980280647:  Hold'em No Limit ($0.05/$0.10 USD) - 2021/01/23 19:42:09 ET
Table 'Demoulina III' 6-max Seat #6 is the button
Seat 1: Tilinimus007 ($11.63 in chips) 
Seat 2: toxa910212 ($13.05 in chips) 
Seat 3: bfindon ($5.54 in chips) 
Seat 4: Gintaras20 ($15.03 in chips) 
Seat 5: SkyTaurus ($18.47 in chips) 
Seat 6: Freedom4all3 ($8.80 in chips) 
Tilinimus007: posts small blind $0.05
toxa910212: posts big blind $0.10
*** HOLE CARDS ***
bfindon: calls $0.10
Gintaras20: raises $0.30 to $0.40
SkyTaurus: folds 
Freedom4all3: folds 
Tilinimus007: folds 
toxa910212: folds 
bfindon: calls $0.30
*** FLOP *** [7d 4s Tc]
bfindon: bets $0.46
Gintaras20: calls $0.46
*** TURN *** [7d 4s Tc] [8c]
bfindon: bets $0.90
Gintaras20: calls $0.90
*** RIVER *** [7d 4s Tc 8c] [Jd]
bfindon: bets $3.50
Gintaras20: folds 
Uncalled bet ($3.50) returned to bfindon
bfindon collected $3.50 from pot
bfindon: doesn't show hand 
*** SUMMARY ***
Total pot $3.67 | Rake $0.17 
Board [7d 4s Tc 8c Jd]
Seat 1: Tilinimus007 (small blind) folded before Flop
Seat 2: toxa910212 (big blind) folded before Flop
Seat 3: bfindon collected ($3.50)
Seat 4: Gintaras20 folded on the River
Seat 5: SkyTaurus folded before Flop (didn't bet)
Seat 6: Freedom4all3 (button) folded before Flop (didn't bet)



PokerStars Hand #222980306000:  Hold'em No Limit ($0.05/$0.10 USD) - 2021/01/23 19:43:00 ET
Table 'Demoulina III' 6-max Seat #1 is the button
Seat 1: Tilinimus007 ($11.58 in chips) 
Seat 2: toxa910212 ($12.95 in chips) 
Seat 3: bfindon ($7.28 in chips) 
Seat 4: Gintaras20 ($13.27 in chips) 
Seat 5: SkyTaurus ($18.47 in chips) 
Seat 6: Freedom4all3 ($10 in chips) 
toxa910212: posts small blind $0.05
bfindon: posts big blind $0.10
*** HOLE CARDS ***
Gintaras20: folds 
SkyTaurus: folds 
Freedom4all3: folds 
Tilinimus007: folds 
toxa910212: folds 
Uncalled bet ($0.05) returned to bfindon
bfindon collected $0.10 from pot
bfindon: doesn't show hand 
*** SUMMARY ***
Total pot $0.10 | Rake $0 
Seat 1: Tilinimus007 (button) folded before Flop (didn't bet)
Seat 2: toxa910212 (small blind) folded before Flop
Seat 3: bfindon (big blind) collected ($0.10)
Seat 4: Gintaras20 folded before Flop (didn't bet)
Seat 5: SkyTaurus folded before Flop (didn't bet)
Seat 6: Freedom4all3 folded before Flop (didn't bet)



PokerStars Hand #222980640243:  Hold'em No Limit ($0.05/$0.10 USD) - 2021/01/23 19:54:13 ET
Table 'Demoulina III' 6-max Seat #3 is the button
Seat 1: Tilinimus007 ($10.15 in chips) 
Seat 2: toxa910212 ($10.27 in chips) 
Seat 3: E2AS ($3.03 in chips) 
Seat 4: Gintaras20 ($23.17 in chips) 
Seat 5: SkyTaurus ($19.19 in chips) 
Seat 6: Freedom4all3 ($12.92 in chips) 
Gintaras20: posts small blind $0.05
SkyTaurus: posts big blind $0.10
*** HOLE CARDS ***
Freedom4all3: folds 
Tilinimus007: raises $0.20 to $0.30
toxa910212: folds 
E2AS: folds 
Gintaras20: folds 
SkyTaurus: folds 
Uncalled bet ($0.20) returned to Tilinimus007
Tilinimus007 collected $0.25 from pot
Tilinimus007: doesn't show hand 
*** SUMMARY ***
Total pot $0.25 | Rake $0 
Seat 1: Tilinimus007 collected ($0.25)
Seat 2: toxa910212 folded before Flop (didn't bet)
Seat 3: E2AS (button) folded before Flop (didn't bet)
Seat 4: Gintaras20 (small blind) folded before Flop
Seat 5: SkyTaurus (big blind) folded before Flop
Seat 6: Freedom4all3 folded before Flop (didn't bet)



PokerStars Hand #222980310116:  Hold'em No Limit ($0.05/$0.10 USD) - 2021/01/23 19:43:09 ET
Table 'Demoulina III' 6-max Seat #2 is the button
Seat 1: Tilinimus007 ($11.58 in chips) 
Seat 2: toxa910212 ($12.90 in chips) 
Seat 3: bfindon ($7.33 in chips) 
Seat 4: Gintaras20 ($13.27 in chips) 
Seat 5: SkyTaurus ($18.47 in chips) 
Seat 6: Freedom4all3 ($10 in chips) 
bfindon: posts small blind $0.05
Gintaras20: posts big blind $0.10
*** HOLE CARDS ***
SkyTaurus: folds 
Freedom4all3: raises $0.20 to $0.30
Tilinimus007: folds 
toxa910212: folds 
bfindon: calls $0.25
Gintaras20: calls $0.20
*** FLOP *** [Qc 7h 4c]
bfindon: checks 
Gintaras20: checks 
Freedom4all3: checks 
*** TURN *** [Qc 7h 4c] [4s]
bfindon: checks 
Gintaras20: bets $0.65
Freedom4all3: folds 
bfindon: folds 
Uncalled bet ($0.65) returned to Gintaras20
Gintaras20 collected $0.86 from pot
Gintaras20: doesn't show hand 
*** SUMMARY ***
Total pot $0.90 | Rake $0.04 
Board [Qc 7h 4c 4s]
Seat 1: Tilinimus007 folded before Flop (didn't bet)
Seat 2: toxa910212 (button) folded before Flop (didn't bet)
Seat 3: bfindon (small blind) folded on the Turn
Seat 4: Gintaras20 (big blind) collected ($0.86)
Seat 5: SkyTaurus folded before Flop (didn't bet)
Seat 6: Freedom4all3 folded on the Turn



PokerStars Hand #222980331081:  Hold'em No Limit ($0.05/$0.10 USD) - 2021/01/23 19:43:51 ET
Table 'Demoulina III' 6-max Seat #3 is the button
Seat 1: Tilinimus007 ($11.58 in chips) 
Seat 2: toxa910212 ($12.90 in chips) 
Seat 3: bfindon ($7.03 in chips) 
Seat 4: Gintaras20 ($13.83 in chips) 
Seat 5: SkyTaurus ($18.47 in chips) 
Seat 6: Freedom4all3 ($9.70 in chips) 
Gintaras20: posts small blind $0.05
SkyTaurus: posts big blind $0.10
*** HOLE CARDS ***
Freedom4all3: raises $0.20 to $0.30
Tilinimus007: folds 
toxa910212: folds 
bfindon: calls $0.30
Gintaras20: folds 
SkyTaurus: folds 
*** FLOP *** [Jc 7d 7s]
Freedom4all3: bets $0.36
bfindon: calls $0.36
*** TURN *** [Jc 7d 7s] [6c]
Freedom4all3: bets $0.70
bfindon: calls $0.70
*** RIVER *** [Jc 7d 7s 6c] [Js]
Freedom4all3: bets $1.37
bfindon: folds 
Uncalled bet ($1.37) returned to Freedom4all3
Freedom4all3 collected $2.74 from pot
Freedom4all3: doesn't show hand 
*** SUMMARY ***
Total pot $2.87 | Rake $0.13 
Board [Jc 7d 7s 6c Js]
Seat 1: Tilinimus007 folded before Flop (didn't bet)
Seat 2: toxa910212 folded before Flop (didn't bet)
Seat 3: bfindon (button) folded on the River
Seat 4: Gintaras20 (small blind) folded before Flop
Seat 5: SkyTaurus (big blind) folded before Flop
Seat 6: Freedom4all3 collected ($2.74)



PokerStars Hand #222980348826:  Hold'em No Limit ($0.05/$0.10 USD) - 2021/01/23 19:44:28 ET
Table 'Demoulina III' 6-max Seat #4 is the button
Seat 1: Tilinimus007 ($11.58 in chips) 
Seat 2: toxa910212 ($12.90 in chips) 
Seat 3: bfindon ($5.67 in chips) 
Seat 4: Gintaras20 ($13.78 in chips) 
Seat 5: SkyTaurus ($18.37 in chips) 
Seat 6: Freedom4all3 ($11.08 in chips) 
SkyTaurus: posts small blind $0.05
Freedom4all3: posts big blind $0.10
*** HOLE CARDS ***
Tilinimus007: folds 
toxa910212: raises $0.20 to $0.30
bfindon: raises $0.20 to $0.50
Gintaras20: calls $0.50
SkyTaurus: folds 
Freedom4all3: folds 
toxa910212: calls $0.20
*** FLOP *** [8h 7h 5h]
toxa910212: checks 
bfindon: bets $1.58
Gintaras20: raises $2.37 to $3.95
toxa910212: folds 
bfindon: calls $2.37
*** TURN *** [8h 7h 5h] [6c]
bfindon: bets $1.22 and is all-in
Gintaras20: calls $1.22
*** RIVER *** [8h 7h 5h 6c] [Qs]
*** SHOW DOWN ***
bfindon: shows [Jc As] (high card Ace)
Gintaras20: shows [3h Jh] (a flush, Jack high)
Gintaras20 collected $11.45 from pot
*** SUMMARY ***
Total pot $11.99 | Rake $0.54 
Board [8h 7h 5h 6c Qs]
Seat 1: Tilinimus007 folded before Flop (didn't bet)
Seat 2: toxa910212 folded on the Flop
Seat 3: bfindon showed [Jc As] and lost with high card Ace
Seat 4: Gintaras20 (button) showed [3h Jh] and won ($11.45) with a flush, Jack high
Seat 5: SkyTaurus (small blind) folded before Flop
Seat 6: Freedom4all3 (big blind) folded before Flop



PokerStars Hand #222980367178:  Hold'em No Limit ($0.05/$0.10 USD) - 2021/01/23 19:45:05 ET
Table 'Demoulina III' 6-max Seat #5 is the button
Seat 1: Tilinimus007 ($11.58 in chips) 
Seat 2: toxa910212 ($12.40 in chips) 
Seat 4: Gintaras20 ($19.56 in chips) 
Seat 5: SkyTaurus ($18.32 in chips) 
Seat 6: Freedom4all3 ($10.98 in chips) 
Freedom4all3: posts small blind $0.05
Tilinimus007: posts big blind $0.10
*** HOLE CARDS ***
toxa910212: folds 
Gintaras20: folds 
SkyTaurus: folds 
bfindon leaves the table
Freedom4all3: folds 
Uncalled bet ($0.05) returned to Tilinimus007
Tilinimus007 collected $0.10 from pot
Tilinimus007: doesn't show hand 
*** SUMMARY ***
Total pot $0.10 | Rake $0 
Seat 1: Tilinimus007 (big blind) collected ($0.10)
Seat 2: toxa910212 folded before Flop (didn't bet)
Seat 4: Gintaras20 folded before Flop (didn't bet)
Seat 5: SkyTaurus (button) folded before Flop (didn't bet)
Seat 6: Freedom4all3 (small blind) folded before Flop



PokerStars Hand #222980372738:  Hold'em No Limit ($0.05/$0.10 USD) - 2021/01/23 19:45:16 ET
Table 'Demoulina III' 6-max Seat #6 is the button
Seat 1: Tilinimus007 ($11.63 in chips) 
Seat 2: toxa910212 ($12.40 in chips) 
Seat 4: Gintaras20 ($19.56 in chips) 
Seat 5: SkyTaurus ($18.32 in chips) 
Seat 6: Freedom4all3 ($10.93 in chips) 
Tilinimus007: posts small blind $0.05
toxa910212: posts big blind $0.10
*** HOLE CARDS ***
Gintaras20: folds 
SkyTaurus: folds 
Freedom4all3: raises $0.20 to $0.30
Tilinimus007: folds 
toxa910212: calls $0.20
*** FLOP *** [2h 3h Th]
toxa910212: checks 
KiraLasVegas joins the table at seat #3 
Freedom4all3: bets $0.31
toxa910212: folds 
Uncalled bet ($0.31) returned to Freedom4all3
Freedom4all3 collected $0.62 from pot
Freedom4all3: doesn't show hand 
*** SUMMARY ***
Total pot $0.65 | Rake $0.03 
Board [2h 3h Th]
Seat 1: Tilinimus007 (small blind) folded before Flop
Seat 2: toxa910212 (big blind) folded on the Flop
Seat 4: Gintaras20 folded before Flop (didn't bet)
Seat 5: SkyTaurus folded before Flop (didn't bet)
Seat 6: Freedom4all3 (button) collected ($0.62)



PokerStars Hand #222980382545:  Hold'em No Limit ($0.05/$0.10 USD) - 2021/01/23 19:45:37 ET
Table 'Demoulina III' 6-max Seat #1 is the button
Seat 1: Tilinimus007 ($11.58 in chips) 
Seat 2: toxa910212 ($12.10 in chips) 
Seat 3: KiraLasVegas ($10.15 in chips) 
Seat 4: Gintaras20 ($19.56 in chips) 
Seat 5: SkyTaurus ($18.32 in chips) 
Seat 6: Freedom4all3 ($11.25 in chips) 
toxa910212: posts small blind $0.05
KiraLasVegas: posts big blind $0.10
*** HOLE CARDS ***
Gintaras20: folds 
SkyTaurus: folds 
Freedom4all3: folds 
Tilinimus007: raises $0.12 to $0.22
toxa910212: folds 
KiraLasVegas: calls $0.12
*** FLOP *** [Ad Td 7s]
KiraLasVegas: checks 
Tilinimus007: checks 
*** TURN *** [Ad Td 7s] [As]
KiraLasVegas: bets $0.24
Tilinimus007: folds 
Uncalled bet ($0.24) returned to KiraLasVegas
KiraLasVegas collected $0.47 from pot
KiraLasVegas: doesn't show hand 
*** SUMMARY ***
Total pot $0.49 | Rake $0.02 
Board [Ad Td 7s As]
Seat 1: Tilinimus007 (button) folded on the Turn
Seat 2: toxa910212 (small blind) folded before Flop
Seat 3: KiraLasVegas (big blind) collected ($0.47)
Seat 4: Gintaras20 folded before Flop (didn't bet)
Seat 5: SkyTaurus folded before Flop (didn't bet)
Seat 6: Freedom4all3 folded before Flop (didn't bet)



PokerStars Hand #222980399646:  Hold'em No Limit ($0.05/$0.10 USD) - 2021/01/23 19:46:12 ET
Table 'Demoulina III' 6-max Seat #2 is the button
Seat 1: Tilinimus007 ($11.36 in chips) 
Seat 2: toxa910212 ($12.05 in chips) 
Seat 3: KiraLasVegas ($10.40 in chips) 
Seat 4: Gintaras20 ($19.56 in chips) 
Seat 5: SkyTaurus ($18.32 in chips) 
Seat 6: Freedom4all3 ($11.25 in chips) 
KiraLasVegas: posts small blind $0.05
Gintaras20: posts big blind $0.10
*** HOLE CARDS ***
SkyTaurus: folds 
Freedom4all3: folds 
Tilinimus007: raises $0.12 to $0.22
toxa910212: folds 
KiraLasVegas: folds 
Gintaras20: folds 
Uncalled bet ($0.12) returned to Tilinimus007
Tilinimus007 collected $0.25 from pot
Tilinimus007: doesn't show hand 
*** SUMMARY ***
Total pot $0.25 | Rake $0 
Seat 1: Tilinimus007 collected ($0.25)
Seat 2: toxa910212 (button) folded before Flop (didn't bet)
Seat 3: KiraLasVegas (small blind) folded before Flop
Seat 4: Gintaras20 (big blind) folded before Flop
Seat 5: SkyTaurus folded before Flop (didn't bet)
Seat 6: Freedom4all3 folded before Flop (didn't bet)



PokerStars Hand #222980407291:  Hold'em No Limit ($0.05/$0.10 USD) - 2021/01/23 19:46:27 ET
Table 'Demoulina III' 6-max Seat #3 is the button
Seat 1: Tilinimus007 ($11.51 in chips) 
Seat 2: toxa910212 ($12.05 in chips) 
Seat 3: KiraLasVegas ($10.35 in chips) 
Seat 4: Gintaras20 ($19.46 in chips) 
Seat 5: SkyTaurus ($18.32 in chips) 
Seat 6: Freedom4all3 ($11.25 in chips) 
Gintaras20: posts small blind $0.05
SkyTaurus: posts big blind $0.10
*** HOLE CARDS ***
Freedom4all3: folds 
Tilinimus007: raises $0.12 to $0.22
toxa910212: folds 
KiraLasVegas: folds 
Gintaras20: calls $0.17
SkyTaurus: calls $0.12
*** FLOP *** [4s Kh 7c]
Gintaras20: checks 
SkyTaurus: checks 
Tilinimus007: checks 
*** TURN *** [4s Kh 7c] [Tc]
Gintaras20: checks 
SkyTaurus: checks 
Tilinimus007: bets $0.33
Gintaras20: folds 
SkyTaurus: folds 
Uncalled bet ($0.33) returned to Tilinimus007
Tilinimus007 collected $0.63 from pot
Tilinimus007: doesn't show hand 
*** SUMMARY ***
Total pot $0.66 | Rake $0.03 
Board [4s Kh 7c Tc]
Seat 1: Tilinimus007 collected ($0.63)
Seat 2: toxa910212 folded before Flop (didn't bet)
Seat 3: KiraLasVegas (button) folded before Flop (didn't bet)
Seat 4: Gintaras20 (small blind) folded on the Turn
Seat 5: SkyTaurus (big blind) folded on the Turn
Seat 6: Freedom4all3 folded before Flop (didn't bet)



PokerStars Hand #222980422697:  Hold'em No Limit ($0.05/$0.10 USD) - 2021/01/23 19:46:59 ET
Table 'Demoulina III' 6-max Seat #4 is the button
Seat 1: Tilinimus007 ($11.92 in chips) 
Seat 2: toxa910212 ($12.05 in chips) 
Seat 3: KiraLasVegas ($10.35 in chips) 
Seat 4: Gintaras20 ($19.24 in chips) 
Seat 5: SkyTaurus ($18.10 in chips) 
Seat 6: Freedom4all3 ($11.25 in chips) 
SkyTaurus: posts small blind $0.05
Freedom4all3: posts big blind $0.10
*** HOLE CARDS ***
Tilinimus007: raises $0.12 to $0.22
toxa910212: folds 
KiraLasVegas: folds 
Gintaras20: folds 
SkyTaurus: folds 
Freedom4all3: folds 
Uncalled bet ($0.12) returned to Tilinimus007
Tilinimus007 collected $0.25 from pot
Tilinimus007: doesn't show hand 
*** SUMMARY ***
Total pot $0.25 | Rake $0 
Seat 1: Tilinimus007 collected ($0.25)
Seat 2: toxa910212 folded before Flop (didn't bet)
Seat 3: KiraLasVegas folded before Flop (didn't bet)
Seat 4: Gintaras20 (button) folded before Flop (didn't bet)
Seat 5: SkyTaurus (small blind) folded before Flop
Seat 6: Freedom4all3 (big blind) folded before Flop



PokerStars Hand #222980442549:  Hold'em No Limit ($0.05/$0.10 USD) - 2021/01/23 19:47:17 ET
Table 'Demoulina III' 6-max Seat #5 is the button
Seat 1: Tilinimus007 ($12.07 in chips) 
Seat 2: toxa910212 ($12.05 in chips) 
Seat 3: KiraLasVegas ($10.35 in chips) 
Seat 4: Gintaras20 ($19.24 in chips) 
Seat 5: SkyTaurus ($18.05 in chips) 
Seat 6: Freedom4all3 ($11.15 in chips) 
Freedom4all3: posts small blind $0.05
Tilinimus007: posts big blind $0.10
*** HOLE CARDS ***
toxa910212: folds 
KiraLasVegas: raises $0.20 to $0.30
Gintaras20: folds 
SkyTaurus: folds 
Freedom4all3: folds 
Tilinimus007: folds 
Uncalled bet ($0.20) returned to KiraLasVegas
KiraLasVegas collected $0.25 from pot
KiraLasVegas: doesn't show hand 
*** SUMMARY ***
Total pot $0.25 | Rake $0 
Seat 1: Tilinimus007 (big blind) folded before Flop
Seat 2: toxa910212 folded before Flop (didn't bet)
Seat 3: KiraLasVegas collected ($0.25)
Seat 4: Gintaras20 folded before Flop (didn't bet)
Seat 5: SkyTaurus (button) folded before Flop (didn't bet)
Seat 6: Freedom4all3 (small blind) folded before Flop



PokerStars Hand #222980448619:  Hold'em No Limit ($0.05/$0.10 USD) - 2021/01/23 19:47:30 ET
Table 'Demoulina III' 6-max Seat #6 is the button
Seat 1: Tilinimus007 ($11.97 in chips) 
Seat 2: toxa910212 ($12.05 in chips) 
Seat 3: KiraLasVegas ($10.50 in chips) 
Seat 4: Gintaras20 ($19.24 in chips) 
Seat 5: SkyTaurus ($18.05 in chips) 
Seat 6: Freedom4all3 ($11.10 in chips) 
Tilinimus007: posts small blind $0.05
toxa910212: posts big blind $0.10
*** HOLE CARDS ***
KiraLasVegas: folds 
KiraLasVegas leaves the table
Gintaras20: raises $0.15 to $0.25
SkyTaurus: folds 
Freedom4all3: folds 
Tilinimus007: calls $0.20
toxa910212: calls $0.15
*** FLOP *** [Td Ts 6s]
E2AS joins the table at seat #3 
Tilinimus007: checks 
toxa910212: checks 
Gintaras20: bets $0.36
Tilinimus007: folds 
toxa910212: folds 
Uncalled bet ($0.36) returned to Gintaras20
Gintaras20 collected $0.72 from pot
Gintaras20: doesn't show hand 
*** SUMMARY ***
Total pot $0.75 | Rake $0.03 
Board [Td Ts 6s]
Seat 1: Tilinimus007 (small blind) folded on the Flop
Seat 2: toxa910212 (big blind) folded on the Flop
Seat 3: KiraLasVegas folded before Flop (didn't bet)
Seat 4: Gintaras20 collected ($0.72)
Seat 5: SkyTaurus folded before Flop (didn't bet)
Seat 6: Freedom4all3 (button) folded before Flop (didn't bet)



PokerStars Hand #222980465688:  Hold'em No Limit ($0.05/$0.10 USD) - 2021/01/23 19:48:05 ET
Table 'Demoulina III' 6-max Seat #1 is the button
Seat 1: Tilinimus007 ($11.72 in chips) 
Seat 2: toxa910212 ($11.80 in chips) 
Seat 3: E2AS ($5 in chips) 
Seat 4: Gintaras20 ($19.71 in chips) 
Seat 5: SkyTaurus ($18.05 in chips) 
Seat 6: Freedom4all3 ($11.10 in chips) 
toxa910212: posts small blind $0.05
E2AS: posts big blind $0.10
*** HOLE CARDS ***
Gintaras20: folds 
SkyTaurus: folds 
Freedom4all3: folds 
Tilinimus007: folds 
toxa910212: folds 
Uncalled bet ($0.05) returned to E2AS
E2AS collected $0.10 from pot
E2AS: doesn't show hand 
*** SUMMARY ***
Total pot $0.10 | Rake $0 
Seat 1: Tilinimus007 (button) folded before Flop (didn't bet)
Seat 2: toxa910212 (small blind) folded before Flop
Seat 3: E2AS (big blind) collected ($0.10)
Seat 4: Gintaras20 folded before Flop (didn't bet)
Seat 5: SkyTaurus folded before Flop (didn't bet)
Seat 6: Freedom4all3 folded before Flop (didn't bet)



PokerStars Hand #222980470030:  Hold'em No Limit ($0.05/$0.10 USD) - 2021/01/23 19:48:14 ET
Table 'Demoulina III' 6-max Seat #2 is the button
Seat 1: Tilinimus007 ($11.72 in chips) 
Seat 2: toxa910212 ($11.75 in chips) 
Seat 3: E2AS ($5.05 in chips) 
Seat 4: Gintaras20 ($19.71 in chips) 
Seat 5: SkyTaurus ($18.05 in chips) 
Seat 6: Freedom4all3 ($11.10 in chips) 
E2AS: posts small blind $0.05
Gintaras20: posts big blind $0.10
*** HOLE CARDS ***
SkyTaurus: folds 
Freedom4all3: folds 
Tilinimus007: raises $0.12 to $0.22
toxa910212: folds 
E2AS: folds 
Gintaras20: calls $0.12
*** FLOP *** [Jh 8h 5c]
Gintaras20: checks 
Tilinimus007: bets $0.19
Gintaras20: raises $0.43 to $0.62
Tilinimus007: calls $0.43
*** TURN *** [Jh 8h 5c] [Qs]
Gintaras20: bets $0.83
Tilinimus007: folds 
Uncalled bet ($0.83) returned to Gintaras20
Gintaras20 collected $1.65 from pot
Gintaras20: doesn't show hand 
*** SUMMARY ***
Total pot $1.73 | Rake $0.08 
Board [Jh 8h 5c Qs]
Seat 1: Tilinimus007 folded on the Turn
Seat 2: toxa910212 (button) folded before Flop (didn't bet)
Seat 3: E2AS (small blind) folded before Flop
Seat 4: Gintaras20 (big blind) collected ($1.65)
Seat 5: SkyTaurus folded before Flop (didn't bet)
Seat 6: Freedom4all3 folded before Flop (didn't bet)



PokerStars Hand #222980487431:  Hold'em No Limit ($0.05/$0.10 USD) - 2021/01/23 19:48:50 ET
Table 'Demoulina III' 6-max Seat #3 is the button
Seat 1: Tilinimus007 ($10.88 in chips) 
Seat 2: toxa910212 ($11.75 in chips) 
Seat 3: E2AS ($5 in chips) 
Seat 4: Gintaras20 ($20.52 in chips) 
Seat 5: SkyTaurus ($18.05 in chips) 
Seat 6: Freedom4all3 ($11.10 in chips) 
Gintaras20: posts small blind $0.05
SkyTaurus: posts big blind $0.10
*** HOLE CARDS ***
Freedom4all3: folds 
Tilinimus007: folds 
toxa910212: raises $0.15 to $0.25
E2AS: calls $0.25
Gintaras20: calls $0.20
SkyTaurus: calls $0.15
*** FLOP *** [8s Td Qc]
Gintaras20: checks 
SkyTaurus: bets $0.53
toxa910212: calls $0.53
E2AS: folds 
Gintaras20: folds 
*** TURN *** [8s Td Qc] [6s]
SkyTaurus: bets $1.30
toxa910212: folds 
Uncalled bet ($1.30) returned to SkyTaurus
SkyTaurus collected $1.97 from pot
*** SUMMARY ***
Total pot $2.06 | Rake $0.09 
Board [8s Td Qc 6s]
Seat 1: Tilinimus007 folded before Flop (didn't bet)
Seat 2: toxa910212 folded on the Turn
Seat 3: E2AS (button) folded on the Flop
Seat 4: Gintaras20 (small blind) folded on the Flop
Seat 5: SkyTaurus (big blind) collected ($1.97)
Seat 6: Freedom4all3 folded before Flop (didn't bet)



PokerStars Hand #222980504963:  Hold'em No Limit ($0.05/$0.10 USD) - 2021/01/23 19:49:27 ET
Table 'Demoulina III' 6-max Seat #4 is the button
Seat 1: Tilinimus007 ($10.88 in chips) 
Seat 2: toxa910212 ($10.97 in chips) 
Seat 3: E2AS ($4.75 in chips) 
Seat 4: Gintaras20 ($20.27 in chips) 
Seat 5: SkyTaurus ($19.24 in chips) 
Seat 6: Freedom4all3 ($11.10 in chips) 
SkyTaurus: posts small blind $0.05
Freedom4all3: posts big blind $0.10
*** HOLE CARDS ***
Tilinimus007: raises $0.12 to $0.22
toxa910212: folds 
E2AS: folds 
Gintaras20: folds 
SkyTaurus: folds 
Freedom4all3: calls $0.12
*** FLOP *** [8c Ac 3s]
Freedom4all3: checks 
Tilinimus007: bets $0.19
Freedom4all3: folds 
Uncalled bet ($0.19) returned to Tilinimus007
Tilinimus007 collected $0.47 from pot
Tilinimus007: doesn't show hand 
*** SUMMARY ***
Total pot $0.49 | Rake $0.02 
Board [8c Ac 3s]
Seat 1: Tilinimus007 collected ($0.47)
Seat 2: toxa910212 folded before Flop (didn't bet)
Seat 3: E2AS folded before Flop (didn't bet)
Seat 4: Gintaras20 (button) folded before Flop (didn't bet)
Seat 5: SkyTaurus (small blind) folded before Flop
Seat 6: Freedom4all3 (big blind) folded on the Flop



PokerStars Hand #222980519215:  Hold'em No Limit ($0.05/$0.10 USD) - 2021/01/23 19:49:56 ET
Table 'Demoulina III' 6-max Seat #5 is the button
Seat 1: Tilinimus007 ($11.13 in chips) 
Seat 2: toxa910212 ($10.97 in chips) 
Seat 3: E2AS ($4.75 in chips) 
Seat 4: Gintaras20 ($20.27 in chips) 
Seat 5: SkyTaurus ($19.19 in chips) 
Seat 6: Freedom4all3 ($10.88 in chips) 
Freedom4all3: posts small blind $0.05
Tilinimus007: posts big blind $0.10
*** HOLE CARDS ***
toxa910212: folds 
E2AS: folds 
Gintaras20: folds 
SkyTaurus: folds 
Freedom4all3: folds 
Uncalled bet ($0.05) returned to Tilinimus007
Tilinimus007 collected $0.10 from pot
Tilinimus007: doesn't show hand 
*** SUMMARY ***
Total pot $0.10 | Rake $0 
Seat 1: Tilinimus007 (big blind) collected ($0.10)
Seat 2: toxa910212 folded before Flop (didn't bet)
Seat 3: E2AS folded before Flop (didn't bet)
Seat 4: Gintaras20 folded before Flop (didn't bet)
Seat 5: SkyTaurus (button) folded before Flop (didn't bet)
Seat 6: Freedom4all3 (small blind) folded before Flop



PokerStars Hand #222980522388:  Hold'em No Limit ($0.05/$0.10 USD) - 2021/01/23 19:50:03 ET
Table 'Demoulina III' 6-max Seat #6 is the button
Seat 1: Tilinimus007 ($11.18 in chips) 
Seat 2: toxa910212 ($10.97 in chips) 
Seat 3: E2AS ($4.75 in chips) 
Seat 4: Gintaras20 ($20.27 in chips) 
Seat 5: SkyTaurus ($19.19 in chips) 
Seat 6: Freedom4all3 ($10.83 in chips) 
Tilinimus007: posts small blind $0.05
toxa910212: posts big blind $0.10
*** HOLE CARDS ***
E2AS: folds 
Gintaras20: raises $0.15 to $0.25
SkyTaurus: folds 
Freedom4all3: folds 
Tilinimus007: folds 
toxa910212: calls $0.15
*** FLOP *** [6c 4c 9s]
toxa910212: checks 
Gintaras20: bets $0.40
toxa910212: calls $0.40
*** TURN *** [6c 4c 9s] [8c]
toxa910212: checks 
Gintaras20: bets $0.97
toxa910212: folds 
Uncalled bet ($0.97) returned to Gintaras20
Gintaras20 collected $1.29 from pot
Gintaras20: doesn't show hand 
*** SUMMARY ***
Total pot $1.35 | Rake $0.06 
Board [6c 4c 9s 8c]
Seat 1: Tilinimus007 (small blind) folded before Flop
Seat 2: toxa910212 (big blind) folded on the Turn
Seat 3: E2AS folded before Flop (didn't bet)
Seat 4: Gintaras20 collected ($1.29)
Seat 5: SkyTaurus folded before Flop (didn't bet)
Seat 6: Freedom4all3 (button) folded before Flop (didn't bet)



PokerStars Hand #222980537277:  Hold'em No Limit ($0.05/$0.10 USD) - 2021/01/23 19:50:35 ET
Table 'Demoulina III' 6-max Seat #1 is the button
Seat 1: Tilinimus007 ($11.13 in chips) 
Seat 2: toxa910212 ($10.32 in chips) 
Seat 3: E2AS ($4.75 in chips) 
Seat 4: Gintaras20 ($20.91 in chips) 
Seat 5: SkyTaurus ($19.19 in chips) 
Seat 6: Freedom4all3 ($10.83 in chips) 
toxa910212: posts small blind $0.05
E2AS: posts big blind $0.10
*** HOLE CARDS ***
Gintaras20: folds 
SkyTaurus: raises $0.20 to $0.30
Freedom4all3: folds 
Tilinimus007: folds 
toxa910212: folds 
E2AS: folds 
Uncalled bet ($0.20) returned to SkyTaurus
SkyTaurus collected $0.25 from pot
*** SUMMARY ***
Total pot $0.25 | Rake $0 
Seat 1: Tilinimus007 (button) folded before Flop (didn't bet)
Seat 2: toxa910212 (small blind) folded before Flop
Seat 3: E2AS (big blind) folded before Flop
Seat 4: Gintaras20 folded before Flop (didn't bet)
Seat 5: SkyTaurus collected ($0.25)
Seat 6: Freedom4all3 folded before Flop (didn't bet)



PokerStars Hand #222980543418:  Hold'em No Limit ($0.05/$0.10 USD) - 2021/01/23 19:50:47 ET
Table 'Demoulina III' 6-max Seat #2 is the button
Seat 1: Tilinimus007 ($11.13 in chips) 
Seat 2: toxa910212 ($10.27 in chips) 
Seat 3: E2AS ($4.65 in chips) 
Seat 4: Gintaras20 ($20.91 in chips) 
Seat 5: SkyTaurus ($19.34 in chips) 
Seat 6: Freedom4all3 ($10.83 in chips) 
E2AS: posts small blind $0.05
Gintaras20: posts big blind $0.10
*** HOLE CARDS ***
SkyTaurus: folds 
Freedom4all3: folds 
Tilinimus007: raises $0.12 to $0.22
toxa910212: folds 
E2AS: folds 
Gintaras20: calls $0.12
*** FLOP *** [Jh 2d 3d]
Gintaras20: bets $0.24
Tilinimus007: calls $0.24
*** TURN *** [Jh 2d 3d] [7c]
Gintaras20: bets $0.47
Tilinimus007: folds 
Uncalled bet ($0.47) returned to Gintaras20
Gintaras20 collected $0.93 from pot
Gintaras20: doesn't show hand 
*** SUMMARY ***
Total pot $0.97 | Rake $0.04 
Board [Jh 2d 3d 7c]
Seat 1: Tilinimus007 folded on the Turn
Seat 2: toxa910212 (button) folded before Flop (didn't bet)
Seat 3: E2AS (small blind) folded before Flop
Seat 4: Gintaras20 (big blind) collected ($0.93)
Seat 5: SkyTaurus folded before Flop (didn't bet)
Seat 6: Freedom4all3 folded before Flop (didn't bet)



PokerStars Hand #222980559347:  Hold'em No Limit ($0.05/$0.10 USD) - 2021/01/23 19:51:21 ET
Table 'Demoulina III' 6-max Seat #3 is the button
Seat 1: Tilinimus007 ($10.67 in chips) 
Seat 2: toxa910212 ($10.27 in chips) 
Seat 3: E2AS ($4.60 in chips) 
Seat 4: Gintaras20 ($21.38 in chips) 
Seat 5: SkyTaurus ($19.34 in chips) 
Seat 6: Freedom4all3 ($10.83 in chips) 
Gintaras20: posts small blind $0.05
SkyTaurus: posts big blind $0.10
*** HOLE CARDS ***
Freedom4all3: folds 
Tilinimus007: folds 
toxa910212: raises $0.20 to $0.30
E2AS: folds 
Gintaras20: folds 
SkyTaurus: folds 
Uncalled bet ($0.20) returned to toxa910212
toxa910212 collected $0.25 from pot
toxa910212: doesn't show hand 
*** SUMMARY ***
Total pot $0.25 | Rake $0 
Seat 1: Tilinimus007 folded before Flop (didn't bet)
Seat 2: toxa910212 collected ($0.25)
Seat 3: E2AS (button) folded before Flop (didn't bet)
Seat 4: Gintaras20 (small blind) folded before Flop
Seat 5: SkyTaurus (big blind) folded before Flop
Seat 6: Freedom4all3 folded before Flop (didn't bet)



PokerStars Hand #222980564369:  Hold'em No Limit ($0.05/$0.10 USD) - 2021/01/23 19:51:32 ET
Table 'Demoulina III' 6-max Seat #4 is the button
Seat 1: Tilinimus007 ($10.67 in chips) 
Seat 2: toxa910212 ($10.42 in chips) 
Seat 3: E2AS ($4.60 in chips) 
Seat 4: Gintaras20 ($21.33 in chips) 
Seat 5: SkyTaurus ($19.24 in chips) 
Seat 6: Freedom4all3 ($10.83 in chips) 
SkyTaurus: posts small blind $0.05
Freedom4all3: posts big blind $0.10
*** HOLE CARDS ***
Tilinimus007: folds 
toxa910212: folds 
E2AS: raises $0.14 to $0.24
Gintaras20: raises $0.36 to $0.60
SkyTaurus: folds 
Freedom4all3: folds 
E2AS: calls $0.36
*** FLOP *** [6d 9s 4d]
E2AS: checks 
Gintaras20: bets $0.97
E2AS: calls $0.97
*** TURN *** [6d 9s 4d] [Td]
E2AS: checks 
Gintaras20: bets $2.36
E2AS: folds 
Uncalled bet ($2.36) returned to Gintaras20
Gintaras20 collected $3.14 from pot
Gintaras20: doesn't show hand 
*** SUMMARY ***
Total pot $3.29 | Rake $0.15 
Board [6d 9s 4d Td]
Seat 1: Tilinimus007 folded before Flop (didn't bet)
Seat 2: toxa910212 folded before Flop (didn't bet)
Seat 3: E2AS folded on the Turn
Seat 4: Gintaras20 (button) collected ($3.14)
Seat 5: SkyTaurus (small blind) folded before Flop
Seat 6: Freedom4all3 (big blind) folded before Flop



PokerStars Hand #222980585622:  Hold'em No Limit ($0.05/$0.10 USD) - 2021/01/23 19:52:17 ET
Table 'Demoulina III' 6-max Seat #5 is the button
Seat 1: Tilinimus007 ($10.67 in chips) 
Seat 2: toxa910212 ($10.42 in chips) 
Seat 3: E2AS ($3.03 in chips) 
Seat 4: Gintaras20 ($22.90 in chips) 
Seat 5: SkyTaurus ($19.19 in chips) 
Seat 6: Freedom4all3 ($10.73 in chips) 
Freedom4all3: posts small blind $0.05
Tilinimus007: posts big blind $0.10
*** HOLE CARDS ***
toxa910212: folds 
E2AS: folds 
Gintaras20: folds 
SkyTaurus: folds 
Freedom4all3: raises $0.20 to $0.30
Tilinimus007: raises $0.60 to $0.90
Freedom4all3: calls $0.60
*** FLOP *** [Jd 2h 2c]
Freedom4all3: checks 
Tilinimus007: bets $0.89
Freedom4all3: raises $0.89 to $1.78
Tilinimus007: calls $0.89
*** TURN *** [Jd 2h 2c] [6d]
Freedom4all3: bets $2.86
Tilinimus007: folds 
Uncalled bet ($2.86) returned to Freedom4all3
Freedom4all3 collected $5.12 from pot
Freedom4all3: doesn't show hand 
*** SUMMARY ***
Total pot $5.36 | Rake $0.24 
Board [Jd 2h 2c 6d]
Seat 1: Tilinimus007 (big blind) folded on the Turn
Seat 2: toxa910212 folded before Flop (didn't bet)
Seat 3: E2AS folded before Flop (didn't bet)
Seat 4: Gintaras20 folded before Flop (didn't bet)
Seat 5: SkyTaurus (button) folded before Flop (didn't bet)
Seat 6: Freedom4all3 (small blind) collected ($5.12)



PokerStars Hand #222980616056:  Hold'em No Limit ($0.05/$0.10 USD) - 2021/01/23 19:53:21 ET
Table 'Demoulina III' 6-max Seat #6 is the button
Seat 1: Tilinimus007 ($10 in chips) 
Seat 2: toxa910212 ($10.42 in chips) 
Seat 3: E2AS ($3.03 in chips) 
Seat 4: Gintaras20 ($22.90 in chips) 
Seat 5: SkyTaurus ($19.19 in chips) 
Seat 6: Freedom4all3 ($13.17 in chips) 
Tilinimus007: posts small blind $0.05
toxa910212: posts big blind $0.10
*** HOLE CARDS ***
E2AS: folds 
Gintaras20: raises $0.15 to $0.25
SkyTaurus: folds 
Freedom4all3: calls $0.25
Tilinimus007: folds 
toxa910212: folds 
*** FLOP *** [Th Jd Qs]
Gintaras20: bets $0.47
Freedom4all3: folds 
Uncalled bet ($0.47) returned to Gintaras20
Gintaras20 collected $0.62 from pot
Gintaras20: doesn't show hand 
*** SUMMARY ***
Total pot $0.65 | Rake $0.03 
Board [Th Jd Qs]
Seat 1: Tilinimus007 (small blind) folded before Flop
Seat 2: toxa910212 (big blind) folded before Flop
Seat 3: E2AS folded before Flop (didn't bet)
Seat 4: Gintaras20 collected ($0.62)
Seat 5: SkyTaurus folded before Flop (didn't bet)
Seat 6: Freedom4all3 (button) folded on the Flop



PokerStars Hand #222980628517:  Hold'em No Limit ($0.05/$0.10 USD) - 2021/01/23 19:53:48 ET
Table 'Demoulina III' 6-max Seat #1 is the button
Seat 1: Tilinimus007 ($10 in chips) 
Seat 2: toxa910212 ($10.32 in chips) 
Seat 3: E2AS ($3.03 in chips) 
Seat 4: Gintaras20 ($23.27 in chips) 
Seat 5: SkyTaurus ($19.19 in chips) 
Seat 6: Freedom4all3 ($12.92 in chips) 
toxa910212: posts small blind $0.05
E2AS: posts big blind $0.10
*** HOLE CARDS ***
Gintaras20: folds 
SkyTaurus: folds 
Freedom4all3: folds 
Tilinimus007: folds 
toxa910212: folds 
Uncalled bet ($0.05) returned to E2AS
E2AS collected $0.10 from pot
E2AS: doesn't show hand 
*** SUMMARY ***
Total pot $0.10 | Rake $0 
Seat 1: Tilinimus007 (button) folded before Flop (didn't bet)
Seat 2: toxa910212 (small blind) folded before Flop
Seat 3: E2AS (big blind) collected ($0.10)
Seat 4: Gintaras20 folded before Flop (didn't bet)
Seat 5: SkyTaurus folded before Flop (didn't bet)
Seat 6: Freedom4all3 folded before Flop (didn't bet)



PokerStars Hand #222980633519:  Hold'em No Limit ($0.05/$0.10 USD) - 2021/01/23 19:53:58 ET
Table 'Demoulina III' 6-max Seat #2 is the button
Seat 1: Tilinimus007 ($10 in chips) 
Seat 2: toxa910212 ($10.27 in chips) 
Seat 3: E2AS ($3.08 in chips) 
Seat 4: Gintaras20 ($23.27 in chips) 
Seat 5: SkyTaurus ($19.19 in chips) 
Seat 6: Freedom4all3 ($12.92 in chips) 
E2AS: posts small blind $0.05
Gintaras20: posts big blind $0.10
*** HOLE CARDS ***
SkyTaurus: folds 
Freedom4all3: folds 
Tilinimus007: raises $0.12 to $0.22
toxa910212: folds 
E2AS: folds 
Gintaras20: folds 
Uncalled bet ($0.12) returned to Tilinimus007
Tilinimus007 collected $0.25 from pot
Tilinimus007: doesn't show hand 
*** SUMMARY ***
Total pot $0.25 | Rake $0 
Seat 1: Tilinimus007 collected ($0.25)
Seat 2: toxa910212 (button) folded before Flop (didn't bet)
Seat 3: E2AS (small blind) folded before Flop
Seat 4: Gintaras20 (big blind) folded before Flop
Seat 5: SkyTaurus folded before Flop (didn't bet)
Seat 6: Freedom4all3 folded before Flop (didn't bet)



PokerStars Hand #222980646110:  Hold'em No Limit ($0.05/$0.10 USD) - 2021/01/23 19:54:25 ET
Table 'Demoulina III' 6-max Seat #4 is the button
Seat 1: Tilinimus007 ($10.30 in chips) 
Seat 2: toxa910212 ($10.27 in chips) 
Seat 3: E2AS ($3.03 in chips) 
Seat 4: Gintaras20 ($23.12 in chips) 
Seat 5: SkyTaurus ($19.09 in chips) 
Seat 6: Freedom4all3 ($12.92 in chips) 
SkyTaurus: posts small blind $0.05
Freedom4all3: posts big blind $0.10
*** HOLE CARDS ***
Tilinimus007: raises $0.12 to $0.22
toxa910212: folds 
E2AS: folds 
Gintaras20: calls $0.22
SkyTaurus: folds 
Freedom4all3: folds 
*** FLOP *** [Qh 7h Ts]
Tilinimus007: bets $0.23
Gintaras20: folds 
Uncalled bet ($0.23) returned to Tilinimus007
Tilinimus007 collected $0.56 from pot
Tilinimus007: doesn't show hand 
*** SUMMARY ***
Total pot $0.59 | Rake $0.03 
Board [Qh 7h Ts]
Seat 1: Tilinimus007 collected ($0.56)
Seat 2: toxa910212 folded before Flop (didn't bet)
Seat 3: E2AS folded before Flop (didn't bet)
Seat 4: Gintaras20 (button) folded on the Flop
Seat 5: SkyTaurus (small blind) folded before Flop
Seat 6: Freedom4all3 (big blind) folded before Flop



PokerStars Hand #222980657051:  Hold'em No Limit ($0.05/$0.10 USD) - 2021/01/23 19:54:49 ET
Table 'Demoulina III' 6-max Seat #5 is the button
Seat 1: Tilinimus007 ($10.64 in chips) 
Seat 2: toxa910212 ($10.27 in chips) 
Seat 3: E2AS ($3.03 in chips) 
Seat 4: Gintaras20 ($22.90 in chips) 
Seat 5: SkyTaurus ($19.04 in chips) 
Seat 6: Freedom4all3 ($12.82 in chips) 
Freedom4all3: posts small blind $0.05
Tilinimus007: posts big blind $0.10
*** HOLE CARDS ***
toxa910212: raises $0.15 to $0.25
E2AS: folds 
Gintaras20: calls $0.25
SkyTaurus: folds 
Freedom4all3: raises $0.85 to $1.10
Tilinimus007: folds 
toxa910212: folds 
Gintaras20: calls $0.85
*** FLOP *** [3c 2c Qh]
Freedom4all3: bets $1.22
Gintaras20: calls $1.22
*** TURN *** [3c 2c Qh] [Td]
Freedom4all3: bets $2.38
Gintaras20: calls $2.38
*** RIVER *** [3c 2c Qh Td] [Jc]
Freedom4all3: checks 
Gintaras20: bets $18.20 and is all-in
Freedom4all3: calls $8.12 and is all-in
Uncalled bet ($10.08) returned to Gintaras20
*** SHOW DOWN ***
Gintaras20: shows [5s 5d] (a pair of Fives)
Freedom4all3: shows [Kd Ad] (a straight, Ten to Ace)
Freedom4all3 collected $24.82 from pot
*** SUMMARY ***
Total pot $25.99 | Rake $1.17 
Board [3c 2c Qh Td Jc]
Seat 1: Tilinimus007 (big blind) folded before Flop
Seat 2: toxa910212 folded before Flop
Seat 3: E2AS folded before Flop (didn't bet)
Seat 4: Gintaras20 showed [5s 5d] and lost with a pair of Fives
Seat 5: SkyTaurus (button) folded before Flop (didn't bet)
Seat 6: Freedom4all3 (small blind) showed [Kd Ad] and won ($24.82) with a straight, Ten to Ace



PokerStars Hand #222980681199:  Hold'em No Limit ($0.05/$0.10 USD) - 2021/01/23 19:55:50 ET
Table 'Demoulina III' 6-max Seat #6 is the button
Seat 1: Tilinimus007 ($10.54 in chips) 
Seat 2: toxa910212 ($10.02 in chips) 
Seat 3: E2AS ($3.03 in chips) 
Seat 4: Gintaras20 ($10.08 in chips) 
Seat 5: SkyTaurus ($19.04 in chips) 
Seat 6: Freedom4all3 ($24.82 in chips) 
Tilinimus007: posts small blind $0.05
toxa910212: posts big blind $0.10
*** HOLE CARDS ***
E2AS: folds 
Gintaras20: folds 
SkyTaurus: folds 
Freedom4all3: folds 
Tilinimus007: raises $0.20 to $0.30
toxa910212: calls $0.20
*** FLOP *** [6s 4h Qd]
Tilinimus007: bets $0.23
toxa910212: folds 
Uncalled bet ($0.23) returned to Tilinimus007
Tilinimus007 collected $0.57 from pot
Tilinimus007: doesn't show hand 
*** SUMMARY ***
Total pot $0.60 | Rake $0.03 
Board [6s 4h Qd]
Seat 1: Tilinimus007 (small blind) collected ($0.57)
Seat 2: toxa910212 (big blind) folded on the Flop
Seat 3: E2AS folded before Flop (didn't bet)
Seat 4: Gintaras20 folded before Flop (didn't bet)
Seat 5: SkyTaurus folded before Flop (didn't bet)
Seat 6: Freedom4all3 (button) folded before Flop (didn't bet)



PokerStars Hand #222980689508:  Hold'em No Limit ($0.05/$0.10 USD) - 2021/01/23 19:56:13 ET
Table 'Demoulina III' 6-max Seat #1 is the button
Seat 1: Tilinimus007 ($10.81 in chips) 
Seat 2: toxa910212 ($10 in chips) 
Seat 3: E2AS ($3.03 in chips) 
Seat 4: Gintaras20 ($10.08 in chips) 
Seat 5: SkyTaurus ($19.04 in chips) 
Seat 6: Freedom4all3 ($24.82 in chips) 
toxa910212: posts small blind $0.05
E2AS: posts big blind $0.10
*** HOLE CARDS ***
Gintaras20: raises $0.15 to $0.25
SkyTaurus: folds 
Freedom4all3: folds 
Tilinimus007: folds 
toxa910212: folds 
E2AS: calls $0.15
*** FLOP *** [As Qc 8c]
E2AS: checks 
Gintaras20: bets $0.40
E2AS: folds 
Uncalled bet ($0.40) returned to Gintaras20
Gintaras20 collected $0.53 from pot
Gintaras20: doesn't show hand 
*** SUMMARY ***
Total pot $0.55 | Rake $0.02 
Board [As Qc 8c]
Seat 1: Tilinimus007 (button) folded before Flop (didn't bet)
Seat 2: toxa910212 (small blind) folded before Flop
Seat 3: E2AS (big blind) folded on the Flop
Seat 4: Gintaras20 collected ($0.53)
Seat 5: SkyTaurus folded before Flop (didn't bet)
Seat 6: Freedom4all3 folded before Flop (didn't bet)



PokerStars Hand #222980698488:  Hold'em No Limit ($0.05/$0.10 USD) - 2021/01/23 19:56:38 ET
Table 'Demoulina III' 6-max Seat #2 is the button
Seat 1: Tilinimus007 ($10.81 in chips) 
Seat 2: toxa910212 ($10 in chips) 
Seat 3: E2AS ($2.78 in chips) 
Seat 4: Gintaras20 ($10.36 in chips) 
Seat 5: SkyTaurus ($19.04 in chips) 
Seat 6: Freedom4all3 ($24.82 in chips) 
E2AS: posts small blind $0.05
Gintaras20: posts big blind $0.10
*** HOLE CARDS ***
SkyTaurus: raises $0.20 to $0.30
Freedom4all3: folds 
Tilinimus007: folds 
toxa910212: folds 
E2AS: calls $0.25
Gintaras20: folds 
*** FLOP *** [Jh 8c 3d]
E2AS: checks 
SkyTaurus: checks 
*** TURN *** [Jh 8c 3d] [Ah]
E2AS: bets $0.40
SkyTaurus: calls $0.40
*** RIVER *** [Jh 8c 3d Ah] [7h]
E2AS: bets $0.72
SkyTaurus: calls $0.72
*** SHOW DOWN ***
E2AS: shows [Qc Tc] (high card Ace)
SkyTaurus: shows [Qs As] (a pair of Aces)
SkyTaurus collected $2.81 from pot
*** SUMMARY ***
Total pot $2.94 | Rake $0.13 
Board [Jh 8c 3d Ah 7h]
Seat 1: Tilinimus007 folded before Flop (didn't bet)
Seat 2: toxa910212 (button) folded before Flop (didn't bet)
Seat 3: E2AS (small blind) showed [Qc Tc] and lost with high card Ace
Seat 4: Gintaras20 (big blind) folded before Flop
Seat 5: SkyTaurus showed [Qs As] and won ($2.81) with a pair of Aces
Seat 6: Freedom4all3 folded before Flop (didn't bet)



PokerStars Hand #222980717341:  Hold'em No Limit ($0.05/$0.10 USD) - 2021/01/23 19:57:30 ET
Table 'Demoulina III' 6-max Seat #3 is the button
Seat 1: Tilinimus007 ($10.81 in chips) 
Seat 2: toxa910212 ($10 in chips) 
Seat 3: E2AS ($1.36 in chips) 
Seat 4: Gintaras20 ($10.26 in chips) 
Seat 5: SkyTaurus ($20.43 in chips) 
Seat 6: Freedom4all3 ($24.82 in chips) 
Gintaras20: posts small blind $0.05
SkyTaurus: posts big blind $0.10
*** HOLE CARDS ***
Freedom4all3: folds 
Tilinimus007: folds 
toxa910212: raises $0.15 to $0.25
E2AS: folds 
Gintaras20: folds 
SkyTaurus: calls $0.15
*** FLOP *** [2d 4d 2c]
SkyTaurus: checks 
toxa910212: checks 
*** TURN *** [2d 4d 2c] [Ts]
SkyTaurus: checks 
toxa910212: checks 
*** RIVER *** [2d 4d 2c Ts] [6s]
SkyTaurus: checks 
toxa910212: checks 
*** SHOW DOWN ***
SkyTaurus: shows [7d Ah] (a pair of Deuces)
toxa910212: shows [Ad 9h] (a pair of Deuces - Ace+Ten+Nine kicker)
toxa910212 collected $0.53 from pot
*** SUMMARY ***
Total pot $0.55 | Rake $0.02 
Board [2d 4d 2c Ts 6s]
Seat 1: Tilinimus007 folded before Flop (didn't bet)
Seat 2: toxa910212 showed [Ad 9h] and won ($0.53) with a pair of Deuces
Seat 3: E2AS (button) folded before Flop (didn't bet)
Seat 4: Gintaras20 (small blind) folded before Flop
Seat 5: SkyTaurus (big blind) showed [7d Ah] and lost with a pair of Deuces
Seat 6: Freedom4all3 folded before Flop (didn't bet)



PokerStars Hand #222980726684:  Hold'em No Limit ($0.05/$0.10 USD) - 2021/01/23 19:57:56 ET
Table 'Demoulina III' 6-max Seat #4 is the button
Seat 1: Tilinimus007 ($10.81 in chips) 
Seat 2: toxa910212 ($10.28 in chips) 
Seat 3: E2AS ($1.36 in chips) 
Seat 4: Gintaras20 ($10.21 in chips) 
Seat 5: SkyTaurus ($20.18 in chips) 
Seat 6: Freedom4all3 ($24.82 in chips) 
SkyTaurus: posts small blind $0.05
Freedom4all3: posts big blind $0.10
*** HOLE CARDS ***
Tilinimus007: folds 
toxa910212: folds 
E2AS: folds 
Gintaras20: raises $0.15 to $0.25
SkyTaurus: folds 
Freedom4all3: calls $0.15
*** FLOP *** [8h Td Qh]
Freedom4all3: checks 
Gintaras20: bets $0.40
Freedom4all3: raises $0.67 to $1.07
Gintaras20: raises $1.34 to $2.41
Freedom4all3: calls $1.34
*** TURN *** [8h Td Qh] [Ah]
Freedom4all3: checks 
Gintaras20: checks 
*** RIVER *** [8h Td Qh Ah] [5d]
Freedom4all3: checks 
Gintaras20: bets $2.57
Freedom4all3: calls $2.57
*** SHOW DOWN ***
Gintaras20: shows [Kh Jh] (a flush, Ace high)
Freedom4all3: mucks hand 
Gintaras20 collected $10.04 from pot
*** SUMMARY ***
Total pot $10.51 | Rake $0.47 
Board [8h Td Qh Ah 5d]
Seat 1: Tilinimus007 folded before Flop (didn't bet)
Seat 2: toxa910212 folded before Flop (didn't bet)
Seat 3: E2AS folded before Flop (didn't bet)
Seat 4: Gintaras20 (button) showed [Kh Jh] and won ($10.04) with a flush, Ace high
Seat 5: SkyTaurus (small blind) folded before Flop
Seat 6: Freedom4all3 (big blind) mucked



PokerStars Hand #222980745345:  Hold'em No Limit ($0.05/$0.10 USD) - 2021/01/23 19:58:48 ET
Table 'Demoulina III' 6-max Seat #5 is the button
Seat 1: Tilinimus007 ($10.81 in chips) 
Seat 2: toxa910212 ($10.28 in chips) 
Seat 3: E2AS ($1.36 in chips) 
Seat 4: Gintaras20 ($15.02 in chips) 
Seat 5: SkyTaurus ($20.13 in chips) 
Seat 6: Freedom4all3 ($19.59 in chips) 
Freedom4all3: posts small blind $0.05
Tilinimus007: posts big blind $0.10
*** HOLE CARDS ***
toxa910212: raises $0.15 to $0.25
E2AS: raises $1.11 to $1.36 and is all-in
Gintaras20: calls $1.36
SkyTaurus: folds 
Freedom4all3: folds 
Tilinimus007: folds 
toxa910212: folds 
*** FLOP *** [Jd 8h 9s]
*** TURN *** [Jd 8h 9s] [3h]
*** RIVER *** [Jd 8h 9s 3h] [9c]
*** SHOW DOWN ***
E2AS: shows [Jc Ad] (two pair, Jacks and Nines)
Gintaras20: shows [6s Qs] (a pair of Nines)
E2AS collected $2.98 from pot
*** SUMMARY ***
Total pot $3.12 | Rake $0.14 
Board [Jd 8h 9s 3h 9c]
Seat 1: Tilinimus007 (big blind) folded before Flop
Seat 2: toxa910212 folded before Flop
Seat 3: E2AS showed [Jc Ad] and won ($2.98) with two pair, Jacks and Nines
Seat 4: Gintaras20 showed [6s Qs] and lost with a pair of Nines
Seat 5: SkyTaurus (button) folded before Flop (didn't bet)
Seat 6: Freedom4all3 (small blind) folded before Flop



PokerStars Hand #222980755436:  Hold'em No Limit ($0.05/$0.10 USD) - 2021/01/23 19:59:15 ET
Table 'Demoulina III' 6-max Seat #6 is the button
Seat 1: Tilinimus007 ($10.71 in chips) 
Seat 2: toxa910212 ($10.03 in chips) 
Seat 3: E2AS ($2.98 in chips) 
Seat 4: Gintaras20 ($13.66 in chips) 
Seat 5: SkyTaurus ($20.13 in chips) 
Seat 6: Freedom4all3 ($19.54 in chips) 
Tilinimus007: posts small blind $0.05
toxa910212: posts big blind $0.10
*** HOLE CARDS ***
E2AS: folds 
Gintaras20: folds 
SkyTaurus: folds 
Freedom4all3: folds 
Tilinimus007: raises $0.20 to $0.30
toxa910212: folds 
Uncalled bet ($0.20) returned to Tilinimus007
Tilinimus007 collected $0.20 from pot
Tilinimus007: doesn't show hand 
*** SUMMARY ***
Total pot $0.20 | Rake $0 
Seat 1: Tilinimus007 (small blind) collected ($0.20)
Seat 2: toxa910212 (big blind) folded before Flop
Seat 3: E2AS folded before Flop (didn't bet)
Seat 4: Gintaras20 folded before Flop (didn't bet)
Seat 5: SkyTaurus folded before Flop (didn't bet)
Seat 6: Freedom4all3 (button) folded before Flop (didn't bet)



PokerStars Hand #222980760218:  Hold'em No Limit ($0.05/$0.10 USD) - 2021/01/23 19:59:29 ET
Table 'Demoulina III' 6-max Seat #1 is the button
Seat 1: Tilinimus007 ($10.81 in chips) 
Seat 2: toxa910212 ($10 in chips) 
Seat 3: E2AS ($2.98 in chips) 
Seat 4: Gintaras20 ($13.66 in chips) 
Seat 5: SkyTaurus ($20.13 in chips) 
Seat 6: Freedom4all3 ($19.54 in chips) 
toxa910212: posts small blind $0.05
E2AS: posts big blind $0.10
*** HOLE CARDS ***
Gintaras20: raises $0.15 to $0.25
SkyTaurus: raises $0.55 to $0.80
Freedom4all3: folds 
Tilinimus007: folds 
toxa910212: folds 
E2AS: folds 
Gintaras20: calls $0.55
*** FLOP *** [3h Kc 5h]
Gintaras20: checks 
SkyTaurus: checks 
*** TURN *** [3h Kc 5h] [6h]
Gintaras20: checks 
SkyTaurus: checks 
*** RIVER *** [3h Kc 5h 6h] [Qd]
Gintaras20: checks 
SkyTaurus: checks 
*** SHOW DOWN ***
Gintaras20: shows [7d 9h] (high card King)
SkyTaurus: shows [Qs Ah] (a pair of Queens)
SkyTaurus collected $1.67 from pot
*** SUMMARY ***
Total pot $1.75 | Rake $0.08 
Board [3h Kc 5h 6h Qd]
Seat 1: Tilinimus007 (button) folded before Flop (didn't bet)
Seat 2: toxa910212 (small blind) folded before Flop
Seat 3: E2AS (big blind) folded before Flop
Seat 4: Gintaras20 showed [7d 9h] and lost with high card King
Seat 5: SkyTaurus showed [Qs Ah] and won ($1.67) with a pair of Queens
Seat 6: Freedom4all3 folded before Flop (didn't bet)



PokerStars Hand #222980774932:  Hold'em No Limit ($0.05/$0.10 USD) - 2021/01/23 20:00:08 ET
Table 'Demoulina III' 6-max Seat #2 is the button
Seat 1: Tilinimus007 ($10.81 in chips) 
Seat 2: toxa910212 ($10 in chips) 
Seat 3: E2AS ($2.88 in chips) 
Seat 4: Gintaras20 ($12.86 in chips) 
Seat 5: SkyTaurus ($21 in chips) 
Seat 6: Freedom4all3 ($19.54 in chips) 
E2AS: posts small blind $0.05
Gintaras20: posts big blind $0.10
*** HOLE CARDS ***
SkyTaurus: folds 
Freedom4all3: folds 
Tilinimus007: folds 
toxa910212: folds 
E2AS: raises $0.20 to $0.30
Gintaras20: raises $12.56 to $12.86 and is all-in
E2AS: folds 
Uncalled bet ($12.56) returned to Gintaras20
Gintaras20 collected $0.60 from pot
Gintaras20: doesn't show hand 
*** SUMMARY ***
Total pot $0.60 | Rake $0 
Seat 1: Tilinimus007 folded before Flop (didn't bet)
Seat 2: toxa910212 (button) folded before Flop (didn't bet)
Seat 3: E2AS (small blind) folded before Flop
Seat 4: Gintaras20 (big blind) collected ($0.60)
Seat 5: SkyTaurus folded before Flop (didn't bet)
Seat 6: Freedom4all3 folded before Flop (didn't bet)



PokerStars Hand #222980782208:  Hold'em No Limit ($0.05/$0.10 USD) - 2021/01/23 20:00:26 ET
Table 'Demoulina III' 6-max Seat #3 is the button
Seat 1: Tilinimus007 ($10.81 in chips) 
Seat 2: toxa910212 ($10 in chips) 
Seat 3: E2AS ($2.58 in chips) 
Seat 4: Gintaras20 ($13.16 in chips) 
Seat 5: SkyTaurus ($21 in chips) 
Seat 6: Freedom4all3 ($19.54 in chips) 
Gintaras20: posts small blind $0.05
SkyTaurus: posts big blind $0.10
*** HOLE CARDS ***
Freedom4all3: folds 
Tilinimus007: folds 
toxa910212: folds 
E2AS: folds 
Gintaras20: raises $0.15 to $0.25
SkyTaurus: calls $0.15
*** FLOP *** [7d 2s Ac]
Gintaras20: bets $0.24
SkyTaurus: calls $0.24
*** TURN *** [7d 2s Ac] [Jh]
Gintaras20: checks 
SkyTaurus: checks 
*** RIVER *** [7d 2s Ac Jh] [8d]
Gintaras20: checks 
SkyTaurus: bets $0.71
Gintaras20: folds 
Uncalled bet ($0.71) returned to SkyTaurus
SkyTaurus collected $0.94 from pot
*** SUMMARY ***
Total pot $0.98 | Rake $0.04 
Board [7d 2s Ac Jh 8d]
Seat 1: Tilinimus007 folded before Flop (didn't bet)
Seat 2: toxa910212 folded before Flop (didn't bet)
Seat 3: E2AS (button) folded before Flop (didn't bet)
Seat 4: Gintaras20 (small blind) folded on the River
Seat 5: SkyTaurus (big blind) collected ($0.94)
Seat 6: Freedom4all3 folded before Flop (didn't bet)



PokerStars Hand #222980799965:  Hold'em No Limit ($0.05/$0.10 USD) - 2021/01/23 20:01:08 ET
Table 'Demoulina III' 6-max Seat #4 is the button
Seat 1: Tilinimus007 ($10.81 in chips) 
Seat 2: toxa910212 ($10 in chips) 
Seat 3: E2AS ($2.58 in chips) 
Seat 4: Gintaras20 ($12.67 in chips) 
Seat 5: SkyTaurus ($21.45 in chips) 
Seat 6: Freedom4all3 ($19.54 in chips) 
SkyTaurus: posts small blind $0.05
Freedom4all3: posts big blind $0.10
*** HOLE CARDS ***
Tilinimus007: folds 
toxa910212: folds 
E2AS: raises $0.15 to $0.25
Gintaras20: calls $0.25
SkyTaurus: raises $0.85 to $1.10
Freedom4all3: folds 
E2AS: folds 
Gintaras20: calls $0.85
*** FLOP *** [Qd Ts Js]
SkyTaurus: bets $1.46
Gintaras20: calls $1.46
*** TURN *** [Qd Ts Js] [9s]
SkyTaurus: bets $1.72
Gintaras20: folds 
Uncalled bet ($1.72) returned to SkyTaurus
SkyTaurus collected $5.22 from pot
*** SUMMARY ***
Total pot $5.47 | Rake $0.25 
Board [Qd Ts Js 9s]
Seat 1: Tilinimus007 folded before Flop (didn't bet)
Seat 2: toxa910212 folded before Flop (didn't bet)
Seat 3: E2AS folded before Flop
Seat 4: Gintaras20 (button) folded on the Turn
Seat 5: SkyTaurus (small blind) collected ($5.22)
Seat 6: Freedom4all3 (big blind) folded before Flop



PokerStars Hand #222980827695:  Hold'em No Limit ($0.05/$0.10 USD) - 2021/01/23 20:02:10 ET
Table 'Demoulina III' 6-max Seat #5 is the button
Seat 1: Tilinimus007 ($10.81 in chips) 
Seat 2: toxa910212 ($10 in chips) 
Seat 3: E2AS ($2.33 in chips) 
Seat 4: Gintaras20 ($10.11 in chips) 
Seat 5: SkyTaurus ($24.11 in chips) 
Seat 6: Freedom4all3 ($19.44 in chips) 
Freedom4all3: posts small blind $0.05
Tilinimus007: posts big blind $0.10
*** HOLE CARDS ***
toxa910212: folds 
E2AS: folds 
Gintaras20: raises $0.25 to $0.35
SkyTaurus: folds 
Freedom4all3: folds 
Tilinimus007: folds 
Uncalled bet ($0.25) returned to Gintaras20
Gintaras20 collected $0.25 from pot
Gintaras20: doesn't show hand 
*** SUMMARY ***
Total pot $0.25 | Rake $0 
Seat 1: Tilinimus007 (big blind) folded before Flop
Seat 2: toxa910212 folded before Flop (didn't bet)
Seat 3: E2AS folded before Flop (didn't bet)
Seat 4: Gintaras20 collected ($0.25)
Seat 5: SkyTaurus (button) folded before Flop (didn't bet)
Seat 6: Freedom4all3 (small blind) folded before Flop



PokerStars Hand #222980833211:  Hold'em No Limit ($0.05/$0.10 USD) - 2021/01/23 20:02:22 ET
Table 'Demoulina III' 6-max Seat #6 is the button
Seat 1: Tilinimus007 ($10.71 in chips) 
Seat 2: toxa910212 ($10 in chips) 
Seat 3: E2AS ($2.33 in chips) 
Seat 4: Gintaras20 ($10.26 in chips) 
Seat 5: SkyTaurus ($24.11 in chips) 
Seat 6: Freedom4all3 ($19.39 in chips) 
Tilinimus007: posts small blind $0.05
toxa910212: posts big blind $0.10
*** HOLE CARDS ***
E2AS: calls $0.10
Gintaras20: folds 
SkyTaurus: raises $0.22 to $0.32
Freedom4all3: folds 
Tilinimus007: calls $0.27
toxa910212: folds 
E2AS: raises $2.01 to $2.33 and is all-in
SkyTaurus: folds 
Tilinimus007: folds 
Uncalled bet ($2.01) returned to E2AS
E2AS collected $1.06 from pot
E2AS: doesn't show hand 
*** SUMMARY ***
Total pot $1.06 | Rake $0 
Seat 1: Tilinimus007 (small blind) folded before Flop
Seat 2: toxa910212 (big blind) folded before Flop
Seat 3: E2AS collected ($1.06)
Seat 4: Gintaras20 folded before Flop (didn't bet)
Seat 5: SkyTaurus folded before Flop
Seat 6: Freedom4all3 (button) folded before Flop (didn't bet)



PokerStars Hand #222980853752:  Hold'em No Limit ($0.05/$0.10 USD) - 2021/01/23 20:03:07 ET
Table 'Demoulina III' 6-max Seat #1 is the button
Seat 1: Tilinimus007 ($10.39 in chips) 
Seat 2: toxa910212 ($10 in chips) 
Seat 3: E2AS ($3.07 in chips) 
Seat 4: Gintaras20 ($10.26 in chips) 
Seat 5: SkyTaurus ($23.79 in chips) 
Seat 6: Freedom4all3 ($19.39 in chips) 
toxa910212: posts small blind $0.05
E2AS: posts big blind $0.10
*** HOLE CARDS ***
Gintaras20: folds 
SkyTaurus: folds 
Freedom4all3: raises $0.20 to $0.30
Tilinimus007: folds 
toxa910212: folds 
E2AS: calls $0.20
*** FLOP *** [Qc 4c 7c]
E2AS: checks 
Freedom4all3: checks 
*** TURN *** [Qc 4c 7c] [Ks]
E2AS: bets $0.31
Freedom4all3: folds 
Uncalled bet ($0.31) returned to E2AS
E2AS collected $0.62 from pot
E2AS: doesn't show hand 
*** SUMMARY ***
Total pot $0.65 | Rake $0.03 
Board [Qc 4c 7c Ks]
Seat 1: Tilinimus007 (button) folded before Flop (didn't bet)
Seat 2: toxa910212 (small blind) folded before Flop
Seat 3: E2AS (big blind) collected ($0.62)
Seat 4: Gintaras20 folded before Flop (didn't bet)
Seat 5: SkyTaurus folded before Flop (didn't bet)
Seat 6: Freedom4all3 folded on the Turn



PokerStars Hand #222980874907:  Hold'em No Limit ($0.05/$0.10 USD) - 2021/01/23 20:03:46 ET
Table 'Demoulina III' 6-max Seat #2 is the button
Seat 1: Tilinimus007 ($10.39 in chips) 
Seat 2: toxa910212 ($10 in chips) 
Seat 3: E2AS ($3.39 in chips) 
Seat 4: Gintaras20 ($10.26 in chips) 
Seat 5: SkyTaurus ($23.79 in chips) 
Seat 6: Freedom4all3 ($19.09 in chips) 
E2AS: posts small blind $0.05
Gintaras20: posts big blind $0.10
*** HOLE CARDS ***
SkyTaurus: folds 
Freedom4all3: raises $0.20 to $0.30
Tilinimus007: folds 
toxa910212: folds 
E2AS: folds 
Gintaras20: calls $0.20
*** FLOP *** [7s Qc Ks]
Gintaras20: checks 
Freedom4all3: bets $0.31
Gintaras20: raises $0.62 to $0.93
Freedom4all3: calls $0.62
*** TURN *** [7s Qc Ks] [9c]
Gintaras20: bets $1.80
Freedom4all3: calls $1.80
*** RIVER *** [7s Qc Ks 9c] [2d]
Gintaras20: bets $7.23 and is all-in
Freedom4all3: calls $7.23
*** SHOW DOWN ***
Gintaras20: shows [Kh Jh] (a pair of Kings)
Freedom4all3: shows [Ad Ah] (a pair of Aces)
Tilinimus007 leaves the table
Freedom4all3 collected $19.64 from pot
*** SUMMARY ***
Total pot $20.57 | Rake $0.93 
Board [7s Qc Ks 9c 2d]
Seat 1: Tilinimus007 folded before Flop (didn't bet)
Seat 2: toxa910212 (button) folded before Flop (didn't bet)
Seat 3: E2AS (small blind) folded before Flop
Seat 4: Gintaras20 (big blind) showed [Kh Jh] and lost with a pair of Kings
Seat 5: SkyTaurus folded before Flop (didn't bet)
Seat 6: Freedom4all3 showed [Ad Ah] and won ($19.64) with a pair of Aces



PokerStars Hand #222980901830:  Hold'em No Limit ($0.05/$0.10 USD) - 2021/01/23 20:04:31 ET
Table 'Demoulina III' 6-max Seat #3 is the button
Seat 2: toxa910212 ($10 in chips) 
Seat 3: E2AS ($3.34 in chips) 
Seat 5: SkyTaurus ($23.79 in chips) 
Seat 6: Freedom4all3 ($28.47 in chips) 
SkyTaurus: posts small blind $0.05
Freedom4all3: posts big blind $0.10
*** HOLE CARDS ***
toxa910212: raises $0.20 to $0.30
E2AS: folds 
SkyTaurus: folds 
Gintaras20 leaves the table
Freedom4all3: folds 
Uncalled bet ($0.20) returned to toxa910212
toxa910212 collected $0.25 from pot
toxa910212: doesn't show hand 
*** SUMMARY ***
Total pot $0.25 | Rake $0 
Seat 2: toxa910212 collected ($0.25)
Seat 3: E2AS (button) folded before Flop (didn't bet)
Seat 5: SkyTaurus (small blind) folded before Flop
Seat 6: Freedom4all3 (big blind) folded before Flop



PokerStars Hand #222980905433:  Hold'em No Limit ($0.05/$0.10 USD) - 2021/01/23 20:04:39 ET
Table 'Demoulina III' 6-max Seat #5 is the button
Seat 2: toxa910212 ($10.15 in chips) 
Seat 3: E2AS ($3.34 in chips) 
Seat 5: SkyTaurus ($23.74 in chips) 
Seat 6: Freedom4all3 ($28.37 in chips) 
Freedom4all3: posts small blind $0.05
toxa910212: posts big blind $0.10
*** HOLE CARDS ***
E2AS: folds 
SkyTaurus: folds 
Freedom4all3: folds 
Uncalled bet ($0.05) returned to toxa910212
toxa910212 collected $0.10 from pot
toxa910212: doesn't show hand 
*** SUMMARY ***
Total pot $0.10 | Rake $0 
Seat 2: toxa910212 (big blind) collected ($0.10)
Seat 3: E2AS folded before Flop (didn't bet)
Seat 5: SkyTaurus (button) folded before Flop (didn't bet)
Seat 6: Freedom4all3 (small blind) folded before Flop



PokerStars Hand #222980909969:  Hold'em No Limit ($0.05/$0.10 USD) - 2021/01/23 20:04:48 ET
Table 'Demoulina III' 6-max Seat #6 is the button
Seat 2: toxa910212 ($10.20 in chips) 
Seat 3: E2AS ($3.34 in chips) 
Seat 5: SkyTaurus ($23.74 in chips) 
Seat 6: Freedom4all3 ($28.32 in chips) 
toxa910212: posts small blind $0.05
E2AS: posts big blind $0.10
*** HOLE CARDS ***
SkyTaurus: raises $0.20 to $0.30
Freedom4all3: folds 
toxa910212: raises $0.70 to $1
E2AS: folds 
SkyTaurus: calls $0.70
*** FLOP *** [2s 8c Th]
toxa910212: bets $1.03
SkyTaurus: calls $1.03
*** TURN *** [2s 8c Th] [Jc]
toxa910212: checks 
SkyTaurus: checks 
*** RIVER *** [2s 8c Th Jc] [6s]
toxa910212: checks 
SkyTaurus: checks 
*** SHOW DOWN ***
toxa910212: shows [Ah 6h] (a pair of Sixes)
SkyTaurus: shows [7s 8s] (a pair of Eights)
SkyTaurus collected $3.97 from pot
*** SUMMARY ***
Total pot $4.16 | Rake $0.19 
Board [2s 8c Th Jc 6s]
Seat 2: toxa910212 (small blind) showed [Ah 6h] and lost with a pair of Sixes
Seat 3: E2AS (big blind) folded before Flop
Seat 5: SkyTaurus showed [7s 8s] and won ($3.97) with a pair of Eights
Seat 6: Freedom4all3 (button) folded before Flop (didn't bet)



PokerStars Hand #222980925966:  Hold'em No Limit ($0.05/$0.10 USD) - 2021/01/23 20:05:23 ET
Table 'Demoulina III' 6-max Seat #2 is the button
Seat 2: toxa910212 ($10 in chips) 
Seat 3: E2AS ($3.24 in chips) 
Seat 5: SkyTaurus ($25.68 in chips) 
Seat 6: Freedom4all3 ($28.32 in chips) 
E2AS: posts small blind $0.05
SkyTaurus: posts big blind $0.10
*** HOLE CARDS ***
Freedom4all3: folds 
toxa910212: raises $0.20 to $0.30
E2AS: calls $0.25
SkyTaurus: folds 
*** FLOP *** [9h 9s 3c]
memojr29 joins the table at seat #1 
E2AS: checks 
toxa910212: bets $0.44
E2AS: folds 
Uncalled bet ($0.44) returned to toxa910212
toxa910212 collected $0.67 from pot
toxa910212: doesn't show hand 
*** SUMMARY ***
Total pot $0.70 | Rake $0.03 
Board [9h 9s 3c]
Seat 2: toxa910212 (button) collected ($0.67)
Seat 3: E2AS (small blind) folded on the Flop
Seat 5: SkyTaurus (big blind) folded before Flop
Seat 6: Freedom4all3 folded before Flop (didn't bet)



PokerStars Hand #222980935622:  Hold'em No Limit ($0.05/$0.10 USD) - 2021/01/23 20:05:44 ET
Table 'Demoulina III' 6-max Seat #3 is the button
Seat 2: toxa910212 ($10.37 in chips) 
Seat 3: E2AS ($2.94 in chips) 
Seat 5: SkyTaurus ($25.58 in chips) 
Seat 6: Freedom4all3 ($28.32 in chips) 
SkyTaurus: posts small blind $0.05
Freedom4all3: posts big blind $0.10
memojr29: sits out 
*** HOLE CARDS ***
toxa910212: folds 
E2AS: raises $0.15 to $0.25
SkyTaurus: folds 
Freedom4all3: calls $0.15
*** FLOP *** [Kd 3c 5h]
Freedom4all3: checks 
E2AS: bets $0.27
Freedom4all3: folds 
Uncalled bet ($0.27) returned to E2AS
E2AS collected $0.53 from pot
E2AS: doesn't show hand 
*** SUMMARY ***
Total pot $0.55 | Rake $0.02 
Board [Kd 3c 5h]
Seat 2: toxa910212 folded before Flop (didn't bet)
Seat 3: E2AS (button) collected ($0.53)
Seat 5: SkyTaurus (small blind) folded before Flop
Seat 6: Freedom4all3 (big blind) folded on the Flop



PokerStars Hand #222980944417:  Hold'em No Limit ($0.05/$0.10 USD) - 2021/01/23 20:06:03 ET
Table 'Demoulina III' 6-max Seat #5 is the button
Seat 1: memojr29 ($10 in chips) 
Seat 2: toxa910212 ($10.37 in chips) 
Seat 3: E2AS ($3.22 in chips) 
Seat 5: SkyTaurus ($25.53 in chips) 
Seat 6: Freedom4all3 ($28.07 in chips) 
Freedom4all3: posts small blind $0.05
memojr29: posts big blind $0.10
*** HOLE CARDS ***
toxa910212: folds 
E2AS: folds 
MrMsry joins the table at seat #4 
SkyTaurus: folds 
Freedom4all3: raises $0.20 to $0.30
memojr29: folds 
Uncalled bet ($0.20) returned to Freedom4all3
Freedom4all3 collected $0.20 from pot
Freedom4all3: doesn't show hand 
*** SUMMARY ***
Total pot $0.20 | Rake $0 
Seat 1: memojr29 (big blind) folded before Flop
Seat 2: toxa910212 folded before Flop (didn't bet)
Seat 3: E2AS folded before Flop (didn't bet)
Seat 5: SkyTaurus (button) folded before Flop (didn't bet)
Seat 6: Freedom4all3 (small blind) collected ($0.20)



PokerStars Hand #222980950051:  Hold'em No Limit ($0.05/$0.10 USD) - 2021/01/23 20:06:15 ET
Table 'Demoulina III' 6-max Seat #6 is the button
Seat 1: memojr29 ($10 in chips) 
Seat 3: E2AS ($3.22 in chips) 
Seat 5: SkyTaurus ($25.53 in chips) 
Seat 6: Freedom4all3 ($28.17 in chips) 
memojr29: posts small blind $0.05
toxa910212: is sitting out 
E2AS: posts big blind $0.10
toxa910212 leaves the table
MrMsry: sits out 
*** HOLE CARDS ***
SkyTaurus: folds 
Freedom4all3: folds 
memojr29: folds 
Uncalled bet ($0.05) returned to E2AS
E2AS collected $0.10 from pot
E2AS: doesn't show hand 
*** SUMMARY ***
Total pot $0.10 | Rake $0 
Seat 1: memojr29 (small blind) folded before Flop
Seat 3: E2AS (big blind) collected ($0.10)
Seat 5: SkyTaurus folded before Flop (didn't bet)
Seat 6: Freedom4all3 (button) folded before Flop (didn't bet)



PokerStars Hand #222980955939:  Hold'em No Limit ($0.05/$0.10 USD) - 2021/01/23 20:06:27 ET
Table 'Demoulina III' 6-max Seat #1 is the button
Seat 1: memojr29 ($10 in chips) 
Seat 3: E2AS ($3.27 in chips) 
Seat 4: MrMsry ($10 in chips) 
Seat 5: SkyTaurus ($25.53 in chips) 
Seat 6: Freedom4all3 ($28.17 in chips) 
E2AS: posts small blind $0.05
MrMsry: posts big blind $0.10
*** HOLE CARDS ***
SkyTaurus: folds 
Freedom4all3: folds 
memojr29: folds 
E2AS: folds 
Uncalled bet ($0.05) returned to MrMsry
MrMsry collected $0.10 from pot
MrMsry: doesn't show hand 
*** SUMMARY ***
Total pot $0.10 | Rake $0 
Seat 1: memojr29 (button) folded before Flop (didn't bet)
Seat 3: E2AS (small blind) folded before Flop
Seat 4: MrMsry (big blind) collected ($0.10)
Seat 5: SkyTaurus folded before Flop (didn't bet)
Seat 6: Freedom4all3 folded before Flop (didn't bet)



PokerStars Hand #222980960670:  Hold'em No Limit ($0.05/$0.10 USD) - 2021/01/23 20:06:38 ET
Table 'Demoulina III' 6-max Seat #3 is the button
Seat 1: memojr29 ($10 in chips) 
Seat 3: E2AS ($3.22 in chips) 
Seat 4: MrMsry ($10.05 in chips) 
Seat 5: SkyTaurus ($25.53 in chips) 
Seat 6: Freedom4all3 ($28.17 in chips) 
MrMsry: posts small blind $0.05
SkyTaurus: posts big blind $0.10
*** HOLE CARDS ***
Freedom4all3: raises $0.20 to $0.30
memojr29: folds 
E2AS: folds 
MrMsry: calls $0.25
SkyTaurus: folds 
*** FLOP *** [Qs 6s Ks]
MrMsry: checks 
Freedom4all3: checks 
*** TURN *** [Qs 6s Ks] [4s]
MrMsry: checks 
Freedom4all3: checks 
*** RIVER *** [Qs 6s Ks 4s] [Qd]
MrMsry: checks 
Freedom4all3: checks 
*** SHOW DOWN ***
MrMsry: shows [3h 3s] (a flush, King high)
Freedom4all3: mucks hand 
MrMsry collected $0.67 from pot
*** SUMMARY ***
Total pot $0.70 | Rake $0.03 
Board [Qs 6s Ks 4s Qd]
Seat 1: memojr29 folded before Flop (didn't bet)
Seat 3: E2AS (button) folded before Flop (didn't bet)
Seat 4: MrMsry (small blind) showed [3h 3s] and won ($0.67) with a flush, King high
Seat 5: SkyTaurus (big blind) folded before Flop
Seat 6: Freedom4all3 mucked



PokerStars Hand #222980984412:  Hold'em No Limit ($0.05/$0.10 USD) - 2021/01/23 20:07:29 ET
Table 'Demoulina III' 6-max Seat #4 is the button
Seat 1: memojr29 ($10 in chips) 
Seat 3: E2AS ($3.22 in chips) 
Seat 4: MrMsry ($10.42 in chips) 
Seat 5: SkyTaurus ($25.43 in chips) 
Seat 6: Freedom4all3 ($27.87 in chips) 
SkyTaurus: posts small blind $0.05
Freedom4all3: posts big blind $0.10
*** HOLE CARDS ***
memojr29: folds 
E2AS: raises $0.14 to $0.24
MrMsry: calls $0.24
SkyTaurus: calls $0.19
Freedom4all3: folds 
*** FLOP *** [6s 9h 3s]
SkyTaurus: bets $0.26
E2AS: calls $0.26
mbsets joins the table at seat #2 
MrMsry: calls $0.26
*** TURN *** [6s 9h 3s] [Qc]
SkyTaurus: checks 
E2AS: checks 
MrMsry: bets $1.30
SkyTaurus: folds 
E2AS: raises $1.42 to $2.72 and is all-in
MrMsry: calls $1.42
*** RIVER *** [6s 9h 3s Qc] [2c]
*** SHOW DOWN ***
E2AS: shows [Qs Ac] (a pair of Queens)
MrMsry: shows [Qd Kd] (a pair of Queens - lower kicker)
E2AS collected $6.72 from pot
MrMsry cashed out the hand for $0.45
*** SUMMARY ***
Total pot $7.04 | Rake $0.32 
Board [6s 9h 3s Qc 2c]
Seat 1: memojr29 folded before Flop (didn't bet)
Seat 3: E2AS showed [Qs Ac] and won ($6.72) with a pair of Queens
Seat 4: MrMsry (button) showed [Qd Kd] and lost with a pair of Queens (cashed out).
Seat 5: SkyTaurus (small blind) folded on the Turn
Seat 6: Freedom4all3 (big blind) folded before Flop



PokerStars Hand #222981024577:  Hold'em No Limit ($0.05/$0.10 USD) - 2021/01/23 20:08:36 ET
Table 'Demoulina III' 6-max Seat #5 is the button
Seat 1: memojr29 ($10 in chips) 
Seat 2: mbsets ($10 in chips) 
Seat 3: E2AS ($6.72 in chips) 
Seat 4: MrMsry ($10 in chips) 
Seat 5: SkyTaurus ($24.93 in chips) 
Seat 6: Freedom4all3 ($27.77 in chips) 
Freedom4all3: posts small blind $0.05
memojr29: posts big blind $0.10
mbsets: posts big blind $0.10
*** HOLE CARDS ***
mbsets: checks 
E2AS: folds 
MrMsry: folds 
SkyTaurus: raises $0.22 to $0.32
Freedom4all3: folds 
memojr29: folds 
mbsets: calls $0.22
*** FLOP *** [2h Tc Qd]
mbsets: checks 
SkyTaurus: checks 
*** TURN *** [2h Tc Qd] [Kh]
mbsets: checks 
SkyTaurus: bets $0.45
Freedom4all3 leaves the table
mbsets: folds 
Uncalled bet ($0.45) returned to SkyTaurus
SkyTaurus collected $0.75 from pot
*** SUMMARY ***
Total pot $0.79 | Rake $0.04 
Board [2h Tc Qd Kh]
Seat 1: memojr29 (big blind) folded before Flop
Seat 2: mbsets folded on the Turn
Seat 3: E2AS folded before Flop (didn't bet)
Seat 4: MrMsry folded before Flop (didn't bet)
Seat 5: SkyTaurus (button) collected ($0.75)
Seat 6: Freedom4all3 (small blind) folded before Flop



PokerStars Hand #222981053398:  Hold'em No Limit ($0.05/$0.10 USD) - 2021/01/23 20:09:39 ET
Table 'Demoulina III' 6-max Seat #1 is the button
Seat 1: memojr29 ($10 in chips) 
Seat 2: mbsets ($9.68 in chips) 
Seat 3: E2AS ($6.72 in chips) 
Seat 4: MrMsry ($10 in chips) 
Seat 5: SkyTaurus ($25.36 in chips) 
mbsets: posts small blind $0.05
E2AS: posts big blind $0.10
*** HOLE CARDS ***
MrMsry: folds 
SkyTaurus: folds 
memojr29: folds 
schoki77 joins the table at seat #6 
mbsets: calls $0.05
E2AS: raises $0.30 to $0.40
mbsets: calls $0.30
*** FLOP *** [Th 6c 8h]
mbsets: checks 
E2AS: bets $0.23
mbsets: folds 
Uncalled bet ($0.23) returned to E2AS
E2AS collected $0.76 from pot
E2AS: doesn't show hand 
*** SUMMARY ***
Total pot $0.80 | Rake $0.04 
Board [Th 6c 8h]
Seat 1: memojr29 (button) folded before Flop (didn't bet)
Seat 2: mbsets (small blind) folded on the Flop
Seat 3: E2AS (big blind) collected ($0.76)
Seat 4: MrMsry folded before Flop (didn't bet)
Seat 5: SkyTaurus folded before Flop (didn't bet)



PokerStars Hand #222981070033:  Hold'em No Limit ($0.05/$0.10 USD) - 2021/01/23 20:10:16 ET
Table 'Demoulina III' 6-max Seat #2 is the button
Seat 1: memojr29 ($10 in chips) 
Seat 2: mbsets ($9.28 in chips) 
Seat 3: E2AS ($7.08 in chips) 
Seat 4: MrMsry ($10 in chips) 
Seat 5: SkyTaurus ($25.36 in chips) 
E2AS: posts small blind $0.05
MrMsry: posts big blind $0.10
schoki77: sits out 
*** HOLE CARDS ***
SkyTaurus: folds 
memojr29: folds 
mbsets: raises $0.30 to $0.40
E2AS: folds 
MrMsry: calls $0.30
*** FLOP *** [4d Kd 2c]
MrMsry: checks 
mbsets: bets $0.20
MrMsry: calls $0.20
*** TURN *** [4d Kd 2c] [7h]
MrMsry: checks 
mbsets: bets $0.40
MrMsry: calls $0.40
*** RIVER *** [4d Kd 2c 7h] [7s]
MrMsry: checks 
mbsets: bets $0.60
MrMsry: calls $0.60
*** SHOW DOWN ***
mbsets: shows [Kh Ad] (two pair, Kings and Sevens)
MrMsry: mucks hand 
mbsets collected $3.10 from pot
*** SUMMARY ***
Total pot $3.25 | Rake $0.15 
Board [4d Kd 2c 7h 7s]
Seat 1: memojr29 folded before Flop (didn't bet)
Seat 2: mbsets (button) showed [Kh Ad] and won ($3.10) with two pair, Kings and Sevens
Seat 3: E2AS (small blind) folded before Flop
Seat 4: MrMsry (big blind) mucked
Seat 5: SkyTaurus folded before Flop (didn't bet)



PokerStars Hand #222981105778:  Hold'em No Limit ($0.05/$0.10 USD) - 2021/01/23 20:11:35 ET
Table 'Demoulina III' 6-max Seat #3 is the button
Seat 1: memojr29 ($10 in chips) 
Seat 2: mbsets ($10.78 in chips) 
Seat 3: E2AS ($7.03 in chips) 
Seat 4: MrMsry ($10 in chips) 
Seat 5: SkyTaurus ($25.36 in chips) 
MrMsry: posts small blind $0.05
SkyTaurus: posts big blind $0.10
schoki77: sits out 
*** HOLE CARDS ***
memojr29 has timed out
memojr29: folds 
mbsets: folds 
E2AS: raises $0.15 to $0.25
MrMsry: folds 
SkyTaurus: folds 
Uncalled bet ($0.15) returned to E2AS
E2AS collected $0.25 from pot
E2AS: doesn't show hand 
*** SUMMARY ***
Total pot $0.25 | Rake $0 
Seat 1: memojr29 folded before Flop (didn't bet)
Seat 2: mbsets folded before Flop (didn't bet)
Seat 3: E2AS (button) collected ($0.25)
Seat 4: MrMsry (small blind) folded before Flop
Seat 5: SkyTaurus (big blind) folded before Flop



PokerStars Hand #222981121593:  Hold'em No Limit ($0.05/$0.10 USD) - 2021/01/23 20:12:10 ET
Table 'Demoulina III' 6-max Seat #4 is the button
Seat 1: memojr29 ($10 in chips) 
Seat 2: mbsets ($10.78 in chips) 
Seat 3: E2AS ($7.18 in chips) 
Seat 4: MrMsry ($10 in chips) 
Seat 5: SkyTaurus ($25.26 in chips) 
Seat 6: schoki77 ($5.40 in chips) 
SkyTaurus: posts small blind $0.05
schoki77: posts big blind $0.10
*** HOLE CARDS ***
memojr29: folds 
mbsets: raises $0.15 to $0.25
E2AS: folds 
MrMsry: folds 
SkyTaurus: folds 
schoki77: folds 
Uncalled bet ($0.15) returned to mbsets
mbsets collected $0.25 from pot
*** SUMMARY ***
Total pot $0.25 | Rake $0 
Seat 1: memojr29 folded before Flop (didn't bet)
Seat 2: mbsets collected ($0.25)
Seat 3: E2AS folded before Flop (didn't bet)
Seat 4: MrMsry (button) folded before Flop (didn't bet)
Seat 5: SkyTaurus (small blind) folded before Flop
Seat 6: schoki77 (big blind) folded before Flop



PokerStars Hand #222981127250:  Hold'em No Limit ($0.05/$0.10 USD) - 2021/01/23 20:12:23 ET
Table 'Demoulina III' 6-max Seat #5 is the button
Seat 1: memojr29 ($10 in chips) 
Seat 2: mbsets ($10.93 in chips) 
Seat 3: E2AS ($7.18 in chips) 
Seat 4: MrMsry ($10 in chips) 
Seat 5: SkyTaurus ($25.21 in chips) 
Seat 6: schoki77 ($5.30 in chips) 
schoki77: posts small blind $0.05
memojr29: posts big blind $0.10
*** HOLE CARDS ***
mbsets: folds 
E2AS: raises $0.15 to $0.25
MrMsry: calls $0.25
SkyTaurus: folds 
schoki77: calls $0.20
memojr29: calls $0.15
*** FLOP *** [9d Ah Kc]
schoki77: checks 
memojr29: checks 
E2AS: checks 
MrMsry: checks 
*** TURN *** [9d Ah Kc] [Kd]
schoki77: checks 
memojr29: checks 
E2AS: bets $0.77
MrMsry: folds 
schoki77: folds 
memojr29: folds 
Uncalled bet ($0.77) returned to E2AS
E2AS collected $0.96 from pot
E2AS: doesn't show hand 
*** SUMMARY ***
Total pot $1 | Rake $0.04 
Board [9d Ah Kc Kd]
Seat 1: memojr29 (big blind) folded on the Turn
Seat 2: mbsets folded before Flop (didn't bet)
Seat 3: E2AS collected ($0.96)
Seat 4: MrMsry folded on the Turn
Seat 5: SkyTaurus (button) folded before Flop (didn't bet)
Seat 6: schoki77 (small blind) folded on the Turn



PokerStars Hand #222981153761:  Hold'em No Limit ($0.05/$0.10 USD) - 2021/01/23 20:13:22 ET
Table 'Demoulina III' 6-max Seat #6 is the button
Seat 1: memojr29 ($10 in chips) 
Seat 3: E2AS ($7.89 in chips) 
Seat 4: MrMsry ($10 in chips) 
Seat 5: SkyTaurus ($25.21 in chips) 
Seat 6: schoki77 ($5.05 in chips) 
memojr29: posts small blind $0.05
mbsets: is sitting out 
E2AS: posts big blind $0.10
*** HOLE CARDS ***
MrMsry: raises $0.21 to $0.31
SkyTaurus: folds 
mbsets leaves the table
schoki77: calls $0.31
memojr29: folds 
E2AS: calls $0.21
*** FLOP *** [9s As 8s]
E2AS: checks 
MrMsry: bets $0.40
schoki77: calls $0.40
E2AS: folds 
*** TURN *** [9s As 8s] [7h]
jorgeebanks joins the table at seat #2 
MrMsry: bets $1.30
schoki77: calls $1.30
*** RIVER *** [9s As 8s 7h] [Ac]
MrMsry: checks 
schoki77: bets $3.04 and is all-in
MrMsry: calls $3.04
*** SHOW DOWN ***
schoki77: shows [Ts 7s] (a flush, Ace high)
MrMsry: shows [9c Tc] (two pair, Aces and Nines)
schoki77 collected $9.99 from pot
*** SUMMARY ***
Total pot $10.46 | Rake $0.47 
Board [9s As 8s 7h Ac]
Seat 1: memojr29 (small blind) folded before Flop
Seat 3: E2AS (big blind) folded on the Flop
Seat 4: MrMsry showed [9c Tc] and lost with two pair, Aces and Nines
Seat 5: SkyTaurus folded before Flop (didn't bet)
Seat 6: schoki77 (button) showed [Ts 7s] and won ($9.99) with a flush, Ace high



PokerStars Hand #222981194637:  Hold'em No Limit ($0.05/$0.10 USD) - 2021/01/23 20:14:53 ET
Table 'Demoulina III' 6-max Seat #1 is the button
Seat 1: memojr29 ($10 in chips) 
Seat 3: E2AS ($7.58 in chips) 
Seat 4: MrMsry ($10 in chips) 
Seat 5: SkyTaurus ($25.21 in chips) 
Seat 6: schoki77 ($9.99 in chips) 
E2AS: posts small blind $0.05
MrMsry: posts big blind $0.10
*** HOLE CARDS ***
SkyTaurus: folds 
schoki77: calls $0.10
memojr29: raises $0.35 to $0.45
E2AS: calls $0.40
MrMsry: folds 
schoki77: calls $0.35
*** FLOP *** [9h 4s 9d]
E2AS: checks 
schoki77: checks 
memojr29: bets $0.69
E2AS: folds 
schoki77: folds 
Uncalled bet ($0.69) returned to memojr29
memojr29 collected $1.38 from pot
memojr29: doesn't show hand 
*** SUMMARY ***
Total pot $1.45 | Rake $0.07 
Board [9h 4s 9d]
Seat 1: memojr29 (button) collected ($1.38)
Seat 3: E2AS (small blind) folded on the Flop
Seat 4: MrMsry (big blind) folded before Flop
Seat 5: SkyTaurus folded before Flop (didn't bet)
Seat 6: schoki77 folded on the Flop



PokerStars Hand #222981207534:  Hold'em No Limit ($0.05/$0.10 USD) - 2021/01/23 20:15:22 ET
Table 'Demoulina III' 6-max Seat #3 is the button
Seat 1: memojr29 ($10.93 in chips) 
Seat 3: E2AS ($7.13 in chips) 
Seat 4: MrMsry ($10 in chips) 
Seat 5: SkyTaurus ($25.21 in chips) 
Seat 6: schoki77 ($9.54 in chips) 
MrMsry: posts small blind $0.05
SkyTaurus: posts big blind $0.10
jorgeebanks: sits out 
*** HOLE CARDS ***
schoki77: folds 
memojr29: folds 
E2AS: raises $0.15 to $0.25
MrMsry: folds 
SkyTaurus: folds 
Uncalled bet ($0.15) returned to E2AS
E2AS collected $0.25 from pot
E2AS: doesn't show hand 
*** SUMMARY ***
Total pot $0.25 | Rake $0 
Seat 1: memojr29 folded before Flop (didn't bet)
Seat 3: E2AS (button) collected ($0.25)
Seat 4: MrMsry (small blind) folded before Flop
Seat 5: SkyTaurus (big blind) folded before Flop
Seat 6: schoki77 folded before Flop (didn't bet)



PokerStars Hand #222981214544:  Hold'em No Limit ($0.05/$0.10 USD) - 2021/01/23 20:15:37 ET
Table 'Demoulina III' 6-max Seat #4 is the button
Seat 1: memojr29 ($10.93 in chips) 
Seat 3: E2AS ($7.28 in chips) 
Seat 4: MrMsry ($10 in chips) 
Seat 5: SkyTaurus ($25.11 in chips) 
Seat 6: schoki77 ($9.54 in chips) 
SkyTaurus: posts small blind $0.05
schoki77: posts big blind $0.10
jorgeebanks: sits out 
*** HOLE CARDS ***
memojr29: raises $0.20 to $0.30
E2AS: raises $0.70 to $1
MrMsry: folds 
SkyTaurus: folds 
schoki77: folds 
memojr29: folds 
Uncalled bet ($0.70) returned to E2AS
E2AS collected $0.75 from pot
E2AS: doesn't show hand 
*** SUMMARY ***
Total pot $0.75 | Rake $0 
Seat 1: memojr29 folded before Flop
Seat 3: E2AS collected ($0.75)
Seat 4: MrMsry (button) folded before Flop (didn't bet)
Seat 5: SkyTaurus (small blind) folded before Flop
Seat 6: schoki77 (big blind) folded before Flop



PokerStars Hand #222981227578:  Hold'em No Limit ($0.05/$0.10 USD) - 2021/01/23 20:16:07 ET
Table 'Demoulina III' 6-max Seat #5 is the button
Seat 1: memojr29 ($10.63 in chips) 
Seat 3: E2AS ($7.73 in chips) 
Seat 4: MrMsry ($10 in chips) 
Seat 5: SkyTaurus ($25.06 in chips) 
Seat 6: schoki77 ($9.44 in chips) 
schoki77: posts small blind $0.05
memojr29: posts big blind $0.10
jorgeebanks: sits out 
*** HOLE CARDS ***
E2AS: raises $0.14 to $0.24
MrMsry: folds 
SkyTaurus: folds 
schoki77: folds 
memojr29: folds 
Uncalled bet ($0.14) returned to E2AS
E2AS collected $0.25 from pot
E2AS: doesn't show hand 
*** SUMMARY ***
Total pot $0.25 | Rake $0 
Seat 1: memojr29 (big blind) folded before Flop
Seat 3: E2AS collected ($0.25)
Seat 4: MrMsry folded before Flop (didn't bet)
Seat 5: SkyTaurus (button) folded before Flop (didn't bet)
Seat 6: schoki77 (small blind) folded before Flop



PokerStars Hand #222981232066:  Hold'em No Limit ($0.05/$0.10 USD) - 2021/01/23 20:16:17 ET
Table 'Demoulina III' 6-max Seat #6 is the button
Seat 1: memojr29 ($10.53 in chips) 
Seat 2: jorgeebanks ($10 in chips) 
Seat 3: E2AS ($7.88 in chips) 
Seat 4: MrMsry ($10 in chips) 
Seat 5: SkyTaurus ($25.06 in chips) 
Seat 6: schoki77 ($9.39 in chips) 
memojr29: posts small blind $0.05
jorgeebanks: posts big blind $0.10
*** HOLE CARDS ***
E2AS: folds 
MrMsry: raises $0.21 to $0.31
SkyTaurus: folds 
schoki77: folds 
memojr29: folds 
jorgeebanks: folds 
Uncalled bet ($0.21) returned to MrMsry
MrMsry collected $0.25 from pot
MrMsry: doesn't show hand 
*** SUMMARY ***
Total pot $0.25 | Rake $0 
Seat 1: memojr29 (small blind) folded before Flop
Seat 2: jorgeebanks (big blind) folded before Flop
Seat 3: E2AS folded before Flop (didn't bet)
Seat 4: MrMsry collected ($0.25)
Seat 5: SkyTaurus folded before Flop (didn't bet)
Seat 6: schoki77 (button) folded before Flop (didn't bet)



PokerStars Hand #222981240750:  Hold'em No Limit ($0.05/$0.10 USD) - 2021/01/23 20:16:37 ET
Table 'Demoulina III' 6-max Seat #1 is the button
Seat 1: memojr29 ($10.48 in chips) 
Seat 2: jorgeebanks ($9.90 in chips) 
Seat 3: E2AS ($7.88 in chips) 
Seat 4: MrMsry ($10.15 in chips) 
Seat 5: SkyTaurus ($25.06 in chips) 
Seat 6: schoki77 ($9.39 in chips) 
jorgeebanks: posts small blind $0.05
E2AS: posts big blind $0.10
*** HOLE CARDS ***
MrMsry: folds 
SkyTaurus: folds 
schoki77: folds 
memojr29: raises $0.15 to $0.25
jorgeebanks: calls $0.20
E2AS: calls $0.15
*** FLOP *** [Ah Qh Kc]
jorgeebanks: checks 
E2AS: checks 
memojr29: bets $0.36
jorgeebanks: folds 
E2AS: calls $0.36
*** TURN *** [Ah Qh Kc] [3s]
E2AS: checks 
memojr29: bets $1.10
E2AS: calls $1.10
*** RIVER *** [Ah Qh Kc 3s] [Ad]
E2AS: checks 
memojr29: checks 
*** SHOW DOWN ***
E2AS: shows [Ac Jc] (three of a kind, Aces)
memojr29: mucks hand 
E2AS collected $3.50 from pot
*** SUMMARY ***
Total pot $3.67 | Rake $0.17 
Board [Ah Qh Kc 3s Ad]
Seat 1: memojr29 (button) mucked
Seat 2: jorgeebanks (small blind) folded on the Flop
Seat 3: E2AS (big blind) showed [Ac Jc] and won ($3.50) with three of a kind, Aces
Seat 4: MrMsry folded before Flop (didn't bet)
Seat 5: SkyTaurus folded before Flop (didn't bet)
Seat 6: schoki77 folded before Flop (didn't bet)



PokerStars Hand #222981272489:  Hold'em No Limit ($0.05/$0.10 USD) - 2021/01/23 20:17:48 ET
Table 'Demoulina III' 6-max Seat #2 is the button
Seat 1: memojr29 ($10 in chips) 
Seat 2: jorgeebanks ($9.65 in chips) 
Seat 3: E2AS ($9.67 in chips) 
Seat 4: MrMsry ($10.15 in chips) 
Seat 5: SkyTaurus ($25.06 in chips) 
Seat 6: schoki77 ($9.39 in chips) 
E2AS: posts small blind $0.05
MrMsry: posts big blind $0.10
*** HOLE CARDS ***
SkyTaurus: folds 
schoki77: folds 
memojr29: folds 
jorgeebanks: folds 
E2AS: folds 
Uncalled bet ($0.05) returned to MrMsry
MrMsry collected $0.10 from pot
MrMsry: doesn't show hand 
*** SUMMARY ***
Total pot $0.10 | Rake $0 
Seat 1: memojr29 folded before Flop (didn't bet)
Seat 2: jorgeebanks (button) folded before Flop (didn't bet)
Seat 3: E2AS (small blind) folded before Flop
Seat 4: MrMsry (big blind) collected ($0.10)
Seat 5: SkyTaurus folded before Flop (didn't bet)
Seat 6: schoki77 folded before Flop (didn't bet)



PokerStars Hand #222981278431:  Hold'em No Limit ($0.05/$0.10 USD) - 2021/01/23 20:18:02 ET
Table 'Demoulina III' 6-max Seat #3 is the button
Seat 1: memojr29 ($10 in chips) 
Seat 2: jorgeebanks ($9.65 in chips) 
Seat 3: E2AS ($9.62 in chips) 
Seat 4: MrMsry ($10.20 in chips) 
Seat 5: SkyTaurus ($25.06 in chips) 
Seat 6: schoki77 ($9.39 in chips) 
MrMsry: posts small blind $0.05
SkyTaurus: posts big blind $0.10
*** HOLE CARDS ***
schoki77: calls $0.10
memojr29: folds 
jorgeebanks: folds 
E2AS: raises $0.30 to $0.40
MrMsry: folds 
SkyTaurus: folds 
schoki77: folds 
Uncalled bet ($0.30) returned to E2AS
E2AS collected $0.35 from pot
E2AS: doesn't show hand 
*** SUMMARY ***
Total pot $0.35 | Rake $0 
Seat 1: memojr29 folded before Flop (didn't bet)
Seat 2: jorgeebanks folded before Flop (didn't bet)
Seat 3: E2AS (button) collected ($0.35)
Seat 4: MrMsry (small blind) folded before Flop
Seat 5: SkyTaurus (big blind) folded before Flop
Seat 6: schoki77 folded before Flop



PokerStars Hand #222981287536:  Hold'em No Limit ($0.05/$0.10 USD) - 2021/01/23 20:18:23 ET
Table 'Demoulina III' 6-max Seat #4 is the button
Seat 1: memojr29 ($10 in chips) 
Seat 2: jorgeebanks ($9.65 in chips) 
Seat 3: E2AS ($9.87 in chips) 
Seat 4: MrMsry ($10.15 in chips) 
Seat 5: SkyTaurus ($24.96 in chips) 
Seat 6: schoki77 ($9.29 in chips) 
SkyTaurus: posts small blind $0.05
schoki77: posts big blind $0.10
*** HOLE CARDS ***
memojr29: folds 
jorgeebanks: folds 
E2AS: raises $0.15 to $0.25
MrMsry: folds 
SkyTaurus: folds 
schoki77: folds 
Uncalled bet ($0.15) returned to E2AS
E2AS collected $0.25 from pot
E2AS: doesn't show hand 
*** SUMMARY ***
Total pot $0.25 | Rake $0 
Seat 1: memojr29 folded before Flop (didn't bet)
Seat 2: jorgeebanks folded before Flop (didn't bet)
Seat 3: E2AS collected ($0.25)
Seat 4: MrMsry (button) folded before Flop (didn't bet)
Seat 5: SkyTaurus (small blind) folded before Flop
Seat 6: schoki77 (big blind) folded before Flop



PokerStars Hand #222981295601:  Hold'em No Limit ($0.05/$0.10 USD) - 2021/01/23 20:18:41 ET
Table 'Demoulina III' 6-max Seat #5 is the button
Seat 1: memojr29 ($10 in chips) 
Seat 2: jorgeebanks ($9.65 in chips) 
Seat 3: E2AS ($10.02 in chips) 
Seat 4: MrMsry ($10.15 in chips) 
Seat 5: SkyTaurus ($24.91 in chips) 
Seat 6: schoki77 ($9.19 in chips) 
schoki77: posts small blind $0.05
memojr29: posts big blind $0.10
*** HOLE CARDS ***
jorgeebanks: folds 
E2AS: folds 
MrMsry: folds 
SkyTaurus: folds 
schoki77: raises $0.20 to $0.30
memojr29: folds 
Uncalled bet ($0.20) returned to schoki77
schoki77 collected $0.20 from pot
schoki77: doesn't show hand 
*** SUMMARY ***
Total pot $0.20 | Rake $0 
Seat 1: memojr29 (big blind) folded before Flop
Seat 2: jorgeebanks folded before Flop (didn't bet)
Seat 3: E2AS folded before Flop (didn't bet)
Seat 4: MrMsry folded before Flop (didn't bet)
Seat 5: SkyTaurus (button) folded before Flop (didn't bet)
Seat 6: schoki77 (small blind) collected ($0.20)



PokerStars Hand #222981304574:  Hold'em No Limit ($0.05/$0.10 USD) - 2021/01/23 20:19:02 ET
Table 'Demoulina III' 6-max Seat #6 is the button
Seat 1: memojr29 ($10 in chips) 
Seat 2: jorgeebanks ($9.65 in chips) 
Seat 3: E2AS ($10.02 in chips) 
Seat 4: MrMsry ($10.15 in chips) 
Seat 5: SkyTaurus ($24.91 in chips) 
Seat 6: schoki77 ($9.29 in chips) 
memojr29: posts small blind $0.05
jorgeebanks: posts big blind $0.10
*** HOLE CARDS ***
E2AS: folds 
MrMsry: folds 
SkyTaurus: folds 
schoki77: raises $0.20 to $0.30
memojr29: folds 
jorgeebanks: folds 
Uncalled bet ($0.20) returned to schoki77
schoki77 collected $0.25 from pot
schoki77: doesn't show hand 
*** SUMMARY ***
Total pot $0.25 | Rake $0 
Seat 1: memojr29 (small blind) folded before Flop
Seat 2: jorgeebanks (big blind) folded before Flop
Seat 3: E2AS folded before Flop (didn't bet)
Seat 4: MrMsry folded before Flop (didn't bet)
Seat 5: SkyTaurus folded before Flop (didn't bet)
Seat 6: schoki77 (button) collected ($0.25)



PokerStars Hand #222981310703:  Hold'em No Limit ($0.05/$0.10 USD) - 2021/01/23 20:19:16 ET
Table 'Demoulina III' 6-max Seat #1 is the button
Seat 1: memojr29 ($10 in chips) 
Seat 2: jorgeebanks ($9.55 in chips) 
Seat 3: E2AS ($10.02 in chips) 
Seat 4: MrMsry ($10.15 in chips) 
Seat 5: SkyTaurus ($24.91 in chips) 
Seat 6: schoki77 ($9.44 in chips) 
jorgeebanks: posts small blind $0.05
E2AS: posts big blind $0.10
*** HOLE CARDS ***
MrMsry: folds 
SkyTaurus: folds 
schoki77: folds 
memojr29: folds 
jorgeebanks: folds 
Uncalled bet ($0.05) returned to E2AS
E2AS collected $0.10 from pot
E2AS: doesn't show hand 
*** SUMMARY ***
Total pot $0.10 | Rake $0 
Seat 1: memojr29 (button) folded before Flop (didn't bet)
Seat 2: jorgeebanks (small blind) folded before Flop
Seat 3: E2AS (big blind) collected ($0.10)
Seat 4: MrMsry folded before Flop (didn't bet)
Seat 5: SkyTaurus folded before Flop (didn't bet)
Seat 6: schoki77 folded before Flop (didn't bet)



PokerStars Hand #222981314914:  Hold'em No Limit ($0.05/$0.10 USD) - 2021/01/23 20:19:26 ET
Table 'Demoulina III' 6-max Seat #2 is the button
Seat 1: memojr29 ($10 in chips) 
Seat 2: jorgeebanks ($9.50 in chips) 
Seat 3: E2AS ($10.07 in chips) 
Seat 4: MrMsry ($10.15 in chips) 
Seat 5: SkyTaurus ($24.91 in chips) 
Seat 6: schoki77 ($9.44 in chips) 
E2AS: posts small blind $0.05
MrMsry: posts big blind $0.10
*** HOLE CARDS ***
SkyTaurus: folds 
schoki77: folds 
memojr29: raises $0.20 to $0.30
jorgeebanks: folds 
E2AS: calls $0.25
MrMsry: folds 
*** FLOP *** [Jd Qh 7d]
E2AS: checks 
memojr29: bets $0.44
E2AS: raises $0.96 to $1.40
memojr29: calls $0.96
*** TURN *** [Jd Qh 7d] [As]
E2AS: bets $1.67
memojr29: calls $1.67
*** RIVER *** [Jd Qh 7d As] [Kc]
E2AS: checks 
memojr29: checks 
*** SHOW DOWN ***
E2AS: shows [7s 7h] (three of a kind, Sevens)
memojr29: mucks hand 
E2AS collected $6.53 from pot
*** SUMMARY ***
Total pot $6.84 | Rake $0.31 
Board [Jd Qh 7d As Kc]
Seat 1: memojr29 mucked
Seat 2: jorgeebanks (button) folded before Flop (didn't bet)
Seat 3: E2AS (small blind) showed [7s 7h] and won ($6.53) with three of a kind, Sevens
Seat 4: MrMsry (big blind) folded before Flop
Seat 5: SkyTaurus folded before Flop (didn't bet)
Seat 6: schoki77 folded before Flop (didn't bet)



PokerStars Hand #222981346486:  Hold'em No Limit ($0.05/$0.10 USD) - 2021/01/23 20:20:38 ET
Table 'Demoulina III' 6-max Seat #3 is the button
Seat 1: memojr29 ($10 in chips) 
Seat 2: jorgeebanks ($9.50 in chips) 
Seat 3: E2AS ($13.23 in chips) 
Seat 4: MrMsry ($10.05 in chips) 
Seat 5: SkyTaurus ($24.91 in chips) 
Seat 6: schoki77 ($9.44 in chips) 
MrMsry: posts small blind $0.05
SkyTaurus: posts big blind $0.10
*** HOLE CARDS ***
schoki77: raises $0.20 to $0.30
memojr29: folds 
jorgeebanks: folds 
E2AS: raises $0.70 to $1
MrMsry: folds 
SkyTaurus: folds 
schoki77: raises $8.44 to $9.44 and is all-in
E2AS: folds 
Uncalled bet ($8.44) returned to schoki77
schoki77 collected $2.15 from pot
schoki77: doesn't show hand 
*** SUMMARY ***
Total pot $2.15 | Rake $0 
Seat 1: memojr29 folded before Flop (didn't bet)
Seat 2: jorgeebanks folded before Flop (didn't bet)
Seat 3: E2AS (button) folded before Flop
Seat 4: MrMsry (small blind) folded before Flop
Seat 5: SkyTaurus (big blind) folded before Flop
Seat 6: schoki77 collected ($2.15)



PokerStars Hand #222981363745:  Hold'em No Limit ($0.05/$0.10 USD) - 2021/01/23 20:21:17 ET
Table 'Demoulina III' 6-max Seat #4 is the button
Seat 1: memojr29 ($10 in chips) 
Seat 2: jorgeebanks ($9.50 in chips) 
Seat 3: E2AS ($12.23 in chips) 
Seat 4: MrMsry ($10 in chips) 
Seat 5: SkyTaurus ($24.81 in chips) 
Seat 6: schoki77 ($10.59 in chips) 
SkyTaurus: posts small blind $0.05
schoki77: posts big blind $0.10
*** HOLE CARDS ***
memojr29: folds 
jorgeebanks: raises $0.25 to $0.35
E2AS: folds 
MrMsry: calls $0.35
SkyTaurus: folds 
schoki77: folds 
*** FLOP *** [4h 8h 8d]
jorgeebanks: bets $0.41
MrMsry: calls $0.41
*** TURN *** [4h 8h 8d] [5s]
jorgeebanks: bets $0.48
MrMsry: calls $0.48
*** RIVER *** [4h 8h 8d 5s] [Ad]
jorgeebanks: checks 
MrMsry: bets $1.85
jorgeebanks: calls $1.85
*** SHOW DOWN ***
MrMsry: shows [Td Ac] (two pair, Aces and Eights)
jorgeebanks: shows [As Qc] (two pair, Aces and Eights - Queen kicker)
jorgeebanks collected $6.05 from pot
*** SUMMARY ***
Total pot $6.33 | Rake $0.28 
Board [4h 8h 8d 5s Ad]
Seat 1: memojr29 folded before Flop (didn't bet)
Seat 2: jorgeebanks showed [As Qc] and won ($6.05) with two pair, Aces and Eights
Seat 3: E2AS folded before Flop (didn't bet)
Seat 4: MrMsry (button) showed [Td Ac] and lost with two pair, Aces and Eights
Seat 5: SkyTaurus (small blind) folded before Flop
Seat 6: schoki77 (big blind) folded before Flop



PokerStars Hand #222981388874:  Hold'em No Limit ($0.05/$0.10 USD) - 2021/01/23 20:22:15 ET
Table 'Demoulina III' 6-max Seat #5 is the button
Seat 1: memojr29 ($10 in chips) 
Seat 2: jorgeebanks ($12.46 in chips) 
Seat 3: E2AS ($12.23 in chips) 
Seat 4: MrMsry ($10 in chips) 
Seat 5: SkyTaurus ($24.76 in chips) 
Seat 6: schoki77 ($10.49 in chips) 
schoki77: posts small blind $0.05
memojr29: posts big blind $0.10
*** HOLE CARDS ***
jorgeebanks: raises $0.20 to $0.30
E2AS: calls $0.30
MrMsry: folds 
SkyTaurus: folds 
schoki77: folds 
memojr29: folds 
*** FLOP *** [Jd 2h As]
jorgeebanks: bets $0.36
E2AS: calls $0.36
*** TURN *** [Jd 2h As] [2d]
jorgeebanks: checks 
E2AS: checks 
*** RIVER *** [Jd 2h As 2d] [3d]
jorgeebanks: checks 
E2AS: bets $0.90
jorgeebanks: folds 
Uncalled bet ($0.90) returned to E2AS
E2AS collected $1.40 from pot
E2AS: doesn't show hand 
*** SUMMARY ***
Total pot $1.47 | Rake $0.07 
Board [Jd 2h As 2d 3d]
Seat 1: memojr29 (big blind) folded before Flop
Seat 2: jorgeebanks folded on the River
Seat 3: E2AS collected ($1.40)
Seat 4: MrMsry folded before Flop (didn't bet)
Seat 5: SkyTaurus (button) folded before Flop (didn't bet)
Seat 6: schoki77 (small blind) folded before Flop



PokerStars Hand #222981406667:  Hold'em No Limit ($0.05/$0.10 USD) - 2021/01/23 20:22:56 ET
Table 'Demoulina III' 6-max Seat #6 is the button
Seat 1: memojr29 ($10 in chips) 
Seat 2: jorgeebanks ($11.80 in chips) 
Seat 3: E2AS ($12.97 in chips) 
Seat 4: MrMsry ($10 in chips) 
Seat 5: SkyTaurus ($24.76 in chips) 
Seat 6: schoki77 ($10.44 in chips) 
memojr29: posts small blind $0.05
jorgeebanks: posts big blind $0.10
*** HOLE CARDS ***
E2AS: folds 
MrMsry: folds 
SkyTaurus: folds 
schoki77: folds 
memojr29: folds 
Uncalled bet ($0.05) returned to jorgeebanks
jorgeebanks collected $0.10 from pot
jorgeebanks: doesn't show hand 
*** SUMMARY ***
Total pot $0.10 | Rake $0 
Seat 1: memojr29 (small blind) folded before Flop
Seat 2: jorgeebanks (big blind) collected ($0.10)
Seat 3: E2AS folded before Flop (didn't bet)
Seat 4: MrMsry folded before Flop (didn't bet)
Seat 5: SkyTaurus folded before Flop (didn't bet)
Seat 6: schoki77 (button) folded before Flop (didn't bet)



PokerStars Hand #222981411977:  Hold'em No Limit ($0.05/$0.10 USD) - 2021/01/23 20:23:08 ET
Table 'Demoulina III' 6-max Seat #1 is the button
Seat 1: memojr29 ($10 in chips) 
Seat 2: jorgeebanks ($11.85 in chips) 
Seat 3: E2AS ($12.97 in chips) 
Seat 4: MrMsry ($10 in chips) 
Seat 5: SkyTaurus ($24.76 in chips) 
Seat 6: schoki77 ($10.44 in chips) 
jorgeebanks: posts small blind $0.05
E2AS: posts big blind $0.10
*** HOLE CARDS ***
MrMsry: raises $0.21 to $0.31
SkyTaurus: folds 
schoki77: folds 
memojr29: folds 
jorgeebanks: raises $0.72 to $1.03
E2AS: folds 
MrMsry: folds 
Uncalled bet ($0.72) returned to jorgeebanks
jorgeebanks collected $0.72 from pot
jorgeebanks: doesn't show hand 
*** SUMMARY ***
Total pot $0.72 | Rake $0 
Seat 1: memojr29 (button) folded before Flop (didn't bet)
Seat 2: jorgeebanks (small blind) collected ($0.72)
Seat 3: E2AS (big blind) folded before Flop
Seat 4: MrMsry folded before Flop
Seat 5: SkyTaurus folded before Flop (didn't bet)
Seat 6: schoki77 folded before Flop (didn't bet)



PokerStars Hand #222981427116:  Hold'em No Limit ($0.05/$0.10 USD) - 2021/01/23 20:23:37 ET
Table 'Demoulina III' 6-max Seat #2 is the button
Seat 1: memojr29 ($10 in chips) 
Seat 2: jorgeebanks ($12.26 in chips) 
Seat 3: E2AS ($12.87 in chips) 
Seat 4: MrMsry ($10 in chips) 
Seat 5: SkyTaurus ($24.76 in chips) 
Seat 6: schoki77 ($10.44 in chips) 
E2AS: posts small blind $0.05
MrMsry: posts big blind $0.10
*** HOLE CARDS ***
SkyTaurus: folds 
schoki77: calls $0.10
memojr29: folds 
jorgeebanks: folds 
E2AS: calls $0.05
MrMsry: checks 
*** FLOP *** [3s 3d Qs]
E2AS: bets $0.10
MrMsry: folds 
schoki77: folds 
Uncalled bet ($0.10) returned to E2AS
E2AS collected $0.29 from pot
E2AS: doesn't show hand 
*** SUMMARY ***
Total pot $0.30 | Rake $0.01 
Board [3s 3d Qs]
Seat 1: memojr29 folded before Flop (didn't bet)
Seat 2: jorgeebanks (button) folded before Flop (didn't bet)
Seat 3: E2AS (small blind) collected ($0.29)
Seat 4: MrMsry (big blind) folded on the Flop
Seat 5: SkyTaurus folded before Flop (didn't bet)
Seat 6: schoki77 folded on the Flop



PokerStars Hand #222981439685:  Hold'em No Limit ($0.05/$0.10 USD) - 2021/01/23 20:24:06 ET
Table 'Demoulina III' 6-max Seat #3 is the button
Seat 1: memojr29 ($10 in chips) 
Seat 2: jorgeebanks ($12.26 in chips) 
Seat 3: E2AS ($13.06 in chips) 
Seat 4: MrMsry ($10 in chips) 
Seat 6: schoki77 ($10.34 in chips) 
MrMsry: posts small blind $0.05
SkyTaurus: is sitting out 
schoki77: posts big blind $0.10
*** HOLE CARDS ***
SkyTaurus leaves the table
memojr29: folds 
jorgeebanks: raises $0.20 to $0.30
E2AS: calls $0.30
MrMsry: calls $0.25
schoki77: folds 
*** FLOP *** [Qc Kc 5c]
MrMsry: checks 
jorgeebanks: bets $0.48
E2AS: folds 
MrMsry: folds 
Uncalled bet ($0.48) returned to jorgeebanks
jorgeebanks collected $0.96 from pot
jorgeebanks: doesn't show hand 
*** SUMMARY ***
Total pot $1 | Rake $0.04 
Board [Qc Kc 5c]
Seat 1: memojr29 folded before Flop (didn't bet)
Seat 2: jorgeebanks collected ($0.96)
Seat 3: E2AS (button) folded on the Flop
Seat 4: MrMsry (small blind) folded on the Flop
Seat 6: schoki77 (big blind) folded before Flop



PokerStars Hand #222981457824:  Hold'em No Limit ($0.05/$0.10 USD) - 2021/01/23 20:24:47 ET
Table 'Demoulina III' 6-max Seat #4 is the button
Seat 1: memojr29 ($10 in chips) 
Seat 2: jorgeebanks ($12.92 in chips) 
Seat 3: E2AS ($12.76 in chips) 
Seat 4: MrMsry ($10 in chips) 
Seat 6: schoki77 ($10.24 in chips) 
schoki77: posts small blind $0.05
memojr29: posts big blind $0.10
*** HOLE CARDS ***
jorgeebanks: raises $0.20 to $0.30
jesusfjn30 joins the table at seat #5 
E2AS: folds 
MrMsry: folds 
schoki77: folds 
memojr29: folds 
Uncalled bet ($0.20) returned to jorgeebanks
jorgeebanks collected $0.25 from pot
jorgeebanks: doesn't show hand 
*** SUMMARY ***
Total pot $0.25 | Rake $0 
Seat 1: memojr29 (big blind) folded before Flop
Seat 2: jorgeebanks collected ($0.25)
Seat 3: E2AS folded before Flop (didn't bet)
Seat 4: MrMsry (button) folded before Flop (didn't bet)
Seat 6: schoki77 (small blind) folded before Flop



PokerStars Hand #222981464305:  Hold'em No Limit ($0.05/$0.10 USD) - 2021/01/23 20:25:01 ET
Table 'Demoulina III' 6-max Seat #6 is the button
Seat 1: memojr29 ($10 in chips) 
Seat 2: jorgeebanks ($13.07 in chips) 
Seat 3: E2AS ($12.76 in chips) 
Seat 4: MrMsry ($10 in chips) 
Seat 5: jesusfjn30 ($10 in chips) 
Seat 6: schoki77 ($10.19 in chips) 
memojr29: posts small blind $0.05
jorgeebanks: posts big blind $0.10
jesusfjn30: posts big blind $0.10
*** HOLE CARDS ***
E2AS: raises $0.14 to $0.24
MrMsry: folds 
jesusfjn30: calls $0.14
schoki77: calls $0.24
memojr29: raises $1.46 to $1.70
jorgeebanks: folds 
E2AS: folds 
jesusfjn30: folds 
schoki77: folds 
Uncalled bet ($1.46) returned to memojr29
memojr29 collected $1.06 from pot
memojr29: doesn't show hand 
*** SUMMARY ***
Total pot $1.06 | Rake $0 
Seat 1: memojr29 (small blind) collected ($1.06)
Seat 2: jorgeebanks (big blind) folded before Flop
Seat 3: E2AS folded before Flop
Seat 4: MrMsry folded before Flop (didn't bet)
Seat 5: jesusfjn30 folded before Flop
Seat 6: schoki77 (button) folded before Flop



PokerStars Hand #222981479729:  Hold'em No Limit ($0.05/$0.10 USD) - 2021/01/23 20:25:36 ET
Table 'Demoulina III' 6-max Seat #1 is the button
Seat 1: memojr29 ($10.82 in chips) 
Seat 2: jorgeebanks ($12.97 in chips) 
Seat 3: E2AS ($12.52 in chips) 
Seat 4: MrMsry ($10 in chips) 
Seat 5: jesusfjn30 ($9.76 in chips) 
Seat 6: schoki77 ($9.95 in chips) 
jorgeebanks: posts small blind $0.05
E2AS: posts big blind $0.10
*** HOLE CARDS ***
MrMsry: folds 
jesusfjn30: calls $0.10
schoki77: folds 
memojr29: raises $0.35 to $0.45
jorgeebanks: folds 
E2AS: folds 
jesusfjn30: calls $0.35
*** FLOP *** [8d 7s 2c]
jesusfjn30: checks 
memojr29: bets $0.50
jesusfjn30: calls $0.50
*** TURN *** [8d 7s 2c] [Kd]
jesusfjn30: bets $0.20
memojr29: raises $1.18 to $1.38
jesusfjn30: folds 
Uncalled bet ($1.18) returned to memojr29
memojr29 collected $2.34 from pot
memojr29: doesn't show hand 
*** SUMMARY ***
Total pot $2.45 | Rake $0.11 
Board [8d 7s 2c Kd]
Seat 1: memojr29 (button) collected ($2.34)
Seat 2: jorgeebanks (small blind) folded before Flop
Seat 3: E2AS (big blind) folded before Flop
Seat 4: MrMsry folded before Flop (didn't bet)
Seat 5: jesusfjn30 folded on the Turn
Seat 6: schoki77 folded before Flop (didn't bet)



PokerStars Hand #222981494829:  Hold'em No Limit ($0.05/$0.10 USD) - 2021/01/23 20:26:11 ET
Table 'Demoulina III' 6-max Seat #2 is the button
Seat 1: memojr29 ($12.01 in chips) 
Seat 2: jorgeebanks ($12.92 in chips) 
Seat 3: E2AS ($12.42 in chips) 
Seat 4: MrMsry ($10 in chips) 
Seat 5: jesusfjn30 ($8.61 in chips) 
Seat 6: schoki77 ($9.95 in chips) 
E2AS: posts small blind $0.05
MrMsry: posts big blind $0.10
*** HOLE CARDS ***
jesusfjn30: folds 
schoki77: calls $0.10
memojr29: folds 
jorgeebanks: folds 
E2AS: folds 
MrMsry: checks 
*** FLOP *** [4d Jc 6h]
MrMsry: checks 
schoki77: bets $0.10
MrMsry: folds 
Uncalled bet ($0.10) returned to schoki77
schoki77 collected $0.24 from pot
schoki77: doesn't show hand 
*** SUMMARY ***
Total pot $0.25 | Rake $0.01 
Board [4d Jc 6h]
Seat 1: memojr29 folded before Flop (didn't bet)
Seat 2: jorgeebanks (button) folded before Flop (didn't bet)
Seat 3: E2AS (small blind) folded before Flop
Seat 4: MrMsry (big blind) folded on the Flop
Seat 5: jesusfjn30 folded before Flop (didn't bet)
Seat 6: schoki77 collected ($0.24)



PokerStars Hand #222981507120:  Hold'em No Limit ($0.05/$0.10 USD) - 2021/01/23 20:26:39 ET
Table 'Demoulina III' 6-max Seat #3 is the button
Seat 1: memojr29 ($12.01 in chips) 
Seat 2: jorgeebanks ($12.92 in chips) 
Seat 3: E2AS ($12.37 in chips) 
Seat 4: MrMsry ($10 in chips) 
Seat 5: jesusfjn30 ($8.61 in chips) 
Seat 6: schoki77 ($10.09 in chips) 
MrMsry: posts small blind $0.05
jesusfjn30: posts big blind $0.10
*** HOLE CARDS ***
schoki77: folds 
memojr29: folds 
jorgeebanks has timed out
jorgeebanks: folds 
E2AS: folds 
MrMsry: raises $0.21 to $0.31
jesusfjn30: folds 
Uncalled bet ($0.21) returned to MrMsry
MrMsry collected $0.20 from pot
MrMsry: doesn't show hand 
*** SUMMARY ***
Total pot $0.20 | Rake $0 
Seat 1: memojr29 folded before Flop (didn't bet)
Seat 2: jorgeebanks folded before Flop (didn't bet)
Seat 3: E2AS (button) folded before Flop (didn't bet)
Seat 4: MrMsry (small blind) collected ($0.20)
Seat 5: jesusfjn30 (big blind) folded before Flop
Seat 6: schoki77 folded before Flop (didn't bet)



PokerStars Hand #222981528732:  Hold'em No Limit ($0.05/$0.10 USD) - 2021/01/23 20:27:12 ET
Table 'Demoulina III' 6-max Seat #4 is the button
Seat 1: memojr29 ($12.01 in chips) 
Seat 2: jorgeebanks ($12.92 in chips) 
Seat 3: E2AS ($12.37 in chips) 
Seat 4: MrMsry ($10.10 in chips) 
Seat 5: jesusfjn30 ($8.51 in chips) 
Seat 6: schoki77 ($10.09 in chips) 
jesusfjn30: posts small blind $0.05
schoki77: posts big blind $0.10
*** HOLE CARDS ***
memojr29: raises $0.20 to $0.30
jorgeebanks: raises $0.90 to $1.20
E2AS: folds 
MrMsry: folds 
jesusfjn30: calls $1.15
schoki77: folds 
memojr29: folds 
*** FLOP *** [Ts Jd Th]
jesusfjn30: checks 
jorgeebanks: bets $1.34
jesusfjn30: calls $1.34
*** TURN *** [Ts Jd Th] [Td]
jesusfjn30: checks 
jorgeebanks: bets $2.80
jesusfjn30: raises $2.80 to $5.60
jorgeebanks: raises $2.80 to $8.40
jesusfjn30: calls $0.37 and is all-in
Uncalled bet ($2.43) returned to jorgeebanks
*** RIVER *** [Ts Jd Th Td] [6c]
*** SHOW DOWN ***
jesusfjn30: shows [Ad Tc] (four of a kind, Tens)
jorgeebanks: shows [Kd Kc] (a full house, Tens full of Kings)
jesusfjn30 collected $16.64 from pot
*** SUMMARY ***
Total pot $17.42 | Rake $0.78 
Board [Ts Jd Th Td 6c]
Seat 1: memojr29 folded before Flop
Seat 2: jorgeebanks showed [Kd Kc] and lost with a full house, Tens full of Kings
Seat 3: E2AS folded before Flop (didn't bet)
Seat 4: MrMsry (button) folded before Flop (didn't bet)
Seat 5: jesusfjn30 (small blind) showed [Ad Tc] and won ($16.64) with four of a kind, Tens
Seat 6: schoki77 (big blind) folded before Flop



PokerStars Hand #222981551368:  Hold'em No Limit ($0.05/$0.10 USD) - 2021/01/23 20:28:04 ET
Table 'Demoulina III' 6-max Seat #5 is the button
Seat 1: memojr29 ($11.71 in chips) 
Seat 2: jorgeebanks ($4.41 in chips) 
Seat 4: MrMsry ($10.10 in chips) 
Seat 5: jesusfjn30 ($16.64 in chips) 
Seat 6: schoki77 ($9.99 in chips) 
schoki77: posts small blind $0.05
memojr29: posts big blind $0.10
*** HOLE CARDS ***
jorgeebanks has timed out
jorgeebanks: folds 
jorgeebanks leaves the table
MrMsry: folds 
jesusfjn30: calls $0.10
harrison385 joins the table at seat #2 
schoki77: raises $0.30 to $0.40
memojr29: folds 
jesusfjn30: calls $0.30
*** FLOP *** [Qh 3c 9d]
schoki77: bets $0.43
jesusfjn30: folds 
Uncalled bet ($0.43) returned to schoki77
schoki77 collected $0.86 from pot
schoki77: doesn't show hand 
*** SUMMARY ***
Total pot $0.90 | Rake $0.04 
Board [Qh 3c 9d]
Seat 1: memojr29 (big blind) folded before Flop
Seat 2: jorgeebanks folded before Flop (didn't bet)
Seat 4: MrMsry folded before Flop (didn't bet)
Seat 5: jesusfjn30 (button) folded on the Flop
Seat 6: schoki77 (small blind) collected ($0.86)



PokerStars Hand #222981563811:  Hold'em No Limit ($0.05/$0.10 USD) - 2021/01/23 20:28:33 ET
Table 'Demoulina III' 6-max Seat #6 is the button
Seat 1: memojr29 ($11.61 in chips) 
Seat 2: harrison385 ($8 in chips) 
Seat 4: MrMsry ($10.10 in chips) 
Seat 5: jesusfjn30 ($16.24 in chips) 
Seat 6: schoki77 ($10.45 in chips) 
memojr29: posts small blind $0.05
harrison385: posts big blind $0.10
*** HOLE CARDS ***
MrMsry: folds 
jesusfjn30 has timed out
jesusfjn30: folds 
schoki77: raises $0.20 to $0.30
memojr29: folds 
harrison385: folds 
Uncalled bet ($0.20) returned to schoki77
harrison385 leaves the table
schoki77 collected $0.25 from pot
schoki77: doesn't show hand 
*** SUMMARY ***
Total pot $0.25 | Rake $0 
Seat 1: memojr29 (small blind) folded before Flop
Seat 2: harrison385 (big blind) folded before Flop
Seat 4: MrMsry folded before Flop (didn't bet)
Seat 5: jesusfjn30 folded before Flop (didn't bet)
Seat 6: schoki77 (button) collected ($0.25)



PokerStars Hand #222981573351:  Hold'em No Limit ($0.05/$0.10 USD) - 2021/01/23 20:28:56 ET
Table 'Demoulina III' 6-max Seat #1 is the button
Seat 1: memojr29 ($11.56 in chips) 
Seat 4: MrMsry ($10.10 in chips) 
Seat 6: schoki77 ($10.60 in chips) 
MrMsry: posts small blind $0.05
schoki77: posts big blind $0.10
*** HOLE CARDS ***
memojr29: raises $0.15 to $0.25
MrMsry: calls $0.20
schoki77: folds 
*** FLOP *** [5d 9s Qh]
MrMsry: checks 
memojr29: bets $0.29
MrMsry: calls $0.29
*** TURN *** [5d 9s Qh] [5c]
MrMsry: checks 
memojr29: checks 
*** RIVER *** [5d 9s Qh 5c] [Kd]
MrMsry: bets $0.95
memojr29: folds 
Uncalled bet ($0.95) returned to MrMsry
MrMsry collected $1.13 from pot
MrMsry: doesn't show hand 
*** SUMMARY ***
Total pot $1.18 | Rake $0.05 
Board [5d 9s Qh 5c Kd]
Seat 1: memojr29 (button) folded on the River
Seat 4: MrMsry (small blind) collected ($1.13)
Seat 6: schoki77 (big blind) folded before Flop



