PokerStars Hand #222971786185:  Hold'em No Limit ($0.05/$0.10 USD) - 2021/01/23 16:19:32 ET
Table 'Dike III' 6-max Seat #4 is the button
Seat 1: Manic Jay ($13 in chips) 
Seat 2: nettasha ($10.10 in chips) 
Seat 3: h00dyboy ($8.60 in chips) 
Seat 4: acesintown ($4.08 in chips) 
Seat 5: pensioner_x ($10.90 in chips) 
Seat 6: Nodrik ($13.32 in chips) 
pensioner_x: posts small blind $0.05
Nodrik: posts big blind $0.10
*** HOLE CARDS ***
Manic Jay: folds 
nettasha: raises $0.15 to $0.25
h00dyboy: folds 
acesintown: folds 
pensioner_x: folds 
Nodrik: folds 
Uncalled bet ($0.15) returned to nettasha
nettasha collected $0.25 from pot
nettasha: doesn't show hand 
*** SUMMARY ***
Total pot $0.25 | Rake $0 
Seat 1: Manic Jay folded before Flop (didn't bet)
Seat 2: nettasha collected ($0.25)
Seat 3: h00dyboy folded before Flop (didn't bet)
Seat 4: acesintown (button) folded before Flop (didn't bet)
Seat 5: pensioner_x (small blind) folded before Flop
Seat 6: Nodrik (big blind) folded before Flop



PokerStars Hand #222971800607:  Hold'em No Limit ($0.05/$0.10 USD) - 2021/01/23 16:19:48 ET
Table 'Dike III' 6-max Seat #5 is the button
Seat 1: Manic Jay ($13 in chips) 
Seat 2: nettasha ($10.25 in chips) 
Seat 3: h00dyboy ($8.60 in chips) 
Seat 4: acesintown ($4.08 in chips) 
Seat 5: pensioner_x ($10.85 in chips) 
Seat 6: Nodrik ($13.22 in chips) 
Nodrik: posts small blind $0.05
Manic Jay: posts big blind $0.10
*** HOLE CARDS ***
nettasha: folds 
h00dyboy: folds 
acesintown: calls $0.10
pensioner_x: raises $0.30 to $0.40
Nodrik: folds 
Manic Jay: calls $0.30
acesintown: calls $0.30
*** FLOP *** [Jd Th 2c]
Manic Jay: checks 
acesintown: bets $0.40
pensioner_x: raises $0.70 to $1.10
Manic Jay: folds 
acesintown: calls $0.70
*** TURN *** [Jd Th 2c] [4c]
acesintown: checks 
pensioner_x: bets $3.29
acesintown: calls $2.58 and is all-in
Uncalled bet ($0.71) returned to pensioner_x
*** RIVER *** [Jd Th 2c 4c] [8c]
*** SHOW DOWN ***
acesintown: shows [4d Td] (two pair, Tens and Fours)
pensioner_x: shows [Qd Jc] (a pair of Jacks)
acesintown collected $8.22 from pot
*** SUMMARY ***
Total pot $8.61 | Rake $0.39 
Board [Jd Th 2c 4c 8c]
Seat 1: Manic Jay (big blind) folded on the Flop
Seat 2: nettasha folded before Flop (didn't bet)
Seat 3: h00dyboy folded before Flop (didn't bet)
Seat 4: acesintown showed [4d Td] and won ($8.22) with two pair, Tens and Fours
Seat 5: pensioner_x (button) showed [Qd Jc] and lost with a pair of Jacks
Seat 6: Nodrik (small blind) folded before Flop



PokerStars Hand #222971840880:  Hold'em No Limit ($0.05/$0.10 USD) - 2021/01/23 16:20:35 ET
Table 'Dike III' 6-max Seat #6 is the button
Seat 1: Manic Jay ($12.60 in chips) 
Seat 2: nettasha ($10.25 in chips) 
Seat 3: h00dyboy ($8.60 in chips) 
Seat 4: acesintown ($8.22 in chips) 
Seat 5: pensioner_x ($10 in chips) 
Seat 6: Nodrik ($13.17 in chips) 
Manic Jay: posts small blind $0.05
nettasha: posts big blind $0.10
*** HOLE CARDS ***
h00dyboy: folds 
acesintown: calls $0.10
pensioner_x: raises $0.30 to $0.40
Nodrik: folds 
Manic Jay: folds 
nettasha: folds 
acesintown: calls $0.30
*** FLOP *** [2d 4h 3s]
acesintown: checks 
pensioner_x: bets $0.46
acesintown: folds 
Uncalled bet ($0.46) returned to pensioner_x
pensioner_x collected $0.91 from pot
pensioner_x: doesn't show hand 
*** SUMMARY ***
Total pot $0.95 | Rake $0.04 
Board [2d 4h 3s]
Seat 1: Manic Jay (small blind) folded before Flop
Seat 2: nettasha (big blind) folded before Flop
Seat 3: h00dyboy folded before Flop (didn't bet)
Seat 4: acesintown folded on the Flop
Seat 5: pensioner_x collected ($0.91)
Seat 6: Nodrik (button) folded before Flop (didn't bet)



PokerStars Hand #222971870738:  Hold'em No Limit ($0.05/$0.10 USD) - 2021/01/23 16:21:10 ET
Table 'Dike III' 6-max Seat #1 is the button
Seat 1: Manic Jay ($12.55 in chips) 
Seat 2: nettasha ($10.15 in chips) 
Seat 3: h00dyboy ($8.60 in chips) 
Seat 4: acesintown ($7.82 in chips) 
Seat 5: pensioner_x ($10.51 in chips) 
Seat 6: Nodrik ($13.17 in chips) 
nettasha: posts small blind $0.05
h00dyboy: posts big blind $0.10
*** HOLE CARDS ***
acesintown: raises $0.30 to $0.40
pensioner_x: calls $0.40
Nodrik: folds 
Manic Jay: raises $0.80 to $1.20
nettasha: folds 
h00dyboy: folds 
acesintown: calls $0.80
pensioner_x: calls $0.80
*** FLOP *** [7h Ah 2h]
acesintown: checks 
pensioner_x: checks 
Manic Jay: bets $1.79
acesintown: folds 
pensioner_x: folds 
Uncalled bet ($1.79) returned to Manic Jay
Manic Jay collected $3.58 from pot
*** SUMMARY ***
Total pot $3.75 | Rake $0.17 
Board [7h Ah 2h]
Seat 1: Manic Jay (button) collected ($3.58)
Seat 2: nettasha (small blind) folded before Flop
Seat 3: h00dyboy (big blind) folded before Flop
Seat 4: acesintown folded on the Flop
Seat 5: pensioner_x folded on the Flop
Seat 6: Nodrik folded before Flop (didn't bet)



PokerStars Hand #222971909324:  Hold'em No Limit ($0.05/$0.10 USD) - 2021/01/23 16:21:55 ET
Table 'Dike III' 6-max Seat #2 is the button
Seat 1: Manic Jay ($14.93 in chips) 
Seat 2: nettasha ($10.10 in chips) 
Seat 3: h00dyboy ($8.50 in chips) 
Seat 4: acesintown ($6.62 in chips) 
Seat 5: pensioner_x ($10 in chips) 
Seat 6: Nodrik ($13.17 in chips) 
h00dyboy: posts small blind $0.05
acesintown: posts big blind $0.10
*** HOLE CARDS ***
pensioner_x: folds 
Nodrik: folds 
Manic Jay: calls $0.10
nettasha: calls $0.10
h00dyboy: calls $0.05
acesintown: raises $0.20 to $0.30
Manic Jay: calls $0.20
nettasha: folds 
h00dyboy: folds 
*** FLOP *** [2h Ad Qs]
acesintown: checks 
Manic Jay: checks 
*** TURN *** [2h Ad Qs] [8h]
acesintown: bets $0.30
Manic Jay: calls $0.30
*** RIVER *** [2h Ad Qs 8h] [4c]
acesintown: bets $0.50
Manic Jay: folds 
Uncalled bet ($0.50) returned to acesintown
acesintown collected $1.34 from pot
acesintown: doesn't show hand 
*** SUMMARY ***
Total pot $1.40 | Rake $0.06 
Board [2h Ad Qs 8h 4c]
Seat 1: Manic Jay folded on the River
Seat 2: nettasha (button) folded before Flop
Seat 3: h00dyboy (small blind) folded before Flop
Seat 4: acesintown (big blind) collected ($1.34)
Seat 5: pensioner_x folded before Flop (didn't bet)
Seat 6: Nodrik folded before Flop (didn't bet)



PokerStars Hand #222971981716:  Hold'em No Limit ($0.05/$0.10 USD) - 2021/01/23 16:23:12 ET
Table 'Dike III' 6-max Seat #3 is the button
Seat 1: Manic Jay ($14.33 in chips) 
Seat 2: nettasha ($10 in chips) 
Seat 3: h00dyboy ($8.40 in chips) 
Seat 4: acesintown ($7.36 in chips) 
Seat 5: pensioner_x ($10 in chips) 
Seat 6: Nodrik ($13.17 in chips) 
acesintown: posts small blind $0.05
pensioner_x: posts big blind $0.10
*** HOLE CARDS ***
Nodrik: folds 
Manic Jay: folds 
nettasha: folds 
h00dyboy: folds 
acesintown: folds 
Uncalled bet ($0.05) returned to pensioner_x
pensioner_x collected $0.10 from pot
pensioner_x: doesn't show hand 
*** SUMMARY ***
Total pot $0.10 | Rake $0 
Seat 1: Manic Jay folded before Flop (didn't bet)
Seat 2: nettasha folded before Flop (didn't bet)
Seat 3: h00dyboy (button) folded before Flop (didn't bet)
Seat 4: acesintown (small blind) folded before Flop
Seat 5: pensioner_x (big blind) collected ($0.10)
Seat 6: Nodrik folded before Flop (didn't bet)



PokerStars Hand #222971995710:  Hold'em No Limit ($0.05/$0.10 USD) - 2021/01/23 16:23:28 ET
Table 'Dike III' 6-max Seat #4 is the button
Seat 1: Manic Jay ($14.33 in chips) 
Seat 2: nettasha ($10 in chips) 
Seat 3: h00dyboy ($8.40 in chips) 
Seat 4: acesintown ($7.31 in chips) 
Seat 5: pensioner_x ($10.05 in chips) 
Seat 6: Nodrik ($13.17 in chips) 
pensioner_x: posts small blind $0.05
Nodrik: posts big blind $0.10
*** HOLE CARDS ***
Manic Jay: calls $0.10
nettasha: folds 
h00dyboy: folds 
acesintown: folds 
pensioner_x: raises $0.30 to $0.40
Nodrik: folds 
Manic Jay: calls $0.30
*** FLOP *** [Th 6c Ts]
pensioner_x: bets $0.43
Manic Jay: folds 
Uncalled bet ($0.43) returned to pensioner_x
pensioner_x collected $0.86 from pot
pensioner_x: doesn't show hand 
*** SUMMARY ***
Total pot $0.90 | Rake $0.04 
Board [Th 6c Ts]
Seat 1: Manic Jay folded on the Flop
Seat 2: nettasha folded before Flop (didn't bet)
Seat 3: h00dyboy folded before Flop (didn't bet)
Seat 4: acesintown (button) folded before Flop (didn't bet)
Seat 5: pensioner_x (small blind) collected ($0.86)
Seat 6: Nodrik (big blind) folded before Flop



PokerStars Hand #222972018224:  Hold'em No Limit ($0.05/$0.10 USD) - 2021/01/23 16:23:54 ET
Table 'Dike III' 6-max Seat #5 is the button
Seat 1: Manic Jay ($13.93 in chips) 
Seat 2: nettasha ($10 in chips) 
Seat 3: h00dyboy ($8.40 in chips) 
Seat 4: acesintown ($7.31 in chips) 
Seat 5: pensioner_x ($10.51 in chips) 
Seat 6: Nodrik ($13.07 in chips) 
Nodrik: posts small blind $0.05
Manic Jay: posts big blind $0.10
*** HOLE CARDS ***
nettasha: folds 
h00dyboy: folds 
acesintown: folds 
pensioner_x: raises $0.20 to $0.30
Nodrik: folds 
Manic Jay: folds 
Uncalled bet ($0.20) returned to pensioner_x
pensioner_x collected $0.25 from pot
pensioner_x: doesn't show hand 
*** SUMMARY ***
Total pot $0.25 | Rake $0 
Seat 1: Manic Jay (big blind) folded before Flop
Seat 2: nettasha folded before Flop (didn't bet)
Seat 3: h00dyboy folded before Flop (didn't bet)
Seat 4: acesintown folded before Flop (didn't bet)
Seat 5: pensioner_x (button) collected ($0.25)
Seat 6: Nodrik (small blind) folded before Flop



PokerStars Hand #222972047548:  Hold'em No Limit ($0.05/$0.10 USD) - 2021/01/23 16:24:29 ET
Table 'Dike III' 6-max Seat #6 is the button
Seat 1: Manic Jay ($13.83 in chips) 
Seat 2: nettasha ($10 in chips) 
Seat 3: h00dyboy ($8.40 in chips) 
Seat 4: acesintown ($7.31 in chips) 
Seat 5: pensioner_x ($10.66 in chips) 
Seat 6: Nodrik ($13.02 in chips) 
Manic Jay: posts small blind $0.05
nettasha: posts big blind $0.10
*** HOLE CARDS ***
h00dyboy: folds 
acesintown: folds 
pensioner_x: folds 
Nodrik: raises $0.13 to $0.23
Manic Jay: calls $0.18
nettasha: calls $0.13
*** FLOP *** [7s 7c Qc]
Manic Jay: checks 
nettasha: checks 
Nodrik: checks 
*** TURN *** [7s 7c Qc] [2h]
Manic Jay: checks 
nettasha: checks 
Nodrik: bets $0.46
Manic Jay: folds 
nettasha: folds 
Uncalled bet ($0.46) returned to Nodrik
Nodrik collected $0.66 from pot
Nodrik: doesn't show hand 
*** SUMMARY ***
Total pot $0.69 | Rake $0.03 
Board [7s 7c Qc 2h]
Seat 1: Manic Jay (small blind) folded on the Turn
Seat 2: nettasha (big blind) folded on the Turn
Seat 3: h00dyboy folded before Flop (didn't bet)
Seat 4: acesintown folded before Flop (didn't bet)
Seat 5: pensioner_x folded before Flop (didn't bet)
Seat 6: Nodrik (button) collected ($0.66)



PokerStars Hand #222972100690:  Hold'em No Limit ($0.05/$0.10 USD) - 2021/01/23 16:25:31 ET
Table 'Dike III' 6-max Seat #1 is the button
Seat 1: Manic Jay ($13.60 in chips) 
Seat 2: nettasha ($10 in chips) 
Seat 3: h00dyboy ($8.40 in chips) 
Seat 4: acesintown ($7.31 in chips) 
Seat 5: pensioner_x ($10.66 in chips) 
Seat 6: Nodrik ($13.45 in chips) 
nettasha: posts small blind $0.05
h00dyboy: posts big blind $0.10
*** HOLE CARDS ***
acesintown: folds 
pensioner_x: raises $0.20 to $0.30
Nodrik: folds 
Manic Jay: folds 
nettasha: folds 
h00dyboy: folds 
Uncalled bet ($0.20) returned to pensioner_x
pensioner_x collected $0.25 from pot
pensioner_x: doesn't show hand 
*** SUMMARY ***
Total pot $0.25 | Rake $0 
Seat 1: Manic Jay (button) folded before Flop (didn't bet)
Seat 2: nettasha (small blind) folded before Flop
Seat 3: h00dyboy (big blind) folded before Flop
Seat 4: acesintown folded before Flop (didn't bet)
Seat 5: pensioner_x collected ($0.25)
Seat 6: Nodrik folded before Flop (didn't bet)



PokerStars Hand #222972112721:  Hold'em No Limit ($0.05/$0.10 USD) - 2021/01/23 16:25:46 ET
Table 'Dike III' 6-max Seat #2 is the button
Seat 1: Manic Jay ($13.60 in chips) 
Seat 2: nettasha ($10 in chips) 
Seat 3: h00dyboy ($8.30 in chips) 
Seat 4: acesintown ($7.31 in chips) 
Seat 5: pensioner_x ($10.81 in chips) 
Seat 6: Nodrik ($13.45 in chips) 
h00dyboy: posts small blind $0.05
acesintown: posts big blind $0.10
*** HOLE CARDS ***
pensioner_x: folds 
Nodrik: folds 
Manic Jay: folds 
nettasha: folds 
h00dyboy: folds 
Uncalled bet ($0.05) returned to acesintown
acesintown collected $0.10 from pot
acesintown: doesn't show hand 
*** SUMMARY ***
Total pot $0.10 | Rake $0 
Seat 1: Manic Jay folded before Flop (didn't bet)
Seat 2: nettasha (button) folded before Flop (didn't bet)
Seat 3: h00dyboy (small blind) folded before Flop
Seat 4: acesintown (big blind) collected ($0.10)
Seat 5: pensioner_x folded before Flop (didn't bet)
Seat 6: Nodrik folded before Flop (didn't bet)



PokerStars Hand #222972119552:  Hold'em No Limit ($0.05/$0.10 USD) - 2021/01/23 16:25:54 ET
Table 'Dike III' 6-max Seat #3 is the button
Seat 1: Manic Jay ($13.60 in chips) 
Seat 2: nettasha ($10 in chips) 
Seat 3: h00dyboy ($8.25 in chips) 
Seat 4: acesintown ($7.36 in chips) 
Seat 6: Nodrik ($13.45 in chips) 
acesintown: posts small blind $0.05
pensioner_x: is sitting out 
Nodrik: posts big blind $0.10
*** HOLE CARDS ***
Manic Jay: calls $0.10
nettasha: folds 
h00dyboy: folds 
acesintown: folds 
Nodrik: checks 
*** FLOP *** [Ac Td 9d]
Nodrik: checks 
Manic Jay: checks 
*** TURN *** [Ac Td 9d] [2d]
Nodrik: checks 
Manic Jay: checks 
*** RIVER *** [Ac Td 9d 2d] [8c]
Nodrik: bets $0.12
Manic Jay: calls $0.12
*** SHOW DOWN ***
Nodrik: shows [6s Ah] (a pair of Aces)
Manic Jay: mucks hand 
Nodrik collected $0.47 from pot
*** SUMMARY ***
Total pot $0.49 | Rake $0.02 
Board [Ac Td 9d 2d 8c]
Seat 1: Manic Jay mucked
Seat 2: nettasha folded before Flop (didn't bet)
Seat 3: h00dyboy (button) folded before Flop (didn't bet)
Seat 4: acesintown (small blind) folded before Flop
Seat 6: Nodrik (big blind) showed [6s Ah] and won ($0.47) with a pair of Aces



PokerStars Hand #222972146494:  Hold'em No Limit ($0.05/$0.10 USD) - 2021/01/23 16:26:25 ET
Table 'Dike III' 6-max Seat #4 is the button
Seat 1: Manic Jay ($13.38 in chips) 
Seat 2: nettasha ($10 in chips) 
Seat 3: h00dyboy ($8.25 in chips) 
Seat 4: acesintown ($7.31 in chips) 
Seat 6: Nodrik ($13.70 in chips) 
Nodrik: posts small blind $0.05
Manic Jay: posts big blind $0.10
*** HOLE CARDS ***
nettasha: folds 
h00dyboy: folds 
acesintown: folds 
Nodrik: folds 
Uncalled bet ($0.05) returned to Manic Jay
Manic Jay collected $0.10 from pot
*** SUMMARY ***
Total pot $0.10 | Rake $0 
Seat 1: Manic Jay (big blind) collected ($0.10)
Seat 2: nettasha folded before Flop (didn't bet)
Seat 3: h00dyboy folded before Flop (didn't bet)
Seat 4: acesintown (button) folded before Flop (didn't bet)
Seat 6: Nodrik (small blind) folded before Flop



PokerStars Hand #222972162905:  Hold'em No Limit ($0.05/$0.10 USD) - 2021/01/23 16:26:45 ET
Table 'Dike III' 6-max Seat #6 is the button
Seat 1: Manic Jay ($13.43 in chips) 
Seat 2: nettasha ($10 in chips) 
Seat 3: h00dyboy ($8.25 in chips) 
Seat 4: acesintown ($7.31 in chips) 
Seat 6: Nodrik ($13.65 in chips) 
Manic Jay: posts small blind $0.05
nettasha: posts big blind $0.10
*** HOLE CARDS ***
h00dyboy: folds 
acesintown: folds 
Nodrik: folds 
Manic Jay: calls $0.05
nettasha: checks 
*** FLOP *** [9d Kd Kc]
Manic Jay: checks 
nettasha: checks 
*** TURN *** [9d Kd Kc] [Qs]
Manic Jay: checks 
nettasha: checks 
*** RIVER *** [9d Kd Kc Qs] [5d]
Manic Jay: checks 
nettasha: checks 
*** SHOW DOWN ***
Manic Jay: shows [Jd 4c] (a pair of Kings)
nettasha: mucks hand 
Manic Jay collected $0.19 from pot
*** SUMMARY ***
Total pot $0.20 | Rake $0.01 
Board [9d Kd Kc Qs 5d]
Seat 1: Manic Jay (small blind) showed [Jd 4c] and won ($0.19) with a pair of Kings
Seat 2: nettasha (big blind) mucked
Seat 3: h00dyboy folded before Flop (didn't bet)
Seat 4: acesintown folded before Flop (didn't bet)
Seat 6: Nodrik (button) folded before Flop (didn't bet)



PokerStars Hand #222972178381:  Hold'em No Limit ($0.05/$0.10 USD) - 2021/01/23 16:27:03 ET
Table 'Dike III' 6-max Seat #1 is the button
Seat 1: Manic Jay ($13.52 in chips) 
Seat 2: nettasha ($10 in chips) 
Seat 3: h00dyboy ($8.25 in chips) 
Seat 4: acesintown ($7.31 in chips) 
Seat 6: Nodrik ($13.65 in chips) 
nettasha: posts small blind $0.05
h00dyboy: posts big blind $0.10
*** HOLE CARDS ***
acesintown: folds 
Nodrik: folds 
Manic Jay: raises $0.20 to $0.30
nettasha: raises $0.60 to $0.90
h00dyboy: folds 
Manic Jay: raises $1.80 to $2.70
nettasha: folds 
Uncalled bet ($1.80) returned to Manic Jay
Manic Jay collected $1.90 from pot
*** SUMMARY ***
Total pot $1.90 | Rake $0 
Seat 1: Manic Jay (button) collected ($1.90)
Seat 2: nettasha (small blind) folded before Flop
Seat 3: h00dyboy (big blind) folded before Flop
Seat 4: acesintown folded before Flop (didn't bet)
Seat 6: Nodrik folded before Flop (didn't bet)



PokerStars Hand #222972204876:  Hold'em No Limit ($0.05/$0.10 USD) - 2021/01/23 16:27:34 ET
Table 'Dike III' 6-max Seat #2 is the button
Seat 1: Manic Jay ($14.52 in chips) 
Seat 2: nettasha ($10 in chips) 
Seat 3: h00dyboy ($8.15 in chips) 
Seat 4: acesintown ($7.31 in chips) 
Seat 6: Nodrik ($13.65 in chips) 
h00dyboy: posts small blind $0.05
acesintown: posts big blind $0.10
*** HOLE CARDS ***
Nodrik: folds 
Manic Jay: folds 
nettasha: folds 
h00dyboy: raises $0.20 to $0.30
acesintown: folds 
Uncalled bet ($0.20) returned to h00dyboy
h00dyboy collected $0.20 from pot
h00dyboy: doesn't show hand 
*** SUMMARY ***
Total pot $0.20 | Rake $0 
Seat 1: Manic Jay folded before Flop (didn't bet)
Seat 2: nettasha (button) folded before Flop (didn't bet)
Seat 3: h00dyboy (small blind) collected ($0.20)
Seat 4: acesintown (big blind) folded before Flop
Seat 6: Nodrik folded before Flop (didn't bet)



PokerStars Hand #222972214528:  Hold'em No Limit ($0.05/$0.10 USD) - 2021/01/23 16:27:45 ET
Table 'Dike III' 6-max Seat #3 is the button
Seat 1: Manic Jay ($14.52 in chips) 
Seat 2: nettasha ($10 in chips) 
Seat 3: h00dyboy ($8.25 in chips) 
Seat 4: acesintown ($7.21 in chips) 
Seat 6: Nodrik ($13.65 in chips) 
acesintown: posts small blind $0.05
Nodrik: posts big blind $0.10
*** HOLE CARDS ***
Manic Jay: folds 
nettasha: raises $0.15 to $0.25
h00dyboy: folds 
acesintown: raises $0.35 to $0.60
Nodrik: folds 
nettasha: calls $0.35
*** FLOP *** [2h 7d 6c]
acesintown: checks 
nettasha: checks 
*** TURN *** [2h 7d 6c] [7c]
acesintown: checks 
nettasha: checks 
*** RIVER *** [2h 7d 6c 7c] [8d]
acesintown has timed out
acesintown: checks 
nettasha: checks 
*** SHOW DOWN ***
acesintown: shows [Td Jd] (a pair of Sevens)
nettasha: shows [Js Ts] (a pair of Sevens)
acesintown collected $0.62 from pot
nettasha collected $0.62 from pot
*** SUMMARY ***
Total pot $1.30 | Rake $0.06 
Board [2h 7d 6c 7c 8d]
Seat 1: Manic Jay folded before Flop (didn't bet)
Seat 2: nettasha showed [Js Ts] and won ($0.62) with a pair of Sevens
Seat 3: h00dyboy (button) folded before Flop (didn't bet)
Seat 4: acesintown (small blind) showed [Td Jd] and won ($0.62) with a pair of Sevens
Seat 6: Nodrik (big blind) folded before Flop



PokerStars Hand #222972311645:  Hold'em No Limit ($0.05/$0.10 USD) - 2021/01/23 16:29:40 ET
Table 'Dike III' 6-max Seat #4 is the button
Seat 1: Manic Jay ($14.52 in chips) 
Seat 2: nettasha ($10.02 in chips) 
Seat 3: h00dyboy ($8.25 in chips) 
Seat 4: acesintown ($7.23 in chips) 
Seat 6: Nodrik ($13.55 in chips) 
Nodrik: posts small blind $0.05
Manic Jay: posts big blind $0.10
*** HOLE CARDS ***
nettasha: folds 
h00dyboy: folds 
acesintown: folds 
Nodrik: raises $0.20 to $0.30
Manic Jay: folds 
Uncalled bet ($0.20) returned to Nodrik
Nodrik collected $0.20 from pot
Nodrik: doesn't show hand 
*** SUMMARY ***
Total pot $0.20 | Rake $0 
Seat 1: Manic Jay (big blind) folded before Flop
Seat 2: nettasha folded before Flop (didn't bet)
Seat 3: h00dyboy folded before Flop (didn't bet)
Seat 4: acesintown (button) folded before Flop (didn't bet)
Seat 6: Nodrik (small blind) collected ($0.20)



PokerStars Hand #222972326603:  Hold'em No Limit ($0.05/$0.10 USD) - 2021/01/23 16:29:57 ET
Table 'Dike III' 6-max Seat #6 is the button
Seat 1: Manic Jay ($14.42 in chips) 
Seat 2: nettasha ($10.02 in chips) 
Seat 3: h00dyboy ($8.25 in chips) 
Seat 4: acesintown ($7.23 in chips) 
Seat 6: Nodrik ($13.65 in chips) 
Manic Jay: posts small blind $0.05
nettasha: posts big blind $0.10
pensioner_x: sits out 
*** HOLE CARDS ***
h00dyboy: folds 
acesintown: raises $0.20 to $0.30
Nodrik: folds 
Manic Jay: raises $0.60 to $0.90
nettasha: calls $0.80
acesintown: calls $0.60
*** FLOP *** [3h 5h Qs]
Manic Jay: checks 
nettasha: bets $2.30
acesintown: folds 
Manic Jay: folds 
Uncalled bet ($2.30) returned to nettasha
nettasha collected $2.58 from pot
nettasha: doesn't show hand 
*** SUMMARY ***
Total pot $2.70 | Rake $0.12 
Board [3h 5h Qs]
Seat 1: Manic Jay (small blind) folded on the Flop
Seat 2: nettasha (big blind) collected ($2.58)
Seat 3: h00dyboy folded before Flop (didn't bet)
Seat 4: acesintown folded on the Flop
Seat 6: Nodrik (button) folded before Flop (didn't bet)



PokerStars Hand #222972353641:  Hold'em No Limit ($0.05/$0.10 USD) - 2021/01/23 16:30:29 ET
Table 'Dike III' 6-max Seat #1 is the button
Seat 1: Manic Jay ($13.52 in chips) 
Seat 2: nettasha ($11.70 in chips) 
Seat 3: h00dyboy ($8.25 in chips) 
Seat 4: acesintown ($6.33 in chips) 
Seat 6: Nodrik ($13.65 in chips) 
nettasha: posts small blind $0.05
h00dyboy: posts big blind $0.10
pensioner_x: sits out 
*** HOLE CARDS ***
acesintown has timed out
acesintown: folds 
Nodrik: raises $0.13 to $0.23
Manic Jay: folds 
nettasha: raises $0.67 to $0.90
h00dyboy: folds 
Nodrik: calls $0.67
*** FLOP *** [5s Jc 6c]
nettasha: bets $0.91
Nodrik: folds 
Uncalled bet ($0.91) returned to nettasha
nettasha collected $1.81 from pot
nettasha: doesn't show hand 
*** SUMMARY ***
Total pot $1.90 | Rake $0.09 
Board [5s Jc 6c]
Seat 1: Manic Jay (button) folded before Flop (didn't bet)
Seat 2: nettasha (small blind) collected ($1.81)
Seat 3: h00dyboy (big blind) folded before Flop
Seat 4: acesintown folded before Flop (didn't bet)
Seat 6: Nodrik folded on the Flop



PokerStars Hand #222972409542:  Hold'em No Limit ($0.05/$0.10 USD) - 2021/01/23 16:31:30 ET
Table 'Dike III' 6-max Seat #2 is the button
Seat 1: Manic Jay ($13.52 in chips) 
Seat 2: nettasha ($12.61 in chips) 
Seat 3: h00dyboy ($8.15 in chips) 
Seat 4: acesintown ($6.33 in chips) 
Seat 6: Nodrik ($12.75 in chips) 
h00dyboy: posts small blind $0.05
acesintown: posts big blind $0.10
pensioner_x: sits out 
*** HOLE CARDS ***
Nodrik: folds 
Manic Jay: calls $0.10
nettasha: folds 
h00dyboy: calls $0.05
acesintown: checks 
*** FLOP *** [2s 8d Js]
h00dyboy: checks 
acesintown: checks 
Manic Jay: bets $0.29
h00dyboy: calls $0.29
acesintown has timed out
acesintown: folds 
*** TURN *** [2s 8d Js] [6d]
h00dyboy: checks 
Manic Jay: checks 
*** RIVER *** [2s 8d Js 6d] [Jd]
h00dyboy: bets $0.51
Manic Jay: folds 
Uncalled bet ($0.51) returned to h00dyboy
h00dyboy collected $0.84 from pot
h00dyboy: doesn't show hand 
*** SUMMARY ***
Total pot $0.88 | Rake $0.04 
Board [2s 8d Js 6d Jd]
Seat 1: Manic Jay folded on the River
Seat 2: nettasha (button) folded before Flop (didn't bet)
Seat 3: h00dyboy (small blind) collected ($0.84)
Seat 4: acesintown (big blind) folded on the Flop
Seat 6: Nodrik folded before Flop (didn't bet)



PokerStars Hand #222972460890:  Hold'em No Limit ($0.05/$0.10 USD) - 2021/01/23 16:32:30 ET
Table 'Dike III' 6-max Seat #3 is the button
Seat 1: Manic Jay ($13.13 in chips) 
Seat 2: nettasha ($12.61 in chips) 
Seat 3: h00dyboy ($8.60 in chips) 
Seat 6: Nodrik ($12.75 in chips) 
Nodrik: posts small blind $0.05
Manic Jay: posts big blind $0.10
*** HOLE CARDS ***
nettasha: raises $0.15 to $0.25
h00dyboy: calls $0.25
Nodrik: folds 
Manic Jay: folds 
*** FLOP *** [8d 3d Ad]
nettasha: checks 
h00dyboy: checks 
*** TURN *** [8d 3d Ad] [8s]
nettasha: checks 
h00dyboy: checks 
*** RIVER *** [8d 3d Ad 8s] [Ac]
nettasha: checks 
h00dyboy: checks 
*** SHOW DOWN ***
nettasha: shows [5c 6c] (two pair, Aces and Eights)
h00dyboy: shows [9d 9h] (two pair, Aces and Nines)
h00dyboy collected $0.62 from pot
*** SUMMARY ***
Total pot $0.65 | Rake $0.03 
Board [8d 3d Ad 8s Ac]
Seat 1: Manic Jay (big blind) folded before Flop
Seat 2: nettasha showed [5c 6c] and lost with two pair, Aces and Eights
Seat 3: h00dyboy (button) showed [9d 9h] and won ($0.62) with two pair, Aces and Nines
Seat 6: Nodrik (small blind) folded before Flop



PokerStars Hand #222972497629:  Hold'em No Limit ($0.05/$0.10 USD) - 2021/01/23 16:33:14 ET
Table 'Dike III' 6-max Seat #6 is the button
Seat 1: Manic Jay ($13.03 in chips) 
Seat 2: nettasha ($12.36 in chips) 
Seat 3: h00dyboy ($8.97 in chips) 
Seat 6: Nodrik ($12.70 in chips) 
Manic Jay: posts small blind $0.05
nettasha: posts big blind $0.10
acesintown: sits out 
pensioner_x: sits out 
*** HOLE CARDS ***
h00dyboy: folds 
Nodrik: folds 
Manic Jay: raises $0.20 to $0.30
nettasha: calls $0.20
*** FLOP *** [Jh Ac Qd]
Manic Jay: bets $0.30
nettasha: calls $0.30
*** TURN *** [Jh Ac Qd] [Ks]
Manic Jay: checks 
nettasha: bets $1.02
Manic Jay: calls $1.02
*** RIVER *** [Jh Ac Qd Ks] [4s]
Manic Jay: checks 
nettasha: checks 
*** SHOW DOWN ***
Manic Jay: shows [As 8d] (a pair of Aces)
nettasha: mucks hand 
Manic Jay collected $3.09 from pot
*** SUMMARY ***
Total pot $3.24 | Rake $0.15 
Board [Jh Ac Qd Ks 4s]
Seat 1: Manic Jay (small blind) showed [As 8d] and won ($3.09) with a pair of Aces
Seat 2: nettasha (big blind) mucked
Seat 3: h00dyboy folded before Flop (didn't bet)
Seat 6: Nodrik (button) folded before Flop (didn't bet)



PokerStars Hand #222972535478:  Hold'em No Limit ($0.05/$0.10 USD) - 2021/01/23 16:33:59 ET
Table 'Dike III' 6-max Seat #1 is the button
Seat 1: Manic Jay ($14.50 in chips) 
Seat 2: nettasha ($10.74 in chips) 
Seat 3: h00dyboy ($8.97 in chips) 
Seat 4: acesintown ($6.23 in chips) 
Seat 6: Nodrik ($12.70 in chips) 
nettasha: posts small blind $0.05
h00dyboy: posts big blind $0.10
acesintown: posts small blind $0.05
pensioner_x: sits out 
*** HOLE CARDS ***
acesintown: raises $0.20 to $0.30
Nodrik: folds 
Manic Jay: folds 
nettasha: folds 
h00dyboy: folds 
Uncalled bet ($0.20) returned to acesintown
acesintown collected $0.30 from pot
acesintown: doesn't show hand 
*** SUMMARY ***
Total pot $0.30 | Rake $0 
Seat 1: Manic Jay (button) folded before Flop (didn't bet)
Seat 2: nettasha (small blind) folded before Flop
Seat 3: h00dyboy (big blind) folded before Flop
Seat 4: acesintown collected ($0.30)
Seat 6: Nodrik folded before Flop (didn't bet)



PokerStars Hand #222972546898:  Hold'em No Limit ($0.05/$0.10 USD) - 2021/01/23 16:34:12 ET
Table 'Dike III' 6-max Seat #2 is the button
Seat 1: Manic Jay ($14.50 in chips) 
Seat 2: nettasha ($10.69 in chips) 
Seat 3: h00dyboy ($8.87 in chips) 
Seat 4: acesintown ($6.38 in chips) 
Seat 6: Nodrik ($12.70 in chips) 
h00dyboy: posts small blind $0.05
acesintown: posts big blind $0.10
pensioner_x: sits out 
*** HOLE CARDS ***
Nodrik: folds 
Manic Jay: calls $0.10
nettasha: folds 
h00dyboy: calls $0.05
acesintown: checks 
*** FLOP *** [4c 5c 3d]
h00dyboy: bets $0.10
acesintown: calls $0.10
Manic Jay: folds 
*** TURN *** [4c 5c 3d] [Kd]
h00dyboy: checks 
acesintown: checks 
*** RIVER *** [4c 5c 3d Kd] [8s]
h00dyboy: checks 
acesintown: bets $0.40
h00dyboy: calls $0.40
*** SHOW DOWN ***
acesintown: shows [7s 8h] (a pair of Eights)
h00dyboy: mucks hand 
acesintown collected $1.24 from pot
*** SUMMARY ***
Total pot $1.30 | Rake $0.06 
Board [4c 5c 3d Kd 8s]
Seat 1: Manic Jay folded on the Flop
Seat 2: nettasha (button) folded before Flop (didn't bet)
Seat 3: h00dyboy (small blind) mucked
Seat 4: acesintown (big blind) showed [7s 8h] and won ($1.24) with a pair of Eights
Seat 6: Nodrik folded before Flop (didn't bet)



PokerStars Hand #222972587873:  Hold'em No Limit ($0.05/$0.10 USD) - 2021/01/23 16:35:01 ET
Table 'Dike III' 6-max Seat #3 is the button
Seat 1: Manic Jay ($14.40 in chips) 
Seat 2: nettasha ($10.69 in chips) 
Seat 3: h00dyboy ($8.27 in chips) 
Seat 4: acesintown ($7.02 in chips) 
Seat 5: pensioner_x ($10.81 in chips) 
Seat 6: Nodrik ($12.70 in chips) 
acesintown: posts small blind $0.05
pensioner_x: posts big blind $0.10
*** HOLE CARDS ***
Nodrik: raises $0.10 to $0.20
Manic Jay: folds 
nettasha: folds 
h00dyboy: folds 
acesintown: calls $0.15
pensioner_x: calls $0.10
*** FLOP *** [8s Js 4c]
acesintown: bets $0.20
pensioner_x: calls $0.20
Nodrik: folds 
*** TURN *** [8s Js 4c] [5d]
acesintown: bets $0.30
pensioner_x: calls $0.30
*** RIVER *** [8s Js 4c 5d] [6d]
acesintown: bets $0.50
pensioner_x: calls $0.50
*** SHOW DOWN ***
acesintown: shows [7h 8d] (a straight, Four to Eight)
pensioner_x: mucks hand 
acesintown collected $2.48 from pot
*** SUMMARY ***
Total pot $2.60 | Rake $0.12 
Board [8s Js 4c 5d 6d]
Seat 1: Manic Jay folded before Flop (didn't bet)
Seat 2: nettasha folded before Flop (didn't bet)
Seat 3: h00dyboy (button) folded before Flop (didn't bet)
Seat 4: acesintown (small blind) showed [7h 8d] and won ($2.48) with a straight, Four to Eight
Seat 5: pensioner_x (big blind) mucked
Seat 6: Nodrik folded on the Flop



PokerStars Hand #222972651080:  Hold'em No Limit ($0.05/$0.10 USD) - 2021/01/23 16:36:17 ET
Table 'Dike III' 6-max Seat #4 is the button
Seat 1: Manic Jay ($14.40 in chips) 
Seat 2: nettasha ($10.69 in chips) 
Seat 3: h00dyboy ($8.27 in chips) 
Seat 4: acesintown ($8.30 in chips) 
Seat 5: pensioner_x ($10 in chips) 
Seat 6: Nodrik ($12.50 in chips) 
pensioner_x: posts small blind $0.05
Nodrik: posts big blind $0.10
*** HOLE CARDS ***
Manic Jay: raises $0.20 to $0.30
nettasha: calls $0.30
h00dyboy: folds 
acesintown: folds 
pensioner_x: folds 
Nodrik: folds 
*** FLOP *** [Ad 3d 7h]
Manic Jay: checks 
nettasha: bets $0.48
Manic Jay: folds 
Uncalled bet ($0.48) returned to nettasha
nettasha collected $0.72 from pot
nettasha: doesn't show hand 
*** SUMMARY ***
Total pot $0.75 | Rake $0.03 
Board [Ad 3d 7h]
Seat 1: Manic Jay folded on the Flop
Seat 2: nettasha collected ($0.72)
Seat 3: h00dyboy folded before Flop (didn't bet)
Seat 4: acesintown (button) folded before Flop (didn't bet)
Seat 5: pensioner_x (small blind) folded before Flop
Seat 6: Nodrik (big blind) folded before Flop



PokerStars Hand #222972685179:  Hold'em No Limit ($0.05/$0.10 USD) - 2021/01/23 16:36:57 ET
Table 'Dike III' 6-max Seat #5 is the button
Seat 1: Manic Jay ($14.10 in chips) 
Seat 2: nettasha ($11.11 in chips) 
Seat 3: h00dyboy ($8.27 in chips) 
Seat 4: acesintown ($8.30 in chips) 
Seat 5: pensioner_x ($10 in chips) 
Seat 6: Nodrik ($12.40 in chips) 
Nodrik: posts small blind $0.05
Manic Jay: posts big blind $0.10
*** HOLE CARDS ***
nettasha: folds 
h00dyboy: raises $0.20 to $0.30
acesintown has timed out
acesintown: folds 
pensioner_x: folds 
Nodrik: folds 
Manic Jay: calls $0.20
*** FLOP *** [Qh Jh 5h]
Manic Jay: checks 
h00dyboy: bets $0.38
Manic Jay: calls $0.38
*** TURN *** [Qh Jh 5h] [3d]
Manic Jay: checks 
h00dyboy: bets $0.85
Manic Jay: calls $0.85
*** RIVER *** [Qh Jh 5h 3d] [Kh]
Manic Jay: checks 
h00dyboy: checks 
*** SHOW DOWN ***
Manic Jay: shows [6h Ah] (a flush, Ace high)
h00dyboy: mucks hand 
Manic Jay collected $2.97 from pot
*** SUMMARY ***
Total pot $3.11 | Rake $0.14 
Board [Qh Jh 5h 3d Kh]
Seat 1: Manic Jay (big blind) showed [6h Ah] and won ($2.97) with a flush, Ace high
Seat 2: nettasha folded before Flop (didn't bet)
Seat 3: h00dyboy mucked
Seat 4: acesintown folded before Flop (didn't bet)
Seat 5: pensioner_x (button) folded before Flop (didn't bet)
Seat 6: Nodrik (small blind) folded before Flop



PokerStars Hand #222972752285:  Hold'em No Limit ($0.05/$0.10 USD) - 2021/01/23 16:38:18 ET
Table 'Dike III' 6-max Seat #6 is the button
Seat 1: Manic Jay ($15.54 in chips) 
Seat 3: h00dyboy ($6.74 in chips) 
Seat 4: acesintown ($8.30 in chips) 
Seat 5: pensioner_x ($10 in chips) 
Seat 6: Nodrik ($12.35 in chips) 
Manic Jay: posts small blind $0.05
nettasha: is sitting out 
h00dyboy: posts big blind $0.10
*** HOLE CARDS ***
acesintown: folds 
pensioner_x: raises $0.20 to $0.30
Nodrik: folds 
Manic Jay: folds 
h00dyboy: folds 
Uncalled bet ($0.20) returned to pensioner_x
pensioner_x collected $0.25 from pot
pensioner_x: doesn't show hand 
*** SUMMARY ***
Total pot $0.25 | Rake $0 
Seat 1: Manic Jay (small blind) folded before Flop
Seat 3: h00dyboy (big blind) folded before Flop
Seat 4: acesintown folded before Flop (didn't bet)
Seat 5: pensioner_x collected ($0.25)
Seat 6: Nodrik (button) folded before Flop (didn't bet)



PokerStars Hand #222972760732:  Hold'em No Limit ($0.05/$0.10 USD) - 2021/01/23 16:38:28 ET
Table 'Dike III' 6-max Seat #1 is the button
Seat 1: Manic Jay ($15.49 in chips) 
Seat 3: h00dyboy ($6.64 in chips) 
Seat 4: acesintown ($8.30 in chips) 
Seat 5: pensioner_x ($10.15 in chips) 
Seat 6: Nodrik ($12.35 in chips) 
h00dyboy: posts small blind $0.05
acesintown: posts big blind $0.10
*** HOLE CARDS ***
pensioner_x: folds 
Nodrik: raises $0.13 to $0.23
Manic Jay: folds 
h00dyboy: folds 
acesintown: folds 
Uncalled bet ($0.13) returned to Nodrik
Nodrik collected $0.25 from pot
*** SUMMARY ***
Total pot $0.25 | Rake $0 
Seat 1: Manic Jay (button) folded before Flop (didn't bet)
Seat 3: h00dyboy (small blind) folded before Flop
Seat 4: acesintown (big blind) folded before Flop
Seat 5: pensioner_x folded before Flop (didn't bet)
Seat 6: Nodrik collected ($0.25)



PokerStars Hand #222972770882:  Hold'em No Limit ($0.05/$0.10 USD) - 2021/01/23 16:38:40 ET
Table 'Dike III' 6-max Seat #3 is the button
Seat 1: Manic Jay ($15.49 in chips) 
Seat 3: h00dyboy ($6.59 in chips) 
Seat 4: acesintown ($8.20 in chips) 
Seat 5: pensioner_x ($10.15 in chips) 
Seat 6: Nodrik ($12.50 in chips) 
acesintown: posts small blind $0.05
pensioner_x: posts big blind $0.10
*** HOLE CARDS ***
Nodrik: folds 
Manic Jay: folds 
h00dyboy: raises $0.15 to $0.25
acesintown: folds 
pensioner_x: calls $0.15
*** FLOP *** [Js 3c 7c]
pensioner_x: checks 
h00dyboy: checks 
*** TURN *** [Js 3c 7c] [7s]
nettasha leaves the table
pensioner_x: bets $0.27
h00dyboy: folds 
Uncalled bet ($0.27) returned to pensioner_x
pensioner_x collected $0.53 from pot
pensioner_x: doesn't show hand 
*** SUMMARY ***
Total pot $0.55 | Rake $0.02 
Board [Js 3c 7c 7s]
Seat 1: Manic Jay folded before Flop (didn't bet)
Seat 3: h00dyboy (button) folded on the Turn
Seat 4: acesintown (small blind) folded before Flop
Seat 5: pensioner_x (big blind) collected ($0.53)
Seat 6: Nodrik folded before Flop (didn't bet)



PokerStars Hand #222972799702:  Hold'em No Limit ($0.05/$0.10 USD) - 2021/01/23 16:39:15 ET
Table 'Dike III' 6-max Seat #4 is the button
Seat 1: Manic Jay ($15.49 in chips) 
Seat 3: h00dyboy ($6.34 in chips) 
Seat 4: acesintown ($8.15 in chips) 
Seat 5: pensioner_x ($10.43 in chips) 
Seat 6: Nodrik ($12.50 in chips) 
pensioner_x: posts small blind $0.05
Nodrik: posts big blind $0.10
*** HOLE CARDS ***
Manic Jay: calls $0.10
h00dyboy: folds 
acesintown: raises $0.20 to $0.30
pensioner_x: calls $0.25
Nodrik: folds 
Manic Jay: calls $0.20
*** FLOP *** [6s 8h 5d]
pensioner_x: checks 
packachew191 joins the table at seat #2 
Manic Jay: bets $0.30
acesintown: folds 
pensioner_x: calls $0.30
*** TURN *** [6s 8h 5d] [Qc]
pensioner_x: checks 
Manic Jay: checks 
*** RIVER *** [6s 8h 5d Qc] [4d]
pensioner_x: checks 
Manic Jay: checks 
*** SHOW DOWN ***
pensioner_x: shows [3h 5h] (a pair of Fives)
Manic Jay: shows [8s 3s] (a pair of Eights)
Manic Jay collected $1.53 from pot
*** SUMMARY ***
Total pot $1.60 | Rake $0.07 
Board [6s 8h 5d Qc 4d]
Seat 1: Manic Jay showed [8s 3s] and won ($1.53) with a pair of Eights
Seat 3: h00dyboy folded before Flop (didn't bet)
Seat 4: acesintown (button) folded on the Flop
Seat 5: pensioner_x (small blind) showed [3h 5h] and lost with a pair of Fives
Seat 6: Nodrik (big blind) folded before Flop



PokerStars Hand #222972841832:  Hold'em No Limit ($0.05/$0.10 USD) - 2021/01/23 16:39:54 ET
Table 'Dike III' 6-max Seat #5 is the button
Seat 1: Manic Jay ($16.42 in chips) 
Seat 3: h00dyboy ($6.34 in chips) 
Seat 4: acesintown ($7.85 in chips) 
Seat 5: pensioner_x ($10 in chips) 
Seat 6: Nodrik ($12.40 in chips) 
Nodrik: posts small blind $0.05
Manic Jay: posts big blind $0.10
packachew191: sits out 
*** HOLE CARDS ***
h00dyboy: raises $0.20 to $0.30
acesintown: calls $0.30
pensioner_x: calls $0.30
Nodrik: folds 
Manic Jay: calls $0.20
*** FLOP *** [9d Jc 3c]
Manic Jay: bets $0.30
h00dyboy: calls $0.30
acesintown has timed out
acesintown: folds 
pensioner_x: raises $0.50 to $0.80
Manic Jay: calls $0.50
h00dyboy: calls $0.50
*** TURN *** [9d Jc 3c] [8c]
Manic Jay: checks 
h00dyboy: bets $1.08
pensioner_x: raises $1.52 to $2.60
Manic Jay: folds 
h00dyboy: calls $1.52
*** RIVER *** [9d Jc 3c 8c] [5h]
h00dyboy: checks 
pensioner_x: bets $4.23
h00dyboy: calls $2.64 and is all-in
Uncalled bet ($1.59) returned to pensioner_x
*** SHOW DOWN ***
pensioner_x: shows [2c Ac] (a flush, Ace high)
h00dyboy: shows [Qs Th] (a straight, Eight to Queen)
pensioner_x collected $13.49 from pot
*** SUMMARY ***
Total pot $14.13 | Rake $0.64 
Board [9d Jc 3c 8c 5h]
Seat 1: Manic Jay (big blind) folded on the Turn
Seat 3: h00dyboy showed [Qs Th] and lost with a straight, Eight to Queen
Seat 4: acesintown folded on the Flop
Seat 5: pensioner_x (button) showed [2c Ac] and won ($13.49) with a flush, Ace high
Seat 6: Nodrik (small blind) folded before Flop



PokerStars Hand #222972913516:  Hold'em No Limit ($0.05/$0.10 USD) - 2021/01/23 16:41:20 ET
Table 'Dike III' 6-max Seat #6 is the button
Seat 1: Manic Jay ($15.32 in chips) 
Seat 2: packachew191 ($7 in chips) 
Seat 4: acesintown ($7.55 in chips) 
Seat 5: pensioner_x ($17.15 in chips) 
Seat 6: Nodrik ($12.35 in chips) 
Manic Jay: posts small blind $0.05
packachew191: posts big blind $0.10
*** HOLE CARDS ***
h00dyboy leaves the table
acesintown has timed out
acesintown: folds 
pensioner_x: raises $0.20 to $0.30
Nodrik: folds 
Manic Jay: calls $0.25
packachew191: calls $0.20
*** FLOP *** [4h Ad As]
Manic Jay: checks 
packachew191: checks 
pensioner_x: bets $0.43
Manic Jay: calls $0.43
packachew191: folds 
*** TURN *** [4h Ad As] [6d]
Manic Jay: checks 
pensioner_x: checks 
*** RIVER *** [4h Ad As 6d] [4s]
Manic Jay: bets $2.10
pensioner_x: folds 
Uncalled bet ($2.10) returned to Manic Jay
Manic Jay collected $1.68 from pot
*** SUMMARY ***
Total pot $1.76 | Rake $0.08 
Board [4h Ad As 6d 4s]
Seat 1: Manic Jay (small blind) collected ($1.68)
Seat 2: packachew191 (big blind) folded on the Flop
Seat 4: acesintown folded before Flop (didn't bet)
Seat 5: pensioner_x folded on the River
Seat 6: Nodrik (button) folded before Flop (didn't bet)



PokerStars Hand #222972952607:  Hold'em No Limit ($0.05/$0.10 USD) - 2021/01/23 16:42:08 ET
Table 'Dike III' 6-max Seat #1 is the button
Seat 1: Manic Jay ($16.27 in chips) 
Seat 2: packachew191 ($7 in chips) 
Seat 4: acesintown ($7.55 in chips) 
Seat 5: pensioner_x ($16.42 in chips) 
Seat 6: Nodrik ($12.35 in chips) 
packachew191: posts small blind $0.05
acesintown: posts big blind $0.10
*** HOLE CARDS ***
pensioner_x: folds 
Nodrik: folds 
Manic Jay: raises $0.20 to $0.30
packachew191: folds 
acesintown: raises $0.60 to $0.90
Manic Jay: calls $0.60
*** FLOP *** [Td Jh 3s]
Bavigne joins the table at seat #3 
acesintown: bets $1
Manic Jay: calls $1
*** TURN *** [Td Jh 3s] [6s]
acesintown: checks 
Manic Jay: bets $1.84
acesintown: folds 
Uncalled bet ($1.84) returned to Manic Jay
Manic Jay collected $3.68 from pot
*** SUMMARY ***
Total pot $3.85 | Rake $0.17 
Board [Td Jh 3s 6s]
Seat 1: Manic Jay (button) collected ($3.68)
Seat 2: packachew191 (small blind) folded before Flop
Seat 4: acesintown (big blind) folded on the Turn
Seat 5: pensioner_x folded before Flop (didn't bet)
Seat 6: Nodrik folded before Flop (didn't bet)



PokerStars Hand #222972992426:  Hold'em No Limit ($0.05/$0.10 USD) - 2021/01/23 16:42:57 ET
Table 'Dike III' 6-max Seat #2 is the button
Seat 1: Manic Jay ($18.05 in chips) 
Seat 2: packachew191 ($7 in chips) 
Seat 4: acesintown ($5.65 in chips) 
Seat 5: pensioner_x ($16.42 in chips) 
Seat 6: Nodrik ($12.35 in chips) 
acesintown: posts small blind $0.05
pensioner_x: posts big blind $0.10
*** HOLE CARDS ***
Nodrik: folds 
Manic Jay: calls $0.10
packachew191: calls $0.10
acesintown: folds 
pensioner_x: checks 
*** FLOP *** [As 2s Js]
pensioner_x: bets $0.17
Manic Jay: folds 
packachew191: calls $0.17
*** TURN *** [As 2s Js] [Ah]
pensioner_x: bets $0.33
packachew191: raises $0.53 to $0.86
pensioner_x: folds 
Uncalled bet ($0.53) returned to packachew191
packachew191 collected $1.29 from pot
packachew191: doesn't show hand 
*** SUMMARY ***
Total pot $1.35 | Rake $0.06 
Board [As 2s Js Ah]
Seat 1: Manic Jay folded on the Flop
Seat 2: packachew191 (button) collected ($1.29)
Seat 4: acesintown (small blind) folded before Flop
Seat 5: pensioner_x (big blind) folded on the Turn
Seat 6: Nodrik folded before Flop (didn't bet)



PokerStars Hand #222973374860:  Hold'em No Limit ($0.05/$0.10 USD) - 2021/01/23 16:50:36 ET
Table 'Dike III' 6-max Seat #1 is the button
Seat 1: Manic Jay ($16.05 in chips) 
Seat 2: packachew191 ($9.65 in chips) 
Seat 3: Bavigne ($13.67 in chips) 
Seat 4: acesintown ($6.76 in chips) 
Seat 5: pensioner_x ($11.82 in chips) 
Seat 6: DrLevty ($10 in chips) 
packachew191: posts small blind $0.05
Bavigne: posts big blind $0.10
*** HOLE CARDS ***
acesintown: calls $0.10
pensioner_x: calls $0.10
DrLevty: folds 
Manic Jay: calls $0.10
packachew191: folds 
Bavigne: checks 
*** FLOP *** [8d 6s 2d]
Bavigne: checks 
acesintown has timed out
acesintown: checks 
pensioner_x: checks 
Manic Jay: checks 
*** TURN *** [8d 6s 2d] [5c]
Bavigne: checks 
acesintown has timed out
acesintown: checks 
pensioner_x: checks 
Manic Jay: checks 
*** RIVER *** [8d 6s 2d 5c] [2c]
Bavigne: checks 
acesintown: bets $0.20
pensioner_x: folds 
Manic Jay: folds 
Bavigne: folds 
Uncalled bet ($0.20) returned to acesintown
acesintown collected $0.43 from pot
acesintown: doesn't show hand 
*** SUMMARY ***
Total pot $0.45 | Rake $0.02 
Board [8d 6s 2d 5c 2c]
Seat 1: Manic Jay (button) folded on the River
Seat 2: packachew191 (small blind) folded before Flop
Seat 3: Bavigne (big blind) folded on the River
Seat 4: acesintown collected ($0.43)
Seat 5: pensioner_x folded on the River
Seat 6: DrLevty folded before Flop (didn't bet)



PokerStars Hand #222973472447:  Hold'em No Limit ($0.05/$0.10 USD) - 2021/01/23 16:52:32 ET
Table 'Dike III' 6-max Seat #2 is the button
Seat 1: Manic Jay ($15.95 in chips) 
Seat 2: packachew191 ($9.60 in chips) 
Seat 3: Bavigne ($13.57 in chips) 
Seat 4: acesintown ($7.09 in chips) 
Seat 5: pensioner_x ($11.72 in chips) 
Seat 6: DrLevty ($10 in chips) 
Bavigne: posts small blind $0.05
acesintown: posts big blind $0.10
*** HOLE CARDS ***
pensioner_x: folds 
DrLevty: raises $0.20 to $0.30
Manic Jay: calls $0.30
packachew191: folds 
Bavigne: calls $0.25
acesintown: raises $0.50 to $0.80
DrLevty: calls $0.50
Manic Jay: calls $0.50
Bavigne: calls $0.50
*** FLOP *** [5c Kc Td]
packachew191 leaves the table
Bavigne: checks 
acesintown: checks 
DrLevty: checks 
Manic Jay: checks 
*** TURN *** [5c Kc Td] [9c]
Bavigne: bets $2.10
acesintown: folds 
DrLevty: folds 
Manic Jay: folds 
Uncalled bet ($2.10) returned to Bavigne
Bavigne collected $3.06 from pot
*** SUMMARY ***
Total pot $3.20 | Rake $0.14 
Board [5c Kc Td 9c]
Seat 1: Manic Jay folded on the Turn
Seat 2: packachew191 (button) folded before Flop (didn't bet)
Seat 3: Bavigne (small blind) collected ($3.06)
Seat 4: acesintown (big blind) folded on the Turn
Seat 5: pensioner_x folded before Flop (didn't bet)
Seat 6: DrLevty folded on the Turn



PokerStars Hand #222973536460:  Hold'em No Limit ($0.05/$0.10 USD) - 2021/01/23 16:53:49 ET
Table 'Dike III' 6-max Seat #3 is the button
Seat 1: Manic Jay ($15.15 in chips) 
Seat 3: Bavigne ($15.83 in chips) 
Seat 4: acesintown ($6.29 in chips) 
Seat 5: pensioner_x ($11.72 in chips) 
Seat 6: DrLevty ($10 in chips) 
acesintown: posts small blind $0.05
pensioner_x: posts big blind $0.10
*** HOLE CARDS ***
DrLevty: folds 
Manic Jay: calls $0.10
Dokugan Ruy joins the table at seat #2 
Bavigne has timed out
Bavigne: folds 
Bavigne is disconnected 
acesintown: raises $0.10 to $0.20
pensioner_x: folds 
Manic Jay: calls $0.10
*** FLOP *** [Tc Ah 8s]
acesintown: bets $0.30
Manic Jay: calls $0.30
*** TURN *** [Tc Ah 8s] [2h]
acesintown: bets $0.50
Manic Jay: raises $1 to $1.50
acesintown: calls $1
*** RIVER *** [Tc Ah 8s 2h] [3h]
acesintown: bets $0.80
Manic Jay: raises $2.50 to $3.30
acesintown: calls $2.50
*** SHOW DOWN ***
Manic Jay: shows [9h 7h] (a flush, Ace high)
acesintown: mucks hand 
Manic Jay collected $10.22 from pot
*** SUMMARY ***
Total pot $10.70 | Rake $0.48 
Board [Tc Ah 8s 2h 3h]
Seat 1: Manic Jay showed [9h 7h] and won ($10.22) with a flush, Ace high
Seat 3: Bavigne (button) folded before Flop (didn't bet)
Seat 4: acesintown (small blind) mucked
Seat 5: pensioner_x (big blind) folded before Flop
Seat 6: DrLevty folded before Flop (didn't bet)



PokerStars Hand #222973607782:  Hold'em No Limit ($0.05/$0.10 USD) - 2021/01/23 16:55:18 ET
Table 'Dike III' 6-max Seat #4 is the button
Seat 1: Manic Jay ($20.07 in chips) 
Seat 3: Bavigne ($15.83 in chips) 
Seat 4: acesintown ($0.99 in chips) 
Seat 5: pensioner_x ($11.62 in chips) 
Seat 6: DrLevty ($10 in chips) 
pensioner_x: posts small blind $0.05
DrLevty: posts big blind $0.10
Dokugan Ruy: sits out 
*** HOLE CARDS ***
Manic Jay: folds 
Bavigne: raises $0.20 to $0.30
acesintown: folds 
pensioner_x: folds 
DrLevty: folds 
Uncalled bet ($0.20) returned to Bavigne
Bavigne collected $0.25 from pot
Bavigne: doesn't show hand 
*** SUMMARY ***
Total pot $0.25 | Rake $0 
Seat 1: Manic Jay folded before Flop (didn't bet)
Seat 3: Bavigne collected ($0.25)
Seat 4: acesintown (button) folded before Flop (didn't bet)
Seat 5: pensioner_x (small blind) folded before Flop
Seat 6: DrLevty (big blind) folded before Flop



PokerStars Hand #222973617661:  Hold'em No Limit ($0.05/$0.10 USD) - 2021/01/23 16:55:35 ET
Table 'Dike III' 6-max Seat #5 is the button
Seat 1: Manic Jay ($20.07 in chips) 
Seat 3: Bavigne ($15.98 in chips) 
Seat 4: acesintown ($0.99 in chips) 
Seat 5: pensioner_x ($11.57 in chips) 
Seat 6: DrLevty ($10 in chips) 
DrLevty: posts small blind $0.05
Manic Jay: posts big blind $0.10
Dokugan Ruy: sits out 
*** HOLE CARDS ***
Bavigne: folds 
acesintown: folds 
pensioner_x: folds 
DrLevty: raises $0.20 to $0.30
Manic Jay: calls $0.20
*** FLOP *** [4h Qs 2s]
DrLevty: bets $0.19
Manic Jay: calls $0.19
*** TURN *** [4h Qs 2s] [6s]
DrLevty: checks 
Manic Jay: checks 
*** RIVER *** [4h Qs 2s 6s] [Jc]
DrLevty: checks 
Manic Jay: checks 
*** SHOW DOWN ***
DrLevty: shows [Tc Ah] (high card Ace)
Manic Jay: shows [Jh Ks] (a pair of Jacks)
Manic Jay collected $0.94 from pot
*** SUMMARY ***
Total pot $0.98 | Rake $0.04 
Board [4h Qs 2s 6s Jc]
Seat 1: Manic Jay (big blind) showed [Jh Ks] and won ($0.94) with a pair of Jacks
Seat 3: Bavigne folded before Flop (didn't bet)
Seat 4: acesintown folded before Flop (didn't bet)
Seat 5: pensioner_x (button) folded before Flop (didn't bet)
Seat 6: DrLevty (small blind) showed [Tc Ah] and lost with high card Ace



PokerStars Hand #222973642213:  Hold'em No Limit ($0.05/$0.10 USD) - 2021/01/23 16:56:19 ET
Table 'Dike III' 6-max Seat #6 is the button
Seat 1: Manic Jay ($20.52 in chips) 
Seat 2: Dokugan Ruy ($10 in chips) 
Seat 3: Bavigne ($15.98 in chips) 
Seat 4: acesintown ($0.99 in chips) 
Seat 5: pensioner_x ($11.57 in chips) 
Seat 6: DrLevty ($10 in chips) 
Manic Jay: posts small blind $0.05
Dokugan Ruy: posts big blind $0.10
*** HOLE CARDS ***
Bavigne: raises $0.20 to $0.30
acesintown: folds 
pensioner_x: folds 
DrLevty: raises $0.60 to $0.90
Manic Jay: folds 
Dokugan Ruy: folds 
Bavigne: folds 
Uncalled bet ($0.60) returned to DrLevty
DrLevty collected $0.75 from pot
DrLevty: doesn't show hand 
*** SUMMARY ***
Total pot $0.75 | Rake $0 
Seat 1: Manic Jay (small blind) folded before Flop
Seat 2: Dokugan Ruy (big blind) folded before Flop
Seat 3: Bavigne folded before Flop
Seat 4: acesintown folded before Flop (didn't bet)
Seat 5: pensioner_x folded before Flop (didn't bet)
Seat 6: DrLevty (button) collected ($0.75)



PokerStars Hand #222973652636:  Hold'em No Limit ($0.05/$0.10 USD) - 2021/01/23 16:56:37 ET
Table 'Dike III' 6-max Seat #1 is the button
Seat 1: Manic Jay ($20.47 in chips) 
Seat 2: Dokugan Ruy ($9.90 in chips) 
Seat 3: Bavigne ($15.68 in chips) 
Seat 4: acesintown ($0.99 in chips) 
Seat 5: pensioner_x ($11.57 in chips) 
Seat 6: DrLevty ($10.45 in chips) 
Dokugan Ruy: posts small blind $0.05
Bavigne: posts big blind $0.10
*** HOLE CARDS ***
acesintown: raises $0.40 to $0.50
pensioner_x: folds 
DrLevty: folds 
Manic Jay: folds 
Dokugan Ruy: folds 
Bavigne: folds 
Uncalled bet ($0.40) returned to acesintown
acesintown collected $0.25 from pot
acesintown: doesn't show hand 
*** SUMMARY ***
Total pot $0.25 | Rake $0 
Seat 1: Manic Jay (button) folded before Flop (didn't bet)
Seat 2: Dokugan Ruy (small blind) folded before Flop
Seat 3: Bavigne (big blind) folded before Flop
Seat 4: acesintown collected ($0.25)
Seat 5: pensioner_x folded before Flop (didn't bet)
Seat 6: DrLevty folded before Flop (didn't bet)



PokerStars Hand #222973663695:  Hold'em No Limit ($0.05/$0.10 USD) - 2021/01/23 16:56:56 ET
Table 'Dike III' 6-max Seat #2 is the button
Seat 1: Manic Jay ($20.47 in chips) 
Seat 2: Dokugan Ruy ($9.85 in chips) 
Seat 3: Bavigne ($15.58 in chips) 
Seat 4: acesintown ($1.14 in chips) 
Seat 5: pensioner_x ($11.57 in chips) 
Seat 6: DrLevty ($10.45 in chips) 
Bavigne: posts small blind $0.05
acesintown: posts big blind $0.10
*** HOLE CARDS ***
pensioner_x: raises $0.20 to $0.30
DrLevty: folds 
Manic Jay: folds 
Dokugan Ruy: folds 
Bavigne: folds 
acesintown: calls $0.20
*** FLOP *** [3d 4h 6d]
acesintown: bets $0.84 and is all-in
pensioner_x: folds 
Uncalled bet ($0.84) returned to acesintown
acesintown collected $0.62 from pot
acesintown: doesn't show hand 
*** SUMMARY ***
Total pot $0.65 | Rake $0.03 
Board [3d 4h 6d]
Seat 1: Manic Jay folded before Flop (didn't bet)
Seat 2: Dokugan Ruy (button) folded before Flop (didn't bet)
Seat 3: Bavigne (small blind) folded before Flop
Seat 4: acesintown (big blind) collected ($0.62)
Seat 5: pensioner_x folded on the Flop
Seat 6: DrLevty folded before Flop (didn't bet)



PokerStars Hand #222973674544:  Hold'em No Limit ($0.05/$0.10 USD) - 2021/01/23 16:57:15 ET
Table 'Dike III' 6-max Seat #3 is the button
Seat 1: Manic Jay ($20.47 in chips) 
Seat 2: Dokugan Ruy ($9.85 in chips) 
Seat 3: Bavigne ($15.53 in chips) 
Seat 4: acesintown ($1.46 in chips) 
Seat 5: pensioner_x ($11.27 in chips) 
Seat 6: DrLevty ($10.45 in chips) 
acesintown: posts small blind $0.05
pensioner_x: posts big blind $0.10
*** HOLE CARDS ***
DrLevty: folds 
Manic Jay: calls $0.10
Dokugan Ruy: folds 
Bavigne: raises $0.20 to $0.30
acesintown: folds 
pensioner_x: folds 
Manic Jay: calls $0.20
*** FLOP *** [7h Kh Td]
Manic Jay: bets $0.30
Bavigne: calls $0.30
*** TURN *** [7h Kh Td] [3s]
Manic Jay: bets $0.30
Bavigne: calls $0.30
*** RIVER *** [7h Kh Td 3s] [8h]
Manic Jay: checks 
Bavigne: bets $0.60
Manic Jay: calls $0.60
*** SHOW DOWN ***
Bavigne: shows [6h 4h] (a flush, King high)
Manic Jay: mucks hand 
Bavigne collected $3.01 from pot
*** SUMMARY ***
Total pot $3.15 | Rake $0.14 
Board [7h Kh Td 3s 8h]
Seat 1: Manic Jay mucked
Seat 2: Dokugan Ruy folded before Flop (didn't bet)
Seat 3: Bavigne (button) showed [6h 4h] and won ($3.01) with a flush, King high
Seat 4: acesintown (small blind) folded before Flop
Seat 5: pensioner_x (big blind) folded before Flop
Seat 6: DrLevty folded before Flop (didn't bet)



PokerStars Hand #222973707692:  Hold'em No Limit ($0.05/$0.10 USD) - 2021/01/23 16:58:12 ET
Table 'Dike III' 6-max Seat #4 is the button
Seat 1: Manic Jay ($18.97 in chips) 
Seat 2: Dokugan Ruy ($9.85 in chips) 
Seat 3: Bavigne ($17.04 in chips) 
Seat 4: acesintown ($1.41 in chips) 
Seat 5: pensioner_x ($11.17 in chips) 
Seat 6: DrLevty ($10.45 in chips) 
pensioner_x: posts small blind $0.05
DrLevty: posts big blind $0.10
*** HOLE CARDS ***
Manic Jay: raises $0.20 to $0.30
Dokugan Ruy: calls $0.30
Bavigne: calls $0.30
acesintown has timed out
acesintown: folds 
pensioner_x: calls $0.25
DrLevty: folds 
*** FLOP *** [2c 9c 5h]
pensioner_x: checks 
Manic Jay: checks 
Dokugan Ruy: checks 
Bavigne: bets $0.50
pensioner_x: folds 
Manic Jay: calls $0.50
Dokugan Ruy: folds 
*** TURN *** [2c 9c 5h] [8s]
Manic Jay: checks 
Bavigne: checks 
*** RIVER *** [2c 9c 5h 8s] [Th]
Manic Jay: bets $2.20
Bavigne: folds 
Uncalled bet ($2.20) returned to Manic Jay
Manic Jay collected $2.20 from pot
*** SUMMARY ***
Total pot $2.30 | Rake $0.10 
Board [2c 9c 5h 8s Th]
Seat 1: Manic Jay collected ($2.20)
Seat 2: Dokugan Ruy folded on the Flop
Seat 3: Bavigne folded on the River
Seat 4: acesintown (button) folded before Flop (didn't bet)
Seat 5: pensioner_x (small blind) folded on the Flop
Seat 6: DrLevty (big blind) folded before Flop



PokerStars Hand #222973775525:  Hold'em No Limit ($0.05/$0.10 USD) - 2021/01/23 17:00:08 ET
Table 'Dike III' 6-max Seat #5 is the button
Seat 1: Manic Jay ($20.37 in chips) 
Seat 2: Dokugan Ruy ($9.55 in chips) 
Seat 3: Bavigne ($16.24 in chips) 
Seat 4: acesintown ($1.41 in chips) 
Seat 5: pensioner_x ($10.87 in chips) 
Seat 6: DrLevty ($10.35 in chips) 
DrLevty: posts small blind $0.05
Manic Jay: posts big blind $0.10
*** HOLE CARDS ***
Dokugan Ruy: folds 
Bavigne: raises $0.20 to $0.30
acesintown: folds 
pensioner_x: raises $0.60 to $0.90
DrLevty: folds 
Manic Jay: folds 
Bavigne: folds 
Uncalled bet ($0.60) returned to pensioner_x
pensioner_x collected $0.75 from pot
pensioner_x: doesn't show hand 
*** SUMMARY ***
Total pot $0.75 | Rake $0 
Seat 1: Manic Jay (big blind) folded before Flop
Seat 2: Dokugan Ruy folded before Flop (didn't bet)
Seat 3: Bavigne folded before Flop
Seat 4: acesintown folded before Flop (didn't bet)
Seat 5: pensioner_x (button) collected ($0.75)
Seat 6: DrLevty (small blind) folded before Flop



PokerStars Hand #222973795269:  Hold'em No Limit ($0.05/$0.10 USD) - 2021/01/23 17:00:39 ET
Table 'Dike III' 6-max Seat #6 is the button
Seat 1: Manic Jay ($20.27 in chips) 
Seat 2: Dokugan Ruy ($9.55 in chips) 
Seat 3: Bavigne ($15.94 in chips) 
Seat 4: acesintown ($1.41 in chips) 
Seat 5: pensioner_x ($11.32 in chips) 
Seat 6: DrLevty ($10.30 in chips) 
Manic Jay: posts small blind $0.05
Dokugan Ruy: posts big blind $0.10
*** HOLE CARDS ***
Bavigne: folds 
acesintown: folds 
pensioner_x: raises $0.20 to $0.30
DrLevty: folds 
Manic Jay: calls $0.25
Dokugan Ruy: calls $0.20
*** FLOP *** [Kc 2d Jc]
Manic Jay: bets $0.50
Dokugan Ruy: calls $0.50
pensioner_x: calls $0.50
*** TURN *** [Kc 2d Jc] [6h]
Manic Jay: bets $0.70
Dokugan Ruy: calls $0.70
pensioner_x: calls $0.70
*** RIVER *** [Kc 2d Jc 6h] [Ah]
Manic Jay: checks 
Dokugan Ruy: checks 
pensioner_x: checks 
*** SHOW DOWN ***
Manic Jay: shows [Qh Ks] (a pair of Kings)
Dokugan Ruy: shows [Qd Th] (a straight, Ten to Ace)
pensioner_x: mucks hand 
Dokugan Ruy collected $4.30 from pot
*** SUMMARY ***
Total pot $4.50 | Rake $0.20 
Board [Kc 2d Jc 6h Ah]
Seat 1: Manic Jay (small blind) showed [Qh Ks] and lost with a pair of Kings
Seat 2: Dokugan Ruy (big blind) showed [Qd Th] and won ($4.30) with a straight, Ten to Ace
Seat 3: Bavigne folded before Flop (didn't bet)
Seat 4: acesintown folded before Flop (didn't bet)
Seat 5: pensioner_x mucked
Seat 6: DrLevty (button) folded before Flop (didn't bet)



PokerStars Hand #222973827417:  Hold'em No Limit ($0.05/$0.10 USD) - 2021/01/23 17:01:23 ET
Table 'Dike III' 6-max Seat #1 is the button
Seat 1: Manic Jay ($18.77 in chips) 
Seat 2: Dokugan Ruy ($12.35 in chips) 
Seat 3: Bavigne ($15.94 in chips) 
Seat 4: acesintown ($1.41 in chips) 
Seat 5: pensioner_x ($10 in chips) 
Seat 6: DrLevty ($10.30 in chips) 
Dokugan Ruy: posts small blind $0.05
Bavigne: posts big blind $0.10
*** HOLE CARDS ***
acesintown: calls $0.10
pensioner_x: folds 
DrLevty: folds 
Manic Jay: folds 
Dokugan Ruy: calls $0.05
Bavigne: raises $0.20 to $0.30
acesintown: calls $0.20
Dokugan Ruy: calls $0.20
*** FLOP *** [Qd 5d 8s]
Dokugan Ruy: checks 
Bavigne: checks 
acesintown: bets $0.30
Dokugan Ruy: calls $0.30
Bavigne: folds 
*** TURN *** [Qd 5d 8s] [Qs]
Dokugan Ruy: checks 
acesintown: checks 
*** RIVER *** [Qd 5d 8s Qs] [As]
Dokugan Ruy: checks 
acesintown: bets $0.81 and is all-in
Dokugan Ruy: folds 
Uncalled bet ($0.81) returned to acesintown
acesintown collected $1.43 from pot
acesintown: doesn't show hand 
*** SUMMARY ***
Total pot $1.50 | Rake $0.07 
Board [Qd 5d 8s Qs As]
Seat 1: Manic Jay (button) folded before Flop (didn't bet)
Seat 2: Dokugan Ruy (small blind) folded on the River
Seat 3: Bavigne (big blind) folded on the Flop
Seat 4: acesintown collected ($1.43)
Seat 5: pensioner_x folded before Flop (didn't bet)
Seat 6: DrLevty folded before Flop (didn't bet)



PokerStars Hand #222973881247:  Hold'em No Limit ($0.05/$0.10 USD) - 2021/01/23 17:02:31 ET
Table 'Dike III' 6-max Seat #2 is the button
Seat 1: Manic Jay ($18.77 in chips) 
Seat 2: Dokugan Ruy ($11.75 in chips) 
Seat 3: Bavigne ($15.64 in chips) 
Seat 4: acesintown ($2.24 in chips) 
Seat 5: pensioner_x ($10 in chips) 
Seat 6: DrLevty ($10.30 in chips) 
Bavigne: posts small blind $0.05
acesintown: posts big blind $0.10
*** HOLE CARDS ***
pensioner_x: folds 
DrLevty: folds 
Manic Jay: folds 
Dokugan Ruy: folds 
Bavigne has timed out
Bavigne: folds 
Uncalled bet ($0.05) returned to acesintown
acesintown collected $0.10 from pot
acesintown: doesn't show hand 
*** SUMMARY ***
Total pot $0.10 | Rake $0 
Seat 1: Manic Jay folded before Flop (didn't bet)
Seat 2: Dokugan Ruy (button) folded before Flop (didn't bet)
Seat 3: Bavigne (small blind) folded before Flop
Seat 4: acesintown (big blind) collected ($0.10)
Seat 5: pensioner_x folded before Flop (didn't bet)
Seat 6: DrLevty folded before Flop (didn't bet)



PokerStars Hand #222973925982:  Hold'em No Limit ($0.05/$0.10 USD) - 2021/01/23 17:03:24 ET
Table 'Dike III' 6-max Seat #4 is the button
Seat 1: Manic Jay ($18.77 in chips) 
Seat 2: Dokugan Ruy ($11.75 in chips) 
Seat 4: acesintown ($2.29 in chips) 
Seat 5: pensioner_x ($10 in chips) 
Seat 6: DrLevty ($10.30 in chips) 
pensioner_x: posts small blind $0.05
DrLevty: posts big blind $0.10
*** HOLE CARDS ***
Manic Jay: raises $0.20 to $0.30
Dokugan Ruy: folds 
acesintown: folds 
pensioner_x: folds 
DrLevty: folds 
Uncalled bet ($0.20) returned to Manic Jay
Manic Jay collected $0.25 from pot
*** SUMMARY ***
Total pot $0.25 | Rake $0 
Seat 1: Manic Jay collected ($0.25)
Seat 2: Dokugan Ruy folded before Flop (didn't bet)
Seat 4: acesintown (button) folded before Flop (didn't bet)
Seat 5: pensioner_x (small blind) folded before Flop
Seat 6: DrLevty (big blind) folded before Flop



PokerStars Hand #222973945647:  Hold'em No Limit ($0.05/$0.10 USD) - 2021/01/23 17:03:47 ET
Table 'Dike III' 6-max Seat #5 is the button
Seat 1: Manic Jay ($18.92 in chips) 
Seat 2: Dokugan Ruy ($11.75 in chips) 
Seat 3: Bavigne ($15.59 in chips) 
Seat 4: acesintown ($2.29 in chips) 
Seat 5: pensioner_x ($10 in chips) 
Seat 6: DrLevty ($10.20 in chips) 
DrLevty: posts small blind $0.05
Manic Jay: posts big blind $0.10
*** HOLE CARDS ***
Dokugan Ruy: folds 
Bavigne: folds 
acesintown: folds 
pensioner_x: folds 
DrLevty: raises $0.20 to $0.30
Manic Jay: calls $0.20
*** FLOP *** [Ac 4d 3d]
DrLevty: checks 
Manic Jay: checks 
*** TURN *** [Ac 4d 3d] [9s]
DrLevty: bets $0.38
Manic Jay: folds 
Uncalled bet ($0.38) returned to DrLevty
DrLevty collected $0.57 from pot
DrLevty: doesn't show hand 
*** SUMMARY ***
Total pot $0.60 | Rake $0.03 
Board [Ac 4d 3d 9s]
Seat 1: Manic Jay (big blind) folded on the Turn
Seat 2: Dokugan Ruy folded before Flop (didn't bet)
Seat 3: Bavigne folded before Flop (didn't bet)
Seat 4: acesintown folded before Flop (didn't bet)
Seat 5: pensioner_x (button) folded before Flop (didn't bet)
Seat 6: DrLevty (small blind) collected ($0.57)



PokerStars Hand #222973993559:  Hold'em No Limit ($0.05/$0.10 USD) - 2021/01/23 17:04:21 ET
Table 'Dike III' 6-max Seat #6 is the button
Seat 1: Manic Jay ($18.62 in chips) 
Seat 2: Dokugan Ruy ($11.75 in chips) 
Seat 3: Bavigne ($15.59 in chips) 
Seat 4: acesintown ($2.29 in chips) 
Seat 5: pensioner_x ($10 in chips) 
Seat 6: DrLevty ($10.47 in chips) 
Manic Jay: posts small blind $0.05
Dokugan Ruy: posts big blind $0.10
*** HOLE CARDS ***
Bavigne: raises $0.20 to $0.30
acesintown: folds 
pensioner_x: calls $0.30
DrLevty: folds 
Manic Jay: calls $0.25
Dokugan Ruy: folds 
*** FLOP *** [7h 2c 5h]
Manic Jay: checks 
Bavigne: checks 
pensioner_x: checks 
*** TURN *** [7h 2c 5h] [Jd]
Manic Jay: checks 
Bavigne: checks 
pensioner_x: checks 
*** RIVER *** [7h 2c 5h Jd] [Jh]
Manic Jay: checks 
Bavigne: bets $0.40
pensioner_x: calls $0.40
Manic Jay: folds 
*** SHOW DOWN ***
Bavigne: shows [Td Qd] (a pair of Jacks)
pensioner_x: shows [Ad 3d] (a pair of Jacks - Ace kicker)
pensioner_x collected $1.72 from pot
*** SUMMARY ***
Total pot $1.80 | Rake $0.08 
Board [7h 2c 5h Jd Jh]
Seat 1: Manic Jay (small blind) folded on the River
Seat 2: Dokugan Ruy (big blind) folded before Flop
Seat 3: Bavigne showed [Td Qd] and lost with a pair of Jacks
Seat 4: acesintown folded before Flop (didn't bet)
Seat 5: pensioner_x showed [Ad 3d] and won ($1.72) with a pair of Jacks
Seat 6: DrLevty (button) folded before Flop (didn't bet)



PokerStars Hand #222974052488:  Hold'em No Limit ($0.05/$0.10 USD) - 2021/01/23 17:05:31 ET
Table 'Dike III' 6-max Seat #1 is the button
Seat 1: Manic Jay ($18.32 in chips) 
Seat 2: Dokugan Ruy ($11.65 in chips) 
Seat 3: Bavigne ($14.89 in chips) 
Seat 4: acesintown ($2.29 in chips) 
Seat 5: pensioner_x ($11.02 in chips) 
Seat 6: DrLevty ($10.47 in chips) 
Dokugan Ruy: posts small blind $0.05
Bavigne: posts big blind $0.10
*** HOLE CARDS ***
acesintown: calls $0.10
pensioner_x: folds 
DrLevty: folds 
Manic Jay: raises $0.20 to $0.30
Dokugan Ruy: folds 
Bavigne: folds 
acesintown: calls $0.20
*** FLOP *** [8h Kd 3d]
acesintown: checks 
Manic Jay: checks 
*** TURN *** [8h Kd 3d] [7s]
acesintown: bets $0.30
Manic Jay: calls $0.30
*** RIVER *** [8h Kd 3d 7s] [9d]
acesintown: bets $0.50
Manic Jay: folds 
Uncalled bet ($0.50) returned to acesintown
acesintown collected $1.29 from pot
acesintown: doesn't show hand 
*** SUMMARY ***
Total pot $1.35 | Rake $0.06 
Board [8h Kd 3d 7s 9d]
Seat 1: Manic Jay (button) folded on the River
Seat 2: Dokugan Ruy (small blind) folded before Flop
Seat 3: Bavigne (big blind) folded before Flop
Seat 4: acesintown collected ($1.29)
Seat 5: pensioner_x folded before Flop (didn't bet)
Seat 6: DrLevty folded before Flop (didn't bet)



PokerStars Hand #222974101198:  Hold'em No Limit ($0.05/$0.10 USD) - 2021/01/23 17:06:30 ET
Table 'Dike III' 6-max Seat #2 is the button
Seat 1: Manic Jay ($17.72 in chips) 
Seat 2: Dokugan Ruy ($11.60 in chips) 
Seat 3: Bavigne ($14.79 in chips) 
Seat 4: acesintown ($2.98 in chips) 
Seat 5: pensioner_x ($11.02 in chips) 
Seat 6: DrLevty ($10.47 in chips) 
Bavigne: posts small blind $0.05
acesintown: posts big blind $0.10
*** HOLE CARDS ***
pensioner_x: folds 
DrLevty: folds 
Manic Jay: folds 
Dokugan Ruy: folds 
Bavigne: raises $0.20 to $0.30
acesintown: folds 
Uncalled bet ($0.20) returned to Bavigne
Bavigne collected $0.20 from pot
Bavigne: doesn't show hand 
*** SUMMARY ***
Total pot $0.20 | Rake $0 
Seat 1: Manic Jay folded before Flop (didn't bet)
Seat 2: Dokugan Ruy (button) folded before Flop (didn't bet)
Seat 3: Bavigne (small blind) collected ($0.20)
Seat 4: acesintown (big blind) folded before Flop
Seat 5: pensioner_x folded before Flop (didn't bet)
Seat 6: DrLevty folded before Flop (didn't bet)



PokerStars Hand #222974117377:  Hold'em No Limit ($0.05/$0.10 USD) - 2021/01/23 17:06:49 ET
Table 'Dike III' 6-max Seat #3 is the button
Seat 1: Manic Jay ($17.72 in chips) 
Seat 2: Dokugan Ruy ($11.60 in chips) 
Seat 3: Bavigne ($14.89 in chips) 
Seat 4: acesintown ($2.88 in chips) 
Seat 5: pensioner_x ($11.02 in chips) 
Seat 6: DrLevty ($10.47 in chips) 
acesintown: posts small blind $0.05
pensioner_x: posts big blind $0.10
*** HOLE CARDS ***
DrLevty: raises $0.20 to $0.30
Manic Jay: folds 
Dokugan Ruy: folds 
Bavigne: calls $0.30
acesintown: calls $0.25
pensioner_x: calls $0.20
*** FLOP *** [8h Qc 2h]
acesintown: checks 
pensioner_x: checks 
DrLevty: checks 
Bavigne: bets $0.60
acesintown: folds 
pensioner_x: folds 
DrLevty: folds 
Uncalled bet ($0.60) returned to Bavigne
Bavigne collected $1.15 from pot
*** SUMMARY ***
Total pot $1.20 | Rake $0.05 
Board [8h Qc 2h]
Seat 1: Manic Jay folded before Flop (didn't bet)
Seat 2: Dokugan Ruy folded before Flop (didn't bet)
Seat 3: Bavigne (button) collected ($1.15)
Seat 4: acesintown (small blind) folded on the Flop
Seat 5: pensioner_x (big blind) folded on the Flop
Seat 6: DrLevty folded on the Flop



PokerStars Hand #222974169165:  Hold'em No Limit ($0.05/$0.10 USD) - 2021/01/23 17:07:51 ET
Table 'Dike III' 6-max Seat #4 is the button
Seat 1: Manic Jay ($17.72 in chips) 
Seat 2: Dokugan Ruy ($11.60 in chips) 
Seat 3: Bavigne ($15.74 in chips) 
Seat 4: acesintown ($2.58 in chips) 
Seat 5: pensioner_x ($10.72 in chips) 
Seat 6: DrLevty ($10.17 in chips) 
pensioner_x: posts small blind $0.05
DrLevty: posts big blind $0.10
*** HOLE CARDS ***
Manic Jay: folds 
Dokugan Ruy: folds 
Bavigne: folds 
acesintown: folds 
pensioner_x: folds 
Uncalled bet ($0.05) returned to DrLevty
DrLevty collected $0.10 from pot
DrLevty: doesn't show hand 
*** SUMMARY ***
Total pot $0.10 | Rake $0 
Seat 1: Manic Jay folded before Flop (didn't bet)
Seat 2: Dokugan Ruy folded before Flop (didn't bet)
Seat 3: Bavigne folded before Flop (didn't bet)
Seat 4: acesintown (button) folded before Flop (didn't bet)
Seat 5: pensioner_x (small blind) folded before Flop
Seat 6: DrLevty (big blind) collected ($0.10)



PokerStars Hand #222974189869:  Hold'em No Limit ($0.05/$0.10 USD) - 2021/01/23 17:08:16 ET
Table 'Dike III' 6-max Seat #5 is the button
Seat 1: Manic Jay ($17.72 in chips) 
Seat 2: Dokugan Ruy ($11.60 in chips) 
Seat 3: Bavigne ($15.74 in chips) 
Seat 4: acesintown ($2.58 in chips) 
Seat 5: pensioner_x ($10.67 in chips) 
Seat 6: DrLevty ($10.22 in chips) 
DrLevty: posts small blind $0.05
Manic Jay: posts big blind $0.10
*** HOLE CARDS ***
Dokugan Ruy: folds 
Bavigne: folds 
acesintown has timed out
acesintown: folds 
pensioner_x: folds 
DrLevty: folds 
Uncalled bet ($0.05) returned to Manic Jay
Manic Jay collected $0.10 from pot
*** SUMMARY ***
Total pot $0.10 | Rake $0 
Seat 1: Manic Jay (big blind) collected ($0.10)
Seat 2: Dokugan Ruy folded before Flop (didn't bet)
Seat 3: Bavigne folded before Flop (didn't bet)
Seat 4: acesintown folded before Flop (didn't bet)
Seat 5: pensioner_x (button) folded before Flop (didn't bet)
Seat 6: DrLevty (small blind) folded before Flop



PokerStars Hand #222974211473:  Hold'em No Limit ($0.05/$0.10 USD) - 2021/01/23 17:08:42 ET
Table 'Dike III' 6-max Seat #6 is the button
Seat 1: Manic Jay ($17.77 in chips) 
Seat 2: Dokugan Ruy ($11.60 in chips) 
Seat 3: Bavigne ($15.74 in chips) 
Seat 4: acesintown ($2.58 in chips) 
Seat 5: pensioner_x ($10.67 in chips) 
Seat 6: DrLevty ($10.17 in chips) 
Manic Jay: posts small blind $0.05
Dokugan Ruy: posts big blind $0.10
*** HOLE CARDS ***
Bavigne: folds 
acesintown: folds 
pensioner_x: folds 
DrLevty: raises $0.20 to $0.30
Manic Jay: folds 
Dokugan Ruy: calls $0.20
*** FLOP *** [6h Qs 9c]
Dokugan Ruy: checks 
DrLevty: bets $0.20
Dokugan Ruy: calls $0.20
*** TURN *** [6h Qs 9c] [Jc]
Dokugan Ruy: checks 
DrLevty: checks 
*** RIVER *** [6h Qs 9c Jc] [7h]
Dokugan Ruy: bets $0.30
DrLevty: calls $0.30
*** SHOW DOWN ***
Dokugan Ruy: shows [6s 9s] (two pair, Nines and Sixes)
DrLevty: shows [Qd 9h] (two pair, Queens and Nines)
DrLevty collected $1.58 from pot
*** SUMMARY ***
Total pot $1.65 | Rake $0.07 
Board [6h Qs 9c Jc 7h]
Seat 1: Manic Jay (small blind) folded before Flop
Seat 2: Dokugan Ruy (big blind) showed [6s 9s] and lost with two pair, Nines and Sixes
Seat 3: Bavigne folded before Flop (didn't bet)
Seat 4: acesintown folded before Flop (didn't bet)
Seat 5: pensioner_x folded before Flop (didn't bet)
Seat 6: DrLevty (button) showed [Qd 9h] and won ($1.58) with two pair, Queens and Nines



PokerStars Hand #222974254842:  Hold'em No Limit ($0.05/$0.10 USD) - 2021/01/23 17:09:34 ET
Table 'Dike III' 6-max Seat #1 is the button
Seat 1: Manic Jay ($17.72 in chips) 
Seat 2: Dokugan Ruy ($10.80 in chips) 
Seat 3: Bavigne ($15.74 in chips) 
Seat 4: acesintown ($2.58 in chips) 
Seat 5: pensioner_x ($10.67 in chips) 
Seat 6: DrLevty ($10.95 in chips) 
Dokugan Ruy: posts small blind $0.05
Bavigne: posts big blind $0.10
*** HOLE CARDS ***
acesintown: calls $0.10
pensioner_x: folds 
DrLevty: folds 
Manic Jay: calls $0.10
Dokugan Ruy: calls $0.05
Bavigne: checks 
*** FLOP *** [7d 8d Ac]
Dokugan Ruy: checks 
Bavigne: checks 
acesintown: checks 
Manic Jay: bets $0.38
Dokugan Ruy: folds 
Bavigne: folds 
acesintown has timed out
acesintown: folds 
Uncalled bet ($0.38) returned to Manic Jay
Manic Jay collected $0.38 from pot
*** SUMMARY ***
Total pot $0.40 | Rake $0.02 
Board [7d 8d Ac]
Seat 1: Manic Jay (button) collected ($0.38)
Seat 2: Dokugan Ruy (small blind) folded on the Flop
Seat 3: Bavigne (big blind) folded on the Flop
Seat 4: acesintown folded on the Flop
Seat 5: pensioner_x folded before Flop (didn't bet)
Seat 6: DrLevty folded before Flop (didn't bet)



PokerStars Hand #222974303069:  Hold'em No Limit ($0.05/$0.10 USD) - 2021/01/23 17:10:32 ET
Table 'Dike III' 6-max Seat #2 is the button
Seat 1: Manic Jay ($18 in chips) 
Seat 2: Dokugan Ruy ($10.70 in chips) 
Seat 3: Bavigne ($15.64 in chips) 
Seat 5: pensioner_x ($10.67 in chips) 
Seat 6: DrLevty ($10.95 in chips) 
Bavigne: posts small blind $0.05
pensioner_x: posts big blind $0.10
*** HOLE CARDS ***
DrLevty: folds 
Manic Jay: raises $0.20 to $0.30
Dokugan Ruy: folds 
Bavigne: calls $0.25
pensioner_x: folds 
*** FLOP *** [2d Td Jc]
Bavigne: checks 
Manic Jay: bets $0.67
Bavigne: folds 
Uncalled bet ($0.67) returned to Manic Jay
Manic Jay collected $0.67 from pot
*** SUMMARY ***
Total pot $0.70 | Rake $0.03 
Board [2d Td Jc]
Seat 1: Manic Jay collected ($0.67)
Seat 2: Dokugan Ruy (button) folded before Flop (didn't bet)
Seat 3: Bavigne (small blind) folded on the Flop
Seat 5: pensioner_x (big blind) folded before Flop
Seat 6: DrLevty folded before Flop (didn't bet)



PokerStars Hand #222974344302:  Hold'em No Limit ($0.05/$0.10 USD) - 2021/01/23 17:11:22 ET
Table 'Dike III' 6-max Seat #3 is the button
Seat 1: Manic Jay ($18.37 in chips) 
Seat 2: Dokugan Ruy ($10.70 in chips) 
Seat 3: Bavigne ($15.34 in chips) 
Seat 5: pensioner_x ($10.57 in chips) 
Seat 6: DrLevty ($10.95 in chips) 
pensioner_x: posts small blind $0.05
DrLevty: posts big blind $0.10
*** HOLE CARDS ***
Manic Jay: calls $0.10
Dokugan Ruy: folds 
Bavigne: raises $0.30 to $0.40
pensioner_x: calls $0.35
DrLevty: folds 
Manic Jay: folds 
*** FLOP *** [4h 5c Jd]
pensioner_x: checks 
Bavigne: bets $0.60
pensioner_x: raises $1.10 to $1.70
Bavigne: calls $1.10
*** TURN *** [4h 5c Jd] [Ts]
pensioner_x: bets $2.10
Bavigne: folds 
Uncalled bet ($2.10) returned to pensioner_x
pensioner_x collected $4.20 from pot
pensioner_x: doesn't show hand 
*** SUMMARY ***
Total pot $4.40 | Rake $0.20 
Board [4h 5c Jd Ts]
Seat 1: Manic Jay folded before Flop
Seat 2: Dokugan Ruy folded before Flop (didn't bet)
Seat 3: Bavigne (button) folded on the Turn
Seat 5: pensioner_x (small blind) collected ($4.20)
Seat 6: DrLevty (big blind) folded before Flop



PokerStars Hand #222974401788:  Hold'em No Limit ($0.05/$0.10 USD) - 2021/01/23 17:12:31 ET
Table 'Dike III' 6-max Seat #5 is the button
Seat 1: Manic Jay ($18.27 in chips) 
Seat 2: Dokugan Ruy ($10.70 in chips) 
Seat 3: Bavigne ($13.24 in chips) 
Seat 5: pensioner_x ($12.67 in chips) 
Seat 6: DrLevty ($10.85 in chips) 
DrLevty: posts small blind $0.05
Manic Jay: posts big blind $0.10
acesintown: sits out 
*** HOLE CARDS ***
Dokugan Ruy: folds 
Bavigne: folds 
pensioner_x: folds 
DrLevty: folds 
Uncalled bet ($0.05) returned to Manic Jay
Manic Jay collected $0.10 from pot
*** SUMMARY ***
Total pot $0.10 | Rake $0 
Seat 1: Manic Jay (big blind) collected ($0.10)
Seat 2: Dokugan Ruy folded before Flop (didn't bet)
Seat 3: Bavigne folded before Flop (didn't bet)
Seat 5: pensioner_x (button) folded before Flop (didn't bet)
Seat 6: DrLevty (small blind) folded before Flop



PokerStars Hand #222974412251:  Hold'em No Limit ($0.05/$0.10 USD) - 2021/01/23 17:12:44 ET
Table 'Dike III' 6-max Seat #6 is the button
Seat 1: Manic Jay ($18.32 in chips) 
Seat 2: Dokugan Ruy ($10.70 in chips) 
Seat 3: Bavigne ($13.24 in chips) 
Seat 5: pensioner_x ($12.67 in chips) 
Seat 6: DrLevty ($10.80 in chips) 
Manic Jay: posts small blind $0.05
Dokugan Ruy: posts big blind $0.10
acesintown: sits out 
*** HOLE CARDS ***
Bavigne: raises $0.20 to $0.30
pensioner_x: folds 
DrLevty: folds 
Manic Jay: calls $0.25
Dokugan Ruy: folds 
*** FLOP *** [5c 6s 9d]
Manic Jay: bets $0.34
Bavigne: calls $0.34
*** TURN *** [5c 6s 9d] [Qh]
Manic Jay: bets $0.40
Bavigne: raises $0.90 to $1.30
Manic Jay: calls $0.90
*** RIVER *** [5c 6s 9d Qh] [2h]
Manic Jay: checks 
Bavigne: bets $2.20
Manic Jay: calls $2.20
*** SHOW DOWN ***
Bavigne: shows [3s 4s] (a straight, Deuce to Six)
Manic Jay: mucks hand 
Bavigne collected $8 from pot
*** SUMMARY ***
Total pot $8.38 | Rake $0.38 
Board [5c 6s 9d Qh 2h]
Seat 1: Manic Jay (small blind) mucked
Seat 2: Dokugan Ruy (big blind) folded before Flop
Seat 3: Bavigne showed [3s 4s] and won ($8) with a straight, Deuce to Six
Seat 5: pensioner_x folded before Flop (didn't bet)
Seat 6: DrLevty (button) folded before Flop (didn't bet)



PokerStars Hand #222974474467:  Hold'em No Limit ($0.05/$0.10 USD) - 2021/01/23 17:14:00 ET
Table 'Dike III' 6-max Seat #1 is the button
Seat 1: Manic Jay ($14.18 in chips) 
Seat 2: Dokugan Ruy ($10.60 in chips) 
Seat 3: Bavigne ($17.10 in chips) 
Seat 4: acesintown ($2.48 in chips) 
Seat 5: pensioner_x ($12.67 in chips) 
Seat 6: DrLevty ($10.80 in chips) 
Dokugan Ruy: posts small blind $0.05
Bavigne: posts big blind $0.10
acesintown: posts small & big blinds $0.15
*** HOLE CARDS ***
acesintown: checks 
pensioner_x: folds 
DrLevty: raises $0.50 to $0.60
Manic Jay: folds 
Dokugan Ruy: folds 
Bavigne: calls $0.50
acesintown: folds 
*** FLOP *** [6d 4c Ah]
Bavigne: checks 
DrLevty: bets $0.44
Bavigne: raises $0.44 to $0.88
DrLevty: calls $0.44
*** TURN *** [6d 4c Ah] [Ac]
Bavigne: bets $2.70
DrLevty: calls $2.70
*** RIVER *** [6d 4c Ah Ac] [Qs]
Bavigne: checks 
DrLevty: bets $2.70
Bavigne: folds 
Uncalled bet ($2.70) returned to DrLevty
DrLevty collected $8.17 from pot
DrLevty: doesn't show hand 
*** SUMMARY ***
Total pot $8.56 | Rake $0.39 
Board [6d 4c Ah Ac Qs]
Seat 1: Manic Jay (button) folded before Flop (didn't bet)
Seat 2: Dokugan Ruy (small blind) folded before Flop
Seat 3: Bavigne (big blind) folded on the River
Seat 4: acesintown folded before Flop (didn't bet)
Seat 5: pensioner_x folded before Flop (didn't bet)
Seat 6: DrLevty collected ($8.17)



PokerStars Hand #222974559672:  Hold'em No Limit ($0.05/$0.10 USD) - 2021/01/23 17:15:43 ET
Table 'Dike III' 6-max Seat #2 is the button
Seat 1: Manic Jay ($14.18 in chips) 
Seat 2: Dokugan Ruy ($10.55 in chips) 
Seat 3: Bavigne ($12.92 in chips) 
Seat 4: acesintown ($2.33 in chips) 
Seat 5: pensioner_x ($12.67 in chips) 
Seat 6: DrLevty ($14.79 in chips) 
Bavigne: posts small blind $0.05
acesintown: posts big blind $0.10
*** HOLE CARDS ***
pensioner_x has timed out
pensioner_x: folds 
DrLevty: folds 
Manic Jay: folds 
Dokugan Ruy: folds 
Bavigne: folds 
Uncalled bet ($0.05) returned to acesintown
acesintown collected $0.10 from pot
acesintown: doesn't show hand 
*** SUMMARY ***
Total pot $0.10 | Rake $0 
Seat 1: Manic Jay folded before Flop (didn't bet)
Seat 2: Dokugan Ruy (button) folded before Flop (didn't bet)
Seat 3: Bavigne (small blind) folded before Flop
Seat 4: acesintown (big blind) collected ($0.10)
Seat 5: pensioner_x folded before Flop (didn't bet)
Seat 6: DrLevty folded before Flop (didn't bet)



PokerStars Hand #222974583641:  Hold'em No Limit ($0.05/$0.10 USD) - 2021/01/23 17:16:12 ET
Table 'Dike III' 6-max Seat #3 is the button
Seat 1: Manic Jay ($14.18 in chips) 
Seat 2: Dokugan Ruy ($10.55 in chips) 
Seat 3: Bavigne ($12.87 in chips) 
Seat 4: acesintown ($2.38 in chips) 
Seat 6: DrLevty ($14.79 in chips) 
acesintown: posts small blind $0.05
DrLevty: posts big blind $0.10
*** HOLE CARDS ***
Manic Jay: raises $0.20 to $0.30
Dokugan Ruy: folds 
Bavigne: folds 
acesintown: folds 
DrLevty: folds 
Uncalled bet ($0.20) returned to Manic Jay
Manic Jay collected $0.25 from pot
*** SUMMARY ***
Total pot $0.25 | Rake $0 
Seat 1: Manic Jay collected ($0.25)
Seat 2: Dokugan Ruy folded before Flop (didn't bet)
Seat 3: Bavigne (button) folded before Flop (didn't bet)
Seat 4: acesintown (small blind) folded before Flop
Seat 6: DrLevty (big blind) folded before Flop



PokerStars Hand #222974599049:  Hold'em No Limit ($0.05/$0.10 USD) - 2021/01/23 17:16:31 ET
Table 'Dike III' 6-max Seat #4 is the button
Seat 1: Manic Jay ($14.33 in chips) 
Seat 2: Dokugan Ruy ($10.55 in chips) 
Seat 3: Bavigne ($12.87 in chips) 
Seat 4: acesintown ($2.33 in chips) 
Seat 6: DrLevty ($14.69 in chips) 
DrLevty: posts small blind $0.05
Manic Jay: posts big blind $0.10
*** HOLE CARDS ***
Dokugan Ruy: raises $0.15 to $0.25
Bavigne: folds 
acesintown: calls $0.25
DrLevty: folds 
Manic Jay: folds 
*** FLOP *** [4s Kc 9d]
Dokugan Ruy: bets $0.25
acesintown: raises $0.50 to $0.75
Dokugan Ruy: folds 
Uncalled bet ($0.50) returned to acesintown
acesintown collected $1.10 from pot
acesintown: doesn't show hand 
*** SUMMARY ***
Total pot $1.15 | Rake $0.05 
Board [4s Kc 9d]
Seat 1: Manic Jay (big blind) folded before Flop
Seat 2: Dokugan Ruy folded on the Flop
Seat 3: Bavigne folded before Flop (didn't bet)
Seat 4: acesintown (button) collected ($1.10)
Seat 6: DrLevty (small blind) folded before Flop



PokerStars Hand #222974628483:  Hold'em No Limit ($0.05/$0.10 USD) - 2021/01/23 17:17:07 ET
Table 'Dike III' 6-max Seat #6 is the button
Seat 1: Manic Jay ($14.23 in chips) 
Seat 2: Dokugan Ruy ($10.05 in chips) 
Seat 3: Bavigne ($12.87 in chips) 
Seat 4: acesintown ($2.93 in chips) 
Seat 6: DrLevty ($14.64 in chips) 
Manic Jay: posts small blind $0.05
Dokugan Ruy: posts big blind $0.10
*** HOLE CARDS ***
Bavigne: raises $0.20 to $0.30
acesintown: folds 
DrLevty: raises $0.60 to $0.90
Manic Jay: folds 
Dokugan Ruy: folds 
Bavigne: folds 
Uncalled bet ($0.60) returned to DrLevty
DrLevty collected $0.75 from pot
DrLevty: doesn't show hand 
*** SUMMARY ***
Total pot $0.75 | Rake $0 
Seat 1: Manic Jay (small blind) folded before Flop
Seat 2: Dokugan Ruy (big blind) folded before Flop
Seat 3: Bavigne folded before Flop
Seat 4: acesintown folded before Flop (didn't bet)
Seat 6: DrLevty (button) collected ($0.75)



PokerStars Hand #222974647898:  Hold'em No Limit ($0.05/$0.10 USD) - 2021/01/23 17:17:30 ET
Table 'Dike III' 6-max Seat #1 is the button
Seat 1: Manic Jay ($14.18 in chips) 
Seat 2: Dokugan Ruy ($9.95 in chips) 
Seat 3: Bavigne ($12.57 in chips) 
Seat 4: acesintown ($2.93 in chips) 
Seat 6: DrLevty ($15.09 in chips) 
Dokugan Ruy: posts small blind $0.05
Bavigne: posts big blind $0.10
*** HOLE CARDS ***
acesintown has timed out
acesintown: folds 
DrLevty: folds 
Manic Jay: folds 
Dokugan Ruy: raises $0.15 to $0.25
Bavigne: raises $0.55 to $0.80
Dokugan Ruy: folds 
Uncalled bet ($0.55) returned to Bavigne
Bavigne collected $0.50 from pot
*** SUMMARY ***
Total pot $0.50 | Rake $0 
Seat 1: Manic Jay (button) folded before Flop (didn't bet)
Seat 2: Dokugan Ruy (small blind) folded before Flop
Seat 3: Bavigne (big blind) collected ($0.50)
Seat 4: acesintown folded before Flop (didn't bet)
Seat 6: DrLevty folded before Flop (didn't bet)



PokerStars Hand #222974675211:  Hold'em No Limit ($0.05/$0.10 USD) - 2021/01/23 17:18:03 ET
Table 'Dike III' 6-max Seat #2 is the button
Seat 1: Manic Jay ($14.18 in chips) 
Seat 2: Dokugan Ruy ($9.70 in chips) 
Seat 3: Bavigne ($12.82 in chips) 
Seat 4: acesintown ($2.93 in chips) 
Seat 6: DrLevty ($15.09 in chips) 
Bavigne: posts small blind $0.05
acesintown: posts big blind $0.10
pensioner_x: sits out 
*** HOLE CARDS ***
DrLevty: folds 
Manic Jay: calls $0.10
Dokugan Ruy: raises $0.15 to $0.25
Bavigne: folds 
acesintown: calls $0.15
Manic Jay: calls $0.15
*** FLOP *** [7s Jh 5c]
acesintown: bets $0.30
Manic Jay: calls $0.30
Dokugan Ruy: calls $0.30
*** TURN *** [7s Jh 5c] [2s]
acesintown: checks 
Manic Jay: checks 
Dokugan Ruy: checks 
*** RIVER *** [7s Jh 5c 2s] [5s]
acesintown: checks 
Manic Jay: checks 
Dokugan Ruy: checks 
*** SHOW DOWN ***
acesintown: shows [Qd 9h] (a pair of Fives)
Manic Jay: shows [4h Kh] (a pair of Fives - King kicker)
Dokugan Ruy: shows [8h 8s] (two pair, Eights and Fives)
Dokugan Ruy collected $1.62 from pot
*** SUMMARY ***
Total pot $1.70 | Rake $0.08 
Board [7s Jh 5c 2s 5s]
Seat 1: Manic Jay showed [4h Kh] and lost with a pair of Fives
Seat 2: Dokugan Ruy (button) showed [8h 8s] and won ($1.62) with two pair, Eights and Fives
Seat 3: Bavigne (small blind) folded before Flop
Seat 4: acesintown (big blind) showed [Qd 9h] and lost with a pair of Fives
Seat 6: DrLevty folded before Flop (didn't bet)



PokerStars Hand #222974736585:  Hold'em No Limit ($0.05/$0.10 USD) - 2021/01/23 17:19:18 ET
Table 'Dike III' 6-max Seat #3 is the button
Seat 1: Manic Jay ($13.63 in chips) 
Seat 2: Dokugan Ruy ($10.77 in chips) 
Seat 3: Bavigne ($12.77 in chips) 
Seat 4: acesintown ($2.38 in chips) 
Seat 5: pensioner_x ($12.67 in chips) 
Seat 6: DrLevty ($15.09 in chips) 
acesintown: posts small blind $0.05
pensioner_x: posts big blind $0.10
*** HOLE CARDS ***
DrLevty: folds 
Manic Jay: folds 
Dokugan Ruy: raises $0.15 to $0.25
Bavigne: calls $0.25
acesintown: folds 
pensioner_x: folds 
*** FLOP *** [2c 7h Th]
Dokugan Ruy: bets $0.25
Bavigne: calls $0.25
*** TURN *** [2c 7h Th] [7c]
Dokugan Ruy: checks 
Bavigne: bets $0.60
Dokugan Ruy: folds 
Uncalled bet ($0.60) returned to Bavigne
Bavigne collected $1.10 from pot
Bavigne: doesn't show hand 
*** SUMMARY ***
Total pot $1.15 | Rake $0.05 
Board [2c 7h Th 7c]
Seat 1: Manic Jay folded before Flop (didn't bet)
Seat 2: Dokugan Ruy folded on the Turn
Seat 3: Bavigne (button) collected ($1.10)
Seat 4: acesintown (small blind) folded before Flop
Seat 5: pensioner_x (big blind) folded before Flop
Seat 6: DrLevty folded before Flop (didn't bet)



PokerStars Hand #222974775175:  Hold'em No Limit ($0.05/$0.10 USD) - 2021/01/23 17:20:06 ET
Table 'Dike III' 6-max Seat #4 is the button
Seat 1: Manic Jay ($13.63 in chips) 
Seat 2: Dokugan Ruy ($10.27 in chips) 
Seat 3: Bavigne ($13.37 in chips) 
Seat 4: acesintown ($2.33 in chips) 
Seat 5: pensioner_x ($12.57 in chips) 
Seat 6: DrLevty ($15.09 in chips) 
pensioner_x: posts small blind $0.05
DrLevty: posts big blind $0.10
*** HOLE CARDS ***
Manic Jay: folds 
Dokugan Ruy: folds 
Bavigne: folds 
acesintown has timed out
acesintown: folds 
pensioner_x: folds 
Uncalled bet ($0.05) returned to DrLevty
DrLevty collected $0.10 from pot
DrLevty: doesn't show hand 
*** SUMMARY ***
Total pot $0.10 | Rake $0 
Seat 1: Manic Jay folded before Flop (didn't bet)
Seat 2: Dokugan Ruy folded before Flop (didn't bet)
Seat 3: Bavigne folded before Flop (didn't bet)
Seat 4: acesintown (button) folded before Flop (didn't bet)
Seat 5: pensioner_x (small blind) folded before Flop
Seat 6: DrLevty (big blind) collected ($0.10)



PokerStars Hand #222974795844:  Hold'em No Limit ($0.05/$0.10 USD) - 2021/01/23 17:20:31 ET
Table 'Dike III' 6-max Seat #5 is the button
Seat 1: Manic Jay ($13.63 in chips) 
Seat 2: Dokugan Ruy ($10.27 in chips) 
Seat 3: Bavigne ($13.37 in chips) 
Seat 5: pensioner_x ($12.52 in chips) 
Seat 6: DrLevty ($15.14 in chips) 
DrLevty: posts small blind $0.05
Manic Jay: posts big blind $0.10
*** HOLE CARDS ***
Dokugan Ruy has timed out
Dokugan Ruy: folds 
Bavigne: folds 
pensioner_x: raises $0.20 to $0.30
DrLevty: raises $1.05 to $1.35
Manic Jay: folds 
pensioner_x: folds 
Uncalled bet ($1.05) returned to DrLevty
DrLevty collected $0.70 from pot
DrLevty: doesn't show hand 
*** SUMMARY ***
Total pot $0.70 | Rake $0 
Seat 1: Manic Jay (big blind) folded before Flop
Seat 2: Dokugan Ruy folded before Flop (didn't bet)
Seat 3: Bavigne folded before Flop (didn't bet)
Seat 5: pensioner_x (button) folded before Flop
Seat 6: DrLevty (small blind) collected ($0.70)



PokerStars Hand #222974816969:  Hold'em No Limit ($0.05/$0.10 USD) - 2021/01/23 17:20:57 ET
Table 'Dike III' 6-max Seat #6 is the button
Seat 1: Manic Jay ($13.53 in chips) 
Seat 2: Dokugan Ruy ($10.27 in chips) 
Seat 3: Bavigne ($13.37 in chips) 
Seat 4: acesintown ($2.33 in chips) 
Seat 5: pensioner_x ($12.22 in chips) 
Seat 6: DrLevty ($15.54 in chips) 
Manic Jay: posts small blind $0.05
Dokugan Ruy: posts big blind $0.10
*** HOLE CARDS ***
Bavigne has timed out
Bavigne: folds 
acesintown: folds 
pensioner_x: folds 
DrLevty: raises $0.20 to $0.30
Manic Jay: calls $0.25
Dokugan Ruy: folds 
*** FLOP *** [Jc 3c Jd]
Manic Jay: checks 
DrLevty: bets $0.22
Manic Jay: folds 
Uncalled bet ($0.22) returned to DrLevty
DrLevty collected $0.67 from pot
DrLevty: doesn't show hand 
*** SUMMARY ***
Total pot $0.70 | Rake $0.03 
Board [Jc 3c Jd]
Seat 1: Manic Jay (small blind) folded on the Flop
Seat 2: Dokugan Ruy (big blind) folded before Flop
Seat 3: Bavigne folded before Flop (didn't bet)
Seat 4: acesintown folded before Flop (didn't bet)
Seat 5: pensioner_x folded before Flop (didn't bet)
Seat 6: DrLevty (button) collected ($0.67)



PokerStars Hand #222974845762:  Hold'em No Limit ($0.05/$0.10 USD) - 2021/01/23 17:21:33 ET
Table 'Dike III' 6-max Seat #1 is the button
Seat 1: Manic Jay ($13.23 in chips) 
Seat 2: Dokugan Ruy ($10.17 in chips) 
Seat 3: Bavigne ($13.37 in chips) 
Seat 4: acesintown ($2.33 in chips) 
Seat 5: pensioner_x ($12.22 in chips) 
Seat 6: DrLevty ($15.91 in chips) 
Dokugan Ruy: posts small blind $0.05
Bavigne: posts big blind $0.10
*** HOLE CARDS ***
acesintown has timed out
acesintown: folds 
pensioner_x: folds 
DrLevty: folds 
Manic Jay: folds 
Dokugan Ruy: folds 
Uncalled bet ($0.05) returned to Bavigne
Bavigne collected $0.10 from pot
*** SUMMARY ***
Total pot $0.10 | Rake $0 
Seat 1: Manic Jay (button) folded before Flop (didn't bet)
Seat 2: Dokugan Ruy (small blind) folded before Flop
Seat 3: Bavigne (big blind) collected ($0.10)
Seat 4: acesintown folded before Flop (didn't bet)
Seat 5: pensioner_x folded before Flop (didn't bet)
Seat 6: DrLevty folded before Flop (didn't bet)



PokerStars Hand #222974862163:  Hold'em No Limit ($0.05/$0.10 USD) - 2021/01/23 17:21:53 ET
Table 'Dike III' 6-max Seat #2 is the button
Seat 1: Manic Jay ($13.23 in chips) 
Seat 2: Dokugan Ruy ($10.12 in chips) 
Seat 3: Bavigne ($13.42 in chips) 
Seat 4: acesintown ($2.33 in chips) 
Seat 5: pensioner_x ($12.22 in chips) 
Seat 6: DrLevty ($15.91 in chips) 
Bavigne: posts small blind $0.05
acesintown: posts big blind $0.10
*** HOLE CARDS ***
pensioner_x: folds 
DrLevty: folds 
Manic Jay: calls $0.10
Dokugan Ruy: folds 
Bavigne: folds 
acesintown: checks 
*** FLOP *** [Tc 3c 8h]
acesintown: checks 
Bavigne is disconnected 
Manic Jay: bets $0.24
acesintown: folds 
Uncalled bet ($0.24) returned to Manic Jay
Manic Jay collected $0.24 from pot
*** SUMMARY ***
Total pot $0.25 | Rake $0.01 
Board [Tc 3c 8h]
Seat 1: Manic Jay collected ($0.24)
Seat 2: Dokugan Ruy (button) folded before Flop (didn't bet)
Seat 3: Bavigne (small blind) folded before Flop
Seat 4: acesintown (big blind) folded on the Flop
Seat 5: pensioner_x folded before Flop (didn't bet)
Seat 6: DrLevty folded before Flop (didn't bet)



PokerStars Hand #222974908278:  Hold'em No Limit ($0.05/$0.10 USD) - 2021/01/23 17:22:49 ET
Table 'Dike III' 6-max Seat #3 is the button
Seat 1: Manic Jay ($13.37 in chips) 
Seat 2: Dokugan Ruy ($10.12 in chips) 
Seat 3: Bavigne ($13.37 in chips) 
Seat 4: acesintown ($2.23 in chips) 
Seat 5: pensioner_x ($12.22 in chips) 
Seat 6: DrLevty ($15.91 in chips) 
acesintown: posts small blind $0.05
pensioner_x: posts big blind $0.10
*** HOLE CARDS ***
DrLevty: folds 
Manic Jay: folds 
Dokugan Ruy: folds 
Bavigne: folds 
acesintown: folds 
Uncalled bet ($0.05) returned to pensioner_x
pensioner_x collected $0.10 from pot
pensioner_x: doesn't show hand 
*** SUMMARY ***
Total pot $0.10 | Rake $0 
Seat 1: Manic Jay folded before Flop (didn't bet)
Seat 2: Dokugan Ruy folded before Flop (didn't bet)
Seat 3: Bavigne (button) folded before Flop (didn't bet)
Seat 4: acesintown (small blind) folded before Flop
Seat 5: pensioner_x (big blind) collected ($0.10)
Seat 6: DrLevty folded before Flop (didn't bet)



PokerStars Hand #222974913210:  Hold'em No Limit ($0.05/$0.10 USD) - 2021/01/23 17:22:55 ET
Table 'Dike III' 6-max Seat #4 is the button
Seat 1: Manic Jay ($13.37 in chips) 
Seat 2: Dokugan Ruy ($10.12 in chips) 
Seat 3: Bavigne ($13.37 in chips) 
Seat 4: acesintown ($2.18 in chips) 
Seat 5: pensioner_x ($12.27 in chips) 
Seat 6: DrLevty ($15.91 in chips) 
pensioner_x: posts small blind $0.05
DrLevty: posts big blind $0.10
*** HOLE CARDS ***
Manic Jay: calls $0.10
Dokugan Ruy: folds 
Bavigne: folds 
acesintown: folds 
pensioner_x: raises $0.30 to $0.40
DrLevty: folds 
Manic Jay: calls $0.30
*** FLOP *** [2s Th 8s]
pensioner_x: checks 
Manic Jay: bets $0.43
pensioner_x: folds 
Uncalled bet ($0.43) returned to Manic Jay
Manic Jay collected $0.86 from pot
*** SUMMARY ***
Total pot $0.90 | Rake $0.04 
Board [2s Th 8s]
Seat 1: Manic Jay collected ($0.86)
Seat 2: Dokugan Ruy folded before Flop (didn't bet)
Seat 3: Bavigne folded before Flop (didn't bet)
Seat 4: acesintown (button) folded before Flop (didn't bet)
Seat 5: pensioner_x (small blind) folded on the Flop
Seat 6: DrLevty (big blind) folded before Flop



PokerStars Hand #222974934603:  Hold'em No Limit ($0.05/$0.10 USD) - 2021/01/23 17:23:22 ET
Table 'Dike III' 6-max Seat #5 is the button
Seat 1: Manic Jay ($13.83 in chips) 
Seat 2: Dokugan Ruy ($10.12 in chips) 
Seat 3: Bavigne ($13.37 in chips) 
Seat 4: acesintown ($2.18 in chips) 
Seat 5: pensioner_x ($11.87 in chips) 
Seat 6: DrLevty ($15.81 in chips) 
DrLevty: posts small blind $0.05
Manic Jay: posts big blind $0.10
*** HOLE CARDS ***
Dokugan Ruy: folds 
Bavigne: folds 
acesintown: folds 
pensioner_x: folds 
DrLevty: folds 
Uncalled bet ($0.05) returned to Manic Jay
Manic Jay collected $0.10 from pot
*** SUMMARY ***
Total pot $0.10 | Rake $0 
Seat 1: Manic Jay (big blind) collected ($0.10)
Seat 2: Dokugan Ruy folded before Flop (didn't bet)
Seat 3: Bavigne folded before Flop (didn't bet)
Seat 4: acesintown folded before Flop (didn't bet)
Seat 5: pensioner_x (button) folded before Flop (didn't bet)
Seat 6: DrLevty (small blind) folded before Flop



PokerStars Hand #222974952133:  Hold'em No Limit ($0.05/$0.10 USD) - 2021/01/23 17:23:43 ET
Table 'Dike III' 6-max Seat #6 is the button
Seat 1: Manic Jay ($13.88 in chips) 
Seat 2: Dokugan Ruy ($10.12 in chips) 
Seat 3: Bavigne ($13.37 in chips) 
Seat 4: acesintown ($2.18 in chips) 
Seat 5: pensioner_x ($11.87 in chips) 
Seat 6: DrLevty ($15.76 in chips) 
Manic Jay: posts small blind $0.05
Dokugan Ruy: posts big blind $0.10
*** HOLE CARDS ***
Bavigne: folds 
acesintown: folds 
pensioner_x: folds 
DrLevty: raises $0.20 to $0.30
Manic Jay: folds 
Dokugan Ruy: folds 
Uncalled bet ($0.20) returned to DrLevty
DrLevty collected $0.25 from pot
DrLevty: doesn't show hand 
*** SUMMARY ***
Total pot $0.25 | Rake $0 
Seat 1: Manic Jay (small blind) folded before Flop
Seat 2: Dokugan Ruy (big blind) folded before Flop
Seat 3: Bavigne folded before Flop (didn't bet)
Seat 4: acesintown folded before Flop (didn't bet)
Seat 5: pensioner_x folded before Flop (didn't bet)
Seat 6: DrLevty (button) collected ($0.25)



PokerStars Hand #222974964064:  Hold'em No Limit ($0.05/$0.10 USD) - 2021/01/23 17:23:58 ET
Table 'Dike III' 6-max Seat #1 is the button
Seat 1: Manic Jay ($13.83 in chips) 
Seat 2: Dokugan Ruy ($10.02 in chips) 
Seat 3: Bavigne ($13.37 in chips) 
Seat 4: acesintown ($2.18 in chips) 
Seat 5: pensioner_x ($11.87 in chips) 
Seat 6: DrLevty ($15.91 in chips) 
Dokugan Ruy: posts small blind $0.05
Bavigne: posts big blind $0.10
*** HOLE CARDS ***
acesintown: folds 
pensioner_x: folds 
DrLevty: folds 
Manic Jay: raises $0.20 to $0.30
Dokugan Ruy: folds 
Bavigne is disconnected 
Bavigne is connected 
Bavigne: folds 
Uncalled bet ($0.20) returned to Manic Jay
Manic Jay collected $0.25 from pot
*** SUMMARY ***
Total pot $0.25 | Rake $0 
Seat 1: Manic Jay (button) collected ($0.25)
Seat 2: Dokugan Ruy (small blind) folded before Flop
Seat 3: Bavigne (big blind) folded before Flop
Seat 4: acesintown folded before Flop (didn't bet)
Seat 5: pensioner_x folded before Flop (didn't bet)
Seat 6: DrLevty folded before Flop (didn't bet)



PokerStars Hand #222974991435:  Hold'em No Limit ($0.05/$0.10 USD) - 2021/01/23 17:24:32 ET
Table 'Dike III' 6-max Seat #2 is the button
Seat 1: Manic Jay ($13.98 in chips) 
Seat 2: Dokugan Ruy ($9.97 in chips) 
Seat 3: Bavigne ($13.27 in chips) 
Seat 4: acesintown ($2.18 in chips) 
Seat 5: pensioner_x ($11.87 in chips) 
Seat 6: DrLevty ($15.91 in chips) 
Bavigne: posts small blind $0.05
acesintown: posts big blind $0.10
*** HOLE CARDS ***
pensioner_x: folds 
DrLevty: folds 
Manic Jay: folds 
Dokugan Ruy: raises $0.15 to $0.25
Bavigne: folds 
acesintown: calls $0.15
*** FLOP *** [Td Qd Ts]
acesintown: checks 
Dokugan Ruy: bets $1.93
acesintown: calls $1.93 and is all-in
*** TURN *** [Td Qd Ts] [7s]
*** RIVER *** [Td Qd Ts 7s] [7h]
*** SHOW DOWN ***
acesintown: shows [Ad Tc] (a full house, Tens full of Sevens)
Dokugan Ruy: shows [9d As] (two pair, Tens and Sevens)
acesintown collected $4.21 from pot
Dokugan Ruy cashed out the hand for $0.10
*** SUMMARY ***
Total pot $4.41 | Rake $0.20 
Board [Td Qd Ts 7s 7h]
Seat 1: Manic Jay folded before Flop (didn't bet)
Seat 2: Dokugan Ruy (button) showed [9d As] and lost with two pair, Tens and Sevens (cashed out).
Seat 3: Bavigne (small blind) folded before Flop
Seat 4: acesintown (big blind) showed [Ad Tc] and won ($4.21) with a full house, Tens full of Sevens
Seat 5: pensioner_x folded before Flop (didn't bet)
Seat 6: DrLevty folded before Flop (didn't bet)



PokerStars Hand #222975029016:  Hold'em No Limit ($0.05/$0.10 USD) - 2021/01/23 17:25:19 ET
Table 'Dike III' 6-max Seat #3 is the button
Seat 1: Manic Jay ($13.98 in chips) 
Seat 2: Dokugan Ruy ($7.89 in chips) 
Seat 3: Bavigne ($13.22 in chips) 
Seat 4: acesintown ($4.21 in chips) 
Seat 5: pensioner_x ($11.87 in chips) 
Seat 6: DrLevty ($15.91 in chips) 
acesintown: posts small blind $0.05
pensioner_x: posts big blind $0.10
*** HOLE CARDS ***
DrLevty: folds 
Manic Jay: calls $0.10
Dokugan Ruy: folds 
Bavigne: calls $0.10
acesintown: raises $0.20 to $0.30
pensioner_x: calls $0.20
Manic Jay: calls $0.20
Bavigne: calls $0.20
*** FLOP *** [9h 7s 5h]
acesintown: bets $0.30
pensioner_x: raises $0.88 to $1.18
Manic Jay: folds 
Bavigne: folds 
acesintown: folds 
Uncalled bet ($0.88) returned to pensioner_x
pensioner_x collected $1.72 from pot
pensioner_x: doesn't show hand 
*** SUMMARY ***
Total pot $1.80 | Rake $0.08 
Board [9h 7s 5h]
Seat 1: Manic Jay folded on the Flop
Seat 2: Dokugan Ruy folded before Flop (didn't bet)
Seat 3: Bavigne (button) folded on the Flop
Seat 4: acesintown (small blind) folded on the Flop
Seat 5: pensioner_x (big blind) collected ($1.72)
Seat 6: DrLevty folded before Flop (didn't bet)



PokerStars Hand #222975085168:  Hold'em No Limit ($0.05/$0.10 USD) - 2021/01/23 17:26:29 ET
Table 'Dike III' 6-max Seat #4 is the button
Seat 1: Manic Jay ($13.68 in chips) 
Seat 2: Dokugan Ruy ($10 in chips) 
Seat 3: Bavigne ($12.92 in chips) 
Seat 4: acesintown ($3.61 in chips) 
Seat 5: pensioner_x ($12.99 in chips) 
Seat 6: DrLevty ($15.91 in chips) 
pensioner_x: posts small blind $0.05
DrLevty: posts big blind $0.10
*** HOLE CARDS ***
Manic Jay: folds 
Dokugan Ruy: folds 
Bavigne: raises $0.20 to $0.30
acesintown: folds 
pensioner_x: folds 
DrLevty: folds 
Uncalled bet ($0.20) returned to Bavigne
Bavigne collected $0.25 from pot
Bavigne: doesn't show hand 
*** SUMMARY ***
Total pot $0.25 | Rake $0 
Seat 1: Manic Jay folded before Flop (didn't bet)
Seat 2: Dokugan Ruy folded before Flop (didn't bet)
Seat 3: Bavigne collected ($0.25)
Seat 4: acesintown (button) folded before Flop (didn't bet)
Seat 5: pensioner_x (small blind) folded before Flop
Seat 6: DrLevty (big blind) folded before Flop



PokerStars Hand #222975100223:  Hold'em No Limit ($0.05/$0.10 USD) - 2021/01/23 17:26:47 ET
Table 'Dike III' 6-max Seat #5 is the button
Seat 1: Manic Jay ($13.68 in chips) 
Seat 2: Dokugan Ruy ($10 in chips) 
Seat 3: Bavigne ($13.07 in chips) 
Seat 4: acesintown ($3.61 in chips) 
Seat 5: pensioner_x ($12.94 in chips) 
Seat 6: DrLevty ($15.81 in chips) 
DrLevty: posts small blind $0.05
Manic Jay: posts big blind $0.10
*** HOLE CARDS ***
Dokugan Ruy: folds 
Bavigne: folds 
acesintown: folds 
pensioner_x: raises $0.20 to $0.30
DrLevty: folds 
Manic Jay: calls $0.20
*** FLOP *** [2s Th 5c]
Manic Jay: checks 
pensioner_x: bets $0.31
Manic Jay: calls $0.31
*** TURN *** [2s Th 5c] [As]
Manic Jay: checks 
pensioner_x: checks 
*** RIVER *** [2s Th 5c As] [Kd]
Manic Jay: bets $1.21
pensioner_x: folds 
Uncalled bet ($1.21) returned to Manic Jay
Manic Jay collected $1.21 from pot
*** SUMMARY ***
Total pot $1.27 | Rake $0.06 
Board [2s Th 5c As Kd]
Seat 1: Manic Jay (big blind) collected ($1.21)
Seat 2: Dokugan Ruy folded before Flop (didn't bet)
Seat 3: Bavigne folded before Flop (didn't bet)
Seat 4: acesintown folded before Flop (didn't bet)
Seat 5: pensioner_x (button) folded on the River
Seat 6: DrLevty (small blind) folded before Flop



PokerStars Hand #222975135029:  Hold'em No Limit ($0.05/$0.10 USD) - 2021/01/23 17:27:31 ET
Table 'Dike III' 6-max Seat #6 is the button
Seat 1: Manic Jay ($14.28 in chips) 
Seat 2: Dokugan Ruy ($10 in chips) 
Seat 3: Bavigne ($13.07 in chips) 
Seat 4: acesintown ($3.61 in chips) 
Seat 5: pensioner_x ($12.33 in chips) 
Seat 6: DrLevty ($15.76 in chips) 
Manic Jay: posts small blind $0.05
Dokugan Ruy: posts big blind $0.10
*** HOLE CARDS ***
Bavigne: raises $0.20 to $0.30
acesintown has timed out
acesintown: folds 
pensioner_x: folds 
DrLevty: folds 
Manic Jay: calls $0.25
Dokugan Ruy: folds 
*** FLOP *** [Jh 2s Jd]
Manic Jay: checks 
Bavigne: bets $0.40
Manic Jay: folds 
Uncalled bet ($0.40) returned to Bavigne
Bavigne collected $0.67 from pot
Bavigne: doesn't show hand 
*** SUMMARY ***
Total pot $0.70 | Rake $0.03 
Board [Jh 2s Jd]
Seat 1: Manic Jay (small blind) folded on the Flop
Seat 2: Dokugan Ruy (big blind) folded before Flop
Seat 3: Bavigne collected ($0.67)
Seat 4: acesintown folded before Flop (didn't bet)
Seat 5: pensioner_x folded before Flop (didn't bet)
Seat 6: DrLevty (button) folded before Flop (didn't bet)



PokerStars Hand #222975175057:  Hold'em No Limit ($0.05/$0.10 USD) - 2021/01/23 17:28:17 ET
Table 'Dike III' 6-max Seat #1 is the button
Seat 1: Manic Jay ($13.98 in chips) 
Seat 2: Dokugan Ruy ($9.90 in chips) 
Seat 3: Bavigne ($13.44 in chips) 
Seat 4: acesintown ($3.61 in chips) 
Seat 5: pensioner_x ($12.33 in chips) 
Seat 6: DrLevty ($15.76 in chips) 
Dokugan Ruy: posts small blind $0.05
Bavigne: posts big blind $0.10
*** HOLE CARDS ***
acesintown has timed out
acesintown: folds 
pensioner_x: folds 
DrLevty: raises $0.20 to $0.30
Manic Jay: calls $0.30
Dokugan Ruy: folds 
Bavigne: folds 
*** FLOP *** [6s Th 8s]
Bavigne leaves the table
DrLevty: checks 
Manic Jay: bets $0.40
DrLevty: folds 
Uncalled bet ($0.40) returned to Manic Jay
Manic Jay collected $0.72 from pot
*** SUMMARY ***
Total pot $0.75 | Rake $0.03 
Board [6s Th 8s]
Seat 1: Manic Jay (button) collected ($0.72)
Seat 2: Dokugan Ruy (small blind) folded before Flop
Seat 3: Bavigne (big blind) folded before Flop
Seat 4: acesintown folded before Flop (didn't bet)
Seat 5: pensioner_x folded before Flop (didn't bet)
Seat 6: DrLevty folded on the Flop



PokerStars Hand #222975205513:  Hold'em No Limit ($0.05/$0.10 USD) - 2021/01/23 17:28:56 ET
Table 'Dike III' 6-max Seat #2 is the button
Seat 1: Manic Jay ($14.40 in chips) 
Seat 2: Dokugan Ruy ($9.85 in chips) 
Seat 4: acesintown ($3.61 in chips) 
Seat 5: pensioner_x ($12.33 in chips) 
Seat 6: DrLevty ($15.46 in chips) 
acesintown: posts small blind $0.05
pensioner_x: posts big blind $0.10
*** HOLE CARDS ***
DrLevty: folds 
Manic Jay: calls $0.10
Dokugan Ruy: folds 
acesintown: raises $0.20 to $0.30
pensioner_x: calls $0.20
Manic Jay: calls $0.20
*** FLOP *** [2h 3s Kh]
acesintown: bets $0.40
Marauder777 joins the table at seat #3 
pensioner_x: folds 
Manic Jay: calls $0.40
*** TURN *** [2h 3s Kh] [Kd]
acesintown: bets $0.50
Manic Jay: raises $0.50 to $1
acesintown: raises $1.91 to $2.91 and is all-in
Manic Jay: calls $1.91
*** RIVER *** [2h 3s Kh Kd] [5c]
*** SHOW DOWN ***
acesintown: shows [8c 8h] (two pair, Kings and Eights)
Manic Jay: shows [2s Kc] (a full house, Kings full of Deuces)
Manic Jay collected $7.18 from pot
*** SUMMARY ***
Total pot $7.52 | Rake $0.34 
Board [2h 3s Kh Kd 5c]
Seat 1: Manic Jay showed [2s Kc] and won ($7.18) with a full house, Kings full of Deuces
Seat 2: Dokugan Ruy (button) folded before Flop (didn't bet)
Seat 4: acesintown (small blind) showed [8c 8h] and lost with two pair, Kings and Eights
Seat 5: pensioner_x (big blind) folded on the Flop
Seat 6: DrLevty folded before Flop (didn't bet)



PokerStars Hand #222975238204:  Hold'em No Limit ($0.05/$0.10 USD) - 2021/01/23 17:29:37 ET
Table 'Dike III' 6-max Seat #5 is the button
Seat 1: Manic Jay ($17.97 in chips) 
Seat 2: Dokugan Ruy ($9.85 in chips) 
Seat 5: pensioner_x ($12.03 in chips) 
Seat 6: DrLevty ($15.46 in chips) 
DrLevty: posts small blind $0.05
Manic Jay: posts big blind $0.10
Marauder777: sits out 
*** HOLE CARDS ***
Dokugan Ruy: folds 
pensioner_x: raises $0.20 to $0.30
DrLevty: folds 
Manic Jay: calls $0.20
*** FLOP *** [8c 5h Ac]
Manic Jay: bets $0.62
pensioner_x: folds 
Uncalled bet ($0.62) returned to Manic Jay
Manic Jay collected $0.62 from pot
*** SUMMARY ***
Total pot $0.65 | Rake $0.03 
Board [8c 5h Ac]
Seat 1: Manic Jay (big blind) collected ($0.62)
Seat 2: Dokugan Ruy folded before Flop (didn't bet)
Seat 5: pensioner_x (button) folded on the Flop
Seat 6: DrLevty (small blind) folded before Flop



PokerStars Hand #222975255800:  Hold'em No Limit ($0.05/$0.10 USD) - 2021/01/23 17:29:59 ET
Table 'Dike III' 6-max Seat #6 is the button
Seat 1: Manic Jay ($18.29 in chips) 
Seat 2: Dokugan Ruy ($9.85 in chips) 
Seat 5: pensioner_x ($11.73 in chips) 
Seat 6: DrLevty ($15.41 in chips) 
Manic Jay: posts small blind $0.05
Dokugan Ruy: posts big blind $0.10
Marauder777: sits out 
*** HOLE CARDS ***
pensioner_x: folds 
DrLevty: folds 
Manic Jay: folds 
Uncalled bet ($0.05) returned to Dokugan Ruy
Dokugan Ruy collected $0.10 from pot
Dokugan Ruy: doesn't show hand 
*** SUMMARY ***
Total pot $0.10 | Rake $0 
Seat 1: Manic Jay (small blind) folded before Flop
Seat 2: Dokugan Ruy (big blind) collected ($0.10)
Seat 5: pensioner_x folded before Flop (didn't bet)
Seat 6: DrLevty (button) folded before Flop (didn't bet)



PokerStars Hand #222975263363:  Hold'em No Limit ($0.05/$0.10 USD) - 2021/01/23 17:30:08 ET
Table 'Dike III' 6-max Seat #1 is the button
Seat 1: Manic Jay ($18.24 in chips) 
Seat 2: Dokugan Ruy ($9.90 in chips) 
Seat 3: Marauder777 ($10 in chips) 
Seat 5: pensioner_x ($11.73 in chips) 
Seat 6: DrLevty ($15.41 in chips) 
Dokugan Ruy: posts small blind $0.05
Marauder777: posts big blind $0.10
*** HOLE CARDS ***
pensioner_x: folds 
acesintown leaves the table
DrLevty: folds 
Manic Jay: folds 
0TheMouse0 joins the table at seat #4 
Dokugan Ruy: raises $0.15 to $0.25
Marauder777: calls $0.15
*** FLOP *** [3d Kd 9h]
Dokugan Ruy: bets $0.19
Marauder777: calls $0.19
*** TURN *** [3d Kd 9h] [Kc]
Dokugan Ruy: checks 
Marauder777: bets $0.54
Dokugan Ruy: folds 
Uncalled bet ($0.54) returned to Marauder777
Marauder777 collected $0.84 from pot
Marauder777: doesn't show hand 
*** SUMMARY ***
Total pot $0.88 | Rake $0.04 
Board [3d Kd 9h Kc]
Seat 1: Manic Jay (button) folded before Flop (didn't bet)
Seat 2: Dokugan Ruy (small blind) folded on the Turn
Seat 3: Marauder777 (big blind) collected ($0.84)
Seat 5: pensioner_x folded before Flop (didn't bet)
Seat 6: DrLevty folded before Flop (didn't bet)



PokerStars Hand #222975309151:  Hold'em No Limit ($0.05/$0.10 USD) - 2021/01/23 17:31:06 ET
Table 'Dike III' 6-max Seat #2 is the button
Seat 1: Manic Jay ($18.24 in chips) 
Seat 2: Dokugan Ruy ($9.46 in chips) 
Seat 3: Marauder777 ($10.40 in chips) 
Seat 4: 0TheMouse0 ($10 in chips) 
Seat 5: pensioner_x ($11.73 in chips) 
Seat 6: DrLevty ($15.41 in chips) 
Marauder777: posts small blind $0.05
0TheMouse0: posts big blind $0.10
*** HOLE CARDS ***
pensioner_x: folds 
DrLevty: folds 
Manic Jay: folds 
Dokugan Ruy: folds 
Marauder777: folds 
Uncalled bet ($0.05) returned to 0TheMouse0
0TheMouse0 collected $0.10 from pot
0TheMouse0: doesn't show hand 
*** SUMMARY ***
Total pot $0.10 | Rake $0 
Seat 1: Manic Jay folded before Flop (didn't bet)
Seat 2: Dokugan Ruy (button) folded before Flop (didn't bet)
Seat 3: Marauder777 (small blind) folded before Flop
Seat 4: 0TheMouse0 (big blind) collected ($0.10)
Seat 5: pensioner_x folded before Flop (didn't bet)
Seat 6: DrLevty folded before Flop (didn't bet)



PokerStars Hand #222975317760:  Hold'em No Limit ($0.05/$0.10 USD) - 2021/01/23 17:31:17 ET
Table 'Dike III' 6-max Seat #3 is the button
Seat 1: Manic Jay ($18.24 in chips) 
Seat 2: Dokugan Ruy ($9.46 in chips) 
Seat 3: Marauder777 ($10.35 in chips) 
Seat 4: 0TheMouse0 ($10.05 in chips) 
Seat 5: pensioner_x ($11.73 in chips) 
Seat 6: DrLevty ($15.41 in chips) 
0TheMouse0: posts small blind $0.05
pensioner_x: posts big blind $0.10
*** HOLE CARDS ***
DrLevty: folds 
Manic Jay: calls $0.10
Dokugan Ruy: folds 
Marauder777: raises $0.25 to $0.35
0TheMouse0: folds 
pensioner_x: folds 
Manic Jay: calls $0.25
*** FLOP *** [3c 8c 9h]
Manic Jay: bets $0.41
Marauder777: calls $0.41
*** TURN *** [3c 8c 9h] [9c]
Manic Jay: bets $0.80
Marauder777: folds 
Uncalled bet ($0.80) returned to Manic Jay
Manic Jay collected $1.59 from pot
*** SUMMARY ***
Total pot $1.67 | Rake $0.08 
Board [3c 8c 9h 9c]
Seat 1: Manic Jay collected ($1.59)
Seat 2: Dokugan Ruy folded before Flop (didn't bet)
Seat 3: Marauder777 (button) folded on the Turn
Seat 4: 0TheMouse0 (small blind) folded before Flop
Seat 5: pensioner_x (big blind) folded before Flop
Seat 6: DrLevty folded before Flop (didn't bet)



PokerStars Hand #222975354396:  Hold'em No Limit ($0.05/$0.10 USD) - 2021/01/23 17:32:04 ET
Table 'Dike III' 6-max Seat #4 is the button
Seat 1: Manic Jay ($19.07 in chips) 
Seat 2: Dokugan Ruy ($9.46 in chips) 
Seat 3: Marauder777 ($10 in chips) 
Seat 4: 0TheMouse0 ($10 in chips) 
Seat 5: pensioner_x ($11.63 in chips) 
Seat 6: DrLevty ($15.41 in chips) 
pensioner_x: posts small blind $0.05
DrLevty: posts big blind $0.10
*** HOLE CARDS ***
Manic Jay: raises $0.20 to $0.30
Dokugan Ruy: folds 
Marauder777: folds 
0TheMouse0: folds 
pensioner_x: folds 
DrLevty: calls $0.20
*** FLOP *** [7c Kd 3c]
DrLevty: checks 
Manic Jay: checks 
*** TURN *** [7c Kd 3c] [Th]
DrLevty: bets $0.47
Manic Jay: folds 
Uncalled bet ($0.47) returned to DrLevty
DrLevty collected $0.62 from pot
DrLevty: doesn't show hand 
*** SUMMARY ***
Total pot $0.65 | Rake $0.03 
Board [7c Kd 3c Th]
Seat 1: Manic Jay folded on the Turn
Seat 2: Dokugan Ruy folded before Flop (didn't bet)
Seat 3: Marauder777 folded before Flop (didn't bet)
Seat 4: 0TheMouse0 (button) folded before Flop (didn't bet)
Seat 5: pensioner_x (small blind) folded before Flop
Seat 6: DrLevty (big blind) collected ($0.62)



PokerStars Hand #222975380556:  Hold'em No Limit ($0.05/$0.10 USD) - 2021/01/23 17:32:37 ET
Table 'Dike III' 6-max Seat #5 is the button
Seat 1: Manic Jay ($18.77 in chips) 
Seat 2: Dokugan Ruy ($9.46 in chips) 
Seat 3: Marauder777 ($10 in chips) 
Seat 4: 0TheMouse0 ($10 in chips) 
Seat 5: pensioner_x ($11.58 in chips) 
Seat 6: DrLevty ($15.73 in chips) 
DrLevty: posts small blind $0.05
Manic Jay: posts big blind $0.10
*** HOLE CARDS ***
Dokugan Ruy: folds 
Marauder777: folds 
0TheMouse0: folds 
pensioner_x: folds 
DrLevty: folds 
Uncalled bet ($0.05) returned to Manic Jay
Manic Jay collected $0.10 from pot
*** SUMMARY ***
Total pot $0.10 | Rake $0 
Seat 1: Manic Jay (big blind) collected ($0.10)
Seat 2: Dokugan Ruy folded before Flop (didn't bet)
Seat 3: Marauder777 folded before Flop (didn't bet)
Seat 4: 0TheMouse0 folded before Flop (didn't bet)
Seat 5: pensioner_x (button) folded before Flop (didn't bet)
Seat 6: DrLevty (small blind) folded before Flop



PokerStars Hand #222975391632:  Hold'em No Limit ($0.05/$0.10 USD) - 2021/01/23 17:32:51 ET
Table 'Dike III' 6-max Seat #6 is the button
Seat 1: Manic Jay ($18.82 in chips) 
Seat 3: Marauder777 ($10 in chips) 
Seat 4: 0TheMouse0 ($10 in chips) 
Seat 5: pensioner_x ($11.58 in chips) 
Seat 6: DrLevty ($15.68 in chips) 
Manic Jay: posts small blind $0.05
Dokugan Ruy: is sitting out 
Marauder777: posts big blind $0.10
*** HOLE CARDS ***
0TheMouse0: folds 
Dokugan Ruy leaves the table
pensioner_x: raises $0.20 to $0.30
DrLevty: folds 
Manic Jay: calls $0.25
Marauder777: calls $0.20
*** FLOP *** [Ks Qd 8s]
Manic Jay: checks 
B E M 4 W 6 330 joins the table at seat #2 
Marauder777: checks 
pensioner_x: checks 
*** TURN *** [Ks Qd 8s] [Th]
Manic Jay: checks 
Marauder777: bets $0.30
pensioner_x: folds 
Manic Jay: folds 
Uncalled bet ($0.30) returned to Marauder777
Marauder777 collected $0.86 from pot
Marauder777: doesn't show hand 
*** SUMMARY ***
Total pot $0.90 | Rake $0.04 
Board [Ks Qd 8s Th]
Seat 1: Manic Jay (small blind) folded on the Turn
Seat 3: Marauder777 (big blind) collected ($0.86)
Seat 4: 0TheMouse0 folded before Flop (didn't bet)
Seat 5: pensioner_x folded on the Turn
Seat 6: DrLevty (button) folded before Flop (didn't bet)



PokerStars Hand #222975418418:  Hold'em No Limit ($0.05/$0.10 USD) - 2021/01/23 17:33:25 ET
Table 'Dike III' 6-max Seat #1 is the button
Seat 1: Manic Jay ($18.52 in chips) 
Seat 3: Marauder777 ($10.56 in chips) 
Seat 4: 0TheMouse0 ($10 in chips) 
Seat 5: pensioner_x ($11.28 in chips) 
Seat 6: DrLevty ($15.68 in chips) 
Marauder777: posts small blind $0.05
0TheMouse0: posts big blind $0.10
*** HOLE CARDS ***
pensioner_x: folds 
DrLevty: folds 
Manic Jay: calls $0.10
Marauder777: folds 
0TheMouse0: checks 
*** FLOP *** [4c 3h Qs]
0TheMouse0: checks 
Manic Jay: bets $0.10
0TheMouse0: folds 
Uncalled bet ($0.10) returned to Manic Jay
Manic Jay collected $0.24 from pot
*** SUMMARY ***
Total pot $0.25 | Rake $0.01 
Board [4c 3h Qs]
Seat 1: Manic Jay (button) collected ($0.24)
Seat 3: Marauder777 (small blind) folded before Flop
Seat 4: 0TheMouse0 (big blind) folded on the Flop
Seat 5: pensioner_x folded before Flop (didn't bet)
Seat 6: DrLevty folded before Flop (didn't bet)



PokerStars Hand #222975433654:  Hold'em No Limit ($0.05/$0.10 USD) - 2021/01/23 17:33:45 ET
Table 'Dike III' 6-max Seat #3 is the button
Seat 1: Manic Jay ($18.66 in chips) 
Seat 3: Marauder777 ($10.51 in chips) 
Seat 4: 0TheMouse0 ($10 in chips) 
Seat 5: pensioner_x ($11.28 in chips) 
Seat 6: DrLevty ($15.68 in chips) 
0TheMouse0: posts small blind $0.05
pensioner_x: posts big blind $0.10
B E M 4 W 6 330: sits out 
*** HOLE CARDS ***
DrLevty: raises $0.20 to $0.30
Manic Jay: calls $0.30
Marauder777: folds 
0TheMouse0: folds 
pensioner_x: calls $0.20
*** FLOP *** [9c 8s Jc]
pensioner_x: checks 
DrLevty: checks 
Manic Jay: bets $0.46
pensioner_x: calls $0.46
DrLevty: calls $0.46
*** TURN *** [9c 8s Jc] [9s]
pensioner_x: bets $2.23
DrLevty: folds 
Manic Jay: folds 
Uncalled bet ($2.23) returned to pensioner_x
pensioner_x collected $2.23 from pot
pensioner_x: doesn't show hand 
*** SUMMARY ***
Total pot $2.33 | Rake $0.10 
Board [9c 8s Jc 9s]
Seat 1: Manic Jay folded on the Turn
Seat 3: Marauder777 (button) folded before Flop (didn't bet)
Seat 4: 0TheMouse0 (small blind) folded before Flop
Seat 5: pensioner_x (big blind) collected ($2.23)
Seat 6: DrLevty folded on the Turn



PokerStars Hand #222975462839:  Hold'em No Limit ($0.05/$0.10 USD) - 2021/01/23 17:34:22 ET
Table 'Dike III' 6-max Seat #4 is the button
Seat 1: Manic Jay ($17.90 in chips) 
Seat 3: Marauder777 ($10.51 in chips) 
Seat 4: 0TheMouse0 ($10 in chips) 
Seat 5: pensioner_x ($12.75 in chips) 
Seat 6: DrLevty ($14.92 in chips) 
pensioner_x: posts small blind $0.05
DrLevty: posts big blind $0.10
B E M 4 W 6 330: sits out 
*** HOLE CARDS ***
Manic Jay: raises $0.20 to $0.30
Marauder777: folds 
0TheMouse0: folds 
pensioner_x: folds 
DrLevty: folds 
Uncalled bet ($0.20) returned to Manic Jay
Manic Jay collected $0.25 from pot
*** SUMMARY ***
Total pot $0.25 | Rake $0 
Seat 1: Manic Jay collected ($0.25)
Seat 3: Marauder777 folded before Flop (didn't bet)
Seat 4: 0TheMouse0 (button) folded before Flop (didn't bet)
Seat 5: pensioner_x (small blind) folded before Flop
Seat 6: DrLevty (big blind) folded before Flop



PokerStars Hand #222975469849:  Hold'em No Limit ($0.05/$0.10 USD) - 2021/01/23 17:34:31 ET
Table 'Dike III' 6-max Seat #5 is the button
Seat 1: Manic Jay ($18.05 in chips) 
Seat 3: Marauder777 ($10.51 in chips) 
Seat 4: 0TheMouse0 ($10 in chips) 
Seat 5: pensioner_x ($12.70 in chips) 
Seat 6: DrLevty ($14.82 in chips) 
DrLevty: posts small blind $0.05
Manic Jay: posts big blind $0.10
B E M 4 W 6 330: sits out 
*** HOLE CARDS ***
Marauder777: folds 
0TheMouse0: folds 
pensioner_x: folds 
DrLevty: raises $0.20 to $0.30
Manic Jay: calls $0.20
*** FLOP *** [Ac 9d 7c]
DrLevty: bets $0.19
Manic Jay: folds 
Uncalled bet ($0.19) returned to DrLevty
DrLevty collected $0.57 from pot
DrLevty: doesn't show hand 
*** SUMMARY ***
Total pot $0.60 | Rake $0.03 
Board [Ac 9d 7c]
Seat 1: Manic Jay (big blind) folded on the Flop
Seat 3: Marauder777 folded before Flop (didn't bet)
Seat 4: 0TheMouse0 folded before Flop (didn't bet)
Seat 5: pensioner_x (button) folded before Flop (didn't bet)
Seat 6: DrLevty (small blind) collected ($0.57)



PokerStars Hand #222975484453:  Hold'em No Limit ($0.05/$0.10 USD) - 2021/01/23 17:34:49 ET
Table 'Dike III' 6-max Seat #6 is the button
Seat 1: Manic Jay ($17.75 in chips) 
Seat 2: B E M 4 W 6 330 ($10 in chips) 
Seat 3: Marauder777 ($10.51 in chips) 
Seat 4: 0TheMouse0 ($10 in chips) 
Seat 5: pensioner_x ($12.70 in chips) 
Seat 6: DrLevty ($15.09 in chips) 
Manic Jay: posts small blind $0.05
B E M 4 W 6 330: posts big blind $0.10
*** HOLE CARDS ***
Marauder777: folds 
0TheMouse0: raises $0.15 to $0.25
pensioner_x: calls $0.25
DrLevty: folds 
Manic Jay: folds 
B E M 4 W 6 330: calls $0.15
*** FLOP *** [9s Ks 4s]
B E M 4 W 6 330: checks 
0TheMouse0: checks 
pensioner_x: bets $0.38
B E M 4 W 6 330: folds 
0TheMouse0: folds 
Uncalled bet ($0.38) returned to pensioner_x
pensioner_x collected $0.76 from pot
pensioner_x: doesn't show hand 
*** SUMMARY ***
Total pot $0.80 | Rake $0.04 
Board [9s Ks 4s]
Seat 1: Manic Jay (small blind) folded before Flop
Seat 2: B E M 4 W 6 330 (big blind) folded on the Flop
Seat 3: Marauder777 folded before Flop (didn't bet)
Seat 4: 0TheMouse0 folded on the Flop
Seat 5: pensioner_x collected ($0.76)
Seat 6: DrLevty (button) folded before Flop (didn't bet)



PokerStars Hand #222975520556:  Hold'em No Limit ($0.05/$0.10 USD) - 2021/01/23 17:35:23 ET
Table 'Dike III' 6-max Seat #1 is the button
Seat 1: Manic Jay ($17.70 in chips) 
Seat 2: B E M 4 W 6 330 ($10 in chips) 
Seat 3: Marauder777 ($10.51 in chips) 
Seat 4: 0TheMouse0 ($10 in chips) 
Seat 5: pensioner_x ($13.21 in chips) 
Seat 6: DrLevty ($15.09 in chips) 
B E M 4 W 6 330: posts small blind $0.05
Marauder777: posts big blind $0.10
*** HOLE CARDS ***
0TheMouse0: raises $0.15 to $0.25
pensioner_x: folds 
DrLevty: folds 
Manic Jay: calls $0.25
B E M 4 W 6 330: calls $0.20
Marauder777: folds 
*** FLOP *** [Kd 6s Ac]
B E M 4 W 6 330: checks 
0TheMouse0: checks 
Manic Jay: checks 
*** TURN *** [Kd 6s Ac] [3d]
B E M 4 W 6 330: checks 
0TheMouse0: checks 
Manic Jay: checks 
*** RIVER *** [Kd 6s Ac 3d] [7c]
B E M 4 W 6 330: checks 
0TheMouse0: checks 
Manic Jay: checks 
*** SHOW DOWN ***
B E M 4 W 6 330: shows [5h 2h] (high card Ace)
0TheMouse0: shows [5c 6c] (a pair of Sixes)
Manic Jay: mucks hand 
0TheMouse0 collected $0.81 from pot
*** SUMMARY ***
Total pot $0.85 | Rake $0.04 
Board [Kd 6s Ac 3d 7c]
Seat 1: Manic Jay (button) mucked
Seat 2: B E M 4 W 6 330 (small blind) showed [5h 2h] and lost with high card Ace
Seat 3: Marauder777 (big blind) folded before Flop
Seat 4: 0TheMouse0 showed [5c 6c] and won ($0.81) with a pair of Sixes
Seat 5: pensioner_x folded before Flop (didn't bet)
Seat 6: DrLevty folded before Flop (didn't bet)



PokerStars Hand #222975545671:  Hold'em No Limit ($0.05/$0.10 USD) - 2021/01/23 17:35:56 ET
Table 'Dike III' 6-max Seat #2 is the button
Seat 1: Manic Jay ($17.45 in chips) 
Seat 2: B E M 4 W 6 330 ($10 in chips) 
Seat 3: Marauder777 ($10.41 in chips) 
Seat 4: 0TheMouse0 ($10.56 in chips) 
Seat 5: pensioner_x ($13.21 in chips) 
Seat 6: DrLevty ($15.09 in chips) 
Marauder777: posts small blind $0.05
0TheMouse0: posts big blind $0.10
*** HOLE CARDS ***
pensioner_x: raises $0.20 to $0.30
DrLevty: folds 
Manic Jay: calls $0.30
B E M 4 W 6 330: folds 
Marauder777: folds 
0TheMouse0: folds 
*** FLOP *** [9h Jd 7c]
pensioner_x: bets $0.36
Manic Jay: calls $0.36
*** TURN *** [9h Jd 7c] [Ah]
pensioner_x: checks 
Manic Jay: bets $0.70
pensioner_x: calls $0.70
*** RIVER *** [9h Jd 7c Ah] [Qh]
pensioner_x: bets $2.74
Manic Jay: calls $2.74
*** SHOW DOWN ***
pensioner_x: shows [Kd Td] (a straight, Ten to Ace)
Manic Jay: mucks hand 
pensioner_x collected $7.97 from pot
*** SUMMARY ***
Total pot $8.35 | Rake $0.38 
Board [9h Jd 7c Ah Qh]
Seat 1: Manic Jay mucked
Seat 2: B E M 4 W 6 330 (button) folded before Flop (didn't bet)
Seat 3: Marauder777 (small blind) folded before Flop
Seat 4: 0TheMouse0 (big blind) folded before Flop
Seat 5: pensioner_x showed [Kd Td] and won ($7.97) with a straight, Ten to Ace
Seat 6: DrLevty folded before Flop (didn't bet)



PokerStars Hand #222975570678:  Hold'em No Limit ($0.05/$0.10 USD) - 2021/01/23 17:36:28 ET
Table 'Dike III' 6-max Seat #3 is the button
Seat 1: Manic Jay ($13.35 in chips) 
Seat 2: B E M 4 W 6 330 ($10 in chips) 
Seat 3: Marauder777 ($10.36 in chips) 
Seat 4: 0TheMouse0 ($10.46 in chips) 
Seat 5: pensioner_x ($17.08 in chips) 
Seat 6: DrLevty ($15.09 in chips) 
0TheMouse0: posts small blind $0.05
pensioner_x: posts big blind $0.10
*** HOLE CARDS ***
DrLevty: raises $0.20 to $0.30
Manic Jay: folds 
B E M 4 W 6 330: calls $0.30
Marauder777: folds 
0TheMouse0: folds 
pensioner_x: folds 
*** FLOP *** [8s Qh 9c]
DrLevty: checks 
B E M 4 W 6 330: checks 
*** TURN *** [8s Qh 9c] [6c]
DrLevty: checks 
B E M 4 W 6 330: bets $0.40
DrLevty: folds 
Uncalled bet ($0.40) returned to B E M 4 W 6 330
B E M 4 W 6 330 collected $0.72 from pot
B E M 4 W 6 330: doesn't show hand 
*** SUMMARY ***
Total pot $0.75 | Rake $0.03 
Board [8s Qh 9c 6c]
Seat 1: Manic Jay folded before Flop (didn't bet)
Seat 2: B E M 4 W 6 330 collected ($0.72)
Seat 3: Marauder777 (button) folded before Flop (didn't bet)
Seat 4: 0TheMouse0 (small blind) folded before Flop
Seat 5: pensioner_x (big blind) folded before Flop
Seat 6: DrLevty folded on the Turn



PokerStars Hand #222975599214:  Hold'em No Limit ($0.05/$0.10 USD) - 2021/01/23 17:37:05 ET
Table 'Dike III' 6-max Seat #4 is the button
Seat 2: B E M 4 W 6 330 ($10.42 in chips) 
Seat 3: Marauder777 ($10.36 in chips) 
Seat 4: 0TheMouse0 ($10.41 in chips) 
Seat 5: pensioner_x ($16.98 in chips) 
Seat 6: DrLevty ($14.79 in chips) 
pensioner_x: posts small blind $0.05
DrLevty: posts big blind $0.10
*** HOLE CARDS ***
B E M 4 W 6 330: folds 
Marauder777: folds 
0TheMouse0: folds 
pensioner_x: folds 
Uncalled bet ($0.05) returned to DrLevty
DrLevty collected $0.10 from pot
DrLevty: doesn't show hand 
*** SUMMARY ***
Total pot $0.10 | Rake $0 
Seat 2: B E M 4 W 6 330 folded before Flop (didn't bet)
Seat 3: Marauder777 folded before Flop (didn't bet)
Seat 4: 0TheMouse0 (button) folded before Flop (didn't bet)
Seat 5: pensioner_x (small blind) folded before Flop
Seat 6: DrLevty (big blind) collected ($0.10)



PokerStars Hand #222975606914:  Hold'em No Limit ($0.05/$0.10 USD) - 2021/01/23 17:37:15 ET
Table 'Dike III' 6-max Seat #5 is the button
Seat 2: B E M 4 W 6 330 ($10.42 in chips) 
Seat 3: Marauder777 ($10.36 in chips) 
Seat 4: 0TheMouse0 ($10.41 in chips) 
Seat 5: pensioner_x ($16.93 in chips) 
Seat 6: DrLevty ($14.84 in chips) 
DrLevty: posts small blind $0.05
B E M 4 W 6 330: posts big blind $0.10
*** HOLE CARDS ***
Marauder777: folds 
0TheMouse0: folds 
pensioner_x: folds 
DrLevty: raises $0.20 to $0.30
B E M 4 W 6 330: folds 
Uncalled bet ($0.20) returned to DrLevty
DrLevty collected $0.20 from pot
DrLevty: doesn't show hand 
*** SUMMARY ***
Total pot $0.20 | Rake $0 
Seat 2: B E M 4 W 6 330 (big blind) folded before Flop
Seat 3: Marauder777 folded before Flop (didn't bet)
Seat 4: 0TheMouse0 folded before Flop (didn't bet)
Seat 5: pensioner_x (button) folded before Flop (didn't bet)
Seat 6: DrLevty (small blind) collected ($0.20)



PokerStars Hand #222975615914:  Hold'em No Limit ($0.05/$0.10 USD) - 2021/01/23 17:37:27 ET
Table 'Dike III' 6-max Seat #6 is the button
Seat 2: B E M 4 W 6 330 ($10.32 in chips) 
Seat 3: Marauder777 ($10.36 in chips) 
Seat 4: 0TheMouse0 ($10.41 in chips) 
Seat 5: pensioner_x ($16.93 in chips) 
Seat 6: DrLevty ($14.94 in chips) 
B E M 4 W 6 330: posts small blind $0.05
Marauder777: posts big blind $0.10
*** HOLE CARDS ***
0TheMouse0: folds 
pensioner_x: raises $0.20 to $0.30
DrLevty: folds 
B E M 4 W 6 330: folds 
Marauder777: folds 
Uncalled bet ($0.20) returned to pensioner_x
pensioner_x collected $0.25 from pot
pensioner_x: doesn't show hand 
*** SUMMARY ***
Total pot $0.25 | Rake $0 
Seat 2: B E M 4 W 6 330 (small blind) folded before Flop
Seat 3: Marauder777 (big blind) folded before Flop
Seat 4: 0TheMouse0 folded before Flop (didn't bet)
Seat 5: pensioner_x collected ($0.25)
Seat 6: DrLevty (button) folded before Flop (didn't bet)



PokerStars Hand #222975625059:  Hold'em No Limit ($0.05/$0.10 USD) - 2021/01/23 17:37:38 ET
Table 'Dike III' 6-max Seat #2 is the button
Seat 1: Manic Jay ($13.35 in chips) 
Seat 2: B E M 4 W 6 330 ($10.27 in chips) 
Seat 3: Marauder777 ($10.26 in chips) 
Seat 4: 0TheMouse0 ($10.41 in chips) 
Seat 5: pensioner_x ($17.08 in chips) 
Seat 6: DrLevty ($14.94 in chips) 
Marauder777: posts small blind $0.05
0TheMouse0: posts big blind $0.10
Manic Jay: posts small & big blinds $0.15
*** HOLE CARDS ***
pensioner_x: folds 
DrLevty: folds 
Manic Jay: checks 
B E M 4 W 6 330: folds 
Marauder777: calls $0.05
0TheMouse0: checks 
*** FLOP *** [Tc 9s 4c]
Marauder777: checks 
0TheMouse0: bets $0.30
Manic Jay: calls $0.30
Marauder777: folds 
*** TURN *** [Tc 9s 4c] [Th]
0TheMouse0: checks 
Manic Jay: checks 
*** RIVER *** [Tc 9s 4c Th] [5h]
0TheMouse0: checks 
Manic Jay: checks 
*** SHOW DOWN ***
0TheMouse0: shows [9h Ad] (two pair, Tens and Nines)
Manic Jay: mucks hand 
0TheMouse0 collected $0.91 from pot
*** SUMMARY ***
Total pot $0.95 | Rake $0.04 
Board [Tc 9s 4c Th 5h]
Seat 1: Manic Jay mucked
Seat 2: B E M 4 W 6 330 (button) folded before Flop (didn't bet)
Seat 3: Marauder777 (small blind) folded on the Flop
Seat 4: 0TheMouse0 (big blind) showed [9h Ad] and won ($0.91) with two pair, Tens and Nines
Seat 5: pensioner_x folded before Flop (didn't bet)
Seat 6: DrLevty folded before Flop (didn't bet)



PokerStars Hand #222975661392:  Hold'em No Limit ($0.05/$0.10 USD) - 2021/01/23 17:38:26 ET
Table 'Dike III' 6-max Seat #3 is the button
Seat 1: Manic Jay ($12.90 in chips) 
Seat 2: B E M 4 W 6 330 ($10.27 in chips) 
Seat 3: Marauder777 ($10.16 in chips) 
Seat 4: 0TheMouse0 ($10.92 in chips) 
Seat 5: pensioner_x ($17.08 in chips) 
Seat 6: DrLevty ($14.94 in chips) 
0TheMouse0: posts small blind $0.05
pensioner_x: posts big blind $0.10
*** HOLE CARDS ***
DrLevty: folds 
Manic Jay: calls $0.10
B E M 4 W 6 330: folds 
Marauder777: folds 
0TheMouse0: folds 
pensioner_x: checks 
*** FLOP *** [Ah Jh Kd]
pensioner_x: bets $0.10
Manic Jay: calls $0.10
*** TURN *** [Ah Jh Kd] [6c]
pensioner_x: checks 
Manic Jay: checks 
*** RIVER *** [Ah Jh Kd 6c] [4d]
pensioner_x: checks 
Manic Jay: checks 
*** SHOW DOWN ***
pensioner_x: shows [6h 2d] (a pair of Sixes)
Manic Jay: mucks hand 
pensioner_x collected $0.43 from pot
*** SUMMARY ***
Total pot $0.45 | Rake $0.02 
Board [Ah Jh Kd 6c 4d]
Seat 1: Manic Jay mucked
Seat 2: B E M 4 W 6 330 folded before Flop (didn't bet)
Seat 3: Marauder777 (button) folded before Flop (didn't bet)
Seat 4: 0TheMouse0 (small blind) folded before Flop
Seat 5: pensioner_x (big blind) showed [6h 2d] and won ($0.43) with a pair of Sixes
Seat 6: DrLevty folded before Flop (didn't bet)



PokerStars Hand #222975687674:  Hold'em No Limit ($0.05/$0.10 USD) - 2021/01/23 17:39:00 ET
Table 'Dike III' 6-max Seat #4 is the button
Seat 1: Manic Jay ($12.70 in chips) 
Seat 2: B E M 4 W 6 330 ($10.27 in chips) 
Seat 3: Marauder777 ($10.16 in chips) 
Seat 4: 0TheMouse0 ($10.87 in chips) 
Seat 5: pensioner_x ($17.31 in chips) 
Seat 6: DrLevty ($14.94 in chips) 
pensioner_x: posts small blind $0.05
DrLevty: posts big blind $0.10
*** HOLE CARDS ***
Manic Jay: raises $0.20 to $0.30
B E M 4 W 6 330: folds 
Marauder777: folds 
0TheMouse0: folds 
pensioner_x: folds 
DrLevty: raises $1.05 to $1.35
Manic Jay: calls $1.05
*** FLOP *** [Th 3s 9c]
DrLevty: bets $1.97
Manic Jay: calls $1.97
*** TURN *** [Th 3s 9c] [8c]
DrLevty: checks 
Manic Jay: checks 
*** RIVER *** [Th 3s 9c 8c] [Tc]
DrLevty: bets $2.11
Manic Jay: folds 
Uncalled bet ($2.11) returned to DrLevty
DrLevty collected $6.39 from pot
DrLevty: doesn't show hand 
*** SUMMARY ***
Total pot $6.69 | Rake $0.30 
Board [Th 3s 9c 8c Tc]
Seat 1: Manic Jay folded on the River
Seat 2: B E M 4 W 6 330 folded before Flop (didn't bet)
Seat 3: Marauder777 folded before Flop (didn't bet)
Seat 4: 0TheMouse0 (button) folded before Flop (didn't bet)
Seat 5: pensioner_x (small blind) folded before Flop
Seat 6: DrLevty (big blind) collected ($6.39)



PokerStars Hand #222975718540:  Hold'em No Limit ($0.05/$0.10 USD) - 2021/01/23 17:39:40 ET
Table 'Dike III' 6-max Seat #5 is the button
Seat 1: Manic Jay ($9.38 in chips) 
Seat 2: B E M 4 W 6 330 ($10.27 in chips) 
Seat 3: Marauder777 ($10.16 in chips) 
Seat 4: 0TheMouse0 ($10.87 in chips) 
Seat 5: pensioner_x ($17.26 in chips) 
Seat 6: DrLevty ($18.01 in chips) 
DrLevty: posts small blind $0.05
Manic Jay: posts big blind $0.10
*** HOLE CARDS ***
B E M 4 W 6 330: folds 
Marauder777: folds 
0TheMouse0: raises $0.15 to $0.25
pensioner_x: folds 
DrLevty: folds 
Manic Jay: calls $0.15
*** FLOP *** [2d Jd 5c]
Manic Jay: bets $0.30
0TheMouse0: folds 
Uncalled bet ($0.30) returned to Manic Jay
Manic Jay collected $0.53 from pot
*** SUMMARY ***
Total pot $0.55 | Rake $0.02 
Board [2d Jd 5c]
Seat 1: Manic Jay (big blind) collected ($0.53)
Seat 2: B E M 4 W 6 330 folded before Flop (didn't bet)
Seat 3: Marauder777 folded before Flop (didn't bet)
Seat 4: 0TheMouse0 folded on the Flop
Seat 5: pensioner_x (button) folded before Flop (didn't bet)
Seat 6: DrLevty (small blind) folded before Flop



PokerStars Hand #222975740685:  Hold'em No Limit ($0.05/$0.10 USD) - 2021/01/23 17:40:09 ET
Table 'Dike III' 6-max Seat #6 is the button
Seat 1: Manic Jay ($9.66 in chips) 
Seat 2: B E M 4 W 6 330 ($10.27 in chips) 
Seat 3: Marauder777 ($10.16 in chips) 
Seat 4: 0TheMouse0 ($10.62 in chips) 
Seat 5: pensioner_x ($17.26 in chips) 
Seat 6: DrLevty ($17.96 in chips) 
Manic Jay: posts small blind $0.05
B E M 4 W 6 330: posts big blind $0.10
*** HOLE CARDS ***
Marauder777: raises $0.12 to $0.22
0TheMouse0: folds 
pensioner_x: folds 
DrLevty: folds 
Manic Jay: folds 
B E M 4 W 6 330: folds 
Uncalled bet ($0.12) returned to Marauder777
Marauder777 collected $0.25 from pot
Marauder777: doesn't show hand 
*** SUMMARY ***
Total pot $0.25 | Rake $0 
Seat 1: Manic Jay (small blind) folded before Flop
Seat 2: B E M 4 W 6 330 (big blind) folded before Flop
Seat 3: Marauder777 collected ($0.25)
Seat 4: 0TheMouse0 folded before Flop (didn't bet)
Seat 5: pensioner_x folded before Flop (didn't bet)
Seat 6: DrLevty (button) folded before Flop (didn't bet)



PokerStars Hand #222975748395:  Hold'em No Limit ($0.05/$0.10 USD) - 2021/01/23 17:40:19 ET
Table 'Dike III' 6-max Seat #1 is the button
Seat 1: Manic Jay ($9.61 in chips) 
Seat 2: B E M 4 W 6 330 ($10.17 in chips) 
Seat 3: Marauder777 ($10.31 in chips) 
Seat 4: 0TheMouse0 ($10.62 in chips) 
Seat 5: pensioner_x ($17.26 in chips) 
Seat 6: DrLevty ($17.96 in chips) 
B E M 4 W 6 330: posts small blind $0.05
Marauder777: posts big blind $0.10
*** HOLE CARDS ***
0TheMouse0: folds 
pensioner_x: raises $0.20 to $0.30
DrLevty: folds 
Manic Jay: folds 
B E M 4 W 6 330: folds 
Marauder777: folds 
Uncalled bet ($0.20) returned to pensioner_x
pensioner_x collected $0.25 from pot
pensioner_x: doesn't show hand 
*** SUMMARY ***
Total pot $0.25 | Rake $0 
Seat 1: Manic Jay (button) folded before Flop (didn't bet)
Seat 2: B E M 4 W 6 330 (small blind) folded before Flop
Seat 3: Marauder777 (big blind) folded before Flop
Seat 4: 0TheMouse0 folded before Flop (didn't bet)
Seat 5: pensioner_x collected ($0.25)
Seat 6: DrLevty folded before Flop (didn't bet)



PokerStars Hand #222975760201:  Hold'em No Limit ($0.05/$0.10 USD) - 2021/01/23 17:40:35 ET
Table 'Dike III' 6-max Seat #2 is the button
Seat 1: Manic Jay ($9.61 in chips) 
Seat 2: B E M 4 W 6 330 ($10.12 in chips) 
Seat 3: Marauder777 ($10.21 in chips) 
Seat 4: 0TheMouse0 ($10.62 in chips) 
Seat 5: pensioner_x ($17.41 in chips) 
Seat 6: DrLevty ($17.96 in chips) 
Marauder777: posts small blind $0.05
0TheMouse0: posts big blind $0.10
*** HOLE CARDS ***
pensioner_x: folds 
DrLevty: folds 
Manic Jay: calls $0.10
B E M 4 W 6 330: raises $0.30 to $0.40
Marauder777: folds 
0TheMouse0: folds 
Manic Jay: calls $0.30
*** FLOP *** [8h 3c 2c]
Manic Jay: checks 
B E M 4 W 6 330: bets $0.60
Manic Jay: calls $0.60
*** TURN *** [8h 3c 2c] [Tc]
Manic Jay: checks 
B E M 4 W 6 330: bets $0.80
Manic Jay: calls $0.80
*** RIVER *** [8h 3c 2c Tc] [Th]
Manic Jay: checks 
B E M 4 W 6 330: bets $2.60
Manic Jay: folds 
Uncalled bet ($2.60) returned to B E M 4 W 6 330
B E M 4 W 6 330 collected $3.58 from pot
B E M 4 W 6 330: doesn't show hand 
*** SUMMARY ***
Total pot $3.75 | Rake $0.17 
Board [8h 3c 2c Tc Th]
Seat 1: Manic Jay folded on the River
Seat 2: B E M 4 W 6 330 (button) collected ($3.58)
Seat 3: Marauder777 (small blind) folded before Flop
Seat 4: 0TheMouse0 (big blind) folded before Flop
Seat 5: pensioner_x folded before Flop (didn't bet)
Seat 6: DrLevty folded before Flop (didn't bet)



PokerStars Hand #222975806629:  Hold'em No Limit ($0.05/$0.10 USD) - 2021/01/23 17:41:35 ET
Table 'Dike III' 6-max Seat #3 is the button
Seat 1: Manic Jay ($7.81 in chips) 
Seat 2: B E M 4 W 6 330 ($11.90 in chips) 
Seat 3: Marauder777 ($10.16 in chips) 
Seat 4: 0TheMouse0 ($10.52 in chips) 
Seat 5: pensioner_x ($17.41 in chips) 
Seat 6: DrLevty ($17.96 in chips) 
0TheMouse0: posts small blind $0.05
pensioner_x: posts big blind $0.10
*** HOLE CARDS ***
DrLevty: raises $0.20 to $0.30
Manic Jay: folds 
B E M 4 W 6 330: folds 
Marauder777: folds 
0TheMouse0: folds 
pensioner_x: folds 
Uncalled bet ($0.20) returned to DrLevty
DrLevty collected $0.25 from pot
DrLevty: doesn't show hand 
*** SUMMARY ***
Total pot $0.25 | Rake $0 
Seat 1: Manic Jay folded before Flop (didn't bet)
Seat 2: B E M 4 W 6 330 folded before Flop (didn't bet)
Seat 3: Marauder777 (button) folded before Flop (didn't bet)
Seat 4: 0TheMouse0 (small blind) folded before Flop
Seat 5: pensioner_x (big blind) folded before Flop
Seat 6: DrLevty collected ($0.25)



PokerStars Hand #222975819203:  Hold'em No Limit ($0.05/$0.10 USD) - 2021/01/23 17:41:52 ET
Table 'Dike III' 6-max Seat #4 is the button
Seat 1: Manic Jay ($7.81 in chips) 
Seat 2: B E M 4 W 6 330 ($11.90 in chips) 
Seat 3: Marauder777 ($10.16 in chips) 
Seat 4: 0TheMouse0 ($10.47 in chips) 
Seat 5: pensioner_x ($17.31 in chips) 
Seat 6: DrLevty ($18.11 in chips) 
pensioner_x: posts small blind $0.05
DrLevty: posts big blind $0.10
*** HOLE CARDS ***
Manic Jay: folds 
B E M 4 W 6 330: folds 
Marauder777: folds 
0TheMouse0: folds 
pensioner_x: folds 
Uncalled bet ($0.05) returned to DrLevty
DrLevty collected $0.10 from pot
DrLevty: doesn't show hand 
*** SUMMARY ***
Total pot $0.10 | Rake $0 
Seat 1: Manic Jay folded before Flop (didn't bet)
Seat 2: B E M 4 W 6 330 folded before Flop (didn't bet)
Seat 3: Marauder777 folded before Flop (didn't bet)
Seat 4: 0TheMouse0 (button) folded before Flop (didn't bet)
Seat 5: pensioner_x (small blind) folded before Flop
Seat 6: DrLevty (big blind) collected ($0.10)



PokerStars Hand #222975829356:  Hold'em No Limit ($0.05/$0.10 USD) - 2021/01/23 17:42:05 ET
Table 'Dike III' 6-max Seat #5 is the button
Seat 1: Manic Jay ($7.81 in chips) 
Seat 2: B E M 4 W 6 330 ($11.90 in chips) 
Seat 3: Marauder777 ($10.16 in chips) 
Seat 4: 0TheMouse0 ($10.47 in chips) 
Seat 5: pensioner_x ($17.26 in chips) 
Seat 6: DrLevty ($18.16 in chips) 
DrLevty: posts small blind $0.05
Manic Jay: posts big blind $0.10
*** HOLE CARDS ***
B E M 4 W 6 330: folds 
Marauder777: folds 
0TheMouse0: raises $0.15 to $0.25
pensioner_x: folds 
DrLevty: folds 
Manic Jay: calls $0.15
*** FLOP *** [8h Th As]
Manic Jay: checks 
0TheMouse0: bets $0.37
Manic Jay: folds 
Uncalled bet ($0.37) returned to 0TheMouse0
0TheMouse0 collected $0.53 from pot
0TheMouse0: doesn't show hand 
*** SUMMARY ***
Total pot $0.55 | Rake $0.02 
Board [8h Th As]
Seat 1: Manic Jay (big blind) folded on the Flop
Seat 2: B E M 4 W 6 330 folded before Flop (didn't bet)
Seat 3: Marauder777 folded before Flop (didn't bet)
Seat 4: 0TheMouse0 collected ($0.53)
Seat 5: pensioner_x (button) folded before Flop (didn't bet)
Seat 6: DrLevty (small blind) folded before Flop



PokerStars Hand #222975849573:  Hold'em No Limit ($0.05/$0.10 USD) - 2021/01/23 17:42:31 ET
Table 'Dike III' 6-max Seat #6 is the button
Seat 1: Manic Jay ($7.56 in chips) 
Seat 2: B E M 4 W 6 330 ($11.90 in chips) 
Seat 3: Marauder777 ($10.16 in chips) 
Seat 4: 0TheMouse0 ($10.75 in chips) 
Seat 5: pensioner_x ($17.26 in chips) 
Seat 6: DrLevty ($18.11 in chips) 
Manic Jay: posts small blind $0.05
B E M 4 W 6 330: posts big blind $0.10
*** HOLE CARDS ***
Marauder777: folds 
0TheMouse0: folds 
pensioner_x: folds 
DrLevty: folds 
Manic Jay: calls $0.05
B E M 4 W 6 330: checks 
*** FLOP *** [Ah 4h 6d]
Manic Jay: checks 
B E M 4 W 6 330: checks 
*** TURN *** [Ah 4h 6d] [9s]
Manic Jay: checks 
B E M 4 W 6 330: checks 
*** RIVER *** [Ah 4h 6d 9s] [4s]
Manic Jay: checks 
B E M 4 W 6 330: checks 
*** SHOW DOWN ***
Manic Jay: shows [Td 8h] (a pair of Fours)
B E M 4 W 6 330: shows [9d 7d] (two pair, Nines and Fours)
B E M 4 W 6 330 collected $0.19 from pot
*** SUMMARY ***
Total pot $0.20 | Rake $0.01 
Board [Ah 4h 6d 9s 4s]
Seat 1: Manic Jay (small blind) showed [Td 8h] and lost with a pair of Fours
Seat 2: B E M 4 W 6 330 (big blind) showed [9d 7d] and won ($0.19) with two pair, Nines and Fours
Seat 3: Marauder777 folded before Flop (didn't bet)
Seat 4: 0TheMouse0 folded before Flop (didn't bet)
Seat 5: pensioner_x folded before Flop (didn't bet)
Seat 6: DrLevty (button) folded before Flop (didn't bet)



PokerStars Hand #222975873462:  Hold'em No Limit ($0.05/$0.10 USD) - 2021/01/23 17:43:02 ET
Table 'Dike III' 6-max Seat #1 is the button
Seat 1: Manic Jay ($7.46 in chips) 
Seat 2: B E M 4 W 6 330 ($11.99 in chips) 
Seat 3: Marauder777 ($10.16 in chips) 
Seat 4: 0TheMouse0 ($10.75 in chips) 
Seat 5: pensioner_x ($17.26 in chips) 
Seat 6: DrLevty ($18.11 in chips) 
B E M 4 W 6 330: posts small blind $0.05
Marauder777: posts big blind $0.10
*** HOLE CARDS ***
0TheMouse0: folds 
pensioner_x: folds 
DrLevty: folds 
Manic Jay: folds 
B E M 4 W 6 330: folds 
Uncalled bet ($0.05) returned to Marauder777
Marauder777 collected $0.10 from pot
Marauder777: doesn't show hand 
*** SUMMARY ***
Total pot $0.10 | Rake $0 
Seat 1: Manic Jay (button) folded before Flop (didn't bet)
Seat 2: B E M 4 W 6 330 (small blind) folded before Flop
Seat 3: Marauder777 (big blind) collected ($0.10)
Seat 4: 0TheMouse0 folded before Flop (didn't bet)
Seat 5: pensioner_x folded before Flop (didn't bet)
Seat 6: DrLevty folded before Flop (didn't bet)



PokerStars Hand #222975879556:  Hold'em No Limit ($0.05/$0.10 USD) - 2021/01/23 17:43:11 ET
Table 'Dike III' 6-max Seat #2 is the button
Seat 1: Manic Jay ($7.46 in chips) 
Seat 2: B E M 4 W 6 330 ($11.94 in chips) 
Seat 3: Marauder777 ($10.21 in chips) 
Seat 4: 0TheMouse0 ($10.75 in chips) 
Seat 5: pensioner_x ($17.26 in chips) 
Seat 6: DrLevty ($18.11 in chips) 
Marauder777: posts small blind $0.05
0TheMouse0: posts big blind $0.10
*** HOLE CARDS ***
pensioner_x: folds 
DrLevty: folds 
Manic Jay: raises $0.20 to $0.30
B E M 4 W 6 330: folds 
Marauder777: folds 
0TheMouse0: folds 
Uncalled bet ($0.20) returned to Manic Jay
Manic Jay collected $0.25 from pot
*** SUMMARY ***
Total pot $0.25 | Rake $0 
Seat 1: Manic Jay collected ($0.25)
Seat 2: B E M 4 W 6 330 (button) folded before Flop (didn't bet)
Seat 3: Marauder777 (small blind) folded before Flop
Seat 4: 0TheMouse0 (big blind) folded before Flop
Seat 5: pensioner_x folded before Flop (didn't bet)
Seat 6: DrLevty folded before Flop (didn't bet)



PokerStars Hand #222976006240:  Hold'em No Limit ($0.05/$0.10 USD) - 2021/01/23 17:45:58 ET
Table 'Dike III' 6-max Seat #4 is the button
Seat 1: Manic Jay ($7.06 in chips) 
Seat 2: B E M 4 W 6 330 ($11.54 in chips) 
Seat 3: Marauder777 ($10.55 in chips) 
Seat 4: 0TheMouse0 ($10.20 in chips) 
Seat 5: pensioner_x ($17.82 in chips) 
Seat 6: DrLevty ($18.38 in chips) 
pensioner_x: posts small blind $0.05
DrLevty: posts big blind $0.10
*** HOLE CARDS ***
Manic Jay: calls $0.10
B E M 4 W 6 330: raises $0.30 to $0.40
Marauder777: folds 
0TheMouse0: folds 
pensioner_x: calls $0.35
DrLevty: folds 
Manic Jay: calls $0.30
*** FLOP *** [7h Qh Th]
pensioner_x: checks 
Manic Jay: checks 
B E M 4 W 6 330: bets $0.80
DrLevty leaves the table
pensioner_x: folds 
Manic Jay: calls $0.80
*** TURN *** [7h Qh Th] [Jh]
Manic Jay: checks 
SRJ18 joins the table at seat #6 
B E M 4 W 6 330: bets $1.70
Manic Jay: calls $1.70
*** RIVER *** [7h Qh Th Jh] [4d]
Manic Jay: checks 
B E M 4 W 6 330: checks 
*** SHOW DOWN ***
Manic Jay: shows [8h Kc] (a flush, Queen high)
B E M 4 W 6 330: mucks hand 
Manic Jay collected $6.02 from pot
*** SUMMARY ***
Total pot $6.30 | Rake $0.28 
Board [7h Qh Th Jh 4d]
Seat 1: Manic Jay showed [8h Kc] and won ($6.02) with a flush, Queen high
Seat 2: B E M 4 W 6 330 mucked
Seat 3: Marauder777 folded before Flop (didn't bet)
Seat 4: 0TheMouse0 (button) folded before Flop (didn't bet)
Seat 5: pensioner_x (small blind) folded on the Flop
Seat 6: DrLevty (big blind) folded before Flop



PokerStars Hand #222976072866:  Hold'em No Limit ($0.05/$0.10 USD) - 2021/01/23 17:47:27 ET
Table 'Dike III' 6-max Seat #5 is the button
Seat 1: Manic Jay ($10.18 in chips) 
Seat 2: B E M 4 W 6 330 ($10 in chips) 
Seat 3: Marauder777 ($10.55 in chips) 
Seat 4: 0TheMouse0 ($10.20 in chips) 
Seat 5: pensioner_x ($17.42 in chips) 
Manic Jay: posts small blind $0.05
B E M 4 W 6 330: posts big blind $0.10
*** HOLE CARDS ***
Marauder777: folds 
0TheMouse0: folds 
pensioner_x: raises $0.20 to $0.30
Manic Jay: calls $0.25
B E M 4 W 6 330: calls $0.20
*** FLOP *** [Qd Td Ks]
Manic Jay: checks 
B E M 4 W 6 330: checks 
pensioner_x: bets $0.50
Manic Jay: calls $0.50
B E M 4 W 6 330: folds 
*** TURN *** [Qd Td Ks] [3d]
Manic Jay: checks 
pensioner_x: bets $1.30
Manic Jay: calls $1.30
*** RIVER *** [Qd Td Ks 3d] [7h]
Manic Jay: checks 
pensioner_x: bets $2.20
Manic Jay: folds 
Uncalled bet ($2.20) returned to pensioner_x
pensioner_x collected $4.30 from pot
pensioner_x: doesn't show hand 
*** SUMMARY ***
Total pot $4.50 | Rake $0.20 
Board [Qd Td Ks 3d 7h]
Seat 1: Manic Jay (small blind) folded on the River
Seat 2: B E M 4 W 6 330 (big blind) folded on the Flop
Seat 3: Marauder777 folded before Flop (didn't bet)
Seat 4: 0TheMouse0 folded before Flop (didn't bet)
Seat 5: pensioner_x (button) collected ($4.30)



PokerStars Hand #222976107731:  Hold'em No Limit ($0.05/$0.10 USD) - 2021/01/23 17:48:14 ET
Table 'Dike III' 6-max Seat #1 is the button
Seat 1: Manic Jay ($8.08 in chips) 
Seat 2: B E M 4 W 6 330 ($10 in chips) 
Seat 3: Marauder777 ($10.55 in chips) 
Seat 4: 0TheMouse0 ($10.20 in chips) 
Seat 5: pensioner_x ($19.62 in chips) 
Seat 6: SRJ18 ($8 in chips) 
B E M 4 W 6 330: posts small blind $0.05
Marauder777: posts big blind $0.10
SRJ18: posts big blind $0.10
*** HOLE CARDS ***
0TheMouse0: folds 
pensioner_x: folds 
SRJ18: checks 
Manic Jay: raises $0.20 to $0.30
B E M 4 W 6 330: folds 
Marauder777: calls $0.20
SRJ18: folds 
*** FLOP *** [Kd 6s 6c]
Marauder777: checks 
Manic Jay: bets $0.30
Marauder777: folds 
Uncalled bet ($0.30) returned to Manic Jay
Manic Jay collected $0.72 from pot
*** SUMMARY ***
Total pot $0.75 | Rake $0.03 
Board [Kd 6s 6c]
Seat 1: Manic Jay (button) collected ($0.72)
Seat 2: B E M 4 W 6 330 (small blind) folded before Flop
Seat 3: Marauder777 (big blind) folded on the Flop
Seat 4: 0TheMouse0 folded before Flop (didn't bet)
Seat 5: pensioner_x folded before Flop (didn't bet)
Seat 6: SRJ18 folded before Flop (didn't bet)



PokerStars Hand #222976132138:  Hold'em No Limit ($0.05/$0.10 USD) - 2021/01/23 17:48:47 ET
Table 'Dike III' 6-max Seat #2 is the button
Seat 1: Manic Jay ($8.50 in chips) 
Seat 2: B E M 4 W 6 330 ($10 in chips) 
Seat 3: Marauder777 ($10.25 in chips) 
Seat 4: 0TheMouse0 ($10.20 in chips) 
Seat 5: pensioner_x ($19.62 in chips) 
Seat 6: SRJ18 ($7.90 in chips) 
Marauder777: posts small blind $0.05
0TheMouse0: posts big blind $0.10
*** HOLE CARDS ***
pensioner_x: folds 
SRJ18: calls $0.10
Manic Jay: folds 
B E M 4 W 6 330: folds 
Marauder777: folds 
0TheMouse0: checks 
*** FLOP *** [As 9c Qs]
0TheMouse0: checks 
SRJ18: checks 
*** TURN *** [As 9c Qs] [Ad]
0TheMouse0: checks 
SRJ18: checks 
*** RIVER *** [As 9c Qs Ad] [Qc]
0TheMouse0: bets $0.17
SRJ18: calls $0.17
*** SHOW DOWN ***
0TheMouse0: shows [4d 3d] (two pair, Aces and Queens)
SRJ18: shows [Js Th] (two pair, Aces and Queens - Jack kicker)
SRJ18 collected $0.56 from pot
*** SUMMARY ***
Total pot $0.59 | Rake $0.03 
Board [As 9c Qs Ad Qc]
Seat 1: Manic Jay folded before Flop (didn't bet)
Seat 2: B E M 4 W 6 330 (button) folded before Flop (didn't bet)
Seat 3: Marauder777 (small blind) folded before Flop
Seat 4: 0TheMouse0 (big blind) showed [4d 3d] and lost with two pair, Aces and Queens
Seat 5: pensioner_x folded before Flop (didn't bet)
Seat 6: SRJ18 showed [Js Th] and won ($0.56) with two pair, Aces and Queens



PokerStars Hand #222976152244:  Hold'em No Limit ($0.05/$0.10 USD) - 2021/01/23 17:49:14 ET
Table 'Dike III' 6-max Seat #3 is the button
Seat 1: Manic Jay ($8.50 in chips) 
Seat 2: B E M 4 W 6 330 ($10 in chips) 
Seat 3: Marauder777 ($10.20 in chips) 
Seat 4: 0TheMouse0 ($10 in chips) 
Seat 5: pensioner_x ($19.62 in chips) 
Seat 6: SRJ18 ($8.19 in chips) 
0TheMouse0: posts small blind $0.05
pensioner_x: posts big blind $0.10
*** HOLE CARDS ***
SRJ18: calls $0.10
Manic Jay: folds 
B E M 4 W 6 330: folds 
Marauder777: raises $0.30 to $0.40
0TheMouse0: folds 
pensioner_x: raises $0.90 to $1.30
SRJ18: folds 
Marauder777: raises $1.65 to $2.95
pensioner_x: calls $1.65
*** FLOP *** [Qc Ac 5d]
pensioner_x: checks 
Marauder777: bets $1.65
pensioner_x: calls $1.65
*** TURN *** [Qc Ac 5d] [Jc]
pensioner_x: checks 
Marauder777: bets $5.60 and is all-in
pensioner_x: calls $5.60
*** RIVER *** [Qc Ac 5d Jc] [8h]
*** SHOW DOWN ***
pensioner_x: shows [Qh Qd] (three of a kind, Queens)
Marauder777: shows [Kc Ad] (a pair of Aces)
pensioner_x cashed out the hand for $14.58 | Cash Out Fee $0.15
*** SUMMARY ***
Total pot $20.55 | Rake $0.92 
Board [Qc Ac 5d Jc 8h]
Seat 1: Manic Jay folded before Flop (didn't bet)
Seat 2: B E M 4 W 6 330 folded before Flop (didn't bet)
Seat 3: Marauder777 (button) showed [Kc Ad] and lost with a pair of Aces
Seat 4: 0TheMouse0 (small blind) folded before Flop
Seat 5: pensioner_x (big blind) showed [Qh Qd] and won ($19.63) with three of a kind, Queens (pot not awarded as player cashed out)
Seat 6: SRJ18 folded before Flop



PokerStars Hand #222976201396:  Hold'em No Limit ($0.05/$0.10 USD) - 2021/01/23 17:50:21 ET
Table 'Dike III' 6-max Seat #4 is the button
Seat 1: Manic Jay ($8.50 in chips) 
Seat 2: B E M 4 W 6 330 ($10 in chips) 
Seat 3: Marauder777 ($10 in chips) 
Seat 4: 0TheMouse0 ($10 in chips) 
Seat 5: pensioner_x ($24 in chips) 
Seat 6: SRJ18 ($8.09 in chips) 
pensioner_x: posts small blind $0.05
SRJ18: posts big blind $0.10
*** HOLE CARDS ***
Manic Jay: calls $0.10
B E M 4 W 6 330: folds 
Marauder777: folds 
0TheMouse0: raises $0.35 to $0.45
pensioner_x: calls $0.40
SRJ18: folds 
Manic Jay: calls $0.35
*** FLOP *** [Tc 9d 4d]
pensioner_x: checks 
Manic Jay: checks 
0TheMouse0: checks 
*** TURN *** [Tc 9d 4d] [6h]
pensioner_x: bets $0.69
Manic Jay: folds 
0TheMouse0: folds 
Uncalled bet ($0.69) returned to pensioner_x
pensioner_x collected $1.38 from pot
pensioner_x: doesn't show hand 
*** SUMMARY ***
Total pot $1.45 | Rake $0.07 
Board [Tc 9d 4d 6h]
Seat 1: Manic Jay folded on the Turn
Seat 2: B E M 4 W 6 330 folded before Flop (didn't bet)
Seat 3: Marauder777 folded before Flop (didn't bet)
Seat 4: 0TheMouse0 (button) folded on the Turn
Seat 5: pensioner_x (small blind) collected ($1.38)
Seat 6: SRJ18 (big blind) folded before Flop



PokerStars Hand #222976239285:  Hold'em No Limit ($0.05/$0.10 USD) - 2021/01/23 17:51:13 ET
Table 'Dike III' 6-max Seat #5 is the button
Seat 1: Manic Jay ($8.05 in chips) 
Seat 2: B E M 4 W 6 330 ($10 in chips) 
Seat 3: Marauder777 ($10 in chips) 
Seat 4: 0TheMouse0 ($10 in chips) 
Seat 5: pensioner_x ($24.93 in chips) 
Seat 6: SRJ18 ($7.99 in chips) 
SRJ18: posts small blind $0.05
Manic Jay: posts big blind $0.10
*** HOLE CARDS ***
B E M 4 W 6 330: folds 
Marauder777: folds 
0TheMouse0: folds 
pensioner_x: folds 
SRJ18: raises $0.30 to $0.40
Manic Jay: calls $0.30
*** FLOP *** [9h Qs 8d]
SRJ18: bets $0.50
Manic Jay: calls $0.50
*** TURN *** [9h Qs 8d] [4s]
SRJ18: bets $1
Manic Jay: folds 
Uncalled bet ($1) returned to SRJ18
SRJ18 collected $1.72 from pot
*** SUMMARY ***
Total pot $1.80 | Rake $0.08 
Board [9h Qs 8d 4s]
Seat 1: Manic Jay (big blind) folded on the Turn
Seat 2: B E M 4 W 6 330 folded before Flop (didn't bet)
Seat 3: Marauder777 folded before Flop (didn't bet)
Seat 4: 0TheMouse0 folded before Flop (didn't bet)
Seat 5: pensioner_x (button) folded before Flop (didn't bet)
Seat 6: SRJ18 (small blind) collected ($1.72)



PokerStars Hand #222976260035:  Hold'em No Limit ($0.05/$0.10 USD) - 2021/01/23 17:51:41 ET
Table 'Dike III' 6-max Seat #6 is the button
Seat 1: Manic Jay ($7.15 in chips) 
Seat 2: B E M 4 W 6 330 ($10 in chips) 
Seat 3: Marauder777 ($10 in chips) 
Seat 4: 0TheMouse0 ($10 in chips) 
Seat 5: pensioner_x ($24.93 in chips) 
Seat 6: SRJ18 ($8.81 in chips) 
Manic Jay: posts small blind $0.05
B E M 4 W 6 330: posts big blind $0.10
*** HOLE CARDS ***
Marauder777: folds 
0TheMouse0: folds 
pensioner_x: folds 
SRJ18: folds 
Manic Jay: folds 
Uncalled bet ($0.05) returned to B E M 4 W 6 330
B E M 4 W 6 330 collected $0.10 from pot
B E M 4 W 6 330: doesn't show hand 
*** SUMMARY ***
Total pot $0.10 | Rake $0 
Seat 1: Manic Jay (small blind) folded before Flop
Seat 2: B E M 4 W 6 330 (big blind) collected ($0.10)
Seat 3: Marauder777 folded before Flop (didn't bet)
Seat 4: 0TheMouse0 folded before Flop (didn't bet)
Seat 5: pensioner_x folded before Flop (didn't bet)
Seat 6: SRJ18 (button) folded before Flop (didn't bet)



PokerStars Hand #222976266634:  Hold'em No Limit ($0.05/$0.10 USD) - 2021/01/23 17:51:50 ET
Table 'Dike III' 6-max Seat #1 is the button
Seat 1: Manic Jay ($7.10 in chips) 
Seat 2: B E M 4 W 6 330 ($10.05 in chips) 
Seat 3: Marauder777 ($10 in chips) 
Seat 4: 0TheMouse0 ($10 in chips) 
Seat 5: pensioner_x ($24.93 in chips) 
Seat 6: SRJ18 ($8.81 in chips) 
B E M 4 W 6 330: posts small blind $0.05
Marauder777: posts big blind $0.10
*** HOLE CARDS ***
0TheMouse0: folds 
pensioner_x: raises $0.20 to $0.30
SRJ18: folds 
Manic Jay: calls $0.30
B E M 4 W 6 330: folds 
Marauder777: folds 
*** FLOP *** [2d 8c 3c]
pensioner_x: bets $0.40
Manic Jay: calls $0.40
*** TURN *** [2d 8c 3c] [9c]
pensioner_x: bets $0.74
Manic Jay: calls $0.74
*** RIVER *** [2d 8c 3c 9c] [3s]
pensioner_x: checks 
Manic Jay: bets $2.89
pensioner_x: folds 
Uncalled bet ($2.89) returned to Manic Jay
Manic Jay collected $2.89 from pot
*** SUMMARY ***
Total pot $3.03 | Rake $0.14 
Board [2d 8c 3c 9c 3s]
Seat 1: Manic Jay (button) collected ($2.89)
Seat 2: B E M 4 W 6 330 (small blind) folded before Flop
Seat 3: Marauder777 (big blind) folded before Flop
Seat 4: 0TheMouse0 folded before Flop (didn't bet)
Seat 5: pensioner_x folded on the River
Seat 6: SRJ18 folded before Flop (didn't bet)



PokerStars Hand #222976287328:  Hold'em No Limit ($0.05/$0.10 USD) - 2021/01/23 17:52:19 ET
Table 'Dike III' 6-max Seat #2 is the button
Seat 1: Manic Jay ($8.55 in chips) 
Seat 2: B E M 4 W 6 330 ($10 in chips) 
Seat 3: Marauder777 ($10 in chips) 
Seat 4: 0TheMouse0 ($10 in chips) 
Seat 5: pensioner_x ($23.49 in chips) 
Seat 6: SRJ18 ($8.81 in chips) 
Marauder777: posts small blind $0.05
0TheMouse0: posts big blind $0.10
*** HOLE CARDS ***
pensioner_x: folds 
SRJ18: raises $0.30 to $0.40
Manic Jay: calls $0.40
B E M 4 W 6 330: folds 
Marauder777: folds 
0TheMouse0: folds 
*** FLOP *** [Kc Ac Qs]
SRJ18: bets $0.70
Manic Jay: folds 
Uncalled bet ($0.70) returned to SRJ18
SRJ18 collected $0.91 from pot
SRJ18: doesn't show hand 
*** SUMMARY ***
Total pot $0.95 | Rake $0.04 
Board [Kc Ac Qs]
Seat 1: Manic Jay folded on the Flop
Seat 2: B E M 4 W 6 330 (button) folded before Flop (didn't bet)
Seat 3: Marauder777 (small blind) folded before Flop
Seat 4: 0TheMouse0 (big blind) folded before Flop
Seat 5: pensioner_x folded before Flop (didn't bet)
Seat 6: SRJ18 collected ($0.91)



PokerStars Hand #222976308478:  Hold'em No Limit ($0.05/$0.10 USD) - 2021/01/23 17:52:48 ET
Table 'Dike III' 6-max Seat #3 is the button
Seat 1: Manic Jay ($8.15 in chips) 
Seat 2: B E M 4 W 6 330 ($10 in chips) 
Seat 3: Marauder777 ($10 in chips) 
Seat 4: 0TheMouse0 ($10 in chips) 
Seat 5: pensioner_x ($23.49 in chips) 
Seat 6: SRJ18 ($9.32 in chips) 
0TheMouse0: posts small blind $0.05
pensioner_x: posts big blind $0.10
*** HOLE CARDS ***
SRJ18: folds 
Manic Jay: folds 
B E M 4 W 6 330: folds 
Marauder777: folds 
0TheMouse0: folds 
Uncalled bet ($0.05) returned to pensioner_x
pensioner_x collected $0.10 from pot
pensioner_x: doesn't show hand 
*** SUMMARY ***
Total pot $0.10 | Rake $0 
Seat 1: Manic Jay folded before Flop (didn't bet)
Seat 2: B E M 4 W 6 330 folded before Flop (didn't bet)
Seat 3: Marauder777 (button) folded before Flop (didn't bet)
Seat 4: 0TheMouse0 (small blind) folded before Flop
Seat 5: pensioner_x (big blind) collected ($0.10)
Seat 6: SRJ18 folded before Flop (didn't bet)



PokerStars Hand #222976314895:  Hold'em No Limit ($0.05/$0.10 USD) - 2021/01/23 17:52:57 ET
Table 'Dike III' 6-max Seat #4 is the button
Seat 1: Manic Jay ($8.15 in chips) 
Seat 2: B E M 4 W 6 330 ($10 in chips) 
Seat 3: Marauder777 ($10 in chips) 
Seat 4: 0TheMouse0 ($10 in chips) 
Seat 5: pensioner_x ($23.54 in chips) 
Seat 6: SRJ18 ($9.32 in chips) 
pensioner_x: posts small blind $0.05
SRJ18: posts big blind $0.10
*** HOLE CARDS ***
Manic Jay: folds 
B E M 4 W 6 330: raises $0.20 to $0.30
Marauder777: raises $0.60 to $0.90
0TheMouse0: folds 
pensioner_x: folds 
SRJ18: folds 
B E M 4 W 6 330: folds 
Uncalled bet ($0.60) returned to Marauder777
Marauder777 collected $0.75 from pot
Marauder777: doesn't show hand 
*** SUMMARY ***
Total pot $0.75 | Rake $0 
Seat 1: Manic Jay folded before Flop (didn't bet)
Seat 2: B E M 4 W 6 330 folded before Flop
Seat 3: Marauder777 collected ($0.75)
Seat 4: 0TheMouse0 (button) folded before Flop (didn't bet)
Seat 5: pensioner_x (small blind) folded before Flop
Seat 6: SRJ18 (big blind) folded before Flop



PokerStars Hand #222976333208:  Hold'em No Limit ($0.05/$0.10 USD) - 2021/01/23 17:53:22 ET
Table 'Dike III' 6-max Seat #5 is the button
Seat 1: Manic Jay ($8.15 in chips) 
Seat 2: B E M 4 W 6 330 ($10 in chips) 
Seat 3: Marauder777 ($10.45 in chips) 
Seat 4: 0TheMouse0 ($10 in chips) 
Seat 5: pensioner_x ($23.49 in chips) 
Seat 6: SRJ18 ($9.22 in chips) 
SRJ18: posts small blind $0.05
Manic Jay: posts big blind $0.10
*** HOLE CARDS ***
B E M 4 W 6 330: folds 
Marauder777: folds 
0TheMouse0: folds 
pensioner_x: raises $0.20 to $0.30
SRJ18: folds 
Manic Jay: calls $0.20
*** FLOP *** [9h Kh 7d]
Manic Jay: checks 
pensioner_x: checks 
*** TURN *** [9h Kh 7d] [6h]
Manic Jay: bets $0.62
pensioner_x: folds 
Uncalled bet ($0.62) returned to Manic Jay
Manic Jay collected $0.62 from pot
*** SUMMARY ***
Total pot $0.65 | Rake $0.03 
Board [9h Kh 7d 6h]
Seat 1: Manic Jay (big blind) collected ($0.62)
Seat 2: B E M 4 W 6 330 folded before Flop (didn't bet)
Seat 3: Marauder777 folded before Flop (didn't bet)
Seat 4: 0TheMouse0 folded before Flop (didn't bet)
Seat 5: pensioner_x (button) folded on the Turn
Seat 6: SRJ18 (small blind) folded before Flop



PokerStars Hand #222976360995:  Hold'em No Limit ($0.05/$0.10 USD) - 2021/01/23 17:54:00 ET
Table 'Dike III' 6-max Seat #6 is the button
Seat 1: Manic Jay ($8.47 in chips) 
Seat 2: B E M 4 W 6 330 ($10 in chips) 
Seat 3: Marauder777 ($10.45 in chips) 
Seat 4: 0TheMouse0 ($10 in chips) 
Seat 5: pensioner_x ($23.19 in chips) 
Seat 6: SRJ18 ($9.17 in chips) 
Manic Jay: posts small blind $0.05
B E M 4 W 6 330: posts big blind $0.10
*** HOLE CARDS ***
Marauder777: folds 
0TheMouse0: folds 
pensioner_x: folds 
SRJ18: folds 
Manic Jay: calls $0.05
B E M 4 W 6 330: raises $0.30 to $0.40
Manic Jay: calls $0.30
*** FLOP *** [8s 6h 4h]
Manic Jay: checks 
B E M 4 W 6 330: bets $0.50
Manic Jay: calls $0.50
*** TURN *** [8s 6h 4h] [Qc]
Manic Jay: checks 
B E M 4 W 6 330: bets $1.20
Manic Jay: calls $1.20
*** RIVER *** [8s 6h 4h Qc] [Qs]
Manic Jay: checks 
B E M 4 W 6 330: bets $2.20
Manic Jay: folds 
Uncalled bet ($2.20) returned to B E M 4 W 6 330
B E M 4 W 6 330 collected $4.01 from pot
B E M 4 W 6 330: doesn't show hand 
*** SUMMARY ***
Total pot $4.20 | Rake $0.19 
Board [8s 6h 4h Qc Qs]
Seat 1: Manic Jay (small blind) folded on the River
Seat 2: B E M 4 W 6 330 (big blind) collected ($4.01)
Seat 3: Marauder777 folded before Flop (didn't bet)
Seat 4: 0TheMouse0 folded before Flop (didn't bet)
Seat 5: pensioner_x folded before Flop (didn't bet)
Seat 6: SRJ18 (button) folded before Flop (didn't bet)



PokerStars Hand #222976386029:  Hold'em No Limit ($0.05/$0.10 USD) - 2021/01/23 17:54:35 ET
Table 'Dike III' 6-max Seat #1 is the button
Seat 1: Manic Jay ($6.37 in chips) 
Seat 2: B E M 4 W 6 330 ($11.91 in chips) 
Seat 3: Marauder777 ($10.45 in chips) 
Seat 4: 0TheMouse0 ($10 in chips) 
Seat 5: pensioner_x ($23.19 in chips) 
Seat 6: SRJ18 ($9.17 in chips) 
B E M 4 W 6 330: posts small blind $0.05
Marauder777: posts big blind $0.10
*** HOLE CARDS ***
0TheMouse0: folds 
pensioner_x: folds 
SRJ18: folds 
Manic Jay: calls $0.10
B E M 4 W 6 330: calls $0.05
Marauder777: checks 
*** FLOP *** [Kc 9d Ah]
B E M 4 W 6 330: checks 
Marauder777: checks 
Manic Jay: checks 
*** TURN *** [Kc 9d Ah] [Jd]
B E M 4 W 6 330: bets $0.20
Marauder777: folds 
Manic Jay: raises $0.40 to $0.60
B E M 4 W 6 330: folds 
Uncalled bet ($0.40) returned to Manic Jay
Manic Jay collected $0.67 from pot
*** SUMMARY ***
Total pot $0.70 | Rake $0.03 
Board [Kc 9d Ah Jd]
Seat 1: Manic Jay (button) collected ($0.67)
Seat 2: B E M 4 W 6 330 (small blind) folded on the Turn
Seat 3: Marauder777 (big blind) folded on the Turn
Seat 4: 0TheMouse0 folded before Flop (didn't bet)
Seat 5: pensioner_x folded before Flop (didn't bet)
Seat 6: SRJ18 folded before Flop (didn't bet)



PokerStars Hand #222976413758:  Hold'em No Limit ($0.05/$0.10 USD) - 2021/01/23 17:55:15 ET
Table 'Dike III' 6-max Seat #2 is the button
Seat 1: Manic Jay ($6.74 in chips) 
Seat 2: B E M 4 W 6 330 ($11.61 in chips) 
Seat 3: Marauder777 ($10.35 in chips) 
Seat 4: 0TheMouse0 ($10 in chips) 
Seat 5: pensioner_x ($23.19 in chips) 
Seat 6: SRJ18 ($9.17 in chips) 
Marauder777: posts small blind $0.05
0TheMouse0: posts big blind $0.10
*** HOLE CARDS ***
pensioner_x: folds 
SRJ18: folds 
Manic Jay: raises $0.20 to $0.30
B E M 4 W 6 330: folds 
Marauder777: folds 
0TheMouse0: folds 
Uncalled bet ($0.20) returned to Manic Jay
Manic Jay collected $0.25 from pot
*** SUMMARY ***
Total pot $0.25 | Rake $0 
Seat 1: Manic Jay collected ($0.25)
Seat 2: B E M 4 W 6 330 (button) folded before Flop (didn't bet)
Seat 3: Marauder777 (small blind) folded before Flop
Seat 4: 0TheMouse0 (big blind) folded before Flop
Seat 5: pensioner_x folded before Flop (didn't bet)
Seat 6: SRJ18 folded before Flop (didn't bet)



PokerStars Hand #222976420578:  Hold'em No Limit ($0.05/$0.10 USD) - 2021/01/23 17:55:28 ET
Table 'Dike III' 6-max Seat #3 is the button
Seat 1: Manic Jay ($6.89 in chips) 
Seat 2: B E M 4 W 6 330 ($11.61 in chips) 
Seat 3: Marauder777 ($10.30 in chips) 
Seat 4: 0TheMouse0 ($10 in chips) 
Seat 5: pensioner_x ($23.19 in chips) 
Seat 6: SRJ18 ($9.17 in chips) 
0TheMouse0: posts small blind $0.05
pensioner_x: posts big blind $0.10
*** HOLE CARDS ***
SRJ18: folds 
Manic Jay: calls $0.10
B E M 4 W 6 330: folds 
Marauder777: folds 
0TheMouse0: folds 
pensioner_x: checks 
*** FLOP *** [5d 9c 9d]
pensioner_x: checks 
Manic Jay: checks 
*** TURN *** [5d 9c 9d] [Jh]
pensioner_x: checks 
Manic Jay: checks 
*** RIVER *** [5d 9c 9d Jh] [As]
pensioner_x: bets $0.12
Manic Jay: folds 
Uncalled bet ($0.12) returned to pensioner_x
pensioner_x collected $0.24 from pot
pensioner_x: doesn't show hand 
*** SUMMARY ***
Total pot $0.25 | Rake $0.01 
Board [5d 9c 9d Jh As]
Seat 1: Manic Jay folded on the River
Seat 2: B E M 4 W 6 330 folded before Flop (didn't bet)
Seat 3: Marauder777 (button) folded before Flop (didn't bet)
Seat 4: 0TheMouse0 (small blind) folded before Flop
Seat 5: pensioner_x (big blind) collected ($0.24)
Seat 6: SRJ18 folded before Flop (didn't bet)



PokerStars Hand #222976430777:  Hold'em No Limit ($0.05/$0.10 USD) - 2021/01/23 17:55:47 ET
Table 'Dike III' 6-max Seat #4 is the button
Seat 1: Manic Jay ($6.79 in chips) 
Seat 2: B E M 4 W 6 330 ($11.61 in chips) 
Seat 3: Marauder777 ($10.30 in chips) 
Seat 4: 0TheMouse0 ($10 in chips) 
Seat 5: pensioner_x ($23.33 in chips) 
Seat 6: SRJ18 ($9.17 in chips) 
pensioner_x: posts small blind $0.05
SRJ18: posts big blind $0.10
*** HOLE CARDS ***
Manic Jay: folds 
B E M 4 W 6 330: folds 
Marauder777: folds 
0TheMouse0: folds 
pensioner_x: raises $0.20 to $0.30
SRJ18: calls $0.20
*** FLOP *** [9d 9s 8c]
pensioner_x: checks 
SRJ18: checks 
*** TURN *** [9d 9s 8c] [8h]
pensioner_x: checks 
SRJ18: checks 
*** RIVER *** [9d 9s 8c 8h] [6d]
pensioner_x: checks 
SRJ18: checks 
*** SHOW DOWN ***
pensioner_x: shows [7h Qd] (two pair, Nines and Eights)
SRJ18: shows [3h Ah] (two pair, Nines and Eights - Ace kicker)
SRJ18 collected $0.57 from pot
*** SUMMARY ***
Total pot $0.60 | Rake $0.03 
Board [9d 9s 8c 8h 6d]
Seat 1: Manic Jay folded before Flop (didn't bet)
Seat 2: B E M 4 W 6 330 folded before Flop (didn't bet)
Seat 3: Marauder777 folded before Flop (didn't bet)
Seat 4: 0TheMouse0 (button) folded before Flop (didn't bet)
Seat 5: pensioner_x (small blind) showed [7h Qd] and lost with two pair, Nines and Eights
Seat 6: SRJ18 (big blind) showed [3h Ah] and won ($0.57) with two pair, Nines and Eights



PokerStars Hand #222976446870:  Hold'em No Limit ($0.05/$0.10 USD) - 2021/01/23 17:56:18 ET
Table 'Dike III' 6-max Seat #5 is the button
Seat 1: Manic Jay ($6.79 in chips) 
Seat 2: B E M 4 W 6 330 ($11.61 in chips) 
Seat 3: Marauder777 ($10.30 in chips) 
Seat 4: 0TheMouse0 ($10 in chips) 
Seat 5: pensioner_x ($23.03 in chips) 
Seat 6: SRJ18 ($9.44 in chips) 
SRJ18: posts small blind $0.05
Manic Jay: posts big blind $0.10
*** HOLE CARDS ***
B E M 4 W 6 330: raises $0.20 to $0.30
Marauder777: folds 
0TheMouse0: folds 
pensioner_x: folds 
SRJ18: folds 
Manic Jay: calls $0.20
*** FLOP *** [4c Ah 9h]
Manic Jay: checks 
B E M 4 W 6 330: bets $0.40
Manic Jay: folds 
Uncalled bet ($0.40) returned to B E M 4 W 6 330
B E M 4 W 6 330 collected $0.62 from pot
B E M 4 W 6 330: doesn't show hand 
*** SUMMARY ***
Total pot $0.65 | Rake $0.03 
Board [4c Ah 9h]
Seat 1: Manic Jay (big blind) folded on the Flop
Seat 2: B E M 4 W 6 330 collected ($0.62)
Seat 3: Marauder777 folded before Flop (didn't bet)
Seat 4: 0TheMouse0 folded before Flop (didn't bet)
Seat 5: pensioner_x (button) folded before Flop (didn't bet)
Seat 6: SRJ18 (small blind) folded before Flop



PokerStars Hand #222976457954:  Hold'em No Limit ($0.05/$0.10 USD) - 2021/01/23 17:56:39 ET
Table 'Dike III' 6-max Seat #6 is the button
Seat 1: Manic Jay ($6.49 in chips) 
Seat 2: B E M 4 W 6 330 ($11.93 in chips) 
Seat 3: Marauder777 ($10.30 in chips) 
Seat 4: 0TheMouse0 ($10 in chips) 
Seat 5: pensioner_x ($23.03 in chips) 
Seat 6: SRJ18 ($9.39 in chips) 
Manic Jay: posts small blind $0.05
B E M 4 W 6 330: posts big blind $0.10
*** HOLE CARDS ***
Marauder777: folds 
0TheMouse0: folds 
pensioner_x: folds 
SRJ18: calls $0.10
Manic Jay: raises $0.20 to $0.30
B E M 4 W 6 330: calls $0.20
SRJ18: folds 
*** FLOP *** [7c 4c 4s]
Manic Jay: bets $0.30
B E M 4 W 6 330: raises $0.60 to $0.90
Manic Jay: calls $0.60
*** TURN *** [7c 4c 4s] [8s]
Manic Jay: checks 
B E M 4 W 6 330: bets $10.40
Manic Jay: folds 
Uncalled bet ($10.40) returned to B E M 4 W 6 330
B E M 4 W 6 330 collected $2.39 from pot
B E M 4 W 6 330: doesn't show hand 
*** SUMMARY ***
Total pot $2.50 | Rake $0.11 
Board [7c 4c 4s 8s]
Seat 1: Manic Jay (small blind) folded on the Turn
Seat 2: B E M 4 W 6 330 (big blind) collected ($2.39)
Seat 3: Marauder777 folded before Flop (didn't bet)
Seat 4: 0TheMouse0 folded before Flop (didn't bet)
Seat 5: pensioner_x folded before Flop (didn't bet)
Seat 6: SRJ18 (button) folded before Flop



PokerStars Hand #222976483239:  Hold'em No Limit ($0.05/$0.10 USD) - 2021/01/23 17:57:26 ET
Table 'Dike III' 6-max Seat #1 is the button
Seat 1: Manic Jay ($5.29 in chips) 
Seat 2: B E M 4 W 6 330 ($13.12 in chips) 
Seat 3: Marauder777 ($10.30 in chips) 
Seat 4: 0TheMouse0 ($10 in chips) 
Seat 5: pensioner_x ($23.03 in chips) 
Seat 6: SRJ18 ($9.29 in chips) 
B E M 4 W 6 330: posts small blind $0.05
Marauder777: posts big blind $0.10
*** HOLE CARDS ***
0TheMouse0: folds 
pensioner_x: folds 
SRJ18: folds 
Manic Jay: folds 
B E M 4 W 6 330: folds 
Uncalled bet ($0.05) returned to Marauder777
Marauder777 collected $0.10 from pot
Marauder777: doesn't show hand 
*** SUMMARY ***
Total pot $0.10 | Rake $0 
Seat 1: Manic Jay (button) folded before Flop (didn't bet)
Seat 2: B E M 4 W 6 330 (small blind) folded before Flop
Seat 3: Marauder777 (big blind) collected ($0.10)
Seat 4: 0TheMouse0 folded before Flop (didn't bet)
Seat 5: pensioner_x folded before Flop (didn't bet)
Seat 6: SRJ18 folded before Flop (didn't bet)



PokerStars Hand #222976488211:  Hold'em No Limit ($0.05/$0.10 USD) - 2021/01/23 17:57:36 ET
Table 'Dike III' 6-max Seat #2 is the button
Seat 1: Manic Jay ($5.29 in chips) 
Seat 2: B E M 4 W 6 330 ($13.07 in chips) 
Seat 3: Marauder777 ($10.35 in chips) 
Seat 4: 0TheMouse0 ($10 in chips) 
Seat 5: pensioner_x ($23.03 in chips) 
Seat 6: SRJ18 ($9.29 in chips) 
Marauder777: posts small blind $0.05
0TheMouse0: posts big blind $0.10
*** HOLE CARDS ***
pensioner_x: folds 
SRJ18 has timed out
SRJ18: folds 
Manic Jay: folds 
B E M 4 W 6 330: folds 
Marauder777: folds 
Uncalled bet ($0.05) returned to 0TheMouse0
0TheMouse0 collected $0.10 from pot
0TheMouse0: doesn't show hand 
*** SUMMARY ***
Total pot $0.10 | Rake $0 
Seat 1: Manic Jay folded before Flop (didn't bet)
Seat 2: B E M 4 W 6 330 (button) folded before Flop (didn't bet)
Seat 3: Marauder777 (small blind) folded before Flop
Seat 4: 0TheMouse0 (big blind) collected ($0.10)
Seat 5: pensioner_x folded before Flop (didn't bet)
Seat 6: SRJ18 folded before Flop (didn't bet)



PokerStars Hand #222976498065:  Hold'em No Limit ($0.05/$0.10 USD) - 2021/01/23 17:57:54 ET
Table 'Dike III' 6-max Seat #3 is the button
Seat 1: Manic Jay ($10 in chips) 
Seat 2: B E M 4 W 6 330 ($13.07 in chips) 
Seat 3: Marauder777 ($10.30 in chips) 
Seat 4: 0TheMouse0 ($10.05 in chips) 
Seat 5: pensioner_x ($23.03 in chips) 
0TheMouse0: posts small blind $0.05
pensioner_x: posts big blind $0.10
*** HOLE CARDS ***
Manic Jay: raises $0.20 to $0.30
B E M 4 W 6 330: calls $0.30
Marauder777: folds 
0TheMouse0: folds 
pensioner_x: calls $0.20
*** FLOP *** [Qc 2s 5d]
pensioner_x: checks 
Manic Jay: checks 
B E M 4 W 6 330: checks 
*** TURN *** [Qc 2s 5d] [Ac]
pensioner_x: checks 
Manic Jay: bets $0.46
B E M 4 W 6 330: folds 
pensioner_x: folds 
Uncalled bet ($0.46) returned to Manic Jay
Manic Jay collected $0.91 from pot
*** SUMMARY ***
Total pot $0.95 | Rake $0.04 
Board [Qc 2s 5d Ac]
Seat 1: Manic Jay collected ($0.91)
Seat 2: B E M 4 W 6 330 folded on the Turn
Seat 3: Marauder777 (button) folded before Flop (didn't bet)
Seat 4: 0TheMouse0 (small blind) folded before Flop
Seat 5: pensioner_x (big blind) folded on the Turn



PokerStars Hand #222976515743:  Hold'em No Limit ($0.05/$0.10 USD) - 2021/01/23 17:58:28 ET
Table 'Dike III' 6-max Seat #4 is the button
Seat 1: Manic Jay ($10.61 in chips) 
Seat 2: B E M 4 W 6 330 ($12.77 in chips) 
Seat 3: Marauder777 ($10.30 in chips) 
Seat 4: 0TheMouse0 ($10 in chips) 
Seat 5: pensioner_x ($22.73 in chips) 
Seat 6: SRJ18 ($9.29 in chips) 
pensioner_x: posts small blind $0.05
SRJ18: posts big blind $0.10
*** HOLE CARDS ***
Manic Jay: folds 
B E M 4 W 6 330: folds 
Marauder777: folds 
0TheMouse0: folds 
pensioner_x: raises $0.20 to $0.30
SRJ18: calls $0.20
*** FLOP *** [Ts 2c Ks]
pensioner_x: bets $0.29
SRJ18: calls $0.29
*** TURN *** [Ts 2c Ks] [5d]
pensioner_x: checks 
SRJ18: checks 
*** RIVER *** [Ts 2c Ks 5d] [Jh]
pensioner_x: checks 
SRJ18: bets $1
pensioner_x: folds 
Uncalled bet ($1) returned to SRJ18
SRJ18 collected $1.13 from pot
SRJ18: doesn't show hand 
*** SUMMARY ***
Total pot $1.18 | Rake $0.05 
Board [Ts 2c Ks 5d Jh]
Seat 1: Manic Jay folded before Flop (didn't bet)
Seat 2: B E M 4 W 6 330 folded before Flop (didn't bet)
Seat 3: Marauder777 folded before Flop (didn't bet)
Seat 4: 0TheMouse0 (button) folded before Flop (didn't bet)
Seat 5: pensioner_x (small blind) folded on the River
Seat 6: SRJ18 (big blind) collected ($1.13)



PokerStars Hand #222976536157:  Hold'em No Limit ($0.05/$0.10 USD) - 2021/01/23 17:59:06 ET
Table 'Dike III' 6-max Seat #5 is the button
Seat 1: Manic Jay ($10.61 in chips) 
Seat 2: B E M 4 W 6 330 ($12.77 in chips) 
Seat 3: Marauder777 ($10.30 in chips) 
Seat 4: 0TheMouse0 ($10 in chips) 
Seat 5: pensioner_x ($22.14 in chips) 
Seat 6: SRJ18 ($9.83 in chips) 
SRJ18: posts small blind $0.05
Manic Jay: posts big blind $0.10
*** HOLE CARDS ***
B E M 4 W 6 330: raises $0.20 to $0.30
Marauder777: calls $0.30
0TheMouse0: folds 
pensioner_x: folds 
SRJ18: folds 
Manic Jay: calls $0.20
*** FLOP *** [Js 5h 8h]
Manic Jay: checks 
B E M 4 W 6 330: bets $0.50
Marauder777: calls $0.50
Manic Jay: folds 
*** TURN *** [Js 5h 8h] [As]
B E M 4 W 6 330: checks 
Marauder777: checks 
*** RIVER *** [Js 5h 8h As] [7s]
B E M 4 W 6 330: checks 
Marauder777: bets $1.19
B E M 4 W 6 330: calls $1.19
*** SHOW DOWN ***
Marauder777: shows [Kh Ah] (a pair of Aces)
B E M 4 W 6 330: mucks hand 
Marauder777 collected $4.14 from pot
*** SUMMARY ***
Total pot $4.33 | Rake $0.19 
Board [Js 5h 8h As 7s]
Seat 1: Manic Jay (big blind) folded on the Flop
Seat 2: B E M 4 W 6 330 mucked
Seat 3: Marauder777 showed [Kh Ah] and won ($4.14) with a pair of Aces
Seat 4: 0TheMouse0 folded before Flop (didn't bet)
Seat 5: pensioner_x (button) folded before Flop (didn't bet)
Seat 6: SRJ18 (small blind) folded before Flop



PokerStars Hand #222976567675:  Hold'em No Limit ($0.05/$0.10 USD) - 2021/01/23 17:59:56 ET
Table 'Dike III' 6-max Seat #6 is the button
Seat 1: Manic Jay ($10.31 in chips) 
Seat 2: B E M 4 W 6 330 ($10.78 in chips) 
Seat 3: Marauder777 ($12.45 in chips) 
Seat 4: 0TheMouse0 ($10 in chips) 
Seat 5: pensioner_x ($22.14 in chips) 
Seat 6: SRJ18 ($9.78 in chips) 
Manic Jay: posts small blind $0.05
B E M 4 W 6 330: posts big blind $0.10
*** HOLE CARDS ***
Marauder777: raises $0.12 to $0.22
0TheMouse0: folds 
pensioner_x: folds 
SRJ18: folds 
Manic Jay: calls $0.17
B E M 4 W 6 330: calls $0.12
*** FLOP *** [4c Kd Ts]
Manic Jay: bets $0.63
B E M 4 W 6 330: folds 
Marauder777: calls $0.63
*** TURN *** [4c Kd Ts] [7s]
Manic Jay: checks 
Marauder777: bets $1.17
Manic Jay: calls $1.17
*** RIVER *** [4c Kd Ts 7s] [6s]
Manic Jay: checks 
Marauder777: bets $1.95
Manic Jay: calls $1.95
*** SHOW DOWN ***
Marauder777: shows [As Ac] (a pair of Aces)
Manic Jay: mucks hand 
Marauder777 collected $7.79 from pot
*** SUMMARY ***
Total pot $8.16 | Rake $0.37 
Board [4c Kd Ts 7s 6s]
Seat 1: Manic Jay (small blind) mucked
Seat 2: B E M 4 W 6 330 (big blind) folded on the Flop
Seat 3: Marauder777 showed [As Ac] and won ($7.79) with a pair of Aces
Seat 4: 0TheMouse0 folded before Flop (didn't bet)
Seat 5: pensioner_x folded before Flop (didn't bet)
Seat 6: SRJ18 (button) folded before Flop (didn't bet)



PokerStars Hand #222976597933:  Hold'em No Limit ($0.05/$0.10 USD) - 2021/01/23 18:00:48 ET
Table 'Dike III' 6-max Seat #1 is the button
Seat 1: Manic Jay ($6.34 in chips) 
Seat 2: B E M 4 W 6 330 ($10.56 in chips) 
Seat 3: Marauder777 ($16.27 in chips) 
Seat 4: 0TheMouse0 ($10 in chips) 
Seat 5: pensioner_x ($22.14 in chips) 
Seat 6: SRJ18 ($9.78 in chips) 
B E M 4 W 6 330: posts small blind $0.05
Marauder777: posts big blind $0.10
*** HOLE CARDS ***
0TheMouse0: folds 
pensioner_x: folds 
SRJ18: calls $0.10
Manic Jay: calls $0.10
B E M 4 W 6 330: raises $0.30 to $0.40
Marauder777: folds 
SRJ18: calls $0.30
Manic Jay: calls $0.30
*** FLOP *** [8h 9d Jh]
B E M 4 W 6 330: bets $0.70
SRJ18: folds 
Manic Jay: calls $0.70
*** TURN *** [8h 9d Jh] [9h]
B E M 4 W 6 330: checks 
Manic Jay: bets $1.29
B E M 4 W 6 330: calls $1.29
*** RIVER *** [8h 9d Jh 9h] [3c]
B E M 4 W 6 330: checks 
Manic Jay: bets $2.52
B E M 4 W 6 330: folds 
Uncalled bet ($2.52) returned to Manic Jay
Manic Jay collected $5.04 from pot
*** SUMMARY ***
Total pot $5.28 | Rake $0.24 
Board [8h 9d Jh 9h 3c]
Seat 1: Manic Jay (button) collected ($5.04)
Seat 2: B E M 4 W 6 330 (small blind) folded on the River
Seat 3: Marauder777 (big blind) folded before Flop
Seat 4: 0TheMouse0 folded before Flop (didn't bet)
Seat 5: pensioner_x folded before Flop (didn't bet)
Seat 6: SRJ18 folded on the Flop



PokerStars Hand #222976641522:  Hold'em No Limit ($0.05/$0.10 USD) - 2021/01/23 18:01:55 ET
Table 'Dike III' 6-max Seat #2 is the button
Seat 1: Manic Jay ($8.99 in chips) 
Seat 2: B E M 4 W 6 330 ($10 in chips) 
Seat 3: Marauder777 ($16.17 in chips) 
Seat 4: 0TheMouse0 ($10 in chips) 
Seat 5: pensioner_x ($22.14 in chips) 
Seat 6: SRJ18 ($9.38 in chips) 
Marauder777: posts small blind $0.05
0TheMouse0: posts big blind $0.10
*** HOLE CARDS ***
pensioner_x: folds 
SRJ18: raises $0.30 to $0.40
Manic Jay: calls $0.40
B E M 4 W 6 330: raises $0.90 to $1.30
Marauder777: folds 
0TheMouse0: folds 
SRJ18: calls $0.90
Manic Jay: folds 
*** FLOP *** [7d Qs 4s]
SRJ18: bets $1.70
B E M 4 W 6 330: calls $1.70
*** TURN *** [7d Qs 4s] [Ts]
SRJ18: bets $6.38 and is all-in
B E M 4 W 6 330: calls $6.38
*** RIVER *** [7d Qs 4s Ts] [6h]
*** SHOW DOWN ***
SRJ18: shows [Qh Ac] (a pair of Queens)
B E M 4 W 6 330: shows [As Kh] (high card Ace)
SRJ18 collected $18.44 from pot
*** SUMMARY ***
Total pot $19.31 | Rake $0.87 
Board [7d Qs 4s Ts 6h]
Seat 1: Manic Jay folded before Flop
Seat 2: B E M 4 W 6 330 (button) showed [As Kh] and lost with high card Ace
Seat 3: Marauder777 (small blind) folded before Flop
Seat 4: 0TheMouse0 (big blind) folded before Flop
Seat 5: pensioner_x folded before Flop (didn't bet)
Seat 6: SRJ18 showed [Qh Ac] and won ($18.44) with a pair of Queens



PokerStars Hand #222976681805:  Hold'em No Limit ($0.05/$0.10 USD) - 2021/01/23 18:02:55 ET
Table 'Dike III' 6-max Seat #3 is the button
Seat 1: Manic Jay ($8.59 in chips) 
Seat 2: B E M 4 W 6 330 ($10 in chips) 
Seat 3: Marauder777 ($16.12 in chips) 
Seat 4: 0TheMouse0 ($10 in chips) 
Seat 5: pensioner_x ($22.14 in chips) 
Seat 6: SRJ18 ($18.44 in chips) 
0TheMouse0: posts small blind $0.05
pensioner_x: posts big blind $0.10
*** HOLE CARDS ***
SRJ18: folds 
Manic Jay: calls $0.10
B E M 4 W 6 330: folds 
Marauder777: raises $0.25 to $0.35
0TheMouse0: folds 
pensioner_x: folds 
Manic Jay: calls $0.25
*** FLOP *** [6s Qs 6h]
Manic Jay: checks 
Marauder777: bets $0.28
Manic Jay: folds 
Uncalled bet ($0.28) returned to Marauder777
Marauder777 collected $0.81 from pot
Marauder777: doesn't show hand 
*** SUMMARY ***
Total pot $0.85 | Rake $0.04 
Board [6s Qs 6h]
Seat 1: Manic Jay folded on the Flop
Seat 2: B E M 4 W 6 330 folded before Flop (didn't bet)
Seat 3: Marauder777 (button) collected ($0.81)
Seat 4: 0TheMouse0 (small blind) folded before Flop
Seat 5: pensioner_x (big blind) folded before Flop
Seat 6: SRJ18 folded before Flop (didn't bet)



PokerStars Hand #222976696078:  Hold'em No Limit ($0.05/$0.10 USD) - 2021/01/23 18:03:14 ET
Table 'Dike III' 6-max Seat #4 is the button
Seat 1: Manic Jay ($8.24 in chips) 
Seat 2: B E M 4 W 6 330 ($10 in chips) 
Seat 3: Marauder777 ($16.58 in chips) 
Seat 4: 0TheMouse0 ($10 in chips) 
Seat 5: pensioner_x ($22.04 in chips) 
Seat 6: SRJ18 ($18.44 in chips) 
pensioner_x: posts small blind $0.05
SRJ18: posts big blind $0.10
*** HOLE CARDS ***
Manic Jay: folds 
B E M 4 W 6 330: raises $0.20 to $0.30
Manic Jay leaves the table
Marauder777: folds 
maltsevig joins the table at seat #1 
0TheMouse0: folds 
pensioner_x: folds 
SRJ18: calls $0.20
*** FLOP *** [Jc Td Kd]
SRJ18: checks 
B E M 4 W 6 330: bets $0.30
SRJ18: folds 
Uncalled bet ($0.30) returned to B E M 4 W 6 330
B E M 4 W 6 330 collected $0.62 from pot
B E M 4 W 6 330: doesn't show hand 
*** SUMMARY ***
Total pot $0.65 | Rake $0.03 
Board [Jc Td Kd]
Seat 1: Manic Jay folded before Flop (didn't bet)
Seat 2: B E M 4 W 6 330 collected ($0.62)
Seat 3: Marauder777 folded before Flop (didn't bet)
Seat 4: 0TheMouse0 (button) folded before Flop (didn't bet)
Seat 5: pensioner_x (small blind) folded before Flop
Seat 6: SRJ18 (big blind) folded on the Flop



PokerStars Hand #222976713999:  Hold'em No Limit ($0.05/$0.10 USD) - 2021/01/23 18:03:40 ET
Table 'Dike III' 6-max Seat #5 is the button
Seat 1: maltsevig ($10 in chips) 
Seat 2: B E M 4 W 6 330 ($10.32 in chips) 
Seat 3: Marauder777 ($16.58 in chips) 
Seat 4: 0TheMouse0 ($10 in chips) 
Seat 5: pensioner_x ($21.99 in chips) 
Seat 6: SRJ18 ($18.14 in chips) 
SRJ18: posts small blind $0.05
maltsevig: posts big blind $0.10
*** HOLE CARDS ***
B E M 4 W 6 330: raises $0.20 to $0.30
Marauder777: folds 
0TheMouse0: folds 
pensioner_x: folds 
SRJ18: folds 
maltsevig: folds 
Uncalled bet ($0.20) returned to B E M 4 W 6 330
B E M 4 W 6 330 collected $0.25 from pot
B E M 4 W 6 330: doesn't show hand 
*** SUMMARY ***
Total pot $0.25 | Rake $0 
Seat 1: maltsevig (big blind) folded before Flop
Seat 2: B E M 4 W 6 330 collected ($0.25)
Seat 3: Marauder777 folded before Flop (didn't bet)
Seat 4: 0TheMouse0 folded before Flop (didn't bet)
Seat 5: pensioner_x (button) folded before Flop (didn't bet)
Seat 6: SRJ18 (small blind) folded before Flop



PokerStars Hand #222976722870:  Hold'em No Limit ($0.05/$0.10 USD) - 2021/01/23 18:03:52 ET
Table 'Dike III' 6-max Seat #6 is the button
Seat 1: maltsevig ($10 in chips) 
Seat 2: B E M 4 W 6 330 ($10.47 in chips) 
Seat 3: Marauder777 ($16.58 in chips) 
Seat 4: 0TheMouse0 ($10 in chips) 
Seat 5: pensioner_x ($21.99 in chips) 
Seat 6: SRJ18 ($18.09 in chips) 
maltsevig: posts small blind $0.05
B E M 4 W 6 330: posts big blind $0.10
*** HOLE CARDS ***
Marauder777: raises $0.12 to $0.22
0TheMouse0: folds 
pensioner_x: calls $0.22
SRJ18: folds 
maltsevig: folds 
B E M 4 W 6 330: folds 
*** FLOP *** [3d 4h 7c]
Marauder777: bets $0.36
pensioner_x: raises $0.54 to $0.90
Marauder777: calls $0.54
*** TURN *** [3d 4h 7c] [8s]
Marauder777: checks 
pensioner_x: checks 
*** RIVER *** [3d 4h 7c 8s] [Qs]
Marauder777: checks 
pensioner_x: checks 
*** SHOW DOWN ***
Marauder777: shows [7d 6d] (a pair of Sevens)
pensioner_x: mucks hand 
Marauder777 collected $2.28 from pot
*** SUMMARY ***
Total pot $2.39 | Rake $0.11 
Board [3d 4h 7c 8s Qs]
Seat 1: maltsevig (small blind) folded before Flop
Seat 2: B E M 4 W 6 330 (big blind) folded before Flop
Seat 3: Marauder777 showed [7d 6d] and won ($2.28) with a pair of Sevens
Seat 4: 0TheMouse0 folded before Flop (didn't bet)
Seat 5: pensioner_x mucked
Seat 6: SRJ18 (button) folded before Flop (didn't bet)



PokerStars Hand #222976764205:  Hold'em No Limit ($0.05/$0.10 USD) - 2021/01/23 18:04:50 ET
Table 'Dike III' 6-max Seat #1 is the button
Seat 1: maltsevig ($10 in chips) 
Seat 2: B E M 4 W 6 330 ($10.37 in chips) 
Seat 4: 0TheMouse0 ($10 in chips) 
Seat 5: pensioner_x ($20.87 in chips) 
Seat 6: SRJ18 ($18.09 in chips) 
B E M 4 W 6 330: posts small blind $0.05
Marauder777: is sitting out 
0TheMouse0: posts big blind $0.10
*** HOLE CARDS ***
pensioner_x: folds 
SRJ18: raises $0.20 to $0.30
maltsevig: calls $0.30
B E M 4 W 6 330: folds 
0TheMouse0: folds 
*** FLOP *** [Ac 4d 2d]
SRJ18: bets $0.40
maltsevig: calls $0.40
*** TURN *** [Ac 4d 2d] [Th]
SRJ18: checks 
maltsevig: bets $0.96
SRJ18: calls $0.96
*** RIVER *** [Ac 4d 2d Th] [4c]
SRJ18: checks 
maltsevig: bets $2.15
SRJ18: folds 
Uncalled bet ($2.15) returned to maltsevig
maltsevig collected $3.31 from pot
maltsevig: doesn't show hand 
*** SUMMARY ***
Total pot $3.47 | Rake $0.16 
Board [Ac 4d 2d Th 4c]
Seat 1: maltsevig (button) collected ($3.31)
Seat 2: B E M 4 W 6 330 (small blind) folded before Flop
Seat 4: 0TheMouse0 (big blind) folded before Flop
Seat 5: pensioner_x folded before Flop (didn't bet)
Seat 6: SRJ18 folded on the River



PokerStars Hand #222976793527:  Hold'em No Limit ($0.05/$0.10 USD) - 2021/01/23 18:05:30 ET
Table 'Dike III' 6-max Seat #2 is the button
Seat 1: maltsevig ($11.65 in chips) 
Seat 2: B E M 4 W 6 330 ($10.32 in chips) 
Seat 4: 0TheMouse0 ($10 in chips) 
Seat 6: SRJ18 ($16.43 in chips) 
0TheMouse0: posts small blind $0.05
pensioner_x: is sitting out 
SRJ18: posts big blind $0.10
*** HOLE CARDS ***
maltsevig: folds 
B E M 4 W 6 330: folds 
0TheMouse0: folds 
Uncalled bet ($0.05) returned to SRJ18
SRJ18 collected $0.10 from pot
SRJ18: doesn't show hand 
*** SUMMARY ***
Total pot $0.10 | Rake $0 
Seat 1: maltsevig folded before Flop (didn't bet)
Seat 2: B E M 4 W 6 330 (button) folded before Flop (didn't bet)
Seat 4: 0TheMouse0 (small blind) folded before Flop
Seat 6: SRJ18 (big blind) collected ($0.10)



PokerStars Hand #222976797918:  Hold'em No Limit ($0.05/$0.10 USD) - 2021/01/23 18:05:37 ET
Table 'Dike III' 6-max Seat #4 is the button
Seat 1: maltsevig ($11.65 in chips) 
Seat 2: B E M 4 W 6 330 ($10.32 in chips) 
Seat 4: 0TheMouse0 ($10 in chips) 
Seat 6: SRJ18 ($16.48 in chips) 
SRJ18: posts small blind $0.05
maltsevig: posts big blind $0.10
*** HOLE CARDS ***
B E M 4 W 6 330: folds 
0TheMouse0: raises $0.15 to $0.25
SRJ18: calls $0.20
maltsevig: folds 
*** FLOP *** [Th 6d 6c]
pensioner_x leaves the table
SRJ18: checks 
0TheMouse0: bets $0.19
SRJ18: calls $0.19
*** TURN *** [Th 6d 6c] [Kd]
EYEWONTSTOP joins the table at seat #5 
SRJ18: checks 
0TheMouse0: bets $0.70
SRJ18: calls $0.70
*** RIVER *** [Th 6d 6c Kd] [7s]
SRJ18: bets $1.20
0TheMouse0: folds 
Uncalled bet ($1.20) returned to SRJ18
SRJ18 collected $2.27 from pot
SRJ18: doesn't show hand 
*** SUMMARY ***
Total pot $2.38 | Rake $0.11 
Board [Th 6d 6c Kd 7s]
Seat 1: maltsevig (big blind) folded before Flop
Seat 2: B E M 4 W 6 330 folded before Flop (didn't bet)
Seat 4: 0TheMouse0 (button) folded on the River
Seat 6: SRJ18 (small blind) collected ($2.27)



PokerStars Hand #222976823785:  Hold'em No Limit ($0.05/$0.10 USD) - 2021/01/23 18:06:14 ET
Table 'Dike III' 6-max Seat #6 is the button
Seat 1: maltsevig ($11.55 in chips) 
Seat 2: B E M 4 W 6 330 ($10.32 in chips) 
Seat 4: 0TheMouse0 ($10 in chips) 
Seat 6: SRJ18 ($17.61 in chips) 
maltsevig: posts small blind $0.05
B E M 4 W 6 330: posts big blind $0.10
EYEWONTSTOP: sits out 
*** HOLE CARDS ***
0TheMouse0: raises $0.15 to $0.25
SRJ18: calls $0.25
maltsevig: folds 
B E M 4 W 6 330: calls $0.15
*** FLOP *** [Th Qh 5s]
B E M 4 W 6 330: checks 
0TheMouse0: bets $0.55
SRJ18: calls $0.55
B E M 4 W 6 330: folds 
*** TURN *** [Th Qh 5s] [8h]
0TheMouse0: checks 
SRJ18: checks 
*** RIVER *** [Th Qh 5s 8h] [Jc]
0TheMouse0: checks 
SRJ18: checks 
*** SHOW DOWN ***
0TheMouse0: shows [Qd As] (a pair of Queens)
SRJ18: mucks hand 
Marauder777 leaves the table
0TheMouse0 collected $1.81 from pot
*** SUMMARY ***
Total pot $1.90 | Rake $0.09 
Board [Th Qh 5s 8h Jc]
Seat 1: maltsevig (small blind) folded before Flop
Seat 2: B E M 4 W 6 330 (big blind) folded on the Flop
Seat 4: 0TheMouse0 showed [Qd As] and won ($1.81) with a pair of Queens
Seat 6: SRJ18 (button) mucked



PokerStars Hand #222976845007:  Hold'em No Limit ($0.05/$0.10 USD) - 2021/01/23 18:06:45 ET
Table 'Dike III' 6-max Seat #1 is the button
Seat 1: maltsevig ($11.50 in chips) 
Seat 2: B E M 4 W 6 330 ($10.07 in chips) 
Seat 4: 0TheMouse0 ($11.01 in chips) 
Seat 6: SRJ18 ($16.81 in chips) 
B E M 4 W 6 330: posts small blind $0.05
0TheMouse0: posts big blind $0.10
EYEWONTSTOP: sits out 
*** HOLE CARDS ***
SRJ18: raises $0.30 to $0.40
maltsevig: folds 
B E M 4 W 6 330: folds 
0TheMouse0: folds 
Uncalled bet ($0.30) returned to SRJ18
SRJ18 collected $0.25 from pot
SRJ18: doesn't show hand 
*** SUMMARY ***
Total pot $0.25 | Rake $0 
Seat 1: maltsevig (button) folded before Flop (didn't bet)
Seat 2: B E M 4 W 6 330 (small blind) folded before Flop
Seat 4: 0TheMouse0 (big blind) folded before Flop
Seat 6: SRJ18 collected ($0.25)



PokerStars Hand #222976856880:  Hold'em No Limit ($0.05/$0.10 USD) - 2021/01/23 18:07:01 ET
Table 'Dike III' 6-max Seat #2 is the button
Seat 1: maltsevig ($11.50 in chips) 
Seat 2: B E M 4 W 6 330 ($10.02 in chips) 
Seat 4: 0TheMouse0 ($10.91 in chips) 
Seat 5: EYEWONTSTOP ($10 in chips) 
Seat 6: SRJ18 ($16.96 in chips) 
0TheMouse0: posts small blind $0.05
EYEWONTSTOP: posts big blind $0.10
*** HOLE CARDS ***
SRJ18: folds 
maltsevig: folds 
B E M 4 W 6 330: folds 
0TheMouse0: raises $0.20 to $0.30
EYEWONTSTOP: folds 
Uncalled bet ($0.20) returned to 0TheMouse0
0TheMouse0 collected $0.20 from pot
0TheMouse0: doesn't show hand 
*** SUMMARY ***
Total pot $0.20 | Rake $0 
Seat 1: maltsevig folded before Flop (didn't bet)
Seat 2: B E M 4 W 6 330 (button) folded before Flop (didn't bet)
Seat 4: 0TheMouse0 (small blind) collected ($0.20)
Seat 5: EYEWONTSTOP (big blind) folded before Flop
Seat 6: SRJ18 folded before Flop (didn't bet)



PokerStars Hand #222976872738:  Hold'em No Limit ($0.05/$0.10 USD) - 2021/01/23 18:07:24 ET
Table 'Dike III' 6-max Seat #4 is the button
Seat 1: maltsevig ($11.50 in chips) 
Seat 2: B E M 4 W 6 330 ($10.02 in chips) 
Seat 4: 0TheMouse0 ($11.01 in chips) 
Seat 5: EYEWONTSTOP ($9.90 in chips) 
Seat 6: SRJ18 ($16.96 in chips) 
EYEWONTSTOP: posts small blind $0.05
SRJ18: posts big blind $0.10
*** HOLE CARDS ***
scofo83 joins the table at seat #3 
maltsevig: raises $0.20 to $0.30
B E M 4 W 6 330: calls $0.30
0TheMouse0: folds 
EYEWONTSTOP: folds 
SRJ18: folds 
*** FLOP *** [6d 3h 7d]
maltsevig: bets $0.47
B E M 4 W 6 330: calls $0.47
*** TURN *** [6d 3h 7d] [7h]
maltsevig: checks 
B E M 4 W 6 330: checks 
*** RIVER *** [6d 3h 7d 7h] [5d]
maltsevig: bets $1.05
B E M 4 W 6 330: folds 
Uncalled bet ($1.05) returned to maltsevig
maltsevig collected $1.61 from pot
maltsevig: doesn't show hand 
*** SUMMARY ***
Total pot $1.69 | Rake $0.08 
Board [6d 3h 7d 7h 5d]
Seat 1: maltsevig collected ($1.61)
Seat 2: B E M 4 W 6 330 folded on the River
Seat 4: 0TheMouse0 (button) folded before Flop (didn't bet)
Seat 5: EYEWONTSTOP (small blind) folded before Flop
Seat 6: SRJ18 (big blind) folded before Flop



PokerStars Hand #222976903555:  Hold'em No Limit ($0.05/$0.10 USD) - 2021/01/23 18:08:08 ET
Table 'Dike III' 6-max Seat #5 is the button
Seat 1: maltsevig ($12.34 in chips) 
Seat 2: B E M 4 W 6 330 ($10 in chips) 
Seat 4: 0TheMouse0 ($11.01 in chips) 
Seat 5: EYEWONTSTOP ($9.85 in chips) 
Seat 6: SRJ18 ($16.86 in chips) 
SRJ18: posts small blind $0.05
maltsevig: posts big blind $0.10
scofo83: sits out 
*** HOLE CARDS ***
B E M 4 W 6 330: raises $0.20 to $0.30
0TheMouse0: folds 
EYEWONTSTOP: folds 
SRJ18: folds 
maltsevig: folds 
Uncalled bet ($0.20) returned to B E M 4 W 6 330
B E M 4 W 6 330 collected $0.25 from pot
B E M 4 W 6 330: doesn't show hand 
*** SUMMARY ***
Total pot $0.25 | Rake $0 
Seat 1: maltsevig (big blind) folded before Flop
Seat 2: B E M 4 W 6 330 collected ($0.25)
Seat 4: 0TheMouse0 folded before Flop (didn't bet)
Seat 5: EYEWONTSTOP (button) folded before Flop (didn't bet)
Seat 6: SRJ18 (small blind) folded before Flop



PokerStars Hand #222976912435:  Hold'em No Limit ($0.05/$0.10 USD) - 2021/01/23 18:08:21 ET
Table 'Dike III' 6-max Seat #6 is the button
Seat 1: maltsevig ($12.24 in chips) 
Seat 2: B E M 4 W 6 330 ($10.15 in chips) 
Seat 4: 0TheMouse0 ($11.01 in chips) 
Seat 5: EYEWONTSTOP ($9.85 in chips) 
Seat 6: SRJ18 ($16.81 in chips) 
maltsevig: posts small blind $0.05
B E M 4 W 6 330: posts big blind $0.10
scofo83: sits out 
*** HOLE CARDS ***
0TheMouse0: raises $0.15 to $0.25
EYEWONTSTOP: folds 
SRJ18: calls $0.25
maltsevig: folds 
B E M 4 W 6 330: folds 
*** FLOP *** [Td Kc 8d]
0TheMouse0: bets $0.45
SRJ18: calls $0.45
*** TURN *** [Td Kc 8d] [As]
0TheMouse0: bets $1.10
SRJ18: raises $2 to $3.10
0TheMouse0: folds 
Uncalled bet ($2) returned to SRJ18
SRJ18 collected $3.58 from pot
SRJ18: doesn't show hand 
*** SUMMARY ***
Total pot $3.75 | Rake $0.17 
Board [Td Kc 8d As]
Seat 1: maltsevig (small blind) folded before Flop
Seat 2: B E M 4 W 6 330 (big blind) folded before Flop
Seat 4: 0TheMouse0 folded on the Turn
Seat 5: EYEWONTSTOP folded before Flop (didn't bet)
Seat 6: SRJ18 (button) collected ($3.58)



PokerStars Hand #222976939261:  Hold'em No Limit ($0.05/$0.10 USD) - 2021/01/23 18:08:59 ET
Table 'Dike III' 6-max Seat #1 is the button
Seat 1: maltsevig ($12.19 in chips) 
Seat 2: B E M 4 W 6 330 ($10.05 in chips) 
Seat 3: scofo83 ($10 in chips) 
Seat 4: 0TheMouse0 ($10 in chips) 
Seat 5: EYEWONTSTOP ($9.85 in chips) 
Seat 6: SRJ18 ($18.59 in chips) 
B E M 4 W 6 330: posts small blind $0.05
scofo83: posts big blind $0.10
*** HOLE CARDS ***
0TheMouse0: folds 
EYEWONTSTOP: folds 
SRJ18: folds 
maltsevig: raises $0.10 to $0.20
B E M 4 W 6 330: folds 
scofo83: folds 
Uncalled bet ($0.10) returned to maltsevig
maltsevig collected $0.25 from pot
maltsevig: doesn't show hand 
*** SUMMARY ***
Total pot $0.25 | Rake $0 
Seat 1: maltsevig (button) collected ($0.25)
Seat 2: B E M 4 W 6 330 (small blind) folded before Flop
Seat 3: scofo83 (big blind) folded before Flop
Seat 4: 0TheMouse0 folded before Flop (didn't bet)
Seat 5: EYEWONTSTOP folded before Flop (didn't bet)
Seat 6: SRJ18 folded before Flop (didn't bet)



PokerStars Hand #222976947787:  Hold'em No Limit ($0.05/$0.10 USD) - 2021/01/23 18:09:12 ET
Table 'Dike III' 6-max Seat #2 is the button
Seat 1: maltsevig ($12.34 in chips) 
Seat 2: B E M 4 W 6 330 ($10 in chips) 
Seat 3: scofo83 ($10 in chips) 
Seat 4: 0TheMouse0 ($10 in chips) 
Seat 5: EYEWONTSTOP ($9.85 in chips) 
Seat 6: SRJ18 ($18.59 in chips) 
scofo83: posts small blind $0.05
0TheMouse0: posts big blind $0.10
*** HOLE CARDS ***
EYEWONTSTOP: folds 
SRJ18: folds 
maltsevig: raises $0.16 to $0.26
B E M 4 W 6 330: folds 
scofo83: folds 
0TheMouse0: folds 
Uncalled bet ($0.16) returned to maltsevig
maltsevig collected $0.25 from pot
maltsevig: doesn't show hand 
*** SUMMARY ***
Total pot $0.25 | Rake $0 
Seat 1: maltsevig collected ($0.25)
Seat 2: B E M 4 W 6 330 (button) folded before Flop (didn't bet)
Seat 3: scofo83 (small blind) folded before Flop
Seat 4: 0TheMouse0 (big blind) folded before Flop
Seat 5: EYEWONTSTOP folded before Flop (didn't bet)
Seat 6: SRJ18 folded before Flop (didn't bet)



PokerStars Hand #222976970198:  Hold'em No Limit ($0.05/$0.10 USD) - 2021/01/23 18:09:35 ET
Table 'Dike III' 6-max Seat #3 is the button
Seat 1: maltsevig ($12.49 in chips) 
Seat 2: B E M 4 W 6 330 ($10 in chips) 
Seat 3: scofo83 ($10 in chips) 
Seat 4: 0TheMouse0 ($10 in chips) 
Seat 5: EYEWONTSTOP ($9.85 in chips) 
Seat 6: SRJ18 ($18.59 in chips) 
0TheMouse0: posts small blind $0.05
EYEWONTSTOP: posts big blind $0.10
*** HOLE CARDS ***
SRJ18: folds 
maltsevig: raises $0.20 to $0.30
B E M 4 W 6 330: folds 
scofo83: folds 
0TheMouse0: folds 
EYEWONTSTOP: folds 
Uncalled bet ($0.20) returned to maltsevig
maltsevig collected $0.25 from pot
maltsevig: doesn't show hand 
*** SUMMARY ***
Total pot $0.25 | Rake $0 
Seat 1: maltsevig collected ($0.25)
Seat 2: B E M 4 W 6 330 folded before Flop (didn't bet)
Seat 3: scofo83 (button) folded before Flop (didn't bet)
Seat 4: 0TheMouse0 (small blind) folded before Flop
Seat 5: EYEWONTSTOP (big blind) folded before Flop
Seat 6: SRJ18 folded before Flop (didn't bet)



PokerStars Hand #222976978639:  Hold'em No Limit ($0.05/$0.10 USD) - 2021/01/23 18:09:48 ET
Table 'Dike III' 6-max Seat #4 is the button
Seat 1: maltsevig ($12.64 in chips) 
Seat 2: B E M 4 W 6 330 ($10 in chips) 
Seat 3: scofo83 ($10 in chips) 
Seat 4: 0TheMouse0 ($10 in chips) 
Seat 5: EYEWONTSTOP ($9.75 in chips) 
Seat 6: SRJ18 ($18.59 in chips) 
EYEWONTSTOP: posts small blind $0.05
SRJ18: posts big blind $0.10
*** HOLE CARDS ***
maltsevig: raises $0.20 to $0.30
B E M 4 W 6 330: calls $0.30
scofo83: folds 
0TheMouse0: folds 
EYEWONTSTOP: folds 
SRJ18: raises $0.80 to $1.10
maltsevig: folds 
B E M 4 W 6 330: calls $0.80
*** FLOP *** [Qc 8d Ts]
SRJ18: bets $1.70
B E M 4 W 6 330: folds 
Uncalled bet ($1.70) returned to SRJ18
SRJ18 collected $2.44 from pot
SRJ18: doesn't show hand 
*** SUMMARY ***
Total pot $2.55 | Rake $0.11 
Board [Qc 8d Ts]
Seat 1: maltsevig folded before Flop
Seat 2: B E M 4 W 6 330 folded on the Flop
Seat 3: scofo83 folded before Flop (didn't bet)
Seat 4: 0TheMouse0 (button) folded before Flop (didn't bet)
Seat 5: EYEWONTSTOP (small blind) folded before Flop
Seat 6: SRJ18 (big blind) collected ($2.44)



PokerStars Hand #222977016065:  Hold'em No Limit ($0.05/$0.10 USD) - 2021/01/23 18:10:33 ET
Table 'Dike III' 6-max Seat #5 is the button
Seat 2: B E M 4 W 6 330 ($10 in chips) 
Seat 3: scofo83 ($10 in chips) 
Seat 4: 0TheMouse0 ($10 in chips) 
Seat 5: EYEWONTSTOP ($9.70 in chips) 
Seat 6: SRJ18 ($19.93 in chips) 
SRJ18: posts small blind $0.05
maltsevig: is sitting out 
B E M 4 W 6 330: posts big blind $0.10
*** HOLE CARDS ***
scofo83: raises $0.25 to $0.35
0TheMouse0: folds 
EYEWONTSTOP: folds 
SRJ18: folds 
B E M 4 W 6 330: folds 
Uncalled bet ($0.25) returned to scofo83
scofo83 collected $0.25 from pot
scofo83: doesn't show hand 
*** SUMMARY ***
Total pot $0.25 | Rake $0 
Seat 2: B E M 4 W 6 330 (big blind) folded before Flop
Seat 3: scofo83 collected ($0.25)
Seat 4: 0TheMouse0 folded before Flop (didn't bet)
Seat 5: EYEWONTSTOP (button) folded before Flop (didn't bet)
Seat 6: SRJ18 (small blind) folded before Flop



PokerStars Hand #222977024181:  Hold'em No Limit ($0.05/$0.10 USD) - 2021/01/23 18:10:45 ET
Table 'Dike III' 6-max Seat #6 is the button
Seat 2: B E M 4 W 6 330 ($10 in chips) 
Seat 3: scofo83 ($10.15 in chips) 
Seat 4: 0TheMouse0 ($10 in chips) 
Seat 5: EYEWONTSTOP ($9.70 in chips) 
Seat 6: SRJ18 ($19.88 in chips) 
B E M 4 W 6 330: posts small blind $0.05
scofo83: posts big blind $0.10
*** HOLE CARDS ***
0TheMouse0: raises $0.15 to $0.25
EYEWONTSTOP: folds 
SRJ18: calls $0.25
B E M 4 W 6 330: folds 
scofo83: folds 
*** FLOP *** [8d Jc Kc]
0TheMouse0: checks 
SRJ18: checks 
*** TURN *** [8d Jc Kc] [Qs]
0TheMouse0: checks 
SRJ18: checks 
*** RIVER *** [8d Jc Kc Qs] [Ks]
0TheMouse0: bets $0.43
SRJ18: folds 
Uncalled bet ($0.43) returned to 0TheMouse0
0TheMouse0 collected $0.62 from pot
0TheMouse0: doesn't show hand 
*** SUMMARY ***
Total pot $0.65 | Rake $0.03 
Board [8d Jc Kc Qs Ks]
Seat 2: B E M 4 W 6 330 (small blind) folded before Flop
Seat 3: scofo83 (big blind) folded before Flop
Seat 4: 0TheMouse0 collected ($0.62)
Seat 5: EYEWONTSTOP folded before Flop (didn't bet)
Seat 6: SRJ18 (button) folded on the River



PokerStars Hand #222977049021:  Hold'em No Limit ($0.05/$0.10 USD) - 2021/01/23 18:11:21 ET
Table 'Dike III' 6-max Seat #2 is the button
Seat 2: B E M 4 W 6 330 ($10 in chips) 
Seat 3: scofo83 ($10.05 in chips) 
Seat 4: 0TheMouse0 ($10.37 in chips) 
Seat 5: EYEWONTSTOP ($9.70 in chips) 
Seat 6: SRJ18 ($19.63 in chips) 
scofo83: posts small blind $0.05
0TheMouse0: posts big blind $0.10
maltsevig: sits out 
*** HOLE CARDS ***
EYEWONTSTOP: folds 
SRJ18: calls $0.10
B E M 4 W 6 330: folds 
scofo83: calls $0.05
0TheMouse0: checks 
*** FLOP *** [6s 7h Kh]
scofo83: checks 
0TheMouse0: checks 
SRJ18: checks 
*** TURN *** [6s 7h Kh] [Qs]
scofo83: checks 
0TheMouse0: checks 
SRJ18: bets $0.29
scofo83: folds 
0TheMouse0: folds 
Uncalled bet ($0.29) returned to SRJ18
SRJ18 collected $0.29 from pot
SRJ18: doesn't show hand 
*** SUMMARY ***
Total pot $0.30 | Rake $0.01 
Board [6s 7h Kh Qs]
Seat 2: B E M 4 W 6 330 (button) folded before Flop (didn't bet)
Seat 3: scofo83 (small blind) folded on the Turn
Seat 4: 0TheMouse0 (big blind) folded on the Turn
Seat 5: EYEWONTSTOP folded before Flop (didn't bet)
Seat 6: SRJ18 collected ($0.29)



PokerStars Hand #222977100266:  Hold'em No Limit ($0.05/$0.10 USD) - 2021/01/23 18:12:35 ET
Table 'Dike III' 6-max Seat #3 is the button
Seat 2: B E M 4 W 6 330 ($10 in chips) 
Seat 3: scofo83 ($10 in chips) 
Seat 5: EYEWONTSTOP ($9.70 in chips) 
Seat 6: SRJ18 ($19.82 in chips) 
0TheMouse0 has timed out
0TheMouse0: is sitting out 
EYEWONTSTOP: posts small blind $0.05
SRJ18: posts big blind $0.10
maltsevig: sits out 
*** HOLE CARDS ***
B E M 4 W 6 330: folds 
scofo83: raises $0.15 to $0.25
EYEWONTSTOP: folds 
SRJ18: calls $0.15
*** FLOP *** [2d 9s 8s]
SRJ18: checks 
scofo83: checks 
*** TURN *** [2d 9s 8s] [Qd]
SRJ18: bets $0.27
scofo83: calls $0.27
*** RIVER *** [2d 9s 8s Qd] [5h]
0TheMouse0 is disconnected 
SRJ18: checks 
scofo83: checks 
*** SHOW DOWN ***
SRJ18: shows [Kh 9d] (a pair of Nines)
scofo83: mucks hand 
SRJ18 collected $1.04 from pot
*** SUMMARY ***
Total pot $1.09 | Rake $0.05 
Board [2d 9s 8s Qd 5h]
Seat 2: B E M 4 W 6 330 folded before Flop (didn't bet)
Seat 3: scofo83 (button) mucked
Seat 5: EYEWONTSTOP (small blind) folded before Flop
Seat 6: SRJ18 (big blind) showed [Kh 9d] and won ($1.04) with a pair of Nines



PokerStars Hand #222977129358:  Hold'em No Limit ($0.05/$0.10 USD) - 2021/01/23 18:13:17 ET
Table 'Dike III' 6-max Seat #5 is the button
Seat 1: maltsevig ($12.34 in chips) 
Seat 2: B E M 4 W 6 330 ($10 in chips) 
Seat 3: scofo83 ($10 in chips) 
Seat 5: EYEWONTSTOP ($9.65 in chips) 
Seat 6: SRJ18 ($20.34 in chips) 
SRJ18: posts small blind $0.05
maltsevig: posts big blind $0.10
*** HOLE CARDS ***
B E M 4 W 6 330: folds 
scofo83: folds 
EYEWONTSTOP: folds 
SRJ18: calls $0.05
maltsevig: checks 
*** FLOP *** [5c Js Td]
SRJ18: bets $0.19
maltsevig: folds 
Uncalled bet ($0.19) returned to SRJ18
SRJ18 collected $0.19 from pot
SRJ18: doesn't show hand 
*** SUMMARY ***
Total pot $0.20 | Rake $0.01 
Board [5c Js Td]
Seat 1: maltsevig (big blind) folded on the Flop
Seat 2: B E M 4 W 6 330 folded before Flop (didn't bet)
Seat 3: scofo83 folded before Flop (didn't bet)
Seat 5: EYEWONTSTOP (button) folded before Flop (didn't bet)
Seat 6: SRJ18 (small blind) collected ($0.19)



PokerStars Hand #222977143982:  Hold'em No Limit ($0.05/$0.10 USD) - 2021/01/23 18:13:39 ET
Table 'Dike III' 6-max Seat #6 is the button
Seat 1: maltsevig ($12.24 in chips) 
Seat 2: B E M 4 W 6 330 ($10 in chips) 
Seat 3: scofo83 ($10 in chips) 
Seat 5: EYEWONTSTOP ($9.65 in chips) 
Seat 6: SRJ18 ($20.43 in chips) 
maltsevig: posts small blind $0.05
B E M 4 W 6 330: posts big blind $0.10
*** HOLE CARDS ***
scofo83: folds 
EYEWONTSTOP: raises $0.20 to $0.30
SRJ18: calls $0.30
maltsevig: folds 
B E M 4 W 6 330: raises $0.90 to $1.20
EYEWONTSTOP: calls $0.90
SRJ18: calls $0.90
*** FLOP *** [3c Qs As]
B E M 4 W 6 330: bets $2
EYEWONTSTOP: folds 
SRJ18: folds 
Uncalled bet ($2) returned to B E M 4 W 6 330
B E M 4 W 6 330 collected $3.49 from pot
B E M 4 W 6 330: doesn't show hand 
*** SUMMARY ***
Total pot $3.65 | Rake $0.16 
Board [3c Qs As]
Seat 1: maltsevig (small blind) folded before Flop
Seat 2: B E M 4 W 6 330 (big blind) collected ($3.49)
Seat 3: scofo83 folded before Flop (didn't bet)
Seat 5: EYEWONTSTOP folded on the Flop
Seat 6: SRJ18 (button) folded on the Flop



PokerStars Hand #222977166941:  Hold'em No Limit ($0.05/$0.10 USD) - 2021/01/23 18:14:12 ET
Table 'Dike III' 6-max Seat #1 is the button
Seat 1: maltsevig ($12.19 in chips) 
Seat 2: B E M 4 W 6 330 ($12.29 in chips) 
Seat 3: scofo83 ($10 in chips) 
Seat 5: EYEWONTSTOP ($8.45 in chips) 
Seat 6: SRJ18 ($19.23 in chips) 
B E M 4 W 6 330: posts small blind $0.05
scofo83: posts big blind $0.10
*** HOLE CARDS ***
EYEWONTSTOP: folds 
SRJ18: folds 
maltsevig: folds 
B E M 4 W 6 330: folds 
Uncalled bet ($0.05) returned to scofo83
scofo83 collected $0.10 from pot
scofo83: doesn't show hand 
*** SUMMARY ***
Total pot $0.10 | Rake $0 
Seat 1: maltsevig (button) folded before Flop (didn't bet)
Seat 2: B E M 4 W 6 330 (small blind) folded before Flop
Seat 3: scofo83 (big blind) collected ($0.10)
Seat 5: EYEWONTSTOP folded before Flop (didn't bet)
Seat 6: SRJ18 folded before Flop (didn't bet)



PokerStars Hand #222977171789:  Hold'em No Limit ($0.05/$0.10 USD) - 2021/01/23 18:14:19 ET
Table 'Dike III' 6-max Seat #2 is the button
Seat 1: maltsevig ($12.19 in chips) 
Seat 2: B E M 4 W 6 330 ($12.24 in chips) 
Seat 3: scofo83 ($10.05 in chips) 
Seat 5: EYEWONTSTOP ($8.45 in chips) 
Seat 6: SRJ18 ($19.23 in chips) 
scofo83: posts small blind $0.05
EYEWONTSTOP: posts big blind $0.10
*** HOLE CARDS ***
SRJ18: calls $0.10
maltsevig: folds 
B E M 4 W 6 330: raises $0.30 to $0.40
scofo83: folds 
EYEWONTSTOP: calls $0.30
SRJ18: calls $0.30
*** FLOP *** [5d Ac 5s]
EYEWONTSTOP: checks 
SRJ18: checks 
B E M 4 W 6 330: checks 
*** TURN *** [5d Ac 5s] [8s]
EYEWONTSTOP: bets $0.60
SRJ18: folds 
B E M 4 W 6 330: folds 
Uncalled bet ($0.60) returned to EYEWONTSTOP
EYEWONTSTOP collected $1.19 from pot
EYEWONTSTOP: doesn't show hand 
*** SUMMARY ***
Total pot $1.25 | Rake $0.06 
Board [5d Ac 5s 8s]
Seat 1: maltsevig folded before Flop (didn't bet)
Seat 2: B E M 4 W 6 330 (button) folded on the Turn
Seat 3: scofo83 (small blind) folded before Flop
Seat 5: EYEWONTSTOP (big blind) collected ($1.19)
Seat 6: SRJ18 folded on the Turn



PokerStars Hand #222977196823:  Hold'em No Limit ($0.05/$0.10 USD) - 2021/01/23 18:14:56 ET
Table 'Dike III' 6-max Seat #3 is the button
Seat 1: maltsevig ($12.19 in chips) 
Seat 2: B E M 4 W 6 330 ($11.84 in chips) 
Seat 3: scofo83 ($10 in chips) 
Seat 5: EYEWONTSTOP ($9.24 in chips) 
Seat 6: SRJ18 ($18.83 in chips) 
EYEWONTSTOP: posts small blind $0.05
SRJ18: posts big blind $0.10
*** HOLE CARDS ***
maltsevig: folds 
B E M 4 W 6 330: raises $0.20 to $0.30
scofo83: calls $0.30
EYEWONTSTOP: folds 
SRJ18: calls $0.20
*** FLOP *** [7c 2h 5d]
SRJ18: checks 
B E M 4 W 6 330: bets $0.50
scofo83: calls $0.50
SRJ18: folds 
*** TURN *** [7c 2h 5d] [7s]
B E M 4 W 6 330: checks 
scofo83: bets $1.40
B E M 4 W 6 330: calls $1.40
*** RIVER *** [7c 2h 5d 7s] [9c]
B E M 4 W 6 330: bets $4
0TheMouse0 is disconnected 
scofo83: folds 
Uncalled bet ($4) returned to B E M 4 W 6 330
B E M 4 W 6 330 collected $4.54 from pot
B E M 4 W 6 330: doesn't show hand 
*** SUMMARY ***
Total pot $4.75 | Rake $0.21 
Board [7c 2h 5d 7s 9c]
Seat 1: maltsevig folded before Flop (didn't bet)
Seat 2: B E M 4 W 6 330 collected ($4.54)
Seat 3: scofo83 (button) folded on the River
Seat 5: EYEWONTSTOP (small blind) folded before Flop
Seat 6: SRJ18 (big blind) folded on the Flop



PokerStars Hand #222977232168:  Hold'em No Limit ($0.05/$0.10 USD) - 2021/01/23 18:15:48 ET
Table 'Dike III' 6-max Seat #5 is the button
Seat 1: maltsevig ($12.19 in chips) 
Seat 2: B E M 4 W 6 330 ($14.18 in chips) 
Seat 3: scofo83 ($10 in chips) 
Seat 5: EYEWONTSTOP ($9.19 in chips) 
Seat 6: SRJ18 ($18.53 in chips) 
SRJ18: posts small blind $0.05
maltsevig: posts big blind $0.10
*** HOLE CARDS ***
B E M 4 W 6 330: folds 
scofo83: folds 
EYEWONTSTOP: folds 
SRJ18: folds 
Uncalled bet ($0.05) returned to maltsevig
maltsevig collected $0.10 from pot
maltsevig: doesn't show hand 
*** SUMMARY ***
Total pot $0.10 | Rake $0 
Seat 1: maltsevig (big blind) collected ($0.10)
Seat 2: B E M 4 W 6 330 folded before Flop (didn't bet)
Seat 3: scofo83 folded before Flop (didn't bet)
Seat 5: EYEWONTSTOP (button) folded before Flop (didn't bet)
Seat 6: SRJ18 (small blind) folded before Flop



PokerStars Hand #222977239638:  Hold'em No Limit ($0.05/$0.10 USD) - 2021/01/23 18:15:58 ET
Table 'Dike III' 6-max Seat #6 is the button
Seat 1: maltsevig ($12.24 in chips) 
Seat 2: B E M 4 W 6 330 ($14.18 in chips) 
Seat 3: scofo83 ($10 in chips) 
Seat 5: EYEWONTSTOP ($9.19 in chips) 
Seat 6: SRJ18 ($18.48 in chips) 
maltsevig: posts small blind $0.05
B E M 4 W 6 330: posts big blind $0.10
*** HOLE CARDS ***
scofo83: folds 
EYEWONTSTOP: raises $0.25 to $0.35
SRJ18: folds 
SRJ18 leaves the table
maltsevig: folds 
B E M 4 W 6 330: folds 
Uncalled bet ($0.25) returned to EYEWONTSTOP
EYEWONTSTOP collected $0.25 from pot
EYEWONTSTOP: doesn't show hand 
*** SUMMARY ***
Total pot $0.25 | Rake $0 
Seat 1: maltsevig (small blind) folded before Flop
Seat 2: B E M 4 W 6 330 (big blind) folded before Flop
Seat 3: scofo83 folded before Flop (didn't bet)
Seat 5: EYEWONTSTOP collected ($0.25)
Seat 6: SRJ18 (button) folded before Flop (didn't bet)



PokerStars Hand #222977252127:  Hold'em No Limit ($0.05/$0.10 USD) - 2021/01/23 18:16:17 ET
Table 'Dike III' 6-max Seat #1 is the button
Seat 1: maltsevig ($12.19 in chips) 
Seat 2: B E M 4 W 6 330 ($14.08 in chips) 
Seat 3: scofo83 ($10 in chips) 
Seat 5: EYEWONTSTOP ($9.34 in chips) 
B E M 4 W 6 330: posts small blind $0.05
scofo83: posts big blind $0.10
*** HOLE CARDS ***
EYEWONTSTOP: raises $0.20 to $0.30
maltsevig: folds 
B E M 4 W 6 330: folds 
scofo83: calls $0.20
*** FLOP *** [4c 4d Tc]
scofo83: checks 
EYEWONTSTOP: bets $0.62
scofo83: folds 
Uncalled bet ($0.62) returned to EYEWONTSTOP
EYEWONTSTOP collected $0.62 from pot
EYEWONTSTOP: doesn't show hand 
*** SUMMARY ***
Total pot $0.65 | Rake $0.03 
Board [4c 4d Tc]
Seat 1: maltsevig (button) folded before Flop (didn't bet)
Seat 2: B E M 4 W 6 330 (small blind) folded before Flop
Seat 3: scofo83 (big blind) folded on the Flop
Seat 5: EYEWONTSTOP collected ($0.62)



PokerStars Hand #222977275257:  Hold'em No Limit ($0.05/$0.10 USD) - 2021/01/23 18:16:51 ET
Table 'Dike III' 6-max Seat #2 is the button
Seat 1: maltsevig ($12.19 in chips) 
Seat 2: B E M 4 W 6 330 ($14.03 in chips) 
Seat 3: scofo83 ($10 in chips) 
Seat 5: EYEWONTSTOP ($9.66 in chips) 
scofo83: posts small blind $0.05
EYEWONTSTOP: posts big blind $0.10
*** HOLE CARDS ***
maltsevig: raises $0.16 to $0.26
B E M 4 W 6 330: folds 
0TheMouse0 is disconnected 
scofo83: folds 
EYEWONTSTOP: folds 
Uncalled bet ($0.16) returned to maltsevig
maltsevig collected $0.25 from pot
0TheMouse0 was removed from the table for failing to post
0TheMouse0 leaves the table
maltsevig: doesn't show hand 
*** SUMMARY ***
Total pot $0.25 | Rake $0 
Seat 1: maltsevig collected ($0.25)
Seat 2: B E M 4 W 6 330 (button) folded before Flop (didn't bet)
Seat 3: scofo83 (small blind) folded before Flop
Seat 5: EYEWONTSTOP (big blind) folded before Flop



PokerStars Hand #222977286823:  Hold'em No Limit ($0.05/$0.10 USD) - 2021/01/23 18:17:08 ET
Table 'Dike III' 6-max Seat #3 is the button
Seat 1: maltsevig ($12.34 in chips) 
Seat 2: B E M 4 W 6 330 ($14.03 in chips) 
Seat 3: scofo83 ($10 in chips) 
Seat 5: EYEWONTSTOP ($9.56 in chips) 
EYEWONTSTOP: posts small blind $0.05
maltsevig: posts big blind $0.10
*** HOLE CARDS ***
B E M 4 W 6 330: raises $0.20 to $0.30
scofo83: folds 
EYEWONTSTOP: folds 
maltsevig: folds 
Uncalled bet ($0.20) returned to B E M 4 W 6 330
B E M 4 W 6 330 collected $0.25 from pot
B E M 4 W 6 330: doesn't show hand 
*** SUMMARY ***
Total pot $0.25 | Rake $0 
Seat 1: maltsevig (big blind) folded before Flop
Seat 2: B E M 4 W 6 330 collected ($0.25)
Seat 3: scofo83 (button) folded before Flop (didn't bet)
Seat 5: EYEWONTSTOP (small blind) folded before Flop



PokerStars Hand #222977294601:  Hold'em No Limit ($0.05/$0.10 USD) - 2021/01/23 18:17:20 ET
Table 'Dike III' 6-max Seat #5 is the button
Seat 1: maltsevig ($12.24 in chips) 
Seat 2: B E M 4 W 6 330 ($14.18 in chips) 
Seat 3: scofo83 ($10 in chips) 
Seat 5: EYEWONTSTOP ($9.51 in chips) 
maltsevig: posts small blind $0.05
B E M 4 W 6 330: posts big blind $0.10
*** HOLE CARDS ***
scofo83: folds 
EYEWONTSTOP has timed out
EYEWONTSTOP: folds 
maltsevig: raises $0.13 to $0.23
B E M 4 W 6 330: raises $0.57 to $0.80
maltsevig: folds 
Uncalled bet ($0.57) returned to B E M 4 W 6 330
B E M 4 W 6 330 collected $0.46 from pot
B E M 4 W 6 330: doesn't show hand 
*** SUMMARY ***
Total pot $0.46 | Rake $0 
Seat 1: maltsevig (small blind) folded before Flop
Seat 2: B E M 4 W 6 330 (big blind) collected ($0.46)
Seat 3: scofo83 folded before Flop (didn't bet)
Seat 5: EYEWONTSTOP (button) folded before Flop (didn't bet)



PokerStars Hand #222977321891:  Hold'em No Limit ($0.05/$0.10 USD) - 2021/01/23 18:18:00 ET
Table 'Dike III' 6-max Seat #2 is the button
Seat 1: maltsevig ($12.01 in chips) 
Seat 2: B E M 4 W 6 330 ($14.41 in chips) 
B E M 4 W 6 330: posts small blind $0.05
RonFFC joins the table at seat #6 
scofo83: is sitting out 
maltsevig: posts big blind $0.10
*** HOLE CARDS ***
B E M 4 W 6 330: folds 
Uncalled bet ($0.05) returned to maltsevig
maltsevig collected $0.10 from pot
maltsevig: doesn't show hand 
scofo83 leaves the table
*** SUMMARY ***
Total pot $0.10 | Rake $0 
Seat 1: maltsevig (big blind) collected ($0.10)
Seat 2: B E M 4 W 6 330 (button) (small blind) folded before Flop



PokerStars Hand #222977327428:  Hold'em No Limit ($0.05/$0.10 USD) - 2021/01/23 18:18:09 ET
Table 'Dike III' 6-max Seat #1 is the button
Seat 1: maltsevig ($12.06 in chips) 
Seat 2: B E M 4 W 6 330 ($14.36 in chips) 
Seat 6: RonFFC ($8 in chips) 
B E M 4 W 6 330: posts small blind $0.05
RonFFC: posts big blind $0.10
*** HOLE CARDS ***
maltsevig: folds 
B E M 4 W 6 330: folds 
Uncalled bet ($0.05) returned to RonFFC
RonFFC collected $0.10 from pot
RonFFC: doesn't show hand 
*** SUMMARY ***
Total pot $0.10 | Rake $0 
Seat 1: maltsevig (button) folded before Flop (didn't bet)
Seat 2: B E M 4 W 6 330 (small blind) folded before Flop
Seat 6: RonFFC (big blind) collected ($0.10)



PokerStars Hand #222977332298:  Hold'em No Limit ($0.05/$0.10 USD) - 2021/01/23 18:18:16 ET
Table 'Dike III' 6-max Seat #2 is the button
Seat 1: maltsevig ($12.06 in chips) 
Seat 2: B E M 4 W 6 330 ($14.31 in chips) 
Seat 6: RonFFC ($8.05 in chips) 
RonFFC: posts small blind $0.05
maltsevig: posts big blind $0.10
*** HOLE CARDS ***
B E M 4 W 6 330: folds 
RonFFC: calls $0.05
maltsevig: checks 
*** FLOP *** [8h 6h 7d]
RonFFC: bets $0.30
maltsevig: folds 
Uncalled bet ($0.30) returned to RonFFC
RonFFC collected $0.19 from pot
RonFFC: doesn't show hand 
*** SUMMARY ***
Total pot $0.20 | Rake $0.01 
Board [8h 6h 7d]
Seat 1: maltsevig (big blind) folded on the Flop
Seat 2: B E M 4 W 6 330 (button) folded before Flop (didn't bet)
Seat 6: RonFFC (small blind) collected ($0.19)



PokerStars Hand #222977346719:  Hold'em No Limit ($0.05/$0.10 USD) - 2021/01/23 18:18:37 ET
Table 'Dike III' 6-max Seat #1 is the button
Seat 1: maltsevig ($11.96 in chips) 
Seat 6: RonFFC ($8.14 in chips) 
maltsevig: posts small blind $0.05
B E M 4 W 6 330: is sitting out 
RonFFC: posts big blind $0.10
*** HOLE CARDS ***
maltsevig: folds 
Uncalled bet ($0.05) returned to RonFFC
RonFFC collected $0.10 from pot
RonFFC: doesn't show hand 
*** SUMMARY ***
Total pot $0.10 | Rake $0 
Seat 1: maltsevig (button) (small blind) folded before Flop
Seat 6: RonFFC (big blind) collected ($0.10)



PokerStars Hand #222977349213:  Hold'em No Limit ($0.05/$0.10 USD) - 2021/01/23 18:18:41 ET
Table 'Dike III' 6-max Seat #6 is the button
Seat 1: maltsevig ($11.91 in chips) 
Seat 6: RonFFC ($8.19 in chips) 
RonFFC: posts small blind $0.05
maltsevig: posts big blind $0.10
*** HOLE CARDS ***
RonFFC: raises $0.30 to $0.40
B E M 4 W 6 330 leaves the table
maltsevig: folds 
Uncalled bet ($0.30) returned to RonFFC
RonFFC collected $0.20 from pot
RonFFC: doesn't show hand 
*** SUMMARY ***
Total pot $0.20 | Rake $0 
Seat 1: maltsevig (big blind) folded before Flop
Seat 6: RonFFC (button) (small blind) collected ($0.20)



PokerStars Hand #222977354253:  Hold'em No Limit ($0.05/$0.10 USD) - 2021/01/23 18:18:48 ET
Table 'Dike III' 6-max Seat #1 is the button
Seat 1: maltsevig ($11.81 in chips) 
Seat 6: RonFFC ($8.29 in chips) 
maltsevig: posts small blind $0.05
RonFFC: posts big blind $0.10
*** HOLE CARDS ***
maltsevig: raises $0.13 to $0.23
RonFFC: calls $0.13
*** FLOP *** [Td Ac Js]
RonFFC: checks 
maltsevig: bets $0.29
RonFFC: raises $0.41 to $0.70
maltsevig: folds 
Uncalled bet ($0.41) returned to RonFFC
RonFFC collected $0.99 from pot
RonFFC: doesn't show hand 
*** SUMMARY ***
Total pot $1.04 | Rake $0.05 
Board [Td Ac Js]
Seat 1: maltsevig (button) (small blind) folded on the Flop
Seat 6: RonFFC (big blind) collected ($0.99)



