PokerStars Hand #222951468527:  Hold'em No Limit ($0.05/$0.10 USD) - 2021/01/23 7:01:28 ET
Table 'Lutetia III' 6-max Seat #5 is the button
Seat 1: TakMits ($10 in chips) 
Seat 2: SERGEY015 ($10.10 in chips) 
Seat 3: Black021 ($10.15 in chips) 
Seat 4: mastiko1996 ($10.21 in chips) 
Seat 5: tatsuyao ($9.37 in chips) 
Seat 6: karhulabase ($10.21 in chips) 
karhulabase: posts small blind $0.05
TakMits: posts big blind $0.10
*** HOLE CARDS ***
SERGEY015: folds 
Black021: folds 
mastiko1996: raises $0.20 to $0.30
tatsuyao: raises $0.20 to $0.50
karhulabase: folds 
TakMits: calls $0.40
mastiko1996: calls $0.20
*** FLOP *** [Jh Qc Kh]
TakMits: checks 
mastiko1996: checks 
tatsuyao: bets $0.50
TakMits: calls $0.50
mastiko1996: calls $0.50
*** TURN *** [Jh Qc Kh] [9c]
TakMits: bets $2.18
mastiko1996: folds 
tatsuyao: folds 
Uncalled bet ($2.18) returned to TakMits
TakMits collected $2.91 from pot
TakMits: doesn't show hand 
*** SUMMARY ***
Total pot $3.05 | Rake $0.14 
Board [Jh Qc Kh 9c]
Seat 1: TakMits (big blind) collected ($2.91)
Seat 2: SERGEY015 folded before Flop (didn't bet)
Seat 3: Black021 folded before Flop (didn't bet)
Seat 4: mastiko1996 folded on the Turn
Seat 5: tatsuyao (button) folded on the Turn
Seat 6: karhulabase (small blind) folded before Flop



PokerStars Hand #222951489993:  Hold'em No Limit ($0.05/$0.10 USD) - 2021/01/23 7:02:30 ET
Table 'Lutetia III' 6-max Seat #6 is the button
Seat 1: TakMits ($11.91 in chips) 
Seat 2: SERGEY015 ($10.10 in chips) 
Seat 3: Black021 ($10.15 in chips) 
Seat 4: mastiko1996 ($10 in chips) 
Seat 5: tatsuyao ($8.37 in chips) 
Seat 6: karhulabase ($10.16 in chips) 
TakMits: posts small blind $0.05
SERGEY015: posts big blind $0.10
*** HOLE CARDS ***
Black021: raises $0.17 to $0.27
mastiko1996: folds 
tatsuyao: calls $0.27
karhulabase: calls $0.27
TakMits: folds 
SERGEY015: folds 
*** FLOP *** [6c Kh 5s]
Black021: checks 
tatsuyao: bets $1.12
karhulabase: folds 
Black021: folds 
Uncalled bet ($1.12) returned to tatsuyao
tatsuyao collected $0.92 from pot
tatsuyao: doesn't show hand 
*** SUMMARY ***
Total pot $0.96 | Rake $0.04 
Board [6c Kh 5s]
Seat 1: TakMits (small blind) folded before Flop
Seat 2: SERGEY015 (big blind) folded before Flop
Seat 3: Black021 folded on the Flop
Seat 4: mastiko1996 folded before Flop (didn't bet)
Seat 5: tatsuyao collected ($0.92)
Seat 6: karhulabase (button) folded on the Flop



PokerStars Hand #222951503282:  Hold'em No Limit ($0.05/$0.10 USD) - 2021/01/23 7:03:07 ET
Table 'Lutetia III' 6-max Seat #1 is the button
Seat 1: TakMits ($11.86 in chips) 
Seat 2: SERGEY015 ($10 in chips) 
Seat 3: Black021 ($10 in chips) 
Seat 4: mastiko1996 ($10 in chips) 
Seat 5: tatsuyao ($9.02 in chips) 
Seat 6: karhulabase ($9.89 in chips) 
SERGEY015: posts small blind $0.05
Black021: posts big blind $0.10
*** HOLE CARDS ***
mastiko1996: raises $0.20 to $0.30
tatsuyao: folds 
karhulabase: calls $0.30
TakMits: folds 
SERGEY015: folds 
Black021: folds 
*** FLOP *** [Ks Jh 9h]
mastiko1996: bets $0.60
karhulabase: calls $0.60
*** TURN *** [Ks Jh 9h] [4h]
mastiko1996: checks 
karhulabase: bets $8.99 and is all-in
mastiko1996: folds 
Uncalled bet ($8.99) returned to karhulabase
karhulabase collected $1.86 from pot
karhulabase: doesn't show hand 
*** SUMMARY ***
Total pot $1.95 | Rake $0.09 
Board [Ks Jh 9h 4h]
Seat 1: TakMits (button) folded before Flop (didn't bet)
Seat 2: SERGEY015 (small blind) folded before Flop
Seat 3: Black021 (big blind) folded before Flop
Seat 4: mastiko1996 folded on the Turn
Seat 5: tatsuyao folded before Flop (didn't bet)
Seat 6: karhulabase collected ($1.86)



PokerStars Hand #222951517143:  Hold'em No Limit ($0.05/$0.10 USD) - 2021/01/23 7:03:46 ET
Table 'Lutetia III' 6-max Seat #2 is the button
Seat 1: TakMits ($11.86 in chips) 
Seat 2: SERGEY015 ($9.95 in chips) 
Seat 3: Black021 ($10 in chips) 
Seat 4: mastiko1996 ($10 in chips) 
Seat 5: tatsuyao ($9.02 in chips) 
Seat 6: karhulabase ($10.85 in chips) 
Black021: posts small blind $0.05
mastiko1996: posts big blind $0.10
*** HOLE CARDS ***
tatsuyao: folds 
karhulabase: folds 
TakMits: folds 
SERGEY015: folds 
Black021: raises $0.17 to $0.27
mastiko1996: calls $0.17
*** FLOP *** [Jc Js 8s]
Black021: bets $0.30
mastiko1996: calls $0.30
*** TURN *** [Jc Js 8s] [7h]
Black021: checks 
mastiko1996: checks 
*** RIVER *** [Jc Js 8s 7h] [3s]
Black021: checks 
mastiko1996: checks 
*** SHOW DOWN ***
Black021: shows [Td Kd] (a pair of Jacks)
mastiko1996: shows [Ac 8c] (two pair, Jacks and Eights)
mastiko1996 collected $1.09 from pot
*** SUMMARY ***
Total pot $1.14 | Rake $0.05 
Board [Jc Js 8s 7h 3s]
Seat 1: TakMits folded before Flop (didn't bet)
Seat 2: SERGEY015 (button) folded before Flop (didn't bet)
Seat 3: Black021 (small blind) showed [Td Kd] and lost with a pair of Jacks
Seat 4: mastiko1996 (big blind) showed [Ac 8c] and won ($1.09) with two pair, Jacks and Eights
Seat 5: tatsuyao folded before Flop (didn't bet)
Seat 6: karhulabase folded before Flop (didn't bet)



PokerStars Hand #222951539267:  Hold'em No Limit ($0.05/$0.10 USD) - 2021/01/23 7:04:48 ET
Table 'Lutetia III' 6-max Seat #3 is the button
Seat 1: TakMits ($11.86 in chips) 
Seat 2: SERGEY015 ($9.95 in chips) 
Seat 3: Black021 ($10 in chips) 
Seat 4: mastiko1996 ($10.52 in chips) 
Seat 5: tatsuyao ($9.02 in chips) 
Seat 6: karhulabase ($10.85 in chips) 
mastiko1996: posts small blind $0.05
tatsuyao: posts big blind $0.10
*** HOLE CARDS ***
karhulabase: raises $0.25 to $0.35
TakMits: folds 
SERGEY015: folds 
Black021: folds 
mastiko1996: folds 
tatsuyao: calls $0.25
*** FLOP *** [Ts Ks 9h]
tatsuyao: bets $0.40
karhulabase: raises $1.52 to $1.92
tatsuyao: calls $1.52
*** TURN *** [Ts Ks 9h] [Js]
tatsuyao: bets $0.10
karhulabase: raises $4.58 to $4.68
tatsuyao: calls $4.58
*** RIVER *** [Ts Ks 9h Js] [4h]
tatsuyao: checks 
karhulabase: bets $3.90 and is all-in
tatsuyao: calls $2.07 and is all-in
Uncalled bet ($1.83) returned to karhulabase
*** SHOW DOWN ***
karhulabase: shows [Jc Jd] (three of a kind, Jacks)
tatsuyao: shows [Tc Qh] (a straight, Nine to King)
tatsuyao collected $17.28 from pot
*** SUMMARY ***
Total pot $18.09 | Rake $0.81 
Board [Ts Ks 9h Js 4h]
Seat 1: TakMits folded before Flop (didn't bet)
Seat 2: SERGEY015 folded before Flop (didn't bet)
Seat 3: Black021 (button) folded before Flop (didn't bet)
Seat 4: mastiko1996 (small blind) folded before Flop
Seat 5: tatsuyao (big blind) showed [Tc Qh] and won ($17.28) with a straight, Nine to King
Seat 6: karhulabase showed [Jc Jd] and lost with three of a kind, Jacks



PokerStars Hand #222951554639:  Hold'em No Limit ($0.05/$0.10 USD) - 2021/01/23 7:05:31 ET
Table 'Lutetia III' 6-max Seat #4 is the button
Seat 1: TakMits ($11.86 in chips) 
Seat 2: SERGEY015 ($9.95 in chips) 
Seat 3: Black021 ($10 in chips) 
Seat 4: mastiko1996 ($10.47 in chips) 
Seat 5: tatsuyao ($17.28 in chips) 
Seat 6: karhulabase ($1.83 in chips) 
tatsuyao: posts small blind $0.05
karhulabase: posts big blind $0.10
*** HOLE CARDS ***
TakMits: folds 
SERGEY015: folds 
Black021: folds 
mastiko1996: raises $0.20 to $0.30
tatsuyao: calls $0.25
karhulabase: folds 
*** FLOP *** [4d Tc Th]
karhulabase leaves the table
tatsuyao: checks 
mastiko1996: bets $0.22
H514OB joins the table at seat #6 
tatsuyao: calls $0.22
*** TURN *** [4d Tc Th] [9s]
tatsuyao: checks 
mastiko1996: checks 
*** RIVER *** [4d Tc Th 9s] [8c]
tatsuyao: checks 
mastiko1996: checks 
*** SHOW DOWN ***
tatsuyao: shows [3h Jd] (a pair of Tens)
mastiko1996: shows [Ah Qh] (a pair of Tens - Ace kicker)
mastiko1996 collected $1.09 from pot
*** SUMMARY ***
Total pot $1.14 | Rake $0.05 
Board [4d Tc Th 9s 8c]
Seat 1: TakMits folded before Flop (didn't bet)
Seat 2: SERGEY015 folded before Flop (didn't bet)
Seat 3: Black021 folded before Flop (didn't bet)
Seat 4: mastiko1996 (button) showed [Ah Qh] and won ($1.09) with a pair of Tens
Seat 5: tatsuyao (small blind) showed [3h Jd] and lost with a pair of Tens
Seat 6: karhulabase (big blind) folded before Flop



PokerStars Hand #222951575661:  Hold'em No Limit ($0.05/$0.10 USD) - 2021/01/23 7:06:30 ET
Table 'Lutetia III' 6-max Seat #5 is the button
Seat 1: TakMits ($11.86 in chips) 
Seat 2: SERGEY015 ($9.95 in chips) 
Seat 3: Black021 ($10 in chips) 
Seat 4: mastiko1996 ($11.04 in chips) 
Seat 5: tatsuyao ($16.76 in chips) 
TakMits: posts small blind $0.05
SERGEY015: posts big blind $0.10
*** HOLE CARDS ***
Black021: folds 
mastiko1996: folds 
tatsuyao: folds 
TakMits: raises $0.20 to $0.30
SERGEY015: calls $0.20
*** FLOP *** [3c Jd Ah]
TakMits: bets $0.29
SERGEY015: folds 
Uncalled bet ($0.29) returned to TakMits
TakMits collected $0.57 from pot
TakMits: doesn't show hand 
*** SUMMARY ***
Total pot $0.60 | Rake $0.03 
Board [3c Jd Ah]
Seat 1: TakMits (small blind) collected ($0.57)
Seat 2: SERGEY015 (big blind) folded on the Flop
Seat 3: Black021 folded before Flop (didn't bet)
Seat 4: mastiko1996 folded before Flop (didn't bet)
Seat 5: tatsuyao (button) folded before Flop (didn't bet)



PokerStars Hand #222951582539:  Hold'em No Limit ($0.05/$0.10 USD) - 2021/01/23 7:06:49 ET
Table 'Lutetia III' 6-max Seat #1 is the button
Seat 1: TakMits ($12.13 in chips) 
Seat 2: SERGEY015 ($9.65 in chips) 
Seat 3: Black021 ($10 in chips) 
Seat 4: mastiko1996 ($11.04 in chips) 
Seat 5: tatsuyao ($16.76 in chips) 
SERGEY015: posts small blind $0.05
Black021: posts big blind $0.10
H514OB: sits out 
*** HOLE CARDS ***
mastiko1996: raises $0.20 to $0.30
tatsuyao: raises $0.20 to $0.50
TakMits: folds 
SERGEY015: folds 
Black021: folds 
mastiko1996: raises $1.40 to $1.90
tatsuyao: calls $1.40
*** FLOP *** [2s 9c 3h]
mastiko1996: bets $1
tatsuyao: calls $1
*** TURN *** [2s 9c 3h] [Kd]
mastiko1996: bets $2.80
tatsuyao: calls $2.80
*** RIVER *** [2s 9c 3h Kd] [Ah]
mastiko1996: bets $5.34 and is all-in
tatsuyao: calls $5.34
*** SHOW DOWN ***
mastiko1996: shows [Ks Ad] (two pair, Aces and Kings)
tatsuyao: shows [Ac 4s] (a pair of Aces)
mastiko1996 collected $21.23 from pot
*** SUMMARY ***
Total pot $22.23 | Rake $1 
Board [2s 9c 3h Kd Ah]
Seat 1: TakMits (button) folded before Flop (didn't bet)
Seat 2: SERGEY015 (small blind) folded before Flop
Seat 3: Black021 (big blind) folded before Flop
Seat 4: mastiko1996 showed [Ks Ad] and won ($21.23) with two pair, Aces and Kings
Seat 5: tatsuyao showed [Ac 4s] and lost with a pair of Aces



PokerStars Hand #222951610583:  Hold'em No Limit ($0.05/$0.10 USD) - 2021/01/23 7:08:07 ET
Table 'Lutetia III' 6-max Seat #2 is the button
Seat 1: TakMits ($12.13 in chips) 
Seat 2: SERGEY015 ($9.60 in chips) 
Seat 3: Black021 ($10 in chips) 
Seat 4: mastiko1996 ($21.23 in chips) 
Seat 5: tatsuyao ($5.72 in chips) 
Black021: posts small blind $0.05
mastiko1996: posts big blind $0.10
H514OB: sits out 
*** HOLE CARDS ***
tatsuyao: raises $0.10 to $0.20
TakMits: folds 
SERGEY015: folds 
Black021: folds 
mastiko1996: folds 
Uncalled bet ($0.10) returned to tatsuyao
tatsuyao collected $0.25 from pot
tatsuyao: doesn't show hand 
*** SUMMARY ***
Total pot $0.25 | Rake $0 
Seat 1: TakMits folded before Flop (didn't bet)
Seat 2: SERGEY015 (button) folded before Flop (didn't bet)
Seat 3: Black021 (small blind) folded before Flop
Seat 4: mastiko1996 (big blind) folded before Flop
Seat 5: tatsuyao collected ($0.25)



PokerStars Hand #222951614100:  Hold'em No Limit ($0.05/$0.10 USD) - 2021/01/23 7:08:17 ET
Table 'Lutetia III' 6-max Seat #3 is the button
Seat 1: TakMits ($12.13 in chips) 
Seat 2: SERGEY015 ($9.60 in chips) 
Seat 3: Black021 ($10 in chips) 
Seat 4: mastiko1996 ($21.13 in chips) 
Seat 5: tatsuyao ($5.87 in chips) 
mastiko1996: posts small blind $0.05
tatsuyao: posts big blind $0.10
H514OB: sits out 
*** HOLE CARDS ***
TakMits: folds 
SERGEY015: folds 
Black021: raises $0.12 to $0.22
mastiko1996: folds 
tatsuyao: folds 
Uncalled bet ($0.12) returned to Black021
Black021 collected $0.25 from pot
Black021: doesn't show hand 
*** SUMMARY ***
Total pot $0.25 | Rake $0 
Seat 1: TakMits folded before Flop (didn't bet)
Seat 2: SERGEY015 folded before Flop (didn't bet)
Seat 3: Black021 (button) collected ($0.25)
Seat 4: mastiko1996 (small blind) folded before Flop
Seat 5: tatsuyao (big blind) folded before Flop



PokerStars Hand #222951618715:  Hold'em No Limit ($0.05/$0.10 USD) - 2021/01/23 7:08:29 ET
Table 'Lutetia III' 6-max Seat #4 is the button
Seat 1: TakMits ($12.13 in chips) 
Seat 2: SERGEY015 ($9.60 in chips) 
Seat 3: Black021 ($10.15 in chips) 
Seat 4: mastiko1996 ($21.08 in chips) 
Seat 5: tatsuyao ($5.77 in chips) 
Seat 6: H514OB ($5 in chips) 
tatsuyao: posts small blind $0.05
H514OB: posts big blind $0.10
*** HOLE CARDS ***
TakMits: folds 
SERGEY015: folds 
Black021: folds 
mastiko1996: folds 
tatsuyao: folds 
Uncalled bet ($0.05) returned to H514OB
tatsuyao leaves the table
H514OB collected $0.10 from pot
H514OB: doesn't show hand 
*** SUMMARY ***
Total pot $0.10 | Rake $0 
Seat 1: TakMits folded before Flop (didn't bet)
Seat 2: SERGEY015 folded before Flop (didn't bet)
Seat 3: Black021 folded before Flop (didn't bet)
Seat 4: mastiko1996 (button) folded before Flop (didn't bet)
Seat 5: tatsuyao (small blind) folded before Flop
Seat 6: H514OB (big blind) collected ($0.10)



PokerStars Hand #222951624266:  Hold'em No Limit ($0.05/$0.10 USD) - 2021/01/23 7:08:44 ET
Table 'Lutetia III' 6-max Seat #6 is the button
Seat 1: TakMits ($12.13 in chips) 
Seat 2: SERGEY015 ($9.60 in chips) 
Seat 3: Black021 ($10.15 in chips) 
Seat 4: mastiko1996 ($21.08 in chips) 
Seat 6: H514OB ($5.05 in chips) 
TakMits: posts small blind $0.05
SERGEY015: posts big blind $0.10
*** HOLE CARDS ***
Black021: folds 
mastiko1996: folds 
H514OB: folds 
TakMits: folds 
Uncalled bet ($0.05) returned to SERGEY015
SERGEY015 collected $0.10 from pot
SERGEY015: doesn't show hand 
*** SUMMARY ***
Total pot $0.10 | Rake $0 
Seat 1: TakMits (small blind) folded before Flop
Seat 2: SERGEY015 (big blind) collected ($0.10)
Seat 3: Black021 folded before Flop (didn't bet)
Seat 4: mastiko1996 folded before Flop (didn't bet)
Seat 6: H514OB (button) folded before Flop (didn't bet)



PokerStars Hand #222951628250:  Hold'em No Limit ($0.05/$0.10 USD) - 2021/01/23 7:08:56 ET
Table 'Lutetia III' 6-max Seat #1 is the button
Seat 1: TakMits ($12.08 in chips) 
Seat 2: SERGEY015 ($9.65 in chips) 
Seat 3: Black021 ($10.15 in chips) 
Seat 4: mastiko1996 ($21.08 in chips) 
Seat 6: H514OB ($5.05 in chips) 
SERGEY015: posts small blind $0.05
Black021: posts big blind $0.10
*** HOLE CARDS ***
mastiko1996: folds 
H514OB: folds 
TakMits: raises $0.12 to $0.22
nickname0105 joins the table at seat #5 
SERGEY015: folds 
Black021: calls $0.12
*** FLOP *** [4d Ks Kc]
Black021: checks 
TakMits: checks 
*** TURN *** [4d Ks Kc] [4h]
Black021: checks 
TakMits: checks 
*** RIVER *** [4d Ks Kc 4h] [Td]
Black021: checks 
mastiko1996 leaves the table
TakMits: bets $0.24
Black021: folds 
Uncalled bet ($0.24) returned to TakMits
TakMits collected $0.47 from pot
TakMits: doesn't show hand 
*** SUMMARY ***
Total pot $0.49 | Rake $0.02 
Board [4d Ks Kc 4h Td]
Seat 1: TakMits (button) collected ($0.47)
Seat 2: SERGEY015 (small blind) folded before Flop
Seat 3: Black021 (big blind) folded on the River
Seat 4: mastiko1996 folded before Flop (didn't bet)
Seat 6: H514OB folded before Flop (didn't bet)



PokerStars Hand #222951643430:  Hold'em No Limit ($0.05/$0.10 USD) - 2021/01/23 7:09:38 ET
Table 'Lutetia III' 6-max Seat #2 is the button
Seat 1: TakMits ($12.33 in chips) 
Seat 2: SERGEY015 ($9.60 in chips) 
Seat 3: Black021 ($10 in chips) 
Seat 5: nickname0105 ($4.46 in chips) 
Seat 6: H514OB ($5.05 in chips) 
Black021: posts small blind $0.05
nickname0105: posts big blind $0.10
*** HOLE CARDS ***
SERG244 joins the table at seat #4 
H514OB has timed out
H514OB: folds 
TakMits: folds 
SERGEY015: folds 
Black021: folds 
Uncalled bet ($0.05) returned to nickname0105
nickname0105 collected $0.10 from pot
nickname0105: doesn't show hand 
*** SUMMARY ***
Total pot $0.10 | Rake $0 
Seat 1: TakMits folded before Flop (didn't bet)
Seat 2: SERGEY015 (button) folded before Flop (didn't bet)
Seat 3: Black021 (small blind) folded before Flop
Seat 5: nickname0105 (big blind) collected ($0.10)
Seat 6: H514OB folded before Flop (didn't bet)



PokerStars Hand #222951648985:  Hold'em No Limit ($0.05/$0.10 USD) - 2021/01/23 7:09:53 ET
Table 'Lutetia III' 6-max Seat #3 is the button
Seat 1: TakMits ($12.33 in chips) 
Seat 2: SERGEY015 ($9.60 in chips) 
Seat 3: Black021 ($10 in chips) 
Seat 5: nickname0105 ($4.51 in chips) 
Seat 6: H514OB ($5.05 in chips) 
nickname0105: posts small blind $0.05
H514OB: posts big blind $0.10
*** HOLE CARDS ***
TakMits: folds 
SERGEY015: folds 
Black021: raises $0.12 to $0.22
nickname0105: calls $0.17
H514OB: folds 
*** FLOP *** [5s 8h 6s]
nickname0105: checks 
Black021: checks 
*** TURN *** [5s 8h 6s] [Tc]
nickname0105: checks 
Black021: bets $0.30
nickname0105: folds 
Uncalled bet ($0.30) returned to Black021
Black021 collected $0.52 from pot
Black021: doesn't show hand 
*** SUMMARY ***
Total pot $0.54 | Rake $0.02 
Board [5s 8h 6s Tc]
Seat 1: TakMits folded before Flop (didn't bet)
Seat 2: SERGEY015 folded before Flop (didn't bet)
Seat 3: Black021 (button) collected ($0.52)
Seat 5: nickname0105 (small blind) folded on the Turn
Seat 6: H514OB (big blind) folded before Flop



PokerStars Hand #222951659165:  Hold'em No Limit ($0.05/$0.10 USD) - 2021/01/23 7:10:22 ET
Table 'Lutetia III' 6-max Seat #5 is the button
Seat 1: TakMits ($12.33 in chips) 
Seat 2: SERGEY015 ($9.60 in chips) 
Seat 3: Black021 ($10.30 in chips) 
Seat 5: nickname0105 ($4.29 in chips) 
Seat 6: H514OB ($4.95 in chips) 
H514OB: posts small blind $0.05
TakMits: posts big blind $0.10
SERG244: sits out 
*** HOLE CARDS ***
SERGEY015: folds 
Black021: folds 
nickname0105: raises $0.10 to $0.20
H514OB: folds 
TakMits: raises $0.80 to $1
nickname0105: raises $3.29 to $4.29 and is all-in
TakMits: calls $3.29
*** FLOP *** [8c 5s 6s]
*** TURN *** [8c 5s 6s] [Qh]
*** RIVER *** [8c 5s 6s Qh] [Ah]
*** SHOW DOWN ***
TakMits: shows [Td Th] (a pair of Tens)
nickname0105: shows [Kh 2h] (high card Ace)
TakMits collected $8.24 from pot
*** SUMMARY ***
Total pot $8.63 | Rake $0.39 
Board [8c 5s 6s Qh Ah]
Seat 1: TakMits (big blind) showed [Td Th] and won ($8.24) with a pair of Tens
Seat 2: SERGEY015 folded before Flop (didn't bet)
Seat 3: Black021 folded before Flop (didn't bet)
Seat 5: nickname0105 (button) showed [Kh 2h] and lost with high card Ace
Seat 6: H514OB (small blind) folded before Flop



PokerStars Hand #222951670340:  Hold'em No Limit ($0.05/$0.10 USD) - 2021/01/23 7:10:52 ET
Table 'Lutetia III' 6-max Seat #6 is the button
Seat 1: TakMits ($16.28 in chips) 
Seat 2: SERGEY015 ($9.60 in chips) 
Seat 3: Black021 ($10.30 in chips) 
Seat 6: H514OB ($4.90 in chips) 
TakMits: posts small blind $0.05
SERGEY015: posts big blind $0.10
SERG244: sits out 
*** HOLE CARDS ***
Black021: folds 
H514OB: raises $0.15 to $0.25
TakMits: folds 
SERGEY015: folds 
Uncalled bet ($0.15) returned to H514OB
H514OB collected $0.25 from pot
H514OB: doesn't show hand 
*** SUMMARY ***
Total pot $0.25 | Rake $0 
Seat 1: TakMits (small blind) folded before Flop
Seat 2: SERGEY015 (big blind) folded before Flop
Seat 3: Black021 folded before Flop (didn't bet)
Seat 6: H514OB (button) collected ($0.25)



PokerStars Hand #222951673766:  Hold'em No Limit ($0.05/$0.10 USD) - 2021/01/23 7:11:02 ET
Table 'Lutetia III' 6-max Seat #1 is the button
Seat 1: TakMits ($16.23 in chips) 
Seat 2: SERGEY015 ($9.50 in chips) 
Seat 4: SERG244 ($10 in chips) 
Seat 6: H514OB ($5.05 in chips) 
SERGEY015: posts small blind $0.05
Black021: is sitting out 
SERG244: posts big blind $0.10
*** HOLE CARDS ***
H514OB: calls $0.10
TakMits: folds 
SERGEY015: folds 
SERG244: checks 
*** FLOP *** [9d 4d 9s]
SERG244: checks 
Black021 leaves the table
H514OB: bets $0.10
nickname0105 is disconnected 
SERG244: folds 
Uncalled bet ($0.10) returned to H514OB
H514OB collected $0.24 from pot
H514OB: doesn't show hand 
*** SUMMARY ***
Total pot $0.25 | Rake $0.01 
Board [9d 4d 9s]
Seat 1: TakMits (button) folded before Flop (didn't bet)
Seat 2: SERGEY015 (small blind) folded before Flop
Seat 4: SERG244 (big blind) folded on the Flop
Seat 6: H514OB collected ($0.24)



PokerStars Hand #222951679741:  Hold'em No Limit ($0.05/$0.10 USD) - 2021/01/23 7:11:18 ET
Table 'Lutetia III' 6-max Seat #2 is the button
Seat 1: TakMits ($16.23 in chips) 
Seat 2: SERGEY015 ($9.45 in chips) 
Seat 4: SERG244 ($10 in chips) 
Seat 6: H514OB ($5.19 in chips) 
SERG244: posts small blind $0.05
H514OB: posts big blind $0.10
*** HOLE CARDS ***
TakMits: folds 
SERGEY015: folds 
xulfster joins the table at seat #3 
SERG244: folds 
Uncalled bet ($0.05) returned to H514OB
H514OB collected $0.10 from pot
H514OB: doesn't show hand 
*** SUMMARY ***
Total pot $0.10 | Rake $0 
Seat 1: TakMits folded before Flop (didn't bet)
Seat 2: SERGEY015 (button) folded before Flop (didn't bet)
Seat 4: SERG244 (small blind) folded before Flop
Seat 6: H514OB (big blind) collected ($0.10)



PokerStars Hand #222951683461:  Hold'em No Limit ($0.05/$0.10 USD) - 2021/01/23 7:11:28 ET
Table 'Lutetia III' 6-max Seat #4 is the button
Seat 1: TakMits ($16.23 in chips) 
Seat 2: SERGEY015 ($9.45 in chips) 
Seat 4: SERG244 ($10 in chips) 
Seat 6: H514OB ($5.24 in chips) 
H514OB: posts small blind $0.05
TakMits: posts big blind $0.10
xulfster: sits out 
*** HOLE CARDS ***
SERGEY015: folds 
SERG244: raises $0.16 to $0.26
H514OB: folds 
TakMits: folds 
Uncalled bet ($0.16) returned to SERG244
SERG244 collected $0.25 from pot
SERG244: doesn't show hand 
*** SUMMARY ***
Total pot $0.25 | Rake $0 
Seat 1: TakMits (big blind) folded before Flop
Seat 2: SERGEY015 folded before Flop (didn't bet)
Seat 4: SERG244 (button) collected ($0.25)
Seat 6: H514OB (small blind) folded before Flop



PokerStars Hand #222951686915:  Hold'em No Limit ($0.05/$0.10 USD) - 2021/01/23 7:11:37 ET
Table 'Lutetia III' 6-max Seat #6 is the button
Seat 1: TakMits ($16.13 in chips) 
Seat 2: SERGEY015 ($9.45 in chips) 
Seat 4: SERG244 ($10.15 in chips) 
Seat 6: H514OB ($5.19 in chips) 
TakMits: posts small blind $0.05
SERGEY015: posts big blind $0.10
xulfster: sits out 
*** HOLE CARDS ***
SERG244: folds 
H514OB: folds 
TakMits: folds 
Uncalled bet ($0.05) returned to SERGEY015
SERGEY015 collected $0.10 from pot
SERGEY015: doesn't show hand 
*** SUMMARY ***
Total pot $0.10 | Rake $0 
Seat 1: TakMits (small blind) folded before Flop
Seat 2: SERGEY015 (big blind) collected ($0.10)
Seat 4: SERG244 folded before Flop (didn't bet)
Seat 6: H514OB (button) folded before Flop (didn't bet)



PokerStars Hand #222951690232:  Hold'em No Limit ($0.05/$0.10 USD) - 2021/01/23 7:11:46 ET
Table 'Lutetia III' 6-max Seat #1 is the button
Seat 1: TakMits ($16.08 in chips) 
Seat 2: SERGEY015 ($9.50 in chips) 
Seat 3: xulfster ($10 in chips) 
Seat 4: SERG244 ($10.15 in chips) 
Seat 6: H514OB ($5.19 in chips) 
SERGEY015: posts small blind $0.05
xulfster: posts big blind $0.10
*** HOLE CARDS ***
SERG244: folds 
SERG244 leaves the table
H514OB: raises $0.15 to $0.25
TakMits: folds 
SERGEY015: folds 
Kalmar333 joins the table at seat #4 
xulfster: calls $0.15
*** FLOP *** [Ad 6h Ks]
xulfster: checks 
H514OB: bets $0.17
xulfster: calls $0.17
*** TURN *** [Ad 6h Ks] [Kh]
xulfster: checks 
H514OB: checks 
*** RIVER *** [Ad 6h Ks Kh] [Qd]
xulfster: bets $0.50
H514OB: folds 
Uncalled bet ($0.50) returned to xulfster
xulfster collected $0.85 from pot
*** SUMMARY ***
Total pot $0.89 | Rake $0.04 
Board [Ad 6h Ks Kh Qd]
Seat 1: TakMits (button) folded before Flop (didn't bet)
Seat 2: SERGEY015 (small blind) folded before Flop
Seat 3: xulfster (big blind) collected ($0.85)
Seat 4: SERG244 folded before Flop (didn't bet)
Seat 6: H514OB folded on the River



PokerStars Hand #222952080278:  Hold'em No Limit ($0.05/$0.10 USD) - 2021/01/23 7:29:05 ET
Table 'Lutetia III' 6-max Seat #3 is the button
Seat 1: Dugipokers ($10 in chips) 
Seat 2: SERGEY015 ($9.80 in chips) 
Seat 3: bliznec828 ($10 in chips) 
Seat 4: Kalmar333 ($10.85 in chips) 
Seat 5: Brownie979 ($9.17 in chips) 
Seat 6: H514OB ($7.64 in chips) 
Kalmar333: posts small blind $0.05
Brownie979: posts big blind $0.10
*** HOLE CARDS ***
H514OB has timed out
H514OB: folds 
Dugipokers: folds 
SERGEY015: folds 
bliznec828: folds 
Kalmar333: folds 
Uncalled bet ($0.05) returned to Brownie979
Brownie979 collected $0.10 from pot
Brownie979: doesn't show hand 
*** SUMMARY ***
Total pot $0.10 | Rake $0 
Seat 1: Dugipokers folded before Flop (didn't bet)
Seat 2: SERGEY015 folded before Flop (didn't bet)
Seat 3: bliznec828 (button) folded before Flop (didn't bet)
Seat 4: Kalmar333 (small blind) folded before Flop
Seat 5: Brownie979 (big blind) collected ($0.10)
Seat 6: H514OB folded before Flop (didn't bet)



PokerStars Hand #222952087002:  Hold'em No Limit ($0.05/$0.10 USD) - 2021/01/23 7:29:23 ET
Table 'Lutetia III' 6-max Seat #4 is the button
Seat 1: Dugipokers ($10 in chips) 
Seat 2: SERGEY015 ($9.80 in chips) 
Seat 3: bliznec828 ($10 in chips) 
Seat 4: Kalmar333 ($10.80 in chips) 
Seat 5: Brownie979 ($9.22 in chips) 
Brownie979: posts small blind $0.05
Dugipokers: posts big blind $0.10
*** HOLE CARDS ***
SERGEY015: folds 
bliznec828: raises $0.15 to $0.25
Kalmar333: folds 
Brownie979: calls $0.20
Dugipokers: calls $0.15
*** FLOP *** [4c 9h 8c]
Brownie979: checks 
Dugipokers: checks 
bliznec828: bets $0.24
Brownie979: calls $0.24
Dugipokers: calls $0.24
*** TURN *** [4c 9h 8c] [9d]
Brownie979: checks 
Dugipokers: checks 
bliznec828: bets $0.93
Brownie979: calls $0.93
Dugipokers: folds 
*** RIVER *** [4c 9h 8c 9d] [4d]
Brownie979: checks 
bliznec828: checks 
*** SHOW DOWN ***
Brownie979: shows [Jd 6s] (two pair, Nines and Fours)
bliznec828: shows [Kc Ac] (two pair, Nines and Fours - Ace kicker)
bliznec828 collected $3.18 from pot
*** SUMMARY ***
Total pot $3.33 | Rake $0.15 
Board [4c 9h 8c 9d 4d]
Seat 1: Dugipokers (big blind) folded on the Turn
Seat 2: SERGEY015 folded before Flop (didn't bet)
Seat 3: bliznec828 showed [Kc Ac] and won ($3.18) with two pair, Nines and Fours
Seat 4: Kalmar333 (button) folded before Flop (didn't bet)
Seat 5: Brownie979 (small blind) showed [Jd 6s] and lost with two pair, Nines and Fours



PokerStars Hand #222952109783:  Hold'em No Limit ($0.05/$0.10 USD) - 2021/01/23 7:30:25 ET
Table 'Lutetia III' 6-max Seat #5 is the button
Seat 1: Dugipokers ($10 in chips) 
Seat 2: SERGEY015 ($9.80 in chips) 
Seat 3: bliznec828 ($11.76 in chips) 
Seat 4: Kalmar333 ($10.80 in chips) 
Seat 5: Brownie979 ($7.80 in chips) 
Dugipokers: posts small blind $0.05
SERGEY015: posts big blind $0.10
*** HOLE CARDS ***
bliznec828: folds 
Kalmar333: folds 
Brownie979: calls $0.10
Dugipokers: folds 
SERGEY015: checks 
*** FLOP *** [4h 9h 6h]
SERGEY015: checks 
Brownie979: checks 
*** TURN *** [4h 9h 6h] [Td]
SERGEY015: checks 
Brownie979: checks 
*** RIVER *** [4h 9h 6h Td] [6c]
SERGEY015: checks 
Brownie979: bets $0.20
SERGEY015: folds 
Uncalled bet ($0.20) returned to Brownie979
Brownie979 collected $0.24 from pot
Brownie979: doesn't show hand 
*** SUMMARY ***
Total pot $0.25 | Rake $0.01 
Board [4h 9h 6h Td 6c]
Seat 1: Dugipokers (small blind) folded before Flop
Seat 2: SERGEY015 (big blind) folded on the River
Seat 3: bliznec828 folded before Flop (didn't bet)
Seat 4: Kalmar333 folded before Flop (didn't bet)
Seat 5: Brownie979 (button) collected ($0.24)



PokerStars Hand #222952121890:  Hold'em No Limit ($0.05/$0.10 USD) - 2021/01/23 7:30:58 ET
Table 'Lutetia III' 6-max Seat #1 is the button
Seat 1: Dugipokers ($10 in chips) 
Seat 2: SERGEY015 ($9.70 in chips) 
Seat 3: bliznec828 ($11.76 in chips) 
Seat 4: Kalmar333 ($10.80 in chips) 
Seat 5: Brownie979 ($7.94 in chips) 
SERGEY015: posts small blind $0.05
bliznec828: posts big blind $0.10
H514OB: sits out 
*** HOLE CARDS ***
Kalmar333 has timed out
Kalmar333: folds 
Brownie979: calls $0.10
Dugipokers: raises $0.30 to $0.40
H514OB leaves the table
SERGEY015: folds 
bliznec828: raises $1.10 to $1.50
Brownie979: folds 
Lergik joins the table at seat #6 
Dugipokers: folds 
Uncalled bet ($1.10) returned to bliznec828
bliznec828 collected $0.95 from pot
bliznec828: doesn't show hand 
*** SUMMARY ***
Total pot $0.95 | Rake $0 
Seat 1: Dugipokers (button) folded before Flop
Seat 2: SERGEY015 (small blind) folded before Flop
Seat 3: bliznec828 (big blind) collected ($0.95)
Seat 4: Kalmar333 folded before Flop (didn't bet)
Seat 5: Brownie979 folded before Flop



PokerStars Hand #222952133990:  Hold'em No Limit ($0.05/$0.10 USD) - 2021/01/23 7:31:31 ET
Table 'Lutetia III' 6-max Seat #2 is the button
Seat 1: Dugipokers ($10 in chips) 
Seat 2: SERGEY015 ($9.65 in chips) 
Seat 3: bliznec828 ($12.31 in chips) 
Seat 4: Kalmar333 ($10.80 in chips) 
Seat 5: Brownie979 ($7.84 in chips) 
bliznec828: posts small blind $0.05
Kalmar333: posts big blind $0.10
Lergik: sits out 
*** HOLE CARDS ***
Brownie979: calls $0.10
Dugipokers: raises $0.30 to $0.40
SERGEY015: folds 
bliznec828: folds 
Kalmar333: folds 
Brownie979: calls $0.30
*** FLOP *** [4c Ac 3c]
Brownie979: checks 
Dugipokers: bets $0.30
Brownie979: calls $0.30
*** TURN *** [4c Ac 3c] [9d]
Brownie979: checks 
Dugipokers: bets $1.12
Brownie979: folds 
Uncalled bet ($1.12) returned to Dugipokers
Dugipokers collected $1.48 from pot
Dugipokers: doesn't show hand 
*** SUMMARY ***
Total pot $1.55 | Rake $0.07 
Board [4c Ac 3c 9d]
Seat 1: Dugipokers collected ($1.48)
Seat 2: SERGEY015 (button) folded before Flop (didn't bet)
Seat 3: bliznec828 (small blind) folded before Flop
Seat 4: Kalmar333 (big blind) folded before Flop
Seat 5: Brownie979 folded on the Turn



PokerStars Hand #222952144946:  Hold'em No Limit ($0.05/$0.10 USD) - 2021/01/23 7:32:01 ET
Table 'Lutetia III' 6-max Seat #3 is the button
Seat 1: Dugipokers ($10.78 in chips) 
Seat 2: SERGEY015 ($9.65 in chips) 
Seat 3: bliznec828 ($12.26 in chips) 
Seat 4: Kalmar333 ($10.70 in chips) 
Seat 5: Brownie979 ($7.14 in chips) 
Kalmar333: posts small blind $0.05
Brownie979: posts big blind $0.10
Lergik: sits out 
*** HOLE CARDS ***
Dugipokers: folds 
SERGEY015: folds 
bliznec828: raises $0.15 to $0.25
Kalmar333: folds 
Brownie979: calls $0.15
*** FLOP *** [Th Ks Jh]
Brownie979: checks 
bliznec828: bets $0.17
Brownie979: calls $0.17
*** TURN *** [Th Ks Jh] [3s]
Brownie979: checks 
bliznec828: bets $0.57
Brownie979: calls $0.57
*** RIVER *** [Th Ks Jh 3s] [3h]
Brownie979: checks 
bliznec828: bets $1.94
Brownie979: folds 
Uncalled bet ($1.94) returned to bliznec828
bliznec828 collected $1.94 from pot
bliznec828: doesn't show hand 
*** SUMMARY ***
Total pot $2.03 | Rake $0.09 
Board [Th Ks Jh 3s 3h]
Seat 1: Dugipokers folded before Flop (didn't bet)
Seat 2: SERGEY015 folded before Flop (didn't bet)
Seat 3: bliznec828 (button) collected ($1.94)
Seat 4: Kalmar333 (small blind) folded before Flop
Seat 5: Brownie979 (big blind) folded on the River



PokerStars Hand #222952155381:  Hold'em No Limit ($0.05/$0.10 USD) - 2021/01/23 7:32:29 ET
Table 'Lutetia III' 6-max Seat #4 is the button
Seat 1: Dugipokers ($10.78 in chips) 
Seat 2: SERGEY015 ($9.65 in chips) 
Seat 3: bliznec828 ($13.21 in chips) 
Seat 4: Kalmar333 ($10.65 in chips) 
Seat 5: Brownie979 ($6.15 in chips) 
Seat 6: Lergik ($10 in chips) 
Brownie979: posts small blind $0.05
Lergik: posts big blind $0.10
*** HOLE CARDS ***
Dugipokers: folds 
SERGEY015: folds 
bliznec828: folds 
Kalmar333: folds 
Brownie979: calls $0.05
Lergik: checks 
*** FLOP *** [8s 9d Qs]
Brownie979: checks 
Lergik: checks 
*** TURN *** [8s 9d Qs] [Ts]
Brownie979: checks 
Lergik: checks 
*** RIVER *** [8s 9d Qs Ts] [5s]
Brownie979: bets $0.19
Lergik: folds 
Uncalled bet ($0.19) returned to Brownie979
Brownie979 collected $0.19 from pot
Brownie979: doesn't show hand 
*** SUMMARY ***
Total pot $0.20 | Rake $0.01 
Board [8s 9d Qs Ts 5s]
Seat 1: Dugipokers folded before Flop (didn't bet)
Seat 2: SERGEY015 folded before Flop (didn't bet)
Seat 3: bliznec828 folded before Flop (didn't bet)
Seat 4: Kalmar333 (button) folded before Flop (didn't bet)
Seat 5: Brownie979 (small blind) collected ($0.19)
Seat 6: Lergik (big blind) folded on the River



PokerStars Hand #222952166402:  Hold'em No Limit ($0.05/$0.10 USD) - 2021/01/23 7:32:58 ET
Table 'Lutetia III' 6-max Seat #5 is the button
Seat 1: Dugipokers ($10.78 in chips) 
Seat 2: SERGEY015 ($9.65 in chips) 
Seat 3: bliznec828 ($13.21 in chips) 
Seat 4: Kalmar333 ($10.65 in chips) 
Seat 5: Brownie979 ($6.24 in chips) 
Seat 6: Lergik ($10 in chips) 
Lergik: posts small blind $0.05
Dugipokers: posts big blind $0.10
*** HOLE CARDS ***
SERGEY015: folds 
bliznec828: raises $0.20 to $0.30
Kalmar333: folds 
Brownie979: calls $0.30
Lergik: folds 
Dugipokers: calls $0.20
*** FLOP *** [Ad Jc 4h]
Dugipokers: checks 
bliznec828: checks 
Brownie979: checks 
*** TURN *** [Ad Jc 4h] [Ah]
Dugipokers: checks 
bliznec828: bets $0.61
Brownie979: folds 
Dugipokers: folds 
Uncalled bet ($0.61) returned to bliznec828
bliznec828 collected $0.91 from pot
bliznec828: doesn't show hand 
*** SUMMARY ***
Total pot $0.95 | Rake $0.04 
Board [Ad Jc 4h Ah]
Seat 1: Dugipokers (big blind) folded on the Turn
Seat 2: SERGEY015 folded before Flop (didn't bet)
Seat 3: bliznec828 collected ($0.91)
Seat 4: Kalmar333 folded before Flop (didn't bet)
Seat 5: Brownie979 (button) folded on the Turn
Seat 6: Lergik (small blind) folded before Flop



PokerStars Hand #222952184263:  Hold'em No Limit ($0.05/$0.10 USD) - 2021/01/23 7:33:47 ET
Table 'Lutetia III' 6-max Seat #6 is the button
Seat 1: Dugipokers ($10.48 in chips) 
Seat 2: SERGEY015 ($9.65 in chips) 
Seat 3: bliznec828 ($13.82 in chips) 
Seat 4: Kalmar333 ($10.65 in chips) 
Seat 5: Brownie979 ($5.94 in chips) 
Seat 6: Lergik ($10 in chips) 
Dugipokers: posts small blind $0.05
SERGEY015: posts big blind $0.10
*** HOLE CARDS ***
bliznec828: folds 
Kalmar333: folds 
Brownie979: calls $0.10
Lergik: folds 
Dugipokers: calls $0.05
SERGEY015: checks 
*** FLOP *** [Ks 7h 9c]
Dugipokers: checks 
SERGEY015: checks 
Brownie979: checks 
*** TURN *** [Ks 7h 9c] [6d]
Dugipokers: checks 
SERGEY015: checks 
Brownie979: checks 
*** RIVER *** [Ks 7h 9c 6d] [Tc]
Dugipokers: checks 
SERGEY015: checks 
Brownie979: bets $0.29
Dugipokers: folds 
SERGEY015: folds 
Uncalled bet ($0.29) returned to Brownie979
Brownie979 collected $0.29 from pot
Brownie979: doesn't show hand 
*** SUMMARY ***
Total pot $0.30 | Rake $0.01 
Board [Ks 7h 9c 6d Tc]
Seat 1: Dugipokers (small blind) folded on the River
Seat 2: SERGEY015 (big blind) folded on the River
Seat 3: bliznec828 folded before Flop (didn't bet)
Seat 4: Kalmar333 folded before Flop (didn't bet)
Seat 5: Brownie979 collected ($0.29)
Seat 6: Lergik (button) folded before Flop (didn't bet)



PokerStars Hand #222952201840:  Hold'em No Limit ($0.05/$0.10 USD) - 2021/01/23 7:34:34 ET
Table 'Lutetia III' 6-max Seat #1 is the button
Seat 1: Dugipokers ($10.38 in chips) 
Seat 2: SERGEY015 ($9.55 in chips) 
Seat 3: bliznec828 ($13.82 in chips) 
Seat 4: Kalmar333 ($10.65 in chips) 
Seat 5: Brownie979 ($6.13 in chips) 
Seat 6: Lergik ($10 in chips) 
SERGEY015: posts small blind $0.05
bliznec828: posts big blind $0.10
*** HOLE CARDS ***
Kalmar333: raises $0.20 to $0.30
Brownie979: folds 
Lergik: folds 
Dugipokers: folds 
SERGEY015: folds 
bliznec828: folds 
Uncalled bet ($0.20) returned to Kalmar333
bliznec828 leaves the table
Kalmar333 collected $0.25 from pot
Kalmar333: doesn't show hand 
*** SUMMARY ***
Total pot $0.25 | Rake $0 
Seat 1: Dugipokers (button) folded before Flop (didn't bet)
Seat 2: SERGEY015 (small blind) folded before Flop
Seat 3: bliznec828 (big blind) folded before Flop
Seat 4: Kalmar333 collected ($0.25)
Seat 5: Brownie979 folded before Flop (didn't bet)
Seat 6: Lergik folded before Flop (didn't bet)



PokerStars Hand #222952207007:  Hold'em No Limit ($0.05/$0.10 USD) - 2021/01/23 7:34:48 ET
Table 'Lutetia III' 6-max Seat #2 is the button
Seat 1: Dugipokers ($10.38 in chips) 
Seat 2: SERGEY015 ($9.50 in chips) 
Seat 4: Kalmar333 ($10.80 in chips) 
Seat 5: Brownie979 ($6.13 in chips) 
Seat 6: Lergik ($10 in chips) 
Kalmar333: posts small blind $0.05
Brownie979: posts big blind $0.10
*** HOLE CARDS ***
guro aye1234 joins the table at seat #3 
Lergik: folds 
Dugipokers: folds 
SERGEY015: folds 
Kalmar333: folds 
Uncalled bet ($0.05) returned to Brownie979
Brownie979 collected $0.10 from pot
Brownie979: doesn't show hand 
*** SUMMARY ***
Total pot $0.10 | Rake $0 
Seat 1: Dugipokers folded before Flop (didn't bet)
Seat 2: SERGEY015 (button) folded before Flop (didn't bet)
Seat 4: Kalmar333 (small blind) folded before Flop
Seat 5: Brownie979 (big blind) collected ($0.10)
Seat 6: Lergik folded before Flop (didn't bet)



PokerStars Hand #222952211969:  Hold'em No Limit ($0.05/$0.10 USD) - 2021/01/23 7:35:01 ET
Table 'Lutetia III' 6-max Seat #4 is the button
Seat 1: Dugipokers ($10.38 in chips) 
Seat 2: SERGEY015 ($9.50 in chips) 
Seat 4: Kalmar333 ($10.75 in chips) 
Seat 5: Brownie979 ($6.18 in chips) 
Seat 6: Lergik ($10 in chips) 
Brownie979: posts small blind $0.05
Lergik: posts big blind $0.10
guro aye1234: sits out 
*** HOLE CARDS ***
Dugipokers: folds 
SERGEY015: folds 
Kalmar333: raises $0.20 to $0.30
Brownie979: calls $0.25
Lergik: folds 
*** FLOP *** [3s 5c Th]
Brownie979: checks 
Kalmar333: bets $0.47
Brownie979: calls $0.47
*** TURN *** [3s 5c Th] [Td]
Brownie979: checks 
Kalmar333: bets $0.79
Brownie979: calls $0.79
*** RIVER *** [3s 5c Th Td] [7d]
Brownie979: checks 
Kalmar333: bets $2.16
Brownie979: raises $2.16 to $4.32
Kalmar333: raises $2.16 to $6.48
Brownie979: calls $0.30 and is all-in
Uncalled bet ($1.86) returned to Kalmar333
*** SHOW DOWN ***
Kalmar333: shows [Ts Ah] (three of a kind, Tens)
Brownie979: shows [Tc 5d] (a full house, Tens full of Fives)
Brownie979 collected $11.90 from pot
*** SUMMARY ***
Total pot $12.46 | Rake $0.56 
Board [3s 5c Th Td 7d]
Seat 1: Dugipokers folded before Flop (didn't bet)
Seat 2: SERGEY015 folded before Flop (didn't bet)
Seat 4: Kalmar333 (button) showed [Ts Ah] and lost with three of a kind, Tens
Seat 5: Brownie979 (small blind) showed [Tc 5d] and won ($11.90) with a full house, Tens full of Fives
Seat 6: Lergik (big blind) folded before Flop



PokerStars Hand #222952229517:  Hold'em No Limit ($0.05/$0.10 USD) - 2021/01/23 7:35:49 ET
Table 'Lutetia III' 6-max Seat #5 is the button
Seat 1: Dugipokers ($10.38 in chips) 
Seat 2: SERGEY015 ($9.50 in chips) 
Seat 4: Kalmar333 ($10 in chips) 
Seat 5: Brownie979 ($11.90 in chips) 
Seat 6: Lergik ($10 in chips) 
Lergik: posts small blind $0.05
Dugipokers: posts big blind $0.10
guro aye1234: sits out 
*** HOLE CARDS ***
SERGEY015: raises $0.20 to $0.30
Kalmar333: folds 
Brownie979: calls $0.30
Lergik: folds 
Dugipokers: folds 
*** FLOP *** [2d Qd 7s]
SERGEY015: bets $0.37
Brownie979: calls $0.37
*** TURN *** [2d Qd 7s] [8h]
SERGEY015: bets $0.80
Brownie979: calls $0.80
*** RIVER *** [2d Qd 7s 8h] [5c]
SERGEY015: bets $2.30
Brownie979: folds 
Uncalled bet ($2.30) returned to SERGEY015
SERGEY015 collected $2.95 from pot
SERGEY015: doesn't show hand 
*** SUMMARY ***
Total pot $3.09 | Rake $0.14 
Board [2d Qd 7s 8h 5c]
Seat 1: Dugipokers (big blind) folded before Flop
Seat 2: SERGEY015 collected ($2.95)
Seat 4: Kalmar333 folded before Flop (didn't bet)
Seat 5: Brownie979 (button) folded on the River
Seat 6: Lergik (small blind) folded before Flop



PokerStars Hand #222952244738:  Hold'em No Limit ($0.05/$0.10 USD) - 2021/01/23 7:36:29 ET
Table 'Lutetia III' 6-max Seat #6 is the button
Seat 1: Dugipokers ($10.28 in chips) 
Seat 2: SERGEY015 ($10.98 in chips) 
Seat 4: Kalmar333 ($10 in chips) 
Seat 5: Brownie979 ($10.43 in chips) 
Seat 6: Lergik ($10 in chips) 
Dugipokers: posts small blind $0.05
SERGEY015: posts big blind $0.10
guro aye1234: sits out 
*** HOLE CARDS ***
Kalmar333 has timed out
Kalmar333: folds 
Brownie979: folds 
Lergik: folds 
Dugipokers: raises $0.20 to $0.30
SERGEY015: folds 
Uncalled bet ($0.20) returned to Dugipokers
Dugipokers collected $0.20 from pot
Dugipokers: doesn't show hand 
*** SUMMARY ***
Total pot $0.20 | Rake $0 
Seat 1: Dugipokers (small blind) collected ($0.20)
Seat 2: SERGEY015 (big blind) folded before Flop
Seat 4: Kalmar333 folded before Flop (didn't bet)
Seat 5: Brownie979 folded before Flop (didn't bet)
Seat 6: Lergik (button) folded before Flop (didn't bet)



PokerStars Hand #222952254889:  Hold'em No Limit ($0.05/$0.10 USD) - 2021/01/23 7:36:56 ET
Table 'Lutetia III' 6-max Seat #1 is the button
Seat 1: Dugipokers ($10.38 in chips) 
Seat 2: SERGEY015 ($10.88 in chips) 
Seat 3: guro aye1234 ($10 in chips) 
Seat 4: Kalmar333 ($10 in chips) 
Seat 5: Brownie979 ($10.43 in chips) 
Seat 6: Lergik ($10 in chips) 
SERGEY015: posts small blind $0.05
guro aye1234: posts big blind $0.10
*** HOLE CARDS ***
Kalmar333: raises $0.20 to $0.30
Brownie979: calls $0.30
Lergik: folds 
Dugipokers: raises $0.90 to $1.20
SERGEY015: calls $1.15
guro aye1234: folds 
Kalmar333: calls $0.90
Brownie979: folds 
*** FLOP *** [2d Qs 3h]
SERGEY015: checks 
Kalmar333: checks 
Dugipokers: bets $1.26
SERGEY015: folds 
Kalmar333: folds 
Uncalled bet ($1.26) returned to Dugipokers
Dugipokers collected $3.82 from pot
Dugipokers: doesn't show hand 
*** SUMMARY ***
Total pot $4 | Rake $0.18 
Board [2d Qs 3h]
Seat 1: Dugipokers (button) collected ($3.82)
Seat 2: SERGEY015 (small blind) folded on the Flop
Seat 3: guro aye1234 (big blind) folded before Flop
Seat 4: Kalmar333 folded on the Flop
Seat 5: Brownie979 folded before Flop
Seat 6: Lergik folded before Flop (didn't bet)



PokerStars Hand #222952272443:  Hold'em No Limit ($0.05/$0.10 USD) - 2021/01/23 7:37:43 ET
Table 'Lutetia III' 6-max Seat #2 is the button
Seat 1: Dugipokers ($13 in chips) 
Seat 2: SERGEY015 ($9.68 in chips) 
Seat 3: guro aye1234 ($10 in chips) 
Seat 4: Kalmar333 ($8.80 in chips) 
Seat 5: Brownie979 ($10.13 in chips) 
Seat 6: Lergik ($10 in chips) 
guro aye1234: posts small blind $0.05
Kalmar333: posts big blind $0.10
*** HOLE CARDS ***
Brownie979: calls $0.10
Lergik: folds 
Dugipokers: folds 
SERGEY015: folds 
guro aye1234: raises $0.30 to $0.40
Kalmar333: folds 
Brownie979: calls $0.30
*** FLOP *** [Td Jh 3c]
guro aye1234: bets $0.28
Brownie979: calls $0.28
*** TURN *** [Td Jh 3c] [5d]
guro aye1234: bets $0.30
Brownie979: calls $0.30
*** RIVER *** [Td Jh 3c 5d] [7d]
guro aye1234: bets $3
Brownie979: folds 
Uncalled bet ($3) returned to guro aye1234
guro aye1234 collected $1.97 from pot
*** SUMMARY ***
Total pot $2.06 | Rake $0.09 
Board [Td Jh 3c 5d 7d]
Seat 1: Dugipokers folded before Flop (didn't bet)
Seat 2: SERGEY015 (button) folded before Flop (didn't bet)
Seat 3: guro aye1234 (small blind) collected ($1.97)
Seat 4: Kalmar333 (big blind) folded before Flop
Seat 5: Brownie979 folded on the River
Seat 6: Lergik folded before Flop (didn't bet)



PokerStars Hand #222952301422:  Hold'em No Limit ($0.05/$0.10 USD) - 2021/01/23 7:39:00 ET
Table 'Lutetia III' 6-max Seat #3 is the button
Seat 1: Dugipokers ($13 in chips) 
Seat 2: SERGEY015 ($9.68 in chips) 
Seat 3: guro aye1234 ($10.99 in chips) 
Seat 4: Kalmar333 ($8.70 in chips) 
Seat 5: Brownie979 ($9.15 in chips) 
Seat 6: Lergik ($10 in chips) 
Kalmar333: posts small blind $0.05
Brownie979: posts big blind $0.10
*** HOLE CARDS ***
Lergik: folds 
Dugipokers: folds 
SERGEY015: folds 
guro aye1234: folds 
Kalmar333: raises $0.20 to $0.30
Brownie979: calls $0.20
*** FLOP *** [Js Qs 2s]
Kalmar333: checks 
Brownie979: checks 
*** TURN *** [Js Qs 2s] [Qd]
Kalmar333: bets $0.40
Brownie979: calls $0.40
*** RIVER *** [Js Qs 2s Qd] [4h]
Kalmar333: checks 
Brownie979: bets $0.60
Kalmar333: calls $0.60
*** SHOW DOWN ***
Brownie979: shows [3s 6d] (a pair of Queens)
Kalmar333: shows [Kc Jd] (two pair, Queens and Jacks)
Kalmar333 collected $2.48 from pot
*** SUMMARY ***
Total pot $2.60 | Rake $0.12 
Board [Js Qs 2s Qd 4h]
Seat 1: Dugipokers folded before Flop (didn't bet)
Seat 2: SERGEY015 folded before Flop (didn't bet)
Seat 3: guro aye1234 (button) folded before Flop (didn't bet)
Seat 4: Kalmar333 (small blind) showed [Kc Jd] and won ($2.48) with two pair, Queens and Jacks
Seat 5: Brownie979 (big blind) showed [3s 6d] and lost with a pair of Queens
Seat 6: Lergik folded before Flop (didn't bet)



PokerStars Hand #222952316615:  Hold'em No Limit ($0.05/$0.10 USD) - 2021/01/23 7:39:40 ET
Table 'Lutetia III' 6-max Seat #4 is the button
Seat 1: Dugipokers ($13 in chips) 
Seat 2: SERGEY015 ($9.68 in chips) 
Seat 3: guro aye1234 ($10.99 in chips) 
Seat 4: Kalmar333 ($9.88 in chips) 
Seat 5: Brownie979 ($7.85 in chips) 
Seat 6: Lergik ($10 in chips) 
Brownie979: posts small blind $0.05
Lergik: posts big blind $0.10
*** HOLE CARDS ***
Dugipokers: folds 
SERGEY015: raises $0.20 to $0.30
guro aye1234: folds 
Kalmar333: calls $0.30
Brownie979: calls $0.25
Lergik: folds 
*** FLOP *** [Qs Tc 3s]
Brownie979: checks 
SERGEY015: checks 
Kalmar333: bets $0.67
Brownie979: folds 
Brownie979 leaves the table
SERGEY015: folds 
Uncalled bet ($0.67) returned to Kalmar333
Kalmar333 collected $0.96 from pot
Kalmar333: doesn't show hand 
*** SUMMARY ***
Total pot $1 | Rake $0.04 
Board [Qs Tc 3s]
Seat 1: Dugipokers folded before Flop (didn't bet)
Seat 2: SERGEY015 folded on the Flop
Seat 3: guro aye1234 folded before Flop (didn't bet)
Seat 4: Kalmar333 (button) collected ($0.96)
Seat 5: Brownie979 (small blind) folded on the Flop
Seat 6: Lergik (big blind) folded before Flop



PokerStars Hand #222952333170:  Hold'em No Limit ($0.05/$0.10 USD) - 2021/01/23 7:40:24 ET
Table 'Lutetia III' 6-max Seat #6 is the button
Seat 1: Dugipokers ($13 in chips) 
Seat 2: SERGEY015 ($9.38 in chips) 
Seat 3: guro aye1234 ($10.99 in chips) 
Seat 4: Kalmar333 ($10.54 in chips) 
Seat 6: Lergik ($10 in chips) 
Dugipokers: posts small blind $0.05
SERGEY015: posts big blind $0.10
*** HOLE CARDS ***
guro aye1234: folds 
Kalmar333: folds 
Lergik: folds 
Dugipokers: raises $0.15 to $0.25
SERGEY015: folds 
Uncalled bet ($0.15) returned to Dugipokers
Dugipokers collected $0.20 from pot
Dugipokers: doesn't show hand 
*** SUMMARY ***
Total pot $0.20 | Rake $0 
Seat 1: Dugipokers (small blind) collected ($0.20)
Seat 2: SERGEY015 (big blind) folded before Flop
Seat 3: guro aye1234 folded before Flop (didn't bet)
Seat 4: Kalmar333 folded before Flop (didn't bet)
Seat 6: Lergik (button) folded before Flop (didn't bet)



PokerStars Hand #222952341152:  Hold'em No Limit ($0.05/$0.10 USD) - 2021/01/23 7:40:46 ET
Table 'Lutetia III' 6-max Seat #1 is the button
Seat 1: Dugipokers ($13.10 in chips) 
Seat 2: SERGEY015 ($9.28 in chips) 
Seat 4: Kalmar333 ($10.54 in chips) 
Seat 6: Lergik ($10 in chips) 
SERGEY015: posts small blind $0.05
guro aye1234: is sitting out 
Kalmar333: posts big blind $0.10
*** HOLE CARDS ***
JerJer1979 joins the table at seat #5 
guro aye1234 leaves the table
Lergik: folds 
Edgarlucky joins the table at seat #3 
Dugipokers: folds 
SERGEY015: raises $0.20 to $0.30
Kalmar333: folds 
Uncalled bet ($0.20) returned to SERGEY015
SERGEY015 collected $0.20 from pot
SERGEY015: doesn't show hand 
*** SUMMARY ***
Total pot $0.20 | Rake $0 
Seat 1: Dugipokers (button) folded before Flop (didn't bet)
Seat 2: SERGEY015 (small blind) collected ($0.20)
Seat 4: Kalmar333 (big blind) folded before Flop
Seat 6: Lergik folded before Flop (didn't bet)



PokerStars Hand #222952348693:  Hold'em No Limit ($0.05/$0.10 USD) - 2021/01/23 7:41:05 ET
Table 'Lutetia III' 6-max Seat #2 is the button
Seat 1: Dugipokers ($13.10 in chips) 
Seat 2: SERGEY015 ($9.38 in chips) 
Seat 4: Kalmar333 ($10.44 in chips) 
Seat 5: JerJer1979 ($10 in chips) 
Seat 6: Lergik ($10 in chips) 
Kalmar333: posts small blind $0.05
JerJer1979: posts big blind $0.10
*** HOLE CARDS ***
Lergik: folds 
Dugipokers: folds 
SERGEY015: folds 
Kalmar333: folds 
Uncalled bet ($0.05) returned to JerJer1979
JerJer1979 collected $0.10 from pot
JerJer1979: doesn't show hand 
*** SUMMARY ***
Total pot $0.10 | Rake $0 
Seat 1: Dugipokers folded before Flop (didn't bet)
Seat 2: SERGEY015 (button) folded before Flop (didn't bet)
Seat 4: Kalmar333 (small blind) folded before Flop
Seat 5: JerJer1979 (big blind) collected ($0.10)
Seat 6: Lergik folded before Flop (didn't bet)



PokerStars Hand #222952351949:  Hold'em No Limit ($0.05/$0.10 USD) - 2021/01/23 7:41:14 ET
Table 'Lutetia III' 6-max Seat #4 is the button
Seat 1: Dugipokers ($13.10 in chips) 
Seat 2: SERGEY015 ($9.38 in chips) 
Seat 4: Kalmar333 ($10.39 in chips) 
Seat 5: JerJer1979 ($10.05 in chips) 
Seat 6: Lergik ($10 in chips) 
JerJer1979: posts small blind $0.05
Lergik: posts big blind $0.10
Edgarlucky: sits out 
*** HOLE CARDS ***
Dugipokers: folds 
SERGEY015: raises $0.20 to $0.30
Kalmar333: folds 
JerJer1979: calls $0.25
Lergik: folds 
*** FLOP *** [4s Js 7c]
JerJer1979: bets $0.33
SERGEY015: folds 
Uncalled bet ($0.33) returned to JerJer1979
JerJer1979 collected $0.67 from pot
JerJer1979: doesn't show hand 
*** SUMMARY ***
Total pot $0.70 | Rake $0.03 
Board [4s Js 7c]
Seat 1: Dugipokers folded before Flop (didn't bet)
Seat 2: SERGEY015 folded on the Flop
Seat 4: Kalmar333 (button) folded before Flop (didn't bet)
Seat 5: JerJer1979 (small blind) collected ($0.67)
Seat 6: Lergik (big blind) folded before Flop



PokerStars Hand #222952361066:  Hold'em No Limit ($0.05/$0.10 USD) - 2021/01/23 7:41:38 ET
Table 'Lutetia III' 6-max Seat #5 is the button
Seat 1: Dugipokers ($13.10 in chips) 
Seat 2: SERGEY015 ($9.08 in chips) 
Seat 4: Kalmar333 ($10.39 in chips) 
Seat 5: JerJer1979 ($10.42 in chips) 
Seat 6: Lergik ($10 in chips) 
Lergik: posts small blind $0.05
Dugipokers: posts big blind $0.10
Edgarlucky: sits out 
*** HOLE CARDS ***
SERGEY015: folds 
Kalmar333: folds 
JerJer1979: folds 
Lergik: folds 
Uncalled bet ($0.05) returned to Dugipokers
Dugipokers collected $0.10 from pot
Dugipokers: doesn't show hand 
*** SUMMARY ***
Total pot $0.10 | Rake $0 
Seat 1: Dugipokers (big blind) collected ($0.10)
Seat 2: SERGEY015 folded before Flop (didn't bet)
Seat 4: Kalmar333 folded before Flop (didn't bet)
Seat 5: JerJer1979 (button) folded before Flop (didn't bet)
Seat 6: Lergik (small blind) folded before Flop



PokerStars Hand #222952366101:  Hold'em No Limit ($0.05/$0.10 USD) - 2021/01/23 7:41:51 ET
Table 'Lutetia III' 6-max Seat #6 is the button
Seat 1: Dugipokers ($13.15 in chips) 
Seat 2: SERGEY015 ($9.08 in chips) 
Seat 4: Kalmar333 ($10.39 in chips) 
Seat 5: JerJer1979 ($10.42 in chips) 
Seat 6: Lergik ($10 in chips) 
Dugipokers: posts small blind $0.05
SERGEY015: posts big blind $0.10
Edgarlucky: sits out 
*** HOLE CARDS ***
Kalmar333: folds 
JerJer1979: calls $0.10
Lergik: raises $0.20 to $0.30
Dugipokers: folds 
SERGEY015: folds 
JerJer1979: calls $0.20
*** FLOP *** [8h Ac 5h]
JerJer1979: checks 
Lergik: bets $0.54
JerJer1979: folds 
Uncalled bet ($0.54) returned to Lergik
Lergik collected $0.72 from pot
*** SUMMARY ***
Total pot $0.75 | Rake $0.03 
Board [8h Ac 5h]
Seat 1: Dugipokers (small blind) folded before Flop
Seat 2: SERGEY015 (big blind) folded before Flop
Seat 4: Kalmar333 folded before Flop (didn't bet)
Seat 5: JerJer1979 folded on the Flop
Seat 6: Lergik (button) collected ($0.72)



PokerStars Hand #222952381312:  Hold'em No Limit ($0.05/$0.10 USD) - 2021/01/23 7:42:32 ET
Table 'Lutetia III' 6-max Seat #1 is the button
Seat 1: Dugipokers ($13.10 in chips) 
Seat 2: SERGEY015 ($8.98 in chips) 
Seat 3: Edgarlucky ($10 in chips) 
Seat 4: Kalmar333 ($10.39 in chips) 
Seat 5: JerJer1979 ($10.12 in chips) 
Seat 6: Lergik ($10.42 in chips) 
SERGEY015: posts small blind $0.05
Edgarlucky: posts big blind $0.10
*** HOLE CARDS ***
Kalmar333: folds 
JerJer1979: calls $0.10
Lergik: folds 
Dugipokers: folds 
SERGEY015: calls $0.05
Edgarlucky: checks 
*** FLOP *** [5s 3h 5h]
SERGEY015: checks 
Edgarlucky: bets $0.15
JerJer1979: calls $0.15
SERGEY015: calls $0.15
*** TURN *** [5s 3h 5h] [Ac]
SERGEY015: checks 
Edgarlucky: bets $0.50
JerJer1979: folds 
SERGEY015: calls $0.50
*** RIVER *** [5s 3h 5h Ac] [Ah]
SERGEY015: checks 
Edgarlucky: bets $1.40
SERGEY015: calls $1.40
*** SHOW DOWN ***
Edgarlucky: shows [4c 7d] (two pair, Aces and Fives)
SERGEY015: shows [Kh 5d] (a full house, Fives full of Aces)
SERGEY015 collected $4.35 from pot
*** SUMMARY ***
Total pot $4.55 | Rake $0.20 
Board [5s 3h 5h Ac Ah]
Seat 1: Dugipokers (button) folded before Flop (didn't bet)
Seat 2: SERGEY015 (small blind) showed [Kh 5d] and won ($4.35) with a full house, Fives full of Aces
Seat 3: Edgarlucky (big blind) showed [4c 7d] and lost with two pair, Aces and Fives
Seat 4: Kalmar333 folded before Flop (didn't bet)
Seat 5: JerJer1979 folded on the Turn
Seat 6: Lergik folded before Flop (didn't bet)



PokerStars Hand #222952400786:  Hold'em No Limit ($0.05/$0.10 USD) - 2021/01/23 7:43:23 ET
Table 'Lutetia III' 6-max Seat #2 is the button
Seat 1: Dugipokers ($13.10 in chips) 
Seat 2: SERGEY015 ($11.18 in chips) 
Seat 3: Edgarlucky ($10 in chips) 
Seat 4: Kalmar333 ($10.39 in chips) 
Seat 5: JerJer1979 ($9.87 in chips) 
Seat 6: Lergik ($10.42 in chips) 
Edgarlucky: posts small blind $0.05
Kalmar333: posts big blind $0.10
*** HOLE CARDS ***
JerJer1979 has timed out
JerJer1979: folds 
Lergik: folds 
Dugipokers: folds 
SERGEY015: raises $0.20 to $0.30
Edgarlucky: folds 
Kalmar333: raises $0.80 to $1.10
SERGEY015: folds 
Uncalled bet ($0.80) returned to Kalmar333
Kalmar333 collected $0.65 from pot
Kalmar333: doesn't show hand 
*** SUMMARY ***
Total pot $0.65 | Rake $0 
Seat 1: Dugipokers folded before Flop (didn't bet)
Seat 2: SERGEY015 (button) folded before Flop
Seat 3: Edgarlucky (small blind) folded before Flop
Seat 4: Kalmar333 (big blind) collected ($0.65)
Seat 5: JerJer1979 folded before Flop (didn't bet)
Seat 6: Lergik folded before Flop (didn't bet)



PokerStars Hand #222954404610:  Hold'em No Limit ($0.05/$0.10 USD) - 2021/01/23 9:03:30 ET
Table 'Lutetia III' 6-max Seat #4 is the button
Seat 2: pernth ($7.52 in chips) 
Seat 4: Mazerpelt ($12.92 in chips) 
Seat 5: AzulAzul999 ($10 in chips) 
Seat 6: Squashy22 ($13.05 in chips) 
AzulAzul999: posts small blind $0.05
Squashy22: posts big blind $0.10
Calltossen: sits out 
*** HOLE CARDS ***
pernth: folds 
Mazerpelt: folds 
AzulAzul999: raises $0.20 to $0.30
Squashy22: folds 
Uncalled bet ($0.20) returned to AzulAzul999
AzulAzul999 collected $0.20 from pot
AzulAzul999: doesn't show hand 
*** SUMMARY ***
Total pot $0.20 | Rake $0 
Seat 2: pernth folded before Flop (didn't bet)
Seat 4: Mazerpelt (button) folded before Flop (didn't bet)
Seat 5: AzulAzul999 (small blind) collected ($0.20)
Seat 6: Squashy22 (big blind) folded before Flop



PokerStars Hand #222954036469:  Hold'em No Limit ($0.05/$0.10 USD) - 2021/01/23 8:49:17 ET
Table 'Lutetia III' 6-max Seat #4 is the button
Seat 1: Proper-tilted ($6.63 in chips) 
Seat 2: pernth ($6.90 in chips) 
Seat 3: YuYuYu777 ($18.93 in chips) 
Seat 4: Mazerpelt ($11.23 in chips) 
Seat 5: Metalaito ($10 in chips) 
Seat 6: Squashy22 ($10.89 in chips) 
Metalaito: posts small blind $0.05
Squashy22: posts big blind $0.10
*** HOLE CARDS ***
Proper-tilted: raises $0.20 to $0.30
pernth: calls $0.30
YuYuYu777: calls $0.30
Mazerpelt: folds 
Metalaito: calls $0.25
Squashy22: folds 
*** FLOP *** [8d 2h 3h]
Metalaito: checks 
Proper-tilted: checks 
pernth: bets $0.50
YuYuYu777: folds 
Metalaito: folds 
Proper-tilted: folds 
Uncalled bet ($0.50) returned to pernth
pernth collected $1.24 from pot
pernth: doesn't show hand 
*** SUMMARY ***
Total pot $1.30 | Rake $0.06 
Board [8d 2h 3h]
Seat 1: Proper-tilted folded on the Flop
Seat 2: pernth collected ($1.24)
Seat 3: YuYuYu777 folded on the Flop
Seat 4: Mazerpelt (button) folded before Flop (didn't bet)
Seat 5: Metalaito (small blind) folded on the Flop
Seat 6: Squashy22 (big blind) folded before Flop



PokerStars Hand #222954061065:  Hold'em No Limit ($0.05/$0.10 USD) - 2021/01/23 8:50:10 ET
Table 'Lutetia III' 6-max Seat #5 is the button
Seat 1: Proper-tilted ($6.33 in chips) 
Seat 2: pernth ($7.84 in chips) 
Seat 3: YuYuYu777 ($18.63 in chips) 
Seat 4: Mazerpelt ($11.23 in chips) 
Seat 5: Metalaito ($10 in chips) 
Seat 6: Squashy22 ($10.79 in chips) 
Squashy22: posts small blind $0.05
Proper-tilted: posts big blind $0.10
*** HOLE CARDS ***
pernth: folds 
YuYuYu777: folds 
Mazerpelt: folds 
Metalaito: raises $0.20 to $0.30
Squashy22: folds 
Proper-tilted: folds 
Uncalled bet ($0.20) returned to Metalaito
Metalaito collected $0.25 from pot
*** SUMMARY ***
Total pot $0.25 | Rake $0 
Seat 1: Proper-tilted (big blind) folded before Flop
Seat 2: pernth folded before Flop (didn't bet)
Seat 3: YuYuYu777 folded before Flop (didn't bet)
Seat 4: Mazerpelt folded before Flop (didn't bet)
Seat 5: Metalaito (button) collected ($0.25)
Seat 6: Squashy22 (small blind) folded before Flop



PokerStars Hand #222954065770:  Hold'em No Limit ($0.05/$0.10 USD) - 2021/01/23 8:50:21 ET
Table 'Lutetia III' 6-max Seat #6 is the button
Seat 1: Proper-tilted ($6.23 in chips) 
Seat 2: pernth ($7.84 in chips) 
Seat 3: YuYuYu777 ($18.63 in chips) 
Seat 4: Mazerpelt ($11.23 in chips) 
Seat 5: Metalaito ($10.15 in chips) 
Seat 6: Squashy22 ($10.74 in chips) 
Proper-tilted: posts small blind $0.05
pernth: posts big blind $0.10
*** HOLE CARDS ***
YuYuYu777: folds 
Mazerpelt: folds 
Metalaito: folds 
Squashy22: folds 
Proper-tilted: folds 
Uncalled bet ($0.05) returned to pernth
pernth collected $0.10 from pot
pernth: doesn't show hand 
*** SUMMARY ***
Total pot $0.10 | Rake $0 
Seat 1: Proper-tilted (small blind) folded before Flop
Seat 2: pernth (big blind) collected ($0.10)
Seat 3: YuYuYu777 folded before Flop (didn't bet)
Seat 4: Mazerpelt folded before Flop (didn't bet)
Seat 5: Metalaito folded before Flop (didn't bet)
Seat 6: Squashy22 (button) folded before Flop (didn't bet)



PokerStars Hand #222954068861:  Hold'em No Limit ($0.05/$0.10 USD) - 2021/01/23 8:50:27 ET
Table 'Lutetia III' 6-max Seat #1 is the button
Seat 1: Proper-tilted ($6.18 in chips) 
Seat 2: pernth ($7.89 in chips) 
Seat 3: YuYuYu777 ($18.63 in chips) 
Seat 4: Mazerpelt ($11.23 in chips) 
Seat 5: Metalaito ($10.15 in chips) 
Seat 6: Squashy22 ($10.74 in chips) 
pernth: posts small blind $0.05
YuYuYu777: posts big blind $0.10
*** HOLE CARDS ***
Mazerpelt: folds 
Metalaito: folds 
Squashy22: folds 
Proper-tilted: raises $0.10 to $0.20
pernth: raises $0.10 to $0.30
YuYuYu777: folds 
Proper-tilted: calls $0.10
*** FLOP *** [6c Js Kd]
pernth: bets $0.40
Proper-tilted: calls $0.40
*** TURN *** [6c Js Kd] [9d]
pernth: bets $0.72
Proper-tilted: folds 
Uncalled bet ($0.72) returned to pernth
pernth collected $1.43 from pot
pernth: doesn't show hand 
*** SUMMARY ***
Total pot $1.50 | Rake $0.07 
Board [6c Js Kd 9d]
Seat 1: Proper-tilted (button) folded on the Turn
Seat 2: pernth (small blind) collected ($1.43)
Seat 3: YuYuYu777 (big blind) folded before Flop
Seat 4: Mazerpelt folded before Flop (didn't bet)
Seat 5: Metalaito folded before Flop (didn't bet)
Seat 6: Squashy22 folded before Flop (didn't bet)



PokerStars Hand #222954080806:  Hold'em No Limit ($0.05/$0.10 USD) - 2021/01/23 8:50:53 ET
Table 'Lutetia III' 6-max Seat #2 is the button
Seat 1: Proper-tilted ($5.48 in chips) 
Seat 2: pernth ($8.62 in chips) 
Seat 3: YuYuYu777 ($18.53 in chips) 
Seat 4: Mazerpelt ($11.23 in chips) 
Seat 5: Metalaito ($10.15 in chips) 
Seat 6: Squashy22 ($10.74 in chips) 
YuYuYu777: posts small blind $0.05
Mazerpelt: posts big blind $0.10
*** HOLE CARDS ***
Metalaito: folds 
Squashy22: raises $0.19 to $0.29
Proper-tilted: folds 
pernth: calls $0.29
YuYuYu777: folds 
Mazerpelt: folds 
*** FLOP *** [Qd 4d 2d]
Squashy22: bets $0.50
pernth: folds 
Uncalled bet ($0.50) returned to Squashy22
Squashy22 collected $0.70 from pot
Squashy22: doesn't show hand 
*** SUMMARY ***
Total pot $0.73 | Rake $0.03 
Board [Qd 4d 2d]
Seat 1: Proper-tilted folded before Flop (didn't bet)
Seat 2: pernth (button) folded on the Flop
Seat 3: YuYuYu777 (small blind) folded before Flop
Seat 4: Mazerpelt (big blind) folded before Flop
Seat 5: Metalaito folded before Flop (didn't bet)
Seat 6: Squashy22 collected ($0.70)



PokerStars Hand #222954089632:  Hold'em No Limit ($0.05/$0.10 USD) - 2021/01/23 8:51:13 ET
Table 'Lutetia III' 6-max Seat #3 is the button
Seat 1: Proper-tilted ($5.48 in chips) 
Seat 2: pernth ($8.33 in chips) 
Seat 3: YuYuYu777 ($18.48 in chips) 
Seat 4: Mazerpelt ($11.13 in chips) 
Seat 6: Squashy22 ($11.15 in chips) 
Mazerpelt: posts small blind $0.05
Metalaito: is sitting out 
Metalaito leaves the table
Squashy22: posts big blind $0.10
*** HOLE CARDS ***
Proper-tilted: raises $0.20 to $0.30
pernth: folds 
YuYuYu777: folds 
Mazerpelt: folds 
Squashy22: folds 
Uncalled bet ($0.20) returned to Proper-tilted
Proper-tilted collected $0.25 from pot
Proper-tilted: doesn't show hand 
*** SUMMARY ***
Total pot $0.25 | Rake $0 
Seat 1: Proper-tilted collected ($0.25)
Seat 2: pernth folded before Flop (didn't bet)
Seat 3: YuYuYu777 (button) folded before Flop (didn't bet)
Seat 4: Mazerpelt (small blind) folded before Flop
Seat 6: Squashy22 (big blind) folded before Flop



PokerStars Hand #222954093773:  Hold'em No Limit ($0.05/$0.10 USD) - 2021/01/23 8:51:22 ET
Table 'Lutetia III' 6-max Seat #4 is the button
Seat 1: Proper-tilted ($5.63 in chips) 
Seat 2: pernth ($8.33 in chips) 
Seat 3: YuYuYu777 ($18.48 in chips) 
Seat 4: Mazerpelt ($11.08 in chips) 
Seat 6: Squashy22 ($11.05 in chips) 
Squashy22: posts small blind $0.05
Proper-tilted: posts big blind $0.10
*** HOLE CARDS ***
pernth: folds 
YuYuYu777: folds 
Mazerpelt: folds 
Squashy22: raises $0.14 to $0.24
Proper-tilted: calls $0.14
*** FLOP *** [6d 4s 8d]
AzulAzul999 joins the table at seat #5 
Squashy22: bets $0.26
Proper-tilted: raises $0.26 to $0.52
Squashy22: calls $0.26
*** TURN *** [6d 4s 8d] [Kc]
Squashy22: checks 
Proper-tilted: checks 
*** RIVER *** [6d 4s 8d Kc] [Js]
Squashy22: checks 
Proper-tilted: checks 
*** SHOW DOWN ***
Squashy22: shows [8c Tc] (a pair of Eights)
Proper-tilted: mucks hand 
Squashy22 collected $1.45 from pot
*** SUMMARY ***
Total pot $1.52 | Rake $0.07 
Board [6d 4s 8d Kc Js]
Seat 1: Proper-tilted (big blind) mucked
Seat 2: pernth folded before Flop (didn't bet)
Seat 3: YuYuYu777 folded before Flop (didn't bet)
Seat 4: Mazerpelt (button) folded before Flop (didn't bet)
Seat 6: Squashy22 (small blind) showed [8c Tc] and won ($1.45) with a pair of Eights



PokerStars Hand #222954107695:  Hold'em No Limit ($0.05/$0.10 USD) - 2021/01/23 8:51:53 ET
Table 'Lutetia III' 6-max Seat #6 is the button
Seat 1: Proper-tilted ($4.87 in chips) 
Seat 2: pernth ($8.33 in chips) 
Seat 3: YuYuYu777 ($18.48 in chips) 
Seat 4: Mazerpelt ($11.08 in chips) 
Seat 6: Squashy22 ($11.74 in chips) 
Proper-tilted: posts small blind $0.05
pernth: posts big blind $0.10
AzulAzul999: sits out 
*** HOLE CARDS ***
YuYuYu777: raises $0.20 to $0.30
Mazerpelt: calls $0.30
Squashy22: folds 
Proper-tilted: folds 
pernth: folds 
*** FLOP *** [Td Qh 3s]
YuYuYu777: bets $0.36
Mazerpelt: calls $0.36
*** TURN *** [Td Qh 3s] [4d]
YuYuYu777: bets $0.70
Mazerpelt: folds 
Uncalled bet ($0.70) returned to YuYuYu777
YuYuYu777 collected $1.40 from pot
YuYuYu777: doesn't show hand 
*** SUMMARY ***
Total pot $1.47 | Rake $0.07 
Board [Td Qh 3s 4d]
Seat 1: Proper-tilted (small blind) folded before Flop
Seat 2: pernth (big blind) folded before Flop
Seat 3: YuYuYu777 collected ($1.40)
Seat 4: Mazerpelt folded on the Turn
Seat 6: Squashy22 (button) folded before Flop (didn't bet)



PokerStars Hand #222954134208:  Hold'em No Limit ($0.05/$0.10 USD) - 2021/01/23 8:52:51 ET
Table 'Lutetia III' 6-max Seat #1 is the button
Seat 1: Proper-tilted ($4.82 in chips) 
Seat 2: pernth ($8.23 in chips) 
Seat 3: YuYuYu777 ($19.22 in chips) 
Seat 4: Mazerpelt ($10.42 in chips) 
Seat 6: Squashy22 ($11.74 in chips) 
pernth: posts small blind $0.05
YuYuYu777: posts big blind $0.10
AzulAzul999: sits out 
*** HOLE CARDS ***
Mazerpelt: raises $0.20 to $0.30
Squashy22: folds 
Proper-tilted: folds 
pernth: folds 
YuYuYu777: folds 
Uncalled bet ($0.20) returned to Mazerpelt
Mazerpelt collected $0.25 from pot
*** SUMMARY ***
Total pot $0.25 | Rake $0 
Seat 1: Proper-tilted (button) folded before Flop (didn't bet)
Seat 2: pernth (small blind) folded before Flop
Seat 3: YuYuYu777 (big blind) folded before Flop
Seat 4: Mazerpelt collected ($0.25)
Seat 6: Squashy22 folded before Flop (didn't bet)



PokerStars Hand #222954139378:  Hold'em No Limit ($0.05/$0.10 USD) - 2021/01/23 8:53:02 ET
Table 'Lutetia III' 6-max Seat #2 is the button
Seat 1: Proper-tilted ($4.82 in chips) 
Seat 2: pernth ($8.18 in chips) 
Seat 3: YuYuYu777 ($19.12 in chips) 
Seat 4: Mazerpelt ($10.57 in chips) 
Seat 6: Squashy22 ($11.74 in chips) 
YuYuYu777: posts small blind $0.05
Mazerpelt: posts big blind $0.10
AzulAzul999: sits out 
*** HOLE CARDS ***
Squashy22: folds 
Proper-tilted: folds 
pernth: folds 
YuYuYu777: folds 
Uncalled bet ($0.05) returned to Mazerpelt
Mazerpelt collected $0.10 from pot
*** SUMMARY ***
Total pot $0.10 | Rake $0 
Seat 1: Proper-tilted folded before Flop (didn't bet)
Seat 2: pernth (button) folded before Flop (didn't bet)
Seat 3: YuYuYu777 (small blind) folded before Flop
Seat 4: Mazerpelt (big blind) collected ($0.10)
Seat 6: Squashy22 folded before Flop (didn't bet)



PokerStars Hand #222954143004:  Hold'em No Limit ($0.05/$0.10 USD) - 2021/01/23 8:53:10 ET
Table 'Lutetia III' 6-max Seat #3 is the button
Seat 1: Proper-tilted ($4.82 in chips) 
Seat 2: pernth ($8.18 in chips) 
Seat 3: YuYuYu777 ($19.07 in chips) 
Seat 4: Mazerpelt ($10.62 in chips) 
Seat 5: AzulAzul999 ($10 in chips) 
Seat 6: Squashy22 ($11.74 in chips) 
Mazerpelt: posts small blind $0.05
AzulAzul999: posts big blind $0.10
*** HOLE CARDS ***
Squashy22: folds 
Proper-tilted: folds 
pernth: folds 
YuYuYu777: folds 
Mazerpelt: folds 
Uncalled bet ($0.05) returned to AzulAzul999
AzulAzul999 collected $0.10 from pot
AzulAzul999: doesn't show hand 
*** SUMMARY ***
Total pot $0.10 | Rake $0 
Seat 1: Proper-tilted folded before Flop (didn't bet)
Seat 2: pernth folded before Flop (didn't bet)
Seat 3: YuYuYu777 (button) folded before Flop (didn't bet)
Seat 4: Mazerpelt (small blind) folded before Flop
Seat 5: AzulAzul999 (big blind) collected ($0.10)
Seat 6: Squashy22 folded before Flop (didn't bet)



PokerStars Hand #222954147026:  Hold'em No Limit ($0.05/$0.10 USD) - 2021/01/23 8:53:19 ET
Table 'Lutetia III' 6-max Seat #4 is the button
Seat 1: Proper-tilted ($4.82 in chips) 
Seat 2: pernth ($8.18 in chips) 
Seat 3: YuYuYu777 ($19.07 in chips) 
Seat 4: Mazerpelt ($10.57 in chips) 
Seat 5: AzulAzul999 ($10.05 in chips) 
Seat 6: Squashy22 ($11.74 in chips) 
AzulAzul999: posts small blind $0.05
Squashy22: posts big blind $0.10
*** HOLE CARDS ***
Proper-tilted: folds 
pernth: folds 
YuYuYu777: raises $0.20 to $0.30
Mazerpelt: folds 
AzulAzul999: folds 
Squashy22: folds 
Uncalled bet ($0.20) returned to YuYuYu777
YuYuYu777 collected $0.25 from pot
YuYuYu777: doesn't show hand 
*** SUMMARY ***
Total pot $0.25 | Rake $0 
Seat 1: Proper-tilted folded before Flop (didn't bet)
Seat 2: pernth folded before Flop (didn't bet)
Seat 3: YuYuYu777 collected ($0.25)
Seat 4: Mazerpelt (button) folded before Flop (didn't bet)
Seat 5: AzulAzul999 (small blind) folded before Flop
Seat 6: Squashy22 (big blind) folded before Flop



PokerStars Hand #222954160544:  Hold'em No Limit ($0.05/$0.10 USD) - 2021/01/23 8:53:49 ET
Table 'Lutetia III' 6-max Seat #5 is the button
Seat 1: Proper-tilted ($4.82 in chips) 
Seat 2: pernth ($8.18 in chips) 
Seat 3: YuYuYu777 ($19.22 in chips) 
Seat 4: Mazerpelt ($10.57 in chips) 
Seat 5: AzulAzul999 ($10 in chips) 
Seat 6: Squashy22 ($11.64 in chips) 
Squashy22: posts small blind $0.05
Proper-tilted: posts big blind $0.10
*** HOLE CARDS ***
pernth: folds 
YuYuYu777: folds 
Mazerpelt: folds 
AzulAzul999: folds 
Squashy22: folds 
Uncalled bet ($0.05) returned to Proper-tilted
Proper-tilted collected $0.10 from pot
Proper-tilted: doesn't show hand 
*** SUMMARY ***
Total pot $0.10 | Rake $0 
Seat 1: Proper-tilted (big blind) collected ($0.10)
Seat 2: pernth folded before Flop (didn't bet)
Seat 3: YuYuYu777 folded before Flop (didn't bet)
Seat 4: Mazerpelt folded before Flop (didn't bet)
Seat 5: AzulAzul999 (button) folded before Flop (didn't bet)
Seat 6: Squashy22 (small blind) folded before Flop



PokerStars Hand #222954172586:  Hold'em No Limit ($0.05/$0.10 USD) - 2021/01/23 8:54:05 ET
Table 'Lutetia III' 6-max Seat #6 is the button
Seat 1: Proper-tilted ($4.87 in chips) 
Seat 2: pernth ($8.18 in chips) 
Seat 3: YuYuYu777 ($19.22 in chips) 
Seat 4: Mazerpelt ($10.57 in chips) 
Seat 5: AzulAzul999 ($10 in chips) 
Seat 6: Squashy22 ($11.59 in chips) 
Proper-tilted: posts small blind $0.05
pernth: posts big blind $0.10
*** HOLE CARDS ***
YuYuYu777: folds 
Mazerpelt: folds 
AzulAzul999: folds 
Squashy22: folds 
Proper-tilted: raises $0.10 to $0.20
pernth: folds 
Uncalled bet ($0.10) returned to Proper-tilted
Proper-tilted collected $0.20 from pot
Proper-tilted: doesn't show hand 
*** SUMMARY ***
Total pot $0.20 | Rake $0 
Seat 1: Proper-tilted (small blind) collected ($0.20)
Seat 2: pernth (big blind) folded before Flop
Seat 3: YuYuYu777 folded before Flop (didn't bet)
Seat 4: Mazerpelt folded before Flop (didn't bet)
Seat 5: AzulAzul999 folded before Flop (didn't bet)
Seat 6: Squashy22 (button) folded before Flop (didn't bet)



PokerStars Hand #222954181886:  Hold'em No Limit ($0.05/$0.10 USD) - 2021/01/23 8:54:26 ET
Table 'Lutetia III' 6-max Seat #1 is the button
Seat 1: Proper-tilted ($4.97 in chips) 
Seat 2: pernth ($8.08 in chips) 
Seat 3: YuYuYu777 ($19.22 in chips) 
Seat 4: Mazerpelt ($10.57 in chips) 
Seat 5: AzulAzul999 ($10 in chips) 
Seat 6: Squashy22 ($11.59 in chips) 
pernth: posts small blind $0.05
YuYuYu777: posts big blind $0.10
*** HOLE CARDS ***
Mazerpelt: folds 
AzulAzul999: raises $0.20 to $0.30
Squashy22: folds 
Proper-tilted: folds 
pernth: folds 
YuYuYu777: raises $0.65 to $0.95
AzulAzul999: calls $0.65
*** FLOP *** [Tc 9d 8d]
YuYuYu777: checks 
AzulAzul999: bets $1.02
YuYuYu777: calls $1.02
*** TURN *** [Tc 9d 8d] [Jh]
YuYuYu777: checks 
AzulAzul999: checks 
*** RIVER *** [Tc 9d 8d Jh] [Ts]
YuYuYu777: bets $1.91
AzulAzul999: calls $1.91
*** SHOW DOWN ***
YuYuYu777: shows [Ah Qc] (a straight, Eight to Queen)
AzulAzul999: mucks hand 
YuYuYu777 collected $7.46 from pot
*** SUMMARY ***
Total pot $7.81 | Rake $0.35 
Board [Tc 9d 8d Jh Ts]
Seat 1: Proper-tilted (button) folded before Flop (didn't bet)
Seat 2: pernth (small blind) folded before Flop
Seat 3: YuYuYu777 (big blind) showed [Ah Qc] and won ($7.46) with a straight, Eight to Queen
Seat 4: Mazerpelt folded before Flop (didn't bet)
Seat 5: AzulAzul999 mucked
Seat 6: Squashy22 folded before Flop (didn't bet)



PokerStars Hand #222954206926:  Hold'em No Limit ($0.05/$0.10 USD) - 2021/01/23 8:55:24 ET
Table 'Lutetia III' 6-max Seat #2 is the button
Seat 1: Proper-tilted ($4.97 in chips) 
Seat 2: pernth ($8.03 in chips) 
Seat 3: YuYuYu777 ($22.80 in chips) 
Seat 4: Mazerpelt ($10.57 in chips) 
Seat 5: AzulAzul999 ($10 in chips) 
Seat 6: Squashy22 ($11.59 in chips) 
YuYuYu777: posts small blind $0.05
Mazerpelt: posts big blind $0.10
*** HOLE CARDS ***
AzulAzul999: folds 
Squashy22: folds 
Proper-tilted: folds 
pernth: folds 
YuYuYu777: folds 
Uncalled bet ($0.05) returned to Mazerpelt
Mazerpelt collected $0.10 from pot
*** SUMMARY ***
Total pot $0.10 | Rake $0 
Seat 1: Proper-tilted folded before Flop (didn't bet)
Seat 2: pernth (button) folded before Flop (didn't bet)
Seat 3: YuYuYu777 (small blind) folded before Flop
Seat 4: Mazerpelt (big blind) collected ($0.10)
Seat 5: AzulAzul999 folded before Flop (didn't bet)
Seat 6: Squashy22 folded before Flop (didn't bet)



PokerStars Hand #222954209999:  Hold'em No Limit ($0.05/$0.10 USD) - 2021/01/23 8:55:33 ET
Table 'Lutetia III' 6-max Seat #3 is the button
Seat 1: Proper-tilted ($4.97 in chips) 
Seat 2: pernth ($8.03 in chips) 
Seat 3: YuYuYu777 ($22.75 in chips) 
Seat 4: Mazerpelt ($10.62 in chips) 
Seat 5: AzulAzul999 ($10 in chips) 
Seat 6: Squashy22 ($11.59 in chips) 
Mazerpelt: posts small blind $0.05
AzulAzul999: posts big blind $0.10
*** HOLE CARDS ***
Squashy22: raises $0.19 to $0.29
Proper-tilted: folds 
pernth: folds 
YuYuYu777: calls $0.29
Mazerpelt: folds 
AzulAzul999: calls $0.19
*** FLOP *** [Ts Qh Th]
AzulAzul999: checks 
Squashy22: bets $0.38
YuYuYu777: folds 
AzulAzul999: calls $0.38
*** TURN *** [Ts Qh Th] [3d]
AzulAzul999: checks 
Squashy22: bets $0.69
AzulAzul999: calls $0.69
*** RIVER *** [Ts Qh Th 3d] [Ad]
AzulAzul999: checks 
Squashy22: checks 
*** SHOW DOWN ***
AzulAzul999: shows [Qd 8d] (two pair, Queens and Tens)
Squashy22: shows [Ac Qc] (two pair, Aces and Queens)
Squashy22 collected $2.92 from pot
*** SUMMARY ***
Total pot $3.06 | Rake $0.14 
Board [Ts Qh Th 3d Ad]
Seat 1: Proper-tilted folded before Flop (didn't bet)
Seat 2: pernth folded before Flop (didn't bet)
Seat 3: YuYuYu777 (button) folded on the Flop
Seat 4: Mazerpelt (small blind) folded before Flop
Seat 5: AzulAzul999 (big blind) showed [Qd 8d] and lost with two pair, Queens and Tens
Seat 6: Squashy22 showed [Ac Qc] and won ($2.92) with two pair, Aces and Queens



PokerStars Hand #222954228646:  Hold'em No Limit ($0.05/$0.10 USD) - 2021/01/23 8:56:24 ET
Table 'Lutetia III' 6-max Seat #4 is the button
Seat 1: Proper-tilted ($4.97 in chips) 
Seat 2: pernth ($8.03 in chips) 
Seat 3: YuYuYu777 ($22.46 in chips) 
Seat 4: Mazerpelt ($10.57 in chips) 
Seat 5: AzulAzul999 ($10 in chips) 
Seat 6: Squashy22 ($13.15 in chips) 
AzulAzul999: posts small blind $0.05
Squashy22: posts big blind $0.10
*** HOLE CARDS ***
Proper-tilted: raises $0.20 to $0.30
pernth: folds 
YuYuYu777: calls $0.30
Mazerpelt: folds 
AzulAzul999: folds 
Squashy22: folds 
*** FLOP *** [Qc Jd 9c]
Proper-tilted: bets $0.36
YuYuYu777: folds 
Uncalled bet ($0.36) returned to Proper-tilted
Proper-tilted collected $0.72 from pot
Proper-tilted: doesn't show hand 
*** SUMMARY ***
Total pot $0.75 | Rake $0.03 
Board [Qc Jd 9c]
Seat 1: Proper-tilted collected ($0.72)
Seat 2: pernth folded before Flop (didn't bet)
Seat 3: YuYuYu777 folded on the Flop
Seat 4: Mazerpelt (button) folded before Flop (didn't bet)
Seat 5: AzulAzul999 (small blind) folded before Flop
Seat 6: Squashy22 (big blind) folded before Flop



PokerStars Hand #222954241724:  Hold'em No Limit ($0.05/$0.10 USD) - 2021/01/23 8:57:01 ET
Table 'Lutetia III' 6-max Seat #5 is the button
Seat 1: Proper-tilted ($5.39 in chips) 
Seat 2: pernth ($8.03 in chips) 
Seat 3: YuYuYu777 ($22.16 in chips) 
Seat 4: Mazerpelt ($10.57 in chips) 
Seat 5: AzulAzul999 ($10 in chips) 
Seat 6: Squashy22 ($13.05 in chips) 
Squashy22: posts small blind $0.05
Proper-tilted: posts big blind $0.10
*** HOLE CARDS ***
pernth: folds 
YuYuYu777: folds 
Mazerpelt: folds 
AzulAzul999 has timed out
AzulAzul999: folds 
Squashy22: folds 
Uncalled bet ($0.05) returned to Proper-tilted
Proper-tilted collected $0.10 from pot
Proper-tilted: doesn't show hand 
*** SUMMARY ***
Total pot $0.10 | Rake $0 
Seat 1: Proper-tilted (big blind) collected ($0.10)
Seat 2: pernth folded before Flop (didn't bet)
Seat 3: YuYuYu777 folded before Flop (didn't bet)
Seat 4: Mazerpelt folded before Flop (didn't bet)
Seat 5: AzulAzul999 (button) folded before Flop (didn't bet)
Seat 6: Squashy22 (small blind) folded before Flop



PokerStars Hand #222954250095:  Hold'em No Limit ($0.05/$0.10 USD) - 2021/01/23 8:57:23 ET
Table 'Lutetia III' 6-max Seat #6 is the button
Seat 1: Proper-tilted ($5.44 in chips) 
Seat 2: pernth ($8.03 in chips) 
Seat 3: YuYuYu777 ($22.16 in chips) 
Seat 4: Mazerpelt ($10.57 in chips) 
Seat 6: Squashy22 ($13 in chips) 
Proper-tilted: posts small blind $0.05
pernth: posts big blind $0.10
*** HOLE CARDS ***
YuYuYu777: raises $0.20 to $0.30
Mazerpelt: folds 
Squashy22: folds 
Proper-tilted: raises $0.60 to $0.90
pernth: folds 
YuYuYu777: folds 
Uncalled bet ($0.60) returned to Proper-tilted
Proper-tilted collected $0.70 from pot
Proper-tilted: doesn't show hand 
*** SUMMARY ***
Total pot $0.70 | Rake $0 
Seat 1: Proper-tilted (small blind) collected ($0.70)
Seat 2: pernth (big blind) folded before Flop
Seat 3: YuYuYu777 folded before Flop
Seat 4: Mazerpelt folded before Flop (didn't bet)
Seat 6: Squashy22 (button) folded before Flop (didn't bet)



PokerStars Hand #222954260215:  Hold'em No Limit ($0.05/$0.10 USD) - 2021/01/23 8:57:51 ET
Table 'Lutetia III' 6-max Seat #1 is the button
Seat 1: Proper-tilted ($5.84 in chips) 
Seat 2: pernth ($7.93 in chips) 
Seat 3: YuYuYu777 ($21.86 in chips) 
Seat 4: Mazerpelt ($10.57 in chips) 
Seat 6: Squashy22 ($13 in chips) 
pernth: posts small blind $0.05
YuYuYu777: posts big blind $0.10
*** HOLE CARDS ***
Mazerpelt: raises $0.20 to $0.30
Squashy22: folds 
Proper-tilted: folds 
pernth: folds 
YuYuYu777: calls $0.20
*** FLOP *** [Th 6s 3s]
YuYuYu777: checks 
Mazerpelt: bets $0.41
YuYuYu777: calls $0.41
*** TURN *** [Th 6s 3s] [Qh]
YuYuYu777: checks 
Mazerpelt: bets $1.05
YuYuYu777: calls $1.05
*** RIVER *** [Th 6s 3s Qh] [3h]
YuYuYu777: checks 
Mazerpelt: bets $2.27
YuYuYu777: folds 
Uncalled bet ($2.27) returned to Mazerpelt
Mazerpelt collected $3.41 from pot
*** SUMMARY ***
Total pot $3.57 | Rake $0.16 
Board [Th 6s 3s Qh 3h]
Seat 1: Proper-tilted (button) folded before Flop (didn't bet)
Seat 2: pernth (small blind) folded before Flop
Seat 3: YuYuYu777 (big blind) folded on the River
Seat 4: Mazerpelt collected ($3.41)
Seat 6: Squashy22 folded before Flop (didn't bet)



PokerStars Hand #222954292735:  Hold'em No Limit ($0.05/$0.10 USD) - 2021/01/23 8:59:20 ET
Table 'Lutetia III' 6-max Seat #2 is the button
Seat 1: Proper-tilted ($5.84 in chips) 
Seat 2: pernth ($7.88 in chips) 
Seat 3: YuYuYu777 ($20.10 in chips) 
Seat 4: Mazerpelt ($12.22 in chips) 
Seat 5: AzulAzul999 ($10 in chips) 
Seat 6: Squashy22 ($13 in chips) 
YuYuYu777: posts small blind $0.05
Mazerpelt: posts big blind $0.10
*** HOLE CARDS ***
AzulAzul999: folds 
Squashy22: folds 
Proper-tilted: folds 
pernth: folds 
YuYuYu777: folds 
Uncalled bet ($0.05) returned to Mazerpelt
Mazerpelt collected $0.10 from pot
*** SUMMARY ***
Total pot $0.10 | Rake $0 
Seat 1: Proper-tilted folded before Flop (didn't bet)
Seat 2: pernth (button) folded before Flop (didn't bet)
Seat 3: YuYuYu777 (small blind) folded before Flop
Seat 4: Mazerpelt (big blind) collected ($0.10)
Seat 5: AzulAzul999 folded before Flop (didn't bet)
Seat 6: Squashy22 folded before Flop (didn't bet)



PokerStars Hand #222954297394:  Hold'em No Limit ($0.05/$0.10 USD) - 2021/01/23 8:59:33 ET
Table 'Lutetia III' 6-max Seat #3 is the button
Seat 1: Proper-tilted ($5.84 in chips) 
Seat 2: pernth ($7.88 in chips) 
Seat 3: YuYuYu777 ($20.05 in chips) 
Seat 4: Mazerpelt ($12.27 in chips) 
Seat 5: AzulAzul999 ($10 in chips) 
Seat 6: Squashy22 ($13 in chips) 
Mazerpelt: posts small blind $0.05
AzulAzul999: posts big blind $0.10
*** HOLE CARDS ***
Squashy22: folds 
Proper-tilted: folds 
pernth: folds 
YuYuYu777: raises $0.20 to $0.30
Mazerpelt: folds 
AzulAzul999: folds 
Uncalled bet ($0.20) returned to YuYuYu777
YuYuYu777 collected $0.25 from pot
YuYuYu777: doesn't show hand 
*** SUMMARY ***
Total pot $0.25 | Rake $0 
Seat 1: Proper-tilted folded before Flop (didn't bet)
Seat 2: pernth folded before Flop (didn't bet)
Seat 3: YuYuYu777 (button) collected ($0.25)
Seat 4: Mazerpelt (small blind) folded before Flop
Seat 5: AzulAzul999 (big blind) folded before Flop
Seat 6: Squashy22 folded before Flop (didn't bet)



PokerStars Hand #222954305340:  Hold'em No Limit ($0.05/$0.10 USD) - 2021/01/23 8:59:54 ET
Table 'Lutetia III' 6-max Seat #4 is the button
Seat 1: Proper-tilted ($5.84 in chips) 
Seat 2: pernth ($7.88 in chips) 
Seat 3: YuYuYu777 ($20.20 in chips) 
Seat 4: Mazerpelt ($12.22 in chips) 
Seat 5: AzulAzul999 ($10 in chips) 
Seat 6: Squashy22 ($13 in chips) 
AzulAzul999: posts small blind $0.05
Squashy22: posts big blind $0.10
*** HOLE CARDS ***
Proper-tilted: raises $0.10 to $0.20
pernth: folds 
YuYuYu777: folds 
Mazerpelt: calls $0.20
AzulAzul999: folds 
Squashy22: calls $0.10
*** FLOP *** [Js Jc 8s]
Squashy22: checks 
Proper-tilted: checks 
Mazerpelt: checks 
*** TURN *** [Js Jc 8s] [3s]
Squashy22: checks 
Proper-tilted: checks 
Mazerpelt: checks 
*** RIVER *** [Js Jc 8s 3s] [As]
Squashy22: checks 
Proper-tilted: folds 
Proper-tilted leaves the table
Mazerpelt: checks 
*** SHOW DOWN ***
Squashy22: shows [3h 2h] (two pair, Jacks and Threes)
Mazerpelt: shows [2c 2s] (a flush, Ace high)
Mazerpelt collected $0.62 from pot
*** SUMMARY ***
Total pot $0.65 | Rake $0.03 
Board [Js Jc 8s 3s As]
Seat 1: Proper-tilted folded on the River
Seat 2: pernth folded before Flop (didn't bet)
Seat 3: YuYuYu777 folded before Flop (didn't bet)
Seat 4: Mazerpelt (button) showed [2c 2s] and won ($0.62) with a flush, Ace high
Seat 5: AzulAzul999 (small blind) folded before Flop
Seat 6: Squashy22 (big blind) showed [3h 2h] and lost with two pair, Jacks and Threes



PokerStars Hand #222954322152:  Hold'em No Limit ($0.05/$0.10 USD) - 2021/01/23 9:00:39 ET
Table 'Lutetia III' 6-max Seat #5 is the button
Seat 2: pernth ($7.88 in chips) 
Seat 3: YuYuYu777 ($20.20 in chips) 
Seat 4: Mazerpelt ($12.64 in chips) 
Seat 5: AzulAzul999 ($10 in chips) 
Seat 6: Squashy22 ($12.80 in chips) 
Squashy22: posts small blind $0.05
pernth: posts big blind $0.10
*** HOLE CARDS ***
YuYuYu777: folds 
Mazerpelt: folds 
AzulAzul999: folds 
Squashy22: folds 
Uncalled bet ($0.05) returned to pernth
pernth collected $0.10 from pot
pernth: doesn't show hand 
*** SUMMARY ***
Total pot $0.10 | Rake $0 
Seat 2: pernth (big blind) collected ($0.10)
Seat 3: YuYuYu777 folded before Flop (didn't bet)
Seat 4: Mazerpelt folded before Flop (didn't bet)
Seat 5: AzulAzul999 (button) folded before Flop (didn't bet)
Seat 6: Squashy22 (small blind) folded before Flop



PokerStars Hand #222954331492:  Hold'em No Limit ($0.05/$0.10 USD) - 2021/01/23 9:01:01 ET
Table 'Lutetia III' 6-max Seat #6 is the button
Seat 2: pernth ($7.93 in chips) 
Seat 3: YuYuYu777 ($20.20 in chips) 
Seat 4: Mazerpelt ($12.64 in chips) 
Seat 5: AzulAzul999 ($10 in chips) 
Seat 6: Squashy22 ($12.75 in chips) 
pernth: posts small blind $0.05
YuYuYu777: posts big blind $0.10
*** HOLE CARDS ***
Mazerpelt: raises $0.20 to $0.30
AzulAzul999: folds 
Squashy22: folds 
pernth: folds 
YuYuYu777: folds 
Uncalled bet ($0.20) returned to Mazerpelt
Mazerpelt collected $0.25 from pot
*** SUMMARY ***
Total pot $0.25 | Rake $0 
Seat 2: pernth (small blind) folded before Flop
Seat 3: YuYuYu777 (big blind) folded before Flop
Seat 4: Mazerpelt collected ($0.25)
Seat 5: AzulAzul999 folded before Flop (didn't bet)
Seat 6: Squashy22 (button) folded before Flop (didn't bet)



PokerStars Hand #222954338814:  Hold'em No Limit ($0.05/$0.10 USD) - 2021/01/23 9:01:15 ET
Table 'Lutetia III' 6-max Seat #2 is the button
Seat 2: pernth ($7.88 in chips) 
Seat 3: YuYuYu777 ($20.10 in chips) 
Seat 4: Mazerpelt ($12.79 in chips) 
Seat 5: AzulAzul999 ($10 in chips) 
Seat 6: Squashy22 ($12.75 in chips) 
YuYuYu777: posts small blind $0.05
Mazerpelt: posts big blind $0.10
*** HOLE CARDS ***
AzulAzul999: folds 
Squashy22: folds 
pernth: folds 
YuYuYu777: folds 
Uncalled bet ($0.05) returned to Mazerpelt
Mazerpelt collected $0.10 from pot
*** SUMMARY ***
Total pot $0.10 | Rake $0 
Seat 2: pernth (button) folded before Flop (didn't bet)
Seat 3: YuYuYu777 (small blind) folded before Flop
Seat 4: Mazerpelt (big blind) collected ($0.10)
Seat 5: AzulAzul999 folded before Flop (didn't bet)
Seat 6: Squashy22 folded before Flop (didn't bet)



PokerStars Hand #222954345743:  Hold'em No Limit ($0.05/$0.10 USD) - 2021/01/23 9:01:27 ET
Table 'Lutetia III' 6-max Seat #3 is the button
Seat 2: pernth ($7.88 in chips) 
Seat 3: YuYuYu777 ($20.05 in chips) 
Seat 4: Mazerpelt ($12.84 in chips) 
Seat 5: AzulAzul999 ($10 in chips) 
Seat 6: Squashy22 ($12.75 in chips) 
Mazerpelt: posts small blind $0.05
AzulAzul999: posts big blind $0.10
*** HOLE CARDS ***
Squashy22: folds 
pernth: folds 
YuYuYu777: folds 
YuYuYu777 leaves the table
Mazerpelt: folds 
Uncalled bet ($0.05) returned to AzulAzul999
AzulAzul999 collected $0.10 from pot
AzulAzul999: doesn't show hand 
*** SUMMARY ***
Total pot $0.10 | Rake $0 
Seat 2: pernth folded before Flop (didn't bet)
Seat 3: YuYuYu777 (button) folded before Flop (didn't bet)
Seat 4: Mazerpelt (small blind) folded before Flop
Seat 5: AzulAzul999 (big blind) collected ($0.10)
Seat 6: Squashy22 folded before Flop (didn't bet)



PokerStars Hand #222954351071:  Hold'em No Limit ($0.05/$0.10 USD) - 2021/01/23 9:01:39 ET
Table 'Lutetia III' 6-max Seat #4 is the button
Seat 2: pernth ($7.88 in chips) 
Seat 4: Mazerpelt ($12.79 in chips) 
Seat 5: AzulAzul999 ($10.05 in chips) 
Seat 6: Squashy22 ($12.75 in chips) 
AzulAzul999: posts small blind $0.05
Squashy22: posts big blind $0.10
*** HOLE CARDS ***
pernth: raises $0.10 to $0.20
Mazerpelt: folds 
AzulAzul999: raises $0.40 to $0.60
Squashy22: folds 
pernth: folds 
Uncalled bet ($0.40) returned to AzulAzul999
AzulAzul999 collected $0.50 from pot
AzulAzul999: doesn't show hand 
*** SUMMARY ***
Total pot $0.50 | Rake $0 
Seat 2: pernth folded before Flop
Seat 4: Mazerpelt (button) folded before Flop (didn't bet)
Seat 5: AzulAzul999 (small blind) collected ($0.50)
Seat 6: Squashy22 (big blind) folded before Flop



PokerStars Hand #222954363187:  Hold'em No Limit ($0.05/$0.10 USD) - 2021/01/23 9:02:05 ET
Table 'Lutetia III' 6-max Seat #5 is the button
Seat 2: pernth ($7.68 in chips) 
Seat 4: Mazerpelt ($12.79 in chips) 
Seat 5: AzulAzul999 ($10.35 in chips) 
Seat 6: Squashy22 ($12.65 in chips) 
Squashy22: posts small blind $0.05
pernth: posts big blind $0.10
*** HOLE CARDS ***
Calltossen joins the table at seat #1 
Mazerpelt: folds 
AzulAzul999: raises $0.20 to $0.30
Squashy22: raises $0.90 to $1.20
pernth: folds 
AzulAzul999: folds 
Uncalled bet ($0.90) returned to Squashy22
Squashy22 collected $0.70 from pot
Squashy22: doesn't show hand 
*** SUMMARY ***
Total pot $0.70 | Rake $0 
Seat 2: pernth (big blind) folded before Flop
Seat 4: Mazerpelt folded before Flop (didn't bet)
Seat 5: AzulAzul999 (button) folded before Flop
Seat 6: Squashy22 (small blind) collected ($0.70)



PokerStars Hand #222954376313:  Hold'em No Limit ($0.05/$0.10 USD) - 2021/01/23 9:02:32 ET
Table 'Lutetia III' 6-max Seat #6 is the button
Seat 2: pernth ($7.58 in chips) 
Seat 4: Mazerpelt ($12.79 in chips) 
Seat 5: AzulAzul999 ($10.05 in chips) 
Seat 6: Squashy22 ($13.05 in chips) 
pernth: posts small blind $0.05
Mazerpelt: posts big blind $0.10
*** HOLE CARDS ***
AzulAzul999: folds 
Squashy22: folds 
pernth: raises $0.10 to $0.20
Mazerpelt: calls $0.10
*** FLOP *** [8h 5d 6d]
pernth: checks 
Mazerpelt: bets $0.25
pernth: folds 
Uncalled bet ($0.25) returned to Mazerpelt
Mazerpelt collected $0.38 from pot
*** SUMMARY ***
Total pot $0.40 | Rake $0.02 
Board [8h 5d 6d]
Seat 2: pernth (small blind) folded on the Flop
Seat 4: Mazerpelt (big blind) collected ($0.38)
Seat 5: AzulAzul999 folded before Flop (didn't bet)
Seat 6: Squashy22 (button) folded before Flop (didn't bet)



PokerStars Hand #222954392774:  Hold'em No Limit ($0.05/$0.10 USD) - 2021/01/23 9:03:06 ET
Table 'Lutetia III' 6-max Seat #2 is the button
Seat 2: pernth ($7.38 in chips) 
Seat 4: Mazerpelt ($12.97 in chips) 
Seat 5: AzulAzul999 ($10.05 in chips) 
Seat 6: Squashy22 ($13.05 in chips) 
Mazerpelt: posts small blind $0.05
AzulAzul999: posts big blind $0.10
Calltossen: sits out 
*** HOLE CARDS ***
Squashy22: folds 
pernth: calls $0.10
Mazerpelt: folds 
AzulAzul999: checks 
*** FLOP *** [3c 7d Ac]
AzulAzul999: checks 
pernth: bets $0.20
AzulAzul999: folds 
Uncalled bet ($0.20) returned to pernth
pernth collected $0.24 from pot
pernth: doesn't show hand 
*** SUMMARY ***
Total pot $0.25 | Rake $0.01 
Board [3c 7d Ac]
Seat 2: pernth (button) collected ($0.24)
Seat 4: Mazerpelt (small blind) folded before Flop
Seat 5: AzulAzul999 (big blind) folded on the Flop
Seat 6: Squashy22 folded before Flop (didn't bet)



PokerStars Hand #222954411709:  Hold'em No Limit ($0.05/$0.10 USD) - 2021/01/23 9:03:45 ET
Table 'Lutetia III' 6-max Seat #5 is the button
Seat 1: Calltossen ($10 in chips) 
Seat 2: pernth ($7.52 in chips) 
Seat 4: Mazerpelt ($12.92 in chips) 
Seat 5: AzulAzul999 ($10.10 in chips) 
Seat 6: Squashy22 ($12.95 in chips) 
Squashy22: posts small blind $0.05
Calltossen: posts big blind $0.10
*** HOLE CARDS ***
pernth: folds 
Mazerpelt: folds 
AzulAzul999: folds 
Squashy22: folds 
Uncalled bet ($0.05) returned to Calltossen
Calltossen collected $0.10 from pot
Calltossen: doesn't show hand 
*** SUMMARY ***
Total pot $0.10 | Rake $0 
Seat 1: Calltossen (big blind) collected ($0.10)
Seat 2: pernth folded before Flop (didn't bet)
Seat 4: Mazerpelt folded before Flop (didn't bet)
Seat 5: AzulAzul999 (button) folded before Flop (didn't bet)
Seat 6: Squashy22 (small blind) folded before Flop



PokerStars Hand #222954416915:  Hold'em No Limit ($0.05/$0.10 USD) - 2021/01/23 9:03:56 ET
Table 'Lutetia III' 6-max Seat #6 is the button
Seat 1: Calltossen ($10.05 in chips) 
Seat 2: pernth ($7.52 in chips) 
Seat 4: Mazerpelt ($12.92 in chips) 
Seat 5: AzulAzul999 ($10.10 in chips) 
Seat 6: Squashy22 ($12.90 in chips) 
Calltossen: posts small blind $0.05
pernth: posts big blind $0.10
*** HOLE CARDS ***
Mazerpelt: folds 
AzulAzul999: folds 
Squashy22: folds 
Calltossen: folds 
Uncalled bet ($0.05) returned to pernth
pernth collected $0.10 from pot
pernth: doesn't show hand 
*** SUMMARY ***
Total pot $0.10 | Rake $0 
Seat 1: Calltossen (small blind) folded before Flop
Seat 2: pernth (big blind) collected ($0.10)
Seat 4: Mazerpelt folded before Flop (didn't bet)
Seat 5: AzulAzul999 folded before Flop (didn't bet)
Seat 6: Squashy22 (button) folded before Flop (didn't bet)



PokerStars Hand #222954421617:  Hold'em No Limit ($0.05/$0.10 USD) - 2021/01/23 9:04:06 ET
Table 'Lutetia III' 6-max Seat #1 is the button
Seat 1: Calltossen ($10 in chips) 
Seat 2: pernth ($7.57 in chips) 
Seat 4: Mazerpelt ($12.92 in chips) 
Seat 5: AzulAzul999 ($10.10 in chips) 
Seat 6: Squashy22 ($12.90 in chips) 
pernth: posts small blind $0.05
Mazerpelt: posts big blind $0.10
*** HOLE CARDS ***
AzulAzul999: folds 
Squashy22: folds 
Calltossen: folds 
pernth: raises $0.10 to $0.20
Mazerpelt: folds 
Uncalled bet ($0.10) returned to pernth
pernth collected $0.20 from pot
pernth: doesn't show hand 
*** SUMMARY ***
Total pot $0.20 | Rake $0 
Seat 1: Calltossen (button) folded before Flop (didn't bet)
Seat 2: pernth (small blind) collected ($0.20)
Seat 4: Mazerpelt (big blind) folded before Flop
Seat 5: AzulAzul999 folded before Flop (didn't bet)
Seat 6: Squashy22 folded before Flop (didn't bet)



PokerStars Hand #222954427043:  Hold'em No Limit ($0.05/$0.10 USD) - 2021/01/23 9:04:17 ET
Table 'Lutetia III' 6-max Seat #2 is the button
Seat 1: Calltossen ($10 in chips) 
Seat 2: pernth ($7.67 in chips) 
Seat 4: Mazerpelt ($12.82 in chips) 
Seat 5: AzulAzul999 ($10.10 in chips) 
Seat 6: Squashy22 ($12.90 in chips) 
Mazerpelt: posts small blind $0.05
AzulAzul999: posts big blind $0.10
*** HOLE CARDS ***
Squashy22: folds 
Calltossen: folds 
pernth: folds 
Mazerpelt: folds 
Uncalled bet ($0.05) returned to AzulAzul999
AzulAzul999 collected $0.10 from pot
AzulAzul999: doesn't show hand 
*** SUMMARY ***
Total pot $0.10 | Rake $0 
Seat 1: Calltossen folded before Flop (didn't bet)
Seat 2: pernth (button) folded before Flop (didn't bet)
Seat 4: Mazerpelt (small blind) folded before Flop
Seat 5: AzulAzul999 (big blind) collected ($0.10)
Seat 6: Squashy22 folded before Flop (didn't bet)



PokerStars Hand #222954432063:  Hold'em No Limit ($0.05/$0.10 USD) - 2021/01/23 9:04:27 ET
Table 'Lutetia III' 6-max Seat #4 is the button
Seat 1: Calltossen ($10 in chips) 
Seat 2: pernth ($7.67 in chips) 
Seat 4: Mazerpelt ($12.77 in chips) 
Seat 5: AzulAzul999 ($10.15 in chips) 
Seat 6: Squashy22 ($12.90 in chips) 
AzulAzul999: posts small blind $0.05
Squashy22: posts big blind $0.10
*** HOLE CARDS ***
Calltossen: folds 
pernth: folds 
Mazerpelt: raises $0.20 to $0.30
AzulAzul999: folds 
Squashy22: raises $0.90 to $1.20
AndriuWasa joins the table at seat #3 
Mazerpelt: folds 
Uncalled bet ($0.90) returned to Squashy22
Squashy22 collected $0.65 from pot
Squashy22: doesn't show hand 
*** SUMMARY ***
Total pot $0.65 | Rake $0 
Seat 1: Calltossen folded before Flop (didn't bet)
Seat 2: pernth folded before Flop (didn't bet)
Seat 4: Mazerpelt (button) folded before Flop
Seat 5: AzulAzul999 (small blind) folded before Flop
Seat 6: Squashy22 (big blind) collected ($0.65)



PokerStars Hand #222954453823:  Hold'em No Limit ($0.05/$0.10 USD) - 2021/01/23 9:05:11 ET
Table 'Lutetia III' 6-max Seat #5 is the button
Seat 1: Calltossen ($10 in chips) 
Seat 2: pernth ($7.67 in chips) 
Seat 4: Mazerpelt ($12.47 in chips) 
Seat 5: AzulAzul999 ($10.10 in chips) 
Seat 6: Squashy22 ($13.25 in chips) 
Squashy22: posts small blind $0.05
Calltossen: posts big blind $0.10
AndriuWasa: sits out 
*** HOLE CARDS ***
pernth: raises $0.10 to $0.20
Mazerpelt: folds 
AzulAzul999: calls $0.20
Squashy22: folds 
Calltossen: calls $0.10
*** FLOP *** [6d Qc 9h]
Calltossen: checks 
pernth: checks 
AzulAzul999: bets $0.34
Calltossen: calls $0.34
pernth: folds 
*** TURN *** [6d Qc 9h] [Kd]
Calltossen: checks 
AzulAzul999: bets $0.70
AndriuWasa is disconnected 
Calltossen: raises $1.34 to $2.04
AzulAzul999: folds 
Uncalled bet ($1.34) returned to Calltossen
Calltossen collected $2.61 from pot
Calltossen: doesn't show hand 
*** SUMMARY ***
Total pot $2.73 | Rake $0.12 
Board [6d Qc 9h Kd]
Seat 1: Calltossen (big blind) collected ($2.61)
Seat 2: pernth folded on the Flop
Seat 4: Mazerpelt folded before Flop (didn't bet)
Seat 5: AzulAzul999 (button) folded on the Turn
Seat 6: Squashy22 (small blind) folded before Flop



PokerStars Hand #222954480496:  Hold'em No Limit ($0.05/$0.10 USD) - 2021/01/23 9:06:06 ET
Table 'Lutetia III' 6-max Seat #6 is the button
Seat 1: Calltossen ($11.37 in chips) 
Seat 2: pernth ($7.47 in chips) 
Seat 4: Mazerpelt ($12.47 in chips) 
Seat 5: AzulAzul999 ($10 in chips) 
Seat 6: Squashy22 ($13.20 in chips) 
Calltossen: posts small blind $0.05
pernth: posts big blind $0.10
AndriuWasa is connected 
AndriuWasa: sits out 
*** HOLE CARDS ***
Mazerpelt: raises $0.20 to $0.30
AzulAzul999: folds 
Squashy22: folds 
Calltossen: folds 
pernth: folds 
Uncalled bet ($0.20) returned to Mazerpelt
Mazerpelt collected $0.25 from pot
*** SUMMARY ***
Total pot $0.25 | Rake $0 
Seat 1: Calltossen (small blind) folded before Flop
Seat 2: pernth (big blind) folded before Flop
Seat 4: Mazerpelt collected ($0.25)
Seat 5: AzulAzul999 folded before Flop (didn't bet)
Seat 6: Squashy22 (button) folded before Flop (didn't bet)



PokerStars Hand #222954485824:  Hold'em No Limit ($0.05/$0.10 USD) - 2021/01/23 9:06:17 ET
Table 'Lutetia III' 6-max Seat #1 is the button
Seat 1: Calltossen ($11.32 in chips) 
Seat 2: pernth ($7.37 in chips) 
Seat 3: AndriuWasa ($10 in chips) 
Seat 4: Mazerpelt ($12.62 in chips) 
Seat 5: AzulAzul999 ($10 in chips) 
Seat 6: Squashy22 ($13.20 in chips) 
pernth: posts small blind $0.05
AndriuWasa: posts big blind $0.10
*** HOLE CARDS ***
Mazerpelt: folds 
AzulAzul999: folds 
Squashy22: folds 
Calltossen: raises $0.20 to $0.30
pernth: folds 
AndriuWasa: folds 
Uncalled bet ($0.20) returned to Calltossen
Calltossen collected $0.25 from pot
Calltossen: doesn't show hand 
*** SUMMARY ***
Total pot $0.25 | Rake $0 
Seat 1: Calltossen (button) collected ($0.25)
Seat 2: pernth (small blind) folded before Flop
Seat 3: AndriuWasa (big blind) folded before Flop
Seat 4: Mazerpelt folded before Flop (didn't bet)
Seat 5: AzulAzul999 folded before Flop (didn't bet)
Seat 6: Squashy22 folded before Flop (didn't bet)



PokerStars Hand #222954493899:  Hold'em No Limit ($0.05/$0.10 USD) - 2021/01/23 9:06:33 ET
Table 'Lutetia III' 6-max Seat #2 is the button
Seat 1: Calltossen ($11.47 in chips) 
Seat 2: pernth ($7.32 in chips) 
Seat 3: AndriuWasa ($10 in chips) 
Seat 4: Mazerpelt ($12.62 in chips) 
Seat 5: AzulAzul999 ($10 in chips) 
Seat 6: Squashy22 ($13.20 in chips) 
AndriuWasa: posts small blind $0.05
Mazerpelt: posts big blind $0.10
*** HOLE CARDS ***
AzulAzul999 has timed out
AzulAzul999: folds 
Squashy22: folds 
Calltossen: raises $0.20 to $0.30
pernth: folds 
AndriuWasa: folds 
Mazerpelt: folds 
Uncalled bet ($0.20) returned to Calltossen
Calltossen collected $0.25 from pot
Calltossen: doesn't show hand 
*** SUMMARY ***
Total pot $0.25 | Rake $0 
Seat 1: Calltossen collected ($0.25)
Seat 2: pernth (button) folded before Flop (didn't bet)
Seat 3: AndriuWasa (small blind) folded before Flop
Seat 4: Mazerpelt (big blind) folded before Flop
Seat 5: AzulAzul999 folded before Flop (didn't bet)
Seat 6: Squashy22 folded before Flop (didn't bet)



PokerStars Hand #222954507256:  Hold'em No Limit ($0.05/$0.10 USD) - 2021/01/23 9:07:00 ET
Table 'Lutetia III' 6-max Seat #3 is the button
Seat 1: Calltossen ($11.62 in chips) 
Seat 2: pernth ($7.32 in chips) 
Seat 3: AndriuWasa ($10 in chips) 
Seat 4: Mazerpelt ($12.52 in chips) 
Seat 6: Squashy22 ($13.20 in chips) 
Mazerpelt: posts small blind $0.05
Squashy22: posts big blind $0.10
*** HOLE CARDS ***
Calltossen: folds 
pernth: folds 
AndriuWasa: raises $0.15 to $0.25
Mazerpelt: folds 
Squashy22: folds 
Uncalled bet ($0.15) returned to AndriuWasa
AndriuWasa collected $0.25 from pot
AndriuWasa: doesn't show hand 
*** SUMMARY ***
Total pot $0.25 | Rake $0 
Seat 1: Calltossen folded before Flop (didn't bet)
Seat 2: pernth folded before Flop (didn't bet)
Seat 3: AndriuWasa (button) collected ($0.25)
Seat 4: Mazerpelt (small blind) folded before Flop
Seat 6: Squashy22 (big blind) folded before Flop



PokerStars Hand #222954516429:  Hold'em No Limit ($0.05/$0.10 USD) - 2021/01/23 9:07:19 ET
Table 'Lutetia III' 6-max Seat #4 is the button
Seat 1: Calltossen ($11.62 in chips) 
Seat 2: pernth ($7.32 in chips) 
Seat 3: AndriuWasa ($10.15 in chips) 
Seat 4: Mazerpelt ($12.47 in chips) 
Seat 6: Squashy22 ($13.10 in chips) 
Squashy22: posts small blind $0.05
Calltossen: posts big blind $0.10
*** HOLE CARDS ***
pernth: raises $0.20 to $0.30
AndriuWasa: folds 
Mazerpelt: folds 
Squashy22: calls $0.25
Calltossen: folds 
*** FLOP *** [Ac 2s 3s]
Squashy22: checks 
pernth: bets $0.40
Squashy22: calls $0.40
*** TURN *** [Ac 2s 3s] [8d]
Squashy22: checks 
pernth: bets $0.80
Squashy22: calls $0.80
*** RIVER *** [Ac 2s 3s 8d] [8c]
Squashy22: checks 
pernth: checks 
*** SHOW DOWN ***
Squashy22: shows [As Kh] (two pair, Aces and Eights)
pernth: shows [Kc Ah] (two pair, Aces and Eights)
Squashy22 collected $1.48 from pot
pernth collected $1.48 from pot
*** SUMMARY ***
Total pot $3.10 | Rake $0.14 
Board [Ac 2s 3s 8d 8c]
Seat 1: Calltossen (big blind) folded before Flop
Seat 2: pernth showed [Kc Ah] and won ($1.48) with two pair, Aces and Eights
Seat 3: AndriuWasa folded before Flop (didn't bet)
Seat 4: Mazerpelt (button) folded before Flop (didn't bet)
Seat 6: Squashy22 (small blind) showed [As Kh] and won ($1.48) with two pair, Aces and Eights



PokerStars Hand #222954541215:  Hold'em No Limit ($0.05/$0.10 USD) - 2021/01/23 9:08:09 ET
Table 'Lutetia III' 6-max Seat #6 is the button
Seat 1: Calltossen ($11.52 in chips) 
Seat 2: pernth ($7.30 in chips) 
Seat 3: AndriuWasa ($10.15 in chips) 
Seat 4: Mazerpelt ($12.47 in chips) 
Seat 6: Squashy22 ($13.08 in chips) 
Calltossen: posts small blind $0.05
pernth: posts big blind $0.10
AzulAzul999: sits out 
*** HOLE CARDS ***
AndriuWasa: folds 
Mazerpelt: raises $0.20 to $0.30
Squashy22: folds 
Calltossen: folds 
pernth: folds 
Uncalled bet ($0.20) returned to Mazerpelt
Mazerpelt collected $0.25 from pot
*** SUMMARY ***
Total pot $0.25 | Rake $0 
Seat 1: Calltossen (small blind) folded before Flop
Seat 2: pernth (big blind) folded before Flop
Seat 3: AndriuWasa folded before Flop (didn't bet)
Seat 4: Mazerpelt collected ($0.25)
Seat 6: Squashy22 (button) folded before Flop (didn't bet)



PokerStars Hand #222954546394:  Hold'em No Limit ($0.05/$0.10 USD) - 2021/01/23 9:08:20 ET
Table 'Lutetia III' 6-max Seat #1 is the button
Seat 1: Calltossen ($11.47 in chips) 
Seat 2: pernth ($7.20 in chips) 
Seat 3: AndriuWasa ($10.15 in chips) 
Seat 4: Mazerpelt ($12.62 in chips) 
Seat 6: Squashy22 ($13.08 in chips) 
pernth: posts small blind $0.05
AndriuWasa: posts big blind $0.10
AzulAzul999: sits out 
*** HOLE CARDS ***
Mazerpelt: raises $0.20 to $0.30
Squashy22: folds 
Calltossen: folds 
pernth: raises $0.20 to $0.50
AndriuWasa: folds 
Mazerpelt: calls $0.20
*** FLOP *** [3s Qd Tc]
pernth: bets $0.53
Mazerpelt: folds 
Uncalled bet ($0.53) returned to pernth
pernth collected $1.05 from pot
pernth: doesn't show hand 
*** SUMMARY ***
Total pot $1.10 | Rake $0.05 
Board [3s Qd Tc]
Seat 1: Calltossen (button) folded before Flop (didn't bet)
Seat 2: pernth (small blind) collected ($1.05)
Seat 3: AndriuWasa (big blind) folded before Flop
Seat 4: Mazerpelt folded on the Flop
Seat 6: Squashy22 folded before Flop (didn't bet)



PokerStars Hand #222954557129:  Hold'em No Limit ($0.05/$0.10 USD) - 2021/01/23 9:08:42 ET
Table 'Lutetia III' 6-max Seat #2 is the button
Seat 1: Calltossen ($11.47 in chips) 
Seat 2: pernth ($7.75 in chips) 
Seat 3: AndriuWasa ($10.05 in chips) 
Seat 4: Mazerpelt ($12.12 in chips) 
Seat 6: Squashy22 ($13.08 in chips) 
AndriuWasa: posts small blind $0.05
Mazerpelt: posts big blind $0.10
AzulAzul999: sits out 
*** HOLE CARDS ***
Squashy22: folds 
Calltossen: folds 
pernth: raises $0.20 to $0.30
AndriuWasa: folds 
Mazerpelt: folds 
Uncalled bet ($0.20) returned to pernth
pernth collected $0.25 from pot
pernth: doesn't show hand 
*** SUMMARY ***
Total pot $0.25 | Rake $0 
Seat 1: Calltossen folded before Flop (didn't bet)
Seat 2: pernth (button) collected ($0.25)
Seat 3: AndriuWasa (small blind) folded before Flop
Seat 4: Mazerpelt (big blind) folded before Flop
Seat 6: Squashy22 folded before Flop (didn't bet)



PokerStars Hand #222954566614:  Hold'em No Limit ($0.05/$0.10 USD) - 2021/01/23 9:09:01 ET
Table 'Lutetia III' 6-max Seat #3 is the button
Seat 1: Calltossen ($11.47 in chips) 
Seat 2: pernth ($7.90 in chips) 
Seat 3: AndriuWasa ($10 in chips) 
Seat 4: Mazerpelt ($12.02 in chips) 
Seat 5: AzulAzul999 ($10 in chips) 
Seat 6: Squashy22 ($13.08 in chips) 
Mazerpelt: posts small blind $0.05
AzulAzul999: posts big blind $0.10
*** HOLE CARDS ***
Squashy22: folds 
Calltossen: raises $0.20 to $0.30
pernth: folds 
AndriuWasa: folds 
Mazerpelt: folds 
AzulAzul999: calls $0.20
*** FLOP *** [Ts Jd 9c]
AzulAzul999: checks 
Calltossen: bets $0.47
AzulAzul999: calls $0.47
*** TURN *** [Ts Jd 9c] [9s]
AzulAzul999: checks 
Calltossen: bets $1.14
AzulAzul999: folds 
Uncalled bet ($1.14) returned to Calltossen
Calltossen collected $1.52 from pot
Calltossen: doesn't show hand 
*** SUMMARY ***
Total pot $1.59 | Rake $0.07 
Board [Ts Jd 9c 9s]
Seat 1: Calltossen collected ($1.52)
Seat 2: pernth folded before Flop (didn't bet)
Seat 3: AndriuWasa (button) folded before Flop (didn't bet)
Seat 4: Mazerpelt (small blind) folded before Flop
Seat 5: AzulAzul999 (big blind) folded on the Turn
Seat 6: Squashy22 folded before Flop (didn't bet)



PokerStars Hand #222954593528:  Hold'em No Limit ($0.05/$0.10 USD) - 2021/01/23 9:09:56 ET
Table 'Lutetia III' 6-max Seat #4 is the button
Seat 1: Calltossen ($12.22 in chips) 
Seat 2: pernth ($7.90 in chips) 
Seat 3: AndriuWasa ($10 in chips) 
Seat 4: Mazerpelt ($11.97 in chips) 
Seat 5: AzulAzul999 ($10 in chips) 
Seat 6: Squashy22 ($13.08 in chips) 
AzulAzul999: posts small blind $0.05
Squashy22: posts big blind $0.10
*** HOLE CARDS ***
Calltossen: folds 
pernth: raises $0.20 to $0.30
AndriuWasa: folds 
Mazerpelt: folds 
AzulAzul999: folds 
Squashy22: folds 
Uncalled bet ($0.20) returned to pernth
pernth collected $0.25 from pot
pernth: doesn't show hand 
*** SUMMARY ***
Total pot $0.25 | Rake $0 
Seat 1: Calltossen folded before Flop (didn't bet)
Seat 2: pernth collected ($0.25)
Seat 3: AndriuWasa folded before Flop (didn't bet)
Seat 4: Mazerpelt (button) folded before Flop (didn't bet)
Seat 5: AzulAzul999 (small blind) folded before Flop
Seat 6: Squashy22 (big blind) folded before Flop



PokerStars Hand #222954603608:  Hold'em No Limit ($0.05/$0.10 USD) - 2021/01/23 9:10:16 ET
Table 'Lutetia III' 6-max Seat #5 is the button
Seat 1: Calltossen ($12.22 in chips) 
Seat 2: pernth ($8.05 in chips) 
Seat 3: AndriuWasa ($10 in chips) 
Seat 4: Mazerpelt ($11.97 in chips) 
Seat 5: AzulAzul999 ($10 in chips) 
Seat 6: Squashy22 ($12.98 in chips) 
Squashy22: posts small blind $0.05
Calltossen: posts big blind $0.10
*** HOLE CARDS ***
pernth: folds 
AndriuWasa: folds 
Mazerpelt: folds 
AzulAzul999: folds 
Squashy22: folds 
Uncalled bet ($0.05) returned to Calltossen
Calltossen collected $0.10 from pot
Calltossen: doesn't show hand 
*** SUMMARY ***
Total pot $0.10 | Rake $0 
Seat 1: Calltossen (big blind) collected ($0.10)
Seat 2: pernth folded before Flop (didn't bet)
Seat 3: AndriuWasa folded before Flop (didn't bet)
Seat 4: Mazerpelt folded before Flop (didn't bet)
Seat 5: AzulAzul999 (button) folded before Flop (didn't bet)
Seat 6: Squashy22 (small blind) folded before Flop



PokerStars Hand #222954611733:  Hold'em No Limit ($0.05/$0.10 USD) - 2021/01/23 9:10:32 ET
Table 'Lutetia III' 6-max Seat #6 is the button
Seat 1: Calltossen ($12.27 in chips) 
Seat 2: pernth ($8.05 in chips) 
Seat 3: AndriuWasa ($10 in chips) 
Seat 4: Mazerpelt ($11.97 in chips) 
Seat 5: AzulAzul999 ($10 in chips) 
Seat 6: Squashy22 ($12.93 in chips) 
Calltossen: posts small blind $0.05
pernth: posts big blind $0.10
*** HOLE CARDS ***
AndriuWasa: folds 
Mazerpelt: folds 
AzulAzul999: folds 
Squashy22: raises $0.16 to $0.26
Calltossen: folds 
pernth: folds 
Uncalled bet ($0.16) returned to Squashy22
Squashy22 collected $0.25 from pot
Squashy22: doesn't show hand 
*** SUMMARY ***
Total pot $0.25 | Rake $0 
Seat 1: Calltossen (small blind) folded before Flop
Seat 2: pernth (big blind) folded before Flop
Seat 3: AndriuWasa folded before Flop (didn't bet)
Seat 4: Mazerpelt folded before Flop (didn't bet)
Seat 5: AzulAzul999 folded before Flop (didn't bet)
Seat 6: Squashy22 (button) collected ($0.25)



PokerStars Hand #222954618890:  Hold'em No Limit ($0.05/$0.10 USD) - 2021/01/23 9:10:47 ET
Table 'Lutetia III' 6-max Seat #1 is the button
Seat 1: Calltossen ($12.22 in chips) 
Seat 2: pernth ($7.95 in chips) 
Seat 3: AndriuWasa ($10 in chips) 
Seat 4: Mazerpelt ($11.97 in chips) 
Seat 5: AzulAzul999 ($10 in chips) 
Seat 6: Squashy22 ($13.08 in chips) 
pernth: posts small blind $0.05
AndriuWasa: posts big blind $0.10
*** HOLE CARDS ***
Mazerpelt: folds 
AzulAzul999: raises $0.20 to $0.30
Squashy22: folds 
Calltossen: folds 
pernth: folds 
AndriuWasa: folds 
Uncalled bet ($0.20) returned to AzulAzul999
AzulAzul999 collected $0.25 from pot
AzulAzul999: doesn't show hand 
*** SUMMARY ***
Total pot $0.25 | Rake $0 
Seat 1: Calltossen (button) folded before Flop (didn't bet)
Seat 2: pernth (small blind) folded before Flop
Seat 3: AndriuWasa (big blind) folded before Flop
Seat 4: Mazerpelt folded before Flop (didn't bet)
Seat 5: AzulAzul999 collected ($0.25)
Seat 6: Squashy22 folded before Flop (didn't bet)



PokerStars Hand #222954631179:  Hold'em No Limit ($0.05/$0.10 USD) - 2021/01/23 9:11:11 ET
Table 'Lutetia III' 6-max Seat #2 is the button
Seat 1: Calltossen ($12.22 in chips) 
Seat 2: pernth ($7.90 in chips) 
Seat 3: AndriuWasa ($10 in chips) 
Seat 4: Mazerpelt ($11.97 in chips) 
Seat 5: AzulAzul999 ($10.15 in chips) 
Seat 6: Squashy22 ($13.08 in chips) 
AndriuWasa: posts small blind $0.05
Mazerpelt: posts big blind $0.10
*** HOLE CARDS ***
AzulAzul999: folds 
Squashy22: folds 
Calltossen: folds 
pernth: folds 
AndriuWasa: raises $0.22 to $0.32
Mazerpelt: folds 
Uncalled bet ($0.22) returned to AndriuWasa
AndriuWasa collected $0.20 from pot
AndriuWasa: doesn't show hand 
*** SUMMARY ***
Total pot $0.20 | Rake $0 
Seat 1: Calltossen folded before Flop (didn't bet)
Seat 2: pernth (button) folded before Flop (didn't bet)
Seat 3: AndriuWasa (small blind) collected ($0.20)
Seat 4: Mazerpelt (big blind) folded before Flop
Seat 5: AzulAzul999 folded before Flop (didn't bet)
Seat 6: Squashy22 folded before Flop (didn't bet)



PokerStars Hand #222954638251:  Hold'em No Limit ($0.05/$0.10 USD) - 2021/01/23 9:11:26 ET
Table 'Lutetia III' 6-max Seat #3 is the button
Seat 1: Calltossen ($12.22 in chips) 
Seat 2: pernth ($7.90 in chips) 
Seat 3: AndriuWasa ($10.10 in chips) 
Seat 4: Mazerpelt ($11.87 in chips) 
Seat 5: AzulAzul999 ($10.15 in chips) 
Seat 6: Squashy22 ($13.08 in chips) 
Mazerpelt: posts small blind $0.05
AzulAzul999: posts big blind $0.10
*** HOLE CARDS ***
Squashy22: folds 
Calltossen: folds 
pernth: folds 
AndriuWasa: folds 
Mazerpelt: folds 
Uncalled bet ($0.05) returned to AzulAzul999
AzulAzul999 collected $0.10 from pot
AzulAzul999: doesn't show hand 
*** SUMMARY ***
Total pot $0.10 | Rake $0 
Seat 1: Calltossen folded before Flop (didn't bet)
Seat 2: pernth folded before Flop (didn't bet)
Seat 3: AndriuWasa (button) folded before Flop (didn't bet)
Seat 4: Mazerpelt (small blind) folded before Flop
Seat 5: AzulAzul999 (big blind) collected ($0.10)
Seat 6: Squashy22 folded before Flop (didn't bet)



PokerStars Hand #222954646272:  Hold'em No Limit ($0.05/$0.10 USD) - 2021/01/23 9:11:42 ET
Table 'Lutetia III' 6-max Seat #4 is the button
Seat 1: Calltossen ($12.22 in chips) 
Seat 2: pernth ($7.90 in chips) 
Seat 3: AndriuWasa ($10.10 in chips) 
Seat 4: Mazerpelt ($11.82 in chips) 
Seat 5: AzulAzul999 ($10.20 in chips) 
Seat 6: Squashy22 ($13.08 in chips) 
AzulAzul999: posts small blind $0.05
Squashy22: posts big blind $0.10
*** HOLE CARDS ***
Calltossen: folds 
pernth: folds 
AndriuWasa: folds 
Mazerpelt: folds 
AzulAzul999: folds 
Uncalled bet ($0.05) returned to Squashy22
Squashy22 collected $0.10 from pot
Squashy22: doesn't show hand 
*** SUMMARY ***
Total pot $0.10 | Rake $0 
Seat 1: Calltossen folded before Flop (didn't bet)
Seat 2: pernth folded before Flop (didn't bet)
Seat 3: AndriuWasa folded before Flop (didn't bet)
Seat 4: Mazerpelt (button) folded before Flop (didn't bet)
Seat 5: AzulAzul999 (small blind) folded before Flop
Seat 6: Squashy22 (big blind) collected ($0.10)



PokerStars Hand #222954650868:  Hold'em No Limit ($0.05/$0.10 USD) - 2021/01/23 9:11:51 ET
Table 'Lutetia III' 6-max Seat #5 is the button
Seat 1: Calltossen ($12.22 in chips) 
Seat 2: pernth ($7.90 in chips) 
Seat 3: AndriuWasa ($10.10 in chips) 
Seat 4: Mazerpelt ($11.82 in chips) 
Seat 5: AzulAzul999 ($10.15 in chips) 
Seat 6: Squashy22 ($13.13 in chips) 
Squashy22: posts small blind $0.05
Calltossen: posts big blind $0.10
*** HOLE CARDS ***
pernth: folds 
AndriuWasa: folds 
Mazerpelt: folds 
AzulAzul999: folds 
Squashy22: folds 
Uncalled bet ($0.05) returned to Calltossen
Calltossen collected $0.10 from pot
Calltossen: doesn't show hand 
*** SUMMARY ***
Total pot $0.10 | Rake $0 
Seat 1: Calltossen (big blind) collected ($0.10)
Seat 2: pernth folded before Flop (didn't bet)
Seat 3: AndriuWasa folded before Flop (didn't bet)
Seat 4: Mazerpelt folded before Flop (didn't bet)
Seat 5: AzulAzul999 (button) folded before Flop (didn't bet)
Seat 6: Squashy22 (small blind) folded before Flop



PokerStars Hand #222954660014:  Hold'em No Limit ($0.05/$0.10 USD) - 2021/01/23 9:12:10 ET
Table 'Lutetia III' 6-max Seat #6 is the button
Seat 1: Calltossen ($12.27 in chips) 
Seat 2: pernth ($7.90 in chips) 
Seat 3: AndriuWasa ($10.10 in chips) 
Seat 4: Mazerpelt ($11.82 in chips) 
Seat 5: AzulAzul999 ($10.15 in chips) 
Seat 6: Squashy22 ($13.08 in chips) 
Calltossen: posts small blind $0.05
pernth: posts big blind $0.10
*** HOLE CARDS ***
AndriuWasa: folds 
Mazerpelt: folds 
AzulAzul999: raises $0.20 to $0.30
Squashy22: folds 
Calltossen: raises $0.70 to $1
pernth: folds 
AzulAzul999: folds 
Uncalled bet ($0.70) returned to Calltossen
Calltossen collected $0.70 from pot
Calltossen: doesn't show hand 
*** SUMMARY ***
Total pot $0.70 | Rake $0 
Seat 1: Calltossen (small blind) collected ($0.70)
Seat 2: pernth (big blind) folded before Flop
Seat 3: AndriuWasa folded before Flop (didn't bet)
Seat 4: Mazerpelt folded before Flop (didn't bet)
Seat 5: AzulAzul999 folded before Flop
Seat 6: Squashy22 (button) folded before Flop (didn't bet)



PokerStars Hand #222954675084:  Hold'em No Limit ($0.05/$0.10 USD) - 2021/01/23 9:12:40 ET
Table 'Lutetia III' 6-max Seat #1 is the button
Seat 1: Calltossen ($12.67 in chips) 
Seat 2: pernth ($7.80 in chips) 
Seat 3: AndriuWasa ($10.10 in chips) 
Seat 4: Mazerpelt ($11.82 in chips) 
Seat 5: AzulAzul999 ($10 in chips) 
Seat 6: Squashy22 ($13.08 in chips) 
pernth: posts small blind $0.05
AndriuWasa: posts big blind $0.10
*** HOLE CARDS ***
Mazerpelt: folds 
AzulAzul999: folds 
Squashy22: folds 
Calltossen: folds 
pernth: raises $0.20 to $0.30
AndriuWasa: folds 
Uncalled bet ($0.20) returned to pernth
pernth collected $0.20 from pot
pernth: doesn't show hand 
*** SUMMARY ***
Total pot $0.20 | Rake $0 
Seat 1: Calltossen (button) folded before Flop (didn't bet)
Seat 2: pernth (small blind) collected ($0.20)
Seat 3: AndriuWasa (big blind) folded before Flop
Seat 4: Mazerpelt folded before Flop (didn't bet)
Seat 5: AzulAzul999 folded before Flop (didn't bet)
Seat 6: Squashy22 folded before Flop (didn't bet)



PokerStars Hand #222954684026:  Hold'em No Limit ($0.05/$0.10 USD) - 2021/01/23 9:12:58 ET
Table 'Lutetia III' 6-max Seat #2 is the button
Seat 1: Calltossen ($12.67 in chips) 
Seat 2: pernth ($7.90 in chips) 
Seat 3: AndriuWasa ($10 in chips) 
Seat 4: Mazerpelt ($11.82 in chips) 
Seat 5: AzulAzul999 ($10 in chips) 
Seat 6: Squashy22 ($13.08 in chips) 
AndriuWasa: posts small blind $0.05
Mazerpelt: posts big blind $0.10
*** HOLE CARDS ***
AzulAzul999 has timed out
AzulAzul999: folds 
Squashy22: folds 
Calltossen: folds 
pernth: raises $0.20 to $0.30
AndriuWasa: folds 
Mazerpelt: calls $0.20
*** FLOP *** [8d 8s 9s]
Mazerpelt: checks 
pernth: checks 
*** TURN *** [8d 8s 9s] [7d]
Mazerpelt: bets $0.41
pernth: folds 
Uncalled bet ($0.41) returned to Mazerpelt
Mazerpelt collected $0.62 from pot
*** SUMMARY ***
Total pot $0.65 | Rake $0.03 
Board [8d 8s 9s 7d]
Seat 1: Calltossen folded before Flop (didn't bet)
Seat 2: pernth (button) folded on the Turn
Seat 3: AndriuWasa (small blind) folded before Flop
Seat 4: Mazerpelt (big blind) collected ($0.62)
Seat 5: AzulAzul999 folded before Flop (didn't bet)
Seat 6: Squashy22 folded before Flop (didn't bet)



PokerStars Hand #222954703733:  Hold'em No Limit ($0.05/$0.10 USD) - 2021/01/23 9:13:37 ET
Table 'Lutetia III' 6-max Seat #3 is the button
Seat 1: Calltossen ($12.67 in chips) 
Seat 2: pernth ($7.60 in chips) 
Seat 3: AndriuWasa ($10 in chips) 
Seat 4: Mazerpelt ($12.14 in chips) 
Seat 6: Squashy22 ($13.08 in chips) 
Mazerpelt: posts small blind $0.05
Squashy22: posts big blind $0.10
*** HOLE CARDS ***
Calltossen: folds 
pernth: raises $0.20 to $0.30
AndriuWasa: calls $0.30
Mazerpelt: folds 
Squashy22: folds 
*** FLOP *** [2c 2d 6c]
pernth: checks 
AndriuWasa: checks 
*** TURN *** [2c 2d 6c] [Js]
pernth: checks 
AndriuWasa: checks 
*** RIVER *** [2c 2d 6c Js] [3s]
pernth: checks 
AndriuWasa: bets $0.24
pernth: folds 
Uncalled bet ($0.24) returned to AndriuWasa
AndriuWasa collected $0.72 from pot
AndriuWasa: doesn't show hand 
*** SUMMARY ***
Total pot $0.75 | Rake $0.03 
Board [2c 2d 6c Js 3s]
Seat 1: Calltossen folded before Flop (didn't bet)
Seat 2: pernth folded on the River
Seat 3: AndriuWasa (button) collected ($0.72)
Seat 4: Mazerpelt (small blind) folded before Flop
Seat 6: Squashy22 (big blind) folded before Flop



PokerStars Hand #222954719714:  Hold'em No Limit ($0.05/$0.10 USD) - 2021/01/23 9:14:09 ET
Table 'Lutetia III' 6-max Seat #4 is the button
Seat 1: Calltossen ($12.67 in chips) 
Seat 2: pernth ($7.30 in chips) 
Seat 3: AndriuWasa ($10.42 in chips) 
Seat 4: Mazerpelt ($12.09 in chips) 
Seat 6: Squashy22 ($12.98 in chips) 
Squashy22: posts small blind $0.05
Calltossen: posts big blind $0.10
*** HOLE CARDS ***
pernth: folds 
AndriuWasa: raises $0.15 to $0.25
Mazerpelt: folds 
Squashy22: folds 
Calltossen: folds 
Uncalled bet ($0.15) returned to AndriuWasa
AndriuWasa collected $0.25 from pot
AndriuWasa: doesn't show hand 
*** SUMMARY ***
Total pot $0.25 | Rake $0 
Seat 1: Calltossen (big blind) folded before Flop
Seat 2: pernth folded before Flop (didn't bet)
Seat 3: AndriuWasa collected ($0.25)
Seat 4: Mazerpelt (button) folded before Flop (didn't bet)
Seat 6: Squashy22 (small blind) folded before Flop



PokerStars Hand #222954728652:  Hold'em No Limit ($0.05/$0.10 USD) - 2021/01/23 9:14:27 ET
Table 'Lutetia III' 6-max Seat #6 is the button
Seat 1: Calltossen ($12.57 in chips) 
Seat 2: pernth ($7.30 in chips) 
Seat 3: AndriuWasa ($10.57 in chips) 
Seat 4: Mazerpelt ($12.09 in chips) 
Seat 6: Squashy22 ($12.93 in chips) 
Calltossen: posts small blind $0.05
pernth: posts big blind $0.10
*** HOLE CARDS ***
AndriuWasa: folds 
Mazerpelt: raises $0.20 to $0.30
Squashy22: folds 
Calltossen: folds 
pernth: folds 
Uncalled bet ($0.20) returned to Mazerpelt
Mazerpelt collected $0.25 from pot
*** SUMMARY ***
Total pot $0.25 | Rake $0 
Seat 1: Calltossen (small blind) folded before Flop
Seat 2: pernth (big blind) folded before Flop
Seat 3: AndriuWasa folded before Flop (didn't bet)
Seat 4: Mazerpelt collected ($0.25)
Seat 6: Squashy22 (button) folded before Flop (didn't bet)



PokerStars Hand #222954732608:  Hold'em No Limit ($0.05/$0.10 USD) - 2021/01/23 9:14:35 ET
Table 'Lutetia III' 6-max Seat #1 is the button
Seat 1: Calltossen ($12.52 in chips) 
Seat 2: pernth ($7.20 in chips) 
Seat 3: AndriuWasa ($10.57 in chips) 
Seat 4: Mazerpelt ($12.24 in chips) 
Seat 6: Squashy22 ($12.93 in chips) 
pernth: posts small blind $0.05
AndriuWasa: posts big blind $0.10
*** HOLE CARDS ***
Mazerpelt: folds 
Squashy22: raises $0.16 to $0.26
Calltossen: folds 
pernth: folds 
AndriuWasa: folds 
Uncalled bet ($0.16) returned to Squashy22
Squashy22 collected $0.25 from pot
Squashy22: doesn't show hand 
*** SUMMARY ***
Total pot $0.25 | Rake $0 
Seat 1: Calltossen (button) folded before Flop (didn't bet)
Seat 2: pernth (small blind) folded before Flop
Seat 3: AndriuWasa (big blind) folded before Flop
Seat 4: Mazerpelt folded before Flop (didn't bet)
Seat 6: Squashy22 collected ($0.25)



PokerStars Hand #222954740068:  Hold'em No Limit ($0.05/$0.10 USD) - 2021/01/23 9:14:50 ET
Table 'Lutetia III' 6-max Seat #2 is the button
Seat 1: Calltossen ($12.52 in chips) 
Seat 2: pernth ($7.15 in chips) 
Seat 3: AndriuWasa ($10.47 in chips) 
Seat 4: Mazerpelt ($12.24 in chips) 
Seat 6: Squashy22 ($13.08 in chips) 
AndriuWasa: posts small blind $0.05
Mazerpelt: posts big blind $0.10
*** HOLE CARDS ***
Squashy22: folds 
Calltossen: folds 
pernth: folds 
AndriuWasa: folds 
Uncalled bet ($0.05) returned to Mazerpelt
Mazerpelt collected $0.10 from pot
*** SUMMARY ***
Total pot $0.10 | Rake $0 
Seat 1: Calltossen folded before Flop (didn't bet)
Seat 2: pernth (button) folded before Flop (didn't bet)
Seat 3: AndriuWasa (small blind) folded before Flop
Seat 4: Mazerpelt (big blind) collected ($0.10)
Seat 6: Squashy22 folded before Flop (didn't bet)



PokerStars Hand #222954744932:  Hold'em No Limit ($0.05/$0.10 USD) - 2021/01/23 9:14:59 ET
Table 'Lutetia III' 6-max Seat #3 is the button
Seat 1: Calltossen ($12.52 in chips) 
Seat 2: pernth ($7.15 in chips) 
Seat 3: AndriuWasa ($10.42 in chips) 
Seat 4: Mazerpelt ($12.29 in chips) 
Seat 6: Squashy22 ($13.08 in chips) 
Mazerpelt: posts small blind $0.05
Squashy22: posts big blind $0.10
*** HOLE CARDS ***
Calltossen: folds 
pernth: folds 
AndriuWasa: raises $0.15 to $0.25
Mazerpelt: folds 
Squashy22: folds 
Uncalled bet ($0.15) returned to AndriuWasa
AndriuWasa collected $0.25 from pot
AndriuWasa: doesn't show hand 
*** SUMMARY ***
Total pot $0.25 | Rake $0 
Seat 1: Calltossen folded before Flop (didn't bet)
Seat 2: pernth folded before Flop (didn't bet)
Seat 3: AndriuWasa (button) collected ($0.25)
Seat 4: Mazerpelt (small blind) folded before Flop
Seat 6: Squashy22 (big blind) folded before Flop



PokerStars Hand #222954754639:  Hold'em No Limit ($0.05/$0.10 USD) - 2021/01/23 9:15:19 ET
Table 'Lutetia III' 6-max Seat #4 is the button
Seat 1: Calltossen ($12.52 in chips) 
Seat 2: pernth ($7.15 in chips) 
Seat 3: AndriuWasa ($10.57 in chips) 
Seat 4: Mazerpelt ($12.24 in chips) 
Seat 6: Squashy22 ($12.98 in chips) 
Squashy22: posts small blind $0.05
Calltossen: posts big blind $0.10
*** HOLE CARDS ***
pernth: raises $0.10 to $0.20
AndriuWasa: folds 
Mazerpelt: folds 
Squashy22: folds 
Calltossen: calls $0.10
*** FLOP *** [5s Ac 5d]
Calltossen: checks 
pernth: checks 
*** TURN *** [5s Ac 5d] [Js]
Calltossen: checks 
pernth: checks 
*** RIVER *** [5s Ac 5d Js] [6c]
Calltossen: checks 
pernth: bets $0.30
Calltossen: folds 
Uncalled bet ($0.30) returned to pernth
pernth collected $0.43 from pot
pernth: doesn't show hand 
*** SUMMARY ***
Total pot $0.45 | Rake $0.02 
Board [5s Ac 5d Js 6c]
Seat 1: Calltossen (big blind) folded on the River
Seat 2: pernth collected ($0.43)
Seat 3: AndriuWasa folded before Flop (didn't bet)
Seat 4: Mazerpelt (button) folded before Flop (didn't bet)
Seat 6: Squashy22 (small blind) folded before Flop



PokerStars Hand #222954772495:  Hold'em No Limit ($0.05/$0.10 USD) - 2021/01/23 9:15:55 ET
Table 'Lutetia III' 6-max Seat #6 is the button
Seat 1: Calltossen ($12.32 in chips) 
Seat 2: pernth ($7.38 in chips) 
Seat 3: AndriuWasa ($10.57 in chips) 
Seat 4: Mazerpelt ($12.24 in chips) 
Seat 6: Squashy22 ($12.93 in chips) 
Calltossen: posts small blind $0.05
pernth: posts big blind $0.10
AzulAzul999: sits out 
*** HOLE CARDS ***
AndriuWasa: folds 
Mazerpelt: raises $0.20 to $0.30
Squashy22: folds 
Calltossen: folds 
pernth: calls $0.20
*** FLOP *** [4h Kh Jh]
pernth: checks 
Mazerpelt: bets $0.41
pernth: calls $0.41
*** TURN *** [4h Kh Jh] [5h]
pernth: checks 
Mazerpelt: checks 
*** RIVER *** [4h Kh Jh 5h] [6h]
pernth: checks 
Mazerpelt: checks 
*** SHOW DOWN ***
pernth: shows [9s 9h] (a flush, King high)
Mazerpelt: mucks hand 
pernth collected $1.40 from pot
*** SUMMARY ***
Total pot $1.47 | Rake $0.07 
Board [4h Kh Jh 5h 6h]
Seat 1: Calltossen (small blind) folded before Flop
Seat 2: pernth (big blind) showed [9s 9h] and won ($1.40) with a flush, King high
Seat 3: AndriuWasa folded before Flop (didn't bet)
Seat 4: Mazerpelt mucked
Seat 6: Squashy22 (button) folded before Flop (didn't bet)



PokerStars Hand #222954790510:  Hold'em No Limit ($0.05/$0.10 USD) - 2021/01/23 9:16:31 ET
Table 'Lutetia III' 6-max Seat #1 is the button
Seat 1: Calltossen ($12.27 in chips) 
Seat 2: pernth ($8.07 in chips) 
Seat 3: AndriuWasa ($10.57 in chips) 
Seat 4: Mazerpelt ($11.53 in chips) 
Seat 6: Squashy22 ($12.93 in chips) 
pernth: posts small blind $0.05
AndriuWasa: posts big blind $0.10
AzulAzul999: sits out 
*** HOLE CARDS ***
Mazerpelt: raises $0.20 to $0.30
Squashy22: folds 
Calltossen: folds 
pernth: calls $0.25
AndriuWasa: folds 
*** FLOP *** [Qh Jh Jc]
pernth: checks 
Mazerpelt: bets $0.45
pernth: calls $0.45
*** TURN *** [Qh Jh Jc] [Ad]
pernth: checks 
Mazerpelt: bets $1.02
pernth: calls $1.02
*** RIVER *** [Qh Jh Jc Ad] [2c]
pernth: checks 
Mazerpelt: checks 
*** SHOW DOWN ***
pernth: shows [Ah 6h] (two pair, Aces and Jacks)
Mazerpelt: mucks hand 
pernth collected $3.48 from pot
*** SUMMARY ***
Total pot $3.64 | Rake $0.16 
Board [Qh Jh Jc Ad 2c]
Seat 1: Calltossen (button) folded before Flop (didn't bet)
Seat 2: pernth (small blind) showed [Ah 6h] and won ($3.48) with two pair, Aces and Jacks
Seat 3: AndriuWasa (big blind) folded before Flop
Seat 4: Mazerpelt mucked
Seat 6: Squashy22 folded before Flop (didn't bet)



PokerStars Hand #222954815944:  Hold'em No Limit ($0.05/$0.10 USD) - 2021/01/23 9:17:22 ET
Table 'Lutetia III' 6-max Seat #2 is the button
Seat 1: Calltossen ($12.27 in chips) 
Seat 2: pernth ($9.78 in chips) 
Seat 3: AndriuWasa ($10.47 in chips) 
Seat 4: Mazerpelt ($10 in chips) 
Seat 6: Squashy22 ($12.93 in chips) 
AndriuWasa: posts small blind $0.05
Mazerpelt: posts big blind $0.10
AzulAzul999: sits out 
*** HOLE CARDS ***
Squashy22: folds 
Calltossen: folds 
pernth: folds 
AndriuWasa: folds 
Uncalled bet ($0.05) returned to Mazerpelt
Mazerpelt collected $0.10 from pot
*** SUMMARY ***
Total pot $0.10 | Rake $0 
Seat 1: Calltossen folded before Flop (didn't bet)
Seat 2: pernth (button) folded before Flop (didn't bet)
Seat 3: AndriuWasa (small blind) folded before Flop
Seat 4: Mazerpelt (big blind) collected ($0.10)
Seat 6: Squashy22 folded before Flop (didn't bet)



PokerStars Hand #222954819788:  Hold'em No Limit ($0.05/$0.10 USD) - 2021/01/23 9:17:30 ET
Table 'Lutetia III' 6-max Seat #3 is the button
Seat 1: Calltossen ($12.27 in chips) 
Seat 2: pernth ($9.78 in chips) 
Seat 3: AndriuWasa ($10.42 in chips) 
Seat 4: Mazerpelt ($10.05 in chips) 
Seat 5: AzulAzul999 ($10 in chips) 
Seat 6: Squashy22 ($12.93 in chips) 
Mazerpelt: posts small blind $0.05
AzulAzul999: posts big blind $0.10
*** HOLE CARDS ***
Squashy22: folds 
Calltossen: folds 
pernth: folds 
AndriuWasa: folds 
Mazerpelt: folds 
Uncalled bet ($0.05) returned to AzulAzul999
AzulAzul999 collected $0.10 from pot
AzulAzul999: doesn't show hand 
*** SUMMARY ***
Total pot $0.10 | Rake $0 
Seat 1: Calltossen folded before Flop (didn't bet)
Seat 2: pernth folded before Flop (didn't bet)
Seat 3: AndriuWasa (button) folded before Flop (didn't bet)
Seat 4: Mazerpelt (small blind) folded before Flop
Seat 5: AzulAzul999 (big blind) collected ($0.10)
Seat 6: Squashy22 folded before Flop (didn't bet)



PokerStars Hand #222954826971:  Hold'em No Limit ($0.05/$0.10 USD) - 2021/01/23 9:17:44 ET
Table 'Lutetia III' 6-max Seat #4 is the button
Seat 1: Calltossen ($12.27 in chips) 
Seat 2: pernth ($9.78 in chips) 
Seat 3: AndriuWasa ($10.42 in chips) 
Seat 4: Mazerpelt ($10 in chips) 
Seat 5: AzulAzul999 ($10.05 in chips) 
Seat 6: Squashy22 ($12.93 in chips) 
AzulAzul999: posts small blind $0.05
Squashy22: posts big blind $0.10
*** HOLE CARDS ***
Calltossen: folds 
pernth: calls $0.10
AndriuWasa: folds 
Mazerpelt: folds 
AzulAzul999: raises $0.35 to $0.45
Squashy22: folds 
pernth: calls $0.35
*** FLOP *** [5h 9d Qd]
AzulAzul999: checks 
pernth: bets $0.50
AzulAzul999: folds 
Uncalled bet ($0.50) returned to pernth
pernth collected $0.96 from pot
pernth: doesn't show hand 
*** SUMMARY ***
Total pot $1 | Rake $0.04 
Board [5h 9d Qd]
Seat 1: Calltossen folded before Flop (didn't bet)
Seat 2: pernth collected ($0.96)
Seat 3: AndriuWasa folded before Flop (didn't bet)
Seat 4: Mazerpelt (button) folded before Flop (didn't bet)
Seat 5: AzulAzul999 (small blind) folded on the Flop
Seat 6: Squashy22 (big blind) folded before Flop



PokerStars Hand #222954856940:  Hold'em No Limit ($0.05/$0.10 USD) - 2021/01/23 9:18:44 ET
Table 'Lutetia III' 6-max Seat #5 is the button
Seat 1: Calltossen ($12.27 in chips) 
Seat 2: pernth ($10.29 in chips) 
Seat 3: AndriuWasa ($10.42 in chips) 
Seat 4: Mazerpelt ($10 in chips) 
Seat 5: AzulAzul999 ($10 in chips) 
Seat 6: Squashy22 ($12.83 in chips) 
Squashy22: posts small blind $0.05
Calltossen: posts big blind $0.10
*** HOLE CARDS ***
pernth: folds 
AndriuWasa: folds 
Mazerpelt: folds 
AzulAzul999: folds 
Squashy22: raises $0.10 to $0.20
Calltossen: folds 
Uncalled bet ($0.10) returned to Squashy22
Squashy22 collected $0.20 from pot
Squashy22: doesn't show hand 
*** SUMMARY ***
Total pot $0.20 | Rake $0 
Seat 1: Calltossen (big blind) folded before Flop
Seat 2: pernth folded before Flop (didn't bet)
Seat 3: AndriuWasa folded before Flop (didn't bet)
Seat 4: Mazerpelt folded before Flop (didn't bet)
Seat 5: AzulAzul999 (button) folded before Flop (didn't bet)
Seat 6: Squashy22 (small blind) collected ($0.20)



PokerStars Hand #222954867147:  Hold'em No Limit ($0.05/$0.10 USD) - 2021/01/23 9:19:04 ET
Table 'Lutetia III' 6-max Seat #6 is the button
Seat 1: Calltossen ($12.17 in chips) 
Seat 2: pernth ($10.29 in chips) 
Seat 3: AndriuWasa ($10.42 in chips) 
Seat 4: Mazerpelt ($10 in chips) 
Seat 5: AzulAzul999 ($10 in chips) 
Seat 6: Squashy22 ($12.93 in chips) 
Calltossen: posts small blind $0.05
pernth: posts big blind $0.10
*** HOLE CARDS ***
AndriuWasa: folds 
Mazerpelt: folds 
AzulAzul999: folds 
Squashy22: folds 
Calltossen: folds 
Uncalled bet ($0.05) returned to pernth
pernth collected $0.10 from pot
pernth: doesn't show hand 
*** SUMMARY ***
Total pot $0.10 | Rake $0 
Seat 1: Calltossen (small blind) folded before Flop
Seat 2: pernth (big blind) collected ($0.10)
Seat 3: AndriuWasa folded before Flop (didn't bet)
Seat 4: Mazerpelt folded before Flop (didn't bet)
Seat 5: AzulAzul999 folded before Flop (didn't bet)
Seat 6: Squashy22 (button) folded before Flop (didn't bet)



PokerStars Hand #222954872294:  Hold'em No Limit ($0.05/$0.10 USD) - 2021/01/23 9:19:15 ET
Table 'Lutetia III' 6-max Seat #1 is the button
Seat 1: Calltossen ($12.12 in chips) 
Seat 2: pernth ($10.34 in chips) 
Seat 3: AndriuWasa ($10.42 in chips) 
Seat 4: Mazerpelt ($10 in chips) 
Seat 5: AzulAzul999 ($10 in chips) 
Seat 6: Squashy22 ($12.93 in chips) 
pernth: posts small blind $0.05
AndriuWasa: posts big blind $0.10
*** HOLE CARDS ***
Mazerpelt: raises $0.20 to $0.30
AzulAzul999: folds 
Squashy22: folds 
Calltossen: folds 
pernth: folds 
AndriuWasa: folds 
Uncalled bet ($0.20) returned to Mazerpelt
Mazerpelt collected $0.25 from pot
*** SUMMARY ***
Total pot $0.25 | Rake $0 
Seat 1: Calltossen (button) folded before Flop (didn't bet)
Seat 2: pernth (small blind) folded before Flop
Seat 3: AndriuWasa (big blind) folded before Flop
Seat 4: Mazerpelt collected ($0.25)
Seat 5: AzulAzul999 folded before Flop (didn't bet)
Seat 6: Squashy22 folded before Flop (didn't bet)



PokerStars Hand #222954880405:  Hold'em No Limit ($0.05/$0.10 USD) - 2021/01/23 9:19:31 ET
Table 'Lutetia III' 6-max Seat #2 is the button
Seat 1: Calltossen ($12.12 in chips) 
Seat 2: pernth ($10.29 in chips) 
Seat 3: AndriuWasa ($10.32 in chips) 
Seat 4: Mazerpelt ($10.15 in chips) 
Seat 5: AzulAzul999 ($10 in chips) 
Seat 6: Squashy22 ($12.93 in chips) 
AndriuWasa: posts small blind $0.05
Mazerpelt: posts big blind $0.10
*** HOLE CARDS ***
AzulAzul999 has timed out
AzulAzul999: folds 
Squashy22: folds 
Calltossen: folds 
pernth: folds 
AndriuWasa: folds 
Uncalled bet ($0.05) returned to Mazerpelt
Mazerpelt collected $0.10 from pot
*** SUMMARY ***
Total pot $0.10 | Rake $0 
Seat 1: Calltossen folded before Flop (didn't bet)
Seat 2: pernth (button) folded before Flop (didn't bet)
Seat 3: AndriuWasa (small blind) folded before Flop
Seat 4: Mazerpelt (big blind) collected ($0.10)
Seat 5: AzulAzul999 folded before Flop (didn't bet)
Seat 6: Squashy22 folded before Flop (didn't bet)



PokerStars Hand #222954888825:  Hold'em No Limit ($0.05/$0.10 USD) - 2021/01/23 9:19:48 ET
Table 'Lutetia III' 6-max Seat #3 is the button
Seat 1: Calltossen ($12.12 in chips) 
Seat 2: pernth ($10.29 in chips) 
Seat 3: AndriuWasa ($10.27 in chips) 
Seat 4: Mazerpelt ($10.20 in chips) 
Seat 5: AzulAzul999 ($10 in chips) 
Seat 6: Squashy22 ($12.93 in chips) 
Mazerpelt: posts small blind $0.05
AzulAzul999: posts big blind $0.10
*** HOLE CARDS ***
Squashy22: folds 
Calltossen: folds 
pernth: folds 
AndriuWasa: folds 
Mazerpelt: folds 
Uncalled bet ($0.05) returned to AzulAzul999
AzulAzul999 collected $0.10 from pot
AzulAzul999: doesn't show hand 
*** SUMMARY ***
Total pot $0.10 | Rake $0 
Seat 1: Calltossen folded before Flop (didn't bet)
Seat 2: pernth folded before Flop (didn't bet)
Seat 3: AndriuWasa (button) folded before Flop (didn't bet)
Seat 4: Mazerpelt (small blind) folded before Flop
Seat 5: AzulAzul999 (big blind) collected ($0.10)
Seat 6: Squashy22 folded before Flop (didn't bet)



PokerStars Hand #222954896098:  Hold'em No Limit ($0.05/$0.10 USD) - 2021/01/23 9:20:02 ET
Table 'Lutetia III' 6-max Seat #4 is the button
Seat 1: Calltossen ($12.12 in chips) 
Seat 2: pernth ($10.29 in chips) 
Seat 3: AndriuWasa ($10.27 in chips) 
Seat 4: Mazerpelt ($10.15 in chips) 
Seat 5: AzulAzul999 ($10.05 in chips) 
Seat 6: Squashy22 ($12.93 in chips) 
AzulAzul999: posts small blind $0.05
Squashy22: posts big blind $0.10
*** HOLE CARDS ***
Calltossen: folds 
pernth: folds 
AndriuWasa: folds 
Mazerpelt: folds 
AzulAzul999: folds 
Uncalled bet ($0.05) returned to Squashy22
Squashy22 collected $0.10 from pot
Squashy22: doesn't show hand 
*** SUMMARY ***
Total pot $0.10 | Rake $0 
Seat 1: Calltossen folded before Flop (didn't bet)
Seat 2: pernth folded before Flop (didn't bet)
Seat 3: AndriuWasa folded before Flop (didn't bet)
Seat 4: Mazerpelt (button) folded before Flop (didn't bet)
Seat 5: AzulAzul999 (small blind) folded before Flop
Seat 6: Squashy22 (big blind) collected ($0.10)



PokerStars Hand #222954900419:  Hold'em No Limit ($0.05/$0.10 USD) - 2021/01/23 9:20:11 ET
Table 'Lutetia III' 6-max Seat #5 is the button
Seat 1: Calltossen ($12.12 in chips) 
Seat 2: pernth ($10.29 in chips) 
Seat 3: AndriuWasa ($10.27 in chips) 
Seat 4: Mazerpelt ($10.15 in chips) 
Seat 5: AzulAzul999 ($10 in chips) 
Seat 6: Squashy22 ($12.98 in chips) 
Squashy22: posts small blind $0.05
Calltossen: posts big blind $0.10
*** HOLE CARDS ***
pernth: folds 
AndriuWasa: folds 
Mazerpelt: folds 
AzulAzul999: folds 
Squashy22: raises $0.14 to $0.24
Calltossen: folds 
Uncalled bet ($0.14) returned to Squashy22
Squashy22 collected $0.20 from pot
Squashy22: doesn't show hand 
*** SUMMARY ***
Total pot $0.20 | Rake $0 
Seat 1: Calltossen (big blind) folded before Flop
Seat 2: pernth folded before Flop (didn't bet)
Seat 3: AndriuWasa folded before Flop (didn't bet)
Seat 4: Mazerpelt folded before Flop (didn't bet)
Seat 5: AzulAzul999 (button) folded before Flop (didn't bet)
Seat 6: Squashy22 (small blind) collected ($0.20)



PokerStars Hand #222954907929:  Hold'em No Limit ($0.05/$0.10 USD) - 2021/01/23 9:20:26 ET
Table 'Lutetia III' 6-max Seat #6 is the button
Seat 1: Calltossen ($12.02 in chips) 
Seat 2: pernth ($10.29 in chips) 
Seat 3: AndriuWasa ($10.27 in chips) 
Seat 4: Mazerpelt ($10.15 in chips) 
Seat 5: AzulAzul999 ($10 in chips) 
Seat 6: Squashy22 ($13.08 in chips) 
Calltossen: posts small blind $0.05
pernth: posts big blind $0.10
*** HOLE CARDS ***
AndriuWasa: folds 
Mazerpelt: folds 
AzulAzul999: raises $0.20 to $0.30
Squashy22: calls $0.30
Calltossen: folds 
pernth: folds 
*** FLOP *** [Qc Jd Qd]
AzulAzul999: checks 
Squashy22: checks 
*** TURN *** [Qc Jd Qd] [6h]
AzulAzul999: checks 
Squashy22: bets $0.40
AzulAzul999: calls $0.40
*** RIVER *** [Qc Jd Qd 6h] [Jc]
AzulAzul999: checks 
Squashy22: checks 
*** SHOW DOWN ***
AzulAzul999: shows [Qs Js] (a full house, Queens full of Jacks)
Squashy22: mucks hand 
AzulAzul999 collected $1.48 from pot
*** SUMMARY ***
Total pot $1.55 | Rake $0.07 
Board [Qc Jd Qd 6h Jc]
Seat 1: Calltossen (small blind) folded before Flop
Seat 2: pernth (big blind) folded before Flop
Seat 3: AndriuWasa folded before Flop (didn't bet)
Seat 4: Mazerpelt folded before Flop (didn't bet)
Seat 5: AzulAzul999 showed [Qs Js] and won ($1.48) with a full house, Queens full of Jacks
Seat 6: Squashy22 (button) mucked



PokerStars Hand #222954923806:  Hold'em No Limit ($0.05/$0.10 USD) - 2021/01/23 9:20:58 ET
Table 'Lutetia III' 6-max Seat #1 is the button
Seat 1: Calltossen ($11.97 in chips) 
Seat 2: pernth ($10.19 in chips) 
Seat 3: AndriuWasa ($10.27 in chips) 
Seat 4: Mazerpelt ($10.15 in chips) 
Seat 5: AzulAzul999 ($10.78 in chips) 
Seat 6: Squashy22 ($12.38 in chips) 
pernth: posts small blind $0.05
AndriuWasa: posts big blind $0.10
*** HOLE CARDS ***
Mazerpelt: folds 
AzulAzul999: raises $0.35 to $0.45
Squashy22: folds 
Calltossen: folds 
pernth: folds 
AndriuWasa is disconnected 
AndriuWasa is connected 
AndriuWasa: folds 
Uncalled bet ($0.35) returned to AzulAzul999
AzulAzul999 collected $0.25 from pot
AzulAzul999: doesn't show hand 
*** SUMMARY ***
Total pot $0.25 | Rake $0 
Seat 1: Calltossen (button) folded before Flop (didn't bet)
Seat 2: pernth (small blind) folded before Flop
Seat 3: AndriuWasa (big blind) folded before Flop
Seat 4: Mazerpelt folded before Flop (didn't bet)
Seat 5: AzulAzul999 collected ($0.25)
Seat 6: Squashy22 folded before Flop (didn't bet)



PokerStars Hand #222954938212:  Hold'em No Limit ($0.05/$0.10 USD) - 2021/01/23 9:21:27 ET
Table 'Lutetia III' 6-max Seat #2 is the button
Seat 1: Calltossen ($11.97 in chips) 
Seat 2: pernth ($10.14 in chips) 
Seat 3: AndriuWasa ($10.17 in chips) 
Seat 4: Mazerpelt ($10.15 in chips) 
Seat 5: AzulAzul999 ($10.93 in chips) 
Seat 6: Squashy22 ($12.38 in chips) 
AndriuWasa: posts small blind $0.05
Mazerpelt: posts big blind $0.10
*** HOLE CARDS ***
AzulAzul999: raises $0.20 to $0.30
Squashy22: folds 
Calltossen: folds 
pernth: calls $0.30
AndriuWasa: folds 
Mazerpelt: folds 
*** FLOP *** [Ts 9c 3d]
AzulAzul999: checks 
pernth: checks 
*** TURN *** [Ts 9c 3d] [8h]
AzulAzul999: checks 
pernth: checks 
*** RIVER *** [Ts 9c 3d 8h] [2s]
AzulAzul999: checks 
pernth: checks 
*** SHOW DOWN ***
AzulAzul999: shows [Ac 4c] (high card Ace)
pernth: mucks hand 
AzulAzul999 collected $0.72 from pot
*** SUMMARY ***
Total pot $0.75 | Rake $0.03 
Board [Ts 9c 3d 8h 2s]
Seat 1: Calltossen folded before Flop (didn't bet)
Seat 2: pernth (button) mucked
Seat 3: AndriuWasa (small blind) folded before Flop
Seat 4: Mazerpelt (big blind) folded before Flop
Seat 5: AzulAzul999 showed [Ac 4c] and won ($0.72) with high card Ace
Seat 6: Squashy22 folded before Flop (didn't bet)



PokerStars Hand #222954956099:  Hold'em No Limit ($0.05/$0.10 USD) - 2021/01/23 9:22:02 ET
Table 'Lutetia III' 6-max Seat #3 is the button
Seat 1: Calltossen ($11.97 in chips) 
Seat 2: pernth ($9.84 in chips) 
Seat 3: AndriuWasa ($10.12 in chips) 
Seat 4: Mazerpelt ($10.05 in chips) 
Seat 5: AzulAzul999 ($11.35 in chips) 
Seat 6: Squashy22 ($12.38 in chips) 
Mazerpelt: posts small blind $0.05
AzulAzul999: posts big blind $0.10
*** HOLE CARDS ***
Squashy22: folds 
Calltossen: folds 
pernth: folds 
AndriuWasa: folds 
Mazerpelt: raises $0.20 to $0.30
AzulAzul999: calls $0.20
*** FLOP *** [Th 4d Qh]
Mazerpelt: bets $0.38
AzulAzul999: calls $0.38
*** TURN *** [Th 4d Qh] [Js]
Mazerpelt: bets $0.87
AzulAzul999: calls $0.87
*** RIVER *** [Th 4d Qh Js] [5s]
Mazerpelt: checks 
AzulAzul999: checks 
*** SHOW DOWN ***
Mazerpelt: shows [Kc Qd] (a pair of Queens)
AzulAzul999: shows [Qs Kd] (a pair of Queens)
Mazerpelt collected $1.48 from pot
AzulAzul999 collected $1.48 from pot
*** SUMMARY ***
Total pot $3.10 | Rake $0.14 
Board [Th 4d Qh Js 5s]
Seat 1: Calltossen folded before Flop (didn't bet)
Seat 2: pernth folded before Flop (didn't bet)
Seat 3: AndriuWasa (button) folded before Flop (didn't bet)
Seat 4: Mazerpelt (small blind) showed [Kc Qd] and won ($1.48) with a pair of Queens
Seat 5: AzulAzul999 (big blind) showed [Qs Kd] and won ($1.48) with a pair of Queens
Seat 6: Squashy22 folded before Flop (didn't bet)



PokerStars Hand #222954988252:  Hold'em No Limit ($0.05/$0.10 USD) - 2021/01/23 9:23:06 ET
Table 'Lutetia III' 6-max Seat #4 is the button
Seat 1: Calltossen ($11.97 in chips) 
Seat 2: pernth ($9.84 in chips) 
Seat 3: AndriuWasa ($10.12 in chips) 
Seat 4: Mazerpelt ($10 in chips) 
Seat 5: AzulAzul999 ($11.28 in chips) 
Seat 6: Squashy22 ($12.38 in chips) 
AzulAzul999: posts small blind $0.05
Squashy22: posts big blind $0.10
*** HOLE CARDS ***
Calltossen: folds 
pernth: folds 
AndriuWasa: folds 
Mazerpelt: folds 
AzulAzul999: raises $0.20 to $0.30
Squashy22: folds 
Uncalled bet ($0.20) returned to AzulAzul999
AzulAzul999 collected $0.20 from pot
AzulAzul999: doesn't show hand 
*** SUMMARY ***
Total pot $0.20 | Rake $0 
Seat 1: Calltossen folded before Flop (didn't bet)
Seat 2: pernth folded before Flop (didn't bet)
Seat 3: AndriuWasa folded before Flop (didn't bet)
Seat 4: Mazerpelt (button) folded before Flop (didn't bet)
Seat 5: AzulAzul999 (small blind) collected ($0.20)
Seat 6: Squashy22 (big blind) folded before Flop



PokerStars Hand #222954995591:  Hold'em No Limit ($0.05/$0.10 USD) - 2021/01/23 9:23:21 ET
Table 'Lutetia III' 6-max Seat #5 is the button
Seat 1: Calltossen ($11.97 in chips) 
Seat 2: pernth ($9.84 in chips) 
Seat 3: AndriuWasa ($10.12 in chips) 
Seat 4: Mazerpelt ($10 in chips) 
Seat 5: AzulAzul999 ($11.38 in chips) 
Seat 6: Squashy22 ($12.28 in chips) 
Squashy22: posts small blind $0.05
Calltossen: posts big blind $0.10
*** HOLE CARDS ***
pernth: folds 
AndriuWasa: folds 
Mazerpelt: raises $0.20 to $0.30
AzulAzul999: folds 
Squashy22: folds 
Calltossen: raises $0.65 to $0.95
Mazerpelt: folds 
Uncalled bet ($0.65) returned to Calltossen
Calltossen collected $0.65 from pot
Calltossen: doesn't show hand 
*** SUMMARY ***
Total pot $0.65 | Rake $0 
Seat 1: Calltossen (big blind) collected ($0.65)
Seat 2: pernth folded before Flop (didn't bet)
Seat 3: AndriuWasa folded before Flop (didn't bet)
Seat 4: Mazerpelt folded before Flop
Seat 5: AzulAzul999 (button) folded before Flop (didn't bet)
Seat 6: Squashy22 (small blind) folded before Flop



PokerStars Hand #222955010375:  Hold'em No Limit ($0.05/$0.10 USD) - 2021/01/23 9:23:50 ET
Table 'Lutetia III' 6-max Seat #6 is the button
Seat 1: Calltossen ($12.32 in chips) 
Seat 2: pernth ($9.84 in chips) 
Seat 3: AndriuWasa ($10.12 in chips) 
Seat 4: Mazerpelt ($10 in chips) 
Seat 5: AzulAzul999 ($11.38 in chips) 
Seat 6: Squashy22 ($12.23 in chips) 
Calltossen: posts small blind $0.05
pernth: posts big blind $0.10
*** HOLE CARDS ***
AndriuWasa: folds 
Mazerpelt: raises $0.20 to $0.30
AzulAzul999: folds 
Squashy22: folds 
Calltossen: folds 
pernth: calls $0.20
*** FLOP *** [Js 7d 5d]
pernth: bets $0.31
Mazerpelt: calls $0.31
*** TURN *** [Js 7d 5d] [Qs]
pernth: checks 
Mazerpelt: bets $0.81
pernth: calls $0.81
*** RIVER *** [Js 7d 5d Qs] [Th]
pernth: checks 
Mazerpelt: checks 
*** SHOW DOWN ***
pernth: shows [7c Kc] (a pair of Sevens)
Mazerpelt: shows [Jc Kd] (a pair of Jacks)
Mazerpelt collected $2.76 from pot
*** SUMMARY ***
Total pot $2.89 | Rake $0.13 
Board [Js 7d 5d Qs Th]
Seat 1: Calltossen (small blind) folded before Flop
Seat 2: pernth (big blind) showed [7c Kc] and lost with a pair of Sevens
Seat 3: AndriuWasa folded before Flop (didn't bet)
Seat 4: Mazerpelt showed [Jc Kd] and won ($2.76) with a pair of Jacks
Seat 5: AzulAzul999 folded before Flop (didn't bet)
Seat 6: Squashy22 (button) folded before Flop (didn't bet)



PokerStars Hand #222955030774:  Hold'em No Limit ($0.05/$0.10 USD) - 2021/01/23 9:24:31 ET
Table 'Lutetia III' 6-max Seat #1 is the button
Seat 1: Calltossen ($12.27 in chips) 
Seat 2: pernth ($8.42 in chips) 
Seat 3: AndriuWasa ($10.12 in chips) 
Seat 4: Mazerpelt ($11.34 in chips) 
Seat 5: AzulAzul999 ($11.38 in chips) 
Seat 6: Squashy22 ($12.23 in chips) 
pernth: posts small blind $0.05
AndriuWasa: posts big blind $0.10
*** HOLE CARDS ***
Mazerpelt: folds 
AzulAzul999: folds 
Squashy22: raises $0.16 to $0.26
Calltossen: folds 
pernth: folds 
AndriuWasa: folds 
Uncalled bet ($0.16) returned to Squashy22
Squashy22 collected $0.25 from pot
Squashy22: doesn't show hand 
*** SUMMARY ***
Total pot $0.25 | Rake $0 
Seat 1: Calltossen (button) folded before Flop (didn't bet)
Seat 2: pernth (small blind) folded before Flop
Seat 3: AndriuWasa (big blind) folded before Flop
Seat 4: Mazerpelt folded before Flop (didn't bet)
Seat 5: AzulAzul999 folded before Flop (didn't bet)
Seat 6: Squashy22 collected ($0.25)



PokerStars Hand #222955036606:  Hold'em No Limit ($0.05/$0.10 USD) - 2021/01/23 9:24:43 ET
Table 'Lutetia III' 6-max Seat #2 is the button
Seat 1: Calltossen ($12.27 in chips) 
Seat 2: pernth ($8.37 in chips) 
Seat 3: AndriuWasa ($10.02 in chips) 
Seat 4: Mazerpelt ($11.34 in chips) 
Seat 5: AzulAzul999 ($11.38 in chips) 
Seat 6: Squashy22 ($12.38 in chips) 
AndriuWasa: posts small blind $0.05
Mazerpelt: posts big blind $0.10
*** HOLE CARDS ***
AzulAzul999: folds 
Squashy22: folds 
Calltossen: folds 
pernth: folds 
AndriuWasa: folds 
Uncalled bet ($0.05) returned to Mazerpelt
Mazerpelt collected $0.10 from pot
*** SUMMARY ***
Total pot $0.10 | Rake $0 
Seat 1: Calltossen folded before Flop (didn't bet)
Seat 2: pernth (button) folded before Flop (didn't bet)
Seat 3: AndriuWasa (small blind) folded before Flop
Seat 4: Mazerpelt (big blind) collected ($0.10)
Seat 5: AzulAzul999 folded before Flop (didn't bet)
Seat 6: Squashy22 folded before Flop (didn't bet)



PokerStars Hand #222955040425:  Hold'em No Limit ($0.05/$0.10 USD) - 2021/01/23 9:24:51 ET
Table 'Lutetia III' 6-max Seat #3 is the button
Seat 1: Calltossen ($12.27 in chips) 
Seat 2: pernth ($8.37 in chips) 
Seat 3: AndriuWasa ($10 in chips) 
Seat 4: Mazerpelt ($11.39 in chips) 
Seat 5: AzulAzul999 ($11.38 in chips) 
Seat 6: Squashy22 ($12.38 in chips) 
Mazerpelt: posts small blind $0.05
AzulAzul999: posts big blind $0.10
*** HOLE CARDS ***
Squashy22: folds 
Calltossen: folds 
pernth: raises $0.10 to $0.20
AndriuWasa: folds 
Mazerpelt: folds 
AzulAzul999: calls $0.10
*** FLOP *** [Jh 5c Kc]
AzulAzul999: checks 
pernth: checks 
*** TURN *** [Jh 5c Kc] [3h]
AzulAzul999: checks 
pernth: checks 
*** RIVER *** [Jh 5c Kc 3h] [Ts]
AzulAzul999: checks 
pernth: checks 
*** SHOW DOWN ***
AzulAzul999: shows [As 8c] (high card Ace)
pernth: shows [3d 6d] (a pair of Threes)
pernth collected $0.43 from pot
*** SUMMARY ***
Total pot $0.45 | Rake $0.02 
Board [Jh 5c Kc 3h Ts]
Seat 1: Calltossen folded before Flop (didn't bet)
Seat 2: pernth showed [3d 6d] and won ($0.43) with a pair of Threes
Seat 3: AndriuWasa (button) folded before Flop (didn't bet)
Seat 4: Mazerpelt (small blind) folded before Flop
Seat 5: AzulAzul999 (big blind) showed [As 8c] and lost with high card Ace
Seat 6: Squashy22 folded before Flop (didn't bet)



PokerStars Hand #222955055664:  Hold'em No Limit ($0.05/$0.10 USD) - 2021/01/23 9:25:22 ET
Table 'Lutetia III' 6-max Seat #4 is the button
Seat 1: Calltossen ($12.27 in chips) 
Seat 2: pernth ($8.60 in chips) 
Seat 3: AndriuWasa ($10 in chips) 
Seat 4: Mazerpelt ($11.34 in chips) 
Seat 5: AzulAzul999 ($11.18 in chips) 
Seat 6: Squashy22 ($12.38 in chips) 
AzulAzul999: posts small blind $0.05
Squashy22: posts big blind $0.10
*** HOLE CARDS ***
Calltossen: folds 
pernth: folds 
AndriuWasa: folds 
Mazerpelt: folds 
AzulAzul999: raises $0.20 to $0.30
Squashy22: folds 
Uncalled bet ($0.20) returned to AzulAzul999
AzulAzul999 collected $0.20 from pot
AzulAzul999: doesn't show hand 
*** SUMMARY ***
Total pot $0.20 | Rake $0 
Seat 1: Calltossen folded before Flop (didn't bet)
Seat 2: pernth folded before Flop (didn't bet)
Seat 3: AndriuWasa folded before Flop (didn't bet)
Seat 4: Mazerpelt (button) folded before Flop (didn't bet)
Seat 5: AzulAzul999 (small blind) collected ($0.20)
Seat 6: Squashy22 (big blind) folded before Flop



PokerStars Hand #222955066524:  Hold'em No Limit ($0.05/$0.10 USD) - 2021/01/23 9:25:44 ET
Table 'Lutetia III' 6-max Seat #5 is the button
Seat 1: Calltossen ($12.27 in chips) 
Seat 2: pernth ($8.60 in chips) 
Seat 3: AndriuWasa ($10 in chips) 
Seat 4: Mazerpelt ($11.34 in chips) 
Seat 5: AzulAzul999 ($11.28 in chips) 
Seat 6: Squashy22 ($12.28 in chips) 
Squashy22: posts small blind $0.05
Calltossen: posts big blind $0.10
*** HOLE CARDS ***
pernth: folds 
AndriuWasa: folds 
Mazerpelt: raises $0.20 to $0.30
AzulAzul999: folds 
Squashy22: folds 
Calltossen: folds 
Uncalled bet ($0.20) returned to Mazerpelt
Mazerpelt collected $0.25 from pot
*** SUMMARY ***
Total pot $0.25 | Rake $0 
Seat 1: Calltossen (big blind) folded before Flop
Seat 2: pernth folded before Flop (didn't bet)
Seat 3: AndriuWasa folded before Flop (didn't bet)
Seat 4: Mazerpelt collected ($0.25)
Seat 5: AzulAzul999 (button) folded before Flop (didn't bet)
Seat 6: Squashy22 (small blind) folded before Flop



PokerStars Hand #222955074930:  Hold'em No Limit ($0.05/$0.10 USD) - 2021/01/23 9:26:01 ET
Table 'Lutetia III' 6-max Seat #6 is the button
Seat 1: Calltossen ($12.17 in chips) 
Seat 2: pernth ($8.60 in chips) 
Seat 3: AndriuWasa ($10 in chips) 
Seat 4: Mazerpelt ($11.49 in chips) 
Seat 5: AzulAzul999 ($11.28 in chips) 
Seat 6: Squashy22 ($12.23 in chips) 
Calltossen: posts small blind $0.05
pernth: posts big blind $0.10
*** HOLE CARDS ***
AndriuWasa: folds 
Mazerpelt: folds 
AzulAzul999: raises $0.20 to $0.30
Squashy22: folds 
Calltossen: folds 
pernth: calls $0.20
*** FLOP *** [3c Kh 5h]
pernth: checks 
AzulAzul999: bets $0.34
pernth: folds 
Uncalled bet ($0.34) returned to AzulAzul999
AzulAzul999 collected $0.62 from pot
AzulAzul999: doesn't show hand 
*** SUMMARY ***
Total pot $0.65 | Rake $0.03 
Board [3c Kh 5h]
Seat 1: Calltossen (small blind) folded before Flop
Seat 2: pernth (big blind) folded on the Flop
Seat 3: AndriuWasa folded before Flop (didn't bet)
Seat 4: Mazerpelt folded before Flop (didn't bet)
Seat 5: AzulAzul999 collected ($0.62)
Seat 6: Squashy22 (button) folded before Flop (didn't bet)



PokerStars Hand #222955086960:  Hold'em No Limit ($0.05/$0.10 USD) - 2021/01/23 9:26:25 ET
Table 'Lutetia III' 6-max Seat #1 is the button
Seat 1: Calltossen ($12.12 in chips) 
Seat 2: pernth ($8.30 in chips) 
Seat 4: Mazerpelt ($11.49 in chips) 
Seat 5: AzulAzul999 ($11.60 in chips) 
Seat 6: Squashy22 ($12.23 in chips) 
pernth: posts small blind $0.05
AndriuWasa has timed out
AndriuWasa: is sitting out 
Mazerpelt: posts big blind $0.10
*** HOLE CARDS ***
AndriuWasa is disconnected 
AzulAzul999: raises $0.20 to $0.30
Squashy22: folds 
Calltossen: folds 
pernth: folds 
Mazerpelt: folds 
Uncalled bet ($0.20) returned to AzulAzul999
AzulAzul999 collected $0.25 from pot
AzulAzul999: doesn't show hand 
*** SUMMARY ***
Total pot $0.25 | Rake $0 
Seat 1: Calltossen (button) folded before Flop (didn't bet)
Seat 2: pernth (small blind) folded before Flop
Seat 4: Mazerpelt (big blind) folded before Flop
Seat 5: AzulAzul999 collected ($0.25)
Seat 6: Squashy22 folded before Flop (didn't bet)



PokerStars Hand #222955097748:  Hold'em No Limit ($0.05/$0.10 USD) - 2021/01/23 9:26:47 ET
Table 'Lutetia III' 6-max Seat #2 is the button
Seat 1: Calltossen ($12.12 in chips) 
Seat 2: pernth ($8.25 in chips) 
Seat 4: Mazerpelt ($11.39 in chips) 
Seat 6: Squashy22 ($12.23 in chips) 
Mazerpelt: posts small blind $0.05
AzulAzul999: is sitting out 
Squashy22: posts big blind $0.10
*** HOLE CARDS ***
AzulAzul999 leaves the table
KingBiscuitT joins the table at seat #5 
Calltossen: folds 
pernth: folds 
Mazerpelt: folds 
Uncalled bet ($0.05) returned to Squashy22
Squashy22 collected $0.10 from pot
Squashy22: doesn't show hand 
*** SUMMARY ***
Total pot $0.10 | Rake $0 
Seat 1: Calltossen folded before Flop (didn't bet)
Seat 2: pernth (button) folded before Flop (didn't bet)
Seat 4: Mazerpelt (small blind) folded before Flop
Seat 6: Squashy22 (big blind) collected ($0.10)



PokerStars Hand #222955106366:  Hold'em No Limit ($0.05/$0.10 USD) - 2021/01/23 9:27:05 ET
Table 'Lutetia III' 6-max Seat #4 is the button
Seat 1: Calltossen ($12.12 in chips) 
Seat 2: pernth ($8.25 in chips) 
Seat 4: Mazerpelt ($11.34 in chips) 
Seat 6: Squashy22 ($12.28 in chips) 
Squashy22: posts small blind $0.05
Calltossen: posts big blind $0.10
AndriuWasa: sits out 
*** HOLE CARDS ***
pernth: folds 
Mazerpelt: folds 
Squashy22: folds 
Uncalled bet ($0.05) returned to Calltossen
Calltossen collected $0.10 from pot
Calltossen: doesn't show hand 
*** SUMMARY ***
Total pot $0.10 | Rake $0 
Seat 1: Calltossen (big blind) collected ($0.10)
Seat 2: pernth folded before Flop (didn't bet)
Seat 4: Mazerpelt (button) folded before Flop (didn't bet)
Seat 6: Squashy22 (small blind) folded before Flop



PokerStars Hand #222955109143:  Hold'em No Limit ($0.05/$0.10 USD) - 2021/01/23 9:27:10 ET
Table 'Lutetia III' 6-max Seat #6 is the button
Seat 1: Calltossen ($12.17 in chips) 
Seat 2: pernth ($8.25 in chips) 
Seat 4: Mazerpelt ($11.34 in chips) 
Seat 6: Squashy22 ($12.23 in chips) 
Calltossen: posts small blind $0.05
pernth: posts big blind $0.10
AndriuWasa: sits out 
KingBiscuitT: sits out 
*** HOLE CARDS ***
Mazerpelt: folds 
Squashy22: folds 
Calltossen: folds 
Uncalled bet ($0.05) returned to pernth
pernth collected $0.10 from pot
pernth: doesn't show hand 
*** SUMMARY ***
Total pot $0.10 | Rake $0 
Seat 1: Calltossen (small blind) folded before Flop
Seat 2: pernth (big blind) collected ($0.10)
Seat 4: Mazerpelt folded before Flop (didn't bet)
Seat 6: Squashy22 (button) folded before Flop (didn't bet)



PokerStars Hand #222955111627:  Hold'em No Limit ($0.05/$0.10 USD) - 2021/01/23 9:27:15 ET
Table 'Lutetia III' 6-max Seat #1 is the button
Seat 1: Calltossen ($12.12 in chips) 
Seat 2: pernth ($8.30 in chips) 
Seat 3: AndriuWasa ($10 in chips) 
Seat 4: Mazerpelt ($11.34 in chips) 
Seat 6: Squashy22 ($12.23 in chips) 
pernth: posts small blind $0.05
AndriuWasa: posts big blind $0.10
KingBiscuitT: sits out 
*** HOLE CARDS ***
Mazerpelt: folds 
Squashy22: raises $0.16 to $0.26
Calltossen: raises $0.67 to $0.93
pernth: folds 
AndriuWasa: folds 
Mazerpelt leaves the table
Squashy22: folds 
Uncalled bet ($0.67) returned to Calltossen
Calltossen collected $0.67 from pot
Calltossen: doesn't show hand 
*** SUMMARY ***
Total pot $0.67 | Rake $0 
Seat 1: Calltossen (button) collected ($0.67)
Seat 2: pernth (small blind) folded before Flop
Seat 3: AndriuWasa (big blind) folded before Flop
Seat 4: Mazerpelt folded before Flop (didn't bet)
Seat 6: Squashy22 folded before Flop



PokerStars Hand #222955120077:  Hold'em No Limit ($0.05/$0.10 USD) - 2021/01/23 9:27:32 ET
Table 'Lutetia III' 6-max Seat #2 is the button
Seat 1: Calltossen ($12.53 in chips) 
Seat 2: pernth ($8.25 in chips) 
Seat 3: AndriuWasa ($10 in chips) 
Seat 5: KingBiscuitT ($10 in chips) 
Seat 6: Squashy22 ($11.97 in chips) 
AndriuWasa: posts small blind $0.05
KingBiscuitT: posts big blind $0.10
*** HOLE CARDS ***
Squashy22: folds 
Calltossen: folds 
pernth: folds 
AndriuWasa: folds 
Uncalled bet ($0.05) returned to KingBiscuitT
KingBiscuitT collected $0.10 from pot
KingBiscuitT: doesn't show hand 
*** SUMMARY ***
Total pot $0.10 | Rake $0 
Seat 1: Calltossen folded before Flop (didn't bet)
Seat 2: pernth (button) folded before Flop (didn't bet)
Seat 3: AndriuWasa (small blind) folded before Flop
Seat 5: KingBiscuitT (big blind) collected ($0.10)
Seat 6: Squashy22 folded before Flop (didn't bet)



PokerStars Hand #222955124676:  Hold'em No Limit ($0.05/$0.10 USD) - 2021/01/23 9:27:42 ET
Table 'Lutetia III' 6-max Seat #3 is the button
Seat 1: Calltossen ($12.53 in chips) 
Seat 2: pernth ($8.25 in chips) 
Seat 3: AndriuWasa ($10 in chips) 
Seat 5: KingBiscuitT ($10.05 in chips) 
Seat 6: Squashy22 ($11.97 in chips) 
KingBiscuitT: posts small blind $0.05
Squashy22: posts big blind $0.10
*** HOLE CARDS ***
Calltossen: raises $0.20 to $0.30
Darhanhaan joins the table at seat #4 
pernth: folds 
AndriuWasa: folds 
KingBiscuitT: folds 
Squashy22: folds 
Uncalled bet ($0.20) returned to Calltossen
Calltossen collected $0.25 from pot
Calltossen: doesn't show hand 
*** SUMMARY ***
Total pot $0.25 | Rake $0 
Seat 1: Calltossen collected ($0.25)
Seat 2: pernth folded before Flop (didn't bet)
Seat 3: AndriuWasa (button) folded before Flop (didn't bet)
Seat 5: KingBiscuitT (small blind) folded before Flop
Seat 6: Squashy22 (big blind) folded before Flop



PokerStars Hand #222955129727:  Hold'em No Limit ($0.05/$0.10 USD) - 2021/01/23 9:27:52 ET
Table 'Lutetia III' 6-max Seat #5 is the button
Seat 1: Calltossen ($12.68 in chips) 
Seat 2: pernth ($8.25 in chips) 
Seat 3: AndriuWasa ($10 in chips) 
Seat 5: KingBiscuitT ($10 in chips) 
Seat 6: Squashy22 ($11.87 in chips) 
Squashy22: posts small blind $0.05
Calltossen: posts big blind $0.10
Darhanhaan: sits out 
*** HOLE CARDS ***
pernth: raises $0.20 to $0.30
AndriuWasa: folds 
KingBiscuitT: folds 
Squashy22: folds 
Calltossen: folds 
Uncalled bet ($0.20) returned to pernth
pernth collected $0.25 from pot
pernth: doesn't show hand 
*** SUMMARY ***
Total pot $0.25 | Rake $0 
Seat 1: Calltossen (big blind) folded before Flop
Seat 2: pernth collected ($0.25)
Seat 3: AndriuWasa folded before Flop (didn't bet)
Seat 5: KingBiscuitT (button) folded before Flop (didn't bet)
Seat 6: Squashy22 (small blind) folded before Flop



PokerStars Hand #222955146528:  Hold'em No Limit ($0.05/$0.10 USD) - 2021/01/23 9:28:13 ET
Table 'Lutetia III' 6-max Seat #6 is the button
Seat 1: Calltossen ($12.58 in chips) 
Seat 2: pernth ($8.40 in chips) 
Seat 3: AndriuWasa ($10 in chips) 
Seat 5: KingBiscuitT ($10 in chips) 
Seat 6: Squashy22 ($11.82 in chips) 
Calltossen: posts small blind $0.05
pernth: posts big blind $0.10
Darhanhaan: sits out 
*** HOLE CARDS ***
AndriuWasa: raises $0.15 to $0.25
KingBiscuitT: folds 
Squashy22: folds 
Calltossen: folds 
pernth: folds 
Uncalled bet ($0.15) returned to AndriuWasa
AndriuWasa collected $0.25 from pot
AndriuWasa: doesn't show hand 
*** SUMMARY ***
Total pot $0.25 | Rake $0 
Seat 1: Calltossen (small blind) folded before Flop
Seat 2: pernth (big blind) folded before Flop
Seat 3: AndriuWasa collected ($0.25)
Seat 5: KingBiscuitT folded before Flop (didn't bet)
Seat 6: Squashy22 (button) folded before Flop (didn't bet)



PokerStars Hand #222955152092:  Hold'em No Limit ($0.05/$0.10 USD) - 2021/01/23 9:28:24 ET
Table 'Lutetia III' 6-max Seat #1 is the button
Seat 1: Calltossen ($12.53 in chips) 
Seat 2: pernth ($8.30 in chips) 
Seat 3: AndriuWasa ($10.15 in chips) 
Seat 5: KingBiscuitT ($10 in chips) 
Seat 6: Squashy22 ($11.82 in chips) 
pernth: posts small blind $0.05
AndriuWasa: posts big blind $0.10
Darhanhaan: sits out 
*** HOLE CARDS ***
KingBiscuitT: folds 
Squashy22 has timed out
Squashy22: folds 
Calltossen: raises $0.20 to $0.30
pernth: folds 
AndriuWasa: folds 
Uncalled bet ($0.20) returned to Calltossen
Calltossen collected $0.25 from pot
Calltossen: doesn't show hand 
*** SUMMARY ***
Total pot $0.25 | Rake $0 
Seat 1: Calltossen (button) collected ($0.25)
Seat 2: pernth (small blind) folded before Flop
Seat 3: AndriuWasa (big blind) folded before Flop
Seat 5: KingBiscuitT folded before Flop (didn't bet)
Seat 6: Squashy22 folded before Flop (didn't bet)



PokerStars Hand #222955162754:  Hold'em No Limit ($0.05/$0.10 USD) - 2021/01/23 9:28:45 ET
Table 'Lutetia III' 6-max Seat #2 is the button
Seat 1: Calltossen ($12.68 in chips) 
Seat 2: pernth ($8.25 in chips) 
Seat 3: AndriuWasa ($10.05 in chips) 
Seat 4: Darhanhaan ($4 in chips) 
Seat 5: KingBiscuitT ($10 in chips) 
AndriuWasa: posts small blind $0.05
Darhanhaan: posts big blind $0.10
*** HOLE CARDS ***
KingBiscuitT: folds 
Calltossen: folds 
pernth: folds 
AndriuWasa: raises $0.22 to $0.32
Darhanhaan: calls $0.22
*** FLOP *** [6d 7h 2c]
AndriuWasa: bets $0.20
Darhanhaan: calls $0.20
*** TURN *** [6d 7h 2c] [Jd]
AndriuWasa: checks 
Darhanhaan: bets $0.10
AndriuWasa: raises $0.55 to $0.65
Darhanhaan: folds 
Uncalled bet ($0.55) returned to AndriuWasa
AndriuWasa collected $1.18 from pot
AndriuWasa: doesn't show hand 
*** SUMMARY ***
Total pot $1.24 | Rake $0.06 
Board [6d 7h 2c Jd]
Seat 1: Calltossen folded before Flop (didn't bet)
Seat 2: pernth (button) folded before Flop (didn't bet)
Seat 3: AndriuWasa (small blind) collected ($1.18)
Seat 4: Darhanhaan (big blind) folded on the Turn
Seat 5: KingBiscuitT folded before Flop (didn't bet)



PokerStars Hand #222955178735:  Hold'em No Limit ($0.05/$0.10 USD) - 2021/01/23 9:29:17 ET
Table 'Lutetia III' 6-max Seat #3 is the button
Seat 1: Calltossen ($12.68 in chips) 
Seat 2: pernth ($8.25 in chips) 
Seat 3: AndriuWasa ($10.61 in chips) 
Seat 4: Darhanhaan ($3.38 in chips) 
Seat 5: KingBiscuitT ($10 in chips) 
Seat 6: Squashy22 ($11.82 in chips) 
Darhanhaan: posts small blind $0.05
KingBiscuitT: posts big blind $0.10
*** HOLE CARDS ***
Squashy22 has timed out
Squashy22: folds 
Calltossen: folds 
pernth: folds 
AndriuWasa: folds 
Darhanhaan: calls $0.05
KingBiscuitT: checks 
*** FLOP *** [3c 7c Tc]
Darhanhaan: bets $0.10
KingBiscuitT: folds 
Uncalled bet ($0.10) returned to Darhanhaan
Darhanhaan collected $0.19 from pot
Darhanhaan: doesn't show hand 
*** SUMMARY ***
Total pot $0.20 | Rake $0.01 
Board [3c 7c Tc]
Seat 1: Calltossen folded before Flop (didn't bet)
Seat 2: pernth folded before Flop (didn't bet)
Seat 3: AndriuWasa (button) folded before Flop (didn't bet)
Seat 4: Darhanhaan (small blind) collected ($0.19)
Seat 5: KingBiscuitT (big blind) folded on the Flop
Seat 6: Squashy22 folded before Flop (didn't bet)



PokerStars Hand #222955191165:  Hold'em No Limit ($0.05/$0.10 USD) - 2021/01/23 9:29:43 ET
Table 'Lutetia III' 6-max Seat #4 is the button
Seat 1: Calltossen ($12.68 in chips) 
Seat 2: pernth ($8.25 in chips) 
Seat 3: AndriuWasa ($10.61 in chips) 
Seat 4: Darhanhaan ($3.47 in chips) 
Seat 5: KingBiscuitT ($10 in chips) 
Seat 6: Squashy22 ($11.82 in chips) 
KingBiscuitT: posts small blind $0.05
Squashy22: posts big blind $0.10
*** HOLE CARDS ***
Calltossen: folds 
pernth: folds 
AndriuWasa: folds 
Darhanhaan: folds 
KingBiscuitT: raises $0.20 to $0.30
Squashy22: folds 
Uncalled bet ($0.20) returned to KingBiscuitT
KingBiscuitT collected $0.20 from pot
KingBiscuitT: doesn't show hand 
*** SUMMARY ***
Total pot $0.20 | Rake $0 
Seat 1: Calltossen folded before Flop (didn't bet)
Seat 2: pernth folded before Flop (didn't bet)
Seat 3: AndriuWasa folded before Flop (didn't bet)
Seat 4: Darhanhaan (button) folded before Flop (didn't bet)
Seat 5: KingBiscuitT (small blind) collected ($0.20)
Seat 6: Squashy22 (big blind) folded before Flop



PokerStars Hand #222955200550:  Hold'em No Limit ($0.05/$0.10 USD) - 2021/01/23 9:30:01 ET
Table 'Lutetia III' 6-max Seat #5 is the button
Seat 1: Calltossen ($12.68 in chips) 
Seat 2: pernth ($8.25 in chips) 
Seat 3: AndriuWasa ($10.61 in chips) 
Seat 4: Darhanhaan ($3.47 in chips) 
Seat 5: KingBiscuitT ($10.10 in chips) 
Seat 6: Squashy22 ($11.72 in chips) 
Squashy22: posts small blind $0.05
Calltossen: posts big blind $0.10
*** HOLE CARDS ***
pernth: folds 
AndriuWasa: folds 
Darhanhaan: calls $0.10
KingBiscuitT: folds 
Squashy22: calls $0.05
Calltossen: checks 
*** FLOP *** [5d Td 7s]
Squashy22: bets $0.21
Calltossen: folds 
Darhanhaan: calls $0.21
*** TURN *** [5d Td 7s] [Qc]
Squashy22: bets $0.49
Darhanhaan: folds 
Uncalled bet ($0.49) returned to Squashy22
Squashy22 collected $0.69 from pot
Squashy22: doesn't show hand 
*** SUMMARY ***
Total pot $0.72 | Rake $0.03 
Board [5d Td 7s Qc]
Seat 1: Calltossen (big blind) folded on the Flop
Seat 2: pernth folded before Flop (didn't bet)
Seat 3: AndriuWasa folded before Flop (didn't bet)
Seat 4: Darhanhaan folded on the Turn
Seat 5: KingBiscuitT (button) folded before Flop (didn't bet)
Seat 6: Squashy22 (small blind) collected ($0.69)



PokerStars Hand #222955218286:  Hold'em No Limit ($0.05/$0.10 USD) - 2021/01/23 9:30:37 ET
Table 'Lutetia III' 6-max Seat #6 is the button
Seat 1: Calltossen ($12.58 in chips) 
Seat 2: pernth ($8.25 in chips) 
Seat 3: AndriuWasa ($10.61 in chips) 
Seat 4: Darhanhaan ($3.16 in chips) 
Seat 5: KingBiscuitT ($10.10 in chips) 
Seat 6: Squashy22 ($12.10 in chips) 
Calltossen: posts small blind $0.05
pernth: posts big blind $0.10
*** HOLE CARDS ***
AndriuWasa: folds 
Darhanhaan: folds 
KingBiscuitT: folds 
Squashy22: raises $0.16 to $0.26
Calltossen: folds 
pernth: folds 
Uncalled bet ($0.16) returned to Squashy22
Squashy22 collected $0.25 from pot
Squashy22: doesn't show hand 
*** SUMMARY ***
Total pot $0.25 | Rake $0 
Seat 1: Calltossen (small blind) folded before Flop
Seat 2: pernth (big blind) folded before Flop
Seat 3: AndriuWasa folded before Flop (didn't bet)
Seat 4: Darhanhaan folded before Flop (didn't bet)
Seat 5: KingBiscuitT folded before Flop (didn't bet)
Seat 6: Squashy22 (button) collected ($0.25)



PokerStars Hand #222955226907:  Hold'em No Limit ($0.05/$0.10 USD) - 2021/01/23 9:30:54 ET
Table 'Lutetia III' 6-max Seat #1 is the button
Seat 1: Calltossen ($12.53 in chips) 
Seat 2: pernth ($8.15 in chips) 
Seat 3: AndriuWasa ($10.61 in chips) 
Seat 4: Darhanhaan ($3.16 in chips) 
Seat 5: KingBiscuitT ($10.10 in chips) 
Seat 6: Squashy22 ($12.25 in chips) 
pernth: posts small blind $0.05
AndriuWasa: posts big blind $0.10
*** HOLE CARDS ***
Darhanhaan: folds 
KingBiscuitT: raises $0.15 to $0.25
Squashy22: folds 
Calltossen: folds 
pernth: folds 
AndriuWasa: folds 
Uncalled bet ($0.15) returned to KingBiscuitT
KingBiscuitT collected $0.25 from pot
KingBiscuitT: doesn't show hand 
*** SUMMARY ***
Total pot $0.25 | Rake $0 
Seat 1: Calltossen (button) folded before Flop (didn't bet)
Seat 2: pernth (small blind) folded before Flop
Seat 3: AndriuWasa (big blind) folded before Flop
Seat 4: Darhanhaan folded before Flop (didn't bet)
Seat 5: KingBiscuitT collected ($0.25)
Seat 6: Squashy22 folded before Flop (didn't bet)



PokerStars Hand #222955233666:  Hold'em No Limit ($0.05/$0.10 USD) - 2021/01/23 9:31:08 ET
Table 'Lutetia III' 6-max Seat #2 is the button
Seat 1: Calltossen ($12.53 in chips) 
Seat 2: pernth ($8.10 in chips) 
Seat 3: AndriuWasa ($10.51 in chips) 
Seat 4: Darhanhaan ($3.16 in chips) 
Seat 5: KingBiscuitT ($10.25 in chips) 
Seat 6: Squashy22 ($12.25 in chips) 
AndriuWasa: posts small blind $0.05
Darhanhaan: posts big blind $0.10
*** HOLE CARDS ***
KingBiscuitT: folds 
Squashy22: folds 
Calltossen: folds 
pernth: raises $0.20 to $0.30
AndriuWasa: folds 
Darhanhaan: folds 
Uncalled bet ($0.20) returned to pernth
pernth collected $0.25 from pot
pernth: doesn't show hand 
*** SUMMARY ***
Total pot $0.25 | Rake $0 
Seat 1: Calltossen folded before Flop (didn't bet)
Seat 2: pernth (button) collected ($0.25)
Seat 3: AndriuWasa (small blind) folded before Flop
Seat 4: Darhanhaan (big blind) folded before Flop
Seat 5: KingBiscuitT folded before Flop (didn't bet)
Seat 6: Squashy22 folded before Flop (didn't bet)



PokerStars Hand #222955239682:  Hold'em No Limit ($0.05/$0.10 USD) - 2021/01/23 9:31:18 ET
Table 'Lutetia III' 6-max Seat #3 is the button
Seat 1: Calltossen ($12.53 in chips) 
Seat 2: pernth ($8.25 in chips) 
Seat 3: AndriuWasa ($10.46 in chips) 
Seat 4: Darhanhaan ($3.06 in chips) 
Seat 5: KingBiscuitT ($10.25 in chips) 
Seat 6: Squashy22 ($12.25 in chips) 
Darhanhaan: posts small blind $0.05
KingBiscuitT: posts big blind $0.10
*** HOLE CARDS ***
Squashy22: folds 
Calltossen: folds 
pernth: raises $0.10 to $0.20
AndriuWasa: folds 
Darhanhaan: folds 
KingBiscuitT: folds 
Uncalled bet ($0.10) returned to pernth
pernth collected $0.25 from pot
pernth: doesn't show hand 
*** SUMMARY ***
Total pot $0.25 | Rake $0 
Seat 1: Calltossen folded before Flop (didn't bet)
Seat 2: pernth collected ($0.25)
Seat 3: AndriuWasa (button) folded before Flop (didn't bet)
Seat 4: Darhanhaan (small blind) folded before Flop
Seat 5: KingBiscuitT (big blind) folded before Flop
Seat 6: Squashy22 folded before Flop (didn't bet)



PokerStars Hand #222955245788:  Hold'em No Limit ($0.05/$0.10 USD) - 2021/01/23 9:31:30 ET
Table 'Lutetia III' 6-max Seat #4 is the button
Seat 1: Calltossen ($12.53 in chips) 
Seat 2: pernth ($8.40 in chips) 
Seat 3: AndriuWasa ($10.46 in chips) 
Seat 4: Darhanhaan ($3.01 in chips) 
Seat 5: KingBiscuitT ($10.15 in chips) 
Seat 6: Squashy22 ($12.25 in chips) 
KingBiscuitT: posts small blind $0.05
Squashy22: posts big blind $0.10
*** HOLE CARDS ***
Calltossen: folds 
pernth: folds 
AndriuWasa: raises $0.15 to $0.25
Darhanhaan: folds 
KingBiscuitT: folds 
Squashy22: folds 
Uncalled bet ($0.15) returned to AndriuWasa
AndriuWasa collected $0.25 from pot
AndriuWasa: doesn't show hand 
*** SUMMARY ***
Total pot $0.25 | Rake $0 
Seat 1: Calltossen folded before Flop (didn't bet)
Seat 2: pernth folded before Flop (didn't bet)
Seat 3: AndriuWasa collected ($0.25)
Seat 4: Darhanhaan (button) folded before Flop (didn't bet)
Seat 5: KingBiscuitT (small blind) folded before Flop
Seat 6: Squashy22 (big blind) folded before Flop



PokerStars Hand #222955252378:  Hold'em No Limit ($0.05/$0.10 USD) - 2021/01/23 9:31:44 ET
Table 'Lutetia III' 6-max Seat #5 is the button
Seat 1: Calltossen ($12.53 in chips) 
Seat 2: pernth ($8.40 in chips) 
Seat 3: AndriuWasa ($10.61 in chips) 
Seat 4: Darhanhaan ($3.01 in chips) 
Seat 5: KingBiscuitT ($10.10 in chips) 
Seat 6: Squashy22 ($12.15 in chips) 
Squashy22: posts small blind $0.05
Calltossen: posts big blind $0.10
*** HOLE CARDS ***
pernth: folds 
AndriuWasa: folds 
Darhanhaan: calls $0.10
KingBiscuitT: raises $0.40 to $0.50
Squashy22: raises $1.40 to $1.90
Calltossen: folds 
Darhanhaan: folds 
KingBiscuitT: folds 
Uncalled bet ($1.40) returned to Squashy22
Squashy22 collected $1.20 from pot
Squashy22: doesn't show hand 
*** SUMMARY ***
Total pot $1.20 | Rake $0 
Seat 1: Calltossen (big blind) folded before Flop
Seat 2: pernth folded before Flop (didn't bet)
Seat 3: AndriuWasa folded before Flop (didn't bet)
Seat 4: Darhanhaan folded before Flop
Seat 5: KingBiscuitT (button) folded before Flop
Seat 6: Squashy22 (small blind) collected ($1.20)



PokerStars Hand #222955267427:  Hold'em No Limit ($0.05/$0.10 USD) - 2021/01/23 9:32:14 ET
Table 'Lutetia III' 6-max Seat #6 is the button
Seat 1: Calltossen ($12.43 in chips) 
Seat 2: pernth ($8.40 in chips) 
Seat 3: AndriuWasa ($10.61 in chips) 
Seat 4: Darhanhaan ($2.91 in chips) 
Seat 5: KingBiscuitT ($10 in chips) 
Seat 6: Squashy22 ($12.85 in chips) 
Calltossen: posts small blind $0.05
pernth: posts big blind $0.10
*** HOLE CARDS ***
AndriuWasa: folds 
Darhanhaan: calls $0.10
KingBiscuitT: folds 
Squashy22: folds 
Calltossen: raises $0.30 to $0.40
pernth: folds 
Darhanhaan: calls $0.30
*** FLOP *** [3h As Ts]
Calltossen: bets $0.65
Darhanhaan: folds 
Uncalled bet ($0.65) returned to Calltossen
Calltossen collected $0.86 from pot
Calltossen: doesn't show hand 
*** SUMMARY ***
Total pot $0.90 | Rake $0.04 
Board [3h As Ts]
Seat 1: Calltossen (small blind) collected ($0.86)
Seat 2: pernth (big blind) folded before Flop
Seat 3: AndriuWasa folded before Flop (didn't bet)
Seat 4: Darhanhaan folded on the Flop
Seat 5: KingBiscuitT folded before Flop (didn't bet)
Seat 6: Squashy22 (button) folded before Flop (didn't bet)



PokerStars Hand #222955508173:  Hold'em No Limit ($0.05/$0.10 USD) - 2021/01/23 9:40:12 ET
Table 'Lutetia III' 6-max Seat #5 is the button
Seat 1: Calltossen ($16.40 in chips) 
Seat 2: pernth ($1.83 in chips) 
Seat 4: PokerPro EPT ($8.09 in chips) 
Seat 5: KingBiscuitT ($11.36 in chips) 
Seat 6: Squashy22 ($11.61 in chips) 
Squashy22: posts small blind $0.05
Calltossen: posts big blind $0.10
Darkhorse2205: sits out 
*** HOLE CARDS ***
pernth: raises $1.73 to $1.83 and is all-in
PokerPro EPT: folds 
KingBiscuitT: folds 
Squashy22: folds 
Calltossen: folds 
Uncalled bet ($1.73) returned to pernth
pernth collected $0.25 from pot
pernth: doesn't show hand 
*** SUMMARY ***
Total pot $0.25 | Rake $0 
Seat 1: Calltossen (big blind) folded before Flop
Seat 2: pernth collected ($0.25)
Seat 4: PokerPro EPT folded before Flop (didn't bet)
Seat 5: KingBiscuitT (button) folded before Flop (didn't bet)
Seat 6: Squashy22 (small blind) folded before Flop



PokerStars Hand #222955512256:  Hold'em No Limit ($0.05/$0.10 USD) - 2021/01/23 9:40:20 ET
Table 'Lutetia III' 6-max Seat #6 is the button
Seat 1: Calltossen ($16.30 in chips) 
Seat 2: pernth ($1.98 in chips) 
Seat 4: PokerPro EPT ($8.09 in chips) 
Seat 5: KingBiscuitT ($11.36 in chips) 
Seat 6: Squashy22 ($11.56 in chips) 
Calltossen: posts small blind $0.05
pernth: posts big blind $0.10
Darkhorse2205: sits out 
*** HOLE CARDS ***
PokerPro EPT: calls $0.10
KingBiscuitT: folds 
Squashy22: folds 
Calltossen: folds 
pernth: checks 
*** FLOP *** [Td 6d 7c]
pernth: bets $1.88 and is all-in
PokerPro EPT: calls $1.88
*** TURN *** [Td 6d 7c] [Jh]
*** RIVER *** [Td 6d 7c Jh] [Ac]
*** SHOW DOWN ***
pernth: shows [3s 6c] (a pair of Sixes)
PokerPro EPT: shows [8d Tc] (a pair of Tens)
PokerPro EPT collected $3.83 from pot
*** SUMMARY ***
Total pot $4.01 | Rake $0.18 
Board [Td 6d 7c Jh Ac]
Seat 1: Calltossen (small blind) folded before Flop
Seat 2: pernth (big blind) showed [3s 6c] and lost with a pair of Sixes
Seat 4: PokerPro EPT showed [8d Tc] and won ($3.83) with a pair of Tens
Seat 5: KingBiscuitT folded before Flop (didn't bet)
Seat 6: Squashy22 (button) folded before Flop (didn't bet)



PokerStars Hand #222955522748:  Hold'em No Limit ($0.05/$0.10 USD) - 2021/01/23 9:40:41 ET
Table 'Lutetia III' 6-max Seat #1 is the button
Seat 1: Calltossen ($16.25 in chips) 
Seat 4: PokerPro EPT ($9.94 in chips) 
Seat 5: KingBiscuitT ($11.36 in chips) 
Seat 6: Squashy22 ($11.56 in chips) 
PokerPro EPT: posts small blind $0.05
KingBiscuitT: posts big blind $0.10
*** HOLE CARDS ***
Squashy22: folds 
Calltossen: folds 
PokerPro EPT: calls $0.05
KingBiscuitT: checks 
*** FLOP *** [9c 6s 9d]
pernth leaves the table
PokerPro EPT: bets $0.20
KingBiscuitT: calls $0.20
*** TURN *** [9c 6s 9d] [7s]
PokerPro EPT: bets $0.20
KingBiscuitT: calls $0.20
*** RIVER *** [9c 6s 9d 7s] [Td]
Kimi1892 joins the table at seat #2 
PokerPro EPT: checks 
KingBiscuitT: bets $0.96
PokerPro EPT: folds 
Uncalled bet ($0.96) returned to KingBiscuitT
KingBiscuitT collected $0.96 from pot
KingBiscuitT: doesn't show hand 
*** SUMMARY ***
Total pot $1 | Rake $0.04 
Board [9c 6s 9d 7s Td]
Seat 1: Calltossen (button) folded before Flop (didn't bet)
Seat 4: PokerPro EPT (small blind) folded on the River
Seat 5: KingBiscuitT (big blind) collected ($0.96)
Seat 6: Squashy22 folded before Flop (didn't bet)



PokerStars Hand #222955534326:  Hold'em No Limit ($0.05/$0.10 USD) - 2021/01/23 9:41:04 ET
Table 'Lutetia III' 6-max Seat #4 is the button
Seat 1: Calltossen ($16.25 in chips) 
Seat 4: PokerPro EPT ($9.44 in chips) 
Seat 5: KingBiscuitT ($11.82 in chips) 
Seat 6: Squashy22 ($11.56 in chips) 
KingBiscuitT: posts small blind $0.05
Squashy22: posts big blind $0.10
Kimi1892: sits out 
Darkhorse2205: sits out 
*** HOLE CARDS ***
Calltossen: folds 
PokerPro EPT: raises $0.20 to $0.30
KingBiscuitT: raises $0.80 to $1.10
Squashy22: folds 
PokerPro EPT: folds 
Uncalled bet ($0.80) returned to KingBiscuitT
KingBiscuitT collected $0.70 from pot
KingBiscuitT: doesn't show hand 
*** SUMMARY ***
Total pot $0.70 | Rake $0 
Seat 1: Calltossen folded before Flop (didn't bet)
Seat 4: PokerPro EPT (button) folded before Flop
Seat 5: KingBiscuitT (small blind) collected ($0.70)
Seat 6: Squashy22 (big blind) folded before Flop



PokerStars Hand #222955550189:  Hold'em No Limit ($0.05/$0.10 USD) - 2021/01/23 9:41:35 ET
Table 'Lutetia III' 6-max Seat #5 is the button
Seat 1: Calltossen ($16.25 in chips) 
Seat 4: PokerPro EPT ($9.14 in chips) 
Seat 5: KingBiscuitT ($12.22 in chips) 
Seat 6: Squashy22 ($11.46 in chips) 
Squashy22: posts small blind $0.05
Calltossen: posts big blind $0.10
Kimi1892: sits out 
Darkhorse2205: sits out 
*** HOLE CARDS ***
PokerPro EPT: raises $0.20 to $0.30
KingBiscuitT: folds 
Squashy22: raises $0.90 to $1.20
Calltossen: calls $1.10
PokerPro EPT: folds 
*** FLOP *** [2d 4s 2s]
Squashy22: bets $1.44
Calltossen: calls $1.44
*** TURN *** [2d 4s 2s] [7c]
Squashy22: checks 
Calltossen: checks 
*** RIVER *** [2d 4s 2s 7c] [4c]
Squashy22: checks 
Calltossen: checks 
*** SHOW DOWN ***
Squashy22: shows [Qd Ah] (two pair, Fours and Deuces)
Calltossen: shows [8d 8c] (two pair, Eights and Fours)
Calltossen collected $5.33 from pot
*** SUMMARY ***
Total pot $5.58 | Rake $0.25 
Board [2d 4s 2s 7c 4c]
Seat 1: Calltossen (big blind) showed [8d 8c] and won ($5.33) with two pair, Eights and Fours
Seat 4: PokerPro EPT folded before Flop
Seat 5: KingBiscuitT (button) folded before Flop (didn't bet)
Seat 6: Squashy22 (small blind) showed [Qd Ah] and lost with two pair, Fours and Deuces



PokerStars Hand #222952415165:  Hold'em No Limit ($0.05/$0.10 USD) - 2021/01/23 7:44:01 ET
Table 'Lutetia III' 6-max Seat #3 is the button
Seat 1: Dugipokers ($13.10 in chips) 
Seat 2: SERGEY015 ($10.88 in chips) 
Seat 3: Edgarlucky ($10 in chips) 
Seat 4: Kalmar333 ($10.74 in chips) 
Seat 5: JerJer1979 ($9.87 in chips) 
Seat 6: Lergik ($10.42 in chips) 
Kalmar333: posts small blind $0.05
JerJer1979: posts big blind $0.10
*** HOLE CARDS ***
Lergik: raises $0.20 to $0.30
Dugipokers: folds 
SERGEY015: folds 
Edgarlucky: folds 
Kalmar333: folds 
JerJer1979: calls $0.20
*** FLOP *** [8h 2h 2s]
JerJer1979: checks 
Lergik: bets $0.41
JerJer1979: calls $0.41
*** TURN *** [8h 2h 2s] [Kc]
JerJer1979: checks 
Lergik: bets $0.93
JerJer1979: folds 
Uncalled bet ($0.93) returned to Lergik
Lergik collected $1.40 from pot
*** SUMMARY ***
Total pot $1.47 | Rake $0.07 
Board [8h 2h 2s Kc]
Seat 1: Dugipokers folded before Flop (didn't bet)
Seat 2: SERGEY015 folded before Flop (didn't bet)
Seat 3: Edgarlucky (button) folded before Flop (didn't bet)
Seat 4: Kalmar333 (small blind) folded before Flop
Seat 5: JerJer1979 (big blind) folded on the Turn
Seat 6: Lergik collected ($1.40)



PokerStars Hand #222952437436:  Hold'em No Limit ($0.05/$0.10 USD) - 2021/01/23 7:44:59 ET
Table 'Lutetia III' 6-max Seat #4 is the button
Seat 1: Dugipokers ($13.10 in chips) 
Seat 2: SERGEY015 ($10.88 in chips) 
Seat 3: Edgarlucky ($10 in chips) 
Seat 4: Kalmar333 ($10.69 in chips) 
Seat 5: JerJer1979 ($9.16 in chips) 
JerJer1979: posts small blind $0.05
Lergik: is sitting out 
Dugipokers: posts big blind $0.10
*** HOLE CARDS ***
SERGEY015: folds 
Edgarlucky: folds 
Kalmar333: folds 
JerJer1979: calls $0.05
Dugipokers: raises $0.30 to $0.40
JerJer1979: calls $0.30
*** FLOP *** [Ts 3h 5s]
JerJer1979: checks 
Dugipokers: bets $0.39
JerJer1979: calls $0.39
*** TURN *** [Ts 3h 5s] [Ah]
JerJer1979: checks 
Dugipokers: bets $1.15
JerJer1979: folds 
Uncalled bet ($1.15) returned to Dugipokers
Dugipokers collected $1.51 from pot
Dugipokers: doesn't show hand 
*** SUMMARY ***
Total pot $1.58 | Rake $0.07 
Board [Ts 3h 5s Ah]
Seat 1: Dugipokers (big blind) collected ($1.51)
Seat 2: SERGEY015 folded before Flop (didn't bet)
Seat 3: Edgarlucky folded before Flop (didn't bet)
Seat 4: Kalmar333 (button) folded before Flop (didn't bet)
Seat 5: JerJer1979 (small blind) folded on the Turn



PokerStars Hand #222952452965:  Hold'em No Limit ($0.05/$0.10 USD) - 2021/01/23 7:45:39 ET
Table 'Lutetia III' 6-max Seat #5 is the button
Seat 1: Dugipokers ($13.82 in chips) 
Seat 2: SERGEY015 ($10.88 in chips) 
Seat 3: Edgarlucky ($10 in chips) 
Seat 4: Kalmar333 ($10.69 in chips) 
Seat 5: JerJer1979 ($8.37 in chips) 
Dugipokers: posts small blind $0.05
SERGEY015: posts big blind $0.10
*** HOLE CARDS ***
Edgarlucky: folds 
Kalmar333: folds 
JerJer1979: folds 
Dugipokers: raises $0.15 to $0.25
SERGEY015: folds 
Uncalled bet ($0.15) returned to Dugipokers
Dugipokers collected $0.20 from pot
Dugipokers: doesn't show hand 
*** SUMMARY ***
Total pot $0.20 | Rake $0 
Seat 1: Dugipokers (small blind) collected ($0.20)
Seat 2: SERGEY015 (big blind) folded before Flop
Seat 3: Edgarlucky folded before Flop (didn't bet)
Seat 4: Kalmar333 folded before Flop (didn't bet)
Seat 5: JerJer1979 (button) folded before Flop (didn't bet)



PokerStars Hand #222952458153:  Hold'em No Limit ($0.05/$0.10 USD) - 2021/01/23 7:45:52 ET
Table 'Lutetia III' 6-max Seat #1 is the button
Seat 1: Dugipokers ($13.92 in chips) 
Seat 2: SERGEY015 ($10.78 in chips) 
Seat 3: Edgarlucky ($10 in chips) 
Seat 4: Kalmar333 ($10.69 in chips) 
Seat 5: JerJer1979 ($8.37 in chips) 
SERGEY015: posts small blind $0.05
Edgarlucky: posts big blind $0.10
*** HOLE CARDS ***
Kalmar333: folds 
JerJer1979: calls $0.10
Dugipokers: raises $0.30 to $0.40
SERGEY015: folds 
Edgarlucky: folds 
JerJer1979: raises $0.95 to $1.35
Dugipokers: folds 
Uncalled bet ($0.95) returned to JerJer1979
JerJer1979 collected $0.95 from pot
JerJer1979: doesn't show hand 
*** SUMMARY ***
Total pot $0.95 | Rake $0 
Seat 1: Dugipokers (button) folded before Flop
Seat 2: SERGEY015 (small blind) folded before Flop
Seat 3: Edgarlucky (big blind) folded before Flop
Seat 4: Kalmar333 folded before Flop (didn't bet)
Seat 5: JerJer1979 collected ($0.95)



PokerStars Hand #222952467506:  Hold'em No Limit ($0.05/$0.10 USD) - 2021/01/23 7:46:17 ET
Table 'Lutetia III' 6-max Seat #2 is the button
Seat 1: Dugipokers ($13.52 in chips) 
Seat 2: SERGEY015 ($10.73 in chips) 
Seat 3: Edgarlucky ($10 in chips) 
Seat 4: Kalmar333 ($10.69 in chips) 
Seat 5: JerJer1979 ($8.92 in chips) 
Edgarlucky: posts small blind $0.05
Kalmar333: posts big blind $0.10
*** HOLE CARDS ***
JerJer1979: folds 
Dugipokers: raises $0.15 to $0.25
SERGEY015: folds 
Edgarlucky: folds 
Kalmar333: folds 
Uncalled bet ($0.15) returned to Dugipokers
Dugipokers collected $0.25 from pot
Dugipokers: doesn't show hand 
*** SUMMARY ***
Total pot $0.25 | Rake $0 
Seat 1: Dugipokers collected ($0.25)
Seat 2: SERGEY015 (button) folded before Flop (didn't bet)
Seat 3: Edgarlucky (small blind) folded before Flop
Seat 4: Kalmar333 (big blind) folded before Flop
Seat 5: JerJer1979 folded before Flop (didn't bet)



PokerStars Hand #222952475790:  Hold'em No Limit ($0.05/$0.10 USD) - 2021/01/23 7:46:38 ET
Table 'Lutetia III' 6-max Seat #3 is the button
Seat 1: Dugipokers ($13.67 in chips) 
Seat 2: SERGEY015 ($10.73 in chips) 
Seat 3: Edgarlucky ($10 in chips) 
Seat 4: Kalmar333 ($10.59 in chips) 
Seat 5: JerJer1979 ($8.92 in chips) 
Kalmar333: posts small blind $0.05
JerJer1979: posts big blind $0.10
Lergik: sits out 
*** HOLE CARDS ***
Dugipokers: folds 
SERGEY015: folds 
Edgarlucky: folds 
Kalmar333: folds 
Uncalled bet ($0.05) returned to JerJer1979
JerJer1979 collected $0.10 from pot
JerJer1979: doesn't show hand 
*** SUMMARY ***
Total pot $0.10 | Rake $0 
Seat 1: Dugipokers folded before Flop (didn't bet)
Seat 2: SERGEY015 folded before Flop (didn't bet)
Seat 3: Edgarlucky (button) folded before Flop (didn't bet)
Seat 4: Kalmar333 (small blind) folded before Flop
Seat 5: JerJer1979 (big blind) collected ($0.10)



PokerStars Hand #222952482204:  Hold'em No Limit ($0.05/$0.10 USD) - 2021/01/23 7:46:55 ET
Table 'Lutetia III' 6-max Seat #4 is the button
Seat 1: Dugipokers ($13.67 in chips) 
Seat 2: SERGEY015 ($10.73 in chips) 
Seat 3: Edgarlucky ($10 in chips) 
Seat 4: Kalmar333 ($10.54 in chips) 
Seat 5: JerJer1979 ($8.97 in chips) 
Seat 6: Lergik ($11.11 in chips) 
JerJer1979: posts small blind $0.05
Lergik: posts big blind $0.10
*** HOLE CARDS ***
Dugipokers: folds 
SERGEY015: folds 
Edgarlucky: raises $0.15 to $0.25
Kalmar333: folds 
JerJer1979: folds 
Lergik: folds 
Uncalled bet ($0.15) returned to Edgarlucky
Edgarlucky collected $0.25 from pot
Edgarlucky: doesn't show hand 
*** SUMMARY ***
Total pot $0.25 | Rake $0 
Seat 1: Dugipokers folded before Flop (didn't bet)
Seat 2: SERGEY015 folded before Flop (didn't bet)
Seat 3: Edgarlucky collected ($0.25)
Seat 4: Kalmar333 (button) folded before Flop (didn't bet)
Seat 5: JerJer1979 (small blind) folded before Flop
Seat 6: Lergik (big blind) folded before Flop



PokerStars Hand #222952491133:  Hold'em No Limit ($0.05/$0.10 USD) - 2021/01/23 7:47:19 ET
Table 'Lutetia III' 6-max Seat #5 is the button
Seat 1: Dugipokers ($13.67 in chips) 
Seat 2: SERGEY015 ($10.73 in chips) 
Seat 3: Edgarlucky ($10.15 in chips) 
Seat 4: Kalmar333 ($10.54 in chips) 
Seat 5: JerJer1979 ($8.92 in chips) 
Seat 6: Lergik ($11.01 in chips) 
Lergik: posts small blind $0.05
Dugipokers: posts big blind $0.10
*** HOLE CARDS ***
SERGEY015: raises $0.20 to $0.30
Edgarlucky: raises $0.60 to $0.90
Kalmar333: folds 
JerJer1979: folds 
Lergik: folds 
Dugipokers: folds 
SERGEY015: folds 
Uncalled bet ($0.60) returned to Edgarlucky
Edgarlucky collected $0.75 from pot
Edgarlucky: doesn't show hand 
*** SUMMARY ***
Total pot $0.75 | Rake $0 
Seat 1: Dugipokers (big blind) folded before Flop
Seat 2: SERGEY015 folded before Flop
Seat 3: Edgarlucky collected ($0.75)
Seat 4: Kalmar333 folded before Flop (didn't bet)
Seat 5: JerJer1979 (button) folded before Flop (didn't bet)
Seat 6: Lergik (small blind) folded before Flop



PokerStars Hand #222952501751:  Hold'em No Limit ($0.05/$0.10 USD) - 2021/01/23 7:47:46 ET
Table 'Lutetia III' 6-max Seat #6 is the button
Seat 1: Dugipokers ($13.57 in chips) 
Seat 2: SERGEY015 ($10.43 in chips) 
Seat 3: Edgarlucky ($10.60 in chips) 
Seat 4: Kalmar333 ($10.54 in chips) 
Seat 5: JerJer1979 ($8.92 in chips) 
Seat 6: Lergik ($10.96 in chips) 
Dugipokers: posts small blind $0.05
SERGEY015: posts big blind $0.10
*** HOLE CARDS ***
Edgarlucky: folds 
Kalmar333: folds 
JerJer1979: folds 
Lergik: folds 
Dugipokers: raises $0.20 to $0.30
SERGEY015: folds 
Uncalled bet ($0.20) returned to Dugipokers
Dugipokers collected $0.20 from pot
Dugipokers: doesn't show hand 
*** SUMMARY ***
Total pot $0.20 | Rake $0 
Seat 1: Dugipokers (small blind) collected ($0.20)
Seat 2: SERGEY015 (big blind) folded before Flop
Seat 3: Edgarlucky folded before Flop (didn't bet)
Seat 4: Kalmar333 folded before Flop (didn't bet)
Seat 5: JerJer1979 folded before Flop (didn't bet)
Seat 6: Lergik (button) folded before Flop (didn't bet)



PokerStars Hand #222952507281:  Hold'em No Limit ($0.05/$0.10 USD) - 2021/01/23 7:48:01 ET
Table 'Lutetia III' 6-max Seat #1 is the button
Seat 1: Dugipokers ($13.67 in chips) 
Seat 2: SERGEY015 ($10.33 in chips) 
Seat 3: Edgarlucky ($10.60 in chips) 
Seat 4: Kalmar333 ($10.54 in chips) 
Seat 5: JerJer1979 ($8.92 in chips) 
Seat 6: Lergik ($10.96 in chips) 
SERGEY015: posts small blind $0.05
Edgarlucky: posts big blind $0.10
*** HOLE CARDS ***
Kalmar333: folds 
JerJer1979: folds 
Lergik: raises $0.20 to $0.30
Dugipokers: folds 
SERGEY015: folds 
Edgarlucky: folds 
Uncalled bet ($0.20) returned to Lergik
Lergik collected $0.25 from pot
*** SUMMARY ***
Total pot $0.25 | Rake $0 
Seat 1: Dugipokers (button) folded before Flop (didn't bet)
Seat 2: SERGEY015 (small blind) folded before Flop
Seat 3: Edgarlucky (big blind) folded before Flop
Seat 4: Kalmar333 folded before Flop (didn't bet)
Seat 5: JerJer1979 folded before Flop (didn't bet)
Seat 6: Lergik collected ($0.25)



PokerStars Hand #222952513702:  Hold'em No Limit ($0.05/$0.10 USD) - 2021/01/23 7:48:18 ET
Table 'Lutetia III' 6-max Seat #2 is the button
Seat 1: Dugipokers ($13.67 in chips) 
Seat 2: SERGEY015 ($10.28 in chips) 
Seat 3: Edgarlucky ($10.50 in chips) 
Seat 4: Kalmar333 ($10.54 in chips) 
Seat 5: JerJer1979 ($8.92 in chips) 
Seat 6: Lergik ($11.11 in chips) 
Edgarlucky: posts small blind $0.05
Kalmar333: posts big blind $0.10
*** HOLE CARDS ***
JerJer1979: calls $0.10
Lergik: folds 
Dugipokers: folds 
SERGEY015: folds 
Edgarlucky: calls $0.05
Kalmar333: checks 
*** FLOP *** [4d Ks 6c]
Edgarlucky: bets $0.14
Kalmar333: folds 
JerJer1979: calls $0.14
*** TURN *** [4d Ks 6c] [8h]
Edgarlucky: checks 
JerJer1979: checks 
*** RIVER *** [4d Ks 6c 8h] [3s]
Edgarlucky: checks 
JerJer1979: bets $0.27
Edgarlucky: calls $0.27
*** SHOW DOWN ***
JerJer1979: shows [Th Ad] (high card Ace)
Edgarlucky: shows [7c 6h] (a pair of Sixes)
Edgarlucky collected $1.07 from pot
*** SUMMARY ***
Total pot $1.12 | Rake $0.05 
Board [4d Ks 6c 8h 3s]
Seat 1: Dugipokers folded before Flop (didn't bet)
Seat 2: SERGEY015 (button) folded before Flop (didn't bet)
Seat 3: Edgarlucky (small blind) showed [7c 6h] and won ($1.07) with a pair of Sixes
Seat 4: Kalmar333 (big blind) folded on the Flop
Seat 5: JerJer1979 showed [Th Ad] and lost with high card Ace
Seat 6: Lergik folded before Flop (didn't bet)



PokerStars Hand #222952531171:  Hold'em No Limit ($0.05/$0.10 USD) - 2021/01/23 7:49:03 ET
Table 'Lutetia III' 6-max Seat #3 is the button
Seat 1: Dugipokers ($13.67 in chips) 
Seat 2: SERGEY015 ($10.28 in chips) 
Seat 3: Edgarlucky ($11.06 in chips) 
Seat 4: Kalmar333 ($10.44 in chips) 
Seat 5: JerJer1979 ($8.41 in chips) 
Seat 6: Lergik ($11.11 in chips) 
Kalmar333: posts small blind $0.05
JerJer1979: posts big blind $0.10
*** HOLE CARDS ***
Lergik: folds 
Dugipokers: folds 
Lergik leaves the table
SERGEY015: folds 
Edgarlucky: folds 
Kalmar333: raises $0.20 to $0.30
JerJer1979: calls $0.20
*** FLOP *** [9h 8h 2h]
Kalmar333: checks 
JerJer1979: bets $0.10
Kalmar333: calls $0.10
*** TURN *** [9h 8h 2h] [3c]
Kalmar333: checks 
JerJer1979: bets $0.38
Kalmar333: folds 
Uncalled bet ($0.38) returned to JerJer1979
JerJer1979 collected $0.76 from pot
JerJer1979: doesn't show hand 
*** SUMMARY ***
Total pot $0.80 | Rake $0.04 
Board [9h 8h 2h 3c]
Seat 1: Dugipokers folded before Flop (didn't bet)
Seat 2: SERGEY015 folded before Flop (didn't bet)
Seat 3: Edgarlucky (button) folded before Flop (didn't bet)
Seat 4: Kalmar333 (small blind) folded on the Turn
Seat 5: JerJer1979 (big blind) collected ($0.76)
Seat 6: Lergik folded before Flop (didn't bet)



PokerStars Hand #222952542603:  Hold'em No Limit ($0.05/$0.10 USD) - 2021/01/23 7:49:33 ET
Table 'Lutetia III' 6-max Seat #4 is the button
Seat 1: Dugipokers ($13.67 in chips) 
Seat 2: SERGEY015 ($10.28 in chips) 
Seat 3: Edgarlucky ($11.06 in chips) 
Seat 4: Kalmar333 ($10.04 in chips) 
Seat 5: JerJer1979 ($8.77 in chips) 
JerJer1979: posts small blind $0.05
Dugipokers: posts big blind $0.10
*** HOLE CARDS ***
SERGEY015: folds 
Edgarlucky: folds 
Kalmar333: folds 
JerJer1979: calls $0.05
Dugipokers: checks 
*** FLOP *** [Ac Ad 2h]
JerJer1979: bets $0.10
Dugipokers: folds 
Uncalled bet ($0.10) returned to JerJer1979
JerJer1979 collected $0.19 from pot
JerJer1979: doesn't show hand 
*** SUMMARY ***
Total pot $0.20 | Rake $0.01 
Board [Ac Ad 2h]
Seat 1: Dugipokers (big blind) folded on the Flop
Seat 2: SERGEY015 folded before Flop (didn't bet)
Seat 3: Edgarlucky folded before Flop (didn't bet)
Seat 4: Kalmar333 (button) folded before Flop (didn't bet)
Seat 5: JerJer1979 (small blind) collected ($0.19)



PokerStars Hand #222952550199:  Hold'em No Limit ($0.05/$0.10 USD) - 2021/01/23 7:49:52 ET
Table 'Lutetia III' 6-max Seat #5 is the button
Seat 1: Dugipokers ($13.57 in chips) 
Seat 2: SERGEY015 ($10.28 in chips) 
Seat 3: Edgarlucky ($11.06 in chips) 
Seat 4: Kalmar333 ($10.04 in chips) 
Seat 5: JerJer1979 ($8.86 in chips) 
Dugipokers: posts small blind $0.05
SERGEY015: posts big blind $0.10
*** HOLE CARDS ***
Edgarlucky: folds 
Kalmar333: folds 
JerJer1979: folds 
Dugipokers: raises $0.15 to $0.25
SERGEY015: calls $0.15
*** FLOP *** [Ts 4c 9d]
sniegs99 joins the table at seat #6 
Dugipokers: bets $0.24
SERGEY015: calls $0.24
*** TURN *** [Ts 4c 9d] [Tc]
Dugipokers: bets $0.71
SERGEY015: calls $0.71
*** RIVER *** [Ts 4c 9d Tc] [9s]
Dugipokers: checks 
SERGEY015: bets $1.17
Dugipokers: folds 
Uncalled bet ($1.17) returned to SERGEY015
SERGEY015 collected $2.29 from pot
SERGEY015: doesn't show hand 
*** SUMMARY ***
Total pot $2.40 | Rake $0.11 
Board [Ts 4c 9d Tc 9s]
Seat 1: Dugipokers (small blind) folded on the River
Seat 2: SERGEY015 (big blind) collected ($2.29)
Seat 3: Edgarlucky folded before Flop (didn't bet)
Seat 4: Kalmar333 folded before Flop (didn't bet)
Seat 5: JerJer1979 (button) folded before Flop (didn't bet)



PokerStars Hand #222952564495:  Hold'em No Limit ($0.05/$0.10 USD) - 2021/01/23 7:50:30 ET
Table 'Lutetia III' 6-max Seat #1 is the button
Seat 1: Dugipokers ($12.37 in chips) 
Seat 2: SERGEY015 ($11.37 in chips) 
Seat 3: Edgarlucky ($11.06 in chips) 
Seat 4: Kalmar333 ($10.04 in chips) 
Seat 5: JerJer1979 ($8.86 in chips) 
SERGEY015: posts small blind $0.05
Edgarlucky: posts big blind $0.10
sniegs99: sits out 
*** HOLE CARDS ***
Kalmar333: folds 
JerJer1979: folds 
Dugipokers: raises $0.15 to $0.25
SERGEY015: folds 
Edgarlucky: raises $0.80 to $1.05
Dugipokers: folds 
Uncalled bet ($0.80) returned to Edgarlucky
Edgarlucky collected $0.55 from pot
Edgarlucky: doesn't show hand 
*** SUMMARY ***
Total pot $0.55 | Rake $0 
Seat 1: Dugipokers (button) folded before Flop
Seat 2: SERGEY015 (small blind) folded before Flop
Seat 3: Edgarlucky (big blind) collected ($0.55)
Seat 4: Kalmar333 folded before Flop (didn't bet)
Seat 5: JerJer1979 folded before Flop (didn't bet)



PokerStars Hand #222952575500:  Hold'em No Limit ($0.05/$0.10 USD) - 2021/01/23 7:50:59 ET
Table 'Lutetia III' 6-max Seat #2 is the button
Seat 1: Dugipokers ($12.12 in chips) 
Seat 2: SERGEY015 ($11.32 in chips) 
Seat 3: Edgarlucky ($11.36 in chips) 
Seat 4: Kalmar333 ($10.04 in chips) 
Seat 5: JerJer1979 ($8.86 in chips) 
Edgarlucky: posts small blind $0.05
Kalmar333: posts big blind $0.10
sniegs99: sits out 
*** HOLE CARDS ***
JerJer1979: folds 
Dugipokers: folds 
SERGEY015: folds 
Edgarlucky: raises $0.20 to $0.30
Kalmar333: folds 
Uncalled bet ($0.20) returned to Edgarlucky
Edgarlucky collected $0.20 from pot
Edgarlucky: doesn't show hand 
*** SUMMARY ***
Total pot $0.20 | Rake $0 
Seat 1: Dugipokers folded before Flop (didn't bet)
Seat 2: SERGEY015 (button) folded before Flop (didn't bet)
Seat 3: Edgarlucky (small blind) collected ($0.20)
Seat 4: Kalmar333 (big blind) folded before Flop
Seat 5: JerJer1979 folded before Flop (didn't bet)



PokerStars Hand #222952580610:  Hold'em No Limit ($0.05/$0.10 USD) - 2021/01/23 7:51:12 ET
Table 'Lutetia III' 6-max Seat #3 is the button
Seat 1: Dugipokers ($12.12 in chips) 
Seat 2: SERGEY015 ($11.32 in chips) 
Seat 3: Edgarlucky ($11.46 in chips) 
Seat 4: Kalmar333 ($9.94 in chips) 
Seat 5: JerJer1979 ($8.86 in chips) 
Kalmar333: posts small blind $0.05
JerJer1979: posts big blind $0.10
sniegs99: sits out 
*** HOLE CARDS ***
Dugipokers: folds 
SERGEY015: folds 
Edgarlucky: folds 
Kalmar333: folds 
Uncalled bet ($0.05) returned to JerJer1979
JerJer1979 collected $0.10 from pot
JerJer1979: doesn't show hand 
*** SUMMARY ***
Total pot $0.10 | Rake $0 
Seat 1: Dugipokers folded before Flop (didn't bet)
Seat 2: SERGEY015 folded before Flop (didn't bet)
Seat 3: Edgarlucky (button) folded before Flop (didn't bet)
Seat 4: Kalmar333 (small blind) folded before Flop
Seat 5: JerJer1979 (big blind) collected ($0.10)



PokerStars Hand #222952585085:  Hold'em No Limit ($0.05/$0.10 USD) - 2021/01/23 7:51:23 ET
Table 'Lutetia III' 6-max Seat #4 is the button
Seat 1: Dugipokers ($12.12 in chips) 
Seat 2: SERGEY015 ($11.32 in chips) 
Seat 3: Edgarlucky ($11.46 in chips) 
Seat 4: Kalmar333 ($9.89 in chips) 
Seat 5: JerJer1979 ($8.91 in chips) 
Seat 6: sniegs99 ($10 in chips) 
JerJer1979: posts small blind $0.05
sniegs99: posts big blind $0.10
*** HOLE CARDS ***
Dugipokers: raises $0.20 to $0.30
SERGEY015: raises $0.60 to $0.90
Edgarlucky: folds 
Kalmar333: folds 
JerJer1979: calls $0.85
sniegs99: folds 
Dugipokers: calls $0.60
*** FLOP *** [8s 3s 3h]
JerJer1979: checks 
Dugipokers: checks 
SERGEY015: bets $1.40
JerJer1979: folds 
Dugipokers: folds 
Uncalled bet ($1.40) returned to SERGEY015
SERGEY015 collected $2.67 from pot
SERGEY015: doesn't show hand 
*** SUMMARY ***
Total pot $2.80 | Rake $0.13 
Board [8s 3s 3h]
Seat 1: Dugipokers folded on the Flop
Seat 2: SERGEY015 collected ($2.67)
Seat 3: Edgarlucky folded before Flop (didn't bet)
Seat 4: Kalmar333 (button) folded before Flop (didn't bet)
Seat 5: JerJer1979 (small blind) folded on the Flop
Seat 6: sniegs99 (big blind) folded before Flop



PokerStars Hand #222952608601:  Hold'em No Limit ($0.05/$0.10 USD) - 2021/01/23 7:52:24 ET
Table 'Lutetia III' 6-max Seat #5 is the button
Seat 1: Dugipokers ($11.22 in chips) 
Seat 2: SERGEY015 ($13.09 in chips) 
Seat 3: Edgarlucky ($11.46 in chips) 
Seat 4: Kalmar333 ($9.89 in chips) 
Seat 5: JerJer1979 ($8.01 in chips) 
Seat 6: sniegs99 ($9.90 in chips) 
sniegs99: posts small blind $0.05
Dugipokers: posts big blind $0.10
*** HOLE CARDS ***
SERGEY015: folds 
Edgarlucky: folds 
Kalmar333: folds 
JerJer1979: folds 
sniegs99: raises $0.15 to $0.25
Dugipokers: folds 
Uncalled bet ($0.15) returned to sniegs99
sniegs99 collected $0.20 from pot
sniegs99: doesn't show hand 
*** SUMMARY ***
Total pot $0.20 | Rake $0 
Seat 1: Dugipokers (big blind) folded before Flop
Seat 2: SERGEY015 folded before Flop (didn't bet)
Seat 3: Edgarlucky folded before Flop (didn't bet)
Seat 4: Kalmar333 folded before Flop (didn't bet)
Seat 5: JerJer1979 (button) folded before Flop (didn't bet)
Seat 6: sniegs99 (small blind) collected ($0.20)



PokerStars Hand #222952615681:  Hold'em No Limit ($0.05/$0.10 USD) - 2021/01/23 7:52:43 ET
Table 'Lutetia III' 6-max Seat #6 is the button
Seat 1: Dugipokers ($11.12 in chips) 
Seat 2: SERGEY015 ($13.09 in chips) 
Seat 3: Edgarlucky ($11.46 in chips) 
Seat 4: Kalmar333 ($9.89 in chips) 
Seat 5: JerJer1979 ($8.01 in chips) 
Seat 6: sniegs99 ($10 in chips) 
Dugipokers: posts small blind $0.05
SERGEY015: posts big blind $0.10
*** HOLE CARDS ***
Edgarlucky: folds 
Kalmar333: folds 
JerJer1979: folds 
sniegs99: folds 
Dugipokers: raises $0.15 to $0.25
SERGEY015: folds 
Uncalled bet ($0.15) returned to Dugipokers
Dugipokers collected $0.20 from pot
Dugipokers: doesn't show hand 
*** SUMMARY ***
Total pot $0.20 | Rake $0 
Seat 1: Dugipokers (small blind) collected ($0.20)
Seat 2: SERGEY015 (big blind) folded before Flop
Seat 3: Edgarlucky folded before Flop (didn't bet)
Seat 4: Kalmar333 folded before Flop (didn't bet)
Seat 5: JerJer1979 folded before Flop (didn't bet)
Seat 6: sniegs99 (button) folded before Flop (didn't bet)



PokerStars Hand #222952623487:  Hold'em No Limit ($0.05/$0.10 USD) - 2021/01/23 7:53:03 ET
Table 'Lutetia III' 6-max Seat #1 is the button
Seat 1: Dugipokers ($11.22 in chips) 
Seat 2: SERGEY015 ($12.99 in chips) 
Seat 3: Edgarlucky ($11.46 in chips) 
Seat 4: Kalmar333 ($9.89 in chips) 
Seat 5: JerJer1979 ($8.01 in chips) 
Seat 6: sniegs99 ($10 in chips) 
SERGEY015: posts small blind $0.05
Edgarlucky: posts big blind $0.10
*** HOLE CARDS ***
Kalmar333: folds 
JerJer1979: folds 
sniegs99: folds 
Dugipokers: raises $0.15 to $0.25
SERGEY015: folds 
Edgarlucky: calls $0.15
*** FLOP *** [Kd Qd 4c]
Edgarlucky: checks 
Dugipokers: bets $0.17
Edgarlucky: folds 
Uncalled bet ($0.17) returned to Dugipokers
Dugipokers collected $0.53 from pot
Dugipokers: doesn't show hand 
*** SUMMARY ***
Total pot $0.55 | Rake $0.02 
Board [Kd Qd 4c]
Seat 1: Dugipokers (button) collected ($0.53)
Seat 2: SERGEY015 (small blind) folded before Flop
Seat 3: Edgarlucky (big blind) folded on the Flop
Seat 4: Kalmar333 folded before Flop (didn't bet)
Seat 5: JerJer1979 folded before Flop (didn't bet)
Seat 6: sniegs99 folded before Flop (didn't bet)



PokerStars Hand #222952634353:  Hold'em No Limit ($0.05/$0.10 USD) - 2021/01/23 7:53:31 ET
Table 'Lutetia III' 6-max Seat #2 is the button
Seat 1: Dugipokers ($11.50 in chips) 
Seat 2: SERGEY015 ($12.94 in chips) 
Seat 3: Edgarlucky ($11.21 in chips) 
Seat 4: Kalmar333 ($9.89 in chips) 
Seat 5: JerJer1979 ($8.01 in chips) 
Seat 6: sniegs99 ($10 in chips) 
Edgarlucky: posts small blind $0.05
Kalmar333: posts big blind $0.10
*** HOLE CARDS ***
JerJer1979: folds 
sniegs99: folds 
Dugipokers: folds 
SERGEY015: folds 
Edgarlucky: raises $0.20 to $0.30
Kalmar333: folds 
Uncalled bet ($0.20) returned to Edgarlucky
Edgarlucky collected $0.20 from pot
Edgarlucky: doesn't show hand 
*** SUMMARY ***
Total pot $0.20 | Rake $0 
Seat 1: Dugipokers folded before Flop (didn't bet)
Seat 2: SERGEY015 (button) folded before Flop (didn't bet)
Seat 3: Edgarlucky (small blind) collected ($0.20)
Seat 4: Kalmar333 (big blind) folded before Flop
Seat 5: JerJer1979 folded before Flop (didn't bet)
Seat 6: sniegs99 folded before Flop (didn't bet)



PokerStars Hand #222952640375:  Hold'em No Limit ($0.05/$0.10 USD) - 2021/01/23 7:53:46 ET
Table 'Lutetia III' 6-max Seat #3 is the button
Seat 1: Dugipokers ($11.50 in chips) 
Seat 2: SERGEY015 ($12.94 in chips) 
Seat 3: Edgarlucky ($11.31 in chips) 
Seat 4: Kalmar333 ($9.79 in chips) 
Seat 5: JerJer1979 ($8.01 in chips) 
Seat 6: sniegs99 ($10 in chips) 
Kalmar333: posts small blind $0.05
JerJer1979: posts big blind $0.10
*** HOLE CARDS ***
sniegs99: raises $0.15 to $0.25
Dugipokers: folds 
SERGEY015: folds 
Edgarlucky: folds 
Kalmar333: folds 
JerJer1979: calls $0.15
*** FLOP *** [Kd Kh Td]
JerJer1979: checks 
sniegs99: bets $0.45
JerJer1979: folds 
Uncalled bet ($0.45) returned to sniegs99
sniegs99 collected $0.53 from pot
sniegs99: doesn't show hand 
*** SUMMARY ***
Total pot $0.55 | Rake $0.02 
Board [Kd Kh Td]
Seat 1: Dugipokers folded before Flop (didn't bet)
Seat 2: SERGEY015 folded before Flop (didn't bet)
Seat 3: Edgarlucky (button) folded before Flop (didn't bet)
Seat 4: Kalmar333 (small blind) folded before Flop
Seat 5: JerJer1979 (big blind) folded on the Flop
Seat 6: sniegs99 collected ($0.53)



PokerStars Hand #222952656202:  Hold'em No Limit ($0.05/$0.10 USD) - 2021/01/23 7:54:27 ET
Table 'Lutetia III' 6-max Seat #4 is the button
Seat 1: Dugipokers ($11.50 in chips) 
Seat 2: SERGEY015 ($12.94 in chips) 
Seat 3: Edgarlucky ($11.31 in chips) 
Seat 4: Kalmar333 ($9.74 in chips) 
Seat 5: JerJer1979 ($7.76 in chips) 
Seat 6: sniegs99 ($10.28 in chips) 
JerJer1979: posts small blind $0.05
sniegs99: posts big blind $0.10
*** HOLE CARDS ***
Dugipokers: folds 
SERGEY015: folds 
Edgarlucky: folds 
Kalmar333: raises $0.20 to $0.30
JerJer1979: calls $0.25
sniegs99: folds 
*** FLOP *** [4c 9s 3s]
JerJer1979: bets $0.33
Kalmar333: calls $0.33
*** TURN *** [4c 9s 3s] [Js]
JerJer1979: checks 
Kalmar333: checks 
*** RIVER *** [4c 9s 3s Js] [Ts]
JerJer1979: bets $0.65
Kalmar333: folds 
Uncalled bet ($0.65) returned to JerJer1979
JerJer1979 collected $1.30 from pot
JerJer1979: doesn't show hand 
*** SUMMARY ***
Total pot $1.36 | Rake $0.06 
Board [4c 9s 3s Js Ts]
Seat 1: Dugipokers folded before Flop (didn't bet)
Seat 2: SERGEY015 folded before Flop (didn't bet)
Seat 3: Edgarlucky folded before Flop (didn't bet)
Seat 4: Kalmar333 (button) folded on the River
Seat 5: JerJer1979 (small blind) collected ($1.30)
Seat 6: sniegs99 (big blind) folded before Flop



PokerStars Hand #222952672996:  Hold'em No Limit ($0.05/$0.10 USD) - 2021/01/23 7:55:12 ET
Table 'Lutetia III' 6-max Seat #5 is the button
Seat 1: Dugipokers ($11.50 in chips) 
Seat 2: SERGEY015 ($12.94 in chips) 
Seat 3: Edgarlucky ($11.31 in chips) 
Seat 4: Kalmar333 ($9.11 in chips) 
Seat 5: JerJer1979 ($8.43 in chips) 
Seat 6: sniegs99 ($10.18 in chips) 
sniegs99: posts small blind $0.05
Dugipokers: posts big blind $0.10
*** HOLE CARDS ***
SERGEY015: folds 
Edgarlucky: raises $0.15 to $0.25
Kalmar333: folds 
JerJer1979: folds 
sniegs99: folds 
Dugipokers: raises $0.75 to $1
Edgarlucky: folds 
Uncalled bet ($0.75) returned to Dugipokers
Dugipokers collected $0.55 from pot
Dugipokers: doesn't show hand 
*** SUMMARY ***
Total pot $0.55 | Rake $0 
Seat 1: Dugipokers (big blind) collected ($0.55)
Seat 2: SERGEY015 folded before Flop (didn't bet)
Seat 3: Edgarlucky folded before Flop
Seat 4: Kalmar333 folded before Flop (didn't bet)
Seat 5: JerJer1979 (button) folded before Flop (didn't bet)
Seat 6: sniegs99 (small blind) folded before Flop



PokerStars Hand #222952683208:  Hold'em No Limit ($0.05/$0.10 USD) - 2021/01/23 7:55:43 ET
Table 'Lutetia III' 6-max Seat #6 is the button
Seat 1: Dugipokers ($11.80 in chips) 
Seat 2: SERGEY015 ($12.94 in chips) 
Seat 3: Edgarlucky ($11.06 in chips) 
Seat 4: Kalmar333 ($9.11 in chips) 
Seat 5: JerJer1979 ($8.43 in chips) 
Seat 6: sniegs99 ($10.13 in chips) 
Dugipokers: posts small blind $0.05
SERGEY015: posts big blind $0.10
*** HOLE CARDS ***
Edgarlucky: raises $0.15 to $0.25
Kalmar333: folds 
JerJer1979: calls $0.25
sniegs99: folds 
Dugipokers: raises $1 to $1.25
SERGEY015: folds 
Edgarlucky: folds 
JerJer1979: calls $1
*** FLOP *** [4c 2c 2d]
Dugipokers: bets $0.90
JerJer1979: raises $6.28 to $7.18 and is all-in
Dugipokers: folds 
Uncalled bet ($6.28) returned to JerJer1979
JerJer1979 collected $4.44 from pot
JerJer1979: doesn't show hand 
*** SUMMARY ***
Total pot $4.65 | Rake $0.21 
Board [4c 2c 2d]
Seat 1: Dugipokers (small blind) folded on the Flop
Seat 2: SERGEY015 (big blind) folded before Flop
Seat 3: Edgarlucky folded before Flop
Seat 4: Kalmar333 folded before Flop (didn't bet)
Seat 5: JerJer1979 collected ($4.44)
Seat 6: sniegs99 (button) folded before Flop (didn't bet)



PokerStars Hand #222952698995:  Hold'em No Limit ($0.05/$0.10 USD) - 2021/01/23 7:56:31 ET
Table 'Lutetia III' 6-max Seat #1 is the button
Seat 1: Dugipokers ($10 in chips) 
Seat 2: SERGEY015 ($12.84 in chips) 
Seat 3: Edgarlucky ($10.81 in chips) 
Seat 4: Kalmar333 ($9.11 in chips) 
Seat 5: JerJer1979 ($10.72 in chips) 
Seat 6: sniegs99 ($10.13 in chips) 
SERGEY015: posts small blind $0.05
Edgarlucky: posts big blind $0.10
*** HOLE CARDS ***
Kalmar333: folds 
JerJer1979: folds 
sniegs99: folds 
Dugipokers: folds 
SERGEY015: calls $0.05
Edgarlucky: raises $0.30 to $0.40
SERGEY015: folds 
Uncalled bet ($0.30) returned to Edgarlucky
Edgarlucky collected $0.20 from pot
Edgarlucky: doesn't show hand 
*** SUMMARY ***
Total pot $0.20 | Rake $0 
Seat 1: Dugipokers (button) folded before Flop (didn't bet)
Seat 2: SERGEY015 (small blind) folded before Flop
Seat 3: Edgarlucky (big blind) collected ($0.20)
Seat 4: Kalmar333 folded before Flop (didn't bet)
Seat 5: JerJer1979 folded before Flop (didn't bet)
Seat 6: sniegs99 folded before Flop (didn't bet)



PokerStars Hand #222952704742:  Hold'em No Limit ($0.05/$0.10 USD) - 2021/01/23 7:56:49 ET
Table 'Lutetia III' 6-max Seat #2 is the button
Seat 1: Dugipokers ($10 in chips) 
Seat 2: SERGEY015 ($12.74 in chips) 
Seat 3: Edgarlucky ($10.91 in chips) 
Seat 4: Kalmar333 ($9.11 in chips) 
Seat 5: JerJer1979 ($10.72 in chips) 
Seat 6: sniegs99 ($10.13 in chips) 
Edgarlucky: posts small blind $0.05
Kalmar333: posts big blind $0.10
*** HOLE CARDS ***
JerJer1979: folds 
sniegs99: folds 
Dugipokers: folds 
SERGEY015: raises $0.20 to $0.30
JerJer1979 leaves the table
Edgarlucky: folds 
Kalmar333: folds 
Uncalled bet ($0.20) returned to SERGEY015
Notatur joins the table at seat #5 
SERGEY015 collected $0.25 from pot
SERGEY015: doesn't show hand 
*** SUMMARY ***
Total pot $0.25 | Rake $0 
Seat 1: Dugipokers folded before Flop (didn't bet)
Seat 2: SERGEY015 (button) collected ($0.25)
Seat 3: Edgarlucky (small blind) folded before Flop
Seat 4: Kalmar333 (big blind) folded before Flop
Seat 5: JerJer1979 folded before Flop (didn't bet)
Seat 6: sniegs99 folded before Flop (didn't bet)



PokerStars Hand #222952709924:  Hold'em No Limit ($0.05/$0.10 USD) - 2021/01/23 7:57:05 ET
Table 'Lutetia III' 6-max Seat #3 is the button
Seat 1: Dugipokers ($10 in chips) 
Seat 2: SERGEY015 ($12.89 in chips) 
Seat 3: Edgarlucky ($10.86 in chips) 
Seat 4: Kalmar333 ($9.01 in chips) 
Seat 5: Notatur ($10 in chips) 
Seat 6: sniegs99 ($10.13 in chips) 
Kalmar333: posts small blind $0.05
Notatur: posts big blind $0.10
*** HOLE CARDS ***
sniegs99: folds 
Dugipokers: folds 
SERGEY015: folds 
Edgarlucky: raises $0.15 to $0.25
Kalmar333: folds 
Notatur: folds 
Uncalled bet ($0.15) returned to Edgarlucky
Edgarlucky collected $0.25 from pot
Edgarlucky: doesn't show hand 
*** SUMMARY ***
Total pot $0.25 | Rake $0 
Seat 1: Dugipokers folded before Flop (didn't bet)
Seat 2: SERGEY015 folded before Flop (didn't bet)
Seat 3: Edgarlucky (button) collected ($0.25)
Seat 4: Kalmar333 (small blind) folded before Flop
Seat 5: Notatur (big blind) folded before Flop
Seat 6: sniegs99 folded before Flop (didn't bet)



PokerStars Hand #222952716626:  Hold'em No Limit ($0.05/$0.10 USD) - 2021/01/23 7:57:25 ET
Table 'Lutetia III' 6-max Seat #4 is the button
Seat 1: Dugipokers ($10 in chips) 
Seat 2: SERGEY015 ($12.89 in chips) 
Seat 3: Edgarlucky ($11.01 in chips) 
Seat 4: Kalmar333 ($8.96 in chips) 
Seat 5: Notatur ($10 in chips) 
Seat 6: sniegs99 ($10.13 in chips) 
Notatur: posts small blind $0.05
sniegs99: posts big blind $0.10
*** HOLE CARDS ***
Dugipokers: folds 
SERGEY015: folds 
Edgarlucky: folds 
Kalmar333: folds 
Notatur: folds 
Uncalled bet ($0.05) returned to sniegs99
sniegs99 collected $0.10 from pot
sniegs99: doesn't show hand 
*** SUMMARY ***
Total pot $0.10 | Rake $0 
Seat 1: Dugipokers folded before Flop (didn't bet)
Seat 2: SERGEY015 folded before Flop (didn't bet)
Seat 3: Edgarlucky folded before Flop (didn't bet)
Seat 4: Kalmar333 (button) folded before Flop (didn't bet)
Seat 5: Notatur (small blind) folded before Flop
Seat 6: sniegs99 (big blind) collected ($0.10)



PokerStars Hand #222952722455:  Hold'em No Limit ($0.05/$0.10 USD) - 2021/01/23 7:57:43 ET
Table 'Lutetia III' 6-max Seat #5 is the button
Seat 2: SERGEY015 ($12.89 in chips) 
Seat 3: Edgarlucky ($11.01 in chips) 
Seat 4: Kalmar333 ($8.96 in chips) 
Seat 5: Notatur ($10 in chips) 
Seat 6: sniegs99 ($10.18 in chips) 
sniegs99: posts small blind $0.05
Dugipokers: is sitting out 
SERGEY015: posts big blind $0.10
*** HOLE CARDS ***
Edgarlucky: folds 
Dugipokers leaves the table
Edgarlucky leaves the table
Kalmar333: folds 
Notatur: raises $0.15 to $0.25
sniegs99: folds 
SERGEY015: calls $0.15
*** FLOP *** [8d 6h 5d]
SERGEY015: checks 
Notatur: checks 
*** TURN *** [8d 6h 5d] [Kc]
SERGEY015: checks 
arissanel joins the table at seat #1 
YuYuYu777 joins the table at seat #3 
Notatur: checks 
*** RIVER *** [8d 6h 5d Kc] [8h]
SERGEY015: checks 
Notatur: checks 
*** SHOW DOWN ***
SERGEY015: shows [Td Js] (a pair of Eights)
Notatur: shows [2c Ac] (a pair of Eights - Ace kicker)
Notatur collected $0.53 from pot
*** SUMMARY ***
Total pot $0.55 | Rake $0.02 
Board [8d 6h 5d Kc 8h]
Seat 2: SERGEY015 (big blind) showed [Td Js] and lost with a pair of Eights
Seat 3: Edgarlucky folded before Flop (didn't bet)
Seat 4: Kalmar333 folded before Flop (didn't bet)
Seat 5: Notatur (button) showed [2c Ac] and won ($0.53) with a pair of Eights
Seat 6: sniegs99 (small blind) folded before Flop



PokerStars Hand #222952743059:  Hold'em No Limit ($0.05/$0.10 USD) - 2021/01/23 7:58:46 ET
Table 'Lutetia III' 6-max Seat #6 is the button
Seat 2: SERGEY015 ($12.64 in chips) 
Seat 3: YuYuYu777 ($10 in chips) 
Seat 4: Kalmar333 ($8.96 in chips) 
Seat 5: Notatur ($10.28 in chips) 
Seat 6: sniegs99 ($10.13 in chips) 
SERGEY015: posts small blind $0.05
YuYuYu777: posts big blind $0.10
*** HOLE CARDS ***
Kalmar333: folds 
Notatur has timed out
Notatur: folds 
sniegs99: raises $0.15 to $0.25
SERGEY015: folds 
YuYuYu777: folds 
Uncalled bet ($0.15) returned to sniegs99
sniegs99 collected $0.25 from pot
sniegs99: doesn't show hand 
*** SUMMARY ***
Total pot $0.25 | Rake $0 
Seat 2: SERGEY015 (small blind) folded before Flop
Seat 3: YuYuYu777 (big blind) folded before Flop
Seat 4: Kalmar333 folded before Flop (didn't bet)
Seat 5: Notatur folded before Flop (didn't bet)
Seat 6: sniegs99 (button) collected ($0.25)



PokerStars Hand #222952751687:  Hold'em No Limit ($0.05/$0.10 USD) - 2021/01/23 7:59:12 ET
Table 'Lutetia III' 6-max Seat #2 is the button
Seat 1: arissanel ($10 in chips) 
Seat 2: SERGEY015 ($12.59 in chips) 
Seat 3: YuYuYu777 ($9.90 in chips) 
Seat 4: Kalmar333 ($8.96 in chips) 
Seat 5: Notatur ($10.28 in chips) 
Seat 6: sniegs99 ($10.28 in chips) 
YuYuYu777: posts small blind $0.05
Kalmar333: posts big blind $0.10
arissanel: posts big blind $0.10
*** HOLE CARDS ***
Notatur: folds 
sniegs99: folds 
arissanel: checks 
SERGEY015: folds 
YuYuYu777: folds 
Kalmar333: checks 
*** FLOP *** [Ad 5h 2c]
Kalmar333: checks 
arissanel: checks 
*** TURN *** [Ad 5h 2c] [Ac]
Kalmar333: checks 
arissanel: checks 
*** RIVER *** [Ad 5h 2c Ac] [4d]
Kalmar333: checks 
arissanel: checks 
*** SHOW DOWN ***
Kalmar333: shows [Kc 9h] (a pair of Aces)
arissanel: shows [4s 7d] (two pair, Aces and Fours)
arissanel collected $0.24 from pot
*** SUMMARY ***
Total pot $0.25 | Rake $0.01 
Board [Ad 5h 2c Ac 4d]
Seat 1: arissanel showed [4s 7d] and won ($0.24) with two pair, Aces and Fours
Seat 2: SERGEY015 (button) folded before Flop (didn't bet)
Seat 3: YuYuYu777 (small blind) folded before Flop
Seat 4: Kalmar333 (big blind) showed [Kc 9h] and lost with a pair of Aces
Seat 5: Notatur folded before Flop (didn't bet)
Seat 6: sniegs99 folded before Flop (didn't bet)



PokerStars Hand #222952763369:  Hold'em No Limit ($0.05/$0.10 USD) - 2021/01/23 7:59:48 ET
Table 'Lutetia III' 6-max Seat #3 is the button
Seat 1: arissanel ($10.14 in chips) 
Seat 2: SERGEY015 ($12.59 in chips) 
Seat 3: YuYuYu777 ($9.85 in chips) 
Seat 4: Kalmar333 ($8.86 in chips) 
Seat 5: Notatur ($10.28 in chips) 
Seat 6: sniegs99 ($10.28 in chips) 
Kalmar333: posts small blind $0.05
Notatur: posts big blind $0.10
*** HOLE CARDS ***
sniegs99: folds 
arissanel: folds 
SERGEY015: raises $0.20 to $0.30
YuYuYu777: folds 
Kalmar333: folds 
Notatur: folds 
Uncalled bet ($0.20) returned to SERGEY015
SERGEY015 collected $0.25 from pot
SERGEY015: doesn't show hand 
*** SUMMARY ***
Total pot $0.25 | Rake $0 
Seat 1: arissanel folded before Flop (didn't bet)
Seat 2: SERGEY015 collected ($0.25)
Seat 3: YuYuYu777 (button) folded before Flop (didn't bet)
Seat 4: Kalmar333 (small blind) folded before Flop
Seat 5: Notatur (big blind) folded before Flop
Seat 6: sniegs99 folded before Flop (didn't bet)



PokerStars Hand #222952769059:  Hold'em No Limit ($0.05/$0.10 USD) - 2021/01/23 8:00:05 ET
Table 'Lutetia III' 6-max Seat #4 is the button
Seat 1: arissanel ($10.14 in chips) 
Seat 2: SERGEY015 ($12.74 in chips) 
Seat 3: YuYuYu777 ($9.85 in chips) 
Seat 4: Kalmar333 ($8.81 in chips) 
Seat 5: Notatur ($10.18 in chips) 
Seat 6: sniegs99 ($10.28 in chips) 
Notatur: posts small blind $0.05
sniegs99: posts big blind $0.10
*** HOLE CARDS ***
arissanel: folds 
SERGEY015: folds 
YuYuYu777: folds 
Kalmar333: folds 
Notatur: folds 
Uncalled bet ($0.05) returned to sniegs99
sniegs99 collected $0.10 from pot
sniegs99: doesn't show hand 
*** SUMMARY ***
Total pot $0.10 | Rake $0 
Seat 1: arissanel folded before Flop (didn't bet)
Seat 2: SERGEY015 folded before Flop (didn't bet)
Seat 3: YuYuYu777 folded before Flop (didn't bet)
Seat 4: Kalmar333 (button) folded before Flop (didn't bet)
Seat 5: Notatur (small blind) folded before Flop
Seat 6: sniegs99 (big blind) collected ($0.10)



PokerStars Hand #222952772660:  Hold'em No Limit ($0.05/$0.10 USD) - 2021/01/23 8:00:15 ET
Table 'Lutetia III' 6-max Seat #5 is the button
Seat 1: arissanel ($10.14 in chips) 
Seat 2: SERGEY015 ($12.74 in chips) 
Seat 3: YuYuYu777 ($9.85 in chips) 
Seat 4: Kalmar333 ($8.81 in chips) 
Seat 5: Notatur ($10.13 in chips) 
Seat 6: sniegs99 ($10.33 in chips) 
sniegs99: posts small blind $0.05
arissanel: posts big blind $0.10
*** HOLE CARDS ***
SERGEY015: folds 
YuYuYu777: raises $0.20 to $0.30
Kalmar333: folds 
Notatur: calls $0.30
sniegs99: folds 
arissanel: folds 
*** FLOP *** [7c Tc 3d]
YuYuYu777: bets $0.36
Notatur: calls $0.36
*** TURN *** [7c Tc 3d] [Ks]
YuYuYu777: checks 
Notatur: checks 
*** RIVER *** [7c Tc 3d Ks] [Jc]
YuYuYu777: bets $1.40
Notatur: folds 
Uncalled bet ($1.40) returned to YuYuYu777
YuYuYu777 collected $1.40 from pot
YuYuYu777: doesn't show hand 
*** SUMMARY ***
Total pot $1.47 | Rake $0.07 
Board [7c Tc 3d Ks Jc]
Seat 1: arissanel (big blind) folded before Flop
Seat 2: SERGEY015 folded before Flop (didn't bet)
Seat 3: YuYuYu777 collected ($1.40)
Seat 4: Kalmar333 folded before Flop (didn't bet)
Seat 5: Notatur (button) folded on the River
Seat 6: sniegs99 (small blind) folded before Flop



PokerStars Hand #222952783800:  Hold'em No Limit ($0.05/$0.10 USD) - 2021/01/23 8:00:48 ET
Table 'Lutetia III' 6-max Seat #6 is the button
Seat 1: arissanel ($10.04 in chips) 
Seat 2: SERGEY015 ($12.74 in chips) 
Seat 3: YuYuYu777 ($10.59 in chips) 
Seat 4: Kalmar333 ($10 in chips) 
Seat 5: Notatur ($10 in chips) 
Seat 6: sniegs99 ($10.28 in chips) 
arissanel: posts small blind $0.05
SERGEY015: posts big blind $0.10
*** HOLE CARDS ***
YuYuYu777: folds 
Kalmar333: folds 
Notatur: raises $0.15 to $0.25
sniegs99: folds 
arissanel: folds 
SERGEY015: calls $0.15
*** FLOP *** [Ac 4h Jc]
SERGEY015: checks 
Notatur: bets $0.20
SERGEY015: folds 
Uncalled bet ($0.20) returned to Notatur
Notatur collected $0.53 from pot
Notatur: doesn't show hand 
*** SUMMARY ***
Total pot $0.55 | Rake $0.02 
Board [Ac 4h Jc]
Seat 1: arissanel (small blind) folded before Flop
Seat 2: SERGEY015 (big blind) folded on the Flop
Seat 3: YuYuYu777 folded before Flop (didn't bet)
Seat 4: Kalmar333 folded before Flop (didn't bet)
Seat 5: Notatur collected ($0.53)
Seat 6: sniegs99 (button) folded before Flop (didn't bet)



PokerStars Hand #222952796404:  Hold'em No Limit ($0.05/$0.10 USD) - 2021/01/23 8:01:22 ET
Table 'Lutetia III' 6-max Seat #1 is the button
Seat 1: arissanel ($10 in chips) 
Seat 2: SERGEY015 ($12.49 in chips) 
Seat 3: YuYuYu777 ($10.59 in chips) 
Seat 4: Kalmar333 ($10 in chips) 
Seat 5: Notatur ($10.28 in chips) 
Seat 6: sniegs99 ($10.28 in chips) 
SERGEY015: posts small blind $0.05
YuYuYu777: posts big blind $0.10
*** HOLE CARDS ***
Kalmar333: folds 
Notatur: folds 
sniegs99: folds 
arissanel: raises $0.15 to $0.25
SERGEY015: raises $0.55 to $0.80
YuYuYu777: folds 
arissanel: calls $0.55
*** FLOP *** [3c 7s 7d]
SERGEY015: bets $0.83
arissanel: folds 
Uncalled bet ($0.83) returned to SERGEY015
SERGEY015 collected $1.62 from pot
SERGEY015: doesn't show hand 
*** SUMMARY ***
Total pot $1.70 | Rake $0.08 
Board [3c 7s 7d]
Seat 1: arissanel (button) folded on the Flop
Seat 2: SERGEY015 (small blind) collected ($1.62)
Seat 3: YuYuYu777 (big blind) folded before Flop
Seat 4: Kalmar333 folded before Flop (didn't bet)
Seat 5: Notatur folded before Flop (didn't bet)
Seat 6: sniegs99 folded before Flop (didn't bet)



PokerStars Hand #222952811000:  Hold'em No Limit ($0.05/$0.10 USD) - 2021/01/23 8:02:00 ET
Table 'Lutetia III' 6-max Seat #2 is the button
Seat 1: arissanel ($10 in chips) 
Seat 2: SERGEY015 ($13.31 in chips) 
Seat 3: YuYuYu777 ($10.49 in chips) 
Seat 4: Kalmar333 ($10 in chips) 
Seat 5: Notatur ($10.28 in chips) 
Seat 6: sniegs99 ($10.28 in chips) 
YuYuYu777: posts small blind $0.05
Kalmar333: posts big blind $0.10
*** HOLE CARDS ***
Notatur: folds 
sniegs99: folds 
arissanel: folds 
SERGEY015: folds 
YuYuYu777: raises $0.20 to $0.30
Kalmar333: folds 
Uncalled bet ($0.20) returned to YuYuYu777
YuYuYu777 collected $0.20 from pot
YuYuYu777: doesn't show hand 
*** SUMMARY ***
Total pot $0.20 | Rake $0 
Seat 1: arissanel folded before Flop (didn't bet)
Seat 2: SERGEY015 (button) folded before Flop (didn't bet)
Seat 3: YuYuYu777 (small blind) collected ($0.20)
Seat 4: Kalmar333 (big blind) folded before Flop
Seat 5: Notatur folded before Flop (didn't bet)
Seat 6: sniegs99 folded before Flop (didn't bet)



PokerStars Hand #222952823186:  Hold'em No Limit ($0.05/$0.10 USD) - 2021/01/23 8:02:19 ET
Table 'Lutetia III' 6-max Seat #3 is the button
Seat 1: arissanel ($10 in chips) 
Seat 2: SERGEY015 ($13.31 in chips) 
Seat 3: YuYuYu777 ($10.59 in chips) 
Seat 4: Kalmar333 ($9.90 in chips) 
Seat 5: Notatur ($10.28 in chips) 
Seat 6: sniegs99 ($10.28 in chips) 
Kalmar333: posts small blind $0.05
Notatur: posts big blind $0.10
*** HOLE CARDS ***
sniegs99 has timed out
sniegs99: folds 
arissanel: folds 
SERGEY015: folds 
YuYuYu777: folds 
Kalmar333: folds 
Uncalled bet ($0.05) returned to Notatur
Notatur collected $0.10 from pot
Notatur: doesn't show hand 
*** SUMMARY ***
Total pot $0.10 | Rake $0 
Seat 1: arissanel folded before Flop (didn't bet)
Seat 2: SERGEY015 folded before Flop (didn't bet)
Seat 3: YuYuYu777 (button) folded before Flop (didn't bet)
Seat 4: Kalmar333 (small blind) folded before Flop
Seat 5: Notatur (big blind) collected ($0.10)
Seat 6: sniegs99 folded before Flop (didn't bet)



PokerStars Hand #222952832744:  Hold'em No Limit ($0.05/$0.10 USD) - 2021/01/23 8:02:44 ET
Table 'Lutetia III' 6-max Seat #4 is the button
Seat 1: arissanel ($10 in chips) 
Seat 2: SERGEY015 ($13.31 in chips) 
Seat 3: YuYuYu777 ($10.59 in chips) 
Seat 4: Kalmar333 ($9.85 in chips) 
Seat 5: Notatur ($10.33 in chips) 
Seat 6: sniegs99 ($10.28 in chips) 
Notatur: posts small blind $0.05
sniegs99: posts big blind $0.10
*** HOLE CARDS ***
arissanel: folds 
SERGEY015: raises $0.20 to $0.30
YuYuYu777: calls $0.30
Kalmar333: folds 
Notatur: folds 
sniegs99: folds 
*** FLOP *** [7h 5d Kh]
SERGEY015: checks 
YuYuYu777: bets $0.72
SERGEY015: folds 
Uncalled bet ($0.72) returned to YuYuYu777
YuYuYu777 collected $0.72 from pot
YuYuYu777: doesn't show hand 
*** SUMMARY ***
Total pot $0.75 | Rake $0.03 
Board [7h 5d Kh]
Seat 1: arissanel folded before Flop (didn't bet)
Seat 2: SERGEY015 folded on the Flop
Seat 3: YuYuYu777 collected ($0.72)
Seat 4: Kalmar333 (button) folded before Flop (didn't bet)
Seat 5: Notatur (small blind) folded before Flop
Seat 6: sniegs99 (big blind) folded before Flop



PokerStars Hand #222952843162:  Hold'em No Limit ($0.05/$0.10 USD) - 2021/01/23 8:03:10 ET
Table 'Lutetia III' 6-max Seat #5 is the button
Seat 1: arissanel ($10 in chips) 
Seat 2: SERGEY015 ($13.01 in chips) 
Seat 3: YuYuYu777 ($11.01 in chips) 
Seat 4: Kalmar333 ($9.85 in chips) 
Seat 5: Notatur ($10.28 in chips) 
Seat 6: sniegs99 ($10.18 in chips) 
sniegs99: posts small blind $0.05
arissanel: posts big blind $0.10
*** HOLE CARDS ***
SERGEY015: folds 
YuYuYu777: folds 
Kalmar333: folds 
Notatur: folds 
sniegs99: folds 
Uncalled bet ($0.05) returned to arissanel
arissanel collected $0.10 from pot
*** SUMMARY ***
Total pot $0.10 | Rake $0 
Seat 1: arissanel (big blind) collected ($0.10)
Seat 2: SERGEY015 folded before Flop (didn't bet)
Seat 3: YuYuYu777 folded before Flop (didn't bet)
Seat 4: Kalmar333 folded before Flop (didn't bet)
Seat 5: Notatur (button) folded before Flop (didn't bet)
Seat 6: sniegs99 (small blind) folded before Flop



PokerStars Hand #222952850097:  Hold'em No Limit ($0.05/$0.10 USD) - 2021/01/23 8:03:28 ET
Table 'Lutetia III' 6-max Seat #6 is the button
Seat 1: arissanel ($10.05 in chips) 
Seat 2: SERGEY015 ($13.01 in chips) 
Seat 3: YuYuYu777 ($11.01 in chips) 
Seat 4: Kalmar333 ($9.85 in chips) 
Seat 5: Notatur ($10.28 in chips) 
Seat 6: sniegs99 ($10.13 in chips) 
arissanel: posts small blind $0.05
SERGEY015: posts big blind $0.10
*** HOLE CARDS ***
YuYuYu777: folds 
Kalmar333: folds 
Notatur: raises $0.15 to $0.25
sniegs99: folds 
arissanel: folds 
SERGEY015: calls $0.15
*** FLOP *** [9s Th Jd]
SERGEY015: checks 
Notatur: checks 
*** TURN *** [9s Th Jd] [2s]
SERGEY015: checks 
Notatur: checks 
*** RIVER *** [9s Th Jd 2s] [6c]
SERGEY015: checks 
Notatur: checks 
*** SHOW DOWN ***
SERGEY015: shows [9c As] (a pair of Nines)
Notatur: mucks hand 
SERGEY015 collected $0.53 from pot
*** SUMMARY ***
Total pot $0.55 | Rake $0.02 
Board [9s Th Jd 2s 6c]
Seat 1: arissanel (small blind) folded before Flop
Seat 2: SERGEY015 (big blind) showed [9c As] and won ($0.53) with a pair of Nines
Seat 3: YuYuYu777 folded before Flop (didn't bet)
Seat 4: Kalmar333 folded before Flop (didn't bet)
Seat 5: Notatur mucked
Seat 6: sniegs99 (button) folded before Flop (didn't bet)



PokerStars Hand #222952866499:  Hold'em No Limit ($0.05/$0.10 USD) - 2021/01/23 8:04:08 ET
Table 'Lutetia III' 6-max Seat #1 is the button
Seat 1: arissanel ($10 in chips) 
Seat 2: SERGEY015 ($13.29 in chips) 
Seat 3: YuYuYu777 ($11.01 in chips) 
Seat 4: Kalmar333 ($9.85 in chips) 
Seat 5: Notatur ($10.03 in chips) 
Seat 6: sniegs99 ($10.13 in chips) 
SERGEY015: posts small blind $0.05
YuYuYu777: posts big blind $0.10
*** HOLE CARDS ***
Kalmar333: folds 
Notatur: folds 
sniegs99: folds 
arissanel: folds 
SERGEY015: folds 
Uncalled bet ($0.05) returned to YuYuYu777
YuYuYu777 collected $0.10 from pot
YuYuYu777: doesn't show hand 
*** SUMMARY ***
Total pot $0.10 | Rake $0 
Seat 1: arissanel (button) folded before Flop (didn't bet)
Seat 2: SERGEY015 (small blind) folded before Flop
Seat 3: YuYuYu777 (big blind) collected ($0.10)
Seat 4: Kalmar333 folded before Flop (didn't bet)
Seat 5: Notatur folded before Flop (didn't bet)
Seat 6: sniegs99 folded before Flop (didn't bet)



PokerStars Hand #222952871302:  Hold'em No Limit ($0.05/$0.10 USD) - 2021/01/23 8:04:20 ET
Table 'Lutetia III' 6-max Seat #2 is the button
Seat 1: arissanel ($10 in chips) 
Seat 2: SERGEY015 ($13.24 in chips) 
Seat 3: YuYuYu777 ($11.06 in chips) 
Seat 4: Kalmar333 ($9.85 in chips) 
Seat 5: Notatur ($10.03 in chips) 
Seat 6: sniegs99 ($10.13 in chips) 
YuYuYu777: posts small blind $0.05
Kalmar333: posts big blind $0.10
*** HOLE CARDS ***
Notatur: folds 
sniegs99: raises $0.15 to $0.25
arissanel: folds 
SERGEY015: folds 
YuYuYu777: folds 
Kalmar333: folds 
Uncalled bet ($0.15) returned to sniegs99
sniegs99 collected $0.25 from pot
sniegs99: doesn't show hand 
*** SUMMARY ***
Total pot $0.25 | Rake $0 
Seat 1: arissanel folded before Flop (didn't bet)
Seat 2: SERGEY015 (button) folded before Flop (didn't bet)
Seat 3: YuYuYu777 (small blind) folded before Flop
Seat 4: Kalmar333 (big blind) folded before Flop
Seat 5: Notatur folded before Flop (didn't bet)
Seat 6: sniegs99 collected ($0.25)



PokerStars Hand #222952879046:  Hold'em No Limit ($0.05/$0.10 USD) - 2021/01/23 8:04:40 ET
Table 'Lutetia III' 6-max Seat #3 is the button
Seat 1: arissanel ($10 in chips) 
Seat 2: SERGEY015 ($13.24 in chips) 
Seat 3: YuYuYu777 ($11.01 in chips) 
Seat 4: Kalmar333 ($9.75 in chips) 
Seat 5: Notatur ($10.03 in chips) 
Seat 6: sniegs99 ($10.28 in chips) 
Kalmar333: posts small blind $0.05
Notatur: posts big blind $0.10
*** HOLE CARDS ***
sniegs99: folds 
arissanel: folds 
SERGEY015: folds 
YuYuYu777: folds 
Kalmar333: raises $0.20 to $0.30
Notatur: folds 
Uncalled bet ($0.20) returned to Kalmar333
Kalmar333 collected $0.20 from pot
Kalmar333: doesn't show hand 
*** SUMMARY ***
Total pot $0.20 | Rake $0 
Seat 1: arissanel folded before Flop (didn't bet)
Seat 2: SERGEY015 folded before Flop (didn't bet)
Seat 3: YuYuYu777 (button) folded before Flop (didn't bet)
Seat 4: Kalmar333 (small blind) collected ($0.20)
Seat 5: Notatur (big blind) folded before Flop
Seat 6: sniegs99 folded before Flop (didn't bet)



PokerStars Hand #222952887908:  Hold'em No Limit ($0.05/$0.10 USD) - 2021/01/23 8:05:02 ET
Table 'Lutetia III' 6-max Seat #4 is the button
Seat 1: arissanel ($10 in chips) 
Seat 2: SERGEY015 ($13.24 in chips) 
Seat 3: YuYuYu777 ($11.01 in chips) 
Seat 4: Kalmar333 ($9.85 in chips) 
Seat 5: Notatur ($10 in chips) 
Seat 6: sniegs99 ($10.28 in chips) 
Notatur: posts small blind $0.05
sniegs99: posts big blind $0.10
*** HOLE CARDS ***
arissanel: folds 
SERGEY015: folds 
YuYuYu777: folds 
Kalmar333: raises $0.20 to $0.30
Notatur: calls $0.25
sniegs99: folds 
*** FLOP *** [4d Tc 4h]
Notatur: checks 
Kalmar333: bets $0.30
Notatur: calls $0.30
*** TURN *** [4d Tc 4h] [Kh]
Notatur: checks 
Kalmar333: bets $0.87
Notatur: folds 
Uncalled bet ($0.87) returned to Kalmar333
Kalmar333 collected $1.24 from pot
Kalmar333: doesn't show hand 
*** SUMMARY ***
Total pot $1.30 | Rake $0.06 
Board [4d Tc 4h Kh]
Seat 1: arissanel folded before Flop (didn't bet)
Seat 2: SERGEY015 folded before Flop (didn't bet)
Seat 3: YuYuYu777 folded before Flop (didn't bet)
Seat 4: Kalmar333 (button) collected ($1.24)
Seat 5: Notatur (small blind) folded on the Turn
Seat 6: sniegs99 (big blind) folded before Flop



PokerStars Hand #222952903979:  Hold'em No Limit ($0.05/$0.10 USD) - 2021/01/23 8:05:42 ET
Table 'Lutetia III' 6-max Seat #5 is the button
Seat 1: arissanel ($10 in chips) 
Seat 2: SERGEY015 ($13.24 in chips) 
Seat 3: YuYuYu777 ($11.01 in chips) 
Seat 4: Kalmar333 ($10.49 in chips) 
Seat 5: Notatur ($10 in chips) 
Seat 6: sniegs99 ($10.18 in chips) 
sniegs99: posts small blind $0.05
arissanel: posts big blind $0.10
*** HOLE CARDS ***
SERGEY015 has timed out
SERGEY015: folds 
YuYuYu777: folds 
Kalmar333: folds 
Notatur: folds 
sniegs99: folds 
Uncalled bet ($0.05) returned to arissanel
arissanel collected $0.10 from pot
*** SUMMARY ***
Total pot $0.10 | Rake $0 
Seat 1: arissanel (big blind) collected ($0.10)
Seat 2: SERGEY015 folded before Flop (didn't bet)
Seat 3: YuYuYu777 folded before Flop (didn't bet)
Seat 4: Kalmar333 folded before Flop (didn't bet)
Seat 5: Notatur (button) folded before Flop (didn't bet)
Seat 6: sniegs99 (small blind) folded before Flop



PokerStars Hand #222952912546:  Hold'em No Limit ($0.05/$0.10 USD) - 2021/01/23 8:06:03 ET
Table 'Lutetia III' 6-max Seat #6 is the button
Seat 1: arissanel ($10.05 in chips) 
Seat 2: SERGEY015 ($13.24 in chips) 
Seat 3: YuYuYu777 ($11.01 in chips) 
Seat 4: Kalmar333 ($10.49 in chips) 
Seat 5: Notatur ($10 in chips) 
Seat 6: sniegs99 ($10.13 in chips) 
arissanel: posts small blind $0.05
SERGEY015: posts big blind $0.10
*** HOLE CARDS ***
YuYuYu777: folds 
Kalmar333: folds 
Notatur: raises $0.15 to $0.25
sniegs99: folds 
arissanel: folds 
SERGEY015: raises $0.65 to $0.90
Notatur: folds 
Uncalled bet ($0.65) returned to SERGEY015
SERGEY015 collected $0.55 from pot
SERGEY015: doesn't show hand 
*** SUMMARY ***
Total pot $0.55 | Rake $0 
Seat 1: arissanel (small blind) folded before Flop
Seat 2: SERGEY015 (big blind) collected ($0.55)
Seat 3: YuYuYu777 folded before Flop (didn't bet)
Seat 4: Kalmar333 folded before Flop (didn't bet)
Seat 5: Notatur folded before Flop
Seat 6: sniegs99 (button) folded before Flop (didn't bet)



PokerStars Hand #222952921691:  Hold'em No Limit ($0.05/$0.10 USD) - 2021/01/23 8:06:26 ET
Table 'Lutetia III' 6-max Seat #1 is the button
Seat 1: arissanel ($10 in chips) 
Seat 2: SERGEY015 ($13.54 in chips) 
Seat 3: YuYuYu777 ($11.01 in chips) 
Seat 4: Kalmar333 ($10.49 in chips) 
Seat 5: Notatur ($10 in chips) 
Seat 6: sniegs99 ($10.13 in chips) 
SERGEY015: posts small blind $0.05
YuYuYu777: posts big blind $0.10
*** HOLE CARDS ***
Kalmar333: folds 
Notatur: folds 
sniegs99: folds 
arissanel: folds 
SERGEY015: raises $0.20 to $0.30
YuYuYu777: calls $0.20
*** FLOP *** [Kc Qc 9s]
SERGEY015: checks 
YuYuYu777: checks 
*** TURN *** [Kc Qc 9s] [8c]
SERGEY015: checks 
YuYuYu777: bets $0.29
SERGEY015: folds 
Uncalled bet ($0.29) returned to YuYuYu777
YuYuYu777 collected $0.57 from pot
YuYuYu777: doesn't show hand 
*** SUMMARY ***
Total pot $0.60 | Rake $0.03 
Board [Kc Qc 9s 8c]
Seat 1: arissanel (button) folded before Flop (didn't bet)
Seat 2: SERGEY015 (small blind) folded on the Turn
Seat 3: YuYuYu777 (big blind) collected ($0.57)
Seat 4: Kalmar333 folded before Flop (didn't bet)
Seat 5: Notatur folded before Flop (didn't bet)
Seat 6: sniegs99 folded before Flop (didn't bet)



PokerStars Hand #222952934352:  Hold'em No Limit ($0.05/$0.10 USD) - 2021/01/23 8:06:57 ET
Table 'Lutetia III' 6-max Seat #2 is the button
Seat 1: arissanel ($10 in chips) 
Seat 2: SERGEY015 ($13.24 in chips) 
Seat 3: YuYuYu777 ($11.28 in chips) 
Seat 4: Kalmar333 ($10.49 in chips) 
Seat 5: Notatur ($10 in chips) 
Seat 6: sniegs99 ($10.13 in chips) 
YuYuYu777: posts small blind $0.05
Kalmar333: posts big blind $0.10
*** HOLE CARDS ***
Notatur: folds 
sniegs99: folds 
arissanel: folds 
SERGEY015: raises $0.20 to $0.30
YuYuYu777: folds 
Kalmar333: calls $0.20
*** FLOP *** [Ac 6h 6d]
Kalmar333: checks 
SERGEY015: checks 
*** TURN *** [Ac 6h 6d] [6c]
Kalmar333: checks 
SERGEY015: bets $0.20
Kalmar333: folds 
Uncalled bet ($0.20) returned to SERGEY015
SERGEY015 collected $0.62 from pot
SERGEY015: doesn't show hand 
*** SUMMARY ***
Total pot $0.65 | Rake $0.03 
Board [Ac 6h 6d 6c]
Seat 1: arissanel folded before Flop (didn't bet)
Seat 2: SERGEY015 (button) collected ($0.62)
Seat 3: YuYuYu777 (small blind) folded before Flop
Seat 4: Kalmar333 (big blind) folded on the Turn
Seat 5: Notatur folded before Flop (didn't bet)
Seat 6: sniegs99 folded before Flop (didn't bet)



PokerStars Hand #222952951278:  Hold'em No Limit ($0.05/$0.10 USD) - 2021/01/23 8:07:39 ET
Table 'Lutetia III' 6-max Seat #3 is the button
Seat 1: arissanel ($10 in chips) 
Seat 2: SERGEY015 ($13.56 in chips) 
Seat 3: YuYuYu777 ($11.23 in chips) 
Seat 4: Kalmar333 ($10.19 in chips) 
Seat 5: Notatur ($10 in chips) 
Seat 6: sniegs99 ($10.13 in chips) 
Kalmar333: posts small blind $0.05
Notatur: posts big blind $0.10
*** HOLE CARDS ***
sniegs99: raises $0.15 to $0.25
arissanel: folds 
SERGEY015: folds 
YuYuYu777: folds 
Kalmar333: folds 
Notatur: folds 
Uncalled bet ($0.15) returned to sniegs99
sniegs99 collected $0.25 from pot
sniegs99: doesn't show hand 
*** SUMMARY ***
Total pot $0.25 | Rake $0 
Seat 1: arissanel folded before Flop (didn't bet)
Seat 2: SERGEY015 folded before Flop (didn't bet)
Seat 3: YuYuYu777 (button) folded before Flop (didn't bet)
Seat 4: Kalmar333 (small blind) folded before Flop
Seat 5: Notatur (big blind) folded before Flop
Seat 6: sniegs99 collected ($0.25)



PokerStars Hand #222952958262:  Hold'em No Limit ($0.05/$0.10 USD) - 2021/01/23 8:07:56 ET
Table 'Lutetia III' 6-max Seat #4 is the button
Seat 1: arissanel ($10 in chips) 
Seat 2: SERGEY015 ($13.56 in chips) 
Seat 3: YuYuYu777 ($11.23 in chips) 
Seat 4: Kalmar333 ($10.14 in chips) 
Seat 5: Notatur ($10 in chips) 
Seat 6: sniegs99 ($10.28 in chips) 
Notatur: posts small blind $0.05
sniegs99: posts big blind $0.10
*** HOLE CARDS ***
arissanel: raises $0.15 to $0.25
SERGEY015: folds 
YuYuYu777: calls $0.25
Kalmar333: folds 
Notatur: folds 
sniegs99: folds 
*** FLOP *** [Kd 6s 2c]
arissanel: bets $0.20
YuYuYu777: folds 
Uncalled bet ($0.20) returned to arissanel
arissanel collected $0.62 from pot
*** SUMMARY ***
Total pot $0.65 | Rake $0.03 
Board [Kd 6s 2c]
Seat 1: arissanel collected ($0.62)
Seat 2: SERGEY015 folded before Flop (didn't bet)
Seat 3: YuYuYu777 folded on the Flop
Seat 4: Kalmar333 (button) folded before Flop (didn't bet)
Seat 5: Notatur (small blind) folded before Flop
Seat 6: sniegs99 (big blind) folded before Flop



PokerStars Hand #222952969781:  Hold'em No Limit ($0.05/$0.10 USD) - 2021/01/23 8:08:24 ET
Table 'Lutetia III' 6-max Seat #5 is the button
Seat 1: arissanel ($10.37 in chips) 
Seat 2: SERGEY015 ($13.56 in chips) 
Seat 3: YuYuYu777 ($10.98 in chips) 
Seat 4: Kalmar333 ($10.14 in chips) 
Seat 5: Notatur ($10 in chips) 
Seat 6: sniegs99 ($10.18 in chips) 
sniegs99: posts small blind $0.05
arissanel: posts big blind $0.10
*** HOLE CARDS ***
SERGEY015: folds 
YuYuYu777: folds 
Kalmar333: folds 
Notatur: folds 
sniegs99: folds 
Uncalled bet ($0.05) returned to arissanel
arissanel collected $0.10 from pot
*** SUMMARY ***
Total pot $0.10 | Rake $0 
Seat 1: arissanel (big blind) collected ($0.10)
Seat 2: SERGEY015 folded before Flop (didn't bet)
Seat 3: YuYuYu777 folded before Flop (didn't bet)
Seat 4: Kalmar333 folded before Flop (didn't bet)
Seat 5: Notatur (button) folded before Flop (didn't bet)
Seat 6: sniegs99 (small blind) folded before Flop



PokerStars Hand #222952974090:  Hold'em No Limit ($0.05/$0.10 USD) - 2021/01/23 8:08:35 ET
Table 'Lutetia III' 6-max Seat #6 is the button
Seat 1: arissanel ($10.42 in chips) 
Seat 2: SERGEY015 ($13.56 in chips) 
Seat 3: YuYuYu777 ($10.98 in chips) 
Seat 4: Kalmar333 ($10.14 in chips) 
Seat 5: Notatur ($10 in chips) 
Seat 6: sniegs99 ($10.13 in chips) 
arissanel: posts small blind $0.05
SERGEY015: posts big blind $0.10
*** HOLE CARDS ***
YuYuYu777: folds 
Kalmar333: raises $0.20 to $0.30
Notatur: folds 
sniegs99: folds 
arissanel: folds 
SERGEY015: folds 
Uncalled bet ($0.20) returned to Kalmar333
Kalmar333 collected $0.25 from pot
Kalmar333: doesn't show hand 
*** SUMMARY ***
Total pot $0.25 | Rake $0 
Seat 1: arissanel (small blind) folded before Flop
Seat 2: SERGEY015 (big blind) folded before Flop
Seat 3: YuYuYu777 folded before Flop (didn't bet)
Seat 4: Kalmar333 collected ($0.25)
Seat 5: Notatur folded before Flop (didn't bet)
Seat 6: sniegs99 (button) folded before Flop (didn't bet)



PokerStars Hand #222952980905:  Hold'em No Limit ($0.05/$0.10 USD) - 2021/01/23 8:08:52 ET
Table 'Lutetia III' 6-max Seat #1 is the button
Seat 1: arissanel ($10.37 in chips) 
Seat 2: SERGEY015 ($13.46 in chips) 
Seat 3: YuYuYu777 ($10.98 in chips) 
Seat 4: Kalmar333 ($10.29 in chips) 
Seat 5: Notatur ($10 in chips) 
Seat 6: sniegs99 ($10.13 in chips) 
SERGEY015: posts small blind $0.05
YuYuYu777: posts big blind $0.10
*** HOLE CARDS ***
Kalmar333: folds 
Notatur: folds 
sniegs99: folds 
arissanel: raises $0.15 to $0.25
SERGEY015: folds 
YuYuYu777: folds 
Uncalled bet ($0.15) returned to arissanel
arissanel collected $0.25 from pot
*** SUMMARY ***
Total pot $0.25 | Rake $0 
Seat 1: arissanel (button) collected ($0.25)
Seat 2: SERGEY015 (small blind) folded before Flop
Seat 3: YuYuYu777 (big blind) folded before Flop
Seat 4: Kalmar333 folded before Flop (didn't bet)
Seat 5: Notatur folded before Flop (didn't bet)
Seat 6: sniegs99 folded before Flop (didn't bet)



PokerStars Hand #222952987058:  Hold'em No Limit ($0.05/$0.10 USD) - 2021/01/23 8:09:07 ET
Table 'Lutetia III' 6-max Seat #2 is the button
Seat 1: arissanel ($10.52 in chips) 
Seat 2: SERGEY015 ($13.41 in chips) 
Seat 3: YuYuYu777 ($10.88 in chips) 
Seat 4: Kalmar333 ($10.29 in chips) 
Seat 5: Notatur ($10 in chips) 
Seat 6: sniegs99 ($10.13 in chips) 
YuYuYu777: posts small blind $0.05
Kalmar333: posts big blind $0.10
*** HOLE CARDS ***
Notatur: folds 
sniegs99: folds 
arissanel: raises $0.15 to $0.25
SERGEY015: folds 
YuYuYu777: folds 
Kalmar333: folds 
Uncalled bet ($0.15) returned to arissanel
arissanel collected $0.25 from pot
*** SUMMARY ***
Total pot $0.25 | Rake $0 
Seat 1: arissanel collected ($0.25)
Seat 2: SERGEY015 (button) folded before Flop (didn't bet)
Seat 3: YuYuYu777 (small blind) folded before Flop
Seat 4: Kalmar333 (big blind) folded before Flop
Seat 5: Notatur folded before Flop (didn't bet)
Seat 6: sniegs99 folded before Flop (didn't bet)



PokerStars Hand #222952991520:  Hold'em No Limit ($0.05/$0.10 USD) - 2021/01/23 8:09:18 ET
Table 'Lutetia III' 6-max Seat #3 is the button
Seat 1: arissanel ($10.67 in chips) 
Seat 2: SERGEY015 ($13.41 in chips) 
Seat 3: YuYuYu777 ($10.83 in chips) 
Seat 4: Kalmar333 ($10.19 in chips) 
Seat 5: Notatur ($10 in chips) 
Seat 6: sniegs99 ($10.13 in chips) 
Kalmar333: posts small blind $0.05
Notatur: posts big blind $0.10
*** HOLE CARDS ***
sniegs99: folds 
arissanel: folds 
SERGEY015: folds 
YuYuYu777: folds 
Kalmar333: folds 
Uncalled bet ($0.05) returned to Notatur
Notatur collected $0.10 from pot
Notatur: doesn't show hand 
*** SUMMARY ***
Total pot $0.10 | Rake $0 
Seat 1: arissanel folded before Flop (didn't bet)
Seat 2: SERGEY015 folded before Flop (didn't bet)
Seat 3: YuYuYu777 (button) folded before Flop (didn't bet)
Seat 4: Kalmar333 (small blind) folded before Flop
Seat 5: Notatur (big blind) collected ($0.10)
Seat 6: sniegs99 folded before Flop (didn't bet)



PokerStars Hand #222952994603:  Hold'em No Limit ($0.05/$0.10 USD) - 2021/01/23 8:09:25 ET
Table 'Lutetia III' 6-max Seat #4 is the button
Seat 1: arissanel ($10.67 in chips) 
Seat 2: SERGEY015 ($13.41 in chips) 
Seat 3: YuYuYu777 ($10.83 in chips) 
Seat 4: Kalmar333 ($10.14 in chips) 
Seat 5: Notatur ($10.05 in chips) 
Seat 6: sniegs99 ($10.13 in chips) 
Notatur: posts small blind $0.05
sniegs99: posts big blind $0.10
*** HOLE CARDS ***
arissanel: folds 
SERGEY015: folds 
YuYuYu777: folds 
Kalmar333: folds 
Notatur: folds 
Uncalled bet ($0.05) returned to sniegs99
sniegs99 collected $0.10 from pot
sniegs99: doesn't show hand 
*** SUMMARY ***
Total pot $0.10 | Rake $0 
Seat 1: arissanel folded before Flop (didn't bet)
Seat 2: SERGEY015 folded before Flop (didn't bet)
Seat 3: YuYuYu777 folded before Flop (didn't bet)
Seat 4: Kalmar333 (button) folded before Flop (didn't bet)
Seat 5: Notatur (small blind) folded before Flop
Seat 6: sniegs99 (big blind) collected ($0.10)



PokerStars Hand #222953000356:  Hold'em No Limit ($0.05/$0.10 USD) - 2021/01/23 8:09:39 ET
Table 'Lutetia III' 6-max Seat #5 is the button
Seat 1: arissanel ($10.67 in chips) 
Seat 2: SERGEY015 ($13.41 in chips) 
Seat 3: YuYuYu777 ($10.83 in chips) 
Seat 4: Kalmar333 ($10.14 in chips) 
Seat 5: Notatur ($10 in chips) 
Seat 6: sniegs99 ($10.18 in chips) 
sniegs99: posts small blind $0.05
arissanel: posts big blind $0.10
*** HOLE CARDS ***
SERGEY015: folds 
YuYuYu777: folds 
Kalmar333: folds 
Notatur: folds 
sniegs99: folds 
Uncalled bet ($0.05) returned to arissanel
arissanel collected $0.10 from pot
*** SUMMARY ***
Total pot $0.10 | Rake $0 
Seat 1: arissanel (big blind) collected ($0.10)
Seat 2: SERGEY015 folded before Flop (didn't bet)
Seat 3: YuYuYu777 folded before Flop (didn't bet)
Seat 4: Kalmar333 folded before Flop (didn't bet)
Seat 5: Notatur (button) folded before Flop (didn't bet)
Seat 6: sniegs99 (small blind) folded before Flop



PokerStars Hand #222953007125:  Hold'em No Limit ($0.05/$0.10 USD) - 2021/01/23 8:09:56 ET
Table 'Lutetia III' 6-max Seat #6 is the button
Seat 1: arissanel ($10.72 in chips) 
Seat 2: SERGEY015 ($13.41 in chips) 
Seat 3: YuYuYu777 ($10.83 in chips) 
Seat 4: Kalmar333 ($10.14 in chips) 
Seat 5: Notatur ($10 in chips) 
Seat 6: sniegs99 ($10.13 in chips) 
arissanel: posts small blind $0.05
SERGEY015: posts big blind $0.10
*** HOLE CARDS ***
YuYuYu777: folds 
Kalmar333: folds 
Notatur: folds 
sniegs99: folds 
arissanel: folds 
Uncalled bet ($0.05) returned to SERGEY015
SERGEY015 collected $0.10 from pot
SERGEY015: doesn't show hand 
*** SUMMARY ***
Total pot $0.10 | Rake $0 
Seat 1: arissanel (small blind) folded before Flop
Seat 2: SERGEY015 (big blind) collected ($0.10)
Seat 3: YuYuYu777 folded before Flop (didn't bet)
Seat 4: Kalmar333 folded before Flop (didn't bet)
Seat 5: Notatur folded before Flop (didn't bet)
Seat 6: sniegs99 (button) folded before Flop (didn't bet)



PokerStars Hand #222953012231:  Hold'em No Limit ($0.05/$0.10 USD) - 2021/01/23 8:10:08 ET
Table 'Lutetia III' 6-max Seat #1 is the button
Seat 1: arissanel ($10.67 in chips) 
Seat 2: SERGEY015 ($13.46 in chips) 
Seat 3: YuYuYu777 ($10.83 in chips) 
Seat 4: Kalmar333 ($10.14 in chips) 
Seat 5: Notatur ($10 in chips) 
Seat 6: sniegs99 ($10.13 in chips) 
SERGEY015: posts small blind $0.05
YuYuYu777: posts big blind $0.10
*** HOLE CARDS ***
Kalmar333: folds 
Notatur: folds 
sniegs99: raises $0.15 to $0.25
arissanel: folds 
SERGEY015: raises $0.65 to $0.90
YuYuYu777: folds 
sniegs99: folds 
Uncalled bet ($0.65) returned to SERGEY015
SERGEY015 collected $0.60 from pot
SERGEY015: doesn't show hand 
*** SUMMARY ***
Total pot $0.60 | Rake $0 
Seat 1: arissanel (button) folded before Flop (didn't bet)
Seat 2: SERGEY015 (small blind) collected ($0.60)
Seat 3: YuYuYu777 (big blind) folded before Flop
Seat 4: Kalmar333 folded before Flop (didn't bet)
Seat 5: Notatur folded before Flop (didn't bet)
Seat 6: sniegs99 folded before Flop



PokerStars Hand #222953022907:  Hold'em No Limit ($0.05/$0.10 USD) - 2021/01/23 8:10:34 ET
Table 'Lutetia III' 6-max Seat #2 is the button
Seat 1: arissanel ($10.67 in chips) 
Seat 2: SERGEY015 ($13.81 in chips) 
Seat 3: YuYuYu777 ($10.73 in chips) 
Seat 4: Kalmar333 ($10.14 in chips) 
Seat 5: Notatur ($10 in chips) 
Seat 6: sniegs99 ($9.88 in chips) 
YuYuYu777: posts small blind $0.05
Kalmar333: posts big blind $0.10
*** HOLE CARDS ***
Notatur: folds 
sniegs99: folds 
arissanel has timed out
arissanel: folds 
SERGEY015: folds 
YuYuYu777: folds 
Uncalled bet ($0.05) returned to Kalmar333
Kalmar333 collected $0.10 from pot
Kalmar333: doesn't show hand 
*** SUMMARY ***
Total pot $0.10 | Rake $0 
Seat 1: arissanel folded before Flop (didn't bet)
Seat 2: SERGEY015 (button) folded before Flop (didn't bet)
Seat 3: YuYuYu777 (small blind) folded before Flop
Seat 4: Kalmar333 (big blind) collected ($0.10)
Seat 5: Notatur folded before Flop (didn't bet)
Seat 6: sniegs99 folded before Flop (didn't bet)



PokerStars Hand #222953031003:  Hold'em No Limit ($0.05/$0.10 USD) - 2021/01/23 8:10:54 ET
Table 'Lutetia III' 6-max Seat #3 is the button
Seat 2: SERGEY015 ($13.81 in chips) 
Seat 3: YuYuYu777 ($10.68 in chips) 
Seat 4: Kalmar333 ($10.19 in chips) 
Seat 5: Notatur ($10 in chips) 
Seat 6: sniegs99 ($9.88 in chips) 
Kalmar333: posts small blind $0.05
Notatur: posts big blind $0.10
*** HOLE CARDS ***
sniegs99: folds 
SERGEY015: folds 
YuYuYu777: folds 
Kalmar333: raises $0.20 to $0.30
Notatur: calls $0.20
*** FLOP *** [Th Qh 9d]
Kalmar333: checks 
Notatur: bets $0.31
Kalmar333: folds 
Uncalled bet ($0.31) returned to Notatur
Notatur collected $0.57 from pot
Notatur: doesn't show hand 
*** SUMMARY ***
Total pot $0.60 | Rake $0.03 
Board [Th Qh 9d]
Seat 2: SERGEY015 folded before Flop (didn't bet)
Seat 3: YuYuYu777 (button) folded before Flop (didn't bet)
Seat 4: Kalmar333 (small blind) folded on the Flop
Seat 5: Notatur (big blind) collected ($0.57)
Seat 6: sniegs99 folded before Flop (didn't bet)



PokerStars Hand #222953048966:  Hold'em No Limit ($0.05/$0.10 USD) - 2021/01/23 8:11:39 ET
Table 'Lutetia III' 6-max Seat #4 is the button
Seat 1: arissanel ($10.67 in chips) 
Seat 2: SERGEY015 ($13.81 in chips) 
Seat 3: YuYuYu777 ($10.68 in chips) 
Seat 4: Kalmar333 ($9.89 in chips) 
Seat 5: Notatur ($10.27 in chips) 
Seat 6: sniegs99 ($9.88 in chips) 
Notatur: posts small blind $0.05
sniegs99: posts big blind $0.10
*** HOLE CARDS ***
arissanel: folds 
SERGEY015: folds 
YuYuYu777: folds 
Kalmar333: raises $0.20 to $0.30
Notatur: folds 
sniegs99: folds 
Uncalled bet ($0.20) returned to Kalmar333
Kalmar333 collected $0.25 from pot
Kalmar333: doesn't show hand 
*** SUMMARY ***
Total pot $0.25 | Rake $0 
Seat 1: arissanel folded before Flop (didn't bet)
Seat 2: SERGEY015 folded before Flop (didn't bet)
Seat 3: YuYuYu777 folded before Flop (didn't bet)
Seat 4: Kalmar333 (button) collected ($0.25)
Seat 5: Notatur (small blind) folded before Flop
Seat 6: sniegs99 (big blind) folded before Flop



PokerStars Hand #222953054292:  Hold'em No Limit ($0.05/$0.10 USD) - 2021/01/23 8:11:51 ET
Table 'Lutetia III' 6-max Seat #5 is the button
Seat 1: arissanel ($10.67 in chips) 
Seat 2: SERGEY015 ($13.81 in chips) 
Seat 3: YuYuYu777 ($10.68 in chips) 
Seat 4: Kalmar333 ($10.04 in chips) 
Seat 5: Notatur ($10.22 in chips) 
Seat 6: sniegs99 ($9.78 in chips) 
sniegs99: posts small blind $0.05
arissanel: posts big blind $0.10
*** HOLE CARDS ***
SERGEY015: raises $0.20 to $0.30
YuYuYu777: folds 
Kalmar333: folds 
Notatur: folds 
sniegs99: folds 
arissanel: calls $0.20
*** FLOP *** [6c 9s 9c]
arissanel: checks 
SERGEY015: bets $0.32
sniegs99 leaves the table
Squashy22 joins the table at seat #6 
arissanel: raises $0.58 to $0.90
SERGEY015: calls $0.58
*** TURN *** [6c 9s 9c] [Kh]
arissanel: bets $1.10
SERGEY015: calls $1.10
*** RIVER *** [6c 9s 9c Kh] [Js]
arissanel: bets $3.73
SERGEY015: raises $7.78 to $11.51 and is all-in
arissanel: calls $4.64 and is all-in
Uncalled bet ($3.14) returned to SERGEY015
*** SHOW DOWN ***
SERGEY015: shows [Jd Jc] (a full house, Jacks full of Nines)
arissanel: shows [Kd 9d] (a full house, Nines full of Kings)
SERGEY015 collected $20.43 from pot
*** SUMMARY ***
Total pot $21.39 | Rake $0.96 
Board [6c 9s 9c Kh Js]
Seat 1: arissanel (big blind) showed [Kd 9d] and lost with a full house, Nines full of Kings
Seat 2: SERGEY015 showed [Jd Jc] and won ($20.43) with a full house, Jacks full of Nines
Seat 3: YuYuYu777 folded before Flop (didn't bet)
Seat 4: Kalmar333 folded before Flop (didn't bet)
Seat 5: Notatur (button) folded before Flop (didn't bet)
Seat 6: sniegs99 (small blind) folded before Flop



PokerStars Hand #222953086747:  Hold'em No Limit ($0.05/$0.10 USD) - 2021/01/23 8:13:10 ET
Table 'Lutetia III' 6-max Seat #1 is the button
Seat 1: arissanel ($10 in chips) 
Seat 2: SERGEY015 ($23.57 in chips) 
Seat 3: YuYuYu777 ($10.68 in chips) 
Seat 4: Kalmar333 ($10.04 in chips) 
Seat 5: Notatur ($10.22 in chips) 
SERGEY015: posts small blind $0.05
YuYuYu777: posts big blind $0.10
Squashy22: sits out 
*** HOLE CARDS ***
Kalmar333: folds 
Notatur: folds 
arissanel: folds 
SERGEY015: raises $0.20 to $0.30
YuYuYu777: folds 
Uncalled bet ($0.20) returned to SERGEY015
SERGEY015 collected $0.20 from pot
SERGEY015: doesn't show hand 
*** SUMMARY ***
Total pot $0.20 | Rake $0 
Seat 1: arissanel (button) folded before Flop (didn't bet)
Seat 2: SERGEY015 (small blind) collected ($0.20)
Seat 3: YuYuYu777 (big blind) folded before Flop
Seat 4: Kalmar333 folded before Flop (didn't bet)
Seat 5: Notatur folded before Flop (didn't bet)



PokerStars Hand #222953137815:  Hold'em No Limit ($0.05/$0.10 USD) - 2021/01/23 8:15:14 ET
Table 'Lutetia III' 6-max Seat #1 is the button
Seat 1: arissanel ($10 in chips) 
Seat 2: SERGEY015 ($23.57 in chips) 
Seat 3: YuYuYu777 ($10.83 in chips) 
Seat 4: Kalmar333 ($10.44 in chips) 
Seat 5: Notatur ($10.07 in chips) 
Seat 6: Squashy22 ($10.15 in chips) 
SERGEY015: posts small blind $0.05
YuYuYu777: posts big blind $0.10
*** HOLE CARDS ***
Kalmar333: raises $0.20 to $0.30
Notatur: folds 
Squashy22: folds 
arissanel: folds 
SERGEY015: calls $0.25
YuYuYu777: folds 
*** FLOP *** [9c Kd 9s]
SERGEY015: checks 
Kalmar333: bets $0.34
SERGEY015: folds 
Uncalled bet ($0.34) returned to Kalmar333
Kalmar333 collected $0.67 from pot
Kalmar333: doesn't show hand 
*** SUMMARY ***
Total pot $0.70 | Rake $0.03 
Board [9c Kd 9s]
Seat 1: arissanel (button) folded before Flop (didn't bet)
Seat 2: SERGEY015 (small blind) folded on the Flop
Seat 3: YuYuYu777 (big blind) folded before Flop
Seat 4: Kalmar333 collected ($0.67)
Seat 5: Notatur folded before Flop (didn't bet)
Seat 6: Squashy22 folded before Flop (didn't bet)



PokerStars Hand #222953148904:  Hold'em No Limit ($0.05/$0.10 USD) - 2021/01/23 8:15:41 ET
Table 'Lutetia III' 6-max Seat #2 is the button
Seat 1: arissanel ($10 in chips) 
Seat 2: SERGEY015 ($23.27 in chips) 
Seat 3: YuYuYu777 ($10.73 in chips) 
Seat 4: Kalmar333 ($10.81 in chips) 
Seat 5: Notatur ($10.07 in chips) 
Seat 6: Squashy22 ($10.15 in chips) 
YuYuYu777: posts small blind $0.05
Kalmar333: posts big blind $0.10
*** HOLE CARDS ***
Notatur: folds 
Squashy22: folds 
arissanel: folds 
arissanel leaves the table
Proper-tilted joins the table at seat #1 
SERGEY015: raises $0.20 to $0.30
YuYuYu777: calls $0.25
Kalmar333: calls $0.20
*** FLOP *** [2h Qh 7h]
YuYuYu777: checks 
Kalmar333: checks 
SERGEY015: checks 
*** TURN *** [2h Qh 7h] [Jh]
YuYuYu777: checks 
Kalmar333: checks 
SERGEY015: checks 
*** RIVER *** [2h Qh 7h Jh] [Kd]
YuYuYu777: checks 
Kalmar333: checks 
SERGEY015: checks 
*** SHOW DOWN ***
YuYuYu777: shows [8c Ad] (high card Ace)
Kalmar333: shows [8d 8s] (a pair of Eights)
SERGEY015: shows [7c Jc] (two pair, Jacks and Sevens)
SERGEY015 collected $0.86 from pot
*** SUMMARY ***
Total pot $0.90 | Rake $0.04 
Board [2h Qh 7h Jh Kd]
Seat 1: arissanel folded before Flop (didn't bet)
Seat 2: SERGEY015 (button) showed [7c Jc] and won ($0.86) with two pair, Jacks and Sevens
Seat 3: YuYuYu777 (small blind) showed [8c Ad] and lost with high card Ace
Seat 4: Kalmar333 (big blind) showed [8d 8s] and lost with a pair of Eights
Seat 5: Notatur folded before Flop (didn't bet)
Seat 6: Squashy22 folded before Flop (didn't bet)



PokerStars Hand #222953165758:  Hold'em No Limit ($0.05/$0.10 USD) - 2021/01/23 8:16:22 ET
Table 'Lutetia III' 6-max Seat #3 is the button
Seat 1: Proper-tilted ($10 in chips) 
Seat 2: SERGEY015 ($23.83 in chips) 
Seat 3: YuYuYu777 ($10.43 in chips) 
Seat 4: Kalmar333 ($10.51 in chips) 
Seat 5: Notatur ($10.07 in chips) 
Seat 6: Squashy22 ($10.15 in chips) 
Kalmar333: posts small blind $0.05
Notatur: posts big blind $0.10
Proper-tilted: posts big blind $0.10
*** HOLE CARDS ***
Squashy22: raises $0.35 to $0.45
Proper-tilted: folds 
SERGEY015: folds 
YuYuYu777: folds 
Kalmar333: folds 
Notatur: calls $0.35
*** FLOP *** [7s 9c 6c]
Notatur: bets $0.55
Squashy22: calls $0.55
*** TURN *** [7s 9c 6c] [7d]
Notatur: bets $1.13
Squashy22: folds 
Uncalled bet ($1.13) returned to Notatur
Notatur collected $2.05 from pot
Notatur: doesn't show hand 
*** SUMMARY ***
Total pot $2.15 | Rake $0.10 
Board [7s 9c 6c 7d]
Seat 1: Proper-tilted folded before Flop (didn't bet)
Seat 2: SERGEY015 folded before Flop (didn't bet)
Seat 3: YuYuYu777 (button) folded before Flop (didn't bet)
Seat 4: Kalmar333 (small blind) folded before Flop
Seat 5: Notatur (big blind) collected ($2.05)
Seat 6: Squashy22 folded on the Turn



PokerStars Hand #222953188693:  Hold'em No Limit ($0.05/$0.10 USD) - 2021/01/23 8:17:17 ET
Table 'Lutetia III' 6-max Seat #4 is the button
Seat 1: Proper-tilted ($9.90 in chips) 
Seat 2: SERGEY015 ($23.83 in chips) 
Seat 3: YuYuYu777 ($10.43 in chips) 
Seat 4: Kalmar333 ($10.46 in chips) 
Seat 5: Notatur ($11.12 in chips) 
Seat 6: Squashy22 ($10 in chips) 
Notatur: posts small blind $0.05
Squashy22: posts big blind $0.10
*** HOLE CARDS ***
Proper-tilted: raises $0.15 to $0.25
SERGEY015: folds 
YuYuYu777: folds 
Kalmar333: calls $0.25
Notatur: folds 
Squashy22: folds 
*** FLOP *** [4d 2s 4s]
Proper-tilted: bets $0.31
Kalmar333: folds 
Uncalled bet ($0.31) returned to Proper-tilted
Proper-tilted collected $0.62 from pot
Proper-tilted: doesn't show hand 
*** SUMMARY ***
Total pot $0.65 | Rake $0.03 
Board [4d 2s 4s]
Seat 1: Proper-tilted collected ($0.62)
Seat 2: SERGEY015 folded before Flop (didn't bet)
Seat 3: YuYuYu777 folded before Flop (didn't bet)
Seat 4: Kalmar333 (button) folded on the Flop
Seat 5: Notatur (small blind) folded before Flop
Seat 6: Squashy22 (big blind) folded before Flop



PokerStars Hand #222953202199:  Hold'em No Limit ($0.05/$0.10 USD) - 2021/01/23 8:17:49 ET
Table 'Lutetia III' 6-max Seat #5 is the button
Seat 1: Proper-tilted ($10.27 in chips) 
Seat 2: SERGEY015 ($23.83 in chips) 
Seat 3: YuYuYu777 ($10.43 in chips) 
Seat 4: Kalmar333 ($10.21 in chips) 
Seat 5: Notatur ($11.07 in chips) 
Seat 6: Squashy22 ($10 in chips) 
Squashy22: posts small blind $0.05
Proper-tilted: posts big blind $0.10
*** HOLE CARDS ***
SERGEY015: folds 
YuYuYu777: raises $0.20 to $0.30
Kalmar333: folds 
Notatur: raises $0.60 to $0.90
Squashy22: folds 
Proper-tilted is disconnected 
Proper-tilted has timed out while disconnected
Proper-tilted: folds 
YuYuYu777: folds 
Uncalled bet ($0.60) returned to Notatur
Notatur collected $0.75 from pot
Notatur: doesn't show hand 
*** SUMMARY ***
Total pot $0.75 | Rake $0 
Seat 1: Proper-tilted (big blind) folded before Flop
Seat 2: SERGEY015 folded before Flop (didn't bet)
Seat 3: YuYuYu777 folded before Flop
Seat 4: Kalmar333 folded before Flop (didn't bet)
Seat 5: Notatur (button) collected ($0.75)
Seat 6: Squashy22 (small blind) folded before Flop



PokerStars Hand #222953237745:  Hold'em No Limit ($0.05/$0.10 USD) - 2021/01/23 8:19:14 ET
Table 'Lutetia III' 6-max Seat #6 is the button
Seat 2: SERGEY015 ($23.83 in chips) 
Seat 3: YuYuYu777 ($10.13 in chips) 
Seat 4: Kalmar333 ($10.21 in chips) 
Seat 5: Notatur ($11.52 in chips) 
Seat 6: Squashy22 ($10 in chips) 
SERGEY015: posts small blind $0.05
YuYuYu777: posts big blind $0.10
*** HOLE CARDS ***
Kalmar333: folds 
Notatur: raises $0.15 to $0.25
Squashy22: folds 
SERGEY015: folds 
YuYuYu777: calls $0.15
*** FLOP *** [Ad 9d Qd]
YuYuYu777: checks 
Notatur: bets $0.40
YuYuYu777: folds 
Uncalled bet ($0.40) returned to Notatur
Notatur collected $0.53 from pot
Notatur: doesn't show hand 
*** SUMMARY ***
Total pot $0.55 | Rake $0.02 
Board [Ad 9d Qd]
Seat 2: SERGEY015 (small blind) folded before Flop
Seat 3: YuYuYu777 (big blind) folded on the Flop
Seat 4: Kalmar333 folded before Flop (didn't bet)
Seat 5: Notatur collected ($0.53)
Seat 6: Squashy22 (button) folded before Flop (didn't bet)



PokerStars Hand #222953250019:  Hold'em No Limit ($0.05/$0.10 USD) - 2021/01/23 8:19:43 ET
Table 'Lutetia III' 6-max Seat #2 is the button
Seat 1: Proper-tilted ($10.17 in chips) 
Seat 2: SERGEY015 ($23.78 in chips) 
Seat 3: YuYuYu777 ($9.88 in chips) 
Seat 5: Notatur ($11.80 in chips) 
Seat 6: Squashy22 ($10 in chips) 
YuYuYu777: posts small blind $0.05
Kalmar333: is sitting out 
Notatur: posts big blind $0.10
Proper-tilted: posts small blind $0.05
*** HOLE CARDS ***
Squashy22: folds 
Proper-tilted: folds 
SERGEY015: raises $0.20 to $0.30
YuYuYu777: calls $0.25
Notatur: folds 
*** FLOP *** [8d 9c Qh]
YuYuYu777: checks 
SERGEY015: checks 
*** TURN *** [8d 9c Qh] [6s]
YuYuYu777: bets $0.36
SERGEY015: folds 
Uncalled bet ($0.36) returned to YuYuYu777
YuYuYu777 collected $0.72 from pot
YuYuYu777: doesn't show hand 
*** SUMMARY ***
Total pot $0.75 | Rake $0.03 
Board [8d 9c Qh 6s]
Seat 1: Proper-tilted folded before Flop (didn't bet)
Seat 2: SERGEY015 (button) folded on the Turn
Seat 3: YuYuYu777 (small blind) collected ($0.72)
Seat 5: Notatur (big blind) folded before Flop
Seat 6: Squashy22 folded before Flop (didn't bet)



PokerStars Hand #222953264180:  Hold'em No Limit ($0.05/$0.10 USD) - 2021/01/23 8:20:16 ET
Table 'Lutetia III' 6-max Seat #3 is the button
Seat 1: Proper-tilted ($10.12 in chips) 
Seat 2: SERGEY015 ($23.48 in chips) 
Seat 3: YuYuYu777 ($10.30 in chips) 
Seat 5: Notatur ($11.70 in chips) 
Seat 6: Squashy22 ($10 in chips) 
Notatur: posts small blind $0.05
Squashy22: posts big blind $0.10
*** HOLE CARDS ***
Proper-tilted: folds 
SERGEY015: raises $0.20 to $0.30
YuYuYu777: folds 
Kalmar333 leaves the table
Notatur: folds 
Squashy22: folds 
Uncalled bet ($0.20) returned to SERGEY015
SERGEY015 collected $0.25 from pot
SERGEY015: doesn't show hand 
*** SUMMARY ***
Total pot $0.25 | Rake $0 
Seat 1: Proper-tilted folded before Flop (didn't bet)
Seat 2: SERGEY015 collected ($0.25)
Seat 3: YuYuYu777 (button) folded before Flop (didn't bet)
Seat 5: Notatur (small blind) folded before Flop
Seat 6: Squashy22 (big blind) folded before Flop



PokerStars Hand #222953271657:  Hold'em No Limit ($0.05/$0.10 USD) - 2021/01/23 8:20:34 ET
Table 'Lutetia III' 6-max Seat #5 is the button
Seat 1: Proper-tilted ($10.12 in chips) 
Seat 2: SERGEY015 ($23.63 in chips) 
Seat 3: YuYuYu777 ($10.30 in chips) 
Seat 5: Notatur ($11.65 in chips) 
Seat 6: Squashy22 ($10 in chips) 
Squashy22: posts small blind $0.05
Proper-tilted: posts big blind $0.10
*** HOLE CARDS ***
SERGEY015: raises $0.20 to $0.30
YuYuYu777: folds 
SafeHead joins the table at seat #4 
Notatur: folds 
Squashy22: folds 
Proper-tilted: calls $0.20
*** FLOP *** [8c Tc Qd]
Proper-tilted: checks 
SERGEY015: bets $0.40
Proper-tilted: folds 
Uncalled bet ($0.40) returned to SERGEY015
SERGEY015 collected $0.62 from pot
SERGEY015: doesn't show hand 
*** SUMMARY ***
Total pot $0.65 | Rake $0.03 
Board [8c Tc Qd]
Seat 1: Proper-tilted (big blind) folded on the Flop
Seat 2: SERGEY015 collected ($0.62)
Seat 3: YuYuYu777 folded before Flop (didn't bet)
Seat 5: Notatur (button) folded before Flop (didn't bet)
Seat 6: Squashy22 (small blind) folded before Flop



PokerStars Hand #222953283291:  Hold'em No Limit ($0.05/$0.10 USD) - 2021/01/23 8:21:00 ET
Table 'Lutetia III' 6-max Seat #6 is the button
Seat 1: Proper-tilted ($9.82 in chips) 
Seat 2: SERGEY015 ($23.95 in chips) 
Seat 3: YuYuYu777 ($10.30 in chips) 
Seat 5: Notatur ($11.65 in chips) 
Seat 6: Squashy22 ($10 in chips) 
Proper-tilted: posts small blind $0.05
SERGEY015: posts big blind $0.10
SafeHead: sits out 
*** HOLE CARDS ***
YuYuYu777: folds 
Notatur: raises $0.15 to $0.25
Squashy22: folds 
Proper-tilted: folds 
SERGEY015: calls $0.15
*** FLOP *** [7s Td Th]
SERGEY015: checks 
Notatur: checks 
*** TURN *** [7s Td Th] [2h]
SERGEY015: checks 
Notatur: checks 
*** RIVER *** [7s Td Th 2h] [3c]
SERGEY015: checks 
Notatur: checks 
*** SHOW DOWN ***
SERGEY015: shows [Qs Jd] (a pair of Tens)
Notatur: shows [Jc Kd] (a pair of Tens - King kicker)
Notatur collected $0.53 from pot
*** SUMMARY ***
Total pot $0.55 | Rake $0.02 
Board [7s Td Th 2h 3c]
Seat 1: Proper-tilted (small blind) folded before Flop
Seat 2: SERGEY015 (big blind) showed [Qs Jd] and lost with a pair of Tens
Seat 3: YuYuYu777 folded before Flop (didn't bet)
Seat 5: Notatur showed [Jc Kd] and won ($0.53) with a pair of Tens
Seat 6: Squashy22 (button) folded before Flop (didn't bet)



PokerStars Hand #222953294928:  Hold'em No Limit ($0.05/$0.10 USD) - 2021/01/23 8:21:27 ET
Table 'Lutetia III' 6-max Seat #1 is the button
Seat 1: Proper-tilted ($9.77 in chips) 
Seat 2: SERGEY015 ($23.70 in chips) 
Seat 3: YuYuYu777 ($10.30 in chips) 
Seat 5: Notatur ($11.93 in chips) 
Seat 6: Squashy22 ($10 in chips) 
SERGEY015: posts small blind $0.05
YuYuYu777: posts big blind $0.10
SafeHead: sits out 
*** HOLE CARDS ***
Notatur: folds 
Squashy22: folds 
Proper-tilted: folds 
SERGEY015: folds 
Uncalled bet ($0.05) returned to YuYuYu777
YuYuYu777 collected $0.10 from pot
YuYuYu777: doesn't show hand 
*** SUMMARY ***
Total pot $0.10 | Rake $0 
Seat 1: Proper-tilted (button) folded before Flop (didn't bet)
Seat 2: SERGEY015 (small blind) folded before Flop
Seat 3: YuYuYu777 (big blind) collected ($0.10)
Seat 5: Notatur folded before Flop (didn't bet)
Seat 6: Squashy22 folded before Flop (didn't bet)



PokerStars Hand #222953299863:  Hold'em No Limit ($0.05/$0.10 USD) - 2021/01/23 8:21:39 ET
Table 'Lutetia III' 6-max Seat #2 is the button
Seat 1: Proper-tilted ($9.77 in chips) 
Seat 2: SERGEY015 ($23.65 in chips) 
Seat 3: YuYuYu777 ($10.35 in chips) 
Seat 4: SafeHead ($10 in chips) 
Seat 5: Notatur ($11.93 in chips) 
Seat 6: Squashy22 ($10 in chips) 
YuYuYu777: posts small blind $0.05
SafeHead: posts big blind $0.10
*** HOLE CARDS ***
Notatur: folds 
Squashy22: folds 
Proper-tilted: folds 
SERGEY015: raises $0.20 to $0.30
YuYuYu777: raises $0.70 to $1
SafeHead: folds 
SERGEY015: folds 
Uncalled bet ($0.70) returned to YuYuYu777
YuYuYu777 collected $0.70 from pot
YuYuYu777: doesn't show hand 
*** SUMMARY ***
Total pot $0.70 | Rake $0 
Seat 1: Proper-tilted folded before Flop (didn't bet)
Seat 2: SERGEY015 (button) folded before Flop
Seat 3: YuYuYu777 (small blind) collected ($0.70)
Seat 4: SafeHead (big blind) folded before Flop
Seat 5: Notatur folded before Flop (didn't bet)
Seat 6: Squashy22 folded before Flop (didn't bet)



PokerStars Hand #222953308236:  Hold'em No Limit ($0.05/$0.10 USD) - 2021/01/23 8:21:59 ET
Table 'Lutetia III' 6-max Seat #3 is the button
Seat 1: Proper-tilted ($9.77 in chips) 
Seat 2: SERGEY015 ($23.35 in chips) 
Seat 3: YuYuYu777 ($10.75 in chips) 
Seat 4: SafeHead ($9.90 in chips) 
Seat 5: Notatur ($11.93 in chips) 
Seat 6: Squashy22 ($10 in chips) 
SafeHead: posts small blind $0.05
Notatur: posts big blind $0.10
*** HOLE CARDS ***
Squashy22: folds 
Proper-tilted: folds 
SERGEY015: raises $0.20 to $0.30
YuYuYu777: folds 
SafeHead: folds 
Notatur: folds 
Uncalled bet ($0.20) returned to SERGEY015
SERGEY015 collected $0.25 from pot
SERGEY015: doesn't show hand 
*** SUMMARY ***
Total pot $0.25 | Rake $0 
Seat 1: Proper-tilted folded before Flop (didn't bet)
Seat 2: SERGEY015 collected ($0.25)
Seat 3: YuYuYu777 (button) folded before Flop (didn't bet)
Seat 4: SafeHead (small blind) folded before Flop
Seat 5: Notatur (big blind) folded before Flop
Seat 6: Squashy22 folded before Flop (didn't bet)



PokerStars Hand #222953316598:  Hold'em No Limit ($0.05/$0.10 USD) - 2021/01/23 8:22:18 ET
Table 'Lutetia III' 6-max Seat #4 is the button
Seat 1: Proper-tilted ($9.77 in chips) 
Seat 2: SERGEY015 ($23.50 in chips) 
Seat 3: YuYuYu777 ($10.75 in chips) 
Seat 4: SafeHead ($9.85 in chips) 
Seat 5: Notatur ($11.83 in chips) 
Seat 6: Squashy22 ($10 in chips) 
Notatur: posts small blind $0.05
Squashy22: posts big blind $0.10
*** HOLE CARDS ***
Proper-tilted: raises $0.20 to $0.30
SERGEY015: folds 
YuYuYu777: folds 
SafeHead: calls $0.30
Notatur: folds 
Squashy22: folds 
*** FLOP *** [3c 6c 2c]
Proper-tilted: bets $0.20
SafeHead: calls $0.20
*** TURN *** [3c 6c 2c] [Ad]
Proper-tilted: checks 
SafeHead: bets $0.50
Proper-tilted: raises $0.50 to $1
SafeHead: raises $8.35 to $9.35 and is all-in
Proper-tilted: calls $8.27 and is all-in
Uncalled bet ($0.08) returned to SafeHead
*** RIVER *** [3c 6c 2c Ad] [7d]
*** SHOW DOWN ***
Proper-tilted: shows [Tc Ac] (a flush, Ace high)
SafeHead: shows [Th Qh] (high card Ace)
Proper-tilted collected $18.80 from pot
*** SUMMARY ***
Total pot $19.69 | Rake $0.89 
Board [3c 6c 2c Ad 7d]
Seat 1: Proper-tilted showed [Tc Ac] and won ($18.80) with a flush, Ace high
Seat 2: SERGEY015 folded before Flop (didn't bet)
Seat 3: YuYuYu777 folded before Flop (didn't bet)
Seat 4: SafeHead (button) showed [Th Qh] and lost with high card Ace
Seat 5: Notatur (small blind) folded before Flop
Seat 6: Squashy22 (big blind) folded before Flop



PokerStars Hand #222953332868:  Hold'em No Limit ($0.05/$0.10 USD) - 2021/01/23 8:22:55 ET
Table 'Lutetia III' 6-max Seat #5 is the button
Seat 1: Proper-tilted ($18.80 in chips) 
Seat 2: SERGEY015 ($23.50 in chips) 
Seat 3: YuYuYu777 ($10.75 in chips) 
Seat 5: Notatur ($11.78 in chips) 
Seat 6: Squashy22 ($10 in chips) 
Squashy22: posts small blind $0.05
Proper-tilted: posts big blind $0.10
*** HOLE CARDS ***
SERGEY015: folds 
YuYuYu777: folds 
Notatur: raises $0.15 to $0.25
Squashy22: folds 
Proper-tilted: folds 
Uncalled bet ($0.15) returned to Notatur
Notatur collected $0.25 from pot
Notatur: doesn't show hand 
*** SUMMARY ***
Total pot $0.25 | Rake $0 
Seat 1: Proper-tilted (big blind) folded before Flop
Seat 2: SERGEY015 folded before Flop (didn't bet)
Seat 3: YuYuYu777 folded before Flop (didn't bet)
Seat 5: Notatur (button) collected ($0.25)
Seat 6: Squashy22 (small blind) folded before Flop



PokerStars Hand #222953337805:  Hold'em No Limit ($0.05/$0.10 USD) - 2021/01/23 8:23:07 ET
Table 'Lutetia III' 6-max Seat #6 is the button
Seat 1: Proper-tilted ($18.70 in chips) 
Seat 2: SERGEY015 ($23.50 in chips) 
Seat 3: YuYuYu777 ($10.75 in chips) 
Seat 5: Notatur ($11.93 in chips) 
Seat 6: Squashy22 ($10 in chips) 
Proper-tilted: posts small blind $0.05
SERGEY015: posts big blind $0.10
*** HOLE CARDS ***
mr_mankut joins the table at seat #4 
YuYuYu777: folds 
Notatur: folds 
Squashy22: folds 
Proper-tilted: folds 
Uncalled bet ($0.05) returned to SERGEY015
SERGEY015 collected $0.10 from pot
SERGEY015: doesn't show hand 
*** SUMMARY ***
Total pot $0.10 | Rake $0 
Seat 1: Proper-tilted (small blind) folded before Flop
Seat 2: SERGEY015 (big blind) collected ($0.10)
Seat 3: YuYuYu777 folded before Flop (didn't bet)
Seat 5: Notatur folded before Flop (didn't bet)
Seat 6: Squashy22 (button) folded before Flop (didn't bet)



PokerStars Hand #222953341225:  Hold'em No Limit ($0.05/$0.10 USD) - 2021/01/23 8:23:15 ET
Table 'Lutetia III' 6-max Seat #1 is the button
Seat 1: Proper-tilted ($18.65 in chips) 
Seat 2: SERGEY015 ($23.55 in chips) 
Seat 3: YuYuYu777 ($10.75 in chips) 
Seat 5: Notatur ($11.93 in chips) 
Seat 6: Squashy22 ($10 in chips) 
SERGEY015: posts small blind $0.05
YuYuYu777: posts big blind $0.10
mr_mankut: sits out 
*** HOLE CARDS ***
Notatur: folds 
Squashy22: raises $0.16 to $0.26
Proper-tilted: folds 
SERGEY015: folds 
YuYuYu777: raises $0.57 to $0.83
Squashy22: calls $0.57
*** FLOP *** [7c Kd 7h]
YuYuYu777: bets $0.82
Squashy22: calls $0.82
*** TURN *** [7c Kd 7h] [5c]
YuYuYu777: bets $2.40
Squashy22: folds 
Uncalled bet ($2.40) returned to YuYuYu777
YuYuYu777 collected $3.20 from pot
YuYuYu777: doesn't show hand 
*** SUMMARY ***
Total pot $3.35 | Rake $0.15 
Board [7c Kd 7h 5c]
Seat 1: Proper-tilted (button) folded before Flop (didn't bet)
Seat 2: SERGEY015 (small blind) folded before Flop
Seat 3: YuYuYu777 (big blind) collected ($3.20)
Seat 5: Notatur folded before Flop (didn't bet)
Seat 6: Squashy22 folded on the Turn



PokerStars Hand #222953358526:  Hold'em No Limit ($0.05/$0.10 USD) - 2021/01/23 8:23:55 ET
Table 'Lutetia III' 6-max Seat #2 is the button
Seat 1: Proper-tilted ($18.65 in chips) 
Seat 2: SERGEY015 ($23.50 in chips) 
Seat 3: YuYuYu777 ($12.30 in chips) 
Seat 4: mr_mankut ($9.98 in chips) 
Seat 5: Notatur ($11.93 in chips) 
Seat 6: Squashy22 ($10 in chips) 
YuYuYu777: posts small blind $0.05
mr_mankut: posts big blind $0.10
*** HOLE CARDS ***
Notatur: raises $0.15 to $0.25
Squashy22: folds 
Proper-tilted: folds 
SERGEY015: folds 
YuYuYu777: folds 
mr_mankut: folds 
Uncalled bet ($0.15) returned to Notatur
Notatur collected $0.25 from pot
Notatur: doesn't show hand 
*** SUMMARY ***
Total pot $0.25 | Rake $0 
Seat 1: Proper-tilted folded before Flop (didn't bet)
Seat 2: SERGEY015 (button) folded before Flop (didn't bet)
Seat 3: YuYuYu777 (small blind) folded before Flop
Seat 4: mr_mankut (big blind) folded before Flop
Seat 5: Notatur collected ($0.25)
Seat 6: Squashy22 folded before Flop (didn't bet)



PokerStars Hand #222953364872:  Hold'em No Limit ($0.05/$0.10 USD) - 2021/01/23 8:24:09 ET
Table 'Lutetia III' 6-max Seat #3 is the button
Seat 1: Proper-tilted ($18.65 in chips) 
Seat 2: SERGEY015 ($23.50 in chips) 
Seat 3: YuYuYu777 ($12.25 in chips) 
Seat 4: mr_mankut ($9.88 in chips) 
Seat 5: Notatur ($12.08 in chips) 
Seat 6: Squashy22 ($10 in chips) 
mr_mankut: posts small blind $0.05
Notatur: posts big blind $0.10
*** HOLE CARDS ***
Squashy22: folds 
Proper-tilted: raises $0.10 to $0.20
SERGEY015: folds 
YuYuYu777: folds 
mr_mankut: folds 
Notatur: folds 
Uncalled bet ($0.10) returned to Proper-tilted
Proper-tilted collected $0.25 from pot
Proper-tilted: doesn't show hand 
*** SUMMARY ***
Total pot $0.25 | Rake $0 
Seat 1: Proper-tilted collected ($0.25)
Seat 2: SERGEY015 folded before Flop (didn't bet)
Seat 3: YuYuYu777 (button) folded before Flop (didn't bet)
Seat 4: mr_mankut (small blind) folded before Flop
Seat 5: Notatur (big blind) folded before Flop
Seat 6: Squashy22 folded before Flop (didn't bet)



PokerStars Hand #222953373801:  Hold'em No Limit ($0.05/$0.10 USD) - 2021/01/23 8:24:30 ET
Table 'Lutetia III' 6-max Seat #4 is the button
Seat 1: Proper-tilted ($18.80 in chips) 
Seat 2: SERGEY015 ($23.50 in chips) 
Seat 3: YuYuYu777 ($12.25 in chips) 
Seat 4: mr_mankut ($9.83 in chips) 
Seat 5: Notatur ($11.98 in chips) 
Seat 6: Squashy22 ($10 in chips) 
Notatur: posts small blind $0.05
Squashy22: posts big blind $0.10
*** HOLE CARDS ***
Proper-tilted: folds 
SERGEY015: folds 
YuYuYu777: folds 
mr_mankut: raises $0.20 to $0.30
Notatur: folds 
Squashy22: folds 
Uncalled bet ($0.20) returned to mr_mankut
mr_mankut collected $0.25 from pot
mr_mankut: doesn't show hand 
*** SUMMARY ***
Total pot $0.25 | Rake $0 
Seat 1: Proper-tilted folded before Flop (didn't bet)
Seat 2: SERGEY015 folded before Flop (didn't bet)
Seat 3: YuYuYu777 folded before Flop (didn't bet)
Seat 4: mr_mankut (button) collected ($0.25)
Seat 5: Notatur (small blind) folded before Flop
Seat 6: Squashy22 (big blind) folded before Flop



PokerStars Hand #222953380617:  Hold'em No Limit ($0.05/$0.10 USD) - 2021/01/23 8:24:46 ET
Table 'Lutetia III' 6-max Seat #5 is the button
Seat 1: Proper-tilted ($18.80 in chips) 
Seat 2: SERGEY015 ($23.50 in chips) 
Seat 3: YuYuYu777 ($12.25 in chips) 
Seat 4: mr_mankut ($9.98 in chips) 
Seat 5: Notatur ($11.93 in chips) 
Seat 6: Squashy22 ($10 in chips) 
Squashy22: posts small blind $0.05
Proper-tilted: posts big blind $0.10
*** HOLE CARDS ***
SERGEY015: folds 
YuYuYu777: raises $0.20 to $0.30
mr_mankut: folds 
Notatur: folds 
Squashy22: calls $0.25
Proper-tilted: calls $0.20
*** FLOP *** [6c 2d Ac]
Squashy22: checks 
Proper-tilted: checks 
YuYuYu777: checks 
*** TURN *** [6c 2d Ac] [As]
Squashy22: checks 
Proper-tilted: checks 
YuYuYu777: bets $0.43
Squashy22: folds 
Proper-tilted: folds 
Uncalled bet ($0.43) returned to YuYuYu777
YuYuYu777 collected $0.86 from pot
YuYuYu777: doesn't show hand 
*** SUMMARY ***
Total pot $0.90 | Rake $0.04 
Board [6c 2d Ac As]
Seat 1: Proper-tilted (big blind) folded on the Turn
Seat 2: SERGEY015 folded before Flop (didn't bet)
Seat 3: YuYuYu777 collected ($0.86)
Seat 4: mr_mankut folded before Flop (didn't bet)
Seat 5: Notatur (button) folded before Flop (didn't bet)
Seat 6: Squashy22 (small blind) folded on the Turn



PokerStars Hand #222953399157:  Hold'em No Limit ($0.05/$0.10 USD) - 2021/01/23 8:25:29 ET
Table 'Lutetia III' 6-max Seat #6 is the button
Seat 1: Proper-tilted ($18.50 in chips) 
Seat 2: SERGEY015 ($23.50 in chips) 
Seat 3: YuYuYu777 ($12.81 in chips) 
Seat 4: mr_mankut ($9.98 in chips) 
Seat 5: Notatur ($11.93 in chips) 
Seat 6: Squashy22 ($10 in chips) 
Proper-tilted: posts small blind $0.05
SERGEY015: posts big blind $0.10
*** HOLE CARDS ***
YuYuYu777: folds 
mr_mankut: folds 
Notatur: raises $0.15 to $0.25
Squashy22: folds 
Proper-tilted: folds 
SERGEY015: folds 
Uncalled bet ($0.15) returned to Notatur
Notatur collected $0.25 from pot
Notatur: doesn't show hand 
*** SUMMARY ***
Total pot $0.25 | Rake $0 
Seat 1: Proper-tilted (small blind) folded before Flop
Seat 2: SERGEY015 (big blind) folded before Flop
Seat 3: YuYuYu777 folded before Flop (didn't bet)
Seat 4: mr_mankut folded before Flop (didn't bet)
Seat 5: Notatur collected ($0.25)
Seat 6: Squashy22 (button) folded before Flop (didn't bet)



PokerStars Hand #222953404664:  Hold'em No Limit ($0.05/$0.10 USD) - 2021/01/23 8:25:42 ET
Table 'Lutetia III' 6-max Seat #1 is the button
Seat 1: Proper-tilted ($18.45 in chips) 
Seat 2: SERGEY015 ($23.40 in chips) 
Seat 3: YuYuYu777 ($12.81 in chips) 
Seat 4: mr_mankut ($9.98 in chips) 
Seat 5: Notatur ($12.08 in chips) 
Seat 6: Squashy22 ($10 in chips) 
SERGEY015: posts small blind $0.05
YuYuYu777: posts big blind $0.10
*** HOLE CARDS ***
mr_mankut: folds 
Notatur: folds 
Squashy22: folds 
Proper-tilted: folds 
SERGEY015: raises $0.20 to $0.30
YuYuYu777: folds 
Uncalled bet ($0.20) returned to SERGEY015
SERGEY015 collected $0.20 from pot
SERGEY015: doesn't show hand 
*** SUMMARY ***
Total pot $0.20 | Rake $0 
Seat 1: Proper-tilted (button) folded before Flop (didn't bet)
Seat 2: SERGEY015 (small blind) collected ($0.20)
Seat 3: YuYuYu777 (big blind) folded before Flop
Seat 4: mr_mankut folded before Flop (didn't bet)
Seat 5: Notatur folded before Flop (didn't bet)
Seat 6: Squashy22 folded before Flop (didn't bet)



PokerStars Hand #222953409455:  Hold'em No Limit ($0.05/$0.10 USD) - 2021/01/23 8:25:53 ET
Table 'Lutetia III' 6-max Seat #2 is the button
Seat 1: Proper-tilted ($18.45 in chips) 
Seat 2: SERGEY015 ($23.50 in chips) 
Seat 3: YuYuYu777 ($12.71 in chips) 
Seat 4: mr_mankut ($9.98 in chips) 
Seat 5: Notatur ($12.08 in chips) 
Seat 6: Squashy22 ($10 in chips) 
YuYuYu777: posts small blind $0.05
mr_mankut: posts big blind $0.10
*** HOLE CARDS ***
Notatur: folds 
Squashy22: folds 
Proper-tilted: raises $0.20 to $0.30
SERGEY015: folds 
YuYuYu777: raises $0.70 to $1
mr_mankut: folds 
Proper-tilted: calls $0.70
*** FLOP *** [4c Ah 4d]
YuYuYu777: checks 
Proper-tilted: bets $0.30
YuYuYu777: calls $0.30
*** TURN *** [4c Ah 4d] [Jd]
YuYuYu777: checks 
Proper-tilted: bets $0.50
YuYuYu777: calls $0.50
*** RIVER *** [4c Ah 4d Jd] [8s]
YuYuYu777: checks 
Proper-tilted: bets $3.53
YuYuYu777: folds 
Uncalled bet ($3.53) returned to Proper-tilted
Proper-tilted collected $3.53 from pot
Proper-tilted: doesn't show hand 
*** SUMMARY ***
Total pot $3.70 | Rake $0.17 
Board [4c Ah 4d Jd 8s]
Seat 1: Proper-tilted collected ($3.53)
Seat 2: SERGEY015 (button) folded before Flop (didn't bet)
Seat 3: YuYuYu777 (small blind) folded on the River
Seat 4: mr_mankut (big blind) folded before Flop
Seat 5: Notatur folded before Flop (didn't bet)
Seat 6: Squashy22 folded before Flop (didn't bet)



PokerStars Hand #222953432542:  Hold'em No Limit ($0.05/$0.10 USD) - 2021/01/23 8:26:47 ET
Table 'Lutetia III' 6-max Seat #3 is the button
Seat 1: Proper-tilted ($20.18 in chips) 
Seat 2: SERGEY015 ($23.50 in chips) 
Seat 3: YuYuYu777 ($10.91 in chips) 
Seat 4: mr_mankut ($9.88 in chips) 
Seat 5: Notatur ($12.08 in chips) 
Seat 6: Squashy22 ($10 in chips) 
mr_mankut: posts small blind $0.05
Notatur: posts big blind $0.10
*** HOLE CARDS ***
Squashy22: folds 
Proper-tilted: folds 
SERGEY015: folds 
YuYuYu777: folds 
mr_mankut: calls $0.05
Notatur: checks 
*** FLOP *** [7h 5c Ts]
mr_mankut: checks 
Notatur: bets $0.10
mr_mankut: folds 
Uncalled bet ($0.10) returned to Notatur
Notatur collected $0.19 from pot
Notatur: doesn't show hand 
*** SUMMARY ***
Total pot $0.20 | Rake $0.01 
Board [7h 5c Ts]
Seat 1: Proper-tilted folded before Flop (didn't bet)
Seat 2: SERGEY015 folded before Flop (didn't bet)
Seat 3: YuYuYu777 (button) folded before Flop (didn't bet)
Seat 4: mr_mankut (small blind) folded on the Flop
Seat 5: Notatur (big blind) collected ($0.19)
Seat 6: Squashy22 folded before Flop (didn't bet)



PokerStars Hand #222953444017:  Hold'em No Limit ($0.05/$0.10 USD) - 2021/01/23 8:27:13 ET
Table 'Lutetia III' 6-max Seat #4 is the button
Seat 1: Proper-tilted ($20.18 in chips) 
Seat 2: SERGEY015 ($23.50 in chips) 
Seat 3: YuYuYu777 ($10.91 in chips) 
Seat 4: mr_mankut ($9.78 in chips) 
Seat 5: Notatur ($12.17 in chips) 
Seat 6: Squashy22 ($10 in chips) 
Notatur: posts small blind $0.05
Squashy22: posts big blind $0.10
*** HOLE CARDS ***
Proper-tilted: raises $0.15 to $0.25
SERGEY015: calls $0.25
YuYuYu777: folds 
mr_mankut: folds 
Notatur: folds 
Squashy22: folds 
*** FLOP *** [5s Kc Th]
Proper-tilted: checks 
SERGEY015: bets $0.32
Proper-tilted: calls $0.32
*** TURN *** [5s Kc Th] [Ts]
Proper-tilted: checks 
SERGEY015: bets $0.63
Proper-tilted: folds 
Uncalled bet ($0.63) returned to SERGEY015
SERGEY015 collected $1.23 from pot
SERGEY015: doesn't show hand 
*** SUMMARY ***
Total pot $1.29 | Rake $0.06 
Board [5s Kc Th Ts]
Seat 1: Proper-tilted folded on the Turn
Seat 2: SERGEY015 collected ($1.23)
Seat 3: YuYuYu777 folded before Flop (didn't bet)
Seat 4: mr_mankut (button) folded before Flop (didn't bet)
Seat 5: Notatur (small blind) folded before Flop
Seat 6: Squashy22 (big blind) folded before Flop



PokerStars Hand #222953458577:  Hold'em No Limit ($0.05/$0.10 USD) - 2021/01/23 8:27:47 ET
Table 'Lutetia III' 6-max Seat #5 is the button
Seat 1: Proper-tilted ($19.61 in chips) 
Seat 2: SERGEY015 ($24.16 in chips) 
Seat 3: YuYuYu777 ($10.91 in chips) 
Seat 4: mr_mankut ($9.78 in chips) 
Seat 5: Notatur ($12.12 in chips) 
Seat 6: Squashy22 ($10 in chips) 
Squashy22: posts small blind $0.05
Proper-tilted: posts big blind $0.10
*** HOLE CARDS ***
SERGEY015: folds 
YuYuYu777: folds 
mr_mankut: folds 
Notatur: folds 
Squashy22: folds 
Uncalled bet ($0.05) returned to Proper-tilted
Proper-tilted collected $0.10 from pot
Proper-tilted: doesn't show hand 
*** SUMMARY ***
Total pot $0.10 | Rake $0 
Seat 1: Proper-tilted (big blind) collected ($0.10)
Seat 2: SERGEY015 folded before Flop (didn't bet)
Seat 3: YuYuYu777 folded before Flop (didn't bet)
Seat 4: mr_mankut folded before Flop (didn't bet)
Seat 5: Notatur (button) folded before Flop (didn't bet)
Seat 6: Squashy22 (small blind) folded before Flop



PokerStars Hand #222953462801:  Hold'em No Limit ($0.05/$0.10 USD) - 2021/01/23 8:27:56 ET
Table 'Lutetia III' 6-max Seat #6 is the button
Seat 1: Proper-tilted ($19.66 in chips) 
Seat 2: SERGEY015 ($24.16 in chips) 
Seat 3: YuYuYu777 ($10.91 in chips) 
Seat 4: mr_mankut ($9.78 in chips) 
Seat 5: Notatur ($12.12 in chips) 
Seat 6: Squashy22 ($10 in chips) 
Proper-tilted: posts small blind $0.05
SERGEY015: posts big blind $0.10
*** HOLE CARDS ***
YuYuYu777: folds 
mr_mankut: folds 
Notatur: folds 
Squashy22: raises $0.14 to $0.24
Proper-tilted: folds 
SERGEY015: raises $0.56 to $0.80
Squashy22: folds 
Uncalled bet ($0.56) returned to SERGEY015
SERGEY015 collected $0.53 from pot
SERGEY015: doesn't show hand 
*** SUMMARY ***
Total pot $0.53 | Rake $0 
Seat 1: Proper-tilted (small blind) folded before Flop
Seat 2: SERGEY015 (big blind) collected ($0.53)
Seat 3: YuYuYu777 folded before Flop (didn't bet)
Seat 4: mr_mankut folded before Flop (didn't bet)
Seat 5: Notatur folded before Flop (didn't bet)
Seat 6: Squashy22 (button) folded before Flop



PokerStars Hand #222953470829:  Hold'em No Limit ($0.05/$0.10 USD) - 2021/01/23 8:28:15 ET
Table 'Lutetia III' 6-max Seat #1 is the button
Seat 1: Proper-tilted ($19.61 in chips) 
Seat 2: SERGEY015 ($24.45 in chips) 
Seat 3: YuYuYu777 ($10.91 in chips) 
Seat 4: mr_mankut ($9.78 in chips) 
Seat 5: Notatur ($12.12 in chips) 
Seat 6: Squashy22 ($10 in chips) 
SERGEY015: posts small blind $0.05
YuYuYu777: posts big blind $0.10
*** HOLE CARDS ***
mr_mankut: folds 
Notatur: folds 
Squashy22: raises $0.16 to $0.26
Proper-tilted: calls $0.26
SERGEY015: folds 
YuYuYu777: folds 
*** FLOP *** [Ah Th 7s]
Squashy22: bets $0.36
Proper-tilted: calls $0.36
*** TURN *** [Ah Th 7s] [9s]
Squashy22: bets $0.74
Proper-tilted: calls $0.74
*** RIVER *** [Ah Th 7s 9s] [Qs]
Squashy22: bets $1.95
Proper-tilted: folds 
Uncalled bet ($1.95) returned to Squashy22
Squashy22 collected $2.74 from pot
Squashy22: doesn't show hand 
*** SUMMARY ***
Total pot $2.87 | Rake $0.13 
Board [Ah Th 7s 9s Qs]
Seat 1: Proper-tilted (button) folded on the River
Seat 2: SERGEY015 (small blind) folded before Flop
Seat 3: YuYuYu777 (big blind) folded before Flop
Seat 4: mr_mankut folded before Flop (didn't bet)
Seat 5: Notatur folded before Flop (didn't bet)
Seat 6: Squashy22 collected ($2.74)



PokerStars Hand #222953492583:  Hold'em No Limit ($0.05/$0.10 USD) - 2021/01/23 8:29:04 ET
Table 'Lutetia III' 6-max Seat #2 is the button
Seat 1: Proper-tilted ($18.25 in chips) 
Seat 2: SERGEY015 ($24.40 in chips) 
Seat 3: YuYuYu777 ($10.81 in chips) 
Seat 4: mr_mankut ($9.78 in chips) 
Seat 5: Notatur ($12.12 in chips) 
Seat 6: Squashy22 ($11.38 in chips) 
YuYuYu777: posts small blind $0.05
mr_mankut: posts big blind $0.10
*** HOLE CARDS ***
Notatur: folds 
Squashy22: folds 
Proper-tilted: raises $0.20 to $0.30
SERGEY015: folds 
YuYuYu777: calls $0.25
mr_mankut: folds 
*** FLOP *** [5c Ks 2c]
YuYuYu777: checks 
Proper-tilted: bets $0.33
YuYuYu777: folds 
Uncalled bet ($0.33) returned to Proper-tilted
Proper-tilted collected $0.67 from pot
Proper-tilted: doesn't show hand 
*** SUMMARY ***
Total pot $0.70 | Rake $0.03 
Board [5c Ks 2c]
Seat 1: Proper-tilted collected ($0.67)
Seat 2: SERGEY015 (button) folded before Flop (didn't bet)
Seat 3: YuYuYu777 (small blind) folded on the Flop
Seat 4: mr_mankut (big blind) folded before Flop
Seat 5: Notatur folded before Flop (didn't bet)
Seat 6: Squashy22 folded before Flop (didn't bet)



PokerStars Hand #222953505645:  Hold'em No Limit ($0.05/$0.10 USD) - 2021/01/23 8:29:34 ET
Table 'Lutetia III' 6-max Seat #3 is the button
Seat 1: Proper-tilted ($18.62 in chips) 
Seat 2: SERGEY015 ($24.40 in chips) 
Seat 3: YuYuYu777 ($10.51 in chips) 
Seat 4: mr_mankut ($9.68 in chips) 
Seat 5: Notatur ($12.12 in chips) 
Seat 6: Squashy22 ($11.38 in chips) 
mr_mankut: posts small blind $0.05
Notatur: posts big blind $0.10
*** HOLE CARDS ***
Squashy22: folds 
Proper-tilted: folds 
SERGEY015: folds 
YuYuYu777: folds 
mr_mankut: calls $0.05
Notatur: checks 
*** FLOP *** [5h 7d 2d]
mr_mankut: bets $0.19
Notatur: folds 
Uncalled bet ($0.19) returned to mr_mankut
mr_mankut collected $0.19 from pot
mr_mankut: doesn't show hand 
*** SUMMARY ***
Total pot $0.20 | Rake $0.01 
Board [5h 7d 2d]
Seat 1: Proper-tilted folded before Flop (didn't bet)
Seat 2: SERGEY015 folded before Flop (didn't bet)
Seat 3: YuYuYu777 (button) folded before Flop (didn't bet)
Seat 4: mr_mankut (small blind) collected ($0.19)
Seat 5: Notatur (big blind) folded on the Flop
Seat 6: Squashy22 folded before Flop (didn't bet)



PokerStars Hand #222953516455:  Hold'em No Limit ($0.05/$0.10 USD) - 2021/01/23 8:29:59 ET
Table 'Lutetia III' 6-max Seat #4 is the button
Seat 1: Proper-tilted ($18.62 in chips) 
Seat 2: SERGEY015 ($24.40 in chips) 
Seat 3: YuYuYu777 ($10.51 in chips) 
Seat 4: mr_mankut ($9.77 in chips) 
Seat 5: Notatur ($12.02 in chips) 
Seat 6: Squashy22 ($11.38 in chips) 
Notatur: posts small blind $0.05
Squashy22: posts big blind $0.10
*** HOLE CARDS ***
Proper-tilted: raises $0.20 to $0.30
SERGEY015: folds 
YuYuYu777: calls $0.30
mr_mankut: folds 
Notatur: folds 
Squashy22: calls $0.20
*** FLOP *** [Ac Th Qd]
Squashy22: checks 
Proper-tilted: checks 
YuYuYu777: checks 
*** TURN *** [Ac Th Qd] [8s]
Squashy22: bets $0.51
Proper-tilted: calls $0.51
YuYuYu777: folds 
*** RIVER *** [Ac Th Qd 8s] [8d]
Squashy22: checks 
Proper-tilted: checks 
*** SHOW DOWN ***
Squashy22: shows [7c 9h] (a pair of Eights)
Proper-tilted: shows [Qs Ks] (two pair, Queens and Eights)
Proper-tilted collected $1.88 from pot
*** SUMMARY ***
Total pot $1.97 | Rake $0.09 
Board [Ac Th Qd 8s 8d]
Seat 1: Proper-tilted showed [Qs Ks] and won ($1.88) with two pair, Queens and Eights
Seat 2: SERGEY015 folded before Flop (didn't bet)
Seat 3: YuYuYu777 folded on the Turn
Seat 4: mr_mankut (button) folded before Flop (didn't bet)
Seat 5: Notatur (small blind) folded before Flop
Seat 6: Squashy22 (big blind) showed [7c 9h] and lost with a pair of Eights



PokerStars Hand #222953535137:  Hold'em No Limit ($0.05/$0.10 USD) - 2021/01/23 8:30:41 ET
Table 'Lutetia III' 6-max Seat #5 is the button
Seat 1: Proper-tilted ($19.69 in chips) 
Seat 2: SERGEY015 ($24.40 in chips) 
Seat 3: YuYuYu777 ($10.21 in chips) 
Seat 4: mr_mankut ($9.77 in chips) 
Seat 5: Notatur ($11.97 in chips) 
Seat 6: Squashy22 ($10.57 in chips) 
Squashy22: posts small blind $0.05
Proper-tilted: posts big blind $0.10
*** HOLE CARDS ***
SERGEY015: folds 
YuYuYu777: raises $0.20 to $0.30
mr_mankut: folds 
SERGEY015 leaves the table
pernth joins the table at seat #2 
Notatur: folds 
Squashy22: folds 
Proper-tilted: folds 
Uncalled bet ($0.20) returned to YuYuYu777
YuYuYu777 collected $0.25 from pot
YuYuYu777: doesn't show hand 
*** SUMMARY ***
Total pot $0.25 | Rake $0 
Seat 1: Proper-tilted (big blind) folded before Flop
Seat 2: SERGEY015 folded before Flop (didn't bet)
Seat 3: YuYuYu777 collected ($0.25)
Seat 4: mr_mankut folded before Flop (didn't bet)
Seat 5: Notatur (button) folded before Flop (didn't bet)
Seat 6: Squashy22 (small blind) folded before Flop



PokerStars Hand #222953545697:  Hold'em No Limit ($0.05/$0.10 USD) - 2021/01/23 8:31:05 ET
Table 'Lutetia III' 6-max Seat #6 is the button
Seat 1: Proper-tilted ($19.59 in chips) 
Seat 2: pernth ($6 in chips) 
Seat 3: YuYuYu777 ($10.36 in chips) 
Seat 4: mr_mankut ($9.77 in chips) 
Seat 5: Notatur ($11.97 in chips) 
Seat 6: Squashy22 ($10.52 in chips) 
Proper-tilted: posts small blind $0.05
pernth: posts big blind $0.10
*** HOLE CARDS ***
YuYuYu777: folds 
mr_mankut: raises $0.10 to $0.20
Notatur: folds 
Squashy22: folds 
Proper-tilted: calls $0.15
pernth: folds 
*** FLOP *** [7d Js 6d]
Proper-tilted: checks 
mr_mankut: bets $0.24
Proper-tilted: folds 
Uncalled bet ($0.24) returned to mr_mankut
mr_mankut collected $0.48 from pot
mr_mankut: doesn't show hand 
*** SUMMARY ***
Total pot $0.50 | Rake $0.02 
Board [7d Js 6d]
Seat 1: Proper-tilted (small blind) folded on the Flop
Seat 2: pernth (big blind) folded before Flop
Seat 3: YuYuYu777 folded before Flop (didn't bet)
Seat 4: mr_mankut collected ($0.48)
Seat 5: Notatur folded before Flop (didn't bet)
Seat 6: Squashy22 (button) folded before Flop (didn't bet)



PokerStars Hand #222953554845:  Hold'em No Limit ($0.05/$0.10 USD) - 2021/01/23 8:31:25 ET
Table 'Lutetia III' 6-max Seat #1 is the button
Seat 1: Proper-tilted ($19.39 in chips) 
Seat 2: pernth ($5.90 in chips) 
Seat 3: YuYuYu777 ($10.36 in chips) 
Seat 4: mr_mankut ($10.05 in chips) 
Seat 5: Notatur ($11.97 in chips) 
Seat 6: Squashy22 ($10.52 in chips) 
pernth: posts small blind $0.05
YuYuYu777: posts big blind $0.10
*** HOLE CARDS ***
mr_mankut: folds 
Notatur: folds 
Squashy22: folds 
Proper-tilted: folds 
pernth: folds 
Uncalled bet ($0.05) returned to YuYuYu777
YuYuYu777 collected $0.10 from pot
YuYuYu777: doesn't show hand 
*** SUMMARY ***
Total pot $0.10 | Rake $0 
Seat 1: Proper-tilted (button) folded before Flop (didn't bet)
Seat 2: pernth (small blind) folded before Flop
Seat 3: YuYuYu777 (big blind) collected ($0.10)
Seat 4: mr_mankut folded before Flop (didn't bet)
Seat 5: Notatur folded before Flop (didn't bet)
Seat 6: Squashy22 folded before Flop (didn't bet)



PokerStars Hand #222953558461:  Hold'em No Limit ($0.05/$0.10 USD) - 2021/01/23 8:31:34 ET
Table 'Lutetia III' 6-max Seat #2 is the button
Seat 1: Proper-tilted ($19.39 in chips) 
Seat 2: pernth ($5.85 in chips) 
Seat 3: YuYuYu777 ($10.41 in chips) 
Seat 4: mr_mankut ($10.05 in chips) 
Seat 5: Notatur ($11.97 in chips) 
Seat 6: Squashy22 ($10.52 in chips) 
YuYuYu777: posts small blind $0.05
mr_mankut: posts big blind $0.10
*** HOLE CARDS ***
Notatur: folds 
Squashy22: folds 
Proper-tilted: folds 
pernth: folds 
YuYuYu777: folds 
Uncalled bet ($0.05) returned to mr_mankut
mr_mankut collected $0.10 from pot
mr_mankut: doesn't show hand 
*** SUMMARY ***
Total pot $0.10 | Rake $0 
Seat 1: Proper-tilted folded before Flop (didn't bet)
Seat 2: pernth (button) folded before Flop (didn't bet)
Seat 3: YuYuYu777 (small blind) folded before Flop
Seat 4: mr_mankut (big blind) collected ($0.10)
Seat 5: Notatur folded before Flop (didn't bet)
Seat 6: Squashy22 folded before Flop (didn't bet)



PokerStars Hand #222953562013:  Hold'em No Limit ($0.05/$0.10 USD) - 2021/01/23 8:31:42 ET
Table 'Lutetia III' 6-max Seat #3 is the button
Seat 1: Proper-tilted ($19.39 in chips) 
Seat 2: pernth ($5.85 in chips) 
Seat 3: YuYuYu777 ($10.36 in chips) 
Seat 4: mr_mankut ($10.10 in chips) 
Seat 6: Squashy22 ($10.52 in chips) 
mr_mankut: posts small blind $0.05
Notatur: is sitting out 
Squashy22: posts big blind $0.10
*** HOLE CARDS ***
Proper-tilted: raises $0.20 to $0.30
pernth: folds 
YuYuYu777: folds 
mr_mankut: folds 
Squashy22: folds 
Uncalled bet ($0.20) returned to Proper-tilted
Proper-tilted collected $0.25 from pot
Proper-tilted: doesn't show hand 
*** SUMMARY ***
Total pot $0.25 | Rake $0 
Seat 1: Proper-tilted collected ($0.25)
Seat 2: pernth folded before Flop (didn't bet)
Seat 3: YuYuYu777 (button) folded before Flop (didn't bet)
Seat 4: mr_mankut (small blind) folded before Flop
Seat 6: Squashy22 (big blind) folded before Flop



PokerStars Hand #222953565749:  Hold'em No Limit ($0.05/$0.10 USD) - 2021/01/23 8:31:50 ET
Table 'Lutetia III' 6-max Seat #4 is the button
Seat 1: Proper-tilted ($19.54 in chips) 
Seat 2: pernth ($5.85 in chips) 
Seat 3: YuYuYu777 ($10.36 in chips) 
Seat 4: mr_mankut ($10.05 in chips) 
Seat 6: Squashy22 ($10.42 in chips) 
Squashy22: posts small blind $0.05
Proper-tilted: posts big blind $0.10
*** HOLE CARDS ***
pernth: folds 
YuYuYu777: raises $0.20 to $0.30
mr_mankut: folds 
Squashy22: folds 
Proper-tilted: folds 
Uncalled bet ($0.20) returned to YuYuYu777
YuYuYu777 collected $0.25 from pot
YuYuYu777: doesn't show hand 
*** SUMMARY ***
Total pot $0.25 | Rake $0 
Seat 1: Proper-tilted (big blind) folded before Flop
Seat 2: pernth folded before Flop (didn't bet)
Seat 3: YuYuYu777 collected ($0.25)
Seat 4: mr_mankut (button) folded before Flop (didn't bet)
Seat 6: Squashy22 (small blind) folded before Flop



PokerStars Hand #222953569989:  Hold'em No Limit ($0.05/$0.10 USD) - 2021/01/23 8:32:00 ET
Table 'Lutetia III' 6-max Seat #6 is the button
Seat 1: Proper-tilted ($19.44 in chips) 
Seat 2: pernth ($5.85 in chips) 
Seat 3: YuYuYu777 ($10.51 in chips) 
Seat 4: mr_mankut ($10.05 in chips) 
Seat 6: Squashy22 ($10.37 in chips) 
Proper-tilted: posts small blind $0.05
pernth: posts big blind $0.10
*** HOLE CARDS ***
YuYuYu777: folds 
mr_mankut: raises $0.20 to $0.30
Squashy22: folds 
Proper-tilted: folds 
pernth: folds 
Uncalled bet ($0.20) returned to mr_mankut
mr_mankut collected $0.25 from pot
mr_mankut: doesn't show hand 
*** SUMMARY ***
Total pot $0.25 | Rake $0 
Seat 1: Proper-tilted (small blind) folded before Flop
Seat 2: pernth (big blind) folded before Flop
Seat 3: YuYuYu777 folded before Flop (didn't bet)
Seat 4: mr_mankut collected ($0.25)
Seat 6: Squashy22 (button) folded before Flop (didn't bet)



PokerStars Hand #222953575266:  Hold'em No Limit ($0.05/$0.10 USD) - 2021/01/23 8:32:11 ET
Table 'Lutetia III' 6-max Seat #1 is the button
Seat 1: Proper-tilted ($19.39 in chips) 
Seat 2: pernth ($5.75 in chips) 
Seat 3: YuYuYu777 ($10.51 in chips) 
Seat 4: mr_mankut ($10.20 in chips) 
Seat 6: Squashy22 ($10.37 in chips) 
pernth: posts small blind $0.05
YuYuYu777: posts big blind $0.10
*** HOLE CARDS ***
mr_mankut: raises $0.20 to $0.30
Squashy22: folds 
Proper-tilted: folds 
pernth: folds 
YuYuYu777: folds 
Uncalled bet ($0.20) returned to mr_mankut
mr_mankut collected $0.25 from pot
mr_mankut: doesn't show hand 
*** SUMMARY ***
Total pot $0.25 | Rake $0 
Seat 1: Proper-tilted (button) folded before Flop (didn't bet)
Seat 2: pernth (small blind) folded before Flop
Seat 3: YuYuYu777 (big blind) folded before Flop
Seat 4: mr_mankut collected ($0.25)
Seat 6: Squashy22 folded before Flop (didn't bet)



PokerStars Hand #222953579308:  Hold'em No Limit ($0.05/$0.10 USD) - 2021/01/23 8:32:20 ET
Table 'Lutetia III' 6-max Seat #2 is the button
Seat 1: Proper-tilted ($19.39 in chips) 
Seat 2: pernth ($5.70 in chips) 
Seat 3: YuYuYu777 ($10.41 in chips) 
Seat 4: mr_mankut ($10.35 in chips) 
Seat 6: Squashy22 ($10.37 in chips) 
YuYuYu777: posts small blind $0.05
mr_mankut: posts big blind $0.10
*** HOLE CARDS ***
Squashy22: folds 
Proper-tilted: raises $0.10 to $0.20
pernth: folds 
YuYuYu777: folds 
mr_mankut: calls $0.10
*** FLOP *** [4d 8d 6c]
mr_mankut: checks 
Proper-tilted: checks 
*** TURN *** [4d 8d 6c] [Qc]
mr_mankut: checks 
Proper-tilted: checks 
*** RIVER *** [4d 8d 6c Qc] [3h]
mr_mankut: bets $0.31
Proper-tilted: folds 
Uncalled bet ($0.31) returned to mr_mankut
mr_mankut collected $0.43 from pot
mr_mankut: doesn't show hand 
*** SUMMARY ***
Total pot $0.45 | Rake $0.02 
Board [4d 8d 6c Qc 3h]
Seat 1: Proper-tilted folded on the River
Seat 2: pernth (button) folded before Flop (didn't bet)
Seat 3: YuYuYu777 (small blind) folded before Flop
Seat 4: mr_mankut (big blind) collected ($0.43)
Seat 6: Squashy22 folded before Flop (didn't bet)



PokerStars Hand #222953593245:  Hold'em No Limit ($0.05/$0.10 USD) - 2021/01/23 8:32:52 ET
Table 'Lutetia III' 6-max Seat #3 is the button
Seat 1: Proper-tilted ($19.19 in chips) 
Seat 2: pernth ($5.70 in chips) 
Seat 3: YuYuYu777 ($10.36 in chips) 
Seat 4: mr_mankut ($10.58 in chips) 
Seat 6: Squashy22 ($10.37 in chips) 
mr_mankut: posts small blind $0.05
Squashy22: posts big blind $0.10
*** HOLE CARDS ***
Proper-tilted: raises $0.10 to $0.20
pernth: folds 
YuYuYu777: calls $0.20
mr_mankut: calls $0.15
Squashy22: folds 
*** FLOP *** [Kh 8c 3h]
mr_mankut: checks 
Proper-tilted: checks 
YuYuYu777: checks 
*** TURN *** [Kh 8c 3h] [6c]
mr_mankut: checks 
Proper-tilted: bets $0.33
YuYuYu777: calls $0.33
mr_mankut: folds 
*** RIVER *** [Kh 8c 3h 6c] [5c]
Proper-tilted: bets $0.40
YuYuYu777: calls $0.40
*** SHOW DOWN ***
Proper-tilted: shows [6s Ts] (a pair of Sixes)
YuYuYu777: shows [9s 8h] (a pair of Eights)
YuYuYu777 collected $2.06 from pot
*** SUMMARY ***
Total pot $2.16 | Rake $0.10 
Board [Kh 8c 3h 6c 5c]
Seat 1: Proper-tilted showed [6s Ts] and lost with a pair of Sixes
Seat 2: pernth folded before Flop (didn't bet)
Seat 3: YuYuYu777 (button) showed [9s 8h] and won ($2.06) with a pair of Eights
Seat 4: mr_mankut (small blind) folded on the Turn
Seat 6: Squashy22 (big blind) folded before Flop



PokerStars Hand #222953619360:  Hold'em No Limit ($0.05/$0.10 USD) - 2021/01/23 8:33:50 ET
Table 'Lutetia III' 6-max Seat #4 is the button
Seat 1: Proper-tilted ($18.26 in chips) 
Seat 2: pernth ($5.70 in chips) 
Seat 3: YuYuYu777 ($11.49 in chips) 
Seat 4: mr_mankut ($10.38 in chips) 
Seat 6: Squashy22 ($10.27 in chips) 
Squashy22: posts small blind $0.05
Proper-tilted: posts big blind $0.10
*** HOLE CARDS ***
pernth: folds 
YuYuYu777: raises $0.20 to $0.30
mr_mankut: folds 
Squashy22: folds 
Proper-tilted: folds 
Uncalled bet ($0.20) returned to YuYuYu777
YuYuYu777 collected $0.25 from pot
YuYuYu777: doesn't show hand 
*** SUMMARY ***
Total pot $0.25 | Rake $0 
Seat 1: Proper-tilted (big blind) folded before Flop
Seat 2: pernth folded before Flop (didn't bet)
Seat 3: YuYuYu777 collected ($0.25)
Seat 4: mr_mankut (button) folded before Flop (didn't bet)
Seat 6: Squashy22 (small blind) folded before Flop



PokerStars Hand #222953626125:  Hold'em No Limit ($0.05/$0.10 USD) - 2021/01/23 8:34:05 ET
Table 'Lutetia III' 6-max Seat #6 is the button
Seat 1: Proper-tilted ($18.16 in chips) 
Seat 2: pernth ($5.70 in chips) 
Seat 3: YuYuYu777 ($11.64 in chips) 
Seat 4: mr_mankut ($10.38 in chips) 
Seat 6: Squashy22 ($10.22 in chips) 
Proper-tilted: posts small blind $0.05
pernth: posts big blind $0.10
*** HOLE CARDS ***
YuYuYu777: folds 
mr_mankut: raises $0.20 to $0.30
Squashy22: folds 
Proper-tilted: folds 
pernth: folds 
Uncalled bet ($0.20) returned to mr_mankut
mr_mankut collected $0.25 from pot
mr_mankut: doesn't show hand 
*** SUMMARY ***
Total pot $0.25 | Rake $0 
Seat 1: Proper-tilted (small blind) folded before Flop
Seat 2: pernth (big blind) folded before Flop
Seat 3: YuYuYu777 folded before Flop (didn't bet)
Seat 4: mr_mankut collected ($0.25)
Seat 6: Squashy22 (button) folded before Flop (didn't bet)



PokerStars Hand #222953630186:  Hold'em No Limit ($0.05/$0.10 USD) - 2021/01/23 8:34:14 ET
Table 'Lutetia III' 6-max Seat #1 is the button
Seat 1: Proper-tilted ($18.11 in chips) 
Seat 2: pernth ($5.60 in chips) 
Seat 3: YuYuYu777 ($11.64 in chips) 
Seat 4: mr_mankut ($10.53 in chips) 
Seat 6: Squashy22 ($10.22 in chips) 
pernth: posts small blind $0.05
YuYuYu777: posts big blind $0.10
*** HOLE CARDS ***
mr_mankut: folds 
Squashy22: folds 
mr_mankut leaves the table
Proper-tilted: raises $0.15 to $0.25
pernth: folds 
YuYuYu777: calls $0.15
*** FLOP *** [8c 7d 9s]
YuYuYu777: checks 
Proper-tilted: bets $0.10
YuYuYu777: calls $0.10
*** TURN *** [8c 7d 9s] [Tc]
YuYuYu777: checks 
Proper-tilted: bets $0.10
YuYuYu777: raises $0.92 to $1.02
Mazerpelt joins the table at seat #4 
Proper-tilted: calls $0.92
*** RIVER *** [8c 7d 9s Tc] [Ah]
YuYuYu777: checks 
Proper-tilted: bets $0.30
YuYuYu777: raises $9.97 to $10.27 and is all-in
Proper-tilted: calls $9.97
*** SHOW DOWN ***
YuYuYu777: shows [Jd Qs] (a straight, Eight to Queen)
Proper-tilted: shows [Js Td] (a straight, Seven to Jack)
YuYuYu777 collected $22.28 from pot
*** SUMMARY ***
Total pot $23.33 | Rake $1.05 
Board [8c 7d 9s Tc Ah]
Seat 1: Proper-tilted (button) showed [Js Td] and lost with a straight, Seven to Jack
Seat 2: pernth (small blind) folded before Flop
Seat 3: YuYuYu777 (big blind) showed [Jd Qs] and won ($22.28) with a straight, Eight to Queen
Seat 4: mr_mankut folded before Flop (didn't bet)
Seat 6: Squashy22 folded before Flop (didn't bet)



PokerStars Hand #222953652425:  Hold'em No Limit ($0.05/$0.10 USD) - 2021/01/23 8:35:04 ET
Table 'Lutetia III' 6-max Seat #2 is the button
Seat 1: Proper-tilted ($6.47 in chips) 
Seat 2: pernth ($5.55 in chips) 
Seat 3: YuYuYu777 ($22.28 in chips) 
Seat 4: Mazerpelt ($10 in chips) 
Seat 6: Squashy22 ($10.22 in chips) 
YuYuYu777: posts small blind $0.05
Mazerpelt: posts big blind $0.10
*** HOLE CARDS ***
Squashy22: folds 
Proper-tilted: folds 
pernth: folds 
YuYuYu777: folds 
Uncalled bet ($0.05) returned to Mazerpelt
Mazerpelt collected $0.10 from pot
*** SUMMARY ***
Total pot $0.10 | Rake $0 
Seat 1: Proper-tilted folded before Flop (didn't bet)
Seat 2: pernth (button) folded before Flop (didn't bet)
Seat 3: YuYuYu777 (small blind) folded before Flop
Seat 4: Mazerpelt (big blind) collected ($0.10)
Seat 6: Squashy22 folded before Flop (didn't bet)



PokerStars Hand #222953655992:  Hold'em No Limit ($0.05/$0.10 USD) - 2021/01/23 8:35:12 ET
Table 'Lutetia III' 6-max Seat #3 is the button
Seat 1: Proper-tilted ($6.47 in chips) 
Seat 2: pernth ($5.55 in chips) 
Seat 3: YuYuYu777 ($22.23 in chips) 
Seat 4: Mazerpelt ($10.05 in chips) 
Seat 6: Squashy22 ($10.22 in chips) 
Mazerpelt: posts small blind $0.05
Squashy22: posts big blind $0.10
*** HOLE CARDS ***
Proper-tilted: raises $0.20 to $0.30
pernth: folds 
YuYuYu777: calls $0.30
Mazerpelt: folds 
Squashy22: folds 
*** FLOP *** [Kh 7h 7s]
Proper-tilted: checks 
YuYuYu777: bets $0.54
Proper-tilted: folds 
Uncalled bet ($0.54) returned to YuYuYu777
YuYuYu777 collected $0.72 from pot
YuYuYu777: doesn't show hand 
*** SUMMARY ***
Total pot $0.75 | Rake $0.03 
Board [Kh 7h 7s]
Seat 1: Proper-tilted folded on the Flop
Seat 2: pernth folded before Flop (didn't bet)
Seat 3: YuYuYu777 (button) collected ($0.72)
Seat 4: Mazerpelt (small blind) folded before Flop
Seat 6: Squashy22 (big blind) folded before Flop



PokerStars Hand #222953665055:  Hold'em No Limit ($0.05/$0.10 USD) - 2021/01/23 8:35:33 ET
Table 'Lutetia III' 6-max Seat #4 is the button
Seat 1: Proper-tilted ($6.17 in chips) 
Seat 2: pernth ($5.55 in chips) 
Seat 3: YuYuYu777 ($22.65 in chips) 
Seat 4: Mazerpelt ($10 in chips) 
Seat 6: Squashy22 ($10.12 in chips) 
Squashy22: posts small blind $0.05
Proper-tilted: posts big blind $0.10
*** HOLE CARDS ***
pernth: raises $0.20 to $0.30
YuYuYu777: folds 
Mazerpelt: calls $0.30
Squashy22: folds 
Proper-tilted: calls $0.20
*** FLOP *** [Qs 9h Ks]
Proper-tilted: checks 
pernth: checks 
Mazerpelt: checks 
*** TURN *** [Qs 9h Ks] [8c]
Proper-tilted: checks 
pernth: checks 
Mazerpelt: checks 
*** RIVER *** [Qs 9h Ks 8c] [2c]
Proper-tilted: checks 
pernth: checks 
Mazerpelt: checks 
*** SHOW DOWN ***
Proper-tilted: shows [2h Ac] (a pair of Deuces)
pernth: shows [7h 8h] (a pair of Eights)
Mazerpelt: shows [Ad 9d] (a pair of Nines)
Mazerpelt collected $0.91 from pot
*** SUMMARY ***
Total pot $0.95 | Rake $0.04 
Board [Qs 9h Ks 8c 2c]
Seat 1: Proper-tilted (big blind) showed [2h Ac] and lost with a pair of Deuces
Seat 2: pernth showed [7h 8h] and lost with a pair of Eights
Seat 3: YuYuYu777 folded before Flop (didn't bet)
Seat 4: Mazerpelt (button) showed [Ad 9d] and won ($0.91) with a pair of Nines
Seat 6: Squashy22 (small blind) folded before Flop



PokerStars Hand #222953686456:  Hold'em No Limit ($0.05/$0.10 USD) - 2021/01/23 8:36:21 ET
Table 'Lutetia III' 6-max Seat #6 is the button
Seat 1: Proper-tilted ($5.87 in chips) 
Seat 2: pernth ($5.25 in chips) 
Seat 3: YuYuYu777 ($22.65 in chips) 
Seat 4: Mazerpelt ($10.61 in chips) 
Seat 6: Squashy22 ($10.07 in chips) 
Proper-tilted: posts small blind $0.05
pernth: posts big blind $0.10
*** HOLE CARDS ***
YuYuYu777: folds 
Mazerpelt: folds 
Squashy22: folds 
Proper-tilted: raises $0.10 to $0.20
pernth: calls $0.10
*** FLOP *** [8s 5s 3s]
Proper-tilted: checks 
pernth: bets $0.20
Proper-tilted: folds 
Uncalled bet ($0.20) returned to pernth
pernth collected $0.38 from pot
pernth: doesn't show hand 
*** SUMMARY ***
Total pot $0.40 | Rake $0.02 
Board [8s 5s 3s]
Seat 1: Proper-tilted (small blind) folded on the Flop
Seat 2: pernth (big blind) collected ($0.38)
Seat 3: YuYuYu777 folded before Flop (didn't bet)
Seat 4: Mazerpelt folded before Flop (didn't bet)
Seat 6: Squashy22 (button) folded before Flop (didn't bet)



PokerStars Hand #222953696156:  Hold'em No Limit ($0.05/$0.10 USD) - 2021/01/23 8:36:43 ET
Table 'Lutetia III' 6-max Seat #1 is the button
Seat 1: Proper-tilted ($5.67 in chips) 
Seat 2: pernth ($5.43 in chips) 
Seat 3: YuYuYu777 ($22.65 in chips) 
Seat 4: Mazerpelt ($10.61 in chips) 
Seat 6: Squashy22 ($10.07 in chips) 
pernth: posts small blind $0.05
YuYuYu777: posts big blind $0.10
*** HOLE CARDS ***
Mazerpelt: folds 
Squashy22: folds 
Proper-tilted: folds 
pernth: folds 
Uncalled bet ($0.05) returned to YuYuYu777
YuYuYu777 collected $0.10 from pot
YuYuYu777: doesn't show hand 
*** SUMMARY ***
Total pot $0.10 | Rake $0 
Seat 1: Proper-tilted (button) folded before Flop (didn't bet)
Seat 2: pernth (small blind) folded before Flop
Seat 3: YuYuYu777 (big blind) collected ($0.10)
Seat 4: Mazerpelt folded before Flop (didn't bet)
Seat 6: Squashy22 folded before Flop (didn't bet)



PokerStars Hand #222953700206:  Hold'em No Limit ($0.05/$0.10 USD) - 2021/01/23 8:36:52 ET
Table 'Lutetia III' 6-max Seat #2 is the button
Seat 1: Proper-tilted ($5.67 in chips) 
Seat 2: pernth ($5.38 in chips) 
Seat 3: YuYuYu777 ($22.70 in chips) 
Seat 4: Mazerpelt ($10.61 in chips) 
Seat 6: Squashy22 ($10.07 in chips) 
YuYuYu777: posts small blind $0.05
Mazerpelt: posts big blind $0.10
*** HOLE CARDS ***
Squashy22: folds 
Proper-tilted: raises $0.20 to $0.30
pernth: folds 
YuYuYu777: folds 
Mazerpelt: folds 
Uncalled bet ($0.20) returned to Proper-tilted
Proper-tilted collected $0.25 from pot
Proper-tilted: doesn't show hand 
*** SUMMARY ***
Total pot $0.25 | Rake $0 
Seat 1: Proper-tilted collected ($0.25)
Seat 2: pernth (button) folded before Flop (didn't bet)
Seat 3: YuYuYu777 (small blind) folded before Flop
Seat 4: Mazerpelt (big blind) folded before Flop
Seat 6: Squashy22 folded before Flop (didn't bet)



PokerStars Hand #222953705173:  Hold'em No Limit ($0.05/$0.10 USD) - 2021/01/23 8:37:03 ET
Table 'Lutetia III' 6-max Seat #3 is the button
Seat 1: Proper-tilted ($5.82 in chips) 
Seat 2: pernth ($5.38 in chips) 
Seat 3: YuYuYu777 ($22.65 in chips) 
Seat 4: Mazerpelt ($10.51 in chips) 
Seat 6: Squashy22 ($10.07 in chips) 
Mazerpelt: posts small blind $0.05
Squashy22: posts big blind $0.10
*** HOLE CARDS ***
Proper-tilted: folds 
pernth: folds 
YuYuYu777: folds 
Mazerpelt: raises $0.20 to $0.30
Squashy22: raises $0.60 to $0.90
Mazerpelt: folds 
Uncalled bet ($0.60) returned to Squashy22
Squashy22 collected $0.60 from pot
Notatur was removed from the table for failing to post
Notatur leaves the table
Squashy22: doesn't show hand 
*** SUMMARY ***
Total pot $0.60 | Rake $0 
Seat 1: Proper-tilted folded before Flop (didn't bet)
Seat 2: pernth folded before Flop (didn't bet)
Seat 3: YuYuYu777 (button) folded before Flop (didn't bet)
Seat 4: Mazerpelt (small blind) folded before Flop
Seat 6: Squashy22 (big blind) collected ($0.60)



PokerStars Hand #222953719185:  Hold'em No Limit ($0.05/$0.10 USD) - 2021/01/23 8:37:35 ET
Table 'Lutetia III' 6-max Seat #4 is the button
Seat 1: Proper-tilted ($5.82 in chips) 
Seat 2: pernth ($5.38 in chips) 
Seat 3: YuYuYu777 ($22.65 in chips) 
Seat 4: Mazerpelt ($10.21 in chips) 
Seat 6: Squashy22 ($10.37 in chips) 
Squashy22: posts small blind $0.05
Proper-tilted: posts big blind $0.10
*** HOLE CARDS ***
pernth: raises $0.20 to $0.30
YuYuYu777: calls $0.30
Mazerpelt: folds 
Squashy22: folds 
Proper-tilted: folds 
*** FLOP *** [3d Kh 5c]
pernth: checks 
YuYuYu777: bets $0.36
pernth: calls $0.36
*** TURN *** [3d Kh 5c] [3s]
pernth: checks 
YuYuYu777: bets $0.70
pernth: calls $0.70
*** RIVER *** [3d Kh 5c 3s] [4h]
pernth: bets $2
Metalaito joins the table at seat #5 
YuYuYu777: calls $2
*** SHOW DOWN ***
pernth: shows [5d 5h] (a full house, Fives full of Threes)
YuYuYu777: mucks hand 
pernth collected $6.56 from pot
*** SUMMARY ***
Total pot $6.87 | Rake $0.31 
Board [3d Kh 5c 3s 4h]
Seat 1: Proper-tilted (big blind) folded before Flop
Seat 2: pernth showed [5d 5h] and won ($6.56) with a full house, Fives full of Threes
Seat 3: YuYuYu777 mucked
Seat 4: Mazerpelt (button) folded before Flop (didn't bet)
Seat 6: Squashy22 (small blind) folded before Flop



PokerStars Hand #222953741710:  Hold'em No Limit ($0.05/$0.10 USD) - 2021/01/23 8:38:25 ET
Table 'Lutetia III' 6-max Seat #6 is the button
Seat 1: Proper-tilted ($5.72 in chips) 
Seat 2: pernth ($8.58 in chips) 
Seat 3: YuYuYu777 ($19.29 in chips) 
Seat 4: Mazerpelt ($10.21 in chips) 
Seat 6: Squashy22 ($10.32 in chips) 
Proper-tilted: posts small blind $0.05
pernth: posts big blind $0.10
Metalaito: sits out 
*** HOLE CARDS ***
YuYuYu777: folds 
Mazerpelt: raises $0.20 to $0.30
Squashy22: folds 
Proper-tilted: calls $0.25
pernth: folds 
*** FLOP *** [2h Ah Kc]
Proper-tilted: checks 
Mazerpelt: bets $0.45
Proper-tilted: folds 
Uncalled bet ($0.45) returned to Mazerpelt
Mazerpelt collected $0.67 from pot
*** SUMMARY ***
Total pot $0.70 | Rake $0.03 
Board [2h Ah Kc]
Seat 1: Proper-tilted (small blind) folded on the Flop
Seat 2: pernth (big blind) folded before Flop
Seat 3: YuYuYu777 folded before Flop (didn't bet)
Seat 4: Mazerpelt collected ($0.67)
Seat 6: Squashy22 (button) folded before Flop (didn't bet)



PokerStars Hand #222953753399:  Hold'em No Limit ($0.05/$0.10 USD) - 2021/01/23 8:38:52 ET
Table 'Lutetia III' 6-max Seat #1 is the button
Seat 1: Proper-tilted ($5.42 in chips) 
Seat 2: pernth ($8.48 in chips) 
Seat 3: YuYuYu777 ($19.29 in chips) 
Seat 4: Mazerpelt ($10.58 in chips) 
Seat 6: Squashy22 ($10.32 in chips) 
pernth: posts small blind $0.05
YuYuYu777: posts big blind $0.10
Metalaito: sits out 
*** HOLE CARDS ***
Mazerpelt: folds 
Squashy22: folds 
Proper-tilted: raises $0.10 to $0.20
pernth: folds 
YuYuYu777: raises $0.45 to $0.65
Proper-tilted: calls $0.45
*** FLOP *** [3c 7s 7d]
YuYuYu777: checks 
Proper-tilted: checks 
*** TURN *** [3c 7s 7d] [Qs]
YuYuYu777: checks 
Proper-tilted: checks 
*** RIVER *** [3c 7s 7d Qs] [4s]
YuYuYu777: checks 
Proper-tilted: checks 
*** SHOW DOWN ***
YuYuYu777: shows [8s Ah] (a pair of Sevens)
Proper-tilted: shows [Ac 9s] (a pair of Sevens - Ace+Queen+Nine kicker)
Proper-tilted collected $1.29 from pot
*** SUMMARY ***
Total pot $1.35 | Rake $0.06 
Board [3c 7s 7d Qs 4s]
Seat 1: Proper-tilted (button) showed [Ac 9s] and won ($1.29) with a pair of Sevens
Seat 2: pernth (small blind) folded before Flop
Seat 3: YuYuYu777 (big blind) showed [8s Ah] and lost with a pair of Sevens
Seat 4: Mazerpelt folded before Flop (didn't bet)
Seat 6: Squashy22 folded before Flop (didn't bet)



PokerStars Hand #222953773824:  Hold'em No Limit ($0.05/$0.10 USD) - 2021/01/23 8:39:37 ET
Table 'Lutetia III' 6-max Seat #2 is the button
Seat 1: Proper-tilted ($6.06 in chips) 
Seat 2: pernth ($8.43 in chips) 
Seat 3: YuYuYu777 ($18.64 in chips) 
Seat 4: Mazerpelt ($10.58 in chips) 
Seat 6: Squashy22 ($10.32 in chips) 
YuYuYu777: posts small blind $0.05
Mazerpelt: posts big blind $0.10
Metalaito: sits out 
*** HOLE CARDS ***
Squashy22: folds 
Proper-tilted: raises $0.10 to $0.20
pernth: folds 
YuYuYu777: folds 
Mazerpelt: calls $0.10
*** FLOP *** [Th 2h 7s]
Mazerpelt: checks 
Proper-tilted: bets $0.30
Mazerpelt: folds 
Uncalled bet ($0.30) returned to Proper-tilted
Proper-tilted collected $0.43 from pot
Proper-tilted: doesn't show hand 
*** SUMMARY ***
Total pot $0.45 | Rake $0.02 
Board [Th 2h 7s]
Seat 1: Proper-tilted collected ($0.43)
Seat 2: pernth (button) folded before Flop (didn't bet)
Seat 3: YuYuYu777 (small blind) folded before Flop
Seat 4: Mazerpelt (big blind) folded on the Flop
Seat 6: Squashy22 folded before Flop (didn't bet)



PokerStars Hand #222953788454:  Hold'em No Limit ($0.05/$0.10 USD) - 2021/01/23 8:40:10 ET
Table 'Lutetia III' 6-max Seat #3 is the button
Seat 1: Proper-tilted ($6.29 in chips) 
Seat 2: pernth ($8.43 in chips) 
Seat 3: YuYuYu777 ($18.59 in chips) 
Seat 4: Mazerpelt ($10.38 in chips) 
Seat 5: Metalaito ($10 in chips) 
Seat 6: Squashy22 ($10.32 in chips) 
Mazerpelt: posts small blind $0.05
Metalaito: posts big blind $0.10
*** HOLE CARDS ***
Squashy22: folds 
Proper-tilted: folds 
pernth: calls $0.10
YuYuYu777: folds 
Mazerpelt: folds 
Metalaito: checks 
*** FLOP *** [7h Ad Ac]
Metalaito: checks 
pernth: checks 
*** TURN *** [7h Ad Ac] [Jd]
Metalaito: checks 
pernth: checks 
*** RIVER *** [7h Ad Ac Jd] [3d]
Metalaito: checks 
pernth: checks 
*** SHOW DOWN ***
Metalaito: shows [4h Js] (two pair, Aces and Jacks)
pernth: mucks hand 
Metalaito collected $0.24 from pot
*** SUMMARY ***
Total pot $0.25 | Rake $0.01 
Board [7h Ad Ac Jd 3d]
Seat 1: Proper-tilted folded before Flop (didn't bet)
Seat 2: pernth mucked
Seat 3: YuYuYu777 (button) folded before Flop (didn't bet)
Seat 4: Mazerpelt (small blind) folded before Flop
Seat 5: Metalaito (big blind) showed [4h Js] and won ($0.24) with two pair, Aces and Jacks
Seat 6: Squashy22 folded before Flop (didn't bet)



PokerStars Hand #222953809201:  Hold'em No Limit ($0.05/$0.10 USD) - 2021/01/23 8:40:56 ET
Table 'Lutetia III' 6-max Seat #4 is the button
Seat 1: Proper-tilted ($6.29 in chips) 
Seat 2: pernth ($8.33 in chips) 
Seat 3: YuYuYu777 ($18.59 in chips) 
Seat 4: Mazerpelt ($10.33 in chips) 
Seat 5: Metalaito ($10.14 in chips) 
Seat 6: Squashy22 ($10.32 in chips) 
Metalaito: posts small blind $0.05
Squashy22: posts big blind $0.10
*** HOLE CARDS ***
Proper-tilted: raises $0.20 to $0.30
pernth: calls $0.30
YuYuYu777: folds 
Mazerpelt: folds 
Metalaito: calls $0.25
Squashy22: folds 
*** FLOP *** [6c Kc 5s]
Metalaito: checks 
Proper-tilted: bets $0.48
pernth: calls $0.48
Metalaito: folds 
*** TURN *** [6c Kc 5s] [9c]
Proper-tilted: checks 
pernth: checks 
*** RIVER *** [6c Kc 5s 9c] [7d]
Proper-tilted: bets $0.10
pernth: calls $0.10
*** SHOW DOWN ***
Proper-tilted: shows [6d 6s] (three of a kind, Sixes)
pernth: mucks hand 
Proper-tilted collected $2.06 from pot
*** SUMMARY ***
Total pot $2.16 | Rake $0.10 
Board [6c Kc 5s 9c 7d]
Seat 1: Proper-tilted showed [6d 6s] and won ($2.06) with three of a kind, Sixes
Seat 2: pernth mucked
Seat 3: YuYuYu777 folded before Flop (didn't bet)
Seat 4: Mazerpelt (button) folded before Flop (didn't bet)
Seat 5: Metalaito (small blind) folded on the Flop
Seat 6: Squashy22 (big blind) folded before Flop



PokerStars Hand #222953833066:  Hold'em No Limit ($0.05/$0.10 USD) - 2021/01/23 8:41:49 ET
Table 'Lutetia III' 6-max Seat #5 is the button
Seat 1: Proper-tilted ($7.47 in chips) 
Seat 2: pernth ($7.45 in chips) 
Seat 3: YuYuYu777 ($18.59 in chips) 
Seat 4: Mazerpelt ($10.33 in chips) 
Seat 5: Metalaito ($10 in chips) 
Seat 6: Squashy22 ($10.22 in chips) 
Squashy22: posts small blind $0.05
Proper-tilted: posts big blind $0.10
*** HOLE CARDS ***
pernth: folds 
YuYuYu777: raises $0.20 to $0.30
Mazerpelt: folds 
Metalaito: folds 
Squashy22: folds 
Proper-tilted: folds 
Uncalled bet ($0.20) returned to YuYuYu777
YuYuYu777 collected $0.25 from pot
YuYuYu777: doesn't show hand 
*** SUMMARY ***
Total pot $0.25 | Rake $0 
Seat 1: Proper-tilted (big blind) folded before Flop
Seat 2: pernth folded before Flop (didn't bet)
Seat 3: YuYuYu777 collected ($0.25)
Seat 4: Mazerpelt folded before Flop (didn't bet)
Seat 5: Metalaito (button) folded before Flop (didn't bet)
Seat 6: Squashy22 (small blind) folded before Flop



PokerStars Hand #222953837636:  Hold'em No Limit ($0.05/$0.10 USD) - 2021/01/23 8:42:00 ET
Table 'Lutetia III' 6-max Seat #6 is the button
Seat 1: Proper-tilted ($7.37 in chips) 
Seat 2: pernth ($7.45 in chips) 
Seat 3: YuYuYu777 ($18.74 in chips) 
Seat 4: Mazerpelt ($10.33 in chips) 
Seat 5: Metalaito ($10 in chips) 
Seat 6: Squashy22 ($10.17 in chips) 
Proper-tilted: posts small blind $0.05
pernth: posts big blind $0.10
*** HOLE CARDS ***
YuYuYu777: raises $0.20 to $0.30
Mazerpelt: folds 
Metalaito: folds 
Squashy22: folds 
Proper-tilted: calls $0.25
pernth: folds 
*** FLOP *** [Td Ah Qh]
Proper-tilted: checks 
YuYuYu777: bets $0.34
Proper-tilted: calls $0.34
*** TURN *** [Td Ah Qh] [4s]
Proper-tilted: checks 
YuYuYu777: checks 
*** RIVER *** [Td Ah Qh 4s] [5c]
Proper-tilted: bets $0.70
YuYuYu777: raises $17.40 to $18.10 and is all-in
Proper-tilted: folds 
Uncalled bet ($17.40) returned to YuYuYu777
YuYuYu777 collected $2.65 from pot
YuYuYu777: doesn't show hand 
*** SUMMARY ***
Total pot $2.78 | Rake $0.13 
Board [Td Ah Qh 4s 5c]
Seat 1: Proper-tilted (small blind) folded on the River
Seat 2: pernth (big blind) folded before Flop
Seat 3: YuYuYu777 collected ($2.65)
Seat 4: Mazerpelt folded before Flop (didn't bet)
Seat 5: Metalaito folded before Flop (didn't bet)
Seat 6: Squashy22 (button) folded before Flop (didn't bet)



PokerStars Hand #222953863804:  Hold'em No Limit ($0.05/$0.10 USD) - 2021/01/23 8:42:55 ET
Table 'Lutetia III' 6-max Seat #1 is the button
Seat 1: Proper-tilted ($6.03 in chips) 
Seat 2: pernth ($7.35 in chips) 
Seat 3: YuYuYu777 ($20.05 in chips) 
Seat 4: Mazerpelt ($10.33 in chips) 
Seat 5: Metalaito ($10 in chips) 
Seat 6: Squashy22 ($10.17 in chips) 
pernth: posts small blind $0.05
YuYuYu777: posts big blind $0.10
*** HOLE CARDS ***
Mazerpelt: raises $0.20 to $0.30
Metalaito: folds 
Squashy22: folds 
Proper-tilted: folds 
pernth: folds 
YuYuYu777: folds 
Uncalled bet ($0.20) returned to Mazerpelt
Mazerpelt collected $0.25 from pot
*** SUMMARY ***
Total pot $0.25 | Rake $0 
Seat 1: Proper-tilted (button) folded before Flop (didn't bet)
Seat 2: pernth (small blind) folded before Flop
Seat 3: YuYuYu777 (big blind) folded before Flop
Seat 4: Mazerpelt collected ($0.25)
Seat 5: Metalaito folded before Flop (didn't bet)
Seat 6: Squashy22 folded before Flop (didn't bet)



PokerStars Hand #222953868904:  Hold'em No Limit ($0.05/$0.10 USD) - 2021/01/23 8:43:06 ET
Table 'Lutetia III' 6-max Seat #2 is the button
Seat 1: Proper-tilted ($6.03 in chips) 
Seat 2: pernth ($7.30 in chips) 
Seat 3: YuYuYu777 ($19.95 in chips) 
Seat 4: Mazerpelt ($10.48 in chips) 
Seat 5: Metalaito ($10 in chips) 
Seat 6: Squashy22 ($10.17 in chips) 
YuYuYu777: posts small blind $0.05
Mazerpelt: posts big blind $0.10
*** HOLE CARDS ***
Metalaito: folds 
Squashy22: folds 
Proper-tilted: folds 
pernth: folds 
YuYuYu777: folds 
Uncalled bet ($0.05) returned to Mazerpelt
Mazerpelt collected $0.10 from pot
*** SUMMARY ***
Total pot $0.10 | Rake $0 
Seat 1: Proper-tilted folded before Flop (didn't bet)
Seat 2: pernth (button) folded before Flop (didn't bet)
Seat 3: YuYuYu777 (small blind) folded before Flop
Seat 4: Mazerpelt (big blind) collected ($0.10)
Seat 5: Metalaito folded before Flop (didn't bet)
Seat 6: Squashy22 folded before Flop (didn't bet)



PokerStars Hand #222953874345:  Hold'em No Limit ($0.05/$0.10 USD) - 2021/01/23 8:43:18 ET
Table 'Lutetia III' 6-max Seat #3 is the button
Seat 1: Proper-tilted ($6.03 in chips) 
Seat 2: pernth ($7.30 in chips) 
Seat 3: YuYuYu777 ($19.90 in chips) 
Seat 4: Mazerpelt ($10.53 in chips) 
Seat 5: Metalaito ($10 in chips) 
Seat 6: Squashy22 ($10.17 in chips) 
Mazerpelt: posts small blind $0.05
Metalaito: posts big blind $0.10
*** HOLE CARDS ***
Squashy22: folds 
Proper-tilted: folds 
pernth: folds 
YuYuYu777: raises $0.20 to $0.30
Mazerpelt: folds 
Metalaito: folds 
Uncalled bet ($0.20) returned to YuYuYu777
YuYuYu777 collected $0.25 from pot
YuYuYu777: doesn't show hand 
*** SUMMARY ***
Total pot $0.25 | Rake $0 
Seat 1: Proper-tilted folded before Flop (didn't bet)
Seat 2: pernth folded before Flop (didn't bet)
Seat 3: YuYuYu777 (button) collected ($0.25)
Seat 4: Mazerpelt (small blind) folded before Flop
Seat 5: Metalaito (big blind) folded before Flop
Seat 6: Squashy22 folded before Flop (didn't bet)



PokerStars Hand #222953878340:  Hold'em No Limit ($0.05/$0.10 USD) - 2021/01/23 8:43:27 ET
Table 'Lutetia III' 6-max Seat #4 is the button
Seat 1: Proper-tilted ($6.03 in chips) 
Seat 2: pernth ($7.30 in chips) 
Seat 3: YuYuYu777 ($20.05 in chips) 
Seat 4: Mazerpelt ($10.48 in chips) 
Seat 5: Metalaito ($10 in chips) 
Seat 6: Squashy22 ($10.17 in chips) 
Metalaito: posts small blind $0.05
Squashy22: posts big blind $0.10
*** HOLE CARDS ***
Proper-tilted: folds 
pernth: folds 
YuYuYu777: folds 
Mazerpelt: folds 
Metalaito: folds 
Uncalled bet ($0.05) returned to Squashy22
Squashy22 collected $0.10 from pot
Squashy22: doesn't show hand 
*** SUMMARY ***
Total pot $0.10 | Rake $0 
Seat 1: Proper-tilted folded before Flop (didn't bet)
Seat 2: pernth folded before Flop (didn't bet)
Seat 3: YuYuYu777 folded before Flop (didn't bet)
Seat 4: Mazerpelt (button) folded before Flop (didn't bet)
Seat 5: Metalaito (small blind) folded before Flop
Seat 6: Squashy22 (big blind) collected ($0.10)



PokerStars Hand #222955569791:  Hold'em No Limit ($0.05/$0.10 USD) - 2021/01/23 9:42:14 ET
Table 'Lutetia III' 6-max Seat #6 is the button
Seat 1: Calltossen ($18.94 in chips) 
Seat 2: Kimi1892 ($10 in chips) 
Seat 4: PokerPro EPT ($8.84 in chips) 
Seat 5: KingBiscuitT ($12.22 in chips) 
Seat 6: Squashy22 ($10 in chips) 
Calltossen: posts small blind $0.05
Kimi1892: posts big blind $0.10
Darkhorse2205: sits out 
*** HOLE CARDS ***
PokerPro EPT: calls $0.10
KingBiscuitT: raises $0.40 to $0.50
Squashy22: folds 
Calltossen: folds 
Kimi1892: folds 
PokerPro EPT: folds 
Uncalled bet ($0.40) returned to KingBiscuitT
KingBiscuitT collected $0.35 from pot
KingBiscuitT: doesn't show hand 
*** SUMMARY ***
Total pot $0.35 | Rake $0 
Seat 1: Calltossen (small blind) folded before Flop
Seat 2: Kimi1892 (big blind) folded before Flop
Seat 4: PokerPro EPT folded before Flop
Seat 5: KingBiscuitT collected ($0.35)
Seat 6: Squashy22 (button) folded before Flop (didn't bet)



PokerStars Hand #222955579410:  Hold'em No Limit ($0.05/$0.10 USD) - 2021/01/23 9:42:34 ET
Table 'Lutetia III' 6-max Seat #1 is the button
Seat 1: Calltossen ($18.89 in chips) 
Seat 2: Kimi1892 ($10 in chips) 
Seat 3: Darkhorse2205 ($4 in chips) 
Seat 4: PokerPro EPT ($8.74 in chips) 
Seat 5: KingBiscuitT ($12.47 in chips) 
Seat 6: Squashy22 ($10 in chips) 
Kimi1892: posts small blind $0.05
Darkhorse2205: posts big blind $0.10
*** HOLE CARDS ***
PokerPro EPT: folds 
KingBiscuitT: folds 
Squashy22: folds 
Calltossen: raises $0.25 to $0.35
Kimi1892: folds 
Darkhorse2205: calls $0.25
*** FLOP *** [5c Jc Th]
Darkhorse2205: checks 
Calltossen: checks 
*** TURN *** [5c Jc Th] [9d]
Darkhorse2205: checks 
Calltossen: checks 
*** RIVER *** [5c Jc Th 9d] [9s]
Darkhorse2205: checks 
Calltossen: checks 
*** SHOW DOWN ***
Darkhorse2205: shows [9h 8h] (three of a kind, Nines)
Calltossen: mucks hand 
Darkhorse2205 collected $0.72 from pot
*** SUMMARY ***
Total pot $0.75 | Rake $0.03 
Board [5c Jc Th 9d 9s]
Seat 1: Calltossen (button) mucked
Seat 2: Kimi1892 (small blind) folded before Flop
Seat 3: Darkhorse2205 (big blind) showed [9h 8h] and won ($0.72) with three of a kind, Nines
Seat 4: PokerPro EPT folded before Flop (didn't bet)
Seat 5: KingBiscuitT folded before Flop (didn't bet)
Seat 6: Squashy22 folded before Flop (didn't bet)



PokerStars Hand #222955597272:  Hold'em No Limit ($0.05/$0.10 USD) - 2021/01/23 9:43:09 ET
Table 'Lutetia III' 6-max Seat #2 is the button
Seat 1: Calltossen ($18.54 in chips) 
Seat 2: Kimi1892 ($10 in chips) 
Seat 3: Darkhorse2205 ($4.37 in chips) 
Seat 4: PokerPro EPT ($8.74 in chips) 
Seat 5: KingBiscuitT ($12.47 in chips) 
Seat 6: Squashy22 ($10 in chips) 
Darkhorse2205: posts small blind $0.05
PokerPro EPT: posts big blind $0.10
*** HOLE CARDS ***
KingBiscuitT: folds 
Squashy22: folds 
Calltossen: raises $0.20 to $0.30
Kimi1892: folds 
Darkhorse2205: calls $0.25
PokerPro EPT: calls $0.20
*** FLOP *** [4d 6d 6s]
Darkhorse2205: checks 
PokerPro EPT: bets $0.30
Calltossen: calls $0.30
Darkhorse2205: folds 
*** TURN *** [4d 6d 6s] [Ah]
PokerPro EPT: bets $1.21
Calltossen: folds 
Uncalled bet ($1.21) returned to PokerPro EPT
PokerPro EPT collected $1.43 from pot
PokerPro EPT: doesn't show hand 
*** SUMMARY ***
Total pot $1.50 | Rake $0.07 
Board [4d 6d 6s Ah]
Seat 1: Calltossen folded on the Turn
Seat 2: Kimi1892 (button) folded before Flop (didn't bet)
Seat 3: Darkhorse2205 (small blind) folded on the Flop
Seat 4: PokerPro EPT (big blind) collected ($1.43)
Seat 5: KingBiscuitT folded before Flop (didn't bet)
Seat 6: Squashy22 folded before Flop (didn't bet)



PokerStars Hand #222955621486:  Hold'em No Limit ($0.05/$0.10 USD) - 2021/01/23 9:43:58 ET
Table 'Lutetia III' 6-max Seat #3 is the button
Seat 1: Calltossen ($17.94 in chips) 
Seat 2: Kimi1892 ($10 in chips) 
Seat 3: Darkhorse2205 ($4.07 in chips) 
Seat 4: PokerPro EPT ($9.57 in chips) 
Seat 5: KingBiscuitT ($12.47 in chips) 
Seat 6: Squashy22 ($10 in chips) 
PokerPro EPT: posts small blind $0.05
KingBiscuitT: posts big blind $0.10
*** HOLE CARDS ***
Squashy22: folds 
Calltossen: raises $0.20 to $0.30
Kimi1892: folds 
Darkhorse2205: raises $0.20 to $0.50
PokerPro EPT: folds 
KingBiscuitT: folds 
Calltossen: raises $17.44 to $17.94 and is all-in
Darkhorse2205: calls $3.57 and is all-in
Uncalled bet ($13.87) returned to Calltossen
*** FLOP *** [4h 8c 4s]
*** TURN *** [4h 8c 4s] [8d]
*** RIVER *** [4h 8c 4s 8d] [Ac]
*** SHOW DOWN ***
Calltossen: shows [Qs Qd] (two pair, Queens and Eights)
Darkhorse2205: shows [Kc Kh] (two pair, Kings and Eights)
Darkhorse2205 collected $7.92 from pot
*** SUMMARY ***
Total pot $8.29 | Rake $0.37 
Board [4h 8c 4s 8d Ac]
Seat 1: Calltossen showed [Qs Qd] and lost with two pair, Queens and Eights
Seat 2: Kimi1892 folded before Flop (didn't bet)
Seat 3: Darkhorse2205 (button) showed [Kc Kh] and won ($7.92) with two pair, Kings and Eights
Seat 4: PokerPro EPT (small blind) folded before Flop
Seat 5: KingBiscuitT (big blind) folded before Flop
Seat 6: Squashy22 folded before Flop (didn't bet)



PokerStars Hand #222955641590:  Hold'em No Limit ($0.05/$0.10 USD) - 2021/01/23 9:44:38 ET
Table 'Lutetia III' 6-max Seat #4 is the button
Seat 1: Calltossen ($13.87 in chips) 
Seat 2: Kimi1892 ($10 in chips) 
Seat 3: Darkhorse2205 ($7.92 in chips) 
Seat 4: PokerPro EPT ($9.52 in chips) 
Seat 5: KingBiscuitT ($12.37 in chips) 
KingBiscuitT: posts small blind $0.05
Squashy22: is sitting out 
Calltossen: posts big blind $0.10
*** HOLE CARDS ***
Squashy22 leaves the table
Kimi1892: folds 
Darkhorse2205: folds 
alex7512007 joins the table at seat #6 
PokerPro EPT: raises $0.20 to $0.30
KingBiscuitT: folds 
Calltossen: folds 
Uncalled bet ($0.20) returned to PokerPro EPT
PokerPro EPT collected $0.25 from pot
PokerPro EPT: doesn't show hand 
*** SUMMARY ***
Total pot $0.25 | Rake $0 
Seat 1: Calltossen (big blind) folded before Flop
Seat 2: Kimi1892 folded before Flop (didn't bet)
Seat 3: Darkhorse2205 folded before Flop (didn't bet)
Seat 4: PokerPro EPT (button) collected ($0.25)
Seat 5: KingBiscuitT (small blind) folded before Flop



PokerStars Hand #222955647487:  Hold'em No Limit ($0.05/$0.10 USD) - 2021/01/23 9:44:50 ET
Table 'Lutetia III' 6-max Seat #5 is the button
Seat 1: Calltossen ($13.77 in chips) 
Seat 2: Kimi1892 ($10 in chips) 
Seat 3: Darkhorse2205 ($7.92 in chips) 
Seat 4: PokerPro EPT ($9.67 in chips) 
Seat 5: KingBiscuitT ($12.32 in chips) 
Calltossen: posts small blind $0.05
Kimi1892: posts big blind $0.10
*** HOLE CARDS ***
Darkhorse2205: folds 
PokerPro EPT: calls $0.10
KingBiscuitT: folds 
Calltossen: folds 
Kimi1892: checks 
*** FLOP *** [9c 8c Th]
Kimi1892: checks 
PokerPro EPT: checks 
*** TURN *** [9c 8c Th] [6c]
Kimi1892: checks 
PokerPro EPT: bets $0.20
Kimi1892: calls $0.20
*** RIVER *** [9c 8c Th 6c] [Ks]
Kimi1892: checks 
PokerPro EPT: checks 
*** SHOW DOWN ***
Kimi1892: shows [7d 5c] (a straight, Six to Ten)
PokerPro EPT: mucks hand 
Kimi1892 collected $0.62 from pot
*** SUMMARY ***
Total pot $0.65 | Rake $0.03 
Board [9c 8c Th 6c Ks]
Seat 1: Calltossen (small blind) folded before Flop
Seat 2: Kimi1892 (big blind) showed [7d 5c] and won ($0.62) with a straight, Six to Ten
Seat 3: Darkhorse2205 folded before Flop (didn't bet)
Seat 4: PokerPro EPT mucked
Seat 5: KingBiscuitT (button) folded before Flop (didn't bet)



PokerStars Hand #222955664970:  Hold'em No Limit ($0.05/$0.10 USD) - 2021/01/23 9:45:24 ET
Table 'Lutetia III' 6-max Seat #1 is the button
Seat 1: Calltossen ($13.72 in chips) 
Seat 2: Kimi1892 ($10.32 in chips) 
Seat 3: Darkhorse2205 ($7.92 in chips) 
Seat 4: PokerPro EPT ($9.37 in chips) 
Seat 5: KingBiscuitT ($12.32 in chips) 
Kimi1892: posts small blind $0.05
Darkhorse2205: posts big blind $0.10
alex7512007: sits out 
*** HOLE CARDS ***
PokerPro EPT: raises $0.20 to $0.30
KingBiscuitT: folds 
Calltossen: folds 
Kimi1892: folds 
Darkhorse2205: calls $0.20
*** FLOP *** [2h Jc 2s]
Darkhorse2205: checks 
PokerPro EPT: checks 
*** TURN *** [2h Jc 2s] [2c]
Darkhorse2205: checks 
PokerPro EPT: bets $0.20
Darkhorse2205: calls $0.20
*** RIVER *** [2h Jc 2s 2c] [4c]
Darkhorse2205: checks 
PokerPro EPT: bets $0.73
Darkhorse2205: folds 
Uncalled bet ($0.73) returned to PokerPro EPT
PokerPro EPT collected $1 from pot
PokerPro EPT: doesn't show hand 
*** SUMMARY ***
Total pot $1.05 | Rake $0.05 
Board [2h Jc 2s 2c 4c]
Seat 1: Calltossen (button) folded before Flop (didn't bet)
Seat 2: Kimi1892 (small blind) folded before Flop
Seat 3: Darkhorse2205 (big blind) folded on the River
Seat 4: PokerPro EPT collected ($1)
Seat 5: KingBiscuitT folded before Flop (didn't bet)



PokerStars Hand #222955686417:  Hold'em No Limit ($0.05/$0.10 USD) - 2021/01/23 9:46:07 ET
Table 'Lutetia III' 6-max Seat #2 is the button
Seat 1: Calltossen ($13.72 in chips) 
Seat 2: Kimi1892 ($10.27 in chips) 
Seat 3: Darkhorse2205 ($7.42 in chips) 
Seat 4: PokerPro EPT ($9.87 in chips) 
Seat 5: KingBiscuitT ($12.32 in chips) 
Darkhorse2205: posts small blind $0.05
PokerPro EPT: posts big blind $0.10
alex7512007: sits out 
*** HOLE CARDS ***
KingBiscuitT: folds 
Calltossen: folds 
Kimi1892: raises $0.15 to $0.25
Darkhorse2205: calls $0.20
PokerPro EPT: calls $0.15
*** FLOP *** [Tc 3c 9d]
Darkhorse2205: checks 
PokerPro EPT: checks 
Kimi1892: bets $0.37
Darkhorse2205: folds 
PokerPro EPT: folds 
Uncalled bet ($0.37) returned to Kimi1892
Kimi1892 collected $0.72 from pot
Kimi1892: doesn't show hand 
*** SUMMARY ***
Total pot $0.75 | Rake $0.03 
Board [Tc 3c 9d]
Seat 1: Calltossen folded before Flop (didn't bet)
Seat 2: Kimi1892 (button) collected ($0.72)
Seat 3: Darkhorse2205 (small blind) folded on the Flop
Seat 4: PokerPro EPT (big blind) folded on the Flop
Seat 5: KingBiscuitT folded before Flop (didn't bet)



PokerStars Hand #222955702407:  Hold'em No Limit ($0.05/$0.10 USD) - 2021/01/23 9:46:38 ET
Table 'Lutetia III' 6-max Seat #3 is the button
Seat 1: Calltossen ($13.72 in chips) 
Seat 2: Kimi1892 ($10.74 in chips) 
Seat 3: Darkhorse2205 ($7.17 in chips) 
Seat 4: PokerPro EPT ($9.62 in chips) 
Seat 5: KingBiscuitT ($12.32 in chips) 
PokerPro EPT: posts small blind $0.05
KingBiscuitT: posts big blind $0.10
alex7512007: sits out 
*** HOLE CARDS ***
Calltossen: folds 
Kimi1892: folds 
Darkhorse2205: folds 
PokerPro EPT: calls $0.05
KingBiscuitT: checks 
*** FLOP *** [8d Qc Qh]
PokerPro EPT: checks 
KingBiscuitT: checks 
*** TURN *** [8d Qc Qh] [3c]
PokerPro EPT: bets $0.10
KingBiscuitT: folds 
Uncalled bet ($0.10) returned to PokerPro EPT
PokerPro EPT collected $0.19 from pot
PokerPro EPT: doesn't show hand 
*** SUMMARY ***
Total pot $0.20 | Rake $0.01 
Board [8d Qc Qh 3c]
Seat 1: Calltossen folded before Flop (didn't bet)
Seat 2: Kimi1892 folded before Flop (didn't bet)
Seat 3: Darkhorse2205 (button) folded before Flop (didn't bet)
Seat 4: PokerPro EPT (small blind) collected ($0.19)
Seat 5: KingBiscuitT (big blind) folded on the Turn



PokerStars Hand #222955718797:  Hold'em No Limit ($0.05/$0.10 USD) - 2021/01/23 9:47:10 ET
Table 'Lutetia III' 6-max Seat #4 is the button
Seat 1: Calltossen ($13.72 in chips) 
Seat 2: Kimi1892 ($10.74 in chips) 
Seat 3: Darkhorse2205 ($7.17 in chips) 
Seat 4: PokerPro EPT ($9.71 in chips) 
Seat 5: KingBiscuitT ($12.22 in chips) 
Seat 6: alex7512007 ($4 in chips) 
KingBiscuitT: posts small blind $0.05
alex7512007: posts big blind $0.10
*** HOLE CARDS ***
Calltossen: folds 
Kimi1892: folds 
Darkhorse2205: folds 
PokerPro EPT: calls $0.10
KingBiscuitT: folds 
alex7512007: checks 
*** FLOP *** [9s Kd Ac]
alex7512007: checks 
PokerPro EPT: bets $0.20
alex7512007: calls $0.20
*** TURN *** [9s Kd Ac] [Ah]
alex7512007: checks 
PokerPro EPT: checks 
*** RIVER *** [9s Kd Ac Ah] [2c]
alex7512007: bets $0.41
PokerPro EPT: folds 
Uncalled bet ($0.41) returned to alex7512007
alex7512007 collected $0.62 from pot
*** SUMMARY ***
Total pot $0.65 | Rake $0.03 
Board [9s Kd Ac Ah 2c]
Seat 1: Calltossen folded before Flop (didn't bet)
Seat 2: Kimi1892 folded before Flop (didn't bet)
Seat 3: Darkhorse2205 folded before Flop (didn't bet)
Seat 4: PokerPro EPT (button) folded on the River
Seat 5: KingBiscuitT (small blind) folded before Flop
Seat 6: alex7512007 (big blind) collected ($0.62)



PokerStars Hand #222955733468:  Hold'em No Limit ($0.05/$0.10 USD) - 2021/01/23 9:47:39 ET
Table 'Lutetia III' 6-max Seat #5 is the button
Seat 1: Calltossen ($13.72 in chips) 
Seat 2: Kimi1892 ($10.74 in chips) 
Seat 3: Darkhorse2205 ($7.17 in chips) 
Seat 4: PokerPro EPT ($9.41 in chips) 
Seat 5: KingBiscuitT ($12.17 in chips) 
Seat 6: alex7512007 ($4.32 in chips) 
alex7512007: posts small blind $0.05
Calltossen: posts big blind $0.10
*** HOLE CARDS ***
Kimi1892: folds 
Darkhorse2205: folds 
PokerPro EPT: calls $0.10
KingBiscuitT: raises $0.40 to $0.50
alex7512007: raises $1.60 to $2.10
Calltossen: folds 
PokerPro EPT: folds 
KingBiscuitT: folds 
Uncalled bet ($1.60) returned to alex7512007
alex7512007 collected $1.20 from pot
*** SUMMARY ***
Total pot $1.20 | Rake $0 
Seat 1: Calltossen (big blind) folded before Flop
Seat 2: Kimi1892 folded before Flop (didn't bet)
Seat 3: Darkhorse2205 folded before Flop (didn't bet)
Seat 4: PokerPro EPT folded before Flop
Seat 5: KingBiscuitT (button) folded before Flop
Seat 6: alex7512007 (small blind) collected ($1.20)



PokerStars Hand #222955745296:  Hold'em No Limit ($0.05/$0.10 USD) - 2021/01/23 9:48:02 ET
Table 'Lutetia III' 6-max Seat #6 is the button
Seat 1: Calltossen ($13.62 in chips) 
Seat 2: Kimi1892 ($10.74 in chips) 
Seat 3: Darkhorse2205 ($7.17 in chips) 
Seat 4: PokerPro EPT ($9.31 in chips) 
Seat 5: KingBiscuitT ($11.67 in chips) 
Seat 6: alex7512007 ($5.02 in chips) 
Calltossen: posts small blind $0.05
Kimi1892: posts big blind $0.10
*** HOLE CARDS ***
Darkhorse2205: folds 
PokerPro EPT: calls $0.10
KingBiscuitT: folds 
alex7512007: folds 
Calltossen: folds 
Kimi1892: checks 
*** FLOP *** [Js 4c 4h]
Kimi1892: checks 
PokerPro EPT: bets $0.20
Kimi1892: folds 
Uncalled bet ($0.20) returned to PokerPro EPT
PokerPro EPT collected $0.24 from pot
PokerPro EPT: doesn't show hand 
*** SUMMARY ***
Total pot $0.25 | Rake $0.01 
Board [Js 4c 4h]
Seat 1: Calltossen (small blind) folded before Flop
Seat 2: Kimi1892 (big blind) folded on the Flop
Seat 3: Darkhorse2205 folded before Flop (didn't bet)
Seat 4: PokerPro EPT collected ($0.24)
Seat 5: KingBiscuitT folded before Flop (didn't bet)
Seat 6: alex7512007 (button) folded before Flop (didn't bet)



PokerStars Hand #222955755955:  Hold'em No Limit ($0.05/$0.10 USD) - 2021/01/23 9:48:23 ET
Table 'Lutetia III' 6-max Seat #1 is the button
Seat 1: Calltossen ($13.57 in chips) 
Seat 2: Kimi1892 ($10.64 in chips) 
Seat 3: Darkhorse2205 ($7.17 in chips) 
Seat 4: PokerPro EPT ($9.45 in chips) 
Seat 5: KingBiscuitT ($11.67 in chips) 
Seat 6: alex7512007 ($5.02 in chips) 
Kimi1892: posts small blind $0.05
Darkhorse2205: posts big blind $0.10
*** HOLE CARDS ***
PokerPro EPT: raises $0.20 to $0.30
KingBiscuitT: folds 
alex7512007: folds 
Calltossen: folds 
Kimi1892: calls $0.25
Darkhorse2205: folds 
*** FLOP *** [As 7h Kd]
Kimi1892: checks 
PokerPro EPT: bets $0.20
Kimi1892: calls $0.20
*** TURN *** [As 7h Kd] [5h]
Kimi1892: checks 
PokerPro EPT: bets $0.40
Kimi1892: calls $0.40
*** RIVER *** [As 7h Kd 5h] [4h]
Kimi1892: checks 
PokerPro EPT: bets $0.79
Kimi1892: calls $0.79
*** SHOW DOWN ***
PokerPro EPT: shows [7c 8c] (a pair of Sevens)
Kimi1892: shows [Ks Jc] (a pair of Kings)
Kimi1892 collected $3.32 from pot
*** SUMMARY ***
Total pot $3.48 | Rake $0.16 
Board [As 7h Kd 5h 4h]
Seat 1: Calltossen (button) folded before Flop (didn't bet)
Seat 2: Kimi1892 (small blind) showed [Ks Jc] and won ($3.32) with a pair of Kings
Seat 3: Darkhorse2205 (big blind) folded before Flop
Seat 4: PokerPro EPT showed [7c 8c] and lost with a pair of Sevens
Seat 5: KingBiscuitT folded before Flop (didn't bet)
Seat 6: alex7512007 folded before Flop (didn't bet)



PokerStars Hand #222955790622:  Hold'em No Limit ($0.05/$0.10 USD) - 2021/01/23 9:49:30 ET
Table 'Lutetia III' 6-max Seat #2 is the button
Seat 1: Calltossen ($13.57 in chips) 
Seat 2: Kimi1892 ($12.27 in chips) 
Seat 3: Darkhorse2205 ($7.07 in chips) 
Seat 4: PokerPro EPT ($7.76 in chips) 
Seat 5: KingBiscuitT ($11.67 in chips) 
Seat 6: alex7512007 ($5.02 in chips) 
Darkhorse2205: posts small blind $0.05
PokerPro EPT: posts big blind $0.10
*** HOLE CARDS ***
KingBiscuitT: folds 
alex7512007: folds 
Calltossen: raises $0.25 to $0.35
Kimi1892: folds 
Darkhorse2205: folds 
PokerPro EPT: calls $0.25
*** FLOP *** [Ac 9s 3d]
PokerPro EPT: checks 
Calltossen: bets $0.70
PokerPro EPT: folds 
Uncalled bet ($0.70) returned to Calltossen
Calltossen collected $0.72 from pot
Calltossen: doesn't show hand 
*** SUMMARY ***
Total pot $0.75 | Rake $0.03 
Board [Ac 9s 3d]
Seat 1: Calltossen collected ($0.72)
Seat 2: Kimi1892 (button) folded before Flop (didn't bet)
Seat 3: Darkhorse2205 (small blind) folded before Flop
Seat 4: PokerPro EPT (big blind) folded on the Flop
Seat 5: KingBiscuitT folded before Flop (didn't bet)
Seat 6: alex7512007 folded before Flop (didn't bet)



PokerStars Hand #222955804993:  Hold'em No Limit ($0.05/$0.10 USD) - 2021/01/23 9:49:58 ET
Table 'Lutetia III' 6-max Seat #3 is the button
Seat 1: Calltossen ($13.94 in chips) 
Seat 2: Kimi1892 ($12.27 in chips) 
Seat 3: Darkhorse2205 ($7.02 in chips) 
Seat 4: PokerPro EPT ($7.41 in chips) 
Seat 5: KingBiscuitT ($11.67 in chips) 
Seat 6: alex7512007 ($5.02 in chips) 
PokerPro EPT: posts small blind $0.05
KingBiscuitT: posts big blind $0.10
*** HOLE CARDS ***
alex7512007: folds 
Calltossen: folds 
Kimi1892: folds 
Darkhorse2205: calls $0.10
PokerPro EPT: raises $0.30 to $0.40
KingBiscuitT: folds 
Darkhorse2205: calls $0.30
*** FLOP *** [3s 9s Jh]
PokerPro EPT: bets $0.50
Darkhorse2205: folds 
Uncalled bet ($0.50) returned to PokerPro EPT
PokerPro EPT collected $0.86 from pot
PokerPro EPT: doesn't show hand 
*** SUMMARY ***
Total pot $0.90 | Rake $0.04 
Board [3s 9s Jh]
Seat 1: Calltossen folded before Flop (didn't bet)
Seat 2: Kimi1892 folded before Flop (didn't bet)
Seat 3: Darkhorse2205 (button) folded on the Flop
Seat 4: PokerPro EPT (small blind) collected ($0.86)
Seat 5: KingBiscuitT (big blind) folded before Flop
Seat 6: alex7512007 folded before Flop (didn't bet)



PokerStars Hand #222955823715:  Hold'em No Limit ($0.05/$0.10 USD) - 2021/01/23 9:50:20 ET
Table 'Lutetia III' 6-max Seat #4 is the button
Seat 1: Calltossen ($13.94 in chips) 
Seat 2: Kimi1892 ($12.27 in chips) 
Seat 3: Darkhorse2205 ($6.62 in chips) 
Seat 4: PokerPro EPT ($7.87 in chips) 
Seat 5: KingBiscuitT ($11.57 in chips) 
Seat 6: alex7512007 ($5.02 in chips) 
KingBiscuitT: posts small blind $0.05
alex7512007: posts big blind $0.10
*** HOLE CARDS ***
Calltossen: raises $0.20 to $0.30
Kimi1892: folds 
Darkhorse2205: folds 
PokerPro EPT: folds 
KingBiscuitT: folds 
alex7512007: folds 
Uncalled bet ($0.20) returned to Calltossen
Calltossen collected $0.25 from pot
Calltossen: doesn't show hand 
*** SUMMARY ***
Total pot $0.25 | Rake $0 
Seat 1: Calltossen collected ($0.25)
Seat 2: Kimi1892 folded before Flop (didn't bet)
Seat 3: Darkhorse2205 folded before Flop (didn't bet)
Seat 4: PokerPro EPT (button) folded before Flop (didn't bet)
Seat 5: KingBiscuitT (small blind) folded before Flop
Seat 6: alex7512007 (big blind) folded before Flop



PokerStars Hand #222955832338:  Hold'em No Limit ($0.05/$0.10 USD) - 2021/01/23 9:50:37 ET
Table 'Lutetia III' 6-max Seat #5 is the button
Seat 1: Calltossen ($14.09 in chips) 
Seat 2: Kimi1892 ($12.27 in chips) 
Seat 3: Darkhorse2205 ($6.62 in chips) 
Seat 4: PokerPro EPT ($7.87 in chips) 
Seat 5: KingBiscuitT ($11.52 in chips) 
Seat 6: alex7512007 ($4.92 in chips) 
alex7512007: posts small blind $0.05
Calltossen: posts big blind $0.10
*** HOLE CARDS ***
Kimi1892: raises $0.20 to $0.30
Darkhorse2205: calls $0.30
PokerPro EPT: calls $0.30
KingBiscuitT: folds 
alex7512007: folds 
Calltossen: calls $0.20
*** FLOP *** [2c 9c Tc]
Calltossen: checks 
Kimi1892: checks 
Darkhorse2205: bets $0.20
PokerPro EPT: raises $1.10 to $1.30
Calltossen: folds 
Kimi1892: folds 
Darkhorse2205: folds 
Uncalled bet ($1.10) returned to PokerPro EPT
PokerPro EPT collected $1.58 from pot
PokerPro EPT: doesn't show hand 
*** SUMMARY ***
Total pot $1.65 | Rake $0.07 
Board [2c 9c Tc]
Seat 1: Calltossen (big blind) folded on the Flop
Seat 2: Kimi1892 folded on the Flop
Seat 3: Darkhorse2205 folded on the Flop
Seat 4: PokerPro EPT collected ($1.58)
Seat 5: KingBiscuitT (button) folded before Flop (didn't bet)
Seat 6: alex7512007 (small blind) folded before Flop



PokerStars Hand #222955852661:  Hold'em No Limit ($0.05/$0.10 USD) - 2021/01/23 9:51:17 ET
Table 'Lutetia III' 6-max Seat #6 is the button
Seat 1: Calltossen ($13.79 in chips) 
Seat 2: Kimi1892 ($11.97 in chips) 
Seat 3: Darkhorse2205 ($6.12 in chips) 
Seat 4: PokerPro EPT ($8.95 in chips) 
Seat 5: KingBiscuitT ($11.52 in chips) 
Seat 6: alex7512007 ($4.87 in chips) 
Calltossen: posts small blind $0.05
Kimi1892: posts big blind $0.10
*** HOLE CARDS ***
Darkhorse2205: folds 
PokerPro EPT: calls $0.10
KingBiscuitT: folds 
alex7512007: raises $0.30 to $0.40
Calltossen: folds 
Kimi1892: calls $0.30
PokerPro EPT: folds 
*** FLOP *** [7c 8d Ac]
Kimi1892: checks 
alex7512007: bets $0.38
Kimi1892: raises $0.92 to $1.30
alex7512007: folds 
Uncalled bet ($0.92) returned to Kimi1892
Kimi1892 collected $1.63 from pot
Kimi1892: doesn't show hand 
*** SUMMARY ***
Total pot $1.71 | Rake $0.08 
Board [7c 8d Ac]
Seat 1: Calltossen (small blind) folded before Flop
Seat 2: Kimi1892 (big blind) collected ($1.63)
Seat 3: Darkhorse2205 folded before Flop (didn't bet)
Seat 4: PokerPro EPT folded before Flop
Seat 5: KingBiscuitT folded before Flop (didn't bet)
Seat 6: alex7512007 (button) folded on the Flop



PokerStars Hand #222955877222:  Hold'em No Limit ($0.05/$0.10 USD) - 2021/01/23 9:52:05 ET
Table 'Lutetia III' 6-max Seat #1 is the button
Seat 1: Calltossen ($13.74 in chips) 
Seat 2: Kimi1892 ($12.82 in chips) 
Seat 3: Darkhorse2205 ($6.12 in chips) 
Seat 4: PokerPro EPT ($8.85 in chips) 
Seat 5: KingBiscuitT ($11.52 in chips) 
Seat 6: alex7512007 ($4.09 in chips) 
Kimi1892: posts small blind $0.05
Darkhorse2205: posts big blind $0.10
*** HOLE CARDS ***
PokerPro EPT: folds 
KingBiscuitT: folds 
alex7512007: folds 
Calltossen: folds 
Kimi1892: raises $0.20 to $0.30
Darkhorse2205: raises $0.30 to $0.60
Kimi1892: raises $0.80 to $1.40
Darkhorse2205: calls $0.80
*** FLOP *** [Ad Td 4h]
Kimi1892: bets $0.70
Darkhorse2205: calls $0.70
*** TURN *** [Ad Td 4h] [3d]
Kimi1892: checks 
Darkhorse2205: checks 
*** RIVER *** [Ad Td 4h 3d] [2s]
Kimi1892: checks 
Darkhorse2205: checks 
*** SHOW DOWN ***
Kimi1892: shows [Qh Qs] (a pair of Queens)
Darkhorse2205: mucks hand 
Kimi1892 collected $4.01 from pot
*** SUMMARY ***
Total pot $4.20 | Rake $0.19 
Board [Ad Td 4h 3d 2s]
Seat 1: Calltossen (button) folded before Flop (didn't bet)
Seat 2: Kimi1892 (small blind) showed [Qh Qs] and won ($4.01) with a pair of Queens
Seat 3: Darkhorse2205 (big blind) mucked
Seat 4: PokerPro EPT folded before Flop (didn't bet)
Seat 5: KingBiscuitT folded before Flop (didn't bet)
Seat 6: alex7512007 folded before Flop (didn't bet)



PokerStars Hand #222955896888:  Hold'em No Limit ($0.05/$0.10 USD) - 2021/01/23 9:52:44 ET
Table 'Lutetia III' 6-max Seat #2 is the button
Seat 1: Calltossen ($13.74 in chips) 
Seat 2: Kimi1892 ($14.73 in chips) 
Seat 3: Darkhorse2205 ($4.02 in chips) 
Seat 4: PokerPro EPT ($8.85 in chips) 
Seat 5: KingBiscuitT ($11.52 in chips) 
Seat 6: alex7512007 ($4.09 in chips) 
Darkhorse2205: posts small blind $0.05
PokerPro EPT: posts big blind $0.10
*** HOLE CARDS ***
KingBiscuitT: raises $0.12 to $0.22
alex7512007: folds 
Calltossen: calls $0.22
Kimi1892: folds 
Darkhorse2205: calls $0.17
PokerPro EPT: calls $0.12
*** FLOP *** [Tc 8h Jd]
Darkhorse2205: checks 
PokerPro EPT: checks 
KingBiscuitT: checks 
Calltossen: checks 
*** TURN *** [Tc 8h Jd] [9c]
Darkhorse2205: checks 
PokerPro EPT: bets $0.20
KingBiscuitT: folds 
Calltossen: folds 
Darkhorse2205: calls $0.20
*** RIVER *** [Tc 8h Jd 9c] [8d]
Darkhorse2205: checks 
PokerPro EPT: checks 
*** SHOW DOWN ***
Darkhorse2205: shows [8s Ah] (three of a kind, Eights)
PokerPro EPT: shows [Kc 7s] (a straight, Seven to Jack)
PokerPro EPT collected $1.22 from pot
*** SUMMARY ***
Total pot $1.28 | Rake $0.06 
Board [Tc 8h Jd 9c 8d]
Seat 1: Calltossen folded on the Turn
Seat 2: Kimi1892 (button) folded before Flop (didn't bet)
Seat 3: Darkhorse2205 (small blind) showed [8s Ah] and lost with three of a kind, Eights
Seat 4: PokerPro EPT (big blind) showed [Kc 7s] and won ($1.22) with a straight, Seven to Jack
Seat 5: KingBiscuitT folded on the Turn
Seat 6: alex7512007 folded before Flop (didn't bet)



PokerStars Hand #222955933072:  Hold'em No Limit ($0.05/$0.10 USD) - 2021/01/23 9:53:55 ET
Table 'Lutetia III' 6-max Seat #3 is the button
Seat 1: Calltossen ($13.52 in chips) 
Seat 2: Kimi1892 ($14.73 in chips) 
Seat 3: Darkhorse2205 ($3.60 in chips) 
Seat 4: PokerPro EPT ($9.65 in chips) 
Seat 5: KingBiscuitT ($11.30 in chips) 
Seat 6: alex7512007 ($4.09 in chips) 
PokerPro EPT: posts small blind $0.05
KingBiscuitT: posts big blind $0.10
*** HOLE CARDS ***
alex7512007: raises $0.20 to $0.30
Calltossen: folds 
Kimi1892: calls $0.30
Darkhorse2205: folds 
PokerPro EPT: folds 
KingBiscuitT: calls $0.20
*** FLOP *** [8d Qc Ah]
KingBiscuitT: checks 
alex7512007: checks 
Kimi1892: checks 
*** TURN *** [8d Qc Ah] [Td]
KingBiscuitT: bets $0.91
alex7512007: folds 
Kimi1892: folds 
Uncalled bet ($0.91) returned to KingBiscuitT
KingBiscuitT collected $0.91 from pot
KingBiscuitT: doesn't show hand 
*** SUMMARY ***
Total pot $0.95 | Rake $0.04 
Board [8d Qc Ah Td]
Seat 1: Calltossen folded before Flop (didn't bet)
Seat 2: Kimi1892 folded on the Turn
Seat 3: Darkhorse2205 (button) folded before Flop (didn't bet)
Seat 4: PokerPro EPT (small blind) folded before Flop
Seat 5: KingBiscuitT (big blind) collected ($0.91)
Seat 6: alex7512007 folded on the Turn



PokerStars Hand #222955949617:  Hold'em No Limit ($0.05/$0.10 USD) - 2021/01/23 9:54:28 ET
Table 'Lutetia III' 6-max Seat #4 is the button
Seat 1: Calltossen ($13.52 in chips) 
Seat 2: Kimi1892 ($14.43 in chips) 
Seat 3: Darkhorse2205 ($3.60 in chips) 
Seat 4: PokerPro EPT ($9.60 in chips) 
Seat 5: KingBiscuitT ($11.91 in chips) 
Seat 6: alex7512007 ($3.79 in chips) 
KingBiscuitT: posts small blind $0.05
alex7512007: posts big blind $0.10
*** HOLE CARDS ***
Calltossen: folds 
Kimi1892: folds 
Darkhorse2205: folds 
PokerPro EPT: raises $0.20 to $0.30
KingBiscuitT: folds 
alex7512007: folds 
Uncalled bet ($0.20) returned to PokerPro EPT
PokerPro EPT collected $0.25 from pot
PokerPro EPT: doesn't show hand 
*** SUMMARY ***
Total pot $0.25 | Rake $0 
Seat 1: Calltossen folded before Flop (didn't bet)
Seat 2: Kimi1892 folded before Flop (didn't bet)
Seat 3: Darkhorse2205 folded before Flop (didn't bet)
Seat 4: PokerPro EPT (button) collected ($0.25)
Seat 5: KingBiscuitT (small blind) folded before Flop
Seat 6: alex7512007 (big blind) folded before Flop



PokerStars Hand #222955958954:  Hold'em No Limit ($0.05/$0.10 USD) - 2021/01/23 9:54:46 ET
Table 'Lutetia III' 6-max Seat #5 is the button
Seat 1: Calltossen ($13.52 in chips) 
Seat 2: Kimi1892 ($14.43 in chips) 
Seat 3: Darkhorse2205 ($3.60 in chips) 
Seat 4: PokerPro EPT ($9.75 in chips) 
Seat 5: KingBiscuitT ($11.86 in chips) 
Seat 6: alex7512007 ($3.69 in chips) 
alex7512007: posts small blind $0.05
Calltossen: posts big blind $0.10
*** HOLE CARDS ***
Kimi1892: raises $0.20 to $0.30
Darkhorse2205: calls $0.30
PokerPro EPT: folds 
KingBiscuitT: calls $0.30
alex7512007: folds 
Calltossen: calls $0.20
*** FLOP *** [7d 9s 5s]
Calltossen: checks 
Kimi1892: checks 
Darkhorse2205: bets $0.60
KingBiscuitT: calls $0.60
Calltossen: raises $12.62 to $13.22 and is all-in
Kimi1892: folds 
Darkhorse2205: calls $2.70 and is all-in
KingBiscuitT: folds 
Uncalled bet ($9.92) returned to Calltossen
*** TURN *** [7d 9s 5s] [8s]
*** RIVER *** [7d 9s 5s 8s] [As]
*** SHOW DOWN ***
Calltossen: shows [7c 5d] (two pair, Sevens and Fives)
Darkhorse2205: shows [Kc Kh] (a pair of Kings)
Calltossen collected $8.07 from pot
Darkhorse2205 cashed out the hand for $2.09 | Cash Out Fee $0.02
*** SUMMARY ***
Total pot $8.45 | Rake $0.38 
Board [7d 9s 5s 8s As]
Seat 1: Calltossen (big blind) showed [7c 5d] and won ($8.07) with two pair, Sevens and Fives
Seat 2: Kimi1892 folded on the Flop
Seat 3: Darkhorse2205 showed [Kc Kh] and lost with a pair of Kings (cashed out).
Seat 4: PokerPro EPT folded before Flop (didn't bet)
Seat 5: KingBiscuitT (button) folded on the Flop
Seat 6: alex7512007 (small blind) folded before Flop



PokerStars Hand #222955985971:  Hold'em No Limit ($0.05/$0.10 USD) - 2021/01/23 9:55:48 ET
Table 'Lutetia III' 6-max Seat #6 is the button
Seat 1: Calltossen ($17.99 in chips) 
Seat 2: Kimi1892 ($14.13 in chips) 
Seat 3: Darkhorse2205 ($2.09 in chips) 
Seat 4: PokerPro EPT ($9.75 in chips) 
Seat 5: KingBiscuitT ($10.96 in chips) 
Seat 6: alex7512007 ($3.64 in chips) 
Calltossen: posts small blind $0.05
Kimi1892: posts big blind $0.10
*** HOLE CARDS ***
Darkhorse2205: calls $0.10
PokerPro EPT: folds 
KingBiscuitT: folds 
alex7512007: folds 
Calltossen: folds 
Kimi1892: checks 
*** FLOP *** [2s 8c 9s]
Kimi1892: checks 
Darkhorse2205: checks 
*** TURN *** [2s 8c 9s] [9c]
Kimi1892: checks 
Darkhorse2205: checks 
*** RIVER *** [2s 8c 9s 9c] [Jh]
Kimi1892: checks 
Darkhorse2205: checks 
*** SHOW DOWN ***
Kimi1892: shows [4h 2h] (two pair, Nines and Deuces)
Darkhorse2205: shows [Ah Js] (two pair, Jacks and Nines)
Darkhorse2205 collected $0.24 from pot
*** SUMMARY ***
Total pot $0.25 | Rake $0.01 
Board [2s 8c 9s 9c Jh]
Seat 1: Calltossen (small blind) folded before Flop
Seat 2: Kimi1892 (big blind) showed [4h 2h] and lost with two pair, Nines and Deuces
Seat 3: Darkhorse2205 showed [Ah Js] and won ($0.24) with two pair, Jacks and Nines
Seat 4: PokerPro EPT folded before Flop (didn't bet)
Seat 5: KingBiscuitT folded before Flop (didn't bet)
Seat 6: alex7512007 (button) folded before Flop (didn't bet)



PokerStars Hand #222955997760:  Hold'em No Limit ($0.05/$0.10 USD) - 2021/01/23 9:56:18 ET
Table 'Lutetia III' 6-max Seat #1 is the button
Seat 1: Calltossen ($17.94 in chips) 
Seat 2: Kimi1892 ($14.03 in chips) 
Seat 3: Darkhorse2205 ($2.23 in chips) 
Seat 4: PokerPro EPT ($9.75 in chips) 
Seat 5: KingBiscuitT ($10.96 in chips) 
Seat 6: alex7512007 ($3.64 in chips) 
Kimi1892: posts small blind $0.05
Darkhorse2205: posts big blind $0.10
*** HOLE CARDS ***
PokerPro EPT: calls $0.10
KingBiscuitT: folds 
alex7512007: folds 
Calltossen: folds 
Kimi1892: folds 
Darkhorse2205: checks 
*** FLOP *** [Td 9h 6d]
Darkhorse2205: checks 
PokerPro EPT: checks 
*** TURN *** [Td 9h 6d] [Qh]
Darkhorse2205: checks 
PokerPro EPT: checks 
*** RIVER *** [Td 9h 6d Qh] [As]
Darkhorse2205: checks 
PokerPro EPT: checks 
*** SHOW DOWN ***
Darkhorse2205: shows [2s 7h] (high card Ace)
PokerPro EPT: shows [Jd 6c] (a pair of Sixes)
PokerPro EPT collected $0.24 from pot
*** SUMMARY ***
Total pot $0.25 | Rake $0.01 
Board [Td 9h 6d Qh As]
Seat 1: Calltossen (button) folded before Flop (didn't bet)
Seat 2: Kimi1892 (small blind) folded before Flop
Seat 3: Darkhorse2205 (big blind) showed [2s 7h] and lost with high card Ace
Seat 4: PokerPro EPT showed [Jd 6c] and won ($0.24) with a pair of Sixes
Seat 5: KingBiscuitT folded before Flop (didn't bet)
Seat 6: alex7512007 folded before Flop (didn't bet)



PokerStars Hand #222956010589:  Hold'em No Limit ($0.05/$0.10 USD) - 2021/01/23 9:56:50 ET
Table 'Lutetia III' 6-max Seat #2 is the button
Seat 1: Calltossen ($17.94 in chips) 
Seat 2: Kimi1892 ($13.98 in chips) 
Seat 3: Darkhorse2205 ($2.13 in chips) 
Seat 4: PokerPro EPT ($9.89 in chips) 
Seat 5: KingBiscuitT ($10.96 in chips) 
Seat 6: alex7512007 ($3.64 in chips) 
Darkhorse2205: posts small blind $0.05
PokerPro EPT: posts big blind $0.10
*** HOLE CARDS ***
KingBiscuitT: folds 
alex7512007: folds 
Calltossen: raises $0.25 to $0.35
Kimi1892: folds 
Darkhorse2205: folds 
PokerPro EPT: folds 
Uncalled bet ($0.25) returned to Calltossen
Calltossen collected $0.25 from pot
Calltossen: doesn't show hand 
*** SUMMARY ***
Total pot $0.25 | Rake $0 
Seat 1: Calltossen collected ($0.25)
Seat 2: Kimi1892 (button) folded before Flop (didn't bet)
Seat 3: Darkhorse2205 (small blind) folded before Flop
Seat 4: PokerPro EPT (big blind) folded before Flop
Seat 5: KingBiscuitT folded before Flop (didn't bet)
Seat 6: alex7512007 folded before Flop (didn't bet)



PokerStars Hand #222956016472:  Hold'em No Limit ($0.05/$0.10 USD) - 2021/01/23 9:57:04 ET
Table 'Lutetia III' 6-max Seat #3 is the button
Seat 1: Calltossen ($18.09 in chips) 
Seat 2: Kimi1892 ($13.98 in chips) 
Seat 3: Darkhorse2205 ($2.08 in chips) 
Seat 4: PokerPro EPT ($9.79 in chips) 
Seat 5: KingBiscuitT ($10.96 in chips) 
Seat 6: alex7512007 ($3.64 in chips) 
PokerPro EPT: posts small blind $0.05
KingBiscuitT: posts big blind $0.10
*** HOLE CARDS ***
alex7512007: folds 
Calltossen: folds 
Kimi1892: folds 
Darkhorse2205: folds 
PokerPro EPT: raises $0.20 to $0.30
KingBiscuitT: folds 
Uncalled bet ($0.20) returned to PokerPro EPT
PokerPro EPT collected $0.20 from pot
PokerPro EPT: doesn't show hand 
*** SUMMARY ***
Total pot $0.20 | Rake $0 
Seat 1: Calltossen folded before Flop (didn't bet)
Seat 2: Kimi1892 folded before Flop (didn't bet)
Seat 3: Darkhorse2205 (button) folded before Flop (didn't bet)
Seat 4: PokerPro EPT (small blind) collected ($0.20)
Seat 5: KingBiscuitT (big blind) folded before Flop
Seat 6: alex7512007 folded before Flop (didn't bet)



PokerStars Hand #222956025353:  Hold'em No Limit ($0.05/$0.10 USD) - 2021/01/23 9:57:26 ET
Table 'Lutetia III' 6-max Seat #4 is the button
Seat 1: Calltossen ($18.09 in chips) 
Seat 2: Kimi1892 ($13.98 in chips) 
Seat 3: Darkhorse2205 ($2.08 in chips) 
Seat 4: PokerPro EPT ($9.89 in chips) 
Seat 5: KingBiscuitT ($10.86 in chips) 
Seat 6: alex7512007 ($3.64 in chips) 
KingBiscuitT: posts small blind $0.05
alex7512007: posts big blind $0.10
*** HOLE CARDS ***
Calltossen: raises $0.20 to $0.30
Kimi1892: folds 
Darkhorse2205: folds 
PokerPro EPT: folds 
KingBiscuitT: folds 
alex7512007: folds 
Uncalled bet ($0.20) returned to Calltossen
Calltossen collected $0.25 from pot
Calltossen: doesn't show hand 
*** SUMMARY ***
Total pot $0.25 | Rake $0 
Seat 1: Calltossen collected ($0.25)
Seat 2: Kimi1892 folded before Flop (didn't bet)
Seat 3: Darkhorse2205 folded before Flop (didn't bet)
Seat 4: PokerPro EPT (button) folded before Flop (didn't bet)
Seat 5: KingBiscuitT (small blind) folded before Flop
Seat 6: alex7512007 (big blind) folded before Flop



PokerStars Hand #222956033717:  Hold'em No Limit ($0.05/$0.10 USD) - 2021/01/23 9:57:47 ET
Table 'Lutetia III' 6-max Seat #5 is the button
Seat 1: Calltossen ($18.24 in chips) 
Seat 2: Kimi1892 ($13.98 in chips) 
Seat 3: Darkhorse2205 ($2.08 in chips) 
Seat 4: PokerPro EPT ($9.89 in chips) 
Seat 5: KingBiscuitT ($10.81 in chips) 
Seat 6: alex7512007 ($3.54 in chips) 
alex7512007: posts small blind $0.05
Calltossen: posts big blind $0.10
*** HOLE CARDS ***
Kimi1892: folds 
Darkhorse2205: folds 
PokerPro EPT: folds 
KingBiscuitT: raises $0.15 to $0.25
alex7512007: folds 
Calltossen: calls $0.15
*** FLOP *** [3s Tc Kh]
Calltossen: checks 
KingBiscuitT: checks 
*** TURN *** [3s Tc Kh] [2h]
Calltossen: checks 
KingBiscuitT: checks 
*** RIVER *** [3s Tc Kh 2h] [Td]
Calltossen: checks 
KingBiscuitT: checks 
*** SHOW DOWN ***
Calltossen: shows [9h 8s] (a pair of Tens)
KingBiscuitT: shows [Ad 2s] (two pair, Tens and Deuces)
KingBiscuitT collected $0.53 from pot
*** SUMMARY ***
Total pot $0.55 | Rake $0.02 
Board [3s Tc Kh 2h Td]
Seat 1: Calltossen (big blind) showed [9h 8s] and lost with a pair of Tens
Seat 2: Kimi1892 folded before Flop (didn't bet)
Seat 3: Darkhorse2205 folded before Flop (didn't bet)
Seat 4: PokerPro EPT folded before Flop (didn't bet)
Seat 5: KingBiscuitT (button) showed [Ad 2s] and won ($0.53) with two pair, Tens and Deuces
Seat 6: alex7512007 (small blind) folded before Flop



PokerStars Hand #222956054324:  Hold'em No Limit ($0.05/$0.10 USD) - 2021/01/23 9:58:39 ET
Table 'Lutetia III' 6-max Seat #6 is the button
Seat 1: Calltossen ($17.99 in chips) 
Seat 2: Kimi1892 ($13.98 in chips) 
Seat 3: Darkhorse2205 ($2.08 in chips) 
Seat 4: PokerPro EPT ($9.89 in chips) 
Seat 5: KingBiscuitT ($11.09 in chips) 
Seat 6: alex7512007 ($3.49 in chips) 
Calltossen: posts small blind $0.05
Kimi1892: posts big blind $0.10
*** HOLE CARDS ***
Darkhorse2205: folds 
PokerPro EPT: calls $0.10
KingBiscuitT: folds 
alex7512007: raises $0.25 to $0.35
Calltossen: folds 
Kimi1892: folds 
PokerPro EPT: folds 
Uncalled bet ($0.25) returned to alex7512007
alex7512007 collected $0.35 from pot
*** SUMMARY ***
Total pot $0.35 | Rake $0 
Seat 1: Calltossen (small blind) folded before Flop
Seat 2: Kimi1892 (big blind) folded before Flop
Seat 3: Darkhorse2205 folded before Flop (didn't bet)
Seat 4: PokerPro EPT folded before Flop
Seat 5: KingBiscuitT folded before Flop (didn't bet)
Seat 6: alex7512007 (button) collected ($0.35)



PokerStars Hand #222956062355:  Hold'em No Limit ($0.05/$0.10 USD) - 2021/01/23 9:58:59 ET
Table 'Lutetia III' 6-max Seat #1 is the button
Seat 1: Calltossen ($17.94 in chips) 
Seat 2: Kimi1892 ($13.88 in chips) 
Seat 3: Darkhorse2205 ($2.08 in chips) 
Seat 4: PokerPro EPT ($9.79 in chips) 
Seat 5: KingBiscuitT ($11.09 in chips) 
Seat 6: alex7512007 ($3.74 in chips) 
Kimi1892: posts small blind $0.05
Darkhorse2205: posts big blind $0.10
*** HOLE CARDS ***
PokerPro EPT: folds 
KingBiscuitT: folds 
alex7512007: folds 
Calltossen: raises $0.20 to $0.30
Kimi1892: calls $0.25
Darkhorse2205: calls $0.20
*** FLOP *** [8d Ks 3s]
Kimi1892: checks 
Darkhorse2205: checks 
Calltossen: bets $0.65
Kimi1892: folds 
Darkhorse2205: folds 
Uncalled bet ($0.65) returned to Calltossen
Calltossen collected $0.86 from pot
Calltossen: doesn't show hand 
*** SUMMARY ***
Total pot $0.90 | Rake $0.04 
Board [8d Ks 3s]
Seat 1: Calltossen (button) collected ($0.86)
Seat 2: Kimi1892 (small blind) folded on the Flop
Seat 3: Darkhorse2205 (big blind) folded on the Flop
Seat 4: PokerPro EPT folded before Flop (didn't bet)
Seat 5: KingBiscuitT folded before Flop (didn't bet)
Seat 6: alex7512007 folded before Flop (didn't bet)



PokerStars Hand #222956077716:  Hold'em No Limit ($0.05/$0.10 USD) - 2021/01/23 9:59:36 ET
Table 'Lutetia III' 6-max Seat #2 is the button
Seat 1: Calltossen ($18.50 in chips) 
Seat 2: Kimi1892 ($13.58 in chips) 
Seat 3: Darkhorse2205 ($1.78 in chips) 
Seat 4: PokerPro EPT ($9.79 in chips) 
Seat 5: KingBiscuitT ($11.09 in chips) 
Seat 6: alex7512007 ($3.74 in chips) 
Darkhorse2205: posts small blind $0.05
PokerPro EPT: posts big blind $0.10
*** HOLE CARDS ***
KingBiscuitT: folds 
alex7512007: raises $0.20 to $0.30
Calltossen: folds 
Kimi1892: calls $0.30
Darkhorse2205: folds 
PokerPro EPT: folds 
*** FLOP *** [9h 2d Ks]
alex7512007: bets $0.30
Kimi1892: calls $0.30
*** TURN *** [9h 2d Ks] [8c]
alex7512007: checks 
Kimi1892: bets $0.66
alex7512007: folds 
Uncalled bet ($0.66) returned to Kimi1892
Kimi1892 collected $1.29 from pot
Kimi1892: doesn't show hand 
*** SUMMARY ***
Total pot $1.35 | Rake $0.06 
Board [9h 2d Ks 8c]
Seat 1: Calltossen folded before Flop (didn't bet)
Seat 2: Kimi1892 (button) collected ($1.29)
Seat 3: Darkhorse2205 (small blind) folded before Flop
Seat 4: PokerPro EPT (big blind) folded before Flop
Seat 5: KingBiscuitT folded before Flop (didn't bet)
Seat 6: alex7512007 folded on the Turn



PokerStars Hand #222956096837:  Hold'em No Limit ($0.05/$0.10 USD) - 2021/01/23 10:00:22 ET
Table 'Lutetia III' 6-max Seat #3 is the button
Seat 1: Calltossen ($18.50 in chips) 
Seat 2: Kimi1892 ($14.27 in chips) 
Seat 3: Darkhorse2205 ($1.73 in chips) 
Seat 4: PokerPro EPT ($9.69 in chips) 
Seat 5: KingBiscuitT ($11.09 in chips) 
Seat 6: alex7512007 ($3.14 in chips) 
PokerPro EPT: posts small blind $0.05
KingBiscuitT: posts big blind $0.10
*** HOLE CARDS ***
alex7512007: folds 
Calltossen: folds 
Kimi1892: folds 
Darkhorse2205: folds 
PokerPro EPT: folds 
Uncalled bet ($0.05) returned to KingBiscuitT
KingBiscuitT collected $0.10 from pot
KingBiscuitT: doesn't show hand 
*** SUMMARY ***
Total pot $0.10 | Rake $0 
Seat 1: Calltossen folded before Flop (didn't bet)
Seat 2: Kimi1892 folded before Flop (didn't bet)
Seat 3: Darkhorse2205 (button) folded before Flop (didn't bet)
Seat 4: PokerPro EPT (small blind) folded before Flop
Seat 5: KingBiscuitT (big blind) collected ($0.10)
Seat 6: alex7512007 folded before Flop (didn't bet)



PokerStars Hand #222956103879:  Hold'em No Limit ($0.05/$0.10 USD) - 2021/01/23 10:00:39 ET
Table 'Lutetia III' 6-max Seat #4 is the button
Seat 1: Calltossen ($18.50 in chips) 
Seat 2: Kimi1892 ($14.27 in chips) 
Seat 3: Darkhorse2205 ($1.73 in chips) 
Seat 4: PokerPro EPT ($9.64 in chips) 
Seat 5: KingBiscuitT ($11.14 in chips) 
Seat 6: alex7512007 ($3.14 in chips) 
KingBiscuitT: posts small blind $0.05
alex7512007: posts big blind $0.10
*** HOLE CARDS ***
Calltossen has timed out
Calltossen: folds 
Kimi1892: folds 
Darkhorse2205: calls $0.10
PokerPro EPT: raises $0.30 to $0.40
KingBiscuitT: folds 
alex7512007: folds 
Darkhorse2205: calls $0.30
*** FLOP *** [6h 4s 5s]
Calltossen leaves the table
Darkhorse2205: checks 
PokerPro EPT: bets $0.70
Darkhorse2205: calls $0.70
*** TURN *** [6h 4s 5s] [Qs]
beta33 joins the table at seat #1 
Darkhorse2205: checks 
PokerPro EPT: bets $8.54 and is all-in
Darkhorse2205: calls $0.63 and is all-in
Uncalled bet ($7.91) returned to PokerPro EPT
*** RIVER *** [6h 4s 5s Qs] [8c]
*** SHOW DOWN ***
Darkhorse2205: shows [7d Jd] (a straight, Four to Eight)
PokerPro EPT: shows [9h 9d] (a pair of Nines)
Darkhorse2205 collected $3.45 from pot
*** SUMMARY ***
Total pot $3.61 | Rake $0.16 
Board [6h 4s 5s Qs 8c]
Seat 1: Calltossen folded before Flop (didn't bet)
Seat 2: Kimi1892 folded before Flop (didn't bet)
Seat 3: Darkhorse2205 showed [7d Jd] and won ($3.45) with a straight, Four to Eight
Seat 4: PokerPro EPT (button) showed [9h 9d] and lost with a pair of Nines
Seat 5: KingBiscuitT (small blind) folded before Flop
Seat 6: alex7512007 (big blind) folded before Flop



PokerStars Hand #222956123277:  Hold'em No Limit ($0.05/$0.10 USD) - 2021/01/23 10:01:22 ET
Table 'Lutetia III' 6-max Seat #5 is the button
Seat 1: beta33 ($10 in chips) 
Seat 2: Kimi1892 ($14.27 in chips) 
Seat 3: Darkhorse2205 ($3.45 in chips) 
Seat 4: PokerPro EPT ($7.91 in chips) 
Seat 5: KingBiscuitT ($11.09 in chips) 
Seat 6: alex7512007 ($3.04 in chips) 
alex7512007: posts small blind $0.05
beta33: posts big blind $0.10
*** HOLE CARDS ***
Kimi1892: folds 
Darkhorse2205: folds 
PokerPro EPT: raises $0.40 to $0.50
KingBiscuitT: folds 
alex7512007: folds 
beta33: calls $0.40
*** FLOP *** [9s 6c 5h]
beta33: checks 
PokerPro EPT: bets $0.20
beta33: calls $0.20
*** TURN *** [9s 6c 5h] [8c]
beta33: checks 
PokerPro EPT: checks 
*** RIVER *** [9s 6c 5h 8c] [9h]
beta33: checks 
PokerPro EPT: checks 
*** SHOW DOWN ***
beta33: shows [Qd Kc] (a pair of Nines)
PokerPro EPT: shows [8h Kh] (two pair, Nines and Eights)
PokerPro EPT collected $1.38 from pot
*** SUMMARY ***
Total pot $1.45 | Rake $0.07 
Board [9s 6c 5h 8c 9h]
Seat 1: beta33 (big blind) showed [Qd Kc] and lost with a pair of Nines
Seat 2: Kimi1892 folded before Flop (didn't bet)
Seat 3: Darkhorse2205 folded before Flop (didn't bet)
Seat 4: PokerPro EPT showed [8h Kh] and won ($1.38) with two pair, Nines and Eights
Seat 5: KingBiscuitT (button) folded before Flop (didn't bet)
Seat 6: alex7512007 (small blind) folded before Flop



PokerStars Hand #222956144467:  Hold'em No Limit ($0.05/$0.10 USD) - 2021/01/23 10:02:06 ET
Table 'Lutetia III' 6-max Seat #6 is the button
Seat 1: beta33 ($10 in chips) 
Seat 2: Kimi1892 ($14.27 in chips) 
Seat 3: Darkhorse2205 ($3.45 in chips) 
Seat 4: PokerPro EPT ($8.59 in chips) 
Seat 5: KingBiscuitT ($11.09 in chips) 
Seat 6: alex7512007 ($2.99 in chips) 
beta33: posts small blind $0.05
Kimi1892: posts big blind $0.10
*** HOLE CARDS ***
Darkhorse2205: folds 
PokerPro EPT: calls $0.10
KingBiscuitT: folds 
alex7512007: folds 
beta33: folds 
Kimi1892: checks 
*** FLOP *** [8h 3s Jd]
Kimi1892: checks 
PokerPro EPT: checks 
*** TURN *** [8h 3s Jd] [2d]
Kimi1892: checks 
PokerPro EPT: checks 
*** RIVER *** [8h 3s Jd 2d] [6d]
Kimi1892: checks 
PokerPro EPT: checks 
*** SHOW DOWN ***
Kimi1892: shows [Tc 4s] (high card Jack)
PokerPro EPT: shows [7d 6h] (a pair of Sixes)
PokerPro EPT collected $0.24 from pot
*** SUMMARY ***
Total pot $0.25 | Rake $0.01 
Board [8h 3s Jd 2d 6d]
Seat 1: beta33 (small blind) folded before Flop
Seat 2: Kimi1892 (big blind) showed [Tc 4s] and lost with high card Jack
Seat 3: Darkhorse2205 folded before Flop (didn't bet)
Seat 4: PokerPro EPT showed [7d 6h] and won ($0.24) with a pair of Sixes
Seat 5: KingBiscuitT folded before Flop (didn't bet)
Seat 6: alex7512007 (button) folded before Flop (didn't bet)



PokerStars Hand #222956161808:  Hold'em No Limit ($0.05/$0.10 USD) - 2021/01/23 10:02:40 ET
Table 'Lutetia III' 6-max Seat #1 is the button
Seat 1: beta33 ($10 in chips) 
Seat 2: Kimi1892 ($14.17 in chips) 
Seat 3: Darkhorse2205 ($3.45 in chips) 
Seat 4: PokerPro EPT ($8.73 in chips) 
Seat 5: KingBiscuitT ($11.09 in chips) 
Seat 6: alex7512007 ($2.99 in chips) 
Kimi1892: posts small blind $0.05
Darkhorse2205: posts big blind $0.10
*** HOLE CARDS ***
PokerPro EPT: calls $0.10
KingBiscuitT: folds 
alex7512007: folds 
beta33: raises $0.30 to $0.40
Kimi1892: folds 
Darkhorse2205: calls $0.30
PokerPro EPT: folds 
*** FLOP *** [8h 8s Ts]
Darkhorse2205: checks 
beta33: bets $0.60
Darkhorse2205: calls $0.60
*** TURN *** [8h 8s Ts] [Td]
Darkhorse2205: checks 
beta33: bets $1.10
Darkhorse2205: calls $1.10
*** RIVER *** [8h 8s Ts Td] [Kd]
Darkhorse2205: checks 
beta33: bets $1.50
Darkhorse2205: calls $1.35 and is all-in
Uncalled bet ($0.15) returned to beta33
*** SHOW DOWN ***
beta33: shows [Kh Kc] (a full house, Kings full of Tens)
Darkhorse2205: shows [9h Th] (a full house, Tens full of Eights)
beta33 collected $6.73 from pot
*** SUMMARY ***
Total pot $7.05 | Rake $0.32 
Board [8h 8s Ts Td Kd]
Seat 1: beta33 (button) showed [Kh Kc] and won ($6.73) with a full house, Kings full of Tens
Seat 2: Kimi1892 (small blind) folded before Flop
Seat 3: Darkhorse2205 (big blind) showed [9h Th] and lost with a full house, Tens full of Eights
Seat 4: PokerPro EPT folded before Flop
Seat 5: KingBiscuitT folded before Flop (didn't bet)
Seat 6: alex7512007 folded before Flop (didn't bet)



PokerStars Hand #222956191808:  Hold'em No Limit ($0.05/$0.10 USD) - 2021/01/23 10:03:38 ET
Table 'Lutetia III' 6-max Seat #2 is the button
Seat 1: beta33 ($13.28 in chips) 
Seat 2: Kimi1892 ($14.12 in chips) 
Seat 4: PokerPro EPT ($8.63 in chips) 
Seat 5: KingBiscuitT ($11.09 in chips) 
Seat 6: alex7512007 ($2.99 in chips) 
PokerPro EPT: posts small blind $0.05
KingBiscuitT: posts big blind $0.10
*** HOLE CARDS ***
alex7512007: folds 
beta33: folds 
Kimi1892: raises $0.15 to $0.25
PokerPro EPT: folds 
KingBiscuitT: calls $0.15
*** FLOP *** [9s 4c Kd]
KingBiscuitT: checks 
Kimi1892: checks 
*** TURN *** [9s 4c Kd] [7d]
KingBiscuitT: checks 
Kimi1892: bets $0.30
KingBiscuitT: folds 
Uncalled bet ($0.30) returned to Kimi1892
Kimi1892 collected $0.53 from pot
Kimi1892: doesn't show hand 
*** SUMMARY ***
Total pot $0.55 | Rake $0.02 
Board [9s 4c Kd 7d]
Seat 1: beta33 folded before Flop (didn't bet)
Seat 2: Kimi1892 (button) collected ($0.53)
Seat 4: PokerPro EPT (small blind) folded before Flop
Seat 5: KingBiscuitT (big blind) folded on the Turn
Seat 6: alex7512007 folded before Flop (didn't bet)



PokerStars Hand #222956222157:  Hold'em No Limit ($0.05/$0.10 USD) - 2021/01/23 10:04:24 ET
Table 'Lutetia III' 6-max Seat #4 is the button
Seat 1: beta33 ($13.28 in chips) 
Seat 2: Kimi1892 ($14.40 in chips) 
Seat 4: PokerPro EPT ($8.58 in chips) 
Seat 5: KingBiscuitT ($10.84 in chips) 
Seat 6: alex7512007 ($2.99 in chips) 
KingBiscuitT: posts small blind $0.05
alex7512007: posts big blind $0.10
*** HOLE CARDS ***
beta33: raises $0.20 to $0.30
Kimi1892: folds 
PokerPro EPT: folds 
KingBiscuitT: folds 
alex7512007: folds 
Uncalled bet ($0.20) returned to beta33
beta33 collected $0.25 from pot
*** SUMMARY ***
Total pot $0.25 | Rake $0 
Seat 1: beta33 collected ($0.25)
Seat 2: Kimi1892 folded before Flop (didn't bet)
Seat 4: PokerPro EPT (button) folded before Flop (didn't bet)
Seat 5: KingBiscuitT (small blind) folded before Flop
Seat 6: alex7512007 (big blind) folded before Flop



PokerStars Hand #222956226673:  Hold'em No Limit ($0.05/$0.10 USD) - 2021/01/23 10:04:33 ET
Table 'Lutetia III' 6-max Seat #5 is the button
Seat 1: beta33 ($13.43 in chips) 
Seat 2: Kimi1892 ($14.40 in chips) 
Seat 4: PokerPro EPT ($8.58 in chips) 
Seat 5: KingBiscuitT ($10.79 in chips) 
Seat 6: alex7512007 ($2.89 in chips) 
alex7512007: posts small blind $0.05
beta33: posts big blind $0.10
*** HOLE CARDS ***
Kimi1892: raises $0.20 to $0.30
PokerPro EPT: calls $0.30
KingBiscuitT: calls $0.30
alex7512007: folds 
beta33: folds 
*** FLOP *** [As 9c Qs]
Kimi1892: checks 
PokerPro EPT: checks 
KingBiscuitT: bets $0.67
Kimi1892: calls $0.67
PokerPro EPT: folds 
*** TURN *** [As 9c Qs] [3d]
Kimi1892: checks 
KingBiscuitT: bets $1.52
Kimi1892: folds 
Uncalled bet ($1.52) returned to KingBiscuitT
KingBiscuitT collected $2.28 from pot
KingBiscuitT: doesn't show hand 
*** SUMMARY ***
Total pot $2.39 | Rake $0.11 
Board [As 9c Qs 3d]
Seat 1: beta33 (big blind) folded before Flop
Seat 2: Kimi1892 folded on the Turn
Seat 4: PokerPro EPT folded on the Flop
Seat 5: KingBiscuitT (button) collected ($2.28)
Seat 6: alex7512007 (small blind) folded before Flop



PokerStars Hand #222956260061:  Hold'em No Limit ($0.05/$0.10 USD) - 2021/01/23 10:05:37 ET
Table 'Lutetia III' 6-max Seat #6 is the button
Seat 1: beta33 ($13.33 in chips) 
Seat 2: Kimi1892 ($13.43 in chips) 
Seat 4: PokerPro EPT ($8.28 in chips) 
Seat 5: KingBiscuitT ($12.10 in chips) 
Seat 6: alex7512007 ($2.84 in chips) 
beta33: posts small blind $0.05
Kimi1892: posts big blind $0.10
*** HOLE CARDS ***
PokerPro EPT: calls $0.10
KingBiscuitT: folds 
alex7512007: folds 
beta33: folds 
Kimi1892: checks 
*** FLOP *** [8d 7h 4h]
Kimi1892: checks 
PokerPro EPT: bets $0.20
Kimi1892: calls $0.20
*** TURN *** [8d 7h 4h] [Tc]
Kimi1892: checks 
PokerPro EPT: bets $0.30
Kimi1892: folds 
Uncalled bet ($0.30) returned to PokerPro EPT
PokerPro EPT collected $0.62 from pot
PokerPro EPT: doesn't show hand 
*** SUMMARY ***
Total pot $0.65 | Rake $0.03 
Board [8d 7h 4h Tc]
Seat 1: beta33 (small blind) folded before Flop
Seat 2: Kimi1892 (big blind) folded on the Turn
Seat 4: PokerPro EPT collected ($0.62)
Seat 5: KingBiscuitT folded before Flop (didn't bet)
Seat 6: alex7512007 (button) folded before Flop (didn't bet)



PokerStars Hand #222956287257:  Hold'em No Limit ($0.05/$0.10 USD) - 2021/01/23 10:06:29 ET
Table 'Lutetia III' 6-max Seat #1 is the button
Seat 1: beta33 ($13.28 in chips) 
Seat 2: Kimi1892 ($13.13 in chips) 
Seat 4: PokerPro EPT ($8.60 in chips) 
Seat 5: KingBiscuitT ($12.10 in chips) 
Seat 6: alex7512007 ($2.84 in chips) 
Kimi1892: posts small blind $0.05
PokerPro EPT: posts big blind $0.10
*** HOLE CARDS ***
KingBiscuitT: raises $0.15 to $0.25
alex7512007: folds 
beta33: folds 
Kimi1892: folds 
PokerPro EPT: calls $0.15
*** FLOP *** [3c 6d Ad]
PokerPro EPT: checks 
KingBiscuitT: bets $0.35
PokerPro EPT: folds 
Uncalled bet ($0.35) returned to KingBiscuitT
KingBiscuitT collected $0.53 from pot
KingBiscuitT: doesn't show hand 
*** SUMMARY ***
Total pot $0.55 | Rake $0.02 
Board [3c 6d Ad]
Seat 1: beta33 (button) folded before Flop (didn't bet)
Seat 2: Kimi1892 (small blind) folded before Flop
Seat 4: PokerPro EPT (big blind) folded on the Flop
Seat 5: KingBiscuitT collected ($0.53)
Seat 6: alex7512007 folded before Flop (didn't bet)



PokerStars Hand #222956300819:  Hold'em No Limit ($0.05/$0.10 USD) - 2021/01/23 10:06:55 ET
Table 'Lutetia III' 6-max Seat #2 is the button
Seat 1: beta33 ($13.28 in chips) 
Seat 2: Kimi1892 ($13.08 in chips) 
Seat 4: PokerPro EPT ($8.35 in chips) 
Seat 5: KingBiscuitT ($12.38 in chips) 
Seat 6: alex7512007 ($2.84 in chips) 
PokerPro EPT: posts small blind $0.05
KingBiscuitT: posts big blind $0.10
*** HOLE CARDS ***
alex7512007: raises $0.20 to $0.30
beta33: folds 
Kimi1892: calls $0.30
PokerPro EPT: calls $0.25
KingBiscuitT: folds 
*** FLOP *** [Ks 2s 5c]
PokerPro EPT: checks 
alex7512007: bets $0.40
Kimi1892: calls $0.40
PokerPro EPT: folds 
*** TURN *** [Ks 2s 5c] [Tc]
alex7512007: checks 
Kimi1892: checks 
*** RIVER *** [Ks 2s 5c Tc] [Js]
alex7512007: bets $0.60
Kimi1892: raises $2 to $2.60
alex7512007: folds 
Uncalled bet ($2) returned to Kimi1892
Kimi1892 collected $2.86 from pot
Kimi1892: doesn't show hand 
*** SUMMARY ***
Total pot $3 | Rake $0.14 
Board [Ks 2s 5c Tc Js]
Seat 1: beta33 folded before Flop (didn't bet)
Seat 2: Kimi1892 (button) collected ($2.86)
Seat 4: PokerPro EPT (small blind) folded on the Flop
Seat 5: KingBiscuitT (big blind) folded before Flop
Seat 6: alex7512007 folded on the River



PokerStars Hand #222956325317:  Hold'em No Limit ($0.05/$0.10 USD) - 2021/01/23 10:07:42 ET
Table 'Lutetia III' 6-max Seat #4 is the button
Seat 1: beta33 ($13.28 in chips) 
Seat 2: Kimi1892 ($14.64 in chips) 
Seat 4: PokerPro EPT ($8.05 in chips) 
Seat 5: KingBiscuitT ($12.28 in chips) 
Seat 6: alex7512007 ($1.54 in chips) 
KingBiscuitT: posts small blind $0.05
alex7512007: posts big blind $0.10
*** HOLE CARDS ***
beta33: folds 
Kimi1892: folds 
PokerPro EPT: folds 
KingBiscuitT: raises $0.15 to $0.25
Darkhorse2205 leaves the table
sheff7880 joins the table at seat #3 
alex7512007: folds 
Uncalled bet ($0.15) returned to KingBiscuitT
KingBiscuitT collected $0.20 from pot
KingBiscuitT: doesn't show hand 
*** SUMMARY ***
Total pot $0.20 | Rake $0 
Seat 1: beta33 folded before Flop (didn't bet)
Seat 2: Kimi1892 folded before Flop (didn't bet)
Seat 4: PokerPro EPT (button) folded before Flop (didn't bet)
Seat 5: KingBiscuitT (small blind) collected ($0.20)
Seat 6: alex7512007 (big blind) folded before Flop



PokerStars Hand #222956334383:  Hold'em No Limit ($0.05/$0.10 USD) - 2021/01/23 10:07:59 ET
Table 'Lutetia III' 6-max Seat #5 is the button
Seat 1: beta33 ($13.28 in chips) 
Seat 2: Kimi1892 ($14.64 in chips) 
Seat 4: PokerPro EPT ($8.05 in chips) 
Seat 5: KingBiscuitT ($12.38 in chips) 
Seat 6: alex7512007 ($1.44 in chips) 
alex7512007: posts small blind $0.05
beta33: posts big blind $0.10
sheff7880: sits out 
*** HOLE CARDS ***
Kimi1892: folds 
PokerPro EPT: raises $0.30 to $0.40
KingBiscuitT: folds 
alex7512007: folds 
beta33: folds 
Uncalled bet ($0.30) returned to PokerPro EPT
PokerPro EPT collected $0.25 from pot
PokerPro EPT: doesn't show hand 
*** SUMMARY ***
Total pot $0.25 | Rake $0 
Seat 1: beta33 (big blind) folded before Flop
Seat 2: Kimi1892 folded before Flop (didn't bet)
Seat 4: PokerPro EPT collected ($0.25)
Seat 5: KingBiscuitT (button) folded before Flop (didn't bet)
Seat 6: alex7512007 (small blind) folded before Flop



PokerStars Hand #222956341891:  Hold'em No Limit ($0.05/$0.10 USD) - 2021/01/23 10:08:14 ET
Table 'Lutetia III' 6-max Seat #6 is the button
Seat 1: beta33 ($13.18 in chips) 
Seat 2: Kimi1892 ($14.64 in chips) 
Seat 4: PokerPro EPT ($8.20 in chips) 
Seat 5: KingBiscuitT ($12.38 in chips) 
Seat 6: alex7512007 ($1.39 in chips) 
beta33: posts small blind $0.05
Kimi1892: posts big blind $0.10
sheff7880: sits out 
*** HOLE CARDS ***
PokerPro EPT: calls $0.10
KingBiscuitT: folds 
alex7512007: folds 
beta33: raises $0.40 to $0.50
Kimi1892: folds 
PokerPro EPT: calls $0.40
*** FLOP *** [Td Ad 5h]
beta33: checks 
PokerPro EPT: bets $0.30
beta33: calls $0.30
*** TURN *** [Td Ad 5h] [2c]
beta33: checks 
PokerPro EPT: bets $0.50
beta33: calls $0.50
*** RIVER *** [Td Ad 5h 2c] [8d]
beta33: checks 
PokerPro EPT: checks 
*** SHOW DOWN ***
beta33: shows [8s 8h] (three of a kind, Eights)
PokerPro EPT: mucks hand 
beta33 collected $2.58 from pot
*** SUMMARY ***
Total pot $2.70 | Rake $0.12 
Board [Td Ad 5h 2c 8d]
Seat 1: beta33 (small blind) showed [8s 8h] and won ($2.58) with three of a kind, Eights
Seat 2: Kimi1892 (big blind) folded before Flop
Seat 4: PokerPro EPT mucked
Seat 5: KingBiscuitT folded before Flop (didn't bet)
Seat 6: alex7512007 (button) folded before Flop (didn't bet)



PokerStars Hand #222956362864:  Hold'em No Limit ($0.05/$0.10 USD) - 2021/01/23 10:08:54 ET
Table 'Lutetia III' 6-max Seat #1 is the button
Seat 1: beta33 ($14.46 in chips) 
Seat 2: Kimi1892 ($14.54 in chips) 
Seat 3: sheff7880 ($10 in chips) 
Seat 4: PokerPro EPT ($6.90 in chips) 
Seat 5: KingBiscuitT ($12.38 in chips) 
Seat 6: alex7512007 ($1.39 in chips) 
Kimi1892: posts small blind $0.05
sheff7880: posts big blind $0.10
*** HOLE CARDS ***
PokerPro EPT: raises $0.70 to $0.80
KingBiscuitT: folds 
alex7512007: folds 
beta33: folds 
Kimi1892: folds 
sheff7880: folds 
Uncalled bet ($0.70) returned to PokerPro EPT
PokerPro EPT collected $0.25 from pot
PokerPro EPT: doesn't show hand 
*** SUMMARY ***
Total pot $0.25 | Rake $0 
Seat 1: beta33 (button) folded before Flop (didn't bet)
Seat 2: Kimi1892 (small blind) folded before Flop
Seat 3: sheff7880 (big blind) folded before Flop
Seat 4: PokerPro EPT collected ($0.25)
Seat 5: KingBiscuitT folded before Flop (didn't bet)
Seat 6: alex7512007 folded before Flop (didn't bet)



PokerStars Hand #222956370798:  Hold'em No Limit ($0.05/$0.10 USD) - 2021/01/23 10:09:09 ET
Table 'Lutetia III' 6-max Seat #2 is the button
Seat 1: beta33 ($14.46 in chips) 
Seat 2: Kimi1892 ($14.49 in chips) 
Seat 3: sheff7880 ($10 in chips) 
Seat 4: PokerPro EPT ($7.05 in chips) 
Seat 5: KingBiscuitT ($12.38 in chips) 
Seat 6: alex7512007 ($1.39 in chips) 
sheff7880: posts small blind $0.05
PokerPro EPT: posts big blind $0.10
*** HOLE CARDS ***
KingBiscuitT: folds 
alex7512007: folds 
beta33: raises $0.20 to $0.30
Kimi1892: folds 
sheff7880: folds 
PokerPro EPT: calls $0.20
*** FLOP *** [Jh 2c Ah]
PokerPro EPT: checks 
beta33: bets $0.40
PokerPro EPT: folds 
Uncalled bet ($0.40) returned to beta33
beta33 collected $0.62 from pot
*** SUMMARY ***
Total pot $0.65 | Rake $0.03 
Board [Jh 2c Ah]
Seat 1: beta33 collected ($0.62)
Seat 2: Kimi1892 (button) folded before Flop (didn't bet)
Seat 3: sheff7880 (small blind) folded before Flop
Seat 4: PokerPro EPT (big blind) folded on the Flop
Seat 5: KingBiscuitT folded before Flop (didn't bet)
Seat 6: alex7512007 folded before Flop (didn't bet)



PokerStars Hand #222956379989:  Hold'em No Limit ($0.05/$0.10 USD) - 2021/01/23 10:09:27 ET
Table 'Lutetia III' 6-max Seat #3 is the button
Seat 1: beta33 ($14.78 in chips) 
Seat 2: Kimi1892 ($14.49 in chips) 
Seat 3: sheff7880 ($10 in chips) 
Seat 4: PokerPro EPT ($6.75 in chips) 
Seat 5: KingBiscuitT ($12.38 in chips) 
Seat 6: alex7512007 ($1.39 in chips) 
PokerPro EPT: posts small blind $0.05
KingBiscuitT: posts big blind $0.10
*** HOLE CARDS ***
alex7512007: folds 
beta33: raises $0.20 to $0.30
Kimi1892: folds 
sheff7880: folds 
PokerPro EPT: folds 
KingBiscuitT: folds 
Uncalled bet ($0.20) returned to beta33
beta33 collected $0.25 from pot
*** SUMMARY ***
Total pot $0.25 | Rake $0 
Seat 1: beta33 collected ($0.25)
Seat 2: Kimi1892 folded before Flop (didn't bet)
Seat 3: sheff7880 (button) folded before Flop (didn't bet)
Seat 4: PokerPro EPT (small blind) folded before Flop
Seat 5: KingBiscuitT (big blind) folded before Flop
Seat 6: alex7512007 folded before Flop (didn't bet)



PokerStars Hand #222956385724:  Hold'em No Limit ($0.05/$0.10 USD) - 2021/01/23 10:09:38 ET
Table 'Lutetia III' 6-max Seat #4 is the button
Seat 1: beta33 ($14.93 in chips) 
Seat 2: Kimi1892 ($14.49 in chips) 
Seat 3: sheff7880 ($10 in chips) 
Seat 4: PokerPro EPT ($6.70 in chips) 
Seat 5: KingBiscuitT ($12.28 in chips) 
Seat 6: alex7512007 ($1.39 in chips) 
KingBiscuitT: posts small blind $0.05
alex7512007: posts big blind $0.10
*** HOLE CARDS ***
beta33: folds 
Kimi1892: folds 
sheff7880: folds 
PokerPro EPT: calls $0.10
KingBiscuitT: folds 
alex7512007: checks 
*** FLOP *** [9h Qs Tc]
alex7512007: checks 
PokerPro EPT: bets $0.20
alex7512007: folds 
Uncalled bet ($0.20) returned to PokerPro EPT
PokerPro EPT collected $0.24 from pot
PokerPro EPT: doesn't show hand 
*** SUMMARY ***
Total pot $0.25 | Rake $0.01 
Board [9h Qs Tc]
Seat 1: beta33 folded before Flop (didn't bet)
Seat 2: Kimi1892 folded before Flop (didn't bet)
Seat 3: sheff7880 folded before Flop (didn't bet)
Seat 4: PokerPro EPT (button) collected ($0.24)
Seat 5: KingBiscuitT (small blind) folded before Flop
Seat 6: alex7512007 (big blind) folded on the Flop



PokerStars Hand #222956399166:  Hold'em No Limit ($0.05/$0.10 USD) - 2021/01/23 10:10:04 ET
Table 'Lutetia III' 6-max Seat #5 is the button
Seat 1: beta33 ($14.93 in chips) 
Seat 2: Kimi1892 ($14.49 in chips) 
Seat 3: sheff7880 ($10 in chips) 
Seat 4: PokerPro EPT ($6.84 in chips) 
Seat 5: KingBiscuitT ($12.23 in chips) 
Seat 6: alex7512007 ($1.29 in chips) 
alex7512007: posts small blind $0.05
beta33: posts big blind $0.10
*** HOLE CARDS ***
Kimi1892: folds 
sheff7880: raises $0.20 to $0.30
PokerPro EPT: calls $0.30
KingBiscuitT: folds 
alex7512007: raises $0.99 to $1.29 and is all-in
beta33: folds 
sheff7880: raises $8.71 to $10 and is all-in
PokerPro EPT: folds 
Uncalled bet ($8.71) returned to sheff7880
alex7512007 has timed out
*** FIRST FLOP *** [Ks Ac 5d]
*** FIRST TURN *** [Ks Ac 5d] [9h]
*** FIRST RIVER *** [Ks Ac 5d 9h] [3s]
*** SECOND FLOP *** [Ad Jc 7d]
*** SECOND TURN *** [Ad Jc 7d] [2d]
*** SECOND RIVER *** [Ad Jc 7d 2d] [9s]
*** FIRST SHOW DOWN ***
alex7512007: shows [Ah Qd] (a pair of Aces)
sheff7880: shows [8d 8h] (a pair of Eights)
alex7512007 collected $1.43 from pot
*** SECOND SHOW DOWN ***
alex7512007: shows [Ah Qd] (a pair of Aces)
sheff7880: shows [8d 8h] (a pair of Eights)
alex7512007 collected $1.42 from pot
*** SUMMARY ***
Total pot $2.98 | Rake $0.13 
Hand was run twice
FIRST Board [Ks Ac 5d 9h 3s]
SECOND Board [Ad Jc 7d 2d 9s]
Seat 1: beta33 (big blind) folded before Flop
Seat 2: Kimi1892 folded before Flop (didn't bet)
Seat 3: sheff7880 showed [8d 8h] and lost with a pair of Eights, and lost with a pair of Eights
Seat 4: PokerPro EPT folded before Flop
Seat 5: KingBiscuitT (button) folded before Flop (didn't bet)
Seat 6: alex7512007 (small blind) showed [Ah Qd] and won ($1.43) with a pair of Aces, and won ($1.42) with a pair of Aces



PokerStars Hand #222956424559:  Hold'em No Limit ($0.05/$0.10 USD) - 2021/01/23 10:10:52 ET
Table 'Lutetia III' 6-max Seat #6 is the button
Seat 1: beta33 ($14.83 in chips) 
Seat 2: Kimi1892 ($14.49 in chips) 
Seat 3: sheff7880 ($10 in chips) 
Seat 4: PokerPro EPT ($6.54 in chips) 
Seat 5: KingBiscuitT ($12.23 in chips) 
Seat 6: alex7512007 ($2.85 in chips) 
beta33: posts small blind $0.05
Kimi1892: posts big blind $0.10
*** HOLE CARDS ***
sheff7880: folds 
PokerPro EPT: calls $0.10
KingBiscuitT: folds 
alex7512007: folds 
beta33: raises $0.40 to $0.50
Kimi1892: folds 
PokerPro EPT: calls $0.40
*** FLOP *** [5s 8c 3h]
beta33: checks 
PokerPro EPT: checks 
*** TURN *** [5s 8c 3h] [3s]
beta33: bets $0.60
PokerPro EPT: folds 
Uncalled bet ($0.60) returned to beta33
beta33 collected $1.05 from pot
*** SUMMARY ***
Total pot $1.10 | Rake $0.05 
Board [5s 8c 3h 3s]
Seat 1: beta33 (small blind) collected ($1.05)
Seat 2: Kimi1892 (big blind) folded before Flop
Seat 3: sheff7880 folded before Flop (didn't bet)
Seat 4: PokerPro EPT folded on the Turn
Seat 5: KingBiscuitT folded before Flop (didn't bet)
Seat 6: alex7512007 (button) folded before Flop (didn't bet)



PokerStars Hand #222956437452:  Hold'em No Limit ($0.05/$0.10 USD) - 2021/01/23 10:11:16 ET
Table 'Lutetia III' 6-max Seat #1 is the button
Seat 1: beta33 ($15.38 in chips) 
Seat 2: Kimi1892 ($14.39 in chips) 
Seat 3: sheff7880 ($10 in chips) 
Seat 4: PokerPro EPT ($6.04 in chips) 
Seat 5: KingBiscuitT ($12.23 in chips) 
Seat 6: alex7512007 ($2.85 in chips) 
Kimi1892: posts small blind $0.05
sheff7880: posts big blind $0.10
*** HOLE CARDS ***
PokerPro EPT: raises $0.20 to $0.30
KingBiscuitT: folds 
alex7512007: folds 
beta33: folds 
Kimi1892: folds 
sheff7880: folds 
Uncalled bet ($0.20) returned to PokerPro EPT
PokerPro EPT collected $0.25 from pot
PokerPro EPT: doesn't show hand 
*** SUMMARY ***
Total pot $0.25 | Rake $0 
Seat 1: beta33 (button) folded before Flop (didn't bet)
Seat 2: Kimi1892 (small blind) folded before Flop
Seat 3: sheff7880 (big blind) folded before Flop
Seat 4: PokerPro EPT collected ($0.25)
Seat 5: KingBiscuitT folded before Flop (didn't bet)
Seat 6: alex7512007 folded before Flop (didn't bet)



PokerStars Hand #222956450128:  Hold'em No Limit ($0.05/$0.10 USD) - 2021/01/23 10:11:40 ET
Table 'Lutetia III' 6-max Seat #2 is the button
Seat 1: beta33 ($15.38 in chips) 
Seat 2: Kimi1892 ($14.34 in chips) 
Seat 3: sheff7880 ($10 in chips) 
Seat 4: PokerPro EPT ($6.19 in chips) 
Seat 5: KingBiscuitT ($12.23 in chips) 
Seat 6: alex7512007 ($2.85 in chips) 
sheff7880: posts small blind $0.05
PokerPro EPT: posts big blind $0.10
*** HOLE CARDS ***
KingBiscuitT: raises $0.15 to $0.25
alex7512007: folds 
beta33: calls $0.25
Kimi1892: calls $0.25
sheff7880: calls $0.20
PokerPro EPT: raises $5.94 to $6.19 and is all-in
KingBiscuitT: folds 
beta33: folds 
Kimi1892: folds 
sheff7880: folds 
Uncalled bet ($5.94) returned to PokerPro EPT
PokerPro EPT collected $1.25 from pot
PokerPro EPT: doesn't show hand 
*** SUMMARY ***
Total pot $1.25 | Rake $0 
Seat 1: beta33 folded before Flop
Seat 2: Kimi1892 (button) folded before Flop
Seat 3: sheff7880 (small blind) folded before Flop
Seat 4: PokerPro EPT (big blind) collected ($1.25)
Seat 5: KingBiscuitT folded before Flop
Seat 6: alex7512007 folded before Flop (didn't bet)



PokerStars Hand #222956469097:  Hold'em No Limit ($0.05/$0.10 USD) - 2021/01/23 10:12:16 ET
Table 'Lutetia III' 6-max Seat #3 is the button
Seat 1: beta33 ($15.13 in chips) 
Seat 2: Kimi1892 ($14.09 in chips) 
Seat 3: sheff7880 ($10 in chips) 
Seat 4: PokerPro EPT ($7.19 in chips) 
Seat 5: KingBiscuitT ($11.98 in chips) 
Seat 6: alex7512007 ($2.85 in chips) 
PokerPro EPT: posts small blind $0.05
KingBiscuitT: posts big blind $0.10
*** HOLE CARDS ***
alex7512007: folds 
beta33: raises $0.20 to $0.30
Kimi1892: folds 
sheff7880: folds 
PokerPro EPT: folds 
KingBiscuitT: folds 
Uncalled bet ($0.20) returned to beta33
beta33 collected $0.25 from pot
*** SUMMARY ***
Total pot $0.25 | Rake $0 
Seat 1: beta33 collected ($0.25)
Seat 2: Kimi1892 folded before Flop (didn't bet)
Seat 3: sheff7880 (button) folded before Flop (didn't bet)
Seat 4: PokerPro EPT (small blind) folded before Flop
Seat 5: KingBiscuitT (big blind) folded before Flop
Seat 6: alex7512007 folded before Flop (didn't bet)



PokerStars Hand #222956473721:  Hold'em No Limit ($0.05/$0.10 USD) - 2021/01/23 10:12:25 ET
Table 'Lutetia III' 6-max Seat #4 is the button
Seat 1: beta33 ($15.28 in chips) 
Seat 2: Kimi1892 ($14.09 in chips) 
Seat 3: sheff7880 ($10 in chips) 
Seat 4: PokerPro EPT ($7.14 in chips) 
Seat 5: KingBiscuitT ($11.88 in chips) 
Seat 6: alex7512007 ($2.85 in chips) 
KingBiscuitT: posts small blind $0.05
alex7512007: posts big blind $0.10
*** HOLE CARDS ***
beta33: raises $0.20 to $0.30
Kimi1892: folds 
sheff7880: folds 
PokerPro EPT: folds 
KingBiscuitT: folds 
alex7512007: folds 
Uncalled bet ($0.20) returned to beta33
beta33 collected $0.25 from pot
*** SUMMARY ***
Total pot $0.25 | Rake $0 
Seat 1: beta33 collected ($0.25)
Seat 2: Kimi1892 folded before Flop (didn't bet)
Seat 3: sheff7880 folded before Flop (didn't bet)
Seat 4: PokerPro EPT (button) folded before Flop (didn't bet)
Seat 5: KingBiscuitT (small blind) folded before Flop
Seat 6: alex7512007 (big blind) folded before Flop



PokerStars Hand #222956486024:  Hold'em No Limit ($0.05/$0.10 USD) - 2021/01/23 10:12:48 ET
Table 'Lutetia III' 6-max Seat #5 is the button
Seat 1: beta33 ($15.43 in chips) 
Seat 2: Kimi1892 ($14.09 in chips) 
Seat 3: sheff7880 ($10 in chips) 
Seat 4: PokerPro EPT ($7.14 in chips) 
Seat 5: KingBiscuitT ($11.83 in chips) 
Seat 6: alex7512007 ($2.75 in chips) 
alex7512007: posts small blind $0.05
beta33: posts big blind $0.10
*** HOLE CARDS ***
Kimi1892: folds 
sheff7880: folds 
PokerPro EPT: calls $0.10
KingBiscuitT: folds 
alex7512007: folds 
beta33: checks 
*** FLOP *** [3c Tc 7c]
beta33: bets $0.20
PokerPro EPT: folds 
Uncalled bet ($0.20) returned to beta33
beta33 collected $0.24 from pot
*** SUMMARY ***
Total pot $0.25 | Rake $0.01 
Board [3c Tc 7c]
Seat 1: beta33 (big blind) collected ($0.24)
Seat 2: Kimi1892 folded before Flop (didn't bet)
Seat 3: sheff7880 folded before Flop (didn't bet)
Seat 4: PokerPro EPT folded on the Flop
Seat 5: KingBiscuitT (button) folded before Flop (didn't bet)
Seat 6: alex7512007 (small blind) folded before Flop



PokerStars Hand #222956499810:  Hold'em No Limit ($0.05/$0.10 USD) - 2021/01/23 10:13:14 ET
Table 'Lutetia III' 6-max Seat #6 is the button
Seat 1: beta33 ($15.57 in chips) 
Seat 2: Kimi1892 ($14.09 in chips) 
Seat 3: sheff7880 ($10 in chips) 
Seat 4: PokerPro EPT ($7.04 in chips) 
Seat 5: KingBiscuitT ($11.83 in chips) 
Seat 6: alex7512007 ($2.70 in chips) 
beta33: posts small blind $0.05
Kimi1892: posts big blind $0.10
*** HOLE CARDS ***
sheff7880: folds 
PokerPro EPT: folds 
PokerPro EPT leaves the table
KingBiscuitT: folds 
alex7512007: folds 
kätzi<3 joins the table at seat #4 
beta33: raises $0.20 to $0.30
Kimi1892: folds 
Uncalled bet ($0.20) returned to beta33
beta33 collected $0.20 from pot
*** SUMMARY ***
Total pot $0.20 | Rake $0 
Seat 1: beta33 (small blind) collected ($0.20)
Seat 2: Kimi1892 (big blind) folded before Flop
Seat 3: sheff7880 folded before Flop (didn't bet)
Seat 4: PokerPro EPT folded before Flop (didn't bet)
Seat 5: KingBiscuitT folded before Flop (didn't bet)
Seat 6: alex7512007 (button) folded before Flop (didn't bet)



PokerStars Hand #222956508805:  Hold'em No Limit ($0.05/$0.10 USD) - 2021/01/23 10:13:31 ET
Table 'Lutetia III' 6-max Seat #1 is the button
Seat 1: beta33 ($15.67 in chips) 
Seat 2: Kimi1892 ($13.99 in chips) 
Seat 3: sheff7880 ($10 in chips) 
Seat 5: KingBiscuitT ($11.83 in chips) 
Seat 6: alex7512007 ($2.70 in chips) 
Kimi1892: posts small blind $0.05
sheff7880: posts big blind $0.10
kätzi<3: sits out 
*** HOLE CARDS ***
KingBiscuitT: folds 
alex7512007: folds 
beta33: raises $0.20 to $0.30
Kimi1892: folds 
sheff7880: raises $0.75 to $1.05
beta33: folds 
Uncalled bet ($0.75) returned to sheff7880
sheff7880 collected $0.65 from pot
sheff7880: doesn't show hand 
*** SUMMARY ***
Total pot $0.65 | Rake $0 
Seat 1: beta33 (button) folded before Flop
Seat 2: Kimi1892 (small blind) folded before Flop
Seat 3: sheff7880 (big blind) collected ($0.65)
Seat 5: KingBiscuitT folded before Flop (didn't bet)
Seat 6: alex7512007 folded before Flop (didn't bet)



PokerStars Hand #222956524647:  Hold'em No Limit ($0.05/$0.10 USD) - 2021/01/23 10:14:01 ET
Table 'Lutetia III' 6-max Seat #2 is the button
Seat 1: beta33 ($15.37 in chips) 
Seat 2: Kimi1892 ($13.94 in chips) 
Seat 3: sheff7880 ($10.35 in chips) 
Seat 4: kätzi<3 ($8 in chips) 
Seat 5: KingBiscuitT ($11.83 in chips) 
Seat 6: alex7512007 ($2.70 in chips) 
sheff7880: posts small blind $0.05
kätzi<3: posts big blind $0.10
*** HOLE CARDS ***
KingBiscuitT: folds 
alex7512007: folds 
beta33: folds 
Kimi1892: folds 
sheff7880: folds 
Uncalled bet ($0.05) returned to kätzi<3
kätzi<3 collected $0.10 from pot
kätzi<3: doesn't show hand 
*** SUMMARY ***
Total pot $0.10 | Rake $0 
Seat 1: beta33 folded before Flop (didn't bet)
Seat 2: Kimi1892 (button) folded before Flop (didn't bet)
Seat 3: sheff7880 (small blind) folded before Flop
Seat 4: kätzi<3 (big blind) collected ($0.10)
Seat 5: KingBiscuitT folded before Flop (didn't bet)
Seat 6: alex7512007 folded before Flop (didn't bet)



PokerStars Hand #222956531783:  Hold'em No Limit ($0.05/$0.10 USD) - 2021/01/23 10:14:14 ET
Table 'Lutetia III' 6-max Seat #3 is the button
Seat 1: beta33 ($15.37 in chips) 
Seat 2: Kimi1892 ($13.94 in chips) 
Seat 3: sheff7880 ($10.30 in chips) 
Seat 4: kätzi<3 ($8.05 in chips) 
Seat 5: KingBiscuitT ($11.83 in chips) 
Seat 6: alex7512007 ($2.70 in chips) 
kätzi<3: posts small blind $0.05
KingBiscuitT: posts big blind $0.10
*** HOLE CARDS ***
alex7512007: raises $0.20 to $0.30
beta33: folds 
Kimi1892: folds 
sheff7880: folds 
kätzi<3: folds 
KingBiscuitT: folds 
Uncalled bet ($0.20) returned to alex7512007
alex7512007 collected $0.25 from pot
*** SUMMARY ***
Total pot $0.25 | Rake $0 
Seat 1: beta33 folded before Flop (didn't bet)
Seat 2: Kimi1892 folded before Flop (didn't bet)
Seat 3: sheff7880 (button) folded before Flop (didn't bet)
Seat 4: kätzi<3 (small blind) folded before Flop
Seat 5: KingBiscuitT (big blind) folded before Flop
Seat 6: alex7512007 collected ($0.25)



PokerStars Hand #222956540163:  Hold'em No Limit ($0.05/$0.10 USD) - 2021/01/23 10:14:30 ET
Table 'Lutetia III' 6-max Seat #4 is the button
Seat 1: beta33 ($15.37 in chips) 
Seat 2: Kimi1892 ($13.94 in chips) 
Seat 3: sheff7880 ($10.30 in chips) 
Seat 4: kätzi<3 ($8 in chips) 
Seat 5: KingBiscuitT ($11.73 in chips) 
KingBiscuitT: posts small blind $0.05
alex7512007: is sitting out 
beta33: posts big blind $0.10
*** HOLE CARDS ***
Kimi1892: folds 
sheff7880: raises $0.20 to $0.30
alex7512007 leaves the table
kätzi<3: calls $0.30
KingBiscuitT: raises $0.90 to $1.20
Tomsik1997 joins the table at seat #6 
beta33: raises $1.30 to $2.50
sheff7880: folds 
kätzi<3: folds 
KingBiscuitT: calls $1.30
*** FLOP *** [8c 4s Ts]
KingBiscuitT: checks 
Tomsik1997 leaves the table
beta33: checks 
*** TURN *** [8c 4s Ts] [Tc]
KingBiscuitT: bets $5.35
beta33: folds 
Uncalled bet ($5.35) returned to KingBiscuitT
KingBiscuitT collected $5.35 from pot
KingBiscuitT: doesn't show hand 
*** SUMMARY ***
Total pot $5.60 | Rake $0.25 
Board [8c 4s Ts Tc]
Seat 1: beta33 (big blind) folded on the Turn
Seat 2: Kimi1892 folded before Flop (didn't bet)
Seat 3: sheff7880 folded before Flop
Seat 4: kätzi<3 (button) folded before Flop
Seat 5: KingBiscuitT (small blind) collected ($5.35)



PokerStars Hand #222956563233:  Hold'em No Limit ($0.05/$0.10 USD) - 2021/01/23 10:15:13 ET
Table 'Lutetia III' 6-max Seat #5 is the button
Seat 1: beta33 ($12.87 in chips) 
Seat 3: sheff7880 ($10 in chips) 
Seat 4: kätzi<3 ($7.70 in chips) 
Seat 5: KingBiscuitT ($14.58 in chips) 
beta33: posts small blind $0.05
Kimi1892: is sitting out 
sheff7880: posts big blind $0.10
*** HOLE CARDS ***
alex7512007 joins the table at seat #6 
kätzi<3: folds 
KingBiscuitT: folds 
beta33: folds 
Uncalled bet ($0.05) returned to sheff7880
sheff7880 collected $0.10 from pot
sheff7880: doesn't show hand 
*** SUMMARY ***
Total pot $0.10 | Rake $0 
Seat 1: beta33 (small blind) folded before Flop
Seat 3: sheff7880 (big blind) collected ($0.10)
Seat 4: kätzi<3 folded before Flop (didn't bet)
Seat 5: KingBiscuitT (button) folded before Flop (didn't bet)



PokerStars Hand #222956569526:  Hold'em No Limit ($0.05/$0.10 USD) - 2021/01/23 10:15:25 ET
Table 'Lutetia III' 6-max Seat #1 is the button
Seat 1: beta33 ($12.82 in chips) 
Seat 3: sheff7880 ($10.05 in chips) 
Seat 4: kätzi<3 ($7.70 in chips) 
Seat 5: KingBiscuitT ($14.58 in chips) 
sheff7880: posts small blind $0.05
kätzi<3: posts big blind $0.10
alex7512007: sits out 
*** HOLE CARDS ***
alex7512007 leaves the table
KingBiscuitT: folds 
beta33: raises $0.20 to $0.30
sheff7880: folds 
kätzi<3: calls $0.20
*** FLOP *** [8c Ah 6c]
FrameRate123 joins the table at seat #6 
kätzi<3: bets $0.40
Kimi1892 leaves the table
beta33: calls $0.40
*** TURN *** [8c Ah 6c] [Th]
alex7512007 joins the table at seat #2 
kätzi<3: checks 
alex7512007 leaves the table
beta33: checks 
*** RIVER *** [8c Ah 6c Th] [Qd]
Gintaras20 joins the table at seat #2 
kätzi<3: bets $1
beta33: folds 
Uncalled bet ($1) returned to kätzi<3
kätzi<3 collected $1.38 from pot
kätzi<3: doesn't show hand 
*** SUMMARY ***
Total pot $1.45 | Rake $0.07 
Board [8c Ah 6c Th Qd]
Seat 1: beta33 (button) folded on the River
Seat 3: sheff7880 (small blind) folded before Flop
Seat 4: kätzi<3 (big blind) collected ($1.38)
Seat 5: KingBiscuitT folded before Flop (didn't bet)



PokerStars Hand #222956601310:  Hold'em No Limit ($0.05/$0.10 USD) - 2021/01/23 10:16:24 ET
Table 'Lutetia III' 6-max Seat #3 is the button
Seat 1: beta33 ($12.12 in chips) 
Seat 3: sheff7880 ($10 in chips) 
Seat 4: kätzi<3 ($8.38 in chips) 
Seat 5: KingBiscuitT ($14.58 in chips) 
kätzi<3: posts small blind $0.05
KingBiscuitT: posts big blind $0.10
FrameRate123: sits out 
Gintaras20: sits out 
*** HOLE CARDS ***
beta33: folds 
sheff7880: raises $0.20 to $0.30
kätzi<3: calls $0.25
KingBiscuitT: folds 
*** FLOP *** [Ks 3c Qh]
kätzi<3: bets $0.30
sheff7880: folds 
Uncalled bet ($0.30) returned to kätzi<3
kätzi<3 collected $0.67 from pot
kätzi<3: doesn't show hand 
*** SUMMARY ***
Total pot $0.70 | Rake $0.03 
Board [Ks 3c Qh]
Seat 1: beta33 folded before Flop (didn't bet)
Seat 3: sheff7880 (button) folded on the Flop
Seat 4: kätzi<3 (small blind) collected ($0.67)
Seat 5: KingBiscuitT (big blind) folded before Flop



PokerStars Hand #222956623485:  Hold'em No Limit ($0.05/$0.10 USD) - 2021/01/23 10:17:06 ET
Table 'Lutetia III' 6-max Seat #4 is the button
Seat 1: beta33 ($12.12 in chips) 
Seat 3: sheff7880 ($10 in chips) 
Seat 4: kätzi<3 ($8.75 in chips) 
Seat 5: KingBiscuitT ($14.48 in chips) 
Seat 6: FrameRate123 ($5 in chips) 
KingBiscuitT: posts small blind $0.05
FrameRate123: posts big blind $0.10
Gintaras20: sits out 
*** HOLE CARDS ***
beta33: folds 
sheff7880: folds 
kätzi<3: raises $0.10 to $0.20
KingBiscuitT: folds 
FrameRate123: calls $0.10
*** FLOP *** [9c 2h Td]
FrameRate123: checks 
kätzi<3: bets $0.30
FrameRate123: folds 
Uncalled bet ($0.30) returned to kätzi<3
kätzi<3 collected $0.43 from pot
kätzi<3: doesn't show hand 
*** SUMMARY ***
Total pot $0.45 | Rake $0.02 
Board [9c 2h Td]
Seat 1: beta33 folded before Flop (didn't bet)
Seat 3: sheff7880 folded before Flop (didn't bet)
Seat 4: kätzi<3 (button) collected ($0.43)
Seat 5: KingBiscuitT (small blind) folded before Flop
Seat 6: FrameRate123 (big blind) folded on the Flop



PokerStars Hand #222956637422:  Hold'em No Limit ($0.05/$0.10 USD) - 2021/01/23 10:17:32 ET
Table 'Lutetia III' 6-max Seat #5 is the button
Seat 1: beta33 ($12.12 in chips) 
Seat 3: sheff7880 ($10 in chips) 
Seat 4: kätzi<3 ($8.98 in chips) 
Seat 5: KingBiscuitT ($14.43 in chips) 
Seat 6: FrameRate123 ($4.80 in chips) 
FrameRate123: posts small blind $0.05
beta33: posts big blind $0.10
Gintaras20: sits out 
*** HOLE CARDS ***
sheff7880: folds 
kätzi<3: folds 
KingBiscuitT: raises $0.15 to $0.25
FrameRate123: folds 
beta33: folds 
Uncalled bet ($0.15) returned to KingBiscuitT
KingBiscuitT collected $0.25 from pot
KingBiscuitT: doesn't show hand 
*** SUMMARY ***
Total pot $0.25 | Rake $0 
Seat 1: beta33 (big blind) folded before Flop
Seat 3: sheff7880 folded before Flop (didn't bet)
Seat 4: kätzi<3 folded before Flop (didn't bet)
Seat 5: KingBiscuitT (button) collected ($0.25)
Seat 6: FrameRate123 (small blind) folded before Flop



PokerStars Hand #222956646381:  Hold'em No Limit ($0.05/$0.10 USD) - 2021/01/23 10:17:48 ET
Table 'Lutetia III' 6-max Seat #6 is the button
Seat 1: beta33 ($12.02 in chips) 
Seat 2: Gintaras20 ($10 in chips) 
Seat 3: sheff7880 ($10 in chips) 
Seat 4: kätzi<3 ($8.98 in chips) 
Seat 5: KingBiscuitT ($14.58 in chips) 
Seat 6: FrameRate123 ($4.75 in chips) 
beta33: posts small blind $0.05
Gintaras20: posts big blind $0.10
*** HOLE CARDS ***
sheff7880: folds 
kätzi<3: folds 
KingBiscuitT: folds 
FrameRate123: calls $0.10
beta33: folds 
Gintaras20: checks 
*** FLOP *** [2h 7c 2c]
Gintaras20: checks 
FrameRate123: checks 
*** TURN *** [2h 7c 2c] [Jh]
Gintaras20: checks 
FrameRate123: checks 
*** RIVER *** [2h 7c 2c Jh] [6h]
Gintaras20: checks 
FrameRate123: checks 
*** SHOW DOWN ***
Gintaras20: shows [5d Qd] (a pair of Deuces)
FrameRate123: shows [Ac 6s] (two pair, Sixes and Deuces)
FrameRate123 collected $0.24 from pot
*** SUMMARY ***
Total pot $0.25 | Rake $0.01 
Board [2h 7c 2c Jh 6h]
Seat 1: beta33 (small blind) folded before Flop
Seat 2: Gintaras20 (big blind) showed [5d Qd] and lost with a pair of Deuces
Seat 3: sheff7880 folded before Flop (didn't bet)
Seat 4: kätzi<3 folded before Flop (didn't bet)
Seat 5: KingBiscuitT folded before Flop (didn't bet)
Seat 6: FrameRate123 (button) showed [Ac 6s] and won ($0.24) with two pair, Sixes and Deuces



PokerStars Hand #222956662505:  Hold'em No Limit ($0.05/$0.10 USD) - 2021/01/23 10:18:19 ET
Table 'Lutetia III' 6-max Seat #1 is the button
Seat 1: beta33 ($11.97 in chips) 
Seat 2: Gintaras20 ($9.90 in chips) 
Seat 3: sheff7880 ($10 in chips) 
Seat 4: kätzi<3 ($8.98 in chips) 
Seat 5: KingBiscuitT ($14.58 in chips) 
Seat 6: FrameRate123 ($4.89 in chips) 
Gintaras20: posts small blind $0.05
sheff7880: posts big blind $0.10
*** HOLE CARDS ***
kätzi<3: folds 
KingBiscuitT: folds 
FrameRate123: calls $0.10
beta33: raises $0.30 to $0.40
Gintaras20: folds 
sheff7880: folds 
FrameRate123: calls $0.30
*** FLOP *** [3s Jh Kd]
FrameRate123: checks 
beta33: checks 
*** TURN *** [3s Jh Kd] [Ad]
FrameRate123: checks 
beta33: checks 
*** RIVER *** [3s Jh Kd Ad] [4c]
FrameRate123: bets $0.50
beta33: folds 
Uncalled bet ($0.50) returned to FrameRate123
FrameRate123 collected $0.91 from pot
FrameRate123: doesn't show hand 
*** SUMMARY ***
Total pot $0.95 | Rake $0.04 
Board [3s Jh Kd Ad 4c]
Seat 1: beta33 (button) folded on the River
Seat 2: Gintaras20 (small blind) folded before Flop
Seat 3: sheff7880 (big blind) folded before Flop
Seat 4: kätzi<3 folded before Flop (didn't bet)
Seat 5: KingBiscuitT folded before Flop (didn't bet)
Seat 6: FrameRate123 collected ($0.91)



PokerStars Hand #222956684215:  Hold'em No Limit ($0.05/$0.10 USD) - 2021/01/23 10:18:59 ET
Table 'Lutetia III' 6-max Seat #2 is the button
Seat 1: beta33 ($11.57 in chips) 
Seat 2: Gintaras20 ($9.85 in chips) 
Seat 3: sheff7880 ($10 in chips) 
Seat 4: kätzi<3 ($8.98 in chips) 
Seat 5: KingBiscuitT ($14.58 in chips) 
Seat 6: FrameRate123 ($5.40 in chips) 
sheff7880: posts small blind $0.05
kätzi<3: posts big blind $0.10
*** HOLE CARDS ***
KingBiscuitT: folds 
FrameRate123: folds 
beta33: folds 
Gintaras20: raises $0.15 to $0.25
sheff7880: folds 
kätzi<3: folds 
Uncalled bet ($0.15) returned to Gintaras20
Gintaras20 collected $0.25 from pot
Gintaras20: doesn't show hand 
*** SUMMARY ***
Total pot $0.25 | Rake $0 
Seat 1: beta33 folded before Flop (didn't bet)
Seat 2: Gintaras20 (button) collected ($0.25)
Seat 3: sheff7880 (small blind) folded before Flop
Seat 4: kätzi<3 (big blind) folded before Flop
Seat 5: KingBiscuitT folded before Flop (didn't bet)
Seat 6: FrameRate123 folded before Flop (didn't bet)



PokerStars Hand #222956697025:  Hold'em No Limit ($0.05/$0.10 USD) - 2021/01/23 10:19:23 ET
Table 'Lutetia III' 6-max Seat #3 is the button
Seat 1: beta33 ($11.57 in chips) 
Seat 2: Gintaras20 ($10 in chips) 
Seat 3: sheff7880 ($10 in chips) 
Seat 4: kätzi<3 ($8.88 in chips) 
Seat 5: KingBiscuitT ($14.58 in chips) 
Seat 6: FrameRate123 ($5.40 in chips) 
kätzi<3: posts small blind $0.05
KingBiscuitT: posts big blind $0.10
*** HOLE CARDS ***
FrameRate123: folds 
beta33: raises $0.20 to $0.30
Gintaras20: folds 
sheff7880: folds 
kätzi<3: folds 
KingBiscuitT: folds 
Uncalled bet ($0.20) returned to beta33
beta33 collected $0.25 from pot
*** SUMMARY ***
Total pot $0.25 | Rake $0 
Seat 1: beta33 collected ($0.25)
Seat 2: Gintaras20 folded before Flop (didn't bet)
Seat 3: sheff7880 (button) folded before Flop (didn't bet)
Seat 4: kätzi<3 (small blind) folded before Flop
Seat 5: KingBiscuitT (big blind) folded before Flop
Seat 6: FrameRate123 folded before Flop (didn't bet)



PokerStars Hand #222956706145:  Hold'em No Limit ($0.05/$0.10 USD) - 2021/01/23 10:19:40 ET
Table 'Lutetia III' 6-max Seat #4 is the button
Seat 1: beta33 ($11.72 in chips) 
Seat 2: Gintaras20 ($10 in chips) 
Seat 3: sheff7880 ($10 in chips) 
Seat 4: kätzi<3 ($8.83 in chips) 
Seat 5: KingBiscuitT ($14.48 in chips) 
Seat 6: FrameRate123 ($5.40 in chips) 
KingBiscuitT: posts small blind $0.05
FrameRate123: posts big blind $0.10
*** HOLE CARDS ***
beta33: folds 
Gintaras20: folds 
sheff7880: folds 
kätzi<3: folds 
KingBiscuitT: raises $0.20 to $0.30
FrameRate123: calls $0.20
*** FLOP *** [Kd As Tc]
KingBiscuitT: checks 
FrameRate123: bets $0.30
KingBiscuitT: folds 
Uncalled bet ($0.30) returned to FrameRate123
FrameRate123 collected $0.57 from pot
FrameRate123: doesn't show hand 
*** SUMMARY ***
Total pot $0.60 | Rake $0.03 
Board [Kd As Tc]
Seat 1: beta33 folded before Flop (didn't bet)
Seat 2: Gintaras20 folded before Flop (didn't bet)
Seat 3: sheff7880 folded before Flop (didn't bet)
Seat 4: kätzi<3 (button) folded before Flop (didn't bet)
Seat 5: KingBiscuitT (small blind) folded on the Flop
Seat 6: FrameRate123 (big blind) collected ($0.57)



PokerStars Hand #222956721796:  Hold'em No Limit ($0.05/$0.10 USD) - 2021/01/23 10:20:09 ET
Table 'Lutetia III' 6-max Seat #5 is the button
Seat 1: beta33 ($11.72 in chips) 
Seat 2: Gintaras20 ($10 in chips) 
Seat 3: sheff7880 ($10 in chips) 
Seat 4: kätzi<3 ($8.83 in chips) 
Seat 5: KingBiscuitT ($14.18 in chips) 
Seat 6: FrameRate123 ($5.67 in chips) 
FrameRate123: posts small blind $0.05
beta33: posts big blind $0.10
*** HOLE CARDS ***
Gintaras20: raises $0.15 to $0.25
sheff7880: folds 
kätzi<3: folds 
KingBiscuitT: raises $0.65 to $0.90
FrameRate123: folds 
beta33: folds 
Gintaras20: calls $0.65
*** FLOP *** [8h 9h 8d]
Gintaras20: checks 
KingBiscuitT: bets $0.56
Gintaras20: calls $0.56
*** TURN *** [8h 9h 8d] [Kd]
Gintaras20: checks 
KingBiscuitT: checks 
*** RIVER *** [8h 9h 8d Kd] [6s]
Gintaras20: checks 
KingBiscuitT: checks 
*** SHOW DOWN ***
Gintaras20: shows [Qh Kc] (two pair, Kings and Eights)
KingBiscuitT: mucks hand 
Gintaras20 collected $2.93 from pot
*** SUMMARY ***
Total pot $3.07 | Rake $0.14 
Board [8h 9h 8d Kd 6s]
Seat 1: beta33 (big blind) folded before Flop
Seat 2: Gintaras20 showed [Qh Kc] and won ($2.93) with two pair, Kings and Eights
Seat 3: sheff7880 folded before Flop (didn't bet)
Seat 4: kätzi<3 folded before Flop (didn't bet)
Seat 5: KingBiscuitT (button) mucked
Seat 6: FrameRate123 (small blind) folded before Flop



PokerStars Hand #222956737111:  Hold'em No Limit ($0.05/$0.10 USD) - 2021/01/23 10:20:38 ET
Table 'Lutetia III' 6-max Seat #6 is the button
Seat 1: beta33 ($11.62 in chips) 
Seat 2: Gintaras20 ($11.47 in chips) 
Seat 3: sheff7880 ($10 in chips) 
Seat 4: kätzi<3 ($8.83 in chips) 
Seat 5: KingBiscuitT ($12.72 in chips) 
Seat 6: FrameRate123 ($5.62 in chips) 
beta33: posts small blind $0.05
Gintaras20: posts big blind $0.10
*** HOLE CARDS ***
sheff7880: folds 
kätzi<3: folds 
KingBiscuitT: raises $0.15 to $0.25
FrameRate123: calls $0.25
beta33: folds 
Gintaras20: folds 
*** FLOP *** [5h 4s 7h]
KingBiscuitT: bets $0.41
FrameRate123: calls $0.41
*** TURN *** [5h 4s 7h] [8d]
KingBiscuitT: bets $2.10
FrameRate123: calls $2.10
*** RIVER *** [5h 4s 7h 8d] [Jd]
KingBiscuitT: bets $5.41
FrameRate123: calls $2.86 and is all-in
Uncalled bet ($2.55) returned to KingBiscuitT
*** SHOW DOWN ***
KingBiscuitT: shows [Ac 6c] (a straight, Four to Eight)
FrameRate123: shows [Ah Jh] (a pair of Jacks)
KingBiscuitT collected $10.88 from pot
*** SUMMARY ***
Total pot $11.39 | Rake $0.51 
Board [5h 4s 7h 8d Jd]
Seat 1: beta33 (small blind) folded before Flop
Seat 2: Gintaras20 (big blind) folded before Flop
Seat 3: sheff7880 folded before Flop (didn't bet)
Seat 4: kätzi<3 folded before Flop (didn't bet)
Seat 5: KingBiscuitT showed [Ac 6c] and won ($10.88) with a straight, Four to Eight
Seat 6: FrameRate123 (button) showed [Ah Jh] and lost with a pair of Jacks



PokerStars Hand #222956759709:  Hold'em No Limit ($0.05/$0.10 USD) - 2021/01/23 10:21:20 ET
Table 'Lutetia III' 6-max Seat #1 is the button
Seat 1: beta33 ($11.57 in chips) 
Seat 2: Gintaras20 ($11.37 in chips) 
Seat 3: sheff7880 ($10 in chips) 
Seat 4: kätzi<3 ($8.83 in chips) 
Seat 5: KingBiscuitT ($17.98 in chips) 
Gintaras20: posts small blind $0.05
sheff7880: posts big blind $0.10
*** HOLE CARDS ***
kätzi<3: folds 
KingBiscuitT: folds 
beta33: folds 
Gintaras20: folds 
Uncalled bet ($0.05) returned to sheff7880
sheff7880 collected $0.10 from pot
sheff7880: doesn't show hand 
*** SUMMARY ***
Total pot $0.10 | Rake $0 
Seat 1: beta33 (button) folded before Flop (didn't bet)
Seat 2: Gintaras20 (small blind) folded before Flop
Seat 3: sheff7880 (big blind) collected ($0.10)
Seat 4: kätzi<3 folded before Flop (didn't bet)
Seat 5: KingBiscuitT folded before Flop (didn't bet)



PokerStars Hand #222956764186:  Hold'em No Limit ($0.05/$0.10 USD) - 2021/01/23 10:21:28 ET
Table 'Lutetia III' 6-max Seat #2 is the button
Seat 1: beta33 ($11.57 in chips) 
Seat 2: Gintaras20 ($11.32 in chips) 
Seat 3: sheff7880 ($10.05 in chips) 
Seat 4: kätzi<3 ($8.83 in chips) 
Seat 5: KingBiscuitT ($17.98 in chips) 
sheff7880: posts small blind $0.05
kätzi<3: posts big blind $0.10
*** HOLE CARDS ***
KingBiscuitT: folds 
beta33: folds 
Gintaras20: folds 
sheff7880: folds 
Uncalled bet ($0.05) returned to kätzi<3
kätzi<3 collected $0.10 from pot
kätzi<3: doesn't show hand 
*** SUMMARY ***
Total pot $0.10 | Rake $0 
Seat 1: beta33 folded before Flop (didn't bet)
Seat 2: Gintaras20 (button) folded before Flop (didn't bet)
Seat 3: sheff7880 (small blind) folded before Flop
Seat 4: kätzi<3 (big blind) collected ($0.10)
Seat 5: KingBiscuitT folded before Flop (didn't bet)



PokerStars Hand #222956771601:  Hold'em No Limit ($0.05/$0.10 USD) - 2021/01/23 10:21:42 ET
Table 'Lutetia III' 6-max Seat #3 is the button
Seat 1: beta33 ($11.57 in chips) 
Seat 2: Gintaras20 ($11.32 in chips) 
Seat 3: sheff7880 ($10 in chips) 
Seat 4: kätzi<3 ($8.88 in chips) 
Seat 5: KingBiscuitT ($17.98 in chips) 
Seat 6: FrameRate123 ($5 in chips) 
kätzi<3: posts small blind $0.05
KingBiscuitT: posts big blind $0.10
*** HOLE CARDS ***
FrameRate123: raises $0.30 to $0.40
beta33: folds 
Gintaras20: folds 
sheff7880: folds 
kätzi<3: folds 
KingBiscuitT: folds 
Uncalled bet ($0.30) returned to FrameRate123
FrameRate123 collected $0.25 from pot
FrameRate123: doesn't show hand 
*** SUMMARY ***
Total pot $0.25 | Rake $0 
Seat 1: beta33 folded before Flop (didn't bet)
Seat 2: Gintaras20 folded before Flop (didn't bet)
Seat 3: sheff7880 (button) folded before Flop (didn't bet)
Seat 4: kätzi<3 (small blind) folded before Flop
Seat 5: KingBiscuitT (big blind) folded before Flop
Seat 6: FrameRate123 collected ($0.25)



PokerStars Hand #222956780320:  Hold'em No Limit ($0.05/$0.10 USD) - 2021/01/23 10:21:58 ET
Table 'Lutetia III' 6-max Seat #4 is the button
Seat 1: beta33 ($11.57 in chips) 
Seat 2: Gintaras20 ($11.32 in chips) 
Seat 3: sheff7880 ($10 in chips) 
Seat 4: kätzi<3 ($8.83 in chips) 
Seat 5: KingBiscuitT ($17.88 in chips) 
Seat 6: FrameRate123 ($5.15 in chips) 
KingBiscuitT: posts small blind $0.05
FrameRate123: posts big blind $0.10
*** HOLE CARDS ***
beta33: folds 
Gintaras20: folds 
sheff7880: folds 
kätzi<3: folds 
KingBiscuitT: folds 
Uncalled bet ($0.05) returned to FrameRate123
FrameRate123 collected $0.10 from pot
FrameRate123: doesn't show hand 
*** SUMMARY ***
Total pot $0.10 | Rake $0 
Seat 1: beta33 folded before Flop (didn't bet)
Seat 2: Gintaras20 folded before Flop (didn't bet)
Seat 3: sheff7880 folded before Flop (didn't bet)
Seat 4: kätzi<3 (button) folded before Flop (didn't bet)
Seat 5: KingBiscuitT (small blind) folded before Flop
Seat 6: FrameRate123 (big blind) collected ($0.10)



PokerStars Hand #222956783879:  Hold'em No Limit ($0.05/$0.10 USD) - 2021/01/23 10:22:05 ET
Table 'Lutetia III' 6-max Seat #5 is the button
Seat 1: beta33 ($11.57 in chips) 
Seat 2: Gintaras20 ($11.32 in chips) 
Seat 3: sheff7880 ($10 in chips) 
Seat 4: kätzi<3 ($8.83 in chips) 
Seat 5: KingBiscuitT ($17.83 in chips) 
Seat 6: FrameRate123 ($5.20 in chips) 
FrameRate123: posts small blind $0.05
beta33: posts big blind $0.10
*** HOLE CARDS ***
Gintaras20: folds 
sheff7880: folds 
kätzi<3: raises $0.20 to $0.30
KingBiscuitT: folds 
FrameRate123: calls $0.25
beta33: folds 
*** FLOP *** [5h Jh Js]
FrameRate123: checks 
kätzi<3: bets $0.40
FrameRate123: raises $0.60 to $1
kätzi<3: calls $0.60
*** TURN *** [5h Jh Js] [Qc]
FrameRate123: checks 
kätzi<3: checks 
*** RIVER *** [5h Jh Js Qc] [Kd]
FrameRate123: bets $1.50
kätzi<3: folds 
Uncalled bet ($1.50) returned to FrameRate123
FrameRate123 collected $2.58 from pot
FrameRate123: doesn't show hand 
*** SUMMARY ***
Total pot $2.70 | Rake $0.12 
Board [5h Jh Js Qc Kd]
Seat 1: beta33 (big blind) folded before Flop
Seat 2: Gintaras20 folded before Flop (didn't bet)
Seat 3: sheff7880 folded before Flop (didn't bet)
Seat 4: kätzi<3 folded on the River
Seat 5: KingBiscuitT (button) folded before Flop (didn't bet)
Seat 6: FrameRate123 (small blind) collected ($2.58)



PokerStars Hand #222956823515:  Hold'em No Limit ($0.05/$0.10 USD) - 2021/01/23 10:23:18 ET
Table 'Lutetia III' 6-max Seat #6 is the button
Seat 1: beta33 ($11.47 in chips) 
Seat 2: Gintaras20 ($11.32 in chips) 
Seat 3: sheff7880 ($10 in chips) 
Seat 4: kätzi<3 ($7.53 in chips) 
Seat 5: KingBiscuitT ($17.83 in chips) 
Seat 6: FrameRate123 ($6.48 in chips) 
beta33: posts small blind $0.05
Gintaras20: posts big blind $0.10
*** HOLE CARDS ***
sheff7880: folds 
kätzi<3: folds 
KingBiscuitT: folds 
FrameRate123 has timed out
FrameRate123: folds 
beta33: folds 
Uncalled bet ($0.05) returned to Gintaras20
Gintaras20 collected $0.10 from pot
Gintaras20: doesn't show hand 
*** SUMMARY ***
Total pot $0.10 | Rake $0 
Seat 1: beta33 (small blind) folded before Flop
Seat 2: Gintaras20 (big blind) collected ($0.10)
Seat 3: sheff7880 folded before Flop (didn't bet)
Seat 4: kätzi<3 folded before Flop (didn't bet)
Seat 5: KingBiscuitT folded before Flop (didn't bet)
Seat 6: FrameRate123 (button) folded before Flop (didn't bet)



PokerStars Hand #222956837483:  Hold'em No Limit ($0.05/$0.10 USD) - 2021/01/23 10:23:44 ET
Table 'Lutetia III' 6-max Seat #1 is the button
Seat 1: beta33 ($11.42 in chips) 
Seat 2: Gintaras20 ($11.37 in chips) 
Seat 3: sheff7880 ($10 in chips) 
Seat 4: kätzi<3 ($7.53 in chips) 
Seat 5: KingBiscuitT ($17.83 in chips) 
Seat 6: FrameRate123 ($6.48 in chips) 
Gintaras20: posts small blind $0.05
sheff7880: posts big blind $0.10
*** HOLE CARDS ***
kätzi<3: raises $0.20 to $0.30
KingBiscuitT: raises $1.60 to $1.90
FrameRate123: folds 
beta33: folds 
Gintaras20: folds 
sheff7880: folds 
kätzi<3: folds 
Uncalled bet ($1.60) returned to KingBiscuitT
KingBiscuitT collected $0.75 from pot
KingBiscuitT: doesn't show hand 
*** SUMMARY ***
Total pot $0.75 | Rake $0 
Seat 1: beta33 (button) folded before Flop (didn't bet)
Seat 2: Gintaras20 (small blind) folded before Flop
Seat 3: sheff7880 (big blind) folded before Flop
Seat 4: kätzi<3 folded before Flop
Seat 5: KingBiscuitT collected ($0.75)
Seat 6: FrameRate123 folded before Flop (didn't bet)



PokerStars Hand #222956854737:  Hold'em No Limit ($0.05/$0.10 USD) - 2021/01/23 10:24:16 ET
Table 'Lutetia III' 6-max Seat #2 is the button
Seat 1: beta33 ($11.42 in chips) 
Seat 2: Gintaras20 ($11.32 in chips) 
Seat 3: sheff7880 ($10 in chips) 
Seat 4: kätzi<3 ($7.23 in chips) 
Seat 5: KingBiscuitT ($18.28 in chips) 
Seat 6: FrameRate123 ($6.48 in chips) 
sheff7880: posts small blind $0.05
kätzi<3: posts big blind $0.10
*** HOLE CARDS ***
KingBiscuitT: folds 
FrameRate123: folds 
beta33: folds 
Gintaras20: raises $0.15 to $0.25
sheff7880: folds 
kätzi<3: calls $0.15
*** FLOP *** [7c 8h 8s]
kätzi<3: bets $0.40
Gintaras20: calls $0.40
*** TURN *** [7c 8h 8s] [Ah]
kätzi<3: bets $1.29
Gintaras20: folds 
Uncalled bet ($1.29) returned to kätzi<3
kätzi<3 collected $1.29 from pot
kätzi<3: doesn't show hand 
*** SUMMARY ***
Total pot $1.35 | Rake $0.06 
Board [7c 8h 8s Ah]
Seat 1: beta33 folded before Flop (didn't bet)
Seat 2: Gintaras20 (button) folded on the Turn
Seat 3: sheff7880 (small blind) folded before Flop
Seat 4: kätzi<3 (big blind) collected ($1.29)
Seat 5: KingBiscuitT folded before Flop (didn't bet)
Seat 6: FrameRate123 folded before Flop (didn't bet)



PokerStars Hand #222956874266:  Hold'em No Limit ($0.05/$0.10 USD) - 2021/01/23 10:24:52 ET
Table 'Lutetia III' 6-max Seat #3 is the button
Seat 1: beta33 ($11.42 in chips) 
Seat 2: Gintaras20 ($10.67 in chips) 
Seat 3: sheff7880 ($10 in chips) 
Seat 4: kätzi<3 ($7.87 in chips) 
Seat 5: KingBiscuitT ($18.28 in chips) 
Seat 6: FrameRate123 ($6.48 in chips) 
kätzi<3: posts small blind $0.05
KingBiscuitT: posts big blind $0.10
*** HOLE CARDS ***
FrameRate123: folds 
beta33: folds 
Gintaras20: folds 
sheff7880: folds 
kätzi<3: raises $0.10 to $0.20
KingBiscuitT: calls $0.10
*** FLOP *** [9d Ah 7c]
kätzi<3: bets $0.20
KingBiscuitT: calls $0.20
*** TURN *** [9d Ah 7c] [Qs]
kätzi<3: bets $0.76
KingBiscuitT: folds 
Uncalled bet ($0.76) returned to kätzi<3
kätzi<3 collected $0.76 from pot
kätzi<3: doesn't show hand 
*** SUMMARY ***
Total pot $0.80 | Rake $0.04 
Board [9d Ah 7c Qs]
Seat 1: beta33 folded before Flop (didn't bet)
Seat 2: Gintaras20 folded before Flop (didn't bet)
Seat 3: sheff7880 (button) folded before Flop (didn't bet)
Seat 4: kätzi<3 (small blind) collected ($0.76)
Seat 5: KingBiscuitT (big blind) folded on the Turn
Seat 6: FrameRate123 folded before Flop (didn't bet)



PokerStars Hand #222956890421:  Hold'em No Limit ($0.05/$0.10 USD) - 2021/01/23 10:25:22 ET
Table 'Lutetia III' 6-max Seat #4 is the button
Seat 1: beta33 ($11.42 in chips) 
Seat 2: Gintaras20 ($10.67 in chips) 
Seat 3: sheff7880 ($10 in chips) 
Seat 4: kätzi<3 ($8.23 in chips) 
Seat 5: KingBiscuitT ($17.88 in chips) 
Seat 6: FrameRate123 ($6.48 in chips) 
KingBiscuitT: posts small blind $0.05
FrameRate123: posts big blind $0.10
*** HOLE CARDS ***
beta33: raises $0.20 to $0.30
Gintaras20: folds 
sheff7880: folds 
kätzi<3: folds 
KingBiscuitT: folds 
FrameRate123: calls $0.20
*** FLOP *** [Jd 7s 4s]
FrameRate123: checks 
beta33: bets $0.40
FrameRate123: folds 
Uncalled bet ($0.40) returned to beta33
beta33 collected $0.62 from pot
*** SUMMARY ***
Total pot $0.65 | Rake $0.03 
Board [Jd 7s 4s]
Seat 1: beta33 collected ($0.62)
Seat 2: Gintaras20 folded before Flop (didn't bet)
Seat 3: sheff7880 folded before Flop (didn't bet)
Seat 4: kätzi<3 (button) folded before Flop (didn't bet)
Seat 5: KingBiscuitT (small blind) folded before Flop
Seat 6: FrameRate123 (big blind) folded on the Flop



PokerStars Hand #222956910602:  Hold'em No Limit ($0.05/$0.10 USD) - 2021/01/23 10:25:59 ET
Table 'Lutetia III' 6-max Seat #5 is the button
Seat 1: beta33 ($11.74 in chips) 
Seat 2: Gintaras20 ($10.67 in chips) 
Seat 3: sheff7880 ($10 in chips) 
Seat 4: kätzi<3 ($8.23 in chips) 
Seat 5: KingBiscuitT ($17.83 in chips) 
Seat 6: FrameRate123 ($6.18 in chips) 
FrameRate123: posts small blind $0.05
beta33: posts big blind $0.10
*** HOLE CARDS ***
Gintaras20: folds 
sheff7880: folds 
kätzi<3: raises $0.20 to $0.30
KingBiscuitT: folds 
FrameRate123: folds 
beta33: folds 
Uncalled bet ($0.20) returned to kätzi<3
kätzi<3 collected $0.25 from pot
kätzi<3: doesn't show hand 
*** SUMMARY ***
Total pot $0.25 | Rake $0 
Seat 1: beta33 (big blind) folded before Flop
Seat 2: Gintaras20 folded before Flop (didn't bet)
Seat 3: sheff7880 folded before Flop (didn't bet)
Seat 4: kätzi<3 collected ($0.25)
Seat 5: KingBiscuitT (button) folded before Flop (didn't bet)
Seat 6: FrameRate123 (small blind) folded before Flop



PokerStars Hand #222956917572:  Hold'em No Limit ($0.05/$0.10 USD) - 2021/01/23 10:26:12 ET
Table 'Lutetia III' 6-max Seat #6 is the button
Seat 1: beta33 ($11.64 in chips) 
Seat 2: Gintaras20 ($10.67 in chips) 
Seat 3: sheff7880 ($10 in chips) 
Seat 4: kätzi<3 ($8.38 in chips) 
Seat 5: KingBiscuitT ($17.83 in chips) 
Seat 6: FrameRate123 ($6.13 in chips) 
beta33: posts small blind $0.05
Gintaras20: posts big blind $0.10
*** HOLE CARDS ***
sheff7880: folds 
kätzi<3: calls $0.10
KingBiscuitT: folds 
FrameRate123: raises $0.20 to $0.30
beta33: folds 
Gintaras20: folds 
kätzi<3: calls $0.20
*** FLOP *** [5c 9h 8d]
kätzi<3: bets $0.50
FrameRate123: calls $0.50
*** TURN *** [5c 9h 8d] [9s]
kätzi<3: checks 
FrameRate123: bets $1
kätzi<3: calls $1
*** RIVER *** [5c 9h 8d 9s] [Jh]
kätzi<3: bets $1.40
FrameRate123: raises $1.60 to $3
kätzi<3: folds 
Uncalled bet ($1.60) returned to FrameRate123
FrameRate123 collected $6.26 from pot
FrameRate123: doesn't show hand 
*** SUMMARY ***
Total pot $6.55 | Rake $0.29 
Board [5c 9h 8d 9s Jh]
Seat 1: beta33 (small blind) folded before Flop
Seat 2: Gintaras20 (big blind) folded before Flop
Seat 3: sheff7880 folded before Flop (didn't bet)
Seat 4: kätzi<3 folded on the River
Seat 5: KingBiscuitT folded before Flop (didn't bet)
Seat 6: FrameRate123 (button) collected ($6.26)



PokerStars Hand #222956969654:  Hold'em No Limit ($0.05/$0.10 USD) - 2021/01/23 10:27:48 ET
Table 'Lutetia III' 6-max Seat #1 is the button
Seat 1: beta33 ($11.59 in chips) 
Seat 2: Gintaras20 ($10.57 in chips) 
Seat 3: sheff7880 ($10 in chips) 
Seat 4: kätzi<3 ($5.18 in chips) 
Seat 5: KingBiscuitT ($17.83 in chips) 
Seat 6: FrameRate123 ($9.19 in chips) 
Gintaras20: posts small blind $0.05
sheff7880: posts big blind $0.10
*** HOLE CARDS ***
kätzi<3: raises $0.20 to $0.30
KingBiscuitT: folds 
FrameRate123: raises $0.70 to $1
beta33: folds 
Gintaras20: folds 
sheff7880: folds 
kätzi<3: raises $1 to $2
FrameRate123: raises $7.19 to $9.19 and is all-in
kätzi<3: calls $3.18 and is all-in
Uncalled bet ($4.01) returned to FrameRate123
*** FLOP *** [Jd Jc Td]
*** TURN *** [Jd Jc Td] [3d]
*** RIVER *** [Jd Jc Td 3d] [Kd]
*** SHOW DOWN ***
kätzi<3: shows [As Ah] (two pair, Aces and Jacks)
FrameRate123: shows [Qc Ac] (a straight, Ten to Ace)
FrameRate123 collected $10.04 from pot
*** SUMMARY ***
Total pot $10.51 | Rake $0.47 
Board [Jd Jc Td 3d Kd]
Seat 1: beta33 (button) folded before Flop (didn't bet)
Seat 2: Gintaras20 (small blind) folded before Flop
Seat 3: sheff7880 (big blind) folded before Flop
Seat 4: kätzi<3 showed [As Ah] and lost with two pair, Aces and Jacks
Seat 5: KingBiscuitT folded before Flop (didn't bet)
Seat 6: FrameRate123 showed [Qc Ac] and won ($10.04) with a straight, Ten to Ace



PokerStars Hand #222956992939:  Hold'em No Limit ($0.05/$0.10 USD) - 2021/01/23 10:28:30 ET
Table 'Lutetia III' 6-max Seat #2 is the button
Seat 1: beta33 ($11.59 in chips) 
Seat 2: Gintaras20 ($10.52 in chips) 
Seat 3: sheff7880 ($10 in chips) 
Seat 5: KingBiscuitT ($17.83 in chips) 
Seat 6: FrameRate123 ($14.05 in chips) 
sheff7880: posts small blind $0.05
KingBiscuitT: posts big blind $0.10
*** HOLE CARDS ***
FrameRate123: raises $0.40 to $0.50
beta33: folds 
Gintaras20: folds 
sheff7880: folds 
KingBiscuitT: folds 
Uncalled bet ($0.40) returned to FrameRate123
FrameRate123 collected $0.25 from pot
FrameRate123: doesn't show hand 
*** SUMMARY ***
Total pot $0.25 | Rake $0 
Seat 1: beta33 folded before Flop (didn't bet)
Seat 2: Gintaras20 (button) folded before Flop (didn't bet)
Seat 3: sheff7880 (small blind) folded before Flop
Seat 5: KingBiscuitT (big blind) folded before Flop
Seat 6: FrameRate123 collected ($0.25)



PokerStars Hand #222956999947:  Hold'em No Limit ($0.05/$0.10 USD) - 2021/01/23 10:28:43 ET
Table 'Lutetia III' 6-max Seat #3 is the button
Seat 1: beta33 ($11.59 in chips) 
Seat 2: Gintaras20 ($10.52 in chips) 
Seat 3: sheff7880 ($10 in chips) 
Seat 5: KingBiscuitT ($17.73 in chips) 
Seat 6: FrameRate123 ($14.20 in chips) 
KingBiscuitT: posts small blind $0.05
FrameRate123: posts big blind $0.10
*** HOLE CARDS ***
beta33: raises $0.20 to $0.30
Gintaras20: folds 
sheff7880: folds 
KingBiscuitT: folds 
kätzi<3 leaves the table
FrameRate123: folds 
Uncalled bet ($0.20) returned to beta33
beta33 collected $0.25 from pot
*** SUMMARY ***
Total pot $0.25 | Rake $0 
Seat 1: beta33 collected ($0.25)
Seat 2: Gintaras20 folded before Flop (didn't bet)
Seat 3: sheff7880 (button) folded before Flop (didn't bet)
Seat 5: KingBiscuitT (small blind) folded before Flop
Seat 6: FrameRate123 (big blind) folded before Flop



PokerStars Hand #222957008076:  Hold'em No Limit ($0.05/$0.10 USD) - 2021/01/23 10:28:58 ET
Table 'Lutetia III' 6-max Seat #5 is the button
Seat 1: beta33 ($11.74 in chips) 
Seat 2: Gintaras20 ($10.52 in chips) 
Seat 3: sheff7880 ($10 in chips) 
Seat 5: KingBiscuitT ($17.68 in chips) 
Seat 6: FrameRate123 ($14.10 in chips) 
FrameRate123: posts small blind $0.05
beta33: posts big blind $0.10
*** HOLE CARDS ***
Gintaras20: folds 
sheff7880: folds 
KingBiscuitT: raises $0.15 to $0.25
FrameRate123: calls $0.20
beta33: folds 
*** FLOP *** [Jh 4h 9d]
FrameRate123: checks 
KingBiscuitT: bets $0.86
FrameRate123: folds 
Uncalled bet ($0.86) returned to KingBiscuitT
KingBiscuitT collected $0.57 from pot
KingBiscuitT: doesn't show hand 
*** SUMMARY ***
Total pot $0.60 | Rake $0.03 
Board [Jh 4h 9d]
Seat 1: beta33 (big blind) folded before Flop
Seat 2: Gintaras20 folded before Flop (didn't bet)
Seat 3: sheff7880 folded before Flop (didn't bet)
Seat 5: KingBiscuitT (button) collected ($0.57)
Seat 6: FrameRate123 (small blind) folded on the Flop



PokerStars Hand #222957022163:  Hold'em No Limit ($0.05/$0.10 USD) - 2021/01/23 10:29:24 ET
Table 'Lutetia III' 6-max Seat #6 is the button
Seat 1: beta33 ($11.64 in chips) 
Seat 2: Gintaras20 ($10.52 in chips) 
Seat 3: sheff7880 ($10 in chips) 
Seat 5: KingBiscuitT ($18 in chips) 
Seat 6: FrameRate123 ($13.85 in chips) 
beta33: posts small blind $0.05
Gintaras20: posts big blind $0.10
*** HOLE CARDS ***
sheff7880: folds 
KingBiscuitT: folds 
FrameRate123: calls $0.10
beta33: folds 
Gintaras20: checks 
*** FLOP *** [Ks Qd Js]
Gintaras20: bets $0.50
tohagan joins the table at seat #4 
FrameRate123: folds 
Uncalled bet ($0.50) returned to Gintaras20
Gintaras20 collected $0.24 from pot
Gintaras20: doesn't show hand 
*** SUMMARY ***
Total pot $0.25 | Rake $0.01 
Board [Ks Qd Js]
Seat 1: beta33 (small blind) folded before Flop
Seat 2: Gintaras20 (big blind) collected ($0.24)
Seat 3: sheff7880 folded before Flop (didn't bet)
Seat 5: KingBiscuitT folded before Flop (didn't bet)
Seat 6: FrameRate123 (button) folded on the Flop



PokerStars Hand #222957031777:  Hold'em No Limit ($0.05/$0.10 USD) - 2021/01/23 10:29:42 ET
Table 'Lutetia III' 6-max Seat #1 is the button
Seat 1: beta33 ($11.59 in chips) 
Seat 2: Gintaras20 ($10.66 in chips) 
Seat 3: sheff7880 ($10 in chips) 
Seat 5: KingBiscuitT ($18 in chips) 
Seat 6: FrameRate123 ($13.75 in chips) 
Gintaras20: posts small blind $0.05
sheff7880: posts big blind $0.10
tohagan: sits out 
*** HOLE CARDS ***
KingBiscuitT: folds 
FrameRate123: folds 
beta33: raises $0.20 to $0.30
Gintaras20: calls $0.25
FrameRate123 leaves the table
sheff7880: folds 
*** FLOP *** [9s 4d 2d]
Gintaras20: checks 
beta33: bets $0.50
Gintaras20: calls $0.50
*** TURN *** [9s 4d 2d] [6h]
Gintaras20: checks 
beta33: bets $1.20
Gintaras20: calls $1.20
*** RIVER *** [9s 4d 2d 6h] [5d]
Gintaras20: bets $2.94
beta33: folds 
Uncalled bet ($2.94) returned to Gintaras20
Gintaras20 collected $3.92 from pot
Gintaras20: doesn't show hand 
*** SUMMARY ***
Total pot $4.10 | Rake $0.18 
Board [9s 4d 2d 6h 5d]
Seat 1: beta33 (button) folded on the River
Seat 2: Gintaras20 (small blind) collected ($3.92)
Seat 3: sheff7880 (big blind) folded before Flop
Seat 5: KingBiscuitT folded before Flop (didn't bet)
Seat 6: FrameRate123 folded before Flop (didn't bet)



PokerStars Hand #222957056911:  Hold'em No Limit ($0.05/$0.10 USD) - 2021/01/23 10:30:28 ET
Table 'Lutetia III' 6-max Seat #2 is the button
Seat 1: beta33 ($10 in chips) 
Seat 2: Gintaras20 ($12.58 in chips) 
Seat 3: sheff7880 ($10 in chips) 
Seat 4: tohagan ($6.15 in chips) 
Seat 5: KingBiscuitT ($18 in chips) 
sheff7880: posts small blind $0.05
tohagan: posts big blind $0.10
*** HOLE CARDS ***
KingBiscuitT: folds 
beta33: raises $0.20 to $0.30
Gintaras20: folds 
sheff7880: raises $0.75 to $1.05
tohagan: calls $0.95
beta33: calls $0.75
*** FLOP *** [6d 7s 9s]
sheff7880: checks 
tohagan: checks 
DJAtgani joins the table at seat #6 
beta33: bets $2
sheff7880: folds 
tohagan: folds 
Uncalled bet ($2) returned to beta33
beta33 collected $3.01 from pot
*** SUMMARY ***
Total pot $3.15 | Rake $0.14 
Board [6d 7s 9s]
Seat 1: beta33 collected ($3.01)
Seat 2: Gintaras20 (button) folded before Flop (didn't bet)
Seat 3: sheff7880 (small blind) folded on the Flop
Seat 4: tohagan (big blind) folded on the Flop
Seat 5: KingBiscuitT folded before Flop (didn't bet)



PokerStars Hand #222957084075:  Hold'em No Limit ($0.05/$0.10 USD) - 2021/01/23 10:31:05 ET
Table 'Lutetia III' 6-max Seat #3 is the button
Seat 1: beta33 ($11.96 in chips) 
Seat 2: Gintaras20 ($12.58 in chips) 
Seat 3: sheff7880 ($10 in chips) 
Seat 4: tohagan ($5.10 in chips) 
Seat 5: KingBiscuitT ($18 in chips) 
tohagan: posts small blind $0.05
KingBiscuitT: posts big blind $0.10
DJAtgani: sits out 
*** HOLE CARDS ***
beta33: folds 
Gintaras20: folds 
sheff7880: raises $0.20 to $0.30
tohagan: calls $0.25
KingBiscuitT: folds 
*** FLOP *** [Td 7c 8d]
tohagan: checks 
sheff7880: bets $0.35
tohagan: calls $0.35
*** TURN *** [Td 7c 8d] [6h]
tohagan: checks 
sheff7880: checks 
*** RIVER *** [Td 7c 8d 6h] [Jh]
tohagan: checks 
sheff7880: checks 
*** SHOW DOWN ***
tohagan: shows [Ks Ad] (high card Ace)
sheff7880: mucks hand 
tohagan collected $1.34 from pot
*** SUMMARY ***
Total pot $1.40 | Rake $0.06 
Board [Td 7c 8d 6h Jh]
Seat 1: beta33 folded before Flop (didn't bet)
Seat 2: Gintaras20 folded before Flop (didn't bet)
Seat 3: sheff7880 (button) mucked
Seat 4: tohagan (small blind) showed [Ks Ad] and won ($1.34) with high card Ace
Seat 5: KingBiscuitT (big blind) folded before Flop



PokerStars Hand #222957103650:  Hold'em No Limit ($0.05/$0.10 USD) - 2021/01/23 10:31:41 ET
Table 'Lutetia III' 6-max Seat #4 is the button
Seat 1: beta33 ($11.96 in chips) 
Seat 2: Gintaras20 ($12.58 in chips) 
Seat 3: sheff7880 ($10 in chips) 
Seat 4: tohagan ($5.79 in chips) 
Seat 5: KingBiscuitT ($17.90 in chips) 
Seat 6: DJAtgani ($8 in chips) 
KingBiscuitT: posts small blind $0.05
DJAtgani: posts big blind $0.10
*** HOLE CARDS ***
beta33: folds 
Gintaras20: folds 
sheff7880: folds 
tohagan: calls $0.10
KingBiscuitT: folds 
DJAtgani: checks 
*** FLOP *** [7d 8c 9h]
DJAtgani: checks 
tohagan: checks 
*** TURN *** [7d 8c 9h] [Ks]
DJAtgani: checks 
tohagan: bets $0.10
DJAtgani: raises $0.10 to $0.20
tohagan: raises $0.10 to $0.30
DJAtgani: raises $0.10 to $0.40
tohagan: raises $0.10 to $0.50
DJAtgani: raises $0.10 to $0.60
tohagan: raises $0.10 to $0.70
DJAtgani: raises $0.10 to $0.80
tohagan: raises $0.10 to $0.90
DJAtgani: raises $0.10 to $1
tohagan: raises $0.10 to $1.10
DJAtgani: calls $0.10
*** RIVER *** [7d 8c 9h Ks] [Jd]
DJAtgani: checks 
tohagan: bets $1.50
DJAtgani: calls $1.50
*** SHOW DOWN ***
tohagan: shows [Kc Kd] (three of a kind, Kings)
DJAtgani: mucks hand 
tohagan collected $5.20 from pot
*** SUMMARY ***
Total pot $5.45 | Rake $0.25 
Board [7d 8c 9h Ks Jd]
Seat 1: beta33 folded before Flop (didn't bet)
Seat 2: Gintaras20 folded before Flop (didn't bet)
Seat 3: sheff7880 folded before Flop (didn't bet)
Seat 4: tohagan (button) showed [Kc Kd] and won ($5.20) with three of a kind, Kings
Seat 5: KingBiscuitT (small blind) folded before Flop
Seat 6: DJAtgani (big blind) mucked



PokerStars Hand #222957143117:  Hold'em No Limit ($0.05/$0.10 USD) - 2021/01/23 10:32:53 ET
Table 'Lutetia III' 6-max Seat #5 is the button
Seat 1: beta33 ($11.96 in chips) 
Seat 2: Gintaras20 ($12.58 in chips) 
Seat 3: sheff7880 ($10 in chips) 
Seat 4: tohagan ($8.29 in chips) 
Seat 5: KingBiscuitT ($17.85 in chips) 
Seat 6: DJAtgani ($5.30 in chips) 
DJAtgani: posts small blind $0.05
beta33: posts big blind $0.10
*** HOLE CARDS ***
Gintaras20: folds 
sheff7880: folds 
tohagan: folds 
KingBiscuitT: folds 
DJAtgani: calls $0.05
beta33: raises $0.20 to $0.30
DJAtgani: calls $0.20
*** FLOP *** [6d Ad As]
DJAtgani: checks 
beta33: bets $0.40
DJAtgani: calls $0.40
*** TURN *** [6d Ad As] [9d]
DJAtgani: checks 
beta33: checks 
*** RIVER *** [6d Ad As 9d] [8c]
DJAtgani: checks 
beta33: checks 
*** SHOW DOWN ***
DJAtgani: shows [Qh 5c] (a pair of Aces)
beta33: shows [5s 8s] (two pair, Aces and Eights)
beta33 collected $1.34 from pot
*** SUMMARY ***
Total pot $1.40 | Rake $0.06 
Board [6d Ad As 9d 8c]
Seat 1: beta33 (big blind) showed [5s 8s] and won ($1.34) with two pair, Aces and Eights
Seat 2: Gintaras20 folded before Flop (didn't bet)
Seat 3: sheff7880 folded before Flop (didn't bet)
Seat 4: tohagan folded before Flop (didn't bet)
Seat 5: KingBiscuitT (button) folded before Flop (didn't bet)
Seat 6: DJAtgani (small blind) showed [Qh 5c] and lost with a pair of Aces



PokerStars Hand #222957171922:  Hold'em No Limit ($0.05/$0.10 USD) - 2021/01/23 10:33:45 ET
Table 'Lutetia III' 6-max Seat #6 is the button
Seat 1: beta33 ($12.60 in chips) 
Seat 2: Gintaras20 ($12.58 in chips) 
Seat 3: sheff7880 ($10 in chips) 
Seat 4: tohagan ($8.29 in chips) 
Seat 5: KingBiscuitT ($17.85 in chips) 
Seat 6: DJAtgani ($4.60 in chips) 
beta33: posts small blind $0.05
Gintaras20: posts big blind $0.10
*** HOLE CARDS ***
sheff7880: folds 
tohagan: calls $0.10
KingBiscuitT: folds 
DJAtgani: calls $0.10
beta33: calls $0.05
Gintaras20: checks 
*** FLOP *** [4s 5d 5s]
beta33: bets $0.30
Gintaras20: folds 
tohagan: folds 
DJAtgani: calls $0.30
*** TURN *** [4s 5d 5s] [Th]
beta33: checks 
DJAtgani: checks 
*** RIVER *** [4s 5d 5s Th] [2c]
beta33: checks 
DJAtgani: checks 
*** SHOW DOWN ***
beta33: shows [As 2d] (two pair, Fives and Deuces)
DJAtgani: mucks hand 
beta33 collected $0.96 from pot
*** SUMMARY ***
Total pot $1 | Rake $0.04 
Board [4s 5d 5s Th 2c]
Seat 1: beta33 (small blind) showed [As 2d] and won ($0.96) with two pair, Fives and Deuces
Seat 2: Gintaras20 (big blind) folded on the Flop
Seat 3: sheff7880 folded before Flop (didn't bet)
Seat 4: tohagan folded on the Flop
Seat 5: KingBiscuitT folded before Flop (didn't bet)
Seat 6: DJAtgani (button) mucked



PokerStars Hand #222957193346:  Hold'em No Limit ($0.05/$0.10 USD) - 2021/01/23 10:34:24 ET
Table 'Lutetia III' 6-max Seat #1 is the button
Seat 1: beta33 ($13.16 in chips) 
Seat 2: Gintaras20 ($12.48 in chips) 
Seat 3: sheff7880 ($10 in chips) 
Seat 4: tohagan ($8.19 in chips) 
Seat 5: KingBiscuitT ($17.85 in chips) 
Seat 6: DJAtgani ($4.20 in chips) 
Gintaras20: posts small blind $0.05
sheff7880: posts big blind $0.10
*** HOLE CARDS ***
tohagan: calls $0.10
KingBiscuitT: folds 
DJAtgani: folds 
beta33: raises $0.30 to $0.40
Gintaras20: calls $0.35
sheff7880: folds 
tohagan: raises $0.30 to $0.70
beta33: calls $0.30
Gintaras20: calls $0.30
*** FLOP *** [Tc 7d Jd]
Gintaras20: checks 
tohagan: bets $0.10
beta33: calls $0.10
Gintaras20: calls $0.10
*** TURN *** [Tc 7d Jd] [Ah]
Gintaras20: checks 
tohagan: checks 
beta33: checks 
*** RIVER *** [Tc 7d Jd Ah] [6c]
Gintaras20: checks 
tohagan: checks 
beta33: checks 
*** SHOW DOWN ***
Gintaras20: shows [7s 9s] (a pair of Sevens)
tohagan: shows [Qc Jc] (a pair of Jacks)
beta33: mucks hand 
tohagan collected $2.39 from pot
*** SUMMARY ***
Total pot $2.50 | Rake $0.11 
Board [Tc 7d Jd Ah 6c]
Seat 1: beta33 (button) mucked
Seat 2: Gintaras20 (small blind) showed [7s 9s] and lost with a pair of Sevens
Seat 3: sheff7880 (big blind) folded before Flop
Seat 4: tohagan showed [Qc Jc] and won ($2.39) with a pair of Jacks
Seat 5: KingBiscuitT folded before Flop (didn't bet)
Seat 6: DJAtgani folded before Flop (didn't bet)



PokerStars Hand #222957226774:  Hold'em No Limit ($0.05/$0.10 USD) - 2021/01/23 10:35:25 ET
Table 'Lutetia III' 6-max Seat #2 is the button
Seat 1: beta33 ($12.36 in chips) 
Seat 2: Gintaras20 ($11.68 in chips) 
Seat 3: sheff7880 ($10 in chips) 
Seat 4: tohagan ($9.78 in chips) 
Seat 5: KingBiscuitT ($17.85 in chips) 
Seat 6: DJAtgani ($4.20 in chips) 
sheff7880: posts small blind $0.05
tohagan: posts big blind $0.10
*** HOLE CARDS ***
KingBiscuitT: folds 
DJAtgani: calls $0.10
beta33: folds 
Gintaras20: folds 
sheff7880: raises $0.30 to $0.40
tohagan: calls $0.30
DJAtgani: calls $0.30
*** FLOP *** [Kc 6s Js]
sheff7880: bets $0.75
tohagan: calls $0.75
DJAtgani: calls $0.75
*** TURN *** [Kc 6s Js] [Jh]
sheff7880: checks 
tohagan: checks 
DJAtgani: checks 
*** RIVER *** [Kc 6s Js Jh] [9h]
sheff7880: checks 
tohagan: bets $1.50
DJAtgani: folds 
sheff7880: calls $1.50
*** SHOW DOWN ***
tohagan: shows [Ks 8h] (two pair, Kings and Jacks)
sheff7880: shows [Kh Th] (two pair, Kings and Jacks - Ten kicker)
sheff7880 collected $6.16 from pot
*** SUMMARY ***
Total pot $6.45 | Rake $0.29 
Board [Kc 6s Js Jh 9h]
Seat 1: beta33 folded before Flop (didn't bet)
Seat 2: Gintaras20 (button) folded before Flop (didn't bet)
Seat 3: sheff7880 (small blind) showed [Kh Th] and won ($6.16) with two pair, Kings and Jacks
Seat 4: tohagan (big blind) showed [Ks 8h] and lost with two pair, Kings and Jacks
Seat 5: KingBiscuitT folded before Flop (didn't bet)
Seat 6: DJAtgani folded on the River



PokerStars Hand #222957260468:  Hold'em No Limit ($0.05/$0.10 USD) - 2021/01/23 10:36:26 ET
Table 'Lutetia III' 6-max Seat #3 is the button
Seat 1: beta33 ($12.36 in chips) 
Seat 2: Gintaras20 ($11.68 in chips) 
Seat 3: sheff7880 ($13.51 in chips) 
Seat 4: tohagan ($7.13 in chips) 
Seat 5: KingBiscuitT ($17.85 in chips) 
Seat 6: DJAtgani ($3.05 in chips) 
tohagan: posts small blind $0.05
KingBiscuitT: posts big blind $0.10
*** HOLE CARDS ***
DJAtgani: folds 
beta33: folds 
Gintaras20: folds 
sheff7880: folds 
tohagan: folds 
Uncalled bet ($0.05) returned to KingBiscuitT
KingBiscuitT collected $0.10 from pot
KingBiscuitT: doesn't show hand 
*** SUMMARY ***
Total pot $0.10 | Rake $0 
Seat 1: beta33 folded before Flop (didn't bet)
Seat 2: Gintaras20 folded before Flop (didn't bet)
Seat 3: sheff7880 (button) folded before Flop (didn't bet)
Seat 4: tohagan (small blind) folded before Flop
Seat 5: KingBiscuitT (big blind) collected ($0.10)
Seat 6: DJAtgani folded before Flop (didn't bet)



PokerStars Hand #222957267004:  Hold'em No Limit ($0.05/$0.10 USD) - 2021/01/23 10:36:38 ET
Table 'Lutetia III' 6-max Seat #4 is the button
Seat 1: beta33 ($12.36 in chips) 
Seat 2: Gintaras20 ($11.68 in chips) 
Seat 3: sheff7880 ($13.51 in chips) 
Seat 4: tohagan ($7.08 in chips) 
Seat 5: KingBiscuitT ($17.90 in chips) 
Seat 6: DJAtgani ($3.05 in chips) 
KingBiscuitT: posts small blind $0.05
DJAtgani: posts big blind $0.10
*** HOLE CARDS ***
beta33: folds 
Gintaras20: raises $0.15 to $0.25
sheff7880: folds 
tohagan: calls $0.25
KingBiscuitT: folds 
DJAtgani: folds 
*** FLOP *** [6s 7h Qs]
Gintaras20: bets $0.31
tohagan: calls $0.31
*** TURN *** [6s 7h Qs] [3h]
Gintaras20: checks 
tohagan: checks 
*** RIVER *** [6s 7h Qs 3h] [9c]
Gintaras20: checks 
tohagan: checks 
*** SHOW DOWN ***
Gintaras20: shows [Td As] (high card Ace)
tohagan: shows [8d 8c] (a pair of Eights)
tohagan collected $1.21 from pot
*** SUMMARY ***
Total pot $1.27 | Rake $0.06 
Board [6s 7h Qs 3h 9c]
Seat 1: beta33 folded before Flop (didn't bet)
Seat 2: Gintaras20 showed [Td As] and lost with high card Ace
Seat 3: sheff7880 folded before Flop (didn't bet)
Seat 4: tohagan (button) showed [8d 8c] and won ($1.21) with a pair of Eights
Seat 5: KingBiscuitT (small blind) folded before Flop
Seat 6: DJAtgani (big blind) folded before Flop



PokerStars Hand #222957289256:  Hold'em No Limit ($0.05/$0.10 USD) - 2021/01/23 10:37:18 ET
Table 'Lutetia III' 6-max Seat #5 is the button
Seat 1: beta33 ($12.36 in chips) 
Seat 2: Gintaras20 ($11.12 in chips) 
Seat 3: sheff7880 ($13.51 in chips) 
Seat 4: tohagan ($7.73 in chips) 
Seat 5: KingBiscuitT ($17.85 in chips) 
Seat 6: DJAtgani ($2.95 in chips) 
DJAtgani: posts small blind $0.05
beta33: posts big blind $0.10
*** HOLE CARDS ***
Gintaras20: folds 
sheff7880: folds 
tohagan: folds 
KingBiscuitT: folds 
DJAtgani: calls $0.05
tohagan leaves the table
beta33: raises $0.30 to $0.40
DJAtgani: calls $0.30
*** FLOP *** [4s 5s 6c]
DJAtgani: checks 
beta33: bets $0.60
Mr50centt joins the table at seat #4 
DJAtgani: calls $0.60
*** TURN *** [4s 5s 6c] [Td]
DJAtgani: checks 
beta33: bets $11.36 and is all-in
DJAtgani: calls $1.95 and is all-in
Uncalled bet ($9.41) returned to beta33
*** RIVER *** [4s 5s 6c Td] [9d]
*** SHOW DOWN ***
DJAtgani: shows [8h 7d] (a straight, Six to Ten)
beta33: shows [Qd Qc] (a pair of Queens)
DJAtgani collected $5.63 from pot
*** SUMMARY ***
Total pot $5.90 | Rake $0.27 
Board [4s 5s 6c Td 9d]
Seat 1: beta33 (big blind) showed [Qd Qc] and lost with a pair of Queens
Seat 2: Gintaras20 folded before Flop (didn't bet)
Seat 3: sheff7880 folded before Flop (didn't bet)
Seat 4: tohagan folded before Flop (didn't bet)
Seat 5: KingBiscuitT (button) folded before Flop (didn't bet)
Seat 6: DJAtgani (small blind) showed [8h 7d] and won ($5.63) with a straight, Six to Ten



PokerStars Hand #222957316086:  Hold'em No Limit ($0.05/$0.10 USD) - 2021/01/23 10:38:07 ET
Table 'Lutetia III' 6-max Seat #6 is the button
Seat 1: beta33 ($10 in chips) 
Seat 2: Gintaras20 ($11.12 in chips) 
Seat 3: sheff7880 ($13.51 in chips) 
Seat 5: KingBiscuitT ($17.85 in chips) 
Seat 6: DJAtgani ($5.63 in chips) 
beta33: posts small blind $0.05
Gintaras20: posts big blind $0.10
Mr50centt: sits out 
*** HOLE CARDS ***
sheff7880: folds 
KingBiscuitT: folds 
DJAtgani: calls $0.10
beta33: folds 
Gintaras20: raises $11.02 to $11.12 and is all-in
DJAtgani: calls $5.53 and is all-in
Uncalled bet ($5.49) returned to Gintaras20
*** FLOP *** [3s Kh 4d]
*** TURN *** [3s Kh 4d] [7d]
*** RIVER *** [3s Kh 4d 7d] [9d]
*** SHOW DOWN ***
Gintaras20: shows [Ad Qh] (high card Ace)
DJAtgani: shows [Th Ts] (a pair of Tens)
DJAtgani collected $10.80 from pot
*** SUMMARY ***
Total pot $11.31 | Rake $0.51 
Board [3s Kh 4d 7d 9d]
Seat 1: beta33 (small blind) folded before Flop
Seat 2: Gintaras20 (big blind) showed [Ad Qh] and lost with high card Ace
Seat 3: sheff7880 folded before Flop (didn't bet)
Seat 5: KingBiscuitT folded before Flop (didn't bet)
Seat 6: DJAtgani (button) showed [Th Ts] and won ($10.80) with a pair of Tens



PokerStars Hand #222957336076:  Hold'em No Limit ($0.05/$0.10 USD) - 2021/01/23 10:38:43 ET
Table 'Lutetia III' 6-max Seat #1 is the button
Seat 1: beta33 ($10 in chips) 
Seat 2: Gintaras20 ($5.49 in chips) 
Seat 3: sheff7880 ($13.51 in chips) 
Seat 5: KingBiscuitT ($17.85 in chips) 
Seat 6: DJAtgani ($10.80 in chips) 
Gintaras20: posts small blind $0.05
sheff7880: posts big blind $0.10
Mr50centt: sits out 
*** HOLE CARDS ***
KingBiscuitT: folds 
DJAtgani: calls $0.10
beta33: raises $0.30 to $0.40
Gintaras20: folds 
sheff7880: folds 
DJAtgani: calls $0.30
*** FLOP *** [8c 6s Ks]
DJAtgani: checks 
beta33: checks 
*** TURN *** [8c 6s Ks] [2c]
DJAtgani: checks 
beta33: checks 
*** RIVER *** [8c 6s Ks 2c] [5c]
DJAtgani: checks 
beta33: checks 
*** SHOW DOWN ***
DJAtgani: shows [6c Kc] (a flush, King high)
beta33: mucks hand 
DJAtgani collected $0.91 from pot
*** SUMMARY ***
Total pot $0.95 | Rake $0.04 
Board [8c 6s Ks 2c 5c]
Seat 1: beta33 (button) mucked
Seat 2: Gintaras20 (small blind) folded before Flop
Seat 3: sheff7880 (big blind) folded before Flop
Seat 5: KingBiscuitT folded before Flop (didn't bet)
Seat 6: DJAtgani showed [6c Kc] and won ($0.91) with a flush, King high



PokerStars Hand #222957356159:  Hold'em No Limit ($0.05/$0.10 USD) - 2021/01/23 10:39:20 ET
Table 'Lutetia III' 6-max Seat #2 is the button
Seat 1: beta33 ($10 in chips) 
Seat 2: Gintaras20 ($10 in chips) 
Seat 3: sheff7880 ($13.41 in chips) 
Seat 4: Mr50centt ($10 in chips) 
Seat 5: KingBiscuitT ($17.85 in chips) 
Seat 6: DJAtgani ($11.31 in chips) 
sheff7880: posts small blind $0.05
Mr50centt: posts big blind $0.10
*** HOLE CARDS ***
KingBiscuitT: raises $0.15 to $0.25
DJAtgani: calls $0.25
beta33: calls $0.25
Gintaras20: folds 
sheff7880: folds 
Mr50centt: folds 
*** FLOP *** [Js 6s 5c]
KingBiscuitT: checks 
DJAtgani: checks 
beta33: checks 
*** TURN *** [Js 6s 5c] [Qs]
KingBiscuitT: checks 
DJAtgani: checks 
beta33: checks 
*** RIVER *** [Js 6s 5c Qs] [4h]
KingBiscuitT: checks 
DJAtgani: checks 
beta33: checks 
*** SHOW DOWN ***
KingBiscuitT: shows [Qc Tc] (a pair of Queens)
DJAtgani: mucks hand 
beta33: mucks hand 
KingBiscuitT collected $0.86 from pot
*** SUMMARY ***
Total pot $0.90 | Rake $0.04 
Board [Js 6s 5c Qs 4h]
Seat 1: beta33 mucked
Seat 2: Gintaras20 (button) folded before Flop (didn't bet)
Seat 3: sheff7880 (small blind) folded before Flop
Seat 4: Mr50centt (big blind) folded before Flop
Seat 5: KingBiscuitT showed [Qc Tc] and won ($0.86) with a pair of Queens
Seat 6: DJAtgani mucked



PokerStars Hand #222957391563:  Hold'em No Limit ($0.05/$0.10 USD) - 2021/01/23 10:40:24 ET
Table 'Lutetia III' 6-max Seat #3 is the button
Seat 1: beta33 ($10 in chips) 
Seat 2: Gintaras20 ($10 in chips) 
Seat 3: sheff7880 ($13.36 in chips) 
Seat 4: Mr50centt ($9.90 in chips) 
Seat 5: KingBiscuitT ($18.46 in chips) 
Seat 6: DJAtgani ($11.06 in chips) 
Mr50centt: posts small blind $0.05
KingBiscuitT: posts big blind $0.10
*** HOLE CARDS ***
DJAtgani: folds 
beta33: raises $0.20 to $0.30
Gintaras20: folds 
sheff7880: folds 
Mr50centt: folds 
KingBiscuitT: folds 
Uncalled bet ($0.20) returned to beta33
beta33 collected $0.25 from pot
*** SUMMARY ***
Total pot $0.25 | Rake $0 
Seat 1: beta33 collected ($0.25)
Seat 2: Gintaras20 folded before Flop (didn't bet)
Seat 3: sheff7880 (button) folded before Flop (didn't bet)
Seat 4: Mr50centt (small blind) folded before Flop
Seat 5: KingBiscuitT (big blind) folded before Flop
Seat 6: DJAtgani folded before Flop (didn't bet)



PokerStars Hand #222957403900:  Hold'em No Limit ($0.05/$0.10 USD) - 2021/01/23 10:40:47 ET
Table 'Lutetia III' 6-max Seat #4 is the button
Seat 1: beta33 ($10.15 in chips) 
Seat 2: Gintaras20 ($10 in chips) 
Seat 3: sheff7880 ($13.36 in chips) 
Seat 4: Mr50centt ($9.85 in chips) 
Seat 5: KingBiscuitT ($18.36 in chips) 
Seat 6: DJAtgani ($11.06 in chips) 
KingBiscuitT: posts small blind $0.05
DJAtgani: posts big blind $0.10
*** HOLE CARDS ***
beta33: folds 
Gintaras20: folds 
sheff7880: folds 
Mr50centt: folds 
KingBiscuitT: raises $0.20 to $0.30
DJAtgani: calls $0.20
*** FLOP *** [Tc Qc 8c]
KingBiscuitT: checks 
DJAtgani: bets $1
KingBiscuitT: calls $1
*** TURN *** [Tc Qc 8c] [Ks]
KingBiscuitT: bets $1.65
DJAtgani: calls $1.65
*** RIVER *** [Tc Qc 8c Ks] [4c]
KingBiscuitT: bets $8.45
DJAtgani: folds 
Uncalled bet ($8.45) returned to KingBiscuitT
KingBiscuitT collected $5.63 from pot
KingBiscuitT: doesn't show hand 
*** SUMMARY ***
Total pot $5.90 | Rake $0.27 
Board [Tc Qc 8c Ks 4c]
Seat 1: beta33 folded before Flop (didn't bet)
Seat 2: Gintaras20 folded before Flop (didn't bet)
Seat 3: sheff7880 folded before Flop (didn't bet)
Seat 4: Mr50centt (button) folded before Flop (didn't bet)
Seat 5: KingBiscuitT (small blind) collected ($5.63)
Seat 6: DJAtgani (big blind) folded on the River



PokerStars Hand #222957752332:  Hold'em No Limit ($0.05/$0.10 USD) - 2021/01/23 10:51:14 ET
Table 'Lutetia III' 6-max Seat #6 is the button
Seat 1: beta33 ($10.53 in chips) 
Seat 2: Gintaras20 ($10 in chips) 
Seat 3: romanromanro ($10.19 in chips) 
Seat 4: Mr50centt ($12.26 in chips) 
Seat 5: KingBiscuitT ($23.60 in chips) 
Seat 6: urmeli10 ($8.23 in chips) 
beta33: posts small blind $0.05
Gintaras20: posts big blind $0.10
*** HOLE CARDS ***
romanromanro: folds 
Mr50centt: raises $0.15 to $0.25
KingBiscuitT: calls $0.25
urmeli10: calls $0.25
beta33: calls $0.20
Gintaras20: calls $0.15
*** FLOP *** [Ac 3s Ts]
beta33: checks 
Gintaras20: checks 
Mr50centt: checks 
KingBiscuitT: checks 
urmeli10: checks 
*** TURN *** [Ac 3s Ts] [5s]
beta33: checks 
Gintaras20: bets $1.50
Mr50centt: folds 
KingBiscuitT: folds 
urmeli10: calls $1.50
beta33: folds 
*** RIVER *** [Ac 3s Ts 5s] [7c]
Gintaras20: bets $8.25 and is all-in
urmeli10: calls $6.48 and is all-in
Uncalled bet ($1.77) returned to Gintaras20
*** SHOW DOWN ***
Gintaras20: shows [5c 3d] (two pair, Fives and Threes)
urmeli10: shows [4h As] (a pair of Aces)
Gintaras20 collected $16.44 from pot
*** SUMMARY ***
Total pot $17.21 | Rake $0.77 
Board [Ac 3s Ts 5s 7c]
Seat 1: beta33 (small blind) folded on the Turn
Seat 2: Gintaras20 (big blind) showed [5c 3d] and won ($16.44) with two pair, Fives and Threes
Seat 3: romanromanro folded before Flop (didn't bet)
Seat 4: Mr50centt folded on the Turn
Seat 5: KingBiscuitT folded on the Turn
Seat 6: urmeli10 (button) showed [4h As] and lost with a pair of Aces



PokerStars Hand #222957784766:  Hold'em No Limit ($0.05/$0.10 USD) - 2021/01/23 10:52:13 ET
Table 'Lutetia III' 6-max Seat #1 is the button
Seat 1: beta33 ($10.28 in chips) 
Seat 2: Gintaras20 ($18.21 in chips) 
Seat 3: romanromanro ($10.19 in chips) 
Seat 4: Mr50centt ($12.01 in chips) 
Seat 5: KingBiscuitT ($23.35 in chips) 
Gintaras20: posts small blind $0.05
romanromanro: posts big blind $0.10
*** HOLE CARDS ***
Mr50centt: folds 
KingBiscuitT: folds 
beta33: folds 
Gintaras20: folds 
Uncalled bet ($0.05) returned to romanromanro
romanromanro collected $0.10 from pot
romanromanro: doesn't show hand 
*** SUMMARY ***
Total pot $0.10 | Rake $0 
Seat 1: beta33 (button) folded before Flop (didn't bet)
Seat 2: Gintaras20 (small blind) folded before Flop
Seat 3: romanromanro (big blind) collected ($0.10)
Seat 4: Mr50centt folded before Flop (didn't bet)
Seat 5: KingBiscuitT folded before Flop (didn't bet)



PokerStars Hand #222957788390:  Hold'em No Limit ($0.05/$0.10 USD) - 2021/01/23 10:52:20 ET
Table 'Lutetia III' 6-max Seat #2 is the button
Seat 1: beta33 ($10.28 in chips) 
Seat 2: Gintaras20 ($18.16 in chips) 
Seat 3: romanromanro ($10.24 in chips) 
Seat 4: Mr50centt ($12.01 in chips) 
Seat 5: KingBiscuitT ($23.35 in chips) 
Seat 6: urmeli10 ($5.40 in chips) 
romanromanro: posts small blind $0.05
Mr50centt: posts big blind $0.10
*** HOLE CARDS ***
KingBiscuitT: folds 
urmeli10: calls $0.10
beta33: folds 
Gintaras20: folds 
romanromanro: folds 
Mr50centt: checks 
*** FLOP *** [6d 7c 2h]
Mr50centt: checks 
urmeli10: checks 
*** TURN *** [6d 7c 2h] [Ac]
Mr50centt: checks 
urmeli10: checks 
*** RIVER *** [6d 7c 2h Ac] [Tc]
Mr50centt: checks 
urmeli10: checks 
*** SHOW DOWN ***
Mr50centt: shows [2c Qh] (a pair of Deuces)
urmeli10: shows [3d 3c] (a pair of Threes)
urmeli10 collected $0.24 from pot
*** SUMMARY ***
Total pot $0.25 | Rake $0.01 
Board [6d 7c 2h Ac Tc]
Seat 1: beta33 folded before Flop (didn't bet)
Seat 2: Gintaras20 (button) folded before Flop (didn't bet)
Seat 3: romanromanro (small blind) folded before Flop
Seat 4: Mr50centt (big blind) showed [2c Qh] and lost with a pair of Deuces
Seat 5: KingBiscuitT folded before Flop (didn't bet)
Seat 6: urmeli10 showed [3d 3c] and won ($0.24) with a pair of Threes



PokerStars Hand #222957801265:  Hold'em No Limit ($0.05/$0.10 USD) - 2021/01/23 10:52:43 ET
Table 'Lutetia III' 6-max Seat #3 is the button
Seat 1: beta33 ($10.28 in chips) 
Seat 2: Gintaras20 ($18.16 in chips) 
Seat 3: romanromanro ($10.19 in chips) 
Seat 4: Mr50centt ($11.91 in chips) 
Seat 5: KingBiscuitT ($23.35 in chips) 
Seat 6: urmeli10 ($5.54 in chips) 
Mr50centt: posts small blind $0.05
KingBiscuitT: posts big blind $0.10
*** HOLE CARDS ***
urmeli10: folds 
beta33: folds 
Gintaras20: folds 
romanromanro: raises $0.15 to $0.25
Mr50centt: folds 
KingBiscuitT: calls $0.15
*** FLOP *** [6h Jc 6c]
KingBiscuitT: checks 
romanromanro: bets $0.17
KingBiscuitT: calls $0.17
*** TURN *** [6h Jc 6c] [4s]
KingBiscuitT: checks 
romanromanro: checks 
*** RIVER *** [6h Jc 6c 4s] [5s]
KingBiscuitT: checks 
romanromanro: checks 
*** SHOW DOWN ***
KingBiscuitT: shows [Qc 8c] (a pair of Sixes)
romanromanro: shows [Ac Ks] (a pair of Sixes - Ace kicker)
romanromanro collected $0.85 from pot
*** SUMMARY ***
Total pot $0.89 | Rake $0.04 
Board [6h Jc 6c 4s 5s]
Seat 1: beta33 folded before Flop (didn't bet)
Seat 2: Gintaras20 folded before Flop (didn't bet)
Seat 3: romanromanro (button) showed [Ac Ks] and won ($0.85) with a pair of Sixes
Seat 4: Mr50centt (small blind) folded before Flop
Seat 5: KingBiscuitT (big blind) showed [Qc 8c] and lost with a pair of Sixes
Seat 6: urmeli10 folded before Flop (didn't bet)



PokerStars Hand #222957817807:  Hold'em No Limit ($0.05/$0.10 USD) - 2021/01/23 10:53:13 ET
Table 'Lutetia III' 6-max Seat #4 is the button
Seat 1: beta33 ($10.28 in chips) 
Seat 2: Gintaras20 ($18.16 in chips) 
Seat 3: romanromanro ($10.62 in chips) 
Seat 4: Mr50centt ($11.86 in chips) 
Seat 5: KingBiscuitT ($22.93 in chips) 
Seat 6: urmeli10 ($5.54 in chips) 
KingBiscuitT: posts small blind $0.05
urmeli10: posts big blind $0.10
*** HOLE CARDS ***
beta33: folds 
Gintaras20: folds 
romanromanro: folds 
Mr50centt: raises $0.10 to $0.20
KingBiscuitT: folds 
urmeli10: folds 
Uncalled bet ($0.10) returned to Mr50centt
Mr50centt collected $0.25 from pot
Mr50centt: doesn't show hand 
*** SUMMARY ***
Total pot $0.25 | Rake $0 
Seat 1: beta33 folded before Flop (didn't bet)
Seat 2: Gintaras20 folded before Flop (didn't bet)
Seat 3: romanromanro folded before Flop (didn't bet)
Seat 4: Mr50centt (button) collected ($0.25)
Seat 5: KingBiscuitT (small blind) folded before Flop
Seat 6: urmeli10 (big blind) folded before Flop



PokerStars Hand #222957822788:  Hold'em No Limit ($0.05/$0.10 USD) - 2021/01/23 10:53:22 ET
Table 'Lutetia III' 6-max Seat #5 is the button
Seat 1: beta33 ($10.28 in chips) 
Seat 2: Gintaras20 ($18.16 in chips) 
Seat 3: romanromanro ($10.62 in chips) 
Seat 4: Mr50centt ($12.01 in chips) 
Seat 5: KingBiscuitT ($22.88 in chips) 
Seat 6: urmeli10 ($5.44 in chips) 
urmeli10: posts small blind $0.05
beta33: posts big blind $0.10
*** HOLE CARDS ***
Gintaras20: folds 
romanromanro: folds 
Mr50centt: folds 
KingBiscuitT: folds 
urmeli10: calls $0.05
beta33: checks 
*** FLOP *** [Kd Kc 4d]
urmeli10: checks 
beta33: bets $0.20
urmeli10: folds 
Uncalled bet ($0.20) returned to beta33
beta33 collected $0.19 from pot
*** SUMMARY ***
Total pot $0.20 | Rake $0.01 
Board [Kd Kc 4d]
Seat 1: beta33 (big blind) collected ($0.19)
Seat 2: Gintaras20 folded before Flop (didn't bet)
Seat 3: romanromanro folded before Flop (didn't bet)
Seat 4: Mr50centt folded before Flop (didn't bet)
Seat 5: KingBiscuitT (button) folded before Flop (didn't bet)
Seat 6: urmeli10 (small blind) folded on the Flop



PokerStars Hand #222957833788:  Hold'em No Limit ($0.05/$0.10 USD) - 2021/01/23 10:53:42 ET
Table 'Lutetia III' 6-max Seat #6 is the button
Seat 1: beta33 ($10.37 in chips) 
Seat 2: Gintaras20 ($18.16 in chips) 
Seat 3: romanromanro ($10.62 in chips) 
Seat 4: Mr50centt ($12.01 in chips) 
Seat 5: KingBiscuitT ($22.88 in chips) 
Seat 6: urmeli10 ($5.34 in chips) 
beta33: posts small blind $0.05
Gintaras20: posts big blind $0.10
*** HOLE CARDS ***
romanromanro: raises $0.15 to $0.25
Mr50centt: folds 
KingBiscuitT: folds 
urmeli10: raises $0.65 to $0.90
beta33: folds 
Gintaras20: folds 
romanromanro: calls $0.65
*** FLOP *** [9s Qd 6s]
romanromanro: checks 
urmeli10: checks 
*** TURN *** [9s Qd 6s] [6h]
romanromanro: bets $0.60
urmeli10: calls $0.60
*** RIVER *** [9s Qd 6s 6h] [2c]
romanromanro: bets $2.26
urmeli10: raises $1.58 to $3.84 and is all-in
romanromanro: calls $1.58
*** SHOW DOWN ***
urmeli10: shows [Qc Qh] (a full house, Queens full of Sixes)
romanromanro: shows [6d 7d] (three of a kind, Sixes)
urmeli10 collected $10.34 from pot
*** SUMMARY ***
Total pot $10.83 | Rake $0.49 
Board [9s Qd 6s 6h 2c]
Seat 1: beta33 (small blind) folded before Flop
Seat 2: Gintaras20 (big blind) folded before Flop
Seat 3: romanromanro showed [6d 7d] and lost with three of a kind, Sixes
Seat 4: Mr50centt folded before Flop (didn't bet)
Seat 5: KingBiscuitT folded before Flop (didn't bet)
Seat 6: urmeli10 (button) showed [Qc Qh] and won ($10.34) with a full house, Queens full of Sixes



PokerStars Hand #222957856121:  Hold'em No Limit ($0.05/$0.10 USD) - 2021/01/23 10:54:23 ET
Table 'Lutetia III' 6-max Seat #1 is the button
Seat 1: beta33 ($10.32 in chips) 
Seat 2: Gintaras20 ($18.06 in chips) 
Seat 3: romanromanro ($10 in chips) 
Seat 4: Mr50centt ($12.01 in chips) 
Seat 5: KingBiscuitT ($22.88 in chips) 
Seat 6: urmeli10 ($10.34 in chips) 
Gintaras20: posts small blind $0.05
romanromanro: posts big blind $0.10
*** HOLE CARDS ***
Mr50centt: folds 
KingBiscuitT: folds 
urmeli10: calls $0.10
beta33: folds 
Gintaras20: folds 
romanromanro: checks 
*** FLOP *** [Jc 2c Js]
romanromanro: checks 
urmeli10: checks 
*** TURN *** [Jc 2c Js] [Td]
romanromanro: checks 
urmeli10: checks 
*** RIVER *** [Jc 2c Js Td] [5h]
romanromanro: checks 
urmeli10: checks 
*** SHOW DOWN ***
romanromanro: shows [As 3h] (a pair of Jacks)
urmeli10: mucks hand 
romanromanro collected $0.24 from pot
*** SUMMARY ***
Total pot $0.25 | Rake $0.01 
Board [Jc 2c Js Td 5h]
Seat 1: beta33 (button) folded before Flop (didn't bet)
Seat 2: Gintaras20 (small blind) folded before Flop
Seat 3: romanromanro (big blind) showed [As 3h] and won ($0.24) with a pair of Jacks
Seat 4: Mr50centt folded before Flop (didn't bet)
Seat 5: KingBiscuitT folded before Flop (didn't bet)
Seat 6: urmeli10 mucked



PokerStars Hand #222957873393:  Hold'em No Limit ($0.05/$0.10 USD) - 2021/01/23 10:54:54 ET
Table 'Lutetia III' 6-max Seat #2 is the button
Seat 1: beta33 ($10.32 in chips) 
Seat 2: Gintaras20 ($18.01 in chips) 
Seat 3: romanromanro ($10.14 in chips) 
Seat 4: Mr50centt ($12.01 in chips) 
Seat 5: KingBiscuitT ($22.88 in chips) 
Seat 6: urmeli10 ($10.24 in chips) 
romanromanro: posts small blind $0.05
Mr50centt: posts big blind $0.10
*** HOLE CARDS ***
KingBiscuitT: raises $0.15 to $0.25
urmeli10: folds 
beta33: raises $0.35 to $0.60
Gintaras20: calls $0.60
romanromanro: folds 
Mr50centt: folds 
KingBiscuitT: calls $0.35
*** FLOP *** [5d Jc 7h]
KingBiscuitT: checks 
beta33: bets $1
Gintaras20: folds 
KingBiscuitT: folds 
Uncalled bet ($1) returned to beta33
beta33 collected $1.86 from pot
*** SUMMARY ***
Total pot $1.95 | Rake $0.09 
Board [5d Jc 7h]
Seat 1: beta33 collected ($1.86)
Seat 2: Gintaras20 (button) folded on the Flop
Seat 3: romanromanro (small blind) folded before Flop
Seat 4: Mr50centt (big blind) folded before Flop
Seat 5: KingBiscuitT folded on the Flop
Seat 6: urmeli10 folded before Flop (didn't bet)



PokerStars Hand #222957889530:  Hold'em No Limit ($0.05/$0.10 USD) - 2021/01/23 10:55:28 ET
Table 'Lutetia III' 6-max Seat #3 is the button
Seat 1: beta33 ($11.58 in chips) 
Seat 2: Gintaras20 ($17.41 in chips) 
Seat 3: romanromanro ($10.09 in chips) 
Seat 4: Mr50centt ($11.91 in chips) 
Seat 6: urmeli10 ($10.24 in chips) 
Mr50centt: posts small blind $0.05
KingBiscuitT: is sitting out 
urmeli10: posts big blind $0.10
*** HOLE CARDS ***
beta33: raises $0.20 to $0.30
Gintaras20: folds 
romanromanro: folds 
Mr50centt: folds 
urmeli10: folds 
Uncalled bet ($0.20) returned to beta33
beta33 collected $0.25 from pot
*** SUMMARY ***
Total pot $0.25 | Rake $0 
Seat 1: beta33 collected ($0.25)
Seat 2: Gintaras20 folded before Flop (didn't bet)
Seat 3: romanromanro (button) folded before Flop (didn't bet)
Seat 4: Mr50centt (small blind) folded before Flop
Seat 6: urmeli10 (big blind) folded before Flop



PokerStars Hand #222957893531:  Hold'em No Limit ($0.05/$0.10 USD) - 2021/01/23 10:55:38 ET
Table 'Lutetia III' 6-max Seat #4 is the button
Seat 1: beta33 ($11.73 in chips) 
Seat 2: Gintaras20 ($17.41 in chips) 
Seat 3: romanromanro ($10.09 in chips) 
Seat 4: Mr50centt ($11.86 in chips) 
Seat 6: urmeli10 ($10.14 in chips) 
urmeli10: posts small blind $0.05
beta33: posts big blind $0.10
*** HOLE CARDS ***
Gintaras20: folds 
romanromanro: raises $0.15 to $0.25
Mr50centt: folds 
urmeli10: calls $0.20
beta33: folds 
*** FLOP *** [8h 7c Ac]
urmeli10: checks 
romanromanro: bets $0.40
urmeli10: folds 
Uncalled bet ($0.40) returned to romanromanro
romanromanro collected $0.57 from pot
romanromanro: doesn't show hand 
*** SUMMARY ***
Total pot $0.60 | Rake $0.03 
Board [8h 7c Ac]
Seat 1: beta33 (big blind) folded before Flop
Seat 2: Gintaras20 folded before Flop (didn't bet)
Seat 3: romanromanro collected ($0.57)
Seat 4: Mr50centt (button) folded before Flop (didn't bet)
Seat 6: urmeli10 (small blind) folded on the Flop



PokerStars Hand #222957903976:  Hold'em No Limit ($0.05/$0.10 USD) - 2021/01/23 10:56:02 ET
Table 'Lutetia III' 6-max Seat #6 is the button
Seat 1: beta33 ($11.63 in chips) 
Seat 2: Gintaras20 ($17.41 in chips) 
Seat 3: romanromanro ($10.41 in chips) 
Seat 4: Mr50centt ($11.86 in chips) 
Seat 6: urmeli10 ($9.89 in chips) 
beta33: posts small blind $0.05
Gintaras20: posts big blind $0.10
*** HOLE CARDS ***
romanromanro: folds 
Mr50centt: folds 
urmeli10: calls $0.10
beta33: raises $0.40 to $0.50
Gintaras20: raises $1 to $1.50
urmeli10: folds 
beta33: raises $1.50 to $3
Gintaras20: calls $1.50
*** FLOP *** [Ts 9d 3h]
beta33: checks 
Gintaras20: checks 
*** TURN *** [Ts 9d 3h] [4s]
beta33: checks 
Gintaras20: bets $2.90
beta33: calls $2.90
*** RIVER *** [Ts 9d 3h 4s] [4c]
beta33: checks 
Gintaras20: checks 
*** SHOW DOWN ***
beta33: shows [Kd Ac] (a pair of Fours)
Gintaras20: mucks hand 
beta33 collected $11.36 from pot
*** SUMMARY ***
Total pot $11.90 | Rake $0.54 
Board [Ts 9d 3h 4s 4c]
Seat 1: beta33 (small blind) showed [Kd Ac] and won ($11.36) with a pair of Fours
Seat 2: Gintaras20 (big blind) mucked
Seat 3: romanromanro folded before Flop (didn't bet)
Seat 4: Mr50centt folded before Flop (didn't bet)
Seat 6: urmeli10 (button) folded before Flop



PokerStars Hand #222957940473:  Hold'em No Limit ($0.05/$0.10 USD) - 2021/01/23 10:57:25 ET
Table 'Lutetia III' 6-max Seat #1 is the button
Seat 1: beta33 ($17.09 in chips) 
Seat 2: Gintaras20 ($11.51 in chips) 
Seat 3: romanromanro ($10.41 in chips) 
Seat 4: Mr50centt ($11.86 in chips) 
Seat 6: urmeli10 ($9.79 in chips) 
Gintaras20: posts small blind $0.05
romanromanro: posts big blind $0.10
*** HOLE CARDS ***
Mr50centt: folds 
urmeli10: folds 
beta33: raises $0.20 to $0.30
Gintaras20: folds 
romanromanro: folds 
Uncalled bet ($0.20) returned to beta33
beta33 collected $0.25 from pot
*** SUMMARY ***
Total pot $0.25 | Rake $0 
Seat 1: beta33 (button) collected ($0.25)
Seat 2: Gintaras20 (small blind) folded before Flop
Seat 3: romanromanro (big blind) folded before Flop
Seat 4: Mr50centt folded before Flop (didn't bet)
Seat 6: urmeli10 folded before Flop (didn't bet)



PokerStars Hand #222957948458:  Hold'em No Limit ($0.05/$0.10 USD) - 2021/01/23 10:57:43 ET
Table 'Lutetia III' 6-max Seat #2 is the button
Seat 1: beta33 ($17.24 in chips) 
Seat 2: Gintaras20 ($11.46 in chips) 
Seat 3: romanromanro ($10.31 in chips) 
Seat 4: Mr50centt ($11.86 in chips) 
Seat 6: urmeli10 ($9.79 in chips) 
romanromanro: posts small blind $0.05
Mr50centt: posts big blind $0.10
KingBiscuitT: sits out 
*** HOLE CARDS ***
urmeli10: folds 
beta33: folds 
Gintaras20: folds 
romanromanro: folds 
Uncalled bet ($0.05) returned to Mr50centt
Mr50centt collected $0.10 from pot
Mr50centt: doesn't show hand 
*** SUMMARY ***
Total pot $0.10 | Rake $0 
Seat 1: beta33 folded before Flop (didn't bet)
Seat 2: Gintaras20 (button) folded before Flop (didn't bet)
Seat 3: romanromanro (small blind) folded before Flop
Seat 4: Mr50centt (big blind) collected ($0.10)
Seat 6: urmeli10 folded before Flop (didn't bet)



PokerStars Hand #222957951263:  Hold'em No Limit ($0.05/$0.10 USD) - 2021/01/23 10:57:49 ET
Table 'Lutetia III' 6-max Seat #3 is the button
Seat 1: beta33 ($17.24 in chips) 
Seat 2: Gintaras20 ($11.46 in chips) 
Seat 3: romanromanro ($10.26 in chips) 
Seat 4: Mr50centt ($11.91 in chips) 
Seat 5: KingBiscuitT ($22.28 in chips) 
Seat 6: urmeli10 ($9.79 in chips) 
Mr50centt: posts small blind $0.05
KingBiscuitT: posts big blind $0.10
*** HOLE CARDS ***
urmeli10: calls $0.10
beta33: folds 
Gintaras20: folds 
romanromanro: calls $0.10
Mr50centt: folds 
KingBiscuitT: checks 
*** FLOP *** [8d 6c Jc]
KingBiscuitT: checks 
urmeli10: checks 
romanromanro: checks 
*** TURN *** [8d 6c Jc] [Ad]
KingBiscuitT: checks 
urmeli10: checks 
romanromanro: checks 
*** RIVER *** [8d 6c Jc Ad] [5c]
KingBiscuitT: checks 
urmeli10: checks 
romanromanro: checks 
*** SHOW DOWN ***
KingBiscuitT: shows [4c Ah] (a pair of Aces)
urmeli10: mucks hand 
romanromanro: mucks hand 
KingBiscuitT collected $0.33 from pot
*** SUMMARY ***
Total pot $0.35 | Rake $0.02 
Board [8d 6c Jc Ad 5c]
Seat 1: beta33 folded before Flop (didn't bet)
Seat 2: Gintaras20 folded before Flop (didn't bet)
Seat 3: romanromanro (button) mucked
Seat 4: Mr50centt (small blind) folded before Flop
Seat 5: KingBiscuitT (big blind) showed [4c Ah] and won ($0.33) with a pair of Aces
Seat 6: urmeli10 mucked



PokerStars Hand #222957970641:  Hold'em No Limit ($0.05/$0.10 USD) - 2021/01/23 10:58:33 ET
Table 'Lutetia III' 6-max Seat #4 is the button
Seat 1: beta33 ($17.24 in chips) 
Seat 2: Gintaras20 ($11.46 in chips) 
Seat 3: romanromanro ($10.16 in chips) 
Seat 4: Mr50centt ($11.86 in chips) 
Seat 5: KingBiscuitT ($22.51 in chips) 
Seat 6: urmeli10 ($9.69 in chips) 
KingBiscuitT: posts small blind $0.05
urmeli10: posts big blind $0.10
*** HOLE CARDS ***
beta33: folds 
Gintaras20: folds 
romanromanro: folds 
Mr50centt: folds 
KingBiscuitT: folds 
Uncalled bet ($0.05) returned to urmeli10
urmeli10 collected $0.10 from pot
urmeli10: doesn't show hand 
*** SUMMARY ***
Total pot $0.10 | Rake $0 
Seat 1: beta33 folded before Flop (didn't bet)
Seat 2: Gintaras20 folded before Flop (didn't bet)
Seat 3: romanromanro folded before Flop (didn't bet)
Seat 4: Mr50centt (button) folded before Flop (didn't bet)
Seat 5: KingBiscuitT (small blind) folded before Flop
Seat 6: urmeli10 (big blind) collected ($0.10)



PokerStars Hand #222957974364:  Hold'em No Limit ($0.05/$0.10 USD) - 2021/01/23 10:58:42 ET
Table 'Lutetia III' 6-max Seat #5 is the button
Seat 1: beta33 ($17.24 in chips) 
Seat 2: Gintaras20 ($11.46 in chips) 
Seat 3: romanromanro ($10.16 in chips) 
Seat 4: Mr50centt ($11.86 in chips) 
Seat 5: KingBiscuitT ($22.46 in chips) 
Seat 6: urmeli10 ($9.74 in chips) 
urmeli10: posts small blind $0.05
beta33: posts big blind $0.10
*** HOLE CARDS ***
Gintaras20: folds 
romanromanro: folds 
Mr50centt: folds 
KingBiscuitT: raises $0.15 to $0.25
urmeli10: calls $0.20
beta33: folds 
*** FLOP *** [2s 6h Tc]
urmeli10: checks 
KingBiscuitT: bets $0.20
urmeli10: folds 
Uncalled bet ($0.20) returned to KingBiscuitT
KingBiscuitT collected $0.57 from pot
KingBiscuitT: doesn't show hand 
*** SUMMARY ***
Total pot $0.60 | Rake $0.03 
Board [2s 6h Tc]
Seat 1: beta33 (big blind) folded before Flop
Seat 2: Gintaras20 folded before Flop (didn't bet)
Seat 3: romanromanro folded before Flop (didn't bet)
Seat 4: Mr50centt folded before Flop (didn't bet)
Seat 5: KingBiscuitT (button) collected ($0.57)
Seat 6: urmeli10 (small blind) folded on the Flop



PokerStars Hand #222957984140:  Hold'em No Limit ($0.05/$0.10 USD) - 2021/01/23 10:59:02 ET
Table 'Lutetia III' 6-max Seat #6 is the button
Seat 1: beta33 ($17.14 in chips) 
Seat 2: Gintaras20 ($11.46 in chips) 
Seat 3: romanromanro ($10.16 in chips) 
Seat 4: Mr50centt ($11.86 in chips) 
Seat 5: KingBiscuitT ($22.78 in chips) 
Seat 6: urmeli10 ($9.49 in chips) 
beta33: posts small blind $0.05
Gintaras20: posts big blind $0.10
*** HOLE CARDS ***
romanromanro: folds 
Mr50centt: folds 
KingBiscuitT: folds 
urmeli10: folds 
beta33: folds 
Uncalled bet ($0.05) returned to Gintaras20
Gintaras20 collected $0.10 from pot
Gintaras20: doesn't show hand 
*** SUMMARY ***
Total pot $0.10 | Rake $0 
Seat 1: beta33 (small blind) folded before Flop
Seat 2: Gintaras20 (big blind) collected ($0.10)
Seat 3: romanromanro folded before Flop (didn't bet)
Seat 4: Mr50centt folded before Flop (didn't bet)
Seat 5: KingBiscuitT folded before Flop (didn't bet)
Seat 6: urmeli10 (button) folded before Flop (didn't bet)



PokerStars Hand #222957988796:  Hold'em No Limit ($0.05/$0.10 USD) - 2021/01/23 10:59:12 ET
Table 'Lutetia III' 6-max Seat #1 is the button
Seat 1: beta33 ($17.09 in chips) 
Seat 2: Gintaras20 ($11.51 in chips) 
Seat 3: romanromanro ($10.16 in chips) 
Seat 4: Mr50centt ($11.86 in chips) 
Seat 5: KingBiscuitT ($22.78 in chips) 
Seat 6: urmeli10 ($9.49 in chips) 
Gintaras20: posts small blind $0.05
romanromanro: posts big blind $0.10
*** HOLE CARDS ***
Mr50centt: raises $0.15 to $0.25
KingBiscuitT: folds 
urmeli10: folds 
beta33: folds 
Gintaras20: raises $0.65 to $0.90
romanromanro: folds 
Mr50centt: folds 
Uncalled bet ($0.65) returned to Gintaras20
Gintaras20 collected $0.60 from pot
Gintaras20: doesn't show hand 
*** SUMMARY ***
Total pot $0.60 | Rake $0 
Seat 1: beta33 (button) folded before Flop (didn't bet)
Seat 2: Gintaras20 (small blind) collected ($0.60)
Seat 3: romanromanro (big blind) folded before Flop
Seat 4: Mr50centt folded before Flop
Seat 5: KingBiscuitT folded before Flop (didn't bet)
Seat 6: urmeli10 folded before Flop (didn't bet)



PokerStars Hand #222957996959:  Hold'em No Limit ($0.05/$0.10 USD) - 2021/01/23 10:59:31 ET
Table 'Lutetia III' 6-max Seat #2 is the button
Seat 1: beta33 ($17.09 in chips) 
Seat 2: Gintaras20 ($11.86 in chips) 
Seat 3: romanromanro ($10.06 in chips) 
Seat 4: Mr50centt ($11.61 in chips) 
Seat 5: KingBiscuitT ($22.78 in chips) 
Seat 6: urmeli10 ($9.49 in chips) 
romanromanro: posts small blind $0.05
Mr50centt: posts big blind $0.10
*** HOLE CARDS ***
KingBiscuitT: folds 
urmeli10: folds 
beta33: folds 
Gintaras20: raises $0.15 to $0.25
romanromanro: raises $0.80 to $1.05
Mr50centt: folds 
Gintaras20: folds 
Uncalled bet ($0.80) returned to romanromanro
romanromanro collected $0.60 from pot
romanromanro: doesn't show hand 
*** SUMMARY ***
Total pot $0.60 | Rake $0 
Seat 1: beta33 folded before Flop (didn't bet)
Seat 2: Gintaras20 (button) folded before Flop
Seat 3: romanromanro (small blind) collected ($0.60)
Seat 4: Mr50centt (big blind) folded before Flop
Seat 5: KingBiscuitT folded before Flop (didn't bet)
Seat 6: urmeli10 folded before Flop (didn't bet)



PokerStars Hand #222958009041:  Hold'em No Limit ($0.05/$0.10 USD) - 2021/01/23 10:59:58 ET
Table 'Lutetia III' 6-max Seat #3 is the button
Seat 1: beta33 ($17.09 in chips) 
Seat 2: Gintaras20 ($11.61 in chips) 
Seat 3: romanromanro ($10.41 in chips) 
Seat 4: Mr50centt ($11.51 in chips) 
Seat 5: KingBiscuitT ($22.78 in chips) 
Seat 6: urmeli10 ($9.49 in chips) 
Mr50centt: posts small blind $0.05
KingBiscuitT: posts big blind $0.10
*** HOLE CARDS ***
urmeli10: folds 
beta33: folds 
Gintaras20: folds 
romanromanro: folds 
Mr50centt: raises $0.20 to $0.30
KingBiscuitT: folds 
Uncalled bet ($0.20) returned to Mr50centt
Mr50centt collected $0.20 from pot
Mr50centt: doesn't show hand 
*** SUMMARY ***
Total pot $0.20 | Rake $0 
Seat 1: beta33 folded before Flop (didn't bet)
Seat 2: Gintaras20 folded before Flop (didn't bet)
Seat 3: romanromanro (button) folded before Flop (didn't bet)
Seat 4: Mr50centt (small blind) collected ($0.20)
Seat 5: KingBiscuitT (big blind) folded before Flop
Seat 6: urmeli10 folded before Flop (didn't bet)



PokerStars Hand #222958018646:  Hold'em No Limit ($0.05/$0.10 USD) - 2021/01/23 11:00:19 ET
Table 'Lutetia III' 6-max Seat #4 is the button
Seat 1: beta33 ($17.09 in chips) 
Seat 2: Gintaras20 ($11.61 in chips) 
Seat 3: romanromanro ($10.41 in chips) 
Seat 4: Mr50centt ($11.61 in chips) 
Seat 5: KingBiscuitT ($22.68 in chips) 
Seat 6: urmeli10 ($9.49 in chips) 
KingBiscuitT: posts small blind $0.05
urmeli10: posts big blind $0.10
*** HOLE CARDS ***
beta33: raises $0.20 to $0.30
Gintaras20: folds 
romanromanro: folds 
Mr50centt: folds 
KingBiscuitT: folds 
urmeli10: folds 
Uncalled bet ($0.20) returned to beta33
beta33 collected $0.25 from pot
*** SUMMARY ***
Total pot $0.25 | Rake $0 
Seat 1: beta33 collected ($0.25)
Seat 2: Gintaras20 folded before Flop (didn't bet)
Seat 3: romanromanro folded before Flop (didn't bet)
Seat 4: Mr50centt (button) folded before Flop (didn't bet)
Seat 5: KingBiscuitT (small blind) folded before Flop
Seat 6: urmeli10 (big blind) folded before Flop



PokerStars Hand #222958028231:  Hold'em No Limit ($0.05/$0.10 USD) - 2021/01/23 11:00:40 ET
Table 'Lutetia III' 6-max Seat #5 is the button
Seat 1: beta33 ($17.24 in chips) 
Seat 2: Gintaras20 ($11.61 in chips) 
Seat 3: romanromanro ($10.41 in chips) 
Seat 4: Mr50centt ($11.61 in chips) 
Seat 5: KingBiscuitT ($22.63 in chips) 
Seat 6: urmeli10 ($9.39 in chips) 
urmeli10: posts small blind $0.05
beta33: posts big blind $0.10
*** HOLE CARDS ***
Gintaras20: folds 
romanromanro: folds 
Mr50centt: folds 
KingBiscuitT: raises $0.15 to $0.25
urmeli10: folds 
beta33: raises $0.75 to $1
KingBiscuitT: folds 
Uncalled bet ($0.75) returned to beta33
beta33 collected $0.55 from pot
*** SUMMARY ***
Total pot $0.55 | Rake $0 
Seat 1: beta33 (big blind) collected ($0.55)
Seat 2: Gintaras20 folded before Flop (didn't bet)
Seat 3: romanromanro folded before Flop (didn't bet)
Seat 4: Mr50centt folded before Flop (didn't bet)
Seat 5: KingBiscuitT (button) folded before Flop
Seat 6: urmeli10 (small blind) folded before Flop



PokerStars Hand #222958036382:  Hold'em No Limit ($0.05/$0.10 USD) - 2021/01/23 11:00:57 ET
Table 'Lutetia III' 6-max Seat #6 is the button
Seat 1: beta33 ($17.54 in chips) 
Seat 2: Gintaras20 ($11.61 in chips) 
Seat 3: romanromanro ($10.41 in chips) 
Seat 4: Mr50centt ($11.61 in chips) 
Seat 5: KingBiscuitT ($22.38 in chips) 
Seat 6: urmeli10 ($9.34 in chips) 
beta33: posts small blind $0.05
Gintaras20: posts big blind $0.10
*** HOLE CARDS ***
romanromanro: folds 
Mr50centt: raises $0.15 to $0.25
KingBiscuitT: calls $0.25
urmeli10: calls $0.25
beta33: folds 
Gintaras20: calls $0.15
*** FLOP *** [9d Qd Jh]
Gintaras20: checks 
Mr50centt: bets $0.30
KingBiscuitT: folds 
urmeli10: calls $0.30
Gintaras20: folds 
*** TURN *** [9d Qd Jh] [5c]
Mr50centt: bets $0.70
urmeli10: folds 
Uncalled bet ($0.70) returned to Mr50centt
Mr50centt collected $1.58 from pot
Mr50centt: doesn't show hand 
*** SUMMARY ***
Total pot $1.65 | Rake $0.07 
Board [9d Qd Jh 5c]
Seat 1: beta33 (small blind) folded before Flop
Seat 2: Gintaras20 (big blind) folded on the Flop
Seat 3: romanromanro folded before Flop (didn't bet)
Seat 4: Mr50centt collected ($1.58)
Seat 5: KingBiscuitT folded on the Flop
Seat 6: urmeli10 (button) folded on the Turn



PokerStars Hand #222958062837:  Hold'em No Limit ($0.05/$0.10 USD) - 2021/01/23 11:01:47 ET
Table 'Lutetia III' 6-max Seat #1 is the button
Seat 1: beta33 ($17.49 in chips) 
Seat 2: Gintaras20 ($11.36 in chips) 
Seat 3: romanromanro ($10.41 in chips) 
Seat 4: Mr50centt ($12.64 in chips) 
Seat 5: KingBiscuitT ($22.13 in chips) 
Seat 6: urmeli10 ($8.79 in chips) 
Gintaras20: posts small blind $0.05
romanromanro: posts big blind $0.10
*** HOLE CARDS ***
Mr50centt: raises $0.15 to $0.25
KingBiscuitT: calls $0.25
urmeli10: folds 
beta33: calls $0.25
Gintaras20: folds 
romanromanro: folds 
*** FLOP *** [7d 2h 8d]
Mr50centt: checks 
KingBiscuitT: checks 
beta33: checks 
*** TURN *** [7d 2h 8d] [Qs]
Mr50centt: checks 
KingBiscuitT: checks 
beta33: checks 
*** RIVER *** [7d 2h 8d Qs] [Tc]
Mr50centt: bets $0.50
KingBiscuitT: folds 
beta33: folds 
Uncalled bet ($0.50) returned to Mr50centt
Mr50centt collected $0.86 from pot
Mr50centt: doesn't show hand 
*** SUMMARY ***
Total pot $0.90 | Rake $0.04 
Board [7d 2h 8d Qs Tc]
Seat 1: beta33 (button) folded on the River
Seat 2: Gintaras20 (small blind) folded before Flop
Seat 3: romanromanro (big blind) folded before Flop
Seat 4: Mr50centt collected ($0.86)
Seat 5: KingBiscuitT folded on the River
Seat 6: urmeli10 folded before Flop (didn't bet)



PokerStars Hand #222958100268:  Hold'em No Limit ($0.05/$0.10 USD) - 2021/01/23 11:02:58 ET
Table 'Lutetia III' 6-max Seat #2 is the button
Seat 1: beta33 ($17.24 in chips) 
Seat 2: Gintaras20 ($11.31 in chips) 
Seat 3: romanromanro ($10.31 in chips) 
Seat 4: Mr50centt ($13.25 in chips) 
Seat 5: KingBiscuitT ($21.88 in chips) 
Seat 6: urmeli10 ($8.79 in chips) 
romanromanro: posts small blind $0.05
Mr50centt: posts big blind $0.10
*** HOLE CARDS ***
KingBiscuitT: folds 
urmeli10: folds 
beta33: raises $0.20 to $0.30
Gintaras20: folds 
romanromanro: folds 
Mr50centt: folds 
Uncalled bet ($0.20) returned to beta33
beta33 collected $0.25 from pot
*** SUMMARY ***
Total pot $0.25 | Rake $0 
Seat 1: beta33 collected ($0.25)
Seat 2: Gintaras20 (button) folded before Flop (didn't bet)
Seat 3: romanromanro (small blind) folded before Flop
Seat 4: Mr50centt (big blind) folded before Flop
Seat 5: KingBiscuitT folded before Flop (didn't bet)
Seat 6: urmeli10 folded before Flop (didn't bet)



PokerStars Hand #222958107228:  Hold'em No Limit ($0.05/$0.10 USD) - 2021/01/23 11:03:11 ET
Table 'Lutetia III' 6-max Seat #3 is the button
Seat 1: beta33 ($17.39 in chips) 
Seat 2: Gintaras20 ($11.31 in chips) 
Seat 3: romanromanro ($10.26 in chips) 
Seat 4: Mr50centt ($13.15 in chips) 
Seat 5: KingBiscuitT ($21.88 in chips) 
Seat 6: urmeli10 ($8.79 in chips) 
Mr50centt: posts small blind $0.05
KingBiscuitT: posts big blind $0.10
*** HOLE CARDS ***
urmeli10: raises $0.10 to $0.20
beta33: raises $0.30 to $0.50
Gintaras20: folds 
romanromanro: folds 
Mr50centt: folds 
KingBiscuitT: folds 
urmeli10: calls $0.30
*** FLOP *** [2h 3h Kh]
urmeli10: checks 
beta33: bets $0.80
urmeli10: calls $0.80
*** TURN *** [2h 3h Kh] [6d]
urmeli10: checks 
beta33: checks 
*** RIVER *** [2h 3h Kh 6d] [3c]
urmeli10: checks 
beta33: checks 
*** SHOW DOWN ***
urmeli10: shows [Qh Kc] (two pair, Kings and Threes)
beta33: mucks hand 
urmeli10 collected $2.63 from pot
*** SUMMARY ***
Total pot $2.75 | Rake $0.12 
Board [2h 3h Kh 6d 3c]
Seat 1: beta33 mucked
Seat 2: Gintaras20 folded before Flop (didn't bet)
Seat 3: romanromanro (button) folded before Flop (didn't bet)
Seat 4: Mr50centt (small blind) folded before Flop
Seat 5: KingBiscuitT (big blind) folded before Flop
Seat 6: urmeli10 showed [Qh Kc] and won ($2.63) with two pair, Kings and Threes



PokerStars Hand #222958139342:  Hold'em No Limit ($0.05/$0.10 USD) - 2021/01/23 11:04:04 ET
Table 'Lutetia III' 6-max Seat #4 is the button
Seat 1: beta33 ($16.09 in chips) 
Seat 2: Gintaras20 ($11.31 in chips) 
Seat 3: romanromanro ($10.26 in chips) 
Seat 4: Mr50centt ($13.10 in chips) 
Seat 5: KingBiscuitT ($21.78 in chips) 
Seat 6: urmeli10 ($10.12 in chips) 
KingBiscuitT: posts small blind $0.05
urmeli10: posts big blind $0.10
*** HOLE CARDS ***
beta33: raises $0.20 to $0.30
Gintaras20: calls $0.30
romanromanro: folds 
Mr50centt: folds 
KingBiscuitT: folds 
urmeli10: calls $0.20
*** FLOP *** [9h Th 3h]
urmeli10: checks 
beta33: bets $0.60
Gintaras20: folds 
urmeli10: folds 
Uncalled bet ($0.60) returned to beta33
beta33 collected $0.91 from pot
*** SUMMARY ***
Total pot $0.95 | Rake $0.04 
Board [9h Th 3h]
Seat 1: beta33 collected ($0.91)
Seat 2: Gintaras20 folded on the Flop
Seat 3: romanromanro folded before Flop (didn't bet)
Seat 4: Mr50centt (button) folded before Flop (didn't bet)
Seat 5: KingBiscuitT (small blind) folded before Flop
Seat 6: urmeli10 (big blind) folded on the Flop



PokerStars Hand #222958160620:  Hold'em No Limit ($0.05/$0.10 USD) - 2021/01/23 11:04:42 ET
Table 'Lutetia III' 6-max Seat #5 is the button
Seat 1: beta33 ($16.70 in chips) 
Seat 2: Gintaras20 ($11.01 in chips) 
Seat 3: romanromanro ($10.26 in chips) 
Seat 4: Mr50centt ($13.10 in chips) 
Seat 5: KingBiscuitT ($21.73 in chips) 
Seat 6: urmeli10 ($9.82 in chips) 
urmeli10: posts small blind $0.05
beta33: posts big blind $0.10
*** HOLE CARDS ***
Gintaras20: folds 
romanromanro: folds 
Mr50centt: raises $0.15 to $0.25
KingBiscuitT: folds 
urmeli10: calls $0.20
beta33: folds 
*** FLOP *** [4d 8c 7c]
urmeli10: bets $0.57
Mr50centt: folds 
Uncalled bet ($0.57) returned to urmeli10
urmeli10 collected $0.57 from pot
urmeli10: doesn't show hand 
*** SUMMARY ***
Total pot $0.60 | Rake $0.03 
Board [4d 8c 7c]
Seat 1: beta33 (big blind) folded before Flop
Seat 2: Gintaras20 folded before Flop (didn't bet)
Seat 3: romanromanro folded before Flop (didn't bet)
Seat 4: Mr50centt folded on the Flop
Seat 5: KingBiscuitT (button) folded before Flop (didn't bet)
Seat 6: urmeli10 (small blind) collected ($0.57)



PokerStars Hand #222958175269:  Hold'em No Limit ($0.05/$0.10 USD) - 2021/01/23 11:05:07 ET
Table 'Lutetia III' 6-max Seat #6 is the button
Seat 1: beta33 ($16.60 in chips) 
Seat 2: Gintaras20 ($11.01 in chips) 
Seat 3: romanromanro ($10.26 in chips) 
Seat 4: Mr50centt ($12.85 in chips) 
Seat 5: KingBiscuitT ($21.73 in chips) 
Seat 6: urmeli10 ($10.14 in chips) 
beta33: posts small blind $0.05
Gintaras20: posts big blind $0.10
*** HOLE CARDS ***
romanromanro: folds 
Mr50centt: folds 
KingBiscuitT: raises $0.40 to $0.50
urmeli10: calls $0.50
beta33: folds 
Gintaras20: calls $0.40
*** FLOP *** [4c 4d 7c]
Gintaras20: checks 
KingBiscuitT: bets $0.99
urmeli10: calls $0.99
Gintaras20: calls $0.99
*** TURN *** [4c 4d 7c] [Jd]
Gintaras20: checks 
KingBiscuitT: checks 
urmeli10: checks 
*** RIVER *** [4c 4d 7c Jd] [8c]
Gintaras20: checks 
KingBiscuitT: checks 
urmeli10: checks 
*** SHOW DOWN ***
Gintaras20: shows [6s 5s] (a straight, Four to Eight)
KingBiscuitT: mucks hand 
urmeli10: mucks hand 
Gintaras20 collected $4.32 from pot
*** SUMMARY ***
Total pot $4.52 | Rake $0.20 
Board [4c 4d 7c Jd 8c]
Seat 1: beta33 (small blind) folded before Flop
Seat 2: Gintaras20 (big blind) showed [6s 5s] and won ($4.32) with a straight, Four to Eight
Seat 3: romanromanro folded before Flop (didn't bet)
Seat 4: Mr50centt folded before Flop (didn't bet)
Seat 5: KingBiscuitT mucked
Seat 6: urmeli10 (button) mucked



PokerStars Hand #222958211106:  Hold'em No Limit ($0.05/$0.10 USD) - 2021/01/23 11:06:07 ET
Table 'Lutetia III' 6-max Seat #1 is the button
Seat 1: beta33 ($16.55 in chips) 
Seat 2: Gintaras20 ($13.84 in chips) 
Seat 3: romanromanro ($10.26 in chips) 
Seat 4: Mr50centt ($12.85 in chips) 
Seat 5: KingBiscuitT ($20.24 in chips) 
Seat 6: urmeli10 ($8.65 in chips) 
Gintaras20: posts small blind $0.05
romanromanro: posts big blind $0.10
*** HOLE CARDS ***
Mr50centt: raises $0.15 to $0.25
KingBiscuitT: folds 
urmeli10: calls $0.25
beta33: calls $0.25
Gintaras20: folds 
romanromanro: folds 
*** FLOP *** [3s 7h 3c]
Mr50centt: checks 
urmeli10: checks 
beta33: bets $0.60
Mr50centt: folds 
urmeli10: calls $0.60
*** TURN *** [3s 7h 3c] [Qs]
urmeli10: bets $1
beta33: folds 
Uncalled bet ($1) returned to urmeli10
urmeli10 collected $2.01 from pot
urmeli10: doesn't show hand 
*** SUMMARY ***
Total pot $2.10 | Rake $0.09 
Board [3s 7h 3c Qs]
Seat 1: beta33 (button) folded on the Turn
Seat 2: Gintaras20 (small blind) folded before Flop
Seat 3: romanromanro (big blind) folded before Flop
Seat 4: Mr50centt folded on the Flop
Seat 5: KingBiscuitT folded before Flop (didn't bet)
Seat 6: urmeli10 collected ($2.01)



PokerStars Hand #222958232604:  Hold'em No Limit ($0.05/$0.10 USD) - 2021/01/23 11:06:43 ET
Table 'Lutetia III' 6-max Seat #2 is the button
Seat 1: beta33 ($15.70 in chips) 
Seat 2: Gintaras20 ($13.79 in chips) 
Seat 3: romanromanro ($10.16 in chips) 
Seat 4: Mr50centt ($12.60 in chips) 
Seat 5: KingBiscuitT ($20.24 in chips) 
Seat 6: urmeli10 ($9.81 in chips) 
romanromanro: posts small blind $0.05
Mr50centt: posts big blind $0.10
*** HOLE CARDS ***
KingBiscuitT: folds 
urmeli10: calls $0.10
beta33: folds 
Gintaras20: folds 
romanromanro: folds 
Mr50centt: checks 
*** FLOP *** [8h 4s Qc]
Mr50centt: checks 
urmeli10: bets $0.12
Mr50centt: calls $0.12
*** TURN *** [8h 4s Qc] [9d]
Mr50centt: checks 
urmeli10: bets $0.47
Mr50centt: raises $1.33 to $1.80
urmeli10: folds 
Uncalled bet ($1.33) returned to Mr50centt
Mr50centt collected $1.37 from pot
*** SUMMARY ***
Total pot $1.43 | Rake $0.06 
Board [8h 4s Qc 9d]
Seat 1: beta33 folded before Flop (didn't bet)
Seat 2: Gintaras20 (button) folded before Flop (didn't bet)
Seat 3: romanromanro (small blind) folded before Flop
Seat 4: Mr50centt (big blind) collected ($1.37)
Seat 5: KingBiscuitT folded before Flop (didn't bet)
Seat 6: urmeli10 folded on the Turn



PokerStars Hand #222958257928:  Hold'em No Limit ($0.05/$0.10 USD) - 2021/01/23 11:07:26 ET
Table 'Lutetia III' 6-max Seat #3 is the button
Seat 1: beta33 ($15.70 in chips) 
Seat 2: Gintaras20 ($13.79 in chips) 
Seat 3: romanromanro ($10.11 in chips) 
Seat 4: Mr50centt ($13.28 in chips) 
Seat 5: KingBiscuitT ($20.24 in chips) 
Seat 6: urmeli10 ($9.12 in chips) 
Mr50centt: posts small blind $0.05
KingBiscuitT: posts big blind $0.10
*** HOLE CARDS ***
urmeli10: calls $0.10
beta33: folds 
Gintaras20: folds 
romanromanro: folds 
Mr50centt: calls $0.05
KingBiscuitT: checks 
*** FLOP *** [9h Ad Td]
Mr50centt: checks 
KingBiscuitT: checks 
urmeli10: checks 
*** TURN *** [9h Ad Td] [4h]
Mr50centt: checks 
KingBiscuitT: checks 
urmeli10: bets $0.29
Mr50centt: folds 
KingBiscuitT: folds 
Uncalled bet ($0.29) returned to urmeli10
urmeli10 collected $0.29 from pot
urmeli10: doesn't show hand 
*** SUMMARY ***
Total pot $0.30 | Rake $0.01 
Board [9h Ad Td 4h]
Seat 1: beta33 folded before Flop (didn't bet)
Seat 2: Gintaras20 folded before Flop (didn't bet)
Seat 3: romanromanro (button) folded before Flop (didn't bet)
Seat 4: Mr50centt (small blind) folded on the Turn
Seat 5: KingBiscuitT (big blind) folded on the Turn
Seat 6: urmeli10 collected ($0.29)



PokerStars Hand #222958279421:  Hold'em No Limit ($0.05/$0.10 USD) - 2021/01/23 11:08:02 ET
Table 'Lutetia III' 6-max Seat #4 is the button
Seat 1: beta33 ($15.70 in chips) 
Seat 2: Gintaras20 ($13.79 in chips) 
Seat 3: romanromanro ($10.11 in chips) 
Seat 4: Mr50centt ($13.18 in chips) 
Seat 5: KingBiscuitT ($20.14 in chips) 
Seat 6: urmeli10 ($9.31 in chips) 
KingBiscuitT: posts small blind $0.05
urmeli10: posts big blind $0.10
*** HOLE CARDS ***
beta33: folds 
Gintaras20: folds 
romanromanro: folds 
Mr50centt: folds 
KingBiscuitT: raises $0.20 to $0.30
urmeli10: calls $0.20
*** FLOP *** [7c 3s 2s]
KingBiscuitT: checks 
urmeli10: checks 
*** TURN *** [7c 3s 2s] [5d]
KingBiscuitT: checks 
urmeli10: checks 
*** RIVER *** [7c 3s 2s 5d] [6c]
KingBiscuitT: bets $0.86
urmeli10: folds 
Uncalled bet ($0.86) returned to KingBiscuitT
KingBiscuitT collected $0.57 from pot
KingBiscuitT: doesn't show hand 
*** SUMMARY ***
Total pot $0.60 | Rake $0.03 
Board [7c 3s 2s 5d 6c]
Seat 1: beta33 folded before Flop (didn't bet)
Seat 2: Gintaras20 folded before Flop (didn't bet)
Seat 3: romanromanro folded before Flop (didn't bet)
Seat 4: Mr50centt (button) folded before Flop (didn't bet)
Seat 5: KingBiscuitT (small blind) collected ($0.57)
Seat 6: urmeli10 (big blind) folded on the River



PokerStars Hand #222958295776:  Hold'em No Limit ($0.05/$0.10 USD) - 2021/01/23 11:08:30 ET
Table 'Lutetia III' 6-max Seat #5 is the button
Seat 1: beta33 ($15.70 in chips) 
Seat 2: Gintaras20 ($13.79 in chips) 
Seat 3: romanromanro ($10.11 in chips) 
Seat 4: Mr50centt ($13.18 in chips) 
Seat 5: KingBiscuitT ($20.41 in chips) 
Seat 6: urmeli10 ($9.01 in chips) 
urmeli10: posts small blind $0.05
beta33: posts big blind $0.10
*** HOLE CARDS ***
Gintaras20: raises $0.15 to $0.25
romanromanro: raises $0.70 to $0.95
Mr50centt: folds 
KingBiscuitT: folds 
urmeli10: folds 
beta33: folds 
Gintaras20: calls $0.70
*** FLOP *** [Ks 5h 4c]
Gintaras20: checks 
romanromanro: bets $0.45
Gintaras20: calls $0.45
*** TURN *** [Ks 5h 4c] [2s]
Gintaras20: checks 
romanromanro: checks 
*** RIVER *** [Ks 5h 4c 2s] [6s]
Gintaras20: bets $1.41
romanromanro: folds 
Uncalled bet ($1.41) returned to Gintaras20
romanromanro leaves the table
Gintaras20 collected $2.82 from pot
Gintaras20: doesn't show hand 
*** SUMMARY ***
Total pot $2.95 | Rake $0.13 
Board [Ks 5h 4c 2s 6s]
Seat 1: beta33 (big blind) folded before Flop
Seat 2: Gintaras20 collected ($2.82)
Seat 3: romanromanro folded on the River
Seat 4: Mr50centt folded before Flop (didn't bet)
Seat 5: KingBiscuitT (button) folded before Flop (didn't bet)
Seat 6: urmeli10 (small blind) folded before Flop



PokerStars Hand #222958317524:  Hold'em No Limit ($0.05/$0.10 USD) - 2021/01/23 11:09:06 ET
Table 'Lutetia III' 6-max Seat #6 is the button
Seat 1: beta33 ($15.60 in chips) 
Seat 2: Gintaras20 ($15.21 in chips) 
Seat 4: Mr50centt ($13.18 in chips) 
Seat 5: KingBiscuitT ($20.41 in chips) 
Seat 6: urmeli10 ($8.96 in chips) 
beta33: posts small blind $0.05
Gintaras20: posts big blind $0.10
*** HOLE CARDS ***
Mr50centt: folds 
KingBiscuitT: folds 
urmeli10: raises $0.10 to $0.20
3EBC96 joins the table at seat #3 
beta33: raises $0.50 to $0.70
Gintaras20: folds 
urmeli10: calls $0.50
*** FLOP *** [2c 9d 3c]
beta33: bets $1
urmeli10: folds 
Uncalled bet ($1) returned to beta33
beta33 collected $1.43 from pot
*** SUMMARY ***
Total pot $1.50 | Rake $0.07 
Board [2c 9d 3c]
Seat 1: beta33 (small blind) collected ($1.43)
Seat 2: Gintaras20 (big blind) folded before Flop
Seat 4: Mr50centt folded before Flop (didn't bet)
Seat 5: KingBiscuitT folded before Flop (didn't bet)
Seat 6: urmeli10 (button) folded on the Flop



PokerStars Hand #222958340749:  Hold'em No Limit ($0.05/$0.10 USD) - 2021/01/23 11:09:45 ET
Table 'Lutetia III' 6-max Seat #1 is the button
Seat 1: beta33 ($16.33 in chips) 
Seat 4: Mr50centt ($13.18 in chips) 
Seat 5: KingBiscuitT ($20.41 in chips) 
Seat 6: urmeli10 ($8.26 in chips) 
Mr50centt: posts small blind $0.05
KingBiscuitT: posts big blind $0.10
*** HOLE CARDS ***
urmeli10: folds 
beta33: raises $0.20 to $0.30
Mr50centt: folds 
KingBiscuitT: folds 
Uncalled bet ($0.20) returned to beta33
beta33 collected $0.25 from pot
*** SUMMARY ***
Total pot $0.25 | Rake $0 
Seat 1: beta33 (button) collected ($0.25)
Seat 4: Mr50centt (small blind) folded before Flop
Seat 5: KingBiscuitT (big blind) folded before Flop
Seat 6: urmeli10 folded before Flop (didn't bet)



PokerStars Hand #222958346805:  Hold'em No Limit ($0.05/$0.10 USD) - 2021/01/23 11:09:55 ET
Table 'Lutetia III' 6-max Seat #4 is the button
Seat 1: beta33 ($16.48 in chips) 
Seat 4: Mr50centt ($13.13 in chips) 
Seat 5: KingBiscuitT ($20.31 in chips) 
Seat 6: urmeli10 ($8.26 in chips) 
KingBiscuitT: posts small blind $0.05
urmeli10: posts big blind $0.10
3EBC96: sits out 
*** HOLE CARDS ***
beta33: folds 
Mr50centt: folds 
KingBiscuitT: folds 
Uncalled bet ($0.05) returned to urmeli10
urmeli10 collected $0.10 from pot
urmeli10: doesn't show hand 
*** SUMMARY ***
Total pot $0.10 | Rake $0 
Seat 1: beta33 folded before Flop (didn't bet)
Seat 4: Mr50centt (button) folded before Flop (didn't bet)
Seat 5: KingBiscuitT (small blind) folded before Flop
Seat 6: urmeli10 (big blind) collected ($0.10)



PokerStars Hand #222958355771:  Hold'em No Limit ($0.05/$0.10 USD) - 2021/01/23 11:10:10 ET
Table 'Lutetia III' 6-max Seat #5 is the button
Seat 1: beta33 ($16.48 in chips) 
Seat 4: Mr50centt ($13.13 in chips) 
Seat 5: KingBiscuitT ($20.26 in chips) 
Seat 6: urmeli10 ($8.31 in chips) 
urmeli10: posts small blind $0.05
beta33: posts big blind $0.10
3EBC96: sits out 
*** HOLE CARDS ***
Mr50centt: folds 
KingBiscuitT: raises $0.12 to $0.22
urmeli10: calls $0.17
beta33: folds 
*** FLOP *** [7h 2s Jh]
urmeli10: bets $0.26
KingBiscuitT: calls $0.26
*** TURN *** [7h 2s Jh] [5s]
urmeli10: bets $0.50
KingBiscuitT: calls $0.50
*** RIVER *** [7h 2s Jh 5s] [4c]
urmeli10: checks 
KingBiscuitT: checks 
*** SHOW DOWN ***
urmeli10: shows [Qh 4h] (a pair of Fours)
KingBiscuitT: shows [7s 8c] (a pair of Sevens)
KingBiscuitT collected $1.97 from pot
*** SUMMARY ***
Total pot $2.06 | Rake $0.09 
Board [7h 2s Jh 5s 4c]
Seat 1: beta33 (big blind) folded before Flop
Seat 4: Mr50centt folded before Flop (didn't bet)
Seat 5: KingBiscuitT (button) showed [7s 8c] and won ($1.97) with a pair of Sevens
Seat 6: urmeli10 (small blind) showed [Qh 4h] and lost with a pair of Fours



PokerStars Hand #222958383020:  Hold'em No Limit ($0.05/$0.10 USD) - 2021/01/23 11:10:55 ET
Table 'Lutetia III' 6-max Seat #6 is the button
Seat 1: beta33 ($16.38 in chips) 
Seat 3: 3EBC96 ($10 in chips) 
Seat 4: Mr50centt ($13.13 in chips) 
Seat 5: KingBiscuitT ($21.25 in chips) 
Seat 6: urmeli10 ($7.33 in chips) 
beta33: posts small blind $0.05
3EBC96: posts big blind $0.10
*** HOLE CARDS ***
Mr50centt: folds 
KingBiscuitT: folds 
urmeli10: folds 
beta33: folds 
Uncalled bet ($0.05) returned to 3EBC96
3EBC96 collected $0.10 from pot
3EBC96: doesn't show hand 
*** SUMMARY ***
Total pot $0.10 | Rake $0 
Seat 1: beta33 (small blind) folded before Flop
Seat 3: 3EBC96 (big blind) collected ($0.10)
Seat 4: Mr50centt folded before Flop (didn't bet)
Seat 5: KingBiscuitT folded before Flop (didn't bet)
Seat 6: urmeli10 (button) folded before Flop (didn't bet)



PokerStars Hand #222958391680:  Hold'em No Limit ($0.05/$0.10 USD) - 2021/01/23 11:11:10 ET
Table 'Lutetia III' 6-max Seat #1 is the button
Seat 1: beta33 ($16.33 in chips) 
Seat 3: 3EBC96 ($10.05 in chips) 
Seat 4: Mr50centt ($13.13 in chips) 
Seat 5: KingBiscuitT ($21.25 in chips) 
Seat 6: urmeli10 ($7.33 in chips) 
3EBC96: posts small blind $0.05
Mr50centt: posts big blind $0.10
*** HOLE CARDS ***
KingBiscuitT: folds 
urmeli10: folds 
beta33: raises $0.20 to $0.30
3EBC96: folds 
Mr50centt: folds 
Uncalled bet ($0.20) returned to beta33
beta33 collected $0.25 from pot
*** SUMMARY ***
Total pot $0.25 | Rake $0 
Seat 1: beta33 (button) collected ($0.25)
Seat 3: 3EBC96 (small blind) folded before Flop
Seat 4: Mr50centt (big blind) folded before Flop
Seat 5: KingBiscuitT folded before Flop (didn't bet)
Seat 6: urmeli10 folded before Flop (didn't bet)



PokerStars Hand #222958401670:  Hold'em No Limit ($0.05/$0.10 USD) - 2021/01/23 11:11:26 ET
Table 'Lutetia III' 6-max Seat #3 is the button
Seat 1: beta33 ($16.48 in chips) 
Seat 3: 3EBC96 ($10 in chips) 
Seat 4: Mr50centt ($13.03 in chips) 
Seat 6: urmeli10 ($7.33 in chips) 
Mr50centt: posts small blind $0.05
KingBiscuitT: is sitting out 
urmeli10: posts big blind $0.10
*** HOLE CARDS ***
KingBiscuitT leaves the table
einsftw joins the table at seat #5 
beta33: raises $0.20 to $0.30
3EBC96: folds 
Mr50centt: folds 
urmeli10: folds 
Uncalled bet ($0.20) returned to beta33
beta33 collected $0.25 from pot
*** SUMMARY ***
Total pot $0.25 | Rake $0 
Seat 1: beta33 collected ($0.25)
Seat 3: 3EBC96 (button) folded before Flop (didn't bet)
Seat 4: Mr50centt (small blind) folded before Flop
Seat 6: urmeli10 (big blind) folded before Flop



PokerStars Hand #222958408499:  Hold'em No Limit ($0.05/$0.10 USD) - 2021/01/23 11:11:37 ET
Table 'Lutetia III' 6-max Seat #4 is the button
Seat 1: beta33 ($16.63 in chips) 
Seat 3: 3EBC96 ($10 in chips) 
Seat 4: Mr50centt ($12.98 in chips) 
Seat 6: urmeli10 ($7.23 in chips) 
urmeli10: posts small blind $0.05
beta33: posts big blind $0.10
*** HOLE CARDS ***
3EBC96: folds 
Mr50centt: raises $0.10 to $0.20
urmeli10: folds 
beta33: folds 
Uncalled bet ($0.10) returned to Mr50centt
Mr50centt collected $0.25 from pot
Mr50centt: doesn't show hand 
*** SUMMARY ***
Total pot $0.25 | Rake $0 
Seat 1: beta33 (big blind) folded before Flop
Seat 3: 3EBC96 folded before Flop (didn't bet)
Seat 4: Mr50centt (button) collected ($0.25)
Seat 6: urmeli10 (small blind) folded before Flop



PokerStars Hand #222958413925:  Hold'em No Limit ($0.05/$0.10 USD) - 2021/01/23 11:11:46 ET
Table 'Lutetia III' 6-max Seat #6 is the button
Seat 1: beta33 ($16.53 in chips) 
Seat 2: Gintaras20 ($15.11 in chips) 
Seat 3: 3EBC96 ($10 in chips) 
Seat 4: Mr50centt ($13.13 in chips) 
Seat 6: urmeli10 ($7.18 in chips) 
beta33: posts small blind $0.05
Gintaras20: posts big blind $0.10
einsftw: sits out 
*** HOLE CARDS ***
3EBC96: folds 
Mr50centt: folds 
urmeli10: calls $0.10
beta33: folds 
Gintaras20: checks 
*** FLOP *** [7s 4c Ts]
Gintaras20: bets $0.12
urmeli10: calls $0.12
*** TURN *** [7s 4c Ts] [Qd]
Gintaras20: bets $0.24
urmeli10: folds 
Uncalled bet ($0.24) returned to Gintaras20
Gintaras20 collected $0.47 from pot
Gintaras20: doesn't show hand 
*** SUMMARY ***
Total pot $0.49 | Rake $0.02 
Board [7s 4c Ts Qd]
Seat 1: beta33 (small blind) folded before Flop
Seat 2: Gintaras20 (big blind) collected ($0.47)
Seat 3: 3EBC96 folded before Flop (didn't bet)
Seat 4: Mr50centt folded before Flop (didn't bet)
Seat 6: urmeli10 (button) folded on the Turn



PokerStars Hand #222958427814:  Hold'em No Limit ($0.05/$0.10 USD) - 2021/01/23 11:12:10 ET
Table 'Lutetia III' 6-max Seat #1 is the button
Seat 1: beta33 ($16.48 in chips) 
Seat 2: Gintaras20 ($15.36 in chips) 
Seat 3: 3EBC96 ($10 in chips) 
Seat 4: Mr50centt ($13.13 in chips) 
Seat 6: urmeli10 ($6.96 in chips) 
Gintaras20: posts small blind $0.05
3EBC96: posts big blind $0.10
einsftw: sits out 
*** HOLE CARDS ***
Mr50centt: folds 
urmeli10: folds 
beta33: folds 
Gintaras20: folds 
Uncalled bet ($0.05) returned to 3EBC96
3EBC96 collected $0.10 from pot
3EBC96: doesn't show hand 
*** SUMMARY ***
Total pot $0.10 | Rake $0 
Seat 1: beta33 (button) folded before Flop (didn't bet)
Seat 2: Gintaras20 (small blind) folded before Flop
Seat 3: 3EBC96 (big blind) collected ($0.10)
Seat 4: Mr50centt folded before Flop (didn't bet)
Seat 6: urmeli10 folded before Flop (didn't bet)



PokerStars Hand #222958431892:  Hold'em No Limit ($0.05/$0.10 USD) - 2021/01/23 11:12:16 ET
Table 'Lutetia III' 6-max Seat #2 is the button
Seat 1: beta33 ($16.48 in chips) 
Seat 2: Gintaras20 ($15.31 in chips) 
Seat 3: 3EBC96 ($10.05 in chips) 
Seat 4: Mr50centt ($13.13 in chips) 
Seat 6: urmeli10 ($6.96 in chips) 
3EBC96: posts small blind $0.05
Mr50centt: posts big blind $0.10
einsftw: sits out 
*** HOLE CARDS ***
urmeli10: calls $0.10
beta33: raises $0.30 to $0.40
Gintaras20: calls $0.40
3EBC96: folds 
Mr50centt: folds 
urmeli10: calls $0.30
*** FLOP *** [Jh 5s Qs]
urmeli10: checks 
beta33: checks 
Gintaras20: bets $0.65
urmeli10: folds 
beta33: calls $0.65
*** TURN *** [Jh 5s Qs] [6d]
beta33: checks 
Gintaras20: bets $1.27
beta33: calls $1.27
*** RIVER *** [Jh 5s Qs 6d] [7c]
beta33: checks 
Gintaras20: checks 
*** SHOW DOWN ***
beta33: shows [Ad Jc] (a pair of Jacks)
Gintaras20: mucks hand 
beta33 collected $4.96 from pot
*** SUMMARY ***
Total pot $5.19 | Rake $0.23 
Board [Jh 5s Qs 6d 7c]
Seat 1: beta33 showed [Ad Jc] and won ($4.96) with a pair of Jacks
Seat 2: Gintaras20 (button) mucked
Seat 3: 3EBC96 (small blind) folded before Flop
Seat 4: Mr50centt (big blind) folded before Flop
Seat 6: urmeli10 folded on the Flop



PokerStars Hand #222958471035:  Hold'em No Limit ($0.05/$0.10 USD) - 2021/01/23 11:13:14 ET
Table 'Lutetia III' 6-max Seat #3 is the button
Seat 1: beta33 ($19.12 in chips) 
Seat 2: Gintaras20 ($12.99 in chips) 
Seat 3: 3EBC96 ($10 in chips) 
Seat 4: Mr50centt ($13.03 in chips) 
Seat 5: einsftw ($10 in chips) 
Seat 6: urmeli10 ($6.56 in chips) 
Mr50centt: posts small blind $0.05
einsftw: posts big blind $0.10
*** HOLE CARDS ***
urmeli10: folds 
beta33: folds 
Gintaras20: folds 
3EBC96: raises $0.20 to $0.30
Mr50centt: folds 
einsftw: folds 
Uncalled bet ($0.20) returned to 3EBC96
3EBC96 collected $0.25 from pot
3EBC96: doesn't show hand 
*** SUMMARY ***
Total pot $0.25 | Rake $0 
Seat 1: beta33 folded before Flop (didn't bet)
Seat 2: Gintaras20 folded before Flop (didn't bet)
Seat 3: 3EBC96 (button) collected ($0.25)
Seat 4: Mr50centt (small blind) folded before Flop
Seat 5: einsftw (big blind) folded before Flop
Seat 6: urmeli10 folded before Flop (didn't bet)



PokerStars Hand #222958482883:  Hold'em No Limit ($0.05/$0.10 USD) - 2021/01/23 11:13:33 ET
Table 'Lutetia III' 6-max Seat #4 is the button
Seat 1: beta33 ($19.12 in chips) 
Seat 2: Gintaras20 ($12.99 in chips) 
Seat 3: 3EBC96 ($10.15 in chips) 
Seat 4: Mr50centt ($12.98 in chips) 
Seat 5: einsftw ($10 in chips) 
Seat 6: urmeli10 ($6.56 in chips) 
einsftw: posts small blind $0.05
urmeli10: posts big blind $0.10
*** HOLE CARDS ***
beta33: folds 
Gintaras20: folds 
3EBC96: raises $0.20 to $0.30
Mr50centt: calls $0.30
einsftw: folds 
urmeli10: calls $0.20
*** FLOP *** [Jc 7d 7h]
urmeli10: checks 
3EBC96: checks 
Mr50centt: checks 
*** TURN *** [Jc 7d 7h] [2h]
urmeli10: checks 
3EBC96: checks 
Mr50centt: checks 
*** RIVER *** [Jc 7d 7h 2h] [3s]
urmeli10: bets $0.45
3EBC96: folds 
Mr50centt: folds 
Uncalled bet ($0.45) returned to urmeli10
urmeli10 collected $0.91 from pot
urmeli10: doesn't show hand 
*** SUMMARY ***
Total pot $0.95 | Rake $0.04 
Board [Jc 7d 7h 2h 3s]
Seat 1: beta33 folded before Flop (didn't bet)
Seat 2: Gintaras20 folded before Flop (didn't bet)
Seat 3: 3EBC96 folded on the River
Seat 4: Mr50centt (button) folded on the River
Seat 5: einsftw (small blind) folded before Flop
Seat 6: urmeli10 (big blind) collected ($0.91)



PokerStars Hand #222958514125:  Hold'em No Limit ($0.05/$0.10 USD) - 2021/01/23 11:14:25 ET
Table 'Lutetia III' 6-max Seat #5 is the button
Seat 1: beta33 ($19.12 in chips) 
Seat 2: Gintaras20 ($12.99 in chips) 
Seat 4: Mr50centt ($12.68 in chips) 
Seat 5: einsftw ($10 in chips) 
Seat 6: urmeli10 ($7.17 in chips) 
urmeli10: posts small blind $0.05
beta33: posts big blind $0.10
*** HOLE CARDS ***
Gintaras20: raises $0.15 to $0.25
Mr50centt: folds 
einsftw: folds 
urmeli10: calls $0.20
beta33: folds 
*** FLOP *** [Ah Jc 8d]
urmeli10: bets $0.57
Gintaras20: calls $0.57
*** TURN *** [Ah Jc 8d] [2h]
urmeli10: bets $0.83
Gintaras20: calls $0.83
*** RIVER *** [Ah Jc 8d 2h] [Qs]
urmeli10: bets $0.92
Gintaras20: calls $0.92
*** SHOW DOWN ***
urmeli10: shows [Jh Kh] (a pair of Jacks)
Gintaras20: shows [Kd Jd] (a pair of Jacks)
urmeli10 collected $2.50 from pot
Gintaras20 collected $2.50 from pot
*** SUMMARY ***
Total pot $5.24 | Rake $0.24 
Board [Ah Jc 8d 2h Qs]
Seat 1: beta33 (big blind) folded before Flop
Seat 2: Gintaras20 showed [Kd Jd] and won ($2.50) with a pair of Jacks
Seat 4: Mr50centt folded before Flop (didn't bet)
Seat 5: einsftw (button) folded before Flop (didn't bet)
Seat 6: urmeli10 (small blind) showed [Jh Kh] and won ($2.50) with a pair of Jacks



PokerStars Hand #222958549445:  Hold'em No Limit ($0.05/$0.10 USD) - 2021/01/23 11:15:24 ET
Table 'Lutetia III' 6-max Seat #6 is the button
Seat 1: beta33 ($19.02 in chips) 
Seat 2: Gintaras20 ($12.92 in chips) 
Seat 4: Mr50centt ($12.68 in chips) 
Seat 5: einsftw ($10 in chips) 
Seat 6: urmeli10 ($7.10 in chips) 
beta33: posts small blind $0.05
Gintaras20: posts big blind $0.10
*** HOLE CARDS ***
Mr50centt: folds 
einsftw: folds 
urmeli10: calls $0.10
beta33: calls $0.05
Gintaras20: checks 
*** FLOP *** [Jc Ts 8s]
beta33: checks 
Gintaras20: checks 
urmeli10: bets $0.29
beta33: folds 
Gintaras20: folds 
Uncalled bet ($0.29) returned to urmeli10
urmeli10 collected $0.29 from pot
urmeli10: doesn't show hand 
*** SUMMARY ***
Total pot $0.30 | Rake $0.01 
Board [Jc Ts 8s]
Seat 1: beta33 (small blind) folded on the Flop
Seat 2: Gintaras20 (big blind) folded on the Flop
Seat 4: Mr50centt folded before Flop (didn't bet)
Seat 5: einsftw folded before Flop (didn't bet)
Seat 6: urmeli10 (button) collected ($0.29)



PokerStars Hand #222958575062:  Hold'em No Limit ($0.05/$0.10 USD) - 2021/01/23 11:16:06 ET
Table 'Lutetia III' 6-max Seat #1 is the button
Seat 1: beta33 ($18.92 in chips) 
Seat 2: Gintaras20 ($12.82 in chips) 
Seat 3: 3EBC96 ($10 in chips) 
Seat 4: Mr50centt ($12.68 in chips) 
Seat 5: einsftw ($10 in chips) 
Seat 6: urmeli10 ($7.29 in chips) 
Gintaras20: posts small blind $0.05
3EBC96: posts big blind $0.10
*** HOLE CARDS ***
Mr50centt: folds 
einsftw: folds 
urmeli10: calls $0.10
beta33: raises $0.30 to $0.40
Gintaras20: folds 
3EBC96: calls $0.30
urmeli10: calls $0.30
*** FLOP *** [9h 3d Ac]
3EBC96: checks 
urmeli10: checks 
beta33: bets $0.80
3EBC96: folds 
urmeli10: folds 
Uncalled bet ($0.80) returned to beta33
beta33 collected $1.19 from pot
*** SUMMARY ***
Total pot $1.25 | Rake $0.06 
Board [9h 3d Ac]
Seat 1: beta33 (button) collected ($1.19)
Seat 2: Gintaras20 (small blind) folded before Flop
Seat 3: 3EBC96 (big blind) folded on the Flop
Seat 4: Mr50centt folded before Flop (didn't bet)
Seat 5: einsftw folded before Flop (didn't bet)
Seat 6: urmeli10 folded on the Flop



PokerStars Hand #222958595057:  Hold'em No Limit ($0.05/$0.10 USD) - 2021/01/23 11:16:40 ET
Table 'Lutetia III' 6-max Seat #2 is the button
Seat 1: beta33 ($19.71 in chips) 
Seat 2: Gintaras20 ($12.77 in chips) 
Seat 3: 3EBC96 ($10 in chips) 
Seat 4: Mr50centt ($12.68 in chips) 
Seat 5: einsftw ($10 in chips) 
Seat 6: urmeli10 ($6.89 in chips) 
3EBC96: posts small blind $0.05
Mr50centt: posts big blind $0.10
*** HOLE CARDS ***
einsftw: folds 
urmeli10: calls $0.10
beta33: folds 
Gintaras20: folds 
3EBC96: folds 
Mr50centt: checks 
*** FLOP *** [Ah Jd 9c]
Mr50centt: checks 
urmeli10: checks 
*** TURN *** [Ah Jd 9c] [As]
Mr50centt: checks 
urmeli10: checks 
*** RIVER *** [Ah Jd 9c As] [Qh]
Mr50centt: checks 
urmeli10: checks 
*** SHOW DOWN ***
Mr50centt: shows [4s 8h] (a pair of Aces)
urmeli10: shows [4c 3c] (a pair of Aces)
Mr50centt collected $0.12 from pot
urmeli10 collected $0.12 from pot
*** SUMMARY ***
Total pot $0.25 | Rake $0.01 
Board [Ah Jd 9c As Qh]
Seat 1: beta33 folded before Flop (didn't bet)
Seat 2: Gintaras20 (button) folded before Flop (didn't bet)
Seat 3: 3EBC96 (small blind) folded before Flop
Seat 4: Mr50centt (big blind) showed [4s 8h] and won ($0.12) with a pair of Aces
Seat 5: einsftw folded before Flop (didn't bet)
Seat 6: urmeli10 showed [4c 3c] and won ($0.12) with a pair of Aces



PokerStars Hand #222958611361:  Hold'em No Limit ($0.05/$0.10 USD) - 2021/01/23 11:17:07 ET
Table 'Lutetia III' 6-max Seat #3 is the button
Seat 1: beta33 ($19.71 in chips) 
Seat 2: Gintaras20 ($12.77 in chips) 
Seat 3: 3EBC96 ($10 in chips) 
Seat 4: Mr50centt ($12.70 in chips) 
Seat 5: einsftw ($10 in chips) 
Seat 6: urmeli10 ($6.91 in chips) 
Mr50centt: posts small blind $0.05
einsftw: posts big blind $0.10
*** HOLE CARDS ***
urmeli10: calls $0.10
beta33: folds 
Gintaras20: folds 
3EBC96: raises $0.40 to $0.50
Mr50centt: folds 
einsftw: folds 
urmeli10: folds 
Uncalled bet ($0.40) returned to 3EBC96
3EBC96 collected $0.35 from pot
3EBC96: doesn't show hand 
*** SUMMARY ***
Total pot $0.35 | Rake $0 
Seat 1: beta33 folded before Flop (didn't bet)
Seat 2: Gintaras20 folded before Flop (didn't bet)
Seat 3: 3EBC96 (button) collected ($0.35)
Seat 4: Mr50centt (small blind) folded before Flop
Seat 5: einsftw (big blind) folded before Flop
Seat 6: urmeli10 folded before Flop



PokerStars Hand #222958624790:  Hold'em No Limit ($0.05/$0.10 USD) - 2021/01/23 11:17:29 ET
Table 'Lutetia III' 6-max Seat #4 is the button
Seat 1: beta33 ($19.71 in chips) 
Seat 2: Gintaras20 ($12.77 in chips) 
Seat 3: 3EBC96 ($10.25 in chips) 
Seat 4: Mr50centt ($12.65 in chips) 
Seat 5: einsftw ($10 in chips) 
Seat 6: urmeli10 ($6.81 in chips) 
einsftw: posts small blind $0.05
urmeli10: posts big blind $0.10
*** HOLE CARDS ***
beta33: folds 
Gintaras20: raises $0.15 to $0.25
3EBC96: folds 
Mr50centt: folds 
einsftw: folds 
urmeli10: calls $0.15
*** FLOP *** [Ts 9d 6d]
urmeli10: checks 
Gintaras20: bets $0.27
urmeli10: calls $0.27
*** TURN *** [Ts 9d 6d] [Ah]
urmeli10: checks 
Gintaras20: bets $0.52
urmeli10: calls $0.52
*** RIVER *** [Ts 9d 6d Ah] [Td]
urmeli10: checks 
Gintaras20: bets $11.73 and is all-in
urmeli10: folds 
Uncalled bet ($11.73) returned to Gintaras20
Gintaras20 collected $2.03 from pot
Gintaras20: doesn't show hand 
*** SUMMARY ***
Total pot $2.13 | Rake $0.10 
Board [Ts 9d 6d Ah Td]
Seat 1: beta33 folded before Flop (didn't bet)
Seat 2: Gintaras20 collected ($2.03)
Seat 3: 3EBC96 folded before Flop (didn't bet)
Seat 4: Mr50centt (button) folded before Flop (didn't bet)
Seat 5: einsftw (small blind) folded before Flop
Seat 6: urmeli10 (big blind) folded on the River



PokerStars Hand #222958660262:  Hold'em No Limit ($0.05/$0.10 USD) - 2021/01/23 11:18:28 ET
Table 'Lutetia III' 6-max Seat #5 is the button
Seat 1: beta33 ($19.71 in chips) 
Seat 2: Gintaras20 ($13.76 in chips) 
Seat 3: 3EBC96 ($10.25 in chips) 
Seat 4: Mr50centt ($12.65 in chips) 
Seat 5: einsftw ($10 in chips) 
Seat 6: urmeli10 ($5.77 in chips) 
urmeli10: posts small blind $0.05
beta33: posts big blind $0.10
*** HOLE CARDS ***
Gintaras20: folds 
3EBC96: folds 
Mr50centt: folds 
einsftw: folds 
urmeli10: calls $0.05
beta33: raises $0.20 to $0.30
urmeli10: folds 
Uncalled bet ($0.20) returned to beta33
beta33 collected $0.20 from pot
*** SUMMARY ***
Total pot $0.20 | Rake $0 
Seat 1: beta33 (big blind) collected ($0.20)
Seat 2: Gintaras20 folded before Flop (didn't bet)
Seat 3: 3EBC96 folded before Flop (didn't bet)
Seat 4: Mr50centt folded before Flop (didn't bet)
Seat 5: einsftw (button) folded before Flop (didn't bet)
Seat 6: urmeli10 (small blind) folded before Flop



PokerStars Hand #222958670463:  Hold'em No Limit ($0.05/$0.10 USD) - 2021/01/23 11:18:45 ET
Table 'Lutetia III' 6-max Seat #6 is the button
Seat 1: beta33 ($19.81 in chips) 
Seat 2: Gintaras20 ($13.76 in chips) 
Seat 3: 3EBC96 ($10.25 in chips) 
Seat 4: Mr50centt ($12.65 in chips) 
Seat 5: einsftw ($10 in chips) 
Seat 6: urmeli10 ($5.67 in chips) 
beta33: posts small blind $0.05
Gintaras20: posts big blind $0.10
*** HOLE CARDS ***
3EBC96: folds 
Mr50centt: folds 
einsftw: folds 
urmeli10: raises $0.20 to $0.30
beta33: folds 
Gintaras20: folds 
Uncalled bet ($0.20) returned to urmeli10
urmeli10 collected $0.25 from pot
urmeli10: doesn't show hand 
*** SUMMARY ***
Total pot $0.25 | Rake $0 
Seat 1: beta33 (small blind) folded before Flop
Seat 2: Gintaras20 (big blind) folded before Flop
Seat 3: 3EBC96 folded before Flop (didn't bet)
Seat 4: Mr50centt folded before Flop (didn't bet)
Seat 5: einsftw folded before Flop (didn't bet)
Seat 6: urmeli10 (button) collected ($0.25)



PokerStars Hand #222958682521:  Hold'em No Limit ($0.05/$0.10 USD) - 2021/01/23 11:19:05 ET
Table 'Lutetia III' 6-max Seat #1 is the button
Seat 1: beta33 ($19.76 in chips) 
Seat 2: Gintaras20 ($13.66 in chips) 
Seat 3: 3EBC96 ($10.25 in chips) 
Seat 4: Mr50centt ($12.65 in chips) 
Seat 5: einsftw ($10 in chips) 
Seat 6: urmeli10 ($5.82 in chips) 
Gintaras20: posts small blind $0.05
3EBC96: posts big blind $0.10
*** HOLE CARDS ***
Mr50centt: folds 
einsftw: folds 
urmeli10: folds 
beta33: folds 
Gintaras20: raises $0.15 to $0.25
3EBC96: calls $0.15
*** FLOP *** [Tc 2s Ts]
Gintaras20: bets $0.24
3EBC96: folds 
Uncalled bet ($0.24) returned to Gintaras20
Gintaras20 collected $0.48 from pot
Gintaras20: doesn't show hand 
*** SUMMARY ***
Total pot $0.50 | Rake $0.02 
Board [Tc 2s Ts]
Seat 1: beta33 (button) folded before Flop (didn't bet)
Seat 2: Gintaras20 (small blind) collected ($0.48)
Seat 3: 3EBC96 (big blind) folded on the Flop
Seat 4: Mr50centt folded before Flop (didn't bet)
Seat 5: einsftw folded before Flop (didn't bet)
Seat 6: urmeli10 folded before Flop (didn't bet)



PokerStars Hand #222958696208:  Hold'em No Limit ($0.05/$0.10 USD) - 2021/01/23 11:19:28 ET
Table 'Lutetia III' 6-max Seat #2 is the button
Seat 1: beta33 ($19.76 in chips) 
Seat 2: Gintaras20 ($13.89 in chips) 
Seat 3: 3EBC96 ($10 in chips) 
Seat 4: Mr50centt ($12.65 in chips) 
Seat 5: einsftw ($10 in chips) 
Seat 6: urmeli10 ($5.82 in chips) 
3EBC96: posts small blind $0.05
Mr50centt: posts big blind $0.10
*** HOLE CARDS ***
einsftw: folds 
urmeli10: folds 
beta33: folds 
Gintaras20: folds 
3EBC96: raises $0.20 to $0.30
Mr50centt: folds 
Uncalled bet ($0.20) returned to 3EBC96
3EBC96 collected $0.20 from pot
3EBC96: doesn't show hand 
*** SUMMARY ***
Total pot $0.20 | Rake $0 
Seat 1: beta33 folded before Flop (didn't bet)
Seat 2: Gintaras20 (button) folded before Flop (didn't bet)
Seat 3: 3EBC96 (small blind) collected ($0.20)
Seat 4: Mr50centt (big blind) folded before Flop
Seat 5: einsftw folded before Flop (didn't bet)
Seat 6: urmeli10 folded before Flop (didn't bet)



PokerStars Hand #222958705219:  Hold'em No Limit ($0.05/$0.10 USD) - 2021/01/23 11:19:43 ET
Table 'Lutetia III' 6-max Seat #3 is the button
Seat 1: beta33 ($19.76 in chips) 
Seat 2: Gintaras20 ($13.89 in chips) 
Seat 3: 3EBC96 ($10.10 in chips) 
Seat 4: Mr50centt ($12.55 in chips) 
Seat 5: einsftw ($10 in chips) 
Seat 6: urmeli10 ($5.82 in chips) 
Mr50centt: posts small blind $0.05
einsftw: posts big blind $0.10
*** HOLE CARDS ***
urmeli10: folds 
beta33: folds 
Gintaras20: folds 
3EBC96: raises $0.20 to $0.30
Mr50centt: folds 
einsftw: folds 
Uncalled bet ($0.20) returned to 3EBC96
3EBC96 collected $0.25 from pot
3EBC96: doesn't show hand 
*** SUMMARY ***
Total pot $0.25 | Rake $0 
Seat 1: beta33 folded before Flop (didn't bet)
Seat 2: Gintaras20 folded before Flop (didn't bet)
Seat 3: 3EBC96 (button) collected ($0.25)
Seat 4: Mr50centt (small blind) folded before Flop
Seat 5: einsftw (big blind) folded before Flop
Seat 6: urmeli10 folded before Flop (didn't bet)



PokerStars Hand #222958715347:  Hold'em No Limit ($0.05/$0.10 USD) - 2021/01/23 11:19:59 ET
Table 'Lutetia III' 6-max Seat #4 is the button
Seat 1: beta33 ($19.76 in chips) 
Seat 2: Gintaras20 ($13.89 in chips) 
Seat 3: 3EBC96 ($10.25 in chips) 
Seat 4: Mr50centt ($12.50 in chips) 
Seat 5: einsftw ($10 in chips) 
Seat 6: urmeli10 ($5.82 in chips) 
einsftw: posts small blind $0.05
urmeli10: posts big blind $0.10
*** HOLE CARDS ***
beta33: folds 
Gintaras20: folds 
3EBC96: folds 
Mr50centt: raises $0.10 to $0.20
einsftw: folds 
urmeli10: calls $0.10
*** FLOP *** [2s 8d 5s]
urmeli10: bets $0.43
Mr50centt: folds 
Uncalled bet ($0.43) returned to urmeli10
urmeli10 collected $0.43 from pot
urmeli10: doesn't show hand 
*** SUMMARY ***
Total pot $0.45 | Rake $0.02 
Board [2s 8d 5s]
Seat 1: beta33 folded before Flop (didn't bet)
Seat 2: Gintaras20 folded before Flop (didn't bet)
Seat 3: 3EBC96 folded before Flop (didn't bet)
Seat 4: Mr50centt (button) folded on the Flop
Seat 5: einsftw (small blind) folded before Flop
Seat 6: urmeli10 (big blind) collected ($0.43)



PokerStars Hand #222958733261:  Hold'em No Limit ($0.05/$0.10 USD) - 2021/01/23 11:20:29 ET
Table 'Lutetia III' 6-max Seat #5 is the button
Seat 1: beta33 ($19.76 in chips) 
Seat 2: Gintaras20 ($13.89 in chips) 
Seat 3: 3EBC96 ($10.25 in chips) 
Seat 4: Mr50centt ($12.30 in chips) 
Seat 5: einsftw ($10 in chips) 
Seat 6: urmeli10 ($6.05 in chips) 
urmeli10: posts small blind $0.05
beta33: posts big blind $0.10
*** HOLE CARDS ***
Gintaras20: folds 
3EBC96: folds 
Mr50centt: folds 
einsftw: folds 
urmeli10: calls $0.05
beta33: checks 
*** FLOP *** [7h 6s Kc]
urmeli10: bets $0.19
beta33: folds 
Uncalled bet ($0.19) returned to urmeli10
urmeli10 collected $0.19 from pot
urmeli10: doesn't show hand 
*** SUMMARY ***
Total pot $0.20 | Rake $0.01 
Board [7h 6s Kc]
Seat 1: beta33 (big blind) folded on the Flop
Seat 2: Gintaras20 folded before Flop (didn't bet)
Seat 3: 3EBC96 folded before Flop (didn't bet)
Seat 4: Mr50centt folded before Flop (didn't bet)
Seat 5: einsftw (button) folded before Flop (didn't bet)
Seat 6: urmeli10 (small blind) collected ($0.19)



PokerStars Hand #222958757289:  Hold'em No Limit ($0.05/$0.10 USD) - 2021/01/23 11:21:08 ET
Table 'Lutetia III' 6-max Seat #6 is the button
Seat 1: beta33 ($19.66 in chips) 
Seat 2: Gintaras20 ($13.89 in chips) 
Seat 3: 3EBC96 ($10.25 in chips) 
Seat 4: Mr50centt ($12.30 in chips) 
Seat 5: einsftw ($10 in chips) 
Seat 6: urmeli10 ($6.14 in chips) 
beta33: posts small blind $0.05
Gintaras20: posts big blind $0.10
*** HOLE CARDS ***
3EBC96: folds 
Mr50centt: raises $0.10 to $0.20
einsftw: folds 
urmeli10: calls $0.20
beta33: folds 
Gintaras20: folds 
*** FLOP *** [9h Qs 7s]
Mr50centt: checks 
urmeli10: checks 
*** TURN *** [9h Qs 7s] [9d]
Mr50centt: bets $0.40
urmeli10: folds 
Uncalled bet ($0.40) returned to Mr50centt
Mr50centt collected $0.53 from pot
Mr50centt: doesn't show hand 
*** SUMMARY ***
Total pot $0.55 | Rake $0.02 
Board [9h Qs 7s 9d]
Seat 1: beta33 (small blind) folded before Flop
Seat 2: Gintaras20 (big blind) folded before Flop
Seat 3: 3EBC96 folded before Flop (didn't bet)
Seat 4: Mr50centt collected ($0.53)
Seat 5: einsftw folded before Flop (didn't bet)
Seat 6: urmeli10 (button) folded on the Turn



PokerStars Hand #222958774771:  Hold'em No Limit ($0.05/$0.10 USD) - 2021/01/23 11:21:37 ET
Table 'Lutetia III' 6-max Seat #1 is the button
Seat 1: beta33 ($19.61 in chips) 
Seat 2: Gintaras20 ($13.79 in chips) 
Seat 4: Mr50centt ($12.63 in chips) 
Seat 5: einsftw ($10 in chips) 
Seat 6: urmeli10 ($5.94 in chips) 
Gintaras20: posts small blind $0.05
Mr50centt: posts big blind $0.10
*** HOLE CARDS ***
einsftw: raises $0.20 to $0.30
urmeli10: folds 
beta33: calls $0.30
Gintaras20: folds 
Mr50centt: folds 
*** FLOP *** [9d Ts 6c]
einsftw: bets $0.60
beta33: folds 
Uncalled bet ($0.60) returned to einsftw
einsftw collected $0.72 from pot
einsftw: doesn't show hand 
*** SUMMARY ***
Total pot $0.75 | Rake $0.03 
Board [9d Ts 6c]
Seat 1: beta33 (button) folded on the Flop
Seat 2: Gintaras20 (small blind) folded before Flop
Seat 4: Mr50centt (big blind) folded before Flop
Seat 5: einsftw collected ($0.72)
Seat 6: urmeli10 folded before Flop (didn't bet)



PokerStars Hand #222958790924:  Hold'em No Limit ($0.05/$0.10 USD) - 2021/01/23 11:22:04 ET
Table 'Lutetia III' 6-max Seat #2 is the button
Seat 1: beta33 ($19.31 in chips) 
Seat 2: Gintaras20 ($13.74 in chips) 
Seat 4: Mr50centt ($12.53 in chips) 
Seat 5: einsftw ($10.42 in chips) 
Seat 6: urmeli10 ($5.94 in chips) 
Mr50centt: posts small blind $0.05
einsftw: posts big blind $0.10
*** HOLE CARDS ***
urmeli10: calls $0.10
beta33 has timed out
beta33: folds 
Gintaras20: folds 
Mr50centt: calls $0.05
einsftw: checks 
*** FLOP *** [Qs Ac 4h]
Mr50centt: checks 
einsftw: checks 
urmeli10: checks 
*** TURN *** [Qs Ac 4h] [9d]
Mr50centt: checks 
einsftw: checks 
urmeli10: checks 
*** RIVER *** [Qs Ac 4h 9d] [6d]
Mr50centt: checks 
einsftw: checks 
urmeli10: checks 
*** SHOW DOWN ***
Mr50centt: shows [9s Ks] (a pair of Nines)
einsftw: shows [7c Qc] (a pair of Queens)
urmeli10: mucks hand 
einsftw collected $0.29 from pot
*** SUMMARY ***
Total pot $0.30 | Rake $0.01 
Board [Qs Ac 4h 9d 6d]
Seat 1: beta33 folded before Flop (didn't bet)
Seat 2: Gintaras20 (button) folded before Flop (didn't bet)
Seat 4: Mr50centt (small blind) showed [9s Ks] and lost with a pair of Nines
Seat 5: einsftw (big blind) showed [7c Qc] and won ($0.29) with a pair of Queens
Seat 6: urmeli10 mucked



PokerStars Hand #222958813178:  Hold'em No Limit ($0.05/$0.10 USD) - 2021/01/23 11:22:41 ET
Table 'Lutetia III' 6-max Seat #4 is the button
Seat 1: beta33 ($19.31 in chips) 
Seat 2: Gintaras20 ($13.74 in chips) 
Seat 4: Mr50centt ($12.43 in chips) 
Seat 5: einsftw ($10.61 in chips) 
Seat 6: urmeli10 ($5.84 in chips) 
einsftw: posts small blind $0.05
urmeli10: posts big blind $0.10
3EBC96: sits out 
*** HOLE CARDS ***
beta33: folds 
Gintaras20: raises $0.15 to $0.25
Mr50centt: raises $0.55 to $0.80
einsftw: folds 
urmeli10: folds 
Gintaras20: calls $0.55
*** FLOP *** [Td 3c 6h]
Gintaras20: checks 
Mr50centt: bets $0.55
Gintaras20: folds 
Uncalled bet ($0.55) returned to Mr50centt
Mr50centt collected $1.67 from pot
Mr50centt: doesn't show hand 
*** SUMMARY ***
Total pot $1.75 | Rake $0.08 
Board [Td 3c 6h]
Seat 1: beta33 folded before Flop (didn't bet)
Seat 2: Gintaras20 folded on the Flop
Seat 4: Mr50centt (button) collected ($1.67)
Seat 5: einsftw (small blind) folded before Flop
Seat 6: urmeli10 (big blind) folded before Flop



PokerStars Hand #222958833027:  Hold'em No Limit ($0.05/$0.10 USD) - 2021/01/23 11:23:13 ET
Table 'Lutetia III' 6-max Seat #5 is the button
Seat 1: beta33 ($19.31 in chips) 
Seat 2: Gintaras20 ($12.94 in chips) 
Seat 4: Mr50centt ($13.30 in chips) 
Seat 5: einsftw ($10.56 in chips) 
Seat 6: urmeli10 ($5.74 in chips) 
urmeli10: posts small blind $0.05
beta33: posts big blind $0.10
3EBC96: sits out 
*** HOLE CARDS ***
Gintaras20: folds 
Mr50centt: raises $0.15 to $0.25
einsftw: folds 
urmeli10: calls $0.20
beta33: folds 
*** FLOP *** [4c Jh Qh]
urmeli10: bets $0.28
Mr50centt: calls $0.28
*** TURN *** [4c Jh Qh] [3h]
urmeli10: bets $0.55
Mr50centt: calls $0.55
*** RIVER *** [4c Jh Qh 3h] [3d]
urmeli10: bets $1.08
Mr50centt: raises $4.32 to $5.40
urmeli10: folds 
Uncalled bet ($4.32) returned to Mr50centt
Mr50centt collected $4.22 from pot
Mr50centt: doesn't show hand 
*** SUMMARY ***
Total pot $4.42 | Rake $0.20 
Board [4c Jh Qh 3h 3d]
Seat 1: beta33 (big blind) folded before Flop
Seat 2: Gintaras20 folded before Flop (didn't bet)
Seat 4: Mr50centt collected ($4.22)
Seat 5: einsftw (button) folded before Flop (didn't bet)
Seat 6: urmeli10 (small blind) folded on the River



PokerStars Hand #222958869801:  Hold'em No Limit ($0.05/$0.10 USD) - 2021/01/23 11:24:14 ET
Table 'Lutetia III' 6-max Seat #6 is the button
Seat 1: beta33 ($19.21 in chips) 
Seat 2: Gintaras20 ($12.94 in chips) 
Seat 4: Mr50centt ($15.36 in chips) 
Seat 5: einsftw ($10.56 in chips) 
Seat 6: urmeli10 ($3.58 in chips) 
beta33: posts small blind $0.05
Gintaras20: posts big blind $0.10
3EBC96: sits out 
*** HOLE CARDS ***
Mr50centt: raises $0.15 to $0.25
einsftw: folds 
urmeli10: calls $0.25
beta33: folds 
Gintaras20: folds 
*** FLOP *** [Ts 9s As]
Mr50centt: bets $0.20
urmeli10: calls $0.20
*** TURN *** [Ts 9s As] [Jh]
Mr50centt: checks 
urmeli10: checks 
*** RIVER *** [Ts 9s As Jh] [Qs]
Mr50centt: checks 
urmeli10: checks 
*** SHOW DOWN ***
Mr50centt: shows [7s 7c] (a flush, Ace high)
urmeli10: mucks hand 
Mr50centt collected $1 from pot
*** SUMMARY ***
Total pot $1.05 | Rake $0.05 
Board [Ts 9s As Jh Qs]
Seat 1: beta33 (small blind) folded before Flop
Seat 2: Gintaras20 (big blind) folded before Flop
Seat 4: Mr50centt showed [7s 7c] and won ($1) with a flush, Ace high
Seat 5: einsftw folded before Flop (didn't bet)
Seat 6: urmeli10 (button) mucked



PokerStars Hand #222958884310:  Hold'em No Limit ($0.05/$0.10 USD) - 2021/01/23 11:24:37 ET
Table 'Lutetia III' 6-max Seat #1 is the button
Seat 1: beta33 ($19.16 in chips) 
Seat 2: Gintaras20 ($12.84 in chips) 
Seat 3: 3EBC96 ($10.25 in chips) 
Seat 4: Mr50centt ($15.91 in chips) 
Seat 5: einsftw ($10.56 in chips) 
Seat 6: urmeli10 ($3.13 in chips) 
Gintaras20: posts small blind $0.05
3EBC96: posts big blind $0.10
*** HOLE CARDS ***
Mr50centt: folds 
einsftw: folds 
urmeli10: folds 
beta33: raises $0.20 to $0.30
Gintaras20: folds 
3EBC96: folds 
Uncalled bet ($0.20) returned to beta33
beta33 collected $0.25 from pot
*** SUMMARY ***
Total pot $0.25 | Rake $0 
Seat 1: beta33 (button) collected ($0.25)
Seat 2: Gintaras20 (small blind) folded before Flop
Seat 3: 3EBC96 (big blind) folded before Flop
Seat 4: Mr50centt folded before Flop (didn't bet)
Seat 5: einsftw folded before Flop (didn't bet)
Seat 6: urmeli10 folded before Flop (didn't bet)



PokerStars Hand #222958892785:  Hold'em No Limit ($0.05/$0.10 USD) - 2021/01/23 11:24:52 ET
Table 'Lutetia III' 6-max Seat #2 is the button
Seat 1: beta33 ($19.31 in chips) 
Seat 2: Gintaras20 ($12.79 in chips) 
Seat 3: 3EBC96 ($10.15 in chips) 
Seat 4: Mr50centt ($15.91 in chips) 
Seat 5: einsftw ($10.56 in chips) 
Seat 6: urmeli10 ($3.13 in chips) 
3EBC96: posts small blind $0.05
Mr50centt: posts big blind $0.10
*** HOLE CARDS ***
einsftw: folds 
urmeli10: calls $0.10
beta33: folds 
Gintaras20: folds 
3EBC96: folds 
Mr50centt: checks 
*** FLOP *** [Js 6d Qh]
Mr50centt: checks 
urmeli10: bets $0.24
Mr50centt: folds 
Uncalled bet ($0.24) returned to urmeli10
urmeli10 collected $0.24 from pot
urmeli10: doesn't show hand 
*** SUMMARY ***
Total pot $0.25 | Rake $0.01 
Board [Js 6d Qh]
Seat 1: beta33 folded before Flop (didn't bet)
Seat 2: Gintaras20 (button) folded before Flop (didn't bet)
Seat 3: 3EBC96 (small blind) folded before Flop
Seat 4: Mr50centt (big blind) folded on the Flop
Seat 5: einsftw folded before Flop (didn't bet)
Seat 6: urmeli10 collected ($0.24)



PokerStars Hand #222958906370:  Hold'em No Limit ($0.05/$0.10 USD) - 2021/01/23 11:25:14 ET
Table 'Lutetia III' 6-max Seat #3 is the button
Seat 1: beta33 ($19.31 in chips) 
Seat 2: Gintaras20 ($12.79 in chips) 
Seat 3: 3EBC96 ($10.10 in chips) 
Seat 4: Mr50centt ($15.81 in chips) 
Seat 5: einsftw ($10.56 in chips) 
Seat 6: urmeli10 ($3.27 in chips) 
Mr50centt: posts small blind $0.05
einsftw: posts big blind $0.10
*** HOLE CARDS ***
urmeli10: raises $0.20 to $0.30
beta33: folds 
Gintaras20: folds 
3EBC96: folds 
Mr50centt: folds 
einsftw: folds 
Uncalled bet ($0.20) returned to urmeli10
urmeli10 collected $0.25 from pot
urmeli10: doesn't show hand 
*** SUMMARY ***
Total pot $0.25 | Rake $0 
Seat 1: beta33 folded before Flop (didn't bet)
Seat 2: Gintaras20 folded before Flop (didn't bet)
Seat 3: 3EBC96 (button) folded before Flop (didn't bet)
Seat 4: Mr50centt (small blind) folded before Flop
Seat 5: einsftw (big blind) folded before Flop
Seat 6: urmeli10 collected ($0.25)



PokerStars Hand #222958912571:  Hold'em No Limit ($0.05/$0.10 USD) - 2021/01/23 11:25:24 ET
Table 'Lutetia III' 6-max Seat #4 is the button
Seat 1: beta33 ($19.31 in chips) 
Seat 2: Gintaras20 ($12.79 in chips) 
Seat 3: 3EBC96 ($10.10 in chips) 
Seat 4: Mr50centt ($15.76 in chips) 
Seat 5: einsftw ($10.46 in chips) 
Seat 6: urmeli10 ($3.42 in chips) 
einsftw: posts small blind $0.05
urmeli10: posts big blind $0.10
*** HOLE CARDS ***
beta33: folds 
Gintaras20: folds 
3EBC96: folds 
Mr50centt: raises $0.10 to $0.20
einsftw: folds 
urmeli10: calls $0.10
*** FLOP *** [Td Ah 3c]
urmeli10: checks 
Mr50centt: bets $0.14
urmeli10: calls $0.14
*** TURN *** [Td Ah 3c] [7s]
urmeli10: bets $0.70
Mr50centt: folds 
Uncalled bet ($0.70) returned to urmeli10
urmeli10 collected $0.70 from pot
urmeli10: doesn't show hand 
*** SUMMARY ***
Total pot $0.73 | Rake $0.03 
Board [Td Ah 3c 7s]
Seat 1: beta33 folded before Flop (didn't bet)
Seat 2: Gintaras20 folded before Flop (didn't bet)
Seat 3: 3EBC96 folded before Flop (didn't bet)
Seat 4: Mr50centt (button) folded on the Turn
Seat 5: einsftw (small blind) folded before Flop
Seat 6: urmeli10 (big blind) collected ($0.70)



PokerStars Hand #222958929784:  Hold'em No Limit ($0.05/$0.10 USD) - 2021/01/23 11:25:53 ET
Table 'Lutetia III' 6-max Seat #5 is the button
Seat 1: beta33 ($19.31 in chips) 
Seat 2: Gintaras20 ($12.79 in chips) 
Seat 3: 3EBC96 ($10.10 in chips) 
Seat 4: Mr50centt ($15.42 in chips) 
Seat 5: einsftw ($10.41 in chips) 
Seat 6: urmeli10 ($3.78 in chips) 
urmeli10: posts small blind $0.05
beta33: posts big blind $0.10
*** HOLE CARDS ***
Gintaras20: folds 
3EBC96: folds 
Mr50centt: folds 
einsftw: folds 
urmeli10: folds 
Uncalled bet ($0.05) returned to beta33
beta33 collected $0.10 from pot
*** SUMMARY ***
Total pot $0.10 | Rake $0 
Seat 1: beta33 (big blind) collected ($0.10)
Seat 2: Gintaras20 folded before Flop (didn't bet)
Seat 3: 3EBC96 folded before Flop (didn't bet)
Seat 4: Mr50centt folded before Flop (didn't bet)
Seat 5: einsftw (button) folded before Flop (didn't bet)
Seat 6: urmeli10 (small blind) folded before Flop



PokerStars Hand #222958937658:  Hold'em No Limit ($0.05/$0.10 USD) - 2021/01/23 11:26:05 ET
Table 'Lutetia III' 6-max Seat #6 is the button
Seat 1: beta33 ($19.36 in chips) 
Seat 2: Gintaras20 ($12.79 in chips) 
Seat 3: 3EBC96 ($10.10 in chips) 
Seat 4: Mr50centt ($15.42 in chips) 
Seat 5: einsftw ($10.41 in chips) 
Seat 6: urmeli10 ($3.73 in chips) 
beta33: posts small blind $0.05
Gintaras20: posts big blind $0.10
*** HOLE CARDS ***
3EBC96: folds 
Mr50centt: folds 
einsftw: raises $0.20 to $0.30
urmeli10: calls $0.30
beta33: folds 
Gintaras20: calls $0.20
*** FLOP *** [Ah 3c 9d]
Gintaras20: checks 
einsftw: bets $0.70
urmeli10: calls $0.70
Gintaras20: folds 
*** TURN *** [Ah 3c 9d] [7s]
einsftw: bets $1.70
urmeli10: raises $1.03 to $2.73 and is all-in
einsftw: calls $1.03
*** RIVER *** [Ah 3c 9d 7s] [Kc]
*** SHOW DOWN ***
einsftw: shows [7h 9h] (two pair, Nines and Sevens)
urmeli10: shows [Qd As] (a pair of Aces)
einsftw collected $7.46 from pot
*** SUMMARY ***
Total pot $7.81 | Rake $0.35 
Board [Ah 3c 9d 7s Kc]
Seat 1: beta33 (small blind) folded before Flop
Seat 2: Gintaras20 (big blind) folded on the Flop
Seat 3: 3EBC96 folded before Flop (didn't bet)
Seat 4: Mr50centt folded before Flop (didn't bet)
Seat 5: einsftw showed [7h 9h] and won ($7.46) with two pair, Nines and Sevens
Seat 6: urmeli10 (button) showed [Qd As] and lost with a pair of Aces



PokerStars Hand #222958966149:  Hold'em No Limit ($0.05/$0.10 USD) - 2021/01/23 11:26:47 ET
Table 'Lutetia III' 6-max Seat #1 is the button
Seat 1: beta33 ($19.31 in chips) 
Seat 2: Gintaras20 ($12.49 in chips) 
Seat 3: 3EBC96 ($10.10 in chips) 
Seat 4: Mr50centt ($15.42 in chips) 
Seat 5: einsftw ($14.14 in chips) 
Gintaras20: posts small blind $0.05
3EBC96: posts big blind $0.10
*** HOLE CARDS ***
Mr50centt: raises $0.15 to $0.25
einsftw: folds 
beta33: folds 
Gintaras20: folds 
3EBC96: folds 
Uncalled bet ($0.15) returned to Mr50centt
Mr50centt collected $0.25 from pot
Mr50centt: doesn't show hand 
*** SUMMARY ***
Total pot $0.25 | Rake $0 
Seat 1: beta33 (button) folded before Flop (didn't bet)
Seat 2: Gintaras20 (small blind) folded before Flop
Seat 3: 3EBC96 (big blind) folded before Flop
Seat 4: Mr50centt collected ($0.25)
Seat 5: einsftw folded before Flop (didn't bet)



PokerStars Hand #222958973400:  Hold'em No Limit ($0.05/$0.10 USD) - 2021/01/23 11:26:59 ET
Table 'Lutetia III' 6-max Seat #2 is the button
Seat 1: beta33 ($19.31 in chips) 
Seat 2: Gintaras20 ($12.44 in chips) 
Seat 3: 3EBC96 ($10 in chips) 
Seat 4: Mr50centt ($15.57 in chips) 
Seat 5: einsftw ($14.14 in chips) 
Seat 6: urmeli10 ($5.72 in chips) 
3EBC96: posts small blind $0.05
Mr50centt: posts big blind $0.10
*** HOLE CARDS ***
einsftw: folds 
urmeli10: folds 
beta33: folds 
Gintaras20: folds 
3EBC96: folds 
Uncalled bet ($0.05) returned to Mr50centt
Mr50centt collected $0.10 from pot
Mr50centt: doesn't show hand 
*** SUMMARY ***
Total pot $0.10 | Rake $0 
Seat 1: beta33 folded before Flop (didn't bet)
Seat 2: Gintaras20 (button) folded before Flop (didn't bet)
Seat 3: 3EBC96 (small blind) folded before Flop
Seat 4: Mr50centt (big blind) collected ($0.10)
Seat 5: einsftw folded before Flop (didn't bet)
Seat 6: urmeli10 folded before Flop (didn't bet)



PokerStars Hand #222958980873:  Hold'em No Limit ($0.05/$0.10 USD) - 2021/01/23 11:27:11 ET
Table 'Lutetia III' 6-max Seat #3 is the button
Seat 1: beta33 ($19.31 in chips) 
Seat 2: Gintaras20 ($12.44 in chips) 
Seat 3: 3EBC96 ($10 in chips) 
Seat 4: Mr50centt ($15.62 in chips) 
Seat 5: einsftw ($14.14 in chips) 
Seat 6: urmeli10 ($5.72 in chips) 
Mr50centt: posts small blind $0.05
einsftw: posts big blind $0.10
*** HOLE CARDS ***
urmeli10: folds 
beta33: raises $0.20 to $0.30
Gintaras20: calls $0.30
3EBC96: folds 
Mr50centt: folds 
einsftw: folds 
*** FLOP *** [Kh 4s Jh]
beta33: bets $0.50
Gintaras20: folds 
Uncalled bet ($0.50) returned to beta33
beta33 collected $0.72 from pot
*** SUMMARY ***
Total pot $0.75 | Rake $0.03 
Board [Kh 4s Jh]
Seat 1: beta33 collected ($0.72)
Seat 2: Gintaras20 folded on the Flop
Seat 3: 3EBC96 (button) folded before Flop (didn't bet)
Seat 4: Mr50centt (small blind) folded before Flop
Seat 5: einsftw (big blind) folded before Flop
Seat 6: urmeli10 folded before Flop (didn't bet)



PokerStars Hand #222958995484:  Hold'em No Limit ($0.05/$0.10 USD) - 2021/01/23 11:27:35 ET
Table 'Lutetia III' 6-max Seat #4 is the button
Seat 1: beta33 ($19.73 in chips) 
Seat 2: Gintaras20 ($12.14 in chips) 
Seat 3: 3EBC96 ($10 in chips) 
Seat 4: Mr50centt ($15.57 in chips) 
Seat 5: einsftw ($14.04 in chips) 
Seat 6: urmeli10 ($5.72 in chips) 
einsftw: posts small blind $0.05
urmeli10: posts big blind $0.10
*** HOLE CARDS ***
beta33: folds 
Gintaras20: folds 
3EBC96: folds 
Mr50centt: raises $0.10 to $0.20
einsftw: folds 
urmeli10: calls $0.10
*** FLOP *** [2h 7s Ks]
urmeli10: checks 
Mr50centt: bets $0.14
urmeli10: folds 
Uncalled bet ($0.14) returned to Mr50centt
Mr50centt collected $0.43 from pot
Mr50centt: doesn't show hand 
*** SUMMARY ***
Total pot $0.45 | Rake $0.02 
Board [2h 7s Ks]
Seat 1: beta33 folded before Flop (didn't bet)
Seat 2: Gintaras20 folded before Flop (didn't bet)
Seat 3: 3EBC96 folded before Flop (didn't bet)
Seat 4: Mr50centt (button) collected ($0.43)
Seat 5: einsftw (small blind) folded before Flop
Seat 6: urmeli10 (big blind) folded on the Flop



PokerStars Hand #222959011405:  Hold'em No Limit ($0.05/$0.10 USD) - 2021/01/23 11:28:02 ET
Table 'Lutetia III' 6-max Seat #5 is the button
Seat 1: beta33 ($19.73 in chips) 
Seat 2: Gintaras20 ($12.14 in chips) 
Seat 3: 3EBC96 ($10 in chips) 
Seat 4: Mr50centt ($15.80 in chips) 
Seat 5: einsftw ($13.99 in chips) 
Seat 6: urmeli10 ($5.52 in chips) 
urmeli10: posts small blind $0.05
beta33: posts big blind $0.10
*** HOLE CARDS ***
Gintaras20: folds 
3EBC96: folds 
Mr50centt: raises $0.15 to $0.25
einsftw: folds 
urmeli10: raises $0.60 to $0.85
beta33: folds 
Mr50centt: folds 
Uncalled bet ($0.60) returned to urmeli10
urmeli10 collected $0.60 from pot
urmeli10: doesn't show hand 
*** SUMMARY ***
Total pot $0.60 | Rake $0 
Seat 1: beta33 (big blind) folded before Flop
Seat 2: Gintaras20 folded before Flop (didn't bet)
Seat 3: 3EBC96 folded before Flop (didn't bet)
Seat 4: Mr50centt folded before Flop
Seat 5: einsftw (button) folded before Flop (didn't bet)
Seat 6: urmeli10 (small blind) collected ($0.60)



PokerStars Hand #222959022871:  Hold'em No Limit ($0.05/$0.10 USD) - 2021/01/23 11:28:20 ET
Table 'Lutetia III' 6-max Seat #6 is the button
Seat 1: beta33 ($19.63 in chips) 
Seat 2: Gintaras20 ($12.14 in chips) 
Seat 3: 3EBC96 ($10 in chips) 
Seat 4: Mr50centt ($15.55 in chips) 
Seat 5: einsftw ($13.99 in chips) 
Seat 6: urmeli10 ($5.87 in chips) 
beta33: posts small blind $0.05
Gintaras20: posts big blind $0.10
*** HOLE CARDS ***
3EBC96: folds 
Mr50centt: folds 
einsftw: folds 
urmeli10: folds 
beta33: raises $0.20 to $0.30
Gintaras20: calls $0.20
*** FLOP *** [7d Js Ad]
beta33: bets $0.40
Gintaras20: calls $0.40
*** TURN *** [7d Js Ad] [3h]
beta33: checks 
Gintaras20: bets $1.01
beta33: folds 
Uncalled bet ($1.01) returned to Gintaras20
Gintaras20 collected $1.34 from pot
Gintaras20: doesn't show hand 
*** SUMMARY ***
Total pot $1.40 | Rake $0.06 
Board [7d Js Ad 3h]
Seat 1: beta33 (small blind) folded on the Turn
Seat 2: Gintaras20 (big blind) collected ($1.34)
Seat 3: 3EBC96 folded before Flop (didn't bet)
Seat 4: Mr50centt folded before Flop (didn't bet)
Seat 5: einsftw folded before Flop (didn't bet)
Seat 6: urmeli10 (button) folded before Flop (didn't bet)



PokerStars Hand #222959049876:  Hold'em No Limit ($0.05/$0.10 USD) - 2021/01/23 11:29:05 ET
Table 'Lutetia III' 6-max Seat #1 is the button
Seat 1: beta33 ($18.93 in chips) 
Seat 2: Gintaras20 ($12.78 in chips) 
Seat 3: 3EBC96 ($10 in chips) 
Seat 4: Mr50centt ($15.55 in chips) 
Seat 5: einsftw ($13.99 in chips) 
Seat 6: urmeli10 ($5.87 in chips) 
Gintaras20: posts small blind $0.05
3EBC96: posts big blind $0.10
*** HOLE CARDS ***
Mr50centt: folds 
einsftw: folds 
urmeli10: folds 
beta33: folds 
Gintaras20: raises $0.15 to $0.25
3EBC96: folds 
Uncalled bet ($0.15) returned to Gintaras20
Gintaras20 collected $0.20 from pot
Gintaras20: doesn't show hand 
*** SUMMARY ***
Total pot $0.20 | Rake $0 
Seat 1: beta33 (button) folded before Flop (didn't bet)
Seat 2: Gintaras20 (small blind) collected ($0.20)
Seat 3: 3EBC96 (big blind) folded before Flop
Seat 4: Mr50centt folded before Flop (didn't bet)
Seat 5: einsftw folded before Flop (didn't bet)
Seat 6: urmeli10 folded before Flop (didn't bet)



PokerStars Hand #222959056497:  Hold'em No Limit ($0.05/$0.10 USD) - 2021/01/23 11:29:16 ET
Table 'Lutetia III' 6-max Seat #2 is the button
Seat 1: beta33 ($18.93 in chips) 
Seat 2: Gintaras20 ($12.88 in chips) 
Seat 3: 3EBC96 ($10 in chips) 
Seat 4: Mr50centt ($15.55 in chips) 
Seat 5: einsftw ($13.99 in chips) 
Seat 6: urmeli10 ($5.87 in chips) 
3EBC96: posts small blind $0.05
Mr50centt: posts big blind $0.10
*** HOLE CARDS ***
einsftw: folds 
urmeli10: folds 
beta33: folds 
Gintaras20: raises $0.15 to $0.25
3EBC96: folds 
Mr50centt: folds 
Uncalled bet ($0.15) returned to Gintaras20
Gintaras20 collected $0.25 from pot
Gintaras20: doesn't show hand 
*** SUMMARY ***
Total pot $0.25 | Rake $0 
Seat 1: beta33 folded before Flop (didn't bet)
Seat 2: Gintaras20 (button) collected ($0.25)
Seat 3: 3EBC96 (small blind) folded before Flop
Seat 4: Mr50centt (big blind) folded before Flop
Seat 5: einsftw folded before Flop (didn't bet)
Seat 6: urmeli10 folded before Flop (didn't bet)



PokerStars Hand #222959068102:  Hold'em No Limit ($0.05/$0.10 USD) - 2021/01/23 11:29:35 ET
Table 'Lutetia III' 6-max Seat #3 is the button
Seat 1: beta33 ($18.93 in chips) 
Seat 2: Gintaras20 ($13.03 in chips) 
Seat 3: 3EBC96 ($10 in chips) 
Seat 4: Mr50centt ($15.45 in chips) 
Seat 5: einsftw ($13.99 in chips) 
Seat 6: urmeli10 ($5.87 in chips) 
Mr50centt: posts small blind $0.05
einsftw: posts big blind $0.10
*** HOLE CARDS ***
urmeli10: raises $0.10 to $0.20
beta33: folds 
Gintaras20: folds 
3EBC96: folds 
Mr50centt: calls $0.15
einsftw: folds 
*** FLOP *** [2s Jc 3c]
Mr50centt: checks 
urmeli10: bets $0.24
Mr50centt: folds 
Uncalled bet ($0.24) returned to urmeli10
urmeli10 collected $0.48 from pot
urmeli10: doesn't show hand 
*** SUMMARY ***
Total pot $0.50 | Rake $0.02 
Board [2s Jc 3c]
Seat 1: beta33 folded before Flop (didn't bet)
Seat 2: Gintaras20 folded before Flop (didn't bet)
Seat 3: 3EBC96 (button) folded before Flop (didn't bet)
Seat 4: Mr50centt (small blind) folded on the Flop
Seat 5: einsftw (big blind) folded before Flop
Seat 6: urmeli10 collected ($0.48)



PokerStars Hand #222959086588:  Hold'em No Limit ($0.05/$0.10 USD) - 2021/01/23 11:30:03 ET
Table 'Lutetia III' 6-max Seat #4 is the button
Seat 1: beta33 ($18.93 in chips) 
Seat 2: Gintaras20 ($13.03 in chips) 
Seat 3: 3EBC96 ($10 in chips) 
Seat 4: Mr50centt ($15.25 in chips) 
Seat 5: einsftw ($13.89 in chips) 
Seat 6: urmeli10 ($6.15 in chips) 
einsftw: posts small blind $0.05
urmeli10: posts big blind $0.10
*** HOLE CARDS ***
beta33: raises $0.20 to $0.30
Gintaras20: folds 
3EBC96: folds 
Mr50centt: folds 
einsftw: folds 
urmeli10: calls $0.20
*** FLOP *** [3s As Ks]
urmeli10: checks 
beta33: checks 
*** TURN *** [3s As Ks] [2d]
urmeli10: bets $0.31
beta33: calls $0.31
*** RIVER *** [3s As Ks 2d] [Qs]
urmeli10: checks 
beta33: bets $0.80
urmeli10: folds 
Uncalled bet ($0.80) returned to beta33
beta33 collected $1.21 from pot
*** SUMMARY ***
Total pot $1.27 | Rake $0.06 
Board [3s As Ks 2d Qs]
Seat 1: beta33 collected ($1.21)
Seat 2: Gintaras20 folded before Flop (didn't bet)
Seat 3: 3EBC96 folded before Flop (didn't bet)
Seat 4: Mr50centt (button) folded before Flop (didn't bet)
Seat 5: einsftw (small blind) folded before Flop
Seat 6: urmeli10 (big blind) folded on the River



PokerStars Hand #222959115592:  Hold'em No Limit ($0.05/$0.10 USD) - 2021/01/23 11:30:50 ET
Table 'Lutetia III' 6-max Seat #5 is the button
Seat 1: beta33 ($19.53 in chips) 
Seat 2: Gintaras20 ($13.03 in chips) 
Seat 3: 3EBC96 ($10 in chips) 
Seat 4: Mr50centt ($15.25 in chips) 
Seat 5: einsftw ($13.84 in chips) 
Seat 6: urmeli10 ($5.54 in chips) 
urmeli10: posts small blind $0.05
beta33: posts big blind $0.10
*** HOLE CARDS ***
Gintaras20: folds 
3EBC96: folds 
Mr50centt: raises $0.15 to $0.25
einsftw: raises $0.55 to $0.80
urmeli10: folds 
beta33: folds 
Mr50centt: folds 
Uncalled bet ($0.55) returned to einsftw
einsftw collected $0.65 from pot
einsftw: doesn't show hand 
*** SUMMARY ***
Total pot $0.65 | Rake $0 
Seat 1: beta33 (big blind) folded before Flop
Seat 2: Gintaras20 folded before Flop (didn't bet)
Seat 3: 3EBC96 folded before Flop (didn't bet)
Seat 4: Mr50centt folded before Flop
Seat 5: einsftw (button) collected ($0.65)
Seat 6: urmeli10 (small blind) folded before Flop



PokerStars Hand #222959129700:  Hold'em No Limit ($0.05/$0.10 USD) - 2021/01/23 11:31:13 ET
Table 'Lutetia III' 6-max Seat #6 is the button
Seat 1: beta33 ($19.43 in chips) 
Seat 2: Gintaras20 ($13.03 in chips) 
Seat 3: 3EBC96 ($10 in chips) 
Seat 4: Mr50centt ($15 in chips) 
Seat 5: einsftw ($14.24 in chips) 
Seat 6: urmeli10 ($5.49 in chips) 
beta33: posts small blind $0.05
Gintaras20: posts big blind $0.10
*** HOLE CARDS ***
3EBC96: folds 
Mr50centt: raises $0.15 to $0.25
einsftw: folds 
urmeli10: calls $0.25
beta33: calls $0.20
Gintaras20: calls $0.15
*** FLOP *** [Qh 2h 5h]
beta33: checks 
Gintaras20: checks 
Mr50centt: checks 
urmeli10: bets $0.48
beta33: folds 
Gintaras20: folds 
Mr50centt: folds 
Uncalled bet ($0.48) returned to urmeli10
urmeli10 collected $0.96 from pot
urmeli10: doesn't show hand 
*** SUMMARY ***
Total pot $1 | Rake $0.04 
Board [Qh 2h 5h]
Seat 1: beta33 (small blind) folded on the Flop
Seat 2: Gintaras20 (big blind) folded on the Flop
Seat 3: 3EBC96 folded before Flop (didn't bet)
Seat 4: Mr50centt folded on the Flop
Seat 5: einsftw folded before Flop (didn't bet)
Seat 6: urmeli10 (button) collected ($0.96)



PokerStars Hand #222959149212:  Hold'em No Limit ($0.05/$0.10 USD) - 2021/01/23 11:31:44 ET
Table 'Lutetia III' 6-max Seat #1 is the button
Seat 1: beta33 ($19.18 in chips) 
Seat 2: Gintaras20 ($12.78 in chips) 
Seat 4: Mr50centt ($14.75 in chips) 
Seat 5: einsftw ($14.24 in chips) 
Seat 6: urmeli10 ($6.20 in chips) 
Gintaras20: posts small blind $0.05
3EBC96 has timed out
3EBC96: is sitting out 
Mr50centt: posts big blind $0.10
*** HOLE CARDS ***
einsftw: folds 
3EBC96 is disconnected 
urmeli10: folds 
beta33: raises $0.20 to $0.30
Gintaras20: folds 
Mr50centt: folds 
Uncalled bet ($0.20) returned to beta33
beta33 collected $0.25 from pot
*** SUMMARY ***
Total pot $0.25 | Rake $0 
Seat 1: beta33 (button) collected ($0.25)
Seat 2: Gintaras20 (small blind) folded before Flop
Seat 4: Mr50centt (big blind) folded before Flop
Seat 5: einsftw folded before Flop (didn't bet)
Seat 6: urmeli10 folded before Flop (didn't bet)



PokerStars Hand #222959161922:  Hold'em No Limit ($0.05/$0.10 USD) - 2021/01/23 11:32:05 ET
Table 'Lutetia III' 6-max Seat #2 is the button
Seat 1: beta33 ($19.33 in chips) 
Seat 2: Gintaras20 ($12.73 in chips) 
Seat 4: Mr50centt ($14.65 in chips) 
Seat 5: einsftw ($14.24 in chips) 
Seat 6: urmeli10 ($6.20 in chips) 
Mr50centt: posts small blind $0.05
einsftw: posts big blind $0.10
*** HOLE CARDS ***
urmeli10: folds 
beta33: raises $0.20 to $0.30
Gintaras20: folds 
Mr50centt: folds 
einsftw: folds 
Uncalled bet ($0.20) returned to beta33
beta33 collected $0.25 from pot
*** SUMMARY ***
Total pot $0.25 | Rake $0 
Seat 1: beta33 collected ($0.25)
Seat 2: Gintaras20 (button) folded before Flop (didn't bet)
Seat 4: Mr50centt (small blind) folded before Flop
Seat 5: einsftw (big blind) folded before Flop
Seat 6: urmeli10 folded before Flop (didn't bet)



PokerStars Hand #222959168134:  Hold'em No Limit ($0.05/$0.10 USD) - 2021/01/23 11:32:15 ET
Table 'Lutetia III' 6-max Seat #4 is the button
Seat 1: beta33 ($19.48 in chips) 
Seat 2: Gintaras20 ($12.73 in chips) 
Seat 4: Mr50centt ($14.60 in chips) 
Seat 5: einsftw ($14.14 in chips) 
Seat 6: urmeli10 ($6.20 in chips) 
einsftw: posts small blind $0.05
urmeli10: posts big blind $0.10
3EBC96: sits out 
*** HOLE CARDS ***
beta33: folds 
Gintaras20: folds 
Mr50centt: folds 
einsftw: raises $0.12 to $0.22
urmeli10: calls $0.12
*** FLOP *** [3c 3h 2s]
einsftw: bets $0.30
urmeli10: calls $0.30
*** TURN *** [3c 3h 2s] [Qc]
einsftw: bets $0.80
urmeli10: calls $0.80
*** RIVER *** [3c 3h 2s Qc] [3s]
einsftw: bets $1.30
urmeli10: calls $1.30
*** SHOW DOWN ***
einsftw: shows [8h Qs] (a full house, Threes full of Queens)
urmeli10: mucks hand 
einsftw collected $5 from pot
*** SUMMARY ***
Total pot $5.24 | Rake $0.24 
Board [3c 3h 2s Qc 3s]
Seat 1: beta33 folded before Flop (didn't bet)
Seat 2: Gintaras20 folded before Flop (didn't bet)
Seat 4: Mr50centt (button) folded before Flop (didn't bet)
Seat 5: einsftw (small blind) showed [8h Qs] and won ($5) with a full house, Threes full of Queens
Seat 6: urmeli10 (big blind) mucked



PokerStars Hand #222959184224:  Hold'em No Limit ($0.05/$0.10 USD) - 2021/01/23 11:32:41 ET
Table 'Lutetia III' 6-max Seat #5 is the button
Seat 1: beta33 ($19.48 in chips) 
Seat 2: Gintaras20 ($12.73 in chips) 
Seat 4: Mr50centt ($14.60 in chips) 
Seat 5: einsftw ($16.52 in chips) 
Seat 6: urmeli10 ($3.58 in chips) 
urmeli10: posts small blind $0.05
beta33: posts big blind $0.10
3EBC96: sits out 
*** HOLE CARDS ***
Gintaras20: folds 
Mr50centt: folds 
einsftw: raises $0.12 to $0.22
urmeli10: calls $0.17
beta33: folds 
*** FLOP *** [2s 6d Tc]
urmeli10: bets $0.52
einsftw: folds 
Uncalled bet ($0.52) returned to urmeli10
urmeli10 collected $0.52 from pot
urmeli10: doesn't show hand 
*** SUMMARY ***
Total pot $0.54 | Rake $0.02 
Board [2s 6d Tc]
Seat 1: beta33 (big blind) folded before Flop
Seat 2: Gintaras20 folded before Flop (didn't bet)
Seat 4: Mr50centt folded before Flop (didn't bet)
Seat 5: einsftw (button) folded on the Flop
Seat 6: urmeli10 (small blind) collected ($0.52)



PokerStars Hand #222959198951:  Hold'em No Limit ($0.05/$0.10 USD) - 2021/01/23 11:33:05 ET
Table 'Lutetia III' 6-max Seat #6 is the button
Seat 1: beta33 ($19.38 in chips) 
Seat 2: Gintaras20 ($12.73 in chips) 
Seat 4: Mr50centt ($14.60 in chips) 
Seat 5: einsftw ($16.30 in chips) 
Seat 6: urmeli10 ($3.88 in chips) 
beta33: posts small blind $0.05
Gintaras20: posts big blind $0.10
3EBC96: sits out 
*** HOLE CARDS ***
Mr50centt: folds 
einsftw: folds 
urmeli10: calls $0.10
beta33: folds 
Gintaras20: raises $0.50 to $0.60
urmeli10: calls $0.50
*** FLOP *** [2c 7d 4s]
Gintaras20: bets $0.60
urmeli10: calls $0.60
*** TURN *** [2c 7d 4s] [9c]
Gintaras20: bets $1.17
urmeli10: calls $1.17
*** RIVER *** [2c 7d 4s 9c] [3h]
Gintaras20: bets $10.36 and is all-in
urmeli10: calls $1.51 and is all-in
Uncalled bet ($8.85) returned to Gintaras20
*** SHOW DOWN ***
Gintaras20: shows [Js Td] (high card Jack)
urmeli10: shows [8c Jc] (high card Jack - lower kicker)
Gintaras20 collected $7.46 from pot
*** SUMMARY ***
Total pot $7.81 | Rake $0.35 
Board [2c 7d 4s 9c 3h]
Seat 1: beta33 (small blind) folded before Flop
Seat 2: Gintaras20 (big blind) showed [Js Td] and won ($7.46) with high card Jack
Seat 4: Mr50centt folded before Flop (didn't bet)
Seat 5: einsftw folded before Flop (didn't bet)
Seat 6: urmeli10 (button) showed [8c Jc] and lost with high card Jack



PokerStars Hand #222959221300:  Hold'em No Limit ($0.05/$0.10 USD) - 2021/01/23 11:33:41 ET
Table 'Lutetia III' 6-max Seat #1 is the button
Seat 1: beta33 ($19.33 in chips) 
Seat 2: Gintaras20 ($16.31 in chips) 
Seat 3: 3EBC96 ($10 in chips) 
Seat 4: Mr50centt ($14.60 in chips) 
Seat 5: einsftw ($16.30 in chips) 
Gintaras20: posts small blind $0.05
3EBC96: posts big blind $0.10
*** HOLE CARDS ***
urmeli10 leaves the table
Mr50centt: folds 
einsftw: folds 
beta33: raises $0.20 to $0.30
Gintaras20: folds 
Vorontsov28 joins the table at seat #6 
3EBC96: raises $0.70 to $1
beta33: folds 
Uncalled bet ($0.70) returned to 3EBC96
3EBC96 collected $0.65 from pot
3EBC96: doesn't show hand 
*** SUMMARY ***
Total pot $0.65 | Rake $0 
Seat 1: beta33 (button) folded before Flop
Seat 2: Gintaras20 (small blind) folded before Flop
Seat 3: 3EBC96 (big blind) collected ($0.65)
Seat 4: Mr50centt folded before Flop (didn't bet)
Seat 5: einsftw folded before Flop (didn't bet)



PokerStars Hand #222959239784:  Hold'em No Limit ($0.05/$0.10 USD) - 2021/01/23 11:34:11 ET
Table 'Lutetia III' 6-max Seat #2 is the button
Seat 1: beta33 ($19.03 in chips) 
Seat 2: Gintaras20 ($16.26 in chips) 
Seat 3: 3EBC96 ($10.35 in chips) 
Seat 4: Mr50centt ($14.60 in chips) 
Seat 5: einsftw ($16.30 in chips) 
3EBC96: posts small blind $0.05
Mr50centt: posts big blind $0.10
Vorontsov28: sits out 
*** HOLE CARDS ***
einsftw: folds 
beta33: folds 
Gintaras20: folds 
3EBC96: raises $0.20 to $0.30
Mr50centt: folds 
Uncalled bet ($0.20) returned to 3EBC96
3EBC96 collected $0.20 from pot
3EBC96: doesn't show hand 
*** SUMMARY ***
Total pot $0.20 | Rake $0 
Seat 1: beta33 folded before Flop (didn't bet)
Seat 2: Gintaras20 (button) folded before Flop (didn't bet)
Seat 3: 3EBC96 (small blind) collected ($0.20)
Seat 4: Mr50centt (big blind) folded before Flop
Seat 5: einsftw folded before Flop (didn't bet)



PokerStars Hand #222959246665:  Hold'em No Limit ($0.05/$0.10 USD) - 2021/01/23 11:34:22 ET
Table 'Lutetia III' 6-max Seat #3 is the button
Seat 1: beta33 ($19.03 in chips) 
Seat 2: Gintaras20 ($16.26 in chips) 
Seat 3: 3EBC96 ($10.45 in chips) 
Seat 4: Mr50centt ($14.50 in chips) 
Seat 5: einsftw ($16.30 in chips) 
Mr50centt: posts small blind $0.05
einsftw: posts big blind $0.10
Vorontsov28: sits out 
*** HOLE CARDS ***
beta33: raises $0.20 to $0.30
Gintaras20: folds 
3EBC96: raises $0.60 to $0.90
Mr50centt: folds 
einsftw: folds 
beta33: calls $0.60
*** FLOP *** [Ah 6d 6s]
beta33: checks 
3EBC96: bets $0.61
beta33: calls $0.61
*** TURN *** [Ah 6d 6s] [Ad]
beta33: checks 
3EBC96: checks 
*** RIVER *** [Ah 6d 6s Ad] [2h]
beta33: checks 
3EBC96: bets $2
beta33: calls $2
*** SHOW DOWN ***
3EBC96: shows [Qc Jc] (two pair, Aces and Sixes)
beta33: shows [9h 9s] (two pair, Aces and Nines)
beta33 collected $6.85 from pot
*** SUMMARY ***
Total pot $7.17 | Rake $0.32 
Board [Ah 6d 6s Ad 2h]
Seat 1: beta33 showed [9h 9s] and won ($6.85) with two pair, Aces and Nines
Seat 2: Gintaras20 folded before Flop (didn't bet)
Seat 3: 3EBC96 (button) showed [Qc Jc] and lost with two pair, Aces and Sixes
Seat 4: Mr50centt (small blind) folded before Flop
Seat 5: einsftw (big blind) folded before Flop



PokerStars Hand #222959279458:  Hold'em No Limit ($0.05/$0.10 USD) - 2021/01/23 11:35:07 ET
Table 'Lutetia III' 6-max Seat #4 is the button
Seat 1: beta33 ($22.37 in chips) 
Seat 2: Gintaras20 ($16.26 in chips) 
Seat 3: 3EBC96 ($10 in chips) 
Seat 4: Mr50centt ($14.45 in chips) 
Seat 5: einsftw ($16.20 in chips) 
Seat 6: Vorontsov28 ($10 in chips) 
einsftw: posts small blind $0.05
Vorontsov28: posts big blind $0.10
*** HOLE CARDS ***
beta33: folds 
Gintaras20: raises $0.15 to $0.25
3EBC96: raises $0.65 to $0.90
Mr50centt: folds 
einsftw: folds 
Vorontsov28: folds 
Gintaras20: calls $0.65
*** FLOP *** [Ad Ah 5s]
Gintaras20: checks 
3EBC96: bets $0.61
Gintaras20: folds 
Uncalled bet ($0.61) returned to 3EBC96
3EBC96 collected $1.86 from pot
3EBC96: doesn't show hand 
*** SUMMARY ***
Total pot $1.95 | Rake $0.09 
Board [Ad Ah 5s]
Seat 1: beta33 folded before Flop (didn't bet)
Seat 2: Gintaras20 folded on the Flop
Seat 3: 3EBC96 collected ($1.86)
Seat 4: Mr50centt (button) folded before Flop (didn't bet)
Seat 5: einsftw (small blind) folded before Flop
Seat 6: Vorontsov28 (big blind) folded before Flop



PokerStars Hand #222959303569:  Hold'em No Limit ($0.05/$0.10 USD) - 2021/01/23 11:35:46 ET
Table 'Lutetia III' 6-max Seat #5 is the button
Seat 1: beta33 ($22.37 in chips) 
Seat 2: Gintaras20 ($15.36 in chips) 
Seat 3: 3EBC96 ($10.96 in chips) 
Seat 4: Mr50centt ($14.45 in chips) 
Seat 5: einsftw ($16.15 in chips) 
Seat 6: Vorontsov28 ($10 in chips) 
Vorontsov28: posts small blind $0.05
beta33: posts big blind $0.10
*** HOLE CARDS ***
Gintaras20: raises $0.15 to $0.25
3EBC96: folds 
Mr50centt: folds 
einsftw: calls $0.25
Vorontsov28: folds 
beta33: folds 
*** FLOP *** [6d 6s 7s]
Gintaras20: checks 
einsftw: bets $0.40
Gintaras20: calls $0.40
*** TURN *** [6d 6s 7s] [8h]
Gintaras20: checks 
einsftw: checks 
*** RIVER *** [6d 6s 7s 8h] [Tc]
Gintaras20: bets $1.04
einsftw: folds 
Uncalled bet ($1.04) returned to Gintaras20
Gintaras20 collected $1.38 from pot
Gintaras20: doesn't show hand 
*** SUMMARY ***
Total pot $1.45 | Rake $0.07 
Board [6d 6s 7s 8h Tc]
Seat 1: beta33 (big blind) folded before Flop
Seat 2: Gintaras20 collected ($1.38)
Seat 3: 3EBC96 folded before Flop (didn't bet)
Seat 4: Mr50centt folded before Flop (didn't bet)
Seat 5: einsftw (button) folded on the River
Seat 6: Vorontsov28 (small blind) folded before Flop



PokerStars Hand #222959334207:  Hold'em No Limit ($0.05/$0.10 USD) - 2021/01/23 11:36:36 ET
Table 'Lutetia III' 6-max Seat #6 is the button
Seat 1: beta33 ($22.27 in chips) 
Seat 2: Gintaras20 ($16.09 in chips) 
Seat 3: 3EBC96 ($10.96 in chips) 
Seat 4: Mr50centt ($14.45 in chips) 
Seat 5: einsftw ($15.50 in chips) 
Seat 6: Vorontsov28 ($10 in chips) 
beta33: posts small blind $0.05
Gintaras20: posts big blind $0.10
*** HOLE CARDS ***
3EBC96: raises $0.20 to $0.30
Mr50centt: folds 
einsftw: calls $0.30
Vorontsov28: folds 
beta33: folds 
Gintaras20: folds 
*** FLOP *** [3s 8d 4s]
3EBC96: checks 
einsftw: bets $0.50
3EBC96: calls $0.50
*** TURN *** [3s 8d 4s] [2c]
3EBC96: checks 
einsftw: checks 
*** RIVER *** [3s 8d 4s 2c] [2d]
3EBC96: bets $1.25
einsftw: folds 
Uncalled bet ($1.25) returned to 3EBC96
3EBC96 collected $1.67 from pot
3EBC96: doesn't show hand 
*** SUMMARY ***
Total pot $1.75 | Rake $0.08 
Board [3s 8d 4s 2c 2d]
Seat 1: beta33 (small blind) folded before Flop
Seat 2: Gintaras20 (big blind) folded before Flop
Seat 3: 3EBC96 collected ($1.67)
Seat 4: Mr50centt folded before Flop (didn't bet)
Seat 5: einsftw folded on the River
Seat 6: Vorontsov28 (button) folded before Flop (didn't bet)



PokerStars Hand #222959358155:  Hold'em No Limit ($0.05/$0.10 USD) - 2021/01/23 11:37:15 ET
Table 'Lutetia III' 6-max Seat #1 is the button
Seat 1: beta33 ($22.22 in chips) 
Seat 2: Gintaras20 ($15.99 in chips) 
Seat 3: 3EBC96 ($11.83 in chips) 
Seat 4: Mr50centt ($14.45 in chips) 
Seat 5: einsftw ($14.70 in chips) 
Seat 6: Vorontsov28 ($10 in chips) 
Gintaras20: posts small blind $0.05
3EBC96: posts big blind $0.10
*** HOLE CARDS ***
Mr50centt: folds 
einsftw: folds 
Vorontsov28: folds 
beta33: raises $0.20 to $0.30
Gintaras20: folds 
3EBC96: folds 
Uncalled bet ($0.20) returned to beta33
beta33 collected $0.25 from pot
*** SUMMARY ***
Total pot $0.25 | Rake $0 
Seat 1: beta33 (button) collected ($0.25)
Seat 2: Gintaras20 (small blind) folded before Flop
Seat 3: 3EBC96 (big blind) folded before Flop
Seat 4: Mr50centt folded before Flop (didn't bet)
Seat 5: einsftw folded before Flop (didn't bet)
Seat 6: Vorontsov28 folded before Flop (didn't bet)



PokerStars Hand #222959364988:  Hold'em No Limit ($0.05/$0.10 USD) - 2021/01/23 11:37:26 ET
Table 'Lutetia III' 6-max Seat #2 is the button
Seat 1: beta33 ($22.37 in chips) 
Seat 2: Gintaras20 ($15.94 in chips) 
Seat 3: 3EBC96 ($11.73 in chips) 
Seat 4: Mr50centt ($14.45 in chips) 
Seat 5: einsftw ($14.70 in chips) 
Seat 6: Vorontsov28 ($10 in chips) 
3EBC96: posts small blind $0.05
Mr50centt: posts big blind $0.10
*** HOLE CARDS ***
einsftw: folds 
Vorontsov28: folds 
beta33: folds 
Gintaras20: folds 
3EBC96: folds 
Uncalled bet ($0.05) returned to Mr50centt
Mr50centt collected $0.10 from pot
Mr50centt: doesn't show hand 
*** SUMMARY ***
Total pot $0.10 | Rake $0 
Seat 1: beta33 folded before Flop (didn't bet)
Seat 2: Gintaras20 (button) folded before Flop (didn't bet)
Seat 3: 3EBC96 (small blind) folded before Flop
Seat 4: Mr50centt (big blind) collected ($0.10)
Seat 5: einsftw folded before Flop (didn't bet)
Seat 6: Vorontsov28 folded before Flop (didn't bet)



PokerStars Hand #222959368729:  Hold'em No Limit ($0.05/$0.10 USD) - 2021/01/23 11:37:33 ET
Table 'Lutetia III' 6-max Seat #3 is the button
Seat 1: beta33 ($22.37 in chips) 
Seat 2: Gintaras20 ($15.94 in chips) 
Seat 3: 3EBC96 ($11.68 in chips) 
Seat 4: Mr50centt ($14.50 in chips) 
Seat 5: einsftw ($14.70 in chips) 
Seat 6: Vorontsov28 ($10 in chips) 
Mr50centt: posts small blind $0.05
einsftw: posts big blind $0.10
*** HOLE CARDS ***
Vorontsov28: folds 
beta33: folds 
Gintaras20: folds 
3EBC96: raises $0.20 to $0.30
Mr50centt: folds 
einsftw: folds 
Uncalled bet ($0.20) returned to 3EBC96
3EBC96 collected $0.25 from pot
3EBC96: doesn't show hand 
*** SUMMARY ***
Total pot $0.25 | Rake $0 
Seat 1: beta33 folded before Flop (didn't bet)
Seat 2: Gintaras20 folded before Flop (didn't bet)
Seat 3: 3EBC96 (button) collected ($0.25)
Seat 4: Mr50centt (small blind) folded before Flop
Seat 5: einsftw (big blind) folded before Flop
Seat 6: Vorontsov28 folded before Flop (didn't bet)



PokerStars Hand #222959376893:  Hold'em No Limit ($0.05/$0.10 USD) - 2021/01/23 11:37:46 ET
Table 'Lutetia III' 6-max Seat #4 is the button
Seat 1: beta33 ($22.37 in chips) 
Seat 2: Gintaras20 ($15.94 in chips) 
Seat 3: 3EBC96 ($11.83 in chips) 
Seat 4: Mr50centt ($14.45 in chips) 
Seat 5: einsftw ($14.60 in chips) 
Seat 6: Vorontsov28 ($10 in chips) 
einsftw: posts small blind $0.05
Vorontsov28: posts big blind $0.10
*** HOLE CARDS ***
beta33: folds 
Gintaras20: raises $0.15 to $0.25
3EBC96: folds 
Mr50centt: folds 
einsftw: folds 
Vorontsov28: raises $0.75 to $1
Gintaras20: folds 
Uncalled bet ($0.75) returned to Vorontsov28
Vorontsov28 collected $0.55 from pot
Vorontsov28: doesn't show hand 
*** SUMMARY ***
Total pot $0.55 | Rake $0 
Seat 1: beta33 folded before Flop (didn't bet)
Seat 2: Gintaras20 folded before Flop
Seat 3: 3EBC96 folded before Flop (didn't bet)
Seat 4: Mr50centt (button) folded before Flop (didn't bet)
Seat 5: einsftw (small blind) folded before Flop
Seat 6: Vorontsov28 (big blind) collected ($0.55)



PokerStars Hand #222959387555:  Hold'em No Limit ($0.05/$0.10 USD) - 2021/01/23 11:38:03 ET
Table 'Lutetia III' 6-max Seat #5 is the button
Seat 1: beta33 ($22.37 in chips) 
Seat 2: Gintaras20 ($15.69 in chips) 
Seat 3: 3EBC96 ($11.83 in chips) 
Seat 4: Mr50centt ($14.45 in chips) 
Seat 5: einsftw ($14.55 in chips) 
Seat 6: Vorontsov28 ($10.30 in chips) 
Vorontsov28: posts small blind $0.05
beta33: posts big blind $0.10
*** HOLE CARDS ***
Gintaras20: folds 
3EBC96: raises $0.20 to $0.30
Mr50centt: folds 
einsftw: raises $0.60 to $0.90
Vorontsov28: folds 
beta33: folds 
3EBC96: calls $0.60
*** FLOP *** [9s 2s 6h]
3EBC96: checks 
einsftw: bets $1.50
3EBC96: folds 
Uncalled bet ($1.50) returned to einsftw
einsftw collected $1.86 from pot
einsftw: doesn't show hand 
*** SUMMARY ***
Total pot $1.95 | Rake $0.09 
Board [9s 2s 6h]
Seat 1: beta33 (big blind) folded before Flop
Seat 2: Gintaras20 folded before Flop (didn't bet)
Seat 3: 3EBC96 folded on the Flop
Seat 4: Mr50centt folded before Flop (didn't bet)
Seat 5: einsftw (button) collected ($1.86)
Seat 6: Vorontsov28 (small blind) folded before Flop



PokerStars Hand #222959410492:  Hold'em No Limit ($0.05/$0.10 USD) - 2021/01/23 11:38:41 ET
Table 'Lutetia III' 6-max Seat #6 is the button
Seat 1: beta33 ($22.27 in chips) 
Seat 2: Gintaras20 ($15.69 in chips) 
Seat 3: 3EBC96 ($10.93 in chips) 
Seat 4: Mr50centt ($14.45 in chips) 
Seat 5: einsftw ($15.51 in chips) 
Seat 6: Vorontsov28 ($10.25 in chips) 
beta33: posts small blind $0.05
Gintaras20: posts big blind $0.10
*** HOLE CARDS ***
3EBC96: raises $0.20 to $0.30
Mr50centt: folds 
einsftw: folds 
Vorontsov28: folds 
beta33: folds 
Gintaras20: folds 
Uncalled bet ($0.20) returned to 3EBC96
3EBC96 collected $0.25 from pot
3EBC96: doesn't show hand 
*** SUMMARY ***
Total pot $0.25 | Rake $0 
Seat 1: beta33 (small blind) folded before Flop
Seat 2: Gintaras20 (big blind) folded before Flop
Seat 3: 3EBC96 collected ($0.25)
Seat 4: Mr50centt folded before Flop (didn't bet)
Seat 5: einsftw folded before Flop (didn't bet)
Seat 6: Vorontsov28 (button) folded before Flop (didn't bet)



PokerStars Hand #222959421700:  Hold'em No Limit ($0.05/$0.10 USD) - 2021/01/23 11:38:59 ET
Table 'Lutetia III' 6-max Seat #1 is the button
Seat 1: beta33 ($22.22 in chips) 
Seat 2: Gintaras20 ($15.59 in chips) 
Seat 3: 3EBC96 ($11.08 in chips) 
Seat 4: Mr50centt ($14.45 in chips) 
Seat 5: einsftw ($15.51 in chips) 
Seat 6: Vorontsov28 ($10.25 in chips) 
Gintaras20: posts small blind $0.05
3EBC96: posts big blind $0.10
*** HOLE CARDS ***
Mr50centt: folds 
einsftw: raises $0.20 to $0.30
Vorontsov28: folds 
beta33: folds 
Gintaras20: calls $0.25
3EBC96: folds 
*** FLOP *** [4h Tc 4c]
Gintaras20: checks 
einsftw: bets $0.60
Gintaras20: calls $0.60
*** TURN *** [4h Tc 4c] [4d]
Gintaras20: checks 
einsftw: bets $1.40
Gintaras20: calls $1.40
*** RIVER *** [4h Tc 4c 4d] [Js]
Gintaras20: checks 
einsftw: checks 
*** SHOW DOWN ***
Gintaras20: shows [7h 7c] (a full house, Fours full of Sevens)
einsftw: shows [8c 8h] (a full house, Fours full of Eights)
einsftw collected $4.49 from pot
*** SUMMARY ***
Total pot $4.70 | Rake $0.21 
Board [4h Tc 4c 4d Js]
Seat 1: beta33 (button) folded before Flop (didn't bet)
Seat 2: Gintaras20 (small blind) showed [7h 7c] and lost with a full house, Fours full of Sevens
Seat 3: 3EBC96 (big blind) folded before Flop
Seat 4: Mr50centt folded before Flop (didn't bet)
Seat 5: einsftw showed [8c 8h] and won ($4.49) with a full house, Fours full of Eights
Seat 6: Vorontsov28 folded before Flop (didn't bet)



PokerStars Hand #222959442378:  Hold'em No Limit ($0.05/$0.10 USD) - 2021/01/23 11:39:33 ET
Table 'Lutetia III' 6-max Seat #2 is the button
Seat 1: beta33 ($22.22 in chips) 
Seat 2: Gintaras20 ($13.29 in chips) 
Seat 3: 3EBC96 ($10.98 in chips) 
Seat 4: Mr50centt ($14.45 in chips) 
Seat 5: einsftw ($17.70 in chips) 
Seat 6: Vorontsov28 ($10.25 in chips) 
3EBC96: posts small blind $0.05
Mr50centt: posts big blind $0.10
*** HOLE CARDS ***
einsftw: folds 
Vorontsov28: folds 
beta33: folds 
Gintaras20: folds 
3EBC96: folds 
Uncalled bet ($0.05) returned to Mr50centt
Mr50centt collected $0.10 from pot
Mr50centt: doesn't show hand 
*** SUMMARY ***
Total pot $0.10 | Rake $0 
Seat 1: beta33 folded before Flop (didn't bet)
Seat 2: Gintaras20 (button) folded before Flop (didn't bet)
Seat 3: 3EBC96 (small blind) folded before Flop
Seat 4: Mr50centt (big blind) collected ($0.10)
Seat 5: einsftw folded before Flop (didn't bet)
Seat 6: Vorontsov28 folded before Flop (didn't bet)



PokerStars Hand #222959448979:  Hold'em No Limit ($0.05/$0.10 USD) - 2021/01/23 11:39:44 ET
Table 'Lutetia III' 6-max Seat #3 is the button
Seat 1: beta33 ($22.22 in chips) 
Seat 2: Gintaras20 ($13.29 in chips) 
Seat 3: 3EBC96 ($10.93 in chips) 
Seat 4: Mr50centt ($14.50 in chips) 
Seat 5: einsftw ($17.70 in chips) 
Seat 6: Vorontsov28 ($10.25 in chips) 
Mr50centt: posts small blind $0.05
einsftw: posts big blind $0.10
*** HOLE CARDS ***
Vorontsov28: folds 
beta33: folds 
Gintaras20: raises $0.15 to $0.25
3EBC96: folds 
Mr50centt: folds 
einsftw: folds 
Uncalled bet ($0.15) returned to Gintaras20
Gintaras20 collected $0.25 from pot
Gintaras20: doesn't show hand 
*** SUMMARY ***
Total pot $0.25 | Rake $0 
Seat 1: beta33 folded before Flop (didn't bet)
Seat 2: Gintaras20 collected ($0.25)
Seat 3: 3EBC96 (button) folded before Flop (didn't bet)
Seat 4: Mr50centt (small blind) folded before Flop
Seat 5: einsftw (big blind) folded before Flop
Seat 6: Vorontsov28 folded before Flop (didn't bet)



PokerStars Hand #222959457847:  Hold'em No Limit ($0.05/$0.10 USD) - 2021/01/23 11:39:58 ET
Table 'Lutetia III' 6-max Seat #4 is the button
Seat 1: beta33 ($22.22 in chips) 
Seat 2: Gintaras20 ($13.44 in chips) 
Seat 3: 3EBC96 ($10.93 in chips) 
Seat 4: Mr50centt ($14.45 in chips) 
Seat 5: einsftw ($17.60 in chips) 
einsftw: posts small blind $0.05
Vorontsov28: is sitting out 
beta33: posts big blind $0.10
*** HOLE CARDS ***
Vorontsov28 leaves the table
Gintaras20: folds 
3EBC96: folds 
Mr50centt: raises $0.10 to $0.20
einsftw: raises $0.50 to $0.70
beta33: folds 
Mr50centt: raises $1.80 to $2.50
einsftw: folds 
Uncalled bet ($1.80) returned to Mr50centt
Mr50centt collected $1.50 from pot
Mr50centt: doesn't show hand 
*** SUMMARY ***
Total pot $1.50 | Rake $0 
Seat 1: beta33 (big blind) folded before Flop
Seat 2: Gintaras20 folded before Flop (didn't bet)
Seat 3: 3EBC96 folded before Flop (didn't bet)
Seat 4: Mr50centt (button) collected ($1.50)
Seat 5: einsftw (small blind) folded before Flop



PokerStars Hand #222959476220:  Hold'em No Limit ($0.05/$0.10 USD) - 2021/01/23 11:40:28 ET
Table 'Lutetia III' 6-max Seat #5 is the button
Seat 1: beta33 ($22.12 in chips) 
Seat 2: Gintaras20 ($13.44 in chips) 
Seat 3: 3EBC96 ($10.93 in chips) 
Seat 4: Mr50centt ($15.25 in chips) 
Seat 5: einsftw ($16.90 in chips) 
beta33: posts small blind $0.05
Gintaras20: posts big blind $0.10
*** HOLE CARDS ***
3EBC96: folds 
Mr50centt: folds 
einsftw: folds 
beta33: folds 
Uncalled bet ($0.05) returned to Gintaras20
Gintaras20 collected $0.10 from pot
Gintaras20: doesn't show hand 
*** SUMMARY ***
Total pot $0.10 | Rake $0 
Seat 1: beta33 (small blind) folded before Flop
Seat 2: Gintaras20 (big blind) collected ($0.10)
Seat 3: 3EBC96 folded before Flop (didn't bet)
Seat 4: Mr50centt folded before Flop (didn't bet)
Seat 5: einsftw (button) folded before Flop (didn't bet)



PokerStars Hand #222959482085:  Hold'em No Limit ($0.05/$0.10 USD) - 2021/01/23 11:40:38 ET
Table 'Lutetia III' 6-max Seat #1 is the button
Seat 1: beta33 ($22.07 in chips) 
Seat 2: Gintaras20 ($13.49 in chips) 
Seat 3: 3EBC96 ($10.93 in chips) 
Seat 4: Mr50centt ($15.25 in chips) 
Seat 5: einsftw ($16.90 in chips) 
Gintaras20: posts small blind $0.05
3EBC96: posts big blind $0.10
*** HOLE CARDS ***
hinanai0032 joins the table at seat #6 
Mr50centt: folds 
einsftw: folds 
beta33: raises $0.20 to $0.30
Gintaras20: folds 
3EBC96: folds 
Uncalled bet ($0.20) returned to beta33
beta33 collected $0.25 from pot
*** SUMMARY ***
Total pot $0.25 | Rake $0 
Seat 1: beta33 (button) collected ($0.25)
Seat 2: Gintaras20 (small blind) folded before Flop
Seat 3: 3EBC96 (big blind) folded before Flop
Seat 4: Mr50centt folded before Flop (didn't bet)
Seat 5: einsftw folded before Flop (didn't bet)



PokerStars Hand #222959488983:  Hold'em No Limit ($0.05/$0.10 USD) - 2021/01/23 11:40:49 ET
Table 'Lutetia III' 6-max Seat #2 is the button
Seat 1: beta33 ($22.22 in chips) 
Seat 2: Gintaras20 ($13.44 in chips) 
Seat 3: 3EBC96 ($10.83 in chips) 
Seat 4: Mr50centt ($15.25 in chips) 
Seat 5: einsftw ($16.90 in chips) 
3EBC96: posts small blind $0.05
Mr50centt: posts big blind $0.10
hinanai0032: sits out 
*** HOLE CARDS ***
einsftw: folds 
beta33: folds 
Gintaras20: raises $0.15 to $0.25
3EBC96: folds 
Mr50centt: folds 
Uncalled bet ($0.15) returned to Gintaras20
Gintaras20 collected $0.25 from pot
Gintaras20: doesn't show hand 
*** SUMMARY ***
Total pot $0.25 | Rake $0 
Seat 1: beta33 folded before Flop (didn't bet)
Seat 2: Gintaras20 (button) collected ($0.25)
Seat 3: 3EBC96 (small blind) folded before Flop
Seat 4: Mr50centt (big blind) folded before Flop
Seat 5: einsftw folded before Flop (didn't bet)



PokerStars Hand #222959497033:  Hold'em No Limit ($0.05/$0.10 USD) - 2021/01/23 11:41:02 ET
Table 'Lutetia III' 6-max Seat #3 is the button
Seat 1: beta33 ($22.22 in chips) 
Seat 2: Gintaras20 ($13.59 in chips) 
Seat 3: 3EBC96 ($10.78 in chips) 
Seat 4: Mr50centt ($15.15 in chips) 
Seat 5: einsftw ($16.90 in chips) 
Seat 6: hinanai0032 ($5.16 in chips) 
Mr50centt: posts small blind $0.05
einsftw: posts big blind $0.10
hinanai0032: posts big blind $0.10
*** HOLE CARDS ***
hinanai0032: checks 
beta33: raises $0.40 to $0.50
Gintaras20: calls $0.50
3EBC96: calls $0.50
Mr50centt: folds 
einsftw: calls $0.40
hinanai0032: folds 
*** FLOP *** [Jd Td 4c]
einsftw: checks 
beta33: checks 
Gintaras20: checks 
3EBC96: checks 
*** TURN *** [Jd Td 4c] [As]
einsftw: checks 
beta33: checks 
Gintaras20: checks 
3EBC96: checks 
*** RIVER *** [Jd Td 4c As] [2s]
einsftw: checks 
beta33: checks 
Gintaras20: checks 
3EBC96: checks 
*** SHOW DOWN ***
einsftw: shows [5c Ac] (a pair of Aces)
beta33: mucks hand 
Gintaras20: mucks hand 
3EBC96: mucks hand 
einsftw collected $2.05 from pot
*** SUMMARY ***
Total pot $2.15 | Rake $0.10 
Board [Jd Td 4c As 2s]
Seat 1: beta33 mucked
Seat 2: Gintaras20 mucked
Seat 3: 3EBC96 (button) mucked
Seat 4: Mr50centt (small blind) folded before Flop
Seat 5: einsftw (big blind) showed [5c Ac] and won ($2.05) with a pair of Aces
Seat 6: hinanai0032 folded before Flop (didn't bet)



PokerStars Hand #222959526772:  Hold'em No Limit ($0.05/$0.10 USD) - 2021/01/23 11:41:50 ET
Table 'Lutetia III' 6-max Seat #4 is the button
Seat 1: beta33 ($21.72 in chips) 
Seat 2: Gintaras20 ($13.09 in chips) 
Seat 3: 3EBC96 ($10.28 in chips) 
Seat 4: Mr50centt ($15.10 in chips) 
Seat 5: einsftw ($18.45 in chips) 
Seat 6: hinanai0032 ($5.06 in chips) 
einsftw: posts small blind $0.05
hinanai0032: posts big blind $0.10
*** HOLE CARDS ***
beta33: raises $0.20 to $0.30
Gintaras20: folds 
3EBC96: folds 
Mr50centt: calls $0.30
einsftw: folds 
hinanai0032: raises $0.40 to $0.70
beta33: calls $0.40
Mr50centt: folds 
*** FLOP *** [7h 9s 3c]
hinanai0032: checks 
beta33: checks 
*** TURN *** [7h 9s 3c] [9d]
hinanai0032: checks 
beta33: checks 
*** RIVER *** [7h 9s 3c 9d] [Qs]
hinanai0032: checks 
beta33: checks 
*** SHOW DOWN ***
hinanai0032: shows [Kc Jc] (a pair of Nines)
beta33: shows [Ks Jh] (a pair of Nines)
hinanai0032 collected $0.84 from pot
beta33 collected $0.83 from pot
*** SUMMARY ***
Total pot $1.75 | Rake $0.08 
Board [7h 9s 3c 9d Qs]
Seat 1: beta33 showed [Ks Jh] and won ($0.83) with a pair of Nines
Seat 2: Gintaras20 folded before Flop (didn't bet)
Seat 3: 3EBC96 folded before Flop (didn't bet)
Seat 4: Mr50centt (button) folded before Flop
Seat 5: einsftw (small blind) folded before Flop
Seat 6: hinanai0032 (big blind) showed [Kc Jc] and won ($0.84) with a pair of Nines



PokerStars Hand #222959563159:  Hold'em No Limit ($0.05/$0.10 USD) - 2021/01/23 11:42:49 ET
Table 'Lutetia III' 6-max Seat #5 is the button
Seat 1: beta33 ($21.85 in chips) 
Seat 2: Gintaras20 ($13.09 in chips) 
Seat 3: 3EBC96 ($10.28 in chips) 
Seat 4: Mr50centt ($14.80 in chips) 
Seat 5: einsftw ($18.40 in chips) 
Seat 6: hinanai0032 ($5.20 in chips) 
hinanai0032: posts small blind $0.05
beta33: posts big blind $0.10
*** HOLE CARDS ***
Gintaras20: folds 
3EBC96: folds 
Mr50centt: folds 
einsftw: raises $0.12 to $0.22
hinanai0032: folds 
beta33: folds 
Uncalled bet ($0.12) returned to einsftw
einsftw collected $0.25 from pot
einsftw: doesn't show hand 
*** SUMMARY ***
Total pot $0.25 | Rake $0 
Seat 1: beta33 (big blind) folded before Flop
Seat 2: Gintaras20 folded before Flop (didn't bet)
Seat 3: 3EBC96 folded before Flop (didn't bet)
Seat 4: Mr50centt folded before Flop (didn't bet)
Seat 5: einsftw (button) collected ($0.25)
Seat 6: hinanai0032 (small blind) folded before Flop



PokerStars Hand #222959571575:  Hold'em No Limit ($0.05/$0.10 USD) - 2021/01/23 11:43:03 ET
Table 'Lutetia III' 6-max Seat #6 is the button
Seat 1: beta33 ($21.75 in chips) 
Seat 2: Gintaras20 ($13.09 in chips) 
Seat 3: 3EBC96 ($10.28 in chips) 
Seat 4: Mr50centt ($14.80 in chips) 
Seat 5: einsftw ($18.55 in chips) 
Seat 6: hinanai0032 ($5.15 in chips) 
beta33: posts small blind $0.05
Gintaras20: posts big blind $0.10
*** HOLE CARDS ***
3EBC96: folds 
Mr50centt: folds 
einsftw: folds 
hinanai0032: raises $0.20 to $0.30
beta33: folds 
Gintaras20: folds 
Uncalled bet ($0.20) returned to hinanai0032
hinanai0032 collected $0.25 from pot
hinanai0032: doesn't show hand 
*** SUMMARY ***
Total pot $0.25 | Rake $0 
Seat 1: beta33 (small blind) folded before Flop
Seat 2: Gintaras20 (big blind) folded before Flop
Seat 3: 3EBC96 folded before Flop (didn't bet)
Seat 4: Mr50centt folded before Flop (didn't bet)
Seat 5: einsftw folded before Flop (didn't bet)
Seat 6: hinanai0032 (button) collected ($0.25)



PokerStars Hand #222959580588:  Hold'em No Limit ($0.05/$0.10 USD) - 2021/01/23 11:43:18 ET
Table 'Lutetia III' 6-max Seat #1 is the button
Seat 1: beta33 ($21.70 in chips) 
Seat 2: Gintaras20 ($12.99 in chips) 
Seat 3: 3EBC96 ($10.28 in chips) 
Seat 4: Mr50centt ($14.80 in chips) 
Seat 5: einsftw ($18.55 in chips) 
Seat 6: hinanai0032 ($5.30 in chips) 
Gintaras20: posts small blind $0.05
3EBC96: posts big blind $0.10
*** HOLE CARDS ***
Mr50centt: folds 
einsftw: folds 
hinanai0032: folds 
beta33: raises $0.20 to $0.30
Gintaras20: calls $0.25
3EBC96: calls $0.20
*** FLOP *** [6d 8c 3d]
Gintaras20: checks 
3EBC96: checks 
beta33: bets $0.70
Gintaras20: calls $0.70
3EBC96: folds 
*** TURN *** [6d 8c 3d] [7d]
Gintaras20: checks 
beta33: checks 
*** RIVER *** [6d 8c 3d 7d] [Kd]
Gintaras20: checks 
beta33: checks 
*** SHOW DOWN ***
Gintaras20: shows [Ah 6h] (a pair of Sixes)
beta33: shows [Ks 7c] (two pair, Kings and Sevens)
beta33 collected $2.20 from pot
*** SUMMARY ***
Total pot $2.30 | Rake $0.10 
Board [6d 8c 3d 7d Kd]
Seat 1: beta33 (button) showed [Ks 7c] and won ($2.20) with two pair, Kings and Sevens
Seat 2: Gintaras20 (small blind) showed [Ah 6h] and lost with a pair of Sixes
Seat 3: 3EBC96 (big blind) folded on the Flop
Seat 4: Mr50centt folded before Flop (didn't bet)
Seat 5: einsftw folded before Flop (didn't bet)
Seat 6: hinanai0032 folded before Flop (didn't bet)



PokerStars Hand #222959602446:  Hold'em No Limit ($0.05/$0.10 USD) - 2021/01/23 11:43:53 ET
Table 'Lutetia III' 6-max Seat #2 is the button
Seat 1: beta33 ($22.90 in chips) 
Seat 2: Gintaras20 ($11.99 in chips) 
Seat 3: 3EBC96 ($10 in chips) 
Seat 4: Mr50centt ($14.80 in chips) 
Seat 5: einsftw ($18.55 in chips) 
Seat 6: hinanai0032 ($5.30 in chips) 
3EBC96: posts small blind $0.05
Mr50centt: posts big blind $0.10
*** HOLE CARDS ***
einsftw: folds 
hinanai0032: raises $0.20 to $0.30
beta33: folds 
Gintaras20: folds 
3EBC96: folds 
Mr50centt: folds 
Uncalled bet ($0.20) returned to hinanai0032
hinanai0032 collected $0.25 from pot
hinanai0032: doesn't show hand 
*** SUMMARY ***
Total pot $0.25 | Rake $0 
Seat 1: beta33 folded before Flop (didn't bet)
Seat 2: Gintaras20 (button) folded before Flop (didn't bet)
Seat 3: 3EBC96 (small blind) folded before Flop
Seat 4: Mr50centt (big blind) folded before Flop
Seat 5: einsftw folded before Flop (didn't bet)
Seat 6: hinanai0032 collected ($0.25)



PokerStars Hand #222959608734:  Hold'em No Limit ($0.05/$0.10 USD) - 2021/01/23 11:44:03 ET
Table 'Lutetia III' 6-max Seat #3 is the button
Seat 1: beta33 ($22.90 in chips) 
Seat 2: Gintaras20 ($11.99 in chips) 
Seat 3: 3EBC96 ($10 in chips) 
Seat 4: Mr50centt ($14.70 in chips) 
Seat 5: einsftw ($18.55 in chips) 
Seat 6: hinanai0032 ($5.45 in chips) 
Mr50centt: posts small blind $0.05
einsftw: posts big blind $0.10
*** HOLE CARDS ***
hinanai0032: folds 
beta33: folds 
Gintaras20: raises $0.15 to $0.25
3EBC96: folds 
Mr50centt: folds 
einsftw: folds 
Uncalled bet ($0.15) returned to Gintaras20
Gintaras20 collected $0.25 from pot
Gintaras20: doesn't show hand 
*** SUMMARY ***
Total pot $0.25 | Rake $0 
Seat 1: beta33 folded before Flop (didn't bet)
Seat 2: Gintaras20 collected ($0.25)
Seat 3: 3EBC96 (button) folded before Flop (didn't bet)
Seat 4: Mr50centt (small blind) folded before Flop
Seat 5: einsftw (big blind) folded before Flop
Seat 6: hinanai0032 folded before Flop (didn't bet)



PokerStars Hand #222959617248:  Hold'em No Limit ($0.05/$0.10 USD) - 2021/01/23 11:44:17 ET
Table 'Lutetia III' 6-max Seat #4 is the button
Seat 1: beta33 ($22.90 in chips) 
Seat 2: Gintaras20 ($12.14 in chips) 
Seat 3: 3EBC96 ($10 in chips) 
Seat 4: Mr50centt ($14.65 in chips) 
Seat 5: einsftw ($18.45 in chips) 
Seat 6: hinanai0032 ($5.45 in chips) 
einsftw: posts small blind $0.05
hinanai0032: posts big blind $0.10
*** HOLE CARDS ***
beta33: folds 
Gintaras20: raises $0.15 to $0.25
3EBC96: folds 
Mr50centt: folds 
einsftw: folds 
hinanai0032: raises $0.15 to $0.40
Gintaras20: raises $0.60 to $1
hinanai0032: calls $0.60
*** FLOP *** [6h Kh 8s]
hinanai0032: bets $0.40
Gintaras20: raises $1.30 to $1.70
hinanai0032: calls $1.30
*** TURN *** [6h Kh 8s] [5h]
hinanai0032: bets $0.40
Gintaras20: calls $0.40
*** RIVER *** [6h Kh 8s 5h] [8c]
hinanai0032: bets $0.60
Gintaras20: raises $8.44 to $9.04 and is all-in
hinanai0032: calls $1.75 and is all-in
Uncalled bet ($6.69) returned to Gintaras20
*** SHOW DOWN ***
Gintaras20: shows [Th Ac] (a pair of Eights)
hinanai0032: shows [9s Ks] (two pair, Kings and Eights)
hinanai0032 collected $10.46 from pot
*** SUMMARY ***
Total pot $10.95 | Rake $0.49 
Board [6h Kh 8s 5h 8c]
Seat 1: beta33 folded before Flop (didn't bet)
Seat 2: Gintaras20 showed [Th Ac] and lost with a pair of Eights
Seat 3: 3EBC96 folded before Flop (didn't bet)
Seat 4: Mr50centt (button) folded before Flop (didn't bet)
Seat 5: einsftw (small blind) folded before Flop
Seat 6: hinanai0032 (big blind) showed [9s Ks] and won ($10.46) with two pair, Kings and Eights



PokerStars Hand #222959656914:  Hold'em No Limit ($0.05/$0.10 USD) - 2021/01/23 11:45:21 ET
Table 'Lutetia III' 6-max Seat #5 is the button
Seat 1: beta33 ($22.90 in chips) 
Seat 2: Gintaras20 ($6.69 in chips) 
Seat 3: 3EBC96 ($10 in chips) 
Seat 4: Mr50centt ($14.65 in chips) 
Seat 5: einsftw ($18.40 in chips) 
Seat 6: hinanai0032 ($10.46 in chips) 
hinanai0032: posts small blind $0.05
beta33: posts big blind $0.10
*** HOLE CARDS ***
Gintaras20: folds 
3EBC96: folds 
Mr50centt: folds 
einsftw: folds 
hinanai0032: raises $0.20 to $0.30
beta33: folds 
Uncalled bet ($0.20) returned to hinanai0032
hinanai0032 collected $0.20 from pot
hinanai0032: doesn't show hand 
*** SUMMARY ***
Total pot $0.20 | Rake $0 
Seat 1: beta33 (big blind) folded before Flop
Seat 2: Gintaras20 folded before Flop (didn't bet)
Seat 3: 3EBC96 folded before Flop (didn't bet)
Seat 4: Mr50centt folded before Flop (didn't bet)
Seat 5: einsftw (button) folded before Flop (didn't bet)
Seat 6: hinanai0032 (small blind) collected ($0.20)



PokerStars Hand #222959666111:  Hold'em No Limit ($0.05/$0.10 USD) - 2021/01/23 11:45:36 ET
Table 'Lutetia III' 6-max Seat #6 is the button
Seat 1: beta33 ($22.80 in chips) 
Seat 2: Gintaras20 ($6.69 in chips) 
Seat 3: 3EBC96 ($10 in chips) 
Seat 4: Mr50centt ($14.65 in chips) 
Seat 5: einsftw ($18.40 in chips) 
Seat 6: hinanai0032 ($10.56 in chips) 
beta33: posts small blind $0.05
Gintaras20: posts big blind $0.10
*** HOLE CARDS ***
3EBC96: raises $0.20 to $0.30
Mr50centt: folds 
einsftw: folds 
hinanai0032: raises $0.20 to $0.50
beta33: calls $0.45
Gintaras20: folds 
3EBC96: calls $0.20
*** FLOP *** [3d Jd 7h]
beta33: checks 
3EBC96: checks 
hinanai0032: checks 
*** TURN *** [3d Jd 7h] [Ac]
beta33: checks 
3EBC96: checks 
hinanai0032: bets $0.76
beta33: calls $0.76
3EBC96: calls $0.76
*** RIVER *** [3d Jd 7h Ac] [3s]
beta33: checks 
3EBC96: checks 
hinanai0032: bets $1.20
beta33: folds 
3EBC96: calls $1.20
*** SHOW DOWN ***
hinanai0032: shows [Qh Ad] (two pair, Aces and Threes)
3EBC96: mucks hand 
hinanai0032 collected $6 from pot
*** SUMMARY ***
Total pot $6.28 | Rake $0.28 
Board [3d Jd 7h Ac 3s]
Seat 1: beta33 (small blind) folded on the River
Seat 2: Gintaras20 (big blind) folded before Flop
Seat 3: 3EBC96 mucked
Seat 4: Mr50centt folded before Flop (didn't bet)
Seat 5: einsftw folded before Flop (didn't bet)
Seat 6: hinanai0032 (button) showed [Qh Ad] and won ($6) with two pair, Aces and Threes



PokerStars Hand #222959702750:  Hold'em No Limit ($0.05/$0.10 USD) - 2021/01/23 11:46:35 ET
Table 'Lutetia III' 6-max Seat #1 is the button
Seat 1: beta33 ($21.54 in chips) 
Seat 2: Gintaras20 ($10 in chips) 
Seat 3: 3EBC96 ($10 in chips) 
Seat 4: Mr50centt ($14.65 in chips) 
Seat 5: einsftw ($18.40 in chips) 
Seat 6: hinanai0032 ($14.10 in chips) 
Gintaras20: posts small blind $0.05
3EBC96: posts big blind $0.10
*** HOLE CARDS ***
Mr50centt: folds 
einsftw: folds 
hinanai0032: raises $0.20 to $0.30
beta33: folds 
beta33 leaves the table
Gintaras20: folds 
3EBC96: folds 
Uncalled bet ($0.20) returned to hinanai0032
hinanai0032 collected $0.25 from pot
hinanai0032: doesn't show hand 
*** SUMMARY ***
Total pot $0.25 | Rake $0 
Seat 1: beta33 (button) folded before Flop (didn't bet)
Seat 2: Gintaras20 (small blind) folded before Flop
Seat 3: 3EBC96 (big blind) folded before Flop
Seat 4: Mr50centt folded before Flop (didn't bet)
Seat 5: einsftw folded before Flop (didn't bet)
Seat 6: hinanai0032 collected ($0.25)



PokerStars Hand #222959711742:  Hold'em No Limit ($0.05/$0.10 USD) - 2021/01/23 11:46:50 ET
Table 'Lutetia III' 6-max Seat #2 is the button
Seat 2: Gintaras20 ($9.95 in chips) 
Seat 3: 3EBC96 ($10 in chips) 
Seat 5: einsftw ($18.40 in chips) 
Seat 6: hinanai0032 ($14.25 in chips) 
3EBC96: posts small blind $0.05
einsftw: posts big blind $0.10
*** HOLE CARDS ***
prs420 joins the table at seat #1 
hinanai0032: raises $0.20 to $0.30
Gintaras20: calls $0.30
3EBC96: folds 
einsftw: folds 
*** FLOP *** [3s Kh 8s]
hinanai0032: checks 
Gintaras20: bets $0.50
hinanai0032: folds 
Uncalled bet ($0.50) returned to Gintaras20
Gintaras20 collected $0.72 from pot
Gintaras20: doesn't show hand 
*** SUMMARY ***
Total pot $0.75 | Rake $0.03 
Board [3s Kh 8s]
Seat 2: Gintaras20 (button) collected ($0.72)
Seat 3: 3EBC96 (small blind) folded before Flop
Seat 5: einsftw (big blind) folded before Flop
Seat 6: hinanai0032 folded on the Flop



PokerStars Hand #222959725029:  Hold'em No Limit ($0.05/$0.10 USD) - 2021/01/23 11:47:11 ET
Table 'Lutetia III' 6-max Seat #3 is the button
Seat 1: prs420 ($8 in chips) 
Seat 2: Gintaras20 ($10.37 in chips) 
Seat 3: 3EBC96 ($10 in chips) 
Seat 5: einsftw ($18.30 in chips) 
Seat 6: hinanai0032 ($13.95 in chips) 
einsftw: posts small blind $0.05
hinanai0032: posts big blind $0.10
prs420: posts big blind $0.10
*** HOLE CARDS ***
prs420: checks 
Gintaras20: folds 
3EBC96: raises $0.20 to $0.30
einsftw: folds 
hinanai0032: calls $0.20
prs420: folds 
*** FLOP *** [Tc 5d Ac]
hinanai0032: checks 
3EBC96: bets $0.36
hinanai0032: folds 
Uncalled bet ($0.36) returned to 3EBC96
3EBC96 collected $0.72 from pot
3EBC96: doesn't show hand 
*** SUMMARY ***
Total pot $0.75 | Rake $0.03 
Board [Tc 5d Ac]
Seat 1: prs420 folded before Flop (didn't bet)
Seat 2: Gintaras20 folded before Flop (didn't bet)
Seat 3: 3EBC96 (button) collected ($0.72)
Seat 5: einsftw (small blind) folded before Flop
Seat 6: hinanai0032 (big blind) folded on the Flop



PokerStars Hand #222959736318:  Hold'em No Limit ($0.05/$0.10 USD) - 2021/01/23 11:47:30 ET
Table 'Lutetia III' 6-max Seat #5 is the button
Seat 1: prs420 ($7.90 in chips) 
Seat 2: Gintaras20 ($10.37 in chips) 
Seat 3: 3EBC96 ($10.42 in chips) 
Seat 5: einsftw ($18.25 in chips) 
Seat 6: hinanai0032 ($13.65 in chips) 
hinanai0032: posts small blind $0.05
prs420: posts big blind $0.10
*** HOLE CARDS ***
Gintaras20: raises $0.15 to $0.25
3EBC96: raises $0.65 to $0.90
einsftw: folds 
hinanai0032: folds 
prs420: folds 
Gintaras20: folds 
Uncalled bet ($0.65) returned to 3EBC96
3EBC96 collected $0.65 from pot
3EBC96: doesn't show hand 
*** SUMMARY ***
Total pot $0.65 | Rake $0 
Seat 1: prs420 (big blind) folded before Flop
Seat 2: Gintaras20 folded before Flop
Seat 3: 3EBC96 collected ($0.65)
Seat 5: einsftw (button) folded before Flop (didn't bet)
Seat 6: hinanai0032 (small blind) folded before Flop



PokerStars Hand #222959749128:  Hold'em No Limit ($0.05/$0.10 USD) - 2021/01/23 11:47:50 ET
Table 'Lutetia III' 6-max Seat #6 is the button
Seat 1: prs420 ($7.80 in chips) 
Seat 2: Gintaras20 ($10.12 in chips) 
Seat 3: 3EBC96 ($10.82 in chips) 
Seat 5: einsftw ($18.25 in chips) 
Seat 6: hinanai0032 ($13.60 in chips) 
prs420: posts small blind $0.05
Gintaras20: posts big blind $0.10
*** HOLE CARDS ***
3EBC96: folds 
einsftw: folds 
hinanai0032: raises $0.20 to $0.30
prs420: calls $0.25
Gintaras20: calls $0.20
*** FLOP *** [Ks 2c 4d]
prs420: bets $0.86
Gintaras20: folds 
hinanai0032: calls $0.86
*** TURN *** [Ks 2c 4d] [5s]
prs420: bets $2.50
hinanai0032: calls $2.50
*** RIVER *** [Ks 2c 4d 5s] [Jh]
prs420: bets $4.14 and is all-in
hinanai0032: folds 
Uncalled bet ($4.14) returned to prs420
prs420 collected $7.28 from pot
prs420: doesn't show hand 
*** SUMMARY ***
Total pot $7.62 | Rake $0.34 
Board [Ks 2c 4d 5s Jh]
Seat 1: prs420 (small blind) collected ($7.28)
Seat 2: Gintaras20 (big blind) folded on the Flop
Seat 3: 3EBC96 folded before Flop (didn't bet)
Seat 5: einsftw folded before Flop (didn't bet)
Seat 6: hinanai0032 (button) folded on the River



PokerStars Hand #222959777162:  Hold'em No Limit ($0.05/$0.10 USD) - 2021/01/23 11:48:36 ET
Table 'Lutetia III' 6-max Seat #1 is the button
Seat 1: prs420 ($11.42 in chips) 
Seat 2: Gintaras20 ($9.82 in chips) 
Seat 3: 3EBC96 ($10.82 in chips) 
Seat 5: einsftw ($18.25 in chips) 
Seat 6: hinanai0032 ($9.94 in chips) 
Gintaras20: posts small blind $0.05
3EBC96: posts big blind $0.10
Mr50centt: sits out 
*** HOLE CARDS ***
einsftw: raises $0.20 to $0.30
hinanai0032: folds 
prs420: folds 
Gintaras20: calls $0.25
3EBC96: calls $0.20
*** FLOP *** [6h 9d 2d]
Gintaras20: checks 
3EBC96: checks 
einsftw: checks 
*** TURN *** [6h 9d 2d] [Jh]
Gintaras20: bets $0.43
3EBC96: calls $0.43
einsftw: folds 
*** RIVER *** [6h 9d 2d Jh] [Qs]
Gintaras20: checks 
3EBC96: checks 
*** SHOW DOWN ***
Gintaras20: shows [Js 8c] (a pair of Jacks)
3EBC96: shows [Tc Qd] (a pair of Queens)
3EBC96 collected $1.68 from pot
*** SUMMARY ***
Total pot $1.76 | Rake $0.08 
Board [6h 9d 2d Jh Qs]
Seat 1: prs420 (button) folded before Flop (didn't bet)
Seat 2: Gintaras20 (small blind) showed [Js 8c] and lost with a pair of Jacks
Seat 3: 3EBC96 (big blind) showed [Tc Qd] and won ($1.68) with a pair of Queens
Seat 5: einsftw folded on the Turn
Seat 6: hinanai0032 folded before Flop (didn't bet)



PokerStars Hand #222959807475:  Hold'em No Limit ($0.05/$0.10 USD) - 2021/01/23 11:49:24 ET
Table 'Lutetia III' 6-max Seat #2 is the button
Seat 1: prs420 ($11.42 in chips) 
Seat 2: Gintaras20 ($9.09 in chips) 
Seat 3: 3EBC96 ($11.77 in chips) 
Seat 4: Mr50centt ($14.65 in chips) 
Seat 5: einsftw ($17.95 in chips) 
Seat 6: hinanai0032 ($9.94 in chips) 
3EBC96: posts small blind $0.05
Mr50centt: posts big blind $0.10
*** HOLE CARDS ***
einsftw: folds 
hinanai0032: folds 
prs420: folds 
Gintaras20: folds 
3EBC96: folds 
Uncalled bet ($0.05) returned to Mr50centt
Mr50centt collected $0.10 from pot
Mr50centt: doesn't show hand 
*** SUMMARY ***
Total pot $0.10 | Rake $0 
Seat 1: prs420 folded before Flop (didn't bet)
Seat 2: Gintaras20 (button) folded before Flop (didn't bet)
Seat 3: 3EBC96 (small blind) folded before Flop
Seat 4: Mr50centt (big blind) collected ($0.10)
Seat 5: einsftw folded before Flop (didn't bet)
Seat 6: hinanai0032 folded before Flop (didn't bet)



PokerStars Hand #222959812666:  Hold'em No Limit ($0.05/$0.10 USD) - 2021/01/23 11:49:33 ET
Table 'Lutetia III' 6-max Seat #3 is the button
Seat 1: prs420 ($11.42 in chips) 
Seat 2: Gintaras20 ($9.09 in chips) 
Seat 3: 3EBC96 ($11.72 in chips) 
Seat 4: Mr50centt ($14.70 in chips) 
Seat 6: hinanai0032 ($9.94 in chips) 
Mr50centt: posts small blind $0.05
einsftw: is sitting out 
einsftw leaves the table
hinanai0032: posts big blind $0.10
*** HOLE CARDS ***
prs420: folds 
IrdinTo16 joins the table at seat #5 
Gintaras20: raises $0.15 to $0.25
3EBC96: folds 
Mr50centt: folds 
hinanai0032: raises $0.55 to $0.80
Gintaras20: calls $0.55
*** FLOP *** [6h 7s 7c]
hinanai0032: checks 
Gintaras20: bets $0.79
hinanai0032: raises $0.79 to $1.58
Gintaras20: calls $0.79
*** TURN *** [6h 7s 7c] [6d]
hinanai0032: bets $7.56 and is all-in
Gintaras20: folds 
Uncalled bet ($7.56) returned to hinanai0032
hinanai0032 collected $4.59 from pot
hinanai0032: doesn't show hand 
*** SUMMARY ***
Total pot $4.81 | Rake $0.22 
Board [6h 7s 7c 6d]
Seat 1: prs420 folded before Flop (didn't bet)
Seat 2: Gintaras20 folded on the Turn
Seat 3: 3EBC96 (button) folded before Flop (didn't bet)
Seat 4: Mr50centt (small blind) folded before Flop
Seat 6: hinanai0032 (big blind) collected ($4.59)



PokerStars Hand #222959844666:  Hold'em No Limit ($0.05/$0.10 USD) - 2021/01/23 11:50:25 ET
Table 'Lutetia III' 6-max Seat #4 is the button
Seat 1: prs420 ($11.42 in chips) 
Seat 2: Gintaras20 ($6.71 in chips) 
Seat 3: 3EBC96 ($11.72 in chips) 
Seat 4: Mr50centt ($14.65 in chips) 
Seat 6: hinanai0032 ($12.15 in chips) 
hinanai0032: posts small blind $0.05
prs420: posts big blind $0.10
*** HOLE CARDS ***
Gintaras20: folds 
3EBC96: raises $0.20 to $0.30
Mr50centt: folds 
hinanai0032: raises $0.70 to $1
prs420: folds 
3EBC96: calls $0.70
*** FLOP *** [6c Jh 2c]
hinanai0032: bets $1
3EBC96: calls $1
*** TURN *** [6c Jh 2c] [6d]
hinanai0032: bets $1.96
3EBC96: folds 
Uncalled bet ($1.96) returned to hinanai0032
hinanai0032 collected $3.92 from pot
hinanai0032: doesn't show hand 
*** SUMMARY ***
Total pot $4.10 | Rake $0.18 
Board [6c Jh 2c 6d]
Seat 1: prs420 (big blind) folded before Flop
Seat 2: Gintaras20 folded before Flop (didn't bet)
Seat 3: 3EBC96 folded on the Turn
Seat 4: Mr50centt (button) folded before Flop (didn't bet)
Seat 6: hinanai0032 (small blind) collected ($3.92)



PokerStars Hand #222959869502:  Hold'em No Limit ($0.05/$0.10 USD) - 2021/01/23 11:51:05 ET
Table 'Lutetia III' 6-max Seat #1 is the button
Seat 1: prs420 ($11.32 in chips) 
Seat 2: Gintaras20 ($10 in chips) 
Seat 3: 3EBC96 ($10 in chips) 
Seat 4: Mr50centt ($14.65 in chips) 
Gintaras20: posts small blind $0.05
3EBC96: posts big blind $0.10
IrdinTo16: sits out 
*** HOLE CARDS ***
Mr50centt: raises $0.15 to $0.25
prs420: folds 
Gintaras20: calls $0.20
3EBC96: calls $0.15
*** FLOP *** [4s Qh Qs]
Gintaras20: bets $0.54
3EBC96: calls $0.54
Mr50centt: calls $0.54
*** TURN *** [4s Qh Qs] [Jh]
Gintaras20: bets $1.70
3EBC96: folds 
Mr50centt: calls $1.70
*** RIVER *** [4s Qh Qs Jh] [Ac]
Gintaras20: bets $7.51 and is all-in
Mr50centt: calls $7.51
*** SHOW DOWN ***
Gintaras20: shows [8c Qc] (three of a kind, Queens)
Mr50centt: shows [As Qd] (a full house, Queens full of Aces)
Mr50centt collected $19.85 from pot
*** SUMMARY ***
Total pot $20.79 | Rake $0.94 
Board [4s Qh Qs Jh Ac]
Seat 1: prs420 (button) folded before Flop (didn't bet)
Seat 2: Gintaras20 (small blind) showed [8c Qc] and lost with three of a kind, Queens
Seat 3: 3EBC96 (big blind) folded on the Turn
Seat 4: Mr50centt showed [As Qd] and won ($19.85) with a full house, Queens full of Aces



PokerStars Hand #222959899488:  Hold'em No Limit ($0.05/$0.10 USD) - 2021/01/23 11:51:43 ET
Table 'Lutetia III' 6-max Seat #2 is the button
Seat 1: prs420 ($11.32 in chips) 
Seat 2: Gintaras20 ($4 in chips) 
Seat 3: 3EBC96 ($10 in chips) 
Seat 4: Mr50centt ($24.50 in chips) 
3EBC96: posts small blind $0.05
Mr50centt: posts big blind $0.10
IrdinTo16: sits out 
*** HOLE CARDS ***
prs420: calls $0.10
Gintaras20: folds 
3EBC96: folds 
Mr50centt: checks 
*** FLOP *** [5s 2c 5h]
Mr50centt: checks 
prs420: checks 
*** TURN *** [5s 2c 5h] [Th]
Mr50centt: checks 
IrdinTo16 leaves the table
prs420: checks 
*** RIVER *** [5s 2c 5h Th] [3c]
Mr50centt: checks 
prs420: checks 
*** SHOW DOWN ***
Mr50centt: shows [Qc 8d] (a pair of Fives)
prs420: mucks hand 
Mr50centt collected $0.24 from pot
*** SUMMARY ***
Total pot $0.25 | Rake $0.01 
Board [5s 2c 5h Th 3c]
Seat 1: prs420 mucked
Seat 2: Gintaras20 (button) folded before Flop (didn't bet)
Seat 3: 3EBC96 (small blind) folded before Flop
Seat 4: Mr50centt (big blind) showed [Qc 8d] and won ($0.24) with a pair of Fives



PokerStars Hand #222959911645:  Hold'em No Limit ($0.05/$0.10 USD) - 2021/01/23 11:52:03 ET
Table 'Lutetia III' 6-max Seat #3 is the button
Seat 1: prs420 ($11.22 in chips) 
Seat 2: Gintaras20 ($4 in chips) 
Seat 3: 3EBC96 ($10 in chips) 
Seat 4: Mr50centt ($24.64 in chips) 
Mr50centt: posts small blind $0.05
prs420: posts big blind $0.10
*** HOLE CARDS ***
magdal28 joins the table at seat #5 
Gintaras20: folds 
3EBC96: folds 
Mr50centt: folds 
Uncalled bet ($0.05) returned to prs420
prs420 collected $0.10 from pot
prs420: doesn't show hand 
*** SUMMARY ***
Total pot $0.10 | Rake $0 
Seat 1: prs420 (big blind) collected ($0.10)
Seat 2: Gintaras20 folded before Flop (didn't bet)
Seat 3: 3EBC96 (button) folded before Flop (didn't bet)
Seat 4: Mr50centt (small blind) folded before Flop



PokerStars Hand #222960016306:  Hold'em No Limit ($0.05/$0.10 USD) - 2021/01/23 11:54:53 ET
Table 'Lutetia III' 6-max Seat #5 is the button
Seat 1: prs420 ($14.55 in chips) 
Seat 2: Gintaras20 ($10 in chips) 
Seat 3: 3EBC96 ($10.60 in chips) 
Seat 4: Mr50centt ($23.42 in chips) 
Seat 5: magdal28 ($10 in chips) 
prs420: posts small blind $0.05
Gintaras20: posts big blind $0.10
*** HOLE CARDS ***
3EBC96: folds 
Mr50centt: folds 
magdal28: raises $0.15 to $0.25
prs420: calls $0.20
Gintaras20: folds 
*** FLOP *** [9s 7c 5c]
prs420: bets $0.10
magdal28: calls $0.10
*** TURN *** [9s 7c 5c] [4h]
prs420: bets $0.20
magdal28: calls $0.20
*** RIVER *** [9s 7c 5c 4h] [Kd]
prs420: checks 
magdal28: bets $0.83
prs420: folds 
Uncalled bet ($0.83) returned to magdal28
magdal28 collected $1.15 from pot
magdal28: doesn't show hand 
*** SUMMARY ***
Total pot $1.20 | Rake $0.05 
Board [9s 7c 5c 4h Kd]
Seat 1: prs420 (small blind) folded on the River
Seat 2: Gintaras20 (big blind) folded before Flop
Seat 3: 3EBC96 folded before Flop (didn't bet)
Seat 4: Mr50centt folded before Flop (didn't bet)
Seat 5: magdal28 (button) collected ($1.15)



PokerStars Hand #222960048159:  Hold'em No Limit ($0.05/$0.10 USD) - 2021/01/23 11:55:57 ET
Table 'Lutetia III' 6-max Seat #1 is the button
Seat 1: prs420 ($14 in chips) 
Seat 2: Gintaras20 ($9.90 in chips) 
Seat 3: 3EBC96 ($10.60 in chips) 
Seat 4: Mr50centt ($23.42 in chips) 
Seat 5: magdal28 ($10.60 in chips) 
Gintaras20: posts small blind $0.05
3EBC96: posts big blind $0.10
*** HOLE CARDS ***
Mr50centt: folds 
magdal28: folds 
prs420: calls $0.10
Gintaras20: folds 
3EBC96: checks 
*** FLOP *** [7d Jd Jh]
3EBC96: checks 
prs420: checks 
*** TURN *** [7d Jd Jh] [Qc]
3EBC96: checks 
prs420: bets $0.10
3EBC96: calls $0.10
*** RIVER *** [7d Jd Jh Qc] [Td]
3EBC96: checks 
prs420: bets $0.41
3EBC96: calls $0.41
*** SHOW DOWN ***
prs420: shows [Jc 7c] (a full house, Jacks full of Sevens)
3EBC96: mucks hand 
prs420 collected $1.21 from pot
*** SUMMARY ***
Total pot $1.27 | Rake $0.06 
Board [7d Jd Jh Qc Td]
Seat 1: prs420 (button) showed [Jc 7c] and won ($1.21) with a full house, Jacks full of Sevens
Seat 2: Gintaras20 (small blind) folded before Flop
Seat 3: 3EBC96 (big blind) mucked
Seat 4: Mr50centt folded before Flop (didn't bet)
Seat 5: magdal28 folded before Flop (didn't bet)



PokerStars Hand #222960061304:  Hold'em No Limit ($0.05/$0.10 USD) - 2021/01/23 11:56:25 ET
Table 'Lutetia III' 6-max Seat #2 is the button
Seat 1: prs420 ($14.60 in chips) 
Seat 2: Gintaras20 ($9.85 in chips) 
Seat 3: 3EBC96 ($10 in chips) 
Seat 4: Mr50centt ($23.42 in chips) 
Seat 5: magdal28 ($10.60 in chips) 
3EBC96: posts small blind $0.05
Mr50centt: posts big blind $0.10
*** HOLE CARDS ***
magdal28: folds 
prs420: calls $0.10
Gintaras20: folds 
3EBC96: raises $0.40 to $0.50
Mr50centt: folds 
prs420: calls $0.40
*** FLOP *** [5d 7c Qh]
3EBC96: bets $0.35
prs420: calls $0.35
*** TURN *** [5d 7c Qh] [2h]
3EBC96: checks 
prs420: bets $0.86
3EBC96: folds 
Uncalled bet ($0.86) returned to prs420
prs420 collected $1.72 from pot
prs420: doesn't show hand 
*** SUMMARY ***
Total pot $1.80 | Rake $0.08 
Board [5d 7c Qh 2h]
Seat 1: prs420 collected ($1.72)
Seat 2: Gintaras20 (button) folded before Flop (didn't bet)
Seat 3: 3EBC96 (small blind) folded on the Turn
Seat 4: Mr50centt (big blind) folded before Flop
Seat 5: magdal28 folded before Flop (didn't bet)



PokerStars Hand #222960072077:  Hold'em No Limit ($0.05/$0.10 USD) - 2021/01/23 11:56:48 ET
Table 'Lutetia III' 6-max Seat #3 is the button
Seat 1: prs420 ($15.47 in chips) 
Seat 2: Gintaras20 ($9.85 in chips) 
Seat 3: 3EBC96 ($10 in chips) 
Seat 4: Mr50centt ($23.32 in chips) 
Seat 5: magdal28 ($10.60 in chips) 
Mr50centt: posts small blind $0.05
magdal28: posts big blind $0.10
*** HOLE CARDS ***
prs420: calls $0.10
Gintaras20: folds 
3EBC96: folds 
Mr50centt: folds 
magdal28: checks 
*** FLOP *** [8h Jc Ad]
magdal28: checks 
prs420: bets $0.10
magdal28: folds 
Uncalled bet ($0.10) returned to prs420
prs420 collected $0.24 from pot
prs420: doesn't show hand 
*** SUMMARY ***
Total pot $0.25 | Rake $0.01 
Board [8h Jc Ad]
Seat 1: prs420 collected ($0.24)
Seat 2: Gintaras20 folded before Flop (didn't bet)
Seat 3: 3EBC96 (button) folded before Flop (didn't bet)
Seat 4: Mr50centt (small blind) folded before Flop
Seat 5: magdal28 (big blind) folded on the Flop



PokerStars Hand #222960083205:  Hold'em No Limit ($0.05/$0.10 USD) - 2021/01/23 11:57:12 ET
Table 'Lutetia III' 6-max Seat #4 is the button
Seat 1: prs420 ($15.61 in chips) 
Seat 2: Gintaras20 ($9.85 in chips) 
Seat 3: 3EBC96 ($10 in chips) 
Seat 4: Mr50centt ($23.27 in chips) 
Seat 5: magdal28 ($10.50 in chips) 
magdal28: posts small blind $0.05
prs420: posts big blind $0.10
*** HOLE CARDS ***
Gintaras20: folds 
3EBC96: folds 
Mr50centt: raises $0.10 to $0.20
magdal28: folds 
prs420: calls $0.10
*** FLOP *** [Kh 8h 9h]
prs420: bets $0.10
Mr50centt: calls $0.10
*** TURN *** [Kh 8h 9h] [9d]
prs420: bets $0.31
Mr50centt: calls $0.31
*** RIVER *** [Kh 8h 9h 9d] [3s]
prs420: bets $0.60
Mr50centt: folds 
Uncalled bet ($0.60) returned to prs420
prs420 collected $1.21 from pot
prs420: doesn't show hand 
*** SUMMARY ***
Total pot $1.27 | Rake $0.06 
Board [Kh 8h 9h 9d 3s]
Seat 1: prs420 (big blind) collected ($1.21)
Seat 2: Gintaras20 folded before Flop (didn't bet)
Seat 3: 3EBC96 folded before Flop (didn't bet)
Seat 4: Mr50centt (button) folded on the River
Seat 5: magdal28 (small blind) folded before Flop



PokerStars Hand #222960096775:  Hold'em No Limit ($0.05/$0.10 USD) - 2021/01/23 11:57:41 ET
Table 'Lutetia III' 6-max Seat #5 is the button
Seat 1: prs420 ($16.21 in chips) 
Seat 2: Gintaras20 ($9.85 in chips) 
Seat 3: 3EBC96 ($10 in chips) 
Seat 4: Mr50centt ($22.66 in chips) 
Seat 5: magdal28 ($10.45 in chips) 
prs420: posts small blind $0.05
Gintaras20: posts big blind $0.10
*** HOLE CARDS ***
3EBC96: folds 
Mr50centt: folds 
magdal28: raises $0.15 to $0.25
prs420: calls $0.20
Gintaras20: folds 
*** FLOP *** [7c Kc Jc]
prs420: bets $0.28
magdal28: folds 
Uncalled bet ($0.28) returned to prs420
prs420 collected $0.57 from pot
prs420: doesn't show hand 
*** SUMMARY ***
Total pot $0.60 | Rake $0.03 
Board [7c Kc Jc]
Seat 1: prs420 (small blind) collected ($0.57)
Seat 2: Gintaras20 (big blind) folded before Flop
Seat 3: 3EBC96 folded before Flop (didn't bet)
Seat 4: Mr50centt folded before Flop (didn't bet)
Seat 5: magdal28 (button) folded on the Flop



PokerStars Hand #222960104488:  Hold'em No Limit ($0.05/$0.10 USD) - 2021/01/23 11:57:57 ET
Table 'Lutetia III' 6-max Seat #1 is the button
Seat 1: prs420 ($16.53 in chips) 
Seat 2: Gintaras20 ($9.75 in chips) 
Seat 3: 3EBC96 ($10 in chips) 
Seat 4: Mr50centt ($22.66 in chips) 
Seat 5: magdal28 ($10.20 in chips) 
Gintaras20: posts small blind $0.05
3EBC96: posts big blind $0.10
*** HOLE CARDS ***
Mr50centt: folds 
magdal28: folds 
prs420: calls $0.10
Gintaras20: folds 
Mr50centt leaves the table
3EBC96: checks 
*** FLOP *** [Jd 2d Ah]
3EBC96: checks 
prs420: checks 
*** TURN *** [Jd 2d Ah] [Ac]
3EBC96: checks 
prs420: checks 
*** RIVER *** [Jd 2d Ah Ac] [5s]
jorgeebanks joins the table at seat #4 
3EBC96: checks 
prs420: checks 
*** SHOW DOWN ***
3EBC96: shows [Kd 9h] (a pair of Aces)
prs420: mucks hand 
3EBC96 collected $0.24 from pot
*** SUMMARY ***
Total pot $0.25 | Rake $0.01 
Board [Jd 2d Ah Ac 5s]
Seat 1: prs420 (button) mucked
Seat 2: Gintaras20 (small blind) folded before Flop
Seat 3: 3EBC96 (big blind) showed [Kd 9h] and won ($0.24) with a pair of Aces
Seat 4: Mr50centt folded before Flop (didn't bet)
Seat 5: magdal28 folded before Flop (didn't bet)



PokerStars Hand #222960113569:  Hold'em No Limit ($0.05/$0.10 USD) - 2021/01/23 11:58:16 ET
Table 'Lutetia III' 6-max Seat #2 is the button
Seat 1: prs420 ($16.43 in chips) 
Seat 2: Gintaras20 ($9.70 in chips) 
Seat 3: 3EBC96 ($10.14 in chips) 
Seat 4: jorgeebanks ($10 in chips) 
Seat 5: magdal28 ($10.20 in chips) 
3EBC96: posts small blind $0.05
jorgeebanks: posts big blind $0.10
*** HOLE CARDS ***
magdal28: raises $0.15 to $0.25
prs420: folds 
Gintaras20: calls $0.25
3EBC96: folds 
jorgeebanks: raises $0.80 to $1.05
magdal28: folds 
Gintaras20: calls $0.80
*** FLOP *** [Ad 6h 8h]
jorgeebanks: bets $1.15
Gintaras20: folds 
Uncalled bet ($1.15) returned to jorgeebanks
jorgeebanks collected $2.29 from pot
jorgeebanks: doesn't show hand 
*** SUMMARY ***
Total pot $2.40 | Rake $0.11 
Board [Ad 6h 8h]
Seat 1: prs420 folded before Flop (didn't bet)
Seat 2: Gintaras20 (button) folded on the Flop
Seat 3: 3EBC96 (small blind) folded before Flop
Seat 4: jorgeebanks (big blind) collected ($2.29)
Seat 5: magdal28 folded before Flop



PokerStars Hand #222960125649:  Hold'em No Limit ($0.05/$0.10 USD) - 2021/01/23 11:58:42 ET
Table 'Lutetia III' 6-max Seat #3 is the button
Seat 1: prs420 ($16.43 in chips) 
Seat 2: Gintaras20 ($8.65 in chips) 
Seat 3: 3EBC96 ($10.09 in chips) 
Seat 4: jorgeebanks ($11.24 in chips) 
Seat 5: magdal28 ($10 in chips) 
jorgeebanks: posts small blind $0.05
magdal28: posts big blind $0.10
*** HOLE CARDS ***
prs420: folds 
Gintaras20: folds 
3EBC96: raises $0.20 to $0.30
jorgeebanks: calls $0.25
magdal28: folds 
*** FLOP *** [5h 5c 4c]
jorgeebanks: bets $0.34
3EBC96: calls $0.34
*** TURN *** [5h 5c 4c] [9s]
jorgeebanks: checks 
hinanai0032 is disconnected 
3EBC96: bets $0.70
jorgeebanks: raises $0.70 to $1.40
3EBC96: calls $0.70
*** RIVER *** [5h 5c 4c 9s] [Qs]
jorgeebanks: bets $2.10
3EBC96: folds 
Uncalled bet ($2.10) returned to jorgeebanks
jorgeebanks collected $3.99 from pot
jorgeebanks: doesn't show hand 
*** SUMMARY ***
Total pot $4.18 | Rake $0.19 
Board [5h 5c 4c 9s Qs]
Seat 1: prs420 folded before Flop (didn't bet)
Seat 2: Gintaras20 folded before Flop (didn't bet)
Seat 3: 3EBC96 (button) folded on the River
Seat 4: jorgeebanks (small blind) collected ($3.99)
Seat 5: magdal28 (big blind) folded before Flop



PokerStars Hand #222960145149:  Hold'em No Limit ($0.05/$0.10 USD) - 2021/01/23 11:59:23 ET
Table 'Lutetia III' 6-max Seat #4 is the button
Seat 1: prs420 ($16.43 in chips) 
Seat 2: Gintaras20 ($10 in chips) 
Seat 3: 3EBC96 ($10 in chips) 
Seat 4: jorgeebanks ($13.19 in chips) 
Seat 5: magdal28 ($10 in chips) 
magdal28: posts small blind $0.05
prs420: posts big blind $0.10
*** HOLE CARDS ***
Gintaras20: folds 
3EBC96: folds 
jorgeebanks: folds 
magdal28: folds 
Uncalled bet ($0.05) returned to prs420
prs420 collected $0.10 from pot
hinanai0032 was removed from the table for failing to post
hinanai0032 leaves the table
prs420: doesn't show hand 
*** SUMMARY ***
Total pot $0.10 | Rake $0 
Seat 1: prs420 (big blind) collected ($0.10)
Seat 2: Gintaras20 folded before Flop (didn't bet)
Seat 3: 3EBC96 folded before Flop (didn't bet)
Seat 4: jorgeebanks (button) folded before Flop (didn't bet)
Seat 5: magdal28 (small blind) folded before Flop



PokerStars Hand #222960149847:  Hold'em No Limit ($0.05/$0.10 USD) - 2021/01/23 11:59:33 ET
Table 'Lutetia III' 6-max Seat #5 is the button
Seat 1: prs420 ($16.48 in chips) 
Seat 2: Gintaras20 ($10 in chips) 
Seat 3: 3EBC96 ($10 in chips) 
Seat 4: jorgeebanks ($13.19 in chips) 
Seat 5: magdal28 ($10 in chips) 
prs420: posts small blind $0.05
Gintaras20: posts big blind $0.10
*** HOLE CARDS ***
3EBC96: folds 
jorgeebanks: folds 
magdal28: folds 
prs420: calls $0.05
Gintaras20: checks 
*** FLOP *** [6h Kd Jh]
Dugipokers joins the table at seat #6 
prs420: bets $0.20
Gintaras20: folds 
Uncalled bet ($0.20) returned to prs420
prs420 collected $0.19 from pot
prs420: doesn't show hand 
*** SUMMARY ***
Total pot $0.20 | Rake $0.01 
Board [6h Kd Jh]
Seat 1: prs420 (small blind) collected ($0.19)
Seat 2: Gintaras20 (big blind) folded on the Flop
Seat 3: 3EBC96 folded before Flop (didn't bet)
Seat 4: jorgeebanks folded before Flop (didn't bet)
Seat 5: magdal28 (button) folded before Flop (didn't bet)



PokerStars Hand #222960157450:  Hold'em No Limit ($0.05/$0.10 USD) - 2021/01/23 11:59:49 ET
Table 'Lutetia III' 6-max Seat #1 is the button
Seat 1: prs420 ($16.57 in chips) 
Seat 2: Gintaras20 ($9.90 in chips) 
Seat 3: 3EBC96 ($10 in chips) 
Seat 4: jorgeebanks ($13.19 in chips) 
Seat 5: magdal28 ($10 in chips) 
Gintaras20: posts small blind $0.05
3EBC96: posts big blind $0.10
Dugipokers: sits out 
*** HOLE CARDS ***
jorgeebanks: folds 
jorgeebanks leaves the table
magdal28: folds 
prs420: calls $0.10
Gintaras20: folds 
3EBC96: raises $0.40 to $0.50
prs420: calls $0.40
*** FLOP *** [Qs 8c 9d]
Gavinifold joins the table at seat #4 
3EBC96: bets $0.33
prs420: folds 
Uncalled bet ($0.33) returned to 3EBC96
3EBC96 collected $1 from pot
3EBC96: doesn't show hand 
*** SUMMARY ***
Total pot $1.05 | Rake $0.05 
Board [Qs 8c 9d]
Seat 1: prs420 (button) folded on the Flop
Seat 2: Gintaras20 (small blind) folded before Flop
Seat 3: 3EBC96 (big blind) collected ($1)
Seat 4: jorgeebanks folded before Flop (didn't bet)
Seat 5: magdal28 folded before Flop (didn't bet)



PokerStars Hand #222960174005:  Hold'em No Limit ($0.05/$0.10 USD) - 2021/01/23 12:00:22 ET
Table 'Lutetia III' 6-max Seat #2 is the button
Seat 1: prs420 ($16.07 in chips) 
Seat 2: Gintaras20 ($9.85 in chips) 
Seat 3: 3EBC96 ($10.50 in chips) 
Seat 4: Gavinifold ($10 in chips) 
Seat 5: magdal28 ($10 in chips) 
3EBC96: posts small blind $0.05
Gavinifold: posts big blind $0.10
Dugipokers: sits out 
*** HOLE CARDS ***
magdal28: folds 
prs420: folds 
Gintaras20: folds 
3EBC96: folds 
Uncalled bet ($0.05) returned to Gavinifold
Gavinifold collected $0.10 from pot
Gavinifold: doesn't show hand 
*** SUMMARY ***
Total pot $0.10 | Rake $0 
Seat 1: prs420 folded before Flop (didn't bet)
Seat 2: Gintaras20 (button) folded before Flop (didn't bet)
Seat 3: 3EBC96 (small blind) folded before Flop
Seat 4: Gavinifold (big blind) collected ($0.10)
Seat 5: magdal28 folded before Flop (didn't bet)



PokerStars Hand #222960177376:  Hold'em No Limit ($0.05/$0.10 USD) - 2021/01/23 12:00:29 ET
Table 'Lutetia III' 6-max Seat #3 is the button
Seat 1: prs420 ($16.07 in chips) 
Seat 2: Gintaras20 ($9.85 in chips) 
Seat 3: 3EBC96 ($10.45 in chips) 
Seat 4: Gavinifold ($10.05 in chips) 
Seat 5: magdal28 ($10 in chips) 
Gavinifold: posts small blind $0.05
magdal28: posts big blind $0.10
Dugipokers: sits out 
*** HOLE CARDS ***
prs420: folds 
Gintaras20: folds 
3EBC96: raises $0.20 to $0.30
Gavinifold: folds 
magdal28: folds 
Uncalled bet ($0.20) returned to 3EBC96
3EBC96 collected $0.25 from pot
3EBC96: doesn't show hand 
*** SUMMARY ***
Total pot $0.25 | Rake $0 
Seat 1: prs420 folded before Flop (didn't bet)
Seat 2: Gintaras20 folded before Flop (didn't bet)
Seat 3: 3EBC96 (button) collected ($0.25)
Seat 4: Gavinifold (small blind) folded before Flop
Seat 5: magdal28 (big blind) folded before Flop



PokerStars Hand #222960188220:  Hold'em No Limit ($0.05/$0.10 USD) - 2021/01/23 12:00:50 ET
Table 'Lutetia III' 6-max Seat #4 is the button
Seat 1: prs420 ($16.07 in chips) 
Seat 2: Gintaras20 ($9.85 in chips) 
Seat 3: 3EBC96 ($10.60 in chips) 
Seat 4: Gavinifold ($10 in chips) 
Seat 5: magdal28 ($10 in chips) 
Seat 6: Dugipokers ($10 in chips) 
magdal28: posts small blind $0.05
Dugipokers: posts big blind $0.10
*** HOLE CARDS ***
prs420: folds 
Gintaras20: folds 
3EBC96: folds 
Gavinifold has timed out
Gavinifold: folds 
magdal28: folds 
Uncalled bet ($0.05) returned to Dugipokers
Dugipokers collected $0.10 from pot
Dugipokers: doesn't show hand 
*** SUMMARY ***
Total pot $0.10 | Rake $0 
Seat 1: prs420 folded before Flop (didn't bet)
Seat 2: Gintaras20 folded before Flop (didn't bet)
Seat 3: 3EBC96 folded before Flop (didn't bet)
Seat 4: Gavinifold (button) folded before Flop (didn't bet)
Seat 5: magdal28 (small blind) folded before Flop
Seat 6: Dugipokers (big blind) collected ($0.10)



PokerStars Hand #222960206195:  Hold'em No Limit ($0.05/$0.10 USD) - 2021/01/23 12:01:08 ET
Table 'Lutetia III' 6-max Seat #5 is the button
Seat 1: prs420 ($16.07 in chips) 
Seat 2: Gintaras20 ($9.85 in chips) 
Seat 3: 3EBC96 ($10.60 in chips) 
Seat 5: magdal28 ($10 in chips) 
Seat 6: Dugipokers ($10.05 in chips) 
Dugipokers: posts small blind $0.05
prs420: posts big blind $0.10
*** HOLE CARDS ***
Gintaras20: folds 
3EBC96: raises $0.20 to $0.30
magdal28: folds 
Dugipokers: folds 
prs420: folds 
Uncalled bet ($0.20) returned to 3EBC96
3EBC96 collected $0.25 from pot
3EBC96: doesn't show hand 
*** SUMMARY ***
Total pot $0.25 | Rake $0 
Seat 1: prs420 (big blind) folded before Flop
Seat 2: Gintaras20 folded before Flop (didn't bet)
Seat 3: 3EBC96 collected ($0.25)
Seat 5: magdal28 (button) folded before Flop (didn't bet)
Seat 6: Dugipokers (small blind) folded before Flop



PokerStars Hand #222960213621:  Hold'em No Limit ($0.05/$0.10 USD) - 2021/01/23 12:01:21 ET
Table 'Lutetia III' 6-max Seat #6 is the button
Seat 1: prs420 ($15.97 in chips) 
Seat 2: Gintaras20 ($9.85 in chips) 
Seat 3: 3EBC96 ($10.75 in chips) 
Seat 4: Gavinifold ($10 in chips) 
Seat 5: magdal28 ($10 in chips) 
Seat 6: Dugipokers ($10 in chips) 
prs420: posts small blind $0.05
Gintaras20: posts big blind $0.10
*** HOLE CARDS ***
3EBC96: folds 
Gavinifold: folds 
magdal28: raises $0.15 to $0.25
Dugipokers: raises $0.65 to $0.90
prs420: folds 
Gintaras20: folds 
magdal28: folds 
Uncalled bet ($0.65) returned to Dugipokers
Dugipokers collected $0.65 from pot
Dugipokers: doesn't show hand 
*** SUMMARY ***
Total pot $0.65 | Rake $0 
Seat 1: prs420 (small blind) folded before Flop
Seat 2: Gintaras20 (big blind) folded before Flop
Seat 3: 3EBC96 folded before Flop (didn't bet)
Seat 4: Gavinifold folded before Flop (didn't bet)
Seat 5: magdal28 folded before Flop
Seat 6: Dugipokers (button) collected ($0.65)



PokerStars Hand #222960226789:  Hold'em No Limit ($0.05/$0.10 USD) - 2021/01/23 12:01:44 ET
Table 'Lutetia III' 6-max Seat #1 is the button
Seat 1: prs420 ($15.92 in chips) 
Seat 2: Gintaras20 ($9.75 in chips) 
Seat 3: 3EBC96 ($10.75 in chips) 
Seat 4: Gavinifold ($10 in chips) 
Seat 5: magdal28 ($10 in chips) 
Seat 6: Dugipokers ($10.40 in chips) 
Gintaras20: posts small blind $0.05
3EBC96: posts big blind $0.10
*** HOLE CARDS ***
Gavinifold: calls $0.10
magdal28: folds 
Dugipokers: raises $0.30 to $0.40
prs420: calls $0.40
Gintaras20: folds 
3EBC96: folds 
Gavinifold: calls $0.30
*** FLOP *** [7c 3c 6s]
Gavinifold: bets $1.30
Dugipokers: folds 
prs420: folds 
Uncalled bet ($1.30) returned to Gavinifold
Gavinifold collected $1.29 from pot
Gavinifold: doesn't show hand 
*** SUMMARY ***
Total pot $1.35 | Rake $0.06 
Board [7c 3c 6s]
Seat 1: prs420 (button) folded on the Flop
Seat 2: Gintaras20 (small blind) folded before Flop
Seat 3: 3EBC96 (big blind) folded before Flop
Seat 4: Gavinifold collected ($1.29)
Seat 5: magdal28 folded before Flop (didn't bet)
Seat 6: Dugipokers folded on the Flop



PokerStars Hand #222960251130:  Hold'em No Limit ($0.05/$0.10 USD) - 2021/01/23 12:02:23 ET
Table 'Lutetia III' 6-max Seat #2 is the button
Seat 1: prs420 ($15.52 in chips) 
Seat 2: Gintaras20 ($9.70 in chips) 
Seat 3: 3EBC96 ($10.65 in chips) 
Seat 4: Gavinifold ($10.89 in chips) 
Seat 5: magdal28 ($10 in chips) 
Seat 6: Dugipokers ($10 in chips) 
3EBC96: posts small blind $0.05
Gavinifold: posts big blind $0.10
*** HOLE CARDS ***
magdal28: folds 
Dugipokers: folds 
prs420: folds 
Gintaras20: folds 
3EBC96: folds 
Uncalled bet ($0.05) returned to Gavinifold
Gavinifold collected $0.10 from pot
Gavinifold: doesn't show hand 
*** SUMMARY ***
Total pot $0.10 | Rake $0 
Seat 1: prs420 folded before Flop (didn't bet)
Seat 2: Gintaras20 (button) folded before Flop (didn't bet)
Seat 3: 3EBC96 (small blind) folded before Flop
Seat 4: Gavinifold (big blind) collected ($0.10)
Seat 5: magdal28 folded before Flop (didn't bet)
Seat 6: Dugipokers folded before Flop (didn't bet)



PokerStars Hand #222960255327:  Hold'em No Limit ($0.05/$0.10 USD) - 2021/01/23 12:02:30 ET
Table 'Lutetia III' 6-max Seat #3 is the button
Seat 1: prs420 ($15.52 in chips) 
Seat 2: Gintaras20 ($9.70 in chips) 
Seat 3: 3EBC96 ($10.60 in chips) 
Seat 4: Gavinifold ($10.94 in chips) 
Seat 5: magdal28 ($10 in chips) 
Seat 6: Dugipokers ($10 in chips) 
Gavinifold: posts small blind $0.05
magdal28: posts big blind $0.10
*** HOLE CARDS ***
Dugipokers: raises $0.20 to $0.30
prs420: folds 
Gintaras20: calls $0.30
3EBC96: calls $0.30
Gavinifold: folds 
magdal28: calls $0.20
*** FLOP *** [Th 9d 6h]
magdal28: checks 
Dugipokers: checks 
Gintaras20: checks 
3EBC96: checks 
*** TURN *** [Th 9d 6h] [5h]
magdal28: bets $0.62
Dugipokers: folds 
Gintaras20: folds 
3EBC96: folds 
Uncalled bet ($0.62) returned to magdal28
magdal28 collected $1.19 from pot
magdal28: doesn't show hand 
*** SUMMARY ***
Total pot $1.25 | Rake $0.06 
Board [Th 9d 6h 5h]
Seat 1: prs420 folded before Flop (didn't bet)
Seat 2: Gintaras20 folded on the Turn
Seat 3: 3EBC96 (button) folded on the Turn
Seat 4: Gavinifold (small blind) folded before Flop
Seat 5: magdal28 (big blind) collected ($1.19)
Seat 6: Dugipokers folded on the Turn



PokerStars Hand #222960279459:  Hold'em No Limit ($0.05/$0.10 USD) - 2021/01/23 12:03:09 ET
Table 'Lutetia III' 6-max Seat #4 is the button
Seat 1: prs420 ($15.52 in chips) 
Seat 2: Gintaras20 ($9.40 in chips) 
Seat 3: 3EBC96 ($10.30 in chips) 
Seat 4: Gavinifold ($10.89 in chips) 
Seat 5: magdal28 ($10.89 in chips) 
Seat 6: Dugipokers ($10 in chips) 
magdal28: posts small blind $0.05
Dugipokers: posts big blind $0.10
*** HOLE CARDS ***
prs420: calls $0.10
Gintaras20: raises $0.15 to $0.25
3EBC96: folds 
Gavinifold: calls $0.25
magdal28: calls $0.20
Dugipokers: folds 
prs420: calls $0.15
*** FLOP *** [2d Td 5c]
magdal28: checks 
prs420: bets $0.20
Gintaras20: folds 
Gavinifold: calls $0.20
magdal28: raises $0.86 to $1.06
prs420: calls $0.86
Gavinifold: calls $0.86
*** TURN *** [2d Td 5c] [Jh]
magdal28: bets $2.45
prs420: folds 
Gavinifold: folds 
Uncalled bet ($2.45) returned to magdal28
magdal28 collected $4.09 from pot
magdal28: doesn't show hand 
*** SUMMARY ***
Total pot $4.28 | Rake $0.19 
Board [2d Td 5c Jh]
Seat 1: prs420 folded on the Turn
Seat 2: Gintaras20 folded on the Flop
Seat 3: 3EBC96 folded before Flop (didn't bet)
Seat 4: Gavinifold (button) folded on the Turn
Seat 5: magdal28 (small blind) collected ($4.09)
Seat 6: Dugipokers (big blind) folded before Flop



PokerStars Hand #222960329662:  Hold'em No Limit ($0.05/$0.10 USD) - 2021/01/23 12:04:29 ET
Table 'Lutetia III' 6-max Seat #5 is the button
Seat 1: prs420 ($14.21 in chips) 
Seat 2: Gintaras20 ($9.15 in chips) 
Seat 3: 3EBC96 ($10.30 in chips) 
Seat 4: Gavinifold ($9.58 in chips) 
Seat 5: magdal28 ($13.67 in chips) 
Seat 6: Dugipokers ($10 in chips) 
Dugipokers: posts small blind $0.05
prs420: posts big blind $0.10
*** HOLE CARDS ***
Gintaras20: folds 
3EBC96: raises $0.20 to $0.30
Gavinifold: folds 
magdal28: folds 
Dugipokers: folds 
prs420: folds 
Uncalled bet ($0.20) returned to 3EBC96
3EBC96 collected $0.25 from pot
3EBC96: doesn't show hand 
*** SUMMARY ***
Total pot $0.25 | Rake $0 
Seat 1: prs420 (big blind) folded before Flop
Seat 2: Gintaras20 folded before Flop (didn't bet)
Seat 3: 3EBC96 collected ($0.25)
Seat 4: Gavinifold folded before Flop (didn't bet)
Seat 5: magdal28 (button) folded before Flop (didn't bet)
Seat 6: Dugipokers (small blind) folded before Flop



PokerStars Hand #222960338387:  Hold'em No Limit ($0.05/$0.10 USD) - 2021/01/23 12:04:43 ET
Table 'Lutetia III' 6-max Seat #6 is the button
Seat 1: prs420 ($14.11 in chips) 
Seat 2: Gintaras20 ($9.15 in chips) 
Seat 3: 3EBC96 ($10.45 in chips) 
Seat 4: Gavinifold ($9.58 in chips) 
Seat 5: magdal28 ($13.67 in chips) 
Seat 6: Dugipokers ($10 in chips) 
prs420: posts small blind $0.05
Gintaras20: posts big blind $0.10
*** HOLE CARDS ***
3EBC96: folds 
Gavinifold: raises $0.10 to $0.20
magdal28: folds 
Dugipokers: folds 
prs420: folds 
Gintaras20: calls $0.10
*** FLOP *** [5c 2d 7c]
Gintaras20: checks 
Gavinifold: bets $0.10
Gintaras20: folds 
Uncalled bet ($0.10) returned to Gavinifold
Gavinifold collected $0.43 from pot
Gavinifold: doesn't show hand 
*** SUMMARY ***
Total pot $0.45 | Rake $0.02 
Board [5c 2d 7c]
Seat 1: prs420 (small blind) folded before Flop
Seat 2: Gintaras20 (big blind) folded on the Flop
Seat 3: 3EBC96 folded before Flop (didn't bet)
Seat 4: Gavinifold collected ($0.43)
Seat 5: magdal28 folded before Flop (didn't bet)
Seat 6: Dugipokers (button) folded before Flop (didn't bet)



PokerStars Hand #222960355200:  Hold'em No Limit ($0.05/$0.10 USD) - 2021/01/23 12:05:09 ET
Table 'Lutetia III' 6-max Seat #1 is the button
Seat 1: prs420 ($14.06 in chips) 
Seat 2: Gintaras20 ($8.95 in chips) 
Seat 3: 3EBC96 ($10.45 in chips) 
Seat 4: Gavinifold ($9.81 in chips) 
Seat 5: magdal28 ($13.67 in chips) 
Seat 6: Dugipokers ($10 in chips) 
Gintaras20: posts small blind $0.05
3EBC96: posts big blind $0.10
*** HOLE CARDS ***
Gavinifold: calls $0.10
magdal28: folds 
Dugipokers: folds 
prs420: calls $0.10
Gintaras20: calls $0.05
3EBC96: checks 
*** FLOP *** [Kd Qs 9h]
Gintaras20: bets $0.19
3EBC96: raises $0.41 to $0.60
Gavinifold: folds 
Gavinifold leaves the table
prs420: calls $0.60
Gintaras20: calls $0.41
*** TURN *** [Kd Qs 9h] [9s]
Gintaras20: bets $1.58
3EBC96: calls $1.58
prs420: calls $1.58
*** RIVER *** [Kd Qs 9h 9s] [5d]
Gintaras20: checks 
3EBC96: bets $4.97
prs420: folds 
Gintaras20: calls $4.97
*** SHOW DOWN ***
3EBC96: shows [Ts Jh] (a straight, Nine to King)
Gintaras20: mucks hand 
3EBC96 collected $16.12 from pot
*** SUMMARY ***
Total pot $16.88 | Rake $0.76 
Board [Kd Qs 9h 9s 5d]
Seat 1: prs420 (button) folded on the River
Seat 2: Gintaras20 (small blind) mucked
Seat 3: 3EBC96 (big blind) showed [Ts Jh] and won ($16.12) with a straight, Nine to King
Seat 4: Gavinifold folded on the Flop
Seat 5: magdal28 folded before Flop (didn't bet)
Seat 6: Dugipokers folded before Flop (didn't bet)



PokerStars Hand #222960407134:  Hold'em No Limit ($0.05/$0.10 USD) - 2021/01/23 12:06:32 ET
Table 'Lutetia III' 6-max Seat #2 is the button
Seat 1: prs420 ($11.78 in chips) 
Seat 2: Gintaras20 ($4 in chips) 
Seat 3: 3EBC96 ($19.32 in chips) 
Seat 5: magdal28 ($13.67 in chips) 
Seat 6: Dugipokers ($10 in chips) 
3EBC96: posts small blind $0.05
magdal28: posts big blind $0.10
*** HOLE CARDS ***
Dugipokers: folds 
prs420: calls $0.10
Gintaras20: raises $0.15 to $0.25
3EBC96: folds 
magdal28: folds 
prs420: raises $0.35 to $0.60
Gintaras20: folds 
Uncalled bet ($0.35) returned to prs420
prs420 collected $0.65 from pot
prs420: doesn't show hand 
*** SUMMARY ***
Total pot $0.65 | Rake $0 
Seat 1: prs420 collected ($0.65)
Seat 2: Gintaras20 (button) folded before Flop
Seat 3: 3EBC96 (small blind) folded before Flop
Seat 5: magdal28 (big blind) folded before Flop
Seat 6: Dugipokers folded before Flop (didn't bet)



PokerStars Hand #222960422353:  Hold'em No Limit ($0.05/$0.10 USD) - 2021/01/23 12:06:56 ET
Table 'Lutetia III' 6-max Seat #3 is the button
Seat 1: prs420 ($12.18 in chips) 
Seat 2: Gintaras20 ($9.75 in chips) 
Seat 3: 3EBC96 ($19.27 in chips) 
Seat 5: magdal28 ($13.57 in chips) 
Seat 6: Dugipokers ($10 in chips) 
magdal28: posts small blind $0.05
Dugipokers: posts big blind $0.10
*** HOLE CARDS ***
prs420: calls $0.10
Gintaras20: raises $0.30 to $0.40
3EBC96: folds 
magdal28: folds 
Dugipokers: folds 
prs420: calls $0.30
*** FLOP *** [7d Jh 3h]
prs420: checks 
Gintaras20: bets $0.68
prs420: folds 
Uncalled bet ($0.68) returned to Gintaras20
Gintaras20 collected $0.91 from pot
Gintaras20: doesn't show hand 
*** SUMMARY ***
Total pot $0.95 | Rake $0.04 
Board [7d Jh 3h]
Seat 1: prs420 folded on the Flop
Seat 2: Gintaras20 collected ($0.91)
Seat 3: 3EBC96 (button) folded before Flop (didn't bet)
Seat 5: magdal28 (small blind) folded before Flop
Seat 6: Dugipokers (big blind) folded before Flop



PokerStars Hand #222960441303:  Hold'em No Limit ($0.05/$0.10 USD) - 2021/01/23 12:07:26 ET
Table 'Lutetia III' 6-max Seat #5 is the button
Seat 1: prs420 ($11.78 in chips) 
Seat 2: Gintaras20 ($10.26 in chips) 
Seat 3: 3EBC96 ($19.27 in chips) 
Seat 5: magdal28 ($13.52 in chips) 
Seat 6: Dugipokers ($10 in chips) 
Dugipokers: posts small blind $0.05
prs420: posts big blind $0.10
*** HOLE CARDS ***
Gintaras20: raises $0.15 to $0.25
3EBC96: folds 
magdal28: folds 
Dugipokers: folds 
prs420: calls $0.15
*** FLOP *** [8d 3h 6c]
prs420: checks 
Gintaras20: bets $0.27
prs420: folds 
Uncalled bet ($0.27) returned to Gintaras20
Gintaras20 collected $0.53 from pot
Gintaras20: doesn't show hand 
*** SUMMARY ***
Total pot $0.55 | Rake $0.02 
Board [8d 3h 6c]
Seat 1: prs420 (big blind) folded on the Flop
Seat 2: Gintaras20 collected ($0.53)
Seat 3: 3EBC96 folded before Flop (didn't bet)
Seat 5: magdal28 (button) folded before Flop (didn't bet)
Seat 6: Dugipokers (small blind) folded before Flop



PokerStars Hand #222960457944:  Hold'em No Limit ($0.05/$0.10 USD) - 2021/01/23 12:07:52 ET
Table 'Lutetia III' 6-max Seat #6 is the button
Seat 1: prs420 ($11.53 in chips) 
Seat 2: Gintaras20 ($10.54 in chips) 
Seat 3: 3EBC96 ($19.27 in chips) 
Seat 5: magdal28 ($13.52 in chips) 
Seat 6: Dugipokers ($10 in chips) 
prs420: posts small blind $0.05
Gintaras20: posts big blind $0.10
*** HOLE CARDS ***
3EBC96: folds 
magdal28: folds 
Dugipokers: folds 
prs420: folds 
Uncalled bet ($0.05) returned to Gintaras20
Gintaras20 collected $0.10 from pot
Gintaras20: doesn't show hand 
*** SUMMARY ***
Total pot $0.10 | Rake $0 
Seat 1: prs420 (small blind) folded before Flop
Seat 2: Gintaras20 (big blind) collected ($0.10)
Seat 3: 3EBC96 folded before Flop (didn't bet)
Seat 5: magdal28 folded before Flop (didn't bet)
Seat 6: Dugipokers (button) folded before Flop (didn't bet)



PokerStars Hand #222960465370:  Hold'em No Limit ($0.05/$0.10 USD) - 2021/01/23 12:08:04 ET
Table 'Lutetia III' 6-max Seat #1 is the button
Seat 1: prs420 ($11.48 in chips) 
Seat 2: Gintaras20 ($10.59 in chips) 
Seat 3: 3EBC96 ($19.27 in chips) 
Seat 5: magdal28 ($13.52 in chips) 
Seat 6: Dugipokers ($10 in chips) 
Gintaras20: posts small blind $0.05
3EBC96: posts big blind $0.10
*** HOLE CARDS ***
magdal28: raises $0.15 to $0.25
Dugipokers: folds 
prs420: calls $0.25
Gintaras20: folds 
Hermit628 joins the table at seat #4 
3EBC96: calls $0.15
*** FLOP *** [6d 9c Ah]
3EBC96: checks 
magdal28: bets $0.40
prs420: folds 
3EBC96: folds 
Uncalled bet ($0.40) returned to magdal28
magdal28 collected $0.76 from pot
magdal28: doesn't show hand 
*** SUMMARY ***
Total pot $0.80 | Rake $0.04 
Board [6d 9c Ah]
Seat 1: prs420 (button) folded on the Flop
Seat 2: Gintaras20 (small blind) folded before Flop
Seat 3: 3EBC96 (big blind) folded on the Flop
Seat 5: magdal28 collected ($0.76)
Seat 6: Dugipokers folded before Flop (didn't bet)



PokerStars Hand #222960476346:  Hold'em No Limit ($0.05/$0.10 USD) - 2021/01/23 12:08:22 ET
Table 'Lutetia III' 6-max Seat #2 is the button
Seat 1: prs420 ($11.23 in chips) 
Seat 2: Gintaras20 ($10.54 in chips) 
Seat 3: 3EBC96 ($19.02 in chips) 
Seat 4: Hermit628 ($10 in chips) 
Seat 5: magdal28 ($14.03 in chips) 
Seat 6: Dugipokers ($10 in chips) 
3EBC96: posts small blind $0.05
Hermit628: posts big blind $0.10
*** HOLE CARDS ***
magdal28: folds 
Dugipokers: folds 
prs420: folds 
Gintaras20: folds 
3EBC96: folds 
Uncalled bet ($0.05) returned to Hermit628
Hermit628 collected $0.10 from pot
Hermit628: doesn't show hand 
*** SUMMARY ***
Total pot $0.10 | Rake $0 
Seat 1: prs420 folded before Flop (didn't bet)
Seat 2: Gintaras20 (button) folded before Flop (didn't bet)
Seat 3: 3EBC96 (small blind) folded before Flop
Seat 4: Hermit628 (big blind) collected ($0.10)
Seat 5: magdal28 folded before Flop (didn't bet)
Seat 6: Dugipokers folded before Flop (didn't bet)



PokerStars Hand #222960482285:  Hold'em No Limit ($0.05/$0.10 USD) - 2021/01/23 12:08:31 ET
Table 'Lutetia III' 6-max Seat #3 is the button
Seat 1: prs420 ($11.23 in chips) 
Seat 2: Gintaras20 ($10.54 in chips) 
Seat 3: 3EBC96 ($18.97 in chips) 
Seat 4: Hermit628 ($10.05 in chips) 
Seat 5: magdal28 ($14.03 in chips) 
Seat 6: Dugipokers ($10 in chips) 
Hermit628: posts small blind $0.05
magdal28: posts big blind $0.10
*** HOLE CARDS ***
Dugipokers: folds 
prs420: folds 
Gintaras20: folds 
3EBC96: folds 
Hermit628: folds 
Uncalled bet ($0.05) returned to magdal28
magdal28 collected $0.10 from pot
magdal28: doesn't show hand 
*** SUMMARY ***
Total pot $0.10 | Rake $0 
Seat 1: prs420 folded before Flop (didn't bet)
Seat 2: Gintaras20 folded before Flop (didn't bet)
Seat 3: 3EBC96 (button) folded before Flop (didn't bet)
Seat 4: Hermit628 (small blind) folded before Flop
Seat 5: magdal28 (big blind) collected ($0.10)
Seat 6: Dugipokers folded before Flop (didn't bet)



PokerStars Hand #222960490072:  Hold'em No Limit ($0.05/$0.10 USD) - 2021/01/23 12:08:43 ET
Table 'Lutetia III' 6-max Seat #4 is the button
Seat 1: prs420 ($11.23 in chips) 
Seat 2: Gintaras20 ($10.54 in chips) 
Seat 3: 3EBC96 ($18.97 in chips) 
Seat 4: Hermit628 ($10 in chips) 
Seat 5: magdal28 ($14.08 in chips) 
Seat 6: Dugipokers ($10 in chips) 
magdal28: posts small blind $0.05
Dugipokers: posts big blind $0.10
*** HOLE CARDS ***
prs420: folds 
Gintaras20: folds 
3EBC96: folds 
Hermit628: raises $0.15 to $0.25
magdal28: folds 
Dugipokers: folds 
Uncalled bet ($0.15) returned to Hermit628
Hermit628 collected $0.25 from pot
Hermit628: doesn't show hand 
*** SUMMARY ***
Total pot $0.25 | Rake $0 
Seat 1: prs420 folded before Flop (didn't bet)
Seat 2: Gintaras20 folded before Flop (didn't bet)
Seat 3: 3EBC96 folded before Flop (didn't bet)
Seat 4: Hermit628 (button) collected ($0.25)
Seat 5: magdal28 (small blind) folded before Flop
Seat 6: Dugipokers (big blind) folded before Flop



PokerStars Hand #222960498958:  Hold'em No Limit ($0.05/$0.10 USD) - 2021/01/23 12:08:57 ET
Table 'Lutetia III' 6-max Seat #5 is the button
Seat 1: prs420 ($11.23 in chips) 
Seat 2: Gintaras20 ($10.54 in chips) 
Seat 3: 3EBC96 ($18.97 in chips) 
Seat 4: Hermit628 ($10.15 in chips) 
Seat 5: magdal28 ($14.03 in chips) 
Seat 6: Dugipokers ($10 in chips) 
Dugipokers: posts small blind $0.05
prs420: posts big blind $0.10
*** HOLE CARDS ***
Gintaras20: folds 
3EBC96: folds 
Hermit628: folds 
magdal28: raises $0.15 to $0.25
Dugipokers: folds 
prs420: calls $0.15
*** FLOP *** [Js 3d 6c]
prs420: checks 
magdal28: checks 
*** TURN *** [Js 3d 6c] [Jc]
prs420: checks 
magdal28: checks 
*** RIVER *** [Js 3d 6c Jc] [6h]
prs420: checks 
magdal28: checks 
*** SHOW DOWN ***
prs420: shows [Tc 9h] (two pair, Jacks and Sixes)
magdal28: shows [5h As] (two pair, Jacks and Sixes - Ace kicker)
magdal28 collected $0.53 from pot
*** SUMMARY ***
Total pot $0.55 | Rake $0.02 
Board [Js 3d 6c Jc 6h]
Seat 1: prs420 (big blind) showed [Tc 9h] and lost with two pair, Jacks and Sixes
Seat 2: Gintaras20 folded before Flop (didn't bet)
Seat 3: 3EBC96 folded before Flop (didn't bet)
Seat 4: Hermit628 folded before Flop (didn't bet)
Seat 5: magdal28 (button) showed [5h As] and won ($0.53) with two pair, Jacks and Sixes
Seat 6: Dugipokers (small blind) folded before Flop



PokerStars Hand #222960533209:  Hold'em No Limit ($0.05/$0.10 USD) - 2021/01/23 12:09:52 ET
Table 'Lutetia III' 6-max Seat #6 is the button
Seat 1: prs420 ($10.98 in chips) 
Seat 2: Gintaras20 ($10.54 in chips) 
Seat 3: 3EBC96 ($18.97 in chips) 
Seat 4: Hermit628 ($10.15 in chips) 
Seat 5: magdal28 ($14.31 in chips) 
Seat 6: Dugipokers ($10 in chips) 
prs420: posts small blind $0.05
Gintaras20: posts big blind $0.10
*** HOLE CARDS ***
3EBC96: folds 
Hermit628: folds 
magdal28: raises $0.15 to $0.25
Dugipokers: folds 
prs420: calls $0.20
Gintaras20: folds 
*** FLOP *** [4c 9h Qs]
prs420: checks 
magdal28: bets $0.30
prs420: folds 
Uncalled bet ($0.30) returned to magdal28
magdal28 collected $0.57 from pot
magdal28: doesn't show hand 
*** SUMMARY ***
Total pot $0.60 | Rake $0.03 
Board [4c 9h Qs]
Seat 1: prs420 (small blind) folded on the Flop
Seat 2: Gintaras20 (big blind) folded before Flop
Seat 3: 3EBC96 folded before Flop (didn't bet)
Seat 4: Hermit628 folded before Flop (didn't bet)
Seat 5: magdal28 collected ($0.57)
Seat 6: Dugipokers (button) folded before Flop (didn't bet)



PokerStars Hand #222960549669:  Hold'em No Limit ($0.05/$0.10 USD) - 2021/01/23 12:10:18 ET
Table 'Lutetia III' 6-max Seat #1 is the button
Seat 1: prs420 ($10.73 in chips) 
Seat 2: Gintaras20 ($10.44 in chips) 
Seat 3: 3EBC96 ($18.97 in chips) 
Seat 4: Hermit628 ($10.15 in chips) 
Seat 5: magdal28 ($14.63 in chips) 
Seat 6: Dugipokers ($10 in chips) 
Gintaras20: posts small blind $0.05
3EBC96: posts big blind $0.10
*** HOLE CARDS ***
Hermit628: folds 
magdal28: folds 
Dugipokers: folds 
prs420: calls $0.10
Gintaras20: folds 
3EBC96: raises $0.40 to $0.50
prs420: folds 
Uncalled bet ($0.40) returned to 3EBC96
Gintaras20 leaves the table
3EBC96 collected $0.25 from pot
3EBC96: doesn't show hand 
*** SUMMARY ***
Total pot $0.25 | Rake $0 
Seat 1: prs420 (button) folded before Flop
Seat 2: Gintaras20 (small blind) folded before Flop
Seat 3: 3EBC96 (big blind) collected ($0.25)
Seat 4: Hermit628 folded before Flop (didn't bet)
Seat 5: magdal28 folded before Flop (didn't bet)
Seat 6: Dugipokers folded before Flop (didn't bet)



PokerStars Hand #222960559380:  Hold'em No Limit ($0.05/$0.10 USD) - 2021/01/23 12:10:33 ET
Table 'Lutetia III' 6-max Seat #3 is the button
Seat 1: prs420 ($10.63 in chips) 
Seat 3: 3EBC96 ($19.12 in chips) 
Seat 4: Hermit628 ($10.15 in chips) 
Seat 5: magdal28 ($14.63 in chips) 
Seat 6: Dugipokers ($10 in chips) 
Hermit628: posts small blind $0.05
magdal28: posts big blind $0.10
*** HOLE CARDS ***
Dugipokers: folds 
prs420: folds 
3EBC96: folds 
Hermit628: folds 
Uncalled bet ($0.05) returned to magdal28
magdal28 collected $0.10 from pot
magdal28: doesn't show hand 
*** SUMMARY ***
Total pot $0.10 | Rake $0 
Seat 1: prs420 folded before Flop (didn't bet)
Seat 3: 3EBC96 (button) folded before Flop (didn't bet)
Seat 4: Hermit628 (small blind) folded before Flop
Seat 5: magdal28 (big blind) collected ($0.10)
Seat 6: Dugipokers folded before Flop (didn't bet)



PokerStars Hand #222960563889:  Hold'em No Limit ($0.05/$0.10 USD) - 2021/01/23 12:10:40 ET
Table 'Lutetia III' 6-max Seat #4 is the button
Seat 1: prs420 ($10.63 in chips) 
Seat 3: 3EBC96 ($19.12 in chips) 
Seat 4: Hermit628 ($10.10 in chips) 
Seat 5: magdal28 ($14.68 in chips) 
Seat 6: Dugipokers ($10 in chips) 
magdal28: posts small blind $0.05
Dugipokers: posts big blind $0.10
*** HOLE CARDS ***
prs420: folds 
3EBC96: folds 
Hermit628: folds 
magdal28: folds 
Uncalled bet ($0.05) returned to Dugipokers
Dugipokers collected $0.10 from pot
Dugipokers: doesn't show hand 
*** SUMMARY ***
Total pot $0.10 | Rake $0 
Seat 1: prs420 folded before Flop (didn't bet)
Seat 3: 3EBC96 folded before Flop (didn't bet)
Seat 4: Hermit628 (button) folded before Flop (didn't bet)
Seat 5: magdal28 (small blind) folded before Flop
Seat 6: Dugipokers (big blind) collected ($0.10)



PokerStars Hand #222960572296:  Hold'em No Limit ($0.05/$0.10 USD) - 2021/01/23 12:10:54 ET
Table 'Lutetia III' 6-max Seat #5 is the button
Seat 1: prs420 ($10.63 in chips) 
Seat 3: 3EBC96 ($19.12 in chips) 
Seat 4: Hermit628 ($10.10 in chips) 
Seat 5: magdal28 ($14.63 in chips) 
Seat 6: Dugipokers ($10.05 in chips) 
Dugipokers: posts small blind $0.05
prs420: posts big blind $0.10
*** HOLE CARDS ***
3EBC96: folds 
Hermit628: folds 
magdal28: folds 
Dugipokers: raises $0.20 to $0.30
prs420: raises $0.60 to $0.90
LocalFixer joins the table at seat #2 
Dugipokers: raises $1.35 to $2.25
prs420: raises $8.38 to $10.63 and is all-in
Dugipokers: calls $7.80 and is all-in
Uncalled bet ($0.58) returned to prs420
*** FLOP *** [9c Jd Td]
*** TURN *** [9c Jd Td] [Qc]
*** RIVER *** [9c Jd Td Qc] [8s]
*** SHOW DOWN ***
Dugipokers: shows [Ks Ah] (a straight, Ten to Ace)
prs420: shows [5s 5d] (a straight, Eight to Queen)
Dugipokers cashed out the hand for $8.63 | Cash Out Fee $0.09
*** SUMMARY ***
Total pot $20.10 | Rake $0.90 
Board [9c Jd Td Qc 8s]
Seat 1: prs420 (big blind) showed [5s 5d] and lost with a straight, Eight to Queen
Seat 3: 3EBC96 folded before Flop (didn't bet)
Seat 4: Hermit628 folded before Flop (didn't bet)
Seat 5: magdal28 (button) folded before Flop (didn't bet)
Seat 6: Dugipokers (small blind) showed [Ks Ah] and won ($19.20) with a straight, Ten to Ace (pot not awarded as player cashed out)



PokerStars Hand #222960596752:  Hold'em No Limit ($0.05/$0.10 USD) - 2021/01/23 12:11:33 ET
Table 'Lutetia III' 6-max Seat #6 is the button
Seat 1: prs420 ($0.58 in chips) 
Seat 2: LocalFixer ($10 in chips) 
Seat 3: 3EBC96 ($19.12 in chips) 
Seat 4: Hermit628 ($10.10 in chips) 
Seat 5: magdal28 ($14.63 in chips) 
Seat 6: Dugipokers ($10 in chips) 
prs420: posts small blind $0.05
LocalFixer: posts big blind $0.10
*** HOLE CARDS ***
3EBC96: folds 
Hermit628: raises $0.15 to $0.25
magdal28: raises $0.65 to $0.90
Dugipokers: folds 
prs420: calls $0.53 and is all-in
LocalFixer: folds 
Hermit628: calls $0.65
*** FLOP *** [Kd 3d Th]
Hermit628: checks 
magdal28: bets $1.23
Hermit628: calls $1.23
*** TURN *** [Kd 3d Th] [9d]
Hermit628: checks 
magdal28: checks 
*** RIVER *** [Kd 3d Th 9d] [2c]
Hermit628: checks 
magdal28: checks 
*** SHOW DOWN ***
Hermit628: shows [Jh Ac] (high card Ace)
magdal28: shows [Tc Jc] (a pair of Tens)
magdal28 collected $2.96 from side pot
prs420: shows [Ah Ad] (a pair of Aces)
prs420 collected $1.76 from main pot
*** SUMMARY ***
Total pot $4.94 Main pot $1.76. Side pot $2.96. | Rake $0.22 
Board [Kd 3d Th 9d 2c]
Seat 1: prs420 (small blind) showed [Ah Ad] and won ($1.76) with a pair of Aces
Seat 2: LocalFixer (big blind) folded before Flop
Seat 3: 3EBC96 folded before Flop (didn't bet)
Seat 4: Hermit628 showed [Jh Ac] and lost with high card Ace
Seat 5: magdal28 showed [Tc Jc] and won ($2.96) with a pair of Tens
Seat 6: Dugipokers (button) folded before Flop (didn't bet)



PokerStars Hand #222960627876:  Hold'em No Limit ($0.05/$0.10 USD) - 2021/01/23 12:12:22 ET
Table 'Lutetia III' 6-max Seat #1 is the button
Seat 1: prs420 ($1.76 in chips) 
Seat 2: LocalFixer ($10 in chips) 
Seat 3: 3EBC96 ($19.12 in chips) 
Seat 4: Hermit628 ($10 in chips) 
Seat 5: magdal28 ($15.46 in chips) 
Seat 6: Dugipokers ($10 in chips) 
LocalFixer: posts small blind $0.05
3EBC96: posts big blind $0.10
*** HOLE CARDS ***
Hermit628: folds 
magdal28: folds 
Dugipokers: raises $0.15 to $0.25
prs420: raises $0.65 to $0.90
LocalFixer: folds 
3EBC96: folds 
Dugipokers: folds 
Uncalled bet ($0.65) returned to prs420
prs420 collected $0.65 from pot
prs420: doesn't show hand 
*** SUMMARY ***
Total pot $0.65 | Rake $0 
Seat 1: prs420 (button) collected ($0.65)
Seat 2: LocalFixer (small blind) folded before Flop
Seat 3: 3EBC96 (big blind) folded before Flop
Seat 4: Hermit628 folded before Flop (didn't bet)
Seat 5: magdal28 folded before Flop (didn't bet)
Seat 6: Dugipokers folded before Flop



PokerStars Hand #222960640797:  Hold'em No Limit ($0.05/$0.10 USD) - 2021/01/23 12:12:42 ET
Table 'Lutetia III' 6-max Seat #2 is the button
Seat 1: prs420 ($2.16 in chips) 
Seat 2: LocalFixer ($10 in chips) 
Seat 3: 3EBC96 ($19.02 in chips) 
Seat 4: Hermit628 ($10 in chips) 
Seat 5: magdal28 ($15.46 in chips) 
Seat 6: Dugipokers ($10 in chips) 
3EBC96: posts small blind $0.05
Hermit628: posts big blind $0.10
*** HOLE CARDS ***
magdal28: folds 
Dugipokers: folds 
prs420: raises $0.20 to $0.30
LocalFixer: folds 
3EBC96: folds 
Hermit628: folds 
Uncalled bet ($0.20) returned to prs420
prs420 collected $0.25 from pot
prs420: doesn't show hand 
*** SUMMARY ***
Total pot $0.25 | Rake $0 
Seat 1: prs420 collected ($0.25)
Seat 2: LocalFixer (button) folded before Flop (didn't bet)
Seat 3: 3EBC96 (small blind) folded before Flop
Seat 4: Hermit628 (big blind) folded before Flop
Seat 5: magdal28 folded before Flop (didn't bet)
Seat 6: Dugipokers folded before Flop (didn't bet)



PokerStars Hand #222960648088:  Hold'em No Limit ($0.05/$0.10 USD) - 2021/01/23 12:12:54 ET
Table 'Lutetia III' 6-max Seat #3 is the button
Seat 1: prs420 ($2.31 in chips) 
Seat 2: LocalFixer ($10 in chips) 
Seat 3: 3EBC96 ($18.97 in chips) 
Seat 4: Hermit628 ($10 in chips) 
Seat 5: magdal28 ($15.46 in chips) 
Seat 6: Dugipokers ($10 in chips) 
Hermit628: posts small blind $0.05
magdal28: posts big blind $0.10
*** HOLE CARDS ***
Dugipokers: folds 
prs420: raises $0.20 to $0.30
LocalFixer: folds 
3EBC96: folds 
Hermit628: calls $0.25
magdal28: calls $0.20
*** FLOP *** [3h 6c Ad]
Hermit628: checks 
magdal28: checks 
prs420: bets $2.01 and is all-in
Hermit628: folds 
magdal28: folds 
Uncalled bet ($2.01) returned to prs420
prs420 collected $0.86 from pot
prs420: doesn't show hand 
*** SUMMARY ***
Total pot $0.90 | Rake $0.04 
Board [3h 6c Ad]
Seat 1: prs420 collected ($0.86)
Seat 2: LocalFixer folded before Flop (didn't bet)
Seat 3: 3EBC96 (button) folded before Flop (didn't bet)
Seat 4: Hermit628 (small blind) folded on the Flop
Seat 5: magdal28 (big blind) folded on the Flop
Seat 6: Dugipokers folded before Flop (didn't bet)



PokerStars Hand #222960672622:  Hold'em No Limit ($0.05/$0.10 USD) - 2021/01/23 12:13:31 ET
Table 'Lutetia III' 6-max Seat #4 is the button
Seat 1: prs420 ($2.87 in chips) 
Seat 2: LocalFixer ($10 in chips) 
Seat 3: 3EBC96 ($18.97 in chips) 
Seat 4: Hermit628 ($10 in chips) 
Seat 5: magdal28 ($15.16 in chips) 
Seat 6: Dugipokers ($10 in chips) 
magdal28: posts small blind $0.05
Dugipokers: posts big blind $0.10
*** HOLE CARDS ***
prs420: raises $0.20 to $0.30
LocalFixer: folds 
3EBC96: folds 
Hermit628: folds 
magdal28: folds 
Dugipokers: folds 
Uncalled bet ($0.20) returned to prs420
prs420 collected $0.25 from pot
prs420: doesn't show hand 
*** SUMMARY ***
Total pot $0.25 | Rake $0 
Seat 1: prs420 collected ($0.25)
Seat 2: LocalFixer folded before Flop (didn't bet)
Seat 3: 3EBC96 folded before Flop (didn't bet)
Seat 4: Hermit628 (button) folded before Flop (didn't bet)
Seat 5: magdal28 (small blind) folded before Flop
Seat 6: Dugipokers (big blind) folded before Flop



PokerStars Hand #222960683864:  Hold'em No Limit ($0.05/$0.10 USD) - 2021/01/23 12:13:49 ET
Table 'Lutetia III' 6-max Seat #5 is the button
Seat 1: prs420 ($3.02 in chips) 
Seat 2: LocalFixer ($10 in chips) 
Seat 3: 3EBC96 ($18.97 in chips) 
Seat 4: Hermit628 ($10 in chips) 
Seat 5: magdal28 ($15.11 in chips) 
Seat 6: Dugipokers ($10 in chips) 
Dugipokers: posts small blind $0.05
prs420: posts big blind $0.10
*** HOLE CARDS ***
LocalFixer: folds 
3EBC96 has timed out
3EBC96: folds 
Hermit628: folds 
magdal28: folds 
Dugipokers: folds 
Uncalled bet ($0.05) returned to prs420
prs420 collected $0.10 from pot
prs420: doesn't show hand 
*** SUMMARY ***
Total pot $0.10 | Rake $0 
Seat 1: prs420 (big blind) collected ($0.10)
Seat 2: LocalFixer folded before Flop (didn't bet)
Seat 3: 3EBC96 folded before Flop (didn't bet)
Seat 4: Hermit628 folded before Flop (didn't bet)
Seat 5: magdal28 (button) folded before Flop (didn't bet)
Seat 6: Dugipokers (small blind) folded before Flop



PokerStars Hand #222960698212:  Hold'em No Limit ($0.05/$0.10 USD) - 2021/01/23 12:14:11 ET
Table 'Lutetia III' 6-max Seat #6 is the button
Seat 1: prs420 ($3.07 in chips) 
Seat 2: LocalFixer ($10 in chips) 
Seat 3: 3EBC96 ($18.97 in chips) 
Seat 4: Hermit628 ($10 in chips) 
Seat 5: magdal28 ($15.11 in chips) 
Seat 6: Dugipokers ($10 in chips) 
prs420: posts small blind $0.05
LocalFixer: posts big blind $0.10
*** HOLE CARDS ***
3EBC96: folds 
Hermit628: folds 
magdal28: folds 
Dugipokers: raises $0.15 to $0.25
prs420: raises $0.60 to $0.85
LocalFixer: folds 
Dugipokers: raises $4.60 to $5.45
prs420: calls $2.22 and is all-in
Uncalled bet ($2.38) returned to Dugipokers
*** FLOP *** [Qh 3s 2c]
*** TURN *** [Qh 3s 2c] [3d]
*** RIVER *** [Qh 3s 2c 3d] [Ad]
*** SHOW DOWN ***
prs420: shows [2h Ac] (two pair, Aces and Threes)
Dugipokers: shows [Kh Ah] (two pair, Aces and Threes - King kicker)
Dugipokers cashed out the hand for $4.42 | Cash Out Fee $0.04
*** SUMMARY ***
Total pot $6.24 | Rake $0.28 
Board [Qh 3s 2c 3d Ad]
Seat 1: prs420 (small blind) showed [2h Ac] and lost with two pair, Aces and Threes
Seat 2: LocalFixer (big blind) folded before Flop
Seat 3: 3EBC96 folded before Flop (didn't bet)
Seat 4: Hermit628 folded before Flop (didn't bet)
Seat 5: magdal28 folded before Flop (didn't bet)
Seat 6: Dugipokers (button) showed [Kh Ah] and won ($5.96) with two pair, Aces and Threes (pot not awarded as player cashed out)



PokerStars Hand #222960716647:  Hold'em No Limit ($0.05/$0.10 USD) - 2021/01/23 12:14:41 ET
Table 'Lutetia III' 6-max Seat #2 is the button
Seat 2: LocalFixer ($10 in chips) 
Seat 3: 3EBC96 ($18.97 in chips) 
Seat 4: Hermit628 ($10 in chips) 
Seat 5: magdal28 ($15.11 in chips) 
Seat 6: Dugipokers ($11.35 in chips) 
3EBC96: posts small blind $0.05
Hermit628: posts big blind $0.10
*** HOLE CARDS ***
magdal28: folds 
Dugipokers: raises $0.15 to $0.25
LocalFixer: folds 
3EBC96: folds 
Hermit628: folds 
Uncalled bet ($0.15) returned to Dugipokers
Dugipokers collected $0.25 from pot
Dugipokers: doesn't show hand 
*** SUMMARY ***
Total pot $0.25 | Rake $0 
Seat 2: LocalFixer (button) folded before Flop (didn't bet)
Seat 3: 3EBC96 (small blind) folded before Flop
Seat 4: Hermit628 (big blind) folded before Flop
Seat 5: magdal28 folded before Flop (didn't bet)
Seat 6: Dugipokers collected ($0.25)



PokerStars Hand #222960723544:  Hold'em No Limit ($0.05/$0.10 USD) - 2021/01/23 12:14:52 ET
Table 'Lutetia III' 6-max Seat #3 is the button
Seat 2: LocalFixer ($10 in chips) 
Seat 3: 3EBC96 ($18.92 in chips) 
Seat 4: Hermit628 ($10 in chips) 
Seat 5: magdal28 ($15.11 in chips) 
Seat 6: Dugipokers ($11.50 in chips) 
Hermit628: posts small blind $0.05
magdal28: posts big blind $0.10
*** HOLE CARDS ***
Dugipokers: folds 
prs420 leaves the table
LocalFixer: folds 
3EBC96: folds 
Hermit628: raises $0.15 to $0.25
Dugipokers leaves the table
grogga1 joins the table at seat #6 
magdal28: folds 
Uncalled bet ($0.15) returned to Hermit628
Hermit628 collected $0.20 from pot
Hermit628: doesn't show hand 
3EBC96 leaves the table
HotMilk2020 joins the table at seat #1 
*** SUMMARY ***
Total pot $0.20 | Rake $0 
Seat 2: LocalFixer folded before Flop (didn't bet)
Seat 3: 3EBC96 (button) folded before Flop (didn't bet)
Seat 4: Hermit628 (small blind) collected ($0.20)
Seat 5: magdal28 (big blind) folded before Flop
Seat 6: Dugipokers folded before Flop (didn't bet)



PokerStars Hand #222960733676:  Hold'em No Limit ($0.05/$0.10 USD) - 2021/01/23 12:15:08 ET
Table 'Lutetia III' 6-max Seat #4 is the button
Seat 2: LocalFixer ($10 in chips) 
Seat 4: Hermit628 ($10.10 in chips) 
Seat 5: magdal28 ($15.01 in chips) 
Seat 6: grogga1 ($8 in chips) 
magdal28: posts small blind $0.05
grogga1: posts big blind $0.10
HotMilk2020: sits out 
*** HOLE CARDS ***
LocalFixer: raises $0.20 to $0.30
Hermit628: folds 
Dugipokers joins the table at seat #3 
magdal28: folds 
grogga1: folds 
Uncalled bet ($0.20) returned to LocalFixer
LocalFixer collected $0.25 from pot
LocalFixer: doesn't show hand 
*** SUMMARY ***
Total pot $0.25 | Rake $0 
Seat 2: LocalFixer collected ($0.25)
Seat 4: Hermit628 (button) folded before Flop (didn't bet)
Seat 5: magdal28 (small blind) folded before Flop
Seat 6: grogga1 (big blind) folded before Flop



PokerStars Hand #222960740892:  Hold'em No Limit ($0.05/$0.10 USD) - 2021/01/23 12:15:19 ET
Table 'Lutetia III' 6-max Seat #5 is the button
Seat 1: HotMilk2020 ($10 in chips) 
Seat 2: LocalFixer ($10.15 in chips) 
Seat 4: Hermit628 ($10.10 in chips) 
Seat 5: magdal28 ($14.96 in chips) 
Seat 6: grogga1 ($7.90 in chips) 
grogga1: posts small blind $0.05
HotMilk2020: posts big blind $0.10
Dugipokers: sits out 
*** HOLE CARDS ***
LocalFixer: folds 
Hermit628: raises $0.15 to $0.25
magdal28: folds 
grogga1: folds 
HotMilk2020: folds 
Uncalled bet ($0.15) returned to Hermit628
Hermit628 collected $0.25 from pot
Hermit628: doesn't show hand 
*** SUMMARY ***
Total pot $0.25 | Rake $0 
Seat 1: HotMilk2020 (big blind) folded before Flop
Seat 2: LocalFixer folded before Flop (didn't bet)
Seat 4: Hermit628 collected ($0.25)
Seat 5: magdal28 (button) folded before Flop (didn't bet)
Seat 6: grogga1 (small blind) folded before Flop



PokerStars Hand #222960753772:  Hold'em No Limit ($0.05/$0.10 USD) - 2021/01/23 12:15:40 ET
Table 'Lutetia III' 6-max Seat #6 is the button
Seat 1: HotMilk2020 ($9.90 in chips) 
Seat 2: LocalFixer ($10.15 in chips) 
Seat 4: Hermit628 ($10.25 in chips) 
Seat 5: magdal28 ($14.96 in chips) 
Seat 6: grogga1 ($7.85 in chips) 
HotMilk2020: posts small blind $0.05
LocalFixer: posts big blind $0.10
Dugipokers: sits out 
*** HOLE CARDS ***
Hermit628: raises $0.15 to $0.25
magdal28: folds 
grogga1: folds 
HotMilk2020: folds 
LocalFixer: folds 
Uncalled bet ($0.15) returned to Hermit628
Hermit628 collected $0.25 from pot
Hermit628: doesn't show hand 
*** SUMMARY ***
Total pot $0.25 | Rake $0 
Seat 1: HotMilk2020 (small blind) folded before Flop
Seat 2: LocalFixer (big blind) folded before Flop
Seat 4: Hermit628 collected ($0.25)
Seat 5: magdal28 folded before Flop (didn't bet)
Seat 6: grogga1 (button) folded before Flop (didn't bet)



PokerStars Hand #222960761757:  Hold'em No Limit ($0.05/$0.10 USD) - 2021/01/23 12:15:52 ET
Table 'Lutetia III' 6-max Seat #1 is the button
Seat 1: HotMilk2020 ($9.85 in chips) 
Seat 2: LocalFixer ($10.05 in chips) 
Seat 3: Dugipokers ($11.50 in chips) 
Seat 4: Hermit628 ($10.40 in chips) 
Seat 5: magdal28 ($14.96 in chips) 
Seat 6: grogga1 ($7.85 in chips) 
LocalFixer: posts small blind $0.05
Dugipokers: posts big blind $0.10
*** HOLE CARDS ***
Hermit628: folds 
magdal28: folds 
grogga1: folds 
HotMilk2020: calls $0.10
LocalFixer: folds 
Dugipokers: checks 
*** FLOP *** [Tc 3c Kd]
Dugipokers: checks 
HotMilk2020: checks 
*** TURN *** [Tc 3c Kd] [2h]
Dugipokers: checks 
HotMilk2020: checks 
*** RIVER *** [Tc 3c Kd 2h] [4d]
Dugipokers: checks 
HotMilk2020: checks 
*** SHOW DOWN ***
Dugipokers: shows [2d 6s] (a pair of Deuces)
HotMilk2020: mucks hand 
Dugipokers collected $0.24 from pot
*** SUMMARY ***
Total pot $0.25 | Rake $0.01 
Board [Tc 3c Kd 2h 4d]
Seat 1: HotMilk2020 (button) mucked
Seat 2: LocalFixer (small blind) folded before Flop
Seat 3: Dugipokers (big blind) showed [2d 6s] and won ($0.24) with a pair of Deuces
Seat 4: Hermit628 folded before Flop (didn't bet)
Seat 5: magdal28 folded before Flop (didn't bet)
Seat 6: grogga1 folded before Flop (didn't bet)



PokerStars Hand #222960798902:  Hold'em No Limit ($0.05/$0.10 USD) - 2021/01/23 12:16:51 ET
Table 'Lutetia III' 6-max Seat #2 is the button
Seat 1: HotMilk2020 ($9.75 in chips) 
Seat 2: LocalFixer ($10 in chips) 
Seat 3: Dugipokers ($11.64 in chips) 
Seat 4: Hermit628 ($10.40 in chips) 
Seat 5: magdal28 ($14.96 in chips) 
Seat 6: grogga1 ($7.85 in chips) 
Dugipokers: posts small blind $0.05
Hermit628: posts big blind $0.10
*** HOLE CARDS ***
magdal28: folds 
grogga1: folds 
magdal28 leaves the table
HotMilk2020: calls $0.10
LocalFixer: folds 
Dugipokers: folds 
Hermit628: checks 
*** FLOP *** [2h 9s 6c]
Hermit628: checks 
Kobert72 joins the table at seat #5 
HotMilk2020: checks 
*** TURN *** [2h 9s 6c] [Jd]
Hermit628: checks 
HotMilk2020: checks 
*** RIVER *** [2h 9s 6c Jd] [Ts]
Hermit628: checks 
HotMilk2020: bets $0.10
Hermit628: calls $0.10
*** SHOW DOWN ***
HotMilk2020: shows [Jh 4h] (a pair of Jacks)
Hermit628: mucks hand 
HotMilk2020 collected $0.43 from pot
*** SUMMARY ***
Total pot $0.45 | Rake $0.02 
Board [2h 9s 6c Jd Ts]
Seat 1: HotMilk2020 showed [Jh 4h] and won ($0.43) with a pair of Jacks
Seat 2: LocalFixer (button) folded before Flop (didn't bet)
Seat 3: Dugipokers (small blind) folded before Flop
Seat 4: Hermit628 (big blind) mucked
Seat 5: magdal28 folded before Flop (didn't bet)
Seat 6: grogga1 folded before Flop (didn't bet)



PokerStars Hand #222960819924:  Hold'em No Limit ($0.05/$0.10 USD) - 2021/01/23 12:17:24 ET
Table 'Lutetia III' 6-max Seat #3 is the button
Seat 1: HotMilk2020 ($9.98 in chips) 
Seat 2: LocalFixer ($10 in chips) 
Seat 3: Dugipokers ($11.59 in chips) 
Seat 4: Hermit628 ($10.20 in chips) 
Seat 5: Kobert72 ($8 in chips) 
Seat 6: grogga1 ($7.85 in chips) 
Hermit628: posts small blind $0.05
Kobert72: posts big blind $0.10
*** HOLE CARDS ***
grogga1: folds 
HotMilk2020: folds 
LocalFixer: raises $0.20 to $0.30
Dugipokers: folds 
Hermit628: folds 
Kobert72: folds 
Uncalled bet ($0.20) returned to LocalFixer
LocalFixer collected $0.25 from pot
LocalFixer: doesn't show hand 
*** SUMMARY ***
Total pot $0.25 | Rake $0 
Seat 1: HotMilk2020 folded before Flop (didn't bet)
Seat 2: LocalFixer collected ($0.25)
Seat 3: Dugipokers (button) folded before Flop (didn't bet)
Seat 4: Hermit628 (small blind) folded before Flop
Seat 5: Kobert72 (big blind) folded before Flop
Seat 6: grogga1 folded before Flop (didn't bet)



PokerStars Hand #222960832592:  Hold'em No Limit ($0.05/$0.10 USD) - 2021/01/23 12:17:44 ET
Table 'Lutetia III' 6-max Seat #4 is the button
Seat 1: HotMilk2020 ($9.98 in chips) 
Seat 2: LocalFixer ($10.15 in chips) 
Seat 3: Dugipokers ($11.59 in chips) 
Seat 4: Hermit628 ($10.15 in chips) 
Seat 5: Kobert72 ($10 in chips) 
Seat 6: grogga1 ($7.85 in chips) 
Kobert72: posts small blind $0.05
grogga1: posts big blind $0.10
*** HOLE CARDS ***
HotMilk2020: calls $0.10
LocalFixer: folds 
Dugipokers: raises $0.30 to $0.40
Hermit628: folds 
Kobert72: folds 
grogga1: folds 
HotMilk2020: calls $0.30
*** FLOP *** [Ac 2d 9c]
HotMilk2020: checks 
Dugipokers: bets $0.30
HotMilk2020: calls $0.30
*** TURN *** [Ac 2d 9c] [5d]
HotMilk2020: checks 
Dugipokers: checks 
*** RIVER *** [Ac 2d 9c 5d] [9h]
HotMilk2020: checks 
Dugipokers: checks 
*** SHOW DOWN ***
HotMilk2020: shows [5c 4c] (two pair, Nines and Fives)
Dugipokers: shows [Jh Jc] (two pair, Jacks and Nines)
Dugipokers collected $1.48 from pot
*** SUMMARY ***
Total pot $1.55 | Rake $0.07 
Board [Ac 2d 9c 5d 9h]
Seat 1: HotMilk2020 showed [5c 4c] and lost with two pair, Nines and Fives
Seat 2: LocalFixer folded before Flop (didn't bet)
Seat 3: Dugipokers showed [Jh Jc] and won ($1.48) with two pair, Jacks and Nines
Seat 4: Hermit628 (button) folded before Flop (didn't bet)
Seat 5: Kobert72 (small blind) folded before Flop
Seat 6: grogga1 (big blind) folded before Flop



PokerStars Hand #222960878446:  Hold'em No Limit ($0.05/$0.10 USD) - 2021/01/23 12:18:53 ET
Table 'Lutetia III' 6-max Seat #5 is the button
Seat 1: HotMilk2020 ($9.28 in chips) 
Seat 2: LocalFixer ($10.15 in chips) 
Seat 3: Dugipokers ($12.37 in chips) 
Seat 4: Hermit628 ($10.15 in chips) 
Seat 5: Kobert72 ($9.95 in chips) 
Seat 6: grogga1 ($7.75 in chips) 
grogga1: posts small blind $0.05
HotMilk2020: posts big blind $0.10
*** HOLE CARDS ***
LocalFixer: folds 
Dugipokers: raises $0.20 to $0.30
Hermit628: folds 
Kobert72: folds 
grogga1: folds 
HotMilk2020: folds 
Uncalled bet ($0.20) returned to Dugipokers
Dugipokers collected $0.25 from pot
Dugipokers: doesn't show hand 
*** SUMMARY ***
Total pot $0.25 | Rake $0 
Seat 1: HotMilk2020 (big blind) folded before Flop
Seat 2: LocalFixer folded before Flop (didn't bet)
Seat 3: Dugipokers collected ($0.25)
Seat 4: Hermit628 folded before Flop (didn't bet)
Seat 5: Kobert72 (button) folded before Flop (didn't bet)
Seat 6: grogga1 (small blind) folded before Flop



PokerStars Hand #222960894791:  Hold'em No Limit ($0.05/$0.10 USD) - 2021/01/23 12:19:19 ET
Table 'Lutetia III' 6-max Seat #6 is the button
Seat 1: HotMilk2020 ($9.18 in chips) 
Seat 2: LocalFixer ($10.15 in chips) 
Seat 3: Dugipokers ($12.52 in chips) 
Seat 4: Hermit628 ($10.15 in chips) 
Seat 5: Kobert72 ($9.95 in chips) 
Seat 6: grogga1 ($7.70 in chips) 
HotMilk2020: posts small blind $0.05
LocalFixer: posts big blind $0.10
*** HOLE CARDS ***
Dugipokers: folds 
Hermit628: folds 
Kobert72: folds 
grogga1: folds 
HotMilk2020: calls $0.05
LocalFixer: raises $0.35 to $0.45
HotMilk2020: folds 
Uncalled bet ($0.35) returned to LocalFixer
LocalFixer collected $0.20 from pot
LocalFixer: doesn't show hand 
*** SUMMARY ***
Total pot $0.20 | Rake $0 
Seat 1: HotMilk2020 (small blind) folded before Flop
Seat 2: LocalFixer (big blind) collected ($0.20)
Seat 3: Dugipokers folded before Flop (didn't bet)
Seat 4: Hermit628 folded before Flop (didn't bet)
Seat 5: Kobert72 folded before Flop (didn't bet)
Seat 6: grogga1 (button) folded before Flop (didn't bet)



PokerStars Hand #222960909397:  Hold'em No Limit ($0.05/$0.10 USD) - 2021/01/23 12:19:42 ET
Table 'Lutetia III' 6-max Seat #1 is the button
Seat 1: HotMilk2020 ($9.08 in chips) 
Seat 2: LocalFixer ($10.25 in chips) 
Seat 3: Dugipokers ($12.52 in chips) 
Seat 4: Hermit628 ($10.15 in chips) 
Seat 5: Kobert72 ($9.95 in chips) 
Seat 6: grogga1 ($7.70 in chips) 
LocalFixer: posts small blind $0.05
Dugipokers: posts big blind $0.10
*** HOLE CARDS ***
Hermit628: folds 
Kobert72: folds 
grogga1: raises $0.15 to $0.25
HotMilk2020: calls $0.25
LocalFixer: folds 
Dugipokers: folds 
*** FLOP *** [Ah Jd 4s]
grogga1: checks 
HotMilk2020: checks 
*** TURN *** [Ah Jd 4s] [Ad]
grogga1: bets $0.31
HotMilk2020: calls $0.31
*** RIVER *** [Ah Jd 4s Ad] [Qc]
grogga1: bets $0.61
HotMilk2020: folds 
Uncalled bet ($0.61) returned to grogga1
grogga1 collected $1.21 from pot
*** SUMMARY ***
Total pot $1.27 | Rake $0.06 
Board [Ah Jd 4s Ad Qc]
Seat 1: HotMilk2020 (button) folded on the River
Seat 2: LocalFixer (small blind) folded before Flop
Seat 3: Dugipokers (big blind) folded before Flop
Seat 4: Hermit628 folded before Flop (didn't bet)
Seat 5: Kobert72 folded before Flop (didn't bet)
Seat 6: grogga1 collected ($1.21)



PokerStars Hand #222960947085:  Hold'em No Limit ($0.05/$0.10 USD) - 2021/01/23 12:20:42 ET
Table 'Lutetia III' 6-max Seat #2 is the button
Seat 1: HotMilk2020 ($8.52 in chips) 
Seat 2: LocalFixer ($10.20 in chips) 
Seat 3: Dugipokers ($12.42 in chips) 
Seat 4: Hermit628 ($10.15 in chips) 
Seat 5: Kobert72 ($9.95 in chips) 
Seat 6: grogga1 ($8.35 in chips) 
Dugipokers: posts small blind $0.05
Hermit628: posts big blind $0.10
*** HOLE CARDS ***
Kobert72: folds 
grogga1: folds 
HotMilk2020: folds 
LocalFixer: raises $0.10 to $0.20
Dugipokers: raises $0.70 to $0.90
Hermit628: folds 
LocalFixer: calls $0.70
*** FLOP *** [3c 7d Td]
Dugipokers: bets $0.92
LocalFixer: folds 
Uncalled bet ($0.92) returned to Dugipokers
Dugipokers collected $1.81 from pot
Dugipokers: doesn't show hand 
*** SUMMARY ***
Total pot $1.90 | Rake $0.09 
Board [3c 7d Td]
Seat 1: HotMilk2020 folded before Flop (didn't bet)
Seat 2: LocalFixer (button) folded on the Flop
Seat 3: Dugipokers (small blind) collected ($1.81)
Seat 4: Hermit628 (big blind) folded before Flop
Seat 5: Kobert72 folded before Flop (didn't bet)
Seat 6: grogga1 folded before Flop (didn't bet)



PokerStars Hand #222960962504:  Hold'em No Limit ($0.05/$0.10 USD) - 2021/01/23 12:21:06 ET
Table 'Lutetia III' 6-max Seat #3 is the button
Seat 1: HotMilk2020 ($8.52 in chips) 
Seat 2: LocalFixer ($10 in chips) 
Seat 3: Dugipokers ($13.33 in chips) 
Seat 4: Hermit628 ($10.05 in chips) 
Seat 5: Kobert72 ($9.95 in chips) 
Seat 6: grogga1 ($8.35 in chips) 
Hermit628: posts small blind $0.05
Kobert72: posts big blind $0.10
*** HOLE CARDS ***
grogga1: folds 
HotMilk2020: folds 
LocalFixer: folds 
Dugipokers: folds 
Hermit628: raises $0.30 to $0.40
Kobert72: calls $0.30
*** FLOP *** [7c 2h 8h]
Hermit628: bets $0.38
Kobert72: folds 
Uncalled bet ($0.38) returned to Hermit628
Hermit628 collected $0.76 from pot
Hermit628: doesn't show hand 
*** SUMMARY ***
Total pot $0.80 | Rake $0.04 
Board [7c 2h 8h]
Seat 1: HotMilk2020 folded before Flop (didn't bet)
Seat 2: LocalFixer folded before Flop (didn't bet)
Seat 3: Dugipokers (button) folded before Flop (didn't bet)
Seat 4: Hermit628 (small blind) collected ($0.76)
Seat 5: Kobert72 (big blind) folded on the Flop
Seat 6: grogga1 folded before Flop (didn't bet)



PokerStars Hand #222960981913:  Hold'em No Limit ($0.05/$0.10 USD) - 2021/01/23 12:21:37 ET
Table 'Lutetia III' 6-max Seat #4 is the button
Seat 1: HotMilk2020 ($8.52 in chips) 
Seat 2: LocalFixer ($10 in chips) 
Seat 3: Dugipokers ($13.33 in chips) 
Seat 4: Hermit628 ($10.41 in chips) 
Seat 5: Kobert72 ($9.55 in chips) 
Seat 6: grogga1 ($8.35 in chips) 
Kobert72: posts small blind $0.05
grogga1: posts big blind $0.10
*** HOLE CARDS ***
HotMilk2020: folds 
LocalFixer: folds 
Dugipokers: raises $0.15 to $0.25
Hermit628: folds 
Kobert72: folds 
grogga1: calls $0.15
*** FLOP *** [Ks 8d 6d]
grogga1: checks 
Dugipokers: bets $0.40
grogga1: calls $0.40
*** TURN *** [Ks 8d 6d] [7c]
grogga1: checks 
Dugipokers: bets $0.98
grogga1: calls $0.98
*** RIVER *** [Ks 8d 6d 7c] [Th]
grogga1: checks 
Dugipokers: bets $2.40
grogga1: raises $4.32 to $6.72 and is all-in
Dugipokers: calls $4.32
*** SHOW DOWN ***
grogga1: shows [8c 9s] (a straight, Six to Ten)
Dugipokers: shows [9h Ad] (a straight, Six to Ten)
grogga1 collected $8 from pot
Dugipokers collected $8 from pot
*** SUMMARY ***
Total pot $16.75 | Rake $0.75 
Board [Ks 8d 6d 7c Th]
Seat 1: HotMilk2020 folded before Flop (didn't bet)
Seat 2: LocalFixer folded before Flop (didn't bet)
Seat 3: Dugipokers showed [9h Ad] and won ($8) with a straight, Six to Ten
Seat 4: Hermit628 (button) folded before Flop (didn't bet)
Seat 5: Kobert72 (small blind) folded before Flop
Seat 6: grogga1 (big blind) showed [8c 9s] and won ($8) with a straight, Six to Ten



PokerStars Hand #222961033875:  Hold'em No Limit ($0.05/$0.10 USD) - 2021/01/23 12:22:59 ET
Table 'Lutetia III' 6-max Seat #5 is the button
Seat 1: HotMilk2020 ($8.52 in chips) 
Seat 2: LocalFixer ($10 in chips) 
Seat 3: Dugipokers ($12.98 in chips) 
Seat 4: Hermit628 ($10.41 in chips) 
Seat 5: Kobert72 ($9.50 in chips) 
Seat 6: grogga1 ($8 in chips) 
grogga1: posts small blind $0.05
HotMilk2020: posts big blind $0.10
*** HOLE CARDS ***
LocalFixer: folds 
Dugipokers: folds 
Hermit628: folds 
Hermit628 leaves the table
Kobert72: folds 
grogga1: raises $0.15 to $0.25
HotMilk2020: calls $0.15
*** FLOP *** [Qd 7d Jc]
eldar919 joins the table at seat #4 
grogga1: checks 
HotMilk2020: bets $0.10
grogga1: calls $0.10
*** TURN *** [Qd 7d Jc] [Qs]
grogga1: checks 
HotMilk2020: bets $0.34
grogga1: raises $0.34 to $0.68
HotMilk2020: calls $0.34
*** RIVER *** [Qd 7d Jc Qs] [Kd]
grogga1: bets $0.30
HotMilk2020: folds 
Uncalled bet ($0.30) returned to grogga1
grogga1 collected $1.97 from pot
*** SUMMARY ***
Total pot $2.06 | Rake $0.09 
Board [Qd 7d Jc Qs Kd]
Seat 1: HotMilk2020 (big blind) folded on the River
Seat 2: LocalFixer folded before Flop (didn't bet)
Seat 3: Dugipokers folded before Flop (didn't bet)
Seat 4: Hermit628 folded before Flop (didn't bet)
Seat 5: Kobert72 (button) folded before Flop (didn't bet)
Seat 6: grogga1 (small blind) collected ($1.97)



PokerStars Hand #222961084185:  Hold'em No Limit ($0.05/$0.10 USD) - 2021/01/23 12:24:06 ET
Table 'Lutetia III' 6-max Seat #6 is the button
Seat 1: HotMilk2020 ($7.49 in chips) 
Seat 2: LocalFixer ($10 in chips) 
Seat 3: Dugipokers ($12.98 in chips) 
Seat 5: Kobert72 ($9.50 in chips) 
Seat 6: grogga1 ($8.94 in chips) 
HotMilk2020: posts small blind $0.05
LocalFixer: posts big blind $0.10
eldar919: sits out 
*** HOLE CARDS ***
Dugipokers: folds 
Kobert72: raises $0.13 to $0.23
grogga1: calls $0.23
HotMilk2020: calls $0.18
LocalFixer: folds 
*** FLOP *** [Kc 7d Kh]
HotMilk2020: checks 
Kobert72: checks 
grogga1: checks 
*** TURN *** [Kc 7d Kh] [Td]
HotMilk2020: checks 
Kobert72: checks 
grogga1: bets $0.38
HotMilk2020: folds 
Kobert72: folds 
Uncalled bet ($0.38) returned to grogga1
grogga1 collected $0.75 from pot
*** SUMMARY ***
Total pot $0.79 | Rake $0.04 
Board [Kc 7d Kh Td]
Seat 1: HotMilk2020 (small blind) folded on the Turn
Seat 2: LocalFixer (big blind) folded before Flop
Seat 3: Dugipokers folded before Flop (didn't bet)
Seat 5: Kobert72 folded on the Turn
Seat 6: grogga1 (button) collected ($0.75)



PokerStars Hand #222961111443:  Hold'em No Limit ($0.05/$0.10 USD) - 2021/01/23 12:24:49 ET
Table 'Lutetia III' 6-max Seat #1 is the button
Seat 1: HotMilk2020 ($7.26 in chips) 
Seat 2: LocalFixer ($10 in chips) 
Seat 3: Dugipokers ($12.98 in chips) 
Seat 5: Kobert72 ($9.27 in chips) 
Seat 6: grogga1 ($9.46 in chips) 
LocalFixer: posts small blind $0.05
Dugipokers: posts big blind $0.10
eldar919: sits out 
*** HOLE CARDS ***
Kobert72: raises $0.13 to $0.23
grogga1: calls $0.23
HotMilk2020: folds 
LocalFixer: folds 
Dugipokers: folds 
*** FLOP *** [Ts 5c Jc]
Kobert72: bets $0.43
grogga1: folds 
Uncalled bet ($0.43) returned to Kobert72
Kobert72 collected $0.58 from pot
Kobert72: doesn't show hand 
*** SUMMARY ***
Total pot $0.61 | Rake $0.03 
Board [Ts 5c Jc]
Seat 1: HotMilk2020 (button) folded before Flop (didn't bet)
Seat 2: LocalFixer (small blind) folded before Flop
Seat 3: Dugipokers (big blind) folded before Flop
Seat 5: Kobert72 collected ($0.58)
Seat 6: grogga1 folded on the Flop



PokerStars Hand #222961131451:  Hold'em No Limit ($0.05/$0.10 USD) - 2021/01/23 12:25:20 ET
Table 'Lutetia III' 6-max Seat #2 is the button
Seat 1: HotMilk2020 ($7.26 in chips) 
Seat 2: LocalFixer ($10 in chips) 
Seat 3: Dugipokers ($12.88 in chips) 
Seat 4: eldar919 ($10 in chips) 
Seat 5: Kobert72 ($9.62 in chips) 
Seat 6: grogga1 ($9.23 in chips) 
Dugipokers: posts small blind $0.05
eldar919: posts big blind $0.10
*** HOLE CARDS ***
Kobert72: raises $0.13 to $0.23
grogga1: folds 
HotMilk2020: folds 
LocalFixer: folds 
Dugipokers: folds 
eldar919: folds 
Uncalled bet ($0.13) returned to Kobert72
Kobert72 collected $0.25 from pot
Kobert72: doesn't show hand 
*** SUMMARY ***
Total pot $0.25 | Rake $0 
Seat 1: HotMilk2020 folded before Flop (didn't bet)
Seat 2: LocalFixer (button) folded before Flop (didn't bet)
Seat 3: Dugipokers (small blind) folded before Flop
Seat 4: eldar919 (big blind) folded before Flop
Seat 5: Kobert72 collected ($0.25)
Seat 6: grogga1 folded before Flop (didn't bet)



PokerStars Hand #222961145078:  Hold'em No Limit ($0.05/$0.10 USD) - 2021/01/23 12:25:41 ET
Table 'Lutetia III' 6-max Seat #3 is the button
Seat 1: HotMilk2020 ($7.26 in chips) 
Seat 2: LocalFixer ($10 in chips) 
Seat 3: Dugipokers ($12.83 in chips) 
Seat 4: eldar919 ($10 in chips) 
Seat 5: Kobert72 ($9.77 in chips) 
Seat 6: grogga1 ($9.23 in chips) 
eldar919: posts small blind $0.05
Kobert72: posts big blind $0.10
*** HOLE CARDS ***
grogga1: raises $0.15 to $0.25
HotMilk2020: folds 
LocalFixer: folds 
Dugipokers: folds 
eldar919: folds 
Kobert72: folds 
Uncalled bet ($0.15) returned to grogga1
grogga1 collected $0.25 from pot
*** SUMMARY ***
Total pot $0.25 | Rake $0 
Seat 1: HotMilk2020 folded before Flop (didn't bet)
Seat 2: LocalFixer folded before Flop (didn't bet)
Seat 3: Dugipokers (button) folded before Flop (didn't bet)
Seat 4: eldar919 (small blind) folded before Flop
Seat 5: Kobert72 (big blind) folded before Flop
Seat 6: grogga1 collected ($0.25)



PokerStars Hand #222961159940:  Hold'em No Limit ($0.05/$0.10 USD) - 2021/01/23 12:26:04 ET
Table 'Lutetia III' 6-max Seat #4 is the button
Seat 1: HotMilk2020 ($7.26 in chips) 
Seat 2: LocalFixer ($10 in chips) 
Seat 3: Dugipokers ($12.83 in chips) 
Seat 4: eldar919 ($10 in chips) 
Seat 5: Kobert72 ($9.67 in chips) 
Seat 6: grogga1 ($9.38 in chips) 
Kobert72: posts small blind $0.05
grogga1: posts big blind $0.10
*** HOLE CARDS ***
HotMilk2020: calls $0.10
LocalFixer: folds 
Dugipokers: folds 
eldar919: folds 
Kobert72: folds 
grogga1: checks 
*** FLOP *** [6c 2d 8h]
grogga1: checks 
HotMilk2020: bets $0.10
grogga1: calls $0.10
*** TURN *** [6c 2d 8h] [6h]
grogga1: checks 
HotMilk2020: bets $0.10
grogga1: calls $0.10
*** RIVER *** [6c 2d 8h 6h] [Qc]
grogga1: checks 
HotMilk2020: bets $0.10
grogga1: folds 
Uncalled bet ($0.10) returned to HotMilk2020
HotMilk2020 collected $0.62 from pot
HotMilk2020: doesn't show hand 
*** SUMMARY ***
Total pot $0.65 | Rake $0.03 
Board [6c 2d 8h 6h Qc]
Seat 1: HotMilk2020 collected ($0.62)
Seat 2: LocalFixer folded before Flop (didn't bet)
Seat 3: Dugipokers folded before Flop (didn't bet)
Seat 4: eldar919 (button) folded before Flop (didn't bet)
Seat 5: Kobert72 (small blind) folded before Flop
Seat 6: grogga1 (big blind) folded on the River



PokerStars Hand #222961183038:  Hold'em No Limit ($0.05/$0.10 USD) - 2021/01/23 12:26:39 ET
Table 'Lutetia III' 6-max Seat #5 is the button
Seat 1: HotMilk2020 ($7.58 in chips) 
Seat 2: LocalFixer ($10 in chips) 
Seat 3: Dugipokers ($12.83 in chips) 
Seat 4: eldar919 ($10 in chips) 
Seat 5: Kobert72 ($10 in chips) 
Seat 6: grogga1 ($9.08 in chips) 
grogga1: posts small blind $0.05
HotMilk2020: posts big blind $0.10
*** HOLE CARDS ***
LocalFixer: folds 
Dugipokers: folds 
eldar919: folds 
Kobert72: raises $0.13 to $0.23
grogga1: folds 
HotMilk2020: calls $0.13
*** FLOP *** [6c 7s Th]
HotMilk2020: checks 
Kobert72: checks 
*** TURN *** [6c 7s Th] [Js]
HotMilk2020: checks 
Kobert72: checks 
*** RIVER *** [6c 7s Th Js] [2c]
HotMilk2020: checks 
Kobert72: checks 
*** SHOW DOWN ***
HotMilk2020: shows [Qd 8h] (high card Queen)
Kobert72: shows [Ad 4h] (high card Ace)
Kobert72 collected $0.49 from pot
*** SUMMARY ***
Total pot $0.51 | Rake $0.02 
Board [6c 7s Th Js 2c]
Seat 1: HotMilk2020 (big blind) showed [Qd 8h] and lost with high card Queen
Seat 2: LocalFixer folded before Flop (didn't bet)
Seat 3: Dugipokers folded before Flop (didn't bet)
Seat 4: eldar919 folded before Flop (didn't bet)
Seat 5: Kobert72 (button) showed [Ad 4h] and won ($0.49) with high card Ace
Seat 6: grogga1 (small blind) folded before Flop



PokerStars Hand #222961212869:  Hold'em No Limit ($0.05/$0.10 USD) - 2021/01/23 12:27:25 ET
Table 'Lutetia III' 6-max Seat #6 is the button
Seat 1: HotMilk2020 ($7.35 in chips) 
Seat 2: LocalFixer ($10 in chips) 
Seat 3: Dugipokers ($12.83 in chips) 
Seat 4: eldar919 ($10 in chips) 
Seat 5: Kobert72 ($10.26 in chips) 
Seat 6: grogga1 ($9.03 in chips) 
HotMilk2020: posts small blind $0.05
LocalFixer: posts big blind $0.10
*** HOLE CARDS ***
Dugipokers: folds 
eldar919: folds 
Kobert72: folds 
grogga1: folds 
HotMilk2020: calls $0.05
LocalFixer: checks 
*** FLOP *** [6s 8d 5c]
HotMilk2020: checks 
LocalFixer: bets $0.10
HotMilk2020: calls $0.10
*** TURN *** [6s 8d 5c] [Ah]
HotMilk2020: checks 
LocalFixer: checks 
*** RIVER *** [6s 8d 5c Ah] [9c]
HotMilk2020: checks 
LocalFixer: checks 
*** SHOW DOWN ***
HotMilk2020: shows [8h Qd] (a pair of Eights)
LocalFixer: mucks hand 
HotMilk2020 collected $0.38 from pot
*** SUMMARY ***
Total pot $0.40 | Rake $0.02 
Board [6s 8d 5c Ah 9c]
Seat 1: HotMilk2020 (small blind) showed [8h Qd] and won ($0.38) with a pair of Eights
Seat 2: LocalFixer (big blind) mucked
Seat 3: Dugipokers folded before Flop (didn't bet)
Seat 4: eldar919 folded before Flop (didn't bet)
Seat 5: Kobert72 folded before Flop (didn't bet)
Seat 6: grogga1 (button) folded before Flop (didn't bet)



PokerStars Hand #222961235809:  Hold'em No Limit ($0.05/$0.10 USD) - 2021/01/23 12:28:00 ET
Table 'Lutetia III' 6-max Seat #1 is the button
Seat 1: HotMilk2020 ($7.53 in chips) 
Seat 2: LocalFixer ($10 in chips) 
Seat 3: Dugipokers ($12.83 in chips) 
Seat 4: eldar919 ($10 in chips) 
Seat 5: Kobert72 ($10.26 in chips) 
Seat 6: grogga1 ($9.03 in chips) 
LocalFixer: posts small blind $0.05
Dugipokers: posts big blind $0.10
*** HOLE CARDS ***
eldar919: raises $0.20 to $0.30
Kobert72: folds 
grogga1: folds 
HotMilk2020: folds 
LocalFixer: folds 
Dugipokers: calls $0.20
*** FLOP *** [Jd 6h 6c]
Dugipokers: checks 
eldar919: bets $0.40
Dugipokers: folds 
Uncalled bet ($0.40) returned to eldar919
eldar919 collected $0.62 from pot
eldar919: doesn't show hand 
*** SUMMARY ***
Total pot $0.65 | Rake $0.03 
Board [Jd 6h 6c]
Seat 1: HotMilk2020 (button) folded before Flop (didn't bet)
Seat 2: LocalFixer (small blind) folded before Flop
Seat 3: Dugipokers (big blind) folded on the Flop
Seat 4: eldar919 collected ($0.62)
Seat 5: Kobert72 folded before Flop (didn't bet)
Seat 6: grogga1 folded before Flop (didn't bet)



PokerStars Hand #222961260001:  Hold'em No Limit ($0.05/$0.10 USD) - 2021/01/23 12:28:37 ET
Table 'Lutetia III' 6-max Seat #2 is the button
Seat 1: HotMilk2020 ($7.53 in chips) 
Seat 2: LocalFixer ($10 in chips) 
Seat 3: Dugipokers ($12.53 in chips) 
Seat 4: eldar919 ($10.32 in chips) 
Seat 5: Kobert72 ($10.26 in chips) 
Seat 6: grogga1 ($9.03 in chips) 
Dugipokers: posts small blind $0.05
eldar919: posts big blind $0.10
*** HOLE CARDS ***
Kobert72: folds 
grogga1: folds 
HotMilk2020: raises $0.10 to $0.20
LocalFixer: folds 
Dugipokers: folds 
eldar919: calls $0.10
*** FLOP *** [Ts 4d 6s]
eldar919: checks 
HotMilk2020: bets $0.22
eldar919: calls $0.22
*** TURN *** [Ts 4d 6s] [Qs]
eldar919: checks 
HotMilk2020: bets $0.43
eldar919: folds 
Uncalled bet ($0.43) returned to HotMilk2020
HotMilk2020 collected $0.85 from pot
HotMilk2020: doesn't show hand 
*** SUMMARY ***
Total pot $0.89 | Rake $0.04 
Board [Ts 4d 6s Qs]
Seat 1: HotMilk2020 collected ($0.85)
Seat 2: LocalFixer (button) folded before Flop (didn't bet)
Seat 3: Dugipokers (small blind) folded before Flop
Seat 4: eldar919 (big blind) folded on the Turn
Seat 5: Kobert72 folded before Flop (didn't bet)
Seat 6: grogga1 folded before Flop (didn't bet)



PokerStars Hand #222961307351:  Hold'em No Limit ($0.05/$0.10 USD) - 2021/01/23 12:29:50 ET
Table 'Lutetia III' 6-max Seat #3 is the button
Seat 1: HotMilk2020 ($7.96 in chips) 
Seat 2: LocalFixer ($10 in chips) 
Seat 3: Dugipokers ($12.48 in chips) 
Seat 4: eldar919 ($10 in chips) 
Seat 5: Kobert72 ($10.26 in chips) 
Seat 6: grogga1 ($9.03 in chips) 
eldar919: posts small blind $0.05
Kobert72: posts big blind $0.10
*** HOLE CARDS ***
grogga1: folds 
HotMilk2020: folds 
LocalFixer: raises $0.20 to $0.30
Dugipokers: folds 
eldar919: folds 
Kobert72: calls $0.20
*** FLOP *** [7d Jh 4c]
Kobert72: checks 
LocalFixer: bets $0.34
Kobert72: folds 
Uncalled bet ($0.34) returned to LocalFixer
LocalFixer collected $0.62 from pot
LocalFixer: doesn't show hand 
*** SUMMARY ***
Total pot $0.65 | Rake $0.03 
Board [7d Jh 4c]
Seat 1: HotMilk2020 folded before Flop (didn't bet)
Seat 2: LocalFixer collected ($0.62)
Seat 3: Dugipokers (button) folded before Flop (didn't bet)
Seat 4: eldar919 (small blind) folded before Flop
Seat 5: Kobert72 (big blind) folded on the Flop
Seat 6: grogga1 folded before Flop (didn't bet)



PokerStars Hand #222961328406:  Hold'em No Limit ($0.05/$0.10 USD) - 2021/01/23 12:30:22 ET
Table 'Lutetia III' 6-max Seat #4 is the button
Seat 1: HotMilk2020 ($7.96 in chips) 
Seat 2: LocalFixer ($10.32 in chips) 
Seat 3: Dugipokers ($12.48 in chips) 
Seat 4: eldar919 ($10 in chips) 
Seat 5: Kobert72 ($10 in chips) 
Seat 6: grogga1 ($9.03 in chips) 
Kobert72: posts small blind $0.05
grogga1: posts big blind $0.10
*** HOLE CARDS ***
HotMilk2020: folds 
LocalFixer: folds 
Dugipokers: raises $0.15 to $0.25
eldar919: calls $0.25
Kobert72: folds 
grogga1: folds 
*** FLOP *** [3c Jd 7h]
Dugipokers: checks 
eldar919: bets $0.31
Dugipokers: folds 
Uncalled bet ($0.31) returned to eldar919
eldar919 collected $0.62 from pot
eldar919: doesn't show hand 
*** SUMMARY ***
Total pot $0.65 | Rake $0.03 
Board [3c Jd 7h]
Seat 1: HotMilk2020 folded before Flop (didn't bet)
Seat 2: LocalFixer folded before Flop (didn't bet)
Seat 3: Dugipokers folded on the Flop
Seat 4: eldar919 (button) collected ($0.62)
Seat 5: Kobert72 (small blind) folded before Flop
Seat 6: grogga1 (big blind) folded before Flop



PokerStars Hand #222961360402:  Hold'em No Limit ($0.05/$0.10 USD) - 2021/01/23 12:31:10 ET
Table 'Lutetia III' 6-max Seat #5 is the button
Seat 1: HotMilk2020 ($7.96 in chips) 
Seat 2: LocalFixer ($10.32 in chips) 
Seat 3: Dugipokers ($12.23 in chips) 
Seat 4: eldar919 ($10.37 in chips) 
Seat 5: Kobert72 ($10 in chips) 
Seat 6: grogga1 ($8.93 in chips) 
grogga1: posts small blind $0.05
HotMilk2020: posts big blind $0.10
*** HOLE CARDS ***
LocalFixer: folds 
Dugipokers: folds 
eldar919: folds 
Kobert72: raises $0.13 to $0.23
grogga1: raises $0.57 to $0.80
HotMilk2020: folds 
Kobert72: folds 
Uncalled bet ($0.57) returned to grogga1
grogga1 collected $0.56 from pot
*** SUMMARY ***
Total pot $0.56 | Rake $0 
Seat 1: HotMilk2020 (big blind) folded before Flop
Seat 2: LocalFixer folded before Flop (didn't bet)
Seat 3: Dugipokers folded before Flop (didn't bet)
Seat 4: eldar919 folded before Flop (didn't bet)
Seat 5: Kobert72 (button) folded before Flop
Seat 6: grogga1 (small blind) collected ($0.56)



PokerStars Hand #222961376954:  Hold'em No Limit ($0.05/$0.10 USD) - 2021/01/23 12:31:35 ET
Table 'Lutetia III' 6-max Seat #6 is the button
Seat 1: HotMilk2020 ($7.86 in chips) 
Seat 2: LocalFixer ($10.32 in chips) 
Seat 3: Dugipokers ($12.23 in chips) 
Seat 4: eldar919 ($10.37 in chips) 
Seat 5: Kobert72 ($10 in chips) 
Seat 6: grogga1 ($9.26 in chips) 
HotMilk2020: posts small blind $0.05
LocalFixer: posts big blind $0.10
*** HOLE CARDS ***
Dugipokers: folds 
eldar919: raises $0.20 to $0.30
Kobert72: folds 
grogga1: calls $0.30
HotMilk2020: folds 
LocalFixer: folds 
*** FLOP *** [3c 2c 9h]
eldar919: bets $0.48
grogga1: calls $0.48
*** TURN *** [3c 2c 9h] [Ks]
eldar919: bets $1.25
grogga1: folds 
Uncalled bet ($1.25) returned to eldar919
eldar919 collected $1.63 from pot
*** SUMMARY ***
Total pot $1.71 | Rake $0.08 
Board [3c 2c 9h Ks]
Seat 1: HotMilk2020 (small blind) folded before Flop
Seat 2: LocalFixer (big blind) folded before Flop
Seat 3: Dugipokers folded before Flop (didn't bet)
Seat 4: eldar919 collected ($1.63)
Seat 5: Kobert72 folded before Flop (didn't bet)
Seat 6: grogga1 (button) folded on the Turn



PokerStars Hand #222961405946:  Hold'em No Limit ($0.05/$0.10 USD) - 2021/01/23 12:32:19 ET
Table 'Lutetia III' 6-max Seat #1 is the button
Seat 1: HotMilk2020 ($7.81 in chips) 
Seat 2: LocalFixer ($10.22 in chips) 
Seat 3: Dugipokers ($12.23 in chips) 
Seat 4: eldar919 ($11.22 in chips) 
Seat 5: Kobert72 ($10 in chips) 
Seat 6: grogga1 ($8.48 in chips) 
LocalFixer: posts small blind $0.05
Dugipokers: posts big blind $0.10
*** HOLE CARDS ***
eldar919: folds 
Kobert72: raises $0.13 to $0.23
grogga1: folds 
HotMilk2020: folds 
LocalFixer: folds 
Dugipokers: calls $0.13
*** FLOP *** [4s Js Jh]
Dugipokers: checks 
Kobert72: bets $0.16
Dugipokers: calls $0.16
*** TURN *** [4s Js Jh] [6s]
Dugipokers: checks 
Kobert72: checks 
*** RIVER *** [4s Js Jh 6s] [4d]
Dugipokers: bets $0.60
Kobert72: calls $0.60
*** SHOW DOWN ***
Dugipokers: shows [Kc Qs] (two pair, Jacks and Fours)
Kobert72: shows [8c 8h] (two pair, Jacks and Eights)
Kobert72 collected $1.94 from pot
*** SUMMARY ***
Total pot $2.03 | Rake $0.09 
Board [4s Js Jh 6s 4d]
Seat 1: HotMilk2020 (button) folded before Flop (didn't bet)
Seat 2: LocalFixer (small blind) folded before Flop
Seat 3: Dugipokers (big blind) showed [Kc Qs] and lost with two pair, Jacks and Fours
Seat 4: eldar919 folded before Flop (didn't bet)
Seat 5: Kobert72 showed [8c 8h] and won ($1.94) with two pair, Jacks and Eights
Seat 6: grogga1 folded before Flop (didn't bet)



PokerStars Hand #222961448430:  Hold'em No Limit ($0.05/$0.10 USD) - 2021/01/23 12:33:22 ET
Table 'Lutetia III' 6-max Seat #2 is the button
Seat 1: HotMilk2020 ($7.81 in chips) 
Seat 2: LocalFixer ($10.17 in chips) 
Seat 3: Dugipokers ($11.24 in chips) 
Seat 5: Kobert72 ($10.95 in chips) 
Seat 6: grogga1 ($8.48 in chips) 
Dugipokers: posts small blind $0.05
eldar919: is sitting out 
Kobert72: posts big blind $0.10
*** HOLE CARDS ***
grogga1: folds 
HotMilk2020: folds 
eldar919 leaves the table
LocalFixer: raises $0.10 to $0.20
Dugipokers: folds 
LisInSky joins the table at seat #4 
Kobert72: folds 
Uncalled bet ($0.10) returned to LocalFixer
LocalFixer collected $0.25 from pot
LocalFixer: doesn't show hand 
*** SUMMARY ***
Total pot $0.25 | Rake $0 
Seat 1: HotMilk2020 folded before Flop (didn't bet)
Seat 2: LocalFixer (button) collected ($0.25)
Seat 3: Dugipokers (small blind) folded before Flop
Seat 5: Kobert72 (big blind) folded before Flop
Seat 6: grogga1 folded before Flop (didn't bet)



PokerStars Hand #222961458934:  Hold'em No Limit ($0.05/$0.10 USD) - 2021/01/23 12:33:38 ET
Table 'Lutetia III' 6-max Seat #3 is the button
Seat 1: HotMilk2020 ($7.81 in chips) 
Seat 2: LocalFixer ($10.32 in chips) 
Seat 3: Dugipokers ($11.19 in chips) 
Seat 5: Kobert72 ($10.85 in chips) 
Kobert72: posts small blind $0.05
grogga1: is sitting out 
HotMilk2020: posts big blind $0.10
*** HOLE CARDS ***
LocalFixer: folds 
Dugipokers: raises $0.15 to $0.25
grogga1 leaves the table
Kobert72: folds 
HotMilk2020: calls $0.15
*** FLOP *** [6c Jc 2s]
HotMilk2020: checks 
diana024 joins the table at seat #6 
Dugipokers: checks 
*** TURN *** [6c Jc 2s] [Kh]
HotMilk2020: checks 
Dugipokers: bets $0.40
LisInSky leaves the table
HotMilk2020: folds 
Uncalled bet ($0.40) returned to Dugipokers
Dugipokers collected $0.53 from pot
*** SUMMARY ***
Total pot $0.55 | Rake $0.02 
Board [6c Jc 2s Kh]
Seat 1: HotMilk2020 (big blind) folded on the Turn
Seat 2: LocalFixer folded before Flop (didn't bet)
Seat 3: Dugipokers (button) collected ($0.53)
Seat 5: Kobert72 (small blind) folded before Flop



PokerStars Hand #222961481685:  Hold'em No Limit ($0.05/$0.10 USD) - 2021/01/23 12:34:11 ET
Table 'Lutetia III' 6-max Seat #5 is the button
Seat 1: HotMilk2020 ($7.56 in chips) 
Seat 2: LocalFixer ($10.32 in chips) 
Seat 3: Dugipokers ($11.47 in chips) 
Seat 5: Kobert72 ($10.80 in chips) 
HotMilk2020: posts small blind $0.05
LocalFixer: posts big blind $0.10
KiraLasVegas: sits out 
*** HOLE CARDS ***
Dugipokers: raises $0.15 to $0.25
Kobert72: folds 
HotMilk2020: folds 
LocalFixer: raises $0.75 to $1
Dugipokers: raises $1.40 to $2.40
LocalFixer: raises $7.92 to $10.32 and is all-in
Dugipokers: calls $7.92
*** FIRST FLOP *** [Kd Th Qh]
*** FIRST TURN *** [Kd Th Qh] [2h]
*** FIRST RIVER *** [Kd Th Qh 2h] [9h]
*** SECOND FLOP *** [6c 4c Jc]
*** SECOND TURN *** [6c 4c Jc] [Jh]
*** SECOND RIVER *** [6c 4c Jc Jh] [8c]
*** FIRST SHOW DOWN ***
LocalFixer: shows [Kc As] (a pair of Kings)
Dugipokers: shows [Kh Ac] (a flush, King high)
Dugipokers collected $9.88 from pot
*** SECOND SHOW DOWN ***
LocalFixer: shows [Kc As] (a flush, King high)
Dugipokers: shows [Kh Ac] (a flush, Ace high)
Dugipokers collected $9.88 from pot
*** SUMMARY ***
Total pot $20.69 | Rake $0.93 
Hand was run twice
FIRST Board [Kd Th Qh 2h 9h]
SECOND Board [6c 4c Jc Jh 8c]
Seat 1: HotMilk2020 (small blind) folded before Flop
Seat 2: LocalFixer (big blind) showed [Kc As] and lost with a pair of Kings, and lost with a flush, King high
Seat 3: Dugipokers showed [Kh Ac] and won ($9.88) with a flush, King high, and won ($9.88) with a flush, Ace high
Seat 5: Kobert72 (button) folded before Flop (didn't bet)



PokerStars Hand #222961518152:  Hold'em No Limit ($0.05/$0.10 USD) - 2021/01/23 12:35:06 ET
Table 'Lutetia III' 6-max Seat #1 is the button
Seat 1: HotMilk2020 ($7.51 in chips) 
Seat 2: LocalFixer ($10 in chips) 
Seat 3: Dugipokers ($20.91 in chips) 
Seat 5: Kobert72 ($10.80 in chips) 
Seat 6: diana024 ($5 in chips) 
LocalFixer: posts small blind $0.05
Dugipokers: posts big blind $0.10
KiraLasVegas: sits out 
diana024: posts big blind $0.10
*** HOLE CARDS ***
Kobert72: raises $0.13 to $0.23
diana024: calls $0.13
HotMilk2020: folds 
LocalFixer: folds 
Dugipokers: folds 
*** FLOP *** [7d 8d Jh]
Kobert72: bets $0.43
diana024: folds 
Uncalled bet ($0.43) returned to Kobert72
Kobert72 collected $0.58 from pot
Kobert72: doesn't show hand 
*** SUMMARY ***
Total pot $0.61 | Rake $0.03 
Board [7d 8d Jh]
Seat 1: HotMilk2020 (button) folded before Flop (didn't bet)
Seat 2: LocalFixer (small blind) folded before Flop
Seat 3: Dugipokers (big blind) folded before Flop
Seat 5: Kobert72 collected ($0.58)
Seat 6: diana024 folded on the Flop



PokerStars Hand #222961542697:  Hold'em No Limit ($0.05/$0.10 USD) - 2021/01/23 12:35:43 ET
Table 'Lutetia III' 6-max Seat #2 is the button
Seat 1: HotMilk2020 ($7.51 in chips) 
Seat 2: LocalFixer ($10 in chips) 
Seat 3: Dugipokers ($20.81 in chips) 
Seat 4: KiraLasVegas ($10 in chips) 
Seat 5: Kobert72 ($11.15 in chips) 
Seat 6: diana024 ($4.77 in chips) 
Dugipokers: posts small blind $0.05
KiraLasVegas: posts big blind $0.10
*** HOLE CARDS ***
Kobert72: folds 
diana024 has timed out
diana024: folds 
HotMilk2020: folds 
LocalFixer: raises $0.10 to $0.20
Dugipokers: folds 
KiraLasVegas: folds 
Uncalled bet ($0.10) returned to LocalFixer
LocalFixer collected $0.25 from pot
LocalFixer: doesn't show hand 
*** SUMMARY ***
Total pot $0.25 | Rake $0 
Seat 1: HotMilk2020 folded before Flop (didn't bet)
Seat 2: LocalFixer (button) collected ($0.25)
Seat 3: Dugipokers (small blind) folded before Flop
Seat 4: KiraLasVegas (big blind) folded before Flop
Seat 5: Kobert72 folded before Flop (didn't bet)
Seat 6: diana024 folded before Flop (didn't bet)



PokerStars Hand #222961559370:  Hold'em No Limit ($0.05/$0.10 USD) - 2021/01/23 12:36:08 ET
Table 'Lutetia III' 6-max Seat #3 is the button
Seat 1: HotMilk2020 ($7.51 in chips) 
Seat 2: LocalFixer ($10.15 in chips) 
Seat 3: Dugipokers ($20.76 in chips) 
Seat 4: KiraLasVegas ($10 in chips) 
Seat 5: Kobert72 ($11.15 in chips) 
Seat 6: diana024 ($4.77 in chips) 
KiraLasVegas: posts small blind $0.05
Kobert72: posts big blind $0.10
*** HOLE CARDS ***
diana024: raises $0.50 to $0.60
HotMilk2020: calls $0.60
LocalFixer: folds 
Dugipokers: folds 
KiraLasVegas: raises $9.40 to $10 and is all-in
Kobert72: folds 
diana024: folds 
HotMilk2020: folds 
Uncalled bet ($9.40) returned to KiraLasVegas
KiraLasVegas collected $1.90 from pot
KiraLasVegas: doesn't show hand 
*** SUMMARY ***
Total pot $1.90 | Rake $0 
Seat 1: HotMilk2020 folded before Flop
Seat 2: LocalFixer folded before Flop (didn't bet)
Seat 3: Dugipokers (button) folded before Flop (didn't bet)
Seat 4: KiraLasVegas (small blind) collected ($1.90)
Seat 5: Kobert72 (big blind) folded before Flop
Seat 6: diana024 folded before Flop



PokerStars Hand #222961583683:  Hold'em No Limit ($0.05/$0.10 USD) - 2021/01/23 12:36:44 ET
Table 'Lutetia III' 6-max Seat #4 is the button
Seat 1: HotMilk2020 ($6.91 in chips) 
Seat 2: LocalFixer ($10.15 in chips) 
Seat 3: Dugipokers ($20.76 in chips) 
Seat 4: KiraLasVegas ($11.30 in chips) 
Seat 5: Kobert72 ($11.05 in chips) 
Seat 6: diana024 ($5 in chips) 
Kobert72: posts small blind $0.05
diana024: posts big blind $0.10
*** HOLE CARDS ***
HotMilk2020: folds 
LocalFixer: raises $0.10 to $0.20
Dugipokers: folds 
KiraLasVegas: folds 
Kobert72: folds 
diana024: calls $0.10
*** FLOP *** [7d 2c 5d]
diana024: checks 
LocalFixer: bets $0.24
diana024: folds 
Uncalled bet ($0.24) returned to LocalFixer
LocalFixer collected $0.43 from pot
LocalFixer: doesn't show hand 
*** SUMMARY ***
Total pot $0.45 | Rake $0.02 
Board [7d 2c 5d]
Seat 1: HotMilk2020 folded before Flop (didn't bet)
Seat 2: LocalFixer collected ($0.43)
Seat 3: Dugipokers folded before Flop (didn't bet)
Seat 4: KiraLasVegas (button) folded before Flop (didn't bet)
Seat 5: Kobert72 (small blind) folded before Flop
Seat 6: diana024 (big blind) folded on the Flop



PokerStars Hand #222961604993:  Hold'em No Limit ($0.05/$0.10 USD) - 2021/01/23 12:37:16 ET
Table 'Lutetia III' 6-max Seat #5 is the button
Seat 1: HotMilk2020 ($6.91 in chips) 
Seat 2: LocalFixer ($10.38 in chips) 
Seat 3: Dugipokers ($20.76 in chips) 
Seat 4: KiraLasVegas ($11.30 in chips) 
Seat 5: Kobert72 ($11 in chips) 
Seat 6: diana024 ($4.80 in chips) 
diana024: posts small blind $0.05
HotMilk2020: posts big blind $0.10
*** HOLE CARDS ***
LocalFixer: raises $0.20 to $0.30
Dugipokers: folds 
KiraLasVegas: folds 
Kobert72: calls $0.30
diana024: folds 
HotMilk2020: calls $0.20
*** FLOP *** [8d 2h 3s]
HotMilk2020: checks 
LocalFixer: checks 
Kobert72: checks 
*** TURN *** [8d 2h 3s] [Qh]
HotMilk2020: checks 
LocalFixer: bets $0.70
Kobert72: folds 
HotMilk2020: folds 
Uncalled bet ($0.70) returned to LocalFixer
LocalFixer collected $0.91 from pot
LocalFixer: doesn't show hand 
*** SUMMARY ***
Total pot $0.95 | Rake $0.04 
Board [8d 2h 3s Qh]
Seat 1: HotMilk2020 (big blind) folded on the Turn
Seat 2: LocalFixer collected ($0.91)
Seat 3: Dugipokers folded before Flop (didn't bet)
Seat 4: KiraLasVegas folded before Flop (didn't bet)
Seat 5: Kobert72 (button) folded on the Turn
Seat 6: diana024 (small blind) folded before Flop



PokerStars Hand #222961636517:  Hold'em No Limit ($0.05/$0.10 USD) - 2021/01/23 12:38:03 ET
Table 'Lutetia III' 6-max Seat #6 is the button
Seat 1: HotMilk2020 ($6.61 in chips) 
Seat 2: LocalFixer ($10.99 in chips) 
Seat 3: Dugipokers ($20.76 in chips) 
Seat 4: KiraLasVegas ($11.30 in chips) 
Seat 5: Kobert72 ($10.70 in chips) 
Seat 6: diana024 ($4.75 in chips) 
HotMilk2020: posts small blind $0.05
LocalFixer: posts big blind $0.10
*** HOLE CARDS ***
Dugipokers: folds 
KiraLasVegas: folds 
Kobert72: folds 
diana024: folds 
HotMilk2020: folds 
Uncalled bet ($0.05) returned to LocalFixer
LocalFixer collected $0.10 from pot
LocalFixer: doesn't show hand 
*** SUMMARY ***
Total pot $0.10 | Rake $0 
Seat 1: HotMilk2020 (small blind) folded before Flop
Seat 2: LocalFixer (big blind) collected ($0.10)
Seat 3: Dugipokers folded before Flop (didn't bet)
Seat 4: KiraLasVegas folded before Flop (didn't bet)
Seat 5: Kobert72 folded before Flop (didn't bet)
Seat 6: diana024 (button) folded before Flop (didn't bet)



PokerStars Hand #222961645596:  Hold'em No Limit ($0.05/$0.10 USD) - 2021/01/23 12:38:17 ET
Table 'Lutetia III' 6-max Seat #1 is the button
Seat 1: HotMilk2020 ($6.56 in chips) 
Seat 2: LocalFixer ($11.04 in chips) 
Seat 3: Dugipokers ($20.76 in chips) 
Seat 4: KiraLasVegas ($11.30 in chips) 
Seat 5: Kobert72 ($10.70 in chips) 
Seat 6: diana024 ($4.75 in chips) 
LocalFixer: posts small blind $0.05
Dugipokers: posts big blind $0.10
*** HOLE CARDS ***
KiraLasVegas: folds 
Kobert72: folds 
diana024: folds 
HotMilk2020: calls $0.10
LocalFixer: folds 
Dugipokers: checks 
*** FLOP *** [2d 9s 5d]
Dugipokers: bets $0.25
HotMilk2020: folds 
Uncalled bet ($0.25) returned to Dugipokers
Dugipokers collected $0.24 from pot
Dugipokers: doesn't show hand 
*** SUMMARY ***
Total pot $0.25 | Rake $0.01 
Board [2d 9s 5d]
Seat 1: HotMilk2020 (button) folded on the Flop
Seat 2: LocalFixer (small blind) folded before Flop
Seat 3: Dugipokers (big blind) collected ($0.24)
Seat 4: KiraLasVegas folded before Flop (didn't bet)
Seat 5: Kobert72 folded before Flop (didn't bet)
Seat 6: diana024 folded before Flop (didn't bet)



PokerStars Hand #222961659021:  Hold'em No Limit ($0.05/$0.10 USD) - 2021/01/23 12:38:37 ET
Table 'Lutetia III' 6-max Seat #2 is the button
Seat 1: HotMilk2020 ($6.46 in chips) 
Seat 2: LocalFixer ($10.99 in chips) 
Seat 3: Dugipokers ($20.90 in chips) 
Seat 4: KiraLasVegas ($11.30 in chips) 
Seat 5: Kobert72 ($10.70 in chips) 
Seat 6: diana024 ($4.75 in chips) 
Dugipokers: posts small blind $0.05
KiraLasVegas: posts big blind $0.10
*** HOLE CARDS ***
Kobert72: raises $0.13 to $0.23
diana024: folds 
HotMilk2020: calls $0.23
LocalFixer: folds 
Dugipokers: folds 
KiraLasVegas: folds 
*** FLOP *** [Kh 2c 6s]
Kobert72: checks 
HotMilk2020: checks 
*** TURN *** [Kh 2c 6s] [6h]
Kobert72: checks 
HotMilk2020: checks 
*** RIVER *** [Kh 2c 6s 6h] [7h]
Kobert72: checks 
HotMilk2020: bets $0.29
Kobert72: calls $0.29
*** SHOW DOWN ***
HotMilk2020: shows [Jh As] (a pair of Sixes)
Kobert72: shows [Th Tc] (two pair, Tens and Sixes)
Kobert72 collected $1.14 from pot
*** SUMMARY ***
Total pot $1.19 | Rake $0.05 
Board [Kh 2c 6s 6h 7h]
Seat 1: HotMilk2020 showed [Jh As] and lost with a pair of Sixes
Seat 2: LocalFixer (button) folded before Flop (didn't bet)
Seat 3: Dugipokers (small blind) folded before Flop
Seat 4: KiraLasVegas (big blind) folded before Flop
Seat 5: Kobert72 showed [Th Tc] and won ($1.14) with two pair, Tens and Sixes
Seat 6: diana024 folded before Flop (didn't bet)



PokerStars Hand #222961701028:  Hold'em No Limit ($0.05/$0.10 USD) - 2021/01/23 12:39:39 ET
Table 'Lutetia III' 6-max Seat #3 is the button
Seat 1: HotMilk2020 ($5.94 in chips) 
Seat 2: LocalFixer ($10.99 in chips) 
Seat 3: Dugipokers ($20.85 in chips) 
Seat 4: KiraLasVegas ($11.20 in chips) 
Seat 5: Kobert72 ($11.32 in chips) 
Seat 6: diana024 ($4.75 in chips) 
KiraLasVegas: posts small blind $0.05
Kobert72: posts big blind $0.10
*** HOLE CARDS ***
diana024: folds 
HotMilk2020: folds 
LocalFixer: raises $0.20 to $0.30
Dugipokers: folds 
KiraLasVegas: folds 
Kobert72: calls $0.20
*** FLOP *** [As Ac Tc]
Kobert72: checks 
LocalFixer: bets $0.25
Kobert72: calls $0.25
*** TURN *** [As Ac Tc] [7h]
Kobert72: checks 
LocalFixer: checks 
*** RIVER *** [As Ac Tc 7h] [Kd]
Kobert72: checks 
LocalFixer: checks 
*** SHOW DOWN ***
Kobert72: shows [Ad Td] (a full house, Aces full of Tens)
LocalFixer: mucks hand 
Kobert72 collected $1.10 from pot
*** SUMMARY ***
Total pot $1.15 | Rake $0.05 
Board [As Ac Tc 7h Kd]
Seat 1: HotMilk2020 folded before Flop (didn't bet)
Seat 2: LocalFixer mucked
Seat 3: Dugipokers (button) folded before Flop (didn't bet)
Seat 4: KiraLasVegas (small blind) folded before Flop
Seat 5: Kobert72 (big blind) showed [Ad Td] and won ($1.10) with a full house, Aces full of Tens
Seat 6: diana024 folded before Flop (didn't bet)



PokerStars Hand #222961746113:  Hold'em No Limit ($0.05/$0.10 USD) - 2021/01/23 12:40:46 ET
Table 'Lutetia III' 6-max Seat #4 is the button
Seat 1: HotMilk2020 ($5.94 in chips) 
Seat 2: LocalFixer ($10.44 in chips) 
Seat 3: Dugipokers ($20.85 in chips) 
Seat 4: KiraLasVegas ($11.15 in chips) 
Seat 5: Kobert72 ($11.87 in chips) 
Seat 6: diana024 ($4.75 in chips) 
Kobert72: posts small blind $0.05
diana024: posts big blind $0.10
*** HOLE CARDS ***
HotMilk2020: folds 
LocalFixer: folds 
Dugipokers: folds 
KiraLasVegas: raises $0.15 to $0.25
Kobert72: folds 
diana024: raises $0.35 to $0.60
KiraLasVegas: folds 
Uncalled bet ($0.35) returned to diana024
diana024 collected $0.55 from pot
diana024: doesn't show hand 
*** SUMMARY ***
Total pot $0.55 | Rake $0 
Seat 1: HotMilk2020 folded before Flop (didn't bet)
Seat 2: LocalFixer folded before Flop (didn't bet)
Seat 3: Dugipokers folded before Flop (didn't bet)
Seat 4: KiraLasVegas (button) folded before Flop
Seat 5: Kobert72 (small blind) folded before Flop
Seat 6: diana024 (big blind) collected ($0.55)



PokerStars Hand #222961757015:  Hold'em No Limit ($0.05/$0.10 USD) - 2021/01/23 12:41:02 ET
Table 'Lutetia III' 6-max Seat #5 is the button
Seat 1: HotMilk2020 ($5.94 in chips) 
Seat 2: LocalFixer ($10.44 in chips) 
Seat 3: Dugipokers ($20.85 in chips) 
Seat 4: KiraLasVegas ($10.90 in chips) 
Seat 5: Kobert72 ($11.82 in chips) 
Seat 6: diana024 ($5.05 in chips) 
diana024: posts small blind $0.05
HotMilk2020: posts big blind $0.10
*** HOLE CARDS ***
LocalFixer: folds 
Dugipokers: folds 
KiraLasVegas: folds 
Kobert72: raises $0.13 to $0.23
diana024: raises $0.37 to $0.60
HotMilk2020: folds 
Kobert72: raises $1.83 to $2.43
diana024: calls $1.83
*** FLOP *** [8h Th 2h]
diana024: bets $2.62 and is all-in
Kobert72: calls $2.62
*** TURN *** [8h Th 2h] [9s]
*** RIVER *** [8h Th 2h 9s] [3h]
*** SHOW DOWN ***
diana024: shows [Kc Ac] (high card Ace)
Kobert72: shows [Js Jd] (a pair of Jacks)
Kobert72 collected $9.74 from pot
*** SUMMARY ***
Total pot $10.20 | Rake $0.46 
Board [8h Th 2h 9s 3h]
Seat 1: HotMilk2020 (big blind) folded before Flop
Seat 2: LocalFixer folded before Flop (didn't bet)
Seat 3: Dugipokers folded before Flop (didn't bet)
Seat 4: KiraLasVegas folded before Flop (didn't bet)
Seat 5: Kobert72 (button) showed [Js Jd] and won ($9.74) with a pair of Jacks
Seat 6: diana024 (small blind) showed [Kc Ac] and lost with high card Ace



PokerStars Hand #222961805774:  Hold'em No Limit ($0.05/$0.10 USD) - 2021/01/23 12:42:14 ET
Table 'Lutetia III' 6-max Seat #6 is the button
Seat 1: HotMilk2020 ($5.84 in chips) 
Seat 2: LocalFixer ($10.44 in chips) 
Seat 3: Dugipokers ($20.85 in chips) 
Seat 4: KiraLasVegas ($10.90 in chips) 
Seat 5: Kobert72 ($16.51 in chips) 
Seat 6: diana024 ($5 in chips) 
HotMilk2020: posts small blind $0.05
LocalFixer: posts big blind $0.10
*** HOLE CARDS ***
Dugipokers: folds 
KiraLasVegas: folds 
Kobert72: folds 
diana024: folds 
HotMilk2020: folds 
Uncalled bet ($0.05) returned to LocalFixer
LocalFixer collected $0.10 from pot
LocalFixer: doesn't show hand 
*** SUMMARY ***
Total pot $0.10 | Rake $0 
Seat 1: HotMilk2020 (small blind) folded before Flop
Seat 2: LocalFixer (big blind) collected ($0.10)
Seat 3: Dugipokers folded before Flop (didn't bet)
Seat 4: KiraLasVegas folded before Flop (didn't bet)
Seat 5: Kobert72 folded before Flop (didn't bet)
Seat 6: diana024 (button) folded before Flop (didn't bet)



PokerStars Hand #222963010763:  Hold'em No Limit ($0.05/$0.10 USD) - 2021/01/23 13:13:15 ET
Table 'Lutetia III' 6-max Seat #1 is the button
Seat 1: HotMilk2020 ($14.86 in chips) 
Seat 2: LocalFixer ($18.45 in chips) 
Seat 3: Rasack007 ($4 in chips) 
Seat 5: fouktoubaba ($11.57 in chips) 
Seat 6: Vaha379 ($11.89 in chips) 
LocalFixer: posts small blind $0.05
Rasack007: posts big blind $0.10
Acedan1369: sits out 
*** HOLE CARDS ***
fouktoubaba: folds 
Vaha379: folds 
HotMilk2020: calls $0.10
LocalFixer: folds 
Rasack007: checks 
*** FLOP *** [3c Th 8c]
Rasack007: bets $0.30
HotMilk2020: folds 
Uncalled bet ($0.30) returned to Rasack007
Rasack007 collected $0.24 from pot
Rasack007: doesn't show hand 
*** SUMMARY ***
Total pot $0.25 | Rake $0.01 
Board [3c Th 8c]
Seat 1: HotMilk2020 (button) folded on the Flop
Seat 2: LocalFixer (small blind) folded before Flop
Seat 3: Rasack007 (big blind) collected ($0.24)
Seat 5: fouktoubaba folded before Flop (didn't bet)
Seat 6: Vaha379 folded before Flop (didn't bet)



PokerStars Hand #222963031857:  Hold'em No Limit ($0.05/$0.10 USD) - 2021/01/23 13:13:45 ET
Table 'Lutetia III' 6-max Seat #2 is the button
Seat 1: HotMilk2020 ($14.76 in chips) 
Seat 2: LocalFixer ($18.40 in chips) 
Seat 3: Rasack007 ($4.14 in chips) 
Seat 4: Acedan1369 ($10 in chips) 
Seat 5: fouktoubaba ($11.57 in chips) 
Seat 6: Vaha379 ($11.89 in chips) 
Rasack007: posts small blind $0.05
Acedan1369: posts big blind $0.10
*** HOLE CARDS ***
fouktoubaba: raises $0.20 to $0.30
Vaha379: folds 
HotMilk2020: calls $0.30
LocalFixer: calls $0.30
Rasack007: folds 
Acedan1369: folds 
*** FLOP *** [4s 6h 2h]
fouktoubaba: checks 
HotMilk2020: bets $0.10
LocalFixer: calls $0.10
fouktoubaba: calls $0.10
*** TURN *** [4s 6h 2h] [Ac]
fouktoubaba: checks 
HotMilk2020: bets $0.10
LocalFixer: calls $0.10
fouktoubaba: calls $0.10
*** RIVER *** [4s 6h 2h Ac] [3s]
fouktoubaba: bets $0.79
HotMilk2020: folds 
LocalFixer: folds 
Uncalled bet ($0.79) returned to fouktoubaba
fouktoubaba collected $1.58 from pot
fouktoubaba: doesn't show hand 
*** SUMMARY ***
Total pot $1.65 | Rake $0.07 
Board [4s 6h 2h Ac 3s]
Seat 1: HotMilk2020 folded on the River
Seat 2: LocalFixer (button) folded on the River
Seat 3: Rasack007 (small blind) folded before Flop
Seat 4: Acedan1369 (big blind) folded before Flop
Seat 5: fouktoubaba collected ($1.58)
Seat 6: Vaha379 folded before Flop (didn't bet)



PokerStars Hand #222963075079:  Hold'em No Limit ($0.05/$0.10 USD) - 2021/01/23 13:14:50 ET
Table 'Lutetia III' 6-max Seat #3 is the button
Seat 1: HotMilk2020 ($14.26 in chips) 
Seat 2: LocalFixer ($17.90 in chips) 
Seat 3: Rasack007 ($4.09 in chips) 
Seat 4: Acedan1369 ($10 in chips) 
Seat 5: fouktoubaba ($12.65 in chips) 
Seat 6: Vaha379 ($11.89 in chips) 
Acedan1369: posts small blind $0.05
fouktoubaba: posts big blind $0.10
*** HOLE CARDS ***
Vaha379: folds 
HotMilk2020: calls $0.10
LocalFixer: folds 
Rasack007: folds 
Acedan1369: folds 
fouktoubaba: raises $0.20 to $0.30
HotMilk2020: calls $0.20
*** FLOP *** [Tc 5d 6d]
fouktoubaba: bets $0.30
HotMilk2020: calls $0.30
*** TURN *** [Tc 5d 6d] [6c]
fouktoubaba: checks 
HotMilk2020: checks 
*** RIVER *** [Tc 5d 6d 6c] [2h]
fouktoubaba: bets $0.40
HotMilk2020: folds 
Uncalled bet ($0.40) returned to fouktoubaba
fouktoubaba collected $1.19 from pot
fouktoubaba: doesn't show hand 
*** SUMMARY ***
Total pot $1.25 | Rake $0.06 
Board [Tc 5d 6d 6c 2h]
Seat 1: HotMilk2020 folded on the River
Seat 2: LocalFixer folded before Flop (didn't bet)
Seat 3: Rasack007 (button) folded before Flop (didn't bet)
Seat 4: Acedan1369 (small blind) folded before Flop
Seat 5: fouktoubaba (big blind) collected ($1.19)
Seat 6: Vaha379 folded before Flop (didn't bet)



PokerStars Hand #222963132654:  Hold'em No Limit ($0.05/$0.10 USD) - 2021/01/23 13:15:56 ET
Table 'Lutetia III' 6-max Seat #4 is the button
Seat 1: HotMilk2020 ($13.66 in chips) 
Seat 2: LocalFixer ($17.90 in chips) 
Seat 3: Rasack007 ($4.09 in chips) 
Seat 4: Acedan1369 ($10 in chips) 
Seat 5: fouktoubaba ($13.24 in chips) 
Seat 6: Vaha379 ($11.89 in chips) 
fouktoubaba: posts small blind $0.05
Vaha379: posts big blind $0.10
*** HOLE CARDS ***
HotMilk2020: calls $0.10
LocalFixer: folds 
Rasack007: folds 
Acedan1369: folds 
fouktoubaba: raises $0.20 to $0.30
Vaha379: raises $0.90 to $1.20
HotMilk2020: folds 
fouktoubaba: folds 
Uncalled bet ($0.90) returned to Vaha379
Vaha379 collected $0.70 from pot
Vaha379: doesn't show hand 
*** SUMMARY ***
Total pot $0.70 | Rake $0 
Seat 1: HotMilk2020 folded before Flop
Seat 2: LocalFixer folded before Flop (didn't bet)
Seat 3: Rasack007 folded before Flop (didn't bet)
Seat 4: Acedan1369 (button) folded before Flop (didn't bet)
Seat 5: fouktoubaba (small blind) folded before Flop
Seat 6: Vaha379 (big blind) collected ($0.70)



PokerStars Hand #222963148320:  Hold'em No Limit ($0.05/$0.10 USD) - 2021/01/23 13:16:18 ET
Table 'Lutetia III' 6-max Seat #5 is the button
Seat 1: HotMilk2020 ($13.56 in chips) 
Seat 2: LocalFixer ($17.90 in chips) 
Seat 3: Rasack007 ($4.09 in chips) 
Seat 4: Acedan1369 ($10 in chips) 
Seat 5: fouktoubaba ($12.94 in chips) 
Seat 6: Vaha379 ($12.29 in chips) 
Vaha379: posts small blind $0.05
HotMilk2020: posts big blind $0.10
*** HOLE CARDS ***
LocalFixer: folds 
Rasack007: folds 
Acedan1369: raises $0.15 to $0.25
fouktoubaba: calls $0.25
Vaha379: folds 
HotMilk2020: calls $0.15
*** FLOP *** [Ts 5c 6h]
HotMilk2020: checks 
Acedan1369: checks 
fouktoubaba: checks 
*** TURN *** [Ts 5c 6h] [7h]
HotMilk2020: checks 
Acedan1369: checks 
fouktoubaba: checks 
*** RIVER *** [Ts 5c 6h 7h] [Js]
HotMilk2020: checks 
Acedan1369: checks 
fouktoubaba: checks 
*** SHOW DOWN ***
HotMilk2020: shows [4d 4c] (a pair of Fours)
Acedan1369: shows [6d Ad] (a pair of Sixes)
fouktoubaba: mucks hand 
Acedan1369 collected $0.76 from pot
*** SUMMARY ***
Total pot $0.80 | Rake $0.04 
Board [Ts 5c 6h 7h Js]
Seat 1: HotMilk2020 (big blind) showed [4d 4c] and lost with a pair of Fours
Seat 2: LocalFixer folded before Flop (didn't bet)
Seat 3: Rasack007 folded before Flop (didn't bet)
Seat 4: Acedan1369 showed [6d Ad] and won ($0.76) with a pair of Sixes
Seat 5: fouktoubaba (button) mucked
Seat 6: Vaha379 (small blind) folded before Flop



PokerStars Hand #222963197639:  Hold'em No Limit ($0.05/$0.10 USD) - 2021/01/23 13:17:14 ET
Table 'Lutetia III' 6-max Seat #6 is the button
Seat 1: HotMilk2020 ($13.31 in chips) 
Seat 2: LocalFixer ($17.90 in chips) 
Seat 3: Rasack007 ($4.09 in chips) 
Seat 4: Acedan1369 ($10.51 in chips) 
Seat 5: fouktoubaba ($12.69 in chips) 
Seat 6: Vaha379 ($12.24 in chips) 
HotMilk2020: posts small blind $0.05
LocalFixer: posts big blind $0.10
*** HOLE CARDS ***
Rasack007: folds 
Acedan1369: folds 
fouktoubaba: raises $0.20 to $0.30
Vaha379: folds 
HotMilk2020: calls $0.25
LocalFixer: folds 
*** FLOP *** [9s 4s 3c]
HotMilk2020: checks 
fouktoubaba: checks 
*** TURN *** [9s 4s 3c] [2h]
HotMilk2020: checks 
fouktoubaba: checks 
*** RIVER *** [9s 4s 3c 2h] [Td]
HotMilk2020: checks 
fouktoubaba: bets $0.30
HotMilk2020: folds 
Uncalled bet ($0.30) returned to fouktoubaba
fouktoubaba collected $0.67 from pot
fouktoubaba: doesn't show hand 
*** SUMMARY ***
Total pot $0.70 | Rake $0.03 
Board [9s 4s 3c 2h Td]
Seat 1: HotMilk2020 (small blind) folded on the River
Seat 2: LocalFixer (big blind) folded before Flop
Seat 3: Rasack007 folded before Flop (didn't bet)
Seat 4: Acedan1369 folded before Flop (didn't bet)
Seat 5: fouktoubaba collected ($0.67)
Seat 6: Vaha379 (button) folded before Flop (didn't bet)



PokerStars Hand #222963250736:  Hold'em No Limit ($0.05/$0.10 USD) - 2021/01/23 13:18:25 ET
Table 'Lutetia III' 6-max Seat #1 is the button
Seat 1: HotMilk2020 ($13.01 in chips) 
Seat 2: LocalFixer ($17.80 in chips) 
Seat 3: Rasack007 ($4.09 in chips) 
Seat 4: Acedan1369 ($10.51 in chips) 
Seat 5: fouktoubaba ($13.06 in chips) 
Seat 6: Vaha379 ($12.24 in chips) 
LocalFixer: posts small blind $0.05
Rasack007: posts big blind $0.10
*** HOLE CARDS ***
Acedan1369 has timed out
Acedan1369: folds 
fouktoubaba: raises $0.20 to $0.30
Vaha379: folds 
HotMilk2020: folds 
LocalFixer: calls $0.25
Rasack007: folds 
*** FLOP *** [Qh 3d 2s]
LocalFixer: checks 
fouktoubaba: checks 
*** TURN *** [Qh 3d 2s] [Kd]
LocalFixer: checks 
fouktoubaba: bets $0.30
LocalFixer: folds 
Uncalled bet ($0.30) returned to fouktoubaba
fouktoubaba collected $0.67 from pot
fouktoubaba: doesn't show hand 
*** SUMMARY ***
Total pot $0.70 | Rake $0.03 
Board [Qh 3d 2s Kd]
Seat 1: HotMilk2020 (button) folded before Flop (didn't bet)
Seat 2: LocalFixer (small blind) folded on the Turn
Seat 3: Rasack007 (big blind) folded before Flop
Seat 4: Acedan1369 folded before Flop (didn't bet)
Seat 5: fouktoubaba collected ($0.67)
Seat 6: Vaha379 folded before Flop (didn't bet)



PokerStars Hand #222963278226:  Hold'em No Limit ($0.05/$0.10 USD) - 2021/01/23 13:19:02 ET
Table 'Lutetia III' 6-max Seat #2 is the button
Seat 1: HotMilk2020 ($13.01 in chips) 
Seat 2: LocalFixer ($17.50 in chips) 
Seat 3: Rasack007 ($3.99 in chips) 
Seat 4: Acedan1369 ($10.51 in chips) 
Seat 5: fouktoubaba ($13.43 in chips) 
Seat 6: Vaha379 ($12.24 in chips) 
Rasack007: posts small blind $0.05
Acedan1369: posts big blind $0.10
*** HOLE CARDS ***
fouktoubaba: folds 
Vaha379: folds 
HotMilk2020: folds 
LocalFixer: raises $0.10 to $0.20
Rasack007: folds 
Acedan1369: folds 
Uncalled bet ($0.10) returned to LocalFixer
LocalFixer collected $0.25 from pot
LocalFixer: doesn't show hand 
*** SUMMARY ***
Total pot $0.25 | Rake $0 
Seat 1: HotMilk2020 folded before Flop (didn't bet)
Seat 2: LocalFixer (button) collected ($0.25)
Seat 3: Rasack007 (small blind) folded before Flop
Seat 4: Acedan1369 (big blind) folded before Flop
Seat 5: fouktoubaba folded before Flop (didn't bet)
Seat 6: Vaha379 folded before Flop (didn't bet)



PokerStars Hand #222963289211:  Hold'em No Limit ($0.05/$0.10 USD) - 2021/01/23 13:19:16 ET
Table 'Lutetia III' 6-max Seat #3 is the button
Seat 1: HotMilk2020 ($13.01 in chips) 
Seat 2: LocalFixer ($17.65 in chips) 
Seat 3: Rasack007 ($3.94 in chips) 
Seat 4: Acedan1369 ($10.41 in chips) 
Seat 5: fouktoubaba ($13.43 in chips) 
Seat 6: Vaha379 ($12.24 in chips) 
Acedan1369: posts small blind $0.05
fouktoubaba: posts big blind $0.10
*** HOLE CARDS ***
Vaha379: folds 
HotMilk2020: folds 
LocalFixer: folds 
Rasack007: raises $0.20 to $0.30
Acedan1369: folds 
fouktoubaba: calls $0.20
*** FLOP *** [3d Kd 2c]
fouktoubaba: checks 
Rasack007: bets $0.40
fouktoubaba: calls $0.40
*** TURN *** [3d Kd 2c] [5c]
fouktoubaba: checks 
Rasack007: bets $0.40
fouktoubaba: calls $0.40
*** RIVER *** [3d Kd 2c 5c] [9h]
fouktoubaba: bets $1.07
Rasack007: calls $1.07
*** SHOW DOWN ***
fouktoubaba: shows [Kh 9d] (two pair, Kings and Nines)
Rasack007: mucks hand 
fouktoubaba collected $4.19 from pot
*** SUMMARY ***
Total pot $4.39 | Rake $0.20 
Board [3d Kd 2c 5c 9h]
Seat 1: HotMilk2020 folded before Flop (didn't bet)
Seat 2: LocalFixer folded before Flop (didn't bet)
Seat 3: Rasack007 (button) mucked
Seat 4: Acedan1369 (small blind) folded before Flop
Seat 5: fouktoubaba (big blind) showed [Kh 9d] and won ($4.19) with two pair, Kings and Nines
Seat 6: Vaha379 folded before Flop (didn't bet)



PokerStars Hand #222963321812:  Hold'em No Limit ($0.05/$0.10 USD) - 2021/01/23 13:20:00 ET
Table 'Lutetia III' 6-max Seat #4 is the button
Seat 1: HotMilk2020 ($13.01 in chips) 
Seat 2: LocalFixer ($17.65 in chips) 
Seat 3: Rasack007 ($1.77 in chips) 
Seat 4: Acedan1369 ($10.36 in chips) 
Seat 5: fouktoubaba ($15.45 in chips) 
Seat 6: Vaha379 ($12.24 in chips) 
fouktoubaba: posts small blind $0.05
Vaha379: posts big blind $0.10
*** HOLE CARDS ***
HotMilk2020: folds 
LocalFixer: folds 
Rasack007: folds 
Acedan1369: folds 
fouktoubaba: raises $0.20 to $0.30
Vaha379: folds 
Uncalled bet ($0.20) returned to fouktoubaba
fouktoubaba collected $0.20 from pot
fouktoubaba: doesn't show hand 
Rasack007 leaves the table
*** SUMMARY ***
Total pot $0.20 | Rake $0 
Seat 1: HotMilk2020 folded before Flop (didn't bet)
Seat 2: LocalFixer folded before Flop (didn't bet)
Seat 3: Rasack007 folded before Flop (didn't bet)
Seat 4: Acedan1369 (button) folded before Flop (didn't bet)
Seat 5: fouktoubaba (small blind) collected ($0.20)
Seat 6: Vaha379 (big blind) folded before Flop



PokerStars Hand #222963336068:  Hold'em No Limit ($0.05/$0.10 USD) - 2021/01/23 13:20:19 ET
Table 'Lutetia III' 6-max Seat #5 is the button
Seat 1: HotMilk2020 ($13.01 in chips) 
Seat 2: LocalFixer ($17.65 in chips) 
Seat 4: Acedan1369 ($10.36 in chips) 
Seat 5: fouktoubaba ($15.55 in chips) 
Seat 6: Vaha379 ($12.14 in chips) 
Vaha379: posts small blind $0.05
HotMilk2020: posts big blind $0.10
*** HOLE CARDS ***
LocalFixer: folds 
Acedan1369: folds 
fouktoubaba: folds 
Vaha379: raises $0.20 to $0.30
HotMilk2020: calls $0.20
*** FLOP *** [9c 5d Ac]
Diana4teen joins the table at seat #3 
Vaha379: bets $0.48
HotMilk2020: folds 
Uncalled bet ($0.48) returned to Vaha379
Vaha379 collected $0.57 from pot
Vaha379: doesn't show hand 
*** SUMMARY ***
Total pot $0.60 | Rake $0.03 
Board [9c 5d Ac]
Seat 1: HotMilk2020 (big blind) folded on the Flop
Seat 2: LocalFixer folded before Flop (didn't bet)
Seat 4: Acedan1369 folded before Flop (didn't bet)
Seat 5: fouktoubaba (button) folded before Flop (didn't bet)
Seat 6: Vaha379 (small blind) collected ($0.57)



PokerStars Hand #222963349351:  Hold'em No Limit ($0.05/$0.10 USD) - 2021/01/23 13:20:36 ET
Table 'Lutetia III' 6-max Seat #6 is the button
Seat 1: HotMilk2020 ($12.71 in chips) 
Seat 2: LocalFixer ($17.65 in chips) 
Seat 4: Acedan1369 ($10.36 in chips) 
Seat 5: fouktoubaba ($15.55 in chips) 
Seat 6: Vaha379 ($12.41 in chips) 
HotMilk2020: posts small blind $0.05
LocalFixer: posts big blind $0.10
Diana4teen: sits out 
*** HOLE CARDS ***
Acedan1369: raises $0.15 to $0.25
fouktoubaba: calls $0.25
Vaha379: folds 
HotMilk2020: folds 
LocalFixer: calls $0.15
*** FLOP *** [Kd Ts Qd]
LocalFixer: checks 
Acedan1369: bets $0.57
fouktoubaba: folds 
LocalFixer: folds 
Uncalled bet ($0.57) returned to Acedan1369
Acedan1369 collected $0.76 from pot
Acedan1369: doesn't show hand 
*** SUMMARY ***
Total pot $0.80 | Rake $0.04 
Board [Kd Ts Qd]
Seat 1: HotMilk2020 (small blind) folded before Flop
Seat 2: LocalFixer (big blind) folded on the Flop
Seat 4: Acedan1369 collected ($0.76)
Seat 5: fouktoubaba folded on the Flop
Seat 6: Vaha379 (button) folded before Flop (didn't bet)



PokerStars Hand #222963365914:  Hold'em No Limit ($0.05/$0.10 USD) - 2021/01/23 13:20:58 ET
Table 'Lutetia III' 6-max Seat #1 is the button
Seat 1: HotMilk2020 ($12.66 in chips) 
Seat 2: LocalFixer ($17.40 in chips) 
Seat 3: Diana4teen ($5 in chips) 
Seat 4: Acedan1369 ($10.87 in chips) 
Seat 5: fouktoubaba ($15.30 in chips) 
Seat 6: Vaha379 ($12.41 in chips) 
LocalFixer: posts small blind $0.05
Diana4teen: posts big blind $0.10
*** HOLE CARDS ***
Acedan1369: folds 
fouktoubaba: folds 
Vaha379: raises $0.20 to $0.30
HotMilk2020: folds 
LocalFixer: folds 
Diana4teen: calls $0.20
*** FLOP *** [6h 6c Th]
Diana4teen: checks 
Vaha379: checks 
*** TURN *** [6h 6c Th] [8c]
Diana4teen: bets $0.51
Vaha379: calls $0.51
*** RIVER *** [6h 6c Th 8c] [5h]
Diana4teen: bets $0.70
Vaha379: folds 
Uncalled bet ($0.70) returned to Diana4teen
Diana4teen collected $1.59 from pot
Diana4teen: doesn't show hand 
*** SUMMARY ***
Total pot $1.67 | Rake $0.08 
Board [6h 6c Th 8c 5h]
Seat 1: HotMilk2020 (button) folded before Flop (didn't bet)
Seat 2: LocalFixer (small blind) folded before Flop
Seat 3: Diana4teen (big blind) collected ($1.59)
Seat 4: Acedan1369 folded before Flop (didn't bet)
Seat 5: fouktoubaba folded before Flop (didn't bet)
Seat 6: Vaha379 folded on the River



PokerStars Hand #222963409086:  Hold'em No Limit ($0.05/$0.10 USD) - 2021/01/23 13:21:56 ET
Table 'Lutetia III' 6-max Seat #2 is the button
Seat 1: HotMilk2020 ($12.66 in chips) 
Seat 2: LocalFixer ($17.35 in chips) 
Seat 3: Diana4teen ($5.78 in chips) 
Seat 4: Acedan1369 ($10.87 in chips) 
Seat 5: fouktoubaba ($15.30 in chips) 
Seat 6: Vaha379 ($11.60 in chips) 
Diana4teen: posts small blind $0.05
Acedan1369: posts big blind $0.10
*** HOLE CARDS ***
fouktoubaba: raises $0.20 to $0.30
Vaha379: folds 
HotMilk2020: folds 
LocalFixer: folds 
Diana4teen: folds 
Acedan1369: raises $0.55 to $0.85
fouktoubaba: folds 
Uncalled bet ($0.55) returned to Acedan1369
Acedan1369 collected $0.65 from pot
Acedan1369: doesn't show hand 
*** SUMMARY ***
Total pot $0.65 | Rake $0 
Seat 1: HotMilk2020 folded before Flop (didn't bet)
Seat 2: LocalFixer (button) folded before Flop (didn't bet)
Seat 3: Diana4teen (small blind) folded before Flop
Seat 4: Acedan1369 (big blind) collected ($0.65)
Seat 5: fouktoubaba folded before Flop
Seat 6: Vaha379 folded before Flop (didn't bet)



PokerStars Hand #222963427638:  Hold'em No Limit ($0.05/$0.10 USD) - 2021/01/23 13:22:21 ET
Table 'Lutetia III' 6-max Seat #3 is the button
Seat 1: HotMilk2020 ($12.66 in chips) 
Seat 2: LocalFixer ($17.35 in chips) 
Seat 3: Diana4teen ($5.73 in chips) 
Seat 4: Acedan1369 ($11.22 in chips) 
Seat 5: fouktoubaba ($15 in chips) 
Seat 6: Vaha379 ($11.60 in chips) 
Acedan1369: posts small blind $0.05
fouktoubaba: posts big blind $0.10
*** HOLE CARDS ***
Vaha379: raises $0.20 to $0.30
HotMilk2020: folds 
LocalFixer: folds 
Diana4teen: folds 
Acedan1369: folds 
fouktoubaba: calls $0.20
*** FLOP *** [Qh 6d Ac]
fouktoubaba: checks 
Vaha379: bets $0.21
fouktoubaba: calls $0.21
*** TURN *** [Qh 6d Ac] [8c]
fouktoubaba: checks 
Vaha379: bets $0.91
fouktoubaba: raises $1.42 to $2.33
Vaha379: raises $3.54 to $5.87
fouktoubaba: calls $3.54
*** RIVER *** [Qh 6d Ac 8c] [9c]
fouktoubaba: checks 
Vaha379: bets $5.22 and is all-in
fouktoubaba: calls $5.22
*** SHOW DOWN ***
Vaha379: shows [As Ad] (three of a kind, Aces)
fouktoubaba: shows [8s Qs] (two pair, Queens and Eights)
Vaha379 collected $22.20 from pot
*** SUMMARY ***
Total pot $23.25 | Rake $1.05 
Board [Qh 6d Ac 8c 9c]
Seat 1: HotMilk2020 folded before Flop (didn't bet)
Seat 2: LocalFixer folded before Flop (didn't bet)
Seat 3: Diana4teen (button) folded before Flop (didn't bet)
Seat 4: Acedan1369 (small blind) folded before Flop
Seat 5: fouktoubaba (big blind) showed [8s Qs] and lost with two pair, Queens and Eights
Seat 6: Vaha379 showed [As Ad] and won ($22.20) with three of a kind, Aces



PokerStars Hand #222963466016:  Hold'em No Limit ($0.05/$0.10 USD) - 2021/01/23 13:23:12 ET
Table 'Lutetia III' 6-max Seat #4 is the button
Seat 1: HotMilk2020 ($12.66 in chips) 
Seat 2: LocalFixer ($17.35 in chips) 
Seat 3: Diana4teen ($5.73 in chips) 
Seat 4: Acedan1369 ($11.17 in chips) 
Seat 5: fouktoubaba ($10 in chips) 
Seat 6: Vaha379 ($22.20 in chips) 
fouktoubaba: posts small blind $0.05
Vaha379: posts big blind $0.10
*** HOLE CARDS ***
HotMilk2020: folds 
LocalFixer: folds 
Diana4teen: calls $0.10
Acedan1369: folds 
fouktoubaba: raises $0.20 to $0.30
Vaha379: folds 
Diana4teen: calls $0.20
*** FLOP *** [3c Kc 4c]
fouktoubaba: bets $0.33
Diana4teen: raises $0.63 to $0.96
fouktoubaba: calls $0.63
*** TURN *** [3c Kc 4c] [Qc]
fouktoubaba: checks 
Diana4teen: checks 
*** RIVER *** [3c Kc 4c Qc] [8d]
Vaha379 leaves the table
fouktoubaba: bets $1.25
Diana4teen: calls $1.25
*** SHOW DOWN ***
fouktoubaba: shows [Kh 9c] (a flush, King high)
Diana4teen: shows [Jc 2c] (a flush, King high - Jack higher)
Diana4teen collected $4.89 from pot
*** SUMMARY ***
Total pot $5.12 | Rake $0.23 
Board [3c Kc 4c Qc 8d]
Seat 1: HotMilk2020 folded before Flop (didn't bet)
Seat 2: LocalFixer folded before Flop (didn't bet)
Seat 3: Diana4teen showed [Jc 2c] and won ($4.89) with a flush, King high
Seat 4: Acedan1369 (button) folded before Flop (didn't bet)
Seat 5: fouktoubaba (small blind) showed [Kh 9c] and lost with a flush, King high
Seat 6: Vaha379 (big blind) folded before Flop



PokerStars Hand #222963521821:  Hold'em No Limit ($0.05/$0.10 USD) - 2021/01/23 13:24:25 ET
Table 'Lutetia III' 6-max Seat #5 is the button
Seat 1: HotMilk2020 ($12.66 in chips) 
Seat 2: LocalFixer ($17.35 in chips) 
Seat 3: Diana4teen ($8.11 in chips) 
Seat 4: Acedan1369 ($11.17 in chips) 
Seat 5: fouktoubaba ($10 in chips) 
HotMilk2020: posts small blind $0.05
LocalFixer: posts big blind $0.10
*** HOLE CARDS ***
snowbird87 joins the table at seat #6 
Diana4teen: calls $0.10
Acedan1369: raises $0.30 to $0.40
fouktoubaba: calls $0.40
HotMilk2020: folds 
LocalFixer: folds 
Diana4teen: calls $0.30
*** FLOP *** [5c 8d Jd]
Diana4teen: checks 
Acedan1369: bets $0.97
fouktoubaba: calls $0.97
Diana4teen: calls $0.97
*** TURN *** [5c 8d Jd] [4c]
Diana4teen: checks 
Acedan1369: bets $3.05
fouktoubaba: calls $3.05
Diana4teen: calls $3.05
*** RIVER *** [5c 8d Jd 4c] [9h]
Diana4teen: bets $3.69 and is all-in
Acedan1369: folds 
fouktoubaba: calls $3.69
*** SHOW DOWN ***
Diana4teen: shows [Tc Qc] (a straight, Eight to Queen)
fouktoubaba: shows [As Ah] (a pair of Aces)
Diana4teen collected $19.85 from pot
*** SUMMARY ***
Total pot $20.79 | Rake $0.94 
Board [5c 8d Jd 4c 9h]
Seat 1: HotMilk2020 (small blind) folded before Flop
Seat 2: LocalFixer (big blind) folded before Flop
Seat 3: Diana4teen showed [Tc Qc] and won ($19.85) with a straight, Eight to Queen
Seat 4: Acedan1369 folded on the River
Seat 5: fouktoubaba (button) showed [As Ah] and lost with a pair of Aces



PokerStars Hand #222963602651:  Hold'em No Limit ($0.05/$0.10 USD) - 2021/01/23 13:26:12 ET
Table 'Lutetia III' 6-max Seat #1 is the button
Seat 1: HotMilk2020 ($12.61 in chips) 
Seat 2: LocalFixer ($17.25 in chips) 
Seat 3: Diana4teen ($19.85 in chips) 
Seat 4: Acedan1369 ($10 in chips) 
Seat 5: fouktoubaba ($10 in chips) 
Seat 6: snowbird87 ($8 in chips) 
LocalFixer: posts small blind $0.05
Diana4teen: posts big blind $0.10
snowbird87: posts big blind $0.10
*** HOLE CARDS ***
Acedan1369: raises $0.30 to $0.40
fouktoubaba: folds 
fouktoubaba leaves the table
snowbird87: calls $0.30
HotMilk2020: folds 
LocalFixer: folds 
Diana4teen: folds 
*** FLOP *** [Ts Qc 8c]
Acedan1369: bets $0.68
snowbird87: raises $1.14 to $1.82
Acedan1369: calls $1.14
*** TURN *** [Ts Qc 8c] [4d]
Acedan1369: checks 
snowbird87: checks 
*** RIVER *** [Ts Qc 8c 4d] [Jd]
RN152 joins the table at seat #5 
Acedan1369: checks 
snowbird87: bets $2.19
Acedan1369: folds 
Uncalled bet ($2.19) returned to snowbird87
snowbird87 collected $4.38 from pot
snowbird87: doesn't show hand 
*** SUMMARY ***
Total pot $4.59 | Rake $0.21 
Board [Ts Qc 8c 4d Jd]
Seat 1: HotMilk2020 (button) folded before Flop (didn't bet)
Seat 2: LocalFixer (small blind) folded before Flop
Seat 3: Diana4teen (big blind) folded before Flop
Seat 4: Acedan1369 folded on the River
Seat 5: fouktoubaba folded before Flop (didn't bet)
Seat 6: snowbird87 collected ($4.38)



PokerStars Hand #222963648152:  Hold'em No Limit ($0.05/$0.10 USD) - 2021/01/23 13:27:12 ET
Table 'Lutetia III' 6-max Seat #2 is the button
Seat 1: HotMilk2020 ($12.61 in chips) 
Seat 2: LocalFixer ($17.20 in chips) 
Seat 3: Diana4teen ($19.75 in chips) 
Seat 4: Acedan1369 ($10 in chips) 
Seat 6: snowbird87 ($10.16 in chips) 
Diana4teen: posts small blind $0.05
Acedan1369: posts big blind $0.10
RN152: sits out 
*** HOLE CARDS ***
snowbird87: raises $0.20 to $0.30
HotMilk2020: folds 
LocalFixer: folds 
Diana4teen: calls $0.25
Acedan1369: folds 
*** FLOP *** [6d 9s 4s]
Diana4teen: checks 
snowbird87: checks 
*** TURN *** [6d 9s 4s] [5c]
Diana4teen: checks 
snowbird87: checks 
*** RIVER *** [6d 9s 4s 5c] [9h]
Diana4teen: checks 
snowbird87: checks 
*** SHOW DOWN ***
Diana4teen: shows [Ts Ah] (a pair of Nines)
snowbird87: mucks hand 
Diana4teen collected $0.67 from pot
*** SUMMARY ***
Total pot $0.70 | Rake $0.03 
Board [6d 9s 4s 5c 9h]
Seat 1: HotMilk2020 folded before Flop (didn't bet)
Seat 2: LocalFixer (button) folded before Flop (didn't bet)
Seat 3: Diana4teen (small blind) showed [Ts Ah] and won ($0.67) with a pair of Nines
Seat 4: Acedan1369 (big blind) folded before Flop
Seat 6: snowbird87 mucked



PokerStars Hand #222963678396:  Hold'em No Limit ($0.05/$0.10 USD) - 2021/01/23 13:27:52 ET
Table 'Lutetia III' 6-max Seat #3 is the button
Seat 1: HotMilk2020 ($12.61 in chips) 
Seat 2: LocalFixer ($17.20 in chips) 
Seat 3: Diana4teen ($20.12 in chips) 
Seat 4: Acedan1369 ($10 in chips) 
Seat 5: RN152 ($10 in chips) 
Seat 6: snowbird87 ($9.86 in chips) 
Acedan1369: posts small blind $0.05
RN152: posts big blind $0.10
*** HOLE CARDS ***
snowbird87: folds 
HotMilk2020: calls $0.10
LocalFixer: folds 
Diana4teen: calls $0.10
Acedan1369: folds 
RN152: checks 
*** FLOP *** [Jc 6d 2s]
RN152: checks 
HotMilk2020: checks 
Diana4teen: checks 
*** TURN *** [Jc 6d 2s] [Ac]
RN152: checks 
HotMilk2020: bets $0.10
Diana4teen: folds 
RN152: folds 
Uncalled bet ($0.10) returned to HotMilk2020
HotMilk2020 collected $0.33 from pot
HotMilk2020: doesn't show hand 
*** SUMMARY ***
Total pot $0.35 | Rake $0.02 
Board [Jc 6d 2s Ac]
Seat 1: HotMilk2020 collected ($0.33)
Seat 2: LocalFixer folded before Flop (didn't bet)
Seat 3: Diana4teen (button) folded on the Turn
Seat 4: Acedan1369 (small blind) folded before Flop
Seat 5: RN152 (big blind) folded on the Turn
Seat 6: snowbird87 folded before Flop (didn't bet)



PokerStars Hand #222963722194:  Hold'em No Limit ($0.05/$0.10 USD) - 2021/01/23 13:28:50 ET
Table 'Lutetia III' 6-max Seat #4 is the button
Seat 1: HotMilk2020 ($12.84 in chips) 
Seat 2: LocalFixer ($17.20 in chips) 
Seat 3: Diana4teen ($20.02 in chips) 
Seat 4: Acedan1369 ($10 in chips) 
Seat 5: RN152 ($10 in chips) 
Seat 6: snowbird87 ($9.86 in chips) 
RN152: posts small blind $0.05
snowbird87: posts big blind $0.10
*** HOLE CARDS ***
HotMilk2020: calls $0.10
LocalFixer: folds 
Diana4teen: folds 
Acedan1369: folds 
RN152: calls $0.05
snowbird87: checks 
*** FLOP *** [7s 6d 7c]
RN152: checks 
snowbird87: checks 
HotMilk2020: bets $0.10
RN152: calls $0.10
snowbird87: calls $0.10
*** TURN *** [7s 6d 7c] [6s]
RN152: checks 
snowbird87: checks 
HotMilk2020: checks 
*** RIVER *** [7s 6d 7c 6s] [Kd]
RN152: bets $0.38
snowbird87: folds 
HotMilk2020: folds 
Uncalled bet ($0.38) returned to RN152
RN152 collected $0.57 from pot
RN152: doesn't show hand 
*** SUMMARY ***
Total pot $0.60 | Rake $0.03 
Board [7s 6d 7c 6s Kd]
Seat 1: HotMilk2020 folded on the River
Seat 2: LocalFixer folded before Flop (didn't bet)
Seat 3: Diana4teen folded before Flop (didn't bet)
Seat 4: Acedan1369 (button) folded before Flop (didn't bet)
Seat 5: RN152 (small blind) collected ($0.57)
Seat 6: snowbird87 (big blind) folded on the River



PokerStars Hand #222963765411:  Hold'em No Limit ($0.05/$0.10 USD) - 2021/01/23 13:29:47 ET
Table 'Lutetia III' 6-max Seat #5 is the button
Seat 1: HotMilk2020 ($12.64 in chips) 
Seat 2: LocalFixer ($17.20 in chips) 
Seat 3: Diana4teen ($20.02 in chips) 
Seat 4: Acedan1369 ($10 in chips) 
Seat 5: RN152 ($10.37 in chips) 
Seat 6: snowbird87 ($9.66 in chips) 
snowbird87: posts small blind $0.05
HotMilk2020: posts big blind $0.10
*** HOLE CARDS ***
LocalFixer: folds 
Diana4teen: folds 
Acedan1369: folds 
RN152: raises $0.15 to $0.25
snowbird87: calls $0.20
HotMilk2020: calls $0.15
*** FLOP *** [4h 3s 9s]
snowbird87: bets $0.36
HotMilk2020: raises $0.36 to $0.72
RN152: folds 
snowbird87: folds 
Uncalled bet ($0.36) returned to HotMilk2020
HotMilk2020 collected $1.40 from pot
HotMilk2020: doesn't show hand 
*** SUMMARY ***
Total pot $1.47 | Rake $0.07 
Board [4h 3s 9s]
Seat 1: HotMilk2020 (big blind) collected ($1.40)
Seat 2: LocalFixer folded before Flop (didn't bet)
Seat 3: Diana4teen folded before Flop (didn't bet)
Seat 4: Acedan1369 folded before Flop (didn't bet)
Seat 5: RN152 (button) folded on the Flop
Seat 6: snowbird87 (small blind) folded on the Flop



PokerStars Hand #222963796079:  Hold'em No Limit ($0.05/$0.10 USD) - 2021/01/23 13:30:27 ET
Table 'Lutetia III' 6-max Seat #6 is the button
Seat 1: HotMilk2020 ($13.43 in chips) 
Seat 2: LocalFixer ($17.20 in chips) 
Seat 3: Diana4teen ($20.02 in chips) 
Seat 4: Acedan1369 ($10 in chips) 
Seat 5: RN152 ($10.12 in chips) 
Seat 6: snowbird87 ($9.05 in chips) 
HotMilk2020: posts small blind $0.05
LocalFixer: posts big blind $0.10
*** HOLE CARDS ***
Diana4teen: folds 
Acedan1369: raises $0.15 to $0.25
RN152: folds 
snowbird87: folds 
HotMilk2020: calls $0.20
LocalFixer: calls $0.15
*** FLOP *** [Tc 8c Jd]
HotMilk2020: checks 
LocalFixer: checks 
Acedan1369: checks 
*** TURN *** [Tc 8c Jd] [3h]
HotMilk2020: checks 
LocalFixer: bets $0.55
Acedan1369: calls $0.55
HotMilk2020: folds 
*** RIVER *** [Tc 8c Jd 3h] [3s]
LocalFixer: checks 
Acedan1369: checks 
*** SHOW DOWN ***
LocalFixer: shows [7c Ac] (a pair of Threes)
Acedan1369: mucks hand 
LocalFixer collected $1.77 from pot
*** SUMMARY ***
Total pot $1.85 | Rake $0.08 
Board [Tc 8c Jd 3h 3s]
Seat 1: HotMilk2020 (small blind) folded on the Turn
Seat 2: LocalFixer (big blind) showed [7c Ac] and won ($1.77) with a pair of Threes
Seat 3: Diana4teen folded before Flop (didn't bet)
Seat 4: Acedan1369 mucked
Seat 5: RN152 folded before Flop (didn't bet)
Seat 6: snowbird87 (button) folded before Flop (didn't bet)



PokerStars Hand #222963838183:  Hold'em No Limit ($0.05/$0.10 USD) - 2021/01/23 13:31:21 ET
Table 'Lutetia III' 6-max Seat #1 is the button
Seat 1: HotMilk2020 ($13.18 in chips) 
Seat 2: LocalFixer ($18.17 in chips) 
Seat 3: Diana4teen ($20.02 in chips) 
Seat 4: Acedan1369 ($10 in chips) 
Seat 5: RN152 ($10.12 in chips) 
Seat 6: snowbird87 ($9.05 in chips) 
LocalFixer: posts small blind $0.05
Diana4teen: posts big blind $0.10
*** HOLE CARDS ***
Acedan1369: folds 
RN152: folds 
snowbird87: folds 
HotMilk2020: folds 
LocalFixer: folds 
Uncalled bet ($0.05) returned to Diana4teen
Diana4teen collected $0.10 from pot
Diana4teen: doesn't show hand 
*** SUMMARY ***
Total pot $0.10 | Rake $0 
Seat 1: HotMilk2020 (button) folded before Flop (didn't bet)
Seat 2: LocalFixer (small blind) folded before Flop
Seat 3: Diana4teen (big blind) collected ($0.10)
Seat 4: Acedan1369 folded before Flop (didn't bet)
Seat 5: RN152 folded before Flop (didn't bet)
Seat 6: snowbird87 folded before Flop (didn't bet)



PokerStars Hand #222963850182:  Hold'em No Limit ($0.05/$0.10 USD) - 2021/01/23 13:31:36 ET
Table 'Lutetia III' 6-max Seat #2 is the button
Seat 1: HotMilk2020 ($13.18 in chips) 
Seat 2: LocalFixer ($18.12 in chips) 
Seat 3: Diana4teen ($20.07 in chips) 
Seat 4: Acedan1369 ($10 in chips) 
Seat 5: RN152 ($10.12 in chips) 
Seat 6: snowbird87 ($9.05 in chips) 
Diana4teen: posts small blind $0.05
Acedan1369: posts big blind $0.10
*** HOLE CARDS ***
RN152: folds 
snowbird87: calls $0.10
HotMilk2020: folds 
LocalFixer: raises $0.30 to $0.40
Diana4teen: folds 
Acedan1369: folds 
snowbird87: calls $0.30
*** FLOP *** [4h 8s Th]
snowbird87: checks 
LocalFixer: bets $0.50
snowbird87: calls $0.50
*** TURN *** [4h 8s Th] [7h]
snowbird87: checks 
LocalFixer: bets $1.43
snowbird87: folds 
Uncalled bet ($1.43) returned to LocalFixer
LocalFixer collected $1.86 from pot
LocalFixer: doesn't show hand 
*** SUMMARY ***
Total pot $1.95 | Rake $0.09 
Board [4h 8s Th 7h]
Seat 1: HotMilk2020 folded before Flop (didn't bet)
Seat 2: LocalFixer (button) collected ($1.86)
Seat 3: Diana4teen (small blind) folded before Flop
Seat 4: Acedan1369 (big blind) folded before Flop
Seat 5: RN152 folded before Flop (didn't bet)
Seat 6: snowbird87 folded on the Turn



PokerStars Hand #222963875191:  Hold'em No Limit ($0.05/$0.10 USD) - 2021/01/23 13:32:08 ET
Table 'Lutetia III' 6-max Seat #3 is the button
Seat 1: HotMilk2020 ($13.18 in chips) 
Seat 2: LocalFixer ($19.08 in chips) 
Seat 3: Diana4teen ($20.02 in chips) 
Seat 4: Acedan1369 ($10 in chips) 
Seat 5: RN152 ($10.12 in chips) 
Seat 6: snowbird87 ($8.15 in chips) 
Acedan1369: posts small blind $0.05
RN152: posts big blind $0.10
*** HOLE CARDS ***
snowbird87: raises $0.20 to $0.30
HotMilk2020: folds 
LocalFixer: folds 
Diana4teen: calls $0.30
Acedan1369: folds 
RN152: folds 
*** FLOP *** [Qs As 4h]
snowbird87: checks 
Diana4teen: checks 
*** TURN *** [Qs As 4h] [Jd]
snowbird87: checks 
Diana4teen: bets $0.40
snowbird87: folds 
Uncalled bet ($0.40) returned to Diana4teen
Diana4teen collected $0.72 from pot
Diana4teen: doesn't show hand 
*** SUMMARY ***
Total pot $0.75 | Rake $0.03 
Board [Qs As 4h Jd]
Seat 1: HotMilk2020 folded before Flop (didn't bet)
Seat 2: LocalFixer folded before Flop (didn't bet)
Seat 3: Diana4teen (button) collected ($0.72)
Seat 4: Acedan1369 (small blind) folded before Flop
Seat 5: RN152 (big blind) folded before Flop
Seat 6: snowbird87 folded on the Turn



PokerStars Hand #222963912633:  Hold'em No Limit ($0.05/$0.10 USD) - 2021/01/23 13:32:56 ET
Table 'Lutetia III' 6-max Seat #4 is the button
Seat 1: HotMilk2020 ($13.18 in chips) 
Seat 2: LocalFixer ($19.08 in chips) 
Seat 3: Diana4teen ($20.44 in chips) 
Seat 4: Acedan1369 ($10 in chips) 
Seat 5: RN152 ($10.02 in chips) 
RN152: posts small blind $0.05
snowbird87: is sitting out 
HotMilk2020: posts big blind $0.10
*** HOLE CARDS ***
LocalFixer: folds 
snowbird87 leaves the table
mikhail_dubkov joins the table at seat #6 
Diana4teen: folds 
Acedan1369 has timed out
Acedan1369: folds 
RN152: folds 
Uncalled bet ($0.05) returned to HotMilk2020
HotMilk2020 collected $0.10 from pot
HotMilk2020: doesn't show hand 
*** SUMMARY ***
Total pot $0.10 | Rake $0 
Seat 1: HotMilk2020 (big blind) collected ($0.10)
Seat 2: LocalFixer folded before Flop (didn't bet)
Seat 3: Diana4teen folded before Flop (didn't bet)
Seat 4: Acedan1369 (button) folded before Flop (didn't bet)
Seat 5: RN152 (small blind) folded before Flop



PokerStars Hand #222963931805:  Hold'em No Limit ($0.05/$0.10 USD) - 2021/01/23 13:33:21 ET
Table 'Lutetia III' 6-max Seat #5 is the button
Seat 1: HotMilk2020 ($13.23 in chips) 
Seat 2: LocalFixer ($19.08 in chips) 
Seat 3: Diana4teen ($20.44 in chips) 
Seat 4: Acedan1369 ($10 in chips) 
Seat 5: RN152 ($10 in chips) 
HotMilk2020: posts small blind $0.05
LocalFixer: posts big blind $0.10
*** HOLE CARDS ***
Diana4teen: calls $0.10
Acedan1369: folds 
RN152: folds 
HotMilk2020: raises $0.10 to $0.20
LocalFixer: folds 
Diana4teen: calls $0.10
*** FLOP *** [8h 8d Ac]
HotMilk2020: bets $0.10
Diana4teen: raises $0.30 to $0.40
HotMilk2020: calls $0.30
*** TURN *** [8h 8d Ac] [Js]
HotMilk2020: checks 
Diana4teen: bets $0.80
HotMilk2020: folds 
Uncalled bet ($0.80) returned to Diana4teen
Diana4teen collected $1.24 from pot
Diana4teen: doesn't show hand 
*** SUMMARY ***
Total pot $1.30 | Rake $0.06 
Board [8h 8d Ac Js]
Seat 1: HotMilk2020 (small blind) folded on the Turn
Seat 2: LocalFixer (big blind) folded before Flop
Seat 3: Diana4teen collected ($1.24)
Seat 4: Acedan1369 folded before Flop (didn't bet)
Seat 5: RN152 (button) folded before Flop (didn't bet)



PokerStars Hand #222963979000:  Hold'em No Limit ($0.05/$0.10 USD) - 2021/01/23 13:34:21 ET
Table 'Lutetia III' 6-max Seat #1 is the button
Seat 1: HotMilk2020 ($12.63 in chips) 
Seat 2: LocalFixer ($18.98 in chips) 
Seat 3: Diana4teen ($21.08 in chips) 
Seat 4: Acedan1369 ($10 in chips) 
Seat 5: RN152 ($10 in chips) 
LocalFixer: posts small blind $0.05
Diana4teen: posts big blind $0.10
mikhail_dubkov: sits out 
*** HOLE CARDS ***
Acedan1369 has timed out
Acedan1369: folds 
RN152: folds 
HotMilk2020: folds 
LocalFixer: raises $0.20 to $0.30
Diana4teen: folds 
Uncalled bet ($0.20) returned to LocalFixer
LocalFixer collected $0.20 from pot
LocalFixer: doesn't show hand 
*** SUMMARY ***
Total pot $0.20 | Rake $0 
Seat 1: HotMilk2020 (button) folded before Flop (didn't bet)
Seat 2: LocalFixer (small blind) collected ($0.20)
Seat 3: Diana4teen (big blind) folded before Flop
Seat 4: Acedan1369 folded before Flop (didn't bet)
Seat 5: RN152 folded before Flop (didn't bet)



PokerStars Hand #222963996425:  Hold'em No Limit ($0.05/$0.10 USD) - 2021/01/23 13:34:44 ET
Table 'Lutetia III' 6-max Seat #2 is the button
Seat 1: HotMilk2020 ($12.63 in chips) 
Seat 2: LocalFixer ($19.08 in chips) 
Seat 3: Diana4teen ($20.98 in chips) 
Seat 5: RN152 ($10 in chips) 
Diana4teen: posts small blind $0.05
RN152: posts big blind $0.10
mikhail_dubkov: sits out 
*** HOLE CARDS ***
HotMilk2020: calls $0.10
LocalFixer: folds 
Diana4teen: calls $0.05
RN152: checks 
*** FLOP *** [As Kc Ts]
Diana4teen: checks 
RN152: checks 
HotMilk2020: checks 
*** TURN *** [As Kc Ts] [Js]
Diana4teen: checks 
RN152: checks 
HotMilk2020: checks 
*** RIVER *** [As Kc Ts Js] [Kd]
Diana4teen: bets $0.10
RN152: folds 
HotMilk2020: folds 
Uncalled bet ($0.10) returned to Diana4teen
Diana4teen collected $0.29 from pot
Diana4teen: doesn't show hand 
*** SUMMARY ***
Total pot $0.30 | Rake $0.01 
Board [As Kc Ts Js Kd]
Seat 1: HotMilk2020 folded on the River
Seat 2: LocalFixer (button) folded before Flop (didn't bet)
Seat 3: Diana4teen (small blind) collected ($0.29)
Seat 5: RN152 (big blind) folded on the River



PokerStars Hand #222964034450:  Hold'em No Limit ($0.05/$0.10 USD) - 2021/01/23 13:35:33 ET
Table 'Lutetia III' 6-max Seat #3 is the button
Seat 1: HotMilk2020 ($12.53 in chips) 
Seat 2: LocalFixer ($19.08 in chips) 
Seat 3: Diana4teen ($21.17 in chips) 
Seat 5: RN152 ($10 in chips) 
Seat 6: mikhail_dubkov ($10 in chips) 
RN152: posts small blind $0.05
mikhail_dubkov: posts big blind $0.10
*** HOLE CARDS ***
HotMilk2020: folds 
LocalFixer: folds 
Diana4teen: folds 
RN152: folds 
Uncalled bet ($0.05) returned to mikhail_dubkov
mikhail_dubkov collected $0.10 from pot
mikhail_dubkov: doesn't show hand 
*** SUMMARY ***
Total pot $0.10 | Rake $0 
Seat 1: HotMilk2020 folded before Flop (didn't bet)
Seat 2: LocalFixer folded before Flop (didn't bet)
Seat 3: Diana4teen (button) folded before Flop (didn't bet)
Seat 5: RN152 (small blind) folded before Flop
Seat 6: mikhail_dubkov (big blind) collected ($0.10)



PokerStars Hand #222964045228:  Hold'em No Limit ($0.05/$0.10 USD) - 2021/01/23 13:35:47 ET
Table 'Lutetia III' 6-max Seat #5 is the button
Seat 1: HotMilk2020 ($12.53 in chips) 
Seat 2: LocalFixer ($19.08 in chips) 
Seat 3: Diana4teen ($21.17 in chips) 
Seat 4: Acedan1369 ($10 in chips) 
Seat 5: RN152 ($10 in chips) 
Seat 6: mikhail_dubkov ($10.05 in chips) 
mikhail_dubkov: posts small blind $0.05
HotMilk2020: posts big blind $0.10
Acedan1369: posts small & big blinds $0.15
*** HOLE CARDS ***
LocalFixer: folds 
Diana4teen: folds 
Acedan1369: checks 
RN152: folds 
mikhail_dubkov: folds 
HotMilk2020: checks 
*** FLOP *** [9s 9d Ad]
HotMilk2020: checks 
Acedan1369: checks 
*** TURN *** [9s 9d Ad] [Jd]
HotMilk2020: checks 
Acedan1369: checks 
*** RIVER *** [9s 9d Ad Jd] [Kh]
HotMilk2020: bets $0.10
Acedan1369: folds 
Uncalled bet ($0.10) returned to HotMilk2020
HotMilk2020 collected $0.29 from pot
HotMilk2020: doesn't show hand 
*** SUMMARY ***
Total pot $0.30 | Rake $0.01 
Board [9s 9d Ad Jd Kh]
Seat 1: HotMilk2020 (big blind) collected ($0.29)
Seat 2: LocalFixer folded before Flop (didn't bet)
Seat 3: Diana4teen folded before Flop (didn't bet)
Seat 4: Acedan1369 folded on the River (didn't bet)
Seat 5: RN152 (button) folded before Flop (didn't bet)
Seat 6: mikhail_dubkov (small blind) folded before Flop



PokerStars Hand #222964092404:  Hold'em No Limit ($0.05/$0.10 USD) - 2021/01/23 13:36:48 ET
Table 'Lutetia III' 6-max Seat #6 is the button
Seat 1: HotMilk2020 ($12.72 in chips) 
Seat 2: LocalFixer ($19.08 in chips) 
Seat 3: Diana4teen ($21.17 in chips) 
Seat 4: Acedan1369 ($10 in chips) 
Seat 5: RN152 ($10 in chips) 
Seat 6: mikhail_dubkov ($10 in chips) 
HotMilk2020: posts small blind $0.05
LocalFixer: posts big blind $0.10
*** HOLE CARDS ***
Diana4teen: folds 
Acedan1369: folds 
RN152: raises $0.15 to $0.25
mikhail_dubkov: folds 
HotMilk2020: folds 
LocalFixer: folds 
Uncalled bet ($0.15) returned to RN152
RN152 collected $0.25 from pot
RN152: doesn't show hand 
*** SUMMARY ***
Total pot $0.25 | Rake $0 
Seat 1: HotMilk2020 (small blind) folded before Flop
Seat 2: LocalFixer (big blind) folded before Flop
Seat 3: Diana4teen folded before Flop (didn't bet)
Seat 4: Acedan1369 folded before Flop (didn't bet)
Seat 5: RN152 collected ($0.25)
Seat 6: mikhail_dubkov (button) folded before Flop (didn't bet)



PokerStars Hand #222964118868:  Hold'em No Limit ($0.05/$0.10 USD) - 2021/01/23 13:37:22 ET
Table 'Lutetia III' 6-max Seat #1 is the button
Seat 1: HotMilk2020 ($12.67 in chips) 
Seat 2: LocalFixer ($18.98 in chips) 
Seat 3: Diana4teen ($21.17 in chips) 
Seat 4: Acedan1369 ($10 in chips) 
Seat 5: RN152 ($10.15 in chips) 
Seat 6: mikhail_dubkov ($10 in chips) 
LocalFixer: posts small blind $0.05
Diana4teen: posts big blind $0.10
*** HOLE CARDS ***
Acedan1369: folds 
RN152: folds 
mikhail_dubkov: folds 
HotMilk2020: calls $0.10
LocalFixer: raises $0.30 to $0.40
Diana4teen: folds 
HotMilk2020: calls $0.30
*** FLOP *** [6c 9s Ah]
LocalFixer: bets $0.47
HotMilk2020: folds 
Uncalled bet ($0.47) returned to LocalFixer
LocalFixer collected $0.86 from pot
LocalFixer: doesn't show hand 
*** SUMMARY ***
Total pot $0.90 | Rake $0.04 
Board [6c 9s Ah]
Seat 1: HotMilk2020 (button) folded on the Flop
Seat 2: LocalFixer (small blind) collected ($0.86)
Seat 3: Diana4teen (big blind) folded before Flop
Seat 4: Acedan1369 folded before Flop (didn't bet)
Seat 5: RN152 folded before Flop (didn't bet)
Seat 6: mikhail_dubkov folded before Flop (didn't bet)



PokerStars Hand #222964147748:  Hold'em No Limit ($0.05/$0.10 USD) - 2021/01/23 13:37:59 ET
Table 'Lutetia III' 6-max Seat #2 is the button
Seat 1: HotMilk2020 ($12.27 in chips) 
Seat 2: LocalFixer ($19.44 in chips) 
Seat 3: Diana4teen ($21.07 in chips) 
Seat 4: Acedan1369 ($10 in chips) 
Seat 5: RN152 ($10.15 in chips) 
Seat 6: mikhail_dubkov ($10 in chips) 
Diana4teen: posts small blind $0.05
Acedan1369: posts big blind $0.10
*** HOLE CARDS ***
RN152: folds 
RN152 leaves the table
mikhail_dubkov: raises $0.10 to $0.20
DrLevty joins the table at seat #5 
HotMilk2020: calls $0.20
LocalFixer: calls $0.20
Diana4teen: calls $0.15
Acedan1369: folds 
*** FLOP *** [2s 6h 2h]
Diana4teen: checks 
mikhail_dubkov: bets $0.43
HotMilk2020: calls $0.43
LocalFixer: folds 
Diana4teen: folds 
*** TURN *** [2s 6h 2h] [Kd]
mikhail_dubkov: bets $0.74
HotMilk2020: calls $0.74
*** RIVER *** [2s 6h 2h Kd] [Th]
mikhail_dubkov: checks 
HotMilk2020: bets $1.55
mikhail_dubkov: calls $1.55
*** SHOW DOWN ***
HotMilk2020: shows [4h 5h] (a flush, Ten high)
mikhail_dubkov: mucks hand 
HotMilk2020 collected $6.05 from pot
*** SUMMARY ***
Total pot $6.34 | Rake $0.29 
Board [2s 6h 2h Kd Th]
Seat 1: HotMilk2020 showed [4h 5h] and won ($6.05) with a flush, Ten high
Seat 2: LocalFixer (button) folded on the Flop
Seat 3: Diana4teen (small blind) folded on the Flop
Seat 4: Acedan1369 (big blind) folded before Flop
Seat 5: RN152 folded before Flop (didn't bet)
Seat 6: mikhail_dubkov mucked



PokerStars Hand #222964191942:  Hold'em No Limit ($0.05/$0.10 USD) - 2021/01/23 13:38:56 ET
Table 'Lutetia III' 6-max Seat #3 is the button
Seat 1: HotMilk2020 ($15.40 in chips) 
Seat 2: LocalFixer ($19.24 in chips) 
Seat 3: Diana4teen ($20.87 in chips) 
Seat 4: Acedan1369 ($10 in chips) 
Seat 5: DrLevty ($10 in chips) 
Seat 6: mikhail_dubkov ($7.08 in chips) 
Acedan1369: posts small blind $0.05
DrLevty: posts big blind $0.10
*** HOLE CARDS ***
mikhail_dubkov: folds 
HotMilk2020: folds 
LocalFixer: raises $0.20 to $0.30
Diana4teen: calls $0.30
Acedan1369: folds 
DrLevty: folds 
*** FLOP *** [Kc Kh 2s]
LocalFixer: checks 
Diana4teen: bets $0.50
LocalFixer: calls $0.50
*** TURN *** [Kc Kh 2s] [Td]
LocalFixer: checks 
Diana4teen: bets $1
LocalFixer: calls $1
*** RIVER *** [Kc Kh 2s Td] [2h]
LocalFixer: checks 
Diana4teen: checks 
*** SHOW DOWN ***
LocalFixer: shows [Qc Qd] (two pair, Kings and Queens)
Diana4teen: mucks hand 
LocalFixer collected $3.58 from pot
*** SUMMARY ***
Total pot $3.75 | Rake $0.17 
Board [Kc Kh 2s Td 2h]
Seat 1: HotMilk2020 folded before Flop (didn't bet)
Seat 2: LocalFixer showed [Qc Qd] and won ($3.58) with two pair, Kings and Queens
Seat 3: Diana4teen (button) mucked
Seat 4: Acedan1369 (small blind) folded before Flop
Seat 5: DrLevty (big blind) folded before Flop
Seat 6: mikhail_dubkov folded before Flop (didn't bet)



PokerStars Hand #222964241580:  Hold'em No Limit ($0.05/$0.10 USD) - 2021/01/23 13:40:00 ET
Table 'Lutetia III' 6-max Seat #4 is the button
Seat 1: HotMilk2020 ($15.40 in chips) 
Seat 2: LocalFixer ($21.02 in chips) 
Seat 3: Diana4teen ($19.07 in chips) 
Seat 4: Acedan1369 ($10 in chips) 
Seat 5: DrLevty ($10 in chips) 
Seat 6: mikhail_dubkov ($7.08 in chips) 
DrLevty: posts small blind $0.05
mikhail_dubkov: posts big blind $0.10
*** HOLE CARDS ***
HotMilk2020 has timed out
HotMilk2020: folds 
LocalFixer: folds 
Diana4teen: calls $0.10
Acedan1369: raises $0.30 to $0.40
DrLevty: folds 
mikhail_dubkov: calls $0.30
Diana4teen: calls $0.30
*** FLOP *** [Tc Qh 6d]
mikhail_dubkov: checks 
Diana4teen: bets $0.60
Acedan1369: calls $0.60
mikhail_dubkov: calls $0.60
*** TURN *** [Tc Qh 6d] [4d]
mikhail_dubkov: checks 
Diana4teen: bets $2
Acedan1369: folds 
mikhail_dubkov: folds 
Uncalled bet ($2) returned to Diana4teen
Diana4teen collected $2.91 from pot
Diana4teen: doesn't show hand 
*** SUMMARY ***
Total pot $3.05 | Rake $0.14 
Board [Tc Qh 6d 4d]
Seat 1: HotMilk2020 folded before Flop (didn't bet)
Seat 2: LocalFixer folded before Flop (didn't bet)
Seat 3: Diana4teen collected ($2.91)
Seat 4: Acedan1369 (button) folded on the Turn
Seat 5: DrLevty (small blind) folded before Flop
Seat 6: mikhail_dubkov (big blind) folded on the Turn



PokerStars Hand #222964283494:  Hold'em No Limit ($0.05/$0.10 USD) - 2021/01/23 13:40:54 ET
Table 'Lutetia III' 6-max Seat #5 is the button
Seat 1: HotMilk2020 ($15.40 in chips) 
Seat 2: LocalFixer ($21.02 in chips) 
Seat 3: Diana4teen ($20.98 in chips) 
Seat 4: Acedan1369 ($10 in chips) 
Seat 5: DrLevty ($10 in chips) 
Seat 6: mikhail_dubkov ($6.08 in chips) 
mikhail_dubkov: posts small blind $0.05
HotMilk2020: posts big blind $0.10
*** HOLE CARDS ***
LocalFixer: folds 
Diana4teen: folds 
Acedan1369: folds 
DrLevty: folds 
mikhail_dubkov: folds 
Uncalled bet ($0.05) returned to HotMilk2020
HotMilk2020 collected $0.10 from pot
HotMilk2020: doesn't show hand 
*** SUMMARY ***
Total pot $0.10 | Rake $0 
Seat 1: HotMilk2020 (big blind) collected ($0.10)
Seat 2: LocalFixer folded before Flop (didn't bet)
Seat 3: Diana4teen folded before Flop (didn't bet)
Seat 4: Acedan1369 folded before Flop (didn't bet)
Seat 5: DrLevty (button) folded before Flop (didn't bet)
Seat 6: mikhail_dubkov (small blind) folded before Flop



PokerStars Hand #222964293030:  Hold'em No Limit ($0.05/$0.10 USD) - 2021/01/23 13:41:07 ET
Table 'Lutetia III' 6-max Seat #6 is the button
Seat 1: HotMilk2020 ($15.45 in chips) 
Seat 2: LocalFixer ($21.02 in chips) 
Seat 3: Diana4teen ($20.98 in chips) 
Seat 4: Acedan1369 ($10 in chips) 
Seat 5: DrLevty ($10 in chips) 
Seat 6: mikhail_dubkov ($6.03 in chips) 
HotMilk2020: posts small blind $0.05
LocalFixer: posts big blind $0.10
*** HOLE CARDS ***
Diana4teen: folds 
Acedan1369: folds 
DrLevty: raises $0.20 to $0.30
mikhail_dubkov: folds 
HotMilk2020: calls $0.25
LocalFixer: folds 
*** FLOP *** [Jc Kd Tc]
HotMilk2020: checks 
DrLevty: bets $0.37
HotMilk2020: raises $0.37 to $0.74
DrLevty: raises $1.91 to $2.65
HotMilk2020: calls $1.91
*** TURN *** [Jc Kd Tc] [4c]
HotMilk2020: checks 
DrLevty: checks 
*** RIVER *** [Jc Kd Tc 4c] [3d]
HotMilk2020: checks 
DrLevty: bets $1.89
HotMilk2020: calls $1.89
*** SHOW DOWN ***
DrLevty: shows [9d Qd] (a straight, Nine to King)
HotMilk2020: mucks hand 
DrLevty collected $9.34 from pot
*** SUMMARY ***
Total pot $9.78 | Rake $0.44 
Board [Jc Kd Tc 4c 3d]
Seat 1: HotMilk2020 (small blind) mucked
Seat 2: LocalFixer (big blind) folded before Flop
Seat 3: Diana4teen folded before Flop (didn't bet)
Seat 4: Acedan1369 folded before Flop (didn't bet)
Seat 5: DrLevty showed [9d Qd] and won ($9.34) with a straight, Nine to King
Seat 6: mikhail_dubkov (button) folded before Flop (didn't bet)



PokerStars Hand #222964339180:  Hold'em No Limit ($0.05/$0.10 USD) - 2021/01/23 13:42:06 ET
Table 'Lutetia III' 6-max Seat #1 is the button
Seat 1: HotMilk2020 ($10.61 in chips) 
Seat 2: LocalFixer ($20.92 in chips) 
Seat 3: Diana4teen ($20.98 in chips) 
Seat 4: Acedan1369 ($10 in chips) 
Seat 5: DrLevty ($14.50 in chips) 
Seat 6: mikhail_dubkov ($6.03 in chips) 
LocalFixer: posts small blind $0.05
Diana4teen: posts big blind $0.10
*** HOLE CARDS ***
Acedan1369: folds 
DrLevty: folds 
mikhail_dubkov: folds 
HotMilk2020: calls $0.10
LocalFixer: folds 
Diana4teen: checks 
*** FLOP *** [Qc 4h Ah]
Diana4teen: bets $0.10
HotMilk2020: folds 
Uncalled bet ($0.10) returned to Diana4teen
Diana4teen collected $0.24 from pot
Diana4teen: doesn't show hand 
*** SUMMARY ***
Total pot $0.25 | Rake $0.01 
Board [Qc 4h Ah]
Seat 1: HotMilk2020 (button) folded on the Flop
Seat 2: LocalFixer (small blind) folded before Flop
Seat 3: Diana4teen (big blind) collected ($0.24)
Seat 4: Acedan1369 folded before Flop (didn't bet)
Seat 5: DrLevty folded before Flop (didn't bet)
Seat 6: mikhail_dubkov folded before Flop (didn't bet)



PokerStars Hand #222964371758:  Hold'em No Limit ($0.05/$0.10 USD) - 2021/01/23 13:42:48 ET
Table 'Lutetia III' 6-max Seat #2 is the button
Seat 1: HotMilk2020 ($10.51 in chips) 
Seat 2: LocalFixer ($20.87 in chips) 
Seat 3: Diana4teen ($21.12 in chips) 
Seat 4: Acedan1369 ($10 in chips) 
Seat 5: DrLevty ($14.50 in chips) 
Seat 6: mikhail_dubkov ($6.03 in chips) 
Diana4teen: posts small blind $0.05
Acedan1369: posts big blind $0.10
*** HOLE CARDS ***
DrLevty: folds 
mikhail_dubkov: folds 
HotMilk2020: folds 
LocalFixer: folds 
Diana4teen: calls $0.05
Acedan1369: checks 
*** FLOP *** [5c 9d 9s]
Diana4teen: bets $0.10
Acedan1369: folds 
Uncalled bet ($0.10) returned to Diana4teen
Diana4teen collected $0.19 from pot
Diana4teen: doesn't show hand 
*** SUMMARY ***
Total pot $0.20 | Rake $0.01 
Board [5c 9d 9s]
Seat 1: HotMilk2020 folded before Flop (didn't bet)
Seat 2: LocalFixer (button) folded before Flop (didn't bet)
Seat 3: Diana4teen (small blind) collected ($0.19)
Seat 4: Acedan1369 (big blind) folded on the Flop
Seat 5: DrLevty folded before Flop (didn't bet)
Seat 6: mikhail_dubkov folded before Flop (didn't bet)



PokerStars Hand #222964391425:  Hold'em No Limit ($0.05/$0.10 USD) - 2021/01/23 13:43:14 ET
Table 'Lutetia III' 6-max Seat #3 is the button
Seat 1: HotMilk2020 ($10.51 in chips) 
Seat 2: LocalFixer ($20.87 in chips) 
Seat 3: Diana4teen ($21.21 in chips) 
Seat 4: Acedan1369 ($10 in chips) 
Seat 5: DrLevty ($14.50 in chips) 
Seat 6: mikhail_dubkov ($6.03 in chips) 
Acedan1369: posts small blind $0.05
DrLevty: posts big blind $0.10
*** HOLE CARDS ***
mikhail_dubkov: folds 
HotMilk2020: calls $0.10
LocalFixer: raises $0.30 to $0.40
Diana4teen: folds 
Acedan1369: folds 
DrLevty: folds 
HotMilk2020: calls $0.30
*** FLOP *** [4s 9d Jc]
HotMilk2020: checks 
LocalFixer: bets $0.50
HotMilk2020: folds 
Uncalled bet ($0.50) returned to LocalFixer
LocalFixer collected $0.91 from pot
LocalFixer: doesn't show hand 
*** SUMMARY ***
Total pot $0.95 | Rake $0.04 
Board [4s 9d Jc]
Seat 1: HotMilk2020 folded on the Flop
Seat 2: LocalFixer collected ($0.91)
Seat 3: Diana4teen (button) folded before Flop (didn't bet)
Seat 4: Acedan1369 (small blind) folded before Flop
Seat 5: DrLevty (big blind) folded before Flop
Seat 6: mikhail_dubkov folded before Flop (didn't bet)



PokerStars Hand #222964408795:  Hold'em No Limit ($0.05/$0.10 USD) - 2021/01/23 13:43:36 ET
Table 'Lutetia III' 6-max Seat #4 is the button
Seat 1: HotMilk2020 ($10.11 in chips) 
Seat 2: LocalFixer ($21.38 in chips) 
Seat 3: Diana4teen ($21.21 in chips) 
Seat 4: Acedan1369 ($10 in chips) 
Seat 5: DrLevty ($14.40 in chips) 
Seat 6: mikhail_dubkov ($6.03 in chips) 
DrLevty: posts small blind $0.05
mikhail_dubkov: posts big blind $0.10
*** HOLE CARDS ***
HotMilk2020: calls $0.10
LocalFixer: folds 
Diana4teen: folds 
Acedan1369 has timed out
Acedan1369: folds 
DrLevty: raises $0.40 to $0.50
mikhail_dubkov: folds 
HotMilk2020: calls $0.40
*** FLOP *** [7s 7c Qd]
DrLevty: checks 
HotMilk2020: bets $0.53
DrLevty: calls $0.53
*** TURN *** [7s 7c Qd] [8h]
DrLevty: checks 
HotMilk2020: checks 
*** RIVER *** [7s 7c Qd 8h] [As]
DrLevty: bets $0.68
HotMilk2020: calls $0.68
*** SHOW DOWN ***
DrLevty: shows [Jh Js] (two pair, Jacks and Sevens)
HotMilk2020: shows [Qs Jc] (two pair, Queens and Sevens)
HotMilk2020 collected $3.36 from pot
*** SUMMARY ***
Total pot $3.52 | Rake $0.16 
Board [7s 7c Qd 8h As]
Seat 1: HotMilk2020 showed [Qs Jc] and won ($3.36) with two pair, Queens and Sevens
Seat 2: LocalFixer folded before Flop (didn't bet)
Seat 3: Diana4teen folded before Flop (didn't bet)
Seat 4: Acedan1369 (button) folded before Flop (didn't bet)
Seat 5: DrLevty (small blind) showed [Jh Js] and lost with two pair, Jacks and Sevens
Seat 6: mikhail_dubkov (big blind) folded before Flop



PokerStars Hand #222964460060:  Hold'em No Limit ($0.05/$0.10 USD) - 2021/01/23 13:44:35 ET
Table 'Lutetia III' 6-max Seat #5 is the button
Seat 1: HotMilk2020 ($11.76 in chips) 
Seat 2: LocalFixer ($21.38 in chips) 
Seat 3: Diana4teen ($21.21 in chips) 
Seat 4: Acedan1369 ($10 in chips) 
Seat 5: DrLevty ($12.69 in chips) 
Seat 6: mikhail_dubkov ($5.93 in chips) 
mikhail_dubkov: posts small blind $0.05
HotMilk2020: posts big blind $0.10
*** HOLE CARDS ***
LocalFixer: folds 
Diana4teen: raises $0.10 to $0.20
Acedan1369: folds 
DrLevty: folds 
mikhail_dubkov: folds 
HotMilk2020: calls $0.10
*** FLOP *** [Td 4c 4h]
HotMilk2020: checks 
Diana4teen: bets $0.30
HotMilk2020: folds 
Uncalled bet ($0.30) returned to Diana4teen
Diana4teen collected $0.43 from pot
Diana4teen: doesn't show hand 
*** SUMMARY ***
Total pot $0.45 | Rake $0.02 
Board [Td 4c 4h]
Seat 1: HotMilk2020 (big blind) folded on the Flop
Seat 2: LocalFixer folded before Flop (didn't bet)
Seat 3: Diana4teen collected ($0.43)
Seat 4: Acedan1369 folded before Flop (didn't bet)
Seat 5: DrLevty (button) folded before Flop (didn't bet)
Seat 6: mikhail_dubkov (small blind) folded before Flop



PokerStars Hand #222964484537:  Hold'em No Limit ($0.05/$0.10 USD) - 2021/01/23 13:45:07 ET
Table 'Lutetia III' 6-max Seat #6 is the button
Seat 1: HotMilk2020 ($11.56 in chips) 
Seat 2: LocalFixer ($21.38 in chips) 
Seat 3: Diana4teen ($21.44 in chips) 
Seat 4: Acedan1369 ($10 in chips) 
Seat 5: DrLevty ($12.69 in chips) 
Seat 6: mikhail_dubkov ($5.88 in chips) 
HotMilk2020: posts small blind $0.05
LocalFixer: posts big blind $0.10
*** HOLE CARDS ***
Diana4teen: calls $0.10
Acedan1369: folds 
DrLevty: folds 
mikhail_dubkov: raises $0.20 to $0.30
HotMilk2020: folds 
LocalFixer: folds 
Diana4teen: calls $0.20
*** FLOP *** [Ad 6d 4h]
Diana4teen: checks 
mikhail_dubkov: bets $0.36
Diana4teen: folds 
Uncalled bet ($0.36) returned to mikhail_dubkov
mikhail_dubkov collected $0.72 from pot
mikhail_dubkov: doesn't show hand 
*** SUMMARY ***
Total pot $0.75 | Rake $0.03 
Board [Ad 6d 4h]
Seat 1: HotMilk2020 (small blind) folded before Flop
Seat 2: LocalFixer (big blind) folded before Flop
Seat 3: Diana4teen folded on the Flop
Seat 4: Acedan1369 folded before Flop (didn't bet)
Seat 5: DrLevty folded before Flop (didn't bet)
Seat 6: mikhail_dubkov (button) collected ($0.72)



PokerStars Hand #222964515814:  Hold'em No Limit ($0.05/$0.10 USD) - 2021/01/23 13:45:47 ET
Table 'Lutetia III' 6-max Seat #1 is the button
Seat 1: HotMilk2020 ($11.51 in chips) 
Seat 2: LocalFixer ($21.28 in chips) 
Seat 3: Diana4teen ($21.14 in chips) 
Seat 4: Acedan1369 ($10 in chips) 
Seat 5: DrLevty ($12.69 in chips) 
Seat 6: mikhail_dubkov ($6.30 in chips) 
LocalFixer: posts small blind $0.05
Diana4teen: posts big blind $0.10
*** HOLE CARDS ***
Acedan1369: folds 
DrLevty: folds 
mikhail_dubkov: folds 
HotMilk2020: folds 
LocalFixer: raises $0.15 to $0.25
Diana4teen: calls $0.15
*** FLOP *** [Kh Qd Js]
LocalFixer: checks 
Diana4teen: checks 
*** TURN *** [Kh Qd Js] [9c]
LocalFixer: checks 
Diana4teen: checks 
*** RIVER *** [Kh Qd Js 9c] [8s]
LocalFixer: checks 
Diana4teen: bets $0.24
LocalFixer: folds 
Uncalled bet ($0.24) returned to Diana4teen
Diana4teen collected $0.48 from pot
Diana4teen: doesn't show hand 
*** SUMMARY ***
Total pot $0.50 | Rake $0.02 
Board [Kh Qd Js 9c 8s]
Seat 1: HotMilk2020 (button) folded before Flop (didn't bet)
Seat 2: LocalFixer (small blind) folded on the River
Seat 3: Diana4teen (big blind) collected ($0.48)
Seat 4: Acedan1369 folded before Flop (didn't bet)
Seat 5: DrLevty folded before Flop (didn't bet)
Seat 6: mikhail_dubkov folded before Flop (didn't bet)



PokerStars Hand #222964557443:  Hold'em No Limit ($0.05/$0.10 USD) - 2021/01/23 13:46:42 ET
Table 'Lutetia III' 6-max Seat #2 is the button
Seat 1: HotMilk2020 ($11.51 in chips) 
Seat 2: LocalFixer ($21.03 in chips) 
Seat 3: Diana4teen ($21.37 in chips) 
Seat 4: Acedan1369 ($10 in chips) 
Seat 5: DrLevty ($12.69 in chips) 
Seat 6: mikhail_dubkov ($6.30 in chips) 
Diana4teen: posts small blind $0.05
Acedan1369: posts big blind $0.10
*** HOLE CARDS ***
DrLevty: raises $0.20 to $0.30
mikhail_dubkov: calls $0.30
HotMilk2020: folds 
LocalFixer: calls $0.30
Diana4teen: folds 
Acedan1369: calls $0.20
*** FLOP *** [Tc 5h 3c]
Acedan1369: checks 
DrLevty: bets $0.65
mikhail_dubkov: folds 
LocalFixer: folds 
Acedan1369: calls $0.65
*** TURN *** [Tc 5h 3c] [2d]
Acedan1369: checks 
DrLevty: bets $2.17
Acedan1369: calls $2.17
*** RIVER *** [Tc 5h 3c 2d] [Ac]
Acedan1369: checks 
DrLevty: checks 
*** SHOW DOWN ***
Acedan1369: shows [Js Td] (a pair of Tens)
DrLevty: shows [Jc Jh] (a pair of Jacks)
DrLevty collected $6.58 from pot
*** SUMMARY ***
Total pot $6.89 | Rake $0.31 
Board [Tc 5h 3c 2d Ac]
Seat 1: HotMilk2020 folded before Flop (didn't bet)
Seat 2: LocalFixer (button) folded on the Flop
Seat 3: Diana4teen (small blind) folded before Flop
Seat 4: Acedan1369 (big blind) showed [Js Td] and lost with a pair of Tens
Seat 5: DrLevty showed [Jc Jh] and won ($6.58) with a pair of Jacks
Seat 6: mikhail_dubkov folded on the Flop



PokerStars Hand #222964600359:  Hold'em No Limit ($0.05/$0.10 USD) - 2021/01/23 13:47:38 ET
Table 'Lutetia III' 6-max Seat #3 is the button
Seat 1: HotMilk2020 ($11.51 in chips) 
Seat 2: LocalFixer ($20.73 in chips) 
Seat 3: Diana4teen ($21.32 in chips) 
Seat 4: Acedan1369 ($10 in chips) 
Seat 5: DrLevty ($16.15 in chips) 
Seat 6: mikhail_dubkov ($6 in chips) 
Acedan1369: posts small blind $0.05
DrLevty: posts big blind $0.10
*** HOLE CARDS ***
mikhail_dubkov: raises $0.10 to $0.20
HotMilk2020: folds 
LocalFixer: folds 
Diana4teen: calls $0.20
Acedan1369: folds 
DrLevty: folds 
*** FLOP *** [8s 2h 8c]
mikhail_dubkov: checks 
Diana4teen: checks 
*** TURN *** [8s 2h 8c] [8d]
mikhail_dubkov: checks 
Diana4teen: checks 
*** RIVER *** [8s 2h 8c 8d] [9h]
mikhail_dubkov: checks 
Diana4teen: checks 
*** SHOW DOWN ***
mikhail_dubkov: shows [Ts Qh] (three of a kind, Eights)
Diana4teen: mucks hand 
mikhail_dubkov collected $0.53 from pot
*** SUMMARY ***
Total pot $0.55 | Rake $0.02 
Board [8s 2h 8c 8d 9h]
Seat 1: HotMilk2020 folded before Flop (didn't bet)
Seat 2: LocalFixer folded before Flop (didn't bet)
Seat 3: Diana4teen (button) mucked
Seat 4: Acedan1369 (small blind) folded before Flop
Seat 5: DrLevty (big blind) folded before Flop
Seat 6: mikhail_dubkov showed [Ts Qh] and won ($0.53) with three of a kind, Eights



PokerStars Hand #222964641218:  Hold'em No Limit ($0.05/$0.10 USD) - 2021/01/23 13:48:32 ET
Table 'Lutetia III' 6-max Seat #4 is the button
Seat 1: HotMilk2020 ($11.51 in chips) 
Seat 2: LocalFixer ($20.73 in chips) 
Seat 3: Diana4teen ($21.12 in chips) 
Seat 4: Acedan1369 ($10 in chips) 
Seat 5: DrLevty ($16.05 in chips) 
Seat 6: mikhail_dubkov ($6.33 in chips) 
DrLevty: posts small blind $0.05
mikhail_dubkov: posts big blind $0.10
*** HOLE CARDS ***
HotMilk2020: calls $0.10
LocalFixer: raises $0.30 to $0.40
Diana4teen: calls $0.40
Acedan1369: folds 
DrLevty: folds 
mikhail_dubkov: folds 
HotMilk2020: calls $0.30
*** FLOP *** [6h 7c 3s]
HotMilk2020: checks 
LocalFixer: checks 
Diana4teen: bets $0.70
HotMilk2020: folds 
LocalFixer: folds 
Uncalled bet ($0.70) returned to Diana4teen
Diana4teen collected $1.29 from pot
*** SUMMARY ***
Total pot $1.35 | Rake $0.06 
Board [6h 7c 3s]
Seat 1: HotMilk2020 folded on the Flop
Seat 2: LocalFixer folded on the Flop
Seat 3: Diana4teen collected ($1.29)
Seat 4: Acedan1369 (button) folded before Flop (didn't bet)
Seat 5: DrLevty (small blind) folded before Flop
Seat 6: mikhail_dubkov (big blind) folded before Flop



PokerStars Hand #222964674977:  Hold'em No Limit ($0.05/$0.10 USD) - 2021/01/23 13:49:16 ET
Table 'Lutetia III' 6-max Seat #5 is the button
Seat 1: HotMilk2020 ($11.11 in chips) 
Seat 2: LocalFixer ($20.33 in chips) 
Seat 3: Diana4teen ($22.01 in chips) 
Seat 4: Acedan1369 ($10 in chips) 
Seat 5: DrLevty ($16 in chips) 
Seat 6: mikhail_dubkov ($6.23 in chips) 
mikhail_dubkov: posts small blind $0.05
HotMilk2020: posts big blind $0.10
*** HOLE CARDS ***
LocalFixer: folds 
Diana4teen: folds 
Acedan1369: folds 
DrLevty: folds 
mikhail_dubkov: folds 
Uncalled bet ($0.05) returned to HotMilk2020
HotMilk2020 collected $0.10 from pot
HotMilk2020: doesn't show hand 
*** SUMMARY ***
Total pot $0.10 | Rake $0 
Seat 1: HotMilk2020 (big blind) collected ($0.10)
Seat 2: LocalFixer folded before Flop (didn't bet)
Seat 3: Diana4teen folded before Flop (didn't bet)
Seat 4: Acedan1369 folded before Flop (didn't bet)
Seat 5: DrLevty (button) folded before Flop (didn't bet)
Seat 6: mikhail_dubkov (small blind) folded before Flop



PokerStars Hand #222964689519:  Hold'em No Limit ($0.05/$0.10 USD) - 2021/01/23 13:49:35 ET
Table 'Lutetia III' 6-max Seat #6 is the button
Seat 1: HotMilk2020 ($11.16 in chips) 
Seat 3: Diana4teen ($22.01 in chips) 
Seat 4: Acedan1369 ($10 in chips) 
Seat 5: DrLevty ($16 in chips) 
Seat 6: mikhail_dubkov ($6.18 in chips) 
HotMilk2020: posts small blind $0.05
LocalFixer: is sitting out 
Diana4teen: posts big blind $0.10
*** HOLE CARDS ***
Acedan1369: folds 
DrLevty: raises $0.20 to $0.30
mikhail_dubkov: folds 
HotMilk2020: folds 
Diana4teen: calls $0.20
*** FLOP *** [Jc 9h Kh]
Diana4teen: checks 
DrLevty: checks 
*** TURN *** [Jc 9h Kh] [4h]
Diana4teen: checks 
DrLevty: checks 
*** RIVER *** [Jc 9h Kh 4h] [9d]
LocalFixer leaves the table
HerrBerg90 joins the table at seat #2 
Diana4teen: bets $0.50
DrLevty: calls $0.50
*** SHOW DOWN ***
Diana4teen: shows [Qd 9c] (three of a kind, Nines)
DrLevty: mucks hand 
Diana4teen collected $1.58 from pot
*** SUMMARY ***
Total pot $1.65 | Rake $0.07 
Board [Jc 9h Kh 4h 9d]
Seat 1: HotMilk2020 (small blind) folded before Flop
Seat 3: Diana4teen (big blind) showed [Qd 9c] and won ($1.58) with three of a kind, Nines
Seat 4: Acedan1369 folded before Flop (didn't bet)
Seat 5: DrLevty mucked
Seat 6: mikhail_dubkov (button) folded before Flop (didn't bet)



PokerStars Hand #222964732385:  Hold'em No Limit ($0.05/$0.10 USD) - 2021/01/23 13:50:32 ET
Table 'Lutetia III' 6-max Seat #1 is the button
Seat 1: HotMilk2020 ($11.11 in chips) 
Seat 3: Diana4teen ($22.79 in chips) 
Seat 4: Acedan1369 ($10 in chips) 
Seat 5: DrLevty ($15.20 in chips) 
Seat 6: mikhail_dubkov ($6.18 in chips) 
Diana4teen: posts small blind $0.05
Acedan1369: posts big blind $0.10
*** HOLE CARDS ***
DrLevty: folds 
mikhail_dubkov: folds 
HotMilk2020: calls $0.10
Diana4teen: folds 
Acedan1369: checks 
*** FLOP *** [2d Ac 6c]
Acedan1369: checks 
HotMilk2020: checks 
*** TURN *** [2d Ac 6c] [Kc]
Acedan1369: checks 
HotMilk2020: checks 
*** RIVER *** [2d Ac 6c Kc] [Kd]
Acedan1369: checks 
HotMilk2020: bets $0.10
Acedan1369: folds 
Uncalled bet ($0.10) returned to HotMilk2020
HotMilk2020 collected $0.24 from pot
HotMilk2020: doesn't show hand 
*** SUMMARY ***
Total pot $0.25 | Rake $0.01 
Board [2d Ac 6c Kc Kd]
Seat 1: HotMilk2020 (button) collected ($0.24)
Seat 3: Diana4teen (small blind) folded before Flop
Seat 4: Acedan1369 (big blind) folded on the River
Seat 5: DrLevty folded before Flop (didn't bet)
Seat 6: mikhail_dubkov folded before Flop (didn't bet)



PokerStars Hand #222964765518:  Hold'em No Limit ($0.05/$0.10 USD) - 2021/01/23 13:51:15 ET
Table 'Lutetia III' 6-max Seat #3 is the button
Seat 1: HotMilk2020 ($11.25 in chips) 
Seat 3: Diana4teen ($22.74 in chips) 
Seat 4: Acedan1369 ($10 in chips) 
Seat 5: DrLevty ($15.20 in chips) 
Seat 6: mikhail_dubkov ($6.18 in chips) 
Acedan1369: posts small blind $0.05
DrLevty: posts big blind $0.10
HerrBerg90: sits out 
*** HOLE CARDS ***
mikhail_dubkov: raises $0.10 to $0.20
HotMilk2020: folds 
Diana4teen: calls $0.20
Acedan1369: calls $0.15
DrLevty: calls $0.10
*** FLOP *** [Jc 4c 5s]
Acedan1369: checks 
DrLevty: checks 
mikhail_dubkov: bets $0.76
Diana4teen: folds 
Acedan1369: calls $0.76
DrLevty: folds 
*** TURN *** [Jc 4c 5s] [4h]
Acedan1369: checks 
mikhail_dubkov: bets $1.11
Acedan1369: folds 
Uncalled bet ($1.11) returned to mikhail_dubkov
mikhail_dubkov collected $2.22 from pot
mikhail_dubkov: doesn't show hand 
*** SUMMARY ***
Total pot $2.32 | Rake $0.10 
Board [Jc 4c 5s 4h]
Seat 1: HotMilk2020 folded before Flop (didn't bet)
Seat 3: Diana4teen (button) folded on the Flop
Seat 4: Acedan1369 (small blind) folded on the Turn
Seat 5: DrLevty (big blind) folded on the Flop
Seat 6: mikhail_dubkov collected ($2.22)



PokerStars Hand #222964810725:  Hold'em No Limit ($0.05/$0.10 USD) - 2021/01/23 13:52:14 ET
Table 'Lutetia III' 6-max Seat #4 is the button
Seat 1: HotMilk2020 ($11.25 in chips) 
Seat 3: Diana4teen ($22.54 in chips) 
Seat 4: Acedan1369 ($10 in chips) 
Seat 5: DrLevty ($15 in chips) 
Seat 6: mikhail_dubkov ($7.44 in chips) 
DrLevty: posts small blind $0.05
mikhail_dubkov: posts big blind $0.10
HerrBerg90: sits out 
*** HOLE CARDS ***
HotMilk2020: calls $0.10
Diana4teen: calls $0.10
Acedan1369: folds 
DrLevty: folds 
mikhail_dubkov: checks 
*** FLOP *** [8h 4h 4c]
mikhail_dubkov: checks 
HotMilk2020: checks 
Diana4teen: bets $0.20
mikhail_dubkov: calls $0.20
HotMilk2020: folds 
*** TURN *** [8h 4h 4c] [Kc]
mikhail_dubkov: checks 
Diana4teen: checks 
*** RIVER *** [8h 4h 4c Kc] [Jd]
mikhail_dubkov: bets $0.46
Diana4teen: folds 
Uncalled bet ($0.46) returned to mikhail_dubkov
mikhail_dubkov collected $0.72 from pot
mikhail_dubkov: doesn't show hand 
*** SUMMARY ***
Total pot $0.75 | Rake $0.03 
Board [8h 4h 4c Kc Jd]
Seat 1: HotMilk2020 folded on the Flop
Seat 3: Diana4teen folded on the River
Seat 4: Acedan1369 (button) folded before Flop (didn't bet)
Seat 5: DrLevty (small blind) folded before Flop
Seat 6: mikhail_dubkov (big blind) collected ($0.72)



PokerStars Hand #222964854392:  Hold'em No Limit ($0.05/$0.10 USD) - 2021/01/23 13:53:11 ET
Table 'Lutetia III' 6-max Seat #5 is the button
Seat 1: HotMilk2020 ($11.15 in chips) 
Seat 3: Diana4teen ($22.24 in chips) 
Seat 4: Acedan1369 ($10 in chips) 
Seat 5: DrLevty ($14.95 in chips) 
Seat 6: mikhail_dubkov ($7.86 in chips) 
mikhail_dubkov: posts small blind $0.05
HotMilk2020: posts big blind $0.10
HerrBerg90: sits out 
*** HOLE CARDS ***
Diana4teen: folds 
Acedan1369: folds 
DrLevty: raises $0.20 to $0.30
mikhail_dubkov: calls $0.25
HotMilk2020: folds 
*** FLOP *** [5c Qs 3s]
mikhail_dubkov: checks 
DrLevty: bets $0.22
mikhail_dubkov: calls $0.22
*** TURN *** [5c Qs 3s] [Kc]
mikhail_dubkov: checks 
DrLevty: checks 
*** RIVER *** [5c Qs 3s Kc] [3h]
mikhail_dubkov: bets $0.54
DrLevty: folds 
Uncalled bet ($0.54) returned to mikhail_dubkov
mikhail_dubkov collected $1.09 from pot
mikhail_dubkov: doesn't show hand 
*** SUMMARY ***
Total pot $1.14 | Rake $0.05 
Board [5c Qs 3s Kc 3h]
Seat 1: HotMilk2020 (big blind) folded before Flop
Seat 3: Diana4teen folded before Flop (didn't bet)
Seat 4: Acedan1369 folded before Flop (didn't bet)
Seat 5: DrLevty (button) folded on the River
Seat 6: mikhail_dubkov (small blind) collected ($1.09)



PokerStars Hand #222964882500:  Hold'em No Limit ($0.05/$0.10 USD) - 2021/01/23 13:53:48 ET
Table 'Lutetia III' 6-max Seat #6 is the button
Seat 1: HotMilk2020 ($11.05 in chips) 
Seat 2: HerrBerg90 ($10 in chips) 
Seat 3: Diana4teen ($22.24 in chips) 
Seat 4: Acedan1369 ($10 in chips) 
Seat 5: DrLevty ($14.43 in chips) 
Seat 6: mikhail_dubkov ($8.43 in chips) 
HotMilk2020: posts small blind $0.05
HerrBerg90: posts big blind $0.10
*** HOLE CARDS ***
Diana4teen: raises $0.30 to $0.40
Acedan1369: folds 
DrLevty: folds 
mikhail_dubkov: folds 
mikhail_dubkov leaves the table
tmWudzy joins the table at seat #6 
HotMilk2020: calls $0.35
HerrBerg90: calls $0.30
*** FLOP *** [9c 9d 2s]
HotMilk2020: checks 
HerrBerg90: checks 
Diana4teen: bets $0.80
HotMilk2020: folds 
HerrBerg90: folds 
Uncalled bet ($0.80) returned to Diana4teen
Diana4teen collected $1.15 from pot
Diana4teen: doesn't show hand 
*** SUMMARY ***
Total pot $1.20 | Rake $0.05 
Board [9c 9d 2s]
Seat 1: HotMilk2020 (small blind) folded on the Flop
Seat 2: HerrBerg90 (big blind) folded on the Flop
Seat 3: Diana4teen collected ($1.15)
Seat 4: Acedan1369 folded before Flop (didn't bet)
Seat 5: DrLevty folded before Flop (didn't bet)
Seat 6: mikhail_dubkov (button) folded before Flop (didn't bet)



PokerStars Hand #222964918059:  Hold'em No Limit ($0.05/$0.10 USD) - 2021/01/23 13:54:35 ET
Table 'Lutetia III' 6-max Seat #1 is the button
Seat 1: HotMilk2020 ($10.65 in chips) 
Seat 2: HerrBerg90 ($9.60 in chips) 
Seat 3: Diana4teen ($22.99 in chips) 
Seat 4: Acedan1369 ($10 in chips) 
Seat 5: DrLevty ($14.43 in chips) 
HerrBerg90: posts small blind $0.05
Diana4teen: posts big blind $0.10
tmWudzy: sits out 
*** HOLE CARDS ***
Acedan1369: folds 
DrLevty: raises $0.20 to $0.30
HotMilk2020: folds 
HerrBerg90: calls $0.25
Diana4teen: folds 
*** FLOP *** [5h Qd Js]
HerrBerg90: bets $0.10
DrLevty: calls $0.10
*** TURN *** [5h Qd Js] [9d]
HerrBerg90: checks 
DrLevty: checks 
*** RIVER *** [5h Qd Js 9d] [5s]
HerrBerg90: bets $3.30
DrLevty: folds 
Uncalled bet ($3.30) returned to HerrBerg90
HerrBerg90 collected $0.86 from pot
HerrBerg90: doesn't show hand 
*** SUMMARY ***
Total pot $0.90 | Rake $0.04 
Board [5h Qd Js 9d 5s]
Seat 1: HotMilk2020 (button) folded before Flop (didn't bet)
Seat 2: HerrBerg90 (small blind) collected ($0.86)
Seat 3: Diana4teen (big blind) folded before Flop
Seat 4: Acedan1369 folded before Flop (didn't bet)
Seat 5: DrLevty folded on the River



PokerStars Hand #222964948032:  Hold'em No Limit ($0.05/$0.10 USD) - 2021/01/23 13:55:19 ET
Table 'Lutetia III' 6-max Seat #2 is the button
Seat 1: HotMilk2020 ($10.65 in chips) 
Seat 2: HerrBerg90 ($10.06 in chips) 
Seat 3: Diana4teen ($22.89 in chips) 
Seat 4: Acedan1369 ($10 in chips) 
Seat 5: DrLevty ($14.03 in chips) 
Diana4teen: posts small blind $0.05
Acedan1369: posts big blind $0.10
tmWudzy: sits out 
*** HOLE CARDS ***
DrLevty: folds 
HotMilk2020: folds 
HerrBerg90: calls $0.10
Diana4teen: raises $0.20 to $0.30
Acedan1369: folds 
HerrBerg90: calls $0.20
*** FLOP *** [5s 5h Kh]
Diana4teen: bets $0.50
HerrBerg90: calls $0.50
*** TURN *** [5s 5h Kh] [3d]
Diana4teen: checks 
HerrBerg90: checks 
*** RIVER *** [5s 5h Kh 3d] [Qs]
Diana4teen: checks 
HerrBerg90: checks 
*** SHOW DOWN ***
Diana4teen: shows [3s As] (two pair, Fives and Threes)
HerrBerg90: mucks hand 
Diana4teen collected $1.62 from pot
*** SUMMARY ***
Total pot $1.70 | Rake $0.08 
Board [5s 5h Kh 3d Qs]
Seat 1: HotMilk2020 folded before Flop (didn't bet)
Seat 2: HerrBerg90 (button) mucked
Seat 3: Diana4teen (small blind) showed [3s As] and won ($1.62) with two pair, Fives and Threes
Seat 4: Acedan1369 (big blind) folded before Flop
Seat 5: DrLevty folded before Flop (didn't bet)



PokerStars Hand #222964982326:  Hold'em No Limit ($0.05/$0.10 USD) - 2021/01/23 13:56:30 ET
Table 'Lutetia III' 6-max Seat #3 is the button
Seat 1: HotMilk2020 ($10.65 in chips) 
Seat 2: HerrBerg90 ($9.26 in chips) 
Seat 3: Diana4teen ($23.71 in chips) 
Seat 4: Acedan1369 ($10 in chips) 
Seat 5: DrLevty ($14.03 in chips) 
Acedan1369: posts small blind $0.05
DrLevty: posts big blind $0.10
tmWudzy: sits out 
*** HOLE CARDS ***
HotMilk2020: calls $0.10
HerrBerg90: calls $0.10
Diana4teen: raises $0.40 to $0.50
Acedan1369: calls $0.45
DrLevty: folds 
HotMilk2020: calls $0.40
HerrBerg90: calls $0.40
*** FLOP *** [2h 6h 5s]
Acedan1369: checks 
HotMilk2020: checks 
HerrBerg90: checks 
Diana4teen: bets $1
Acedan1369: calls $1
HotMilk2020: calls $1
HerrBerg90: folds 
*** TURN *** [2h 6h 5s] [2s]
Acedan1369: checks 
HotMilk2020: checks 
tmWudzy was removed from the table for failing to post
tmWudzy leaves the table
Diana4teen: bets $2
Acedan1369: calls $2
HotMilk2020: folds 
*** RIVER *** [2h 6h 5s 2s] [3s]
Acedan1369: bets $6.50 and is all-in
Diana4teen: folds 
Uncalled bet ($6.50) returned to Acedan1369
Acedan1369 collected $8.69 from pot
Acedan1369: doesn't show hand 
*** SUMMARY ***
Total pot $9.10 | Rake $0.41 
Board [2h 6h 5s 2s 3s]
Seat 1: HotMilk2020 folded on the Turn
Seat 2: HerrBerg90 folded on the Flop
Seat 3: Diana4teen (button) folded on the River
Seat 4: Acedan1369 (small blind) collected ($8.69)
Seat 5: DrLevty (big blind) folded before Flop



PokerStars Hand #222965023741:  Hold'em No Limit ($0.05/$0.10 USD) - 2021/01/23 13:57:55 ET
Table 'Lutetia III' 6-max Seat #4 is the button
Seat 1: HotMilk2020 ($9.15 in chips) 
Seat 2: HerrBerg90 ($8.76 in chips) 
Seat 3: Diana4teen ($20.21 in chips) 
Seat 4: Acedan1369 ($15.19 in chips) 
Seat 5: DrLevty ($13.93 in chips) 
DrLevty: posts small blind $0.05
HotMilk2020: posts big blind $0.10
*** HOLE CARDS ***
paquitabomb joins the table at seat #6 
HerrBerg90: calls $0.10
Diana4teen: raises $0.40 to $0.50
Acedan1369: folds 
DrLevty: folds 
HotMilk2020: calls $0.40
HerrBerg90: calls $0.40
*** FLOP *** [5c 5h Qc]
HotMilk2020: checks 
HerrBerg90: checks 
Diana4teen: bets $1
HotMilk2020: folds 
HerrBerg90: folds 
Uncalled bet ($1) returned to Diana4teen
Diana4teen collected $1.48 from pot
*** SUMMARY ***
Total pot $1.55 | Rake $0.07 
Board [5c 5h Qc]
Seat 1: HotMilk2020 (big blind) folded on the Flop
Seat 2: HerrBerg90 folded on the Flop
Seat 3: Diana4teen collected ($1.48)
Seat 4: Acedan1369 (button) folded before Flop (didn't bet)
Seat 5: DrLevty (small blind) folded before Flop



PokerStars Hand #222965059658:  Hold'em No Limit ($0.05/$0.10 USD) - 2021/01/23 13:59:09 ET
Table 'Lutetia III' 6-max Seat #5 is the button
Seat 1: HotMilk2020 ($8.65 in chips) 
Seat 2: HerrBerg90 ($8.26 in chips) 
Seat 3: Diana4teen ($21.19 in chips) 
Seat 4: Acedan1369 ($15.19 in chips) 
Seat 5: DrLevty ($13.88 in chips) 
HotMilk2020: posts small blind $0.05
HerrBerg90: posts big blind $0.10
*** HOLE CARDS ***
Diana4teen: raises $0.40 to $0.50
Acedan1369: folds 
DrLevty: folds 
HotMilk2020: calls $0.45
HerrBerg90: folds 
*** FLOP *** [As 7s 4h]
HotMilk2020: checks 
Diana4teen: checks 
*** TURN *** [As 7s 4h] [2d]
HotMilk2020: checks 
Diana4teen: checks 
*** RIVER *** [As 7s 4h 2d] [Ad]
HotMilk2020: checks 
Diana4teen: checks 
*** SHOW DOWN ***
HotMilk2020: shows [Ah 6h] (three of a kind, Aces)
Diana4teen: mucks hand 
HotMilk2020 collected $1.05 from pot
*** SUMMARY ***
Total pot $1.10 | Rake $0.05 
Board [As 7s 4h 2d Ad]
Seat 1: HotMilk2020 (small blind) showed [Ah 6h] and won ($1.05) with three of a kind, Aces
Seat 2: HerrBerg90 (big blind) folded before Flop
Seat 3: Diana4teen mucked
Seat 4: Acedan1369 folded before Flop (didn't bet)
Seat 5: DrLevty (button) folded before Flop (didn't bet)



PokerStars Hand #222965083067:  Hold'em No Limit ($0.05/$0.10 USD) - 2021/01/23 13:59:56 ET
Table 'Lutetia III' 6-max Seat #1 is the button
Seat 1: HotMilk2020 ($9.20 in chips) 
Seat 2: HerrBerg90 ($8.16 in chips) 
Seat 3: Diana4teen ($20.69 in chips) 
Seat 4: Acedan1369 ($15.19 in chips) 
Seat 5: DrLevty ($13.88 in chips) 
HerrBerg90: posts small blind $0.05
Diana4teen: posts big blind $0.10
paquitabomb: sits out 
*** HOLE CARDS ***
Acedan1369: folds 
DrLevty: raises $0.20 to $0.30
HotMilk2020: folds 
HerrBerg90: calls $0.25
Diana4teen: calls $0.20
*** FLOP *** [8d Jd 9d]
HerrBerg90: checks 
Diana4teen: checks 
DrLevty: checks 
*** TURN *** [8d Jd 9d] [9h]
HerrBerg90: checks 
Diana4teen: bets $0.50
DrLevty: folds 
HerrBerg90: calls $0.50
*** RIVER *** [8d Jd 9d 9h] [Ac]
HerrBerg90: checks 
Diana4teen: bets $1
HerrBerg90: folds 
Uncalled bet ($1) returned to Diana4teen
Diana4teen collected $1.81 from pot
Diana4teen: doesn't show hand 
*** SUMMARY ***
Total pot $1.90 | Rake $0.09 
Board [8d Jd 9d 9h Ac]
Seat 1: HotMilk2020 (button) folded before Flop (didn't bet)
Seat 2: HerrBerg90 (small blind) folded on the River
Seat 3: Diana4teen (big blind) collected ($1.81)
Seat 4: Acedan1369 folded before Flop (didn't bet)
Seat 5: DrLevty folded on the Turn



PokerStars Hand #222965118298:  Hold'em No Limit ($0.05/$0.10 USD) - 2021/01/23 14:01:00 ET
Table 'Lutetia III' 6-max Seat #2 is the button
Seat 1: HotMilk2020 ($9.20 in chips) 
Seat 2: HerrBerg90 ($7.36 in chips) 
Seat 3: Diana4teen ($21.70 in chips) 
Seat 4: Acedan1369 ($15.19 in chips) 
Seat 5: DrLevty ($13.58 in chips) 
Diana4teen: posts small blind $0.05
Acedan1369: posts big blind $0.10
paquitabomb: sits out 
*** HOLE CARDS ***
DrLevty: folds 
HotMilk2020: folds 
HerrBerg90: calls $0.10
Diana4teen: calls $0.05
Acedan1369: checks 
*** FLOP *** [6d 5h 4c]
Diana4teen: checks 
Acedan1369: checks 
HerrBerg90: bets $0.50
Diana4teen: calls $0.50
Acedan1369: calls $0.50
*** TURN *** [6d 5h 4c] [Ad]
Diana4teen: checks 
Acedan1369: bets $1.29
HerrBerg90: calls $1.29
Diana4teen: calls $1.29
*** RIVER *** [6d 5h 4c Ad] [6s]
Diana4teen: checks 
Acedan1369: checks 
HerrBerg90: bets $5.47 and is all-in
Diana4teen: folds 
Acedan1369: folds 
Uncalled bet ($5.47) returned to HerrBerg90
HerrBerg90 collected $5.41 from pot
HerrBerg90: doesn't show hand 
*** SUMMARY ***
Total pot $5.67 | Rake $0.26 
Board [6d 5h 4c Ad 6s]
Seat 1: HotMilk2020 folded before Flop (didn't bet)
Seat 2: HerrBerg90 (button) collected ($5.41)
Seat 3: Diana4teen (small blind) folded on the River
Seat 4: Acedan1369 (big blind) folded on the River
Seat 5: DrLevty folded before Flop (didn't bet)



PokerStars Hand #222965218872:  Hold'em No Limit ($0.05/$0.10 USD) - 2021/01/23 14:03:09 ET
Table 'Lutetia III' 6-max Seat #3 is the button
Seat 1: HotMilk2020 ($9.20 in chips) 
Seat 2: HerrBerg90 ($10.88 in chips) 
Seat 3: Diana4teen ($19.81 in chips) 
Seat 4: Acedan1369 ($13.30 in chips) 
Seat 5: DrLevty ($13.58 in chips) 
Acedan1369: posts small blind $0.05
DrLevty: posts big blind $0.10
paquitabomb: sits out 
*** HOLE CARDS ***
HotMilk2020: folds 
HerrBerg90: folds 
Diana4teen: folds 
Acedan1369: folds 
Uncalled bet ($0.05) returned to DrLevty
DrLevty collected $0.10 from pot
DrLevty: doesn't show hand 
*** SUMMARY ***
Total pot $0.10 | Rake $0 
Seat 1: HotMilk2020 folded before Flop (didn't bet)
Seat 2: HerrBerg90 folded before Flop (didn't bet)
Seat 3: Diana4teen (button) folded before Flop (didn't bet)
Seat 4: Acedan1369 (small blind) folded before Flop
Seat 5: DrLevty (big blind) collected ($0.10)



PokerStars Hand #222965226344:  Hold'em No Limit ($0.05/$0.10 USD) - 2021/01/23 14:03:18 ET
Table 'Lutetia III' 6-max Seat #4 is the button
Seat 1: HotMilk2020 ($9.20 in chips) 
Seat 2: HerrBerg90 ($10.88 in chips) 
Seat 3: Diana4teen ($19.81 in chips) 
Seat 4: Acedan1369 ($13.25 in chips) 
Seat 5: DrLevty ($13.63 in chips) 
Seat 6: paquitabomb ($8 in chips) 
DrLevty: posts small blind $0.05
paquitabomb: posts big blind $0.10
*** HOLE CARDS ***
HotMilk2020: folds 
HerrBerg90: calls $0.10
Diana4teen: folds 
Acedan1369: folds 
DrLevty: folds 
paquitabomb: checks 
*** FLOP *** [6d 3h Ts]
paquitabomb: checks 
HerrBerg90: checks 
*** TURN *** [6d 3h Ts] [3s]
paquitabomb: checks 
HerrBerg90: checks 
*** RIVER *** [6d 3h Ts 3s] [9d]
paquitabomb: checks 
HerrBerg90: checks 
*** SHOW DOWN ***
paquitabomb: shows [7c 5s] (a pair of Threes)
HerrBerg90: shows [Th 6h] (two pair, Tens and Sixes)
HerrBerg90 collected $0.24 from pot
*** SUMMARY ***
Total pot $0.25 | Rake $0.01 
Board [6d 3h Ts 3s 9d]
Seat 1: HotMilk2020 folded before Flop (didn't bet)
Seat 2: HerrBerg90 showed [Th 6h] and won ($0.24) with two pair, Tens and Sixes
Seat 3: Diana4teen folded before Flop (didn't bet)
Seat 4: Acedan1369 (button) folded before Flop (didn't bet)
Seat 5: DrLevty (small blind) folded before Flop
Seat 6: paquitabomb (big blind) showed [7c 5s] and lost with a pair of Threes



PokerStars Hand #222965247271:  Hold'em No Limit ($0.05/$0.10 USD) - 2021/01/23 14:03:45 ET
Table 'Lutetia III' 6-max Seat #5 is the button
Seat 1: HotMilk2020 ($9.20 in chips) 
Seat 2: HerrBerg90 ($11.02 in chips) 
Seat 3: Diana4teen ($19.81 in chips) 
Seat 4: Acedan1369 ($13.25 in chips) 
Seat 5: DrLevty ($13.58 in chips) 
Seat 6: paquitabomb ($10 in chips) 
paquitabomb: posts small blind $0.05
HotMilk2020: posts big blind $0.10
*** HOLE CARDS ***
HerrBerg90: folds 
Diana4teen: folds 
Acedan1369: folds 
DrLevty: folds 
paquitabomb: folds 
Uncalled bet ($0.05) returned to HotMilk2020
HotMilk2020 collected $0.10 from pot
HotMilk2020: doesn't show hand 
*** SUMMARY ***
Total pot $0.10 | Rake $0 
Seat 1: HotMilk2020 (big blind) collected ($0.10)
Seat 2: HerrBerg90 folded before Flop (didn't bet)
Seat 3: Diana4teen folded before Flop (didn't bet)
Seat 4: Acedan1369 folded before Flop (didn't bet)
Seat 5: DrLevty (button) folded before Flop (didn't bet)
Seat 6: paquitabomb (small blind) folded before Flop



PokerStars Hand #222965259337:  Hold'em No Limit ($0.05/$0.10 USD) - 2021/01/23 14:04:00 ET
Table 'Lutetia III' 6-max Seat #6 is the button
Seat 1: HotMilk2020 ($9.25 in chips) 
Seat 2: HerrBerg90 ($11.02 in chips) 
Seat 3: Diana4teen ($19.81 in chips) 
Seat 4: Acedan1369 ($13.25 in chips) 
Seat 5: DrLevty ($13.58 in chips) 
Seat 6: paquitabomb ($9.95 in chips) 
HotMilk2020: posts small blind $0.05
HerrBerg90: posts big blind $0.10
*** HOLE CARDS ***
Diana4teen: folds 
Acedan1369: folds 
DrLevty: raises $0.20 to $0.30
paquitabomb: folds 
HotMilk2020: calls $0.25
HerrBerg90: folds 
*** FLOP *** [Qd Ah 9d]
HotMilk2020: checks 
DrLevty: checks 
*** TURN *** [Qd Ah 9d] [4s]
HotMilk2020: checks 
DrLevty: checks 
*** RIVER *** [Qd Ah 9d 4s] [7d]
HotMilk2020: checks 
DrLevty: checks 
*** SHOW DOWN ***
HotMilk2020: shows [Ts Ks] (high card Ace)
DrLevty: shows [3c 3s] (a pair of Threes)
DrLevty collected $0.67 from pot
*** SUMMARY ***
Total pot $0.70 | Rake $0.03 
Board [Qd Ah 9d 4s 7d]
Seat 1: HotMilk2020 (small blind) showed [Ts Ks] and lost with high card Ace
Seat 2: HerrBerg90 (big blind) folded before Flop
Seat 3: Diana4teen folded before Flop (didn't bet)
Seat 4: Acedan1369 folded before Flop (didn't bet)
Seat 5: DrLevty showed [3c 3s] and won ($0.67) with a pair of Threes
Seat 6: paquitabomb (button) folded before Flop (didn't bet)



PokerStars Hand #222965286771:  Hold'em No Limit ($0.05/$0.10 USD) - 2021/01/23 14:04:36 ET
Table 'Lutetia III' 6-max Seat #1 is the button
Seat 1: HotMilk2020 ($8.95 in chips) 
Seat 2: HerrBerg90 ($10.92 in chips) 
Seat 3: Diana4teen ($19.81 in chips) 
Seat 4: Acedan1369 ($13.25 in chips) 
Seat 5: DrLevty ($13.95 in chips) 
Seat 6: paquitabomb ($9.95 in chips) 
HerrBerg90: posts small blind $0.05
Diana4teen: posts big blind $0.10
*** HOLE CARDS ***
Acedan1369: folds 
DrLevty: folds 
paquitabomb: raises $0.15 to $0.25
HotMilk2020: folds 
HerrBerg90: calls $0.20
Diana4teen: calls $0.15
*** FLOP *** [Jd 4h Jc]
HerrBerg90: checks 
Diana4teen: checks 
paquitabomb: checks 
*** TURN *** [Jd 4h Jc] [5d]
HerrBerg90: checks 
Diana4teen: checks 
paquitabomb: bets $0.47
HerrBerg90: folds 
Diana4teen: calls $0.47
*** RIVER *** [Jd 4h Jc 5d] [8s]
Diana4teen: bets $1.61
paquitabomb: folds 
Uncalled bet ($1.61) returned to Diana4teen
Diana4teen collected $1.61 from pot
Diana4teen: doesn't show hand 
*** SUMMARY ***
Total pot $1.69 | Rake $0.08 
Board [Jd 4h Jc 5d 8s]
Seat 1: HotMilk2020 (button) folded before Flop (didn't bet)
Seat 2: HerrBerg90 (small blind) folded on the Turn
Seat 3: Diana4teen (big blind) collected ($1.61)
Seat 4: Acedan1369 folded before Flop (didn't bet)
Seat 5: DrLevty folded before Flop (didn't bet)
Seat 6: paquitabomb folded on the River



PokerStars Hand #222965335069:  Hold'em No Limit ($0.05/$0.10 USD) - 2021/01/23 14:05:36 ET
Table 'Lutetia III' 6-max Seat #2 is the button
Seat 1: HotMilk2020 ($8.95 in chips) 
Seat 2: HerrBerg90 ($10.67 in chips) 
Seat 3: Diana4teen ($20.70 in chips) 
Seat 4: Acedan1369 ($13.25 in chips) 
Seat 5: DrLevty ($13.95 in chips) 
Seat 6: paquitabomb ($9.23 in chips) 
Diana4teen: posts small blind $0.05
Acedan1369: posts big blind $0.10
*** HOLE CARDS ***
DrLevty: folds 
paquitabomb: folds 
HotMilk2020: calls $0.10
HerrBerg90: calls $0.10
Diana4teen: raises $0.40 to $0.50
Acedan1369: raises $0.80 to $1.30
HotMilk2020: folds 
HerrBerg90: folds 
Diana4teen: calls $0.80
*** FLOP *** [7h 9s 3d]
Diana4teen: checks 
Acedan1369: bets $1.20
Diana4teen: calls $1.20
*** TURN *** [7h 9s 3d] [6d]
Diana4teen: checks 
Acedan1369: bets $3.73
Diana4teen: folds 
Uncalled bet ($3.73) returned to Acedan1369
Acedan1369 collected $4.97 from pot
Acedan1369: doesn't show hand 
*** SUMMARY ***
Total pot $5.20 | Rake $0.23 
Board [7h 9s 3d 6d]
Seat 1: HotMilk2020 folded before Flop
Seat 2: HerrBerg90 (button) folded before Flop
Seat 3: Diana4teen (small blind) folded on the Turn
Seat 4: Acedan1369 (big blind) collected ($4.97)
Seat 5: DrLevty folded before Flop (didn't bet)
Seat 6: paquitabomb folded before Flop (didn't bet)



PokerStars Hand #222965441184:  Hold'em No Limit ($0.05/$0.10 USD) - 2021/01/23 14:07:50 ET
Table 'Lutetia III' 6-max Seat #3 is the button
Seat 1: HotMilk2020 ($8.85 in chips) 
Seat 2: HerrBerg90 ($10.57 in chips) 
Seat 3: Diana4teen ($18.20 in chips) 
Seat 4: Acedan1369 ($15.72 in chips) 
Seat 5: DrLevty ($13.95 in chips) 
Seat 6: paquitabomb ($9.23 in chips) 
Acedan1369: posts small blind $0.05
DrLevty: posts big blind $0.10
*** HOLE CARDS ***
paquitabomb: folds 
HotMilk2020: calls $0.10
HerrBerg90: folds 
Diana4teen: calls $0.10
Acedan1369: folds 
DrLevty: checks 
*** FLOP *** [5h 4h 4d]
DrLevty: bets $0.22
HotMilk2020: calls $0.22
Diana4teen: folds 
*** TURN *** [5h 4h 4d] [Ac]
DrLevty: bets $0.56
HotMilk2020: calls $0.56
*** RIVER *** [5h 4h 4d Ac] [Td]
DrLevty: bets $1.37
HotMilk2020: raises $1.37 to $2.74
DrLevty: calls $1.37
*** SHOW DOWN ***
HotMilk2020: shows [Ah 5d] (two pair, Aces and Fives)
DrLevty: shows [4s 8s] (three of a kind, Fours)
DrLevty collected $7.06 from pot
*** SUMMARY ***
Total pot $7.39 | Rake $0.33 
Board [5h 4h 4d Ac Td]
Seat 1: HotMilk2020 showed [Ah 5d] and lost with two pair, Aces and Fives
Seat 2: HerrBerg90 folded before Flop (didn't bet)
Seat 3: Diana4teen (button) folded on the Flop
Seat 4: Acedan1369 (small blind) folded before Flop
Seat 5: DrLevty (big blind) showed [4s 8s] and won ($7.06) with three of a kind, Fours
Seat 6: paquitabomb folded before Flop (didn't bet)



PokerStars Hand #222965493119:  Hold'em No Limit ($0.05/$0.10 USD) - 2021/01/23 14:08:55 ET
Table 'Lutetia III' 6-max Seat #4 is the button
Seat 1: HotMilk2020 ($5.23 in chips) 
Seat 2: HerrBerg90 ($10.57 in chips) 
Seat 3: Diana4teen ($18.10 in chips) 
Seat 4: Acedan1369 ($15.67 in chips) 
Seat 5: DrLevty ($17.39 in chips) 
Seat 6: paquitabomb ($9.23 in chips) 
DrLevty: posts small blind $0.05
paquitabomb: posts big blind $0.10
*** HOLE CARDS ***
HotMilk2020: calls $0.10
HerrBerg90: calls $0.10
Diana4teen has timed out
Diana4teen: folds 
Acedan1369: folds 
DrLevty: raises $0.40 to $0.50
paquitabomb: folds 
HotMilk2020: calls $0.40
HerrBerg90: folds 
*** FLOP *** [4d 9c 8c]
DrLevty: checks 
HotMilk2020: bets $0.58
DrLevty: folds 
Uncalled bet ($0.58) returned to HotMilk2020
HotMilk2020 collected $1.15 from pot
HotMilk2020: doesn't show hand 
*** SUMMARY ***
Total pot $1.20 | Rake $0.05 
Board [4d 9c 8c]
Seat 1: HotMilk2020 collected ($1.15)
Seat 2: HerrBerg90 folded before Flop
Seat 3: Diana4teen folded before Flop (didn't bet)
Seat 4: Acedan1369 (button) folded before Flop (didn't bet)
Seat 5: DrLevty (small blind) folded on the Flop
Seat 6: paquitabomb (big blind) folded before Flop



PokerStars Hand #222965528388:  Hold'em No Limit ($0.05/$0.10 USD) - 2021/01/23 14:09:40 ET
Table 'Lutetia III' 6-max Seat #5 is the button
Seat 1: HotMilk2020 ($5.88 in chips) 
Seat 2: HerrBerg90 ($10.47 in chips) 
Seat 3: Diana4teen ($18.10 in chips) 
Seat 4: Acedan1369 ($15.67 in chips) 
Seat 5: DrLevty ($16.89 in chips) 
Seat 6: paquitabomb ($9.13 in chips) 
paquitabomb: posts small blind $0.05
HotMilk2020: posts big blind $0.10
*** HOLE CARDS ***
HerrBerg90: calls $0.10
Diana4teen: folds 
Acedan1369: folds 
DrLevty: folds 
paquitabomb: calls $0.05
HotMilk2020: checks 
*** FLOP *** [9s 2d Ac]
paquitabomb: checks 
HotMilk2020: checks 
HerrBerg90: checks 
*** TURN *** [9s 2d Ac] [2c]
paquitabomb: checks 
HotMilk2020: checks 
HerrBerg90: checks 
*** RIVER *** [9s 2d Ac 2c] [9d]
paquitabomb: checks 
HotMilk2020: checks 
HerrBerg90: checks 
*** SHOW DOWN ***
paquitabomb: shows [Jd 3h] (two pair, Nines and Deuces)
HotMilk2020: shows [Qs 5s] (two pair, Nines and Deuces)
HerrBerg90: shows [5h Th] (two pair, Nines and Deuces)
paquitabomb collected $0.10 from pot
HotMilk2020 collected $0.10 from pot
HerrBerg90 collected $0.09 from pot
*** SUMMARY ***
Total pot $0.30 | Rake $0.01 
Board [9s 2d Ac 2c 9d]
Seat 1: HotMilk2020 (big blind) showed [Qs 5s] and won ($0.10) with two pair, Nines and Deuces
Seat 2: HerrBerg90 showed [5h Th] and won ($0.09) with two pair, Nines and Deuces
Seat 3: Diana4teen folded before Flop (didn't bet)
Seat 4: Acedan1369 folded before Flop (didn't bet)
Seat 5: DrLevty (button) folded before Flop (didn't bet)
Seat 6: paquitabomb (small blind) showed [Jd 3h] and won ($0.10) with two pair, Nines and Deuces



PokerStars Hand #222965557452:  Hold'em No Limit ($0.05/$0.10 USD) - 2021/01/23 14:10:17 ET
Table 'Lutetia III' 6-max Seat #6 is the button
Seat 1: HotMilk2020 ($5.88 in chips) 
Seat 2: HerrBerg90 ($10.46 in chips) 
Seat 3: Diana4teen ($18.10 in chips) 
Seat 4: Acedan1369 ($15.67 in chips) 
Seat 5: DrLevty ($16.89 in chips) 
Seat 6: paquitabomb ($9.13 in chips) 
HotMilk2020: posts small blind $0.05
HerrBerg90: posts big blind $0.10
*** HOLE CARDS ***
Diana4teen: calls $0.10
Acedan1369: folds 
DrLevty: raises $0.40 to $0.50
paquitabomb: folds 
HotMilk2020: folds 
HerrBerg90: calls $0.40
Diana4teen: calls $0.40
*** FLOP *** [8d 5c 8c]
HerrBerg90: checks 
Diana4teen: checks 
DrLevty: bets $0.99
HerrBerg90: folds 
Diana4teen: folds 
Uncalled bet ($0.99) returned to DrLevty
DrLevty collected $1.48 from pot
DrLevty: doesn't show hand 
*** SUMMARY ***
Total pot $1.55 | Rake $0.07 
Board [8d 5c 8c]
Seat 1: HotMilk2020 (small blind) folded before Flop
Seat 2: HerrBerg90 (big blind) folded on the Flop
Seat 3: Diana4teen folded on the Flop
Seat 4: Acedan1369 folded before Flop (didn't bet)
Seat 5: DrLevty collected ($1.48)
Seat 6: paquitabomb (button) folded before Flop (didn't bet)



PokerStars Hand #222965594318:  Hold'em No Limit ($0.05/$0.10 USD) - 2021/01/23 14:11:04 ET
Table 'Lutetia III' 6-max Seat #1 is the button
Seat 1: HotMilk2020 ($5.83 in chips) 
Seat 2: HerrBerg90 ($9.96 in chips) 
Seat 3: Diana4teen ($17.60 in chips) 
Seat 4: Acedan1369 ($15.67 in chips) 
Seat 5: DrLevty ($17.87 in chips) 
Seat 6: paquitabomb ($9.13 in chips) 
HerrBerg90: posts small blind $0.05
Diana4teen: posts big blind $0.10
*** HOLE CARDS ***
Acedan1369: folds 
DrLevty: folds 
paquitabomb: raises $0.15 to $0.25
HotMilk2020: folds 
HerrBerg90: folds 
Diana4teen: raises $0.55 to $0.80
paquitabomb: calls $0.55
*** FLOP *** [4s 7s 5c]
HerrBerg90 leaves the table
Marocki joins the table at seat #2 
Diana4teen: bets $1
paquitabomb: raises $1.60 to $2.60
Diana4teen: raises $2.70 to $5.30
paquitabomb: raises $3.03 to $8.33 and is all-in
Diana4teen: calls $3.03
Diana4teen has timed out
*** TURN *** [4s 7s 5c] [Ts]
*** RIVER *** [4s 7s 5c Ts] [Ah]
*** SHOW DOWN ***
Diana4teen: shows [Ks Kc] (a pair of Kings)
paquitabomb: shows [6c 8c] (a straight, Four to Eight)
paquitabomb collected $17.49 from pot
*** SUMMARY ***
Total pot $18.31 | Rake $0.82 
Board [4s 7s 5c Ts Ah]
Seat 1: HotMilk2020 (button) folded before Flop (didn't bet)
Seat 2: HerrBerg90 (small blind) folded before Flop
Seat 3: Diana4teen (big blind) showed [Ks Kc] and lost with a pair of Kings
Seat 4: Acedan1369 folded before Flop (didn't bet)
Seat 5: DrLevty folded before Flop (didn't bet)
Seat 6: paquitabomb showed [6c 8c] and won ($17.49) with a straight, Four to Eight



PokerStars Hand #222965672906:  Hold'em No Limit ($0.05/$0.10 USD) - 2021/01/23 14:12:43 ET
Table 'Lutetia III' 6-max Seat #3 is the button
Seat 1: HotMilk2020 ($5.83 in chips) 
Seat 3: Diana4teen ($8.47 in chips) 
Seat 4: Acedan1369 ($15.67 in chips) 
Seat 5: DrLevty ($17.87 in chips) 
Seat 6: paquitabomb ($17.49 in chips) 
Acedan1369: posts small blind $0.05
DrLevty: posts big blind $0.10
Marocki: sits out 
*** HOLE CARDS ***
paquitabomb: folds 
HotMilk2020: folds 
Diana4teen: raises $0.40 to $0.50
Acedan1369: calls $0.45
DrLevty: folds 
*** FLOP *** [Kc 7c 8c]
Acedan1369: checks 
Diana4teen: bets $0.50
Acedan1369: folds 
Uncalled bet ($0.50) returned to Diana4teen
Diana4teen collected $1.05 from pot
Diana4teen: doesn't show hand 
*** SUMMARY ***
Total pot $1.10 | Rake $0.05 
Board [Kc 7c 8c]
Seat 1: HotMilk2020 folded before Flop (didn't bet)
Seat 3: Diana4teen (button) collected ($1.05)
Seat 4: Acedan1369 (small blind) folded on the Flop
Seat 5: DrLevty (big blind) folded before Flop
Seat 6: paquitabomb folded before Flop (didn't bet)



PokerStars Hand #222965696789:  Hold'em No Limit ($0.05/$0.10 USD) - 2021/01/23 14:13:13 ET
Table 'Lutetia III' 6-max Seat #4 is the button
Seat 1: HotMilk2020 ($5.83 in chips) 
Seat 3: Diana4teen ($9.02 in chips) 
Seat 4: Acedan1369 ($15.17 in chips) 
Seat 5: DrLevty ($17.77 in chips) 
DrLevty: posts small blind $0.05
paquitabomb: is sitting out 
paquitabomb leaves the table
HotMilk2020: posts big blind $0.10
Marocki: sits out 
*** HOLE CARDS ***
Diana4teen: folds 
Acedan1369: raises $0.15 to $0.25
DrLevty: folds 
HotMilk2020: calls $0.15
*** FLOP *** [7s 2s 7d]
fish72o joins the table at seat #6 
HotMilk2020: checks 
Acedan1369: bets $0.24
HotMilk2020: calls $0.24
*** TURN *** [7s 2s 7d] [Qd]
HotMilk2020: checks 
Acedan1369: bets $0.74
HotMilk2020: raises $4.60 to $5.34 and is all-in
Acedan1369: folds 
Uncalled bet ($4.60) returned to HotMilk2020
HotMilk2020 collected $2.40 from pot
HotMilk2020: doesn't show hand 
*** SUMMARY ***
Total pot $2.51 | Rake $0.11 
Board [7s 2s 7d Qd]
Seat 1: HotMilk2020 (big blind) collected ($2.40)
Seat 3: Diana4teen folded before Flop (didn't bet)
Seat 4: Acedan1369 (button) folded on the Turn
Seat 5: DrLevty (small blind) folded before Flop



PokerStars Hand #222965727876:  Hold'em No Limit ($0.05/$0.10 USD) - 2021/01/23 14:13:53 ET
Table 'Lutetia III' 6-max Seat #5 is the button
Seat 1: HotMilk2020 ($7 in chips) 
Seat 2: Marocki ($10 in chips) 
Seat 3: Diana4teen ($9.02 in chips) 
Seat 4: Acedan1369 ($13.94 in chips) 
Seat 5: DrLevty ($17.72 in chips) 
HotMilk2020: posts small blind $0.05
Marocki: posts big blind $0.10
*** HOLE CARDS ***
Diana4teen: folds 
Acedan1369: folds 
DrLevty: folds 
HotMilk2020: calls $0.05
Marocki: raises $0.30 to $0.40
HotMilk2020: calls $0.30
*** FLOP *** [3s Ac 8h]
HotMilk2020: checks 
Marocki: bets $0.40
HotMilk2020: folds 
Uncalled bet ($0.40) returned to Marocki
Marocki collected $0.76 from pot
*** SUMMARY ***
Total pot $0.80 | Rake $0.04 
Board [3s Ac 8h]
Seat 1: HotMilk2020 (small blind) folded on the Flop
Seat 2: Marocki (big blind) collected ($0.76)
Seat 3: Diana4teen folded before Flop (didn't bet)
Seat 4: Acedan1369 folded before Flop (didn't bet)
Seat 5: DrLevty (button) folded before Flop (didn't bet)



PokerStars Hand #222965752091:  Hold'em No Limit ($0.05/$0.10 USD) - 2021/01/23 14:14:23 ET
Table 'Lutetia III' 6-max Seat #1 is the button
Seat 1: HotMilk2020 ($6.60 in chips) 
Seat 2: Marocki ($10.36 in chips) 
Seat 3: Diana4teen ($9.02 in chips) 
Seat 4: Acedan1369 ($13.94 in chips) 
Seat 5: DrLevty ($17.72 in chips) 
Marocki: posts small blind $0.05
Diana4teen: posts big blind $0.10
fish72o: sits out 
*** HOLE CARDS ***
Acedan1369: folds 
DrLevty: folds 
HotMilk2020: raises $0.25 to $0.35
Marocki: folds 
Diana4teen: folds 
Uncalled bet ($0.25) returned to HotMilk2020
HotMilk2020 collected $0.25 from pot
HotMilk2020: doesn't show hand 
*** SUMMARY ***
Total pot $0.25 | Rake $0 
Seat 1: HotMilk2020 (button) collected ($0.25)
Seat 2: Marocki (small blind) folded before Flop
Seat 3: Diana4teen (big blind) folded before Flop
Seat 4: Acedan1369 folded before Flop (didn't bet)
Seat 5: DrLevty folded before Flop (didn't bet)



PokerStars Hand #222965767713:  Hold'em No Limit ($0.05/$0.10 USD) - 2021/01/23 14:14:43 ET
Table 'Lutetia III' 6-max Seat #2 is the button
Seat 1: HotMilk2020 ($6.75 in chips) 
Seat 2: Marocki ($10.31 in chips) 
Seat 3: Diana4teen ($8.92 in chips) 
Seat 4: Acedan1369 ($13.94 in chips) 
Seat 5: DrLevty ($17.72 in chips) 
Diana4teen: posts small blind $0.05
Acedan1369: posts big blind $0.10
fish72o: sits out 
*** HOLE CARDS ***
DrLevty: raises $0.20 to $0.30
HotMilk2020: calls $0.30
Marocki: folds 
Diana4teen: calls $0.25
Acedan1369: calls $0.20
*** FLOP *** [3d 4c Kh]
Diana4teen: checks 
Acedan1369: checks 
DrLevty: bets $0.38
HotMilk2020: folds 
Diana4teen: calls $0.38
Acedan1369: folds 
*** TURN *** [3d 4c Kh] [Qc]
Diana4teen: checks 
DrLevty: checks 
*** RIVER *** [3d 4c Kh Qc] [2s]
Diana4teen: bets $1.50
DrLevty: folds 
Uncalled bet ($1.50) returned to Diana4teen
Diana4teen collected $1.87 from pot
*** SUMMARY ***
Total pot $1.96 | Rake $0.09 
Board [3d 4c Kh Qc 2s]
Seat 1: HotMilk2020 folded on the Flop
Seat 2: Marocki (button) folded before Flop (didn't bet)
Seat 3: Diana4teen (small blind) collected ($1.87)
Seat 4: Acedan1369 (big blind) folded on the Flop
Seat 5: DrLevty folded on the River



PokerStars Hand #222965822606:  Hold'em No Limit ($0.05/$0.10 USD) - 2021/01/23 14:15:52 ET
Table 'Lutetia III' 6-max Seat #3 is the button
Seat 1: HotMilk2020 ($6.45 in chips) 
Seat 2: Marocki ($10.31 in chips) 
Seat 3: Diana4teen ($10.11 in chips) 
Seat 4: Acedan1369 ($13.64 in chips) 
Seat 5: DrLevty ($17.04 in chips) 
Acedan1369: posts small blind $0.05
DrLevty: posts big blind $0.10
fish72o: sits out 
*** HOLE CARDS ***
HotMilk2020: folds 
Marocki: folds 
Diana4teen: raises $0.40 to $0.50
Acedan1369: folds 
DrLevty: folds 
Uncalled bet ($0.40) returned to Diana4teen
Diana4teen collected $0.25 from pot
Diana4teen: doesn't show hand 
*** SUMMARY ***
Total pot $0.25 | Rake $0 
Seat 1: HotMilk2020 folded before Flop (didn't bet)
Seat 2: Marocki folded before Flop (didn't bet)
Seat 3: Diana4teen (button) collected ($0.25)
Seat 4: Acedan1369 (small blind) folded before Flop
Seat 5: DrLevty (big blind) folded before Flop



PokerStars Hand #222965835411:  Hold'em No Limit ($0.05/$0.10 USD) - 2021/01/23 14:16:08 ET
Table 'Lutetia III' 6-max Seat #4 is the button
Seat 1: HotMilk2020 ($6.45 in chips) 
Seat 2: Marocki ($10.31 in chips) 
Seat 3: Diana4teen ($10.26 in chips) 
Seat 4: Acedan1369 ($13.59 in chips) 
Seat 5: DrLevty ($16.94 in chips) 
Seat 6: fish72o ($10 in chips) 
DrLevty: posts small blind $0.05
fish72o: posts big blind $0.10
*** HOLE CARDS ***
HotMilk2020: folds 
Marocki: folds 
Diana4teen: folds 
Acedan1369: raises $0.15 to $0.25
DrLevty: folds 
fish72o: calls $0.15
*** FLOP *** [9c Qh 7d]
fish72o: checks 
Acedan1369: checks 
*** TURN *** [9c Qh 7d] [Th]
fish72o: checks 
HotMilk2020 leaves the table
Acedan1369: checks 
*** RIVER *** [9c Qh 7d Th] [4s]
maltsevig joins the table at seat #1 
fish72o: checks 
Acedan1369: checks 
*** SHOW DOWN ***
fish72o: shows [6d Ac] (high card Ace)
Acedan1369: shows [3s Ad] (high card Ace)
fish72o collected $0.27 from pot
Acedan1369 collected $0.26 from pot
*** SUMMARY ***
Total pot $0.55 | Rake $0.02 
Board [9c Qh 7d Th 4s]
Seat 1: HotMilk2020 folded before Flop (didn't bet)
Seat 2: Marocki folded before Flop (didn't bet)
Seat 3: Diana4teen folded before Flop (didn't bet)
Seat 4: Acedan1369 (button) showed [3s Ad] and won ($0.26) with high card Ace
Seat 5: DrLevty (small blind) folded before Flop
Seat 6: fish72o (big blind) showed [6d Ac] and won ($0.27) with high card Ace



PokerStars Hand #222965869041:  Hold'em No Limit ($0.05/$0.10 USD) - 2021/01/23 14:16:48 ET
Table 'Lutetia III' 6-max Seat #5 is the button
Seat 1: maltsevig ($10 in chips) 
Seat 2: Marocki ($10.31 in chips) 
Seat 3: Diana4teen ($10.26 in chips) 
Seat 4: Acedan1369 ($13.60 in chips) 
Seat 5: DrLevty ($16.89 in chips) 
Seat 6: fish72o ($10.02 in chips) 
fish72o: posts small blind $0.05
maltsevig: posts big blind $0.10
*** HOLE CARDS ***
Marocki has timed out
Marocki: folds 
Diana4teen: folds 
Acedan1369: folds 
DrLevty: folds 
fish72o: folds 
Uncalled bet ($0.05) returned to maltsevig
maltsevig collected $0.10 from pot
maltsevig: doesn't show hand 
*** SUMMARY ***
Total pot $0.10 | Rake $0 
Seat 1: maltsevig (big blind) collected ($0.10)
Seat 2: Marocki folded before Flop (didn't bet)
Seat 3: Diana4teen folded before Flop (didn't bet)
Seat 4: Acedan1369 folded before Flop (didn't bet)
Seat 5: DrLevty (button) folded before Flop (didn't bet)
Seat 6: fish72o (small blind) folded before Flop



PokerStars Hand #222965885639:  Hold'em No Limit ($0.05/$0.10 USD) - 2021/01/23 14:17:09 ET
Table 'Lutetia III' 6-max Seat #6 is the button
Seat 1: maltsevig ($10.05 in chips) 
Seat 2: Marocki ($10.31 in chips) 
Seat 3: Diana4teen ($10.26 in chips) 
Seat 4: Acedan1369 ($13.60 in chips) 
Seat 5: DrLevty ($16.89 in chips) 
Seat 6: fish72o ($10 in chips) 
maltsevig: posts small blind $0.05
Marocki: posts big blind $0.10
*** HOLE CARDS ***
Diana4teen: calls $0.10
Acedan1369: raises $0.15 to $0.25
DrLevty: folds 
fish72o: folds 
maltsevig: folds 
Marocki: calls $0.15
Diana4teen: calls $0.15
*** FLOP *** [Kh Ah Jd]
Marocki: checks 
Diana4teen: checks 
Acedan1369: bets $0.57
Marocki: folds 
Diana4teen: folds 
Uncalled bet ($0.57) returned to Acedan1369
Acedan1369 collected $0.76 from pot
Acedan1369: doesn't show hand 
*** SUMMARY ***
Total pot $0.80 | Rake $0.04 
Board [Kh Ah Jd]
Seat 1: maltsevig (small blind) folded before Flop
Seat 2: Marocki (big blind) folded on the Flop
Seat 3: Diana4teen folded on the Flop
Seat 4: Acedan1369 collected ($0.76)
Seat 5: DrLevty folded before Flop (didn't bet)
Seat 6: fish72o (button) folded before Flop (didn't bet)



PokerStars Hand #222965934714:  Hold'em No Limit ($0.05/$0.10 USD) - 2021/01/23 14:18:11 ET
Table 'Lutetia III' 6-max Seat #1 is the button
Seat 1: maltsevig ($10 in chips) 
Seat 2: Marocki ($10.06 in chips) 
Seat 3: Diana4teen ($10.01 in chips) 
Seat 4: Acedan1369 ($14.11 in chips) 
Seat 5: DrLevty ($16.89 in chips) 
Seat 6: fish72o ($10 in chips) 
Marocki: posts small blind $0.05
Diana4teen: posts big blind $0.10
*** HOLE CARDS ***
Acedan1369: folds 
DrLevty: raises $0.20 to $0.30
fish72o: folds 
maltsevig: folds 
Marocki: folds 
Diana4teen: calls $0.20
*** FLOP *** [Ks 9s 9h]
Diana4teen: checks 
DrLevty: checks 
*** TURN *** [Ks 9s 9h] [Qh]
Diana4teen: bets $0.50
DrLevty: calls $0.50
*** RIVER *** [Ks 9s 9h Qh] [Th]
Diana4teen: bets $1.20
DrLevty: calls $1.20
*** SHOW DOWN ***
Diana4teen: shows [Ac Td] (two pair, Tens and Nines)
DrLevty: shows [Jd Js] (a straight, Nine to King)
DrLevty collected $3.87 from pot
*** SUMMARY ***
Total pot $4.05 | Rake $0.18 
Board [Ks 9s 9h Qh Th]
Seat 1: maltsevig (button) folded before Flop (didn't bet)
Seat 2: Marocki (small blind) folded before Flop
Seat 3: Diana4teen (big blind) showed [Ac Td] and lost with two pair, Tens and Nines
Seat 4: Acedan1369 folded before Flop (didn't bet)
Seat 5: DrLevty showed [Jd Js] and won ($3.87) with a straight, Nine to King
Seat 6: fish72o folded before Flop (didn't bet)



PokerStars Hand #222965989954:  Hold'em No Limit ($0.05/$0.10 USD) - 2021/01/23 14:19:21 ET
Table 'Lutetia III' 6-max Seat #2 is the button
Seat 1: maltsevig ($10 in chips) 
Seat 2: Marocki ($10.01 in chips) 
Seat 3: Diana4teen ($8.01 in chips) 
Seat 4: Acedan1369 ($14.11 in chips) 
Seat 5: DrLevty ($18.76 in chips) 
Seat 6: fish72o ($10 in chips) 
Diana4teen: posts small blind $0.05
Acedan1369: posts big blind $0.10
*** HOLE CARDS ***
DrLevty: folds 
fish72o: folds 
maltsevig: raises $0.16 to $0.26
Marocki: folds 
Diana4teen: folds 
Acedan1369: folds 
Uncalled bet ($0.16) returned to maltsevig
Diana4teen leaves the table
maltsevig collected $0.25 from pot
maltsevig: doesn't show hand 
*** SUMMARY ***
Total pot $0.25 | Rake $0 
Seat 1: maltsevig collected ($0.25)
Seat 2: Marocki (button) folded before Flop (didn't bet)
Seat 3: Diana4teen (small blind) folded before Flop
Seat 4: Acedan1369 (big blind) folded before Flop
Seat 5: DrLevty folded before Flop (didn't bet)
Seat 6: fish72o folded before Flop (didn't bet)



PokerStars Hand #222966013749:  Hold'em No Limit ($0.05/$0.10 USD) - 2021/01/23 14:19:51 ET
Table 'Lutetia III' 6-max Seat #4 is the button
Seat 1: maltsevig ($10.15 in chips) 
Seat 2: Marocki ($10.01 in chips) 
Seat 4: Acedan1369 ($14.01 in chips) 
Seat 5: DrLevty ($18.76 in chips) 
Seat 6: fish72o ($10 in chips) 
DrLevty: posts small blind $0.05
fish72o: posts big blind $0.10
*** HOLE CARDS ***
sAnt1n135 joins the table at seat #3 
maltsevig: folds 
Marocki: folds 
Acedan1369: folds 
DrLevty: raises $0.20 to $0.30
fish72o: raises $0.60 to $0.90
DrLevty: folds 
Uncalled bet ($0.60) returned to fish72o
fish72o collected $0.60 from pot
fish72o: doesn't show hand 
*** SUMMARY ***
Total pot $0.60 | Rake $0 
Seat 1: maltsevig folded before Flop (didn't bet)
Seat 2: Marocki folded before Flop (didn't bet)
Seat 4: Acedan1369 (button) folded before Flop (didn't bet)
Seat 5: DrLevty (small blind) folded before Flop
Seat 6: fish72o (big blind) collected ($0.60)



PokerStars Hand #222966041188:  Hold'em No Limit ($0.05/$0.10 USD) - 2021/01/23 14:20:26 ET
Table 'Lutetia III' 6-max Seat #5 is the button
Seat 1: maltsevig ($10.15 in chips) 
Seat 2: Marocki ($10.01 in chips) 
Seat 4: Acedan1369 ($14.01 in chips) 
Seat 5: DrLevty ($18.46 in chips) 
Seat 6: fish72o ($10.30 in chips) 
fish72o: posts small blind $0.05
maltsevig: posts big blind $0.10
sAnt1n135: sits out 
*** HOLE CARDS ***
Marocki: folds 
Acedan1369: raises $0.15 to $0.25
DrLevty: folds 
fish72o: calls $0.20
maltsevig: folds 
*** FLOP *** [7d Ad Ks]
fish72o: checks 
Acedan1369: bets $0.43
fish72o: folds 
Uncalled bet ($0.43) returned to Acedan1369
Acedan1369 collected $0.57 from pot
Acedan1369: doesn't show hand 
*** SUMMARY ***
Total pot $0.60 | Rake $0.03 
Board [7d Ad Ks]
Seat 1: maltsevig (big blind) folded before Flop
Seat 2: Marocki folded before Flop (didn't bet)
Seat 4: Acedan1369 collected ($0.57)
Seat 5: DrLevty (button) folded before Flop (didn't bet)
Seat 6: fish72o (small blind) folded on the Flop



PokerStars Hand #222966068094:  Hold'em No Limit ($0.05/$0.10 USD) - 2021/01/23 14:21:01 ET
Table 'Lutetia III' 6-max Seat #6 is the button
Seat 1: maltsevig ($10.05 in chips) 
Seat 2: Marocki ($10.01 in chips) 
Seat 4: Acedan1369 ($14.33 in chips) 
Seat 5: DrLevty ($18.46 in chips) 
Seat 6: fish72o ($10.05 in chips) 
maltsevig: posts small blind $0.05
Marocki: posts big blind $0.10
sAnt1n135: sits out 
*** HOLE CARDS ***
Acedan1369: folds 
DrLevty: raises $0.20 to $0.30
fish72o: folds 
maltsevig: folds 
Marocki: folds 
Uncalled bet ($0.20) returned to DrLevty
DrLevty collected $0.25 from pot
DrLevty: doesn't show hand 
*** SUMMARY ***
Total pot $0.25 | Rake $0 
Seat 1: maltsevig (small blind) folded before Flop
Seat 2: Marocki (big blind) folded before Flop
Seat 4: Acedan1369 folded before Flop (didn't bet)
Seat 5: DrLevty collected ($0.25)
Seat 6: fish72o (button) folded before Flop (didn't bet)



PokerStars Hand #222966091054:  Hold'em No Limit ($0.05/$0.10 USD) - 2021/01/23 14:21:26 ET
Table 'Lutetia III' 6-max Seat #1 is the button
Seat 1: maltsevig ($10 in chips) 
Seat 2: Marocki ($9.91 in chips) 
Seat 3: sAnt1n135 ($10 in chips) 
Seat 4: Acedan1369 ($14.33 in chips) 
Seat 5: DrLevty ($18.61 in chips) 
Seat 6: fish72o ($10.05 in chips) 
Marocki: posts small blind $0.05
sAnt1n135: posts big blind $0.10
*** HOLE CARDS ***
Acedan1369 has timed out
Acedan1369: folds 
DrLevty: folds 
fish72o: raises $0.15 to $0.25
maltsevig: raises $0.65 to $0.90
Marocki: folds 
sAnt1n135: folds 
fish72o: folds 
Uncalled bet ($0.65) returned to maltsevig
maltsevig collected $0.65 from pot
maltsevig: doesn't show hand 
*** SUMMARY ***
Total pot $0.65 | Rake $0 
Seat 1: maltsevig (button) collected ($0.65)
Seat 2: Marocki (small blind) folded before Flop
Seat 3: sAnt1n135 (big blind) folded before Flop
Seat 4: Acedan1369 folded before Flop (didn't bet)
Seat 5: DrLevty folded before Flop (didn't bet)
Seat 6: fish72o folded before Flop



PokerStars Hand #222966120179:  Hold'em No Limit ($0.05/$0.10 USD) - 2021/01/23 14:22:03 ET
Table 'Lutetia III' 6-max Seat #2 is the button
Seat 1: maltsevig ($10.40 in chips) 
Seat 2: Marocki ($9.86 in chips) 
Seat 3: sAnt1n135 ($9.90 in chips) 
Seat 4: Acedan1369 ($14.33 in chips) 
Seat 5: DrLevty ($18.61 in chips) 
Seat 6: fish72o ($10 in chips) 
sAnt1n135: posts small blind $0.05
Acedan1369: posts big blind $0.10
*** HOLE CARDS ***
DrLevty: raises $0.20 to $0.30
fish72o: folds 
maltsevig: folds 
Marocki: folds 
sAnt1n135: calls $0.25
Acedan1369: folds 
*** FLOP *** [Ts Qd 3h]
sAnt1n135: checks 
DrLevty: bets $0.22
sAnt1n135: folds 
Uncalled bet ($0.22) returned to DrLevty
DrLevty collected $0.67 from pot
DrLevty: doesn't show hand 
*** SUMMARY ***
Total pot $0.70 | Rake $0.03 
Board [Ts Qd 3h]
Seat 1: maltsevig folded before Flop (didn't bet)
Seat 2: Marocki (button) folded before Flop (didn't bet)
Seat 3: sAnt1n135 (small blind) folded on the Flop
Seat 4: Acedan1369 (big blind) folded before Flop
Seat 5: DrLevty collected ($0.67)
Seat 6: fish72o folded before Flop (didn't bet)



PokerStars Hand #222966158557:  Hold'em No Limit ($0.05/$0.10 USD) - 2021/01/23 14:22:52 ET
Table 'Lutetia III' 6-max Seat #3 is the button
Seat 1: maltsevig ($10.40 in chips) 
Seat 2: Marocki ($9.86 in chips) 
Seat 3: sAnt1n135 ($9.60 in chips) 
Seat 4: Acedan1369 ($14.23 in chips) 
Seat 5: DrLevty ($18.98 in chips) 
Seat 6: fish72o ($10 in chips) 
Acedan1369: posts small blind $0.05
DrLevty: posts big blind $0.10
*** HOLE CARDS ***
fish72o: folds 
maltsevig: folds 
Marocki: raises $0.20 to $0.30
sAnt1n135: raises $0.60 to $0.90
Acedan1369: folds 
DrLevty: folds 
Marocki: calls $0.60
*** FLOP *** [6s 5d 6c]
Marocki: checks 
sAnt1n135: bets $0.80
Marocki: calls $0.80
*** TURN *** [6s 5d 6c] [Ah]
Marocki: checks 
sAnt1n135: bets $2
Marocki: calls $2
*** RIVER *** [6s 5d 6c Ah] [4c]
Marocki: checks 
sAnt1n135: checks 
*** SHOW DOWN ***
Marocki: shows [Ac Kc] (two pair, Aces and Sixes)
sAnt1n135: mucks hand 
Marocki collected $7.21 from pot
*** SUMMARY ***
Total pot $7.55 | Rake $0.34 
Board [6s 5d 6c Ah 4c]
Seat 1: maltsevig folded before Flop (didn't bet)
Seat 2: Marocki showed [Ac Kc] and won ($7.21) with two pair, Aces and Sixes
Seat 3: sAnt1n135 (button) mucked
Seat 4: Acedan1369 (small blind) folded before Flop
Seat 5: DrLevty (big blind) folded before Flop
Seat 6: fish72o folded before Flop (didn't bet)



PokerStars Hand #222966218623:  Hold'em No Limit ($0.05/$0.10 USD) - 2021/01/23 14:24:09 ET
Table 'Lutetia III' 6-max Seat #4 is the button
Seat 1: maltsevig ($10.40 in chips) 
Seat 2: Marocki ($13.37 in chips) 
Seat 3: sAnt1n135 ($5.90 in chips) 
Seat 4: Acedan1369 ($14.18 in chips) 
Seat 5: DrLevty ($18.88 in chips) 
Seat 6: fish72o ($10 in chips) 
DrLevty: posts small blind $0.05
fish72o: posts big blind $0.10
*** HOLE CARDS ***
maltsevig: folds 
Marocki: folds 
sAnt1n135: folds 
Acedan1369: folds 
DrLevty: raises $0.20 to $0.30
fish72o: folds 
Uncalled bet ($0.20) returned to DrLevty
DrLevty collected $0.20 from pot
DrLevty: doesn't show hand 
*** SUMMARY ***
Total pot $0.20 | Rake $0 
Seat 1: maltsevig folded before Flop (didn't bet)
Seat 2: Marocki folded before Flop (didn't bet)
Seat 3: sAnt1n135 folded before Flop (didn't bet)
Seat 4: Acedan1369 (button) folded before Flop (didn't bet)
Seat 5: DrLevty (small blind) collected ($0.20)
Seat 6: fish72o (big blind) folded before Flop



PokerStars Hand #222966233928:  Hold'em No Limit ($0.05/$0.10 USD) - 2021/01/23 14:24:28 ET
Table 'Lutetia III' 6-max Seat #5 is the button
Seat 1: maltsevig ($10.40 in chips) 
Seat 2: Marocki ($13.37 in chips) 
Seat 3: sAnt1n135 ($5.90 in chips) 
Seat 4: Acedan1369 ($14.18 in chips) 
Seat 5: DrLevty ($18.98 in chips) 
Seat 6: fish72o ($10 in chips) 
fish72o: posts small blind $0.05
maltsevig: posts big blind $0.10
*** HOLE CARDS ***
Marocki: folds 
sAnt1n135: raises $0.20 to $0.30
Acedan1369: folds 
DrLevty: folds 
fish72o: folds 
maltsevig: folds 
Uncalled bet ($0.20) returned to sAnt1n135
sAnt1n135 collected $0.25 from pot
sAnt1n135: doesn't show hand 
*** SUMMARY ***
Total pot $0.25 | Rake $0 
Seat 1: maltsevig (big blind) folded before Flop
Seat 2: Marocki folded before Flop (didn't bet)
Seat 3: sAnt1n135 collected ($0.25)
Seat 4: Acedan1369 folded before Flop (didn't bet)
Seat 5: DrLevty (button) folded before Flop (didn't bet)
Seat 6: fish72o (small blind) folded before Flop



PokerStars Hand #222966246855:  Hold'em No Limit ($0.05/$0.10 USD) - 2021/01/23 14:24:45 ET
Table 'Lutetia III' 6-max Seat #6 is the button
Seat 1: maltsevig ($10.30 in chips) 
Seat 2: Marocki ($13.37 in chips) 
Seat 3: sAnt1n135 ($6.05 in chips) 
Seat 4: Acedan1369 ($14.18 in chips) 
Seat 5: DrLevty ($18.98 in chips) 
Seat 6: fish72o ($10 in chips) 
maltsevig: posts small blind $0.05
Marocki: posts big blind $0.10
*** HOLE CARDS ***
sAnt1n135: folds 
Acedan1369: folds 
DrLevty: folds 
fish72o: folds 
maltsevig: folds 
Uncalled bet ($0.05) returned to Marocki
Marocki collected $0.10 from pot
*** SUMMARY ***
Total pot $0.10 | Rake $0 
Seat 1: maltsevig (small blind) folded before Flop
Seat 2: Marocki (big blind) collected ($0.10)
Seat 3: sAnt1n135 folded before Flop (didn't bet)
Seat 4: Acedan1369 folded before Flop (didn't bet)
Seat 5: DrLevty folded before Flop (didn't bet)
Seat 6: fish72o (button) folded before Flop (didn't bet)



PokerStars Hand #222966253303:  Hold'em No Limit ($0.05/$0.10 USD) - 2021/01/23 14:24:53 ET
Table 'Lutetia III' 6-max Seat #1 is the button
Seat 1: maltsevig ($10.25 in chips) 
Seat 2: Marocki ($13.42 in chips) 
Seat 3: sAnt1n135 ($6.05 in chips) 
Seat 4: Acedan1369 ($14.18 in chips) 
Seat 5: DrLevty ($18.98 in chips) 
Seat 6: fish72o ($10 in chips) 
Marocki: posts small blind $0.05
sAnt1n135: posts big blind $0.10
*** HOLE CARDS ***
Acedan1369: folds 
DrLevty: folds 
fish72o: folds 
maltsevig: raises $0.10 to $0.20
Marocki: folds 
sAnt1n135: raises $0.50 to $0.70
maltsevig: folds 
Uncalled bet ($0.50) returned to sAnt1n135
sAnt1n135 collected $0.45 from pot
sAnt1n135: doesn't show hand 
*** SUMMARY ***
Total pot $0.45 | Rake $0 
Seat 1: maltsevig (button) folded before Flop
Seat 2: Marocki (small blind) folded before Flop
Seat 3: sAnt1n135 (big blind) collected ($0.45)
Seat 4: Acedan1369 folded before Flop (didn't bet)
Seat 5: DrLevty folded before Flop (didn't bet)
Seat 6: fish72o folded before Flop (didn't bet)



PokerStars Hand #222966274200:  Hold'em No Limit ($0.05/$0.10 USD) - 2021/01/23 14:25:20 ET
Table 'Lutetia III' 6-max Seat #2 is the button
Seat 1: maltsevig ($10.05 in chips) 
Seat 2: Marocki ($13.37 in chips) 
Seat 3: sAnt1n135 ($6.30 in chips) 
Seat 4: Acedan1369 ($14.18 in chips) 
Seat 5: DrLevty ($18.98 in chips) 
Seat 6: fish72o ($10 in chips) 
sAnt1n135: posts small blind $0.05
Acedan1369: posts big blind $0.10
*** HOLE CARDS ***
DrLevty: folds 
fish72o: folds 
maltsevig: raises $0.16 to $0.26
Marocki has timed out
Marocki: folds 
sAnt1n135: folds 
Acedan1369: folds 
Uncalled bet ($0.16) returned to maltsevig
maltsevig collected $0.25 from pot
maltsevig: doesn't show hand 
*** SUMMARY ***
Total pot $0.25 | Rake $0 
Seat 1: maltsevig collected ($0.25)
Seat 2: Marocki (button) folded before Flop (didn't bet)
Seat 3: sAnt1n135 (small blind) folded before Flop
Seat 4: Acedan1369 (big blind) folded before Flop
Seat 5: DrLevty folded before Flop (didn't bet)
Seat 6: fish72o folded before Flop (didn't bet)



PokerStars Hand #222966297034:  Hold'em No Limit ($0.05/$0.10 USD) - 2021/01/23 14:25:49 ET
Table 'Lutetia III' 6-max Seat #3 is the button
Seat 1: maltsevig ($10.20 in chips) 
Seat 3: sAnt1n135 ($6.25 in chips) 
Seat 4: Acedan1369 ($14.08 in chips) 
Seat 5: DrLevty ($18.98 in chips) 
Seat 6: fish72o ($10 in chips) 
Acedan1369: posts small blind $0.05
DrLevty: posts big blind $0.10
*** HOLE CARDS ***
fish72o: folds 
maltsevig: folds 
sAnt1n135: raises $0.13 to $0.23
Acedan1369: folds 
DrLevty: folds 
Uncalled bet ($0.13) returned to sAnt1n135
sAnt1n135 collected $0.25 from pot
sAnt1n135: doesn't show hand 
*** SUMMARY ***
Total pot $0.25 | Rake $0 
Seat 1: maltsevig folded before Flop (didn't bet)
Seat 3: sAnt1n135 (button) collected ($0.25)
Seat 4: Acedan1369 (small blind) folded before Flop
Seat 5: DrLevty (big blind) folded before Flop
Seat 6: fish72o folded before Flop (didn't bet)



PokerStars Hand #222966321100:  Hold'em No Limit ($0.05/$0.10 USD) - 2021/01/23 14:26:20 ET
Table 'Lutetia III' 6-max Seat #4 is the button
Seat 1: maltsevig ($10.20 in chips) 
Seat 2: Marocki ($13.37 in chips) 
Seat 3: sAnt1n135 ($6.40 in chips) 
Seat 4: Acedan1369 ($14.03 in chips) 
Seat 5: DrLevty ($18.88 in chips) 
Seat 6: fish72o ($10 in chips) 
DrLevty: posts small blind $0.05
fish72o: posts big blind $0.10
*** HOLE CARDS ***
maltsevig: folds 
Marocki: folds 
sAnt1n135: folds 
Acedan1369: folds 
DrLevty: folds 
Uncalled bet ($0.05) returned to fish72o
fish72o collected $0.10 from pot
fish72o: doesn't show hand 
*** SUMMARY ***
Total pot $0.10 | Rake $0 
Seat 1: maltsevig folded before Flop (didn't bet)
Seat 2: Marocki folded before Flop (didn't bet)
Seat 3: sAnt1n135 folded before Flop (didn't bet)
Seat 4: Acedan1369 (button) folded before Flop (didn't bet)
Seat 5: DrLevty (small blind) folded before Flop
Seat 6: fish72o (big blind) collected ($0.10)



PokerStars Hand #222966333999:  Hold'em No Limit ($0.05/$0.10 USD) - 2021/01/23 14:26:37 ET
Table 'Lutetia III' 6-max Seat #5 is the button
Seat 1: maltsevig ($10.20 in chips) 
Seat 2: Marocki ($13.37 in chips) 
Seat 3: sAnt1n135 ($6.40 in chips) 
Seat 4: Acedan1369 ($14.03 in chips) 
Seat 5: DrLevty ($18.83 in chips) 
Seat 6: fish72o ($10.05 in chips) 
fish72o: posts small blind $0.05
maltsevig: posts big blind $0.10
*** HOLE CARDS ***
Marocki: folds 
sAnt1n135: folds 
Acedan1369: folds 
DrLevty: folds 
fish72o: raises $0.15 to $0.25
maltsevig: folds 
Uncalled bet ($0.15) returned to fish72o
fish72o collected $0.20 from pot
fish72o: doesn't show hand 
*** SUMMARY ***
Total pot $0.20 | Rake $0 
Seat 1: maltsevig (big blind) folded before Flop
Seat 2: Marocki folded before Flop (didn't bet)
Seat 3: sAnt1n135 folded before Flop (didn't bet)
Seat 4: Acedan1369 folded before Flop (didn't bet)
Seat 5: DrLevty (button) folded before Flop (didn't bet)
Seat 6: fish72o (small blind) collected ($0.20)



PokerStars Hand #222966356023:  Hold'em No Limit ($0.05/$0.10 USD) - 2021/01/23 14:27:06 ET
Table 'Lutetia III' 6-max Seat #6 is the button
Seat 1: maltsevig ($10.10 in chips) 
Seat 2: Marocki ($13.37 in chips) 
Seat 3: sAnt1n135 ($6.40 in chips) 
Seat 4: Acedan1369 ($14.03 in chips) 
Seat 5: DrLevty ($18.83 in chips) 
Seat 6: fish72o ($10.15 in chips) 
maltsevig: posts small blind $0.05
Marocki: posts big blind $0.10
*** HOLE CARDS ***
sAnt1n135: raises $0.20 to $0.30
Acedan1369: raises $0.55 to $0.85
DrLevty: folds 
fish72o: folds 
maltsevig: folds 
Marocki: folds 
sAnt1n135: calls $0.55
*** FLOP *** [7h Ac Qd]
sAnt1n135: checks 
Acedan1369: bets $0.80
sAnt1n135: calls $0.80
*** TURN *** [7h Ac Qd] [3h]
sAnt1n135: checks 
Acedan1369: bets $2
sAnt1n135: raises $2.75 to $4.75 and is all-in
Acedan1369: calls $2.75
*** RIVER *** [7h Ac Qd 3h] [4d]
*** SHOW DOWN ***
sAnt1n135: shows [Ad Kc] (a pair of Aces)
Acedan1369: shows [Js As] (a pair of Aces - lower kicker)
sAnt1n135 collected $12.37 from pot
*** SUMMARY ***
Total pot $12.95 | Rake $0.58 
Board [7h Ac Qd 3h 4d]
Seat 1: maltsevig (small blind) folded before Flop
Seat 2: Marocki (big blind) folded before Flop
Seat 3: sAnt1n135 showed [Ad Kc] and won ($12.37) with a pair of Aces
Seat 4: Acedan1369 showed [Js As] and lost with a pair of Aces
Seat 5: DrLevty folded before Flop (didn't bet)
Seat 6: fish72o (button) folded before Flop (didn't bet)



PokerStars Hand #222966419119:  Hold'em No Limit ($0.05/$0.10 USD) - 2021/01/23 14:28:20 ET
Table 'Lutetia III' 6-max Seat #1 is the button
Seat 1: maltsevig ($10.05 in chips) 
Seat 2: Marocki ($13.27 in chips) 
Seat 3: sAnt1n135 ($12.37 in chips) 
Seat 4: Acedan1369 ($10 in chips) 
Seat 5: DrLevty ($18.83 in chips) 
Seat 6: fish72o ($10.15 in chips) 
Marocki: posts small blind $0.05
sAnt1n135: posts big blind $0.10
*** HOLE CARDS ***
Acedan1369: folds 
DrLevty: folds 
fish72o: raises $0.15 to $0.25
maltsevig: folds 
Marocki: folds 
sAnt1n135: folds 
Uncalled bet ($0.15) returned to fish72o
fish72o collected $0.25 from pot
fish72o: doesn't show hand 
*** SUMMARY ***
Total pot $0.25 | Rake $0 
Seat 1: maltsevig (button) folded before Flop (didn't bet)
Seat 2: Marocki (small blind) folded before Flop
Seat 3: sAnt1n135 (big blind) folded before Flop
Seat 4: Acedan1369 folded before Flop (didn't bet)
Seat 5: DrLevty folded before Flop (didn't bet)
Seat 6: fish72o collected ($0.25)



PokerStars Hand #222966435303:  Hold'em No Limit ($0.05/$0.10 USD) - 2021/01/23 14:28:41 ET
Table 'Lutetia III' 6-max Seat #2 is the button
Seat 1: maltsevig ($10.05 in chips) 
Seat 2: Marocki ($13.22 in chips) 
Seat 3: sAnt1n135 ($12.27 in chips) 
Seat 4: Acedan1369 ($10 in chips) 
Seat 5: DrLevty ($18.83 in chips) 
Seat 6: fish72o ($10.30 in chips) 
sAnt1n135: posts small blind $0.05
Acedan1369: posts big blind $0.10
*** HOLE CARDS ***
DrLevty: raises $0.20 to $0.30
fish72o: folds 
maltsevig: folds 
Marocki: folds 
sAnt1n135: folds 
Acedan1369: folds 
Uncalled bet ($0.20) returned to DrLevty
DrLevty collected $0.25 from pot
DrLevty: doesn't show hand 
*** SUMMARY ***
Total pot $0.25 | Rake $0 
Seat 1: maltsevig folded before Flop (didn't bet)
Seat 2: Marocki (button) folded before Flop (didn't bet)
Seat 3: sAnt1n135 (small blind) folded before Flop
Seat 4: Acedan1369 (big blind) folded before Flop
Seat 5: DrLevty collected ($0.25)
Seat 6: fish72o folded before Flop (didn't bet)



PokerStars Hand #222966452387:  Hold'em No Limit ($0.05/$0.10 USD) - 2021/01/23 14:29:03 ET
Table 'Lutetia III' 6-max Seat #3 is the button
Seat 1: maltsevig ($10.05 in chips) 
Seat 2: Marocki ($13.22 in chips) 
Seat 3: sAnt1n135 ($12.22 in chips) 
Seat 4: Acedan1369 ($10 in chips) 
Seat 5: DrLevty ($18.98 in chips) 
Seat 6: fish72o ($10.30 in chips) 
Acedan1369: posts small blind $0.05
DrLevty: posts big blind $0.10
*** HOLE CARDS ***
fish72o: folds 
maltsevig: folds 
Marocki: folds 
sAnt1n135: folds 
Acedan1369: folds 
Uncalled bet ($0.05) returned to DrLevty
DrLevty collected $0.10 from pot
DrLevty: doesn't show hand 
*** SUMMARY ***
Total pot $0.10 | Rake $0 
Seat 1: maltsevig folded before Flop (didn't bet)
Seat 2: Marocki folded before Flop (didn't bet)
Seat 3: sAnt1n135 (button) folded before Flop (didn't bet)
Seat 4: Acedan1369 (small blind) folded before Flop
Seat 5: DrLevty (big blind) collected ($0.10)
Seat 6: fish72o folded before Flop (didn't bet)



PokerStars Hand #222966464890:  Hold'em No Limit ($0.05/$0.10 USD) - 2021/01/23 14:29:19 ET
Table 'Lutetia III' 6-max Seat #4 is the button
Seat 1: maltsevig ($10.05 in chips) 
Seat 2: Marocki ($13.22 in chips) 
Seat 3: sAnt1n135 ($12.22 in chips) 
Seat 4: Acedan1369 ($10 in chips) 
Seat 5: DrLevty ($19.03 in chips) 
Seat 6: fish72o ($10.30 in chips) 
DrLevty: posts small blind $0.05
fish72o: posts big blind $0.10
*** HOLE CARDS ***
maltsevig: folds 
Marocki: folds 
sAnt1n135: folds 
Acedan1369: folds 
DrLevty: raises $0.20 to $0.30
fish72o: calls $0.20
*** FLOP *** [7s 2s Ts]
DrLevty: bets $0.19
fish72o: calls $0.19
*** TURN *** [7s 2s Ts] [Tc]
DrLevty: bets $0.31
fish72o: calls $0.31
*** RIVER *** [7s 2s Ts Tc] [3s]
DrLevty: bets $1.15
fish72o: calls $1.15
*** SHOW DOWN ***
DrLevty: shows [2h As] (a flush, Ace high)
fish72o: mucks hand 
DrLevty collected $3.72 from pot
*** SUMMARY ***
Total pot $3.90 | Rake $0.18 
Board [7s 2s Ts Tc 3s]
Seat 1: maltsevig folded before Flop (didn't bet)
Seat 2: Marocki folded before Flop (didn't bet)
Seat 3: sAnt1n135 folded before Flop (didn't bet)
Seat 4: Acedan1369 (button) folded before Flop (didn't bet)
Seat 5: DrLevty (small blind) showed [2h As] and won ($3.72) with a flush, Ace high
Seat 6: fish72o (big blind) mucked



PokerStars Hand #222966507604:  Hold'em No Limit ($0.05/$0.10 USD) - 2021/01/23 14:30:03 ET
Table 'Lutetia III' 6-max Seat #5 is the button
Seat 1: maltsevig ($10.05 in chips) 
Seat 2: Marocki ($13.22 in chips) 
Seat 3: sAnt1n135 ($12.22 in chips) 
Seat 4: Acedan1369 ($10 in chips) 
Seat 5: DrLevty ($20.80 in chips) 
Seat 6: fish72o ($10 in chips) 
fish72o: posts small blind $0.05
maltsevig: posts big blind $0.10
*** HOLE CARDS ***
Marocki: folds 
sAnt1n135: folds 
Acedan1369: folds 
DrLevty: folds 
fish72o: raises $0.15 to $0.25
maltsevig: raises $0.65 to $0.90
fish72o: folds 
Uncalled bet ($0.65) returned to maltsevig
maltsevig collected $0.50 from pot
maltsevig: doesn't show hand 
*** SUMMARY ***
Total pot $0.50 | Rake $0 
Seat 1: maltsevig (big blind) collected ($0.50)
Seat 2: Marocki folded before Flop (didn't bet)
Seat 3: sAnt1n135 folded before Flop (didn't bet)
Seat 4: Acedan1369 folded before Flop (didn't bet)
Seat 5: DrLevty (button) folded before Flop (didn't bet)
Seat 6: fish72o (small blind) folded before Flop



PokerStars Hand #222966523769:  Hold'em No Limit ($0.05/$0.10 USD) - 2021/01/23 14:30:23 ET
Table 'Lutetia III' 6-max Seat #6 is the button
Seat 1: maltsevig ($10.30 in chips) 
Seat 2: Marocki ($13.22 in chips) 
Seat 3: sAnt1n135 ($12.22 in chips) 
Seat 4: Acedan1369 ($10 in chips) 
Seat 5: DrLevty ($20.80 in chips) 
Seat 6: fish72o ($10 in chips) 
maltsevig: posts small blind $0.05
Marocki: posts big blind $0.10
*** HOLE CARDS ***
sAnt1n135: folds 
Acedan1369: folds 
DrLevty: folds 
fish72o: folds 
maltsevig: raises $0.13 to $0.23
Marocki: folds 
Uncalled bet ($0.13) returned to maltsevig
maltsevig collected $0.20 from pot
maltsevig: doesn't show hand 
*** SUMMARY ***
Total pot $0.20 | Rake $0 
Seat 1: maltsevig (small blind) collected ($0.20)
Seat 2: Marocki (big blind) folded before Flop
Seat 3: sAnt1n135 folded before Flop (didn't bet)
Seat 4: Acedan1369 folded before Flop (didn't bet)
Seat 5: DrLevty folded before Flop (didn't bet)
Seat 6: fish72o (button) folded before Flop (didn't bet)



PokerStars Hand #222966549515:  Hold'em No Limit ($0.05/$0.10 USD) - 2021/01/23 14:30:56 ET
Table 'Lutetia III' 6-max Seat #1 is the button
Seat 1: maltsevig ($10.40 in chips) 
Seat 2: Marocki ($13.12 in chips) 
Seat 3: sAnt1n135 ($12.22 in chips) 
Seat 4: Acedan1369 ($10 in chips) 
Seat 5: DrLevty ($20.80 in chips) 
Seat 6: fish72o ($10 in chips) 
Marocki: posts small blind $0.05
sAnt1n135: posts big blind $0.10
*** HOLE CARDS ***
Acedan1369: folds 
DrLevty: folds 
fish72o: folds 
maltsevig: folds 
Marocki: calls $0.05
sAnt1n135: checks 
*** FLOP *** [6c 4d 5c]
Marocki: checks 
sAnt1n135: checks 
*** TURN *** [6c 4d 5c] [Jc]
Marocki: checks 
sAnt1n135: checks 
*** RIVER *** [6c 4d 5c Jc] [5d]
Marocki: bets $0.10
sAnt1n135: folds 
Uncalled bet ($0.10) returned to Marocki
Marocki collected $0.19 from pot
*** SUMMARY ***
Total pot $0.20 | Rake $0.01 
Board [6c 4d 5c Jc 5d]
Seat 1: maltsevig (button) folded before Flop (didn't bet)
Seat 2: Marocki (small blind) collected ($0.19)
Seat 3: sAnt1n135 (big blind) folded on the River
Seat 4: Acedan1369 folded before Flop (didn't bet)
Seat 5: DrLevty folded before Flop (didn't bet)
Seat 6: fish72o folded before Flop (didn't bet)



PokerStars Hand #222966588773:  Hold'em No Limit ($0.05/$0.10 USD) - 2021/01/23 14:31:46 ET
Table 'Lutetia III' 6-max Seat #2 is the button
Seat 1: maltsevig ($10.40 in chips) 
Seat 2: Marocki ($13.21 in chips) 
Seat 3: sAnt1n135 ($12.12 in chips) 
Seat 4: Acedan1369 ($10 in chips) 
Seat 5: DrLevty ($20.80 in chips) 
Seat 6: fish72o ($10 in chips) 
sAnt1n135: posts small blind $0.05
Acedan1369: posts big blind $0.10
*** HOLE CARDS ***
DrLevty: folds 
fish72o: folds 
maltsevig: raises $0.16 to $0.26
Marocki: folds 
sAnt1n135: folds 
Acedan1369: calls $0.16
*** FLOP *** [3s 6c Td]
Acedan1369: checks 
maltsevig: bets $0.35
Acedan1369: calls $0.35
*** TURN *** [3s 6c Td] [7c]
Acedan1369: checks 
maltsevig: checks 
*** RIVER *** [3s 6c Td 7c] [Jd]
Acedan1369: bets $0.91
maltsevig: folds 
Uncalled bet ($0.91) returned to Acedan1369
Acedan1369 collected $1.21 from pot
Acedan1369: doesn't show hand 
*** SUMMARY ***
Total pot $1.27 | Rake $0.06 
Board [3s 6c Td 7c Jd]
Seat 1: maltsevig folded on the River
Seat 2: Marocki (button) folded before Flop (didn't bet)
Seat 3: sAnt1n135 (small blind) folded before Flop
Seat 4: Acedan1369 (big blind) collected ($1.21)
Seat 5: DrLevty folded before Flop (didn't bet)
Seat 6: fish72o folded before Flop (didn't bet)



PokerStars Hand #222966629410:  Hold'em No Limit ($0.05/$0.10 USD) - 2021/01/23 14:32:38 ET
Table 'Lutetia III' 6-max Seat #3 is the button
Seat 1: maltsevig ($10 in chips) 
Seat 2: Marocki ($13.21 in chips) 
Seat 3: sAnt1n135 ($12.07 in chips) 
Seat 4: Acedan1369 ($10.60 in chips) 
Seat 6: fish72o ($10 in chips) 
Acedan1369: posts small blind $0.05
DrLevty: is sitting out 
fish72o: posts big blind $0.10
*** HOLE CARDS ***
maltsevig: folds 
Marocki: folds 
sAnt1n135: folds 
Acedan1369: raises $0.15 to $0.25
fish72o: raises $0.50 to $0.75
Acedan1369: calls $0.50
*** FLOP *** [Qc 2s Jd]
Acedan1369: checks 
fish72o: checks 
*** TURN *** [Qc 2s Jd] [4s]
DrLevty leaves the table
Acedan1369: bets $1.07
fish72o: calls $1.07
*** RIVER *** [Qc 2s Jd 4s] [3s]
Acedan1369: bets $2.61
schwalbeunited joins the table at seat #5 
fish72o: folds 
Uncalled bet ($2.61) returned to Acedan1369
Acedan1369 collected $3.48 from pot
Acedan1369: doesn't show hand 
*** SUMMARY ***
Total pot $3.64 | Rake $0.16 
Board [Qc 2s Jd 4s 3s]
Seat 1: maltsevig folded before Flop (didn't bet)
Seat 2: Marocki folded before Flop (didn't bet)
Seat 3: sAnt1n135 (button) folded before Flop (didn't bet)
Seat 4: Acedan1369 (small blind) collected ($3.48)
Seat 6: fish72o (big blind) folded on the River



PokerStars Hand #222961815141:  Hold'em No Limit ($0.05/$0.10 USD) - 2021/01/23 12:42:28 ET
Table 'Lutetia III' 6-max Seat #1 is the button
Seat 1: HotMilk2020 ($5.79 in chips) 
Seat 2: LocalFixer ($10.49 in chips) 
Seat 3: Dugipokers ($20.85 in chips) 
Seat 4: KiraLasVegas ($10.90 in chips) 
Seat 5: Kobert72 ($16.51 in chips) 
Seat 6: diana024 ($5 in chips) 
LocalFixer: posts small blind $0.05
Dugipokers: posts big blind $0.10
*** HOLE CARDS ***
KiraLasVegas: folds 
Kobert72: folds 
KiraLasVegas leaves the table
diana024: folds 
HotMilk2020: folds 
LocalFixer: folds 
Uncalled bet ($0.05) returned to Dugipokers
Dugipokers collected $0.10 from pot
Dugipokers: doesn't show hand 
*** SUMMARY ***
Total pot $0.10 | Rake $0 
Seat 1: HotMilk2020 (button) folded before Flop (didn't bet)
Seat 2: LocalFixer (small blind) folded before Flop
Seat 3: Dugipokers (big blind) collected ($0.10)
Seat 4: KiraLasVegas folded before Flop (didn't bet)
Seat 5: Kobert72 folded before Flop (didn't bet)
Seat 6: diana024 folded before Flop (didn't bet)



PokerStars Hand #222961828427:  Hold'em No Limit ($0.05/$0.10 USD) - 2021/01/23 12:42:48 ET
Table 'Lutetia III' 6-max Seat #2 is the button
Seat 1: HotMilk2020 ($5.79 in chips) 
Seat 2: LocalFixer ($10.44 in chips) 
Seat 3: Dugipokers ($20.90 in chips) 
Seat 5: Kobert72 ($16.51 in chips) 
Seat 6: diana024 ($5 in chips) 
Dugipokers: posts small blind $0.05
Kobert72: posts big blind $0.10
*** HOLE CARDS ***
Kimi1892 joins the table at seat #4 
diana024: raises $0.50 to $0.60
HotMilk2020: calls $0.60
LocalFixer: folds 
Dugipokers: folds 
Kobert72: folds 
*** FLOP *** [5c Jc Qh]
diana024: bets $0.77
HotMilk2020: calls $0.77
*** TURN *** [5c Jc Qh] [6s]
diana024: bets $1.66
HotMilk2020: raises $1.66 to $3.32
diana024: calls $1.66
*** RIVER *** [5c Jc Qh 6s] [4d]
diana024: checks 
HotMilk2020: bets $1.10 and is all-in
diana024: calls $0.31 and is all-in
Uncalled bet ($0.79) returned to HotMilk2020
*** SHOW DOWN ***
HotMilk2020: shows [Qc Jd] (two pair, Queens and Jacks)
diana024: shows [Td Ac] (high card Ace)
HotMilk2020 collected $9.69 from pot
*** SUMMARY ***
Total pot $10.15 | Rake $0.46 
Board [5c Jc Qh 6s 4d]
Seat 1: HotMilk2020 showed [Qc Jd] and won ($9.69) with two pair, Queens and Jacks
Seat 2: LocalFixer (button) folded before Flop (didn't bet)
Seat 3: Dugipokers (small blind) folded before Flop
Seat 5: Kobert72 (big blind) folded before Flop
Seat 6: diana024 showed [Td Ac] and lost with high card Ace



PokerStars Hand #222961865688:  Hold'em No Limit ($0.05/$0.10 USD) - 2021/01/23 12:43:43 ET
Table 'Lutetia III' 6-max Seat #3 is the button
Seat 1: HotMilk2020 ($10.48 in chips) 
Seat 2: LocalFixer ($10.44 in chips) 
Seat 3: Dugipokers ($20.85 in chips) 
Seat 5: Kobert72 ($16.41 in chips) 
Seat 6: diana024 ($5 in chips) 
Kobert72: posts small blind $0.05
diana024: posts big blind $0.10
*** HOLE CARDS ***
HotMilk2020: calls $0.10
LocalFixer: folds 
Dugipokers: raises $0.30 to $0.40
Kobert72: folds 
diana024: folds 
HotMilk2020: calls $0.30
*** FLOP *** [Ac 5s Ts]
HotMilk2020: checks 
Dugipokers: bets $0.30
HotMilk2020: calls $0.30
*** TURN *** [Ac 5s Ts] [Th]
HotMilk2020: checks 
Dugipokers: checks 
*** RIVER *** [Ac 5s Ts Th] [6s]
HotMilk2020: checks 
Dugipokers: checks 
*** SHOW DOWN ***
HotMilk2020: shows [Qc Js] (a pair of Tens)
Dugipokers: shows [Jd Jc] (two pair, Jacks and Tens)
Dugipokers collected $1.48 from pot
*** SUMMARY ***
Total pot $1.55 | Rake $0.07 
Board [Ac 5s Ts Th 6s]
Seat 1: HotMilk2020 showed [Qc Js] and lost with a pair of Tens
Seat 2: LocalFixer folded before Flop (didn't bet)
Seat 3: Dugipokers (button) showed [Jd Jc] and won ($1.48) with two pair, Jacks and Tens
Seat 5: Kobert72 (small blind) folded before Flop
Seat 6: diana024 (big blind) folded before Flop



PokerStars Hand #222961899515:  Hold'em No Limit ($0.05/$0.10 USD) - 2021/01/23 12:44:33 ET
Table 'Lutetia III' 6-max Seat #5 is the button
Seat 1: HotMilk2020 ($9.78 in chips) 
Seat 2: LocalFixer ($10.44 in chips) 
Seat 3: Dugipokers ($21.63 in chips) 
Seat 5: Kobert72 ($16.36 in chips) 
Seat 6: diana024 ($4.90 in chips) 
diana024: posts small blind $0.05
HotMilk2020: posts big blind $0.10
Kimi1892: sits out 
*** HOLE CARDS ***
LocalFixer: raises $0.20 to $0.30
Dugipokers: folds 
Kobert72: folds 
diana024: folds 
HotMilk2020: calls $0.20
*** FLOP *** [3s 4d 4h]
HotMilk2020: checks 
LocalFixer: checks 
*** TURN *** [3s 4d 4h] [7h]
HotMilk2020: checks 
LocalFixer: checks 
*** RIVER *** [3s 4d 4h 7h] [Td]
HotMilk2020: checks 
LocalFixer: checks 
*** SHOW DOWN ***
HotMilk2020: shows [Kh Jd] (a pair of Fours)
LocalFixer: shows [Kd Qh] (a pair of Fours - King+Queen kicker)
LocalFixer collected $0.62 from pot
*** SUMMARY ***
Total pot $0.65 | Rake $0.03 
Board [3s 4d 4h 7h Td]
Seat 1: HotMilk2020 (big blind) showed [Kh Jd] and lost with a pair of Fours
Seat 2: LocalFixer showed [Kd Qh] and won ($0.62) with a pair of Fours
Seat 3: Dugipokers folded before Flop (didn't bet)
Seat 5: Kobert72 (button) folded before Flop (didn't bet)
Seat 6: diana024 (small blind) folded before Flop



PokerStars Hand #222961920226:  Hold'em No Limit ($0.05/$0.10 USD) - 2021/01/23 12:45:04 ET
Table 'Lutetia III' 6-max Seat #6 is the button
Seat 1: HotMilk2020 ($9.48 in chips) 
Seat 2: LocalFixer ($10.76 in chips) 
Seat 3: Dugipokers ($21.63 in chips) 
Seat 5: Kobert72 ($16.36 in chips) 
Seat 6: diana024 ($4.85 in chips) 
HotMilk2020: posts small blind $0.05
LocalFixer: posts big blind $0.10
Kimi1892: sits out 
*** HOLE CARDS ***
Dugipokers: folds 
Kobert72: folds 
diana024: raises $0.10 to $0.20
HotMilk2020: folds 
LocalFixer: folds 
Uncalled bet ($0.10) returned to diana024
diana024 collected $0.25 from pot
diana024: doesn't show hand 
*** SUMMARY ***
Total pot $0.25 | Rake $0 
Seat 1: HotMilk2020 (small blind) folded before Flop
Seat 2: LocalFixer (big blind) folded before Flop
Seat 3: Dugipokers folded before Flop (didn't bet)
Seat 5: Kobert72 folded before Flop (didn't bet)
Seat 6: diana024 (button) collected ($0.25)



PokerStars Hand #222961934123:  Hold'em No Limit ($0.05/$0.10 USD) - 2021/01/23 12:45:25 ET
Table 'Lutetia III' 6-max Seat #1 is the button
Seat 1: HotMilk2020 ($9.43 in chips) 
Seat 2: LocalFixer ($10.66 in chips) 
Seat 3: Dugipokers ($21.63 in chips) 
Seat 5: Kobert72 ($16.36 in chips) 
Seat 6: diana024 ($5 in chips) 
LocalFixer: posts small blind $0.05
Dugipokers: posts big blind $0.10
Kimi1892: sits out 
*** HOLE CARDS ***
Kobert72: folds 
diana024: raises $0.50 to $0.60
HotMilk2020: folds 
LocalFixer: folds 
Dugipokers: folds 
Uncalled bet ($0.50) returned to diana024
diana024 collected $0.25 from pot
diana024: doesn't show hand 
*** SUMMARY ***
Total pot $0.25 | Rake $0 
Seat 1: HotMilk2020 (button) folded before Flop (didn't bet)
Seat 2: LocalFixer (small blind) folded before Flop
Seat 3: Dugipokers (big blind) folded before Flop
Seat 5: Kobert72 folded before Flop (didn't bet)
Seat 6: diana024 collected ($0.25)



PokerStars Hand #222961947531:  Hold'em No Limit ($0.05/$0.10 USD) - 2021/01/23 12:45:44 ET
Table 'Lutetia III' 6-max Seat #2 is the button
Seat 1: HotMilk2020 ($9.43 in chips) 
Seat 2: LocalFixer ($10.61 in chips) 
Seat 3: Dugipokers ($21.53 in chips) 
Seat 4: Kimi1892 ($10 in chips) 
Seat 5: Kobert72 ($16.36 in chips) 
Seat 6: diana024 ($5.15 in chips) 
Dugipokers: posts small blind $0.05
Kimi1892: posts big blind $0.10
*** HOLE CARDS ***
Kobert72: raises $0.13 to $0.23
diana024: folds 
HotMilk2020: folds 
LocalFixer: folds 
Dugipokers: folds 
Kimi1892: folds 
Uncalled bet ($0.13) returned to Kobert72
Kobert72 collected $0.25 from pot
Kobert72: doesn't show hand 
*** SUMMARY ***
Total pot $0.25 | Rake $0 
Seat 1: HotMilk2020 folded before Flop (didn't bet)
Seat 2: LocalFixer (button) folded before Flop (didn't bet)
Seat 3: Dugipokers (small blind) folded before Flop
Seat 4: Kimi1892 (big blind) folded before Flop
Seat 5: Kobert72 collected ($0.25)
Seat 6: diana024 folded before Flop (didn't bet)



PokerStars Hand #222961957241:  Hold'em No Limit ($0.05/$0.10 USD) - 2021/01/23 12:45:59 ET
Table 'Lutetia III' 6-max Seat #3 is the button
Seat 1: HotMilk2020 ($9.43 in chips) 
Seat 2: LocalFixer ($10.61 in chips) 
Seat 3: Dugipokers ($21.48 in chips) 
Seat 4: Kimi1892 ($10 in chips) 
Seat 5: Kobert72 ($16.51 in chips) 
Seat 6: diana024 ($5.15 in chips) 
Kimi1892: posts small blind $0.05
Kobert72: posts big blind $0.10
*** HOLE CARDS ***
diana024: folds 
HotMilk2020: folds 
LocalFixer: folds 
Dugipokers: folds 
Kimi1892: folds 
Uncalled bet ($0.05) returned to Kobert72
Kobert72 collected $0.10 from pot
Kobert72: doesn't show hand 
*** SUMMARY ***
Total pot $0.10 | Rake $0 
Seat 1: HotMilk2020 folded before Flop (didn't bet)
Seat 2: LocalFixer folded before Flop (didn't bet)
Seat 3: Dugipokers (button) folded before Flop (didn't bet)
Seat 4: Kimi1892 (small blind) folded before Flop
Seat 5: Kobert72 (big blind) collected ($0.10)
Seat 6: diana024 folded before Flop (didn't bet)



PokerStars Hand #222961965102:  Hold'em No Limit ($0.05/$0.10 USD) - 2021/01/23 12:46:11 ET
Table 'Lutetia III' 6-max Seat #4 is the button
Seat 1: HotMilk2020 ($9.43 in chips) 
Seat 2: LocalFixer ($10.61 in chips) 
Seat 3: Dugipokers ($21.48 in chips) 
Seat 4: Kimi1892 ($10 in chips) 
Seat 5: Kobert72 ($16.56 in chips) 
Seat 6: diana024 ($5.15 in chips) 
Kobert72: posts small blind $0.05
diana024: posts big blind $0.10
*** HOLE CARDS ***
HotMilk2020: folds 
LocalFixer: folds 
Dugipokers: folds 
Kimi1892: folds 
Kobert72: folds 
Uncalled bet ($0.05) returned to diana024
diana024 collected $0.10 from pot
diana024: doesn't show hand 
*** SUMMARY ***
Total pot $0.10 | Rake $0 
Seat 1: HotMilk2020 folded before Flop (didn't bet)
Seat 2: LocalFixer folded before Flop (didn't bet)
Seat 3: Dugipokers folded before Flop (didn't bet)
Seat 4: Kimi1892 (button) folded before Flop (didn't bet)
Seat 5: Kobert72 (small blind) folded before Flop
Seat 6: diana024 (big blind) collected ($0.10)



PokerStars Hand #222961973154:  Hold'em No Limit ($0.05/$0.10 USD) - 2021/01/23 12:46:23 ET
Table 'Lutetia III' 6-max Seat #5 is the button
Seat 1: HotMilk2020 ($9.43 in chips) 
Seat 2: LocalFixer ($10.61 in chips) 
Seat 3: Dugipokers ($21.48 in chips) 
Seat 4: Kimi1892 ($10 in chips) 
Seat 5: Kobert72 ($16.51 in chips) 
Seat 6: diana024 ($5.20 in chips) 
diana024: posts small blind $0.05
HotMilk2020: posts big blind $0.10
*** HOLE CARDS ***
LocalFixer: raises $0.20 to $0.30
Dugipokers: folds 
Kimi1892: calls $0.30
Kobert72: raises $0.68 to $0.98
diana024: folds 
HotMilk2020: folds 
LocalFixer: folds 
Kimi1892: folds 
Uncalled bet ($0.68) returned to Kobert72
Kobert72 collected $1.05 from pot
Kobert72: doesn't show hand 
*** SUMMARY ***
Total pot $1.05 | Rake $0 
Seat 1: HotMilk2020 (big blind) folded before Flop
Seat 2: LocalFixer folded before Flop
Seat 3: Dugipokers folded before Flop (didn't bet)
Seat 4: Kimi1892 folded before Flop
Seat 5: Kobert72 (button) collected ($1.05)
Seat 6: diana024 (small blind) folded before Flop



PokerStars Hand #222961994041:  Hold'em No Limit ($0.05/$0.10 USD) - 2021/01/23 12:46:54 ET
Table 'Lutetia III' 6-max Seat #6 is the button
Seat 1: HotMilk2020 ($9.33 in chips) 
Seat 2: LocalFixer ($10.31 in chips) 
Seat 3: Dugipokers ($21.48 in chips) 
Seat 4: Kimi1892 ($10 in chips) 
Seat 5: Kobert72 ($17.26 in chips) 
Seat 6: diana024 ($5.15 in chips) 
HotMilk2020: posts small blind $0.05
LocalFixer: posts big blind $0.10
*** HOLE CARDS ***
Dugipokers: folds 
Kimi1892: raises $0.20 to $0.30
Kobert72: folds 
diana024: folds 
HotMilk2020: folds 
LocalFixer: folds 
Uncalled bet ($0.20) returned to Kimi1892
Kimi1892 collected $0.25 from pot
Kimi1892: doesn't show hand 
*** SUMMARY ***
Total pot $0.25 | Rake $0 
Seat 1: HotMilk2020 (small blind) folded before Flop
Seat 2: LocalFixer (big blind) folded before Flop
Seat 3: Dugipokers folded before Flop (didn't bet)
Seat 4: Kimi1892 collected ($0.25)
Seat 5: Kobert72 folded before Flop (didn't bet)
Seat 6: diana024 (button) folded before Flop (didn't bet)



PokerStars Hand #222961999385:  Hold'em No Limit ($0.05/$0.10 USD) - 2021/01/23 12:47:01 ET
Table 'Lutetia III' 6-max Seat #1 is the button
Seat 1: HotMilk2020 ($9.28 in chips) 
Seat 2: LocalFixer ($10.21 in chips) 
Seat 3: Dugipokers ($21.48 in chips) 
Seat 4: Kimi1892 ($10.15 in chips) 
Seat 5: Kobert72 ($17.26 in chips) 
Seat 6: diana024 ($5.15 in chips) 
LocalFixer: posts small blind $0.05
Dugipokers: posts big blind $0.10
*** HOLE CARDS ***
Kimi1892: folds 
Kobert72: folds 
diana024: calls $0.10
HotMilk2020: folds 
LocalFixer: folds 
Dugipokers: checks 
*** FLOP *** [6d 3c 2h]
Dugipokers: checks 
diana024: bets $0.10
Dugipokers: calls $0.10
*** TURN *** [6d 3c 2h] [4d]
Dugipokers: checks 
diana024: checks 
*** RIVER *** [6d 3c 2h 4d] [7h]
Dugipokers: checks 
diana024: checks 
*** SHOW DOWN ***
Dugipokers: shows [7c 9c] (a pair of Sevens)
diana024: mucks hand 
Dugipokers collected $0.43 from pot
*** SUMMARY ***
Total pot $0.45 | Rake $0.02 
Board [6d 3c 2h 4d 7h]
Seat 1: HotMilk2020 (button) folded before Flop (didn't bet)
Seat 2: LocalFixer (small blind) folded before Flop
Seat 3: Dugipokers (big blind) showed [7c 9c] and won ($0.43) with a pair of Sevens
Seat 4: Kimi1892 folded before Flop (didn't bet)
Seat 5: Kobert72 folded before Flop (didn't bet)
Seat 6: diana024 mucked



PokerStars Hand #222962027607:  Hold'em No Limit ($0.05/$0.10 USD) - 2021/01/23 12:47:43 ET
Table 'Lutetia III' 6-max Seat #2 is the button
Seat 1: HotMilk2020 ($9.28 in chips) 
Seat 2: LocalFixer ($10.16 in chips) 
Seat 3: Dugipokers ($21.71 in chips) 
Seat 4: Kimi1892 ($10.15 in chips) 
Seat 5: Kobert72 ($17.26 in chips) 
Seat 6: diana024 ($4.95 in chips) 
Dugipokers: posts small blind $0.05
Kimi1892: posts big blind $0.10
*** HOLE CARDS ***
Kobert72: folds 
diana024: raises $0.50 to $0.60
HotMilk2020: folds 
LocalFixer: raises $1.40 to $2
Dugipokers: folds 
Kimi1892: folds 
diana024: calls $1.40
*** FLOP *** [8c 8h 7d]
diana024: checks 
LocalFixer: bets $2.18
diana024: folds 
Uncalled bet ($2.18) returned to LocalFixer
LocalFixer collected $3.96 from pot
LocalFixer: doesn't show hand 
*** SUMMARY ***
Total pot $4.15 | Rake $0.19 
Board [8c 8h 7d]
Seat 1: HotMilk2020 folded before Flop (didn't bet)
Seat 2: LocalFixer (button) collected ($3.96)
Seat 3: Dugipokers (small blind) folded before Flop
Seat 4: Kimi1892 (big blind) folded before Flop
Seat 5: Kobert72 folded before Flop (didn't bet)
Seat 6: diana024 folded on the Flop



PokerStars Hand #222962051384:  Hold'em No Limit ($0.05/$0.10 USD) - 2021/01/23 12:48:19 ET
Table 'Lutetia III' 6-max Seat #3 is the button
Seat 1: HotMilk2020 ($9.28 in chips) 
Seat 2: LocalFixer ($12.12 in chips) 
Seat 3: Dugipokers ($21.66 in chips) 
Seat 4: Kimi1892 ($10.05 in chips) 
Seat 5: Kobert72 ($17.26 in chips) 
Seat 6: diana024 ($5 in chips) 
Kimi1892: posts small blind $0.05
Kobert72: posts big blind $0.10
*** HOLE CARDS ***
diana024: folds 
diana024 leaves the table
HotMilk2020: folds 
LocalFixer: folds 
Dugipokers: folds 
Kimi1892: folds 
Uncalled bet ($0.05) returned to Kobert72
Kobert72 collected $0.10 from pot
Kobert72: doesn't show hand 
*** SUMMARY ***
Total pot $0.10 | Rake $0 
Seat 1: HotMilk2020 folded before Flop (didn't bet)
Seat 2: LocalFixer folded before Flop (didn't bet)
Seat 3: Dugipokers (button) folded before Flop (didn't bet)
Seat 4: Kimi1892 (small blind) folded before Flop
Seat 5: Kobert72 (big blind) collected ($0.10)
Seat 6: diana024 folded before Flop (didn't bet)



PokerStars Hand #222962060431:  Hold'em No Limit ($0.05/$0.10 USD) - 2021/01/23 12:48:32 ET
Table 'Lutetia III' 6-max Seat #4 is the button
Seat 1: HotMilk2020 ($9.28 in chips) 
Seat 2: LocalFixer ($12.12 in chips) 
Seat 3: Dugipokers ($21.66 in chips) 
Seat 4: Kimi1892 ($10 in chips) 
Seat 5: Kobert72 ($17.31 in chips) 
Kobert72: posts small blind $0.05
HotMilk2020: posts big blind $0.10
*** HOLE CARDS ***
LocalFixer: raises $0.20 to $0.30
Dugipokers: folds 
Kimi1892: folds 
Kobert72: folds 
HotMilk2020: folds 
Uncalled bet ($0.20) returned to LocalFixer
Vaha379 joins the table at seat #6 
LocalFixer collected $0.25 from pot
LocalFixer: doesn't show hand 
*** SUMMARY ***
Total pot $0.25 | Rake $0 
Seat 1: HotMilk2020 (big blind) folded before Flop
Seat 2: LocalFixer collected ($0.25)
Seat 3: Dugipokers folded before Flop (didn't bet)
Seat 4: Kimi1892 (button) folded before Flop (didn't bet)
Seat 5: Kobert72 (small blind) folded before Flop



PokerStars Hand #222962069469:  Hold'em No Limit ($0.05/$0.10 USD) - 2021/01/23 12:48:45 ET
Table 'Lutetia III' 6-max Seat #5 is the button
Seat 1: HotMilk2020 ($9.18 in chips) 
Seat 2: LocalFixer ($12.27 in chips) 
Seat 3: Dugipokers ($21.66 in chips) 
Seat 4: Kimi1892 ($10 in chips) 
Seat 5: Kobert72 ($17.26 in chips) 
HotMilk2020: posts small blind $0.05
LocalFixer: posts big blind $0.10
*** HOLE CARDS ***
Dugipokers: raises $0.20 to $0.30
Kimi1892: folds 
Kobert72: folds 
HotMilk2020: folds 
LocalFixer: folds 
Uncalled bet ($0.20) returned to Dugipokers
Dugipokers collected $0.25 from pot
Dugipokers: doesn't show hand 
*** SUMMARY ***
Total pot $0.25 | Rake $0 
Seat 1: HotMilk2020 (small blind) folded before Flop
Seat 2: LocalFixer (big blind) folded before Flop
Seat 3: Dugipokers collected ($0.25)
Seat 4: Kimi1892 folded before Flop (didn't bet)
Seat 5: Kobert72 (button) folded before Flop (didn't bet)



PokerStars Hand #222962079476:  Hold'em No Limit ($0.05/$0.10 USD) - 2021/01/23 12:49:00 ET
Table 'Lutetia III' 6-max Seat #1 is the button
Seat 1: HotMilk2020 ($9.13 in chips) 
Seat 2: LocalFixer ($12.17 in chips) 
Seat 4: Kimi1892 ($10 in chips) 
Seat 5: Kobert72 ($17.26 in chips) 
LocalFixer: posts small blind $0.05
Dugipokers: is sitting out 
Kimi1892: posts big blind $0.10
Vaha379: sits out 
*** HOLE CARDS ***
Dugipokers leaves the table
Kobert72: folds 
IliyaGLA joins the table at seat #3 
HotMilk2020: calls $0.10
LocalFixer: folds 
Kimi1892: raises $0.30 to $0.40
HotMilk2020: calls $0.30
*** FLOP *** [2c 7h Qc]
Kimi1892: bets $0.27
HotMilk2020: calls $0.27
*** TURN *** [2c 7h Qc] [9d]
Kimi1892: bets $0.68
HotMilk2020: calls $0.68
*** RIVER *** [2c 7h Qc 9d] [3d]
Kimi1892: checks 
HotMilk2020: bets $2.63
Kimi1892: folds 
Uncalled bet ($2.63) returned to HotMilk2020
HotMilk2020 collected $2.63 from pot
HotMilk2020: doesn't show hand 
*** SUMMARY ***
Total pot $2.75 | Rake $0.12 
Board [2c 7h Qc 9d 3d]
Seat 1: HotMilk2020 (button) collected ($2.63)
Seat 2: LocalFixer (small blind) folded before Flop
Seat 4: Kimi1892 (big blind) folded on the River
Seat 5: Kobert72 folded before Flop (didn't bet)



PokerStars Hand #222962114291:  Hold'em No Limit ($0.05/$0.10 USD) - 2021/01/23 12:49:52 ET
Table 'Lutetia III' 6-max Seat #2 is the button
Seat 1: HotMilk2020 ($10.41 in chips) 
Seat 2: LocalFixer ($12.12 in chips) 
Seat 4: Kimi1892 ($10 in chips) 
Seat 5: Kobert72 ($17.26 in chips) 
Kimi1892: posts small blind $0.05
Kobert72: posts big blind $0.10
Vaha379: sits out 
*** HOLE CARDS ***
HotMilk2020: folds 
LocalFixer: folds 
Kimi1892: folds 
Uncalled bet ($0.05) returned to Kobert72
Kobert72 collected $0.10 from pot
Kobert72: doesn't show hand 
*** SUMMARY ***
Total pot $0.10 | Rake $0 
Seat 1: HotMilk2020 folded before Flop (didn't bet)
Seat 2: LocalFixer (button) folded before Flop (didn't bet)
Seat 4: Kimi1892 (small blind) folded before Flop
Seat 5: Kobert72 (big blind) collected ($0.10)



PokerStars Hand #222962121962:  Hold'em No Limit ($0.05/$0.10 USD) - 2021/01/23 12:50:03 ET
Table 'Lutetia III' 6-max Seat #4 is the button
Seat 1: HotMilk2020 ($10.41 in chips) 
Seat 2: LocalFixer ($12.12 in chips) 
Seat 4: Kimi1892 ($10 in chips) 
Seat 5: Kobert72 ($17.31 in chips) 
Seat 6: Vaha379 ($10 in chips) 
Kobert72: posts small blind $0.05
Vaha379: posts big blind $0.10
IliyaGLA: sits out 
*** HOLE CARDS ***
HotMilk2020: calls $0.10
LocalFixer: folds 
Kimi1892: folds 
Kobert72: folds 
Vaha379: checks 
*** FLOP *** [4s 8c 7c]
Vaha379: checks 
HotMilk2020: checks 
*** TURN *** [4s 8c 7c] [6h]
Vaha379: checks 
HotMilk2020: checks 
*** RIVER *** [4s 8c 7c 6h] [3c]
Vaha379: checks 
HotMilk2020: bets $0.24
Vaha379: calls $0.24
*** SHOW DOWN ***
HotMilk2020: shows [4c 9c] (a flush, Nine high)
Vaha379: mucks hand 
HotMilk2020 collected $0.70 from pot
*** SUMMARY ***
Total pot $0.73 | Rake $0.03 
Board [4s 8c 7c 6h 3c]
Seat 1: HotMilk2020 showed [4c 9c] and won ($0.70) with a flush, Nine high
Seat 2: LocalFixer folded before Flop (didn't bet)
Seat 4: Kimi1892 (button) folded before Flop (didn't bet)
Seat 5: Kobert72 (small blind) folded before Flop
Seat 6: Vaha379 (big blind) mucked



PokerStars Hand #222962141495:  Hold'em No Limit ($0.05/$0.10 USD) - 2021/01/23 12:50:32 ET
Table 'Lutetia III' 6-max Seat #5 is the button
Seat 1: HotMilk2020 ($10.77 in chips) 
Seat 2: LocalFixer ($12.12 in chips) 
Seat 4: Kimi1892 ($10 in chips) 
Seat 5: Kobert72 ($17.26 in chips) 
Seat 6: Vaha379 ($9.66 in chips) 
Vaha379: posts small blind $0.05
HotMilk2020: posts big blind $0.10
IliyaGLA: sits out 
*** HOLE CARDS ***
LocalFixer: folds 
Kimi1892: folds 
Kobert72: folds 
Vaha379: raises $0.20 to $0.30
HotMilk2020: calls $0.20
*** FLOP *** [7s 4h Ah]
Vaha379: bets $0.18
HotMilk2020: folds 
Uncalled bet ($0.18) returned to Vaha379
Vaha379 collected $0.57 from pot
Vaha379: doesn't show hand 
*** SUMMARY ***
Total pot $0.60 | Rake $0.03 
Board [7s 4h Ah]
Seat 1: HotMilk2020 (big blind) folded on the Flop
Seat 2: LocalFixer folded before Flop (didn't bet)
Seat 4: Kimi1892 folded before Flop (didn't bet)
Seat 5: Kobert72 (button) folded before Flop (didn't bet)
Seat 6: Vaha379 (small blind) collected ($0.57)



PokerStars Hand #222962155996:  Hold'em No Limit ($0.05/$0.10 USD) - 2021/01/23 12:50:54 ET
Table 'Lutetia III' 6-max Seat #6 is the button
Seat 1: HotMilk2020 ($10.47 in chips) 
Seat 2: LocalFixer ($12.12 in chips) 
Seat 4: Kimi1892 ($10 in chips) 
Seat 5: Kobert72 ($17.26 in chips) 
Seat 6: Vaha379 ($9.93 in chips) 
HotMilk2020: posts small blind $0.05
LocalFixer: posts big blind $0.10
IliyaGLA: sits out 
*** HOLE CARDS ***
Kimi1892: folds 
Kobert72: raises $0.13 to $0.23
Vaha379: raises $0.61 to $0.84
HotMilk2020: folds 
LocalFixer: raises $1.66 to $2.50
Kobert72: folds 
Vaha379: calls $1.66
*** FLOP *** [Ts 7c 5c]
LocalFixer: bets $2.77
Vaha379: raises $4.66 to $7.43 and is all-in
LocalFixer: calls $4.66
*** TURN *** [Ts 7c 5c] [7h]
*** RIVER *** [Ts 7c 5c 7h] [8s]
*** SHOW DOWN ***
LocalFixer: shows [Ac Ah] (two pair, Aces and Sevens)
Vaha379: shows [Kd Js] (a pair of Sevens)
LocalFixer collected $19.23 from pot
*** SUMMARY ***
Total pot $20.14 | Rake $0.91 
Board [Ts 7c 5c 7h 8s]
Seat 1: HotMilk2020 (small blind) folded before Flop
Seat 2: LocalFixer (big blind) showed [Ac Ah] and won ($19.23) with two pair, Aces and Sevens
Seat 4: Kimi1892 folded before Flop (didn't bet)
Seat 5: Kobert72 folded before Flop
Seat 6: Vaha379 (button) showed [Kd Js] and lost with a pair of Sevens



PokerStars Hand #222962195164:  Hold'em No Limit ($0.05/$0.10 USD) - 2021/01/23 12:51:51 ET
Table 'Lutetia III' 6-max Seat #1 is the button
Seat 1: HotMilk2020 ($10.42 in chips) 
Seat 2: LocalFixer ($21.42 in chips) 
Seat 3: IliyaGLA ($10 in chips) 
Seat 4: Kimi1892 ($10 in chips) 
Seat 5: Kobert72 ($17.03 in chips) 
Vaha379 leaves the table
LocalFixer: posts small blind $0.05
IliyaGLA: posts big blind $0.10
*** HOLE CARDS ***
Kimi1892: folds 
Kobert72: raises $0.13 to $0.23
HotMilk2020: folds 
Vaha379 joins the table at seat #6 
LocalFixer: folds 
IliyaGLA: folds 
Uncalled bet ($0.13) returned to Kobert72
Kobert72 collected $0.25 from pot
Kobert72: doesn't show hand 
*** SUMMARY ***
Total pot $0.25 | Rake $0 
Seat 1: HotMilk2020 (button) folded before Flop (didn't bet)
Seat 2: LocalFixer (small blind) folded before Flop
Seat 3: IliyaGLA (big blind) folded before Flop
Seat 4: Kimi1892 folded before Flop (didn't bet)
Seat 5: Kobert72 collected ($0.25)



PokerStars Hand #222962202322:  Hold'em No Limit ($0.05/$0.10 USD) - 2021/01/23 12:52:02 ET
Table 'Lutetia III' 6-max Seat #2 is the button
Seat 1: HotMilk2020 ($10.42 in chips) 
Seat 2: LocalFixer ($21.37 in chips) 
Seat 3: IliyaGLA ($9.90 in chips) 
Seat 4: Kimi1892 ($10 in chips) 
Seat 5: Kobert72 ($17.18 in chips) 
IliyaGLA: posts small blind $0.05
Kimi1892: posts big blind $0.10
Vaha379: sits out 
*** HOLE CARDS ***
Kobert72: folds 
HotMilk2020: folds 
LocalFixer: folds 
IliyaGLA: calls $0.05
Kimi1892: checks 
*** FLOP *** [4c Kd Tc]
IliyaGLA: checks 
Kimi1892: bets $0.20
IliyaGLA: folds 
Uncalled bet ($0.20) returned to Kimi1892
Kimi1892 collected $0.19 from pot
Kimi1892: doesn't show hand 
*** SUMMARY ***
Total pot $0.20 | Rake $0.01 
Board [4c Kd Tc]
Seat 1: HotMilk2020 folded before Flop (didn't bet)
Seat 2: LocalFixer (button) folded before Flop (didn't bet)
Seat 3: IliyaGLA (small blind) folded on the Flop
Seat 4: Kimi1892 (big blind) collected ($0.19)
Seat 5: Kobert72 folded before Flop (didn't bet)



PokerStars Hand #222962217682:  Hold'em No Limit ($0.05/$0.10 USD) - 2021/01/23 12:52:25 ET
Table 'Lutetia III' 6-max Seat #3 is the button
Seat 1: HotMilk2020 ($10.42 in chips) 
Seat 2: LocalFixer ($21.37 in chips) 
Seat 3: IliyaGLA ($9.80 in chips) 
Seat 4: Kimi1892 ($10.09 in chips) 
Seat 5: Kobert72 ($17.18 in chips) 
Kimi1892: posts small blind $0.05
Kobert72: posts big blind $0.10
Vaha379: sits out 
*** HOLE CARDS ***
HotMilk2020: calls $0.10
LocalFixer: folds 
IliyaGLA: folds 
Kimi1892: folds 
Kobert72: folds 
Kobert72 leaves the table
HotMilk2020 collected $0.25 from pot
HotMilk2020: doesn't show hand 
*** SUMMARY ***
Total pot $0.25 | Rake $0 
Seat 1: HotMilk2020 collected ($0.25)
Seat 2: LocalFixer folded before Flop (didn't bet)
Seat 3: IliyaGLA (button) folded before Flop (didn't bet)
Seat 4: Kimi1892 (small blind) folded before Flop
Seat 5: Kobert72 (big blind) folded before Flop



PokerStars Hand #222962226877:  Hold'em No Limit ($0.05/$0.10 USD) - 2021/01/23 12:52:38 ET
Table 'Lutetia III' 6-max Seat #4 is the button
Seat 1: HotMilk2020 ($10.57 in chips) 
Seat 2: LocalFixer ($21.37 in chips) 
Seat 3: IliyaGLA ($9.80 in chips) 
Seat 4: Kimi1892 ($10.04 in chips) 
HotMilk2020: posts small blind $0.05
LocalFixer: posts big blind $0.10
*** HOLE CARDS ***
IliyaGLA: raises $0.10 to $0.20
Kimi1892: folds 
HotMilk2020: folds 
LocalFixer: folds 
Uncalled bet ($0.10) returned to IliyaGLA
IliyaGLA collected $0.25 from pot
IliyaGLA: doesn't show hand 
*** SUMMARY ***
Total pot $0.25 | Rake $0 
Seat 1: HotMilk2020 (small blind) folded before Flop
Seat 2: LocalFixer (big blind) folded before Flop
Seat 3: IliyaGLA collected ($0.25)
Seat 4: Kimi1892 (button) folded before Flop (didn't bet)



PokerStars Hand #222962234528:  Hold'em No Limit ($0.05/$0.10 USD) - 2021/01/23 12:52:50 ET
Table 'Lutetia III' 6-max Seat #1 is the button
Seat 1: HotMilk2020 ($10.52 in chips) 
Seat 2: LocalFixer ($21.27 in chips) 
Seat 3: IliyaGLA ($9.95 in chips) 
Seat 4: Kimi1892 ($10.04 in chips) 
LocalFixer: posts small blind $0.05
IliyaGLA: posts big blind $0.10
Vaha379: sits out 
*** HOLE CARDS ***
fouktoubaba joins the table at seat #5 
Kimi1892: raises $0.20 to $0.30
HotMilk2020: folds 
LocalFixer: folds 
IliyaGLA: calls $0.20
*** FLOP *** [7s Ah 9s]
IliyaGLA: bets $0.10
Kimi1892: calls $0.10
*** TURN *** [7s Ah 9s] [Qs]
IliyaGLA: bets $0.10
Kimi1892: calls $0.10
*** RIVER *** [7s Ah 9s Qs] [Tc]
IliyaGLA: bets $0.10
Kimi1892: folds 
Uncalled bet ($0.10) returned to IliyaGLA
IliyaGLA collected $1 from pot
*** SUMMARY ***
Total pot $1.05 | Rake $0.05 
Board [7s Ah 9s Qs Tc]
Seat 1: HotMilk2020 (button) folded before Flop (didn't bet)
Seat 2: LocalFixer (small blind) folded before Flop
Seat 3: IliyaGLA (big blind) collected ($1)
Seat 4: Kimi1892 folded on the River



PokerStars Hand #222962268238:  Hold'em No Limit ($0.05/$0.10 USD) - 2021/01/23 12:53:30 ET
Table 'Lutetia III' 6-max Seat #2 is the button
Seat 1: HotMilk2020 ($10.52 in chips) 
Seat 2: LocalFixer ($21.22 in chips) 
Seat 3: IliyaGLA ($10.45 in chips) 
Seat 4: Kimi1892 ($10 in chips) 
IliyaGLA: posts small blind $0.05
Kimi1892: posts big blind $0.10
fouktoubaba: sits out 
Vaha379: sits out 
*** HOLE CARDS ***
HotMilk2020: calls $0.10
LocalFixer: folds 
IliyaGLA: calls $0.05
Kimi1892: checks 
*** FLOP *** [8s 7d Ah]
IliyaGLA: checks 
Kimi1892: checks 
HotMilk2020: checks 
*** TURN *** [8s 7d Ah] [4h]
IliyaGLA: checks 
Kimi1892: checks 
HotMilk2020: checks 
*** RIVER *** [8s 7d Ah 4h] [Ad]
IliyaGLA: checks 
Kimi1892: checks 
HotMilk2020: bets $0.29
IliyaGLA: folds 
Kimi1892: calls $0.29
*** SHOW DOWN ***
HotMilk2020: shows [Qs Ac] (three of a kind, Aces)
Kimi1892: mucks hand 
HotMilk2020 collected $0.84 from pot
*** SUMMARY ***
Total pot $0.88 | Rake $0.04 
Board [8s 7d Ah 4h Ad]
Seat 1: HotMilk2020 showed [Qs Ac] and won ($0.84) with three of a kind, Aces
Seat 2: LocalFixer (button) folded before Flop (didn't bet)
Seat 3: IliyaGLA (small blind) folded on the River
Seat 4: Kimi1892 (big blind) mucked



PokerStars Hand #222962322374:  Hold'em No Limit ($0.05/$0.10 USD) - 2021/01/23 12:54:51 ET
Table 'Lutetia III' 6-max Seat #3 is the button
Seat 1: HotMilk2020 ($10.97 in chips) 
Seat 2: LocalFixer ($21.22 in chips) 
Seat 3: IliyaGLA ($10.35 in chips) 
Seat 4: Kimi1892 ($10 in chips) 
Seat 5: fouktoubaba ($10 in chips) 
Kimi1892: posts small blind $0.05
fouktoubaba: posts big blind $0.10
Vaha379: sits out 
*** HOLE CARDS ***
HotMilk2020: calls $0.10
LocalFixer: folds 
IliyaGLA: folds 
Kimi1892: folds 
fouktoubaba: checks 
*** FLOP *** [2d 6h 4c]
fouktoubaba: bets $0.10
HotMilk2020: calls $0.10
*** TURN *** [2d 6h 4c] [8c]
fouktoubaba: bets $0.20
HotMilk2020: folds 
Uncalled bet ($0.20) returned to fouktoubaba
fouktoubaba collected $0.43 from pot
fouktoubaba: doesn't show hand 
*** SUMMARY ***
Total pot $0.45 | Rake $0.02 
Board [2d 6h 4c 8c]
Seat 1: HotMilk2020 folded on the Turn
Seat 2: LocalFixer folded before Flop (didn't bet)
Seat 3: IliyaGLA (button) folded before Flop (didn't bet)
Seat 4: Kimi1892 (small blind) folded before Flop
Seat 5: fouktoubaba (big blind) collected ($0.43)



PokerStars Hand #222962341417:  Hold'em No Limit ($0.05/$0.10 USD) - 2021/01/23 12:55:23 ET
Table 'Lutetia III' 6-max Seat #4 is the button
Seat 1: HotMilk2020 ($10.77 in chips) 
Seat 2: LocalFixer ($21.22 in chips) 
Seat 3: IliyaGLA ($10.35 in chips) 
Seat 4: Kimi1892 ($10 in chips) 
Seat 5: fouktoubaba ($10.23 in chips) 
Seat 6: Vaha379 ($10 in chips) 
fouktoubaba: posts small blind $0.05
Vaha379: posts big blind $0.10
*** HOLE CARDS ***
HotMilk2020: folds 
LocalFixer: folds 
IliyaGLA: folds 
Kimi1892: folds 
fouktoubaba: folds 
Uncalled bet ($0.05) returned to Vaha379
Vaha379 collected $0.10 from pot
Vaha379: doesn't show hand 
*** SUMMARY ***
Total pot $0.10 | Rake $0 
Seat 1: HotMilk2020 folded before Flop (didn't bet)
Seat 2: LocalFixer folded before Flop (didn't bet)
Seat 3: IliyaGLA folded before Flop (didn't bet)
Seat 4: Kimi1892 (button) folded before Flop (didn't bet)
Seat 5: fouktoubaba (small blind) folded before Flop
Seat 6: Vaha379 (big blind) collected ($0.10)



PokerStars Hand #222962347567:  Hold'em No Limit ($0.05/$0.10 USD) - 2021/01/23 12:55:36 ET
Table 'Lutetia III' 6-max Seat #5 is the button
Seat 1: HotMilk2020 ($10.77 in chips) 
Seat 2: LocalFixer ($21.22 in chips) 
Seat 3: IliyaGLA ($10.35 in chips) 
Seat 4: Kimi1892 ($10 in chips) 
Seat 5: fouktoubaba ($10.18 in chips) 
Seat 6: Vaha379 ($10.05 in chips) 
Vaha379: posts small blind $0.05
HotMilk2020: posts big blind $0.10
*** HOLE CARDS ***
LocalFixer: folds 
IliyaGLA: folds 
Kimi1892: folds 
fouktoubaba: raises $0.20 to $0.30
Vaha379: folds 
HotMilk2020: folds 
Uncalled bet ($0.20) returned to fouktoubaba
fouktoubaba collected $0.25 from pot
fouktoubaba: doesn't show hand 
*** SUMMARY ***
Total pot $0.25 | Rake $0 
Seat 1: HotMilk2020 (big blind) folded before Flop
Seat 2: LocalFixer folded before Flop (didn't bet)
Seat 3: IliyaGLA folded before Flop (didn't bet)
Seat 4: Kimi1892 folded before Flop (didn't bet)
Seat 5: fouktoubaba (button) collected ($0.25)
Seat 6: Vaha379 (small blind) folded before Flop



PokerStars Hand #222962357150:  Hold'em No Limit ($0.05/$0.10 USD) - 2021/01/23 12:55:55 ET
Table 'Lutetia III' 6-max Seat #6 is the button
Seat 1: HotMilk2020 ($10.67 in chips) 
Seat 2: LocalFixer ($21.22 in chips) 
Seat 3: IliyaGLA ($10.35 in chips) 
Seat 4: Kimi1892 ($10 in chips) 
Seat 5: fouktoubaba ($10.33 in chips) 
Seat 6: Vaha379 ($10 in chips) 
HotMilk2020: posts small blind $0.05
LocalFixer: posts big blind $0.10
*** HOLE CARDS ***
IliyaGLA: folds 
Kimi1892: folds 
fouktoubaba: raises $0.20 to $0.30
Vaha379: folds 
HotMilk2020: folds 
LocalFixer: folds 
Uncalled bet ($0.20) returned to fouktoubaba
fouktoubaba collected $0.25 from pot
fouktoubaba: doesn't show hand 
*** SUMMARY ***
Total pot $0.25 | Rake $0 
Seat 1: HotMilk2020 (small blind) folded before Flop
Seat 2: LocalFixer (big blind) folded before Flop
Seat 3: IliyaGLA folded before Flop (didn't bet)
Seat 4: Kimi1892 folded before Flop (didn't bet)
Seat 5: fouktoubaba collected ($0.25)
Seat 6: Vaha379 (button) folded before Flop (didn't bet)



PokerStars Hand #222962364695:  Hold'em No Limit ($0.05/$0.10 USD) - 2021/01/23 12:56:11 ET
Table 'Lutetia III' 6-max Seat #1 is the button
Seat 1: HotMilk2020 ($10.62 in chips) 
Seat 2: LocalFixer ($21.12 in chips) 
Seat 3: IliyaGLA ($10.35 in chips) 
Seat 4: Kimi1892 ($10 in chips) 
Seat 5: fouktoubaba ($10.48 in chips) 
Seat 6: Vaha379 ($10 in chips) 
LocalFixer: posts small blind $0.05
IliyaGLA: posts big blind $0.10
*** HOLE CARDS ***
Kimi1892 has timed out
Kimi1892: folds 
fouktoubaba: raises $0.20 to $0.30
Vaha379: folds 
HotMilk2020: folds 
LocalFixer: folds 
IliyaGLA: folds 
Uncalled bet ($0.20) returned to fouktoubaba
fouktoubaba collected $0.25 from pot
fouktoubaba: doesn't show hand 
*** SUMMARY ***
Total pot $0.25 | Rake $0 
Seat 1: HotMilk2020 (button) folded before Flop (didn't bet)
Seat 2: LocalFixer (small blind) folded before Flop
Seat 3: IliyaGLA (big blind) folded before Flop
Seat 4: Kimi1892 folded before Flop (didn't bet)
Seat 5: fouktoubaba collected ($0.25)
Seat 6: Vaha379 folded before Flop (didn't bet)



PokerStars Hand #222962376467:  Hold'em No Limit ($0.05/$0.10 USD) - 2021/01/23 12:56:34 ET
Table 'Lutetia III' 6-max Seat #2 is the button
Seat 1: HotMilk2020 ($10.62 in chips) 
Seat 2: LocalFixer ($21.07 in chips) 
Seat 3: IliyaGLA ($10.25 in chips) 
Seat 4: Kimi1892 ($10 in chips) 
Seat 5: fouktoubaba ($10.63 in chips) 
Seat 6: Vaha379 ($10 in chips) 
IliyaGLA: posts small blind $0.05
Kimi1892: posts big blind $0.10
*** HOLE CARDS ***
fouktoubaba: folds 
Vaha379: raises $0.20 to $0.30
HotMilk2020: folds 
LocalFixer: folds 
IliyaGLA: calls $0.25
Kimi1892: raises $1.10 to $1.40
Vaha379: folds 
IliyaGLA: folds 
Uncalled bet ($1.10) returned to Kimi1892
Kimi1892 collected $0.90 from pot
Kimi1892: doesn't show hand 
*** SUMMARY ***
Total pot $0.90 | Rake $0 
Seat 1: HotMilk2020 folded before Flop (didn't bet)
Seat 2: LocalFixer (button) folded before Flop (didn't bet)
Seat 3: IliyaGLA (small blind) folded before Flop
Seat 4: Kimi1892 (big blind) collected ($0.90)
Seat 5: fouktoubaba folded before Flop (didn't bet)
Seat 6: Vaha379 folded before Flop



PokerStars Hand #222962393160:  Hold'em No Limit ($0.05/$0.10 USD) - 2021/01/23 12:57:08 ET
Table 'Lutetia III' 6-max Seat #3 is the button
Seat 1: HotMilk2020 ($10.62 in chips) 
Seat 2: LocalFixer ($21.07 in chips) 
Seat 3: IliyaGLA ($9.95 in chips) 
Seat 4: Kimi1892 ($10.60 in chips) 
Seat 5: fouktoubaba ($10.63 in chips) 
Seat 6: Vaha379 ($9.70 in chips) 
Kimi1892: posts small blind $0.05
fouktoubaba: posts big blind $0.10
*** HOLE CARDS ***
Vaha379: folds 
HotMilk2020: calls $0.10
LocalFixer: raises $0.30 to $0.40
IliyaGLA: folds 
Kimi1892: folds 
fouktoubaba: calls $0.30
HotMilk2020: calls $0.30
*** FLOP *** [6d 5s 7c]
fouktoubaba: checks 
HotMilk2020: checks 
LocalFixer: checks 
*** TURN *** [6d 5s 7c] [Ac]
fouktoubaba: bets $0.70
HotMilk2020: folds 
LocalFixer: folds 
Uncalled bet ($0.70) returned to fouktoubaba
fouktoubaba collected $1.19 from pot
fouktoubaba: doesn't show hand 
*** SUMMARY ***
Total pot $1.25 | Rake $0.06 
Board [6d 5s 7c Ac]
Seat 1: HotMilk2020 folded on the Turn
Seat 2: LocalFixer folded on the Turn
Seat 3: IliyaGLA (button) folded before Flop (didn't bet)
Seat 4: Kimi1892 (small blind) folded before Flop
Seat 5: fouktoubaba (big blind) collected ($1.19)
Seat 6: Vaha379 folded before Flop (didn't bet)



PokerStars Hand #222962410936:  Hold'em No Limit ($0.05/$0.10 USD) - 2021/01/23 12:57:44 ET
Table 'Lutetia III' 6-max Seat #4 is the button
Seat 1: HotMilk2020 ($10.22 in chips) 
Seat 2: LocalFixer ($20.67 in chips) 
Seat 3: IliyaGLA ($9.95 in chips) 
Seat 4: Kimi1892 ($10.55 in chips) 
Seat 5: fouktoubaba ($11.42 in chips) 
Seat 6: Vaha379 ($9.70 in chips) 
fouktoubaba: posts small blind $0.05
Vaha379: posts big blind $0.10
*** HOLE CARDS ***
HotMilk2020: folds 
LocalFixer: folds 
IliyaGLA: folds 
Kimi1892: folds 
fouktoubaba: raises $0.20 to $0.30
Vaha379: calls $0.20
*** FLOP *** [9h 3d Qd]
fouktoubaba: checks 
Vaha379: checks 
*** TURN *** [9h 3d Qd] [2h]
fouktoubaba: checks 
Vaha379: checks 
*** RIVER *** [9h 3d Qd 2h] [9s]
fouktoubaba: bets $0.20
Vaha379: folds 
Uncalled bet ($0.20) returned to fouktoubaba
fouktoubaba collected $0.57 from pot
fouktoubaba: doesn't show hand 
*** SUMMARY ***
Total pot $0.60 | Rake $0.03 
Board [9h 3d Qd 2h 9s]
Seat 1: HotMilk2020 folded before Flop (didn't bet)
Seat 2: LocalFixer folded before Flop (didn't bet)
Seat 3: IliyaGLA folded before Flop (didn't bet)
Seat 4: Kimi1892 (button) folded before Flop (didn't bet)
Seat 5: fouktoubaba (small blind) collected ($0.57)
Seat 6: Vaha379 (big blind) folded on the River



PokerStars Hand #222962432915:  Hold'em No Limit ($0.05/$0.10 USD) - 2021/01/23 12:58:28 ET
Table 'Lutetia III' 6-max Seat #5 is the button
Seat 1: HotMilk2020 ($10.22 in chips) 
Seat 2: LocalFixer ($20.67 in chips) 
Seat 3: IliyaGLA ($9.95 in chips) 
Seat 4: Kimi1892 ($10.55 in chips) 
Seat 5: fouktoubaba ($11.69 in chips) 
Seat 6: Vaha379 ($9.40 in chips) 
Vaha379: posts small blind $0.05
HotMilk2020: posts big blind $0.10
*** HOLE CARDS ***
LocalFixer: folds 
IliyaGLA: folds 
Kimi1892: folds 
fouktoubaba: folds 
Vaha379: folds 
Uncalled bet ($0.05) returned to HotMilk2020
HotMilk2020 collected $0.10 from pot
HotMilk2020: doesn't show hand 
*** SUMMARY ***
Total pot $0.10 | Rake $0 
Seat 1: HotMilk2020 (big blind) collected ($0.10)
Seat 2: LocalFixer folded before Flop (didn't bet)
Seat 3: IliyaGLA folded before Flop (didn't bet)
Seat 4: Kimi1892 folded before Flop (didn't bet)
Seat 5: fouktoubaba (button) folded before Flop (didn't bet)
Seat 6: Vaha379 (small blind) folded before Flop



PokerStars Hand #222962440767:  Hold'em No Limit ($0.05/$0.10 USD) - 2021/01/23 12:58:44 ET
Table 'Lutetia III' 6-max Seat #6 is the button
Seat 1: HotMilk2020 ($10.27 in chips) 
Seat 2: LocalFixer ($20.67 in chips) 
Seat 3: IliyaGLA ($9.95 in chips) 
Seat 4: Kimi1892 ($10.55 in chips) 
Seat 5: fouktoubaba ($11.69 in chips) 
Seat 6: Vaha379 ($9.35 in chips) 
HotMilk2020: posts small blind $0.05
LocalFixer: posts big blind $0.10
*** HOLE CARDS ***
IliyaGLA: folds 
Kimi1892: folds 
fouktoubaba: raises $0.20 to $0.30
Vaha379: folds 
HotMilk2020: folds 
LocalFixer: folds 
Uncalled bet ($0.20) returned to fouktoubaba
fouktoubaba collected $0.25 from pot
fouktoubaba: doesn't show hand 
*** SUMMARY ***
Total pot $0.25 | Rake $0 
Seat 1: HotMilk2020 (small blind) folded before Flop
Seat 2: LocalFixer (big blind) folded before Flop
Seat 3: IliyaGLA folded before Flop (didn't bet)
Seat 4: Kimi1892 folded before Flop (didn't bet)
Seat 5: fouktoubaba collected ($0.25)
Seat 6: Vaha379 (button) folded before Flop (didn't bet)



PokerStars Hand #222962449917:  Hold'em No Limit ($0.05/$0.10 USD) - 2021/01/23 12:59:02 ET
Table 'Lutetia III' 6-max Seat #1 is the button
Seat 1: HotMilk2020 ($10.22 in chips) 
Seat 2: LocalFixer ($20.57 in chips) 
Seat 3: IliyaGLA ($9.95 in chips) 
Seat 4: Kimi1892 ($10.55 in chips) 
Seat 5: fouktoubaba ($11.84 in chips) 
Seat 6: Vaha379 ($10 in chips) 
LocalFixer: posts small blind $0.05
IliyaGLA: posts big blind $0.10
*** HOLE CARDS ***
Kimi1892: folds 
fouktoubaba: raises $0.20 to $0.30
Vaha379: folds 
HotMilk2020: folds 
LocalFixer: folds 
IliyaGLA is disconnected 
IliyaGLA has timed out while disconnected
IliyaGLA: folds 
Uncalled bet ($0.20) returned to fouktoubaba
fouktoubaba collected $0.25 from pot
fouktoubaba: doesn't show hand 
*** SUMMARY ***
Total pot $0.25 | Rake $0 
Seat 1: HotMilk2020 (button) folded before Flop (didn't bet)
Seat 2: LocalFixer (small blind) folded before Flop
Seat 3: IliyaGLA (big blind) folded before Flop
Seat 4: Kimi1892 folded before Flop (didn't bet)
Seat 5: fouktoubaba collected ($0.25)
Seat 6: Vaha379 folded before Flop (didn't bet)



PokerStars Hand #222962463554:  Hold'em No Limit ($0.05/$0.10 USD) - 2021/01/23 12:59:29 ET
Table 'Lutetia III' 6-max Seat #2 is the button
Seat 1: HotMilk2020 ($10.22 in chips) 
Seat 2: LocalFixer ($20.52 in chips) 
Seat 4: Kimi1892 ($10.55 in chips) 
Seat 5: fouktoubaba ($11.99 in chips) 
Seat 6: Vaha379 ($10 in chips) 
Kimi1892: posts small blind $0.05
fouktoubaba: posts big blind $0.10
*** HOLE CARDS ***
Vaha379: folds 
HotMilk2020: calls $0.10
LocalFixer: folds 
Kimi1892: folds 
fouktoubaba: checks 
*** FLOP *** [8c 9d Ts]
fouktoubaba: bets $0.10
HotMilk2020: calls $0.10
*** TURN *** [8c 9d Ts] [7d]
fouktoubaba: bets $0.20
HotMilk2020: folds 
Uncalled bet ($0.20) returned to fouktoubaba
fouktoubaba collected $0.43 from pot
fouktoubaba: doesn't show hand 
*** SUMMARY ***
Total pot $0.45 | Rake $0.02 
Board [8c 9d Ts 7d]
Seat 1: HotMilk2020 folded on the Turn
Seat 2: LocalFixer (button) folded before Flop (didn't bet)
Seat 4: Kimi1892 (small blind) folded before Flop
Seat 5: fouktoubaba (big blind) collected ($0.43)
Seat 6: Vaha379 folded before Flop (didn't bet)



PokerStars Hand #222962482822:  Hold'em No Limit ($0.05/$0.10 USD) - 2021/01/23 13:00:07 ET
Table 'Lutetia III' 6-max Seat #4 is the button
Seat 1: HotMilk2020 ($10.02 in chips) 
Seat 2: LocalFixer ($20.52 in chips) 
Seat 4: Kimi1892 ($10.50 in chips) 
Seat 5: fouktoubaba ($12.22 in chips) 
Seat 6: Vaha379 ($10 in chips) 
fouktoubaba: posts small blind $0.05
Vaha379: posts big blind $0.10
*** HOLE CARDS ***
HotMilk2020: calls $0.10
LocalFixer: raises $0.30 to $0.40
Kimi1892: folds 
fouktoubaba: folds 
Vaha379: folds 
HotMilk2020: calls $0.30
*** FLOP *** [Qs 2c Jd]
HotMilk2020: checks 
LocalFixer: bets $0.50
HotMilk2020: folds 
Uncalled bet ($0.50) returned to LocalFixer
LocalFixer collected $0.91 from pot
LocalFixer: doesn't show hand 
*** SUMMARY ***
Total pot $0.95 | Rake $0.04 
Board [Qs 2c Jd]
Seat 1: HotMilk2020 folded on the Flop
Seat 2: LocalFixer collected ($0.91)
Seat 4: Kimi1892 (button) folded before Flop (didn't bet)
Seat 5: fouktoubaba (small blind) folded before Flop
Seat 6: Vaha379 (big blind) folded before Flop



PokerStars Hand #222962494118:  Hold'em No Limit ($0.05/$0.10 USD) - 2021/01/23 13:00:28 ET
Table 'Lutetia III' 6-max Seat #5 is the button
Seat 1: HotMilk2020 ($9.62 in chips) 
Seat 2: LocalFixer ($21.03 in chips) 
Seat 4: Kimi1892 ($10.50 in chips) 
Seat 5: fouktoubaba ($12.17 in chips) 
Seat 6: Vaha379 ($9.90 in chips) 
Vaha379: posts small blind $0.05
HotMilk2020: posts big blind $0.10
IliyaGLA: sits out 
*** HOLE CARDS ***
LocalFixer: folds 
Kimi1892: folds 
fouktoubaba: raises $0.20 to $0.30
Vaha379: raises $0.70 to $1
HotMilk2020: folds 
fouktoubaba: calls $0.70
*** FLOP *** [Kh Qc Ac]
Vaha379: bets $0.70
fouktoubaba: raises $1.71 to $2.41
Vaha379: folds 
Uncalled bet ($1.71) returned to fouktoubaba
fouktoubaba collected $3.34 from pot
fouktoubaba: doesn't show hand 
*** SUMMARY ***
Total pot $3.50 | Rake $0.16 
Board [Kh Qc Ac]
Seat 1: HotMilk2020 (big blind) folded before Flop
Seat 2: LocalFixer folded before Flop (didn't bet)
Seat 4: Kimi1892 folded before Flop (didn't bet)
Seat 5: fouktoubaba (button) collected ($3.34)
Seat 6: Vaha379 (small blind) folded on the Flop



PokerStars Hand #222962508378:  Hold'em No Limit ($0.05/$0.10 USD) - 2021/01/23 13:00:54 ET
Table 'Lutetia III' 6-max Seat #6 is the button
Seat 1: HotMilk2020 ($9.52 in chips) 
Seat 2: LocalFixer ($21.03 in chips) 
Seat 4: Kimi1892 ($10.50 in chips) 
Seat 5: fouktoubaba ($13.81 in chips) 
Seat 6: Vaha379 ($8.20 in chips) 
HotMilk2020: posts small blind $0.05
LocalFixer: posts big blind $0.10
IliyaGLA: sits out 
*** HOLE CARDS ***
Kimi1892: folds 
fouktoubaba: raises $0.20 to $0.30
Vaha379: folds 
HotMilk2020: folds 
LocalFixer: folds 
Uncalled bet ($0.20) returned to fouktoubaba
fouktoubaba collected $0.25 from pot
fouktoubaba: doesn't show hand 
*** SUMMARY ***
Total pot $0.25 | Rake $0 
Seat 1: HotMilk2020 (small blind) folded before Flop
Seat 2: LocalFixer (big blind) folded before Flop
Seat 4: Kimi1892 folded before Flop (didn't bet)
Seat 5: fouktoubaba collected ($0.25)
Seat 6: Vaha379 (button) folded before Flop (didn't bet)



PokerStars Hand #222962513533:  Hold'em No Limit ($0.05/$0.10 USD) - 2021/01/23 13:01:03 ET
Table 'Lutetia III' 6-max Seat #1 is the button
Seat 1: HotMilk2020 ($9.47 in chips) 
Seat 2: LocalFixer ($20.93 in chips) 
Seat 3: IliyaGLA ($9.85 in chips) 
Seat 4: Kimi1892 ($10.50 in chips) 
Seat 5: fouktoubaba ($13.96 in chips) 
Seat 6: Vaha379 ($10 in chips) 
LocalFixer: posts small blind $0.05
IliyaGLA: posts big blind $0.10
*** HOLE CARDS ***
Kimi1892: folds 
fouktoubaba: raises $0.20 to $0.30
Vaha379: folds 
HotMilk2020: folds 
LocalFixer: folds 
IliyaGLA: raises $0.65 to $0.95
fouktoubaba: folds 
Uncalled bet ($0.65) returned to IliyaGLA
IliyaGLA collected $0.65 from pot
IliyaGLA: doesn't show hand 
*** SUMMARY ***
Total pot $0.65 | Rake $0 
Seat 1: HotMilk2020 (button) folded before Flop (didn't bet)
Seat 2: LocalFixer (small blind) folded before Flop
Seat 3: IliyaGLA (big blind) collected ($0.65)
Seat 4: Kimi1892 folded before Flop (didn't bet)
Seat 5: fouktoubaba folded before Flop
Seat 6: Vaha379 folded before Flop (didn't bet)



PokerStars Hand #222962527364:  Hold'em No Limit ($0.05/$0.10 USD) - 2021/01/23 13:01:26 ET
Table 'Lutetia III' 6-max Seat #2 is the button
Seat 1: HotMilk2020 ($9.47 in chips) 
Seat 2: LocalFixer ($20.88 in chips) 
Seat 3: IliyaGLA ($10.20 in chips) 
Seat 4: Kimi1892 ($10.50 in chips) 
Seat 5: fouktoubaba ($13.66 in chips) 
Seat 6: Vaha379 ($10 in chips) 
IliyaGLA: posts small blind $0.05
Kimi1892: posts big blind $0.10
*** HOLE CARDS ***
fouktoubaba: raises $0.20 to $0.30
Vaha379: folds 
HotMilk2020: folds 
LocalFixer: folds 
IliyaGLA: folds 
Kimi1892: folds 
Uncalled bet ($0.20) returned to fouktoubaba
fouktoubaba collected $0.25 from pot
fouktoubaba: doesn't show hand 
*** SUMMARY ***
Total pot $0.25 | Rake $0 
Seat 1: HotMilk2020 folded before Flop (didn't bet)
Seat 2: LocalFixer (button) folded before Flop (didn't bet)
Seat 3: IliyaGLA (small blind) folded before Flop
Seat 4: Kimi1892 (big blind) folded before Flop
Seat 5: fouktoubaba collected ($0.25)
Seat 6: Vaha379 folded before Flop (didn't bet)



PokerStars Hand #222962532901:  Hold'em No Limit ($0.05/$0.10 USD) - 2021/01/23 13:01:36 ET
Table 'Lutetia III' 6-max Seat #3 is the button
Seat 1: HotMilk2020 ($9.47 in chips) 
Seat 2: LocalFixer ($20.88 in chips) 
Seat 3: IliyaGLA ($10.15 in chips) 
Seat 4: Kimi1892 ($10.40 in chips) 
Seat 5: fouktoubaba ($13.81 in chips) 
Seat 6: Vaha379 ($10 in chips) 
Kimi1892: posts small blind $0.05
fouktoubaba: posts big blind $0.10
*** HOLE CARDS ***
Vaha379: folds 
HotMilk2020: folds 
LocalFixer: raises $0.20 to $0.30
IliyaGLA: folds 
Kimi1892: folds 
fouktoubaba: calls $0.20
*** FLOP *** [6s 8h 9c]
fouktoubaba: checks 
LocalFixer: bets $0.34
fouktoubaba: calls $0.34
*** TURN *** [6s 8h 9c] [Ad]
fouktoubaba: checks 
LocalFixer: bets $1
fouktoubaba: calls $1
*** RIVER *** [6s 8h 9c Ad] [Kh]
fouktoubaba: checks 
LocalFixer: checks 
*** SHOW DOWN ***
fouktoubaba: shows [8s Ah] (two pair, Aces and Eights)
LocalFixer: mucks hand 
fouktoubaba collected $3.18 from pot
*** SUMMARY ***
Total pot $3.33 | Rake $0.15 
Board [6s 8h 9c Ad Kh]
Seat 1: HotMilk2020 folded before Flop (didn't bet)
Seat 2: LocalFixer mucked
Seat 3: IliyaGLA (button) folded before Flop (didn't bet)
Seat 4: Kimi1892 (small blind) folded before Flop
Seat 5: fouktoubaba (big blind) showed [8s Ah] and won ($3.18) with two pair, Aces and Eights
Seat 6: Vaha379 folded before Flop (didn't bet)



PokerStars Hand #222969751149:  Hold'em No Limit ($0.05/$0.10 USD) - 2021/01/23 15:37:27 ET
Table 'Lutetia III' 6-max Seat #4 is the button
Seat 1: tjmmkdi01 ($11.79 in chips) 
Seat 2: Yahan588 ($13.69 in chips) 
Seat 3: ignaciospc ($10 in chips) 
Seat 4: Acedan1369 ($21.75 in chips) 
Seat 5: easywtf ($8.29 in chips) 
Seat 6: fish72o ($12.67 in chips) 
easywtf: posts small blind $0.05
fish72o: posts big blind $0.10
*** HOLE CARDS ***
tjmmkdi01: folds 
Yahan588: folds 
ignaciospc: folds 
Acedan1369: folds 
easywtf: raises $0.15 to $0.25
fish72o: calls $0.15
*** FLOP *** [5d 6s Ts]
easywtf: checks 
fish72o: bets $0.32
easywtf: folds 
Uncalled bet ($0.32) returned to fish72o
fish72o collected $0.48 from pot
fish72o: doesn't show hand 
*** SUMMARY ***
Total pot $0.50 | Rake $0.02 
Board [5d 6s Ts]
Seat 1: tjmmkdi01 folded before Flop (didn't bet)
Seat 2: Yahan588 folded before Flop (didn't bet)
Seat 3: ignaciospc folded before Flop (didn't bet)
Seat 4: Acedan1369 (button) folded before Flop (didn't bet)
Seat 5: easywtf (small blind) folded on the Flop
Seat 6: fish72o (big blind) collected ($0.48)



PokerStars Hand #222969767781:  Hold'em No Limit ($0.05/$0.10 USD) - 2021/01/23 15:37:47 ET
Table 'Lutetia III' 6-max Seat #5 is the button
Seat 1: tjmmkdi01 ($11.79 in chips) 
Seat 2: Yahan588 ($13.69 in chips) 
Seat 3: ignaciospc ($10 in chips) 
Seat 4: Acedan1369 ($21.75 in chips) 
Seat 5: easywtf ($8.04 in chips) 
Seat 6: fish72o ($12.90 in chips) 
fish72o: posts small blind $0.05
tjmmkdi01: posts big blind $0.10
*** HOLE CARDS ***
Yahan588: folds 
ignaciospc: folds 
Acedan1369: folds 
easywtf: raises $0.10 to $0.20
fish72o: folds 
tjmmkdi01: calls $0.10
*** FLOP *** [Js Td Jd]
tjmmkdi01: checks 
easywtf: bets $0.15
tjmmkdi01: folds 
Uncalled bet ($0.15) returned to easywtf
easywtf collected $0.43 from pot
easywtf: doesn't show hand 
*** SUMMARY ***
Total pot $0.45 | Rake $0.02 
Board [Js Td Jd]
Seat 1: tjmmkdi01 (big blind) folded on the Flop
Seat 2: Yahan588 folded before Flop (didn't bet)
Seat 3: ignaciospc folded before Flop (didn't bet)
Seat 4: Acedan1369 folded before Flop (didn't bet)
Seat 5: easywtf (button) collected ($0.43)
Seat 6: fish72o (small blind) folded before Flop



PokerStars Hand #222969783826:  Hold'em No Limit ($0.05/$0.10 USD) - 2021/01/23 15:38:06 ET
Table 'Lutetia III' 6-max Seat #6 is the button
Seat 1: tjmmkdi01 ($11.59 in chips) 
Seat 2: Yahan588 ($13.69 in chips) 
Seat 3: ignaciospc ($10 in chips) 
Seat 4: Acedan1369 ($21.75 in chips) 
Seat 5: easywtf ($8.27 in chips) 
Seat 6: fish72o ($12.85 in chips) 
tjmmkdi01: posts small blind $0.05
Yahan588: posts big blind $0.10
*** HOLE CARDS ***
ignaciospc: folds 
Acedan1369: folds 
easywtf: folds 
fish72o: folds 
tjmmkdi01: calls $0.05
Yahan588: checks 
*** FLOP *** [Kc Ac 5d]
tjmmkdi01: checks 
Yahan588: checks 
*** TURN *** [Kc Ac 5d] [Qc]
tjmmkdi01: checks 
Yahan588: checks 
*** RIVER *** [Kc Ac 5d Qc] [2d]
tjmmkdi01: bets $0.10
Yahan588: calls $0.10
*** SHOW DOWN ***
tjmmkdi01: shows [Ah 8s] (a pair of Aces)
Yahan588: mucks hand 
tjmmkdi01 collected $0.38 from pot
*** SUMMARY ***
Total pot $0.40 | Rake $0.02 
Board [Kc Ac 5d Qc 2d]
Seat 1: tjmmkdi01 (small blind) showed [Ah 8s] and won ($0.38) with a pair of Aces
Seat 2: Yahan588 (big blind) mucked
Seat 3: ignaciospc folded before Flop (didn't bet)
Seat 4: Acedan1369 folded before Flop (didn't bet)
Seat 5: easywtf folded before Flop (didn't bet)
Seat 6: fish72o (button) folded before Flop (didn't bet)



PokerStars Hand #222969801173:  Hold'em No Limit ($0.05/$0.10 USD) - 2021/01/23 15:38:26 ET
Table 'Lutetia III' 6-max Seat #1 is the button
Seat 1: tjmmkdi01 ($11.77 in chips) 
Seat 2: Yahan588 ($13.49 in chips) 
Seat 3: ignaciospc ($10 in chips) 
Seat 4: Acedan1369 ($21.75 in chips) 
Seat 5: easywtf ($8.27 in chips) 
Seat 6: fish72o ($12.85 in chips) 
Yahan588: posts small blind $0.05
ignaciospc: posts big blind $0.10
*** HOLE CARDS ***
Acedan1369: folds 
easywtf: folds 
fish72o: folds 
tjmmkdi01: folds 
Yahan588: raises $0.20 to $0.30
ignaciospc: calls $0.20
*** FLOP *** [8d Jc 3d]
Yahan588: bets $0.19
ignaciospc: calls $0.19
*** TURN *** [8d Jc 3d] [Qc]
Yahan588: bets $0.50
ignaciospc: calls $0.50
*** RIVER *** [8d Jc 3d Qc] [6d]
Yahan588: checks 
ignaciospc: bets $1.46
Yahan588: folds 
Uncalled bet ($1.46) returned to ignaciospc
ignaciospc collected $1.89 from pot
ignaciospc: doesn't show hand 
*** SUMMARY ***
Total pot $1.98 | Rake $0.09 
Board [8d Jc 3d Qc 6d]
Seat 1: tjmmkdi01 (button) folded before Flop (didn't bet)
Seat 2: Yahan588 (small blind) folded on the River
Seat 3: ignaciospc (big blind) collected ($1.89)
Seat 4: Acedan1369 folded before Flop (didn't bet)
Seat 5: easywtf folded before Flop (didn't bet)
Seat 6: fish72o folded before Flop (didn't bet)



PokerStars Hand #222969851354:  Hold'em No Limit ($0.05/$0.10 USD) - 2021/01/23 15:39:17 ET
Table 'Lutetia III' 6-max Seat #2 is the button
Seat 1: tjmmkdi01 ($11.77 in chips) 
Seat 2: Yahan588 ($12.50 in chips) 
Seat 3: ignaciospc ($10.90 in chips) 
Seat 4: Acedan1369 ($21.75 in chips) 
Seat 5: easywtf ($8.27 in chips) 
Seat 6: fish72o ($12.85 in chips) 
ignaciospc: posts small blind $0.05
Acedan1369: posts big blind $0.10
*** HOLE CARDS ***
easywtf: raises $0.20 to $0.30
fish72o: folds 
tjmmkdi01: calls $0.30
Yahan588: folds 
ignaciospc: folds 
Acedan1369: folds 
*** FLOP *** [Ac Th 7h]
easywtf: checks 
tjmmkdi01: checks 
*** TURN *** [Ac Th 7h] [6d]
easywtf: bets $0.25
tjmmkdi01: calls $0.25
*** RIVER *** [Ac Th 7h 6d] [Td]
easywtf: checks 
tjmmkdi01: checks 
*** SHOW DOWN ***
easywtf: shows [Js Jd] (two pair, Jacks and Tens)
tjmmkdi01: mucks hand 
easywtf collected $1.19 from pot
*** SUMMARY ***
Total pot $1.25 | Rake $0.06 
Board [Ac Th 7h 6d Td]
Seat 1: tjmmkdi01 mucked
Seat 2: Yahan588 (button) folded before Flop (didn't bet)
Seat 3: ignaciospc (small blind) folded before Flop
Seat 4: Acedan1369 (big blind) folded before Flop
Seat 5: easywtf showed [Js Jd] and won ($1.19) with two pair, Jacks and Tens
Seat 6: fish72o folded before Flop (didn't bet)



PokerStars Hand #222969882699:  Hold'em No Limit ($0.05/$0.10 USD) - 2021/01/23 15:39:54 ET
Table 'Lutetia III' 6-max Seat #4 is the button
Seat 1: tjmmkdi01 ($11.22 in chips) 
Seat 2: Yahan588 ($12.50 in chips) 
Seat 4: Acedan1369 ($21.65 in chips) 
Seat 5: easywtf ($8.91 in chips) 
Seat 6: fish72o ($12.85 in chips) 
easywtf: posts small blind $0.05
fish72o: posts big blind $0.10
*** HOLE CARDS ***
tjmmkdi01: raises $0.20 to $0.30
Yahan588: calls $0.30
Acedan1369 has timed out
Acedan1369: folds 
easywtf: folds 
fish72o: folds 
*** FLOP *** [4s Jd 7s]
tjmmkdi01: checks 
Yahan588: bets $0.53
tjmmkdi01: calls $0.53
*** TURN *** [4s Jd 7s] [Jc]
tjmmkdi01: checks 
Yahan588: checks 
*** RIVER *** [4s Jd 7s Jc] [6d]
tjmmkdi01: bets $1.73
Yahan588: folds 
Uncalled bet ($1.73) returned to tjmmkdi01
tjmmkdi01 collected $1.73 from pot
tjmmkdi01: doesn't show hand 
*** SUMMARY ***
Total pot $1.81 | Rake $0.08 
Board [4s Jd 7s Jc 6d]
Seat 1: tjmmkdi01 collected ($1.73)
Seat 2: Yahan588 folded on the River
Seat 4: Acedan1369 (button) folded before Flop (didn't bet)
Seat 5: easywtf (small blind) folded before Flop
Seat 6: fish72o (big blind) folded before Flop



PokerStars Hand #222969948472:  Hold'em No Limit ($0.05/$0.10 USD) - 2021/01/23 15:41:12 ET
Table 'Lutetia III' 6-max Seat #5 is the button
Seat 1: tjmmkdi01 ($12.12 in chips) 
Seat 2: Yahan588 ($11.67 in chips) 
Seat 4: Acedan1369 ($21.65 in chips) 
Seat 5: easywtf ($8.86 in chips) 
Seat 6: fish72o ($12.75 in chips) 
fish72o: posts small blind $0.05
tjmmkdi01: posts big blind $0.10
*** HOLE CARDS ***
Yahan588: folds 
Acedan1369: folds 
easywtf: folds 
fish72o: folds 
Uncalled bet ($0.05) returned to tjmmkdi01
tjmmkdi01 collected $0.10 from pot
tjmmkdi01: doesn't show hand 
*** SUMMARY ***
Total pot $0.10 | Rake $0 
Seat 1: tjmmkdi01 (big blind) collected ($0.10)
Seat 2: Yahan588 folded before Flop (didn't bet)
Seat 4: Acedan1369 folded before Flop (didn't bet)
Seat 5: easywtf (button) folded before Flop (didn't bet)
Seat 6: fish72o (small blind) folded before Flop



PokerStars Hand #222969956023:  Hold'em No Limit ($0.05/$0.10 USD) - 2021/01/23 15:41:21 ET
Table 'Lutetia III' 6-max Seat #6 is the button
Seat 1: tjmmkdi01 ($12.17 in chips) 
Seat 2: Yahan588 ($11.67 in chips) 
Seat 4: Acedan1369 ($21.65 in chips) 
Seat 5: easywtf ($8.86 in chips) 
Seat 6: fish72o ($12.70 in chips) 
tjmmkdi01: posts small blind $0.05
Yahan588: posts big blind $0.10
*** HOLE CARDS ***
Acedan1369: folds 
easywtf: folds 
fish72o: raises $0.15 to $0.25
tjmmkdi01: calls $0.20
Yahan588: folds 
*** FLOP *** [4s 6d 9c]
tjmmkdi01: checks 
fish72o: bets $0.51
tjmmkdi01: folds 
Uncalled bet ($0.51) returned to fish72o
fish72o collected $0.57 from pot
fish72o: doesn't show hand 
*** SUMMARY ***
Total pot $0.60 | Rake $0.03 
Board [4s 6d 9c]
Seat 1: tjmmkdi01 (small blind) folded on the Flop
Seat 2: Yahan588 (big blind) folded before Flop
Seat 4: Acedan1369 folded before Flop (didn't bet)
Seat 5: easywtf folded before Flop (didn't bet)
Seat 6: fish72o (button) collected ($0.57)



PokerStars Hand #222969972999:  Hold'em No Limit ($0.05/$0.10 USD) - 2021/01/23 15:41:41 ET
Table 'Lutetia III' 6-max Seat #1 is the button
Seat 1: tjmmkdi01 ($11.92 in chips) 
Seat 2: Yahan588 ($11.57 in chips) 
Seat 4: Acedan1369 ($21.65 in chips) 
Seat 5: easywtf ($8.86 in chips) 
Seat 6: fish72o ($13.02 in chips) 
Yahan588: posts small blind $0.05
Acedan1369: posts big blind $0.10
*** HOLE CARDS ***
easywtf: folds 
fish72o: folds 
tjmmkdi01: folds 
Yahan588: folds 
Uncalled bet ($0.05) returned to Acedan1369
Acedan1369 collected $0.10 from pot
Acedan1369: doesn't show hand 
*** SUMMARY ***
Total pot $0.10 | Rake $0 
Seat 1: tjmmkdi01 (button) folded before Flop (didn't bet)
Seat 2: Yahan588 (small blind) folded before Flop
Seat 4: Acedan1369 (big blind) collected ($0.10)
Seat 5: easywtf folded before Flop (didn't bet)
Seat 6: fish72o folded before Flop (didn't bet)



PokerStars Hand #222969088656:  Hold'em No Limit ($0.05/$0.10 USD) - 2021/01/23 15:24:50 ET
Table 'Lutetia III' 6-max Seat #3 is the button
Seat 1: tjmmkdi01 ($11.46 in chips) 
Seat 2: Yahan588 ($11.83 in chips) 
Seat 3: Foky82 ($10 in chips) 
Seat 4: Acedan1369 ($22.83 in chips) 
Seat 5: easywtf ($9.70 in chips) 
Seat 6: fish72o ($12.11 in chips) 
Acedan1369: posts small blind $0.05
easywtf: posts big blind $0.10
*** HOLE CARDS ***
fish72o: folds 
tjmmkdi01: calls $0.10
Yahan588: raises $0.30 to $0.40
Foky82: folds 
Acedan1369: calls $0.35
easywtf: calls $0.30
tjmmkdi01: folds 
*** FLOP *** [4s 3c Tc]
Acedan1369: checks 
easywtf: checks 
Yahan588: bets $0.66
Acedan1369: calls $0.66
easywtf: calls $0.66
*** TURN *** [4s 3c Tc] [2h]
Acedan1369: checks 
easywtf: checks 
Yahan588: bets $3.20
Acedan1369: folds 
easywtf: folds 
Uncalled bet ($3.20) returned to Yahan588
Yahan588 collected $3.13 from pot
*** SUMMARY ***
Total pot $3.28 | Rake $0.15 
Board [4s 3c Tc 2h]
Seat 1: tjmmkdi01 folded before Flop
Seat 2: Yahan588 collected ($3.13)
Seat 3: Foky82 (button) folded before Flop (didn't bet)
Seat 4: Acedan1369 (small blind) folded on the Turn
Seat 5: easywtf (big blind) folded on the Turn
Seat 6: fish72o folded before Flop (didn't bet)



PokerStars Hand #222969154639:  Hold'em No Limit ($0.05/$0.10 USD) - 2021/01/23 15:26:07 ET
Table 'Lutetia III' 6-max Seat #4 is the button
Seat 1: tjmmkdi01 ($11.36 in chips) 
Seat 2: Yahan588 ($13.90 in chips) 
Seat 3: Foky82 ($10 in chips) 
Seat 4: Acedan1369 ($21.77 in chips) 
Seat 5: easywtf ($8.64 in chips) 
Seat 6: fish72o ($12.11 in chips) 
easywtf: posts small blind $0.05
fish72o: posts big blind $0.10
*** HOLE CARDS ***
tjmmkdi01: folds 
Yahan588: folds 
Foky82: raises $0.20 to $0.30
Acedan1369: folds 
easywtf: folds 
fish72o: folds 
Uncalled bet ($0.20) returned to Foky82
Foky82 collected $0.25 from pot
Foky82: doesn't show hand 
*** SUMMARY ***
Total pot $0.25 | Rake $0 
Seat 1: tjmmkdi01 folded before Flop (didn't bet)
Seat 2: Yahan588 folded before Flop (didn't bet)
Seat 3: Foky82 collected ($0.25)
Seat 4: Acedan1369 (button) folded before Flop (didn't bet)
Seat 5: easywtf (small blind) folded before Flop
Seat 6: fish72o (big blind) folded before Flop



PokerStars Hand #222969172037:  Hold'em No Limit ($0.05/$0.10 USD) - 2021/01/23 15:26:28 ET
Table 'Lutetia III' 6-max Seat #5 is the button
Seat 1: tjmmkdi01 ($11.36 in chips) 
Seat 2: Yahan588 ($13.90 in chips) 
Seat 3: Foky82 ($10.15 in chips) 
Seat 4: Acedan1369 ($21.77 in chips) 
Seat 5: easywtf ($8.59 in chips) 
Seat 6: fish72o ($12.01 in chips) 
fish72o: posts small blind $0.05
tjmmkdi01: posts big blind $0.10
*** HOLE CARDS ***
Yahan588: folds 
Foky82: folds 
Acedan1369: raises $0.15 to $0.25
easywtf: folds 
fish72o: folds 
tjmmkdi01: folds 
Uncalled bet ($0.15) returned to Acedan1369
Acedan1369 collected $0.25 from pot
Acedan1369: doesn't show hand 
*** SUMMARY ***
Total pot $0.25 | Rake $0 
Seat 1: tjmmkdi01 (big blind) folded before Flop
Seat 2: Yahan588 folded before Flop (didn't bet)
Seat 3: Foky82 folded before Flop (didn't bet)
Seat 4: Acedan1369 collected ($0.25)
Seat 5: easywtf (button) folded before Flop (didn't bet)
Seat 6: fish72o (small blind) folded before Flop



PokerStars Hand #222969186884:  Hold'em No Limit ($0.05/$0.10 USD) - 2021/01/23 15:26:45 ET
Table 'Lutetia III' 6-max Seat #6 is the button
Seat 1: tjmmkdi01 ($11.26 in chips) 
Seat 2: Yahan588 ($13.90 in chips) 
Seat 3: Foky82 ($10.15 in chips) 
Seat 4: Acedan1369 ($21.92 in chips) 
Seat 5: easywtf ($8.59 in chips) 
Seat 6: fish72o ($11.96 in chips) 
tjmmkdi01: posts small blind $0.05
Yahan588: posts big blind $0.10
*** HOLE CARDS ***
Foky82: folds 
Acedan1369: raises $0.15 to $0.25
easywtf: folds 
fish72o: folds 
tjmmkdi01: folds 
Yahan588: folds 
Uncalled bet ($0.15) returned to Acedan1369
Acedan1369 collected $0.25 from pot
Acedan1369: doesn't show hand 
*** SUMMARY ***
Total pot $0.25 | Rake $0 
Seat 1: tjmmkdi01 (small blind) folded before Flop
Seat 2: Yahan588 (big blind) folded before Flop
Seat 3: Foky82 folded before Flop (didn't bet)
Seat 4: Acedan1369 collected ($0.25)
Seat 5: easywtf folded before Flop (didn't bet)
Seat 6: fish72o (button) folded before Flop (didn't bet)



PokerStars Hand #222969211862:  Hold'em No Limit ($0.05/$0.10 USD) - 2021/01/23 15:27:14 ET
Table 'Lutetia III' 6-max Seat #1 is the button
Seat 1: tjmmkdi01 ($11.21 in chips) 
Seat 2: Yahan588 ($13.80 in chips) 
Seat 3: Foky82 ($10.15 in chips) 
Seat 4: Acedan1369 ($22.07 in chips) 
Seat 5: easywtf ($8.59 in chips) 
Seat 6: fish72o ($11.96 in chips) 
Yahan588: posts small blind $0.05
Foky82: posts big blind $0.10
*** HOLE CARDS ***
Acedan1369: folds 
easywtf: folds 
fish72o: folds 
tjmmkdi01: folds 
Yahan588: folds 
Uncalled bet ($0.05) returned to Foky82
Foky82 collected $0.10 from pot
Foky82: doesn't show hand 
*** SUMMARY ***
Total pot $0.10 | Rake $0 
Seat 1: tjmmkdi01 (button) folded before Flop (didn't bet)
Seat 2: Yahan588 (small blind) folded before Flop
Seat 3: Foky82 (big blind) collected ($0.10)
Seat 4: Acedan1369 folded before Flop (didn't bet)
Seat 5: easywtf folded before Flop (didn't bet)
Seat 6: fish72o folded before Flop (didn't bet)



PokerStars Hand #222969217885:  Hold'em No Limit ($0.05/$0.10 USD) - 2021/01/23 15:27:21 ET
Table 'Lutetia III' 6-max Seat #2 is the button
Seat 1: tjmmkdi01 ($11.21 in chips) 
Seat 2: Yahan588 ($13.75 in chips) 
Seat 3: Foky82 ($10.20 in chips) 
Seat 4: Acedan1369 ($22.07 in chips) 
Seat 5: easywtf ($8.59 in chips) 
Seat 6: fish72o ($11.96 in chips) 
Foky82: posts small blind $0.05
Acedan1369: posts big blind $0.10
*** HOLE CARDS ***
easywtf has timed out
easywtf: folds 
fish72o: raises $0.15 to $0.25
tjmmkdi01: folds 
Yahan588: folds 
Foky82: folds 
Acedan1369: folds 
Uncalled bet ($0.15) returned to fish72o
fish72o collected $0.25 from pot
fish72o: doesn't show hand 
*** SUMMARY ***
Total pot $0.25 | Rake $0 
Seat 1: tjmmkdi01 folded before Flop (didn't bet)
Seat 2: Yahan588 (button) folded before Flop (didn't bet)
Seat 3: Foky82 (small blind) folded before Flop
Seat 4: Acedan1369 (big blind) folded before Flop
Seat 5: easywtf folded before Flop (didn't bet)
Seat 6: fish72o collected ($0.25)



PokerStars Hand #222969239607:  Hold'em No Limit ($0.05/$0.10 USD) - 2021/01/23 15:27:47 ET
Table 'Lutetia III' 6-max Seat #3 is the button
Seat 1: tjmmkdi01 ($11.21 in chips) 
Seat 2: Yahan588 ($13.75 in chips) 
Seat 3: Foky82 ($10.15 in chips) 
Seat 4: Acedan1369 ($21.97 in chips) 
Seat 5: easywtf ($8.59 in chips) 
Seat 6: fish72o ($12.11 in chips) 
Acedan1369: posts small blind $0.05
easywtf: posts big blind $0.10
*** HOLE CARDS ***
fish72o: folds 
tjmmkdi01: calls $0.10
Yahan588: folds 
Foky82: folds 
Acedan1369: calls $0.05
easywtf: checks 
*** FLOP *** [9d 3s 4h]
Acedan1369: checks 
easywtf: checks 
tjmmkdi01: checks 
*** TURN *** [9d 3s 4h] [Th]
Acedan1369: checks 
easywtf: checks 
tjmmkdi01: checks 
*** RIVER *** [9d 3s 4h Th] [Td]
Acedan1369: checks 
easywtf: checks 
tjmmkdi01: bets $0.10
Acedan1369: calls $0.10
easywtf: folds 
*** SHOW DOWN ***
tjmmkdi01: shows [2c Jc] (a pair of Tens)
Acedan1369: shows [Ah 2d] (a pair of Tens - Ace kicker)
Acedan1369 collected $0.48 from pot
*** SUMMARY ***
Total pot $0.50 | Rake $0.02 
Board [9d 3s 4h Th Td]
Seat 1: tjmmkdi01 showed [2c Jc] and lost with a pair of Tens
Seat 2: Yahan588 folded before Flop (didn't bet)
Seat 3: Foky82 (button) folded before Flop (didn't bet)
Seat 4: Acedan1369 (small blind) showed [Ah 2d] and won ($0.48) with a pair of Tens
Seat 5: easywtf (big blind) folded on the River
Seat 6: fish72o folded before Flop (didn't bet)



PokerStars Hand #222969273683:  Hold'em No Limit ($0.05/$0.10 USD) - 2021/01/23 15:28:27 ET
Table 'Lutetia III' 6-max Seat #4 is the button
Seat 1: tjmmkdi01 ($11.01 in chips) 
Seat 2: Yahan588 ($13.75 in chips) 
Seat 3: Foky82 ($10.15 in chips) 
Seat 4: Acedan1369 ($22.25 in chips) 
Seat 5: easywtf ($8.49 in chips) 
Seat 6: fish72o ($12.11 in chips) 
easywtf: posts small blind $0.05
fish72o: posts big blind $0.10
*** HOLE CARDS ***
tjmmkdi01: folds 
Yahan588: raises $0.20 to $0.30
Foky82: folds 
Acedan1369: raises $0.55 to $0.85
easywtf: folds 
fish72o: folds 
Yahan588: folds 
Uncalled bet ($0.55) returned to Acedan1369
Acedan1369 collected $0.75 from pot
Acedan1369: doesn't show hand 
*** SUMMARY ***
Total pot $0.75 | Rake $0 
Seat 1: tjmmkdi01 folded before Flop (didn't bet)
Seat 2: Yahan588 folded before Flop
Seat 3: Foky82 folded before Flop (didn't bet)
Seat 4: Acedan1369 (button) collected ($0.75)
Seat 5: easywtf (small blind) folded before Flop
Seat 6: fish72o (big blind) folded before Flop



PokerStars Hand #222969291802:  Hold'em No Limit ($0.05/$0.10 USD) - 2021/01/23 15:28:48 ET
Table 'Lutetia III' 6-max Seat #5 is the button
Seat 1: tjmmkdi01 ($11.01 in chips) 
Seat 2: Yahan588 ($13.45 in chips) 
Seat 3: Foky82 ($10.15 in chips) 
Seat 4: Acedan1369 ($22.70 in chips) 
Seat 5: easywtf ($8.44 in chips) 
Seat 6: fish72o ($12.01 in chips) 
fish72o: posts small blind $0.05
tjmmkdi01: posts big blind $0.10
*** HOLE CARDS ***
Yahan588: folds 
Foky82: folds 
Acedan1369: folds 
easywtf has timed out
easywtf: folds 
fish72o: raises $0.15 to $0.25
tjmmkdi01: folds 
Uncalled bet ($0.15) returned to fish72o
fish72o collected $0.20 from pot
fish72o: doesn't show hand 
*** SUMMARY ***
Total pot $0.20 | Rake $0 
Seat 1: tjmmkdi01 (big blind) folded before Flop
Seat 2: Yahan588 folded before Flop (didn't bet)
Seat 3: Foky82 folded before Flop (didn't bet)
Seat 4: Acedan1369 folded before Flop (didn't bet)
Seat 5: easywtf (button) folded before Flop (didn't bet)
Seat 6: fish72o (small blind) collected ($0.20)



PokerStars Hand #222969320291:  Hold'em No Limit ($0.05/$0.10 USD) - 2021/01/23 15:29:21 ET
Table 'Lutetia III' 6-max Seat #6 is the button
Seat 1: tjmmkdi01 ($10.91 in chips) 
Seat 2: Yahan588 ($13.45 in chips) 
Seat 3: Foky82 ($10.15 in chips) 
Seat 4: Acedan1369 ($22.70 in chips) 
Seat 5: easywtf ($8.44 in chips) 
Seat 6: fish72o ($12.11 in chips) 
tjmmkdi01: posts small blind $0.05
Yahan588: posts big blind $0.10
*** HOLE CARDS ***
Foky82: folds 
Acedan1369: folds 
easywtf: folds 
fish72o: raises $0.15 to $0.25
tjmmkdi01: folds 
Yahan588: folds 
Uncalled bet ($0.15) returned to fish72o
fish72o collected $0.25 from pot
fish72o: doesn't show hand 
*** SUMMARY ***
Total pot $0.25 | Rake $0 
Seat 1: tjmmkdi01 (small blind) folded before Flop
Seat 2: Yahan588 (big blind) folded before Flop
Seat 3: Foky82 folded before Flop (didn't bet)
Seat 4: Acedan1369 folded before Flop (didn't bet)
Seat 5: easywtf folded before Flop (didn't bet)
Seat 6: fish72o (button) collected ($0.25)



PokerStars Hand #222969334168:  Hold'em No Limit ($0.05/$0.10 USD) - 2021/01/23 15:29:37 ET
Table 'Lutetia III' 6-max Seat #1 is the button
Seat 1: tjmmkdi01 ($10.86 in chips) 
Seat 2: Yahan588 ($13.35 in chips) 
Seat 4: Acedan1369 ($22.70 in chips) 
Seat 5: easywtf ($8.44 in chips) 
Seat 6: fish72o ($12.26 in chips) 
Yahan588: posts small blind $0.05
Foky82: is sitting out 
Acedan1369: posts big blind $0.10
*** HOLE CARDS ***
easywtf: raises $0.20 to $0.30
Foky82 leaves the table
fish72o: folds 
tjmmkdi01: folds 
Yahan588: folds 
Acedan1369: folds 
Uncalled bet ($0.20) returned to easywtf
easywtf collected $0.25 from pot
easywtf: doesn't show hand 
*** SUMMARY ***
Total pot $0.25 | Rake $0 
Seat 1: tjmmkdi01 (button) folded before Flop (didn't bet)
Seat 2: Yahan588 (small blind) folded before Flop
Seat 4: Acedan1369 (big blind) folded before Flop
Seat 5: easywtf collected ($0.25)
Seat 6: fish72o folded before Flop (didn't bet)



PokerStars Hand #222969346850:  Hold'em No Limit ($0.05/$0.10 USD) - 2021/01/23 15:29:52 ET
Table 'Lutetia III' 6-max Seat #2 is the button
Seat 1: tjmmkdi01 ($10.86 in chips) 
Seat 2: Yahan588 ($13.30 in chips) 
Seat 4: Acedan1369 ($22.60 in chips) 
Seat 5: easywtf ($8.59 in chips) 
Seat 6: fish72o ($12.26 in chips) 
Acedan1369: posts small blind $0.05
easywtf: posts big blind $0.10
*** HOLE CARDS ***
fish72o: folds 
tjmmkdi01: calls $0.10
Yahan588: raises $0.30 to $0.40
Acedan1369: folds 
easywtf: calls $0.30
tjmmkdi01: folds 
*** FLOP *** [7h 4d 2h]
easywtf: checks 
Yahan588: checks 
*** TURN *** [7h 4d 2h] [Jh]
easywtf: checks 
Yahan588: checks 
*** RIVER *** [7h 4d 2h Jh] [8s]
easywtf: checks 
Yahan588: checks 
*** SHOW DOWN ***
easywtf: shows [Th Qd] (high card Queen)
Yahan588: shows [6d 6h] (a pair of Sixes)
Yahan588 collected $0.91 from pot
*** SUMMARY ***
Total pot $0.95 | Rake $0.04 
Board [7h 4d 2h Jh 8s]
Seat 1: tjmmkdi01 folded before Flop
Seat 2: Yahan588 (button) showed [6d 6h] and won ($0.91) with a pair of Sixes
Seat 4: Acedan1369 (small blind) folded before Flop
Seat 5: easywtf (big blind) showed [Th Qd] and lost with high card Queen
Seat 6: fish72o folded before Flop (didn't bet)



PokerStars Hand #222969382981:  Hold'em No Limit ($0.05/$0.10 USD) - 2021/01/23 15:30:33 ET
Table 'Lutetia III' 6-max Seat #4 is the button
Seat 1: tjmmkdi01 ($10.76 in chips) 
Seat 2: Yahan588 ($13.81 in chips) 
Seat 4: Acedan1369 ($22.55 in chips) 
Seat 5: easywtf ($8.19 in chips) 
Seat 6: fish72o ($12.26 in chips) 
easywtf: posts small blind $0.05
fish72o: posts big blind $0.10
*** HOLE CARDS ***
tjmmkdi01: calls $0.10
Yahan588: folds 
Acedan1369: folds 
easywtf: folds 
fish72o: checks 
*** FLOP *** [2s 6s 6c]
fish72o: checks 
tjmmkdi01: checks 
*** TURN *** [2s 6s 6c] [Ts]
fish72o: bets $0.16
tjmmkdi01: calls $0.16
*** RIVER *** [2s 6s 6c Ts] [8c]
wils482 joins the table at seat #3 
fish72o: bets $0.36
tjmmkdi01: calls $0.36
*** SHOW DOWN ***
fish72o: shows [7h 9c] (a straight, Six to Ten)
tjmmkdi01: mucks hand 
fish72o collected $1.23 from pot
*** SUMMARY ***
Total pot $1.29 | Rake $0.06 
Board [2s 6s 6c Ts 8c]
Seat 1: tjmmkdi01 mucked
Seat 2: Yahan588 folded before Flop (didn't bet)
Seat 4: Acedan1369 (button) folded before Flop (didn't bet)
Seat 5: easywtf (small blind) folded before Flop
Seat 6: fish72o (big blind) showed [7h 9c] and won ($1.23) with a straight, Six to Ten



PokerStars Hand #222969406480:  Hold'em No Limit ($0.05/$0.10 USD) - 2021/01/23 15:31:01 ET
Table 'Lutetia III' 6-max Seat #5 is the button
Seat 1: tjmmkdi01 ($10.14 in chips) 
Seat 2: Yahan588 ($13.81 in chips) 
Seat 4: Acedan1369 ($22.55 in chips) 
Seat 5: easywtf ($8.14 in chips) 
Seat 6: fish72o ($12.87 in chips) 
fish72o: posts small blind $0.05
tjmmkdi01: posts big blind $0.10
wils482: sits out 
*** HOLE CARDS ***
Yahan588: folds 
Acedan1369: folds 
easywtf: folds 
fish72o: folds 
Uncalled bet ($0.05) returned to tjmmkdi01
tjmmkdi01 collected $0.10 from pot
tjmmkdi01: doesn't show hand 
*** SUMMARY ***
Total pot $0.10 | Rake $0 
Seat 1: tjmmkdi01 (big blind) collected ($0.10)
Seat 2: Yahan588 folded before Flop (didn't bet)
Seat 4: Acedan1369 folded before Flop (didn't bet)
Seat 5: easywtf (button) folded before Flop (didn't bet)
Seat 6: fish72o (small blind) folded before Flop



PokerStars Hand #222969429631:  Hold'em No Limit ($0.05/$0.10 USD) - 2021/01/23 15:31:14 ET
Table 'Lutetia III' 6-max Seat #6 is the button
Seat 1: tjmmkdi01 ($10.19 in chips) 
Seat 2: Yahan588 ($13.81 in chips) 
Seat 3: wils482 ($8 in chips) 
Seat 4: Acedan1369 ($22.55 in chips) 
Seat 5: easywtf ($8.14 in chips) 
Seat 6: fish72o ($12.82 in chips) 
tjmmkdi01: posts small blind $0.05
Yahan588: posts big blind $0.10
wils482: posts big blind $0.10
*** HOLE CARDS ***
wils482: checks 
Acedan1369: folds 
easywtf has timed out
easywtf: folds 
fish72o: folds 
tjmmkdi01: raises $0.30 to $0.40
Yahan588: folds 
wils482: calls $0.30
*** FLOP *** [Ks Th 8s]
tjmmkdi01: bets $0.60
wils482: folds 
Uncalled bet ($0.60) returned to tjmmkdi01
tjmmkdi01 collected $0.86 from pot
tjmmkdi01: doesn't show hand 
*** SUMMARY ***
Total pot $0.90 | Rake $0.04 
Board [Ks Th 8s]
Seat 1: tjmmkdi01 (small blind) collected ($0.86)
Seat 2: Yahan588 (big blind) folded before Flop
Seat 3: wils482 folded on the Flop
Seat 4: Acedan1369 folded before Flop (didn't bet)
Seat 5: easywtf folded before Flop (didn't bet)
Seat 6: fish72o (button) folded before Flop (didn't bet)



PokerStars Hand #222969460243:  Hold'em No Limit ($0.05/$0.10 USD) - 2021/01/23 15:31:49 ET
Table 'Lutetia III' 6-max Seat #1 is the button
Seat 1: tjmmkdi01 ($10.65 in chips) 
Seat 2: Yahan588 ($13.71 in chips) 
Seat 3: wils482 ($7.60 in chips) 
Seat 4: Acedan1369 ($22.55 in chips) 
Seat 5: easywtf ($8.14 in chips) 
Seat 6: fish72o ($12.82 in chips) 
Yahan588: posts small blind $0.05
wils482: posts big blind $0.10
*** HOLE CARDS ***
Acedan1369 has timed out
Acedan1369: folds 
easywtf: folds 
fish72o: folds 
tjmmkdi01: calls $0.10
Yahan588: folds 
wils482: checks 
*** FLOP *** [4d Tc 9h]
wils482: checks 
tjmmkdi01: bets $0.20
wils482: calls $0.20
*** TURN *** [4d Tc 9h] [7s]
wils482: bets $0.31
tjmmkdi01: calls $0.31
*** RIVER *** [4d Tc 9h 7s] [5h]
wils482: bets $1.21
tjmmkdi01: calls $1.21
*** SHOW DOWN ***
wils482: shows [7c Ac] (a pair of Sevens)
tjmmkdi01: shows [8h 9c] (a pair of Nines)
tjmmkdi01 collected $3.52 from pot
*** SUMMARY ***
Total pot $3.69 | Rake $0.17 
Board [4d Tc 9h 7s 5h]
Seat 1: tjmmkdi01 (button) showed [8h 9c] and won ($3.52) with a pair of Nines
Seat 2: Yahan588 (small blind) folded before Flop
Seat 3: wils482 (big blind) showed [7c Ac] and lost with a pair of Sevens
Seat 4: Acedan1369 folded before Flop (didn't bet)
Seat 5: easywtf folded before Flop (didn't bet)
Seat 6: fish72o folded before Flop (didn't bet)



PokerStars Hand #222969494575:  Hold'em No Limit ($0.05/$0.10 USD) - 2021/01/23 15:32:29 ET
Table 'Lutetia III' 6-max Seat #2 is the button
Seat 1: tjmmkdi01 ($12.35 in chips) 
Seat 2: Yahan588 ($13.66 in chips) 
Seat 3: wils482 ($5.78 in chips) 
Seat 4: Acedan1369 ($22.55 in chips) 
Seat 5: easywtf ($8.14 in chips) 
Seat 6: fish72o ($12.82 in chips) 
wils482: posts small blind $0.05
Acedan1369: posts big blind $0.10
*** HOLE CARDS ***
easywtf: folds 
fish72o: folds 
tjmmkdi01: folds 
Yahan588: folds 
wils482: calls $0.05
Acedan1369: checks 
*** FLOP *** [5s Qd Qs]
wils482: checks 
Acedan1369: checks 
*** TURN *** [5s Qd Qs] [9d]
wils482: bets $0.10
Acedan1369: folds 
Uncalled bet ($0.10) returned to wils482
wils482 collected $0.19 from pot
wils482: doesn't show hand 
*** SUMMARY ***
Total pot $0.20 | Rake $0.01 
Board [5s Qd Qs 9d]
Seat 1: tjmmkdi01 folded before Flop (didn't bet)
Seat 2: Yahan588 (button) folded before Flop (didn't bet)
Seat 3: wils482 (small blind) collected ($0.19)
Seat 4: Acedan1369 (big blind) folded on the Turn
Seat 5: easywtf folded before Flop (didn't bet)
Seat 6: fish72o folded before Flop (didn't bet)



PokerStars Hand #222969530837:  Hold'em No Limit ($0.05/$0.10 USD) - 2021/01/23 15:33:11 ET
Table 'Lutetia III' 6-max Seat #3 is the button
Seat 1: tjmmkdi01 ($12.35 in chips) 
Seat 2: Yahan588 ($13.66 in chips) 
Seat 3: wils482 ($5.87 in chips) 
Seat 4: Acedan1369 ($22.45 in chips) 
Seat 5: easywtf ($8.14 in chips) 
Seat 6: fish72o ($12.82 in chips) 
Acedan1369: posts small blind $0.05
easywtf: posts big blind $0.10
*** HOLE CARDS ***
fish72o: folds 
tjmmkdi01: folds 
Yahan588: raises $0.20 to $0.30
wils482: calls $0.30
Acedan1369: calls $0.25
easywtf: folds 
*** FLOP *** [Qh 5d 2c]
Acedan1369: checks 
Yahan588: checks 
wils482: bets $0.48
Acedan1369: folds 
Yahan588: calls $0.48
*** TURN *** [Qh 5d 2c] [Kc]
Yahan588: checks 
wils482: checks 
*** RIVER *** [Qh 5d 2c Kc] [Ts]
Yahan588: checks 
wils482: checks 
*** SHOW DOWN ***
Yahan588: shows [5h 6h] (a pair of Fives)
wils482: shows [8s 8h] (a pair of Eights)
wils482 collected $1.87 from pot
*** SUMMARY ***
Total pot $1.96 | Rake $0.09 
Board [Qh 5d 2c Kc Ts]
Seat 1: tjmmkdi01 folded before Flop (didn't bet)
Seat 2: Yahan588 showed [5h 6h] and lost with a pair of Fives
Seat 3: wils482 (button) showed [8s 8h] and won ($1.87) with a pair of Eights
Seat 4: Acedan1369 (small blind) folded on the Flop
Seat 5: easywtf (big blind) folded before Flop
Seat 6: fish72o folded before Flop (didn't bet)



PokerStars Hand #222969593446:  Hold'em No Limit ($0.05/$0.10 USD) - 2021/01/23 15:34:24 ET
Table 'Lutetia III' 6-max Seat #4 is the button
Seat 1: tjmmkdi01 ($12.35 in chips) 
Seat 2: Yahan588 ($12.88 in chips) 
Seat 3: wils482 ($6.96 in chips) 
Seat 4: Acedan1369 ($22.15 in chips) 
Seat 5: easywtf ($8.04 in chips) 
Seat 6: fish72o ($12.82 in chips) 
easywtf: posts small blind $0.05
fish72o: posts big blind $0.10
*** HOLE CARDS ***
tjmmkdi01: calls $0.10
Yahan588: folds 
wils482: raises $0.35 to $0.45
Acedan1369: folds 
easywtf: folds 
fish72o: folds 
tjmmkdi01: folds 
Uncalled bet ($0.35) returned to wils482
wils482 collected $0.35 from pot
wils482: doesn't show hand 
*** SUMMARY ***
Total pot $0.35 | Rake $0 
Seat 1: tjmmkdi01 folded before Flop
Seat 2: Yahan588 folded before Flop (didn't bet)
Seat 3: wils482 collected ($0.35)
Seat 4: Acedan1369 (button) folded before Flop (didn't bet)
Seat 5: easywtf (small blind) folded before Flop
Seat 6: fish72o (big blind) folded before Flop



PokerStars Hand #222969623825:  Hold'em No Limit ($0.05/$0.10 USD) - 2021/01/23 15:34:58 ET
Table 'Lutetia III' 6-max Seat #5 is the button
Seat 1: tjmmkdi01 ($12.25 in chips) 
Seat 2: Yahan588 ($12.88 in chips) 
Seat 3: wils482 ($7.21 in chips) 
Seat 4: Acedan1369 ($22.15 in chips) 
Seat 5: easywtf ($7.99 in chips) 
Seat 6: fish72o ($12.72 in chips) 
fish72o: posts small blind $0.05
tjmmkdi01: posts big blind $0.10
*** HOLE CARDS ***
Yahan588: folds 
wils482: folds 
Acedan1369: raises $0.15 to $0.25
wils482 leaves the table
easywtf: raises $0.65 to $0.90
fish72o: folds 
ignaciospc joins the table at seat #3 
tjmmkdi01: folds 
Acedan1369: folds 
Uncalled bet ($0.65) returned to easywtf
easywtf collected $0.65 from pot
easywtf: doesn't show hand 
*** SUMMARY ***
Total pot $0.65 | Rake $0 
Seat 1: tjmmkdi01 (big blind) folded before Flop
Seat 2: Yahan588 folded before Flop (didn't bet)
Seat 3: wils482 folded before Flop (didn't bet)
Seat 4: Acedan1369 folded before Flop
Seat 5: easywtf (button) collected ($0.65)
Seat 6: fish72o (small blind) folded before Flop



PokerStars Hand #222969649882:  Hold'em No Limit ($0.05/$0.10 USD) - 2021/01/23 15:35:28 ET
Table 'Lutetia III' 6-max Seat #6 is the button
Seat 1: tjmmkdi01 ($12.15 in chips) 
Seat 2: Yahan588 ($12.88 in chips) 
Seat 3: ignaciospc ($10 in chips) 
Seat 4: Acedan1369 ($21.90 in chips) 
Seat 5: easywtf ($8.39 in chips) 
Seat 6: fish72o ($12.67 in chips) 
tjmmkdi01: posts small blind $0.05
Yahan588: posts big blind $0.10
ignaciospc: posts big blind $0.10
*** HOLE CARDS ***
ignaciospc: checks 
Acedan1369: folds 
easywtf: folds 
fish72o: folds 
tjmmkdi01: calls $0.05
Yahan588: raises $0.60 to $0.70
ignaciospc: folds 
tjmmkdi01: folds 
Uncalled bet ($0.60) returned to Yahan588
Yahan588 collected $0.30 from pot
*** SUMMARY ***
Total pot $0.30 | Rake $0 
Seat 1: tjmmkdi01 (small blind) folded before Flop
Seat 2: Yahan588 (big blind) collected ($0.30)
Seat 3: ignaciospc folded before Flop (didn't bet)
Seat 4: Acedan1369 folded before Flop (didn't bet)
Seat 5: easywtf folded before Flop (didn't bet)
Seat 6: fish72o (button) folded before Flop (didn't bet)



PokerStars Hand #222969673178:  Hold'em No Limit ($0.05/$0.10 USD) - 2021/01/23 15:35:56 ET
Table 'Lutetia III' 6-max Seat #1 is the button
Seat 1: tjmmkdi01 ($12.05 in chips) 
Seat 2: Yahan588 ($13.08 in chips) 
Seat 3: ignaciospc ($10 in chips) 
Seat 4: Acedan1369 ($21.90 in chips) 
Seat 5: easywtf ($8.39 in chips) 
Seat 6: fish72o ($12.67 in chips) 
Yahan588: posts small blind $0.05
ignaciospc: posts big blind $0.10
*** HOLE CARDS ***
Acedan1369: folds 
easywtf: folds 
fish72o: folds 
tjmmkdi01: calls $0.10
Yahan588: folds 
ignaciospc: checks 
*** FLOP *** [3h Ad 4d]
ignaciospc: checks 
tjmmkdi01: checks 
*** TURN *** [3h Ad 4d] [Kd]
ignaciospc: checks 
tjmmkdi01: checks 
*** RIVER *** [3h Ad 4d Kd] [Th]
ignaciospc: checks 
tjmmkdi01: bets $0.10
ignaciospc: folds 
Uncalled bet ($0.10) returned to tjmmkdi01
tjmmkdi01 collected $0.24 from pot
tjmmkdi01: doesn't show hand 
*** SUMMARY ***
Total pot $0.25 | Rake $0.01 
Board [3h Ad 4d Kd Th]
Seat 1: tjmmkdi01 (button) collected ($0.24)
Seat 2: Yahan588 (small blind) folded before Flop
Seat 3: ignaciospc (big blind) folded on the River
Seat 4: Acedan1369 folded before Flop (didn't bet)
Seat 5: easywtf folded before Flop (didn't bet)
Seat 6: fish72o folded before Flop (didn't bet)



PokerStars Hand #222969702033:  Hold'em No Limit ($0.05/$0.10 USD) - 2021/01/23 15:36:29 ET
Table 'Lutetia III' 6-max Seat #2 is the button
Seat 1: tjmmkdi01 ($12.19 in chips) 
Seat 2: Yahan588 ($13.03 in chips) 
Seat 3: ignaciospc ($10 in chips) 
Seat 4: Acedan1369 ($21.90 in chips) 
Seat 5: easywtf ($8.39 in chips) 
Seat 6: fish72o ($12.67 in chips) 
ignaciospc: posts small blind $0.05
Acedan1369: posts big blind $0.10
*** HOLE CARDS ***
easywtf: folds 
fish72o: folds 
tjmmkdi01: folds 
Yahan588: raises $0.15 to $0.25
ignaciospc: folds 
Acedan1369: folds 
Uncalled bet ($0.15) returned to Yahan588
Yahan588 collected $0.25 from pot
*** SUMMARY ***
Total pot $0.25 | Rake $0 
Seat 1: tjmmkdi01 folded before Flop (didn't bet)
Seat 2: Yahan588 (button) collected ($0.25)
Seat 3: ignaciospc (small blind) folded before Flop
Seat 4: Acedan1369 (big blind) folded before Flop
Seat 5: easywtf folded before Flop (didn't bet)
Seat 6: fish72o folded before Flop (didn't bet)



PokerStars Hand #222969716194:  Hold'em No Limit ($0.05/$0.10 USD) - 2021/01/23 15:36:46 ET
Table 'Lutetia III' 6-max Seat #3 is the button
Seat 1: tjmmkdi01 ($12.19 in chips) 
Seat 2: Yahan588 ($13.18 in chips) 
Seat 3: ignaciospc ($10 in chips) 
Seat 4: Acedan1369 ($21.80 in chips) 
Seat 5: easywtf ($8.39 in chips) 
Seat 6: fish72o ($12.67 in chips) 
Acedan1369: posts small blind $0.05
easywtf: posts big blind $0.10
*** HOLE CARDS ***
fish72o: folds 
tjmmkdi01: calls $0.10
Yahan588: raises $0.30 to $0.40
ignaciospc: folds 
Acedan1369: folds 
easywtf: folds 
tjmmkdi01: calls $0.30
*** FLOP *** [Kh 4h 5s]
tjmmkdi01: checks 
Yahan588: bets $0.58
tjmmkdi01: folds 
Uncalled bet ($0.58) returned to Yahan588
Yahan588 collected $0.91 from pot
*** SUMMARY ***
Total pot $0.95 | Rake $0.04 
Board [Kh 4h 5s]
Seat 1: tjmmkdi01 folded on the Flop
Seat 2: Yahan588 collected ($0.91)
Seat 3: ignaciospc (button) folded before Flop (didn't bet)
Seat 4: Acedan1369 (small blind) folded before Flop
Seat 5: easywtf (big blind) folded before Flop
Seat 6: fish72o folded before Flop (didn't bet)



PokerStars Hand #222969981734:  Hold'em No Limit ($0.05/$0.10 USD) - 2021/01/23 15:41:52 ET
Table 'Lutetia III' 6-max Seat #2 is the button
Seat 1: tjmmkdi01 ($11.92 in chips) 
Seat 2: Yahan588 ($11.52 in chips) 
Seat 4: Acedan1369 ($21.70 in chips) 
Seat 5: easywtf ($8.86 in chips) 
Seat 6: fish72o ($13.02 in chips) 
Acedan1369: posts small blind $0.05
easywtf: posts big blind $0.10
*** HOLE CARDS ***
fish72o: folds 
tjmmkdi01: folds 
Yahan588: raises $0.15 to $0.25
Acedan1369: folds 
easywtf: calls $0.15
*** FLOP *** [6s Kd Jc]
easywtf: checks 
Yahan588: checks 
*** TURN *** [6s Kd Jc] [7c]
easywtf: checks 
Yahan588: checks 
*** RIVER *** [6s Kd Jc 7c] [2d]
easywtf: checks 
Yahan588: bets $0.17
easywtf: folds 
Uncalled bet ($0.17) returned to Yahan588
Yahan588 collected $0.53 from pot
*** SUMMARY ***
Total pot $0.55 | Rake $0.02 
Board [6s Kd Jc 7c 2d]
Seat 1: tjmmkdi01 folded before Flop (didn't bet)
Seat 2: Yahan588 (button) collected ($0.53)
Seat 4: Acedan1369 (small blind) folded before Flop
Seat 5: easywtf (big blind) folded on the River
Seat 6: fish72o folded before Flop (didn't bet)



PokerStars Hand #222970033107:  Hold'em No Limit ($0.05/$0.10 USD) - 2021/01/23 15:42:52 ET
Table 'Lutetia III' 6-max Seat #4 is the button
Seat 1: tjmmkdi01 ($11.92 in chips) 
Seat 2: Yahan588 ($11.80 in chips) 
Seat 4: Acedan1369 ($21.65 in chips) 
Seat 5: easywtf ($8.61 in chips) 
Seat 6: fish72o ($13.02 in chips) 
easywtf: posts small blind $0.05
fish72o: posts big blind $0.10
*** HOLE CARDS ***
tjmmkdi01: calls $0.10
Yahan588: folds 
Acedan1369: raises $0.30 to $0.40
easywtf: folds 
fish72o: folds 
tjmmkdi01: folds 
Uncalled bet ($0.30) returned to Acedan1369
Acedan1369 collected $0.35 from pot
Acedan1369: doesn't show hand 
*** SUMMARY ***
Total pot $0.35 | Rake $0 
Seat 1: tjmmkdi01 folded before Flop
Seat 2: Yahan588 folded before Flop (didn't bet)
Seat 4: Acedan1369 (button) collected ($0.35)
Seat 5: easywtf (small blind) folded before Flop
Seat 6: fish72o (big blind) folded before Flop



PokerStars Hand #222970048861:  Hold'em No Limit ($0.05/$0.10 USD) - 2021/01/23 15:43:11 ET
Table 'Lutetia III' 6-max Seat #5 is the button
Seat 1: tjmmkdi01 ($11.82 in chips) 
Seat 2: Yahan588 ($11.80 in chips) 
Seat 3: ignaciospc ($10.85 in chips) 
Seat 4: Acedan1369 ($21.90 in chips) 
Seat 5: easywtf ($8.56 in chips) 
Seat 6: fish72o ($12.92 in chips) 
fish72o: posts small blind $0.05
tjmmkdi01: posts big blind $0.10
ignaciospc: posts small & big blinds $0.15
*** HOLE CARDS ***
Yahan588: folds 
ignaciospc: checks 
Acedan1369: folds 
easywtf: folds 
fish72o: folds 
tjmmkdi01: checks 
*** FLOP *** [6c 8d 3c]
tjmmkdi01: checks 
ignaciospc: bets $0.20
tjmmkdi01: folds 
Uncalled bet ($0.20) returned to ignaciospc
ignaciospc collected $0.29 from pot
ignaciospc: doesn't show hand 
*** SUMMARY ***
Total pot $0.30 | Rake $0.01 
Board [6c 8d 3c]
Seat 1: tjmmkdi01 (big blind) folded on the Flop
Seat 2: Yahan588 folded before Flop (didn't bet)
Seat 3: ignaciospc collected ($0.29)
Seat 4: Acedan1369 folded before Flop (didn't bet)
Seat 5: easywtf (button) folded before Flop (didn't bet)
Seat 6: fish72o (small blind) folded before Flop



PokerStars Hand #222970073808:  Hold'em No Limit ($0.05/$0.10 USD) - 2021/01/23 15:43:41 ET
Table 'Lutetia III' 6-max Seat #6 is the button
Seat 1: tjmmkdi01 ($11.72 in chips) 
Seat 2: Yahan588 ($11.80 in chips) 
Seat 3: ignaciospc ($10.99 in chips) 
Seat 4: Acedan1369 ($21.90 in chips) 
Seat 5: easywtf ($8.56 in chips) 
Seat 6: fish72o ($12.87 in chips) 
tjmmkdi01: posts small blind $0.05
Yahan588: posts big blind $0.10
*** HOLE CARDS ***
ignaciospc: folds 
Acedan1369: raises $0.15 to $0.25
easywtf: folds 
fish72o: folds 
tjmmkdi01: folds 
Yahan588: calls $0.15
*** FLOP *** [6h Th Qc]
Yahan588: checks 
Acedan1369: checks 
*** TURN *** [6h Th Qc] [2c]
Yahan588: bets $0.39
Acedan1369: folds 
Uncalled bet ($0.39) returned to Yahan588
Yahan588 collected $0.53 from pot
*** SUMMARY ***
Total pot $0.55 | Rake $0.02 
Board [6h Th Qc 2c]
Seat 1: tjmmkdi01 (small blind) folded before Flop
Seat 2: Yahan588 (big blind) collected ($0.53)
Seat 3: ignaciospc folded before Flop (didn't bet)
Seat 4: Acedan1369 folded on the Turn
Seat 5: easywtf folded before Flop (didn't bet)
Seat 6: fish72o (button) folded before Flop (didn't bet)



PokerStars Hand #222970105507:  Hold'em No Limit ($0.05/$0.10 USD) - 2021/01/23 15:44:18 ET
Table 'Lutetia III' 6-max Seat #1 is the button
Seat 1: tjmmkdi01 ($11.67 in chips) 
Seat 2: Yahan588 ($12.08 in chips) 
Seat 3: ignaciospc ($10.99 in chips) 
Seat 4: Acedan1369 ($21.65 in chips) 
Seat 5: easywtf ($8.56 in chips) 
Seat 6: fish72o ($12.87 in chips) 
Yahan588: posts small blind $0.05
ignaciospc: posts big blind $0.10
*** HOLE CARDS ***
Acedan1369: folds 
easywtf: folds 
fish72o: folds 
tjmmkdi01: folds 
Yahan588: folds 
Uncalled bet ($0.05) returned to ignaciospc
ignaciospc collected $0.10 from pot
ignaciospc: doesn't show hand 
*** SUMMARY ***
Total pot $0.10 | Rake $0 
Seat 1: tjmmkdi01 (button) folded before Flop (didn't bet)
Seat 2: Yahan588 (small blind) folded before Flop
Seat 3: ignaciospc (big blind) collected ($0.10)
Seat 4: Acedan1369 folded before Flop (didn't bet)
Seat 5: easywtf folded before Flop (didn't bet)
Seat 6: fish72o folded before Flop (didn't bet)



PokerStars Hand #222970114089:  Hold'em No Limit ($0.05/$0.10 USD) - 2021/01/23 15:44:29 ET
Table 'Lutetia III' 6-max Seat #2 is the button
Seat 1: tjmmkdi01 ($11.67 in chips) 
Seat 2: Yahan588 ($12.03 in chips) 
Seat 3: ignaciospc ($11.04 in chips) 
Seat 4: Acedan1369 ($21.65 in chips) 
Seat 5: easywtf ($8.56 in chips) 
Seat 6: fish72o ($12.87 in chips) 
ignaciospc: posts small blind $0.05
Acedan1369: posts big blind $0.10
*** HOLE CARDS ***
easywtf: folds 
fish72o: folds 
tjmmkdi01: calls $0.10
Yahan588: folds 
ignaciospc: folds 
Acedan1369: checks 
*** FLOP *** [Jh 4s 6h]
Acedan1369: checks 
tjmmkdi01: bets $0.10
Acedan1369: folds 
Uncalled bet ($0.10) returned to tjmmkdi01
tjmmkdi01 collected $0.24 from pot
tjmmkdi01: doesn't show hand 
*** SUMMARY ***
Total pot $0.25 | Rake $0.01 
Board [Jh 4s 6h]
Seat 1: tjmmkdi01 collected ($0.24)
Seat 2: Yahan588 (button) folded before Flop (didn't bet)
Seat 3: ignaciospc (small blind) folded before Flop
Seat 4: Acedan1369 (big blind) folded on the Flop
Seat 5: easywtf folded before Flop (didn't bet)
Seat 6: fish72o folded before Flop (didn't bet)



PokerStars Hand #222970145467:  Hold'em No Limit ($0.05/$0.10 USD) - 2021/01/23 15:45:06 ET
Table 'Lutetia III' 6-max Seat #3 is the button
Seat 1: tjmmkdi01 ($11.81 in chips) 
Seat 2: Yahan588 ($12.03 in chips) 
Seat 3: ignaciospc ($10.99 in chips) 
Seat 4: Acedan1369 ($21.55 in chips) 
Seat 5: easywtf ($8.56 in chips) 
Seat 6: fish72o ($12.87 in chips) 
Acedan1369: posts small blind $0.05
easywtf: posts big blind $0.10
*** HOLE CARDS ***
fish72o: folds 
tjmmkdi01: calls $0.10
Yahan588: raises $0.30 to $0.40
ignaciospc: raises $0.60 to $1
Acedan1369: folds 
easywtf: folds 
tjmmkdi01: folds 
Yahan588: folds 
Uncalled bet ($0.60) returned to ignaciospc
ignaciospc collected $1.05 from pot
ignaciospc: doesn't show hand 
*** SUMMARY ***
Total pot $1.05 | Rake $0 
Seat 1: tjmmkdi01 folded before Flop
Seat 2: Yahan588 folded before Flop
Seat 3: ignaciospc (button) collected ($1.05)
Seat 4: Acedan1369 (small blind) folded before Flop
Seat 5: easywtf (big blind) folded before Flop
Seat 6: fish72o folded before Flop (didn't bet)



PokerStars Hand #222970172750:  Hold'em No Limit ($0.05/$0.10 USD) - 2021/01/23 15:45:38 ET
Table 'Lutetia III' 6-max Seat #4 is the button
Seat 1: tjmmkdi01 ($11.71 in chips) 
Seat 2: Yahan588 ($11.63 in chips) 
Seat 3: ignaciospc ($11.64 in chips) 
Seat 4: Acedan1369 ($21.50 in chips) 
Seat 5: easywtf ($8.46 in chips) 
Seat 6: fish72o ($12.87 in chips) 
easywtf: posts small blind $0.05
fish72o: posts big blind $0.10
*** HOLE CARDS ***
tjmmkdi01: calls $0.10
Yahan588: folds 
ignaciospc: folds 
Acedan1369 has timed out
Acedan1369: folds 
easywtf: raises $0.40 to $0.50
fish72o: folds 
tjmmkdi01: calls $0.40
*** FLOP *** [7c 5d 8s]
easywtf: checks 
tjmmkdi01: checks 
*** TURN *** [7c 5d 8s] [9s]
easywtf: checks 
tjmmkdi01: checks 
*** RIVER *** [7c 5d 8s 9s] [7d]
easywtf: checks 
tjmmkdi01: checks 
*** SHOW DOWN ***
easywtf: shows [Jd Ac] (a pair of Sevens)
tjmmkdi01: mucks hand 
easywtf collected $1.05 from pot
*** SUMMARY ***
Total pot $1.10 | Rake $0.05 
Board [7c 5d 8s 9s 7d]
Seat 1: tjmmkdi01 mucked
Seat 2: Yahan588 folded before Flop (didn't bet)
Seat 3: ignaciospc folded before Flop (didn't bet)
Seat 4: Acedan1369 (button) folded before Flop (didn't bet)
Seat 5: easywtf (small blind) showed [Jd Ac] and won ($1.05) with a pair of Sevens
Seat 6: fish72o (big blind) folded before Flop



PokerStars Hand #222970204599:  Hold'em No Limit ($0.05/$0.10 USD) - 2021/01/23 15:46:16 ET
Table 'Lutetia III' 6-max Seat #5 is the button
Seat 1: tjmmkdi01 ($11.21 in chips) 
Seat 2: Yahan588 ($11.63 in chips) 
Seat 3: ignaciospc ($11.64 in chips) 
Seat 4: Acedan1369 ($21.50 in chips) 
Seat 5: easywtf ($9.01 in chips) 
Seat 6: fish72o ($12.77 in chips) 
fish72o: posts small blind $0.05
tjmmkdi01: posts big blind $0.10
*** HOLE CARDS ***
Yahan588: folds 
ignaciospc: folds 
Acedan1369: folds 
easywtf: folds 
fish72o: folds 
Uncalled bet ($0.05) returned to tjmmkdi01
tjmmkdi01 collected $0.10 from pot
tjmmkdi01: doesn't show hand 
*** SUMMARY ***
Total pot $0.10 | Rake $0 
Seat 1: tjmmkdi01 (big blind) collected ($0.10)
Seat 2: Yahan588 folded before Flop (didn't bet)
Seat 3: ignaciospc folded before Flop (didn't bet)
Seat 4: Acedan1369 folded before Flop (didn't bet)
Seat 5: easywtf (button) folded before Flop (didn't bet)
Seat 6: fish72o (small blind) folded before Flop



PokerStars Hand #222970213884:  Hold'em No Limit ($0.05/$0.10 USD) - 2021/01/23 15:46:27 ET
Table 'Lutetia III' 6-max Seat #6 is the button
Seat 2: Yahan588 ($11.63 in chips) 
Seat 3: ignaciospc ($11.64 in chips) 
Seat 4: Acedan1369 ($21.50 in chips) 
Seat 5: easywtf ($9.01 in chips) 
Seat 6: fish72o ($12.72 in chips) 
Yahan588: posts small blind $0.05
ignaciospc: posts big blind $0.10
*** HOLE CARDS ***
Raidylol joins the table at seat #1 
Acedan1369: folds 
easywtf: folds 
fish72o: folds 
Yahan588: folds 
Uncalled bet ($0.05) returned to ignaciospc
ignaciospc collected $0.10 from pot
ignaciospc: doesn't show hand 
*** SUMMARY ***
Total pot $0.10 | Rake $0 
Seat 2: Yahan588 (small blind) folded before Flop
Seat 3: ignaciospc (big blind) collected ($0.10)
Seat 4: Acedan1369 folded before Flop (didn't bet)
Seat 5: easywtf folded before Flop (didn't bet)
Seat 6: fish72o (button) folded before Flop (didn't bet)



PokerStars Hand #222970226177:  Hold'em No Limit ($0.05/$0.10 USD) - 2021/01/23 15:46:42 ET
Table 'Lutetia III' 6-max Seat #2 is the button
Seat 2: Yahan588 ($11.58 in chips) 
Seat 3: ignaciospc ($11.69 in chips) 
Seat 4: Acedan1369 ($21.50 in chips) 
Seat 5: easywtf ($9.01 in chips) 
Seat 6: fish72o ($12.72 in chips) 
ignaciospc: posts small blind $0.05
Acedan1369: posts big blind $0.10
Raidylol: sits out 
*** HOLE CARDS ***
easywtf: folds 
fish72o: folds 
Yahan588: raises $0.15 to $0.25
ignaciospc: folds 
Acedan1369: folds 
Uncalled bet ($0.15) returned to Yahan588
Yahan588 collected $0.25 from pot
*** SUMMARY ***
Total pot $0.25 | Rake $0 
Seat 2: Yahan588 (button) collected ($0.25)
Seat 3: ignaciospc (small blind) folded before Flop
Seat 4: Acedan1369 (big blind) folded before Flop
Seat 5: easywtf folded before Flop (didn't bet)
Seat 6: fish72o folded before Flop (didn't bet)



PokerStars Hand #222970239823:  Hold'em No Limit ($0.05/$0.10 USD) - 2021/01/23 15:46:58 ET
Table 'Lutetia III' 6-max Seat #3 is the button
Seat 2: Yahan588 ($11.73 in chips) 
Seat 3: ignaciospc ($11.64 in chips) 
Seat 4: Acedan1369 ($21.40 in chips) 
Seat 5: easywtf ($9.01 in chips) 
Seat 6: fish72o ($12.72 in chips) 
Acedan1369: posts small blind $0.05
easywtf: posts big blind $0.10
Raidylol: sits out 
*** HOLE CARDS ***
fish72o: folds 
Yahan588: folds 
ignaciospc: raises $0.15 to $0.25
Acedan1369: raises $0.60 to $0.85
easywtf: folds 
ignaciospc: folds 
Uncalled bet ($0.60) returned to Acedan1369
Acedan1369 collected $0.60 from pot
Acedan1369: doesn't show hand 
*** SUMMARY ***
Total pot $0.60 | Rake $0 
Seat 2: Yahan588 folded before Flop (didn't bet)
Seat 3: ignaciospc (button) folded before Flop
Seat 4: Acedan1369 (small blind) collected ($0.60)
Seat 5: easywtf (big blind) folded before Flop
Seat 6: fish72o folded before Flop (didn't bet)



PokerStars Hand #222970256965:  Hold'em No Limit ($0.05/$0.10 USD) - 2021/01/23 15:47:19 ET
Table 'Lutetia III' 6-max Seat #4 is the button
Seat 2: Yahan588 ($11.73 in chips) 
Seat 3: ignaciospc ($11.39 in chips) 
Seat 4: Acedan1369 ($21.75 in chips) 
Seat 5: easywtf ($8.91 in chips) 
Seat 6: fish72o ($12.72 in chips) 
easywtf: posts small blind $0.05
fish72o: posts big blind $0.10
Raidylol: sits out 
*** HOLE CARDS ***
Yahan588: folds 
ignaciospc: folds 
Acedan1369: raises $0.15 to $0.25
easywtf: folds 
fish72o: folds 
Uncalled bet ($0.15) returned to Acedan1369
Acedan1369 collected $0.25 from pot
Acedan1369: doesn't show hand 
*** SUMMARY ***
Total pot $0.25 | Rake $0 
Seat 2: Yahan588 folded before Flop (didn't bet)
Seat 3: ignaciospc folded before Flop (didn't bet)
Seat 4: Acedan1369 (button) collected ($0.25)
Seat 5: easywtf (small blind) folded before Flop
Seat 6: fish72o (big blind) folded before Flop



PokerStars Hand #222970268116:  Hold'em No Limit ($0.05/$0.10 USD) - 2021/01/23 15:47:32 ET
Table 'Lutetia III' 6-max Seat #5 is the button
Seat 1: Raidylol ($10 in chips) 
Seat 2: Yahan588 ($11.73 in chips) 
Seat 3: ignaciospc ($11.39 in chips) 
Seat 4: Acedan1369 ($21.90 in chips) 
Seat 5: easywtf ($8.86 in chips) 
Seat 6: fish72o ($12.62 in chips) 
fish72o: posts small blind $0.05
Raidylol: posts big blind $0.10
*** HOLE CARDS ***
Yahan588: folds 
ignaciospc: raises $0.20 to $0.30
Acedan1369: folds 
easywtf: folds 
fish72o: folds 
Raidylol: calls $0.20
*** FLOP *** [8h 5s 9c]
Raidylol: checks 
ignaciospc: checks 
*** TURN *** [8h 5s 9c] [3d]
Raidylol: checks 
ignaciospc: bets $0.20
Raidylol: calls $0.20
*** RIVER *** [8h 5s 9c 3d] [Kd]
Raidylol: checks 
ignaciospc: checks 
*** SHOW DOWN ***
Raidylol: shows [Ac Jc] (high card Ace)
ignaciospc: shows [Th Ts] (a pair of Tens)
ignaciospc collected $1 from pot
*** SUMMARY ***
Total pot $1.05 | Rake $0.05 
Board [8h 5s 9c 3d Kd]
Seat 1: Raidylol (big blind) showed [Ac Jc] and lost with high card Ace
Seat 2: Yahan588 folded before Flop (didn't bet)
Seat 3: ignaciospc showed [Th Ts] and won ($1) with a pair of Tens
Seat 4: Acedan1369 folded before Flop (didn't bet)
Seat 5: easywtf (button) folded before Flop (didn't bet)
Seat 6: fish72o (small blind) folded before Flop



PokerStars Hand #222970308507:  Hold'em No Limit ($0.05/$0.10 USD) - 2021/01/23 15:48:21 ET
Table 'Lutetia III' 6-max Seat #6 is the button
Seat 1: Raidylol ($10 in chips) 
Seat 3: ignaciospc ($11.89 in chips) 
Seat 4: Acedan1369 ($21.90 in chips) 
Seat 5: easywtf ($8.86 in chips) 
Seat 6: fish72o ($12.57 in chips) 
Raidylol: posts small blind $0.05
Yahan588: is sitting out 
ignaciospc: posts big blind $0.10
*** HOLE CARDS ***
Yahan588 leaves the table
Acedan1369: folds 
easywtf: folds 
fish72o: folds 
Raidylol: raises $0.20 to $0.30
ignaciospc: calls $0.20
*** FLOP *** [2s Th 6s]
Raidylol: checks 
ignaciospc: bets $0.19
Raidylol: folds 
Uncalled bet ($0.19) returned to ignaciospc
ignaciospc collected $0.57 from pot
ignaciospc: doesn't show hand 
*** SUMMARY ***
Total pot $0.60 | Rake $0.03 
Board [2s Th 6s]
Seat 1: Raidylol (small blind) folded on the Flop
Seat 3: ignaciospc (big blind) collected ($0.57)
Seat 4: Acedan1369 folded before Flop (didn't bet)
Seat 5: easywtf folded before Flop (didn't bet)
Seat 6: fish72o (button) folded before Flop (didn't bet)



PokerStars Hand #222970346304:  Hold'em No Limit ($0.05/$0.10 USD) - 2021/01/23 15:49:06 ET
Table 'Lutetia III' 6-max Seat #1 is the button
Seat 1: Raidylol ($10 in chips) 
Seat 3: ignaciospc ($12.16 in chips) 
Seat 4: Acedan1369 ($21.90 in chips) 
Seat 5: easywtf ($8.86 in chips) 
Seat 6: fish72o ($12.57 in chips) 
ignaciospc: posts small blind $0.05
Acedan1369: posts big blind $0.10
*** HOLE CARDS ***
easywtf: folds 
fish72o: folds 
Raidylol: raises $0.15 to $0.25
ignaciospc: folds 
Acedan1369: folds 
Uncalled bet ($0.15) returned to Raidylol
Raidylol collected $0.25 from pot
*** SUMMARY ***
Total pot $0.25 | Rake $0 
Seat 1: Raidylol (button) collected ($0.25)
Seat 3: ignaciospc (small blind) folded before Flop
Seat 4: Acedan1369 (big blind) folded before Flop
Seat 5: easywtf folded before Flop (didn't bet)
Seat 6: fish72o folded before Flop (didn't bet)



PokerStars Hand #222970355699:  Hold'em No Limit ($0.05/$0.10 USD) - 2021/01/23 15:49:18 ET
Table 'Lutetia III' 6-max Seat #3 is the button
Seat 1: Raidylol ($10.15 in chips) 
Seat 3: ignaciospc ($12.11 in chips) 
Seat 4: Acedan1369 ($21.80 in chips) 
Seat 5: easywtf ($8.86 in chips) 
Seat 6: fish72o ($12.57 in chips) 
Acedan1369: posts small blind $0.05
easywtf: posts big blind $0.10
*** HOLE CARDS ***
fish72o: folds 
Raidylol: folds 
ignaciospc: raises $0.15 to $0.25
Acedan1369: folds 
easywtf: folds 
Uncalled bet ($0.15) returned to ignaciospc
ignaciospc collected $0.25 from pot
ignaciospc: doesn't show hand 
*** SUMMARY ***
Total pot $0.25 | Rake $0 
Seat 1: Raidylol folded before Flop (didn't bet)
Seat 3: ignaciospc (button) collected ($0.25)
Seat 4: Acedan1369 (small blind) folded before Flop
Seat 5: easywtf (big blind) folded before Flop
Seat 6: fish72o folded before Flop (didn't bet)



PokerStars Hand #222970363292:  Hold'em No Limit ($0.05/$0.10 USD) - 2021/01/23 15:49:27 ET
Table 'Lutetia III' 6-max Seat #4 is the button
Seat 1: Raidylol ($10.15 in chips) 
Seat 3: ignaciospc ($12.26 in chips) 
Seat 4: Acedan1369 ($21.75 in chips) 
Seat 5: easywtf ($8.76 in chips) 
Seat 6: fish72o ($12.57 in chips) 
easywtf: posts small blind $0.05
fish72o: posts big blind $0.10
*** HOLE CARDS ***
Raidylol: folds 
ignaciospc: folds 
Acedan1369: raises $0.15 to $0.25
easywtf: folds 
fish72o: raises $0.55 to $0.80
Acedan1369: calls $0.55
*** FLOP *** [5s 3d 8h]
fish72o: bets $0.52
Acedan1369: raises $0.98 to $1.50
fish72o: folds 
Uncalled bet ($0.98) returned to Acedan1369
Acedan1369 collected $2.57 from pot
Acedan1369: doesn't show hand 
*** SUMMARY ***
Total pot $2.69 | Rake $0.12 
Board [5s 3d 8h]
Seat 1: Raidylol folded before Flop (didn't bet)
Seat 3: ignaciospc folded before Flop (didn't bet)
Seat 4: Acedan1369 (button) collected ($2.57)
Seat 5: easywtf (small blind) folded before Flop
Seat 6: fish72o (big blind) folded on the Flop



PokerStars Hand #222970393262:  Hold'em No Limit ($0.05/$0.10 USD) - 2021/01/23 15:50:03 ET
Table 'Lutetia III' 6-max Seat #5 is the button
Seat 1: Raidylol ($10.15 in chips) 
Seat 3: ignaciospc ($12.26 in chips) 
Seat 4: Acedan1369 ($23 in chips) 
Seat 5: easywtf ($8.71 in chips) 
Seat 6: fish72o ($11.25 in chips) 
fish72o: posts small blind $0.05
Raidylol: posts big blind $0.10
*** HOLE CARDS ***
ignaciospc: raises $0.20 to $0.30
Acedan1369: folds 
easywtf: folds 
fish72o: folds 
Raidylol: folds 
Uncalled bet ($0.20) returned to ignaciospc
ignaciospc collected $0.25 from pot
ignaciospc: doesn't show hand 
*** SUMMARY ***
Total pot $0.25 | Rake $0 
Seat 1: Raidylol (big blind) folded before Flop
Seat 3: ignaciospc collected ($0.25)
Seat 4: Acedan1369 folded before Flop (didn't bet)
Seat 5: easywtf (button) folded before Flop (didn't bet)
Seat 6: fish72o (small blind) folded before Flop



PokerStars Hand #222970400387:  Hold'em No Limit ($0.05/$0.10 USD) - 2021/01/23 15:50:11 ET
Table 'Lutetia III' 6-max Seat #6 is the button
Seat 1: Raidylol ($10.05 in chips) 
Seat 3: ignaciospc ($12.41 in chips) 
Seat 4: Acedan1369 ($23 in chips) 
Seat 5: easywtf ($8.71 in chips) 
Seat 6: fish72o ($11.20 in chips) 
Raidylol: posts small blind $0.05
ignaciospc: posts big blind $0.10
*** HOLE CARDS ***
Acedan1369: folds 
easywtf: folds 
fish72o: raises $0.15 to $0.25
Raidylol: folds 
ignaciospc: folds 
Uncalled bet ($0.15) returned to fish72o
fish72o collected $0.25 from pot
fish72o: doesn't show hand 
*** SUMMARY ***
Total pot $0.25 | Rake $0 
Seat 1: Raidylol (small blind) folded before Flop
Seat 3: ignaciospc (big blind) folded before Flop
Seat 4: Acedan1369 folded before Flop (didn't bet)
Seat 5: easywtf folded before Flop (didn't bet)
Seat 6: fish72o (button) collected ($0.25)



PokerStars Hand #222970416068:  Hold'em No Limit ($0.05/$0.10 USD) - 2021/01/23 15:50:30 ET
Table 'Lutetia III' 6-max Seat #1 is the button
Seat 1: Raidylol ($10 in chips) 
Seat 3: ignaciospc ($12.31 in chips) 
Seat 4: Acedan1369 ($23 in chips) 
Seat 5: easywtf ($8.71 in chips) 
Seat 6: fish72o ($11.35 in chips) 
ignaciospc: posts small blind $0.05
Acedan1369: posts big blind $0.10
*** HOLE CARDS ***
easywtf: folds 
fish72o: folds 
Raidylol: raises $0.15 to $0.25
ignaciospc: folds 
Acedan1369: folds 
Uncalled bet ($0.15) returned to Raidylol
Raidylol collected $0.25 from pot
*** SUMMARY ***
Total pot $0.25 | Rake $0 
Seat 1: Raidylol (button) collected ($0.25)
Seat 3: ignaciospc (small blind) folded before Flop
Seat 4: Acedan1369 (big blind) folded before Flop
Seat 5: easywtf folded before Flop (didn't bet)
Seat 6: fish72o folded before Flop (didn't bet)



PokerStars Hand #222970434470:  Hold'em No Limit ($0.05/$0.10 USD) - 2021/01/23 15:50:52 ET
Table 'Lutetia III' 6-max Seat #3 is the button
Seat 1: Raidylol ($10.15 in chips) 
Seat 3: ignaciospc ($12.26 in chips) 
Seat 4: Acedan1369 ($22.90 in chips) 
Seat 5: easywtf ($8.71 in chips) 
Seat 6: fish72o ($11.35 in chips) 
Acedan1369: posts small blind $0.05
easywtf: posts big blind $0.10
*** HOLE CARDS ***
fish72o: folds 
Raidylol: folds 
ignaciospc: raises $0.15 to $0.25
Acedan1369: folds 
easywtf: calls $0.15
*** FLOP *** [5h 8h Kc]
easywtf: checks 
ignaciospc: bets $0.17
easywtf: folds 
Uncalled bet ($0.17) returned to ignaciospc
ignaciospc collected $0.53 from pot
ignaciospc: doesn't show hand 
*** SUMMARY ***
Total pot $0.55 | Rake $0.02 
Board [5h 8h Kc]
Seat 1: Raidylol folded before Flop (didn't bet)
Seat 3: ignaciospc (button) collected ($0.53)
Seat 4: Acedan1369 (small blind) folded before Flop
Seat 5: easywtf (big blind) folded on the Flop
Seat 6: fish72o folded before Flop (didn't bet)



PokerStars Hand #222970451128:  Hold'em No Limit ($0.05/$0.10 USD) - 2021/01/23 15:51:12 ET
Table 'Lutetia III' 6-max Seat #4 is the button
Seat 1: Raidylol ($10.15 in chips) 
Seat 3: ignaciospc ($12.54 in chips) 
Seat 4: Acedan1369 ($22.85 in chips) 
Seat 5: easywtf ($8.46 in chips) 
Seat 6: fish72o ($11.35 in chips) 
easywtf: posts small blind $0.05
fish72o: posts big blind $0.10
*** HOLE CARDS ***
Raidylol: folds 
ignaciospc: raises $0.20 to $0.30
podrico79 joins the table at seat #2 
Acedan1369: raises $0.55 to $0.85
easywtf: folds 
fish72o: folds 
ignaciospc: folds 
Uncalled bet ($0.55) returned to Acedan1369
Acedan1369 collected $0.75 from pot
Acedan1369: doesn't show hand 
*** SUMMARY ***
Total pot $0.75 | Rake $0 
Seat 1: Raidylol folded before Flop (didn't bet)
Seat 3: ignaciospc folded before Flop
Seat 4: Acedan1369 (button) collected ($0.75)
Seat 5: easywtf (small blind) folded before Flop
Seat 6: fish72o (big blind) folded before Flop



PokerStars Hand #222970466370:  Hold'em No Limit ($0.05/$0.10 USD) - 2021/01/23 15:51:30 ET
Table 'Lutetia III' 6-max Seat #5 is the button
Seat 1: Raidylol ($10.15 in chips) 
Seat 3: ignaciospc ($12.24 in chips) 
Seat 4: Acedan1369 ($23.30 in chips) 
Seat 5: easywtf ($8.41 in chips) 
Seat 6: fish72o ($11.25 in chips) 
fish72o: posts small blind $0.05
Raidylol: posts big blind $0.10
podrico79: sits out 
*** HOLE CARDS ***
ignaciospc: raises $0.20 to $0.30
Acedan1369: folds 
easywtf: folds 
fish72o: folds 
Raidylol: folds 
Uncalled bet ($0.20) returned to ignaciospc
ignaciospc collected $0.25 from pot
ignaciospc: doesn't show hand 
*** SUMMARY ***
Total pot $0.25 | Rake $0 
Seat 1: Raidylol (big blind) folded before Flop
Seat 3: ignaciospc collected ($0.25)
Seat 4: Acedan1369 folded before Flop (didn't bet)
Seat 5: easywtf (button) folded before Flop (didn't bet)
Seat 6: fish72o (small blind) folded before Flop



PokerStars Hand #222970476072:  Hold'em No Limit ($0.05/$0.10 USD) - 2021/01/23 15:51:42 ET
Table 'Lutetia III' 6-max Seat #6 is the button
Seat 1: Raidylol ($10.05 in chips) 
Seat 2: podrico79 ($8 in chips) 
Seat 3: ignaciospc ($12.39 in chips) 
Seat 4: Acedan1369 ($23.30 in chips) 
Seat 5: easywtf ($8.41 in chips) 
Seat 6: fish72o ($11.20 in chips) 
Raidylol: posts small blind $0.05
podrico79: posts big blind $0.10
*** HOLE CARDS ***
ignaciospc: folds 
Acedan1369: folds 
easywtf: folds 
ignaciospc leaves the table
fish72o: folds 
Raidylol: raises $0.20 to $0.30
podrico79: folds 
Uncalled bet ($0.20) returned to Raidylol
Raidylol collected $0.20 from pot
*** SUMMARY ***
Total pot $0.20 | Rake $0 
Seat 1: Raidylol (small blind) collected ($0.20)
Seat 2: podrico79 (big blind) folded before Flop
Seat 3: ignaciospc folded before Flop (didn't bet)
Seat 4: Acedan1369 folded before Flop (didn't bet)
Seat 5: easywtf folded before Flop (didn't bet)
Seat 6: fish72o (button) folded before Flop (didn't bet)



PokerStars Hand #222970487842:  Hold'em No Limit ($0.05/$0.10 USD) - 2021/01/23 15:51:56 ET
Table 'Lutetia III' 6-max Seat #1 is the button
Seat 1: Raidylol ($10.15 in chips) 
Seat 2: podrico79 ($7.90 in chips) 
Seat 4: Acedan1369 ($23.30 in chips) 
Seat 5: easywtf ($8.41 in chips) 
Seat 6: fish72o ($11.20 in chips) 
podrico79: posts small blind $0.05
Acedan1369: posts big blind $0.10
*** HOLE CARDS ***
easywtf: folds 
fish72o: raises $0.15 to $0.25
Raidylol: calls $0.25
podrico79: calls $0.20
Acedan1369: folds 
*** FLOP *** [7s Kc 3d]
podrico79: checks 
fish72o: bets $0.16
Raidylol: folds 
podrico79: calls $0.16
*** TURN *** [7s Kc 3d] [4h]
podrico79: checks 
fish72o: checks 
*** RIVER *** [7s Kc 3d 4h] [2h]
podrico79: checks 
Igor22913 joins the table at seat #3 
fish72o: checks 
*** SHOW DOWN ***
podrico79: shows [Ac 9c] (high card Ace)
fish72o: mucks hand 
podrico79 collected $1.12 from pot
*** SUMMARY ***
Total pot $1.17 | Rake $0.05 
Board [7s Kc 3d 4h 2h]
Seat 1: Raidylol (button) folded on the Flop
Seat 2: podrico79 (small blind) showed [Ac 9c] and won ($1.12) with high card Ace
Seat 4: Acedan1369 (big blind) folded before Flop
Seat 5: easywtf folded before Flop (didn't bet)
Seat 6: fish72o mucked



PokerStars Hand #222970560888:  Hold'em No Limit ($0.05/$0.10 USD) - 2021/01/23 15:53:24 ET
Table 'Lutetia III' 6-max Seat #2 is the button
Seat 1: Raidylol ($10 in chips) 
Seat 2: podrico79 ($8.61 in chips) 
Seat 4: Acedan1369 ($23.20 in chips) 
Seat 5: easywtf ($8.41 in chips) 
Seat 6: fish72o ($10.79 in chips) 
Acedan1369: posts small blind $0.05
easywtf: posts big blind $0.10
*** HOLE CARDS ***
fish72o: folds 
Raidylol: folds 
podrico79: folds 
Acedan1369: folds 
Uncalled bet ($0.05) returned to easywtf
easywtf collected $0.10 from pot
easywtf: doesn't show hand 
*** SUMMARY ***
Total pot $0.10 | Rake $0 
Seat 1: Raidylol folded before Flop (didn't bet)
Seat 2: podrico79 (button) folded before Flop (didn't bet)
Seat 4: Acedan1369 (small blind) folded before Flop
Seat 5: easywtf (big blind) collected ($0.10)
Seat 6: fish72o folded before Flop (didn't bet)



PokerStars Hand #222970569727:  Hold'em No Limit ($0.05/$0.10 USD) - 2021/01/23 15:53:34 ET
Table 'Lutetia III' 6-max Seat #4 is the button
Seat 1: Raidylol ($10 in chips) 
Seat 2: podrico79 ($8.61 in chips) 
Seat 4: Acedan1369 ($23.15 in chips) 
Seat 5: easywtf ($8.46 in chips) 
Seat 6: fish72o ($10.79 in chips) 
easywtf: posts small blind $0.05
fish72o: posts big blind $0.10
Igor22913: sits out 
*** HOLE CARDS ***
Raidylol: folds 
podrico79 has timed out
podrico79: folds 
Acedan1369: raises $0.15 to $0.25
easywtf: folds 
fish72o: folds 
Uncalled bet ($0.15) returned to Acedan1369
Acedan1369 collected $0.25 from pot
Acedan1369: doesn't show hand 
*** SUMMARY ***
Total pot $0.25 | Rake $0 
Seat 1: Raidylol folded before Flop (didn't bet)
Seat 2: podrico79 folded before Flop (didn't bet)
Seat 4: Acedan1369 (button) collected ($0.25)
Seat 5: easywtf (small blind) folded before Flop
Seat 6: fish72o (big blind) folded before Flop



PokerStars Hand #222970591948:  Hold'em No Limit ($0.05/$0.10 USD) - 2021/01/23 15:54:01 ET
Table 'Lutetia III' 6-max Seat #5 is the button
Seat 1: Raidylol ($10 in chips) 
Seat 2: podrico79 ($8.61 in chips) 
Seat 4: Acedan1369 ($23.30 in chips) 
Seat 5: easywtf ($8.41 in chips) 
Seat 6: fish72o ($10.69 in chips) 
fish72o: posts small blind $0.05
Raidylol: posts big blind $0.10
Igor22913: sits out 
*** HOLE CARDS ***
podrico79: folds 
Acedan1369: folds 
easywtf: raises $0.10 to $0.20
fish72o: folds 
Raidylol: raises $0.60 to $0.80
easywtf: calls $0.60
*** FLOP *** [8h 9d 6h]
Raidylol: checks 
easywtf: checks 
*** TURN *** [8h 9d 6h] [Td]
Raidylol: checks 
easywtf: bets $0.55
Raidylol: calls $0.55
*** RIVER *** [8h 9d 6h Td] [3c]
Raidylol: checks 
easywtf: checks 
*** SHOW DOWN ***
Raidylol: shows [Jc Jh] (a pair of Jacks)
easywtf: mucks hand 
Raidylol collected $2.63 from pot
*** SUMMARY ***
Total pot $2.75 | Rake $0.12 
Board [8h 9d 6h Td 3c]
Seat 1: Raidylol (big blind) showed [Jc Jh] and won ($2.63) with a pair of Jacks
Seat 2: podrico79 folded before Flop (didn't bet)
Seat 4: Acedan1369 folded before Flop (didn't bet)
Seat 5: easywtf (button) mucked
Seat 6: fish72o (small blind) folded before Flop



PokerStars Hand #222970630428:  Hold'em No Limit ($0.05/$0.10 USD) - 2021/01/23 15:54:48 ET
Table 'Lutetia III' 6-max Seat #6 is the button
Seat 1: Raidylol ($11.28 in chips) 
Seat 2: podrico79 ($8.61 in chips) 
Seat 4: Acedan1369 ($23.30 in chips) 
Seat 5: easywtf ($7.06 in chips) 
Seat 6: fish72o ($10.64 in chips) 
Raidylol: posts small blind $0.05
podrico79: posts big blind $0.10
Igor22913: sits out 
*** HOLE CARDS ***
Acedan1369: raises $0.15 to $0.25
easywtf: folds 
fish72o: folds 
Raidylol: folds 
podrico79: calls $0.15
*** FLOP *** [Jd 2h 6c]
podrico79: checks 
Acedan1369: bets $0.24
podrico79: folds 
Uncalled bet ($0.24) returned to Acedan1369
Acedan1369 collected $0.53 from pot
Acedan1369: doesn't show hand 
*** SUMMARY ***
Total pot $0.55 | Rake $0.02 
Board [Jd 2h 6c]
Seat 1: Raidylol (small blind) folded before Flop
Seat 2: podrico79 (big blind) folded on the Flop
Seat 4: Acedan1369 collected ($0.53)
Seat 5: easywtf folded before Flop (didn't bet)
Seat 6: fish72o (button) folded before Flop (didn't bet)



PokerStars Hand #222970663292:  Hold'em No Limit ($0.05/$0.10 USD) - 2021/01/23 15:55:36 ET
Table 'Lutetia III' 6-max Seat #1 is the button
Seat 1: Raidylol ($11.23 in chips) 
Seat 2: podrico79 ($8.36 in chips) 
Seat 3: Igor22913 ($10 in chips) 
Seat 4: Acedan1369 ($23.58 in chips) 
Seat 5: easywtf ($7.06 in chips) 
Seat 6: fish72o ($10.64 in chips) 
podrico79: posts small blind $0.05
Igor22913: posts big blind $0.10
*** HOLE CARDS ***
Acedan1369: folds 
easywtf: folds 
fish72o: folds 
Raidylol: folds 
podrico79: calls $0.05
Igor22913: checks 
*** FLOP *** [2s Kh 4d]
podrico79: checks 
Igor22913: checks 
*** TURN *** [2s Kh 4d] [7d]
podrico79: checks 
Igor22913: bets $0.25
podrico79: folds 
Uncalled bet ($0.25) returned to Igor22913
Igor22913 collected $0.19 from pot
Igor22913: doesn't show hand 
*** SUMMARY ***
Total pot $0.20 | Rake $0.01 
Board [2s Kh 4d 7d]
Seat 1: Raidylol (button) folded before Flop (didn't bet)
Seat 2: podrico79 (small blind) folded on the Turn
Seat 3: Igor22913 (big blind) collected ($0.19)
Seat 4: Acedan1369 folded before Flop (didn't bet)
Seat 5: easywtf folded before Flop (didn't bet)
Seat 6: fish72o folded before Flop (didn't bet)



PokerStars Hand #222970702053:  Hold'em No Limit ($0.05/$0.10 USD) - 2021/01/23 15:56:36 ET
Table 'Lutetia III' 6-max Seat #2 is the button
Seat 1: Raidylol ($11.23 in chips) 
Seat 2: podrico79 ($8.26 in chips) 
Seat 3: Igor22913 ($10.09 in chips) 
Seat 4: Acedan1369 ($23.58 in chips) 
Seat 5: easywtf ($7.06 in chips) 
Seat 6: fish72o ($10.64 in chips) 
Igor22913: posts small blind $0.05
Acedan1369: posts big blind $0.10
*** HOLE CARDS ***
easywtf: folds 
fish72o: folds 
Raidylol: folds 
podrico79: folds 
Igor22913: folds 
Uncalled bet ($0.05) returned to Acedan1369
Acedan1369 collected $0.10 from pot
Acedan1369: doesn't show hand 
*** SUMMARY ***
Total pot $0.10 | Rake $0 
Seat 1: Raidylol folded before Flop (didn't bet)
Seat 2: podrico79 (button) folded before Flop (didn't bet)
Seat 3: Igor22913 (small blind) folded before Flop
Seat 4: Acedan1369 (big blind) collected ($0.10)
Seat 5: easywtf folded before Flop (didn't bet)
Seat 6: fish72o folded before Flop (didn't bet)



PokerStars Hand #222970707760:  Hold'em No Limit ($0.05/$0.10 USD) - 2021/01/23 15:56:46 ET
Table 'Lutetia III' 6-max Seat #3 is the button
Seat 1: Raidylol ($11.23 in chips) 
Seat 2: podrico79 ($8.26 in chips) 
Seat 3: Igor22913 ($10.04 in chips) 
Seat 4: Acedan1369 ($23.63 in chips) 
Seat 5: easywtf ($7.06 in chips) 
Seat 6: fish72o ($10.64 in chips) 
Acedan1369: posts small blind $0.05
easywtf: posts big blind $0.10
*** HOLE CARDS ***
fish72o: folds 
Raidylol: folds 
podrico79: raises $0.10 to $0.20
Igor22913: folds 
Acedan1369: folds 
easywtf: calls $0.10
*** FLOP *** [8h Ks 2h]
easywtf: checks 
podrico79: bets $0.20
easywtf: calls $0.20
*** TURN *** [8h Ks 2h] [Qc]
easywtf: checks 
podrico79: bets $0.30
easywtf: folds 
Uncalled bet ($0.30) returned to podrico79
podrico79 collected $0.81 from pot
podrico79: doesn't show hand 
*** SUMMARY ***
Total pot $0.85 | Rake $0.04 
Board [8h Ks 2h Qc]
Seat 1: Raidylol folded before Flop (didn't bet)
Seat 2: podrico79 collected ($0.81)
Seat 3: Igor22913 (button) folded before Flop (didn't bet)
Seat 4: Acedan1369 (small blind) folded before Flop
Seat 5: easywtf (big blind) folded on the Turn
Seat 6: fish72o folded before Flop (didn't bet)



PokerStars Hand #222970728646:  Hold'em No Limit ($0.05/$0.10 USD) - 2021/01/23 15:57:23 ET
Table 'Lutetia III' 6-max Seat #4 is the button
Seat 1: Raidylol ($11.23 in chips) 
Seat 2: podrico79 ($8.67 in chips) 
Seat 3: Igor22913 ($10.04 in chips) 
Seat 4: Acedan1369 ($23.58 in chips) 
Seat 5: easywtf ($6.66 in chips) 
Seat 6: fish72o ($10.64 in chips) 
easywtf: posts small blind $0.05
fish72o: posts big blind $0.10
*** HOLE CARDS ***
Raidylol: folds 
podrico79: raises $0.10 to $0.20
Igor22913: folds 
Acedan1369: folds 
easywtf: folds 
fish72o: folds 
Uncalled bet ($0.10) returned to podrico79
podrico79 collected $0.25 from pot
podrico79: doesn't show hand 
*** SUMMARY ***
Total pot $0.25 | Rake $0 
Seat 1: Raidylol folded before Flop (didn't bet)
Seat 2: podrico79 collected ($0.25)
Seat 3: Igor22913 folded before Flop (didn't bet)
Seat 4: Acedan1369 (button) folded before Flop (didn't bet)
Seat 5: easywtf (small blind) folded before Flop
Seat 6: fish72o (big blind) folded before Flop



PokerStars Hand #222970739426:  Hold'em No Limit ($0.05/$0.10 USD) - 2021/01/23 15:57:42 ET
Table 'Lutetia III' 6-max Seat #5 is the button
Seat 1: Raidylol ($11.23 in chips) 
Seat 2: podrico79 ($8.82 in chips) 
Seat 3: Igor22913 ($10.04 in chips) 
Seat 4: Acedan1369 ($23.58 in chips) 
Seat 5: easywtf ($6.61 in chips) 
Seat 6: fish72o ($10.54 in chips) 
fish72o: posts small blind $0.05
Raidylol: posts big blind $0.10
*** HOLE CARDS ***
podrico79: folds 
Igor22913: folds 
Acedan1369: raises $0.15 to $0.25
easywtf: calls $0.25
fish72o: folds 
Raidylol: raises $1.05 to $1.30
Acedan1369: raises $1.50 to $2.80
easywtf: folds 
Raidylol: raises $8.43 to $11.23 and is all-in
Acedan1369: calls $8.43
*** FLOP *** [Th 7d 4c]
*** TURN *** [Th 7d 4c] [7h]
*** RIVER *** [Th 7d 4c 7h] [Qc]
*** SHOW DOWN ***
Raidylol: shows [Ac Kc] (a pair of Sevens)
Acedan1369: shows [Kh Ah] (a pair of Sevens)
Raidylol collected $10.87 from pot
Acedan1369 collected $10.87 from pot
*** SUMMARY ***
Total pot $22.76 | Rake $1.02 
Board [Th 7d 4c 7h Qc]
Seat 1: Raidylol (big blind) showed [Ac Kc] and won ($10.87) with a pair of Sevens
Seat 2: podrico79 folded before Flop (didn't bet)
Seat 3: Igor22913 folded before Flop (didn't bet)
Seat 4: Acedan1369 showed [Kh Ah] and won ($10.87) with a pair of Sevens
Seat 5: easywtf (button) folded before Flop
Seat 6: fish72o (small blind) folded before Flop



PokerStars Hand #222970771678:  Hold'em No Limit ($0.05/$0.10 USD) - 2021/01/23 15:58:39 ET
Table 'Lutetia III' 6-max Seat #6 is the button
Seat 1: Raidylol ($10.87 in chips) 
Seat 2: podrico79 ($8.82 in chips) 
Seat 3: Igor22913 ($10.04 in chips) 
Seat 4: Acedan1369 ($23.22 in chips) 
Seat 5: easywtf ($10 in chips) 
Seat 6: fish72o ($10.49 in chips) 
Raidylol: posts small blind $0.05
podrico79: posts big blind $0.10
*** HOLE CARDS ***
Igor22913: folds 
Acedan1369: folds 
easywtf: raises $0.15 to $0.25
fish72o: calls $0.25
Raidylol: folds 
podrico79: calls $0.15
*** FLOP *** [2s Ad 6s]
podrico79: checks 
easywtf: checks 
fish72o: bets $0.15
podrico79: calls $0.15
easywtf: calls $0.15
*** TURN *** [2s Ad 6s] [5h]
podrico79: checks 
easywtf: checks 
fish72o: checks 
*** RIVER *** [2s Ad 6s 5h] [8c]
podrico79: checks 
easywtf: checks 
fish72o: checks 
*** SHOW DOWN ***
podrico79: shows [3h 3d] (a pair of Threes)
easywtf: shows [Ah 4h] (a pair of Aces)
fish72o: mucks hand 
easywtf collected $1.19 from pot
*** SUMMARY ***
Total pot $1.25 | Rake $0.06 
Board [2s Ad 6s 5h 8c]
Seat 1: Raidylol (small blind) folded before Flop
Seat 2: podrico79 (big blind) showed [3h 3d] and lost with a pair of Threes
Seat 3: Igor22913 folded before Flop (didn't bet)
Seat 4: Acedan1369 folded before Flop (didn't bet)
Seat 5: easywtf showed [Ah 4h] and won ($1.19) with a pair of Aces
Seat 6: fish72o (button) mucked



PokerStars Hand #222970818307:  Hold'em No Limit ($0.05/$0.10 USD) - 2021/01/23 16:00:00 ET
Table 'Lutetia III' 6-max Seat #1 is the button
Seat 1: Raidylol ($10.82 in chips) 
Seat 2: podrico79 ($8.42 in chips) 
Seat 3: Igor22913 ($10.04 in chips) 
Seat 4: Acedan1369 ($23.22 in chips) 
Seat 5: easywtf ($10.79 in chips) 
Seat 6: fish72o ($10.09 in chips) 
podrico79: posts small blind $0.05
Igor22913: posts big blind $0.10
*** HOLE CARDS ***
Acedan1369: folds 
easywtf: folds 
fish72o: folds 
Raidylol: raises $0.15 to $0.25
podrico79: folds 
Igor22913: folds 
Uncalled bet ($0.15) returned to Raidylol
Raidylol collected $0.25 from pot
*** SUMMARY ***
Total pot $0.25 | Rake $0 
Seat 1: Raidylol (button) collected ($0.25)
Seat 2: podrico79 (small blind) folded before Flop
Seat 3: Igor22913 (big blind) folded before Flop
Seat 4: Acedan1369 folded before Flop (didn't bet)
Seat 5: easywtf folded before Flop (didn't bet)
Seat 6: fish72o folded before Flop (didn't bet)



PokerStars Hand #222970829488:  Hold'em No Limit ($0.05/$0.10 USD) - 2021/01/23 16:00:19 ET
Table 'Lutetia III' 6-max Seat #2 is the button
Seat 1: Raidylol ($10.97 in chips) 
Seat 2: podrico79 ($8.37 in chips) 
Seat 3: Igor22913 ($10 in chips) 
Seat 4: Acedan1369 ($23.22 in chips) 
Seat 5: easywtf ($10.79 in chips) 
Seat 6: fish72o ($10.09 in chips) 
Igor22913: posts small blind $0.05
Acedan1369: posts big blind $0.10
*** HOLE CARDS ***
easywtf: folds 
fish72o: folds 
Raidylol: folds 
podrico79: folds 
Igor22913: raises $0.20 to $0.30
Acedan1369: calls $0.20
*** FLOP *** [5c Js 2c]
Igor22913: checks 
Acedan1369: bets $0.43
Igor22913: calls $0.43
*** TURN *** [5c Js 2c] [Ad]
Igor22913: checks 
Acedan1369: checks 
*** RIVER *** [5c Js 2c Ad] [7c]
Igor22913: checks 
Acedan1369: checks 
*** SHOW DOWN ***
Igor22913: shows [Ah Kc] (a pair of Aces)
Acedan1369: mucks hand 
Igor22913 collected $1.39 from pot
*** SUMMARY ***
Total pot $1.46 | Rake $0.07 
Board [5c Js 2c Ad 7c]
Seat 1: Raidylol folded before Flop (didn't bet)
Seat 2: podrico79 (button) folded before Flop (didn't bet)
Seat 3: Igor22913 (small blind) showed [Ah Kc] and won ($1.39) with a pair of Aces
Seat 4: Acedan1369 (big blind) mucked
Seat 5: easywtf folded before Flop (didn't bet)
Seat 6: fish72o folded before Flop (didn't bet)



PokerStars Hand #222970850824:  Hold'em No Limit ($0.05/$0.10 USD) - 2021/01/23 16:00:52 ET
Table 'Lutetia III' 6-max Seat #3 is the button
Seat 1: Raidylol ($10.97 in chips) 
Seat 2: podrico79 ($8.37 in chips) 
Seat 3: Igor22913 ($10.66 in chips) 
Seat 4: Acedan1369 ($22.49 in chips) 
Seat 5: easywtf ($10.79 in chips) 
Seat 6: fish72o ($10.09 in chips) 
Acedan1369: posts small blind $0.05
easywtf: posts big blind $0.10
*** HOLE CARDS ***
fish72o: folds 
Raidylol: folds 
podrico79: raises $0.10 to $0.20
Igor22913: folds 
Acedan1369: raises $0.65 to $0.85
easywtf: folds 
podrico79: folds 
Uncalled bet ($0.65) returned to Acedan1369
Acedan1369 collected $0.50 from pot
Acedan1369: doesn't show hand 
*** SUMMARY ***
Total pot $0.50 | Rake $0 
Seat 1: Raidylol folded before Flop (didn't bet)
Seat 2: podrico79 folded before Flop
Seat 3: Igor22913 (button) folded before Flop (didn't bet)
Seat 4: Acedan1369 (small blind) collected ($0.50)
Seat 5: easywtf (big blind) folded before Flop
Seat 6: fish72o folded before Flop (didn't bet)



PokerStars Hand #222970873957:  Hold'em No Limit ($0.05/$0.10 USD) - 2021/01/23 16:01:27 ET
Table 'Lutetia III' 6-max Seat #4 is the button
Seat 1: Raidylol ($10.97 in chips) 
Seat 2: podrico79 ($8.17 in chips) 
Seat 3: Igor22913 ($10.66 in chips) 
Seat 4: Acedan1369 ($22.79 in chips) 
Seat 5: easywtf ($10.69 in chips) 
easywtf: posts small blind $0.05
fish72o: is sitting out 
Raidylol: posts big blind $0.10
*** HOLE CARDS ***
podrico79: folds 
Igor22913: folds 
Acedan1369: folds 
easywtf: folds 
Uncalled bet ($0.05) returned to Raidylol
Raidylol collected $0.10 from pot
*** SUMMARY ***
Total pot $0.10 | Rake $0 
Seat 1: Raidylol (big blind) collected ($0.10)
Seat 2: podrico79 folded before Flop (didn't bet)
Seat 3: Igor22913 folded before Flop (didn't bet)
Seat 4: Acedan1369 (button) folded before Flop (didn't bet)
Seat 5: easywtf (small blind) folded before Flop



PokerStars Hand #222970881445:  Hold'em No Limit ($0.05/$0.10 USD) - 2021/01/23 16:01:37 ET
Table 'Lutetia III' 6-max Seat #5 is the button
Seat 1: Raidylol ($11.02 in chips) 
Seat 2: podrico79 ($8.17 in chips) 
Seat 3: Igor22913 ($10.66 in chips) 
Seat 4: Acedan1369 ($22.79 in chips) 
Seat 5: easywtf ($10.64 in chips) 
Raidylol: posts small blind $0.05
podrico79: posts big blind $0.10
*** HOLE CARDS ***
Igor22913: folds 
Acedan1369: folds 
easywtf: folds 
Raidylol: folds 
Uncalled bet ($0.05) returned to podrico79
podrico79 collected $0.10 from pot
podrico79: doesn't show hand 
*** SUMMARY ***
Total pot $0.10 | Rake $0 
Seat 1: Raidylol (small blind) folded before Flop
Seat 2: podrico79 (big blind) collected ($0.10)
Seat 3: Igor22913 folded before Flop (didn't bet)
Seat 4: Acedan1369 folded before Flop (didn't bet)
Seat 5: easywtf (button) folded before Flop (didn't bet)



PokerStars Hand #222970891909:  Hold'em No Limit ($0.05/$0.10 USD) - 2021/01/23 16:01:51 ET
Table 'Lutetia III' 6-max Seat #1 is the button
Seat 1: Raidylol ($10.97 in chips) 
Seat 2: podrico79 ($8.22 in chips) 
Seat 3: Igor22913 ($10.66 in chips) 
Seat 4: Acedan1369 ($22.79 in chips) 
Seat 5: easywtf ($10.64 in chips) 
podrico79: posts small blind $0.05
Igor22913: posts big blind $0.10
*** HOLE CARDS ***
fish72o leaves the table
Acedan1369: folds 
easywtf: folds 
Raidylol: folds 
podrico79: calls $0.05
Igor22913: raises $0.30 to $0.40
podrico79: folds 
Uncalled bet ($0.30) returned to Igor22913
Igor22913 collected $0.20 from pot
Igor22913: doesn't show hand 
*** SUMMARY ***
Total pot $0.20 | Rake $0 
Seat 1: Raidylol (button) folded before Flop (didn't bet)
Seat 2: podrico79 (small blind) folded before Flop
Seat 3: Igor22913 (big blind) collected ($0.20)
Seat 4: Acedan1369 folded before Flop (didn't bet)
Seat 5: easywtf folded before Flop (didn't bet)



PokerStars Hand #222970911691:  Hold'em No Limit ($0.05/$0.10 USD) - 2021/01/23 16:02:17 ET
Table 'Lutetia III' 6-max Seat #2 is the button
Seat 1: Raidylol ($10.97 in chips) 
Seat 2: podrico79 ($8.12 in chips) 
Seat 3: Igor22913 ($10.76 in chips) 
Seat 4: Acedan1369 ($22.79 in chips) 
Seat 5: easywtf ($10.64 in chips) 
Igor22913: posts small blind $0.05
Acedan1369: posts big blind $0.10
*** HOLE CARDS ***
easywtf: folds 
Raidylol: raises $0.15 to $0.25
podrico79: folds 
Igor22913: folds 
Acedan1369: raises $0.60 to $0.85
jorgeebanks joins the table at seat #6 
Raidylol: folds 
Uncalled bet ($0.60) returned to Acedan1369
Acedan1369 collected $0.55 from pot
Acedan1369: doesn't show hand 
*** SUMMARY ***
Total pot $0.55 | Rake $0 
Seat 1: Raidylol folded before Flop
Seat 2: podrico79 (button) folded before Flop (didn't bet)
Seat 3: Igor22913 (small blind) folded before Flop
Seat 4: Acedan1369 (big blind) collected ($0.55)
Seat 5: easywtf folded before Flop (didn't bet)



PokerStars Hand #222970937259:  Hold'em No Limit ($0.05/$0.10 USD) - 2021/01/23 16:02:49 ET
Table 'Lutetia III' 6-max Seat #3 is the button
Seat 1: Raidylol ($10.72 in chips) 
Seat 2: podrico79 ($8.12 in chips) 
Seat 3: Igor22913 ($10.71 in chips) 
Seat 4: Acedan1369 ($23.09 in chips) 
Seat 5: easywtf ($10.64 in chips) 
Acedan1369: posts small blind $0.05
easywtf: posts big blind $0.10
jorgeebanks: sits out 
*** HOLE CARDS ***
Raidylol: folds 
podrico79: folds 
Igor22913: folds 
Acedan1369: raises $0.15 to $0.25
easywtf: calls $0.15
*** FLOP *** [Jd 5d Jc]
Acedan1369: checks 
easywtf: checks 
*** TURN *** [Jd 5d Jc] [Td]
Acedan1369: checks 
easywtf: checks 
*** RIVER *** [Jd 5d Jc Td] [2s]
Acedan1369: checks 
easywtf: checks 
*** SHOW DOWN ***
Acedan1369: shows [4d Ah] (a pair of Jacks)
easywtf: mucks hand 
Acedan1369 collected $0.48 from pot
*** SUMMARY ***
Total pot $0.50 | Rake $0.02 
Board [Jd 5d Jc Td 2s]
Seat 1: Raidylol folded before Flop (didn't bet)
Seat 2: podrico79 folded before Flop (didn't bet)
Seat 3: Igor22913 (button) folded before Flop (didn't bet)
Seat 4: Acedan1369 (small blind) showed [4d Ah] and won ($0.48) with a pair of Jacks
Seat 5: easywtf (big blind) mucked



PokerStars Hand #222971000683:  Hold'em No Limit ($0.05/$0.10 USD) - 2021/01/23 16:04:06 ET
Table 'Lutetia III' 6-max Seat #4 is the button
Seat 1: Raidylol ($10.72 in chips) 
Seat 2: podrico79 ($8.12 in chips) 
Seat 3: Igor22913 ($10.71 in chips) 
Seat 4: Acedan1369 ($23.32 in chips) 
Seat 5: easywtf ($10.39 in chips) 
Seat 6: jorgeebanks ($10 in chips) 
easywtf: posts small blind $0.05
jorgeebanks: posts big blind $0.10
*** HOLE CARDS ***
Raidylol: folds 
podrico79: folds 
Igor22913: folds 
Acedan1369: folds 
easywtf: folds 
Uncalled bet ($0.05) returned to jorgeebanks
jorgeebanks collected $0.10 from pot
jorgeebanks: doesn't show hand 
*** SUMMARY ***
Total pot $0.10 | Rake $0 
Seat 1: Raidylol folded before Flop (didn't bet)
Seat 2: podrico79 folded before Flop (didn't bet)
Seat 3: Igor22913 folded before Flop (didn't bet)
Seat 4: Acedan1369 (button) folded before Flop (didn't bet)
Seat 5: easywtf (small blind) folded before Flop
Seat 6: jorgeebanks (big blind) collected ($0.10)



PokerStars Hand #222971026797:  Hold'em No Limit ($0.05/$0.10 USD) - 2021/01/23 16:04:38 ET
Table 'Lutetia III' 6-max Seat #5 is the button
Seat 1: Raidylol ($10.72 in chips) 
Seat 2: podrico79 ($8.12 in chips) 
Seat 3: Igor22913 ($10.71 in chips) 
Seat 4: Acedan1369 ($23.32 in chips) 
Seat 5: easywtf ($10.34 in chips) 
Seat 6: jorgeebanks ($10.05 in chips) 
jorgeebanks: posts small blind $0.05
Raidylol: posts big blind $0.10
*** HOLE CARDS ***
podrico79 has timed out
podrico79: folds 
Igor22913: raises $0.15 to $0.25
Acedan1369: folds 
easywtf: folds 
jorgeebanks: folds 
Raidylol: folds 
Uncalled bet ($0.15) returned to Igor22913
Igor22913 collected $0.25 from pot
Igor22913: doesn't show hand 
podrico79 is disconnected 
*** SUMMARY ***
Total pot $0.25 | Rake $0 
Seat 1: Raidylol (big blind) folded before Flop
Seat 2: podrico79 folded before Flop (didn't bet)
Seat 3: Igor22913 collected ($0.25)
Seat 4: Acedan1369 folded before Flop (didn't bet)
Seat 5: easywtf (button) folded before Flop (didn't bet)
Seat 6: jorgeebanks (small blind) folded before Flop



PokerStars Hand #222971045628:  Hold'em No Limit ($0.05/$0.10 USD) - 2021/01/23 16:05:00 ET
Table 'Lutetia III' 6-max Seat #6 is the button
Seat 1: Raidylol ($10.62 in chips) 
Seat 4: Acedan1369 ($23.32 in chips) 
Seat 5: easywtf ($10.34 in chips) 
Seat 6: jorgeebanks ($10 in chips) 
Raidylol: posts small blind $0.05
podrico79 has timed out while disconnected
podrico79: is sitting out 
Igor22913: is sitting out 
Acedan1369: posts big blind $0.10
*** HOLE CARDS ***
easywtf: folds 
jorgeebanks: folds 
Igor22913 leaves the table
Raidylol: folds 
Uncalled bet ($0.05) returned to Acedan1369
Acedan1369 collected $0.10 from pot
Acedan1369: doesn't show hand 
*** SUMMARY ***
Total pot $0.10 | Rake $0 
Seat 1: Raidylol (small blind) folded before Flop
Seat 4: Acedan1369 (big blind) collected ($0.10)
Seat 5: easywtf folded before Flop (didn't bet)
Seat 6: jorgeebanks (button) folded before Flop (didn't bet)



PokerStars Hand #222971062644:  Hold'em No Limit ($0.05/$0.10 USD) - 2021/01/23 16:05:20 ET
Table 'Lutetia III' 6-max Seat #1 is the button
Seat 1: Raidylol ($10.57 in chips) 
Seat 4: Acedan1369 ($23.37 in chips) 
Seat 5: easywtf ($10.34 in chips) 
Seat 6: jorgeebanks ($10 in chips) 
Acedan1369: posts small blind $0.05
easywtf: posts big blind $0.10
*** HOLE CARDS ***
Leandra1808 joins the table at seat #3 
jorgeebanks: folds 
Raidylol: folds 
Acedan1369: folds 
Uncalled bet ($0.05) returned to easywtf
easywtf collected $0.10 from pot
easywtf: doesn't show hand 
*** SUMMARY ***
Total pot $0.10 | Rake $0 
Seat 1: Raidylol (button) folded before Flop (didn't bet)
Seat 4: Acedan1369 (small blind) folded before Flop
Seat 5: easywtf (big blind) collected ($0.10)
Seat 6: jorgeebanks folded before Flop (didn't bet)



PokerStars Hand #222971071337:  Hold'em No Limit ($0.05/$0.10 USD) - 2021/01/23 16:05:31 ET
Table 'Lutetia III' 6-max Seat #4 is the button
Seat 1: Raidylol ($10.57 in chips) 
Seat 4: Acedan1369 ($23.32 in chips) 
Seat 5: easywtf ($10.39 in chips) 
Seat 6: jorgeebanks ($10 in chips) 
easywtf: posts small blind $0.05
jorgeebanks: posts big blind $0.10
Leandra1808: sits out 
*** HOLE CARDS ***
Raidylol: folds 
Acedan1369: folds 
easywtf: raises $0.15 to $0.25
jorgeebanks: folds 
Uncalled bet ($0.15) returned to easywtf
easywtf collected $0.20 from pot
easywtf: doesn't show hand 
*** SUMMARY ***
Total pot $0.20 | Rake $0 
Seat 1: Raidylol folded before Flop (didn't bet)
Seat 4: Acedan1369 (button) folded before Flop (didn't bet)
Seat 5: easywtf (small blind) collected ($0.20)
Seat 6: jorgeebanks (big blind) folded before Flop



PokerStars Hand #222971078255:  Hold'em No Limit ($0.05/$0.10 USD) - 2021/01/23 16:05:39 ET
Table 'Lutetia III' 6-max Seat #5 is the button
Seat 1: Raidylol ($10.57 in chips) 
Seat 3: Leandra1808 ($8 in chips) 
Seat 4: Acedan1369 ($23.32 in chips) 
Seat 5: easywtf ($10.49 in chips) 
Seat 6: jorgeebanks ($9.90 in chips) 
jorgeebanks: posts small blind $0.05
Raidylol: posts big blind $0.10
Leandra1808: posts big blind $0.10
*** HOLE CARDS ***
Leandra1808: checks 
Acedan1369: raises $0.30 to $0.40
easywtf: folds 
jorgeebanks: folds 
Raidylol: folds 
Leandra1808: folds 
Uncalled bet ($0.30) returned to Acedan1369
Acedan1369 collected $0.35 from pot
Acedan1369: doesn't show hand 
*** SUMMARY ***
Total pot $0.35 | Rake $0 
Seat 1: Raidylol (big blind) folded before Flop
Seat 3: Leandra1808 folded before Flop (didn't bet)
Seat 4: Acedan1369 collected ($0.35)
Seat 5: easywtf (button) folded before Flop (didn't bet)
Seat 6: jorgeebanks (small blind) folded before Flop



PokerStars Hand #222971096885:  Hold'em No Limit ($0.05/$0.10 USD) - 2021/01/23 16:06:01 ET
Table 'Lutetia III' 6-max Seat #6 is the button
Seat 1: Raidylol ($10.47 in chips) 
Seat 3: Leandra1808 ($7.90 in chips) 
Seat 4: Acedan1369 ($23.57 in chips) 
Seat 5: easywtf ($10.49 in chips) 
Seat 6: jorgeebanks ($9.85 in chips) 
Raidylol: posts small blind $0.05
Leandra1808: posts big blind $0.10
*** HOLE CARDS ***
Acedan1369: raises $0.15 to $0.25
easywtf: folds 
jorgeebanks: calls $0.25
Raidylol: raises $0.95 to $1.20
Leandra1808: folds 
Acedan1369: calls $0.95
jorgeebanks: folds 
*** FLOP *** [3h 8s Ah]
Raidylol: checks 
Acedan1369: bets $1.18
Raidylol: calls $1.18
*** TURN *** [3h 8s Ah] [4d]
Raidylol: checks 
Acedan1369: bets $2.20
Raidylol: calls $2.20
*** RIVER *** [3h 8s Ah 4d] [9h]
Raidylol: bets $5.89 and is all-in
Acedan1369: calls $5.89
*** SHOW DOWN ***
Raidylol: shows [Ad Jc] (a pair of Aces)
Acedan1369: shows [8h 8d] (three of a kind, Eights)
Acedan1369 collected $20.33 from pot
*** SUMMARY ***
Total pot $21.29 | Rake $0.96 
Board [3h 8s Ah 4d 9h]
Seat 1: Raidylol (small blind) showed [Ad Jc] and lost with a pair of Aces
Seat 3: Leandra1808 (big blind) folded before Flop
Seat 4: Acedan1369 showed [8h 8d] and won ($20.33) with three of a kind, Eights
Seat 5: easywtf folded before Flop (didn't bet)
Seat 6: jorgeebanks (button) folded before Flop



PokerStars Hand #222971145219:  Hold'em No Limit ($0.05/$0.10 USD) - 2021/01/23 16:06:59 ET
Table 'Lutetia III' 6-max Seat #1 is the button
Seat 1: Raidylol ($10 in chips) 
Seat 3: Leandra1808 ($7.80 in chips) 
Seat 4: Acedan1369 ($33.43 in chips) 
Seat 5: easywtf ($10.49 in chips) 
Seat 6: jorgeebanks ($9.60 in chips) 
Leandra1808: posts small blind $0.05
Acedan1369: posts big blind $0.10
*** HOLE CARDS ***
easywtf: folds 
jorgeebanks: folds 
Raidylol: folds 
Leandra1808: raises $0.10 to $0.20
Acedan1369: folds 
Uncalled bet ($0.10) returned to Leandra1808
Leandra1808 collected $0.20 from pot
Leandra1808: doesn't show hand 
*** SUMMARY ***
Total pot $0.20 | Rake $0 
Seat 1: Raidylol (button) folded before Flop (didn't bet)
Seat 3: Leandra1808 (small blind) collected ($0.20)
Seat 4: Acedan1369 (big blind) folded before Flop
Seat 5: easywtf folded before Flop (didn't bet)
Seat 6: jorgeebanks folded before Flop (didn't bet)



PokerStars Hand #222971155464:  Hold'em No Limit ($0.05/$0.10 USD) - 2021/01/23 16:07:11 ET
Table 'Lutetia III' 6-max Seat #3 is the button
Seat 1: Raidylol ($10 in chips) 
Seat 3: Leandra1808 ($7.90 in chips) 
Seat 4: Acedan1369 ($33.33 in chips) 
Seat 5: easywtf ($10.49 in chips) 
Seat 6: jorgeebanks ($9.60 in chips) 
Acedan1369: posts small blind $0.05
easywtf: posts big blind $0.10
*** HOLE CARDS ***
jorgeebanks: raises $0.20 to $0.30
Raidylol: folds 
Leandra1808: folds 
Acedan1369: folds 
easywtf: calls $0.20
*** FLOP *** [As 9h 9s]
easywtf: checks 
jorgeebanks: bets $0.31
easywtf: folds 
Uncalled bet ($0.31) returned to jorgeebanks
jorgeebanks collected $0.62 from pot
jorgeebanks: doesn't show hand 
*** SUMMARY ***
Total pot $0.65 | Rake $0.03 
Board [As 9h 9s]
Seat 1: Raidylol folded before Flop (didn't bet)
Seat 3: Leandra1808 (button) folded before Flop (didn't bet)
Seat 4: Acedan1369 (small blind) folded before Flop
Seat 5: easywtf (big blind) folded on the Flop
Seat 6: jorgeebanks collected ($0.62)



PokerStars Hand #222971171179:  Hold'em No Limit ($0.05/$0.10 USD) - 2021/01/23 16:07:30 ET
Table 'Lutetia III' 6-max Seat #4 is the button
Seat 1: Raidylol ($10 in chips) 
Seat 3: Leandra1808 ($7.90 in chips) 
Seat 4: Acedan1369 ($33.28 in chips) 
Seat 5: easywtf ($10.19 in chips) 
Seat 6: jorgeebanks ($9.92 in chips) 
easywtf: posts small blind $0.05
jorgeebanks: posts big blind $0.10
*** HOLE CARDS ***
Raidylol: folds 
Leandra1808: calls $0.10
Acedan1369: folds 
easywtf: folds 
jorgeebanks: checks 
*** FLOP *** [8s Tc 6c]
jorgeebanks: bets $0.10
Leandra1808: calls $0.10
*** TURN *** [8s Tc 6c] [8d]
jorgeebanks: bets $0.22
Leandra1808: calls $0.22
*** RIVER *** [8s Tc 6c 8d] [9c]
jorgeebanks: checks 
Leandra1808: bets $0.85
jorgeebanks: folds 
Uncalled bet ($0.85) returned to Leandra1808
Leandra1808 collected $0.85 from pot
Leandra1808: doesn't show hand 
*** SUMMARY ***
Total pot $0.89 | Rake $0.04 
Board [8s Tc 6c 8d 9c]
Seat 1: Raidylol folded before Flop (didn't bet)
Seat 3: Leandra1808 collected ($0.85)
Seat 4: Acedan1369 (button) folded before Flop (didn't bet)
Seat 5: easywtf (small blind) folded before Flop
Seat 6: jorgeebanks (big blind) folded on the River



PokerStars Hand #222971199229:  Hold'em No Limit ($0.05/$0.10 USD) - 2021/01/23 16:08:04 ET
Table 'Lutetia III' 6-max Seat #5 is the button
Seat 1: Raidylol ($10 in chips) 
Seat 3: Leandra1808 ($8.33 in chips) 
Seat 4: Acedan1369 ($33.28 in chips) 
Seat 5: easywtf ($10.14 in chips) 
Seat 6: jorgeebanks ($9.50 in chips) 
jorgeebanks: posts small blind $0.05
Raidylol: posts big blind $0.10
*** HOLE CARDS ***
Leandra1808: folds 
Acedan1369: folds 
easywtf: folds 
jorgeebanks: raises $0.20 to $0.30
Raidylol: folds 
Uncalled bet ($0.20) returned to jorgeebanks
jorgeebanks collected $0.20 from pot
jorgeebanks: doesn't show hand 
*** SUMMARY ***
Total pot $0.20 | Rake $0 
Seat 1: Raidylol (big blind) folded before Flop
Seat 3: Leandra1808 folded before Flop (didn't bet)
Seat 4: Acedan1369 folded before Flop (didn't bet)
Seat 5: easywtf (button) folded before Flop (didn't bet)
Seat 6: jorgeebanks (small blind) collected ($0.20)



PokerStars Hand #222971209103:  Hold'em No Limit ($0.05/$0.10 USD) - 2021/01/23 16:08:16 ET
Table 'Lutetia III' 6-max Seat #6 is the button
Seat 1: Raidylol ($10 in chips) 
Seat 3: Leandra1808 ($8.33 in chips) 
Seat 4: Acedan1369 ($33.28 in chips) 
Seat 5: easywtf ($10.14 in chips) 
Seat 6: jorgeebanks ($9.60 in chips) 
Raidylol: posts small blind $0.05
Leandra1808: posts big blind $0.10
*** HOLE CARDS ***
Acedan1369: folds 
easywtf: raises $0.15 to $0.25
jorgeebanks: folds 
Raidylol: folds 
Leandra1808: calls $0.15
*** FLOP *** [8h 5h 6h]
Leandra1808: bets $0.10
easywtf: calls $0.10
*** TURN *** [8h 5h 6h] [4s]
Leandra1808: bets $0.36
easywtf: folds 
Uncalled bet ($0.36) returned to Leandra1808
Leandra1808 collected $0.72 from pot
Leandra1808: doesn't show hand 
*** SUMMARY ***
Total pot $0.75 | Rake $0.03 
Board [8h 5h 6h 4s]
Seat 1: Raidylol (small blind) folded before Flop
Seat 3: Leandra1808 (big blind) collected ($0.72)
Seat 4: Acedan1369 folded before Flop (didn't bet)
Seat 5: easywtf folded on the Turn
Seat 6: jorgeebanks (button) folded before Flop (didn't bet)



PokerStars Hand #222971236950:  Hold'em No Limit ($0.05/$0.10 USD) - 2021/01/23 16:08:50 ET
Table 'Lutetia III' 6-max Seat #1 is the button
Seat 1: Raidylol ($10 in chips) 
Seat 3: Leandra1808 ($8.70 in chips) 
Seat 4: Acedan1369 ($33.28 in chips) 
Seat 5: easywtf ($9.79 in chips) 
Seat 6: jorgeebanks ($9.60 in chips) 
Leandra1808: posts small blind $0.05
Acedan1369: posts big blind $0.10
*** HOLE CARDS ***
easywtf: folds 
jorgeebanks: raises $0.10 to $0.20
Raidylol: raises $0.60 to $0.80
Leandra1808: folds 
Acedan1369: folds 
jorgeebanks: calls $0.60
*** FLOP *** [4c Js Ac]
jorgeebanks: checks 
Raidylol: checks 
*** TURN *** [4c Js Ac] [6s]
jorgeebanks: bets $0.84
Raidylol: calls $0.84
*** RIVER *** [4c Js Ac 6s] [2h]
jorgeebanks: checks 
Raidylol: checks 
*** SHOW DOWN ***
jorgeebanks: shows [5c 6c] (a pair of Sixes)
Raidylol: shows [Kd Kc] (a pair of Kings)
Raidylol collected $3.28 from pot
*** SUMMARY ***
Total pot $3.43 | Rake $0.15 
Board [4c Js Ac 6s 2h]
Seat 1: Raidylol (button) showed [Kd Kc] and won ($3.28) with a pair of Kings
Seat 3: Leandra1808 (small blind) folded before Flop
Seat 4: Acedan1369 (big blind) folded before Flop
Seat 5: easywtf folded before Flop (didn't bet)
Seat 6: jorgeebanks showed [5c 6c] and lost with a pair of Sixes



PokerStars Hand #222971265539:  Hold'em No Limit ($0.05/$0.10 USD) - 2021/01/23 16:09:24 ET
Table 'Lutetia III' 6-max Seat #3 is the button
Seat 1: Raidylol ($11.64 in chips) 
Seat 3: Leandra1808 ($8.65 in chips) 
Seat 4: Acedan1369 ($33.18 in chips) 
Seat 5: easywtf ($9.79 in chips) 
Seat 6: jorgeebanks ($7.96 in chips) 
Acedan1369: posts small blind $0.05
easywtf: posts big blind $0.10
*** HOLE CARDS ***
jorgeebanks: folds 
Raidylol: folds 
Leandra1808: folds 
Acedan1369: folds 
Uncalled bet ($0.05) returned to easywtf
easywtf collected $0.10 from pot
easywtf: doesn't show hand 
*** SUMMARY ***
Total pot $0.10 | Rake $0 
Seat 1: Raidylol folded before Flop (didn't bet)
Seat 3: Leandra1808 (button) folded before Flop (didn't bet)
Seat 4: Acedan1369 (small blind) folded before Flop
Seat 5: easywtf (big blind) collected ($0.10)
Seat 6: jorgeebanks folded before Flop (didn't bet)



PokerStars Hand #222971271843:  Hold'em No Limit ($0.05/$0.10 USD) - 2021/01/23 16:09:32 ET
Table 'Lutetia III' 6-max Seat #4 is the button
Seat 1: Raidylol ($11.64 in chips) 
Seat 3: Leandra1808 ($8.65 in chips) 
Seat 4: Acedan1369 ($33.13 in chips) 
Seat 5: easywtf ($9.84 in chips) 
Seat 6: jorgeebanks ($10 in chips) 
easywtf: posts small blind $0.05
jorgeebanks: posts big blind $0.10
*** HOLE CARDS ***
Raidylol: folds 
Leandra1808: calls $0.10
Acedan1369: folds 
easywtf: calls $0.05
jorgeebanks: checks 
*** FLOP *** [As Tc 7h]
easywtf: checks 
jorgeebanks: bets $0.10
Leandra1808: folds 
easywtf: calls $0.10
*** TURN *** [As Tc 7h] [8s]
easywtf: checks 
jorgeebanks: checks 
*** RIVER *** [As Tc 7h 8s] [Ks]
easywtf: checks 
jorgeebanks: checks 
*** SHOW DOWN ***
easywtf: shows [Th 9d] (a pair of Tens)
jorgeebanks: mucks hand 
easywtf collected $0.48 from pot
*** SUMMARY ***
Total pot $0.50 | Rake $0.02 
Board [As Tc 7h 8s Ks]
Seat 1: Raidylol folded before Flop (didn't bet)
Seat 3: Leandra1808 folded on the Flop
Seat 4: Acedan1369 (button) folded before Flop (didn't bet)
Seat 5: easywtf (small blind) showed [Th 9d] and won ($0.48) with a pair of Tens
Seat 6: jorgeebanks (big blind) mucked



PokerStars Hand #222971297585:  Hold'em No Limit ($0.05/$0.10 USD) - 2021/01/23 16:10:02 ET
Table 'Lutetia III' 6-max Seat #5 is the button
Seat 1: Raidylol ($11.64 in chips) 
Seat 3: Leandra1808 ($8.55 in chips) 
Seat 5: easywtf ($10.12 in chips) 
Seat 6: jorgeebanks ($9.80 in chips) 
jorgeebanks: posts small blind $0.05
Raidylol: posts big blind $0.10
*** HOLE CARDS ***
Leandra1808: calls $0.10
easywtf: folds 
jorgeebanks: folds 
Raidylol: checks 
*** FLOP *** [Kc 8d Ks]
Raidylol: checks 
Leandra1808: checks 
*** TURN *** [Kc 8d Ks] [4s]
Raidylol: checks 
Leandra1808: checks 
*** RIVER *** [Kc 8d Ks 4s] [2c]
Raidylol: checks 
Leandra1808: checks 
*** SHOW DOWN ***
Raidylol: shows [Qs Tc] (a pair of Kings)
Leandra1808: shows [3h Ac] (a pair of Kings - Ace kicker)
Leandra1808 collected $0.24 from pot
*** SUMMARY ***
Total pot $0.25 | Rake $0.01 
Board [Kc 8d Ks 4s 2c]
Seat 1: Raidylol (big blind) showed [Qs Tc] and lost with a pair of Kings
Seat 3: Leandra1808 showed [3h Ac] and won ($0.24) with a pair of Kings
Seat 5: easywtf (button) folded before Flop (didn't bet)
Seat 6: jorgeebanks (small blind) folded before Flop



PokerStars Hand #222971321213:  Hold'em No Limit ($0.05/$0.10 USD) - 2021/01/23 16:10:30 ET
Table 'Lutetia III' 6-max Seat #6 is the button
Seat 1: Raidylol ($11.54 in chips) 
Seat 3: Leandra1808 ($8.69 in chips) 
Seat 5: easywtf ($10.12 in chips) 
Seat 6: jorgeebanks ($9.75 in chips) 
Raidylol: posts small blind $0.05
Leandra1808: posts big blind $0.10
*** HOLE CARDS ***
easywtf: folds 
jorgeebanks: raises $0.20 to $0.30
Raidylol: folds 
Leandra1808: calls $0.20
*** FLOP *** [4s 9s Js]
Leandra1808: checks 
jorgeebanks: checks 
*** TURN *** [4s 9s Js] [5c]
Leandra1808: checks 
jorgeebanks: bets $0.31
Leandra1808: folds 
Uncalled bet ($0.31) returned to jorgeebanks
jorgeebanks collected $0.62 from pot
podrico79 was removed from the table for failing to post
podrico79 leaves the table
jorgeebanks: doesn't show hand 
*** SUMMARY ***
Total pot $0.65 | Rake $0.03 
Board [4s 9s Js 5c]
Seat 1: Raidylol (small blind) folded before Flop
Seat 3: Leandra1808 (big blind) folded on the Turn
Seat 5: easywtf folded before Flop (didn't bet)
Seat 6: jorgeebanks (button) collected ($0.62)



PokerStars Hand #222971348403:  Hold'em No Limit ($0.05/$0.10 USD) - 2021/01/23 16:11:03 ET
Table 'Lutetia III' 6-max Seat #1 is the button
Seat 1: Raidylol ($11.49 in chips) 
Seat 3: Leandra1808 ($8.39 in chips) 
Seat 5: easywtf ($10.12 in chips) 
Seat 6: jorgeebanks ($10.07 in chips) 
Leandra1808: posts small blind $0.05
easywtf: posts big blind $0.10
*** HOLE CARDS ***
jorgeebanks: folds 
fatkinglouie joins the table at seat #2 
Raidylol: folds 
Leandra1808: calls $0.05
easywtf: checks 
*** FLOP *** [Jd 6s 5s]
Leandra1808: checks 
easywtf: checks 
*** TURN *** [Jd 6s 5s] [5h]
Leandra1808: bets $0.19
easywtf: folds 
Uncalled bet ($0.19) returned to Leandra1808
Leandra1808 collected $0.19 from pot
Leandra1808: doesn't show hand 
*** SUMMARY ***
Total pot $0.20 | Rake $0.01 
Board [Jd 6s 5s 5h]
Seat 1: Raidylol (button) folded before Flop (didn't bet)
Seat 3: Leandra1808 (small blind) collected ($0.19)
Seat 5: easywtf (big blind) folded on the Turn
Seat 6: jorgeebanks folded before Flop (didn't bet)



PokerStars Hand #222971369190:  Hold'em No Limit ($0.05/$0.10 USD) - 2021/01/23 16:11:28 ET
Table 'Lutetia III' 6-max Seat #3 is the button
Seat 1: Raidylol ($11.49 in chips) 
Seat 3: Leandra1808 ($8.48 in chips) 
Seat 5: easywtf ($10.02 in chips) 
Seat 6: jorgeebanks ($10.07 in chips) 
easywtf: posts small blind $0.05
jorgeebanks: posts big blind $0.10
fatkinglouie: sits out 
*** HOLE CARDS ***
Raidylol: folds 
Leandra1808: raises $0.10 to $0.20
easywtf: calls $0.15
jorgeebanks: folds 
*** FLOP *** [Th 2s 4c]
easywtf: checks 
Leandra1808: checks 
*** TURN *** [Th 2s 4c] [7s]
easywtf: checks 
Leandra1808: checks 
*** RIVER *** [Th 2s 4c 7s] [Qc]
easywtf: checks 
Leandra1808: checks 
*** SHOW DOWN ***
easywtf: shows [3h 3c] (a pair of Threes)
Leandra1808: mucks hand 
easywtf collected $0.48 from pot
*** SUMMARY ***
Total pot $0.50 | Rake $0.02 
Board [Th 2s 4c 7s Qc]
Seat 1: Raidylol folded before Flop (didn't bet)
Seat 3: Leandra1808 (button) mucked
Seat 5: easywtf (small blind) showed [3h 3c] and won ($0.48) with a pair of Threes
Seat 6: jorgeebanks (big blind) folded before Flop



PokerStars Hand #222971386103:  Hold'em No Limit ($0.05/$0.10 USD) - 2021/01/23 16:11:49 ET
Table 'Lutetia III' 6-max Seat #5 is the button
Seat 1: Raidylol ($11.49 in chips) 
Seat 3: Leandra1808 ($8.28 in chips) 
Seat 5: easywtf ($10.30 in chips) 
Seat 6: jorgeebanks ($9.97 in chips) 
jorgeebanks: posts small blind $0.05
Raidylol: posts big blind $0.10
fatkinglouie: sits out 
*** HOLE CARDS ***
Leandra1808: calls $0.10
easywtf: folds 
jorgeebanks: folds 
Raidylol: checks 
*** FLOP *** [Jc Kc 6d]
Raidylol: checks 
Leandra1808: bets $0.10
Raidylol: raises $0.30 to $0.40
Leandra1808: calls $0.30
*** TURN *** [Jc Kc 6d] [Qh]
Raidylol: bets $1
Leandra1808: calls $1
*** RIVER *** [Jc Kc 6d Qh] [7d]
Raidylol: checks 
Leandra1808: checks 
*** SHOW DOWN ***
Raidylol: shows [8c 6c] (a pair of Sixes)
Leandra1808: shows [9h Ks] (a pair of Kings)
Leandra1808 collected $2.91 from pot
*** SUMMARY ***
Total pot $3.05 | Rake $0.14 
Board [Jc Kc 6d Qh 7d]
Seat 1: Raidylol (big blind) showed [8c 6c] and lost with a pair of Sixes
Seat 3: Leandra1808 showed [9h Ks] and won ($2.91) with a pair of Kings
Seat 5: easywtf (button) folded before Flop (didn't bet)
Seat 6: jorgeebanks (small blind) folded before Flop



PokerStars Hand #222971427429:  Hold'em No Limit ($0.05/$0.10 USD) - 2021/01/23 16:12:39 ET
Table 'Lutetia III' 6-max Seat #6 is the button
Seat 1: Raidylol ($10 in chips) 
Seat 2: fatkinglouie ($10 in chips) 
Seat 3: Leandra1808 ($9.69 in chips) 
Seat 5: easywtf ($10.30 in chips) 
Seat 6: jorgeebanks ($9.92 in chips) 
Raidylol: posts small blind $0.05
fatkinglouie: posts big blind $0.10
*** HOLE CARDS ***
Leandra1808: folds 
easywtf: folds 
jorgeebanks: folds 
Raidylol: raises $0.20 to $0.30
fatkinglouie: folds 
Uncalled bet ($0.20) returned to Raidylol
Raidylol collected $0.20 from pot
*** SUMMARY ***
Total pot $0.20 | Rake $0 
Seat 1: Raidylol (small blind) collected ($0.20)
Seat 2: fatkinglouie (big blind) folded before Flop
Seat 3: Leandra1808 folded before Flop (didn't bet)
Seat 5: easywtf folded before Flop (didn't bet)
Seat 6: jorgeebanks (button) folded before Flop (didn't bet)



PokerStars Hand #222971440609:  Hold'em No Limit ($0.05/$0.10 USD) - 2021/01/23 16:12:55 ET
Table 'Lutetia III' 6-max Seat #1 is the button
Seat 1: Raidylol ($10.10 in chips) 
Seat 2: fatkinglouie ($10 in chips) 
Seat 3: Leandra1808 ($9.69 in chips) 
Seat 5: easywtf ($10.30 in chips) 
Seat 6: jorgeebanks ($9.92 in chips) 
fatkinglouie: posts small blind $0.05
Leandra1808: posts big blind $0.10
*** HOLE CARDS ***
easywtf: folds 
jorgeebanks: folds 
Raidylol: folds 
fatkinglouie: folds 
Uncalled bet ($0.05) returned to Leandra1808
Leandra1808 collected $0.10 from pot
Leandra1808: doesn't show hand 
*** SUMMARY ***
Total pot $0.10 | Rake $0 
Seat 1: Raidylol (button) folded before Flop (didn't bet)
Seat 2: fatkinglouie (small blind) folded before Flop
Seat 3: Leandra1808 (big blind) collected ($0.10)
Seat 5: easywtf folded before Flop (didn't bet)
Seat 6: jorgeebanks folded before Flop (didn't bet)



PokerStars Hand #222971455377:  Hold'em No Limit ($0.05/$0.10 USD) - 2021/01/23 16:13:04 ET
Table 'Lutetia III' 6-max Seat #2 is the button
Seat 1: Raidylol ($10.10 in chips) 
Seat 2: fatkinglouie ($10 in chips) 
Seat 3: Leandra1808 ($9.74 in chips) 
Seat 5: easywtf ($10.30 in chips) 
Seat 6: jorgeebanks ($9.92 in chips) 
Leandra1808: posts small blind $0.05
easywtf: posts big blind $0.10
*** HOLE CARDS ***
jorgeebanks: folds 
Raidylol: folds 
fatkinglouie: folds 
Leandra1808: folds 
Uncalled bet ($0.05) returned to easywtf
easywtf collected $0.10 from pot
easywtf: doesn't show hand 
*** SUMMARY ***
Total pot $0.10 | Rake $0 
Seat 1: Raidylol folded before Flop (didn't bet)
Seat 2: fatkinglouie (button) folded before Flop (didn't bet)
Seat 3: Leandra1808 (small blind) folded before Flop
Seat 5: easywtf (big blind) collected ($0.10)
Seat 6: jorgeebanks folded before Flop (didn't bet)



PokerStars Hand #222971464063:  Hold'em No Limit ($0.05/$0.10 USD) - 2021/01/23 16:13:14 ET
Table 'Lutetia III' 6-max Seat #3 is the button
Seat 1: Raidylol ($10.10 in chips) 
Seat 2: fatkinglouie ($10 in chips) 
Seat 3: Leandra1808 ($9.69 in chips) 
Seat 5: easywtf ($10.35 in chips) 
Seat 6: jorgeebanks ($9.92 in chips) 
easywtf: posts small blind $0.05
jorgeebanks: posts big blind $0.10
*** HOLE CARDS ***
Raidylol: folds 
fatkinglouie: folds 
Leandra1808: calls $0.10
easywtf: folds 
jorgeebanks: checks 
*** FLOP *** [2h Kd 2c]
jorgeebanks: checks 
Leandra1808: checks 
*** TURN *** [2h Kd 2c] [8d]
jorgeebanks: bets $0.18
Leandra1808: calls $0.18
*** RIVER *** [2h Kd 2c 8d] [Jc]
jorgeebanks: bets $0.29
Acedan1369 leaves the table
Leandra1808: raises $0.58 to $0.87
jorgeebanks: calls $0.58
*** SHOW DOWN ***
Leandra1808: shows [Kc 5s] (two pair, Kings and Deuces)
jorgeebanks: shows [Kh 8s] (two pair, Kings and Eights)
jorgeebanks collected $2.24 from pot
*** SUMMARY ***
Total pot $2.35 | Rake $0.11 
Board [2h Kd 2c 8d Jc]
Seat 1: Raidylol folded before Flop (didn't bet)
Seat 2: fatkinglouie folded before Flop (didn't bet)
Seat 3: Leandra1808 (button) showed [Kc 5s] and lost with two pair, Kings and Deuces
Seat 5: easywtf (small blind) folded before Flop
Seat 6: jorgeebanks (big blind) showed [Kh 8s] and won ($2.24) with two pair, Kings and Eights



PokerStars Hand #222971510607:  Hold'em No Limit ($0.05/$0.10 USD) - 2021/01/23 16:14:10 ET
Table 'Lutetia III' 6-max Seat #5 is the button
Seat 1: Raidylol ($10.10 in chips) 
Seat 2: fatkinglouie ($10 in chips) 
Seat 3: Leandra1808 ($8.54 in chips) 
Seat 5: easywtf ($10.30 in chips) 
Seat 6: jorgeebanks ($11.01 in chips) 
jorgeebanks: posts small blind $0.05
Raidylol: posts big blind $0.10
*** HOLE CARDS ***
fatkinglouie: folds 
Leandra1808: folds 
easywtf: raises $0.10 to $0.20
jorgeebanks: folds 
Raidylol: raises $0.60 to $0.80
kostya17380 joins the table at seat #4 
easywtf: folds 
Uncalled bet ($0.60) returned to Raidylol
Raidylol collected $0.45 from pot
*** SUMMARY ***
Total pot $0.45 | Rake $0 
Seat 1: Raidylol (big blind) collected ($0.45)
Seat 2: fatkinglouie folded before Flop (didn't bet)
Seat 3: Leandra1808 folded before Flop (didn't bet)
Seat 5: easywtf (button) folded before Flop
Seat 6: jorgeebanks (small blind) folded before Flop



PokerStars Hand #222971529898:  Hold'em No Limit ($0.05/$0.10 USD) - 2021/01/23 16:14:34 ET
Table 'Lutetia III' 6-max Seat #6 is the button
Seat 1: Raidylol ($10.35 in chips) 
Seat 2: fatkinglouie ($10 in chips) 
Seat 3: Leandra1808 ($8.54 in chips) 
Seat 5: easywtf ($10.10 in chips) 
Seat 6: jorgeebanks ($10.96 in chips) 
Raidylol: posts small blind $0.05
fatkinglouie: posts big blind $0.10
kostya17380: sits out 
*** HOLE CARDS ***
Leandra1808: raises $0.20 to $0.30
easywtf: folds 
jorgeebanks: calls $0.30
Raidylol: folds 
fatkinglouie: folds 
*** FLOP *** [Ts 7h 5s]
Leandra1808: checks 
jorgeebanks: bets $0.36
Leandra1808: raises $1.44 to $1.80
jorgeebanks: calls $1.44
*** TURN *** [Ts 7h 5s] [Qd]
Leandra1808: checks 
jorgeebanks: checks 
*** RIVER *** [Ts 7h 5s Qd] [Qs]
Leandra1808: bets $6.44 and is all-in
jorgeebanks: folds 
Uncalled bet ($6.44) returned to Leandra1808
Leandra1808 collected $4.15 from pot
Leandra1808: doesn't show hand 
*** SUMMARY ***
Total pot $4.35 | Rake $0.20 
Board [Ts 7h 5s Qd Qs]
Seat 1: Raidylol (small blind) folded before Flop
Seat 2: fatkinglouie (big blind) folded before Flop
Seat 3: Leandra1808 collected ($4.15)
Seat 5: easywtf folded before Flop (didn't bet)
Seat 6: jorgeebanks (button) folded on the River



PokerStars Hand #222971580853:  Hold'em No Limit ($0.05/$0.10 USD) - 2021/01/23 16:15:34 ET
Table 'Lutetia III' 6-max Seat #1 is the button
Seat 1: Raidylol ($10.30 in chips) 
Seat 2: fatkinglouie ($10 in chips) 
Seat 3: Leandra1808 ($10.59 in chips) 
Seat 5: easywtf ($10.10 in chips) 
Seat 6: jorgeebanks ($8.86 in chips) 
fatkinglouie: posts small blind $0.05
Leandra1808: posts big blind $0.10
kostya17380: sits out 
*** HOLE CARDS ***
easywtf: folds 
jorgeebanks: folds 
Raidylol: folds 
fatkinglouie: folds 
Uncalled bet ($0.05) returned to Leandra1808
Leandra1808 collected $0.10 from pot
Leandra1808: doesn't show hand 
*** SUMMARY ***
Total pot $0.10 | Rake $0 
Seat 1: Raidylol (button) folded before Flop (didn't bet)
Seat 2: fatkinglouie (small blind) folded before Flop
Seat 3: Leandra1808 (big blind) collected ($0.10)
Seat 5: easywtf folded before Flop (didn't bet)
Seat 6: jorgeebanks folded before Flop (didn't bet)



PokerStars Hand #222971590758:  Hold'em No Limit ($0.05/$0.10 USD) - 2021/01/23 16:15:46 ET
Table 'Lutetia III' 6-max Seat #2 is the button
Seat 1: Raidylol ($10.30 in chips) 
Seat 2: fatkinglouie ($10 in chips) 
Seat 3: Leandra1808 ($10.64 in chips) 
Seat 4: kostya17380 ($10 in chips) 
Seat 5: easywtf ($10.10 in chips) 
Seat 6: jorgeebanks ($10 in chips) 
Leandra1808: posts small blind $0.05
kostya17380: posts big blind $0.10
*** HOLE CARDS ***
easywtf: folds 
jorgeebanks: folds 
Raidylol: folds 
fatkinglouie: raises $0.15 to $0.25
Leandra1808: folds 
kostya17380: calls $0.15
*** FLOP *** [8c 5s Qh]
kostya17380: checks 
fatkinglouie: checks 
*** TURN *** [8c 5s Qh] [4h]
kostya17380: bets $0.30
fatkinglouie: calls $0.30
*** RIVER *** [8c 5s Qh 4h] [Js]
kostya17380: bets $0.60
fatkinglouie: folds 
Uncalled bet ($0.60) returned to kostya17380
kostya17380 collected $1.10 from pot
kostya17380: doesn't show hand 
*** SUMMARY ***
Total pot $1.15 | Rake $0.05 
Board [8c 5s Qh 4h Js]
Seat 1: Raidylol folded before Flop (didn't bet)
Seat 2: fatkinglouie (button) folded on the River
Seat 3: Leandra1808 (small blind) folded before Flop
Seat 4: kostya17380 (big blind) collected ($1.10)
Seat 5: easywtf folded before Flop (didn't bet)
Seat 6: jorgeebanks folded before Flop (didn't bet)



PokerStars Hand #222971641918:  Hold'em No Limit ($0.05/$0.10 USD) - 2021/01/23 16:16:45 ET
Table 'Lutetia III' 6-max Seat #3 is the button
Seat 1: Raidylol ($10.30 in chips) 
Seat 2: fatkinglouie ($10 in chips) 
Seat 3: Leandra1808 ($10.59 in chips) 
Seat 4: kostya17380 ($10.55 in chips) 
Seat 5: easywtf ($10.10 in chips) 
Seat 6: jorgeebanks ($10 in chips) 
kostya17380: posts small blind $0.05
easywtf: posts big blind $0.10
*** HOLE CARDS ***
jorgeebanks: folds 
Raidylol: folds 
fatkinglouie: folds 
Leandra1808: raises $0.10 to $0.20
kostya17380: folds 
easywtf: calls $0.10
*** FLOP *** [6h 9c Qc]
easywtf: checks 
Leandra1808: checks 
*** TURN *** [6h 9c Qc] [Kc]
easywtf: checks 
Leandra1808: checks 
*** RIVER *** [6h 9c Qc Kc] [Kd]
easywtf: checks 
Leandra1808: bets $0.43
easywtf: folds 
Uncalled bet ($0.43) returned to Leandra1808
Leandra1808 collected $0.43 from pot
Leandra1808: doesn't show hand 
*** SUMMARY ***
Total pot $0.45 | Rake $0.02 
Board [6h 9c Qc Kc Kd]
Seat 1: Raidylol folded before Flop (didn't bet)
Seat 2: fatkinglouie folded before Flop (didn't bet)
Seat 3: Leandra1808 (button) collected ($0.43)
Seat 4: kostya17380 (small blind) folded before Flop
Seat 5: easywtf (big blind) folded on the River
Seat 6: jorgeebanks folded before Flop (didn't bet)



PokerStars Hand #222971696351:  Hold'em No Limit ($0.05/$0.10 USD) - 2021/01/23 16:17:48 ET
Table 'Lutetia III' 6-max Seat #4 is the button
Seat 1: Raidylol ($10.30 in chips) 
Seat 2: fatkinglouie ($10 in chips) 
Seat 3: Leandra1808 ($10.82 in chips) 
Seat 4: kostya17380 ($10.50 in chips) 
Seat 5: easywtf ($9.90 in chips) 
Seat 6: jorgeebanks ($10 in chips) 
easywtf: posts small blind $0.05
jorgeebanks: posts big blind $0.10
*** HOLE CARDS ***
Raidylol: raises $0.15 to $0.25
fatkinglouie has timed out
fatkinglouie: folds 
Leandra1808: folds 
kostya17380: folds 
easywtf: folds 
jorgeebanks: calls $0.15
*** FLOP *** [7s 9d 8c]
jorgeebanks: bets $0.27
Raidylol: raises $0.43 to $0.70
jorgeebanks: calls $0.43
*** TURN *** [7s 9d 8c] [6s]
jorgeebanks: checks 
Raidylol: checks 
*** RIVER *** [7s 9d 8c 6s] [Kc]
jorgeebanks: checks 
Raidylol: checks 
*** SHOW DOWN ***
jorgeebanks: shows [8d 8h] (three of a kind, Eights)
Raidylol: mucks hand 
jorgeebanks collected $1.86 from pot
*** SUMMARY ***
Total pot $1.95 | Rake $0.09 
Board [7s 9d 8c 6s Kc]
Seat 1: Raidylol mucked
Seat 2: fatkinglouie folded before Flop (didn't bet)
Seat 3: Leandra1808 folded before Flop (didn't bet)
Seat 4: kostya17380 (button) folded before Flop (didn't bet)
Seat 5: easywtf (small blind) folded before Flop
Seat 6: jorgeebanks (big blind) showed [8d 8h] and won ($1.86) with three of a kind, Eights



PokerStars Hand #222971747158:  Hold'em No Limit ($0.05/$0.10 USD) - 2021/01/23 16:18:47 ET
Table 'Lutetia III' 6-max Seat #5 is the button
Seat 1: Raidylol ($10 in chips) 
Seat 2: fatkinglouie ($10 in chips) 
Seat 3: Leandra1808 ($10.82 in chips) 
Seat 4: kostya17380 ($10.50 in chips) 
Seat 5: easywtf ($9.85 in chips) 
Seat 6: jorgeebanks ($10.91 in chips) 
jorgeebanks: posts small blind $0.05
Raidylol: posts big blind $0.10
*** HOLE CARDS ***
fatkinglouie: folds 
Leandra1808: calls $0.10
kostya17380: folds 
easywtf: folds 
jorgeebanks: folds 
Raidylol: checks 
*** FLOP *** [8d Qs Ad]
Raidylol: checks 
Leandra1808: bets $0.12
Raidylol: calls $0.12
*** TURN *** [8d Qs Ad] [8s]
Raidylol: checks 
Leandra1808: bets $0.23
Raidylol: calls $0.23
*** RIVER *** [8d Qs Ad 8s] [2h]
Raidylol: checks 
Leandra1808: bets $0.91
Raidylol: calls $0.91
*** SHOW DOWN ***
Leandra1808: shows [6d 8c] (three of a kind, Eights)
Raidylol: mucks hand 
Leandra1808 collected $2.65 from pot
*** SUMMARY ***
Total pot $2.77 | Rake $0.12 
Board [8d Qs Ad 8s 2h]
Seat 1: Raidylol (big blind) mucked
Seat 2: fatkinglouie folded before Flop (didn't bet)
Seat 3: Leandra1808 showed [6d 8c] and won ($2.65) with three of a kind, Eights
Seat 4: kostya17380 folded before Flop (didn't bet)
Seat 5: easywtf (button) folded before Flop (didn't bet)
Seat 6: jorgeebanks (small blind) folded before Flop



PokerStars Hand #222971787023:  Hold'em No Limit ($0.05/$0.10 USD) - 2021/01/23 16:19:33 ET
Table 'Lutetia III' 6-max Seat #6 is the button
Seat 1: Raidylol ($10 in chips) 
Seat 2: fatkinglouie ($10 in chips) 
Seat 3: Leandra1808 ($12.11 in chips) 
Seat 4: kostya17380 ($10.50 in chips) 
Seat 5: easywtf ($9.85 in chips) 
Seat 6: jorgeebanks ($10.86 in chips) 
Raidylol: posts small blind $0.05
fatkinglouie: posts big blind $0.10
*** HOLE CARDS ***
Leandra1808: calls $0.10
kostya17380: folds 
easywtf: folds 
jorgeebanks: raises $0.20 to $0.30
Raidylol: folds 
fatkinglouie: raises $0.90 to $1.20
Leandra1808: folds 
jorgeebanks: folds 
Uncalled bet ($0.90) returned to fatkinglouie
fatkinglouie collected $0.75 from pot
*** SUMMARY ***
Total pot $0.75 | Rake $0 
Seat 1: Raidylol (small blind) folded before Flop
Seat 2: fatkinglouie (big blind) collected ($0.75)
Seat 3: Leandra1808 folded before Flop
Seat 4: kostya17380 folded before Flop (didn't bet)
Seat 5: easywtf folded before Flop (didn't bet)
Seat 6: jorgeebanks (button) folded before Flop



PokerStars Hand #222971809385:  Hold'em No Limit ($0.05/$0.10 USD) - 2021/01/23 16:19:59 ET
Table 'Lutetia III' 6-max Seat #1 is the button
Seat 1: Raidylol ($10 in chips) 
Seat 2: fatkinglouie ($10.45 in chips) 
Seat 3: Leandra1808 ($12.01 in chips) 
Seat 4: kostya17380 ($10.50 in chips) 
Seat 5: easywtf ($9.85 in chips) 
Seat 6: jorgeebanks ($10.56 in chips) 
fatkinglouie: posts small blind $0.05
Leandra1808: posts big blind $0.10
*** HOLE CARDS ***
kostya17380: folds 
easywtf: folds 
jorgeebanks: folds 
Raidylol: raises $0.15 to $0.25
fatkinglouie: folds 
Leandra1808: calls $0.15
*** FLOP *** [8s Td Kh]
Leandra1808: bets $0.26
Raidylol: calls $0.26
*** TURN *** [8s Td Kh] [Ah]
Leandra1808: checks 
Raidylol: bets $0.80
Leandra1808: folds 
Uncalled bet ($0.80) returned to Raidylol
Raidylol collected $1.02 from pot
*** SUMMARY ***
Total pot $1.07 | Rake $0.05 
Board [8s Td Kh Ah]
Seat 1: Raidylol (button) collected ($1.02)
Seat 2: fatkinglouie (small blind) folded before Flop
Seat 3: Leandra1808 (big blind) folded on the Turn
Seat 4: kostya17380 folded before Flop (didn't bet)
Seat 5: easywtf folded before Flop (didn't bet)
Seat 6: jorgeebanks folded before Flop (didn't bet)



PokerStars Hand #222971842377:  Hold'em No Limit ($0.05/$0.10 USD) - 2021/01/23 16:20:37 ET
Table 'Lutetia III' 6-max Seat #2 is the button
Seat 1: Raidylol ($10.51 in chips) 
Seat 2: fatkinglouie ($10.40 in chips) 
Seat 3: Leandra1808 ($11.50 in chips) 
Seat 4: kostya17380 ($10.50 in chips) 
Seat 5: easywtf ($9.85 in chips) 
Seat 6: jorgeebanks ($10.56 in chips) 
Leandra1808: posts small blind $0.05
kostya17380: posts big blind $0.10
*** HOLE CARDS ***
easywtf: folds 
jorgeebanks: raises $0.20 to $0.30
Raidylol: folds 
fatkinglouie: raises $0.75 to $1.05
Leandra1808: folds 
kostya17380: folds 
kostya17380 was removed from the table for failing to post
kostya17380 is disconnected 
jorgeebanks: calls $0.75
*** FLOP *** [4c 5s 3s]
kostya17380 leaves the table
jorgeebanks: checks 
fatkinglouie: bets $1.14
jorgeebanks: raises $2.22 to $3.36
fatkinglouie: raises $5.99 to $9.35 and is all-in
jorgeebanks: folds 
Uncalled bet ($5.99) returned to fatkinglouie
fatkinglouie collected $8.57 from pot
*** SUMMARY ***
Total pot $8.97 | Rake $0.40 
Board [4c 5s 3s]
Seat 1: Raidylol folded before Flop (didn't bet)
Seat 2: fatkinglouie (button) collected ($8.57)
Seat 3: Leandra1808 (small blind) folded before Flop
Seat 4: kostya17380 (big blind) folded before Flop
Seat 5: easywtf folded before Flop (didn't bet)
Seat 6: jorgeebanks folded on the Flop



PokerStars Hand #222971881921:  Hold'em No Limit ($0.05/$0.10 USD) - 2021/01/23 16:21:23 ET
Table 'Lutetia III' 6-max Seat #3 is the button
Seat 1: Raidylol ($10.51 in chips) 
Seat 2: fatkinglouie ($14.56 in chips) 
Seat 3: Leandra1808 ($11.45 in chips) 
Seat 5: easywtf ($9.85 in chips) 
Seat 6: jorgeebanks ($6.15 in chips) 
easywtf: posts small blind $0.05
jorgeebanks: posts big blind $0.10
*** HOLE CARDS ***
Raidylol: raises $0.15 to $0.25
fatkinglouie: folds 
Leandra1808: calls $0.25
Oleg032 joins the table at seat #4 
easywtf: calls $0.20
jorgeebanks: calls $0.15
*** FLOP *** [Js Ah Td]
easywtf: checks 
jorgeebanks: checks 
Raidylol: bets $0.31
Leandra1808: folds 
easywtf: calls $0.31
jorgeebanks: folds 
*** TURN *** [Js Ah Td] [4d]
jorgeebanks leaves the table
easywtf: bets $0.54
Raidylol: calls $0.54
*** RIVER *** [Js Ah Td 4d] [Kh]
easywtf: bets $1.81
brightsunfun joins the table at seat #6 
Raidylol: raises $1.98 to $3.79
easywtf: raises $4.96 to $8.75 and is all-in
Raidylol: calls $4.96
*** SHOW DOWN ***
easywtf: shows [Qs Ac] (a straight, Ten to Ace)
Raidylol: shows [Ks Qd] (a straight, Ten to Ace)
easywtf collected $9.65 from pot
Raidylol collected $9.64 from pot
*** SUMMARY ***
Total pot $20.20 | Rake $0.91 
Board [Js Ah Td 4d Kh]
Seat 1: Raidylol showed [Ks Qd] and won ($9.64) with a straight, Ten to Ace
Seat 2: fatkinglouie folded before Flop (didn't bet)
Seat 3: Leandra1808 (button) folded on the Flop
Seat 5: easywtf (small blind) showed [Qs Ac] and won ($9.65) with a straight, Ten to Ace
Seat 6: jorgeebanks (big blind) folded on the Flop



PokerStars Hand #222971936027:  Hold'em No Limit ($0.05/$0.10 USD) - 2021/01/23 16:22:26 ET
Table 'Lutetia III' 6-max Seat #5 is the button
Seat 1: Raidylol ($10.30 in chips) 
Seat 2: fatkinglouie ($14.56 in chips) 
Seat 3: Leandra1808 ($11.20 in chips) 
Seat 5: easywtf ($9.65 in chips) 
Raidylol: posts small blind $0.05
fatkinglouie: posts big blind $0.10
Oleg032: sits out 
*** HOLE CARDS ***
Leandra1808: calls $0.10
easywtf: folds 
Raidylol: folds 
fatkinglouie: raises $0.30 to $0.40
Leandra1808: calls $0.30
*** FLOP *** [6d Jd 4d]
fatkinglouie: checks 
Leandra1808: bets $0.81
fatkinglouie: folds 
Uncalled bet ($0.81) returned to Leandra1808
Leandra1808 collected $0.81 from pot
Leandra1808: doesn't show hand 
*** SUMMARY ***
Total pot $0.85 | Rake $0.04 
Board [6d Jd 4d]
Seat 1: Raidylol (small blind) folded before Flop
Seat 2: fatkinglouie (big blind) folded on the Flop
Seat 3: Leandra1808 collected ($0.81)
Seat 5: easywtf (button) folded before Flop (didn't bet)



PokerStars Hand #222971959615:  Hold'em No Limit ($0.05/$0.10 USD) - 2021/01/23 16:22:54 ET
Table 'Lutetia III' 6-max Seat #1 is the button
Seat 1: Raidylol ($10.25 in chips) 
Seat 2: fatkinglouie ($14.16 in chips) 
Seat 3: Leandra1808 ($11.61 in chips) 
Seat 5: easywtf ($9.65 in chips) 
fatkinglouie: posts small blind $0.05
Leandra1808: posts big blind $0.10
Oleg032: sits out 
brightsunfun: sits out 
*** HOLE CARDS ***
easywtf: folds 
Raidylol: raises $0.15 to $0.25
fatkinglouie: folds 
Leandra1808: calls $0.15
*** FLOP *** [7d 8c 9c]
Leandra1808: checks 
Raidylol: bets $0.40
Leandra1808: calls $0.40
*** TURN *** [7d 8c 9c] [Td]
Leandra1808: checks 
Raidylol: bets $0.80
Leandra1808: calls $0.80
*** RIVER *** [7d 8c 9c Td] [Qd]
Leandra1808: bets $1.41
Raidylol: calls $1.41
*** SHOW DOWN ***
Leandra1808: shows [6d Ac] (a straight, Six to Ten)
Raidylol: shows [As Jd] (a straight, Eight to Queen)
Raidylol collected $5.51 from pot
*** SUMMARY ***
Total pot $5.77 | Rake $0.26 
Board [7d 8c 9c Td Qd]
Seat 1: Raidylol (button) showed [As Jd] and won ($5.51) with a straight, Eight to Queen
Seat 2: fatkinglouie (small blind) folded before Flop
Seat 3: Leandra1808 (big blind) showed [6d Ac] and lost with a straight, Six to Ten
Seat 5: easywtf folded before Flop (didn't bet)



PokerStars Hand #222972017047:  Hold'em No Limit ($0.05/$0.10 USD) - 2021/01/23 16:23:53 ET
Table 'Lutetia III' 6-max Seat #2 is the button
Seat 1: Raidylol ($12.90 in chips) 
Seat 2: fatkinglouie ($14.11 in chips) 
Seat 3: Leandra1808 ($8.75 in chips) 
Seat 4: Oleg032 ($10 in chips) 
Seat 5: easywtf ($9.65 in chips) 
Leandra1808: posts small blind $0.05
Oleg032: posts big blind $0.10
brightsunfun: sits out 
*** HOLE CARDS ***
easywtf: folds 
Raidylol: raises $0.15 to $0.25
fatkinglouie: folds 
Leandra1808: raises $0.15 to $0.40
Oleg032: folds 
Raidylol: calls $0.15
*** FLOP *** [7c Js 6d]
Leandra1808: bets $0.86
Raidylol: folds 
Uncalled bet ($0.86) returned to Leandra1808
Leandra1808 collected $0.86 from pot
Leandra1808: doesn't show hand 
*** SUMMARY ***
Total pot $0.90 | Rake $0.04 
Board [7c Js 6d]
Seat 1: Raidylol folded on the Flop
Seat 2: fatkinglouie (button) folded before Flop (didn't bet)
Seat 3: Leandra1808 (small blind) collected ($0.86)
Seat 4: Oleg032 (big blind) folded before Flop
Seat 5: easywtf folded before Flop (didn't bet)



PokerStars Hand #222972040536:  Hold'em No Limit ($0.05/$0.10 USD) - 2021/01/23 16:24:20 ET
Table 'Lutetia III' 6-max Seat #3 is the button
Seat 1: Raidylol ($12.50 in chips) 
Seat 2: fatkinglouie ($14.11 in chips) 
Seat 3: Leandra1808 ($9.21 in chips) 
Seat 4: Oleg032 ($10 in chips) 
Seat 5: easywtf ($9.65 in chips) 
Oleg032: posts small blind $0.05
easywtf: posts big blind $0.10
brightsunfun: sits out 
*** HOLE CARDS ***
Raidylol: folds 
fatkinglouie: folds 
Leandra1808: calls $0.10
Oleg032: calls $0.05
easywtf: raises $0.40 to $0.50
Leandra1808: folds 
Oleg032: calls $0.40
*** FLOP *** [Tc Qs 4s]
Oleg032: checks 
easywtf: checks 
*** TURN *** [Tc Qs 4s] [4h]
Oleg032: checks 
easywtf: bets $0.37
Oleg032: calls $0.37
*** RIVER *** [Tc Qs 4s 4h] [3s]
Oleg032: checks 
easywtf: checks 
*** SHOW DOWN ***
Oleg032: shows [2s 2c] (two pair, Fours and Deuces)
easywtf: shows [6s 6d] (two pair, Sixes and Fours)
easywtf collected $1.76 from pot
*** SUMMARY ***
Total pot $1.84 | Rake $0.08 
Board [Tc Qs 4s 4h 3s]
Seat 1: Raidylol folded before Flop (didn't bet)
Seat 2: fatkinglouie folded before Flop (didn't bet)
Seat 3: Leandra1808 (button) folded before Flop
Seat 4: Oleg032 (small blind) showed [2s 2c] and lost with two pair, Fours and Deuces
Seat 5: easywtf (big blind) showed [6s 6d] and won ($1.76) with two pair, Sixes and Fours



PokerStars Hand #222972088422:  Hold'em No Limit ($0.05/$0.10 USD) - 2021/01/23 16:25:17 ET
Table 'Lutetia III' 6-max Seat #4 is the button
Seat 1: Raidylol ($12.50 in chips) 
Seat 2: fatkinglouie ($14.11 in chips) 
Seat 3: Leandra1808 ($9.11 in chips) 
Seat 4: Oleg032 ($10 in chips) 
Seat 5: easywtf ($10.54 in chips) 
Seat 6: brightsunfun ($10 in chips) 
easywtf: posts small blind $0.05
brightsunfun: posts big blind $0.10
*** HOLE CARDS ***
Raidylol: folds 
fatkinglouie: folds 
Leandra1808: calls $0.10
Oleg032: folds 
easywtf: folds 
brightsunfun: checks 
*** FLOP *** [Qh Ks Qd]
brightsunfun: checks 
Leandra1808: checks 
*** TURN *** [Qh Ks Qd] [7d]
brightsunfun: checks 
Leandra1808: checks 
*** RIVER *** [Qh Ks Qd 7d] [Ts]
brightsunfun: checks 
Leandra1808: bets $0.24
brightsunfun: calls $0.24
*** SHOW DOWN ***
Leandra1808: shows [9d Kh] (two pair, Kings and Queens)
brightsunfun: shows [9s Jd] (a straight, Nine to King)
brightsunfun collected $0.70 from pot
*** SUMMARY ***
Total pot $0.73 | Rake $0.03 
Board [Qh Ks Qd 7d Ts]
Seat 1: Raidylol folded before Flop (didn't bet)
Seat 2: fatkinglouie folded before Flop (didn't bet)
Seat 3: Leandra1808 showed [9d Kh] and lost with two pair, Kings and Queens
Seat 4: Oleg032 (button) folded before Flop (didn't bet)
Seat 5: easywtf (small blind) folded before Flop
Seat 6: brightsunfun (big blind) showed [9s Jd] and won ($0.70) with a straight, Nine to King



PokerStars Hand #222972122780:  Hold'em No Limit ($0.05/$0.10 USD) - 2021/01/23 16:25:58 ET
Table 'Lutetia III' 6-max Seat #5 is the button
Seat 1: Raidylol ($12.50 in chips) 
Seat 2: fatkinglouie ($14.11 in chips) 
Seat 3: Leandra1808 ($8.77 in chips) 
Seat 4: Oleg032 ($10 in chips) 
Seat 5: easywtf ($10.49 in chips) 
Seat 6: brightsunfun ($10.36 in chips) 
brightsunfun: posts small blind $0.05
Raidylol: posts big blind $0.10
*** HOLE CARDS ***
fatkinglouie: folds 
Leandra1808: folds 
Oleg032: raises $0.15 to $0.25
easywtf: folds 
brightsunfun: calls $0.20
Raidylol: folds 
*** FLOP *** [4c Ts 3c]
brightsunfun: checks 
Oleg032: checks 
*** TURN *** [4c Ts 3c] [2c]
brightsunfun: checks 
Oleg032: checks 
*** RIVER *** [4c Ts 3c 2c] [Jh]
brightsunfun: checks 
Oleg032: checks 
*** SHOW DOWN ***
brightsunfun: shows [5c 5s] (a pair of Fives)
Oleg032: shows [9d Jd] (a pair of Jacks)
Oleg032 collected $0.57 from pot
*** SUMMARY ***
Total pot $0.60 | Rake $0.03 
Board [4c Ts 3c 2c Jh]
Seat 1: Raidylol (big blind) folded before Flop
Seat 2: fatkinglouie folded before Flop (didn't bet)
Seat 3: Leandra1808 folded before Flop (didn't bet)
Seat 4: Oleg032 showed [9d Jd] and won ($0.57) with a pair of Jacks
Seat 5: easywtf (button) folded before Flop (didn't bet)
Seat 6: brightsunfun (small blind) showed [5c 5s] and lost with a pair of Fives



PokerStars Hand #222972164451:  Hold'em No Limit ($0.05/$0.10 USD) - 2021/01/23 16:26:47 ET
Table 'Lutetia III' 6-max Seat #6 is the button
Seat 1: Raidylol ($12.40 in chips) 
Seat 2: fatkinglouie ($14.11 in chips) 
Seat 3: Leandra1808 ($8.77 in chips) 
Seat 4: Oleg032 ($10.32 in chips) 
Seat 5: easywtf ($10.49 in chips) 
Seat 6: brightsunfun ($10.11 in chips) 
Raidylol: posts small blind $0.05
fatkinglouie: posts big blind $0.10
*** HOLE CARDS ***
Leandra1808: folds 
Oleg032: folds 
easywtf: folds 
brightsunfun: raises $0.18 to $0.28
Raidylol: folds 
fatkinglouie: calls $0.18
*** FLOP *** [Tc 2d Qd]
fatkinglouie: checks 
brightsunfun: bets $0.35
fatkinglouie: folds 
Uncalled bet ($0.35) returned to brightsunfun
brightsunfun collected $0.58 from pot
brightsunfun: doesn't show hand 
*** SUMMARY ***
Total pot $0.61 | Rake $0.03 
Board [Tc 2d Qd]
Seat 1: Raidylol (small blind) folded before Flop
Seat 2: fatkinglouie (big blind) folded on the Flop
Seat 3: Leandra1808 folded before Flop (didn't bet)
Seat 4: Oleg032 folded before Flop (didn't bet)
Seat 5: easywtf folded before Flop (didn't bet)
Seat 6: brightsunfun (button) collected ($0.58)



PokerStars Hand #222972202353:  Hold'em No Limit ($0.05/$0.10 USD) - 2021/01/23 16:27:31 ET
Table 'Lutetia III' 6-max Seat #1 is the button
Seat 1: Raidylol ($12.35 in chips) 
Seat 2: fatkinglouie ($13.83 in chips) 
Seat 3: Leandra1808 ($8.77 in chips) 
Seat 4: Oleg032 ($10.32 in chips) 
Seat 5: easywtf ($10.49 in chips) 
Seat 6: brightsunfun ($10.41 in chips) 
fatkinglouie: posts small blind $0.05
Leandra1808: posts big blind $0.10
*** HOLE CARDS ***
Oleg032: folds 
easywtf: raises $0.20 to $0.30
brightsunfun: folds 
Raidylol: folds 
fatkinglouie: folds 
Leandra1808: calls $0.20
*** FLOP *** [8h Kh Qc]
Leandra1808: checks 
easywtf: checks 
*** TURN *** [8h Kh Qc] [5h]
Leandra1808: bets $0.62
easywtf: folds 
Uncalled bet ($0.62) returned to Leandra1808
Leandra1808 collected $0.62 from pot
Leandra1808: doesn't show hand 
*** SUMMARY ***
Total pot $0.65 | Rake $0.03 
Board [8h Kh Qc 5h]
Seat 1: Raidylol (button) folded before Flop (didn't bet)
Seat 2: fatkinglouie (small blind) folded before Flop
Seat 3: Leandra1808 (big blind) collected ($0.62)
Seat 4: Oleg032 folded before Flop (didn't bet)
Seat 5: easywtf folded on the Turn
Seat 6: brightsunfun folded before Flop (didn't bet)



PokerStars Hand #222972252346:  Hold'em No Limit ($0.05/$0.10 USD) - 2021/01/23 16:28:30 ET
Table 'Lutetia III' 6-max Seat #2 is the button
Seat 1: Raidylol ($12.35 in chips) 
Seat 2: fatkinglouie ($13.78 in chips) 
Seat 3: Leandra1808 ($9.09 in chips) 
Seat 4: Oleg032 ($10.32 in chips) 
Seat 5: easywtf ($10.19 in chips) 
Seat 6: brightsunfun ($10.41 in chips) 
Leandra1808: posts small blind $0.05
Oleg032: posts big blind $0.10
*** HOLE CARDS ***
easywtf: folds 
brightsunfun: folds 
Raidylol: folds 
fatkinglouie has timed out
fatkinglouie: folds 
Leandra1808: folds 
Uncalled bet ($0.05) returned to Oleg032
Oleg032 collected $0.10 from pot
Oleg032: doesn't show hand 
*** SUMMARY ***
Total pot $0.10 | Rake $0 
Seat 1: Raidylol folded before Flop (didn't bet)
Seat 2: fatkinglouie (button) folded before Flop (didn't bet)
Seat 3: Leandra1808 (small blind) folded before Flop
Seat 4: Oleg032 (big blind) collected ($0.10)
Seat 5: easywtf folded before Flop (didn't bet)
Seat 6: brightsunfun folded before Flop (didn't bet)



PokerStars Hand #222972267954:  Hold'em No Limit ($0.05/$0.10 USD) - 2021/01/23 16:28:48 ET
Table 'Lutetia III' 6-max Seat #3 is the button
Seat 1: Raidylol ($12.35 in chips) 
Seat 3: Leandra1808 ($9.04 in chips) 
Seat 4: Oleg032 ($10.37 in chips) 
Seat 5: easywtf ($10.19 in chips) 
Seat 6: brightsunfun ($10.41 in chips) 
Oleg032: posts small blind $0.05
easywtf: posts big blind $0.10
*** HOLE CARDS ***
brightsunfun: folds 
Raidylol: folds 
Leandra1808: folds 
Oleg032: raises $0.20 to $0.30
easywtf: folds 
Uncalled bet ($0.20) returned to Oleg032
Oleg032 collected $0.20 from pot
Oleg032: doesn't show hand 
*** SUMMARY ***
Total pot $0.20 | Rake $0 
Seat 1: Raidylol folded before Flop (didn't bet)
Seat 3: Leandra1808 (button) folded before Flop (didn't bet)
Seat 4: Oleg032 (small blind) collected ($0.20)
Seat 5: easywtf (big blind) folded before Flop
Seat 6: brightsunfun folded before Flop (didn't bet)



PokerStars Hand #222972279881:  Hold'em No Limit ($0.05/$0.10 USD) - 2021/01/23 16:29:02 ET
Table 'Lutetia III' 6-max Seat #4 is the button
Seat 1: Raidylol ($12.35 in chips) 
Seat 2: fatkinglouie ($13.78 in chips) 
Seat 3: Leandra1808 ($9.04 in chips) 
Seat 4: Oleg032 ($10.47 in chips) 
Seat 5: easywtf ($10.09 in chips) 
Seat 6: brightsunfun ($10.41 in chips) 
easywtf: posts small blind $0.05
brightsunfun: posts big blind $0.10
*** HOLE CARDS ***
Raidylol: raises $0.10 to $0.20
fatkinglouie: folds 
Leandra1808: calls $0.20
Oleg032: folds 
easywtf: folds 
brightsunfun: folds 
*** FLOP *** [Tc As 9c]
Raidylol: checks 
Leandra1808: bets $0.26
Raidylol: folds 
Uncalled bet ($0.26) returned to Leandra1808
Leandra1808 collected $0.53 from pot
Leandra1808: doesn't show hand 
*** SUMMARY ***
Total pot $0.55 | Rake $0.02 
Board [Tc As 9c]
Seat 1: Raidylol folded on the Flop
Seat 2: fatkinglouie folded before Flop (didn't bet)
Seat 3: Leandra1808 collected ($0.53)
Seat 4: Oleg032 (button) folded before Flop (didn't bet)
Seat 5: easywtf (small blind) folded before Flop
Seat 6: brightsunfun (big blind) folded before Flop



PokerStars Hand #222972312428:  Hold'em No Limit ($0.05/$0.10 USD) - 2021/01/23 16:29:41 ET
Table 'Lutetia III' 6-max Seat #5 is the button
Seat 1: Raidylol ($12.15 in chips) 
Seat 2: fatkinglouie ($13.78 in chips) 
Seat 3: Leandra1808 ($9.37 in chips) 
Seat 4: Oleg032 ($10.47 in chips) 
Seat 5: easywtf ($10.04 in chips) 
Seat 6: brightsunfun ($10.31 in chips) 
brightsunfun: posts small blind $0.05
Raidylol: posts big blind $0.10
*** HOLE CARDS ***
fatkinglouie: folds 
Leandra1808: calls $0.10
Oleg032: folds 
easywtf: raises $0.35 to $0.45
brightsunfun: folds 
Raidylol: folds 
Leandra1808: calls $0.35
*** FLOP *** [8s 2s Kc]
Leandra1808: checks 
easywtf: bets $0.40
Leandra1808: folds 
Uncalled bet ($0.40) returned to easywtf
easywtf collected $1 from pot
easywtf: doesn't show hand 
*** SUMMARY ***
Total pot $1.05 | Rake $0.05 
Board [8s 2s Kc]
Seat 1: Raidylol (big blind) folded before Flop
Seat 2: fatkinglouie folded before Flop (didn't bet)
Seat 3: Leandra1808 folded on the Flop
Seat 4: Oleg032 folded before Flop (didn't bet)
Seat 5: easywtf (button) collected ($1)
Seat 6: brightsunfun (small blind) folded before Flop



PokerStars Hand #222972348939:  Hold'em No Limit ($0.05/$0.10 USD) - 2021/01/23 16:30:23 ET
Table 'Lutetia III' 6-max Seat #6 is the button
Seat 1: Raidylol ($12.05 in chips) 
Seat 2: fatkinglouie ($13.78 in chips) 
Seat 3: Leandra1808 ($8.92 in chips) 
Seat 4: Oleg032 ($10.47 in chips) 
Seat 5: easywtf ($10.59 in chips) 
Seat 6: brightsunfun ($10.26 in chips) 
Raidylol: posts small blind $0.05
fatkinglouie: posts big blind $0.10
*** HOLE CARDS ***
Leandra1808 has timed out
Leandra1808: folds 
Oleg032: folds 
easywtf: folds 
brightsunfun has timed out
brightsunfun: folds 
Raidylol: raises $0.20 to $0.30
fatkinglouie: folds 
Uncalled bet ($0.20) returned to Raidylol
Raidylol collected $0.20 from pot
*** SUMMARY ***
Total pot $0.20 | Rake $0 
Seat 1: Raidylol (small blind) collected ($0.20)
Seat 2: fatkinglouie (big blind) folded before Flop
Seat 3: Leandra1808 folded before Flop (didn't bet)
Seat 4: Oleg032 folded before Flop (didn't bet)
Seat 5: easywtf folded before Flop (didn't bet)
Seat 6: brightsunfun (button) folded before Flop (didn't bet)



