PokerStars Hand #222943083942:  Hold'em No Limit ($0.05/$0.10 USD) - 2021/01/23 22:39:30 ET
Table 'Polydoros II' 6-max Seat #5 is the button
Seat 2: Breno_Silveira ($3.60 in chips) 
Seat 3: pudge.3096 ($10.28 in chips) 
Seat 4: Black021 ($14.66 in chips) 
Seat 5: Bunkiebear ($2.02 in chips) 
Seat 6: MilesSteel ($19.31 in chips) 
MilesSteel: posts small blind $0.05
Breno_Silveira: posts big blind $0.10
*** HOLE CARDS ***
pudge.3096: folds 
Black021: raises $0.15 to $0.25
Bunkiebear: folds 
MilesSteel: folds 
Breno_Silveira: calls $0.15
*** FLOP *** [8c Js Tc]
Breno_Silveira: checks 
Black021: bets $0.35
Breno_Silveira: calls $0.35
*** TURN *** [8c Js Tc] [Qh]
Breno_Silveira: checks 
Black021: checks 
*** RIVER *** [8c Js Tc Qh] [3s]
Breno_Silveira: bets $3 and is all-in
Black021: folds 
Uncalled bet ($3) returned to Breno_Silveira
Breno_Silveira collected $1.19 from pot
Breno_Silveira: doesn't show hand 
*** SUMMARY ***
Total pot $1.25 | Rake $0.06 
Board [8c Js Tc Qh 3s]
Seat 2: Breno_Silveira (big blind) collected ($1.19)
Seat 3: pudge.3096 folded before Flop (didn't bet)
Seat 4: Black021 folded on the River
Seat 5: Bunkiebear (button) folded before Flop (didn't bet)
Seat 6: MilesSteel (small blind) folded before Flop



PokerStars Hand #222943101172:  Hold'em No Limit ($0.05/$0.10 USD) - 2021/01/23 22:40:20 ET
Table 'Polydoros II' 6-max Seat #6 is the button
Seat 2: Breno_Silveira ($4.19 in chips) 
Seat 3: pudge.3096 ($10.28 in chips) 
Seat 4: Black021 ($14.06 in chips) 
Seat 5: Bunkiebear ($2.02 in chips) 
Seat 6: MilesSteel ($19.26 in chips) 
Breno_Silveira: posts small blind $0.05
pudge.3096: posts big blind $0.10
*** HOLE CARDS ***
Black021: folds 
Bunkiebear: folds 
MilesSteel: raises $0.20 to $0.30
Breno_Silveira: folds 
pudge.3096: folds 
Uncalled bet ($0.20) returned to MilesSteel
MilesSteel collected $0.25 from pot
MilesSteel: doesn't show hand 
*** SUMMARY ***
Total pot $0.25 | Rake $0 
Seat 2: Breno_Silveira (small blind) folded before Flop
Seat 3: pudge.3096 (big blind) folded before Flop
Seat 4: Black021 folded before Flop (didn't bet)
Seat 5: Bunkiebear folded before Flop (didn't bet)
Seat 6: MilesSteel (button) collected ($0.25)



PokerStars Hand #222943107458:  Hold'em No Limit ($0.05/$0.10 USD) - 2021/01/23 22:40:38 ET
Table 'Polydoros II' 6-max Seat #2 is the button
Seat 2: Breno_Silveira ($4.14 in chips) 
Seat 4: Black021 ($14.06 in chips) 
Seat 5: Bunkiebear ($2.02 in chips) 
Seat 6: MilesSteel ($19.41 in chips) 
Black021: posts small blind $0.05
Bunkiebear: posts big blind $0.10
*** HOLE CARDS ***
pudge.3096 leaves the table
MilesSteel: folds 
Breno_Silveira: folds 
Black021: raises $0.17 to $0.27
Bunkiebear: folds 
Uncalled bet ($0.17) returned to Black021
Black021 collected $0.20 from pot
Black021: doesn't show hand 
ken_wynn joins the table at seat #3 
*** SUMMARY ***
Total pot $0.20 | Rake $0 
Seat 2: Breno_Silveira (button) folded before Flop (didn't bet)
Seat 4: Black021 (small blind) collected ($0.20)
Seat 5: Bunkiebear (big blind) folded before Flop
Seat 6: MilesSteel folded before Flop (didn't bet)



PokerStars Hand #222943109749:  Hold'em No Limit ($0.05/$0.10 USD) - 2021/01/23 22:40:44 ET
Table 'Polydoros II' 6-max Seat #4 is the button
Seat 2: Breno_Silveira ($4.14 in chips) 
Seat 4: Black021 ($14.16 in chips) 
Seat 5: Bunkiebear ($1.92 in chips) 
Seat 6: MilesSteel ($19.41 in chips) 
Bunkiebear: posts small blind $0.05
MilesSteel: posts big blind $0.10
ken_wynn: sits out 
*** HOLE CARDS ***
Breno_Silveira: folds 
Black021: raises $0.12 to $0.22
Bunkiebear: calls $0.17
MilesSteel: calls $0.12
*** FLOP *** [2d As Kd]
Bunkiebear: checks 
MilesSteel: checks 
Black021: bets $0.21
Bunkiebear: calls $0.21
MilesSteel: folds 
*** TURN *** [2d As Kd] [Ah]
Bunkiebear: checks 
Black021: bets $0.77
Bunkiebear: calls $0.77
*** RIVER *** [2d As Kd Ah] [Jc]
Bunkiebear: checks 
Black021: bets $12.96 and is all-in
Bunkiebear: calls $0.72 and is all-in
Uncalled bet ($12.24) returned to Black021
*** SHOW DOWN ***
Black021: shows [7d Ac] (three of a kind, Aces)
Bunkiebear: shows [6h 6s] (two pair, Aces and Sixes)
Black021 collected $3.88 from pot
*** SUMMARY ***
Total pot $4.06 | Rake $0.18 
Board [2d As Kd Ah Jc]
Seat 2: Breno_Silveira folded before Flop (didn't bet)
Seat 4: Black021 (button) showed [7d Ac] and won ($3.88) with three of a kind, Aces
Seat 5: Bunkiebear (small blind) showed [6h 6s] and lost with two pair, Aces and Sixes
Seat 6: MilesSteel (big blind) folded on the Flop



PokerStars Hand #222943124661:  Hold'em No Limit ($0.05/$0.10 USD) - 2021/01/23 22:41:27 ET
Table 'Polydoros II' 6-max Seat #6 is the button
Seat 2: Breno_Silveira ($4.14 in chips) 
Seat 3: ken_wynn ($6 in chips) 
Seat 4: Black021 ($16.12 in chips) 
Seat 6: MilesSteel ($19.19 in chips) 
Breno_Silveira: posts small blind $0.05
ken_wynn: posts big blind $0.10
*** HOLE CARDS ***
Black021: raises $0.15 to $0.25
MilesSteel: folds 
Breno_Silveira: folds 
Bunkiebear leaves the table
ken_wynn: calls $0.15
*** FLOP *** [5s 3c 2d]
ken_wynn: bets $0.27
Black021: folds 
Uncalled bet ($0.27) returned to ken_wynn
ken_wynn collected $0.53 from pot
ken_wynn: doesn't show hand 
*** SUMMARY ***
Total pot $0.55 | Rake $0.02 
Board [5s 3c 2d]
Seat 2: Breno_Silveira (small blind) folded before Flop
Seat 3: ken_wynn (big blind) collected ($0.53)
Seat 4: Black021 folded on the Flop
Seat 6: MilesSteel (button) folded before Flop (didn't bet)



PokerStars Hand #222943132845:  Hold'em No Limit ($0.05/$0.10 USD) - 2021/01/23 22:41:51 ET
Table 'Polydoros II' 6-max Seat #3 is the button
Seat 3: ken_wynn ($6.28 in chips) 
Seat 4: Black021 ($15.87 in chips) 
Seat 6: MilesSteel ($19.19 in chips) 
Black021: posts small blind $0.05
MilesSteel: posts big blind $0.10
*** HOLE CARDS ***
ken_wynn: raises $0.15 to $0.25
Black021: raises $0.65 to $0.90
MilesSteel: folds 
ken_wynn: folds 
Uncalled bet ($0.65) returned to Black021
Black021 collected $0.60 from pot
Black021: doesn't show hand 
*** SUMMARY ***
Total pot $0.60 | Rake $0 
Seat 3: ken_wynn (button) folded before Flop
Seat 4: Black021 (small blind) collected ($0.60)
Seat 6: MilesSteel (big blind) folded before Flop



PokerStars Hand #222943142847:  Hold'em No Limit ($0.05/$0.10 USD) - 2021/01/23 22:42:20 ET
Table 'Polydoros II' 6-max Seat #4 is the button
Seat 3: ken_wynn ($6.03 in chips) 
Seat 4: Black021 ($16.22 in chips) 
Seat 6: MilesSteel ($19.09 in chips) 
MilesSteel: posts small blind $0.05
ken_wynn: posts big blind $0.10
*** HOLE CARDS ***
Black021: folds 
MilesSteel: calls $0.05
ken_wynn: raises $0.25 to $0.35
MilesSteel: folds 
Uncalled bet ($0.25) returned to ken_wynn
ken_wynn collected $0.20 from pot
M709199 was removed from the table for failing to post
M709199 leaves the table
ken_wynn: doesn't show hand 
*** SUMMARY ***
Total pot $0.20 | Rake $0 
Seat 3: ken_wynn (big blind) collected ($0.20)
Seat 4: Black021 (button) folded before Flop (didn't bet)
Seat 6: MilesSteel (small blind) folded before Flop



PokerStars Hand #222943147472:  Hold'em No Limit ($0.05/$0.10 USD) - 2021/01/23 22:42:33 ET
Table 'Polydoros II' 6-max Seat #6 is the button
Seat 3: ken_wynn ($6.13 in chips) 
Seat 4: Black021 ($16.22 in chips) 
Seat 6: MilesSteel ($18.99 in chips) 
ken_wynn: posts small blind $0.05
Ger Cortes joins the table at seat #5 
Black021: posts big blind $0.10
*** HOLE CARDS ***
MilesSteel: folds 
Bunkiebear joins the table at seat #1 
ken_wynn: folds 
Uncalled bet ($0.05) returned to Black021
Black021 collected $0.10 from pot
Black021: doesn't show hand 
*** SUMMARY ***
Total pot $0.10 | Rake $0 
Seat 3: ken_wynn (small blind) folded before Flop
Seat 4: Black021 (big blind) collected ($0.10)
Seat 6: MilesSteel (button) folded before Flop (didn't bet)



PokerStars Hand #222943153069:  Hold'em No Limit ($0.05/$0.10 USD) - 2021/01/23 22:42:43 ET
Table 'Polydoros II' 6-max Seat #3 is the button
Seat 2: Breno_Silveira ($4.09 in chips) 
Seat 3: ken_wynn ($6.08 in chips) 
Seat 4: Black021 ($16.27 in chips) 
Seat 5: Ger Cortes ($10 in chips) 
Seat 6: MilesSteel ($18.99 in chips) 
Black021: posts small blind $0.05
Ger Cortes: posts big blind $0.10
Bunkiebear: sits out 
Breno_Silveira: posts small & big blinds $0.15
*** HOLE CARDS ***
MilesSteel: folds 
Breno_Silveira: checks 
ken_wynn: folds 
Black021: raises $0.30 to $0.40
Ger Cortes: folds 
Breno_Silveira: folds 
Uncalled bet ($0.30) returned to Black021
Black021 collected $0.35 from pot
Black021: doesn't show hand 
*** SUMMARY ***
Total pot $0.35 | Rake $0 
Seat 2: Breno_Silveira folded before Flop (didn't bet)
Seat 3: ken_wynn (button) folded before Flop (didn't bet)
Seat 4: Black021 (small blind) collected ($0.35)
Seat 5: Ger Cortes (big blind) folded before Flop
Seat 6: MilesSteel folded before Flop (didn't bet)



PokerStars Hand #222943157984:  Hold'em No Limit ($0.05/$0.10 USD) - 2021/01/23 22:42:57 ET
Table 'Polydoros II' 6-max Seat #4 is the button
Seat 1: Bunkiebear ($10 in chips) 
Seat 2: Breno_Silveira ($3.94 in chips) 
Seat 3: ken_wynn ($6.08 in chips) 
Seat 4: Black021 ($16.52 in chips) 
Seat 5: Ger Cortes ($10 in chips) 
Ger Cortes: posts small blind $0.05
MilesSteel: is sitting out 
Bunkiebear: posts big blind $0.10
*** HOLE CARDS ***
Breno_Silveira: calls $0.10
ken_wynn: raises $0.15 to $0.25
Black021: folds 
Ger Cortes: folds 
Bunkiebear: folds 
Breno_Silveira: folds 
Uncalled bet ($0.15) returned to ken_wynn
ken_wynn collected $0.35 from pot
ken_wynn: doesn't show hand 
*** SUMMARY ***
Total pot $0.35 | Rake $0 
Seat 1: Bunkiebear (big blind) folded before Flop
Seat 2: Breno_Silveira folded before Flop
Seat 3: ken_wynn collected ($0.35)
Seat 4: Black021 (button) folded before Flop (didn't bet)
Seat 5: Ger Cortes (small blind) folded before Flop



PokerStars Hand #222943162914:  Hold'em No Limit ($0.05/$0.10 USD) - 2021/01/23 22:43:12 ET
Table 'Polydoros II' 6-max Seat #5 is the button
Seat 1: Bunkiebear ($9.90 in chips) 
Seat 2: Breno_Silveira ($3.84 in chips) 
Seat 3: ken_wynn ($6.33 in chips) 
Seat 4: Black021 ($16.52 in chips) 
Seat 5: Ger Cortes ($10 in chips) 
Bunkiebear: posts small blind $0.05
Breno_Silveira: posts big blind $0.10
*** HOLE CARDS ***
ken_wynn: raises $0.20 to $0.30
Black021: folds 
Ger Cortes: folds 
Bunkiebear: folds 
Breno_Silveira is connected 
Breno_Silveira: calls $0.20
*** FLOP *** [9c 2c 9s]
Breno_Silveira: checks 
ken_wynn: checks 
*** TURN *** [9c 2c 9s] [8d]
Breno_Silveira: checks 
ken_wynn: checks 
*** RIVER *** [9c 2c 9s 8d] [Th]
Breno_Silveira: checks 
ken_wynn: checks 
*** SHOW DOWN ***
Breno_Silveira: shows [Js Kc] (a pair of Nines)
ken_wynn: shows [Ks Jd] (a pair of Nines)
Breno_Silveira collected $0.31 from pot
ken_wynn collected $0.31 from pot
*** SUMMARY ***
Total pot $0.65 | Rake $0.03 
Board [9c 2c 9s 8d Th]
Seat 1: Bunkiebear (small blind) folded before Flop
Seat 2: Breno_Silveira (big blind) showed [Js Kc] and won ($0.31) with a pair of Nines
Seat 3: ken_wynn showed [Ks Jd] and won ($0.31) with a pair of Nines
Seat 4: Black021 folded before Flop (didn't bet)
Seat 5: Ger Cortes (button) folded before Flop (didn't bet)



PokerStars Hand #222943191399:  Hold'em No Limit ($0.05/$0.10 USD) - 2021/01/23 22:44:34 ET
Table 'Polydoros II' 6-max Seat #1 is the button
Seat 1: Bunkiebear ($9.85 in chips) 
Seat 2: Breno_Silveira ($3.85 in chips) 
Seat 3: ken_wynn ($6.34 in chips) 
Seat 4: Black021 ($16.52 in chips) 
Seat 5: Ger Cortes ($10 in chips) 
Breno_Silveira: posts small blind $0.05
ken_wynn: posts big blind $0.10
*** HOLE CARDS ***
Black021: folds 
Ger Cortes: folds 
Bunkiebear: folds 
Breno_Silveira: folds 
Uncalled bet ($0.05) returned to ken_wynn
ken_wynn collected $0.10 from pot
ken_wynn: doesn't show hand 
*** SUMMARY ***
Total pot $0.10 | Rake $0 
Seat 1: Bunkiebear (button) folded before Flop (didn't bet)
Seat 2: Breno_Silveira (small blind) folded before Flop
Seat 3: ken_wynn (big blind) collected ($0.10)
Seat 4: Black021 folded before Flop (didn't bet)
Seat 5: Ger Cortes folded before Flop (didn't bet)



PokerStars Hand #222943194932:  Hold'em No Limit ($0.05/$0.10 USD) - 2021/01/23 22:44:44 ET
Table 'Polydoros II' 6-max Seat #2 is the button
Seat 1: Bunkiebear ($9.85 in chips) 
Seat 2: Breno_Silveira ($3.80 in chips) 
Seat 3: ken_wynn ($6.39 in chips) 
Seat 4: Black021 ($16.52 in chips) 
Seat 5: Ger Cortes ($10 in chips) 
ken_wynn: posts small blind $0.05
Black021: posts big blind $0.10
*** HOLE CARDS ***
Ger Cortes: folds 
Bunkiebear: folds 
Breno_Silveira: folds 
ken_wynn: calls $0.05
Black021: raises $0.30 to $0.40
ken_wynn: raises $0.50 to $0.90
Black021: calls $0.50
*** FLOP *** [4h 4s 4d]
ken_wynn: bets $0.86
Black021: folds 
Uncalled bet ($0.86) returned to ken_wynn
ken_wynn collected $1.72 from pot
ken_wynn: doesn't show hand 
*** SUMMARY ***
Total pot $1.80 | Rake $0.08 
Board [4h 4s 4d]
Seat 1: Bunkiebear folded before Flop (didn't bet)
Seat 2: Breno_Silveira (button) folded before Flop (didn't bet)
Seat 3: ken_wynn (small blind) collected ($1.72)
Seat 4: Black021 (big blind) folded on the Flop
Seat 5: Ger Cortes folded before Flop (didn't bet)



PokerStars Hand #222943209001:  Hold'em No Limit ($0.05/$0.10 USD) - 2021/01/23 22:45:26 ET
Table 'Polydoros II' 6-max Seat #3 is the button
Seat 1: Bunkiebear ($9.85 in chips) 
Seat 2: Breno_Silveira ($3.80 in chips) 
Seat 3: ken_wynn ($7.21 in chips) 
Seat 4: Black021 ($15.62 in chips) 
Seat 5: Ger Cortes ($10 in chips) 
Black021: posts small blind $0.05
Ger Cortes: posts big blind $0.10
*** HOLE CARDS ***
Bunkiebear: calls $0.10
Breno_Silveira: folds 
ken_wynn: folds 
Black021: folds 
Ger Cortes: checks 
*** FLOP *** [Qh Kd 4d]
Ger Cortes: checks 
Bunkiebear: bets $0.50
Ger Cortes: folds 
Uncalled bet ($0.50) returned to Bunkiebear
Bunkiebear collected $0.24 from pot
Bunkiebear: doesn't show hand 
*** SUMMARY ***
Total pot $0.25 | Rake $0.01 
Board [Qh Kd 4d]
Seat 1: Bunkiebear collected ($0.24)
Seat 2: Breno_Silveira folded before Flop (didn't bet)
Seat 3: ken_wynn (button) folded before Flop (didn't bet)
Seat 4: Black021 (small blind) folded before Flop
Seat 5: Ger Cortes (big blind) folded on the Flop



PokerStars Hand #222943218741:  Hold'em No Limit ($0.05/$0.10 USD) - 2021/01/23 22:45:54 ET
Table 'Polydoros II' 6-max Seat #4 is the button
Seat 1: Bunkiebear ($9.99 in chips) 
Seat 2: Breno_Silveira ($3.80 in chips) 
Seat 3: ken_wynn ($7.21 in chips) 
Seat 4: Black021 ($15.57 in chips) 
Seat 5: Ger Cortes ($10 in chips) 
Ger Cortes: posts small blind $0.05
Bunkiebear: posts big blind $0.10
*** HOLE CARDS ***
Breno_Silveira: calls $0.10
ken_wynn: calls $0.10
Black021: folds 
Ger Cortes: folds 
Bunkiebear: checks 
*** FLOP *** [Ah 7s 6s]
Bunkiebear: checks 
Breno_Silveira: checks 
ken_wynn: bets $0.17
Bunkiebear: calls $0.17
Breno_Silveira: folds 
*** TURN *** [Ah 7s 6s] [2c]
Bunkiebear: checks 
ken_wynn: checks 
*** RIVER *** [Ah 7s 6s 2c] [Ac]
Bunkiebear: checks 
Breno_Silveira leaves the table
ken_wynn: checks 
*** SHOW DOWN ***
Bunkiebear: shows [4h Qs] (a pair of Aces)
ken_wynn: shows [6c 8c] (two pair, Aces and Sixes)
ken_wynn collected $0.66 from pot
*** SUMMARY ***
Total pot $0.69 | Rake $0.03 
Board [Ah 7s 6s 2c Ac]
Seat 1: Bunkiebear (big blind) showed [4h Qs] and lost with a pair of Aces
Seat 2: Breno_Silveira folded on the Flop
Seat 3: ken_wynn showed [6c 8c] and won ($0.66) with two pair, Aces and Sixes
Seat 4: Black021 (button) folded before Flop (didn't bet)
Seat 5: Ger Cortes (small blind) folded before Flop



PokerStars Hand #222943234860:  Hold'em No Limit ($0.05/$0.10 USD) - 2021/01/23 22:46:32 ET
Table 'Polydoros II' 6-max Seat #5 is the button
Seat 1: Bunkiebear ($9.72 in chips) 
Seat 3: ken_wynn ($7.60 in chips) 
Seat 4: Black021 ($15.57 in chips) 
Seat 5: Ger Cortes ($10 in chips) 
Bunkiebear: posts small blind $0.05
ken_wynn: posts big blind $0.10
*** HOLE CARDS ***
Black021: folds 
analytic1 joins the table at seat #2 
Ger Cortes: folds 
Bunkiebear: calls $0.05
ken_wynn: checks 
*** FLOP *** [Kc 8s 7c]
Bunkiebear: checks 
ken_wynn: checks 
*** TURN *** [Kc 8s 7c] [Kh]
Bunkiebear: bets $0.30
ken_wynn: folds 
Uncalled bet ($0.30) returned to Bunkiebear
Bunkiebear collected $0.19 from pot
Bunkiebear: doesn't show hand 
*** SUMMARY ***
Total pot $0.20 | Rake $0.01 
Board [Kc 8s 7c Kh]
Seat 1: Bunkiebear (small blind) collected ($0.19)
Seat 3: ken_wynn (big blind) folded on the Turn
Seat 4: Black021 folded before Flop (didn't bet)
Seat 5: Ger Cortes (button) folded before Flop (didn't bet)



PokerStars Hand #222943243719:  Hold'em No Limit ($0.05/$0.10 USD) - 2021/01/23 22:46:58 ET
Table 'Polydoros II' 6-max Seat #1 is the button
Seat 1: Bunkiebear ($9.81 in chips) 
Seat 3: ken_wynn ($7.50 in chips) 
Seat 4: Black021 ($15.57 in chips) 
Seat 5: Ger Cortes ($10 in chips) 
ken_wynn: posts small blind $0.05
Black021: posts big blind $0.10
*** HOLE CARDS ***
Ger Cortes: folds 
Bunkiebear: calls $0.10
ken_wynn: folds 
Black021: raises $0.30 to $0.40
Bunkiebear: calls $0.30
*** FLOP *** [Kh 4h 2s]
Black021: checks 
Bunkiebear: checks 
*** TURN *** [Kh 4h 2s] [9s]
Black021: bets $0.50
Bunkiebear: folds 
Uncalled bet ($0.50) returned to Black021
Black021 collected $0.81 from pot
Black021: doesn't show hand 
*** SUMMARY ***
Total pot $0.85 | Rake $0.04 
Board [Kh 4h 2s 9s]
Seat 1: Bunkiebear (button) folded on the Turn
Seat 3: ken_wynn (small blind) folded before Flop
Seat 4: Black021 (big blind) collected ($0.81)
Seat 5: Ger Cortes folded before Flop (didn't bet)



PokerStars Hand #222943251362:  Hold'em No Limit ($0.05/$0.10 USD) - 2021/01/23 22:47:20 ET
Table 'Polydoros II' 6-max Seat #3 is the button
Seat 1: Bunkiebear ($9.41 in chips) 
Seat 3: ken_wynn ($7.45 in chips) 
Seat 4: Black021 ($15.98 in chips) 
Seat 5: Ger Cortes ($10 in chips) 
Black021: posts small blind $0.05
Ger Cortes: posts big blind $0.10
analytic1: sits out 
*** HOLE CARDS ***
Bunkiebear: calls $0.10
ken_wynn: folds 
Black021: raises $0.30 to $0.40
Ger Cortes: folds 
Bunkiebear: calls $0.30
*** FLOP *** [Kh Ah Kd]
Black021: checks 
Bunkiebear: bets $0.40
Black021: calls $0.40
*** TURN *** [Kh Ah Kd] [4h]
Black021: checks 
Bunkiebear: bets $0.50
Black021: calls $0.50
*** RIVER *** [Kh Ah Kd 4h] [Jd]
Black021: checks 
Bunkiebear: bets $1.40
Black021: folds 
Uncalled bet ($1.40) returned to Bunkiebear
Bunkiebear collected $2.58 from pot
Bunkiebear: doesn't show hand 
*** SUMMARY ***
Total pot $2.70 | Rake $0.12 
Board [Kh Ah Kd 4h Jd]
Seat 1: Bunkiebear collected ($2.58)
Seat 3: ken_wynn (button) folded before Flop (didn't bet)
Seat 4: Black021 (small blind) folded on the River
Seat 5: Ger Cortes (big blind) folded before Flop



PokerStars Hand #222943263997:  Hold'em No Limit ($0.05/$0.10 USD) - 2021/01/23 22:47:57 ET
Table 'Polydoros II' 6-max Seat #4 is the button
Seat 1: Bunkiebear ($10.69 in chips) 
Seat 3: ken_wynn ($7.45 in chips) 
Seat 4: Black021 ($14.68 in chips) 
Seat 5: Ger Cortes ($10 in chips) 
Ger Cortes: posts small blind $0.05
Bunkiebear: posts big blind $0.10
analytic1: sits out 
*** HOLE CARDS ***
ken_wynn: folds 
Black021: raises $0.12 to $0.22
Ger Cortes: folds 
Bunkiebear: folds 
Uncalled bet ($0.12) returned to Black021
Black021 collected $0.25 from pot
Black021: doesn't show hand 
*** SUMMARY ***
Total pot $0.25 | Rake $0 
Seat 1: Bunkiebear (big blind) folded before Flop
Seat 3: ken_wynn folded before Flop (didn't bet)
Seat 4: Black021 (button) collected ($0.25)
Seat 5: Ger Cortes (small blind) folded before Flop



PokerStars Hand #222943267618:  Hold'em No Limit ($0.05/$0.10 USD) - 2021/01/23 22:48:08 ET
Table 'Polydoros II' 6-max Seat #5 is the button
Seat 1: Bunkiebear ($10.59 in chips) 
Seat 2: analytic1 ($10 in chips) 
Seat 3: ken_wynn ($7.45 in chips) 
Seat 4: Black021 ($14.83 in chips) 
Seat 5: Ger Cortes ($10 in chips) 
Bunkiebear: posts small blind $0.05
analytic1: posts big blind $0.10
*** HOLE CARDS ***
ken_wynn: folds 
Black021: raises $0.15 to $0.25
Ger Cortes: folds 
Bunkiebear: folds 
analytic1: folds 
Uncalled bet ($0.15) returned to Black021
Black021 collected $0.25 from pot
Black021: doesn't show hand 
*** SUMMARY ***
Total pot $0.25 | Rake $0 
Seat 1: Bunkiebear (small blind) folded before Flop
Seat 2: analytic1 (big blind) folded before Flop
Seat 3: ken_wynn folded before Flop (didn't bet)
Seat 4: Black021 collected ($0.25)
Seat 5: Ger Cortes (button) folded before Flop (didn't bet)



PokerStars Hand #222943270846:  Hold'em No Limit ($0.05/$0.10 USD) - 2021/01/23 22:48:17 ET
Table 'Polydoros II' 6-max Seat #1 is the button
Seat 1: Bunkiebear ($10.54 in chips) 
Seat 2: analytic1 ($9.90 in chips) 
Seat 3: ken_wynn ($7.45 in chips) 
Seat 4: Black021 ($14.98 in chips) 
Seat 5: Ger Cortes ($10 in chips) 
analytic1: posts small blind $0.05
ken_wynn: posts big blind $0.10
*** HOLE CARDS ***
Black021: folds 
Ger Cortes has timed out
Ger Cortes: folds 
Bunkiebear: folds 
analytic1: raises $0.20 to $0.30
ken_wynn: calls $0.20
*** FLOP *** [7c Kh Kd]
analytic1: bets $0.29
ken_wynn: folds 
Uncalled bet ($0.29) returned to analytic1
analytic1 collected $0.57 from pot
analytic1: doesn't show hand 
*** SUMMARY ***
Total pot $0.60 | Rake $0.03 
Board [7c Kh Kd]
Seat 1: Bunkiebear (button) folded before Flop (didn't bet)
Seat 2: analytic1 (small blind) collected ($0.57)
Seat 3: ken_wynn (big blind) folded on the Flop
Seat 4: Black021 folded before Flop (didn't bet)
Seat 5: Ger Cortes folded before Flop (didn't bet)



PokerStars Hand #222943290528:  Hold'em No Limit ($0.05/$0.10 USD) - 2021/01/23 22:48:57 ET
Table 'Polydoros II' 6-max Seat #2 is the button
Seat 1: Bunkiebear ($10.54 in chips) 
Seat 2: analytic1 ($10.17 in chips) 
Seat 3: ken_wynn ($7.15 in chips) 
Seat 4: Black021 ($14.98 in chips) 
Seat 5: Ger Cortes ($10 in chips) 
ken_wynn: posts small blind $0.05
Black021: posts big blind $0.10
*** HOLE CARDS ***
Ger Cortes: raises $0.15 to $0.25
Bunkiebear: folds 
analytic1: folds 
ken_wynn: folds 
Black021: folds 
Uncalled bet ($0.15) returned to Ger Cortes
Ger Cortes collected $0.25 from pot
*** SUMMARY ***
Total pot $0.25 | Rake $0 
Seat 1: Bunkiebear folded before Flop (didn't bet)
Seat 2: analytic1 (button) folded before Flop (didn't bet)
Seat 3: ken_wynn (small blind) folded before Flop
Seat 4: Black021 (big blind) folded before Flop
Seat 5: Ger Cortes collected ($0.25)



PokerStars Hand #222943296902:  Hold'em No Limit ($0.05/$0.10 USD) - 2021/01/23 22:49:16 ET
Table 'Polydoros II' 6-max Seat #3 is the button
Seat 1: Bunkiebear ($10.54 in chips) 
Seat 2: analytic1 ($10.17 in chips) 
Seat 3: ken_wynn ($7.10 in chips) 
Seat 4: Black021 ($14.88 in chips) 
Seat 5: Ger Cortes ($10.15 in chips) 
Black021: posts small blind $0.05
Ger Cortes: posts big blind $0.10
*** HOLE CARDS ***
Bunkiebear: folds 
analytic1: folds 
ken_wynn: folds 
Black021: raises $0.17 to $0.27
Ger Cortes: calls $0.17
*** FLOP *** [Ad 6s 5h]
Black021: bets $0.17
Ger Cortes: calls $0.17
*** TURN *** [Ad 6s 5h] [2d]
Black021: checks 
Ger Cortes: checks 
*** RIVER *** [Ad 6s 5h 2d] [7d]
Black021: checks 
Ger Cortes: checks 
*** SHOW DOWN ***
Black021: shows [Jh Kh] (high card Ace)
Ger Cortes: shows [8h 6h] (a pair of Sixes)
Ger Cortes collected $0.84 from pot
*** SUMMARY ***
Total pot $0.88 | Rake $0.04 
Board [Ad 6s 5h 2d 7d]
Seat 1: Bunkiebear folded before Flop (didn't bet)
Seat 2: analytic1 folded before Flop (didn't bet)
Seat 3: ken_wynn (button) folded before Flop (didn't bet)
Seat 4: Black021 (small blind) showed [Jh Kh] and lost with high card Ace
Seat 5: Ger Cortes (big blind) showed [8h 6h] and won ($0.84) with a pair of Sixes



PokerStars Hand #222943310789:  Hold'em No Limit ($0.05/$0.10 USD) - 2021/01/23 22:49:58 ET
Table 'Polydoros II' 6-max Seat #4 is the button
Seat 1: Bunkiebear ($10.54 in chips) 
Seat 2: analytic1 ($10.17 in chips) 
Seat 3: ken_wynn ($7.10 in chips) 
Seat 4: Black021 ($14.44 in chips) 
Seat 5: Ger Cortes ($10.55 in chips) 
Ger Cortes: posts small blind $0.05
Bunkiebear: posts big blind $0.10
*** HOLE CARDS ***
analytic1: raises $0.20 to $0.30
ken_wynn: folds 
Black021: folds 
Ger Cortes: folds 
Bunkiebear: folds 
Uncalled bet ($0.20) returned to analytic1
analytic1 collected $0.25 from pot
MilesSteel was removed from the table for failing to post
MilesSteel leaves the table
analytic1: doesn't show hand 
*** SUMMARY ***
Total pot $0.25 | Rake $0 
Seat 1: Bunkiebear (big blind) folded before Flop
Seat 2: analytic1 collected ($0.25)
Seat 3: ken_wynn folded before Flop (didn't bet)
Seat 4: Black021 (button) folded before Flop (didn't bet)
Seat 5: Ger Cortes (small blind) folded before Flop



PokerStars Hand #222943316026:  Hold'em No Limit ($0.05/$0.10 USD) - 2021/01/23 22:50:13 ET
Table 'Polydoros II' 6-max Seat #5 is the button
Seat 1: Bunkiebear ($10.44 in chips) 
Seat 2: analytic1 ($10.32 in chips) 
Seat 3: ken_wynn ($7.10 in chips) 
Seat 4: Black021 ($14.44 in chips) 
Seat 5: Ger Cortes ($10.50 in chips) 
Bunkiebear: posts small blind $0.05
analytic1: posts big blind $0.10
*** HOLE CARDS ***
ken_wynn: folds 
Black021: raises $0.15 to $0.25
Ger Cortes: folds 
Bunkiebear: folds 
I find you ez joins the table at seat #6 
analytic1: folds 
Uncalled bet ($0.15) returned to Black021
Black021 collected $0.25 from pot
Black021: doesn't show hand 
*** SUMMARY ***
Total pot $0.25 | Rake $0 
Seat 1: Bunkiebear (small blind) folded before Flop
Seat 2: analytic1 (big blind) folded before Flop
Seat 3: ken_wynn folded before Flop (didn't bet)
Seat 4: Black021 collected ($0.25)
Seat 5: Ger Cortes (button) folded before Flop (didn't bet)



PokerStars Hand #222943322283:  Hold'em No Limit ($0.05/$0.10 USD) - 2021/01/23 22:50:32 ET
Table 'Polydoros II' 6-max Seat #1 is the button
Seat 1: Bunkiebear ($10.39 in chips) 
Seat 2: analytic1 ($10.22 in chips) 
Seat 3: ken_wynn ($7.10 in chips) 
Seat 4: Black021 ($14.59 in chips) 
Seat 5: Ger Cortes ($10.50 in chips) 
analytic1: posts small blind $0.05
ken_wynn: posts big blind $0.10
I find you ez: sits out 
*** HOLE CARDS ***
Black021: folds 
Ger Cortes: folds 
Bunkiebear: folds 
analytic1: folds 
Uncalled bet ($0.05) returned to ken_wynn
ken_wynn collected $0.10 from pot
ken_wynn: doesn't show hand 
*** SUMMARY ***
Total pot $0.10 | Rake $0 
Seat 1: Bunkiebear (button) folded before Flop (didn't bet)
Seat 2: analytic1 (small blind) folded before Flop
Seat 3: ken_wynn (big blind) collected ($0.10)
Seat 4: Black021 folded before Flop (didn't bet)
Seat 5: Ger Cortes folded before Flop (didn't bet)



PokerStars Hand #222943327569:  Hold'em No Limit ($0.05/$0.10 USD) - 2021/01/23 22:50:48 ET
Table 'Polydoros II' 6-max Seat #2 is the button
Seat 1: Bunkiebear ($10.39 in chips) 
Seat 2: analytic1 ($10.17 in chips) 
Seat 3: ken_wynn ($7.15 in chips) 
Seat 4: Black021 ($14.59 in chips) 
Seat 5: Ger Cortes ($10.50 in chips) 
ken_wynn: posts small blind $0.05
Black021: posts big blind $0.10
I find you ez: sits out 
*** HOLE CARDS ***
Ger Cortes: folds 
Bunkiebear: calls $0.10
analytic1: folds 
ken_wynn: folds 
Black021: checks 
*** FLOP *** [5h Kd 2d]
Black021: checks 
Bunkiebear: bets $0.40
Black021: folds 
Uncalled bet ($0.40) returned to Bunkiebear
Bunkiebear collected $0.24 from pot
Bunkiebear: doesn't show hand 
*** SUMMARY ***
Total pot $0.25 | Rake $0.01 
Board [5h Kd 2d]
Seat 1: Bunkiebear collected ($0.24)
Seat 2: analytic1 (button) folded before Flop (didn't bet)
Seat 3: ken_wynn (small blind) folded before Flop
Seat 4: Black021 (big blind) folded on the Flop
Seat 5: Ger Cortes folded before Flop (didn't bet)



PokerStars Hand #222943334492:  Hold'em No Limit ($0.05/$0.10 USD) - 2021/01/23 22:51:09 ET
Table 'Polydoros II' 6-max Seat #3 is the button
Seat 1: Bunkiebear ($10.53 in chips) 
Seat 2: analytic1 ($10.17 in chips) 
Seat 3: ken_wynn ($7.10 in chips) 
Seat 4: Black021 ($14.49 in chips) 
Seat 5: Ger Cortes ($10.50 in chips) 
Black021: posts small blind $0.05
Ger Cortes: posts big blind $0.10
I find you ez: sits out 
*** HOLE CARDS ***
Bunkiebear: folds 
analytic1: folds 
ken_wynn: folds 
Black021: folds 
Uncalled bet ($0.05) returned to Ger Cortes
Ger Cortes collected $0.10 from pot
*** SUMMARY ***
Total pot $0.10 | Rake $0 
Seat 1: Bunkiebear folded before Flop (didn't bet)
Seat 2: analytic1 folded before Flop (didn't bet)
Seat 3: ken_wynn (button) folded before Flop (didn't bet)
Seat 4: Black021 (small blind) folded before Flop
Seat 5: Ger Cortes (big blind) collected ($0.10)



PokerStars Hand #222943338843:  Hold'em No Limit ($0.05/$0.10 USD) - 2021/01/23 22:51:22 ET
Table 'Polydoros II' 6-max Seat #4 is the button
Seat 1: Bunkiebear ($10.53 in chips) 
Seat 2: analytic1 ($10.17 in chips) 
Seat 3: ken_wynn ($7.10 in chips) 
Seat 4: Black021 ($14.44 in chips) 
Seat 5: Ger Cortes ($10.55 in chips) 
Seat 6: I find you ez ($10 in chips) 
Ger Cortes: posts small blind $0.05
I find you ez: posts big blind $0.10
*** HOLE CARDS ***
Bunkiebear: calls $0.10
analytic1 has timed out
analytic1: folds 
ken_wynn: raises $0.30 to $0.40
Black021: folds 
Ger Cortes: folds 
I find you ez: folds 
Bunkiebear: calls $0.30
*** FLOP *** [6h 5h 8c]
Bunkiebear: checks 
ken_wynn: bets $0.70
Bunkiebear: folds 
Uncalled bet ($0.70) returned to ken_wynn
ken_wynn collected $0.91 from pot
ken_wynn: doesn't show hand 
*** SUMMARY ***
Total pot $0.95 | Rake $0.04 
Board [6h 5h 8c]
Seat 1: Bunkiebear folded on the Flop
Seat 2: analytic1 folded before Flop (didn't bet)
Seat 3: ken_wynn collected ($0.91)
Seat 4: Black021 (button) folded before Flop (didn't bet)
Seat 5: Ger Cortes (small blind) folded before Flop
Seat 6: I find you ez (big blind) folded before Flop



PokerStars Hand #222943357354:  Hold'em No Limit ($0.05/$0.10 USD) - 2021/01/23 22:51:55 ET
Table 'Polydoros II' 6-max Seat #5 is the button
Seat 1: Bunkiebear ($10.13 in chips) 
Seat 3: ken_wynn ($7.61 in chips) 
Seat 4: Black021 ($14.44 in chips) 
Seat 5: Ger Cortes ($10.50 in chips) 
Seat 6: I find you ez ($10 in chips) 
I find you ez: posts small blind $0.05
Bunkiebear: posts big blind $0.10
*** HOLE CARDS ***
ken_wynn: folds 
Black021: folds 
Ger Cortes: folds 
I find you ez: raises $0.30 to $0.40
Bunkiebear: calls $0.30
*** FLOP *** [5h 2c 4d]
I find you ez: bets $0.40
Bunkiebear: calls $0.40
*** TURN *** [5h 2c 4d] [4c]
I find you ez: checks 
Bunkiebear: checks 
*** RIVER *** [5h 2c 4d 4c] [7s]
I find you ez: bets $0.75
Bunkiebear: folds 
Uncalled bet ($0.75) returned to I find you ez
I find you ez collected $1.53 from pot
I find you ez: doesn't show hand 
*** SUMMARY ***
Total pot $1.60 | Rake $0.07 
Board [5h 2c 4d 4c 7s]
Seat 1: Bunkiebear (big blind) folded on the River
Seat 3: ken_wynn folded before Flop (didn't bet)
Seat 4: Black021 folded before Flop (didn't bet)
Seat 5: Ger Cortes (button) folded before Flop (didn't bet)
Seat 6: I find you ez (small blind) collected ($1.53)



PokerStars Hand #222943369162:  Hold'em No Limit ($0.05/$0.10 USD) - 2021/01/23 22:52:30 ET
Table 'Polydoros II' 6-max Seat #6 is the button
Seat 1: Bunkiebear ($9.33 in chips) 
Seat 2: analytic1 ($10.17 in chips) 
Seat 3: ken_wynn ($7.61 in chips) 
Seat 4: Black021 ($14.44 in chips) 
Seat 5: Ger Cortes ($10.50 in chips) 
Seat 6: I find you ez ($10.73 in chips) 
Bunkiebear: posts small blind $0.05
analytic1: posts big blind $0.10
*** HOLE CARDS ***
ken_wynn: folds 
Black021: folds 
Ger Cortes: folds 
I find you ez: folds 
Bunkiebear: calls $0.05
analytic1: checks 
*** FLOP *** [As 3d Kh]
Bunkiebear: checks 
analytic1: checks 
*** TURN *** [As 3d Kh] [6d]
Bunkiebear: checks 
analytic1: checks 
*** RIVER *** [As 3d Kh 6d] [Kc]
Bunkiebear: checks 
analytic1: checks 
*** SHOW DOWN ***
Bunkiebear: shows [Jc 8h] (a pair of Kings)
analytic1: shows [3h 4h] (two pair, Kings and Threes)
analytic1 collected $0.19 from pot
*** SUMMARY ***
Total pot $0.20 | Rake $0.01 
Board [As 3d Kh 6d Kc]
Seat 1: Bunkiebear (small blind) showed [Jc 8h] and lost with a pair of Kings
Seat 2: analytic1 (big blind) showed [3h 4h] and won ($0.19) with two pair, Kings and Threes
Seat 3: ken_wynn folded before Flop (didn't bet)
Seat 4: Black021 folded before Flop (didn't bet)
Seat 5: Ger Cortes folded before Flop (didn't bet)
Seat 6: I find you ez (button) folded before Flop (didn't bet)



PokerStars Hand #222943378834:  Hold'em No Limit ($0.05/$0.10 USD) - 2021/01/23 22:52:59 ET
Table 'Polydoros II' 6-max Seat #1 is the button
Seat 1: Bunkiebear ($9.23 in chips) 
Seat 2: analytic1 ($10.26 in chips) 
Seat 3: ken_wynn ($7.61 in chips) 
Seat 4: Black021 ($14.44 in chips) 
Seat 5: Ger Cortes ($10.50 in chips) 
Seat 6: I find you ez ($10.73 in chips) 
analytic1: posts small blind $0.05
ken_wynn: posts big blind $0.10
*** HOLE CARDS ***
Black021: folds 
Ger Cortes: folds 
I find you ez: raises $0.20 to $0.30
Bunkiebear: folds 
analytic1: folds 
ken_wynn: folds 
Uncalled bet ($0.20) returned to I find you ez
I find you ez collected $0.25 from pot
I find you ez: doesn't show hand 
*** SUMMARY ***
Total pot $0.25 | Rake $0 
Seat 1: Bunkiebear (button) folded before Flop (didn't bet)
Seat 2: analytic1 (small blind) folded before Flop
Seat 3: ken_wynn (big blind) folded before Flop
Seat 4: Black021 folded before Flop (didn't bet)
Seat 5: Ger Cortes folded before Flop (didn't bet)
Seat 6: I find you ez collected ($0.25)



PokerStars Hand #222943382197:  Hold'em No Limit ($0.05/$0.10 USD) - 2021/01/23 22:53:09 ET
Table 'Polydoros II' 6-max Seat #2 is the button
Seat 1: Bunkiebear ($9.23 in chips) 
Seat 2: analytic1 ($10.21 in chips) 
Seat 3: ken_wynn ($7.51 in chips) 
Seat 4: Black021 ($14.44 in chips) 
Seat 5: Ger Cortes ($10.50 in chips) 
Seat 6: I find you ez ($10.88 in chips) 
ken_wynn: posts small blind $0.05
Black021: posts big blind $0.10
*** HOLE CARDS ***
Ger Cortes: raises $0.15 to $0.25
I find you ez: folds 
Bunkiebear: calls $0.25
analytic1: folds 
ken_wynn: folds 
Black021: folds 
*** FLOP *** [5d Qd 7c]
Ger Cortes: bets $0.20
Bunkiebear: calls $0.20
*** TURN *** [5d Qd 7c] [Ks]
Ger Cortes: bets $0.77
Bunkiebear: calls $0.77
*** RIVER *** [5d Qd 7c Ks] [Ad]
Ger Cortes: bets $0.82
Bunkiebear: calls $0.82
*** SHOW DOWN ***
Ger Cortes: shows [Ac Tc] (a pair of Aces)
Bunkiebear: shows [As Jd] (a pair of Aces - King+Queen+Jack kicker)
Bunkiebear collected $4.04 from pot
*** SUMMARY ***
Total pot $4.23 | Rake $0.19 
Board [5d Qd 7c Ks Ad]
Seat 1: Bunkiebear showed [As Jd] and won ($4.04) with a pair of Aces
Seat 2: analytic1 (button) folded before Flop (didn't bet)
Seat 3: ken_wynn (small blind) folded before Flop
Seat 4: Black021 (big blind) folded before Flop
Seat 5: Ger Cortes showed [Ac Tc] and lost with a pair of Aces
Seat 6: I find you ez folded before Flop (didn't bet)



PokerStars Hand #222943395711:  Hold'em No Limit ($0.05/$0.10 USD) - 2021/01/23 22:53:50 ET
Table 'Polydoros II' 6-max Seat #3 is the button
Seat 1: Bunkiebear ($11.23 in chips) 
Seat 2: analytic1 ($10.21 in chips) 
Seat 3: ken_wynn ($7.46 in chips) 
Seat 4: Black021 ($14.34 in chips) 
Seat 5: Ger Cortes ($10 in chips) 
Seat 6: I find you ez ($10.88 in chips) 
Black021: posts small blind $0.05
Ger Cortes: posts big blind $0.10
*** HOLE CARDS ***
I find you ez: raises $0.30 to $0.40
Bunkiebear: folds 
analytic1: folds 
ken_wynn: folds 
Black021: folds 
Ger Cortes: calls $0.30
*** FLOP *** [Qd Ts 6d]
Ger Cortes: checks 
I find you ez: bets $0.40
Ger Cortes: calls $0.40
*** TURN *** [Qd Ts 6d] [Jc]
Ger Cortes: checks 
I find you ez: checks 
*** RIVER *** [Qd Ts 6d Jc] [4c]
Ger Cortes: checks 
I find you ez: checks 
*** SHOW DOWN ***
Ger Cortes: shows [Jd Js] (three of a kind, Jacks)
I find you ez: mucks hand 
Ger Cortes collected $1.58 from pot
*** SUMMARY ***
Total pot $1.65 | Rake $0.07 
Board [Qd Ts 6d Jc 4c]
Seat 1: Bunkiebear folded before Flop (didn't bet)
Seat 2: analytic1 folded before Flop (didn't bet)
Seat 3: ken_wynn (button) folded before Flop (didn't bet)
Seat 4: Black021 (small blind) folded before Flop
Seat 5: Ger Cortes (big blind) showed [Jd Js] and won ($1.58) with three of a kind, Jacks
Seat 6: I find you ez mucked



PokerStars Hand #222943416192:  Hold'em No Limit ($0.05/$0.10 USD) - 2021/01/23 22:54:51 ET
Table 'Polydoros II' 6-max Seat #4 is the button
Seat 1: Bunkiebear ($11.23 in chips) 
Seat 2: analytic1 ($10.21 in chips) 
Seat 3: ken_wynn ($7.46 in chips) 
Seat 4: Black021 ($14.29 in chips) 
Seat 5: Ger Cortes ($10.78 in chips) 
Seat 6: I find you ez ($10.08 in chips) 
Ger Cortes: posts small blind $0.05
I find you ez: posts big blind $0.10
*** HOLE CARDS ***
Bunkiebear: folds 
analytic1: folds 
ken_wynn: raises $0.15 to $0.25
Black021: folds 
Ger Cortes: folds 
I find you ez: folds 
Uncalled bet ($0.15) returned to ken_wynn
ken_wynn collected $0.25 from pot
ken_wynn: doesn't show hand 
*** SUMMARY ***
Total pot $0.25 | Rake $0 
Seat 1: Bunkiebear folded before Flop (didn't bet)
Seat 2: analytic1 folded before Flop (didn't bet)
Seat 3: ken_wynn collected ($0.25)
Seat 4: Black021 (button) folded before Flop (didn't bet)
Seat 5: Ger Cortes (small blind) folded before Flop
Seat 6: I find you ez (big blind) folded before Flop



PokerStars Hand #222943421062:  Hold'em No Limit ($0.05/$0.10 USD) - 2021/01/23 22:55:05 ET
Table 'Polydoros II' 6-max Seat #5 is the button
Seat 1: Bunkiebear ($11.23 in chips) 
Seat 2: analytic1 ($10.21 in chips) 
Seat 3: ken_wynn ($7.61 in chips) 
Seat 4: Black021 ($14.29 in chips) 
Seat 5: Ger Cortes ($10.73 in chips) 
Seat 6: I find you ez ($10 in chips) 
I find you ez: posts small blind $0.05
Bunkiebear: posts big blind $0.10
*** HOLE CARDS ***
analytic1: raises $0.20 to $0.30
ken_wynn: folds 
Black021: raises $0.66 to $0.96
Ger Cortes: folds 
I find you ez: folds 
Bunkiebear: folds 
analytic1: folds 
Uncalled bet ($0.66) returned to Black021
Black021 collected $0.75 from pot
Black021: doesn't show hand 
*** SUMMARY ***
Total pot $0.75 | Rake $0 
Seat 1: Bunkiebear (big blind) folded before Flop
Seat 2: analytic1 folded before Flop
Seat 3: ken_wynn folded before Flop (didn't bet)
Seat 4: Black021 collected ($0.75)
Seat 5: Ger Cortes (button) folded before Flop (didn't bet)
Seat 6: I find you ez (small blind) folded before Flop



PokerStars Hand #222943429615:  Hold'em No Limit ($0.05/$0.10 USD) - 2021/01/23 22:55:38 ET
Table 'Polydoros II' 6-max Seat #6 is the button
Seat 1: Bunkiebear ($11.13 in chips) 
Seat 2: analytic1 ($9.91 in chips) 
Seat 3: ken_wynn ($7.61 in chips) 
Seat 4: Black021 ($14.74 in chips) 
Seat 5: Ger Cortes ($10.73 in chips) 
Seat 6: I find you ez ($10 in chips) 
Bunkiebear: posts small blind $0.05
analytic1: posts big blind $0.10
*** HOLE CARDS ***
ken_wynn: raises $0.15 to $0.25
Black021: folds 
Ger Cortes: folds 
I find you ez: folds 
Bunkiebear: calls $0.20
analytic1: calls $0.15
*** FLOP *** [8s 3s Tc]
Bunkiebear: checks 
analytic1: bets $0.36
ken_wynn: calls $0.36
Bunkiebear: calls $0.36
*** TURN *** [8s 3s Tc] [7s]
Bunkiebear: checks 
analytic1: bets $1.31
ken_wynn: folds 
Bunkiebear: calls $1.31
*** RIVER *** [8s 3s Tc 7s] [6d]
Bunkiebear: checks 
analytic1: checks 
*** SHOW DOWN ***
Bunkiebear: shows [As 9c] (a straight, Six to Ten)
analytic1: mucks hand 
Bunkiebear collected $4.25 from pot
*** SUMMARY ***
Total pot $4.45 | Rake $0.20 
Board [8s 3s Tc 7s 6d]
Seat 1: Bunkiebear (small blind) showed [As 9c] and won ($4.25) with a straight, Six to Ten
Seat 2: analytic1 (big blind) mucked
Seat 3: ken_wynn folded on the Turn
Seat 4: Black021 folded before Flop (didn't bet)
Seat 5: Ger Cortes folded before Flop (didn't bet)
Seat 6: I find you ez (button) folded before Flop (didn't bet)



PokerStars Hand #222943441831:  Hold'em No Limit ($0.05/$0.10 USD) - 2021/01/23 22:56:27 ET
Table 'Polydoros II' 6-max Seat #1 is the button
Seat 1: Bunkiebear ($13.46 in chips) 
Seat 2: analytic1 ($10 in chips) 
Seat 4: Black021 ($14.74 in chips) 
Seat 5: Ger Cortes ($10.73 in chips) 
Seat 6: I find you ez ($10 in chips) 
analytic1: posts small blind $0.05
Black021: posts big blind $0.10
*** HOLE CARDS ***
Ger Cortes: folds 
I find you ez: raises $0.20 to $0.30
Bunkiebear: calls $0.30
analytic1: folds 
Black021: folds 
*** FLOP *** [Js 6d 8s]
I find you ez: bets $0.50
Bunkiebear: calls $0.50
*** TURN *** [Js 6d 8s] [8h]
I find you ez: bets $1.10
Bunkiebear: folds 
Uncalled bet ($1.10) returned to I find you ez
I find you ez collected $1.67 from pot
I find you ez: doesn't show hand 
*** SUMMARY ***
Total pot $1.75 | Rake $0.08 
Board [Js 6d 8s 8h]
Seat 1: Bunkiebear (button) folded on the Turn
Seat 2: analytic1 (small blind) folded before Flop
Seat 4: Black021 (big blind) folded before Flop
Seat 5: Ger Cortes folded before Flop (didn't bet)
Seat 6: I find you ez collected ($1.67)



PokerStars Hand #222943448742:  Hold'em No Limit ($0.05/$0.10 USD) - 2021/01/23 22:56:54 ET
Table 'Polydoros II' 6-max Seat #2 is the button
Seat 1: Bunkiebear ($12.66 in chips) 
Seat 2: analytic1 ($9.95 in chips) 
Seat 4: Black021 ($14.64 in chips) 
Seat 5: Ger Cortes ($10.73 in chips) 
Seat 6: I find you ez ($10.87 in chips) 
Black021: posts small blind $0.05
Ger Cortes: posts big blind $0.10
*** HOLE CARDS ***
I find you ez: folds 
Bunkiebear: calls $0.10
analytic1: raises $0.20 to $0.30
Black021: folds 
Ger Cortes: folds 
Bunkiebear: calls $0.20
*** FLOP *** [6c Kc Td]
Bunkiebear: checks 
analytic1: bets $0.36
Bunkiebear: calls $0.36
*** TURN *** [6c Kc Td] [Tc]
Bunkiebear: checks 
analytic1: checks 
*** RIVER *** [6c Kc Td Tc] [8d]
Bunkiebear: checks 
analytic1: checks 
*** SHOW DOWN ***
Bunkiebear: shows [2c 2d] (two pair, Tens and Deuces)
analytic1: mucks hand 
Bunkiebear collected $1.40 from pot
*** SUMMARY ***
Total pot $1.47 | Rake $0.07 
Board [6c Kc Td Tc 8d]
Seat 1: Bunkiebear showed [2c 2d] and won ($1.40) with two pair, Tens and Deuces
Seat 2: analytic1 (button) mucked
Seat 4: Black021 (small blind) folded before Flop
Seat 5: Ger Cortes (big blind) folded before Flop
Seat 6: I find you ez folded before Flop (didn't bet)



PokerStars Hand #222943457474:  Hold'em No Limit ($0.05/$0.10 USD) - 2021/01/23 22:57:28 ET
Table 'Polydoros II' 6-max Seat #4 is the button
Seat 1: Bunkiebear ($13.40 in chips) 
Seat 2: analytic1 ($9.29 in chips) 
Seat 4: Black021 ($14.59 in chips) 
Seat 5: Ger Cortes ($10.63 in chips) 
Seat 6: I find you ez ($10.87 in chips) 
Ger Cortes: posts small blind $0.05
I find you ez: posts big blind $0.10
*** HOLE CARDS ***
Bunkiebear: folds 
analytic1 has timed out
analytic1: folds 
Black021: raises $0.12 to $0.22
Ger Cortes: folds 
I find you ez: folds 
Uncalled bet ($0.12) returned to Black021
Black021 collected $0.25 from pot
Black021: doesn't show hand 
*** SUMMARY ***
Total pot $0.25 | Rake $0 
Seat 1: Bunkiebear folded before Flop (didn't bet)
Seat 2: analytic1 folded before Flop (didn't bet)
Seat 4: Black021 (button) collected ($0.25)
Seat 5: Ger Cortes (small blind) folded before Flop
Seat 6: I find you ez (big blind) folded before Flop



PokerStars Hand #222943462422:  Hold'em No Limit ($0.05/$0.10 USD) - 2021/01/23 22:57:47 ET
Table 'Polydoros II' 6-max Seat #5 is the button
Seat 1: Bunkiebear ($13.40 in chips) 
Seat 2: analytic1 ($9.29 in chips) 
Seat 4: Black021 ($14.74 in chips) 
Seat 5: Ger Cortes ($10.58 in chips) 
Seat 6: I find you ez ($10.77 in chips) 
I find you ez: posts small blind $0.05
Bunkiebear: posts big blind $0.10
*** HOLE CARDS ***
analytic1: folds 
Black021: folds 
Ger Cortes: raises $0.15 to $0.25
analytic1 leaves the table
I find you ez: calls $0.20
Bunkiebear: folds 
*** FLOP *** [6h 7s Qh]
I find you ez: checks 
Ger Cortes: bets $0.31
I find you ez: calls $0.31
*** TURN *** [6h 7s Qh] [Td]
I find you ez: checks 
Ger Cortes: checks 
*** RIVER *** [6h 7s Qh Td] [3s]
I find you ez: bets $0.40
Ger Cortes: folds 
Uncalled bet ($0.40) returned to I find you ez
I find you ez collected $1.17 from pot
I find you ez: doesn't show hand 
*** SUMMARY ***
Total pot $1.22 | Rake $0.05 
Board [6h 7s Qh Td 3s]
Seat 1: Bunkiebear (big blind) folded before Flop
Seat 2: analytic1 folded before Flop (didn't bet)
Seat 4: Black021 folded before Flop (didn't bet)
Seat 5: Ger Cortes (button) folded on the River
Seat 6: I find you ez (small blind) collected ($1.17)



PokerStars Hand #222943472667:  Hold'em No Limit ($0.05/$0.10 USD) - 2021/01/23 22:58:27 ET
Table 'Polydoros II' 6-max Seat #6 is the button
Seat 1: Bunkiebear ($13.30 in chips) 
Seat 4: Black021 ($14.74 in chips) 
Seat 5: Ger Cortes ($10.02 in chips) 
Seat 6: I find you ez ($11.38 in chips) 
Bunkiebear: posts small blind $0.05
Black021: posts big blind $0.10
*** HOLE CARDS ***
Ger Cortes: folds 
I find you ez: raises $0.15 to $0.25
Bunkiebear: folds 
Black021: calls $0.15
*** FLOP *** [Tc 5s Ah]
Black021: checks 
M709199 joins the table at seat #2 
I find you ez: bets $0.25
Black021: folds 
Uncalled bet ($0.25) returned to I find you ez
I find you ez collected $0.53 from pot
I find you ez: doesn't show hand 
*** SUMMARY ***
Total pot $0.55 | Rake $0.02 
Board [Tc 5s Ah]
Seat 1: Bunkiebear (small blind) folded before Flop
Seat 4: Black021 (big blind) folded on the Flop
Seat 5: Ger Cortes folded before Flop (didn't bet)
Seat 6: I find you ez (button) collected ($0.53)



PokerStars Hand #222943477460:  Hold'em No Limit ($0.05/$0.10 USD) - 2021/01/23 22:58:46 ET
Table 'Polydoros II' 6-max Seat #1 is the button
Seat 1: Bunkiebear ($13.25 in chips) 
Seat 4: Black021 ($14.49 in chips) 
Seat 5: Ger Cortes ($10.02 in chips) 
Seat 6: I find you ez ($11.66 in chips) 
Black021: posts small blind $0.05
Ger Cortes: posts big blind $0.10
*** HOLE CARDS ***
I find you ez: folds 
Bunkiebear: folds 
Black021: folds 
Uncalled bet ($0.05) returned to Ger Cortes
Ger Cortes collected $0.10 from pot
*** SUMMARY ***
Total pot $0.10 | Rake $0 
Seat 1: Bunkiebear (button) folded before Flop (didn't bet)
Seat 4: Black021 (small blind) folded before Flop
Seat 5: Ger Cortes (big blind) collected ($0.10)
Seat 6: I find you ez folded before Flop (didn't bet)



PokerStars Hand #222943479777:  Hold'em No Limit ($0.05/$0.10 USD) - 2021/01/23 22:58:55 ET
Table 'Polydoros II' 6-max Seat #4 is the button
Seat 1: Bunkiebear ($13.25 in chips) 
Seat 4: Black021 ($14.44 in chips) 
Seat 5: Ger Cortes ($10.07 in chips) 
Seat 6: I find you ez ($11.66 in chips) 
Ger Cortes: posts small blind $0.05
I find you ez: posts big blind $0.10
*** HOLE CARDS ***
Bunkiebear: calls $0.10
Black021: folds 
Ger Cortes: raises $0.40 to $0.50
I find you ez: folds 
Bunkiebear: calls $0.40
*** FLOP *** [8h Td 4h]
Ger Cortes: checks 
Bunkiebear: bets $0.40
Ger Cortes: calls $0.40
*** TURN *** [8h Td 4h] [Js]
Ger Cortes: checks 
Bunkiebear: bets $0.50
Ger Cortes: calls $0.50
*** RIVER *** [8h Td 4h Js] [Ts]
Ger Cortes: checks 
Bunkiebear: checks 
*** SHOW DOWN ***
Ger Cortes: shows [9c 9d] (two pair, Tens and Nines)
Bunkiebear: mucks hand 
Ger Cortes collected $2.77 from pot
*** SUMMARY ***
Total pot $2.90 | Rake $0.13 
Board [8h Td 4h Js Ts]
Seat 1: Bunkiebear mucked
Seat 4: Black021 (button) folded before Flop (didn't bet)
Seat 5: Ger Cortes (small blind) showed [9c 9d] and won ($2.77) with two pair, Tens and Nines
Seat 6: I find you ez (big blind) folded before Flop



PokerStars Hand #222943489945:  Hold'em No Limit ($0.05/$0.10 USD) - 2021/01/23 22:59:35 ET
Table 'Polydoros II' 6-max Seat #5 is the button
Seat 1: Bunkiebear ($11.85 in chips) 
Seat 4: Black021 ($14.44 in chips) 
Seat 5: Ger Cortes ($11.44 in chips) 
Seat 6: I find you ez ($11.56 in chips) 
I find you ez: posts small blind $0.05
Bunkiebear: posts big blind $0.10
ken_wynn: sits out 
*** HOLE CARDS ***
Black021: folds 
Ger Cortes: folds 
I find you ez: raises $0.30 to $0.40
Bunkiebear: calls $0.30
*** FLOP *** [Ts Jc 2s]
I find you ez: bets $0.45
Bunkiebear: calls $0.45
*** TURN *** [Ts Jc 2s] [Qd]
I find you ez: bets $1.10
Bunkiebear: calls $1.10
*** RIVER *** [Ts Jc 2s Qd] [3h]
I find you ez: bets $2.50
Bunkiebear: folds 
Uncalled bet ($2.50) returned to I find you ez
I find you ez collected $3.72 from pot
I find you ez: doesn't show hand 
*** SUMMARY ***
Total pot $3.90 | Rake $0.18 
Board [Ts Jc 2s Qd 3h]
Seat 1: Bunkiebear (big blind) folded on the River
Seat 4: Black021 folded before Flop (didn't bet)
Seat 5: Ger Cortes (button) folded before Flop (didn't bet)
Seat 6: I find you ez (small blind) collected ($3.72)



PokerStars Hand #222943497740:  Hold'em No Limit ($0.05/$0.10 USD) - 2021/01/23 23:00:05 ET
Table 'Polydoros II' 6-max Seat #6 is the button
Seat 1: Bunkiebear ($9.90 in chips) 
Seat 3: ken_wynn ($7 in chips) 
Seat 4: Black021 ($14.44 in chips) 
Seat 5: Ger Cortes ($11.44 in chips) 
Seat 6: I find you ez ($13.33 in chips) 
Bunkiebear: posts small blind $0.05
ken_wynn: posts big blind $0.10
*** HOLE CARDS ***
Black021: raises $0.17 to $0.27
Ger Cortes: folds 
I find you ez: folds 
Bunkiebear: folds 
ken_wynn: folds 
Uncalled bet ($0.17) returned to Black021
Black021 collected $0.25 from pot
Black021: doesn't show hand 
*** SUMMARY ***
Total pot $0.25 | Rake $0 
Seat 1: Bunkiebear (small blind) folded before Flop
Seat 3: ken_wynn (big blind) folded before Flop
Seat 4: Black021 collected ($0.25)
Seat 5: Ger Cortes folded before Flop (didn't bet)
Seat 6: I find you ez (button) folded before Flop (didn't bet)



PokerStars Hand #222943501267:  Hold'em No Limit ($0.05/$0.10 USD) - 2021/01/23 23:00:17 ET
Table 'Polydoros II' 6-max Seat #1 is the button
Seat 1: Bunkiebear ($9.85 in chips) 
Seat 3: ken_wynn ($6.90 in chips) 
Seat 5: Ger Cortes ($11.44 in chips) 
Seat 6: I find you ez ($13.33 in chips) 
ken_wynn: posts small blind $0.05
Ger Cortes: posts big blind $0.10
*** HOLE CARDS ***
I find you ez: folds 
Bunkiebear: folds 
ken_wynn: folds 
Uncalled bet ($0.05) returned to Ger Cortes
Ger Cortes collected $0.10 from pot
*** SUMMARY ***
Total pot $0.10 | Rake $0 
Seat 1: Bunkiebear (button) folded before Flop (didn't bet)
Seat 3: ken_wynn (small blind) folded before Flop
Seat 5: Ger Cortes (big blind) collected ($0.10)
Seat 6: I find you ez folded before Flop (didn't bet)



PokerStars Hand #222943504263:  Hold'em No Limit ($0.05/$0.10 USD) - 2021/01/23 23:00:27 ET
Table 'Polydoros II' 6-max Seat #3 is the button
Seat 1: Bunkiebear ($9.85 in chips) 
Seat 3: ken_wynn ($6.85 in chips) 
Seat 5: Ger Cortes ($11.49 in chips) 
Seat 6: I find you ez ($13.33 in chips) 
Ger Cortes: posts small blind $0.05
I find you ez: posts big blind $0.10
*** HOLE CARDS ***
Bunkiebear: calls $0.10
ken_wynn: folds 
Ger Cortes: folds 
I find you ez: checks 
*** FLOP *** [7h 9d Th]
I find you ez: bets $0.15
Bunkiebear: raises $0.15 to $0.30
I find you ez: calls $0.15
*** TURN *** [7h 9d Th] [6d]
I find you ez: checks 
Bunkiebear: bets $0.90
I find you ez: folds 
Uncalled bet ($0.90) returned to Bunkiebear
Bunkiebear collected $0.81 from pot
Bunkiebear: doesn't show hand 
*** SUMMARY ***
Total pot $0.85 | Rake $0.04 
Board [7h 9d Th 6d]
Seat 1: Bunkiebear collected ($0.81)
Seat 3: ken_wynn (button) folded before Flop (didn't bet)
Seat 5: Ger Cortes (small blind) folded before Flop
Seat 6: I find you ez (big blind) folded on the Turn



PokerStars Hand #222943526665:  Hold'em No Limit ($0.05/$0.10 USD) - 2021/01/23 23:01:38 ET
Table 'Polydoros II' 6-max Seat #5 is the button
Seat 1: Bunkiebear ($10.26 in chips) 
Seat 3: ken_wynn ($6.85 in chips) 
Seat 5: Ger Cortes ($11.44 in chips) 
Seat 6: I find you ez ($12.93 in chips) 
I find you ez: posts small blind $0.05
Bunkiebear: posts big blind $0.10
*** HOLE CARDS ***
ken_wynn: raises $0.15 to $0.25
Ger Cortes: raises $0.45 to $0.70
I find you ez: folds 
Bunkiebear: folds 
ken_wynn: folds 
Uncalled bet ($0.45) returned to Ger Cortes
Ger Cortes collected $0.65 from pot
*** SUMMARY ***
Total pot $0.65 | Rake $0 
Seat 1: Bunkiebear (big blind) folded before Flop
Seat 3: ken_wynn folded before Flop
Seat 5: Ger Cortes (button) collected ($0.65)
Seat 6: I find you ez (small blind) folded before Flop



PokerStars Hand #222943536343:  Hold'em No Limit ($0.05/$0.10 USD) - 2021/01/23 23:02:08 ET
Table 'Polydoros II' 6-max Seat #6 is the button
Seat 1: Bunkiebear ($10.16 in chips) 
Seat 3: ken_wynn ($6.60 in chips) 
Seat 5: Ger Cortes ($11.84 in chips) 
Seat 6: I find you ez ($12.88 in chips) 
Bunkiebear: posts small blind $0.05
ken_wynn: posts big blind $0.10
*** HOLE CARDS ***
Ger Cortes: folds 
I find you ez: raises $0.15 to $0.25
Bunkiebear: calls $0.20
ken_wynn: raises $0.74 to $0.99
I find you ez: folds 
Bunkiebear: calls $0.74
*** FLOP *** [5c 4d 7c]
Bunkiebear: checks 
ken_wynn: bets $1.07
Bunkiebear: calls $1.07
*** TURN *** [5c 4d 7c] [Kh]
Bunkiebear: checks 
ken_wynn: bets $2.69
Bunkiebear: folds 
Uncalled bet ($2.69) returned to ken_wynn
ken_wynn collected $4.17 from pot
ken_wynn: doesn't show hand 
*** SUMMARY ***
Total pot $4.37 | Rake $0.20 
Board [5c 4d 7c Kh]
Seat 1: Bunkiebear (small blind) folded on the Turn
Seat 3: ken_wynn (big blind) collected ($4.17)
Seat 5: Ger Cortes folded before Flop (didn't bet)
Seat 6: I find you ez (button) folded before Flop



PokerStars Hand #222943552386:  Hold'em No Limit ($0.05/$0.10 USD) - 2021/01/23 23:02:58 ET
Table 'Polydoros II' 6-max Seat #1 is the button
Seat 1: Bunkiebear ($8.10 in chips) 
Seat 3: ken_wynn ($8.71 in chips) 
Seat 4: Black021 ($14.59 in chips) 
Seat 5: Ger Cortes ($11.84 in chips) 
Seat 6: I find you ez ($12.63 in chips) 
ken_wynn: posts small blind $0.05
Black021: posts big blind $0.10
*** HOLE CARDS ***
Ger Cortes: folds 
I find you ez: raises $0.20 to $0.30
Bunkiebear: folds 
ken_wynn: folds 
Black021: folds 
Uncalled bet ($0.20) returned to I find you ez
I find you ez collected $0.25 from pot
I find you ez: doesn't show hand 
*** SUMMARY ***
Total pot $0.25 | Rake $0 
Seat 1: Bunkiebear (button) folded before Flop (didn't bet)
Seat 3: ken_wynn (small blind) folded before Flop
Seat 4: Black021 (big blind) folded before Flop
Seat 5: Ger Cortes folded before Flop (didn't bet)
Seat 6: I find you ez collected ($0.25)



PokerStars Hand #222943556322:  Hold'em No Limit ($0.05/$0.10 USD) - 2021/01/23 23:03:10 ET
Table 'Polydoros II' 6-max Seat #3 is the button
Seat 1: Bunkiebear ($8.10 in chips) 
Seat 3: ken_wynn ($8.66 in chips) 
Seat 4: Black021 ($14.49 in chips) 
Seat 5: Ger Cortes ($11.84 in chips) 
Seat 6: I find you ez ($12.78 in chips) 
Black021: posts small blind $0.05
Ger Cortes: posts big blind $0.10
*** HOLE CARDS ***
I find you ez: folds 
Bunkiebear: folds 
ken_wynn: folds 
Black021: raises $0.17 to $0.27
Ger Cortes: folds 
Uncalled bet ($0.17) returned to Black021
Black021 collected $0.20 from pot
Black021: doesn't show hand 
*** SUMMARY ***
Total pot $0.20 | Rake $0 
Seat 1: Bunkiebear folded before Flop (didn't bet)
Seat 3: ken_wynn (button) folded before Flop (didn't bet)
Seat 4: Black021 (small blind) collected ($0.20)
Seat 5: Ger Cortes (big blind) folded before Flop
Seat 6: I find you ez folded before Flop (didn't bet)



PokerStars Hand #222943561051:  Hold'em No Limit ($0.05/$0.10 USD) - 2021/01/23 23:03:25 ET
Table 'Polydoros II' 6-max Seat #4 is the button
Seat 1: Bunkiebear ($8.10 in chips) 
Seat 3: ken_wynn ($8.66 in chips) 
Seat 4: Black021 ($14.59 in chips) 
Seat 5: Ger Cortes ($11.74 in chips) 
Seat 6: I find you ez ($12.78 in chips) 
Ger Cortes: posts small blind $0.05
I find you ez: posts big blind $0.10
*** HOLE CARDS ***
Bunkiebear: folds 
ken_wynn: folds 
Black021: raises $0.12 to $0.22
Ger Cortes: raises $0.78 to $1
I find you ez: folds 
Black021: raises $1.35 to $2.35
Ger Cortes: calls $1.35
*** FLOP *** [4c Kd 6s]
Ger Cortes: checks 
Black021: checks 
*** TURN *** [4c Kd 6s] [5h]
Ger Cortes: checks 
Black021: bets $1.51
Ger Cortes: folds 
Uncalled bet ($1.51) returned to Black021
Black021 collected $4.58 from pot
Black021: doesn't show hand 
*** SUMMARY ***
Total pot $4.80 | Rake $0.22 
Board [4c Kd 6s 5h]
Seat 1: Bunkiebear folded before Flop (didn't bet)
Seat 3: ken_wynn folded before Flop (didn't bet)
Seat 4: Black021 (button) collected ($4.58)
Seat 5: Ger Cortes (small blind) folded on the Turn
Seat 6: I find you ez (big blind) folded before Flop



PokerStars Hand #222943582910:  Hold'em No Limit ($0.05/$0.10 USD) - 2021/01/23 23:04:32 ET
Table 'Polydoros II' 6-max Seat #5 is the button
Seat 1: Bunkiebear ($8.10 in chips) 
Seat 3: ken_wynn ($8.66 in chips) 
Seat 4: Black021 ($16.82 in chips) 
Seat 5: Ger Cortes ($10 in chips) 
Seat 6: I find you ez ($12.68 in chips) 
I find you ez: posts small blind $0.05
Bunkiebear: posts big blind $0.10
*** HOLE CARDS ***
ken_wynn: folds 
Black021: raises $0.15 to $0.25
Ger Cortes: folds 
I find you ez: folds 
Bunkiebear: folds 
Uncalled bet ($0.15) returned to Black021
Black021 collected $0.25 from pot
Black021: doesn't show hand 
*** SUMMARY ***
Total pot $0.25 | Rake $0 
Seat 1: Bunkiebear (big blind) folded before Flop
Seat 3: ken_wynn folded before Flop (didn't bet)
Seat 4: Black021 collected ($0.25)
Seat 5: Ger Cortes (button) folded before Flop (didn't bet)
Seat 6: I find you ez (small blind) folded before Flop



PokerStars Hand #222943588834:  Hold'em No Limit ($0.05/$0.10 USD) - 2021/01/23 23:04:50 ET
Table 'Polydoros II' 6-max Seat #6 is the button
Seat 1: Bunkiebear ($8 in chips) 
Seat 3: ken_wynn ($8.66 in chips) 
Seat 4: Black021 ($16.97 in chips) 
Seat 5: Ger Cortes ($10 in chips) 
Seat 6: I find you ez ($12.63 in chips) 
Bunkiebear: posts small blind $0.05
ken_wynn: posts big blind $0.10
*** HOLE CARDS ***
Black021: folds 
Ger Cortes: raises $0.15 to $0.25
I find you ez: folds 
Bunkiebear: folds 
ken_wynn: folds 
Uncalled bet ($0.15) returned to Ger Cortes
Ger Cortes collected $0.25 from pot
M709199 was removed from the table for failing to post
M709199 leaves the table
*** SUMMARY ***
Total pot $0.25 | Rake $0 
Seat 1: Bunkiebear (small blind) folded before Flop
Seat 3: ken_wynn (big blind) folded before Flop
Seat 4: Black021 folded before Flop (didn't bet)
Seat 5: Ger Cortes collected ($0.25)
Seat 6: I find you ez (button) folded before Flop (didn't bet)



PokerStars Hand #222943592946:  Hold'em No Limit ($0.05/$0.10 USD) - 2021/01/23 23:05:03 ET
Table 'Polydoros II' 6-max Seat #1 is the button
Seat 1: Bunkiebear ($7.95 in chips) 
Seat 3: ken_wynn ($8.56 in chips) 
Seat 4: Black021 ($16.97 in chips) 
Seat 5: Ger Cortes ($10.15 in chips) 
Seat 6: I find you ez ($12.63 in chips) 
ken_wynn: posts small blind $0.05
Black021: posts big blind $0.10
*** HOLE CARDS ***
Ger Cortes: folds 
I find you ez: raises $0.20 to $0.30
Bunkiebear: calls $0.30
ken_wynn: folds 
Black021: folds 
*** FLOP *** [Td 5h Qc]
EZEQUIEL.C10 joins the table at seat #2 
I find you ez: bets $0.35
Bunkiebear: calls $0.35
*** TURN *** [Td 5h Qc] [7h]
I find you ez: bets $0.90
Bunkiebear: calls $0.90
*** RIVER *** [Td 5h Qc 7h] [Ac]
I find you ez: checks 
Bunkiebear: checks 
*** SHOW DOWN ***
I find you ez: shows [Ks Kd] (a pair of Kings)
Bunkiebear: mucks hand 
I find you ez collected $3.10 from pot
*** SUMMARY ***
Total pot $3.25 | Rake $0.15 
Board [Td 5h Qc 7h Ac]
Seat 1: Bunkiebear (button) mucked
Seat 3: ken_wynn (small blind) folded before Flop
Seat 4: Black021 (big blind) folded before Flop
Seat 5: Ger Cortes folded before Flop (didn't bet)
Seat 6: I find you ez showed [Ks Kd] and won ($3.10) with a pair of Kings



PokerStars Hand #222943606214:  Hold'em No Limit ($0.05/$0.10 USD) - 2021/01/23 23:05:34 ET
Table 'Polydoros II' 6-max Seat #3 is the button
Seat 1: Bunkiebear ($6.40 in chips) 
Seat 3: ken_wynn ($8.51 in chips) 
Seat 4: Black021 ($16.87 in chips) 
Seat 5: Ger Cortes ($10.15 in chips) 
Seat 6: I find you ez ($14.18 in chips) 
Black021: posts small blind $0.05
Ger Cortes: posts big blind $0.10
EZEQUIEL.C10: sits out 
*** HOLE CARDS ***
I find you ez: raises $0.30 to $0.40
Bunkiebear: folds 
ken_wynn: raises $0.40 to $0.80
Black021: folds 
Ger Cortes: folds 
I find you ez: calls $0.40
*** FLOP *** [Jh Js 3c]
I find you ez: checks 
ken_wynn: bets $0.84
I find you ez: calls $0.84
*** TURN *** [Jh Js 3c] [9c]
I find you ez: checks 
ken_wynn: bets $1.64
I find you ez: raises $10.90 to $12.54 and is all-in
ken_wynn: calls $5.23 and is all-in
Uncalled bet ($5.67) returned to I find you ez
*** RIVER *** [Jh Js 3c 9c] [Ah]
*** SHOW DOWN ***
I find you ez: shows [Ks Jd] (three of a kind, Jacks)
ken_wynn: shows [As Ad] (a full house, Aces full of Jacks)
ken_wynn collected $16.40 from pot
*** SUMMARY ***
Total pot $17.17 | Rake $0.77 
Board [Jh Js 3c 9c Ah]
Seat 1: Bunkiebear folded before Flop (didn't bet)
Seat 3: ken_wynn (button) showed [As Ad] and won ($16.40) with a full house, Aces full of Jacks
Seat 4: Black021 (small blind) folded before Flop
Seat 5: Ger Cortes (big blind) folded before Flop
Seat 6: I find you ez showed [Ks Jd] and lost with three of a kind, Jacks



PokerStars Hand #222943625381:  Hold'em No Limit ($0.05/$0.10 USD) - 2021/01/23 23:06:34 ET
Table 'Polydoros II' 6-max Seat #4 is the button
Seat 1: Bunkiebear ($6.40 in chips) 
Seat 3: ken_wynn ($16.40 in chips) 
Seat 4: Black021 ($16.82 in chips) 
Seat 5: Ger Cortes ($10.05 in chips) 
Ger Cortes: posts small blind $0.05
I find you ez: is sitting out 
Bunkiebear: posts big blind $0.10
EZEQUIEL.C10: sits out 
*** HOLE CARDS ***
I find you ez leaves the table
ken_wynn: folds 
Black021: folds 
Ger Cortes: raises $0.20 to $0.30
Bunkiebear: calls $0.20
*** FLOP *** [2h 4c 9h]
Ger Cortes: bets $0.31
Bunkiebear: calls $0.31
*** TURN *** [2h 4c 9h] [3c]
Ger Cortes: bets $0.70
Bunkiebear: calls $0.70
*** RIVER *** [2h 4c 9h 3c] [Tc]
Ger Cortes: bets $0.83
Bunkiebear: calls $0.83
*** SHOW DOWN ***
Ger Cortes: shows [9s Qc] (a pair of Nines)
Bunkiebear: mucks hand 
Ger Cortes collected $4.09 from pot
*** SUMMARY ***
Total pot $4.28 | Rake $0.19 
Board [2h 4c 9h 3c Tc]
Seat 1: Bunkiebear (big blind) mucked
Seat 3: ken_wynn folded before Flop (didn't bet)
Seat 4: Black021 (button) folded before Flop (didn't bet)
Seat 5: Ger Cortes (small blind) showed [9s Qc] and won ($4.09) with a pair of Nines



PokerStars Hand #222943637077:  Hold'em No Limit ($0.05/$0.10 USD) - 2021/01/23 23:07:10 ET
Table 'Polydoros II' 6-max Seat #5 is the button
Seat 1: Bunkiebear ($4.26 in chips) 
Seat 2: EZEQUIEL.C10 ($8 in chips) 
Seat 3: ken_wynn ($16.40 in chips) 
Seat 4: Black021 ($16.82 in chips) 
Seat 5: Ger Cortes ($12 in chips) 
Bunkiebear: posts small blind $0.05
EZEQUIEL.C10: posts big blind $0.10
*** HOLE CARDS ***
ken_wynn: folds 
Black021: folds 
Ger Cortes: folds 
Bunkiebear: calls $0.05
EZEQUIEL.C10: raises $0.30 to $0.40
Bunkiebear: folds 
Uncalled bet ($0.30) returned to EZEQUIEL.C10
EZEQUIEL.C10 collected $0.20 from pot
EZEQUIEL.C10: doesn't show hand 
*** SUMMARY ***
Total pot $0.20 | Rake $0 
Seat 1: Bunkiebear (small blind) folded before Flop
Seat 2: EZEQUIEL.C10 (big blind) collected ($0.20)
Seat 3: ken_wynn folded before Flop (didn't bet)
Seat 4: Black021 folded before Flop (didn't bet)
Seat 5: Ger Cortes (button) folded before Flop (didn't bet)



PokerStars Hand #222943643410:  Hold'em No Limit ($0.05/$0.10 USD) - 2021/01/23 23:07:30 ET
Table 'Polydoros II' 6-max Seat #1 is the button
Seat 1: Bunkiebear ($4.16 in chips) 
Seat 2: EZEQUIEL.C10 ($8.10 in chips) 
Seat 3: ken_wynn ($16.40 in chips) 
Seat 4: Black021 ($16.82 in chips) 
Seat 5: Ger Cortes ($12 in chips) 
EZEQUIEL.C10: posts small blind $0.05
ken_wynn: posts big blind $0.10
*** HOLE CARDS ***
Black021: folds 
Ger Cortes: folds 
Bunkiebear: calls $0.10
EZEQUIEL.C10: folds 
ken_wynn: checks 
*** FLOP *** [8d Td 8s]
ken_wynn: bets $0.12
benjieshah15 joins the table at seat #6 
Bunkiebear: raises $0.12 to $0.24
ken_wynn: calls $0.12
*** TURN *** [8d Td 8s] [9d]
ken_wynn: checks 
Bunkiebear: bets $0.20
ken_wynn: calls $0.20
*** RIVER *** [8d Td 8s 9d] [3s]
ken_wynn: checks 
Bunkiebear: bets $0.50
ken_wynn: folds 
Uncalled bet ($0.50) returned to Bunkiebear
Bunkiebear collected $1.08 from pot
Bunkiebear: doesn't show hand 
*** SUMMARY ***
Total pot $1.13 | Rake $0.05 
Board [8d Td 8s 9d 3s]
Seat 1: Bunkiebear (button) collected ($1.08)
Seat 2: EZEQUIEL.C10 (small blind) folded before Flop
Seat 3: ken_wynn (big blind) folded on the River
Seat 4: Black021 folded before Flop (didn't bet)
Seat 5: Ger Cortes folded before Flop (didn't bet)



PokerStars Hand #222943668665:  Hold'em No Limit ($0.05/$0.10 USD) - 2021/01/23 23:08:48 ET
Table 'Polydoros II' 6-max Seat #2 is the button
Seat 1: Bunkiebear ($4.70 in chips) 
Seat 2: EZEQUIEL.C10 ($8.05 in chips) 
Seat 3: ken_wynn ($15.86 in chips) 
Seat 4: Black021 ($16.82 in chips) 
Seat 5: Ger Cortes ($12 in chips) 
ken_wynn: posts small blind $0.05
Black021: posts big blind $0.10
benjieshah15: sits out 
*** HOLE CARDS ***
benjieshah15 leaves the table
Ger Cortes: raises $0.15 to $0.25
Bunkiebear: folds 
EZEQUIEL.C10: folds 
ken_wynn: calls $0.20
Bobok1971 joins the table at seat #6 
Black021: folds 
*** FLOP *** [9h 8d 4d]
ken_wynn: checks 
Ger Cortes: checks 
*** TURN *** [9h 8d 4d] [Qd]
ken_wynn: bets $0.29
Ger Cortes: calls $0.29
*** RIVER *** [9h 8d 4d Qd] [Ad]
ken_wynn: bets $0.57
Ger Cortes: calls $0.57
*** SHOW DOWN ***
ken_wynn: shows [9s 9c] (three of a kind, Nines)
Ger Cortes: shows [7d 7c] (a flush, Ace high)
Ger Cortes collected $2.22 from pot
*** SUMMARY ***
Total pot $2.32 | Rake $0.10 
Board [9h 8d 4d Qd Ad]
Seat 1: Bunkiebear folded before Flop (didn't bet)
Seat 2: EZEQUIEL.C10 (button) folded before Flop (didn't bet)
Seat 3: ken_wynn (small blind) showed [9s 9c] and lost with three of a kind, Nines
Seat 4: Black021 (big blind) folded before Flop
Seat 5: Ger Cortes showed [7d 7c] and won ($2.22) with a flush, Ace high



PokerStars Hand #222943688391:  Hold'em No Limit ($0.05/$0.10 USD) - 2021/01/23 23:09:49 ET
Table 'Polydoros II' 6-max Seat #3 is the button
Seat 1: Bunkiebear ($4.70 in chips) 
Seat 2: EZEQUIEL.C10 ($8.05 in chips) 
Seat 3: ken_wynn ($14.75 in chips) 
Seat 4: Black021 ($16.72 in chips) 
Seat 5: Ger Cortes ($13.11 in chips) 
Seat 6: Bobok1971 ($8 in chips) 
Black021: posts small blind $0.05
Ger Cortes: posts big blind $0.10
Bobok1971: posts big blind $0.10
*** HOLE CARDS ***
Bobok1971: checks 
Bunkiebear: folds 
EZEQUIEL.C10: folds 
ken_wynn: folds 
Black021: raises $0.30 to $0.40
Ger Cortes: folds 
Bobok1971: folds 
Uncalled bet ($0.30) returned to Black021
Black021 collected $0.30 from pot
Black021: doesn't show hand 
*** SUMMARY ***
Total pot $0.30 | Rake $0 
Seat 1: Bunkiebear folded before Flop (didn't bet)
Seat 2: EZEQUIEL.C10 folded before Flop (didn't bet)
Seat 3: ken_wynn (button) folded before Flop (didn't bet)
Seat 4: Black021 (small blind) collected ($0.30)
Seat 5: Ger Cortes (big blind) folded before Flop
Seat 6: Bobok1971 folded before Flop (didn't bet)



PokerStars Hand #222943696522:  Hold'em No Limit ($0.05/$0.10 USD) - 2021/01/23 23:10:15 ET
Table 'Polydoros II' 6-max Seat #4 is the button
Seat 1: Bunkiebear ($4.70 in chips) 
Seat 2: EZEQUIEL.C10 ($8.05 in chips) 
Seat 3: ken_wynn ($14.75 in chips) 
Seat 4: Black021 ($16.92 in chips) 
Seat 5: Ger Cortes ($13.01 in chips) 
Seat 6: Bobok1971 ($7.90 in chips) 
Ger Cortes: posts small blind $0.05
Bobok1971: posts big blind $0.10
*** HOLE CARDS ***
Bunkiebear: calls $0.10
EZEQUIEL.C10: folds 
ken_wynn: folds 
Black021: folds 
Ger Cortes: calls $0.05
Bobok1971: checks 
*** FLOP *** [4c 4h Qh]
Ger Cortes: checks 
Bobok1971: checks 
Bunkiebear: bets $0.20
Ger Cortes: calls $0.20
Bobok1971: calls $0.20
*** TURN *** [4c 4h Qh] [8s]
Ger Cortes: checks 
Bobok1971: checks 
Bunkiebear: bets $0.60
Ger Cortes: calls $0.60
Bobok1971: raises $0.60 to $1.20
Bunkiebear: calls $0.60
Ger Cortes: folds 
*** RIVER *** [4c 4h Qh 8s] [9h]
Bobok1971: checks 
Bunkiebear: checks 
*** SHOW DOWN ***
Bobok1971: shows [4s Ad] (three of a kind, Fours)
Bunkiebear: mucks hand 
Bobok1971 collected $3.72 from pot
*** SUMMARY ***
Total pot $3.90 | Rake $0.18 
Board [4c 4h Qh 8s 9h]
Seat 1: Bunkiebear mucked
Seat 2: EZEQUIEL.C10 folded before Flop (didn't bet)
Seat 3: ken_wynn folded before Flop (didn't bet)
Seat 4: Black021 (button) folded before Flop (didn't bet)
Seat 5: Ger Cortes (small blind) folded on the Turn
Seat 6: Bobok1971 (big blind) showed [4s Ad] and won ($3.72) with three of a kind, Fours



PokerStars Hand #222943724493:  Hold'em No Limit ($0.05/$0.10 USD) - 2021/01/23 23:11:39 ET
Table 'Polydoros II' 6-max Seat #5 is the button
Seat 1: Bunkiebear ($3.20 in chips) 
Seat 2: EZEQUIEL.C10 ($8.05 in chips) 
Seat 3: ken_wynn ($14.75 in chips) 
Seat 4: Black021 ($16.92 in chips) 
Seat 5: Ger Cortes ($12.11 in chips) 
Seat 6: Bobok1971 ($10.12 in chips) 
Bobok1971: posts small blind $0.05
Bunkiebear: posts big blind $0.10
*** HOLE CARDS ***
EZEQUIEL.C10: folds 
ken_wynn: folds 
Black021: raises $0.15 to $0.25
Ger Cortes: folds 
Bobok1971: calls $0.20
Bunkiebear: calls $0.15
*** FLOP *** [7c 8h 5s]
Bobok1971: checks 
Bunkiebear: checks 
Black021: checks 
*** TURN *** [7c 8h 5s] [Qh]
Bobok1971: bets $0.72
Bunkiebear: calls $0.72
Black021: folds 
*** RIVER *** [7c 8h 5s Qh] [8d]
Bobok1971: checks 
Bunkiebear: checks 
*** SHOW DOWN ***
Bobok1971: shows [Kd Qc] (two pair, Queens and Eights)
Bunkiebear: mucks hand 
Bobok1971 collected $2.09 from pot
*** SUMMARY ***
Total pot $2.19 | Rake $0.10 
Board [7c 8h 5s Qh 8d]
Seat 1: Bunkiebear (big blind) mucked
Seat 2: EZEQUIEL.C10 folded before Flop (didn't bet)
Seat 3: ken_wynn folded before Flop (didn't bet)
Seat 4: Black021 folded on the Turn
Seat 5: Ger Cortes (button) folded before Flop (didn't bet)
Seat 6: Bobok1971 (small blind) showed [Kd Qc] and won ($2.09) with two pair, Queens and Eights



PokerStars Hand #222943741522:  Hold'em No Limit ($0.05/$0.10 USD) - 2021/01/23 23:12:20 ET
Table 'Polydoros II' 6-max Seat #6 is the button
Seat 1: Bunkiebear ($2.23 in chips) 
Seat 2: EZEQUIEL.C10 ($8.05 in chips) 
Seat 3: ken_wynn ($14.75 in chips) 
Seat 4: Black021 ($16.67 in chips) 
Seat 5: Ger Cortes ($12.11 in chips) 
Seat 6: Bobok1971 ($11.24 in chips) 
Bunkiebear: posts small blind $0.05
EZEQUIEL.C10: posts big blind $0.10
*** HOLE CARDS ***
ken_wynn: folds 
Black021: folds 
Ger Cortes: folds 
Bobok1971: folds 
Bunkiebear: calls $0.05
EZEQUIEL.C10: checks 
*** FLOP *** [2h Qh 9d]
Bunkiebear: checks 
EZEQUIEL.C10: checks 
*** TURN *** [2h Qh 9d] [8c]
Bunkiebear: checks 
EZEQUIEL.C10: checks 
*** RIVER *** [2h Qh 9d 8c] [2s]
Bunkiebear: checks 
EZEQUIEL.C10: checks 
*** SHOW DOWN ***
Bunkiebear: shows [4h Kh] (a pair of Deuces)
EZEQUIEL.C10: shows [6c 6h] (two pair, Sixes and Deuces)
EZEQUIEL.C10 collected $0.19 from pot
*** SUMMARY ***
Total pot $0.20 | Rake $0.01 
Board [2h Qh 9d 8c 2s]
Seat 1: Bunkiebear (small blind) showed [4h Kh] and lost with a pair of Deuces
Seat 2: EZEQUIEL.C10 (big blind) showed [6c 6h] and won ($0.19) with two pair, Sixes and Deuces
Seat 3: ken_wynn folded before Flop (didn't bet)
Seat 4: Black021 folded before Flop (didn't bet)
Seat 5: Ger Cortes folded before Flop (didn't bet)
Seat 6: Bobok1971 (button) folded before Flop (didn't bet)



PokerStars Hand #222943757092:  Hold'em No Limit ($0.05/$0.10 USD) - 2021/01/23 23:13:09 ET
Table 'Polydoros II' 6-max Seat #1 is the button
Seat 1: Bunkiebear ($2.13 in chips) 
Seat 2: EZEQUIEL.C10 ($8.14 in chips) 
Seat 3: ken_wynn ($14.75 in chips) 
Seat 4: Black021 ($16.67 in chips) 
Seat 5: Ger Cortes ($12.11 in chips) 
Seat 6: Bobok1971 ($11.24 in chips) 
EZEQUIEL.C10: posts small blind $0.05
ken_wynn: posts big blind $0.10
*** HOLE CARDS ***
Black021: folds 
Ger Cortes: folds 
Bobok1971: raises $0.25 to $0.35
Bunkiebear: folds 
EZEQUIEL.C10: folds 
ken_wynn: folds 
Uncalled bet ($0.25) returned to Bobok1971
Bobok1971 collected $0.25 from pot
Bobok1971: doesn't show hand 
*** SUMMARY ***
Total pot $0.25 | Rake $0 
Seat 1: Bunkiebear (button) folded before Flop (didn't bet)
Seat 2: EZEQUIEL.C10 (small blind) folded before Flop
Seat 3: ken_wynn (big blind) folded before Flop
Seat 4: Black021 folded before Flop (didn't bet)
Seat 5: Ger Cortes folded before Flop (didn't bet)
Seat 6: Bobok1971 collected ($0.25)



PokerStars Hand #222943764003:  Hold'em No Limit ($0.05/$0.10 USD) - 2021/01/23 23:13:30 ET
Table 'Polydoros II' 6-max Seat #2 is the button
Seat 1: Bunkiebear ($2.13 in chips) 
Seat 2: EZEQUIEL.C10 ($8.09 in chips) 
Seat 3: ken_wynn ($14.65 in chips) 
Seat 4: Black021 ($16.67 in chips) 
Seat 5: Ger Cortes ($12.11 in chips) 
Seat 6: Bobok1971 ($11.39 in chips) 
ken_wynn: posts small blind $0.05
Black021: posts big blind $0.10
*** HOLE CARDS ***
Ger Cortes: folds 
Bobok1971: folds 
Bunkiebear: calls $0.10
EZEQUIEL.C10: folds 
ken_wynn: folds 
Black021: raises $0.30 to $0.40
Bunkiebear: calls $0.30
*** FLOP *** [3d Ac 2h]
Black021: bets $0.27
Bunkiebear: calls $0.27
*** TURN *** [3d Ac 2h] [4c]
Black021: bets $16 and is all-in
Bunkiebear: calls $1.46 and is all-in
Uncalled bet ($14.54) returned to Black021
*** RIVER *** [3d Ac 2h 4c] [5c]
*** SHOW DOWN ***
Black021: shows [Ad As] (a straight, Ace to Five)
Bunkiebear: shows [Qs 5s] (a straight, Ace to Five)
Black021 collected $2.06 from pot
Bunkiebear collected $2.06 from pot
*** SUMMARY ***
Total pot $4.31 | Rake $0.19 
Board [3d Ac 2h 4c 5c]
Seat 1: Bunkiebear showed [Qs 5s] and won ($2.06) with a straight, Ace to Five
Seat 2: EZEQUIEL.C10 (button) folded before Flop (didn't bet)
Seat 3: ken_wynn (small blind) folded before Flop
Seat 4: Black021 (big blind) showed [Ad As] and won ($2.06) with a straight, Ace to Five
Seat 5: Ger Cortes folded before Flop (didn't bet)
Seat 6: Bobok1971 folded before Flop (didn't bet)



PokerStars Hand #222943776691:  Hold'em No Limit ($0.05/$0.10 USD) - 2021/01/23 23:14:10 ET
Table 'Polydoros II' 6-max Seat #3 is the button
Seat 1: Bunkiebear ($2.06 in chips) 
Seat 2: EZEQUIEL.C10 ($8.09 in chips) 
Seat 3: ken_wynn ($14.60 in chips) 
Seat 4: Black021 ($16.60 in chips) 
Seat 5: Ger Cortes ($12.11 in chips) 
Seat 6: Bobok1971 ($11.39 in chips) 
Black021: posts small blind $0.05
Ger Cortes: posts big blind $0.10
*** HOLE CARDS ***
Bobok1971 has timed out
Bobok1971: folds 
Bunkiebear: folds 
EZEQUIEL.C10: folds 
ken_wynn: folds 
Black021: folds 
Uncalled bet ($0.05) returned to Ger Cortes
Ger Cortes collected $0.10 from pot
*** SUMMARY ***
Total pot $0.10 | Rake $0 
Seat 1: Bunkiebear folded before Flop (didn't bet)
Seat 2: EZEQUIEL.C10 folded before Flop (didn't bet)
Seat 3: ken_wynn (button) folded before Flop (didn't bet)
Seat 4: Black021 (small blind) folded before Flop
Seat 5: Ger Cortes (big blind) collected ($0.10)
Seat 6: Bobok1971 folded before Flop (didn't bet)



PokerStars Hand #222943783057:  Hold'em No Limit ($0.05/$0.10 USD) - 2021/01/23 23:14:30 ET
Table 'Polydoros II' 6-max Seat #4 is the button
Seat 1: Bunkiebear ($2.06 in chips) 
Seat 2: EZEQUIEL.C10 ($8.09 in chips) 
Seat 3: ken_wynn ($14.60 in chips) 
Seat 4: Black021 ($16.55 in chips) 
Seat 5: Ger Cortes ($12.16 in chips) 
Seat 6: Bobok1971 ($11.39 in chips) 
Ger Cortes: posts small blind $0.05
Bobok1971: posts big blind $0.10
*** HOLE CARDS ***
Bunkiebear: folds 
EZEQUIEL.C10: folds 
ken_wynn: raises $0.15 to $0.25
Black021: raises $0.55 to $0.80
Ger Cortes: folds 
Bobok1971: folds 
ken_wynn: folds 
Uncalled bet ($0.55) returned to Black021
Black021 collected $0.65 from pot
Black021: doesn't show hand 
*** SUMMARY ***
Total pot $0.65 | Rake $0 
Seat 1: Bunkiebear folded before Flop (didn't bet)
Seat 2: EZEQUIEL.C10 folded before Flop (didn't bet)
Seat 3: ken_wynn folded before Flop
Seat 4: Black021 (button) collected ($0.65)
Seat 5: Ger Cortes (small blind) folded before Flop
Seat 6: Bobok1971 (big blind) folded before Flop



PokerStars Hand #222943790794:  Hold'em No Limit ($0.05/$0.10 USD) - 2021/01/23 23:14:54 ET
Table 'Polydoros II' 6-max Seat #5 is the button
Seat 1: Bunkiebear ($2.06 in chips) 
Seat 2: EZEQUIEL.C10 ($8.09 in chips) 
Seat 3: ken_wynn ($14.35 in chips) 
Seat 4: Black021 ($16.95 in chips) 
Seat 5: Ger Cortes ($12.11 in chips) 
Seat 6: Bobok1971 ($11.29 in chips) 
Bobok1971: posts small blind $0.05
Bunkiebear: posts big blind $0.10
*** HOLE CARDS ***
EZEQUIEL.C10: folds 
ken_wynn: raises $0.15 to $0.25
Black021: folds 
Ger Cortes: folds 
Bobok1971: folds 
Bunkiebear: calls $0.15
*** FLOP *** [6s 8d Td]
Bunkiebear: checks 
ken_wynn: bets $0.27
Bunkiebear: folds 
Uncalled bet ($0.27) returned to ken_wynn
ken_wynn collected $0.53 from pot
ken_wynn: doesn't show hand 
*** SUMMARY ***
Total pot $0.55 | Rake $0.02 
Board [6s 8d Td]
Seat 1: Bunkiebear (big blind) folded on the Flop
Seat 2: EZEQUIEL.C10 folded before Flop (didn't bet)
Seat 3: ken_wynn collected ($0.53)
Seat 4: Black021 folded before Flop (didn't bet)
Seat 5: Ger Cortes (button) folded before Flop (didn't bet)
Seat 6: Bobok1971 (small blind) folded before Flop



PokerStars Hand #222943800180:  Hold'em No Limit ($0.05/$0.10 USD) - 2021/01/23 23:15:23 ET
Table 'Polydoros II' 6-max Seat #6 is the button
Seat 1: Bunkiebear ($1.81 in chips) 
Seat 2: EZEQUIEL.C10 ($8.09 in chips) 
Seat 3: ken_wynn ($14.63 in chips) 
Seat 4: Black021 ($16.95 in chips) 
Seat 5: Ger Cortes ($12.11 in chips) 
Seat 6: Bobok1971 ($11.24 in chips) 
Bunkiebear: posts small blind $0.05
EZEQUIEL.C10: posts big blind $0.10
*** HOLE CARDS ***
ken_wynn: folds 
Black021: folds 
Ger Cortes: raises $0.15 to $0.25
ken_wynn leaves the table
whtocean joins the table at seat #3 
Bobok1971 is disconnected 
Bobok1971 has timed out while disconnected
Bobok1971: folds 
Bunkiebear: calls $0.20
EZEQUIEL.C10: folds 
*** FLOP *** [2s 9c 2h]
Bunkiebear: checks 
Ger Cortes: bets $0.19
Bunkiebear: raises $0.19 to $0.38
Ger Cortes: calls $0.19
*** TURN *** [2s 9c 2h] [Kh]
Bunkiebear: bets $1.18 and is all-in
Ger Cortes: folds 
Uncalled bet ($1.18) returned to Bunkiebear
Bunkiebear collected $1.30 from pot
Bunkiebear: doesn't show hand 
*** SUMMARY ***
Total pot $1.36 | Rake $0.06 
Board [2s 9c 2h Kh]
Seat 1: Bunkiebear (small blind) collected ($1.30)
Seat 2: EZEQUIEL.C10 (big blind) folded before Flop
Seat 3: ken_wynn folded before Flop (didn't bet)
Seat 4: Black021 folded before Flop (didn't bet)
Seat 5: Ger Cortes folded on the Turn
Seat 6: Bobok1971 (button) folded before Flop (didn't bet)



PokerStars Hand #222943818502:  Hold'em No Limit ($0.05/$0.10 USD) - 2021/01/23 23:16:20 ET
Table 'Polydoros II' 6-max Seat #1 is the button
Seat 1: Bunkiebear ($2.48 in chips) 
Seat 2: EZEQUIEL.C10 ($7.99 in chips) 
Seat 3: whtocean ($10 in chips) 
Seat 4: Black021 ($16.95 in chips) 
Seat 5: Ger Cortes ($11.48 in chips) 
EZEQUIEL.C10: posts small blind $0.05
whtocean: posts big blind $0.10
*** HOLE CARDS ***
Black021: folds 
Ger Cortes: raises $0.15 to $0.25
Bunkiebear: folds 
EZEQUIEL.C10: folds 
whtocean: folds 
Uncalled bet ($0.15) returned to Ger Cortes
Ger Cortes collected $0.25 from pot
*** SUMMARY ***
Total pot $0.25 | Rake $0 
Seat 1: Bunkiebear (button) folded before Flop (didn't bet)
Seat 2: EZEQUIEL.C10 (small blind) folded before Flop
Seat 3: whtocean (big blind) folded before Flop
Seat 4: Black021 folded before Flop (didn't bet)
Seat 5: Ger Cortes collected ($0.25)



PokerStars Hand #222943824428:  Hold'em No Limit ($0.05/$0.10 USD) - 2021/01/23 23:16:38 ET
Table 'Polydoros II' 6-max Seat #2 is the button
Seat 1: Bunkiebear ($2.48 in chips) 
Seat 2: EZEQUIEL.C10 ($7.94 in chips) 
Seat 3: whtocean ($10 in chips) 
Seat 4: Black021 ($16.95 in chips) 
Seat 5: Ger Cortes ($11.63 in chips) 
whtocean: posts small blind $0.05
Black021: posts big blind $0.10
*** HOLE CARDS ***
Ger Cortes: folds 
Bunkiebear: folds 
EZEQUIEL.C10: raises $0.10 to $0.20
whtocean: folds 
Black021: calls $0.10
*** FLOP *** [2s 3c 3h]
Black021: checks 
EZEQUIEL.C10: checks 
*** TURN *** [2s 3c 3h] [4d]
Black021: checks 
EZEQUIEL.C10: checks 
*** RIVER *** [2s 3c 3h 4d] [Jh]
Black021: checks 
EZEQUIEL.C10: bets $0.20
Black021: folds 
Uncalled bet ($0.20) returned to EZEQUIEL.C10
EZEQUIEL.C10 collected $0.43 from pot
EZEQUIEL.C10: doesn't show hand 
*** SUMMARY ***
Total pot $0.45 | Rake $0.02 
Board [2s 3c 3h 4d Jh]
Seat 1: Bunkiebear folded before Flop (didn't bet)
Seat 2: EZEQUIEL.C10 (button) collected ($0.43)
Seat 3: whtocean (small blind) folded before Flop
Seat 4: Black021 (big blind) folded on the River
Seat 5: Ger Cortes folded before Flop (didn't bet)



PokerStars Hand #222943844874:  Hold'em No Limit ($0.05/$0.10 USD) - 2021/01/23 23:17:16 ET
Table 'Polydoros II' 6-max Seat #3 is the button
Seat 1: Bunkiebear ($2.48 in chips) 
Seat 2: EZEQUIEL.C10 ($8.17 in chips) 
Seat 3: whtocean ($10 in chips) 
Seat 4: Black021 ($16.75 in chips) 
Seat 5: Ger Cortes ($11.63 in chips) 
Seat 6: Bobok1971 ($11.24 in chips) 
Black021: posts small blind $0.05
Ger Cortes: posts big blind $0.10
*** HOLE CARDS ***
Bobok1971: folds 
Bunkiebear: folds 
EZEQUIEL.C10: folds 
whtocean: folds 
Black021: raises $0.17 to $0.27
Ger Cortes: folds 
Uncalled bet ($0.17) returned to Black021
Black021 collected $0.20 from pot
Black021: doesn't show hand 
*** SUMMARY ***
Total pot $0.20 | Rake $0 
Seat 1: Bunkiebear folded before Flop (didn't bet)
Seat 2: EZEQUIEL.C10 folded before Flop (didn't bet)
Seat 3: whtocean (button) folded before Flop (didn't bet)
Seat 4: Black021 (small blind) collected ($0.20)
Seat 5: Ger Cortes (big blind) folded before Flop
Seat 6: Bobok1971 folded before Flop (didn't bet)



PokerStars Hand #222943851929:  Hold'em No Limit ($0.05/$0.10 USD) - 2021/01/23 23:17:38 ET
Table 'Polydoros II' 6-max Seat #4 is the button
Seat 1: Bunkiebear ($2.48 in chips) 
Seat 2: EZEQUIEL.C10 ($8.17 in chips) 
Seat 3: whtocean ($10 in chips) 
Seat 4: Black021 ($16.85 in chips) 
Seat 5: Ger Cortes ($11.53 in chips) 
Ger Cortes: posts small blind $0.05
Bobok1971 has timed out
Bobok1971: is sitting out 
Bunkiebear: posts big blind $0.10
*** HOLE CARDS ***
EZEQUIEL.C10: raises $0.12 to $0.22
whtocean: folds 
Black021: folds 
Ger Cortes: folds 
Bunkiebear: raises $0.12 to $0.34
EZEQUIEL.C10: calls $0.12
*** FLOP *** [5h Ah 4d]
Bunkiebear: bets $2.14 and is all-in
EZEQUIEL.C10: folds 
Uncalled bet ($2.14) returned to Bunkiebear
Bunkiebear collected $0.70 from pot
Bunkiebear: doesn't show hand 
*** SUMMARY ***
Total pot $0.73 | Rake $0.03 
Board [5h Ah 4d]
Seat 1: Bunkiebear (big blind) collected ($0.70)
Seat 2: EZEQUIEL.C10 folded on the Flop
Seat 3: whtocean folded before Flop (didn't bet)
Seat 4: Black021 (button) folded before Flop (didn't bet)
Seat 5: Ger Cortes (small blind) folded before Flop



PokerStars Hand #222943870133:  Hold'em No Limit ($0.05/$0.10 USD) - 2021/01/23 23:18:12 ET
Table 'Polydoros II' 6-max Seat #5 is the button
Seat 1: Bunkiebear ($2.84 in chips) 
Seat 2: EZEQUIEL.C10 ($7.83 in chips) 
Seat 3: whtocean ($10 in chips) 
Seat 4: Black021 ($16.85 in chips) 
Seat 5: Ger Cortes ($11.48 in chips) 
Bunkiebear: posts small blind $0.05
EZEQUIEL.C10: posts big blind $0.10
*** HOLE CARDS ***
whtocean: folds 
Black021: raises $0.15 to $0.25
Ger Cortes: folds 
Bunkiebear: raises $2.59 to $2.84 and is all-in
EZEQUIEL.C10: folds 
Black021: folds 
Uncalled bet ($2.59) returned to Bunkiebear
Bunkiebear collected $0.60 from pot
Bunkiebear: doesn't show hand 
*** SUMMARY ***
Total pot $0.60 | Rake $0 
Seat 1: Bunkiebear (small blind) collected ($0.60)
Seat 2: EZEQUIEL.C10 (big blind) folded before Flop
Seat 3: whtocean folded before Flop (didn't bet)
Seat 4: Black021 folded before Flop
Seat 5: Ger Cortes (button) folded before Flop (didn't bet)



PokerStars Hand #222943877024:  Hold'em No Limit ($0.05/$0.10 USD) - 2021/01/23 23:18:33 ET
Table 'Polydoros II' 6-max Seat #1 is the button
Seat 1: Bunkiebear ($3.19 in chips) 
Seat 2: EZEQUIEL.C10 ($7.73 in chips) 
Seat 3: whtocean ($10 in chips) 
Seat 4: Black021 ($16.60 in chips) 
Seat 5: Ger Cortes ($11.48 in chips) 
Seat 6: Bobok1971 ($11.24 in chips) 
EZEQUIEL.C10: posts small blind $0.05
whtocean: posts big blind $0.10
Bobok1971: posts small & big blinds $0.15
*** HOLE CARDS ***
Black021: folds 
Ger Cortes: folds 
Bobok1971: checks 
Bunkiebear: calls $0.10
EZEQUIEL.C10: folds 
whtocean: checks 
*** FLOP *** [3h Kc 8d]
whtocean: bets $0.20
Bobok1971: calls $0.20
Bunkiebear: calls $0.20
*** TURN *** [3h Kc 8d] [6h]
whtocean: checks 
Bobok1971: checks 
Bunkiebear: checks 
*** RIVER *** [3h Kc 8d 6h] [5d]
whtocean: checks 
Bobok1971: bets $0.96
Bunkiebear: folds 
whtocean: folds 
Uncalled bet ($0.96) returned to Bobok1971
Bobok1971 collected $0.96 from pot
*** SUMMARY ***
Total pot $1 | Rake $0.04 
Board [3h Kc 8d 6h 5d]
Seat 1: Bunkiebear (button) folded on the River
Seat 2: EZEQUIEL.C10 (small blind) folded before Flop
Seat 3: whtocean (big blind) folded on the River
Seat 4: Black021 folded before Flop (didn't bet)
Seat 5: Ger Cortes folded before Flop (didn't bet)
Seat 6: Bobok1971 collected ($0.96)



PokerStars Hand #222943896193:  Hold'em No Limit ($0.05/$0.10 USD) - 2021/01/23 23:19:33 ET
Table 'Polydoros II' 6-max Seat #2 is the button
Seat 1: Bunkiebear ($2.89 in chips) 
Seat 2: EZEQUIEL.C10 ($7.68 in chips) 
Seat 3: whtocean ($10 in chips) 
Seat 4: Black021 ($16.60 in chips) 
Seat 5: Ger Cortes ($11.48 in chips) 
Seat 6: Bobok1971 ($11.85 in chips) 
whtocean: posts small blind $0.05
Black021: posts big blind $0.10
*** HOLE CARDS ***
Ger Cortes: folds 
Bobok1971: folds 
Bunkiebear: folds 
EZEQUIEL.C10: folds 
whtocean: raises $0.15 to $0.25
Black021: folds 
Uncalled bet ($0.15) returned to whtocean
whtocean collected $0.20 from pot
whtocean: doesn't show hand 
*** SUMMARY ***
Total pot $0.20 | Rake $0 
Seat 1: Bunkiebear folded before Flop (didn't bet)
Seat 2: EZEQUIEL.C10 (button) folded before Flop (didn't bet)
Seat 3: whtocean (small blind) collected ($0.20)
Seat 4: Black021 (big blind) folded before Flop
Seat 5: Ger Cortes folded before Flop (didn't bet)
Seat 6: Bobok1971 folded before Flop (didn't bet)



PokerStars Hand #222943904966:  Hold'em No Limit ($0.05/$0.10 USD) - 2021/01/23 23:20:01 ET
Table 'Polydoros II' 6-max Seat #3 is the button
Seat 1: Bunkiebear ($2.89 in chips) 
Seat 2: EZEQUIEL.C10 ($7.68 in chips) 
Seat 3: whtocean ($10.10 in chips) 
Seat 4: Black021 ($16.50 in chips) 
Seat 5: Ger Cortes ($11.48 in chips) 
Seat 6: Bobok1971 ($11.85 in chips) 
Black021: posts small blind $0.05
Ger Cortes: posts big blind $0.10
*** HOLE CARDS ***
Bobok1971: calls $0.10
Bunkiebear: calls $0.10
EZEQUIEL.C10: folds 
whtocean: folds 
Black021: folds 
Ger Cortes: checks 
*** FLOP *** [Qh 3d 5h]
Ger Cortes: bets $0.20
Bobok1971: folds 
Bunkiebear: calls $0.20
*** TURN *** [Qh 3d 5h] [Kd]
Ger Cortes: checks 
Bunkiebear: checks 
*** RIVER *** [Qh 3d 5h Kd] [9s]
Ger Cortes: checks 
Bunkiebear: checks 
*** SHOW DOWN ***
Ger Cortes: shows [Qc 9c] (two pair, Queens and Nines)
Bunkiebear: mucks hand 
Ger Cortes collected $0.72 from pot
*** SUMMARY ***
Total pot $0.75 | Rake $0.03 
Board [Qh 3d 5h Kd 9s]
Seat 1: Bunkiebear mucked
Seat 2: EZEQUIEL.C10 folded before Flop (didn't bet)
Seat 3: whtocean (button) folded before Flop (didn't bet)
Seat 4: Black021 (small blind) folded before Flop
Seat 5: Ger Cortes (big blind) showed [Qc 9c] and won ($0.72) with two pair, Queens and Nines
Seat 6: Bobok1971 folded on the Flop



PokerStars Hand #222943920762:  Hold'em No Limit ($0.05/$0.10 USD) - 2021/01/23 23:20:51 ET
Table 'Polydoros II' 6-max Seat #4 is the button
Seat 1: Bunkiebear ($2.59 in chips) 
Seat 2: EZEQUIEL.C10 ($7.68 in chips) 
Seat 3: whtocean ($10.10 in chips) 
Seat 4: Black021 ($16.45 in chips) 
Seat 5: Ger Cortes ($11.90 in chips) 
Seat 6: Bobok1971 ($11.75 in chips) 
Ger Cortes: posts small blind $0.05
Bobok1971: posts big blind $0.10
*** HOLE CARDS ***
Bunkiebear: folds 
EZEQUIEL.C10: folds 
whtocean: raises $0.15 to $0.25
Black021: folds 
Ger Cortes: raises $0.95 to $1.20
Bobok1971: folds 
whtocean: raises $1.05 to $2.25
Ger Cortes: folds 
Uncalled bet ($1.05) returned to whtocean
whtocean collected $2.50 from pot
whtocean: doesn't show hand 
*** SUMMARY ***
Total pot $2.50 | Rake $0 
Seat 1: Bunkiebear folded before Flop (didn't bet)
Seat 2: EZEQUIEL.C10 folded before Flop (didn't bet)
Seat 3: whtocean collected ($2.50)
Seat 4: Black021 (button) folded before Flop (didn't bet)
Seat 5: Ger Cortes (small blind) folded before Flop
Seat 6: Bobok1971 (big blind) folded before Flop



PokerStars Hand #222943939294:  Hold'em No Limit ($0.05/$0.10 USD) - 2021/01/23 23:21:50 ET
Table 'Polydoros II' 6-max Seat #5 is the button
Seat 1: Bunkiebear ($2.59 in chips) 
Seat 2: EZEQUIEL.C10 ($7.68 in chips) 
Seat 3: whtocean ($11.40 in chips) 
Seat 4: Black021 ($16.45 in chips) 
Seat 5: Ger Cortes ($10.70 in chips) 
Seat 6: Bobok1971 ($11.65 in chips) 
Bobok1971: posts small blind $0.05
Bunkiebear: posts big blind $0.10
*** HOLE CARDS ***
EZEQUIEL.C10: folds 
whtocean: folds 
Black021: folds 
Ger Cortes: folds 
Bobok1971: calls $0.05
Bunkiebear: checks 
*** FLOP *** [Th Qc 9s]
Bobok1971: checks 
Bunkiebear: bets $0.20
Bobok1971: folds 
Uncalled bet ($0.20) returned to Bunkiebear
Bunkiebear collected $0.19 from pot
Bunkiebear: doesn't show hand 
*** SUMMARY ***
Total pot $0.20 | Rake $0.01 
Board [Th Qc 9s]
Seat 1: Bunkiebear (big blind) collected ($0.19)
Seat 2: EZEQUIEL.C10 folded before Flop (didn't bet)
Seat 3: whtocean folded before Flop (didn't bet)
Seat 4: Black021 folded before Flop (didn't bet)
Seat 5: Ger Cortes (button) folded before Flop (didn't bet)
Seat 6: Bobok1971 (small blind) folded on the Flop



PokerStars Hand #222943959045:  Hold'em No Limit ($0.05/$0.10 USD) - 2021/01/23 23:22:51 ET
Table 'Polydoros II' 6-max Seat #6 is the button
Seat 1: Bunkiebear ($2.68 in chips) 
Seat 2: EZEQUIEL.C10 ($7.68 in chips) 
Seat 3: whtocean ($11.40 in chips) 
Seat 4: Black021 ($16.45 in chips) 
Seat 5: Ger Cortes ($10.70 in chips) 
Seat 6: Bobok1971 ($11.55 in chips) 
Bunkiebear: posts small blind $0.05
EZEQUIEL.C10: posts big blind $0.10
*** HOLE CARDS ***
whtocean: folds 
Black021: folds 
Ger Cortes: raises $0.15 to $0.25
Bobok1971: folds 
Bunkiebear: folds 
EZEQUIEL.C10: folds 
Uncalled bet ($0.15) returned to Ger Cortes
Ger Cortes collected $0.25 from pot
*** SUMMARY ***
Total pot $0.25 | Rake $0 
Seat 1: Bunkiebear (small blind) folded before Flop
Seat 2: EZEQUIEL.C10 (big blind) folded before Flop
Seat 3: whtocean folded before Flop (didn't bet)
Seat 4: Black021 folded before Flop (didn't bet)
Seat 5: Ger Cortes collected ($0.25)
Seat 6: Bobok1971 (button) folded before Flop (didn't bet)



PokerStars Hand #222943963564:  Hold'em No Limit ($0.05/$0.10 USD) - 2021/01/23 23:23:05 ET
Table 'Polydoros II' 6-max Seat #1 is the button
Seat 1: Bunkiebear ($2.63 in chips) 
Seat 2: EZEQUIEL.C10 ($7.58 in chips) 
Seat 3: whtocean ($11.40 in chips) 
Seat 4: Black021 ($16.45 in chips) 
Seat 5: Ger Cortes ($10.85 in chips) 
Seat 6: Bobok1971 ($11.55 in chips) 
EZEQUIEL.C10: posts small blind $0.05
whtocean: posts big blind $0.10
*** HOLE CARDS ***
Black021: folds 
Ger Cortes: folds 
Bobok1971: calls $0.10
Bunkiebear: calls $0.10
EZEQUIEL.C10: folds 
whtocean: checks 
*** FLOP *** [Jd 7h 4d]
whtocean: bets $0.15
Bobok1971: folds 
Bunkiebear: calls $0.15
*** TURN *** [Jd 7h 4d] [8h]
whtocean: checks 
Bunkiebear: checks 
*** RIVER *** [Jd 7h 4d 8h] [7c]
whtocean: checks 
Bunkiebear: checks 
*** SHOW DOWN ***
whtocean: shows [Ah 4c] (two pair, Sevens and Fours)
Bunkiebear: mucks hand 
whtocean collected $0.62 from pot
*** SUMMARY ***
Total pot $0.65 | Rake $0.03 
Board [Jd 7h 4d 8h 7c]
Seat 1: Bunkiebear (button) mucked
Seat 2: EZEQUIEL.C10 (small blind) folded before Flop
Seat 3: whtocean (big blind) showed [Ah 4c] and won ($0.62) with two pair, Sevens and Fours
Seat 4: Black021 folded before Flop (didn't bet)
Seat 5: Ger Cortes folded before Flop (didn't bet)
Seat 6: Bobok1971 folded on the Flop



PokerStars Hand #222943975680:  Hold'em No Limit ($0.05/$0.10 USD) - 2021/01/23 23:23:43 ET
Table 'Polydoros II' 6-max Seat #2 is the button
Seat 1: Bunkiebear ($2.38 in chips) 
Seat 2: EZEQUIEL.C10 ($7.53 in chips) 
Seat 3: whtocean ($11.77 in chips) 
Seat 4: Black021 ($16.45 in chips) 
Seat 5: Ger Cortes ($10.85 in chips) 
Seat 6: Bobok1971 ($11.45 in chips) 
whtocean: posts small blind $0.05
Black021: posts big blind $0.10
*** HOLE CARDS ***
Ger Cortes: folds 
Bobok1971: folds 
Bunkiebear: calls $0.10
EZEQUIEL.C10: folds 
whtocean: folds 
Black021: checks 
*** FLOP *** [Jc Jh 4s]
Black021: checks 
Bunkiebear: checks 
*** TURN *** [Jc Jh 4s] [7s]
Black021: checks 
Bunkiebear: checks 
*** RIVER *** [Jc Jh 4s 7s] [8d]
Black021: checks 
Bunkiebear: checks 
*** SHOW DOWN ***
Black021: shows [2h 7h] (two pair, Jacks and Sevens)
Bunkiebear: mucks hand 
Black021 collected $0.24 from pot
*** SUMMARY ***
Total pot $0.25 | Rake $0.01 
Board [Jc Jh 4s 7s 8d]
Seat 1: Bunkiebear mucked
Seat 2: EZEQUIEL.C10 (button) folded before Flop (didn't bet)
Seat 3: whtocean (small blind) folded before Flop
Seat 4: Black021 (big blind) showed [2h 7h] and won ($0.24) with two pair, Jacks and Sevens
Seat 5: Ger Cortes folded before Flop (didn't bet)
Seat 6: Bobok1971 folded before Flop (didn't bet)



PokerStars Hand #222943988754:  Hold'em No Limit ($0.05/$0.10 USD) - 2021/01/23 23:24:24 ET
Table 'Polydoros II' 6-max Seat #3 is the button
Seat 1: Bunkiebear ($2.28 in chips) 
Seat 2: EZEQUIEL.C10 ($7.53 in chips) 
Seat 3: whtocean ($11.72 in chips) 
Seat 4: Black021 ($16.59 in chips) 
Seat 5: Ger Cortes ($10.85 in chips) 
Seat 6: Bobok1971 ($11.45 in chips) 
Black021: posts small blind $0.05
Ger Cortes: posts big blind $0.10
*** HOLE CARDS ***
Bobok1971 has timed out
Bobok1971: folds 
Bunkiebear: folds 
EZEQUIEL.C10: folds 
whtocean: folds 
Black021: folds 
Uncalled bet ($0.05) returned to Ger Cortes
Ger Cortes collected $0.10 from pot
*** SUMMARY ***
Total pot $0.10 | Rake $0 
Seat 1: Bunkiebear folded before Flop (didn't bet)
Seat 2: EZEQUIEL.C10 folded before Flop (didn't bet)
Seat 3: whtocean (button) folded before Flop (didn't bet)
Seat 4: Black021 (small blind) folded before Flop
Seat 5: Ger Cortes (big blind) collected ($0.10)
Seat 6: Bobok1971 folded before Flop (didn't bet)



PokerStars Hand #222943995369:  Hold'em No Limit ($0.05/$0.10 USD) - 2021/01/23 23:24:45 ET
Table 'Polydoros II' 6-max Seat #4 is the button
Seat 1: Bunkiebear ($2.28 in chips) 
Seat 2: EZEQUIEL.C10 ($7.53 in chips) 
Seat 3: whtocean ($11.72 in chips) 
Seat 4: Black021 ($16.54 in chips) 
Seat 5: Ger Cortes ($10.90 in chips) 
Ger Cortes: posts small blind $0.05
Bunkiebear: posts big blind $0.10
*** HOLE CARDS ***
EZEQUIEL.C10: folds 
whtocean: folds 
Black021: raises $0.12 to $0.22
Ger Cortes: folds 
Bunkiebear: calls $0.12
*** FLOP *** [8s 2h 3s]
Bunkiebear: checks 
Black021: checks 
*** TURN *** [8s 2h 3s] [Kc]
Bunkiebear: checks 
Black021: checks 
*** RIVER *** [8s 2h 3s Kc] [7s]
Bunkiebear: checks 
Black021: checks 
*** SHOW DOWN ***
Bunkiebear: shows [Ad Jh] (high card Ace)
Black021: shows [Ac 7h] (a pair of Sevens)
Black021 collected $0.47 from pot
*** SUMMARY ***
Total pot $0.49 | Rake $0.02 
Board [8s 2h 3s Kc 7s]
Seat 1: Bunkiebear (big blind) showed [Ad Jh] and lost with high card Ace
Seat 2: EZEQUIEL.C10 folded before Flop (didn't bet)
Seat 3: whtocean folded before Flop (didn't bet)
Seat 4: Black021 (button) showed [Ac 7h] and won ($0.47) with a pair of Sevens
Seat 5: Ger Cortes (small blind) folded before Flop



PokerStars Hand #222944007921:  Hold'em No Limit ($0.05/$0.10 USD) - 2021/01/23 23:25:25 ET
Table 'Polydoros II' 6-max Seat #5 is the button
Seat 1: Bunkiebear ($2.06 in chips) 
Seat 2: EZEQUIEL.C10 ($7.53 in chips) 
Seat 3: whtocean ($11.72 in chips) 
Seat 4: Black021 ($16.79 in chips) 
Seat 5: Ger Cortes ($10.85 in chips) 
Bunkiebear: posts small blind $0.05
EZEQUIEL.C10: posts big blind $0.10
*** HOLE CARDS ***
whtocean: folds 
Black021: folds 
Ger Cortes: folds 
Bunkiebear: calls $0.05
EZEQUIEL.C10: checks 
*** FLOP *** [9s 4s Qd]
Bunkiebear: checks 
EZEQUIEL.C10: checks 
*** TURN *** [9s 4s Qd] [Jc]
Bunkiebear: checks 
EZEQUIEL.C10: bets $0.10
Bunkiebear: calls $0.10
*** RIVER *** [9s 4s Qd Jc] [5h]
Bunkiebear: bets $1.86 and is all-in
EZEQUIEL.C10: folds 
Uncalled bet ($1.86) returned to Bunkiebear
Bunkiebear collected $0.38 from pot
Bunkiebear: doesn't show hand 
*** SUMMARY ***
Total pot $0.40 | Rake $0.02 
Board [9s 4s Qd Jc 5h]
Seat 1: Bunkiebear (small blind) collected ($0.38)
Seat 2: EZEQUIEL.C10 (big blind) folded on the River
Seat 3: whtocean folded before Flop (didn't bet)
Seat 4: Black021 folded before Flop (didn't bet)
Seat 5: Ger Cortes (button) folded before Flop (didn't bet)



PokerStars Hand #222944022322:  Hold'em No Limit ($0.05/$0.10 USD) - 2021/01/23 23:26:10 ET
Table 'Polydoros II' 6-max Seat #1 is the button
Seat 1: Bunkiebear ($2.24 in chips) 
Seat 2: EZEQUIEL.C10 ($7.33 in chips) 
Seat 3: whtocean ($11.72 in chips) 
Seat 4: Black021 ($16.79 in chips) 
Seat 5: Ger Cortes ($10.85 in chips) 
Seat 6: Bobok1971 ($11.45 in chips) 
EZEQUIEL.C10: posts small blind $0.05
whtocean: posts big blind $0.10
Bobok1971: posts small & big blinds $0.15
*** HOLE CARDS ***
Black021: folds 
Ger Cortes: raises $0.40 to $0.50
Bobok1971: folds 
Bunkiebear: calls $0.50
EZEQUIEL.C10: folds 
whtocean: folds 
*** FLOP *** [9c 7d 9h]
Ger Cortes: bets $10.35 and is all-in
Bunkiebear: calls $1.74 and is all-in
Uncalled bet ($8.61) returned to Ger Cortes
*** TURN *** [9c 7d 9h] [Kd]
*** RIVER *** [9c 7d 9h Kd] [Jd]
*** SHOW DOWN ***
Ger Cortes: shows [Ah Kc] (two pair, Kings and Nines)
Bunkiebear: shows [9d Qd] (a flush, King high)
Bunkiebear collected $4.56 from pot
*** SUMMARY ***
Total pot $4.78 | Rake $0.22 
Board [9c 7d 9h Kd Jd]
Seat 1: Bunkiebear (button) showed [9d Qd] and won ($4.56) with a flush, King high
Seat 2: EZEQUIEL.C10 (small blind) folded before Flop
Seat 3: whtocean (big blind) folded before Flop
Seat 4: Black021 folded before Flop (didn't bet)
Seat 5: Ger Cortes showed [Ah Kc] and lost with two pair, Kings and Nines
Seat 6: Bobok1971 folded before Flop (didn't bet)



PokerStars Hand #222944036851:  Hold'em No Limit ($0.05/$0.10 USD) - 2021/01/23 23:26:56 ET
Table 'Polydoros II' 6-max Seat #2 is the button
Seat 1: Bunkiebear ($4.56 in chips) 
Seat 2: EZEQUIEL.C10 ($7.28 in chips) 
Seat 3: whtocean ($11.62 in chips) 
Seat 4: Black021 ($16.79 in chips) 
Seat 5: Ger Cortes ($10 in chips) 
Seat 6: Bobok1971 ($11.30 in chips) 
whtocean: posts small blind $0.05
Black021: posts big blind $0.10
*** HOLE CARDS ***
Ger Cortes: folds 
Bobok1971: calls $0.10
Bunkiebear: calls $0.10
EZEQUIEL.C10: folds 
whtocean: calls $0.05
Black021: checks 
*** FLOP *** [5s 7h Ts]
whtocean: checks 
Black021: bets $0.25
Bobok1971: folds 
Bunkiebear: calls $0.25
whtocean: folds 
*** TURN *** [5s 7h Ts] [5h]
Black021: checks 
Bunkiebear: checks 
*** RIVER *** [5s 7h Ts 5h] [2s]
Black021: bets $0.85
Bunkiebear: folds 
Uncalled bet ($0.85) returned to Black021
Black021 collected $0.86 from pot
Black021: doesn't show hand 
*** SUMMARY ***
Total pot $0.90 | Rake $0.04 
Board [5s 7h Ts 5h 2s]
Seat 1: Bunkiebear folded on the River
Seat 2: EZEQUIEL.C10 (button) folded before Flop (didn't bet)
Seat 3: whtocean (small blind) folded on the Flop
Seat 4: Black021 (big blind) collected ($0.86)
Seat 5: Ger Cortes folded before Flop (didn't bet)
Seat 6: Bobok1971 folded on the Flop



PokerStars Hand #222944055987:  Hold'em No Limit ($0.05/$0.10 USD) - 2021/01/23 23:27:58 ET
Table 'Polydoros II' 6-max Seat #3 is the button
Seat 1: Bunkiebear ($4.21 in chips) 
Seat 2: EZEQUIEL.C10 ($7.28 in chips) 
Seat 3: whtocean ($11.52 in chips) 
Seat 4: Black021 ($17.30 in chips) 
Seat 5: Ger Cortes ($10 in chips) 
Seat 6: Bobok1971 ($11.20 in chips) 
Black021: posts small blind $0.05
Ger Cortes: posts big blind $0.10
*** HOLE CARDS ***
Bobok1971: folds 
Bunkiebear: calls $0.10
EZEQUIEL.C10: folds 
whtocean: folds 
Black021: raises $0.30 to $0.40
Ger Cortes: raises $0.90 to $1.30
Bunkiebear: calls $1.20
Black021: folds 
*** FLOP *** [2d 9h 4d]
Ger Cortes: checks 
Bunkiebear: checks 
*** TURN *** [2d 9h 4d] [Jd]
Ger Cortes: checks 
Bunkiebear: checks 
*** RIVER *** [2d 9h 4d Jd] [2h]
Ger Cortes: bets $4.29
Bunkiebear: folds 
Uncalled bet ($4.29) returned to Ger Cortes
Ger Cortes collected $2.86 from pot
*** SUMMARY ***
Total pot $3 | Rake $0.14 
Board [2d 9h 4d Jd 2h]
Seat 1: Bunkiebear folded on the River
Seat 2: EZEQUIEL.C10 folded before Flop (didn't bet)
Seat 3: whtocean (button) folded before Flop (didn't bet)
Seat 4: Black021 (small blind) folded before Flop
Seat 5: Ger Cortes (big blind) collected ($2.86)
Seat 6: Bobok1971 folded before Flop (didn't bet)



PokerStars Hand #222944074848:  Hold'em No Limit ($0.05/$0.10 USD) - 2021/01/23 23:28:59 ET
Table 'Polydoros II' 6-max Seat #4 is the button
Seat 1: Bunkiebear ($2.91 in chips) 
Seat 2: EZEQUIEL.C10 ($7.28 in chips) 
Seat 3: whtocean ($11.52 in chips) 
Seat 4: Black021 ($16.90 in chips) 
Seat 5: Ger Cortes ($11.56 in chips) 
Seat 6: Bobok1971 ($11.20 in chips) 
Ger Cortes: posts small blind $0.05
Bobok1971: posts big blind $0.10
*** HOLE CARDS ***
Bunkiebear: folds 
EZEQUIEL.C10: raises $0.20 to $0.30
whtocean: folds 
Black021: folds 
Ger Cortes: folds 
Bobok1971: folds 
Uncalled bet ($0.20) returned to EZEQUIEL.C10
EZEQUIEL.C10 collected $0.25 from pot
EZEQUIEL.C10: doesn't show hand 
*** SUMMARY ***
Total pot $0.25 | Rake $0 
Seat 1: Bunkiebear folded before Flop (didn't bet)
Seat 2: EZEQUIEL.C10 collected ($0.25)
Seat 3: whtocean folded before Flop (didn't bet)
Seat 4: Black021 (button) folded before Flop (didn't bet)
Seat 5: Ger Cortes (small blind) folded before Flop
Seat 6: Bobok1971 (big blind) folded before Flop



PokerStars Hand #222944079664:  Hold'em No Limit ($0.05/$0.10 USD) - 2021/01/23 23:29:14 ET
Table 'Polydoros II' 6-max Seat #5 is the button
Seat 1: Bunkiebear ($2.91 in chips) 
Seat 2: EZEQUIEL.C10 ($7.43 in chips) 
Seat 3: whtocean ($11.52 in chips) 
Seat 4: Black021 ($16.90 in chips) 
Seat 5: Ger Cortes ($11.51 in chips) 
Seat 6: Bobok1971 ($11.10 in chips) 
Bobok1971: posts small blind $0.05
Bunkiebear: posts big blind $0.10
*** HOLE CARDS ***
EZEQUIEL.C10: folds 
whtocean: folds 
Black021: folds 
Ger Cortes: folds 
Bobok1971: raises $0.10 to $0.20
Bunkiebear: folds 
Uncalled bet ($0.10) returned to Bobok1971
Bobok1971 collected $0.20 from pot
Bobok1971: doesn't show hand 
*** SUMMARY ***
Total pot $0.20 | Rake $0 
Seat 1: Bunkiebear (big blind) folded before Flop
Seat 2: EZEQUIEL.C10 folded before Flop (didn't bet)
Seat 3: whtocean folded before Flop (didn't bet)
Seat 4: Black021 folded before Flop (didn't bet)
Seat 5: Ger Cortes (button) folded before Flop (didn't bet)
Seat 6: Bobok1971 (small blind) collected ($0.20)



PokerStars Hand #222944083517:  Hold'em No Limit ($0.05/$0.10 USD) - 2021/01/23 23:29:27 ET
Table 'Polydoros II' 6-max Seat #6 is the button
Seat 1: Bunkiebear ($2.81 in chips) 
Seat 2: EZEQUIEL.C10 ($7.43 in chips) 
Seat 3: whtocean ($11.52 in chips) 
Seat 4: Black021 ($16.90 in chips) 
Seat 5: Ger Cortes ($11.51 in chips) 
Seat 6: Bobok1971 ($11.20 in chips) 
Bunkiebear: posts small blind $0.05
EZEQUIEL.C10: posts big blind $0.10
*** HOLE CARDS ***
whtocean: raises $0.20 to $0.30
Black021: folds 
Ger Cortes: folds 
Bobok1971: folds 
Bunkiebear: folds 
EZEQUIEL.C10: folds 
Uncalled bet ($0.20) returned to whtocean
whtocean collected $0.25 from pot
whtocean: doesn't show hand 
*** SUMMARY ***
Total pot $0.25 | Rake $0 
Seat 1: Bunkiebear (small blind) folded before Flop
Seat 2: EZEQUIEL.C10 (big blind) folded before Flop
Seat 3: whtocean collected ($0.25)
Seat 4: Black021 folded before Flop (didn't bet)
Seat 5: Ger Cortes folded before Flop (didn't bet)
Seat 6: Bobok1971 (button) folded before Flop (didn't bet)



PokerStars Hand #222944087863:  Hold'em No Limit ($0.05/$0.10 USD) - 2021/01/23 23:29:41 ET
Table 'Polydoros II' 6-max Seat #1 is the button
Seat 1: Bunkiebear ($2.76 in chips) 
Seat 2: EZEQUIEL.C10 ($7.33 in chips) 
Seat 3: whtocean ($11.67 in chips) 
Seat 4: Black021 ($16.90 in chips) 
Seat 5: Ger Cortes ($11.51 in chips) 
Seat 6: Bobok1971 ($11.20 in chips) 
EZEQUIEL.C10: posts small blind $0.05
whtocean: posts big blind $0.10
*** HOLE CARDS ***
Black021: folds 
Ger Cortes: folds 
Bobok1971: folds 
Bunkiebear: folds 
EZEQUIEL.C10: raises $0.15 to $0.25
whtocean: raises $0.65 to $0.90
EZEQUIEL.C10: folds 
Uncalled bet ($0.65) returned to whtocean
whtocean collected $0.50 from pot
whtocean: doesn't show hand 
*** SUMMARY ***
Total pot $0.50 | Rake $0 
Seat 1: Bunkiebear (button) folded before Flop (didn't bet)
Seat 2: EZEQUIEL.C10 (small blind) folded before Flop
Seat 3: whtocean (big blind) collected ($0.50)
Seat 4: Black021 folded before Flop (didn't bet)
Seat 5: Ger Cortes folded before Flop (didn't bet)
Seat 6: Bobok1971 folded before Flop (didn't bet)



PokerStars Hand #222944096315:  Hold'em No Limit ($0.05/$0.10 USD) - 2021/01/23 23:30:08 ET
Table 'Polydoros II' 6-max Seat #2 is the button
Seat 1: Bunkiebear ($2.76 in chips) 
Seat 2: EZEQUIEL.C10 ($7.08 in chips) 
Seat 3: whtocean ($11.92 in chips) 
Seat 4: Black021 ($16.90 in chips) 
Seat 5: Ger Cortes ($11.51 in chips) 
Seat 6: Bobok1971 ($11.20 in chips) 
whtocean: posts small blind $0.05
Black021: posts big blind $0.10
*** HOLE CARDS ***
Ger Cortes: folds 
Bobok1971: calls $0.10
Bunkiebear: calls $0.10
EZEQUIEL.C10: calls $0.10
whtocean: calls $0.05
Black021: raises $0.60 to $0.70
Bobok1971: folds 
Bunkiebear: calls $0.60
EZEQUIEL.C10: folds 
whtocean: folds 
*** FLOP *** [7h Jh 5s]
Black021: bets $16.20 and is all-in
Bunkiebear: folds 
Uncalled bet ($16.20) returned to Black021
Black021 collected $1.62 from pot
Black021: doesn't show hand 
*** SUMMARY ***
Total pot $1.70 | Rake $0.08 
Board [7h Jh 5s]
Seat 1: Bunkiebear folded on the Flop
Seat 2: EZEQUIEL.C10 (button) folded before Flop
Seat 3: whtocean (small blind) folded before Flop
Seat 4: Black021 (big blind) collected ($1.62)
Seat 5: Ger Cortes folded before Flop (didn't bet)
Seat 6: Bobok1971 folded before Flop



PokerStars Hand #222944112791:  Hold'em No Limit ($0.05/$0.10 USD) - 2021/01/23 23:30:54 ET
Table 'Polydoros II' 6-max Seat #3 is the button
Seat 1: Bunkiebear ($2.06 in chips) 
Seat 2: EZEQUIEL.C10 ($6.98 in chips) 
Seat 3: whtocean ($11.82 in chips) 
Seat 4: Black021 ($17.82 in chips) 
Seat 5: Ger Cortes ($11.51 in chips) 
Seat 6: Bobok1971 ($11.10 in chips) 
Black021: posts small blind $0.05
Ger Cortes: posts big blind $0.10
*** HOLE CARDS ***
Bobok1971: calls $0.10
Bunkiebear: folds 
EZEQUIEL.C10: folds 
whtocean: folds 
Black021: folds 
Ger Cortes: checks 
*** FLOP *** [5h 8s Kh]
Ger Cortes: checks 
Bobok1971: checks 
*** TURN *** [5h 8s Kh] [6h]
Ger Cortes: checks 
Bobok1971: checks 
*** RIVER *** [5h 8s Kh 6h] [3d]
Ger Cortes: checks 
Bobok1971: checks 
*** SHOW DOWN ***
Ger Cortes: shows [Td 6d] (a pair of Sixes)
Bobok1971: mucks hand 
Ger Cortes collected $0.24 from pot
*** SUMMARY ***
Total pot $0.25 | Rake $0.01 
Board [5h 8s Kh 6h 3d]
Seat 1: Bunkiebear folded before Flop (didn't bet)
Seat 2: EZEQUIEL.C10 folded before Flop (didn't bet)
Seat 3: whtocean (button) folded before Flop (didn't bet)
Seat 4: Black021 (small blind) folded before Flop
Seat 5: Ger Cortes (big blind) showed [Td 6d] and won ($0.24) with a pair of Sixes
Seat 6: Bobok1971 mucked



PokerStars Hand #222944124720:  Hold'em No Limit ($0.05/$0.10 USD) - 2021/01/23 23:31:33 ET
Table 'Polydoros II' 6-max Seat #4 is the button
Seat 1: Bunkiebear ($2.06 in chips) 
Seat 2: EZEQUIEL.C10 ($6.98 in chips) 
Seat 3: whtocean ($11.82 in chips) 
Seat 4: Black021 ($17.77 in chips) 
Seat 5: Ger Cortes ($11.65 in chips) 
Seat 6: Bobok1971 ($11 in chips) 
Ger Cortes: posts small blind $0.05
Bobok1971: posts big blind $0.10
*** HOLE CARDS ***
Bunkiebear: folds 
EZEQUIEL.C10: folds 
whtocean: folds 
Black021: raises $0.12 to $0.22
Ger Cortes: folds 
Bobok1971: raises $0.49 to $0.71
Black021: raises $1.14 to $1.85
Bobok1971 has timed out
Bobok1971: folds 
Uncalled bet ($1.14) returned to Black021
Black021 collected $1.47 from pot
Black021: doesn't show hand 
*** SUMMARY ***
Total pot $1.47 | Rake $0 
Seat 1: Bunkiebear folded before Flop (didn't bet)
Seat 2: EZEQUIEL.C10 folded before Flop (didn't bet)
Seat 3: whtocean folded before Flop (didn't bet)
Seat 4: Black021 (button) collected ($1.47)
Seat 5: Ger Cortes (small blind) folded before Flop
Seat 6: Bobok1971 (big blind) folded before Flop



PokerStars Hand #222944141953:  Hold'em No Limit ($0.05/$0.10 USD) - 2021/01/23 23:32:29 ET
Table 'Polydoros II' 6-max Seat #5 is the button
Seat 1: Bunkiebear ($2.06 in chips) 
Seat 2: EZEQUIEL.C10 ($6.98 in chips) 
Seat 3: whtocean ($11.82 in chips) 
Seat 4: Black021 ($18.53 in chips) 
Seat 5: Ger Cortes ($11.60 in chips) 
Bunkiebear: posts small blind $0.05
EZEQUIEL.C10: posts big blind $0.10
*** HOLE CARDS ***
whtocean: folds 
Black021: raises $0.15 to $0.25
Ger Cortes: folds 
Bunkiebear: raises $1.81 to $2.06 and is all-in
EZEQUIEL.C10: folds 
Black021: folds 
Uncalled bet ($1.81) returned to Bunkiebear
Bunkiebear collected $0.60 from pot
Bunkiebear: doesn't show hand 
*** SUMMARY ***
Total pot $0.60 | Rake $0 
Seat 1: Bunkiebear (small blind) collected ($0.60)
Seat 2: EZEQUIEL.C10 (big blind) folded before Flop
Seat 3: whtocean folded before Flop (didn't bet)
Seat 4: Black021 folded before Flop
Seat 5: Ger Cortes (button) folded before Flop (didn't bet)



PokerStars Hand #222944145975:  Hold'em No Limit ($0.05/$0.10 USD) - 2021/01/23 23:32:42 ET
Table 'Polydoros II' 6-max Seat #1 is the button
Seat 1: Bunkiebear ($2.41 in chips) 
Seat 2: EZEQUIEL.C10 ($6.88 in chips) 
Seat 3: whtocean ($11.82 in chips) 
Seat 4: Black021 ($18.28 in chips) 
Seat 5: Ger Cortes ($11.60 in chips) 
EZEQUIEL.C10: posts small blind $0.05
whtocean: posts big blind $0.10
*** HOLE CARDS ***
Black021: raises $0.17 to $0.27
Ger Cortes: folds 
Bunkiebear: calls $0.27
EZEQUIEL.C10: folds 
whtocean: folds 
*** FLOP *** [Kc 5s 8c]
Black021: bets $0.22
Bunkiebear: raises $1.92 to $2.14 and is all-in
Black021: calls $1.92
*** TURN *** [Kc 5s 8c] [Td]
*** RIVER *** [Kc 5s 8c Td] [2s]
*** SHOW DOWN ***
Black021: shows [Ks 9s] (a pair of Kings)
Bunkiebear: shows [Th Kd] (two pair, Kings and Tens)
Bunkiebear collected $4.75 from pot
*** SUMMARY ***
Total pot $4.97 | Rake $0.22 
Board [Kc 5s 8c Td 2s]
Seat 1: Bunkiebear (button) showed [Th Kd] and won ($4.75) with two pair, Kings and Tens
Seat 2: EZEQUIEL.C10 (small blind) folded before Flop
Seat 3: whtocean (big blind) folded before Flop
Seat 4: Black021 showed [Ks 9s] and lost with a pair of Kings
Seat 5: Ger Cortes folded before Flop (didn't bet)



PokerStars Hand #222944154125:  Hold'em No Limit ($0.05/$0.10 USD) - 2021/01/23 23:33:09 ET
Table 'Polydoros II' 6-max Seat #2 is the button
Seat 1: Bunkiebear ($4.75 in chips) 
Seat 2: EZEQUIEL.C10 ($6.83 in chips) 
Seat 3: whtocean ($11.72 in chips) 
Seat 4: Black021 ($15.87 in chips) 
Seat 5: Ger Cortes ($11.60 in chips) 
whtocean: posts small blind $0.05
Black021: posts big blind $0.10
*** HOLE CARDS ***
Ger Cortes: folds 
Bunkiebear: folds 
EZEQUIEL.C10: folds 
whtocean: raises $0.15 to $0.25
Black021: folds 
Uncalled bet ($0.15) returned to whtocean
whtocean collected $0.20 from pot
whtocean: doesn't show hand 
*** SUMMARY ***
Total pot $0.20 | Rake $0 
Seat 1: Bunkiebear folded before Flop (didn't bet)
Seat 2: EZEQUIEL.C10 (button) folded before Flop (didn't bet)
Seat 3: whtocean (small blind) collected ($0.20)
Seat 4: Black021 (big blind) folded before Flop
Seat 5: Ger Cortes folded before Flop (didn't bet)



PokerStars Hand #222944159397:  Hold'em No Limit ($0.05/$0.10 USD) - 2021/01/23 23:33:26 ET
Table 'Polydoros II' 6-max Seat #3 is the button
Seat 1: Bunkiebear ($4.75 in chips) 
Seat 2: EZEQUIEL.C10 ($6.83 in chips) 
Seat 3: whtocean ($11.82 in chips) 
Seat 4: Black021 ($15.77 in chips) 
Seat 5: Ger Cortes ($11.60 in chips) 
Black021: posts small blind $0.05
Ger Cortes: posts big blind $0.10
*** HOLE CARDS ***
Bunkiebear: calls $0.10
EZEQUIEL.C10: folds 
whtocean: folds 
Black021: raises $0.30 to $0.40
Ger Cortes: folds 
Bunkiebear: calls $0.30
*** FLOP *** [4d Ts 6c]
Black021: bets $0.57
Bunkiebear: folds 
Uncalled bet ($0.57) returned to Black021
Black021 collected $0.86 from pot
Black021: doesn't show hand 
*** SUMMARY ***
Total pot $0.90 | Rake $0.04 
Board [4d Ts 6c]
Seat 1: Bunkiebear folded on the Flop
Seat 2: EZEQUIEL.C10 folded before Flop (didn't bet)
Seat 3: whtocean (button) folded before Flop (didn't bet)
Seat 4: Black021 (small blind) collected ($0.86)
Seat 5: Ger Cortes (big blind) folded before Flop



PokerStars Hand #222944165431:  Hold'em No Limit ($0.05/$0.10 USD) - 2021/01/23 23:33:46 ET
Table 'Polydoros II' 6-max Seat #4 is the button
Seat 1: Bunkiebear ($4.35 in chips) 
Seat 2: EZEQUIEL.C10 ($10 in chips) 
Seat 3: whtocean ($11.82 in chips) 
Seat 4: Black021 ($16.23 in chips) 
Seat 5: Ger Cortes ($11.50 in chips) 
Ger Cortes: posts small blind $0.05
Bunkiebear: posts big blind $0.10
*** HOLE CARDS ***
EZEQUIEL.C10: folds 
whtocean: folds 
Black021: raises $0.12 to $0.22
Ger Cortes: raises $0.78 to $1
Bunkiebear: folds 
Black021: folds 
Uncalled bet ($0.78) returned to Ger Cortes
Ger Cortes collected $0.54 from pot
*** SUMMARY ***
Total pot $0.54 | Rake $0 
Seat 1: Bunkiebear (big blind) folded before Flop
Seat 2: EZEQUIEL.C10 folded before Flop (didn't bet)
Seat 3: whtocean folded before Flop (didn't bet)
Seat 4: Black021 (button) folded before Flop
Seat 5: Ger Cortes (small blind) collected ($0.54)



PokerStars Hand #222944171028:  Hold'em No Limit ($0.05/$0.10 USD) - 2021/01/23 23:34:04 ET
Table 'Polydoros II' 6-max Seat #5 is the button
Seat 1: Bunkiebear ($4.25 in chips) 
Seat 2: EZEQUIEL.C10 ($10 in chips) 
Seat 3: whtocean ($11.82 in chips) 
Seat 4: Black021 ($16.01 in chips) 
Seat 5: Ger Cortes ($11.82 in chips) 
Bunkiebear: posts small blind $0.05
EZEQUIEL.C10: posts big blind $0.10
*** HOLE CARDS ***
whtocean: folds 
Black021: folds 
Ger Cortes: folds 
Bunkiebear: calls $0.05
EZEQUIEL.C10: checks 
*** FLOP *** [Ac 7h 9d]
Bunkiebear: bets $0.20
EZEQUIEL.C10: folds 
Uncalled bet ($0.20) returned to Bunkiebear
Bunkiebear collected $0.19 from pot
Bunkiebear: doesn't show hand 
*** SUMMARY ***
Total pot $0.20 | Rake $0.01 
Board [Ac 7h 9d]
Seat 1: Bunkiebear (small blind) collected ($0.19)
Seat 2: EZEQUIEL.C10 (big blind) folded on the Flop
Seat 3: whtocean folded before Flop (didn't bet)
Seat 4: Black021 folded before Flop (didn't bet)
Seat 5: Ger Cortes (button) folded before Flop (didn't bet)



PokerStars Hand #222944178057:  Hold'em No Limit ($0.05/$0.10 USD) - 2021/01/23 23:34:27 ET
Table 'Polydoros II' 6-max Seat #1 is the button
Seat 1: Bunkiebear ($4.34 in chips) 
Seat 2: EZEQUIEL.C10 ($9.90 in chips) 
Seat 3: whtocean ($11.82 in chips) 
Seat 4: Black021 ($16.01 in chips) 
Seat 5: Ger Cortes ($11.82 in chips) 
Seat 6: Bobok1971 ($10.29 in chips) 
EZEQUIEL.C10: posts small blind $0.05
whtocean: posts big blind $0.10
Bobok1971: posts small & big blinds $0.15
*** HOLE CARDS ***
Black021: raises $0.30 to $0.40
Ger Cortes: folds 
Bobok1971: folds 
Bunkiebear: calls $0.40
EZEQUIEL.C10: folds 
whtocean: folds 
*** FLOP *** [4s Ac 8h]
Black021: checks 
Bunkiebear: checks 
*** TURN *** [4s Ac 8h] [2s]
Black021: checks 
Bunkiebear: checks 
*** RIVER *** [4s Ac 8h 2s] [3h]
Black021: checks 
Bunkiebear: checks 
*** SHOW DOWN ***
Black021: shows [6h 6s] (a pair of Sixes)
Bunkiebear: mucks hand 
Black021 collected $1.05 from pot
*** SUMMARY ***
Total pot $1.10 | Rake $0.05 
Board [4s Ac 8h 2s 3h]
Seat 1: Bunkiebear (button) mucked
Seat 2: EZEQUIEL.C10 (small blind) folded before Flop
Seat 3: whtocean (big blind) folded before Flop
Seat 4: Black021 showed [6h 6s] and won ($1.05) with a pair of Sixes
Seat 5: Ger Cortes folded before Flop (didn't bet)
Seat 6: Bobok1971 folded before Flop (didn't bet)



PokerStars Hand #222944190315:  Hold'em No Limit ($0.05/$0.10 USD) - 2021/01/23 23:34:58 ET
Table 'Polydoros II' 6-max Seat #2 is the button
Seat 1: Bunkiebear ($3.94 in chips) 
Seat 2: EZEQUIEL.C10 ($9.85 in chips) 
Seat 3: whtocean ($11.72 in chips) 
Seat 4: Black021 ($16.66 in chips) 
Seat 5: Ger Cortes ($11.82 in chips) 
Seat 6: Bobok1971 ($10.14 in chips) 
whtocean: posts small blind $0.05
Black021: posts big blind $0.10
*** HOLE CARDS ***
Ger Cortes: folds 
Bobok1971: folds 
Bunkiebear: folds 
EZEQUIEL.C10: raises $0.15 to $0.25
whtocean: folds 
Black021: folds 
Uncalled bet ($0.15) returned to EZEQUIEL.C10
Black021 was removed from the table for failing to post
Black021 leaves the table
EZEQUIEL.C10 collected $0.25 from pot
EZEQUIEL.C10: doesn't show hand 
*** SUMMARY ***
Total pot $0.25 | Rake $0 
Seat 1: Bunkiebear folded before Flop (didn't bet)
Seat 2: EZEQUIEL.C10 (button) collected ($0.25)
Seat 3: whtocean (small blind) folded before Flop
Seat 4: Black021 (big blind) folded before Flop
Seat 5: Ger Cortes folded before Flop (didn't bet)
Seat 6: Bobok1971 folded before Flop (didn't bet)



PokerStars Hand #222944197579:  Hold'em No Limit ($0.05/$0.10 USD) - 2021/01/23 23:35:22 ET
Table 'Polydoros II' 6-max Seat #3 is the button
Seat 1: Bunkiebear ($3.94 in chips) 
Seat 2: EZEQUIEL.C10 ($10 in chips) 
Seat 3: whtocean ($11.67 in chips) 
Seat 5: Ger Cortes ($11.82 in chips) 
Seat 6: Bobok1971 ($10.14 in chips) 
Ger Cortes: posts small blind $0.05
Bobok1971: posts big blind $0.10
*** HOLE CARDS ***
Bunkiebear: folds 
EZEQUIEL.C10: folds 
whtocean: raises $0.15 to $0.25
Ger Cortes: folds 
Bobok1971: raises $0.15 to $0.40
whtocean: calls $0.15
*** FLOP *** [8c 5d 5h]
Bobok1971: checks 
whtocean: checks 
*** TURN *** [8c 5d 5h] [8s]
Bobok1971: bets $0.40
whtocean: folds 
Uncalled bet ($0.40) returned to Bobok1971
Bobok1971 collected $0.81 from pot
Bobok1971: doesn't show hand 
*** SUMMARY ***
Total pot $0.85 | Rake $0.04 
Board [8c 5d 5h 8s]
Seat 1: Bunkiebear folded before Flop (didn't bet)
Seat 2: EZEQUIEL.C10 folded before Flop (didn't bet)
Seat 3: whtocean (button) folded on the Turn
Seat 5: Ger Cortes (small blind) folded before Flop
Seat 6: Bobok1971 (big blind) collected ($0.81)



PokerStars Hand #222944207749:  Hold'em No Limit ($0.05/$0.10 USD) - 2021/01/23 23:35:55 ET
Table 'Polydoros II' 6-max Seat #5 is the button
Seat 1: Bunkiebear ($3.94 in chips) 
Seat 2: EZEQUIEL.C10 ($10 in chips) 
Seat 3: whtocean ($11.27 in chips) 
Seat 5: Ger Cortes ($11.77 in chips) 
Seat 6: Bobok1971 ($10.55 in chips) 
Bobok1971: posts small blind $0.05
Bunkiebear: posts big blind $0.10
*** HOLE CARDS ***
EZEQUIEL.C10: folds 
whtocean: folds 
Ger Cortes: raises $0.15 to $0.25
Bobok1971: folds 
Bunkiebear: folds 
Uncalled bet ($0.15) returned to Ger Cortes
Ger Cortes collected $0.25 from pot
*** SUMMARY ***
Total pot $0.25 | Rake $0 
Seat 1: Bunkiebear (big blind) folded before Flop
Seat 2: EZEQUIEL.C10 folded before Flop (didn't bet)
Seat 3: whtocean folded before Flop (didn't bet)
Seat 5: Ger Cortes (button) collected ($0.25)
Seat 6: Bobok1971 (small blind) folded before Flop



PokerStars Hand #222944211983:  Hold'em No Limit ($0.05/$0.10 USD) - 2021/01/23 23:36:09 ET
Table 'Polydoros II' 6-max Seat #6 is the button
Seat 1: Bunkiebear ($3.84 in chips) 
Seat 2: EZEQUIEL.C10 ($10 in chips) 
Seat 3: whtocean ($11.27 in chips) 
Seat 5: Ger Cortes ($11.92 in chips) 
Seat 6: Bobok1971 ($10.50 in chips) 
Bunkiebear: posts small blind $0.05
EZEQUIEL.C10: posts big blind $0.10
*** HOLE CARDS ***
whtocean: folds 
Ger Cortes: folds 
Bobok1971: raises $0.10 to $0.20
Bunkiebear: calls $0.15
EZEQUIEL.C10: folds 
*** FLOP *** [4c 2h Jd]
Bunkiebear: checks 
images777 joins the table at seat #4 
Bobok1971: bets $0.24
Bunkiebear: calls $0.24
*** TURN *** [4c 2h Jd] [8d]
Bunkiebear: checks 
Bobok1971: bets $0.47
Bunkiebear: folds 
Uncalled bet ($0.47) returned to Bobok1971
Bobok1971 collected $0.94 from pot
Bobok1971: doesn't show hand 
*** SUMMARY ***
Total pot $0.98 | Rake $0.04 
Board [4c 2h Jd 8d]
Seat 1: Bunkiebear (small blind) folded on the Turn
Seat 2: EZEQUIEL.C10 (big blind) folded before Flop
Seat 3: whtocean folded before Flop (didn't bet)
Seat 5: Ger Cortes folded before Flop (didn't bet)
Seat 6: Bobok1971 (button) collected ($0.94)



PokerStars Hand #222944224985:  Hold'em No Limit ($0.05/$0.10 USD) - 2021/01/23 23:36:52 ET
Table 'Polydoros II' 6-max Seat #1 is the button
Seat 1: Bunkiebear ($3.40 in chips) 
Seat 2: EZEQUIEL.C10 ($9.90 in chips) 
Seat 3: whtocean ($11.27 in chips) 
Seat 5: Ger Cortes ($11.92 in chips) 
Seat 6: Bobok1971 ($11 in chips) 
EZEQUIEL.C10: posts small blind $0.05
whtocean: posts big blind $0.10
images777: sits out 
*** HOLE CARDS ***
Ger Cortes: folds 
Bobok1971: calls $0.10
Bunkiebear: folds 
EZEQUIEL.C10: folds 
whtocean: checks 
*** FLOP *** [7d As Js]
whtocean: checks 
Bobok1971: checks 
*** TURN *** [7d As Js] [Kh]
whtocean: checks 
Bobok1971: checks 
*** RIVER *** [7d As Js Kh] [3d]
whtocean: bets $0.13
Bobok1971: raises $0.13 to $0.26
whtocean: calls $0.13
*** SHOW DOWN ***
Bobok1971: shows [5d Td] (high card Ace)
whtocean: shows [Kd 8d] (a pair of Kings)
whtocean collected $0.74 from pot
*** SUMMARY ***
Total pot $0.77 | Rake $0.03 
Board [7d As Js Kh 3d]
Seat 1: Bunkiebear (button) folded before Flop (didn't bet)
Seat 2: EZEQUIEL.C10 (small blind) folded before Flop
Seat 3: whtocean (big blind) showed [Kd 8d] and won ($0.74) with a pair of Kings
Seat 5: Ger Cortes folded before Flop (didn't bet)
Seat 6: Bobok1971 showed [5d Td] and lost with high card Ace



PokerStars Hand #222944239979:  Hold'em No Limit ($0.05/$0.10 USD) - 2021/01/23 23:37:42 ET
Table 'Polydoros II' 6-max Seat #2 is the button
Seat 1: Bunkiebear ($3.40 in chips) 
Seat 2: EZEQUIEL.C10 ($9.85 in chips) 
Seat 3: whtocean ($11.65 in chips) 
Seat 4: images777 ($8 in chips) 
Seat 5: Ger Cortes ($11.92 in chips) 
Seat 6: Bobok1971 ($10.64 in chips) 
whtocean: posts small blind $0.05
images777: posts big blind $0.10
*** HOLE CARDS ***
Ger Cortes: folds 
Bobok1971: folds 
Bunkiebear: folds 
EZEQUIEL.C10: raises $0.15 to $0.25
whtocean: folds 
images777: folds 
Uncalled bet ($0.15) returned to EZEQUIEL.C10
EZEQUIEL.C10 collected $0.25 from pot
EZEQUIEL.C10: doesn't show hand 
*** SUMMARY ***
Total pot $0.25 | Rake $0 
Seat 1: Bunkiebear folded before Flop (didn't bet)
Seat 2: EZEQUIEL.C10 (button) collected ($0.25)
Seat 3: whtocean (small blind) folded before Flop
Seat 4: images777 (big blind) folded before Flop
Seat 5: Ger Cortes folded before Flop (didn't bet)
Seat 6: Bobok1971 folded before Flop (didn't bet)



PokerStars Hand #222944243380:  Hold'em No Limit ($0.05/$0.10 USD) - 2021/01/23 23:37:53 ET
Table 'Polydoros II' 6-max Seat #3 is the button
Seat 1: Bunkiebear ($3.40 in chips) 
Seat 2: EZEQUIEL.C10 ($10 in chips) 
Seat 3: whtocean ($11.60 in chips) 
Seat 4: images777 ($8 in chips) 
Seat 5: Ger Cortes ($11.92 in chips) 
Seat 6: Bobok1971 ($10.64 in chips) 
images777: posts small blind $0.05
Ger Cortes: posts big blind $0.10
*** HOLE CARDS ***
Bobok1971: calls $0.10
Bunkiebear: folds 
EZEQUIEL.C10: folds 
whtocean: folds 
images777: folds 
Ger Cortes: checks 
*** FLOP *** [Jc 5c Kd]
Ger Cortes: checks 
Bobok1971: checks 
*** TURN *** [Jc 5c Kd] [9c]
Ger Cortes: checks 
Bobok1971: checks 
*** RIVER *** [Jc 5c Kd 9c] [8s]
Ger Cortes: checks 
Bobok1971: checks 
*** SHOW DOWN ***
Ger Cortes: shows [3c 7s] (high card King)
Bobok1971: shows [6d Qd] (high card King - Queen kicker)
Bobok1971 collected $0.24 from pot
*** SUMMARY ***
Total pot $0.25 | Rake $0.01 
Board [Jc 5c Kd 9c 8s]
Seat 1: Bunkiebear folded before Flop (didn't bet)
Seat 2: EZEQUIEL.C10 folded before Flop (didn't bet)
Seat 3: whtocean (button) folded before Flop (didn't bet)
Seat 4: images777 (small blind) folded before Flop
Seat 5: Ger Cortes (big blind) showed [3c 7s] and lost with high card King
Seat 6: Bobok1971 showed [6d Qd] and won ($0.24) with high card King



PokerStars Hand #222944253389:  Hold'em No Limit ($0.05/$0.10 USD) - 2021/01/23 23:38:27 ET
Table 'Polydoros II' 6-max Seat #4 is the button
Seat 1: Bunkiebear ($3.40 in chips) 
Seat 2: EZEQUIEL.C10 ($10 in chips) 
Seat 3: whtocean ($11.60 in chips) 
Seat 4: images777 ($8 in chips) 
Seat 5: Ger Cortes ($11.82 in chips) 
Seat 6: Bobok1971 ($10.78 in chips) 
Ger Cortes: posts small blind $0.05
Bobok1971: posts big blind $0.10
*** HOLE CARDS ***
Bunkiebear: calls $0.10
EZEQUIEL.C10: folds 
whtocean: folds 
images777: raises $0.35 to $0.45
Ger Cortes: folds 
Bobok1971: folds 
Bunkiebear: calls $0.35
*** FLOP *** [Js 6c 9c]
Bunkiebear: checks 
images777: bets $0.70
Bunkiebear: calls $0.70
*** TURN *** [Js 6c 9c] [8s]
Bunkiebear: checks 
images777: checks 
*** RIVER *** [Js 6c 9c 8s] [4d]
Bunkiebear: checks 
images777: checks 
*** SHOW DOWN ***
Bunkiebear: shows [Th Td] (a pair of Tens)
images777: mucks hand 
Bunkiebear collected $2.34 from pot
*** SUMMARY ***
Total pot $2.45 | Rake $0.11 
Board [Js 6c 9c 8s 4d]
Seat 1: Bunkiebear showed [Th Td] and won ($2.34) with a pair of Tens
Seat 2: EZEQUIEL.C10 folded before Flop (didn't bet)
Seat 3: whtocean folded before Flop (didn't bet)
Seat 4: images777 (button) mucked
Seat 5: Ger Cortes (small blind) folded before Flop
Seat 6: Bobok1971 (big blind) folded before Flop



PokerStars Hand #222945370374:  Hold'em No Limit ($0.05/$0.10 USD) - 2021/01/23 0:43:38 ET
Table 'Polydoros II' 6-max Seat #4 is the button
Seat 2: fish72o ($10.15 in chips) 
Seat 3: reznor1 ($9.18 in chips) 
Seat 4: Halfyard007 ($14.44 in chips) 
Seat 5: JorgeLemart ($8.96 in chips) 
Seat 6: Pablo7-Pro ($10.60 in chips) 
JorgeLemart: posts small blind $0.05
Pablo7-Pro: posts big blind $0.10
Quetlaah: sits out 
*** HOLE CARDS ***
fish72o: raises $0.15 to $0.25
reznor1: folds 
Halfyard007: folds 
JorgeLemart: folds 
Pablo7-Pro: calls $0.15
*** FLOP *** [Jh 9h 7c]
Pablo7-Pro: checks 
fish72o: checks 
*** TURN *** [Jh 9h 7c] [Ts]
Pablo7-Pro: checks 
fish72o: bets $0.35
Pablo7-Pro: calls $0.35
*** RIVER *** [Jh 9h 7c Ts] [3h]
Pablo7-Pro: checks 
fish72o: bets $0.79
Pablo7-Pro: raises $2.16 to $2.95
fish72o: calls $2.16
*** SHOW DOWN ***
Pablo7-Pro: shows [6h Ah] (a flush, Ace high)
fish72o: mucks hand 
Pablo7-Pro collected $6.83 from pot
*** SUMMARY ***
Total pot $7.15 | Rake $0.32 
Board [Jh 9h 7c Ts 3h]
Seat 2: fish72o mucked
Seat 3: reznor1 folded before Flop (didn't bet)
Seat 4: Halfyard007 (button) folded before Flop (didn't bet)
Seat 5: JorgeLemart (small blind) folded before Flop
Seat 6: Pablo7-Pro (big blind) showed [6h Ah] and won ($6.83) with a flush, Ace high



PokerStars Hand #222945384795:  Hold'em No Limit ($0.05/$0.10 USD) - 2021/01/23 0:44:34 ET
Table 'Polydoros II' 6-max Seat #5 is the button
Seat 1: Quetlaah ($13.22 in chips) 
Seat 2: fish72o ($10 in chips) 
Seat 3: reznor1 ($9.18 in chips) 
Seat 4: Halfyard007 ($14.44 in chips) 
Seat 5: JorgeLemart ($8.91 in chips) 
Seat 6: Pablo7-Pro ($13.88 in chips) 
Pablo7-Pro: posts small blind $0.05
Quetlaah: posts big blind $0.10
*** HOLE CARDS ***
fish72o: folds 
reznor1: folds 
Halfyard007: folds 
JorgeLemart: calls $0.10
Pablo7-Pro: folds 
Quetlaah: checks 
*** FLOP *** [9c Th 7s]
Quetlaah: bets $0.18
JorgeLemart: folds 
Uncalled bet ($0.18) returned to Quetlaah
Quetlaah collected $0.24 from pot
Quetlaah: doesn't show hand 
*** SUMMARY ***
Total pot $0.25 | Rake $0.01 
Board [9c Th 7s]
Seat 1: Quetlaah (big blind) collected ($0.24)
Seat 2: fish72o folded before Flop (didn't bet)
Seat 3: reznor1 folded before Flop (didn't bet)
Seat 4: Halfyard007 folded before Flop (didn't bet)
Seat 5: JorgeLemart (button) folded on the Flop
Seat 6: Pablo7-Pro (small blind) folded before Flop



PokerStars Hand #222945392366:  Hold'em No Limit ($0.05/$0.10 USD) - 2021/01/23 0:45:03 ET
Table 'Polydoros II' 6-max Seat #6 is the button
Seat 1: Quetlaah ($13.36 in chips) 
Seat 2: fish72o ($10 in chips) 
Seat 3: reznor1 ($9.18 in chips) 
Seat 4: Halfyard007 ($14.44 in chips) 
Seat 5: JorgeLemart ($8.81 in chips) 
Seat 6: Pablo7-Pro ($13.83 in chips) 
Quetlaah: posts small blind $0.05
fish72o: posts big blind $0.10
*** HOLE CARDS ***
reznor1: folds 
Halfyard007: folds 
JorgeLemart: folds 
Pablo7-Pro: raises $0.20 to $0.30
Quetlaah: folds 
JorgeLemart is disconnected 
fish72o: calls $0.20
*** FLOP *** [7d Th Kc]
fish72o: checks 
Pablo7-Pro: checks 
*** TURN *** [7d Th Kc] [Ac]
fish72o: bets $0.41
Pablo7-Pro: folds 
Uncalled bet ($0.41) returned to fish72o
fish72o collected $0.62 from pot
fish72o: doesn't show hand 
*** SUMMARY ***
Total pot $0.65 | Rake $0.03 
Board [7d Th Kc Ac]
Seat 1: Quetlaah (small blind) folded before Flop
Seat 2: fish72o (big blind) collected ($0.62)
Seat 3: reznor1 folded before Flop (didn't bet)
Seat 4: Halfyard007 folded before Flop (didn't bet)
Seat 5: JorgeLemart folded before Flop (didn't bet)
Seat 6: Pablo7-Pro (button) folded on the Turn



PokerStars Hand #222945401585:  Hold'em No Limit ($0.05/$0.10 USD) - 2021/01/23 0:45:39 ET
Table 'Polydoros II' 6-max Seat #1 is the button
Seat 1: Quetlaah ($13.31 in chips) 
Seat 2: fish72o ($10.32 in chips) 
Seat 3: reznor1 ($9.18 in chips) 
Seat 4: Halfyard007 ($14.44 in chips) 
Seat 5: JorgeLemart ($8.81 in chips) 
Seat 6: Pablo7-Pro ($13.53 in chips) 
fish72o: posts small blind $0.05
reznor1: posts big blind $0.10
*** HOLE CARDS ***
Halfyard007: folds 
JorgeLemart: folds 
Pablo7-Pro: raises $0.20 to $0.30
Quetlaah: folds 
fish72o: folds 
reznor1: folds 
Uncalled bet ($0.20) returned to Pablo7-Pro
Pablo7-Pro collected $0.25 from pot
Pablo7-Pro: doesn't show hand 
*** SUMMARY ***
Total pot $0.25 | Rake $0 
Seat 1: Quetlaah (button) folded before Flop (didn't bet)
Seat 2: fish72o (small blind) folded before Flop
Seat 3: reznor1 (big blind) folded before Flop
Seat 4: Halfyard007 folded before Flop (didn't bet)
Seat 5: JorgeLemart folded before Flop (didn't bet)
Seat 6: Pablo7-Pro collected ($0.25)



PokerStars Hand #222945408264:  Hold'em No Limit ($0.05/$0.10 USD) - 2021/01/23 0:46:05 ET
Table 'Polydoros II' 6-max Seat #2 is the button
Seat 1: Quetlaah ($13.31 in chips) 
Seat 2: fish72o ($10.27 in chips) 
Seat 3: reznor1 ($9.08 in chips) 
Seat 4: Halfyard007 ($14.44 in chips) 
Seat 5: JorgeLemart ($8.81 in chips) 
Seat 6: Pablo7-Pro ($13.68 in chips) 
reznor1: posts small blind $0.05
Halfyard007: posts big blind $0.10
*** HOLE CARDS ***
JorgeLemart: folds 
Pablo7-Pro: folds 
Quetlaah: folds 
fish72o: folds 
reznor1: calls $0.05
Halfyard007: raises $0.20 to $0.30
reznor1: calls $0.20
*** FLOP *** [7h Qh 5s]
reznor1: checks 
Halfyard007: bets $0.50
reznor1: folds 
Uncalled bet ($0.50) returned to Halfyard007
Halfyard007 collected $0.57 from pot
Halfyard007: doesn't show hand 
*** SUMMARY ***
Total pot $0.60 | Rake $0.03 
Board [7h Qh 5s]
Seat 1: Quetlaah folded before Flop (didn't bet)
Seat 2: fish72o (button) folded before Flop (didn't bet)
Seat 3: reznor1 (small blind) folded on the Flop
Seat 4: Halfyard007 (big blind) collected ($0.57)
Seat 5: JorgeLemart folded before Flop (didn't bet)
Seat 6: Pablo7-Pro folded before Flop (didn't bet)



PokerStars Hand #222945420638:  Hold'em No Limit ($0.05/$0.10 USD) - 2021/01/23 0:46:53 ET
Table 'Polydoros II' 6-max Seat #3 is the button
Seat 1: Quetlaah ($13.31 in chips) 
Seat 2: fish72o ($10.27 in chips) 
Seat 3: reznor1 ($8.78 in chips) 
Seat 4: Halfyard007 ($14.71 in chips) 
Seat 5: JorgeLemart ($8.81 in chips) 
Seat 6: Pablo7-Pro ($13.68 in chips) 
Halfyard007: posts small blind $0.05
JorgeLemart: posts big blind $0.10
*** HOLE CARDS ***
Pablo7-Pro: folds 
Quetlaah: raises $0.20 to $0.30
fish72o: folds 
reznor1: folds 
Halfyard007: folds 
JorgeLemart: folds 
Uncalled bet ($0.20) returned to Quetlaah
Quetlaah collected $0.25 from pot
Quetlaah: doesn't show hand 
*** SUMMARY ***
Total pot $0.25 | Rake $0 
Seat 1: Quetlaah collected ($0.25)
Seat 2: fish72o folded before Flop (didn't bet)
Seat 3: reznor1 (button) folded before Flop (didn't bet)
Seat 4: Halfyard007 (small blind) folded before Flop
Seat 5: JorgeLemart (big blind) folded before Flop
Seat 6: Pablo7-Pro folded before Flop (didn't bet)



PokerStars Hand #222945423238:  Hold'em No Limit ($0.05/$0.10 USD) - 2021/01/23 0:47:03 ET
Table 'Polydoros II' 6-max Seat #4 is the button
Seat 1: Quetlaah ($13.46 in chips) 
Seat 2: fish72o ($10.27 in chips) 
Seat 3: reznor1 ($8.78 in chips) 
Seat 4: Halfyard007 ($14.66 in chips) 
Seat 5: JorgeLemart ($8.71 in chips) 
Seat 6: Pablo7-Pro ($13.68 in chips) 
JorgeLemart: posts small blind $0.05
Pablo7-Pro: posts big blind $0.10
*** HOLE CARDS ***
Quetlaah: folds 
fish72o: folds 
reznor1: raises $0.40 to $0.50
Halfyard007: calls $0.50
JorgeLemart: folds 
Pablo7-Pro: folds 
*** FLOP *** [9d Js Ts]
reznor1: bets $0.55
Halfyard007: calls $0.55
*** TURN *** [9d Js Ts] [6c]
reznor1: bets $1.08
Halfyard007: folds 
Uncalled bet ($1.08) returned to reznor1
reznor1 collected $2.15 from pot
*** SUMMARY ***
Total pot $2.25 | Rake $0.10 
Board [9d Js Ts 6c]
Seat 1: Quetlaah folded before Flop (didn't bet)
Seat 2: fish72o folded before Flop (didn't bet)
Seat 3: reznor1 collected ($2.15)
Seat 4: Halfyard007 (button) folded on the Turn
Seat 5: JorgeLemart (small blind) folded before Flop
Seat 6: Pablo7-Pro (big blind) folded before Flop



PokerStars Hand #222945435190:  Hold'em No Limit ($0.05/$0.10 USD) - 2021/01/23 0:47:50 ET
Table 'Polydoros II' 6-max Seat #5 is the button
Seat 1: Quetlaah ($13.46 in chips) 
Seat 2: fish72o ($10.27 in chips) 
Seat 3: reznor1 ($9.88 in chips) 
Seat 4: Halfyard007 ($13.61 in chips) 
Seat 5: JorgeLemart ($8.66 in chips) 
Seat 6: Pablo7-Pro ($13.58 in chips) 
Pablo7-Pro: posts small blind $0.05
Quetlaah: posts big blind $0.10
*** HOLE CARDS ***
fish72o: folds 
reznor1: raises $0.20 to $0.30
Halfyard007: folds 
JorgeLemart: folds 
Pablo7-Pro: folds 
Quetlaah: folds 
Uncalled bet ($0.20) returned to reznor1
reznor1 collected $0.25 from pot
*** SUMMARY ***
Total pot $0.25 | Rake $0 
Seat 1: Quetlaah (big blind) folded before Flop
Seat 2: fish72o folded before Flop (didn't bet)
Seat 3: reznor1 collected ($0.25)
Seat 4: Halfyard007 folded before Flop (didn't bet)
Seat 5: JorgeLemart (button) folded before Flop (didn't bet)
Seat 6: Pablo7-Pro (small blind) folded before Flop



PokerStars Hand #222945439212:  Hold'em No Limit ($0.05/$0.10 USD) - 2021/01/23 0:48:06 ET
Table 'Polydoros II' 6-max Seat #6 is the button
Seat 1: Quetlaah ($13.36 in chips) 
Seat 2: fish72o ($10.27 in chips) 
Seat 3: reznor1 ($10.03 in chips) 
Seat 4: Halfyard007 ($13.61 in chips) 
Seat 5: JorgeLemart ($8.66 in chips) 
Seat 6: Pablo7-Pro ($13.53 in chips) 
Quetlaah: posts small blind $0.05
fish72o: posts big blind $0.10
*** HOLE CARDS ***
reznor1: calls $0.10
Halfyard007: folds 
JorgeLemart: folds 
Pablo7-Pro: folds 
Quetlaah: folds 
fish72o: checks 
*** FLOP *** [5c 7d 6s]
fish72o: checks 
reznor1: checks 
*** TURN *** [5c 7d 6s] [2c]
fish72o: checks 
reznor1: bets $0.10
fish72o: calls $0.10
*** RIVER *** [5c 7d 6s 2c] [9h]
fish72o: checks 
reznor1: bets $0.10
fish72o: calls $0.10
*** SHOW DOWN ***
reznor1: shows [Jd 9s] (a pair of Nines)
fish72o: mucks hand 
reznor1 collected $0.62 from pot
*** SUMMARY ***
Total pot $0.65 | Rake $0.03 
Board [5c 7d 6s 2c 9h]
Seat 1: Quetlaah (small blind) folded before Flop
Seat 2: fish72o (big blind) mucked
Seat 3: reznor1 showed [Jd 9s] and won ($0.62) with a pair of Nines
Seat 4: Halfyard007 folded before Flop (didn't bet)
Seat 5: JorgeLemart folded before Flop (didn't bet)
Seat 6: Pablo7-Pro (button) folded before Flop (didn't bet)



PokerStars Hand #222945448483:  Hold'em No Limit ($0.05/$0.10 USD) - 2021/01/23 0:48:42 ET
Table 'Polydoros II' 6-max Seat #1 is the button
Seat 1: Quetlaah ($13.31 in chips) 
Seat 2: fish72o ($10 in chips) 
Seat 3: reznor1 ($10.35 in chips) 
Seat 4: Halfyard007 ($13.61 in chips) 
Seat 5: JorgeLemart ($8.66 in chips) 
Seat 6: Pablo7-Pro ($13.53 in chips) 
fish72o: posts small blind $0.05
reznor1: posts big blind $0.10
*** HOLE CARDS ***
Halfyard007: calls $0.10
JorgeLemart: folds 
Pablo7-Pro: folds 
Quetlaah: folds 
fish72o: folds 
reznor1: checks 
*** FLOP *** [2d Kh 4c]
reznor1: checks 
Halfyard007: checks 
*** TURN *** [2d Kh 4c] [9d]
reznor1: checks 
Halfyard007: checks 
*** RIVER *** [2d Kh 4c 9d] [5s]
reznor1: bets $0.24
Halfyard007: folds 
Uncalled bet ($0.24) returned to reznor1
reznor1 collected $0.24 from pot
*** SUMMARY ***
Total pot $0.25 | Rake $0.01 
Board [2d Kh 4c 9d 5s]
Seat 1: Quetlaah (button) folded before Flop (didn't bet)
Seat 2: fish72o (small blind) folded before Flop
Seat 3: reznor1 (big blind) collected ($0.24)
Seat 4: Halfyard007 folded on the River
Seat 5: JorgeLemart folded before Flop (didn't bet)
Seat 6: Pablo7-Pro folded before Flop (didn't bet)



PokerStars Hand #222945458243:  Hold'em No Limit ($0.05/$0.10 USD) - 2021/01/23 0:49:20 ET
Table 'Polydoros II' 6-max Seat #2 is the button
Seat 1: Quetlaah ($13.31 in chips) 
Seat 2: fish72o ($10 in chips) 
Seat 3: reznor1 ($10.49 in chips) 
Seat 4: Halfyard007 ($13.51 in chips) 
Seat 5: JorgeLemart ($8.66 in chips) 
Seat 6: Pablo7-Pro ($13.53 in chips) 
reznor1: posts small blind $0.05
Halfyard007: posts big blind $0.10
*** HOLE CARDS ***
JorgeLemart: calls $0.10
Pablo7-Pro: folds 
Quetlaah: folds 
fish72o: folds 
reznor1: calls $0.05
Halfyard007: checks 
*** FLOP *** [As 5d Kh]
reznor1: bets $0.15
Halfyard007: folds 
JorgeLemart: raises $0.35 to $0.50
reznor1: calls $0.35
*** TURN *** [As 5d Kh] [3c]
reznor1: checks 
JorgeLemart: bets $0.80
reznor1: calls $0.80
*** RIVER *** [As 5d Kh 3c] [Ad]
reznor1: checks 
JorgeLemart: bets $1.50
reznor1: raises $1.50 to $3
JorgeLemart: folds 
Uncalled bet ($1.50) returned to reznor1
reznor1 collected $5.63 from pot
*** SUMMARY ***
Total pot $5.90 | Rake $0.27 
Board [As 5d Kh 3c Ad]
Seat 1: Quetlaah folded before Flop (didn't bet)
Seat 2: fish72o (button) folded before Flop (didn't bet)
Seat 3: reznor1 (small blind) collected ($5.63)
Seat 4: Halfyard007 (big blind) folded on the Flop
Seat 5: JorgeLemart folded on the River
Seat 6: Pablo7-Pro folded before Flop (didn't bet)



PokerStars Hand #222945479487:  Hold'em No Limit ($0.05/$0.10 USD) - 2021/01/23 0:50:44 ET
Table 'Polydoros II' 6-max Seat #3 is the button
Seat 1: Quetlaah ($13.31 in chips) 
Seat 2: fish72o ($10 in chips) 
Seat 3: reznor1 ($13.22 in chips) 
Seat 4: Halfyard007 ($13.41 in chips) 
Seat 5: JorgeLemart ($5.76 in chips) 
Seat 6: Pablo7-Pro ($13.53 in chips) 
Halfyard007: posts small blind $0.05
JorgeLemart: posts big blind $0.10
*** HOLE CARDS ***
Pablo7-Pro: folds 
Quetlaah: folds 
fish72o: folds 
reznor1: calls $0.10
Halfyard007: folds 
JorgeLemart: checks 
*** FLOP *** [9s Kd 6d]
JorgeLemart: checks 
reznor1: checks 
*** TURN *** [9s Kd 6d] [Jc]
JorgeLemart: bets $0.30
reznor1: raises $0.40 to $0.70
JorgeLemart: calls $0.40
*** RIVER *** [9s Kd 6d Jc] [2s]
JorgeLemart: checks 
reznor1: bets $0.80
JorgeLemart: folds 
Uncalled bet ($0.80) returned to reznor1
reznor1 collected $1.58 from pot
*** SUMMARY ***
Total pot $1.65 | Rake $0.07 
Board [9s Kd 6d Jc 2s]
Seat 1: Quetlaah folded before Flop (didn't bet)
Seat 2: fish72o folded before Flop (didn't bet)
Seat 3: reznor1 (button) collected ($1.58)
Seat 4: Halfyard007 (small blind) folded before Flop
Seat 5: JorgeLemart (big blind) folded on the River
Seat 6: Pablo7-Pro folded before Flop (didn't bet)



PokerStars Hand #222945491803:  Hold'em No Limit ($0.05/$0.10 USD) - 2021/01/23 0:51:33 ET
Table 'Polydoros II' 6-max Seat #4 is the button
Seat 1: Quetlaah ($13.31 in chips) 
Seat 2: fish72o ($10 in chips) 
Seat 3: reznor1 ($14 in chips) 
Seat 4: Halfyard007 ($13.36 in chips) 
Seat 5: JorgeLemart ($4.96 in chips) 
Seat 6: Pablo7-Pro ($13.53 in chips) 
JorgeLemart: posts small blind $0.05
Pablo7-Pro: posts big blind $0.10
*** HOLE CARDS ***
Quetlaah: folds 
fish72o: folds 
reznor1: calls $0.10
Halfyard007 has timed out
Halfyard007: folds 
JorgeLemart: folds 
Pablo7-Pro: checks 
*** FLOP *** [2h 8s 4c]
Pablo7-Pro: bets $0.19
reznor1: calls $0.19
*** TURN *** [2h 8s 4c] [Jc]
Pablo7-Pro: checks 
reznor1: checks 
*** RIVER *** [2h 8s 4c Jc] [Tc]
Pablo7-Pro: checks 
reznor1: checks 
*** SHOW DOWN ***
Pablo7-Pro: shows [Kc 8d] (a pair of Eights)
reznor1: mucks hand 
Pablo7-Pro collected $0.60 from pot
*** SUMMARY ***
Total pot $0.63 | Rake $0.03 
Board [2h 8s 4c Jc Tc]
Seat 1: Quetlaah folded before Flop (didn't bet)
Seat 2: fish72o folded before Flop (didn't bet)
Seat 3: reznor1 mucked
Seat 4: Halfyard007 (button) folded before Flop (didn't bet)
Seat 5: JorgeLemart (small blind) folded before Flop
Seat 6: Pablo7-Pro (big blind) showed [Kc 8d] and won ($0.60) with a pair of Eights



PokerStars Hand #222945505973:  Hold'em No Limit ($0.05/$0.10 USD) - 2021/01/23 0:52:28 ET
Table 'Polydoros II' 6-max Seat #5 is the button
Seat 1: Quetlaah ($13.31 in chips) 
Seat 2: fish72o ($10 in chips) 
Seat 3: reznor1 ($13.71 in chips) 
Seat 4: Halfyard007 ($13.36 in chips) 
Seat 5: JorgeLemart ($4.91 in chips) 
Seat 6: Pablo7-Pro ($13.84 in chips) 
Pablo7-Pro: posts small blind $0.05
Quetlaah: posts big blind $0.10
*** HOLE CARDS ***
fish72o: folds 
reznor1: calls $0.10
Halfyard007: raises $0.20 to $0.30
JorgeLemart: folds 
Pablo7-Pro: folds 
Quetlaah: folds 
reznor1: calls $0.20
*** FLOP *** [2d 7c Qs]
reznor1: bets $0.36
Halfyard007: calls $0.36
*** TURN *** [2d 7c Qs] [8c]
reznor1: bets $0.80
Halfyard007: folds 
Uncalled bet ($0.80) returned to reznor1
reznor1 collected $1.40 from pot
*** SUMMARY ***
Total pot $1.47 | Rake $0.07 
Board [2d 7c Qs 8c]
Seat 1: Quetlaah (big blind) folded before Flop
Seat 2: fish72o folded before Flop (didn't bet)
Seat 3: reznor1 collected ($1.40)
Seat 4: Halfyard007 folded on the Turn
Seat 5: JorgeLemart (button) folded before Flop (didn't bet)
Seat 6: Pablo7-Pro (small blind) folded before Flop



PokerStars Hand #222945523856:  Hold'em No Limit ($0.05/$0.10 USD) - 2021/01/23 0:53:10 ET
Table 'Polydoros II' 6-max Seat #6 is the button
Seat 1: Quetlaah ($13.21 in chips) 
Seat 2: fish72o ($10 in chips) 
Seat 3: reznor1 ($14.45 in chips) 
Seat 4: Halfyard007 ($12.70 in chips) 
Seat 5: JorgeLemart ($4.91 in chips) 
Seat 6: Pablo7-Pro ($13.79 in chips) 
Quetlaah: posts small blind $0.05
fish72o: posts big blind $0.10
*** HOLE CARDS ***
reznor1: folds 
Halfyard007: folds 
JorgeLemart: raises $0.30 to $0.40
Pablo7-Pro: folds 
Quetlaah: folds 
fish72o: folds 
Uncalled bet ($0.30) returned to JorgeLemart
JorgeLemart collected $0.25 from pot
JorgeLemart: doesn't show hand 
*** SUMMARY ***
Total pot $0.25 | Rake $0 
Seat 1: Quetlaah (small blind) folded before Flop
Seat 2: fish72o (big blind) folded before Flop
Seat 3: reznor1 folded before Flop (didn't bet)
Seat 4: Halfyard007 folded before Flop (didn't bet)
Seat 5: JorgeLemart collected ($0.25)
Seat 6: Pablo7-Pro (button) folded before Flop (didn't bet)



PokerStars Hand #222945529342:  Hold'em No Limit ($0.05/$0.10 USD) - 2021/01/23 0:53:32 ET
Table 'Polydoros II' 6-max Seat #1 is the button
Seat 1: Quetlaah ($13.16 in chips) 
Seat 2: fish72o ($10 in chips) 
Seat 3: reznor1 ($14.45 in chips) 
Seat 4: Halfyard007 ($12.70 in chips) 
Seat 5: JorgeLemart ($5.06 in chips) 
Seat 6: Pablo7-Pro ($13.79 in chips) 
fish72o: posts small blind $0.05
reznor1: posts big blind $0.10
*** HOLE CARDS ***
Halfyard007: raises $0.20 to $0.30
JorgeLemart: calls $0.30
Pablo7-Pro: folds 
Quetlaah: folds 
fish72o: folds 
reznor1: calls $0.20
*** FLOP *** [7h Ks Th]
reznor1: checks 
Halfyard007: checks 
JorgeLemart: checks 
*** TURN *** [7h Ks Th] [Js]
reznor1: checks 
Halfyard007: checks 
JorgeLemart: bets $0.60
reznor1: folds 
Halfyard007: calls $0.60
*** RIVER *** [7h Ks Th Js] [Jh]
Halfyard007: bets $0.90
JorgeLemart: folds 
Uncalled bet ($0.90) returned to Halfyard007
Halfyard007 collected $2.05 from pot
Halfyard007: doesn't show hand 
*** SUMMARY ***
Total pot $2.15 | Rake $0.10 
Board [7h Ks Th Js Jh]
Seat 1: Quetlaah (button) folded before Flop (didn't bet)
Seat 2: fish72o (small blind) folded before Flop
Seat 3: reznor1 (big blind) folded on the Turn
Seat 4: Halfyard007 collected ($2.05)
Seat 5: JorgeLemart folded on the River
Seat 6: Pablo7-Pro folded before Flop (didn't bet)



PokerStars Hand #222945548642:  Hold'em No Limit ($0.05/$0.10 USD) - 2021/01/23 0:54:49 ET
Table 'Polydoros II' 6-max Seat #2 is the button
Seat 1: Quetlaah ($13.16 in chips) 
Seat 2: fish72o ($10 in chips) 
Seat 3: reznor1 ($14.15 in chips) 
Seat 4: Halfyard007 ($13.85 in chips) 
Seat 5: JorgeLemart ($4.16 in chips) 
Seat 6: Pablo7-Pro ($13.79 in chips) 
reznor1: posts small blind $0.05
Halfyard007: posts big blind $0.10
*** HOLE CARDS ***
JorgeLemart: folds 
Pablo7-Pro: folds 
Quetlaah: folds 
fish72o: raises $0.15 to $0.25
reznor1: folds 
Halfyard007: calls $0.15
*** FLOP *** [Td 8s Jh]
Halfyard007: checks 
fish72o: bets $0.35
Halfyard007: folds 
Uncalled bet ($0.35) returned to fish72o
fish72o collected $0.53 from pot
fish72o: doesn't show hand 
*** SUMMARY ***
Total pot $0.55 | Rake $0.02 
Board [Td 8s Jh]
Seat 1: Quetlaah folded before Flop (didn't bet)
Seat 2: fish72o (button) collected ($0.53)
Seat 3: reznor1 (small blind) folded before Flop
Seat 4: Halfyard007 (big blind) folded on the Flop
Seat 5: JorgeLemart folded before Flop (didn't bet)
Seat 6: Pablo7-Pro folded before Flop (didn't bet)



PokerStars Hand #222945555470:  Hold'em No Limit ($0.05/$0.10 USD) - 2021/01/23 0:55:19 ET
Table 'Polydoros II' 6-max Seat #3 is the button
Seat 1: Quetlaah ($13.16 in chips) 
Seat 2: fish72o ($10.28 in chips) 
Seat 3: reznor1 ($14.10 in chips) 
Seat 4: Halfyard007 ($13.60 in chips) 
Seat 5: JorgeLemart ($4.16 in chips) 
Seat 6: Pablo7-Pro ($13.79 in chips) 
Halfyard007: posts small blind $0.05
JorgeLemart: posts big blind $0.10
*** HOLE CARDS ***
Pablo7-Pro: folds 
Quetlaah: raises $0.20 to $0.30
fish72o: folds 
reznor1: folds 
Halfyard007: folds 
JorgeLemart: folds 
Uncalled bet ($0.20) returned to Quetlaah
Quetlaah collected $0.25 from pot
Quetlaah: doesn't show hand 
*** SUMMARY ***
Total pot $0.25 | Rake $0 
Seat 1: Quetlaah collected ($0.25)
Seat 2: fish72o folded before Flop (didn't bet)
Seat 3: reznor1 (button) folded before Flop (didn't bet)
Seat 4: Halfyard007 (small blind) folded before Flop
Seat 5: JorgeLemart (big blind) folded before Flop
Seat 6: Pablo7-Pro folded before Flop (didn't bet)



PokerStars Hand #222945558305:  Hold'em No Limit ($0.05/$0.10 USD) - 2021/01/23 0:55:33 ET
Table 'Polydoros II' 6-max Seat #4 is the button
Seat 1: Quetlaah ($13.31 in chips) 
Seat 2: fish72o ($10.28 in chips) 
Seat 3: reznor1 ($14.10 in chips) 
Seat 4: Halfyard007 ($13.55 in chips) 
Seat 5: JorgeLemart ($4.06 in chips) 
Seat 6: Pablo7-Pro ($13.79 in chips) 
JorgeLemart: posts small blind $0.05
Pablo7-Pro: posts big blind $0.10
*** HOLE CARDS ***
Quetlaah: raises $0.20 to $0.30
fish72o: folds 
reznor1: folds 
Halfyard007: calls $0.30
JorgeLemart: folds 
Pablo7-Pro: folds 
*** FLOP *** [Td 9h 6h]
Quetlaah: checks 
Halfyard007: bets $0.30
Quetlaah: calls $0.30
*** TURN *** [Td 9h 6h] [3h]
Quetlaah: checks 
Halfyard007: bets $0.40
Quetlaah: calls $0.40
*** RIVER *** [Td 9h 6h 3h] [8c]
Quetlaah: checks 
Halfyard007: bets $0.40
Quetlaah: calls $0.40
*** SHOW DOWN ***
Halfyard007: shows [Ad 2h] (high card Ace)
Quetlaah: shows [Kh Ac] (high card Ace - King kicker)
Quetlaah collected $2.82 from pot
*** SUMMARY ***
Total pot $2.95 | Rake $0.13 
Board [Td 9h 6h 3h 8c]
Seat 1: Quetlaah showed [Kh Ac] and won ($2.82) with high card Ace
Seat 2: fish72o folded before Flop (didn't bet)
Seat 3: reznor1 folded before Flop (didn't bet)
Seat 4: Halfyard007 (button) showed [Ad 2h] and lost with high card Ace
Seat 5: JorgeLemart (small blind) folded before Flop
Seat 6: Pablo7-Pro (big blind) folded before Flop



PokerStars Hand #222945573200:  Hold'em No Limit ($0.05/$0.10 USD) - 2021/01/23 0:56:48 ET
Table 'Polydoros II' 6-max Seat #5 is the button
Seat 1: Quetlaah ($14.73 in chips) 
Seat 2: fish72o ($10.28 in chips) 
Seat 3: reznor1 ($14.10 in chips) 
Seat 4: Halfyard007 ($12.15 in chips) 
Seat 5: JorgeLemart ($4.01 in chips) 
Seat 6: Pablo7-Pro ($13.69 in chips) 
Pablo7-Pro: posts small blind $0.05
Quetlaah: posts big blind $0.10
*** HOLE CARDS ***
fish72o: folds 
reznor1: calls $0.10
Halfyard007: calls $0.10
JorgeLemart: calls $0.10
Pablo7-Pro: folds 
Quetlaah: checks 
*** FLOP *** [6s 2d 2c]
Quetlaah: checks 
reznor1: bets $0.22
Halfyard007: folds 
JorgeLemart: folds 
Quetlaah: folds 
Uncalled bet ($0.22) returned to reznor1
reznor1 collected $0.43 from pot
*** SUMMARY ***
Total pot $0.45 | Rake $0.02 
Board [6s 2d 2c]
Seat 1: Quetlaah (big blind) folded on the Flop
Seat 2: fish72o folded before Flop (didn't bet)
Seat 3: reznor1 collected ($0.43)
Seat 4: Halfyard007 folded on the Flop
Seat 5: JorgeLemart (button) folded on the Flop
Seat 6: Pablo7-Pro (small blind) folded before Flop



PokerStars Hand #222945578618:  Hold'em No Limit ($0.05/$0.10 USD) - 2021/01/23 0:57:16 ET
Table 'Polydoros II' 6-max Seat #6 is the button
Seat 1: Quetlaah ($14.63 in chips) 
Seat 2: fish72o ($10.28 in chips) 
Seat 3: reznor1 ($14.43 in chips) 
Seat 4: Halfyard007 ($12.05 in chips) 
Seat 5: JorgeLemart ($3.91 in chips) 
Seat 6: Pablo7-Pro ($13.64 in chips) 
Quetlaah: posts small blind $0.05
fish72o: posts big blind $0.10
*** HOLE CARDS ***
reznor1: calls $0.10
Halfyard007: raises $0.20 to $0.30
JorgeLemart: folds 
Pablo7-Pro: calls $0.30
Quetlaah: calls $0.25
fish72o: folds 
reznor1: calls $0.20
*** FLOP *** [As Kd 5d]
Quetlaah: checks 
reznor1: checks 
Halfyard007: bets $0.30
Pablo7-Pro: calls $0.30
Quetlaah: calls $0.30
reznor1: calls $0.30
*** TURN *** [As Kd 5d] [9s]
Quetlaah: checks 
reznor1: checks 
Halfyard007: checks 
Pablo7-Pro: checks 
*** RIVER *** [As Kd 5d 9s] [4h]
Quetlaah: checks 
reznor1: checks 
Halfyard007: bets $0.50
Pablo7-Pro: folds 
Quetlaah: folds 
reznor1: folds 
Uncalled bet ($0.50) returned to Halfyard007
Halfyard007 collected $2.39 from pot
Halfyard007: doesn't show hand 
*** SUMMARY ***
Total pot $2.50 | Rake $0.11 
Board [As Kd 5d 9s 4h]
Seat 1: Quetlaah (small blind) folded on the River
Seat 2: fish72o (big blind) folded before Flop
Seat 3: reznor1 folded on the River
Seat 4: Halfyard007 collected ($2.39)
Seat 5: JorgeLemart folded before Flop (didn't bet)
Seat 6: Pablo7-Pro (button) folded on the River



PokerStars Hand #222945593659:  Hold'em No Limit ($0.05/$0.10 USD) - 2021/01/23 0:58:31 ET
Table 'Polydoros II' 6-max Seat #1 is the button
Seat 1: Quetlaah ($14.03 in chips) 
Seat 2: fish72o ($10.18 in chips) 
Seat 3: reznor1 ($13.83 in chips) 
Seat 4: Halfyard007 ($13.84 in chips) 
Seat 5: JorgeLemart ($3.91 in chips) 
Seat 6: Pablo7-Pro ($13.04 in chips) 
fish72o: posts small blind $0.05
reznor1: posts big blind $0.10
*** HOLE CARDS ***
Halfyard007: folds 
JorgeLemart: folds 
Pablo7-Pro: folds 
Quetlaah has timed out
Quetlaah: folds 
fish72o: raises $0.15 to $0.25
reznor1: folds 
Uncalled bet ($0.15) returned to fish72o
fish72o collected $0.20 from pot
fish72o: doesn't show hand 
*** SUMMARY ***
Total pot $0.20 | Rake $0 
Seat 1: Quetlaah (button) folded before Flop (didn't bet)
Seat 2: fish72o (small blind) collected ($0.20)
Seat 3: reznor1 (big blind) folded before Flop
Seat 4: Halfyard007 folded before Flop (didn't bet)
Seat 5: JorgeLemart folded before Flop (didn't bet)
Seat 6: Pablo7-Pro folded before Flop (didn't bet)



PokerStars Hand #222945599775:  Hold'em No Limit ($0.05/$0.10 USD) - 2021/01/23 0:59:01 ET
Table 'Polydoros II' 6-max Seat #2 is the button
Seat 1: Quetlaah ($14.03 in chips) 
Seat 2: fish72o ($10.28 in chips) 
Seat 3: reznor1 ($13.73 in chips) 
Seat 4: Halfyard007 ($13.84 in chips) 
Seat 5: JorgeLemart ($3.91 in chips) 
Seat 6: Pablo7-Pro ($13.04 in chips) 
reznor1: posts small blind $0.05
Halfyard007: posts big blind $0.10
*** HOLE CARDS ***
JorgeLemart is disconnected 
JorgeLemart has timed out while disconnected
JorgeLemart: folds 
Pablo7-Pro: raises $0.20 to $0.30
Quetlaah: folds 
fish72o: calls $0.30
reznor1: calls $0.25
Halfyard007: calls $0.20
*** FLOP *** [6c 2d 2c]
reznor1: bets $0.58
Halfyard007: folds 
Pablo7-Pro: folds 
fish72o: folds 
Uncalled bet ($0.58) returned to reznor1
reznor1 collected $1.15 from pot
*** SUMMARY ***
Total pot $1.20 | Rake $0.05 
Board [6c 2d 2c]
Seat 1: Quetlaah folded before Flop (didn't bet)
Seat 2: fish72o (button) folded on the Flop
Seat 3: reznor1 (small blind) collected ($1.15)
Seat 4: Halfyard007 (big blind) folded on the Flop
Seat 5: JorgeLemart folded before Flop (didn't bet)
Seat 6: Pablo7-Pro folded on the Flop



PokerStars Hand #222945609861:  Hold'em No Limit ($0.05/$0.10 USD) - 2021/01/23 0:59:52 ET
Table 'Polydoros II' 6-max Seat #3 is the button
Seat 1: Quetlaah ($14.03 in chips) 
Seat 2: fish72o ($10 in chips) 
Seat 3: reznor1 ($14.58 in chips) 
Seat 4: Halfyard007 ($13.54 in chips) 
Seat 6: Pablo7-Pro ($12.74 in chips) 
Halfyard007: posts small blind $0.05
Pablo7-Pro: posts big blind $0.10
*** HOLE CARDS ***
Quetlaah: folds 
fish72o: folds 
reznor1: calls $0.10
Halfyard007: raises $0.40 to $0.50
Pablo7-Pro: calls $0.40
reznor1: folds 
*** FLOP *** [8c 2h 8d]
Halfyard007: bets $0.40
Pablo7-Pro: calls $0.40
*** TURN *** [8c 2h 8d] [Td]
Halfyard007: bets $0.40
Pablo7-Pro: calls $0.40
*** RIVER *** [8c 2h 8d Td] [3s]
Halfyard007: checks 
Pablo7-Pro: checks 
*** SHOW DOWN ***
Halfyard007: shows [As Kc] (a pair of Eights)
Pablo7-Pro: shows [4d 4h] (two pair, Eights and Fours)
Pablo7-Pro collected $2.58 from pot
*** SUMMARY ***
Total pot $2.70 | Rake $0.12 
Board [8c 2h 8d Td 3s]
Seat 1: Quetlaah folded before Flop (didn't bet)
Seat 2: fish72o folded before Flop (didn't bet)
Seat 3: reznor1 (button) folded before Flop
Seat 4: Halfyard007 (small blind) showed [As Kc] and lost with a pair of Eights
Seat 6: Pablo7-Pro (big blind) showed [4d 4h] and won ($2.58) with two pair, Eights and Fours



PokerStars Hand #222945622737:  Hold'em No Limit ($0.05/$0.10 USD) - 2021/01/23 1:00:49 ET
Table 'Polydoros II' 6-max Seat #4 is the button
Seat 1: Quetlaah ($14.03 in chips) 
Seat 2: fish72o ($10 in chips) 
Seat 3: reznor1 ($14.48 in chips) 
Seat 4: Halfyard007 ($12.24 in chips) 
Seat 6: Pablo7-Pro ($14.02 in chips) 
Pablo7-Pro: posts small blind $0.05
Quetlaah: posts big blind $0.10
*** HOLE CARDS ***
fish72o: folds 
reznor1: folds 
Halfyard007: folds 
Pablo7-Pro: raises $0.20 to $0.30
Quetlaah: folds 
Uncalled bet ($0.20) returned to Pablo7-Pro
Pablo7-Pro collected $0.20 from pot
Pablo7-Pro: doesn't show hand 
*** SUMMARY ***
Total pot $0.20 | Rake $0 
Seat 1: Quetlaah (big blind) folded before Flop
Seat 2: fish72o folded before Flop (didn't bet)
Seat 3: reznor1 folded before Flop (didn't bet)
Seat 4: Halfyard007 (button) folded before Flop (didn't bet)
Seat 6: Pablo7-Pro (small blind) collected ($0.20)



PokerStars Hand #222945628893:  Hold'em No Limit ($0.05/$0.10 USD) - 2021/01/23 1:01:15 ET
Table 'Polydoros II' 6-max Seat #6 is the button
Seat 1: Quetlaah ($13.93 in chips) 
Seat 2: fish72o ($10 in chips) 
Seat 3: reznor1 ($14.48 in chips) 
Seat 4: Halfyard007 ($12.24 in chips) 
Seat 6: Pablo7-Pro ($14.12 in chips) 
Quetlaah: posts small blind $0.05
fish72o: posts big blind $0.10
*** HOLE CARDS ***
reznor1: calls $0.10
Halfyard007: folds 
Pablo7-Pro: folds 
Quetlaah: folds 
fish72o: checks 
*** FLOP *** [8s 9c Kc]
fish72o: checks 
reznor1: bets $0.12
fish72o: folds 
Uncalled bet ($0.12) returned to reznor1
reznor1 collected $0.24 from pot
*** SUMMARY ***
Total pot $0.25 | Rake $0.01 
Board [8s 9c Kc]
Seat 1: Quetlaah (small blind) folded before Flop
Seat 2: fish72o (big blind) folded on the Flop
Seat 3: reznor1 collected ($0.24)
Seat 4: Halfyard007 folded before Flop (didn't bet)
Seat 6: Pablo7-Pro (button) folded before Flop (didn't bet)



PokerStars Hand #222945633680:  Hold'em No Limit ($0.05/$0.10 USD) - 2021/01/23 1:01:35 ET
Table 'Polydoros II' 6-max Seat #1 is the button
Seat 1: Quetlaah ($13.88 in chips) 
Seat 2: fish72o ($10 in chips) 
Seat 3: reznor1 ($14.62 in chips) 
Seat 4: Halfyard007 ($12.24 in chips) 
Seat 6: Pablo7-Pro ($14.12 in chips) 
fish72o: posts small blind $0.05
reznor1: posts big blind $0.10
*** HOLE CARDS ***
Halfyard007: calls $0.10
Pablo7-Pro: folds 
Quetlaah: folds 
fish72o: raises $0.15 to $0.25
reznor1: folds 
Halfyard007: raises $0.35 to $0.60
fish72o: folds 
Uncalled bet ($0.35) returned to Halfyard007
Halfyard007 collected $0.60 from pot
Halfyard007: doesn't show hand 
*** SUMMARY ***
Total pot $0.60 | Rake $0 
Seat 1: Quetlaah (button) folded before Flop (didn't bet)
Seat 2: fish72o (small blind) folded before Flop
Seat 3: reznor1 (big blind) folded before Flop
Seat 4: Halfyard007 collected ($0.60)
Seat 6: Pablo7-Pro folded before Flop (didn't bet)



PokerStars Hand #222945639942:  Hold'em No Limit ($0.05/$0.10 USD) - 2021/01/23 1:02:01 ET
Table 'Polydoros II' 6-max Seat #2 is the button
Seat 1: Quetlaah ($13.88 in chips) 
Seat 2: fish72o ($10 in chips) 
Seat 3: reznor1 ($14.52 in chips) 
Seat 4: Halfyard007 ($12.59 in chips) 
Seat 6: Pablo7-Pro ($14.12 in chips) 
reznor1: posts small blind $0.05
Halfyard007: posts big blind $0.10
*** HOLE CARDS ***
Pablo7-Pro: folds 
Quetlaah: folds 
fish72o: folds 
reznor1: calls $0.05
Halfyard007: checks 
*** FLOP *** [Qs 5h 9s]
reznor1: checks 
Halfyard007: bets $0.20
reznor1: calls $0.20
*** TURN *** [Qs 5h 9s] [5d]
reznor1: bets $0.17
Halfyard007: raises $0.17 to $0.34
reznor1: calls $0.17
*** RIVER *** [Qs 5h 9s 5d] [Ks]
reznor1: checks 
Halfyard007: bets $0.40
reznor1: folds 
Uncalled bet ($0.40) returned to Halfyard007
Halfyard007 collected $1.22 from pot
Halfyard007: doesn't show hand 
*** SUMMARY ***
Total pot $1.28 | Rake $0.06 
Board [Qs 5h 9s 5d Ks]
Seat 1: Quetlaah folded before Flop (didn't bet)
Seat 2: fish72o (button) folded before Flop (didn't bet)
Seat 3: reznor1 (small blind) folded on the River
Seat 4: Halfyard007 (big blind) collected ($1.22)
Seat 6: Pablo7-Pro folded before Flop (didn't bet)



PokerStars Hand #222945654896:  Hold'em No Limit ($0.05/$0.10 USD) - 2021/01/23 1:03:02 ET
Table 'Polydoros II' 6-max Seat #3 is the button
Seat 1: Quetlaah ($13.88 in chips) 
Seat 2: fish72o ($10 in chips) 
Seat 3: reznor1 ($13.88 in chips) 
Seat 4: Halfyard007 ($13.17 in chips) 
Seat 6: Pablo7-Pro ($14.12 in chips) 
Halfyard007: posts small blind $0.05
Pablo7-Pro: posts big blind $0.10
*** HOLE CARDS ***
Quetlaah: folds 
fish72o: folds 
reznor1: calls $0.10
Halfyard007: calls $0.05
Pablo7-Pro: checks 
*** FLOP *** [Jd 9c 7c]
Halfyard007: checks 
Pablo7-Pro: checks 
reznor1: bets $0.29
Halfyard007: folds 
Pablo7-Pro: calls $0.29
*** TURN *** [Jd 9c 7c] [9s]
Pablo7-Pro: checks 
reznor1: bets $0.42
Pablo7-Pro: calls $0.42
*** RIVER *** [Jd 9c 7c 9s] [Jc]
Pablo7-Pro: checks 
reznor1: bets $1.64
Pablo7-Pro: folds 
Uncalled bet ($1.64) returned to reznor1
reznor1 collected $1.64 from pot
*** SUMMARY ***
Total pot $1.72 | Rake $0.08 
Board [Jd 9c 7c 9s Jc]
Seat 1: Quetlaah folded before Flop (didn't bet)
Seat 2: fish72o folded before Flop (didn't bet)
Seat 3: reznor1 (button) collected ($1.64)
Seat 4: Halfyard007 (small blind) folded on the Flop
Seat 6: Pablo7-Pro (big blind) folded on the River



PokerStars Hand #222945670140:  Hold'em No Limit ($0.05/$0.10 USD) - 2021/01/23 1:04:04 ET
Table 'Polydoros II' 6-max Seat #4 is the button
Seat 1: Quetlaah ($13.88 in chips) 
Seat 2: fish72o ($10 in chips) 
Seat 3: reznor1 ($14.71 in chips) 
Seat 4: Halfyard007 ($13.07 in chips) 
Seat 6: Pablo7-Pro ($13.31 in chips) 
Pablo7-Pro: posts small blind $0.05
Quetlaah: posts big blind $0.10
*** HOLE CARDS ***
fish72o: folds 
reznor1: folds 
Halfyard007: folds 
Pablo7-Pro: folds 
Uncalled bet ($0.05) returned to Quetlaah
Quetlaah collected $0.10 from pot
Quetlaah: doesn't show hand 
*** SUMMARY ***
Total pot $0.10 | Rake $0 
Seat 1: Quetlaah (big blind) collected ($0.10)
Seat 2: fish72o folded before Flop (didn't bet)
Seat 3: reznor1 folded before Flop (didn't bet)
Seat 4: Halfyard007 (button) folded before Flop (didn't bet)
Seat 6: Pablo7-Pro (small blind) folded before Flop



PokerStars Hand #222945672290:  Hold'em No Limit ($0.05/$0.10 USD) - 2021/01/23 1:04:13 ET
Table 'Polydoros II' 6-max Seat #6 is the button
Seat 1: Quetlaah ($13.93 in chips) 
Seat 2: fish72o ($10 in chips) 
Seat 3: reznor1 ($14.71 in chips) 
Seat 4: Halfyard007 ($13.07 in chips) 
Seat 6: Pablo7-Pro ($13.26 in chips) 
Quetlaah: posts small blind $0.05
fish72o: posts big blind $0.10
*** HOLE CARDS ***
reznor1: folds 
Halfyard007: folds 
Halfyard007 leaves the table
Pablo7-Pro: folds 
Quetlaah: folds 
Uncalled bet ($0.05) returned to fish72o
fish72o collected $0.10 from pot
fish72o: doesn't show hand 
*** SUMMARY ***
Total pot $0.10 | Rake $0 
Seat 1: Quetlaah (small blind) folded before Flop
Seat 2: fish72o (big blind) collected ($0.10)
Seat 3: reznor1 folded before Flop (didn't bet)
Seat 4: Halfyard007 folded before Flop (didn't bet)
Seat 6: Pablo7-Pro (button) folded before Flop (didn't bet)



PokerStars Hand #222945673731:  Hold'em No Limit ($0.05/$0.10 USD) - 2021/01/23 1:04:18 ET
Table 'Polydoros II' 6-max Seat #1 is the button
Seat 1: Quetlaah ($13.88 in chips) 
Seat 2: fish72o ($10.05 in chips) 
Seat 3: reznor1 ($14.71 in chips) 
Seat 6: Pablo7-Pro ($13.26 in chips) 
fish72o: posts small blind $0.05
reznor1: posts big blind $0.10
*** HOLE CARDS ***
Pablo7-Pro: raises $0.20 to $0.30
Quetlaah: calls $0.30
fish72o: folds 
reznor1: folds 
*** FLOP *** [8c 6s 2h]
Pablo7-Pro: checks 
Quetlaah: checks 
*** TURN *** [8c 6s 2h] [5s]
Pablo7-Pro: checks 
Quetlaah: checks 
*** RIVER *** [8c 6s 2h 5s] [Ah]
Pablo7-Pro: checks 
Quetlaah: checks 
*** SHOW DOWN ***
Pablo7-Pro: shows [Ac Qd] (a pair of Aces)
Quetlaah: mucks hand 
Pablo7-Pro collected $0.72 from pot
*** SUMMARY ***
Total pot $0.75 | Rake $0.03 
Board [8c 6s 2h 5s Ah]
Seat 1: Quetlaah (button) mucked
Seat 2: fish72o (small blind) folded before Flop
Seat 3: reznor1 (big blind) folded before Flop
Seat 6: Pablo7-Pro showed [Ac Qd] and won ($0.72) with a pair of Aces



PokerStars Hand #222945679415:  Hold'em No Limit ($0.05/$0.10 USD) - 2021/01/23 1:04:41 ET
Table 'Polydoros II' 6-max Seat #2 is the button
Seat 1: Quetlaah ($13.58 in chips) 
Seat 2: fish72o ($10 in chips) 
Seat 3: reznor1 ($14.61 in chips) 
Seat 6: Pablo7-Pro ($13.68 in chips) 
reznor1: posts small blind $0.05
Pablo7-Pro: posts big blind $0.10
*** HOLE CARDS ***
JELAFIT10 joins the table at seat #4 
Quetlaah: folds 
fish72o: raises $0.15 to $0.25
reznor1: folds 
Pablo7-Pro: calls $0.15
*** FLOP *** [7s 5h Qh]
Pablo7-Pro: checks 
fish72o: bets $0.30
Pablo7-Pro: folds 
Uncalled bet ($0.30) returned to fish72o
fish72o collected $0.53 from pot
fish72o: doesn't show hand 
*** SUMMARY ***
Total pot $0.55 | Rake $0.02 
Board [7s 5h Qh]
Seat 1: Quetlaah folded before Flop (didn't bet)
Seat 2: fish72o (button) collected ($0.53)
Seat 3: reznor1 (small blind) folded before Flop
Seat 6: Pablo7-Pro (big blind) folded on the Flop



PokerStars Hand #222945686729:  Hold'em No Limit ($0.05/$0.10 USD) - 2021/01/23 1:05:10 ET
Table 'Polydoros II' 6-max Seat #3 is the button
Seat 1: Quetlaah ($13.58 in chips) 
Seat 2: fish72o ($10.28 in chips) 
Seat 3: reznor1 ($14.56 in chips) 
Seat 6: Pablo7-Pro ($13.43 in chips) 
Pablo7-Pro: posts small blind $0.05
Quetlaah: posts big blind $0.10
*** HOLE CARDS ***
fish72o: folds 
reznor1: folds 
Pablo7-Pro: raises $0.20 to $0.30
Quetlaah: calls $0.20
*** FLOP *** [2c 6c Js]
Pablo7-Pro: bets $0.19
Quetlaah: raises $0.41 to $0.60
Pablo7-Pro: raises $1.20 to $1.80
Quetlaah: folds 
Uncalled bet ($1.20) returned to Pablo7-Pro
Pablo7-Pro collected $1.72 from pot
Pablo7-Pro: doesn't show hand 
*** SUMMARY ***
Total pot $1.80 | Rake $0.08 
Board [2c 6c Js]
Seat 1: Quetlaah (big blind) folded on the Flop
Seat 2: fish72o folded before Flop (didn't bet)
Seat 3: reznor1 (button) folded before Flop (didn't bet)
Seat 6: Pablo7-Pro (small blind) collected ($1.72)



PokerStars Hand #222945696172:  Hold'em No Limit ($0.05/$0.10 USD) - 2021/01/23 1:05:47 ET
Table 'Polydoros II' 6-max Seat #6 is the button
Seat 1: Quetlaah ($12.68 in chips) 
Seat 2: fish72o ($10.28 in chips) 
Seat 3: reznor1 ($14.56 in chips) 
Seat 4: JELAFIT10 ($10 in chips) 
Seat 6: Pablo7-Pro ($14.25 in chips) 
Quetlaah: posts small blind $0.05
fish72o: posts big blind $0.10
JELAFIT10: posts big blind $0.10
*** HOLE CARDS ***
reznor1: folds 
JELAFIT10: checks 
Pablo7-Pro: raises $0.40 to $0.50
Quetlaah: folds 
fish72o: folds 
JELAFIT10: calls $0.40
*** FLOP *** [4s Ts 3d]
Quetlaah leaves the table
JELAFIT10: checks 
Pablo7-Pro: bets $0.36
JELAFIT10: folds 
Uncalled bet ($0.36) returned to Pablo7-Pro
Pablo7-Pro collected $1.10 from pot
Pablo7-Pro: doesn't show hand 
*** SUMMARY ***
Total pot $1.15 | Rake $0.05 
Board [4s Ts 3d]
Seat 1: Quetlaah (small blind) folded before Flop
Seat 2: fish72o (big blind) folded before Flop
Seat 3: reznor1 folded before Flop (didn't bet)
Seat 4: JELAFIT10 folded on the Flop
Seat 6: Pablo7-Pro (button) collected ($1.10)



PokerStars Hand #222945702164:  Hold'em No Limit ($0.05/$0.10 USD) - 2021/01/23 1:06:11 ET
Table 'Polydoros II' 6-max Seat #2 is the button
Seat 2: fish72o ($10.18 in chips) 
Seat 3: reznor1 ($14.56 in chips) 
Seat 4: JELAFIT10 ($9.50 in chips) 
Seat 6: Pablo7-Pro ($14.85 in chips) 
reznor1: posts small blind $0.05
JELAFIT10: posts big blind $0.10
*** HOLE CARDS ***
Pablo7-Pro: folds 
fish72o: folds 
reznor1: folds 
Uncalled bet ($0.05) returned to JELAFIT10
JELAFIT10 collected $0.10 from pot
*** SUMMARY ***
Total pot $0.10 | Rake $0 
Seat 2: fish72o (button) folded before Flop (didn't bet)
Seat 3: reznor1 (small blind) folded before Flop
Seat 4: JELAFIT10 (big blind) collected ($0.10)
Seat 6: Pablo7-Pro folded before Flop (didn't bet)



PokerStars Hand #222945705409:  Hold'em No Limit ($0.05/$0.10 USD) - 2021/01/23 1:06:24 ET
Table 'Polydoros II' 6-max Seat #3 is the button
Seat 2: fish72o ($10.18 in chips) 
Seat 3: reznor1 ($14.51 in chips) 
Seat 4: JELAFIT10 ($9.55 in chips) 
Seat 6: Pablo7-Pro ($14.85 in chips) 
JELAFIT10: posts small blind $0.05
Pablo7-Pro: posts big blind $0.10
*** HOLE CARDS ***
fish72o: folds 
reznor1: calls $0.10
JELAFIT10: folds 
Pablo7-Pro: raises $0.40 to $0.50
reznor1: folds 
Uncalled bet ($0.40) returned to Pablo7-Pro
Pablo7-Pro collected $0.25 from pot
JorgeLemart was removed from the table for failing to post
JorgeLemart leaves the table
Pablo7-Pro: doesn't show hand 
*** SUMMARY ***
Total pot $0.25 | Rake $0 
Seat 2: fish72o folded before Flop (didn't bet)
Seat 3: reznor1 (button) folded before Flop
Seat 4: JELAFIT10 (small blind) folded before Flop
Seat 6: Pablo7-Pro (big blind) collected ($0.25)



PokerStars Hand #222945709675:  Hold'em No Limit ($0.05/$0.10 USD) - 2021/01/23 1:06:41 ET
Table 'Polydoros II' 6-max Seat #4 is the button
Seat 2: fish72o ($10.18 in chips) 
Seat 3: reznor1 ($14.41 in chips) 
Seat 4: JELAFIT10 ($9.50 in chips) 
Seat 6: Pablo7-Pro ($15 in chips) 
Pablo7-Pro: posts small blind $0.05
Romeo rus89 joins the table at seat #1 
fish72o: posts big blind $0.10
*** HOLE CARDS ***
reznor1: folds 
JELAFIT10: folds 
Pablo7-Pro: folds 
Uncalled bet ($0.05) returned to fish72o
fish72o collected $0.10 from pot
fish72o: doesn't show hand 
*** SUMMARY ***
Total pot $0.10 | Rake $0 
Seat 2: fish72o (big blind) collected ($0.10)
Seat 3: reznor1 folded before Flop (didn't bet)
Seat 4: JELAFIT10 (button) folded before Flop (didn't bet)
Seat 6: Pablo7-Pro (small blind) folded before Flop



PokerStars Hand #222945712099:  Hold'em No Limit ($0.05/$0.10 USD) - 2021/01/23 1:06:51 ET
Table 'Polydoros II' 6-max Seat #6 is the button
Seat 2: fish72o ($10.23 in chips) 
Seat 3: reznor1 ($14.41 in chips) 
Seat 4: JELAFIT10 ($9.50 in chips) 
Seat 6: Pablo7-Pro ($14.95 in chips) 
fish72o: posts small blind $0.05
reznor1: posts big blind $0.10
*** HOLE CARDS ***
JELAFIT10: calls $0.10
Pablo7-Pro: folds 
fish72o: raises $0.30 to $0.40
reznor1: folds 
JELAFIT10: calls $0.30
*** FLOP *** [6c 6d 3h]
fish72o: bets $0.28
JELAFIT10: raises $0.71 to $0.99
fish72o: folds 
Uncalled bet ($0.71) returned to JELAFIT10
JELAFIT10 collected $1.39 from pot
*** SUMMARY ***
Total pot $1.46 | Rake $0.07 
Board [6c 6d 3h]
Seat 2: fish72o (small blind) folded on the Flop
Seat 3: reznor1 (big blind) folded before Flop
Seat 4: JELAFIT10 collected ($1.39)
Seat 6: Pablo7-Pro (button) folded before Flop (didn't bet)



PokerStars Hand #222945719002:  Hold'em No Limit ($0.05/$0.10 USD) - 2021/01/23 1:07:18 ET
Table 'Polydoros II' 6-max Seat #2 is the button
Seat 2: fish72o ($10 in chips) 
Seat 3: reznor1 ($14.31 in chips) 
Seat 4: JELAFIT10 ($10.21 in chips) 
Seat 6: Pablo7-Pro ($14.95 in chips) 
reznor1: posts small blind $0.05
JELAFIT10: posts big blind $0.10
Romeo rus89: sits out 
*** HOLE CARDS ***
Pablo7-Pro: folds 
fish72o: folds 
reznor1: folds 
Uncalled bet ($0.05) returned to JELAFIT10
12311985 joins the table at seat #5 
JELAFIT10 collected $0.10 from pot
*** SUMMARY ***
Total pot $0.10 | Rake $0 
Seat 2: fish72o (button) folded before Flop (didn't bet)
Seat 3: reznor1 (small blind) folded before Flop
Seat 4: JELAFIT10 (big blind) collected ($0.10)
Seat 6: Pablo7-Pro folded before Flop (didn't bet)



PokerStars Hand #222945721473:  Hold'em No Limit ($0.05/$0.10 USD) - 2021/01/23 1:07:28 ET
Table 'Polydoros II' 6-max Seat #3 is the button
Seat 2: fish72o ($10 in chips) 
Seat 3: reznor1 ($14.26 in chips) 
Seat 4: JELAFIT10 ($10.26 in chips) 
Seat 5: 12311985 ($10 in chips) 
Seat 6: Pablo7-Pro ($14.95 in chips) 
JELAFIT10: posts small blind $0.05
12311985: posts big blind $0.10
Romeo rus89: sits out 
*** HOLE CARDS ***
Pablo7-Pro: folds 
fish72o: folds 
reznor1: folds 
JELAFIT10: calls $0.05
12311985: checks 
*** FLOP *** [5s 8h Ah]
JELAFIT10: bets $0.10
12311985: calls $0.10
*** TURN *** [5s 8h Ah] [4d]
JELAFIT10: bets $0.19
12311985: calls $0.19
*** RIVER *** [5s 8h Ah 4d] [Ad]
JELAFIT10: checks 
12311985: bets $0.37
JELAFIT10: calls $0.37
*** SHOW DOWN ***
12311985: shows [Jh 7h] (a pair of Aces)
JELAFIT10: shows [5c 4h] (two pair, Aces and Fives)
JELAFIT10 collected $1.45 from pot
*** SUMMARY ***
Total pot $1.52 | Rake $0.07 
Board [5s 8h Ah 4d Ad]
Seat 2: fish72o folded before Flop (didn't bet)
Seat 3: reznor1 (button) folded before Flop (didn't bet)
Seat 4: JELAFIT10 (small blind) showed [5c 4h] and won ($1.45) with two pair, Aces and Fives
Seat 5: 12311985 (big blind) showed [Jh 7h] and lost with a pair of Aces
Seat 6: Pablo7-Pro folded before Flop (didn't bet)



PokerStars Hand #222945731840:  Hold'em No Limit ($0.05/$0.10 USD) - 2021/01/23 1:08:10 ET
Table 'Polydoros II' 6-max Seat #4 is the button
Seat 2: fish72o ($10 in chips) 
Seat 3: reznor1 ($14.26 in chips) 
Seat 4: JELAFIT10 ($10.95 in chips) 
Seat 5: 12311985 ($10 in chips) 
Seat 6: Pablo7-Pro ($14.95 in chips) 
12311985: posts small blind $0.05
Pablo7-Pro: posts big blind $0.10
Romeo rus89: sits out 
*** HOLE CARDS ***
fish72o: folds 
reznor1: folds 
JELAFIT10: calls $0.10
12311985: folds 
Pablo7-Pro: checks 
*** FLOP *** [Jc 6s As]
Pablo7-Pro: checks 
JELAFIT10: bets $0.12
Pablo7-Pro: folds 
Uncalled bet ($0.12) returned to JELAFIT10
JELAFIT10 collected $0.24 from pot
JELAFIT10: doesn't show hand 
*** SUMMARY ***
Total pot $0.25 | Rake $0.01 
Board [Jc 6s As]
Seat 2: fish72o folded before Flop (didn't bet)
Seat 3: reznor1 folded before Flop (didn't bet)
Seat 4: JELAFIT10 (button) collected ($0.24)
Seat 5: 12311985 (small blind) folded before Flop
Seat 6: Pablo7-Pro (big blind) folded on the Flop



PokerStars Hand #222945736773:  Hold'em No Limit ($0.05/$0.10 USD) - 2021/01/23 1:08:29 ET
Table 'Polydoros II' 6-max Seat #5 is the button
Seat 1: Romeo rus89 ($8 in chips) 
Seat 2: fish72o ($10 in chips) 
Seat 3: reznor1 ($14.26 in chips) 
Seat 4: JELAFIT10 ($11.09 in chips) 
Seat 5: 12311985 ($10 in chips) 
Seat 6: Pablo7-Pro ($14.85 in chips) 
Pablo7-Pro: posts small blind $0.05
Romeo rus89: posts big blind $0.10
*** HOLE CARDS ***
fish72o: folds 
reznor1: folds 
JELAFIT10: folds 
12311985: raises $0.20 to $0.30
Pablo7-Pro: folds 
Romeo rus89: calls $0.20
*** FLOP *** [4d Qh 6h]
JELAFIT10 leaves the table
Romeo rus89: checks 
12311985: bets $0.19
Romeo rus89: folds 
Uncalled bet ($0.19) returned to 12311985
12311985 collected $0.62 from pot
12311985: doesn't show hand 
*** SUMMARY ***
Total pot $0.65 | Rake $0.03 
Board [4d Qh 6h]
Seat 1: Romeo rus89 (big blind) folded on the Flop
Seat 2: fish72o folded before Flop (didn't bet)
Seat 3: reznor1 folded before Flop (didn't bet)
Seat 4: JELAFIT10 folded before Flop (didn't bet)
Seat 5: 12311985 (button) collected ($0.62)
Seat 6: Pablo7-Pro (small blind) folded before Flop



PokerStars Hand #222945745283:  Hold'em No Limit ($0.05/$0.10 USD) - 2021/01/23 1:09:04 ET
Table 'Polydoros II' 6-max Seat #1 is the button
Seat 1: Romeo rus89 ($7.70 in chips) 
Seat 2: fish72o ($10 in chips) 
Seat 3: reznor1 ($14.26 in chips) 
Seat 5: 12311985 ($10.32 in chips) 
fish72o: posts small blind $0.05
reznor1: posts big blind $0.10
*** HOLE CARDS ***
12311985: folds 
Romeo rus89: folds 
fish72o: raises $0.15 to $0.25
reznor1: folds 
Uncalled bet ($0.15) returned to fish72o
fish72o collected $0.20 from pot
fish72o: doesn't show hand 
*** SUMMARY ***
Total pot $0.20 | Rake $0 
Seat 1: Romeo rus89 (button) folded before Flop (didn't bet)
Seat 2: fish72o (small blind) collected ($0.20)
Seat 3: reznor1 (big blind) folded before Flop
Seat 5: 12311985 folded before Flop (didn't bet)



PokerStars Hand #222945749766:  Hold'em No Limit ($0.05/$0.10 USD) - 2021/01/23 1:09:22 ET
Table 'Polydoros II' 6-max Seat #2 is the button
Seat 1: Romeo rus89 ($7.70 in chips) 
Seat 2: fish72o ($10.10 in chips) 
Seat 3: reznor1 ($14.16 in chips) 
Seat 5: 12311985 ($10.32 in chips) 
reznor1: posts small blind $0.05
12311985: posts big blind $0.10
*** HOLE CARDS ***
Romeo rus89: folds 
fish72o: folds 
reznor1: folds 
Uncalled bet ($0.05) returned to 12311985
12311985 collected $0.10 from pot
12311985: doesn't show hand 
*** SUMMARY ***
Total pot $0.10 | Rake $0 
Seat 1: Romeo rus89 folded before Flop (didn't bet)
Seat 2: fish72o (button) folded before Flop (didn't bet)
Seat 3: reznor1 (small blind) folded before Flop
Seat 5: 12311985 (big blind) collected ($0.10)



PokerStars Hand #222945753919:  Hold'em No Limit ($0.05/$0.10 USD) - 2021/01/23 1:09:39 ET
Table 'Polydoros II' 6-max Seat #3 is the button
Seat 1: Romeo rus89 ($7.70 in chips) 
Seat 2: fish72o ($10.10 in chips) 
Seat 3: reznor1 ($14.11 in chips) 
Seat 5: 12311985 ($10.37 in chips) 
12311985: posts small blind $0.05
Romeo rus89: posts big blind $0.10
*** HOLE CARDS ***
fish72o: folds 
reznor1: folds 
12311985: raises $0.20 to $0.30
Romeo rus89: folds 
Uncalled bet ($0.20) returned to 12311985
12311985 collected $0.20 from pot
12311985: doesn't show hand 
*** SUMMARY ***
Total pot $0.20 | Rake $0 
Seat 1: Romeo rus89 (big blind) folded before Flop
Seat 2: fish72o folded before Flop (didn't bet)
Seat 3: reznor1 (button) folded before Flop (didn't bet)
Seat 5: 12311985 (small blind) collected ($0.20)



PokerStars Hand #222945757259:  Hold'em No Limit ($0.05/$0.10 USD) - 2021/01/23 1:09:52 ET
Table 'Polydoros II' 6-max Seat #5 is the button
Seat 1: Romeo rus89 ($7.60 in chips) 
Seat 2: fish72o ($10.10 in chips) 
Seat 3: reznor1 ($14.11 in chips) 
Seat 5: 12311985 ($10.47 in chips) 
Romeo rus89: posts small blind $0.05
fish72o: posts big blind $0.10
*** HOLE CARDS ***
reznor1: calls $0.10
12311985: folds 
Romeo rus89: calls $0.05
fish72o: checks 
*** FLOP *** [7s 9c 4h]
Romeo rus89: checks 
fish72o: checks 
reznor1: checks 
*** TURN *** [7s 9c 4h] [4d]
Romeo rus89: bets $0.19
fish72o: folds 
reznor1: folds 
Uncalled bet ($0.19) returned to Romeo rus89
Romeo rus89 collected $0.29 from pot
*** SUMMARY ***
Total pot $0.30 | Rake $0.01 
Board [7s 9c 4h 4d]
Seat 1: Romeo rus89 (small blind) collected ($0.29)
Seat 2: fish72o (big blind) folded on the Turn
Seat 3: reznor1 folded on the Turn
Seat 5: 12311985 (button) folded before Flop (didn't bet)



PokerStars Hand #222945766550:  Hold'em No Limit ($0.05/$0.10 USD) - 2021/01/23 1:10:29 ET
Table 'Polydoros II' 6-max Seat #1 is the button
Seat 1: Romeo rus89 ($7.79 in chips) 
Seat 2: fish72o ($10 in chips) 
Seat 3: reznor1 ($14.01 in chips) 
Seat 5: 12311985 ($10.47 in chips) 
fish72o: posts small blind $0.05
reznor1: posts big blind $0.10
*** HOLE CARDS ***
12311985: folds 
Romeo rus89: folds 
fish72o: raises $0.15 to $0.25
reznor1: calls $0.15
*** FLOP *** [Qs 4d 9d]
qwe17 joins the table at seat #4 
fish72o: bets $0.32
reznor1: folds 
Uncalled bet ($0.32) returned to fish72o
fish72o collected $0.48 from pot
fish72o: doesn't show hand 
*** SUMMARY ***
Total pot $0.50 | Rake $0.02 
Board [Qs 4d 9d]
Seat 1: Romeo rus89 (button) folded before Flop (didn't bet)
Seat 2: fish72o (small blind) collected ($0.48)
Seat 3: reznor1 (big blind) folded on the Flop
Seat 5: 12311985 folded before Flop (didn't bet)



PokerStars Hand #222945781052:  Hold'em No Limit ($0.05/$0.10 USD) - 2021/01/23 1:10:48 ET
Table 'Polydoros II' 6-max Seat #2 is the button
Seat 1: Romeo rus89 ($7.79 in chips) 
Seat 2: fish72o ($10.23 in chips) 
Seat 3: reznor1 ($13.76 in chips) 
Seat 4: qwe17 ($10 in chips) 
Seat 5: 12311985 ($10.47 in chips) 
reznor1: posts small blind $0.05
qwe17: posts big blind $0.10
*** HOLE CARDS ***
12311985: folds 
Romeo rus89: folds 
fish72o: folds 
reznor1: calls $0.05
qwe17: checks 
*** FLOP *** [5c Td Qc]
reznor1: bets $0.10
qwe17: folds 
Uncalled bet ($0.10) returned to reznor1
reznor1 collected $0.19 from pot
*** SUMMARY ***
Total pot $0.20 | Rake $0.01 
Board [5c Td Qc]
Seat 1: Romeo rus89 folded before Flop (didn't bet)
Seat 2: fish72o (button) folded before Flop (didn't bet)
Seat 3: reznor1 (small blind) collected ($0.19)
Seat 4: qwe17 (big blind) folded on the Flop
Seat 5: 12311985 folded before Flop (didn't bet)



PokerStars Hand #222945786093:  Hold'em No Limit ($0.05/$0.10 USD) - 2021/01/23 1:11:09 ET
Table 'Polydoros II' 6-max Seat #3 is the button
Seat 1: Romeo rus89 ($7.79 in chips) 
Seat 2: fish72o ($10.23 in chips) 
Seat 3: reznor1 ($13.85 in chips) 
Seat 4: qwe17 ($9.90 in chips) 
Seat 5: 12311985 ($10.47 in chips) 
qwe17: posts small blind $0.05
12311985: posts big blind $0.10
*** HOLE CARDS ***
Romeo rus89: folds 
fish72o: folds 
reznor1: folds 
qwe17: folds 
Uncalled bet ($0.05) returned to 12311985
12311985 collected $0.10 from pot
12311985: doesn't show hand 
*** SUMMARY ***
Total pot $0.10 | Rake $0 
Seat 1: Romeo rus89 folded before Flop (didn't bet)
Seat 2: fish72o folded before Flop (didn't bet)
Seat 3: reznor1 (button) folded before Flop (didn't bet)
Seat 4: qwe17 (small blind) folded before Flop
Seat 5: 12311985 (big blind) collected ($0.10)



PokerStars Hand #222945789706:  Hold'em No Limit ($0.05/$0.10 USD) - 2021/01/23 1:11:23 ET
Table 'Polydoros II' 6-max Seat #4 is the button
Seat 1: Romeo rus89 ($7.79 in chips) 
Seat 2: fish72o ($10.23 in chips) 
Seat 3: reznor1 ($13.85 in chips) 
Seat 4: qwe17 ($9.85 in chips) 
Seat 5: 12311985 ($10.52 in chips) 
12311985: posts small blind $0.05
Romeo rus89: posts big blind $0.10
*** HOLE CARDS ***
fish72o: folds 
reznor1: raises $0.40 to $0.50
qwe17: folds 
12311985: folds 
Romeo rus89: folds 
Uncalled bet ($0.40) returned to reznor1
reznor1 collected $0.25 from pot
*** SUMMARY ***
Total pot $0.25 | Rake $0 
Seat 1: Romeo rus89 (big blind) folded before Flop
Seat 2: fish72o folded before Flop (didn't bet)
Seat 3: reznor1 collected ($0.25)
Seat 4: qwe17 (button) folded before Flop (didn't bet)
Seat 5: 12311985 (small blind) folded before Flop



PokerStars Hand #222945793260:  Hold'em No Limit ($0.05/$0.10 USD) - 2021/01/23 1:11:37 ET
Table 'Polydoros II' 6-max Seat #5 is the button
Seat 1: Romeo rus89 ($7.69 in chips) 
Seat 2: fish72o ($10.23 in chips) 
Seat 3: reznor1 ($14 in chips) 
Seat 4: qwe17 ($9.85 in chips) 
Seat 5: 12311985 ($10.47 in chips) 
Romeo rus89: posts small blind $0.05
fish72o: posts big blind $0.10
*** HOLE CARDS ***
reznor1: folds 
qwe17: raises $0.15 to $0.25
12311985: folds 
Romeo rus89: calls $0.20
fish72o: calls $0.15
*** FLOP *** [6h 9c Kd]
Romeo rus89: checks 
fish72o: checks 
qwe17: checks 
*** TURN *** [6h 9c Kd] [5c]
Romeo rus89: checks 
fish72o: bets $0.24
qwe17: folds 
Romeo rus89: raises $0.60 to $0.84
fish72o: folds 
Uncalled bet ($0.60) returned to Romeo rus89
Romeo rus89 collected $1.17 from pot
*** SUMMARY ***
Total pot $1.23 | Rake $0.06 
Board [6h 9c Kd 5c]
Seat 1: Romeo rus89 (small blind) collected ($1.17)
Seat 2: fish72o (big blind) folded on the Turn
Seat 3: reznor1 folded before Flop (didn't bet)
Seat 4: qwe17 folded on the Turn
Seat 5: 12311985 (button) folded before Flop (didn't bet)



PokerStars Hand #222945807949:  Hold'em No Limit ($0.05/$0.10 USD) - 2021/01/23 1:12:36 ET
Table 'Polydoros II' 6-max Seat #1 is the button
Seat 1: Romeo rus89 ($8.37 in chips) 
Seat 2: fish72o ($10 in chips) 
Seat 3: reznor1 ($14 in chips) 
Seat 4: qwe17 ($9.60 in chips) 
Seat 5: 12311985 ($10.47 in chips) 
fish72o: posts small blind $0.05
reznor1: posts big blind $0.10
*** HOLE CARDS ***
qwe17: folds 
12311985: folds 
Romeo rus89: raises $0.15 to $0.25
fish72o: folds 
reznor1: folds 
Uncalled bet ($0.15) returned to Romeo rus89
Romeo rus89 collected $0.25 from pot
*** SUMMARY ***
Total pot $0.25 | Rake $0 
Seat 1: Romeo rus89 (button) collected ($0.25)
Seat 2: fish72o (small blind) folded before Flop
Seat 3: reznor1 (big blind) folded before Flop
Seat 4: qwe17 folded before Flop (didn't bet)
Seat 5: 12311985 folded before Flop (didn't bet)



PokerStars Hand #222945811915:  Hold'em No Limit ($0.05/$0.10 USD) - 2021/01/23 1:12:53 ET
Table 'Polydoros II' 6-max Seat #2 is the button
Seat 1: Romeo rus89 ($8.52 in chips) 
Seat 2: fish72o ($10 in chips) 
Seat 3: reznor1 ($13.90 in chips) 
Seat 4: qwe17 ($9.60 in chips) 
Seat 5: 12311985 ($10.47 in chips) 
reznor1: posts small blind $0.05
qwe17: posts big blind $0.10
*** HOLE CARDS ***
12311985: folds 
Romeo rus89: folds 
fish72o: folds 
reznor1: calls $0.05
qwe17: checks 
*** FLOP *** [Ah 4d Jh]
reznor1: bets $0.10
qwe17: calls $0.10
*** TURN *** [Ah 4d Jh] [5h]
reznor1: bets $0.19
qwe17: calls $0.19
*** RIVER *** [Ah 4d Jh 5h] [Js]
reznor1: bets $0.37
qwe17: calls $0.37
*** SHOW DOWN ***
reznor1: shows [Ad Qh] (two pair, Aces and Jacks)
qwe17: shows [Jc Kd] (three of a kind, Jacks)
qwe17 collected $1.45 from pot
*** SUMMARY ***
Total pot $1.52 | Rake $0.07 
Board [Ah 4d Jh 5h Js]
Seat 1: Romeo rus89 folded before Flop (didn't bet)
Seat 2: fish72o (button) folded before Flop (didn't bet)
Seat 3: reznor1 (small blind) showed [Ad Qh] and lost with two pair, Aces and Jacks
Seat 4: qwe17 (big blind) showed [Jc Kd] and won ($1.45) with three of a kind, Jacks
Seat 5: 12311985 folded before Flop (didn't bet)



PokerStars Hand #222945820526:  Hold'em No Limit ($0.05/$0.10 USD) - 2021/01/23 1:13:28 ET
Table 'Polydoros II' 6-max Seat #3 is the button
Seat 1: Romeo rus89 ($8.52 in chips) 
Seat 2: fish72o ($10 in chips) 
Seat 3: reznor1 ($13.14 in chips) 
Seat 4: qwe17 ($10.29 in chips) 
Seat 5: 12311985 ($10.47 in chips) 
qwe17: posts small blind $0.05
12311985: posts big blind $0.10
Pablo7-Pro: sits out 
*** HOLE CARDS ***
Romeo rus89: folds 
fish72o: folds 
reznor1: folds 
qwe17: folds 
Uncalled bet ($0.05) returned to 12311985
12311985 collected $0.10 from pot
12311985: doesn't show hand 
*** SUMMARY ***
Total pot $0.10 | Rake $0 
Seat 1: Romeo rus89 folded before Flop (didn't bet)
Seat 2: fish72o folded before Flop (didn't bet)
Seat 3: reznor1 (button) folded before Flop (didn't bet)
Seat 4: qwe17 (small blind) folded before Flop
Seat 5: 12311985 (big blind) collected ($0.10)



PokerStars Hand #222945822785:  Hold'em No Limit ($0.05/$0.10 USD) - 2021/01/23 1:13:37 ET
Table 'Polydoros II' 6-max Seat #4 is the button
Seat 1: Romeo rus89 ($8.52 in chips) 
Seat 2: fish72o ($10 in chips) 
Seat 3: reznor1 ($13.14 in chips) 
Seat 4: qwe17 ($10.24 in chips) 
Seat 5: 12311985 ($10.52 in chips) 
Seat 6: Pablo7-Pro ($14.80 in chips) 
12311985: posts small blind $0.05
Pablo7-Pro: posts big blind $0.10
*** HOLE CARDS ***
Romeo rus89: folds 
fish72o: folds 
reznor1: folds 
qwe17: folds 
12311985: raises $0.20 to $0.30
Pablo7-Pro: folds 
Uncalled bet ($0.20) returned to 12311985
12311985 collected $0.20 from pot
12311985: doesn't show hand 
*** SUMMARY ***
Total pot $0.20 | Rake $0 
Seat 1: Romeo rus89 folded before Flop (didn't bet)
Seat 2: fish72o folded before Flop (didn't bet)
Seat 3: reznor1 folded before Flop (didn't bet)
Seat 4: qwe17 (button) folded before Flop (didn't bet)
Seat 5: 12311985 (small blind) collected ($0.20)
Seat 6: Pablo7-Pro (big blind) folded before Flop



PokerStars Hand #222945825534:  Hold'em No Limit ($0.05/$0.10 USD) - 2021/01/23 1:13:48 ET
Table 'Polydoros II' 6-max Seat #5 is the button
Seat 1: Romeo rus89 ($8.52 in chips) 
Seat 2: fish72o ($10 in chips) 
Seat 3: reznor1 ($13.14 in chips) 
Seat 4: qwe17 ($10.24 in chips) 
Seat 5: 12311985 ($10.62 in chips) 
Seat 6: Pablo7-Pro ($14.70 in chips) 
Pablo7-Pro: posts small blind $0.05
Romeo rus89: posts big blind $0.10
*** HOLE CARDS ***
fish72o: raises $0.15 to $0.25
reznor1: calls $0.25
qwe17: folds 
12311985: folds 
Pablo7-Pro: folds 
Romeo rus89: folds 
*** FLOP *** [2h 4h Kd]
fish72o: bets $0.20
reznor1: raises $0.20 to $0.40
fish72o: calls $0.20
*** TURN *** [2h 4h Kd] [Jd]
fish72o: checks 
reznor1: bets $0.69
fish72o: calls $0.69
*** RIVER *** [2h 4h Kd Jd] [9d]
fish72o: checks 
reznor1: bets $1.35
fish72o: folds 
Uncalled bet ($1.35) returned to reznor1
reznor1 collected $2.70 from pot
*** SUMMARY ***
Total pot $2.83 | Rake $0.13 
Board [2h 4h Kd Jd 9d]
Seat 1: Romeo rus89 (big blind) folded before Flop
Seat 2: fish72o folded on the River
Seat 3: reznor1 collected ($2.70)
Seat 4: qwe17 folded before Flop (didn't bet)
Seat 5: 12311985 (button) folded before Flop (didn't bet)
Seat 6: Pablo7-Pro (small blind) folded before Flop



PokerStars Hand #222945837174:  Hold'em No Limit ($0.05/$0.10 USD) - 2021/01/23 1:14:35 ET
Table 'Polydoros II' 6-max Seat #6 is the button
Seat 1: Romeo rus89 ($8.42 in chips) 
Seat 2: fish72o ($10 in chips) 
Seat 3: reznor1 ($14.50 in chips) 
Seat 4: qwe17 ($10.24 in chips) 
Seat 5: 12311985 ($10.62 in chips) 
Seat 6: Pablo7-Pro ($14.65 in chips) 
Romeo rus89: posts small blind $0.05
fish72o: posts big blind $0.10
*** HOLE CARDS ***
reznor1: raises $0.40 to $0.50
qwe17: folds 
12311985: folds 
Pablo7-Pro: folds 
Romeo rus89: folds 
fish72o: folds 
Uncalled bet ($0.40) returned to reznor1
reznor1 collected $0.25 from pot
*** SUMMARY ***
Total pot $0.25 | Rake $0 
Seat 1: Romeo rus89 (small blind) folded before Flop
Seat 2: fish72o (big blind) folded before Flop
Seat 3: reznor1 collected ($0.25)
Seat 4: qwe17 folded before Flop (didn't bet)
Seat 5: 12311985 folded before Flop (didn't bet)
Seat 6: Pablo7-Pro (button) folded before Flop (didn't bet)



PokerStars Hand #222945841502:  Hold'em No Limit ($0.05/$0.10 USD) - 2021/01/23 1:14:53 ET
Table 'Polydoros II' 6-max Seat #1 is the button
Seat 1: Romeo rus89 ($8.37 in chips) 
Seat 2: fish72o ($10 in chips) 
Seat 3: reznor1 ($14.65 in chips) 
Seat 4: qwe17 ($10.24 in chips) 
Seat 5: 12311985 ($10.62 in chips) 
Seat 6: Pablo7-Pro ($14.65 in chips) 
fish72o: posts small blind $0.05
reznor1: posts big blind $0.10
*** HOLE CARDS ***
qwe17: folds 
12311985: folds 
Pablo7-Pro: folds 
Romeo rus89: raises $0.15 to $0.25
fish72o: calls $0.20
reznor1: folds 
*** FLOP *** [2h 7c 9d]
fish72o: checks 
Romeo rus89: checks 
*** TURN *** [2h 7c 9d] [4s]
fish72o: checks 
Romeo rus89: checks 
*** RIVER *** [2h 7c 9d 4s] [7d]
fish72o: bets $0.19
Romeo rus89: folds 
Uncalled bet ($0.19) returned to fish72o
fish72o collected $0.57 from pot
fish72o: doesn't show hand 
*** SUMMARY ***
Total pot $0.60 | Rake $0.03 
Board [2h 7c 9d 4s 7d]
Seat 1: Romeo rus89 (button) folded on the River
Seat 2: fish72o (small blind) collected ($0.57)
Seat 3: reznor1 (big blind) folded before Flop
Seat 4: qwe17 folded before Flop (didn't bet)
Seat 5: 12311985 folded before Flop (didn't bet)
Seat 6: Pablo7-Pro folded before Flop (didn't bet)



PokerStars Hand #222945853537:  Hold'em No Limit ($0.05/$0.10 USD) - 2021/01/23 1:15:41 ET
Table 'Polydoros II' 6-max Seat #2 is the button
Seat 1: Romeo rus89 ($8.12 in chips) 
Seat 2: fish72o ($10.32 in chips) 
Seat 3: reznor1 ($14.55 in chips) 
Seat 4: qwe17 ($10.24 in chips) 
Seat 5: 12311985 ($10.62 in chips) 
Seat 6: Pablo7-Pro ($14.65 in chips) 
reznor1: posts small blind $0.05
qwe17: posts big blind $0.10
*** HOLE CARDS ***
12311985: folds 
Pablo7-Pro: raises $0.20 to $0.30
Romeo rus89: folds 
fish72o: folds 
reznor1: folds 
qwe17: calls $0.20
*** FLOP *** [Tc 2s 7c]
qwe17: checks 
Pablo7-Pro: checks 
*** TURN *** [Tc 2s 7c] [9s]
qwe17: checks 
Pablo7-Pro: bets $0.48
qwe17: folds 
Uncalled bet ($0.48) returned to Pablo7-Pro
Pablo7-Pro collected $0.62 from pot
Pablo7-Pro: doesn't show hand 
*** SUMMARY ***
Total pot $0.65 | Rake $0.03 
Board [Tc 2s 7c 9s]
Seat 1: Romeo rus89 folded before Flop (didn't bet)
Seat 2: fish72o (button) folded before Flop (didn't bet)
Seat 3: reznor1 (small blind) folded before Flop
Seat 4: qwe17 (big blind) folded on the Turn
Seat 5: 12311985 folded before Flop (didn't bet)
Seat 6: Pablo7-Pro collected ($0.62)



PokerStars Hand #222945864868:  Hold'em No Limit ($0.05/$0.10 USD) - 2021/01/23 1:16:27 ET
Table 'Polydoros II' 6-max Seat #3 is the button
Seat 1: Romeo rus89 ($8.12 in chips) 
Seat 2: fish72o ($10.32 in chips) 
Seat 3: reznor1 ($14.50 in chips) 
Seat 4: qwe17 ($9.94 in chips) 
Seat 5: 12311985 ($10.62 in chips) 
Seat 6: Pablo7-Pro ($14.97 in chips) 
qwe17: posts small blind $0.05
12311985: posts big blind $0.10
*** HOLE CARDS ***
Pablo7-Pro: folds 
Romeo rus89: raises $0.20 to $0.30
fish72o: folds 
reznor1: calls $0.30
qwe17: folds 
12311985: raises $1.20 to $1.50
Romeo rus89: folds 
reznor1: calls $1.20
*** FLOP *** [Kd 9c 4d]
12311985: bets $0.96
reznor1: folds 
Uncalled bet ($0.96) returned to 12311985
12311985 collected $3.20 from pot
12311985: doesn't show hand 
*** SUMMARY ***
Total pot $3.35 | Rake $0.15 
Board [Kd 9c 4d]
Seat 1: Romeo rus89 folded before Flop
Seat 2: fish72o folded before Flop (didn't bet)
Seat 3: reznor1 (button) folded on the Flop
Seat 4: qwe17 (small blind) folded before Flop
Seat 5: 12311985 (big blind) collected ($3.20)
Seat 6: Pablo7-Pro folded before Flop (didn't bet)



PokerStars Hand #222945882929:  Hold'em No Limit ($0.05/$0.10 USD) - 2021/01/23 1:17:07 ET
Table 'Polydoros II' 6-max Seat #4 is the button
Seat 1: Romeo rus89 ($7.82 in chips) 
Seat 2: fish72o ($10.32 in chips) 
Seat 3: reznor1 ($13 in chips) 
Seat 4: qwe17 ($9.89 in chips) 
Seat 5: 12311985 ($12.32 in chips) 
Seat 6: Pablo7-Pro ($14.97 in chips) 
12311985: posts small blind $0.05
Pablo7-Pro: posts big blind $0.10
*** HOLE CARDS ***
Romeo rus89: folds 
fish72o: raises $0.15 to $0.25
reznor1: folds 
qwe17: folds 
12311985: folds 
Pablo7-Pro: folds 
Uncalled bet ($0.15) returned to fish72o
fish72o collected $0.25 from pot
fish72o: doesn't show hand 
*** SUMMARY ***
Total pot $0.25 | Rake $0 
Seat 1: Romeo rus89 folded before Flop (didn't bet)
Seat 2: fish72o collected ($0.25)
Seat 3: reznor1 folded before Flop (didn't bet)
Seat 4: qwe17 (button) folded before Flop (didn't bet)
Seat 5: 12311985 (small blind) folded before Flop
Seat 6: Pablo7-Pro (big blind) folded before Flop



PokerStars Hand #222945887999:  Hold'em No Limit ($0.05/$0.10 USD) - 2021/01/23 1:17:28 ET
Table 'Polydoros II' 6-max Seat #5 is the button
Seat 1: Romeo rus89 ($7.82 in chips) 
Seat 2: fish72o ($10.47 in chips) 
Seat 3: reznor1 ($13 in chips) 
Seat 4: qwe17 ($9.89 in chips) 
Seat 5: 12311985 ($12.27 in chips) 
Seat 6: Pablo7-Pro ($14.87 in chips) 
Pablo7-Pro: posts small blind $0.05
Romeo rus89: posts big blind $0.10
*** HOLE CARDS ***
fish72o: folds 
reznor1: folds 
qwe17: folds 
12311985: folds 
Pablo7-Pro: folds 
Uncalled bet ($0.05) returned to Romeo rus89
Romeo rus89 collected $0.10 from pot
*** SUMMARY ***
Total pot $0.10 | Rake $0 
Seat 1: Romeo rus89 (big blind) collected ($0.10)
Seat 2: fish72o folded before Flop (didn't bet)
Seat 3: reznor1 folded before Flop (didn't bet)
Seat 4: qwe17 folded before Flop (didn't bet)
Seat 5: 12311985 (button) folded before Flop (didn't bet)
Seat 6: Pablo7-Pro (small blind) folded before Flop



PokerStars Hand #222945892703:  Hold'em No Limit ($0.05/$0.10 USD) - 2021/01/23 1:17:47 ET
Table 'Polydoros II' 6-max Seat #6 is the button
Seat 1: Romeo rus89 ($7.87 in chips) 
Seat 2: fish72o ($10.47 in chips) 
Seat 3: reznor1 ($13 in chips) 
Seat 4: qwe17 ($9.89 in chips) 
Seat 5: 12311985 ($12.27 in chips) 
Seat 6: Pablo7-Pro ($14.82 in chips) 
Romeo rus89: posts small blind $0.05
fish72o: posts big blind $0.10
*** HOLE CARDS ***
reznor1: folds 
qwe17: raises $0.15 to $0.25
12311985: folds 
Pablo7-Pro: folds 
Romeo rus89: folds 
fish72o: folds 
Uncalled bet ($0.15) returned to qwe17
qwe17 collected $0.25 from pot
qwe17: doesn't show hand 
*** SUMMARY ***
Total pot $0.25 | Rake $0 
Seat 1: Romeo rus89 (small blind) folded before Flop
Seat 2: fish72o (big blind) folded before Flop
Seat 3: reznor1 folded before Flop (didn't bet)
Seat 4: qwe17 collected ($0.25)
Seat 5: 12311985 folded before Flop (didn't bet)
Seat 6: Pablo7-Pro (button) folded before Flop (didn't bet)



PokerStars Hand #222945896363:  Hold'em No Limit ($0.05/$0.10 USD) - 2021/01/23 1:18:02 ET
Table 'Polydoros II' 6-max Seat #1 is the button
Seat 1: Romeo rus89 ($7.82 in chips) 
Seat 2: fish72o ($10.37 in chips) 
Seat 3: reznor1 ($13 in chips) 
Seat 4: qwe17 ($10.04 in chips) 
Seat 5: 12311985 ($12.27 in chips) 
Seat 6: Pablo7-Pro ($14.82 in chips) 
fish72o: posts small blind $0.05
reznor1: posts big blind $0.10
*** HOLE CARDS ***
qwe17: raises $0.15 to $0.25
12311985: folds 
Pablo7-Pro: folds 
Romeo rus89: folds 
fish72o: raises $0.85 to $1.10
reznor1: folds 
qwe17: folds 
Uncalled bet ($0.85) returned to fish72o
fish72o collected $0.60 from pot
fish72o: doesn't show hand 
*** SUMMARY ***
Total pot $0.60 | Rake $0 
Seat 1: Romeo rus89 (button) folded before Flop (didn't bet)
Seat 2: fish72o (small blind) collected ($0.60)
Seat 3: reznor1 (big blind) folded before Flop
Seat 4: qwe17 folded before Flop
Seat 5: 12311985 folded before Flop (didn't bet)
Seat 6: Pablo7-Pro folded before Flop (didn't bet)



PokerStars Hand #222945905665:  Hold'em No Limit ($0.05/$0.10 USD) - 2021/01/23 1:18:40 ET
Table 'Polydoros II' 6-max Seat #2 is the button
Seat 1: Romeo rus89 ($7.82 in chips) 
Seat 2: fish72o ($10.72 in chips) 
Seat 3: reznor1 ($12.90 in chips) 
Seat 4: qwe17 ($9.79 in chips) 
Seat 5: 12311985 ($12.27 in chips) 
Seat 6: Pablo7-Pro ($14.82 in chips) 
reznor1: posts small blind $0.05
qwe17: posts big blind $0.10
*** HOLE CARDS ***
12311985: folds 
Pablo7-Pro: folds 
Romeo rus89: folds 
fish72o: folds 
reznor1: folds 
Uncalled bet ($0.05) returned to qwe17
qwe17 collected $0.10 from pot
qwe17: doesn't show hand 
*** SUMMARY ***
Total pot $0.10 | Rake $0 
Seat 1: Romeo rus89 folded before Flop (didn't bet)
Seat 2: fish72o (button) folded before Flop (didn't bet)
Seat 3: reznor1 (small blind) folded before Flop
Seat 4: qwe17 (big blind) collected ($0.10)
Seat 5: 12311985 folded before Flop (didn't bet)
Seat 6: Pablo7-Pro folded before Flop (didn't bet)



PokerStars Hand #222945909117:  Hold'em No Limit ($0.05/$0.10 USD) - 2021/01/23 1:18:54 ET
Table 'Polydoros II' 6-max Seat #3 is the button
Seat 1: Romeo rus89 ($7.82 in chips) 
Seat 2: fish72o ($10.72 in chips) 
Seat 3: reznor1 ($12.85 in chips) 
Seat 4: qwe17 ($9.84 in chips) 
Seat 5: 12311985 ($12.27 in chips) 
Seat 6: Pablo7-Pro ($14.82 in chips) 
qwe17: posts small blind $0.05
12311985: posts big blind $0.10
*** HOLE CARDS ***
Pablo7-Pro: folds 
Romeo rus89: raises $0.20 to $0.30
fish72o: folds 
reznor1: folds 
qwe17: folds 
12311985: folds 
Uncalled bet ($0.20) returned to Romeo rus89
Romeo rus89 collected $0.25 from pot
*** SUMMARY ***
Total pot $0.25 | Rake $0 
Seat 1: Romeo rus89 collected ($0.25)
Seat 2: fish72o folded before Flop (didn't bet)
Seat 3: reznor1 (button) folded before Flop (didn't bet)
Seat 4: qwe17 (small blind) folded before Flop
Seat 5: 12311985 (big blind) folded before Flop
Seat 6: Pablo7-Pro folded before Flop (didn't bet)



PokerStars Hand #222945912201:  Hold'em No Limit ($0.05/$0.10 USD) - 2021/01/23 1:19:07 ET
Table 'Polydoros II' 6-max Seat #4 is the button
Seat 1: Romeo rus89 ($7.97 in chips) 
Seat 2: fish72o ($10.72 in chips) 
Seat 3: reznor1 ($12.85 in chips) 
Seat 4: qwe17 ($9.79 in chips) 
Seat 5: 12311985 ($12.17 in chips) 
Seat 6: Pablo7-Pro ($14.82 in chips) 
12311985: posts small blind $0.05
Pablo7-Pro: posts big blind $0.10
*** HOLE CARDS ***
Romeo rus89: folds 
fish72o: folds 
reznor1: folds 
qwe17: raises $0.15 to $0.25
12311985: folds 
Pablo7-Pro: calls $0.15
*** FLOP *** [9d Kc 3s]
Pablo7-Pro: checks 
qwe17: bets $0.40
Pablo7-Pro: calls $0.40
*** TURN *** [9d Kc 3s] [8d]
Pablo7-Pro: checks 
qwe17: bets $0.97
Pablo7-Pro: folds 
Uncalled bet ($0.97) returned to qwe17
qwe17 collected $1.29 from pot
qwe17: doesn't show hand 
*** SUMMARY ***
Total pot $1.35 | Rake $0.06 
Board [9d Kc 3s 8d]
Seat 1: Romeo rus89 folded before Flop (didn't bet)
Seat 2: fish72o folded before Flop (didn't bet)
Seat 3: reznor1 folded before Flop (didn't bet)
Seat 4: qwe17 (button) collected ($1.29)
Seat 5: 12311985 (small blind) folded before Flop
Seat 6: Pablo7-Pro (big blind) folded on the Turn



PokerStars Hand #222945923661:  Hold'em No Limit ($0.05/$0.10 USD) - 2021/01/23 1:19:54 ET
Table 'Polydoros II' 6-max Seat #5 is the button
Seat 1: Romeo rus89 ($7.97 in chips) 
Seat 2: fish72o ($10.72 in chips) 
Seat 3: reznor1 ($12.85 in chips) 
Seat 4: qwe17 ($10.43 in chips) 
Seat 5: 12311985 ($12.12 in chips) 
Seat 6: Pablo7-Pro ($14.17 in chips) 
Pablo7-Pro: posts small blind $0.05
Romeo rus89: posts big blind $0.10
*** HOLE CARDS ***
fish72o: folds 
reznor1: folds 
qwe17: folds 
12311985: folds 
Pablo7-Pro: folds 
Uncalled bet ($0.05) returned to Romeo rus89
Romeo rus89 collected $0.10 from pot
*** SUMMARY ***
Total pot $0.10 | Rake $0 
Seat 1: Romeo rus89 (big blind) collected ($0.10)
Seat 2: fish72o folded before Flop (didn't bet)
Seat 3: reznor1 folded before Flop (didn't bet)
Seat 4: qwe17 folded before Flop (didn't bet)
Seat 5: 12311985 (button) folded before Flop (didn't bet)
Seat 6: Pablo7-Pro (small blind) folded before Flop



PokerStars Hand #222945926240:  Hold'em No Limit ($0.05/$0.10 USD) - 2021/01/23 1:20:04 ET
Table 'Polydoros II' 6-max Seat #6 is the button
Seat 1: Romeo rus89 ($8.02 in chips) 
Seat 2: fish72o ($10.72 in chips) 
Seat 3: reznor1 ($12.85 in chips) 
Seat 4: qwe17 ($10.43 in chips) 
Seat 5: 12311985 ($12.12 in chips) 
Seat 6: Pablo7-Pro ($14.12 in chips) 
Romeo rus89: posts small blind $0.05
fish72o: posts big blind $0.10
*** HOLE CARDS ***
reznor1: folds 
qwe17: raises $0.15 to $0.25
12311985: raises $0.50 to $0.75
Pablo7-Pro: folds 
Romeo rus89: folds 
fish72o: folds 
qwe17: folds 
Uncalled bet ($0.50) returned to 12311985
12311985 collected $0.65 from pot
12311985: doesn't show hand 
*** SUMMARY ***
Total pot $0.65 | Rake $0 
Seat 1: Romeo rus89 (small blind) folded before Flop
Seat 2: fish72o (big blind) folded before Flop
Seat 3: reznor1 folded before Flop (didn't bet)
Seat 4: qwe17 folded before Flop
Seat 5: 12311985 collected ($0.65)
Seat 6: Pablo7-Pro (button) folded before Flop (didn't bet)



PokerStars Hand #222945930725:  Hold'em No Limit ($0.05/$0.10 USD) - 2021/01/23 1:20:23 ET
Table 'Polydoros II' 6-max Seat #1 is the button
Seat 1: Romeo rus89 ($7.97 in chips) 
Seat 2: fish72o ($10.62 in chips) 
Seat 3: reznor1 ($12.85 in chips) 
Seat 4: qwe17 ($10.18 in chips) 
Seat 5: 12311985 ($12.52 in chips) 
Seat 6: Pablo7-Pro ($14.12 in chips) 
fish72o: posts small blind $0.05
reznor1: posts big blind $0.10
*** HOLE CARDS ***
qwe17: folds 
12311985: folds 
Pablo7-Pro: raises $0.20 to $0.30
Romeo rus89: folds 
fish72o: folds 
reznor1: calls $0.20
*** FLOP *** [4h 2c 6s]
reznor1: checks 
Pablo7-Pro: checks 
*** TURN *** [4h 2c 6s] [Ad]
reznor1: checks 
Pablo7-Pro: checks 
*** RIVER *** [4h 2c 6s Ad] [8d]
reznor1: bets $0.19
Pablo7-Pro: folds 
Uncalled bet ($0.19) returned to reznor1
reznor1 collected $0.62 from pot
*** SUMMARY ***
Total pot $0.65 | Rake $0.03 
Board [4h 2c 6s Ad 8d]
Seat 1: Romeo rus89 (button) folded before Flop (didn't bet)
Seat 2: fish72o (small blind) folded before Flop
Seat 3: reznor1 (big blind) collected ($0.62)
Seat 4: qwe17 folded before Flop (didn't bet)
Seat 5: 12311985 folded before Flop (didn't bet)
Seat 6: Pablo7-Pro folded on the River



PokerStars Hand #222945941327:  Hold'em No Limit ($0.05/$0.10 USD) - 2021/01/23 1:21:06 ET
Table 'Polydoros II' 6-max Seat #2 is the button
Seat 1: Romeo rus89 ($7.97 in chips) 
Seat 2: fish72o ($10.57 in chips) 
Seat 3: reznor1 ($13.17 in chips) 
Seat 4: qwe17 ($10.18 in chips) 
Seat 5: 12311985 ($12.52 in chips) 
Seat 6: Pablo7-Pro ($13.82 in chips) 
reznor1: posts small blind $0.05
qwe17: posts big blind $0.10
*** HOLE CARDS ***
12311985: folds 
Pablo7-Pro: folds 
Romeo rus89: folds 
fish72o: folds 
reznor1: folds 
Uncalled bet ($0.05) returned to qwe17
qwe17 collected $0.10 from pot
qwe17: doesn't show hand 
*** SUMMARY ***
Total pot $0.10 | Rake $0 
Seat 1: Romeo rus89 folded before Flop (didn't bet)
Seat 2: fish72o (button) folded before Flop (didn't bet)
Seat 3: reznor1 (small blind) folded before Flop
Seat 4: qwe17 (big blind) collected ($0.10)
Seat 5: 12311985 folded before Flop (didn't bet)
Seat 6: Pablo7-Pro folded before Flop (didn't bet)



PokerStars Hand #222945944956:  Hold'em No Limit ($0.05/$0.10 USD) - 2021/01/23 1:21:21 ET
Table 'Polydoros II' 6-max Seat #3 is the button
Seat 1: Romeo rus89 ($7.97 in chips) 
Seat 2: fish72o ($10.57 in chips) 
Seat 3: reznor1 ($13.12 in chips) 
Seat 4: qwe17 ($10.23 in chips) 
Seat 5: 12311985 ($12.52 in chips) 
Seat 6: Pablo7-Pro ($13.82 in chips) 
qwe17: posts small blind $0.05
12311985: posts big blind $0.10
*** HOLE CARDS ***
Pablo7-Pro: folds 
Romeo rus89: folds 
fish72o: folds 
reznor1: folds 
qwe17: folds 
Uncalled bet ($0.05) returned to 12311985
12311985 collected $0.10 from pot
12311985: doesn't show hand 
*** SUMMARY ***
Total pot $0.10 | Rake $0 
Seat 1: Romeo rus89 folded before Flop (didn't bet)
Seat 2: fish72o folded before Flop (didn't bet)
Seat 3: reznor1 (button) folded before Flop (didn't bet)
Seat 4: qwe17 (small blind) folded before Flop
Seat 5: 12311985 (big blind) collected ($0.10)
Seat 6: Pablo7-Pro folded before Flop (didn't bet)



PokerStars Hand #222945947861:  Hold'em No Limit ($0.05/$0.10 USD) - 2021/01/23 1:21:33 ET
Table 'Polydoros II' 6-max Seat #4 is the button
Seat 1: Romeo rus89 ($7.97 in chips) 
Seat 2: fish72o ($10.57 in chips) 
Seat 3: reznor1 ($13.12 in chips) 
Seat 4: qwe17 ($10.18 in chips) 
Seat 5: 12311985 ($12.57 in chips) 
Seat 6: Pablo7-Pro ($13.82 in chips) 
12311985: posts small blind $0.05
Pablo7-Pro: posts big blind $0.10
*** HOLE CARDS ***
Romeo rus89: folds 
fish72o: folds 
reznor1: calls $0.10
qwe17: folds 
12311985: folds 
Pablo7-Pro: checks 
*** FLOP *** [7s Jc 9h]
Pablo7-Pro: checks 
reznor1: bets $0.12
Pablo7-Pro: calls $0.12
*** TURN *** [7s Jc 9h] [Js]
Pablo7-Pro: checks 
reznor1: bets $0.20
Pablo7-Pro: calls $0.20
*** RIVER *** [7s Jc 9h Js] [Ts]
Pablo7-Pro: checks 
reznor1: checks 
*** SHOW DOWN ***
Pablo7-Pro: shows [3d 7h] (two pair, Jacks and Sevens)
reznor1: shows [9d As] (two pair, Jacks and Nines)
reznor1 collected $0.85 from pot
*** SUMMARY ***
Total pot $0.89 | Rake $0.04 
Board [7s Jc 9h Js Ts]
Seat 1: Romeo rus89 folded before Flop (didn't bet)
Seat 2: fish72o folded before Flop (didn't bet)
Seat 3: reznor1 showed [9d As] and won ($0.85) with two pair, Jacks and Nines
Seat 4: qwe17 (button) folded before Flop (didn't bet)
Seat 5: 12311985 (small blind) folded before Flop
Seat 6: Pablo7-Pro (big blind) showed [3d 7h] and lost with two pair, Jacks and Sevens



PokerStars Hand #222946000240:  Hold'em No Limit ($0.05/$0.10 USD) - 2021/01/23 1:25:09 ET
Table 'Polydoros II' 6-max Seat #1 is the button
Seat 1: Romeo rus89 ($7.67 in chips) 
Seat 2: fish72o ($10.94 in chips) 
Seat 3: reznor1 ($13.08 in chips) 
Seat 4: qwe17 ($10.33 in chips) 
Seat 5: 12311985 ($12.67 in chips) 
Seat 6: Pablo7-Pro ($13.43 in chips) 
fish72o: posts small blind $0.05
reznor1: posts big blind $0.10
*** HOLE CARDS ***
qwe17: raises $0.15 to $0.25
12311985: folds 
Pablo7-Pro: folds 
Romeo rus89: calls $0.25
fish72o: folds 
reznor1: folds 
*** FLOP *** [7d 4d Qh]
qwe17: bets $0.31
Romeo rus89: raises $0.62 to $0.93
qwe17: calls $0.62
*** TURN *** [7d 4d Qh] [Kc]
qwe17: checks 
Romeo rus89: bets $1.60
qwe17: calls $1.60
*** RIVER *** [7d 4d Qh Kc] [Kd]
qwe17: bets $7.55 and is all-in
Romeo rus89: calls $4.89 and is all-in
Uncalled bet ($2.66) returned to qwe17
*** SHOW DOWN ***
qwe17: shows [Kh Qd] (a full house, Kings full of Queens)
Romeo rus89: shows [Ks Jd] (three of a kind, Kings)
qwe17 collected $14.79 from pot
*** SUMMARY ***
Total pot $15.49 | Rake $0.70 
Board [7d 4d Qh Kc Kd]
Seat 1: Romeo rus89 (button) showed [Ks Jd] and lost with three of a kind, Kings
Seat 2: fish72o (small blind) folded before Flop
Seat 3: reznor1 (big blind) folded before Flop
Seat 4: qwe17 showed [Kh Qd] and won ($14.79) with a full house, Kings full of Queens
Seat 5: 12311985 folded before Flop (didn't bet)
Seat 6: Pablo7-Pro folded before Flop (didn't bet)



PokerStars Hand #222946016296:  Hold'em No Limit ($0.05/$0.10 USD) - 2021/01/23 1:26:16 ET
Table 'Polydoros II' 6-max Seat #2 is the button
Seat 1: Romeo rus89 ($10 in chips) 
Seat 2: fish72o ($10.89 in chips) 
Seat 3: reznor1 ($12.98 in chips) 
Seat 5: 12311985 ($12.67 in chips) 
Seat 6: Pablo7-Pro ($13.43 in chips) 
reznor1: posts small blind $0.05
qwe17: is sitting out 
12311985: posts big blind $0.10
*** HOLE CARDS ***
Pablo7-Pro: folds 
Romeo rus89: folds 
fish72o: folds 
reznor1: folds 
Uncalled bet ($0.05) returned to 12311985
12311985 collected $0.10 from pot
12311985: doesn't show hand 
*** SUMMARY ***
Total pot $0.10 | Rake $0 
Seat 1: Romeo rus89 folded before Flop (didn't bet)
Seat 2: fish72o (button) folded before Flop (didn't bet)
Seat 3: reznor1 (small blind) folded before Flop
Seat 5: 12311985 (big blind) collected ($0.10)
Seat 6: Pablo7-Pro folded before Flop (didn't bet)



PokerStars Hand #222946020250:  Hold'em No Limit ($0.05/$0.10 USD) - 2021/01/23 1:26:32 ET
Table 'Polydoros II' 6-max Seat #3 is the button
Seat 1: Romeo rus89 ($10 in chips) 
Seat 2: fish72o ($10.89 in chips) 
Seat 3: reznor1 ($12.93 in chips) 
Seat 5: 12311985 ($12.72 in chips) 
Seat 6: Pablo7-Pro ($13.43 in chips) 
12311985: posts small blind $0.05
Pablo7-Pro: posts big blind $0.10
*** HOLE CARDS ***
Romeo rus89: raises $0.20 to $0.30
fish72o: calls $0.30
reznor1: folds 
12311985: folds 
Pablo7-Pro: calls $0.20
*** FLOP *** [7h 6s Js]
Pablo7-Pro: checks 
Romeo rus89: checks 
fish72o: bets $0.30
Pablo7-Pro: calls $0.30
Romeo rus89: folds 
*** TURN *** [7h 6s Js] [4s]
Pablo7-Pro: checks 
fish72o: checks 
*** RIVER *** [7h 6s Js 4s] [9c]
Pablo7-Pro: bets $1.15
fish72o: folds 
Uncalled bet ($1.15) returned to Pablo7-Pro
Pablo7-Pro collected $1.48 from pot
Pablo7-Pro: doesn't show hand 
*** SUMMARY ***
Total pot $1.55 | Rake $0.07 
Board [7h 6s Js 4s 9c]
Seat 1: Romeo rus89 folded on the Flop
Seat 2: fish72o folded on the River
Seat 3: reznor1 (button) folded before Flop (didn't bet)
Seat 5: 12311985 (small blind) folded before Flop
Seat 6: Pablo7-Pro (big blind) collected ($1.48)



PokerStars Hand #222946029939:  Hold'em No Limit ($0.05/$0.10 USD) - 2021/01/23 1:27:13 ET
Table 'Polydoros II' 6-max Seat #5 is the button
Seat 1: Romeo rus89 ($9.70 in chips) 
Seat 2: fish72o ($10.29 in chips) 
Seat 3: reznor1 ($12.93 in chips) 
Seat 5: 12311985 ($12.67 in chips) 
Seat 6: Pablo7-Pro ($14.31 in chips) 
Pablo7-Pro: posts small blind $0.05
Romeo rus89: posts big blind $0.10
qwe17: sits out 
*** HOLE CARDS ***
qwe17 leaves the table
fish72o: folds 
reznor1: folds 
12311985: raises $0.20 to $0.30
Pablo7-Pro: folds 
Romeo rus89: folds 
Uncalled bet ($0.20) returned to 12311985
12311985 collected $0.25 from pot
12311985: doesn't show hand 
*** SUMMARY ***
Total pot $0.25 | Rake $0 
Seat 1: Romeo rus89 (big blind) folded before Flop
Seat 2: fish72o folded before Flop (didn't bet)
Seat 3: reznor1 folded before Flop (didn't bet)
Seat 5: 12311985 (button) collected ($0.25)
Seat 6: Pablo7-Pro (small blind) folded before Flop



PokerStars Hand #222946034372:  Hold'em No Limit ($0.05/$0.10 USD) - 2021/01/23 1:27:32 ET
Table 'Polydoros II' 6-max Seat #6 is the button
Seat 1: Romeo rus89 ($9.60 in chips) 
Seat 2: fish72o ($10.29 in chips) 
Seat 3: reznor1 ($12.93 in chips) 
Seat 5: 12311985 ($12.82 in chips) 
Seat 6: Pablo7-Pro ($14.26 in chips) 
Romeo rus89: posts small blind $0.05
fish72o: posts big blind $0.10
*** HOLE CARDS ***
reznor1: calls $0.10
12311985: folds 
Pablo7-Pro: folds 
Romeo rus89: folds 
fish72o: raises $0.25 to $0.35
reznor1: calls $0.25
*** FLOP *** [3s Qs 7d]
fish72o: bets $0.48
reznor1: folds 
Uncalled bet ($0.48) returned to fish72o
fish72o collected $0.72 from pot
fish72o: doesn't show hand 
*** SUMMARY ***
Total pot $0.75 | Rake $0.03 
Board [3s Qs 7d]
Seat 1: Romeo rus89 (small blind) folded before Flop
Seat 2: fish72o (big blind) collected ($0.72)
Seat 3: reznor1 folded on the Flop
Seat 5: 12311985 folded before Flop (didn't bet)
Seat 6: Pablo7-Pro (button) folded before Flop (didn't bet)



PokerStars Hand #222946042605:  Hold'em No Limit ($0.05/$0.10 USD) - 2021/01/23 1:28:06 ET
Table 'Polydoros II' 6-max Seat #1 is the button
Seat 1: Romeo rus89 ($9.55 in chips) 
Seat 2: fish72o ($10.66 in chips) 
Seat 3: reznor1 ($12.58 in chips) 
Seat 5: 12311985 ($12.82 in chips) 
Seat 6: Pablo7-Pro ($14.26 in chips) 
fish72o: posts small blind $0.05
reznor1: posts big blind $0.10
*** HOLE CARDS ***
12311985: folds 
Pablo7-Pro has timed out
Pablo7-Pro: folds 
Romeo rus89: raises $0.15 to $0.25
fish72o: calls $0.20
reznor1: folds 
*** FLOP *** [3d 8c Ts]
fish72o: checks 
Romeo rus89: bets $0.38
fish72o: folds 
Uncalled bet ($0.38) returned to Romeo rus89
Romeo rus89 collected $0.57 from pot
*** SUMMARY ***
Total pot $0.60 | Rake $0.03 
Board [3d 8c Ts]
Seat 1: Romeo rus89 (button) collected ($0.57)
Seat 2: fish72o (small blind) folded on the Flop
Seat 3: reznor1 (big blind) folded before Flop
Seat 5: 12311985 folded before Flop (didn't bet)
Seat 6: Pablo7-Pro folded before Flop (didn't bet)



PokerStars Hand #222946051107:  Hold'em No Limit ($0.05/$0.10 USD) - 2021/01/23 1:28:41 ET
Table 'Polydoros II' 6-max Seat #2 is the button
Seat 1: Romeo rus89 ($9.87 in chips) 
Seat 2: fish72o ($10.41 in chips) 
Seat 3: reznor1 ($12.48 in chips) 
Seat 5: 12311985 ($12.82 in chips) 
Seat 6: Pablo7-Pro ($14.26 in chips) 
reznor1: posts small blind $0.05
12311985: posts big blind $0.10
*** HOLE CARDS ***
Cocacol422 joins the table at seat #4 
Pablo7-Pro: folds 
Romeo rus89: folds 
fish72o: folds 
reznor1: folds 
Uncalled bet ($0.05) returned to 12311985
12311985 collected $0.10 from pot
12311985: doesn't show hand 
*** SUMMARY ***
Total pot $0.10 | Rake $0 
Seat 1: Romeo rus89 folded before Flop (didn't bet)
Seat 2: fish72o (button) folded before Flop (didn't bet)
Seat 3: reznor1 (small blind) folded before Flop
Seat 5: 12311985 (big blind) collected ($0.10)
Seat 6: Pablo7-Pro folded before Flop (didn't bet)



PokerStars Hand #222946053752:  Hold'em No Limit ($0.05/$0.10 USD) - 2021/01/23 1:28:52 ET
Table 'Polydoros II' 6-max Seat #3 is the button
Seat 1: Romeo rus89 ($9.87 in chips) 
Seat 2: fish72o ($10.41 in chips) 
Seat 3: reznor1 ($12.43 in chips) 
Seat 5: 12311985 ($12.87 in chips) 
Seat 6: Pablo7-Pro ($14.26 in chips) 
12311985: posts small blind $0.05
Pablo7-Pro: posts big blind $0.10
*** HOLE CARDS ***
Romeo rus89: raises $0.20 to $0.30
fish72o: folds 
reznor1: folds 
12311985: folds 
Pablo7-Pro: folds 
Uncalled bet ($0.20) returned to Romeo rus89
Romeo rus89 collected $0.25 from pot
*** SUMMARY ***
Total pot $0.25 | Rake $0 
Seat 1: Romeo rus89 collected ($0.25)
Seat 2: fish72o folded before Flop (didn't bet)
Seat 3: reznor1 (button) folded before Flop (didn't bet)
Seat 5: 12311985 (small blind) folded before Flop
Seat 6: Pablo7-Pro (big blind) folded before Flop



PokerStars Hand #222946055951:  Hold'em No Limit ($0.05/$0.10 USD) - 2021/01/23 1:29:01 ET
Table 'Polydoros II' 6-max Seat #5 is the button
Seat 1: Romeo rus89 ($10.02 in chips) 
Seat 2: fish72o ($10.41 in chips) 
Seat 3: reznor1 ($12.43 in chips) 
Seat 4: Cocacol422 ($4 in chips) 
Seat 5: 12311985 ($12.82 in chips) 
Seat 6: Pablo7-Pro ($14.16 in chips) 
Pablo7-Pro: posts small blind $0.05
Romeo rus89: posts big blind $0.10
Cocacol422: posts big blind $0.10
*** HOLE CARDS ***
fish72o: folds 
reznor1: folds 
Cocacol422: checks 
12311985: raises $0.35 to $0.45
Pablo7-Pro: folds 
Romeo rus89: folds 
Cocacol422: folds 
Uncalled bet ($0.35) returned to 12311985
12311985 collected $0.35 from pot
12311985: doesn't show hand 
*** SUMMARY ***
Total pot $0.35 | Rake $0 
Seat 1: Romeo rus89 (big blind) folded before Flop
Seat 2: fish72o folded before Flop (didn't bet)
Seat 3: reznor1 folded before Flop (didn't bet)
Seat 4: Cocacol422 folded before Flop (didn't bet)
Seat 5: 12311985 (button) collected ($0.35)
Seat 6: Pablo7-Pro (small blind) folded before Flop



PokerStars Hand #222946061462:  Hold'em No Limit ($0.05/$0.10 USD) - 2021/01/23 1:29:24 ET
Table 'Polydoros II' 6-max Seat #6 is the button
Seat 1: Romeo rus89 ($9.92 in chips) 
Seat 2: fish72o ($10.41 in chips) 
Seat 3: reznor1 ($12.43 in chips) 
Seat 4: Cocacol422 ($3.90 in chips) 
Seat 5: 12311985 ($13.07 in chips) 
Seat 6: Pablo7-Pro ($14.11 in chips) 
Romeo rus89: posts small blind $0.05
fish72o: posts big blind $0.10
*** HOLE CARDS ***
reznor1: folds 
Cocacol422: folds 
12311985: folds 
Pablo7-Pro: folds 
Romeo rus89: raises $0.15 to $0.25
fish72o: folds 
Uncalled bet ($0.15) returned to Romeo rus89
Romeo rus89 collected $0.20 from pot
*** SUMMARY ***
Total pot $0.20 | Rake $0 
Seat 1: Romeo rus89 (small blind) collected ($0.20)
Seat 2: fish72o (big blind) folded before Flop
Seat 3: reznor1 folded before Flop (didn't bet)
Seat 4: Cocacol422 folded before Flop (didn't bet)
Seat 5: 12311985 folded before Flop (didn't bet)
Seat 6: Pablo7-Pro (button) folded before Flop (didn't bet)



PokerStars Hand #222946065718:  Hold'em No Limit ($0.05/$0.10 USD) - 2021/01/23 1:29:41 ET
Table 'Polydoros II' 6-max Seat #1 is the button
Seat 1: Romeo rus89 ($10.02 in chips) 
Seat 2: fish72o ($10.31 in chips) 
Seat 3: reznor1 ($12.43 in chips) 
Seat 4: Cocacol422 ($3.90 in chips) 
Seat 5: 12311985 ($13.07 in chips) 
Seat 6: Pablo7-Pro ($14.11 in chips) 
fish72o: posts small blind $0.05
reznor1: posts big blind $0.10
*** HOLE CARDS ***
Cocacol422: folds 
12311985: folds 
Pablo7-Pro: folds 
Romeo rus89: folds 
fish72o: raises $0.15 to $0.25
reznor1: folds 
Uncalled bet ($0.15) returned to fish72o
fish72o collected $0.20 from pot
fish72o: doesn't show hand 
*** SUMMARY ***
Total pot $0.20 | Rake $0 
Seat 1: Romeo rus89 (button) folded before Flop (didn't bet)
Seat 2: fish72o (small blind) collected ($0.20)
Seat 3: reznor1 (big blind) folded before Flop
Seat 4: Cocacol422 folded before Flop (didn't bet)
Seat 5: 12311985 folded before Flop (didn't bet)
Seat 6: Pablo7-Pro folded before Flop (didn't bet)



PokerStars Hand #222946070108:  Hold'em No Limit ($0.05/$0.10 USD) - 2021/01/23 1:29:59 ET
Table 'Polydoros II' 6-max Seat #2 is the button
Seat 1: Romeo rus89 ($10.02 in chips) 
Seat 2: fish72o ($10.41 in chips) 
Seat 3: reznor1 ($12.33 in chips) 
Seat 4: Cocacol422 ($3.90 in chips) 
Seat 5: 12311985 ($13.07 in chips) 
Seat 6: Pablo7-Pro ($14.11 in chips) 
reznor1: posts small blind $0.05
Cocacol422: posts big blind $0.10
*** HOLE CARDS ***
12311985: folds 
Pablo7-Pro: folds 
Romeo rus89: folds 
fish72o: raises $0.15 to $0.25
reznor1: folds 
Cocacol422: calls $0.15
*** FLOP *** [4c 7h Kc]
Cocacol422: checks 
fish72o: bets $0.17
Cocacol422: calls $0.17
*** TURN *** [4c 7h Kc] [7d]
Cocacol422: checks 
fish72o: checks 
*** RIVER *** [4c 7h Kc 7d] [2s]
Cocacol422: checks 
fish72o: checks 
*** SHOW DOWN ***
Cocacol422: shows [3s Ah] (a pair of Sevens)
fish72o: shows [Ad Js] (a pair of Sevens - Ace+King+Jack kicker)
fish72o collected $0.85 from pot
*** SUMMARY ***
Total pot $0.89 | Rake $0.04 
Board [4c 7h Kc 7d 2s]
Seat 1: Romeo rus89 folded before Flop (didn't bet)
Seat 2: fish72o (button) showed [Ad Js] and won ($0.85) with a pair of Sevens
Seat 3: reznor1 (small blind) folded before Flop
Seat 4: Cocacol422 (big blind) showed [3s Ah] and lost with a pair of Sevens
Seat 5: 12311985 folded before Flop (didn't bet)
Seat 6: Pablo7-Pro folded before Flop (didn't bet)



PokerStars Hand #222946077738:  Hold'em No Limit ($0.05/$0.10 USD) - 2021/01/23 1:30:30 ET
Table 'Polydoros II' 6-max Seat #3 is the button
Seat 1: Romeo rus89 ($10.02 in chips) 
Seat 2: fish72o ($10.84 in chips) 
Seat 3: reznor1 ($12.28 in chips) 
Seat 4: Cocacol422 ($3.48 in chips) 
Seat 5: 12311985 ($13.07 in chips) 
Seat 6: Pablo7-Pro ($14.11 in chips) 
Cocacol422: posts small blind $0.05
12311985: posts big blind $0.10
*** HOLE CARDS ***
Pablo7-Pro: folds 
Romeo rus89: folds 
fish72o: folds 
reznor1: folds 
Cocacol422: raises $0.10 to $0.20
12311985: calls $0.10
*** FLOP *** [2d Kd 2h]
Cocacol422: checks 
12311985: bets $0.27
Cocacol422: folds 
Uncalled bet ($0.27) returned to 12311985
12311985 collected $0.38 from pot
12311985: doesn't show hand 
*** SUMMARY ***
Total pot $0.40 | Rake $0.02 
Board [2d Kd 2h]
Seat 1: Romeo rus89 folded before Flop (didn't bet)
Seat 2: fish72o folded before Flop (didn't bet)
Seat 3: reznor1 (button) folded before Flop (didn't bet)
Seat 4: Cocacol422 (small blind) folded on the Flop
Seat 5: 12311985 (big blind) collected ($0.38)
Seat 6: Pablo7-Pro folded before Flop (didn't bet)



PokerStars Hand #222946082299:  Hold'em No Limit ($0.05/$0.10 USD) - 2021/01/23 1:30:49 ET
Table 'Polydoros II' 6-max Seat #4 is the button
Seat 1: Romeo rus89 ($10.02 in chips) 
Seat 2: fish72o ($10.84 in chips) 
Seat 3: reznor1 ($12.28 in chips) 
Seat 4: Cocacol422 ($3.28 in chips) 
Seat 5: 12311985 ($13.25 in chips) 
Seat 6: Pablo7-Pro ($14.11 in chips) 
12311985: posts small blind $0.05
Pablo7-Pro: posts big blind $0.10
*** HOLE CARDS ***
Romeo rus89: folds 
fish72o: folds 
reznor1: folds 
Cocacol422: calls $0.10
12311985: raises $0.30 to $0.40
Pablo7-Pro: folds 
Cocacol422: calls $0.30
*** FLOP *** [Ah 9c 3h]
12311985: bets $0.26
Cocacol422: calls $0.26
*** TURN *** [Ah 9c 3h] [Js]
12311985: bets $0.68
Cocacol422: calls $0.68
*** RIVER *** [Ah 9c 3h Js] [7d]
12311985: checks 
Cocacol422: checks 
*** SHOW DOWN ***
12311985: shows [Jc Qc] (a pair of Jacks)
Cocacol422: shows [2h As] (a pair of Aces)
Cocacol422 collected $2.65 from pot
*** SUMMARY ***
Total pot $2.78 | Rake $0.13 
Board [Ah 9c 3h Js 7d]
Seat 1: Romeo rus89 folded before Flop (didn't bet)
Seat 2: fish72o folded before Flop (didn't bet)
Seat 3: reznor1 folded before Flop (didn't bet)
Seat 4: Cocacol422 (button) showed [2h As] and won ($2.65) with a pair of Aces
Seat 5: 12311985 (small blind) showed [Jc Qc] and lost with a pair of Jacks
Seat 6: Pablo7-Pro (big blind) folded before Flop



PokerStars Hand #222946090885:  Hold'em No Limit ($0.05/$0.10 USD) - 2021/01/23 1:31:24 ET
Table 'Polydoros II' 6-max Seat #5 is the button
Seat 1: Romeo rus89 ($10.02 in chips) 
Seat 2: fish72o ($10.84 in chips) 
Seat 3: reznor1 ($12.28 in chips) 
Seat 4: Cocacol422 ($4.59 in chips) 
Seat 5: 12311985 ($11.91 in chips) 
Seat 6: Pablo7-Pro ($14.01 in chips) 
Pablo7-Pro: posts small blind $0.05
Romeo rus89: posts big blind $0.10
*** HOLE CARDS ***
fish72o: folds 
reznor1: calls $0.10
Cocacol422: calls $0.10
12311985: folds 
Pablo7-Pro: folds 
Romeo rus89: checks 
*** FLOP *** [2h 7s 3d]
Romeo rus89: checks 
reznor1: checks 
Cocacol422: checks 
*** TURN *** [2h 7s 3d] [Qd]
Romeo rus89: checks 
reznor1: checks 
Cocacol422: checks 
*** RIVER *** [2h 7s 3d Qd] [7h]
Romeo rus89: checks 
reznor1: checks 
Cocacol422: bets $0.20
Romeo rus89: folds 
reznor1: folds 
Uncalled bet ($0.20) returned to Cocacol422
Cocacol422 collected $0.33 from pot
Cocacol422: doesn't show hand 
*** SUMMARY ***
Total pot $0.35 | Rake $0.02 
Board [2h 7s 3d Qd 7h]
Seat 1: Romeo rus89 (big blind) folded on the River
Seat 2: fish72o folded before Flop (didn't bet)
Seat 3: reznor1 folded on the River
Seat 4: Cocacol422 collected ($0.33)
Seat 5: 12311985 (button) folded before Flop (didn't bet)
Seat 6: Pablo7-Pro (small blind) folded before Flop



PokerStars Hand #222946100122:  Hold'em No Limit ($0.05/$0.10 USD) - 2021/01/23 1:32:01 ET
Table 'Polydoros II' 6-max Seat #6 is the button
Seat 1: Romeo rus89 ($9.92 in chips) 
Seat 2: fish72o ($10.84 in chips) 
Seat 3: reznor1 ($12.18 in chips) 
Seat 4: Cocacol422 ($4.82 in chips) 
Seat 5: 12311985 ($11.91 in chips) 
Seat 6: Pablo7-Pro ($13.96 in chips) 
Romeo rus89: posts small blind $0.05
fish72o: posts big blind $0.10
*** HOLE CARDS ***
reznor1: folds 
Cocacol422: calls $0.10
12311985: folds 
Pablo7-Pro: folds 
Romeo rus89: folds 
fish72o: checks 
*** FLOP *** [6d Kc Qs]
fish72o: checks 
Cocacol422: checks 
*** TURN *** [6d Kc Qs] [9c]
fish72o: checks 
Cocacol422: checks 
*** RIVER *** [6d Kc Qs 9c] [Td]
fish72o: checks 
Cocacol422: bets $0.10
fish72o: folds 
Uncalled bet ($0.10) returned to Cocacol422
Cocacol422 collected $0.24 from pot
Cocacol422: doesn't show hand 
*** SUMMARY ***
Total pot $0.25 | Rake $0.01 
Board [6d Kc Qs 9c Td]
Seat 1: Romeo rus89 (small blind) folded before Flop
Seat 2: fish72o (big blind) folded on the River
Seat 3: reznor1 folded before Flop (didn't bet)
Seat 4: Cocacol422 collected ($0.24)
Seat 5: 12311985 folded before Flop (didn't bet)
Seat 6: Pablo7-Pro (button) folded before Flop (didn't bet)



PokerStars Hand #222946108628:  Hold'em No Limit ($0.05/$0.10 USD) - 2021/01/23 1:32:37 ET
Table 'Polydoros II' 6-max Seat #1 is the button
Seat 1: Romeo rus89 ($9.87 in chips) 
Seat 2: fish72o ($10.74 in chips) 
Seat 3: reznor1 ($12.18 in chips) 
Seat 4: Cocacol422 ($4.96 in chips) 
Seat 5: 12311985 ($11.91 in chips) 
Seat 6: Pablo7-Pro ($13.96 in chips) 
fish72o: posts small blind $0.05
reznor1: posts big blind $0.10
*** HOLE CARDS ***
Cocacol422: raises $0.10 to $0.20
12311985: folds 
Pablo7-Pro: folds 
Romeo rus89: folds 
fish72o: calls $0.15
reznor1: calls $0.10
*** FLOP *** [8h Qd Ks]
fish72o: checks 
reznor1: bets $0.20
Cocacol422: calls $0.20
fish72o: calls $0.20
*** TURN *** [8h Qd Ks] [7c]
fish72o: checks 
reznor1: bets $0.58
Cocacol422: folds 
fish72o: calls $0.58
*** RIVER *** [8h Qd Ks 7c] [9s]
fish72o: checks 
reznor1: checks 
*** SHOW DOWN ***
fish72o: shows [Qc Ah] (a pair of Queens)
reznor1: shows [7h 7s] (three of a kind, Sevens)
reznor1 collected $2.25 from pot
*** SUMMARY ***
Total pot $2.36 | Rake $0.11 
Board [8h Qd Ks 7c 9s]
Seat 1: Romeo rus89 (button) folded before Flop (didn't bet)
Seat 2: fish72o (small blind) showed [Qc Ah] and lost with a pair of Queens
Seat 3: reznor1 (big blind) showed [7h 7s] and won ($2.25) with three of a kind, Sevens
Seat 4: Cocacol422 folded on the Turn
Seat 5: 12311985 folded before Flop (didn't bet)
Seat 6: Pablo7-Pro folded before Flop (didn't bet)



PokerStars Hand #222946123463:  Hold'em No Limit ($0.05/$0.10 USD) - 2021/01/23 1:33:38 ET
Table 'Polydoros II' 6-max Seat #2 is the button
Seat 1: Romeo rus89 ($9.87 in chips) 
Seat 2: fish72o ($10 in chips) 
Seat 3: reznor1 ($13.45 in chips) 
Seat 4: Cocacol422 ($4.56 in chips) 
Seat 5: 12311985 ($11.91 in chips) 
Seat 6: Pablo7-Pro ($13.96 in chips) 
reznor1: posts small blind $0.05
Cocacol422: posts big blind $0.10
*** HOLE CARDS ***
12311985: folds 
Pablo7-Pro: folds 
Romeo rus89: folds 
fish72o: raises $0.15 to $0.25
reznor1: raises $0.25 to $0.50
Cocacol422: folds 
fish72o: folds 
Uncalled bet ($0.25) returned to reznor1
reznor1 collected $0.60 from pot
*** SUMMARY ***
Total pot $0.60 | Rake $0 
Seat 1: Romeo rus89 folded before Flop (didn't bet)
Seat 2: fish72o (button) folded before Flop
Seat 3: reznor1 (small blind) collected ($0.60)
Seat 4: Cocacol422 (big blind) folded before Flop
Seat 5: 12311985 folded before Flop (didn't bet)
Seat 6: Pablo7-Pro folded before Flop (didn't bet)



PokerStars Hand #222946129101:  Hold'em No Limit ($0.05/$0.10 USD) - 2021/01/23 1:34:01 ET
Table 'Polydoros II' 6-max Seat #3 is the button
Seat 1: Romeo rus89 ($9.87 in chips) 
Seat 2: fish72o ($10 in chips) 
Seat 3: reznor1 ($13.80 in chips) 
Seat 4: Cocacol422 ($4.46 in chips) 
Seat 5: 12311985 ($11.91 in chips) 
Seat 6: Pablo7-Pro ($13.96 in chips) 
Cocacol422: posts small blind $0.05
12311985: posts big blind $0.10
*** HOLE CARDS ***
Pablo7-Pro: folds 
Romeo rus89: folds 
fish72o: raises $0.15 to $0.25
reznor1: calls $0.25
Cocacol422: calls $0.20
12311985: folds 
*** FLOP *** [4d 3c 6c]
Cocacol422: bets $0.30
fish72o: calls $0.30
reznor1: folds 
*** TURN *** [4d 3c 6c] [5h]
Cocacol422: bets $0.30
fish72o: calls $0.30
*** RIVER *** [4d 3c 6c 5h] [Ts]
Cocacol422: bets $0.30
fish72o: calls $0.30
*** SHOW DOWN ***
Cocacol422: shows [Ad 3d] (a pair of Threes)
fish72o: shows [Ks Kd] (a pair of Kings)
fish72o collected $2.53 from pot
*** SUMMARY ***
Total pot $2.65 | Rake $0.12 
Board [4d 3c 6c 5h Ts]
Seat 1: Romeo rus89 folded before Flop (didn't bet)
Seat 2: fish72o showed [Ks Kd] and won ($2.53) with a pair of Kings
Seat 3: reznor1 (button) folded on the Flop
Seat 4: Cocacol422 (small blind) showed [Ad 3d] and lost with a pair of Threes
Seat 5: 12311985 (big blind) folded before Flop
Seat 6: Pablo7-Pro folded before Flop (didn't bet)



PokerStars Hand #222946140967:  Hold'em No Limit ($0.05/$0.10 USD) - 2021/01/23 1:34:51 ET
Table 'Polydoros II' 6-max Seat #4 is the button
Seat 1: Romeo rus89 ($9.87 in chips) 
Seat 2: fish72o ($11.38 in chips) 
Seat 3: reznor1 ($13.55 in chips) 
Seat 4: Cocacol422 ($3.31 in chips) 
Seat 5: 12311985 ($11.81 in chips) 
Seat 6: Pablo7-Pro ($13.96 in chips) 
12311985: posts small blind $0.05
Pablo7-Pro: posts big blind $0.10
*** HOLE CARDS ***
Romeo rus89: folds 
fish72o: folds 
reznor1: folds 
Cocacol422: calls $0.10
12311985: raises $0.30 to $0.40
Pablo7-Pro: folds 
Cocacol422: folds 
Uncalled bet ($0.30) returned to 12311985
12311985 collected $0.30 from pot
12311985: doesn't show hand 
*** SUMMARY ***
Total pot $0.30 | Rake $0 
Seat 1: Romeo rus89 folded before Flop (didn't bet)
Seat 2: fish72o folded before Flop (didn't bet)
Seat 3: reznor1 folded before Flop (didn't bet)
Seat 4: Cocacol422 (button) folded before Flop
Seat 5: 12311985 (small blind) collected ($0.30)
Seat 6: Pablo7-Pro (big blind) folded before Flop



PokerStars Hand #222946145470:  Hold'em No Limit ($0.05/$0.10 USD) - 2021/01/23 1:35:09 ET
Table 'Polydoros II' 6-max Seat #5 is the button
Seat 1: Romeo rus89 ($9.87 in chips) 
Seat 2: fish72o ($11.38 in chips) 
Seat 3: reznor1 ($13.55 in chips) 
Seat 4: Cocacol422 ($3.21 in chips) 
Seat 5: 12311985 ($12.01 in chips) 
Seat 6: Pablo7-Pro ($13.86 in chips) 
Pablo7-Pro: posts small blind $0.05
Romeo rus89: posts big blind $0.10
*** HOLE CARDS ***
fish72o: folds 
reznor1: folds 
Cocacol422: folds 
12311985: folds 
Pablo7-Pro: folds 
Uncalled bet ($0.05) returned to Romeo rus89
Romeo rus89 collected $0.10 from pot
*** SUMMARY ***
Total pot $0.10 | Rake $0 
Seat 1: Romeo rus89 (big blind) collected ($0.10)
Seat 2: fish72o folded before Flop (didn't bet)
Seat 3: reznor1 folded before Flop (didn't bet)
Seat 4: Cocacol422 folded before Flop (didn't bet)
Seat 5: 12311985 (button) folded before Flop (didn't bet)
Seat 6: Pablo7-Pro (small blind) folded before Flop



PokerStars Hand #222946147694:  Hold'em No Limit ($0.05/$0.10 USD) - 2021/01/23 1:35:19 ET
Table 'Polydoros II' 6-max Seat #6 is the button
Seat 1: Romeo rus89 ($9.92 in chips) 
Seat 2: fish72o ($11.38 in chips) 
Seat 3: reznor1 ($13.55 in chips) 
Seat 4: Cocacol422 ($3.21 in chips) 
Seat 5: 12311985 ($12.01 in chips) 
Seat 6: Pablo7-Pro ($13.81 in chips) 
Romeo rus89: posts small blind $0.05
fish72o: posts big blind $0.10
*** HOLE CARDS ***
reznor1: folds 
Cocacol422: calls $0.10
12311985: folds 
Pablo7-Pro: folds 
Romeo rus89: folds 
fish72o: raises $0.25 to $0.35
Cocacol422: calls $0.25
*** FLOP *** [6c Td Jh]
fish72o: bets $0.24
Cocacol422: calls $0.24
*** TURN *** [6c Td Jh] [As]
fish72o: checks 
Cocacol422: checks 
*** RIVER *** [6c Td Jh As] [Kh]
fish72o: checks 
Cocacol422: checks 
*** SHOW DOWN ***
fish72o: shows [9c 9d] (a pair of Nines)
Cocacol422: shows [7h Ks] (a pair of Kings)
Cocacol422 collected $1.17 from pot
*** SUMMARY ***
Total pot $1.23 | Rake $0.06 
Board [6c Td Jh As Kh]
Seat 1: Romeo rus89 (small blind) folded before Flop
Seat 2: fish72o (big blind) showed [9c 9d] and lost with a pair of Nines
Seat 3: reznor1 folded before Flop (didn't bet)
Seat 4: Cocacol422 showed [7h Ks] and won ($1.17) with a pair of Kings
Seat 5: 12311985 folded before Flop (didn't bet)
Seat 6: Pablo7-Pro (button) folded before Flop (didn't bet)



PokerStars Hand #222946154455:  Hold'em No Limit ($0.05/$0.10 USD) - 2021/01/23 1:35:47 ET
Table 'Polydoros II' 6-max Seat #1 is the button
Seat 1: Romeo rus89 ($9.87 in chips) 
Seat 2: fish72o ($10.79 in chips) 
Seat 3: reznor1 ($13.55 in chips) 
Seat 4: Cocacol422 ($3.79 in chips) 
Seat 5: 12311985 ($12.01 in chips) 
Seat 6: Pablo7-Pro ($13.81 in chips) 
fish72o: posts small blind $0.05
reznor1: posts big blind $0.10
*** HOLE CARDS ***
Cocacol422: folds 
12311985: folds 
Pablo7-Pro: folds 
Romeo rus89: raises $0.15 to $0.25
fish72o: folds 
reznor1: folds 
Uncalled bet ($0.15) returned to Romeo rus89
Romeo rus89 collected $0.25 from pot
*** SUMMARY ***
Total pot $0.25 | Rake $0 
Seat 1: Romeo rus89 (button) collected ($0.25)
Seat 2: fish72o (small blind) folded before Flop
Seat 3: reznor1 (big blind) folded before Flop
Seat 4: Cocacol422 folded before Flop (didn't bet)
Seat 5: 12311985 folded before Flop (didn't bet)
Seat 6: Pablo7-Pro folded before Flop (didn't bet)



PokerStars Hand #222946158253:  Hold'em No Limit ($0.05/$0.10 USD) - 2021/01/23 1:36:03 ET
Table 'Polydoros II' 6-max Seat #2 is the button
Seat 1: Romeo rus89 ($10.02 in chips) 
Seat 2: fish72o ($10.74 in chips) 
Seat 4: Cocacol422 ($3.79 in chips) 
Seat 5: 12311985 ($12.01 in chips) 
Seat 6: Pablo7-Pro ($13.81 in chips) 
Cocacol422: posts small blind $0.05
12311985: posts big blind $0.10
*** HOLE CARDS ***
Pablo7-Pro: folds 
Romeo rus89: raises $0.15 to $0.25
fish72o: folds 
Cocacol422: calls $0.20
12311985: folds 
*** FLOP *** [Kc 8c Ac]
Cocacol422: checks 
Romeo rus89: bets $0.38
Cocacol422: folds 
Uncalled bet ($0.38) returned to Romeo rus89
Romeo rus89 collected $0.57 from pot
*** SUMMARY ***
Total pot $0.60 | Rake $0.03 
Board [Kc 8c Ac]
Seat 1: Romeo rus89 collected ($0.57)
Seat 2: fish72o (button) folded before Flop (didn't bet)
Seat 4: Cocacol422 (small blind) folded on the Flop
Seat 5: 12311985 (big blind) folded before Flop
Seat 6: Pablo7-Pro folded before Flop (didn't bet)



PokerStars Hand #222946163014:  Hold'em No Limit ($0.05/$0.10 USD) - 2021/01/23 1:36:23 ET
Table 'Polydoros II' 6-max Seat #4 is the button
Seat 1: Romeo rus89 ($10.34 in chips) 
Seat 2: fish72o ($10.74 in chips) 
Seat 4: Cocacol422 ($3.54 in chips) 
Seat 5: 12311985 ($11.91 in chips) 
Seat 6: Pablo7-Pro ($13.81 in chips) 
12311985: posts small blind $0.05
Pablo7-Pro: posts big blind $0.10
*** HOLE CARDS ***
Romeo rus89: folds 
fish72o: folds 
Cocacol422: folds 
Cocacol422 leaves the table
12311985: raises $0.20 to $0.30
Pablo7-Pro: raises $0.70 to $1
12311985: folds 
Uncalled bet ($0.70) returned to Pablo7-Pro
Pablo7-Pro collected $0.60 from pot
Pablo7-Pro: doesn't show hand 
*** SUMMARY ***
Total pot $0.60 | Rake $0 
Seat 1: Romeo rus89 folded before Flop (didn't bet)
Seat 2: fish72o folded before Flop (didn't bet)
Seat 4: Cocacol422 (button) folded before Flop (didn't bet)
Seat 5: 12311985 (small blind) folded before Flop
Seat 6: Pablo7-Pro (big blind) collected ($0.60)



PokerStars Hand #222946167526:  Hold'em No Limit ($0.05/$0.10 USD) - 2021/01/23 1:36:41 ET
Table 'Polydoros II' 6-max Seat #5 is the button
Seat 1: Romeo rus89 ($10.34 in chips) 
Seat 2: fish72o ($10.74 in chips) 
Seat 5: 12311985 ($11.61 in chips) 
Seat 6: Pablo7-Pro ($14.11 in chips) 
Pablo7-Pro: posts small blind $0.05
Romeo rus89: posts big blind $0.10
*** HOLE CARDS ***
fish72o: folds 
12311985: raises $0.20 to $0.30
Pablo7-Pro: folds 
Romeo rus89: folds 
Uncalled bet ($0.20) returned to 12311985
12311985 collected $0.25 from pot
12311985: doesn't show hand 
*** SUMMARY ***
Total pot $0.25 | Rake $0 
Seat 1: Romeo rus89 (big blind) folded before Flop
Seat 2: fish72o folded before Flop (didn't bet)
Seat 5: 12311985 (button) collected ($0.25)
Seat 6: Pablo7-Pro (small blind) folded before Flop



PokerStars Hand #222946169751:  Hold'em No Limit ($0.05/$0.10 USD) - 2021/01/23 1:36:51 ET
Table 'Polydoros II' 6-max Seat #6 is the button
Seat 1: Romeo rus89 ($10.24 in chips) 
Seat 2: fish72o ($10.74 in chips) 
Seat 5: 12311985 ($11.76 in chips) 
Seat 6: Pablo7-Pro ($14.06 in chips) 
Romeo rus89: posts small blind $0.05
fish72o: posts big blind $0.10
*** HOLE CARDS ***
12311985: folds 
Pablo7-Pro: folds 
Romeo rus89: raises $0.15 to $0.25
fish72o: folds 
Uncalled bet ($0.15) returned to Romeo rus89
Romeo rus89 collected $0.20 from pot
*** SUMMARY ***
Total pot $0.20 | Rake $0 
Seat 1: Romeo rus89 (small blind) collected ($0.20)
Seat 2: fish72o (big blind) folded before Flop
Seat 5: 12311985 folded before Flop (didn't bet)
Seat 6: Pablo7-Pro (button) folded before Flop (didn't bet)



PokerStars Hand #222946172320:  Hold'em No Limit ($0.05/$0.10 USD) - 2021/01/23 1:37:02 ET
Table 'Polydoros II' 6-max Seat #1 is the button
Seat 1: Romeo rus89 ($10.34 in chips) 
Seat 2: fish72o ($10.64 in chips) 
Seat 6: Pablo7-Pro ($14.06 in chips) 
fish72o: posts small blind $0.05
12311985: is sitting out 
Pablo7-Pro: posts big blind $0.10
*** HOLE CARDS ***
Romeo rus89: folds 
fish72o: folds 
Uncalled bet ($0.05) returned to Pablo7-Pro
Pablo7-Pro collected $0.10 from pot
Pablo7-Pro: doesn't show hand 
*** SUMMARY ***
Total pot $0.10 | Rake $0 
Seat 1: Romeo rus89 (button) folded before Flop (didn't bet)
Seat 2: fish72o (small blind) folded before Flop
Seat 6: Pablo7-Pro (big blind) collected ($0.10)



PokerStars Hand #222946173918:  Hold'em No Limit ($0.05/$0.10 USD) - 2021/01/23 1:37:09 ET
Table 'Polydoros II' 6-max Seat #2 is the button
Seat 1: Romeo rus89 ($10.34 in chips) 
Seat 2: fish72o ($10.59 in chips) 
Seat 6: Pablo7-Pro ($14.11 in chips) 
Pablo7-Pro: posts small blind $0.05
Romeo rus89: posts big blind $0.10
*** HOLE CARDS ***
fish72o: folds 
Pablo7-Pro: folds 
Uncalled bet ($0.05) returned to Romeo rus89
Romeo rus89 collected $0.10 from pot
*** SUMMARY ***
Total pot $0.10 | Rake $0 
Seat 1: Romeo rus89 (big blind) collected ($0.10)
Seat 2: fish72o (button) folded before Flop (didn't bet)
Seat 6: Pablo7-Pro (small blind) folded before Flop



PokerStars Hand #222946175399:  Hold'em No Limit ($0.05/$0.10 USD) - 2021/01/23 1:37:15 ET
Table 'Polydoros II' 6-max Seat #6 is the button
Seat 1: Romeo rus89 ($10.39 in chips) 
Seat 2: fish72o ($10.59 in chips) 
Seat 6: Pablo7-Pro ($14.06 in chips) 
Romeo rus89: posts small blind $0.05
fish72o: posts big blind $0.10
reznor1: sits out 
*** HOLE CARDS ***
Pablo7-Pro: raises $0.20 to $0.30
Romeo rus89: folds 
fish72o: calls $0.20
*** FLOP *** [Jh 6d 7c]
fish72o: checks 
Pablo7-Pro: bets $0.20
fish72o: calls $0.20
*** TURN *** [Jh 6d 7c] [5s]
fish72o: checks 
MooHas10961 joins the table at seat #4 
Pablo7-Pro: bets $0.78
fish72o: calls $0.78
*** RIVER *** [Jh 6d 7c 5s] [Ad]
fish72o: checks 
Pablo7-Pro: checks 
*** SHOW DOWN ***
fish72o: shows [Qh Jd] (a pair of Jacks)
Pablo7-Pro: shows [Qs Qd] (a pair of Queens)
Pablo7-Pro collected $2.49 from pot
*** SUMMARY ***
Total pot $2.61 | Rake $0.12 
Board [Jh 6d 7c 5s Ad]
Seat 1: Romeo rus89 (small blind) folded before Flop
Seat 2: fish72o (big blind) showed [Qh Jd] and lost with a pair of Jacks
Seat 6: Pablo7-Pro (button) showed [Qs Qd] and won ($2.49) with a pair of Queens



PokerStars Hand #222946184126:  Hold'em No Limit ($0.05/$0.10 USD) - 2021/01/23 1:37:52 ET
Table 'Polydoros II' 6-max Seat #1 is the button
Seat 1: Romeo rus89 ($10.34 in chips) 
Seat 2: fish72o ($10 in chips) 
Seat 3: reznor1 ($13.45 in chips) 
Seat 6: Pablo7-Pro ($15.27 in chips) 
fish72o: posts small blind $0.05
reznor1: posts big blind $0.10
MooHas10961: sits out 
*** HOLE CARDS ***
Pablo7-Pro: folds 
Romeo rus89: folds 
fish72o: folds 
Uncalled bet ($0.05) returned to reznor1
reznor1 collected $0.10 from pot
*** SUMMARY ***
Total pot $0.10 | Rake $0 
Seat 1: Romeo rus89 (button) folded before Flop (didn't bet)
Seat 2: fish72o (small blind) folded before Flop
Seat 3: reznor1 (big blind) collected ($0.10)
Seat 6: Pablo7-Pro folded before Flop (didn't bet)



PokerStars Hand #222946186070:  Hold'em No Limit ($0.05/$0.10 USD) - 2021/01/23 1:38:00 ET
Table 'Polydoros II' 6-max Seat #2 is the button
Seat 1: Romeo rus89 ($10.34 in chips) 
Seat 2: fish72o ($10 in chips) 
Seat 3: reznor1 ($13.50 in chips) 
Seat 4: MooHas10961 ($8 in chips) 
Seat 6: Pablo7-Pro ($15.27 in chips) 
reznor1: posts small blind $0.05
MooHas10961: posts big blind $0.10
*** HOLE CARDS ***
Pablo7-Pro: raises $0.20 to $0.30
Romeo rus89: folds 
fish72o: folds 
reznor1: folds 
MooHas10961: calls $0.20
*** FLOP *** [7d 3c Th]
MooHas10961: checks 
Pablo7-Pro: checks 
*** TURN *** [7d 3c Th] [Kc]
MooHas10961: checks 
Pablo7-Pro: checks 
*** RIVER *** [7d 3c Th Kc] [2d]
MooHas10961: checks 
Pablo7-Pro: checks 
*** SHOW DOWN ***
MooHas10961: shows [Qs 7s] (a pair of Sevens)
Pablo7-Pro: mucks hand 
MooHas10961 collected $0.62 from pot
*** SUMMARY ***
Total pot $0.65 | Rake $0.03 
Board [7d 3c Th Kc 2d]
Seat 1: Romeo rus89 folded before Flop (didn't bet)
Seat 2: fish72o (button) folded before Flop (didn't bet)
Seat 3: reznor1 (small blind) folded before Flop
Seat 4: MooHas10961 (big blind) showed [Qs 7s] and won ($0.62) with a pair of Sevens
Seat 6: Pablo7-Pro mucked



PokerStars Hand #222946196257:  Hold'em No Limit ($0.05/$0.10 USD) - 2021/01/23 1:38:43 ET
Table 'Polydoros II' 6-max Seat #3 is the button
Seat 1: Romeo rus89 ($10.34 in chips) 
Seat 2: fish72o ($10 in chips) 
Seat 3: reznor1 ($13.45 in chips) 
Seat 4: MooHas10961 ($8.32 in chips) 
Seat 6: Pablo7-Pro ($14.97 in chips) 
MooHas10961: posts small blind $0.05
Pablo7-Pro: posts big blind $0.10
*** HOLE CARDS ***
Romeo rus89: folds 
fish72o: raises $0.15 to $0.25
reznor1: folds 
MooHas10961: calls $0.20
Pablo7-Pro: folds 
*** FLOP *** [6d 7s Js]
MooHas10961: checks 
fish72o: bets $0.38
MooHas10961: raises $0.38 to $0.76
fish72o: calls $0.38
*** TURN *** [6d 7s Js] [9h]
MooHas10961: bets $1.01
fish72o: calls $1.01
*** RIVER *** [6d 7s Js 9h] [2d]
MooHas10961: bets $6.30 and is all-in
fish72o: folds 
Uncalled bet ($6.30) returned to MooHas10961
MooHas10961 collected $3.95 from pot
MooHas10961: doesn't show hand 
*** SUMMARY ***
Total pot $4.14 | Rake $0.19 
Board [6d 7s Js 9h 2d]
Seat 1: Romeo rus89 folded before Flop (didn't bet)
Seat 2: fish72o folded on the River
Seat 3: reznor1 (button) folded before Flop (didn't bet)
Seat 4: MooHas10961 (small blind) collected ($3.95)
Seat 6: Pablo7-Pro (big blind) folded before Flop



PokerStars Hand #222946206274:  Hold'em No Limit ($0.05/$0.10 USD) - 2021/01/23 1:39:24 ET
Table 'Polydoros II' 6-max Seat #4 is the button
Seat 1: Romeo rus89 ($10.34 in chips) 
Seat 2: fish72o ($10 in chips) 
Seat 3: reznor1 ($13.45 in chips) 
Seat 4: MooHas10961 ($10.25 in chips) 
Seat 6: Pablo7-Pro ($14.87 in chips) 
Pablo7-Pro: posts small blind $0.05
Romeo rus89: posts big blind $0.10
*** HOLE CARDS ***
fish72o: folds 
reznor1: folds 
MooHas10961: calls $0.10
Pablo7-Pro: folds 
Romeo rus89: checks 
*** FLOP *** [Jc 5h 5s]
Romeo rus89: checks 
MooHas10961: checks 
*** TURN *** [Jc 5h 5s] [3d]
Romeo rus89: checks 
MooHas10961: checks 
*** RIVER *** [Jc 5h 5s 3d] [Ad]
Romeo rus89: checks 
MooHas10961: checks 
*** SHOW DOWN ***
Romeo rus89: shows [6c 8c] (a pair of Fives)
MooHas10961: shows [4h Ac] (two pair, Aces and Fives)
MooHas10961 collected $0.24 from pot
*** SUMMARY ***
Total pot $0.25 | Rake $0.01 
Board [Jc 5h 5s 3d Ad]
Seat 1: Romeo rus89 (big blind) showed [6c 8c] and lost with a pair of Fives
Seat 2: fish72o folded before Flop (didn't bet)
Seat 3: reznor1 folded before Flop (didn't bet)
Seat 4: MooHas10961 (button) showed [4h Ac] and won ($0.24) with two pair, Aces and Fives
Seat 6: Pablo7-Pro (small blind) folded before Flop



PokerStars Hand #222946212021:  Hold'em No Limit ($0.05/$0.10 USD) - 2021/01/23 1:39:48 ET
Table 'Polydoros II' 6-max Seat #6 is the button
Seat 1: Romeo rus89 ($10.24 in chips) 
Seat 2: fish72o ($10 in chips) 
Seat 3: reznor1 ($13.45 in chips) 
Seat 4: MooHas10961 ($10.39 in chips) 
Seat 6: Pablo7-Pro ($14.82 in chips) 
Romeo rus89: posts small blind $0.05
fish72o: posts big blind $0.10
*** HOLE CARDS ***
reznor1: folds 
MooHas10961: folds 
Pablo7-Pro: raises $0.10 to $0.20
Romeo rus89: calls $0.15
fish72o: folds 
*** FLOP *** [Kc 4s 9c]
Romeo rus89: checks 
Pablo7-Pro: checks 
*** TURN *** [Kc 4s 9c] [5c]
Romeo rus89: checks 
Pablo7-Pro: checks 
*** RIVER *** [Kc 4s 9c 5c] [Ad]
Romeo rus89: checks 
Pablo7-Pro: checks 
*** SHOW DOWN ***
Romeo rus89: shows [2c 2s] (a pair of Deuces)
Pablo7-Pro: shows [6d As] (a pair of Aces)
Pablo7-Pro collected $0.48 from pot
*** SUMMARY ***
Total pot $0.50 | Rake $0.02 
Board [Kc 4s 9c 5c Ad]
Seat 1: Romeo rus89 (small blind) showed [2c 2s] and lost with a pair of Deuces
Seat 2: fish72o (big blind) folded before Flop
Seat 3: reznor1 folded before Flop (didn't bet)
Seat 4: MooHas10961 folded before Flop (didn't bet)
Seat 6: Pablo7-Pro (button) showed [6d As] and won ($0.48) with a pair of Aces



PokerStars Hand #222946219131:  Hold'em No Limit ($0.05/$0.10 USD) - 2021/01/23 1:40:18 ET
Table 'Polydoros II' 6-max Seat #1 is the button
Seat 1: Romeo rus89 ($10.04 in chips) 
Seat 2: fish72o ($10 in chips) 
Seat 3: reznor1 ($13.45 in chips) 
Seat 4: MooHas10961 ($10.39 in chips) 
Seat 6: Pablo7-Pro ($15.10 in chips) 
fish72o: posts small blind $0.05
reznor1: posts big blind $0.10
*** HOLE CARDS ***
MooHas10961: calls $0.10
Pablo7-Pro: folds 
Romeo rus89: folds 
fish72o: folds 
reznor1: checks 
*** FLOP *** [9h 5s 6h]
reznor1: checks 
MooHas10961: checks 
*** TURN *** [9h 5s 6h] [8d]
reznor1: bets $0.10
MooHas10961: calls $0.10
*** RIVER *** [9h 5s 6h 8d] [7s]
reznor1: bets $0.10
MooHas10961: calls $0.10
*** SHOW DOWN ***
reznor1: shows [Kc 2s] (a straight, Five to Nine)
MooHas10961: shows [3h 3c] (a straight, Five to Nine)
reznor1 collected $0.31 from pot
MooHas10961 collected $0.31 from pot
*** SUMMARY ***
Total pot $0.65 | Rake $0.03 
Board [9h 5s 6h 8d 7s]
Seat 1: Romeo rus89 (button) folded before Flop (didn't bet)
Seat 2: fish72o (small blind) folded before Flop
Seat 3: reznor1 (big blind) showed [Kc 2s] and won ($0.31) with a straight, Five to Nine
Seat 4: MooHas10961 showed [3h 3c] and won ($0.31) with a straight, Five to Nine
Seat 6: Pablo7-Pro folded before Flop (didn't bet)



PokerStars Hand #222946226136:  Hold'em No Limit ($0.05/$0.10 USD) - 2021/01/23 1:40:48 ET
Table 'Polydoros II' 6-max Seat #2 is the button
Seat 1: Romeo rus89 ($10.04 in chips) 
Seat 2: fish72o ($10 in chips) 
Seat 3: reznor1 ($13.46 in chips) 
Seat 4: MooHas10961 ($10.40 in chips) 
Seat 6: Pablo7-Pro ($15.10 in chips) 
reznor1: posts small blind $0.05
MooHas10961: posts big blind $0.10
*** HOLE CARDS ***
Pablo7-Pro: folds 
Romeo rus89: folds 
fish72o: raises $0.15 to $0.25
reznor1: folds 
MooHas10961: calls $0.15
*** FLOP *** [4d Ks 2s]
MooHas10961: checks 
fish72o: bets $0.17
MooHas10961: folds 
Uncalled bet ($0.17) returned to fish72o
fish72o collected $0.53 from pot
fish72o: doesn't show hand 
*** SUMMARY ***
Total pot $0.55 | Rake $0.02 
Board [4d Ks 2s]
Seat 1: Romeo rus89 folded before Flop (didn't bet)
Seat 2: fish72o (button) collected ($0.53)
Seat 3: reznor1 (small blind) folded before Flop
Seat 4: MooHas10961 (big blind) folded on the Flop
Seat 6: Pablo7-Pro folded before Flop (didn't bet)



PokerStars Hand #222946230620:  Hold'em No Limit ($0.05/$0.10 USD) - 2021/01/23 1:41:07 ET
Table 'Polydoros II' 6-max Seat #3 is the button
Seat 1: Romeo rus89 ($10.04 in chips) 
Seat 2: fish72o ($10.28 in chips) 
Seat 3: reznor1 ($13.41 in chips) 
Seat 4: MooHas10961 ($10.15 in chips) 
Seat 6: Pablo7-Pro ($15.10 in chips) 
MooHas10961: posts small blind $0.05
Pablo7-Pro: posts big blind $0.10
*** HOLE CARDS ***
Romeo rus89: folds 
fish72o: raises $0.15 to $0.25
reznor1: folds 
MooHas10961: calls $0.20
Pablo7-Pro: calls $0.15
*** FLOP *** [3h Ad 7d]
MooHas10961: checks 
Pablo7-Pro: checks 
fish72o: checks 
*** TURN *** [3h Ad 7d] [6s]
MooHas10961: checks 
Pablo7-Pro: checks 
fish72o: bets $0.48
MooHas10961: folds 
Pablo7-Pro: folds 
Uncalled bet ($0.48) returned to fish72o
fish72o collected $0.72 from pot
fish72o: doesn't show hand 
*** SUMMARY ***
Total pot $0.75 | Rake $0.03 
Board [3h Ad 7d 6s]
Seat 1: Romeo rus89 folded before Flop (didn't bet)
Seat 2: fish72o collected ($0.72)
Seat 3: reznor1 (button) folded before Flop (didn't bet)
Seat 4: MooHas10961 (small blind) folded on the Turn
Seat 6: Pablo7-Pro (big blind) folded on the Turn



PokerStars Hand #222946242060:  Hold'em No Limit ($0.05/$0.10 USD) - 2021/01/23 1:41:55 ET
Table 'Polydoros II' 6-max Seat #4 is the button
Seat 1: Romeo rus89 ($10.04 in chips) 
Seat 2: fish72o ($10.75 in chips) 
Seat 3: reznor1 ($13.41 in chips) 
Seat 4: MooHas10961 ($9.90 in chips) 
Seat 6: Pablo7-Pro ($14.85 in chips) 
Pablo7-Pro: posts small blind $0.05
Romeo rus89: posts big blind $0.10
*** HOLE CARDS ***
fish72o: folds 
reznor1: folds 
MooHas10961: folds 
Pablo7-Pro: folds 
Uncalled bet ($0.05) returned to Romeo rus89
Romeo rus89 collected $0.10 from pot
*** SUMMARY ***
Total pot $0.10 | Rake $0 
Seat 1: Romeo rus89 (big blind) collected ($0.10)
Seat 2: fish72o folded before Flop (didn't bet)
Seat 3: reznor1 folded before Flop (didn't bet)
Seat 4: MooHas10961 (button) folded before Flop (didn't bet)
Seat 6: Pablo7-Pro (small blind) folded before Flop



PokerStars Hand #222944626893:  Hold'em No Limit ($0.05/$0.10 USD) - 2021/01/23 0:00:15 ET
Table 'Polydoros II' 6-max Seat #3 is the button
Seat 1: Bunkiebear ($6.27 in chips) 
Seat 2: Monterrey S ($10.05 in chips) 
Seat 3: whtocean ($14.23 in chips) 
Seat 4: Halfyard007 ($10.32 in chips) 
Seat 5: abrm20 ($7.95 in chips) 
Halfyard007: posts small blind $0.05
abrm20: posts big blind $0.10
gresscrack: sits out 
*** HOLE CARDS ***
Bunkiebear: folds 
Monterrey S: folds 
whtocean: raises $0.15 to $0.25
Halfyard007: calls $0.20
abrm20: folds 
*** FLOP *** [Qs Ad 7s]
Halfyard007: checks 
whtocean: bets $0.37
Halfyard007: calls $0.37
*** TURN *** [Qs Ad 7s] [2d]
Halfyard007: checks 
whtocean: checks 
*** RIVER *** [Qs Ad 7s 2d] [Ts]
Halfyard007: bets $0.30
whtocean: folds 
Uncalled bet ($0.30) returned to Halfyard007
Halfyard007 collected $1.28 from pot
Halfyard007: doesn't show hand 
*** SUMMARY ***
Total pot $1.34 | Rake $0.06 
Board [Qs Ad 7s 2d Ts]
Seat 1: Bunkiebear folded before Flop (didn't bet)
Seat 2: Monterrey S folded before Flop (didn't bet)
Seat 3: whtocean (button) folded on the River
Seat 4: Halfyard007 (small blind) collected ($1.28)
Seat 5: abrm20 (big blind) folded before Flop



PokerStars Hand #222944647020:  Hold'em No Limit ($0.05/$0.10 USD) - 2021/01/23 0:00:56 ET
Table 'Polydoros II' 6-max Seat #4 is the button
Seat 1: Bunkiebear ($6.27 in chips) 
Seat 2: Monterrey S ($10.05 in chips) 
Seat 3: whtocean ($13.61 in chips) 
Seat 4: Halfyard007 ($10.98 in chips) 
Seat 5: abrm20 ($7.85 in chips) 
Seat 6: gresscrack ($10 in chips) 
abrm20: posts small blind $0.05
gresscrack: posts big blind $0.10
*** HOLE CARDS ***
Bunkiebear: folds 
Monterrey S: folds 
whtocean: folds 
Halfyard007: folds 
abrm20: folds 
Uncalled bet ($0.05) returned to gresscrack
gresscrack collected $0.10 from pot
gresscrack: doesn't show hand 
*** SUMMARY ***
Total pot $0.10 | Rake $0 
Seat 1: Bunkiebear folded before Flop (didn't bet)
Seat 2: Monterrey S folded before Flop (didn't bet)
Seat 3: whtocean folded before Flop (didn't bet)
Seat 4: Halfyard007 (button) folded before Flop (didn't bet)
Seat 5: abrm20 (small blind) folded before Flop
Seat 6: gresscrack (big blind) collected ($0.10)



PokerStars Hand #222944649618:  Hold'em No Limit ($0.05/$0.10 USD) - 2021/01/23 0:01:05 ET
Table 'Polydoros II' 6-max Seat #5 is the button
Seat 1: Bunkiebear ($6.27 in chips) 
Seat 2: Monterrey S ($10.05 in chips) 
Seat 3: whtocean ($13.61 in chips) 
Seat 4: Halfyard007 ($10.98 in chips) 
Seat 5: abrm20 ($7.80 in chips) 
Seat 6: gresscrack ($10.05 in chips) 
gresscrack: posts small blind $0.05
Bunkiebear: posts big blind $0.10
*** HOLE CARDS ***
Monterrey S: folds 
whtocean: folds 
Halfyard007: folds 
abrm20: folds 
gresscrack: raises $0.20 to $0.30
Bunkiebear: folds 
Uncalled bet ($0.20) returned to gresscrack
gresscrack collected $0.20 from pot
gresscrack: doesn't show hand 
*** SUMMARY ***
Total pot $0.20 | Rake $0 
Seat 1: Bunkiebear (big blind) folded before Flop
Seat 2: Monterrey S folded before Flop (didn't bet)
Seat 3: whtocean folded before Flop (didn't bet)
Seat 4: Halfyard007 folded before Flop (didn't bet)
Seat 5: abrm20 (button) folded before Flop (didn't bet)
Seat 6: gresscrack (small blind) collected ($0.20)



PokerStars Hand #222944653218:  Hold'em No Limit ($0.05/$0.10 USD) - 2021/01/23 0:01:18 ET
Table 'Polydoros II' 6-max Seat #6 is the button
Seat 1: Bunkiebear ($6.17 in chips) 
Seat 3: whtocean ($13.61 in chips) 
Seat 4: Halfyard007 ($10.98 in chips) 
Seat 5: abrm20 ($7.80 in chips) 
Seat 6: gresscrack ($10.15 in chips) 
Bunkiebear: posts small blind $0.05
Monterrey S: is sitting out 
whtocean: posts big blind $0.10
*** HOLE CARDS ***
Monterrey S leaves the table
Halfyard007: folds 
abrm20: raises $0.20 to $0.30
gresscrack: folds 
fish72o joins the table at seat #2 
Bunkiebear: folds 
whtocean: folds 
Uncalled bet ($0.20) returned to abrm20
abrm20 collected $0.25 from pot
abrm20: doesn't show hand 
*** SUMMARY ***
Total pot $0.25 | Rake $0 
Seat 1: Bunkiebear (small blind) folded before Flop
Seat 3: whtocean (big blind) folded before Flop
Seat 4: Halfyard007 folded before Flop (didn't bet)
Seat 5: abrm20 collected ($0.25)
Seat 6: gresscrack (button) folded before Flop (didn't bet)



PokerStars Hand #222944656244:  Hold'em No Limit ($0.05/$0.10 USD) - 2021/01/23 0:01:29 ET
Table 'Polydoros II' 6-max Seat #1 is the button
Seat 1: Bunkiebear ($6.12 in chips) 
Seat 3: whtocean ($13.51 in chips) 
Seat 4: Halfyard007 ($10.98 in chips) 
Seat 5: abrm20 ($7.95 in chips) 
Seat 6: gresscrack ($10.15 in chips) 
whtocean: posts small blind $0.05
Halfyard007: posts big blind $0.10
*** HOLE CARDS ***
abrm20: folds 
gresscrack: folds 
Bunkiebear: folds 
whtocean: folds 
Uncalled bet ($0.05) returned to Halfyard007
Halfyard007 collected $0.10 from pot
Halfyard007: doesn't show hand 
*** SUMMARY ***
Total pot $0.10 | Rake $0 
Seat 1: Bunkiebear (button) folded before Flop (didn't bet)
Seat 3: whtocean (small blind) folded before Flop
Seat 4: Halfyard007 (big blind) collected ($0.10)
Seat 5: abrm20 folded before Flop (didn't bet)
Seat 6: gresscrack folded before Flop (didn't bet)



PokerStars Hand #222944659852:  Hold'em No Limit ($0.05/$0.10 USD) - 2021/01/23 0:01:42 ET
Table 'Polydoros II' 6-max Seat #3 is the button
Seat 1: Bunkiebear ($6.12 in chips) 
Seat 3: whtocean ($13.46 in chips) 
Seat 4: Halfyard007 ($11.03 in chips) 
Seat 5: abrm20 ($7.95 in chips) 
Seat 6: gresscrack ($10.15 in chips) 
Halfyard007: posts small blind $0.05
abrm20: posts big blind $0.10
fish72o: sits out 
*** HOLE CARDS ***
gresscrack: folds 
Bunkiebear: folds 
whtocean: folds 
Halfyard007: folds 
Uncalled bet ($0.05) returned to abrm20
abrm20 collected $0.10 from pot
abrm20: doesn't show hand 
*** SUMMARY ***
Total pot $0.10 | Rake $0 
Seat 1: Bunkiebear folded before Flop (didn't bet)
Seat 3: whtocean (button) folded before Flop (didn't bet)
Seat 4: Halfyard007 (small blind) folded before Flop
Seat 5: abrm20 (big blind) collected ($0.10)
Seat 6: gresscrack folded before Flop (didn't bet)



PokerStars Hand #222944663048:  Hold'em No Limit ($0.05/$0.10 USD) - 2021/01/23 0:01:54 ET
Table 'Polydoros II' 6-max Seat #4 is the button
Seat 1: Bunkiebear ($6.12 in chips) 
Seat 3: whtocean ($13.46 in chips) 
Seat 4: Halfyard007 ($10.98 in chips) 
Seat 5: abrm20 ($8 in chips) 
Seat 6: gresscrack ($10.15 in chips) 
abrm20: posts small blind $0.05
gresscrack: posts big blind $0.10
fish72o: sits out 
*** HOLE CARDS ***
Bunkiebear: calls $0.10
whtocean: folds 
Halfyard007: folds 
abrm20: folds 
gresscrack: checks 
*** FLOP *** [Jc 9d Jd]
gresscrack: checks 
Bunkiebear: bets $0.40
gresscrack: folds 
Uncalled bet ($0.40) returned to Bunkiebear
Bunkiebear collected $0.24 from pot
Bunkiebear: doesn't show hand 
*** SUMMARY ***
Total pot $0.25 | Rake $0.01 
Board [Jc 9d Jd]
Seat 1: Bunkiebear collected ($0.24)
Seat 3: whtocean folded before Flop (didn't bet)
Seat 4: Halfyard007 (button) folded before Flop (didn't bet)
Seat 5: abrm20 (small blind) folded before Flop
Seat 6: gresscrack (big blind) folded on the Flop



PokerStars Hand #222944669950:  Hold'em No Limit ($0.05/$0.10 USD) - 2021/01/23 0:02:19 ET
Table 'Polydoros II' 6-max Seat #5 is the button
Seat 1: Bunkiebear ($6.26 in chips) 
Seat 3: whtocean ($13.46 in chips) 
Seat 4: Halfyard007 ($10.98 in chips) 
Seat 5: abrm20 ($7.95 in chips) 
Seat 6: gresscrack ($10.05 in chips) 
gresscrack: posts small blind $0.05
Bunkiebear: posts big blind $0.10
fish72o: sits out 
*** HOLE CARDS ***
whtocean: folds 
Halfyard007: folds 
abrm20: raises $0.20 to $0.30
gresscrack: folds 
Bunkiebear: folds 
Uncalled bet ($0.20) returned to abrm20
abrm20 collected $0.25 from pot
abrm20: doesn't show hand 
*** SUMMARY ***
Total pot $0.25 | Rake $0 
Seat 1: Bunkiebear (big blind) folded before Flop
Seat 3: whtocean folded before Flop (didn't bet)
Seat 4: Halfyard007 folded before Flop (didn't bet)
Seat 5: abrm20 (button) collected ($0.25)
Seat 6: gresscrack (small blind) folded before Flop



PokerStars Hand #222944673638:  Hold'em No Limit ($0.05/$0.10 USD) - 2021/01/23 0:02:32 ET
Table 'Polydoros II' 6-max Seat #6 is the button
Seat 1: Bunkiebear ($6.16 in chips) 
Seat 2: fish72o ($10 in chips) 
Seat 3: whtocean ($13.46 in chips) 
Seat 4: Halfyard007 ($10.98 in chips) 
Seat 5: abrm20 ($8.10 in chips) 
Seat 6: gresscrack ($10 in chips) 
Bunkiebear: posts small blind $0.05
fish72o: posts big blind $0.10
*** HOLE CARDS ***
whtocean: folds 
Halfyard007: folds 
abrm20: folds 
gresscrack: folds 
Bunkiebear: calls $0.05
fish72o: checks 
*** FLOP *** [Kd Qc Ah]
Bunkiebear: checks 
fish72o: checks 
*** TURN *** [Kd Qc Ah] [Jd]
Bunkiebear: checks 
fish72o: checks 
*** RIVER *** [Kd Qc Ah Jd] [Ks]
Bunkiebear: checks 
fish72o: bets $0.13
Bunkiebear: calls $0.13
*** SHOW DOWN ***
fish72o: shows [Kc 5c] (three of a kind, Kings)
Bunkiebear: mucks hand 
fish72o collected $0.44 from pot
*** SUMMARY ***
Total pot $0.46 | Rake $0.02 
Board [Kd Qc Ah Jd Ks]
Seat 1: Bunkiebear (small blind) mucked
Seat 2: fish72o (big blind) showed [Kc 5c] and won ($0.44) with three of a kind, Kings
Seat 3: whtocean folded before Flop (didn't bet)
Seat 4: Halfyard007 folded before Flop (didn't bet)
Seat 5: abrm20 folded before Flop (didn't bet)
Seat 6: gresscrack (button) folded before Flop (didn't bet)



PokerStars Hand #222944681668:  Hold'em No Limit ($0.05/$0.10 USD) - 2021/01/23 0:03:01 ET
Table 'Polydoros II' 6-max Seat #1 is the button
Seat 1: Bunkiebear ($5.93 in chips) 
Seat 2: fish72o ($10.21 in chips) 
Seat 3: whtocean ($13.46 in chips) 
Seat 4: Halfyard007 ($10.98 in chips) 
Seat 5: abrm20 ($8.10 in chips) 
Seat 6: gresscrack ($10 in chips) 
fish72o: posts small blind $0.05
whtocean: posts big blind $0.10
*** HOLE CARDS ***
Halfyard007: raises $0.20 to $0.30
abrm20: folds 
gresscrack: raises $0.60 to $0.90
Bunkiebear: folds 
fish72o: folds 
whtocean: folds 
Halfyard007: calls $0.60
*** FLOP *** [6c 8c Td]
Halfyard007: bets $1.10
gresscrack: calls $1.10
*** TURN *** [6c 8c Td] [As]
Halfyard007: checks 
gresscrack: bets $2.97
Halfyard007: calls $2.97
*** RIVER *** [6c 8c Td As] [8h]
Halfyard007: checks 
gresscrack: checks 
*** SHOW DOWN ***
Halfyard007: shows [Tc Ac] (two pair, Aces and Tens)
gresscrack: mucks hand 
Halfyard007 collected $9.64 from pot
*** SUMMARY ***
Total pot $10.09 | Rake $0.45 
Board [6c 8c Td As 8h]
Seat 1: Bunkiebear (button) folded before Flop (didn't bet)
Seat 2: fish72o (small blind) folded before Flop
Seat 3: whtocean (big blind) folded before Flop
Seat 4: Halfyard007 showed [Tc Ac] and won ($9.64) with two pair, Aces and Tens
Seat 5: abrm20 folded before Flop (didn't bet)
Seat 6: gresscrack mucked



PokerStars Hand #222944713891:  Hold'em No Limit ($0.05/$0.10 USD) - 2021/01/23 0:04:20 ET
Table 'Polydoros II' 6-max Seat #2 is the button
Seat 1: Bunkiebear ($5.93 in chips) 
Seat 2: fish72o ($10.16 in chips) 
Seat 3: whtocean ($13.36 in chips) 
Seat 4: Halfyard007 ($15.65 in chips) 
Seat 5: abrm20 ($8.10 in chips) 
Seat 6: gresscrack ($10 in chips) 
whtocean: posts small blind $0.05
Halfyard007: posts big blind $0.10
*** HOLE CARDS ***
abrm20: folds 
gresscrack: raises $0.20 to $0.30
Bunkiebear: calls $0.30
fish72o: folds 
whtocean: folds 
Halfyard007: folds 
*** FLOP *** [7c 8h Ah]
gresscrack: bets $0.72
Bunkiebear: calls $0.72
*** TURN *** [7c 8h Ah] [9h]
gresscrack: bets $8.70
Bunkiebear: calls $4.91 and is all-in
Uncalled bet ($3.79) returned to gresscrack
*** RIVER *** [7c 8h Ah 9h] [8c]
*** SHOW DOWN ***
gresscrack: shows [7s 7h] (a full house, Sevens full of Eights)
Bunkiebear: shows [Qs Qh] (two pair, Queens and Eights)
gresscrack collected $11.47 from pot
*** SUMMARY ***
Total pot $12.01 | Rake $0.54 
Board [7c 8h Ah 9h 8c]
Seat 1: Bunkiebear showed [Qs Qh] and lost with two pair, Queens and Eights
Seat 2: fish72o (button) folded before Flop (didn't bet)
Seat 3: whtocean (small blind) folded before Flop
Seat 4: Halfyard007 (big blind) folded before Flop
Seat 5: abrm20 folded before Flop (didn't bet)
Seat 6: gresscrack showed [7s 7h] and won ($11.47) with a full house, Sevens full of Eights



PokerStars Hand #222944730857:  Hold'em No Limit ($0.05/$0.10 USD) - 2021/01/23 0:05:19 ET
Table 'Polydoros II' 6-max Seat #3 is the button
Seat 2: fish72o ($10.16 in chips) 
Seat 3: whtocean ($13.31 in chips) 
Seat 4: Halfyard007 ($15.55 in chips) 
Seat 5: abrm20 ($8.10 in chips) 
Seat 6: gresscrack ($15.54 in chips) 
Halfyard007: posts small blind $0.05
abrm20: posts big blind $0.10
*** HOLE CARDS ***
gresscrack: folds 
fish72o: raises $0.15 to $0.25
whtocean: folds 
Bunkiebear leaves the table
Halfyard007: folds 
abrm20: folds 
Uncalled bet ($0.15) returned to fish72o
fish72o collected $0.25 from pot
fish72o: doesn't show hand 
*** SUMMARY ***
Total pot $0.25 | Rake $0 
Seat 2: fish72o collected ($0.25)
Seat 3: whtocean (button) folded before Flop (didn't bet)
Seat 4: Halfyard007 (small blind) folded before Flop
Seat 5: abrm20 (big blind) folded before Flop
Seat 6: gresscrack folded before Flop (didn't bet)



PokerStars Hand #222944734377:  Hold'em No Limit ($0.05/$0.10 USD) - 2021/01/23 0:05:31 ET
Table 'Polydoros II' 6-max Seat #4 is the button
Seat 2: fish72o ($10.31 in chips) 
Seat 3: whtocean ($13.31 in chips) 
Seat 4: Halfyard007 ($15.50 in chips) 
Seat 5: abrm20 ($8 in chips) 
Seat 6: gresscrack ($15.54 in chips) 
abrm20: posts small blind $0.05
gresscrack: posts big blind $0.10
*** HOLE CARDS ***
fish72o: folds 
whtocean: folds 
Halfyard007: raises $0.20 to $0.30
abrm20: folds 
gresscrack: raises $0.70 to $1
Halfyard007: calls $0.70
*** FLOP *** [8c 7d 7h]
gresscrack: bets $0.65
Halfyard007: raises $0.65 to $1.30
gresscrack: folds 
Uncalled bet ($0.65) returned to Halfyard007
Halfyard007 collected $3.20 from pot
Halfyard007: doesn't show hand 
*** SUMMARY ***
Total pot $3.35 | Rake $0.15 
Board [8c 7d 7h]
Seat 2: fish72o folded before Flop (didn't bet)
Seat 3: whtocean folded before Flop (didn't bet)
Seat 4: Halfyard007 (button) collected ($3.20)
Seat 5: abrm20 (small blind) folded before Flop
Seat 6: gresscrack (big blind) folded on the Flop



PokerStars Hand #222944747281:  Hold'em No Limit ($0.05/$0.10 USD) - 2021/01/23 0:06:17 ET
Table 'Polydoros II' 6-max Seat #5 is the button
Seat 2: fish72o ($10.31 in chips) 
Seat 3: whtocean ($13.31 in chips) 
Seat 4: Halfyard007 ($17.05 in chips) 
Seat 5: abrm20 ($7.95 in chips) 
Seat 6: gresscrack ($13.89 in chips) 
gresscrack: posts small blind $0.05
fish72o: posts big blind $0.10
*** HOLE CARDS ***
whtocean: folds 
Halfyard007: folds 
abrm20: raises $0.20 to $0.30
gresscrack: folds 
fish72o: calls $0.20
*** FLOP *** [2c 5s 4c]
fish72o: checks 
abrm20: checks 
*** TURN *** [2c 5s 4c] [Ts]
fish72o: bets $0.41
abrm20: raises $0.79 to $1.20
fish72o: calls $0.79
*** RIVER *** [2c 5s 4c Ts] [8d]
fish72o: checks 
abrm20: checks 
*** SHOW DOWN ***
fish72o: shows [6c Kc] (high card King)
abrm20: shows [9c Td] (a pair of Tens)
abrm20 collected $2.91 from pot
*** SUMMARY ***
Total pot $3.05 | Rake $0.14 
Board [2c 5s 4c Ts 8d]
Seat 2: fish72o (big blind) showed [6c Kc] and lost with high card King
Seat 3: whtocean folded before Flop (didn't bet)
Seat 4: Halfyard007 folded before Flop (didn't bet)
Seat 5: abrm20 (button) showed [9c Td] and won ($2.91) with a pair of Tens
Seat 6: gresscrack (small blind) folded before Flop



PokerStars Hand #222944758347:  Hold'em No Limit ($0.05/$0.10 USD) - 2021/01/23 0:06:55 ET
Table 'Polydoros II' 6-max Seat #6 is the button
Seat 2: fish72o ($10 in chips) 
Seat 3: whtocean ($13.31 in chips) 
Seat 4: Halfyard007 ($17.05 in chips) 
Seat 5: abrm20 ($9.36 in chips) 
Seat 6: gresscrack ($13.84 in chips) 
fish72o: posts small blind $0.05
whtocean: posts big blind $0.10
*** HOLE CARDS ***
Halfyard007: folds 
abrm20: folds 
gresscrack: raises $0.20 to $0.30
fish72o: folds 
whtocean: folds 
Uncalled bet ($0.20) returned to gresscrack
gresscrack collected $0.25 from pot
gresscrack: doesn't show hand 
*** SUMMARY ***
Total pot $0.25 | Rake $0 
Seat 2: fish72o (small blind) folded before Flop
Seat 3: whtocean (big blind) folded before Flop
Seat 4: Halfyard007 folded before Flop (didn't bet)
Seat 5: abrm20 folded before Flop (didn't bet)
Seat 6: gresscrack (button) collected ($0.25)



PokerStars Hand #222944762860:  Hold'em No Limit ($0.05/$0.10 USD) - 2021/01/23 0:07:11 ET
Table 'Polydoros II' 6-max Seat #2 is the button
Seat 2: fish72o ($10 in chips) 
Seat 3: whtocean ($13.21 in chips) 
Seat 4: Halfyard007 ($17.05 in chips) 
Seat 5: abrm20 ($9.36 in chips) 
Seat 6: gresscrack ($13.99 in chips) 
whtocean: posts small blind $0.05
Halfyard007: posts big blind $0.10
*** HOLE CARDS ***
dpv82 joins the table at seat #1 
abrm20: raises $0.20 to $0.30
gresscrack: folds 
fish72o: folds 
whtocean: folds 
Halfyard007: folds 
Uncalled bet ($0.20) returned to abrm20
abrm20 collected $0.25 from pot
abrm20: doesn't show hand 
*** SUMMARY ***
Total pot $0.25 | Rake $0 
Seat 2: fish72o (button) folded before Flop (didn't bet)
Seat 3: whtocean (small blind) folded before Flop
Seat 4: Halfyard007 (big blind) folded before Flop
Seat 5: abrm20 collected ($0.25)
Seat 6: gresscrack folded before Flop (didn't bet)



PokerStars Hand #222944765507:  Hold'em No Limit ($0.05/$0.10 USD) - 2021/01/23 0:07:21 ET
Table 'Polydoros II' 6-max Seat #3 is the button
Seat 2: fish72o ($10 in chips) 
Seat 3: whtocean ($13.16 in chips) 
Seat 4: Halfyard007 ($16.95 in chips) 
Seat 5: abrm20 ($9.51 in chips) 
Seat 6: gresscrack ($13.99 in chips) 
Halfyard007: posts small blind $0.05
abrm20: posts big blind $0.10
dpv82: sits out 
*** HOLE CARDS ***
gresscrack: folds 
fish72o: folds 
whtocean: raises $0.15 to $0.25
Halfyard007: calls $0.20
abrm20: calls $0.15
*** FLOP *** [Ad 6c 5s]
Halfyard007: bets $0.50
abrm20: folds 
whtocean: calls $0.50
*** TURN *** [Ad 6c 5s] [7d]
Halfyard007: checks 
whtocean: checks 
*** RIVER *** [Ad 6c 5s 7d] [4c]
Halfyard007: checks 
whtocean: checks 
*** SHOW DOWN ***
Halfyard007: shows [9c Ah] (a pair of Aces)
whtocean: shows [9s As] (a pair of Aces)
Halfyard007 collected $0.84 from pot
whtocean collected $0.83 from pot
*** SUMMARY ***
Total pot $1.75 | Rake $0.08 
Board [Ad 6c 5s 7d 4c]
Seat 2: fish72o folded before Flop (didn't bet)
Seat 3: whtocean (button) showed [9s As] and won ($0.83) with a pair of Aces
Seat 4: Halfyard007 (small blind) showed [9c Ah] and won ($0.84) with a pair of Aces
Seat 5: abrm20 (big blind) folded on the Flop
Seat 6: gresscrack folded before Flop (didn't bet)



PokerStars Hand #222944778711:  Hold'em No Limit ($0.05/$0.10 USD) - 2021/01/23 0:08:06 ET
Table 'Polydoros II' 6-max Seat #4 is the button
Seat 1: dpv82 ($10 in chips) 
Seat 2: fish72o ($10 in chips) 
Seat 3: whtocean ($13.24 in chips) 
Seat 4: Halfyard007 ($17.04 in chips) 
Seat 5: abrm20 ($9.26 in chips) 
abrm20: posts small blind $0.05
gresscrack: is sitting out 
dpv82: posts big blind $0.10
*** HOLE CARDS ***
fish72o: folds 
gresscrack leaves the table
whtocean: folds 
Halfyard007: raises $0.20 to $0.30
abrm20: folds 
dpv82: calls $0.20
*** FLOP *** [Tc 5s 6d]
dpv82: checks 
Halfyard007: bets $0.50
dpv82: folds 
Uncalled bet ($0.50) returned to Halfyard007
Halfyard007 collected $0.62 from pot
Halfyard007: doesn't show hand 
*** SUMMARY ***
Total pot $0.65 | Rake $0.03 
Board [Tc 5s 6d]
Seat 1: dpv82 (big blind) folded on the Flop
Seat 2: fish72o folded before Flop (didn't bet)
Seat 3: whtocean folded before Flop (didn't bet)
Seat 4: Halfyard007 (button) collected ($0.62)
Seat 5: abrm20 (small blind) folded before Flop



PokerStars Hand #222944787827:  Hold'em No Limit ($0.05/$0.10 USD) - 2021/01/23 0:08:38 ET
Table 'Polydoros II' 6-max Seat #5 is the button
Seat 1: dpv82 ($10 in chips) 
Seat 2: fish72o ($10 in chips) 
Seat 3: whtocean ($13.24 in chips) 
Seat 4: Halfyard007 ($17.36 in chips) 
Seat 5: abrm20 ($9.21 in chips) 
dpv82: posts small blind $0.05
fish72o: posts big blind $0.10
*** HOLE CARDS ***
whtocean: folds 
Halfyard007: raises $0.20 to $0.30
abrm20: folds 
Pablo7-Pro joins the table at seat #6 
dpv82: raises $0.60 to $0.90
fish72o: folds 
Halfyard007: folds 
Uncalled bet ($0.60) returned to dpv82
dpv82 collected $0.70 from pot
*** SUMMARY ***
Total pot $0.70 | Rake $0 
Seat 1: dpv82 (small blind) collected ($0.70)
Seat 2: fish72o (big blind) folded before Flop
Seat 3: whtocean folded before Flop (didn't bet)
Seat 4: Halfyard007 folded before Flop
Seat 5: abrm20 (button) folded before Flop (didn't bet)



PokerStars Hand #222944794661:  Hold'em No Limit ($0.05/$0.10 USD) - 2021/01/23 0:09:02 ET
Table 'Polydoros II' 6-max Seat #1 is the button
Seat 1: dpv82 ($10.40 in chips) 
Seat 2: fish72o ($10 in chips) 
Seat 3: whtocean ($13.24 in chips) 
Seat 4: Halfyard007 ($17.06 in chips) 
Seat 5: abrm20 ($9.21 in chips) 
fish72o: posts small blind $0.05
whtocean: posts big blind $0.10
Pablo7-Pro: sits out 
*** HOLE CARDS ***
Halfyard007: folds 
abrm20: folds 
dpv82: folds 
fish72o: raises $0.15 to $0.25
whtocean: raises $0.65 to $0.90
fish72o: folds 
Uncalled bet ($0.65) returned to whtocean
whtocean collected $0.50 from pot
whtocean: doesn't show hand 
*** SUMMARY ***
Total pot $0.50 | Rake $0 
Seat 1: dpv82 (button) folded before Flop (didn't bet)
Seat 2: fish72o (small blind) folded before Flop
Seat 3: whtocean (big blind) collected ($0.50)
Seat 4: Halfyard007 folded before Flop (didn't bet)
Seat 5: abrm20 folded before Flop (didn't bet)



PokerStars Hand #222944800240:  Hold'em No Limit ($0.05/$0.10 USD) - 2021/01/23 0:09:22 ET
Table 'Polydoros II' 6-max Seat #2 is the button
Seat 1: dpv82 ($10.40 in chips) 
Seat 2: fish72o ($10 in chips) 
Seat 3: whtocean ($13.49 in chips) 
Seat 4: Halfyard007 ($17.06 in chips) 
Seat 5: abrm20 ($9.21 in chips) 
whtocean: posts small blind $0.05
Halfyard007: posts big blind $0.10
Pablo7-Pro: sits out 
*** HOLE CARDS ***
abrm20: folds 
dpv82: folds 
fish72o: folds 
whtocean: folds 
Uncalled bet ($0.05) returned to Halfyard007
Halfyard007 collected $0.10 from pot
Halfyard007: doesn't show hand 
*** SUMMARY ***
Total pot $0.10 | Rake $0 
Seat 1: dpv82 folded before Flop (didn't bet)
Seat 2: fish72o (button) folded before Flop (didn't bet)
Seat 3: whtocean (small blind) folded before Flop
Seat 4: Halfyard007 (big blind) collected ($0.10)
Seat 5: abrm20 folded before Flop (didn't bet)



PokerStars Hand #222944802606:  Hold'em No Limit ($0.05/$0.10 USD) - 2021/01/23 0:09:31 ET
Table 'Polydoros II' 6-max Seat #3 is the button
Seat 1: dpv82 ($10.40 in chips) 
Seat 2: fish72o ($10 in chips) 
Seat 3: whtocean ($13.44 in chips) 
Seat 4: Halfyard007 ($17.11 in chips) 
Seat 5: abrm20 ($9.21 in chips) 
Halfyard007: posts small blind $0.05
abrm20: posts big blind $0.10
Pablo7-Pro: sits out 
*** HOLE CARDS ***
dpv82: raises $0.20 to $0.30
fish72o: folds 
whtocean: folds 
Halfyard007: folds 
abrm20: folds 
Uncalled bet ($0.20) returned to dpv82
dpv82 collected $0.25 from pot
*** SUMMARY ***
Total pot $0.25 | Rake $0 
Seat 1: dpv82 collected ($0.25)
Seat 2: fish72o folded before Flop (didn't bet)
Seat 3: whtocean (button) folded before Flop (didn't bet)
Seat 4: Halfyard007 (small blind) folded before Flop
Seat 5: abrm20 (big blind) folded before Flop



PokerStars Hand #222944807482:  Hold'em No Limit ($0.05/$0.10 USD) - 2021/01/23 0:09:48 ET
Table 'Polydoros II' 6-max Seat #4 is the button
Seat 1: dpv82 ($10.55 in chips) 
Seat 2: fish72o ($10 in chips) 
Seat 3: whtocean ($13.44 in chips) 
Seat 4: Halfyard007 ($17.06 in chips) 
Seat 5: abrm20 ($9.11 in chips) 
Seat 6: Pablo7-Pro ($10 in chips) 
abrm20: posts small blind $0.05
Pablo7-Pro: posts big blind $0.10
*** HOLE CARDS ***
dpv82: folds 
fish72o: folds 
whtocean: raises $0.15 to $0.25
Halfyard007: folds 
abrm20: raises $0.65 to $0.90
Pablo7-Pro: folds 
whtocean: folds 
Uncalled bet ($0.65) returned to abrm20
abrm20 collected $0.60 from pot
abrm20: doesn't show hand 
*** SUMMARY ***
Total pot $0.60 | Rake $0 
Seat 1: dpv82 folded before Flop (didn't bet)
Seat 2: fish72o folded before Flop (didn't bet)
Seat 3: whtocean folded before Flop
Seat 4: Halfyard007 (button) folded before Flop (didn't bet)
Seat 5: abrm20 (small blind) collected ($0.60)
Seat 6: Pablo7-Pro (big blind) folded before Flop



PokerStars Hand #222944816457:  Hold'em No Limit ($0.05/$0.10 USD) - 2021/01/23 0:10:20 ET
Table 'Polydoros II' 6-max Seat #5 is the button
Seat 1: dpv82 ($10.55 in chips) 
Seat 2: fish72o ($10 in chips) 
Seat 3: whtocean ($13.19 in chips) 
Seat 4: Halfyard007 ($17.06 in chips) 
Seat 5: abrm20 ($9.46 in chips) 
Seat 6: Pablo7-Pro ($10 in chips) 
Pablo7-Pro: posts small blind $0.05
dpv82: posts big blind $0.10
*** HOLE CARDS ***
fish72o: folds 
whtocean: folds 
Halfyard007: folds 
abrm20: folds 
Pablo7-Pro: raises $0.20 to $0.30
dpv82: folds 
Uncalled bet ($0.20) returned to Pablo7-Pro
Pablo7-Pro collected $0.20 from pot
Pablo7-Pro: doesn't show hand 
*** SUMMARY ***
Total pot $0.20 | Rake $0 
Seat 1: dpv82 (big blind) folded before Flop
Seat 2: fish72o folded before Flop (didn't bet)
Seat 3: whtocean folded before Flop (didn't bet)
Seat 4: Halfyard007 folded before Flop (didn't bet)
Seat 5: abrm20 (button) folded before Flop (didn't bet)
Seat 6: Pablo7-Pro (small blind) collected ($0.20)



PokerStars Hand #222944820686:  Hold'em No Limit ($0.05/$0.10 USD) - 2021/01/23 0:10:35 ET
Table 'Polydoros II' 6-max Seat #6 is the button
Seat 1: dpv82 ($10.45 in chips) 
Seat 2: fish72o ($10 in chips) 
Seat 3: whtocean ($13.19 in chips) 
Seat 4: Halfyard007 ($17.06 in chips) 
Seat 5: abrm20 ($9.46 in chips) 
Seat 6: Pablo7-Pro ($10.10 in chips) 
dpv82: posts small blind $0.05
fish72o: posts big blind $0.10
*** HOLE CARDS ***
whtocean: folds 
Halfyard007: folds 
abrm20: folds 
Pablo7-Pro: raises $0.20 to $0.30
dpv82: folds 
fish72o: calls $0.20
*** FLOP *** [Jc 3h 3c]
fish72o: checks 
Pablo7-Pro: checks 
*** TURN *** [Jc 3h 3c] [Kc]
fish72o: bets $0.41
Pablo7-Pro: folds 
Uncalled bet ($0.41) returned to fish72o
fish72o collected $0.62 from pot
fish72o: doesn't show hand 
*** SUMMARY ***
Total pot $0.65 | Rake $0.03 
Board [Jc 3h 3c Kc]
Seat 1: dpv82 (small blind) folded before Flop
Seat 2: fish72o (big blind) collected ($0.62)
Seat 3: whtocean folded before Flop (didn't bet)
Seat 4: Halfyard007 folded before Flop (didn't bet)
Seat 5: abrm20 folded before Flop (didn't bet)
Seat 6: Pablo7-Pro (button) folded on the Turn



PokerStars Hand #222944828971:  Hold'em No Limit ($0.05/$0.10 USD) - 2021/01/23 0:11:04 ET
Table 'Polydoros II' 6-max Seat #1 is the button
Seat 1: dpv82 ($10.40 in chips) 
Seat 2: fish72o ($10.32 in chips) 
Seat 3: whtocean ($13.19 in chips) 
Seat 4: Halfyard007 ($17.06 in chips) 
Seat 5: abrm20 ($9.46 in chips) 
Seat 6: Pablo7-Pro ($10 in chips) 
fish72o: posts small blind $0.05
whtocean: posts big blind $0.10
*** HOLE CARDS ***
Halfyard007: folds 
abrm20: folds 
Pablo7-Pro: folds 
dpv82: raises $0.20 to $0.30
fish72o: folds 
whtocean: folds 
Uncalled bet ($0.20) returned to dpv82
dpv82 collected $0.25 from pot
*** SUMMARY ***
Total pot $0.25 | Rake $0 
Seat 1: dpv82 (button) collected ($0.25)
Seat 2: fish72o (small blind) folded before Flop
Seat 3: whtocean (big blind) folded before Flop
Seat 4: Halfyard007 folded before Flop (didn't bet)
Seat 5: abrm20 folded before Flop (didn't bet)
Seat 6: Pablo7-Pro folded before Flop (didn't bet)



PokerStars Hand #222944833508:  Hold'em No Limit ($0.05/$0.10 USD) - 2021/01/23 0:11:21 ET
Table 'Polydoros II' 6-max Seat #2 is the button
Seat 1: dpv82 ($10.55 in chips) 
Seat 2: fish72o ($10.27 in chips) 
Seat 3: whtocean ($13.09 in chips) 
Seat 4: Halfyard007 ($17.06 in chips) 
Seat 5: abrm20 ($9.46 in chips) 
Seat 6: Pablo7-Pro ($10 in chips) 
whtocean: posts small blind $0.05
Halfyard007: posts big blind $0.10
*** HOLE CARDS ***
abrm20: folds 
Pablo7-Pro: folds 
dpv82: raises $0.20 to $0.30
fish72o: folds 
whtocean: folds 
Halfyard007: folds 
Uncalled bet ($0.20) returned to dpv82
dpv82 collected $0.25 from pot
*** SUMMARY ***
Total pot $0.25 | Rake $0 
Seat 1: dpv82 collected ($0.25)
Seat 2: fish72o (button) folded before Flop (didn't bet)
Seat 3: whtocean (small blind) folded before Flop
Seat 4: Halfyard007 (big blind) folded before Flop
Seat 5: abrm20 folded before Flop (didn't bet)
Seat 6: Pablo7-Pro folded before Flop (didn't bet)



PokerStars Hand #222944838766:  Hold'em No Limit ($0.05/$0.10 USD) - 2021/01/23 0:11:39 ET
Table 'Polydoros II' 6-max Seat #3 is the button
Seat 1: dpv82 ($10.70 in chips) 
Seat 2: fish72o ($10.27 in chips) 
Seat 3: whtocean ($13.04 in chips) 
Seat 4: Halfyard007 ($16.96 in chips) 
Seat 5: abrm20 ($9.46 in chips) 
Seat 6: Pablo7-Pro ($10 in chips) 
Halfyard007: posts small blind $0.05
abrm20: posts big blind $0.10
*** HOLE CARDS ***
Pablo7-Pro: folds 
dpv82: folds 
fish72o: raises $0.15 to $0.25
whtocean: folds 
Halfyard007: folds 
abrm20: folds 
Uncalled bet ($0.15) returned to fish72o
fish72o collected $0.25 from pot
fish72o: doesn't show hand 
*** SUMMARY ***
Total pot $0.25 | Rake $0 
Seat 1: dpv82 folded before Flop (didn't bet)
Seat 2: fish72o collected ($0.25)
Seat 3: whtocean (button) folded before Flop (didn't bet)
Seat 4: Halfyard007 (small blind) folded before Flop
Seat 5: abrm20 (big blind) folded before Flop
Seat 6: Pablo7-Pro folded before Flop (didn't bet)



PokerStars Hand #222944843864:  Hold'em No Limit ($0.05/$0.10 USD) - 2021/01/23 0:11:57 ET
Table 'Polydoros II' 6-max Seat #4 is the button
Seat 1: dpv82 ($10.70 in chips) 
Seat 2: fish72o ($10.42 in chips) 
Seat 3: whtocean ($13.04 in chips) 
Seat 4: Halfyard007 ($16.91 in chips) 
Seat 5: abrm20 ($9.36 in chips) 
Seat 6: Pablo7-Pro ($10 in chips) 
abrm20: posts small blind $0.05
Pablo7-Pro: posts big blind $0.10
*** HOLE CARDS ***
dpv82: folds 
fish72o: folds 
whtocean: folds 
Halfyard007: folds 
abrm20: raises $0.15 to $0.25
Pablo7-Pro: calls $0.15
*** FLOP *** [4s Td Jc]
abrm20: bets $0.40
Pablo7-Pro: folds 
Uncalled bet ($0.40) returned to abrm20
abrm20 collected $0.48 from pot
abrm20: doesn't show hand 
*** SUMMARY ***
Total pot $0.50 | Rake $0.02 
Board [4s Td Jc]
Seat 1: dpv82 folded before Flop (didn't bet)
Seat 2: fish72o folded before Flop (didn't bet)
Seat 3: whtocean folded before Flop (didn't bet)
Seat 4: Halfyard007 (button) folded before Flop (didn't bet)
Seat 5: abrm20 (small blind) collected ($0.48)
Seat 6: Pablo7-Pro (big blind) folded on the Flop



PokerStars Hand #222944849994:  Hold'em No Limit ($0.05/$0.10 USD) - 2021/01/23 0:12:20 ET
Table 'Polydoros II' 6-max Seat #5 is the button
Seat 1: dpv82 ($10.70 in chips) 
Seat 2: fish72o ($10.42 in chips) 
Seat 3: whtocean ($13.04 in chips) 
Seat 4: Halfyard007 ($16.91 in chips) 
Seat 5: abrm20 ($9.59 in chips) 
Seat 6: Pablo7-Pro ($10 in chips) 
Pablo7-Pro: posts small blind $0.05
dpv82: posts big blind $0.10
*** HOLE CARDS ***
fish72o: folds 
whtocean: folds 
Halfyard007: folds 
abrm20: folds 
Pablo7-Pro: raises $0.20 to $0.30
dpv82: folds 
Uncalled bet ($0.20) returned to Pablo7-Pro
Pablo7-Pro collected $0.20 from pot
Pablo7-Pro: doesn't show hand 
*** SUMMARY ***
Total pot $0.20 | Rake $0 
Seat 1: dpv82 (big blind) folded before Flop
Seat 2: fish72o folded before Flop (didn't bet)
Seat 3: whtocean folded before Flop (didn't bet)
Seat 4: Halfyard007 folded before Flop (didn't bet)
Seat 5: abrm20 (button) folded before Flop (didn't bet)
Seat 6: Pablo7-Pro (small blind) collected ($0.20)



PokerStars Hand #222944853859:  Hold'em No Limit ($0.05/$0.10 USD) - 2021/01/23 0:12:33 ET
Table 'Polydoros II' 6-max Seat #6 is the button
Seat 1: dpv82 ($10.60 in chips) 
Seat 2: fish72o ($10.42 in chips) 
Seat 3: whtocean ($13.04 in chips) 
Seat 4: Halfyard007 ($16.91 in chips) 
Seat 5: abrm20 ($9.59 in chips) 
Seat 6: Pablo7-Pro ($10.10 in chips) 
dpv82: posts small blind $0.05
fish72o: posts big blind $0.10
*** HOLE CARDS ***
whtocean: folds 
Halfyard007: folds 
abrm20: folds 
Pablo7-Pro: raises $0.10 to $0.20
dpv82: folds 
fish72o: folds 
Uncalled bet ($0.10) returned to Pablo7-Pro
Pablo7-Pro collected $0.25 from pot
Pablo7-Pro: doesn't show hand 
*** SUMMARY ***
Total pot $0.25 | Rake $0 
Seat 1: dpv82 (small blind) folded before Flop
Seat 2: fish72o (big blind) folded before Flop
Seat 3: whtocean folded before Flop (didn't bet)
Seat 4: Halfyard007 folded before Flop (didn't bet)
Seat 5: abrm20 folded before Flop (didn't bet)
Seat 6: Pablo7-Pro (button) collected ($0.25)



PokerStars Hand #222944857963:  Hold'em No Limit ($0.05/$0.10 USD) - 2021/01/23 0:12:48 ET
Table 'Polydoros II' 6-max Seat #1 is the button
Seat 1: dpv82 ($10.55 in chips) 
Seat 2: fish72o ($10.32 in chips) 
Seat 3: whtocean ($13.04 in chips) 
Seat 4: Halfyard007 ($16.91 in chips) 
Seat 5: abrm20 ($9.59 in chips) 
Seat 6: Pablo7-Pro ($10.25 in chips) 
fish72o: posts small blind $0.05
whtocean: posts big blind $0.10
*** HOLE CARDS ***
Halfyard007: folds 
abrm20: folds 
Pablo7-Pro: folds 
dpv82: raises $0.20 to $0.30
fish72o: folds 
whtocean: raises $0.70 to $1
dpv82: calls $0.70
*** FLOP *** [Qs 5s Td]
whtocean: bets $1.04
dpv82: folds 
Uncalled bet ($1.04) returned to whtocean
whtocean collected $1.96 from pot
whtocean: doesn't show hand 
*** SUMMARY ***
Total pot $2.05 | Rake $0.09 
Board [Qs 5s Td]
Seat 1: dpv82 (button) folded on the Flop
Seat 2: fish72o (small blind) folded before Flop
Seat 3: whtocean (big blind) collected ($1.96)
Seat 4: Halfyard007 folded before Flop (didn't bet)
Seat 5: abrm20 folded before Flop (didn't bet)
Seat 6: Pablo7-Pro folded before Flop (didn't bet)



PokerStars Hand #222944869275:  Hold'em No Limit ($0.05/$0.10 USD) - 2021/01/23 0:13:28 ET
Table 'Polydoros II' 6-max Seat #2 is the button
Seat 1: dpv82 ($10 in chips) 
Seat 2: fish72o ($10.27 in chips) 
Seat 3: whtocean ($14 in chips) 
Seat 4: Halfyard007 ($16.91 in chips) 
Seat 5: abrm20 ($9.59 in chips) 
whtocean: posts small blind $0.05
Halfyard007: posts big blind $0.10
*** HOLE CARDS ***
abrm20: folds 
dpv82: folds 
fish72o: folds 
whtocean: folds 
Uncalled bet ($0.05) returned to Halfyard007
Halfyard007 collected $0.10 from pot
Halfyard007: doesn't show hand 
*** SUMMARY ***
Total pot $0.10 | Rake $0 
Seat 1: dpv82 folded before Flop (didn't bet)
Seat 2: fish72o (button) folded before Flop (didn't bet)
Seat 3: whtocean (small blind) folded before Flop
Seat 4: Halfyard007 (big blind) collected ($0.10)
Seat 5: abrm20 folded before Flop (didn't bet)



PokerStars Hand #222944872431:  Hold'em No Limit ($0.05/$0.10 USD) - 2021/01/23 0:13:39 ET
Table 'Polydoros II' 6-max Seat #3 is the button
Seat 1: dpv82 ($10 in chips) 
Seat 2: fish72o ($10.27 in chips) 
Seat 3: whtocean ($13.95 in chips) 
Seat 4: Halfyard007 ($16.96 in chips) 
Seat 5: abrm20 ($9.59 in chips) 
Halfyard007: posts small blind $0.05
abrm20: posts big blind $0.10
*** HOLE CARDS ***
dpv82: folds 
fish72o: folds 
whtocean: folds 
Halfyard007: raises $0.20 to $0.30
abrm20: calls $0.20
*** FLOP *** [4s 5s 8s]
Halfyard007: checks 
abrm20: checks 
*** TURN *** [4s 5s 8s] [Qc]
Halfyard007: bets $0.60
abrm20: calls $0.60
*** RIVER *** [4s 5s 8s Qc] [Ks]
Halfyard007: checks 
abrm20: checks 
*** SHOW DOWN ***
Halfyard007: shows [Ad Qs] (a flush, King high)
abrm20: mucks hand 
Halfyard007 collected $1.72 from pot
*** SUMMARY ***
Total pot $1.80 | Rake $0.08 
Board [4s 5s 8s Qc Ks]
Seat 1: dpv82 folded before Flop (didn't bet)
Seat 2: fish72o folded before Flop (didn't bet)
Seat 3: whtocean (button) folded before Flop (didn't bet)
Seat 4: Halfyard007 (small blind) showed [Ad Qs] and won ($1.72) with a flush, King high
Seat 5: abrm20 (big blind) mucked



PokerStars Hand #222944883422:  Hold'em No Limit ($0.05/$0.10 USD) - 2021/01/23 0:14:18 ET
Table 'Polydoros II' 6-max Seat #4 is the button
Seat 1: dpv82 ($10 in chips) 
Seat 2: fish72o ($10.27 in chips) 
Seat 3: whtocean ($13.95 in chips) 
Seat 4: Halfyard007 ($17.78 in chips) 
Seat 5: abrm20 ($8.69 in chips) 
abrm20: posts small blind $0.05
dpv82: posts big blind $0.10
*** HOLE CARDS ***
fish72o: folds 
whtocean: folds 
Halfyard007: raises $0.20 to $0.30
abrm20: folds 
dpv82: folds 
Uncalled bet ($0.20) returned to Halfyard007
dpv82 was removed from the table for failing to post
dpv82 leaves the table
Halfyard007 collected $0.25 from pot
Halfyard007: doesn't show hand 
*** SUMMARY ***
Total pot $0.25 | Rake $0 
Seat 1: dpv82 (big blind) folded before Flop
Seat 2: fish72o folded before Flop (didn't bet)
Seat 3: whtocean folded before Flop (didn't bet)
Seat 4: Halfyard007 (button) collected ($0.25)
Seat 5: abrm20 (small blind) folded before Flop



PokerStars Hand #222944886751:  Hold'em No Limit ($0.05/$0.10 USD) - 2021/01/23 0:14:30 ET
Table 'Polydoros II' 6-max Seat #5 is the button
Seat 2: fish72o ($10.27 in chips) 
Seat 4: Halfyard007 ($17.93 in chips) 
Seat 5: abrm20 ($8.64 in chips) 
fish72o: posts small blind $0.05
whtocean: is sitting out 
Halfyard007: posts big blind $0.10
*** HOLE CARDS ***
whtocean leaves the table
abrm20: folds 
fish72o: raises $0.15 to $0.25
Halfyard007: folds 
Uncalled bet ($0.15) returned to fish72o
fish72o collected $0.20 from pot
fish72o: doesn't show hand 
*** SUMMARY ***
Total pot $0.20 | Rake $0 
Seat 2: fish72o (small blind) collected ($0.20)
Seat 4: Halfyard007 (big blind) folded before Flop
Seat 5: abrm20 (button) folded before Flop (didn't bet)



PokerStars Hand #222944889738:  Hold'em No Limit ($0.05/$0.10 USD) - 2021/01/23 0:14:40 ET
Table 'Polydoros II' 6-max Seat #2 is the button
Seat 2: fish72o ($10.37 in chips) 
Seat 4: Halfyard007 ($17.83 in chips) 
Seat 5: abrm20 ($8.64 in chips) 
Halfyard007: posts small blind $0.05
abrm20: posts big blind $0.10
*** HOLE CARDS ***
fish72o: folds 
Halfyard007: raises $0.10 to $0.20
abrm20: calls $0.10
*** FLOP *** [3s 4c 2d]
Halfyard007: bets $0.30
abrm20: folds 
Uncalled bet ($0.30) returned to Halfyard007
Halfyard007 collected $0.38 from pot
Halfyard007: doesn't show hand 
*** SUMMARY ***
Total pot $0.40 | Rake $0.02 
Board [3s 4c 2d]
Seat 2: fish72o (button) folded before Flop (didn't bet)
Seat 4: Halfyard007 (small blind) collected ($0.38)
Seat 5: abrm20 (big blind) folded on the Flop



PokerStars Hand #222944896075:  Hold'em No Limit ($0.05/$0.10 USD) - 2021/01/23 0:15:03 ET
Table 'Polydoros II' 6-max Seat #4 is the button
Seat 2: fish72o ($10.37 in chips) 
Seat 4: Halfyard007 ($18.01 in chips) 
Seat 5: abrm20 ($8.44 in chips) 
Seat 6: Pablo7-Pro ($10.25 in chips) 
abrm20: posts small blind $0.05
Pablo7-Pro: posts big blind $0.10
*** HOLE CARDS ***
fish72o: folds 
Halfyard007: folds 
abrm20: folds 
Uncalled bet ($0.05) returned to Pablo7-Pro
Pablo7-Pro collected $0.10 from pot
Pablo7-Pro: doesn't show hand 
*** SUMMARY ***
Total pot $0.10 | Rake $0 
Seat 2: fish72o folded before Flop (didn't bet)
Seat 4: Halfyard007 (button) folded before Flop (didn't bet)
Seat 5: abrm20 (small blind) folded before Flop
Seat 6: Pablo7-Pro (big blind) collected ($0.10)



PokerStars Hand #222944898700:  Hold'em No Limit ($0.05/$0.10 USD) - 2021/01/23 0:15:12 ET
Table 'Polydoros II' 6-max Seat #5 is the button
Seat 2: fish72o ($10.37 in chips) 
Seat 4: Halfyard007 ($18.01 in chips) 
Seat 5: abrm20 ($8.39 in chips) 
Seat 6: Pablo7-Pro ($10.30 in chips) 
Pablo7-Pro: posts small blind $0.05
fish72o: posts big blind $0.10
*** HOLE CARDS ***
Halfyard007: raises $0.20 to $0.30
abrm20: folds 
Pablo7-Pro: folds 
fish72o: calls $0.20
*** FLOP *** [Jh Ts 8h]
fish72o: checks 
Halfyard007: bets $0.40
fish72o: folds 
Uncalled bet ($0.40) returned to Halfyard007
Halfyard007 collected $0.62 from pot
Halfyard007: doesn't show hand 
*** SUMMARY ***
Total pot $0.65 | Rake $0.03 
Board [Jh Ts 8h]
Seat 2: fish72o (big blind) folded on the Flop
Seat 4: Halfyard007 collected ($0.62)
Seat 5: abrm20 (button) folded before Flop (didn't bet)
Seat 6: Pablo7-Pro (small blind) folded before Flop



PokerStars Hand #222944905687:  Hold'em No Limit ($0.05/$0.10 USD) - 2021/01/23 0:15:37 ET
Table 'Polydoros II' 6-max Seat #6 is the button
Seat 2: fish72o ($10.07 in chips) 
Seat 4: Halfyard007 ($18.33 in chips) 
Seat 5: abrm20 ($8.39 in chips) 
Seat 6: Pablo7-Pro ($10.25 in chips) 
fish72o: posts small blind $0.05
Halfyard007: posts big blind $0.10
*** HOLE CARDS ***
abrm20: folds 
Pablo7-Pro: raises $0.20 to $0.30
fish72o: folds 
Halfyard007: calls $0.20
*** FLOP *** [Ts 4s 5c]
Halfyard007: checks 
Pablo7-Pro: bets $0.20
Halfyard007: folds 
Uncalled bet ($0.20) returned to Pablo7-Pro
Pablo7-Pro collected $0.62 from pot
Pablo7-Pro: doesn't show hand 
*** SUMMARY ***
Total pot $0.65 | Rake $0.03 
Board [Ts 4s 5c]
Seat 2: fish72o (small blind) folded before Flop
Seat 4: Halfyard007 (big blind) folded on the Flop
Seat 5: abrm20 folded before Flop (didn't bet)
Seat 6: Pablo7-Pro (button) collected ($0.62)



PokerStars Hand #222944911800:  Hold'em No Limit ($0.05/$0.10 USD) - 2021/01/23 0:16:00 ET
Table 'Polydoros II' 6-max Seat #2 is the button
Seat 2: fish72o ($10.02 in chips) 
Seat 4: Halfyard007 ($18.03 in chips) 
Seat 5: abrm20 ($8.39 in chips) 
Seat 6: Pablo7-Pro ($10.57 in chips) 
Halfyard007: posts small blind $0.05
abrm20: posts big blind $0.10
*** HOLE CARDS ***
Pablo7-Pro: folds 
fish72o: raises $0.15 to $0.25
Halfyard007: folds 
abrm20: calls $0.15
*** FLOP *** [Kc 6d 6h]
abrm20: checks 
Quetlaah joins the table at seat #1 
fish72o: bets $0.17
abrm20: calls $0.17
*** TURN *** [Kc 6d 6h] [7s]
abrm20: checks 
fish72o: checks 
*** RIVER *** [Kc 6d 6h 7s] [7h]
abrm20: checks 
fish72o: checks 
*** SHOW DOWN ***
abrm20: shows [8d 8c] (two pair, Eights and Sevens)
fish72o: mucks hand 
abrm20 collected $0.85 from pot
*** SUMMARY ***
Total pot $0.89 | Rake $0.04 
Board [Kc 6d 6h 7s 7h]
Seat 2: fish72o (button) mucked
Seat 4: Halfyard007 (small blind) folded before Flop
Seat 5: abrm20 (big blind) showed [8d 8c] and won ($0.85) with two pair, Eights and Sevens
Seat 6: Pablo7-Pro folded before Flop (didn't bet)



PokerStars Hand #222944923971:  Hold'em No Limit ($0.05/$0.10 USD) - 2021/01/23 0:16:44 ET
Table 'Polydoros II' 6-max Seat #4 is the button
Seat 2: fish72o ($10 in chips) 
Seat 4: Halfyard007 ($17.98 in chips) 
Seat 5: abrm20 ($8.82 in chips) 
Seat 6: Pablo7-Pro ($10.57 in chips) 
abrm20: posts small blind $0.05
Pablo7-Pro: posts big blind $0.10
Quetlaah: sits out 
*** HOLE CARDS ***
fish72o: folds 
Halfyard007: raises $0.20 to $0.30
lalito.mdq joins the table at seat #3 
abrm20: raises $0.70 to $1
Pablo7-Pro: folds 
Halfyard007: calls $0.70
*** FLOP *** [Qd 7h Kc]
abrm20: bets $1
Halfyard007: folds 
Uncalled bet ($1) returned to abrm20
abrm20 collected $2.01 from pot
abrm20: doesn't show hand 
*** SUMMARY ***
Total pot $2.10 | Rake $0.09 
Board [Qd 7h Kc]
Seat 2: fish72o folded before Flop (didn't bet)
Seat 4: Halfyard007 (button) folded on the Flop
Seat 5: abrm20 (small blind) collected ($2.01)
Seat 6: Pablo7-Pro (big blind) folded before Flop



PokerStars Hand #222944936325:  Hold'em No Limit ($0.05/$0.10 USD) - 2021/01/23 0:17:28 ET
Table 'Polydoros II' 6-max Seat #5 is the button
Seat 1: Quetlaah ($10 in chips) 
Seat 2: fish72o ($10 in chips) 
Seat 4: Halfyard007 ($16.98 in chips) 
Seat 5: abrm20 ($9.83 in chips) 
Seat 6: Pablo7-Pro ($10.47 in chips) 
Pablo7-Pro: posts small blind $0.05
Quetlaah: posts big blind $0.10
lalito.mdq: sits out 
*** HOLE CARDS ***
fish72o: folds 
Halfyard007: raises $0.20 to $0.30
abrm20: folds 
Pablo7-Pro: folds 
Quetlaah: folds 
Uncalled bet ($0.20) returned to Halfyard007
Halfyard007 collected $0.25 from pot
Halfyard007: doesn't show hand 
*** SUMMARY ***
Total pot $0.25 | Rake $0 
Seat 1: Quetlaah (big blind) folded before Flop
Seat 2: fish72o folded before Flop (didn't bet)
Seat 4: Halfyard007 collected ($0.25)
Seat 5: abrm20 (button) folded before Flop (didn't bet)
Seat 6: Pablo7-Pro (small blind) folded before Flop



PokerStars Hand #222944941125:  Hold'em No Limit ($0.05/$0.10 USD) - 2021/01/23 0:17:46 ET
Table 'Polydoros II' 6-max Seat #6 is the button
Seat 1: Quetlaah ($10 in chips) 
Seat 2: fish72o ($10 in chips) 
Seat 4: Halfyard007 ($17.13 in chips) 
Seat 5: abrm20 ($9.83 in chips) 
Seat 6: Pablo7-Pro ($10.42 in chips) 
Quetlaah: posts small blind $0.05
fish72o: posts big blind $0.10
lalito.mdq: sits out 
*** HOLE CARDS ***
Halfyard007: calls $0.10
abrm20: folds 
Pablo7-Pro: raises $0.20 to $0.30
Quetlaah: folds 
fish72o: folds 
Halfyard007: calls $0.20
*** FLOP *** [8h 4s 2c]
Halfyard007: bets $0.40
Pablo7-Pro: folds 
Uncalled bet ($0.40) returned to Halfyard007
Halfyard007 collected $0.72 from pot
Halfyard007: doesn't show hand 
*** SUMMARY ***
Total pot $0.75 | Rake $0.03 
Board [8h 4s 2c]
Seat 1: Quetlaah (small blind) folded before Flop
Seat 2: fish72o (big blind) folded before Flop
Seat 4: Halfyard007 collected ($0.72)
Seat 5: abrm20 folded before Flop (didn't bet)
Seat 6: Pablo7-Pro (button) folded on the Flop



PokerStars Hand #222944947742:  Hold'em No Limit ($0.05/$0.10 USD) - 2021/01/23 0:18:09 ET
Table 'Polydoros II' 6-max Seat #1 is the button
Seat 1: Quetlaah ($10 in chips) 
Seat 2: fish72o ($10 in chips) 
Seat 3: lalito.mdq ($10 in chips) 
Seat 4: Halfyard007 ($17.55 in chips) 
Seat 5: abrm20 ($9.83 in chips) 
Seat 6: Pablo7-Pro ($10.12 in chips) 
fish72o: posts small blind $0.05
lalito.mdq: posts big blind $0.10
*** HOLE CARDS ***
Halfyard007: calls $0.10
abrm20: folds 
Pablo7-Pro: raises $0.20 to $0.30
Quetlaah: folds 
fish72o: folds 
lalito.mdq: calls $0.20
Halfyard007: folds 
*** FLOP *** [8s Qc 7h]
lalito.mdq: checks 
Pablo7-Pro: bets $0.24
lalito.mdq: calls $0.24
*** TURN *** [8s Qc 7h] [4d]
lalito.mdq: checks 
Pablo7-Pro: bets $0.91
lalito.mdq: folds 
Uncalled bet ($0.91) returned to Pablo7-Pro
Pablo7-Pro collected $1.17 from pot
Pablo7-Pro: doesn't show hand 
*** SUMMARY ***
Total pot $1.23 | Rake $0.06 
Board [8s Qc 7h 4d]
Seat 1: Quetlaah (button) folded before Flop (didn't bet)
Seat 2: fish72o (small blind) folded before Flop
Seat 3: lalito.mdq (big blind) folded on the Turn
Seat 4: Halfyard007 folded before Flop
Seat 5: abrm20 folded before Flop (didn't bet)
Seat 6: Pablo7-Pro collected ($1.17)



PokerStars Hand #222944961249:  Hold'em No Limit ($0.05/$0.10 USD) - 2021/01/23 0:18:57 ET
Table 'Polydoros II' 6-max Seat #2 is the button
Seat 1: Quetlaah ($10 in chips) 
Seat 2: fish72o ($10 in chips) 
Seat 3: lalito.mdq ($10 in chips) 
Seat 4: Halfyard007 ($17.45 in chips) 
Seat 5: abrm20 ($9.83 in chips) 
Seat 6: Pablo7-Pro ($10.75 in chips) 
lalito.mdq: posts small blind $0.05
Halfyard007: posts big blind $0.10
*** HOLE CARDS ***
abrm20: folds 
Pablo7-Pro: folds 
Quetlaah: folds 
fish72o: folds 
lalito.mdq: folds 
Uncalled bet ($0.05) returned to Halfyard007
Halfyard007 collected $0.10 from pot
Halfyard007: doesn't show hand 
*** SUMMARY ***
Total pot $0.10 | Rake $0 
Seat 1: Quetlaah folded before Flop (didn't bet)
Seat 2: fish72o (button) folded before Flop (didn't bet)
Seat 3: lalito.mdq (small blind) folded before Flop
Seat 4: Halfyard007 (big blind) collected ($0.10)
Seat 5: abrm20 folded before Flop (didn't bet)
Seat 6: Pablo7-Pro folded before Flop (didn't bet)



PokerStars Hand #222944965885:  Hold'em No Limit ($0.05/$0.10 USD) - 2021/01/23 0:19:14 ET
Table 'Polydoros II' 6-max Seat #3 is the button
Seat 1: Quetlaah ($10 in chips) 
Seat 2: fish72o ($10 in chips) 
Seat 3: lalito.mdq ($10 in chips) 
Seat 4: Halfyard007 ($17.50 in chips) 
Seat 5: abrm20 ($9.83 in chips) 
Seat 6: Pablo7-Pro ($10.75 in chips) 
Halfyard007: posts small blind $0.05
abrm20: posts big blind $0.10
*** HOLE CARDS ***
Pablo7-Pro: raises $0.20 to $0.30
Quetlaah: folds 
fish72o: folds 
lalito.mdq: folds 
Halfyard007: calls $0.25
abrm20: calls $0.20
*** FLOP *** [Kh Jd 4h]
Halfyard007: checks 
abrm20: checks 
Pablo7-Pro: bets $0.67
Halfyard007: calls $0.67
abrm20: folds 
*** TURN *** [Kh Jd 4h] [Ad]
Halfyard007: bets $0.90
Pablo7-Pro: calls $0.90
*** RIVER *** [Kh Jd 4h Ad] [3d]
Halfyard007: checks 
Pablo7-Pro: checks 
*** SHOW DOWN ***
Halfyard007: shows [Jc Qs] (a pair of Jacks)
Pablo7-Pro: shows [Ks Kd] (three of a kind, Kings)
Pablo7-Pro collected $3.86 from pot
*** SUMMARY ***
Total pot $4.04 | Rake $0.18 
Board [Kh Jd 4h Ad 3d]
Seat 1: Quetlaah folded before Flop (didn't bet)
Seat 2: fish72o folded before Flop (didn't bet)
Seat 3: lalito.mdq (button) folded before Flop (didn't bet)
Seat 4: Halfyard007 (small blind) showed [Jc Qs] and lost with a pair of Jacks
Seat 5: abrm20 (big blind) folded on the Flop
Seat 6: Pablo7-Pro showed [Ks Kd] and won ($3.86) with three of a kind, Kings



PokerStars Hand #222944987099:  Hold'em No Limit ($0.05/$0.10 USD) - 2021/01/23 0:20:29 ET
Table 'Polydoros II' 6-max Seat #4 is the button
Seat 1: Quetlaah ($10 in chips) 
Seat 2: fish72o ($10 in chips) 
Seat 3: lalito.mdq ($10 in chips) 
Seat 4: Halfyard007 ($15.63 in chips) 
Seat 5: abrm20 ($9.53 in chips) 
Seat 6: Pablo7-Pro ($12.74 in chips) 
abrm20: posts small blind $0.05
Pablo7-Pro: posts big blind $0.10
*** HOLE CARDS ***
Quetlaah: folds 
fish72o: folds 
lalito.mdq: folds 
Halfyard007: raises $0.20 to $0.30
abrm20: folds 
Pablo7-Pro: folds 
Uncalled bet ($0.20) returned to Halfyard007
Halfyard007 collected $0.25 from pot
Halfyard007: doesn't show hand 
*** SUMMARY ***
Total pot $0.25 | Rake $0 
Seat 1: Quetlaah folded before Flop (didn't bet)
Seat 2: fish72o folded before Flop (didn't bet)
Seat 3: lalito.mdq folded before Flop (didn't bet)
Seat 4: Halfyard007 (button) collected ($0.25)
Seat 5: abrm20 (small blind) folded before Flop
Seat 6: Pablo7-Pro (big blind) folded before Flop



PokerStars Hand #222944991023:  Hold'em No Limit ($0.05/$0.10 USD) - 2021/01/23 0:20:44 ET
Table 'Polydoros II' 6-max Seat #5 is the button
Seat 1: Quetlaah ($10 in chips) 
Seat 2: fish72o ($10 in chips) 
Seat 3: lalito.mdq ($10 in chips) 
Seat 4: Halfyard007 ($15.78 in chips) 
Seat 5: abrm20 ($9.48 in chips) 
Seat 6: Pablo7-Pro ($12.64 in chips) 
Pablo7-Pro: posts small blind $0.05
Quetlaah: posts big blind $0.10
*** HOLE CARDS ***
fish72o: folds 
lalito.mdq: raises $0.15 to $0.25
Halfyard007: folds 
abrm20: folds 
Pablo7-Pro: folds 
Quetlaah: folds 
Uncalled bet ($0.15) returned to lalito.mdq
lalito.mdq collected $0.25 from pot
*** SUMMARY ***
Total pot $0.25 | Rake $0 
Seat 1: Quetlaah (big blind) folded before Flop
Seat 2: fish72o folded before Flop (didn't bet)
Seat 3: lalito.mdq collected ($0.25)
Seat 4: Halfyard007 folded before Flop (didn't bet)
Seat 5: abrm20 (button) folded before Flop (didn't bet)
Seat 6: Pablo7-Pro (small blind) folded before Flop



PokerStars Hand #222944994799:  Hold'em No Limit ($0.05/$0.10 USD) - 2021/01/23 0:20:57 ET
Table 'Polydoros II' 6-max Seat #6 is the button
Seat 1: Quetlaah ($10 in chips) 
Seat 2: fish72o ($10 in chips) 
Seat 3: lalito.mdq ($10.15 in chips) 
Seat 4: Halfyard007 ($15.78 in chips) 
Seat 5: abrm20 ($9.48 in chips) 
Seat 6: Pablo7-Pro ($12.59 in chips) 
Quetlaah: posts small blind $0.05
fish72o: posts big blind $0.10
*** HOLE CARDS ***
lalito.mdq: raises $0.15 to $0.25
Halfyard007: folds 
abrm20: calls $0.25
Pablo7-Pro: folds 
Quetlaah: folds 
fish72o: folds 
*** FLOP *** [Jh 7d Qd]
lalito.mdq: checks 
abrm20: checks 
*** TURN *** [Jh 7d Qd] [8d]
lalito.mdq: checks 
abrm20: bets $0.40
lalito.mdq: folds 
Uncalled bet ($0.40) returned to abrm20
abrm20 collected $0.62 from pot
abrm20: doesn't show hand 
*** SUMMARY ***
Total pot $0.65 | Rake $0.03 
Board [Jh 7d Qd 8d]
Seat 1: Quetlaah (small blind) folded before Flop
Seat 2: fish72o (big blind) folded before Flop
Seat 3: lalito.mdq folded on the Turn
Seat 4: Halfyard007 folded before Flop (didn't bet)
Seat 5: abrm20 collected ($0.62)
Seat 6: Pablo7-Pro (button) folded before Flop (didn't bet)



PokerStars Hand #222945003065:  Hold'em No Limit ($0.05/$0.10 USD) - 2021/01/23 0:21:27 ET
Table 'Polydoros II' 6-max Seat #1 is the button
Seat 1: Quetlaah ($10 in chips) 
Seat 2: fish72o ($10 in chips) 
Seat 3: lalito.mdq ($10 in chips) 
Seat 4: Halfyard007 ($15.78 in chips) 
Seat 5: abrm20 ($9.85 in chips) 
Seat 6: Pablo7-Pro ($12.59 in chips) 
fish72o: posts small blind $0.05
lalito.mdq: posts big blind $0.10
*** HOLE CARDS ***
Halfyard007: folds 
abrm20: folds 
Pablo7-Pro: folds 
Quetlaah: folds 
fish72o: folds 
Uncalled bet ($0.05) returned to lalito.mdq
lalito.mdq collected $0.10 from pot
lalito.mdq: doesn't show hand 
*** SUMMARY ***
Total pot $0.10 | Rake $0 
Seat 1: Quetlaah (button) folded before Flop (didn't bet)
Seat 2: fish72o (small blind) folded before Flop
Seat 3: lalito.mdq (big blind) collected ($0.10)
Seat 4: Halfyard007 folded before Flop (didn't bet)
Seat 5: abrm20 folded before Flop (didn't bet)
Seat 6: Pablo7-Pro folded before Flop (didn't bet)



PokerStars Hand #222945008210:  Hold'em No Limit ($0.05/$0.10 USD) - 2021/01/23 0:21:45 ET
Table 'Polydoros II' 6-max Seat #2 is the button
Seat 1: Quetlaah ($10 in chips) 
Seat 2: fish72o ($10 in chips) 
Seat 3: lalito.mdq ($10.05 in chips) 
Seat 4: Halfyard007 ($15.78 in chips) 
Seat 5: abrm20 ($9.85 in chips) 
Seat 6: Pablo7-Pro ($12.59 in chips) 
lalito.mdq: posts small blind $0.05
Halfyard007: posts big blind $0.10
*** HOLE CARDS ***
abrm20: folds 
Pablo7-Pro: folds 
Quetlaah: raises $0.20 to $0.30
fish72o: folds 
lalito.mdq: folds 
Halfyard007: folds 
Uncalled bet ($0.20) returned to Quetlaah
Quetlaah collected $0.25 from pot
Quetlaah: doesn't show hand 
*** SUMMARY ***
Total pot $0.25 | Rake $0 
Seat 1: Quetlaah collected ($0.25)
Seat 2: fish72o (button) folded before Flop (didn't bet)
Seat 3: lalito.mdq (small blind) folded before Flop
Seat 4: Halfyard007 (big blind) folded before Flop
Seat 5: abrm20 folded before Flop (didn't bet)
Seat 6: Pablo7-Pro folded before Flop (didn't bet)



PokerStars Hand #222945012329:  Hold'em No Limit ($0.05/$0.10 USD) - 2021/01/23 0:22:00 ET
Table 'Polydoros II' 6-max Seat #3 is the button
Seat 1: Quetlaah ($10.15 in chips) 
Seat 2: fish72o ($10 in chips) 
Seat 3: lalito.mdq ($10 in chips) 
Seat 4: Halfyard007 ($15.68 in chips) 
Seat 5: abrm20 ($9.85 in chips) 
Seat 6: Pablo7-Pro ($12.59 in chips) 
Halfyard007: posts small blind $0.05
abrm20: posts big blind $0.10
*** HOLE CARDS ***
Pablo7-Pro: folds 
Quetlaah: folds 
fish72o: folds 
lalito.mdq: folds 
Halfyard007: raises $0.20 to $0.30
abrm20: folds 
Uncalled bet ($0.20) returned to Halfyard007
Halfyard007 collected $0.20 from pot
Halfyard007: doesn't show hand 
*** SUMMARY ***
Total pot $0.20 | Rake $0 
Seat 1: Quetlaah folded before Flop (didn't bet)
Seat 2: fish72o folded before Flop (didn't bet)
Seat 3: lalito.mdq (button) folded before Flop (didn't bet)
Seat 4: Halfyard007 (small blind) collected ($0.20)
Seat 5: abrm20 (big blind) folded before Flop
Seat 6: Pablo7-Pro folded before Flop (didn't bet)



PokerStars Hand #222945015622:  Hold'em No Limit ($0.05/$0.10 USD) - 2021/01/23 0:22:12 ET
Table 'Polydoros II' 6-max Seat #4 is the button
Seat 1: Quetlaah ($10.15 in chips) 
Seat 2: fish72o ($10 in chips) 
Seat 3: lalito.mdq ($10 in chips) 
Seat 4: Halfyard007 ($15.78 in chips) 
Seat 5: abrm20 ($9.75 in chips) 
Seat 6: Pablo7-Pro ($12.59 in chips) 
abrm20: posts small blind $0.05
Pablo7-Pro: posts big blind $0.10
*** HOLE CARDS ***
Quetlaah: folds 
fish72o: folds 
lalito.mdq: folds 
Halfyard007: raises $0.20 to $0.30
abrm20: folds 
Pablo7-Pro: folds 
Uncalled bet ($0.20) returned to Halfyard007
Halfyard007 collected $0.25 from pot
Halfyard007: doesn't show hand 
*** SUMMARY ***
Total pot $0.25 | Rake $0 
Seat 1: Quetlaah folded before Flop (didn't bet)
Seat 2: fish72o folded before Flop (didn't bet)
Seat 3: lalito.mdq folded before Flop (didn't bet)
Seat 4: Halfyard007 (button) collected ($0.25)
Seat 5: abrm20 (small blind) folded before Flop
Seat 6: Pablo7-Pro (big blind) folded before Flop



PokerStars Hand #222945019989:  Hold'em No Limit ($0.05/$0.10 USD) - 2021/01/23 0:22:30 ET
Table 'Polydoros II' 6-max Seat #5 is the button
Seat 1: Quetlaah ($10.15 in chips) 
Seat 2: fish72o ($10 in chips) 
Seat 4: Halfyard007 ($15.93 in chips) 
Seat 5: abrm20 ($9.70 in chips) 
Seat 6: Pablo7-Pro ($12.49 in chips) 
Pablo7-Pro: posts small blind $0.05
Quetlaah: posts big blind $0.10
*** HOLE CARDS ***
fish72o: folds 
Halfyard007: raises $0.20 to $0.30
abrm20: folds 
Pablo7-Pro: calls $0.25
Quetlaah: calls $0.20
*** FLOP *** [8c 2h 9h]
Pablo7-Pro: checks 
Quetlaah: bets $0.66
Halfyard007: folds 
Pablo7-Pro: calls $0.66
*** TURN *** [8c 2h 9h] [Ks]
Pablo7-Pro: checks 
Quetlaah: bets $1.63
Pablo7-Pro: calls $1.63
*** RIVER *** [8c 2h 9h Ks] [6c]
lalito.mdq leaves the table
Pablo7-Pro: checks 
Quetlaah: bets $2.67
reznor1 joins the table at seat #3 
Pablo7-Pro: folds 
Uncalled bet ($2.67) returned to Quetlaah
Quetlaah collected $5.23 from pot
Quetlaah: doesn't show hand 
*** SUMMARY ***
Total pot $5.48 | Rake $0.25 
Board [8c 2h 9h Ks 6c]
Seat 1: Quetlaah (big blind) collected ($5.23)
Seat 2: fish72o folded before Flop (didn't bet)
Seat 4: Halfyard007 folded on the Flop
Seat 5: abrm20 (button) folded before Flop (didn't bet)
Seat 6: Pablo7-Pro (small blind) folded on the River



PokerStars Hand #222945039408:  Hold'em No Limit ($0.05/$0.10 USD) - 2021/01/23 0:23:40 ET
Table 'Polydoros II' 6-max Seat #6 is the button
Seat 1: Quetlaah ($12.79 in chips) 
Seat 2: fish72o ($10 in chips) 
Seat 4: Halfyard007 ($15.63 in chips) 
Seat 5: abrm20 ($9.70 in chips) 
Seat 6: Pablo7-Pro ($10 in chips) 
Quetlaah: posts small blind $0.05
fish72o: posts big blind $0.10
reznor1: sits out 
*** HOLE CARDS ***
Halfyard007: raises $0.20 to $0.30
abrm20: calls $0.30
Pablo7-Pro: calls $0.30
Quetlaah: folds 
fish72o: folds 
*** FLOP *** [6c Ks 5s]
Halfyard007: checks 
abrm20: checks 
Pablo7-Pro: checks 
*** TURN *** [6c Ks 5s] [6s]
Halfyard007: bets $0.40
abrm20: folds 
Pablo7-Pro: folds 
Uncalled bet ($0.40) returned to Halfyard007
Halfyard007 collected $1 from pot
Halfyard007: doesn't show hand 
*** SUMMARY ***
Total pot $1.05 | Rake $0.05 
Board [6c Ks 5s 6s]
Seat 1: Quetlaah (small blind) folded before Flop
Seat 2: fish72o (big blind) folded before Flop
Seat 4: Halfyard007 collected ($1)
Seat 5: abrm20 folded on the Turn
Seat 6: Pablo7-Pro (button) folded on the Turn



PokerStars Hand #222945053478:  Hold'em No Limit ($0.05/$0.10 USD) - 2021/01/23 0:24:30 ET
Table 'Polydoros II' 6-max Seat #1 is the button
Seat 1: Quetlaah ($12.74 in chips) 
Seat 2: fish72o ($10 in chips) 
Seat 3: reznor1 ($4 in chips) 
Seat 4: Halfyard007 ($16.33 in chips) 
Seat 5: abrm20 ($9.40 in chips) 
Seat 6: Pablo7-Pro ($10 in chips) 
fish72o: posts small blind $0.05
reznor1: posts big blind $0.10
*** HOLE CARDS ***
Halfyard007: folds 
abrm20: folds 
Pablo7-Pro: raises $0.20 to $0.30
Quetlaah: folds 
fish72o: folds 
reznor1: folds 
Uncalled bet ($0.20) returned to Pablo7-Pro
Pablo7-Pro collected $0.25 from pot
Pablo7-Pro: doesn't show hand 
*** SUMMARY ***
Total pot $0.25 | Rake $0 
Seat 1: Quetlaah (button) folded before Flop (didn't bet)
Seat 2: fish72o (small blind) folded before Flop
Seat 3: reznor1 (big blind) folded before Flop
Seat 4: Halfyard007 folded before Flop (didn't bet)
Seat 5: abrm20 folded before Flop (didn't bet)
Seat 6: Pablo7-Pro collected ($0.25)



PokerStars Hand #222945057877:  Hold'em No Limit ($0.05/$0.10 USD) - 2021/01/23 0:24:46 ET
Table 'Polydoros II' 6-max Seat #2 is the button
Seat 1: Quetlaah ($12.74 in chips) 
Seat 2: fish72o ($10 in chips) 
Seat 3: reznor1 ($3.90 in chips) 
Seat 4: Halfyard007 ($16.33 in chips) 
Seat 5: abrm20 ($9.40 in chips) 
Seat 6: Pablo7-Pro ($10.15 in chips) 
reznor1: posts small blind $0.05
Halfyard007: posts big blind $0.10
*** HOLE CARDS ***
abrm20: folds 
Pablo7-Pro: folds 
Quetlaah: folds 
fish72o: folds 
reznor1: raises $0.40 to $0.50
Halfyard007: calls $0.40
*** FLOP *** [Jd 6h 3s]
reznor1: bets $0.30
Halfyard007: raises $0.30 to $0.60
reznor1: raises $0.40 to $1
Halfyard007: calls $0.40
*** TURN *** [Jd 6h 3s] [Qd]
reznor1: bets $2.40 and is all-in
Halfyard007: folds 
Uncalled bet ($2.40) returned to reznor1
reznor1 collected $2.86 from pot
*** SUMMARY ***
Total pot $3 | Rake $0.14 
Board [Jd 6h 3s Qd]
Seat 1: Quetlaah folded before Flop (didn't bet)
Seat 2: fish72o (button) folded before Flop (didn't bet)
Seat 3: reznor1 (small blind) collected ($2.86)
Seat 4: Halfyard007 (big blind) folded on the Turn
Seat 5: abrm20 folded before Flop (didn't bet)
Seat 6: Pablo7-Pro folded before Flop (didn't bet)



PokerStars Hand #222945072878:  Hold'em No Limit ($0.05/$0.10 USD) - 2021/01/23 0:25:41 ET
Table 'Polydoros II' 6-max Seat #3 is the button
Seat 1: Quetlaah ($12.74 in chips) 
Seat 2: fish72o ($10 in chips) 
Seat 3: reznor1 ($5.26 in chips) 
Seat 4: Halfyard007 ($14.83 in chips) 
Seat 5: abrm20 ($9.40 in chips) 
Seat 6: Pablo7-Pro ($10.15 in chips) 
Halfyard007: posts small blind $0.05
abrm20: posts big blind $0.10
*** HOLE CARDS ***
Pablo7-Pro: raises $0.20 to $0.30
Quetlaah: folds 
fish72o: folds 
reznor1: folds 
Halfyard007: folds 
abrm20: folds 
Uncalled bet ($0.20) returned to Pablo7-Pro
Pablo7-Pro collected $0.25 from pot
Pablo7-Pro: doesn't show hand 
*** SUMMARY ***
Total pot $0.25 | Rake $0 
Seat 1: Quetlaah folded before Flop (didn't bet)
Seat 2: fish72o folded before Flop (didn't bet)
Seat 3: reznor1 (button) folded before Flop (didn't bet)
Seat 4: Halfyard007 (small blind) folded before Flop
Seat 5: abrm20 (big blind) folded before Flop
Seat 6: Pablo7-Pro collected ($0.25)



PokerStars Hand #222945076635:  Hold'em No Limit ($0.05/$0.10 USD) - 2021/01/23 0:25:55 ET
Table 'Polydoros II' 6-max Seat #4 is the button
Seat 1: Quetlaah ($12.74 in chips) 
Seat 2: fish72o ($10 in chips) 
Seat 3: reznor1 ($5.26 in chips) 
Seat 4: Halfyard007 ($14.78 in chips) 
Seat 5: abrm20 ($9.30 in chips) 
Seat 6: Pablo7-Pro ($10.30 in chips) 
abrm20: posts small blind $0.05
Pablo7-Pro: posts big blind $0.10
*** HOLE CARDS ***
Quetlaah: folds 
fish72o: folds 
reznor1: folds 
Halfyard007: raises $0.20 to $0.30
abrm20: calls $0.25
Pablo7-Pro: folds 
*** FLOP *** [Ad 8h 4s]
abrm20: checks 
Halfyard007: bets $0.30
abrm20: calls $0.30
*** TURN *** [Ad 8h 4s] [7s]
abrm20: checks 
Halfyard007: bets $0.50
abrm20: calls $0.50
*** RIVER *** [Ad 8h 4s 7s] [5s]
abrm20: bets $2.20
Halfyard007: folds 
Uncalled bet ($2.20) returned to abrm20
abrm20 collected $2.20 from pot
abrm20: doesn't show hand 
*** SUMMARY ***
Total pot $2.30 | Rake $0.10 
Board [Ad 8h 4s 7s 5s]
Seat 1: Quetlaah folded before Flop (didn't bet)
Seat 2: fish72o folded before Flop (didn't bet)
Seat 3: reznor1 folded before Flop (didn't bet)
Seat 4: Halfyard007 (button) folded on the River
Seat 5: abrm20 (small blind) collected ($2.20)
Seat 6: Pablo7-Pro (big blind) folded before Flop



PokerStars Hand #222945094084:  Hold'em No Limit ($0.05/$0.10 USD) - 2021/01/23 0:26:59 ET
Table 'Polydoros II' 6-max Seat #5 is the button
Seat 1: Quetlaah ($12.74 in chips) 
Seat 2: fish72o ($10 in chips) 
Seat 3: reznor1 ($5.26 in chips) 
Seat 4: Halfyard007 ($13.68 in chips) 
Seat 5: abrm20 ($10.40 in chips) 
Seat 6: Pablo7-Pro ($10.20 in chips) 
Pablo7-Pro: posts small blind $0.05
Quetlaah: posts big blind $0.10
*** HOLE CARDS ***
fish72o: folds 
reznor1: calls $0.10
Halfyard007: raises $0.20 to $0.30
abrm20: folds 
Pablo7-Pro: folds 
Quetlaah: folds 
reznor1: calls $0.20
*** FLOP *** [3s Qh 5s]
reznor1: checks 
Halfyard007: checks 
*** TURN *** [3s Qh 5s] [3c]
reznor1: checks 
Halfyard007: checks 
*** RIVER *** [3s Qh 5s 3c] [Ts]
reznor1: bets $0.22
Halfyard007: calls $0.22
*** SHOW DOWN ***
reznor1: shows [8c Js] (a pair of Threes)
Halfyard007: shows [Ah 7s] (a pair of Threes - Ace kicker)
Halfyard007 collected $1.14 from pot
*** SUMMARY ***
Total pot $1.19 | Rake $0.05 
Board [3s Qh 5s 3c Ts]
Seat 1: Quetlaah (big blind) folded before Flop
Seat 2: fish72o folded before Flop (didn't bet)
Seat 3: reznor1 showed [8c Js] and lost with a pair of Threes
Seat 4: Halfyard007 showed [Ah 7s] and won ($1.14) with a pair of Threes
Seat 5: abrm20 (button) folded before Flop (didn't bet)
Seat 6: Pablo7-Pro (small blind) folded before Flop



PokerStars Hand #222945104968:  Hold'em No Limit ($0.05/$0.10 USD) - 2021/01/23 0:27:38 ET
Table 'Polydoros II' 6-max Seat #6 is the button
Seat 1: Quetlaah ($12.64 in chips) 
Seat 2: fish72o ($10 in chips) 
Seat 3: reznor1 ($4.74 in chips) 
Seat 4: Halfyard007 ($14.30 in chips) 
Seat 5: abrm20 ($10.40 in chips) 
Seat 6: Pablo7-Pro ($10.15 in chips) 
Quetlaah: posts small blind $0.05
fish72o: posts big blind $0.10
*** HOLE CARDS ***
reznor1: folds 
Halfyard007: folds 
abrm20: folds 
Pablo7-Pro: folds 
Quetlaah: raises $0.20 to $0.30
fish72o: calls $0.20
*** FLOP *** [7d Ad 2s]
Quetlaah: checks 
fish72o: bets $0.19
Quetlaah: calls $0.19
*** TURN *** [7d Ad 2s] [Jc]
Quetlaah: checks 
fish72o: checks 
*** RIVER *** [7d Ad 2s Jc] [Jd]
Quetlaah: checks 
fish72o: bets $0.31
Quetlaah: folds 
Uncalled bet ($0.31) returned to fish72o
fish72o collected $0.94 from pot
fish72o: doesn't show hand 
*** SUMMARY ***
Total pot $0.98 | Rake $0.04 
Board [7d Ad 2s Jc Jd]
Seat 1: Quetlaah (small blind) folded on the River
Seat 2: fish72o (big blind) collected ($0.94)
Seat 3: reznor1 folded before Flop (didn't bet)
Seat 4: Halfyard007 folded before Flop (didn't bet)
Seat 5: abrm20 folded before Flop (didn't bet)
Seat 6: Pablo7-Pro (button) folded before Flop (didn't bet)



PokerStars Hand #222945116282:  Hold'em No Limit ($0.05/$0.10 USD) - 2021/01/23 0:28:20 ET
Table 'Polydoros II' 6-max Seat #1 is the button
Seat 1: Quetlaah ($12.15 in chips) 
Seat 2: fish72o ($10.45 in chips) 
Seat 3: reznor1 ($4.74 in chips) 
Seat 4: Halfyard007 ($14.30 in chips) 
Seat 5: abrm20 ($10.40 in chips) 
Seat 6: Pablo7-Pro ($10.15 in chips) 
fish72o: posts small blind $0.05
reznor1: posts big blind $0.10
*** HOLE CARDS ***
Halfyard007: folds 
abrm20: folds 
Pablo7-Pro: folds 
Quetlaah: folds 
fish72o: raises $0.15 to $0.25
reznor1: calls $0.15
*** FLOP *** [Ah Th 7h]
fish72o: bets $0.16
reznor1: raises $0.16 to $0.32
fish72o: folds 
Uncalled bet ($0.16) returned to reznor1
reznor1 collected $0.78 from pot
*** SUMMARY ***
Total pot $0.82 | Rake $0.04 
Board [Ah Th 7h]
Seat 1: Quetlaah (button) folded before Flop (didn't bet)
Seat 2: fish72o (small blind) folded on the Flop
Seat 3: reznor1 (big blind) collected ($0.78)
Seat 4: Halfyard007 folded before Flop (didn't bet)
Seat 5: abrm20 folded before Flop (didn't bet)
Seat 6: Pablo7-Pro folded before Flop (didn't bet)



PokerStars Hand #222945124201:  Hold'em No Limit ($0.05/$0.10 USD) - 2021/01/23 0:28:49 ET
Table 'Polydoros II' 6-max Seat #2 is the button
Seat 1: Quetlaah ($12.15 in chips) 
Seat 2: fish72o ($10.04 in chips) 
Seat 3: reznor1 ($5.11 in chips) 
Seat 4: Halfyard007 ($14.30 in chips) 
Seat 5: abrm20 ($10.40 in chips) 
Seat 6: Pablo7-Pro ($10.15 in chips) 
reznor1: posts small blind $0.05
Halfyard007: posts big blind $0.10
*** HOLE CARDS ***
abrm20: folds 
Pablo7-Pro: folds 
Quetlaah: raises $0.20 to $0.30
fish72o: folds 
reznor1: folds 
Halfyard007: folds 
Uncalled bet ($0.20) returned to Quetlaah
Quetlaah collected $0.25 from pot
Quetlaah: doesn't show hand 
*** SUMMARY ***
Total pot $0.25 | Rake $0 
Seat 1: Quetlaah collected ($0.25)
Seat 2: fish72o (button) folded before Flop (didn't bet)
Seat 3: reznor1 (small blind) folded before Flop
Seat 4: Halfyard007 (big blind) folded before Flop
Seat 5: abrm20 folded before Flop (didn't bet)
Seat 6: Pablo7-Pro folded before Flop (didn't bet)



PokerStars Hand #222945133219:  Hold'em No Limit ($0.05/$0.10 USD) - 2021/01/23 0:29:01 ET
Table 'Polydoros II' 6-max Seat #3 is the button
Seat 1: Quetlaah ($12.30 in chips) 
Seat 2: fish72o ($10.04 in chips) 
Seat 3: reznor1 ($5.06 in chips) 
Seat 4: Halfyard007 ($14.20 in chips) 
Seat 5: abrm20 ($10.40 in chips) 
Seat 6: Pablo7-Pro ($10.15 in chips) 
Halfyard007: posts small blind $0.05
abrm20: posts big blind $0.10
*** HOLE CARDS ***
Pablo7-Pro: raises $0.20 to $0.30
Quetlaah: folds 
fish72o: folds 
reznor1: folds 
Halfyard007: folds 
abrm20: calls $0.20
*** FLOP *** [5s 9s Qh]
abrm20: checks 
Pablo7-Pro: bets $0.31
abrm20: calls $0.31
*** TURN *** [5s 9s Qh] [7c]
abrm20: checks 
Pablo7-Pro: checks 
*** RIVER *** [5s 9s Qh 7c] [8c]
abrm20: bets $0.90
Pablo7-Pro: calls $0.90
*** SHOW DOWN ***
abrm20: shows [Jh Td] (a straight, Eight to Queen)
Pablo7-Pro: mucks hand 
abrm20 collected $2.93 from pot
*** SUMMARY ***
Total pot $3.07 | Rake $0.14 
Board [5s 9s Qh 7c 8c]
Seat 1: Quetlaah folded before Flop (didn't bet)
Seat 2: fish72o folded before Flop (didn't bet)
Seat 3: reznor1 (button) folded before Flop (didn't bet)
Seat 4: Halfyard007 (small blind) folded before Flop
Seat 5: abrm20 (big blind) showed [Jh Td] and won ($2.93) with a straight, Eight to Queen
Seat 6: Pablo7-Pro mucked



PokerStars Hand #222945147680:  Hold'em No Limit ($0.05/$0.10 USD) - 2021/01/23 0:29:55 ET
Table 'Polydoros II' 6-max Seat #4 is the button
Seat 1: Quetlaah ($12.30 in chips) 
Seat 2: fish72o ($10.04 in chips) 
Seat 3: reznor1 ($5.06 in chips) 
Seat 4: Halfyard007 ($14.15 in chips) 
Seat 5: abrm20 ($11.82 in chips) 
Seat 6: Pablo7-Pro ($10 in chips) 
abrm20: posts small blind $0.05
Pablo7-Pro: posts big blind $0.10
*** HOLE CARDS ***
Quetlaah: folds 
fish72o: folds 
reznor1: folds 
Halfyard007: folds 
abrm20: folds 
Uncalled bet ($0.05) returned to Pablo7-Pro
Pablo7-Pro collected $0.10 from pot
Pablo7-Pro: doesn't show hand 
*** SUMMARY ***
Total pot $0.10 | Rake $0 
Seat 1: Quetlaah folded before Flop (didn't bet)
Seat 2: fish72o folded before Flop (didn't bet)
Seat 3: reznor1 folded before Flop (didn't bet)
Seat 4: Halfyard007 (button) folded before Flop (didn't bet)
Seat 5: abrm20 (small blind) folded before Flop
Seat 6: Pablo7-Pro (big blind) collected ($0.10)



PokerStars Hand #222945150084:  Hold'em No Limit ($0.05/$0.10 USD) - 2021/01/23 0:30:04 ET
Table 'Polydoros II' 6-max Seat #5 is the button
Seat 1: Quetlaah ($12.30 in chips) 
Seat 2: fish72o ($10.04 in chips) 
Seat 3: reznor1 ($5.06 in chips) 
Seat 4: Halfyard007 ($14.15 in chips) 
Seat 5: abrm20 ($11.77 in chips) 
Seat 6: Pablo7-Pro ($10.05 in chips) 
Pablo7-Pro: posts small blind $0.05
Quetlaah: posts big blind $0.10
*** HOLE CARDS ***
fish72o: folds 
reznor1: folds 
Halfyard007: folds 
abrm20: raises $0.20 to $0.30
Pablo7-Pro: folds 
Quetlaah: folds 
Uncalled bet ($0.20) returned to abrm20
abrm20 collected $0.25 from pot
abrm20: doesn't show hand 
*** SUMMARY ***
Total pot $0.25 | Rake $0 
Seat 1: Quetlaah (big blind) folded before Flop
Seat 2: fish72o folded before Flop (didn't bet)
Seat 3: reznor1 folded before Flop (didn't bet)
Seat 4: Halfyard007 folded before Flop (didn't bet)
Seat 5: abrm20 (button) collected ($0.25)
Seat 6: Pablo7-Pro (small blind) folded before Flop



PokerStars Hand #222945153994:  Hold'em No Limit ($0.05/$0.10 USD) - 2021/01/23 0:30:18 ET
Table 'Polydoros II' 6-max Seat #6 is the button
Seat 1: Quetlaah ($12.20 in chips) 
Seat 2: fish72o ($10.04 in chips) 
Seat 3: reznor1 ($5.06 in chips) 
Seat 4: Halfyard007 ($14.15 in chips) 
Seat 5: abrm20 ($11.92 in chips) 
Seat 6: Pablo7-Pro ($10 in chips) 
Quetlaah: posts small blind $0.05
fish72o: posts big blind $0.10
*** HOLE CARDS ***
reznor1: calls $0.10
Halfyard007: folds 
abrm20: folds 
Pablo7-Pro: raises $0.40 to $0.50
Quetlaah: raises $1.20 to $1.70
fish72o: folds 
reznor1: folds 
Pablo7-Pro: folds 
Uncalled bet ($1.20) returned to Quetlaah
Quetlaah collected $1.20 from pot
Quetlaah: doesn't show hand 
*** SUMMARY ***
Total pot $1.20 | Rake $0 
Seat 1: Quetlaah (small blind) collected ($1.20)
Seat 2: fish72o (big blind) folded before Flop
Seat 3: reznor1 folded before Flop
Seat 4: Halfyard007 folded before Flop (didn't bet)
Seat 5: abrm20 folded before Flop (didn't bet)
Seat 6: Pablo7-Pro (button) folded before Flop



PokerStars Hand #222945164834:  Hold'em No Limit ($0.05/$0.10 USD) - 2021/01/23 0:30:58 ET
Table 'Polydoros II' 6-max Seat #1 is the button
Seat 1: Quetlaah ($12.90 in chips) 
Seat 2: fish72o ($10 in chips) 
Seat 3: reznor1 ($4.96 in chips) 
Seat 4: Halfyard007 ($14.15 in chips) 
Seat 5: abrm20 ($11.92 in chips) 
Seat 6: Pablo7-Pro ($10 in chips) 
fish72o: posts small blind $0.05
reznor1: posts big blind $0.10
*** HOLE CARDS ***
Halfyard007: folds 
abrm20: folds 
Pablo7-Pro: folds 
Quetlaah: folds 
fish72o: raises $0.15 to $0.25
reznor1: folds 
Uncalled bet ($0.15) returned to fish72o
fish72o collected $0.20 from pot
fish72o: doesn't show hand 
*** SUMMARY ***
Total pot $0.20 | Rake $0 
Seat 1: Quetlaah (button) folded before Flop (didn't bet)
Seat 2: fish72o (small blind) collected ($0.20)
Seat 3: reznor1 (big blind) folded before Flop
Seat 4: Halfyard007 folded before Flop (didn't bet)
Seat 5: abrm20 folded before Flop (didn't bet)
Seat 6: Pablo7-Pro folded before Flop (didn't bet)



PokerStars Hand #222945168275:  Hold'em No Limit ($0.05/$0.10 USD) - 2021/01/23 0:31:10 ET
Table 'Polydoros II' 6-max Seat #2 is the button
Seat 1: Quetlaah ($12.90 in chips) 
Seat 2: fish72o ($10.10 in chips) 
Seat 3: reznor1 ($4.86 in chips) 
Seat 4: Halfyard007 ($14.15 in chips) 
Seat 5: abrm20 ($11.92 in chips) 
Seat 6: Pablo7-Pro ($10 in chips) 
reznor1: posts small blind $0.05
Halfyard007: posts big blind $0.10
*** HOLE CARDS ***
abrm20: folds 
Pablo7-Pro: folds 
Quetlaah: folds 
fish72o: folds 
reznor1: folds 
Uncalled bet ($0.05) returned to Halfyard007
Halfyard007 collected $0.10 from pot
Halfyard007: doesn't show hand 
*** SUMMARY ***
Total pot $0.10 | Rake $0 
Seat 1: Quetlaah folded before Flop (didn't bet)
Seat 2: fish72o (button) folded before Flop (didn't bet)
Seat 3: reznor1 (small blind) folded before Flop
Seat 4: Halfyard007 (big blind) collected ($0.10)
Seat 5: abrm20 folded before Flop (didn't bet)
Seat 6: Pablo7-Pro folded before Flop (didn't bet)



PokerStars Hand #222945170846:  Hold'em No Limit ($0.05/$0.10 USD) - 2021/01/23 0:31:20 ET
Table 'Polydoros II' 6-max Seat #3 is the button
Seat 1: Quetlaah ($12.90 in chips) 
Seat 2: fish72o ($10.10 in chips) 
Seat 3: reznor1 ($4.81 in chips) 
Seat 4: Halfyard007 ($14.20 in chips) 
Seat 5: abrm20 ($11.92 in chips) 
Seat 6: Pablo7-Pro ($10 in chips) 
Halfyard007: posts small blind $0.05
abrm20: posts big blind $0.10
*** HOLE CARDS ***
Pablo7-Pro: folds 
Quetlaah: folds 
fish72o: raises $0.15 to $0.25
reznor1: folds 
Halfyard007: folds 
abrm20: folds 
Uncalled bet ($0.15) returned to fish72o
fish72o collected $0.25 from pot
fish72o: doesn't show hand 
*** SUMMARY ***
Total pot $0.25 | Rake $0 
Seat 1: Quetlaah folded before Flop (didn't bet)
Seat 2: fish72o collected ($0.25)
Seat 3: reznor1 (button) folded before Flop (didn't bet)
Seat 4: Halfyard007 (small blind) folded before Flop
Seat 5: abrm20 (big blind) folded before Flop
Seat 6: Pablo7-Pro folded before Flop (didn't bet)



PokerStars Hand #222945175083:  Hold'em No Limit ($0.05/$0.10 USD) - 2021/01/23 0:31:35 ET
Table 'Polydoros II' 6-max Seat #4 is the button
Seat 1: Quetlaah ($12.90 in chips) 
Seat 2: fish72o ($10.25 in chips) 
Seat 3: reznor1 ($4.81 in chips) 
Seat 4: Halfyard007 ($14.15 in chips) 
Seat 5: abrm20 ($11.82 in chips) 
Seat 6: Pablo7-Pro ($10 in chips) 
abrm20: posts small blind $0.05
Pablo7-Pro: posts big blind $0.10
*** HOLE CARDS ***
Quetlaah: folds 
fish72o: folds 
reznor1: folds 
Halfyard007: folds 
abrm20: folds 
Uncalled bet ($0.05) returned to Pablo7-Pro
Pablo7-Pro collected $0.10 from pot
Pablo7-Pro: doesn't show hand 
*** SUMMARY ***
Total pot $0.10 | Rake $0 
Seat 1: Quetlaah folded before Flop (didn't bet)
Seat 2: fish72o folded before Flop (didn't bet)
Seat 3: reznor1 folded before Flop (didn't bet)
Seat 4: Halfyard007 (button) folded before Flop (didn't bet)
Seat 5: abrm20 (small blind) folded before Flop
Seat 6: Pablo7-Pro (big blind) collected ($0.10)



PokerStars Hand #222945177596:  Hold'em No Limit ($0.05/$0.10 USD) - 2021/01/23 0:31:45 ET
Table 'Polydoros II' 6-max Seat #5 is the button
Seat 1: Quetlaah ($12.90 in chips) 
Seat 2: fish72o ($10.25 in chips) 
Seat 3: reznor1 ($4.81 in chips) 
Seat 4: Halfyard007 ($14.15 in chips) 
Seat 5: abrm20 ($11.77 in chips) 
Seat 6: Pablo7-Pro ($10.05 in chips) 
Pablo7-Pro: posts small blind $0.05
Quetlaah: posts big blind $0.10
*** HOLE CARDS ***
fish72o: folds 
reznor1: folds 
Halfyard007: folds 
abrm20: folds 
Pablo7-Pro: folds 
Uncalled bet ($0.05) returned to Quetlaah
Quetlaah collected $0.10 from pot
Quetlaah: doesn't show hand 
*** SUMMARY ***
Total pot $0.10 | Rake $0 
Seat 1: Quetlaah (big blind) collected ($0.10)
Seat 2: fish72o folded before Flop (didn't bet)
Seat 3: reznor1 folded before Flop (didn't bet)
Seat 4: Halfyard007 folded before Flop (didn't bet)
Seat 5: abrm20 (button) folded before Flop (didn't bet)
Seat 6: Pablo7-Pro (small blind) folded before Flop



PokerStars Hand #222945179852:  Hold'em No Limit ($0.05/$0.10 USD) - 2021/01/23 0:31:53 ET
Table 'Polydoros II' 6-max Seat #6 is the button
Seat 1: Quetlaah ($12.95 in chips) 
Seat 2: fish72o ($10.25 in chips) 
Seat 3: reznor1 ($4.81 in chips) 
Seat 4: Halfyard007 ($14.15 in chips) 
Seat 5: abrm20 ($11.77 in chips) 
Seat 6: Pablo7-Pro ($10 in chips) 
Quetlaah: posts small blind $0.05
fish72o: posts big blind $0.10
*** HOLE CARDS ***
reznor1: folds 
Halfyard007: folds 
abrm20: folds 
Pablo7-Pro: raises $0.10 to $0.20
Quetlaah: raises $0.60 to $0.80
fish72o: folds 
Pablo7-Pro: folds 
Uncalled bet ($0.60) returned to Quetlaah
Quetlaah collected $0.50 from pot
Quetlaah: doesn't show hand 
*** SUMMARY ***
Total pot $0.50 | Rake $0 
Seat 1: Quetlaah (small blind) collected ($0.50)
Seat 2: fish72o (big blind) folded before Flop
Seat 3: reznor1 folded before Flop (didn't bet)
Seat 4: Halfyard007 folded before Flop (didn't bet)
Seat 5: abrm20 folded before Flop (didn't bet)
Seat 6: Pablo7-Pro (button) folded before Flop



PokerStars Hand #222945184478:  Hold'em No Limit ($0.05/$0.10 USD) - 2021/01/23 0:32:10 ET
Table 'Polydoros II' 6-max Seat #1 is the button
Seat 1: Quetlaah ($13.25 in chips) 
Seat 2: fish72o ($10.15 in chips) 
Seat 3: reznor1 ($4.81 in chips) 
Seat 4: Halfyard007 ($14.15 in chips) 
Seat 5: abrm20 ($11.77 in chips) 
Seat 6: Pablo7-Pro ($10 in chips) 
fish72o: posts small blind $0.05
reznor1: posts big blind $0.10
*** HOLE CARDS ***
Halfyard007: folds 
abrm20: folds 
Pablo7-Pro: folds 
Quetlaah: folds 
fish72o: raises $0.15 to $0.25
reznor1: calls $0.15
*** FLOP *** [2s Ts Tc]
fish72o: bets $0.32
reznor1: calls $0.32
*** TURN *** [2s Ts Tc] [3h]
fish72o: bets $0.73
reznor1: calls $0.73
*** RIVER *** [2s Ts Tc 3h] [Jh]
fish72o: bets $1.65
reznor1: raises $1.86 to $3.51 and is all-in
fish72o: calls $1.86
*** SHOW DOWN ***
reznor1: shows [Td Ad] (three of a kind, Tens)
fish72o: shows [Th 8h] (three of a kind, Tens - lower kicker)
reznor1 collected $9.19 from pot
*** SUMMARY ***
Total pot $9.62 | Rake $0.43 
Board [2s Ts Tc 3h Jh]
Seat 1: Quetlaah (button) folded before Flop (didn't bet)
Seat 2: fish72o (small blind) showed [Th 8h] and lost with three of a kind, Tens
Seat 3: reznor1 (big blind) showed [Td Ad] and won ($9.19) with three of a kind, Tens
Seat 4: Halfyard007 folded before Flop (didn't bet)
Seat 5: abrm20 folded before Flop (didn't bet)
Seat 6: Pablo7-Pro folded before Flop (didn't bet)



PokerStars Hand #222945194616:  Hold'em No Limit ($0.05/$0.10 USD) - 2021/01/23 0:32:48 ET
Table 'Polydoros II' 6-max Seat #2 is the button
Seat 1: Quetlaah ($13.25 in chips) 
Seat 2: fish72o ($10 in chips) 
Seat 3: reznor1 ($9.19 in chips) 
Seat 4: Halfyard007 ($14.15 in chips) 
Seat 5: abrm20 ($11.77 in chips) 
Seat 6: Pablo7-Pro ($10 in chips) 
reznor1: posts small blind $0.05
Halfyard007: posts big blind $0.10
*** HOLE CARDS ***
abrm20: folds 
Pablo7-Pro: folds 
Quetlaah: raises $0.20 to $0.30
fish72o: folds 
reznor1: folds 
Halfyard007: calls $0.20
*** FLOP *** [Ad As Jc]
abrm20 leaves the table
Halfyard007: bets $0.30
Quetlaah: folds 
Uncalled bet ($0.30) returned to Halfyard007
Halfyard007 collected $0.62 from pot
Halfyard007: doesn't show hand 
*** SUMMARY ***
Total pot $0.65 | Rake $0.03 
Board [Ad As Jc]
Seat 1: Quetlaah folded on the Flop
Seat 2: fish72o (button) folded before Flop (didn't bet)
Seat 3: reznor1 (small blind) folded before Flop
Seat 4: Halfyard007 (big blind) collected ($0.62)
Seat 5: abrm20 folded before Flop (didn't bet)
Seat 6: Pablo7-Pro folded before Flop (didn't bet)



PokerStars Hand #222945201015:  Hold'em No Limit ($0.05/$0.10 USD) - 2021/01/23 0:33:11 ET
Table 'Polydoros II' 6-max Seat #3 is the button
Seat 1: Quetlaah ($12.95 in chips) 
Seat 2: fish72o ($10 in chips) 
Seat 3: reznor1 ($9.14 in chips) 
Seat 4: Halfyard007 ($14.47 in chips) 
Seat 6: Pablo7-Pro ($10 in chips) 
Halfyard007: posts small blind $0.05
Pablo7-Pro: posts big blind $0.10
*** HOLE CARDS ***
Quetlaah: folds 
JorgeLemart joins the table at seat #5 
fish72o: raises $0.15 to $0.25
reznor1: folds 
Halfyard007: calls $0.20
Pablo7-Pro: calls $0.15
*** FLOP *** [4d 5d Ah]
Halfyard007: bets $0.40
Pablo7-Pro: folds 
fish72o: folds 
Uncalled bet ($0.40) returned to Halfyard007
Halfyard007 collected $0.72 from pot
Halfyard007: doesn't show hand 
*** SUMMARY ***
Total pot $0.75 | Rake $0.03 
Board [4d 5d Ah]
Seat 1: Quetlaah folded before Flop (didn't bet)
Seat 2: fish72o folded on the Flop
Seat 3: reznor1 (button) folded before Flop (didn't bet)
Seat 4: Halfyard007 (small blind) collected ($0.72)
Seat 6: Pablo7-Pro (big blind) folded on the Flop



PokerStars Hand #222945207904:  Hold'em No Limit ($0.05/$0.10 USD) - 2021/01/23 0:33:37 ET
Table 'Polydoros II' 6-max Seat #4 is the button
Seat 1: Quetlaah ($12.95 in chips) 
Seat 2: fish72o ($10 in chips) 
Seat 3: reznor1 ($9.14 in chips) 
Seat 4: Halfyard007 ($14.94 in chips) 
Seat 6: Pablo7-Pro ($10 in chips) 
Pablo7-Pro: posts small blind $0.05
Quetlaah: posts big blind $0.10
*** HOLE CARDS ***
fish72o: folds 
reznor1: folds 
Halfyard007: folds 
Pablo7-Pro: raises $0.20 to $0.30
Quetlaah: calls $0.20
*** FLOP *** [9h 2d 3h]
Pablo7-Pro: bets $0.19
Quetlaah: calls $0.19
*** TURN *** [9h 2d 3h] [Kc]
Pablo7-Pro: checks 
Quetlaah: bets $0.26
Pablo7-Pro: folds 
Uncalled bet ($0.26) returned to Quetlaah
Quetlaah collected $0.94 from pot
Quetlaah: doesn't show hand 
*** SUMMARY ***
Total pot $0.98 | Rake $0.04 
Board [9h 2d 3h Kc]
Seat 1: Quetlaah (big blind) collected ($0.94)
Seat 2: fish72o folded before Flop (didn't bet)
Seat 3: reznor1 folded before Flop (didn't bet)
Seat 4: Halfyard007 (button) folded before Flop (didn't bet)
Seat 6: Pablo7-Pro (small blind) folded on the Turn



PokerStars Hand #222945217507:  Hold'em No Limit ($0.05/$0.10 USD) - 2021/01/23 0:34:13 ET
Table 'Polydoros II' 6-max Seat #6 is the button
Seat 1: Quetlaah ($13.40 in chips) 
Seat 2: fish72o ($10 in chips) 
Seat 3: reznor1 ($9.14 in chips) 
Seat 4: Halfyard007 ($14.94 in chips) 
Seat 5: JorgeLemart ($8 in chips) 
Seat 6: Pablo7-Pro ($10 in chips) 
Quetlaah: posts small blind $0.05
fish72o: posts big blind $0.10
JorgeLemart: posts big blind $0.10
*** HOLE CARDS ***
reznor1: calls $0.10
Halfyard007: folds 
JorgeLemart: checks 
Pablo7-Pro: folds 
Quetlaah: folds 
fish72o: checks 
*** FLOP *** [6s 4c Ah]
fish72o: checks 
reznor1: checks 
JorgeLemart: checks 
*** TURN *** [6s 4c Ah] [3c]
fish72o: checks 
reznor1: checks 
JorgeLemart: checks 
*** RIVER *** [6s 4c Ah 3c] [Kd]
fish72o: checks 
reznor1: checks 
JorgeLemart: checks 
*** SHOW DOWN ***
fish72o: shows [9s 4s] (a pair of Fours)
reznor1: mucks hand 
JorgeLemart: shows [9d Kh] (a pair of Kings)
JorgeLemart collected $0.33 from pot
*** SUMMARY ***
Total pot $0.35 | Rake $0.02 
Board [6s 4c Ah 3c Kd]
Seat 1: Quetlaah (small blind) folded before Flop
Seat 2: fish72o (big blind) showed [9s 4s] and lost with a pair of Fours
Seat 3: reznor1 mucked
Seat 4: Halfyard007 folded before Flop (didn't bet)
Seat 5: JorgeLemart showed [9d Kh] and won ($0.33) with a pair of Kings
Seat 6: Pablo7-Pro (button) folded before Flop (didn't bet)



PokerStars Hand #222945230182:  Hold'em No Limit ($0.05/$0.10 USD) - 2021/01/23 0:35:00 ET
Table 'Polydoros II' 6-max Seat #1 is the button
Seat 1: Quetlaah ($13.35 in chips) 
Seat 2: fish72o ($10 in chips) 
Seat 3: reznor1 ($9.04 in chips) 
Seat 4: Halfyard007 ($14.94 in chips) 
Seat 5: JorgeLemart ($8.23 in chips) 
Seat 6: Pablo7-Pro ($10 in chips) 
fish72o: posts small blind $0.05
reznor1: posts big blind $0.10
*** HOLE CARDS ***
Halfyard007: raises $0.20 to $0.30
JorgeLemart: folds 
Pablo7-Pro: folds 
Quetlaah: folds 
fish72o: folds 
reznor1: folds 
Uncalled bet ($0.20) returned to Halfyard007
Halfyard007 collected $0.25 from pot
Halfyard007: doesn't show hand 
*** SUMMARY ***
Total pot $0.25 | Rake $0 
Seat 1: Quetlaah (button) folded before Flop (didn't bet)
Seat 2: fish72o (small blind) folded before Flop
Seat 3: reznor1 (big blind) folded before Flop
Seat 4: Halfyard007 collected ($0.25)
Seat 5: JorgeLemart folded before Flop (didn't bet)
Seat 6: Pablo7-Pro folded before Flop (didn't bet)



PokerStars Hand #222945236324:  Hold'em No Limit ($0.05/$0.10 USD) - 2021/01/23 0:35:24 ET
Table 'Polydoros II' 6-max Seat #2 is the button
Seat 1: Quetlaah ($13.35 in chips) 
Seat 2: fish72o ($10 in chips) 
Seat 3: reznor1 ($8.94 in chips) 
Seat 4: Halfyard007 ($15.09 in chips) 
Seat 5: JorgeLemart ($8.23 in chips) 
Seat 6: Pablo7-Pro ($10 in chips) 
reznor1: posts small blind $0.05
Halfyard007: posts big blind $0.10
*** HOLE CARDS ***
JorgeLemart: folds 
Pablo7-Pro: folds 
Quetlaah: folds 
fish72o: raises $0.15 to $0.25
reznor1: calls $0.20
Halfyard007: calls $0.15
*** FLOP *** [4c 9c Jc]
reznor1: checks 
Halfyard007: checks 
fish72o: checks 
*** TURN *** [4c 9c Jc] [4s]
reznor1: bets $0.36
Halfyard007: folds 
fish72o: folds 
Uncalled bet ($0.36) returned to reznor1
reznor1 collected $0.72 from pot
*** SUMMARY ***
Total pot $0.75 | Rake $0.03 
Board [4c 9c Jc 4s]
Seat 1: Quetlaah folded before Flop (didn't bet)
Seat 2: fish72o (button) folded on the Turn
Seat 3: reznor1 (small blind) collected ($0.72)
Seat 4: Halfyard007 (big blind) folded on the Turn
Seat 5: JorgeLemart folded before Flop (didn't bet)
Seat 6: Pablo7-Pro folded before Flop (didn't bet)



PokerStars Hand #222945245062:  Hold'em No Limit ($0.05/$0.10 USD) - 2021/01/23 0:35:57 ET
Table 'Polydoros II' 6-max Seat #3 is the button
Seat 1: Quetlaah ($13.35 in chips) 
Seat 2: fish72o ($10 in chips) 
Seat 3: reznor1 ($9.41 in chips) 
Seat 4: Halfyard007 ($14.84 in chips) 
Seat 5: JorgeLemart ($8.23 in chips) 
Seat 6: Pablo7-Pro ($10 in chips) 
Halfyard007: posts small blind $0.05
JorgeLemart: posts big blind $0.10
*** HOLE CARDS ***
Pablo7-Pro: folds 
Quetlaah: folds 
fish72o: folds 
reznor1: folds 
Halfyard007: raises $0.20 to $0.30
JorgeLemart: raises $0.60 to $0.90
Halfyard007: folds 
Uncalled bet ($0.60) returned to JorgeLemart
JorgeLemart collected $0.60 from pot
JorgeLemart: doesn't show hand 
*** SUMMARY ***
Total pot $0.60 | Rake $0 
Seat 1: Quetlaah folded before Flop (didn't bet)
Seat 2: fish72o folded before Flop (didn't bet)
Seat 3: reznor1 (button) folded before Flop (didn't bet)
Seat 4: Halfyard007 (small blind) folded before Flop
Seat 5: JorgeLemart (big blind) collected ($0.60)
Seat 6: Pablo7-Pro folded before Flop (didn't bet)



PokerStars Hand #222945250211:  Hold'em No Limit ($0.05/$0.10 USD) - 2021/01/23 0:36:16 ET
Table 'Polydoros II' 6-max Seat #4 is the button
Seat 1: Quetlaah ($13.35 in chips) 
Seat 2: fish72o ($10 in chips) 
Seat 3: reznor1 ($9.41 in chips) 
Seat 4: Halfyard007 ($14.54 in chips) 
Seat 5: JorgeLemart ($8.53 in chips) 
Seat 6: Pablo7-Pro ($10 in chips) 
JorgeLemart: posts small blind $0.05
Pablo7-Pro: posts big blind $0.10
*** HOLE CARDS ***
Quetlaah: folds 
fish72o: folds 
reznor1: folds 
Halfyard007: raises $0.20 to $0.30
JorgeLemart: folds 
Pablo7-Pro: calls $0.20
*** FLOP *** [Kd 5c Qd]
Pablo7-Pro: checks 
Halfyard007: checks 
*** TURN *** [Kd 5c Qd] [4s]
Pablo7-Pro: bets $0.20
Halfyard007: calls $0.20
*** RIVER *** [Kd 5c Qd 4s] [6c]
Pablo7-Pro: checks 
Halfyard007: bets $0.30
Pablo7-Pro: folds 
Uncalled bet ($0.30) returned to Halfyard007
Halfyard007 collected $1 from pot
Halfyard007: doesn't show hand 
*** SUMMARY ***
Total pot $1.05 | Rake $0.05 
Board [Kd 5c Qd 4s 6c]
Seat 1: Quetlaah folded before Flop (didn't bet)
Seat 2: fish72o folded before Flop (didn't bet)
Seat 3: reznor1 folded before Flop (didn't bet)
Seat 4: Halfyard007 (button) collected ($1)
Seat 5: JorgeLemart (small blind) folded before Flop
Seat 6: Pablo7-Pro (big blind) folded on the River



PokerStars Hand #222945261471:  Hold'em No Limit ($0.05/$0.10 USD) - 2021/01/23 0:36:58 ET
Table 'Polydoros II' 6-max Seat #5 is the button
Seat 1: Quetlaah ($13.35 in chips) 
Seat 2: fish72o ($10 in chips) 
Seat 3: reznor1 ($9.41 in chips) 
Seat 4: Halfyard007 ($15.04 in chips) 
Seat 5: JorgeLemart ($8.48 in chips) 
Seat 6: Pablo7-Pro ($10 in chips) 
Pablo7-Pro: posts small blind $0.05
Quetlaah: posts big blind $0.10
*** HOLE CARDS ***
fish72o: folds 
reznor1: folds 
Halfyard007: folds 
JorgeLemart: folds 
Pablo7-Pro: raises $0.20 to $0.30
Quetlaah: raises $0.60 to $0.90
Pablo7-Pro: raises $1.50 to $2.40
Quetlaah: folds 
Uncalled bet ($1.50) returned to Pablo7-Pro
Pablo7-Pro collected $1.80 from pot
Pablo7-Pro: doesn't show hand 
*** SUMMARY ***
Total pot $1.80 | Rake $0 
Seat 1: Quetlaah (big blind) folded before Flop
Seat 2: fish72o folded before Flop (didn't bet)
Seat 3: reznor1 folded before Flop (didn't bet)
Seat 4: Halfyard007 folded before Flop (didn't bet)
Seat 5: JorgeLemart (button) folded before Flop (didn't bet)
Seat 6: Pablo7-Pro (small blind) collected ($1.80)



PokerStars Hand #222945268916:  Hold'em No Limit ($0.05/$0.10 USD) - 2021/01/23 0:37:26 ET
Table 'Polydoros II' 6-max Seat #6 is the button
Seat 1: Quetlaah ($12.45 in chips) 
Seat 2: fish72o ($10 in chips) 
Seat 3: reznor1 ($9.41 in chips) 
Seat 4: Halfyard007 ($15.04 in chips) 
Seat 5: JorgeLemart ($8.48 in chips) 
Seat 6: Pablo7-Pro ($10.90 in chips) 
Quetlaah: posts small blind $0.05
fish72o: posts big blind $0.10
*** HOLE CARDS ***
reznor1: calls $0.10
Halfyard007: folds 
JorgeLemart: calls $0.10
Pablo7-Pro: folds 
Quetlaah: folds 
fish72o: checks 
*** FLOP *** [8s Jc Td]
fish72o: checks 
reznor1: checks 
JorgeLemart: bets $0.33
fish72o: folds 
reznor1: calls $0.33
*** TURN *** [8s Jc Td] [9d]
reznor1: checks 
JorgeLemart: checks 
*** RIVER *** [8s Jc Td 9d] [7s]
reznor1: bets $0.96
JorgeLemart: folds 
Uncalled bet ($0.96) returned to reznor1
reznor1 collected $0.96 from pot
*** SUMMARY ***
Total pot $1.01 | Rake $0.05 
Board [8s Jc Td 9d 7s]
Seat 1: Quetlaah (small blind) folded before Flop
Seat 2: fish72o (big blind) folded on the Flop
Seat 3: reznor1 collected ($0.96)
Seat 4: Halfyard007 folded before Flop (didn't bet)
Seat 5: JorgeLemart folded on the River
Seat 6: Pablo7-Pro (button) folded before Flop (didn't bet)



PokerStars Hand #222945283843:  Hold'em No Limit ($0.05/$0.10 USD) - 2021/01/23 0:38:22 ET
Table 'Polydoros II' 6-max Seat #1 is the button
Seat 1: Quetlaah ($12.40 in chips) 
Seat 2: fish72o ($10 in chips) 
Seat 3: reznor1 ($9.94 in chips) 
Seat 4: Halfyard007 ($15.04 in chips) 
Seat 5: JorgeLemart ($8.05 in chips) 
Seat 6: Pablo7-Pro ($10.90 in chips) 
fish72o: posts small blind $0.05
reznor1: posts big blind $0.10
*** HOLE CARDS ***
Halfyard007: folds 
JorgeLemart: folds 
Pablo7-Pro: folds 
Quetlaah: raises $0.25 to $0.35
fish72o: folds 
reznor1: calls $0.25
*** FLOP *** [6h 5d Th]
reznor1: checks 
Quetlaah: bets $0.55
reznor1: folds 
Uncalled bet ($0.55) returned to Quetlaah
Quetlaah collected $0.72 from pot
Quetlaah: doesn't show hand 
*** SUMMARY ***
Total pot $0.75 | Rake $0.03 
Board [6h 5d Th]
Seat 1: Quetlaah (button) collected ($0.72)
Seat 2: fish72o (small blind) folded before Flop
Seat 3: reznor1 (big blind) folded on the Flop
Seat 4: Halfyard007 folded before Flop (didn't bet)
Seat 5: JorgeLemart folded before Flop (didn't bet)
Seat 6: Pablo7-Pro folded before Flop (didn't bet)



PokerStars Hand #222945291275:  Hold'em No Limit ($0.05/$0.10 USD) - 2021/01/23 0:38:50 ET
Table 'Polydoros II' 6-max Seat #2 is the button
Seat 1: Quetlaah ($12.77 in chips) 
Seat 2: fish72o ($10 in chips) 
Seat 3: reznor1 ($9.59 in chips) 
Seat 4: Halfyard007 ($15.04 in chips) 
Seat 5: JorgeLemart ($8.05 in chips) 
Seat 6: Pablo7-Pro ($10.90 in chips) 
reznor1: posts small blind $0.05
Halfyard007: posts big blind $0.10
*** HOLE CARDS ***
JorgeLemart is disconnected 
JorgeLemart has timed out while disconnected
JorgeLemart: folds 
Pablo7-Pro: folds 
Quetlaah: folds 
fish72o: raises $0.15 to $0.25
reznor1: folds 
Halfyard007: folds 
Uncalled bet ($0.15) returned to fish72o
fish72o collected $0.25 from pot
fish72o: doesn't show hand 
*** SUMMARY ***
Total pot $0.25 | Rake $0 
Seat 1: Quetlaah folded before Flop (didn't bet)
Seat 2: fish72o (button) collected ($0.25)
Seat 3: reznor1 (small blind) folded before Flop
Seat 4: Halfyard007 (big blind) folded before Flop
Seat 5: JorgeLemart folded before Flop (didn't bet)
Seat 6: Pablo7-Pro folded before Flop (didn't bet)



PokerStars Hand #222945297919:  Hold'em No Limit ($0.05/$0.10 USD) - 2021/01/23 0:39:16 ET
Table 'Polydoros II' 6-max Seat #3 is the button
Seat 1: Quetlaah ($12.77 in chips) 
Seat 2: fish72o ($10.15 in chips) 
Seat 3: reznor1 ($9.54 in chips) 
Seat 4: Halfyard007 ($14.94 in chips) 
Seat 6: Pablo7-Pro ($10.90 in chips) 
Halfyard007: posts small blind $0.05
Pablo7-Pro: posts big blind $0.10
*** HOLE CARDS ***
Quetlaah: folds 
fish72o: folds 
reznor1: raises $0.60 to $0.70
Halfyard007: folds 
Pablo7-Pro: folds 
Uncalled bet ($0.60) returned to reznor1
reznor1 collected $0.25 from pot
*** SUMMARY ***
Total pot $0.25 | Rake $0 
Seat 1: Quetlaah folded before Flop (didn't bet)
Seat 2: fish72o folded before Flop (didn't bet)
Seat 3: reznor1 (button) collected ($0.25)
Seat 4: Halfyard007 (small blind) folded before Flop
Seat 6: Pablo7-Pro (big blind) folded before Flop



PokerStars Hand #222944267033:  Hold'em No Limit ($0.05/$0.10 USD) - 2021/01/23 23:39:11 ET
Table 'Polydoros II' 6-max Seat #5 is the button
Seat 1: Bunkiebear ($4.59 in chips) 
Seat 2: EZEQUIEL.C10 ($10 in chips) 
Seat 3: whtocean ($11.60 in chips) 
Seat 4: images777 ($8 in chips) 
Seat 5: Ger Cortes ($11.77 in chips) 
Seat 6: Bobok1971 ($10.68 in chips) 
Bobok1971: posts small blind $0.05
Bunkiebear: posts big blind $0.10
*** HOLE CARDS ***
EZEQUIEL.C10: folds 
whtocean: folds 
images777: raises $0.10 to $0.20
Ger Cortes: folds 
Bobok1971: raises $0.10 to $0.30
Bunkiebear: calls $0.20
images777: calls $0.10
*** FLOP *** [2d As 9s]
Bobok1971: checks 
Bunkiebear: bets $0.60
images777: calls $0.60
Bobok1971: folds 
*** TURN *** [2d As 9s] [Kc]
Bunkiebear: bets $3.69 and is all-in
images777 has timed out
images777: folds 
Uncalled bet ($3.69) returned to Bunkiebear
Bunkiebear collected $2.01 from pot
Bunkiebear: doesn't show hand 
*** SUMMARY ***
Total pot $2.10 | Rake $0.09 
Board [2d As 9s Kc]
Seat 1: Bunkiebear (big blind) collected ($2.01)
Seat 2: EZEQUIEL.C10 folded before Flop (didn't bet)
Seat 3: whtocean folded before Flop (didn't bet)
Seat 4: images777 folded on the Turn
Seat 5: Ger Cortes (button) folded before Flop (didn't bet)
Seat 6: Bobok1971 (small blind) folded on the Flop



PokerStars Hand #222944289625:  Hold'em No Limit ($0.05/$0.10 USD) - 2021/01/23 23:40:26 ET
Table 'Polydoros II' 6-max Seat #6 is the button
Seat 1: Bunkiebear ($5.70 in chips) 
Seat 2: EZEQUIEL.C10 ($10 in chips) 
Seat 3: whtocean ($11.60 in chips) 
Seat 5: Ger Cortes ($11.77 in chips) 
Seat 6: Bobok1971 ($10.38 in chips) 
Bunkiebear: posts small blind $0.05
EZEQUIEL.C10: posts big blind $0.10
*** HOLE CARDS ***
whtocean: folds 
Ger Cortes: raises $0.15 to $0.25
Bobok1971: folds 
Bunkiebear: folds 
EZEQUIEL.C10: folds 
Uncalled bet ($0.15) returned to Ger Cortes
Ger Cortes collected $0.25 from pot
*** SUMMARY ***
Total pot $0.25 | Rake $0 
Seat 1: Bunkiebear (small blind) folded before Flop
Seat 2: EZEQUIEL.C10 (big blind) folded before Flop
Seat 3: whtocean folded before Flop (didn't bet)
Seat 5: Ger Cortes collected ($0.25)
Seat 6: Bobok1971 (button) folded before Flop (didn't bet)



PokerStars Hand #222944300433:  Hold'em No Limit ($0.05/$0.10 USD) - 2021/01/23 23:40:40 ET
Table 'Polydoros II' 6-max Seat #1 is the button
Seat 1: Bunkiebear ($5.65 in chips) 
Seat 2: EZEQUIEL.C10 ($9.90 in chips) 
Seat 3: whtocean ($11.60 in chips) 
Seat 5: Ger Cortes ($11.92 in chips) 
Seat 6: Bobok1971 ($10.38 in chips) 
EZEQUIEL.C10: posts small blind $0.05
whtocean: posts big blind $0.10
*** HOLE CARDS ***
Ger Cortes: raises $0.15 to $0.25
Bobok1971: folds 
Bunkiebear: folds 
EZEQUIEL.C10: folds 
whtocean: folds 
Uncalled bet ($0.15) returned to Ger Cortes
Ger Cortes collected $0.25 from pot
*** SUMMARY ***
Total pot $0.25 | Rake $0 
Seat 1: Bunkiebear (button) folded before Flop (didn't bet)
Seat 2: EZEQUIEL.C10 (small blind) folded before Flop
Seat 3: whtocean (big blind) folded before Flop
Seat 5: Ger Cortes collected ($0.25)
Seat 6: Bobok1971 folded before Flop (didn't bet)



PokerStars Hand #222944309015:  Hold'em No Limit ($0.05/$0.10 USD) - 2021/01/23 23:41:09 ET
Table 'Polydoros II' 6-max Seat #2 is the button
Seat 1: Bunkiebear ($5.65 in chips) 
Seat 2: EZEQUIEL.C10 ($9.85 in chips) 
Seat 3: whtocean ($11.50 in chips) 
Seat 5: Ger Cortes ($12.07 in chips) 
Seat 6: Bobok1971 ($10.38 in chips) 
whtocean: posts small blind $0.05
Ger Cortes: posts big blind $0.10
*** HOLE CARDS ***
Bobok1971: calls $0.10
Bunkiebear: folds 
EZEQUIEL.C10: folds 
whtocean: folds 
Ger Cortes: checks 
*** FLOP *** [9d 5h Kd]
Ger Cortes: checks 
Bobok1971: checks 
*** TURN *** [9d 5h Kd] [8s]
Ger Cortes: bets $0.18
Bobok1971: calls $0.18
*** RIVER *** [9d 5h Kd 8s] [3h]
Ger Cortes: bets $0.20
Bobok1971: calls $0.20
*** SHOW DOWN ***
Ger Cortes: shows [8d 6d] (a pair of Eights)
Bobok1971: mucks hand 
Ger Cortes collected $0.96 from pot
images777 leaves the table
*** SUMMARY ***
Total pot $1.01 | Rake $0.05 
Board [9d 5h Kd 8s 3h]
Seat 1: Bunkiebear folded before Flop (didn't bet)
Seat 2: EZEQUIEL.C10 (button) folded before Flop (didn't bet)
Seat 3: whtocean (small blind) folded before Flop
Seat 5: Ger Cortes (big blind) showed [8d 6d] and won ($0.96) with a pair of Eights
Seat 6: Bobok1971 mucked



PokerStars Hand #222944322230:  Hold'em No Limit ($0.05/$0.10 USD) - 2021/01/23 23:41:53 ET
Table 'Polydoros II' 6-max Seat #3 is the button
Seat 1: Bunkiebear ($5.65 in chips) 
Seat 2: EZEQUIEL.C10 ($9.85 in chips) 
Seat 3: whtocean ($11.45 in chips) 
Seat 5: Ger Cortes ($12.55 in chips) 
Seat 6: Bobok1971 ($9.90 in chips) 
Ger Cortes: posts small blind $0.05
Bobok1971: posts big blind $0.10
*** HOLE CARDS ***
Bunkiebear: calls $0.10
EZEQUIEL.C10: folds 
Gulch1 joins the table at seat #4 
whtocean: folds 
Ger Cortes: calls $0.05
Bobok1971: checks 
*** FLOP *** [Tc Ts 5c]
Ger Cortes: checks 
Bobok1971: checks 
Bunkiebear: bets $0.20
Ger Cortes: folds 
Bobok1971: folds 
Uncalled bet ($0.20) returned to Bunkiebear
Bunkiebear collected $0.29 from pot
Bunkiebear: doesn't show hand 
*** SUMMARY ***
Total pot $0.30 | Rake $0.01 
Board [Tc Ts 5c]
Seat 1: Bunkiebear collected ($0.29)
Seat 2: EZEQUIEL.C10 folded before Flop (didn't bet)
Seat 3: whtocean (button) folded before Flop (didn't bet)
Seat 5: Ger Cortes (small blind) folded on the Flop
Seat 6: Bobok1971 (big blind) folded on the Flop



PokerStars Hand #222944334906:  Hold'em No Limit ($0.05/$0.10 USD) - 2021/01/23 23:42:35 ET
Table 'Polydoros II' 6-max Seat #5 is the button
Seat 1: Bunkiebear ($5.84 in chips) 
Seat 2: EZEQUIEL.C10 ($9.85 in chips) 
Seat 3: whtocean ($11.45 in chips) 
Seat 4: Gulch1 ($10 in chips) 
Seat 5: Ger Cortes ($12.45 in chips) 
Seat 6: Bobok1971 ($9.80 in chips) 
Bobok1971: posts small blind $0.05
Bunkiebear: posts big blind $0.10
Gulch1: posts big blind $0.10
*** HOLE CARDS ***
EZEQUIEL.C10: folds 
whtocean: folds 
Gulch1: checks 
Ger Cortes: raises $0.30 to $0.40
Bobok1971 is disconnected 
Bobok1971 is connected 
Bobok1971 has timed out
Bobok1971: folds 
Bunkiebear: calls $0.30
Gulch1: calls $0.30
*** FLOP *** [Qd 4d 4s]
Bunkiebear: checks 
Gulch1: checks 
Ger Cortes: bets $0.39
Bunkiebear: folds 
Bobok1971 is disconnected 
Gulch1: folds 
Uncalled bet ($0.39) returned to Ger Cortes
Ger Cortes collected $1.19 from pot
*** SUMMARY ***
Total pot $1.25 | Rake $0.06 
Board [Qd 4d 4s]
Seat 1: Bunkiebear (big blind) folded on the Flop
Seat 2: EZEQUIEL.C10 folded before Flop (didn't bet)
Seat 3: whtocean folded before Flop (didn't bet)
Seat 4: Gulch1 folded on the Flop
Seat 5: Ger Cortes (button) collected ($1.19)
Seat 6: Bobok1971 (small blind) folded before Flop



PokerStars Hand #222944357056:  Hold'em No Limit ($0.05/$0.10 USD) - 2021/01/23 23:43:49 ET
Table 'Polydoros II' 6-max Seat #1 is the button
Seat 1: Bunkiebear ($5.44 in chips) 
Seat 2: EZEQUIEL.C10 ($9.85 in chips) 
Seat 3: whtocean ($11.45 in chips) 
Seat 4: Gulch1 ($9.60 in chips) 
Seat 5: Ger Cortes ($13.24 in chips) 
EZEQUIEL.C10: posts small blind $0.05
whtocean: posts big blind $0.10
*** HOLE CARDS ***
Gulch1: raises $0.20 to $0.30
Ger Cortes: folds 
Bunkiebear: folds 
EZEQUIEL.C10: folds 
whtocean: calls $0.20
*** FLOP *** [4h Qc 6h]
whtocean: checks 
Gulch1: bets $0.40
whtocean: calls $0.40
*** TURN *** [4h Qc 6h] [3h]
whtocean: checks 
Gulch1: checks 
*** RIVER *** [4h Qc 6h 3h] [As]
whtocean: checks 
Gulch1: bets $1.50
whtocean: folds 
Uncalled bet ($1.50) returned to Gulch1
Gulch1 collected $1.38 from pot
Gulch1: doesn't show hand 
*** SUMMARY ***
Total pot $1.45 | Rake $0.07 
Board [4h Qc 6h 3h As]
Seat 1: Bunkiebear (button) folded before Flop (didn't bet)
Seat 2: EZEQUIEL.C10 (small blind) folded before Flop
Seat 3: whtocean (big blind) folded on the River
Seat 4: Gulch1 collected ($1.38)
Seat 5: Ger Cortes folded before Flop (didn't bet)



PokerStars Hand #222944367589:  Hold'em No Limit ($0.05/$0.10 USD) - 2021/01/23 23:44:25 ET
Table 'Polydoros II' 6-max Seat #2 is the button
Seat 1: Bunkiebear ($5.44 in chips) 
Seat 2: EZEQUIEL.C10 ($9.80 in chips) 
Seat 3: whtocean ($10.75 in chips) 
Seat 4: Gulch1 ($10.28 in chips) 
Seat 5: Ger Cortes ($13.24 in chips) 
whtocean: posts small blind $0.05
Gulch1: posts big blind $0.10
*** HOLE CARDS ***
Ger Cortes: folds 
Bunkiebear: folds 
EZEQUIEL.C10: folds 
whtocean: folds 
Uncalled bet ($0.05) returned to Gulch1
Gulch1 collected $0.10 from pot
Gulch1: doesn't show hand 
*** SUMMARY ***
Total pot $0.10 | Rake $0 
Seat 1: Bunkiebear folded before Flop (didn't bet)
Seat 2: EZEQUIEL.C10 (button) folded before Flop (didn't bet)
Seat 3: whtocean (small blind) folded before Flop
Seat 4: Gulch1 (big blind) collected ($0.10)
Seat 5: Ger Cortes folded before Flop (didn't bet)



PokerStars Hand #222944370603:  Hold'em No Limit ($0.05/$0.10 USD) - 2021/01/23 23:44:35 ET
Table 'Polydoros II' 6-max Seat #3 is the button
Seat 1: Bunkiebear ($5.44 in chips) 
Seat 2: EZEQUIEL.C10 ($9.80 in chips) 
Seat 3: whtocean ($10.70 in chips) 
Seat 4: Gulch1 ($10.33 in chips) 
Seat 5: Ger Cortes ($13.24 in chips) 
Gulch1: posts small blind $0.05
Ger Cortes: posts big blind $0.10
*** HOLE CARDS ***
Bunkiebear: folds 
EZEQUIEL.C10: raises $0.20 to $0.30
whtocean: folds 
Gulch1: folds 
Ger Cortes: folds 
Uncalled bet ($0.20) returned to EZEQUIEL.C10
EZEQUIEL.C10 collected $0.25 from pot
EZEQUIEL.C10: doesn't show hand 
*** SUMMARY ***
Total pot $0.25 | Rake $0 
Seat 1: Bunkiebear folded before Flop (didn't bet)
Seat 2: EZEQUIEL.C10 collected ($0.25)
Seat 3: whtocean (button) folded before Flop (didn't bet)
Seat 4: Gulch1 (small blind) folded before Flop
Seat 5: Ger Cortes (big blind) folded before Flop



PokerStars Hand #222944374310:  Hold'em No Limit ($0.05/$0.10 USD) - 2021/01/23 23:44:47 ET
Table 'Polydoros II' 6-max Seat #4 is the button
Seat 1: Bunkiebear ($5.44 in chips) 
Seat 2: EZEQUIEL.C10 ($9.95 in chips) 
Seat 3: whtocean ($10.70 in chips) 
Seat 4: Gulch1 ($10.28 in chips) 
Seat 5: Ger Cortes ($13.14 in chips) 
Ger Cortes: posts small blind $0.05
Bunkiebear: posts big blind $0.10
*** HOLE CARDS ***
EZEQUIEL.C10: folds 
whtocean: folds 
Gulch1: calls $0.10
Ger Cortes: calls $0.05
Bunkiebear: checks 
*** FLOP *** [4s 5h Qs]
Ger Cortes: checks 
Bunkiebear: checks 
Gulch1: bets $0.29
Ger Cortes: calls $0.29
Bunkiebear: folds 
*** TURN *** [4s 5h Qs] [8c]
Ger Cortes: checks 
Gulch1: bets $0.70
Ger Cortes: calls $0.70
*** RIVER *** [4s 5h Qs 8c] [9h]
Ger Cortes: checks 
Gulch1: bets $2.18
Ger Cortes: folds 
Uncalled bet ($2.18) returned to Gulch1
Gulch1 collected $2.18 from pot
*** SUMMARY ***
Total pot $2.28 | Rake $0.10 
Board [4s 5h Qs 8c 9h]
Seat 1: Bunkiebear (big blind) folded on the Flop
Seat 2: EZEQUIEL.C10 folded before Flop (didn't bet)
Seat 3: whtocean folded before Flop (didn't bet)
Seat 4: Gulch1 (button) collected ($2.18)
Seat 5: Ger Cortes (small blind) folded on the River



PokerStars Hand #222944401507:  Hold'em No Limit ($0.05/$0.10 USD) - 2021/01/23 23:46:19 ET
Table 'Polydoros II' 6-max Seat #5 is the button
Seat 1: Bunkiebear ($5.34 in chips) 
Seat 2: EZEQUIEL.C10 ($9.95 in chips) 
Seat 3: whtocean ($10.70 in chips) 
Seat 4: Gulch1 ($11.37 in chips) 
Seat 5: Ger Cortes ($12.05 in chips) 
Bunkiebear: posts small blind $0.05
EZEQUIEL.C10: posts big blind $0.10
*** HOLE CARDS ***
whtocean: folds 
Gulch1 has timed out
Gulch1: folds 
Ger Cortes has timed out
Ger Cortes: folds 
Bunkiebear: calls $0.05
EZEQUIEL.C10: checks 
*** FLOP *** [Qd Th Ks]
Bunkiebear: checks 
Ger Cortes is disconnected 
EZEQUIEL.C10: checks 
*** TURN *** [Qd Th Ks] [5s]
Bunkiebear: checks 
EZEQUIEL.C10: checks 
*** RIVER *** [Qd Th Ks 5s] [5h]
Bunkiebear: checks 
EZEQUIEL.C10: checks 
*** SHOW DOWN ***
Bunkiebear: shows [8h 7s] (a pair of Fives)
EZEQUIEL.C10: shows [4d 3d] (a pair of Fives)
Bunkiebear collected $0.10 from pot
EZEQUIEL.C10 collected $0.09 from pot
*** SUMMARY ***
Total pot $0.20 | Rake $0.01 
Board [Qd Th Ks 5s 5h]
Seat 1: Bunkiebear (small blind) showed [8h 7s] and won ($0.10) with a pair of Fives
Seat 2: EZEQUIEL.C10 (big blind) showed [4d 3d] and won ($0.09) with a pair of Fives
Seat 3: whtocean folded before Flop (didn't bet)
Seat 4: Gulch1 folded before Flop (didn't bet)
Seat 5: Ger Cortes (button) folded before Flop (didn't bet)



PokerStars Hand #222944421078:  Hold'em No Limit ($0.05/$0.10 USD) - 2021/01/23 23:47:25 ET
Table 'Polydoros II' 6-max Seat #1 is the button
Seat 1: Bunkiebear ($5.34 in chips) 
Seat 2: EZEQUIEL.C10 ($9.94 in chips) 
Seat 3: whtocean ($10.70 in chips) 
Seat 4: Gulch1 ($11.37 in chips) 
EZEQUIEL.C10: posts small blind $0.05
whtocean: posts big blind $0.10
*** HOLE CARDS ***
Gulch1: folds 
Bunkiebear: folds 
EZEQUIEL.C10: folds 
Uncalled bet ($0.05) returned to whtocean
whtocean collected $0.10 from pot
whtocean: doesn't show hand 
*** SUMMARY ***
Total pot $0.10 | Rake $0 
Seat 1: Bunkiebear (button) folded before Flop (didn't bet)
Seat 2: EZEQUIEL.C10 (small blind) folded before Flop
Seat 3: whtocean (big blind) collected ($0.10)
Seat 4: Gulch1 folded before Flop (didn't bet)



PokerStars Hand #222944425347:  Hold'em No Limit ($0.05/$0.10 USD) - 2021/01/23 23:47:39 ET
Table 'Polydoros II' 6-max Seat #2 is the button
Seat 1: Bunkiebear ($5.34 in chips) 
Seat 2: EZEQUIEL.C10 ($9.89 in chips) 
Seat 3: whtocean ($10.75 in chips) 
Seat 4: Gulch1 ($11.37 in chips) 
whtocean: posts small blind $0.05
Gulch1: posts big blind $0.10
*** HOLE CARDS ***
Bunkiebear: folds 
EZEQUIEL.C10: raises $0.15 to $0.25
whtocean: folds 
Gulch1: calls $0.15
*** FLOP *** [Ah 6d Th]
Gulch1: checks 
EZEQUIEL.C10: checks 
*** TURN *** [Ah 6d Th] [8s]
Gulch1: bets $0.53
EZEQUIEL.C10: folds 
Uncalled bet ($0.53) returned to Gulch1
Gulch1 collected $0.53 from pot
Gulch1: doesn't show hand 
*** SUMMARY ***
Total pot $0.55 | Rake $0.02 
Board [Ah 6d Th 8s]
Seat 1: Bunkiebear folded before Flop (didn't bet)
Seat 2: EZEQUIEL.C10 (button) folded on the Turn
Seat 3: whtocean (small blind) folded before Flop
Seat 4: Gulch1 (big blind) collected ($0.53)



PokerStars Hand #222944433905:  Hold'em No Limit ($0.05/$0.10 USD) - 2021/01/23 23:48:08 ET
Table 'Polydoros II' 6-max Seat #3 is the button
Seat 1: Bunkiebear ($5.34 in chips) 
Seat 2: EZEQUIEL.C10 ($9.64 in chips) 
Seat 3: whtocean ($10.70 in chips) 
Seat 4: Gulch1 ($11.65 in chips) 
Gulch1: posts small blind $0.05
Bunkiebear: posts big blind $0.10
*** HOLE CARDS ***
EZEQUIEL.C10: folds 
whtocean: folds 
Gulch1: calls $0.05
Bunkiebear: checks 
*** FLOP *** [7h Qc 4d]
Gulch1: bets $0.20
Bunkiebear: calls $0.20
*** TURN *** [7h Qc 4d] [8s]
Gulch1: checks 
Bunkiebear: checks 
*** RIVER *** [7h Qc 4d 8s] [6s]
Gulch1: bets $1
Bunkiebear: raises $1 to $2
Gulch1: calls $1
*** SHOW DOWN ***
Bunkiebear: shows [5d 4c] (a straight, Four to Eight)
Gulch1: shows [4s 5h] (a straight, Four to Eight)
Gulch1 collected $2.20 from pot
Bunkiebear collected $2.19 from pot
*** SUMMARY ***
Total pot $4.60 | Rake $0.21 
Board [7h Qc 4d 8s 6s]
Seat 1: Bunkiebear (big blind) showed [5d 4c] and won ($2.19) with a straight, Four to Eight
Seat 2: EZEQUIEL.C10 folded before Flop (didn't bet)
Seat 3: whtocean (button) folded before Flop (didn't bet)
Seat 4: Gulch1 (small blind) showed [4s 5h] and won ($2.20) with a straight, Four to Eight



PokerStars Hand #222944448823:  Hold'em No Limit ($0.05/$0.10 USD) - 2021/01/23 23:48:58 ET
Table 'Polydoros II' 6-max Seat #4 is the button
Seat 1: Bunkiebear ($5.23 in chips) 
Seat 2: EZEQUIEL.C10 ($9.64 in chips) 
Seat 3: whtocean ($10.70 in chips) 
Seat 4: Gulch1 ($11.55 in chips) 
Bunkiebear: posts small blind $0.05
EZEQUIEL.C10: posts big blind $0.10
*** HOLE CARDS ***
whtocean: raises $0.15 to $0.25
Gulch1: calls $0.25
Bunkiebear: folds 
EZEQUIEL.C10: folds 
*** FLOP *** [4h 7d 3d]
whtocean: checks 
Gulch1: bets $0.31
whtocean: folds 
Uncalled bet ($0.31) returned to Gulch1
Gulch1 collected $0.62 from pot
Gulch1: doesn't show hand 
*** SUMMARY ***
Total pot $0.65 | Rake $0.03 
Board [4h 7d 3d]
Seat 1: Bunkiebear (small blind) folded before Flop
Seat 2: EZEQUIEL.C10 (big blind) folded before Flop
Seat 3: whtocean folded on the Flop
Seat 4: Gulch1 (button) collected ($0.62)



PokerStars Hand #222944455669:  Hold'em No Limit ($0.05/$0.10 USD) - 2021/01/23 23:49:21 ET
Table 'Polydoros II' 6-max Seat #1 is the button
Seat 1: Bunkiebear ($5.18 in chips) 
Seat 2: EZEQUIEL.C10 ($9.54 in chips) 
Seat 3: whtocean ($10.45 in chips) 
Seat 4: Gulch1 ($11.92 in chips) 
EZEQUIEL.C10: posts small blind $0.05
whtocean: posts big blind $0.10
*** HOLE CARDS ***
Gulch1: calls $0.10
Bunkiebear: folds 
EZEQUIEL.C10: calls $0.05
whtocean: checks 
*** FLOP *** [2c 2h 8c]
EZEQUIEL.C10: checks 
whtocean: bets $0.15
Gulch1: folds 
EZEQUIEL.C10: folds 
Uncalled bet ($0.15) returned to whtocean
whtocean collected $0.29 from pot
whtocean: doesn't show hand 
*** SUMMARY ***
Total pot $0.30 | Rake $0.01 
Board [2c 2h 8c]
Seat 1: Bunkiebear (button) folded before Flop (didn't bet)
Seat 2: EZEQUIEL.C10 (small blind) folded on the Flop
Seat 3: whtocean (big blind) collected ($0.29)
Seat 4: Gulch1 folded on the Flop



PokerStars Hand #222944463888:  Hold'em No Limit ($0.05/$0.10 USD) - 2021/01/23 23:49:49 ET
Table 'Polydoros II' 6-max Seat #2 is the button
Seat 1: Bunkiebear ($5.18 in chips) 
Seat 2: EZEQUIEL.C10 ($9.44 in chips) 
Seat 3: whtocean ($10.64 in chips) 
Seat 4: Gulch1 ($11.82 in chips) 
whtocean: posts small blind $0.05
Gulch1: posts big blind $0.10
*** HOLE CARDS ***
Bunkiebear: calls $0.10
EZEQUIEL.C10: folds 
whtocean: folds 
Gulch1: checks 
*** FLOP *** [Ad Qh Ac]
Gulch1: bets $0.10
Bunkiebear: raises $0.10 to $0.20
Gulch1: folds 
Uncalled bet ($0.10) returned to Bunkiebear
Bunkiebear collected $0.43 from pot
Bunkiebear: doesn't show hand 
*** SUMMARY ***
Total pot $0.45 | Rake $0.02 
Board [Ad Qh Ac]
Seat 1: Bunkiebear collected ($0.43)
Seat 2: EZEQUIEL.C10 (button) folded before Flop (didn't bet)
Seat 3: whtocean (small blind) folded before Flop
Seat 4: Gulch1 (big blind) folded on the Flop



PokerStars Hand #222944469347:  Hold'em No Limit ($0.05/$0.10 USD) - 2021/01/23 23:50:08 ET
Table 'Polydoros II' 6-max Seat #3 is the button
Seat 1: Bunkiebear ($5.41 in chips) 
Seat 2: EZEQUIEL.C10 ($9.44 in chips) 
Seat 3: whtocean ($10.59 in chips) 
Seat 4: Gulch1 ($11.62 in chips) 
Gulch1: posts small blind $0.05
Bunkiebear: posts big blind $0.10
*** HOLE CARDS ***
EZEQUIEL.C10: folds 
whtocean: raises $0.15 to $0.25
Gulch1: folds 
Bunkiebear: folds 
Uncalled bet ($0.15) returned to whtocean
whtocean collected $0.25 from pot
whtocean: doesn't show hand 
*** SUMMARY ***
Total pot $0.25 | Rake $0 
Seat 1: Bunkiebear (big blind) folded before Flop
Seat 2: EZEQUIEL.C10 folded before Flop (didn't bet)
Seat 3: whtocean (button) collected ($0.25)
Seat 4: Gulch1 (small blind) folded before Flop



PokerStars Hand #222944472716:  Hold'em No Limit ($0.05/$0.10 USD) - 2021/01/23 23:50:20 ET
Table 'Polydoros II' 6-max Seat #4 is the button
Seat 1: Bunkiebear ($5.31 in chips) 
Seat 2: EZEQUIEL.C10 ($9.44 in chips) 
Seat 3: whtocean ($10.74 in chips) 
Seat 4: Gulch1 ($11.57 in chips) 
Bunkiebear: posts small blind $0.05
EZEQUIEL.C10: posts big blind $0.10
*** HOLE CARDS ***
whtocean: folds 
Gulch1: raises $0.10 to $0.20
Bunkiebear: raises $0.10 to $0.30
EZEQUIEL.C10: folds 
Gulch1: calls $0.10
*** FLOP *** [8c 4s 6d]
Bunkiebear: bets $0.30
Gulch1: folds 
Uncalled bet ($0.30) returned to Bunkiebear
Bunkiebear collected $0.67 from pot
Bunkiebear: doesn't show hand 
*** SUMMARY ***
Total pot $0.70 | Rake $0.03 
Board [8c 4s 6d]
Seat 1: Bunkiebear (small blind) collected ($0.67)
Seat 2: EZEQUIEL.C10 (big blind) folded before Flop
Seat 3: whtocean folded before Flop (didn't bet)
Seat 4: Gulch1 (button) folded on the Flop



PokerStars Hand #222944478484:  Hold'em No Limit ($0.05/$0.10 USD) - 2021/01/23 23:50:39 ET
Table 'Polydoros II' 6-max Seat #1 is the button
Seat 1: Bunkiebear ($5.68 in chips) 
Seat 2: EZEQUIEL.C10 ($9.34 in chips) 
Seat 3: whtocean ($10.74 in chips) 
Seat 4: Gulch1 ($11.27 in chips) 
EZEQUIEL.C10: posts small blind $0.05
whtocean: posts big blind $0.10
*** HOLE CARDS ***
Gulch1: raises $0.10 to $0.20
Bunkiebear: calls $0.20
EZEQUIEL.C10: folds 
whtocean: calls $0.10
*** FLOP *** [Qc Qh 2c]
whtocean: checks 
Gulch1: checks 
Bunkiebear: checks 
*** TURN *** [Qc Qh 2c] [As]
whtocean: checks 
Gulch1: checks 
Bunkiebear: checks 
*** RIVER *** [Qc Qh 2c As] [9h]
whtocean: checks 
Gulch1: checks 
Bunkiebear: checks 
*** SHOW DOWN ***
whtocean: shows [6s 4c] (a pair of Queens)
Gulch1: shows [Td Jd] (a pair of Queens - Ace+Jack kicker)
Bunkiebear: shows [7c Kc] (a pair of Queens - Ace+King kicker)
Bunkiebear collected $0.62 from pot
*** SUMMARY ***
Total pot $0.65 | Rake $0.03 
Board [Qc Qh 2c As 9h]
Seat 1: Bunkiebear (button) showed [7c Kc] and won ($0.62) with a pair of Queens
Seat 2: EZEQUIEL.C10 (small blind) folded before Flop
Seat 3: whtocean (big blind) showed [6s 4c] and lost with a pair of Queens
Seat 4: Gulch1 showed [Td Jd] and lost with a pair of Queens



PokerStars Hand #222944488317:  Hold'em No Limit ($0.05/$0.10 USD) - 2021/01/23 23:51:13 ET
Table 'Polydoros II' 6-max Seat #2 is the button
Seat 1: Bunkiebear ($6.10 in chips) 
Seat 2: EZEQUIEL.C10 ($9.29 in chips) 
Seat 3: whtocean ($10.54 in chips) 
Seat 4: Gulch1 ($11.07 in chips) 
whtocean: posts small blind $0.05
Gulch1: posts big blind $0.10
*** HOLE CARDS ***
Bunkiebear: calls $0.10
EZEQUIEL.C10: folds 
whtocean: raises $0.25 to $0.35
Gulch1: calls $0.25
Bunkiebear: folds 
*** FLOP *** [3d Ah Qc]
whtocean: checks 
Gulch1: bets $0.38
whtocean: calls $0.38
*** TURN *** [3d Ah Qc] [Qd]
whtocean: checks 
Gulch1: bets $1.49
whtocean: calls $1.49
*** RIVER *** [3d Ah Qc Qd] [3s]
whtocean: checks 
Gulch1: checks 
*** SHOW DOWN ***
whtocean: shows [Qs Kc] (a full house, Queens full of Threes)
Gulch1: mucks hand 
whtocean collected $4.34 from pot
*** SUMMARY ***
Total pot $4.54 | Rake $0.20 
Board [3d Ah Qc Qd 3s]
Seat 1: Bunkiebear folded before Flop
Seat 2: EZEQUIEL.C10 (button) folded before Flop (didn't bet)
Seat 3: whtocean (small blind) showed [Qs Kc] and won ($4.34) with a full house, Queens full of Threes
Seat 4: Gulch1 (big blind) mucked



PokerStars Hand #222944510302:  Hold'em No Limit ($0.05/$0.10 USD) - 2021/01/23 23:52:28 ET
Table 'Polydoros II' 6-max Seat #3 is the button
Seat 1: Bunkiebear ($6 in chips) 
Seat 2: EZEQUIEL.C10 ($9.29 in chips) 
Seat 3: whtocean ($12.66 in chips) 
Seat 4: Gulch1 ($8.85 in chips) 
Gulch1: posts small blind $0.05
Bunkiebear: posts big blind $0.10
*** HOLE CARDS ***
EZEQUIEL.C10: folds 
whtocean: folds 
Gulch1: folds 
Uncalled bet ($0.05) returned to Bunkiebear
Gulch1 leaves the table
Bunkiebear collected $0.10 from pot
Bobok1971 was removed from the table for failing to post
Bobok1971 leaves the table
Bunkiebear: doesn't show hand 
*** SUMMARY ***
Total pot $0.10 | Rake $0 
Seat 1: Bunkiebear (big blind) collected ($0.10)
Seat 2: EZEQUIEL.C10 folded before Flop (didn't bet)
Seat 3: whtocean (button) folded before Flop (didn't bet)
Seat 4: Gulch1 (small blind) folded before Flop



PokerStars Hand #222944513232:  Hold'em No Limit ($0.05/$0.10 USD) - 2021/01/23 23:52:39 ET
Table 'Polydoros II' 6-max Seat #1 is the button
Seat 1: Bunkiebear ($6.05 in chips) 
Seat 2: EZEQUIEL.C10 ($9.29 in chips) 
Seat 3: whtocean ($12.66 in chips) 
EZEQUIEL.C10: posts small blind $0.05
whtocean: posts big blind $0.10
*** HOLE CARDS ***
Bunkiebear: folds 
EZEQUIEL.C10: raises $0.20 to $0.30
whtocean: raises $0.60 to $0.90
EZEQUIEL.C10: folds 
Uncalled bet ($0.60) returned to whtocean
whtocean collected $0.60 from pot
whtocean: doesn't show hand 
*** SUMMARY ***
Total pot $0.60 | Rake $0 
Seat 1: Bunkiebear (button) folded before Flop (didn't bet)
Seat 2: EZEQUIEL.C10 (small blind) folded before Flop
Seat 3: whtocean (big blind) collected ($0.60)



PokerStars Hand #222944518808:  Hold'em No Limit ($0.05/$0.10 USD) - 2021/01/23 23:52:58 ET
Table 'Polydoros II' 6-max Seat #2 is the button
Seat 1: Bunkiebear ($6.05 in chips) 
Seat 2: EZEQUIEL.C10 ($8.99 in chips) 
Seat 3: whtocean ($12.96 in chips) 
whtocean: posts small blind $0.05
Bunkiebear: posts big blind $0.10
*** HOLE CARDS ***
EZEQUIEL.C10: raises $0.10 to $0.20
whtocean: folds 
Bunkiebear: calls $0.10
*** FLOP *** [Ac 4c Ts]
Bunkiebear: checks 
EZEQUIEL.C10: checks 
*** TURN *** [Ac 4c Ts] [Kc]
Bunkiebear: bets $0.20
EZEQUIEL.C10: calls $0.20
*** RIVER *** [Ac 4c Ts Kc] [8d]
Bunkiebear: bets $0.50
EZEQUIEL.C10: folds 
Uncalled bet ($0.50) returned to Bunkiebear
Bunkiebear collected $0.81 from pot
Bunkiebear: doesn't show hand 
*** SUMMARY ***
Total pot $0.85 | Rake $0.04 
Board [Ac 4c Ts Kc 8d]
Seat 1: Bunkiebear (big blind) collected ($0.81)
Seat 2: EZEQUIEL.C10 (button) folded on the River
Seat 3: whtocean (small blind) folded before Flop



PokerStars Hand #222944533691:  Hold'em No Limit ($0.05/$0.10 USD) - 2021/01/23 23:53:49 ET
Table 'Polydoros II' 6-max Seat #1 is the button
Seat 1: Bunkiebear ($6.46 in chips) 
Seat 3: whtocean ($12.91 in chips) 
Bunkiebear: posts small blind $0.05
EZEQUIEL.C10: is sitting out 
whtocean: posts big blind $0.10
*** HOLE CARDS ***
Bunkiebear: calls $0.05
whtocean: checks 
*** FLOP *** [3s 4d 6s]
whtocean: checks 
Bunkiebear: checks 
*** TURN *** [3s 4d 6s] [4s]
whtocean: checks 
Bunkiebear: bets $0.40
whtocean: folds 
Uncalled bet ($0.40) returned to Bunkiebear
Bunkiebear collected $0.19 from pot
Ger Cortes was removed from the table for failing to post
Ger Cortes leaves the table
Bunkiebear: doesn't show hand 
*** SUMMARY ***
Total pot $0.20 | Rake $0.01 
Board [3s 4d 6s 4s]
Seat 1: Bunkiebear (button) (small blind) collected ($0.19)
Seat 3: whtocean (big blind) folded on the Turn



PokerStars Hand #222944545121:  Hold'em No Limit ($0.05/$0.10 USD) - 2021/01/23 23:54:29 ET
Table 'Polydoros II' 6-max Seat #3 is the button
Seat 1: Bunkiebear ($6.55 in chips) 
Seat 3: whtocean ($12.81 in chips) 
whtocean: posts small blind $0.05
Bunkiebear: posts big blind $0.10
*** HOLE CARDS ***
whtocean: raises $0.15 to $0.25
Bunkiebear: calls $0.15
*** FLOP *** [Js Kd 7s]
Bunkiebear: checks 
whtocean: bets $0.31
Bunkiebear: folds 
Uncalled bet ($0.31) returned to whtocean
whtocean collected $0.48 from pot
whtocean: doesn't show hand 
*** SUMMARY ***
Total pot $0.50 | Rake $0.02 
Board [Js Kd 7s]
Seat 1: Bunkiebear (big blind) folded on the Flop
Seat 3: whtocean (button) (small blind) collected ($0.48)



PokerStars Hand #222944552074:  Hold'em No Limit ($0.05/$0.10 USD) - 2021/01/23 23:54:41 ET
Table 'Polydoros II' 6-max Seat #1 is the button
Seat 1: Bunkiebear ($6.30 in chips) 
Seat 3: whtocean ($13.04 in chips) 
Bunkiebear: posts small blind $0.05
whtocean: posts big blind $0.10
*** HOLE CARDS ***
Bunkiebear: folds 
Uncalled bet ($0.05) returned to whtocean
whtocean collected $0.10 from pot
whtocean: doesn't show hand 
*** SUMMARY ***
Total pot $0.10 | Rake $0 
Seat 1: Bunkiebear (button) (small blind) folded before Flop
Seat 3: whtocean (big blind) collected ($0.10)



PokerStars Hand #222944553307:  Hold'em No Limit ($0.05/$0.10 USD) - 2021/01/23 23:54:45 ET
Table 'Polydoros II' 6-max Seat #3 is the button
Seat 1: Bunkiebear ($6.25 in chips) 
Seat 3: whtocean ($13.09 in chips) 
whtocean: posts small blind $0.05
Bunkiebear: posts big blind $0.10
*** HOLE CARDS ***
whtocean: raises $0.15 to $0.25
Bunkiebear: folds 
Uncalled bet ($0.15) returned to whtocean
whtocean collected $0.20 from pot
whtocean: doesn't show hand 
*** SUMMARY ***
Total pot $0.20 | Rake $0 
Seat 1: Bunkiebear (big blind) folded before Flop
Seat 3: whtocean (button) (small blind) collected ($0.20)



PokerStars Hand #222944554799:  Hold'em No Limit ($0.05/$0.10 USD) - 2021/01/23 23:54:50 ET
Table 'Polydoros II' 6-max Seat #1 is the button
Seat 1: Bunkiebear ($6.15 in chips) 
Seat 3: whtocean ($13.19 in chips) 
Bunkiebear: posts small blind $0.05
whtocean: posts big blind $0.10
*** HOLE CARDS ***
Bunkiebear: calls $0.05
whtocean: raises $0.25 to $0.35
Bunkiebear: folds 
Uncalled bet ($0.25) returned to whtocean
whtocean collected $0.20 from pot
whtocean: doesn't show hand 
*** SUMMARY ***
Total pot $0.20 | Rake $0 
Seat 1: Bunkiebear (button) (small blind) folded before Flop
Seat 3: whtocean (big blind) collected ($0.20)



PokerStars Hand #222944557071:  Hold'em No Limit ($0.05/$0.10 USD) - 2021/01/23 23:54:58 ET
Table 'Polydoros II' 6-max Seat #3 is the button
Seat 1: Bunkiebear ($6.05 in chips) 
Seat 3: whtocean ($13.29 in chips) 
whtocean: posts small blind $0.05
Bunkiebear: posts big blind $0.10
*** HOLE CARDS ***
whtocean: raises $0.15 to $0.25
Bunkiebear: calls $0.15
*** FLOP *** [3h 3s 9d]
Bunkiebear: checks 
whtocean: bets $0.17
Bunkiebear: calls $0.17
*** TURN *** [3h 3s 9d] [4s]
Bunkiebear: checks 
whtocean: checks 
*** RIVER *** [3h 3s 9d 4s] [Ac]
Bunkiebear: checks 
whtocean: bets $0.20
Bunkiebear: calls $0.20
*** SHOW DOWN ***
whtocean: shows [Ad 5c] (two pair, Aces and Threes)
Bunkiebear: mucks hand 
whtocean collected $1.18 from pot
*** SUMMARY ***
Total pot $1.24 | Rake $0.06 
Board [3h 3s 9d 4s Ac]
Seat 1: Bunkiebear (big blind) mucked
Seat 3: whtocean (button) (small blind) showed [Ad 5c] and won ($1.18) with two pair, Aces and Threes



PokerStars Hand #222944562582:  Hold'em No Limit ($0.05/$0.10 USD) - 2021/01/23 23:55:21 ET
Table 'Polydoros II' 6-max Seat #1 is the button
Seat 1: Bunkiebear ($5.43 in chips) 
Seat 3: whtocean ($13.85 in chips) 
Bunkiebear: posts small blind $0.05
whtocean: posts big blind $0.10
*** HOLE CARDS ***
Bunkiebear: folds 
Uncalled bet ($0.05) returned to whtocean
whtocean collected $0.10 from pot
whtocean: doesn't show hand 
*** SUMMARY ***
Total pot $0.10 | Rake $0 
Seat 1: Bunkiebear (button) (small blind) folded before Flop
Seat 3: whtocean (big blind) collected ($0.10)



PokerStars Hand #222944563522:  Hold'em No Limit ($0.05/$0.10 USD) - 2021/01/23 23:55:25 ET
Table 'Polydoros II' 6-max Seat #3 is the button
Seat 1: Bunkiebear ($5.38 in chips) 
Seat 3: whtocean ($13.90 in chips) 
whtocean: posts small blind $0.05
Bunkiebear: posts big blind $0.10
*** HOLE CARDS ***
whtocean: raises $0.15 to $0.25
Bunkiebear: calls $0.15
*** FLOP *** [Kc Ks 8d]
Bunkiebear: checks 
whtocean: checks 
*** TURN *** [Kc Ks 8d] [Th]
Bunkiebear: checks 
whtocean: bets $0.25
Bunkiebear: calls $0.25
*** RIVER *** [Kc Ks 8d Th] [2s]
Bunkiebear: checks 
whtocean: bets $0.34
Bunkiebear: calls $0.34
*** SHOW DOWN ***
whtocean: shows [Td Js] (two pair, Kings and Tens)
Bunkiebear: mucks hand 
whtocean collected $1.60 from pot
*** SUMMARY ***
Total pot $1.68 | Rake $0.08 
Board [Kc Ks 8d Th 2s]
Seat 1: Bunkiebear (big blind) mucked
Seat 3: whtocean (button) (small blind) showed [Td Js] and won ($1.60) with two pair, Kings and Tens



PokerStars Hand #222944570492:  Hold'em No Limit ($0.05/$0.10 USD) - 2021/01/23 23:55:57 ET
Table 'Polydoros II' 6-max Seat #1 is the button
Seat 1: Bunkiebear ($4.54 in chips) 
Seat 3: whtocean ($14.66 in chips) 
Bunkiebear: posts small blind $0.05
whtocean: posts big blind $0.10
*** HOLE CARDS ***
Bunkiebear: calls $0.05
whtocean: checks 
*** FLOP *** [Ks Kd 7h]
whtocean: checks 
Bunkiebear: checks 
*** TURN *** [Ks Kd 7h] [5c]
whtocean: bets $0.10
Bunkiebear: calls $0.10
*** RIVER *** [Ks Kd 7h 5c] [Js]
whtocean: checks 
abrm20 joins the table at seat #5 
Bunkiebear: checks 
*** SHOW DOWN ***
whtocean: shows [3h 5d] (two pair, Kings and Fives)
Bunkiebear: mucks hand 
whtocean collected $0.38 from pot
*** SUMMARY ***
Total pot $0.40 | Rake $0.02 
Board [Ks Kd 7h 5c Js]
Seat 1: Bunkiebear (button) (small blind) mucked
Seat 3: whtocean (big blind) showed [3h 5d] and won ($0.38) with two pair, Kings and Fives



PokerStars Hand #222944575011:  Hold'em No Limit ($0.05/$0.10 USD) - 2021/01/23 23:56:18 ET
Table 'Polydoros II' 6-max Seat #1 is the button
Seat 1: Bunkiebear ($4.34 in chips) 
Seat 3: whtocean ($14.84 in chips) 
Seat 5: abrm20 ($10 in chips) 
whtocean: posts small blind $0.05
abrm20: posts big blind $0.10
*** HOLE CARDS ***
Bunkiebear: calls $0.10
whtocean: raises $0.25 to $0.35
abrm20: calls $0.25
Bunkiebear: folds 
*** FLOP *** [Qh As 7c]
whtocean: bets $0.40
abrm20: calls $0.40
*** TURN *** [Qh As 7c] [9d]
whtocean: bets $0.99
EZEQUIEL.C10 leaves the table
abrm20: folds 
Uncalled bet ($0.99) returned to whtocean
whtocean collected $1.53 from pot
whtocean: doesn't show hand 
*** SUMMARY ***
Total pot $1.60 | Rake $0.07 
Board [Qh As 7c 9d]
Seat 1: Bunkiebear (button) folded before Flop
Seat 3: whtocean (small blind) collected ($1.53)
Seat 5: abrm20 (big blind) folded on the Turn



PokerStars Hand #222944582539:  Hold'em No Limit ($0.05/$0.10 USD) - 2021/01/23 23:56:52 ET
Table 'Polydoros II' 6-max Seat #3 is the button
Seat 1: Bunkiebear ($4.24 in chips) 
Seat 3: whtocean ($15.62 in chips) 
Seat 5: abrm20 ($9.25 in chips) 
abrm20: posts small blind $0.05
Bunkiebear: posts big blind $0.10
*** HOLE CARDS ***
whtocean: folds 
abrm20: raises $0.15 to $0.25
Bunkiebear: calls $0.15
*** FLOP *** [2d 9c 5c]
abrm20: checks 
Bunkiebear: checks 
*** TURN *** [2d 9c 5c] [7h]
abrm20: checks 
Bunkiebear: checks 
*** RIVER *** [2d 9c 5c 7h] [4d]
abrm20: checks 
Bunkiebear: checks 
*** SHOW DOWN ***
abrm20: shows [3h 3s] (a pair of Threes)
Bunkiebear: shows [Ac 7d] (a pair of Sevens)
Bunkiebear collected $0.48 from pot
*** SUMMARY ***
Total pot $0.50 | Rake $0.02 
Board [2d 9c 5c 7h 4d]
Seat 1: Bunkiebear (big blind) showed [Ac 7d] and won ($0.48) with a pair of Sevens
Seat 3: whtocean (button) folded before Flop (didn't bet)
Seat 5: abrm20 (small blind) showed [3h 3s] and lost with a pair of Threes



PokerStars Hand #222944588610:  Hold'em No Limit ($0.05/$0.10 USD) - 2021/01/23 23:57:20 ET
Table 'Polydoros II' 6-max Seat #5 is the button
Seat 1: Bunkiebear ($4.47 in chips) 
Seat 3: whtocean ($15.62 in chips) 
Seat 5: abrm20 ($9 in chips) 
Bunkiebear: posts small blind $0.05
whtocean: posts big blind $0.10
*** HOLE CARDS ***
abrm20: folds 
Bunkiebear: calls $0.05
whtocean: checks 
*** FLOP *** [8h 2s 3s]
Bunkiebear: checks 
Monterrey S joins the table at seat #2 
whtocean: bets $0.10
Bunkiebear: calls $0.10
*** TURN *** [8h 2s 3s] [3h]
Bunkiebear: checks 
whtocean: bets $0.25
Bunkiebear: folds 
Uncalled bet ($0.25) returned to whtocean
whtocean collected $0.38 from pot
whtocean: doesn't show hand 
*** SUMMARY ***
Total pot $0.40 | Rake $0.02 
Board [8h 2s 3s 3h]
Seat 1: Bunkiebear (small blind) folded on the Turn
Seat 3: whtocean (big blind) collected ($0.38)
Seat 5: abrm20 (button) folded before Flop (didn't bet)



PokerStars Hand #222944593444:  Hold'em No Limit ($0.05/$0.10 USD) - 2021/01/23 23:57:43 ET
Table 'Polydoros II' 6-max Seat #1 is the button
Seat 1: Bunkiebear ($4.27 in chips) 
Seat 3: whtocean ($15.80 in chips) 
Seat 5: abrm20 ($9 in chips) 
whtocean: posts small blind $0.05
abrm20: posts big blind $0.10
*** HOLE CARDS ***
Bunkiebear: calls $0.10
whtocean: raises $0.25 to $0.35
abrm20: folds 
Bunkiebear: calls $0.25
*** FLOP *** [Js Th 9d]
whtocean: bets $0.57
Bunkiebear: calls $0.57
*** TURN *** [Js Th 9d] [As]
whtocean: checks 
Bunkiebear: bets $0.50
whtocean: calls $0.50
*** RIVER *** [Js Th 9d As] [6s]
whtocean: checks 
Bunkiebear: bets $1.70
whtocean: folds 
Uncalled bet ($1.70) returned to Bunkiebear
Bunkiebear collected $2.81 from pot
Bunkiebear: doesn't show hand 
*** SUMMARY ***
Total pot $2.94 | Rake $0.13 
Board [Js Th 9d As 6s]
Seat 1: Bunkiebear (button) collected ($2.81)
Seat 3: whtocean (small blind) folded on the River
Seat 5: abrm20 (big blind) folded before Flop



PokerStars Hand #222944602640:  Hold'em No Limit ($0.05/$0.10 USD) - 2021/01/23 23:58:25 ET
Table 'Polydoros II' 6-max Seat #3 is the button
Seat 1: Bunkiebear ($5.66 in chips) 
Seat 3: whtocean ($14.38 in chips) 
Seat 5: abrm20 ($8.90 in chips) 
abrm20: posts small blind $0.05
Bunkiebear: posts big blind $0.10
Monterrey S: sits out 
*** HOLE CARDS ***
whtocean: folds 
abrm20: raises $0.15 to $0.25
Bunkiebear: calls $0.15
*** FLOP *** [9s 6h 4d]
abrm20: bets $0.40
Bunkiebear: calls $0.40
*** TURN *** [9s 6h 4d] [5c]
abrm20: checks 
Bunkiebear: checks 
*** RIVER *** [9s 6h 4d 5c] [8c]
abrm20: checks 
Bunkiebear: checks 
*** SHOW DOWN ***
abrm20: shows [5s Ah] (a pair of Fives)
Bunkiebear: shows [6d As] (a pair of Sixes)
Bunkiebear collected $1.24 from pot
*** SUMMARY ***
Total pot $1.30 | Rake $0.06 
Board [9s 6h 4d 5c 8c]
Seat 1: Bunkiebear (big blind) showed [6d As] and won ($1.24) with a pair of Sixes
Seat 3: whtocean (button) folded before Flop (didn't bet)
Seat 5: abrm20 (small blind) showed [5s Ah] and lost with a pair of Fives



PokerStars Hand #222944608681:  Hold'em No Limit ($0.05/$0.10 USD) - 2021/01/23 23:58:53 ET
Table 'Polydoros II' 6-max Seat #5 is the button
Seat 1: Bunkiebear ($6.25 in chips) 
Seat 2: Monterrey S ($10 in chips) 
Seat 3: whtocean ($14.38 in chips) 
Seat 5: abrm20 ($8.25 in chips) 
Bunkiebear: posts small blind $0.05
Monterrey S: posts big blind $0.10
*** HOLE CARDS ***
whtocean: folds 
abrm20: folds 
Bunkiebear: calls $0.05
Monterrey S: raises $0.25 to $0.35
Bunkiebear: folds 
Uncalled bet ($0.25) returned to Monterrey S
Monterrey S collected $0.20 from pot
Monterrey S: doesn't show hand 
*** SUMMARY ***
Total pot $0.20 | Rake $0 
Seat 1: Bunkiebear (small blind) folded before Flop
Seat 2: Monterrey S (big blind) collected ($0.20)
Seat 3: whtocean folded before Flop (didn't bet)
Seat 5: abrm20 (button) folded before Flop (didn't bet)



PokerStars Hand #222944612329:  Hold'em No Limit ($0.05/$0.10 USD) - 2021/01/23 23:59:09 ET
Table 'Polydoros II' 6-max Seat #1 is the button
Seat 1: Bunkiebear ($6.15 in chips) 
Seat 2: Monterrey S ($10.10 in chips) 
Seat 3: whtocean ($14.38 in chips) 
Seat 5: abrm20 ($8.25 in chips) 
Monterrey S: posts small blind $0.05
whtocean: posts big blind $0.10
*** HOLE CARDS ***
abrm20: raises $0.20 to $0.30
Bunkiebear: calls $0.30
Monterrey S: folds 
Halfyard007 joins the table at seat #4 
whtocean: folds 
*** FLOP *** [7d Jc Jh]
abrm20: checks 
gresscrack joins the table at seat #6 
Bunkiebear: bets $0.40
abrm20: folds 
Uncalled bet ($0.40) returned to Bunkiebear
Bunkiebear collected $0.72 from pot
Bunkiebear: doesn't show hand 
*** SUMMARY ***
Total pot $0.75 | Rake $0.03 
Board [7d Jc Jh]
Seat 1: Bunkiebear (button) collected ($0.72)
Seat 2: Monterrey S (small blind) folded before Flop
Seat 3: whtocean (big blind) folded before Flop
Seat 5: abrm20 folded on the Flop



PokerStars Hand #222944618282:  Hold'em No Limit ($0.05/$0.10 USD) - 2021/01/23 23:59:37 ET
Table 'Polydoros II' 6-max Seat #2 is the button
Seat 1: Bunkiebear ($6.57 in chips) 
Seat 2: Monterrey S ($10.05 in chips) 
Seat 3: whtocean ($14.28 in chips) 
Seat 4: Halfyard007 ($10 in chips) 
Seat 5: abrm20 ($7.95 in chips) 
whtocean: posts small blind $0.05
Halfyard007: posts big blind $0.10
gresscrack: sits out 
*** HOLE CARDS ***
abrm20: folds 
Bunkiebear: calls $0.10
Monterrey S: folds 
whtocean: folds 
Halfyard007: checks 
*** FLOP *** [8d 4s 8c]
Halfyard007: bets $0.20
Bunkiebear: calls $0.20
*** TURN *** [8d 4s 8c] [Qs]
Halfyard007: checks 
Bunkiebear: checks 
*** RIVER *** [8d 4s 8c Qs] [6s]
Halfyard007: checks 
Bunkiebear: checks 
*** SHOW DOWN ***
Halfyard007: shows [9d 6d] (two pair, Eights and Sixes)
Bunkiebear: mucks hand 
Halfyard007 collected $0.62 from pot
*** SUMMARY ***
Total pot $0.65 | Rake $0.03 
Board [8d 4s 8c Qs 6s]
Seat 1: Bunkiebear mucked
Seat 2: Monterrey S (button) folded before Flop (didn't bet)
Seat 3: whtocean (small blind) folded before Flop
Seat 4: Halfyard007 (big blind) showed [9d 6d] and won ($0.62) with two pair, Eights and Sixes
Seat 5: abrm20 folded before Flop (didn't bet)



PokerStars Hand #222946244232:  Hold'em No Limit ($0.05/$0.10 USD) - 2021/01/23 1:42:04 ET
Table 'Polydoros II' 6-max Seat #6 is the button
Seat 1: Romeo rus89 ($10.09 in chips) 
Seat 2: fish72o ($10.75 in chips) 
Seat 3: reznor1 ($13.41 in chips) 
Seat 4: MooHas10961 ($9.90 in chips) 
Seat 6: Pablo7-Pro ($14.80 in chips) 
Romeo rus89: posts small blind $0.05
fish72o: posts big blind $0.10
*** HOLE CARDS ***
reznor1: folds 
MooHas10961 has timed out
MooHas10961: folds 
Pablo7-Pro: folds 
Romeo rus89: raises $0.15 to $0.25
fish72o: calls $0.15
*** FLOP *** [7h 7d 2s]
Romeo rus89: checks 
fish72o: checks 
*** TURN *** [7h 7d 2s] [9s]
Romeo rus89: checks 
fish72o: checks 
*** RIVER *** [7h 7d 2s 9s] [Kd]
Romeo rus89: checks 
fish72o: checks 
*** SHOW DOWN ***
Romeo rus89: shows [Ad Js] (a pair of Sevens)
fish72o: mucks hand 
Romeo rus89 collected $0.48 from pot
*** SUMMARY ***
Total pot $0.50 | Rake $0.02 
Board [7h 7d 2s 9s Kd]
Seat 1: Romeo rus89 (small blind) showed [Ad Js] and won ($0.48) with a pair of Sevens
Seat 2: fish72o (big blind) mucked
Seat 3: reznor1 folded before Flop (didn't bet)
Seat 4: MooHas10961 folded before Flop (didn't bet)
Seat 6: Pablo7-Pro (button) folded before Flop (didn't bet)



PokerStars Hand #222946254737:  Hold'em No Limit ($0.05/$0.10 USD) - 2021/01/23 1:42:48 ET
Table 'Polydoros II' 6-max Seat #1 is the button
Seat 1: Romeo rus89 ($10.32 in chips) 
Seat 2: fish72o ($10.50 in chips) 
Seat 3: reznor1 ($13.41 in chips) 
Seat 4: MooHas10961 ($9.90 in chips) 
Seat 6: Pablo7-Pro ($14.80 in chips) 
fish72o: posts small blind $0.05
reznor1: posts big blind $0.10
12311985: sits out 
*** HOLE CARDS ***
MooHas10961: folds 
Pablo7-Pro: folds 
Romeo rus89: folds 
fish72o: raises $0.15 to $0.25
reznor1: calls $0.15
*** FLOP *** [7c 3d 4d]
fish72o: bets $0.16
reznor1: raises $0.16 to $0.32
fish72o: folds 
Uncalled bet ($0.16) returned to reznor1
reznor1 collected $0.78 from pot
*** SUMMARY ***
Total pot $0.82 | Rake $0.04 
Board [7c 3d 4d]
Seat 1: Romeo rus89 (button) folded before Flop (didn't bet)
Seat 2: fish72o (small blind) folded on the Flop
Seat 3: reznor1 (big blind) collected ($0.78)
Seat 4: MooHas10961 folded before Flop (didn't bet)
Seat 6: Pablo7-Pro folded before Flop (didn't bet)



PokerStars Hand #222946262038:  Hold'em No Limit ($0.05/$0.10 USD) - 2021/01/23 1:43:19 ET
Table 'Polydoros II' 6-max Seat #2 is the button
Seat 1: Romeo rus89 ($10.32 in chips) 
Seat 2: fish72o ($10.09 in chips) 
Seat 3: reznor1 ($13.78 in chips) 
Seat 4: MooHas10961 ($9.90 in chips) 
Seat 6: Pablo7-Pro ($14.80 in chips) 
reznor1: posts small blind $0.05
MooHas10961: posts big blind $0.10
12311985: sits out 
*** HOLE CARDS ***
Pablo7-Pro: raises $0.20 to $0.30
Romeo rus89: folds 
fish72o: folds 
reznor1: folds 
MooHas10961: calls $0.20
*** FLOP *** [4s 8s 7h]
MooHas10961: checks 
Pablo7-Pro: checks 
*** TURN *** [4s 8s 7h] [4c]
MooHas10961: checks 
Pablo7-Pro: checks 
*** RIVER *** [4s 8s 7h 4c] [8h]
MooHas10961: checks 
Pablo7-Pro: checks 
*** SHOW DOWN ***
MooHas10961: shows [9c 3c] (two pair, Eights and Fours)
Pablo7-Pro: shows [Qc Jh] (two pair, Eights and Fours - Queen kicker)
Pablo7-Pro collected $0.62 from pot
*** SUMMARY ***
Total pot $0.65 | Rake $0.03 
Board [4s 8s 7h 4c 8h]
Seat 1: Romeo rus89 folded before Flop (didn't bet)
Seat 2: fish72o (button) folded before Flop (didn't bet)
Seat 3: reznor1 (small blind) folded before Flop
Seat 4: MooHas10961 (big blind) showed [9c 3c] and lost with two pair, Eights and Fours
Seat 6: Pablo7-Pro showed [Qc Jh] and won ($0.62) with two pair, Eights and Fours



PokerStars Hand #222946270904:  Hold'em No Limit ($0.05/$0.10 USD) - 2021/01/23 1:43:56 ET
Table 'Polydoros II' 6-max Seat #3 is the button
Seat 1: Romeo rus89 ($10.32 in chips) 
Seat 2: fish72o ($10.09 in chips) 
Seat 3: reznor1 ($13.73 in chips) 
Seat 4: MooHas10961 ($9.60 in chips) 
Seat 5: 12311985 ($11.76 in chips) 
Seat 6: Pablo7-Pro ($15.12 in chips) 
MooHas10961: posts small blind $0.05
12311985: posts big blind $0.10
*** HOLE CARDS ***
Pablo7-Pro: folds 
Romeo rus89: folds 
fish72o: folds 
reznor1: calls $0.10
MooHas10961: calls $0.05
12311985: checks 
*** FLOP *** [Kc 6s Kd]
MooHas10961: checks 
12311985: checks 
reznor1: checks 
*** TURN *** [Kc 6s Kd] [4h]
MooHas10961: checks 
12311985: checks 
reznor1: checks 
*** RIVER *** [Kc 6s Kd 4h] [9c]
MooHas10961: checks 
12311985: checks 
reznor1: checks 
*** SHOW DOWN ***
MooHas10961: shows [6c 9h] (two pair, Kings and Nines)
12311985: mucks hand 
reznor1: mucks hand 
MooHas10961 collected $0.29 from pot
*** SUMMARY ***
Total pot $0.30 | Rake $0.01 
Board [Kc 6s Kd 4h 9c]
Seat 1: Romeo rus89 folded before Flop (didn't bet)
Seat 2: fish72o folded before Flop (didn't bet)
Seat 3: reznor1 (button) mucked
Seat 4: MooHas10961 (small blind) showed [6c 9h] and won ($0.29) with two pair, Kings and Nines
Seat 5: 12311985 (big blind) mucked
Seat 6: Pablo7-Pro folded before Flop (didn't bet)



PokerStars Hand #222946285168:  Hold'em No Limit ($0.05/$0.10 USD) - 2021/01/23 1:44:57 ET
Table 'Polydoros II' 6-max Seat #4 is the button
Seat 1: Romeo rus89 ($10.32 in chips) 
Seat 2: fish72o ($10.09 in chips) 
Seat 3: reznor1 ($13.63 in chips) 
Seat 4: MooHas10961 ($9.79 in chips) 
Seat 5: 12311985 ($11.66 in chips) 
Seat 6: Pablo7-Pro ($15.12 in chips) 
12311985: posts small blind $0.05
Pablo7-Pro: posts big blind $0.10
*** HOLE CARDS ***
Romeo rus89: folds 
fish72o: folds 
reznor1: calls $0.10
MooHas10961: folds 
12311985: folds 
Pablo7-Pro: checks 
*** FLOP *** [Qs 4s Th]
Pablo7-Pro: checks 
reznor1: checks 
*** TURN *** [Qs 4s Th] [Kc]
Pablo7-Pro: checks 
reznor1: bets $0.10
Pablo7-Pro: calls $0.10
*** RIVER *** [Qs 4s Th Kc] [9s]
Pablo7-Pro: checks 
reznor1: checks 
*** SHOW DOWN ***
Pablo7-Pro: shows [5c As] (high card Ace)
reznor1: shows [2s 2h] (a pair of Deuces)
reznor1 collected $0.43 from pot
*** SUMMARY ***
Total pot $0.45 | Rake $0.02 
Board [Qs 4s Th Kc 9s]
Seat 1: Romeo rus89 folded before Flop (didn't bet)
Seat 2: fish72o folded before Flop (didn't bet)
Seat 3: reznor1 showed [2s 2h] and won ($0.43) with a pair of Deuces
Seat 4: MooHas10961 (button) folded before Flop (didn't bet)
Seat 5: 12311985 (small blind) folded before Flop
Seat 6: Pablo7-Pro (big blind) showed [5c As] and lost with high card Ace



PokerStars Hand #222946295729:  Hold'em No Limit ($0.05/$0.10 USD) - 2021/01/23 1:45:42 ET
Table 'Polydoros II' 6-max Seat #5 is the button
Seat 1: Romeo rus89 ($10.32 in chips) 
Seat 2: fish72o ($10.09 in chips) 
Seat 3: reznor1 ($13.86 in chips) 
Seat 4: MooHas10961 ($9.79 in chips) 
Seat 5: 12311985 ($11.61 in chips) 
Seat 6: Pablo7-Pro ($14.92 in chips) 
Pablo7-Pro: posts small blind $0.05
Romeo rus89: posts big blind $0.10
*** HOLE CARDS ***
fish72o: folds 
reznor1: folds 
MooHas10961: folds 
12311985: folds 
Pablo7-Pro: folds 
Uncalled bet ($0.05) returned to Romeo rus89
Romeo rus89 collected $0.10 from pot
Romeo rus89: doesn't show hand 
*** SUMMARY ***
Total pot $0.10 | Rake $0 
Seat 1: Romeo rus89 (big blind) collected ($0.10)
Seat 2: fish72o folded before Flop (didn't bet)
Seat 3: reznor1 folded before Flop (didn't bet)
Seat 4: MooHas10961 folded before Flop (didn't bet)
Seat 5: 12311985 (button) folded before Flop (didn't bet)
Seat 6: Pablo7-Pro (small blind) folded before Flop



PokerStars Hand #222946299833:  Hold'em No Limit ($0.05/$0.10 USD) - 2021/01/23 1:45:59 ET
Table 'Polydoros II' 6-max Seat #6 is the button
Seat 1: Romeo rus89 ($10.37 in chips) 
Seat 2: fish72o ($10.09 in chips) 
Seat 3: reznor1 ($13.86 in chips) 
Seat 4: MooHas10961 ($9.79 in chips) 
Seat 5: 12311985 ($11.61 in chips) 
Seat 6: Pablo7-Pro ($14.87 in chips) 
Romeo rus89: posts small blind $0.05
fish72o: posts big blind $0.10
*** HOLE CARDS ***
reznor1: folds 
MooHas10961: folds 
12311985: folds 
Pablo7-Pro: folds 
Romeo rus89: folds 
Uncalled bet ($0.05) returned to fish72o
fish72o collected $0.10 from pot
fish72o: doesn't show hand 
*** SUMMARY ***
Total pot $0.10 | Rake $0 
Seat 1: Romeo rus89 (small blind) folded before Flop
Seat 2: fish72o (big blind) collected ($0.10)
Seat 3: reznor1 folded before Flop (didn't bet)
Seat 4: MooHas10961 folded before Flop (didn't bet)
Seat 5: 12311985 folded before Flop (didn't bet)
Seat 6: Pablo7-Pro (button) folded before Flop (didn't bet)



PokerStars Hand #222946302598:  Hold'em No Limit ($0.05/$0.10 USD) - 2021/01/23 1:46:11 ET
Table 'Polydoros II' 6-max Seat #1 is the button
Seat 1: Romeo rus89 ($10.32 in chips) 
Seat 2: fish72o ($10.14 in chips) 
Seat 3: reznor1 ($13.86 in chips) 
Seat 4: MooHas10961 ($9.79 in chips) 
Seat 5: 12311985 ($11.61 in chips) 
Seat 6: Pablo7-Pro ($14.87 in chips) 
fish72o: posts small blind $0.05
reznor1: posts big blind $0.10
*** HOLE CARDS ***
MooHas10961: calls $0.10
12311985: folds 
Pablo7-Pro: folds 
Romeo rus89: raises $0.25 to $0.35
fish72o: folds 
reznor1: calls $0.25
MooHas10961: raises $0.25 to $0.60
Romeo rus89: calls $0.25
reznor1: calls $0.25
*** FLOP *** [2s Tc As]
reznor1: bets $0.53
MooHas10961: raises $0.53 to $1.06
Romeo rus89: folds 
reznor1: calls $0.53
*** TURN *** [2s Tc As] [8s]
reznor1: bets $1.90
MooHas10961: calls $1.90
*** RIVER *** [2s Tc As 8s] [Th]
reznor1: bets $3.71
MooHas10961: raises $2.52 to $6.23 and is all-in
reznor1: calls $2.52
*** SHOW DOWN ***
MooHas10961: shows [Qh Ac] (two pair, Aces and Tens)
reznor1: shows [9s Ts] (a flush, Ace high)
reznor1 collected $19.32 from pot
*** SUMMARY ***
Total pot $20.23 | Rake $0.91 
Board [2s Tc As 8s Th]
Seat 1: Romeo rus89 (button) folded on the Flop
Seat 2: fish72o (small blind) folded before Flop
Seat 3: reznor1 (big blind) showed [9s Ts] and won ($19.32) with a flush, Ace high
Seat 4: MooHas10961 showed [Qh Ac] and lost with two pair, Aces and Tens
Seat 5: 12311985 folded before Flop (didn't bet)
Seat 6: Pablo7-Pro folded before Flop (didn't bet)



PokerStars Hand #222946316147:  Hold'em No Limit ($0.05/$0.10 USD) - 2021/01/23 1:47:09 ET
Table 'Polydoros II' 6-max Seat #2 is the button
Seat 1: Romeo rus89 ($9.72 in chips) 
Seat 2: fish72o ($10.09 in chips) 
Seat 3: reznor1 ($23.39 in chips) 
Seat 5: 12311985 ($11.61 in chips) 
Seat 6: Pablo7-Pro ($14.87 in chips) 
reznor1: posts small blind $0.05
12311985: posts big blind $0.10
*** HOLE CARDS ***
Pablo7-Pro: folds 
Romeo rus89: raises $0.15 to $0.25
fish72o: folds 
MooHas10961 leaves the table
reznor1: folds 
12311985: folds 
Uncalled bet ($0.15) returned to Romeo rus89
Romeo rus89 collected $0.25 from pot
*** SUMMARY ***
Total pot $0.25 | Rake $0 
Seat 1: Romeo rus89 collected ($0.25)
Seat 2: fish72o (button) folded before Flop (didn't bet)
Seat 3: reznor1 (small blind) folded before Flop
Seat 5: 12311985 (big blind) folded before Flop
Seat 6: Pablo7-Pro folded before Flop (didn't bet)



PokerStars Hand #222946319650:  Hold'em No Limit ($0.05/$0.10 USD) - 2021/01/23 1:47:24 ET
Table 'Polydoros II' 6-max Seat #3 is the button
Seat 1: Romeo rus89 ($9.87 in chips) 
Seat 2: fish72o ($10.09 in chips) 
Seat 3: reznor1 ($23.34 in chips) 
Seat 5: 12311985 ($11.51 in chips) 
Seat 6: Pablo7-Pro ($14.87 in chips) 
12311985: posts small blind $0.05
Pablo7-Pro: posts big blind $0.10
*** HOLE CARDS ***
Romeo rus89: folds 
fish72o: raises $0.15 to $0.25
reznor1: folds 
12311985: folds 
Pablo7-Pro: raises $0.55 to $0.80
1212387 joins the table at seat #4 
fish72o: folds 
Uncalled bet ($0.55) returned to Pablo7-Pro
Pablo7-Pro collected $0.55 from pot
Pablo7-Pro: doesn't show hand 
*** SUMMARY ***
Total pot $0.55 | Rake $0 
Seat 1: Romeo rus89 folded before Flop (didn't bet)
Seat 2: fish72o folded before Flop
Seat 3: reznor1 (button) folded before Flop (didn't bet)
Seat 5: 12311985 (small blind) folded before Flop
Seat 6: Pablo7-Pro (big blind) collected ($0.55)



PokerStars Hand #222946325701:  Hold'em No Limit ($0.05/$0.10 USD) - 2021/01/23 1:47:50 ET
Table 'Polydoros II' 6-max Seat #5 is the button
Seat 1: Romeo rus89 ($9.87 in chips) 
Seat 2: fish72o ($10 in chips) 
Seat 3: reznor1 ($23.34 in chips) 
Seat 5: 12311985 ($11.46 in chips) 
Seat 6: Pablo7-Pro ($15.17 in chips) 
Pablo7-Pro: posts small blind $0.05
Romeo rus89: posts big blind $0.10
1212387: sits out 
*** HOLE CARDS ***
fish72o: folds 
reznor1: folds 
12311985: folds 
Pablo7-Pro: folds 
Uncalled bet ($0.05) returned to Romeo rus89
Romeo rus89 collected $0.10 from pot
*** SUMMARY ***
Total pot $0.10 | Rake $0 
Seat 1: Romeo rus89 (big blind) collected ($0.10)
Seat 2: fish72o folded before Flop (didn't bet)
Seat 3: reznor1 folded before Flop (didn't bet)
Seat 5: 12311985 (button) folded before Flop (didn't bet)
Seat 6: Pablo7-Pro (small blind) folded before Flop



PokerStars Hand #222946329929:  Hold'em No Limit ($0.05/$0.10 USD) - 2021/01/23 1:48:08 ET
Table 'Polydoros II' 6-max Seat #6 is the button
Seat 1: Romeo rus89 ($9.92 in chips) 
Seat 2: fish72o ($10 in chips) 
Seat 3: reznor1 ($23.34 in chips) 
Seat 5: 12311985 ($11.46 in chips) 
Seat 6: Pablo7-Pro ($15.12 in chips) 
Romeo rus89: posts small blind $0.05
fish72o: posts big blind $0.10
1212387: sits out 
*** HOLE CARDS ***
reznor1: folds 
12311985: raises $0.15 to $0.25
Pablo7-Pro: folds 
Romeo rus89: folds 
fish72o: calls $0.15
*** FLOP *** [Qc 2d 8s]
fish72o: checks 
12311985: bets $0.16
fish72o: folds 
Uncalled bet ($0.16) returned to 12311985
12311985 collected $0.53 from pot
12311985: doesn't show hand 
*** SUMMARY ***
Total pot $0.55 | Rake $0.02 
Board [Qc 2d 8s]
Seat 1: Romeo rus89 (small blind) folded before Flop
Seat 2: fish72o (big blind) folded on the Flop
Seat 3: reznor1 folded before Flop (didn't bet)
Seat 5: 12311985 collected ($0.53)
Seat 6: Pablo7-Pro (button) folded before Flop (didn't bet)



PokerStars Hand #222946337772:  Hold'em No Limit ($0.05/$0.10 USD) - 2021/01/23 1:48:41 ET
Table 'Polydoros II' 6-max Seat #1 is the button
Seat 1: Romeo rus89 ($9.87 in chips) 
Seat 2: fish72o ($10 in chips) 
Seat 3: reznor1 ($23.34 in chips) 
Seat 5: 12311985 ($11.74 in chips) 
Seat 6: Pablo7-Pro ($15.12 in chips) 
fish72o: posts small blind $0.05
reznor1: posts big blind $0.10
1212387: sits out 
*** HOLE CARDS ***
12311985: folds 
Pablo7-Pro: folds 
Romeo rus89: folds 
fish72o: raises $0.15 to $0.25
reznor1: folds 
Uncalled bet ($0.15) returned to fish72o
fish72o collected $0.20 from pot
fish72o: doesn't show hand 
*** SUMMARY ***
Total pot $0.20 | Rake $0 
Seat 1: Romeo rus89 (button) folded before Flop (didn't bet)
Seat 2: fish72o (small blind) collected ($0.20)
Seat 3: reznor1 (big blind) folded before Flop
Seat 5: 12311985 folded before Flop (didn't bet)
Seat 6: Pablo7-Pro folded before Flop (didn't bet)



PokerStars Hand #222946341738:  Hold'em No Limit ($0.05/$0.10 USD) - 2021/01/23 1:48:58 ET
Table 'Polydoros II' 6-max Seat #2 is the button
Seat 1: Romeo rus89 ($9.87 in chips) 
Seat 2: fish72o ($10.10 in chips) 
Seat 3: reznor1 ($23.24 in chips) 
Seat 4: 1212387 ($10 in chips) 
Seat 5: 12311985 ($11.74 in chips) 
Seat 6: Pablo7-Pro ($15.12 in chips) 
reznor1: posts small blind $0.05
1212387: posts big blind $0.10
*** HOLE CARDS ***
12311985: folds 
Pablo7-Pro: folds 
Romeo rus89: raises $0.15 to $0.25
fish72o: folds 
reznor1: folds 
1212387: folds 
Uncalled bet ($0.15) returned to Romeo rus89
Romeo rus89 collected $0.25 from pot
*** SUMMARY ***
Total pot $0.25 | Rake $0 
Seat 1: Romeo rus89 collected ($0.25)
Seat 2: fish72o (button) folded before Flop (didn't bet)
Seat 3: reznor1 (small blind) folded before Flop
Seat 4: 1212387 (big blind) folded before Flop
Seat 5: 12311985 folded before Flop (didn't bet)
Seat 6: Pablo7-Pro folded before Flop (didn't bet)



PokerStars Hand #222946345689:  Hold'em No Limit ($0.05/$0.10 USD) - 2021/01/23 1:49:15 ET
Table 'Polydoros II' 6-max Seat #3 is the button
Seat 1: Romeo rus89 ($10.02 in chips) 
Seat 2: fish72o ($10.10 in chips) 
Seat 3: reznor1 ($23.19 in chips) 
Seat 4: 1212387 ($9.90 in chips) 
Seat 5: 12311985 ($11.74 in chips) 
Seat 6: Pablo7-Pro ($15.12 in chips) 
1212387: posts small blind $0.05
12311985: posts big blind $0.10
*** HOLE CARDS ***
Pablo7-Pro: folds 
Romeo rus89: folds 
fish72o: folds 
reznor1: folds 
1212387: folds 
Uncalled bet ($0.05) returned to 12311985
12311985 collected $0.10 from pot
12311985: doesn't show hand 
*** SUMMARY ***
Total pot $0.10 | Rake $0 
Seat 1: Romeo rus89 folded before Flop (didn't bet)
Seat 2: fish72o folded before Flop (didn't bet)
Seat 3: reznor1 (button) folded before Flop (didn't bet)
Seat 4: 1212387 (small blind) folded before Flop
Seat 5: 12311985 (big blind) collected ($0.10)
Seat 6: Pablo7-Pro folded before Flop (didn't bet)



PokerStars Hand #222946347055:  Hold'em No Limit ($0.05/$0.10 USD) - 2021/01/23 1:49:21 ET
Table 'Polydoros II' 6-max Seat #4 is the button
Seat 1: Romeo rus89 ($10.02 in chips) 
Seat 2: fish72o ($10.10 in chips) 
Seat 3: reznor1 ($23.19 in chips) 
Seat 4: 1212387 ($9.85 in chips) 
Seat 5: 12311985 ($11.79 in chips) 
Seat 6: Pablo7-Pro ($15.12 in chips) 
12311985: posts small blind $0.05
Pablo7-Pro: posts big blind $0.10
*** HOLE CARDS ***
Romeo rus89: folds 
fish72o: folds 
reznor1: folds 
1212387: raises $0.20 to $0.30
12311985: folds 
Pablo7-Pro: calls $0.20
*** FLOP *** [2h Qs Ks]
Pablo7-Pro: checks 
1212387: checks 
*** TURN *** [2h Qs Ks] [6c]
Pablo7-Pro: bets $0.20
1212387: raises $0.51 to $0.71
Pablo7-Pro: calls $0.51
*** RIVER *** [2h Qs Ks 6c] [Td]
Pablo7-Pro: checks 
1212387: bets $0.99
Pablo7-Pro: calls $0.99
*** SHOW DOWN ***
1212387: shows [Ad As] (a pair of Aces)
Pablo7-Pro: mucks hand 
1212387 collected $3.87 from pot
*** SUMMARY ***
Total pot $4.05 | Rake $0.18 
Board [2h Qs Ks 6c Td]
Seat 1: Romeo rus89 folded before Flop (didn't bet)
Seat 2: fish72o folded before Flop (didn't bet)
Seat 3: reznor1 folded before Flop (didn't bet)
Seat 4: 1212387 (button) showed [Ad As] and won ($3.87) with a pair of Aces
Seat 5: 12311985 (small blind) folded before Flop
Seat 6: Pablo7-Pro (big blind) mucked



PokerStars Hand #222946356472:  Hold'em No Limit ($0.05/$0.10 USD) - 2021/01/23 1:49:58 ET
Table 'Polydoros II' 6-max Seat #5 is the button
Seat 1: Romeo rus89 ($10.02 in chips) 
Seat 2: fish72o ($10.10 in chips) 
Seat 3: reznor1 ($23.19 in chips) 
Seat 4: 1212387 ($11.72 in chips) 
Seat 5: 12311985 ($11.74 in chips) 
Seat 6: Pablo7-Pro ($13.12 in chips) 
Pablo7-Pro: posts small blind $0.05
Romeo rus89: posts big blind $0.10
*** HOLE CARDS ***
fish72o: folds 
reznor1: calls $0.10
1212387 has timed out
1212387: folds 
12311985: folds 
Pablo7-Pro: folds 
Romeo rus89: checks 
*** FLOP *** [8c 7s Jd]
Romeo rus89: checks 
reznor1: bets $0.10
Romeo rus89: folds 
Uncalled bet ($0.10) returned to reznor1
reznor1 collected $0.24 from pot
*** SUMMARY ***
Total pot $0.25 | Rake $0.01 
Board [8c 7s Jd]
Seat 1: Romeo rus89 (big blind) folded on the Flop
Seat 2: fish72o folded before Flop (didn't bet)
Seat 3: reznor1 collected ($0.24)
Seat 4: 1212387 folded before Flop (didn't bet)
Seat 5: 12311985 (button) folded before Flop (didn't bet)
Seat 6: Pablo7-Pro (small blind) folded before Flop



PokerStars Hand #222946366320:  Hold'em No Limit ($0.05/$0.10 USD) - 2021/01/23 1:50:41 ET
Table 'Polydoros II' 6-max Seat #6 is the button
Seat 1: Romeo rus89 ($9.92 in chips) 
Seat 2: fish72o ($10.10 in chips) 
Seat 3: reznor1 ($23.33 in chips) 
Seat 4: 1212387 ($11.72 in chips) 
Seat 5: 12311985 ($11.74 in chips) 
Seat 6: Pablo7-Pro ($13.07 in chips) 
Romeo rus89: posts small blind $0.05
fish72o: posts big blind $0.10
*** HOLE CARDS ***
reznor1: folds 
1212387: raises $0.10 to $0.20
12311985: folds 
Pablo7-Pro: raises $0.60 to $0.80
Romeo rus89: folds 
fish72o: folds 
1212387: calls $0.60
*** FLOP *** [5s 8s Qc]
1212387: checks 
Pablo7-Pro: bets $0.55
1212387: folds 
Uncalled bet ($0.55) returned to Pablo7-Pro
Pablo7-Pro collected $1.67 from pot
Pablo7-Pro: doesn't show hand 
*** SUMMARY ***
Total pot $1.75 | Rake $0.08 
Board [5s 8s Qc]
Seat 1: Romeo rus89 (small blind) folded before Flop
Seat 2: fish72o (big blind) folded before Flop
Seat 3: reznor1 folded before Flop (didn't bet)
Seat 4: 1212387 folded on the Flop
Seat 5: 12311985 folded before Flop (didn't bet)
Seat 6: Pablo7-Pro (button) collected ($1.67)



PokerStars Hand #222946372840:  Hold'em No Limit ($0.05/$0.10 USD) - 2021/01/23 1:51:09 ET
Table 'Polydoros II' 6-max Seat #1 is the button
Seat 1: Romeo rus89 ($9.87 in chips) 
Seat 2: fish72o ($10 in chips) 
Seat 3: reznor1 ($23.33 in chips) 
Seat 4: 1212387 ($10.92 in chips) 
Seat 5: 12311985 ($11.74 in chips) 
Seat 6: Pablo7-Pro ($13.94 in chips) 
fish72o: posts small blind $0.05
reznor1: posts big blind $0.10
*** HOLE CARDS ***
1212387: folds 
12311985: folds 
Pablo7-Pro: folds 
Romeo rus89: raises $0.15 to $0.25
fish72o: raises $0.75 to $1
reznor1: folds 
Romeo rus89: folds 
Uncalled bet ($0.75) returned to fish72o
fish72o collected $0.60 from pot
fish72o: doesn't show hand 
*** SUMMARY ***
Total pot $0.60 | Rake $0 
Seat 1: Romeo rus89 (button) folded before Flop
Seat 2: fish72o (small blind) collected ($0.60)
Seat 3: reznor1 (big blind) folded before Flop
Seat 4: 1212387 folded before Flop (didn't bet)
Seat 5: 12311985 folded before Flop (didn't bet)
Seat 6: Pablo7-Pro folded before Flop (didn't bet)



PokerStars Hand #222946376516:  Hold'em No Limit ($0.05/$0.10 USD) - 2021/01/23 1:51:25 ET
Table 'Polydoros II' 6-max Seat #2 is the button
Seat 1: Romeo rus89 ($9.62 in chips) 
Seat 2: fish72o ($10.35 in chips) 
Seat 3: reznor1 ($23.23 in chips) 
Seat 4: 1212387 ($10.92 in chips) 
Seat 5: 12311985 ($11.74 in chips) 
Seat 6: Pablo7-Pro ($13.94 in chips) 
reznor1: posts small blind $0.05
1212387: posts big blind $0.10
*** HOLE CARDS ***
12311985: folds 
Pablo7-Pro: folds 
Romeo rus89: raises $0.15 to $0.25
fish72o: folds 
reznor1: folds 
1212387: folds 
Uncalled bet ($0.15) returned to Romeo rus89
Romeo rus89 collected $0.25 from pot
*** SUMMARY ***
Total pot $0.25 | Rake $0 
Seat 1: Romeo rus89 collected ($0.25)
Seat 2: fish72o (button) folded before Flop (didn't bet)
Seat 3: reznor1 (small blind) folded before Flop
Seat 4: 1212387 (big blind) folded before Flop
Seat 5: 12311985 folded before Flop (didn't bet)
Seat 6: Pablo7-Pro folded before Flop (didn't bet)



PokerStars Hand #222946379841:  Hold'em No Limit ($0.05/$0.10 USD) - 2021/01/23 1:51:40 ET
Table 'Polydoros II' 6-max Seat #3 is the button
Seat 1: Romeo rus89 ($9.77 in chips) 
Seat 2: fish72o ($10.35 in chips) 
Seat 3: reznor1 ($23.18 in chips) 
Seat 4: 1212387 ($10.82 in chips) 
Seat 5: 12311985 ($11.74 in chips) 
Seat 6: Pablo7-Pro ($13.94 in chips) 
1212387: posts small blind $0.05
12311985: posts big blind $0.10
*** HOLE CARDS ***
Pablo7-Pro: folds 
Romeo rus89: folds 
fish72o: folds 
reznor1: folds 
1212387: calls $0.05
12311985: checks 
*** FLOP *** [Qs 5h Td]
1212387: bets $0.10
12311985: calls $0.10
*** TURN *** [Qs 5h Td] [Ah]
1212387: bets $0.19
12311985: calls $0.19
*** RIVER *** [Qs 5h Td Ah] [7d]
1212387: checks 
12311985: bets $0.22
1212387: folds 
Uncalled bet ($0.22) returned to 12311985
12311985 collected $0.74 from pot
*** SUMMARY ***
Total pot $0.78 | Rake $0.04 
Board [Qs 5h Td Ah 7d]
Seat 1: Romeo rus89 folded before Flop (didn't bet)
Seat 2: fish72o folded before Flop (didn't bet)
Seat 3: reznor1 (button) folded before Flop (didn't bet)
Seat 4: 1212387 (small blind) folded on the River
Seat 5: 12311985 (big blind) collected ($0.74)
Seat 6: Pablo7-Pro folded before Flop (didn't bet)



PokerStars Hand #222946388517:  Hold'em No Limit ($0.05/$0.10 USD) - 2021/01/23 1:52:17 ET
Table 'Polydoros II' 6-max Seat #4 is the button
Seat 1: Romeo rus89 ($9.77 in chips) 
Seat 2: fish72o ($10.35 in chips) 
Seat 3: reznor1 ($23.18 in chips) 
Seat 4: 1212387 ($10.43 in chips) 
Seat 5: 12311985 ($12.09 in chips) 
Seat 6: Pablo7-Pro ($13.94 in chips) 
12311985: posts small blind $0.05
Pablo7-Pro: posts big blind $0.10
*** HOLE CARDS ***
Romeo rus89: folds 
fish72o: folds 
reznor1: calls $0.10
1212387: calls $0.10
12311985: raises $0.40 to $0.50
Pablo7-Pro: folds 
reznor1: calls $0.40
1212387: folds 
*** FLOP *** [6c 5s 6s]
12311985: checks 
reznor1: checks 
*** TURN *** [6c 5s 6s] [6d]
12311985: checks 
reznor1: checks 
*** RIVER *** [6c 5s 6s 6d] [4c]
12311985: bets $0.58
reznor1: folds 
Uncalled bet ($0.58) returned to 12311985
12311985 collected $1.15 from pot
12311985: doesn't show hand 
*** SUMMARY ***
Total pot $1.20 | Rake $0.05 
Board [6c 5s 6s 6d 4c]
Seat 1: Romeo rus89 folded before Flop (didn't bet)
Seat 2: fish72o folded before Flop (didn't bet)
Seat 3: reznor1 folded on the River
Seat 4: 1212387 (button) folded before Flop
Seat 5: 12311985 (small blind) collected ($1.15)
Seat 6: Pablo7-Pro (big blind) folded before Flop



PokerStars Hand #222946402028:  Hold'em No Limit ($0.05/$0.10 USD) - 2021/01/23 1:53:06 ET
Table 'Polydoros II' 6-max Seat #5 is the button
Seat 1: Romeo rus89 ($9.77 in chips) 
Seat 2: fish72o ($10.35 in chips) 
Seat 3: reznor1 ($22.68 in chips) 
Seat 4: 1212387 ($10.33 in chips) 
Seat 5: 12311985 ($12.74 in chips) 
Seat 6: Pablo7-Pro ($13.84 in chips) 
Pablo7-Pro: posts small blind $0.05
Romeo rus89: posts big blind $0.10
*** HOLE CARDS ***
fish72o: folds 
reznor1: calls $0.10
1212387: folds 
12311985: folds 
Pablo7-Pro: raises $0.20 to $0.30
Romeo rus89: folds 
reznor1: calls $0.20
*** FLOP *** [Qs 2h Jd]
Pablo7-Pro: checks 
reznor1: checks 
*** TURN *** [Qs 2h Jd] [Ac]
Pablo7-Pro: checks 
reznor1: bets $0.10
Pablo7-Pro: folds 
Uncalled bet ($0.10) returned to reznor1
reznor1 collected $0.67 from pot
*** SUMMARY ***
Total pot $0.70 | Rake $0.03 
Board [Qs 2h Jd Ac]
Seat 1: Romeo rus89 (big blind) folded before Flop
Seat 2: fish72o folded before Flop (didn't bet)
Seat 3: reznor1 collected ($0.67)
Seat 4: 1212387 folded before Flop (didn't bet)
Seat 5: 12311985 (button) folded before Flop (didn't bet)
Seat 6: Pablo7-Pro (small blind) folded on the Turn



PokerStars Hand #222946414786:  Hold'em No Limit ($0.05/$0.10 USD) - 2021/01/23 1:54:01 ET
Table 'Polydoros II' 6-max Seat #6 is the button
Seat 1: Romeo rus89 ($9.67 in chips) 
Seat 2: fish72o ($10.35 in chips) 
Seat 3: reznor1 ($23.05 in chips) 
Seat 4: 1212387 ($10.33 in chips) 
Seat 5: 12311985 ($12.74 in chips) 
Seat 6: Pablo7-Pro ($13.54 in chips) 
Romeo rus89: posts small blind $0.05
fish72o: posts big blind $0.10
*** HOLE CARDS ***
reznor1: folds 
1212387: folds 
12311985: raises $0.15 to $0.25
Pablo7-Pro: folds 
Romeo rus89: folds 
fish72o: raises $0.65 to $0.90
12311985: folds 
Uncalled bet ($0.65) returned to fish72o
fish72o collected $0.55 from pot
fish72o: doesn't show hand 
*** SUMMARY ***
Total pot $0.55 | Rake $0 
Seat 1: Romeo rus89 (small blind) folded before Flop
Seat 2: fish72o (big blind) collected ($0.55)
Seat 3: reznor1 folded before Flop (didn't bet)
Seat 4: 1212387 folded before Flop (didn't bet)
Seat 5: 12311985 folded before Flop
Seat 6: Pablo7-Pro (button) folded before Flop (didn't bet)



PokerStars Hand #222946420325:  Hold'em No Limit ($0.05/$0.10 USD) - 2021/01/23 1:54:25 ET
Table 'Polydoros II' 6-max Seat #1 is the button
Seat 1: Romeo rus89 ($9.62 in chips) 
Seat 2: fish72o ($10.65 in chips) 
Seat 3: reznor1 ($23.05 in chips) 
Seat 4: 1212387 ($10.33 in chips) 
Seat 5: 12311985 ($12.49 in chips) 
Seat 6: Pablo7-Pro ($13.54 in chips) 
fish72o: posts small blind $0.05
reznor1: posts big blind $0.10
*** HOLE CARDS ***
1212387: calls $0.10
12311985: folds 
Pablo7-Pro: folds 
Romeo rus89: folds 
fish72o: folds 
reznor1: checks 
*** FLOP *** [7h 2h Qs]
reznor1: checks 
1212387: bets $0.12
reznor1: folds 
Uncalled bet ($0.12) returned to 1212387
1212387 collected $0.24 from pot
1212387: doesn't show hand 
*** SUMMARY ***
Total pot $0.25 | Rake $0.01 
Board [7h 2h Qs]
Seat 1: Romeo rus89 (button) folded before Flop (didn't bet)
Seat 2: fish72o (small blind) folded before Flop
Seat 3: reznor1 (big blind) folded on the Flop
Seat 4: 1212387 collected ($0.24)
Seat 5: 12311985 folded before Flop (didn't bet)
Seat 6: Pablo7-Pro folded before Flop (didn't bet)



PokerStars Hand #222946426311:  Hold'em No Limit ($0.05/$0.10 USD) - 2021/01/23 1:54:51 ET
Table 'Polydoros II' 6-max Seat #2 is the button
Seat 1: Romeo rus89 ($9.62 in chips) 
Seat 2: fish72o ($10.60 in chips) 
Seat 3: reznor1 ($22.95 in chips) 
Seat 4: 1212387 ($10.47 in chips) 
Seat 5: 12311985 ($12.49 in chips) 
Seat 6: Pablo7-Pro ($13.54 in chips) 
reznor1: posts small blind $0.05
1212387: posts big blind $0.10
*** HOLE CARDS ***
12311985: folds 
Pablo7-Pro: raises $0.20 to $0.30
Romeo rus89: folds 
fish72o: raises $0.70 to $1
reznor1: folds 
1212387: folds 
Pablo7-Pro: folds 
Uncalled bet ($0.70) returned to fish72o
fish72o collected $0.75 from pot
fish72o: doesn't show hand 
*** SUMMARY ***
Total pot $0.75 | Rake $0 
Seat 1: Romeo rus89 folded before Flop (didn't bet)
Seat 2: fish72o (button) collected ($0.75)
Seat 3: reznor1 (small blind) folded before Flop
Seat 4: 1212387 (big blind) folded before Flop
Seat 5: 12311985 folded before Flop (didn't bet)
Seat 6: Pablo7-Pro folded before Flop



PokerStars Hand #222946431221:  Hold'em No Limit ($0.05/$0.10 USD) - 2021/01/23 1:55:13 ET
Table 'Polydoros II' 6-max Seat #3 is the button
Seat 1: Romeo rus89 ($9.62 in chips) 
Seat 2: fish72o ($11.05 in chips) 
Seat 3: reznor1 ($22.90 in chips) 
Seat 4: 1212387 ($10.37 in chips) 
Seat 5: 12311985 ($12.49 in chips) 
Seat 6: Pablo7-Pro ($13.24 in chips) 
1212387: posts small blind $0.05
12311985: posts big blind $0.10
*** HOLE CARDS ***
Pablo7-Pro: folds 
Romeo rus89: folds 
fish72o: folds 
reznor1: folds 
1212387: folds 
Uncalled bet ($0.05) returned to 12311985
12311985 collected $0.10 from pot
12311985: doesn't show hand 
*** SUMMARY ***
Total pot $0.10 | Rake $0 
Seat 1: Romeo rus89 folded before Flop (didn't bet)
Seat 2: fish72o folded before Flop (didn't bet)
Seat 3: reznor1 (button) folded before Flop (didn't bet)
Seat 4: 1212387 (small blind) folded before Flop
Seat 5: 12311985 (big blind) collected ($0.10)
Seat 6: Pablo7-Pro folded before Flop (didn't bet)



PokerStars Hand #222946432925:  Hold'em No Limit ($0.05/$0.10 USD) - 2021/01/23 1:55:22 ET
Table 'Polydoros II' 6-max Seat #4 is the button
Seat 1: Romeo rus89 ($9.62 in chips) 
Seat 2: fish72o ($11.05 in chips) 
Seat 3: reznor1 ($22.90 in chips) 
Seat 4: 1212387 ($10.32 in chips) 
Seat 5: 12311985 ($12.54 in chips) 
Seat 6: Pablo7-Pro ($13.24 in chips) 
12311985: posts small blind $0.05
Pablo7-Pro: posts big blind $0.10
*** HOLE CARDS ***
Romeo rus89: raises $0.20 to $0.30
fish72o: folds 
reznor1: folds 
1212387: calls $0.30
12311985: folds 
Pablo7-Pro: folds 
*** FLOP *** [Td 8d 3c]
Romeo rus89: bets $0.48
1212387: folds 
Uncalled bet ($0.48) returned to Romeo rus89
Romeo rus89 collected $0.72 from pot
*** SUMMARY ***
Total pot $0.75 | Rake $0.03 
Board [Td 8d 3c]
Seat 1: Romeo rus89 collected ($0.72)
Seat 2: fish72o folded before Flop (didn't bet)
Seat 3: reznor1 folded before Flop (didn't bet)
Seat 4: 1212387 (button) folded on the Flop
Seat 5: 12311985 (small blind) folded before Flop
Seat 6: Pablo7-Pro (big blind) folded before Flop



PokerStars Hand #222946438954:  Hold'em No Limit ($0.05/$0.10 USD) - 2021/01/23 1:55:53 ET
Table 'Polydoros II' 6-max Seat #5 is the button
Seat 2: fish72o ($11.05 in chips) 
Seat 3: reznor1 ($22.90 in chips) 
Seat 4: 1212387 ($10.02 in chips) 
Seat 5: 12311985 ($12.49 in chips) 
Seat 6: Pablo7-Pro ($13.14 in chips) 
Pablo7-Pro: posts small blind $0.05
Romeo rus89: is sitting out 
Romeo rus89 leaves the table
fish72o: posts big blind $0.10
*** HOLE CARDS ***
reznor1: folds 
1212387: calls $0.10
12311985: folds 
dave from ki joins the table at seat #1 
Pablo7-Pro: raises $0.20 to $0.30
fish72o: folds 
1212387: calls $0.20
*** FLOP *** [4s 2h 5c]
Pablo7-Pro: bets $0.52
1212387: folds 
Uncalled bet ($0.52) returned to Pablo7-Pro
Pablo7-Pro collected $0.67 from pot
Pablo7-Pro: doesn't show hand 
*** SUMMARY ***
Total pot $0.70 | Rake $0.03 
Board [4s 2h 5c]
Seat 2: fish72o (big blind) folded before Flop
Seat 3: reznor1 folded before Flop (didn't bet)
Seat 4: 1212387 folded on the Flop
Seat 5: 12311985 (button) folded before Flop (didn't bet)
Seat 6: Pablo7-Pro (small blind) collected ($0.67)



PokerStars Hand #222946443526:  Hold'em No Limit ($0.05/$0.10 USD) - 2021/01/23 1:56:17 ET
Table 'Polydoros II' 6-max Seat #6 is the button
Seat 2: fish72o ($10.95 in chips) 
Seat 3: reznor1 ($22.90 in chips) 
Seat 4: 1212387 ($9.72 in chips) 
Seat 5: 12311985 ($12.49 in chips) 
Seat 6: Pablo7-Pro ($13.51 in chips) 
fish72o: posts small blind $0.05
reznor1: posts big blind $0.10
*** HOLE CARDS ***
1212387: folds 
12311985: folds 
Pablo7-Pro: folds 
fish72o: folds 
Uncalled bet ($0.05) returned to reznor1
reznor1 collected $0.10 from pot
*** SUMMARY ***
Total pot $0.10 | Rake $0 
Seat 2: fish72o (small blind) folded before Flop
Seat 3: reznor1 (big blind) collected ($0.10)
Seat 4: 1212387 folded before Flop (didn't bet)
Seat 5: 12311985 folded before Flop (didn't bet)
Seat 6: Pablo7-Pro (button) folded before Flop (didn't bet)



PokerStars Hand #222946446570:  Hold'em No Limit ($0.05/$0.10 USD) - 2021/01/23 1:56:32 ET
Table 'Polydoros II' 6-max Seat #2 is the button
Seat 2: fish72o ($10.90 in chips) 
Seat 3: reznor1 ($22.95 in chips) 
Seat 4: 1212387 ($9.72 in chips) 
Seat 5: 12311985 ($12.49 in chips) 
Seat 6: Pablo7-Pro ($13.51 in chips) 
reznor1: posts small blind $0.05
1212387: posts big blind $0.10
dave from ki: sits out 
*** HOLE CARDS ***
12311985: folds 
Pablo7-Pro: folds 
fish72o: raises $0.15 to $0.25
reznor1: folds 
1212387: folds 
Uncalled bet ($0.15) returned to fish72o
fish72o collected $0.25 from pot
fish72o: doesn't show hand 
*** SUMMARY ***
Total pot $0.25 | Rake $0 
Seat 2: fish72o (button) collected ($0.25)
Seat 3: reznor1 (small blind) folded before Flop
Seat 4: 1212387 (big blind) folded before Flop
Seat 5: 12311985 folded before Flop (didn't bet)
Seat 6: Pablo7-Pro folded before Flop (didn't bet)



PokerStars Hand #222946450939:  Hold'em No Limit ($0.05/$0.10 USD) - 2021/01/23 1:56:55 ET
Table 'Polydoros II' 6-max Seat #3 is the button
Seat 2: fish72o ($11.05 in chips) 
Seat 3: reznor1 ($22.90 in chips) 
Seat 4: 1212387 ($9.62 in chips) 
Seat 5: 12311985 ($12.49 in chips) 
Seat 6: Pablo7-Pro ($13.51 in chips) 
1212387: posts small blind $0.05
12311985: posts big blind $0.10
dave from ki: sits out 
*** HOLE CARDS ***
Pablo7-Pro: folds 
fish72o: folds 
reznor1: folds 
1212387: folds 
Uncalled bet ($0.05) returned to 12311985
12311985 collected $0.10 from pot
12311985: doesn't show hand 
*** SUMMARY ***
Total pot $0.10 | Rake $0 
Seat 2: fish72o folded before Flop (didn't bet)
Seat 3: reznor1 (button) folded before Flop (didn't bet)
Seat 4: 1212387 (small blind) folded before Flop
Seat 5: 12311985 (big blind) collected ($0.10)
Seat 6: Pablo7-Pro folded before Flop (didn't bet)



PokerStars Hand #222946452549:  Hold'em No Limit ($0.05/$0.10 USD) - 2021/01/23 1:57:04 ET
Table 'Polydoros II' 6-max Seat #4 is the button
Seat 2: fish72o ($11.05 in chips) 
Seat 3: reznor1 ($22.90 in chips) 
Seat 4: 1212387 ($9.57 in chips) 
Seat 5: 12311985 ($12.54 in chips) 
Seat 6: Pablo7-Pro ($13.51 in chips) 
12311985: posts small blind $0.05
Pablo7-Pro: posts big blind $0.10
dave from ki: sits out 
*** HOLE CARDS ***
fish72o: raises $0.15 to $0.25
reznor1: folds 
1212387: folds 
12311985: folds 
Pablo7-Pro: folds 
Uncalled bet ($0.15) returned to fish72o
fish72o collected $0.25 from pot
fish72o: doesn't show hand 
*** SUMMARY ***
Total pot $0.25 | Rake $0 
Seat 2: fish72o collected ($0.25)
Seat 3: reznor1 folded before Flop (didn't bet)
Seat 4: 1212387 (button) folded before Flop (didn't bet)
Seat 5: 12311985 (small blind) folded before Flop
Seat 6: Pablo7-Pro (big blind) folded before Flop



PokerStars Hand #222946455491:  Hold'em No Limit ($0.05/$0.10 USD) - 2021/01/23 1:57:19 ET
Table 'Polydoros II' 6-max Seat #5 is the button
Seat 1: dave from ki ($8 in chips) 
Seat 2: fish72o ($11.20 in chips) 
Seat 3: reznor1 ($22.90 in chips) 
Seat 4: 1212387 ($9.57 in chips) 
Seat 5: 12311985 ($12.49 in chips) 
Seat 6: Pablo7-Pro ($13.41 in chips) 
Pablo7-Pro: posts small blind $0.05
dave from ki: posts big blind $0.10
*** HOLE CARDS ***
fish72o: folds 
reznor1: folds 
1212387: raises $0.20 to $0.30
12311985: folds 
Pablo7-Pro: folds 
dave from ki: folds 
Uncalled bet ($0.20) returned to 1212387
1212387 collected $0.25 from pot
1212387: doesn't show hand 
*** SUMMARY ***
Total pot $0.25 | Rake $0 
Seat 1: dave from ki (big blind) folded before Flop
Seat 2: fish72o folded before Flop (didn't bet)
Seat 3: reznor1 folded before Flop (didn't bet)
Seat 4: 1212387 collected ($0.25)
Seat 5: 12311985 (button) folded before Flop (didn't bet)
Seat 6: Pablo7-Pro (small blind) folded before Flop



PokerStars Hand #222946459687:  Hold'em No Limit ($0.05/$0.10 USD) - 2021/01/23 1:57:41 ET
Table 'Polydoros II' 6-max Seat #6 is the button
Seat 1: dave from ki ($7.90 in chips) 
Seat 2: fish72o ($11.20 in chips) 
Seat 3: reznor1 ($22.90 in chips) 
Seat 4: 1212387 ($9.72 in chips) 
Seat 5: 12311985 ($12.49 in chips) 
Seat 6: Pablo7-Pro ($13.36 in chips) 
dave from ki: posts small blind $0.05
fish72o: posts big blind $0.10
*** HOLE CARDS ***
reznor1: folds 
1212387: folds 
12311985: folds 
Pablo7-Pro: raises $0.20 to $0.30
dave from ki: folds 
fish72o: folds 
Uncalled bet ($0.20) returned to Pablo7-Pro
Pablo7-Pro collected $0.25 from pot
Pablo7-Pro: doesn't show hand 
*** SUMMARY ***
Total pot $0.25 | Rake $0 
Seat 1: dave from ki (small blind) folded before Flop
Seat 2: fish72o (big blind) folded before Flop
Seat 3: reznor1 folded before Flop (didn't bet)
Seat 4: 1212387 folded before Flop (didn't bet)
Seat 5: 12311985 folded before Flop (didn't bet)
Seat 6: Pablo7-Pro (button) collected ($0.25)



PokerStars Hand #222946463621:  Hold'em No Limit ($0.05/$0.10 USD) - 2021/01/23 1:58:01 ET
Table 'Polydoros II' 6-max Seat #1 is the button
Seat 1: dave from ki ($7.85 in chips) 
Seat 2: fish72o ($11.10 in chips) 
Seat 3: reznor1 ($22.90 in chips) 
Seat 4: 1212387 ($9.72 in chips) 
Seat 5: 12311985 ($12.49 in chips) 
Seat 6: Pablo7-Pro ($13.51 in chips) 
fish72o: posts small blind $0.05
reznor1: posts big blind $0.10
*** HOLE CARDS ***
1212387: calls $0.10
12311985: folds 
Pablo7-Pro: folds 
dave from ki: folds 
fish72o: folds 
reznor1: checks 
*** FLOP *** [Ac Jh Qs]
reznor1: checks 
1212387: bets $0.12
reznor1: folds 
Uncalled bet ($0.12) returned to 1212387
1212387 collected $0.24 from pot
1212387: doesn't show hand 
*** SUMMARY ***
Total pot $0.25 | Rake $0.01 
Board [Ac Jh Qs]
Seat 1: dave from ki (button) folded before Flop (didn't bet)
Seat 2: fish72o (small blind) folded before Flop
Seat 3: reznor1 (big blind) folded on the Flop
Seat 4: 1212387 collected ($0.24)
Seat 5: 12311985 folded before Flop (didn't bet)
Seat 6: Pablo7-Pro folded before Flop (didn't bet)



PokerStars Hand #222946470749:  Hold'em No Limit ($0.05/$0.10 USD) - 2021/01/23 1:58:38 ET
Table 'Polydoros II' 6-max Seat #2 is the button
Seat 1: dave from ki ($7.85 in chips) 
Seat 2: fish72o ($11.05 in chips) 
Seat 3: reznor1 ($22.80 in chips) 
Seat 4: 1212387 ($9.86 in chips) 
Seat 5: 12311985 ($12.49 in chips) 
Seat 6: Pablo7-Pro ($13.51 in chips) 
reznor1: posts small blind $0.05
1212387: posts big blind $0.10
*** HOLE CARDS ***
12311985: folds 
Pablo7-Pro: raises $0.20 to $0.30
dave from ki: calls $0.30
fish72o: folds 
reznor1: folds 
1212387: folds 
*** FLOP *** [Th Kc Jh]
Pablo7-Pro: checks 
dave from ki: bets $0.10
Pablo7-Pro: calls $0.10
*** TURN *** [Th Kc Jh] [7d]
Pablo7-Pro: checks 
dave from ki: bets $0.10
Pablo7-Pro: calls $0.10
*** RIVER *** [Th Kc Jh 7d] [6d]
Pablo7-Pro: checks 
dave from ki: bets $0.55
Pablo7-Pro: folds 
Uncalled bet ($0.55) returned to dave from ki
dave from ki collected $1.10 from pot
dave from ki: doesn't show hand 
*** SUMMARY ***
Total pot $1.15 | Rake $0.05 
Board [Th Kc Jh 7d 6d]
Seat 1: dave from ki collected ($1.10)
Seat 2: fish72o (button) folded before Flop (didn't bet)
Seat 3: reznor1 (small blind) folded before Flop
Seat 4: 1212387 (big blind) folded before Flop
Seat 5: 12311985 folded before Flop (didn't bet)
Seat 6: Pablo7-Pro folded on the River



PokerStars Hand #222946480702:  Hold'em No Limit ($0.05/$0.10 USD) - 2021/01/23 1:59:29 ET
Table 'Polydoros II' 6-max Seat #3 is the button
Seat 1: dave from ki ($8.45 in chips) 
Seat 2: fish72o ($11.05 in chips) 
Seat 3: reznor1 ($22.75 in chips) 
Seat 4: 1212387 ($9.76 in chips) 
Seat 5: 12311985 ($12.49 in chips) 
Seat 6: Pablo7-Pro ($13.01 in chips) 
1212387: posts small blind $0.05
12311985: posts big blind $0.10
*** HOLE CARDS ***
Pablo7-Pro: raises $0.20 to $0.30
dave from ki: calls $0.30
fish72o: folds 
reznor1: calls $0.30
1212387: folds 
12311985: folds 
*** FLOP *** [Qh 4h 9c]
Pablo7-Pro: checks 
dave from ki: bets $0.50
reznor1: folds 
Pablo7-Pro: calls $0.50
*** TURN *** [Qh 4h 9c] [6s]
Pablo7-Pro: checks 
dave from ki: bets $0.98
Pablo7-Pro: calls $0.98
*** RIVER *** [Qh 4h 9c 6s] [Jh]
Pablo7-Pro: checks 
dave from ki: bets $1.92
Pablo7-Pro: raises $3.84 to $5.76
dave from ki: calls $3.84
*** SHOW DOWN ***
Pablo7-Pro: shows [Ah Th] (a flush, Ace high)
dave from ki: mucks hand 
Pablo7-Pro collected $14.83 from pot
*** SUMMARY ***
Total pot $15.53 | Rake $0.70 
Board [Qh 4h 9c 6s Jh]
Seat 1: dave from ki mucked
Seat 2: fish72o folded before Flop (didn't bet)
Seat 3: reznor1 (button) folded on the Flop
Seat 4: 1212387 (small blind) folded before Flop
Seat 5: 12311985 (big blind) folded before Flop
Seat 6: Pablo7-Pro showed [Ah Th] and won ($14.83) with a flush, Ace high



PokerStars Hand #222946496916:  Hold'em No Limit ($0.05/$0.10 USD) - 2021/01/23 2:00:47 ET
Table 'Polydoros II' 6-max Seat #4 is the button
Seat 1: dave from ki ($0.91 in chips) 
Seat 2: fish72o ($11.05 in chips) 
Seat 3: reznor1 ($22.45 in chips) 
Seat 4: 1212387 ($9.71 in chips) 
Seat 5: 12311985 ($12.39 in chips) 
Seat 6: Pablo7-Pro ($20.30 in chips) 
12311985: posts small blind $0.05
Pablo7-Pro: posts big blind $0.10
*** HOLE CARDS ***
dave from ki: raises $0.81 to $0.91 and is all-in
fish72o: folds 
reznor1: folds 
1212387: folds 
12311985: calls $0.86
Pablo7-Pro: folds 
*** FLOP *** [7d 9c Ac]
*** TURN *** [7d 9c Ac] [Jh]
*** RIVER *** [7d 9c Ac Jh] [2s]
*** SHOW DOWN ***
12311985: shows [Kc Kd] (a pair of Kings)
dave from ki: shows [Td 9d] (a pair of Nines)
12311985 collected $1.83 from pot
*** SUMMARY ***
Total pot $1.92 | Rake $0.09 
Board [7d 9c Ac Jh 2s]
Seat 1: dave from ki showed [Td 9d] and lost with a pair of Nines
Seat 2: fish72o folded before Flop (didn't bet)
Seat 3: reznor1 folded before Flop (didn't bet)
Seat 4: 1212387 (button) folded before Flop (didn't bet)
Seat 5: 12311985 (small blind) showed [Kc Kd] and won ($1.83) with a pair of Kings
Seat 6: Pablo7-Pro (big blind) folded before Flop



PokerStars Hand #222946503644:  Hold'em No Limit ($0.05/$0.10 USD) - 2021/01/23 2:01:17 ET
Table 'Polydoros II' 6-max Seat #5 is the button
Seat 3: reznor1 ($22.45 in chips) 
Seat 4: 1212387 ($9.71 in chips) 
Seat 5: 12311985 ($13.31 in chips) 
Seat 6: Pablo7-Pro ($20.20 in chips) 
Pablo7-Pro: posts small blind $0.05
fish72o: is sitting out 
reznor1: posts big blind $0.10
*** HOLE CARDS ***
fish72o leaves the table
1212387: folds 
12311985: folds 
dave from ki leaves the table
Pablo7-Pro: raises $0.20 to $0.30
reznor1: folds 
Uncalled bet ($0.20) returned to Pablo7-Pro
Pablo7-Pro collected $0.20 from pot
Pablo7-Pro: doesn't show hand 
*** SUMMARY ***
Total pot $0.20 | Rake $0 
Seat 3: reznor1 (big blind) folded before Flop
Seat 4: 1212387 folded before Flop (didn't bet)
Seat 5: 12311985 (button) folded before Flop (didn't bet)
Seat 6: Pablo7-Pro (small blind) collected ($0.20)



PokerStars Hand #222946507670:  Hold'em No Limit ($0.05/$0.10 USD) - 2021/01/23 2:01:34 ET
Table 'Polydoros II' 6-max Seat #6 is the button
Seat 3: reznor1 ($22.35 in chips) 
Seat 4: 1212387 ($9.71 in chips) 
Seat 5: 12311985 ($13.31 in chips) 
Seat 6: Pablo7-Pro ($20.30 in chips) 
reznor1: posts small blind $0.05
1212387: posts big blind $0.10
*** HOLE CARDS ***
12311985 has timed out
12311985: folds 
Pablo7-Pro: folds 
reznor1: folds 
Uncalled bet ($0.05) returned to 1212387
1212387 collected $0.10 from pot
1212387: doesn't show hand 
delbergg joins the table at seat #1 
*** SUMMARY ***
Total pot $0.10 | Rake $0 
Seat 3: reznor1 (small blind) folded before Flop
Seat 4: 1212387 (big blind) collected ($0.10)
Seat 5: 12311985 folded before Flop (didn't bet)
Seat 6: Pablo7-Pro (button) folded before Flop (didn't bet)



PokerStars Hand #222946511522:  Hold'em No Limit ($0.05/$0.10 USD) - 2021/01/23 2:01:51 ET
Table 'Polydoros II' 6-max Seat #3 is the button
Seat 3: reznor1 ($22.30 in chips) 
Seat 4: 1212387 ($9.76 in chips) 
Seat 6: Pablo7-Pro ($20.30 in chips) 
1212387: posts small blind $0.05
Pablo7-Pro: posts big blind $0.10
delbergg: sits out 
*** HOLE CARDS ***
reznor1: folds 
1212387: raises $0.20 to $0.30
Pablo7-Pro: folds 
Uncalled bet ($0.20) returned to 1212387
1212387 collected $0.20 from pot
1212387: doesn't show hand 
*** SUMMARY ***
Total pot $0.20 | Rake $0 
Seat 3: reznor1 (button) folded before Flop (didn't bet)
Seat 4: 1212387 (small blind) collected ($0.20)
Seat 6: Pablo7-Pro (big blind) folded before Flop



PokerStars Hand #222946514012:  Hold'em No Limit ($0.05/$0.10 USD) - 2021/01/23 2:02:02 ET
Table 'Polydoros II' 6-max Seat #4 is the button
Seat 1: delbergg ($10 in chips) 
Seat 3: reznor1 ($22.30 in chips) 
Seat 4: 1212387 ($9.86 in chips) 
Seat 6: Pablo7-Pro ($20.20 in chips) 
Pablo7-Pro: posts small blind $0.05
delbergg: posts big blind $0.10
*** HOLE CARDS ***
reznor1: calls $0.10
1212387: calls $0.10
Pablo7-Pro: folds 
delbergg: raises $0.70 to $0.80
reznor1: folds 
1212387: folds 
Uncalled bet ($0.70) returned to delbergg
delbergg collected $0.35 from pot
*** SUMMARY ***
Total pot $0.35 | Rake $0 
Seat 1: delbergg (big blind) collected ($0.35)
Seat 3: reznor1 folded before Flop
Seat 4: 1212387 (button) folded before Flop
Seat 6: Pablo7-Pro (small blind) folded before Flop



PokerStars Hand #222946520709:  Hold'em No Limit ($0.05/$0.10 USD) - 2021/01/23 2:02:31 ET
Table 'Polydoros II' 6-max Seat #6 is the button
Seat 1: delbergg ($10.25 in chips) 
Seat 3: reznor1 ($22.20 in chips) 
Seat 4: 1212387 ($9.76 in chips) 
Seat 6: Pablo7-Pro ($20.15 in chips) 
delbergg: posts small blind $0.05
reznor1: posts big blind $0.10
*** HOLE CARDS ***
1212387: calls $0.10
Pablo7-Pro: folds 
delbergg: raises $0.50 to $0.60
reznor1: folds 
1212387: folds 
Uncalled bet ($0.50) returned to delbergg
delbergg collected $0.30 from pot
*** SUMMARY ***
Total pot $0.30 | Rake $0 
Seat 1: delbergg (small blind) collected ($0.30)
Seat 3: reznor1 (big blind) folded before Flop
Seat 4: 1212387 folded before Flop
Seat 6: Pablo7-Pro (button) folded before Flop (didn't bet)



PokerStars Hand #222946524963:  Hold'em No Limit ($0.05/$0.10 USD) - 2021/01/23 2:02:49 ET
Table 'Polydoros II' 6-max Seat #1 is the button
Seat 1: delbergg ($10.45 in chips) 
Seat 3: reznor1 ($22.10 in chips) 
Seat 4: 1212387 ($9.66 in chips) 
Seat 6: Pablo7-Pro ($20.15 in chips) 
reznor1: posts small blind $0.05
1212387: posts big blind $0.10
*** HOLE CARDS ***
Pablo7-Pro: folds 
delbergg: folds 
reznor1: folds 
Uncalled bet ($0.05) returned to 1212387
1212387 collected $0.10 from pot
1212387: doesn't show hand 
*** SUMMARY ***
Total pot $0.10 | Rake $0 
Seat 1: delbergg (button) folded before Flop (didn't bet)
Seat 3: reznor1 (small blind) folded before Flop
Seat 4: 1212387 (big blind) collected ($0.10)
Seat 6: Pablo7-Pro folded before Flop (didn't bet)



PokerStars Hand #222946526271:  Hold'em No Limit ($0.05/$0.10 USD) - 2021/01/23 2:02:55 ET
Table 'Polydoros II' 6-max Seat #3 is the button
Seat 1: delbergg ($10.45 in chips) 
Seat 3: reznor1 ($22.05 in chips) 
Seat 4: 1212387 ($9.71 in chips) 
Seat 5: 12311985 ($13.31 in chips) 
Seat 6: Pablo7-Pro ($20.15 in chips) 
1212387: posts small blind $0.05
12311985: posts big blind $0.10
*** HOLE CARDS ***
Pablo7-Pro: raises $0.20 to $0.30
AM740RU joins the table at seat #2 
delbergg: calls $0.30
reznor1: folds 
1212387: folds 
12311985: folds 
*** FLOP *** [5d Qs 4d]
Pablo7-Pro: checks 
delbergg: bets $0.48
Pablo7-Pro: folds 
Uncalled bet ($0.48) returned to delbergg
delbergg collected $0.72 from pot
delbergg: doesn't show hand 
*** SUMMARY ***
Total pot $0.75 | Rake $0.03 
Board [5d Qs 4d]
Seat 1: delbergg collected ($0.72)
Seat 3: reznor1 (button) folded before Flop (didn't bet)
Seat 4: 1212387 (small blind) folded before Flop
Seat 5: 12311985 (big blind) folded before Flop
Seat 6: Pablo7-Pro folded on the Flop



PokerStars Hand #222946542127:  Hold'em No Limit ($0.05/$0.10 USD) - 2021/01/23 2:03:27 ET
Table 'Polydoros II' 6-max Seat #4 is the button
Seat 1: delbergg ($10.87 in chips) 
Seat 3: reznor1 ($22.05 in chips) 
Seat 4: 1212387 ($9.66 in chips) 
Seat 5: 12311985 ($13.21 in chips) 
Seat 6: Pablo7-Pro ($19.85 in chips) 
12311985: posts small blind $0.05
Pablo7-Pro: posts big blind $0.10
AM740RU: sits out 
*** HOLE CARDS ***
delbergg: folds 
reznor1: calls $0.10
1212387: calls $0.10
12311985: folds 
Pablo7-Pro: checks 
*** FLOP *** [8s Kc 6h]
Pablo7-Pro: checks 
reznor1: checks 
1212387: bets $0.16
Pablo7-Pro: folds 
reznor1: folds 
Uncalled bet ($0.16) returned to 1212387
1212387 collected $0.33 from pot
1212387: doesn't show hand 
*** SUMMARY ***
Total pot $0.35 | Rake $0.02 
Board [8s Kc 6h]
Seat 1: delbergg folded before Flop (didn't bet)
Seat 3: reznor1 folded on the Flop
Seat 4: 1212387 (button) collected ($0.33)
Seat 5: 12311985 (small blind) folded before Flop
Seat 6: Pablo7-Pro (big blind) folded on the Flop



PokerStars Hand #222946549339:  Hold'em No Limit ($0.05/$0.10 USD) - 2021/01/23 2:03:58 ET
Table 'Polydoros II' 6-max Seat #5 is the button
Seat 1: delbergg ($10.87 in chips) 
Seat 3: reznor1 ($21.95 in chips) 
Seat 4: 1212387 ($9.89 in chips) 
Seat 5: 12311985 ($13.16 in chips) 
Seat 6: Pablo7-Pro ($19.75 in chips) 
Pablo7-Pro: posts small blind $0.05
delbergg: posts big blind $0.10
AM740RU: sits out 
*** HOLE CARDS ***
reznor1: raises $0.20 to $0.30
1212387: calls $0.30
12311985: folds 
Pablo7-Pro: folds 
delbergg: calls $0.20
*** FLOP *** [8s Qs Th]
delbergg: checks 
reznor1: bets $0.27
1212387: raises $0.27 to $0.54
delbergg: calls $0.54
reznor1: calls $0.27
*** TURN *** [8s Qs Th] [Ah]
delbergg: checks 
reznor1: bets $1.23
1212387: folds 
delbergg: calls $1.23
*** RIVER *** [8s Qs Th Ah] [2c]
delbergg: checks 
reznor1: checks 
*** SHOW DOWN ***
delbergg: shows [6s Ks] (high card Ace)
reznor1: shows [Ad Kh] (a pair of Aces)
reznor1 collected $4.80 from pot
*** SUMMARY ***
Total pot $5.03 | Rake $0.23 
Board [8s Qs Th Ah 2c]
Seat 1: delbergg (big blind) showed [6s Ks] and lost with high card Ace
Seat 3: reznor1 showed [Ad Kh] and won ($4.80) with a pair of Aces
Seat 4: 1212387 folded on the Turn
Seat 5: 12311985 (button) folded before Flop (didn't bet)
Seat 6: Pablo7-Pro (small blind) folded before Flop



PokerStars Hand #222946561639:  Hold'em No Limit ($0.05/$0.10 USD) - 2021/01/23 2:04:51 ET
Table 'Polydoros II' 6-max Seat #6 is the button
Seat 1: delbergg ($8.80 in chips) 
Seat 2: AM740RU ($10 in chips) 
Seat 3: reznor1 ($24.68 in chips) 
Seat 4: 1212387 ($9.05 in chips) 
Seat 5: 12311985 ($13.16 in chips) 
Seat 6: Pablo7-Pro ($19.70 in chips) 
delbergg: posts small blind $0.05
AM740RU: posts big blind $0.10
*** HOLE CARDS ***
reznor1: folds 
1212387: calls $0.10
12311985: folds 
Pablo7-Pro: raises $0.40 to $0.50
delbergg: folds 
AM740RU: folds 
1212387: calls $0.40
*** FLOP *** [7c Td Jd]
1212387: bets $0.55
Pablo7-Pro: calls $0.55
*** TURN *** [7c Td Jd] [6c]
1212387: bets $1.07
Pablo7-Pro: calls $1.07
*** RIVER *** [7c Td Jd 6c] [Tc]
1212387: bets $2.09
Pablo7-Pro: folds 
Uncalled bet ($2.09) returned to 1212387
1212387 collected $4.19 from pot
1212387: doesn't show hand 
*** SUMMARY ***
Total pot $4.39 | Rake $0.20 
Board [7c Td Jd 6c Tc]
Seat 1: delbergg (small blind) folded before Flop
Seat 2: AM740RU (big blind) folded before Flop
Seat 3: reznor1 folded before Flop (didn't bet)
Seat 4: 1212387 collected ($4.19)
Seat 5: 12311985 folded before Flop (didn't bet)
Seat 6: Pablo7-Pro (button) folded on the River



PokerStars Hand #222946574626:  Hold'em No Limit ($0.05/$0.10 USD) - 2021/01/23 2:05:46 ET
Table 'Polydoros II' 6-max Seat #1 is the button
Seat 1: delbergg ($8.75 in chips) 
Seat 2: AM740RU ($9.90 in chips) 
Seat 3: reznor1 ($24.68 in chips) 
Seat 4: 1212387 ($11.12 in chips) 
Seat 5: 12311985 ($13.16 in chips) 
Seat 6: Pablo7-Pro ($17.58 in chips) 
AM740RU: posts small blind $0.05
reznor1: posts big blind $0.10
*** HOLE CARDS ***
1212387: calls $0.10
12311985: folds 
Pablo7-Pro: raises $0.20 to $0.30
delbergg: folds 
AM740RU: folds 
reznor1: folds 
1212387: calls $0.20
*** FLOP *** [Td 5c Ad]
1212387: bets $0.36
Pablo7-Pro: calls $0.36
*** TURN *** [Td 5c Ad] [6s]
1212387: bets $0.70
Pablo7-Pro: calls $0.70
*** RIVER *** [Td 5c Ad 6s] [2c]
1212387: bets $1.37
Pablo7-Pro: calls $1.37
*** SHOW DOWN ***
1212387: shows [Tc Kh] (a pair of Tens)
Pablo7-Pro: shows [Qc As] (a pair of Aces)
Pablo7-Pro collected $5.36 from pot
*** SUMMARY ***
Total pot $5.61 | Rake $0.25 
Board [Td 5c Ad 6s 2c]
Seat 1: delbergg (button) folded before Flop (didn't bet)
Seat 2: AM740RU (small blind) folded before Flop
Seat 3: reznor1 (big blind) folded before Flop
Seat 4: 1212387 showed [Tc Kh] and lost with a pair of Tens
Seat 5: 12311985 folded before Flop (didn't bet)
Seat 6: Pablo7-Pro showed [Qc As] and won ($5.36) with a pair of Aces



PokerStars Hand #222946584471:  Hold'em No Limit ($0.05/$0.10 USD) - 2021/01/23 2:06:28 ET
Table 'Polydoros II' 6-max Seat #2 is the button
Seat 1: delbergg ($8.75 in chips) 
Seat 2: AM740RU ($9.85 in chips) 
Seat 3: reznor1 ($24.58 in chips) 
Seat 4: 1212387 ($8.39 in chips) 
Seat 5: 12311985 ($13.16 in chips) 
Seat 6: Pablo7-Pro ($20.21 in chips) 
reznor1: posts small blind $0.05
1212387: posts big blind $0.10
*** HOLE CARDS ***
12311985: folds 
Pablo7-Pro: folds 
delbergg: folds 
AM740RU: raises $0.20 to $0.30
reznor1: folds 
1212387: calls $0.20
*** FLOP *** [7c 8h Ac]
1212387: checks 
AM740RU: bets $0.10
1212387: calls $0.10
*** TURN *** [7c 8h Ac] [2h]
1212387: bets $0.40
AM740RU: calls $0.40
*** RIVER *** [7c 8h Ac 2h] [8d]
1212387: checks 
AM740RU: bets $0.20
1212387: folds 
Uncalled bet ($0.20) returned to AM740RU
AM740RU collected $1.58 from pot
AM740RU: doesn't show hand 
*** SUMMARY ***
Total pot $1.65 | Rake $0.07 
Board [7c 8h Ac 2h 8d]
Seat 1: delbergg folded before Flop (didn't bet)
Seat 2: AM740RU (button) collected ($1.58)
Seat 3: reznor1 (small blind) folded before Flop
Seat 4: 1212387 (big blind) folded on the River
Seat 5: 12311985 folded before Flop (didn't bet)
Seat 6: Pablo7-Pro folded before Flop (didn't bet)



PokerStars Hand #222946593581:  Hold'em No Limit ($0.05/$0.10 USD) - 2021/01/23 2:07:07 ET
Table 'Polydoros II' 6-max Seat #3 is the button
Seat 1: delbergg ($10 in chips) 
Seat 2: AM740RU ($10.63 in chips) 
Seat 3: reznor1 ($24.53 in chips) 
Seat 4: 1212387 ($7.59 in chips) 
Seat 5: 12311985 ($13.16 in chips) 
Seat 6: Pablo7-Pro ($20.21 in chips) 
1212387: posts small blind $0.05
12311985: posts big blind $0.10
*** HOLE CARDS ***
Pablo7-Pro: folds 
delbergg: folds 
AM740RU: folds 
reznor1: folds 
1212387: folds 
Uncalled bet ($0.05) returned to 12311985
12311985 collected $0.10 from pot
12311985: doesn't show hand 
*** SUMMARY ***
Total pot $0.10 | Rake $0 
Seat 1: delbergg folded before Flop (didn't bet)
Seat 2: AM740RU folded before Flop (didn't bet)
Seat 3: reznor1 (button) folded before Flop (didn't bet)
Seat 4: 1212387 (small blind) folded before Flop
Seat 5: 12311985 (big blind) collected ($0.10)
Seat 6: Pablo7-Pro folded before Flop (didn't bet)



PokerStars Hand #222946595574:  Hold'em No Limit ($0.05/$0.10 USD) - 2021/01/23 2:07:15 ET
Table 'Polydoros II' 6-max Seat #4 is the button
Seat 1: delbergg ($10 in chips) 
Seat 2: AM740RU ($10.63 in chips) 
Seat 3: reznor1 ($24.53 in chips) 
Seat 4: 1212387 ($7.54 in chips) 
Seat 5: 12311985 ($13.21 in chips) 
Seat 6: Pablo7-Pro ($20.21 in chips) 
12311985: posts small blind $0.05
Pablo7-Pro: posts big blind $0.10
*** HOLE CARDS ***
delbergg: folds 
AM740RU: calls $0.10
reznor1: folds 
1212387: calls $0.10
12311985: folds 
Pablo7-Pro: checks 
*** FLOP *** [3c 2c 2s]
Pablo7-Pro: checks 
AM740RU: checks 
1212387: checks 
*** TURN *** [3c 2c 2s] [Ad]
Pablo7-Pro: checks 
AM740RU: checks 
1212387: checks 
*** RIVER *** [3c 2c 2s Ad] [Jd]
Pablo7-Pro: checks 
AM740RU: checks 
1212387: checks 
*** SHOW DOWN ***
Pablo7-Pro: shows [8h 7s] (a pair of Deuces)
AM740RU: shows [Ts Kd] (a pair of Deuces - Ace+King kicker)
1212387: mucks hand 
AM740RU collected $0.33 from pot
*** SUMMARY ***
Total pot $0.35 | Rake $0.02 
Board [3c 2c 2s Ad Jd]
Seat 1: delbergg folded before Flop (didn't bet)
Seat 2: AM740RU showed [Ts Kd] and won ($0.33) with a pair of Deuces
Seat 3: reznor1 folded before Flop (didn't bet)
Seat 4: 1212387 (button) mucked
Seat 5: 12311985 (small blind) folded before Flop
Seat 6: Pablo7-Pro (big blind) showed [8h 7s] and lost with a pair of Deuces



PokerStars Hand #222946603374:  Hold'em No Limit ($0.05/$0.10 USD) - 2021/01/23 2:07:48 ET
Table 'Polydoros II' 6-max Seat #5 is the button
Seat 1: delbergg ($10 in chips) 
Seat 2: AM740RU ($10.86 in chips) 
Seat 3: reznor1 ($24.53 in chips) 
Seat 4: 1212387 ($7.44 in chips) 
Seat 5: 12311985 ($13.16 in chips) 
Seat 6: Pablo7-Pro ($20.11 in chips) 
Pablo7-Pro: posts small blind $0.05
delbergg: posts big blind $0.10
*** HOLE CARDS ***
AM740RU: calls $0.10
reznor1: calls $0.10
1212387: raises $0.20 to $0.30
12311985: folds 
Pablo7-Pro: folds 
delbergg: folds 
AM740RU: calls $0.20
reznor1: calls $0.20
*** FLOP *** [Ts Qd 5c]
AM740RU: checks 
reznor1: checks 
1212387: bets $0.50
AM740RU: calls $0.50
reznor1: calls $0.50
*** TURN *** [Ts Qd 5c] [4h]
AM740RU: checks 
reznor1: checks 
1212387: checks 
*** RIVER *** [Ts Qd 5c 4h] [Td]
AM740RU: bets $0.10
reznor1: folds 
1212387: calls $0.10
*** SHOW DOWN ***
AM740RU: shows [9c 9d] (two pair, Tens and Nines)
1212387: mucks hand 
AM740RU collected $2.63 from pot
*** SUMMARY ***
Total pot $2.75 | Rake $0.12 
Board [Ts Qd 5c 4h Td]
Seat 1: delbergg (big blind) folded before Flop
Seat 2: AM740RU showed [9c 9d] and won ($2.63) with two pair, Tens and Nines
Seat 3: reznor1 folded on the River
Seat 4: 1212387 mucked
Seat 5: 12311985 (button) folded before Flop (didn't bet)
Seat 6: Pablo7-Pro (small blind) folded before Flop



PokerStars Hand #222946619956:  Hold'em No Limit ($0.05/$0.10 USD) - 2021/01/23 2:08:57 ET
Table 'Polydoros II' 6-max Seat #6 is the button
Seat 1: delbergg ($9.90 in chips) 
Seat 2: AM740RU ($12.59 in chips) 
Seat 3: reznor1 ($23.73 in chips) 
Seat 4: 1212387 ($6.54 in chips) 
Seat 5: 12311985 ($13.16 in chips) 
Seat 6: Pablo7-Pro ($20.06 in chips) 
delbergg: posts small blind $0.05
AM740RU: posts big blind $0.10
*** HOLE CARDS ***
reznor1: calls $0.10
1212387: folds 
12311985: calls $0.10
Pablo7-Pro: folds 
delbergg: calls $0.05
AM740RU: checks 
*** FLOP *** [8d 9h Ks]
delbergg: checks 
AM740RU: checks 
reznor1: checks 
12311985: checks 
*** TURN *** [8d 9h Ks] [2c]
delbergg: bets $0.25
AM740RU: folds 
reznor1: folds 
12311985: folds 
Uncalled bet ($0.25) returned to delbergg
delbergg collected $0.38 from pot
*** SUMMARY ***
Total pot $0.40 | Rake $0.02 
Board [8d 9h Ks 2c]
Seat 1: delbergg (small blind) collected ($0.38)
Seat 2: AM740RU (big blind) folded on the Turn
Seat 3: reznor1 folded on the Turn
Seat 4: 1212387 folded before Flop (didn't bet)
Seat 5: 12311985 folded on the Turn
Seat 6: Pablo7-Pro (button) folded before Flop (didn't bet)



PokerStars Hand #222946628748:  Hold'em No Limit ($0.05/$0.10 USD) - 2021/01/23 2:09:35 ET
Table 'Polydoros II' 6-max Seat #1 is the button
Seat 1: delbergg ($10.18 in chips) 
Seat 2: AM740RU ($12.49 in chips) 
Seat 3: reznor1 ($23.63 in chips) 
Seat 4: 1212387 ($6.54 in chips) 
Seat 5: 12311985 ($13.06 in chips) 
Seat 6: Pablo7-Pro ($20.06 in chips) 
AM740RU: posts small blind $0.05
reznor1: posts big blind $0.10
*** HOLE CARDS ***
1212387: calls $0.10
12311985: folds 
Pablo7-Pro: folds 
delbergg: folds 
AM740RU: raises $0.20 to $0.30
reznor1: calls $0.20
1212387: calls $0.20
*** FLOP *** [5h Jd 7d]
AM740RU: checks 
reznor1: bets $0.43
1212387: calls $0.43
AM740RU: folds 
*** TURN *** [5h Jd 7d] [8s]
reznor1: bets $0.84
1212387: calls $0.84
*** RIVER *** [5h Jd 7d 8s] [Jh]
reznor1: bets $1.65
1212387: raises $3.32 to $4.97 and is all-in
reznor1: calls $3.32
*** SHOW DOWN ***
1212387: shows [7s Ac] (two pair, Jacks and Sevens)
reznor1: shows [Jc Qc] (three of a kind, Jacks)
reznor1 collected $12.78 from pot
*** SUMMARY ***
Total pot $13.38 | Rake $0.60 
Board [5h Jd 7d 8s Jh]
Seat 1: delbergg (button) folded before Flop (didn't bet)
Seat 2: AM740RU (small blind) folded on the Flop
Seat 3: reznor1 (big blind) showed [Jc Qc] and won ($12.78) with three of a kind, Jacks
Seat 4: 1212387 showed [7s Ac] and lost with two pair, Jacks and Sevens
Seat 5: 12311985 folded before Flop (didn't bet)
Seat 6: Pablo7-Pro folded before Flop (didn't bet)



PokerStars Hand #222946646073:  Hold'em No Limit ($0.05/$0.10 USD) - 2021/01/23 2:10:49 ET
Table 'Polydoros II' 6-max Seat #2 is the button
Seat 1: delbergg ($10.18 in chips) 
Seat 2: AM740RU ($12.19 in chips) 
Seat 3: reznor1 ($29.87 in chips) 
Seat 5: 12311985 ($13.06 in chips) 
Seat 6: Pablo7-Pro ($20.06 in chips) 
reznor1: posts small blind $0.05
12311985: posts big blind $0.10
*** HOLE CARDS ***
1212387 leaves the table
Pablo7-Pro: folds 
delbergg: raises $0.15 to $0.25
AM740RU: calls $0.25
reznor1: folds 
12311985: folds 
*** FLOP *** [9c 4h Jc]
delbergg: checks 
AM740RU: checks 
*** TURN *** [9c 4h Jc] [2d]
delbergg: bets $0.50
AM740RU: calls $0.50
*** RIVER *** [9c 4h Jc 2d] [5s]
delbergg: bets $1.80
AM740RU: folds 
Uncalled bet ($1.80) returned to delbergg
delbergg collected $1.58 from pot
reznor1 leaves the table
delbergg: doesn't show hand 
*** SUMMARY ***
Total pot $1.65 | Rake $0.07 
Board [9c 4h Jc 2d 5s]
Seat 1: delbergg collected ($1.58)
Seat 2: AM740RU (button) folded on the River
Seat 3: reznor1 (small blind) folded before Flop
Seat 5: 12311985 (big blind) folded before Flop
Seat 6: Pablo7-Pro folded before Flop (didn't bet)



PokerStars Hand #222946655014:  Hold'em No Limit ($0.05/$0.10 USD) - 2021/01/23 2:11:27 ET
Table 'Polydoros II' 6-max Seat #5 is the button
Seat 1: delbergg ($11.01 in chips) 
Seat 2: AM740RU ($11.44 in chips) 
Seat 5: 12311985 ($12.96 in chips) 
Seat 6: Pablo7-Pro ($20.06 in chips) 
Pablo7-Pro: posts small blind $0.05
delbergg: posts big blind $0.10
*** HOLE CARDS ***
AM740RU: folds 
12311985: folds 
Pablo7-Pro: folds 
Uncalled bet ($0.05) returned to delbergg
delbergg collected $0.10 from pot
*** SUMMARY ***
Total pot $0.10 | Rake $0 
Seat 1: delbergg (big blind) collected ($0.10)
Seat 2: AM740RU folded before Flop (didn't bet)
Seat 5: 12311985 (button) folded before Flop (didn't bet)
Seat 6: Pablo7-Pro (small blind) folded before Flop



PokerStars Hand #222946657009:  Hold'em No Limit ($0.05/$0.10 USD) - 2021/01/23 2:11:35 ET
Table 'Polydoros II' 6-max Seat #6 is the button
Seat 1: delbergg ($11.06 in chips) 
Seat 2: AM740RU ($11.44 in chips) 
Seat 5: 12311985 ($12.96 in chips) 
Seat 6: Pablo7-Pro ($20.01 in chips) 
delbergg: posts small blind $0.05
AM740RU: posts big blind $0.10
*** HOLE CARDS ***
12311985: raises $0.15 to $0.25
Pablo7-Pro: raises $0.55 to $0.80
delbergg: folds 
AM740RU: folds 
12311985: folds 
Uncalled bet ($0.55) returned to Pablo7-Pro
Pablo7-Pro collected $0.65 from pot
Pablo7-Pro: doesn't show hand 
*** SUMMARY ***
Total pot $0.65 | Rake $0 
Seat 1: delbergg (small blind) folded before Flop
Seat 2: AM740RU (big blind) folded before Flop
Seat 5: 12311985 folded before Flop
Seat 6: Pablo7-Pro (button) collected ($0.65)



PokerStars Hand #222946662025:  Hold'em No Limit ($0.05/$0.10 USD) - 2021/01/23 2:11:57 ET
Table 'Polydoros II' 6-max Seat #1 is the button
Seat 1: delbergg ($11.01 in chips) 
Seat 2: AM740RU ($11.34 in chips) 
Seat 5: 12311985 ($12.71 in chips) 
Seat 6: Pablo7-Pro ($20.41 in chips) 
AM740RU: posts small blind $0.05
12311985: posts big blind $0.10
*** HOLE CARDS ***
Pablo7-Pro: folds 
delbergg: folds 
AM740RU: raises $0.20 to $0.30
12311985: folds 
Uncalled bet ($0.20) returned to AM740RU
AM740RU collected $0.20 from pot
AM740RU: doesn't show hand 
*** SUMMARY ***
Total pot $0.20 | Rake $0 
Seat 1: delbergg (button) folded before Flop (didn't bet)
Seat 2: AM740RU (small blind) collected ($0.20)
Seat 5: 12311985 (big blind) folded before Flop
Seat 6: Pablo7-Pro folded before Flop (didn't bet)



PokerStars Hand #222946664731:  Hold'em No Limit ($0.05/$0.10 USD) - 2021/01/23 2:12:09 ET
Table 'Polydoros II' 6-max Seat #2 is the button
Seat 1: delbergg ($11.01 in chips) 
Seat 2: AM740RU ($11.44 in chips) 
Seat 5: 12311985 ($12.61 in chips) 
Seat 6: Pablo7-Pro ($20.41 in chips) 
12311985: posts small blind $0.05
Pablo7-Pro: posts big blind $0.10
*** HOLE CARDS ***
delbergg: folds 
AM740RU: folds 
12311985: folds 
Uncalled bet ($0.05) returned to Pablo7-Pro
Pablo7-Pro collected $0.10 from pot
Pablo7-Pro: doesn't show hand 
*** SUMMARY ***
Total pot $0.10 | Rake $0 
Seat 1: delbergg folded before Flop (didn't bet)
Seat 2: AM740RU (button) folded before Flop (didn't bet)
Seat 5: 12311985 (small blind) folded before Flop
Seat 6: Pablo7-Pro (big blind) collected ($0.10)



PokerStars Hand #222946666943:  Hold'em No Limit ($0.05/$0.10 USD) - 2021/01/23 2:12:18 ET
Table 'Polydoros II' 6-max Seat #5 is the button
Seat 1: delbergg ($11.01 in chips) 
Seat 2: AM740RU ($11.44 in chips) 
Seat 5: 12311985 ($12.56 in chips) 
Seat 6: Pablo7-Pro ($20.46 in chips) 
Pablo7-Pro: posts small blind $0.05
delbergg: posts big blind $0.10
*** HOLE CARDS ***
AM740RU: folds 
12311985: raises $0.20 to $0.30
StarkomT3ob joins the table at seat #3 
Pablo7-Pro: raises $0.70 to $1
delbergg: folds 
12311985: folds 
Uncalled bet ($0.70) returned to Pablo7-Pro
Pablo7-Pro collected $0.70 from pot
Pablo7-Pro: doesn't show hand 
*** SUMMARY ***
Total pot $0.70 | Rake $0 
Seat 1: delbergg (big blind) folded before Flop
Seat 2: AM740RU folded before Flop (didn't bet)
Seat 5: 12311985 (button) folded before Flop
Seat 6: Pablo7-Pro (small blind) collected ($0.70)



PokerStars Hand #222946671748:  Hold'em No Limit ($0.05/$0.10 USD) - 2021/01/23 2:12:39 ET
Table 'Polydoros II' 6-max Seat #6 is the button
Seat 1: delbergg ($10.91 in chips) 
Seat 2: AM740RU ($11.44 in chips) 
Seat 5: 12311985 ($12.26 in chips) 
Seat 6: Pablo7-Pro ($20.86 in chips) 
delbergg: posts small blind $0.05
AM740RU: posts big blind $0.10
StarkomT3ob: sits out 
*** HOLE CARDS ***
12311985: folds 
Pablo7-Pro: raises $0.20 to $0.30
delbergg: folds 
whtocean joins the table at seat #4 
AM740RU: folds 
Uncalled bet ($0.20) returned to Pablo7-Pro
Pablo7-Pro collected $0.25 from pot
Pablo7-Pro: doesn't show hand 
*** SUMMARY ***
Total pot $0.25 | Rake $0 
Seat 1: delbergg (small blind) folded before Flop
Seat 2: AM740RU (big blind) folded before Flop
Seat 5: 12311985 folded before Flop (didn't bet)
Seat 6: Pablo7-Pro (button) collected ($0.25)



PokerStars Hand #222946674394:  Hold'em No Limit ($0.05/$0.10 USD) - 2021/01/23 2:12:50 ET
Table 'Polydoros II' 6-max Seat #1 is the button
Seat 1: delbergg ($10.86 in chips) 
Seat 2: AM740RU ($11.34 in chips) 
Seat 3: StarkomT3ob ($10 in chips) 
Seat 5: 12311985 ($12.26 in chips) 
Seat 6: Pablo7-Pro ($21.01 in chips) 
AM740RU: posts small blind $0.05
StarkomT3ob: posts big blind $0.10
whtocean: sits out 
*** HOLE CARDS ***
12311985: folds 
Pablo7-Pro: folds 
delbergg: folds 
AM740RU: calls $0.05
StarkomT3ob: checks 
*** FLOP *** [Qc 8s Ks]
AM740RU: bets $0.10
StarkomT3ob: calls $0.10
*** TURN *** [Qc 8s Ks] [Kd]
AM740RU: checks 
StarkomT3ob: bets $0.25
AM740RU: calls $0.25
*** RIVER *** [Qc 8s Ks Kd] [5d]
AM740RU: bets $10.89 and is all-in
StarkomT3ob: folds 
Uncalled bet ($10.89) returned to AM740RU
AM740RU collected $0.86 from pot
AM740RU: doesn't show hand 
*** SUMMARY ***
Total pot $0.90 | Rake $0.04 
Board [Qc 8s Ks Kd 5d]
Seat 1: delbergg (button) folded before Flop (didn't bet)
Seat 2: AM740RU (small blind) collected ($0.86)
Seat 3: StarkomT3ob (big blind) folded on the River
Seat 5: 12311985 folded before Flop (didn't bet)
Seat 6: Pablo7-Pro folded before Flop (didn't bet)



PokerStars Hand #222946686347:  Hold'em No Limit ($0.05/$0.10 USD) - 2021/01/23 2:13:42 ET
Table 'Polydoros II' 6-max Seat #2 is the button
Seat 1: delbergg ($10.86 in chips) 
Seat 2: AM740RU ($11.75 in chips) 
Seat 3: StarkomT3ob ($10 in chips) 
Seat 4: whtocean ($13.95 in chips) 
Seat 5: 12311985 ($12.26 in chips) 
Seat 6: Pablo7-Pro ($21.01 in chips) 
StarkomT3ob: posts small blind $0.05
whtocean: posts big blind $0.10
*** HOLE CARDS ***
12311985: folds 
Pablo7-Pro: folds 
delbergg: folds 
AM740RU: folds 
StarkomT3ob: folds 
Uncalled bet ($0.05) returned to whtocean
whtocean collected $0.10 from pot
whtocean: doesn't show hand 
*** SUMMARY ***
Total pot $0.10 | Rake $0 
Seat 1: delbergg folded before Flop (didn't bet)
Seat 2: AM740RU (button) folded before Flop (didn't bet)
Seat 3: StarkomT3ob (small blind) folded before Flop
Seat 4: whtocean (big blind) collected ($0.10)
Seat 5: 12311985 folded before Flop (didn't bet)
Seat 6: Pablo7-Pro folded before Flop (didn't bet)



PokerStars Hand #222946690186:  Hold'em No Limit ($0.05/$0.10 USD) - 2021/01/23 2:13:58 ET
Table 'Polydoros II' 6-max Seat #3 is the button
Seat 1: delbergg ($10.86 in chips) 
Seat 2: AM740RU ($11.75 in chips) 
Seat 3: StarkomT3ob ($10 in chips) 
Seat 4: whtocean ($14 in chips) 
Seat 5: 12311985 ($12.26 in chips) 
Seat 6: Pablo7-Pro ($21.01 in chips) 
whtocean: posts small blind $0.05
12311985: posts big blind $0.10
*** HOLE CARDS ***
Pablo7-Pro: folds 
delbergg: raises $0.15 to $0.25
AM740RU: folds 
StarkomT3ob: calls $0.25
whtocean: folds 
12311985: folds 
*** FLOP *** [7h 4c 7s]
delbergg: checks 
StarkomT3ob: checks 
*** TURN *** [7h 4c 7s] [Qs]
delbergg: checks 
StarkomT3ob: bets $0.35
delbergg: folds 
Uncalled bet ($0.35) returned to StarkomT3ob
StarkomT3ob collected $0.62 from pot
StarkomT3ob: doesn't show hand 
*** SUMMARY ***
Total pot $0.65 | Rake $0.03 
Board [7h 4c 7s Qs]
Seat 1: delbergg folded on the Turn
Seat 2: AM740RU folded before Flop (didn't bet)
Seat 3: StarkomT3ob (button) collected ($0.62)
Seat 4: whtocean (small blind) folded before Flop
Seat 5: 12311985 (big blind) folded before Flop
Seat 6: Pablo7-Pro folded before Flop (didn't bet)



PokerStars Hand #222946699636:  Hold'em No Limit ($0.05/$0.10 USD) - 2021/01/23 2:14:39 ET
Table 'Polydoros II' 6-max Seat #4 is the button
Seat 1: delbergg ($10.61 in chips) 
Seat 2: AM740RU ($11.75 in chips) 
Seat 3: StarkomT3ob ($10.37 in chips) 
Seat 4: whtocean ($13.95 in chips) 
Seat 5: 12311985 ($12.16 in chips) 
Seat 6: Pablo7-Pro ($21.01 in chips) 
12311985: posts small blind $0.05
Pablo7-Pro: posts big blind $0.10
*** HOLE CARDS ***
delbergg: folds 
AM740RU: folds 
StarkomT3ob: folds 
whtocean: raises $0.15 to $0.25
12311985: folds 
Pablo7-Pro: folds 
Uncalled bet ($0.15) returned to whtocean
whtocean collected $0.25 from pot
whtocean: doesn't show hand 
*** SUMMARY ***
Total pot $0.25 | Rake $0 
Seat 1: delbergg folded before Flop (didn't bet)
Seat 2: AM740RU folded before Flop (didn't bet)
Seat 3: StarkomT3ob folded before Flop (didn't bet)
Seat 4: whtocean (button) collected ($0.25)
Seat 5: 12311985 (small blind) folded before Flop
Seat 6: Pablo7-Pro (big blind) folded before Flop



PokerStars Hand #222946703196:  Hold'em No Limit ($0.05/$0.10 USD) - 2021/01/23 2:14:55 ET
Table 'Polydoros II' 6-max Seat #5 is the button
Seat 1: delbergg ($10.61 in chips) 
Seat 2: AM740RU ($11.75 in chips) 
Seat 3: StarkomT3ob ($10.37 in chips) 
Seat 4: whtocean ($14.10 in chips) 
Seat 5: 12311985 ($12.11 in chips) 
Seat 6: Pablo7-Pro ($20.91 in chips) 
Pablo7-Pro: posts small blind $0.05
delbergg: posts big blind $0.10
*** HOLE CARDS ***
AM740RU: folds 
StarkomT3ob: folds 
whtocean: folds 
12311985: folds 
Pablo7-Pro: folds 
Uncalled bet ($0.05) returned to delbergg
delbergg collected $0.10 from pot
*** SUMMARY ***
Total pot $0.10 | Rake $0 
Seat 1: delbergg (big blind) collected ($0.10)
Seat 2: AM740RU folded before Flop (didn't bet)
Seat 3: StarkomT3ob folded before Flop (didn't bet)
Seat 4: whtocean folded before Flop (didn't bet)
Seat 5: 12311985 (button) folded before Flop (didn't bet)
Seat 6: Pablo7-Pro (small blind) folded before Flop



PokerStars Hand #222946705782:  Hold'em No Limit ($0.05/$0.10 USD) - 2021/01/23 2:15:06 ET
Table 'Polydoros II' 6-max Seat #6 is the button
Seat 1: delbergg ($10.66 in chips) 
Seat 2: AM740RU ($11.75 in chips) 
Seat 3: StarkomT3ob ($10.37 in chips) 
Seat 4: whtocean ($14.10 in chips) 
Seat 5: 12311985 ($12.11 in chips) 
Seat 6: Pablo7-Pro ($20.86 in chips) 
delbergg: posts small blind $0.05
AM740RU: posts big blind $0.10
*** HOLE CARDS ***
StarkomT3ob: raises $0.21 to $0.31
whtocean: folds 
12311985: folds 
Pablo7-Pro: folds 
delbergg: folds 
AM740RU: folds 
Uncalled bet ($0.21) returned to StarkomT3ob
StarkomT3ob collected $0.25 from pot
StarkomT3ob: doesn't show hand 
*** SUMMARY ***
Total pot $0.25 | Rake $0 
Seat 1: delbergg (small blind) folded before Flop
Seat 2: AM740RU (big blind) folded before Flop
Seat 3: StarkomT3ob collected ($0.25)
Seat 4: whtocean folded before Flop (didn't bet)
Seat 5: 12311985 folded before Flop (didn't bet)
Seat 6: Pablo7-Pro (button) folded before Flop (didn't bet)



PokerStars Hand #222946709956:  Hold'em No Limit ($0.05/$0.10 USD) - 2021/01/23 2:15:24 ET
Table 'Polydoros II' 6-max Seat #1 is the button
Seat 1: delbergg ($10.61 in chips) 
Seat 2: AM740RU ($11.65 in chips) 
Seat 3: StarkomT3ob ($10.52 in chips) 
Seat 4: whtocean ($14.10 in chips) 
Seat 5: 12311985 ($12.11 in chips) 
Seat 6: Pablo7-Pro ($20.86 in chips) 
AM740RU: posts small blind $0.05
StarkomT3ob: posts big blind $0.10
*** HOLE CARDS ***
whtocean: folds 
12311985: folds 
Pablo7-Pro: folds 
delbergg: raises $0.15 to $0.25
AM740RU: calls $0.20
StarkomT3ob: folds 
*** FLOP *** [Qh Th 7d]
AM740RU: checks 
delbergg: checks 
*** TURN *** [Qh Th 7d] [5c]
AM740RU: checks 
delbergg: checks 
*** RIVER *** [Qh Th 7d 5c] [Ad]
AM740RU: checks 
delbergg: bets $0.38
AM740RU: folds 
Uncalled bet ($0.38) returned to delbergg
delbergg collected $0.57 from pot
*** SUMMARY ***
Total pot $0.60 | Rake $0.03 
Board [Qh Th 7d 5c Ad]
Seat 1: delbergg (button) collected ($0.57)
Seat 2: AM740RU (small blind) folded on the River
Seat 3: StarkomT3ob (big blind) folded before Flop
Seat 4: whtocean folded before Flop (didn't bet)
Seat 5: 12311985 folded before Flop (didn't bet)
Seat 6: Pablo7-Pro folded before Flop (didn't bet)



PokerStars Hand #222946718292:  Hold'em No Limit ($0.05/$0.10 USD) - 2021/01/23 2:15:59 ET
Table 'Polydoros II' 6-max Seat #2 is the button
Seat 1: delbergg ($10.93 in chips) 
Seat 2: AM740RU ($11.40 in chips) 
Seat 3: StarkomT3ob ($10.42 in chips) 
Seat 4: whtocean ($14.10 in chips) 
Seat 5: 12311985 ($12.11 in chips) 
Seat 6: Pablo7-Pro ($20.86 in chips) 
StarkomT3ob: posts small blind $0.05
whtocean: posts big blind $0.10
*** HOLE CARDS ***
12311985: folds 
Pablo7-Pro: folds 
delbergg: folds 
AM740RU: folds 
StarkomT3ob: folds 
Uncalled bet ($0.05) returned to whtocean
whtocean collected $0.10 from pot
whtocean: doesn't show hand 
*** SUMMARY ***
Total pot $0.10 | Rake $0 
Seat 1: delbergg folded before Flop (didn't bet)
Seat 2: AM740RU (button) folded before Flop (didn't bet)
Seat 3: StarkomT3ob (small blind) folded before Flop
Seat 4: whtocean (big blind) collected ($0.10)
Seat 5: 12311985 folded before Flop (didn't bet)
Seat 6: Pablo7-Pro folded before Flop (didn't bet)



PokerStars Hand #222946720444:  Hold'em No Limit ($0.05/$0.10 USD) - 2021/01/23 2:16:09 ET
Table 'Polydoros II' 6-max Seat #3 is the button
Seat 1: delbergg ($10.93 in chips) 
Seat 2: AM740RU ($11.40 in chips) 
Seat 3: StarkomT3ob ($10.37 in chips) 
Seat 4: whtocean ($14.15 in chips) 
Seat 5: 12311985 ($12.11 in chips) 
Seat 6: Pablo7-Pro ($20.86 in chips) 
whtocean: posts small blind $0.05
12311985: posts big blind $0.10
*** HOLE CARDS ***
Pablo7-Pro: raises $0.20 to $0.30
delbergg: folds 
AM740RU: folds 
StarkomT3ob: folds 
whtocean: folds 
12311985: folds 
Uncalled bet ($0.20) returned to Pablo7-Pro
Pablo7-Pro collected $0.25 from pot
Pablo7-Pro: doesn't show hand 
*** SUMMARY ***
Total pot $0.25 | Rake $0 
Seat 1: delbergg folded before Flop (didn't bet)
Seat 2: AM740RU folded before Flop (didn't bet)
Seat 3: StarkomT3ob (button) folded before Flop (didn't bet)
Seat 4: whtocean (small blind) folded before Flop
Seat 5: 12311985 (big blind) folded before Flop
Seat 6: Pablo7-Pro collected ($0.25)



PokerStars Hand #222946723314:  Hold'em No Limit ($0.05/$0.10 USD) - 2021/01/23 2:16:21 ET
Table 'Polydoros II' 6-max Seat #4 is the button
Seat 1: delbergg ($10.93 in chips) 
Seat 2: AM740RU ($11.40 in chips) 
Seat 3: StarkomT3ob ($10.37 in chips) 
Seat 4: whtocean ($14.10 in chips) 
Seat 5: 12311985 ($12.01 in chips) 
Seat 6: Pablo7-Pro ($21.01 in chips) 
12311985: posts small blind $0.05
Pablo7-Pro: posts big blind $0.10
*** HOLE CARDS ***
delbergg: raises $0.15 to $0.25
AM740RU: folds 
StarkomT3ob: folds 
whtocean: folds 
12311985: folds 
Pablo7-Pro: folds 
Uncalled bet ($0.15) returned to delbergg
delbergg collected $0.25 from pot
*** SUMMARY ***
Total pot $0.25 | Rake $0 
Seat 1: delbergg collected ($0.25)
Seat 2: AM740RU folded before Flop (didn't bet)
Seat 3: StarkomT3ob folded before Flop (didn't bet)
Seat 4: whtocean (button) folded before Flop (didn't bet)
Seat 5: 12311985 (small blind) folded before Flop
Seat 6: Pablo7-Pro (big blind) folded before Flop



PokerStars Hand #222946728383:  Hold'em No Limit ($0.05/$0.10 USD) - 2021/01/23 2:16:42 ET
Table 'Polydoros II' 6-max Seat #5 is the button
Seat 1: delbergg ($11.08 in chips) 
Seat 2: AM740RU ($11.40 in chips) 
Seat 3: StarkomT3ob ($10.37 in chips) 
Seat 4: whtocean ($14.10 in chips) 
Seat 5: 12311985 ($11.96 in chips) 
Seat 6: Pablo7-Pro ($20.91 in chips) 
Pablo7-Pro: posts small blind $0.05
delbergg: posts big blind $0.10
*** HOLE CARDS ***
AM740RU: folds 
StarkomT3ob: folds 
whtocean: raises $0.15 to $0.25
12311985: calls $0.25
Pablo7-Pro: folds 
delbergg: folds 
*** FLOP *** [9h 3h Kh]
whtocean: checks 
12311985: bets $0.19
whtocean: folds 
Uncalled bet ($0.19) returned to 12311985
12311985 collected $0.62 from pot
12311985: doesn't show hand 
*** SUMMARY ***
Total pot $0.65 | Rake $0.03 
Board [9h 3h Kh]
Seat 1: delbergg (big blind) folded before Flop
Seat 2: AM740RU folded before Flop (didn't bet)
Seat 3: StarkomT3ob folded before Flop (didn't bet)
Seat 4: whtocean folded on the Flop
Seat 5: 12311985 (button) collected ($0.62)
Seat 6: Pablo7-Pro (small blind) folded before Flop



PokerStars Hand #222946734407:  Hold'em No Limit ($0.05/$0.10 USD) - 2021/01/23 2:17:08 ET
Table 'Polydoros II' 6-max Seat #6 is the button
Seat 1: delbergg ($10.98 in chips) 
Seat 2: AM740RU ($11.40 in chips) 
Seat 3: StarkomT3ob ($10.37 in chips) 
Seat 4: whtocean ($13.85 in chips) 
Seat 5: 12311985 ($12.33 in chips) 
Seat 6: Pablo7-Pro ($20.86 in chips) 
delbergg: posts small blind $0.05
AM740RU: posts big blind $0.10
*** HOLE CARDS ***
StarkomT3ob: folds 
whtocean: raises $0.20 to $0.30
12311985: folds 
Pablo7-Pro: folds 
delbergg: folds 
AM740RU: folds 
Uncalled bet ($0.20) returned to whtocean
whtocean collected $0.25 from pot
whtocean: doesn't show hand 
*** SUMMARY ***
Total pot $0.25 | Rake $0 
Seat 1: delbergg (small blind) folded before Flop
Seat 2: AM740RU (big blind) folded before Flop
Seat 3: StarkomT3ob folded before Flop (didn't bet)
Seat 4: whtocean collected ($0.25)
Seat 5: 12311985 folded before Flop (didn't bet)
Seat 6: Pablo7-Pro (button) folded before Flop (didn't bet)



PokerStars Hand #222946738496:  Hold'em No Limit ($0.05/$0.10 USD) - 2021/01/23 2:17:26 ET
Table 'Polydoros II' 6-max Seat #1 is the button
Seat 1: delbergg ($10.93 in chips) 
Seat 2: AM740RU ($11.30 in chips) 
Seat 3: StarkomT3ob ($10.37 in chips) 
Seat 4: whtocean ($14 in chips) 
Seat 5: 12311985 ($12.33 in chips) 
Seat 6: Pablo7-Pro ($20.86 in chips) 
AM740RU: posts small blind $0.05
StarkomT3ob: posts big blind $0.10
*** HOLE CARDS ***
whtocean: folds 
12311985: folds 
Pablo7-Pro: folds 
delbergg: folds 
AM740RU: raises $0.20 to $0.30
StarkomT3ob: raises $0.60 to $0.90
AM740RU: raises $10.40 to $11.30 and is all-in
StarkomT3ob: folds 
Uncalled bet ($10.40) returned to AM740RU
AM740RU collected $1.80 from pot
AM740RU: doesn't show hand 
*** SUMMARY ***
Total pot $1.80 | Rake $0 
Seat 1: delbergg (button) folded before Flop (didn't bet)
Seat 2: AM740RU (small blind) collected ($1.80)
Seat 3: StarkomT3ob (big blind) folded before Flop
Seat 4: whtocean folded before Flop (didn't bet)
Seat 5: 12311985 folded before Flop (didn't bet)
Seat 6: Pablo7-Pro folded before Flop (didn't bet)



PokerStars Hand #222946743615:  Hold'em No Limit ($0.05/$0.10 USD) - 2021/01/23 2:17:47 ET
Table 'Polydoros II' 6-max Seat #2 is the button
Seat 1: delbergg ($10.93 in chips) 
Seat 2: AM740RU ($12.20 in chips) 
Seat 3: StarkomT3ob ($10 in chips) 
Seat 4: whtocean ($14 in chips) 
Seat 5: 12311985 ($12.33 in chips) 
Seat 6: Pablo7-Pro ($20.86 in chips) 
StarkomT3ob: posts small blind $0.05
whtocean: posts big blind $0.10
*** HOLE CARDS ***
12311985: raises $0.15 to $0.25
Pablo7-Pro: folds 
delbergg: folds 
AM740RU: folds 
StarkomT3ob: folds 
whtocean: folds 
Uncalled bet ($0.15) returned to 12311985
12311985 collected $0.25 from pot
12311985: doesn't show hand 
*** SUMMARY ***
Total pot $0.25 | Rake $0 
Seat 1: delbergg folded before Flop (didn't bet)
Seat 2: AM740RU (button) folded before Flop (didn't bet)
Seat 3: StarkomT3ob (small blind) folded before Flop
Seat 4: whtocean (big blind) folded before Flop
Seat 5: 12311985 collected ($0.25)
Seat 6: Pablo7-Pro folded before Flop (didn't bet)



PokerStars Hand #222946746710:  Hold'em No Limit ($0.05/$0.10 USD) - 2021/01/23 2:18:01 ET
Table 'Polydoros II' 6-max Seat #3 is the button
Seat 1: delbergg ($10.93 in chips) 
Seat 2: AM740RU ($12.20 in chips) 
Seat 3: StarkomT3ob ($10 in chips) 
Seat 4: whtocean ($13.90 in chips) 
Seat 5: 12311985 ($12.48 in chips) 
Seat 6: Pablo7-Pro ($20.86 in chips) 
whtocean: posts small blind $0.05
12311985: posts big blind $0.10
*** HOLE CARDS ***
Pablo7-Pro: folds 
delbergg: folds 
AM740RU: folds 
StarkomT3ob: folds 
whtocean: folds 
Uncalled bet ($0.05) returned to 12311985
12311985 collected $0.10 from pot
12311985: doesn't show hand 
*** SUMMARY ***
Total pot $0.10 | Rake $0 
Seat 1: delbergg folded before Flop (didn't bet)
Seat 2: AM740RU folded before Flop (didn't bet)
Seat 3: StarkomT3ob (button) folded before Flop (didn't bet)
Seat 4: whtocean (small blind) folded before Flop
Seat 5: 12311985 (big blind) collected ($0.10)
Seat 6: Pablo7-Pro folded before Flop (didn't bet)



PokerStars Hand #222946751150:  Hold'em No Limit ($0.05/$0.10 USD) - 2021/01/23 2:18:20 ET
Table 'Polydoros II' 6-max Seat #4 is the button
Seat 1: delbergg ($10.93 in chips) 
Seat 2: AM740RU ($12.20 in chips) 
Seat 3: StarkomT3ob ($10 in chips) 
Seat 4: whtocean ($13.85 in chips) 
Seat 5: 12311985 ($12.53 in chips) 
Seat 6: Pablo7-Pro ($20.86 in chips) 
12311985: posts small blind $0.05
Pablo7-Pro: posts big blind $0.10
*** HOLE CARDS ***
delbergg: folds 
AM740RU: calls $0.10
StarkomT3ob: calls $0.10
whtocean: folds 
12311985: folds 
Pablo7-Pro: checks 
*** FLOP *** [Ad Ks 5h]
Pablo7-Pro: checks 
AM740RU: checks 
StarkomT3ob: checks 
*** TURN *** [Ad Ks 5h] [2d]
Pablo7-Pro: checks 
AM740RU: checks 
StarkomT3ob: checks 
*** RIVER *** [Ad Ks 5h 2d] [7d]
Pablo7-Pro: checks 
AM740RU: bets $0.10
StarkomT3ob: folds 
Pablo7-Pro: folds 
Uncalled bet ($0.10) returned to AM740RU
AM740RU collected $0.33 from pot
AM740RU: doesn't show hand 
*** SUMMARY ***
Total pot $0.35 | Rake $0.02 
Board [Ad Ks 5h 2d 7d]
Seat 1: delbergg folded before Flop (didn't bet)
Seat 2: AM740RU collected ($0.33)
Seat 3: StarkomT3ob folded on the River
Seat 4: whtocean (button) folded before Flop (didn't bet)
Seat 5: 12311985 (small blind) folded before Flop
Seat 6: Pablo7-Pro (big blind) folded on the River



PokerStars Hand #222946762968:  Hold'em No Limit ($0.05/$0.10 USD) - 2021/01/23 2:19:10 ET
Table 'Polydoros II' 6-max Seat #5 is the button
Seat 1: delbergg ($10.93 in chips) 
Seat 2: AM740RU ($12.43 in chips) 
Seat 3: StarkomT3ob ($10 in chips) 
Seat 4: whtocean ($13.85 in chips) 
Seat 5: 12311985 ($12.48 in chips) 
Seat 6: Pablo7-Pro ($20.76 in chips) 
Pablo7-Pro: posts small blind $0.05
delbergg: posts big blind $0.10
*** HOLE CARDS ***
AM740RU: folds 
StarkomT3ob: folds 
whtocean: folds 
12311985: folds 
Pablo7-Pro: raises $0.20 to $0.30
delbergg: calls $0.20
*** FLOP *** [Kh 9c 8h]
Pablo7-Pro: checks 
delbergg: checks 
*** TURN *** [Kh 9c 8h] [9h]
Pablo7-Pro: checks 
delbergg: bets $0.40
Pablo7-Pro: calls $0.40
*** RIVER *** [Kh 9c 8h 9h] [Jh]
Pablo7-Pro: checks 
delbergg: bets $1.50
Pablo7-Pro: calls $1.50
*** SHOW DOWN ***
delbergg: shows [Qd 6c] (a pair of Nines)
Pablo7-Pro: shows [Ah 8c] (a flush, Ace high)
Pablo7-Pro collected $4.20 from pot
*** SUMMARY ***
Total pot $4.40 | Rake $0.20 
Board [Kh 9c 8h 9h Jh]
Seat 1: delbergg (big blind) showed [Qd 6c] and lost with a pair of Nines
Seat 2: AM740RU folded before Flop (didn't bet)
Seat 3: StarkomT3ob folded before Flop (didn't bet)
Seat 4: whtocean folded before Flop (didn't bet)
Seat 5: 12311985 (button) folded before Flop (didn't bet)
Seat 6: Pablo7-Pro (small blind) showed [Ah 8c] and won ($4.20) with a flush, Ace high



PokerStars Hand #222946775883:  Hold'em No Limit ($0.05/$0.10 USD) - 2021/01/23 2:20:05 ET
Table 'Polydoros II' 6-max Seat #6 is the button
Seat 1: delbergg ($8.73 in chips) 
Seat 2: AM740RU ($12.43 in chips) 
Seat 3: StarkomT3ob ($10 in chips) 
Seat 4: whtocean ($13.85 in chips) 
Seat 5: 12311985 ($12.48 in chips) 
Seat 6: Pablo7-Pro ($22.76 in chips) 
delbergg: posts small blind $0.05
AM740RU: posts big blind $0.10
*** HOLE CARDS ***
StarkomT3ob: folds 
whtocean: folds 
12311985: folds 
Pablo7-Pro: folds 
delbergg: calls $0.05
AM740RU: checks 
*** FLOP *** [Qc Jc 2c]
delbergg: bets $0.10
AM740RU: folds 
Uncalled bet ($0.10) returned to delbergg
delbergg collected $0.19 from pot
delbergg: doesn't show hand 
*** SUMMARY ***
Total pot $0.20 | Rake $0.01 
Board [Qc Jc 2c]
Seat 1: delbergg (small blind) collected ($0.19)
Seat 2: AM740RU (big blind) folded on the Flop
Seat 3: StarkomT3ob folded before Flop (didn't bet)
Seat 4: whtocean folded before Flop (didn't bet)
Seat 5: 12311985 folded before Flop (didn't bet)
Seat 6: Pablo7-Pro (button) folded before Flop (didn't bet)



PokerStars Hand #222946779748:  Hold'em No Limit ($0.05/$0.10 USD) - 2021/01/23 2:20:22 ET
Table 'Polydoros II' 6-max Seat #1 is the button
Seat 1: delbergg ($8.82 in chips) 
Seat 2: AM740RU ($12.33 in chips) 
Seat 3: StarkomT3ob ($10 in chips) 
Seat 4: whtocean ($13.85 in chips) 
Seat 5: 12311985 ($12.48 in chips) 
Seat 6: Pablo7-Pro ($22.76 in chips) 
AM740RU: posts small blind $0.05
StarkomT3ob: posts big blind $0.10
*** HOLE CARDS ***
whtocean: folds 
12311985: folds 
Pablo7-Pro: folds 
delbergg: raises $0.15 to $0.25
AM740RU: folds 
StarkomT3ob: folds 
Uncalled bet ($0.15) returned to delbergg
delbergg collected $0.25 from pot
delbergg: doesn't show hand 
*** SUMMARY ***
Total pot $0.25 | Rake $0 
Seat 1: delbergg (button) collected ($0.25)
Seat 2: AM740RU (small blind) folded before Flop
Seat 3: StarkomT3ob (big blind) folded before Flop
Seat 4: whtocean folded before Flop (didn't bet)
Seat 5: 12311985 folded before Flop (didn't bet)
Seat 6: Pablo7-Pro folded before Flop (didn't bet)



PokerStars Hand #222946782318:  Hold'em No Limit ($0.05/$0.10 USD) - 2021/01/23 2:20:33 ET
Table 'Polydoros II' 6-max Seat #2 is the button
Seat 1: delbergg ($8.97 in chips) 
Seat 2: AM740RU ($12.28 in chips) 
Seat 3: StarkomT3ob ($10 in chips) 
Seat 4: whtocean ($13.85 in chips) 
Seat 5: 12311985 ($12.48 in chips) 
Seat 6: Pablo7-Pro ($22.76 in chips) 
StarkomT3ob: posts small blind $0.05
whtocean: posts big blind $0.10
*** HOLE CARDS ***
12311985: folds 
Pablo7-Pro: folds 
delbergg: folds 
AM740RU: folds 
StarkomT3ob: raises $0.23 to $0.33
whtocean: folds 
Uncalled bet ($0.23) returned to StarkomT3ob
StarkomT3ob collected $0.20 from pot
StarkomT3ob: doesn't show hand 
*** SUMMARY ***
Total pot $0.20 | Rake $0 
Seat 1: delbergg folded before Flop (didn't bet)
Seat 2: AM740RU (button) folded before Flop (didn't bet)
Seat 3: StarkomT3ob (small blind) collected ($0.20)
Seat 4: whtocean (big blind) folded before Flop
Seat 5: 12311985 folded before Flop (didn't bet)
Seat 6: Pablo7-Pro folded before Flop (didn't bet)



PokerStars Hand #222946785268:  Hold'em No Limit ($0.05/$0.10 USD) - 2021/01/23 2:20:45 ET
Table 'Polydoros II' 6-max Seat #3 is the button
Seat 1: delbergg ($8.97 in chips) 
Seat 2: AM740RU ($12.28 in chips) 
Seat 3: StarkomT3ob ($10.10 in chips) 
Seat 4: whtocean ($13.75 in chips) 
Seat 5: 12311985 ($12.48 in chips) 
Seat 6: Pablo7-Pro ($22.76 in chips) 
whtocean: posts small blind $0.05
12311985: posts big blind $0.10
*** HOLE CARDS ***
Pablo7-Pro: folds 
delbergg: raises $0.15 to $0.25
AM740RU: folds 
StarkomT3ob: folds 
whtocean: folds 
12311985: folds 
Uncalled bet ($0.15) returned to delbergg
delbergg collected $0.25 from pot
delbergg: doesn't show hand 
*** SUMMARY ***
Total pot $0.25 | Rake $0 
Seat 1: delbergg collected ($0.25)
Seat 2: AM740RU folded before Flop (didn't bet)
Seat 3: StarkomT3ob (button) folded before Flop (didn't bet)
Seat 4: whtocean (small blind) folded before Flop
Seat 5: 12311985 (big blind) folded before Flop
Seat 6: Pablo7-Pro folded before Flop (didn't bet)



PokerStars Hand #222946789078:  Hold'em No Limit ($0.05/$0.10 USD) - 2021/01/23 2:21:02 ET
Table 'Polydoros II' 6-max Seat #4 is the button
Seat 1: delbergg ($9.12 in chips) 
Seat 2: AM740RU ($12.28 in chips) 
Seat 3: StarkomT3ob ($10.10 in chips) 
Seat 4: whtocean ($13.70 in chips) 
Seat 5: 12311985 ($12.38 in chips) 
Seat 6: Pablo7-Pro ($22.76 in chips) 
12311985: posts small blind $0.05
Pablo7-Pro: posts big blind $0.10
*** HOLE CARDS ***
delbergg: calls $0.10
AM740RU: folds 
StarkomT3ob: folds 
whtocean: folds 
12311985: folds 
Pablo7-Pro: checks 
*** FLOP *** [Td 5s 3c]
Pablo7-Pro: checks 
delbergg: checks 
*** TURN *** [Td 5s 3c] [9c]
Pablo7-Pro: checks 
delbergg: checks 
*** RIVER *** [Td 5s 3c 9c] [9d]
Pablo7-Pro: checks 
delbergg: checks 
*** SHOW DOWN ***
Pablo7-Pro: shows [6s 2c] (a pair of Nines)
delbergg: shows [3d 6d] (two pair, Nines and Threes)
delbergg collected $0.24 from pot
*** SUMMARY ***
Total pot $0.25 | Rake $0.01 
Board [Td 5s 3c 9c 9d]
Seat 1: delbergg showed [3d 6d] and won ($0.24) with two pair, Nines and Threes
Seat 2: AM740RU folded before Flop (didn't bet)
Seat 3: StarkomT3ob folded before Flop (didn't bet)
Seat 4: whtocean (button) folded before Flop (didn't bet)
Seat 5: 12311985 (small blind) folded before Flop
Seat 6: Pablo7-Pro (big blind) showed [6s 2c] and lost with a pair of Nines



PokerStars Hand #222946795848:  Hold'em No Limit ($0.05/$0.10 USD) - 2021/01/23 2:21:31 ET
Table 'Polydoros II' 6-max Seat #5 is the button
Seat 1: delbergg ($9.26 in chips) 
Seat 2: AM740RU ($12.28 in chips) 
Seat 3: StarkomT3ob ($10.10 in chips) 
Seat 4: whtocean ($13.70 in chips) 
Seat 5: 12311985 ($12.33 in chips) 
Seat 6: Pablo7-Pro ($22.66 in chips) 
Pablo7-Pro: posts small blind $0.05
delbergg: posts big blind $0.10
*** HOLE CARDS ***
AM740RU has timed out
AM740RU: folds 
StarkomT3ob: folds 
whtocean: raises $0.15 to $0.25
12311985: calls $0.25
Pablo7-Pro: folds 
delbergg: calls $0.15
*** FLOP *** [Ad 7c Qc]
delbergg: checks 
whtocean: checks 
12311985: checks 
*** TURN *** [Ad 7c Qc] [Ac]
delbergg: bets $0.60
whtocean: folds 
12311985: calls $0.60
*** RIVER *** [Ad 7c Qc Ac] [2d]
delbergg: bets $2.40
12311985: calls $2.40
*** SHOW DOWN ***
delbergg: shows [7s 7d] (a full house, Sevens full of Aces)
12311985: mucks hand 
delbergg collected $6.49 from pot
*** SUMMARY ***
Total pot $6.80 | Rake $0.31 
Board [Ad 7c Qc Ac 2d]
Seat 1: delbergg (big blind) showed [7s 7d] and won ($6.49) with a full house, Sevens full of Aces
Seat 2: AM740RU folded before Flop (didn't bet)
Seat 3: StarkomT3ob folded before Flop (didn't bet)
Seat 4: whtocean folded on the Turn
Seat 5: 12311985 (button) mucked
Seat 6: Pablo7-Pro (small blind) folded before Flop



PokerStars Hand #222946809510:  Hold'em No Limit ($0.05/$0.10 USD) - 2021/01/23 2:22:30 ET
Table 'Polydoros II' 6-max Seat #6 is the button
Seat 1: delbergg ($12.50 in chips) 
Seat 2: AM740RU ($12.28 in chips) 
Seat 3: StarkomT3ob ($10.10 in chips) 
Seat 4: whtocean ($13.45 in chips) 
Seat 5: 12311985 ($10 in chips) 
Seat 6: Pablo7-Pro ($22.61 in chips) 
delbergg: posts small blind $0.05
AM740RU: posts big blind $0.10
*** HOLE CARDS ***
StarkomT3ob: folds 
whtocean: folds 
12311985: folds 
Pablo7-Pro: raises $0.20 to $0.30
delbergg: calls $0.25
AM740RU: folds 
*** FLOP *** [8c Ac Jd]
delbergg: checks 
Pablo7-Pro: checks 
*** TURN *** [8c Ac Jd] [9c]
delbergg: bets $0.70
Pablo7-Pro: calls $0.70
*** RIVER *** [8c Ac Jd 9c] [Qc]
delbergg: checks 
Pablo7-Pro: checks 
*** SHOW DOWN ***
delbergg: shows [8h As] (two pair, Aces and Eights)
Pablo7-Pro: shows [Ad Ts] (a straight, Eight to Queen)
Pablo7-Pro collected $2.01 from pot
*** SUMMARY ***
Total pot $2.10 | Rake $0.09 
Board [8c Ac Jd 9c Qc]
Seat 1: delbergg (small blind) showed [8h As] and lost with two pair, Aces and Eights
Seat 2: AM740RU (big blind) folded before Flop
Seat 3: StarkomT3ob folded before Flop (didn't bet)
Seat 4: whtocean folded before Flop (didn't bet)
Seat 5: 12311985 folded before Flop (didn't bet)
Seat 6: Pablo7-Pro (button) showed [Ad Ts] and won ($2.01) with a straight, Eight to Queen



PokerStars Hand #222946820189:  Hold'em No Limit ($0.05/$0.10 USD) - 2021/01/23 2:23:15 ET
Table 'Polydoros II' 6-max Seat #1 is the button
Seat 1: delbergg ($11.50 in chips) 
Seat 2: AM740RU ($12.18 in chips) 
Seat 3: StarkomT3ob ($10.10 in chips) 
Seat 4: whtocean ($13.45 in chips) 
Seat 5: 12311985 ($10 in chips) 
Seat 6: Pablo7-Pro ($23.62 in chips) 
AM740RU: posts small blind $0.05
StarkomT3ob: posts big blind $0.10
*** HOLE CARDS ***
whtocean: folds 
12311985: folds 
Pablo7-Pro: folds 
delbergg: raises $0.15 to $0.25
AM740RU: calls $0.20
StarkomT3ob: folds 
*** FLOP *** [Ac 8h Jd]
AM740RU: checks 
delbergg: bets $0.18
AM740RU: folds 
Uncalled bet ($0.18) returned to delbergg
delbergg collected $0.57 from pot
delbergg: doesn't show hand 
*** SUMMARY ***
Total pot $0.60 | Rake $0.03 
Board [Ac 8h Jd]
Seat 1: delbergg (button) collected ($0.57)
Seat 2: AM740RU (small blind) folded on the Flop
Seat 3: StarkomT3ob (big blind) folded before Flop
Seat 4: whtocean folded before Flop (didn't bet)
Seat 5: 12311985 folded before Flop (didn't bet)
Seat 6: Pablo7-Pro folded before Flop (didn't bet)



PokerStars Hand #222946825545:  Hold'em No Limit ($0.05/$0.10 USD) - 2021/01/23 2:23:39 ET
Table 'Polydoros II' 6-max Seat #2 is the button
Seat 1: delbergg ($11.82 in chips) 
Seat 2: AM740RU ($11.93 in chips) 
Seat 3: StarkomT3ob ($10 in chips) 
Seat 4: whtocean ($13.45 in chips) 
Seat 5: 12311985 ($10 in chips) 
Seat 6: Pablo7-Pro ($23.62 in chips) 
StarkomT3ob: posts small blind $0.05
whtocean: posts big blind $0.10
*** HOLE CARDS ***
12311985: folds 
Pablo7-Pro: folds 
delbergg: raises $0.15 to $0.25
AM740RU: folds 
StarkomT3ob: folds 
whtocean: folds 
Uncalled bet ($0.15) returned to delbergg
delbergg collected $0.25 from pot
*** SUMMARY ***
Total pot $0.25 | Rake $0 
Seat 1: delbergg collected ($0.25)
Seat 2: AM740RU (button) folded before Flop (didn't bet)
Seat 3: StarkomT3ob (small blind) folded before Flop
Seat 4: whtocean (big blind) folded before Flop
Seat 5: 12311985 folded before Flop (didn't bet)
Seat 6: Pablo7-Pro folded before Flop (didn't bet)



PokerStars Hand #222946829417:  Hold'em No Limit ($0.05/$0.10 USD) - 2021/01/23 2:23:56 ET
Table 'Polydoros II' 6-max Seat #3 is the button
Seat 1: delbergg ($11.97 in chips) 
Seat 2: AM740RU ($11.93 in chips) 
Seat 3: StarkomT3ob ($10 in chips) 
Seat 4: whtocean ($13.35 in chips) 
Seat 5: 12311985 ($10 in chips) 
Seat 6: Pablo7-Pro ($23.62 in chips) 
whtocean: posts small blind $0.05
12311985: posts big blind $0.10
*** HOLE CARDS ***
Pablo7-Pro: folds 
delbergg: raises $0.15 to $0.25
AM740RU: folds 
StarkomT3ob: folds 
whtocean: folds 
12311985: calls $0.15
*** FLOP *** [Ac Js 7c]
12311985: checks 
delbergg: bets $0.35
12311985: calls $0.35
*** TURN *** [Ac Js 7c] [4s]
12311985: checks 
delbergg: checks 
*** RIVER *** [Ac Js 7c 4s] [Qh]
12311985: checks 
delbergg: checks 
*** SHOW DOWN ***
12311985: shows [Ad Td] (a pair of Aces)
delbergg: mucks hand 
12311985 collected $1.19 from pot
*** SUMMARY ***
Total pot $1.25 | Rake $0.06 
Board [Ac Js 7c 4s Qh]
Seat 1: delbergg mucked
Seat 2: AM740RU folded before Flop (didn't bet)
Seat 3: StarkomT3ob (button) folded before Flop (didn't bet)
Seat 4: whtocean (small blind) folded before Flop
Seat 5: 12311985 (big blind) showed [Ad Td] and won ($1.19) with a pair of Aces
Seat 6: Pablo7-Pro folded before Flop (didn't bet)



PokerStars Hand #222946836665:  Hold'em No Limit ($0.05/$0.10 USD) - 2021/01/23 2:24:27 ET
Table 'Polydoros II' 6-max Seat #4 is the button
Seat 1: delbergg ($11.37 in chips) 
Seat 2: AM740RU ($11.93 in chips) 
Seat 3: StarkomT3ob ($10 in chips) 
Seat 4: whtocean ($13.30 in chips) 
Seat 5: 12311985 ($10.59 in chips) 
Seat 6: Pablo7-Pro ($23.62 in chips) 
12311985: posts small blind $0.05
Pablo7-Pro: posts big blind $0.10
*** HOLE CARDS ***
delbergg: folds 
AM740RU: folds 
StarkomT3ob: folds 
whtocean: folds 
12311985: folds 
Uncalled bet ($0.05) returned to Pablo7-Pro
Pablo7-Pro collected $0.10 from pot
Pablo7-Pro: doesn't show hand 
*** SUMMARY ***
Total pot $0.10 | Rake $0 
Seat 1: delbergg folded before Flop (didn't bet)
Seat 2: AM740RU folded before Flop (didn't bet)
Seat 3: StarkomT3ob folded before Flop (didn't bet)
Seat 4: whtocean (button) folded before Flop (didn't bet)
Seat 5: 12311985 (small blind) folded before Flop
Seat 6: Pablo7-Pro (big blind) collected ($0.10)



PokerStars Hand #222946840987:  Hold'em No Limit ($0.05/$0.10 USD) - 2021/01/23 2:24:45 ET
Table 'Polydoros II' 6-max Seat #5 is the button
Seat 1: delbergg ($11.37 in chips) 
Seat 2: AM740RU ($11.93 in chips) 
Seat 3: StarkomT3ob ($10 in chips) 
Seat 4: whtocean ($13.30 in chips) 
Seat 5: 12311985 ($10.54 in chips) 
Seat 6: Pablo7-Pro ($23.67 in chips) 
Pablo7-Pro: posts small blind $0.05
delbergg: posts big blind $0.10
*** HOLE CARDS ***
AM740RU: folds 
StarkomT3ob: folds 
whtocean: raises $0.15 to $0.25
12311985: folds 
Pablo7-Pro: folds 
delbergg: folds 
Uncalled bet ($0.15) returned to whtocean
whtocean collected $0.25 from pot
whtocean: doesn't show hand 
*** SUMMARY ***
Total pot $0.25 | Rake $0 
Seat 1: delbergg (big blind) folded before Flop
Seat 2: AM740RU folded before Flop (didn't bet)
Seat 3: StarkomT3ob folded before Flop (didn't bet)
Seat 4: whtocean collected ($0.25)
Seat 5: 12311985 (button) folded before Flop (didn't bet)
Seat 6: Pablo7-Pro (small blind) folded before Flop



PokerStars Hand #222946847773:  Hold'em No Limit ($0.05/$0.10 USD) - 2021/01/23 2:25:15 ET
Table 'Polydoros II' 6-max Seat #6 is the button
Seat 1: delbergg ($11.27 in chips) 
Seat 2: AM740RU ($11.93 in chips) 
Seat 3: StarkomT3ob ($10 in chips) 
Seat 4: whtocean ($13.45 in chips) 
Seat 5: 12311985 ($10.54 in chips) 
Seat 6: Pablo7-Pro ($23.62 in chips) 
delbergg: posts small blind $0.05
AM740RU: posts big blind $0.10
*** HOLE CARDS ***
StarkomT3ob: folds 
whtocean: folds 
12311985: folds 
Pablo7-Pro: folds 
delbergg: raises $0.20 to $0.30
AM740RU: folds 
Uncalled bet ($0.20) returned to delbergg
delbergg collected $0.20 from pot
delbergg: doesn't show hand 
*** SUMMARY ***
Total pot $0.20 | Rake $0 
Seat 1: delbergg (small blind) collected ($0.20)
Seat 2: AM740RU (big blind) folded before Flop
Seat 3: StarkomT3ob folded before Flop (didn't bet)
Seat 4: whtocean folded before Flop (didn't bet)
Seat 5: 12311985 folded before Flop (didn't bet)
Seat 6: Pablo7-Pro (button) folded before Flop (didn't bet)



PokerStars Hand #222946850856:  Hold'em No Limit ($0.05/$0.10 USD) - 2021/01/23 2:25:28 ET
Table 'Polydoros II' 6-max Seat #1 is the button
Seat 1: delbergg ($11.37 in chips) 
Seat 2: AM740RU ($11.83 in chips) 
Seat 3: StarkomT3ob ($10 in chips) 
Seat 4: whtocean ($13.45 in chips) 
Seat 5: 12311985 ($10.54 in chips) 
Seat 6: Pablo7-Pro ($23.62 in chips) 
AM740RU: posts small blind $0.05
StarkomT3ob: posts big blind $0.10
*** HOLE CARDS ***
whtocean: folds 
12311985: folds 
Pablo7-Pro: raises $0.20 to $0.30
delbergg: folds 
AM740RU: folds 
StarkomT3ob: folds 
Uncalled bet ($0.20) returned to Pablo7-Pro
Pablo7-Pro collected $0.25 from pot
Pablo7-Pro: doesn't show hand 
*** SUMMARY ***
Total pot $0.25 | Rake $0 
Seat 1: delbergg (button) folded before Flop (didn't bet)
Seat 2: AM740RU (small blind) folded before Flop
Seat 3: StarkomT3ob (big blind) folded before Flop
Seat 4: whtocean folded before Flop (didn't bet)
Seat 5: 12311985 folded before Flop (didn't bet)
Seat 6: Pablo7-Pro collected ($0.25)



PokerStars Hand #222946854677:  Hold'em No Limit ($0.05/$0.10 USD) - 2021/01/23 2:25:45 ET
Table 'Polydoros II' 6-max Seat #2 is the button
Seat 1: delbergg ($11.37 in chips) 
Seat 2: AM740RU ($11.78 in chips) 
Seat 3: StarkomT3ob ($10 in chips) 
Seat 4: whtocean ($13.45 in chips) 
Seat 5: 12311985 ($10.54 in chips) 
Seat 6: Pablo7-Pro ($23.77 in chips) 
StarkomT3ob: posts small blind $0.05
whtocean: posts big blind $0.10
*** HOLE CARDS ***
12311985: folds 
Pablo7-Pro: folds 
delbergg: folds 
AM740RU: folds 
StarkomT3ob: raises $0.23 to $0.33
whtocean: folds 
Uncalled bet ($0.23) returned to StarkomT3ob
StarkomT3ob collected $0.20 from pot
StarkomT3ob: doesn't show hand 
*** SUMMARY ***
Total pot $0.20 | Rake $0 
Seat 1: delbergg folded before Flop (didn't bet)
Seat 2: AM740RU (button) folded before Flop (didn't bet)
Seat 3: StarkomT3ob (small blind) collected ($0.20)
Seat 4: whtocean (big blind) folded before Flop
Seat 5: 12311985 folded before Flop (didn't bet)
Seat 6: Pablo7-Pro folded before Flop (didn't bet)



PokerStars Hand #222946857665:  Hold'em No Limit ($0.05/$0.10 USD) - 2021/01/23 2:25:58 ET
Table 'Polydoros II' 6-max Seat #3 is the button
Seat 1: delbergg ($11.37 in chips) 
Seat 2: AM740RU ($11.78 in chips) 
Seat 3: StarkomT3ob ($10.10 in chips) 
Seat 4: whtocean ($13.35 in chips) 
Seat 5: 12311985 ($10.54 in chips) 
Seat 6: Pablo7-Pro ($23.77 in chips) 
whtocean: posts small blind $0.05
12311985: posts big blind $0.10
*** HOLE CARDS ***
Pablo7-Pro: folds 
delbergg has timed out
delbergg: folds 
AM740RU: folds 
StarkomT3ob: raises $0.22 to $0.32
whtocean: folds 
12311985: folds 
Uncalled bet ($0.22) returned to StarkomT3ob
StarkomT3ob collected $0.25 from pot
StarkomT3ob: doesn't show hand 
*** SUMMARY ***
Total pot $0.25 | Rake $0 
Seat 1: delbergg folded before Flop (didn't bet)
Seat 2: AM740RU folded before Flop (didn't bet)
Seat 3: StarkomT3ob (button) collected ($0.25)
Seat 4: whtocean (small blind) folded before Flop
Seat 5: 12311985 (big blind) folded before Flop
Seat 6: Pablo7-Pro folded before Flop (didn't bet)



PokerStars Hand #222946862984:  Hold'em No Limit ($0.05/$0.10 USD) - 2021/01/23 2:26:21 ET
Table 'Polydoros II' 6-max Seat #4 is the button
Seat 2: AM740RU ($11.78 in chips) 
Seat 3: StarkomT3ob ($10.25 in chips) 
Seat 4: whtocean ($13.30 in chips) 
Seat 5: 12311985 ($10.44 in chips) 
Seat 6: Pablo7-Pro ($23.77 in chips) 
12311985: posts small blind $0.05
Pablo7-Pro: posts big blind $0.10
*** HOLE CARDS ***
AM740RU: folds 
StarkomT3ob: folds 
whtocean: raises $0.15 to $0.25
12311985: folds 
Pablo7-Pro: calls $0.15
*** FLOP *** [Kd 9c 7h]
Pablo7-Pro: checks 
whtocean: bets $0.19
Pablo7-Pro: folds 
Uncalled bet ($0.19) returned to whtocean
whtocean collected $0.53 from pot
whtocean: doesn't show hand 
*** SUMMARY ***
Total pot $0.55 | Rake $0.02 
Board [Kd 9c 7h]
Seat 2: AM740RU folded before Flop (didn't bet)
Seat 3: StarkomT3ob folded before Flop (didn't bet)
Seat 4: whtocean (button) collected ($0.53)
Seat 5: 12311985 (small blind) folded before Flop
Seat 6: Pablo7-Pro (big blind) folded on the Flop



PokerStars Hand #222946869990:  Hold'em No Limit ($0.05/$0.10 USD) - 2021/01/23 2:26:52 ET
Table 'Polydoros II' 6-max Seat #5 is the button
Seat 1: delbergg ($11.37 in chips) 
Seat 2: AM740RU ($11.78 in chips) 
Seat 3: StarkomT3ob ($10.25 in chips) 
Seat 4: whtocean ($13.58 in chips) 
Seat 5: 12311985 ($10.39 in chips) 
Seat 6: Pablo7-Pro ($23.52 in chips) 
Pablo7-Pro: posts small blind $0.05
delbergg: posts big blind $0.10
*** HOLE CARDS ***
AM740RU: raises $0.20 to $0.30
StarkomT3ob: folds 
whtocean: folds 
12311985: folds 
Pablo7-Pro: folds 
delbergg: calls $0.20
*** FLOP *** [3h As 5h]
delbergg: checks 
AM740RU: bets $0.10
delbergg: raises $0.54 to $0.64
AM740RU: calls $0.54
*** TURN *** [3h As 5h] [Qc]
delbergg: bets $1.21
AM740RU: folds 
Uncalled bet ($1.21) returned to delbergg
delbergg collected $1.84 from pot
*** SUMMARY ***
Total pot $1.93 | Rake $0.09 
Board [3h As 5h Qc]
Seat 1: delbergg (big blind) collected ($1.84)
Seat 2: AM740RU folded on the Turn
Seat 3: StarkomT3ob folded before Flop (didn't bet)
Seat 4: whtocean folded before Flop (didn't bet)
Seat 5: 12311985 (button) folded before Flop (didn't bet)
Seat 6: Pablo7-Pro (small blind) folded before Flop



PokerStars Hand #222946880825:  Hold'em No Limit ($0.05/$0.10 USD) - 2021/01/23 2:27:38 ET
Table 'Polydoros II' 6-max Seat #6 is the button
Seat 1: delbergg ($12.27 in chips) 
Seat 2: AM740RU ($10.84 in chips) 
Seat 3: StarkomT3ob ($10.25 in chips) 
Seat 4: whtocean ($13.58 in chips) 
Seat 5: 12311985 ($10.39 in chips) 
Seat 6: Pablo7-Pro ($23.47 in chips) 
delbergg: posts small blind $0.05
AM740RU: posts big blind $0.10
*** HOLE CARDS ***
StarkomT3ob: folds 
whtocean: folds 
12311985: folds 
Pablo7-Pro: folds 
delbergg: calls $0.05
AM740RU: raises $0.20 to $0.30
delbergg: calls $0.20
*** FLOP *** [7d 5h 6c]
delbergg: checks 
AM740RU: bets $0.10
delbergg: calls $0.10
*** TURN *** [7d 5h 6c] [6d]
delbergg: checks 
AM740RU: bets $0.10
delbergg: calls $0.10
*** RIVER *** [7d 5h 6c 6d] [2s]
delbergg: checks 
AM740RU: bets $0.30
delbergg: calls $0.30
*** SHOW DOWN ***
AM740RU: shows [Kc Ad] (a pair of Sixes)
delbergg: shows [7c 8s] (two pair, Sevens and Sixes)
delbergg collected $1.53 from pot
*** SUMMARY ***
Total pot $1.60 | Rake $0.07 
Board [7d 5h 6c 6d 2s]
Seat 1: delbergg (small blind) showed [7c 8s] and won ($1.53) with two pair, Sevens and Sixes
Seat 2: AM740RU (big blind) showed [Kc Ad] and lost with a pair of Sixes
Seat 3: StarkomT3ob folded before Flop (didn't bet)
Seat 4: whtocean folded before Flop (didn't bet)
Seat 5: 12311985 folded before Flop (didn't bet)
Seat 6: Pablo7-Pro (button) folded before Flop (didn't bet)



PokerStars Hand #222946891269:  Hold'em No Limit ($0.05/$0.10 USD) - 2021/01/23 2:28:23 ET
Table 'Polydoros II' 6-max Seat #1 is the button
Seat 1: delbergg ($13 in chips) 
Seat 2: AM740RU ($10.04 in chips) 
Seat 3: StarkomT3ob ($10.25 in chips) 
Seat 4: whtocean ($13.58 in chips) 
Seat 5: 12311985 ($10.39 in chips) 
Seat 6: Pablo7-Pro ($23.47 in chips) 
AM740RU: posts small blind $0.05
StarkomT3ob: posts big blind $0.10
*** HOLE CARDS ***
whtocean: raises $0.20 to $0.30
12311985: folds 
Pablo7-Pro: folds 
delbergg: folds 
AM740RU: folds 
StarkomT3ob: calls $0.20
*** FLOP *** [4h Jh Qh]
StarkomT3ob: checks 
whtocean: bets $0.50
StarkomT3ob: calls $0.50
*** TURN *** [4h Jh Qh] [2s]
StarkomT3ob: checks 
whtocean: bets $0.84
StarkomT3ob: calls $0.84
*** RIVER *** [4h Jh Qh 2s] [6s]
StarkomT3ob: checks 
whtocean: checks 
*** SHOW DOWN ***
StarkomT3ob: shows [Qc Ah] (a pair of Queens)
whtocean: shows [4c 4d] (three of a kind, Fours)
whtocean collected $3.18 from pot
*** SUMMARY ***
Total pot $3.33 | Rake $0.15 
Board [4h Jh Qh 2s 6s]
Seat 1: delbergg (button) folded before Flop (didn't bet)
Seat 2: AM740RU (small blind) folded before Flop
Seat 3: StarkomT3ob (big blind) showed [Qc Ah] and lost with a pair of Queens
Seat 4: whtocean showed [4c 4d] and won ($3.18) with three of a kind, Fours
Seat 5: 12311985 folded before Flop (didn't bet)
Seat 6: Pablo7-Pro folded before Flop (didn't bet)



PokerStars Hand #222946907031:  Hold'em No Limit ($0.05/$0.10 USD) - 2021/01/23 2:29:31 ET
Table 'Polydoros II' 6-max Seat #2 is the button
Seat 1: delbergg ($13 in chips) 
Seat 2: AM740RU ($9.99 in chips) 
Seat 3: StarkomT3ob ($10 in chips) 
Seat 4: whtocean ($15.12 in chips) 
Seat 5: 12311985 ($10.39 in chips) 
Seat 6: Pablo7-Pro ($23.47 in chips) 
StarkomT3ob: posts small blind $0.05
whtocean: posts big blind $0.10
*** HOLE CARDS ***
12311985: folds 
Pablo7-Pro: folds 
delbergg: raises $0.15 to $0.25
AM740RU: calls $0.25
StarkomT3ob: folds 
whtocean: calls $0.15
*** FLOP *** [Kd Jc Ac]
whtocean: bets $0.40
delbergg: folds 
AM740RU: calls $0.40
*** TURN *** [Kd Jc Ac] [Qh]
whtocean: checks 
AM740RU: bets $0.10
whtocean: calls $0.10
*** RIVER *** [Kd Jc Ac Qh] [Th]
whtocean: checks 
AM740RU: bets $0.10
whtocean: calls $0.10
*** SHOW DOWN ***
AM740RU: shows [Ad 8h] (a straight, Ten to Ace)
whtocean: shows [Jh Kh] (a straight, Ten to Ace)
whtocean collected $0.96 from pot
AM740RU collected $0.95 from pot
*** SUMMARY ***
Total pot $2 | Rake $0.09 
Board [Kd Jc Ac Qh Th]
Seat 1: delbergg folded on the Flop
Seat 2: AM740RU (button) showed [Ad 8h] and won ($0.95) with a straight, Ten to Ace
Seat 3: StarkomT3ob (small blind) folded before Flop
Seat 4: whtocean (big blind) showed [Jh Kh] and won ($0.96) with a straight, Ten to Ace
Seat 5: 12311985 folded before Flop (didn't bet)
Seat 6: Pablo7-Pro folded before Flop (didn't bet)



PokerStars Hand #222946914070:  Hold'em No Limit ($0.05/$0.10 USD) - 2021/01/23 2:30:01 ET
Table 'Polydoros II' 6-max Seat #3 is the button
Seat 1: delbergg ($12.75 in chips) 
Seat 2: AM740RU ($10.09 in chips) 
Seat 3: StarkomT3ob ($10 in chips) 
Seat 4: whtocean ($15.23 in chips) 
Seat 5: 12311985 ($10.39 in chips) 
Seat 6: Pablo7-Pro ($23.47 in chips) 
whtocean: posts small blind $0.05
12311985: posts big blind $0.10
*** HOLE CARDS ***
Pablo7-Pro: folds 
delbergg: folds 
AM740RU: calls $0.10
StarkomT3ob: folds 
whtocean: folds 
12311985: checks 
*** FLOP *** [8c 7c 2c]
12311985: checks 
AM740RU: checks 
*** TURN *** [8c 7c 2c] [Jc]
12311985: checks 
AM740RU: bets $0.10
12311985: calls $0.10
*** RIVER *** [8c 7c 2c Jc] [9d]
12311985: checks 
AM740RU: bets $0.10
12311985: calls $0.10
*** SHOW DOWN ***
AM740RU: shows [Kd Tc] (a flush, Jack high)
12311985: mucks hand 
AM740RU collected $0.62 from pot
*** SUMMARY ***
Total pot $0.65 | Rake $0.03 
Board [8c 7c 2c Jc 9d]
Seat 1: delbergg folded before Flop (didn't bet)
Seat 2: AM740RU showed [Kd Tc] and won ($0.62) with a flush, Jack high
Seat 3: StarkomT3ob (button) folded before Flop (didn't bet)
Seat 4: whtocean (small blind) folded before Flop
Seat 5: 12311985 (big blind) mucked
Seat 6: Pablo7-Pro folded before Flop (didn't bet)



PokerStars Hand #222946922929:  Hold'em No Limit ($0.05/$0.10 USD) - 2021/01/23 2:30:39 ET
Table 'Polydoros II' 6-max Seat #4 is the button
Seat 1: delbergg ($12.75 in chips) 
Seat 2: AM740RU ($10.41 in chips) 
Seat 3: StarkomT3ob ($10 in chips) 
Seat 4: whtocean ($15.18 in chips) 
Seat 5: 12311985 ($10.09 in chips) 
Seat 6: Pablo7-Pro ($23.47 in chips) 
12311985: posts small blind $0.05
Pablo7-Pro: posts big blind $0.10
*** HOLE CARDS ***
delbergg: folds 
AM740RU: calls $0.10
StarkomT3ob: folds 
StarkomT3ob leaves the table
whtocean: raises $0.20 to $0.30
12311985: folds 
Pablo7-Pro: folds 
AM740RU: calls $0.20
*** FLOP *** [Ac 2h 2c]
AM740RU: checks 
whtocean: checks 
*** TURN *** [Ac 2h 2c] [9d]
AM740RU: bets $0.36
whtocean: calls $0.36
*** RIVER *** [Ac 2h 2c 9d] [Ad]
AM740RU: bets $0.70
whtocean: folds 
Uncalled bet ($0.70) returned to AM740RU
AM740RU collected $1.40 from pot
AM740RU: doesn't show hand 
*** SUMMARY ***
Total pot $1.47 | Rake $0.07 
Board [Ac 2h 2c 9d Ad]
Seat 1: delbergg folded before Flop (didn't bet)
Seat 2: AM740RU collected ($1.40)
Seat 3: StarkomT3ob folded before Flop (didn't bet)
Seat 4: whtocean (button) folded on the River
Seat 5: 12311985 (small blind) folded before Flop
Seat 6: Pablo7-Pro (big blind) folded before Flop



PokerStars Hand #222946937281:  Hold'em No Limit ($0.05/$0.10 USD) - 2021/01/23 2:31:40 ET
Table 'Polydoros II' 6-max Seat #5 is the button
Seat 1: delbergg ($12.75 in chips) 
Seat 2: AM740RU ($11.15 in chips) 
Seat 4: whtocean ($14.52 in chips) 
Seat 5: 12311985 ($10.04 in chips) 
Seat 6: Pablo7-Pro ($23.37 in chips) 
Pablo7-Pro: posts small blind $0.05
delbergg: posts big blind $0.10
*** HOLE CARDS ***
AM740RU: folds 
whtocean: raises $0.15 to $0.25
12311985: folds 
Pablo7-Pro: folds 
delbergg: calls $0.15
*** FLOP *** [5s 7c 9s]
Pugamble joins the table at seat #3 
delbergg: checks 
whtocean: bets $0.40
delbergg: raises $0.88 to $1.28
whtocean: folds 
Uncalled bet ($0.88) returned to delbergg
delbergg collected $1.29 from pot
delbergg: doesn't show hand 
*** SUMMARY ***
Total pot $1.35 | Rake $0.06 
Board [5s 7c 9s]
Seat 1: delbergg (big blind) collected ($1.29)
Seat 2: AM740RU folded before Flop (didn't bet)
Seat 4: whtocean folded on the Flop
Seat 5: 12311985 (button) folded before Flop (didn't bet)
Seat 6: Pablo7-Pro (small blind) folded before Flop



PokerStars Hand #222946943894:  Hold'em No Limit ($0.05/$0.10 USD) - 2021/01/23 2:32:08 ET
Table 'Polydoros II' 6-max Seat #6 is the button
Seat 1: delbergg ($13.39 in chips) 
Seat 2: AM740RU ($11.15 in chips) 
Seat 4: whtocean ($13.87 in chips) 
Seat 5: 12311985 ($10.04 in chips) 
Seat 6: Pablo7-Pro ($23.32 in chips) 
delbergg: posts small blind $0.05
AM740RU: posts big blind $0.10
Pugamble: sits out 
*** HOLE CARDS ***
whtocean: folds 
12311985: raises $0.15 to $0.25
Pablo7-Pro: folds 
delbergg: calls $0.20
AM740RU: calls $0.15
*** FLOP *** [7h 9c 3c]
delbergg: bets $0.48
AM740RU: folds 
12311985: folds 
Uncalled bet ($0.48) returned to delbergg
delbergg collected $0.72 from pot
*** SUMMARY ***
Total pot $0.75 | Rake $0.03 
Board [7h 9c 3c]
Seat 1: delbergg (small blind) collected ($0.72)
Seat 2: AM740RU (big blind) folded on the Flop
Seat 4: whtocean folded before Flop (didn't bet)
Seat 5: 12311985 folded on the Flop
Seat 6: Pablo7-Pro (button) folded before Flop (didn't bet)



PokerStars Hand #222945342901:  Hold'em No Limit ($0.05/$0.10 USD) - 2021/01/23 0:42:07 ET
Table 'Polydoros II' 6-max Seat #6 is the button
Seat 2: fish72o ($10.05 in chips) 
Seat 3: reznor1 ($9.19 in chips) 
Seat 4: Halfyard007 ($14.59 in chips) 
Seat 5: JorgeLemart ($8.91 in chips) 
Seat 6: Pablo7-Pro ($10.60 in chips) 
fish72o: posts small blind $0.05
reznor1: posts big blind $0.10
*** HOLE CARDS ***
Halfyard007: folds 
JorgeLemart: folds 
Pablo7-Pro: folds 
fish72o: raises $0.15 to $0.25
reznor1: folds 
Uncalled bet ($0.15) returned to fish72o
fish72o collected $0.20 from pot
fish72o: doesn't show hand 
*** SUMMARY ***
Total pot $0.20 | Rake $0 
Seat 2: fish72o (small blind) collected ($0.20)
Seat 3: reznor1 (big blind) folded before Flop
Seat 4: Halfyard007 folded before Flop (didn't bet)
Seat 5: JorgeLemart folded before Flop (didn't bet)
Seat 6: Pablo7-Pro (button) folded before Flop (didn't bet)



PokerStars Hand #222945348428:  Hold'em No Limit ($0.05/$0.10 USD) - 2021/01/23 0:42:27 ET
Table 'Polydoros II' 6-max Seat #2 is the button
Seat 2: fish72o ($10.15 in chips) 
Seat 3: reznor1 ($9.09 in chips) 
Seat 4: Halfyard007 ($14.59 in chips) 
Seat 5: JorgeLemart ($8.91 in chips) 
Seat 6: Pablo7-Pro ($10.60 in chips) 
reznor1: posts small blind $0.05
Halfyard007: posts big blind $0.10
*** HOLE CARDS ***
JorgeLemart: raises $0.40 to $0.50
Pablo7-Pro: folds 
fish72o: folds 
reznor1: folds 
Halfyard007: folds 
Uncalled bet ($0.40) returned to JorgeLemart
JorgeLemart collected $0.25 from pot
JorgeLemart: doesn't show hand 
*** SUMMARY ***
Total pot $0.25 | Rake $0 
Seat 2: fish72o (button) folded before Flop (didn't bet)
Seat 3: reznor1 (small blind) folded before Flop
Seat 4: Halfyard007 (big blind) folded before Flop
Seat 5: JorgeLemart collected ($0.25)
Seat 6: Pablo7-Pro folded before Flop (didn't bet)



PokerStars Hand #222945352685:  Hold'em No Limit ($0.05/$0.10 USD) - 2021/01/23 0:42:44 ET
Table 'Polydoros II' 6-max Seat #3 is the button
Seat 2: fish72o ($10.15 in chips) 
Seat 3: reznor1 ($9.04 in chips) 
Seat 4: Halfyard007 ($14.49 in chips) 
Seat 5: JorgeLemart ($9.06 in chips) 
Seat 6: Pablo7-Pro ($10.60 in chips) 
Halfyard007: posts small blind $0.05
JorgeLemart: posts big blind $0.10
*** HOLE CARDS ***
Pablo7-Pro: folds 
fish72o: folds 
reznor1: calls $0.10
Halfyard007: folds 
JorgeLemart: checks 
*** FLOP *** [2d Jc Td]
JorgeLemart is disconnected 
JorgeLemart has timed out while disconnected
JorgeLemart: checks 
reznor1: checks 
*** TURN *** [2d Jc Td] [Ah]
JorgeLemart: checks 
reznor1: checks 
*** RIVER *** [2d Jc Td Ah] [Kc]
JorgeLemart: checks 
reznor1: bets $0.24
JorgeLemart: folds 
Uncalled bet ($0.24) returned to reznor1
reznor1 collected $0.24 from pot
*** SUMMARY ***
Total pot $0.25 | Rake $0.01 
Board [2d Jc Td Ah Kc]
Seat 2: fish72o folded before Flop (didn't bet)
Seat 3: reznor1 (button) collected ($0.24)
Seat 4: Halfyard007 (small blind) folded before Flop
Seat 5: JorgeLemart (big blind) folded on the River
Seat 6: Pablo7-Pro folded before Flop (didn't bet)



PokerStars Hand #222947010275:  Hold'em No Limit ($0.05/$0.10 USD) - 2021/01/23 2:36:52 ET
Table 'Polydoros II' 6-max Seat #6 is the button
Seat 1: delbergg ($22.28 in chips) 
Seat 4: whtocean ($20.43 in chips) 
Seat 5: 12311985 ($10.32 in chips) 
Seat 6: Pablo7-Pro ($22.96 in chips) 
delbergg: posts small blind $0.05
whtocean: posts big blind $0.10
*** HOLE CARDS ***
12311985: folds 
AM740RU leaves the table
Pablo7-Pro: raises $0.20 to $0.30
delbergg: folds 
whtocean: calls $0.20
*** FLOP *** [Qh 2h 2d]
whtocean: checks 
Pablo7-Pro: bets $0.20
whtocean: folds 
Uncalled bet ($0.20) returned to Pablo7-Pro
Pablo7-Pro collected $0.62 from pot
Pablo7-Pro: doesn't show hand 
*** SUMMARY ***
Total pot $0.65 | Rake $0.03 
Board [Qh 2h 2d]
Seat 1: delbergg (small blind) folded before Flop
Seat 4: whtocean (big blind) folded on the Flop
Seat 5: 12311985 folded before Flop (didn't bet)
Seat 6: Pablo7-Pro (button) collected ($0.62)



PokerStars Hand #222947018509:  Hold'em No Limit ($0.05/$0.10 USD) - 2021/01/23 2:37:28 ET
Table 'Polydoros II' 6-max Seat #1 is the button
Seat 1: delbergg ($22.23 in chips) 
Seat 4: whtocean ($20.13 in chips) 
Seat 5: 12311985 ($10.32 in chips) 
Seat 6: Pablo7-Pro ($23.28 in chips) 
whtocean: posts small blind $0.05
12311985: posts big blind $0.10
*** HOLE CARDS ***
Pablo7-Pro: folds 
delbergg: raises $0.15 to $0.25
whtocean: folds 
12311985: folds 
Uncalled bet ($0.15) returned to delbergg
delbergg collected $0.25 from pot
*** SUMMARY ***
Total pot $0.25 | Rake $0 
Seat 1: delbergg (button) collected ($0.25)
Seat 4: whtocean (small blind) folded before Flop
Seat 5: 12311985 (big blind) folded before Flop
Seat 6: Pablo7-Pro folded before Flop (didn't bet)



PokerStars Hand #222947021839:  Hold'em No Limit ($0.05/$0.10 USD) - 2021/01/23 2:37:43 ET
Table 'Polydoros II' 6-max Seat #4 is the button
Seat 1: delbergg ($22.38 in chips) 
Seat 4: whtocean ($20.08 in chips) 
Seat 5: 12311985 ($10.22 in chips) 
Seat 6: Pablo7-Pro ($23.28 in chips) 
12311985: posts small blind $0.05
Pablo7-Pro: posts big blind $0.10
*** HOLE CARDS ***
delbergg: raises $0.15 to $0.25
whtocean: folds 
12311985: folds 
Pablo7-Pro: folds 
Uncalled bet ($0.15) returned to delbergg
delbergg collected $0.25 from pot
*** SUMMARY ***
Total pot $0.25 | Rake $0 
Seat 1: delbergg collected ($0.25)
Seat 4: whtocean (button) folded before Flop (didn't bet)
Seat 5: 12311985 (small blind) folded before Flop
Seat 6: Pablo7-Pro (big blind) folded before Flop



PokerStars Hand #222947028045:  Hold'em No Limit ($0.05/$0.10 USD) - 2021/01/23 2:38:10 ET
Table 'Polydoros II' 6-max Seat #5 is the button
Seat 1: delbergg ($22.53 in chips) 
Seat 4: whtocean ($20.08 in chips) 
Seat 5: 12311985 ($10.17 in chips) 
Seat 6: Pablo7-Pro ($23.18 in chips) 
Pablo7-Pro: posts small blind $0.05
delbergg: posts big blind $0.10
*** HOLE CARDS ***
whtocean: raises $0.15 to $0.25
willworsf joins the table at seat #2 
12311985: folds 
Pablo7-Pro: folds 
delbergg: calls $0.15
*** FLOP *** [3h 6s Th]
delbergg: checks 
whtocean: bets $0.34
delbergg: folds 
Uncalled bet ($0.34) returned to whtocean
whtocean collected $0.53 from pot
whtocean: doesn't show hand 
*** SUMMARY ***
Total pot $0.55 | Rake $0.02 
Board [3h 6s Th]
Seat 1: delbergg (big blind) folded on the Flop
Seat 4: whtocean collected ($0.53)
Seat 5: 12311985 (button) folded before Flop (didn't bet)
Seat 6: Pablo7-Pro (small blind) folded before Flop



PokerStars Hand #222947035264:  Hold'em No Limit ($0.05/$0.10 USD) - 2021/01/23 2:38:41 ET
Table 'Polydoros II' 6-max Seat #6 is the button
Seat 1: delbergg ($22.28 in chips) 
Seat 2: willworsf ($10 in chips) 
Seat 4: whtocean ($20.36 in chips) 
Seat 5: 12311985 ($10.17 in chips) 
Seat 6: Pablo7-Pro ($23.13 in chips) 
delbergg: posts small blind $0.05
willworsf: posts big blind $0.10
*** HOLE CARDS ***
whtocean: folds 
12311985: folds 
Pablo7-Pro: folds 
delbergg: calls $0.05
willworsf: raises $0.20 to $0.30
delbergg: folds 
Uncalled bet ($0.20) returned to willworsf
willworsf collected $0.20 from pot
willworsf: doesn't show hand 
*** SUMMARY ***
Total pot $0.20 | Rake $0 
Seat 1: delbergg (small blind) folded before Flop
Seat 2: willworsf (big blind) collected ($0.20)
Seat 4: whtocean folded before Flop (didn't bet)
Seat 5: 12311985 folded before Flop (didn't bet)
Seat 6: Pablo7-Pro (button) folded before Flop (didn't bet)



PokerStars Hand #222947041843:  Hold'em No Limit ($0.05/$0.10 USD) - 2021/01/23 2:39:09 ET
Table 'Polydoros II' 6-max Seat #1 is the button
Seat 1: delbergg ($22.18 in chips) 
Seat 2: willworsf ($10.10 in chips) 
Seat 4: whtocean ($20.36 in chips) 
Seat 5: 12311985 ($10.17 in chips) 
Seat 6: Pablo7-Pro ($23.13 in chips) 
willworsf: posts small blind $0.05
whtocean: posts big blind $0.10
*** HOLE CARDS ***
12311985: raises $0.15 to $0.25
Pablo7-Pro: folds 
delbergg: folds 
willworsf: calls $0.20
whtocean: folds 
*** FLOP *** [6h 4c 7h]
willworsf: checks 
12311985: checks 
*** TURN *** [6h 4c 7h] [8h]
willworsf: checks 
12311985: checks 
*** RIVER *** [6h 4c 7h 8h] [7s]
willworsf: bets $0.23
12311985: folds 
Uncalled bet ($0.23) returned to willworsf
willworsf collected $0.57 from pot
willworsf: doesn't show hand 
*** SUMMARY ***
Total pot $0.60 | Rake $0.03 
Board [6h 4c 7h 8h 7s]
Seat 1: delbergg (button) folded before Flop (didn't bet)
Seat 2: willworsf (small blind) collected ($0.57)
Seat 4: whtocean (big blind) folded before Flop
Seat 5: 12311985 folded on the River
Seat 6: Pablo7-Pro folded before Flop (didn't bet)



PokerStars Hand #222947052240:  Hold'em No Limit ($0.05/$0.10 USD) - 2021/01/23 2:39:54 ET
Table 'Polydoros II' 6-max Seat #2 is the button
Seat 1: delbergg ($22.18 in chips) 
Seat 2: willworsf ($10.42 in chips) 
Seat 4: whtocean ($20.26 in chips) 
Seat 5: 12311985 ($10 in chips) 
Seat 6: Pablo7-Pro ($23.13 in chips) 
whtocean: posts small blind $0.05
12311985: posts big blind $0.10
*** HOLE CARDS ***
Pablo7-Pro: raises $0.20 to $0.30
delbergg: folds 
willworsf: calls $0.30
whtocean: folds 
12311985: folds 
*** FLOP *** [8d Jd Kd]
Pablo7-Pro: bets $0.24
willworsf: calls $0.24
*** TURN *** [8d Jd Kd] [8h]
Pablo7-Pro: checks 
willworsf: bets $0.60
Pablo7-Pro: calls $0.60
*** RIVER *** [8d Jd Kd 8h] [Ts]
Pablo7-Pro: bets $1.81
willworsf: folds 
Uncalled bet ($1.81) returned to Pablo7-Pro
Pablo7-Pro collected $2.32 from pot
Pablo7-Pro: doesn't show hand 
*** SUMMARY ***
Total pot $2.43 | Rake $0.11 
Board [8d Jd Kd 8h Ts]
Seat 1: delbergg folded before Flop (didn't bet)
Seat 2: willworsf (button) folded on the River
Seat 4: whtocean (small blind) folded before Flop
Seat 5: 12311985 (big blind) folded before Flop
Seat 6: Pablo7-Pro collected ($2.32)



PokerStars Hand #222947062167:  Hold'em No Limit ($0.05/$0.10 USD) - 2021/01/23 2:40:37 ET
Table 'Polydoros II' 6-max Seat #4 is the button
Seat 1: delbergg ($22.18 in chips) 
Seat 2: willworsf ($9.28 in chips) 
Seat 4: whtocean ($20.21 in chips) 
Seat 5: 12311985 ($10 in chips) 
Seat 6: Pablo7-Pro ($24.31 in chips) 
12311985: posts small blind $0.05
Pablo7-Pro: posts big blind $0.10
*** HOLE CARDS ***
delbergg: folds 
willworsf: folds 
whtocean: raises $0.15 to $0.25
12311985: folds 
Pablo7-Pro: folds 
Uncalled bet ($0.15) returned to whtocean
whtocean collected $0.25 from pot
whtocean: doesn't show hand 
*** SUMMARY ***
Total pot $0.25 | Rake $0 
Seat 1: delbergg folded before Flop (didn't bet)
Seat 2: willworsf folded before Flop (didn't bet)
Seat 4: whtocean (button) collected ($0.25)
Seat 5: 12311985 (small blind) folded before Flop
Seat 6: Pablo7-Pro (big blind) folded before Flop



PokerStars Hand #222947068312:  Hold'em No Limit ($0.05/$0.10 USD) - 2021/01/23 2:41:04 ET
Table 'Polydoros II' 6-max Seat #5 is the button
Seat 1: delbergg ($22.18 in chips) 
Seat 2: willworsf ($9.28 in chips) 
Seat 4: whtocean ($20.36 in chips) 
Seat 5: 12311985 ($10 in chips) 
Seat 6: Pablo7-Pro ($24.21 in chips) 
Pablo7-Pro: posts small blind $0.05
delbergg: posts big blind $0.10
*** HOLE CARDS ***
willworsf: calls $0.10
whtocean: folds 
12311985: folds 
Pablo7-Pro: folds 
delbergg: checks 
*** FLOP *** [9s Tc 8c]
delbergg: checks 
willworsf: bets $0.10
delbergg: raises $0.29 to $0.39
willworsf: calls $0.29
*** TURN *** [9s Tc 8c] [4h]
delbergg: bets $1.20
willworsf: calls $1.20
*** RIVER *** [9s Tc 8c 4h] [Qc]
delbergg: checks 
willworsf: bets $3.28
delbergg: folds 
Uncalled bet ($3.28) returned to willworsf
willworsf collected $3.28 from pot
willworsf: doesn't show hand 
*** SUMMARY ***
Total pot $3.43 | Rake $0.15 
Board [9s Tc 8c 4h Qc]
Seat 1: delbergg (big blind) folded on the River
Seat 2: willworsf collected ($3.28)
Seat 4: whtocean folded before Flop (didn't bet)
Seat 5: 12311985 (button) folded before Flop (didn't bet)
Seat 6: Pablo7-Pro (small blind) folded before Flop



PokerStars Hand #222947078574:  Hold'em No Limit ($0.05/$0.10 USD) - 2021/01/23 2:41:48 ET
Table 'Polydoros II' 6-max Seat #6 is the button
Seat 1: delbergg ($20.49 in chips) 
Seat 2: willworsf ($10.87 in chips) 
Seat 4: whtocean ($20.36 in chips) 
Seat 5: 12311985 ($10 in chips) 
Seat 6: Pablo7-Pro ($24.16 in chips) 
delbergg: posts small blind $0.05
willworsf: posts big blind $0.10
*** HOLE CARDS ***
whtocean: raises $0.20 to $0.30
12311985: folds 
Pablo7-Pro: folds 
delbergg: folds 
willworsf: calls $0.20
*** FLOP *** [5h Jc 2c]
willworsf: bets $0.34
whtocean: calls $0.34
*** TURN *** [5h Jc 2c] [3h]
willworsf: bets $0.83
whtocean: calls $0.83
*** RIVER *** [5h Jc 2c 3h] [4h]
willworsf: bets $3.50
whtocean: raises $15.39 to $18.89 and is all-in
willworsf: folds 
Uncalled bet ($15.39) returned to whtocean
whtocean collected $9.54 from pot
whtocean: doesn't show hand 
*** SUMMARY ***
Total pot $9.99 | Rake $0.45 
Board [5h Jc 2c 3h 4h]
Seat 1: delbergg (small blind) folded before Flop
Seat 2: willworsf (big blind) folded on the River
Seat 4: whtocean collected ($9.54)
Seat 5: 12311985 folded before Flop (didn't bet)
Seat 6: Pablo7-Pro (button) folded before Flop (didn't bet)



PokerStars Hand #222947092433:  Hold'em No Limit ($0.05/$0.10 USD) - 2021/01/23 2:42:48 ET
Table 'Polydoros II' 6-max Seat #1 is the button
Seat 1: delbergg ($20.44 in chips) 
Seat 2: willworsf ($5.90 in chips) 
Seat 4: whtocean ($24.93 in chips) 
Seat 5: 12311985 ($10 in chips) 
Seat 6: Pablo7-Pro ($24.16 in chips) 
willworsf: posts small blind $0.05
whtocean: posts big blind $0.10
*** HOLE CARDS ***
12311985: folds 
Pablo7-Pro: folds 
delbergg: raises $0.15 to $0.25
willworsf: calls $0.20
whtocean: folds 
*** FLOP *** [Kh 6h 7s]
willworsf: checks 
delbergg: bets $0.18
willworsf: folds 
Uncalled bet ($0.18) returned to delbergg
delbergg collected $0.57 from pot
Pugamble was removed from the table for failing to post
Pugamble leaves the table
*** SUMMARY ***
Total pot $0.60 | Rake $0.03 
Board [Kh 6h 7s]
Seat 1: delbergg (button) collected ($0.57)
Seat 2: willworsf (small blind) folded on the Flop
Seat 4: whtocean (big blind) folded before Flop
Seat 5: 12311985 folded before Flop (didn't bet)
Seat 6: Pablo7-Pro folded before Flop (didn't bet)



PokerStars Hand #222948001833:  Hold'em No Limit ($0.05/$0.10 USD) - 2021/01/23 3:46:12 ET
Table 'Polydoros II' 6-max Seat #4 is the button
Seat 1: delbergg ($26.46 in chips) 
Seat 2: LM Tate ($8.03 in chips) 
Seat 3: father here ($18.20 in chips) 
Seat 4: Lindst ($11.25 in chips) 
Seat 5: rog3543 ($10 in chips) 
rog3543: posts small blind $0.05
Pablo7-Pro: is sitting out 
delbergg: posts big blind $0.10
*** HOLE CARDS ***
Pablo7-Pro leaves the table
Sergey_Bolos joins the table at seat #6 
LM Tate has timed out
LM Tate: folds 
father here: folds 
Lindst: calls $0.10
LM Tate leaves the table
rog3543: folds 
delbergg: checks 
*** FLOP *** [9c 3h 3c]
GreenChe joins the table at seat #2 
delbergg: checks 
Lindst: bets $0.18
delbergg: folds 
Uncalled bet ($0.18) returned to Lindst
Lindst collected $0.24 from pot
*** SUMMARY ***
Total pot $0.25 | Rake $0.01 
Board [9c 3h 3c]
Seat 1: delbergg (big blind) folded on the Flop
Seat 2: LM Tate folded before Flop (didn't bet)
Seat 3: father here folded before Flop (didn't bet)
Seat 4: Lindst (button) collected ($0.24)
Seat 5: rog3543 (small blind) folded before Flop



PokerStars Hand #222948012177:  Hold'em No Limit ($0.05/$0.10 USD) - 2021/01/23 3:46:54 ET
Table 'Polydoros II' 6-max Seat #5 is the button
Seat 1: delbergg ($26.36 in chips) 
Seat 2: GreenChe ($10 in chips) 
Seat 3: father here ($18.20 in chips) 
Seat 4: Lindst ($11.39 in chips) 
Seat 5: rog3543 ($10 in chips) 
delbergg: posts small blind $0.05
GreenChe: posts big blind $0.10
*** HOLE CARDS ***
father here: folds 
Lindst: folds 
rog3543: raises $0.20 to $0.30
delbergg: folds 
GreenChe: folds 
Uncalled bet ($0.20) returned to rog3543
rog3543 collected $0.25 from pot
rog3543: doesn't show hand 
*** SUMMARY ***
Total pot $0.25 | Rake $0 
Seat 1: delbergg (small blind) folded before Flop
Seat 2: GreenChe (big blind) folded before Flop
Seat 3: father here folded before Flop (didn't bet)
Seat 4: Lindst folded before Flop (didn't bet)
Seat 5: rog3543 (button) collected ($0.25)



PokerStars Hand #222948016854:  Hold'em No Limit ($0.05/$0.10 USD) - 2021/01/23 3:47:13 ET
Table 'Polydoros II' 6-max Seat #1 is the button
Seat 1: delbergg ($26.31 in chips) 
Seat 2: GreenChe ($10 in chips) 
Seat 3: father here ($18.20 in chips) 
Seat 4: Lindst ($11.39 in chips) 
Seat 5: rog3543 ($10.15 in chips) 
GreenChe: posts small blind $0.05
father here: posts big blind $0.10
Sergey_Bolos: sits out 
*** HOLE CARDS ***
Lindst: calls $0.10
rog3543: folds 
delbergg: calls $0.10
GreenChe: calls $0.05
father here: checks 
*** FLOP *** [7s 2d Qh]
GreenChe: checks 
father here: checks 
Lindst: bets $0.29
delbergg: calls $0.29
GreenChe: folds 
father here: folds 
*** TURN *** [7s 2d Qh] [As]
Lindst: bets $0.71
delbergg: folds 
Uncalled bet ($0.71) returned to Lindst
Lindst collected $0.94 from pot
*** SUMMARY ***
Total pot $0.98 | Rake $0.04 
Board [7s 2d Qh As]
Seat 1: delbergg (button) folded on the Turn
Seat 2: GreenChe (small blind) folded on the Flop
Seat 3: father here (big blind) folded on the Flop
Seat 4: Lindst collected ($0.94)
Seat 5: rog3543 folded before Flop (didn't bet)



PokerStars Hand #222948034191:  Hold'em No Limit ($0.05/$0.10 USD) - 2021/01/23 3:48:23 ET
Table 'Polydoros II' 6-max Seat #2 is the button
Seat 1: delbergg ($25.92 in chips) 
Seat 2: GreenChe ($10 in chips) 
Seat 3: father here ($18.10 in chips) 
Seat 4: Lindst ($11.94 in chips) 
Seat 5: rog3543 ($10.15 in chips) 
father here: posts small blind $0.05
Lindst: posts big blind $0.10
Sergey_Bolos: sits out 
*** HOLE CARDS ***
rog3543: folds 
delbergg: raises $0.15 to $0.25
GreenChe: folds 
father here: raises $0.65 to $0.90
Lindst: folds 
delbergg: calls $0.65
*** FLOP *** [6h Kd 7h]
father here: checks 
delbergg: checks 
*** TURN *** [6h Kd 7h] [9d]
father here: checks 
delbergg: checks 
*** RIVER *** [6h Kd 7h 9d] [7d]
father here: bets $0.60
delbergg: raises $1.99 to $2.59
father here: calls $1.99
*** SHOW DOWN ***
delbergg: shows [4d 6d] (a flush, King high)
father here: mucks hand 
delbergg collected $6.76 from pot
*** SUMMARY ***
Total pot $7.08 | Rake $0.32 
Board [6h Kd 7h 9d 7d]
Seat 1: delbergg showed [4d 6d] and won ($6.76) with a flush, King high
Seat 2: GreenChe (button) folded before Flop (didn't bet)
Seat 3: father here (small blind) mucked
Seat 4: Lindst (big blind) folded before Flop
Seat 5: rog3543 folded before Flop (didn't bet)



PokerStars Hand #222948049343:  Hold'em No Limit ($0.05/$0.10 USD) - 2021/01/23 3:49:24 ET
Table 'Polydoros II' 6-max Seat #3 is the button
Seat 1: delbergg ($29.19 in chips) 
Seat 2: GreenChe ($10 in chips) 
Seat 3: father here ($14.61 in chips) 
Seat 4: Lindst ($11.84 in chips) 
Seat 5: rog3543 ($10.15 in chips) 
Lindst: posts small blind $0.05
rog3543: posts big blind $0.10
Sergey_Bolos: sits out 
*** HOLE CARDS ***
delbergg: folds 
GreenChe: folds 
father here: raises $0.25 to $0.35
Lindst: calls $0.30
rog3543: folds 
*** FLOP *** [7h 8s 9d]
Lindst: checks 
father here: bets $0.40
Lindst: calls $0.40
*** TURN *** [7h 8s 9d] [4d]
Lindst: checks 
father here: bets $0.90
Lindst: calls $0.90
*** RIVER *** [7h 8s 9d 4d] [Jd]
Lindst: checks 
father here: bets $0.80
Lindst: folds 
Uncalled bet ($0.80) returned to father here
father here collected $3.25 from pot
*** SUMMARY ***
Total pot $3.40 | Rake $0.15 
Board [7h 8s 9d 4d Jd]
Seat 1: delbergg folded before Flop (didn't bet)
Seat 2: GreenChe folded before Flop (didn't bet)
Seat 3: father here (button) collected ($3.25)
Seat 4: Lindst (small blind) folded on the River
Seat 5: rog3543 (big blind) folded before Flop



PokerStars Hand #222948070500:  Hold'em No Limit ($0.05/$0.10 USD) - 2021/01/23 3:50:49 ET
Table 'Polydoros II' 6-max Seat #4 is the button
Seat 1: delbergg ($29.19 in chips) 
Seat 2: GreenChe ($10 in chips) 
Seat 3: father here ($16.21 in chips) 
Seat 4: Lindst ($10.19 in chips) 
Seat 5: rog3543 ($10.05 in chips) 
Seat 6: Sergey_Bolos ($10 in chips) 
rog3543: posts small blind $0.05
Sergey_Bolos: posts big blind $0.10
*** HOLE CARDS ***
delbergg: folds 
GreenChe: folds 
father here: folds 
Lindst: folds 
rog3543: folds 
Uncalled bet ($0.05) returned to Sergey_Bolos
Sergey_Bolos collected $0.10 from pot
Sergey_Bolos: doesn't show hand 
*** SUMMARY ***
Total pot $0.10 | Rake $0 
Seat 1: delbergg folded before Flop (didn't bet)
Seat 2: GreenChe folded before Flop (didn't bet)
Seat 3: father here folded before Flop (didn't bet)
Seat 4: Lindst (button) folded before Flop (didn't bet)
Seat 5: rog3543 (small blind) folded before Flop
Seat 6: Sergey_Bolos (big blind) collected ($0.10)



PokerStars Hand #222948074212:  Hold'em No Limit ($0.05/$0.10 USD) - 2021/01/23 3:51:04 ET
Table 'Polydoros II' 6-max Seat #5 is the button
Seat 1: delbergg ($29.19 in chips) 
Seat 2: GreenChe ($10 in chips) 
Seat 3: father here ($16.21 in chips) 
Seat 4: Lindst ($10.19 in chips) 
Seat 5: rog3543 ($10 in chips) 
Seat 6: Sergey_Bolos ($10.05 in chips) 
Sergey_Bolos: posts small blind $0.05
delbergg: posts big blind $0.10
*** HOLE CARDS ***
GreenChe: folds 
father here: folds 
Lindst has timed out
Lindst: folds 
rog3543: raises $0.20 to $0.30
Sergey_Bolos: calls $0.25
delbergg: calls $0.20
*** FLOP *** [2h Kd 5d]
Sergey_Bolos: checks 
delbergg: checks 
rog3543: bets $0.33
Sergey_Bolos: folds 
delbergg: folds 
Uncalled bet ($0.33) returned to rog3543
rog3543 collected $0.86 from pot
*** SUMMARY ***
Total pot $0.90 | Rake $0.04 
Board [2h Kd 5d]
Seat 1: delbergg (big blind) folded on the Flop
Seat 2: GreenChe folded before Flop (didn't bet)
Seat 3: father here folded before Flop (didn't bet)
Seat 4: Lindst folded before Flop (didn't bet)
Seat 5: rog3543 (button) collected ($0.86)
Seat 6: Sergey_Bolos (small blind) folded on the Flop



PokerStars Hand #222948084726:  Hold'em No Limit ($0.05/$0.10 USD) - 2021/01/23 3:51:47 ET
Table 'Polydoros II' 6-max Seat #6 is the button
Seat 1: delbergg ($28.89 in chips) 
Seat 2: GreenChe ($10 in chips) 
Seat 3: father here ($16.21 in chips) 
Seat 4: Lindst ($10.19 in chips) 
Seat 5: rog3543 ($10.56 in chips) 
Seat 6: Sergey_Bolos ($10 in chips) 
delbergg: posts small blind $0.05
GreenChe: posts big blind $0.10
*** HOLE CARDS ***
father here: raises $0.20 to $0.30
Lindst: folds 
rog3543: folds 
Sergey_Bolos: calls $0.30
delbergg: calls $0.25
GreenChe: calls $0.20
*** FLOP *** [2c 5s Jh]
delbergg: checks 
GreenChe: bets $0.86
father here: folds 
Sergey_Bolos: calls $0.86
delbergg: folds 
*** TURN *** [2c 5s Jh] [Ks]
GreenChe: bets $1.86
Sergey_Bolos: folds 
Uncalled bet ($1.86) returned to GreenChe
GreenChe collected $2.79 from pot
GreenChe: doesn't show hand 
*** SUMMARY ***
Total pot $2.92 | Rake $0.13 
Board [2c 5s Jh Ks]
Seat 1: delbergg (small blind) folded on the Flop
Seat 2: GreenChe (big blind) collected ($2.79)
Seat 3: father here folded on the Flop
Seat 4: Lindst folded before Flop (didn't bet)
Seat 5: rog3543 folded before Flop (didn't bet)
Seat 6: Sergey_Bolos (button) folded on the Turn



PokerStars Hand #222948101448:  Hold'em No Limit ($0.05/$0.10 USD) - 2021/01/23 3:52:54 ET
Table 'Polydoros II' 6-max Seat #1 is the button
Seat 1: delbergg ($28.59 in chips) 
Seat 2: GreenChe ($11.63 in chips) 
Seat 3: father here ($15.91 in chips) 
Seat 4: Lindst ($10.19 in chips) 
Seat 5: rog3543 ($10.56 in chips) 
Seat 6: Sergey_Bolos ($10 in chips) 
GreenChe: posts small blind $0.05
father here: posts big blind $0.10
*** HOLE CARDS ***
Lindst: folds 
rog3543: folds 
Sergey_Bolos: raises $0.15 to $0.25
delbergg: raises $0.65 to $0.90
GreenChe: folds 
father here: folds 
Sergey_Bolos: folds 
Uncalled bet ($0.65) returned to delbergg
delbergg collected $0.65 from pot
*** SUMMARY ***
Total pot $0.65 | Rake $0 
Seat 1: delbergg (button) collected ($0.65)
Seat 2: GreenChe (small blind) folded before Flop
Seat 3: father here (big blind) folded before Flop
Seat 4: Lindst folded before Flop (didn't bet)
Seat 5: rog3543 folded before Flop (didn't bet)
Seat 6: Sergey_Bolos folded before Flop



PokerStars Hand #222948109486:  Hold'em No Limit ($0.05/$0.10 USD) - 2021/01/23 3:53:26 ET
Table 'Polydoros II' 6-max Seat #2 is the button
Seat 1: delbergg ($28.99 in chips) 
Seat 2: GreenChe ($11.58 in chips) 
Seat 3: father here ($15.81 in chips) 
Seat 4: Lindst ($10.19 in chips) 
Seat 5: rog3543 ($10.56 in chips) 
Seat 6: Sergey_Bolos ($10 in chips) 
father here: posts small blind $0.05
Lindst: posts big blind $0.10
*** HOLE CARDS ***
rog3543: folds 
Sergey_Bolos: raises $0.15 to $0.25
delbergg: raises $0.55 to $0.80
GreenChe: folds 
father here: folds 
Lindst: folds 
Sergey_Bolos: calls $0.55
*** FLOP *** [5h 7c Qd]
Sergey_Bolos: checks 
delbergg: bets $0.52
Sergey_Bolos: calls $0.52
*** TURN *** [5h 7c Qd] [8s]
Sergey_Bolos: checks 
Lindst leaves the table
delbergg: checks 
*** RIVER *** [5h 7c Qd 8s] [6d]
Sergey_Bolos: checks 
Silveradom joins the table at seat #4 
delbergg: checks 
*** SHOW DOWN ***
Sergey_Bolos: shows [As 5s] (a pair of Fives)
delbergg: mucks hand 
Sergey_Bolos collected $2.66 from pot
*** SUMMARY ***
Total pot $2.79 | Rake $0.13 
Board [5h 7c Qd 8s 6d]
Seat 1: delbergg mucked
Seat 2: GreenChe (button) folded before Flop (didn't bet)
Seat 3: father here (small blind) folded before Flop
Seat 4: Lindst (big blind) folded before Flop
Seat 5: rog3543 folded before Flop (didn't bet)
Seat 6: Sergey_Bolos showed [As 5s] and won ($2.66) with a pair of Fives



PokerStars Hand #222948119325:  Hold'em No Limit ($0.05/$0.10 USD) - 2021/01/23 3:54:07 ET
Table 'Polydoros II' 6-max Seat #3 is the button
Seat 1: delbergg ($27.67 in chips) 
Seat 2: GreenChe ($11.58 in chips) 
Seat 3: father here ($15.76 in chips) 
Seat 5: rog3543 ($10.56 in chips) 
Seat 6: Sergey_Bolos ($11.34 in chips) 
rog3543: posts small blind $0.05
Sergey_Bolos: posts big blind $0.10
*** HOLE CARDS ***
delbergg: folds 
GreenChe: folds 
father here: raises $0.20 to $0.30
rog3543: raises $0.90 to $1.20
Sergey_Bolos: folds 
father here: calls $0.90
*** FLOP *** [Kh 9h 6s]
rog3543: bets $1.09
father here: folds 
Uncalled bet ($1.09) returned to rog3543
rog3543 collected $2.39 from pot
rog3543: doesn't show hand 
*** SUMMARY ***
Total pot $2.50 | Rake $0.11 
Board [Kh 9h 6s]
Seat 1: delbergg folded before Flop (didn't bet)
Seat 2: GreenChe folded before Flop (didn't bet)
Seat 3: father here (button) folded on the Flop
Seat 5: rog3543 (small blind) collected ($2.39)
Seat 6: Sergey_Bolos (big blind) folded before Flop



PokerStars Hand #222948126779:  Hold'em No Limit ($0.05/$0.10 USD) - 2021/01/23 3:54:37 ET
Table 'Polydoros II' 6-max Seat #5 is the button
Seat 1: delbergg ($27.67 in chips) 
Seat 2: GreenChe ($11.58 in chips) 
Seat 3: father here ($14.56 in chips) 
Seat 5: rog3543 ($11.75 in chips) 
Seat 6: Sergey_Bolos ($11.24 in chips) 
Sergey_Bolos: posts small blind $0.05
delbergg: posts big blind $0.10
Silveradom: sits out 
*** HOLE CARDS ***
GreenChe: folds 
father here: folds 
rog3543: raises $0.20 to $0.30
Sergey_Bolos: folds 
delbergg: calls $0.20
*** FLOP *** [7d Qs 6c]
delbergg: checks 
rog3543: checks 
*** TURN *** [7d Qs 6c] [6h]
delbergg: bets $0.41
rog3543: calls $0.41
*** RIVER *** [7d Qs 6c 6h] [Tc]
delbergg: bets $0.43
rog3543: raises $0.93 to $1.36
delbergg: calls $0.93
*** SHOW DOWN ***
rog3543: shows [6s 9c] (three of a kind, Sixes)
delbergg: mucks hand 
rog3543 collected $4 from pot
*** SUMMARY ***
Total pot $4.19 | Rake $0.19 
Board [7d Qs 6c 6h Tc]
Seat 1: delbergg (big blind) mucked
Seat 2: GreenChe folded before Flop (didn't bet)
Seat 3: father here folded before Flop (didn't bet)
Seat 5: rog3543 (button) showed [6s 9c] and won ($4) with three of a kind, Sixes
Seat 6: Sergey_Bolos (small blind) folded before Flop



PokerStars Hand #222948136975:  Hold'em No Limit ($0.05/$0.10 USD) - 2021/01/23 3:55:20 ET
Table 'Polydoros II' 6-max Seat #6 is the button
Seat 1: delbergg ($25.60 in chips) 
Seat 2: GreenChe ($11.58 in chips) 
Seat 3: father here ($14.56 in chips) 
Seat 5: rog3543 ($13.68 in chips) 
Seat 6: Sergey_Bolos ($11.19 in chips) 
delbergg: posts small blind $0.05
GreenChe: posts big blind $0.10
Silveradom: sits out 
*** HOLE CARDS ***
father here: folds 
rog3543: folds 
Sergey_Bolos: folds 
delbergg: calls $0.05
GreenChe: checks 
*** FLOP *** [3h 7c 9s]
delbergg: bets $0.10
GreenChe: calls $0.10
*** TURN *** [3h 7c 9s] [Jd]
delbergg: checks 
GreenChe: bets $0.25
delbergg: calls $0.25
*** RIVER *** [3h 7c 9s Jd] [Td]
delbergg: checks 
GreenChe: bets $0.43
delbergg: raises $1.14 to $1.57
GreenChe: calls $1.14
*** SHOW DOWN ***
delbergg: shows [7s 4h] (a pair of Sevens)
GreenChe: shows [5h 8h] (a straight, Seven to Jack)
GreenChe collected $3.86 from pot
*** SUMMARY ***
Total pot $4.04 | Rake $0.18 
Board [3h 7c 9s Jd Td]
Seat 1: delbergg (small blind) showed [7s 4h] and lost with a pair of Sevens
Seat 2: GreenChe (big blind) showed [5h 8h] and won ($3.86) with a straight, Seven to Jack
Seat 3: father here folded before Flop (didn't bet)
Seat 5: rog3543 folded before Flop (didn't bet)
Seat 6: Sergey_Bolos (button) folded before Flop (didn't bet)



PokerStars Hand #222948147901:  Hold'em No Limit ($0.05/$0.10 USD) - 2021/01/23 3:56:14 ET
Table 'Polydoros II' 6-max Seat #1 is the button
Seat 1: delbergg ($23.58 in chips) 
Seat 2: GreenChe ($13.42 in chips) 
Seat 3: father here ($14.56 in chips) 
Seat 5: rog3543 ($13.68 in chips) 
Seat 6: Sergey_Bolos ($11.19 in chips) 
GreenChe: posts small blind $0.05
father here: posts big blind $0.10
Silveradom: sits out 
*** HOLE CARDS ***
rog3543: raises $0.20 to $0.30
Sergey_Bolos: calls $0.30
delbergg: raises $0.90 to $1.20
GreenChe: folds 
father here: folds 
rog3543: folds 
Sergey_Bolos: calls $0.90
*** FLOP *** [Js Td 4d]
Sergey_Bolos: checks 
delbergg: bets $1.80
Sergey_Bolos: folds 
Uncalled bet ($1.80) returned to delbergg
delbergg collected $2.72 from pot
*** SUMMARY ***
Total pot $2.85 | Rake $0.13 
Board [Js Td 4d]
Seat 1: delbergg (button) collected ($2.72)
Seat 2: GreenChe (small blind) folded before Flop
Seat 3: father here (big blind) folded before Flop
Seat 5: rog3543 folded before Flop
Seat 6: Sergey_Bolos folded on the Flop



PokerStars Hand #222948157590:  Hold'em No Limit ($0.05/$0.10 USD) - 2021/01/23 3:57:00 ET
Table 'Polydoros II' 6-max Seat #2 is the button
Seat 1: delbergg ($25.10 in chips) 
Seat 2: GreenChe ($13.37 in chips) 
Seat 3: father here ($14.46 in chips) 
Seat 4: Silveradom ($10 in chips) 
Seat 5: rog3543 ($13.38 in chips) 
Seat 6: Sergey_Bolos ($10 in chips) 
father here: posts small blind $0.05
Silveradom: posts big blind $0.10
*** HOLE CARDS ***
rog3543: folds 
Sergey_Bolos: raises $0.15 to $0.25
delbergg: calls $0.25
GreenChe: folds 
father here: folds 
Silveradom: calls $0.15
*** FLOP *** [5d Td 9c]
Silveradom: checks 
Sergey_Bolos: checks 
delbergg: bets $0.80
Silveradom: calls $0.80
Sergey_Bolos: folds 
*** TURN *** [5d Td 9c] [2s]
Silveradom: checks 
delbergg: bets $2.50
Silveradom: folds 
Uncalled bet ($2.50) returned to delbergg
delbergg collected $2.29 from pot
delbergg: doesn't show hand 
*** SUMMARY ***
Total pot $2.40 | Rake $0.11 
Board [5d Td 9c 2s]
Seat 1: delbergg collected ($2.29)
Seat 2: GreenChe (button) folded before Flop (didn't bet)
Seat 3: father here (small blind) folded before Flop
Seat 4: Silveradom (big blind) folded on the Turn
Seat 5: rog3543 folded before Flop (didn't bet)
Seat 6: Sergey_Bolos folded on the Flop



PokerStars Hand #222948168369:  Hold'em No Limit ($0.05/$0.10 USD) - 2021/01/23 3:57:52 ET
Table 'Polydoros II' 6-max Seat #3 is the button
Seat 1: delbergg ($26.34 in chips) 
Seat 2: GreenChe ($13.37 in chips) 
Seat 3: father here ($14.41 in chips) 
Seat 4: Silveradom ($8.95 in chips) 
Seat 5: rog3543 ($13.38 in chips) 
Seat 6: Sergey_Bolos ($10 in chips) 
Silveradom: posts small blind $0.05
rog3543: posts big blind $0.10
*** HOLE CARDS ***
Sergey_Bolos: raises $0.15 to $0.25
delbergg: folds 
GreenChe: folds 
father here: folds 
Silveradom: raises $0.60 to $0.85
rog3543: folds 
Sergey_Bolos: calls $0.60
*** FLOP *** [2h 7c 4h]
Silveradom: checks 
Sergey_Bolos: bets $1.15
Silveradom: calls $1.15
*** TURN *** [2h 7c 4h] [5d]
Silveradom: checks 
Sergey_Bolos: checks 
*** RIVER *** [2h 7c 4h 5d] [7h]
Silveradom: checks 
Sergey_Bolos: checks 
*** SHOW DOWN ***
Silveradom: shows [Ac Kd] (a pair of Sevens)
Sergey_Bolos: shows [Tc Th] (two pair, Tens and Sevens)
Sergey_Bolos collected $3.92 from pot
*** SUMMARY ***
Total pot $4.10 | Rake $0.18 
Board [2h 7c 4h 5d 7h]
Seat 1: delbergg folded before Flop (didn't bet)
Seat 2: GreenChe folded before Flop (didn't bet)
Seat 3: father here (button) folded before Flop (didn't bet)
Seat 4: Silveradom (small blind) showed [Ac Kd] and lost with a pair of Sevens
Seat 5: rog3543 (big blind) folded before Flop
Seat 6: Sergey_Bolos showed [Tc Th] and won ($3.92) with two pair, Tens and Sevens



PokerStars Hand #222948181891:  Hold'em No Limit ($0.05/$0.10 USD) - 2021/01/23 3:58:55 ET
Table 'Polydoros II' 6-max Seat #4 is the button
Seat 1: delbergg ($26.34 in chips) 
Seat 2: GreenChe ($13.37 in chips) 
Seat 3: father here ($14.41 in chips) 
Seat 4: Silveradom ($8 in chips) 
Seat 5: rog3543 ($13.28 in chips) 
Seat 6: Sergey_Bolos ($11.92 in chips) 
rog3543: posts small blind $0.05
Sergey_Bolos: posts big blind $0.10
*** HOLE CARDS ***
delbergg: folds 
GreenChe: folds 
father here: folds 
Silveradom: folds 
rog3543: folds 
Uncalled bet ($0.05) returned to Sergey_Bolos
Sergey_Bolos collected $0.10 from pot
Sergey_Bolos: doesn't show hand 
*** SUMMARY ***
Total pot $0.10 | Rake $0 
Seat 1: delbergg folded before Flop (didn't bet)
Seat 2: GreenChe folded before Flop (didn't bet)
Seat 3: father here folded before Flop (didn't bet)
Seat 4: Silveradom (button) folded before Flop (didn't bet)
Seat 5: rog3543 (small blind) folded before Flop
Seat 6: Sergey_Bolos (big blind) collected ($0.10)



PokerStars Hand #222948184435:  Hold'em No Limit ($0.05/$0.10 USD) - 2021/01/23 3:59:07 ET
Table 'Polydoros II' 6-max Seat #5 is the button
Seat 1: delbergg ($26.34 in chips) 
Seat 2: GreenChe ($13.37 in chips) 
Seat 3: father here ($14.41 in chips) 
Seat 4: Silveradom ($10 in chips) 
Seat 5: rog3543 ($13.23 in chips) 
Seat 6: Sergey_Bolos ($11.97 in chips) 
Sergey_Bolos: posts small blind $0.05
delbergg: posts big blind $0.10
*** HOLE CARDS ***
GreenChe: folds 
father here: folds 
Silveradom: folds 
rog3543: folds 
Sergey_Bolos: raises $0.15 to $0.25
delbergg: calls $0.15
*** FLOP *** [Js 5s Qc]
Sergey_Bolos: bets $0.22
delbergg: folds 
Uncalled bet ($0.22) returned to Sergey_Bolos
Sergey_Bolos collected $0.48 from pot
Sergey_Bolos: doesn't show hand 
*** SUMMARY ***
Total pot $0.50 | Rake $0.02 
Board [Js 5s Qc]
Seat 1: delbergg (big blind) folded on the Flop
Seat 2: GreenChe folded before Flop (didn't bet)
Seat 3: father here folded before Flop (didn't bet)
Seat 4: Silveradom folded before Flop (didn't bet)
Seat 5: rog3543 (button) folded before Flop (didn't bet)
Seat 6: Sergey_Bolos (small blind) collected ($0.48)



PokerStars Hand #222948189761:  Hold'em No Limit ($0.05/$0.10 USD) - 2021/01/23 3:59:32 ET
Table 'Polydoros II' 6-max Seat #6 is the button
Seat 1: delbergg ($26.09 in chips) 
Seat 2: GreenChe ($13.37 in chips) 
Seat 3: father here ($14.41 in chips) 
Seat 4: Silveradom ($10 in chips) 
Seat 5: rog3543 ($13.23 in chips) 
Seat 6: Sergey_Bolos ($12.20 in chips) 
delbergg: posts small blind $0.05
GreenChe: posts big blind $0.10
*** HOLE CARDS ***
father here: folds 
Silveradom: folds 
rog3543: folds 
Sergey_Bolos: folds 
delbergg: folds 
Uncalled bet ($0.05) returned to GreenChe
GreenChe collected $0.10 from pot
GreenChe: doesn't show hand 
*** SUMMARY ***
Total pot $0.10 | Rake $0 
Seat 1: delbergg (small blind) folded before Flop
Seat 2: GreenChe (big blind) collected ($0.10)
Seat 3: father here folded before Flop (didn't bet)
Seat 4: Silveradom folded before Flop (didn't bet)
Seat 5: rog3543 folded before Flop (didn't bet)
Seat 6: Sergey_Bolos (button) folded before Flop (didn't bet)



PokerStars Hand #222948194735:  Hold'em No Limit ($0.05/$0.10 USD) - 2021/01/23 3:59:55 ET
Table 'Polydoros II' 6-max Seat #1 is the button
Seat 1: delbergg ($26.04 in chips) 
Seat 2: GreenChe ($13.42 in chips) 
Seat 4: Silveradom ($10 in chips) 
Seat 5: rog3543 ($13.23 in chips) 
Seat 6: Sergey_Bolos ($12.20 in chips) 
GreenChe: posts small blind $0.05
father here: is sitting out 
Silveradom: posts big blind $0.10
*** HOLE CARDS ***
rog3543: folds 
Sergey_Bolos: folds 
delbergg: raises $0.15 to $0.25
GreenChe: folds 
Silveradom: calls $0.15
*** FLOP *** [3d 4h Tc]
Silveradom: checks 
delbergg: bets $0.35
Silveradom: calls $0.35
*** TURN *** [3d 4h Tc] [7c]
Silveradom: checks 
delbergg: checks 
*** RIVER *** [3d 4h Tc 7c] [9d]
Silveradom: checks 
delbergg: checks 
*** SHOW DOWN ***
Silveradom: shows [6s As] (high card Ace)
delbergg: shows [Kh 9c] (a pair of Nines)
delbergg collected $1.19 from pot
*** SUMMARY ***
Total pot $1.25 | Rake $0.06 
Board [3d 4h Tc 7c 9d]
Seat 1: delbergg (button) showed [Kh 9c] and won ($1.19) with a pair of Nines
Seat 2: GreenChe (small blind) folded before Flop
Seat 4: Silveradom (big blind) showed [6s As] and lost with high card Ace
Seat 5: rog3543 folded before Flop (didn't bet)
Seat 6: Sergey_Bolos folded before Flop (didn't bet)



PokerStars Hand #222948206775:  Hold'em No Limit ($0.05/$0.10 USD) - 2021/01/23 4:00:48 ET
Table 'Polydoros II' 6-max Seat #2 is the button
Seat 1: delbergg ($26.63 in chips) 
Seat 2: GreenChe ($13.37 in chips) 
Seat 4: Silveradom ($9.40 in chips) 
Seat 5: rog3543 ($13.23 in chips) 
Seat 6: Sergey_Bolos ($12.20 in chips) 
Silveradom: posts small blind $0.05
rog3543: posts big blind $0.10
*** HOLE CARDS ***
Sergey_Bolos: folds 
delbergg: folds 
GreenChe: folds 
Silveradom: raises $0.20 to $0.30
rog3543: calls $0.20
*** FLOP *** [Tc Jc 8c]
father here leaves the table
Silveradom: bets $0.35
rog3543: folds 
Uncalled bet ($0.35) returned to Silveradom
Silveradom collected $0.57 from pot
Silveradom: doesn't show hand 
*** SUMMARY ***
Total pot $0.60 | Rake $0.03 
Board [Tc Jc 8c]
Seat 1: delbergg folded before Flop (didn't bet)
Seat 2: GreenChe (button) folded before Flop (didn't bet)
Seat 4: Silveradom (small blind) collected ($0.57)
Seat 5: rog3543 (big blind) folded on the Flop
Seat 6: Sergey_Bolos folded before Flop (didn't bet)



PokerStars Hand #222948212571:  Hold'em No Limit ($0.05/$0.10 USD) - 2021/01/23 4:01:11 ET
Table 'Polydoros II' 6-max Seat #4 is the button
Seat 1: delbergg ($26.63 in chips) 
Seat 2: GreenChe ($13.37 in chips) 
Seat 4: Silveradom ($9.67 in chips) 
Seat 5: rog3543 ($12.93 in chips) 
Seat 6: Sergey_Bolos ($12.20 in chips) 
rog3543: posts small blind $0.05
Sergey_Bolos: posts big blind $0.10
*** HOLE CARDS ***
delbergg: folds 
GreenChe: raises $0.20 to $0.30
armin75 joins the table at seat #3 
Silveradom: folds 
rog3543: folds 
Sergey_Bolos: raises $0.90 to $1.20
GreenChe: folds 
Uncalled bet ($0.90) returned to Sergey_Bolos
Sergey_Bolos collected $0.65 from pot
Sergey_Bolos: doesn't show hand 
*** SUMMARY ***
Total pot $0.65 | Rake $0 
Seat 1: delbergg folded before Flop (didn't bet)
Seat 2: GreenChe folded before Flop
Seat 4: Silveradom (button) folded before Flop (didn't bet)
Seat 5: rog3543 (small blind) folded before Flop
Seat 6: Sergey_Bolos (big blind) collected ($0.65)



PokerStars Hand #222948223518:  Hold'em No Limit ($0.05/$0.10 USD) - 2021/01/23 4:01:55 ET
Table 'Polydoros II' 6-max Seat #5 is the button
Seat 1: delbergg ($26.63 in chips) 
Seat 2: GreenChe ($13.07 in chips) 
Seat 3: armin75 ($10 in chips) 
Seat 4: Silveradom ($10 in chips) 
Seat 5: rog3543 ($12.88 in chips) 
Seat 6: Sergey_Bolos ($12.55 in chips) 
Sergey_Bolos: posts small blind $0.05
delbergg: posts big blind $0.10
armin75: posts big blind $0.10
*** HOLE CARDS ***
GreenChe: folds 
armin75: checks 
Silveradom: folds 
rog3543: folds 
Sergey_Bolos: folds 
delbergg: checks 
*** FLOP *** [Td 9c Jh]
delbergg: checks 
armin75: checks 
*** TURN *** [Td 9c Jh] [5h]
delbergg: checks 
armin75: checks 
*** RIVER *** [Td 9c Jh 5h] [9d]
delbergg: bets $0.30
armin75: folds 
Uncalled bet ($0.30) returned to delbergg
delbergg collected $0.24 from pot
*** SUMMARY ***
Total pot $0.25 | Rake $0.01 
Board [Td 9c Jh 5h 9d]
Seat 1: delbergg (big blind) collected ($0.24)
Seat 2: GreenChe folded before Flop (didn't bet)
Seat 3: armin75 folded on the River (didn't bet)
Seat 4: Silveradom folded before Flop (didn't bet)
Seat 5: rog3543 (button) folded before Flop (didn't bet)
Seat 6: Sergey_Bolos (small blind) folded before Flop



PokerStars Hand #222948231915:  Hold'em No Limit ($0.05/$0.10 USD) - 2021/01/23 4:02:29 ET
Table 'Polydoros II' 6-max Seat #6 is the button
Seat 1: delbergg ($26.77 in chips) 
Seat 2: GreenChe ($13.07 in chips) 
Seat 3: armin75 ($9.90 in chips) 
Seat 4: Silveradom ($10 in chips) 
Seat 5: rog3543 ($12.88 in chips) 
Seat 6: Sergey_Bolos ($12.50 in chips) 
delbergg: posts small blind $0.05
GreenChe: posts big blind $0.10
*** HOLE CARDS ***
armin75: folds 
Silveradom: folds 
rog3543: folds 
Sergey_Bolos: folds 
delbergg: calls $0.05
GreenChe: raises $0.40 to $0.50
delbergg: calls $0.40
*** FLOP *** [8c 7s 5s]
delbergg: checks 
GreenChe: bets $0.72
delbergg: calls $0.72
*** TURN *** [8c 7s 5s] [2h]
delbergg: checks 
GreenChe: bets $1.75
delbergg: calls $1.75
*** RIVER *** [8c 7s 5s 2h] [Th]
delbergg: checks 
GreenChe: bets $2.84
delbergg: calls $2.84
*** SHOW DOWN ***
GreenChe: shows [Qh Qs] (a pair of Queens)
delbergg: mucks hand 
GreenChe collected $11.10 from pot
*** SUMMARY ***
Total pot $11.62 | Rake $0.52 
Board [8c 7s 5s 2h Th]
Seat 1: delbergg (small blind) mucked
Seat 2: GreenChe (big blind) showed [Qh Qs] and won ($11.10) with a pair of Queens
Seat 3: armin75 folded before Flop (didn't bet)
Seat 4: Silveradom folded before Flop (didn't bet)
Seat 5: rog3543 folded before Flop (didn't bet)
Seat 6: Sergey_Bolos (button) folded before Flop (didn't bet)



PokerStars Hand #222948248993:  Hold'em No Limit ($0.05/$0.10 USD) - 2021/01/23 4:03:36 ET
Table 'Polydoros II' 6-max Seat #1 is the button
Seat 1: delbergg ($20.96 in chips) 
Seat 2: GreenChe ($18.36 in chips) 
Seat 3: armin75 ($9.90 in chips) 
Seat 4: Silveradom ($10 in chips) 
Seat 5: rog3543 ($12.88 in chips) 
Seat 6: Sergey_Bolos ($12.50 in chips) 
GreenChe: posts small blind $0.05
armin75: posts big blind $0.10
*** HOLE CARDS ***
Silveradom: folds 
rog3543: folds 
Sergey_Bolos: folds 
delbergg: folds 
GreenChe: folds 
Uncalled bet ($0.05) returned to armin75
armin75 collected $0.10 from pot
armin75: doesn't show hand 
*** SUMMARY ***
Total pot $0.10 | Rake $0 
Seat 1: delbergg (button) folded before Flop (didn't bet)
Seat 2: GreenChe (small blind) folded before Flop
Seat 3: armin75 (big blind) collected ($0.10)
Seat 4: Silveradom folded before Flop (didn't bet)
Seat 5: rog3543 folded before Flop (didn't bet)
Seat 6: Sergey_Bolos folded before Flop (didn't bet)



PokerStars Hand #222948251011:  Hold'em No Limit ($0.05/$0.10 USD) - 2021/01/23 4:03:44 ET
Table 'Polydoros II' 6-max Seat #2 is the button
Seat 1: delbergg ($20.96 in chips) 
Seat 2: GreenChe ($18.31 in chips) 
Seat 3: armin75 ($9.95 in chips) 
Seat 4: Silveradom ($10 in chips) 
Seat 5: rog3543 ($12.88 in chips) 
Seat 6: Sergey_Bolos ($12.50 in chips) 
armin75: posts small blind $0.05
Silveradom: posts big blind $0.10
*** HOLE CARDS ***
rog3543: folds 
Sergey_Bolos: folds 
delbergg: raises $0.15 to $0.25
GreenChe: folds 
armin75: folds 
Silveradom: folds 
Uncalled bet ($0.15) returned to delbergg
delbergg collected $0.25 from pot
*** SUMMARY ***
Total pot $0.25 | Rake $0 
Seat 1: delbergg collected ($0.25)
Seat 2: GreenChe (button) folded before Flop (didn't bet)
Seat 3: armin75 (small blind) folded before Flop
Seat 4: Silveradom (big blind) folded before Flop
Seat 5: rog3543 folded before Flop (didn't bet)
Seat 6: Sergey_Bolos folded before Flop (didn't bet)



PokerStars Hand #222948257223:  Hold'em No Limit ($0.05/$0.10 USD) - 2021/01/23 4:04:09 ET
Table 'Polydoros II' 6-max Seat #3 is the button
Seat 1: delbergg ($21.11 in chips) 
Seat 2: GreenChe ($18.31 in chips) 
Seat 3: armin75 ($9.90 in chips) 
Seat 4: Silveradom ($9.90 in chips) 
Seat 5: rog3543 ($12.88 in chips) 
Seat 6: Sergey_Bolos ($12.50 in chips) 
Silveradom: posts small blind $0.05
rog3543: posts big blind $0.10
*** HOLE CARDS ***
Sergey_Bolos: folds 
delbergg: folds 
GreenChe: folds 
armin75: folds 
Silveradom: raises $0.20 to $0.30
rog3543: calls $0.20
*** FLOP *** [Qh As 4c]
Silveradom: bets $0.35
rog3543: calls $0.35
*** TURN *** [Qh As 4c] [2d]
Silveradom: checks 
rog3543: checks 
*** RIVER *** [Qh As 4c 2d] [Ks]
Silveradom: checks 
rog3543: checks 
*** SHOW DOWN ***
Silveradom: shows [8h Ah] (a pair of Aces)
rog3543: mucks hand 
Silveradom collected $1.24 from pot
*** SUMMARY ***
Total pot $1.30 | Rake $0.06 
Board [Qh As 4c 2d Ks]
Seat 1: delbergg folded before Flop (didn't bet)
Seat 2: GreenChe folded before Flop (didn't bet)
Seat 3: armin75 (button) folded before Flop (didn't bet)
Seat 4: Silveradom (small blind) showed [8h Ah] and won ($1.24) with a pair of Aces
Seat 5: rog3543 (big blind) mucked
Seat 6: Sergey_Bolos folded before Flop (didn't bet)



PokerStars Hand #222948272526:  Hold'em No Limit ($0.05/$0.10 USD) - 2021/01/23 4:05:09 ET
Table 'Polydoros II' 6-max Seat #4 is the button
Seat 1: delbergg ($21.11 in chips) 
Seat 2: GreenChe ($18.31 in chips) 
Seat 3: armin75 ($9.90 in chips) 
Seat 4: Silveradom ($10.49 in chips) 
Seat 5: rog3543 ($12.23 in chips) 
Seat 6: Sergey_Bolos ($12.50 in chips) 
rog3543: posts small blind $0.05
Sergey_Bolos: posts big blind $0.10
*** HOLE CARDS ***
delbergg: folds 
GreenChe: raises $0.20 to $0.30
armin75: folds 
Silveradom: folds 
rog3543: folds 
Sergey_Bolos: folds 
Uncalled bet ($0.20) returned to GreenChe
GreenChe collected $0.25 from pot
GreenChe: doesn't show hand 
*** SUMMARY ***
Total pot $0.25 | Rake $0 
Seat 1: delbergg folded before Flop (didn't bet)
Seat 2: GreenChe collected ($0.25)
Seat 3: armin75 folded before Flop (didn't bet)
Seat 4: Silveradom (button) folded before Flop (didn't bet)
Seat 5: rog3543 (small blind) folded before Flop
Seat 6: Sergey_Bolos (big blind) folded before Flop



PokerStars Hand #222948275973:  Hold'em No Limit ($0.05/$0.10 USD) - 2021/01/23 4:05:22 ET
Table 'Polydoros II' 6-max Seat #5 is the button
Seat 1: delbergg ($21.11 in chips) 
Seat 2: GreenChe ($18.46 in chips) 
Seat 3: armin75 ($9.90 in chips) 
Seat 4: Silveradom ($10.49 in chips) 
Seat 5: rog3543 ($12.18 in chips) 
Seat 6: Sergey_Bolos ($12.40 in chips) 
Sergey_Bolos: posts small blind $0.05
delbergg: posts big blind $0.10
*** HOLE CARDS ***
GreenChe: raises $0.25 to $0.35
armin75: calls $0.35
Silveradom: folds 
rog3543: folds 
Sergey_Bolos: calls $0.30
delbergg: calls $0.25
*** FLOP *** [4d 6d 6c]
Sergey_Bolos: checks 
delbergg: checks 
GreenChe: checks 
armin75: bets $0.67
Sergey_Bolos: folds 
delbergg: calls $0.67
GreenChe: folds 
*** TURN *** [4d 6d 6c] [5h]
delbergg: checks 
armin75: checks 
*** RIVER *** [4d 6d 6c 5h] [5d]
delbergg: checks 
armin75: checks 
*** SHOW DOWN ***
delbergg: shows [2s 3d] (a straight, Deuce to Six)
armin75: mucks hand 
delbergg collected $2.62 from pot
*** SUMMARY ***
Total pot $2.74 | Rake $0.12 
Board [4d 6d 6c 5h 5d]
Seat 1: delbergg (big blind) showed [2s 3d] and won ($2.62) with a straight, Deuce to Six
Seat 2: GreenChe folded on the Flop
Seat 3: armin75 mucked
Seat 4: Silveradom folded before Flop (didn't bet)
Seat 5: rog3543 (button) folded before Flop (didn't bet)
Seat 6: Sergey_Bolos (small blind) folded on the Flop



PokerStars Hand #222948286589:  Hold'em No Limit ($0.05/$0.10 USD) - 2021/01/23 4:06:03 ET
Table 'Polydoros II' 6-max Seat #6 is the button
Seat 1: delbergg ($22.71 in chips) 
Seat 2: GreenChe ($18.11 in chips) 
Seat 3: armin75 ($10 in chips) 
Seat 4: Silveradom ($10.49 in chips) 
Seat 5: rog3543 ($12.18 in chips) 
Seat 6: Sergey_Bolos ($12.05 in chips) 
delbergg: posts small blind $0.05
GreenChe: posts big blind $0.10
*** HOLE CARDS ***
armin75: folds 
Silveradom: raises $0.20 to $0.30
rog3543: folds 
Sergey_Bolos: calls $0.30
delbergg: folds 
GreenChe: folds 
*** FLOP *** [Th Ah 9h]
Silveradom: bets $0.40
Sergey_Bolos: calls $0.40
*** TURN *** [Th Ah 9h] [2c]
Silveradom: bets $1
Sergey_Bolos: folds 
Uncalled bet ($1) returned to Silveradom
Silveradom collected $1.48 from pot
Silveradom: doesn't show hand 
*** SUMMARY ***
Total pot $1.55 | Rake $0.07 
Board [Th Ah 9h 2c]
Seat 1: delbergg (small blind) folded before Flop
Seat 2: GreenChe (big blind) folded before Flop
Seat 3: armin75 folded before Flop (didn't bet)
Seat 4: Silveradom collected ($1.48)
Seat 5: rog3543 folded before Flop (didn't bet)
Seat 6: Sergey_Bolos (button) folded on the Turn



PokerStars Hand #222948299322:  Hold'em No Limit ($0.05/$0.10 USD) - 2021/01/23 4:06:54 ET
Table 'Polydoros II' 6-max Seat #1 is the button
Seat 1: delbergg ($22.66 in chips) 
Seat 2: GreenChe ($18.01 in chips) 
Seat 3: armin75 ($10 in chips) 
Seat 4: Silveradom ($11.27 in chips) 
Seat 5: rog3543 ($12.18 in chips) 
Seat 6: Sergey_Bolos ($11.35 in chips) 
GreenChe: posts small blind $0.05
armin75: posts big blind $0.10
*** HOLE CARDS ***
Silveradom: raises $0.20 to $0.30
rog3543: folds 
Sergey_Bolos: folds 
delbergg: calls $0.30
GreenChe: folds 
armin75: folds 
*** FLOP *** [Jd 2h 5s]
Silveradom: checks 
delbergg: bets $0.48
Silveradom: calls $0.48
*** TURN *** [Jd 2h 5s] [6s]
Silveradom: checks 
delbergg: checks 
*** RIVER *** [Jd 2h 5s 6s] [7d]
Silveradom: bets $1.30
delbergg: folds 
Uncalled bet ($1.30) returned to Silveradom
Silveradom collected $1.63 from pot
Silveradom: doesn't show hand 
*** SUMMARY ***
Total pot $1.71 | Rake $0.08 
Board [Jd 2h 5s 6s 7d]
Seat 1: delbergg (button) folded on the River
Seat 2: GreenChe (small blind) folded before Flop
Seat 3: armin75 (big blind) folded before Flop
Seat 4: Silveradom collected ($1.63)
Seat 5: rog3543 folded before Flop (didn't bet)
Seat 6: Sergey_Bolos folded before Flop (didn't bet)



PokerStars Hand #222948320115:  Hold'em No Limit ($0.05/$0.10 USD) - 2021/01/23 4:08:15 ET
Table 'Polydoros II' 6-max Seat #2 is the button
Seat 1: delbergg ($21.88 in chips) 
Seat 2: GreenChe ($17.96 in chips) 
Seat 3: armin75 ($9.90 in chips) 
Seat 4: Silveradom ($12.12 in chips) 
Seat 5: rog3543 ($12.18 in chips) 
Seat 6: Sergey_Bolos ($11.35 in chips) 
armin75: posts small blind $0.05
Silveradom: posts big blind $0.10
*** HOLE CARDS ***
rog3543: folds 
Sergey_Bolos: folds 
delbergg: raises $0.15 to $0.25
GreenChe: folds 
rog3543 leaves the table
Samirzade joins the table at seat #5 
armin75: folds 
Silveradom: folds 
Uncalled bet ($0.15) returned to delbergg
delbergg collected $0.25 from pot
delbergg: doesn't show hand 
*** SUMMARY ***
Total pot $0.25 | Rake $0 
Seat 1: delbergg collected ($0.25)
Seat 2: GreenChe (button) folded before Flop (didn't bet)
Seat 3: armin75 (small blind) folded before Flop
Seat 4: Silveradom (big blind) folded before Flop
Seat 5: rog3543 folded before Flop (didn't bet)
Seat 6: Sergey_Bolos folded before Flop (didn't bet)



PokerStars Hand #222948329493:  Hold'em No Limit ($0.05/$0.10 USD) - 2021/01/23 4:08:51 ET
Table 'Polydoros II' 6-max Seat #3 is the button
Seat 1: delbergg ($22.03 in chips) 
Seat 2: GreenChe ($17.96 in chips) 
Seat 3: armin75 ($9.85 in chips) 
Seat 4: Silveradom ($12.02 in chips) 
Seat 5: Samirzade ($6 in chips) 
Seat 6: Sergey_Bolos ($11.35 in chips) 
Silveradom: posts small blind $0.05
Samirzade: posts big blind $0.10
*** HOLE CARDS ***
Sergey_Bolos: folds 
delbergg: folds 
GreenChe: folds 
armin75: folds 
Silveradom: folds 
Uncalled bet ($0.05) returned to Samirzade
Samirzade collected $0.10 from pot
Samirzade: doesn't show hand 
*** SUMMARY ***
Total pot $0.10 | Rake $0 
Seat 1: delbergg folded before Flop (didn't bet)
Seat 2: GreenChe folded before Flop (didn't bet)
Seat 3: armin75 (button) folded before Flop (didn't bet)
Seat 4: Silveradom (small blind) folded before Flop
Seat 5: Samirzade (big blind) collected ($0.10)
Seat 6: Sergey_Bolos folded before Flop (didn't bet)



PokerStars Hand #222948331164:  Hold'em No Limit ($0.05/$0.10 USD) - 2021/01/23 4:08:57 ET
Table 'Polydoros II' 6-max Seat #4 is the button
Seat 1: delbergg ($22.03 in chips) 
Seat 2: GreenChe ($17.96 in chips) 
Seat 3: armin75 ($9.85 in chips) 
Seat 4: Silveradom ($11.97 in chips) 
Seat 5: Samirzade ($6.05 in chips) 
Seat 6: Sergey_Bolos ($11.35 in chips) 
Samirzade: posts small blind $0.05
Sergey_Bolos: posts big blind $0.10
*** HOLE CARDS ***
delbergg: folds 
GreenChe: folds 
armin75: folds 
Silveradom: folds 
Samirzade: calls $0.05
Sergey_Bolos: checks 
*** FLOP *** [9s 8d 2d]
Samirzade: checks 
Sergey_Bolos: checks 
*** TURN *** [9s 8d 2d] [9h]
Samirzade: bets $0.10
Sergey_Bolos: folds 
Uncalled bet ($0.10) returned to Samirzade
Samirzade collected $0.19 from pot
Samirzade: doesn't show hand 
*** SUMMARY ***
Total pot $0.20 | Rake $0.01 
Board [9s 8d 2d 9h]
Seat 1: delbergg folded before Flop (didn't bet)
Seat 2: GreenChe folded before Flop (didn't bet)
Seat 3: armin75 folded before Flop (didn't bet)
Seat 4: Silveradom (button) folded before Flop (didn't bet)
Seat 5: Samirzade (small blind) collected ($0.19)
Seat 6: Sergey_Bolos (big blind) folded on the Turn



PokerStars Hand #222948341280:  Hold'em No Limit ($0.05/$0.10 USD) - 2021/01/23 4:09:37 ET
Table 'Polydoros II' 6-max Seat #5 is the button
Seat 1: delbergg ($22.03 in chips) 
Seat 2: GreenChe ($17.96 in chips) 
Seat 3: armin75 ($9.85 in chips) 
Seat 4: Silveradom ($11.97 in chips) 
Seat 5: Samirzade ($6.14 in chips) 
Seat 6: Sergey_Bolos ($11.25 in chips) 
Sergey_Bolos: posts small blind $0.05
delbergg: posts big blind $0.10
*** HOLE CARDS ***
GreenChe: folds 
armin75: folds 
Silveradom: folds 
Samirzade: raises $0.10 to $0.20
Sergey_Bolos: folds 
delbergg: calls $0.10
*** FLOP *** [2h 5d Ac]
delbergg: checks 
Samirzade: bets $0.21
delbergg: calls $0.21
*** TURN *** [2h 5d Ac] [Kd]
delbergg: checks 
Samirzade: checks 
*** RIVER *** [2h 5d Ac Kd] [Tc]
delbergg: checks 
Samirzade: checks 
*** SHOW DOWN ***
delbergg: shows [3c 2c] (a pair of Deuces)
Samirzade: shows [Ts Qh] (a pair of Tens)
Samirzade collected $0.83 from pot
*** SUMMARY ***
Total pot $0.87 | Rake $0.04 
Board [2h 5d Ac Kd Tc]
Seat 1: delbergg (big blind) showed [3c 2c] and lost with a pair of Deuces
Seat 2: GreenChe folded before Flop (didn't bet)
Seat 3: armin75 folded before Flop (didn't bet)
Seat 4: Silveradom folded before Flop (didn't bet)
Seat 5: Samirzade (button) showed [Ts Qh] and won ($0.83) with a pair of Tens
Seat 6: Sergey_Bolos (small blind) folded before Flop



PokerStars Hand #222947098695:  Hold'em No Limit ($0.05/$0.10 USD) - 2021/01/23 2:43:15 ET
Table 'Polydoros II' 6-max Seat #2 is the button
Seat 1: delbergg ($20.76 in chips) 
Seat 2: willworsf ($5.65 in chips) 
Seat 4: whtocean ($24.83 in chips) 
Seat 5: 12311985 ($10 in chips) 
Seat 6: Pablo7-Pro ($24.16 in chips) 
whtocean: posts small blind $0.05
12311985: posts big blind $0.10
*** HOLE CARDS ***
Pablo7-Pro: folds 
delbergg: folds 
father here joins the table at seat #3 
willworsf: calls $0.10
whtocean: raises $0.25 to $0.35
12311985: calls $0.25
willworsf: calls $0.25
*** FLOP *** [3d 5c 2h]
whtocean: checks 
12311985: checks 
willworsf: bets $0.36
whtocean: folds 
12311985: calls $0.36
*** TURN *** [3d 5c 2h] [Qc]
12311985: checks 
willworsf: checks 
*** RIVER *** [3d 5c 2h Qc] [Jd]
12311985: bets $0.85
willworsf: folds 
Uncalled bet ($0.85) returned to 12311985
12311985 collected $1.69 from pot
12311985: doesn't show hand 
*** SUMMARY ***
Total pot $1.77 | Rake $0.08 
Board [3d 5c 2h Qc Jd]
Seat 1: delbergg folded before Flop (didn't bet)
Seat 2: willworsf (button) folded on the River
Seat 4: whtocean (small blind) folded on the Flop
Seat 5: 12311985 (big blind) collected ($1.69)
Seat 6: Pablo7-Pro folded before Flop (didn't bet)



PokerStars Hand #222947113842:  Hold'em No Limit ($0.05/$0.10 USD) - 2021/01/23 2:44:21 ET
Table 'Polydoros II' 6-max Seat #4 is the button
Seat 1: delbergg ($20.76 in chips) 
Seat 2: willworsf ($4.94 in chips) 
Seat 4: whtocean ($24.48 in chips) 
Seat 5: 12311985 ($10.98 in chips) 
Seat 6: Pablo7-Pro ($24.16 in chips) 
12311985: posts small blind $0.05
Pablo7-Pro: posts big blind $0.10
father here: sits out 
*** HOLE CARDS ***
delbergg: raises $0.15 to $0.25
willworsf: folds 
whtocean: folds 
12311985: folds 
Pablo7-Pro: calls $0.15
*** FLOP *** [4s 4c Js]
Pablo7-Pro: checks 
delbergg: bets $0.16
Pablo7-Pro: calls $0.16
*** TURN *** [4s 4c Js] [Kh]
Pablo7-Pro: checks 
delbergg: bets $0.55
Pablo7-Pro: calls $0.55
*** RIVER *** [4s 4c Js Kh] [Kc]
Pablo7-Pro: checks 
delbergg: checks 
*** SHOW DOWN ***
Pablo7-Pro: shows [As Qc] (two pair, Kings and Fours)
delbergg: shows [8d Ad] (two pair, Kings and Fours)
Pablo7-Pro collected $0.94 from pot
delbergg collected $0.94 from pot
*** SUMMARY ***
Total pot $1.97 | Rake $0.09 
Board [4s 4c Js Kh Kc]
Seat 1: delbergg showed [8d Ad] and won ($0.94) with two pair, Kings and Fours
Seat 2: willworsf folded before Flop (didn't bet)
Seat 4: whtocean (button) folded before Flop (didn't bet)
Seat 5: 12311985 (small blind) folded before Flop
Seat 6: Pablo7-Pro (big blind) showed [As Qc] and won ($0.94) with two pair, Kings and Fours



PokerStars Hand #222947126796:  Hold'em No Limit ($0.05/$0.10 USD) - 2021/01/23 2:45:16 ET
Table 'Polydoros II' 6-max Seat #5 is the button
Seat 1: delbergg ($20.74 in chips) 
Seat 2: willworsf ($4.94 in chips) 
Seat 4: whtocean ($24.48 in chips) 
Seat 5: 12311985 ($10.93 in chips) 
Seat 6: Pablo7-Pro ($24.14 in chips) 
Pablo7-Pro: posts small blind $0.05
delbergg: posts big blind $0.10
father here: sits out 
*** HOLE CARDS ***
willworsf: raises $4.84 to $4.94 and is all-in
whtocean: folds 
12311985: raises $5.99 to $10.93 and is all-in
Pablo7-Pro: folds 
delbergg: folds 
Uncalled bet ($5.99) returned to 12311985
*** FLOP *** [3h Td Ks]
*** TURN *** [3h Td Ks] [4h]
*** RIVER *** [3h Td Ks 4h] [8d]
*** SHOW DOWN ***
willworsf: shows [Kh 4s] (two pair, Kings and Fours)
12311985: shows [As Ac] (a pair of Aces)
willworsf collected $9.58 from pot
*** SUMMARY ***
Total pot $10.03 | Rake $0.45 
Board [3h Td Ks 4h 8d]
Seat 1: delbergg (big blind) folded before Flop
Seat 2: willworsf showed [Kh 4s] and won ($9.58) with two pair, Kings and Fours
Seat 4: whtocean folded before Flop (didn't bet)
Seat 5: 12311985 (button) showed [As Ac] and lost with a pair of Aces
Seat 6: Pablo7-Pro (small blind) folded before Flop



PokerStars Hand #222947131950:  Hold'em No Limit ($0.05/$0.10 USD) - 2021/01/23 2:45:38 ET
Table 'Polydoros II' 6-max Seat #6 is the button
Seat 1: delbergg ($20.64 in chips) 
Seat 2: willworsf ($9.58 in chips) 
Seat 4: whtocean ($24.48 in chips) 
Seat 5: 12311985 ($10 in chips) 
Seat 6: Pablo7-Pro ($24.09 in chips) 
delbergg: posts small blind $0.05
willworsf: posts big blind $0.10
father here: sits out 
*** HOLE CARDS ***
whtocean: folds 
12311985: folds 
Pablo7-Pro: folds 
delbergg: raises $0.20 to $0.30
willworsf: calls $0.20
*** FLOP *** [3d Th Ah]
delbergg: bets $0.38
willworsf: calls $0.38
*** TURN *** [3d Th Ah] [7h]
delbergg: checks 
willworsf: checks 
*** RIVER *** [3d Th Ah 7h] [8h]
delbergg: bets $1.70
willworsf: calls $1.70
*** SHOW DOWN ***
delbergg: shows [Kd 9s] (high card Ace)
willworsf: shows [9h Ac] (a flush, Ace high)
willworsf collected $4.55 from pot
*** SUMMARY ***
Total pot $4.76 | Rake $0.21 
Board [3d Th Ah 7h 8h]
Seat 1: delbergg (small blind) showed [Kd 9s] and lost with high card Ace
Seat 2: willworsf (big blind) showed [9h Ac] and won ($4.55) with a flush, Ace high
Seat 4: whtocean folded before Flop (didn't bet)
Seat 5: 12311985 folded before Flop (didn't bet)
Seat 6: Pablo7-Pro (button) folded before Flop (didn't bet)



PokerStars Hand #222947141904:  Hold'em No Limit ($0.05/$0.10 USD) - 2021/01/23 2:46:20 ET
Table 'Polydoros II' 6-max Seat #1 is the button
Seat 1: delbergg ($18.26 in chips) 
Seat 2: willworsf ($11.75 in chips) 
Seat 3: father here ($10 in chips) 
Seat 4: whtocean ($24.48 in chips) 
Seat 5: 12311985 ($10 in chips) 
Seat 6: Pablo7-Pro ($24.09 in chips) 
willworsf: posts small blind $0.05
father here: posts big blind $0.10
*** HOLE CARDS ***
whtocean: folds 
12311985: folds 
Pablo7-Pro: folds 
delbergg: raises $0.15 to $0.25
willworsf: folds 
father here: folds 
Uncalled bet ($0.15) returned to delbergg
delbergg collected $0.25 from pot
*** SUMMARY ***
Total pot $0.25 | Rake $0 
Seat 1: delbergg (button) collected ($0.25)
Seat 2: willworsf (small blind) folded before Flop
Seat 3: father here (big blind) folded before Flop
Seat 4: whtocean folded before Flop (didn't bet)
Seat 5: 12311985 folded before Flop (didn't bet)
Seat 6: Pablo7-Pro folded before Flop (didn't bet)



PokerStars Hand #222947145457:  Hold'em No Limit ($0.05/$0.10 USD) - 2021/01/23 2:46:35 ET
Table 'Polydoros II' 6-max Seat #2 is the button
Seat 1: delbergg ($18.41 in chips) 
Seat 2: willworsf ($11.70 in chips) 
Seat 3: father here ($10 in chips) 
Seat 4: whtocean ($24.48 in chips) 
Seat 5: 12311985 ($10 in chips) 
Seat 6: Pablo7-Pro ($24.09 in chips) 
father here: posts small blind $0.05
whtocean: posts big blind $0.10
*** HOLE CARDS ***
12311985: folds 
Pablo7-Pro: folds 
delbergg: raises $0.15 to $0.25
willworsf: calls $0.25
father here: folds 
whtocean: folds 
*** FLOP *** [5d Ac 3c]
delbergg: checks 
willworsf: checks 
*** TURN *** [5d Ac 3c] [7h]
delbergg: bets $0.41
willworsf: calls $0.41
*** RIVER *** [5d Ac 3c 7h] [Ts]
delbergg: bets $1.90
willworsf: calls $1.90
*** SHOW DOWN ***
delbergg: shows [As 6s] (a pair of Aces)
willworsf: mucks hand 
delbergg collected $5.03 from pot
*** SUMMARY ***
Total pot $5.27 | Rake $0.24 
Board [5d Ac 3c 7h Ts]
Seat 1: delbergg showed [As 6s] and won ($5.03) with a pair of Aces
Seat 2: willworsf (button) mucked
Seat 3: father here (small blind) folded before Flop
Seat 4: whtocean (big blind) folded before Flop
Seat 5: 12311985 folded before Flop (didn't bet)
Seat 6: Pablo7-Pro folded before Flop (didn't bet)



PokerStars Hand #222947151969:  Hold'em No Limit ($0.05/$0.10 USD) - 2021/01/23 2:47:03 ET
Table 'Polydoros II' 6-max Seat #3 is the button
Seat 1: delbergg ($20.88 in chips) 
Seat 2: willworsf ($9.14 in chips) 
Seat 3: father here ($10 in chips) 
Seat 4: whtocean ($24.38 in chips) 
Seat 5: 12311985 ($10 in chips) 
Seat 6: Pablo7-Pro ($24.09 in chips) 
whtocean: posts small blind $0.05
12311985: posts big blind $0.10
*** HOLE CARDS ***
Pablo7-Pro: folds 
delbergg: folds 
willworsf: calls $0.10
father here: folds 
whtocean: folds 
12311985: checks 
*** FLOP *** [4d Kh Ad]
12311985: checks 
willworsf: checks 
*** TURN *** [4d Kh Ad] [2c]
12311985: checks 
willworsf: bets $0.10
12311985: folds 
Uncalled bet ($0.10) returned to willworsf
willworsf collected $0.24 from pot
willworsf: doesn't show hand 
*** SUMMARY ***
Total pot $0.25 | Rake $0.01 
Board [4d Kh Ad 2c]
Seat 1: delbergg folded before Flop (didn't bet)
Seat 2: willworsf collected ($0.24)
Seat 3: father here (button) folded before Flop (didn't bet)
Seat 4: whtocean (small blind) folded before Flop
Seat 5: 12311985 (big blind) folded on the Turn
Seat 6: Pablo7-Pro folded before Flop (didn't bet)



PokerStars Hand #222947157886:  Hold'em No Limit ($0.05/$0.10 USD) - 2021/01/23 2:47:28 ET
Table 'Polydoros II' 6-max Seat #4 is the button
Seat 1: delbergg ($20.88 in chips) 
Seat 2: willworsf ($9.28 in chips) 
Seat 3: father here ($10 in chips) 
Seat 4: whtocean ($24.33 in chips) 
Seat 5: 12311985 ($10 in chips) 
Seat 6: Pablo7-Pro ($24.09 in chips) 
12311985: posts small blind $0.05
Pablo7-Pro: posts big blind $0.10
*** HOLE CARDS ***
delbergg: folds 
willworsf: calls $0.10
father here: folds 
whtocean: folds 
12311985: folds 
Pablo7-Pro: checks 
*** FLOP *** [Ad 7h 8c]
Pablo7-Pro: checks 
willworsf: bets $0.10
Pablo7-Pro: calls $0.10
*** TURN *** [Ad 7h 8c] [3c]
Pablo7-Pro: checks 
willworsf: bets $0.22
Pablo7-Pro: calls $0.22
*** RIVER *** [Ad 7h 8c 3c] [7d]
Pablo7-Pro: checks 
willworsf: bets $0.85
Pablo7-Pro: folds 
Uncalled bet ($0.85) returned to willworsf
willworsf collected $0.85 from pot
willworsf: doesn't show hand 
*** SUMMARY ***
Total pot $0.89 | Rake $0.04 
Board [Ad 7h 8c 3c 7d]
Seat 1: delbergg folded before Flop (didn't bet)
Seat 2: willworsf collected ($0.85)
Seat 3: father here folded before Flop (didn't bet)
Seat 4: whtocean (button) folded before Flop (didn't bet)
Seat 5: 12311985 (small blind) folded before Flop
Seat 6: Pablo7-Pro (big blind) folded on the River



PokerStars Hand #222947168375:  Hold'em No Limit ($0.05/$0.10 USD) - 2021/01/23 2:48:13 ET
Table 'Polydoros II' 6-max Seat #5 is the button
Seat 1: delbergg ($20.88 in chips) 
Seat 2: willworsf ($9.71 in chips) 
Seat 3: father here ($10 in chips) 
Seat 4: whtocean ($24.33 in chips) 
Seat 5: 12311985 ($10 in chips) 
Seat 6: Pablo7-Pro ($23.67 in chips) 
Pablo7-Pro: posts small blind $0.05
delbergg: posts big blind $0.10
*** HOLE CARDS ***
willworsf: folds 
father here: folds 
whtocean: folds 
12311985: folds 
Pablo7-Pro: folds 
Uncalled bet ($0.05) returned to delbergg
delbergg collected $0.10 from pot
delbergg: doesn't show hand 
*** SUMMARY ***
Total pot $0.10 | Rake $0 
Seat 1: delbergg (big blind) collected ($0.10)
Seat 2: willworsf folded before Flop (didn't bet)
Seat 3: father here folded before Flop (didn't bet)
Seat 4: whtocean folded before Flop (didn't bet)
Seat 5: 12311985 (button) folded before Flop (didn't bet)
Seat 6: Pablo7-Pro (small blind) folded before Flop



PokerStars Hand #222947172006:  Hold'em No Limit ($0.05/$0.10 USD) - 2021/01/23 2:48:28 ET
Table 'Polydoros II' 6-max Seat #6 is the button
Seat 1: delbergg ($20.93 in chips) 
Seat 2: willworsf ($9.71 in chips) 
Seat 3: father here ($10 in chips) 
Seat 4: whtocean ($24.33 in chips) 
Seat 5: 12311985 ($10 in chips) 
Seat 6: Pablo7-Pro ($23.62 in chips) 
delbergg: posts small blind $0.05
willworsf: posts big blind $0.10
*** HOLE CARDS ***
father here: folds 
whtocean: folds 
12311985: folds 
Pablo7-Pro: folds 
delbergg: calls $0.05
willworsf: checks 
*** FLOP *** [2h 2d Qs]
delbergg: bets $0.10
willworsf: calls $0.10
*** TURN *** [2h 2d Qs] [Qh]
delbergg: checks 
willworsf: checks 
*** RIVER *** [2h 2d Qs Qh] [3c]
delbergg: bets $0.90
willworsf: raises $8.61 to $9.51 and is all-in
delbergg: calls $8.61
*** SHOW DOWN ***
willworsf: shows [Ah Ac] (two pair, Aces and Queens)
delbergg: shows [Qd 4s] (a full house, Queens full of Deuces)
delbergg collected $18.55 from pot
*** SUMMARY ***
Total pot $19.42 | Rake $0.87 
Board [2h 2d Qs Qh 3c]
Seat 1: delbergg (small blind) showed [Qd 4s] and won ($18.55) with a full house, Queens full of Deuces
Seat 2: willworsf (big blind) showed [Ah Ac] and lost with two pair, Aces and Queens
Seat 3: father here folded before Flop (didn't bet)
Seat 4: whtocean folded before Flop (didn't bet)
Seat 5: 12311985 folded before Flop (didn't bet)
Seat 6: Pablo7-Pro (button) folded before Flop (didn't bet)



PokerStars Hand #222947181721:  Hold'em No Limit ($0.05/$0.10 USD) - 2021/01/23 2:49:09 ET
Table 'Polydoros II' 6-max Seat #1 is the button
Seat 1: delbergg ($29.77 in chips) 
Seat 3: father here ($10 in chips) 
Seat 5: 12311985 ($10 in chips) 
Seat 6: Pablo7-Pro ($23.62 in chips) 
father here: posts small blind $0.05
whtocean: is sitting out 
whtocean leaves the table
12311985: posts big blind $0.10
*** HOLE CARDS ***
Pablo7-Pro: raises $0.20 to $0.30
delbergg: folds 
willworsf leaves the table
father here: raises $0.70 to $1
12311985: folds 
Pablo7-Pro: calls $0.70
*** FLOP *** [8c 3s 7c]
father here: bets $1.30
Pablo7-Pro: calls $1.30
*** TURN *** [8c 3s 7c] [Ks]
Jermein joins the table at seat #2 
father here: bets $2.60
Pablo7-Pro: raises $8.50 to $11.10
father here: calls $5.10 and is all-in
Uncalled bet ($3.40) returned to Pablo7-Pro
*** RIVER *** [8c 3s 7c Ks] [6c]
*** SHOW DOWN ***
father here: shows [Jh Jc] (a pair of Jacks)
Pablo7-Pro: shows [Tc Kc] (a flush, King high)
Pablo7-Pro collected $19.20 from pot
*** SUMMARY ***
Total pot $20.10 | Rake $0.90 
Board [8c 3s 7c Ks 6c]
Seat 1: delbergg (button) folded before Flop (didn't bet)
Seat 3: father here (small blind) showed [Jh Jc] and lost with a pair of Jacks
Seat 5: 12311985 (big blind) folded before Flop
Seat 6: Pablo7-Pro showed [Tc Kc] and won ($19.20) with a flush, King high



PokerStars Hand #222947201957:  Hold'em No Limit ($0.05/$0.10 USD) - 2021/01/23 2:50:36 ET
Table 'Polydoros II' 6-max Seat #3 is the button
Seat 1: delbergg ($29.77 in chips) 
Seat 3: father here ($10 in chips) 
Seat 5: 12311985 ($10 in chips) 
Seat 6: Pablo7-Pro ($32.82 in chips) 
12311985: posts small blind $0.05
Pablo7-Pro: posts big blind $0.10
Jermein: sits out 
*** HOLE CARDS ***
delbergg: raises $0.15 to $0.25
father here: folds 
12311985: folds 
Pablo7-Pro: folds 
Uncalled bet ($0.15) returned to delbergg
delbergg collected $0.25 from pot
*** SUMMARY ***
Total pot $0.25 | Rake $0 
Seat 1: delbergg collected ($0.25)
Seat 3: father here (button) folded before Flop (didn't bet)
Seat 5: 12311985 (small blind) folded before Flop
Seat 6: Pablo7-Pro (big blind) folded before Flop



PokerStars Hand #222947204813:  Hold'em No Limit ($0.05/$0.10 USD) - 2021/01/23 2:50:48 ET
Table 'Polydoros II' 6-max Seat #5 is the button
Seat 1: delbergg ($29.92 in chips) 
Seat 3: father here ($10 in chips) 
Seat 5: 12311985 ($10 in chips) 
Seat 6: Pablo7-Pro ($32.72 in chips) 
Pablo7-Pro: posts small blind $0.05
delbergg: posts big blind $0.10
Jermein: sits out 
*** HOLE CARDS ***
father here: folds 
12311985: raises $0.20 to $0.30
Pablo7-Pro: folds 
delbergg: calls $0.20
*** FLOP *** [Td Qc 6d]
delbergg: checks 
12311985: bets $0.19
delbergg: raises $0.66 to $0.85
12311985: raises $1.30 to $2.15
delbergg: raises $27.47 to $29.62 and is all-in
12311985: calls $7.55 and is all-in
Uncalled bet ($19.92) returned to delbergg
*** TURN *** [Td Qc 6d] [5h]
*** RIVER *** [Td Qc 6d 5h] [4c]
*** SHOW DOWN ***
delbergg: shows [6c 6h] (three of a kind, Sixes)
12311985: shows [Tc Ts] (three of a kind, Tens)
12311985 collected $19.15 from pot
*** SUMMARY ***
Total pot $20.05 | Rake $0.90 
Board [Td Qc 6d 5h 4c]
Seat 1: delbergg (big blind) showed [6c 6h] and lost with three of a kind, Sixes
Seat 3: father here folded before Flop (didn't bet)
Seat 5: 12311985 (button) showed [Tc Ts] and won ($19.15) with three of a kind, Tens
Seat 6: Pablo7-Pro (small blind) folded before Flop



PokerStars Hand #222947218056:  Hold'em No Limit ($0.05/$0.10 USD) - 2021/01/23 2:51:25 ET
Table 'Polydoros II' 6-max Seat #6 is the button
Seat 1: delbergg ($19.92 in chips) 
Seat 2: Jermein ($10 in chips) 
Seat 3: father here ($10 in chips) 
Seat 5: 12311985 ($19.15 in chips) 
Seat 6: Pablo7-Pro ($32.67 in chips) 
delbergg: posts small blind $0.05
Jermein: posts big blind $0.10
*** HOLE CARDS ***
father here: folds 
12311985: folds 
Pablo7-Pro: folds 
delbergg: calls $0.05
Jermein: checks 
*** FLOP *** [6c Jh Kh]
delbergg: bets $0.10
Jermein: folds 
Uncalled bet ($0.10) returned to delbergg
delbergg collected $0.19 from pot
delbergg: doesn't show hand 
*** SUMMARY ***
Total pot $0.20 | Rake $0.01 
Board [6c Jh Kh]
Seat 1: delbergg (small blind) collected ($0.19)
Seat 2: Jermein (big blind) folded on the Flop
Seat 3: father here folded before Flop (didn't bet)
Seat 5: 12311985 folded before Flop (didn't bet)
Seat 6: Pablo7-Pro (button) folded before Flop (didn't bet)



PokerStars Hand #222947223996:  Hold'em No Limit ($0.05/$0.10 USD) - 2021/01/23 2:51:51 ET
Table 'Polydoros II' 6-max Seat #1 is the button
Seat 1: delbergg ($20.01 in chips) 
Seat 2: Jermein ($10 in chips) 
Seat 3: father here ($10 in chips) 
Seat 5: 12311985 ($19.15 in chips) 
Seat 6: Pablo7-Pro ($32.67 in chips) 
Jermein: posts small blind $0.05
father here: posts big blind $0.10
*** HOLE CARDS ***
12311985: folds 
Lord_Antoan joins the table at seat #4 
Pablo7-Pro: folds 
delbergg: folds 
Jermein: raises $0.20 to $0.30
father here: raises $0.60 to $0.90
Jermein: folds 
Uncalled bet ($0.60) returned to father here
father here collected $0.60 from pot
*** SUMMARY ***
Total pot $0.60 | Rake $0 
Seat 1: delbergg (button) folded before Flop (didn't bet)
Seat 2: Jermein (small blind) folded before Flop
Seat 3: father here (big blind) collected ($0.60)
Seat 5: 12311985 folded before Flop (didn't bet)
Seat 6: Pablo7-Pro folded before Flop (didn't bet)



PokerStars Hand #222947228118:  Hold'em No Limit ($0.05/$0.10 USD) - 2021/01/23 2:52:09 ET
Table 'Polydoros II' 6-max Seat #2 is the button
Seat 1: delbergg ($20.01 in chips) 
Seat 2: Jermein ($10 in chips) 
Seat 3: father here ($10.30 in chips) 
Seat 4: Lord_Antoan ($10 in chips) 
Seat 5: 12311985 ($19.15 in chips) 
Seat 6: Pablo7-Pro ($32.67 in chips) 
father here: posts small blind $0.05
Lord_Antoan: posts big blind $0.10
*** HOLE CARDS ***
12311985: folds 
Pablo7-Pro: folds 
delbergg: folds 
Jermein: folds 
father here: raises $0.10 to $0.20
Lord_Antoan: raises $0.50 to $0.70
father here: folds 
Uncalled bet ($0.50) returned to Lord_Antoan
Lord_Antoan collected $0.40 from pot
Lord_Antoan: doesn't show hand 
*** SUMMARY ***
Total pot $0.40 | Rake $0 
Seat 1: delbergg folded before Flop (didn't bet)
Seat 2: Jermein (button) folded before Flop (didn't bet)
Seat 3: father here (small blind) folded before Flop
Seat 4: Lord_Antoan (big blind) collected ($0.40)
Seat 5: 12311985 folded before Flop (didn't bet)
Seat 6: Pablo7-Pro folded before Flop (didn't bet)



PokerStars Hand #222947236963:  Hold'em No Limit ($0.05/$0.10 USD) - 2021/01/23 2:52:47 ET
Table 'Polydoros II' 6-max Seat #3 is the button
Seat 1: delbergg ($20.01 in chips) 
Seat 2: Jermein ($10 in chips) 
Seat 3: father here ($10.10 in chips) 
Seat 4: Lord_Antoan ($10.20 in chips) 
Seat 5: 12311985 ($19.15 in chips) 
Seat 6: Pablo7-Pro ($32.67 in chips) 
Lord_Antoan: posts small blind $0.05
12311985: posts big blind $0.10
*** HOLE CARDS ***
Pablo7-Pro: folds 
delbergg: folds 
Jermein: raises $0.20 to $0.30
father here: folds 
Lord_Antoan: raises $1.10 to $1.40
12311985: folds 
Jermein: calls $1.10
*** FLOP *** [6s Ah 7s]
Lord_Antoan: bets $1
Jermein: calls $1
*** TURN *** [6s Ah 7s] [Ad]
Lord_Antoan: bets $2.30
Jermein: calls $2.30
*** RIVER *** [6s Ah 7s Ad] [5d]
Lord_Antoan: bets $5.50 and is all-in
Jermein: calls $5.30 and is all-in
Uncalled bet ($0.20) returned to Lord_Antoan
*** SHOW DOWN ***
Lord_Antoan: shows [Jd Js] (two pair, Aces and Jacks)
Jermein: shows [Jh As] (three of a kind, Aces)
Jermein collected $19.20 from pot
*** SUMMARY ***
Total pot $20.10 | Rake $0.90 
Board [6s Ah 7s Ad 5d]
Seat 1: delbergg folded before Flop (didn't bet)
Seat 2: Jermein showed [Jh As] and won ($19.20) with three of a kind, Aces
Seat 3: father here (button) folded before Flop (didn't bet)
Seat 4: Lord_Antoan (small blind) showed [Jd Js] and lost with two pair, Aces and Jacks
Seat 5: 12311985 (big blind) folded before Flop
Seat 6: Pablo7-Pro folded before Flop (didn't bet)



PokerStars Hand #222947254728:  Hold'em No Limit ($0.05/$0.10 USD) - 2021/01/23 2:54:04 ET
Table 'Polydoros II' 6-max Seat #4 is the button
Seat 1: delbergg ($20.01 in chips) 
Seat 2: Jermein ($19.20 in chips) 
Seat 3: father here ($10.10 in chips) 
Seat 4: Lord_Antoan ($10 in chips) 
Seat 5: 12311985 ($19.05 in chips) 
Seat 6: Pablo7-Pro ($32.67 in chips) 
12311985: posts small blind $0.05
Pablo7-Pro: posts big blind $0.10
*** HOLE CARDS ***
delbergg: folds 
Jermein: folds 
father here: folds 
Lord_Antoan: raises $0.20 to $0.30
12311985: folds 
Pablo7-Pro: folds 
Uncalled bet ($0.20) returned to Lord_Antoan
Lord_Antoan collected $0.25 from pot
Lord_Antoan: doesn't show hand 
*** SUMMARY ***
Total pot $0.25 | Rake $0 
Seat 1: delbergg folded before Flop (didn't bet)
Seat 2: Jermein folded before Flop (didn't bet)
Seat 3: father here folded before Flop (didn't bet)
Seat 4: Lord_Antoan (button) collected ($0.25)
Seat 5: 12311985 (small blind) folded before Flop
Seat 6: Pablo7-Pro (big blind) folded before Flop



PokerStars Hand #222947258219:  Hold'em No Limit ($0.05/$0.10 USD) - 2021/01/23 2:54:19 ET
Table 'Polydoros II' 6-max Seat #5 is the button
Seat 1: delbergg ($20.01 in chips) 
Seat 2: Jermein ($19.20 in chips) 
Seat 3: father here ($10.10 in chips) 
Seat 4: Lord_Antoan ($10.15 in chips) 
Seat 5: 12311985 ($19 in chips) 
Seat 6: Pablo7-Pro ($32.57 in chips) 
Pablo7-Pro: posts small blind $0.05
delbergg: posts big blind $0.10
*** HOLE CARDS ***
Jermein: folds 
father here: folds 
Lord_Antoan: raises $0.20 to $0.30
12311985: folds 
Pablo7-Pro: folds 
delbergg: calls $0.20
*** FLOP *** [8c 3c Kc]
delbergg: checks 
Lord_Antoan: bets $0.22
delbergg: calls $0.22
*** TURN *** [8c 3c Kc] [Qd]
delbergg: checks 
Lord_Antoan: checks 
*** RIVER *** [8c 3c Kc Qd] [As]
delbergg: checks 
Lord_Antoan: checks 
*** SHOW DOWN ***
delbergg: shows [7c 6s] (high card Ace)
Lord_Antoan: shows [Ts Qc] (a pair of Queens)
Lord_Antoan collected $1.04 from pot
*** SUMMARY ***
Total pot $1.09 | Rake $0.05 
Board [8c 3c Kc Qd As]
Seat 1: delbergg (big blind) showed [7c 6s] and lost with high card Ace
Seat 2: Jermein folded before Flop (didn't bet)
Seat 3: father here folded before Flop (didn't bet)
Seat 4: Lord_Antoan showed [Ts Qc] and won ($1.04) with a pair of Queens
Seat 5: 12311985 (button) folded before Flop (didn't bet)
Seat 6: Pablo7-Pro (small blind) folded before Flop



PokerStars Hand #222947266106:  Hold'em No Limit ($0.05/$0.10 USD) - 2021/01/23 2:54:52 ET
Table 'Polydoros II' 6-max Seat #6 is the button
Seat 1: delbergg ($19.49 in chips) 
Seat 2: Jermein ($19.20 in chips) 
Seat 3: father here ($10.10 in chips) 
Seat 4: Lord_Antoan ($10.67 in chips) 
Seat 5: 12311985 ($19 in chips) 
Seat 6: Pablo7-Pro ($32.52 in chips) 
delbergg: posts small blind $0.05
Jermein: posts big blind $0.10
*** HOLE CARDS ***
father here: folds 
Lord_Antoan: folds 
12311985: folds 
Pablo7-Pro: raises $0.20 to $0.30
delbergg: calls $0.25
Jermein: folds 
*** FLOP *** [Tc 9d 6c]
delbergg: checks 
Pablo7-Pro: bets $0.22
delbergg: raises $0.73 to $0.95
Pablo7-Pro: folds 
Uncalled bet ($0.73) returned to delbergg
delbergg collected $1.09 from pot
*** SUMMARY ***
Total pot $1.14 | Rake $0.05 
Board [Tc 9d 6c]
Seat 1: delbergg (small blind) collected ($1.09)
Seat 2: Jermein (big blind) folded before Flop
Seat 3: father here folded before Flop (didn't bet)
Seat 4: Lord_Antoan folded before Flop (didn't bet)
Seat 5: 12311985 folded before Flop (didn't bet)
Seat 6: Pablo7-Pro (button) folded on the Flop



PokerStars Hand #222947273458:  Hold'em No Limit ($0.05/$0.10 USD) - 2021/01/23 2:55:27 ET
Table 'Polydoros II' 6-max Seat #1 is the button
Seat 1: delbergg ($20.06 in chips) 
Seat 2: Jermein ($19.10 in chips) 
Seat 3: father here ($10.10 in chips) 
Seat 4: Lord_Antoan ($10.67 in chips) 
Seat 5: 12311985 ($19 in chips) 
Seat 6: Pablo7-Pro ($32 in chips) 
Jermein: posts small blind $0.05
father here: posts big blind $0.10
*** HOLE CARDS ***
Lord_Antoan: folds 
12311985: raises $0.15 to $0.25
Pablo7-Pro: folds 
delbergg: folds 
Jermein: folds 
father here: folds 
Uncalled bet ($0.15) returned to 12311985
12311985 collected $0.25 from pot
12311985: doesn't show hand 
*** SUMMARY ***
Total pot $0.25 | Rake $0 
Seat 1: delbergg (button) folded before Flop (didn't bet)
Seat 2: Jermein (small blind) folded before Flop
Seat 3: father here (big blind) folded before Flop
Seat 4: Lord_Antoan folded before Flop (didn't bet)
Seat 5: 12311985 collected ($0.25)
Seat 6: Pablo7-Pro folded before Flop (didn't bet)



PokerStars Hand #222947276641:  Hold'em No Limit ($0.05/$0.10 USD) - 2021/01/23 2:55:43 ET
Table 'Polydoros II' 6-max Seat #2 is the button
Seat 1: delbergg ($20.06 in chips) 
Seat 2: Jermein ($19.05 in chips) 
Seat 3: father here ($10 in chips) 
Seat 4: Lord_Antoan ($10.67 in chips) 
Seat 5: 12311985 ($19.15 in chips) 
Seat 6: Pablo7-Pro ($32 in chips) 
father here: posts small blind $0.05
Lord_Antoan: posts big blind $0.10
*** HOLE CARDS ***
12311985: folds 
Pablo7-Pro: folds 
delbergg: folds 
Jermein: folds 
father here: raises $0.10 to $0.20
Lord_Antoan: folds 
Uncalled bet ($0.10) returned to father here
father here collected $0.20 from pot
*** SUMMARY ***
Total pot $0.20 | Rake $0 
Seat 1: delbergg folded before Flop (didn't bet)
Seat 2: Jermein (button) folded before Flop (didn't bet)
Seat 3: father here (small blind) collected ($0.20)
Seat 4: Lord_Antoan (big blind) folded before Flop
Seat 5: 12311985 folded before Flop (didn't bet)
Seat 6: Pablo7-Pro folded before Flop (didn't bet)



PokerStars Hand #222947280710:  Hold'em No Limit ($0.05/$0.10 USD) - 2021/01/23 2:56:04 ET
Table 'Polydoros II' 6-max Seat #3 is the button
Seat 1: delbergg ($20.06 in chips) 
Seat 2: Jermein ($19.05 in chips) 
Seat 3: father here ($10.10 in chips) 
Seat 4: Lord_Antoan ($10.57 in chips) 
Seat 6: Pablo7-Pro ($32 in chips) 
Lord_Antoan: posts small blind $0.05
12311985: is sitting out 
Pablo7-Pro: posts big blind $0.10
*** HOLE CARDS ***
delbergg: folds 
Jermein: folds 
father here: raises $0.10 to $0.20
Lord_Antoan: raises $0.80 to $1
Pablo7-Pro: folds 
father here: calls $0.80
*** FLOP *** [3c 7c 5c]
Lord_Antoan: checks 
father here: checks 
*** TURN *** [3c 7c 5c] [3s]
Lord_Antoan: checks 
father here: checks 
*** RIVER *** [3c 7c 5c 3s] [8c]
Lord_Antoan: bets $0.90
father here: folds 
Uncalled bet ($0.90) returned to Lord_Antoan
Lord_Antoan collected $2.01 from pot
Lord_Antoan: doesn't show hand 
*** SUMMARY ***
Total pot $2.10 | Rake $0.09 
Board [3c 7c 5c 3s 8c]
Seat 1: delbergg folded before Flop (didn't bet)
Seat 2: Jermein folded before Flop (didn't bet)
Seat 3: father here (button) folded on the River
Seat 4: Lord_Antoan (small blind) collected ($2.01)
Seat 6: Pablo7-Pro (big blind) folded before Flop



PokerStars Hand #222947297233:  Hold'em No Limit ($0.05/$0.10 USD) - 2021/01/23 2:57:28 ET
Table 'Polydoros II' 6-max Seat #4 is the button
Seat 1: delbergg ($20.06 in chips) 
Seat 2: Jermein ($19.05 in chips) 
Seat 3: father here ($10 in chips) 
Seat 4: Lord_Antoan ($11.58 in chips) 
Seat 6: Pablo7-Pro ($31.90 in chips) 
Pablo7-Pro: posts small blind $0.05
delbergg: posts big blind $0.10
*** HOLE CARDS ***
Jermein: folds 
father here: folds 
Lord_Antoan: raises $0.20 to $0.30
Pablo7-Pro: folds 
delbergg: calls $0.20
*** FLOP *** [Qc 9s Tc]
delbergg: checks 
Lord_Antoan: bets $0.22
delbergg: calls $0.22
*** TURN *** [Qc 9s Tc] [4h]
delbergg: checks 
Lord_Antoan: bets $0.40
delbergg: calls $0.40
*** RIVER *** [Qc 9s Tc 4h] [6s]
delbergg: bets $2.90
Lord_Antoan: folds 
Uncalled bet ($2.90) returned to delbergg
delbergg collected $1.80 from pot
delbergg: doesn't show hand 
*** SUMMARY ***
Total pot $1.89 | Rake $0.09 
Board [Qc 9s Tc 4h 6s]
Seat 1: delbergg (big blind) collected ($1.80)
Seat 2: Jermein folded before Flop (didn't bet)
Seat 3: father here folded before Flop (didn't bet)
Seat 4: Lord_Antoan (button) folded on the River
Seat 6: Pablo7-Pro (small blind) folded before Flop



PokerStars Hand #222947310880:  Hold'em No Limit ($0.05/$0.10 USD) - 2021/01/23 2:58:37 ET
Table 'Polydoros II' 6-max Seat #6 is the button
Seat 1: delbergg ($20.94 in chips) 
Seat 2: Jermein ($19.05 in chips) 
Seat 3: father here ($10 in chips) 
Seat 4: Lord_Antoan ($10.66 in chips) 
Seat 6: Pablo7-Pro ($31.85 in chips) 
delbergg: posts small blind $0.05
Jermein: posts big blind $0.10
12311985: sits out 
*** HOLE CARDS ***
father here: folds 
Lord_Antoan: raises $0.20 to $0.30
Pablo7-Pro: calls $0.30
delbergg: folds 
Jermein: folds 
*** FLOP *** [Qc 7c 4h]
Lord_Antoan: checks 
Pablo7-Pro: checks 
*** TURN *** [Qc 7c 4h] [Th]
Lord_Antoan: bets $0.40
Pablo7-Pro: calls $0.40
*** RIVER *** [Qc 7c 4h Th] [Kd]
Lord_Antoan: checks 
Pablo7-Pro: bets $1.15
Lord_Antoan: folds 
Uncalled bet ($1.15) returned to Pablo7-Pro
Pablo7-Pro collected $1.48 from pot
Pablo7-Pro: doesn't show hand 
*** SUMMARY ***
Total pot $1.55 | Rake $0.07 
Board [Qc 7c 4h Th Kd]
Seat 1: delbergg (small blind) folded before Flop
Seat 2: Jermein (big blind) folded before Flop
Seat 3: father here folded before Flop (didn't bet)
Seat 4: Lord_Antoan folded on the River
Seat 6: Pablo7-Pro (button) collected ($1.48)



PokerStars Hand #222947323142:  Hold'em No Limit ($0.05/$0.10 USD) - 2021/01/23 2:59:39 ET
Table 'Polydoros II' 6-max Seat #1 is the button
Seat 1: delbergg ($20.89 in chips) 
Seat 2: Jermein ($18.95 in chips) 
Seat 3: father here ($10 in chips) 
Seat 4: Lord_Antoan ($10 in chips) 
Seat 6: Pablo7-Pro ($32.63 in chips) 
Jermein: posts small blind $0.05
father here: posts big blind $0.10
12311985: sits out 
*** HOLE CARDS ***
Lord_Antoan: folds 
Pablo7-Pro: raises $0.20 to $0.30
delbergg: folds 
Jermein: folds 
father here: folds 
Uncalled bet ($0.20) returned to Pablo7-Pro
Pablo7-Pro collected $0.25 from pot
Pablo7-Pro: doesn't show hand 
*** SUMMARY ***
Total pot $0.25 | Rake $0 
Seat 1: delbergg (button) folded before Flop (didn't bet)
Seat 2: Jermein (small blind) folded before Flop
Seat 3: father here (big blind) folded before Flop
Seat 4: Lord_Antoan folded before Flop (didn't bet)
Seat 6: Pablo7-Pro collected ($0.25)



PokerStars Hand #222947325934:  Hold'em No Limit ($0.05/$0.10 USD) - 2021/01/23 2:59:54 ET
Table 'Polydoros II' 6-max Seat #2 is the button
Seat 1: delbergg ($20.89 in chips) 
Seat 2: Jermein ($18.90 in chips) 
Seat 3: father here ($10 in chips) 
Seat 4: Lord_Antoan ($10 in chips) 
Seat 6: Pablo7-Pro ($32.78 in chips) 
father here: posts small blind $0.05
Lord_Antoan: posts big blind $0.10
12311985: sits out 
*** HOLE CARDS ***
Pablo7-Pro: raises $0.20 to $0.30
delbergg: folds 
Jermein: folds 
father here: folds 
Lord_Antoan: folds 
Uncalled bet ($0.20) returned to Pablo7-Pro
Pablo7-Pro collected $0.25 from pot
Pablo7-Pro: doesn't show hand 
*** SUMMARY ***
Total pot $0.25 | Rake $0 
Seat 1: delbergg folded before Flop (didn't bet)
Seat 2: Jermein (button) folded before Flop (didn't bet)
Seat 3: father here (small blind) folded before Flop
Seat 4: Lord_Antoan (big blind) folded before Flop
Seat 6: Pablo7-Pro collected ($0.25)



PokerStars Hand #222947333088:  Hold'em No Limit ($0.05/$0.10 USD) - 2021/01/23 3:00:29 ET
Table 'Polydoros II' 6-max Seat #3 is the button
Seat 1: delbergg ($20.89 in chips) 
Seat 2: Jermein ($18.90 in chips) 
Seat 3: father here ($10 in chips) 
Seat 4: Lord_Antoan ($10 in chips) 
Seat 5: 12311985 ($19.15 in chips) 
Seat 6: Pablo7-Pro ($32.93 in chips) 
Lord_Antoan: posts small blind $0.05
12311985: posts big blind $0.10
*** HOLE CARDS ***
Pablo7-Pro: folds 
delbergg: folds 
Jermein: raises $0.20 to $0.30
father here: folds 
Lord_Antoan: raises $1.10 to $1.40
12311985: folds 
Jermein: folds 
Uncalled bet ($1.10) returned to Lord_Antoan
Lord_Antoan collected $0.70 from pot
Lord_Antoan: doesn't show hand 
*** SUMMARY ***
Total pot $0.70 | Rake $0 
Seat 1: delbergg folded before Flop (didn't bet)
Seat 2: Jermein folded before Flop
Seat 3: father here (button) folded before Flop (didn't bet)
Seat 4: Lord_Antoan (small blind) collected ($0.70)
Seat 5: 12311985 (big blind) folded before Flop
Seat 6: Pablo7-Pro folded before Flop (didn't bet)



PokerStars Hand #222947339129:  Hold'em No Limit ($0.05/$0.10 USD) - 2021/01/23 3:00:56 ET
Table 'Polydoros II' 6-max Seat #4 is the button
Seat 1: delbergg ($20.89 in chips) 
Seat 2: Jermein ($18.60 in chips) 
Seat 3: father here ($10 in chips) 
Seat 4: Lord_Antoan ($10.40 in chips) 
Seat 5: 12311985 ($19.05 in chips) 
Seat 6: Pablo7-Pro ($32.93 in chips) 
12311985: posts small blind $0.05
Pablo7-Pro: posts big blind $0.10
*** HOLE CARDS ***
delbergg: folds 
Jermein: folds 
father here: raises $0.20 to $0.30
Lord_Antoan: folds 
12311985: folds 
Pablo7-Pro: calls $0.20
*** FLOP *** [9h 9c 8s]
Pablo7-Pro: checks 
father here: bets $0.40
Pablo7-Pro: calls $0.40
*** TURN *** [9h 9c 8s] [Tc]
Pablo7-Pro: checks 
father here: checks 
*** RIVER *** [9h 9c 8s Tc] [9s]
Pablo7-Pro: checks 
father here: bets $0.80
Pablo7-Pro: calls $0.80
*** SHOW DOWN ***
father here: shows [Td Qh] (a full house, Nines full of Tens)
Pablo7-Pro: mucks hand 
father here collected $2.91 from pot
*** SUMMARY ***
Total pot $3.05 | Rake $0.14 
Board [9h 9c 8s Tc 9s]
Seat 1: delbergg folded before Flop (didn't bet)
Seat 2: Jermein folded before Flop (didn't bet)
Seat 3: father here showed [Td Qh] and won ($2.91) with a full house, Nines full of Tens
Seat 4: Lord_Antoan (button) folded before Flop (didn't bet)
Seat 5: 12311985 (small blind) folded before Flop
Seat 6: Pablo7-Pro (big blind) mucked



PokerStars Hand #222947354821:  Hold'em No Limit ($0.05/$0.10 USD) - 2021/01/23 3:02:07 ET
Table 'Polydoros II' 6-max Seat #5 is the button
Seat 1: delbergg ($20.89 in chips) 
Seat 2: Jermein ($18.60 in chips) 
Seat 3: father here ($11.41 in chips) 
Seat 4: Lord_Antoan ($10.40 in chips) 
Seat 5: 12311985 ($19 in chips) 
Seat 6: Pablo7-Pro ($31.43 in chips) 
Pablo7-Pro: posts small blind $0.05
delbergg: posts big blind $0.10
*** HOLE CARDS ***
Jermein: raises $0.20 to $0.30
father here: folds 
Lord_Antoan: folds 
12311985: folds 
Pablo7-Pro: folds 
delbergg: calls $0.20
*** FLOP *** [2d 5h 8d]
delbergg: checks 
Jermein: bets $0.31
delbergg: calls $0.31
*** TURN *** [2d 5h 8d] [Ts]
delbergg: bets $0.90
Jermein: folds 
Uncalled bet ($0.90) returned to delbergg
delbergg collected $1.21 from pot
delbergg: doesn't show hand 
*** SUMMARY ***
Total pot $1.27 | Rake $0.06 
Board [2d 5h 8d Ts]
Seat 1: delbergg (big blind) collected ($1.21)
Seat 2: Jermein folded on the Turn
Seat 3: father here folded before Flop (didn't bet)
Seat 4: Lord_Antoan folded before Flop (didn't bet)
Seat 5: 12311985 (button) folded before Flop (didn't bet)
Seat 6: Pablo7-Pro (small blind) folded before Flop



PokerStars Hand #222947368981:  Hold'em No Limit ($0.05/$0.10 USD) - 2021/01/23 3:03:08 ET
Table 'Polydoros II' 6-max Seat #6 is the button
Seat 1: delbergg ($21.49 in chips) 
Seat 3: father here ($11.41 in chips) 
Seat 4: Lord_Antoan ($10.40 in chips) 
Seat 5: 12311985 ($19 in chips) 
Seat 6: Pablo7-Pro ($31.38 in chips) 
delbergg: posts small blind $0.05
Jermein: is sitting out 
father here: posts big blind $0.10
*** HOLE CARDS ***
Jermein leaves the table
Lord_Antoan: raises $0.20 to $0.30
12311985: folds 
Pablo7-Pro: folds 
delbergg: folds 
father here: folds 
Uncalled bet ($0.20) returned to Lord_Antoan
Lord_Antoan collected $0.25 from pot
Lord_Antoan: doesn't show hand 
*** SUMMARY ***
Total pot $0.25 | Rake $0 
Seat 1: delbergg (small blind) folded before Flop
Seat 3: father here (big blind) folded before Flop
Seat 4: Lord_Antoan collected ($0.25)
Seat 5: 12311985 folded before Flop (didn't bet)
Seat 6: Pablo7-Pro (button) folded before Flop (didn't bet)



PokerStars Hand #222947377291:  Hold'em No Limit ($0.05/$0.10 USD) - 2021/01/23 3:03:44 ET
Table 'Polydoros II' 6-max Seat #1 is the button
Seat 1: delbergg ($21.44 in chips) 
Seat 3: father here ($11.31 in chips) 
Seat 4: Lord_Antoan ($10.55 in chips) 
Seat 5: 12311985 ($19 in chips) 
Seat 6: Pablo7-Pro ($31.38 in chips) 
father here: posts small blind $0.05
Lord_Antoan: posts big blind $0.10
*** HOLE CARDS ***
12311985: folds 
Pablo7-Pro: raises $0.20 to $0.30
delbergg: raises $0.60 to $0.90
father here: folds 
Lord_Antoan: folds 
Pablo7-Pro: folds 
Uncalled bet ($0.60) returned to delbergg
delbergg collected $0.75 from pot
delbergg: doesn't show hand 
*** SUMMARY ***
Total pot $0.75 | Rake $0 
Seat 1: delbergg (button) collected ($0.75)
Seat 3: father here (small blind) folded before Flop
Seat 4: Lord_Antoan (big blind) folded before Flop
Seat 5: 12311985 folded before Flop (didn't bet)
Seat 6: Pablo7-Pro folded before Flop



PokerStars Hand #222947382133:  Hold'em No Limit ($0.05/$0.10 USD) - 2021/01/23 3:04:05 ET
Table 'Polydoros II' 6-max Seat #3 is the button
Seat 1: delbergg ($21.89 in chips) 
Seat 3: father here ($11.26 in chips) 
Seat 4: Lord_Antoan ($10.45 in chips) 
Seat 5: 12311985 ($19 in chips) 
Seat 6: Pablo7-Pro ($31.08 in chips) 
Lord_Antoan: posts small blind $0.05
12311985: posts big blind $0.10
*** HOLE CARDS ***
Pablo7-Pro: folds 
delbergg: folds 
father here: folds 
Lord_Antoan: raises $0.20 to $0.30
12311985: folds 
Uncalled bet ($0.20) returned to Lord_Antoan
Lord_Antoan collected $0.20 from pot
Lord_Antoan: doesn't show hand 
*** SUMMARY ***
Total pot $0.20 | Rake $0 
Seat 1: delbergg folded before Flop (didn't bet)
Seat 3: father here (button) folded before Flop (didn't bet)
Seat 4: Lord_Antoan (small blind) collected ($0.20)
Seat 5: 12311985 (big blind) folded before Flop
Seat 6: Pablo7-Pro folded before Flop (didn't bet)



PokerStars Hand #222947384820:  Hold'em No Limit ($0.05/$0.10 USD) - 2021/01/23 3:04:16 ET
Table 'Polydoros II' 6-max Seat #4 is the button
Seat 1: delbergg ($21.89 in chips) 
Seat 3: father here ($11.26 in chips) 
Seat 4: Lord_Antoan ($10.55 in chips) 
Seat 5: 12311985 ($18.90 in chips) 
Seat 6: Pablo7-Pro ($31.08 in chips) 
12311985: posts small blind $0.05
Pablo7-Pro: posts big blind $0.10
*** HOLE CARDS ***
delbergg: raises $0.15 to $0.25
father here: folds 
DrLevty joins the table at seat #2 
Lord_Antoan: folds 
12311985: folds 
Pablo7-Pro: calls $0.15
*** FLOP *** [8h Tc Qh]
Pablo7-Pro: checks 
delbergg: bets $0.60
Pablo7-Pro: folds 
Uncalled bet ($0.60) returned to delbergg
delbergg collected $0.53 from pot
delbergg: doesn't show hand 
*** SUMMARY ***
Total pot $0.55 | Rake $0.02 
Board [8h Tc Qh]
Seat 1: delbergg collected ($0.53)
Seat 3: father here folded before Flop (didn't bet)
Seat 4: Lord_Antoan (button) folded before Flop (didn't bet)
Seat 5: 12311985 (small blind) folded before Flop
Seat 6: Pablo7-Pro (big blind) folded on the Flop



PokerStars Hand #222947390459:  Hold'em No Limit ($0.05/$0.10 USD) - 2021/01/23 3:04:40 ET
Table 'Polydoros II' 6-max Seat #5 is the button
Seat 1: delbergg ($22.17 in chips) 
Seat 3: father here ($11.26 in chips) 
Seat 4: Lord_Antoan ($10.55 in chips) 
Seat 5: 12311985 ($18.85 in chips) 
Seat 6: Pablo7-Pro ($30.83 in chips) 
Pablo7-Pro: posts small blind $0.05
delbergg: posts big blind $0.10
DrLevty: sits out 
*** HOLE CARDS ***
father here: folds 
Lord_Antoan: raises $0.20 to $0.30
12311985: raises $0.60 to $0.90
Pablo7-Pro: raises $1.50 to $2.40
delbergg: folds 
Lord_Antoan: folds 
12311985: folds 
Uncalled bet ($1.50) returned to Pablo7-Pro
Pablo7-Pro collected $2.20 from pot
Pablo7-Pro: doesn't show hand 
*** SUMMARY ***
Total pot $2.20 | Rake $0 
Seat 1: delbergg (big blind) folded before Flop
Seat 3: father here folded before Flop (didn't bet)
Seat 4: Lord_Antoan folded before Flop
Seat 5: 12311985 (button) folded before Flop
Seat 6: Pablo7-Pro (small blind) collected ($2.20)



PokerStars Hand #222947396924:  Hold'em No Limit ($0.05/$0.10 USD) - 2021/01/23 3:05:08 ET
Table 'Polydoros II' 6-max Seat #6 is the button
Seat 1: delbergg ($22.07 in chips) 
Seat 2: DrLevty ($10 in chips) 
Seat 3: father here ($11.26 in chips) 
Seat 4: Lord_Antoan ($10.25 in chips) 
Seat 5: 12311985 ($17.95 in chips) 
Seat 6: Pablo7-Pro ($32.13 in chips) 
delbergg: posts small blind $0.05
DrLevty: posts big blind $0.10
*** HOLE CARDS ***
father here: folds 
Lord_Antoan: folds 
12311985: raises $0.15 to $0.25
Pablo7-Pro: folds 
delbergg: calls $0.20
DrLevty: folds 
*** FLOP *** [2h 6d 6c]
delbergg: checks 
12311985: checks 
*** TURN *** [2h 6d 6c] [Kd]
delbergg: checks 
12311985: bets $0.40
delbergg: calls $0.40
*** RIVER *** [2h 6d 6c Kd] [3s]
delbergg: checks 
12311985: checks 
*** SHOW DOWN ***
delbergg: shows [Kc 8c] (two pair, Kings and Sixes)
12311985: mucks hand 
delbergg collected $1.34 from pot
*** SUMMARY ***
Total pot $1.40 | Rake $0.06 
Board [2h 6d 6c Kd 3s]
Seat 1: delbergg (small blind) showed [Kc 8c] and won ($1.34) with two pair, Kings and Sixes
Seat 2: DrLevty (big blind) folded before Flop
Seat 3: father here folded before Flop (didn't bet)
Seat 4: Lord_Antoan folded before Flop (didn't bet)
Seat 5: 12311985 mucked
Seat 6: Pablo7-Pro (button) folded before Flop (didn't bet)



PokerStars Hand #222947403257:  Hold'em No Limit ($0.05/$0.10 USD) - 2021/01/23 3:05:36 ET
Table 'Polydoros II' 6-max Seat #1 is the button
Seat 1: delbergg ($22.76 in chips) 
Seat 2: DrLevty ($10 in chips) 
Seat 3: father here ($11.26 in chips) 
Seat 4: Lord_Antoan ($10.25 in chips) 
Seat 5: 12311985 ($17.30 in chips) 
Seat 6: Pablo7-Pro ($32.13 in chips) 
DrLevty: posts small blind $0.05
father here: posts big blind $0.10
*** HOLE CARDS ***
Lord_Antoan: folds 
12311985: folds 
Pablo7-Pro: folds 
delbergg: raises $0.15 to $0.25
DrLevty: folds 
father here: calls $0.15
*** FLOP *** [9c Ks Tc]
father here: bets $0.30
delbergg: folds 
Uncalled bet ($0.30) returned to father here
Lord_Antoan leaves the table
father here collected $0.53 from pot
*** SUMMARY ***
Total pot $0.55 | Rake $0.02 
Board [9c Ks Tc]
Seat 1: delbergg (button) folded on the Flop
Seat 2: DrLevty (small blind) folded before Flop
Seat 3: father here (big blind) collected ($0.53)
Seat 4: Lord_Antoan folded before Flop (didn't bet)
Seat 5: 12311985 folded before Flop (didn't bet)
Seat 6: Pablo7-Pro folded before Flop (didn't bet)



PokerStars Hand #222947411336:  Hold'em No Limit ($0.05/$0.10 USD) - 2021/01/23 3:06:10 ET
Table 'Polydoros II' 6-max Seat #2 is the button
Seat 1: delbergg ($22.51 in chips) 
Seat 2: DrLevty ($10 in chips) 
Seat 3: father here ($11.54 in chips) 
Seat 5: 12311985 ($17.30 in chips) 
Seat 6: Pablo7-Pro ($32.13 in chips) 
father here: posts small blind $0.05
12311985: posts big blind $0.10
*** HOLE CARDS ***
Pablo7-Pro: folds 
delbergg: folds 
DrLevty: raises $0.20 to $0.30
father here: folds 
Lindst joins the table at seat #4 
12311985: folds 
Uncalled bet ($0.20) returned to DrLevty
DrLevty collected $0.25 from pot
DrLevty: doesn't show hand 
*** SUMMARY ***
Total pot $0.25 | Rake $0 
Seat 1: delbergg folded before Flop (didn't bet)
Seat 2: DrLevty (button) collected ($0.25)
Seat 3: father here (small blind) folded before Flop
Seat 5: 12311985 (big blind) folded before Flop
Seat 6: Pablo7-Pro folded before Flop (didn't bet)



PokerStars Hand #222947414898:  Hold'em No Limit ($0.05/$0.10 USD) - 2021/01/23 3:06:26 ET
Table 'Polydoros II' 6-max Seat #3 is the button
Seat 1: delbergg ($22.51 in chips) 
Seat 2: DrLevty ($10.15 in chips) 
Seat 3: father here ($11.49 in chips) 
Seat 5: 12311985 ($17.20 in chips) 
Seat 6: Pablo7-Pro ($32.13 in chips) 
12311985: posts small blind $0.05
Pablo7-Pro: posts big blind $0.10
*** HOLE CARDS ***
delbergg: folds 
DrLevty: folds 
father here: folds 
12311985: folds 
Uncalled bet ($0.05) returned to Pablo7-Pro
Pablo7-Pro collected $0.10 from pot
Pablo7-Pro: doesn't show hand 
*** SUMMARY ***
Total pot $0.10 | Rake $0 
Seat 1: delbergg folded before Flop (didn't bet)
Seat 2: DrLevty folded before Flop (didn't bet)
Seat 3: father here (button) folded before Flop (didn't bet)
Seat 5: 12311985 (small blind) folded before Flop
Seat 6: Pablo7-Pro (big blind) collected ($0.10)



PokerStars Hand #222947417167:  Hold'em No Limit ($0.05/$0.10 USD) - 2021/01/23 3:06:36 ET
Table 'Polydoros II' 6-max Seat #5 is the button
Seat 1: delbergg ($22.51 in chips) 
Seat 2: DrLevty ($10.15 in chips) 
Seat 3: father here ($11.49 in chips) 
Seat 5: 12311985 ($17.15 in chips) 
Seat 6: Pablo7-Pro ($32.18 in chips) 
Pablo7-Pro: posts small blind $0.05
delbergg: posts big blind $0.10
Lindst: sits out 
*** HOLE CARDS ***
DrLevty: folds 
father here: folds 
12311985: folds 
Pablo7-Pro: folds 
Uncalled bet ($0.05) returned to delbergg
delbergg collected $0.10 from pot
*** SUMMARY ***
Total pot $0.10 | Rake $0 
Seat 1: delbergg (big blind) collected ($0.10)
Seat 2: DrLevty folded before Flop (didn't bet)
Seat 3: father here folded before Flop (didn't bet)
Seat 5: 12311985 (button) folded before Flop (didn't bet)
Seat 6: Pablo7-Pro (small blind) folded before Flop



PokerStars Hand #222947420096:  Hold'em No Limit ($0.05/$0.10 USD) - 2021/01/23 3:06:48 ET
Table 'Polydoros II' 6-max Seat #6 is the button
Seat 1: delbergg ($22.56 in chips) 
Seat 2: DrLevty ($10.15 in chips) 
Seat 3: father here ($11.49 in chips) 
Seat 5: 12311985 ($17.15 in chips) 
Seat 6: Pablo7-Pro ($32.13 in chips) 
delbergg: posts small blind $0.05
DrLevty: posts big blind $0.10
Lindst: sits out 
*** HOLE CARDS ***
father here: folds 
12311985: folds 
Pablo7-Pro: folds 
delbergg: folds 
Uncalled bet ($0.05) returned to DrLevty
DrLevty collected $0.10 from pot
DrLevty: doesn't show hand 
*** SUMMARY ***
Total pot $0.10 | Rake $0 
Seat 1: delbergg (small blind) folded before Flop
Seat 2: DrLevty (big blind) collected ($0.10)
Seat 3: father here folded before Flop (didn't bet)
Seat 5: 12311985 folded before Flop (didn't bet)
Seat 6: Pablo7-Pro (button) folded before Flop (didn't bet)



PokerStars Hand #222947424827:  Hold'em No Limit ($0.05/$0.10 USD) - 2021/01/23 3:07:09 ET
Table 'Polydoros II' 6-max Seat #1 is the button
Seat 1: delbergg ($22.51 in chips) 
Seat 2: DrLevty ($10.20 in chips) 
Seat 3: father here ($11.49 in chips) 
Seat 5: 12311985 ($17.15 in chips) 
Seat 6: Pablo7-Pro ($32.13 in chips) 
DrLevty: posts small blind $0.05
father here: posts big blind $0.10
Lindst: sits out 
*** HOLE CARDS ***
12311985: folds 
Pablo7-Pro: folds 
delbergg: raises $0.15 to $0.25
DrLevty: folds 
father here: folds 
Uncalled bet ($0.15) returned to delbergg
delbergg collected $0.25 from pot
*** SUMMARY ***
Total pot $0.25 | Rake $0 
Seat 1: delbergg (button) collected ($0.25)
Seat 2: DrLevty (small blind) folded before Flop
Seat 3: father here (big blind) folded before Flop
Seat 5: 12311985 folded before Flop (didn't bet)
Seat 6: Pablo7-Pro folded before Flop (didn't bet)



PokerStars Hand #222947427262:  Hold'em No Limit ($0.05/$0.10 USD) - 2021/01/23 3:07:19 ET
Table 'Polydoros II' 6-max Seat #2 is the button
Seat 1: delbergg ($22.66 in chips) 
Seat 2: DrLevty ($10.15 in chips) 
Seat 3: father here ($11.39 in chips) 
Seat 4: Lindst ($8 in chips) 
Seat 5: 12311985 ($17.15 in chips) 
Seat 6: Pablo7-Pro ($32.13 in chips) 
father here: posts small blind $0.05
Lindst: posts big blind $0.10
*** HOLE CARDS ***
12311985: folds 
Pablo7-Pro: folds 
delbergg: raises $0.15 to $0.25
DrLevty: folds 
father here: folds 
Lindst: folds 
Uncalled bet ($0.15) returned to delbergg
delbergg collected $0.25 from pot
*** SUMMARY ***
Total pot $0.25 | Rake $0 
Seat 1: delbergg collected ($0.25)
Seat 2: DrLevty (button) folded before Flop (didn't bet)
Seat 3: father here (small blind) folded before Flop
Seat 4: Lindst (big blind) folded before Flop
Seat 5: 12311985 folded before Flop (didn't bet)
Seat 6: Pablo7-Pro folded before Flop (didn't bet)



PokerStars Hand #222947430376:  Hold'em No Limit ($0.05/$0.10 USD) - 2021/01/23 3:07:33 ET
Table 'Polydoros II' 6-max Seat #3 is the button
Seat 1: delbergg ($22.81 in chips) 
Seat 2: DrLevty ($10.15 in chips) 
Seat 3: father here ($11.34 in chips) 
Seat 4: Lindst ($7.90 in chips) 
Seat 5: 12311985 ($17.15 in chips) 
Seat 6: Pablo7-Pro ($32.13 in chips) 
Lindst: posts small blind $0.05
12311985: posts big blind $0.10
*** HOLE CARDS ***
Pablo7-Pro: raises $0.20 to $0.30
delbergg: folds 
DrLevty: folds 
father here: calls $0.30
Lindst: folds 
12311985: raises $1.20 to $1.50
Pablo7-Pro: folds 
father here: folds 
Uncalled bet ($1.20) returned to 12311985
12311985 collected $0.95 from pot
12311985: doesn't show hand 
*** SUMMARY ***
Total pot $0.95 | Rake $0 
Seat 1: delbergg folded before Flop (didn't bet)
Seat 2: DrLevty folded before Flop (didn't bet)
Seat 3: father here (button) folded before Flop
Seat 4: Lindst (small blind) folded before Flop
Seat 5: 12311985 (big blind) collected ($0.95)
Seat 6: Pablo7-Pro folded before Flop



PokerStars Hand #222947441134:  Hold'em No Limit ($0.05/$0.10 USD) - 2021/01/23 3:08:19 ET
Table 'Polydoros II' 6-max Seat #4 is the button
Seat 1: delbergg ($22.81 in chips) 
Seat 2: DrLevty ($10.15 in chips) 
Seat 3: father here ($11.04 in chips) 
Seat 4: Lindst ($7.85 in chips) 
Seat 5: 12311985 ($17.80 in chips) 
Seat 6: Pablo7-Pro ($31.83 in chips) 
12311985: posts small blind $0.05
Pablo7-Pro: posts big blind $0.10
*** HOLE CARDS ***
delbergg: folds 
DrLevty: raises $0.20 to $0.30
father here: folds 
Lindst: folds 
12311985: folds 
Pablo7-Pro: calls $0.20
*** FLOP *** [2d 4c 3c]
Pablo7-Pro: checks 
DrLevty: checks 
*** TURN *** [2d 4c 3c] [6s]
Pablo7-Pro: checks 
DrLevty: checks 
*** RIVER *** [2d 4c 3c 6s] [Tc]
Pablo7-Pro: checks 
DrLevty: checks 
*** SHOW DOWN ***
Pablo7-Pro: shows [9c Jc] (a flush, Jack high)
DrLevty: mucks hand 
Pablo7-Pro collected $0.62 from pot
*** SUMMARY ***
Total pot $0.65 | Rake $0.03 
Board [2d 4c 3c 6s Tc]
Seat 1: delbergg folded before Flop (didn't bet)
Seat 2: DrLevty mucked
Seat 3: father here folded before Flop (didn't bet)
Seat 4: Lindst (button) folded before Flop (didn't bet)
Seat 5: 12311985 (small blind) folded before Flop
Seat 6: Pablo7-Pro (big blind) showed [9c Jc] and won ($0.62) with a flush, Jack high



PokerStars Hand #222947451045:  Hold'em No Limit ($0.05/$0.10 USD) - 2021/01/23 3:09:02 ET
Table 'Polydoros II' 6-max Seat #5 is the button
Seat 1: delbergg ($22.81 in chips) 
Seat 2: DrLevty ($10 in chips) 
Seat 3: father here ($11.04 in chips) 
Seat 4: Lindst ($7.85 in chips) 
Seat 5: 12311985 ($17.75 in chips) 
Seat 6: Pablo7-Pro ($32.15 in chips) 
Pablo7-Pro: posts small blind $0.05
delbergg: posts big blind $0.10
*** HOLE CARDS ***
DrLevty: raises $0.20 to $0.30
father here: calls $0.30
Lindst: folds 
12311985: folds 
Pablo7-Pro: folds 
delbergg: folds 
*** FLOP *** [2s Tc Ah]
DrLevty: checks 
father here: checks 
*** TURN *** [2s Tc Ah] [Th]
DrLevty: bets $0.48
father here: folds 
Uncalled bet ($0.48) returned to DrLevty
DrLevty collected $0.72 from pot
DrLevty: doesn't show hand 
*** SUMMARY ***
Total pot $0.75 | Rake $0.03 
Board [2s Tc Ah Th]
Seat 1: delbergg (big blind) folded before Flop
Seat 2: DrLevty collected ($0.72)
Seat 3: father here folded on the Turn
Seat 4: Lindst folded before Flop (didn't bet)
Seat 5: 12311985 (button) folded before Flop (didn't bet)
Seat 6: Pablo7-Pro (small blind) folded before Flop



PokerStars Hand #222947464449:  Hold'em No Limit ($0.05/$0.10 USD) - 2021/01/23 3:09:59 ET
Table 'Polydoros II' 6-max Seat #6 is the button
Seat 1: delbergg ($22.71 in chips) 
Seat 2: DrLevty ($10.42 in chips) 
Seat 3: father here ($10.74 in chips) 
Seat 4: Lindst ($7.85 in chips) 
Seat 5: 12311985 ($17.75 in chips) 
Seat 6: Pablo7-Pro ($32.10 in chips) 
delbergg: posts small blind $0.05
DrLevty: posts big blind $0.10
*** HOLE CARDS ***
father here: folds 
Lindst: calls $0.10
12311985: folds 
Pablo7-Pro: folds 
delbergg: calls $0.05
DrLevty: checks 
*** FLOP *** [Qc Js 6c]
delbergg: checks 
DrLevty: checks 
Lindst: checks 
*** TURN *** [Qc Js 6c] [7c]
delbergg: checks 
DrLevty: bets $0.20
Lindst: folds 
delbergg: calls $0.20
*** RIVER *** [Qc Js 6c 7c] [Td]
delbergg: checks 
DrLevty: bets $0.50
delbergg: folds 
Uncalled bet ($0.50) returned to DrLevty
DrLevty collected $0.67 from pot
DrLevty: doesn't show hand 
*** SUMMARY ***
Total pot $0.70 | Rake $0.03 
Board [Qc Js 6c 7c Td]
Seat 1: delbergg (small blind) folded on the River
Seat 2: DrLevty (big blind) collected ($0.67)
Seat 3: father here folded before Flop (didn't bet)
Seat 4: Lindst folded on the Turn
Seat 5: 12311985 folded before Flop (didn't bet)
Seat 6: Pablo7-Pro (button) folded before Flop (didn't bet)



PokerStars Hand #222947475642:  Hold'em No Limit ($0.05/$0.10 USD) - 2021/01/23 3:10:47 ET
Table 'Polydoros II' 6-max Seat #1 is the button
Seat 1: delbergg ($22.41 in chips) 
Seat 2: DrLevty ($10.79 in chips) 
Seat 3: father here ($10.74 in chips) 
Seat 4: Lindst ($7.75 in chips) 
Seat 5: 12311985 ($17.75 in chips) 
Seat 6: Pablo7-Pro ($32.10 in chips) 
DrLevty: posts small blind $0.05
father here: posts big blind $0.10
*** HOLE CARDS ***
Lindst: calls $0.10
12311985: folds 
Pablo7-Pro: folds 
delbergg: calls $0.10
DrLevty: raises $0.40 to $0.50
father here: folds 
Lindst: calls $0.40
delbergg: calls $0.40
*** FLOP *** [Jc 7c 3h]
DrLevty: checks 
Lindst: bets $0.77
delbergg: calls $0.77
DrLevty: folds 
*** TURN *** [Jc 7c 3h] [8h]
Lindst: bets $1.50
delbergg: calls $1.50
*** RIVER *** [Jc 7c 3h 8h] [5d]
Lindst: bets $4.98 and is all-in
delbergg: folds 
Uncalled bet ($4.98) returned to Lindst
Lindst collected $5.86 from pot
*** SUMMARY ***
Total pot $6.14 | Rake $0.28 
Board [Jc 7c 3h 8h 5d]
Seat 1: delbergg (button) folded on the River
Seat 2: DrLevty (small blind) folded on the Flop
Seat 3: father here (big blind) folded before Flop
Seat 4: Lindst collected ($5.86)
Seat 5: 12311985 folded before Flop (didn't bet)
Seat 6: Pablo7-Pro folded before Flop (didn't bet)



PokerStars Hand #222947492660:  Hold'em No Limit ($0.05/$0.10 USD) - 2021/01/23 3:12:00 ET
Table 'Polydoros II' 6-max Seat #2 is the button
Seat 1: delbergg ($19.64 in chips) 
Seat 2: DrLevty ($10.29 in chips) 
Seat 3: father here ($10.64 in chips) 
Seat 4: Lindst ($10.84 in chips) 
Seat 5: 12311985 ($17.75 in chips) 
Seat 6: Pablo7-Pro ($32.10 in chips) 
father here: posts small blind $0.05
Lindst: posts big blind $0.10
*** HOLE CARDS ***
12311985: folds 
Pablo7-Pro: folds 
delbergg: folds 
DrLevty: raises $0.20 to $0.30
father here: raises $0.70 to $1
Lindst: folds 
DrLevty: calls $0.70
*** FLOP *** [7c 3c 7s]
father here: checks 
DrLevty: bets $0.66
father here: folds 
Uncalled bet ($0.66) returned to DrLevty
DrLevty collected $2.01 from pot
DrLevty: doesn't show hand 
*** SUMMARY ***
Total pot $2.10 | Rake $0.09 
Board [7c 3c 7s]
Seat 1: delbergg folded before Flop (didn't bet)
Seat 2: DrLevty (button) collected ($2.01)
Seat 3: father here (small blind) folded on the Flop
Seat 4: Lindst (big blind) folded before Flop
Seat 5: 12311985 folded before Flop (didn't bet)
Seat 6: Pablo7-Pro folded before Flop (didn't bet)



PokerStars Hand #222947510024:  Hold'em No Limit ($0.05/$0.10 USD) - 2021/01/23 3:13:13 ET
Table 'Polydoros II' 6-max Seat #3 is the button
Seat 1: delbergg ($19.64 in chips) 
Seat 2: DrLevty ($11.30 in chips) 
Seat 3: father here ($10 in chips) 
Seat 4: Lindst ($10.74 in chips) 
Seat 5: 12311985 ($17.75 in chips) 
Seat 6: Pablo7-Pro ($32.10 in chips) 
Lindst: posts small blind $0.05
12311985: posts big blind $0.10
*** HOLE CARDS ***
Pablo7-Pro: folds 
delbergg: folds 
DrLevty: folds 
father here: folds 
Lindst: raises $0.20 to $0.30
12311985: folds 
Uncalled bet ($0.20) returned to Lindst
Lindst collected $0.20 from pot
*** SUMMARY ***
Total pot $0.20 | Rake $0 
Seat 1: delbergg folded before Flop (didn't bet)
Seat 2: DrLevty folded before Flop (didn't bet)
Seat 3: father here (button) folded before Flop (didn't bet)
Seat 4: Lindst (small blind) collected ($0.20)
Seat 5: 12311985 (big blind) folded before Flop
Seat 6: Pablo7-Pro folded before Flop (didn't bet)



PokerStars Hand #222947513425:  Hold'em No Limit ($0.05/$0.10 USD) - 2021/01/23 3:13:27 ET
Table 'Polydoros II' 6-max Seat #4 is the button
Seat 1: delbergg ($19.64 in chips) 
Seat 2: DrLevty ($11.30 in chips) 
Seat 3: father here ($10 in chips) 
Seat 4: Lindst ($10.84 in chips) 
Seat 5: 12311985 ($17.65 in chips) 
Seat 6: Pablo7-Pro ($32.10 in chips) 
12311985: posts small blind $0.05
Pablo7-Pro: posts big blind $0.10
*** HOLE CARDS ***
delbergg: folds 
DrLevty: folds 
father here: raises $0.20 to $0.30
Lindst: folds 
12311985: raises $0.90 to $1.20
Pablo7-Pro: folds 
father here: calls $0.90
*** FLOP *** [Qs 2d Qc]
12311985: bets $0.72
father here: calls $0.72
*** TURN *** [Qs 2d Qc] [Kc]
12311985: bets $2.63
father here: folds 
Uncalled bet ($2.63) returned to 12311985
12311985 collected $3.76 from pot
12311985: doesn't show hand 
*** SUMMARY ***
Total pot $3.94 | Rake $0.18 
Board [Qs 2d Qc Kc]
Seat 1: delbergg folded before Flop (didn't bet)
Seat 2: DrLevty folded before Flop (didn't bet)
Seat 3: father here folded on the Turn
Seat 4: Lindst (button) folded before Flop (didn't bet)
Seat 5: 12311985 (small blind) collected ($3.76)
Seat 6: Pablo7-Pro (big blind) folded before Flop



PokerStars Hand #222947523761:  Hold'em No Limit ($0.05/$0.10 USD) - 2021/01/23 3:14:11 ET
Table 'Polydoros II' 6-max Seat #5 is the button
Seat 1: delbergg ($19.64 in chips) 
Seat 2: DrLevty ($11.30 in chips) 
Seat 3: father here ($10 in chips) 
Seat 4: Lindst ($10.84 in chips) 
Seat 5: 12311985 ($19.49 in chips) 
Seat 6: Pablo7-Pro ($32 in chips) 
Pablo7-Pro: posts small blind $0.05
delbergg: posts big blind $0.10
*** HOLE CARDS ***
DrLevty: folds 
father here: raises $0.20 to $0.30
Lindst: folds 
12311985: folds 
Pablo7-Pro: folds 
delbergg: calls $0.20
*** FLOP *** [8c 3c Ah]
delbergg: checks 
father here: checks 
*** TURN *** [8c 3c Ah] [As]
delbergg: checks 
father here: checks 
*** RIVER *** [8c 3c Ah As] [7c]
delbergg: checks 
father here: checks 
*** SHOW DOWN ***
delbergg: shows [2d Qc] (a pair of Aces)
father here: shows [Kc Jd] (a pair of Aces - King kicker)
father here collected $0.62 from pot
*** SUMMARY ***
Total pot $0.65 | Rake $0.03 
Board [8c 3c Ah As 7c]
Seat 1: delbergg (big blind) showed [2d Qc] and lost with a pair of Aces
Seat 2: DrLevty folded before Flop (didn't bet)
Seat 3: father here showed [Kc Jd] and won ($0.62) with a pair of Aces
Seat 4: Lindst folded before Flop (didn't bet)
Seat 5: 12311985 (button) folded before Flop (didn't bet)
Seat 6: Pablo7-Pro (small blind) folded before Flop



PokerStars Hand #222947538553:  Hold'em No Limit ($0.05/$0.10 USD) - 2021/01/23 3:15:13 ET
Table 'Polydoros II' 6-max Seat #6 is the button
Seat 1: delbergg ($19.34 in chips) 
Seat 2: DrLevty ($11.30 in chips) 
Seat 3: father here ($10.32 in chips) 
Seat 4: Lindst ($10.84 in chips) 
Seat 5: 12311985 ($19.49 in chips) 
Seat 6: Pablo7-Pro ($31.95 in chips) 
delbergg: posts small blind $0.05
DrLevty: posts big blind $0.10
*** HOLE CARDS ***
father here: folds 
Lindst: folds 
12311985: folds 
Pablo7-Pro: folds 
delbergg: raises $0.20 to $0.30
DrLevty: folds 
Uncalled bet ($0.20) returned to delbergg
delbergg collected $0.20 from pot
*** SUMMARY ***
Total pot $0.20 | Rake $0 
Seat 1: delbergg (small blind) collected ($0.20)
Seat 2: DrLevty (big blind) folded before Flop
Seat 3: father here folded before Flop (didn't bet)
Seat 4: Lindst folded before Flop (didn't bet)
Seat 5: 12311985 folded before Flop (didn't bet)
Seat 6: Pablo7-Pro (button) folded before Flop (didn't bet)



PokerStars Hand #222947544623:  Hold'em No Limit ($0.05/$0.10 USD) - 2021/01/23 3:15:38 ET
Table 'Polydoros II' 6-max Seat #1 is the button
Seat 1: delbergg ($19.44 in chips) 
Seat 2: DrLevty ($11.20 in chips) 
Seat 3: father here ($10.32 in chips) 
Seat 4: Lindst ($10.84 in chips) 
Seat 5: 12311985 ($19.49 in chips) 
Seat 6: Pablo7-Pro ($31.95 in chips) 
DrLevty: posts small blind $0.05
father here: posts big blind $0.10
*** HOLE CARDS ***
Lindst: raises $0.25 to $0.35
12311985: raises $0.65 to $1
Pablo7-Pro: folds 
delbergg: folds 
DrLevty: folds 
father here: folds 
Lindst: calls $0.65
*** FLOP *** [2h As 4s]
Lindst: checks 
12311985: bets $0.62
Lindst: raises $0.62 to $1.24
12311985: calls $0.62
*** TURN *** [2h As 4s] [4d]
Lindst: bets $3.32
12311985: folds 
Uncalled bet ($3.32) returned to Lindst
Lindst collected $4.42 from pot
*** SUMMARY ***
Total pot $4.63 | Rake $0.21 
Board [2h As 4s 4d]
Seat 1: delbergg (button) folded before Flop (didn't bet)
Seat 2: DrLevty (small blind) folded before Flop
Seat 3: father here (big blind) folded before Flop
Seat 4: Lindst collected ($4.42)
Seat 5: 12311985 folded on the Turn
Seat 6: Pablo7-Pro folded before Flop (didn't bet)



PokerStars Hand #222947557818:  Hold'em No Limit ($0.05/$0.10 USD) - 2021/01/23 3:16:34 ET
Table 'Polydoros II' 6-max Seat #2 is the button
Seat 1: delbergg ($19.44 in chips) 
Seat 2: DrLevty ($11.15 in chips) 
Seat 3: father here ($10.22 in chips) 
Seat 4: Lindst ($13.02 in chips) 
Seat 5: 12311985 ($17.25 in chips) 
Seat 6: Pablo7-Pro ($31.95 in chips) 
father here: posts small blind $0.05
Lindst: posts big blind $0.10
*** HOLE CARDS ***
12311985: folds 
Pablo7-Pro: raises $0.20 to $0.30
delbergg: folds 
DrLevty: folds 
father here: folds 
Lindst: folds 
Uncalled bet ($0.20) returned to Pablo7-Pro
Pablo7-Pro collected $0.25 from pot
Pablo7-Pro: doesn't show hand 
*** SUMMARY ***
Total pot $0.25 | Rake $0 
Seat 1: delbergg folded before Flop (didn't bet)
Seat 2: DrLevty (button) folded before Flop (didn't bet)
Seat 3: father here (small blind) folded before Flop
Seat 4: Lindst (big blind) folded before Flop
Seat 5: 12311985 folded before Flop (didn't bet)
Seat 6: Pablo7-Pro collected ($0.25)



PokerStars Hand #222947562424:  Hold'em No Limit ($0.05/$0.10 USD) - 2021/01/23 3:16:53 ET
Table 'Polydoros II' 6-max Seat #3 is the button
Seat 1: delbergg ($19.44 in chips) 
Seat 2: DrLevty ($11.15 in chips) 
Seat 3: father here ($10.17 in chips) 
Seat 4: Lindst ($12.92 in chips) 
Seat 5: 12311985 ($17.25 in chips) 
Seat 6: Pablo7-Pro ($32.10 in chips) 
Lindst: posts small blind $0.05
12311985: posts big blind $0.10
*** HOLE CARDS ***
Pablo7-Pro: folds 
delbergg: raises $0.15 to $0.25
DrLevty: raises $0.50 to $0.75
father here: folds 
Lindst: folds 
12311985: folds 
delbergg: calls $0.50
*** FLOP *** [3d Qs 4d]
delbergg: checks 
DrLevty: bets $0.52
delbergg: folds 
Uncalled bet ($0.52) returned to DrLevty
DrLevty collected $1.58 from pot
DrLevty: doesn't show hand 
*** SUMMARY ***
Total pot $1.65 | Rake $0.07 
Board [3d Qs 4d]
Seat 1: delbergg folded on the Flop
Seat 2: DrLevty collected ($1.58)
Seat 3: father here (button) folded before Flop (didn't bet)
Seat 4: Lindst (small blind) folded before Flop
Seat 5: 12311985 (big blind) folded before Flop
Seat 6: Pablo7-Pro folded before Flop (didn't bet)



PokerStars Hand #222947572197:  Hold'em No Limit ($0.05/$0.10 USD) - 2021/01/23 3:17:35 ET
Table 'Polydoros II' 6-max Seat #4 is the button
Seat 1: delbergg ($18.69 in chips) 
Seat 2: DrLevty ($11.98 in chips) 
Seat 3: father here ($10.17 in chips) 
Seat 4: Lindst ($12.87 in chips) 
Seat 5: 12311985 ($17.15 in chips) 
Seat 6: Pablo7-Pro ($32.10 in chips) 
12311985: posts small blind $0.05
Pablo7-Pro: posts big blind $0.10
*** HOLE CARDS ***
delbergg: folds 
DrLevty: folds 
father here: folds 
Lindst: calls $0.10
12311985: folds 
Pablo7-Pro: checks 
*** FLOP *** [6s 7d 8h]
Pablo7-Pro: checks 
Lindst: bets $0.18
Pablo7-Pro: calls $0.18
*** TURN *** [6s 7d 8h] [Kc]
Pablo7-Pro: checks 
Lindst: checks 
*** RIVER *** [6s 7d 8h Kc] [Js]
Pablo7-Pro: checks 
Lindst: checks 
*** SHOW DOWN ***
Pablo7-Pro: shows [Ts Qd] (high card King)
Lindst: shows [Ac 9h] (high card Ace)
Lindst collected $0.58 from pot
*** SUMMARY ***
Total pot $0.61 | Rake $0.03 
Board [6s 7d 8h Kc Js]
Seat 1: delbergg folded before Flop (didn't bet)
Seat 2: DrLevty folded before Flop (didn't bet)
Seat 3: father here folded before Flop (didn't bet)
Seat 4: Lindst (button) showed [Ac 9h] and won ($0.58) with high card Ace
Seat 5: 12311985 (small blind) folded before Flop
Seat 6: Pablo7-Pro (big blind) showed [Ts Qd] and lost with high card King



PokerStars Hand #222947582587:  Hold'em No Limit ($0.05/$0.10 USD) - 2021/01/23 3:18:18 ET
Table 'Polydoros II' 6-max Seat #5 is the button
Seat 1: delbergg ($18.69 in chips) 
Seat 2: DrLevty ($11.98 in chips) 
Seat 3: father here ($10.17 in chips) 
Seat 4: Lindst ($13.17 in chips) 
Seat 5: 12311985 ($17.10 in chips) 
Seat 6: Pablo7-Pro ($31.82 in chips) 
Pablo7-Pro: posts small blind $0.05
delbergg: posts big blind $0.10
*** HOLE CARDS ***
DrLevty: folds 
father here: folds 
Lindst: folds 
12311985: folds 
Pablo7-Pro: folds 
Uncalled bet ($0.05) returned to delbergg
delbergg collected $0.10 from pot
*** SUMMARY ***
Total pot $0.10 | Rake $0 
Seat 1: delbergg (big blind) collected ($0.10)
Seat 2: DrLevty folded before Flop (didn't bet)
Seat 3: father here folded before Flop (didn't bet)
Seat 4: Lindst folded before Flop (didn't bet)
Seat 5: 12311985 (button) folded before Flop (didn't bet)
Seat 6: Pablo7-Pro (small blind) folded before Flop



PokerStars Hand #222947587177:  Hold'em No Limit ($0.05/$0.10 USD) - 2021/01/23 3:18:37 ET
Table 'Polydoros II' 6-max Seat #6 is the button
Seat 1: delbergg ($18.74 in chips) 
Seat 2: DrLevty ($11.98 in chips) 
Seat 3: father here ($10.17 in chips) 
Seat 4: Lindst ($13.17 in chips) 
Seat 5: 12311985 ($17.10 in chips) 
Seat 6: Pablo7-Pro ($31.77 in chips) 
delbergg: posts small blind $0.05
DrLevty: posts big blind $0.10
*** HOLE CARDS ***
father here: raises $0.20 to $0.30
Lindst: folds 
12311985: folds 
Pablo7-Pro: folds 
delbergg: folds 
DrLevty: folds 
Uncalled bet ($0.20) returned to father here
DrLevty leaves the table
father here collected $0.25 from pot
*** SUMMARY ***
Total pot $0.25 | Rake $0 
Seat 1: delbergg (small blind) folded before Flop
Seat 2: DrLevty (big blind) folded before Flop
Seat 3: father here collected ($0.25)
Seat 4: Lindst folded before Flop (didn't bet)
Seat 5: 12311985 folded before Flop (didn't bet)
Seat 6: Pablo7-Pro (button) folded before Flop (didn't bet)



PokerStars Hand #222947589376:  Hold'em No Limit ($0.05/$0.10 USD) - 2021/01/23 3:18:46 ET
Table 'Polydoros II' 6-max Seat #1 is the button
Seat 1: delbergg ($18.69 in chips) 
Seat 3: father here ($10.32 in chips) 
Seat 4: Lindst ($13.17 in chips) 
Seat 5: 12311985 ($17.10 in chips) 
Seat 6: Pablo7-Pro ($31.77 in chips) 
father here: posts small blind $0.05
Lindst: posts big blind $0.10
*** HOLE CARDS ***
Sutherland01 joins the table at seat #2 
12311985: folds 
Pablo7-Pro: folds 
delbergg: raises $0.15 to $0.25
father here: calls $0.20
Lindst: calls $0.15
*** FLOP *** [5s 3h 5c]
father here: checks 
Lindst: checks 
delbergg: bets $0.22
father here: folds 
Lindst: folds 
Uncalled bet ($0.22) returned to delbergg
delbergg collected $0.72 from pot
delbergg: doesn't show hand 
*** SUMMARY ***
Total pot $0.75 | Rake $0.03 
Board [5s 3h 5c]
Seat 1: delbergg (button) collected ($0.72)
Seat 3: father here (small blind) folded on the Flop
Seat 4: Lindst (big blind) folded on the Flop
Seat 5: 12311985 folded before Flop (didn't bet)
Seat 6: Pablo7-Pro folded before Flop (didn't bet)



PokerStars Hand #222947599854:  Hold'em No Limit ($0.05/$0.10 USD) - 2021/01/23 3:19:30 ET
Table 'Polydoros II' 6-max Seat #3 is the button
Seat 1: delbergg ($19.16 in chips) 
Seat 2: Sutherland01 ($4.05 in chips) 
Seat 3: father here ($10.07 in chips) 
Seat 4: Lindst ($12.92 in chips) 
Seat 5: 12311985 ($17.10 in chips) 
Seat 6: Pablo7-Pro ($31.77 in chips) 
Lindst: posts small blind $0.05
12311985: posts big blind $0.10
Sutherland01: posts big blind $0.10
*** HOLE CARDS ***
Pablo7-Pro: raises $0.20 to $0.30
delbergg: folds 
Sutherland01: folds 
father here: folds 
Lindst: folds 
12311985: folds 
Uncalled bet ($0.20) returned to Pablo7-Pro
Pablo7-Pro collected $0.35 from pot
Pablo7-Pro: doesn't show hand 
*** SUMMARY ***
Total pot $0.35 | Rake $0 
Seat 1: delbergg folded before Flop (didn't bet)
Seat 2: Sutherland01 folded before Flop (didn't bet)
Seat 3: father here (button) folded before Flop (didn't bet)
Seat 4: Lindst (small blind) folded before Flop
Seat 5: 12311985 (big blind) folded before Flop
Seat 6: Pablo7-Pro collected ($0.35)



PokerStars Hand #222947602571:  Hold'em No Limit ($0.05/$0.10 USD) - 2021/01/23 3:19:41 ET
Table 'Polydoros II' 6-max Seat #4 is the button
Seat 1: delbergg ($19.16 in chips) 
Seat 2: Sutherland01 ($3.95 in chips) 
Seat 3: father here ($10.07 in chips) 
Seat 4: Lindst ($12.87 in chips) 
Seat 5: 12311985 ($17 in chips) 
Seat 6: Pablo7-Pro ($32.02 in chips) 
12311985: posts small blind $0.05
Pablo7-Pro: posts big blind $0.10
*** HOLE CARDS ***
delbergg: folds 
Sutherland01: raises $0.10 to $0.20
father here: calls $0.20
Lindst: folds 
12311985: folds 
Pablo7-Pro: folds 
*** FLOP *** [4h 5h 4d]
Sutherland01: bets $0.36
father here: folds 
Uncalled bet ($0.36) returned to Sutherland01
Sutherland01 collected $0.53 from pot
Sutherland01: doesn't show hand 
*** SUMMARY ***
Total pot $0.55 | Rake $0.02 
Board [4h 5h 4d]
Seat 1: delbergg folded before Flop (didn't bet)
Seat 2: Sutherland01 collected ($0.53)
Seat 3: father here folded on the Flop
Seat 4: Lindst (button) folded before Flop (didn't bet)
Seat 5: 12311985 (small blind) folded before Flop
Seat 6: Pablo7-Pro (big blind) folded before Flop



PokerStars Hand #222947609500:  Hold'em No Limit ($0.05/$0.10 USD) - 2021/01/23 3:20:10 ET
Table 'Polydoros II' 6-max Seat #5 is the button
Seat 1: delbergg ($19.16 in chips) 
Seat 2: Sutherland01 ($4.28 in chips) 
Seat 3: father here ($10 in chips) 
Seat 4: Lindst ($12.87 in chips) 
Seat 5: 12311985 ($16.95 in chips) 
Seat 6: Pablo7-Pro ($31.92 in chips) 
Pablo7-Pro: posts small blind $0.05
delbergg: posts big blind $0.10
*** HOLE CARDS ***
Sutherland01: folds 
father here: raises $0.20 to $0.30
Lindst: folds 
12311985: folds 
Pablo7-Pro: folds 
delbergg: calls $0.20
*** FLOP *** [3c Th Jc]
delbergg: checks 
father here: bets $0.40
delbergg: calls $0.40
*** TURN *** [3c Th Jc] [6s]
delbergg: checks 
father here: checks 
*** RIVER *** [3c Th Jc 6s] [2h]
delbergg: bets $2.40
father here: folds 
Uncalled bet ($2.40) returned to delbergg
delbergg collected $1.38 from pot
*** SUMMARY ***
Total pot $1.45 | Rake $0.07 
Board [3c Th Jc 6s 2h]
Seat 1: delbergg (big blind) collected ($1.38)
Seat 2: Sutherland01 folded before Flop (didn't bet)
Seat 3: father here folded on the River
Seat 4: Lindst folded before Flop (didn't bet)
Seat 5: 12311985 (button) folded before Flop (didn't bet)
Seat 6: Pablo7-Pro (small blind) folded before Flop



PokerStars Hand #222947620907:  Hold'em No Limit ($0.05/$0.10 USD) - 2021/01/23 3:20:58 ET
Table 'Polydoros II' 6-max Seat #6 is the button
Seat 1: delbergg ($19.84 in chips) 
Seat 2: Sutherland01 ($4.28 in chips) 
Seat 3: father here ($10 in chips) 
Seat 4: Lindst ($12.87 in chips) 
Seat 5: 12311985 ($16.95 in chips) 
Seat 6: Pablo7-Pro ($31.87 in chips) 
delbergg: posts small blind $0.05
Sutherland01: posts big blind $0.10
*** HOLE CARDS ***
father here: folds 
Lindst: folds 
12311985: folds 
Pablo7-Pro: folds 
delbergg: calls $0.05
Sutherland01: checks 
*** FLOP *** [Qs 3d Ah]
delbergg: bets $0.10
Sutherland01: calls $0.10
*** TURN *** [Qs 3d Ah] [As]
delbergg: checks 
Sutherland01: checks 
*** RIVER *** [Qs 3d Ah As] [5d]
delbergg: checks 
Sutherland01: bets $0.30
delbergg: folds 
Uncalled bet ($0.30) returned to Sutherland01
Sutherland01 collected $0.38 from pot
Sutherland01: doesn't show hand 
*** SUMMARY ***
Total pot $0.40 | Rake $0.02 
Board [Qs 3d Ah As 5d]
Seat 1: delbergg (small blind) folded on the River
Seat 2: Sutherland01 (big blind) collected ($0.38)
Seat 3: father here folded before Flop (didn't bet)
Seat 4: Lindst folded before Flop (didn't bet)
Seat 5: 12311985 folded before Flop (didn't bet)
Seat 6: Pablo7-Pro (button) folded before Flop (didn't bet)



PokerStars Hand #222947629982:  Hold'em No Limit ($0.05/$0.10 USD) - 2021/01/23 3:21:36 ET
Table 'Polydoros II' 6-max Seat #1 is the button
Seat 1: delbergg ($19.64 in chips) 
Seat 2: Sutherland01 ($4.46 in chips) 
Seat 3: father here ($10 in chips) 
Seat 4: Lindst ($12.87 in chips) 
Seat 5: 12311985 ($16.95 in chips) 
Seat 6: Pablo7-Pro ($31.87 in chips) 
Sutherland01: posts small blind $0.05
father here: posts big blind $0.10
*** HOLE CARDS ***
Lindst: folds 
12311985: raises $0.15 to $0.25
Pablo7-Pro: folds 
delbergg: raises $0.55 to $0.80
Sutherland01: folds 
father here: folds 
12311985: raises $1.25 to $2.05
delbergg: calls $1.25
*** FLOP *** [2d 5h Qd]
12311985: bets $1.22
delbergg: calls $1.22
*** TURN *** [2d 5h Qd] [3d]
12311985: checks 
delbergg: bets $1.98
12311985: folds 
Uncalled bet ($1.98) returned to delbergg
delbergg collected $6.39 from pot
delbergg: doesn't show hand 
*** SUMMARY ***
Total pot $6.69 | Rake $0.30 
Board [2d 5h Qd 3d]
Seat 1: delbergg (button) collected ($6.39)
Seat 2: Sutherland01 (small blind) folded before Flop
Seat 3: father here (big blind) folded before Flop
Seat 4: Lindst folded before Flop (didn't bet)
Seat 5: 12311985 folded on the Turn
Seat 6: Pablo7-Pro folded before Flop (didn't bet)



PokerStars Hand #222947642369:  Hold'em No Limit ($0.05/$0.10 USD) - 2021/01/23 3:22:27 ET
Table 'Polydoros II' 6-max Seat #2 is the button
Seat 1: delbergg ($22.76 in chips) 
Seat 2: Sutherland01 ($4.41 in chips) 
Seat 3: father here ($10 in chips) 
Seat 4: Lindst ($12.87 in chips) 
Seat 5: 12311985 ($13.68 in chips) 
Seat 6: Pablo7-Pro ($31.87 in chips) 
father here: posts small blind $0.05
Lindst: posts big blind $0.10
*** HOLE CARDS ***
12311985: folds 
Pablo7-Pro: folds 
delbergg: raises $0.15 to $0.25
Sutherland01: calls $0.25
father here: raises $0.95 to $1.20
Lindst: folds 
delbergg: folds 
Sutherland01: calls $0.95
*** FLOP *** [Jd 7c Tc]
father here: bets $8.80 and is all-in
Sutherland01: calls $3.21 and is all-in
Uncalled bet ($5.59) returned to father here
*** TURN *** [Jd 7c Tc] [4h]
*** RIVER *** [Jd 7c Tc 4h] [Kc]
*** SHOW DOWN ***
father here: shows [Qc Qh] (a pair of Queens)
Sutherland01: shows [9d 9h] (a pair of Nines)
Sutherland01 cashed out the hand for $1.95 | Cash Out Fee $0.02
father here cashed out the hand for $6.72 | Cash Out Fee $0.07
*** SUMMARY ***
Total pot $9.17 | Rake $0.41 
Board [Jd 7c Tc 4h Kc]
Seat 1: delbergg folded before Flop
Seat 2: Sutherland01 (button) showed [9d 9h] and lost with a pair of Nines (cashed out).
Seat 3: father here (small blind) showed [Qc Qh] and won ($8.76) with a pair of Queens (pot not awarded as player cashed out)
Seat 4: Lindst (big blind) folded before Flop
Seat 5: 12311985 folded before Flop (didn't bet)
Seat 6: Pablo7-Pro folded before Flop (didn't bet)



PokerStars Hand #222947659232:  Hold'em No Limit ($0.05/$0.10 USD) - 2021/01/23 3:23:38 ET
Table 'Polydoros II' 6-max Seat #3 is the button
Seat 1: delbergg ($22.51 in chips) 
Seat 2: Sutherland01 ($1.95 in chips) 
Seat 3: father here ($12.31 in chips) 
Seat 4: Lindst ($12.77 in chips) 
Seat 5: 12311985 ($13.68 in chips) 
Seat 6: Pablo7-Pro ($31.87 in chips) 
Lindst: posts small blind $0.05
12311985: posts big blind $0.10
*** HOLE CARDS ***
Pablo7-Pro: folds 
delbergg: raises $0.15 to $0.25
Sutherland01: calls $0.25
father here: folds 
Lindst: folds 
12311985: folds 
*** FLOP *** [7h 6d 4d]
delbergg: checks 
Sutherland01: checks 
*** TURN *** [7h 6d 4d] [Jd]
delbergg: bets $0.16
Sutherland01: folds 
Uncalled bet ($0.16) returned to delbergg
delbergg collected $0.62 from pot
*** SUMMARY ***
Total pot $0.65 | Rake $0.03 
Board [7h 6d 4d Jd]
Seat 1: delbergg collected ($0.62)
Seat 2: Sutherland01 folded on the Turn
Seat 3: father here (button) folded before Flop (didn't bet)
Seat 4: Lindst (small blind) folded before Flop
Seat 5: 12311985 (big blind) folded before Flop
Seat 6: Pablo7-Pro folded before Flop (didn't bet)



PokerStars Hand #222947669012:  Hold'em No Limit ($0.05/$0.10 USD) - 2021/01/23 3:24:18 ET
Table 'Polydoros II' 6-max Seat #4 is the button
Seat 1: delbergg ($22.88 in chips) 
Seat 2: Sutherland01 ($1.70 in chips) 
Seat 3: father here ($12.31 in chips) 
Seat 4: Lindst ($12.72 in chips) 
Seat 5: 12311985 ($13.58 in chips) 
Seat 6: Pablo7-Pro ($31.87 in chips) 
12311985: posts small blind $0.05
Pablo7-Pro: posts big blind $0.10
*** HOLE CARDS ***
delbergg: folds 
Sutherland01: raises $0.10 to $0.20
father here: calls $0.20
Lindst: folds 
12311985: folds 
Pablo7-Pro: folds 
*** FLOP *** [As 9d Kd]
Sutherland01: checks 
father here: checks 
*** TURN *** [As 9d Kd] [5c]
Sutherland01: bets $0.30
father here: calls $0.30
*** RIVER *** [As 9d Kd 5c] [Ad]
Sutherland01: checks 
father here: checks 
*** SHOW DOWN ***
Sutherland01: shows [Jc Qs] (a pair of Aces)
father here: shows [Td Kc] (two pair, Aces and Kings)
father here collected $1.10 from pot
*** SUMMARY ***
Total pot $1.15 | Rake $0.05 
Board [As 9d Kd 5c Ad]
Seat 1: delbergg folded before Flop (didn't bet)
Seat 2: Sutherland01 showed [Jc Qs] and lost with a pair of Aces
Seat 3: father here showed [Td Kc] and won ($1.10) with two pair, Aces and Kings
Seat 4: Lindst (button) folded before Flop (didn't bet)
Seat 5: 12311985 (small blind) folded before Flop
Seat 6: Pablo7-Pro (big blind) folded before Flop



PokerStars Hand #222947684818:  Hold'em No Limit ($0.05/$0.10 USD) - 2021/01/23 3:25:24 ET
Table 'Polydoros II' 6-max Seat #5 is the button
Seat 1: delbergg ($22.88 in chips) 
Seat 2: Sutherland01 ($1.20 in chips) 
Seat 3: father here ($12.91 in chips) 
Seat 4: Lindst ($12.72 in chips) 
Seat 5: 12311985 ($13.53 in chips) 
Seat 6: Pablo7-Pro ($31.77 in chips) 
Pablo7-Pro: posts small blind $0.05
delbergg: posts big blind $0.10
*** HOLE CARDS ***
Sutherland01: folds 
father here: raises $0.20 to $0.30
Lindst: calls $0.30
12311985: folds 
Pablo7-Pro: folds 
delbergg: calls $0.20
*** FLOP *** [Kd Ac Th]
delbergg: checks 
father here: checks 
Lindst: bets $0.46
delbergg: folds 
father here: calls $0.46
*** TURN *** [Kd Ac Th] [Ah]
father here: checks 
Lindst: checks 
*** RIVER *** [Kd Ac Th Ah] [5s]
father here: bets $0.90
Lindst: calls $0.90
*** SHOW DOWN ***
father here: shows [Qd Ad] (three of a kind, Aces)
Lindst: mucks hand 
father here collected $3.50 from pot
*** SUMMARY ***
Total pot $3.67 | Rake $0.17 
Board [Kd Ac Th Ah 5s]
Seat 1: delbergg (big blind) folded on the Flop
Seat 2: Sutherland01 folded before Flop (didn't bet)
Seat 3: father here showed [Qd Ad] and won ($3.50) with three of a kind, Aces
Seat 4: Lindst mucked
Seat 5: 12311985 (button) folded before Flop (didn't bet)
Seat 6: Pablo7-Pro (small blind) folded before Flop



PokerStars Hand #222947698237:  Hold'em No Limit ($0.05/$0.10 USD) - 2021/01/23 3:26:20 ET
Table 'Polydoros II' 6-max Seat #6 is the button
Seat 1: delbergg ($22.58 in chips) 
Seat 2: Sutherland01 ($1.20 in chips) 
Seat 3: father here ($14.75 in chips) 
Seat 4: Lindst ($11.06 in chips) 
Seat 5: 12311985 ($13.53 in chips) 
Seat 6: Pablo7-Pro ($31.72 in chips) 
delbergg: posts small blind $0.05
Sutherland01: posts big blind $0.10
*** HOLE CARDS ***
father here: raises $0.20 to $0.30
Lindst: folds 
12311985: folds 
Pablo7-Pro: folds 
delbergg: folds 
Sutherland01: folds 
Uncalled bet ($0.20) returned to father here
father here collected $0.25 from pot
*** SUMMARY ***
Total pot $0.25 | Rake $0 
Seat 1: delbergg (small blind) folded before Flop
Seat 2: Sutherland01 (big blind) folded before Flop
Seat 3: father here collected ($0.25)
Seat 4: Lindst folded before Flop (didn't bet)
Seat 5: 12311985 folded before Flop (didn't bet)
Seat 6: Pablo7-Pro (button) folded before Flop (didn't bet)



PokerStars Hand #222947702786:  Hold'em No Limit ($0.05/$0.10 USD) - 2021/01/23 3:26:39 ET
Table 'Polydoros II' 6-max Seat #1 is the button
Seat 1: delbergg ($22.53 in chips) 
Seat 2: Sutherland01 ($1.10 in chips) 
Seat 3: father here ($14.90 in chips) 
Seat 4: Lindst ($11.06 in chips) 
Seat 5: 12311985 ($13.53 in chips) 
Seat 6: Pablo7-Pro ($31.72 in chips) 
Sutherland01: posts small blind $0.05
father here: posts big blind $0.10
*** HOLE CARDS ***
Lindst: raises $0.25 to $0.35
12311985: raises $0.65 to $1
Pablo7-Pro: folds 
delbergg: folds 
Sutherland01: folds 
father here: folds 
Lindst: calls $0.65
*** FLOP *** [3c 7c Ac]
Lindst: checks 
12311985: bets $1.03
Lindst: calls $1.03
*** TURN *** [3c 7c Ac] [9s]
Lindst: checks 
12311985: bets $2.81
Lindst: calls $2.81
*** RIVER *** [3c 7c Ac 9s] [3d]
Lindst: bets $6.22 and is all-in
12311985: calls $6.22
*** SHOW DOWN ***
Lindst: shows [Kc As] (two pair, Aces and Threes)
12311985: shows [Kh Ad] (two pair, Aces and Threes)
Lindst collected $10.64 from pot
12311985 collected $10.63 from pot
*** SUMMARY ***
Total pot $22.27 | Rake $1 
Board [3c 7c Ac 9s 3d]
Seat 1: delbergg (button) folded before Flop (didn't bet)
Seat 2: Sutherland01 (small blind) folded before Flop
Seat 3: father here (big blind) folded before Flop
Seat 4: Lindst showed [Kc As] and won ($10.64) with two pair, Aces and Threes
Seat 5: 12311985 showed [Kh Ad] and won ($10.63) with two pair, Aces and Threes
Seat 6: Pablo7-Pro folded before Flop (didn't bet)



PokerStars Hand #222947715696:  Hold'em No Limit ($0.05/$0.10 USD) - 2021/01/23 3:27:32 ET
Table 'Polydoros II' 6-max Seat #2 is the button
Seat 1: delbergg ($22.53 in chips) 
Seat 2: Sutherland01 ($1.05 in chips) 
Seat 3: father here ($14.80 in chips) 
Seat 4: Lindst ($10.64 in chips) 
Seat 5: 12311985 ($13.10 in chips) 
Seat 6: Pablo7-Pro ($31.72 in chips) 
father here: posts small blind $0.05
Lindst: posts big blind $0.10
*** HOLE CARDS ***
12311985: folds 
Pablo7-Pro: folds 
delbergg: raises $0.15 to $0.25
Sutherland01: folds 
father here: folds 
Lindst: folds 
Uncalled bet ($0.15) returned to delbergg
delbergg collected $0.25 from pot
delbergg: doesn't show hand 
*** SUMMARY ***
Total pot $0.25 | Rake $0 
Seat 1: delbergg collected ($0.25)
Seat 2: Sutherland01 (button) folded before Flop (didn't bet)
Seat 3: father here (small blind) folded before Flop
Seat 4: Lindst (big blind) folded before Flop
Seat 5: 12311985 folded before Flop (didn't bet)
Seat 6: Pablo7-Pro folded before Flop (didn't bet)



PokerStars Hand #222947719544:  Hold'em No Limit ($0.05/$0.10 USD) - 2021/01/23 3:27:48 ET
Table 'Polydoros II' 6-max Seat #3 is the button
Seat 1: delbergg ($22.68 in chips) 
Seat 2: Sutherland01 ($1.05 in chips) 
Seat 3: father here ($14.75 in chips) 
Seat 4: Lindst ($10.54 in chips) 
Seat 6: Pablo7-Pro ($31.72 in chips) 
Lindst: posts small blind $0.05
12311985: is sitting out 
Pablo7-Pro: posts big blind $0.10
*** HOLE CARDS ***
delbergg: folds 
Sutherland01: folds 
father here: raises $0.25 to $0.35
Lindst: folds 
Pablo7-Pro: calls $0.25
*** FLOP *** [3h 9d 9h]
Pablo7-Pro: checks 
father here: checks 
*** TURN *** [3h 9d 9h] [5c]
Pablo7-Pro: checks 
father here: checks 
*** RIVER *** [3h 9d 9h 5c] [Qc]
Pablo7-Pro: bets $0.56
12311985 leaves the table
father here: folds 
Uncalled bet ($0.56) returned to Pablo7-Pro
Pablo7-Pro collected $0.72 from pot
Pablo7-Pro: doesn't show hand 
*** SUMMARY ***
Total pot $0.75 | Rake $0.03 
Board [3h 9d 9h 5c Qc]
Seat 1: delbergg folded before Flop (didn't bet)
Seat 2: Sutherland01 folded before Flop (didn't bet)
Seat 3: father here (button) folded on the River
Seat 4: Lindst (small blind) folded before Flop
Seat 6: Pablo7-Pro (big blind) collected ($0.72)



PokerStars Hand #222948349615:  Hold'em No Limit ($0.05/$0.10 USD) - 2021/01/23 4:10:09 ET
Table 'Polydoros II' 6-max Seat #6 is the button
Seat 1: delbergg ($21.62 in chips) 
Seat 2: GreenChe ($17.96 in chips) 
Seat 3: armin75 ($9.85 in chips) 
Seat 4: Silveradom ($11.97 in chips) 
Seat 5: Samirzade ($6.56 in chips) 
Seat 6: Sergey_Bolos ($11.20 in chips) 
delbergg: posts small blind $0.05
GreenChe: posts big blind $0.10
*** HOLE CARDS ***
armin75: folds 
Silveradom: folds 
Samirzade: raises $0.10 to $0.20
Sergey_Bolos: folds 
delbergg: calls $0.15
GreenChe: folds 
*** FLOP *** [Qc 3h Ks]
delbergg: checks 
Samirzade: bets $0.24
delbergg: calls $0.24
*** TURN *** [Qc 3h Ks] [8d]
delbergg: checks 
Samirzade: bets $0.47
delbergg: calls $0.47
*** RIVER *** [Qc 3h Ks 8d] [7d]
delbergg: checks 
Samirzade: checks 
*** SHOW DOWN ***
delbergg: shows [Td Jh] (high card King)
Samirzade: shows [Qd 9d] (a pair of Queens)
Samirzade collected $1.83 from pot
*** SUMMARY ***
Total pot $1.92 | Rake $0.09 
Board [Qc 3h Ks 8d 7d]
Seat 1: delbergg (small blind) showed [Td Jh] and lost with high card King
Seat 2: GreenChe (big blind) folded before Flop
Seat 3: armin75 folded before Flop (didn't bet)
Seat 4: Silveradom folded before Flop (didn't bet)
Seat 5: Samirzade showed [Qd 9d] and won ($1.83) with a pair of Queens
Seat 6: Sergey_Bolos (button) folded before Flop (didn't bet)



PokerStars Hand #222948357521:  Hold'em No Limit ($0.05/$0.10 USD) - 2021/01/23 4:10:40 ET
Table 'Polydoros II' 6-max Seat #1 is the button
Seat 1: delbergg ($20.71 in chips) 
Seat 2: GreenChe ($17.86 in chips) 
Seat 3: armin75 ($9.85 in chips) 
Seat 4: Silveradom ($11.97 in chips) 
Seat 5: Samirzade ($7.48 in chips) 
Seat 6: Sergey_Bolos ($11.20 in chips) 
GreenChe: posts small blind $0.05
armin75: posts big blind $0.10
*** HOLE CARDS ***
Silveradom: folds 
Samirzade: folds 
Sergey_Bolos: folds 
delbergg: raises $0.15 to $0.25
GreenChe: folds 
armin75: folds 
Uncalled bet ($0.15) returned to delbergg
delbergg collected $0.25 from pot
*** SUMMARY ***
Total pot $0.25 | Rake $0 
Seat 1: delbergg (button) collected ($0.25)
Seat 2: GreenChe (small blind) folded before Flop
Seat 3: armin75 (big blind) folded before Flop
Seat 4: Silveradom folded before Flop (didn't bet)
Seat 5: Samirzade folded before Flop (didn't bet)
Seat 6: Sergey_Bolos folded before Flop (didn't bet)



PokerStars Hand #222948359988:  Hold'em No Limit ($0.05/$0.10 USD) - 2021/01/23 4:10:50 ET
Table 'Polydoros II' 6-max Seat #2 is the button
Seat 1: delbergg ($20.86 in chips) 
Seat 2: GreenChe ($17.81 in chips) 
Seat 3: armin75 ($9.75 in chips) 
Seat 4: Silveradom ($11.97 in chips) 
Seat 5: Samirzade ($7.48 in chips) 
Seat 6: Sergey_Bolos ($11.20 in chips) 
armin75: posts small blind $0.05
Silveradom: posts big blind $0.10
*** HOLE CARDS ***
Samirzade: folds 
Sergey_Bolos: folds 
delbergg: raises $0.15 to $0.25
GreenChe: folds 
armin75: raises $0.60 to $0.85
Silveradom: folds 
delbergg: calls $0.60
*** FLOP *** [Kc 7d Jh]
armin75: bets $0.86
delbergg: calls $0.86
*** TURN *** [Kc 7d Jh] [4h]
armin75: bets $1.68
delbergg: calls $1.68
*** RIVER *** [Kc 7d Jh 4h] [Ts]
armin75: bets $0.10
delbergg: calls $0.10
*** SHOW DOWN ***
armin75: shows [4d Kd] (two pair, Kings and Fours)
delbergg: mucks hand 
armin75 collected $6.76 from pot
*** SUMMARY ***
Total pot $7.08 | Rake $0.32 
Board [Kc 7d Jh 4h Ts]
Seat 1: delbergg mucked
Seat 2: GreenChe (button) folded before Flop (didn't bet)
Seat 3: armin75 (small blind) showed [4d Kd] and won ($6.76) with two pair, Kings and Fours
Seat 4: Silveradom (big blind) folded before Flop
Seat 5: Samirzade folded before Flop (didn't bet)
Seat 6: Sergey_Bolos folded before Flop (didn't bet)



PokerStars Hand #222948367739:  Hold'em No Limit ($0.05/$0.10 USD) - 2021/01/23 4:11:20 ET
Table 'Polydoros II' 6-max Seat #3 is the button
Seat 1: delbergg ($17.37 in chips) 
Seat 2: GreenChe ($17.81 in chips) 
Seat 3: armin75 ($13.02 in chips) 
Seat 4: Silveradom ($11.87 in chips) 
Seat 5: Samirzade ($7.48 in chips) 
Seat 6: Sergey_Bolos ($11.20 in chips) 
Silveradom: posts small blind $0.05
Samirzade: posts big blind $0.10
*** HOLE CARDS ***
Sergey_Bolos: folds 
delbergg: raises $0.15 to $0.25
GreenChe: folds 
armin75: folds 
Silveradom: folds 
Samirzade: folds 
Uncalled bet ($0.15) returned to delbergg
delbergg collected $0.25 from pot
*** SUMMARY ***
Total pot $0.25 | Rake $0 
Seat 1: delbergg collected ($0.25)
Seat 2: GreenChe folded before Flop (didn't bet)
Seat 3: armin75 (button) folded before Flop (didn't bet)
Seat 4: Silveradom (small blind) folded before Flop
Seat 5: Samirzade (big blind) folded before Flop
Seat 6: Sergey_Bolos folded before Flop (didn't bet)



PokerStars Hand #222948370196:  Hold'em No Limit ($0.05/$0.10 USD) - 2021/01/23 4:11:30 ET
Table 'Polydoros II' 6-max Seat #4 is the button
Seat 1: delbergg ($17.52 in chips) 
Seat 2: GreenChe ($17.81 in chips) 
Seat 3: armin75 ($13.02 in chips) 
Seat 4: Silveradom ($11.82 in chips) 
Seat 5: Samirzade ($7.38 in chips) 
Seat 6: Sergey_Bolos ($11.20 in chips) 
Samirzade: posts small blind $0.05
Sergey_Bolos: posts big blind $0.10
*** HOLE CARDS ***
delbergg: folds 
GreenChe: folds 
armin75: folds 
Silveradom: raises $0.15 to $0.25
Samirzade: calls $0.20
Sergey_Bolos: folds 
*** FLOP *** [Ks As 7d]
Samirzade: checks 
Silveradom: checks 
*** TURN *** [Ks As 7d] [Jh]
Samirzade: bets $0.10
Silveradom: calls $0.10
*** RIVER *** [Ks As 7d Jh] [8c]
Samirzade: bets $0.38
Silveradom: calls $0.38
*** SHOW DOWN ***
Samirzade: shows [Kc Jd] (two pair, Kings and Jacks)
Silveradom: mucks hand 
Samirzade collected $1.49 from pot
*** SUMMARY ***
Total pot $1.56 | Rake $0.07 
Board [Ks As 7d Jh 8c]
Seat 1: delbergg folded before Flop (didn't bet)
Seat 2: GreenChe folded before Flop (didn't bet)
Seat 3: armin75 folded before Flop (didn't bet)
Seat 4: Silveradom (button) mucked
Seat 5: Samirzade (small blind) showed [Kc Jd] and won ($1.49) with two pair, Kings and Jacks
Seat 6: Sergey_Bolos (big blind) folded before Flop



PokerStars Hand #222948377909:  Hold'em No Limit ($0.05/$0.10 USD) - 2021/01/23 4:11:59 ET
Table 'Polydoros II' 6-max Seat #5 is the button
Seat 1: delbergg ($17.52 in chips) 
Seat 2: GreenChe ($17.81 in chips) 
Seat 3: armin75 ($13.02 in chips) 
Seat 4: Silveradom ($11.09 in chips) 
Seat 5: Samirzade ($8.14 in chips) 
Seat 6: Sergey_Bolos ($11.10 in chips) 
Sergey_Bolos: posts small blind $0.05
delbergg: posts big blind $0.10
*** HOLE CARDS ***
GreenChe: folds 
armin75: raises $0.25 to $0.35
Silveradom: folds 
Samirzade: folds 
Sergey_Bolos: calls $0.30
delbergg: folds 
*** FLOP *** [Ks 7d 4c]
Sergey_Bolos: checks 
armin75: bets $0.38
Sergey_Bolos: calls $0.38
*** TURN *** [Ks 7d 4c] [Qh]
Sergey_Bolos: checks 
armin75: checks 
*** RIVER *** [Ks 7d 4c Qh] [Kd]
Sergey_Bolos: bets $0.67
armin75: folds 
Uncalled bet ($0.67) returned to Sergey_Bolos
Sergey_Bolos collected $1.49 from pot
Sergey_Bolos: doesn't show hand 
*** SUMMARY ***
Total pot $1.56 | Rake $0.07 
Board [Ks 7d 4c Qh Kd]
Seat 1: delbergg (big blind) folded before Flop
Seat 2: GreenChe folded before Flop (didn't bet)
Seat 3: armin75 folded on the River
Seat 4: Silveradom folded before Flop (didn't bet)
Seat 5: Samirzade (button) folded before Flop (didn't bet)
Seat 6: Sergey_Bolos (small blind) collected ($1.49)



PokerStars Hand #222948388542:  Hold'em No Limit ($0.05/$0.10 USD) - 2021/01/23 4:12:41 ET
Table 'Polydoros II' 6-max Seat #6 is the button
Seat 1: delbergg ($17.42 in chips) 
Seat 2: GreenChe ($17.81 in chips) 
Seat 3: armin75 ($12.29 in chips) 
Seat 4: Silveradom ($11.09 in chips) 
Seat 5: Samirzade ($8.14 in chips) 
Seat 6: Sergey_Bolos ($11.86 in chips) 
delbergg: posts small blind $0.05
GreenChe: posts big blind $0.10
*** HOLE CARDS ***
armin75: calls $0.10
Silveradom: folds 
Samirzade: folds 
Sergey_Bolos: folds 
delbergg: calls $0.05
GreenChe: checks 
*** FLOP *** [7c 2c Ac]
delbergg: checks 
GreenChe: checks 
armin75: checks 
*** TURN *** [7c 2c Ac] [9h]
delbergg: bets $0.19
GreenChe: folds 
armin75: calls $0.19
*** RIVER *** [7c 2c Ac 9h] [6s]
delbergg: checks 
armin75: bets $0.65
delbergg: calls $0.65
*** SHOW DOWN ***
armin75: shows [6c Kc] (a flush, Ace high)
delbergg: mucks hand 
armin75 collected $1.89 from pot
*** SUMMARY ***
Total pot $1.98 | Rake $0.09 
Board [7c 2c Ac 9h 6s]
Seat 1: delbergg (small blind) mucked
Seat 2: GreenChe (big blind) folded on the Turn
Seat 3: armin75 showed [6c Kc] and won ($1.89) with a flush, Ace high
Seat 4: Silveradom folded before Flop (didn't bet)
Seat 5: Samirzade folded before Flop (didn't bet)
Seat 6: Sergey_Bolos (button) folded before Flop (didn't bet)



PokerStars Hand #222948400038:  Hold'em No Limit ($0.05/$0.10 USD) - 2021/01/23 4:13:25 ET
Table 'Polydoros II' 6-max Seat #1 is the button
Seat 1: delbergg ($16.48 in chips) 
Seat 2: GreenChe ($17.71 in chips) 
Seat 3: armin75 ($13.24 in chips) 
Seat 4: Silveradom ($11.09 in chips) 
Seat 5: Samirzade ($8.14 in chips) 
Seat 6: Sergey_Bolos ($11.86 in chips) 
GreenChe: posts small blind $0.05
armin75: posts big blind $0.10
*** HOLE CARDS ***
Silveradom: folds 
Samirzade: calls $0.10
Sergey_Bolos: raises $0.30 to $0.40
delbergg: folds 
GreenChe: folds 
armin75: folds 
Samirzade: folds 
Uncalled bet ($0.30) returned to Sergey_Bolos
Sergey_Bolos collected $0.35 from pot
Sergey_Bolos: doesn't show hand 
*** SUMMARY ***
Total pot $0.35 | Rake $0 
Seat 1: delbergg (button) folded before Flop (didn't bet)
Seat 2: GreenChe (small blind) folded before Flop
Seat 3: armin75 (big blind) folded before Flop
Seat 4: Silveradom folded before Flop (didn't bet)
Seat 5: Samirzade folded before Flop
Seat 6: Sergey_Bolos collected ($0.35)



PokerStars Hand #222948404610:  Hold'em No Limit ($0.05/$0.10 USD) - 2021/01/23 4:13:43 ET
Table 'Polydoros II' 6-max Seat #2 is the button
Seat 1: delbergg ($16.48 in chips) 
Seat 2: GreenChe ($17.66 in chips) 
Seat 3: armin75 ($13.14 in chips) 
Seat 4: Silveradom ($11.09 in chips) 
Seat 5: Samirzade ($8.04 in chips) 
Seat 6: Sergey_Bolos ($12.11 in chips) 
armin75: posts small blind $0.05
Silveradom: posts big blind $0.10
*** HOLE CARDS ***
Samirzade: raises $0.20 to $0.30
Sergey_Bolos: folds 
delbergg: folds 
GreenChe: folds 
armin75: folds 
Silveradom: folds 
Uncalled bet ($0.20) returned to Samirzade
Samirzade collected $0.25 from pot
Samirzade: doesn't show hand 
*** SUMMARY ***
Total pot $0.25 | Rake $0 
Seat 1: delbergg folded before Flop (didn't bet)
Seat 2: GreenChe (button) folded before Flop (didn't bet)
Seat 3: armin75 (small blind) folded before Flop
Seat 4: Silveradom (big blind) folded before Flop
Seat 5: Samirzade collected ($0.25)
Seat 6: Sergey_Bolos folded before Flop (didn't bet)



PokerStars Hand #222948407840:  Hold'em No Limit ($0.05/$0.10 USD) - 2021/01/23 4:13:56 ET
Table 'Polydoros II' 6-max Seat #3 is the button
Seat 1: delbergg ($16.48 in chips) 
Seat 2: GreenChe ($17.66 in chips) 
Seat 3: armin75 ($13.09 in chips) 
Seat 4: Silveradom ($10.99 in chips) 
Seat 5: Samirzade ($8.19 in chips) 
Seat 6: Sergey_Bolos ($12.11 in chips) 
Silveradom: posts small blind $0.05
Samirzade: posts big blind $0.10
*** HOLE CARDS ***
Sergey_Bolos: folds 
delbergg: folds 
GreenChe: folds 
armin75: calls $0.10
Silveradom: folds 
Samirzade: checks 
*** FLOP *** [4d 7h 3c]
Samirzade: bets $0.10
armin75: calls $0.10
*** TURN *** [4d 7h 3c] [4s]
Samirzade: bets $0.10
armin75: calls $0.10
*** RIVER *** [4d 7h 3c 4s] [2h]
Samirzade: bets $0.31
armin75: calls $0.31
*** SHOW DOWN ***
Samirzade: shows [2c 3d] (two pair, Fours and Threes)
armin75: shows [7c As] (two pair, Sevens and Fours)
armin75 collected $1.21 from pot
*** SUMMARY ***
Total pot $1.27 | Rake $0.06 
Board [4d 7h 3c 4s 2h]
Seat 1: delbergg folded before Flop (didn't bet)
Seat 2: GreenChe folded before Flop (didn't bet)
Seat 3: armin75 (button) showed [7c As] and won ($1.21) with two pair, Sevens and Fours
Seat 4: Silveradom (small blind) folded before Flop
Seat 5: Samirzade (big blind) showed [2c 3d] and lost with two pair, Fours and Threes
Seat 6: Sergey_Bolos folded before Flop (didn't bet)



PokerStars Hand #222948413633:  Hold'em No Limit ($0.05/$0.10 USD) - 2021/01/23 4:14:18 ET
Table 'Polydoros II' 6-max Seat #4 is the button
Seat 1: delbergg ($16.48 in chips) 
Seat 2: GreenChe ($17.66 in chips) 
Seat 3: armin75 ($13.69 in chips) 
Seat 4: Silveradom ($10.94 in chips) 
Seat 5: Samirzade ($7.58 in chips) 
Seat 6: Sergey_Bolos ($12.11 in chips) 
Samirzade: posts small blind $0.05
Sergey_Bolos: posts big blind $0.10
*** HOLE CARDS ***
delbergg: raises $0.15 to $0.25
GreenChe: folds 
armin75: calls $0.25
Silveradom: folds 
Samirzade: folds 
Sergey_Bolos: folds 
*** FLOP *** [2c 6c 6d]
Samirzade leaves the table
delbergg: checks 
armin75: bets $0.62
delbergg: folds 
Uncalled bet ($0.62) returned to armin75
armin75 collected $0.62 from pot
armin75: doesn't show hand 
Impostore1988 joins the table at seat #5 
*** SUMMARY ***
Total pot $0.65 | Rake $0.03 
Board [2c 6c 6d]
Seat 1: delbergg folded on the Flop
Seat 2: GreenChe folded before Flop (didn't bet)
Seat 3: armin75 collected ($0.62)
Seat 4: Silveradom (button) folded before Flop (didn't bet)
Seat 5: Samirzade (small blind) folded before Flop
Seat 6: Sergey_Bolos (big blind) folded before Flop



PokerStars Hand #222948418834:  Hold'em No Limit ($0.05/$0.10 USD) - 2021/01/23 4:14:38 ET
Table 'Polydoros II' 6-max Seat #6 is the button
Seat 1: delbergg ($16.23 in chips) 
Seat 2: GreenChe ($17.66 in chips) 
Seat 3: armin75 ($14.06 in chips) 
Seat 4: Silveradom ($10.94 in chips) 
Seat 6: Sergey_Bolos ($12.01 in chips) 
delbergg: posts small blind $0.05
GreenChe: posts big blind $0.10
Impostore1988: sits out 
*** HOLE CARDS ***
armin75: folds 
Silveradom: raises $0.20 to $0.30
Sergey_Bolos: calls $0.30
delbergg: folds 
GreenChe: folds 
*** FLOP *** [2c 6h 7s]
Silveradom: bets $0.55
Sergey_Bolos: calls $0.55
*** TURN *** [2c 6h 7s] [4c]
Silveradom: bets $1.25
Sergey_Bolos: calls $1.25
*** RIVER *** [2c 6h 7s 4c] [Tc]
Silveradom: bets $1.50
Sergey_Bolos: folds 
Uncalled bet ($1.50) returned to Silveradom
Silveradom collected $4.15 from pot
Silveradom: doesn't show hand 
*** SUMMARY ***
Total pot $4.35 | Rake $0.20 
Board [2c 6h 7s 4c Tc]
Seat 1: delbergg (small blind) folded before Flop
Seat 2: GreenChe (big blind) folded before Flop
Seat 3: armin75 folded before Flop (didn't bet)
Seat 4: Silveradom collected ($4.15)
Seat 6: Sergey_Bolos (button) folded on the River



PokerStars Hand #222948431545:  Hold'em No Limit ($0.05/$0.10 USD) - 2021/01/23 4:15:27 ET
Table 'Polydoros II' 6-max Seat #1 is the button
Seat 1: delbergg ($16.18 in chips) 
Seat 2: GreenChe ($17.56 in chips) 
Seat 3: armin75 ($14.06 in chips) 
Seat 4: Silveradom ($12.99 in chips) 
Seat 6: Sergey_Bolos ($10 in chips) 
GreenChe: posts small blind $0.05
armin75: posts big blind $0.10
Impostore1988: sits out 
*** HOLE CARDS ***
Silveradom: folds 
Sergey_Bolos: folds 
delbergg: raises $0.15 to $0.25
GreenChe: folds 
armin75: folds 
Uncalled bet ($0.15) returned to delbergg
delbergg collected $0.25 from pot
delbergg: doesn't show hand 
*** SUMMARY ***
Total pot $0.25 | Rake $0 
Seat 1: delbergg (button) collected ($0.25)
Seat 2: GreenChe (small blind) folded before Flop
Seat 3: armin75 (big blind) folded before Flop
Seat 4: Silveradom folded before Flop (didn't bet)
Seat 6: Sergey_Bolos folded before Flop (didn't bet)



PokerStars Hand #222948434071:  Hold'em No Limit ($0.05/$0.10 USD) - 2021/01/23 4:15:37 ET
Table 'Polydoros II' 6-max Seat #2 is the button
Seat 1: delbergg ($16.33 in chips) 
Seat 2: GreenChe ($17.51 in chips) 
Seat 3: armin75 ($13.96 in chips) 
Seat 4: Silveradom ($12.99 in chips) 
Seat 6: Sergey_Bolos ($10 in chips) 
armin75: posts small blind $0.05
Silveradom: posts big blind $0.10
Impostore1988: sits out 
*** HOLE CARDS ***
Sergey_Bolos: folds 
delbergg: raises $0.15 to $0.25
GreenChe: folds 
armin75: folds 
Silveradom: folds 
Uncalled bet ($0.15) returned to delbergg
delbergg collected $0.25 from pot
delbergg: doesn't show hand 
*** SUMMARY ***
Total pot $0.25 | Rake $0 
Seat 1: delbergg collected ($0.25)
Seat 2: GreenChe (button) folded before Flop (didn't bet)
Seat 3: armin75 (small blind) folded before Flop
Seat 4: Silveradom (big blind) folded before Flop
Seat 6: Sergey_Bolos folded before Flop (didn't bet)



PokerStars Hand #222948437065:  Hold'em No Limit ($0.05/$0.10 USD) - 2021/01/23 4:15:49 ET
Table 'Polydoros II' 6-max Seat #3 is the button
Seat 1: delbergg ($16.48 in chips) 
Seat 2: GreenChe ($17.51 in chips) 
Seat 3: armin75 ($13.91 in chips) 
Seat 4: Silveradom ($12.89 in chips) 
Seat 5: Impostore1988 ($10 in chips) 
Seat 6: Sergey_Bolos ($10 in chips) 
Silveradom: posts small blind $0.05
Impostore1988: posts big blind $0.10
*** HOLE CARDS ***
Sergey_Bolos: folds 
delbergg: raises $0.15 to $0.25
GreenChe: folds 
armin75: calls $0.25
Silveradom: folds 
Impostore1988: folds 
*** FLOP *** [Kh 6d Ac]
delbergg: checks 
armin75: checks 
*** TURN *** [Kh 6d Ac] [Jd]
delbergg: checks 
armin75: checks 
*** RIVER *** [Kh 6d Ac Jd] [8h]
delbergg: checks 
armin75: checks 
*** SHOW DOWN ***
delbergg: shows [6s 5s] (a pair of Sixes)
armin75: mucks hand 
delbergg collected $0.62 from pot
*** SUMMARY ***
Total pot $0.65 | Rake $0.03 
Board [Kh 6d Ac Jd 8h]
Seat 1: delbergg showed [6s 5s] and won ($0.62) with a pair of Sixes
Seat 2: GreenChe folded before Flop (didn't bet)
Seat 3: armin75 (button) mucked
Seat 4: Silveradom (small blind) folded before Flop
Seat 5: Impostore1988 (big blind) folded before Flop
Seat 6: Sergey_Bolos folded before Flop (didn't bet)



PokerStars Hand #222948442936:  Hold'em No Limit ($0.05/$0.10 USD) - 2021/01/23 4:16:11 ET
Table 'Polydoros II' 6-max Seat #4 is the button
Seat 1: delbergg ($16.85 in chips) 
Seat 2: GreenChe ($17.51 in chips) 
Seat 3: armin75 ($13.66 in chips) 
Seat 4: Silveradom ($12.84 in chips) 
Seat 5: Impostore1988 ($9.90 in chips) 
Seat 6: Sergey_Bolos ($10 in chips) 
Impostore1988: posts small blind $0.05
Sergey_Bolos: posts big blind $0.10
*** HOLE CARDS ***
delbergg: raises $0.15 to $0.25
GreenChe: folds 
armin75: folds 
Silveradom: folds 
Impostore1988: folds 
Sergey_Bolos: folds 
Uncalled bet ($0.15) returned to delbergg
delbergg collected $0.25 from pot
delbergg: doesn't show hand 
*** SUMMARY ***
Total pot $0.25 | Rake $0 
Seat 1: delbergg collected ($0.25)
Seat 2: GreenChe folded before Flop (didn't bet)
Seat 3: armin75 folded before Flop (didn't bet)
Seat 4: Silveradom (button) folded before Flop (didn't bet)
Seat 5: Impostore1988 (small blind) folded before Flop
Seat 6: Sergey_Bolos (big blind) folded before Flop



PokerStars Hand #222948445827:  Hold'em No Limit ($0.05/$0.10 USD) - 2021/01/23 4:16:22 ET
Table 'Polydoros II' 6-max Seat #5 is the button
Seat 1: delbergg ($17 in chips) 
Seat 2: GreenChe ($17.51 in chips) 
Seat 3: armin75 ($13.66 in chips) 
Seat 4: Silveradom ($12.84 in chips) 
Seat 5: Impostore1988 ($9.85 in chips) 
Seat 6: Sergey_Bolos ($10 in chips) 
Sergey_Bolos: posts small blind $0.05
delbergg: posts big blind $0.10
*** HOLE CARDS ***
GreenChe: raises $0.25 to $0.35
armin75: folds 
Silveradom: folds 
Impostore1988: calls $0.35
Sergey_Bolos: folds 
delbergg: folds 
*** FLOP *** [Td 3s Ad]
GreenChe: bets $0.54
Impostore1988: folds 
Uncalled bet ($0.54) returned to GreenChe
GreenChe collected $0.81 from pot
GreenChe: doesn't show hand 
*** SUMMARY ***
Total pot $0.85 | Rake $0.04 
Board [Td 3s Ad]
Seat 1: delbergg (big blind) folded before Flop
Seat 2: GreenChe collected ($0.81)
Seat 3: armin75 folded before Flop (didn't bet)
Seat 4: Silveradom folded before Flop (didn't bet)
Seat 5: Impostore1988 (button) folded on the Flop
Seat 6: Sergey_Bolos (small blind) folded before Flop



PokerStars Hand #222948457299:  Hold'em No Limit ($0.05/$0.10 USD) - 2021/01/23 4:17:07 ET
Table 'Polydoros II' 6-max Seat #6 is the button
Seat 1: delbergg ($16.90 in chips) 
Seat 2: GreenChe ($17.97 in chips) 
Seat 3: armin75 ($13.66 in chips) 
Seat 4: Silveradom ($12.84 in chips) 
Seat 5: Impostore1988 ($9.50 in chips) 
Seat 6: Sergey_Bolos ($10 in chips) 
delbergg: posts small blind $0.05
GreenChe: posts big blind $0.10
*** HOLE CARDS ***
armin75: folds 
Silveradom: folds 
Impostore1988: raises $0.10 to $0.20
Sergey_Bolos: folds 
delbergg: calls $0.15
GreenChe: calls $0.10
*** FLOP *** [9c 7h 2c]
delbergg: checks 
GreenChe: checks 
Impostore1988: bets $0.29
delbergg: folds 
GreenChe: folds 
Uncalled bet ($0.29) returned to Impostore1988
Impostore1988 collected $0.57 from pot
Impostore1988: doesn't show hand 
*** SUMMARY ***
Total pot $0.60 | Rake $0.03 
Board [9c 7h 2c]
Seat 1: delbergg (small blind) folded on the Flop
Seat 2: GreenChe (big blind) folded on the Flop
Seat 3: armin75 folded before Flop (didn't bet)
Seat 4: Silveradom folded before Flop (didn't bet)
Seat 5: Impostore1988 collected ($0.57)
Seat 6: Sergey_Bolos (button) folded before Flop (didn't bet)



PokerStars Hand #222948465160:  Hold'em No Limit ($0.05/$0.10 USD) - 2021/01/23 4:17:37 ET
Table 'Polydoros II' 6-max Seat #1 is the button
Seat 1: delbergg ($16.70 in chips) 
Seat 2: GreenChe ($17.77 in chips) 
Seat 3: armin75 ($13.66 in chips) 
Seat 4: Silveradom ($12.84 in chips) 
Seat 5: Impostore1988 ($9.87 in chips) 
Seat 6: Sergey_Bolos ($10 in chips) 
GreenChe: posts small blind $0.05
armin75: posts big blind $0.10
*** HOLE CARDS ***
Silveradom: folds 
Impostore1988: raises $0.10 to $0.20
Sergey_Bolos: folds 
delbergg: raises $0.40 to $0.60
GreenChe: folds 
armin75: folds 
Impostore1988: calls $0.40
*** FLOP *** [5d 4h Ks]
Impostore1988: checks 
delbergg: bets $0.40
Impostore1988: folds 
Uncalled bet ($0.40) returned to delbergg
delbergg collected $1.29 from pot
*** SUMMARY ***
Total pot $1.35 | Rake $0.06 
Board [5d 4h Ks]
Seat 1: delbergg (button) collected ($1.29)
Seat 2: GreenChe (small blind) folded before Flop
Seat 3: armin75 (big blind) folded before Flop
Seat 4: Silveradom folded before Flop (didn't bet)
Seat 5: Impostore1988 folded on the Flop
Seat 6: Sergey_Bolos folded before Flop (didn't bet)



PokerStars Hand #222948472361:  Hold'em No Limit ($0.05/$0.10 USD) - 2021/01/23 4:18:04 ET
Table 'Polydoros II' 6-max Seat #2 is the button
Seat 1: delbergg ($17.39 in chips) 
Seat 2: GreenChe ($17.72 in chips) 
Seat 3: armin75 ($13.56 in chips) 
Seat 4: Silveradom ($12.84 in chips) 
Seat 5: Impostore1988 ($9.27 in chips) 
Seat 6: Sergey_Bolos ($10 in chips) 
armin75: posts small blind $0.05
Silveradom: posts big blind $0.10
*** HOLE CARDS ***
Impostore1988: raises $0.10 to $0.20
Sergey_Bolos: calls $0.20
delbergg: raises $0.90 to $1.10
GreenChe: calls $1.10
armin75: folds 
Silveradom: folds 
Impostore1988: calls $0.90
Sergey_Bolos: calls $0.90
*** FLOP *** [3d Jc As]
Impostore1988: bets $2.18
Sergey_Bolos: folds 
delbergg: raises $14.11 to $16.29 and is all-in
GreenChe: folds 
Impostore1988: calls $5.99 and is all-in
Uncalled bet ($8.12) returned to delbergg
*** TURN *** [3d Jc As] [7s]
*** RIVER *** [3d Jc As 7s] [3c]
*** SHOW DOWN ***
Impostore1988: shows [3s 3h] (four of a kind, Threes)
delbergg: shows [Ah Ac] (a full house, Aces full of Threes)
Impostore1988 collected $19.95 from pot
*** SUMMARY ***
Total pot $20.89 | Rake $0.94 
Board [3d Jc As 7s 3c]
Seat 1: delbergg showed [Ah Ac] and lost with a full house, Aces full of Threes
Seat 2: GreenChe (button) folded on the Flop
Seat 3: armin75 (small blind) folded before Flop
Seat 4: Silveradom (big blind) folded before Flop
Seat 5: Impostore1988 showed [3s 3h] and won ($19.95) with four of a kind, Threes
Seat 6: Sergey_Bolos folded on the Flop



PokerStars Hand #222948484171:  Hold'em No Limit ($0.05/$0.10 USD) - 2021/01/23 4:18:49 ET
Table 'Polydoros II' 6-max Seat #3 is the button
Seat 1: delbergg ($8.12 in chips) 
Seat 2: GreenChe ($16.62 in chips) 
Seat 3: armin75 ($13.51 in chips) 
Seat 4: Silveradom ($12.74 in chips) 
Seat 5: Impostore1988 ($19.95 in chips) 
Seat 6: Sergey_Bolos ($10 in chips) 
Silveradom: posts small blind $0.05
Impostore1988: posts big blind $0.10
*** HOLE CARDS ***
Sergey_Bolos: folds 
delbergg: folds 
GreenChe: folds 
armin75: folds 
Silveradom: folds 
Uncalled bet ($0.05) returned to Impostore1988
Impostore1988 collected $0.10 from pot
Impostore1988: doesn't show hand 
*** SUMMARY ***
Total pot $0.10 | Rake $0 
Seat 1: delbergg folded before Flop (didn't bet)
Seat 2: GreenChe folded before Flop (didn't bet)
Seat 3: armin75 (button) folded before Flop (didn't bet)
Seat 4: Silveradom (small blind) folded before Flop
Seat 5: Impostore1988 (big blind) collected ($0.10)
Seat 6: Sergey_Bolos folded before Flop (didn't bet)



PokerStars Hand #222948486948:  Hold'em No Limit ($0.05/$0.10 USD) - 2021/01/23 4:18:59 ET
Table 'Polydoros II' 6-max Seat #4 is the button
Seat 1: delbergg ($8.12 in chips) 
Seat 2: GreenChe ($16.62 in chips) 
Seat 3: armin75 ($13.51 in chips) 
Seat 4: Silveradom ($12.69 in chips) 
Seat 5: Impostore1988 ($20 in chips) 
Seat 6: Sergey_Bolos ($10 in chips) 
Impostore1988: posts small blind $0.05
Sergey_Bolos: posts big blind $0.10
*** HOLE CARDS ***
delbergg: folds 
GreenChe: folds 
armin75: calls $0.10
Silveradom: folds 
Impostore1988: raises $0.30 to $0.40
Sergey_Bolos: folds 
armin75: calls $0.30
*** FLOP *** [7h 2s Qs]
Impostore1988: bets $0.86
armin75: folds 
Uncalled bet ($0.86) returned to Impostore1988
Impostore1988 collected $0.86 from pot
Impostore1988: doesn't show hand 
*** SUMMARY ***
Total pot $0.90 | Rake $0.04 
Board [7h 2s Qs]
Seat 1: delbergg folded before Flop (didn't bet)
Seat 2: GreenChe folded before Flop (didn't bet)
Seat 3: armin75 folded on the Flop
Seat 4: Silveradom (button) folded before Flop (didn't bet)
Seat 5: Impostore1988 (small blind) collected ($0.86)
Seat 6: Sergey_Bolos (big blind) folded before Flop



PokerStars Hand #222948493108:  Hold'em No Limit ($0.05/$0.10 USD) - 2021/01/23 4:19:23 ET
Table 'Polydoros II' 6-max Seat #5 is the button
Seat 1: delbergg ($8.12 in chips) 
Seat 2: GreenChe ($16.62 in chips) 
Seat 3: armin75 ($13.11 in chips) 
Seat 4: Silveradom ($12.69 in chips) 
Seat 5: Impostore1988 ($20.46 in chips) 
Seat 6: Sergey_Bolos ($10 in chips) 
Sergey_Bolos: posts small blind $0.05
delbergg: posts big blind $0.10
*** HOLE CARDS ***
GreenChe: folds 
armin75: folds 
Silveradom: folds 
Impostore1988: folds 
Sergey_Bolos: folds 
Uncalled bet ($0.05) returned to delbergg
delbergg collected $0.10 from pot
*** SUMMARY ***
Total pot $0.10 | Rake $0 
Seat 1: delbergg (big blind) collected ($0.10)
Seat 2: GreenChe folded before Flop (didn't bet)
Seat 3: armin75 folded before Flop (didn't bet)
Seat 4: Silveradom folded before Flop (didn't bet)
Seat 5: Impostore1988 (button) folded before Flop (didn't bet)
Seat 6: Sergey_Bolos (small blind) folded before Flop



PokerStars Hand #222948497720:  Hold'em No Limit ($0.05/$0.10 USD) - 2021/01/23 4:19:40 ET
Table 'Polydoros II' 6-max Seat #6 is the button
Seat 1: delbergg ($8.17 in chips) 
Seat 2: GreenChe ($16.62 in chips) 
Seat 3: armin75 ($13.11 in chips) 
Seat 4: Silveradom ($12.69 in chips) 
Seat 5: Impostore1988 ($20.46 in chips) 
Seat 6: Sergey_Bolos ($10 in chips) 
delbergg: posts small blind $0.05
GreenChe: posts big blind $0.10
*** HOLE CARDS ***
armin75: folds 
Silveradom: folds 
Impostore1988: folds 
Sergey_Bolos: raises $0.15 to $0.25
delbergg: raises $0.65 to $0.90
GreenChe: folds 
Sergey_Bolos: raises $1.30 to $2.20
delbergg: calls $1.30
*** FLOP *** [3d 8s 2d]
delbergg: checks 
Sergey_Bolos: bets $1.46
delbergg: folds 
Uncalled bet ($1.46) returned to Sergey_Bolos
Sergey_Bolos collected $4.30 from pot
Sergey_Bolos: doesn't show hand 
*** SUMMARY ***
Total pot $4.50 | Rake $0.20 
Board [3d 8s 2d]
Seat 1: delbergg (small blind) folded on the Flop
Seat 2: GreenChe (big blind) folded before Flop
Seat 3: armin75 folded before Flop (didn't bet)
Seat 4: Silveradom folded before Flop (didn't bet)
Seat 5: Impostore1988 folded before Flop (didn't bet)
Seat 6: Sergey_Bolos (button) collected ($4.30)



PokerStars Hand #222948505124:  Hold'em No Limit ($0.05/$0.10 USD) - 2021/01/23 4:20:08 ET
Table 'Polydoros II' 6-max Seat #1 is the button
Seat 1: delbergg ($5.97 in chips) 
Seat 2: GreenChe ($16.52 in chips) 
Seat 3: armin75 ($13.11 in chips) 
Seat 4: Silveradom ($12.69 in chips) 
Seat 5: Impostore1988 ($20.46 in chips) 
Seat 6: Sergey_Bolos ($12.10 in chips) 
GreenChe: posts small blind $0.05
armin75: posts big blind $0.10
*** HOLE CARDS ***
Silveradom: folds 
Impostore1988: folds 
Sergey_Bolos: folds 
delbergg: raises $0.15 to $0.25
GreenChe: raises $0.65 to $0.90
armin75: folds 
delbergg: calls $0.65
*** FLOP *** [Jd Js 3h]
GreenChe: bets $0.91
delbergg: folds 
Uncalled bet ($0.91) returned to GreenChe
GreenChe collected $1.81 from pot
GreenChe: doesn't show hand 
*** SUMMARY ***
Total pot $1.90 | Rake $0.09 
Board [Jd Js 3h]
Seat 1: delbergg (button) folded on the Flop
Seat 2: GreenChe (small blind) collected ($1.81)
Seat 3: armin75 (big blind) folded before Flop
Seat 4: Silveradom folded before Flop (didn't bet)
Seat 5: Impostore1988 folded before Flop (didn't bet)
Seat 6: Sergey_Bolos folded before Flop (didn't bet)



PokerStars Hand #222948511592:  Hold'em No Limit ($0.05/$0.10 USD) - 2021/01/23 4:20:33 ET
Table 'Polydoros II' 6-max Seat #2 is the button
Seat 1: delbergg ($9.10 in chips) 
Seat 2: GreenChe ($17.43 in chips) 
Seat 3: armin75 ($13.01 in chips) 
Seat 4: Silveradom ($12.69 in chips) 
Seat 5: Impostore1988 ($20.46 in chips) 
Seat 6: Sergey_Bolos ($12.10 in chips) 
armin75: posts small blind $0.05
Silveradom: posts big blind $0.10
*** HOLE CARDS ***
Impostore1988: folds 
Sergey_Bolos: folds 
delbergg: folds 
GreenChe: folds 
armin75: calls $0.05
Silveradom: raises $0.20 to $0.30
armin75: calls $0.20
*** FLOP *** [6d Jd 9d]
armin75: checks 
Silveradom: bets $0.35
armin75: raises $1.27 to $1.62
Silveradom: folds 
Uncalled bet ($1.27) returned to armin75
armin75 collected $1.24 from pot
armin75: doesn't show hand 
*** SUMMARY ***
Total pot $1.30 | Rake $0.06 
Board [6d Jd 9d]
Seat 1: delbergg folded before Flop (didn't bet)
Seat 2: GreenChe (button) folded before Flop (didn't bet)
Seat 3: armin75 (small blind) collected ($1.24)
Seat 4: Silveradom (big blind) folded on the Flop
Seat 5: Impostore1988 folded before Flop (didn't bet)
Seat 6: Sergey_Bolos folded before Flop (didn't bet)



PokerStars Hand #222948521266:  Hold'em No Limit ($0.05/$0.10 USD) - 2021/01/23 4:21:10 ET
Table 'Polydoros II' 6-max Seat #3 is the button
Seat 1: delbergg ($10 in chips) 
Seat 2: GreenChe ($17.43 in chips) 
Seat 3: armin75 ($13.60 in chips) 
Seat 4: Silveradom ($12.04 in chips) 
Seat 5: Impostore1988 ($20.46 in chips) 
Seat 6: Sergey_Bolos ($12.10 in chips) 
Silveradom: posts small blind $0.05
Impostore1988: posts big blind $0.10
*** HOLE CARDS ***
Sergey_Bolos: raises $0.15 to $0.25
delbergg: folds 
GreenChe: folds 
armin75: folds 
Silveradom: folds 
Impostore1988: folds 
Uncalled bet ($0.15) returned to Sergey_Bolos
Sergey_Bolos collected $0.25 from pot
*** SUMMARY ***
Total pot $0.25 | Rake $0 
Seat 1: delbergg folded before Flop (didn't bet)
Seat 2: GreenChe folded before Flop (didn't bet)
Seat 3: armin75 (button) folded before Flop (didn't bet)
Seat 4: Silveradom (small blind) folded before Flop
Seat 5: Impostore1988 (big blind) folded before Flop
Seat 6: Sergey_Bolos collected ($0.25)



PokerStars Hand #222948524185:  Hold'em No Limit ($0.05/$0.10 USD) - 2021/01/23 4:21:21 ET
Table 'Polydoros II' 6-max Seat #4 is the button
Seat 1: delbergg ($10 in chips) 
Seat 2: GreenChe ($17.43 in chips) 
Seat 3: armin75 ($13.60 in chips) 
Seat 4: Silveradom ($11.99 in chips) 
Seat 5: Impostore1988 ($20.36 in chips) 
Seat 6: Sergey_Bolos ($12.25 in chips) 
Impostore1988: posts small blind $0.05
Sergey_Bolos: posts big blind $0.10
*** HOLE CARDS ***
delbergg: folds 
GreenChe: folds 
armin75: folds 
Silveradom: raises $0.15 to $0.25
Impostore1988: folds 
Sergey_Bolos: raises $0.95 to $1.20
Silveradom: folds 
Uncalled bet ($0.95) returned to Sergey_Bolos
Sergey_Bolos collected $0.55 from pot
Sergey_Bolos: doesn't show hand 
*** SUMMARY ***
Total pot $0.55 | Rake $0 
Seat 1: delbergg folded before Flop (didn't bet)
Seat 2: GreenChe folded before Flop (didn't bet)
Seat 3: armin75 folded before Flop (didn't bet)
Seat 4: Silveradom (button) folded before Flop
Seat 5: Impostore1988 (small blind) folded before Flop
Seat 6: Sergey_Bolos (big blind) collected ($0.55)



PokerStars Hand #222948528437:  Hold'em No Limit ($0.05/$0.10 USD) - 2021/01/23 4:21:36 ET
Table 'Polydoros II' 6-max Seat #5 is the button
Seat 1: delbergg ($10 in chips) 
Seat 2: GreenChe ($17.43 in chips) 
Seat 3: armin75 ($13.60 in chips) 
Seat 4: Silveradom ($11.74 in chips) 
Seat 5: Impostore1988 ($20.31 in chips) 
Seat 6: Sergey_Bolos ($12.55 in chips) 
Sergey_Bolos: posts small blind $0.05
delbergg: posts big blind $0.10
*** HOLE CARDS ***
GreenChe: folds 
armin75: folds 
Silveradom: folds 
Impostore1988: folds 
Sergey_Bolos: folds 
Uncalled bet ($0.05) returned to delbergg
delbergg collected $0.10 from pot
*** SUMMARY ***
Total pot $0.10 | Rake $0 
Seat 1: delbergg (big blind) collected ($0.10)
Seat 2: GreenChe folded before Flop (didn't bet)
Seat 3: armin75 folded before Flop (didn't bet)
Seat 4: Silveradom folded before Flop (didn't bet)
Seat 5: Impostore1988 (button) folded before Flop (didn't bet)
Seat 6: Sergey_Bolos (small blind) folded before Flop



PokerStars Hand #222948532421:  Hold'em No Limit ($0.05/$0.10 USD) - 2021/01/23 4:21:52 ET
Table 'Polydoros II' 6-max Seat #6 is the button
Seat 1: delbergg ($10.05 in chips) 
Seat 2: GreenChe ($17.43 in chips) 
Seat 3: armin75 ($13.60 in chips) 
Seat 4: Silveradom ($11.74 in chips) 
Seat 5: Impostore1988 ($20.31 in chips) 
Seat 6: Sergey_Bolos ($12.50 in chips) 
delbergg: posts small blind $0.05
GreenChe: posts big blind $0.10
*** HOLE CARDS ***
armin75: folds 
Silveradom: folds 
Impostore1988: folds 
Sergey_Bolos: raises $0.15 to $0.25
delbergg: folds 
GreenChe: folds 
Uncalled bet ($0.15) returned to Sergey_Bolos
Sergey_Bolos collected $0.25 from pot
Sergey_Bolos: doesn't show hand 
*** SUMMARY ***
Total pot $0.25 | Rake $0 
Seat 1: delbergg (small blind) folded before Flop
Seat 2: GreenChe (big blind) folded before Flop
Seat 3: armin75 folded before Flop (didn't bet)
Seat 4: Silveradom folded before Flop (didn't bet)
Seat 5: Impostore1988 folded before Flop (didn't bet)
Seat 6: Sergey_Bolos (button) collected ($0.25)



PokerStars Hand #222948536416:  Hold'em No Limit ($0.05/$0.10 USD) - 2021/01/23 4:22:07 ET
Table 'Polydoros II' 6-max Seat #1 is the button
Seat 1: delbergg ($10 in chips) 
Seat 2: GreenChe ($17.33 in chips) 
Seat 3: armin75 ($13.60 in chips) 
Seat 4: Silveradom ($11.74 in chips) 
Seat 5: Impostore1988 ($20.31 in chips) 
Seat 6: Sergey_Bolos ($12.65 in chips) 
GreenChe: posts small blind $0.05
armin75: posts big blind $0.10
*** HOLE CARDS ***
Silveradom: folds 
Impostore1988: folds 
Sergey_Bolos: raises $0.15 to $0.25
delbergg: raises $0.65 to $0.90
GreenChe: folds 
armin75: folds 
Sergey_Bolos: calls $0.65
*** FLOP *** [6c 5d 5s]
Sergey_Bolos: checks 
delbergg: bets $1
Sergey_Bolos: calls $1
*** TURN *** [6c 5d 5s] [6h]
Sergey_Bolos: checks 
delbergg: checks 
*** RIVER *** [6c 5d 5s 6h] [3s]
Sergey_Bolos: checks 
delbergg: checks 
*** SHOW DOWN ***
Sergey_Bolos: shows [7d 7h] (two pair, Sevens and Sixes)
delbergg: mucks hand 
Sergey_Bolos collected $3.77 from pot
*** SUMMARY ***
Total pot $3.95 | Rake $0.18 
Board [6c 5d 5s 6h 3s]
Seat 1: delbergg (button) mucked
Seat 2: GreenChe (small blind) folded before Flop
Seat 3: armin75 (big blind) folded before Flop
Seat 4: Silveradom folded before Flop (didn't bet)
Seat 5: Impostore1988 folded before Flop (didn't bet)
Seat 6: Sergey_Bolos showed [7d 7h] and won ($3.77) with two pair, Sevens and Sixes



PokerStars Hand #222948547754:  Hold'em No Limit ($0.05/$0.10 USD) - 2021/01/23 4:22:50 ET
Table 'Polydoros II' 6-max Seat #2 is the button
Seat 1: delbergg ($8.10 in chips) 
Seat 2: GreenChe ($17.28 in chips) 
Seat 3: armin75 ($13.50 in chips) 
Seat 4: Silveradom ($11.74 in chips) 
Seat 5: Impostore1988 ($20.31 in chips) 
Seat 6: Sergey_Bolos ($14.52 in chips) 
armin75: posts small blind $0.05
Silveradom: posts big blind $0.10
*** HOLE CARDS ***
Impostore1988: raises $0.40 to $0.50
Sergey_Bolos: folds 
delbergg: folds 
GreenChe: calls $0.50
armin75: folds 
Silveradom: folds 
*** FLOP *** [3d Ts 2d]
Impostore1988: checks 
GreenChe: checks 
*** TURN *** [3d Ts 2d] [Ks]
Impostore1988: checks 
GreenChe: checks 
*** RIVER *** [3d Ts 2d Ks] [Qc]
Impostore1988: bets $1.10
GreenChe: folds 
Uncalled bet ($1.10) returned to Impostore1988
Impostore1988 collected $1.10 from pot
Impostore1988: doesn't show hand 
*** SUMMARY ***
Total pot $1.15 | Rake $0.05 
Board [3d Ts 2d Ks Qc]
Seat 1: delbergg folded before Flop (didn't bet)
Seat 2: GreenChe (button) folded on the River
Seat 3: armin75 (small blind) folded before Flop
Seat 4: Silveradom (big blind) folded before Flop
Seat 5: Impostore1988 collected ($1.10)
Seat 6: Sergey_Bolos folded before Flop (didn't bet)



PokerStars Hand #222948558681:  Hold'em No Limit ($0.05/$0.10 USD) - 2021/01/23 4:23:32 ET
Table 'Polydoros II' 6-max Seat #3 is the button
Seat 1: delbergg ($10 in chips) 
Seat 2: GreenChe ($16.78 in chips) 
Seat 3: armin75 ($13.45 in chips) 
Seat 4: Silveradom ($11.64 in chips) 
Seat 5: Impostore1988 ($20.91 in chips) 
Seat 6: Sergey_Bolos ($14.52 in chips) 
Silveradom: posts small blind $0.05
Impostore1988: posts big blind $0.10
*** HOLE CARDS ***
Sergey_Bolos: raises $0.15 to $0.25
delbergg: folds 
GreenChe: folds 
armin75: folds 
Silveradom: folds 
Impostore1988: folds 
Uncalled bet ($0.15) returned to Sergey_Bolos
Sergey_Bolos collected $0.25 from pot
Sergey_Bolos: doesn't show hand 
*** SUMMARY ***
Total pot $0.25 | Rake $0 
Seat 1: delbergg folded before Flop (didn't bet)
Seat 2: GreenChe folded before Flop (didn't bet)
Seat 3: armin75 (button) folded before Flop (didn't bet)
Seat 4: Silveradom (small blind) folded before Flop
Seat 5: Impostore1988 (big blind) folded before Flop
Seat 6: Sergey_Bolos collected ($0.25)



PokerStars Hand #222948562529:  Hold'em No Limit ($0.05/$0.10 USD) - 2021/01/23 4:23:47 ET
Table 'Polydoros II' 6-max Seat #4 is the button
Seat 1: delbergg ($10 in chips) 
Seat 2: GreenChe ($16.78 in chips) 
Seat 3: armin75 ($13.45 in chips) 
Seat 4: Silveradom ($11.59 in chips) 
Seat 5: Impostore1988 ($20.81 in chips) 
Seat 6: Sergey_Bolos ($14.67 in chips) 
Impostore1988: posts small blind $0.05
Sergey_Bolos: posts big blind $0.10
*** HOLE CARDS ***
delbergg: folds 
GreenChe: folds 
armin75: folds 
Silveradom: raises $0.15 to $0.25
Impostore1988: folds 
Sergey_Bolos: calls $0.15
*** FLOP *** [5h Jh 2c]
Sergey_Bolos: checks 
Silveradom: bets $0.35
Sergey_Bolos: folds 
Uncalled bet ($0.35) returned to Silveradom
Silveradom collected $0.53 from pot
Silveradom: doesn't show hand 
*** SUMMARY ***
Total pot $0.55 | Rake $0.02 
Board [5h Jh 2c]
Seat 1: delbergg folded before Flop (didn't bet)
Seat 2: GreenChe folded before Flop (didn't bet)
Seat 3: armin75 folded before Flop (didn't bet)
Seat 4: Silveradom (button) collected ($0.53)
Seat 5: Impostore1988 (small blind) folded before Flop
Seat 6: Sergey_Bolos (big blind) folded on the Flop



PokerStars Hand #222948570374:  Hold'em No Limit ($0.05/$0.10 USD) - 2021/01/23 4:24:16 ET
Table 'Polydoros II' 6-max Seat #5 is the button
Seat 1: delbergg ($10 in chips) 
Seat 2: GreenChe ($16.78 in chips) 
Seat 3: armin75 ($13.45 in chips) 
Seat 4: Silveradom ($11.87 in chips) 
Seat 5: Impostore1988 ($20.76 in chips) 
Seat 6: Sergey_Bolos ($14.42 in chips) 
Sergey_Bolos: posts small blind $0.05
delbergg: posts big blind $0.10
*** HOLE CARDS ***
GreenChe: folds 
armin75: folds 
Silveradom: folds 
Impostore1988: folds 
Sergey_Bolos: folds 
Uncalled bet ($0.05) returned to delbergg
delbergg collected $0.10 from pot
delbergg: doesn't show hand 
*** SUMMARY ***
Total pot $0.10 | Rake $0 
Seat 1: delbergg (big blind) collected ($0.10)
Seat 2: GreenChe folded before Flop (didn't bet)
Seat 3: armin75 folded before Flop (didn't bet)
Seat 4: Silveradom folded before Flop (didn't bet)
Seat 5: Impostore1988 (button) folded before Flop (didn't bet)
Seat 6: Sergey_Bolos (small blind) folded before Flop



PokerStars Hand #222948573820:  Hold'em No Limit ($0.05/$0.10 USD) - 2021/01/23 4:24:29 ET
Table 'Polydoros II' 6-max Seat #6 is the button
Seat 1: delbergg ($10.05 in chips) 
Seat 2: GreenChe ($16.78 in chips) 
Seat 3: armin75 ($13.45 in chips) 
Seat 4: Silveradom ($11.87 in chips) 
Seat 5: Impostore1988 ($20.76 in chips) 
Seat 6: Sergey_Bolos ($14.37 in chips) 
delbergg: posts small blind $0.05
GreenChe: posts big blind $0.10
*** HOLE CARDS ***
armin75: folds 
Silveradom: folds 
Impostore1988: folds 
Sergey_Bolos: folds 
delbergg: folds 
Uncalled bet ($0.05) returned to GreenChe
GreenChe collected $0.10 from pot
GreenChe: doesn't show hand 
*** SUMMARY ***
Total pot $0.10 | Rake $0 
Seat 1: delbergg (small blind) folded before Flop
Seat 2: GreenChe (big blind) collected ($0.10)
Seat 3: armin75 folded before Flop (didn't bet)
Seat 4: Silveradom folded before Flop (didn't bet)
Seat 5: Impostore1988 folded before Flop (didn't bet)
Seat 6: Sergey_Bolos (button) folded before Flop (didn't bet)



PokerStars Hand #222948577249:  Hold'em No Limit ($0.05/$0.10 USD) - 2021/01/23 4:24:42 ET
Table 'Polydoros II' 6-max Seat #1 is the button
Seat 1: delbergg ($10 in chips) 
Seat 2: GreenChe ($16.83 in chips) 
Seat 3: armin75 ($13.45 in chips) 
Seat 4: Silveradom ($11.87 in chips) 
Seat 5: Impostore1988 ($20.76 in chips) 
Seat 6: Sergey_Bolos ($14.37 in chips) 
GreenChe: posts small blind $0.05
armin75: posts big blind $0.10
*** HOLE CARDS ***
Silveradom: folds 
Impostore1988: folds 
Sergey_Bolos: raises $0.15 to $0.25
delbergg: folds 
GreenChe: folds 
armin75: folds 
Uncalled bet ($0.15) returned to Sergey_Bolos
Sergey_Bolos collected $0.25 from pot
Sergey_Bolos: doesn't show hand 
*** SUMMARY ***
Total pot $0.25 | Rake $0 
Seat 1: delbergg (button) folded before Flop (didn't bet)
Seat 2: GreenChe (small blind) folded before Flop
Seat 3: armin75 (big blind) folded before Flop
Seat 4: Silveradom folded before Flop (didn't bet)
Seat 5: Impostore1988 folded before Flop (didn't bet)
Seat 6: Sergey_Bolos collected ($0.25)



PokerStars Hand #222948582795:  Hold'em No Limit ($0.05/$0.10 USD) - 2021/01/23 4:25:04 ET
Table 'Polydoros II' 6-max Seat #2 is the button
Seat 1: delbergg ($10 in chips) 
Seat 2: GreenChe ($16.78 in chips) 
Seat 3: armin75 ($13.35 in chips) 
Seat 4: Silveradom ($11.87 in chips) 
Seat 5: Impostore1988 ($20.76 in chips) 
Seat 6: Sergey_Bolos ($14.52 in chips) 
armin75: posts small blind $0.05
Silveradom: posts big blind $0.10
*** HOLE CARDS ***
Impostore1988: raises $0.10 to $0.20
Sergey_Bolos: folds 
delbergg: folds 
GreenChe: folds 
armin75: calls $0.15
Silveradom: folds 
*** FLOP *** [Jc Ts 3d]
armin75: checks 
Impostore1988: checks 
*** TURN *** [Jc Ts 3d] [Qd]
armin75: checks 
Impostore1988: checks 
*** RIVER *** [Jc Ts 3d Qd] [Kc]
armin75: checks 
Impostore1988: bets $0.48
armin75: calls $0.48
*** SHOW DOWN ***
Impostore1988: shows [Ad 5d] (a straight, Ten to Ace)
armin75: mucks hand 
Impostore1988 collected $1.39 from pot
*** SUMMARY ***
Total pot $1.46 | Rake $0.07 
Board [Jc Ts 3d Qd Kc]
Seat 1: delbergg folded before Flop (didn't bet)
Seat 2: GreenChe (button) folded before Flop (didn't bet)
Seat 3: armin75 (small blind) mucked
Seat 4: Silveradom (big blind) folded before Flop
Seat 5: Impostore1988 showed [Ad 5d] and won ($1.39) with a straight, Ten to Ace
Seat 6: Sergey_Bolos folded before Flop (didn't bet)



PokerStars Hand #222948592898:  Hold'em No Limit ($0.05/$0.10 USD) - 2021/01/23 4:25:43 ET
Table 'Polydoros II' 6-max Seat #3 is the button
Seat 1: delbergg ($10 in chips) 
Seat 2: GreenChe ($16.78 in chips) 
Seat 3: armin75 ($12.67 in chips) 
Seat 4: Silveradom ($11.77 in chips) 
Seat 5: Impostore1988 ($21.47 in chips) 
Seat 6: Sergey_Bolos ($14.52 in chips) 
Silveradom: posts small blind $0.05
Impostore1988: posts big blind $0.10
*** HOLE CARDS ***
Sergey_Bolos: folds 
delbergg: folds 
GreenChe: raises $0.20 to $0.30
armin75: folds 
Silveradom: raises $0.70 to $1
Impostore1988: folds 
GreenChe: raises $1.74 to $2.74
Silveradom: folds 
Uncalled bet ($1.74) returned to GreenChe
GreenChe collected $2.10 from pot
GreenChe: doesn't show hand 
*** SUMMARY ***
Total pot $2.10 | Rake $0 
Seat 1: delbergg folded before Flop (didn't bet)
Seat 2: GreenChe collected ($2.10)
Seat 3: armin75 (button) folded before Flop (didn't bet)
Seat 4: Silveradom (small blind) folded before Flop
Seat 5: Impostore1988 (big blind) folded before Flop
Seat 6: Sergey_Bolos folded before Flop (didn't bet)



PokerStars Hand #222948603502:  Hold'em No Limit ($0.05/$0.10 USD) - 2021/01/23 4:26:23 ET
Table 'Polydoros II' 6-max Seat #4 is the button
Seat 1: delbergg ($10 in chips) 
Seat 2: GreenChe ($17.88 in chips) 
Seat 3: armin75 ($12.67 in chips) 
Seat 4: Silveradom ($10.77 in chips) 
Seat 5: Impostore1988 ($21.37 in chips) 
Impostore1988: posts small blind $0.05
Sergey_Bolos: is sitting out 
delbergg: posts big blind $0.10
*** HOLE CARDS ***
GreenChe: folds 
armin75: folds 
Silveradom: folds 
Impostore1988: folds 
Uncalled bet ($0.05) returned to delbergg
delbergg collected $0.10 from pot
*** SUMMARY ***
Total pot $0.10 | Rake $0 
Seat 1: delbergg (big blind) collected ($0.10)
Seat 2: GreenChe folded before Flop (didn't bet)
Seat 3: armin75 folded before Flop (didn't bet)
Seat 4: Silveradom (button) folded before Flop (didn't bet)
Seat 5: Impostore1988 (small blind) folded before Flop



PokerStars Hand #222948606005:  Hold'em No Limit ($0.05/$0.10 USD) - 2021/01/23 4:26:33 ET
Table 'Polydoros II' 6-max Seat #5 is the button
Seat 1: delbergg ($10.05 in chips) 
Seat 2: GreenChe ($17.88 in chips) 
Seat 3: armin75 ($12.67 in chips) 
Seat 4: Silveradom ($10.77 in chips) 
Seat 5: Impostore1988 ($21.32 in chips) 
delbergg: posts small blind $0.05
GreenChe: posts big blind $0.10
*** HOLE CARDS ***
armin75: folds 
Silveradom: folds 
Impostore1988: raises $0.20 to $0.30
delbergg: raises $0.80 to $1.10
GreenChe: folds 
Impostore1988: calls $0.80
*** FLOP *** [Ts Qd 4c]
delbergg: bets $1.45
Impostore1988: calls $1.45
*** TURN *** [Ts Qd 4c] [6d]
delbergg: bets $7.50 and is all-in
Impostore1988: calls $7.50
*** RIVER *** [Ts Qd 4c 6d] [Ac]
*** SHOW DOWN ***
delbergg: shows [8s 3s] (high card Ace)
Impostore1988: shows [Th Tc] (three of a kind, Tens)
Impostore1988 collected $19.29 from pot
*** SUMMARY ***
Total pot $20.20 | Rake $0.91 
Board [Ts Qd 4c 6d Ac]
Seat 1: delbergg (small blind) showed [8s 3s] and lost with high card Ace
Seat 2: GreenChe (big blind) folded before Flop
Seat 3: armin75 folded before Flop (didn't bet)
Seat 4: Silveradom folded before Flop (didn't bet)
Seat 5: Impostore1988 (button) showed [Th Tc] and won ($19.29) with three of a kind, Tens



PokerStars Hand #222948616308:  Hold'em No Limit ($0.05/$0.10 USD) - 2021/01/23 4:27:12 ET
Table 'Polydoros II' 6-max Seat #2 is the button
Seat 2: GreenChe ($17.78 in chips) 
Seat 3: armin75 ($12.67 in chips) 
Seat 4: Silveradom ($10.77 in chips) 
Seat 5: Impostore1988 ($30.56 in chips) 
armin75: posts small blind $0.05
Silveradom: posts big blind $0.10
*** HOLE CARDS ***
Impostore1988: folds 
GreenChe: folds 
armin75: folds 
Uncalled bet ($0.05) returned to Silveradom
Silveradom collected $0.10 from pot
Silveradom: doesn't show hand 
*** SUMMARY ***
Total pot $0.10 | Rake $0 
Seat 2: GreenChe (button) folded before Flop (didn't bet)
Seat 3: armin75 (small blind) folded before Flop
Seat 4: Silveradom (big blind) collected ($0.10)
Seat 5: Impostore1988 folded before Flop (didn't bet)



PokerStars Hand #222948619452:  Hold'em No Limit ($0.05/$0.10 USD) - 2021/01/23 4:27:24 ET
Table 'Polydoros II' 6-max Seat #3 is the button
Seat 1: delbergg ($10 in chips) 
Seat 2: GreenChe ($17.78 in chips) 
Seat 3: armin75 ($12.62 in chips) 
Seat 4: Silveradom ($10.82 in chips) 
Seat 5: Impostore1988 ($30.56 in chips) 
Silveradom: posts small blind $0.05
Impostore1988: posts big blind $0.10
*** HOLE CARDS ***
delbergg: raises $0.15 to $0.25
GreenChe: folds 
armin75: folds 
Silveradom: folds 
Impostore1988: folds 
Uncalled bet ($0.15) returned to delbergg
delbergg collected $0.25 from pot
delbergg: doesn't show hand 
*** SUMMARY ***
Total pot $0.25 | Rake $0 
Seat 1: delbergg collected ($0.25)
Seat 2: GreenChe folded before Flop (didn't bet)
Seat 3: armin75 (button) folded before Flop (didn't bet)
Seat 4: Silveradom (small blind) folded before Flop
Seat 5: Impostore1988 (big blind) folded before Flop



PokerStars Hand #222948622032:  Hold'em No Limit ($0.05/$0.10 USD) - 2021/01/23 4:27:34 ET
Table 'Polydoros II' 6-max Seat #4 is the button
Seat 1: delbergg ($10.15 in chips) 
Seat 2: GreenChe ($17.78 in chips) 
Seat 3: armin75 ($12.62 in chips) 
Seat 4: Silveradom ($10.77 in chips) 
Seat 5: Impostore1988 ($30.46 in chips) 
Impostore1988: posts small blind $0.05
delbergg: posts big blind $0.10
*** HOLE CARDS ***
GreenChe: folds 
armin75: raises $0.25 to $0.35
Silveradom: folds 
Impostore1988: raises $0.55 to $0.90
delbergg: calls $0.80
armin75: folds 
*** FLOP *** [Qs Js 5s]
Impostore1988: bets $2.05
delbergg: folds 
Uncalled bet ($2.05) returned to Impostore1988
Impostore1988 collected $2.05 from pot
Impostore1988: doesn't show hand 
*** SUMMARY ***
Total pot $2.15 | Rake $0.10 
Board [Qs Js 5s]
Seat 1: delbergg (big blind) folded on the Flop
Seat 2: GreenChe folded before Flop (didn't bet)
Seat 3: armin75 folded before Flop
Seat 4: Silveradom (button) folded before Flop (didn't bet)
Seat 5: Impostore1988 (small blind) collected ($2.05)



PokerStars Hand #222948628100:  Hold'em No Limit ($0.05/$0.10 USD) - 2021/01/23 4:27:57 ET
Table 'Polydoros II' 6-max Seat #5 is the button
Seat 1: delbergg ($9.25 in chips) 
Seat 2: GreenChe ($17.78 in chips) 
Seat 3: armin75 ($12.27 in chips) 
Seat 4: Silveradom ($10.77 in chips) 
Seat 5: Impostore1988 ($31.61 in chips) 
delbergg: posts small blind $0.05
GreenChe: posts big blind $0.10
*** HOLE CARDS ***
armin75: folds 
Silveradom: folds 
Impostore1988: raises $0.10 to $0.20
delbergg: folds 
GreenChe: folds 
Uncalled bet ($0.10) returned to Impostore1988
Impostore1988 collected $0.25 from pot
Impostore1988: doesn't show hand 
*** SUMMARY ***
Total pot $0.25 | Rake $0 
Seat 1: delbergg (small blind) folded before Flop
Seat 2: GreenChe (big blind) folded before Flop
Seat 3: armin75 folded before Flop (didn't bet)
Seat 4: Silveradom folded before Flop (didn't bet)
Seat 5: Impostore1988 (button) collected ($0.25)



PokerStars Hand #222948631782:  Hold'em No Limit ($0.05/$0.10 USD) - 2021/01/23 4:28:11 ET
Table 'Polydoros II' 6-max Seat #1 is the button
Seat 1: delbergg ($9.20 in chips) 
Seat 2: GreenChe ($17.68 in chips) 
Seat 3: armin75 ($12.27 in chips) 
Seat 4: Silveradom ($10.77 in chips) 
Seat 5: Impostore1988 ($31.76 in chips) 
GreenChe: posts small blind $0.05
armin75: posts big blind $0.10
*** HOLE CARDS ***
Silveradom: folds 
Impostore1988: folds 
delbergg: raises $0.15 to $0.25
GreenChe: raises $0.65 to $0.90
armin75: folds 
delbergg: calls $0.65
*** FLOP *** [3s 3h 6h]
GreenChe: bets $1.36
delbergg: folds 
Uncalled bet ($1.36) returned to GreenChe
GreenChe collected $1.81 from pot
GreenChe: doesn't show hand 
*** SUMMARY ***
Total pot $1.90 | Rake $0.09 
Board [3s 3h 6h]
Seat 1: delbergg (button) folded on the Flop
Seat 2: GreenChe (small blind) collected ($1.81)
Seat 3: armin75 (big blind) folded before Flop
Seat 4: Silveradom folded before Flop (didn't bet)
Seat 5: Impostore1988 folded before Flop (didn't bet)



PokerStars Hand #222948639434:  Hold'em No Limit ($0.05/$0.10 USD) - 2021/01/23 4:28:40 ET
Table 'Polydoros II' 6-max Seat #2 is the button
Seat 1: delbergg ($8.30 in chips) 
Seat 2: GreenChe ($18.59 in chips) 
Seat 3: armin75 ($12.17 in chips) 
Seat 4: Silveradom ($10.77 in chips) 
Seat 5: Impostore1988 ($31.76 in chips) 
armin75: posts small blind $0.05
Silveradom: posts big blind $0.10
*** HOLE CARDS ***
Impostore1988: raises $0.10 to $0.20
delbergg: folds 
GreenChe: folds 
armin75: calls $0.15
Silveradom: calls $0.10
*** FLOP *** [4d 7c Jd]
armin75: checks 
Silveradom: checks 
Impostore1988: checks 
*** TURN *** [4d 7c Jd] [2s]
armin75: checks 
Silveradom: checks 
Impostore1988: checks 
*** RIVER *** [4d 7c Jd 2s] [7d]
armin75: checks 
Silveradom: checks 
Impostore1988: checks 
*** SHOW DOWN ***
armin75: shows [2c As] (two pair, Sevens and Deuces)
Silveradom: mucks hand 
Impostore1988: mucks hand 
armin75 collected $0.57 from pot
*** SUMMARY ***
Total pot $0.60 | Rake $0.03 
Board [4d 7c Jd 2s 7d]
Seat 1: delbergg folded before Flop (didn't bet)
Seat 2: GreenChe (button) folded before Flop (didn't bet)
Seat 3: armin75 (small blind) showed [2c As] and won ($0.57) with two pair, Sevens and Deuces
Seat 4: Silveradom (big blind) mucked
Seat 5: Impostore1988 mucked



PokerStars Hand #222948650079:  Hold'em No Limit ($0.05/$0.10 USD) - 2021/01/23 4:29:20 ET
Table 'Polydoros II' 6-max Seat #3 is the button
Seat 1: delbergg ($8.30 in chips) 
Seat 2: GreenChe ($18.59 in chips) 
Seat 3: armin75 ($12.54 in chips) 
Seat 4: Silveradom ($10.57 in chips) 
Seat 5: Impostore1988 ($31.56 in chips) 
Silveradom: posts small blind $0.05
Impostore1988: posts big blind $0.10
*** HOLE CARDS ***
delbergg: raises $0.15 to $0.25
GreenChe: folds 
armin75: calls $0.25
Silveradom: folds 
Impostore1988: folds 
*** FLOP *** [5h Qh Jh]
delbergg: checks 
armin75: bets $0.62
delbergg: folds 
Uncalled bet ($0.62) returned to armin75
armin75 collected $0.62 from pot
armin75: doesn't show hand 
*** SUMMARY ***
Total pot $0.65 | Rake $0.03 
Board [5h Qh Jh]
Seat 1: delbergg folded on the Flop
Seat 2: GreenChe folded before Flop (didn't bet)
Seat 3: armin75 (button) collected ($0.62)
Seat 4: Silveradom (small blind) folded before Flop
Seat 5: Impostore1988 (big blind) folded before Flop



PokerStars Hand #222948659334:  Hold'em No Limit ($0.05/$0.10 USD) - 2021/01/23 4:29:55 ET
Table 'Polydoros II' 6-max Seat #4 is the button
Seat 1: delbergg ($8.05 in chips) 
Seat 2: GreenChe ($18.59 in chips) 
Seat 3: armin75 ($12.91 in chips) 
Seat 4: Silveradom ($10.52 in chips) 
Seat 5: Impostore1988 ($31.46 in chips) 
Impostore1988: posts small blind $0.05
delbergg: posts big blind $0.10
*** HOLE CARDS ***
GreenChe: folds 
armin75: folds 
Silveradom: folds 
Impostore1988: raises $0.20 to $0.30
delbergg: calls $0.20
*** FLOP *** [9c Jd Ad]
Impostore1988: checks 
delbergg: checks 
*** TURN *** [9c Jd Ad] [8c]
Impostore1988: checks 
delbergg: bets $0.38
Impostore1988: calls $0.38
*** RIVER *** [9c Jd Ad 8c] [Qd]
Impostore1988: bets $1.30
delbergg: calls $1.30
*** SHOW DOWN ***
Impostore1988: shows [Th Kc] (a straight, Ten to Ace)
delbergg: mucks hand 
Impostore1988 collected $3.78 from pot
*** SUMMARY ***
Total pot $3.96 | Rake $0.18 
Board [9c Jd Ad 8c Qd]
Seat 1: delbergg (big blind) mucked
Seat 2: GreenChe folded before Flop (didn't bet)
Seat 3: armin75 folded before Flop (didn't bet)
Seat 4: Silveradom (button) folded before Flop (didn't bet)
Seat 5: Impostore1988 (small blind) showed [Th Kc] and won ($3.78) with a straight, Ten to Ace



PokerStars Hand #222948668429:  Hold'em No Limit ($0.05/$0.10 USD) - 2021/01/23 4:30:29 ET
Table 'Polydoros II' 6-max Seat #5 is the button
Seat 1: delbergg ($6.07 in chips) 
Seat 3: armin75 ($12.91 in chips) 
Seat 4: Silveradom ($10.52 in chips) 
Seat 5: Impostore1988 ($33.26 in chips) 
delbergg: posts small blind $0.05
GreenChe: is sitting out 
armin75: posts big blind $0.10
*** HOLE CARDS ***
Silveradom: raises $0.20 to $0.30
Impostore1988: folds 
delbergg: calls $0.25
armin75: calls $0.20
*** FLOP *** [Jd 2d 3c]
delbergg: checks 
armin75: checks 
Silveradom: bets $0.50
delbergg: folds 
armin75: calls $0.50
*** TURN *** [Jd 2d 3c] [8h]
armin75: checks 
Silveradom: checks 
*** RIVER *** [Jd 2d 3c 8h] [9c]
armin75: bets $1.81
Silveradom: raises $7.91 to $9.72 and is all-in
armin75: folds 
Uncalled bet ($7.91) returned to Silveradom
Silveradom collected $5.27 from pot
Silveradom: doesn't show hand 
*** SUMMARY ***
Total pot $5.52 | Rake $0.25 
Board [Jd 2d 3c 8h 9c]
Seat 1: delbergg (small blind) folded on the Flop
Seat 3: armin75 (big blind) folded on the River
Seat 4: Silveradom collected ($5.27)
Seat 5: Impostore1988 (button) folded before Flop (didn't bet)



PokerStars Hand #222948677871:  Hold'em No Limit ($0.05/$0.10 USD) - 2021/01/23 4:31:04 ET
Table 'Polydoros II' 6-max Seat #1 is the button
Seat 1: delbergg ($5.77 in chips) 
Seat 3: armin75 ($10.30 in chips) 
Seat 5: Impostore1988 ($33.26 in chips) 
armin75: posts small blind $0.05
Silveradom: is sitting out 
Impostore1988: posts big blind $0.10
Sergey_Bolos: sits out 
*** HOLE CARDS ***
delbergg: raises $0.15 to $0.25
armin75: folds 
Impostore1988: folds 
Uncalled bet ($0.15) returned to delbergg
delbergg collected $0.25 from pot
delbergg: doesn't show hand 
*** SUMMARY ***
Total pot $0.25 | Rake $0 
Seat 1: delbergg (button) collected ($0.25)
Seat 3: armin75 (small blind) folded before Flop
Seat 5: Impostore1988 (big blind) folded before Flop



PokerStars Hand #222948679912:  Hold'em No Limit ($0.05/$0.10 USD) - 2021/01/23 4:31:12 ET
Table 'Polydoros II' 6-max Seat #3 is the button
Seat 1: delbergg ($5.92 in chips) 
Seat 3: armin75 ($10.25 in chips) 
Seat 5: Impostore1988 ($33.16 in chips) 
Seat 6: Sergey_Bolos ($14.52 in chips) 
Impostore1988: posts small blind $0.05
Silveradom leaves the table
Sergey_Bolos: posts big blind $0.10
*** HOLE CARDS ***
delbergg: folds 
armin75: folds 
Impostore1988: folds 
Uncalled bet ($0.05) returned to Sergey_Bolos
Sergey_Bolos collected $0.10 from pot
Sergey_Bolos: doesn't show hand 
*** SUMMARY ***
Total pot $0.10 | Rake $0 
Seat 1: delbergg folded before Flop (didn't bet)
Seat 3: armin75 (button) folded before Flop (didn't bet)
Seat 5: Impostore1988 (small blind) folded before Flop
Seat 6: Sergey_Bolos (big blind) collected ($0.10)



PokerStars Hand #222948681628:  Hold'em No Limit ($0.05/$0.10 USD) - 2021/01/23 4:31:19 ET
Table 'Polydoros II' 6-max Seat #5 is the button
Seat 1: delbergg ($5.92 in chips) 
Seat 3: armin75 ($10.25 in chips) 
Seat 5: Impostore1988 ($33.11 in chips) 
Seat 6: Sergey_Bolos ($14.57 in chips) 
Sergey_Bolos: posts small blind $0.05
delbergg: posts big blind $0.10
*** HOLE CARDS ***
armin75: folds 
Impostore1988: raises $0.10 to $0.20
Sergey_Bolos: calls $0.15
delbergg: raises $5.72 to $5.92 and is all-in
Impostore1988: folds 
Sergey_Bolos: folds 
Uncalled bet ($5.72) returned to delbergg
delbergg collected $0.60 from pot
delbergg: shows [8c 7h] (high card Eight)
*** SUMMARY ***
Total pot $0.60 | Rake $0 
Seat 1: delbergg (big blind) collected ($0.60)
Seat 3: armin75 folded before Flop (didn't bet)
Seat 5: Impostore1988 (button) folded before Flop
Seat 6: Sergey_Bolos (small blind) folded before Flop



PokerStars Hand #222948686496:  Hold'em No Limit ($0.05/$0.10 USD) - 2021/01/23 4:31:37 ET
Table 'Polydoros II' 6-max Seat #6 is the button
Seat 1: delbergg ($6.32 in chips) 
Seat 3: armin75 ($10.25 in chips) 
Seat 5: Impostore1988 ($32.91 in chips) 
Seat 6: Sergey_Bolos ($14.37 in chips) 
delbergg: posts small blind $0.05
armin75: posts big blind $0.10
*** HOLE CARDS ***
Impostore1988: folds 
Sergey_Bolos: folds 
delbergg: calls $0.05
armin75: checks 
*** FLOP *** [Kh As 6c]
delbergg: checks 
armin75: checks 
*** TURN *** [Kh As 6c] [4d]
delbergg: checks 
armin75: checks 
*** RIVER *** [Kh As 6c 4d] [Js]
delbergg: checks 
armin75: checks 
*** SHOW DOWN ***
delbergg: shows [Tc 5c] (high card Ace)
armin75: shows [7d Jc] (a pair of Jacks)
maze994 joins the table at seat #4 
armin75 collected $0.19 from pot
*** SUMMARY ***
Total pot $0.20 | Rake $0.01 
Board [Kh As 6c 4d Js]
Seat 1: delbergg (small blind) showed [Tc 5c] and lost with high card Ace
Seat 3: armin75 (big blind) showed [7d Jc] and won ($0.19) with a pair of Jacks
Seat 5: Impostore1988 folded before Flop (didn't bet)
Seat 6: Sergey_Bolos (button) folded before Flop (didn't bet)



PokerStars Hand #222948693444:  Hold'em No Limit ($0.05/$0.10 USD) - 2021/01/23 4:32:03 ET
Table 'Polydoros II' 6-max Seat #1 is the button
Seat 1: delbergg ($6.22 in chips) 
Seat 3: armin75 ($10.34 in chips) 
Seat 4: maze994 ($8 in chips) 
Seat 5: Impostore1988 ($32.91 in chips) 
Seat 6: Sergey_Bolos ($14.37 in chips) 
armin75: posts small blind $0.05
maze994: posts big blind $0.10
*** HOLE CARDS ***
Impostore1988: folds 
Sergey_Bolos: folds 
delbergg: folds 
armin75: calls $0.05
maze994: checks 
*** FLOP *** [Qd 2s 4c]
armin75: checks 
maze994: checks 
*** TURN *** [Qd 2s 4c] [2h]
armin75: checks 
maze994: checks 
*** RIVER *** [Qd 2s 4c 2h] [Jc]
armin75: checks 
maze994: checks 
*** SHOW DOWN ***
armin75: shows [9d Jh] (two pair, Jacks and Deuces)
maze994: mucks hand 
armin75 collected $0.19 from pot
*** SUMMARY ***
Total pot $0.20 | Rake $0.01 
Board [Qd 2s 4c 2h Jc]
Seat 1: delbergg (button) folded before Flop (didn't bet)
Seat 3: armin75 (small blind) showed [9d Jh] and won ($0.19) with two pair, Jacks and Deuces
Seat 4: maze994 (big blind) mucked
Seat 5: Impostore1988 folded before Flop (didn't bet)
Seat 6: Sergey_Bolos folded before Flop (didn't bet)



PokerStars Hand #222948698903:  Hold'em No Limit ($0.05/$0.10 USD) - 2021/01/23 4:32:23 ET
Table 'Polydoros II' 6-max Seat #3 is the button
Seat 1: delbergg ($6.22 in chips) 
Seat 3: armin75 ($10.43 in chips) 
Seat 4: maze994 ($7.90 in chips) 
Seat 5: Impostore1988 ($32.91 in chips) 
Seat 6: Sergey_Bolos ($14.37 in chips) 
maze994: posts small blind $0.05
Impostore1988: posts big blind $0.10
*** HOLE CARDS ***
Sergey_Bolos: folds 
delbergg: raises $0.15 to $0.25
armin75: folds 
maze994: calls $0.20
Impostore1988: folds 
*** FLOP *** [Tc 2c As]
maze994: checks 
delbergg: checks 
*** TURN *** [Tc 2c As] [Kc]
maze994: checks 
delbergg: checks 
*** RIVER *** [Tc 2c As Kc] [8d]
maze994: checks 
delbergg: checks 
*** SHOW DOWN ***
maze994: shows [9c Ad] (a pair of Aces)
delbergg: mucks hand 
maze994 collected $0.57 from pot
*** SUMMARY ***
Total pot $0.60 | Rake $0.03 
Board [Tc 2c As Kc 8d]
Seat 1: delbergg mucked
Seat 3: armin75 (button) folded before Flop (didn't bet)
Seat 4: maze994 (small blind) showed [9c Ad] and won ($0.57) with a pair of Aces
Seat 5: Impostore1988 (big blind) folded before Flop
Seat 6: Sergey_Bolos folded before Flop (didn't bet)



PokerStars Hand #222948712006:  Hold'em No Limit ($0.05/$0.10 USD) - 2021/01/23 4:33:12 ET
Table 'Polydoros II' 6-max Seat #4 is the button
Seat 1: delbergg ($5.97 in chips) 
Seat 3: armin75 ($10.43 in chips) 
Seat 4: maze994 ($8.22 in chips) 
Seat 5: Impostore1988 ($32.81 in chips) 
Seat 6: Sergey_Bolos ($14.37 in chips) 
Impostore1988: posts small blind $0.05
Sergey_Bolos: posts big blind $0.10
*** HOLE CARDS ***
delbergg: folds 
armin75: calls $0.10
maze994: folds 
Impostore1988: folds 
Sergey_Bolos: checks 
*** FLOP *** [5c Ac Kd]
Sergey_Bolos: checks 
armin75: checks 
*** TURN *** [5c Ac Kd] [Kc]
Sergey_Bolos: checks 
armin75: checks 
*** RIVER *** [5c Ac Kd Kc] [7c]
Sergey_Bolos: checks 
armin75: checks 
*** SHOW DOWN ***
Sergey_Bolos: shows [9h 6d] (a pair of Kings)
armin75: shows [Jd 7d] (two pair, Kings and Sevens)
armin75 collected $0.24 from pot
*** SUMMARY ***
Total pot $0.25 | Rake $0.01 
Board [5c Ac Kd Kc 7c]
Seat 1: delbergg folded before Flop (didn't bet)
Seat 3: armin75 showed [Jd 7d] and won ($0.24) with two pair, Kings and Sevens
Seat 4: maze994 (button) folded before Flop (didn't bet)
Seat 5: Impostore1988 (small blind) folded before Flop
Seat 6: Sergey_Bolos (big blind) showed [9h 6d] and lost with a pair of Kings



PokerStars Hand #222948720959:  Hold'em No Limit ($0.05/$0.10 USD) - 2021/01/23 4:33:46 ET
Table 'Polydoros II' 6-max Seat #5 is the button
Seat 1: delbergg ($5.97 in chips) 
Seat 3: armin75 ($10.57 in chips) 
Seat 4: maze994 ($8.22 in chips) 
Seat 5: Impostore1988 ($32.76 in chips) 
Seat 6: Sergey_Bolos ($14.27 in chips) 
Sergey_Bolos: posts small blind $0.05
delbergg: posts big blind $0.10
*** HOLE CARDS ***
armin75: raises $0.25 to $0.35
maze994: folds 
Impostore1988: folds 
Sergey_Bolos: folds 
delbergg: calls $0.25
*** FLOP *** [9s 4s Td]
delbergg: checks 
armin75: checks 
*** TURN *** [9s 4s Td] [Qs]
delbergg: bets $1.10
armin75: folds 
Uncalled bet ($1.10) returned to delbergg
delbergg collected $0.72 from pot
delbergg: doesn't show hand 
*** SUMMARY ***
Total pot $0.75 | Rake $0.03 
Board [9s 4s Td Qs]
Seat 1: delbergg (big blind) collected ($0.72)
Seat 3: armin75 folded on the Turn
Seat 4: maze994 folded before Flop (didn't bet)
Seat 5: Impostore1988 (button) folded before Flop (didn't bet)
Seat 6: Sergey_Bolos (small blind) folded before Flop



PokerStars Hand #222948726336:  Hold'em No Limit ($0.05/$0.10 USD) - 2021/01/23 4:34:06 ET
Table 'Polydoros II' 6-max Seat #6 is the button
Seat 1: delbergg ($6.34 in chips) 
Seat 3: armin75 ($10.22 in chips) 
Seat 4: maze994 ($8.22 in chips) 
Seat 5: Impostore1988 ($32.76 in chips) 
Seat 6: Sergey_Bolos ($14.22 in chips) 
delbergg: posts small blind $0.05
armin75: posts big blind $0.10
*** HOLE CARDS ***
maze994: raises $0.20 to $0.30
Impostore1988: folds 
Sergey_Bolos: folds 
delbergg: calls $0.25
armin75: folds 
*** FLOP *** [Tc 6s 2c]
delbergg: checks 
maze994: bets $0.33
delbergg: folds 
Uncalled bet ($0.33) returned to maze994
maze994 collected $0.67 from pot
maze994: doesn't show hand 
*** SUMMARY ***
Total pot $0.70 | Rake $0.03 
Board [Tc 6s 2c]
Seat 1: delbergg (small blind) folded on the Flop
Seat 3: armin75 (big blind) folded before Flop
Seat 4: maze994 collected ($0.67)
Seat 5: Impostore1988 folded before Flop (didn't bet)
Seat 6: Sergey_Bolos (button) folded before Flop (didn't bet)



PokerStars Hand #222948732329:  Hold'em No Limit ($0.05/$0.10 USD) - 2021/01/23 4:34:29 ET
Table 'Polydoros II' 6-max Seat #1 is the button
Seat 1: delbergg ($6.04 in chips) 
Seat 3: armin75 ($10.12 in chips) 
Seat 5: Impostore1988 ($32.76 in chips) 
Seat 6: Sergey_Bolos ($14.22 in chips) 
armin75: posts small blind $0.05
Impostore1988: posts big blind $0.10
*** HOLE CARDS ***
Sergey_Bolos: folds 
maze994 leaves the table
delbergg: raises $0.15 to $0.25
armin75: folds 
Impostore1988: raises $1.25 to $1.50
delbergg: raises $4.54 to $6.04 and is all-in
Impostore1988: calls $4.54
*** FLOP *** [2h Js As]
*** TURN *** [2h Js As] [Kd]
*** RIVER *** [2h Js As Kd] [7d]
*** SHOW DOWN ***
Impostore1988: shows [Ad Ac] (three of a kind, Aces)
delbergg: shows [8h 8s] (a pair of Eights)
Impostore1988 collected $11.58 from pot
*** SUMMARY ***
Total pot $12.13 | Rake $0.55 
Board [2h Js As Kd 7d]
Seat 1: delbergg (button) showed [8h 8s] and lost with a pair of Eights
Seat 3: armin75 (small blind) folded before Flop
Seat 5: Impostore1988 (big blind) showed [Ad Ac] and won ($11.58) with three of a kind, Aces
Seat 6: Sergey_Bolos folded before Flop (didn't bet)



PokerStars Hand #222948738574:  Hold'em No Limit ($0.05/$0.10 USD) - 2021/01/23 4:34:52 ET
Table 'Polydoros II' 6-max Seat #3 is the button
Seat 3: armin75 ($10.07 in chips) 
Seat 5: Impostore1988 ($38.30 in chips) 
Seat 6: Sergey_Bolos ($14.22 in chips) 
Impostore1988: posts small blind $0.05
Sergey_Bolos: posts big blind $0.10
*** HOLE CARDS ***
armin75: folds 
Impostore1988: raises $0.20 to $0.30
Sergey_Bolos: calls $0.20
*** FLOP *** [8s Qh 5d]
Impostore1988: checks 
Sergey_Bolos: checks 
*** TURN *** [8s Qh 5d] [3h]
delbergg leaves the table
teddyKK joins the table at seat #4 
Impostore1988: checks 
Sergey_Bolos: bets $0.26
Normalnie joins the table at seat #1 
Impostore1988: folds 
Uncalled bet ($0.26) returned to Sergey_Bolos
Sergey_Bolos collected $0.57 from pot
Sergey_Bolos: doesn't show hand 
*** SUMMARY ***
Total pot $0.60 | Rake $0.03 
Board [8s Qh 5d 3h]
Seat 3: armin75 (button) folded before Flop (didn't bet)
Seat 5: Impostore1988 (small blind) folded on the Turn
Seat 6: Sergey_Bolos (big blind) collected ($0.57)



PokerStars Hand #222948751297:  Hold'em No Limit ($0.05/$0.10 USD) - 2021/01/23 4:35:39 ET
Table 'Polydoros II' 6-max Seat #5 is the button
Seat 1: Normalnie ($8 in chips) 
Seat 3: armin75 ($10.07 in chips) 
Seat 5: Impostore1988 ($38 in chips) 
Seat 6: Sergey_Bolos ($14.49 in chips) 
Sergey_Bolos: posts small blind $0.05
Normalnie: posts big blind $0.10
teddyKK: sits out 
*** HOLE CARDS ***
armin75: calls $0.10
Impostore1988: folds 
Sergey_Bolos: folds 
Normalnie: checks 
*** FLOP *** [5h 3s Kh]
Normalnie: bets $0.20
armin75: folds 
Uncalled bet ($0.20) returned to Normalnie
Normalnie collected $0.24 from pot
Normalnie: doesn't show hand 
*** SUMMARY ***
Total pot $0.25 | Rake $0.01 
Board [5h 3s Kh]
Seat 1: Normalnie (big blind) collected ($0.24)
Seat 3: armin75 folded on the Flop
Seat 5: Impostore1988 (button) folded before Flop (didn't bet)
Seat 6: Sergey_Bolos (small blind) folded before Flop



PokerStars Hand #222948758710:  Hold'em No Limit ($0.05/$0.10 USD) - 2021/01/23 4:36:07 ET
Table 'Polydoros II' 6-max Seat #6 is the button
Seat 1: Normalnie ($8.14 in chips) 
Seat 3: armin75 ($9.97 in chips) 
Seat 5: Impostore1988 ($38 in chips) 
Seat 6: Sergey_Bolos ($14.44 in chips) 
Normalnie: posts small blind $0.05
armin75: posts big blind $0.10
teddyKK: sits out 
*** HOLE CARDS ***
Impostore1988: folds 
Sergey_Bolos: raises $0.15 to $0.25
Normalnie: calls $0.20
armin75: folds 
*** FLOP *** [Kc 3s 4d]
Normalnie: checks 
Sergey_Bolos: bets $0.26
Normalnie: calls $0.26
*** TURN *** [Kc 3s 4d] [Ks]
Normalnie: checks 
Sergey_Bolos: bets $0.48
Normalnie: calls $0.48
*** RIVER *** [Kc 3s 4d Ks] [4h]
Normalnie: bets $1
Sergey_Bolos: calls $1
*** SHOW DOWN ***
Normalnie: shows [3h Kh] (a full house, Kings full of Fours)
Sergey_Bolos: mucks hand 
Normalnie collected $3.90 from pot
GreenChe was removed from the table for failing to post
GreenChe leaves the table
*** SUMMARY ***
Total pot $4.08 | Rake $0.18 
Board [Kc 3s 4d Ks 4h]
Seat 1: Normalnie (small blind) showed [3h Kh] and won ($3.90) with a full house, Kings full of Fours
Seat 3: armin75 (big blind) folded before Flop
Seat 5: Impostore1988 folded before Flop (didn't bet)
Seat 6: Sergey_Bolos (button) mucked



PokerStars Hand #222948779495:  Hold'em No Limit ($0.05/$0.10 USD) - 2021/01/23 4:37:23 ET
Table 'Polydoros II' 6-max Seat #1 is the button
Seat 1: Normalnie ($10.05 in chips) 
Seat 3: armin75 ($9.87 in chips) 
Seat 4: teddyKK ($10 in chips) 
Seat 5: Impostore1988 ($38 in chips) 
Seat 6: Sergey_Bolos ($12.45 in chips) 
armin75: posts small blind $0.05
teddyKK: posts big blind $0.10
*** HOLE CARDS ***
Impostore1988 has timed out
Impostore1988: folds 
Sergey_Bolos: folds 
Normalnie: folds 
armin75: calls $0.05
arbuzzas joins the table at seat #2 
teddyKK: checks 
*** FLOP *** [9c 4d 5c]
armin75: checks 
teddyKK: bets $0.20
armin75: folds 
Uncalled bet ($0.20) returned to teddyKK
teddyKK collected $0.19 from pot
teddyKK: doesn't show hand 
*** SUMMARY ***
Total pot $0.20 | Rake $0.01 
Board [9c 4d 5c]
Seat 1: Normalnie (button) folded before Flop (didn't bet)
Seat 3: armin75 (small blind) folded on the Flop
Seat 4: teddyKK (big blind) collected ($0.19)
Seat 5: Impostore1988 folded before Flop (didn't bet)
Seat 6: Sergey_Bolos folded before Flop (didn't bet)



PokerStars Hand #222948789515:  Hold'em No Limit ($0.05/$0.10 USD) - 2021/01/23 4:38:00 ET
Table 'Polydoros II' 6-max Seat #3 is the button
Seat 1: Normalnie ($10.05 in chips) 
Seat 2: arbuzzas ($4.38 in chips) 
Seat 3: armin75 ($9.77 in chips) 
Seat 4: teddyKK ($10.09 in chips) 
Seat 5: Impostore1988 ($38 in chips) 
Seat 6: Sergey_Bolos ($12.45 in chips) 
teddyKK: posts small blind $0.05
Impostore1988: posts big blind $0.10
arbuzzas: posts big blind $0.10
*** HOLE CARDS ***
Sergey_Bolos: folds 
Normalnie: folds 
arbuzzas: checks 
armin75: folds 
teddyKK: folds 
Impostore1988: checks 
*** FLOP *** [Jh As 3h]
Impostore1988: checks 
arbuzzas: bets $0.10
Impostore1988: folds 
Uncalled bet ($0.10) returned to arbuzzas
arbuzzas collected $0.24 from pot
*** SUMMARY ***
Total pot $0.25 | Rake $0.01 
Board [Jh As 3h]
Seat 1: Normalnie folded before Flop (didn't bet)
Seat 2: arbuzzas collected ($0.24)
Seat 3: armin75 (button) folded before Flop (didn't bet)
Seat 4: teddyKK (small blind) folded before Flop
Seat 5: Impostore1988 (big blind) folded on the Flop
Seat 6: Sergey_Bolos folded before Flop (didn't bet)



PokerStars Hand #222948801071:  Hold'em No Limit ($0.05/$0.10 USD) - 2021/01/23 4:38:43 ET
Table 'Polydoros II' 6-max Seat #4 is the button
Seat 1: Normalnie ($10.05 in chips) 
Seat 2: arbuzzas ($4.52 in chips) 
Seat 3: armin75 ($9.77 in chips) 
Seat 4: teddyKK ($10.04 in chips) 
Seat 5: Impostore1988 ($37.90 in chips) 
Seat 6: Sergey_Bolos ($12.45 in chips) 
Impostore1988: posts small blind $0.05
Sergey_Bolos: posts big blind $0.10
*** HOLE CARDS ***
Normalnie: raises $0.20 to $0.30
arbuzzas: folds 
armin75: folds 
teddyKK: folds 
Impostore1988: folds 
Sergey_Bolos: folds 
Uncalled bet ($0.20) returned to Normalnie
Normalnie collected $0.25 from pot
Normalnie: doesn't show hand 
*** SUMMARY ***
Total pot $0.25 | Rake $0 
Seat 1: Normalnie collected ($0.25)
Seat 2: arbuzzas folded before Flop (didn't bet)
Seat 3: armin75 folded before Flop (didn't bet)
Seat 4: teddyKK (button) folded before Flop (didn't bet)
Seat 5: Impostore1988 (small blind) folded before Flop
Seat 6: Sergey_Bolos (big blind) folded before Flop



PokerStars Hand #222948813700:  Hold'em No Limit ($0.05/$0.10 USD) - 2021/01/23 4:39:30 ET
Table 'Polydoros II' 6-max Seat #5 is the button
Seat 1: Normalnie ($10.20 in chips) 
Seat 2: arbuzzas ($4.52 in chips) 
Seat 3: armin75 ($9.77 in chips) 
Seat 4: teddyKK ($10.04 in chips) 
Seat 5: Impostore1988 ($37.85 in chips) 
Seat 6: Sergey_Bolos ($12.35 in chips) 
Sergey_Bolos: posts small blind $0.05
Normalnie: posts big blind $0.10
*** HOLE CARDS ***
arbuzzas: folds 
armin75: raises $0.25 to $0.35
teddyKK: folds 
Impostore1988: folds 
Sergey_Bolos: folds 
Normalnie: folds 
Uncalled bet ($0.25) returned to armin75
armin75 collected $0.25 from pot
armin75: doesn't show hand 
*** SUMMARY ***
Total pot $0.25 | Rake $0 
Seat 1: Normalnie (big blind) folded before Flop
Seat 2: arbuzzas folded before Flop (didn't bet)
Seat 3: armin75 collected ($0.25)
Seat 4: teddyKK folded before Flop (didn't bet)
Seat 5: Impostore1988 (button) folded before Flop (didn't bet)
Seat 6: Sergey_Bolos (small blind) folded before Flop



PokerStars Hand #222948820873:  Hold'em No Limit ($0.05/$0.10 USD) - 2021/01/23 4:39:56 ET
Table 'Polydoros II' 6-max Seat #6 is the button
Seat 1: Normalnie ($10.10 in chips) 
Seat 2: arbuzzas ($4.52 in chips) 
Seat 3: armin75 ($10 in chips) 
Seat 4: teddyKK ($10.04 in chips) 
Seat 5: Impostore1988 ($37.85 in chips) 
Seat 6: Sergey_Bolos ($12.30 in chips) 
Normalnie: posts small blind $0.05
arbuzzas: posts big blind $0.10
*** HOLE CARDS ***
armin75: folds 
teddyKK: folds 
Impostore1988: folds 
Sergey_Bolos: folds 
Normalnie: calls $0.05
arbuzzas: checks 
*** FLOP *** [5d 6s Td]
Normalnie: checks 
arbuzzas: bets $0.10
Normalnie: calls $0.10
*** TURN *** [5d 6s Td] [2d]
Normalnie: bets $0.20
arbuzzas: calls $0.20
*** RIVER *** [5d 6s Td 2d] [Ts]
Normalnie: checks 
arbuzzas: bets $0.10
Normalnie: calls $0.10
*** SHOW DOWN ***
arbuzzas: shows [Kd Th] (three of a kind, Tens)
Normalnie: mucks hand 
arbuzzas collected $0.96 from pot
*** SUMMARY ***
Total pot $1 | Rake $0.04 
Board [5d 6s Td 2d Ts]
Seat 1: Normalnie (small blind) mucked
Seat 2: arbuzzas (big blind) showed [Kd Th] and won ($0.96) with three of a kind, Tens
Seat 3: armin75 folded before Flop (didn't bet)
Seat 4: teddyKK folded before Flop (didn't bet)
Seat 5: Impostore1988 folded before Flop (didn't bet)
Seat 6: Sergey_Bolos (button) folded before Flop (didn't bet)



PokerStars Hand #222948832614:  Hold'em No Limit ($0.05/$0.10 USD) - 2021/01/23 4:40:39 ET
Table 'Polydoros II' 6-max Seat #1 is the button
Seat 1: Normalnie ($9.60 in chips) 
Seat 2: arbuzzas ($4.98 in chips) 
Seat 3: armin75 ($10 in chips) 
Seat 4: teddyKK ($10.04 in chips) 
Seat 5: Impostore1988 ($37.85 in chips) 
Seat 6: Sergey_Bolos ($12.30 in chips) 
arbuzzas: posts small blind $0.05
armin75: posts big blind $0.10
*** HOLE CARDS ***
teddyKK: folds 
Impostore1988 has timed out
Impostore1988: folds 
Sergey_Bolos: folds 
Normalnie: folds 
arbuzzas: calls $0.05
armin75: checks 
*** FLOP *** [Kc 2c 9s]
arbuzzas: checks 
armin75: bets $0.19
arbuzzas: folds 
Uncalled bet ($0.19) returned to armin75
armin75 collected $0.19 from pot
armin75: doesn't show hand 
*** SUMMARY ***
Total pot $0.20 | Rake $0.01 
Board [Kc 2c 9s]
Seat 1: Normalnie (button) folded before Flop (didn't bet)
Seat 2: arbuzzas (small blind) folded on the Flop
Seat 3: armin75 (big blind) collected ($0.19)
Seat 4: teddyKK folded before Flop (didn't bet)
Seat 5: Impostore1988 folded before Flop (didn't bet)
Seat 6: Sergey_Bolos folded before Flop (didn't bet)



PokerStars Hand #222948846385:  Hold'em No Limit ($0.05/$0.10 USD) - 2021/01/23 4:41:28 ET
Table 'Polydoros II' 6-max Seat #2 is the button
Seat 1: Normalnie ($9.60 in chips) 
Seat 2: arbuzzas ($4.88 in chips) 
Seat 3: armin75 ($10.09 in chips) 
Seat 4: teddyKK ($10.04 in chips) 
Seat 5: Impostore1988 ($37.85 in chips) 
Seat 6: Sergey_Bolos ($12.30 in chips) 
armin75: posts small blind $0.05
teddyKK: posts big blind $0.10
*** HOLE CARDS ***
Impostore1988: folds 
Sergey_Bolos: folds 
Normalnie: folds 
arbuzzas: folds 
armin75: folds 
Uncalled bet ($0.05) returned to teddyKK
teddyKK collected $0.10 from pot
teddyKK: doesn't show hand 
*** SUMMARY ***
Total pot $0.10 | Rake $0 
Seat 1: Normalnie folded before Flop (didn't bet)
Seat 2: arbuzzas (button) folded before Flop (didn't bet)
Seat 3: armin75 (small blind) folded before Flop
Seat 4: teddyKK (big blind) collected ($0.10)
Seat 5: Impostore1988 folded before Flop (didn't bet)
Seat 6: Sergey_Bolos folded before Flop (didn't bet)



PokerStars Hand #222948849058:  Hold'em No Limit ($0.05/$0.10 USD) - 2021/01/23 4:41:38 ET
Table 'Polydoros II' 6-max Seat #3 is the button
Seat 1: Normalnie ($9.60 in chips) 
Seat 2: arbuzzas ($4.88 in chips) 
Seat 3: armin75 ($10.04 in chips) 
Seat 4: teddyKK ($10.09 in chips) 
Seat 5: Impostore1988 ($37.85 in chips) 
Seat 6: Sergey_Bolos ($12.30 in chips) 
teddyKK: posts small blind $0.05
Impostore1988: posts big blind $0.10
*** HOLE CARDS ***
Sergey_Bolos: folds 
Normalnie: folds 
arbuzzas: folds 
armin75: folds 
teddyKK: folds 
Uncalled bet ($0.05) returned to Impostore1988
Impostore1988 collected $0.10 from pot
Impostore1988: doesn't show hand 
*** SUMMARY ***
Total pot $0.10 | Rake $0 
Seat 1: Normalnie folded before Flop (didn't bet)
Seat 2: arbuzzas folded before Flop (didn't bet)
Seat 3: armin75 (button) folded before Flop (didn't bet)
Seat 4: teddyKK (small blind) folded before Flop
Seat 5: Impostore1988 (big blind) collected ($0.10)
Seat 6: Sergey_Bolos folded before Flop (didn't bet)



PokerStars Hand #222948854598:  Hold'em No Limit ($0.05/$0.10 USD) - 2021/01/23 4:41:57 ET
Table 'Polydoros II' 6-max Seat #4 is the button
Seat 1: Normalnie ($9.60 in chips) 
Seat 2: arbuzzas ($4.88 in chips) 
Seat 3: armin75 ($10.04 in chips) 
Seat 4: teddyKK ($10.04 in chips) 
Seat 5: Impostore1988 ($37.90 in chips) 
Seat 6: Sergey_Bolos ($12.30 in chips) 
Impostore1988: posts small blind $0.05
Sergey_Bolos: posts big blind $0.10
*** HOLE CARDS ***
Normalnie: folds 
arbuzzas: folds 
armin75: raises $0.25 to $0.35
teddyKK: folds 
Impostore1988: folds 
Sergey_Bolos: calls $0.25
*** FLOP *** [8h 4c Js]
Sergey_Bolos: checks 
armin75: bets $0.36
Sergey_Bolos: calls $0.36
*** TURN *** [8h 4c Js] [9h]
Sergey_Bolos: checks 
armin75: bets $0.70
Sergey_Bolos: raises $1.40 to $2.10
armin75: folds 
Uncalled bet ($1.40) returned to Sergey_Bolos
Sergey_Bolos collected $2.74 from pot
Sergey_Bolos: doesn't show hand 
*** SUMMARY ***
Total pot $2.87 | Rake $0.13 
Board [8h 4c Js 9h]
Seat 1: Normalnie folded before Flop (didn't bet)
Seat 2: arbuzzas folded before Flop (didn't bet)
Seat 3: armin75 folded on the Turn
Seat 4: teddyKK (button) folded before Flop (didn't bet)
Seat 5: Impostore1988 (small blind) folded before Flop
Seat 6: Sergey_Bolos (big blind) collected ($2.74)



PokerStars Hand #222948869353:  Hold'em No Limit ($0.05/$0.10 USD) - 2021/01/23 4:42:41 ET
Table 'Polydoros II' 6-max Seat #5 is the button
Seat 1: Normalnie ($9.60 in chips) 
Seat 2: arbuzzas ($4.88 in chips) 
Seat 3: armin75 ($8.63 in chips) 
Seat 4: teddyKK ($10.04 in chips) 
Seat 5: Impostore1988 ($37.85 in chips) 
Seat 6: Sergey_Bolos ($13.63 in chips) 
Sergey_Bolos: posts small blind $0.05
Normalnie: posts big blind $0.10
*** HOLE CARDS ***
arbuzzas: folds 
armin75: folds 
armin75 leaves the table
teddyKK: folds 
Impostore1988: raises $0.10 to $0.20
Sergey_Bolos: folds 
Normalnie: calls $0.10
*** FLOP *** [7h Tc 2c]
Normalnie: checks 
Impostore1988: checks 
*** TURN *** [7h Tc 2c] [Jd]
Normalnie: checks 
Impostore1988: checks 
*** RIVER *** [7h Tc 2c Jd] [2h]
guro aye1234 joins the table at seat #3 
Normalnie: checks 
Impostore1988: checks 
*** SHOW DOWN ***
Normalnie: shows [5s 6d] (a pair of Deuces)
Impostore1988: shows [6s Ac] (a pair of Deuces - Ace kicker)
Impostore1988 collected $0.43 from pot
*** SUMMARY ***
Total pot $0.45 | Rake $0.02 
Board [7h Tc 2c Jd 2h]
Seat 1: Normalnie (big blind) showed [5s 6d] and lost with a pair of Deuces
Seat 2: arbuzzas folded before Flop (didn't bet)
Seat 3: armin75 folded before Flop (didn't bet)
Seat 4: teddyKK folded before Flop (didn't bet)
Seat 5: Impostore1988 (button) showed [6s Ac] and won ($0.43) with a pair of Deuces
Seat 6: Sergey_Bolos (small blind) folded before Flop



PokerStars Hand #222948886606:  Hold'em No Limit ($0.05/$0.10 USD) - 2021/01/23 4:43:42 ET
Table 'Polydoros II' 6-max Seat #6 is the button
Seat 1: Normalnie ($9.40 in chips) 
Seat 2: arbuzzas ($4.88 in chips) 
Seat 4: teddyKK ($10.04 in chips) 
Seat 5: Impostore1988 ($38.08 in chips) 
Seat 6: Sergey_Bolos ($13.58 in chips) 
Normalnie: posts small blind $0.05
arbuzzas: posts big blind $0.10
*** HOLE CARDS ***
teddyKK: folds 
Impostore1988: raises $0.20 to $0.30
Sergey_Bolos: folds 
Normalnie: folds 
arbuzzas: calls $0.20
*** FLOP *** [Jd Kh 6c]
arbuzzas: checks 
Impostore1988: bets $0.31
arbuzzas: folds 
Uncalled bet ($0.31) returned to Impostore1988
Impostore1988 collected $0.62 from pot
Impostore1988: doesn't show hand 
*** SUMMARY ***
Total pot $0.65 | Rake $0.03 
Board [Jd Kh 6c]
Seat 1: Normalnie (small blind) folded before Flop
Seat 2: arbuzzas (big blind) folded on the Flop
Seat 4: teddyKK folded before Flop (didn't bet)
Seat 5: Impostore1988 collected ($0.62)
Seat 6: Sergey_Bolos (button) folded before Flop (didn't bet)



PokerStars Hand #222948897434:  Hold'em No Limit ($0.05/$0.10 USD) - 2021/01/23 4:44:21 ET
Table 'Polydoros II' 6-max Seat #1 is the button
Seat 1: Normalnie ($9.35 in chips) 
Seat 2: arbuzzas ($4.58 in chips) 
Seat 3: guro aye1234 ($10 in chips) 
Seat 4: teddyKK ($10.04 in chips) 
Seat 5: Impostore1988 ($38.40 in chips) 
Seat 6: Sergey_Bolos ($13.58 in chips) 
arbuzzas: posts small blind $0.05
guro aye1234: posts big blind $0.10
*** HOLE CARDS ***
teddyKK: folds 
Impostore1988: raises $0.10 to $0.20
Sergey_Bolos: folds 
Normalnie: calls $0.20
arbuzzas: folds 
guro aye1234: folds 
*** FLOP *** [Ac 7c 4h]
Impostore1988: bets $0.53
Normalnie: calls $0.53
*** TURN *** [Ac 7c 4h] [Td]
Impostore1988: bets $1.54
Normalnie: calls $1.54
*** RIVER *** [Ac 7c 4h Td] [Jc]
Impostore1988: bets $36.13 and is all-in
Normalnie: folds 
Uncalled bet ($36.13) returned to Impostore1988
Impostore1988 collected $4.48 from pot
Impostore1988: doesn't show hand 
*** SUMMARY ***
Total pot $4.69 | Rake $0.21 
Board [Ac 7c 4h Td Jc]
Seat 1: Normalnie (button) folded on the River
Seat 2: arbuzzas (small blind) folded before Flop
Seat 3: guro aye1234 (big blind) folded before Flop
Seat 4: teddyKK folded before Flop (didn't bet)
Seat 5: Impostore1988 collected ($4.48)
Seat 6: Sergey_Bolos folded before Flop (didn't bet)



PokerStars Hand #222948911030:  Hold'em No Limit ($0.05/$0.10 USD) - 2021/01/23 4:45:09 ET
Table 'Polydoros II' 6-max Seat #2 is the button
Seat 1: Normalnie ($7.08 in chips) 
Seat 2: arbuzzas ($4.53 in chips) 
Seat 3: guro aye1234 ($10 in chips) 
Seat 4: teddyKK ($10.04 in chips) 
Seat 5: Impostore1988 ($40.61 in chips) 
Seat 6: Sergey_Bolos ($13.58 in chips) 
guro aye1234: posts small blind $0.05
teddyKK: posts big blind $0.10
*** HOLE CARDS ***
Impostore1988: folds 
Sergey_Bolos: folds 
Normalnie: folds 
arbuzzas: folds 
guro aye1234: raises $0.15 to $0.25
teddyKK: folds 
Uncalled bet ($0.15) returned to guro aye1234
guro aye1234 collected $0.20 from pot
*** SUMMARY ***
Total pot $0.20 | Rake $0 
Seat 1: Normalnie folded before Flop (didn't bet)
Seat 2: arbuzzas (button) folded before Flop (didn't bet)
Seat 3: guro aye1234 (small blind) collected ($0.20)
Seat 4: teddyKK (big blind) folded before Flop
Seat 5: Impostore1988 folded before Flop (didn't bet)
Seat 6: Sergey_Bolos folded before Flop (didn't bet)



PokerStars Hand #222948914395:  Hold'em No Limit ($0.05/$0.10 USD) - 2021/01/23 4:45:21 ET
Table 'Polydoros II' 6-max Seat #3 is the button
Seat 1: Normalnie ($7.08 in chips) 
Seat 2: arbuzzas ($4.53 in chips) 
Seat 3: guro aye1234 ($10.10 in chips) 
Seat 4: teddyKK ($10 in chips) 
Seat 5: Impostore1988 ($40.61 in chips) 
Seat 6: Sergey_Bolos ($13.58 in chips) 
teddyKK: posts small blind $0.05
Impostore1988: posts big blind $0.10
*** HOLE CARDS ***
Sergey_Bolos: folds 
Normalnie: folds 
arbuzzas: folds 
guro aye1234: folds 
teddyKK: raises $0.20 to $0.30
Impostore1988: calls $0.20
*** FLOP *** [Ks Js 7h]
teddyKK: checks 
Impostore1988: checks 
*** TURN *** [Ks Js 7h] [Jd]
teddyKK: checks 
Impostore1988: checks 
*** RIVER *** [Ks Js 7h Jd] [6s]
teddyKK: checks 
Impostore1988: checks 
*** SHOW DOWN ***
teddyKK: shows [As 7d] (two pair, Jacks and Sevens)
Impostore1988: mucks hand 
teddyKK collected $0.57 from pot
*** SUMMARY ***
Total pot $0.60 | Rake $0.03 
Board [Ks Js 7h Jd 6s]
Seat 1: Normalnie folded before Flop (didn't bet)
Seat 2: arbuzzas folded before Flop (didn't bet)
Seat 3: guro aye1234 (button) folded before Flop (didn't bet)
Seat 4: teddyKK (small blind) showed [As 7d] and won ($0.57) with two pair, Jacks and Sevens
Seat 5: Impostore1988 (big blind) mucked
Seat 6: Sergey_Bolos folded before Flop (didn't bet)



PokerStars Hand #222948925221:  Hold'em No Limit ($0.05/$0.10 USD) - 2021/01/23 4:45:59 ET
Table 'Polydoros II' 6-max Seat #4 is the button
Seat 1: Normalnie ($7.08 in chips) 
Seat 2: arbuzzas ($4.53 in chips) 
Seat 3: guro aye1234 ($10.10 in chips) 
Seat 4: teddyKK ($10.27 in chips) 
Seat 5: Impostore1988 ($40.31 in chips) 
Seat 6: Sergey_Bolos ($13.58 in chips) 
Impostore1988: posts small blind $0.05
Sergey_Bolos: posts big blind $0.10
*** HOLE CARDS ***
Normalnie: folds 
arbuzzas: calls $0.10
guro aye1234: folds 
teddyKK: raises $0.30 to $0.40
Impostore1988: folds 
Sergey_Bolos: folds 
arbuzzas: calls $0.30
*** FLOP *** [Qc 6s As]
arbuzzas: checks 
teddyKK: checks 
*** TURN *** [Qc 6s As] [Td]
arbuzzas: checks 
teddyKK: checks 
*** RIVER *** [Qc 6s As Td] [Kc]
arbuzzas: checks 
teddyKK: bets $0.30
arbuzzas: folds 
Uncalled bet ($0.30) returned to teddyKK
teddyKK collected $0.91 from pot
teddyKK: doesn't show hand 
*** SUMMARY ***
Total pot $0.95 | Rake $0.04 
Board [Qc 6s As Td Kc]
Seat 1: Normalnie folded before Flop (didn't bet)
Seat 2: arbuzzas folded on the River
Seat 3: guro aye1234 folded before Flop (didn't bet)
Seat 4: teddyKK (button) collected ($0.91)
Seat 5: Impostore1988 (small blind) folded before Flop
Seat 6: Sergey_Bolos (big blind) folded before Flop



PokerStars Hand #222948940134:  Hold'em No Limit ($0.05/$0.10 USD) - 2021/01/23 4:46:52 ET
Table 'Polydoros II' 6-max Seat #5 is the button
Seat 1: Normalnie ($7.08 in chips) 
Seat 2: arbuzzas ($4.13 in chips) 
Seat 3: guro aye1234 ($10.10 in chips) 
Seat 4: teddyKK ($10.78 in chips) 
Seat 5: Impostore1988 ($40.26 in chips) 
Seat 6: Sergey_Bolos ($13.48 in chips) 
Sergey_Bolos: posts small blind $0.05
Normalnie: posts big blind $0.10
*** HOLE CARDS ***
arbuzzas: folds 
guro aye1234: folds 
teddyKK: folds 
Impostore1988: folds 
Sergey_Bolos: raises $0.15 to $0.25
Normalnie: calls $0.15
*** FLOP *** [Kh 5d 9c]
Sergey_Bolos: bets $0.22
Normalnie: folds 
Uncalled bet ($0.22) returned to Sergey_Bolos
Sergey_Bolos collected $0.48 from pot
Sergey_Bolos: doesn't show hand 
*** SUMMARY ***
Total pot $0.50 | Rake $0.02 
Board [Kh 5d 9c]
Seat 1: Normalnie (big blind) folded on the Flop
Seat 2: arbuzzas folded before Flop (didn't bet)
Seat 3: guro aye1234 folded before Flop (didn't bet)
Seat 4: teddyKK folded before Flop (didn't bet)
Seat 5: Impostore1988 (button) folded before Flop (didn't bet)
Seat 6: Sergey_Bolos (small blind) collected ($0.48)



PokerStars Hand #222948950053:  Hold'em No Limit ($0.05/$0.10 USD) - 2021/01/23 4:47:26 ET
Table 'Polydoros II' 6-max Seat #6 is the button
Seat 1: Normalnie ($6.83 in chips) 
Seat 2: arbuzzas ($4.13 in chips) 
Seat 3: guro aye1234 ($10.10 in chips) 
Seat 4: teddyKK ($10.78 in chips) 
Seat 5: Impostore1988 ($40.26 in chips) 
Seat 6: Sergey_Bolos ($13.71 in chips) 
Normalnie: posts small blind $0.05
arbuzzas: posts big blind $0.10
*** HOLE CARDS ***
guro aye1234: raises $0.15 to $0.25
teddyKK: folds 
Impostore1988: folds 
Sergey_Bolos: folds 
Normalnie: calls $0.20
arbuzzas: calls $0.15
*** FLOP *** [4d Td 9d]
Normalnie: bets $0.72
arbuzzas: calls $0.72
guro aye1234: calls $0.72
*** TURN *** [4d Td 9d] [4c]
Normalnie: checks 
arbuzzas: checks 
guro aye1234: checks 
*** RIVER *** [4d Td 9d 4c] [Qs]
Normalnie: bets $2.78
arbuzzas: calls $2.78
guro aye1234: folds 
*** SHOW DOWN ***
Normalnie: shows [Ac Ah] (two pair, Aces and Fours)
arbuzzas: shows [Kh Jd] (a straight, Nine to King)
arbuzzas collected $8.09 from pot
*** SUMMARY ***
Total pot $8.47 | Rake $0.38 
Board [4d Td 9d 4c Qs]
Seat 1: Normalnie (small blind) showed [Ac Ah] and lost with two pair, Aces and Fours
Seat 2: arbuzzas (big blind) showed [Kh Jd] and won ($8.09) with a straight, Nine to King
Seat 3: guro aye1234 folded on the River
Seat 4: teddyKK folded before Flop (didn't bet)
Seat 5: Impostore1988 folded before Flop (didn't bet)
Seat 6: Sergey_Bolos (button) folded before Flop (didn't bet)



PokerStars Hand #222948966340:  Hold'em No Limit ($0.05/$0.10 USD) - 2021/01/23 4:48:24 ET
Table 'Polydoros II' 6-max Seat #1 is the button
Seat 1: Normalnie ($3.08 in chips) 
Seat 2: arbuzzas ($8.47 in chips) 
Seat 3: guro aye1234 ($10 in chips) 
Seat 4: teddyKK ($10.78 in chips) 
Seat 5: Impostore1988 ($40.26 in chips) 
Seat 6: Sergey_Bolos ($13.71 in chips) 
arbuzzas: posts small blind $0.05
guro aye1234: posts big blind $0.10
*** HOLE CARDS ***
teddyKK: folds 
Impostore1988: folds 
Sergey_Bolos: raises $0.15 to $0.25
Normalnie: folds 
arbuzzas: folds 
guro aye1234: folds 
Uncalled bet ($0.15) returned to Sergey_Bolos
Sergey_Bolos collected $0.25 from pot
Sergey_Bolos: doesn't show hand 
*** SUMMARY ***
Total pot $0.25 | Rake $0 
Seat 1: Normalnie (button) folded before Flop (didn't bet)
Seat 2: arbuzzas (small blind) folded before Flop
Seat 3: guro aye1234 (big blind) folded before Flop
Seat 4: teddyKK folded before Flop (didn't bet)
Seat 5: Impostore1988 folded before Flop (didn't bet)
Seat 6: Sergey_Bolos collected ($0.25)



PokerStars Hand #222948973711:  Hold'em No Limit ($0.05/$0.10 USD) - 2021/01/23 4:48:51 ET
Table 'Polydoros II' 6-max Seat #2 is the button
Seat 1: Normalnie ($5.18 in chips) 
Seat 2: arbuzzas ($8.42 in chips) 
Seat 3: guro aye1234 ($10 in chips) 
Seat 4: teddyKK ($10.78 in chips) 
Seat 5: Impostore1988 ($40.26 in chips) 
Seat 6: Sergey_Bolos ($13.86 in chips) 
guro aye1234: posts small blind $0.05
teddyKK: posts big blind $0.10
*** HOLE CARDS ***
Impostore1988: raises $0.20 to $0.30
Sergey_Bolos: folds 
Normalnie: folds 
arbuzzas: folds 
guro aye1234: folds 
teddyKK: calls $0.20
*** FLOP *** [Th 7c Ad]
teddyKK: checks 
Impostore1988: checks 
*** TURN *** [Th 7c Ad] [5c]
teddyKK: checks 
Impostore1988: checks 
*** RIVER *** [Th 7c Ad 5c] [2c]
teddyKK: checks 
Impostore1988: bets $1.20
teddyKK: folds 
Uncalled bet ($1.20) returned to Impostore1988
Impostore1988 collected $0.62 from pot
Impostore1988: doesn't show hand 
*** SUMMARY ***
Total pot $0.65 | Rake $0.03 
Board [Th 7c Ad 5c 2c]
Seat 1: Normalnie folded before Flop (didn't bet)
Seat 2: arbuzzas (button) folded before Flop (didn't bet)
Seat 3: guro aye1234 (small blind) folded before Flop
Seat 4: teddyKK (big blind) folded on the River
Seat 5: Impostore1988 collected ($0.62)
Seat 6: Sergey_Bolos folded before Flop (didn't bet)



PokerStars Hand #222948988766:  Hold'em No Limit ($0.05/$0.10 USD) - 2021/01/23 4:49:44 ET
Table 'Polydoros II' 6-max Seat #3 is the button
Seat 1: Normalnie ($5.18 in chips) 
Seat 2: arbuzzas ($8.42 in chips) 
Seat 3: guro aye1234 ($10 in chips) 
Seat 4: teddyKK ($10.48 in chips) 
Seat 5: Impostore1988 ($40.58 in chips) 
Seat 6: Sergey_Bolos ($13.86 in chips) 
teddyKK: posts small blind $0.05
Impostore1988: posts big blind $0.10
*** HOLE CARDS ***
Sergey_Bolos: folds 
Normalnie: folds 
arbuzzas: folds 
guro aye1234: folds 
teddyKK: folds 
Uncalled bet ($0.05) returned to Impostore1988
Impostore1988 collected $0.10 from pot
Impostore1988: doesn't show hand 
*** SUMMARY ***
Total pot $0.10 | Rake $0 
Seat 1: Normalnie folded before Flop (didn't bet)
Seat 2: arbuzzas folded before Flop (didn't bet)
Seat 3: guro aye1234 (button) folded before Flop (didn't bet)
Seat 4: teddyKK (small blind) folded before Flop
Seat 5: Impostore1988 (big blind) collected ($0.10)
Seat 6: Sergey_Bolos folded before Flop (didn't bet)



PokerStars Hand #222948992776:  Hold'em No Limit ($0.05/$0.10 USD) - 2021/01/23 4:49:59 ET
Table 'Polydoros II' 6-max Seat #4 is the button
Seat 1: Normalnie ($5.18 in chips) 
Seat 2: arbuzzas ($8.42 in chips) 
Seat 3: guro aye1234 ($10 in chips) 
Seat 4: teddyKK ($10.43 in chips) 
Seat 5: Impostore1988 ($40.63 in chips) 
Seat 6: Sergey_Bolos ($13.86 in chips) 
Impostore1988: posts small blind $0.05
Sergey_Bolos: posts big blind $0.10
*** HOLE CARDS ***
Normalnie: folds 
arbuzzas: folds 
guro aye1234: folds 
teddyKK: folds 
Impostore1988: folds 
Uncalled bet ($0.05) returned to Sergey_Bolos
Sergey_Bolos collected $0.10 from pot
Sergey_Bolos: doesn't show hand 
*** SUMMARY ***
Total pot $0.10 | Rake $0 
Seat 1: Normalnie folded before Flop (didn't bet)
Seat 2: arbuzzas folded before Flop (didn't bet)
Seat 3: guro aye1234 folded before Flop (didn't bet)
Seat 4: teddyKK (button) folded before Flop (didn't bet)
Seat 5: Impostore1988 (small blind) folded before Flop
Seat 6: Sergey_Bolos (big blind) collected ($0.10)



PokerStars Hand #222948998406:  Hold'em No Limit ($0.05/$0.10 USD) - 2021/01/23 4:50:18 ET
Table 'Polydoros II' 6-max Seat #5 is the button
Seat 1: Normalnie ($5.18 in chips) 
Seat 2: arbuzzas ($8.42 in chips) 
Seat 3: guro aye1234 ($10 in chips) 
Seat 4: teddyKK ($10.43 in chips) 
Seat 5: Impostore1988 ($40.58 in chips) 
Seat 6: Sergey_Bolos ($13.91 in chips) 
Sergey_Bolos: posts small blind $0.05
Normalnie: posts big blind $0.10
*** HOLE CARDS ***
arbuzzas: folds 
guro aye1234: folds 
teddyKK: folds 
Impostore1988: folds 
Sergey_Bolos: folds 
Uncalled bet ($0.05) returned to Normalnie
Normalnie collected $0.10 from pot
Normalnie: doesn't show hand 
*** SUMMARY ***
Total pot $0.10 | Rake $0 
Seat 1: Normalnie (big blind) collected ($0.10)
Seat 2: arbuzzas folded before Flop (didn't bet)
Seat 3: guro aye1234 folded before Flop (didn't bet)
Seat 4: teddyKK folded before Flop (didn't bet)
Seat 5: Impostore1988 (button) folded before Flop (didn't bet)
Seat 6: Sergey_Bolos (small blind) folded before Flop



PokerStars Hand #222949003662:  Hold'em No Limit ($0.05/$0.10 USD) - 2021/01/23 4:50:37 ET
Table 'Polydoros II' 6-max Seat #6 is the button
Seat 1: Normalnie ($5.23 in chips) 
Seat 2: arbuzzas ($8.42 in chips) 
Seat 3: guro aye1234 ($10 in chips) 
Seat 4: teddyKK ($10.43 in chips) 
Seat 5: Impostore1988 ($40.58 in chips) 
Seat 6: Sergey_Bolos ($13.86 in chips) 
Normalnie: posts small blind $0.05
arbuzzas: posts big blind $0.10
*** HOLE CARDS ***
guro aye1234: raises $0.15 to $0.25
teddyKK: folds 
Impostore1988: calls $0.25
Sergey_Bolos: calls $0.25
Normalnie: folds 
arbuzzas: folds 
*** FLOP *** [4h Tc 3c]
guro aye1234: checks 
Impostore1988: checks 
Sergey_Bolos: bets $0.58
guro aye1234: folds 
Impostore1988: folds 
Uncalled bet ($0.58) returned to Sergey_Bolos
Sergey_Bolos collected $0.86 from pot
Sergey_Bolos: doesn't show hand 
*** SUMMARY ***
Total pot $0.90 | Rake $0.04 
Board [4h Tc 3c]
Seat 1: Normalnie (small blind) folded before Flop
Seat 2: arbuzzas (big blind) folded before Flop
Seat 3: guro aye1234 folded on the Flop
Seat 4: teddyKK folded before Flop (didn't bet)
Seat 5: Impostore1988 folded on the Flop
Seat 6: Sergey_Bolos (button) collected ($0.86)



PokerStars Hand #222949014861:  Hold'em No Limit ($0.05/$0.10 USD) - 2021/01/23 4:51:17 ET
Table 'Polydoros II' 6-max Seat #1 is the button
Seat 1: Normalnie ($5.18 in chips) 
Seat 2: arbuzzas ($8.32 in chips) 
Seat 4: teddyKK ($10.43 in chips) 
Seat 5: Impostore1988 ($40.33 in chips) 
Seat 6: Sergey_Bolos ($14.47 in chips) 
arbuzzas: posts small blind $0.05
guro aye1234: is sitting out 
teddyKK: posts big blind $0.10
*** HOLE CARDS ***
Impostore1988: folds 
Sergey_Bolos: folds 
Normalnie: folds 
arbuzzas: calls $0.05
guro aye1234 leaves the table
teddyKK: checks 
*** FLOP *** [Ac 3s Tc]
arbuzzas: bets $0.10
teddyKK: folds 
Uncalled bet ($0.10) returned to arbuzzas
arbuzzas collected $0.19 from pot
*** SUMMARY ***
Total pot $0.20 | Rake $0.01 
Board [Ac 3s Tc]
Seat 1: Normalnie (button) folded before Flop (didn't bet)
Seat 2: arbuzzas (small blind) collected ($0.19)
Seat 4: teddyKK (big blind) folded on the Flop
Seat 5: Impostore1988 folded before Flop (didn't bet)
Seat 6: Sergey_Bolos folded before Flop (didn't bet)



PokerStars Hand #222949020603:  Hold'em No Limit ($0.05/$0.10 USD) - 2021/01/23 4:51:37 ET
Table 'Polydoros II' 6-max Seat #2 is the button
Seat 1: Normalnie ($5.18 in chips) 
Seat 2: arbuzzas ($8.41 in chips) 
Seat 4: teddyKK ($10.33 in chips) 
Seat 5: Impostore1988 ($40.33 in chips) 
Seat 6: Sergey_Bolos ($14.47 in chips) 
teddyKK: posts small blind $0.05
Impostore1988: posts big blind $0.10
*** HOLE CARDS ***
Sergey_Bolos: folds 
Normalnie: folds 
arbuzzas: folds 
supshockAA joins the table at seat #3 
teddyKK: raises $0.20 to $0.30
Impostore1988: folds 
Uncalled bet ($0.20) returned to teddyKK
teddyKK collected $0.20 from pot
teddyKK: doesn't show hand 
*** SUMMARY ***
Total pot $0.20 | Rake $0 
Seat 1: Normalnie folded before Flop (didn't bet)
Seat 2: arbuzzas (button) folded before Flop (didn't bet)
Seat 4: teddyKK (small blind) collected ($0.20)
Seat 5: Impostore1988 (big blind) folded before Flop
Seat 6: Sergey_Bolos folded before Flop (didn't bet)



PokerStars Hand #222949027841:  Hold'em No Limit ($0.05/$0.10 USD) - 2021/01/23 4:52:03 ET
Table 'Polydoros II' 6-max Seat #4 is the button
Seat 1: Normalnie ($5.18 in chips) 
Seat 2: arbuzzas ($8.41 in chips) 
Seat 4: teddyKK ($10.43 in chips) 
Seat 5: Impostore1988 ($40.23 in chips) 
Seat 6: Sergey_Bolos ($14.47 in chips) 
Impostore1988: posts small blind $0.05
Sergey_Bolos: posts big blind $0.10
supshockAA: sits out 
*** HOLE CARDS ***
Normalnie: folds 
arbuzzas: folds 
teddyKK: folds 
Impostore1988: folds 
Uncalled bet ($0.05) returned to Sergey_Bolos
Sergey_Bolos collected $0.10 from pot
Sergey_Bolos: doesn't show hand 
*** SUMMARY ***
Total pot $0.10 | Rake $0 
Seat 1: Normalnie folded before Flop (didn't bet)
Seat 2: arbuzzas folded before Flop (didn't bet)
Seat 4: teddyKK (button) folded before Flop (didn't bet)
Seat 5: Impostore1988 (small blind) folded before Flop
Seat 6: Sergey_Bolos (big blind) collected ($0.10)



PokerStars Hand #222949032503:  Hold'em No Limit ($0.05/$0.10 USD) - 2021/01/23 4:52:19 ET
Table 'Polydoros II' 6-max Seat #5 is the button
Seat 1: Normalnie ($5.18 in chips) 
Seat 2: arbuzzas ($8.41 in chips) 
Seat 4: teddyKK ($10.43 in chips) 
Seat 5: Impostore1988 ($40.18 in chips) 
Seat 6: Sergey_Bolos ($14.52 in chips) 
Sergey_Bolos: posts small blind $0.05
Normalnie: posts big blind $0.10
supshockAA: sits out 
*** HOLE CARDS ***
arbuzzas: folds 
teddyKK: raises $0.20 to $0.30
Impostore1988: folds 
Sergey_Bolos: folds 
Normalnie: calls $0.20
*** FLOP *** [Kd 7d 8h]
Normalnie: checks 
teddyKK: checks 
*** TURN *** [Kd 7d 8h] [4c]
Normalnie: bets $0.62
teddyKK: folds 
Uncalled bet ($0.62) returned to Normalnie
Normalnie collected $0.62 from pot
Normalnie: doesn't show hand 
*** SUMMARY ***
Total pot $0.65 | Rake $0.03 
Board [Kd 7d 8h 4c]
Seat 1: Normalnie (big blind) collected ($0.62)
Seat 2: arbuzzas folded before Flop (didn't bet)
Seat 4: teddyKK folded on the Turn
Seat 5: Impostore1988 (button) folded before Flop (didn't bet)
Seat 6: Sergey_Bolos (small blind) folded before Flop



PokerStars Hand #222949040815:  Hold'em No Limit ($0.05/$0.10 USD) - 2021/01/23 4:52:48 ET
Table 'Polydoros II' 6-max Seat #6 is the button
Seat 1: Normalnie ($5.50 in chips) 
Seat 2: arbuzzas ($8.41 in chips) 
Seat 4: teddyKK ($10.13 in chips) 
Seat 5: Impostore1988 ($40.18 in chips) 
Seat 6: Sergey_Bolos ($14.47 in chips) 
Normalnie: posts small blind $0.05
arbuzzas: posts big blind $0.10
supshockAA: sits out 
*** HOLE CARDS ***
teddyKK: folds 
Impostore1988: folds 
Sergey_Bolos: folds 
Normalnie: folds 
Uncalled bet ($0.05) returned to arbuzzas
arbuzzas collected $0.10 from pot
*** SUMMARY ***
Total pot $0.10 | Rake $0 
Seat 1: Normalnie (small blind) folded before Flop
Seat 2: arbuzzas (big blind) collected ($0.10)
Seat 4: teddyKK folded before Flop (didn't bet)
Seat 5: Impostore1988 folded before Flop (didn't bet)
Seat 6: Sergey_Bolos (button) folded before Flop (didn't bet)



PokerStars Hand #222949044473:  Hold'em No Limit ($0.05/$0.10 USD) - 2021/01/23 4:53:01 ET
Table 'Polydoros II' 6-max Seat #1 is the button
Seat 1: Normalnie ($5.45 in chips) 
Seat 2: arbuzzas ($8.46 in chips) 
Seat 3: supshockAA ($10 in chips) 
Seat 4: teddyKK ($10.13 in chips) 
Seat 5: Impostore1988 ($40.18 in chips) 
Seat 6: Sergey_Bolos ($14.47 in chips) 
arbuzzas: posts small blind $0.05
supshockAA: posts big blind $0.10
*** HOLE CARDS ***
teddyKK has timed out
teddyKK: folds 
Impostore1988: folds 
Sergey_Bolos: raises $0.15 to $0.25
Normalnie: calls $0.25
arbuzzas: folds 
supshockAA: calls $0.15
*** FLOP *** [3s Th Jh]
supshockAA: checks 
Sergey_Bolos: checks 
Normalnie: bets $0.40
supshockAA: calls $0.40
Sergey_Bolos: folds 
*** TURN *** [3s Th Jh] [2h]
supshockAA: checks 
Normalnie: checks 
*** RIVER *** [3s Th Jh 2h] [5h]
supshockAA: checks 
Normalnie: bets $1.53
supshockAA: folds 
Uncalled bet ($1.53) returned to Normalnie
Normalnie collected $1.53 from pot
Normalnie: doesn't show hand 
*** SUMMARY ***
Total pot $1.60 | Rake $0.07 
Board [3s Th Jh 2h 5h]
Seat 1: Normalnie (button) collected ($1.53)
Seat 2: arbuzzas (small blind) folded before Flop
Seat 3: supshockAA (big blind) folded on the River
Seat 4: teddyKK folded before Flop (didn't bet)
Seat 5: Impostore1988 folded before Flop (didn't bet)
Seat 6: Sergey_Bolos folded on the Flop



PokerStars Hand #222949066219:  Hold'em No Limit ($0.05/$0.10 USD) - 2021/01/23 4:54:18 ET
Table 'Polydoros II' 6-max Seat #2 is the button
Seat 1: Normalnie ($6.33 in chips) 
Seat 2: arbuzzas ($8.41 in chips) 
Seat 3: supshockAA ($10 in chips) 
Seat 4: teddyKK ($10.13 in chips) 
Seat 5: Impostore1988 ($40.18 in chips) 
Seat 6: Sergey_Bolos ($14.22 in chips) 
supshockAA: posts small blind $0.05
teddyKK: posts big blind $0.10
*** HOLE CARDS ***
Impostore1988: folds 
Sergey_Bolos: folds 
Normalnie: folds 
arbuzzas: folds 
supshockAA: folds 
Uncalled bet ($0.05) returned to teddyKK
teddyKK collected $0.10 from pot
teddyKK: doesn't show hand 
*** SUMMARY ***
Total pot $0.10 | Rake $0 
Seat 1: Normalnie folded before Flop (didn't bet)
Seat 2: arbuzzas (button) folded before Flop (didn't bet)
Seat 3: supshockAA (small blind) folded before Flop
Seat 4: teddyKK (big blind) collected ($0.10)
Seat 5: Impostore1988 folded before Flop (didn't bet)
Seat 6: Sergey_Bolos folded before Flop (didn't bet)



PokerStars Hand #222949069384:  Hold'em No Limit ($0.05/$0.10 USD) - 2021/01/23 4:54:29 ET
Table 'Polydoros II' 6-max Seat #3 is the button
Seat 1: Normalnie ($6.33 in chips) 
Seat 2: arbuzzas ($8.41 in chips) 
Seat 3: supshockAA ($10 in chips) 
Seat 4: teddyKK ($10.18 in chips) 
Seat 5: Impostore1988 ($40.18 in chips) 
Seat 6: Sergey_Bolos ($14.22 in chips) 
teddyKK: posts small blind $0.05
Impostore1988: posts big blind $0.10
*** HOLE CARDS ***
Sergey_Bolos: raises $0.15 to $0.25
Normalnie: folds 
arbuzzas: folds 
supshockAA: folds 
teddyKK: folds 
Impostore1988: folds 
Uncalled bet ($0.15) returned to Sergey_Bolos
Sergey_Bolos collected $0.25 from pot
Sergey_Bolos: doesn't show hand 
*** SUMMARY ***
Total pot $0.25 | Rake $0 
Seat 1: Normalnie folded before Flop (didn't bet)
Seat 2: arbuzzas folded before Flop (didn't bet)
Seat 3: supshockAA (button) folded before Flop (didn't bet)
Seat 4: teddyKK (small blind) folded before Flop
Seat 5: Impostore1988 (big blind) folded before Flop
Seat 6: Sergey_Bolos collected ($0.25)



PokerStars Hand #222949075850:  Hold'em No Limit ($0.05/$0.10 USD) - 2021/01/23 4:54:52 ET
Table 'Polydoros II' 6-max Seat #4 is the button
Seat 1: Normalnie ($6.33 in chips) 
Seat 2: arbuzzas ($8.41 in chips) 
Seat 3: supshockAA ($10 in chips) 
Seat 4: teddyKK ($10.13 in chips) 
Seat 5: Impostore1988 ($40.08 in chips) 
Seat 6: Sergey_Bolos ($14.37 in chips) 
Impostore1988: posts small blind $0.05
Sergey_Bolos: posts big blind $0.10
*** HOLE CARDS ***
Normalnie: raises $0.10 to $0.20
arbuzzas: folds 
supshockAA: folds 
teddyKK: folds 
Impostore1988: folds 
Sergey_Bolos: folds 
Uncalled bet ($0.10) returned to Normalnie
Normalnie collected $0.25 from pot
Normalnie: doesn't show hand 
*** SUMMARY ***
Total pot $0.25 | Rake $0 
Seat 1: Normalnie collected ($0.25)
Seat 2: arbuzzas folded before Flop (didn't bet)
Seat 3: supshockAA folded before Flop (didn't bet)
Seat 4: teddyKK (button) folded before Flop (didn't bet)
Seat 5: Impostore1988 (small blind) folded before Flop
Seat 6: Sergey_Bolos (big blind) folded before Flop



PokerStars Hand #222949080514:  Hold'em No Limit ($0.05/$0.10 USD) - 2021/01/23 4:55:09 ET
Table 'Polydoros II' 6-max Seat #5 is the button
Seat 1: Normalnie ($6.48 in chips) 
Seat 2: arbuzzas ($8.41 in chips) 
Seat 3: supshockAA ($10 in chips) 
Seat 4: teddyKK ($10.13 in chips) 
Seat 5: Impostore1988 ($40.03 in chips) 
Seat 6: Sergey_Bolos ($14.27 in chips) 
Sergey_Bolos: posts small blind $0.05
Normalnie: posts big blind $0.10
*** HOLE CARDS ***
arbuzzas: folds 
supshockAA: folds 
teddyKK: raises $0.20 to $0.30
Impostore1988 has timed out
Impostore1988: folds 
Sergey_Bolos: folds 
Normalnie: calls $0.20
*** FLOP *** [5c Kh 5d]
Normalnie: checks 
teddyKK: checks 
*** TURN *** [5c Kh 5d] [7c]
Normalnie: checks 
teddyKK: bets $0.30
Normalnie: calls $0.30
*** RIVER *** [5c Kh 5d 7c] [3c]
Normalnie: bets $0.60
teddyKK: raises $1.79 to $2.39
Normalnie: folds 
Uncalled bet ($1.79) returned to teddyKK
teddyKK collected $2.34 from pot
teddyKK: doesn't show hand 
*** SUMMARY ***
Total pot $2.45 | Rake $0.11 
Board [5c Kh 5d 7c 3c]
Seat 1: Normalnie (big blind) folded on the River
Seat 2: arbuzzas folded before Flop (didn't bet)
Seat 3: supshockAA folded before Flop (didn't bet)
Seat 4: teddyKK collected ($2.34)
Seat 5: Impostore1988 (button) folded before Flop (didn't bet)
Seat 6: Sergey_Bolos (small blind) folded before Flop



PokerStars Hand #222949099425:  Hold'em No Limit ($0.05/$0.10 USD) - 2021/01/23 4:56:29 ET
Table 'Polydoros II' 6-max Seat #6 is the button
Seat 1: Normalnie ($5.28 in chips) 
Seat 2: arbuzzas ($8.41 in chips) 
Seat 3: supshockAA ($10 in chips) 
Seat 4: teddyKK ($11.27 in chips) 
Seat 5: Impostore1988 ($40.03 in chips) 
Seat 6: Sergey_Bolos ($14.22 in chips) 
Normalnie: posts small blind $0.05
arbuzzas: posts big blind $0.10
*** HOLE CARDS ***
supshockAA: folds 
teddyKK: raises $0.20 to $0.30
Impostore1988: folds 
Sergey_Bolos: folds 
Normalnie: calls $0.25
arbuzzas: calls $0.20
*** FLOP *** [6s 6c 7s]
Normalnie: bets $0.43
arbuzzas: calls $0.43
teddyKK: folds 
*** TURN *** [6s 6c 7s] [9c]
Normalnie: checks 
arbuzzas: bets $0.84
Normalnie: calls $0.84
*** RIVER *** [6s 6c 7s 9c] [5h]
Normalnie: checks 
arbuzzas: bets $1.65
Normalnie: calls $1.65
*** SHOW DOWN ***
arbuzzas: shows [5s 6d] (a full house, Sixes full of Fives)
Normalnie: mucks hand 
arbuzzas collected $6.44 from pot
*** SUMMARY ***
Total pot $6.74 | Rake $0.30 
Board [6s 6c 7s 9c 5h]
Seat 1: Normalnie (small blind) mucked
Seat 2: arbuzzas (big blind) showed [5s 6d] and won ($6.44) with a full house, Sixes full of Fives
Seat 3: supshockAA folded before Flop (didn't bet)
Seat 4: teddyKK folded on the Flop
Seat 5: Impostore1988 folded before Flop (didn't bet)
Seat 6: Sergey_Bolos (button) folded before Flop (didn't bet)



PokerStars Hand #222949113454:  Hold'em No Limit ($0.05/$0.10 USD) - 2021/01/23 4:57:28 ET
Table 'Polydoros II' 6-max Seat #1 is the button
Seat 1: Normalnie ($2.06 in chips) 
Seat 2: arbuzzas ($11.63 in chips) 
Seat 3: supshockAA ($10 in chips) 
Seat 4: teddyKK ($10.97 in chips) 
Seat 5: Impostore1988 ($40.03 in chips) 
Seat 6: Sergey_Bolos ($14.22 in chips) 
arbuzzas: posts small blind $0.05
supshockAA: posts big blind $0.10
*** HOLE CARDS ***
teddyKK: folds 
Impostore1988: raises $0.20 to $0.30
Sergey_Bolos: folds 
Normalnie: calls $0.30
arbuzzas: folds 
supshockAA: folds 
*** FLOP *** [Kh 2c 4d]
Impostore1988: bets $0.72
Normalnie: raises $1.04 to $1.76 and is all-in
Impostore1988: calls $1.04
*** TURN *** [Kh 2c 4d] [Ts]
*** RIVER *** [Kh 2c 4d Ts] [4h]
*** SHOW DOWN ***
Impostore1988: shows [Ad Ac] (two pair, Aces and Fours)
Normalnie: shows [As 3c] (a pair of Fours)
Impostore1988 collected $4.08 from pot
*** SUMMARY ***
Total pot $4.27 | Rake $0.19 
Board [Kh 2c 4d Ts 4h]
Seat 1: Normalnie (button) showed [As 3c] and lost with a pair of Fours
Seat 2: arbuzzas (small blind) folded before Flop
Seat 3: supshockAA (big blind) folded before Flop
Seat 4: teddyKK folded before Flop (didn't bet)
Seat 5: Impostore1988 showed [Ad Ac] and won ($4.08) with two pair, Aces and Fours
Seat 6: Sergey_Bolos folded before Flop (didn't bet)



PokerStars Hand #222949121844:  Hold'em No Limit ($0.05/$0.10 USD) - 2021/01/23 4:58:02 ET
Table 'Polydoros II' 6-max Seat #2 is the button
Seat 2: arbuzzas ($11.58 in chips) 
Seat 3: supshockAA ($10 in chips) 
Seat 4: teddyKK ($10.97 in chips) 
Seat 5: Impostore1988 ($42.05 in chips) 
Seat 6: Sergey_Bolos ($14.22 in chips) 
supshockAA: posts small blind $0.05
teddyKK: posts big blind $0.10
*** HOLE CARDS ***
Normalnie leaves the table
Impostore1988: raises $0.20 to $0.30
Sergey_Bolos: raises $0.60 to $0.90
arbuzzas: folds 
supshockAA: folds 
teddyKK: folds 
RockstarRaf joins the table at seat #1 
Impostore1988: calls $0.60
*** FLOP *** [Qs 4h 2c]
Impostore1988: checks 
RockstarRaf leaves the table
Sergey_Bolos: bets $0.84
Impostore1988: folds 
Uncalled bet ($0.84) returned to Sergey_Bolos
Sergey_Bolos collected $1.86 from pot
Sergey_Bolos: doesn't show hand 
*** SUMMARY ***
Total pot $1.95 | Rake $0.09 
Board [Qs 4h 2c]
Seat 2: arbuzzas (button) folded before Flop (didn't bet)
Seat 3: supshockAA (small blind) folded before Flop
Seat 4: teddyKK (big blind) folded before Flop
Seat 5: Impostore1988 folded on the Flop
Seat 6: Sergey_Bolos collected ($1.86)



PokerStars Hand #222949130055:  Hold'em No Limit ($0.05/$0.10 USD) - 2021/01/23 4:58:36 ET
Table 'Polydoros II' 6-max Seat #3 is the button
Seat 2: arbuzzas ($11.58 in chips) 
Seat 3: supshockAA ($10 in chips) 
Seat 4: teddyKK ($10.87 in chips) 
Seat 5: Impostore1988 ($41.15 in chips) 
Seat 6: Sergey_Bolos ($15.18 in chips) 
teddyKK: posts small blind $0.05
Impostore1988: posts big blind $0.10
*** HOLE CARDS ***
FeverPitch44 joins the table at seat #1 
Sergey_Bolos: folds 
arbuzzas: folds 
supshockAA: raises $0.20 to $0.30
teddyKK: folds 
Impostore1988: folds 
Uncalled bet ($0.20) returned to supshockAA
supshockAA collected $0.25 from pot
supshockAA: doesn't show hand 
*** SUMMARY ***
Total pot $0.25 | Rake $0 
Seat 2: arbuzzas folded before Flop (didn't bet)
Seat 3: supshockAA (button) collected ($0.25)
Seat 4: teddyKK (small blind) folded before Flop
Seat 5: Impostore1988 (big blind) folded before Flop
Seat 6: Sergey_Bolos folded before Flop (didn't bet)



PokerStars Hand #222949133853:  Hold'em No Limit ($0.05/$0.10 USD) - 2021/01/23 4:58:52 ET
Table 'Polydoros II' 6-max Seat #4 is the button
Seat 2: arbuzzas ($11.58 in chips) 
Seat 3: supshockAA ($10.15 in chips) 
Seat 4: teddyKK ($10.82 in chips) 
Seat 5: Impostore1988 ($41.05 in chips) 
Seat 6: Sergey_Bolos ($15.18 in chips) 
Impostore1988: posts small blind $0.05
Sergey_Bolos: posts big blind $0.10
FeverPitch44: sits out 
*** HOLE CARDS ***
arbuzzas: folds 
supshockAA: folds 
teddyKK: folds 
Impostore1988: folds 
Uncalled bet ($0.05) returned to Sergey_Bolos
Sergey_Bolos collected $0.10 from pot
Sergey_Bolos: doesn't show hand 
*** SUMMARY ***
Total pot $0.10 | Rake $0 
Seat 2: arbuzzas folded before Flop (didn't bet)
Seat 3: supshockAA folded before Flop (didn't bet)
Seat 4: teddyKK (button) folded before Flop (didn't bet)
Seat 5: Impostore1988 (small blind) folded before Flop
Seat 6: Sergey_Bolos (big blind) collected ($0.10)



PokerStars Hand #222949136507:  Hold'em No Limit ($0.05/$0.10 USD) - 2021/01/23 4:59:03 ET
Table 'Polydoros II' 6-max Seat #5 is the button
Seat 1: FeverPitch44 ($9.37 in chips) 
Seat 2: arbuzzas ($11.58 in chips) 
Seat 3: supshockAA ($10.15 in chips) 
Seat 4: teddyKK ($10.82 in chips) 
Seat 5: Impostore1988 ($41 in chips) 
Seat 6: Sergey_Bolos ($15.23 in chips) 
Sergey_Bolos: posts small blind $0.05
FeverPitch44: posts big blind $0.10
*** HOLE CARDS ***
arbuzzas: folds 
supshockAA: folds 
teddyKK: folds 
Impostore1988: raises $0.20 to $0.30
Sergey_Bolos: raises $0.90 to $1.20
FeverPitch44: calls $1.10
Impostore1988: raises $2.60 to $3.80
Sergey_Bolos: calls $2.60
FeverPitch44: calls $2.60
*** FLOP *** [5h 2h 2s]
Sergey_Bolos: checks 
FeverPitch44: checks 
Impostore1988: checks 
*** TURN *** [5h 2h 2s] [6d]
Sergey_Bolos: bets $5.60
FeverPitch44: folds 
Impostore1988: folds 
Uncalled bet ($5.60) returned to Sergey_Bolos
Sergey_Bolos collected $10.89 from pot
Sergey_Bolos: doesn't show hand 
*** SUMMARY ***
Total pot $11.40 | Rake $0.51 
Board [5h 2h 2s 6d]
Seat 1: FeverPitch44 (big blind) folded on the Turn
Seat 2: arbuzzas folded before Flop (didn't bet)
Seat 3: supshockAA folded before Flop (didn't bet)
Seat 4: teddyKK folded before Flop (didn't bet)
Seat 5: Impostore1988 (button) folded on the Turn
Seat 6: Sergey_Bolos (small blind) collected ($10.89)



PokerStars Hand #222949153048:  Hold'em No Limit ($0.05/$0.10 USD) - 2021/01/23 5:00:12 ET
Table 'Polydoros II' 6-max Seat #6 is the button
Seat 2: arbuzzas ($11.58 in chips) 
Seat 3: supshockAA ($10.15 in chips) 
Seat 4: teddyKK ($10.82 in chips) 
Seat 5: Impostore1988 ($37.20 in chips) 
Seat 6: Sergey_Bolos ($22.32 in chips) 
arbuzzas: posts small blind $0.05
supshockAA: posts big blind $0.10
*** HOLE CARDS ***
FeverPitch44 leaves the table
teddyKK: folds 
Impostore1988: folds 
Sergey_Bolos: folds 
arbuzzas: folds 
Uncalled bet ($0.05) returned to supshockAA
supshockAA collected $0.10 from pot
supshockAA: doesn't show hand 
*** SUMMARY ***
Total pot $0.10 | Rake $0 
Seat 2: arbuzzas (small blind) folded before Flop
Seat 3: supshockAA (big blind) collected ($0.10)
Seat 4: teddyKK folded before Flop (didn't bet)
Seat 5: Impostore1988 folded before Flop (didn't bet)
Seat 6: Sergey_Bolos (button) folded before Flop (didn't bet)



PokerStars Hand #222949155318:  Hold'em No Limit ($0.05/$0.10 USD) - 2021/01/23 5:00:20 ET
Table 'Polydoros II' 6-max Seat #2 is the button
Seat 2: arbuzzas ($11.53 in chips) 
Seat 3: supshockAA ($10.20 in chips) 
Seat 4: teddyKK ($10.82 in chips) 
Seat 5: Impostore1988 ($37.20 in chips) 
Seat 6: Sergey_Bolos ($22.32 in chips) 
supshockAA: posts small blind $0.05
teddyKK: posts big blind $0.10
*** HOLE CARDS ***
Impostore1988: folds 
whell11 joins the table at seat #1 
Sergey_Bolos: raises $0.15 to $0.25
arbuzzas: folds 
supshockAA: folds 
Impostore1988 leaves the table
teddyKK: folds 
Uncalled bet ($0.15) returned to Sergey_Bolos
Sergey_Bolos collected $0.25 from pot
Sergey_Bolos: doesn't show hand 
*** SUMMARY ***
Total pot $0.25 | Rake $0 
Seat 2: arbuzzas (button) folded before Flop (didn't bet)
Seat 3: supshockAA (small blind) folded before Flop
Seat 4: teddyKK (big blind) folded before Flop
Seat 5: Impostore1988 folded before Flop (didn't bet)
Seat 6: Sergey_Bolos collected ($0.25)



PokerStars Hand #222949158907:  Hold'em No Limit ($0.05/$0.10 USD) - 2021/01/23 5:00:34 ET
Table 'Polydoros II' 6-max Seat #3 is the button
Seat 2: arbuzzas ($11.53 in chips) 
Seat 3: supshockAA ($10.15 in chips) 
Seat 4: teddyKK ($10.72 in chips) 
Seat 6: Sergey_Bolos ($22.47 in chips) 
teddyKK: posts small blind $0.05
Sergey_Bolos: posts big blind $0.10
whell11: sits out 
*** HOLE CARDS ***
arbuzzas: folds 
supshockAA: raises $0.20 to $0.30
teddyKK: folds 
Sergey_Bolos: folds 
Uncalled bet ($0.20) returned to supshockAA
supshockAA collected $0.25 from pot
supshockAA: doesn't show hand 
*** SUMMARY ***
Total pot $0.25 | Rake $0 
Seat 2: arbuzzas folded before Flop (didn't bet)
Seat 3: supshockAA (button) collected ($0.25)
Seat 4: teddyKK (small blind) folded before Flop
Seat 6: Sergey_Bolos (big blind) folded before Flop



PokerStars Hand #222949163241:  Hold'em No Limit ($0.05/$0.10 USD) - 2021/01/23 5:00:51 ET
Table 'Polydoros II' 6-max Seat #4 is the button
Seat 1: whell11 ($10 in chips) 
Seat 2: arbuzzas ($11.53 in chips) 
Seat 3: supshockAA ($10.30 in chips) 
Seat 4: teddyKK ($10.67 in chips) 
Seat 6: Sergey_Bolos ($22.37 in chips) 
Sergey_Bolos: posts small blind $0.05
whell11: posts big blind $0.10
*** HOLE CARDS ***
arbuzzas: folds 
arbuzzas leaves the table
supshockAA: raises $0.20 to $0.30
teddyKK: folds 
Sergey_Bolos: folds 
whell11: folds 
Uncalled bet ($0.20) returned to supshockAA
supshockAA collected $0.25 from pot
supshockAA: doesn't show hand 
*** SUMMARY ***
Total pot $0.25 | Rake $0 
Seat 1: whell11 (big blind) folded before Flop
Seat 2: arbuzzas folded before Flop (didn't bet)
Seat 3: supshockAA collected ($0.25)
Seat 4: teddyKK (button) folded before Flop (didn't bet)
Seat 6: Sergey_Bolos (small blind) folded before Flop



PokerStars Hand #222949170471:  Hold'em No Limit ($0.05/$0.10 USD) - 2021/01/23 5:01:16 ET
Table 'Polydoros II' 6-max Seat #6 is the button
Seat 1: whell11 ($10 in chips) 
Seat 3: supshockAA ($10.45 in chips) 
Seat 4: teddyKK ($10.67 in chips) 
Seat 6: Sergey_Bolos ($22.32 in chips) 
whell11: posts small blind $0.05
supshockAA: posts big blind $0.10
*** HOLE CARDS ***
teddyKK: folds 
Sergey_Bolos: folds 
whell11: folds 
Uncalled bet ($0.05) returned to supshockAA
supshockAA collected $0.10 from pot
supshockAA: doesn't show hand 
*** SUMMARY ***
Total pot $0.10 | Rake $0 
Seat 1: whell11 (small blind) folded before Flop
Seat 3: supshockAA (big blind) collected ($0.10)
Seat 4: teddyKK folded before Flop (didn't bet)
Seat 6: Sergey_Bolos (button) folded before Flop (didn't bet)



PokerStars Hand #222949173508:  Hold'em No Limit ($0.05/$0.10 USD) - 2021/01/23 5:01:27 ET
Table 'Polydoros II' 6-max Seat #1 is the button
Seat 1: whell11 ($10 in chips) 
Seat 3: supshockAA ($10.50 in chips) 
Seat 6: Sergey_Bolos ($22.32 in chips) 
supshockAA: posts small blind $0.05
teddyKK: is sitting out 
Sergey_Bolos: posts big blind $0.10
*** HOLE CARDS ***
teddyKK leaves the table
whell11: folds 
supshockAA: folds 
Uncalled bet ($0.05) returned to Sergey_Bolos
Sabali420 joins the table at seat #2 
Sergey_Bolos collected $0.10 from pot
*** SUMMARY ***
Total pot $0.10 | Rake $0 
Seat 1: whell11 (button) folded before Flop (didn't bet)
Seat 3: supshockAA (small blind) folded before Flop
Seat 6: Sergey_Bolos (big blind) collected ($0.10)



PokerStars Hand #222949176085:  Hold'em No Limit ($0.05/$0.10 USD) - 2021/01/23 5:01:36 ET
Table 'Polydoros II' 6-max Seat #3 is the button
Seat 2: Sabali420 ($10 in chips) 
Seat 3: supshockAA ($10.45 in chips) 
Seat 6: Sergey_Bolos ($22.37 in chips) 
Sergey_Bolos: posts small blind $0.05
Sabali420: posts big blind $0.10
*** HOLE CARDS ***
supshockAA: raises $0.20 to $0.30
Sergey_Bolos: calls $0.25
Sabali420: folds 
*** FLOP *** [7s 9s 2d]
whell11 leaves the table
Sergey_Bolos: checks 
supshockAA: bets $0.34
Sergey_Bolos: calls $0.34
*** TURN *** [7s 9s 2d] [Js]
Sergey_Bolos: checks 
supshockAA: bets $0.66
Sergey_Bolos: folds 
Uncalled bet ($0.66) returned to supshockAA
supshockAA collected $1.32 from pot
supshockAA: doesn't show hand 
*** SUMMARY ***
Total pot $1.38 | Rake $0.06 
Board [7s 9s 2d Js]
Seat 2: Sabali420 (big blind) folded before Flop
Seat 3: supshockAA (button) collected ($1.32)
Seat 6: Sergey_Bolos (small blind) folded on the Turn



PokerStars Hand #222949182942:  Hold'em No Limit ($0.05/$0.10 USD) - 2021/01/23 5:02:00 ET
Table 'Polydoros II' 6-max Seat #2 is the button
Seat 2: Sabali420 ($9.90 in chips) 
Seat 6: Sergey_Bolos ($21.73 in chips) 
Sabali420: posts small blind $0.05
Sergey_Bolos: posts big blind $0.10
*** HOLE CARDS ***
supshockAA leaves the table
Sabali420: folds 
Uncalled bet ($0.05) returned to Sergey_Bolos
Sergey_Bolos collected $0.10 from pot
Sergey_Bolos: doesn't show hand 
*** SUMMARY ***
Total pot $0.10 | Rake $0 
Seat 2: Sabali420 (button) (small blind) folded before Flop
Seat 6: Sergey_Bolos (big blind) collected ($0.10)



PokerStars Hand #222949184534:  Hold'em No Limit ($0.05/$0.10 USD) - 2021/01/23 5:02:06 ET
Table 'Polydoros II' 6-max Seat #6 is the button
Seat 2: Sabali420 ($9.85 in chips) 
Seat 6: Sergey_Bolos ($21.78 in chips) 
Sergey_Bolos: posts small blind $0.05
Sabali420: posts big blind $0.10
*** HOLE CARDS ***
Sergey_Bolos: folds 
Uncalled bet ($0.05) returned to Sabali420
Sabali420 collected $0.10 from pot
Sabali420: doesn't show hand 
*** SUMMARY ***
Total pot $0.10 | Rake $0 
Seat 2: Sabali420 (big blind) collected ($0.10)
Seat 6: Sergey_Bolos (button) (small blind) folded before Flop



PokerStars Hand #222949185624:  Hold'em No Limit ($0.05/$0.10 USD) - 2021/01/23 5:02:10 ET
Table 'Polydoros II' 6-max Seat #2 is the button
Seat 2: Sabali420 ($9.90 in chips) 
Seat 6: Sergey_Bolos ($21.73 in chips) 
Sabali420: posts small blind $0.05
Sergey_Bolos: posts big blind $0.10
*** HOLE CARDS ***
Sabali420: raises $0.20 to $0.30
Sergey_Bolos: calls $0.20
*** FLOP *** [4h Ah Th]
Sergey_Bolos: checks 
Sabali420: bets $0.29
Sergey_Bolos: folds 
Uncalled bet ($0.29) returned to Sabali420
Sabali420 collected $0.57 from pot
Sabali420: doesn't show hand 
*** SUMMARY ***
Total pot $0.60 | Rake $0.03 
Board [4h Ah Th]
Seat 2: Sabali420 (button) (small blind) collected ($0.57)
Seat 6: Sergey_Bolos (big blind) folded on the Flop



PokerStars Hand #222949216681:  Hold'em No Limit ($0.05/$0.10 USD) - 2021/01/23 5:03:56 ET
Table 'Polydoros II' 6-max Seat #3 is the button
Seat 3: Assetgasse ($10 in chips) 
Seat 6: Sergey_Bolos ($21.43 in chips) 
Assetgasse: posts small blind $0.05
Sergey_Bolos: posts big blind $0.10
*** HOLE CARDS ***
Assetgasse: raises $0.12 to $0.22
Sergey_Bolos: folds 
Uncalled bet ($0.12) returned to Assetgasse
Assetgasse collected $0.20 from pot
Assetgasse: doesn't show hand 
*** SUMMARY ***
Total pot $0.20 | Rake $0 
Seat 3: Assetgasse (button) (small blind) collected ($0.20)
Seat 6: Sergey_Bolos (big blind) folded before Flop



PokerStars Hand #222949219815:  Hold'em No Limit ($0.05/$0.10 USD) - 2021/01/23 5:04:06 ET
Table 'Polydoros II' 6-max Seat #6 is the button
Seat 3: Assetgasse ($10.10 in chips) 
Seat 6: Sergey_Bolos ($21.33 in chips) 
Sergey_Bolos: posts small blind $0.05
Assetgasse: posts big blind $0.10
*** HOLE CARDS ***
Sergey_Bolos: folds 
Uncalled bet ($0.05) returned to Assetgasse
Assetgasse collected $0.10 from pot
Assetgasse: doesn't show hand 
*** SUMMARY ***
Total pot $0.10 | Rake $0 
Seat 3: Assetgasse (big blind) collected ($0.10)
Seat 6: Sergey_Bolos (button) (small blind) folded before Flop



PokerStars Hand #222949221063:  Hold'em No Limit ($0.05/$0.10 USD) - 2021/01/23 5:04:10 ET
Table 'Polydoros II' 6-max Seat #3 is the button
Seat 3: Assetgasse ($10.15 in chips) 
Seat 6: Sergey_Bolos ($21.28 in chips) 
Assetgasse: posts small blind $0.05
Sergey_Bolos: posts big blind $0.10
*** HOLE CARDS ***
Assetgasse: raises $0.12 to $0.22
Sergey_Bolos: folds 
Uncalled bet ($0.12) returned to Assetgasse
Assetgasse collected $0.20 from pot
Assetgasse: doesn't show hand 
*** SUMMARY ***
Total pot $0.20 | Rake $0 
Seat 3: Assetgasse (button) (small blind) collected ($0.20)
Seat 6: Sergey_Bolos (big blind) folded before Flop



PokerStars Hand #222949228215:  Hold'em No Limit ($0.05/$0.10 USD) - 2021/01/23 5:04:35 ET
Table 'Polydoros II' 6-max Seat #6 is the button
Seat 3: Assetgasse ($10.25 in chips) 
Seat 6: Sergey_Bolos ($21.18 in chips) 
Sergey_Bolos: posts small blind $0.05
Assetgasse: posts big blind $0.10
*** HOLE CARDS ***
3EBC96 joins the table at seat #4 
Sergey_Bolos: folds 
Uncalled bet ($0.05) returned to Assetgasse
Assetgasse collected $0.10 from pot
Assetgasse: doesn't show hand 
lucima10 joins the table at seat #1 
*** SUMMARY ***
Total pot $0.10 | Rake $0 
Seat 3: Assetgasse (big blind) collected ($0.10)
Seat 6: Sergey_Bolos (button) (small blind) folded before Flop



PokerStars Hand #222949231235:  Hold'em No Limit ($0.05/$0.10 USD) - 2021/01/23 5:04:45 ET
Table 'Polydoros II' 6-max Seat #3 is the button
Seat 1: lucima10 ($10 in chips) 
Seat 3: Assetgasse ($10.30 in chips) 
Seat 6: Sergey_Bolos ($21.13 in chips) 
Sergey_Bolos: posts small blind $0.05
lucima10: posts big blind $0.10
*** HOLE CARDS ***
wesa280 joins the table at seat #2 
gprobro joins the table at seat #5 
Assetgasse: folds 
Sergey_Bolos: raises $0.15 to $0.25
lucima10: raises $0.75 to $1
Sergey_Bolos: calls $0.75
*** FLOP *** [8s Th Ac]
Sergey_Bolos: checks 
lucima10: checks 
*** TURN *** [8s Th Ac] [4s]
Sergey_Bolos: bets $1.28
lucima10: calls $1.28
*** RIVER *** [8s Th Ac 4s] [6h]
Sergey_Bolos: bets $2.91
lucima10: calls $2.91
*** SHOW DOWN ***
Sergey_Bolos: shows [Jd Qd] (high card Ace)
lucima10: shows [Ad 3s] (a pair of Aces)
lucima10 collected $9.91 from pot
*** SUMMARY ***
Total pot $10.38 | Rake $0.47 
Board [8s Th Ac 4s 6h]
Seat 1: lucima10 (big blind) showed [Ad 3s] and won ($9.91) with a pair of Aces
Seat 3: Assetgasse (button) folded before Flop (didn't bet)
Seat 6: Sergey_Bolos (small blind) showed [Jd Qd] and lost with high card Ace



PokerStars Hand #222949243967:  Hold'em No Limit ($0.05/$0.10 USD) - 2021/01/23 5:05:29 ET
Table 'Polydoros II' 6-max Seat #6 is the button
Seat 1: lucima10 ($14.72 in chips) 
Seat 2: wesa280 ($10 in chips) 
Seat 3: Assetgasse ($10.30 in chips) 
Seat 5: gprobro ($10 in chips) 
Seat 6: Sergey_Bolos ($15.94 in chips) 
lucima10: posts small blind $0.05
wesa280: posts big blind $0.10
3EBC96: sits out 
gprobro: posts big blind $0.10
*** HOLE CARDS ***
Assetgasse has timed out
Assetgasse: folds 
gprobro: checks 
Sergey_Bolos: folds 
lucima10: folds 
wesa280: checks 
*** FLOP *** [6d Th Qh]
wesa280: checks 
gprobro: checks 
*** TURN *** [6d Th Qh] [Js]
wesa280: bets $0.10
gprobro: calls $0.10
*** RIVER *** [6d Th Qh Js] [Ts]
wesa280: bets $2.10
gprobro: folds 
Uncalled bet ($2.10) returned to wesa280
wesa280 collected $0.43 from pot
wesa280: doesn't show hand 
*** SUMMARY ***
Total pot $0.45 | Rake $0.02 
Board [6d Th Qh Js Ts]
Seat 1: lucima10 (small blind) folded before Flop
Seat 2: wesa280 (big blind) collected ($0.43)
Seat 3: Assetgasse folded before Flop (didn't bet)
Seat 5: gprobro folded on the River
Seat 6: Sergey_Bolos (button) folded before Flop (didn't bet)



PokerStars Hand #222949257360:  Hold'em No Limit ($0.05/$0.10 USD) - 2021/01/23 5:06:15 ET
Table 'Polydoros II' 6-max Seat #1 is the button
Seat 1: lucima10 ($14.67 in chips) 
Seat 2: wesa280 ($10.23 in chips) 
Seat 3: Assetgasse ($10.30 in chips) 
Seat 5: gprobro ($9.80 in chips) 
Seat 6: Sergey_Bolos ($15.94 in chips) 
wesa280: posts small blind $0.05
Assetgasse: posts big blind $0.10
3EBC96: sits out 
*** HOLE CARDS ***
gprobro: folds 
Sergey_Bolos: raises $0.15 to $0.25
lucima10: calls $0.25
wesa280: folds 
Assetgasse: folds 
*** FLOP *** [7c Td 3h]
Sergey_Bolos: bets $0.53
lucima10: folds 
Uncalled bet ($0.53) returned to Sergey_Bolos
Sergey_Bolos collected $0.62 from pot
Sergey_Bolos: doesn't show hand 
*** SUMMARY ***
Total pot $0.65 | Rake $0.03 
Board [7c Td 3h]
Seat 1: lucima10 (button) folded on the Flop
Seat 2: wesa280 (small blind) folded before Flop
Seat 3: Assetgasse (big blind) folded before Flop
Seat 5: gprobro folded before Flop (didn't bet)
Seat 6: Sergey_Bolos collected ($0.62)



PokerStars Hand #222949269194:  Hold'em No Limit ($0.05/$0.10 USD) - 2021/01/23 5:06:55 ET
Table 'Polydoros II' 6-max Seat #2 is the button
Seat 1: lucima10 ($14.42 in chips) 
Seat 2: wesa280 ($10.18 in chips) 
Seat 3: Assetgasse ($10.20 in chips) 
Seat 4: 3EBC96 ($10 in chips) 
Seat 5: gprobro ($9.80 in chips) 
Seat 6: Sergey_Bolos ($16.31 in chips) 
Assetgasse: posts small blind $0.05
3EBC96: posts big blind $0.10
*** HOLE CARDS ***
gprobro: folds 
Sergey_Bolos: folds 
lucima10: folds 
wesa280: folds 
Assetgasse: raises $0.20 to $0.30
3EBC96: calls $0.20
*** FLOP *** [Ks Ac 8d]
Assetgasse: bets $0.19
3EBC96: calls $0.19
*** TURN *** [Ks Ac 8d] [8h]
Assetgasse: checks 
3EBC96: checks 
*** RIVER *** [Ks Ac 8d 8h] [7d]
Assetgasse: checks 
3EBC96: checks 
*** SHOW DOWN ***
Assetgasse: shows [Qc Th] (a pair of Eights)
3EBC96: shows [Jc Kh] (two pair, Kings and Eights)
3EBC96 collected $0.94 from pot
*** SUMMARY ***
Total pot $0.98 | Rake $0.04 
Board [Ks Ac 8d 8h 7d]
Seat 1: lucima10 folded before Flop (didn't bet)
Seat 2: wesa280 (button) folded before Flop (didn't bet)
Seat 3: Assetgasse (small blind) showed [Qc Th] and lost with a pair of Eights
Seat 4: 3EBC96 (big blind) showed [Jc Kh] and won ($0.94) with two pair, Kings and Eights
Seat 5: gprobro folded before Flop (didn't bet)
Seat 6: Sergey_Bolos folded before Flop (didn't bet)



PokerStars Hand #222949279021:  Hold'em No Limit ($0.05/$0.10 USD) - 2021/01/23 5:07:29 ET
Table 'Polydoros II' 6-max Seat #3 is the button
Seat 1: lucima10 ($14.42 in chips) 
Seat 2: wesa280 ($10.18 in chips) 
Seat 3: Assetgasse ($10 in chips) 
Seat 4: 3EBC96 ($10.45 in chips) 
Seat 5: gprobro ($9.80 in chips) 
Seat 6: Sergey_Bolos ($16.31 in chips) 
3EBC96: posts small blind $0.05
gprobro: posts big blind $0.10
*** HOLE CARDS ***
Sergey_Bolos: folds 
lucima10: folds 
wesa280: calls $0.10
Assetgasse: folds 
3EBC96: folds 
gprobro: checks 
*** FLOP *** [Qs 4d 5c]
gprobro: bets $0.20
wesa280: folds 
Uncalled bet ($0.20) returned to gprobro
gprobro collected $0.24 from pot
*** SUMMARY ***
Total pot $0.25 | Rake $0.01 
Board [Qs 4d 5c]
Seat 1: lucima10 folded before Flop (didn't bet)
Seat 2: wesa280 folded on the Flop
Seat 3: Assetgasse (button) folded before Flop (didn't bet)
Seat 4: 3EBC96 (small blind) folded before Flop
Seat 5: gprobro (big blind) collected ($0.24)
Seat 6: Sergey_Bolos folded before Flop (didn't bet)



PokerStars Hand #222949284511:  Hold'em No Limit ($0.05/$0.10 USD) - 2021/01/23 5:07:48 ET
Table 'Polydoros II' 6-max Seat #4 is the button
Seat 1: lucima10 ($14.42 in chips) 
Seat 2: wesa280 ($10.08 in chips) 
Seat 3: Assetgasse ($10 in chips) 
Seat 4: 3EBC96 ($10.40 in chips) 
Seat 5: gprobro ($9.94 in chips) 
Seat 6: Sergey_Bolos ($16.31 in chips) 
gprobro: posts small blind $0.05
Sergey_Bolos: posts big blind $0.10
*** HOLE CARDS ***
lucima10: folds 
wesa280: calls $0.10
Assetgasse: raises $0.20 to $0.30
3EBC96: folds 
gprobro: folds 
Sergey_Bolos: folds 
wesa280: calls $0.20
*** FLOP *** [4h 2c 6c]
wesa280: checks 
Assetgasse: bets $0.54
wesa280: calls $0.54
*** TURN *** [4h 2c 6c] [2s]
wesa280: checks 
Assetgasse: checks 
*** RIVER *** [4h 2c 6c 2s] [6s]
wesa280: bets $0.10
Assetgasse: calls $0.10
*** SHOW DOWN ***
wesa280: shows [9c Ac] (two pair, Sixes and Deuces)
Assetgasse: mucks hand 
wesa280 collected $1.94 from pot
*** SUMMARY ***
Total pot $2.03 | Rake $0.09 
Board [4h 2c 6c 2s 6s]
Seat 1: lucima10 folded before Flop (didn't bet)
Seat 2: wesa280 showed [9c Ac] and won ($1.94) with two pair, Sixes and Deuces
Seat 3: Assetgasse mucked
Seat 4: 3EBC96 (button) folded before Flop (didn't bet)
Seat 5: gprobro (small blind) folded before Flop
Seat 6: Sergey_Bolos (big blind) folded before Flop



PokerStars Hand #222949305099:  Hold'em No Limit ($0.05/$0.10 USD) - 2021/01/23 5:08:57 ET
Table 'Polydoros II' 6-max Seat #5 is the button
Seat 1: lucima10 ($14.42 in chips) 
Seat 2: wesa280 ($11.08 in chips) 
Seat 3: Assetgasse ($10 in chips) 
Seat 4: 3EBC96 ($10.40 in chips) 
Seat 5: gprobro ($9.89 in chips) 
Seat 6: Sergey_Bolos ($16.21 in chips) 
Sergey_Bolos: posts small blind $0.05
lucima10: posts big blind $0.10
*** HOLE CARDS ***
wesa280: calls $0.10
Assetgasse: folds 
3EBC96: raises $0.20 to $0.30
gprobro: calls $0.30
Sergey_Bolos: folds 
lucima10: calls $0.20
wesa280: raises $0.70 to $1
3EBC96: folds 
gprobro: calls $0.70
lucima10: calls $0.70
*** FLOP *** [7d 8h 3s]
lucima10: checks 
wesa280: checks 
gprobro: bets $0.80
lucima10: folds 
wesa280: calls $0.80
*** TURN *** [7d 8h 3s] [5c]
wesa280: bets $0.10
gprobro: raises $1 to $1.10
wesa280: folds 
Uncalled bet ($1) returned to gprobro
gprobro collected $4.92 from pot
*** SUMMARY ***
Total pot $5.15 | Rake $0.23 
Board [7d 8h 3s 5c]
Seat 1: lucima10 (big blind) folded on the Flop
Seat 2: wesa280 folded on the Turn
Seat 3: Assetgasse folded before Flop (didn't bet)
Seat 4: 3EBC96 folded before Flop
Seat 5: gprobro (button) collected ($4.92)
Seat 6: Sergey_Bolos (small blind) folded before Flop



PokerStars Hand #222949326824:  Hold'em No Limit ($0.05/$0.10 USD) - 2021/01/23 5:10:11 ET
Table 'Polydoros II' 6-max Seat #6 is the button
Seat 1: lucima10 ($13.42 in chips) 
Seat 2: wesa280 ($9.18 in chips) 
Seat 4: 3EBC96 ($10.10 in chips) 
Seat 5: gprobro ($12.91 in chips) 
Seat 6: Sergey_Bolos ($16.16 in chips) 
lucima10: posts small blind $0.05
wesa280: posts big blind $0.10
*** HOLE CARDS ***
3EBC96: folds 
gprobro: calls $0.10
Sergey_Bolos: folds 
lucima10: folds 
wesa280: checks 
*** FLOP *** [3c Qd 7h]
wesa280: checks 
gprobro: checks 
*** TURN *** [3c Qd 7h] [Ts]
wesa280: checks 
gprobro: bets $0.24
wesa280: calls $0.24
*** RIVER *** [3c Qd 7h Ts] [4h]
wesa280: bets $0.10
gprobro: raises $0.60 to $0.70
wesa280: folds 
Uncalled bet ($0.60) returned to gprobro
gprobro collected $0.89 from pot
*** SUMMARY ***
Total pot $0.93 | Rake $0.04 
Board [3c Qd 7h Ts 4h]
Seat 1: lucima10 (small blind) folded before Flop
Seat 2: wesa280 (big blind) folded on the River
Seat 4: 3EBC96 folded before Flop (didn't bet)
Seat 5: gprobro collected ($0.89)
Seat 6: Sergey_Bolos (button) folded before Flop (didn't bet)



PokerStars Hand #222949339219:  Hold'em No Limit ($0.05/$0.10 USD) - 2021/01/23 5:10:53 ET
Table 'Polydoros II' 6-max Seat #1 is the button
Seat 1: lucima10 ($13.37 in chips) 
Seat 2: wesa280 ($8.74 in chips) 
Seat 4: 3EBC96 ($10.10 in chips) 
Seat 5: gprobro ($13.36 in chips) 
Seat 6: Sergey_Bolos ($16.16 in chips) 
wesa280: posts small blind $0.05
3EBC96: posts big blind $0.10
*** HOLE CARDS ***
gprobro: calls $0.10
Sergey_Bolos: folds 
lucima10: folds 
wesa280: calls $0.05
3EBC96: checks 
*** FLOP *** [Ah 2c Qh]
wesa280: checks 
3EBC96: checks 
gprobro: checks 
*** TURN *** [Ah 2c Qh] [Td]
wesa280: checks 
3EBC96: checks 
gprobro: checks 
*** RIVER *** [Ah 2c Qh Td] [Jh]
wesa280: bets $0.50
3EBC96: folds 
gprobro: folds 
Uncalled bet ($0.50) returned to wesa280
wesa280 collected $0.29 from pot
wesa280: doesn't show hand 
*** SUMMARY ***
Total pot $0.30 | Rake $0.01 
Board [Ah 2c Qh Td Jh]
Seat 1: lucima10 (button) folded before Flop (didn't bet)
Seat 2: wesa280 (small blind) collected ($0.29)
Seat 4: 3EBC96 (big blind) folded on the River
Seat 5: gprobro folded on the River
Seat 6: Sergey_Bolos folded before Flop (didn't bet)



PokerStars Hand #222949352107:  Hold'em No Limit ($0.05/$0.10 USD) - 2021/01/23 5:11:37 ET
Table 'Polydoros II' 6-max Seat #2 is the button
Seat 1: lucima10 ($13.37 in chips) 
Seat 2: wesa280 ($8.93 in chips) 
Seat 4: 3EBC96 ($10 in chips) 
Seat 5: gprobro ($13.26 in chips) 
Seat 6: Sergey_Bolos ($16.16 in chips) 
3EBC96: posts small blind $0.05
gprobro: posts big blind $0.10
*** HOLE CARDS ***
Sergey_Bolos: folds 
lucima10: folds 
wesa280: calls $0.10
3EBC96: folds 
gprobro: checks 
*** FLOP *** [Kd 8h 5s]
gprobro: checks 
wesa280: checks 
*** TURN *** [Kd 8h 5s] [3s]
gprobro: bets $0.20
wesa280: calls $0.20
*** RIVER *** [Kd 8h 5s 3s] [Ks]
gprobro: bets $0.30
wesa280: raises $0.70 to $1
gprobro: folds 
Uncalled bet ($0.70) returned to wesa280
wesa280 collected $1.19 from pot
wesa280: doesn't show hand 
*** SUMMARY ***
Total pot $1.25 | Rake $0.06 
Board [Kd 8h 5s 3s Ks]
Seat 1: lucima10 folded before Flop (didn't bet)
Seat 2: wesa280 (button) collected ($1.19)
Seat 4: 3EBC96 (small blind) folded before Flop
Seat 5: gprobro (big blind) folded on the River
Seat 6: Sergey_Bolos folded before Flop (didn't bet)



PokerStars Hand #222949364036:  Hold'em No Limit ($0.05/$0.10 USD) - 2021/01/23 5:12:17 ET
Table 'Polydoros II' 6-max Seat #4 is the button
Seat 1: lucima10 ($13.37 in chips) 
Seat 2: wesa280 ($9.52 in chips) 
Seat 4: 3EBC96 ($10 in chips) 
Seat 5: gprobro ($12.66 in chips) 
Seat 6: Sergey_Bolos ($16.16 in chips) 
gprobro: posts small blind $0.05
Sergey_Bolos: posts big blind $0.10
*** HOLE CARDS ***
lucima10: folds 
wesa280: folds 
3EBC96: folds 
gprobro: folds 
Uncalled bet ($0.05) returned to Sergey_Bolos
Sergey_Bolos collected $0.10 from pot
Sergey_Bolos: doesn't show hand 
*** SUMMARY ***
Total pot $0.10 | Rake $0 
Seat 1: lucima10 folded before Flop (didn't bet)
Seat 2: wesa280 folded before Flop (didn't bet)
Seat 4: 3EBC96 (button) folded before Flop (didn't bet)
Seat 5: gprobro (small blind) folded before Flop
Seat 6: Sergey_Bolos (big blind) collected ($0.10)



PokerStars Hand #222949368487:  Hold'em No Limit ($0.05/$0.10 USD) - 2021/01/23 5:12:32 ET
Table 'Polydoros II' 6-max Seat #5 is the button
Seat 1: lucima10 ($13.37 in chips) 
Seat 2: wesa280 ($9.52 in chips) 
Seat 4: 3EBC96 ($10 in chips) 
Seat 5: gprobro ($12.61 in chips) 
Seat 6: Sergey_Bolos ($16.21 in chips) 
Sergey_Bolos: posts small blind $0.05
lucima10: posts big blind $0.10
*** HOLE CARDS ***
wesa280: folds 
3EBC96: folds 
gprobro: calls $0.10
Sergey_Bolos: folds 
lucima10: raises $0.40 to $0.50
gprobro: calls $0.40
*** FLOP *** [2h 8s Qh]
lucima10: bets $0.50
gprobro: calls $0.50
*** TURN *** [2h 8s Qh] [Jc]
lucima10: bets $1.30
gprobro: calls $1.30
*** RIVER *** [2h 8s Qh Jc] [Ac]
lucima10: bets $11.07 and is all-in
gprobro: folds 
Uncalled bet ($11.07) returned to lucima10
lucima10 collected $4.44 from pot
lucima10: doesn't show hand 
*** SUMMARY ***
Total pot $4.65 | Rake $0.21 
Board [2h 8s Qh Jc Ac]
Seat 1: lucima10 (big blind) collected ($4.44)
Seat 2: wesa280 folded before Flop (didn't bet)
Seat 4: 3EBC96 folded before Flop (didn't bet)
Seat 5: gprobro (button) folded on the River
Seat 6: Sergey_Bolos (small blind) folded before Flop



PokerStars Hand #222949379522:  Hold'em No Limit ($0.05/$0.10 USD) - 2021/01/23 5:13:10 ET
Table 'Polydoros II' 6-max Seat #6 is the button
Seat 1: lucima10 ($15.51 in chips) 
Seat 2: wesa280 ($9.52 in chips) 
Seat 4: 3EBC96 ($10 in chips) 
Seat 5: gprobro ($10.31 in chips) 
Seat 6: Sergey_Bolos ($16.16 in chips) 
lucima10: posts small blind $0.05
wesa280: posts big blind $0.10
*** HOLE CARDS ***
3EBC96: raises $0.20 to $0.30
gprobro: calls $0.30
Sergey_Bolos: folds 
lucima10: folds 
wesa280: folds 
*** FLOP *** [Jd Jh 5c]
3EBC96: checks 
gprobro: bets $0.40
3EBC96: folds 
Uncalled bet ($0.40) returned to gprobro
gprobro collected $0.72 from pot
*** SUMMARY ***
Total pot $0.75 | Rake $0.03 
Board [Jd Jh 5c]
Seat 1: lucima10 (small blind) folded before Flop
Seat 2: wesa280 (big blind) folded before Flop
Seat 4: 3EBC96 folded on the Flop
Seat 5: gprobro collected ($0.72)
Seat 6: Sergey_Bolos (button) folded before Flop (didn't bet)



PokerStars Hand #222949385417:  Hold'em No Limit ($0.05/$0.10 USD) - 2021/01/23 5:13:30 ET
Table 'Polydoros II' 6-max Seat #1 is the button
Seat 1: lucima10 ($15.46 in chips) 
Seat 2: wesa280 ($9.42 in chips) 
Seat 4: 3EBC96 ($10 in chips) 
Seat 5: gprobro ($10.73 in chips) 
Seat 6: Sergey_Bolos ($16.16 in chips) 
wesa280: posts small blind $0.05
3EBC96: posts big blind $0.10
*** HOLE CARDS ***
gprobro: folds 
Sergey_Bolos: folds 
lucima10: folds 
wesa280: calls $0.05
3EBC96: checks 
*** FLOP *** [6d Js 4h]
wesa280: checks 
3EBC96: bets $0.20
wesa280: calls $0.20
*** TURN *** [6d Js 4h] [2h]
wesa280: bets $0.10
3EBC96: calls $0.10
*** RIVER *** [6d Js 4h 2h] [8h]
wesa280: checks 
3EBC96: checks 
*** SHOW DOWN ***
wesa280: shows [Kh Qh] (a flush, King high)
3EBC96: mucks hand 
wesa280 collected $0.76 from pot
*** SUMMARY ***
Total pot $0.80 | Rake $0.04 
Board [6d Js 4h 2h 8h]
Seat 1: lucima10 (button) folded before Flop (didn't bet)
Seat 2: wesa280 (small blind) showed [Kh Qh] and won ($0.76) with a flush, King high
Seat 4: 3EBC96 (big blind) mucked
Seat 5: gprobro folded before Flop (didn't bet)
Seat 6: Sergey_Bolos folded before Flop (didn't bet)



PokerStars Hand #222949397715:  Hold'em No Limit ($0.05/$0.10 USD) - 2021/01/23 5:14:12 ET
Table 'Polydoros II' 6-max Seat #2 is the button
Seat 1: lucima10 ($15.46 in chips) 
Seat 2: wesa280 ($9.78 in chips) 
Seat 4: 3EBC96 ($10 in chips) 
Seat 5: gprobro ($10.73 in chips) 
Seat 6: Sergey_Bolos ($16.16 in chips) 
3EBC96: posts small blind $0.05
gprobro: posts big blind $0.10
*** HOLE CARDS ***
Sergey_Bolos: raises $0.15 to $0.25
lucima10: raises $0.75 to $1
wesa280: folds 
3EBC96: folds 
gprobro: folds 
Sergey_Bolos: calls $0.75
*** FLOP *** [4h 5s 5c]
Sergey_Bolos: checks 
lucima10: checks 
*** TURN *** [4h 5s 5c] [Th]
Sergey_Bolos: bets $1.37
lucima10: folds 
Uncalled bet ($1.37) returned to Sergey_Bolos
Sergey_Bolos collected $2.05 from pot
Sergey_Bolos: doesn't show hand 
*** SUMMARY ***
Total pot $2.15 | Rake $0.10 
Board [4h 5s 5c Th]
Seat 1: lucima10 folded on the Turn
Seat 2: wesa280 (button) folded before Flop (didn't bet)
Seat 4: 3EBC96 (small blind) folded before Flop
Seat 5: gprobro (big blind) folded before Flop
Seat 6: Sergey_Bolos collected ($2.05)



PokerStars Hand #222949407040:  Hold'em No Limit ($0.05/$0.10 USD) - 2021/01/23 5:14:44 ET
Table 'Polydoros II' 6-max Seat #4 is the button
Seat 1: lucima10 ($14.46 in chips) 
Seat 2: wesa280 ($9.78 in chips) 
Seat 4: 3EBC96 ($10 in chips) 
Seat 5: gprobro ($10.63 in chips) 
Seat 6: Sergey_Bolos ($17.21 in chips) 
gprobro: posts small blind $0.05
Sergey_Bolos: posts big blind $0.10
*** HOLE CARDS ***
lucima10: raises $0.20 to $0.30
wesa280: calls $0.30
3EBC96: folds 
gprobro: calls $0.25
Sergey_Bolos: calls $0.20
*** FLOP *** [4h Qd 5d]
gprobro: bets $0.30
Sergey_Bolos: calls $0.30
lucima10: raises $0.40 to $0.70
wesa280: folds 
gprobro: calls $0.40
Sergey_Bolos: calls $0.40
*** TURN *** [4h Qd 5d] [Th]
gprobro: checks 
Sergey_Bolos: checks 
lucima10: bets $13.46 and is all-in
gprobro: folds 
Sergey_Bolos: calls $13.46
*** RIVER *** [4h Qd 5d Th] [Ts]
*** SHOW DOWN ***
Sergey_Bolos: shows [Tc Td] (four of a kind, Tens)
lucima10: shows [Ah 3h] (a pair of Tens)
Sergey_Bolos collected $28.86 from pot
*** SUMMARY ***
Total pot $30.22 | Rake $1.36 
Board [4h Qd 5d Th Ts]
Seat 1: lucima10 showed [Ah 3h] and lost with a pair of Tens
Seat 2: wesa280 folded on the Flop
Seat 4: 3EBC96 (button) folded before Flop (didn't bet)
Seat 5: gprobro (small blind) folded on the Turn
Seat 6: Sergey_Bolos (big blind) showed [Tc Td] and won ($28.86) with four of a kind, Tens



PokerStars Hand #222949426193:  Hold'em No Limit ($0.05/$0.10 USD) - 2021/01/23 5:15:48 ET
Table 'Polydoros II' 6-max Seat #5 is the button
Seat 1: lucima10 ($10 in chips) 
Seat 2: wesa280 ($9.48 in chips) 
Seat 4: 3EBC96 ($10 in chips) 
Seat 5: gprobro ($9.63 in chips) 
Seat 6: Sergey_Bolos ($31.61 in chips) 
Sergey_Bolos: posts small blind $0.05
lucima10: posts big blind $0.10
*** HOLE CARDS ***
wesa280: calls $0.10
3EBC96: folds 
gprobro: calls $0.10
Sergey_Bolos: calls $0.05
lucima10: checks 
*** FLOP *** [Qc Js Qd]
Sergey_Bolos: checks 
lucima10: checks 
wesa280: checks 
gprobro: checks 
*** TURN *** [Qc Js Qd] [Th]
Sergey_Bolos: checks 
lucima10: checks 
wesa280: checks 
gprobro: checks 
*** RIVER *** [Qc Js Qd Th] [Jd]
Sergey_Bolos: checks 
lucima10: checks 
wesa280: bets $0.10
gprobro: calls $0.10
Sergey_Bolos: folds 
lucima10: folds 
*** SHOW DOWN ***
wesa280: shows [7c 7h] (two pair, Queens and Jacks)
gprobro: shows [Ad 7d] (two pair, Queens and Jacks - Ace kicker)
gprobro collected $0.57 from pot
*** SUMMARY ***
Total pot $0.60 | Rake $0.03 
Board [Qc Js Qd Th Jd]
Seat 1: lucima10 (big blind) folded on the River
Seat 2: wesa280 showed [7c 7h] and lost with two pair, Queens and Jacks
Seat 4: 3EBC96 folded before Flop (didn't bet)
Seat 5: gprobro (button) showed [Ad 7d] and won ($0.57) with two pair, Queens and Jacks
Seat 6: Sergey_Bolos (small blind) folded on the River



PokerStars Hand #222949452340:  Hold'em No Limit ($0.05/$0.10 USD) - 2021/01/23 5:16:45 ET
Table 'Polydoros II' 6-max Seat #6 is the button
Seat 1: lucima10 ($10 in chips) 
Seat 2: wesa280 ($9.28 in chips) 
Seat 4: 3EBC96 ($10 in chips) 
Seat 5: gprobro ($10 in chips) 
Seat 6: Sergey_Bolos ($31.51 in chips) 
lucima10: posts small blind $0.05
wesa280: posts big blind $0.10
*** HOLE CARDS ***
3EBC96: folds 
gprobro: raises $0.20 to $0.30
Sergey_Bolos: calls $0.30
lucima10: folds 
wesa280: calls $0.20
*** FLOP *** [3d 7c Td]
wesa280: checks 
gprobro: bets $0.91
Sergey_Bolos: folds 
wesa280: folds 
Uncalled bet ($0.91) returned to gprobro
gprobro collected $0.91 from pot
*** SUMMARY ***
Total pot $0.95 | Rake $0.04 
Board [3d 7c Td]
Seat 1: lucima10 (small blind) folded before Flop
Seat 2: wesa280 (big blind) folded on the Flop
Seat 4: 3EBC96 folded before Flop (didn't bet)
Seat 5: gprobro collected ($0.91)
Seat 6: Sergey_Bolos (button) folded on the Flop



PokerStars Hand #222949461915:  Hold'em No Limit ($0.05/$0.10 USD) - 2021/01/23 5:17:18 ET
Table 'Polydoros II' 6-max Seat #1 is the button
Seat 1: lucima10 ($10 in chips) 
Seat 2: wesa280 ($8.98 in chips) 
Seat 4: 3EBC96 ($10 in chips) 
Seat 5: gprobro ($10.61 in chips) 
Seat 6: Sergey_Bolos ($31.21 in chips) 
wesa280: posts small blind $0.05
3EBC96: posts big blind $0.10
*** HOLE CARDS ***
gprobro: calls $0.10
Sergey_Bolos: raises $0.25 to $0.35
lucima10: folds 
wesa280: folds 
3EBC96: calls $0.25
gprobro: calls $0.25
*** FLOP *** [Ad 9s Qh]
3EBC96: checks 
gprobro: checks 
Sergey_Bolos: bets $0.47
3EBC96: calls $0.47
gprobro: folds 
*** TURN *** [Ad 9s Qh] [2c]
3EBC96: checks 
Sergey_Bolos: checks 
*** RIVER *** [Ad 9s Qh 2c] [9h]
3EBC96: checks 
Sergey_Bolos: checks 
*** SHOW DOWN ***
3EBC96: shows [Qc Jh] (two pair, Queens and Nines)
Sergey_Bolos: shows [Kc Qd] (two pair, Queens and Nines)
3EBC96 collected $0.98 from pot
Sergey_Bolos collected $0.97 from pot
*** SUMMARY ***
Total pot $2.04 | Rake $0.09 
Board [Ad 9s Qh 2c 9h]
Seat 1: lucima10 (button) folded before Flop (didn't bet)
Seat 2: wesa280 (small blind) folded before Flop
Seat 4: 3EBC96 (big blind) showed [Qc Jh] and won ($0.98) with two pair, Queens and Nines
Seat 5: gprobro folded on the Flop
Seat 6: Sergey_Bolos showed [Kc Qd] and won ($0.97) with two pair, Queens and Nines



PokerStars Hand #222949480210:  Hold'em No Limit ($0.05/$0.10 USD) - 2021/01/23 5:18:20 ET
Table 'Polydoros II' 6-max Seat #2 is the button
Seat 1: lucima10 ($10 in chips) 
Seat 2: wesa280 ($8.93 in chips) 
Seat 4: 3EBC96 ($10.16 in chips) 
Seat 5: gprobro ($10.26 in chips) 
Seat 6: Sergey_Bolos ($31.36 in chips) 
3EBC96: posts small blind $0.05
gprobro: posts big blind $0.10
*** HOLE CARDS ***
Sergey_Bolos: folds 
lucima10: folds 
wesa280: calls $0.10
3EBC96: folds 
gprobro: checks 
*** FLOP *** [Qs Tc Kd]
gprobro: checks 
wesa280: checks 
*** TURN *** [Qs Tc Kd] [Th]
gprobro: bets $0.20
wesa280: calls $0.20
*** RIVER *** [Qs Tc Kd Th] [5d]
gprobro: checks 
wesa280: bets $0.10
gprobro: calls $0.10
*** SHOW DOWN ***
wesa280: shows [5s Jd] (two pair, Tens and Fives)
gprobro: mucks hand 
wesa280 collected $0.81 from pot
*** SUMMARY ***
Total pot $0.85 | Rake $0.04 
Board [Qs Tc Kd Th 5d]
Seat 1: lucima10 folded before Flop (didn't bet)
Seat 2: wesa280 (button) showed [5s Jd] and won ($0.81) with two pair, Tens and Fives
Seat 4: 3EBC96 (small blind) folded before Flop
Seat 5: gprobro (big blind) mucked
Seat 6: Sergey_Bolos folded before Flop (didn't bet)



PokerStars Hand #222949491575:  Hold'em No Limit ($0.05/$0.10 USD) - 2021/01/23 5:18:58 ET
Table 'Polydoros II' 6-max Seat #4 is the button
Seat 1: lucima10 ($10 in chips) 
Seat 2: wesa280 ($9.34 in chips) 
Seat 4: 3EBC96 ($10.11 in chips) 
Seat 5: gprobro ($9.86 in chips) 
Seat 6: Sergey_Bolos ($31.36 in chips) 
gprobro: posts small blind $0.05
Sergey_Bolos: posts big blind $0.10
*** HOLE CARDS ***
lucima10: folds 
wesa280: folds 
3EBC96: raises $0.20 to $0.30
gprobro: folds 
Sergey_Bolos: folds 
Uncalled bet ($0.20) returned to 3EBC96
3EBC96 collected $0.25 from pot
3EBC96: doesn't show hand 
*** SUMMARY ***
Total pot $0.25 | Rake $0 
Seat 1: lucima10 folded before Flop (didn't bet)
Seat 2: wesa280 folded before Flop (didn't bet)
Seat 4: 3EBC96 (button) collected ($0.25)
Seat 5: gprobro (small blind) folded before Flop
Seat 6: Sergey_Bolos (big blind) folded before Flop



PokerStars Hand #222949496517:  Hold'em No Limit ($0.05/$0.10 USD) - 2021/01/23 5:19:15 ET
Table 'Polydoros II' 6-max Seat #5 is the button
Seat 1: lucima10 ($10 in chips) 
Seat 2: wesa280 ($9.34 in chips) 
Seat 4: 3EBC96 ($10.26 in chips) 
Seat 5: gprobro ($9.81 in chips) 
Seat 6: Sergey_Bolos ($31.26 in chips) 
Sergey_Bolos: posts small blind $0.05
lucima10: posts big blind $0.10
*** HOLE CARDS ***
wesa280: calls $0.10
3EBC96: raises $0.40 to $0.50
gprobro: calls $0.50
Sergey_Bolos: folds 
lucima10: calls $0.40
wesa280: folds 
*** FLOP *** [4s Jh 6d]
lucima10: checks 
3EBC96: checks 
gprobro: bets $0.70
lucima10: calls $0.70
3EBC96: calls $0.70
*** TURN *** [4s Jh 6d] [9d]
lucima10: checks 
3EBC96: checks 
gprobro: bets $0.70
lucima10: raises $8.10 to $8.80 and is all-in
3EBC96: folds 
gprobro: folds 
Uncalled bet ($8.10) returned to lucima10
lucima10 collected $4.92 from pot
lucima10: doesn't show hand 
*** SUMMARY ***
Total pot $5.15 | Rake $0.23 
Board [4s Jh 6d 9d]
Seat 1: lucima10 (big blind) collected ($4.92)
Seat 2: wesa280 folded before Flop
Seat 4: 3EBC96 folded on the Turn
Seat 5: gprobro (button) folded on the Turn
Seat 6: Sergey_Bolos (small blind) folded before Flop



PokerStars Hand #222949510940:  Hold'em No Limit ($0.05/$0.10 USD) - 2021/01/23 5:20:02 ET
Table 'Polydoros II' 6-max Seat #6 is the button
Seat 1: lucima10 ($13.02 in chips) 
Seat 2: wesa280 ($9.24 in chips) 
Seat 4: 3EBC96 ($10 in chips) 
Seat 5: gprobro ($7.91 in chips) 
Seat 6: Sergey_Bolos ($31.21 in chips) 
lucima10: posts small blind $0.05
wesa280: posts big blind $0.10
*** HOLE CARDS ***
3EBC96: folds 
gprobro: folds 
Sergey_Bolos: raises $0.15 to $0.25
lucima10: folds 
wesa280: calls $0.15
*** FLOP *** [2d 5s 4c]
wesa280: checks 
Sergey_Bolos: bets $0.24
wesa280: folds 
Uncalled bet ($0.24) returned to Sergey_Bolos
Sergey_Bolos collected $0.53 from pot
Sergey_Bolos: doesn't show hand 
*** SUMMARY ***
Total pot $0.55 | Rake $0.02 
Board [2d 5s 4c]
Seat 1: lucima10 (small blind) folded before Flop
Seat 2: wesa280 (big blind) folded on the Flop
Seat 4: 3EBC96 folded before Flop (didn't bet)
Seat 5: gprobro folded before Flop (didn't bet)
Seat 6: Sergey_Bolos (button) collected ($0.53)



PokerStars Hand #222949518625:  Hold'em No Limit ($0.05/$0.10 USD) - 2021/01/23 5:20:27 ET
Table 'Polydoros II' 6-max Seat #1 is the button
Seat 1: lucima10 ($12.97 in chips) 
Seat 2: wesa280 ($8.99 in chips) 
Seat 4: 3EBC96 ($10 in chips) 
Seat 5: gprobro ($7.91 in chips) 
Seat 6: Sergey_Bolos ($31.49 in chips) 
wesa280: posts small blind $0.05
3EBC96: posts big blind $0.10
*** HOLE CARDS ***
gprobro: folds 
Sergey_Bolos: raises $0.15 to $0.25
lucima10: folds 
wesa280: calls $0.20
3EBC96: calls $0.15
*** FLOP *** [5c Ks 3h]
wesa280: checks 
3EBC96: bets $0.40
Sergey_Bolos: folds 
wesa280: calls $0.40
*** TURN *** [5c Ks 3h] [8d]
wesa280: checks 
3EBC96: bets $1.20
wesa280: folds 
Uncalled bet ($1.20) returned to 3EBC96
3EBC96 collected $1.48 from pot
Assetgasse was removed from the table for failing to post
Assetgasse leaves the table
3EBC96: doesn't show hand 
*** SUMMARY ***
Total pot $1.55 | Rake $0.07 
Board [5c Ks 3h 8d]
Seat 1: lucima10 (button) folded before Flop (didn't bet)
Seat 2: wesa280 (small blind) folded on the Turn
Seat 4: 3EBC96 (big blind) collected ($1.48)
Seat 5: gprobro folded before Flop (didn't bet)
Seat 6: Sergey_Bolos folded on the Flop



PokerStars Hand #222949531838:  Hold'em No Limit ($0.05/$0.10 USD) - 2021/01/23 5:21:11 ET
Table 'Polydoros II' 6-max Seat #2 is the button
Seat 1: lucima10 ($12.97 in chips) 
Seat 2: wesa280 ($8.34 in chips) 
Seat 4: 3EBC96 ($10.83 in chips) 
Seat 5: gprobro ($7.91 in chips) 
Seat 6: Sergey_Bolos ($31.24 in chips) 
3EBC96: posts small blind $0.05
gprobro: posts big blind $0.10
*** HOLE CARDS ***
Sergey_Bolos: folds 
hornetsvp joins the table at seat #3 
lucima10: folds 
wesa280: folds 
3EBC96: folds 
Uncalled bet ($0.05) returned to gprobro
gprobro collected $0.10 from pot
*** SUMMARY ***
Total pot $0.10 | Rake $0 
Seat 1: lucima10 folded before Flop (didn't bet)
Seat 2: wesa280 (button) folded before Flop (didn't bet)
Seat 4: 3EBC96 (small blind) folded before Flop
Seat 5: gprobro (big blind) collected ($0.10)
Seat 6: Sergey_Bolos folded before Flop (didn't bet)



PokerStars Hand #222949538380:  Hold'em No Limit ($0.05/$0.10 USD) - 2021/01/23 5:21:33 ET
Table 'Polydoros II' 6-max Seat #4 is the button
Seat 1: lucima10 ($12.97 in chips) 
Seat 2: wesa280 ($8.34 in chips) 
Seat 4: 3EBC96 ($10.78 in chips) 
Seat 5: gprobro ($7.96 in chips) 
Seat 6: Sergey_Bolos ($31.24 in chips) 
gprobro: posts small blind $0.05
Sergey_Bolos: posts big blind $0.10
hornetsvp: sits out 
*** HOLE CARDS ***
lucima10: folds 
wesa280: calls $0.10
3EBC96: raises $0.40 to $0.50
gprobro: folds 
Sergey_Bolos: folds 
wesa280: raises $0.40 to $0.90
3EBC96: calls $0.40
*** FLOP *** [Jd 2d Ts]
wesa280: bets $1
3EBC96: calls $1
*** TURN *** [Jd 2d Ts] [5h]
wesa280: checks 
3EBC96: bets $1.89
wesa280: raises $4.55 to $6.44 and is all-in
3EBC96: calls $4.55
*** RIVER *** [Jd 2d Ts 5h] [9s]
*** SHOW DOWN ***
wesa280: shows [Ks Kd] (a pair of Kings)
3EBC96: shows [Jc Kc] (a pair of Jacks)
wesa280 collected $16.07 from pot
*** SUMMARY ***
Total pot $16.83 | Rake $0.76 
Board [Jd 2d Ts 5h 9s]
Seat 1: lucima10 folded before Flop (didn't bet)
Seat 2: wesa280 showed [Ks Kd] and won ($16.07) with a pair of Kings
Seat 4: 3EBC96 (button) showed [Jc Kc] and lost with a pair of Jacks
Seat 5: gprobro (small blind) folded before Flop
Seat 6: Sergey_Bolos (big blind) folded before Flop



PokerStars Hand #222949563368:  Hold'em No Limit ($0.05/$0.10 USD) - 2021/01/23 5:22:56 ET
Table 'Polydoros II' 6-max Seat #5 is the button
Seat 1: lucima10 ($12.97 in chips) 
Seat 2: wesa280 ($16.07 in chips) 
Seat 4: 3EBC96 ($10 in chips) 
Seat 5: gprobro ($7.91 in chips) 
Seat 6: Sergey_Bolos ($31.14 in chips) 
Sergey_Bolos: posts small blind $0.05
lucima10: posts big blind $0.10
hornetsvp: sits out 
*** HOLE CARDS ***
wesa280 has timed out
wesa280: folds 
3EBC96: raises $0.20 to $0.30
gprobro: folds 
Sergey_Bolos: raises $0.90 to $1.20
lucima10: folds 
3EBC96: calls $0.90
*** FLOP *** [3d As 5s]
Sergey_Bolos: bets $1.60
3EBC96: calls $1.60
*** TURN *** [3d As 5s] [5h]
Sergey_Bolos: checks 
3EBC96: bets $2.72
Sergey_Bolos: raises $10.73 to $13.45
3EBC96: folds 
Uncalled bet ($10.73) returned to Sergey_Bolos
Sergey_Bolos collected $10.64 from pot
Sergey_Bolos: doesn't show hand 
*** SUMMARY ***
Total pot $11.14 | Rake $0.50 
Board [3d As 5s 5h]
Seat 1: lucima10 (big blind) folded before Flop
Seat 2: wesa280 folded before Flop (didn't bet)
Seat 4: 3EBC96 folded on the Turn
Seat 5: gprobro (button) folded before Flop (didn't bet)
Seat 6: Sergey_Bolos (small blind) collected ($10.64)



PokerStars Hand #222949585010:  Hold'em No Limit ($0.05/$0.10 USD) - 2021/01/23 5:24:07 ET
Table 'Polydoros II' 6-max Seat #6 is the button
Seat 1: lucima10 ($12.87 in chips) 
Seat 2: wesa280 ($16.07 in chips) 
Seat 4: 3EBC96 ($10 in chips) 
Seat 5: gprobro ($7.91 in chips) 
Seat 6: Sergey_Bolos ($36.26 in chips) 
lucima10: posts small blind $0.05
wesa280: posts big blind $0.10
hornetsvp: sits out 
*** HOLE CARDS ***
3EBC96: folds 
gprobro: folds 
Sergey_Bolos: folds 
lucima10: raises $0.20 to $0.30
wesa280: calls $0.20
*** FLOP *** [Qs Kd Jh]
lucima10: bets $0.40
wesa280: folds 
Uncalled bet ($0.40) returned to lucima10
lucima10 collected $0.57 from pot
lucima10: doesn't show hand 
*** SUMMARY ***
Total pot $0.60 | Rake $0.03 
Board [Qs Kd Jh]
Seat 1: lucima10 (small blind) collected ($0.57)
Seat 2: wesa280 (big blind) folded on the Flop
Seat 4: 3EBC96 folded before Flop (didn't bet)
Seat 5: gprobro folded before Flop (didn't bet)
Seat 6: Sergey_Bolos (button) folded before Flop (didn't bet)



PokerStars Hand #222949590459:  Hold'em No Limit ($0.05/$0.10 USD) - 2021/01/23 5:24:25 ET
Table 'Polydoros II' 6-max Seat #1 is the button
Seat 1: lucima10 ($13.14 in chips) 
Seat 2: wesa280 ($15.77 in chips) 
Seat 3: hornetsvp ($10 in chips) 
Seat 4: 3EBC96 ($10 in chips) 
Seat 5: gprobro ($7.91 in chips) 
Seat 6: Sergey_Bolos ($36.26 in chips) 
wesa280: posts small blind $0.05
hornetsvp: posts big blind $0.10
*** HOLE CARDS ***
3EBC96: folds 
gprobro: folds 
Sergey_Bolos: folds 
lucima10: raises $0.15 to $0.25
wesa280: calls $0.20
hornetsvp: folds 
*** FLOP *** [9c 8s 8c]
wesa280: checks 
lucima10: checks 
*** TURN *** [9c 8s 8c] [2s]
wesa280: bets $0.10
lucima10: folds 
Uncalled bet ($0.10) returned to wesa280
wesa280 collected $0.57 from pot
wesa280: doesn't show hand 
*** SUMMARY ***
Total pot $0.60 | Rake $0.03 
Board [9c 8s 8c 2s]
Seat 1: lucima10 (button) folded on the Turn
Seat 2: wesa280 (small blind) collected ($0.57)
Seat 3: hornetsvp (big blind) folded before Flop
Seat 4: 3EBC96 folded before Flop (didn't bet)
Seat 5: gprobro folded before Flop (didn't bet)
Seat 6: Sergey_Bolos folded before Flop (didn't bet)



PokerStars Hand #222949600830:  Hold'em No Limit ($0.05/$0.10 USD) - 2021/01/23 5:24:59 ET
Table 'Polydoros II' 6-max Seat #2 is the button
Seat 1: lucima10 ($12.89 in chips) 
Seat 2: wesa280 ($16.09 in chips) 
Seat 3: hornetsvp ($9.90 in chips) 
Seat 4: 3EBC96 ($10 in chips) 
Seat 5: gprobro ($7.91 in chips) 
Seat 6: Sergey_Bolos ($36.26 in chips) 
hornetsvp: posts small blind $0.05
3EBC96: posts big blind $0.10
*** HOLE CARDS ***
gprobro: calls $0.10
Sergey_Bolos: folds 
lucima10: raises $0.20 to $0.30
wesa280: folds 
hornetsvp: folds 
3EBC96: calls $0.20
gprobro: calls $0.20
*** FLOP *** [2s 2c 5h]
3EBC96: checks 
gprobro: checks 
lucima10: bets $0.30
3EBC96: folds 
gprobro: calls $0.30
*** TURN *** [2s 2c 5h] [9h]
gprobro: checks 
lucima10: bets $1.11
gprobro: folds 
Uncalled bet ($1.11) returned to lucima10
lucima10 collected $1.48 from pot
lucima10: doesn't show hand 
*** SUMMARY ***
Total pot $1.55 | Rake $0.07 
Board [2s 2c 5h 9h]
Seat 1: lucima10 collected ($1.48)
Seat 2: wesa280 (button) folded before Flop (didn't bet)
Seat 3: hornetsvp (small blind) folded before Flop
Seat 4: 3EBC96 (big blind) folded on the Flop
Seat 5: gprobro folded on the Turn
Seat 6: Sergey_Bolos folded before Flop (didn't bet)



PokerStars Hand #222949612748:  Hold'em No Limit ($0.05/$0.10 USD) - 2021/01/23 5:25:38 ET
Table 'Polydoros II' 6-max Seat #3 is the button
Seat 1: lucima10 ($13.77 in chips) 
Seat 2: wesa280 ($16.09 in chips) 
Seat 3: hornetsvp ($9.85 in chips) 
Seat 4: 3EBC96 ($10 in chips) 
Seat 5: gprobro ($7.31 in chips) 
Seat 6: Sergey_Bolos ($36.26 in chips) 
3EBC96: posts small blind $0.05
gprobro: posts big blind $0.10
*** HOLE CARDS ***
Sergey_Bolos: folds 
lucima10: folds 
wesa280: calls $0.10
hornetsvp: folds 
3EBC96: folds 
gprobro: checks 
*** FLOP *** [4d 6d Qc]
gprobro: bets $0.24
wesa280: calls $0.24
*** TURN *** [4d 6d Qc] [Jd]
gprobro: bets $0.70
wesa280: calls $0.70
*** RIVER *** [4d 6d Qc Jd] [4h]
gprobro: bets $2.03
wesa280: raises $2.03 to $4.06
gprobro: calls $2.03
*** SHOW DOWN ***
wesa280: shows [Js Qd] (two pair, Queens and Jacks)
gprobro: shows [Td 9d] (a flush, Jack high)
gprobro collected $9.79 from pot
*** SUMMARY ***
Total pot $10.25 | Rake $0.46 
Board [4d 6d Qc Jd 4h]
Seat 1: lucima10 folded before Flop (didn't bet)
Seat 2: wesa280 showed [Js Qd] and lost with two pair, Queens and Jacks
Seat 3: hornetsvp (button) folded before Flop (didn't bet)
Seat 4: 3EBC96 (small blind) folded before Flop
Seat 5: gprobro (big blind) showed [Td 9d] and won ($9.79) with a flush, Jack high
Seat 6: Sergey_Bolos folded before Flop (didn't bet)



PokerStars Hand #222949625537:  Hold'em No Limit ($0.05/$0.10 USD) - 2021/01/23 5:26:20 ET
Table 'Polydoros II' 6-max Seat #4 is the button
Seat 1: lucima10 ($13.77 in chips) 
Seat 2: wesa280 ($10.99 in chips) 
Seat 3: hornetsvp ($9.85 in chips) 
Seat 4: 3EBC96 ($10 in chips) 
Seat 5: gprobro ($12 in chips) 
Seat 6: Sergey_Bolos ($36.26 in chips) 
gprobro: posts small blind $0.05
Sergey_Bolos: posts big blind $0.10
*** HOLE CARDS ***
lucima10: folds 
wesa280: calls $0.10
hornetsvp: folds 
3EBC96: folds 
gprobro: calls $0.05
Sergey_Bolos: checks 
*** FLOP *** [Ks Jd 5s]
gprobro: checks 
Sergey_Bolos: checks 
wesa280: checks 
*** TURN *** [Ks Jd 5s] [5h]
gprobro: bets $0.20
Sergey_Bolos: folds 
wesa280: calls $0.20
*** RIVER *** [Ks Jd 5s 5h] [9h]
gprobro: bets $0.20
wesa280: raises $0.20 to $0.40
gprobro: folds 
Uncalled bet ($0.20) returned to wesa280
wesa280 collected $1.05 from pot
wesa280: doesn't show hand 
*** SUMMARY ***
Total pot $1.10 | Rake $0.05 
Board [Ks Jd 5s 5h 9h]
Seat 1: lucima10 folded before Flop (didn't bet)
Seat 2: wesa280 collected ($1.05)
Seat 3: hornetsvp folded before Flop (didn't bet)
Seat 4: 3EBC96 (button) folded before Flop (didn't bet)
Seat 5: gprobro (small blind) folded on the River
Seat 6: Sergey_Bolos (big blind) folded on the Turn



PokerStars Hand #222949637106:  Hold'em No Limit ($0.05/$0.10 USD) - 2021/01/23 5:26:58 ET
Table 'Polydoros II' 6-max Seat #5 is the button
Seat 1: lucima10 ($13.77 in chips) 
Seat 2: wesa280 ($11.54 in chips) 
Seat 3: hornetsvp ($9.85 in chips) 
Seat 4: 3EBC96 ($10 in chips) 
Seat 5: gprobro ($11.50 in chips) 
Seat 6: Sergey_Bolos ($36.16 in chips) 
Sergey_Bolos: posts small blind $0.05
lucima10: posts big blind $0.10
*** HOLE CARDS ***
wesa280: calls $0.10
hornetsvp: folds 
3EBC96: folds 
gprobro: calls $0.10
Sergey_Bolos: calls $0.05
lucima10: raises $0.70 to $0.80
wesa280: folds 
gprobro: calls $0.70
Sergey_Bolos: folds 
*** FLOP *** [Ac 2d 2c]
lucima10: bets $0.80
gprobro: calls $0.80
*** TURN *** [Ac 2d 2c] [Ts]
lucima10: bets $0.90
gprobro: raises $0.90 to $1.80
lucima10: calls $0.90
*** RIVER *** [Ac 2d 2c Ts] [8c]
lucima10: checks 
gprobro: bets $6.68
lucima10: folds 
Uncalled bet ($6.68) returned to gprobro
gprobro collected $6.68 from pot
*** SUMMARY ***
Total pot $7 | Rake $0.32 
Board [Ac 2d 2c Ts 8c]
Seat 1: lucima10 (big blind) folded on the River
Seat 2: wesa280 folded before Flop
Seat 3: hornetsvp folded before Flop (didn't bet)
Seat 4: 3EBC96 folded before Flop (didn't bet)
Seat 5: gprobro (button) collected ($6.68)
Seat 6: Sergey_Bolos (small blind) folded before Flop



PokerStars Hand #222949649056:  Hold'em No Limit ($0.05/$0.10 USD) - 2021/01/23 5:27:38 ET
Table 'Polydoros II' 6-max Seat #6 is the button
Seat 1: lucima10 ($10.37 in chips) 
Seat 2: wesa280 ($11.44 in chips) 
Seat 3: hornetsvp ($9.85 in chips) 
Seat 4: 3EBC96 ($10 in chips) 
Seat 5: gprobro ($14.78 in chips) 
Seat 6: Sergey_Bolos ($36.06 in chips) 
lucima10: posts small blind $0.05
wesa280: posts big blind $0.10
*** HOLE CARDS ***
hornetsvp: folds 
3EBC96: raises $0.20 to $0.30
gprobro: calls $0.30
Sergey_Bolos: folds 
lucima10: folds 
wesa280: calls $0.20
*** FLOP *** [3h Kc Kd]
wesa280: checks 
3EBC96: checks 
gprobro: checks 
*** TURN *** [3h Kc Kd] [7d]
wesa280: checks 
3EBC96: checks 
gprobro: bets $0.30
wesa280: calls $0.30
3EBC96: calls $0.30
*** RIVER *** [3h Kc Kd 7d] [2s]
wesa280: bets $0.10
3EBC96: calls $0.10
gprobro: calls $0.10
*** SHOW DOWN ***
wesa280: shows [As 3d] (two pair, Kings and Threes)
3EBC96: shows [Qc Qs] (two pair, Kings and Queens)
gprobro: mucks hand 
3EBC96 collected $2.05 from pot
*** SUMMARY ***
Total pot $2.15 | Rake $0.10 
Board [3h Kc Kd 7d 2s]
Seat 1: lucima10 (small blind) folded before Flop
Seat 2: wesa280 (big blind) showed [As 3d] and lost with two pair, Kings and Threes
Seat 3: hornetsvp folded before Flop (didn't bet)
Seat 4: 3EBC96 showed [Qc Qs] and won ($2.05) with two pair, Kings and Queens
Seat 5: gprobro mucked
Seat 6: Sergey_Bolos (button) folded before Flop (didn't bet)



PokerStars Hand #222949666479:  Hold'em No Limit ($0.05/$0.10 USD) - 2021/01/23 5:28:35 ET
Table 'Polydoros II' 6-max Seat #1 is the button
Seat 1: lucima10 ($10.32 in chips) 
Seat 2: wesa280 ($10.74 in chips) 
Seat 3: hornetsvp ($10 in chips) 
Seat 4: 3EBC96 ($11.35 in chips) 
Seat 5: gprobro ($14.08 in chips) 
Seat 6: Sergey_Bolos ($36.06 in chips) 
wesa280: posts small blind $0.05
hornetsvp: posts big blind $0.10
*** HOLE CARDS ***
3EBC96: folds 
gprobro: folds 
Sergey_Bolos: raises $0.15 to $0.25
lucima10: calls $0.25
wesa280: calls $0.20
hornetsvp: folds 
*** FLOP *** [7h 9s Ah]
wesa280: checks 
Sergey_Bolos: bets $0.69
lucima10: folds 
wesa280: folds 
Uncalled bet ($0.69) returned to Sergey_Bolos
Sergey_Bolos collected $0.81 from pot
Sergey_Bolos: doesn't show hand 
*** SUMMARY ***
Total pot $0.85 | Rake $0.04 
Board [7h 9s Ah]
Seat 1: lucima10 (button) folded on the Flop
Seat 2: wesa280 (small blind) folded on the Flop
Seat 3: hornetsvp (big blind) folded before Flop
Seat 4: 3EBC96 folded before Flop (didn't bet)
Seat 5: gprobro folded before Flop (didn't bet)
Seat 6: Sergey_Bolos collected ($0.81)



PokerStars Hand #222949673355:  Hold'em No Limit ($0.05/$0.10 USD) - 2021/01/23 5:28:57 ET
Table 'Polydoros II' 6-max Seat #2 is the button
Seat 1: lucima10 ($10.07 in chips) 
Seat 2: wesa280 ($10.49 in chips) 
Seat 3: hornetsvp ($9.90 in chips) 
Seat 4: 3EBC96 ($11.35 in chips) 
Seat 5: gprobro ($14.08 in chips) 
Seat 6: Sergey_Bolos ($36.62 in chips) 
hornetsvp: posts small blind $0.05
3EBC96: posts big blind $0.10
*** HOLE CARDS ***
gprobro: calls $0.10
Sergey_Bolos: raises $0.15 to $0.25
lucima10: folds 
wesa280: folds 
hornetsvp: folds 
3EBC96: calls $0.15
gprobro: calls $0.15
*** FLOP *** [8d 8s 6s]
3EBC96: checks 
gprobro: checks 
Sergey_Bolos: checks 
*** TURN *** [8d 8s 6s] [Ad]
3EBC96: checks 
gprobro: checks 
Sergey_Bolos: bets $0.65
3EBC96: folds 
gprobro: folds 
Uncalled bet ($0.65) returned to Sergey_Bolos
Sergey_Bolos collected $0.76 from pot
Sergey_Bolos: doesn't show hand 
*** SUMMARY ***
Total pot $0.80 | Rake $0.04 
Board [8d 8s 6s Ad]
Seat 1: lucima10 folded before Flop (didn't bet)
Seat 2: wesa280 (button) folded before Flop (didn't bet)
Seat 3: hornetsvp (small blind) folded before Flop
Seat 4: 3EBC96 (big blind) folded on the Turn
Seat 5: gprobro folded on the Turn
Seat 6: Sergey_Bolos collected ($0.76)



PokerStars Hand #222949684647:  Hold'em No Limit ($0.05/$0.10 USD) - 2021/01/23 5:29:34 ET
Table 'Polydoros II' 6-max Seat #3 is the button
Seat 1: lucima10 ($10.07 in chips) 
Seat 2: wesa280 ($10.49 in chips) 
Seat 3: hornetsvp ($9.85 in chips) 
Seat 4: 3EBC96 ($11.10 in chips) 
Seat 5: gprobro ($13.83 in chips) 
Seat 6: Sergey_Bolos ($37.13 in chips) 
3EBC96: posts small blind $0.05
gprobro: posts big blind $0.10
*** HOLE CARDS ***
Sergey_Bolos: folds 
lucima10: folds 
wesa280: calls $0.10
hornetsvp: folds 
3EBC96: folds 
gprobro: checks 
*** FLOP *** [Qd 9c 7d]
gprobro: checks 
wesa280: checks 
*** TURN *** [Qd 9c 7d] [Qs]
gprobro: bets $0.30
wesa280: folds 
Uncalled bet ($0.30) returned to gprobro
gprobro collected $0.24 from pot
*** SUMMARY ***
Total pot $0.25 | Rake $0.01 
Board [Qd 9c 7d Qs]
Seat 1: lucima10 folded before Flop (didn't bet)
Seat 2: wesa280 folded on the Turn
Seat 3: hornetsvp (button) folded before Flop (didn't bet)
Seat 4: 3EBC96 (small blind) folded before Flop
Seat 5: gprobro (big blind) collected ($0.24)
Seat 6: Sergey_Bolos folded before Flop (didn't bet)



PokerStars Hand #222949692714:  Hold'em No Limit ($0.05/$0.10 USD) - 2021/01/23 5:30:01 ET
Table 'Polydoros II' 6-max Seat #4 is the button
Seat 1: lucima10 ($10.07 in chips) 
Seat 2: wesa280 ($10.39 in chips) 
Seat 3: hornetsvp ($9.85 in chips) 
Seat 4: 3EBC96 ($11.05 in chips) 
Seat 5: gprobro ($13.97 in chips) 
Seat 6: Sergey_Bolos ($37.13 in chips) 
gprobro: posts small blind $0.05
Sergey_Bolos: posts big blind $0.10
*** HOLE CARDS ***
lucima10: raises $0.20 to $0.30
wesa280: folds 
hornetsvp: folds 
3EBC96: folds 
gprobro: calls $0.25
Sergey_Bolos: calls $0.20
*** FLOP *** [Qh Qd 2c]
gprobro: checks 
Sergey_Bolos: checks 
lucima10: checks 
*** TURN *** [Qh Qd 2c] [Qc]
gprobro: checks 
Sergey_Bolos: bets $0.39
lucima10: folds 
gprobro: folds 
Uncalled bet ($0.39) returned to Sergey_Bolos
Sergey_Bolos collected $0.86 from pot
Sergey_Bolos: doesn't show hand 
*** SUMMARY ***
Total pot $0.90 | Rake $0.04 
Board [Qh Qd 2c Qc]
Seat 1: lucima10 folded on the Turn
Seat 2: wesa280 folded before Flop (didn't bet)
Seat 3: hornetsvp folded before Flop (didn't bet)
Seat 4: 3EBC96 (button) folded before Flop (didn't bet)
Seat 5: gprobro (small blind) folded on the Turn
Seat 6: Sergey_Bolos (big blind) collected ($0.86)



PokerStars Hand #222949701772:  Hold'em No Limit ($0.05/$0.10 USD) - 2021/01/23 5:30:31 ET
Table 'Polydoros II' 6-max Seat #5 is the button
Seat 1: lucima10 ($10 in chips) 
Seat 2: wesa280 ($10.39 in chips) 
Seat 3: hornetsvp ($10 in chips) 
Seat 4: 3EBC96 ($11.05 in chips) 
Seat 5: gprobro ($13.67 in chips) 
Seat 6: Sergey_Bolos ($37.69 in chips) 
Sergey_Bolos: posts small blind $0.05
lucima10: posts big blind $0.10
*** HOLE CARDS ***
wesa280: calls $0.10
hornetsvp: folds 
3EBC96: raises $0.40 to $0.50
gprobro: folds 
Sergey_Bolos: folds 
lucima10: calls $0.40
wesa280: calls $0.40
*** FLOP *** [4s Jd 2h]
lucima10: checks 
wesa280: checks 
3EBC96: checks 
*** TURN *** [4s Jd 2h] [3c]
lucima10: checks 
wesa280: checks 
3EBC96: checks 
*** RIVER *** [4s Jd 2h 3c] [8d]
lucima10: checks 
wesa280: bets $0.10
3EBC96: calls $0.10
lucima10: calls $0.10
*** SHOW DOWN ***
wesa280: shows [7s 5s] (high card Jack)
3EBC96: shows [Ah Kc] (high card Ace)
lucima10: shows [3h Kh] (a pair of Threes)
lucima10 collected $1.77 from pot
*** SUMMARY ***
Total pot $1.85 | Rake $0.08 
Board [4s Jd 2h 3c 8d]
Seat 1: lucima10 (big blind) showed [3h Kh] and won ($1.77) with a pair of Threes
Seat 2: wesa280 showed [7s 5s] and lost with high card Jack
Seat 3: hornetsvp folded before Flop (didn't bet)
Seat 4: 3EBC96 showed [Ah Kc] and lost with high card Ace
Seat 5: gprobro (button) folded before Flop (didn't bet)
Seat 6: Sergey_Bolos (small blind) folded before Flop



PokerStars Hand #222949715570:  Hold'em No Limit ($0.05/$0.10 USD) - 2021/01/23 5:31:15 ET
Table 'Polydoros II' 6-max Seat #6 is the button
Seat 1: lucima10 ($11.17 in chips) 
Seat 2: wesa280 ($9.79 in chips) 
Seat 3: hornetsvp ($10 in chips) 
Seat 4: 3EBC96 ($10.45 in chips) 
Seat 5: gprobro ($13.67 in chips) 
Seat 6: Sergey_Bolos ($37.64 in chips) 
lucima10: posts small blind $0.05
wesa280: posts big blind $0.10
*** HOLE CARDS ***
hornetsvp: folds 
3EBC96: folds 
gprobro has timed out
gprobro: folds 
Sergey_Bolos: raises $0.15 to $0.25
lucima10: folds 
wesa280: calls $0.15
*** FLOP *** [Jc 7c Jh]
wesa280: bets $0.10
Sergey_Bolos: calls $0.10
*** TURN *** [Jc 7c Jh] [5c]
wesa280: bets $0.10
Sergey_Bolos: folds 
Uncalled bet ($0.10) returned to wesa280
wesa280 collected $0.72 from pot
wesa280: doesn't show hand 
*** SUMMARY ***
Total pot $0.75 | Rake $0.03 
Board [Jc 7c Jh 5c]
Seat 1: lucima10 (small blind) folded before Flop
Seat 2: wesa280 (big blind) collected ($0.72)
Seat 3: hornetsvp folded before Flop (didn't bet)
Seat 4: 3EBC96 folded before Flop (didn't bet)
Seat 5: gprobro folded before Flop (didn't bet)
Seat 6: Sergey_Bolos (button) folded on the Turn



PokerStars Hand #222949730263:  Hold'em No Limit ($0.05/$0.10 USD) - 2021/01/23 5:32:03 ET
Table 'Polydoros II' 6-max Seat #1 is the button
Seat 1: lucima10 ($11.12 in chips) 
Seat 2: wesa280 ($10.16 in chips) 
Seat 3: hornetsvp ($10 in chips) 
Seat 4: 3EBC96 ($10.45 in chips) 
Seat 5: gprobro ($13.67 in chips) 
Seat 6: Sergey_Bolos ($37.29 in chips) 
wesa280: posts small blind $0.05
hornetsvp: posts big blind $0.10
*** HOLE CARDS ***
3EBC96: folds 
gprobro: calls $0.10
Sergey_Bolos: folds 
lucima10: folds 
wesa280: calls $0.05
hornetsvp: checks 
*** FLOP *** [Td 3h 2c]
wesa280: bets $0.10
hornetsvp: folds 
gprobro: folds 
Uncalled bet ($0.10) returned to wesa280
wesa280 collected $0.29 from pot
wesa280: doesn't show hand 
*** SUMMARY ***
Total pot $0.30 | Rake $0.01 
Board [Td 3h 2c]
Seat 1: lucima10 (button) folded before Flop (didn't bet)
Seat 2: wesa280 (small blind) collected ($0.29)
Seat 3: hornetsvp (big blind) folded on the Flop
Seat 4: 3EBC96 folded before Flop (didn't bet)
Seat 5: gprobro folded on the Flop
Seat 6: Sergey_Bolos folded before Flop (didn't bet)



PokerStars Hand #222949736508:  Hold'em No Limit ($0.05/$0.10 USD) - 2021/01/23 5:32:23 ET
Table 'Polydoros II' 6-max Seat #2 is the button
Seat 1: lucima10 ($11.12 in chips) 
Seat 2: wesa280 ($10.35 in chips) 
Seat 3: hornetsvp ($9.90 in chips) 
Seat 4: 3EBC96 ($10.45 in chips) 
Seat 5: gprobro ($13.57 in chips) 
Seat 6: Sergey_Bolos ($37.29 in chips) 
hornetsvp: posts small blind $0.05
3EBC96: posts big blind $0.10
*** HOLE CARDS ***
gprobro: folds 
Sergey_Bolos: raises $0.15 to $0.25
lucima10: folds 
wesa280: raises $0.15 to $0.40
hornetsvp: folds 
3EBC96: folds 
Sergey_Bolos: raises $1.20 to $1.60
wesa280: calls $1.20
*** FLOP *** [Ah 4s As]
Sergey_Bolos: bets $1.09
wesa280: raises $1.09 to $2.18
Sergey_Bolos: raises $33.51 to $35.69 and is all-in
wesa280: calls $6.57 and is all-in
Uncalled bet ($26.94) returned to Sergey_Bolos
*** TURN *** [Ah 4s As] [9s]
*** RIVER *** [Ah 4s As 9s] [Jd]
*** SHOW DOWN ***
Sergey_Bolos: shows [Ad Kh] (three of a kind, Aces)
wesa280: shows [Ks Ac] (three of a kind, Aces)
Sergey_Bolos collected $9.96 from pot
wesa280 collected $9.95 from pot
*** SUMMARY ***
Total pot $20.85 | Rake $0.94 
Board [Ah 4s As 9s Jd]
Seat 1: lucima10 folded before Flop (didn't bet)
Seat 2: wesa280 (button) showed [Ks Ac] and won ($9.95) with three of a kind, Aces
Seat 3: hornetsvp (small blind) folded before Flop
Seat 4: 3EBC96 (big blind) folded before Flop
Seat 5: gprobro folded before Flop (didn't bet)
Seat 6: Sergey_Bolos showed [Ad Kh] and won ($9.96) with three of a kind, Aces



PokerStars Hand #222949754115:  Hold'em No Limit ($0.05/$0.10 USD) - 2021/01/23 5:33:20 ET
Table 'Polydoros II' 6-max Seat #3 is the button
Seat 1: lucima10 ($11.12 in chips) 
Seat 2: wesa280 ($9.95 in chips) 
Seat 3: hornetsvp ($10 in chips) 
Seat 4: 3EBC96 ($10.35 in chips) 
Seat 5: gprobro ($13.57 in chips) 
Seat 6: Sergey_Bolos ($36.90 in chips) 
3EBC96: posts small blind $0.05
gprobro: posts big blind $0.10
*** HOLE CARDS ***
Sergey_Bolos: raises $0.15 to $0.25
lucima10: raises $0.75 to $1
wesa280: folds 
hornetsvp: folds 
3EBC96: folds 
gprobro: folds 
Sergey_Bolos: calls $0.75
*** FLOP *** [Js 7h 5c]
Sergey_Bolos: checks 
lucima10: bets $1.10
Sergey_Bolos: calls $1.10
*** TURN *** [Js 7h 5c] [Ac]
Sergey_Bolos: checks 
lucima10: bets $1.80
Sergey_Bolos: folds 
Uncalled bet ($1.80) returned to lucima10
lucima10 collected $4.15 from pot
lucima10: doesn't show hand 
*** SUMMARY ***
Total pot $4.35 | Rake $0.20 
Board [Js 7h 5c Ac]
Seat 1: lucima10 collected ($4.15)
Seat 2: wesa280 folded before Flop (didn't bet)
Seat 3: hornetsvp (button) folded before Flop (didn't bet)
Seat 4: 3EBC96 (small blind) folded before Flop
Seat 5: gprobro (big blind) folded before Flop
Seat 6: Sergey_Bolos folded on the Turn



PokerStars Hand #222949767460:  Hold'em No Limit ($0.05/$0.10 USD) - 2021/01/23 5:34:03 ET
Table 'Polydoros II' 6-max Seat #4 is the button
Seat 1: lucima10 ($13.17 in chips) 
Seat 2: wesa280 ($9.95 in chips) 
Seat 3: hornetsvp ($10 in chips) 
Seat 4: 3EBC96 ($10.30 in chips) 
Seat 5: gprobro ($13.47 in chips) 
Seat 6: Sergey_Bolos ($34.80 in chips) 
gprobro: posts small blind $0.05
Sergey_Bolos: posts big blind $0.10
*** HOLE CARDS ***
lucima10: folds 
wesa280: calls $0.10
hornetsvp: folds 
3EBC96: folds 
gprobro: calls $0.05
Sergey_Bolos: checks 
*** FLOP *** [Qd 6d As]
gprobro: checks 
Sergey_Bolos: bets $0.25
wesa280: calls $0.25
gprobro: calls $0.25
*** TURN *** [Qd 6d As] [7d]
gprobro: checks 
Sergey_Bolos: checks 
wesa280: bets $0.10
gprobro: calls $0.10
Sergey_Bolos: raises $0.87 to $0.97
wesa280: calls $0.87
gprobro: calls $0.87
*** RIVER *** [Qd 6d As 7d] [4s]
gprobro: checks 
Sergey_Bolos: bets $3.21
wesa280: folds 
gprobro: folds 
Uncalled bet ($3.21) returned to Sergey_Bolos
Sergey_Bolos collected $3.78 from pot
Sergey_Bolos: doesn't show hand 
*** SUMMARY ***
Total pot $3.96 | Rake $0.18 
Board [Qd 6d As 7d 4s]
Seat 1: lucima10 folded before Flop (didn't bet)
Seat 2: wesa280 folded on the River
Seat 3: hornetsvp folded before Flop (didn't bet)
Seat 4: 3EBC96 (button) folded before Flop (didn't bet)
Seat 5: gprobro (small blind) folded on the River
Seat 6: Sergey_Bolos (big blind) collected ($3.78)



PokerStars Hand #222949789325:  Hold'em No Limit ($0.05/$0.10 USD) - 2021/01/23 5:35:13 ET
Table 'Polydoros II' 6-max Seat #5 is the button
Seat 2: wesa280 ($8.63 in chips) 
Seat 3: hornetsvp ($10 in chips) 
Seat 4: 3EBC96 ($10.30 in chips) 
Seat 5: gprobro ($12.15 in chips) 
Seat 6: Sergey_Bolos ($37.26 in chips) 
Sergey_Bolos: posts small blind $0.05
lucima10: is sitting out 
wesa280: posts big blind $0.10
*** HOLE CARDS ***
lucima10 leaves the table
hornetsvp: raises $0.15 to $0.25
3EBC96: folds 
gprobro: calls $0.25
Sergey_Bolos: calls $0.20
wesa280: calls $0.15
*** FLOP *** [Th 4d 5c]
Sergey_Bolos: checks 
wesa280: checks 
hornetsvp: checks 
gprobro: checks 
*** TURN *** [Th 4d 5c] [6c]
Sergey_Bolos: checks 
wesa280: bets $0.10
hornetsvp: folds 
gprobro: folds 
Sergey_Bolos: folds 
Uncalled bet ($0.10) returned to wesa280
wesa280 collected $0.96 from pot
wesa280: doesn't show hand 
*** SUMMARY ***
Total pot $1 | Rake $0.04 
Board [Th 4d 5c 6c]
Seat 2: wesa280 (big blind) collected ($0.96)
Seat 3: hornetsvp folded on the Turn
Seat 4: 3EBC96 folded before Flop (didn't bet)
Seat 5: gprobro (button) folded on the Turn
Seat 6: Sergey_Bolos (small blind) folded on the Turn



PokerStars Hand #222949800787:  Hold'em No Limit ($0.05/$0.10 USD) - 2021/01/23 5:35:50 ET
Table 'Polydoros II' 6-max Seat #6 is the button
Seat 2: wesa280 ($9.34 in chips) 
Seat 3: hornetsvp ($10 in chips) 
Seat 4: 3EBC96 ($10.30 in chips) 
Seat 5: gprobro ($11.90 in chips) 
Seat 6: Sergey_Bolos ($37.01 in chips) 
wesa280: posts small blind $0.05
hornetsvp: posts big blind $0.10
*** HOLE CARDS ***
3EBC96: folds 
gprobro: calls $0.10
Sergey_Bolos: folds 
wesa280: folds 
hornetsvp: checks 
*** FLOP *** [8s 9s 4h]
hornetsvp: checks 
gprobro: bets $0.24
hornetsvp: folds 
Uncalled bet ($0.24) returned to gprobro
gprobro collected $0.24 from pot
*** SUMMARY ***
Total pot $0.25 | Rake $0.01 
Board [8s 9s 4h]
Seat 2: wesa280 (small blind) folded before Flop
Seat 3: hornetsvp (big blind) folded on the Flop
Seat 4: 3EBC96 folded before Flop (didn't bet)
Seat 5: gprobro collected ($0.24)
Seat 6: Sergey_Bolos (button) folded before Flop (didn't bet)



PokerStars Hand #222949807520:  Hold'em No Limit ($0.05/$0.10 USD) - 2021/01/23 5:36:11 ET
Table 'Polydoros II' 6-max Seat #2 is the button
Seat 2: wesa280 ($9.29 in chips) 
Seat 3: hornetsvp ($9.90 in chips) 
Seat 4: 3EBC96 ($10.30 in chips) 
Seat 5: gprobro ($12.04 in chips) 
Seat 6: Sergey_Bolos ($37.01 in chips) 
hornetsvp: posts small blind $0.05
3EBC96: posts big blind $0.10
*** HOLE CARDS ***
gprobro: folds 
Sergey_Bolos: folds 
wesa280: calls $0.10
hornetsvp: folds 
3EBC96: checks 
*** FLOP *** [2s Ts 3c]
3EBC96: checks 
wesa280: checks 
*** TURN *** [2s Ts 3c] [7d]
3EBC96: checks 
wesa280: bets $0.10
3EBC96: calls $0.10
*** RIVER *** [2s Ts 3c 7d] [As]
3EBC96: checks 
wesa280: bets $0.10
3EBC96: folds 
Uncalled bet ($0.10) returned to wesa280
wesa280 collected $0.43 from pot
wesa280: doesn't show hand 
*** SUMMARY ***
Total pot $0.45 | Rake $0.02 
Board [2s Ts 3c 7d As]
Seat 2: wesa280 (button) collected ($0.43)
Seat 3: hornetsvp (small blind) folded before Flop
Seat 4: 3EBC96 (big blind) folded on the River
Seat 5: gprobro folded before Flop (didn't bet)
Seat 6: Sergey_Bolos folded before Flop (didn't bet)



PokerStars Hand #222949816318:  Hold'em No Limit ($0.05/$0.10 USD) - 2021/01/23 5:36:39 ET
Table 'Polydoros II' 6-max Seat #3 is the button
Seat 2: wesa280 ($9.52 in chips) 
Seat 3: hornetsvp ($10 in chips) 
Seat 4: 3EBC96 ($10.10 in chips) 
Seat 5: gprobro ($12.04 in chips) 
Seat 6: Sergey_Bolos ($37.01 in chips) 
3EBC96: posts small blind $0.05
gprobro: posts big blind $0.10
*** HOLE CARDS ***
Sergey_Bolos: folds 
wesa280: calls $0.10
hornetsvp: folds 
3EBC96: folds 
gprobro: checks 
*** FLOP *** [Qc 3s 7d]
gprobro: checks 
wesa280: bets $0.10
gprobro: folds 
Uncalled bet ($0.10) returned to wesa280
wesa280 collected $0.24 from pot
wesa280: doesn't show hand 
*** SUMMARY ***
Total pot $0.25 | Rake $0.01 
Board [Qc 3s 7d]
Seat 2: wesa280 collected ($0.24)
Seat 3: hornetsvp (button) folded before Flop (didn't bet)
Seat 4: 3EBC96 (small blind) folded before Flop
Seat 5: gprobro (big blind) folded on the Flop
Seat 6: Sergey_Bolos folded before Flop (didn't bet)



PokerStars Hand #222949822709:  Hold'em No Limit ($0.05/$0.10 USD) - 2021/01/23 5:37:00 ET
Table 'Polydoros II' 6-max Seat #4 is the button
Seat 2: wesa280 ($9.66 in chips) 
Seat 3: hornetsvp ($10 in chips) 
Seat 4: 3EBC96 ($10.05 in chips) 
Seat 5: gprobro ($11.94 in chips) 
Seat 6: Sergey_Bolos ($37.01 in chips) 
gprobro: posts small blind $0.05
Sergey_Bolos: posts big blind $0.10
*** HOLE CARDS ***
wesa280: folds 
ume3727 joins the table at seat #1 
hornetsvp: raises $0.15 to $0.25
3EBC96: raises $0.65 to $0.90
gprobro: folds 
Sergey_Bolos: folds 
hornetsvp: folds 
Uncalled bet ($0.65) returned to 3EBC96
3EBC96 collected $0.65 from pot
3EBC96: doesn't show hand 
*** SUMMARY ***
Total pot $0.65 | Rake $0 
Seat 2: wesa280 folded before Flop (didn't bet)
Seat 3: hornetsvp folded before Flop
Seat 4: 3EBC96 (button) collected ($0.65)
Seat 5: gprobro (small blind) folded before Flop
Seat 6: Sergey_Bolos (big blind) folded before Flop



PokerStars Hand #222949832169:  Hold'em No Limit ($0.05/$0.10 USD) - 2021/01/23 5:37:30 ET
Table 'Polydoros II' 6-max Seat #5 is the button
Seat 1: ume3727 ($9.90 in chips) 
Seat 2: wesa280 ($9.66 in chips) 
Seat 3: hornetsvp ($9.75 in chips) 
Seat 4: 3EBC96 ($10.45 in chips) 
Seat 5: gprobro ($11.89 in chips) 
Seat 6: Sergey_Bolos ($36.91 in chips) 
Sergey_Bolos: posts small blind $0.05
ume3727: posts big blind $0.10
*** HOLE CARDS ***
wesa280: calls $0.10
hornetsvp: folds 
3EBC96: raises $0.20 to $0.30
gprobro: calls $0.30
Sergey_Bolos: folds 
ume3727: folds 
wesa280: folds 
*** FLOP *** [4d 7s 6d]
3EBC96: bets $0.41
gprobro: calls $0.41
*** TURN *** [4d 7s 6d] [Td]
3EBC96: bets $1.19
gprobro: calls $1.19
*** RIVER *** [4d 7s 6d Td] [Ah]
3EBC96: bets $4.30
gprobro: raises $5.69 to $9.99 and is all-in
3EBC96: calls $4.25 and is all-in
Uncalled bet ($1.44) returned to gprobro
*** SHOW DOWN ***
gprobro: shows [9d Ad] (a flush, Ace high)
3EBC96: shows [Kd 7d] (a flush, King high)
gprobro collected $20.20 from pot
*** SUMMARY ***
Total pot $21.15 | Rake $0.95 
Board [4d 7s 6d Td Ah]
Seat 1: ume3727 (big blind) folded before Flop
Seat 2: wesa280 folded before Flop
Seat 3: hornetsvp folded before Flop (didn't bet)
Seat 4: 3EBC96 showed [Kd 7d] and lost with a flush, King high
Seat 5: gprobro (button) showed [9d Ad] and won ($20.20) with a flush, Ace high
Seat 6: Sergey_Bolos (small blind) folded before Flop



PokerStars Hand #222949847014:  Hold'em No Limit ($0.05/$0.10 USD) - 2021/01/23 5:38:17 ET
Table 'Polydoros II' 6-max Seat #6 is the button
Seat 1: ume3727 ($9.80 in chips) 
Seat 2: wesa280 ($9.56 in chips) 
Seat 3: hornetsvp ($10 in chips) 
Seat 4: 3EBC96 ($10 in chips) 
Seat 5: gprobro ($21.64 in chips) 
Seat 6: Sergey_Bolos ($36.86 in chips) 
ume3727: posts small blind $0.05
wesa280: posts big blind $0.10
*** HOLE CARDS ***
hornetsvp: folds 
3EBC96: folds 
gprobro: folds 
Sergey_Bolos: raises $0.15 to $0.25
gprobro leaves the table
ume3727: folds 
wesa280: calls $0.15
*** FLOP *** [Td Jh 3s]
and_sp6 joins the table at seat #5 
wesa280: bets $0.10
Sergey_Bolos: calls $0.10
*** TURN *** [Td Jh 3s] [Qs]
wesa280: bets $0.10
Sergey_Bolos: folds 
Uncalled bet ($0.10) returned to wesa280
wesa280 collected $0.72 from pot
wesa280: doesn't show hand 
*** SUMMARY ***
Total pot $0.75 | Rake $0.03 
Board [Td Jh 3s Qs]
Seat 1: ume3727 (small blind) folded before Flop
Seat 2: wesa280 (big blind) collected ($0.72)
Seat 3: hornetsvp folded before Flop (didn't bet)
Seat 4: 3EBC96 folded before Flop (didn't bet)
Seat 5: gprobro folded before Flop (didn't bet)
Seat 6: Sergey_Bolos (button) folded on the Turn



PokerStars Hand #222949857193:  Hold'em No Limit ($0.05/$0.10 USD) - 2021/01/23 5:38:49 ET
Table 'Polydoros II' 6-max Seat #1 is the button
Seat 1: ume3727 ($9.75 in chips) 
Seat 2: wesa280 ($9.93 in chips) 
Seat 3: hornetsvp ($10 in chips) 
Seat 4: 3EBC96 ($10 in chips) 
Seat 6: Sergey_Bolos ($36.51 in chips) 
wesa280: posts small blind $0.05
hornetsvp: posts big blind $0.10
and_sp6: sits out 
*** HOLE CARDS ***
3EBC96: folds 
Sergey_Bolos: folds 
ume3727: raises $0.10 to $0.20
wesa280: raises $0.10 to $0.30
hornetsvp: folds 
ume3727: calls $0.10
*** FLOP *** [8s 6s 3c]
wesa280: checks 
ume3727: checks 
*** TURN *** [8s 6s 3c] [Qh]
wesa280: bets $0.10
ume3727: calls $0.10
*** RIVER *** [8s 6s 3c Qh] [Kc]
wesa280: bets $9.53 and is all-in
ume3727: folds 
Uncalled bet ($9.53) returned to wesa280
wesa280 collected $0.86 from pot
wesa280: doesn't show hand 
*** SUMMARY ***
Total pot $0.90 | Rake $0.04 
Board [8s 6s 3c Qh Kc]
Seat 1: ume3727 (button) folded on the River
Seat 2: wesa280 (small blind) collected ($0.86)
Seat 3: hornetsvp (big blind) folded before Flop
Seat 4: 3EBC96 folded before Flop (didn't bet)
Seat 6: Sergey_Bolos folded before Flop (didn't bet)



PokerStars Hand #222949874845:  Hold'em No Limit ($0.05/$0.10 USD) - 2021/01/23 5:39:45 ET
Table 'Polydoros II' 6-max Seat #2 is the button
Seat 1: ume3727 ($9.35 in chips) 
Seat 2: wesa280 ($10.39 in chips) 
Seat 3: hornetsvp ($10 in chips) 
Seat 4: 3EBC96 ($10 in chips) 
Seat 6: Sergey_Bolos ($36.51 in chips) 
hornetsvp: posts small blind $0.05
3EBC96: posts big blind $0.10
and_sp6: sits out 
*** HOLE CARDS ***
Sergey_Bolos: folds 
ume3727: folds 
wesa280: calls $0.10
hornetsvp: folds 
3EBC96: checks 
*** FLOP *** [Ah 7d 9s]
3EBC96: checks 
wesa280: checks 
*** TURN *** [Ah 7d 9s] [8s]
3EBC96: checks 
wesa280: bets $0.10
3EBC96: folds 
Uncalled bet ($0.10) returned to wesa280
wesa280 collected $0.24 from pot
wesa280: doesn't show hand 
*** SUMMARY ***
Total pot $0.25 | Rake $0.01 
Board [Ah 7d 9s 8s]
Seat 1: ume3727 folded before Flop (didn't bet)
Seat 2: wesa280 (button) collected ($0.24)
Seat 3: hornetsvp (small blind) folded before Flop
Seat 4: 3EBC96 (big blind) folded on the Turn
Seat 6: Sergey_Bolos folded before Flop (didn't bet)



PokerStars Hand #222949886791:  Hold'em No Limit ($0.05/$0.10 USD) - 2021/01/23 5:40:23 ET
Table 'Polydoros II' 6-max Seat #3 is the button
Seat 1: ume3727 ($9.35 in chips) 
Seat 2: wesa280 ($10.53 in chips) 
Seat 3: hornetsvp ($10 in chips) 
Seat 4: 3EBC96 ($10 in chips) 
Seat 5: and_sp6 ($10 in chips) 
Seat 6: Sergey_Bolos ($36.51 in chips) 
3EBC96: posts small blind $0.05
and_sp6: posts big blind $0.10
*** HOLE CARDS ***
Sergey_Bolos: folds 
ume3727: folds 
wesa280: calls $0.10
hornetsvp: folds 
3EBC96: folds 
and_sp6: checks 
*** FLOP *** [3h 5c Jd]
and_sp6: checks 
wesa280: checks 
*** TURN *** [3h 5c Jd] [5s]
and_sp6: bets $0.18
wesa280: calls $0.18
*** RIVER *** [3h 5c Jd 5s] [6h]
and_sp6: bets $0.39
wesa280: raises $0.39 to $0.78
and_sp6: calls $0.39
*** SHOW DOWN ***
wesa280: shows [5h 8d] (three of a kind, Fives)
and_sp6: shows [8h 5d] (three of a kind, Fives)
and_sp6 collected $1.04 from pot
wesa280 collected $1.03 from pot
*** SUMMARY ***
Total pot $2.17 | Rake $0.10 
Board [3h 5c Jd 5s 6h]
Seat 1: ume3727 folded before Flop (didn't bet)
Seat 2: wesa280 showed [5h 8d] and won ($1.03) with three of a kind, Fives
Seat 3: hornetsvp (button) folded before Flop (didn't bet)
Seat 4: 3EBC96 (small blind) folded before Flop
Seat 5: and_sp6 (big blind) showed [8h 5d] and won ($1.04) with three of a kind, Fives
Seat 6: Sergey_Bolos folded before Flop (didn't bet)



PokerStars Hand #222949898991:  Hold'em No Limit ($0.05/$0.10 USD) - 2021/01/23 5:41:03 ET
Table 'Polydoros II' 6-max Seat #4 is the button
Seat 1: ume3727 ($9.35 in chips) 
Seat 2: wesa280 ($10.50 in chips) 
Seat 3: hornetsvp ($10 in chips) 
Seat 4: 3EBC96 ($10 in chips) 
Seat 5: and_sp6 ($10 in chips) 
Seat 6: Sergey_Bolos ($36.51 in chips) 
and_sp6: posts small blind $0.05
Sergey_Bolos: posts big blind $0.10
*** HOLE CARDS ***
ume3727: folds 
wesa280: calls $0.10
hornetsvp: folds 
3EBC96: folds 
and_sp6: raises $0.30 to $0.40
Sergey_Bolos: folds 
wesa280: folds 
Uncalled bet ($0.30) returned to and_sp6
and_sp6 collected $0.30 from pot
and_sp6: doesn't show hand 
*** SUMMARY ***
Total pot $0.30 | Rake $0 
Seat 1: ume3727 folded before Flop (didn't bet)
Seat 2: wesa280 folded before Flop
Seat 3: hornetsvp folded before Flop (didn't bet)
Seat 4: 3EBC96 (button) folded before Flop (didn't bet)
Seat 5: and_sp6 (small blind) collected ($0.30)
Seat 6: Sergey_Bolos (big blind) folded before Flop



PokerStars Hand #222949904568:  Hold'em No Limit ($0.05/$0.10 USD) - 2021/01/23 5:41:20 ET
Table 'Polydoros II' 6-max Seat #5 is the button
Seat 1: ume3727 ($9.35 in chips) 
Seat 2: wesa280 ($10.40 in chips) 
Seat 3: hornetsvp ($10 in chips) 
Seat 4: 3EBC96 ($10 in chips) 
Seat 5: and_sp6 ($10.20 in chips) 
Seat 6: Sergey_Bolos ($36.41 in chips) 
Sergey_Bolos: posts small blind $0.05
ume3727: posts big blind $0.10
*** HOLE CARDS ***
wesa280: calls $0.10
hornetsvp: folds 
3EBC96: folds 
and_sp6: folds 
Sergey_Bolos: folds 
ume3727: checks 
*** FLOP *** [Ad 8s 5c]
ume3727: checks 
wesa280: checks 
*** TURN *** [Ad 8s 5c] [6c]
ume3727: bets $0.12
wesa280: raises $0.12 to $0.24
ume3727: calls $0.12
*** RIVER *** [Ad 8s 5c 6c] [3d]
ume3727: bets $0.35
wesa280: calls $0.35
*** SHOW DOWN ***
ume3727: shows [As 7h] (a pair of Aces)
wesa280: mucks hand 
ume3727 collected $1.37 from pot
*** SUMMARY ***
Total pot $1.43 | Rake $0.06 
Board [Ad 8s 5c 6c 3d]
Seat 1: ume3727 (big blind) showed [As 7h] and won ($1.37) with a pair of Aces
Seat 2: wesa280 mucked
Seat 3: hornetsvp folded before Flop (didn't bet)
Seat 4: 3EBC96 folded before Flop (didn't bet)
Seat 5: and_sp6 (button) folded before Flop (didn't bet)
Seat 6: Sergey_Bolos (small blind) folded before Flop



PokerStars Hand #222949918259:  Hold'em No Limit ($0.05/$0.10 USD) - 2021/01/23 5:42:04 ET
Table 'Polydoros II' 6-max Seat #6 is the button
Seat 1: ume3727 ($10.03 in chips) 
Seat 2: wesa280 ($9.71 in chips) 
Seat 3: hornetsvp ($10 in chips) 
Seat 4: 3EBC96 ($10 in chips) 
Seat 5: and_sp6 ($10.20 in chips) 
Seat 6: Sergey_Bolos ($36.36 in chips) 
ume3727: posts small blind $0.05
wesa280: posts big blind $0.10
*** HOLE CARDS ***
hornetsvp: folds 
3EBC96: folds 
and_sp6: raises $0.15 to $0.25
Sergey_Bolos: folds 
ume3727: folds 
wesa280: calls $0.15
*** FLOP *** [8h 4c 4d]
ume3727 leaves the table
l KAAK l joins the table at seat #1 
wesa280: bets $0.10
and_sp6: calls $0.10
*** TURN *** [8h 4c 4d] [Qd]
wesa280: bets $0.10
and_sp6: folds 
Uncalled bet ($0.10) returned to wesa280
wesa280 collected $0.72 from pot
wesa280: doesn't show hand 
*** SUMMARY ***
Total pot $0.75 | Rake $0.03 
Board [8h 4c 4d Qd]
Seat 1: ume3727 (small blind) folded before Flop
Seat 2: wesa280 (big blind) collected ($0.72)
Seat 3: hornetsvp folded before Flop (didn't bet)
Seat 4: 3EBC96 folded before Flop (didn't bet)
Seat 5: and_sp6 folded on the Turn
Seat 6: Sergey_Bolos (button) folded before Flop (didn't bet)



PokerStars Hand #222949936395:  Hold'em No Limit ($0.05/$0.10 USD) - 2021/01/23 5:43:02 ET
Table 'Polydoros II' 6-max Seat #2 is the button
Seat 2: wesa280 ($10.08 in chips) 
Seat 3: hornetsvp ($10 in chips) 
Seat 4: 3EBC96 ($10 in chips) 
Seat 5: and_sp6 ($10 in chips) 
Seat 6: Sergey_Bolos ($36.36 in chips) 
hornetsvp: posts small blind $0.05
3EBC96: posts big blind $0.10
l KAAK l: sits out 
*** HOLE CARDS ***
and_sp6: folds 
Sergey_Bolos: raises $0.15 to $0.25
wesa280: folds 
hornetsvp: folds 
3EBC96: calls $0.15
*** FLOP *** [Kd Jh 3d]
3EBC96: checks 
Sergey_Bolos: checks 
*** TURN *** [Kd Jh 3d] [6c]
3EBC96: bets $0.30
Sergey_Bolos: folds 
Uncalled bet ($0.30) returned to 3EBC96
3EBC96 collected $0.53 from pot
3EBC96: doesn't show hand 
*** SUMMARY ***
Total pot $0.55 | Rake $0.02 
Board [Kd Jh 3d 6c]
Seat 2: wesa280 (button) folded before Flop (didn't bet)
Seat 3: hornetsvp (small blind) folded before Flop
Seat 4: 3EBC96 (big blind) collected ($0.53)
Seat 5: and_sp6 folded before Flop (didn't bet)
Seat 6: Sergey_Bolos folded on the Turn



PokerStars Hand #222949947766:  Hold'em No Limit ($0.05/$0.10 USD) - 2021/01/23 5:43:39 ET
Table 'Polydoros II' 6-max Seat #3 is the button
Seat 2: wesa280 ($10.08 in chips) 
Seat 3: hornetsvp ($9.95 in chips) 
Seat 4: 3EBC96 ($10.28 in chips) 
Seat 5: and_sp6 ($10 in chips) 
Seat 6: Sergey_Bolos ($36.11 in chips) 
3EBC96: posts small blind $0.05
and_sp6: posts big blind $0.10
l KAAK l: sits out 
*** HOLE CARDS ***
Sergey_Bolos: raises $0.15 to $0.25
wesa280: calls $0.25
hornetsvp: folds 
3EBC96: folds 
and_sp6: folds 
*** FLOP *** [Qs 5s Td]
Sergey_Bolos: bets $0.21
wesa280: folds 
Uncalled bet ($0.21) returned to Sergey_Bolos
Sergey_Bolos collected $0.62 from pot
Sergey_Bolos: doesn't show hand 
*** SUMMARY ***
Total pot $0.65 | Rake $0.03 
Board [Qs 5s Td]
Seat 2: wesa280 folded on the Flop
Seat 3: hornetsvp (button) folded before Flop (didn't bet)
Seat 4: 3EBC96 (small blind) folded before Flop
Seat 5: and_sp6 (big blind) folded before Flop
Seat 6: Sergey_Bolos collected ($0.62)



PokerStars Hand #222949952927:  Hold'em No Limit ($0.05/$0.10 USD) - 2021/01/23 5:43:55 ET
Table 'Polydoros II' 6-max Seat #4 is the button
Seat 2: wesa280 ($9.83 in chips) 
Seat 3: hornetsvp ($9.95 in chips) 
Seat 4: 3EBC96 ($10.23 in chips) 
Seat 5: and_sp6 ($10 in chips) 
Seat 6: Sergey_Bolos ($36.48 in chips) 
and_sp6: posts small blind $0.05
Sergey_Bolos: posts big blind $0.10
l KAAK l: sits out 
*** HOLE CARDS ***
wesa280: calls $0.10
hornetsvp: calls $0.10
3EBC96: raises $0.30 to $0.40
and_sp6: folds 
Sergey_Bolos: raises $1 to $1.40
wesa280: folds 
hornetsvp: folds 
3EBC96: folds 
Uncalled bet ($1) returned to Sergey_Bolos
Sergey_Bolos collected $1.05 from pot
Sergey_Bolos: doesn't show hand 
*** SUMMARY ***
Total pot $1.05 | Rake $0 
Seat 2: wesa280 folded before Flop
Seat 3: hornetsvp folded before Flop
Seat 4: 3EBC96 (button) folded before Flop
Seat 5: and_sp6 (small blind) folded before Flop
Seat 6: Sergey_Bolos (big blind) collected ($1.05)



PokerStars Hand #222949962605:  Hold'em No Limit ($0.05/$0.10 USD) - 2021/01/23 5:44:26 ET
Table 'Polydoros II' 6-max Seat #5 is the button
Seat 1: l KAAK l ($10 in chips) 
Seat 2: wesa280 ($9.73 in chips) 
Seat 3: hornetsvp ($9.85 in chips) 
Seat 4: 3EBC96 ($10 in chips) 
Seat 5: and_sp6 ($10 in chips) 
Seat 6: Sergey_Bolos ($37.13 in chips) 
Sergey_Bolos: posts small blind $0.05
l KAAK l: posts big blind $0.10
*** HOLE CARDS ***
wesa280: calls $0.10
hornetsvp: folds 
3EBC96: folds 
and_sp6: raises $0.30 to $0.40
Sergey_Bolos: folds 
l KAAK l: folds 
wesa280: calls $0.30
*** FLOP *** [Qs 7s Jh]
wesa280: checks 
and_sp6: bets $0.46
wesa280: raises $0.46 to $0.92
and_sp6: calls $0.46
*** TURN *** [Qs 7s Jh] [6h]
wesa280: checks 
and_sp6: checks 
*** RIVER *** [Qs 7s Jh 6h] [3h]
wesa280: checks 
and_sp6: bets $0.89
wesa280: raises $7.52 to $8.41 and is all-in
and_sp6: folds 
Uncalled bet ($7.52) returned to wesa280
wesa280 collected $4.36 from pot
wesa280: doesn't show hand 
*** SUMMARY ***
Total pot $4.57 | Rake $0.21 
Board [Qs 7s Jh 6h 3h]
Seat 1: l KAAK l (big blind) folded before Flop
Seat 2: wesa280 collected ($4.36)
Seat 3: hornetsvp folded before Flop (didn't bet)
Seat 4: 3EBC96 folded before Flop (didn't bet)
Seat 5: and_sp6 (button) folded on the River
Seat 6: Sergey_Bolos (small blind) folded before Flop



PokerStars Hand #222949988306:  Hold'em No Limit ($0.05/$0.10 USD) - 2021/01/23 5:45:47 ET
Table 'Polydoros II' 6-max Seat #6 is the button
Seat 1: l KAAK l ($10 in chips) 
Seat 2: wesa280 ($11.88 in chips) 
Seat 3: hornetsvp ($10 in chips) 
Seat 4: 3EBC96 ($10 in chips) 
Seat 5: and_sp6 ($10 in chips) 
Seat 6: Sergey_Bolos ($37.08 in chips) 
l KAAK l: posts small blind $0.05
wesa280: posts big blind $0.10
*** HOLE CARDS ***
hornetsvp: folds 
3EBC96: folds 
and_sp6: raises $0.15 to $0.25
Sergey_Bolos: folds 
l KAAK l: folds 
wesa280: calls $0.15
*** FLOP *** [9d 5s 8s]
wesa280: bets $0.10
and_sp6: raises $0.49 to $0.59
wesa280: calls $0.49
*** TURN *** [9d 5s 8s] [9s]
wesa280: bets $0.10
and_sp6: calls $0.10
*** RIVER *** [9d 5s 8s 9s] [2d]
wesa280: checks 
and_sp6: checks 
*** SHOW DOWN ***
wesa280: shows [Jc 6c] (a pair of Nines)
and_sp6: shows [8h Ah] (two pair, Nines and Eights)
and_sp6 collected $1.84 from pot
*** SUMMARY ***
Total pot $1.93 | Rake $0.09 
Board [9d 5s 8s 9s 2d]
Seat 1: l KAAK l (small blind) folded before Flop
Seat 2: wesa280 (big blind) showed [Jc 6c] and lost with a pair of Nines
Seat 3: hornetsvp folded before Flop (didn't bet)
Seat 4: 3EBC96 folded before Flop (didn't bet)
Seat 5: and_sp6 showed [8h Ah] and won ($1.84) with two pair, Nines and Eights
Seat 6: Sergey_Bolos (button) folded before Flop (didn't bet)



PokerStars Hand #222950001613:  Hold'em No Limit ($0.05/$0.10 USD) - 2021/01/23 5:46:29 ET
Table 'Polydoros II' 6-max Seat #1 is the button
Seat 1: l KAAK l ($10 in chips) 
Seat 2: wesa280 ($10.94 in chips) 
Seat 3: hornetsvp ($10 in chips) 
Seat 4: 3EBC96 ($10 in chips) 
Seat 5: and_sp6 ($10.90 in chips) 
Seat 6: Sergey_Bolos ($37.08 in chips) 
wesa280: posts small blind $0.05
hornetsvp: posts big blind $0.10
*** HOLE CARDS ***
3EBC96: folds 
and_sp6: folds 
Sergey_Bolos: folds 
l KAAK l: raises $0.17 to $0.27
wesa280: calls $0.22
hornetsvp: folds 
*** FLOP *** [3h 9h 7c]
wesa280: checks 
l KAAK l: checks 
*** TURN *** [3h 9h 7c] [3c]
wesa280: bets $0.10
l KAAK l: folds 
Uncalled bet ($0.10) returned to wesa280
wesa280 collected $0.61 from pot
wesa280: doesn't show hand 
*** SUMMARY ***
Total pot $0.64 | Rake $0.03 
Board [3h 9h 7c 3c]
Seat 1: l KAAK l (button) folded on the Turn
Seat 2: wesa280 (small blind) collected ($0.61)
Seat 3: hornetsvp (big blind) folded before Flop
Seat 4: 3EBC96 folded before Flop (didn't bet)
Seat 5: and_sp6 folded before Flop (didn't bet)
Seat 6: Sergey_Bolos folded before Flop (didn't bet)



PokerStars Hand #222950012071:  Hold'em No Limit ($0.05/$0.10 USD) - 2021/01/23 5:47:02 ET
Table 'Polydoros II' 6-max Seat #2 is the button
Seat 1: l KAAK l ($10 in chips) 
Seat 2: wesa280 ($11.28 in chips) 
Seat 3: hornetsvp ($9.90 in chips) 
Seat 4: 3EBC96 ($10 in chips) 
Seat 5: and_sp6 ($10.90 in chips) 
Seat 6: Sergey_Bolos ($37.08 in chips) 
hornetsvp: posts small blind $0.05
3EBC96: posts big blind $0.10
*** HOLE CARDS ***
and_sp6: folds 
Sergey_Bolos: folds 
l KAAK l: folds 
l KAAK l leaves the table
wesa280: folds 
hornetsvp: folds 
Uncalled bet ($0.05) returned to 3EBC96
vergießet joins the table at seat #1 
3EBC96 collected $0.10 from pot
3EBC96: doesn't show hand 
*** SUMMARY ***
Total pot $0.10 | Rake $0 
Seat 1: l KAAK l folded before Flop (didn't bet)
Seat 2: wesa280 (button) folded before Flop (didn't bet)
Seat 3: hornetsvp (small blind) folded before Flop
Seat 4: 3EBC96 (big blind) collected ($0.10)
Seat 5: and_sp6 folded before Flop (didn't bet)
Seat 6: Sergey_Bolos folded before Flop (didn't bet)



PokerStars Hand #222950014338:  Hold'em No Limit ($0.05/$0.10 USD) - 2021/01/23 5:47:10 ET
Table 'Polydoros II' 6-max Seat #3 is the button
Seat 2: wesa280 ($11.28 in chips) 
Seat 3: hornetsvp ($9.85 in chips) 
Seat 4: 3EBC96 ($10.05 in chips) 
Seat 5: and_sp6 ($10.90 in chips) 
Seat 6: Sergey_Bolos ($37.08 in chips) 
3EBC96: posts small blind $0.05
and_sp6: posts big blind $0.10
vergießet: sits out 
*** HOLE CARDS ***
Sergey_Bolos: folds 
wesa280: calls $0.10
hornetsvp: folds 
3EBC96: folds 
and_sp6: checks 
*** FLOP *** [Td Jd 5s]
and_sp6: checks 
wesa280: bets $0.10
and_sp6: calls $0.10
*** TURN *** [Td Jd 5s] [4d]
and_sp6: checks 
wesa280: bets $0.10
and_sp6: calls $0.10
*** RIVER *** [Td Jd 5s 4d] [9d]
and_sp6: checks 
wesa280: bets $0.10
and_sp6: calls $0.10
*** SHOW DOWN ***
wesa280: shows [2c 9c] (a pair of Nines)
and_sp6: shows [Kc 5d] (a flush, Jack high)
and_sp6 collected $0.81 from pot
*** SUMMARY ***
Total pot $0.85 | Rake $0.04 
Board [Td Jd 5s 4d 9d]
Seat 2: wesa280 showed [2c 9c] and lost with a pair of Nines
Seat 3: hornetsvp (button) folded before Flop (didn't bet)
Seat 4: 3EBC96 (small blind) folded before Flop
Seat 5: and_sp6 (big blind) showed [Kc 5d] and won ($0.81) with a flush, Jack high
Seat 6: Sergey_Bolos folded before Flop (didn't bet)



PokerStars Hand #222950030279:  Hold'em No Limit ($0.05/$0.10 USD) - 2021/01/23 5:48:00 ET
Table 'Polydoros II' 6-max Seat #4 is the button
Seat 1: vergießet ($10 in chips) 
Seat 2: wesa280 ($10.88 in chips) 
Seat 3: hornetsvp ($9.85 in chips) 
Seat 4: 3EBC96 ($10 in chips) 
Seat 5: and_sp6 ($11.31 in chips) 
Seat 6: Sergey_Bolos ($37.08 in chips) 
and_sp6: posts small blind $0.05
Sergey_Bolos: posts big blind $0.10
vergießet: posts big blind $0.10
*** HOLE CARDS ***
vergießet: raises $0.25 to $0.35
wesa280: calls $0.35
hornetsvp: folds 
3EBC96: folds 
and_sp6: folds 
Sergey_Bolos: folds 
*** FLOP *** [Ts Qh 7d]
vergießet: bets $0.81
wesa280: calls $0.81
*** TURN *** [Ts Qh 7d] [Kh]
vergießet: checks 
wesa280: bets $0.10
vergießet: raises $1.28 to $1.38
wesa280: folds 
Uncalled bet ($1.28) returned to vergießet
vergießet collected $2.55 from pot
vergießet: doesn't show hand 
*** SUMMARY ***
Total pot $2.67 | Rake $0.12 
Board [Ts Qh 7d Kh]
Seat 1: vergießet collected ($2.55)
Seat 2: wesa280 folded on the Turn
Seat 3: hornetsvp folded before Flop (didn't bet)
Seat 4: 3EBC96 (button) folded before Flop (didn't bet)
Seat 5: and_sp6 (small blind) folded before Flop
Seat 6: Sergey_Bolos (big blind) folded before Flop



PokerStars Hand #222950040049:  Hold'em No Limit ($0.05/$0.10 USD) - 2021/01/23 5:48:30 ET
Table 'Polydoros II' 6-max Seat #5 is the button
Seat 1: vergießet ($11.29 in chips) 
Seat 2: wesa280 ($9.62 in chips) 
Seat 3: hornetsvp ($9.85 in chips) 
Seat 4: 3EBC96 ($10 in chips) 
Seat 5: and_sp6 ($11.26 in chips) 
Seat 6: Sergey_Bolos ($36.98 in chips) 
Sergey_Bolos: posts small blind $0.05
vergießet: posts big blind $0.10
*** HOLE CARDS ***
wesa280: calls $0.10
hornetsvp: folds 
3EBC96: folds 
and_sp6: calls $0.10
Sergey_Bolos: calls $0.05
vergießet: checks 
*** FLOP *** [3h 9c 4s]
Sergey_Bolos: checks 
vergießet: checks 
wesa280: checks 
and_sp6: bets $0.13
Sergey_Bolos: folds 
vergießet: folds 
wesa280: calls $0.13
*** TURN *** [3h 9c 4s] [Ac]
wesa280: bets $0.10
and_sp6: folds 
Uncalled bet ($0.10) returned to wesa280
wesa280 collected $0.63 from pot
wesa280: doesn't show hand 
*** SUMMARY ***
Total pot $0.66 | Rake $0.03 
Board [3h 9c 4s Ac]
Seat 1: vergießet (big blind) folded on the Flop
Seat 2: wesa280 collected ($0.63)
Seat 3: hornetsvp folded before Flop (didn't bet)
Seat 4: 3EBC96 folded before Flop (didn't bet)
Seat 5: and_sp6 (button) folded on the Turn
Seat 6: Sergey_Bolos (small blind) folded on the Flop



PokerStars Hand #222950051347:  Hold'em No Limit ($0.05/$0.10 USD) - 2021/01/23 5:49:06 ET
Table 'Polydoros II' 6-max Seat #6 is the button
Seat 1: vergießet ($11.19 in chips) 
Seat 2: wesa280 ($10.02 in chips) 
Seat 3: hornetsvp ($9.85 in chips) 
Seat 4: 3EBC96 ($10 in chips) 
Seat 5: and_sp6 ($11.03 in chips) 
Seat 6: Sergey_Bolos ($36.88 in chips) 
vergießet: posts small blind $0.05
wesa280: posts big blind $0.10
*** HOLE CARDS ***
hornetsvp: folds 
3EBC96: folds 
and_sp6: folds 
Sergey_Bolos: folds 
vergießet: folds 
Uncalled bet ($0.05) returned to wesa280
wesa280 collected $0.10 from pot
wesa280: doesn't show hand 
*** SUMMARY ***
Total pot $0.10 | Rake $0 
Seat 1: vergießet (small blind) folded before Flop
Seat 2: wesa280 (big blind) collected ($0.10)
Seat 3: hornetsvp folded before Flop (didn't bet)
Seat 4: 3EBC96 folded before Flop (didn't bet)
Seat 5: and_sp6 folded before Flop (didn't bet)
Seat 6: Sergey_Bolos (button) folded before Flop (didn't bet)



PokerStars Hand #222950054688:  Hold'em No Limit ($0.05/$0.10 USD) - 2021/01/23 5:49:17 ET
Table 'Polydoros II' 6-max Seat #1 is the button
Seat 1: vergießet ($11.14 in chips) 
Seat 2: wesa280 ($10.07 in chips) 
Seat 3: hornetsvp ($9.85 in chips) 
Seat 4: 3EBC96 ($10 in chips) 
Seat 5: and_sp6 ($11.03 in chips) 
Seat 6: Sergey_Bolos ($36.88 in chips) 
wesa280: posts small blind $0.05
hornetsvp: posts big blind $0.10
*** HOLE CARDS ***
3EBC96: folds 
and_sp6: folds 
Sergey_Bolos: raises $0.15 to $0.25
vergießet: folds 
wesa280: folds 
hornetsvp: folds 
Uncalled bet ($0.15) returned to Sergey_Bolos
Sergey_Bolos collected $0.25 from pot
Sergey_Bolos: doesn't show hand 
*** SUMMARY ***
Total pot $0.25 | Rake $0 
Seat 1: vergießet (button) folded before Flop (didn't bet)
Seat 2: wesa280 (small blind) folded before Flop
Seat 3: hornetsvp (big blind) folded before Flop
Seat 4: 3EBC96 folded before Flop (didn't bet)
Seat 5: and_sp6 folded before Flop (didn't bet)
Seat 6: Sergey_Bolos collected ($0.25)



PokerStars Hand #222950059059:  Hold'em No Limit ($0.05/$0.10 USD) - 2021/01/23 5:49:31 ET
Table 'Polydoros II' 6-max Seat #2 is the button
Seat 1: vergießet ($11.14 in chips) 
Seat 2: wesa280 ($10.02 in chips) 
Seat 3: hornetsvp ($9.75 in chips) 
Seat 4: 3EBC96 ($10 in chips) 
Seat 5: and_sp6 ($11.03 in chips) 
Seat 6: Sergey_Bolos ($37.03 in chips) 
hornetsvp: posts small blind $0.05
3EBC96: posts big blind $0.10
*** HOLE CARDS ***
and_sp6: folds 
Sergey_Bolos: raises $0.15 to $0.25
vergießet: raises $0.45 to $0.70
wesa280: folds 
hornetsvp: folds 
3EBC96: folds 
Sergey_Bolos: raises $1.20 to $1.90
vergießet: calls $1.20
*** FLOP *** [4h 5h Kc]
Sergey_Bolos: bets $1.28
vergießet: calls $1.28
*** TURN *** [4h 5h Kc] [2d]
Sergey_Bolos: bets $11.55
vergießet: folds 
Uncalled bet ($11.55) returned to Sergey_Bolos
Sergey_Bolos collected $6.22 from pot
Sergey_Bolos: doesn't show hand 
*** SUMMARY ***
Total pot $6.51 | Rake $0.29 
Board [4h 5h Kc 2d]
Seat 1: vergießet folded on the Turn
Seat 2: wesa280 (button) folded before Flop (didn't bet)
Seat 3: hornetsvp (small blind) folded before Flop
Seat 4: 3EBC96 (big blind) folded before Flop
Seat 5: and_sp6 folded before Flop (didn't bet)
Seat 6: Sergey_Bolos collected ($6.22)



PokerStars Hand #222950075236:  Hold'em No Limit ($0.05/$0.10 USD) - 2021/01/23 5:50:22 ET
Table 'Polydoros II' 6-max Seat #3 is the button
Seat 1: vergießet ($7.96 in chips) 
Seat 2: wesa280 ($10.02 in chips) 
Seat 3: hornetsvp ($9.95 in chips) 
Seat 4: 3EBC96 ($10 in chips) 
Seat 5: and_sp6 ($11.03 in chips) 
Seat 6: Sergey_Bolos ($40.07 in chips) 
3EBC96: posts small blind $0.05
and_sp6: posts big blind $0.10
*** HOLE CARDS ***
Sergey_Bolos: folds 
vergießet: folds 
wesa280: calls $0.10
hornetsvp: folds 
3EBC96: raises $0.40 to $0.50
and_sp6: folds 
wesa280: calls $0.40
*** FLOP *** [9d 6s 4c]
3EBC96: bets $0.80
wesa280: calls $0.80
*** TURN *** [9d 6s 4c] [3s]
3EBC96: bets $2
wesa280: folds 
Uncalled bet ($2) returned to 3EBC96
3EBC96 collected $2.58 from pot
3EBC96: doesn't show hand 
*** SUMMARY ***
Total pot $2.70 | Rake $0.12 
Board [9d 6s 4c 3s]
Seat 1: vergießet folded before Flop (didn't bet)
Seat 2: wesa280 folded on the Turn
Seat 3: hornetsvp (button) folded before Flop (didn't bet)
Seat 4: 3EBC96 (small blind) collected ($2.58)
Seat 5: and_sp6 (big blind) folded before Flop
Seat 6: Sergey_Bolos folded before Flop (didn't bet)



PokerStars Hand #222950084745:  Hold'em No Limit ($0.05/$0.10 USD) - 2021/01/23 5:50:52 ET
Table 'Polydoros II' 6-max Seat #4 is the button
Seat 1: vergießet ($7.96 in chips) 
Seat 2: wesa280 ($8.72 in chips) 
Seat 3: hornetsvp ($9.95 in chips) 
Seat 4: 3EBC96 ($11.28 in chips) 
Seat 5: and_sp6 ($10.93 in chips) 
Seat 6: Sergey_Bolos ($40.07 in chips) 
and_sp6: posts small blind $0.05
Sergey_Bolos: posts big blind $0.10
*** HOLE CARDS ***
vergießet: folds 
wesa280: calls $0.10
hornetsvp: folds 
3EBC96: folds 
and_sp6: folds 
Sergey_Bolos: raises $0.30 to $0.40
wesa280: calls $0.30
*** FLOP *** [4d Th Tc]
Sergey_Bolos: bets $0.36
wesa280: raises $0.36 to $0.72
Sergey_Bolos: folds 
Uncalled bet ($0.36) returned to wesa280
wesa280 collected $1.50 from pot
wesa280: doesn't show hand 
*** SUMMARY ***
Total pot $1.57 | Rake $0.07 
Board [4d Th Tc]
Seat 1: vergießet folded before Flop (didn't bet)
Seat 2: wesa280 collected ($1.50)
Seat 3: hornetsvp folded before Flop (didn't bet)
Seat 4: 3EBC96 (button) folded before Flop (didn't bet)
Seat 5: and_sp6 (small blind) folded before Flop
Seat 6: Sergey_Bolos (big blind) folded on the Flop



PokerStars Hand #222950093670:  Hold'em No Limit ($0.05/$0.10 USD) - 2021/01/23 5:51:20 ET
Table 'Polydoros II' 6-max Seat #5 is the button
Seat 1: vergießet ($7.96 in chips) 
Seat 2: wesa280 ($9.46 in chips) 
Seat 3: hornetsvp ($9.95 in chips) 
Seat 4: 3EBC96 ($11.28 in chips) 
Seat 5: and_sp6 ($10.88 in chips) 
Seat 6: Sergey_Bolos ($39.31 in chips) 
Sergey_Bolos: posts small blind $0.05
vergießet: posts big blind $0.10
*** HOLE CARDS ***
wesa280: calls $0.10
hornetsvp: folds 
3EBC96: folds 
and_sp6: folds 
Sergey_Bolos: raises $0.30 to $0.40
vergießet: folds 
wesa280: calls $0.30
*** FLOP *** [Ks 2c 6d]
Sergey_Bolos: checks 
wesa280: checks 
*** TURN *** [Ks 2c 6d] [8s]
Sergey_Bolos: checks 
wesa280: bets $0.10
Sergey_Bolos: calls $0.10
*** RIVER *** [Ks 2c 6d 8s] [7d]
Sergey_Bolos: checks 
wesa280: bets $0.10
Sergey_Bolos: calls $0.10
*** SHOW DOWN ***
wesa280: shows [4h Jh] (high card King)
Sergey_Bolos: shows [Ah Ts] (high card Ace)
Sergey_Bolos collected $1.24 from pot
*** SUMMARY ***
Total pot $1.30 | Rake $0.06 
Board [Ks 2c 6d 8s 7d]
Seat 1: vergießet (big blind) folded before Flop
Seat 2: wesa280 showed [4h Jh] and lost with high card King
Seat 3: hornetsvp folded before Flop (didn't bet)
Seat 4: 3EBC96 folded before Flop (didn't bet)
Seat 5: and_sp6 (button) folded before Flop (didn't bet)
Seat 6: Sergey_Bolos (small blind) showed [Ah Ts] and won ($1.24) with high card Ace



PokerStars Hand #222950104029:  Hold'em No Limit ($0.05/$0.10 USD) - 2021/01/23 5:51:53 ET
Table 'Polydoros II' 6-max Seat #6 is the button
Seat 1: vergießet ($7.86 in chips) 
Seat 2: wesa280 ($8.86 in chips) 
Seat 3: hornetsvp ($10 in chips) 
Seat 4: 3EBC96 ($11.28 in chips) 
Seat 5: and_sp6 ($10.88 in chips) 
Seat 6: Sergey_Bolos ($39.95 in chips) 
vergießet: posts small blind $0.05
wesa280: posts big blind $0.10
*** HOLE CARDS ***
hornetsvp: folds 
3EBC96: folds 
and_sp6: raises $0.15 to $0.25
Sergey_Bolos: folds 
vergießet: folds 
wesa280: calls $0.15
*** FLOP *** [4c Jc 3h]
wesa280: checks 
and_sp6: bets $0.40
wesa280: calls $0.40
*** TURN *** [4c Jc 3h] [4s]
wesa280: checks 
and_sp6: bets $1.05
wesa280: raises $7.16 to $8.21 and is all-in
and_sp6: calls $7.16
*** RIVER *** [4c Jc 3h 4s] [Ac]
*** SHOW DOWN ***
wesa280: shows [4h Js] (a full house, Fours full of Jacks)
and_sp6: shows [Jd Ad] (two pair, Aces and Jacks)
wesa280 collected $16.97 from pot
*** SUMMARY ***
Total pot $17.77 | Rake $0.80 
Board [4c Jc 3h 4s Ac]
Seat 1: vergießet (small blind) folded before Flop
Seat 2: wesa280 (big blind) showed [4h Js] and won ($16.97) with a full house, Fours full of Jacks
Seat 3: hornetsvp folded before Flop (didn't bet)
Seat 4: 3EBC96 folded before Flop (didn't bet)
Seat 5: and_sp6 showed [Jd Ad] and lost with two pair, Aces and Jacks
Seat 6: Sergey_Bolos (button) folded before Flop (didn't bet)



PokerStars Hand #222950120558:  Hold'em No Limit ($0.05/$0.10 USD) - 2021/01/23 5:52:46 ET
Table 'Polydoros II' 6-max Seat #1 is the button
Seat 1: vergießet ($7.81 in chips) 
Seat 2: wesa280 ($16.97 in chips) 
Seat 3: hornetsvp ($10 in chips) 
Seat 4: 3EBC96 ($11.28 in chips) 
Seat 5: and_sp6 ($10 in chips) 
Seat 6: Sergey_Bolos ($39.95 in chips) 
wesa280: posts small blind $0.05
hornetsvp: posts big blind $0.10
*** HOLE CARDS ***
3EBC96: folds 
and_sp6: folds 
Sergey_Bolos: raises $0.15 to $0.25
vergießet: calls $0.25
wesa280: calls $0.20
hornetsvp: calls $0.15
*** FLOP *** [2c Qd 5d]
wesa280: checks 
hornetsvp: checks 
Sergey_Bolos: checks 
vergießet: checks 
*** TURN *** [2c Qd 5d] [Th]
wesa280: bets $0.10
hornetsvp: folds 
Sergey_Bolos: folds 
vergießet: folds 
Uncalled bet ($0.10) returned to wesa280
wesa280 collected $0.96 from pot
wesa280: doesn't show hand 
*** SUMMARY ***
Total pot $1 | Rake $0.04 
Board [2c Qd 5d Th]
Seat 1: vergießet (button) folded on the Turn
Seat 2: wesa280 (small blind) collected ($0.96)
Seat 3: hornetsvp (big blind) folded on the Turn
Seat 4: 3EBC96 folded before Flop (didn't bet)
Seat 5: and_sp6 folded before Flop (didn't bet)
Seat 6: Sergey_Bolos folded on the Turn



PokerStars Hand #222950139684:  Hold'em No Limit ($0.05/$0.10 USD) - 2021/01/23 5:53:46 ET
Table 'Polydoros II' 6-max Seat #2 is the button
Seat 1: vergießet ($7.56 in chips) 
Seat 2: wesa280 ($17.68 in chips) 
Seat 3: hornetsvp ($9.75 in chips) 
Seat 4: 3EBC96 ($11.28 in chips) 
Seat 5: and_sp6 ($10 in chips) 
Seat 6: Sergey_Bolos ($39.70 in chips) 
hornetsvp: posts small blind $0.05
3EBC96: posts big blind $0.10
*** HOLE CARDS ***
and_sp6: folds 
Sergey_Bolos: folds 
vergießet: raises $0.25 to $0.35
wesa280: folds 
hornetsvp: folds 
3EBC96: calls $0.25
*** FLOP *** [7d 5h 7s]
3EBC96: checks 
vergießet: checks 
*** TURN *** [7d 5h 7s] [8c]
3EBC96: checks 
vergießet: checks 
*** RIVER *** [7d 5h 7s 8c] [Td]
3EBC96: checks 
vergießet: checks 
*** SHOW DOWN ***
3EBC96: shows [Kd Jh] (a pair of Sevens)
vergießet: shows [Js Ad] (a pair of Sevens - Ace kicker)
vergießet collected $0.72 from pot
*** SUMMARY ***
Total pot $0.75 | Rake $0.03 
Board [7d 5h 7s 8c Td]
Seat 1: vergießet showed [Js Ad] and won ($0.72) with a pair of Sevens
Seat 2: wesa280 (button) folded before Flop (didn't bet)
Seat 3: hornetsvp (small blind) folded before Flop
Seat 4: 3EBC96 (big blind) showed [Kd Jh] and lost with a pair of Sevens
Seat 5: and_sp6 folded before Flop (didn't bet)
Seat 6: Sergey_Bolos folded before Flop (didn't bet)



PokerStars Hand #222950147274:  Hold'em No Limit ($0.05/$0.10 USD) - 2021/01/23 5:54:10 ET
Table 'Polydoros II' 6-max Seat #3 is the button
Seat 1: vergießet ($7.93 in chips) 
Seat 2: wesa280 ($17.68 in chips) 
Seat 3: hornetsvp ($10 in chips) 
Seat 4: 3EBC96 ($10.93 in chips) 
Seat 5: and_sp6 ($10 in chips) 
Seat 6: Sergey_Bolos ($39.70 in chips) 
3EBC96: posts small blind $0.05
and_sp6: posts big blind $0.10
*** HOLE CARDS ***
Sergey_Bolos: folds 
vergießet: folds 
wesa280: calls $0.10
hornetsvp: folds 
3EBC96: folds 
and_sp6: raises $0.35 to $0.45
wesa280: folds 
Uncalled bet ($0.35) returned to and_sp6
and_sp6 collected $0.25 from pot
and_sp6: doesn't show hand 
*** SUMMARY ***
Total pot $0.25 | Rake $0 
Seat 1: vergießet folded before Flop (didn't bet)
Seat 2: wesa280 folded before Flop
Seat 3: hornetsvp (button) folded before Flop (didn't bet)
Seat 4: 3EBC96 (small blind) folded before Flop
Seat 5: and_sp6 (big blind) collected ($0.25)
Seat 6: Sergey_Bolos folded before Flop (didn't bet)



PokerStars Hand #222950152237:  Hold'em No Limit ($0.05/$0.10 USD) - 2021/01/23 5:54:26 ET
Table 'Polydoros II' 6-max Seat #4 is the button
Seat 1: vergießet ($7.93 in chips) 
Seat 2: wesa280 ($17.58 in chips) 
Seat 3: hornetsvp ($10 in chips) 
Seat 4: 3EBC96 ($10.88 in chips) 
Seat 5: and_sp6 ($10.15 in chips) 
Seat 6: Sergey_Bolos ($39.70 in chips) 
and_sp6: posts small blind $0.05
Sergey_Bolos: posts big blind $0.10
*** HOLE CARDS ***
vergießet: calls $0.10
wesa280: calls $0.10
hornetsvp: folds 
3EBC96: folds 
and_sp6: folds 
Sergey_Bolos: checks 
*** FLOP *** [3h 4c 6h]
Sergey_Bolos: bets $0.22
vergießet: calls $0.22
wesa280: calls $0.22
*** TURN *** [3h 4c 6h] [7c]
Sergey_Bolos: bets $0.33
vergießet: raises $1.62 to $1.95
wesa280: calls $1.95
Sergey_Bolos: calls $1.62
*** RIVER *** [3h 4c 6h 7c] [2s]
Sergey_Bolos: checks 
vergießet: bets $5.66 and is all-in
wesa280: raises $9.65 to $15.31 and is all-in
Sergey_Bolos: folds 
Uncalled bet ($9.65) returned to wesa280
*** SHOW DOWN ***
wesa280: shows [5d As] (a straight, Three to Seven)
vergießet: shows [Ac 5c] (a straight, Three to Seven)
vergießet collected $8.68 from pot
wesa280 collected $8.68 from pot
*** SUMMARY ***
Total pot $18.18 | Rake $0.82 
Board [3h 4c 6h 7c 2s]
Seat 1: vergießet showed [Ac 5c] and won ($8.68) with a straight, Three to Seven
Seat 2: wesa280 showed [5d As] and won ($8.68) with a straight, Three to Seven
Seat 3: hornetsvp folded before Flop (didn't bet)
Seat 4: 3EBC96 (button) folded before Flop (didn't bet)
Seat 5: and_sp6 (small blind) folded before Flop
Seat 6: Sergey_Bolos (big blind) folded on the River



PokerStars Hand #222950171938:  Hold'em No Limit ($0.05/$0.10 USD) - 2021/01/23 5:55:32 ET
Table 'Polydoros II' 6-max Seat #5 is the button
Seat 1: vergießet ($8.68 in chips) 
Seat 2: wesa280 ($18.33 in chips) 
Seat 3: hornetsvp ($10 in chips) 
Seat 4: 3EBC96 ($10.88 in chips) 
Seat 5: and_sp6 ($10.10 in chips) 
Seat 6: Sergey_Bolos ($37.43 in chips) 
Sergey_Bolos: posts small blind $0.05
vergießet: posts big blind $0.10
*** HOLE CARDS ***
wesa280: calls $0.10
hornetsvp: folds 
3EBC96: folds 
and_sp6 has timed out
and_sp6: folds 
Sergey_Bolos: calls $0.05
vergießet: checks 
*** FLOP *** [4d Kc 8h]
Sergey_Bolos: checks 
vergießet: checks 
wesa280: checks 
*** TURN *** [4d Kc 8h] [3d]
Sergey_Bolos: checks 
vergießet: checks 
wesa280: checks 
*** RIVER *** [4d Kc 8h 3d] [2c]
Sergey_Bolos: checks 
vergießet: checks 
wesa280: bets $0.10
Sergey_Bolos: folds 
vergießet: folds 
Uncalled bet ($0.10) returned to wesa280
wesa280 collected $0.29 from pot
wesa280: doesn't show hand 
*** SUMMARY ***
Total pot $0.30 | Rake $0.01 
Board [4d Kc 8h 3d 2c]
Seat 1: vergießet (big blind) folded on the River
Seat 2: wesa280 collected ($0.29)
Seat 3: hornetsvp folded before Flop (didn't bet)
Seat 4: 3EBC96 folded before Flop (didn't bet)
Seat 5: and_sp6 (button) folded before Flop (didn't bet)
Seat 6: Sergey_Bolos (small blind) folded on the River



PokerStars Hand #222950188972:  Hold'em No Limit ($0.05/$0.10 USD) - 2021/01/23 5:56:34 ET
Table 'Polydoros II' 6-max Seat #6 is the button
Seat 1: vergießet ($8.58 in chips) 
Seat 2: wesa280 ($18.52 in chips) 
Seat 3: hornetsvp ($10 in chips) 
Seat 4: 3EBC96 ($10.88 in chips) 
Seat 5: and_sp6 ($10.10 in chips) 
Seat 6: Sergey_Bolos ($37.33 in chips) 
vergießet: posts small blind $0.05
wesa280: posts big blind $0.10
*** HOLE CARDS ***
hornetsvp: folds 
3EBC96: folds 
and_sp6: folds 
Sergey_Bolos: folds 
vergießet: folds 
Uncalled bet ($0.05) returned to wesa280
wesa280 collected $0.10 from pot
wesa280: doesn't show hand 
*** SUMMARY ***
Total pot $0.10 | Rake $0 
Seat 1: vergießet (small blind) folded before Flop
Seat 2: wesa280 (big blind) collected ($0.10)
Seat 3: hornetsvp folded before Flop (didn't bet)
Seat 4: 3EBC96 folded before Flop (didn't bet)
Seat 5: and_sp6 folded before Flop (didn't bet)
Seat 6: Sergey_Bolos (button) folded before Flop (didn't bet)



PokerStars Hand #222950191984:  Hold'em No Limit ($0.05/$0.10 USD) - 2021/01/23 5:56:45 ET
Table 'Polydoros II' 6-max Seat #1 is the button
Seat 1: vergießet ($8.53 in chips) 
Seat 2: wesa280 ($18.57 in chips) 
Seat 3: hornetsvp ($10 in chips) 
Seat 4: 3EBC96 ($10.88 in chips) 
Seat 5: and_sp6 ($10.10 in chips) 
Seat 6: Sergey_Bolos ($37.33 in chips) 
wesa280: posts small blind $0.05
hornetsvp: posts big blind $0.10
*** HOLE CARDS ***
3EBC96: folds 
and_sp6: raises $0.20 to $0.30
Sergey_Bolos: folds 
vergießet: folds 
wesa280: folds 
hornetsvp: folds 
Uncalled bet ($0.20) returned to and_sp6
and_sp6 collected $0.25 from pot
and_sp6: doesn't show hand 
*** SUMMARY ***
Total pot $0.25 | Rake $0 
Seat 1: vergießet (button) folded before Flop (didn't bet)
Seat 2: wesa280 (small blind) folded before Flop
Seat 3: hornetsvp (big blind) folded before Flop
Seat 4: 3EBC96 folded before Flop (didn't bet)
Seat 5: and_sp6 collected ($0.25)
Seat 6: Sergey_Bolos folded before Flop (didn't bet)



PokerStars Hand #222950194996:  Hold'em No Limit ($0.05/$0.10 USD) - 2021/01/23 5:56:56 ET
Table 'Polydoros II' 6-max Seat #2 is the button
Seat 1: vergießet ($8.53 in chips) 
Seat 2: wesa280 ($18.52 in chips) 
Seat 3: hornetsvp ($9.90 in chips) 
Seat 4: 3EBC96 ($10.88 in chips) 
Seat 5: and_sp6 ($10.25 in chips) 
Seat 6: Sergey_Bolos ($37.33 in chips) 
hornetsvp: posts small blind $0.05
3EBC96: posts big blind $0.10
*** HOLE CARDS ***
and_sp6: raises $0.20 to $0.30
Sergey_Bolos: folds 
vergießet: folds 
wesa280: calls $0.30
hornetsvp: folds 
3EBC96: folds 
*** FLOP *** [5h 8c 4c]
and_sp6: checks 
wesa280: bets $0.10
and_sp6: calls $0.10
*** TURN *** [5h 8c 4c] [2d]
and_sp6: checks 
wesa280: bets $0.10
and_sp6: calls $0.10
*** RIVER *** [5h 8c 4c 2d] [Jh]
and_sp6: checks 
wesa280: bets $0.10
and_sp6: calls $0.10
*** SHOW DOWN ***
wesa280: shows [Qd Kc] (high card King)
and_sp6: shows [3h 3c] (a pair of Threes)
and_sp6 collected $1.29 from pot
*** SUMMARY ***
Total pot $1.35 | Rake $0.06 
Board [5h 8c 4c 2d Jh]
Seat 1: vergießet folded before Flop (didn't bet)
Seat 2: wesa280 (button) showed [Qd Kc] and lost with high card King
Seat 3: hornetsvp (small blind) folded before Flop
Seat 4: 3EBC96 (big blind) folded before Flop
Seat 5: and_sp6 showed [3h 3c] and won ($1.29) with a pair of Threes
Seat 6: Sergey_Bolos folded before Flop (didn't bet)



PokerStars Hand #222950204674:  Hold'em No Limit ($0.05/$0.10 USD) - 2021/01/23 5:57:31 ET
Table 'Polydoros II' 6-max Seat #3 is the button
Seat 1: vergießet ($8.53 in chips) 
Seat 2: wesa280 ($17.92 in chips) 
Seat 3: hornetsvp ($9.85 in chips) 
Seat 4: 3EBC96 ($10.78 in chips) 
Seat 5: and_sp6 ($10.94 in chips) 
Seat 6: Sergey_Bolos ($37.33 in chips) 
3EBC96: posts small blind $0.05
and_sp6: posts big blind $0.10
*** HOLE CARDS ***
Sergey_Bolos: folds 
vergießet: folds 
wesa280: calls $0.10
hornetsvp: folds 
3EBC96: folds 
and_sp6: checks 
*** FLOP *** [4h 9d Tc]
and_sp6: bets $0.15
wesa280: calls $0.15
*** TURN *** [4h 9d Tc] [Ad]
and_sp6: bets $0.65
wesa280: calls $0.65
*** RIVER *** [4h 9d Tc Ad] [3s]
and_sp6: checks 
wesa280: bets $1.40
and_sp6: calls $1.40
*** SHOW DOWN ***
wesa280: shows [9h Ah] (two pair, Aces and Nines)
and_sp6: mucks hand 
wesa280 collected $4.44 from pot
*** SUMMARY ***
Total pot $4.65 | Rake $0.21 
Board [4h 9d Tc Ad 3s]
Seat 1: vergießet folded before Flop (didn't bet)
Seat 2: wesa280 showed [9h Ah] and won ($4.44) with two pair, Aces and Nines
Seat 3: hornetsvp (button) folded before Flop (didn't bet)
Seat 4: 3EBC96 (small blind) folded before Flop
Seat 5: and_sp6 (big blind) mucked
Seat 6: Sergey_Bolos folded before Flop (didn't bet)



PokerStars Hand #222950218044:  Hold'em No Limit ($0.05/$0.10 USD) - 2021/01/23 5:58:19 ET
Table 'Polydoros II' 6-max Seat #5 is the button
Seat 1: vergießet ($8.53 in chips) 
Seat 2: wesa280 ($20.06 in chips) 
Seat 3: hornetsvp ($10 in chips) 
Seat 5: and_sp6 ($10 in chips) 
Seat 6: Sergey_Bolos ($37.33 in chips) 
Sergey_Bolos: posts small blind $0.05
vergießet: posts big blind $0.10
*** HOLE CARDS ***
wesa280: calls $0.10
hornetsvp: folds 
and_sp6: folds 
Sergey_Bolos: calls $0.05
vergießet: raises $0.30 to $0.40
wesa280: calls $0.30
Sergey_Bolos: calls $0.30
*** FLOP *** [Ks Jc Kd]
Sergey_Bolos: checks 
vergießet: bets $1.15
wesa280: folds 
Sergey_Bolos: folds 
Uncalled bet ($1.15) returned to vergießet
vergießet collected $1.15 from pot
vergießet: doesn't show hand 
*** SUMMARY ***
Total pot $1.20 | Rake $0.05 
Board [Ks Jc Kd]
Seat 1: vergießet (big blind) collected ($1.15)
Seat 2: wesa280 folded on the Flop
Seat 3: hornetsvp folded before Flop (didn't bet)
Seat 5: and_sp6 (button) folded before Flop (didn't bet)
Seat 6: Sergey_Bolos (small blind) folded on the Flop



PokerStars Hand #222950225171:  Hold'em No Limit ($0.05/$0.10 USD) - 2021/01/23 5:58:45 ET
Table 'Polydoros II' 6-max Seat #6 is the button
Seat 1: vergießet ($9.28 in chips) 
Seat 2: wesa280 ($19.66 in chips) 
Seat 3: hornetsvp ($10 in chips) 
Seat 5: and_sp6 ($10 in chips) 
Seat 6: Sergey_Bolos ($36.93 in chips) 
vergießet: posts small blind $0.05
wesa280: posts big blind $0.10
*** HOLE CARDS ***
hornetsvp: folds 
and_sp6: raises $0.15 to $0.25
Sergey_Bolos: calls $0.25
vergießet: folds 
wesa280: calls $0.15
*** FLOP *** [4h 6h Kh]
wesa280: checks 
and_sp6: checks 
Sergey_Bolos: checks 
*** TURN *** [4h 6h Kh] [Ah]
wesa280: bets $0.10
and_sp6: folds 
Sergey_Bolos: folds 
Uncalled bet ($0.10) returned to wesa280
wesa280 collected $0.76 from pot
wesa280: doesn't show hand 
*** SUMMARY ***
Total pot $0.80 | Rake $0.04 
Board [4h 6h Kh Ah]
Seat 1: vergießet (small blind) folded before Flop
Seat 2: wesa280 (big blind) collected ($0.76)
Seat 3: hornetsvp folded before Flop (didn't bet)
Seat 5: and_sp6 folded on the Turn
Seat 6: Sergey_Bolos (button) folded on the Turn



PokerStars Hand #222950233694:  Hold'em No Limit ($0.05/$0.10 USD) - 2021/01/23 5:59:15 ET
Table 'Polydoros II' 6-max Seat #1 is the button
Seat 1: vergießet ($9.23 in chips) 
Seat 2: wesa280 ($20.17 in chips) 
Seat 3: hornetsvp ($10 in chips) 
Seat 5: and_sp6 ($10 in chips) 
Seat 6: Sergey_Bolos ($36.68 in chips) 
wesa280: posts small blind $0.05
hornetsvp: posts big blind $0.10
*** HOLE CARDS ***
and_sp6: folds 
Sergey_Bolos: folds 
vergießet: folds 
wesa280: calls $0.05
hornetsvp: raises $0.50 to $0.60
wesa280: folds 
Uncalled bet ($0.50) returned to hornetsvp
hornetsvp collected $0.20 from pot
hornetsvp: doesn't show hand 
*** SUMMARY ***
Total pot $0.20 | Rake $0 
Seat 1: vergießet (button) folded before Flop (didn't bet)
Seat 2: wesa280 (small blind) folded before Flop
Seat 3: hornetsvp (big blind) collected ($0.20)
Seat 5: and_sp6 folded before Flop (didn't bet)
Seat 6: Sergey_Bolos folded before Flop (didn't bet)



PokerStars Hand #222950237892:  Hold'em No Limit ($0.05/$0.10 USD) - 2021/01/23 5:59:31 ET
Table 'Polydoros II' 6-max Seat #2 is the button
Seat 1: vergießet ($9.23 in chips) 
Seat 2: wesa280 ($20.07 in chips) 
Seat 3: hornetsvp ($10.10 in chips) 
Seat 5: and_sp6 ($10 in chips) 
Seat 6: Sergey_Bolos ($36.68 in chips) 
hornetsvp: posts small blind $0.05
and_sp6: posts big blind $0.10
*** HOLE CARDS ***
Sergey_Bolos: raises $0.15 to $0.25
vergießet: folds 
wesa280: folds 
hornetsvp: folds 
and_sp6: folds 
Uncalled bet ($0.15) returned to Sergey_Bolos
Sergey_Bolos collected $0.25 from pot
Sergey_Bolos: doesn't show hand 
*** SUMMARY ***
Total pot $0.25 | Rake $0 
Seat 1: vergießet folded before Flop (didn't bet)
Seat 2: wesa280 (button) folded before Flop (didn't bet)
Seat 3: hornetsvp (small blind) folded before Flop
Seat 5: and_sp6 (big blind) folded before Flop
Seat 6: Sergey_Bolos collected ($0.25)



PokerStars Hand #222950243528:  Hold'em No Limit ($0.05/$0.10 USD) - 2021/01/23 5:59:51 ET
Table 'Polydoros II' 6-max Seat #3 is the button
Seat 1: vergießet ($9.23 in chips) 
Seat 2: wesa280 ($20.07 in chips) 
Seat 3: hornetsvp ($10.05 in chips) 
Seat 5: and_sp6 ($10 in chips) 
Seat 6: Sergey_Bolos ($36.83 in chips) 
and_sp6: posts small blind $0.05
Sergey_Bolos: posts big blind $0.10
*** HOLE CARDS ***
vergießet: calls $0.10
wesa280: calls $0.10
hornetsvp: folds 
and_sp6: folds 
Sergey_Bolos: checks 
*** FLOP *** [Ts Qh Th]
Sergey_Bolos: checks 
vergießet: checks 
wesa280: checks 
*** TURN *** [Ts Qh Th] [8s]
Sergey_Bolos: checks 
vergießet: checks 
wesa280: checks 
*** RIVER *** [Ts Qh Th 8s] [6d]
Sergey_Bolos: checks 
vergießet: checks 
wesa280: bets $2
Sergey_Bolos: folds 
vergießet: folds 
Uncalled bet ($2) returned to wesa280
wesa280 collected $0.33 from pot
wesa280: doesn't show hand 
*** SUMMARY ***
Total pot $0.35 | Rake $0.02 
Board [Ts Qh Th 8s 6d]
Seat 1: vergießet folded on the River
Seat 2: wesa280 collected ($0.33)
Seat 3: hornetsvp (button) folded before Flop (didn't bet)
Seat 5: and_sp6 (small blind) folded before Flop
Seat 6: Sergey_Bolos (big blind) folded on the River



PokerStars Hand #222950260597:  Hold'em No Limit ($0.05/$0.10 USD) - 2021/01/23 6:00:50 ET
Table 'Polydoros II' 6-max Seat #5 is the button
Seat 1: vergießet ($9.13 in chips) 
Seat 2: wesa280 ($20.30 in chips) 
Seat 3: hornetsvp ($10.05 in chips) 
Seat 5: and_sp6 ($10 in chips) 
Seat 6: Sergey_Bolos ($36.73 in chips) 
Sergey_Bolos: posts small blind $0.05
vergießet: posts big blind $0.10
*** HOLE CARDS ***
wesa280: calls $0.10
hornetsvp: folds 
and_sp6: folds 
Sergey_Bolos: folds 
vergießet: checks 
*** FLOP *** [4c Kc 2c]
vergießet: checks 
wesa280: checks 
*** TURN *** [4c Kc 2c] [Jh]
vergießet: checks 
wesa280: bets $0.10
vergießet: folds 
Uncalled bet ($0.10) returned to wesa280
wesa280 collected $0.24 from pot
wesa280: doesn't show hand 
*** SUMMARY ***
Total pot $0.25 | Rake $0.01 
Board [4c Kc 2c Jh]
Seat 1: vergießet (big blind) folded on the Turn
Seat 2: wesa280 collected ($0.24)
Seat 3: hornetsvp folded before Flop (didn't bet)
Seat 5: and_sp6 (button) folded before Flop (didn't bet)
Seat 6: Sergey_Bolos (small blind) folded before Flop



PokerStars Hand #222950267032:  Hold'em No Limit ($0.05/$0.10 USD) - 2021/01/23 6:01:11 ET
Table 'Polydoros II' 6-max Seat #6 is the button
Seat 1: vergießet ($9.03 in chips) 
Seat 2: wesa280 ($20.44 in chips) 
Seat 3: hornetsvp ($10.05 in chips) 
Seat 5: and_sp6 ($10 in chips) 
Seat 6: Sergey_Bolos ($36.68 in chips) 
vergießet: posts small blind $0.05
wesa280: posts big blind $0.10
*** HOLE CARDS ***
hornetsvp: folds 
and_sp6: folds 
Sergey_Bolos: raises $0.15 to $0.25
vergießet: folds 
wesa280: calls $0.15
*** FLOP *** [9d Ts Js]
wesa280: checks 
Sergey_Bolos: checks 
*** TURN *** [9d Ts Js] [Ks]
wesa280: checks 
Sergey_Bolos: checks 
*** RIVER *** [9d Ts Js Ks] [9c]
wesa280: bets $2
Sergey_Bolos: folds 
Uncalled bet ($2) returned to wesa280
wesa280 collected $0.53 from pot
wesa280: doesn't show hand 
*** SUMMARY ***
Total pot $0.55 | Rake $0.02 
Board [9d Ts Js Ks 9c]
Seat 1: vergießet (small blind) folded before Flop
Seat 2: wesa280 (big blind) collected ($0.53)
Seat 3: hornetsvp folded before Flop (didn't bet)
Seat 5: and_sp6 folded before Flop (didn't bet)
Seat 6: Sergey_Bolos (button) folded on the River



PokerStars Hand #222950281713:  Hold'em No Limit ($0.05/$0.10 USD) - 2021/01/23 6:01:56 ET
Table 'Polydoros II' 6-max Seat #1 is the button
Seat 1: vergießet ($8.98 in chips) 
Seat 2: wesa280 ($20.72 in chips) 
Seat 3: hornetsvp ($10.05 in chips) 
Seat 5: and_sp6 ($10 in chips) 
Seat 6: Sergey_Bolos ($36.43 in chips) 
wesa280: posts small blind $0.05
hornetsvp: posts big blind $0.10
3EBC96: sits out 
*** HOLE CARDS ***
and_sp6: folds 
Sergey_Bolos: folds 
vergießet: folds 
wesa280: calls $0.05
hornetsvp: checks 
*** FLOP *** [Tc Th 9c]
wesa280: bets $0.10
hornetsvp: folds 
Uncalled bet ($0.10) returned to wesa280
wesa280 collected $0.19 from pot
wesa280: doesn't show hand 
*** SUMMARY ***
Total pot $0.20 | Rake $0.01 
Board [Tc Th 9c]
Seat 1: vergießet (button) folded before Flop (didn't bet)
Seat 2: wesa280 (small blind) collected ($0.19)
Seat 3: hornetsvp (big blind) folded on the Flop
Seat 5: and_sp6 folded before Flop (didn't bet)
Seat 6: Sergey_Bolos folded before Flop (didn't bet)



PokerStars Hand #222950293536:  Hold'em No Limit ($0.05/$0.10 USD) - 2021/01/23 6:02:33 ET
Table 'Polydoros II' 6-max Seat #2 is the button
Seat 1: vergießet ($8.98 in chips) 
Seat 2: wesa280 ($20.81 in chips) 
Seat 3: hornetsvp ($10 in chips) 
Seat 4: 3EBC96 ($10.73 in chips) 
Seat 5: and_sp6 ($10 in chips) 
Seat 6: Sergey_Bolos ($36.43 in chips) 
hornetsvp: posts small blind $0.05
3EBC96: posts big blind $0.10
*** HOLE CARDS ***
and_sp6: folds 
Sergey_Bolos: folds 
vergießet: raises $0.25 to $0.35
wesa280: folds 
hornetsvp: folds 
3EBC96: raises $0.85 to $1.20
vergießet: calls $0.85
*** FLOP *** [6h Th 9s]
3EBC96: bets $0.77
vergießet: calls $0.77
*** TURN *** [6h Th 9s] [3h]
3EBC96: bets $1.91
vergießet: calls $1.91
*** RIVER *** [6h Th 9s 3h] [2d]
3EBC96: checks 
vergießet: bets $3.73
3EBC96: raises $3.12 to $6.85 and is all-in
vergießet: calls $1.37 and is all-in
Uncalled bet ($1.75) returned to 3EBC96
*** SHOW DOWN ***
3EBC96: shows [Ts Td] (three of a kind, Tens)
vergießet: shows [Qc Kc] (high card King)
3EBC96 collected $17.20 from pot
*** SUMMARY ***
Total pot $18.01 | Rake $0.81 
Board [6h Th 9s 3h 2d]
Seat 1: vergießet showed [Qc Kc] and lost with high card King
Seat 2: wesa280 (button) folded before Flop (didn't bet)
Seat 3: hornetsvp (small blind) folded before Flop
Seat 4: 3EBC96 (big blind) showed [Ts Td] and won ($17.20) with three of a kind, Tens
Seat 5: and_sp6 folded before Flop (didn't bet)
Seat 6: Sergey_Bolos folded before Flop (didn't bet)



PokerStars Hand #222950310478:  Hold'em No Limit ($0.05/$0.10 USD) - 2021/01/23 6:03:26 ET
Table 'Polydoros II' 6-max Seat #3 is the button
Seat 2: wesa280 ($20.81 in chips) 
Seat 3: hornetsvp ($9.95 in chips) 
Seat 4: 3EBC96 ($18.95 in chips) 
Seat 5: and_sp6 ($10 in chips) 
Seat 6: Sergey_Bolos ($36.43 in chips) 
3EBC96: posts small blind $0.05
and_sp6: posts big blind $0.10
*** HOLE CARDS ***
Sergey_Bolos: folds 
wesa280: calls $0.10
hornetsvp: folds 
3EBC96: folds 
vergießet leaves the table
and_sp6: checks 
*** FLOP *** [4c Ts 9d]
and_sp6: checks 
wesa280: checks 
*** TURN *** [4c Ts 9d] [4d]
Matbrown27 joins the table at seat #1 
and_sp6: bets $0.20
wesa280: folds 
Uncalled bet ($0.20) returned to and_sp6
and_sp6 collected $0.24 from pot
and_sp6: doesn't show hand 
*** SUMMARY ***
Total pot $0.25 | Rake $0.01 
Board [4c Ts 9d 4d]
Seat 2: wesa280 folded on the Turn
Seat 3: hornetsvp (button) folded before Flop (didn't bet)
Seat 4: 3EBC96 (small blind) folded before Flop
Seat 5: and_sp6 (big blind) collected ($0.24)
Seat 6: Sergey_Bolos folded before Flop (didn't bet)



PokerStars Hand #222950317126:  Hold'em No Limit ($0.05/$0.10 USD) - 2021/01/23 6:03:47 ET
Table 'Polydoros II' 6-max Seat #4 is the button
Seat 2: wesa280 ($20.71 in chips) 
Seat 3: hornetsvp ($9.95 in chips) 
Seat 4: 3EBC96 ($18.90 in chips) 
Seat 5: and_sp6 ($10.14 in chips) 
Seat 6: Sergey_Bolos ($36.43 in chips) 
and_sp6: posts small blind $0.05
Sergey_Bolos: posts big blind $0.10
Matbrown27: sits out 
*** HOLE CARDS ***
wesa280: calls $0.10
hornetsvp: folds 
3EBC96: folds 
and_sp6: calls $0.05
Sergey_Bolos: checks 
*** FLOP *** [Kh 8s Qs]
and_sp6: checks 
Sergey_Bolos: checks 
wesa280: checks 
*** TURN *** [Kh 8s Qs] [2s]
and_sp6: bets $0.19
Sergey_Bolos: calls $0.19
wesa280: folds 
*** RIVER *** [Kh 8s Qs 2s] [Kd]
and_sp6: bets $0.33
Sergey_Bolos: calls $0.33
*** SHOW DOWN ***
and_sp6: shows [7s Ad] (a pair of Kings)
Sergey_Bolos: shows [Js Qc] (two pair, Kings and Queens)
Sergey_Bolos collected $1.28 from pot
*** SUMMARY ***
Total pot $1.34 | Rake $0.06 
Board [Kh 8s Qs 2s Kd]
Seat 2: wesa280 folded on the Turn
Seat 3: hornetsvp folded before Flop (didn't bet)
Seat 4: 3EBC96 (button) folded before Flop (didn't bet)
Seat 5: and_sp6 (small blind) showed [7s Ad] and lost with a pair of Kings
Seat 6: Sergey_Bolos (big blind) showed [Js Qc] and won ($1.28) with two pair, Kings and Queens



PokerStars Hand #222950332696:  Hold'em No Limit ($0.05/$0.10 USD) - 2021/01/23 6:04:35 ET
Table 'Polydoros II' 6-max Seat #5 is the button
Seat 1: Matbrown27 ($10 in chips) 
Seat 2: wesa280 ($20.61 in chips) 
Seat 3: hornetsvp ($10 in chips) 
Seat 4: 3EBC96 ($18.90 in chips) 
Seat 5: and_sp6 ($10 in chips) 
Seat 6: Sergey_Bolos ($37.09 in chips) 
Sergey_Bolos: posts small blind $0.05
Matbrown27: posts big blind $0.10
*** HOLE CARDS ***
wesa280: calls $0.10
hornetsvp: folds 
3EBC96: folds 
and_sp6: raises $0.35 to $0.45
Sergey_Bolos: raises $0.95 to $1.40
Matbrown27: folds 
wesa280: folds 
and_sp6: calls $0.95
*** FLOP *** [5s 8h Jc]
Sergey_Bolos: bets $1.92
and_sp6: calls $1.92
*** TURN *** [5s 8h Jc] [2c]
Sergey_Bolos: bets $10.25
and_sp6: folds 
Uncalled bet ($10.25) returned to Sergey_Bolos
Sergey_Bolos collected $6.53 from pot
Sergey_Bolos: doesn't show hand 
*** SUMMARY ***
Total pot $6.84 | Rake $0.31 
Board [5s 8h Jc 2c]
Seat 1: Matbrown27 (big blind) folded before Flop
Seat 2: wesa280 folded before Flop
Seat 3: hornetsvp folded before Flop (didn't bet)
Seat 4: 3EBC96 folded before Flop (didn't bet)
Seat 5: and_sp6 (button) folded on the Turn
Seat 6: Sergey_Bolos (small blind) collected ($6.53)



PokerStars Hand #222950356939:  Hold'em No Limit ($0.05/$0.10 USD) - 2021/01/23 6:05:50 ET
Table 'Polydoros II' 6-max Seat #6 is the button
Seat 1: Matbrown27 ($9.90 in chips) 
Seat 2: wesa280 ($20.51 in chips) 
Seat 3: hornetsvp ($10 in chips) 
Seat 4: 3EBC96 ($18.90 in chips) 
Seat 5: and_sp6 ($10 in chips) 
Seat 6: Sergey_Bolos ($40.30 in chips) 
Matbrown27: posts small blind $0.05
wesa280: posts big blind $0.10
*** HOLE CARDS ***
hornetsvp: folds 
3EBC96: raises $0.20 to $0.30
and_sp6: folds 
Sergey_Bolos: folds 
Matbrown27: folds 
wesa280: calls $0.20
*** FLOP *** [5s 5h 2d]
wesa280: checks 
3EBC96: checks 
*** TURN *** [5s 5h 2d] [Jd]
wesa280: checks 
3EBC96: checks 
*** RIVER *** [5s 5h 2d Jd] [2c]
wesa280: bets $2
3EBC96: folds 
Uncalled bet ($2) returned to wesa280
wesa280 collected $0.62 from pot
wesa280: doesn't show hand 
*** SUMMARY ***
Total pot $0.65 | Rake $0.03 
Board [5s 5h 2d Jd 2c]
Seat 1: Matbrown27 (small blind) folded before Flop
Seat 2: wesa280 (big blind) collected ($0.62)
Seat 3: hornetsvp folded before Flop (didn't bet)
Seat 4: 3EBC96 folded on the River
Seat 5: and_sp6 folded before Flop (didn't bet)
Seat 6: Sergey_Bolos (button) folded before Flop (didn't bet)



PokerStars Hand #222950369935:  Hold'em No Limit ($0.05/$0.10 USD) - 2021/01/23 6:06:31 ET
Table 'Polydoros II' 6-max Seat #1 is the button
Seat 1: Matbrown27 ($9.85 in chips) 
Seat 2: wesa280 ($20.83 in chips) 
Seat 3: hornetsvp ($10 in chips) 
Seat 4: 3EBC96 ($18.60 in chips) 
Seat 5: and_sp6 ($10 in chips) 
Seat 6: Sergey_Bolos ($40.30 in chips) 
wesa280: posts small blind $0.05
hornetsvp: posts big blind $0.10
*** HOLE CARDS ***
3EBC96: folds 
and_sp6: raises $0.20 to $0.30
Sergey_Bolos: folds 
Matbrown27: folds 
wesa280: folds 
hornetsvp: folds 
Uncalled bet ($0.20) returned to and_sp6
and_sp6 collected $0.25 from pot
and_sp6: doesn't show hand 
*** SUMMARY ***
Total pot $0.25 | Rake $0 
Seat 1: Matbrown27 (button) folded before Flop (didn't bet)
Seat 2: wesa280 (small blind) folded before Flop
Seat 3: hornetsvp (big blind) folded before Flop
Seat 4: 3EBC96 folded before Flop (didn't bet)
Seat 5: and_sp6 collected ($0.25)
Seat 6: Sergey_Bolos folded before Flop (didn't bet)



PokerStars Hand #222950376829:  Hold'em No Limit ($0.05/$0.10 USD) - 2021/01/23 6:06:52 ET
Table 'Polydoros II' 6-max Seat #2 is the button
Seat 1: Matbrown27 ($9.85 in chips) 
Seat 2: wesa280 ($20.78 in chips) 
Seat 3: hornetsvp ($9.90 in chips) 
Seat 4: 3EBC96 ($18.60 in chips) 
Seat 5: and_sp6 ($10.15 in chips) 
Seat 6: Sergey_Bolos ($40.30 in chips) 
hornetsvp: posts small blind $0.05
3EBC96: posts big blind $0.10
*** HOLE CARDS ***
and_sp6: raises $0.20 to $0.30
Sergey_Bolos: folds 
Matbrown27: raises $0.75 to $1.05
wesa280: folds 
hornetsvp: folds 
3EBC96: folds 
and_sp6: calls $0.75
*** FLOP *** [7s 3d Ad]
and_sp6: checks 
Matbrown27: bets $0.71
and_sp6: calls $0.71
*** TURN *** [7s 3d Ad] [2d]
and_sp6: checks 
Matbrown27: bets $1.16
and_sp6: calls $1.16
*** RIVER *** [7s 3d Ad 2d] [Qh]
and_sp6: checks 
Matbrown27: checks 
*** SHOW DOWN ***
and_sp6: shows [Kd As] (a pair of Aces)
Matbrown27: mucks hand 
and_sp6 collected $5.72 from pot
*** SUMMARY ***
Total pot $5.99 | Rake $0.27 
Board [7s 3d Ad 2d Qh]
Seat 1: Matbrown27 mucked
Seat 2: wesa280 (button) folded before Flop (didn't bet)
Seat 3: hornetsvp (small blind) folded before Flop
Seat 4: 3EBC96 (big blind) folded before Flop
Seat 5: and_sp6 showed [Kd As] and won ($5.72) with a pair of Aces
Seat 6: Sergey_Bolos folded before Flop (didn't bet)



PokerStars Hand #222950395023:  Hold'em No Limit ($0.05/$0.10 USD) - 2021/01/23 6:07:48 ET
Table 'Polydoros II' 6-max Seat #3 is the button
Seat 1: Matbrown27 ($8.13 in chips) 
Seat 2: wesa280 ($20.78 in chips) 
Seat 3: hornetsvp ($9.85 in chips) 
Seat 4: 3EBC96 ($18.50 in chips) 
Seat 5: and_sp6 ($12.95 in chips) 
Seat 6: Sergey_Bolos ($40.30 in chips) 
3EBC96: posts small blind $0.05
and_sp6: posts big blind $0.10
*** HOLE CARDS ***
Sergey_Bolos: folds 
Matbrown27: folds 
wesa280: calls $0.10
hornetsvp: folds 
3EBC96: folds 
and_sp6: checks 
*** FLOP *** [Ah Qh 5d]
and_sp6: checks 
wesa280: bets $0.10
and_sp6: folds 
Uncalled bet ($0.10) returned to wesa280
wesa280 collected $0.24 from pot
wesa280: doesn't show hand 
*** SUMMARY ***
Total pot $0.25 | Rake $0.01 
Board [Ah Qh 5d]
Seat 1: Matbrown27 folded before Flop (didn't bet)
Seat 2: wesa280 collected ($0.24)
Seat 3: hornetsvp (button) folded before Flop (didn't bet)
Seat 4: 3EBC96 (small blind) folded before Flop
Seat 5: and_sp6 (big blind) folded on the Flop
Seat 6: Sergey_Bolos folded before Flop (didn't bet)



PokerStars Hand #222950410431:  Hold'em No Limit ($0.05/$0.10 USD) - 2021/01/23 6:08:35 ET
Table 'Polydoros II' 6-max Seat #4 is the button
Seat 1: Matbrown27 ($10 in chips) 
Seat 2: wesa280 ($20.92 in chips) 
Seat 3: hornetsvp ($9.85 in chips) 
Seat 4: 3EBC96 ($18.45 in chips) 
Seat 5: and_sp6 ($12.85 in chips) 
Seat 6: Sergey_Bolos ($40.30 in chips) 
and_sp6: posts small blind $0.05
Sergey_Bolos: posts big blind $0.10
*** HOLE CARDS ***
Matbrown27: folds 
wesa280: calls $0.10
hornetsvp: folds 
3EBC96: raises $0.30 to $0.40
and_sp6: folds 
Sergey_Bolos: calls $0.30
wesa280: calls $0.30
*** FLOP *** [Kh 5h 3c]
Sergey_Bolos: checks 
wesa280: checks 
3EBC96: bets $0.60
Sergey_Bolos: folds 
wesa280: folds 
Uncalled bet ($0.60) returned to 3EBC96
3EBC96 collected $1.19 from pot
3EBC96: doesn't show hand 
*** SUMMARY ***
Total pot $1.25 | Rake $0.06 
Board [Kh 5h 3c]
Seat 1: Matbrown27 folded before Flop (didn't bet)
Seat 2: wesa280 folded on the Flop
Seat 3: hornetsvp folded before Flop (didn't bet)
Seat 4: 3EBC96 (button) collected ($1.19)
Seat 5: and_sp6 (small blind) folded before Flop
Seat 6: Sergey_Bolos (big blind) folded on the Flop



PokerStars Hand #222950422801:  Hold'em No Limit ($0.05/$0.10 USD) - 2021/01/23 6:09:13 ET
Table 'Polydoros II' 6-max Seat #5 is the button
Seat 1: Matbrown27 ($10 in chips) 
Seat 2: wesa280 ($20.52 in chips) 
Seat 3: hornetsvp ($9.85 in chips) 
Seat 4: 3EBC96 ($19.24 in chips) 
Seat 5: and_sp6 ($12.80 in chips) 
Seat 6: Sergey_Bolos ($39.90 in chips) 
Sergey_Bolos: posts small blind $0.05
Matbrown27: posts big blind $0.10
*** HOLE CARDS ***
wesa280: calls $0.10
hornetsvp: folds 
3EBC96: folds 
and_sp6: raises $0.35 to $0.45
Sergey_Bolos: folds 
Matbrown27: folds 
wesa280: calls $0.35
*** FLOP *** [7d 8c 5h]
wesa280: checks 
and_sp6: bets $0.50
wesa280: calls $0.50
*** TURN *** [7d 8c 5h] [6s]
wesa280: checks 
and_sp6: bets $1.31
wesa280: calls $1.31
*** RIVER *** [7d 8c 5h 6s] [Qs]
wesa280: bets $18.26 and is all-in
and_sp6: calls $10.54 and is all-in
Uncalled bet ($7.72) returned to wesa280
*** SHOW DOWN ***
wesa280: shows [8d 9h] (a straight, Five to Nine)
and_sp6: shows [9d Ks] (a straight, Five to Nine)
wesa280 collected $12.30 from pot
and_sp6 collected $12.29 from pot
*** SUMMARY ***
Total pot $25.75 | Rake $1.16 
Board [7d 8c 5h 6s Qs]
Seat 1: Matbrown27 (big blind) folded before Flop
Seat 2: wesa280 showed [8d 9h] and won ($12.30) with a straight, Five to Nine
Seat 3: hornetsvp folded before Flop (didn't bet)
Seat 4: 3EBC96 folded before Flop (didn't bet)
Seat 5: and_sp6 (button) showed [9d Ks] and won ($12.29) with a straight, Five to Nine
Seat 6: Sergey_Bolos (small blind) folded before Flop



PokerStars Hand #222950448407:  Hold'em No Limit ($0.05/$0.10 USD) - 2021/01/23 6:10:31 ET
Table 'Polydoros II' 6-max Seat #6 is the button
Seat 1: Matbrown27 ($9.90 in chips) 
Seat 2: wesa280 ($20.02 in chips) 
Seat 3: hornetsvp ($9.85 in chips) 
Seat 4: 3EBC96 ($19.24 in chips) 
Seat 5: and_sp6 ($12.29 in chips) 
Seat 6: Sergey_Bolos ($39.85 in chips) 
Matbrown27: posts small blind $0.05
wesa280: posts big blind $0.10
*** HOLE CARDS ***
hornetsvp: folds 
3EBC96: folds 
and_sp6: folds 
Sergey_Bolos: folds 
Matbrown27: raises $0.15 to $0.25
wesa280: calls $0.15
*** FLOP *** [Ac Kd Td]
Matbrown27: bets $0.29
wesa280: calls $0.29
*** TURN *** [Ac Kd Td] [Qd]
Matbrown27: bets $0.62
wesa280: calls $0.62
*** RIVER *** [Ac Kd Td Qd] [6d]
Matbrown27: bets $4
wesa280: folds 
Uncalled bet ($4) returned to Matbrown27
Matbrown27 collected $2.22 from pot
Matbrown27: doesn't show hand 
*** SUMMARY ***
Total pot $2.32 | Rake $0.10 
Board [Ac Kd Td Qd 6d]
Seat 1: Matbrown27 (small blind) collected ($2.22)
Seat 2: wesa280 (big blind) folded on the River
Seat 3: hornetsvp folded before Flop (didn't bet)
Seat 4: 3EBC96 folded before Flop (didn't bet)
Seat 5: and_sp6 folded before Flop (didn't bet)
Seat 6: Sergey_Bolos (button) folded before Flop (didn't bet)



PokerStars Hand #222950463006:  Hold'em No Limit ($0.05/$0.10 USD) - 2021/01/23 6:11:16 ET
Table 'Polydoros II' 6-max Seat #1 is the button
Seat 1: Matbrown27 ($10.96 in chips) 
Seat 2: wesa280 ($18.86 in chips) 
Seat 3: hornetsvp ($9.85 in chips) 
Seat 4: 3EBC96 ($19.24 in chips) 
Seat 5: and_sp6 ($12.29 in chips) 
Seat 6: Sergey_Bolos ($39.85 in chips) 
wesa280: posts small blind $0.05
hornetsvp: posts big blind $0.10
*** HOLE CARDS ***
3EBC96: folds 
and_sp6: folds 
Sergey_Bolos: raises $0.15 to $0.25
Matbrown27: folds 
wesa280: calls $0.20
hornetsvp: folds 
*** FLOP *** [Ad 8c 8d]
wesa280: checks 
Sergey_Bolos: bets $0.26
wesa280: calls $0.26
*** TURN *** [Ad 8c 8d] [Js]
wesa280: checks 
Sergey_Bolos: bets $0.48
wesa280: calls $0.48
*** RIVER *** [Ad 8c 8d Js] [4d]
wesa280: bets $1
Sergey_Bolos: folds 
Uncalled bet ($1) returned to wesa280
wesa280 collected $1.99 from pot
wesa280: doesn't show hand 
*** SUMMARY ***
Total pot $2.08 | Rake $0.09 
Board [Ad 8c 8d Js 4d]
Seat 1: Matbrown27 (button) folded before Flop (didn't bet)
Seat 2: wesa280 (small blind) collected ($1.99)
Seat 3: hornetsvp (big blind) folded before Flop
Seat 4: 3EBC96 folded before Flop (didn't bet)
Seat 5: and_sp6 folded before Flop (didn't bet)
Seat 6: Sergey_Bolos folded on the River



PokerStars Hand #222950479300:  Hold'em No Limit ($0.05/$0.10 USD) - 2021/01/23 6:12:06 ET
Table 'Polydoros II' 6-max Seat #2 is the button
Seat 1: Matbrown27 ($10.96 in chips) 
Seat 2: wesa280 ($19.86 in chips) 
Seat 3: hornetsvp ($9.75 in chips) 
Seat 4: 3EBC96 ($19.24 in chips) 
Seat 5: and_sp6 ($12.29 in chips) 
Seat 6: Sergey_Bolos ($38.86 in chips) 
hornetsvp: posts small blind $0.05
3EBC96: posts big blind $0.10
*** HOLE CARDS ***
and_sp6: folds 
Sergey_Bolos: folds 
Matbrown27: folds 
wesa280: calls $0.10
hornetsvp: folds 
3EBC96: checks 
*** FLOP *** [4d Ah 8c]
3EBC96: checks 
wesa280: checks 
*** TURN *** [4d Ah 8c] [Kd]
3EBC96: checks 
wesa280: bets $0.70
3EBC96: folds 
Uncalled bet ($0.70) returned to wesa280
wesa280 collected $0.24 from pot
wesa280: doesn't show hand 
*** SUMMARY ***
Total pot $0.25 | Rake $0.01 
Board [4d Ah 8c Kd]
Seat 1: Matbrown27 folded before Flop (didn't bet)
Seat 2: wesa280 (button) collected ($0.24)
Seat 3: hornetsvp (small blind) folded before Flop
Seat 4: 3EBC96 (big blind) folded on the Turn
Seat 5: and_sp6 folded before Flop (didn't bet)
Seat 6: Sergey_Bolos folded before Flop (didn't bet)



PokerStars Hand #222950487106:  Hold'em No Limit ($0.05/$0.10 USD) - 2021/01/23 6:12:31 ET
Table 'Polydoros II' 6-max Seat #3 is the button
Seat 1: Matbrown27 ($10.96 in chips) 
Seat 2: wesa280 ($20 in chips) 
Seat 3: hornetsvp ($9.70 in chips) 
Seat 4: 3EBC96 ($19.14 in chips) 
Seat 5: and_sp6 ($12.29 in chips) 
Seat 6: Sergey_Bolos ($38.86 in chips) 
3EBC96: posts small blind $0.05
and_sp6: posts big blind $0.10
*** HOLE CARDS ***
Sergey_Bolos: folds 
Matbrown27: folds 
wesa280: calls $0.10
hornetsvp: folds 
3EBC96: folds 
and_sp6: checks 
*** FLOP *** [Qh 9d Js]
and_sp6: checks 
wesa280: checks 
*** TURN *** [Qh 9d Js] [2h]
and_sp6: checks 
wesa280: checks 
*** RIVER *** [Qh 9d Js 2h] [6d]
and_sp6: bets $0.20
wesa280: raises $12.20 to $12.40
and_sp6: folds 
Uncalled bet ($12.20) returned to wesa280
wesa280 collected $0.62 from pot
wesa280: doesn't show hand 
*** SUMMARY ***
Total pot $0.65 | Rake $0.03 
Board [Qh 9d Js 2h 6d]
Seat 1: Matbrown27 folded before Flop (didn't bet)
Seat 2: wesa280 collected ($0.62)
Seat 3: hornetsvp (button) folded before Flop (didn't bet)
Seat 4: 3EBC96 (small blind) folded before Flop
Seat 5: and_sp6 (big blind) folded on the River
Seat 6: Sergey_Bolos folded before Flop (didn't bet)



PokerStars Hand #222950507016:  Hold'em No Limit ($0.05/$0.10 USD) - 2021/01/23 6:13:32 ET
Table 'Polydoros II' 6-max Seat #4 is the button
Seat 1: Matbrown27 ($10.96 in chips) 
Seat 2: wesa280 ($20.32 in chips) 
Seat 3: hornetsvp ($9.70 in chips) 
Seat 4: 3EBC96 ($19.09 in chips) 
Seat 5: and_sp6 ($11.99 in chips) 
and_sp6: posts small blind $0.05
Sergey_Bolos: is sitting out 
Matbrown27: posts big blind $0.10
*** HOLE CARDS ***
Sergey_Bolos leaves the table
wesa280: calls $0.10
hornetsvp: folds 
3EBC96: raises $0.20 to $0.30
and_sp6: raises $0.75 to $1.05
Matbrown27: folds 
wesa280: folds 
1.Richmond joins the table at seat #6 
3EBC96: calls $0.75
*** FLOP *** [7h Jc Tc]
and_sp6: checks 
3EBC96: checks 
*** TURN *** [7h Jc Tc] [Ah]
and_sp6: bets $0.73
3EBC96: calls $0.73
*** RIVER *** [7h Jc Tc Ah] [Td]
and_sp6: checks 
3EBC96: checks 
*** SHOW DOWN ***
and_sp6: shows [Ad Kc] (two pair, Aces and Tens)
3EBC96: shows [Ts Ks] (three of a kind, Tens)
3EBC96 collected $3.59 from pot
*** SUMMARY ***
Total pot $3.76 | Rake $0.17 
Board [7h Jc Tc Ah Td]
Seat 1: Matbrown27 (big blind) folded before Flop
Seat 2: wesa280 folded before Flop
Seat 3: hornetsvp folded before Flop (didn't bet)
Seat 4: 3EBC96 (button) showed [Ts Ks] and won ($3.59) with three of a kind, Tens
Seat 5: and_sp6 (small blind) showed [Ad Kc] and lost with two pair, Aces and Tens



PokerStars Hand #222950532225:  Hold'em No Limit ($0.05/$0.10 USD) - 2021/01/23 6:14:50 ET
Table 'Polydoros II' 6-max Seat #5 is the button
Seat 1: Matbrown27 ($10.86 in chips) 
Seat 2: wesa280 ($20.22 in chips) 
Seat 3: hornetsvp ($10 in chips) 
Seat 4: 3EBC96 ($20.90 in chips) 
Seat 5: and_sp6 ($10.21 in chips) 
Matbrown27: posts small blind $0.05
wesa280: posts big blind $0.10
*** HOLE CARDS ***
hornetsvp: folds 
3EBC96: raises $0.20 to $0.30
and_sp6: folds 
Matbrown27: folds 
wesa280: folds 
Uncalled bet ($0.20) returned to 3EBC96
3EBC96 collected $0.25 from pot
3EBC96: doesn't show hand 
*** SUMMARY ***
Total pot $0.25 | Rake $0 
Seat 1: Matbrown27 (small blind) folded before Flop
Seat 2: wesa280 (big blind) folded before Flop
Seat 3: hornetsvp folded before Flop (didn't bet)
Seat 4: 3EBC96 collected ($0.25)
Seat 5: and_sp6 (button) folded before Flop (didn't bet)



PokerStars Hand #222950536144:  Hold'em No Limit ($0.05/$0.10 USD) - 2021/01/23 6:15:02 ET
Table 'Polydoros II' 6-max Seat #1 is the button
Seat 1: Matbrown27 ($10.81 in chips) 
Seat 2: wesa280 ($20.12 in chips) 
Seat 3: hornetsvp ($10 in chips) 
Seat 4: 3EBC96 ($21.05 in chips) 
Seat 5: and_sp6 ($10.21 in chips) 
wesa280: posts small blind $0.05
hornetsvp: posts big blind $0.10
1.Richmond has timed out
1.Richmond: is sitting out 
*** HOLE CARDS ***
3EBC96: raises $0.20 to $0.30
and_sp6: folds 
1.Richmond is disconnected 
Matbrown27: folds 
wesa280: calls $0.25
hornetsvp: folds 
*** FLOP *** [2s 3h 2d]
wesa280: checks 
3EBC96: checks 
*** TURN *** [2s 3h 2d] [9c]
wesa280: bets $0.10
3EBC96: folds 
Uncalled bet ($0.10) returned to wesa280
wesa280 collected $0.67 from pot
wesa280: doesn't show hand 
*** SUMMARY ***
Total pot $0.70 | Rake $0.03 
Board [2s 3h 2d 9c]
Seat 1: Matbrown27 (button) folded before Flop (didn't bet)
Seat 2: wesa280 (small blind) collected ($0.67)
Seat 3: hornetsvp (big blind) folded before Flop
Seat 4: 3EBC96 folded on the Turn
Seat 5: and_sp6 folded before Flop (didn't bet)



PokerStars Hand #222950547087:  Hold'em No Limit ($0.05/$0.10 USD) - 2021/01/23 6:15:35 ET
Table 'Polydoros II' 6-max Seat #2 is the button
Seat 1: Matbrown27 ($10.81 in chips) 
Seat 2: wesa280 ($20.49 in chips) 
Seat 3: hornetsvp ($9.90 in chips) 
Seat 4: 3EBC96 ($20.75 in chips) 
Seat 5: and_sp6 ($10.21 in chips) 
hornetsvp: posts small blind $0.05
3EBC96: posts big blind $0.10
*** HOLE CARDS ***
and_sp6: folds 
Matbrown27: folds 
wesa280: calls $0.10
hornetsvp: folds 
3EBC96: checks 
*** FLOP *** [4c 4s 7c]
3EBC96: checks 
wesa280: checks 
*** TURN *** [4c 4s 7c] [2h]
3EBC96: checks 
wesa280: checks 
*** RIVER *** [4c 4s 7c 2h] [Ad]
3EBC96: checks 
wesa280: bets $0.10
3EBC96: folds 
Uncalled bet ($0.10) returned to wesa280
wesa280 collected $0.24 from pot
wesa280: doesn't show hand 
*** SUMMARY ***
Total pot $0.25 | Rake $0.01 
Board [4c 4s 7c 2h Ad]
Seat 1: Matbrown27 folded before Flop (didn't bet)
Seat 2: wesa280 (button) collected ($0.24)
Seat 3: hornetsvp (small blind) folded before Flop
Seat 4: 3EBC96 (big blind) folded on the River
Seat 5: and_sp6 folded before Flop (didn't bet)



PokerStars Hand #222950558134:  Hold'em No Limit ($0.05/$0.10 USD) - 2021/01/23 6:16:09 ET
Table 'Polydoros II' 6-max Seat #3 is the button
Seat 1: Matbrown27 ($10.81 in chips) 
Seat 2: wesa280 ($20.63 in chips) 
Seat 3: hornetsvp ($10 in chips) 
Seat 4: 3EBC96 ($20.65 in chips) 
Seat 5: and_sp6 ($10.21 in chips) 
3EBC96: posts small blind $0.05
and_sp6: posts big blind $0.10
1.Richmond: sits out 
*** HOLE CARDS ***
Matbrown27: folds 
wesa280: calls $0.10
hornetsvp: folds 
3EBC96: folds 
and_sp6: raises $0.35 to $0.45
wesa280: folds 
Uncalled bet ($0.35) returned to and_sp6
and_sp6 collected $0.25 from pot
and_sp6: doesn't show hand 
*** SUMMARY ***
Total pot $0.25 | Rake $0 
Seat 1: Matbrown27 folded before Flop (didn't bet)
Seat 2: wesa280 folded before Flop
Seat 3: hornetsvp (button) folded before Flop (didn't bet)
Seat 4: 3EBC96 (small blind) folded before Flop
Seat 5: and_sp6 (big blind) collected ($0.25)



PokerStars Hand #222950564380:  Hold'em No Limit ($0.05/$0.10 USD) - 2021/01/23 6:16:28 ET
Table 'Polydoros II' 6-max Seat #4 is the button
Seat 1: Matbrown27 ($10.81 in chips) 
Seat 2: wesa280 ($20.53 in chips) 
Seat 3: hornetsvp ($10 in chips) 
Seat 4: 3EBC96 ($20.60 in chips) 
Seat 5: and_sp6 ($10.36 in chips) 
Seat 6: 1.Richmond ($10 in chips) 
and_sp6: posts small blind $0.05
1.Richmond: posts big blind $0.10
*** HOLE CARDS ***
Matbrown27: folds 
wesa280: calls $0.10
hornetsvp: folds 
3EBC96: folds 
and_sp6: raises $0.35 to $0.45
1.Richmond: folds 
wesa280: calls $0.35
*** FLOP *** [4d 7c Kd]
and_sp6: bets $0.32
wesa280: calls $0.32
*** TURN *** [4d 7c Kd] [Jh]
and_sp6: checks 
wesa280: bets $0.10
and_sp6: calls $0.10
*** RIVER *** [4d 7c Kd Jh] [Ks]
and_sp6: checks 
wesa280: bets $0.70
and_sp6: raises $1.40 to $2.10
wesa280: folds 
Uncalled bet ($1.40) returned to and_sp6
and_sp6 collected $3.09 from pot
and_sp6: doesn't show hand 
*** SUMMARY ***
Total pot $3.24 | Rake $0.15 
Board [4d 7c Kd Jh Ks]
Seat 1: Matbrown27 folded before Flop (didn't bet)
Seat 2: wesa280 folded on the River
Seat 3: hornetsvp folded before Flop (didn't bet)
Seat 4: 3EBC96 (button) folded before Flop (didn't bet)
Seat 5: and_sp6 (small blind) collected ($3.09)
Seat 6: 1.Richmond (big blind) folded before Flop



PokerStars Hand #222950584854:  Hold'em No Limit ($0.05/$0.10 USD) - 2021/01/23 6:17:31 ET
Table 'Polydoros II' 6-max Seat #5 is the button
Seat 1: Matbrown27 ($10.81 in chips) 
Seat 2: wesa280 ($18.96 in chips) 
Seat 3: hornetsvp ($10 in chips) 
Seat 4: 3EBC96 ($20.60 in chips) 
Seat 5: and_sp6 ($11.88 in chips) 
Seat 6: 1.Richmond ($10 in chips) 
1.Richmond: posts small blind $0.05
Matbrown27: posts big blind $0.10
*** HOLE CARDS ***
wesa280: calls $0.10
hornetsvp: folds 
3EBC96: raises $0.20 to $0.30
and_sp6: folds 
1.Richmond: raises $0.80 to $1.10
Matbrown27: folds 
wesa280: folds 
3EBC96: calls $0.80
*** FLOP *** [7s Qd 6d]
1.Richmond: bets $1.30
3EBC96: folds 
Uncalled bet ($1.30) returned to 1.Richmond
1.Richmond collected $2.29 from pot
1.Richmond: doesn't show hand 
*** SUMMARY ***
Total pot $2.40 | Rake $0.11 
Board [7s Qd 6d]
Seat 1: Matbrown27 (big blind) folded before Flop
Seat 2: wesa280 folded before Flop
Seat 3: hornetsvp folded before Flop (didn't bet)
Seat 4: 3EBC96 folded on the Flop
Seat 5: and_sp6 (button) folded before Flop (didn't bet)
Seat 6: 1.Richmond (small blind) collected ($2.29)



PokerStars Hand #222950595305:  Hold'em No Limit ($0.05/$0.10 USD) - 2021/01/23 6:18:03 ET
Table 'Polydoros II' 6-max Seat #6 is the button
Seat 1: Matbrown27 ($10.71 in chips) 
Seat 2: wesa280 ($18.86 in chips) 
Seat 3: hornetsvp ($10 in chips) 
Seat 4: 3EBC96 ($19.50 in chips) 
Seat 5: and_sp6 ($11.88 in chips) 
Seat 6: 1.Richmond ($11.19 in chips) 
Matbrown27: posts small blind $0.05
wesa280: posts big blind $0.10
*** HOLE CARDS ***
hornetsvp: raises $0.15 to $0.25
3EBC96: folds 
and_sp6: folds 
1.Richmond: folds 
Matbrown27: folds 
wesa280: calls $0.15
*** FLOP *** [2s Th Kh]
wesa280: checks 
hornetsvp: checks 
*** TURN *** [2s Th Kh] [Ad]
wesa280: bets $0.10
hornetsvp: calls $0.10
*** RIVER *** [2s Th Kh Ad] [Qh]
wesa280: bets $0.10
hornetsvp: calls $0.10
*** SHOW DOWN ***
wesa280: shows [Qc 5c] (a pair of Queens)
hornetsvp: shows [4s As] (a pair of Aces)
hornetsvp collected $0.91 from pot
*** SUMMARY ***
Total pot $0.95 | Rake $0.04 
Board [2s Th Kh Ad Qh]
Seat 1: Matbrown27 (small blind) folded before Flop
Seat 2: wesa280 (big blind) showed [Qc 5c] and lost with a pair of Queens
Seat 3: hornetsvp showed [4s As] and won ($0.91) with a pair of Aces
Seat 4: 3EBC96 folded before Flop (didn't bet)
Seat 5: and_sp6 folded before Flop (didn't bet)
Seat 6: 1.Richmond (button) folded before Flop (didn't bet)



PokerStars Hand #222950607321:  Hold'em No Limit ($0.05/$0.10 USD) - 2021/01/23 6:18:40 ET
Table 'Polydoros II' 6-max Seat #1 is the button
Seat 1: Matbrown27 ($10.66 in chips) 
Seat 2: wesa280 ($18.41 in chips) 
Seat 3: hornetsvp ($10.46 in chips) 
Seat 4: 3EBC96 ($19.50 in chips) 
Seat 5: and_sp6 ($11.88 in chips) 
Seat 6: 1.Richmond ($11.19 in chips) 
wesa280: posts small blind $0.05
hornetsvp: posts big blind $0.10
*** HOLE CARDS ***
3EBC96: folds 
and_sp6: raises $0.20 to $0.30
1.Richmond: folds 
Matbrown27: folds 
wesa280: calls $0.25
hornetsvp: folds 
*** FLOP *** [2d 8h 6s]
wesa280: bets $0.10
and_sp6: raises $0.20 to $0.30
wesa280: folds 
Uncalled bet ($0.20) returned to and_sp6
and_sp6 collected $0.86 from pot
and_sp6: doesn't show hand 
*** SUMMARY ***
Total pot $0.90 | Rake $0.04 
Board [2d 8h 6s]
Seat 1: Matbrown27 (button) folded before Flop (didn't bet)
Seat 2: wesa280 (small blind) folded on the Flop
Seat 3: hornetsvp (big blind) folded before Flop
Seat 4: 3EBC96 folded before Flop (didn't bet)
Seat 5: and_sp6 collected ($0.86)
Seat 6: 1.Richmond folded before Flop (didn't bet)



PokerStars Hand #222950615226:  Hold'em No Limit ($0.05/$0.10 USD) - 2021/01/23 6:19:04 ET
Table 'Polydoros II' 6-max Seat #2 is the button
Seat 1: Matbrown27 ($10.66 in chips) 
Seat 2: wesa280 ($18.01 in chips) 
Seat 3: hornetsvp ($10.36 in chips) 
Seat 4: 3EBC96 ($19.50 in chips) 
Seat 5: and_sp6 ($12.34 in chips) 
Seat 6: 1.Richmond ($11.19 in chips) 
hornetsvp: posts small blind $0.05
3EBC96: posts big blind $0.10
*** HOLE CARDS ***
and_sp6: folds 
1.Richmond: raises $0.20 to $0.30
Matbrown27: folds 
wesa280: folds 
hornetsvp: folds 
3EBC96: folds 
Uncalled bet ($0.20) returned to 1.Richmond
1.Richmond collected $0.25 from pot
1.Richmond: doesn't show hand 
*** SUMMARY ***
Total pot $0.25 | Rake $0 
Seat 1: Matbrown27 folded before Flop (didn't bet)
Seat 2: wesa280 (button) folded before Flop (didn't bet)
Seat 3: hornetsvp (small blind) folded before Flop
Seat 4: 3EBC96 (big blind) folded before Flop
Seat 5: and_sp6 folded before Flop (didn't bet)
Seat 6: 1.Richmond collected ($0.25)



PokerStars Hand #222950618989:  Hold'em No Limit ($0.05/$0.10 USD) - 2021/01/23 6:19:16 ET
Table 'Polydoros II' 6-max Seat #3 is the button
Seat 1: Matbrown27 ($10.66 in chips) 
Seat 2: wesa280 ($18.01 in chips) 
Seat 3: hornetsvp ($10.31 in chips) 
Seat 4: 3EBC96 ($19.40 in chips) 
Seat 5: and_sp6 ($12.34 in chips) 
Seat 6: 1.Richmond ($11.34 in chips) 
3EBC96: posts small blind $0.05
and_sp6: posts big blind $0.10
*** HOLE CARDS ***
1.Richmond: folds 
Matbrown27: folds 
wesa280: calls $0.10
hornetsvp: folds 
3EBC96: folds 
and_sp6: raises $0.40 to $0.50
wesa280: calls $0.40
*** FLOP *** [3s 9d Jc]
and_sp6: checks 
wesa280: bets $0.10
and_sp6: calls $0.10
*** TURN *** [3s 9d Jc] [Qc]
and_sp6: checks 
wesa280: checks 
*** RIVER *** [3s 9d Jc Qc] [7s]
and_sp6: checks 
wesa280: bets $0.10
and_sp6: calls $0.10
*** SHOW DOWN ***
wesa280: shows [5h Th] (high card Queen)
and_sp6: shows [Ad Kh] (high card Ace)
and_sp6 collected $1.38 from pot
*** SUMMARY ***
Total pot $1.45 | Rake $0.07 
Board [3s 9d Jc Qc 7s]
Seat 1: Matbrown27 folded before Flop (didn't bet)
Seat 2: wesa280 showed [5h Th] and lost with high card Queen
Seat 3: hornetsvp (button) folded before Flop (didn't bet)
Seat 4: 3EBC96 (small blind) folded before Flop
Seat 5: and_sp6 (big blind) showed [Ad Kh] and won ($1.38) with high card Ace
Seat 6: 1.Richmond folded before Flop (didn't bet)



PokerStars Hand #222950635698:  Hold'em No Limit ($0.05/$0.10 USD) - 2021/01/23 6:20:06 ET
Table 'Polydoros II' 6-max Seat #4 is the button
Seat 1: Matbrown27 ($10.66 in chips) 
Seat 2: wesa280 ($17.31 in chips) 
Seat 3: hornetsvp ($10.31 in chips) 
Seat 4: 3EBC96 ($19.35 in chips) 
Seat 5: and_sp6 ($13.02 in chips) 
Seat 6: 1.Richmond ($11.34 in chips) 
and_sp6: posts small blind $0.05
1.Richmond: posts big blind $0.10
*** HOLE CARDS ***
Matbrown27: folds 
wesa280: folds 
hornetsvp: folds 
3EBC96: raises $0.20 to $0.30
and_sp6: folds 
1.Richmond: folds 
Uncalled bet ($0.20) returned to 3EBC96
3EBC96 collected $0.25 from pot
3EBC96: doesn't show hand 
*** SUMMARY ***
Total pot $0.25 | Rake $0 
Seat 1: Matbrown27 folded before Flop (didn't bet)
Seat 2: wesa280 folded before Flop (didn't bet)
Seat 3: hornetsvp folded before Flop (didn't bet)
Seat 4: 3EBC96 (button) collected ($0.25)
Seat 5: and_sp6 (small blind) folded before Flop
Seat 6: 1.Richmond (big blind) folded before Flop



PokerStars Hand #222950642504:  Hold'em No Limit ($0.05/$0.10 USD) - 2021/01/23 6:20:26 ET
Table 'Polydoros II' 6-max Seat #5 is the button
Seat 1: Matbrown27 ($10.66 in chips) 
Seat 2: wesa280 ($17.31 in chips) 
Seat 3: hornetsvp ($10.31 in chips) 
Seat 4: 3EBC96 ($19.50 in chips) 
Seat 5: and_sp6 ($12.97 in chips) 
Seat 6: 1.Richmond ($11.24 in chips) 
1.Richmond: posts small blind $0.05
Matbrown27: posts big blind $0.10
*** HOLE CARDS ***
wesa280: folds 
hornetsvp: folds 
3EBC96: folds 
and_sp6: raises $0.15 to $0.25
1.Richmond: folds 
Matbrown27: calls $0.15
*** FLOP *** [Td 8d 8s]
Matbrown27: bets $0.32
and_sp6: calls $0.32
*** TURN *** [Td 8d 8s] [Jh]
Matbrown27: bets $0.91
and_sp6: calls $0.91
*** RIVER *** [Td 8d 8s Jh] [9s]
Matbrown27: bets $2.30
and_sp6: folds 
Uncalled bet ($2.30) returned to Matbrown27
Matbrown27 collected $2.87 from pot
Matbrown27: doesn't show hand 
*** SUMMARY ***
Total pot $3.01 | Rake $0.14 
Board [Td 8d 8s Jh 9s]
Seat 1: Matbrown27 (big blind) collected ($2.87)
Seat 2: wesa280 folded before Flop (didn't bet)
Seat 3: hornetsvp folded before Flop (didn't bet)
Seat 4: 3EBC96 folded before Flop (didn't bet)
Seat 5: and_sp6 (button) folded on the River
Seat 6: 1.Richmond (small blind) folded before Flop



PokerStars Hand #222950662701:  Hold'em No Limit ($0.05/$0.10 USD) - 2021/01/23 6:21:28 ET
Table 'Polydoros II' 6-max Seat #6 is the button
Seat 1: Matbrown27 ($12.05 in chips) 
Seat 2: wesa280 ($17.31 in chips) 
Seat 3: hornetsvp ($10.31 in chips) 
Seat 4: 3EBC96 ($19.50 in chips) 
Seat 5: and_sp6 ($11.49 in chips) 
Seat 6: 1.Richmond ($11.19 in chips) 
Matbrown27: posts small blind $0.05
wesa280: posts big blind $0.10
*** HOLE CARDS ***
hornetsvp: folds 
3EBC96: raises $0.20 to $0.30
and_sp6: folds 
1.Richmond: folds 
Matbrown27: folds 
wesa280: calls $0.20
*** FLOP *** [6c Qc 7h]
wesa280: checks 
3EBC96: checks 
*** TURN *** [6c Qc 7h] [5s]
wesa280: checks 
3EBC96: checks 
*** RIVER *** [6c Qc 7h 5s] [Th]
wesa280: bets $0.10
3EBC96: calls $0.10
*** SHOW DOWN ***
wesa280: shows [Jh 5h] (a pair of Fives)
3EBC96: shows [7s Ks] (a pair of Sevens)
3EBC96 collected $0.81 from pot
*** SUMMARY ***
Total pot $0.85 | Rake $0.04 
Board [6c Qc 7h 5s Th]
Seat 1: Matbrown27 (small blind) folded before Flop
Seat 2: wesa280 (big blind) showed [Jh 5h] and lost with a pair of Fives
Seat 3: hornetsvp folded before Flop (didn't bet)
Seat 4: 3EBC96 showed [7s Ks] and won ($0.81) with a pair of Sevens
Seat 5: and_sp6 folded before Flop (didn't bet)
Seat 6: 1.Richmond (button) folded before Flop (didn't bet)



PokerStars Hand #222950676551:  Hold'em No Limit ($0.05/$0.10 USD) - 2021/01/23 6:22:10 ET
Table 'Polydoros II' 6-max Seat #1 is the button
Seat 1: Matbrown27 ($12 in chips) 
Seat 2: wesa280 ($16.91 in chips) 
Seat 3: hornetsvp ($10.31 in chips) 
Seat 4: 3EBC96 ($19.91 in chips) 
Seat 5: and_sp6 ($11.49 in chips) 
Seat 6: 1.Richmond ($11.19 in chips) 
wesa280: posts small blind $0.05
hornetsvp: posts big blind $0.10
*** HOLE CARDS ***
3EBC96: folds 
and_sp6: folds 
1.Richmond: folds 
Matbrown27: raises $0.15 to $0.25
wesa280: calls $0.20
hornetsvp: calls $0.15
*** FLOP *** [As 6h Js]
wesa280: checks 
hornetsvp: checks 
Matbrown27: bets $0.24
wesa280: calls $0.24
hornetsvp: folds 
*** TURN *** [As 6h Js] [8s]
wesa280: checks 
Matbrown27: checks 
*** RIVER *** [As 6h Js 8s] [Jd]
wesa280: bets $1
Matbrown27: folds 
Uncalled bet ($1) returned to wesa280
wesa280 collected $1.17 from pot
wesa280: doesn't show hand 
*** SUMMARY ***
Total pot $1.23 | Rake $0.06 
Board [As 6h Js 8s Jd]
Seat 1: Matbrown27 (button) folded on the River
Seat 2: wesa280 (small blind) collected ($1.17)
Seat 3: hornetsvp (big blind) folded on the Flop
Seat 4: 3EBC96 folded before Flop (didn't bet)
Seat 5: and_sp6 folded before Flop (didn't bet)
Seat 6: 1.Richmond folded before Flop (didn't bet)



PokerStars Hand #222950703642:  Hold'em No Limit ($0.05/$0.10 USD) - 2021/01/23 6:23:32 ET
Table 'Polydoros II' 6-max Seat #2 is the button
Seat 1: Matbrown27 ($11.51 in chips) 
Seat 2: wesa280 ($17.59 in chips) 
Seat 3: hornetsvp ($10.06 in chips) 
Seat 4: 3EBC96 ($19.91 in chips) 
Seat 5: and_sp6 ($11.49 in chips) 
Seat 6: 1.Richmond ($11.19 in chips) 
hornetsvp: posts small blind $0.05
3EBC96: posts big blind $0.10
*** HOLE CARDS ***
and_sp6: folds 
1.Richmond: raises $0.20 to $0.30
Matbrown27: folds 
wesa280: calls $0.30
hornetsvp: folds 
3EBC96: calls $0.20
*** FLOP *** [Qh Kd Th]
3EBC96: checks 
1.Richmond: bets $0.50
wesa280: folds 
3EBC96: calls $0.50
*** TURN *** [Qh Kd Th] [Td]
3EBC96: checks 
1.Richmond: bets $2.10
3EBC96: folds 
Uncalled bet ($2.10) returned to 1.Richmond
1.Richmond collected $1.86 from pot
1.Richmond: doesn't show hand 
*** SUMMARY ***
Total pot $1.95 | Rake $0.09 
Board [Qh Kd Th Td]
Seat 1: Matbrown27 folded before Flop (didn't bet)
Seat 2: wesa280 (button) folded on the Flop
Seat 3: hornetsvp (small blind) folded before Flop
Seat 4: 3EBC96 (big blind) folded on the Turn
Seat 5: and_sp6 folded before Flop (didn't bet)
Seat 6: 1.Richmond collected ($1.86)



PokerStars Hand #222950719108:  Hold'em No Limit ($0.05/$0.10 USD) - 2021/01/23 6:24:18 ET
Table 'Polydoros II' 6-max Seat #3 is the button
Seat 1: Matbrown27 ($11.51 in chips) 
Seat 2: wesa280 ($17.29 in chips) 
Seat 3: hornetsvp ($10.01 in chips) 
Seat 4: 3EBC96 ($19.11 in chips) 
Seat 5: and_sp6 ($11.49 in chips) 
Seat 6: 1.Richmond ($12.25 in chips) 
3EBC96: posts small blind $0.05
and_sp6: posts big blind $0.10
*** HOLE CARDS ***
1.Richmond: folds 
Matbrown27: folds 
wesa280: folds 
hornetsvp: folds 
3EBC96: raises $0.20 to $0.30
and_sp6: folds 
Uncalled bet ($0.20) returned to 3EBC96
3EBC96 collected $0.20 from pot
3EBC96: doesn't show hand 
*** SUMMARY ***
Total pot $0.20 | Rake $0 
Seat 1: Matbrown27 folded before Flop (didn't bet)
Seat 2: wesa280 folded before Flop (didn't bet)
Seat 3: hornetsvp (button) folded before Flop (didn't bet)
Seat 4: 3EBC96 (small blind) collected ($0.20)
Seat 5: and_sp6 (big blind) folded before Flop
Seat 6: 1.Richmond folded before Flop (didn't bet)



PokerStars Hand #222950725688:  Hold'em No Limit ($0.05/$0.10 USD) - 2021/01/23 6:24:38 ET
Table 'Polydoros II' 6-max Seat #4 is the button
Seat 1: Matbrown27 ($11.51 in chips) 
Seat 2: wesa280 ($17.29 in chips) 
Seat 3: hornetsvp ($10.01 in chips) 
Seat 4: 3EBC96 ($19.21 in chips) 
Seat 5: and_sp6 ($11.39 in chips) 
Seat 6: 1.Richmond ($12.25 in chips) 
and_sp6: posts small blind $0.05
1.Richmond: posts big blind $0.10
*** HOLE CARDS ***
Matbrown27: raises $0.15 to $0.25
wesa280: calls $0.25
hornetsvp: folds 
3EBC96: folds 
and_sp6: folds 
1.Richmond: folds 
*** FLOP *** [6d Qs Qh]
Matbrown27: checks 
wesa280: bets $0.10
Matbrown27: calls $0.10
*** TURN *** [6d Qs Qh] [4s]
Matbrown27: checks 
wesa280: bets $0.10
Matbrown27: calls $0.10
*** RIVER *** [6d Qs Qh 4s] [7d]
Matbrown27: checks 
wesa280: bets $0.10
Matbrown27: calls $0.10
*** SHOW DOWN ***
wesa280: shows [Ks 3c] (a pair of Queens)
Matbrown27: shows [Ad Jh] (a pair of Queens - Ace kicker)
Matbrown27 collected $1.19 from pot
*** SUMMARY ***
Total pot $1.25 | Rake $0.06 
Board [6d Qs Qh 4s 7d]
Seat 1: Matbrown27 showed [Ad Jh] and won ($1.19) with a pair of Queens
Seat 2: wesa280 showed [Ks 3c] and lost with a pair of Queens
Seat 3: hornetsvp folded before Flop (didn't bet)
Seat 4: 3EBC96 (button) folded before Flop (didn't bet)
Seat 5: and_sp6 (small blind) folded before Flop
Seat 6: 1.Richmond (big blind) folded before Flop



PokerStars Hand #222950741584:  Hold'em No Limit ($0.05/$0.10 USD) - 2021/01/23 6:25:26 ET
Table 'Polydoros II' 6-max Seat #5 is the button
Seat 1: Matbrown27 ($12.15 in chips) 
Seat 2: wesa280 ($16.74 in chips) 
Seat 3: hornetsvp ($10.01 in chips) 
Seat 4: 3EBC96 ($19.21 in chips) 
Seat 5: and_sp6 ($11.34 in chips) 
Seat 6: 1.Richmond ($12.15 in chips) 
1.Richmond: posts small blind $0.05
Matbrown27: posts big blind $0.10
*** HOLE CARDS ***
wesa280: calls $0.10
hornetsvp: folds 
3EBC96: folds 
and_sp6: folds 
1.Richmond: calls $0.05
Matbrown27: checks 
*** FLOP *** [Jc 2d Qd]
1.Richmond: checks 
Matbrown27: checks 
wesa280: checks 
*** TURN *** [Jc 2d Qd] [Ks]
1.Richmond: bets $0.15
Matbrown27: folds 
wesa280: calls $0.15
*** RIVER *** [Jc 2d Qd Ks] [Kd]
1.Richmond: checks 
wesa280: bets $1
1.Richmond: calls $1
*** SHOW DOWN ***
wesa280: shows [Qs 6h] (two pair, Kings and Queens)
1.Richmond: shows [3h Kh] (three of a kind, Kings)
1.Richmond collected $2.48 from pot
*** SUMMARY ***
Total pot $2.60 | Rake $0.12 
Board [Jc 2d Qd Ks Kd]
Seat 1: Matbrown27 (big blind) folded on the Turn
Seat 2: wesa280 showed [Qs 6h] and lost with two pair, Kings and Queens
Seat 3: hornetsvp folded before Flop (didn't bet)
Seat 4: 3EBC96 folded before Flop (didn't bet)
Seat 5: and_sp6 (button) folded before Flop (didn't bet)
Seat 6: 1.Richmond (small blind) showed [3h Kh] and won ($2.48) with three of a kind, Kings



PokerStars Hand #222950756667:  Hold'em No Limit ($0.05/$0.10 USD) - 2021/01/23 6:26:11 ET
Table 'Polydoros II' 6-max Seat #6 is the button
Seat 1: Matbrown27 ($12.05 in chips) 
Seat 2: wesa280 ($15.49 in chips) 
Seat 3: hornetsvp ($10.01 in chips) 
Seat 4: 3EBC96 ($19.21 in chips) 
Seat 5: and_sp6 ($11.34 in chips) 
Seat 6: 1.Richmond ($13.38 in chips) 
Matbrown27: posts small blind $0.05
wesa280: posts big blind $0.10
*** HOLE CARDS ***
hornetsvp: raises $0.15 to $0.25
3EBC96: folds 
and_sp6: folds 
1.Richmond: folds 
Matbrown27: folds 
wesa280: calls $0.15
*** FLOP *** [6d 5c Qc]
wesa280: checks 
hornetsvp: bets $0.40
wesa280: folds 
Uncalled bet ($0.40) returned to hornetsvp
hornetsvp collected $0.53 from pot
hornetsvp: doesn't show hand 
*** SUMMARY ***
Total pot $0.55 | Rake $0.02 
Board [6d 5c Qc]
Seat 1: Matbrown27 (small blind) folded before Flop
Seat 2: wesa280 (big blind) folded on the Flop
Seat 3: hornetsvp collected ($0.53)
Seat 4: 3EBC96 folded before Flop (didn't bet)
Seat 5: and_sp6 folded before Flop (didn't bet)
Seat 6: 1.Richmond (button) folded before Flop (didn't bet)



PokerStars Hand #222950764131:  Hold'em No Limit ($0.05/$0.10 USD) - 2021/01/23 6:26:34 ET
Table 'Polydoros II' 6-max Seat #1 is the button
Seat 1: Matbrown27 ($12 in chips) 
Seat 2: wesa280 ($15.24 in chips) 
Seat 3: hornetsvp ($10.29 in chips) 
Seat 4: 3EBC96 ($19.21 in chips) 
Seat 5: and_sp6 ($11.34 in chips) 
Seat 6: 1.Richmond ($13.38 in chips) 
wesa280: posts small blind $0.05
hornetsvp: posts big blind $0.10
*** HOLE CARDS ***
3EBC96: folds 
and_sp6: folds 
1.Richmond: folds 
Matbrown27: folds 
wesa280: calls $0.05
hornetsvp: checks 
*** FLOP *** [6s 7s Jc]
wesa280: checks 
hornetsvp: checks 
*** TURN *** [6s 7s Jc] [As]
wesa280: checks 
hornetsvp: checks 
*** RIVER *** [6s 7s Jc As] [4h]
wesa280: bets $10
hornetsvp: calls $10
*** SHOW DOWN ***
wesa280: shows [Jd Ac] (two pair, Aces and Jacks)
hornetsvp: mucks hand 
wesa280 collected $19.29 from pot
*** SUMMARY ***
Total pot $20.20 | Rake $0.91 
Board [6s 7s Jc As 4h]
Seat 1: Matbrown27 (button) folded before Flop (didn't bet)
Seat 2: wesa280 (small blind) showed [Jd Ac] and won ($19.29) with two pair, Aces and Jacks
Seat 3: hornetsvp (big blind) mucked
Seat 4: 3EBC96 folded before Flop (didn't bet)
Seat 5: and_sp6 folded before Flop (didn't bet)
Seat 6: 1.Richmond folded before Flop (didn't bet)



PokerStars Hand #222950781169:  Hold'em No Limit ($0.05/$0.10 USD) - 2021/01/23 6:27:25 ET
Table 'Polydoros II' 6-max Seat #2 is the button
Seat 1: Matbrown27 ($12 in chips) 
Seat 2: wesa280 ($24.43 in chips) 
Seat 3: hornetsvp ($0.19 in chips) 
Seat 4: 3EBC96 ($19.21 in chips) 
Seat 5: and_sp6 ($11.34 in chips) 
Seat 6: 1.Richmond ($13.38 in chips) 
hornetsvp: posts small blind $0.05
3EBC96: posts big blind $0.10
*** HOLE CARDS ***
and_sp6: folds 
1.Richmond: folds 
Matbrown27: folds 
wesa280: calls $0.10
hornetsvp: folds 
3EBC96: checks 
*** FLOP *** [2d 3c Td]
3EBC96: checks 
wesa280: checks 
*** TURN *** [2d 3c Td] [Th]
3EBC96: checks 
wesa280: bets $0.10
3EBC96: folds 
Uncalled bet ($0.10) returned to wesa280
wesa280 collected $0.24 from pot
wesa280: doesn't show hand 
*** SUMMARY ***
Total pot $0.25 | Rake $0.01 
Board [2d 3c Td Th]
Seat 1: Matbrown27 folded before Flop (didn't bet)
Seat 2: wesa280 (button) collected ($0.24)
Seat 3: hornetsvp (small blind) folded before Flop
Seat 4: 3EBC96 (big blind) folded on the Turn
Seat 5: and_sp6 folded before Flop (didn't bet)
Seat 6: 1.Richmond folded before Flop (didn't bet)



PokerStars Hand #222950791146:  Hold'em No Limit ($0.05/$0.10 USD) - 2021/01/23 6:27:54 ET
Table 'Polydoros II' 6-max Seat #3 is the button
Seat 1: Matbrown27 ($12 in chips) 
Seat 2: wesa280 ($24.57 in chips) 
Seat 3: hornetsvp ($0.14 in chips) 
Seat 4: 3EBC96 ($19.11 in chips) 
Seat 5: and_sp6 ($11.34 in chips) 
Seat 6: 1.Richmond ($13.38 in chips) 
3EBC96: posts small blind $0.05
and_sp6: posts big blind $0.10
*** HOLE CARDS ***
1.Richmond: folds 
Matbrown27: folds 
wesa280: calls $0.10
hornetsvp: raises $0.04 to $0.14 and is all-in
3EBC96: folds 
and_sp6: folds 
wesa280: calls $0.04
*** FLOP *** [6c 7h Qs]
*** TURN *** [6c 7h Qs] [8s]
*** RIVER *** [6c 7h Qs 8s] [Jd]
*** SHOW DOWN ***
wesa280: shows [2c Ad] (high card Ace)
hornetsvp: shows [Ah Kc] (high card Ace - King kicker)
hornetsvp collected $0.41 from pot
*** SUMMARY ***
Total pot $0.43 | Rake $0.02 
Board [6c 7h Qs 8s Jd]
Seat 1: Matbrown27 folded before Flop (didn't bet)
Seat 2: wesa280 showed [2c Ad] and lost with high card Ace
Seat 3: hornetsvp (button) showed [Ah Kc] and won ($0.41) with high card Ace
Seat 4: 3EBC96 (small blind) folded before Flop
Seat 5: and_sp6 (big blind) folded before Flop
Seat 6: 1.Richmond folded before Flop (didn't bet)



PokerStars Hand #222950805507:  Hold'em No Limit ($0.05/$0.10 USD) - 2021/01/23 6:28:38 ET
Table 'Polydoros II' 6-max Seat #4 is the button
Seat 1: Matbrown27 ($12 in chips) 
Seat 2: wesa280 ($24.43 in chips) 
Seat 3: hornetsvp ($0.41 in chips) 
Seat 4: 3EBC96 ($19.06 in chips) 
Seat 5: and_sp6 ($11.24 in chips) 
Seat 6: 1.Richmond ($13.38 in chips) 
and_sp6: posts small blind $0.05
1.Richmond: posts big blind $0.10
*** HOLE CARDS ***
Matbrown27: folds 
wesa280: calls $0.10
hornetsvp: folds 
3EBC96: folds 
and_sp6: folds 
1.Richmond: raises $0.30 to $0.40
wesa280: calls $0.30
*** FLOP *** [3c Jh Jc]
1.Richmond: bets $0.35
wesa280: calls $0.35
*** TURN *** [3c Jh Jc] [Qh]
1.Richmond: checks 
wesa280: checks 
*** RIVER *** [3c Jh Jc Qh] [Js]
1.Richmond: checks 
wesa280: bets $12.60
1.Richmond: folds 
Uncalled bet ($12.60) returned to wesa280
wesa280 collected $1.48 from pot
wesa280: doesn't show hand 
*** SUMMARY ***
Total pot $1.55 | Rake $0.07 
Board [3c Jh Jc Qh Js]
Seat 1: Matbrown27 folded before Flop (didn't bet)
Seat 2: wesa280 collected ($1.48)
Seat 3: hornetsvp folded before Flop (didn't bet)
Seat 4: 3EBC96 (button) folded before Flop (didn't bet)
Seat 5: and_sp6 (small blind) folded before Flop
Seat 6: 1.Richmond (big blind) folded on the River



PokerStars Hand #222950830165:  Hold'em No Limit ($0.05/$0.10 USD) - 2021/01/23 6:29:52 ET
Table 'Polydoros II' 6-max Seat #5 is the button
Seat 1: Matbrown27 ($12 in chips) 
Seat 2: wesa280 ($25.16 in chips) 
Seat 3: hornetsvp ($10 in chips) 
Seat 4: 3EBC96 ($19.06 in chips) 
Seat 5: and_sp6 ($11.19 in chips) 
Seat 6: 1.Richmond ($12.63 in chips) 
1.Richmond: posts small blind $0.05
Matbrown27: posts big blind $0.10
*** HOLE CARDS ***
wesa280: calls $0.10
hornetsvp: folds 
3EBC96: folds 
and_sp6: folds 
1.Richmond: calls $0.05
Matbrown27: checks 
*** FLOP *** [Kh 3d Ac]
1.Richmond: checks 
Matbrown27: checks 
wesa280: checks 
*** TURN *** [Kh 3d Ac] [5d]
1.Richmond: checks 
Matbrown27: bets $0.10
wesa280: calls $0.10
1.Richmond: calls $0.10
*** RIVER *** [Kh 3d Ac 5d] [Td]
1.Richmond: checks 
Matbrown27: bets $0.19
wesa280: raises $1.59 to $1.78
1.Richmond: folds 
Matbrown27: folds 
Uncalled bet ($1.59) returned to wesa280
wesa280 collected $0.94 from pot
wesa280: doesn't show hand 
*** SUMMARY ***
Total pot $0.98 | Rake $0.04 
Board [Kh 3d Ac 5d Td]
Seat 1: Matbrown27 (big blind) folded on the River
Seat 2: wesa280 collected ($0.94)
Seat 3: hornetsvp folded before Flop (didn't bet)
Seat 4: 3EBC96 folded before Flop (didn't bet)
Seat 5: and_sp6 (button) folded before Flop (didn't bet)
Seat 6: 1.Richmond (small blind) folded on the River



PokerStars Hand #222950848423:  Hold'em No Limit ($0.05/$0.10 USD) - 2021/01/23 6:30:46 ET
Table 'Polydoros II' 6-max Seat #6 is the button
Seat 1: Matbrown27 ($11.61 in chips) 
Seat 2: wesa280 ($25.71 in chips) 
Seat 3: hornetsvp ($10 in chips) 
Seat 4: 3EBC96 ($19.06 in chips) 
Seat 5: and_sp6 ($11.19 in chips) 
Seat 6: 1.Richmond ($12.43 in chips) 
Matbrown27: posts small blind $0.05
wesa280: posts big blind $0.10
*** HOLE CARDS ***
hornetsvp: folds 
3EBC96: raises $0.20 to $0.30
and_sp6: folds 
1.Richmond: folds 
Matbrown27: folds 
wesa280: calls $0.20
*** FLOP *** [2s 2d 9s]
wesa280: checks 
3EBC96: checks 
*** TURN *** [2s 2d 9s] [Kd]
wesa280: checks 
3EBC96: bets $0.31
wesa280: calls $0.31
*** RIVER *** [2s 2d 9s Kd] [Js]
wesa280: bets $1
3EBC96: folds 
Uncalled bet ($1) returned to wesa280
wesa280 collected $1.21 from pot
wesa280: doesn't show hand 
*** SUMMARY ***
Total pot $1.27 | Rake $0.06 
Board [2s 2d 9s Kd Js]
Seat 1: Matbrown27 (small blind) folded before Flop
Seat 2: wesa280 (big blind) collected ($1.21)
Seat 3: hornetsvp folded before Flop (didn't bet)
Seat 4: 3EBC96 folded on the River
Seat 5: and_sp6 folded before Flop (didn't bet)
Seat 6: 1.Richmond (button) folded before Flop (didn't bet)



PokerStars Hand #222950864836:  Hold'em No Limit ($0.05/$0.10 USD) - 2021/01/23 6:31:35 ET
Table 'Polydoros II' 6-max Seat #1 is the button
Seat 1: Matbrown27 ($11.56 in chips) 
Seat 2: wesa280 ($26.31 in chips) 
Seat 4: 3EBC96 ($18.45 in chips) 
Seat 5: and_sp6 ($11.19 in chips) 
Seat 6: 1.Richmond ($12.43 in chips) 
wesa280: posts small blind $0.05
hornetsvp: is sitting out 
3EBC96: posts big blind $0.10
*** HOLE CARDS ***
and_sp6: folds 
1.Richmond: folds 
Matbrown27: raises $0.15 to $0.25
wesa280: calls $0.20
3EBC96: folds 
*** FLOP *** [Ks 9c 8h]
wesa280: bets $0.10
Matbrown27: calls $0.10
*** TURN *** [Ks 9c 8h] [7d]
wesa280: bets $0.10
Matbrown27: calls $0.10
*** RIVER *** [Ks 9c 8h 7d] [4h]
wesa280: checks 
Matbrown27: bets $0.32
wesa280: calls $0.32
*** SHOW DOWN ***
Matbrown27: shows [Td Th] (a pair of Tens)
wesa280: mucks hand 
Matbrown27 collected $1.57 from pot
*** SUMMARY ***
Total pot $1.64 | Rake $0.07 
Board [Ks 9c 8h 7d 4h]
Seat 1: Matbrown27 (button) showed [Td Th] and won ($1.57) with a pair of Tens
Seat 2: wesa280 (small blind) mucked
Seat 4: 3EBC96 (big blind) folded before Flop
Seat 5: and_sp6 folded before Flop (didn't bet)
Seat 6: 1.Richmond folded before Flop (didn't bet)



PokerStars Hand #222950880192:  Hold'em No Limit ($0.05/$0.10 USD) - 2021/01/23 6:32:21 ET
Table 'Polydoros II' 6-max Seat #2 is the button
Seat 1: Matbrown27 ($12.36 in chips) 
Seat 2: wesa280 ($25.54 in chips) 
Seat 4: 3EBC96 ($18.35 in chips) 
Seat 5: and_sp6 ($11.19 in chips) 
Seat 6: 1.Richmond ($12.43 in chips) 
3EBC96: posts small blind $0.05
and_sp6: posts big blind $0.10
*** HOLE CARDS ***
1.Richmond: folds 
Matbrown27: folds 
1.Richmond leaves the table
wesa280: calls $0.10
3EBC96: folds 
and_sp6: checks 
*** FLOP *** [Jh As 5d]
and_sp6: checks 
wesa280: bets $0.10
and_sp6: folds 
Uncalled bet ($0.10) returned to wesa280
wesa280 collected $0.24 from pot
wesa280: doesn't show hand 
*** SUMMARY ***
Total pot $0.25 | Rake $0.01 
Board [Jh As 5d]
Seat 1: Matbrown27 folded before Flop (didn't bet)
Seat 2: wesa280 (button) collected ($0.24)
Seat 4: 3EBC96 (small blind) folded before Flop
Seat 5: and_sp6 (big blind) folded on the Flop
Seat 6: 1.Richmond folded before Flop (didn't bet)



PokerStars Hand #222950894292:  Hold'em No Limit ($0.05/$0.10 USD) - 2021/01/23 6:33:02 ET
Table 'Polydoros II' 6-max Seat #4 is the button
Seat 1: Matbrown27 ($12.36 in chips) 
Seat 2: wesa280 ($25.68 in chips) 
Seat 4: 3EBC96 ($18.30 in chips) 
Seat 5: and_sp6 ($11.09 in chips) 
and_sp6: posts small blind $0.05
Matbrown27: posts big blind $0.10
hornetsvp: sits out 
*** HOLE CARDS ***
wesa280: calls $0.10
3EBC96: folds 
and_sp6: folds 
Matbrown27: checks 
*** FLOP *** [6c 8c 5d]
Matbrown27: checks 
wesa280: checks 
*** TURN *** [6c 8c 5d] [2h]
Matbrown27: checks 
wesa280: checks 
*** RIVER *** [6c 8c 5d 2h] [4s]
Matbrown27: bets $0.19
wesa280: raises $0.19 to $0.38
Matbrown27: calls $0.19
*** SHOW DOWN ***
wesa280: shows [3s Td] (a straight, Deuce to Six)
Matbrown27: shows [2s 3d] (a straight, Deuce to Six)
Matbrown27 collected $0.48 from pot
wesa280 collected $0.48 from pot
*** SUMMARY ***
Total pot $1.01 | Rake $0.05 
Board [6c 8c 5d 2h 4s]
Seat 1: Matbrown27 (big blind) showed [2s 3d] and won ($0.48) with a straight, Deuce to Six
Seat 2: wesa280 showed [3s Td] and won ($0.48) with a straight, Deuce to Six
Seat 4: 3EBC96 (button) folded before Flop (didn't bet)
Seat 5: and_sp6 (small blind) folded before Flop



PokerStars Hand #222950907074:  Hold'em No Limit ($0.05/$0.10 USD) - 2021/01/23 6:33:40 ET
Table 'Polydoros II' 6-max Seat #5 is the button
Seat 1: Matbrown27 ($12.36 in chips) 
Seat 2: wesa280 ($25.68 in chips) 
Seat 4: 3EBC96 ($18.30 in chips) 
Seat 5: and_sp6 ($11.04 in chips) 
Matbrown27: posts small blind $0.05
wesa280: posts big blind $0.10
hornetsvp: sits out 
*** HOLE CARDS ***
3EBC96: raises $0.20 to $0.30
and_sp6: folds 
Matbrown27: folds 
wesa280: calls $0.20
*** FLOP *** [3c Tc 7h]
wesa280: checks 
3EBC96: bets $0.31
wesa280: calls $0.31
*** TURN *** [3c Tc 7h] [5c]
wesa280: bets $0.10
3EBC96: calls $0.10
*** RIVER *** [3c Tc 7h 5c] [4s]
wesa280: checks 
3EBC96: checks 
*** SHOW DOWN ***
wesa280: shows [Js Ks] (high card King)
3EBC96: shows [Td Jh] (a pair of Tens)
3EBC96 collected $1.40 from pot
*** SUMMARY ***
Total pot $1.47 | Rake $0.07 
Board [3c Tc 7h 5c 4s]
Seat 1: Matbrown27 (small blind) folded before Flop
Seat 2: wesa280 (big blind) showed [Js Ks] and lost with high card King
Seat 4: 3EBC96 showed [Td Jh] and won ($1.40) with a pair of Tens
Seat 5: and_sp6 (button) folded before Flop (didn't bet)



PokerStars Hand #222950922267:  Hold'em No Limit ($0.05/$0.10 USD) - 2021/01/23 6:34:25 ET
Table 'Polydoros II' 6-max Seat #1 is the button
Seat 1: Matbrown27 ($12.31 in chips) 
Seat 2: wesa280 ($24.97 in chips) 
Seat 3: hornetsvp ($10 in chips) 
Seat 4: 3EBC96 ($18.99 in chips) 
Seat 5: and_sp6 ($11.04 in chips) 
wesa280: posts small blind $0.05
hornetsvp: posts big blind $0.10
*** HOLE CARDS ***
Kimiuran joins the table at seat #6 
3EBC96: folds 
and_sp6: folds 
Matbrown27: folds 
wesa280: calls $0.05
hornetsvp: checks 
*** FLOP *** [6s 6h Qd]
wesa280: checks 
hornetsvp: checks 
*** TURN *** [6s 6h Qd] [Td]
wesa280: checks 
hornetsvp: checks 
*** RIVER *** [6s 6h Qd Td] [5c]
wesa280: bets $0.10
hornetsvp: folds 
Uncalled bet ($0.10) returned to wesa280
wesa280 collected $0.19 from pot
wesa280: doesn't show hand 
*** SUMMARY ***
Total pot $0.20 | Rake $0.01 
Board [6s 6h Qd Td 5c]
Seat 1: Matbrown27 (button) folded before Flop (didn't bet)
Seat 2: wesa280 (small blind) collected ($0.19)
Seat 3: hornetsvp (big blind) folded on the River
Seat 4: 3EBC96 folded before Flop (didn't bet)
Seat 5: and_sp6 folded before Flop (didn't bet)



PokerStars Hand #222950933589:  Hold'em No Limit ($0.05/$0.10 USD) - 2021/01/23 6:34:59 ET
Table 'Polydoros II' 6-max Seat #2 is the button
Seat 1: Matbrown27 ($12.31 in chips) 
Seat 2: wesa280 ($25.06 in chips) 
Seat 3: hornetsvp ($9.90 in chips) 
Seat 4: 3EBC96 ($18.99 in chips) 
Seat 5: and_sp6 ($11.04 in chips) 
hornetsvp: posts small blind $0.05
3EBC96: posts big blind $0.10
Kimiuran: sits out 
*** HOLE CARDS ***
and_sp6: raises $0.20 to $0.30
Matbrown27: calls $0.30
wesa280: calls $0.30
hornetsvp: folds 
3EBC96: folds 
*** FLOP *** [9d 6c 2c]
and_sp6: checks 
Matbrown27: bets $0.60
wesa280: calls $0.60
and_sp6: folds 
*** TURN *** [9d 6c 2c] [6h]
Matbrown27: checks 
wesa280: checks 
*** RIVER *** [9d 6c 2c 6h] [Td]
Matbrown27: checks 
wesa280: bets $0.90
Matbrown27: folds 
Uncalled bet ($0.90) returned to wesa280
wesa280 collected $2.15 from pot
wesa280: doesn't show hand 
*** SUMMARY ***
Total pot $2.25 | Rake $0.10 
Board [9d 6c 2c 6h Td]
Seat 1: Matbrown27 folded on the River
Seat 2: wesa280 (button) collected ($2.15)
Seat 3: hornetsvp (small blind) folded before Flop
Seat 4: 3EBC96 (big blind) folded before Flop
Seat 5: and_sp6 folded on the Flop



PokerStars Hand #222950960957:  Hold'em No Limit ($0.05/$0.10 USD) - 2021/01/23 6:36:20 ET
Table 'Polydoros II' 6-max Seat #3 is the button
Seat 1: Matbrown27 ($11.41 in chips) 
Seat 2: wesa280 ($26.31 in chips) 
Seat 3: hornetsvp ($10 in chips) 
Seat 4: 3EBC96 ($18.89 in chips) 
Seat 5: and_sp6 ($10.74 in chips) 
3EBC96: posts small blind $0.05
and_sp6: posts big blind $0.10
Kimiuran: sits out 
*** HOLE CARDS ***
Matbrown27: folds 
wesa280: calls $0.10
hornetsvp: folds 
3EBC96: raises $0.20 to $0.30
and_sp6: calls $0.20
wesa280: calls $0.20
*** FLOP *** [3h 3s 2s]
3EBC96: checks 
and_sp6: checks 
wesa280: checks 
*** TURN *** [3h 3s 2s] [9d]
3EBC96: checks 
and_sp6: checks 
wesa280: checks 
*** RIVER *** [3h 3s 2s 9d] [5c]
3EBC96: checks 
and_sp6: checks 
wesa280: bets $1.30
3EBC96: folds 
and_sp6: folds 
Uncalled bet ($1.30) returned to wesa280
wesa280 collected $0.86 from pot
wesa280: doesn't show hand 
*** SUMMARY ***
Total pot $0.90 | Rake $0.04 
Board [3h 3s 2s 9d 5c]
Seat 1: Matbrown27 folded before Flop (didn't bet)
Seat 2: wesa280 collected ($0.86)
Seat 3: hornetsvp (button) folded before Flop (didn't bet)
Seat 4: 3EBC96 (small blind) folded on the River
Seat 5: and_sp6 (big blind) folded on the River



PokerStars Hand #222950986212:  Hold'em No Limit ($0.05/$0.10 USD) - 2021/01/23 6:37:36 ET
Table 'Polydoros II' 6-max Seat #4 is the button
Seat 1: Matbrown27 ($11.41 in chips) 
Seat 2: wesa280 ($26.87 in chips) 
Seat 3: hornetsvp ($10 in chips) 
Seat 4: 3EBC96 ($18.59 in chips) 
Seat 5: and_sp6 ($10.44 in chips) 
Seat 6: Kimiuran ($10 in chips) 
and_sp6: posts small blind $0.05
Kimiuran: posts big blind $0.10
*** HOLE CARDS ***
Matbrown27: folds 
wesa280: calls $0.10
hornetsvp: folds 
3EBC96: raises $0.20 to $0.30
and_sp6: folds 
Kimiuran: calls $0.20
wesa280: folds 
*** FLOP *** [8c 8s Js]
Kimiuran: checks 
3EBC96: checks 
*** TURN *** [8c 8s Js] [2s]
Kimiuran: checks 
3EBC96: checks 
*** RIVER *** [8c 8s Js 2s] [6d]
Kimiuran: bets $0.80
3EBC96: folds 
Uncalled bet ($0.80) returned to Kimiuran
Kimiuran collected $0.72 from pot
Kimiuran: doesn't show hand 
*** SUMMARY ***
Total pot $0.75 | Rake $0.03 
Board [8c 8s Js 2s 6d]
Seat 1: Matbrown27 folded before Flop (didn't bet)
Seat 2: wesa280 folded before Flop
Seat 3: hornetsvp folded before Flop (didn't bet)
Seat 4: 3EBC96 (button) folded on the River
Seat 5: and_sp6 (small blind) folded before Flop
Seat 6: Kimiuran (big blind) collected ($0.72)



PokerStars Hand #222951011320:  Hold'em No Limit ($0.05/$0.10 USD) - 2021/01/23 6:38:49 ET
Table 'Polydoros II' 6-max Seat #5 is the button
Seat 2: wesa280 ($26.77 in chips) 
Seat 3: hornetsvp ($10 in chips) 
Seat 4: 3EBC96 ($18.29 in chips) 
Seat 5: and_sp6 ($10.39 in chips) 
Seat 6: Kimiuran ($10.42 in chips) 
Kimiuran: posts small blind $0.05
Matbrown27: is sitting out 
wesa280: posts big blind $0.10
*** HOLE CARDS ***
hornetsvp: folds 
3EBC96: folds 
and_sp6: raises $0.15 to $0.25
Kimiuran: folds 
Matbrown27 leaves the table
wesa280: calls $0.15
*** FLOP *** [Kd 2d Td]
TSA958 joins the table at seat #1 
wesa280: checks 
and_sp6: checks 
*** TURN *** [Kd 2d Td] [Qc]
wesa280: bets $0.10
and_sp6: calls $0.10
*** RIVER *** [Kd 2d Td Qc] [3c]
wesa280: bets $1
and_sp6: folds 
Uncalled bet ($1) returned to wesa280
wesa280 collected $0.72 from pot
wesa280: doesn't show hand 
*** SUMMARY ***
Total pot $0.75 | Rake $0.03 
Board [Kd 2d Td Qc 3c]
Seat 2: wesa280 (big blind) collected ($0.72)
Seat 3: hornetsvp folded before Flop (didn't bet)
Seat 4: 3EBC96 folded before Flop (didn't bet)
Seat 5: and_sp6 (button) folded on the River
Seat 6: Kimiuran (small blind) folded before Flop



PokerStars Hand #222951036477:  Hold'em No Limit ($0.05/$0.10 USD) - 2021/01/23 6:40:03 ET
Table 'Polydoros II' 6-max Seat #6 is the button
Seat 2: wesa280 ($27.14 in chips) 
Seat 3: hornetsvp ($10 in chips) 
Seat 4: 3EBC96 ($18.29 in chips) 
Seat 5: and_sp6 ($10.04 in chips) 
Seat 6: Kimiuran ($10.37 in chips) 
wesa280: posts small blind $0.05
hornetsvp: posts big blind $0.10
*** HOLE CARDS ***
3EBC96: folds 
and_sp6: folds 
Kimiuran: raises $0.15 to $0.25
wesa280: calls $0.20
hornetsvp: folds 
*** FLOP *** [5c 7s 3d]
wesa280: checks 
Kimiuran: bets $0.29
wesa280: calls $0.29
*** TURN *** [5c 7s 3d] [2c]
wesa280: checks 
Kimiuran: checks 
*** RIVER *** [5c 7s 3d 2c] [Jc]
wesa280: bets $0.10
Kimiuran: calls $0.10
*** SHOW DOWN ***
wesa280: shows [5s Jh] (two pair, Jacks and Fives)
Kimiuran: mucks hand 
wesa280 collected $1.32 from pot
*** SUMMARY ***
Total pot $1.38 | Rake $0.06 
Board [5c 7s 3d 2c Jc]
Seat 2: wesa280 (small blind) showed [5s Jh] and won ($1.32) with two pair, Jacks and Fives
Seat 3: hornetsvp (big blind) folded before Flop
Seat 4: 3EBC96 folded before Flop (didn't bet)
Seat 5: and_sp6 folded before Flop (didn't bet)
Seat 6: Kimiuran (button) mucked



PokerStars Hand #222951049311:  Hold'em No Limit ($0.05/$0.10 USD) - 2021/01/23 6:40:41 ET
Table 'Polydoros II' 6-max Seat #2 is the button
Seat 2: wesa280 ($27.82 in chips) 
Seat 3: hornetsvp ($10 in chips) 
Seat 4: 3EBC96 ($18.29 in chips) 
Seat 5: and_sp6 ($10.04 in chips) 
Seat 6: Kimiuran ($10 in chips) 
hornetsvp: posts small blind $0.05
3EBC96: posts big blind $0.10
TSA958: sits out 
*** HOLE CARDS ***
and_sp6: raises $0.20 to $0.30
Kimiuran: folds 
wesa280: calls $0.30
hornetsvp: folds 
3EBC96: calls $0.20
*** FLOP *** [4c 8c 6c]
3EBC96: checks 
and_sp6: checks 
wesa280: checks 
*** TURN *** [4c 8c 6c] [Kh]
3EBC96: bets $0.68
and_sp6: calls $0.68
wesa280: calls $0.68
*** RIVER *** [4c 8c 6c Kh] [Qh]
3EBC96: bets $3
and_sp6: folds 
wesa280: folds 
Uncalled bet ($3) returned to 3EBC96
3EBC96 collected $2.86 from pot
3EBC96: doesn't show hand 
*** SUMMARY ***
Total pot $2.99 | Rake $0.13 
Board [4c 8c 6c Kh Qh]
Seat 2: wesa280 (button) folded on the River
Seat 3: hornetsvp (small blind) folded before Flop
Seat 4: 3EBC96 (big blind) collected ($2.86)
Seat 5: and_sp6 folded on the River
Seat 6: Kimiuran folded before Flop (didn't bet)



PokerStars Hand #222951068720:  Hold'em No Limit ($0.05/$0.10 USD) - 2021/01/23 6:41:38 ET
Table 'Polydoros II' 6-max Seat #3 is the button
Seat 2: wesa280 ($26.84 in chips) 
Seat 3: hornetsvp ($9.95 in chips) 
Seat 4: 3EBC96 ($20.17 in chips) 
Seat 5: and_sp6 ($10 in chips) 
Seat 6: Kimiuran ($10 in chips) 
3EBC96: posts small blind $0.05
and_sp6: posts big blind $0.10
TSA958: sits out 
*** HOLE CARDS ***
Kimiuran: folds 
wesa280: calls $0.10
hornetsvp: folds 
3EBC96: raises $0.30 to $0.40
and_sp6: folds 
wesa280: calls $0.30
*** FLOP *** [Js 6c 4s]
3EBC96: checks 
wesa280: checks 
*** TURN *** [Js 6c 4s] [4d]
3EBC96: checks 
wesa280: bets $0.10
3EBC96: calls $0.10
*** RIVER *** [Js 6c 4s 4d] [Th]
3EBC96: checks 
wesa280: bets $0.10
3EBC96: calls $0.10
*** SHOW DOWN ***
wesa280: shows [2d 2s] (two pair, Fours and Deuces)
3EBC96: shows [Jd Qs] (two pair, Jacks and Fours)
3EBC96 collected $1.24 from pot
*** SUMMARY ***
Total pot $1.30 | Rake $0.06 
Board [Js 6c 4s 4d Th]
Seat 2: wesa280 showed [2d 2s] and lost with two pair, Fours and Deuces
Seat 3: hornetsvp (button) folded before Flop (didn't bet)
Seat 4: 3EBC96 (small blind) showed [Jd Qs] and won ($1.24) with two pair, Jacks and Fours
Seat 5: and_sp6 (big blind) folded before Flop
Seat 6: Kimiuran folded before Flop (didn't bet)



PokerStars Hand #222951086414:  Hold'em No Limit ($0.05/$0.10 USD) - 2021/01/23 6:42:30 ET
Table 'Polydoros II' 6-max Seat #4 is the button
Seat 2: wesa280 ($26.24 in chips) 
Seat 3: hornetsvp ($9.95 in chips) 
Seat 4: 3EBC96 ($20.81 in chips) 
Seat 5: and_sp6 ($10 in chips) 
Seat 6: Kimiuran ($10 in chips) 
and_sp6: posts small blind $0.05
Kimiuran: posts big blind $0.10
TSA958: sits out 
*** HOLE CARDS ***
wesa280: calls $0.10
hornetsvp: folds 
3EBC96: folds 
and_sp6: calls $0.05
Kimiuran: checks 
*** FLOP *** [Kc 4d 3h]
and_sp6: checks 
Kimiuran: checks 
wesa280: checks 
*** TURN *** [Kc 4d 3h] [2h]
and_sp6: bets $0.19
Kimiuran: calls $0.19
wesa280: calls $0.19
*** RIVER *** [Kc 4d 3h 2h] [5h]
and_sp6: checks 
Kimiuran: checks 
wesa280: bets $9.60
and_sp6 has timed out
and_sp6: folds 
Kimiuran: folds 
Uncalled bet ($9.60) returned to wesa280
wesa280 collected $0.83 from pot
wesa280: doesn't show hand 
*** SUMMARY ***
Total pot $0.87 | Rake $0.04 
Board [Kc 4d 3h 2h 5h]
Seat 2: wesa280 collected ($0.83)
Seat 3: hornetsvp folded before Flop (didn't bet)
Seat 4: 3EBC96 (button) folded before Flop (didn't bet)
Seat 5: and_sp6 (small blind) folded on the River
Seat 6: Kimiuran (big blind) folded on the River



PokerStars Hand #222951114214:  Hold'em No Limit ($0.05/$0.10 USD) - 2021/01/23 6:43:51 ET
Table 'Polydoros II' 6-max Seat #2 is the button
Seat 2: wesa280 ($26.78 in chips) 
Seat 3: hornetsvp ($9.95 in chips) 
Seat 4: 3EBC96 ($20.81 in chips) 
hornetsvp: posts small blind $0.05
3EBC96: posts big blind $0.10
TSA958: sits out 
*** HOLE CARDS ***
wesa280: calls $0.10
hornetsvp: folds 
3EBC96: checks 
*** FLOP *** [Jh 8s 6s]
3EBC96: checks 
wesa280: checks 
*** TURN *** [Jh 8s 6s] [Qd]
3EBC96: checks 
wesa280: bets $0.10
3EBC96: folds 
Uncalled bet ($0.10) returned to wesa280
wesa280 collected $0.24 from pot
wesa280: doesn't show hand 
*** SUMMARY ***
Total pot $0.25 | Rake $0.01 
Board [Jh 8s 6s Qd]
Seat 2: wesa280 (button) collected ($0.24)
Seat 3: hornetsvp (small blind) folded before Flop
Seat 4: 3EBC96 (big blind) folded on the Turn



PokerStars Hand #222951120647:  Hold'em No Limit ($0.05/$0.10 USD) - 2021/01/23 6:44:10 ET
Table 'Polydoros II' 6-max Seat #3 is the button
Seat 2: wesa280 ($26.92 in chips) 
Seat 3: hornetsvp ($10 in chips) 
Seat 4: 3EBC96 ($20.71 in chips) 
Seat 5: and_sp6 ($10 in chips) 
3EBC96: posts small blind $0.05
and_sp6: posts big blind $0.10
TSA958: sits out 
*** HOLE CARDS ***
wesa280: calls $0.10
hornetsvp: folds 
3EBC96: raises $0.40 to $0.50
and_sp6: folds 
wesa280: folds 
Uncalled bet ($0.40) returned to 3EBC96
3EBC96 collected $0.30 from pot
3EBC96: doesn't show hand 
*** SUMMARY ***
Total pot $0.30 | Rake $0 
Seat 2: wesa280 folded before Flop
Seat 3: hornetsvp (button) folded before Flop (didn't bet)
Seat 4: 3EBC96 (small blind) collected ($0.30)
Seat 5: and_sp6 (big blind) folded before Flop



PokerStars Hand #222951125507:  Hold'em No Limit ($0.05/$0.10 USD) - 2021/01/23 6:44:24 ET
Table 'Polydoros II' 6-max Seat #4 is the button
Seat 1: TSA958 ($10 in chips) 
Seat 2: wesa280 ($26.82 in chips) 
Seat 3: hornetsvp ($10 in chips) 
Seat 4: 3EBC96 ($20.91 in chips) 
Seat 5: and_sp6 ($10 in chips) 
and_sp6: posts small blind $0.05
TSA958: posts big blind $0.10
*** HOLE CARDS ***
wesa280: calls $0.10
hornetsvp: folds 
3EBC96: raises $0.30 to $0.40
and_sp6: raises $0.90 to $1.30
TSA958: folds 
wesa280: folds 
3EBC96: raises $2.20 to $3.50
and_sp6: raises $6.50 to $10 and is all-in
3EBC96: folds 
Uncalled bet ($6.50) returned to and_sp6
and_sp6 collected $7.20 from pot
and_sp6: doesn't show hand 
*** SUMMARY ***
Total pot $7.20 | Rake $0 
Seat 1: TSA958 (big blind) folded before Flop
Seat 2: wesa280 folded before Flop
Seat 3: hornetsvp folded before Flop (didn't bet)
Seat 4: 3EBC96 (button) folded before Flop
Seat 5: and_sp6 (small blind) collected ($7.20)



PokerStars Hand #222951139091:  Hold'em No Limit ($0.05/$0.10 USD) - 2021/01/23 6:45:03 ET
Table 'Polydoros II' 6-max Seat #5 is the button
Seat 1: TSA958 ($10 in chips) 
Seat 2: wesa280 ($26.72 in chips) 
Seat 3: hornetsvp ($10 in chips) 
Seat 4: 3EBC96 ($17.41 in chips) 
Seat 5: and_sp6 ($13.70 in chips) 
TSA958: posts small blind $0.05
wesa280: posts big blind $0.10
*** HOLE CARDS ***
hornetsvp: folds 
3EBC96: folds 
and_sp6 has timed out
and_sp6: folds 
TSA958: folds 
Uncalled bet ($0.05) returned to wesa280
wesa280 collected $0.10 from pot
wesa280: doesn't show hand 
*** SUMMARY ***
Total pot $0.10 | Rake $0 
Seat 1: TSA958 (small blind) folded before Flop
Seat 2: wesa280 (big blind) collected ($0.10)
Seat 3: hornetsvp folded before Flop (didn't bet)
Seat 4: 3EBC96 folded before Flop (didn't bet)
Seat 5: and_sp6 (button) folded before Flop (didn't bet)



PokerStars Hand #222951145626:  Hold'em No Limit ($0.05/$0.10 USD) - 2021/01/23 6:45:22 ET
Table 'Polydoros II' 6-max Seat #1 is the button
Seat 1: TSA958 ($10 in chips) 
Seat 2: wesa280 ($26.77 in chips) 
Seat 3: hornetsvp ($10 in chips) 
Seat 4: 3EBC96 ($17.41 in chips) 
Seat 5: and_sp6 ($13.70 in chips) 
wesa280: posts small blind $0.05
hornetsvp: posts big blind $0.10
*** HOLE CARDS ***
3EBC96: folds 
and_sp6: folds 
TSA958: folds 
wesa280: calls $0.05
hornetsvp: checks 
*** FLOP *** [7h 2s 3c]
wesa280: checks 
hornetsvp: checks 
*** TURN *** [7h 2s 3c] [6h]
wesa280: checks 
hornetsvp: bets $0.10
wesa280: calls $0.10
*** RIVER *** [7h 2s 3c 6h] [Kh]
wesa280: bets $1.90
hornetsvp: folds 
Uncalled bet ($1.90) returned to wesa280
wesa280 collected $0.38 from pot
wesa280: doesn't show hand 
*** SUMMARY ***
Total pot $0.40 | Rake $0.02 
Board [7h 2s 3c 6h Kh]
Seat 1: TSA958 (button) folded before Flop (didn't bet)
Seat 2: wesa280 (small blind) collected ($0.38)
Seat 3: hornetsvp (big blind) folded on the River
Seat 4: 3EBC96 folded before Flop (didn't bet)
Seat 5: and_sp6 folded before Flop (didn't bet)



PokerStars Hand #222951162110:  Hold'em No Limit ($0.05/$0.10 USD) - 2021/01/23 6:46:09 ET
Table 'Polydoros II' 6-max Seat #2 is the button
Seat 1: TSA958 ($10 in chips) 
Seat 2: wesa280 ($26.95 in chips) 
Seat 3: hornetsvp ($9.80 in chips) 
Seat 4: 3EBC96 ($17.41 in chips) 
Seat 5: and_sp6 ($13.70 in chips) 
hornetsvp: posts small blind $0.05
3EBC96: posts big blind $0.10
*** HOLE CARDS ***
and_sp6: folds 
TSA958: folds 
wesa280: calls $0.10
hornetsvp: folds 
3EBC96: checks 
*** FLOP *** [Ah Jh Qc]
3EBC96: checks 
wesa280: checks 
*** TURN *** [Ah Jh Qc] [Qd]
3EBC96: checks 
wesa280: checks 
*** RIVER *** [Ah Jh Qc Qd] [7c]
3EBC96: checks 
wesa280: bets $4.40
3EBC96: folds 
Uncalled bet ($4.40) returned to wesa280
wesa280 collected $0.24 from pot
wesa280: doesn't show hand 
*** SUMMARY ***
Total pot $0.25 | Rake $0.01 
Board [Ah Jh Qc Qd 7c]
Seat 1: TSA958 folded before Flop (didn't bet)
Seat 2: wesa280 (button) collected ($0.24)
Seat 3: hornetsvp (small blind) folded before Flop
Seat 4: 3EBC96 (big blind) folded on the River
Seat 5: and_sp6 folded before Flop (didn't bet)



PokerStars Hand #222951173553:  Hold'em No Limit ($0.05/$0.10 USD) - 2021/01/23 6:46:43 ET
Table 'Polydoros II' 6-max Seat #3 is the button
Seat 1: TSA958 ($10 in chips) 
Seat 2: wesa280 ($27.09 in chips) 
Seat 3: hornetsvp ($10 in chips) 
Seat 4: 3EBC96 ($17.31 in chips) 
Seat 5: and_sp6 ($13.70 in chips) 
3EBC96: posts small blind $0.05
and_sp6: posts big blind $0.10
Kimiuran: sits out 
*** HOLE CARDS ***
TSA958: folds 
wesa280: calls $0.10
hornetsvp: folds 
3EBC96: folds 
and_sp6: checks 
*** FLOP *** [8s 4d Qh]
and_sp6: checks 
wesa280: bets $0.10
and_sp6: folds 
Uncalled bet ($0.10) returned to wesa280
wesa280 collected $0.24 from pot
wesa280: doesn't show hand 
*** SUMMARY ***
Total pot $0.25 | Rake $0.01 
Board [8s 4d Qh]
Seat 1: TSA958 folded before Flop (didn't bet)
Seat 2: wesa280 collected ($0.24)
Seat 3: hornetsvp (button) folded before Flop (didn't bet)
Seat 4: 3EBC96 (small blind) folded before Flop
Seat 5: and_sp6 (big blind) folded on the Flop



PokerStars Hand #222951184725:  Hold'em No Limit ($0.05/$0.10 USD) - 2021/01/23 6:47:15 ET
Table 'Polydoros II' 6-max Seat #4 is the button
Seat 1: TSA958 ($10 in chips) 
Seat 2: wesa280 ($27.23 in chips) 
Seat 3: hornetsvp ($10 in chips) 
Seat 4: 3EBC96 ($17.26 in chips) 
Seat 5: and_sp6 ($13.60 in chips) 
Seat 6: Kimiuran ($10 in chips) 
and_sp6: posts small blind $0.05
Kimiuran: posts big blind $0.10
*** HOLE CARDS ***
TSA958: folds 
wesa280: calls $0.10
hornetsvp: folds 
TSA958 leaves the table
3EBC96: folds 
and_sp6: folds 
balisstica joins the table at seat #1 
Kimiuran: raises $0.30 to $0.40
wesa280: folds 
Uncalled bet ($0.30) returned to Kimiuran
Kimiuran collected $0.25 from pot
Kimiuran: doesn't show hand 
*** SUMMARY ***
Total pot $0.25 | Rake $0 
Seat 1: TSA958 folded before Flop (didn't bet)
Seat 2: wesa280 folded before Flop
Seat 3: hornetsvp folded before Flop (didn't bet)
Seat 4: 3EBC96 (button) folded before Flop (didn't bet)
Seat 5: and_sp6 (small blind) folded before Flop
Seat 6: Kimiuran (big blind) collected ($0.25)



PokerStars Hand #222951189482:  Hold'em No Limit ($0.05/$0.10 USD) - 2021/01/23 6:47:28 ET
Table 'Polydoros II' 6-max Seat #5 is the button
Seat 1: balisstica ($10 in chips) 
Seat 2: wesa280 ($27.13 in chips) 
Seat 3: hornetsvp ($10 in chips) 
Seat 4: 3EBC96 ($17.26 in chips) 
Seat 5: and_sp6 ($13.55 in chips) 
Seat 6: Kimiuran ($10.15 in chips) 
Kimiuran: posts small blind $0.05
balisstica: posts big blind $0.10
*** HOLE CARDS ***
wesa280: folds 
hornetsvp: folds 
3EBC96: folds 
and_sp6: raises $0.15 to $0.25
Kimiuran: folds 
balisstica: calls $0.15
*** FLOP *** [9c 3c 6s]
balisstica: checks 
and_sp6: checks 
*** TURN *** [9c 3c 6s] [3h]
balisstica: checks 
and_sp6: bets $0.27
balisstica: folds 
Uncalled bet ($0.27) returned to and_sp6
and_sp6 collected $0.53 from pot
and_sp6: doesn't show hand 
*** SUMMARY ***
Total pot $0.55 | Rake $0.02 
Board [9c 3c 6s 3h]
Seat 1: balisstica (big blind) folded on the Turn
Seat 2: wesa280 folded before Flop (didn't bet)
Seat 3: hornetsvp folded before Flop (didn't bet)
Seat 4: 3EBC96 folded before Flop (didn't bet)
Seat 5: and_sp6 (button) collected ($0.53)
Seat 6: Kimiuran (small blind) folded before Flop



PokerStars Hand #222951200222:  Hold'em No Limit ($0.05/$0.10 USD) - 2021/01/23 6:47:59 ET
Table 'Polydoros II' 6-max Seat #6 is the button
Seat 1: balisstica ($10 in chips) 
Seat 2: wesa280 ($27.13 in chips) 
Seat 3: hornetsvp ($10 in chips) 
Seat 4: 3EBC96 ($17.26 in chips) 
Seat 5: and_sp6 ($13.83 in chips) 
Seat 6: Kimiuran ($10.10 in chips) 
balisstica: posts small blind $0.05
wesa280: posts big blind $0.10
*** HOLE CARDS ***
hornetsvp: folds 
3EBC96: raises $0.20 to $0.30
and_sp6: folds 
Kimiuran: folds 
balisstica: folds 
wesa280: calls $0.20
*** FLOP *** [7h Qs Td]
wesa280: checks 
3EBC96: checks 
*** TURN *** [7h Qs Td] [Ah]
wesa280: bets $0.10
3EBC96: calls $0.10
*** RIVER *** [7h Qs Td Ah] [2d]
wesa280: bets $0.10
3EBC96: folds 
Uncalled bet ($0.10) returned to wesa280
wesa280 collected $0.81 from pot
wesa280: doesn't show hand 
*** SUMMARY ***
Total pot $0.85 | Rake $0.04 
Board [7h Qs Td Ah 2d]
Seat 1: balisstica (small blind) folded before Flop
Seat 2: wesa280 (big blind) collected ($0.81)
Seat 3: hornetsvp folded before Flop (didn't bet)
Seat 4: 3EBC96 folded on the River
Seat 5: and_sp6 folded before Flop (didn't bet)
Seat 6: Kimiuran (button) folded before Flop (didn't bet)



PokerStars Hand #222951209604:  Hold'em No Limit ($0.05/$0.10 USD) - 2021/01/23 6:48:26 ET
Table 'Polydoros II' 6-max Seat #1 is the button
Seat 1: balisstica ($10 in chips) 
Seat 2: wesa280 ($27.54 in chips) 
Seat 3: hornetsvp ($10 in chips) 
Seat 4: 3EBC96 ($16.86 in chips) 
Seat 5: and_sp6 ($13.83 in chips) 
Seat 6: Kimiuran ($10.10 in chips) 
wesa280: posts small blind $0.05
hornetsvp: posts big blind $0.10
*** HOLE CARDS ***
3EBC96: folds 
and_sp6: folds 
Kimiuran: folds 
balisstica: folds 
wesa280: raises $0.10 to $0.20
hornetsvp: calls $0.10
*** FLOP *** [5s 6c 8h]
wesa280: checks 
hornetsvp: checks 
*** TURN *** [5s 6c 8h] [3s]
wesa280: bets $0.10
hornetsvp: folds 
Uncalled bet ($0.10) returned to wesa280
wesa280 collected $0.38 from pot
wesa280: doesn't show hand 
*** SUMMARY ***
Total pot $0.40 | Rake $0.02 
Board [5s 6c 8h 3s]
Seat 1: balisstica (button) folded before Flop (didn't bet)
Seat 2: wesa280 (small blind) collected ($0.38)
Seat 3: hornetsvp (big blind) folded on the Turn
Seat 4: 3EBC96 folded before Flop (didn't bet)
Seat 5: and_sp6 folded before Flop (didn't bet)
Seat 6: Kimiuran folded before Flop (didn't bet)



PokerStars Hand #222951221557:  Hold'em No Limit ($0.05/$0.10 USD) - 2021/01/23 6:49:00 ET
Table 'Polydoros II' 6-max Seat #2 is the button
Seat 1: balisstica ($10 in chips) 
Seat 2: wesa280 ($27.72 in chips) 
Seat 3: hornetsvp ($9.80 in chips) 
Seat 4: 3EBC96 ($16.86 in chips) 
Seat 5: and_sp6 ($13.83 in chips) 
Seat 6: Kimiuran ($10.10 in chips) 
hornetsvp: posts small blind $0.05
3EBC96: posts big blind $0.10
*** HOLE CARDS ***
and_sp6: folds 
Kimiuran: folds 
and_sp6 leaves the table
balisstica: folds 
wesa280: calls $0.10
hornetsvp: folds 
3EBC96: checks 
*** FLOP *** [4c 2h Qd]
whell11 joins the table at seat #5 
3EBC96: checks 
wesa280: checks 
*** TURN *** [4c 2h Qd] [Kc]
3EBC96: checks 
wesa280: bets $0.10
3EBC96: calls $0.10
*** RIVER *** [4c 2h Qd Kc] [Jc]
3EBC96: checks 
wesa280: bets $0.10
3EBC96: folds 
Uncalled bet ($0.10) returned to wesa280
wesa280 collected $0.43 from pot
wesa280: doesn't show hand 
*** SUMMARY ***
Total pot $0.45 | Rake $0.02 
Board [4c 2h Qd Kc Jc]
Seat 1: balisstica folded before Flop (didn't bet)
Seat 2: wesa280 (button) collected ($0.43)
Seat 3: hornetsvp (small blind) folded before Flop
Seat 4: 3EBC96 (big blind) folded on the River
Seat 5: and_sp6 folded before Flop (didn't bet)
Seat 6: Kimiuran folded before Flop (didn't bet)



PokerStars Hand #222951231260:  Hold'em No Limit ($0.05/$0.10 USD) - 2021/01/23 6:49:28 ET
Table 'Polydoros II' 6-max Seat #3 is the button
Seat 1: balisstica ($10 in chips) 
Seat 2: wesa280 ($27.95 in chips) 
Seat 3: hornetsvp ($10 in chips) 
Seat 4: 3EBC96 ($16.66 in chips) 
Seat 5: whell11 ($10 in chips) 
Seat 6: Kimiuran ($10.10 in chips) 
3EBC96: posts small blind $0.05
whell11: posts big blind $0.10
*** HOLE CARDS ***
Kimiuran: folds 
balisstica: folds 
wesa280: calls $0.10
hornetsvp: folds 
3EBC96: folds 
whell11: checks 
*** FLOP *** [8c Qc 7c]
whell11: checks 
wesa280: checks 
*** TURN *** [8c Qc 7c] [6h]
whell11: checks 
wesa280: bets $0.10
whell11: folds 
Uncalled bet ($0.10) returned to wesa280
wesa280 collected $0.24 from pot
wesa280: doesn't show hand 
*** SUMMARY ***
Total pot $0.25 | Rake $0.01 
Board [8c Qc 7c 6h]
Seat 1: balisstica folded before Flop (didn't bet)
Seat 2: wesa280 collected ($0.24)
Seat 3: hornetsvp (button) folded before Flop (didn't bet)
Seat 4: 3EBC96 (small blind) folded before Flop
Seat 5: whell11 (big blind) folded on the Turn
Seat 6: Kimiuran folded before Flop (didn't bet)



PokerStars Hand #222951242399:  Hold'em No Limit ($0.05/$0.10 USD) - 2021/01/23 6:49:59 ET
Table 'Polydoros II' 6-max Seat #4 is the button
Seat 1: balisstica ($10 in chips) 
Seat 2: wesa280 ($28.09 in chips) 
Seat 3: hornetsvp ($10 in chips) 
Seat 4: 3EBC96 ($16.61 in chips) 
Seat 5: whell11 ($10 in chips) 
Seat 6: Kimiuran ($10.10 in chips) 
whell11: posts small blind $0.05
Kimiuran: posts big blind $0.10
*** HOLE CARDS ***
balisstica: folds 
wesa280: calls $0.10
hornetsvp: folds 
3EBC96: folds 
whell11: folds 
Kimiuran: raises $0.30 to $0.40
wesa280: calls $0.30
*** FLOP *** [6d 6h Kd]
Kimiuran: checks 
wesa280: checks 
*** TURN *** [6d 6h Kd] [5c]
Kimiuran: bets $0.54
wesa280: calls $0.54
*** RIVER *** [6d 6h Kd 5c] [3h]
Kimiuran: checks 
wesa280: bets $3.10
Kimiuran: folds 
Uncalled bet ($3.10) returned to wesa280
wesa280 collected $1.84 from pot
wesa280: doesn't show hand 
*** SUMMARY ***
Total pot $1.93 | Rake $0.09 
Board [6d 6h Kd 5c 3h]
Seat 1: balisstica folded before Flop (didn't bet)
Seat 2: wesa280 collected ($1.84)
Seat 3: hornetsvp folded before Flop (didn't bet)
Seat 4: 3EBC96 (button) folded before Flop (didn't bet)
Seat 5: whell11 (small blind) folded before Flop
Seat 6: Kimiuran (big blind) folded on the River



PokerStars Hand #222951262054:  Hold'em No Limit ($0.05/$0.10 USD) - 2021/01/23 6:50:55 ET
Table 'Polydoros II' 6-max Seat #5 is the button
Seat 1: balisstica ($10 in chips) 
Seat 2: wesa280 ($28.99 in chips) 
Seat 3: hornetsvp ($10 in chips) 
Seat 4: 3EBC96 ($16.61 in chips) 
Seat 5: whell11 ($10 in chips) 
Seat 6: Kimiuran ($10 in chips) 
Kimiuran: posts small blind $0.05
balisstica: posts big blind $0.10
*** HOLE CARDS ***
wesa280: calls $0.10
hornetsvp: folds 
3EBC96: folds 
whell11: folds 
Kimiuran: folds 
balisstica: checks 
*** FLOP *** [As Ts Jh]
balisstica: checks 
wesa280: checks 
*** TURN *** [As Ts Jh] [6d]
balisstica: checks 
wesa280: bets $0.10
balisstica: folds 
Uncalled bet ($0.10) returned to wesa280
wesa280 collected $0.24 from pot
wesa280: doesn't show hand 
*** SUMMARY ***
Total pot $0.25 | Rake $0.01 
Board [As Ts Jh 6d]
Seat 1: balisstica (big blind) folded on the Turn
Seat 2: wesa280 collected ($0.24)
Seat 3: hornetsvp folded before Flop (didn't bet)
Seat 4: 3EBC96 folded before Flop (didn't bet)
Seat 5: whell11 (button) folded before Flop (didn't bet)
Seat 6: Kimiuran (small blind) folded before Flop



PokerStars Hand #222951270591:  Hold'em No Limit ($0.05/$0.10 USD) - 2021/01/23 6:51:20 ET
Table 'Polydoros II' 6-max Seat #6 is the button
Seat 1: balisstica ($10 in chips) 
Seat 2: wesa280 ($29.13 in chips) 
Seat 3: hornetsvp ($10 in chips) 
Seat 4: 3EBC96 ($16.61 in chips) 
Seat 5: whell11 ($10 in chips) 
Seat 6: Kimiuran ($10 in chips) 
balisstica: posts small blind $0.05
wesa280: posts big blind $0.10
*** HOLE CARDS ***
hornetsvp: raises $0.15 to $0.25
3EBC96: calls $0.25
whell11: folds 
Kimiuran: folds 
balisstica: folds 
wesa280: calls $0.15
*** FLOP *** [As 4d Qd]
wesa280: checks 
hornetsvp: checks 
3EBC96: checks 
*** TURN *** [As 4d Qd] [Ad]
wesa280: bets $0.10
hornetsvp: folds 
3EBC96: calls $0.10
*** RIVER *** [As 4d Qd Ad] [Kc]
wesa280: bets $0.10
3EBC96: calls $0.10
*** SHOW DOWN ***
wesa280: shows [2c 9c] (a pair of Aces)
3EBC96: shows [3s 3c] (two pair, Aces and Threes)
3EBC96 collected $1.15 from pot
*** SUMMARY ***
Total pot $1.20 | Rake $0.05 
Board [As 4d Qd Ad Kc]
Seat 1: balisstica (small blind) folded before Flop
Seat 2: wesa280 (big blind) showed [2c 9c] and lost with a pair of Aces
Seat 3: hornetsvp folded on the Turn
Seat 4: 3EBC96 showed [3s 3c] and won ($1.15) with two pair, Aces and Threes
Seat 5: whell11 folded before Flop (didn't bet)
Seat 6: Kimiuran (button) folded before Flop (didn't bet)



PokerStars Hand #222951289673:  Hold'em No Limit ($0.05/$0.10 USD) - 2021/01/23 6:52:15 ET
Table 'Polydoros II' 6-max Seat #1 is the button
Seat 1: balisstica ($10 in chips) 
Seat 2: wesa280 ($28.68 in chips) 
Seat 3: hornetsvp ($10 in chips) 
Seat 4: 3EBC96 ($17.31 in chips) 
Seat 5: whell11 ($10 in chips) 
Seat 6: Kimiuran ($10 in chips) 
wesa280: posts small blind $0.05
hornetsvp: posts big blind $0.10
*** HOLE CARDS ***
3EBC96: folds 
whell11: raises $0.20 to $0.30
Kimiuran: folds 
balisstica: folds 
wesa280: calls $0.25
hornetsvp: folds 
*** FLOP *** [7c 5d 6c]
wesa280: checks 
whell11: bets $0.45
wesa280: folds 
Uncalled bet ($0.45) returned to whell11
whell11 collected $0.67 from pot
whell11: doesn't show hand 
*** SUMMARY ***
Total pot $0.70 | Rake $0.03 
Board [7c 5d 6c]
Seat 1: balisstica (button) folded before Flop (didn't bet)
Seat 2: wesa280 (small blind) folded on the Flop
Seat 3: hornetsvp (big blind) folded before Flop
Seat 4: 3EBC96 folded before Flop (didn't bet)
Seat 5: whell11 collected ($0.67)
Seat 6: Kimiuran folded before Flop (didn't bet)



PokerStars Hand #222951297696:  Hold'em No Limit ($0.05/$0.10 USD) - 2021/01/23 6:52:38 ET
Table 'Polydoros II' 6-max Seat #2 is the button
Seat 1: balisstica ($10 in chips) 
Seat 2: wesa280 ($28.38 in chips) 
Seat 3: hornetsvp ($9.90 in chips) 
Seat 4: 3EBC96 ($17.31 in chips) 
Seat 5: whell11 ($10.37 in chips) 
Seat 6: Kimiuran ($10 in chips) 
hornetsvp: posts small blind $0.05
3EBC96: posts big blind $0.10
*** HOLE CARDS ***
whell11: folds 
Kimiuran: folds 
balisstica: folds 
wesa280: calls $0.10
hornetsvp: folds 
3EBC96: checks 
*** FLOP *** [3d 8d 5h]
3EBC96: checks 
wesa280: checks 
*** TURN *** [3d 8d 5h] [7s]
3EBC96: checks 
wesa280: checks 
*** RIVER *** [3d 8d 5h 7s] [9c]
3EBC96: checks 
wesa280: bets $1.50
3EBC96: folds 
Uncalled bet ($1.50) returned to wesa280
wesa280 collected $0.24 from pot
wesa280: doesn't show hand 
*** SUMMARY ***
Total pot $0.25 | Rake $0.01 
Board [3d 8d 5h 7s 9c]
Seat 1: balisstica folded before Flop (didn't bet)
Seat 2: wesa280 (button) collected ($0.24)
Seat 3: hornetsvp (small blind) folded before Flop
Seat 4: 3EBC96 (big blind) folded on the River
Seat 5: whell11 folded before Flop (didn't bet)
Seat 6: Kimiuran folded before Flop (didn't bet)



PokerStars Hand #222951308045:  Hold'em No Limit ($0.05/$0.10 USD) - 2021/01/23 6:53:08 ET
Table 'Polydoros II' 6-max Seat #3 is the button
Seat 1: balisstica ($10 in chips) 
Seat 2: wesa280 ($28.52 in chips) 
Seat 3: hornetsvp ($9.95 in chips) 
Seat 4: 3EBC96 ($17.21 in chips) 
Seat 5: whell11 ($10.37 in chips) 
Seat 6: Kimiuran ($10 in chips) 
3EBC96: posts small blind $0.05
whell11: posts big blind $0.10
*** HOLE CARDS ***
Kimiuran: folds 
balisstica: folds 
wesa280: calls $0.10
hornetsvp: folds 
3EBC96: folds 
whell11: checks 
*** FLOP *** [4d 6d Qs]
whell11: checks 
wesa280: bets $0.10
whell11: folds 
Uncalled bet ($0.10) returned to wesa280
wesa280 collected $0.24 from pot
wesa280: doesn't show hand 
*** SUMMARY ***
Total pot $0.25 | Rake $0.01 
Board [4d 6d Qs]
Seat 1: balisstica folded before Flop (didn't bet)
Seat 2: wesa280 collected ($0.24)
Seat 3: hornetsvp (button) folded before Flop (didn't bet)
Seat 4: 3EBC96 (small blind) folded before Flop
Seat 5: whell11 (big blind) folded on the Flop
Seat 6: Kimiuran folded before Flop (didn't bet)



PokerStars Hand #222951316826:  Hold'em No Limit ($0.05/$0.10 USD) - 2021/01/23 6:53:33 ET
Table 'Polydoros II' 6-max Seat #4 is the button
Seat 1: balisstica ($10 in chips) 
Seat 2: wesa280 ($28.66 in chips) 
Seat 3: hornetsvp ($9.95 in chips) 
Seat 4: 3EBC96 ($17.16 in chips) 
Seat 5: whell11 ($10.27 in chips) 
Seat 6: Kimiuran ($10 in chips) 
whell11: posts small blind $0.05
Kimiuran: posts big blind $0.10
*** HOLE CARDS ***
balisstica: folds 
wesa280: calls $0.10
hornetsvp: folds 
3EBC96: folds 
whell11: folds 
Kimiuran: raises $0.30 to $0.40
wesa280: folds 
Uncalled bet ($0.30) returned to Kimiuran
Kimiuran collected $0.25 from pot
Kimiuran: doesn't show hand 
*** SUMMARY ***
Total pot $0.25 | Rake $0 
Seat 1: balisstica folded before Flop (didn't bet)
Seat 2: wesa280 folded before Flop
Seat 3: hornetsvp folded before Flop (didn't bet)
Seat 4: 3EBC96 (button) folded before Flop (didn't bet)
Seat 5: whell11 (small blind) folded before Flop
Seat 6: Kimiuran (big blind) collected ($0.25)



PokerStars Hand #222951322331:  Hold'em No Limit ($0.05/$0.10 USD) - 2021/01/23 6:53:48 ET
Table 'Polydoros II' 6-max Seat #5 is the button
Seat 1: balisstica ($10 in chips) 
Seat 2: wesa280 ($28.56 in chips) 
Seat 3: hornetsvp ($9.95 in chips) 
Seat 4: 3EBC96 ($17.16 in chips) 
Seat 5: whell11 ($10.22 in chips) 
Seat 6: Kimiuran ($10.15 in chips) 
Kimiuran: posts small blind $0.05
balisstica: posts big blind $0.10
*** HOLE CARDS ***
wesa280: calls $0.10
hornetsvp: calls $0.10
3EBC96: raises $0.30 to $0.40
whell11: folds 
Kimiuran: folds 
balisstica: folds 
wesa280: calls $0.30
hornetsvp: calls $0.30
*** FLOP *** [Td 3c 8s]
wesa280: checks 
hornetsvp: checks 
3EBC96: checks 
*** TURN *** [Td 3c 8s] [9d]
wesa280: checks 
hornetsvp: bets $0.97
3EBC96: folds 
wesa280: folds 
Uncalled bet ($0.97) returned to hornetsvp
hornetsvp collected $1.29 from pot
hornetsvp: doesn't show hand 
*** SUMMARY ***
Total pot $1.35 | Rake $0.06 
Board [Td 3c 8s 9d]
Seat 1: balisstica (big blind) folded before Flop
Seat 2: wesa280 folded on the Turn
Seat 3: hornetsvp collected ($1.29)
Seat 4: 3EBC96 folded on the Turn
Seat 5: whell11 (button) folded before Flop (didn't bet)
Seat 6: Kimiuran (small blind) folded before Flop



PokerStars Hand #222951338494:  Hold'em No Limit ($0.05/$0.10 USD) - 2021/01/23 6:54:34 ET
Table 'Polydoros II' 6-max Seat #6 is the button
Seat 1: balisstica ($10 in chips) 
Seat 2: wesa280 ($28.16 in chips) 
Seat 3: hornetsvp ($10.84 in chips) 
Seat 4: 3EBC96 ($16.76 in chips) 
Seat 5: whell11 ($10.22 in chips) 
Seat 6: Kimiuran ($10.10 in chips) 
balisstica: posts small blind $0.05
wesa280: posts big blind $0.10
*** HOLE CARDS ***
hornetsvp: folds 
3EBC96: folds 
whell11: raises $0.20 to $0.30
Kimiuran: folds 
balisstica: folds 
wesa280: folds 
Uncalled bet ($0.20) returned to whell11
whell11 collected $0.25 from pot
whell11: doesn't show hand 
*** SUMMARY ***
Total pot $0.25 | Rake $0 
Seat 1: balisstica (small blind) folded before Flop
Seat 2: wesa280 (big blind) folded before Flop
Seat 3: hornetsvp folded before Flop (didn't bet)
Seat 4: 3EBC96 folded before Flop (didn't bet)
Seat 5: whell11 collected ($0.25)
Seat 6: Kimiuran (button) folded before Flop (didn't bet)



PokerStars Hand #222951347753:  Hold'em No Limit ($0.05/$0.10 USD) - 2021/01/23 6:55:00 ET
Table 'Polydoros II' 6-max Seat #1 is the button
Seat 1: balisstica ($10 in chips) 
Seat 2: wesa280 ($28.06 in chips) 
Seat 3: hornetsvp ($10.84 in chips) 
Seat 4: 3EBC96 ($16.76 in chips) 
Seat 5: whell11 ($10.37 in chips) 
Seat 6: Kimiuran ($10.10 in chips) 
wesa280: posts small blind $0.05
hornetsvp: posts big blind $0.10
*** HOLE CARDS ***
3EBC96: folds 
whell11: folds 
Kimiuran: folds 
balisstica: folds 
wesa280: calls $0.05
hornetsvp: checks 
*** FLOP *** [Jc Kc 2h]
wesa280: checks 
hornetsvp: checks 
*** TURN *** [Jc Kc 2h] [8h]
wesa280: checks 
hornetsvp: checks 
*** RIVER *** [Jc Kc 2h 8h] [Qd]
wesa280: bets $0.10
hornetsvp: folds 
Uncalled bet ($0.10) returned to wesa280
wesa280 collected $0.19 from pot
wesa280: doesn't show hand 
*** SUMMARY ***
Total pot $0.20 | Rake $0.01 
Board [Jc Kc 2h 8h Qd]
Seat 1: balisstica (button) folded before Flop (didn't bet)
Seat 2: wesa280 (small blind) collected ($0.19)
Seat 3: hornetsvp (big blind) folded on the River
Seat 4: 3EBC96 folded before Flop (didn't bet)
Seat 5: whell11 folded before Flop (didn't bet)
Seat 6: Kimiuran folded before Flop (didn't bet)



PokerStars Hand #222951363055:  Hold'em No Limit ($0.05/$0.10 USD) - 2021/01/23 6:55:50 ET
Table 'Polydoros II' 6-max Seat #2 is the button
Seat 1: balisstica ($10 in chips) 
Seat 2: wesa280 ($28.15 in chips) 
Seat 3: hornetsvp ($10.74 in chips) 
Seat 4: 3EBC96 ($16.76 in chips) 
Seat 6: Kimiuran ($10.10 in chips) 
hornetsvp: posts small blind $0.05
3EBC96: posts big blind $0.10
*** HOLE CARDS ***
Kimiuran: folds 
balisstica: folds 
wesa280: calls $0.10
hornetsvp: folds 
3EBC96: checks 
*** FLOP *** [3h 2h Jh]
3EBC96: checks 
wesa280: bets $0.10
3EBC96: folds 
Uncalled bet ($0.10) returned to wesa280
wesa280 collected $0.24 from pot
wesa280: doesn't show hand 
*** SUMMARY ***
Total pot $0.25 | Rake $0.01 
Board [3h 2h Jh]
Seat 1: balisstica folded before Flop (didn't bet)
Seat 2: wesa280 (button) collected ($0.24)
Seat 3: hornetsvp (small blind) folded before Flop
Seat 4: 3EBC96 (big blind) folded on the Flop
Seat 6: Kimiuran folded before Flop (didn't bet)



PokerStars Hand #222951369090:  Hold'em No Limit ($0.05/$0.10 USD) - 2021/01/23 6:56:09 ET
Table 'Polydoros II' 6-max Seat #3 is the button
Seat 1: balisstica ($10 in chips) 
Seat 2: wesa280 ($28.29 in chips) 
Seat 3: hornetsvp ($10.69 in chips) 
Seat 4: 3EBC96 ($16.66 in chips) 
Seat 6: Kimiuran ($10.10 in chips) 
3EBC96: posts small blind $0.05
Kimiuran: posts big blind $0.10
*** HOLE CARDS ***
balisstica: folds 
wesa280: calls $0.10
hornetsvp: folds 
3EBC96: folds 
Kimiuran: raises $0.30 to $0.40
wesa280: calls $0.30
*** FLOP *** [6d Qd 8c]
Kimiuran: checks 
wesa280: checks 
*** TURN *** [6d Qd 8c] [Js]
Kimiuran: bets $0.54
wesa280: folds 
Uncalled bet ($0.54) returned to Kimiuran
Kimiuran collected $0.81 from pot
Kimiuran: doesn't show hand 
*** SUMMARY ***
Total pot $0.85 | Rake $0.04 
Board [6d Qd 8c Js]
Seat 1: balisstica folded before Flop (didn't bet)
Seat 2: wesa280 folded on the Turn
Seat 3: hornetsvp (button) folded before Flop (didn't bet)
Seat 4: 3EBC96 (small blind) folded before Flop
Seat 6: Kimiuran (big blind) collected ($0.81)



PokerStars Hand #222951376501:  Hold'em No Limit ($0.05/$0.10 USD) - 2021/01/23 6:56:34 ET
Table 'Polydoros II' 6-max Seat #4 is the button
Seat 1: balisstica ($10 in chips) 
Seat 2: wesa280 ($27.89 in chips) 
Seat 3: hornetsvp ($10.69 in chips) 
Seat 4: 3EBC96 ($16.61 in chips) 
Seat 6: Kimiuran ($10.51 in chips) 
Kimiuran: posts small blind $0.05
balisstica: posts big blind $0.10
*** HOLE CARDS ***
wesa280: calls $0.10
hornetsvp: calls $0.10
3EBC96: folds 
Kimiuran: raises $0.40 to $0.50
balisstica: folds 
wesa280: calls $0.40
hornetsvp: folds 
*** FLOP *** [Jh Kd 3c]
Kimiuran: bets $0.58
wesa280: calls $0.58
*** TURN *** [Jh Kd 3c] [5s]
Kimiuran: checks 
wesa280: checks 
*** RIVER *** [Jh Kd 3c 5s] [7s]
Kimiuran: checks 
wesa280: bets $0.10
Kimiuran: calls $0.10
*** SHOW DOWN ***
wesa280: shows [4d Js] (a pair of Jacks)
Kimiuran: shows [Tc Jc] (a pair of Jacks - King+Ten kicker)
Kimiuran collected $2.44 from pot
*** SUMMARY ***
Total pot $2.56 | Rake $0.12 
Board [Jh Kd 3c 5s 7s]
Seat 1: balisstica (big blind) folded before Flop
Seat 2: wesa280 showed [4d Js] and lost with a pair of Jacks
Seat 3: hornetsvp folded before Flop
Seat 4: 3EBC96 (button) folded before Flop (didn't bet)
Seat 6: Kimiuran (small blind) showed [Tc Jc] and won ($2.44) with a pair of Jacks



PokerStars Hand #222951390488:  Hold'em No Limit ($0.05/$0.10 USD) - 2021/01/23 6:57:20 ET
Table 'Polydoros II' 6-max Seat #6 is the button
Seat 1: balisstica ($10 in chips) 
Seat 2: wesa280 ($26.71 in chips) 
Seat 3: hornetsvp ($10.59 in chips) 
Seat 4: 3EBC96 ($16.61 in chips) 
Seat 6: Kimiuran ($11.77 in chips) 
balisstica: posts small blind $0.05
wesa280: posts big blind $0.10
whell11: sits out 
*** HOLE CARDS ***
hornetsvp: folds 
3EBC96: folds 
Kimiuran: raises $0.15 to $0.25
balisstica: folds 
wesa280: calls $0.15
*** FLOP *** [3d 5s 9d]
wesa280: checks 
Kimiuran: checks 
*** TURN *** [3d 5s 9d] [Ad]
wesa280: bets $0.10
Kimiuran: calls $0.10
*** RIVER *** [3d 5s 9d Ad] [6h]
wesa280: checks 
Kimiuran: bets $0.80
wesa280: folds 
Uncalled bet ($0.80) returned to Kimiuran
Kimiuran collected $0.72 from pot
Kimiuran: doesn't show hand 
*** SUMMARY ***
Total pot $0.75 | Rake $0.03 
Board [3d 5s 9d Ad 6h]
Seat 1: balisstica (small blind) folded before Flop
Seat 2: wesa280 (big blind) folded on the River
Seat 3: hornetsvp folded before Flop (didn't bet)
Seat 4: 3EBC96 folded before Flop (didn't bet)
Seat 6: Kimiuran (button) collected ($0.72)



PokerStars Hand #222951401090:  Hold'em No Limit ($0.05/$0.10 USD) - 2021/01/23 6:57:55 ET
Table 'Polydoros II' 6-max Seat #1 is the button
Seat 1: balisstica ($10 in chips) 
Seat 2: wesa280 ($26.36 in chips) 
Seat 3: hornetsvp ($10.59 in chips) 
Seat 4: 3EBC96 ($16.61 in chips) 
Seat 6: Kimiuran ($12.14 in chips) 
wesa280: posts small blind $0.05
hornetsvp: posts big blind $0.10
whell11: sits out 
*** HOLE CARDS ***
3EBC96: folds 
Kimiuran: folds 
balisstica: raises $0.15 to $0.25
wesa280: calls $0.20
hornetsvp: calls $0.15
*** FLOP *** [Kc 7h 2d]
wesa280: checks 
hornetsvp: checks 
balisstica: checks 
*** TURN *** [Kc 7h 2d] [7s]
wesa280: checks 
hornetsvp: checks 
balisstica: bets $0.54
wesa280: folds 
hornetsvp: folds 
Uncalled bet ($0.54) returned to balisstica
balisstica collected $0.72 from pot
balisstica: doesn't show hand 
*** SUMMARY ***
Total pot $0.75 | Rake $0.03 
Board [Kc 7h 2d 7s]
Seat 1: balisstica (button) collected ($0.72)
Seat 2: wesa280 (small blind) folded on the Turn
Seat 3: hornetsvp (big blind) folded on the Turn
Seat 4: 3EBC96 folded before Flop (didn't bet)
Seat 6: Kimiuran folded before Flop (didn't bet)



PokerStars Hand #222951414729:  Hold'em No Limit ($0.05/$0.10 USD) - 2021/01/23 6:58:39 ET
Table 'Polydoros II' 6-max Seat #2 is the button
Seat 1: balisstica ($10.47 in chips) 
Seat 2: wesa280 ($26.11 in chips) 
Seat 3: hornetsvp ($10.34 in chips) 
Seat 4: 3EBC96 ($16.61 in chips) 
Seat 6: Kimiuran ($12.14 in chips) 
hornetsvp: posts small blind $0.05
3EBC96: posts big blind $0.10
whell11: sits out 
*** HOLE CARDS ***
Kimiuran: folds 
balisstica: folds 
wesa280: calls $0.10
hornetsvp: folds 
3EBC96: checks 
*** FLOP *** [Td 9d Js]
3EBC96: checks 
wesa280: checks 
*** TURN *** [Td 9d Js] [Tc]
3EBC96: bets $0.30
wesa280: calls $0.30
*** RIVER *** [Td 9d Js Tc] [5c]
3EBC96: checks 
wesa280: bets $0.90
3EBC96: folds 
Uncalled bet ($0.90) returned to wesa280
wesa280 collected $0.81 from pot
wesa280: doesn't show hand 
*** SUMMARY ***
Total pot $0.85 | Rake $0.04 
Board [Td 9d Js Tc 5c]
Seat 1: balisstica folded before Flop (didn't bet)
Seat 2: wesa280 (button) collected ($0.81)
Seat 3: hornetsvp (small blind) folded before Flop
Seat 4: 3EBC96 (big blind) folded on the River
Seat 6: Kimiuran folded before Flop (didn't bet)



PokerStars Hand #222951427898:  Hold'em No Limit ($0.05/$0.10 USD) - 2021/01/23 6:59:22 ET
Table 'Polydoros II' 6-max Seat #3 is the button
Seat 1: balisstica ($10.47 in chips) 
Seat 2: wesa280 ($26.52 in chips) 
Seat 3: hornetsvp ($10.29 in chips) 
Seat 4: 3EBC96 ($16.21 in chips) 
Seat 5: whell11 ($10.37 in chips) 
Seat 6: Kimiuran ($12.14 in chips) 
3EBC96: posts small blind $0.05
whell11: posts big blind $0.10
*** HOLE CARDS ***
Kimiuran: raises $0.15 to $0.25
balisstica: folds 
wesa280: calls $0.25
hornetsvp: calls $0.25
3EBC96: folds 
whell11: folds 
*** FLOP *** [4h 7d Kh]
Kimiuran: bets $0.57
wesa280: folds 
hornetsvp: raises $1 to $1.57
Kimiuran: calls $1
*** TURN *** [4h 7d Kh] [6c]
Kimiuran: checks 
hornetsvp: bets $1.93
Kimiuran: calls $1.93
*** RIVER *** [4h 7d Kh 6c] [Ac]
Kimiuran: checks 
hornetsvp: bets $6.54 and is all-in
Kimiuran: calls $6.54
*** SHOW DOWN ***
hornetsvp: shows [7s 7h] (three of a kind, Sevens)
Kimiuran: shows [Kc As] (two pair, Aces and Kings)
hornetsvp collected $20.04 from pot
*** SUMMARY ***
Total pot $20.98 | Rake $0.94 
Board [4h 7d Kh 6c Ac]
Seat 1: balisstica folded before Flop (didn't bet)
Seat 2: wesa280 folded on the Flop
Seat 3: hornetsvp (button) showed [7s 7h] and won ($20.04) with three of a kind, Sevens
Seat 4: 3EBC96 (small blind) folded before Flop
Seat 5: whell11 (big blind) folded before Flop
Seat 6: Kimiuran showed [Kc As] and lost with two pair, Aces and Kings



PokerStars Hand #222951451014:  Hold'em No Limit ($0.05/$0.10 USD) - 2021/01/23 7:00:36 ET
Table 'Polydoros II' 6-max Seat #4 is the button
Seat 1: balisstica ($10.47 in chips) 
Seat 2: wesa280 ($26.27 in chips) 
Seat 3: hornetsvp ($20.04 in chips) 
Seat 4: 3EBC96 ($16.16 in chips) 
Seat 5: whell11 ($10.27 in chips) 
Seat 6: Kimiuran ($10 in chips) 
whell11: posts small blind $0.05
Kimiuran: posts big blind $0.10
*** HOLE CARDS ***
balisstica: raises $0.20 to $0.30
wesa280: calls $0.30
hornetsvp: folds 
3EBC96: folds 
whell11: folds 
Kimiuran: folds 
*** FLOP *** [As 3d Ac]
balisstica: checks 
wesa280: checks 
*** TURN *** [As 3d Ac] [Th]
balisstica: checks 
wesa280: checks 
*** RIVER *** [As 3d Ac Th] [Qs]
balisstica: bets $1.50
wesa280: raises $7.20 to $8.70
balisstica: folds 
Uncalled bet ($7.20) returned to wesa280
wesa280 collected $3.58 from pot
wesa280: doesn't show hand 
*** SUMMARY ***
Total pot $3.75 | Rake $0.17 
Board [As 3d Ac Th Qs]
Seat 1: balisstica folded on the River
Seat 2: wesa280 collected ($3.58)
Seat 3: hornetsvp folded before Flop (didn't bet)
Seat 4: 3EBC96 (button) folded before Flop (didn't bet)
Seat 5: whell11 (small blind) folded before Flop
Seat 6: Kimiuran (big blind) folded before Flop



PokerStars Hand #222951472526:  Hold'em No Limit ($0.05/$0.10 USD) - 2021/01/23 7:01:39 ET
Table 'Polydoros II' 6-max Seat #5 is the button
Seat 1: balisstica ($10 in chips) 
Seat 2: wesa280 ($28.05 in chips) 
Seat 3: hornetsvp ($20.04 in chips) 
Seat 4: 3EBC96 ($16.16 in chips) 
Seat 5: whell11 ($10.22 in chips) 
Seat 6: Kimiuran ($10 in chips) 
Kimiuran: posts small blind $0.05
balisstica: posts big blind $0.10
*** HOLE CARDS ***
wesa280: calls $0.10
hornetsvp: folds 
3EBC96: folds 
whell11: folds 
Kimiuran: raises $0.30 to $0.40
balisstica: folds 
wesa280: calls $0.30
*** FLOP *** [6d Jh 9d]
Kimiuran: checks 
wesa280: bets $0.10
Kimiuran: calls $0.10
*** TURN *** [6d Jh 9d] [Kc]
Kimiuran: checks 
wesa280: bets $0.10
Kimiuran: calls $0.10
*** RIVER *** [6d Jh 9d Kc] [8s]
Kimiuran: checks 
wesa280: bets $0.10
Kimiuran: calls $0.10
*** SHOW DOWN ***
wesa280: shows [9c 4h] (a pair of Nines)
Kimiuran: mucks hand 
wesa280 collected $1.43 from pot
*** SUMMARY ***
Total pot $1.50 | Rake $0.07 
Board [6d Jh 9d Kc 8s]
Seat 1: balisstica (big blind) folded before Flop
Seat 2: wesa280 showed [9c 4h] and won ($1.43) with a pair of Nines
Seat 3: hornetsvp folded before Flop (didn't bet)
Seat 4: 3EBC96 folded before Flop (didn't bet)
Seat 5: whell11 (button) folded before Flop (didn't bet)
Seat 6: Kimiuran (small blind) mucked



PokerStars Hand #222951489037:  Hold'em No Limit ($0.05/$0.10 USD) - 2021/01/23 7:02:27 ET
Table 'Polydoros II' 6-max Seat #6 is the button
Seat 1: balisstica ($10 in chips) 
Seat 2: wesa280 ($28.78 in chips) 
Seat 3: hornetsvp ($20.04 in chips) 
Seat 4: 3EBC96 ($16.16 in chips) 
Seat 5: whell11 ($10.22 in chips) 
Seat 6: Kimiuran ($10 in chips) 
balisstica: posts small blind $0.05
wesa280: posts big blind $0.10
*** HOLE CARDS ***
hornetsvp: folds 
3EBC96: folds 
whell11: folds 
Kimiuran: folds 
balisstica: raises $0.20 to $0.30
wesa280: calls $0.20
*** FLOP *** [5h Jc 2s]
balisstica: checks 
wesa280: checks 
*** TURN *** [5h Jc 2s] [2h]
balisstica: checks 
wesa280: bets $0.10
balisstica: calls $0.10
*** RIVER *** [5h Jc 2s 2h] [5c]
balisstica: checks 
wesa280: bets $0.10
balisstica: calls $0.10
*** SHOW DOWN ***
wesa280: shows [9c Qc] (two pair, Fives and Deuces)
balisstica: shows [7s Kh] (two pair, Fives and Deuces - King kicker)
balisstica collected $0.96 from pot
*** SUMMARY ***
Total pot $1 | Rake $0.04 
Board [5h Jc 2s 2h 5c]
Seat 1: balisstica (small blind) showed [7s Kh] and won ($0.96) with two pair, Fives and Deuces
Seat 2: wesa280 (big blind) showed [9c Qc] and lost with two pair, Fives and Deuces
Seat 3: hornetsvp folded before Flop (didn't bet)
Seat 4: 3EBC96 folded before Flop (didn't bet)
Seat 5: whell11 folded before Flop (didn't bet)
Seat 6: Kimiuran (button) folded before Flop (didn't bet)



PokerStars Hand #222951498770:  Hold'em No Limit ($0.05/$0.10 USD) - 2021/01/23 7:02:54 ET
Table 'Polydoros II' 6-max Seat #1 is the button
Seat 1: balisstica ($10.46 in chips) 
Seat 2: wesa280 ($28.28 in chips) 
Seat 3: hornetsvp ($20.04 in chips) 
Seat 4: 3EBC96 ($16.16 in chips) 
Seat 5: whell11 ($10.22 in chips) 
Seat 6: Kimiuran ($10 in chips) 
wesa280: posts small blind $0.05
hornetsvp: posts big blind $0.10
*** HOLE CARDS ***
3EBC96: raises $0.20 to $0.30
whell11: folds 
Kimiuran: folds 
balisstica: raises $0.60 to $0.90
wesa280: calls $0.85
hornetsvp: folds 
3EBC96: calls $0.60
*** FLOP *** [Tc 9d 8d]
wesa280: checks 
3EBC96: checks 
balisstica: checks 
*** TURN *** [Tc 9d 8d] [Jh]
wesa280: bets $1
3EBC96: calls $1
balisstica: folds 
*** RIVER *** [Tc 9d 8d Jh] [6c]
wesa280: bets $0.10
3EBC96: calls $0.10
*** SHOW DOWN ***
wesa280: shows [4c 4h] (a pair of Fours)
3EBC96: shows [8c 8s] (three of a kind, Eights)
3EBC96 collected $4.78 from pot
*** SUMMARY ***
Total pot $5 | Rake $0.22 
Board [Tc 9d 8d Jh 6c]
Seat 1: balisstica (button) folded on the Turn
Seat 2: wesa280 (small blind) showed [4c 4h] and lost with a pair of Fours
Seat 3: hornetsvp (big blind) folded before Flop
Seat 4: 3EBC96 showed [8c 8s] and won ($4.78) with three of a kind, Eights
Seat 5: whell11 folded before Flop (didn't bet)
Seat 6: Kimiuran folded before Flop (didn't bet)



PokerStars Hand #222951519531:  Hold'em No Limit ($0.05/$0.10 USD) - 2021/01/23 7:03:52 ET
Table 'Polydoros II' 6-max Seat #2 is the button
Seat 1: balisstica ($10 in chips) 
Seat 2: wesa280 ($26.28 in chips) 
Seat 3: hornetsvp ($19.94 in chips) 
Seat 4: 3EBC96 ($18.94 in chips) 
Seat 5: whell11 ($10.22 in chips) 
Seat 6: Kimiuran ($10 in chips) 
hornetsvp: posts small blind $0.05
3EBC96: posts big blind $0.10
*** HOLE CARDS ***
whell11: folds 
Kimiuran: raises $0.15 to $0.25
balisstica: folds 
wesa280: calls $0.25
hornetsvp: folds 
3EBC96: folds 
*** FLOP *** [Ts Td 5h]
Kimiuran: bets $0.31
wesa280: calls $0.31
*** TURN *** [Ts Td 5h] [8c]
whell11 leaves the table
Kimiuran: checks 
wesa280: bets $0.10
Laker_Style joins the table at seat #5 
Kimiuran: calls $0.10
*** RIVER *** [Ts Td 5h 8c] [Kd]
Kimiuran: checks 
wesa280: checks 
*** SHOW DOWN ***
Kimiuran: shows [Ah 7h] (a pair of Tens)
wesa280: mucks hand 
Kimiuran collected $1.40 from pot
*** SUMMARY ***
Total pot $1.47 | Rake $0.07 
Board [Ts Td 5h 8c Kd]
Seat 1: balisstica folded before Flop (didn't bet)
Seat 2: wesa280 (button) mucked
Seat 3: hornetsvp (small blind) folded before Flop
Seat 4: 3EBC96 (big blind) folded before Flop
Seat 5: whell11 folded before Flop (didn't bet)
Seat 6: Kimiuran showed [Ah 7h] and won ($1.40) with a pair of Tens



PokerStars Hand #222951536857:  Hold'em No Limit ($0.05/$0.10 USD) - 2021/01/23 7:04:41 ET
Table 'Polydoros II' 6-max Seat #3 is the button
Seat 1: balisstica ($10 in chips) 
Seat 2: wesa280 ($25.62 in chips) 
Seat 3: hornetsvp ($19.89 in chips) 
Seat 4: 3EBC96 ($18.84 in chips) 
Seat 5: Laker_Style ($10 in chips) 
Seat 6: Kimiuran ($10.74 in chips) 
3EBC96: posts small blind $0.05
Laker_Style: posts big blind $0.10
*** HOLE CARDS ***
Kimiuran: folds 
balisstica: folds 
wesa280: calls $0.10
hornetsvp: calls $0.10
3EBC96: folds 
Laker_Style: checks 
*** FLOP *** [Js 6s 3c]
Laker_Style: checks 
wesa280: checks 
hornetsvp: checks 
*** TURN *** [Js 6s 3c] [2s]
Laker_Style: checks 
wesa280: bets $0.10
hornetsvp: calls $0.10
Laker_Style: calls $0.10
*** RIVER *** [Js 6s 3c 2s] [Ac]
Laker_Style: checks 
wesa280: checks 
hornetsvp: checks 
*** SHOW DOWN ***
Laker_Style: shows [5h 6d] (a pair of Sixes)
wesa280: mucks hand 
hornetsvp: shows [4c 5c] (a straight, Deuce to Six)
hornetsvp collected $0.62 from pot
*** SUMMARY ***
Total pot $0.65 | Rake $0.03 
Board [Js 6s 3c 2s Ac]
Seat 1: balisstica folded before Flop (didn't bet)
Seat 2: wesa280 mucked
Seat 3: hornetsvp (button) showed [4c 5c] and won ($0.62) with a straight, Deuce to Six
Seat 4: 3EBC96 (small blind) folded before Flop
Seat 5: Laker_Style (big blind) showed [5h 6d] and lost with a pair of Sixes
Seat 6: Kimiuran folded before Flop (didn't bet)



PokerStars Hand #222951550923:  Hold'em No Limit ($0.05/$0.10 USD) - 2021/01/23 7:05:21 ET
Table 'Polydoros II' 6-max Seat #4 is the button
Seat 1: balisstica ($10 in chips) 
Seat 2: wesa280 ($25.42 in chips) 
Seat 3: hornetsvp ($20.31 in chips) 
Seat 4: 3EBC96 ($18.79 in chips) 
Seat 5: Laker_Style ($10 in chips) 
Seat 6: Kimiuran ($10.74 in chips) 
Laker_Style: posts small blind $0.05
Kimiuran: posts big blind $0.10
*** HOLE CARDS ***
balisstica: folds 
wesa280: calls $0.10
hornetsvp: folds 
3EBC96: raises $0.20 to $0.30
Laker_Style: folds 
Kimiuran: folds 
wesa280: calls $0.20
*** FLOP *** [4h Jc 5c]
wesa280: checks 
3EBC96: bets $0.24
wesa280: calls $0.24
*** TURN *** [4h Jc 5c] [Qh]
wesa280: checks 
3EBC96: bets $0.88
wesa280: calls $0.88
*** RIVER *** [4h Jc 5c Qh] [2c]
wesa280: checks 
3EBC96: bets $2.15
wesa280: raises $2.15 to $4.30
3EBC96: calls $2.15
*** SHOW DOWN ***
wesa280: shows [Qd 5h] (two pair, Queens and Fives)
3EBC96: shows [9c Qc] (a flush, Queen high)
3EBC96 collected $11.07 from pot
*** SUMMARY ***
Total pot $11.59 | Rake $0.52 
Board [4h Jc 5c Qh 2c]
Seat 1: balisstica folded before Flop (didn't bet)
Seat 2: wesa280 showed [Qd 5h] and lost with two pair, Queens and Fives
Seat 3: hornetsvp folded before Flop (didn't bet)
Seat 4: 3EBC96 (button) showed [9c Qc] and won ($11.07) with a flush, Queen high
Seat 5: Laker_Style (small blind) folded before Flop
Seat 6: Kimiuran (big blind) folded before Flop



PokerStars Hand #222951581573:  Hold'em No Limit ($0.05/$0.10 USD) - 2021/01/23 7:06:46 ET
Table 'Polydoros II' 6-max Seat #5 is the button
Seat 1: balisstica ($10 in chips) 
Seat 2: wesa280 ($19.70 in chips) 
Seat 3: hornetsvp ($20.31 in chips) 
Seat 4: 3EBC96 ($24.14 in chips) 
Seat 5: Laker_Style ($10 in chips) 
Seat 6: Kimiuran ($10.64 in chips) 
Kimiuran: posts small blind $0.05
balisstica: posts big blind $0.10
*** HOLE CARDS ***
wesa280: calls $0.10
hornetsvp: calls $0.10
3EBC96: folds 
Laker_Style: raises $0.50 to $0.60
Kimiuran: calls $0.55
balisstica: folds 
wesa280: calls $0.50
hornetsvp: folds 
*** FLOP *** [Kh Ad 3d]
Kimiuran: checks 
wesa280: checks 
Laker_Style: checks 
*** TURN *** [Kh Ad 3d] [6d]
Kimiuran: bets $0.96
wesa280: folds 
Laker_Style: folds 
Uncalled bet ($0.96) returned to Kimiuran
Kimiuran collected $1.91 from pot
Kimiuran: doesn't show hand 
*** SUMMARY ***
Total pot $2 | Rake $0.09 
Board [Kh Ad 3d 6d]
Seat 1: balisstica (big blind) folded before Flop
Seat 2: wesa280 folded on the Turn
Seat 3: hornetsvp folded before Flop
Seat 4: 3EBC96 folded before Flop (didn't bet)
Seat 5: Laker_Style (button) folded on the Turn
Seat 6: Kimiuran (small blind) collected ($1.91)



PokerStars Hand #222951608511:  Hold'em No Limit ($0.05/$0.10 USD) - 2021/01/23 7:08:01 ET
Table 'Polydoros II' 6-max Seat #6 is the button
Seat 1: balisstica ($10 in chips) 
Seat 2: wesa280 ($19.10 in chips) 
Seat 3: hornetsvp ($20.21 in chips) 
Seat 4: 3EBC96 ($24.14 in chips) 
Seat 5: Laker_Style ($10 in chips) 
Seat 6: Kimiuran ($11.95 in chips) 
balisstica: posts small blind $0.05
wesa280: posts big blind $0.10
*** HOLE CARDS ***
hornetsvp: folds 
3EBC96: raises $0.20 to $0.30
Laker_Style: calls $0.30
Kimiuran: folds 
balisstica: folds 
wesa280: calls $0.20
*** FLOP *** [Ah 7s 2d]
wesa280: checks 
3EBC96: checks 
Laker_Style: checks 
*** TURN *** [Ah 7s 2d] [Ts]
wesa280: checks 
3EBC96: checks 
Laker_Style: checks 
*** RIVER *** [Ah 7s 2d Ts] [Ac]
wesa280: bets $0.10
3EBC96: folds 
Laker_Style: calls $0.10
*** SHOW DOWN ***
wesa280: shows [5s 8s] (a pair of Aces)
Laker_Style: shows [9d Td] (two pair, Aces and Tens)
Laker_Style collected $1.10 from pot
*** SUMMARY ***
Total pot $1.15 | Rake $0.05 
Board [Ah 7s 2d Ts Ac]
Seat 1: balisstica (small blind) folded before Flop
Seat 2: wesa280 (big blind) showed [5s 8s] and lost with a pair of Aces
Seat 3: hornetsvp folded before Flop (didn't bet)
Seat 4: 3EBC96 folded on the River
Seat 5: Laker_Style showed [9d Td] and won ($1.10) with two pair, Aces and Tens
Seat 6: Kimiuran (button) folded before Flop (didn't bet)



PokerStars Hand #222951626237:  Hold'em No Limit ($0.05/$0.10 USD) - 2021/01/23 7:08:50 ET
Table 'Polydoros II' 6-max Seat #1 is the button
Seat 1: balisstica ($10 in chips) 
Seat 2: wesa280 ($18.70 in chips) 
Seat 3: hornetsvp ($20.21 in chips) 
Seat 4: 3EBC96 ($23.84 in chips) 
Seat 5: Laker_Style ($10.70 in chips) 
Seat 6: Kimiuran ($11.95 in chips) 
wesa280: posts small blind $0.05
hornetsvp: posts big blind $0.10
*** HOLE CARDS ***
3EBC96: folds 
Laker_Style: folds 
Kimiuran: raises $0.15 to $0.25
balisstica: folds 
wesa280: calls $0.20
hornetsvp: folds 
*** FLOP *** [Qh 7h 6d]
wesa280: bets $0.10
Kimiuran: calls $0.10
*** TURN *** [Qh 7h 6d] [Th]
wesa280: checks 
Kimiuran: checks 
*** RIVER *** [Qh 7h 6d Th] [Ad]
wesa280: bets $0.10
Kimiuran: calls $0.10
*** SHOW DOWN ***
wesa280: shows [2s 4d] (high card Ace)
Kimiuran: shows [As 9c] (a pair of Aces)
Kimiuran collected $0.96 from pot
*** SUMMARY ***
Total pot $1 | Rake $0.04 
Board [Qh 7h 6d Th Ad]
Seat 1: balisstica (button) folded before Flop (didn't bet)
Seat 2: wesa280 (small blind) showed [2s 4d] and lost with high card Ace
Seat 3: hornetsvp (big blind) folded before Flop
Seat 4: 3EBC96 folded before Flop (didn't bet)
Seat 5: Laker_Style folded before Flop (didn't bet)
Seat 6: Kimiuran showed [As 9c] and won ($0.96) with a pair of Aces



PokerStars Hand #222951637055:  Hold'em No Limit ($0.05/$0.10 USD) - 2021/01/23 7:09:20 ET
Table 'Polydoros II' 6-max Seat #2 is the button
Seat 1: balisstica ($10 in chips) 
Seat 2: wesa280 ($18.25 in chips) 
Seat 3: hornetsvp ($20.11 in chips) 
Seat 4: 3EBC96 ($23.84 in chips) 
Seat 5: Laker_Style ($10.70 in chips) 
Seat 6: Kimiuran ($12.46 in chips) 
hornetsvp: posts small blind $0.05
3EBC96: posts big blind $0.10
*** HOLE CARDS ***
Laker_Style: folds 
Kimiuran: folds 
balisstica: raises $0.20 to $0.30
wesa280: calls $0.30
hornetsvp: folds 
3EBC96: folds 
*** FLOP *** [7d 6h 6c]
balisstica: bets $0.24
wesa280: calls $0.24
*** TURN *** [7d 6h 6c] [Kd]
balisstica: checks 
wesa280: checks 
*** RIVER *** [7d 6h 6c Kd] [8d]
balisstica: checks 
wesa280: bets $5.30
balisstica: folds 
Uncalled bet ($5.30) returned to wesa280
wesa280 collected $1.17 from pot
wesa280: doesn't show hand 
*** SUMMARY ***
Total pot $1.23 | Rake $0.06 
Board [7d 6h 6c Kd 8d]
Seat 1: balisstica folded on the River
Seat 2: wesa280 (button) collected ($1.17)
Seat 3: hornetsvp (small blind) folded before Flop
Seat 4: 3EBC96 (big blind) folded before Flop
Seat 5: Laker_Style folded before Flop (didn't bet)
Seat 6: Kimiuran folded before Flop (didn't bet)



PokerStars Hand #222951655834:  Hold'em No Limit ($0.05/$0.10 USD) - 2021/01/23 7:10:12 ET
Table 'Polydoros II' 6-max Seat #3 is the button
Seat 1: balisstica ($10 in chips) 
Seat 2: wesa280 ($18.88 in chips) 
Seat 3: hornetsvp ($20.06 in chips) 
Seat 4: 3EBC96 ($23.74 in chips) 
Seat 5: Laker_Style ($10.70 in chips) 
Seat 6: Kimiuran ($12.46 in chips) 
3EBC96: posts small blind $0.05
Laker_Style: posts big blind $0.10
*** HOLE CARDS ***
Kimiuran: folds 
balisstica: folds 
balisstica was removed from the table for failing to post
balisstica leaves the table
wesa280: calls $0.10
hornetsvp: folds 
balisstica joins the table at seat #1 
3EBC96: folds 
Laker_Style: checks 
*** FLOP *** [Qc Ah 8c]
Laker_Style: checks 
wesa280: checks 
*** TURN *** [Qc Ah 8c] [7s]
Laker_Style: checks 
wesa280: checks 
*** RIVER *** [Qc Ah 8c 7s] [8s]
Laker_Style: bets $0.20
wesa280: folds 
Uncalled bet ($0.20) returned to Laker_Style
Laker_Style collected $0.24 from pot
Laker_Style: doesn't show hand 
*** SUMMARY ***
Total pot $0.25 | Rake $0.01 
Board [Qc Ah 8c 7s 8s]
Seat 1: balisstica folded before Flop (didn't bet)
Seat 2: wesa280 folded on the River
Seat 3: hornetsvp (button) folded before Flop (didn't bet)
Seat 4: 3EBC96 (small blind) folded before Flop
Seat 5: Laker_Style (big blind) collected ($0.24)
Seat 6: Kimiuran folded before Flop (didn't bet)



PokerStars Hand #222951679404:  Hold'em No Limit ($0.05/$0.10 USD) - 2021/01/23 7:11:17 ET
Table 'Polydoros II' 6-max Seat #4 is the button
Seat 2: wesa280 ($18.78 in chips) 
Seat 3: hornetsvp ($20.06 in chips) 
Seat 4: 3EBC96 ($23.69 in chips) 
Seat 5: Laker_Style ($10.84 in chips) 
Seat 6: Kimiuran ($12.46 in chips) 
Laker_Style: posts small blind $0.05
Kimiuran: posts big blind $0.10
balisstica: sits out 
*** HOLE CARDS ***
wesa280: calls $0.10
hornetsvp: folds 
3EBC96: folds 
Laker_Style: folds 
Kimiuran: raises $0.30 to $0.40
wesa280: calls $0.30
*** FLOP *** [Th 2d 9c]
Kimiuran: bets $0.41
wesa280: calls $0.41
*** TURN *** [Th 2d 9c] [4d]
Kimiuran: checks 
wesa280: checks 
*** RIVER *** [Th 2d 9c 4d] [8d]
Kimiuran: checks 
wesa280: bets $0.10
Kimiuran: calls $0.10
*** SHOW DOWN ***
wesa280: shows [Kc 3c] (high card King)
Kimiuran: shows [9h 8h] (two pair, Nines and Eights)
Kimiuran collected $1.79 from pot
*** SUMMARY ***
Total pot $1.87 | Rake $0.08 
Board [Th 2d 9c 4d 8d]
Seat 2: wesa280 showed [Kc 3c] and lost with high card King
Seat 3: hornetsvp folded before Flop (didn't bet)
Seat 4: 3EBC96 (button) folded before Flop (didn't bet)
Seat 5: Laker_Style (small blind) folded before Flop
Seat 6: Kimiuran (big blind) showed [9h 8h] and won ($1.79) with two pair, Nines and Eights



PokerStars Hand #222951694628:  Hold'em No Limit ($0.05/$0.10 USD) - 2021/01/23 7:11:58 ET
Table 'Polydoros II' 6-max Seat #5 is the button
Seat 1: balisstica ($10 in chips) 
Seat 2: wesa280 ($17.87 in chips) 
Seat 3: hornetsvp ($20.06 in chips) 
Seat 4: 3EBC96 ($23.69 in chips) 
Seat 5: Laker_Style ($10.79 in chips) 
Seat 6: Kimiuran ($13.34 in chips) 
Kimiuran: posts small blind $0.05
balisstica: posts big blind $0.10
*** HOLE CARDS ***
wesa280: calls $0.10
hornetsvp: folds 
3EBC96: folds 
Laker_Style has timed out
Laker_Style: folds 
Kimiuran: folds 
balisstica: checks 
*** FLOP *** [3c Js Ts]
balisstica: checks 
wesa280: checks 
*** TURN *** [3c Js Ts] [6d]
balisstica: checks 
wesa280: bets $0.10
balisstica: folds 
Uncalled bet ($0.10) returned to wesa280
wesa280 collected $0.24 from pot
wesa280: doesn't show hand 
*** SUMMARY ***
Total pot $0.25 | Rake $0.01 
Board [3c Js Ts 6d]
Seat 1: balisstica (big blind) folded on the Turn
Seat 2: wesa280 collected ($0.24)
Seat 3: hornetsvp folded before Flop (didn't bet)
Seat 4: 3EBC96 folded before Flop (didn't bet)
Seat 5: Laker_Style (button) folded before Flop (didn't bet)
Seat 6: Kimiuran (small blind) folded before Flop



PokerStars Hand #222951710706:  Hold'em No Limit ($0.05/$0.10 USD) - 2021/01/23 7:12:42 ET
Table 'Polydoros II' 6-max Seat #6 is the button
Seat 1: balisstica ($10 in chips) 
Seat 2: wesa280 ($18.01 in chips) 
Seat 3: hornetsvp ($20.06 in chips) 
Seat 4: 3EBC96 ($23.69 in chips) 
Seat 5: Laker_Style ($10.79 in chips) 
Seat 6: Kimiuran ($13.29 in chips) 
balisstica: posts small blind $0.05
wesa280: posts big blind $0.10
*** HOLE CARDS ***
hornetsvp: folds 
3EBC96: folds 
Laker_Style: folds 
Kimiuran: folds 
balisstica: folds 
Uncalled bet ($0.05) returned to wesa280
wesa280 collected $0.10 from pot
wesa280: doesn't show hand 
*** SUMMARY ***
Total pot $0.10 | Rake $0 
Seat 1: balisstica (small blind) folded before Flop
Seat 2: wesa280 (big blind) collected ($0.10)
Seat 3: hornetsvp folded before Flop (didn't bet)
Seat 4: 3EBC96 folded before Flop (didn't bet)
Seat 5: Laker_Style folded before Flop (didn't bet)
Seat 6: Kimiuran (button) folded before Flop (didn't bet)



PokerStars Hand #222951716966:  Hold'em No Limit ($0.05/$0.10 USD) - 2021/01/23 7:12:59 ET
Table 'Polydoros II' 6-max Seat #1 is the button
Seat 1: balisstica ($10 in chips) 
Seat 2: wesa280 ($18.06 in chips) 
Seat 3: hornetsvp ($20.06 in chips) 
Seat 4: 3EBC96 ($23.69 in chips) 
Seat 5: Laker_Style ($10.79 in chips) 
Seat 6: Kimiuran ($13.29 in chips) 
wesa280: posts small blind $0.05
hornetsvp: posts big blind $0.10
*** HOLE CARDS ***
3EBC96: folds 
Laker_Style: folds 
Kimiuran: raises $0.15 to $0.25
balisstica: folds 
wesa280: folds 
hornetsvp: folds 
Uncalled bet ($0.15) returned to Kimiuran
Kimiuran collected $0.25 from pot
Kimiuran: doesn't show hand 
*** SUMMARY ***
Total pot $0.25 | Rake $0 
Seat 1: balisstica (button) folded before Flop (didn't bet)
Seat 2: wesa280 (small blind) folded before Flop
Seat 3: hornetsvp (big blind) folded before Flop
Seat 4: 3EBC96 folded before Flop (didn't bet)
Seat 5: Laker_Style folded before Flop (didn't bet)
Seat 6: Kimiuran collected ($0.25)



PokerStars Hand #222951724406:  Hold'em No Limit ($0.05/$0.10 USD) - 2021/01/23 7:13:19 ET
Table 'Polydoros II' 6-max Seat #2 is the button
Seat 1: balisstica ($10 in chips) 
Seat 2: wesa280 ($18.01 in chips) 
Seat 3: hornetsvp ($19.96 in chips) 
Seat 4: 3EBC96 ($23.69 in chips) 
Seat 5: Laker_Style ($10.79 in chips) 
Seat 6: Kimiuran ($13.44 in chips) 
hornetsvp: posts small blind $0.05
3EBC96: posts big blind $0.10
*** HOLE CARDS ***
Laker_Style: folds 
Kimiuran: folds 
balisstica: folds 
wesa280: calls $0.10
hornetsvp: folds 
3EBC96: checks 
*** FLOP *** [6s Jd Qh]
3EBC96: checks 
wesa280: checks 
*** TURN *** [6s Jd Qh] [2c]
3EBC96: checks 
wesa280: checks 
*** RIVER *** [6s Jd Qh 2c] [Th]
3EBC96: checks 
wesa280: bets $0.10
3EBC96: calls $0.10
*** SHOW DOWN ***
wesa280: shows [2h 4s] (a pair of Deuces)
3EBC96: shows [3h Ts] (a pair of Tens)
3EBC96 collected $0.43 from pot
*** SUMMARY ***
Total pot $0.45 | Rake $0.02 
Board [6s Jd Qh 2c Th]
Seat 1: balisstica folded before Flop (didn't bet)
Seat 2: wesa280 (button) showed [2h 4s] and lost with a pair of Deuces
Seat 3: hornetsvp (small blind) folded before Flop
Seat 4: 3EBC96 (big blind) showed [3h Ts] and won ($0.43) with a pair of Tens
Seat 5: Laker_Style folded before Flop (didn't bet)
Seat 6: Kimiuran folded before Flop (didn't bet)



PokerStars Hand #222951741933:  Hold'em No Limit ($0.05/$0.10 USD) - 2021/01/23 7:13:43 ET
Table 'Polydoros II' 6-max Seat #3 is the button
Seat 1: balisstica ($10 in chips) 
Seat 2: wesa280 ($17.81 in chips) 
Seat 3: hornetsvp ($19.91 in chips) 
Seat 4: 3EBC96 ($23.92 in chips) 
Seat 5: Laker_Style ($10.79 in chips) 
Seat 6: Kimiuran ($13.44 in chips) 
3EBC96: posts small blind $0.05
Laker_Style: posts big blind $0.10
*** HOLE CARDS ***
Kimiuran: folds 
balisstica: folds 
wesa280: calls $0.10
hornetsvp: folds 
3EBC96: folds 
Laker_Style: raises $0.40 to $0.50
wesa280: calls $0.40
*** FLOP *** [8h 4h 3h]
Laker_Style: bets $0.70
wesa280: calls $0.70
*** TURN *** [8h 4h 3h] [9c]
Laker_Style: bets $1.87
wesa280: folds 
Uncalled bet ($1.87) returned to Laker_Style
Laker_Style collected $2.34 from pot
Laker_Style: doesn't show hand 
*** SUMMARY ***
Total pot $2.45 | Rake $0.11 
Board [8h 4h 3h 9c]
Seat 1: balisstica folded before Flop (didn't bet)
Seat 2: wesa280 folded on the Turn
Seat 3: hornetsvp (button) folded before Flop (didn't bet)
Seat 4: 3EBC96 (small blind) folded before Flop
Seat 5: Laker_Style (big blind) collected ($2.34)
Seat 6: Kimiuran folded before Flop (didn't bet)



PokerStars Hand #222951754604:  Hold'em No Limit ($0.05/$0.10 USD) - 2021/01/23 7:14:17 ET
Table 'Polydoros II' 6-max Seat #4 is the button
Seat 1: balisstica ($10 in chips) 
Seat 2: wesa280 ($16.61 in chips) 
Seat 3: hornetsvp ($19.91 in chips) 
Seat 4: 3EBC96 ($23.87 in chips) 
Seat 5: Laker_Style ($11.93 in chips) 
Seat 6: Kimiuran ($13.44 in chips) 
Laker_Style: posts small blind $0.05
Kimiuran: posts big blind $0.10
*** HOLE CARDS ***
balisstica: folds 
wesa280: calls $0.10
hornetsvp has timed out
hornetsvp: folds 
3EBC96: folds 
Laker_Style: folds 
Kimiuran: checks 
*** FLOP *** [Jd 9h 5s]
Kimiuran: bets $0.12
wesa280: calls $0.12
*** TURN *** [Jd 9h 5s] [3c]
Kimiuran: bets $0.24
wesa280: calls $0.24
*** RIVER *** [Jd 9h 5s 3c] [As]
Kimiuran: checks 
wesa280: bets $0.10
Kimiuran: calls $0.10
*** SHOW DOWN ***
wesa280: shows [5c 4c] (a pair of Fives)
Kimiuran: shows [6d Js] (a pair of Jacks)
Kimiuran collected $1.12 from pot
*** SUMMARY ***
Total pot $1.17 | Rake $0.05 
Board [Jd 9h 5s 3c As]
Seat 1: balisstica folded before Flop (didn't bet)
Seat 2: wesa280 showed [5c 4c] and lost with a pair of Fives
Seat 3: hornetsvp folded before Flop (didn't bet)
Seat 4: 3EBC96 (button) folded before Flop (didn't bet)
Seat 5: Laker_Style (small blind) folded before Flop
Seat 6: Kimiuran (big blind) showed [6d Js] and won ($1.12) with a pair of Jacks



PokerStars Hand #222951769127:  Hold'em No Limit ($0.05/$0.10 USD) - 2021/01/23 7:14:57 ET
Table 'Polydoros II' 6-max Seat #5 is the button
Seat 1: balisstica ($10 in chips) 
Seat 2: wesa280 ($16.05 in chips) 
Seat 3: hornetsvp ($19.91 in chips) 
Seat 4: 3EBC96 ($23.87 in chips) 
Seat 5: Laker_Style ($11.88 in chips) 
Seat 6: Kimiuran ($14 in chips) 
Kimiuran: posts small blind $0.05
balisstica: posts big blind $0.10
*** HOLE CARDS ***
wesa280: calls $0.10
hornetsvp: folds 
3EBC96: raises $0.20 to $0.30
Laker_Style: folds 
Kimiuran: folds 
balisstica: folds 
wesa280: calls $0.20
*** FLOP *** [3d 8c 4c]
wesa280: checks 
3EBC96: bets $0.36
wesa280: folds 
Uncalled bet ($0.36) returned to 3EBC96
3EBC96 collected $0.72 from pot
3EBC96: doesn't show hand 
*** SUMMARY ***
Total pot $0.75 | Rake $0.03 
Board [3d 8c 4c]
Seat 1: balisstica (big blind) folded before Flop
Seat 2: wesa280 folded on the Flop
Seat 3: hornetsvp folded before Flop (didn't bet)
Seat 4: 3EBC96 collected ($0.72)
Seat 5: Laker_Style (button) folded before Flop (didn't bet)
Seat 6: Kimiuran (small blind) folded before Flop



PokerStars Hand #222951778286:  Hold'em No Limit ($0.05/$0.10 USD) - 2021/01/23 7:15:22 ET
Table 'Polydoros II' 6-max Seat #6 is the button
Seat 1: balisstica ($10 in chips) 
Seat 2: wesa280 ($15.75 in chips) 
Seat 3: hornetsvp ($19.91 in chips) 
Seat 4: 3EBC96 ($24.29 in chips) 
Seat 5: Laker_Style ($11.88 in chips) 
Seat 6: Kimiuran ($13.95 in chips) 
balisstica: posts small blind $0.05
wesa280: posts big blind $0.10
*** HOLE CARDS ***
hornetsvp has timed out
hornetsvp: folds 
3EBC96: folds 
Laker_Style: folds 
Kimiuran: folds 
balisstica: raises $0.20 to $0.30
wesa280: calls $0.20
*** FLOP *** [Qc Ks Qh]
balisstica: bets $0.19
wesa280: raises $0.19 to $0.38
balisstica: calls $0.19
*** TURN *** [Qc Ks Qh] [5c]
balisstica: checks 
wesa280: bets $0.10
balisstica: calls $0.10
*** RIVER *** [Qc Ks Qh 5c] [Kc]
balisstica: checks 
wesa280: bets $1.20
balisstica: folds 
Uncalled bet ($1.20) returned to wesa280
wesa280 collected $1.49 from pot
wesa280: doesn't show hand 
*** SUMMARY ***
Total pot $1.56 | Rake $0.07 
Board [Qc Ks Qh 5c Kc]
Seat 1: balisstica (small blind) folded on the River
Seat 2: wesa280 (big blind) collected ($1.49)
Seat 3: hornetsvp folded before Flop (didn't bet)
Seat 4: 3EBC96 folded before Flop (didn't bet)
Seat 5: Laker_Style folded before Flop (didn't bet)
Seat 6: Kimiuran (button) folded before Flop (didn't bet)



PokerStars Hand #222951798046:  Hold'em No Limit ($0.05/$0.10 USD) - 2021/01/23 7:16:16 ET
Table 'Polydoros II' 6-max Seat #1 is the button
Seat 1: balisstica ($10 in chips) 
Seat 2: wesa280 ($16.46 in chips) 
Seat 3: hornetsvp ($19.91 in chips) 
Seat 4: 3EBC96 ($24.29 in chips) 
Seat 5: Laker_Style ($11.88 in chips) 
Seat 6: Kimiuran ($13.95 in chips) 
wesa280: posts small blind $0.05
hornetsvp: posts big blind $0.10
*** HOLE CARDS ***
3EBC96: folds 
Laker_Style: folds 
Kimiuran: folds 
balisstica: folds 
wesa280: calls $0.05
hornetsvp: checks 
*** FLOP *** [7d 9c Qh]
wesa280: checks 
hornetsvp: checks 
*** TURN *** [7d 9c Qh] [Ks]
wesa280: checks 
hornetsvp: bets $0.14
wesa280: calls $0.14
*** RIVER *** [7d 9c Qh Ks] [5h]
wesa280: checks 
hornetsvp: checks 
*** SHOW DOWN ***
wesa280: shows [9s 9h] (three of a kind, Nines)
hornetsvp: mucks hand 
wesa280 collected $0.46 from pot
*** SUMMARY ***
Total pot $0.48 | Rake $0.02 
Board [7d 9c Qh Ks 5h]
Seat 1: balisstica (button) folded before Flop (didn't bet)
Seat 2: wesa280 (small blind) showed [9s 9h] and won ($0.46) with three of a kind, Nines
Seat 3: hornetsvp (big blind) mucked
Seat 4: 3EBC96 folded before Flop (didn't bet)
Seat 5: Laker_Style folded before Flop (didn't bet)
Seat 6: Kimiuran folded before Flop (didn't bet)



PokerStars Hand #222951816986:  Hold'em No Limit ($0.05/$0.10 USD) - 2021/01/23 7:17:08 ET
Table 'Polydoros II' 6-max Seat #2 is the button
Seat 1: balisstica ($10 in chips) 
Seat 2: wesa280 ($16.68 in chips) 
Seat 3: hornetsvp ($19.67 in chips) 
Seat 4: 3EBC96 ($24.29 in chips) 
Seat 5: Laker_Style ($11.88 in chips) 
Seat 6: Kimiuran ($13.95 in chips) 
hornetsvp: posts small blind $0.05
3EBC96: posts big blind $0.10
*** HOLE CARDS ***
Laker_Style: folds 
Kimiuran: folds 
balisstica: folds 
wesa280: calls $0.10
hornetsvp: folds 
3EBC96: checks 
*** FLOP *** [Qs 6s 5c]
3EBC96: checks 
wesa280: checks 
*** TURN *** [Qs 6s 5c] [Qd]
3EBC96: checks 
wesa280: bets $0.10
3EBC96: calls $0.10
*** RIVER *** [Qs 6s 5c Qd] [Ad]
3EBC96: checks 
wesa280: bets $0.10
3EBC96: calls $0.10
*** SHOW DOWN ***
wesa280: shows [3d 6c] (two pair, Queens and Sixes)
3EBC96: mucks hand 
wesa280 collected $0.62 from pot
*** SUMMARY ***
Total pot $0.65 | Rake $0.03 
Board [Qs 6s 5c Qd Ad]
Seat 1: balisstica folded before Flop (didn't bet)
Seat 2: wesa280 (button) showed [3d 6c] and won ($0.62) with two pair, Queens and Sixes
Seat 3: hornetsvp (small blind) folded before Flop
Seat 4: 3EBC96 (big blind) mucked
Seat 5: Laker_Style folded before Flop (didn't bet)
Seat 6: Kimiuran folded before Flop (didn't bet)



PokerStars Hand #222951831713:  Hold'em No Limit ($0.05/$0.10 USD) - 2021/01/23 7:17:47 ET
Table 'Polydoros II' 6-max Seat #3 is the button
Seat 1: balisstica ($10 in chips) 
Seat 2: wesa280 ($17 in chips) 
Seat 3: hornetsvp ($19.62 in chips) 
Seat 4: 3EBC96 ($23.99 in chips) 
Seat 6: Kimiuran ($13.95 in chips) 
3EBC96: posts small blind $0.05
Laker_Style: is sitting out 
Kimiuran: posts big blind $0.10
*** HOLE CARDS ***
balisstica: folds 
wesa280: calls $0.10
hornetsvp: folds 
3EBC96: folds 
Kimiuran: checks 
*** FLOP *** [Jh Ac Ad]
Laker_Style leaves the table
Kimiuran: checks 
wesa280: bets $0.10
Kimiuran: calls $0.10
*** TURN *** [Jh Ac Ad] [8c]
Kimiuran: checks 
wesa280: bets $0.10
Lergik joins the table at seat #5 
Kimiuran: calls $0.10
*** RIVER *** [Jh Ac Ad 8c] [6d]
Kimiuran: checks 
wesa280: bets $1.50
Kimiuran: folds 
Uncalled bet ($1.50) returned to wesa280
wesa280 collected $0.62 from pot
wesa280: doesn't show hand 
*** SUMMARY ***
Total pot $0.65 | Rake $0.03 
Board [Jh Ac Ad 8c 6d]
Seat 1: balisstica folded before Flop (didn't bet)
Seat 2: wesa280 collected ($0.62)
Seat 3: hornetsvp (button) folded before Flop (didn't bet)
Seat 4: 3EBC96 (small blind) folded before Flop
Seat 6: Kimiuran (big blind) folded on the River



PokerStars Hand #222951843602:  Hold'em No Limit ($0.05/$0.10 USD) - 2021/01/23 7:18:20 ET
Table 'Polydoros II' 6-max Seat #4 is the button
Seat 1: balisstica ($10 in chips) 
Seat 2: wesa280 ($17.32 in chips) 
Seat 3: hornetsvp ($19.62 in chips) 
Seat 4: 3EBC96 ($23.94 in chips) 
Seat 6: Kimiuran ($13.65 in chips) 
Kimiuran: posts small blind $0.05
balisstica: posts big blind $0.10
*** HOLE CARDS ***
wesa280: calls $0.10
hornetsvp: folds 
3EBC96: folds 
Kimiuran: folds 
balisstica: checks 
*** FLOP *** [8d 3c 5c]
balisstica: checks 
wesa280: checks 
*** TURN *** [8d 3c 5c] [Th]
balisstica: checks 
wesa280: bets $0.10
balisstica: folds 
Uncalled bet ($0.10) returned to wesa280
wesa280 collected $0.24 from pot
wesa280: doesn't show hand 
*** SUMMARY ***
Total pot $0.25 | Rake $0.01 
Board [8d 3c 5c Th]
Seat 1: balisstica (big blind) folded on the Turn
Seat 2: wesa280 collected ($0.24)
Seat 3: hornetsvp folded before Flop (didn't bet)
Seat 4: 3EBC96 (button) folded before Flop (didn't bet)
Seat 6: Kimiuran (small blind) folded before Flop



PokerStars Hand #222951856685:  Hold'em No Limit ($0.05/$0.10 USD) - 2021/01/23 7:18:56 ET
Table 'Polydoros II' 6-max Seat #6 is the button
Seat 1: balisstica ($10 in chips) 
Seat 2: wesa280 ($17.46 in chips) 
Seat 3: hornetsvp ($19.62 in chips) 
Seat 4: 3EBC96 ($23.94 in chips) 
Seat 6: Kimiuran ($13.60 in chips) 
balisstica: posts small blind $0.05
wesa280: posts big blind $0.10
Lergik: sits out 
*** HOLE CARDS ***
hornetsvp: folds 
3EBC96: folds 
Kimiuran: folds 
balisstica: folds 
Uncalled bet ($0.05) returned to wesa280
wesa280 collected $0.10 from pot
wesa280: doesn't show hand 
*** SUMMARY ***
Total pot $0.10 | Rake $0 
Seat 1: balisstica (small blind) folded before Flop
Seat 2: wesa280 (big blind) collected ($0.10)
Seat 3: hornetsvp folded before Flop (didn't bet)
Seat 4: 3EBC96 folded before Flop (didn't bet)
Seat 6: Kimiuran (button) folded before Flop (didn't bet)



PokerStars Hand #222951860387:  Hold'em No Limit ($0.05/$0.10 USD) - 2021/01/23 7:19:06 ET
Table 'Polydoros II' 6-max Seat #1 is the button
Seat 1: balisstica ($10 in chips) 
Seat 2: wesa280 ($17.51 in chips) 
Seat 3: hornetsvp ($19.62 in chips) 
Seat 4: 3EBC96 ($23.94 in chips) 
Seat 6: Kimiuran ($13.60 in chips) 
wesa280: posts small blind $0.05
hornetsvp: posts big blind $0.10
Lergik: sits out 
*** HOLE CARDS ***
3EBC96: folds 
Kimiuran: folds 
balisstica: raises $0.15 to $0.25
wesa280: calls $0.20
hornetsvp: raises $0.75 to $1
balisstica: folds 
wesa280: folds 
Uncalled bet ($0.75) returned to hornetsvp
hornetsvp collected $0.75 from pot
hornetsvp: doesn't show hand 
*** SUMMARY ***
Total pot $0.75 | Rake $0 
Seat 1: balisstica (button) folded before Flop
Seat 2: wesa280 (small blind) folded before Flop
Seat 3: hornetsvp (big blind) collected ($0.75)
Seat 4: 3EBC96 folded before Flop (didn't bet)
Seat 6: Kimiuran folded before Flop (didn't bet)



PokerStars Hand #222951868355:  Hold'em No Limit ($0.05/$0.10 USD) - 2021/01/23 7:19:28 ET
Table 'Polydoros II' 6-max Seat #2 is the button
Seat 1: balisstica ($10 in chips) 
Seat 2: wesa280 ($17.26 in chips) 
Seat 3: hornetsvp ($20.12 in chips) 
Seat 4: 3EBC96 ($23.94 in chips) 
Seat 6: Kimiuran ($13.60 in chips) 
hornetsvp: posts small blind $0.05
3EBC96: posts big blind $0.10
Lergik: sits out 
*** HOLE CARDS ***
Kimiuran: folds 
balisstica: folds 
wesa280: calls $0.10
hornetsvp: folds 
3EBC96: checks 
*** FLOP *** [Ad 9h Ks]
3EBC96: checks 
wesa280: checks 
*** TURN *** [Ad 9h Ks] [6d]
3EBC96: checks 
wesa280: checks 
*** RIVER *** [Ad 9h Ks 6d] [7s]
3EBC96: checks 
wesa280: bets $1.40
3EBC96: folds 
Uncalled bet ($1.40) returned to wesa280
wesa280 collected $0.24 from pot
wesa280: doesn't show hand 
*** SUMMARY ***
Total pot $0.25 | Rake $0.01 
Board [Ad 9h Ks 6d 7s]
Seat 1: balisstica folded before Flop (didn't bet)
Seat 2: wesa280 (button) collected ($0.24)
Seat 3: hornetsvp (small blind) folded before Flop
Seat 4: 3EBC96 (big blind) folded on the River
Seat 6: Kimiuran folded before Flop (didn't bet)



PokerStars Hand #222951881835:  Hold'em No Limit ($0.05/$0.10 USD) - 2021/01/23 7:20:05 ET
Table 'Polydoros II' 6-max Seat #3 is the button
Seat 1: balisstica ($10 in chips) 
Seat 2: wesa280 ($17.40 in chips) 
Seat 3: hornetsvp ($20.07 in chips) 
Seat 4: 3EBC96 ($23.84 in chips) 
Seat 5: Lergik ($10 in chips) 
Seat 6: Kimiuran ($13.60 in chips) 
3EBC96: posts small blind $0.05
Lergik: posts big blind $0.10
*** HOLE CARDS ***
Kimiuran: folds 
balisstica: folds 
wesa280: calls $0.10
hornetsvp: folds 
3EBC96: folds 
balisstica leaves the table
Lergik: checks 
*** FLOP *** [5d 7d Qc]
Lergik: checks 
wesa280: checks 
*** TURN *** [5d 7d Qc] [Kc]
Lergik: checks 
wesa280: bets $0.10
DrLevty joins the table at seat #1 
Lergik: folds 
Uncalled bet ($0.10) returned to wesa280
wesa280 collected $0.24 from pot
wesa280: doesn't show hand 
*** SUMMARY ***
Total pot $0.25 | Rake $0.01 
Board [5d 7d Qc Kc]
Seat 1: balisstica folded before Flop (didn't bet)
Seat 2: wesa280 collected ($0.24)
Seat 3: hornetsvp (button) folded before Flop (didn't bet)
Seat 4: 3EBC96 (small blind) folded before Flop
Seat 5: Lergik (big blind) folded on the Turn
Seat 6: Kimiuran folded before Flop (didn't bet)



PokerStars Hand #222951897359:  Hold'em No Limit ($0.05/$0.10 USD) - 2021/01/23 7:20:47 ET
Table 'Polydoros II' 6-max Seat #4 is the button
Seat 2: wesa280 ($17.54 in chips) 
Seat 3: hornetsvp ($20.07 in chips) 
Seat 4: 3EBC96 ($23.79 in chips) 
Seat 5: Lergik ($10 in chips) 
Seat 6: Kimiuran ($13.60 in chips) 
Lergik: posts small blind $0.05
Kimiuran: posts big blind $0.10
DrLevty: sits out 
*** HOLE CARDS ***
wesa280: calls $0.10
hornetsvp: folds 
3EBC96: folds 
Lergik: folds 
Kimiuran: checks 
*** FLOP *** [9c Js 3h]
Kimiuran: bets $0.12
wesa280: calls $0.12
*** TURN *** [9c Js 3h] [Ad]
Kimiuran: checks 
wesa280: bets $0.10
Kimiuran: calls $0.10
*** RIVER *** [9c Js 3h Ad] [7c]
Kimiuran: checks 
wesa280: bets $0.10
Kimiuran: calls $0.10
*** SHOW DOWN ***
wesa280: shows [Jh 8s] (a pair of Jacks)
Kimiuran: shows [Jd Th] (a pair of Jacks - Ace+Ten kicker)
Kimiuran collected $0.85 from pot
*** SUMMARY ***
Total pot $0.89 | Rake $0.04 
Board [9c Js 3h Ad 7c]
Seat 2: wesa280 showed [Jh 8s] and lost with a pair of Jacks
Seat 3: hornetsvp folded before Flop (didn't bet)
Seat 4: 3EBC96 (button) folded before Flop (didn't bet)
Seat 5: Lergik (small blind) folded before Flop
Seat 6: Kimiuran (big blind) showed [Jd Th] and won ($0.85) with a pair of Jacks



PokerStars Hand #222951909915:  Hold'em No Limit ($0.05/$0.10 USD) - 2021/01/23 7:21:21 ET
Table 'Polydoros II' 6-max Seat #5 is the button
Seat 1: DrLevty ($10 in chips) 
Seat 2: wesa280 ($17.12 in chips) 
Seat 3: hornetsvp ($20.07 in chips) 
Seat 4: 3EBC96 ($23.79 in chips) 
Seat 5: Lergik ($10 in chips) 
Seat 6: Kimiuran ($14.03 in chips) 
Kimiuran: posts small blind $0.05
DrLevty: posts big blind $0.10
*** HOLE CARDS ***
wesa280: calls $0.10
hornetsvp: calls $0.10
3EBC96: folds 
Lergik: folds 
Kimiuran: folds 
DrLevty: raises $0.40 to $0.50
wesa280: calls $0.40
hornetsvp: folds 
*** FLOP *** [Jc 2c 4c]
DrLevty: bets $0.36
wesa280: folds 
Uncalled bet ($0.36) returned to DrLevty
DrLevty collected $1.10 from pot
DrLevty: doesn't show hand 
*** SUMMARY ***
Total pot $1.15 | Rake $0.05 
Board [Jc 2c 4c]
Seat 1: DrLevty (big blind) collected ($1.10)
Seat 2: wesa280 folded on the Flop
Seat 3: hornetsvp folded before Flop
Seat 4: 3EBC96 folded before Flop (didn't bet)
Seat 5: Lergik (button) folded before Flop (didn't bet)
Seat 6: Kimiuran (small blind) folded before Flop



PokerStars Hand #222951921622:  Hold'em No Limit ($0.05/$0.10 USD) - 2021/01/23 7:21:53 ET
Table 'Polydoros II' 6-max Seat #6 is the button
Seat 1: DrLevty ($10.60 in chips) 
Seat 2: wesa280 ($16.62 in chips) 
Seat 3: hornetsvp ($19.97 in chips) 
Seat 4: 3EBC96 ($23.79 in chips) 
Seat 5: Lergik ($10 in chips) 
Seat 6: Kimiuran ($13.98 in chips) 
DrLevty: posts small blind $0.05
wesa280: posts big blind $0.10
*** HOLE CARDS ***
hornetsvp: folds 
3EBC96: folds 
Lergik has timed out
Lergik: folds 
Kimiuran: raises $0.15 to $0.25
DrLevty: folds 
wesa280: calls $0.15
*** FLOP *** [Jc 9d 2h]
wesa280: checks 
Kimiuran: checks 
*** TURN *** [Jc 9d 2h] [2c]
wesa280: bets $0.10
Kimiuran: calls $0.10
*** RIVER *** [Jc 9d 2h 2c] [Ac]
wesa280: bets $0.10
Kimiuran: calls $0.10
*** SHOW DOWN ***
wesa280: shows [5d Kc] (a pair of Deuces)
Kimiuran: shows [As 4d] (two pair, Aces and Deuces)
Kimiuran collected $0.91 from pot
*** SUMMARY ***
Total pot $0.95 | Rake $0.04 
Board [Jc 9d 2h 2c Ac]
Seat 1: DrLevty (small blind) folded before Flop
Seat 2: wesa280 (big blind) showed [5d Kc] and lost with a pair of Deuces
Seat 3: hornetsvp folded before Flop (didn't bet)
Seat 4: 3EBC96 folded before Flop (didn't bet)
Seat 5: Lergik folded before Flop (didn't bet)
Seat 6: Kimiuran (button) showed [As 4d] and won ($0.91) with two pair, Aces and Deuces



PokerStars Hand #222951954640:  Hold'em No Limit ($0.05/$0.10 USD) - 2021/01/23 7:23:22 ET
Table 'Polydoros II' 6-max Seat #1 is the button
Seat 1: DrLevty ($10.55 in chips) 
Seat 2: wesa280 ($16.17 in chips) 
Seat 3: hornetsvp ($19.97 in chips) 
Seat 4: 3EBC96 ($23.79 in chips) 
Seat 5: Lergik ($10 in chips) 
Seat 6: Kimiuran ($14.44 in chips) 
wesa280: posts small blind $0.05
hornetsvp: posts big blind $0.10
*** HOLE CARDS ***
3EBC96: raises $0.20 to $0.30
Lergik: folds 
Kimiuran: folds 
DrLevty: folds 
wesa280: calls $0.25
hornetsvp: folds 
*** FLOP *** [5c 7d 7h]
wesa280: bets $0.10
3EBC96: calls $0.10
*** TURN *** [5c 7d 7h] [Qc]
wesa280: checks 
3EBC96: bets $0.50
wesa280: folds 
Uncalled bet ($0.50) returned to 3EBC96
3EBC96 collected $0.86 from pot
3EBC96: doesn't show hand 
*** SUMMARY ***
Total pot $0.90 | Rake $0.04 
Board [5c 7d 7h Qc]
Seat 1: DrLevty (button) folded before Flop (didn't bet)
Seat 2: wesa280 (small blind) folded on the Turn
Seat 3: hornetsvp (big blind) folded before Flop
Seat 4: 3EBC96 collected ($0.86)
Seat 5: Lergik folded before Flop (didn't bet)
Seat 6: Kimiuran folded before Flop (didn't bet)



PokerStars Hand #222951971588:  Hold'em No Limit ($0.05/$0.10 USD) - 2021/01/23 7:24:08 ET
Table 'Polydoros II' 6-max Seat #2 is the button
Seat 1: DrLevty ($10.55 in chips) 
Seat 2: wesa280 ($15.77 in chips) 
Seat 3: hornetsvp ($19.87 in chips) 
Seat 4: 3EBC96 ($24.25 in chips) 
Seat 5: Lergik ($10 in chips) 
Seat 6: Kimiuran ($14.44 in chips) 
hornetsvp: posts small blind $0.05
3EBC96: posts big blind $0.10
*** HOLE CARDS ***
Lergik: folds 
Kimiuran: folds 
DrLevty: raises $0.20 to $0.30
wesa280: calls $0.30
hornetsvp: folds 
3EBC96: folds 
*** FLOP *** [7c Jc 7s]
DrLevty: checks 
wesa280: checks 
*** TURN *** [7c Jc 7s] [Kd]
DrLevty: checks 
wesa280: checks 
*** RIVER *** [7c Jc 7s Kd] [3s]
DrLevty: checks 
wesa280: bets $10.50
DrLevty: folds 
Uncalled bet ($10.50) returned to wesa280
wesa280 collected $0.72 from pot
wesa280: doesn't show hand 
*** SUMMARY ***
Total pot $0.75 | Rake $0.03 
Board [7c Jc 7s Kd 3s]
Seat 1: DrLevty folded on the River
Seat 2: wesa280 (button) collected ($0.72)
Seat 3: hornetsvp (small blind) folded before Flop
Seat 4: 3EBC96 (big blind) folded before Flop
Seat 5: Lergik folded before Flop (didn't bet)
Seat 6: Kimiuran folded before Flop (didn't bet)



PokerStars Hand #222951993243:  Hold'em No Limit ($0.05/$0.10 USD) - 2021/01/23 7:25:08 ET
Table 'Polydoros II' 6-max Seat #3 is the button
Seat 1: DrLevty ($10.25 in chips) 
Seat 2: wesa280 ($16.19 in chips) 
Seat 3: hornetsvp ($19.82 in chips) 
Seat 4: 3EBC96 ($24.15 in chips) 
Seat 5: Lergik ($10 in chips) 
Seat 6: Kimiuran ($14.44 in chips) 
3EBC96: posts small blind $0.05
Lergik: posts big blind $0.10
*** HOLE CARDS ***
Kimiuran: folds 
DrLevty: raises $0.20 to $0.30
wesa280: folds 
hornetsvp: folds 
3EBC96: folds 
Lergik: folds 
Uncalled bet ($0.20) returned to DrLevty
DrLevty collected $0.25 from pot
DrLevty: doesn't show hand 
*** SUMMARY ***
Total pot $0.25 | Rake $0 
Seat 1: DrLevty collected ($0.25)
Seat 2: wesa280 folded before Flop (didn't bet)
Seat 3: hornetsvp (button) folded before Flop (didn't bet)
Seat 4: 3EBC96 (small blind) folded before Flop
Seat 5: Lergik (big blind) folded before Flop
Seat 6: Kimiuran folded before Flop (didn't bet)



PokerStars Hand #222951998585:  Hold'em No Limit ($0.05/$0.10 USD) - 2021/01/23 7:25:22 ET
Table 'Polydoros II' 6-max Seat #4 is the button
Seat 1: DrLevty ($10.40 in chips) 
Seat 2: wesa280 ($16.19 in chips) 
Seat 3: hornetsvp ($19.82 in chips) 
Seat 4: 3EBC96 ($24.10 in chips) 
Seat 5: Lergik ($10 in chips) 
Seat 6: Kimiuran ($14.44 in chips) 
Lergik: posts small blind $0.05
Kimiuran: posts big blind $0.10
*** HOLE CARDS ***
DrLevty: folds 
wesa280 has timed out
wesa280: folds 
hornetsvp: raises $0.15 to $0.25
3EBC96: folds 
Lergik: folds 
Kimiuran: calls $0.15
*** FLOP *** [Qd Kc 6s]
Kimiuran: checks 
hornetsvp: bets $0.40
Kimiuran: raises $1 to $1.40
hornetsvp: folds 
Uncalled bet ($1) returned to Kimiuran
Kimiuran collected $1.29 from pot
Kimiuran: doesn't show hand 
*** SUMMARY ***
Total pot $1.35 | Rake $0.06 
Board [Qd Kc 6s]
Seat 1: DrLevty folded before Flop (didn't bet)
Seat 2: wesa280 folded before Flop (didn't bet)
Seat 3: hornetsvp folded on the Flop
Seat 4: 3EBC96 (button) folded before Flop (didn't bet)
Seat 5: Lergik (small blind) folded before Flop
Seat 6: Kimiuran (big blind) collected ($1.29)



PokerStars Hand #222952015648:  Hold'em No Limit ($0.05/$0.10 USD) - 2021/01/23 7:26:09 ET
Table 'Polydoros II' 6-max Seat #5 is the button
Seat 1: DrLevty ($10.40 in chips) 
Seat 2: wesa280 ($16.19 in chips) 
Seat 3: hornetsvp ($19.17 in chips) 
Seat 4: 3EBC96 ($24.10 in chips) 
Seat 5: Lergik ($10 in chips) 
Seat 6: Kimiuran ($15.08 in chips) 
Kimiuran: posts small blind $0.05
DrLevty: posts big blind $0.10
*** HOLE CARDS ***
wesa280: folds 
hornetsvp: folds 
3EBC96: folds 
Lergik: folds 
Kimiuran: folds 
Uncalled bet ($0.05) returned to DrLevty
DrLevty collected $0.10 from pot
DrLevty: doesn't show hand 
*** SUMMARY ***
Total pot $0.10 | Rake $0 
Seat 1: DrLevty (big blind) collected ($0.10)
Seat 2: wesa280 folded before Flop (didn't bet)
Seat 3: hornetsvp folded before Flop (didn't bet)
Seat 4: 3EBC96 folded before Flop (didn't bet)
Seat 5: Lergik (button) folded before Flop (didn't bet)
Seat 6: Kimiuran (small blind) folded before Flop



PokerStars Hand #222952020179:  Hold'em No Limit ($0.05/$0.10 USD) - 2021/01/23 7:26:21 ET
Table 'Polydoros II' 6-max Seat #6 is the button
Seat 1: DrLevty ($10.45 in chips) 
Seat 2: wesa280 ($16.19 in chips) 
Seat 3: hornetsvp ($19.17 in chips) 
Seat 4: 3EBC96 ($24.10 in chips) 
Seat 5: Lergik ($10 in chips) 
Seat 6: Kimiuran ($15.03 in chips) 
DrLevty: posts small blind $0.05
wesa280: posts big blind $0.10
*** HOLE CARDS ***
hornetsvp: folds 
3EBC96: folds 
Lergik has timed out
Lergik: folds 
Kimiuran: folds 
DrLevty: raises $0.20 to $0.30
wesa280: folds 
Uncalled bet ($0.20) returned to DrLevty
wesa280 leaves the table
DrLevty collected $0.20 from pot
DrLevty: doesn't show hand 
*** SUMMARY ***
Total pot $0.20 | Rake $0 
Seat 1: DrLevty (small blind) collected ($0.20)
Seat 2: wesa280 (big blind) folded before Flop
Seat 3: hornetsvp folded before Flop (didn't bet)
Seat 4: 3EBC96 folded before Flop (didn't bet)
Seat 5: Lergik folded before Flop (didn't bet)
Seat 6: Kimiuran (button) folded before Flop (didn't bet)



PokerStars Hand #222952027181:  Hold'em No Limit ($0.05/$0.10 USD) - 2021/01/23 7:26:40 ET
Table 'Polydoros II' 6-max Seat #1 is the button
Seat 1: DrLevty ($10.55 in chips) 
Seat 3: hornetsvp ($19.17 in chips) 
Seat 4: 3EBC96 ($24.10 in chips) 
Seat 5: Lergik ($10 in chips) 
Seat 6: Kimiuran ($15.03 in chips) 
hornetsvp: posts small blind $0.05
3EBC96: posts big blind $0.10
*** HOLE CARDS ***
Lergik: folds 
Kimiuran: folds 
DrLevty: folds 
hornetsvp: folds 
Uncalled bet ($0.05) returned to 3EBC96
3EBC96 collected $0.10 from pot
3EBC96: doesn't show hand 
*** SUMMARY ***
Total pot $0.10 | Rake $0 
Seat 1: DrLevty (button) folded before Flop (didn't bet)
Seat 3: hornetsvp (small blind) folded before Flop
Seat 4: 3EBC96 (big blind) collected ($0.10)
Seat 5: Lergik folded before Flop (didn't bet)
Seat 6: Kimiuran folded before Flop (didn't bet)



PokerStars Hand #222952031299:  Hold'em No Limit ($0.05/$0.10 USD) - 2021/01/23 7:26:52 ET
Table 'Polydoros II' 6-max Seat #3 is the button
Seat 1: DrLevty ($10.55 in chips) 
Seat 3: hornetsvp ($19.12 in chips) 
Seat 5: Lergik ($10 in chips) 
Seat 6: Kimiuran ($15.03 in chips) 
Lergik: posts small blind $0.05
Kimiuran: posts big blind $0.10
*** HOLE CARDS ***
DrLevty: folds 
3EBC96 leaves the table
hornetsvp: folds 
Lergik: folds 
Uncalled bet ($0.05) returned to Kimiuran
Kimiuran collected $0.10 from pot
Kimiuran: doesn't show hand 
*** SUMMARY ***
Total pot $0.10 | Rake $0 
Seat 1: DrLevty folded before Flop (didn't bet)
Seat 3: hornetsvp (button) folded before Flop (didn't bet)
Seat 5: Lergik (small blind) folded before Flop
Seat 6: Kimiuran (big blind) collected ($0.10)



PokerStars Hand #222952035511:  Hold'em No Limit ($0.05/$0.10 USD) - 2021/01/23 7:27:03 ET
Table 'Polydoros II' 6-max Seat #5 is the button
Seat 1: DrLevty ($10.55 in chips) 
Seat 3: hornetsvp ($19.12 in chips) 
Seat 5: Lergik ($10 in chips) 
Seat 6: Kimiuran ($15.08 in chips) 
Kimiuran: posts small blind $0.05
DrLevty: posts big blind $0.10
*** HOLE CARDS ***
hornetsvp: folds 
Lergik: folds 
Kimiuran: raises $0.20 to $0.30
DrLevty: calls $0.20
*** FLOP *** [3c 5d 9d]
Kimiuran: bets $0.38
DrLevty: calls $0.38
*** TURN *** [3c 5d 9d] [Tc]
Kimiuran: bets $0.87
DrLevty: calls $0.87
*** RIVER *** [3c 5d 9d Tc] [7d]
Kimiuran: checks 
hornetsvp leaves the table
DrLevty: checks 
*** SHOW DOWN ***
Kimiuran: shows [Jh Ts] (a pair of Tens)
DrLevty: shows [Td Kd] (a flush, King high)
DrLevty collected $2.96 from pot
*** SUMMARY ***
Total pot $3.10 | Rake $0.14 
Board [3c 5d 9d Tc 7d]
Seat 1: DrLevty (big blind) showed [Td Kd] and won ($2.96) with a flush, King high
Seat 3: hornetsvp folded before Flop (didn't bet)
Seat 5: Lergik (button) folded before Flop (didn't bet)
Seat 6: Kimiuran (small blind) showed [Jh Ts] and lost with a pair of Tens



PokerStars Hand #222952127628:  Hold'em No Limit ($0.05/$0.10 USD) - 2021/01/23 7:31:14 ET
Table 'Polydoros II' 6-max Seat #2 is the button
Seat 2: manroy86 ($10 in chips) 
Seat 3: bensari ($10 in chips) 
manroy86: posts small blind $0.05
bensari: posts big blind $0.10
*** HOLE CARDS ***
manroy86: raises $0.15 to $0.25
bensari: calls $0.15
*** FLOP *** [Ac 7s 5c]
bensari: checks 
manroy86: bets $0.20
bensari: folds 
Uncalled bet ($0.20) returned to manroy86
manroy86 collected $0.48 from pot
manroy86: doesn't show hand 
*** SUMMARY ***
Total pot $0.50 | Rake $0.02 
Board [Ac 7s 5c]
Seat 2: manroy86 (button) (small blind) collected ($0.48)
Seat 3: bensari (big blind) folded on the Flop



PokerStars Hand #222952136865:  Hold'em No Limit ($0.05/$0.10 USD) - 2021/01/23 7:31:39 ET
Table 'Polydoros II' 6-max Seat #3 is the button
Seat 2: manroy86 ($10.23 in chips) 
Seat 3: bensari ($9.75 in chips) 
bensari: posts small blind $0.05
manroy86: posts big blind $0.10
*** HOLE CARDS ***
bensari: folds 
Uncalled bet ($0.05) returned to manroy86
manroy86 collected $0.10 from pot
manroy86: doesn't show hand 
*** SUMMARY ***
Total pot $0.10 | Rake $0 
Seat 2: manroy86 (big blind) collected ($0.10)
Seat 3: bensari (button) (small blind) folded before Flop



PokerStars Hand #222952138428:  Hold'em No Limit ($0.05/$0.10 USD) - 2021/01/23 7:31:43 ET
Table 'Polydoros II' 6-max Seat #2 is the button
Seat 2: manroy86 ($10.28 in chips) 
Seat 3: bensari ($9.70 in chips) 
manroy86: posts small blind $0.05
bensari: posts big blind $0.10
*** HOLE CARDS ***
manroy86: folds 
Uncalled bet ($0.05) returned to bensari
bensari collected $0.10 from pot
bensari: doesn't show hand 
*** SUMMARY ***
Total pot $0.10 | Rake $0 
Seat 2: manroy86 (button) (small blind) folded before Flop
Seat 3: bensari (big blind) collected ($0.10)



PokerStars Hand #222952139856:  Hold'em No Limit ($0.05/$0.10 USD) - 2021/01/23 7:31:47 ET
Table 'Polydoros II' 6-max Seat #3 is the button
Seat 2: manroy86 ($10.23 in chips) 
Seat 3: bensari ($9.75 in chips) 
bensari: posts small blind $0.05
manroy86: posts big blind $0.10
*** HOLE CARDS ***
bensari: calls $0.05
manroy86: checks 
*** FLOP *** [Jh 2s 4h]
manroy86: checks 
bensari: checks 
*** TURN *** [Jh 2s 4h] [3c]
manroy86: checks 
bensari: bets $0.30
manroy86: folds 
Uncalled bet ($0.30) returned to bensari
Xath76 joins the table at seat #1 
bensari collected $0.19 from pot
bensari: doesn't show hand 
*** SUMMARY ***
Total pot $0.20 | Rake $0.01 
Board [Jh 2s 4h 3c]
Seat 2: manroy86 (big blind) folded on the Turn
Seat 3: bensari (button) (small blind) collected ($0.19)



PokerStars Hand #222952147085:  Hold'em No Limit ($0.05/$0.10 USD) - 2021/01/23 7:32:06 ET
Table 'Polydoros II' 6-max Seat #2 is the button
Seat 1: Xath76 ($10 in chips) 
Seat 2: manroy86 ($10.13 in chips) 
Seat 3: bensari ($9.84 in chips) 
bensari: posts small blind $0.05
Xath76: posts big blind $0.10
*** HOLE CARDS ***
manroy86: folds 
bensari: folds 
Uncalled bet ($0.05) returned to Xath76
Xath76 collected $0.10 from pot
Xath76: doesn't show hand 
*** SUMMARY ***
Total pot $0.10 | Rake $0 
Seat 1: Xath76 (big blind) collected ($0.10)
Seat 2: manroy86 (button) folded before Flop (didn't bet)
Seat 3: bensari (small blind) folded before Flop



PokerStars Hand #222952149276:  Hold'em No Limit ($0.05/$0.10 USD) - 2021/01/23 7:32:12 ET
Table 'Polydoros II' 6-max Seat #3 is the button
Seat 1: Xath76 ($10.05 in chips) 
Seat 2: manroy86 ($10.13 in chips) 
Seat 3: bensari ($9.79 in chips) 
Xath76: posts small blind $0.05
manroy86: posts big blind $0.10
*** HOLE CARDS ***
bensari: folds 
Xath76: calls $0.05
manroy86: checks 
*** FLOP *** [9s 4c Qc]
Xath76: checks 
manroy86: checks 
*** TURN *** [9s 4c Qc] [9d]
Joe Abbotts joins the table at seat #6 
Xath76: checks 
manroy86: bets $0.15
Xath76: folds 
Uncalled bet ($0.15) returned to manroy86
manroy86 collected $0.19 from pot
manroy86: doesn't show hand 
*** SUMMARY ***
Total pot $0.20 | Rake $0.01 
Board [9s 4c Qc 9d]
Seat 1: Xath76 (small blind) folded on the Turn
Seat 2: manroy86 (big blind) collected ($0.19)
Seat 3: bensari (button) folded before Flop (didn't bet)



PokerStars Hand #222952159617:  Hold'em No Limit ($0.05/$0.10 USD) - 2021/01/23 7:32:40 ET
Table 'Polydoros II' 6-max Seat #1 is the button
Seat 1: Xath76 ($10 in chips) 
Seat 2: manroy86 ($10.22 in chips) 
Seat 3: bensari ($9.79 in chips) 
Seat 6: Joe Abbotts ($4 in chips) 
manroy86: posts small blind $0.05
bensari: posts big blind $0.10
Joe Abbotts: posts big blind $0.10
*** HOLE CARDS ***
1920kbps joins the table at seat #5 
Joe Abbotts: checks 
Xath76: folds 
Zephaaas joins the table at seat #4 
manroy86: raises $0.35 to $0.45
bensari: calls $0.35
Joe Abbotts: folds 
*** FLOP *** [2d Qc 8s]
manroy86: bets $0.70
bensari: raises $1.80 to $2.50
manroy86: folds 
Uncalled bet ($1.80) returned to bensari
bensari collected $2.29 from pot
bensari: doesn't show hand 
*** SUMMARY ***
Total pot $2.40 | Rake $0.11 
Board [2d Qc 8s]
Seat 1: Xath76 (button) folded before Flop (didn't bet)
Seat 2: manroy86 (small blind) folded on the Flop
Seat 3: bensari (big blind) collected ($2.29)
Seat 6: Joe Abbotts folded before Flop (didn't bet)



PokerStars Hand #222952174911:  Hold'em No Limit ($0.05/$0.10 USD) - 2021/01/23 7:33:21 ET
Table 'Polydoros II' 6-max Seat #2 is the button
Seat 1: Xath76 ($10 in chips) 
Seat 2: manroy86 ($10 in chips) 
Seat 3: bensari ($10.93 in chips) 
Seat 4: Zephaaas ($4.69 in chips) 
Seat 6: Joe Abbotts ($3.90 in chips) 
bensari: posts small blind $0.05
Zephaaas: posts big blind $0.10
1920kbps: sits out 
*** HOLE CARDS ***
Joe Abbotts: raises $0.25 to $0.35
Xath76: folds 
manroy86: folds 
bensari: folds 
Zephaaas: calls $0.25
*** FLOP *** [7d Jc 6c]
Zephaaas: checks 
Joe Abbotts: bets $0.72
Zephaaas: calls $0.72
*** TURN *** [7d Jc 6c] [5d]
Zephaaas: bets $0.10
Joe Abbotts: calls $0.10
*** RIVER *** [7d Jc 6c 5d] [Ac]
Zephaaas: checks 
Joe Abbotts: bets $2.28
Zephaaas: folds 
Uncalled bet ($2.28) returned to Joe Abbotts
Joe Abbotts collected $2.28 from pot
Joe Abbotts: doesn't show hand 
*** SUMMARY ***
Total pot $2.39 | Rake $0.11 
Board [7d Jc 6c 5d Ac]
Seat 1: Xath76 folded before Flop (didn't bet)
Seat 2: manroy86 (button) folded before Flop (didn't bet)
Seat 3: bensari (small blind) folded before Flop
Seat 4: Zephaaas (big blind) folded on the River
Seat 6: Joe Abbotts collected ($2.28)



PokerStars Hand #222952192609:  Hold'em No Limit ($0.05/$0.10 USD) - 2021/01/23 7:34:09 ET
Table 'Polydoros II' 6-max Seat #3 is the button
Seat 1: Xath76 ($10 in chips) 
Seat 2: manroy86 ($10 in chips) 
Seat 3: bensari ($10.88 in chips) 
Seat 4: Zephaaas ($3.52 in chips) 
Seat 5: 1920kbps ($10 in chips) 
Seat 6: Joe Abbotts ($5.01 in chips) 
Zephaaas: posts small blind $0.05
1920kbps: posts big blind $0.10
*** HOLE CARDS ***
Joe Abbotts: folds 
Xath76: folds 
manroy86: folds 
bensari: raises $0.10 to $0.20
Zephaaas: calls $0.15
1920kbps: raises $1 to $1.20
bensari: calls $1
Zephaaas: raises $1 to $2.20
1920kbps: raises $7.80 to $10 and is all-in
bensari: folds 
Zephaaas: calls $1.32 and is all-in
Uncalled bet ($6.48) returned to 1920kbps
*** FLOP *** [4d 9h 5h]
*** TURN *** [4d 9h 5h] [Qh]
*** RIVER *** [4d 9h 5h Qh] [Jd]
*** SHOW DOWN ***
Zephaaas: shows [6s Ks] (high card King)
1920kbps: shows [Js Ac] (a pair of Jacks)
1920kbps collected $7.87 from pot
*** SUMMARY ***
Total pot $8.24 | Rake $0.37 
Board [4d 9h 5h Qh Jd]
Seat 1: Xath76 folded before Flop (didn't bet)
Seat 2: manroy86 folded before Flop (didn't bet)
Seat 3: bensari (button) folded before Flop
Seat 4: Zephaaas (small blind) showed [6s Ks] and lost with high card King
Seat 5: 1920kbps (big blind) showed [Js Ac] and won ($7.87) with a pair of Jacks
Seat 6: Joe Abbotts folded before Flop (didn't bet)



PokerStars Hand #222952212936:  Hold'em No Limit ($0.05/$0.10 USD) - 2021/01/23 7:35:04 ET
Table 'Polydoros II' 6-max Seat #5 is the button
Seat 1: Xath76 ($10 in chips) 
Seat 2: manroy86 ($10 in chips) 
Seat 3: bensari ($9.68 in chips) 
Seat 5: 1920kbps ($14.35 in chips) 
Seat 6: Joe Abbotts ($5.01 in chips) 
Joe Abbotts: posts small blind $0.05
Xath76: posts big blind $0.10
*** HOLE CARDS ***
manroy86: folds 
bensari: folds 
1920kbps: folds 
Zephaaas leaves the table
Joe Abbotts: calls $0.05
Xath76: checks 
*** FLOP *** [9h Ad Js]
father here joins the table at seat #4 
Joe Abbotts: checks 
Xath76: checks 
*** TURN *** [9h Ad Js] [6s]
Joe Abbotts: bets $0.19
Xath76: folds 
Uncalled bet ($0.19) returned to Joe Abbotts
Joe Abbotts collected $0.19 from pot
Joe Abbotts: doesn't show hand 
*** SUMMARY ***
Total pot $0.20 | Rake $0.01 
Board [9h Ad Js 6s]
Seat 1: Xath76 (big blind) folded on the Turn
Seat 2: manroy86 folded before Flop (didn't bet)
Seat 3: bensari folded before Flop (didn't bet)
Seat 5: 1920kbps (button) folded before Flop (didn't bet)
Seat 6: Joe Abbotts (small blind) collected ($0.19)



PokerStars Hand #222952220372:  Hold'em No Limit ($0.05/$0.10 USD) - 2021/01/23 7:35:24 ET
Table 'Polydoros II' 6-max Seat #6 is the button
Seat 1: Xath76 ($10 in chips) 
Seat 2: manroy86 ($10 in chips) 
Seat 3: bensari ($9.68 in chips) 
Seat 5: 1920kbps ($14.35 in chips) 
Seat 6: Joe Abbotts ($5.10 in chips) 
Xath76: posts small blind $0.05
manroy86: posts big blind $0.10
father here: sits out 
*** HOLE CARDS ***
bensari: calls $0.10
1920kbps: raises $0.30 to $0.40
Joe Abbotts: calls $0.40
Xath76: raises $1.40 to $1.80
manroy86: folds 
bensari: calls $1.70
1920kbps: folds 
Joe Abbotts: folds 
*** FLOP *** [8c 5d 8h]
Xath76: bets $4.30
bensari: raises $3.58 to $7.88 and is all-in
Xath76: calls $3.58
*** TURN *** [8c 5d 8h] [9d]
*** RIVER *** [8c 5d 8h 9d] [7s]
*** SHOW DOWN ***
Xath76: shows [Qd Qc] (two pair, Queens and Eights)
bensari: shows [Kh Tc] (a pair of Eights)
Xath76 collected $19.35 from pot
*** SUMMARY ***
Total pot $20.26 | Rake $0.91 
Board [8c 5d 8h 9d 7s]
Seat 1: Xath76 (small blind) showed [Qd Qc] and won ($19.35) with two pair, Queens and Eights
Seat 2: manroy86 (big blind) folded before Flop
Seat 3: bensari showed [Kh Tc] and lost with a pair of Eights
Seat 5: 1920kbps folded before Flop
Seat 6: Joe Abbotts (button) folded before Flop



PokerStars Hand #222952234568:  Hold'em No Limit ($0.05/$0.10 USD) - 2021/01/23 7:36:02 ET
Table 'Polydoros II' 6-max Seat #1 is the button
Seat 1: Xath76 ($19.67 in chips) 
Seat 2: manroy86 ($10 in chips) 
Seat 4: father here ($10 in chips) 
Seat 5: 1920kbps ($13.95 in chips) 
Seat 6: Joe Abbotts ($4.70 in chips) 
manroy86: posts small blind $0.05
father here: posts big blind $0.10
*** HOLE CARDS ***
1920kbps: folds 
Joe Abbotts: calls $0.10
Xath76: folds 
manroy86: folds 
bensari leaves the table
father here: checks 
*** FLOP *** [2d 6d Kc]
father here: checks 
Antonio8812 joins the table at seat #3 
Joe Abbotts: bets $0.24
father here: folds 
Uncalled bet ($0.24) returned to Joe Abbotts
Joe Abbotts collected $0.24 from pot
*** SUMMARY ***
Total pot $0.25 | Rake $0.01 
Board [2d 6d Kc]
Seat 1: Xath76 (button) folded before Flop (didn't bet)
Seat 2: manroy86 (small blind) folded before Flop
Seat 4: father here (big blind) folded on the Flop
Seat 5: 1920kbps folded before Flop (didn't bet)
Seat 6: Joe Abbotts collected ($0.24)



PokerStars Hand #222952242859:  Hold'em No Limit ($0.05/$0.10 USD) - 2021/01/23 7:36:24 ET
Table 'Polydoros II' 6-max Seat #2 is the button
Seat 1: Xath76 ($19.67 in chips) 
Seat 2: manroy86 ($10 in chips) 
Seat 4: father here ($10 in chips) 
Seat 5: 1920kbps ($13.95 in chips) 
Seat 6: Joe Abbotts ($4.84 in chips) 
father here: posts small blind $0.05
1920kbps: posts big blind $0.10
*** HOLE CARDS ***
Joe Abbotts: folds 
Xath76: raises $0.20 to $0.30
manroy86: folds 
father here: folds 
1920kbps: folds 
Uncalled bet ($0.20) returned to Xath76
Xath76 collected $0.25 from pot
Xath76: doesn't show hand 
*** SUMMARY ***
Total pot $0.25 | Rake $0 
Seat 1: Xath76 collected ($0.25)
Seat 2: manroy86 (button) folded before Flop (didn't bet)
Seat 4: father here (small blind) folded before Flop
Seat 5: 1920kbps (big blind) folded before Flop
Seat 6: Joe Abbotts folded before Flop (didn't bet)



PokerStars Hand #222952247482:  Hold'em No Limit ($0.05/$0.10 USD) - 2021/01/23 7:36:36 ET
Table 'Polydoros II' 6-max Seat #4 is the button
Seat 1: Xath76 ($19.82 in chips) 
Seat 2: manroy86 ($10 in chips) 
Seat 4: father here ($10 in chips) 
Seat 5: 1920kbps ($13.85 in chips) 
Seat 6: Joe Abbotts ($4.84 in chips) 
1920kbps: posts small blind $0.05
Joe Abbotts: posts big blind $0.10
Antonio8812: sits out 
*** HOLE CARDS ***
Xath76: folds 
manroy86: folds 
father here: raises $0.20 to $0.30
1920kbps: folds 
Joe Abbotts: calls $0.20
*** FLOP *** [Ah 6c 9h]
Joe Abbotts: bets $0.62
father here: folds 
Uncalled bet ($0.62) returned to Joe Abbotts
Joe Abbotts collected $0.62 from pot
*** SUMMARY ***
Total pot $0.65 | Rake $0.03 
Board [Ah 6c 9h]
Seat 1: Xath76 folded before Flop (didn't bet)
Seat 2: manroy86 folded before Flop (didn't bet)
Seat 4: father here (button) folded on the Flop
Seat 5: 1920kbps (small blind) folded before Flop
Seat 6: Joe Abbotts (big blind) collected ($0.62)



PokerStars Hand #222952261616:  Hold'em No Limit ($0.05/$0.10 USD) - 2021/01/23 7:37:14 ET
Table 'Polydoros II' 6-max Seat #5 is the button
Seat 1: Xath76 ($19.82 in chips) 
Seat 2: manroy86 ($10 in chips) 
Seat 4: father here ($10 in chips) 
Seat 5: 1920kbps ($13.80 in chips) 
Seat 6: Joe Abbotts ($5.16 in chips) 
Joe Abbotts: posts small blind $0.05
Xath76: posts big blind $0.10
Antonio8812: sits out 
*** HOLE CARDS ***
manroy86: raises $0.20 to $0.30
father here: folds 
1920kbps: folds 
Joe Abbotts: folds 
Xath76: folds 
Uncalled bet ($0.20) returned to manroy86
manroy86 collected $0.25 from pot
manroy86: doesn't show hand 
*** SUMMARY ***
Total pot $0.25 | Rake $0 
Seat 1: Xath76 (big blind) folded before Flop
Seat 2: manroy86 collected ($0.25)
Seat 4: father here folded before Flop (didn't bet)
Seat 5: 1920kbps (button) folded before Flop (didn't bet)
Seat 6: Joe Abbotts (small blind) folded before Flop



PokerStars Hand #222952269037:  Hold'em No Limit ($0.05/$0.10 USD) - 2021/01/23 7:37:34 ET
Table 'Polydoros II' 6-max Seat #6 is the button
Seat 1: Xath76 ($19.72 in chips) 
Seat 2: manroy86 ($10.15 in chips) 
Seat 4: father here ($10 in chips) 
Seat 5: 1920kbps ($13.80 in chips) 
Seat 6: Joe Abbotts ($5.11 in chips) 
Xath76: posts small blind $0.05
manroy86: posts big blind $0.10
Antonio8812: sits out 
*** HOLE CARDS ***
father here: folds 
1920kbps: folds 
Joe Abbotts: calls $0.10
Xath76: folds 
manroy86: checks 
*** FLOP *** [4d Ac 4c]
manroy86: checks 
Joe Abbotts: bets $0.24
manroy86: folds 
Uncalled bet ($0.24) returned to Joe Abbotts
Joe Abbotts collected $0.24 from pot
*** SUMMARY ***
Total pot $0.25 | Rake $0.01 
Board [4d Ac 4c]
Seat 1: Xath76 (small blind) folded before Flop
Seat 2: manroy86 (big blind) folded on the Flop
Seat 4: father here folded before Flop (didn't bet)
Seat 5: 1920kbps folded before Flop (didn't bet)
Seat 6: Joe Abbotts (button) collected ($0.24)



PokerStars Hand #222952284403:  Hold'em No Limit ($0.05/$0.10 USD) - 2021/01/23 7:38:15 ET
Table 'Polydoros II' 6-max Seat #1 is the button
Seat 1: Xath76 ($19.67 in chips) 
Seat 2: manroy86 ($10.05 in chips) 
Seat 3: Antonio8812 ($10 in chips) 
Seat 4: father here ($10 in chips) 
Seat 5: 1920kbps ($13.80 in chips) 
Seat 6: Joe Abbotts ($5.25 in chips) 
manroy86: posts small blind $0.05
Antonio8812: posts big blind $0.10
*** HOLE CARDS ***
father here: raises $0.20 to $0.30
1920kbps: folds 
Joe Abbotts: folds 
Xath76: calls $0.30
manroy86: folds 
Joe Abbotts leaves the table
Antonio8812: calls $0.20
*** FLOP *** [7d 5d 2h]
Antonio8812: checks 
bigmen100 joins the table at seat #6 
father here: bets $0.60
Xath76: calls $0.60
Antonio8812: folds 
*** TURN *** [7d 5d 2h] [Jh]
father here: bets $1.50
Xath76: folds 
Uncalled bet ($1.50) returned to father here
father here collected $2.05 from pot
*** SUMMARY ***
Total pot $2.15 | Rake $0.10 
Board [7d 5d 2h Jh]
Seat 1: Xath76 (button) folded on the Turn
Seat 2: manroy86 (small blind) folded before Flop
Seat 3: Antonio8812 (big blind) folded on the Flop
Seat 4: father here collected ($2.05)
Seat 5: 1920kbps folded before Flop (didn't bet)
Seat 6: Joe Abbotts folded before Flop (didn't bet)



PokerStars Hand #222952302070:  Hold'em No Limit ($0.05/$0.10 USD) - 2021/01/23 7:39:02 ET
Table 'Polydoros II' 6-max Seat #2 is the button
Seat 1: Xath76 ($18.77 in chips) 
Seat 2: manroy86 ($10 in chips) 
Seat 3: Antonio8812 ($10 in chips) 
Seat 4: father here ($11.15 in chips) 
Seat 5: 1920kbps ($13.80 in chips) 
Antonio8812: posts small blind $0.05
father here: posts big blind $0.10
bigmen100: sits out 
*** HOLE CARDS ***
1920kbps: folds 
Xath76: folds 
manroy86: raises $0.15 to $0.25
Antonio8812: folds 
father here: folds 
Uncalled bet ($0.15) returned to manroy86
manroy86 collected $0.25 from pot
manroy86: doesn't show hand 
*** SUMMARY ***
Total pot $0.25 | Rake $0 
Seat 1: Xath76 folded before Flop (didn't bet)
Seat 2: manroy86 (button) collected ($0.25)
Seat 3: Antonio8812 (small blind) folded before Flop
Seat 4: father here (big blind) folded before Flop
Seat 5: 1920kbps folded before Flop (didn't bet)



PokerStars Hand #222952307236:  Hold'em No Limit ($0.05/$0.10 USD) - 2021/01/23 7:39:15 ET
Table 'Polydoros II' 6-max Seat #3 is the button
Seat 1: Xath76 ($18.77 in chips) 
Seat 2: manroy86 ($10.15 in chips) 
Seat 3: Antonio8812 ($10 in chips) 
Seat 4: father here ($11.05 in chips) 
Seat 5: 1920kbps ($13.80 in chips) 
father here: posts small blind $0.05
1920kbps: posts big blind $0.10
bigmen100: sits out 
*** HOLE CARDS ***
Xath76: folds 
manroy86: folds 
Antonio8812: raises $0.20 to $0.30
father here: raises $0.70 to $1
1920kbps: folds 
Antonio8812: folds 
Uncalled bet ($0.70) returned to father here
father here collected $0.70 from pot
*** SUMMARY ***
Total pot $0.70 | Rake $0 
Seat 1: Xath76 folded before Flop (didn't bet)
Seat 2: manroy86 folded before Flop (didn't bet)
Seat 3: Antonio8812 (button) folded before Flop
Seat 4: father here (small blind) collected ($0.70)
Seat 5: 1920kbps (big blind) folded before Flop



PokerStars Hand #222952314231:  Hold'em No Limit ($0.05/$0.10 USD) - 2021/01/23 7:39:34 ET
Table 'Polydoros II' 6-max Seat #4 is the button
Seat 1: Xath76 ($18.77 in chips) 
Seat 2: manroy86 ($10.15 in chips) 
Seat 3: Antonio8812 ($10 in chips) 
Seat 4: father here ($11.45 in chips) 
Seat 5: 1920kbps ($13.70 in chips) 
Seat 6: bigmen100 ($8 in chips) 
1920kbps: posts small blind $0.05
bigmen100: posts big blind $0.10
*** HOLE CARDS ***
Xath76: folds 
manroy86: folds 
Antonio8812: folds 
father here: folds 
1920kbps: raises $0.20 to $0.30
bigmen100: folds 
Uncalled bet ($0.20) returned to 1920kbps
1920kbps collected $0.20 from pot
*** SUMMARY ***
Total pot $0.20 | Rake $0 
Seat 1: Xath76 folded before Flop (didn't bet)
Seat 2: manroy86 folded before Flop (didn't bet)
Seat 3: Antonio8812 folded before Flop (didn't bet)
Seat 4: father here (button) folded before Flop (didn't bet)
Seat 5: 1920kbps (small blind) collected ($0.20)
Seat 6: bigmen100 (big blind) folded before Flop



PokerStars Hand #222953821841:  Hold'em No Limit ($0.05/$0.10 USD) - 2021/01/23 8:41:24 ET
Table 'Polydoros II' 6-max Seat #2 is the button
Seat 1: Xath76 ($10 in chips) 
Seat 2: voronin885 ($19.87 in chips) 
Seat 3: Vaha379 ($11.67 in chips) 
Seat 4: Squashy22 ($23.60 in chips) 
Seat 5: einsftw ($10.15 in chips) 
Seat 6: alexos04 ($23.33 in chips) 
Vaha379: posts small blind $0.05
Squashy22: posts big blind $0.10
*** HOLE CARDS ***
einsftw: folds 
alexos04: raises $0.20 to $0.30
Xath76: calls $0.30
voronin885: folds 
Vaha379: folds 
Squashy22: folds 
*** FLOP *** [Qc 9h Qh]
alexos04: bets $0.40
Xath76: calls $0.40
*** TURN *** [Qc 9h Qh] [4c]
alexos04: bets $0.90
Xath76: raises $3.28 to $4.18
alexos04: folds 
Uncalled bet ($3.28) returned to Xath76
Xath76 collected $3.20 from pot
Xath76: doesn't show hand 
*** SUMMARY ***
Total pot $3.35 | Rake $0.15 
Board [Qc 9h Qh 4c]
Seat 1: Xath76 collected ($3.20)
Seat 2: voronin885 (button) folded before Flop (didn't bet)
Seat 3: Vaha379 (small blind) folded before Flop
Seat 4: Squashy22 (big blind) folded before Flop
Seat 5: einsftw folded before Flop (didn't bet)
Seat 6: alexos04 folded on the Turn



PokerStars Hand #222953840787:  Hold'em No Limit ($0.05/$0.10 USD) - 2021/01/23 8:42:03 ET
Table 'Polydoros II' 6-max Seat #3 is the button
Seat 1: Xath76 ($11.60 in chips) 
Seat 2: voronin885 ($19.87 in chips) 
Seat 3: Vaha379 ($11.62 in chips) 
Seat 4: Squashy22 ($23.50 in chips) 
Seat 5: einsftw ($10.15 in chips) 
Seat 6: alexos04 ($21.73 in chips) 
Squashy22: posts small blind $0.05
einsftw: posts big blind $0.10
*** HOLE CARDS ***
alexos04: folds 
Xath76: folds 
voronin885: calls $0.10
Vaha379: raises $0.35 to $0.45
Squashy22: folds 
einsftw: folds 
voronin885: folds 
Uncalled bet ($0.35) returned to Vaha379
Vaha379 collected $0.35 from pot
Vaha379: doesn't show hand 
*** SUMMARY ***
Total pot $0.35 | Rake $0 
Seat 1: Xath76 folded before Flop (didn't bet)
Seat 2: voronin885 folded before Flop
Seat 3: Vaha379 (button) collected ($0.35)
Seat 4: Squashy22 (small blind) folded before Flop
Seat 5: einsftw (big blind) folded before Flop
Seat 6: alexos04 folded before Flop (didn't bet)



PokerStars Hand #222954046444:  Hold'em No Limit ($0.05/$0.10 USD) - 2021/01/23 8:49:38 ET
Table 'Polydoros II' 6-max Seat #5 is the button
Seat 1: Xath76 ($10.89 in chips) 
Seat 2: voronin885 ($17.38 in chips) 
Seat 3: Vaha379 ($11.24 in chips) 
Seat 4: Squashy22 ($26.30 in chips) 
Seat 5: einsftw ($12.19 in chips) 
Seat 6: alexos04 ($19.93 in chips) 
alexos04: posts small blind $0.05
Xath76: posts big blind $0.10
*** HOLE CARDS ***
voronin885: folds 
Vaha379: folds 
Squashy22: folds 
einsftw: folds 
alexos04: raises $0.20 to $0.30
Xath76: folds 
Uncalled bet ($0.20) returned to alexos04
alexos04 collected $0.20 from pot
alexos04: doesn't show hand 
*** SUMMARY ***
Total pot $0.20 | Rake $0 
Seat 1: Xath76 (big blind) folded before Flop
Seat 2: voronin885 folded before Flop (didn't bet)
Seat 3: Vaha379 folded before Flop (didn't bet)
Seat 4: Squashy22 folded before Flop (didn't bet)
Seat 5: einsftw (button) folded before Flop (didn't bet)
Seat 6: alexos04 (small blind) collected ($0.20)



PokerStars Hand #222954051645:  Hold'em No Limit ($0.05/$0.10 USD) - 2021/01/23 8:49:49 ET
Table 'Polydoros II' 6-max Seat #6 is the button
Seat 1: Xath76 ($10.79 in chips) 
Seat 2: voronin885 ($17.38 in chips) 
Seat 3: Vaha379 ($11.24 in chips) 
Seat 4: Squashy22 ($26.30 in chips) 
Seat 5: einsftw ($12.19 in chips) 
Seat 6: alexos04 ($20.03 in chips) 
Xath76: posts small blind $0.05
voronin885: posts big blind $0.10
*** HOLE CARDS ***
Vaha379: raises $0.20 to $0.30
Squashy22: folds 
einsftw: folds 
alexos04: folds 
Xath76: folds 
voronin885: calls $0.20
*** FLOP *** [2d 7h 8h]
voronin885: checks 
Vaha379: checks 
*** TURN *** [2d 7h 8h] [Qs]
voronin885: checks 
Vaha379: checks 
*** RIVER *** [2d 7h 8h Qs] [5d]
voronin885: bets $0.10
Vaha379: folds 
Uncalled bet ($0.10) returned to voronin885
voronin885 collected $0.62 from pot
voronin885: doesn't show hand 
*** SUMMARY ***
Total pot $0.65 | Rake $0.03 
Board [2d 7h 8h Qs 5d]
Seat 1: Xath76 (small blind) folded before Flop
Seat 2: voronin885 (big blind) collected ($0.62)
Seat 3: Vaha379 folded on the River
Seat 4: Squashy22 folded before Flop (didn't bet)
Seat 5: einsftw folded before Flop (didn't bet)
Seat 6: alexos04 (button) folded before Flop (didn't bet)



PokerStars Hand #222954064705:  Hold'em No Limit ($0.05/$0.10 USD) - 2021/01/23 8:50:18 ET
Table 'Polydoros II' 6-max Seat #1 is the button
Seat 1: Xath76 ($10.74 in chips) 
Seat 2: voronin885 ($17.70 in chips) 
Seat 3: Vaha379 ($10.94 in chips) 
Seat 4: Squashy22 ($26.30 in chips) 
Seat 5: einsftw ($12.19 in chips) 
Seat 6: alexos04 ($20.03 in chips) 
voronin885: posts small blind $0.05
Vaha379: posts big blind $0.10
*** HOLE CARDS ***
Squashy22: folds 
einsftw: folds 
alexos04: folds 
Xath76: folds 
voronin885: folds 
Uncalled bet ($0.05) returned to Vaha379
Vaha379 collected $0.10 from pot
Vaha379: doesn't show hand 
*** SUMMARY ***
Total pot $0.10 | Rake $0 
Seat 1: Xath76 (button) folded before Flop (didn't bet)
Seat 2: voronin885 (small blind) folded before Flop
Seat 3: Vaha379 (big blind) collected ($0.10)
Seat 4: Squashy22 folded before Flop (didn't bet)
Seat 5: einsftw folded before Flop (didn't bet)
Seat 6: alexos04 folded before Flop (didn't bet)



PokerStars Hand #222954069507:  Hold'em No Limit ($0.05/$0.10 USD) - 2021/01/23 8:50:29 ET
Table 'Polydoros II' 6-max Seat #2 is the button
Seat 1: Xath76 ($10.74 in chips) 
Seat 2: voronin885 ($17.65 in chips) 
Seat 3: Vaha379 ($10.99 in chips) 
Seat 4: Squashy22 ($26.30 in chips) 
Seat 5: einsftw ($12.19 in chips) 
Seat 6: alexos04 ($20.03 in chips) 
Vaha379: posts small blind $0.05
Squashy22: posts big blind $0.10
*** HOLE CARDS ***
einsftw: raises $0.20 to $0.30
alexos04: folds 
Xath76: folds 
voronin885: folds 
Vaha379: folds 
Squashy22: folds 
Uncalled bet ($0.20) returned to einsftw
einsftw collected $0.25 from pot
einsftw: doesn't show hand 
*** SUMMARY ***
Total pot $0.25 | Rake $0 
Seat 1: Xath76 folded before Flop (didn't bet)
Seat 2: voronin885 (button) folded before Flop (didn't bet)
Seat 3: Vaha379 (small blind) folded before Flop
Seat 4: Squashy22 (big blind) folded before Flop
Seat 5: einsftw collected ($0.25)
Seat 6: alexos04 folded before Flop (didn't bet)



PokerStars Hand #222954073664:  Hold'em No Limit ($0.05/$0.10 USD) - 2021/01/23 8:50:38 ET
Table 'Polydoros II' 6-max Seat #3 is the button
Seat 1: Xath76 ($10.74 in chips) 
Seat 2: voronin885 ($17.65 in chips) 
Seat 3: Vaha379 ($10.94 in chips) 
Seat 4: Squashy22 ($26.20 in chips) 
Seat 5: einsftw ($12.34 in chips) 
Seat 6: alexos04 ($20.03 in chips) 
Squashy22: posts small blind $0.05
einsftw: posts big blind $0.10
*** HOLE CARDS ***
alexos04: folds 
Xath76: folds 
voronin885: folds 
Vaha379: folds 
Squashy22: folds 
Uncalled bet ($0.05) returned to einsftw
einsftw collected $0.10 from pot
einsftw: doesn't show hand 
*** SUMMARY ***
Total pot $0.10 | Rake $0 
Seat 1: Xath76 folded before Flop (didn't bet)
Seat 2: voronin885 folded before Flop (didn't bet)
Seat 3: Vaha379 (button) folded before Flop (didn't bet)
Seat 4: Squashy22 (small blind) folded before Flop
Seat 5: einsftw (big blind) collected ($0.10)
Seat 6: alexos04 folded before Flop (didn't bet)



PokerStars Hand #222954078991:  Hold'em No Limit ($0.05/$0.10 USD) - 2021/01/23 8:50:50 ET
Table 'Polydoros II' 6-max Seat #4 is the button
Seat 1: Xath76 ($10.74 in chips) 
Seat 2: voronin885 ($17.65 in chips) 
Seat 3: Vaha379 ($10.94 in chips) 
Seat 4: Squashy22 ($26.15 in chips) 
Seat 5: einsftw ($12.39 in chips) 
Seat 6: alexos04 ($20.03 in chips) 
einsftw: posts small blind $0.05
alexos04: posts big blind $0.10
*** HOLE CARDS ***
Xath76: folds 
voronin885: folds 
Vaha379: folds 
Squashy22: folds 
einsftw: folds 
Uncalled bet ($0.05) returned to alexos04
alexos04 collected $0.10 from pot
alexos04: doesn't show hand 
*** SUMMARY ***
Total pot $0.10 | Rake $0 
Seat 1: Xath76 folded before Flop (didn't bet)
Seat 2: voronin885 folded before Flop (didn't bet)
Seat 3: Vaha379 folded before Flop (didn't bet)
Seat 4: Squashy22 (button) folded before Flop (didn't bet)
Seat 5: einsftw (small blind) folded before Flop
Seat 6: alexos04 (big blind) collected ($0.10)



PokerStars Hand #222954082624:  Hold'em No Limit ($0.05/$0.10 USD) - 2021/01/23 8:50:57 ET
Table 'Polydoros II' 6-max Seat #5 is the button
Seat 1: Xath76 ($10.74 in chips) 
Seat 2: voronin885 ($17.65 in chips) 
Seat 3: Vaha379 ($10.94 in chips) 
Seat 4: Squashy22 ($26.15 in chips) 
Seat 5: einsftw ($12.34 in chips) 
Seat 6: alexos04 ($20.08 in chips) 
alexos04: posts small blind $0.05
Xath76: posts big blind $0.10
*** HOLE CARDS ***
voronin885: calls $0.10
Vaha379: folds 
Squashy22: folds 
einsftw: folds 
alexos04: folds 
Xath76: checks 
*** FLOP *** [2c 5c 6h]
Xath76: checks 
voronin885: checks 
*** TURN *** [2c 5c 6h] [7s]
Xath76: checks 
voronin885: bets $0.24
Xath76: folds 
Uncalled bet ($0.24) returned to voronin885
voronin885 collected $0.24 from pot
voronin885: doesn't show hand 
*** SUMMARY ***
Total pot $0.25 | Rake $0.01 
Board [2c 5c 6h 7s]
Seat 1: Xath76 (big blind) folded on the Turn
Seat 2: voronin885 collected ($0.24)
Seat 3: Vaha379 folded before Flop (didn't bet)
Seat 4: Squashy22 folded before Flop (didn't bet)
Seat 5: einsftw (button) folded before Flop (didn't bet)
Seat 6: alexos04 (small blind) folded before Flop



PokerStars Hand #222954096216:  Hold'em No Limit ($0.05/$0.10 USD) - 2021/01/23 8:51:27 ET
Table 'Polydoros II' 6-max Seat #6 is the button
Seat 1: Xath76 ($10.64 in chips) 
Seat 2: voronin885 ($17.79 in chips) 
Seat 3: Vaha379 ($10.94 in chips) 
Seat 4: Squashy22 ($26.15 in chips) 
Seat 5: einsftw ($12.34 in chips) 
Seat 6: alexos04 ($20.03 in chips) 
Xath76: posts small blind $0.05
voronin885: posts big blind $0.10
*** HOLE CARDS ***
Vaha379: raises $0.20 to $0.30
Squashy22: calls $0.30
einsftw: folds 
alexos04: folds 
Xath76: folds 
voronin885: calls $0.20
*** FLOP *** [Kc 5d Td]
voronin885: checks 
Vaha379: bets $0.75
Squashy22: calls $0.75
voronin885: raises $3.16 to $3.91
Vaha379: folds 
Squashy22: raises $8.72 to $12.63
voronin885: calls $8.72
*** TURN *** [Kc 5d Td] [Ah]
voronin885: bets $4.86 and is all-in
Squashy22: calls $4.86
*** RIVER *** [Kc 5d Td Ah] [4c]
*** SHOW DOWN ***
voronin885: shows [Ks 5s] (two pair, Kings and Fives)
Squashy22: shows [5h 5c] (three of a kind, Fives)
Squashy22 cashed out the hand for $33.24 | Cash Out Fee $0.34
*** SUMMARY ***
Total pot $36.68 | Rake $1.50 
Board [Kc 5d Td Ah 4c]
Seat 1: Xath76 (small blind) folded before Flop
Seat 2: voronin885 (big blind) showed [Ks 5s] and lost with two pair, Kings and Fives
Seat 3: Vaha379 folded on the Flop
Seat 4: Squashy22 showed [5h 5c] and won ($35.18) with three of a kind, Fives (pot not awarded as player cashed out)
Seat 5: einsftw folded before Flop (didn't bet)
Seat 6: alexos04 (button) folded before Flop (didn't bet)



PokerStars Hand #222954123470:  Hold'em No Limit ($0.05/$0.10 USD) - 2021/01/23 8:52:27 ET
Table 'Polydoros II' 6-max Seat #1 is the button
Seat 1: Xath76 ($10.59 in chips) 
Seat 3: Vaha379 ($9.89 in chips) 
Seat 4: Squashy22 ($41.60 in chips) 
Seat 5: einsftw ($12.34 in chips) 
Seat 6: alexos04 ($20.03 in chips) 
Vaha379: posts small blind $0.05
Squashy22: posts big blind $0.10
*** HOLE CARDS ***
einsftw: raises $0.20 to $0.30
alexos04: folds 
Xath76: calls $0.30
Vaha379: folds 
voronin885 leaves the table
Squashy22: folds 
*** FLOP *** [9c Ts Ks]
einsftw: bets $0.60
Xath76: calls $0.60
*** TURN *** [9c Ts Ks] [7s]
einsftw: bets $1.50
Xath76: calls $1.50
*** RIVER *** [9c Ts Ks 7s] [Ah]
PokerMasta55 joins the table at seat #2 
einsftw: checks 
Xath76: checks 
*** SHOW DOWN ***
einsftw: shows [Kh Jd] (a pair of Kings)
Xath76: shows [Kd Qd] (a pair of Kings - Ace+Queen kicker)
Xath76 collected $4.73 from pot
*** SUMMARY ***
Total pot $4.95 | Rake $0.22 
Board [9c Ts Ks 7s Ah]
Seat 1: Xath76 (button) showed [Kd Qd] and won ($4.73) with a pair of Kings
Seat 3: Vaha379 (small blind) folded before Flop
Seat 4: Squashy22 (big blind) folded before Flop
Seat 5: einsftw showed [Kh Jd] and lost with a pair of Kings
Seat 6: alexos04 folded before Flop (didn't bet)



PokerStars Hand #222954139972:  Hold'em No Limit ($0.05/$0.10 USD) - 2021/01/23 8:53:04 ET
Table 'Polydoros II' 6-max Seat #3 is the button
Seat 1: Xath76 ($12.92 in chips) 
Seat 3: Vaha379 ($9.84 in chips) 
Seat 4: Squashy22 ($41.50 in chips) 
Seat 5: einsftw ($10 in chips) 
Seat 6: alexos04 ($20.03 in chips) 
Squashy22: posts small blind $0.05
einsftw: posts big blind $0.10
PokerMasta55: sits out 
*** HOLE CARDS ***
alexos04: folds 
Xath76: folds 
Vaha379: folds 
Squashy22: folds 
Uncalled bet ($0.05) returned to einsftw
einsftw collected $0.10 from pot
einsftw: doesn't show hand 
*** SUMMARY ***
Total pot $0.10 | Rake $0 
Seat 1: Xath76 folded before Flop (didn't bet)
Seat 3: Vaha379 (button) folded before Flop (didn't bet)
Seat 4: Squashy22 (small blind) folded before Flop
Seat 5: einsftw (big blind) collected ($0.10)
Seat 6: alexos04 folded before Flop (didn't bet)



PokerStars Hand #222954145532:  Hold'em No Limit ($0.05/$0.10 USD) - 2021/01/23 8:53:16 ET
Table 'Polydoros II' 6-max Seat #4 is the button
Seat 1: Xath76 ($12.92 in chips) 
Seat 3: Vaha379 ($9.84 in chips) 
Seat 4: Squashy22 ($41.45 in chips) 
Seat 5: einsftw ($10.05 in chips) 
Seat 6: alexos04 ($20.03 in chips) 
einsftw: posts small blind $0.05
alexos04: posts big blind $0.10
PokerMasta55: sits out 
*** HOLE CARDS ***
Xath76: raises $0.20 to $0.30
Vaha379: folds 
Squashy22: calls $0.30
einsftw: folds 
alexos04: folds 
*** FLOP *** [Qc Jc Ac]
Xath76: checks 
Squashy22: bets $0.40
Xath76: folds 
Uncalled bet ($0.40) returned to Squashy22
Squashy22 collected $0.72 from pot
Squashy22: doesn't show hand 
*** SUMMARY ***
Total pot $0.75 | Rake $0.03 
Board [Qc Jc Ac]
Seat 1: Xath76 folded on the Flop
Seat 3: Vaha379 folded before Flop (didn't bet)
Seat 4: Squashy22 (button) collected ($0.72)
Seat 5: einsftw (small blind) folded before Flop
Seat 6: alexos04 (big blind) folded before Flop



PokerStars Hand #222954164352:  Hold'em No Limit ($0.05/$0.10 USD) - 2021/01/23 8:53:57 ET
Table 'Polydoros II' 6-max Seat #5 is the button
Seat 1: Xath76 ($12.62 in chips) 
Seat 3: Vaha379 ($9.84 in chips) 
Seat 4: Squashy22 ($41.87 in chips) 
Seat 5: einsftw ($10 in chips) 
Seat 6: alexos04 ($19.93 in chips) 
alexos04: posts small blind $0.05
Xath76: posts big blind $0.10
PokerMasta55: sits out 
*** HOLE CARDS ***
Vaha379: folds 
Squashy22: folds 
einsftw: raises $0.12 to $0.22
PokerMasta55 leaves the table
alexos04: calls $0.17
Xath76: folds 
*** FLOP *** [Ks Ad 4d]
alexos04: checks 
einsftw: bets $0.30
alexos04: calls $0.30
*** TURN *** [Ks Ad 4d] [3d]
yuvelir73 joins the table at seat #2 
alexos04: checks 
einsftw: checks 
*** RIVER *** [Ks Ad 4d 3d] [6h]
alexos04: checks 
einsftw: checks 
*** SHOW DOWN ***
alexos04: shows [Kh Tc] (a pair of Kings)
einsftw: mucks hand 
alexos04 collected $1.09 from pot
*** SUMMARY ***
Total pot $1.14 | Rake $0.05 
Board [Ks Ad 4d 3d 6h]
Seat 1: Xath76 (big blind) folded before Flop
Seat 3: Vaha379 folded before Flop (didn't bet)
Seat 4: Squashy22 folded before Flop (didn't bet)
Seat 5: einsftw (button) mucked
Seat 6: alexos04 (small blind) showed [Kh Tc] and won ($1.09) with a pair of Kings



PokerStars Hand #222954194800:  Hold'em No Limit ($0.05/$0.10 USD) - 2021/01/23 8:54:54 ET
Table 'Polydoros II' 6-max Seat #6 is the button
Seat 1: Xath76 ($12.52 in chips) 
Seat 2: yuvelir73 ($10 in chips) 
Seat 3: Vaha379 ($9.84 in chips) 
Seat 4: Squashy22 ($41.87 in chips) 
Seat 5: einsftw ($10 in chips) 
Seat 6: alexos04 ($20.50 in chips) 
Xath76: posts small blind $0.05
yuvelir73: posts big blind $0.10
*** HOLE CARDS ***
Vaha379: raises $0.20 to $0.30
Squashy22: folds 
einsftw: calls $0.30
alexos04: folds 
Xath76: calls $0.25
yuvelir73: folds 
*** FLOP *** [Jh 4c 5d]
Xath76: checks 
Vaha379: checks 
einsftw: checks 
*** TURN *** [Jh 4c 5d] [6s]
Xath76: checks 
Vaha379: bets $0.48
einsftw: folds 
Xath76: folds 
Uncalled bet ($0.48) returned to Vaha379
Vaha379 collected $0.96 from pot
Vaha379: doesn't show hand 
*** SUMMARY ***
Total pot $1 | Rake $0.04 
Board [Jh 4c 5d 6s]
Seat 1: Xath76 (small blind) folded on the Turn
Seat 2: yuvelir73 (big blind) folded before Flop
Seat 3: Vaha379 collected ($0.96)
Seat 4: Squashy22 folded before Flop (didn't bet)
Seat 5: einsftw folded on the Turn
Seat 6: alexos04 (button) folded before Flop (didn't bet)



PokerStars Hand #222954208818:  Hold'em No Limit ($0.05/$0.10 USD) - 2021/01/23 8:55:29 ET
Table 'Polydoros II' 6-max Seat #1 is the button
Seat 1: Xath76 ($12.22 in chips) 
Seat 2: yuvelir73 ($9.90 in chips) 
Seat 3: Vaha379 ($10.50 in chips) 
Seat 4: Squashy22 ($41.87 in chips) 
Seat 5: einsftw ($10 in chips) 
Seat 6: alexos04 ($20.50 in chips) 
yuvelir73: posts small blind $0.05
Vaha379: posts big blind $0.10
*** HOLE CARDS ***
Squashy22: folds 
einsftw: folds 
alexos04: folds 
Xath76: raises $0.20 to $0.30
yuvelir73: calls $0.25
Vaha379: calls $0.20
*** FLOP *** [3c Ks 9c]
yuvelir73: checks 
Vaha379: checks 
Xath76: checks 
*** TURN *** [3c Ks 9c] [Ad]
yuvelir73: checks 
Vaha379: checks 
Xath76: checks 
*** RIVER *** [3c Ks 9c Ad] [2h]
yuvelir73: bets $0.30
Vaha379: folds 
Xath76: folds 
Uncalled bet ($0.30) returned to yuvelir73
yuvelir73 collected $0.86 from pot
*** SUMMARY ***
Total pot $0.90 | Rake $0.04 
Board [3c Ks 9c Ad 2h]
Seat 1: Xath76 (button) folded on the River
Seat 2: yuvelir73 (small blind) collected ($0.86)
Seat 3: Vaha379 (big blind) folded on the River
Seat 4: Squashy22 folded before Flop (didn't bet)
Seat 5: einsftw folded before Flop (didn't bet)
Seat 6: alexos04 folded before Flop (didn't bet)



PokerStars Hand #222954219558:  Hold'em No Limit ($0.05/$0.10 USD) - 2021/01/23 8:55:59 ET
Table 'Polydoros II' 6-max Seat #2 is the button
Seat 1: Xath76 ($11.92 in chips) 
Seat 2: yuvelir73 ($10.46 in chips) 
Seat 3: Vaha379 ($10.20 in chips) 
Seat 4: Squashy22 ($41.87 in chips) 
Seat 5: einsftw ($10 in chips) 
Seat 6: alexos04 ($20.50 in chips) 
Vaha379: posts small blind $0.05
Squashy22: posts big blind $0.10
*** HOLE CARDS ***
einsftw: folds 
alexos04: folds 
Xath76: folds 
yuvelir73: folds 
Vaha379: folds 
Uncalled bet ($0.05) returned to Squashy22
Squashy22 collected $0.10 from pot
Squashy22: doesn't show hand 
*** SUMMARY ***
Total pot $0.10 | Rake $0 
Seat 1: Xath76 folded before Flop (didn't bet)
Seat 2: yuvelir73 (button) folded before Flop (didn't bet)
Seat 3: Vaha379 (small blind) folded before Flop
Seat 4: Squashy22 (big blind) collected ($0.10)
Seat 5: einsftw folded before Flop (didn't bet)
Seat 6: alexos04 folded before Flop (didn't bet)



PokerStars Hand #222954223643:  Hold'em No Limit ($0.05/$0.10 USD) - 2021/01/23 8:56:10 ET
Table 'Polydoros II' 6-max Seat #3 is the button
Seat 1: Xath76 ($11.92 in chips) 
Seat 2: yuvelir73 ($10.46 in chips) 
Seat 3: Vaha379 ($10.15 in chips) 
Seat 4: Squashy22 ($41.92 in chips) 
Seat 5: einsftw ($10 in chips) 
Seat 6: alexos04 ($20.50 in chips) 
Squashy22: posts small blind $0.05
einsftw: posts big blind $0.10
*** HOLE CARDS ***
alexos04: raises $0.20 to $0.30
Xath76: folds 
yuvelir73: folds 
Vaha379: folds 
Squashy22: folds 
einsftw: folds 
Uncalled bet ($0.20) returned to alexos04
alexos04 collected $0.25 from pot
alexos04: doesn't show hand 
*** SUMMARY ***
Total pot $0.25 | Rake $0 
Seat 1: Xath76 folded before Flop (didn't bet)
Seat 2: yuvelir73 folded before Flop (didn't bet)
Seat 3: Vaha379 (button) folded before Flop (didn't bet)
Seat 4: Squashy22 (small blind) folded before Flop
Seat 5: einsftw (big blind) folded before Flop
Seat 6: alexos04 collected ($0.25)



PokerStars Hand #222954226837:  Hold'em No Limit ($0.05/$0.10 USD) - 2021/01/23 8:56:19 ET
Table 'Polydoros II' 6-max Seat #4 is the button
Seat 1: Xath76 ($11.92 in chips) 
Seat 2: yuvelir73 ($10.46 in chips) 
Seat 3: Vaha379 ($10.15 in chips) 
Seat 4: Squashy22 ($41.87 in chips) 
Seat 5: einsftw ($10 in chips) 
Seat 6: alexos04 ($20.65 in chips) 
einsftw: posts small blind $0.05
alexos04: posts big blind $0.10
*** HOLE CARDS ***
Xath76: folds 
yuvelir73: raises $0.10 to $0.20
Vaha379: folds 
Squashy22: raises $0.55 to $0.75
einsftw: folds 
alexos04: folds 
yuvelir73: folds 
Uncalled bet ($0.55) returned to Squashy22
Squashy22 collected $0.55 from pot
Squashy22: doesn't show hand 
*** SUMMARY ***
Total pot $0.55 | Rake $0 
Seat 1: Xath76 folded before Flop (didn't bet)
Seat 2: yuvelir73 folded before Flop
Seat 3: Vaha379 folded before Flop (didn't bet)
Seat 4: Squashy22 (button) collected ($0.55)
Seat 5: einsftw (small blind) folded before Flop
Seat 6: alexos04 (big blind) folded before Flop



PokerStars Hand #222954238100:  Hold'em No Limit ($0.05/$0.10 USD) - 2021/01/23 8:56:51 ET
Table 'Polydoros II' 6-max Seat #5 is the button
Seat 1: Xath76 ($11.92 in chips) 
Seat 2: yuvelir73 ($10.26 in chips) 
Seat 3: Vaha379 ($10.15 in chips) 
Seat 4: Squashy22 ($42.22 in chips) 
Seat 5: einsftw ($10 in chips) 
Seat 6: alexos04 ($20.55 in chips) 
alexos04: posts small blind $0.05
Xath76: posts big blind $0.10
*** HOLE CARDS ***
yuvelir73: raises $0.10 to $0.20
Vaha379 has timed out
Vaha379: folds 
Squashy22: folds 
einsftw: folds 
alexos04: folds 
Xath76: folds 
Uncalled bet ($0.10) returned to yuvelir73
yuvelir73 collected $0.25 from pot
*** SUMMARY ***
Total pot $0.25 | Rake $0 
Seat 1: Xath76 (big blind) folded before Flop
Seat 2: yuvelir73 collected ($0.25)
Seat 3: Vaha379 folded before Flop (didn't bet)
Seat 4: Squashy22 folded before Flop (didn't bet)
Seat 5: einsftw (button) folded before Flop (didn't bet)
Seat 6: alexos04 (small blind) folded before Flop



PokerStars Hand #222954248899:  Hold'em No Limit ($0.05/$0.10 USD) - 2021/01/23 8:57:20 ET
Table 'Polydoros II' 6-max Seat #6 is the button
Seat 1: Xath76 ($11.82 in chips) 
Seat 2: yuvelir73 ($10.41 in chips) 
Seat 4: Squashy22 ($42.22 in chips) 
Seat 5: einsftw ($10 in chips) 
Seat 6: alexos04 ($20.50 in chips) 
Xath76: posts small blind $0.05
yuvelir73: posts big blind $0.10
*** HOLE CARDS ***
Squashy22: raises $0.19 to $0.29
einsftw: folds 
alexos04: folds 
Xath76: calls $0.24
yuvelir73: folds 
*** FLOP *** [Qs 6s 3c]
Xath76: checks 
Squashy22: bets $0.28
Xath76: folds 
Uncalled bet ($0.28) returned to Squashy22
Squashy22 collected $0.65 from pot
Squashy22: doesn't show hand 
*** SUMMARY ***
Total pot $0.68 | Rake $0.03 
Board [Qs 6s 3c]
Seat 1: Xath76 (small blind) folded on the Flop
Seat 2: yuvelir73 (big blind) folded before Flop
Seat 4: Squashy22 collected ($0.65)
Seat 5: einsftw folded before Flop (didn't bet)
Seat 6: alexos04 (button) folded before Flop (didn't bet)



PokerStars Hand #222954256406:  Hold'em No Limit ($0.05/$0.10 USD) - 2021/01/23 8:57:41 ET
Table 'Polydoros II' 6-max Seat #1 is the button
Seat 1: Xath76 ($11.53 in chips) 
Seat 2: yuvelir73 ($10.31 in chips) 
Seat 4: Squashy22 ($42.58 in chips) 
Seat 5: einsftw ($10 in chips) 
Seat 6: alexos04 ($20.50 in chips) 
yuvelir73: posts small blind $0.05
Squashy22: posts big blind $0.10
*** HOLE CARDS ***
einsftw: folds 
alexos04: folds 
Xath76: folds 
yuvelir73: folds 
Uncalled bet ($0.05) returned to Squashy22
Squashy22 collected $0.10 from pot
Squashy22: doesn't show hand 
*** SUMMARY ***
Total pot $0.10 | Rake $0 
Seat 1: Xath76 (button) folded before Flop (didn't bet)
Seat 2: yuvelir73 (small blind) folded before Flop
Seat 4: Squashy22 (big blind) collected ($0.10)
Seat 5: einsftw folded before Flop (didn't bet)
Seat 6: alexos04 folded before Flop (didn't bet)



PokerStars Hand #222954259160:  Hold'em No Limit ($0.05/$0.10 USD) - 2021/01/23 8:57:48 ET
Table 'Polydoros II' 6-max Seat #2 is the button
Seat 1: Xath76 ($11.53 in chips) 
Seat 2: yuvelir73 ($10.26 in chips) 
Seat 4: Squashy22 ($42.63 in chips) 
Seat 5: einsftw ($10 in chips) 
Seat 6: alexos04 ($20.50 in chips) 
Squashy22: posts small blind $0.05
einsftw: posts big blind $0.10
*** HOLE CARDS ***
alexos04: raises $0.20 to $0.30
Xath76: folds 
yuvelir73: calls $0.30
Squashy22: folds 
einsftw: calls $0.20
*** FLOP *** [9h Js Kc]
einsftw: checks 
alexos04: checks 
yuvelir73: checks 
*** TURN *** [9h Js Kc] [Qd]
einsftw: checks 
alexos04: checks 
yuvelir73: checks 
*** RIVER *** [9h Js Kc Qd] [Th]
einsftw: checks 
alexos04: bets $0.40
yuvelir73: folds 
einsftw: calls $0.40
*** SHOW DOWN ***
alexos04: shows [6s As] (a straight, Ten to Ace)
einsftw: mucks hand 
alexos04 collected $1.67 from pot
*** SUMMARY ***
Total pot $1.75 | Rake $0.08 
Board [9h Js Kc Qd Th]
Seat 1: Xath76 folded before Flop (didn't bet)
Seat 2: yuvelir73 (button) folded on the River
Seat 4: Squashy22 (small blind) folded before Flop
Seat 5: einsftw (big blind) mucked
Seat 6: alexos04 showed [6s As] and won ($1.67) with a straight, Ten to Ace



PokerStars Hand #222954281785:  Hold'em No Limit ($0.05/$0.10 USD) - 2021/01/23 8:58:50 ET
Table 'Polydoros II' 6-max Seat #4 is the button
Seat 1: Xath76 ($11.53 in chips) 
Seat 2: yuvelir73 ($9.96 in chips) 
Seat 3: Vaha379 ($10.15 in chips) 
Seat 4: Squashy22 ($42.58 in chips) 
Seat 5: einsftw ($10 in chips) 
Seat 6: alexos04 ($21.47 in chips) 
einsftw: posts small blind $0.05
alexos04: posts big blind $0.10
Vaha379: posts small & big blinds $0.15
*** HOLE CARDS ***
Xath76: folds 
yuvelir73: folds 
Vaha379: raises $0.30 to $0.40
Squashy22: folds 
einsftw: folds 
alexos04: calls $0.30
*** FLOP *** [8c 9c Kc]
alexos04: checks 
Vaha379: bets $0.33
alexos04: raises $0.67 to $1
Vaha379: raises $1.43 to $2.43
alexos04: folds 
Uncalled bet ($1.43) returned to Vaha379
Vaha379 collected $2.77 from pot
Vaha379: doesn't show hand 
*** SUMMARY ***
Total pot $2.90 | Rake $0.13 
Board [8c 9c Kc]
Seat 1: Xath76 folded before Flop (didn't bet)
Seat 2: yuvelir73 folded before Flop (didn't bet)
Seat 3: Vaha379 collected ($2.77)
Seat 4: Squashy22 (button) folded before Flop (didn't bet)
Seat 5: einsftw (small blind) folded before Flop
Seat 6: alexos04 (big blind) folded on the Flop



PokerStars Hand #222954302835:  Hold'em No Limit ($0.05/$0.10 USD) - 2021/01/23 8:59:48 ET
Table 'Polydoros II' 6-max Seat #5 is the button
Seat 1: Xath76 ($11.53 in chips) 
Seat 2: yuvelir73 ($9.96 in chips) 
Seat 3: Vaha379 ($11.47 in chips) 
Seat 4: Squashy22 ($42.58 in chips) 
Seat 5: einsftw ($10 in chips) 
Seat 6: alexos04 ($20.07 in chips) 
alexos04: posts small blind $0.05
Xath76: posts big blind $0.10
*** HOLE CARDS ***
yuvelir73: folds 
Vaha379: folds 
Squashy22: raises $0.16 to $0.26
einsftw: folds 
alexos04: folds 
Xath76: folds 
Uncalled bet ($0.16) returned to Squashy22
Squashy22 collected $0.25 from pot
Squashy22: doesn't show hand 
*** SUMMARY ***
Total pot $0.25 | Rake $0 
Seat 1: Xath76 (big blind) folded before Flop
Seat 2: yuvelir73 folded before Flop (didn't bet)
Seat 3: Vaha379 folded before Flop (didn't bet)
Seat 4: Squashy22 collected ($0.25)
Seat 5: einsftw (button) folded before Flop (didn't bet)
Seat 6: alexos04 (small blind) folded before Flop



PokerStars Hand #222954308447:  Hold'em No Limit ($0.05/$0.10 USD) - 2021/01/23 9:00:03 ET
Table 'Polydoros II' 6-max Seat #6 is the button
Seat 1: Xath76 ($11.43 in chips) 
Seat 2: yuvelir73 ($9.96 in chips) 
Seat 3: Vaha379 ($11.47 in chips) 
Seat 4: Squashy22 ($42.73 in chips) 
Seat 5: einsftw ($10 in chips) 
Seat 6: alexos04 ($20.02 in chips) 
Xath76: posts small blind $0.05
yuvelir73: posts big blind $0.10
*** HOLE CARDS ***
Vaha379: folds 
Squashy22: folds 
einsftw: folds 
alexos04: folds 
Xath76: calls $0.05
yuvelir73: checks 
*** FLOP *** [9h Ad Js]
Xath76: checks 
yuvelir73: bets $0.10
Xath76: calls $0.10
*** TURN *** [9h Ad Js] [Td]
Xath76: checks 
yuvelir73: checks 
*** RIVER *** [9h Ad Js Td] [5h]
Xath76: bets $0.19
yuvelir73: calls $0.19
*** SHOW DOWN ***
Xath76: shows [8h 7h] (a straight, Seven to Jack)
yuvelir73: mucks hand 
Xath76 collected $0.74 from pot
*** SUMMARY ***
Total pot $0.78 | Rake $0.04 
Board [9h Ad Js Td 5h]
Seat 1: Xath76 (small blind) showed [8h 7h] and won ($0.74) with a straight, Seven to Jack
Seat 2: yuvelir73 (big blind) mucked
Seat 3: Vaha379 folded before Flop (didn't bet)
Seat 4: Squashy22 folded before Flop (didn't bet)
Seat 5: einsftw folded before Flop (didn't bet)
Seat 6: alexos04 (button) folded before Flop (didn't bet)



PokerStars Hand #222954320341:  Hold'em No Limit ($0.05/$0.10 USD) - 2021/01/23 9:00:34 ET
Table 'Polydoros II' 6-max Seat #1 is the button
Seat 1: Xath76 ($11.78 in chips) 
Seat 2: yuvelir73 ($9.57 in chips) 
Seat 3: Vaha379 ($11.47 in chips) 
Seat 4: Squashy22 ($42.73 in chips) 
Seat 5: einsftw ($10 in chips) 
Seat 6: alexos04 ($20.02 in chips) 
yuvelir73: posts small blind $0.05
Vaha379: posts big blind $0.10
*** HOLE CARDS ***
Squashy22: folds 
einsftw: folds 
alexos04: folds 
Xath76: folds 
yuvelir73: raises $0.20 to $0.30
Vaha379: folds 
Uncalled bet ($0.20) returned to yuvelir73
yuvelir73 collected $0.20 from pot
*** SUMMARY ***
Total pot $0.20 | Rake $0 
Seat 1: Xath76 (button) folded before Flop (didn't bet)
Seat 2: yuvelir73 (small blind) collected ($0.20)
Seat 3: Vaha379 (big blind) folded before Flop
Seat 4: Squashy22 folded before Flop (didn't bet)
Seat 5: einsftw folded before Flop (didn't bet)
Seat 6: alexos04 folded before Flop (didn't bet)



PokerStars Hand #222954324812:  Hold'em No Limit ($0.05/$0.10 USD) - 2021/01/23 9:00:45 ET
Table 'Polydoros II' 6-max Seat #2 is the button
Seat 1: Xath76 ($11.78 in chips) 
Seat 2: yuvelir73 ($9.67 in chips) 
Seat 3: Vaha379 ($11.37 in chips) 
Seat 4: Squashy22 ($42.73 in chips) 
Seat 5: einsftw ($10 in chips) 
Seat 6: alexos04 ($20.02 in chips) 
Vaha379: posts small blind $0.05
Squashy22: posts big blind $0.10
*** HOLE CARDS ***
einsftw: folds 
alexos04: folds 
Xath76: folds 
yuvelir73: folds 
Vaha379: raises $0.20 to $0.30
Squashy22: folds 
Uncalled bet ($0.20) returned to Vaha379
Vaha379 collected $0.20 from pot
Vaha379: doesn't show hand 
*** SUMMARY ***
Total pot $0.20 | Rake $0 
Seat 1: Xath76 folded before Flop (didn't bet)
Seat 2: yuvelir73 (button) folded before Flop (didn't bet)
Seat 3: Vaha379 (small blind) collected ($0.20)
Seat 4: Squashy22 (big blind) folded before Flop
Seat 5: einsftw folded before Flop (didn't bet)
Seat 6: alexos04 folded before Flop (didn't bet)



PokerStars Hand #222954328487:  Hold'em No Limit ($0.05/$0.10 USD) - 2021/01/23 9:00:54 ET
Table 'Polydoros II' 6-max Seat #3 is the button
Seat 1: Xath76 ($11.78 in chips) 
Seat 2: yuvelir73 ($9.67 in chips) 
Seat 3: Vaha379 ($11.47 in chips) 
Seat 4: Squashy22 ($42.63 in chips) 
Seat 6: alexos04 ($20.02 in chips) 
Squashy22: posts small blind $0.05
einsftw: is sitting out 
einsftw leaves the table
alexos04: posts big blind $0.10
*** HOLE CARDS ***
Xath76: raises $0.20 to $0.30
yuvelir73: folds 
crankthatsoulja joins the table at seat #5 
Vaha379: folds 
Squashy22: folds 
crankthatsoulja leaves the table
alexos04: folds 
Uncalled bet ($0.20) returned to Xath76
Xath76 collected $0.25 from pot
Xath76: doesn't show hand 
*** SUMMARY ***
Total pot $0.25 | Rake $0 
Seat 1: Xath76 collected ($0.25)
Seat 2: yuvelir73 folded before Flop (didn't bet)
Seat 3: Vaha379 (button) folded before Flop (didn't bet)
Seat 4: Squashy22 (small blind) folded before Flop
Seat 6: alexos04 (big blind) folded before Flop



PokerStars Hand #222954335067:  Hold'em No Limit ($0.05/$0.10 USD) - 2021/01/23 9:01:10 ET
Table 'Polydoros II' 6-max Seat #4 is the button
Seat 1: Xath76 ($11.93 in chips) 
Seat 2: yuvelir73 ($9.67 in chips) 
Seat 3: Vaha379 ($11.47 in chips) 
Seat 4: Squashy22 ($42.58 in chips) 
Seat 6: alexos04 ($19.92 in chips) 
alexos04: posts small blind $0.05
Xath76: posts big blind $0.10
*** HOLE CARDS ***
yuvelir73: folds 
Vaha379: folds 
Squashy22: folds 
alexos04: raises $0.20 to $0.30
Xath76: folds 
Uncalled bet ($0.20) returned to alexos04
alexos04 collected $0.20 from pot
alexos04: doesn't show hand 
*** SUMMARY ***
Total pot $0.20 | Rake $0 
Seat 1: Xath76 (big blind) folded before Flop
Seat 2: yuvelir73 folded before Flop (didn't bet)
Seat 3: Vaha379 folded before Flop (didn't bet)
Seat 4: Squashy22 (button) folded before Flop (didn't bet)
Seat 6: alexos04 (small blind) collected ($0.20)



PokerStars Hand #222954344181:  Hold'em No Limit ($0.05/$0.10 USD) - 2021/01/23 9:01:23 ET
Table 'Polydoros II' 6-max Seat #6 is the button
Seat 1: Xath76 ($11.83 in chips) 
Seat 2: yuvelir73 ($9.67 in chips) 
Seat 3: Vaha379 ($11.47 in chips) 
Seat 4: Squashy22 ($42.58 in chips) 
Seat 6: alexos04 ($20.02 in chips) 
Xath76: posts small blind $0.05
yuvelir73: posts big blind $0.10
*** HOLE CARDS ***
Vaha379: folds 
SafeHead joins the table at seat #5 
Squashy22: folds 
alexos04: folds 
Xath76: folds 
Uncalled bet ($0.05) returned to yuvelir73
yuvelir73 collected $0.10 from pot
*** SUMMARY ***
Total pot $0.10 | Rake $0 
Seat 1: Xath76 (small blind) folded before Flop
Seat 2: yuvelir73 (big blind) collected ($0.10)
Seat 3: Vaha379 folded before Flop (didn't bet)
Seat 4: Squashy22 folded before Flop (didn't bet)
Seat 6: alexos04 (button) folded before Flop (didn't bet)



PokerStars Hand #222954349850:  Hold'em No Limit ($0.05/$0.10 USD) - 2021/01/23 9:01:36 ET
Table 'Polydoros II' 6-max Seat #1 is the button
Seat 1: Xath76 ($11.78 in chips) 
Seat 2: yuvelir73 ($9.72 in chips) 
Seat 3: Vaha379 ($11.47 in chips) 
Seat 4: Squashy22 ($42.58 in chips) 
Seat 5: SafeHead ($10 in chips) 
Seat 6: alexos04 ($20.02 in chips) 
yuvelir73: posts small blind $0.05
Vaha379: posts big blind $0.10
SafeHead: posts big blind $0.10
*** HOLE CARDS ***
Squashy22: folds 
SafeHead: checks 
alexos04: folds 
Xath76: folds 
yuvelir73: calls $0.05
Vaha379: checks 
*** FLOP *** [6d 8s 6c]
yuvelir73: checks 
Vaha379: checks 
SafeHead: bets $0.15
yuvelir73: folds 
Vaha379: calls $0.15
*** TURN *** [6d 8s 6c] [Th]
Vaha379: checks 
SafeHead: bets $0.30
Vaha379: calls $0.30
*** RIVER *** [6d 8s 6c Th] [9s]
Vaha379: checks 
SafeHead: bets $2
Vaha379: calls $2
*** SHOW DOWN ***
SafeHead: shows [5d 2h] (a pair of Sixes)
Vaha379: shows [7h 9h] (a straight, Six to Ten)
Vaha379 collected $4.97 from pot
*** SUMMARY ***
Total pot $5.20 | Rake $0.23 
Board [6d 8s 6c Th 9s]
Seat 1: Xath76 (button) folded before Flop (didn't bet)
Seat 2: yuvelir73 (small blind) folded on the Flop
Seat 3: Vaha379 (big blind) showed [7h 9h] and won ($4.97) with a straight, Six to Ten
Seat 4: Squashy22 folded before Flop (didn't bet)
Seat 5: SafeHead showed [5d 2h] and lost with a pair of Sixes
Seat 6: alexos04 folded before Flop (didn't bet)



PokerStars Hand #222954377318:  Hold'em No Limit ($0.05/$0.10 USD) - 2021/01/23 9:02:34 ET
Table 'Polydoros II' 6-max Seat #2 is the button
Seat 1: Xath76 ($11.78 in chips) 
Seat 2: yuvelir73 ($9.62 in chips) 
Seat 3: Vaha379 ($13.89 in chips) 
Seat 4: Squashy22 ($42.58 in chips) 
Seat 5: SafeHead ($7.45 in chips) 
Seat 6: alexos04 ($20.02 in chips) 
Vaha379: posts small blind $0.05
Squashy22: posts big blind $0.10
*** HOLE CARDS ***
SafeHead: folds 
alexos04: folds 
Xath76: folds 
yuvelir73: raises $0.10 to $0.20
Vaha379: folds 
SafeHead leaves the table
Squashy22: folds 
Uncalled bet ($0.10) returned to yuvelir73
yuvelir73 collected $0.25 from pot
*** SUMMARY ***
Total pot $0.25 | Rake $0 
Seat 1: Xath76 folded before Flop (didn't bet)
Seat 2: yuvelir73 (button) collected ($0.25)
Seat 3: Vaha379 (small blind) folded before Flop
Seat 4: Squashy22 (big blind) folded before Flop
Seat 5: SafeHead folded before Flop (didn't bet)
Seat 6: alexos04 folded before Flop (didn't bet)



PokerStars Hand #222954382370:  Hold'em No Limit ($0.05/$0.10 USD) - 2021/01/23 9:02:45 ET
Table 'Polydoros II' 6-max Seat #3 is the button
Seat 1: Xath76 ($11.78 in chips) 
Seat 2: yuvelir73 ($9.77 in chips) 
Seat 3: Vaha379 ($13.84 in chips) 
Seat 4: Squashy22 ($42.48 in chips) 
Seat 6: alexos04 ($20.02 in chips) 
Squashy22: posts small blind $0.05
alexos04: posts big blind $0.10
*** HOLE CARDS ***
Xath76: folds 
yuvelir73: folds 
Vaha379: raises $0.20 to $0.30
Squashy22: folds 
alexos04: folds 
Uncalled bet ($0.20) returned to Vaha379
Vaha379 collected $0.25 from pot
Vaha379: doesn't show hand 
*** SUMMARY ***
Total pot $0.25 | Rake $0 
Seat 1: Xath76 folded before Flop (didn't bet)
Seat 2: yuvelir73 folded before Flop (didn't bet)
Seat 3: Vaha379 (button) collected ($0.25)
Seat 4: Squashy22 (small blind) folded before Flop
Seat 6: alexos04 (big blind) folded before Flop



PokerStars Hand #222954389742:  Hold'em No Limit ($0.05/$0.10 USD) - 2021/01/23 9:03:00 ET
Table 'Polydoros II' 6-max Seat #4 is the button
Seat 1: Xath76 ($11.78 in chips) 
Seat 2: yuvelir73 ($9.77 in chips) 
Seat 3: Vaha379 ($13.99 in chips) 
Seat 4: Squashy22 ($42.43 in chips) 
Seat 6: alexos04 ($19.92 in chips) 
alexos04: posts small blind $0.05
Xath76: posts big blind $0.10
*** HOLE CARDS ***
yuvelir73: folds 
Vaha379: folds 
Squashy22: raises $0.14 to $0.24
alexos04: calls $0.19
Xath76: folds 
*** FLOP *** [8d 2d 2h]
alexos04: checks 
Squashy22: bets $0.24
alexos04: calls $0.24
*** TURN *** [8d 2d 2h] [5h]
alexos04: checks 
VanCleef322 joins the table at seat #5 
Squashy22: bets $0.43
alexos04: folds 
Uncalled bet ($0.43) returned to Squashy22
Squashy22 collected $1.01 from pot
Squashy22: doesn't show hand 
*** SUMMARY ***
Total pot $1.06 | Rake $0.05 
Board [8d 2d 2h 5h]
Seat 1: Xath76 (big blind) folded before Flop
Seat 2: yuvelir73 folded before Flop (didn't bet)
Seat 3: Vaha379 folded before Flop (didn't bet)
Seat 4: Squashy22 (button) collected ($1.01)
Seat 6: alexos04 (small blind) folded on the Turn



PokerStars Hand #222954417533:  Hold'em No Limit ($0.05/$0.10 USD) - 2021/01/23 9:03:57 ET
Table 'Polydoros II' 6-max Seat #6 is the button
Seat 1: Xath76 ($11.68 in chips) 
Seat 2: yuvelir73 ($9.77 in chips) 
Seat 3: Vaha379 ($13.99 in chips) 
Seat 4: Squashy22 ($42.96 in chips) 
Seat 6: alexos04 ($19.44 in chips) 
Xath76: posts small blind $0.05
yuvelir73: posts big blind $0.10
VanCleef322: sits out 
*** HOLE CARDS ***
Vaha379: folds 
Squashy22: folds 
alexos04: folds 
Xath76: folds 
Uncalled bet ($0.05) returned to yuvelir73
yuvelir73 collected $0.10 from pot
*** SUMMARY ***
Total pot $0.10 | Rake $0 
Seat 1: Xath76 (small blind) folded before Flop
Seat 2: yuvelir73 (big blind) collected ($0.10)
Seat 3: Vaha379 folded before Flop (didn't bet)
Seat 4: Squashy22 folded before Flop (didn't bet)
Seat 6: alexos04 (button) folded before Flop (didn't bet)



PokerStars Hand #222954422115:  Hold'em No Limit ($0.05/$0.10 USD) - 2021/01/23 9:04:07 ET
Table 'Polydoros II' 6-max Seat #1 is the button
Seat 1: Xath76 ($11.63 in chips) 
Seat 2: yuvelir73 ($9.82 in chips) 
Seat 3: Vaha379 ($13.99 in chips) 
Seat 4: Squashy22 ($42.96 in chips) 
Seat 6: alexos04 ($19.44 in chips) 
yuvelir73: posts small blind $0.05
Vaha379: posts big blind $0.10
VanCleef322: sits out 
*** HOLE CARDS ***
Squashy22: folds 
alexos04: folds 
Xath76: folds 
yuvelir73: raises $0.10 to $0.20
Vaha379: folds 
Uncalled bet ($0.10) returned to yuvelir73
yuvelir73 collected $0.20 from pot
*** SUMMARY ***
Total pot $0.20 | Rake $0 
Seat 1: Xath76 (button) folded before Flop (didn't bet)
Seat 2: yuvelir73 (small blind) collected ($0.20)
Seat 3: Vaha379 (big blind) folded before Flop
Seat 4: Squashy22 folded before Flop (didn't bet)
Seat 6: alexos04 folded before Flop (didn't bet)



PokerStars Hand #222954429601:  Hold'em No Limit ($0.05/$0.10 USD) - 2021/01/23 9:04:22 ET
Table 'Polydoros II' 6-max Seat #2 is the button
Seat 1: Xath76 ($11.63 in chips) 
Seat 2: yuvelir73 ($9.92 in chips) 
Seat 3: Vaha379 ($13.89 in chips) 
Seat 4: Squashy22 ($42.96 in chips) 
Seat 6: alexos04 ($19.44 in chips) 
Vaha379: posts small blind $0.05
Squashy22: posts big blind $0.10
VanCleef322: sits out 
*** HOLE CARDS ***
alexos04: folds 
Xath76: folds 
yuvelir73: folds 
Vaha379: folds 
Uncalled bet ($0.05) returned to Squashy22
Squashy22 collected $0.10 from pot
*** SUMMARY ***
Total pot $0.10 | Rake $0 
Seat 1: Xath76 folded before Flop (didn't bet)
Seat 2: yuvelir73 (button) folded before Flop (didn't bet)
Seat 3: Vaha379 (small blind) folded before Flop
Seat 4: Squashy22 (big blind) collected ($0.10)
Seat 6: alexos04 folded before Flop (didn't bet)



PokerStars Hand #222954437582:  Hold'em No Limit ($0.05/$0.10 USD) - 2021/01/23 9:04:38 ET
Table 'Polydoros II' 6-max Seat #3 is the button
Seat 1: Xath76 ($11.63 in chips) 
Seat 2: yuvelir73 ($9.92 in chips) 
Seat 3: Vaha379 ($13.84 in chips) 
Seat 4: Squashy22 ($43.01 in chips) 
Seat 5: VanCleef322 ($10 in chips) 
Seat 6: alexos04 ($19.44 in chips) 
Squashy22: posts small blind $0.05
VanCleef322: posts big blind $0.10
*** HOLE CARDS ***
alexos04: folds 
Xath76: folds 
yuvelir73: folds 
Vaha379 has timed out
Vaha379: folds 
Squashy22: folds 
Uncalled bet ($0.05) returned to VanCleef322
VanCleef322 collected $0.10 from pot
VanCleef322: doesn't show hand 
*** SUMMARY ***
Total pot $0.10 | Rake $0 
Seat 1: Xath76 folded before Flop (didn't bet)
Seat 2: yuvelir73 folded before Flop (didn't bet)
Seat 3: Vaha379 (button) folded before Flop (didn't bet)
Seat 4: Squashy22 (small blind) folded before Flop
Seat 5: VanCleef322 (big blind) collected ($0.10)
Seat 6: alexos04 folded before Flop (didn't bet)



PokerStars Hand #222954446304:  Hold'em No Limit ($0.05/$0.10 USD) - 2021/01/23 9:04:56 ET
Table 'Polydoros II' 6-max Seat #4 is the button
Seat 1: Xath76 ($11.63 in chips) 
Seat 2: yuvelir73 ($9.92 in chips) 
Seat 4: Squashy22 ($42.96 in chips) 
Seat 5: VanCleef322 ($10.05 in chips) 
Seat 6: alexos04 ($19.44 in chips) 
VanCleef322: posts small blind $0.05
alexos04: posts big blind $0.10
*** HOLE CARDS ***
Xath76: folds 
yuvelir73: folds 
Squashy22: folds 
VanCleef322: raises $0.15 to $0.25
alexos04: folds 
Uncalled bet ($0.15) returned to VanCleef322
VanCleef322 collected $0.20 from pot
VanCleef322: doesn't show hand 
*** SUMMARY ***
Total pot $0.20 | Rake $0 
Seat 1: Xath76 folded before Flop (didn't bet)
Seat 2: yuvelir73 folded before Flop (didn't bet)
Seat 4: Squashy22 (button) folded before Flop (didn't bet)
Seat 5: VanCleef322 (small blind) collected ($0.20)
Seat 6: alexos04 (big blind) folded before Flop



PokerStars Hand #222954451664:  Hold'em No Limit ($0.05/$0.10 USD) - 2021/01/23 9:05:07 ET
Table 'Polydoros II' 6-max Seat #5 is the button
Seat 1: Xath76 ($11.63 in chips) 
Seat 2: yuvelir73 ($9.92 in chips) 
Seat 3: Vaha379 ($13.84 in chips) 
Seat 4: Squashy22 ($42.96 in chips) 
Seat 5: VanCleef322 ($10.15 in chips) 
Seat 6: alexos04 ($19.34 in chips) 
alexos04: posts small blind $0.05
Xath76: posts big blind $0.10
*** HOLE CARDS ***
yuvelir73: folds 
Vaha379: folds 
Squashy22: folds 
VanCleef322: folds 
alexos04: folds 
Uncalled bet ($0.05) returned to Xath76
Xath76 collected $0.10 from pot
Xath76: doesn't show hand 
*** SUMMARY ***
Total pot $0.10 | Rake $0 
Seat 1: Xath76 (big blind) collected ($0.10)
Seat 2: yuvelir73 folded before Flop (didn't bet)
Seat 3: Vaha379 folded before Flop (didn't bet)
Seat 4: Squashy22 folded before Flop (didn't bet)
Seat 5: VanCleef322 (button) folded before Flop (didn't bet)
Seat 6: alexos04 (small blind) folded before Flop



PokerStars Hand #222954458986:  Hold'em No Limit ($0.05/$0.10 USD) - 2021/01/23 9:05:22 ET
Table 'Polydoros II' 6-max Seat #6 is the button
Seat 1: Xath76 ($11.68 in chips) 
Seat 2: yuvelir73 ($9.92 in chips) 
Seat 3: Vaha379 ($13.84 in chips) 
Seat 4: Squashy22 ($42.96 in chips) 
Seat 5: VanCleef322 ($10.15 in chips) 
Seat 6: alexos04 ($19.29 in chips) 
Xath76: posts small blind $0.05
yuvelir73: posts big blind $0.10
*** HOLE CARDS ***
Vaha379: raises $0.20 to $0.30
Squashy22: folds 
VanCleef322: raises $0.70 to $1
alexos04: folds 
Xath76: folds 
yuvelir73: folds 
Vaha379: folds 
Uncalled bet ($0.70) returned to VanCleef322
VanCleef322 collected $0.75 from pot
VanCleef322: doesn't show hand 
*** SUMMARY ***
Total pot $0.75 | Rake $0 
Seat 1: Xath76 (small blind) folded before Flop
Seat 2: yuvelir73 (big blind) folded before Flop
Seat 3: Vaha379 folded before Flop
Seat 4: Squashy22 folded before Flop (didn't bet)
Seat 5: VanCleef322 collected ($0.75)
Seat 6: alexos04 (button) folded before Flop (didn't bet)



PokerStars Hand #222954466103:  Hold'em No Limit ($0.05/$0.10 USD) - 2021/01/23 9:05:37 ET
Table 'Polydoros II' 6-max Seat #1 is the button
Seat 1: Xath76 ($11.63 in chips) 
Seat 2: yuvelir73 ($9.82 in chips) 
Seat 3: Vaha379 ($13.54 in chips) 
Seat 4: Squashy22 ($42.96 in chips) 
Seat 5: VanCleef322 ($10.60 in chips) 
Seat 6: alexos04 ($19.29 in chips) 
yuvelir73: posts small blind $0.05
Vaha379: posts big blind $0.10
*** HOLE CARDS ***
Squashy22: folds 
VanCleef322: folds 
alexos04: raises $0.20 to $0.30
Xath76: folds 
yuvelir73: calls $0.25
Vaha379: folds 
*** FLOP *** [Jd Js 8h]
yuvelir73: checks 
alexos04: bets $0.30
yuvelir73: folds 
Uncalled bet ($0.30) returned to alexos04
alexos04 collected $0.67 from pot
alexos04: doesn't show hand 
*** SUMMARY ***
Total pot $0.70 | Rake $0.03 
Board [Jd Js 8h]
Seat 1: Xath76 (button) folded before Flop (didn't bet)
Seat 2: yuvelir73 (small blind) folded on the Flop
Seat 3: Vaha379 (big blind) folded before Flop
Seat 4: Squashy22 folded before Flop (didn't bet)
Seat 5: VanCleef322 folded before Flop (didn't bet)
Seat 6: alexos04 collected ($0.67)



PokerStars Hand #222954476111:  Hold'em No Limit ($0.05/$0.10 USD) - 2021/01/23 9:05:57 ET
Table 'Polydoros II' 6-max Seat #2 is the button
Seat 1: Xath76 ($11.63 in chips) 
Seat 2: yuvelir73 ($9.52 in chips) 
Seat 3: Vaha379 ($13.44 in chips) 
Seat 4: Squashy22 ($42.96 in chips) 
Seat 5: VanCleef322 ($10.60 in chips) 
Seat 6: alexos04 ($19.66 in chips) 
Vaha379: posts small blind $0.05
Squashy22: posts big blind $0.10
*** HOLE CARDS ***
VanCleef322: raises $0.15 to $0.25
alexos04: folds 
Xath76: calls $0.25
yuvelir73: folds 
Vaha379: folds 
Squashy22: folds 
*** FLOP *** [7c Ac Qs]
VanCleef322: bets $0.31
Xath76: calls $0.31
*** TURN *** [7c Ac Qs] [2h]
VanCleef322: bets $0.85
Xath76: calls $0.85
*** RIVER *** [7c Ac Qs 2h] [7h]
VanCleef322: bets $0.85
Xath76: calls $0.85
*** SHOW DOWN ***
VanCleef322: shows [Ks Ah] (two pair, Aces and Sevens)
Xath76: mucks hand 
VanCleef322 collected $4.46 from pot
*** SUMMARY ***
Total pot $4.67 | Rake $0.21 
Board [7c Ac Qs 2h 7h]
Seat 1: Xath76 mucked
Seat 2: yuvelir73 (button) folded before Flop (didn't bet)
Seat 3: Vaha379 (small blind) folded before Flop
Seat 4: Squashy22 (big blind) folded before Flop
Seat 5: VanCleef322 showed [Ks Ah] and won ($4.46) with two pair, Aces and Sevens
Seat 6: alexos04 folded before Flop (didn't bet)



PokerStars Hand #222954491708:  Hold'em No Limit ($0.05/$0.10 USD) - 2021/01/23 9:06:29 ET
Table 'Polydoros II' 6-max Seat #3 is the button
Seat 1: Xath76 ($10 in chips) 
Seat 2: yuvelir73 ($9.52 in chips) 
Seat 3: Vaha379 ($13.39 in chips) 
Seat 4: Squashy22 ($42.86 in chips) 
Seat 5: VanCleef322 ($12.80 in chips) 
Seat 6: alexos04 ($19.66 in chips) 
Squashy22: posts small blind $0.05
VanCleef322: posts big blind $0.10
*** HOLE CARDS ***
alexos04: folds 
Xath76: folds 
yuvelir73: folds 
Vaha379 has timed out
Vaha379: folds 
Squashy22: raises $0.14 to $0.24
VanCleef322: folds 
Uncalled bet ($0.14) returned to Squashy22
Squashy22 collected $0.20 from pot
Squashy22: doesn't show hand 
*** SUMMARY ***
Total pot $0.20 | Rake $0 
Seat 1: Xath76 folded before Flop (didn't bet)
Seat 2: yuvelir73 folded before Flop (didn't bet)
Seat 3: Vaha379 (button) folded before Flop (didn't bet)
Seat 4: Squashy22 (small blind) collected ($0.20)
Seat 5: VanCleef322 (big blind) folded before Flop
Seat 6: alexos04 folded before Flop (didn't bet)



PokerStars Hand #222954504037:  Hold'em No Limit ($0.05/$0.10 USD) - 2021/01/23 9:06:54 ET
Table 'Polydoros II' 6-max Seat #4 is the button
Seat 1: Xath76 ($10 in chips) 
Seat 2: yuvelir73 ($9.52 in chips) 
Seat 4: Squashy22 ($42.96 in chips) 
Seat 5: VanCleef322 ($12.70 in chips) 
Seat 6: alexos04 ($19.66 in chips) 
VanCleef322: posts small blind $0.05
alexos04: posts big blind $0.10
*** HOLE CARDS ***
Xath76: folds 
yuvelir73: folds 
Squashy22: folds 
VanCleef322: calls $0.05
alexos04: checks 
*** FLOP *** [Qc Jd Qd]
VanCleef322: checks 
alexos04: checks 
*** TURN *** [Qc Jd Qd] [7d]
VanCleef322: bets $0.14
alexos04: calls $0.14
*** RIVER *** [Qc Jd Qd 7d] [5s]
VanCleef322: bets $0.35
alexos04: folds 
Uncalled bet ($0.35) returned to VanCleef322
VanCleef322 collected $0.46 from pot
VanCleef322: doesn't show hand 
*** SUMMARY ***
Total pot $0.48 | Rake $0.02 
Board [Qc Jd Qd 7d 5s]
Seat 1: Xath76 folded before Flop (didn't bet)
Seat 2: yuvelir73 folded before Flop (didn't bet)
Seat 4: Squashy22 (button) folded before Flop (didn't bet)
Seat 5: VanCleef322 (small blind) collected ($0.46)
Seat 6: alexos04 (big blind) folded on the River



PokerStars Hand #222954526047:  Hold'em No Limit ($0.05/$0.10 USD) - 2021/01/23 9:07:39 ET
Table 'Polydoros II' 6-max Seat #5 is the button
Seat 1: Xath76 ($10 in chips) 
Seat 2: yuvelir73 ($9.52 in chips) 
Seat 3: Vaha379 ($13.39 in chips) 
Seat 4: Squashy22 ($42.96 in chips) 
Seat 5: VanCleef322 ($12.92 in chips) 
Seat 6: alexos04 ($19.42 in chips) 
alexos04: posts small blind $0.05
Xath76: posts big blind $0.10
*** HOLE CARDS ***
yuvelir73: folds 
Vaha379: folds 
Squashy22: folds 
VanCleef322: raises $0.15 to $0.25
alexos04: folds 
Xath76: folds 
Uncalled bet ($0.15) returned to VanCleef322
VanCleef322 collected $0.25 from pot
VanCleef322: doesn't show hand 
*** SUMMARY ***
Total pot $0.25 | Rake $0 
Seat 1: Xath76 (big blind) folded before Flop
Seat 2: yuvelir73 folded before Flop (didn't bet)
Seat 3: Vaha379 folded before Flop (didn't bet)
Seat 4: Squashy22 folded before Flop (didn't bet)
Seat 5: VanCleef322 (button) collected ($0.25)
Seat 6: alexos04 (small blind) folded before Flop



PokerStars Hand #222954531228:  Hold'em No Limit ($0.05/$0.10 USD) - 2021/01/23 9:07:49 ET
Table 'Polydoros II' 6-max Seat #6 is the button
Seat 1: Xath76 ($10 in chips) 
Seat 2: yuvelir73 ($9.52 in chips) 
Seat 3: Vaha379 ($13.39 in chips) 
Seat 4: Squashy22 ($42.96 in chips) 
Seat 5: VanCleef322 ($13.07 in chips) 
Seat 6: alexos04 ($19.37 in chips) 
Xath76: posts small blind $0.05
yuvelir73: posts big blind $0.10
*** HOLE CARDS ***
Vaha379: folds 
Squashy22: folds 
VanCleef322: folds 
alexos04: folds 
Xath76: folds 
Uncalled bet ($0.05) returned to yuvelir73
yuvelir73 collected $0.10 from pot
*** SUMMARY ***
Total pot $0.10 | Rake $0 
Seat 1: Xath76 (small blind) folded before Flop
Seat 2: yuvelir73 (big blind) collected ($0.10)
Seat 3: Vaha379 folded before Flop (didn't bet)
Seat 4: Squashy22 folded before Flop (didn't bet)
Seat 5: VanCleef322 folded before Flop (didn't bet)
Seat 6: alexos04 (button) folded before Flop (didn't bet)



PokerStars Hand #222954535886:  Hold'em No Limit ($0.05/$0.10 USD) - 2021/01/23 9:07:59 ET
Table 'Polydoros II' 6-max Seat #1 is the button
Seat 1: Xath76 ($10 in chips) 
Seat 2: yuvelir73 ($9.57 in chips) 
Seat 3: Vaha379 ($13.39 in chips) 
Seat 4: Squashy22 ($42.96 in chips) 
Seat 5: VanCleef322 ($13.07 in chips) 
Seat 6: alexos04 ($19.37 in chips) 
yuvelir73: posts small blind $0.05
Vaha379: posts big blind $0.10
*** HOLE CARDS ***
Squashy22: folds 
VanCleef322: folds 
alexos04: folds 
Xath76: folds 
yuvelir73: raises $0.10 to $0.20
Vaha379: calls $0.10
*** FLOP *** [Qh 6s 7h]
yuvelir73: bets $0.20
Vaha379: calls $0.20
*** TURN *** [Qh 6s 7h] [Qc]
yuvelir73: checks 
Vaha379: checks 
*** RIVER *** [Qh 6s 7h Qc] [7c]
yuvelir73: checks 
Vaha379: checks 
*** SHOW DOWN ***
yuvelir73: shows [9d Kh] (two pair, Queens and Sevens)
Vaha379: mucks hand 
yuvelir73 collected $0.76 from pot
*** SUMMARY ***
Total pot $0.80 | Rake $0.04 
Board [Qh 6s 7h Qc 7c]
Seat 1: Xath76 (button) folded before Flop (didn't bet)
Seat 2: yuvelir73 (small blind) showed [9d Kh] and won ($0.76) with two pair, Queens and Sevens
Seat 3: Vaha379 (big blind) mucked
Seat 4: Squashy22 folded before Flop (didn't bet)
Seat 5: VanCleef322 folded before Flop (didn't bet)
Seat 6: alexos04 folded before Flop (didn't bet)



PokerStars Hand #222954555267:  Hold'em No Limit ($0.05/$0.10 USD) - 2021/01/23 9:08:38 ET
Table 'Polydoros II' 6-max Seat #2 is the button
Seat 1: Xath76 ($10 in chips) 
Seat 2: yuvelir73 ($9.93 in chips) 
Seat 3: Vaha379 ($12.99 in chips) 
Seat 4: Squashy22 ($42.96 in chips) 
Seat 5: VanCleef322 ($13.07 in chips) 
Seat 6: alexos04 ($19.37 in chips) 
Vaha379: posts small blind $0.05
Squashy22: posts big blind $0.10
*** HOLE CARDS ***
VanCleef322: folds 
alexos04: folds 
Xath76: raises $0.20 to $0.30
yuvelir73: folds 
Vaha379: folds 
Squashy22: folds 
Uncalled bet ($0.20) returned to Xath76
Xath76 collected $0.25 from pot
Xath76: doesn't show hand 
*** SUMMARY ***
Total pot $0.25 | Rake $0 
Seat 1: Xath76 collected ($0.25)
Seat 2: yuvelir73 (button) folded before Flop (didn't bet)
Seat 3: Vaha379 (small blind) folded before Flop
Seat 4: Squashy22 (big blind) folded before Flop
Seat 5: VanCleef322 folded before Flop (didn't bet)
Seat 6: alexos04 folded before Flop (didn't bet)



PokerStars Hand #222954564422:  Hold'em No Limit ($0.05/$0.10 USD) - 2021/01/23 9:08:56 ET
Table 'Polydoros II' 6-max Seat #3 is the button
Seat 1: Xath76 ($10.15 in chips) 
Seat 2: yuvelir73 ($9.93 in chips) 
Seat 3: Vaha379 ($12.94 in chips) 
Seat 4: Squashy22 ($42.86 in chips) 
Seat 5: VanCleef322 ($13.07 in chips) 
Seat 6: alexos04 ($19.37 in chips) 
Squashy22: posts small blind $0.05
VanCleef322: posts big blind $0.10
*** HOLE CARDS ***
alexos04: folds 
Xath76: folds 
yuvelir73: folds 
Vaha379: folds 
Squashy22: folds 
Uncalled bet ($0.05) returned to VanCleef322
VanCleef322 collected $0.10 from pot
VanCleef322: doesn't show hand 
*** SUMMARY ***
Total pot $0.10 | Rake $0 
Seat 1: Xath76 folded before Flop (didn't bet)
Seat 2: yuvelir73 folded before Flop (didn't bet)
Seat 3: Vaha379 (button) folded before Flop (didn't bet)
Seat 4: Squashy22 (small blind) folded before Flop
Seat 5: VanCleef322 (big blind) collected ($0.10)
Seat 6: alexos04 folded before Flop (didn't bet)



PokerStars Hand #222954567813:  Hold'em No Limit ($0.05/$0.10 USD) - 2021/01/23 9:09:03 ET
Table 'Polydoros II' 6-max Seat #4 is the button
Seat 1: Xath76 ($10.15 in chips) 
Seat 2: yuvelir73 ($9.93 in chips) 
Seat 3: Vaha379 ($12.94 in chips) 
Seat 4: Squashy22 ($42.81 in chips) 
Seat 5: VanCleef322 ($13.12 in chips) 
Seat 6: alexos04 ($19.37 in chips) 
VanCleef322: posts small blind $0.05
alexos04: posts big blind $0.10
*** HOLE CARDS ***
Xath76: folds 
yuvelir73: folds 
Vaha379: folds 
Squashy22: raises $0.16 to $0.26
VanCleef322: folds 
alexos04: calls $0.16
*** FLOP *** [7s 3d 7c]
alexos04: checks 
Squashy22: bets $0.38
alexos04: calls $0.38
*** TURN *** [7s 3d 7c] [Jh]
alexos04: checks 
Squashy22: bets $0.90
alexos04: raises $1.40 to $2.30
Squashy22: calls $1.40
*** RIVER *** [7s 3d 7c Jh] [2s]
alexos04: bets $3.90
Squashy22: calls $3.90
*** SHOW DOWN ***
alexos04: shows [Tc 9c] (a pair of Sevens)
Squashy22: shows [5d 7d] (three of a kind, Sevens)
Squashy22 collected $13.11 from pot
*** SUMMARY ***
Total pot $13.73 | Rake $0.62 
Board [7s 3d 7c Jh 2s]
Seat 1: Xath76 folded before Flop (didn't bet)
Seat 2: yuvelir73 folded before Flop (didn't bet)
Seat 3: Vaha379 folded before Flop (didn't bet)
Seat 4: Squashy22 (button) showed [5d 7d] and won ($13.11) with three of a kind, Sevens
Seat 5: VanCleef322 (small blind) folded before Flop
Seat 6: alexos04 (big blind) showed [Tc 9c] and lost with a pair of Sevens



PokerStars Hand #222954600381:  Hold'em No Limit ($0.05/$0.10 USD) - 2021/01/23 9:10:09 ET
Table 'Polydoros II' 6-max Seat #5 is the button
Seat 1: Xath76 ($10.15 in chips) 
Seat 2: yuvelir73 ($9.93 in chips) 
Seat 3: Vaha379 ($12.94 in chips) 
Seat 4: Squashy22 ($49.08 in chips) 
Seat 5: VanCleef322 ($13.07 in chips) 
Seat 6: alexos04 ($12.53 in chips) 
alexos04: posts small blind $0.05
Xath76: posts big blind $0.10
*** HOLE CARDS ***
yuvelir73: folds 
Vaha379: folds 
Squashy22: folds 
VanCleef322: folds 
alexos04: folds 
Uncalled bet ($0.05) returned to Xath76
Xath76 collected $0.10 from pot
Xath76: doesn't show hand 
*** SUMMARY ***
Total pot $0.10 | Rake $0 
Seat 1: Xath76 (big blind) collected ($0.10)
Seat 2: yuvelir73 folded before Flop (didn't bet)
Seat 3: Vaha379 folded before Flop (didn't bet)
Seat 4: Squashy22 folded before Flop (didn't bet)
Seat 5: VanCleef322 (button) folded before Flop (didn't bet)
Seat 6: alexos04 (small blind) folded before Flop



PokerStars Hand #222954605532:  Hold'em No Limit ($0.05/$0.10 USD) - 2021/01/23 9:10:20 ET
Table 'Polydoros II' 6-max Seat #6 is the button
Seat 1: Xath76 ($10.20 in chips) 
Seat 2: yuvelir73 ($9.93 in chips) 
Seat 3: Vaha379 ($12.94 in chips) 
Seat 4: Squashy22 ($49.08 in chips) 
Seat 5: VanCleef322 ($13.07 in chips) 
Seat 6: alexos04 ($12.48 in chips) 
Xath76: posts small blind $0.05
yuvelir73: posts big blind $0.10
*** HOLE CARDS ***
Vaha379: folds 
Squashy22: folds 
VanCleef322: folds 
alexos04: folds 
Xath76: folds 
Uncalled bet ($0.05) returned to yuvelir73
yuvelir73 collected $0.10 from pot
*** SUMMARY ***
Total pot $0.10 | Rake $0 
Seat 1: Xath76 (small blind) folded before Flop
Seat 2: yuvelir73 (big blind) collected ($0.10)
Seat 3: Vaha379 folded before Flop (didn't bet)
Seat 4: Squashy22 folded before Flop (didn't bet)
Seat 5: VanCleef322 folded before Flop (didn't bet)
Seat 6: alexos04 (button) folded before Flop (didn't bet)



PokerStars Hand #222954609799:  Hold'em No Limit ($0.05/$0.10 USD) - 2021/01/23 9:10:28 ET
Table 'Polydoros II' 6-max Seat #1 is the button
Seat 1: Xath76 ($10.15 in chips) 
Seat 2: yuvelir73 ($9.98 in chips) 
Seat 3: Vaha379 ($12.94 in chips) 
Seat 4: Squashy22 ($49.08 in chips) 
Seat 5: VanCleef322 ($13.07 in chips) 
Seat 6: alexos04 ($12.48 in chips) 
yuvelir73: posts small blind $0.05
Vaha379: posts big blind $0.10
*** HOLE CARDS ***
Squashy22: folds 
VanCleef322: raises $0.15 to $0.25
alexos04: folds 
Xath76: folds 
yuvelir73: folds 
Vaha379: calls $0.15
*** FLOP *** [3h 9s 4d]
Vaha379: checks 
VanCleef322: checks 
*** TURN *** [3h 9s 4d] [Jh]
Vaha379: checks 
VanCleef322: bets $0.25
Vaha379: calls $0.25
*** RIVER *** [3h 9s 4d Jh] [8c]
Vaha379: checks 
VanCleef322: checks 
*** SHOW DOWN ***
Vaha379: shows [2d Ah] (high card Ace)
VanCleef322: shows [As Kd] (high card Ace - King kicker)
VanCleef322 collected $1 from pot
*** SUMMARY ***
Total pot $1.05 | Rake $0.05 
Board [3h 9s 4d Jh 8c]
Seat 1: Xath76 (button) folded before Flop (didn't bet)
Seat 2: yuvelir73 (small blind) folded before Flop
Seat 3: Vaha379 (big blind) showed [2d Ah] and lost with high card Ace
Seat 4: Squashy22 folded before Flop (didn't bet)
Seat 5: VanCleef322 showed [As Kd] and won ($1) with high card Ace
Seat 6: alexos04 folded before Flop (didn't bet)



PokerStars Hand #222954628046:  Hold'em No Limit ($0.05/$0.10 USD) - 2021/01/23 9:11:05 ET
Table 'Polydoros II' 6-max Seat #2 is the button
Seat 1: Xath76 ($10.15 in chips) 
Seat 2: yuvelir73 ($9.93 in chips) 
Seat 3: Vaha379 ($12.44 in chips) 
Seat 4: Squashy22 ($49.08 in chips) 
Seat 5: VanCleef322 ($13.57 in chips) 
Seat 6: alexos04 ($12.48 in chips) 
Vaha379: posts small blind $0.05
Squashy22: posts big blind $0.10
*** HOLE CARDS ***
VanCleef322: folds 
alexos04: folds 
Xath76: folds 
yuvelir73: raises $0.10 to $0.20
Vaha379: folds 
Squashy22: folds 
Uncalled bet ($0.10) returned to yuvelir73
yuvelir73 collected $0.25 from pot
*** SUMMARY ***
Total pot $0.25 | Rake $0 
Seat 1: Xath76 folded before Flop (didn't bet)
Seat 2: yuvelir73 (button) collected ($0.25)
Seat 3: Vaha379 (small blind) folded before Flop
Seat 4: Squashy22 (big blind) folded before Flop
Seat 5: VanCleef322 folded before Flop (didn't bet)
Seat 6: alexos04 folded before Flop (didn't bet)



PokerStars Hand #222954632686:  Hold'em No Limit ($0.05/$0.10 USD) - 2021/01/23 9:11:14 ET
Table 'Polydoros II' 6-max Seat #3 is the button
Seat 1: Xath76 ($10.15 in chips) 
Seat 2: yuvelir73 ($10.08 in chips) 
Seat 3: Vaha379 ($12.39 in chips) 
Seat 4: Squashy22 ($48.98 in chips) 
Seat 5: VanCleef322 ($13.57 in chips) 
Seat 6: alexos04 ($12.48 in chips) 
Squashy22: posts small blind $0.05
VanCleef322: posts big blind $0.10
*** HOLE CARDS ***
alexos04: folds 
Xath76: folds 
yuvelir73 has timed out
yuvelir73: folds 
Vaha379: folds 
Squashy22: folds 
Uncalled bet ($0.05) returned to VanCleef322
VanCleef322 collected $0.10 from pot
VanCleef322: doesn't show hand 
*** SUMMARY ***
Total pot $0.10 | Rake $0 
Seat 1: Xath76 folded before Flop (didn't bet)
Seat 2: yuvelir73 folded before Flop (didn't bet)
Seat 3: Vaha379 (button) folded before Flop (didn't bet)
Seat 4: Squashy22 (small blind) folded before Flop
Seat 5: VanCleef322 (big blind) collected ($0.10)
Seat 6: alexos04 folded before Flop (didn't bet)



PokerStars Hand #222954641893:  Hold'em No Limit ($0.05/$0.10 USD) - 2021/01/23 9:11:33 ET
Table 'Polydoros II' 6-max Seat #4 is the button
Seat 1: Xath76 ($10.15 in chips) 
Seat 2: yuvelir73 ($10.08 in chips) 
Seat 3: Vaha379 ($12.39 in chips) 
Seat 4: Squashy22 ($48.93 in chips) 
Seat 5: VanCleef322 ($13.62 in chips) 
Seat 6: alexos04 ($12.48 in chips) 
VanCleef322: posts small blind $0.05
alexos04: posts big blind $0.10
*** HOLE CARDS ***
Xath76: raises $0.20 to $0.30
yuvelir73: folds 
Vaha379: folds 
Squashy22: folds 
VanCleef322: folds 
alexos04: folds 
Uncalled bet ($0.20) returned to Xath76
Xath76 collected $0.25 from pot
Xath76: doesn't show hand 
*** SUMMARY ***
Total pot $0.25 | Rake $0 
Seat 1: Xath76 collected ($0.25)
Seat 2: yuvelir73 folded before Flop (didn't bet)
Seat 3: Vaha379 folded before Flop (didn't bet)
Seat 4: Squashy22 (button) folded before Flop (didn't bet)
Seat 5: VanCleef322 (small blind) folded before Flop
Seat 6: alexos04 (big blind) folded before Flop



PokerStars Hand #222954650897:  Hold'em No Limit ($0.05/$0.10 USD) - 2021/01/23 9:11:51 ET
Table 'Polydoros II' 6-max Seat #5 is the button
Seat 1: Xath76 ($10.30 in chips) 
Seat 2: yuvelir73 ($10.08 in chips) 
Seat 3: Vaha379 ($12.39 in chips) 
Seat 4: Squashy22 ($48.93 in chips) 
Seat 5: VanCleef322 ($13.57 in chips) 
Seat 6: alexos04 ($12.38 in chips) 
alexos04: posts small blind $0.05
Xath76: posts big blind $0.10
*** HOLE CARDS ***
yuvelir73: folds 
Vaha379: folds 
Squashy22: folds 
VanCleef322: folds 
alexos04: folds 
Uncalled bet ($0.05) returned to Xath76
Xath76 collected $0.10 from pot
Xath76: doesn't show hand 
*** SUMMARY ***
Total pot $0.10 | Rake $0 
Seat 1: Xath76 (big blind) collected ($0.10)
Seat 2: yuvelir73 folded before Flop (didn't bet)
Seat 3: Vaha379 folded before Flop (didn't bet)
Seat 4: Squashy22 folded before Flop (didn't bet)
Seat 5: VanCleef322 (button) folded before Flop (didn't bet)
Seat 6: alexos04 (small blind) folded before Flop



PokerStars Hand #222954654629:  Hold'em No Limit ($0.05/$0.10 USD) - 2021/01/23 9:11:59 ET
Table 'Polydoros II' 6-max Seat #6 is the button
Seat 1: Xath76 ($10.35 in chips) 
Seat 2: yuvelir73 ($10.08 in chips) 
Seat 3: Vaha379 ($12.39 in chips) 
Seat 4: Squashy22 ($48.93 in chips) 
Seat 5: VanCleef322 ($13.57 in chips) 
Seat 6: alexos04 ($12.33 in chips) 
Xath76: posts small blind $0.05
yuvelir73: posts big blind $0.10
*** HOLE CARDS ***
Vaha379: folds 
Squashy22: folds 
VanCleef322: folds 
alexos04: folds 
Xath76: folds 
Uncalled bet ($0.05) returned to yuvelir73
yuvelir73 collected $0.10 from pot
*** SUMMARY ***
Total pot $0.10 | Rake $0 
Seat 1: Xath76 (small blind) folded before Flop
Seat 2: yuvelir73 (big blind) collected ($0.10)
Seat 3: Vaha379 folded before Flop (didn't bet)
Seat 4: Squashy22 folded before Flop (didn't bet)
Seat 5: VanCleef322 folded before Flop (didn't bet)
Seat 6: alexos04 (button) folded before Flop (didn't bet)



PokerStars Hand #222954660822:  Hold'em No Limit ($0.05/$0.10 USD) - 2021/01/23 9:12:11 ET
Table 'Polydoros II' 6-max Seat #1 is the button
Seat 1: Xath76 ($10.30 in chips) 
Seat 2: yuvelir73 ($10.13 in chips) 
Seat 3: Vaha379 ($12.39 in chips) 
Seat 4: Squashy22 ($48.93 in chips) 
Seat 5: VanCleef322 ($13.57 in chips) 
Seat 6: alexos04 ($12.33 in chips) 
yuvelir73: posts small blind $0.05
Vaha379: posts big blind $0.10
*** HOLE CARDS ***
Squashy22: folds 
VanCleef322: raises $0.15 to $0.25
alexos04: folds 
Xath76: folds 
yuvelir73: folds 
Vaha379: calls $0.15
*** FLOP *** [2c Js 7s]
Vaha379: checks 
VanCleef322: bets $0.25
Vaha379: calls $0.25
*** TURN *** [2c Js 7s] [Jd]
Vaha379: checks 
VanCleef322: bets $0.70
Vaha379: calls $0.70
*** RIVER *** [2c Js 7s Jd] [Tc]
Vaha379: checks 
VanCleef322: checks 
*** SHOW DOWN ***
Vaha379: shows [Jc Qh] (three of a kind, Jacks)
VanCleef322: mucks hand 
Vaha379 collected $2.34 from pot
*** SUMMARY ***
Total pot $2.45 | Rake $0.11 
Board [2c Js 7s Jd Tc]
Seat 1: Xath76 (button) folded before Flop (didn't bet)
Seat 2: yuvelir73 (small blind) folded before Flop
Seat 3: Vaha379 (big blind) showed [Jc Qh] and won ($2.34) with three of a kind, Jacks
Seat 4: Squashy22 folded before Flop (didn't bet)
Seat 5: VanCleef322 mucked
Seat 6: alexos04 folded before Flop (didn't bet)



PokerStars Hand #222954678423:  Hold'em No Limit ($0.05/$0.10 USD) - 2021/01/23 9:12:46 ET
Table 'Polydoros II' 6-max Seat #2 is the button
Seat 1: Xath76 ($10.30 in chips) 
Seat 2: yuvelir73 ($10.08 in chips) 
Seat 3: Vaha379 ($13.53 in chips) 
Seat 4: Squashy22 ($48.93 in chips) 
Seat 5: VanCleef322 ($12.37 in chips) 
Seat 6: alexos04 ($12.33 in chips) 
Vaha379: posts small blind $0.05
Squashy22: posts big blind $0.10
*** HOLE CARDS ***
VanCleef322: folds 
alexos04: raises $0.20 to $0.30
Xath76: folds 
yuvelir73: raises $0.75 to $1.05
Vaha379: folds 
Squashy22: folds 
alexos04: folds 
Uncalled bet ($0.75) returned to yuvelir73
yuvelir73 collected $0.75 from pot
*** SUMMARY ***
Total pot $0.75 | Rake $0 
Seat 1: Xath76 folded before Flop (didn't bet)
Seat 2: yuvelir73 (button) collected ($0.75)
Seat 3: Vaha379 (small blind) folded before Flop
Seat 4: Squashy22 (big blind) folded before Flop
Seat 5: VanCleef322 folded before Flop (didn't bet)
Seat 6: alexos04 folded before Flop



PokerStars Hand #222954689294:  Hold'em No Limit ($0.05/$0.10 USD) - 2021/01/23 9:13:08 ET
Table 'Polydoros II' 6-max Seat #3 is the button
Seat 1: Xath76 ($10.30 in chips) 
Seat 2: yuvelir73 ($10.53 in chips) 
Seat 3: Vaha379 ($13.48 in chips) 
Seat 4: Squashy22 ($48.83 in chips) 
Seat 5: VanCleef322 ($12.37 in chips) 
Seat 6: alexos04 ($12.03 in chips) 
Squashy22: posts small blind $0.05
VanCleef322: posts big blind $0.10
*** HOLE CARDS ***
alexos04: folds 
Xath76: folds 
yuvelir73: folds 
Vaha379: folds 
Squashy22: folds 
Uncalled bet ($0.05) returned to VanCleef322
VanCleef322 collected $0.10 from pot
VanCleef322: doesn't show hand 
*** SUMMARY ***
Total pot $0.10 | Rake $0 
Seat 1: Xath76 folded before Flop (didn't bet)
Seat 2: yuvelir73 folded before Flop (didn't bet)
Seat 3: Vaha379 (button) folded before Flop (didn't bet)
Seat 4: Squashy22 (small blind) folded before Flop
Seat 5: VanCleef322 (big blind) collected ($0.10)
Seat 6: alexos04 folded before Flop (didn't bet)



PokerStars Hand #222954696780:  Hold'em No Limit ($0.05/$0.10 USD) - 2021/01/23 9:13:23 ET
Table 'Polydoros II' 6-max Seat #4 is the button
Seat 1: Xath76 ($10.30 in chips) 
Seat 2: yuvelir73 ($10.53 in chips) 
Seat 3: Vaha379 ($13.48 in chips) 
Seat 4: Squashy22 ($48.78 in chips) 
Seat 5: VanCleef322 ($12.42 in chips) 
Seat 6: alexos04 ($12.03 in chips) 
VanCleef322: posts small blind $0.05
alexos04: posts big blind $0.10
*** HOLE CARDS ***
Xath76: folds 
yuvelir73: folds 
Vaha379: folds 
Squashy22: raises $0.16 to $0.26
VanCleef322: folds 
alexos04: raises $0.64 to $0.90
Squashy22: folds 
Uncalled bet ($0.64) returned to alexos04
alexos04 collected $0.57 from pot
alexos04: doesn't show hand 
*** SUMMARY ***
Total pot $0.57 | Rake $0 
Seat 1: Xath76 folded before Flop (didn't bet)
Seat 2: yuvelir73 folded before Flop (didn't bet)
Seat 3: Vaha379 folded before Flop (didn't bet)
Seat 4: Squashy22 (button) folded before Flop
Seat 5: VanCleef322 (small blind) folded before Flop
Seat 6: alexos04 (big blind) collected ($0.57)



PokerStars Hand #222954708231:  Hold'em No Limit ($0.05/$0.10 USD) - 2021/01/23 9:13:46 ET
Table 'Polydoros II' 6-max Seat #5 is the button
Seat 1: Xath76 ($10.30 in chips) 
Seat 2: yuvelir73 ($10.53 in chips) 
Seat 3: Vaha379 ($13.48 in chips) 
Seat 4: Squashy22 ($48.52 in chips) 
Seat 5: VanCleef322 ($12.37 in chips) 
Seat 6: alexos04 ($12.34 in chips) 
alexos04: posts small blind $0.05
Xath76: posts big blind $0.10
*** HOLE CARDS ***
yuvelir73: raises $0.10 to $0.20
Vaha379: folds 
Squashy22: folds 
VanCleef322: folds 
alexos04: folds 
Xath76: folds 
Uncalled bet ($0.10) returned to yuvelir73
yuvelir73 collected $0.25 from pot
*** SUMMARY ***
Total pot $0.25 | Rake $0 
Seat 1: Xath76 (big blind) folded before Flop
Seat 2: yuvelir73 collected ($0.25)
Seat 3: Vaha379 folded before Flop (didn't bet)
Seat 4: Squashy22 folded before Flop (didn't bet)
Seat 5: VanCleef322 (button) folded before Flop (didn't bet)
Seat 6: alexos04 (small blind) folded before Flop



PokerStars Hand #222954713230:  Hold'em No Limit ($0.05/$0.10 USD) - 2021/01/23 9:13:56 ET
Table 'Polydoros II' 6-max Seat #6 is the button
Seat 1: Xath76 ($10.20 in chips) 
Seat 2: yuvelir73 ($10.68 in chips) 
Seat 3: Vaha379 ($13.48 in chips) 
Seat 4: Squashy22 ($48.52 in chips) 
Seat 5: VanCleef322 ($12.37 in chips) 
Seat 6: alexos04 ($12.29 in chips) 
Xath76: posts small blind $0.05
yuvelir73: posts big blind $0.10
*** HOLE CARDS ***
Vaha379: folds 
Squashy22: folds 
VanCleef322: folds 
alexos04: raises $0.20 to $0.30
Xath76: folds 
yuvelir73: folds 
Uncalled bet ($0.20) returned to alexos04
alexos04 collected $0.25 from pot
alexos04: doesn't show hand 
*** SUMMARY ***
Total pot $0.25 | Rake $0 
Seat 1: Xath76 (small blind) folded before Flop
Seat 2: yuvelir73 (big blind) folded before Flop
Seat 3: Vaha379 folded before Flop (didn't bet)
Seat 4: Squashy22 folded before Flop (didn't bet)
Seat 5: VanCleef322 folded before Flop (didn't bet)
Seat 6: alexos04 (button) collected ($0.25)



PokerStars Hand #222954717932:  Hold'em No Limit ($0.05/$0.10 USD) - 2021/01/23 9:14:05 ET
Table 'Polydoros II' 6-max Seat #1 is the button
Seat 1: Xath76 ($10.15 in chips) 
Seat 2: yuvelir73 ($10.58 in chips) 
Seat 3: Vaha379 ($13.48 in chips) 
Seat 4: Squashy22 ($48.52 in chips) 
Seat 5: VanCleef322 ($12.37 in chips) 
Seat 6: alexos04 ($12.44 in chips) 
yuvelir73: posts small blind $0.05
Vaha379: posts big blind $0.10
*** HOLE CARDS ***
Squashy22: folds 
VanCleef322: folds 
alexos04: raises $0.20 to $0.30
Xath76: folds 
yuvelir73: calls $0.25
Vaha379: calls $0.20
*** FLOP *** [8c Kd 4h]
yuvelir73: checks 
Vaha379: checks 
alexos04: checks 
*** TURN *** [8c Kd 4h] [3c]
yuvelir73: bets $0.30
Vaha379: calls $0.30
alexos04: folds 
*** RIVER *** [8c Kd 4h 3c] [9s]
yuvelir73: bets $0.70
Vaha379: folds 
Uncalled bet ($0.70) returned to yuvelir73
yuvelir73 collected $1.43 from pot
*** SUMMARY ***
Total pot $1.50 | Rake $0.07 
Board [8c Kd 4h 3c 9s]
Seat 1: Xath76 (button) folded before Flop (didn't bet)
Seat 2: yuvelir73 (small blind) collected ($1.43)
Seat 3: Vaha379 (big blind) folded on the River
Seat 4: Squashy22 folded before Flop (didn't bet)
Seat 5: VanCleef322 folded before Flop (didn't bet)
Seat 6: alexos04 folded on the Turn



PokerStars Hand #222954746383:  Hold'em No Limit ($0.05/$0.10 USD) - 2021/01/23 9:15:02 ET
Table 'Polydoros II' 6-max Seat #2 is the button
Seat 1: Xath76 ($10.15 in chips) 
Seat 2: yuvelir73 ($11.41 in chips) 
Seat 3: Vaha379 ($12.88 in chips) 
Seat 4: Squashy22 ($48.52 in chips) 
Seat 5: VanCleef322 ($12.37 in chips) 
Seat 6: alexos04 ($12.14 in chips) 
Vaha379: posts small blind $0.05
Squashy22: posts big blind $0.10
*** HOLE CARDS ***
VanCleef322: folds 
alexos04: folds 
Xath76: folds 
yuvelir73: raises $0.20 to $0.30
Vaha379: folds 
Squashy22: calls $0.20
*** FLOP *** [Ah 3c Ac]
Squashy22: checks 
yuvelir73: bets $0.30
Squashy22: folds 
Uncalled bet ($0.30) returned to yuvelir73
yuvelir73 collected $0.62 from pot
*** SUMMARY ***
Total pot $0.65 | Rake $0.03 
Board [Ah 3c Ac]
Seat 1: Xath76 folded before Flop (didn't bet)
Seat 2: yuvelir73 (button) collected ($0.62)
Seat 3: Vaha379 (small blind) folded before Flop
Seat 4: Squashy22 (big blind) folded on the Flop
Seat 5: VanCleef322 folded before Flop (didn't bet)
Seat 6: alexos04 folded before Flop (didn't bet)



PokerStars Hand #222954758215:  Hold'em No Limit ($0.05/$0.10 USD) - 2021/01/23 9:15:26 ET
Table 'Polydoros II' 6-max Seat #3 is the button
Seat 1: Xath76 ($10.15 in chips) 
Seat 2: yuvelir73 ($11.73 in chips) 
Seat 3: Vaha379 ($12.83 in chips) 
Seat 4: Squashy22 ($48.22 in chips) 
Seat 5: VanCleef322 ($12.37 in chips) 
Seat 6: alexos04 ($12.14 in chips) 
Squashy22: posts small blind $0.05
VanCleef322: posts big blind $0.10
*** HOLE CARDS ***
alexos04: folds 
Xath76: folds 
yuvelir73: folds 
Vaha379 has timed out
Vaha379: folds 
Squashy22: folds 
Uncalled bet ($0.05) returned to VanCleef322
VanCleef322 collected $0.10 from pot
VanCleef322: doesn't show hand 
*** SUMMARY ***
Total pot $0.10 | Rake $0 
Seat 1: Xath76 folded before Flop (didn't bet)
Seat 2: yuvelir73 folded before Flop (didn't bet)
Seat 3: Vaha379 (button) folded before Flop (didn't bet)
Seat 4: Squashy22 (small blind) folded before Flop
Seat 5: VanCleef322 (big blind) collected ($0.10)
Seat 6: alexos04 folded before Flop (didn't bet)



PokerStars Hand #222954771040:  Hold'em No Limit ($0.05/$0.10 USD) - 2021/01/23 9:15:52 ET
Table 'Polydoros II' 6-max Seat #4 is the button
Seat 1: Xath76 ($10.15 in chips) 
Seat 2: yuvelir73 ($11.73 in chips) 
Seat 4: Squashy22 ($48.17 in chips) 
Seat 5: VanCleef322 ($12.42 in chips) 
Seat 6: alexos04 ($12.14 in chips) 
VanCleef322: posts small blind $0.05
alexos04: posts big blind $0.10
*** HOLE CARDS ***
Xath76: folds 
yuvelir73: folds 
Squashy22: raises $0.16 to $0.26
VanCleef322: folds 
alexos04: folds 
Uncalled bet ($0.16) returned to Squashy22
Squashy22 collected $0.25 from pot
Squashy22: doesn't show hand 
*** SUMMARY ***
Total pot $0.25 | Rake $0 
Seat 1: Xath76 folded before Flop (didn't bet)
Seat 2: yuvelir73 folded before Flop (didn't bet)
Seat 4: Squashy22 (button) collected ($0.25)
Seat 5: VanCleef322 (small blind) folded before Flop
Seat 6: alexos04 (big blind) folded before Flop



PokerStars Hand #222954776354:  Hold'em No Limit ($0.05/$0.10 USD) - 2021/01/23 9:16:02 ET
Table 'Polydoros II' 6-max Seat #5 is the button
Seat 1: Xath76 ($10.15 in chips) 
Seat 2: yuvelir73 ($11.73 in chips) 
Seat 4: Squashy22 ($48.32 in chips) 
Seat 5: VanCleef322 ($12.37 in chips) 
Seat 6: alexos04 ($12.04 in chips) 
alexos04: posts small blind $0.05
Xath76: posts big blind $0.10
*** HOLE CARDS ***
yuvelir73: folds 
Squashy22: folds 
VanCleef322: folds 
alexos04: folds 
Uncalled bet ($0.05) returned to Xath76
Xath76 collected $0.10 from pot
Xath76: doesn't show hand 
*** SUMMARY ***
Total pot $0.10 | Rake $0 
Seat 1: Xath76 (big blind) collected ($0.10)
Seat 2: yuvelir73 folded before Flop (didn't bet)
Seat 4: Squashy22 folded before Flop (didn't bet)
Seat 5: VanCleef322 (button) folded before Flop (didn't bet)
Seat 6: alexos04 (small blind) folded before Flop



PokerStars Hand #222954782634:  Hold'em No Limit ($0.05/$0.10 USD) - 2021/01/23 9:16:15 ET
Table 'Polydoros II' 6-max Seat #6 is the button
Seat 1: Xath76 ($10.20 in chips) 
Seat 2: yuvelir73 ($11.73 in chips) 
Seat 4: Squashy22 ($48.32 in chips) 
Seat 5: VanCleef322 ($12.37 in chips) 
Seat 6: alexos04 ($11.99 in chips) 
Xath76: posts small blind $0.05
yuvelir73: posts big blind $0.10
*** HOLE CARDS ***
Squashy22 has timed out
Squashy22: folds 
VanCleef322: folds 
alexos04: folds 
Xath76: folds 
Uncalled bet ($0.05) returned to yuvelir73
yuvelir73 collected $0.10 from pot
Vaha379 is disconnected 
*** SUMMARY ***
Total pot $0.10 | Rake $0 
Seat 1: Xath76 (small blind) folded before Flop
Seat 2: yuvelir73 (big blind) collected ($0.10)
Seat 4: Squashy22 folded before Flop (didn't bet)
Seat 5: VanCleef322 folded before Flop (didn't bet)
Seat 6: alexos04 (button) folded before Flop (didn't bet)



PokerStars Hand #222954790630:  Hold'em No Limit ($0.05/$0.10 USD) - 2021/01/23 9:16:31 ET
Table 'Polydoros II' 6-max Seat #1 is the button
Seat 1: Xath76 ($10.15 in chips) 
Seat 2: yuvelir73 ($11.78 in chips) 
Seat 4: Squashy22 ($48.32 in chips) 
Seat 5: VanCleef322 ($12.37 in chips) 
Seat 6: alexos04 ($11.99 in chips) 
yuvelir73: posts small blind $0.05
Squashy22: posts big blind $0.10
*** HOLE CARDS ***
VanCleef322: folds 
alexos04: raises $0.20 to $0.30
Xath76: folds 
yuvelir73: folds 
Squashy22: folds 
Uncalled bet ($0.20) returned to alexos04
alexos04 collected $0.25 from pot
alexos04: doesn't show hand 
*** SUMMARY ***
Total pot $0.25 | Rake $0 
Seat 1: Xath76 (button) folded before Flop (didn't bet)
Seat 2: yuvelir73 (small blind) folded before Flop
Seat 4: Squashy22 (big blind) folded before Flop
Seat 5: VanCleef322 folded before Flop (didn't bet)
Seat 6: alexos04 collected ($0.25)



PokerStars Hand #222954798524:  Hold'em No Limit ($0.05/$0.10 USD) - 2021/01/23 9:16:47 ET
Table 'Polydoros II' 6-max Seat #2 is the button
Seat 1: Xath76 ($10.15 in chips) 
Seat 2: yuvelir73 ($11.73 in chips) 
Seat 4: Squashy22 ($48.22 in chips) 
Seat 5: VanCleef322 ($12.37 in chips) 
Seat 6: alexos04 ($12.14 in chips) 
Squashy22: posts small blind $0.05
VanCleef322: posts big blind $0.10
*** HOLE CARDS ***
alexos04: folds 
Xath76: raises $0.20 to $0.30
yuvelir73: folds 
Squashy22: folds 
VanCleef322: calls $0.20
*** FLOP *** [3s 4h 6c]
VanCleef322: checks 
Xath76: checks 
*** TURN *** [3s 4h 6c] [3h]
VanCleef322: checks 
Xath76: checks 
*** RIVER *** [3s 4h 6c 3h] [4d]
VanCleef322: bets $0.45
Xath76: folds 
Uncalled bet ($0.45) returned to VanCleef322
VanCleef322 collected $0.62 from pot
VanCleef322: doesn't show hand 
*** SUMMARY ***
Total pot $0.65 | Rake $0.03 
Board [3s 4h 6c 3h 4d]
Seat 1: Xath76 folded on the River
Seat 2: yuvelir73 (button) folded before Flop (didn't bet)
Seat 4: Squashy22 (small blind) folded before Flop
Seat 5: VanCleef322 (big blind) collected ($0.62)
Seat 6: alexos04 folded before Flop (didn't bet)



PokerStars Hand #222954818371:  Hold'em No Limit ($0.05/$0.10 USD) - 2021/01/23 9:17:27 ET
Table 'Polydoros II' 6-max Seat #4 is the button
Seat 1: Xath76 ($10 in chips) 
Seat 2: yuvelir73 ($11.73 in chips) 
Seat 4: Squashy22 ($48.17 in chips) 
Seat 5: VanCleef322 ($12.69 in chips) 
Seat 6: alexos04 ($12.14 in chips) 
VanCleef322: posts small blind $0.05
alexos04: posts big blind $0.10
*** HOLE CARDS ***
Xath76: folds 
yuvelir73: raises $0.20 to $0.30
Squashy22: folds 
VanCleef322: folds 
alexos04: raises $0.60 to $0.90
yuvelir73: folds 
Uncalled bet ($0.60) returned to alexos04
alexos04 collected $0.65 from pot
alexos04: doesn't show hand 
*** SUMMARY ***
Total pot $0.65 | Rake $0 
Seat 1: Xath76 folded before Flop (didn't bet)
Seat 2: yuvelir73 folded before Flop
Seat 4: Squashy22 (button) folded before Flop (didn't bet)
Seat 5: VanCleef322 (small blind) folded before Flop
Seat 6: alexos04 (big blind) collected ($0.65)



PokerStars Hand #222954830005:  Hold'em No Limit ($0.05/$0.10 USD) - 2021/01/23 9:17:51 ET
Table 'Polydoros II' 6-max Seat #5 is the button
Seat 1: Xath76 ($10 in chips) 
Seat 2: yuvelir73 ($11.43 in chips) 
Seat 4: Squashy22 ($48.17 in chips) 
Seat 5: VanCleef322 ($12.64 in chips) 
Seat 6: alexos04 ($12.49 in chips) 
alexos04: posts small blind $0.05
Xath76: posts big blind $0.10
*** HOLE CARDS ***
yuvelir73: folds 
Squashy22: folds 
VanCleef322: raises $0.15 to $0.25
alexos04: folds 
Xath76: calls $0.15
*** FLOP *** [Qs 3d 9c]
Xath76: checks 
VanCleef322: bets $0.27
Xath76: calls $0.27
*** TURN *** [Qs 3d 9c] [5h]
Xath76: checks 
VanCleef322: checks 
*** RIVER *** [Qs 3d 9c 5h] [4h]
Xath76: bets $1.04
VanCleef322: folds 
Uncalled bet ($1.04) returned to Xath76
Xath76 collected $1.04 from pot
Xath76: doesn't show hand 
*** SUMMARY ***
Total pot $1.09 | Rake $0.05 
Board [Qs 3d 9c 5h 4h]
Seat 1: Xath76 (big blind) collected ($1.04)
Seat 2: yuvelir73 folded before Flop (didn't bet)
Seat 4: Squashy22 folded before Flop (didn't bet)
Seat 5: VanCleef322 (button) folded on the River
Seat 6: alexos04 (small blind) folded before Flop



PokerStars Hand #222954845302:  Hold'em No Limit ($0.05/$0.10 USD) - 2021/01/23 9:18:21 ET
Table 'Polydoros II' 6-max Seat #6 is the button
Seat 1: Xath76 ($10.52 in chips) 
Seat 2: yuvelir73 ($11.43 in chips) 
Seat 4: Squashy22 ($48.17 in chips) 
Seat 5: VanCleef322 ($12.12 in chips) 
Seat 6: alexos04 ($12.44 in chips) 
Xath76: posts small blind $0.05
yuvelir73: posts big blind $0.10
*** HOLE CARDS ***
Squashy22: folds 
VanCleef322: folds 
alexos04: folds 
Xath76: folds 
Uncalled bet ($0.05) returned to yuvelir73
yuvelir73 collected $0.10 from pot
*** SUMMARY ***
Total pot $0.10 | Rake $0 
Seat 1: Xath76 (small blind) folded before Flop
Seat 2: yuvelir73 (big blind) collected ($0.10)
Seat 4: Squashy22 folded before Flop (didn't bet)
Seat 5: VanCleef322 folded before Flop (didn't bet)
Seat 6: alexos04 (button) folded before Flop (didn't bet)



PokerStars Hand #222954850326:  Hold'em No Limit ($0.05/$0.10 USD) - 2021/01/23 9:18:31 ET
Table 'Polydoros II' 6-max Seat #1 is the button
Seat 1: Xath76 ($10.47 in chips) 
Seat 2: yuvelir73 ($11.48 in chips) 
Seat 4: Squashy22 ($48.17 in chips) 
Seat 5: VanCleef322 ($12.12 in chips) 
Seat 6: alexos04 ($12.44 in chips) 
yuvelir73: posts small blind $0.05
Squashy22: posts big blind $0.10
*** HOLE CARDS ***
VanCleef322: folds 
alexos04: folds 
Xath76: folds 
yuvelir73: folds 
Uncalled bet ($0.05) returned to Squashy22
Squashy22 collected $0.10 from pot
Squashy22: doesn't show hand 
*** SUMMARY ***
Total pot $0.10 | Rake $0 
Seat 1: Xath76 (button) folded before Flop (didn't bet)
Seat 2: yuvelir73 (small blind) folded before Flop
Seat 4: Squashy22 (big blind) collected ($0.10)
Seat 5: VanCleef322 folded before Flop (didn't bet)
Seat 6: alexos04 folded before Flop (didn't bet)



PokerStars Hand #222954855962:  Hold'em No Limit ($0.05/$0.10 USD) - 2021/01/23 9:18:42 ET
Table 'Polydoros II' 6-max Seat #2 is the button
Seat 1: Xath76 ($10.47 in chips) 
Seat 2: yuvelir73 ($11.43 in chips) 
Seat 4: Squashy22 ($48.22 in chips) 
Seat 5: VanCleef322 ($12.12 in chips) 
Seat 6: alexos04 ($12.44 in chips) 
Squashy22: posts small blind $0.05
VanCleef322: posts big blind $0.10
*** HOLE CARDS ***
alexos04: folds 
Xath76: raises $0.20 to $0.30
yuvelir73: folds 
Squashy22: folds 
VanCleef322: folds 
Uncalled bet ($0.20) returned to Xath76
Xath76 collected $0.25 from pot
Xath76: doesn't show hand 
*** SUMMARY ***
Total pot $0.25 | Rake $0 
Seat 1: Xath76 collected ($0.25)
Seat 2: yuvelir73 (button) folded before Flop (didn't bet)
Seat 4: Squashy22 (small blind) folded before Flop
Seat 5: VanCleef322 (big blind) folded before Flop
Seat 6: alexos04 folded before Flop (didn't bet)



PokerStars Hand #222954861210:  Hold'em No Limit ($0.05/$0.10 USD) - 2021/01/23 9:18:53 ET
Table 'Polydoros II' 6-max Seat #4 is the button
Seat 1: Xath76 ($10.62 in chips) 
Seat 2: yuvelir73 ($11.43 in chips) 
Seat 4: Squashy22 ($48.17 in chips) 
Seat 5: VanCleef322 ($12.02 in chips) 
Seat 6: alexos04 ($12.44 in chips) 
VanCleef322: posts small blind $0.05
alexos04: posts big blind $0.10
*** HOLE CARDS ***
Xath76: folds 
yuvelir73: raises $0.20 to $0.30
Squashy22: folds 
VanCleef322: folds 
alexos04: folds 
Uncalled bet ($0.20) returned to yuvelir73
yuvelir73 collected $0.25 from pot
*** SUMMARY ***
Total pot $0.25 | Rake $0 
Seat 1: Xath76 folded before Flop (didn't bet)
Seat 2: yuvelir73 collected ($0.25)
Seat 4: Squashy22 (button) folded before Flop (didn't bet)
Seat 5: VanCleef322 (small blind) folded before Flop
Seat 6: alexos04 (big blind) folded before Flop



PokerStars Hand #222954870406:  Hold'em No Limit ($0.05/$0.10 USD) - 2021/01/23 9:19:11 ET
Table 'Polydoros II' 6-max Seat #5 is the button
Seat 1: Xath76 ($10.62 in chips) 
Seat 2: yuvelir73 ($11.58 in chips) 
Seat 4: Squashy22 ($48.17 in chips) 
Seat 5: VanCleef322 ($11.97 in chips) 
Seat 6: alexos04 ($12.34 in chips) 
alexos04: posts small blind $0.05
Xath76: posts big blind $0.10
*** HOLE CARDS ***
yuvelir73: raises $0.20 to $0.30
Squashy22: folds 
VanCleef322: folds 
alexos04: folds 
Xath76: folds 
Uncalled bet ($0.20) returned to yuvelir73
yuvelir73 collected $0.25 from pot
*** SUMMARY ***
Total pot $0.25 | Rake $0 
Seat 1: Xath76 (big blind) folded before Flop
Seat 2: yuvelir73 collected ($0.25)
Seat 4: Squashy22 folded before Flop (didn't bet)
Seat 5: VanCleef322 (button) folded before Flop (didn't bet)
Seat 6: alexos04 (small blind) folded before Flop



PokerStars Hand #222954874676:  Hold'em No Limit ($0.05/$0.10 USD) - 2021/01/23 9:19:20 ET
Table 'Polydoros II' 6-max Seat #6 is the button
Seat 1: Xath76 ($10.52 in chips) 
Seat 2: yuvelir73 ($11.73 in chips) 
Seat 4: Squashy22 ($48.17 in chips) 
Seat 5: VanCleef322 ($11.97 in chips) 
Seat 6: alexos04 ($12.29 in chips) 
Xath76: posts small blind $0.05
yuvelir73: posts big blind $0.10
*** HOLE CARDS ***
Squashy22: folds 
VanCleef322: folds 
alexos04: folds 
Xath76: folds 
Uncalled bet ($0.05) returned to yuvelir73
yuvelir73 collected $0.10 from pot
*** SUMMARY ***
Total pot $0.10 | Rake $0 
Seat 1: Xath76 (small blind) folded before Flop
Seat 2: yuvelir73 (big blind) collected ($0.10)
Seat 4: Squashy22 folded before Flop (didn't bet)
Seat 5: VanCleef322 folded before Flop (didn't bet)
Seat 6: alexos04 (button) folded before Flop (didn't bet)



PokerStars Hand #222954881171:  Hold'em No Limit ($0.05/$0.10 USD) - 2021/01/23 9:19:33 ET
Table 'Polydoros II' 6-max Seat #1 is the button
Seat 1: Xath76 ($10.47 in chips) 
Seat 2: yuvelir73 ($11.78 in chips) 
Seat 4: Squashy22 ($48.17 in chips) 
Seat 5: VanCleef322 ($11.97 in chips) 
Seat 6: alexos04 ($12.29 in chips) 
yuvelir73: posts small blind $0.05
Squashy22: posts big blind $0.10
*** HOLE CARDS ***
VanCleef322: folds 
alexos04: folds 
Xath76: folds 
yuvelir73: folds 
Uncalled bet ($0.05) returned to Squashy22
Squashy22 collected $0.10 from pot
Squashy22: doesn't show hand 
*** SUMMARY ***
Total pot $0.10 | Rake $0 
Seat 1: Xath76 (button) folded before Flop (didn't bet)
Seat 2: yuvelir73 (small blind) folded before Flop
Seat 4: Squashy22 (big blind) collected ($0.10)
Seat 5: VanCleef322 folded before Flop (didn't bet)
Seat 6: alexos04 folded before Flop (didn't bet)



PokerStars Hand #222954886269:  Hold'em No Limit ($0.05/$0.10 USD) - 2021/01/23 9:19:43 ET
Table 'Polydoros II' 6-max Seat #2 is the button
Seat 1: Xath76 ($10.47 in chips) 
Seat 2: yuvelir73 ($11.73 in chips) 
Seat 4: Squashy22 ($48.22 in chips) 
Seat 5: VanCleef322 ($11.97 in chips) 
Seat 6: alexos04 ($12.29 in chips) 
Squashy22: posts small blind $0.05
VanCleef322: posts big blind $0.10
*** HOLE CARDS ***
alexos04: raises $0.20 to $0.30
Xath76: folds 
yuvelir73: folds 
Squashy22: folds 
VanCleef322: raises $0.70 to $1
alexos04: folds 
Uncalled bet ($0.70) returned to VanCleef322
VanCleef322 collected $0.65 from pot
VanCleef322: doesn't show hand 
*** SUMMARY ***
Total pot $0.65 | Rake $0 
Seat 1: Xath76 folded before Flop (didn't bet)
Seat 2: yuvelir73 (button) folded before Flop (didn't bet)
Seat 4: Squashy22 (small blind) folded before Flop
Seat 5: VanCleef322 (big blind) collected ($0.65)
Seat 6: alexos04 folded before Flop



PokerStars Hand #222954899754:  Hold'em No Limit ($0.05/$0.10 USD) - 2021/01/23 9:20:10 ET
Table 'Polydoros II' 6-max Seat #4 is the button
Seat 1: Xath76 ($10.47 in chips) 
Seat 2: yuvelir73 ($11.73 in chips) 
Seat 4: Squashy22 ($48.17 in chips) 
Seat 5: VanCleef322 ($12.32 in chips) 
Seat 6: alexos04 ($11.99 in chips) 
VanCleef322: posts small blind $0.05
alexos04: posts big blind $0.10
*** HOLE CARDS ***
Xath76: folds 
yuvelir73: folds 
Squashy22: raises $0.14 to $0.24
VanCleef322: folds 
alexos04: calls $0.14
*** FLOP *** [6s Tc Kd]
alexos04: checks 
Squashy22: bets $0.22
alexos04: calls $0.22
*** TURN *** [6s Tc Kd] [5s]
alexos04: checks 
Squashy22: checks 
*** RIVER *** [6s Tc Kd 5s] [6c]
alexos04: checks 
Squashy22: checks 
*** SHOW DOWN ***
alexos04: shows [Ad 4d] (a pair of Sixes)
Squashy22: shows [Ah Qh] (a pair of Sixes - Ace+King+Queen kicker)
Squashy22 collected $0.93 from pot
*** SUMMARY ***
Total pot $0.97 | Rake $0.04 
Board [6s Tc Kd 5s 6c]
Seat 1: Xath76 folded before Flop (didn't bet)
Seat 2: yuvelir73 folded before Flop (didn't bet)
Seat 4: Squashy22 (button) showed [Ah Qh] and won ($0.93) with a pair of Sixes
Seat 5: VanCleef322 (small blind) folded before Flop
Seat 6: alexos04 (big blind) showed [Ad 4d] and lost with a pair of Sixes



PokerStars Hand #222954927385:  Hold'em No Limit ($0.05/$0.10 USD) - 2021/01/23 9:21:05 ET
Table 'Polydoros II' 6-max Seat #5 is the button
Seat 1: Xath76 ($10.47 in chips) 
Seat 2: yuvelir73 ($11.73 in chips) 
Seat 4: Squashy22 ($48.64 in chips) 
Seat 5: VanCleef322 ($12.27 in chips) 
Seat 6: alexos04 ($11.53 in chips) 
alexos04: posts small blind $0.05
Xath76: posts big blind $0.10
*** HOLE CARDS ***
yuvelir73: folds 
Squashy22: folds 
VanCleef322: raises $0.15 to $0.25
alexos04: folds 
Xath76: folds 
Uncalled bet ($0.15) returned to VanCleef322
VanCleef322 collected $0.25 from pot
VanCleef322: doesn't show hand 
*** SUMMARY ***
Total pot $0.25 | Rake $0 
Seat 1: Xath76 (big blind) folded before Flop
Seat 2: yuvelir73 folded before Flop (didn't bet)
Seat 4: Squashy22 folded before Flop (didn't bet)
Seat 5: VanCleef322 (button) collected ($0.25)
Seat 6: alexos04 (small blind) folded before Flop



PokerStars Hand #222954934663:  Hold'em No Limit ($0.05/$0.10 USD) - 2021/01/23 9:21:19 ET
Table 'Polydoros II' 6-max Seat #6 is the button
Seat 1: Xath76 ($10.37 in chips) 
Seat 2: yuvelir73 ($11.73 in chips) 
Seat 4: Squashy22 ($48.64 in chips) 
Seat 5: VanCleef322 ($12.42 in chips) 
Seat 6: alexos04 ($11.48 in chips) 
Xath76: posts small blind $0.05
yuvelir73: posts big blind $0.10
*** HOLE CARDS ***
Squashy22: raises $0.19 to $0.29
VanCleef322: folds 
alexos04: calls $0.29
Xath76: folds 
yuvelir73: calls $0.19
*** FLOP *** [Kd Jd 6h]
yuvelir73: bets $0.40
Squashy22: calls $0.40
alexos04: calls $0.40
*** TURN *** [Kd Jd 6h] [9c]
yuvelir73: checks 
Squashy22: checks 
alexos04: checks 
*** RIVER *** [Kd Jd 6h 9c] [Js]
yuvelir73: checks 
Squashy22: checks 
alexos04: bets $0.40
yuvelir73: calls $0.40
Squashy22: folds 
*** SHOW DOWN ***
alexos04: shows [Jh Ad] (three of a kind, Jacks)
yuvelir73: mucks hand 
alexos04 collected $2.79 from pot
*** SUMMARY ***
Total pot $2.92 | Rake $0.13 
Board [Kd Jd 6h 9c Js]
Seat 1: Xath76 (small blind) folded before Flop
Seat 2: yuvelir73 (big blind) mucked
Seat 4: Squashy22 folded on the River
Seat 5: VanCleef322 folded before Flop (didn't bet)
Seat 6: alexos04 (button) showed [Jh Ad] and won ($2.79) with three of a kind, Jacks



PokerStars Hand #222954960171:  Hold'em No Limit ($0.05/$0.10 USD) - 2021/01/23 9:22:10 ET
Table 'Polydoros II' 6-max Seat #1 is the button
Seat 1: Xath76 ($10.32 in chips) 
Seat 2: yuvelir73 ($10.64 in chips) 
Seat 4: Squashy22 ($47.95 in chips) 
Seat 5: VanCleef322 ($12.42 in chips) 
Seat 6: alexos04 ($13.18 in chips) 
yuvelir73: posts small blind $0.05
Squashy22: posts big blind $0.10
*** HOLE CARDS ***
VanCleef322: folds 
alexos04: folds 
Xath76: raises $0.20 to $0.30
yuvelir73: raises $0.70 to $1
Squashy22: folds 
Xath76: calls $0.70
*** FLOP *** [4h 7s Kd]
yuvelir73: bets $0.50
Xath76: calls $0.50
*** TURN *** [4h 7s Kd] [3s]
yuvelir73: bets $0.90
Xath76: calls $0.90
*** RIVER *** [4h 7s Kd 3s] [Ad]
yuvelir73: bets $1.10
Xath76: calls $1.10
*** SHOW DOWN ***
yuvelir73: shows [9h Ac] (a pair of Aces)
Xath76: mucks hand 
yuvelir73 collected $6.78 from pot
Vaha379 was removed from the table for failing to post
Vaha379 leaves the table
*** SUMMARY ***
Total pot $7.10 | Rake $0.32 
Board [4h 7s Kd 3s Ad]
Seat 1: Xath76 (button) mucked
Seat 2: yuvelir73 (small blind) showed [9h Ac] and won ($6.78) with a pair of Aces
Seat 4: Squashy22 (big blind) folded before Flop
Seat 5: VanCleef322 folded before Flop (didn't bet)
Seat 6: alexos04 folded before Flop (didn't bet)



PokerStars Hand #222954983780:  Hold'em No Limit ($0.05/$0.10 USD) - 2021/01/23 9:22:57 ET
Table 'Polydoros II' 6-max Seat #2 is the button
Seat 1: Xath76 ($10 in chips) 
Seat 2: yuvelir73 ($13.92 in chips) 
Seat 4: Squashy22 ($47.85 in chips) 
Seat 5: VanCleef322 ($12.42 in chips) 
Seat 6: alexos04 ($13.18 in chips) 
Squashy22: posts small blind $0.05
VanCleef322: posts big blind $0.10
*** HOLE CARDS ***
alexos04: folds 
Xath76: folds 
yuvelir73: folds 
fooledagain1 joins the table at seat #3 
Squashy22: folds 
Uncalled bet ($0.05) returned to VanCleef322
VanCleef322 collected $0.10 from pot
VanCleef322: doesn't show hand 
*** SUMMARY ***
Total pot $0.10 | Rake $0 
Seat 1: Xath76 folded before Flop (didn't bet)
Seat 2: yuvelir73 (button) folded before Flop (didn't bet)
Seat 4: Squashy22 (small blind) folded before Flop
Seat 5: VanCleef322 (big blind) collected ($0.10)
Seat 6: alexos04 folded before Flop (didn't bet)



PokerStars Hand #222954988322:  Hold'em No Limit ($0.05/$0.10 USD) - 2021/01/23 9:23:06 ET
Table 'Polydoros II' 6-max Seat #4 is the button
Seat 1: Xath76 ($10 in chips) 
Seat 2: yuvelir73 ($13.92 in chips) 
Seat 4: Squashy22 ($47.80 in chips) 
Seat 5: VanCleef322 ($12.47 in chips) 
Seat 6: alexos04 ($13.18 in chips) 
VanCleef322: posts small blind $0.05
alexos04: posts big blind $0.10
fooledagain1: sits out 
*** HOLE CARDS ***
Xath76: raises $0.20 to $0.30
yuvelir73: folds 
yuvelir73 leaves the table
Lord_of_days joins the table at seat #2 
Squashy22: folds 
VanCleef322: folds 
alexos04: folds 
Uncalled bet ($0.20) returned to Xath76
Xath76 collected $0.25 from pot
Xath76: doesn't show hand 
*** SUMMARY ***
Total pot $0.25 | Rake $0 
Seat 1: Xath76 collected ($0.25)
Seat 2: yuvelir73 folded before Flop (didn't bet)
Seat 4: Squashy22 (button) folded before Flop (didn't bet)
Seat 5: VanCleef322 (small blind) folded before Flop
Seat 6: alexos04 (big blind) folded before Flop



PokerStars Hand #222954995572:  Hold'em No Limit ($0.05/$0.10 USD) - 2021/01/23 9:23:21 ET
Table 'Polydoros II' 6-max Seat #5 is the button
Seat 1: Xath76 ($10.15 in chips) 
Seat 3: fooledagain1 ($6.96 in chips) 
Seat 4: Squashy22 ($47.80 in chips) 
Seat 5: VanCleef322 ($12.42 in chips) 
Seat 6: alexos04 ($13.08 in chips) 
alexos04: posts small blind $0.05
Xath76: posts big blind $0.10
Lord_of_days: sits out 
fooledagain1: posts big blind $0.10
*** HOLE CARDS ***
fooledagain1: checks 
Squashy22: folds 
VanCleef322: raises $0.30 to $0.40
alexos04: folds 
Xath76: folds 
fooledagain1: calls $0.30
*** FLOP *** [Kh 5d 2h]
fooledagain1: bets $0.10
VanCleef322: raises $0.35 to $0.45
fooledagain1: folds 
Uncalled bet ($0.35) returned to VanCleef322
VanCleef322 collected $1.10 from pot
VanCleef322: doesn't show hand 
*** SUMMARY ***
Total pot $1.15 | Rake $0.05 
Board [Kh 5d 2h]
Seat 1: Xath76 (big blind) folded before Flop
Seat 3: fooledagain1 folded on the Flop
Seat 4: Squashy22 folded before Flop (didn't bet)
Seat 5: VanCleef322 (button) collected ($1.10)
Seat 6: alexos04 (small blind) folded before Flop



PokerStars Hand #222955008488:  Hold'em No Limit ($0.05/$0.10 USD) - 2021/01/23 9:23:46 ET
Table 'Polydoros II' 6-max Seat #6 is the button
Seat 1: Xath76 ($10.05 in chips) 
Seat 2: Lord_of_days ($10 in chips) 
Seat 3: fooledagain1 ($6.46 in chips) 
Seat 4: Squashy22 ($47.80 in chips) 
Seat 5: VanCleef322 ($13.02 in chips) 
Seat 6: alexos04 ($13.03 in chips) 
Xath76: posts small blind $0.05
Lord_of_days: posts big blind $0.10
*** HOLE CARDS ***
fooledagain1: calls $0.10
Squashy22: folds 
VanCleef322: folds 
alexos04: raises $0.40 to $0.50
Xath76: folds 
Lord_of_days: folds 
fooledagain1: calls $0.40
*** FLOP *** [3d Jh 7s]
fooledagain1: bets $0.10
alexos04: raises $0.90 to $1
fooledagain1: folds 
Uncalled bet ($0.90) returned to alexos04
alexos04 collected $1.29 from pot
alexos04: doesn't show hand 
*** SUMMARY ***
Total pot $1.35 | Rake $0.06 
Board [3d Jh 7s]
Seat 1: Xath76 (small blind) folded before Flop
Seat 2: Lord_of_days (big blind) folded before Flop
Seat 3: fooledagain1 folded on the Flop
Seat 4: Squashy22 folded before Flop (didn't bet)
Seat 5: VanCleef322 folded before Flop (didn't bet)
Seat 6: alexos04 (button) collected ($1.29)



PokerStars Hand #222955022846:  Hold'em No Limit ($0.05/$0.10 USD) - 2021/01/23 9:24:15 ET
Table 'Polydoros II' 6-max Seat #1 is the button
Seat 1: Xath76 ($10 in chips) 
Seat 2: Lord_of_days ($9.90 in chips) 
Seat 3: fooledagain1 ($5.86 in chips) 
Seat 4: Squashy22 ($47.80 in chips) 
Seat 5: VanCleef322 ($13.02 in chips) 
Seat 6: alexos04 ($13.72 in chips) 
Lord_of_days: posts small blind $0.05
fooledagain1: posts big blind $0.10
*** HOLE CARDS ***
Squashy22: folds 
VanCleef322: folds 
alexos04: folds 
Xath76: folds 
Lord_of_days: raises $0.20 to $0.30
fooledagain1: calls $0.20
*** FLOP *** [4s Ac 2s]
Lord_of_days: bets $0.19
fooledagain1: calls $0.19
*** TURN *** [4s Ac 2s] [6h]
Lord_of_days: checks 
fooledagain1: checks 
*** RIVER *** [4s Ac 2s 6h] [Ad]
Lord_of_days: checks 
fooledagain1: checks 
*** SHOW DOWN ***
Lord_of_days: shows [Td Qh] (a pair of Aces)
fooledagain1: mucks hand 
Lord_of_days collected $0.94 from pot
*** SUMMARY ***
Total pot $0.98 | Rake $0.04 
Board [4s Ac 2s 6h Ad]
Seat 1: Xath76 (button) folded before Flop (didn't bet)
Seat 2: Lord_of_days (small blind) showed [Td Qh] and won ($0.94) with a pair of Aces
Seat 3: fooledagain1 (big blind) mucked
Seat 4: Squashy22 folded before Flop (didn't bet)
Seat 5: VanCleef322 folded before Flop (didn't bet)
Seat 6: alexos04 folded before Flop (didn't bet)



PokerStars Hand #222955037680:  Hold'em No Limit ($0.05/$0.10 USD) - 2021/01/23 9:24:45 ET
Table 'Polydoros II' 6-max Seat #2 is the button
Seat 1: Xath76 ($10 in chips) 
Seat 2: Lord_of_days ($10.35 in chips) 
Seat 3: fooledagain1 ($5.37 in chips) 
Seat 4: Squashy22 ($47.80 in chips) 
Seat 5: VanCleef322 ($13.02 in chips) 
Seat 6: alexos04 ($13.72 in chips) 
fooledagain1: posts small blind $0.05
Squashy22: posts big blind $0.10
*** HOLE CARDS ***
VanCleef322: folds 
alexos04: folds 
Xath76: raises $0.20 to $0.30
Lord_of_days: folds 
fooledagain1: folds 
Squashy22: calls $0.20
*** FLOP *** [2s 7h Jd]
Squashy22: checks 
Xath76: checks 
*** TURN *** [2s 7h Jd] [4s]
Squashy22: bets $0.35
Xath76: calls $0.35
*** RIVER *** [2s 7h Jd 4s] [6d]
Squashy22: bets $0.72
Xath76: calls $0.72
*** SHOW DOWN ***
Squashy22: shows [Jc Qh] (a pair of Jacks)
Xath76: mucks hand 
Squashy22 collected $2.66 from pot
*** SUMMARY ***
Total pot $2.79 | Rake $0.13 
Board [2s 7h Jd 4s 6d]
Seat 1: Xath76 mucked
Seat 2: Lord_of_days (button) folded before Flop (didn't bet)
Seat 3: fooledagain1 (small blind) folded before Flop
Seat 4: Squashy22 (big blind) showed [Jc Qh] and won ($2.66) with a pair of Jacks
Seat 5: VanCleef322 folded before Flop (didn't bet)
Seat 6: alexos04 folded before Flop (didn't bet)



PokerStars Hand #222955052566:  Hold'em No Limit ($0.05/$0.10 USD) - 2021/01/23 9:25:16 ET
Table 'Polydoros II' 6-max Seat #3 is the button
Seat 1: Xath76 ($10 in chips) 
Seat 2: Lord_of_days ($10.35 in chips) 
Seat 3: fooledagain1 ($5.32 in chips) 
Seat 4: Squashy22 ($49.09 in chips) 
Seat 5: VanCleef322 ($13.02 in chips) 
Seat 6: alexos04 ($13.72 in chips) 
Squashy22: posts small blind $0.05
VanCleef322: posts big blind $0.10
*** HOLE CARDS ***
alexos04: folds 
Xath76: folds 
Lord_of_days: folds 
fooledagain1: raises $0.10 to $0.20
Squashy22: calls $0.15
VanCleef322: calls $0.10
*** FLOP *** [3c 9c 3h]
Squashy22: checks 
VanCleef322: checks 
fooledagain1: checks 
*** TURN *** [3c 9c 3h] [7d]
Squashy22: checks 
VanCleef322: checks 
fooledagain1: checks 
*** RIVER *** [3c 9c 3h 7d] [Jd]
Squashy22: checks 
VanCleef322: checks 
fooledagain1: checks 
*** SHOW DOWN ***
Squashy22: shows [8c Ks] (a pair of Threes)
VanCleef322: shows [5s 7s] (two pair, Sevens and Threes)
fooledagain1: mucks hand 
VanCleef322 collected $0.57 from pot
*** SUMMARY ***
Total pot $0.60 | Rake $0.03 
Board [3c 9c 3h 7d Jd]
Seat 1: Xath76 folded before Flop (didn't bet)
Seat 2: Lord_of_days folded before Flop (didn't bet)
Seat 3: fooledagain1 (button) mucked
Seat 4: Squashy22 (small blind) showed [8c Ks] and lost with a pair of Threes
Seat 5: VanCleef322 (big blind) showed [5s 7s] and won ($0.57) with two pair, Sevens and Threes
Seat 6: alexos04 folded before Flop (didn't bet)



PokerStars Hand #222955069951:  Hold'em No Limit ($0.05/$0.10 USD) - 2021/01/23 9:25:51 ET
Table 'Polydoros II' 6-max Seat #4 is the button
Seat 1: Xath76 ($10 in chips) 
Seat 2: Lord_of_days ($10.35 in chips) 
Seat 3: fooledagain1 ($5.12 in chips) 
Seat 4: Squashy22 ($48.89 in chips) 
Seat 5: VanCleef322 ($13.39 in chips) 
Seat 6: alexos04 ($13.72 in chips) 
VanCleef322: posts small blind $0.05
alexos04: posts big blind $0.10
*** HOLE CARDS ***
Xath76: folds 
Lord_of_days: folds 
fooledagain1: folds 
Squashy22: folds 
VanCleef322: raises $0.15 to $0.25
alexos04: folds 
Uncalled bet ($0.15) returned to VanCleef322
VanCleef322 collected $0.20 from pot
VanCleef322: doesn't show hand 
*** SUMMARY ***
Total pot $0.20 | Rake $0 
Seat 1: Xath76 folded before Flop (didn't bet)
Seat 2: Lord_of_days folded before Flop (didn't bet)
Seat 3: fooledagain1 folded before Flop (didn't bet)
Seat 4: Squashy22 (button) folded before Flop (didn't bet)
Seat 5: VanCleef322 (small blind) collected ($0.20)
Seat 6: alexos04 (big blind) folded before Flop



PokerStars Hand #222955079782:  Hold'em No Limit ($0.05/$0.10 USD) - 2021/01/23 9:26:11 ET
Table 'Polydoros II' 6-max Seat #5 is the button
Seat 1: Xath76 ($10 in chips) 
Seat 2: Lord_of_days ($10.35 in chips) 
Seat 3: fooledagain1 ($5.12 in chips) 
Seat 4: Squashy22 ($48.89 in chips) 
Seat 5: VanCleef322 ($13.49 in chips) 
Seat 6: alexos04 ($13.62 in chips) 
alexos04: posts small blind $0.05
Xath76: posts big blind $0.10
*** HOLE CARDS ***
Lord_of_days: folds 
fooledagain1: folds 
Squashy22: folds 
VanCleef322: raises $0.15 to $0.25
alexos04: folds 
Xath76: calls $0.15
*** FLOP *** [5h Kh Qh]
Xath76: checks 
VanCleef322: bets $0.17
Xath76: folds 
Uncalled bet ($0.17) returned to VanCleef322
VanCleef322 collected $0.53 from pot
VanCleef322: doesn't show hand 
*** SUMMARY ***
Total pot $0.55 | Rake $0.02 
Board [5h Kh Qh]
Seat 1: Xath76 (big blind) folded on the Flop
Seat 2: Lord_of_days folded before Flop (didn't bet)
Seat 3: fooledagain1 folded before Flop (didn't bet)
Seat 4: Squashy22 folded before Flop (didn't bet)
Seat 5: VanCleef322 (button) collected ($0.53)
Seat 6: alexos04 (small blind) folded before Flop



PokerStars Hand #222955092484:  Hold'em No Limit ($0.05/$0.10 USD) - 2021/01/23 9:26:36 ET
Table 'Polydoros II' 6-max Seat #6 is the button
Seat 1: Xath76 ($10 in chips) 
Seat 2: Lord_of_days ($10.35 in chips) 
Seat 3: fooledagain1 ($5.12 in chips) 
Seat 4: Squashy22 ($48.89 in chips) 
Seat 5: VanCleef322 ($13.77 in chips) 
Seat 6: alexos04 ($13.57 in chips) 
Xath76: posts small blind $0.05
Lord_of_days: posts big blind $0.10
*** HOLE CARDS ***
fooledagain1: folds 
Squashy22: folds 
VanCleef322: raises $0.15 to $0.25
alexos04: folds 
Xath76: folds 
Lord_of_days: folds 
Uncalled bet ($0.15) returned to VanCleef322
VanCleef322 collected $0.25 from pot
VanCleef322: doesn't show hand 
*** SUMMARY ***
Total pot $0.25 | Rake $0 
Seat 1: Xath76 (small blind) folded before Flop
Seat 2: Lord_of_days (big blind) folded before Flop
Seat 3: fooledagain1 folded before Flop (didn't bet)
Seat 4: Squashy22 folded before Flop (didn't bet)
Seat 5: VanCleef322 collected ($0.25)
Seat 6: alexos04 (button) folded before Flop (didn't bet)



PokerStars Hand #222955099815:  Hold'em No Limit ($0.05/$0.10 USD) - 2021/01/23 9:26:51 ET
Table 'Polydoros II' 6-max Seat #1 is the button
Seat 1: Xath76 ($10 in chips) 
Seat 2: Lord_of_days ($10.25 in chips) 
Seat 3: fooledagain1 ($5.12 in chips) 
Seat 4: Squashy22 ($48.89 in chips) 
Seat 5: VanCleef322 ($13.92 in chips) 
Seat 6: alexos04 ($13.57 in chips) 
Lord_of_days: posts small blind $0.05
fooledagain1: posts big blind $0.10
*** HOLE CARDS ***
Squashy22: folds 
VanCleef322: folds 
alexos04: folds 
Xath76: folds 
Lord_of_days: raises $0.20 to $0.30
fooledagain1: calls $0.20
*** FLOP *** [Ts 6s Jh]
Lord_of_days: bets $0.19
fooledagain1: calls $0.19
*** TURN *** [Ts 6s Jh] [5c]
Lord_of_days: checks 
fooledagain1: checks 
*** RIVER *** [Ts 6s Jh 5c] [Qs]
Lord_of_days: checks 
fooledagain1: bets $0.10
Lord_of_days: calls $0.10
*** SHOW DOWN ***
fooledagain1: shows [Ks Qd] (a pair of Queens)
Lord_of_days: mucks hand 
fooledagain1 collected $1.13 from pot
*** SUMMARY ***
Total pot $1.18 | Rake $0.05 
Board [Ts 6s Jh 5c Qs]
Seat 1: Xath76 (button) folded before Flop (didn't bet)
Seat 2: Lord_of_days (small blind) mucked
Seat 3: fooledagain1 (big blind) showed [Ks Qd] and won ($1.13) with a pair of Queens
Seat 4: Squashy22 folded before Flop (didn't bet)
Seat 5: VanCleef322 folded before Flop (didn't bet)
Seat 6: alexos04 folded before Flop (didn't bet)



PokerStars Hand #222955117663:  Hold'em No Limit ($0.05/$0.10 USD) - 2021/01/23 9:27:28 ET
Table 'Polydoros II' 6-max Seat #2 is the button
Seat 1: Xath76 ($10 in chips) 
Seat 2: Lord_of_days ($10 in chips) 
Seat 3: fooledagain1 ($5.66 in chips) 
Seat 4: Squashy22 ($48.89 in chips) 
Seat 5: VanCleef322 ($13.92 in chips) 
Seat 6: alexos04 ($13.57 in chips) 
fooledagain1: posts small blind $0.05
Squashy22: posts big blind $0.10
*** HOLE CARDS ***
VanCleef322: folds 
alexos04: raises $0.20 to $0.30
Xath76: folds 
Lord_of_days: folds 
fooledagain1: folds 
Squashy22: folds 
Uncalled bet ($0.20) returned to alexos04
alexos04 collected $0.25 from pot
alexos04: doesn't show hand 
*** SUMMARY ***
Total pot $0.25 | Rake $0 
Seat 1: Xath76 folded before Flop (didn't bet)
Seat 2: Lord_of_days (button) folded before Flop (didn't bet)
Seat 3: fooledagain1 (small blind) folded before Flop
Seat 4: Squashy22 (big blind) folded before Flop
Seat 5: VanCleef322 folded before Flop (didn't bet)
Seat 6: alexos04 collected ($0.25)



PokerStars Hand #222955122017:  Hold'em No Limit ($0.05/$0.10 USD) - 2021/01/23 9:27:36 ET
Table 'Polydoros II' 6-max Seat #3 is the button
Seat 1: Xath76 ($10 in chips) 
Seat 2: Lord_of_days ($10 in chips) 
Seat 3: fooledagain1 ($5.61 in chips) 
Seat 4: Squashy22 ($48.79 in chips) 
Seat 5: VanCleef322 ($13.92 in chips) 
Seat 6: alexos04 ($13.72 in chips) 
Squashy22: posts small blind $0.05
VanCleef322: posts big blind $0.10
*** HOLE CARDS ***
alexos04: folds 
Xath76: folds 
Lord_of_days: folds 
fooledagain1: raises $0.50 to $0.60
Squashy22: folds 
VanCleef322: folds 
Uncalled bet ($0.50) returned to fooledagain1
fooledagain1 collected $0.25 from pot
fooledagain1: doesn't show hand 
*** SUMMARY ***
Total pot $0.25 | Rake $0 
Seat 1: Xath76 folded before Flop (didn't bet)
Seat 2: Lord_of_days folded before Flop (didn't bet)
Seat 3: fooledagain1 (button) collected ($0.25)
Seat 4: Squashy22 (small blind) folded before Flop
Seat 5: VanCleef322 (big blind) folded before Flop
Seat 6: alexos04 folded before Flop (didn't bet)



PokerStars Hand #222955130579:  Hold'em No Limit ($0.05/$0.10 USD) - 2021/01/23 9:27:54 ET
Table 'Polydoros II' 6-max Seat #4 is the button
Seat 1: Xath76 ($10 in chips) 
Seat 2: Lord_of_days ($10 in chips) 
Seat 3: fooledagain1 ($5.76 in chips) 
Seat 4: Squashy22 ($48.74 in chips) 
Seat 5: VanCleef322 ($13.82 in chips) 
Seat 6: alexos04 ($13.72 in chips) 
VanCleef322: posts small blind $0.05
alexos04: posts big blind $0.10
*** HOLE CARDS ***
Xath76: folds 
Lord_of_days: folds 
fooledagain1: folds 
Squashy22: folds 
VanCleef322: folds 
Uncalled bet ($0.05) returned to alexos04
alexos04 collected $0.10 from pot
alexos04: doesn't show hand 
*** SUMMARY ***
Total pot $0.10 | Rake $0 
Seat 1: Xath76 folded before Flop (didn't bet)
Seat 2: Lord_of_days folded before Flop (didn't bet)
Seat 3: fooledagain1 folded before Flop (didn't bet)
Seat 4: Squashy22 (button) folded before Flop (didn't bet)
Seat 5: VanCleef322 (small blind) folded before Flop
Seat 6: alexos04 (big blind) collected ($0.10)



PokerStars Hand #222955141217:  Hold'em No Limit ($0.05/$0.10 USD) - 2021/01/23 9:28:02 ET
Table 'Polydoros II' 6-max Seat #5 is the button
Seat 1: Xath76 ($10 in chips) 
Seat 2: Lord_of_days ($10 in chips) 
Seat 3: fooledagain1 ($5.76 in chips) 
Seat 4: Squashy22 ($48.74 in chips) 
Seat 5: VanCleef322 ($13.77 in chips) 
Seat 6: alexos04 ($13.77 in chips) 
alexos04: posts small blind $0.05
Xath76: posts big blind $0.10
*** HOLE CARDS ***
Lord_of_days: folds 
fooledagain1: folds 
Squashy22: raises $0.16 to $0.26
VanCleef322: folds 
alexos04: folds 
Xath76: calls $0.16
*** FLOP *** [Ts Js 9c]
Xath76: checks 
Squashy22: checks 
*** TURN *** [Ts Js 9c] [7s]
Xath76: checks 
Squashy22: checks 
*** RIVER *** [Ts Js 9c 7s] [8h]
Xath76: checks 
Squashy22: checks 
*** SHOW DOWN ***
Xath76: shows [Ad Jh] (a straight, Seven to Jack)
Squashy22: shows [Kd Tc] (a straight, Seven to Jack)
Xath76 collected $0.27 from pot
Squashy22 collected $0.27 from pot
*** SUMMARY ***
Total pot $0.57 | Rake $0.03 
Board [Ts Js 9c 7s 8h]
Seat 1: Xath76 (big blind) showed [Ad Jh] and won ($0.27) with a straight, Seven to Jack
Seat 2: Lord_of_days folded before Flop (didn't bet)
Seat 3: fooledagain1 folded before Flop (didn't bet)
Seat 4: Squashy22 showed [Kd Tc] and won ($0.27) with a straight, Seven to Jack
Seat 5: VanCleef322 (button) folded before Flop (didn't bet)
Seat 6: alexos04 (small blind) folded before Flop



PokerStars Hand #222955159873:  Hold'em No Limit ($0.05/$0.10 USD) - 2021/01/23 9:28:39 ET
Table 'Polydoros II' 6-max Seat #6 is the button
Seat 1: Xath76 ($10.01 in chips) 
Seat 2: Lord_of_days ($10 in chips) 
Seat 3: fooledagain1 ($5.76 in chips) 
Seat 4: Squashy22 ($48.75 in chips) 
Seat 5: VanCleef322 ($13.77 in chips) 
Seat 6: alexos04 ($13.72 in chips) 
Xath76: posts small blind $0.05
Lord_of_days: posts big blind $0.10
*** HOLE CARDS ***
fooledagain1: folds 
Squashy22: raises $0.19 to $0.29
VanCleef322: folds 
alexos04: folds 
Xath76: calls $0.24
Lord_of_days: folds 
*** FLOP *** [6c 4d 8s]
Xath76: checks 
Squashy22: bets $0.46
Xath76: calls $0.46
*** TURN *** [6c 4d 8s] [9h]
Xath76: checks 
Squashy22: checks 
*** RIVER *** [6c 4d 8s 9h] [2s]
Xath76: checks 
Squashy22: bets $0.86
Xath76: folds 
Uncalled bet ($0.86) returned to Squashy22
Squashy22 collected $1.53 from pot
Squashy22: doesn't show hand 
*** SUMMARY ***
Total pot $1.60 | Rake $0.07 
Board [6c 4d 8s 9h 2s]
Seat 1: Xath76 (small blind) folded on the River
Seat 2: Lord_of_days (big blind) folded before Flop
Seat 3: fooledagain1 folded before Flop (didn't bet)
Seat 4: Squashy22 collected ($1.53)
Seat 5: VanCleef322 folded before Flop (didn't bet)
Seat 6: alexos04 (button) folded before Flop (didn't bet)



PokerStars Hand #222955192611:  Hold'em No Limit ($0.05/$0.10 USD) - 2021/01/23 9:29:45 ET
Table 'Polydoros II' 6-max Seat #1 is the button
Seat 1: Xath76 ($10 in chips) 
Seat 2: Lord_of_days ($9.90 in chips) 
Seat 3: fooledagain1 ($5.76 in chips) 
Seat 4: Squashy22 ($49.53 in chips) 
Seat 5: VanCleef322 ($13.77 in chips) 
Seat 6: alexos04 ($13.72 in chips) 
Lord_of_days: posts small blind $0.05
fooledagain1: posts big blind $0.10
*** HOLE CARDS ***
Squashy22: folds 
VanCleef322: folds 
alexos04: raises $0.20 to $0.30
Xath76: folds 
Lord_of_days: folds 
fooledagain1: raises $0.20 to $0.50
alexos04: calls $0.20
*** FLOP *** [6h As Ks]
fooledagain1: checks 
alexos04: checks 
*** TURN *** [6h As Ks] [7s]
fooledagain1: bets $1
alexos04: calls $1
*** RIVER *** [6h As Ks 7s] [8c]
fooledagain1: checks 
alexos04: checks 
*** SHOW DOWN ***
fooledagain1: shows [Kc Ac] (two pair, Aces and Kings)
alexos04: mucks hand 
fooledagain1 collected $2.91 from pot
*** SUMMARY ***
Total pot $3.05 | Rake $0.14 
Board [6h As Ks 7s 8c]
Seat 1: Xath76 (button) folded before Flop (didn't bet)
Seat 2: Lord_of_days (small blind) folded before Flop
Seat 3: fooledagain1 (big blind) showed [Kc Ac] and won ($2.91) with two pair, Aces and Kings
Seat 4: Squashy22 folded before Flop (didn't bet)
Seat 5: VanCleef322 folded before Flop (didn't bet)
Seat 6: alexos04 mucked



PokerStars Hand #222955213622:  Hold'em No Limit ($0.05/$0.10 USD) - 2021/01/23 9:30:27 ET
Table 'Polydoros II' 6-max Seat #2 is the button
Seat 1: Xath76 ($10 in chips) 
Seat 2: Lord_of_days ($10 in chips) 
Seat 3: fooledagain1 ($7.17 in chips) 
Seat 4: Squashy22 ($49.53 in chips) 
Seat 5: VanCleef322 ($13.77 in chips) 
Seat 6: alexos04 ($12.22 in chips) 
fooledagain1: posts small blind $0.05
Squashy22: posts big blind $0.10
*** HOLE CARDS ***
VanCleef322: raises $0.15 to $0.25
alexos04: folds 
Xath76: folds 
Lord_of_days: folds 
fooledagain1: calls $0.20
Squashy22: calls $0.15
*** FLOP *** [Th Kc 4c]
fooledagain1: bets $0.10
Squashy22: calls $0.10
VanCleef322: calls $0.10
*** TURN *** [Th Kc 4c] [Ts]
fooledagain1: bets $0.10
Squashy22: folds 
VanCleef322: calls $0.10
*** RIVER *** [Th Kc 4c Ts] [Qc]
fooledagain1: bets $0.10
VanCleef322: calls $0.10
*** SHOW DOWN ***
fooledagain1: shows [Jd 9d] (a straight, Nine to King)
VanCleef322: mucks hand 
fooledagain1 collected $1.38 from pot
*** SUMMARY ***
Total pot $1.45 | Rake $0.07 
Board [Th Kc 4c Ts Qc]
Seat 1: Xath76 folded before Flop (didn't bet)
Seat 2: Lord_of_days (button) folded before Flop (didn't bet)
Seat 3: fooledagain1 (small blind) showed [Jd 9d] and won ($1.38) with a straight, Nine to King
Seat 4: Squashy22 (big blind) folded on the Turn
Seat 5: VanCleef322 mucked
Seat 6: alexos04 folded before Flop (didn't bet)



PokerStars Hand #222955236139:  Hold'em No Limit ($0.05/$0.10 USD) - 2021/01/23 9:31:12 ET
Table 'Polydoros II' 6-max Seat #3 is the button
Seat 1: Xath76 ($10 in chips) 
Seat 2: Lord_of_days ($10 in chips) 
Seat 3: fooledagain1 ($8 in chips) 
Seat 4: Squashy22 ($49.18 in chips) 
Seat 5: VanCleef322 ($13.22 in chips) 
Seat 6: alexos04 ($12.22 in chips) 
Squashy22: posts small blind $0.05
VanCleef322: posts big blind $0.10
*** HOLE CARDS ***
alexos04: folds 
Xath76: folds 
Lord_of_days: folds 
fooledagain1: calls $0.10
Squashy22: calls $0.05
VanCleef322: checks 
*** FLOP *** [7d 6c 5d]
Squashy22: checks 
VanCleef322: checks 
fooledagain1: checks 
*** TURN *** [7d 6c 5d] [Ac]
Squashy22: bets $0.16
VanCleef322: raises $0.29 to $0.45
fooledagain1: folds 
Squashy22: calls $0.29
*** RIVER *** [7d 6c 5d Ac] [Ah]
Squashy22: checks 
VanCleef322: bets $0.58
Squashy22: folds 
Uncalled bet ($0.58) returned to VanCleef322
VanCleef322 collected $1.15 from pot
VanCleef322: doesn't show hand 
*** SUMMARY ***
Total pot $1.20 | Rake $0.05 
Board [7d 6c 5d Ac Ah]
Seat 1: Xath76 folded before Flop (didn't bet)
Seat 2: Lord_of_days folded before Flop (didn't bet)
Seat 3: fooledagain1 (button) folded on the Turn
Seat 4: Squashy22 (small blind) folded on the River
Seat 5: VanCleef322 (big blind) collected ($1.15)
Seat 6: alexos04 folded before Flop (didn't bet)



PokerStars Hand #222955258618:  Hold'em No Limit ($0.05/$0.10 USD) - 2021/01/23 9:31:56 ET
Table 'Polydoros II' 6-max Seat #4 is the button
Seat 1: Xath76 ($10 in chips) 
Seat 2: Lord_of_days ($10 in chips) 
Seat 3: fooledagain1 ($7.90 in chips) 
Seat 4: Squashy22 ($48.63 in chips) 
Seat 5: VanCleef322 ($13.82 in chips) 
Seat 6: alexos04 ($12.22 in chips) 
VanCleef322: posts small blind $0.05
alexos04: posts big blind $0.10
*** HOLE CARDS ***
Xath76: folds 
Lord_of_days: folds 
fooledagain1: folds 
Squashy22: folds 
VanCleef322: folds 
Uncalled bet ($0.05) returned to alexos04
alexos04 collected $0.10 from pot
alexos04: doesn't show hand 
*** SUMMARY ***
Total pot $0.10 | Rake $0 
Seat 1: Xath76 folded before Flop (didn't bet)
Seat 2: Lord_of_days folded before Flop (didn't bet)
Seat 3: fooledagain1 folded before Flop (didn't bet)
Seat 4: Squashy22 (button) folded before Flop (didn't bet)
Seat 5: VanCleef322 (small blind) folded before Flop
Seat 6: alexos04 (big blind) collected ($0.10)



PokerStars Hand #222955263023:  Hold'em No Limit ($0.05/$0.10 USD) - 2021/01/23 9:32:05 ET
Table 'Polydoros II' 6-max Seat #5 is the button
Seat 1: Xath76 ($10 in chips) 
Seat 2: Lord_of_days ($10 in chips) 
Seat 3: fooledagain1 ($7.90 in chips) 
Seat 4: Squashy22 ($48.63 in chips) 
Seat 5: VanCleef322 ($13.77 in chips) 
Seat 6: alexos04 ($12.27 in chips) 
alexos04: posts small blind $0.05
Xath76: posts big blind $0.10
*** HOLE CARDS ***
Lord_of_days: folds 
fooledagain1: folds 
Squashy22: folds 
VanCleef322: folds 
alexos04: folds 
Uncalled bet ($0.05) returned to Xath76
Xath76 collected $0.10 from pot
Xath76: doesn't show hand 
*** SUMMARY ***
Total pot $0.10 | Rake $0 
Seat 1: Xath76 (big blind) collected ($0.10)
Seat 2: Lord_of_days folded before Flop (didn't bet)
Seat 3: fooledagain1 folded before Flop (didn't bet)
Seat 4: Squashy22 folded before Flop (didn't bet)
Seat 5: VanCleef322 (button) folded before Flop (didn't bet)
Seat 6: alexos04 (small blind) folded before Flop



PokerStars Hand #222955268073:  Hold'em No Limit ($0.05/$0.10 USD) - 2021/01/23 9:32:15 ET
Table 'Polydoros II' 6-max Seat #6 is the button
Seat 1: Xath76 ($10.05 in chips) 
Seat 2: Lord_of_days ($10 in chips) 
Seat 3: fooledagain1 ($7.90 in chips) 
Seat 4: Squashy22 ($48.63 in chips) 
Seat 5: VanCleef322 ($13.77 in chips) 
Seat 6: alexos04 ($12.22 in chips) 
Xath76: posts small blind $0.05
Lord_of_days: posts big blind $0.10
*** HOLE CARDS ***
fooledagain1: folds 
Squashy22: folds 
VanCleef322: folds 
alexos04: folds 
Xath76: raises $0.20 to $0.30
Lord_of_days: folds 
Uncalled bet ($0.20) returned to Xath76
Xath76 collected $0.20 from pot
Xath76: doesn't show hand 
*** SUMMARY ***
Total pot $0.20 | Rake $0 
Seat 1: Xath76 (small blind) collected ($0.20)
Seat 2: Lord_of_days (big blind) folded before Flop
Seat 3: fooledagain1 folded before Flop (didn't bet)
Seat 4: Squashy22 folded before Flop (didn't bet)
Seat 5: VanCleef322 folded before Flop (didn't bet)
Seat 6: alexos04 (button) folded before Flop (didn't bet)



PokerStars Hand #222952318914:  Hold'em No Limit ($0.05/$0.10 USD) - 2021/01/23 7:39:46 ET
Table 'Polydoros II' 6-max Seat #5 is the button
Seat 1: Xath76 ($18.77 in chips) 
Seat 2: manroy86 ($10.15 in chips) 
Seat 3: Antonio8812 ($10 in chips) 
Seat 4: father here ($11.45 in chips) 
Seat 5: 1920kbps ($13.80 in chips) 
Seat 6: bigmen100 ($7.90 in chips) 
bigmen100: posts small blind $0.05
Xath76: posts big blind $0.10
*** HOLE CARDS ***
manroy86: folds 
Antonio8812: folds 
father here: raises $0.20 to $0.30
1920kbps: folds 
bigmen100: folds 
Xath76: folds 
Uncalled bet ($0.20) returned to father here
father here collected $0.25 from pot
*** SUMMARY ***
Total pot $0.25 | Rake $0 
Seat 1: Xath76 (big blind) folded before Flop
Seat 2: manroy86 folded before Flop (didn't bet)
Seat 3: Antonio8812 folded before Flop (didn't bet)
Seat 4: father here collected ($0.25)
Seat 5: 1920kbps (button) folded before Flop (didn't bet)
Seat 6: bigmen100 (small blind) folded before Flop



PokerStars Hand #222952323774:  Hold'em No Limit ($0.05/$0.10 USD) - 2021/01/23 7:39:59 ET
Table 'Polydoros II' 6-max Seat #6 is the button
Seat 1: Xath76 ($18.67 in chips) 
Seat 2: manroy86 ($10.15 in chips) 
Seat 3: Antonio8812 ($10 in chips) 
Seat 4: father here ($11.60 in chips) 
Seat 5: 1920kbps ($13.80 in chips) 
Seat 6: bigmen100 ($7.85 in chips) 
Xath76: posts small blind $0.05
manroy86: posts big blind $0.10
*** HOLE CARDS ***
Antonio8812: folds 
father here: folds 
1920kbps: raises $0.20 to $0.30
bigmen100: folds 
Xath76: folds 
manroy86: folds 
Uncalled bet ($0.20) returned to 1920kbps
1920kbps collected $0.25 from pot
*** SUMMARY ***
Total pot $0.25 | Rake $0 
Seat 1: Xath76 (small blind) folded before Flop
Seat 2: manroy86 (big blind) folded before Flop
Seat 3: Antonio8812 folded before Flop (didn't bet)
Seat 4: father here folded before Flop (didn't bet)
Seat 5: 1920kbps collected ($0.25)
Seat 6: bigmen100 (button) folded before Flop (didn't bet)



PokerStars Hand #222952329638:  Hold'em No Limit ($0.05/$0.10 USD) - 2021/01/23 7:40:15 ET
Table 'Polydoros II' 6-max Seat #1 is the button
Seat 1: Xath76 ($18.62 in chips) 
Seat 2: manroy86 ($10.05 in chips) 
Seat 3: Antonio8812 ($10 in chips) 
Seat 4: father here ($11.60 in chips) 
Seat 5: 1920kbps ($13.95 in chips) 
Seat 6: bigmen100 ($7.85 in chips) 
manroy86: posts small blind $0.05
Antonio8812: posts big blind $0.10
*** HOLE CARDS ***
father here: raises $0.20 to $0.30
1920kbps: folds 
bigmen100: folds 
Xath76: folds 
manroy86: calls $0.25
Antonio8812: folds 
*** FLOP *** [7s Ad Ac]
manroy86: checks 
father here: bets $0.22
manroy86: folds 
Uncalled bet ($0.22) returned to father here
father here collected $0.67 from pot
*** SUMMARY ***
Total pot $0.70 | Rake $0.03 
Board [7s Ad Ac]
Seat 1: Xath76 (button) folded before Flop (didn't bet)
Seat 2: manroy86 (small blind) folded on the Flop
Seat 3: Antonio8812 (big blind) folded before Flop
Seat 4: father here collected ($0.67)
Seat 5: 1920kbps folded before Flop (didn't bet)
Seat 6: bigmen100 folded before Flop (didn't bet)



PokerStars Hand #222952340548:  Hold'em No Limit ($0.05/$0.10 USD) - 2021/01/23 7:40:44 ET
Table 'Polydoros II' 6-max Seat #2 is the button
Seat 1: Xath76 ($18.62 in chips) 
Seat 2: manroy86 ($10 in chips) 
Seat 3: Antonio8812 ($10 in chips) 
Seat 4: father here ($11.97 in chips) 
Seat 5: 1920kbps ($13.95 in chips) 
Seat 6: bigmen100 ($7.85 in chips) 
Antonio8812: posts small blind $0.05
father here: posts big blind $0.10
*** HOLE CARDS ***
1920kbps: raises $0.20 to $0.30
bigmen100: folds 
Xath76: folds 
manroy86: folds 
Antonio8812: folds 
father here: folds 
Uncalled bet ($0.20) returned to 1920kbps
1920kbps collected $0.25 from pot
*** SUMMARY ***
Total pot $0.25 | Rake $0 
Seat 1: Xath76 folded before Flop (didn't bet)
Seat 2: manroy86 (button) folded before Flop (didn't bet)
Seat 3: Antonio8812 (small blind) folded before Flop
Seat 4: father here (big blind) folded before Flop
Seat 5: 1920kbps collected ($0.25)
Seat 6: bigmen100 folded before Flop (didn't bet)



PokerStars Hand #222952345951:  Hold'em No Limit ($0.05/$0.10 USD) - 2021/01/23 7:40:58 ET
Table 'Polydoros II' 6-max Seat #3 is the button
Seat 1: Xath76 ($18.62 in chips) 
Seat 2: manroy86 ($10 in chips) 
Seat 3: Antonio8812 ($10 in chips) 
Seat 4: father here ($11.87 in chips) 
Seat 5: 1920kbps ($14.10 in chips) 
Seat 6: bigmen100 ($7.85 in chips) 
father here: posts small blind $0.05
1920kbps: posts big blind $0.10
*** HOLE CARDS ***
bigmen100: raises $0.20 to $0.30
Xath76: folds 
manroy86: folds 
Antonio8812: folds 
father here: folds 
1920kbps: calls $0.20
*** FLOP *** [5c Qd 5s]
1920kbps: checks 
bigmen100: bets $0.31
1920kbps: folds 
Uncalled bet ($0.31) returned to bigmen100
bigmen100 collected $0.62 from pot
*** SUMMARY ***
Total pot $0.65 | Rake $0.03 
Board [5c Qd 5s]
Seat 1: Xath76 folded before Flop (didn't bet)
Seat 2: manroy86 folded before Flop (didn't bet)
Seat 3: Antonio8812 (button) folded before Flop (didn't bet)
Seat 4: father here (small blind) folded before Flop
Seat 5: 1920kbps (big blind) folded on the Flop
Seat 6: bigmen100 collected ($0.62)



PokerStars Hand #222952359413:  Hold'em No Limit ($0.05/$0.10 USD) - 2021/01/23 7:41:34 ET
Table 'Polydoros II' 6-max Seat #4 is the button
Seat 1: Xath76 ($18.62 in chips) 
Seat 2: manroy86 ($10 in chips) 
Seat 3: Antonio8812 ($10 in chips) 
Seat 4: father here ($11.82 in chips) 
Seat 5: 1920kbps ($13.80 in chips) 
Seat 6: bigmen100 ($8.17 in chips) 
1920kbps: posts small blind $0.05
bigmen100: posts big blind $0.10
*** HOLE CARDS ***
Xath76: folds 
manroy86: folds 
Antonio8812: folds 
father here: raises $0.20 to $0.30
1920kbps: raises $0.90 to $1.20
bigmen100: folds 
father here: folds 
Uncalled bet ($0.90) returned to 1920kbps
1920kbps collected $0.70 from pot
*** SUMMARY ***
Total pot $0.70 | Rake $0 
Seat 1: Xath76 folded before Flop (didn't bet)
Seat 2: manroy86 folded before Flop (didn't bet)
Seat 3: Antonio8812 folded before Flop (didn't bet)
Seat 4: father here (button) folded before Flop
Seat 5: 1920kbps (small blind) collected ($0.70)
Seat 6: bigmen100 (big blind) folded before Flop



PokerStars Hand #222952372773:  Hold'em No Limit ($0.05/$0.10 USD) - 2021/01/23 7:42:09 ET
Table 'Polydoros II' 6-max Seat #5 is the button
Seat 1: Xath76 ($18.62 in chips) 
Seat 2: manroy86 ($10 in chips) 
Seat 3: Antonio8812 ($10 in chips) 
Seat 4: father here ($11.52 in chips) 
Seat 5: 1920kbps ($14.20 in chips) 
Seat 6: bigmen100 ($8.07 in chips) 
bigmen100: posts small blind $0.05
Xath76: posts big blind $0.10
*** HOLE CARDS ***
manroy86: folds 
Antonio8812: folds 
father here: raises $0.20 to $0.30
1920kbps: calls $0.30
bigmen100: folds 
Xath76: calls $0.20
*** FLOP *** [3h Kc 5d]
Xath76: checks 
father here: checks 
1920kbps: checks 
*** TURN *** [3h Kc 5d] [Jh]
Xath76: checks 
father here: bets $0.60
1920kbps: folds 
Xath76: folds 
Uncalled bet ($0.60) returned to father here
father here collected $0.91 from pot
*** SUMMARY ***
Total pot $0.95 | Rake $0.04 
Board [3h Kc 5d Jh]
Seat 1: Xath76 (big blind) folded on the Turn
Seat 2: manroy86 folded before Flop (didn't bet)
Seat 3: Antonio8812 folded before Flop (didn't bet)
Seat 4: father here collected ($0.91)
Seat 5: 1920kbps (button) folded on the Turn
Seat 6: bigmen100 (small blind) folded before Flop



PokerStars Hand #222952394488:  Hold'em No Limit ($0.05/$0.10 USD) - 2021/01/23 7:43:06 ET
Table 'Polydoros II' 6-max Seat #6 is the button
Seat 1: Xath76 ($18.32 in chips) 
Seat 2: manroy86 ($10 in chips) 
Seat 3: Antonio8812 ($10 in chips) 
Seat 4: father here ($12.13 in chips) 
Seat 5: 1920kbps ($13.90 in chips) 
Seat 6: bigmen100 ($8.02 in chips) 
Xath76: posts small blind $0.05
manroy86: posts big blind $0.10
*** HOLE CARDS ***
Antonio8812: folds 
father here: raises $0.20 to $0.30
1920kbps: folds 
bigmen100: folds 
Xath76: folds 
manroy86: folds 
Uncalled bet ($0.20) returned to father here
father here collected $0.25 from pot
*** SUMMARY ***
Total pot $0.25 | Rake $0 
Seat 1: Xath76 (small blind) folded before Flop
Seat 2: manroy86 (big blind) folded before Flop
Seat 3: Antonio8812 folded before Flop (didn't bet)
Seat 4: father here collected ($0.25)
Seat 5: 1920kbps folded before Flop (didn't bet)
Seat 6: bigmen100 (button) folded before Flop (didn't bet)



PokerStars Hand #222952400590:  Hold'em No Limit ($0.05/$0.10 USD) - 2021/01/23 7:43:22 ET
Table 'Polydoros II' 6-max Seat #1 is the button
Seat 1: Xath76 ($18.27 in chips) 
Seat 2: manroy86 ($10 in chips) 
Seat 3: Antonio8812 ($10 in chips) 
Seat 4: father here ($12.28 in chips) 
Seat 5: 1920kbps ($13.90 in chips) 
Seat 6: bigmen100 ($8.02 in chips) 
manroy86: posts small blind $0.05
Antonio8812: posts big blind $0.10
*** HOLE CARDS ***
father here: folds 
father here leaves the table
1920kbps: folds 
bigmen100: raises $0.20 to $0.30
Xath76: folds 
manroy86: folds 
Antonio8812: raises $0.65 to $0.95
bigmen100: calls $0.65
*** FLOP *** [7s 5d 6d]
Antonio8812: bets $0.93
bigmen100: raises $1.27 to $2.20
PokerMasta55 joins the table at seat #4 
Antonio8812: raises $6.85 to $9.05 and is all-in
bigmen100: calls $4.87 and is all-in
Uncalled bet ($1.98) returned to Antonio8812
*** TURN *** [7s 5d 6d] [Qd]
*** RIVER *** [7s 5d 6d Qd] [2d]
*** SHOW DOWN ***
Antonio8812: shows [Ad 8d] (a flush, Ace high)
bigmen100: shows [8h 8c] (a pair of Eights)
Antonio8812 collected $15.37 from pot
*** SUMMARY ***
Total pot $16.09 | Rake $0.72 
Board [7s 5d 6d Qd 2d]
Seat 1: Xath76 (button) folded before Flop (didn't bet)
Seat 2: manroy86 (small blind) folded before Flop
Seat 3: Antonio8812 (big blind) showed [Ad 8d] and won ($15.37) with a flush, Ace high
Seat 4: father here folded before Flop (didn't bet)
Seat 5: 1920kbps folded before Flop (didn't bet)
Seat 6: bigmen100 showed [8h 8c] and lost with a pair of Eights



PokerStars Hand #222952425195:  Hold'em No Limit ($0.05/$0.10 USD) - 2021/01/23 7:44:27 ET
Table 'Polydoros II' 6-max Seat #2 is the button
Seat 1: Xath76 ($18.27 in chips) 
Seat 2: manroy86 ($10 in chips) 
Seat 3: Antonio8812 ($17.35 in chips) 
Seat 4: PokerMasta55 ($10 in chips) 
Seat 5: 1920kbps ($13.90 in chips) 
Antonio8812: posts small blind $0.05
PokerMasta55: posts big blind $0.10
*** HOLE CARDS ***
1920kbps: folds 
Xath76: folds 
manroy86: raises $0.15 to $0.25
Antonio8812: folds 
PokerMasta55: calls $0.15
*** FLOP *** [Ts 5h Kh]
PokerMasta55: checks 
manroy86: bets $0.20
PokerMasta55: calls $0.20
*** TURN *** [Ts 5h Kh] [Jh]
PokerMasta55: checks 
manroy86: checks 
*** RIVER *** [Ts 5h Kh Jh] [8h]
PokerMasta55: checks 
manroy86: checks 
*** SHOW DOWN ***
PokerMasta55: shows [7s Td] (a pair of Tens)
manroy86: shows [Ac Ad] (a pair of Aces)
manroy86 collected $0.91 from pot
*** SUMMARY ***
Total pot $0.95 | Rake $0.04 
Board [Ts 5h Kh Jh 8h]
Seat 1: Xath76 folded before Flop (didn't bet)
Seat 2: manroy86 (button) showed [Ac Ad] and won ($0.91) with a pair of Aces
Seat 3: Antonio8812 (small blind) folded before Flop
Seat 4: PokerMasta55 (big blind) showed [7s Td] and lost with a pair of Tens
Seat 5: 1920kbps folded before Flop (didn't bet)



PokerStars Hand #222952444600:  Hold'em No Limit ($0.05/$0.10 USD) - 2021/01/23 7:45:17 ET
Table 'Polydoros II' 6-max Seat #3 is the button
Seat 1: Xath76 ($18.27 in chips) 
Seat 2: manroy86 ($10.46 in chips) 
Seat 3: Antonio8812 ($17.30 in chips) 
Seat 4: PokerMasta55 ($10 in chips) 
Seat 5: 1920kbps ($13.90 in chips) 
Seat 6: bigmen100 ($5.10 in chips) 
PokerMasta55: posts small blind $0.05
1920kbps: posts big blind $0.10
*** HOLE CARDS ***
bigmen100: folds 
Xath76: folds 
manroy86: folds 
Antonio8812: raises $0.20 to $0.30
PokerMasta55: folds 
1920kbps: raises $0.90 to $1.20
Antonio8812: folds 
Uncalled bet ($0.90) returned to 1920kbps
1920kbps collected $0.65 from pot
*** SUMMARY ***
Total pot $0.65 | Rake $0 
Seat 1: Xath76 folded before Flop (didn't bet)
Seat 2: manroy86 folded before Flop (didn't bet)
Seat 3: Antonio8812 (button) folded before Flop
Seat 4: PokerMasta55 (small blind) folded before Flop
Seat 5: 1920kbps (big blind) collected ($0.65)
Seat 6: bigmen100 folded before Flop (didn't bet)



PokerStars Hand #222952450853:  Hold'em No Limit ($0.05/$0.10 USD) - 2021/01/23 7:45:33 ET
Table 'Polydoros II' 6-max Seat #4 is the button
Seat 1: Xath76 ($18.27 in chips) 
Seat 2: manroy86 ($10.46 in chips) 
Seat 3: Antonio8812 ($17 in chips) 
Seat 4: PokerMasta55 ($10 in chips) 
Seat 5: 1920kbps ($14.25 in chips) 
Seat 6: bigmen100 ($5.10 in chips) 
1920kbps: posts small blind $0.05
bigmen100: posts big blind $0.10
*** HOLE CARDS ***
Xath76: folds 
manroy86: raises $0.20 to $0.30
Antonio8812: folds 
PokerMasta55: folds 
1920kbps: calls $0.25
bigmen100: folds 
*** FLOP *** [9h Kh Jd]
1920kbps: checks 
manroy86: bets $0.22
1920kbps: folds 
Uncalled bet ($0.22) returned to manroy86
manroy86 collected $0.67 from pot
manroy86: doesn't show hand 
*** SUMMARY ***
Total pot $0.70 | Rake $0.03 
Board [9h Kh Jd]
Seat 1: Xath76 folded before Flop (didn't bet)
Seat 2: manroy86 collected ($0.67)
Seat 3: Antonio8812 folded before Flop (didn't bet)
Seat 4: PokerMasta55 (button) folded before Flop (didn't bet)
Seat 5: 1920kbps (small blind) folded on the Flop
Seat 6: bigmen100 (big blind) folded before Flop



PokerStars Hand #222952459198:  Hold'em No Limit ($0.05/$0.10 USD) - 2021/01/23 7:45:55 ET
Table 'Polydoros II' 6-max Seat #5 is the button
Seat 1: Xath76 ($18.27 in chips) 
Seat 2: manroy86 ($10.83 in chips) 
Seat 3: Antonio8812 ($17 in chips) 
Seat 4: PokerMasta55 ($10 in chips) 
Seat 5: 1920kbps ($13.95 in chips) 
Seat 6: bigmen100 ($5 in chips) 
bigmen100: posts small blind $0.05
Xath76: posts big blind $0.10
*** HOLE CARDS ***
manroy86: folds 
Antonio8812: folds 
PokerMasta55: folds 
manroy86 leaves the table
Raquk joins the table at seat #2 
1920kbps: folds 
bigmen100: raises $0.20 to $0.30
Xath76: folds 
Uncalled bet ($0.20) returned to bigmen100
bigmen100 collected $0.20 from pot
*** SUMMARY ***
Total pot $0.20 | Rake $0 
Seat 1: Xath76 (big blind) folded before Flop
Seat 2: manroy86 folded before Flop (didn't bet)
Seat 3: Antonio8812 folded before Flop (didn't bet)
Seat 4: PokerMasta55 folded before Flop (didn't bet)
Seat 5: 1920kbps (button) folded before Flop (didn't bet)
Seat 6: bigmen100 (small blind) collected ($0.20)



PokerStars Hand #222952466047:  Hold'em No Limit ($0.05/$0.10 USD) - 2021/01/23 7:46:13 ET
Table 'Polydoros II' 6-max Seat #6 is the button
Seat 1: Xath76 ($18.17 in chips) 
Seat 2: Raquk ($10 in chips) 
Seat 3: Antonio8812 ($17 in chips) 
Seat 4: PokerMasta55 ($10 in chips) 
Seat 5: 1920kbps ($13.95 in chips) 
Seat 6: bigmen100 ($5.10 in chips) 
Xath76: posts small blind $0.05
Raquk: posts big blind $0.10
*** HOLE CARDS ***
Antonio8812: folds 
PokerMasta55: folds 
1920kbps: folds 
bigmen100: folds 
Xath76: folds 
Uncalled bet ($0.05) returned to Raquk
Raquk collected $0.10 from pot
Raquk: doesn't show hand 
*** SUMMARY ***
Total pot $0.10 | Rake $0 
Seat 1: Xath76 (small blind) folded before Flop
Seat 2: Raquk (big blind) collected ($0.10)
Seat 3: Antonio8812 folded before Flop (didn't bet)
Seat 4: PokerMasta55 folded before Flop (didn't bet)
Seat 5: 1920kbps folded before Flop (didn't bet)
Seat 6: bigmen100 (button) folded before Flop (didn't bet)



PokerStars Hand #222952469719:  Hold'em No Limit ($0.05/$0.10 USD) - 2021/01/23 7:46:23 ET
Table 'Polydoros II' 6-max Seat #1 is the button
Seat 1: Xath76 ($18.12 in chips) 
Seat 2: Raquk ($10.05 in chips) 
Seat 3: Antonio8812 ($17 in chips) 
Seat 4: PokerMasta55 ($10 in chips) 
Seat 5: 1920kbps ($13.95 in chips) 
Seat 6: bigmen100 ($5.10 in chips) 
Raquk: posts small blind $0.05
Antonio8812: posts big blind $0.10
*** HOLE CARDS ***
PokerMasta55: folds 
1920kbps: raises $0.20 to $0.30
bigmen100: calls $0.30
Xath76: folds 
Raquk: folds 
Antonio8812: raises $0.95 to $1.25
1920kbps: folds 
bigmen100: folds 
Uncalled bet ($0.95) returned to Antonio8812
Antonio8812 collected $0.95 from pot
Antonio8812: doesn't show hand 
*** SUMMARY ***
Total pot $0.95 | Rake $0 
Seat 1: Xath76 (button) folded before Flop (didn't bet)
Seat 2: Raquk (small blind) folded before Flop
Seat 3: Antonio8812 (big blind) collected ($0.95)
Seat 4: PokerMasta55 folded before Flop (didn't bet)
Seat 5: 1920kbps folded before Flop
Seat 6: bigmen100 folded before Flop



PokerStars Hand #222952486149:  Hold'em No Limit ($0.05/$0.10 USD) - 2021/01/23 7:47:05 ET
Table 'Polydoros II' 6-max Seat #2 is the button
Seat 1: Xath76 ($18.12 in chips) 
Seat 2: Raquk ($10 in chips) 
Seat 3: Antonio8812 ($17.65 in chips) 
Seat 4: PokerMasta55 ($10 in chips) 
Seat 5: 1920kbps ($13.65 in chips) 
Seat 6: bigmen100 ($4.80 in chips) 
Antonio8812: posts small blind $0.05
PokerMasta55: posts big blind $0.10
*** HOLE CARDS ***
1920kbps: folds 
bigmen100: folds 
Xath76: raises $0.20 to $0.30
Raquk: raises $0.20 to $0.50
Antonio8812: folds 
PokerMasta55: folds 
Xath76: folds 
Uncalled bet ($0.20) returned to Raquk
Raquk collected $0.75 from pot
Raquk: doesn't show hand 
*** SUMMARY ***
Total pot $0.75 | Rake $0 
Seat 1: Xath76 folded before Flop
Seat 2: Raquk (button) collected ($0.75)
Seat 3: Antonio8812 (small blind) folded before Flop
Seat 4: PokerMasta55 (big blind) folded before Flop
Seat 5: 1920kbps folded before Flop (didn't bet)
Seat 6: bigmen100 folded before Flop (didn't bet)



PokerStars Hand #222952500032:  Hold'em No Limit ($0.05/$0.10 USD) - 2021/01/23 7:47:42 ET
Table 'Polydoros II' 6-max Seat #3 is the button
Seat 1: Xath76 ($17.82 in chips) 
Seat 2: Raquk ($10.45 in chips) 
Seat 3: Antonio8812 ($17.60 in chips) 
Seat 4: PokerMasta55 ($10 in chips) 
Seat 5: 1920kbps ($13.65 in chips) 
Seat 6: bigmen100 ($4.80 in chips) 
PokerMasta55: posts small blind $0.05
1920kbps: posts big blind $0.10
*** HOLE CARDS ***
bigmen100: folds 
Xath76: folds 
Raquk: raises $0.30 to $0.40
Antonio8812: folds 
PokerMasta55: folds 
1920kbps: folds 
Uncalled bet ($0.30) returned to Raquk
Raquk collected $0.25 from pot
Raquk: doesn't show hand 
*** SUMMARY ***
Total pot $0.25 | Rake $0 
Seat 1: Xath76 folded before Flop (didn't bet)
Seat 2: Raquk collected ($0.25)
Seat 3: Antonio8812 (button) folded before Flop (didn't bet)
Seat 4: PokerMasta55 (small blind) folded before Flop
Seat 5: 1920kbps (big blind) folded before Flop
Seat 6: bigmen100 folded before Flop (didn't bet)



PokerStars Hand #222952508346:  Hold'em No Limit ($0.05/$0.10 USD) - 2021/01/23 7:48:04 ET
Table 'Polydoros II' 6-max Seat #4 is the button
Seat 1: Xath76 ($17.82 in chips) 
Seat 2: Raquk ($10.60 in chips) 
Seat 3: Antonio8812 ($17.60 in chips) 
Seat 4: PokerMasta55 ($10 in chips) 
Seat 5: 1920kbps ($13.55 in chips) 
Seat 6: bigmen100 ($4.80 in chips) 
1920kbps: posts small blind $0.05
bigmen100: posts big blind $0.10
*** HOLE CARDS ***
Xath76: folds 
Raquk: folds 
Antonio8812: folds 
PokerMasta55: raises $0.15 to $0.25
1920kbps: raises $0.75 to $1
bigmen100: folds 
PokerMasta55: folds 
Uncalled bet ($0.75) returned to 1920kbps
1920kbps collected $0.60 from pot
*** SUMMARY ***
Total pot $0.60 | Rake $0 
Seat 1: Xath76 folded before Flop (didn't bet)
Seat 2: Raquk folded before Flop (didn't bet)
Seat 3: Antonio8812 folded before Flop (didn't bet)
Seat 4: PokerMasta55 (button) folded before Flop
Seat 5: 1920kbps (small blind) collected ($0.60)
Seat 6: bigmen100 (big blind) folded before Flop



PokerStars Hand #222952517250:  Hold'em No Limit ($0.05/$0.10 USD) - 2021/01/23 7:48:27 ET
Table 'Polydoros II' 6-max Seat #5 is the button
Seat 1: Xath76 ($17.82 in chips) 
Seat 2: Raquk ($10.60 in chips) 
Seat 3: Antonio8812 ($17.60 in chips) 
Seat 4: PokerMasta55 ($10 in chips) 
Seat 5: 1920kbps ($13.90 in chips) 
Seat 6: bigmen100 ($4.70 in chips) 
bigmen100: posts small blind $0.05
Xath76: posts big blind $0.10
*** HOLE CARDS ***
Raquk: folds 
Antonio8812: folds 
PokerMasta55: raises $0.20 to $0.30
1920kbps: folds 
bigmen100: folds 
Xath76: folds 
Uncalled bet ($0.20) returned to PokerMasta55
PokerMasta55 collected $0.25 from pot
PokerMasta55: doesn't show hand 
*** SUMMARY ***
Total pot $0.25 | Rake $0 
Seat 1: Xath76 (big blind) folded before Flop
Seat 2: Raquk folded before Flop (didn't bet)
Seat 3: Antonio8812 folded before Flop (didn't bet)
Seat 4: PokerMasta55 collected ($0.25)
Seat 5: 1920kbps (button) folded before Flop (didn't bet)
Seat 6: bigmen100 (small blind) folded before Flop



PokerStars Hand #222952523972:  Hold'em No Limit ($0.05/$0.10 USD) - 2021/01/23 7:48:44 ET
Table 'Polydoros II' 6-max Seat #6 is the button
Seat 1: Xath76 ($17.72 in chips) 
Seat 2: Raquk ($10.60 in chips) 
Seat 3: Antonio8812 ($17.60 in chips) 
Seat 4: PokerMasta55 ($10.15 in chips) 
Seat 5: 1920kbps ($13.90 in chips) 
Seat 6: bigmen100 ($4.65 in chips) 
Xath76: posts small blind $0.05
Raquk: posts big blind $0.10
*** HOLE CARDS ***
Antonio8812: raises $0.20 to $0.30
PokerMasta55: folds 
1920kbps: calls $0.30
bigmen100: folds 
Xath76: calls $0.25
Raquk: folds 
*** FLOP *** [7s Qd 2h]
Xath76: checks 
Antonio8812: checks 
1920kbps: checks 
*** TURN *** [7s Qd 2h] [Ah]
Xath76: bets $0.48
Antonio8812: folds 
1920kbps: folds 
Uncalled bet ($0.48) returned to Xath76
Xath76 collected $0.96 from pot
Xath76: doesn't show hand 
*** SUMMARY ***
Total pot $1 | Rake $0.04 
Board [7s Qd 2h Ah]
Seat 1: Xath76 (small blind) collected ($0.96)
Seat 2: Raquk (big blind) folded before Flop
Seat 3: Antonio8812 folded on the Turn
Seat 4: PokerMasta55 folded before Flop (didn't bet)
Seat 5: 1920kbps folded on the Turn
Seat 6: bigmen100 (button) folded before Flop (didn't bet)



PokerStars Hand #222952540664:  Hold'em No Limit ($0.05/$0.10 USD) - 2021/01/23 7:49:28 ET
Table 'Polydoros II' 6-max Seat #1 is the button
Seat 1: Xath76 ($18.38 in chips) 
Seat 2: Raquk ($10.50 in chips) 
Seat 3: Antonio8812 ($17.30 in chips) 
Seat 4: PokerMasta55 ($10.15 in chips) 
Seat 5: 1920kbps ($13.60 in chips) 
Seat 6: bigmen100 ($4.65 in chips) 
Raquk: posts small blind $0.05
Antonio8812: posts big blind $0.10
*** HOLE CARDS ***
PokerMasta55: folds 
1920kbps: folds 
bigmen100: folds 
Xath76: folds 
Raquk: raises $0.20 to $0.30
Antonio8812: folds 
Uncalled bet ($0.20) returned to Raquk
Raquk collected $0.20 from pot
Raquk: doesn't show hand 
*** SUMMARY ***
Total pot $0.20 | Rake $0 
Seat 1: Xath76 (button) folded before Flop (didn't bet)
Seat 2: Raquk (small blind) collected ($0.20)
Seat 3: Antonio8812 (big blind) folded before Flop
Seat 4: PokerMasta55 folded before Flop (didn't bet)
Seat 5: 1920kbps folded before Flop (didn't bet)
Seat 6: bigmen100 folded before Flop (didn't bet)



PokerStars Hand #222952546759:  Hold'em No Limit ($0.05/$0.10 USD) - 2021/01/23 7:49:44 ET
Table 'Polydoros II' 6-max Seat #2 is the button
Seat 1: Xath76 ($18.38 in chips) 
Seat 2: Raquk ($10.60 in chips) 
Seat 3: Antonio8812 ($17.20 in chips) 
Seat 5: 1920kbps ($13.60 in chips) 
Seat 6: bigmen100 ($4.65 in chips) 
Antonio8812: posts small blind $0.05
PokerMasta55: is sitting out 
1920kbps: posts big blind $0.10
*** HOLE CARDS ***
bigmen100: folds 
Xath76: folds 
PokerMasta55 leaves the table
Raquk: raises $0.30 to $0.40
Antonio8812: folds 
1920kbps: raises $7.30 to $7.70
Raquk: folds 
Uncalled bet ($7.30) returned to 1920kbps
1920kbps collected $0.85 from pot
*** SUMMARY ***
Total pot $0.85 | Rake $0 
Seat 1: Xath76 folded before Flop (didn't bet)
Seat 2: Raquk (button) folded before Flop
Seat 3: Antonio8812 (small blind) folded before Flop
Seat 5: 1920kbps (big blind) collected ($0.85)
Seat 6: bigmen100 folded before Flop (didn't bet)



PokerStars Hand #222952555835:  Hold'em No Limit ($0.05/$0.10 USD) - 2021/01/23 7:50:07 ET
Table 'Polydoros II' 6-max Seat #3 is the button
Seat 1: Xath76 ($18.38 in chips) 
Seat 2: Raquk ($10.20 in chips) 
Seat 3: Antonio8812 ($17.15 in chips) 
Seat 5: 1920kbps ($14.05 in chips) 
Seat 6: bigmen100 ($4.65 in chips) 
1920kbps: posts small blind $0.05
bigmen100: posts big blind $0.10
*** HOLE CARDS ***
Xath76: folds 
Raquk: raises $0.20 to $0.30
Antonio8812: folds 
1920kbps: folds 
Notatur joins the table at seat #4 
bigmen100: calls $0.20
*** FLOP *** [Ks 3d Qd]
bigmen100: checks 
Raquk: bets $0.50
bigmen100: folds 
Uncalled bet ($0.50) returned to Raquk
Raquk collected $0.62 from pot
Raquk: doesn't show hand 
*** SUMMARY ***
Total pot $0.65 | Rake $0.03 
Board [Ks 3d Qd]
Seat 1: Xath76 folded before Flop (didn't bet)
Seat 2: Raquk collected ($0.62)
Seat 3: Antonio8812 (button) folded before Flop (didn't bet)
Seat 5: 1920kbps (small blind) folded before Flop
Seat 6: bigmen100 (big blind) folded on the Flop



PokerStars Hand #222952573877:  Hold'em No Limit ($0.05/$0.10 USD) - 2021/01/23 7:50:54 ET
Table 'Polydoros II' 6-max Seat #5 is the button
Seat 1: Xath76 ($18.38 in chips) 
Seat 2: Raquk ($10.52 in chips) 
Seat 3: Antonio8812 ($17.15 in chips) 
Seat 5: 1920kbps ($14 in chips) 
Seat 6: bigmen100 ($4.35 in chips) 
bigmen100: posts small blind $0.05
Xath76: posts big blind $0.10
Notatur: sits out 
*** HOLE CARDS ***
Raquk: calls $0.10
Antonio8812: folds 
1920kbps: folds 
bigmen100: raises $0.40 to $0.50
Xath76: folds 
Raquk: folds 
Uncalled bet ($0.40) returned to bigmen100
bigmen100 collected $0.30 from pot
*** SUMMARY ***
Total pot $0.30 | Rake $0 
Seat 1: Xath76 (big blind) folded before Flop
Seat 2: Raquk folded before Flop
Seat 3: Antonio8812 folded before Flop (didn't bet)
Seat 5: 1920kbps (button) folded before Flop (didn't bet)
Seat 6: bigmen100 (small blind) collected ($0.30)



PokerStars Hand #222952580498:  Hold'em No Limit ($0.05/$0.10 USD) - 2021/01/23 7:51:11 ET
Table 'Polydoros II' 6-max Seat #6 is the button
Seat 1: Xath76 ($18.28 in chips) 
Seat 2: Raquk ($10.42 in chips) 
Seat 3: Antonio8812 ($17.15 in chips) 
Seat 5: 1920kbps ($14 in chips) 
Seat 6: bigmen100 ($4.55 in chips) 
Xath76: posts small blind $0.05
Raquk: posts big blind $0.10
Notatur: sits out 
*** HOLE CARDS ***
Antonio8812: folds 
1920kbps: folds 
bigmen100: raises $0.20 to $0.30
Xath76: folds 
Raquk: calls $0.20
*** FLOP *** [Qc 5h 8h]
Raquk: bets $0.50
bigmen100: calls $0.50
*** TURN *** [Qc 5h 8h] [5s]
Raquk: bets $0.50
bigmen100: calls $0.50
*** RIVER *** [Qc 5h 8h 5s] [4h]
Raquk: bets $3.30
bigmen100: folds 
Uncalled bet ($3.30) returned to Raquk
Raquk collected $2.53 from pot
Raquk: doesn't show hand 
*** SUMMARY ***
Total pot $2.65 | Rake $0.12 
Board [Qc 5h 8h 5s 4h]
Seat 1: Xath76 (small blind) folded before Flop
Seat 2: Raquk (big blind) collected ($2.53)
Seat 3: Antonio8812 folded before Flop (didn't bet)
Seat 5: 1920kbps folded before Flop (didn't bet)
Seat 6: bigmen100 (button) folded on the River



PokerStars Hand #222952615229:  Hold'em No Limit ($0.05/$0.10 USD) - 2021/01/23 7:52:41 ET
Table 'Polydoros II' 6-max Seat #1 is the button
Seat 1: Xath76 ($18.23 in chips) 
Seat 2: Raquk ($11.65 in chips) 
Seat 3: Antonio8812 ($17.15 in chips) 
Seat 5: 1920kbps ($14 in chips) 
Seat 6: bigmen100 ($3.25 in chips) 
Raquk: posts small blind $0.05
Antonio8812: posts big blind $0.10
Notatur: sits out 
*** HOLE CARDS ***
1920kbps: raises $0.20 to $0.30
bigmen100: folds 
Xath76: folds 
Raquk: folds 
Antonio8812: folds 
Uncalled bet ($0.20) returned to 1920kbps
1920kbps collected $0.25 from pot
*** SUMMARY ***
Total pot $0.25 | Rake $0 
Seat 1: Xath76 (button) folded before Flop (didn't bet)
Seat 2: Raquk (small blind) folded before Flop
Seat 3: Antonio8812 (big blind) folded before Flop
Seat 5: 1920kbps collected ($0.25)
Seat 6: bigmen100 folded before Flop (didn't bet)



PokerStars Hand #222952619902:  Hold'em No Limit ($0.05/$0.10 USD) - 2021/01/23 7:52:54 ET
Table 'Polydoros II' 6-max Seat #2 is the button
Seat 1: Xath76 ($18.23 in chips) 
Seat 2: Raquk ($11.60 in chips) 
Seat 3: Antonio8812 ($17.05 in chips) 
Seat 4: Notatur ($10 in chips) 
Seat 5: 1920kbps ($14.15 in chips) 
Seat 6: bigmen100 ($3.25 in chips) 
Antonio8812: posts small blind $0.05
Notatur: posts big blind $0.10
*** HOLE CARDS ***
1920kbps: folds 
bigmen100: raises $0.20 to $0.30
Xath76: folds 
Raquk: folds 
Antonio8812: folds 
Notatur: folds 
Uncalled bet ($0.20) returned to bigmen100
bigmen100 collected $0.25 from pot
*** SUMMARY ***
Total pot $0.25 | Rake $0 
Seat 1: Xath76 folded before Flop (didn't bet)
Seat 2: Raquk (button) folded before Flop (didn't bet)
Seat 3: Antonio8812 (small blind) folded before Flop
Seat 4: Notatur (big blind) folded before Flop
Seat 5: 1920kbps folded before Flop (didn't bet)
Seat 6: bigmen100 collected ($0.25)



PokerStars Hand #222952626721:  Hold'em No Limit ($0.05/$0.10 USD) - 2021/01/23 7:53:11 ET
Table 'Polydoros II' 6-max Seat #3 is the button
Seat 1: Xath76 ($18.23 in chips) 
Seat 2: Raquk ($11.60 in chips) 
Seat 3: Antonio8812 ($17 in chips) 
Seat 4: Notatur ($10 in chips) 
Seat 5: 1920kbps ($14.15 in chips) 
Seat 6: bigmen100 ($3.40 in chips) 
Notatur: posts small blind $0.05
1920kbps: posts big blind $0.10
*** HOLE CARDS ***
bigmen100: folds 
Xath76: folds 
Raquk: raises $0.30 to $0.40
Antonio8812: folds 
Notatur: folds 
1920kbps: folds 
Uncalled bet ($0.30) returned to Raquk
Raquk collected $0.25 from pot
Raquk: doesn't show hand 
*** SUMMARY ***
Total pot $0.25 | Rake $0 
Seat 1: Xath76 folded before Flop (didn't bet)
Seat 2: Raquk collected ($0.25)
Seat 3: Antonio8812 (button) folded before Flop (didn't bet)
Seat 4: Notatur (small blind) folded before Flop
Seat 5: 1920kbps (big blind) folded before Flop
Seat 6: bigmen100 folded before Flop (didn't bet)



PokerStars Hand #222952632632:  Hold'em No Limit ($0.05/$0.10 USD) - 2021/01/23 7:53:26 ET
Table 'Polydoros II' 6-max Seat #4 is the button
Seat 1: Xath76 ($18.23 in chips) 
Seat 2: Raquk ($11.75 in chips) 
Seat 3: Antonio8812 ($17 in chips) 
Seat 4: Notatur ($10 in chips) 
Seat 5: 1920kbps ($14.05 in chips) 
Seat 6: bigmen100 ($3.40 in chips) 
1920kbps: posts small blind $0.05
bigmen100: posts big blind $0.10
*** HOLE CARDS ***
Xath76: raises $0.20 to $0.30
Raquk: folds 
Antonio8812: folds 
Notatur: folds 
1920kbps: calls $0.25
bigmen100: calls $0.20
*** FLOP *** [2s 9c 9h]
1920kbps: checks 
bigmen100: checks 
Xath76: bets $0.43
1920kbps: folds 
bigmen100: folds 
Uncalled bet ($0.43) returned to Xath76
Xath76 collected $0.86 from pot
Xath76: doesn't show hand 
*** SUMMARY ***
Total pot $0.90 | Rake $0.04 
Board [2s 9c 9h]
Seat 1: Xath76 collected ($0.86)
Seat 2: Raquk folded before Flop (didn't bet)
Seat 3: Antonio8812 folded before Flop (didn't bet)
Seat 4: Notatur (button) folded before Flop (didn't bet)
Seat 5: 1920kbps (small blind) folded on the Flop
Seat 6: bigmen100 (big blind) folded on the Flop



PokerStars Hand #222952649950:  Hold'em No Limit ($0.05/$0.10 USD) - 2021/01/23 7:54:11 ET
Table 'Polydoros II' 6-max Seat #5 is the button
Seat 1: Xath76 ($18.79 in chips) 
Seat 2: Raquk ($11.75 in chips) 
Seat 3: Antonio8812 ($17 in chips) 
Seat 4: Notatur ($10 in chips) 
Seat 5: 1920kbps ($13.75 in chips) 
Seat 6: bigmen100 ($3.10 in chips) 
bigmen100: posts small blind $0.05
Xath76: posts big blind $0.10
*** HOLE CARDS ***
Raquk: raises $0.20 to $0.30
Antonio8812: folds 
Notatur: folds 
1920kbps: calls $0.30
bigmen100: folds 
Xath76: folds 
*** FLOP *** [6c Qs Jc]
Raquk: bets $0.50
1920kbps: folds 
Uncalled bet ($0.50) returned to Raquk
Raquk collected $0.72 from pot
Raquk: doesn't show hand 
*** SUMMARY ***
Total pot $0.75 | Rake $0.03 
Board [6c Qs Jc]
Seat 1: Xath76 (big blind) folded before Flop
Seat 2: Raquk collected ($0.72)
Seat 3: Antonio8812 folded before Flop (didn't bet)
Seat 4: Notatur folded before Flop (didn't bet)
Seat 5: 1920kbps (button) folded on the Flop
Seat 6: bigmen100 (small blind) folded before Flop



PokerStars Hand #222952660532:  Hold'em No Limit ($0.05/$0.10 USD) - 2021/01/23 7:54:39 ET
Table 'Polydoros II' 6-max Seat #6 is the button
Seat 1: Xath76 ($18.69 in chips) 
Seat 2: Raquk ($12.17 in chips) 
Seat 3: Antonio8812 ($17 in chips) 
Seat 4: Notatur ($10 in chips) 
Seat 5: 1920kbps ($13.45 in chips) 
Seat 6: bigmen100 ($3.05 in chips) 
Xath76: posts small blind $0.05
Raquk: posts big blind $0.10
*** HOLE CARDS ***
Antonio8812: folds 
Notatur: folds 
1920kbps: folds 
bigmen100: folds 
Xath76: folds 
Uncalled bet ($0.05) returned to Raquk
Raquk collected $0.10 from pot
Raquk: doesn't show hand 
*** SUMMARY ***
Total pot $0.10 | Rake $0 
Seat 1: Xath76 (small blind) folded before Flop
Seat 2: Raquk (big blind) collected ($0.10)
Seat 3: Antonio8812 folded before Flop (didn't bet)
Seat 4: Notatur folded before Flop (didn't bet)
Seat 5: 1920kbps folded before Flop (didn't bet)
Seat 6: bigmen100 (button) folded before Flop (didn't bet)



PokerStars Hand #222952663363:  Hold'em No Limit ($0.05/$0.10 USD) - 2021/01/23 7:54:46 ET
Table 'Polydoros II' 6-max Seat #1 is the button
Seat 1: Xath76 ($18.64 in chips) 
Seat 2: Raquk ($12.22 in chips) 
Seat 3: Antonio8812 ($17 in chips) 
Seat 4: Notatur ($10 in chips) 
Seat 5: 1920kbps ($13.45 in chips) 
Seat 6: bigmen100 ($3.05 in chips) 
Raquk: posts small blind $0.05
Antonio8812: posts big blind $0.10
*** HOLE CARDS ***
Notatur: folds 
1920kbps: raises $0.20 to $0.30
bigmen100: folds 
Xath76: calls $0.30
Raquk: folds 
Antonio8812: folds 
*** FLOP *** [Qc 8c 7s]
1920kbps: checks 
Xath76: bets $0.36
1920kbps: raises $2.44 to $2.80
Xath76: folds 
Uncalled bet ($2.44) returned to 1920kbps
1920kbps collected $1.40 from pot
*** SUMMARY ***
Total pot $1.47 | Rake $0.07 
Board [Qc 8c 7s]
Seat 1: Xath76 (button) folded on the Flop
Seat 2: Raquk (small blind) folded before Flop
Seat 3: Antonio8812 (big blind) folded before Flop
Seat 4: Notatur folded before Flop (didn't bet)
Seat 5: 1920kbps collected ($1.40)
Seat 6: bigmen100 folded before Flop (didn't bet)



PokerStars Hand #222952674167:  Hold'em No Limit ($0.05/$0.10 USD) - 2021/01/23 7:55:15 ET
Table 'Polydoros II' 6-max Seat #2 is the button
Seat 1: Xath76 ($17.98 in chips) 
Seat 2: Raquk ($12.17 in chips) 
Seat 3: Antonio8812 ($16.90 in chips) 
Seat 4: Notatur ($10 in chips) 
Seat 5: 1920kbps ($14.19 in chips) 
Seat 6: bigmen100 ($3.05 in chips) 
Antonio8812: posts small blind $0.05
Notatur: posts big blind $0.10
*** HOLE CARDS ***
1920kbps: folds 
bigmen100: folds 
Xath76: folds 
Raquk: raises $0.20 to $0.30
Antonio8812: folds 
Notatur: calls $0.20
*** FLOP *** [3s 6d 3c]
Notatur: checks 
Raquk: bets $0.50
Notatur: folds 
Uncalled bet ($0.50) returned to Raquk
Raquk collected $0.62 from pot
Raquk: doesn't show hand 
*** SUMMARY ***
Total pot $0.65 | Rake $0.03 
Board [3s 6d 3c]
Seat 1: Xath76 folded before Flop (didn't bet)
Seat 2: Raquk (button) collected ($0.62)
Seat 3: Antonio8812 (small blind) folded before Flop
Seat 4: Notatur (big blind) folded on the Flop
Seat 5: 1920kbps folded before Flop (didn't bet)
Seat 6: bigmen100 folded before Flop (didn't bet)



PokerStars Hand #222952683529:  Hold'em No Limit ($0.05/$0.10 USD) - 2021/01/23 7:55:44 ET
Table 'Polydoros II' 6-max Seat #3 is the button
Seat 1: Xath76 ($17.98 in chips) 
Seat 2: Raquk ($12.49 in chips) 
Seat 3: Antonio8812 ($16.85 in chips) 
Seat 4: Notatur ($10 in chips) 
Seat 5: 1920kbps ($14.19 in chips) 
Seat 6: bigmen100 ($3.05 in chips) 
Notatur: posts small blind $0.05
1920kbps: posts big blind $0.10
*** HOLE CARDS ***
bigmen100: folds 
Xath76: folds 
Raquk: raises $0.20 to $0.30
Antonio8812: folds 
Notatur: folds 
1920kbps: folds 
Uncalled bet ($0.20) returned to Raquk
Raquk collected $0.25 from pot
Raquk: doesn't show hand 
*** SUMMARY ***
Total pot $0.25 | Rake $0 
Seat 1: Xath76 folded before Flop (didn't bet)
Seat 2: Raquk collected ($0.25)
Seat 3: Antonio8812 (button) folded before Flop (didn't bet)
Seat 4: Notatur (small blind) folded before Flop
Seat 5: 1920kbps (big blind) folded before Flop
Seat 6: bigmen100 folded before Flop (didn't bet)



PokerStars Hand #222952690848:  Hold'em No Limit ($0.05/$0.10 USD) - 2021/01/23 7:56:06 ET
Table 'Polydoros II' 6-max Seat #4 is the button
Seat 1: Xath76 ($17.98 in chips) 
Seat 2: Raquk ($12.64 in chips) 
Seat 3: Antonio8812 ($16.85 in chips) 
Seat 4: Notatur ($10 in chips) 
Seat 5: 1920kbps ($14.09 in chips) 
Seat 6: bigmen100 ($3.05 in chips) 
1920kbps: posts small blind $0.05
bigmen100: posts big blind $0.10
*** HOLE CARDS ***
Xath76: folds 
Raquk: calls $0.10
Antonio8812: folds 
Notatur: raises $0.30 to $0.40
1920kbps: folds 
bigmen100: calls $0.30
Raquk: folds 
*** FLOP *** [3s Tc 8d]
bigmen100: checks 
Notatur: bets $0.50
bigmen100: calls $0.50
*** TURN *** [3s Tc 8d] [9d]
bigmen100: checks 
Notatur: checks 
*** RIVER *** [3s Tc 8d 9d] [Jh]
bigmen100: bets $1.10
Notatur: raises $2.23 to $3.33
bigmen100: calls $1.05 and is all-in
Uncalled bet ($1.18) returned to Notatur
*** SHOW DOWN ***
Notatur: shows [Qd Ad] (a straight, Eight to Queen)
bigmen100: shows [9h Qh] (a straight, Eight to Queen)
bigmen100 collected $2.99 from pot
Notatur collected $2.98 from pot
*** SUMMARY ***
Total pot $6.25 | Rake $0.28 
Board [3s Tc 8d 9d Jh]
Seat 1: Xath76 folded before Flop (didn't bet)
Seat 2: Raquk folded before Flop
Seat 3: Antonio8812 folded before Flop (didn't bet)
Seat 4: Notatur (button) showed [Qd Ad] and won ($2.98) with a straight, Eight to Queen
Seat 5: 1920kbps (small blind) folded before Flop
Seat 6: bigmen100 (big blind) showed [9h Qh] and won ($2.99) with a straight, Eight to Queen



PokerStars Hand #222952720929:  Hold'em No Limit ($0.05/$0.10 USD) - 2021/01/23 7:57:38 ET
Table 'Polydoros II' 6-max Seat #5 is the button
Seat 1: Xath76 ($17.98 in chips) 
Seat 2: Raquk ($12.54 in chips) 
Seat 3: Antonio8812 ($16.85 in chips) 
Seat 4: Notatur ($10 in chips) 
Seat 5: 1920kbps ($14.04 in chips) 
Seat 6: bigmen100 ($2.99 in chips) 
bigmen100: posts small blind $0.05
Xath76: posts big blind $0.10
*** HOLE CARDS ***
Raquk: folds 
Antonio8812: folds 
Notatur: folds 
1920kbps: raises $0.20 to $0.30
bigmen100: raises $1 to $1.30
Xath76: folds 
1920kbps: folds 
Uncalled bet ($1) returned to bigmen100
bigmen100 collected $0.70 from pot
*** SUMMARY ***
Total pot $0.70 | Rake $0 
Seat 1: Xath76 (big blind) folded before Flop
Seat 2: Raquk folded before Flop (didn't bet)
Seat 3: Antonio8812 folded before Flop (didn't bet)
Seat 4: Notatur folded before Flop (didn't bet)
Seat 5: 1920kbps (button) folded before Flop
Seat 6: bigmen100 (small blind) collected ($0.70)



PokerStars Hand #222952734371:  Hold'em No Limit ($0.05/$0.10 USD) - 2021/01/23 7:58:19 ET
Table 'Polydoros II' 6-max Seat #6 is the button
Seat 1: Xath76 ($17.88 in chips) 
Seat 2: Raquk ($12.54 in chips) 
Seat 3: Antonio8812 ($16.85 in chips) 
Seat 4: Notatur ($10 in chips) 
Seat 5: 1920kbps ($13.74 in chips) 
Seat 6: bigmen100 ($3.39 in chips) 
Xath76: posts small blind $0.05
Raquk: posts big blind $0.10
*** HOLE CARDS ***
Antonio8812: folds 
Notatur: raises $0.15 to $0.25
1920kbps: folds 
bigmen100: folds 
Xath76: calls $0.20
Raquk: raises $0.25 to $0.50
Notatur: calls $0.25
Xath76: calls $0.25
*** FLOP *** [3s 4d Jd]
Xath76: checks 
Raquk: bets $0.30
Notatur: calls $0.30
Xath76: calls $0.30
*** TURN *** [3s 4d Jd] [Js]
Xath76: checks 
Raquk: bets $0.50
Notatur: folds 
Xath76: calls $0.50
*** RIVER *** [3s 4d Jd Js] [4h]
Xath76: checks 
Raquk: bets $0.50
Xath76: raises $2.13 to $2.63
Raquk: folds 
Uncalled bet ($2.13) returned to Xath76
Xath76 collected $4.20 from pot
Xath76: doesn't show hand 
*** SUMMARY ***
Total pot $4.40 | Rake $0.20 
Board [3s 4d Jd Js 4h]
Seat 1: Xath76 (small blind) collected ($4.20)
Seat 2: Raquk (big blind) folded on the River
Seat 3: Antonio8812 folded before Flop (didn't bet)
Seat 4: Notatur folded on the Turn
Seat 5: 1920kbps folded before Flop (didn't bet)
Seat 6: bigmen100 (button) folded before Flop (didn't bet)



PokerStars Hand #222952768654:  Hold'em No Limit ($0.05/$0.10 USD) - 2021/01/23 8:00:04 ET
Table 'Polydoros II' 6-max Seat #1 is the button
Seat 1: Xath76 ($20.28 in chips) 
Seat 2: Raquk ($10.74 in chips) 
Seat 3: Antonio8812 ($16.85 in chips) 
Seat 4: Notatur ($10 in chips) 
Seat 5: 1920kbps ($13.74 in chips) 
Seat 6: bigmen100 ($3.39 in chips) 
Raquk: posts small blind $0.05
Antonio8812: posts big blind $0.10
*** HOLE CARDS ***
Notatur: folds 
1920kbps: folds 
bigmen100: folds 
Xath76: folds 
Raquk: raises $0.20 to $0.30
Antonio8812: folds 
Uncalled bet ($0.20) returned to Raquk
Raquk collected $0.20 from pot
Raquk: doesn't show hand 
*** SUMMARY ***
Total pot $0.20 | Rake $0 
Seat 1: Xath76 (button) folded before Flop (didn't bet)
Seat 2: Raquk (small blind) collected ($0.20)
Seat 3: Antonio8812 (big blind) folded before Flop
Seat 4: Notatur folded before Flop (didn't bet)
Seat 5: 1920kbps folded before Flop (didn't bet)
Seat 6: bigmen100 folded before Flop (didn't bet)



PokerStars Hand #222952775880:  Hold'em No Limit ($0.05/$0.10 USD) - 2021/01/23 8:00:25 ET
Table 'Polydoros II' 6-max Seat #2 is the button
Seat 1: Xath76 ($20.28 in chips) 
Seat 2: Raquk ($10.84 in chips) 
Seat 3: Antonio8812 ($16.75 in chips) 
Seat 4: Notatur ($10 in chips) 
Seat 5: 1920kbps ($13.74 in chips) 
Seat 6: bigmen100 ($3.39 in chips) 
Antonio8812: posts small blind $0.05
Notatur: posts big blind $0.10
*** HOLE CARDS ***
1920kbps: folds 
bigmen100: raises $0.20 to $0.30
Xath76: folds 
Raquk: raises $0.20 to $0.50
Antonio8812: folds 
Notatur: folds 
bigmen100: calls $0.20
*** FLOP *** [Js 5d 7h]
bigmen100: checks 
Raquk: bets $0.40
bigmen100: calls $0.40
*** TURN *** [Js 5d 7h] [Td]
bigmen100: checks 
Raquk: bets $0.40
bigmen100: raises $1.10 to $1.50
Raquk: calls $1.10
*** RIVER *** [Js 5d 7h Td] [Ad]
bigmen100: bets $0.99 and is all-in
Raquk: calls $0.99
*** SHOW DOWN ***
bigmen100: shows [Kh Th] (a pair of Tens)
Raquk: shows [Jc Jh] (three of a kind, Jacks)
Raquk collected $6.62 from pot
*** SUMMARY ***
Total pot $6.93 | Rake $0.31 
Board [Js 5d 7h Td Ad]
Seat 1: Xath76 folded before Flop (didn't bet)
Seat 2: Raquk (button) showed [Jc Jh] and won ($6.62) with three of a kind, Jacks
Seat 3: Antonio8812 (small blind) folded before Flop
Seat 4: Notatur (big blind) folded before Flop
Seat 5: 1920kbps folded before Flop (didn't bet)
Seat 6: bigmen100 showed [Kh Th] and lost with a pair of Tens



PokerStars Hand #222952804944:  Hold'em No Limit ($0.05/$0.10 USD) - 2021/01/23 8:01:44 ET
Table 'Polydoros II' 6-max Seat #3 is the button
Seat 1: Xath76 ($20.28 in chips) 
Seat 2: Raquk ($14.07 in chips) 
Seat 3: Antonio8812 ($16.70 in chips) 
Seat 4: Notatur ($10 in chips) 
Seat 5: 1920kbps ($13.74 in chips) 
Notatur: posts small blind $0.05
1920kbps: posts big blind $0.10
*** HOLE CARDS ***
Xath76: folds 
bigmen100 leaves the table
Raquk: folds 
Antonio8812: raises $0.20 to $0.30
Notatur: folds 
1920kbps: calls $0.20
*** FLOP *** [Tc As 6h]
1920kbps: checks 
Brobat45 joins the table at seat #6 
Antonio8812: bets $0.31
1920kbps: calls $0.31
*** TURN *** [Tc As 6h] [Js]
1920kbps: checks 
Antonio8812: checks 
*** RIVER *** [Tc As 6h Js] [9c]
Brobat45 leaves the table
1920kbps: bets $0.90
Antonio8812: calls $0.90
*** SHOW DOWN ***
1920kbps: shows [Jd Ah] (two pair, Aces and Jacks)
Antonio8812: mucks hand 
1920kbps collected $2.93 from pot
*** SUMMARY ***
Total pot $3.07 | Rake $0.14 
Board [Tc As 6h Js 9c]
Seat 1: Xath76 folded before Flop (didn't bet)
Seat 2: Raquk folded before Flop (didn't bet)
Seat 3: Antonio8812 (button) mucked
Seat 4: Notatur (small blind) folded before Flop
Seat 5: 1920kbps (big blind) showed [Jd Ah] and won ($2.93) with two pair, Aces and Jacks



PokerStars Hand #222952825747:  Hold'em No Limit ($0.05/$0.10 USD) - 2021/01/23 8:02:26 ET
Table 'Polydoros II' 6-max Seat #4 is the button
Seat 1: Xath76 ($20.28 in chips) 
Seat 2: Raquk ($14.07 in chips) 
Seat 3: Antonio8812 ($15.19 in chips) 
Seat 4: Notatur ($10 in chips) 
Seat 5: 1920kbps ($15.16 in chips) 
1920kbps: posts small blind $0.05
Xath76: posts big blind $0.10
*** HOLE CARDS ***
ivan2772ms joins the table at seat #6 
Raquk: folds 
Antonio8812: folds 
Notatur: calls $0.10
1920kbps: folds 
Xath76: checks 
*** FLOP *** [Kh 7d 3c]
Xath76: checks 
Notatur: checks 
*** TURN *** [Kh 7d 3c] [Th]
Xath76: checks 
Notatur: checks 
*** RIVER *** [Kh 7d 3c Th] [7c]
Xath76: bets $0.24
Notatur: calls $0.24
*** SHOW DOWN ***
Xath76: shows [7h 5c] (three of a kind, Sevens)
Notatur: mucks hand 
Xath76 collected $0.70 from pot
*** SUMMARY ***
Total pot $0.73 | Rake $0.03 
Board [Kh 7d 3c Th 7c]
Seat 1: Xath76 (big blind) showed [7h 5c] and won ($0.70) with three of a kind, Sevens
Seat 2: Raquk folded before Flop (didn't bet)
Seat 3: Antonio8812 folded before Flop (didn't bet)
Seat 4: Notatur (button) mucked
Seat 5: 1920kbps (small blind) folded before Flop



PokerStars Hand #222952844891:  Hold'em No Limit ($0.05/$0.10 USD) - 2021/01/23 8:03:14 ET
Table 'Polydoros II' 6-max Seat #5 is the button
Seat 1: Xath76 ($20.64 in chips) 
Seat 2: Raquk ($14.07 in chips) 
Seat 3: Antonio8812 ($15.19 in chips) 
Seat 4: Notatur ($10 in chips) 
Seat 5: 1920kbps ($15.11 in chips) 
Xath76: posts small blind $0.05
Raquk: posts big blind $0.10
*** HOLE CARDS ***
Antonio8812: folds 
Notatur: folds 
1920kbps: folds 
Xath76: raises $0.20 to $0.30
Raquk: calls $0.20
*** FLOP *** [8s 4s Jd]
Xath76: checks 
Raquk: bets $0.50
Xath76: calls $0.50
*** TURN *** [8s 4s Jd] [6d]
Xath76: checks 
Raquk: bets $0.50
Xath76: calls $0.50
*** RIVER *** [8s 4s Jd 6d] [7c]
Xath76: checks 
Raquk: bets $1
Xath76: calls $1
*** SHOW DOWN ***
Raquk: shows [Jc 6h] (two pair, Jacks and Sixes)
Xath76: mucks hand 
Raquk collected $4.39 from pot
*** SUMMARY ***
Total pot $4.60 | Rake $0.21 
Board [8s 4s Jd 6d 7c]
Seat 1: Xath76 (small blind) mucked
Seat 2: Raquk (big blind) showed [Jc 6h] and won ($4.39) with two pair, Jacks and Sixes
Seat 3: Antonio8812 folded before Flop (didn't bet)
Seat 4: Notatur folded before Flop (didn't bet)
Seat 5: 1920kbps (button) folded before Flop (didn't bet)



PokerStars Hand #222952879618:  Hold'em No Limit ($0.05/$0.10 USD) - 2021/01/23 8:04:41 ET
Table 'Polydoros II' 6-max Seat #1 is the button
Seat 1: Xath76 ($18.34 in chips) 
Seat 2: Raquk ($16.16 in chips) 
Seat 3: Antonio8812 ($15.19 in chips) 
Seat 4: Notatur ($10 in chips) 
Seat 5: 1920kbps ($15.11 in chips) 
Raquk: posts small blind $0.05
Antonio8812: posts big blind $0.10
ivan2772ms: sits out 
*** HOLE CARDS ***
Notatur: raises $0.15 to $0.25
1920kbps: folds 
Xath76: calls $0.25
Raquk: folds 
Antonio8812: folds 
*** FLOP *** [5d 6h 5s]
Notatur: bets $0.34
Xath76: folds 
Uncalled bet ($0.34) returned to Notatur
Notatur collected $0.62 from pot
Notatur: doesn't show hand 
*** SUMMARY ***
Total pot $0.65 | Rake $0.03 
Board [5d 6h 5s]
Seat 1: Xath76 (button) folded on the Flop
Seat 2: Raquk (small blind) folded before Flop
Seat 3: Antonio8812 (big blind) folded before Flop
Seat 4: Notatur collected ($0.62)
Seat 5: 1920kbps folded before Flop (didn't bet)



PokerStars Hand #222952888920:  Hold'em No Limit ($0.05/$0.10 USD) - 2021/01/23 8:05:04 ET
Table 'Polydoros II' 6-max Seat #2 is the button
Seat 1: Xath76 ($18.09 in chips) 
Seat 2: Raquk ($16.11 in chips) 
Seat 3: Antonio8812 ($15.09 in chips) 
Seat 4: Notatur ($10.37 in chips) 
Seat 5: 1920kbps ($15.11 in chips) 
Antonio8812: posts small blind $0.05
Notatur: posts big blind $0.10
ivan2772ms: sits out 
*** HOLE CARDS ***
1920kbps: folds 
Xath76: folds 
Raquk: raises $0.40 to $0.50
Antonio8812: folds 
Notatur: folds 
Uncalled bet ($0.40) returned to Raquk
Raquk collected $0.25 from pot
Raquk: doesn't show hand 
*** SUMMARY ***
Total pot $0.25 | Rake $0 
Seat 1: Xath76 folded before Flop (didn't bet)
Seat 2: Raquk (button) collected ($0.25)
Seat 3: Antonio8812 (small blind) folded before Flop
Seat 4: Notatur (big blind) folded before Flop
Seat 5: 1920kbps folded before Flop (didn't bet)



PokerStars Hand #222952896608:  Hold'em No Limit ($0.05/$0.10 USD) - 2021/01/23 8:05:24 ET
Table 'Polydoros II' 6-max Seat #3 is the button
Seat 1: Xath76 ($18.09 in chips) 
Seat 2: Raquk ($16.26 in chips) 
Seat 3: Antonio8812 ($15.04 in chips) 
Seat 4: Notatur ($10.27 in chips) 
Seat 5: 1920kbps ($15.11 in chips) 
Notatur: posts small blind $0.05
1920kbps: posts big blind $0.10
ivan2772ms: sits out 
*** HOLE CARDS ***
Xath76: folds 
Raquk: raises $0.20 to $0.30
Antonio8812: folds 
Notatur: folds 
1920kbps: folds 
Uncalled bet ($0.20) returned to Raquk
Raquk collected $0.25 from pot
Raquk: doesn't show hand 
*** SUMMARY ***
Total pot $0.25 | Rake $0 
Seat 1: Xath76 folded before Flop (didn't bet)
Seat 2: Raquk collected ($0.25)
Seat 3: Antonio8812 (button) folded before Flop (didn't bet)
Seat 4: Notatur (small blind) folded before Flop
Seat 5: 1920kbps (big blind) folded before Flop



PokerStars Hand #222952905122:  Hold'em No Limit ($0.05/$0.10 USD) - 2021/01/23 8:05:45 ET
Table 'Polydoros II' 6-max Seat #4 is the button
Seat 1: Xath76 ($18.09 in chips) 
Seat 2: Raquk ($16.41 in chips) 
Seat 3: Antonio8812 ($15.04 in chips) 
Seat 4: Notatur ($10.22 in chips) 
Seat 5: 1920kbps ($15.01 in chips) 
1920kbps: posts small blind $0.05
Xath76: posts big blind $0.10
*** HOLE CARDS ***
Raquk: folds 
Antonio8812: raises $0.20 to $0.30
Notatur: folds 
1920kbps: folds 
Xath76: folds 
Uncalled bet ($0.20) returned to Antonio8812
Antonio8812 collected $0.25 from pot
Antonio8812: doesn't show hand 
*** SUMMARY ***
Total pot $0.25 | Rake $0 
Seat 1: Xath76 (big blind) folded before Flop
Seat 2: Raquk folded before Flop (didn't bet)
Seat 3: Antonio8812 collected ($0.25)
Seat 4: Notatur (button) folded before Flop (didn't bet)
Seat 5: 1920kbps (small blind) folded before Flop



PokerStars Hand #222952916223:  Hold'em No Limit ($0.05/$0.10 USD) - 2021/01/23 8:06:12 ET
Table 'Polydoros II' 6-max Seat #5 is the button
Seat 1: Xath76 ($17.99 in chips) 
Seat 2: Raquk ($16.41 in chips) 
Seat 3: Antonio8812 ($15.19 in chips) 
Seat 4: Notatur ($10.22 in chips) 
Seat 5: 1920kbps ($14.96 in chips) 
Xath76: posts small blind $0.05
Raquk: posts big blind $0.10
*** HOLE CARDS ***
Antonio8812: folds 
Notatur: folds 
1920kbps: folds 
Xath76: folds 
Uncalled bet ($0.05) returned to Raquk
Raquk collected $0.10 from pot
Raquk: doesn't show hand 
*** SUMMARY ***
Total pot $0.10 | Rake $0 
Seat 1: Xath76 (small blind) folded before Flop
Seat 2: Raquk (big blind) collected ($0.10)
Seat 3: Antonio8812 folded before Flop (didn't bet)
Seat 4: Notatur folded before Flop (didn't bet)
Seat 5: 1920kbps (button) folded before Flop (didn't bet)



PokerStars Hand #222952924398:  Hold'em No Limit ($0.05/$0.10 USD) - 2021/01/23 8:06:32 ET
Table 'Polydoros II' 6-max Seat #1 is the button
Seat 1: Xath76 ($17.94 in chips) 
Seat 2: Raquk ($16.46 in chips) 
Seat 3: Antonio8812 ($15.19 in chips) 
Seat 4: Notatur ($10.22 in chips) 
Seat 5: 1920kbps ($14.96 in chips) 
Raquk: posts small blind $0.05
Antonio8812: posts big blind $0.10
*** HOLE CARDS ***
Notatur: folds 
1920kbps: folds 
Xath76: raises $0.20 to $0.30
Raquk: raises $0.20 to $0.50
Antonio8812: folds 
Xath76: calls $0.20
*** FLOP *** [2d 2c 2s]
Raquk: bets $0.50
Xath76: calls $0.50
*** TURN *** [2d 2c 2s] [8c]
Raquk: bets $1
Xath76: folds 
Uncalled bet ($1) returned to Raquk
Raquk collected $2.01 from pot
Raquk: doesn't show hand 
*** SUMMARY ***
Total pot $2.10 | Rake $0.09 
Board [2d 2c 2s 8c]
Seat 1: Xath76 (button) folded on the Turn
Seat 2: Raquk (small blind) collected ($2.01)
Seat 3: Antonio8812 (big blind) folded before Flop
Seat 4: Notatur folded before Flop (didn't bet)
Seat 5: 1920kbps folded before Flop (didn't bet)



PokerStars Hand #222952947217:  Hold'em No Limit ($0.05/$0.10 USD) - 2021/01/23 8:07:29 ET
Table 'Polydoros II' 6-max Seat #2 is the button
Seat 1: Xath76 ($16.94 in chips) 
Seat 2: Raquk ($17.47 in chips) 
Seat 3: Antonio8812 ($15.09 in chips) 
Seat 4: Notatur ($10.22 in chips) 
Seat 5: 1920kbps ($14.96 in chips) 
Antonio8812: posts small blind $0.05
Notatur: posts big blind $0.10
*** HOLE CARDS ***
1920kbps: raises $0.20 to $0.30
Xath76: calls $0.30
Raquk: folds 
Antonio8812: folds 
Notatur: folds 
*** FLOP *** [Ad 2s Qh]
1920kbps: bets $0.40
Xath76: folds 
Uncalled bet ($0.40) returned to 1920kbps
1920kbps collected $0.72 from pot
*** SUMMARY ***
Total pot $0.75 | Rake $0.03 
Board [Ad 2s Qh]
Seat 1: Xath76 folded on the Flop
Seat 2: Raquk (button) folded before Flop (didn't bet)
Seat 3: Antonio8812 (small blind) folded before Flop
Seat 4: Notatur (big blind) folded before Flop
Seat 5: 1920kbps collected ($0.72)



PokerStars Hand #222952959727:  Hold'em No Limit ($0.05/$0.10 USD) - 2021/01/23 8:08:00 ET
Table 'Polydoros II' 6-max Seat #3 is the button
Seat 1: Xath76 ($16.64 in chips) 
Seat 2: Raquk ($17.47 in chips) 
Seat 3: Antonio8812 ($15.04 in chips) 
Seat 4: Notatur ($10.12 in chips) 
Seat 5: 1920kbps ($15.38 in chips) 
Notatur: posts small blind $0.05
1920kbps: posts big blind $0.10
*** HOLE CARDS ***
Xath76: folds 
Raquk: raises $0.20 to $0.30
Antonio8812: folds 
Notatur: folds 
1920kbps: folds 
Uncalled bet ($0.20) returned to Raquk
Raquk collected $0.25 from pot
Raquk: doesn't show hand 
*** SUMMARY ***
Total pot $0.25 | Rake $0 
Seat 1: Xath76 folded before Flop (didn't bet)
Seat 2: Raquk collected ($0.25)
Seat 3: Antonio8812 (button) folded before Flop (didn't bet)
Seat 4: Notatur (small blind) folded before Flop
Seat 5: 1920kbps (big blind) folded before Flop



PokerStars Hand #222952965959:  Hold'em No Limit ($0.05/$0.10 USD) - 2021/01/23 8:08:15 ET
Table 'Polydoros II' 6-max Seat #4 is the button
Seat 1: Xath76 ($16.64 in chips) 
Seat 2: Raquk ($17.62 in chips) 
Seat 3: Antonio8812 ($15.04 in chips) 
Seat 4: Notatur ($10.07 in chips) 
Seat 5: 1920kbps ($15.28 in chips) 
1920kbps: posts small blind $0.05
Xath76: posts big blind $0.10
*** HOLE CARDS ***
Raquk: raises $0.20 to $0.30
Antonio8812: folds 
Notatur: folds 
1920kbps: calls $0.25
Xath76: folds 
*** FLOP *** [9c 3d Th]
1920kbps: checks 
Raquk: bets $0.50
1920kbps: folds 
Uncalled bet ($0.50) returned to Raquk
Raquk collected $0.67 from pot
Raquk: doesn't show hand 
*** SUMMARY ***
Total pot $0.70 | Rake $0.03 
Board [9c 3d Th]
Seat 1: Xath76 (big blind) folded before Flop
Seat 2: Raquk collected ($0.67)
Seat 3: Antonio8812 folded before Flop (didn't bet)
Seat 4: Notatur (button) folded before Flop (didn't bet)
Seat 5: 1920kbps (small blind) folded on the Flop



PokerStars Hand #222952980635:  Hold'em No Limit ($0.05/$0.10 USD) - 2021/01/23 8:08:51 ET
Table 'Polydoros II' 6-max Seat #5 is the button
Seat 1: Xath76 ($16.54 in chips) 
Seat 2: Raquk ($17.99 in chips) 
Seat 3: Antonio8812 ($15.04 in chips) 
Seat 4: Notatur ($10.07 in chips) 
Seat 5: 1920kbps ($14.98 in chips) 
Xath76: posts small blind $0.05
Raquk: posts big blind $0.10
*** HOLE CARDS ***
Antonio8812: folds 
Notatur: raises $0.15 to $0.25
1920kbps: folds 
Xath76: folds 
Raquk: raises $0.25 to $0.50
Notatur: calls $0.25
*** FLOP *** [Jd 4d 6s]
Raquk: bets $0.50
Notatur: calls $0.50
*** TURN *** [Jd 4d 6s] [9h]
Raquk: checks 
Notatur: checks 
*** RIVER *** [Jd 4d 6s 9h] [7c]
Raquk: checks 
Notatur: checks 
*** SHOW DOWN ***
Raquk: shows [Ah Tc] (high card Ace)
Notatur: shows [8d 8h] (a pair of Eights)
Notatur collected $1.96 from pot
*** SUMMARY ***
Total pot $2.05 | Rake $0.09 
Board [Jd 4d 6s 9h 7c]
Seat 1: Xath76 (small blind) folded before Flop
Seat 2: Raquk (big blind) showed [Ah Tc] and lost with high card Ace
Seat 3: Antonio8812 folded before Flop (didn't bet)
Seat 4: Notatur showed [8d 8h] and won ($1.96) with a pair of Eights
Seat 5: 1920kbps (button) folded before Flop (didn't bet)



PokerStars Hand #222953006852:  Hold'em No Limit ($0.05/$0.10 USD) - 2021/01/23 8:09:55 ET
Table 'Polydoros II' 6-max Seat #1 is the button
Seat 1: Xath76 ($16.49 in chips) 
Seat 2: Raquk ($16.99 in chips) 
Seat 3: Antonio8812 ($15.04 in chips) 
Seat 4: Notatur ($11.03 in chips) 
Seat 5: 1920kbps ($14.98 in chips) 
Raquk: posts small blind $0.05
Antonio8812: posts big blind $0.10
*** HOLE CARDS ***
Notatur: folds 
1920kbps: folds 
Xath76: folds 
Raquk: raises $0.30 to $0.40
Antonio8812: folds 
Uncalled bet ($0.30) returned to Raquk
Raquk collected $0.20 from pot
Raquk: doesn't show hand 
*** SUMMARY ***
Total pot $0.20 | Rake $0 
Seat 1: Xath76 (button) folded before Flop (didn't bet)
Seat 2: Raquk (small blind) collected ($0.20)
Seat 3: Antonio8812 (big blind) folded before Flop
Seat 4: Notatur folded before Flop (didn't bet)
Seat 5: 1920kbps folded before Flop (didn't bet)



PokerStars Hand #222953014524:  Hold'em No Limit ($0.05/$0.10 USD) - 2021/01/23 8:10:14 ET
Table 'Polydoros II' 6-max Seat #2 is the button
Seat 1: Xath76 ($16.49 in chips) 
Seat 2: Raquk ($17.09 in chips) 
Seat 3: Antonio8812 ($14.94 in chips) 
Seat 5: 1920kbps ($14.98 in chips) 
Antonio8812: posts small blind $0.05
Notatur: is sitting out 
1920kbps: posts big blind $0.10
*** HOLE CARDS ***
Xath76: folds 
Raquk: raises $0.10 to $0.20
Antonio8812: folds 
1920kbps: folds 
Uncalled bet ($0.10) returned to Raquk
Notatur leaves the table
Raquk collected $0.25 from pot
Raquk: doesn't show hand 
*** SUMMARY ***
Total pot $0.25 | Rake $0 
Seat 1: Xath76 folded before Flop (didn't bet)
Seat 2: Raquk (button) collected ($0.25)
Seat 3: Antonio8812 (small blind) folded before Flop
Seat 5: 1920kbps (big blind) folded before Flop



PokerStars Hand #222953020776:  Hold'em No Limit ($0.05/$0.10 USD) - 2021/01/23 8:10:29 ET
Table 'Polydoros II' 6-max Seat #3 is the button
Seat 1: Xath76 ($16.49 in chips) 
Seat 2: Raquk ($17.24 in chips) 
Seat 3: Antonio8812 ($14.89 in chips) 
Seat 5: 1920kbps ($14.88 in chips) 
1920kbps: posts small blind $0.05
Xath76: posts big blind $0.10
*** HOLE CARDS ***
Raquk: raises $0.20 to $0.30
Antonio8812: folds 
1920kbps: folds 
Xath76: calls $0.20
*** FLOP *** [5h Qc 5c]
Xath76: checks 
Raquk: bets $0.50
Xath76: folds 
Uncalled bet ($0.50) returned to Raquk
Raquk collected $0.62 from pot
ivan2772ms was removed from the table for failing to post
ivan2772ms leaves the table
Raquk: doesn't show hand 
*** SUMMARY ***
Total pot $0.65 | Rake $0.03 
Board [5h Qc 5c]
Seat 1: Xath76 (big blind) folded on the Flop
Seat 2: Raquk collected ($0.62)
Seat 3: Antonio8812 (button) folded before Flop (didn't bet)
Seat 5: 1920kbps (small blind) folded before Flop



PokerStars Hand #222953035051:  Hold'em No Limit ($0.05/$0.10 USD) - 2021/01/23 8:11:04 ET
Table 'Polydoros II' 6-max Seat #5 is the button
Seat 1: Xath76 ($16.19 in chips) 
Seat 2: Raquk ($17.56 in chips) 
Seat 3: Antonio8812 ($14.89 in chips) 
Seat 5: 1920kbps ($14.83 in chips) 
Xath76: posts small blind $0.05
Raquk: posts big blind $0.10
*** HOLE CARDS ***
Antonio8812: folds 
1920kbps: folds 
Xath76: folds 
Uncalled bet ($0.05) returned to Raquk
Raquk collected $0.10 from pot
Raquk: doesn't show hand 
*** SUMMARY ***
Total pot $0.10 | Rake $0 
Seat 1: Xath76 (small blind) folded before Flop
Seat 2: Raquk (big blind) collected ($0.10)
Seat 3: Antonio8812 folded before Flop (didn't bet)
Seat 5: 1920kbps (button) folded before Flop (didn't bet)



PokerStars Hand #222953036965:  Hold'em No Limit ($0.05/$0.10 USD) - 2021/01/23 8:11:09 ET
Table 'Polydoros II' 6-max Seat #1 is the button
Seat 1: Xath76 ($16.14 in chips) 
Seat 2: Raquk ($17.61 in chips) 
Seat 5: 1920kbps ($14.83 in chips) 
Raquk: posts small blind $0.05
Antonio8812: is sitting out 
1920kbps: posts big blind $0.10
*** HOLE CARDS ***
Antonio8812 leaves the table
Xath76: folds 
Raquk: calls $0.05
1920kbps: checks 
*** FLOP *** [9d Tc Jc]
Raquk: checks 
1920kbps: checks 
*** TURN *** [9d Tc Jc] [9c]
Raquk: bets $0.30
Eskay58 joins the table at seat #4 
1920kbps: folds 
Uncalled bet ($0.30) returned to Raquk
Peeeta98 joins the table at seat #6 
Jesus Ololo joins the table at seat #3 
Raquk collected $0.19 from pot
Raquk: doesn't show hand 
*** SUMMARY ***
Total pot $0.20 | Rake $0.01 
Board [9d Tc Jc 9c]
Seat 1: Xath76 (button) folded before Flop (didn't bet)
Seat 2: Raquk (small blind) collected ($0.19)
Seat 5: 1920kbps (big blind) folded on the Turn



PokerStars Hand #222953060602:  Hold'em No Limit ($0.05/$0.10 USD) - 2021/01/23 8:12:07 ET
Table 'Polydoros II' 6-max Seat #2 is the button
Seat 1: Xath76 ($16.14 in chips) 
Seat 2: Raquk ($17.70 in chips) 
Seat 5: 1920kbps ($14.73 in chips) 
Seat 6: Peeeta98 ($10 in chips) 
1920kbps: posts small blind $0.05
Peeeta98: posts big blind $0.10
*** HOLE CARDS ***
Xath76: folds 
Eskay58 leaves the table
Raquk: raises $0.40 to $0.50
Squashy22 joins the table at seat #4 
1920kbps: folds 
Peeeta98: folds 
Uncalled bet ($0.40) returned to Raquk
Raquk collected $0.25 from pot
Raquk: doesn't show hand 
*** SUMMARY ***
Total pot $0.25 | Rake $0 
Seat 1: Xath76 folded before Flop (didn't bet)
Seat 2: Raquk (button) collected ($0.25)
Seat 5: 1920kbps (small blind) folded before Flop
Seat 6: Peeeta98 (big blind) folded before Flop



PokerStars Hand #222953068792:  Hold'em No Limit ($0.05/$0.10 USD) - 2021/01/23 8:12:27 ET
Table 'Polydoros II' 6-max Seat #5 is the button
Seat 1: Xath76 ($16.14 in chips) 
Seat 2: Raquk ($17.85 in chips) 
Seat 5: 1920kbps ($14.68 in chips) 
Xath76: posts small blind $0.05
Raquk: posts big blind $0.10
Jesus Ololo: sits out 
Squashy22: sits out 
*** HOLE CARDS ***
Peeeta98 leaves the table
Foky82 joins the table at seat #6 
1920kbps: folds 
Xath76: raises $0.20 to $0.30
Raquk: raises $0.20 to $0.50
Xath76: calls $0.20
*** FLOP *** [9s As 4c]
Xath76: checks 
Raquk: bets $0.50
Xath76: calls $0.50
*** TURN *** [9s As 4c] [2c]
Xath76: checks 
Raquk: bets $0.50
Xath76: calls $0.50
*** RIVER *** [9s As 4c 2c] [6h]
Xath76: bets $1.43
Raquk: calls $1.43
*** SHOW DOWN ***
Xath76: shows [6c Ad] (two pair, Aces and Sixes)
Raquk: mucks hand 
Xath76 collected $5.60 from pot
*** SUMMARY ***
Total pot $5.86 | Rake $0.26 
Board [9s As 4c 2c 6h]
Seat 1: Xath76 (small blind) showed [6c Ad] and won ($5.60) with two pair, Aces and Sixes
Seat 2: Raquk (big blind) mucked
Seat 5: 1920kbps (button) folded before Flop (didn't bet)



PokerStars Hand #222953090439:  Hold'em No Limit ($0.05/$0.10 USD) - 2021/01/23 8:13:19 ET
Table 'Polydoros II' 6-max Seat #1 is the button
Seat 1: Xath76 ($18.81 in chips) 
Seat 2: Raquk ($14.92 in chips) 
Seat 3: Jesus Ololo ($10 in chips) 
Seat 5: 1920kbps ($14.68 in chips) 
Raquk: posts small blind $0.05
Jesus Ololo: posts big blind $0.10
Squashy22: sits out 
Foky82: sits out 
*** HOLE CARDS ***
1920kbps: folds 
Xath76: folds 
Raquk: folds 
Uncalled bet ($0.05) returned to Jesus Ololo
Jesus Ololo collected $0.10 from pot
*** SUMMARY ***
Total pot $0.10 | Rake $0 
Seat 1: Xath76 (button) folded before Flop (didn't bet)
Seat 2: Raquk (small blind) folded before Flop
Seat 3: Jesus Ololo (big blind) collected ($0.10)
Seat 5: 1920kbps folded before Flop (didn't bet)



PokerStars Hand #222953097640:  Hold'em No Limit ($0.05/$0.10 USD) - 2021/01/23 8:13:37 ET
Table 'Polydoros II' 6-max Seat #2 is the button
Seat 1: Xath76 ($18.81 in chips) 
Seat 2: Raquk ($14.87 in chips) 
Seat 3: Jesus Ololo ($10.05 in chips) 
Seat 4: Squashy22 ($10 in chips) 
Seat 5: 1920kbps ($14.68 in chips) 
Jesus Ololo: posts small blind $0.05
Squashy22: posts big blind $0.10
Foky82: sits out 
*** HOLE CARDS ***
1920kbps: folds 
Xath76: folds 
Raquk: raises $0.20 to $0.30
Jesus Ololo: calls $0.25
Squashy22: folds 
*** FLOP *** [9d Ad Jh]
Jesus Ololo: checks 
Raquk: bets $0.30
Jesus Ololo: folds 
Uncalled bet ($0.30) returned to Raquk
Raquk collected $0.67 from pot
Raquk: doesn't show hand 
*** SUMMARY ***
Total pot $0.70 | Rake $0.03 
Board [9d Ad Jh]
Seat 1: Xath76 folded before Flop (didn't bet)
Seat 2: Raquk (button) collected ($0.67)
Seat 3: Jesus Ololo (small blind) folded on the Flop
Seat 4: Squashy22 (big blind) folded before Flop
Seat 5: 1920kbps folded before Flop (didn't bet)



PokerStars Hand #222953113232:  Hold'em No Limit ($0.05/$0.10 USD) - 2021/01/23 8:14:15 ET
Table 'Polydoros II' 6-max Seat #3 is the button
Seat 1: Xath76 ($18.81 in chips) 
Seat 2: Raquk ($15.24 in chips) 
Seat 3: Jesus Ololo ($10 in chips) 
Seat 4: Squashy22 ($10 in chips) 
Seat 5: 1920kbps ($14.68 in chips) 
Squashy22: posts small blind $0.05
1920kbps: posts big blind $0.10
Foky82: sits out 
*** HOLE CARDS ***
Xath76: folds 
Raquk: raises $0.40 to $0.50
Jesus Ololo: calls $0.50
Squashy22: folds 
1920kbps: folds 
*** FLOP *** [Qs As Kd]
Raquk: bets $0.50
Jesus Ololo: folds 
Uncalled bet ($0.50) returned to Raquk
Raquk collected $1.10 from pot
Raquk: doesn't show hand 
*** SUMMARY ***
Total pot $1.15 | Rake $0.05 
Board [Qs As Kd]
Seat 1: Xath76 folded before Flop (didn't bet)
Seat 2: Raquk collected ($1.10)
Seat 3: Jesus Ololo (button) folded on the Flop
Seat 4: Squashy22 (small blind) folded before Flop
Seat 5: 1920kbps (big blind) folded before Flop



PokerStars Hand #222953123602:  Hold'em No Limit ($0.05/$0.10 USD) - 2021/01/23 8:14:40 ET
Table 'Polydoros II' 6-max Seat #4 is the button
Seat 1: Xath76 ($18.81 in chips) 
Seat 2: Raquk ($15.84 in chips) 
Seat 3: Jesus Ololo ($10 in chips) 
Seat 4: Squashy22 ($10 in chips) 
Seat 5: 1920kbps ($14.58 in chips) 
Seat 6: Foky82 ($10 in chips) 
1920kbps: posts small blind $0.05
Foky82: posts big blind $0.10
*** HOLE CARDS ***
Xath76: folds 
Raquk: raises $0.40 to $0.50
Jesus Ololo: calls $0.50
Squashy22: folds 
1920kbps: folds 
Foky82: folds 
*** FLOP *** [Qc Qh 5c]
Raquk: bets $0.30
Jesus Ololo: folds 
Uncalled bet ($0.30) returned to Raquk
Raquk collected $1.10 from pot
Raquk: doesn't show hand 
*** SUMMARY ***
Total pot $1.15 | Rake $0.05 
Board [Qc Qh 5c]
Seat 1: Xath76 folded before Flop (didn't bet)
Seat 2: Raquk collected ($1.10)
Seat 3: Jesus Ololo folded on the Flop
Seat 4: Squashy22 (button) folded before Flop (didn't bet)
Seat 5: 1920kbps (small blind) folded before Flop
Seat 6: Foky82 (big blind) folded before Flop



PokerStars Hand #222953137877:  Hold'em No Limit ($0.05/$0.10 USD) - 2021/01/23 8:15:15 ET
Table 'Polydoros II' 6-max Seat #5 is the button
Seat 1: Xath76 ($18.81 in chips) 
Seat 2: Raquk ($16.44 in chips) 
Seat 3: Jesus Ololo ($10 in chips) 
Seat 4: Squashy22 ($10 in chips) 
Seat 5: 1920kbps ($14.53 in chips) 
Seat 6: Foky82 ($10 in chips) 
Foky82: posts small blind $0.05
Xath76: posts big blind $0.10
*** HOLE CARDS ***
Raquk: raises $0.20 to $0.30
Jesus Ololo: folds 
Squashy22: folds 
1920kbps: folds 
Foky82: folds 
Xath76: calls $0.20
*** FLOP *** [8s Td Ts]
Xath76: checks 
Raquk: bets $0.50
Xath76: calls $0.50
*** TURN *** [8s Td Ts] [3d]
Xath76: checks 
Raquk: bets $0.50
Xath76: raises $2.58 to $3.08
Raquk: calls $2.58
*** RIVER *** [8s Td Ts 3d] [Qd]
Xath76: bets $3.73
Raquk: raises $3.73 to $7.46
Xath76: calls $3.73
*** SHOW DOWN ***
Raquk: shows [Kd 8d] (a flush, King high)
Xath76: mucks hand 
Raquk collected $21.71 from pot
*** SUMMARY ***
Total pot $22.73 | Rake $1.02 
Board [8s Td Ts 3d Qd]
Seat 1: Xath76 (big blind) mucked
Seat 2: Raquk showed [Kd 8d] and won ($21.71) with a flush, King high
Seat 3: Jesus Ololo folded before Flop (didn't bet)
Seat 4: Squashy22 folded before Flop (didn't bet)
Seat 5: 1920kbps (button) folded before Flop (didn't bet)
Seat 6: Foky82 (small blind) folded before Flop



PokerStars Hand #222953163154:  Hold'em No Limit ($0.05/$0.10 USD) - 2021/01/23 8:16:16 ET
Table 'Polydoros II' 6-max Seat #6 is the button
Seat 1: Xath76 ($10 in chips) 
Seat 2: Raquk ($26.81 in chips) 
Seat 3: Jesus Ololo ($10 in chips) 
Seat 4: Squashy22 ($10 in chips) 
Seat 5: 1920kbps ($14.53 in chips) 
Seat 6: Foky82 ($10 in chips) 
Xath76: posts small blind $0.05
Raquk: posts big blind $0.10
*** HOLE CARDS ***
Jesus Ololo: folds 
Jesus Ololo leaves the table
Squashy22: raises $0.19 to $0.29
Vaha379 joins the table at seat #3 
1920kbps: folds 
Foky82: calls $0.29
Xath76: folds 
Raquk: raises $0.19 to $0.48
Squashy22: calls $0.19
Foky82: calls $0.19
*** FLOP *** [6s 8h 9s]
Raquk: bets $0.50
Squashy22: folds 
Foky82: calls $0.50
*** TURN *** [6s 8h 9s] [7s]
Raquk: bets $0.50
Foky82: calls $0.50
*** RIVER *** [6s 8h 9s 7s] [Jd]
Raquk: checks 
Foky82: bets $1.67
Raquk: folds 
Uncalled bet ($1.67) returned to Foky82
Foky82 collected $3.33 from pot
Foky82: doesn't show hand 
*** SUMMARY ***
Total pot $3.49 | Rake $0.16 
Board [6s 8h 9s 7s Jd]
Seat 1: Xath76 (small blind) folded before Flop
Seat 2: Raquk (big blind) folded on the River
Seat 3: Jesus Ololo folded before Flop (didn't bet)
Seat 4: Squashy22 folded on the Flop
Seat 5: 1920kbps folded before Flop (didn't bet)
Seat 6: Foky82 (button) collected ($3.33)



PokerStars Hand #222953197471:  Hold'em No Limit ($0.05/$0.10 USD) - 2021/01/23 8:17:38 ET
Table 'Polydoros II' 6-max Seat #1 is the button
Seat 1: Xath76 ($10 in chips) 
Seat 2: Raquk ($25.33 in chips) 
Seat 3: Vaha379 ($10 in chips) 
Seat 4: Squashy22 ($10 in chips) 
Seat 5: 1920kbps ($14.53 in chips) 
Seat 6: Foky82 ($11.85 in chips) 
Raquk: posts small blind $0.05
Vaha379: posts big blind $0.10
*** HOLE CARDS ***
Squashy22: folds 
1920kbps: folds 
Foky82: folds 
Xath76: folds 
Raquk: raises $0.40 to $0.50
Vaha379: folds 
Uncalled bet ($0.40) returned to Raquk
Raquk collected $0.20 from pot
Raquk: doesn't show hand 
*** SUMMARY ***
Total pot $0.20 | Rake $0 
Seat 1: Xath76 (button) folded before Flop (didn't bet)
Seat 2: Raquk (small blind) collected ($0.20)
Seat 3: Vaha379 (big blind) folded before Flop
Seat 4: Squashy22 folded before Flop (didn't bet)
Seat 5: 1920kbps folded before Flop (didn't bet)
Seat 6: Foky82 folded before Flop (didn't bet)



PokerStars Hand #222953202544:  Hold'em No Limit ($0.05/$0.10 USD) - 2021/01/23 8:17:50 ET
Table 'Polydoros II' 6-max Seat #2 is the button
Seat 1: Xath76 ($10 in chips) 
Seat 2: Raquk ($25.43 in chips) 
Seat 3: Vaha379 ($9.90 in chips) 
Seat 4: Squashy22 ($10 in chips) 
Seat 5: 1920kbps ($14.53 in chips) 
Seat 6: Foky82 ($11.85 in chips) 
Vaha379: posts small blind $0.05
Squashy22: posts big blind $0.10
*** HOLE CARDS ***
1920kbps: folds 
1920kbps leaves the table
Foky82: raises $0.20 to $0.30
Xath76: raises $0.75 to $1.05
Raquk: folds 
Vaha379: folds 
Squashy22: folds 
Foky82: folds 
Uncalled bet ($0.75) returned to Xath76
Xath76 collected $0.75 from pot
Xath76: doesn't show hand 
*** SUMMARY ***
Total pot $0.75 | Rake $0 
Seat 1: Xath76 collected ($0.75)
Seat 2: Raquk (button) folded before Flop (didn't bet)
Seat 3: Vaha379 (small blind) folded before Flop
Seat 4: Squashy22 (big blind) folded before Flop
Seat 5: 1920kbps folded before Flop (didn't bet)
Seat 6: Foky82 folded before Flop



PokerStars Hand #222953211706:  Hold'em No Limit ($0.05/$0.10 USD) - 2021/01/23 8:18:12 ET
Table 'Polydoros II' 6-max Seat #3 is the button
Seat 1: Xath76 ($10.45 in chips) 
Seat 2: Raquk ($25.43 in chips) 
Seat 3: Vaha379 ($9.85 in chips) 
Seat 4: Squashy22 ($10 in chips) 
Seat 6: Foky82 ($11.55 in chips) 
Squashy22: posts small blind $0.05
Foky82: posts big blind $0.10
*** HOLE CARDS ***
Xath76: folds 
Raquk: raises $0.30 to $0.40
Vaha379: folds 
WillyDePoeh joins the table at seat #5 
Squashy22: folds 
Foky82: folds 
Uncalled bet ($0.30) returned to Raquk
Raquk collected $0.25 from pot
Raquk: doesn't show hand 
*** SUMMARY ***
Total pot $0.25 | Rake $0 
Seat 1: Xath76 folded before Flop (didn't bet)
Seat 2: Raquk collected ($0.25)
Seat 3: Vaha379 (button) folded before Flop (didn't bet)
Seat 4: Squashy22 (small blind) folded before Flop
Seat 6: Foky82 (big blind) folded before Flop



PokerStars Hand #222953221761:  Hold'em No Limit ($0.05/$0.10 USD) - 2021/01/23 8:18:36 ET
Table 'Polydoros II' 6-max Seat #4 is the button
Seat 1: Xath76 ($10.45 in chips) 
Seat 2: Raquk ($25.58 in chips) 
Seat 3: Vaha379 ($10 in chips) 
Seat 4: Squashy22 ($10 in chips) 
Seat 6: Foky82 ($11.45 in chips) 
Foky82: posts small blind $0.05
Xath76: posts big blind $0.10
*** HOLE CARDS ***
Raquk: raises $0.40 to $0.50
Vaha379: folds 
Squashy22: calls $0.50
Foky82: folds 
Xath76: calls $0.40
*** FLOP *** [8d 6c Qs]
Xath76: checks 
Raquk: bets $0.50
Squashy22: calls $0.50
Xath76: calls $0.50
*** TURN *** [8d 6c Qs] [3c]
Xath76: checks 
Raquk: bets $0.50
Squashy22: raises $2.78 to $3.28
Xath76: folds 
Raquk: folds 
Uncalled bet ($2.78) returned to Squashy22
Squashy22 collected $3.87 from pot
Squashy22: doesn't show hand 
*** SUMMARY ***
Total pot $4.05 | Rake $0.18 
Board [8d 6c Qs 3c]
Seat 1: Xath76 (big blind) folded on the Turn
Seat 2: Raquk folded on the Turn
Seat 3: Vaha379 folded before Flop (didn't bet)
Seat 4: Squashy22 (button) collected ($3.87)
Seat 6: Foky82 (small blind) folded before Flop



PokerStars Hand #222953244574:  Hold'em No Limit ($0.05/$0.10 USD) - 2021/01/23 8:19:30 ET
Table 'Polydoros II' 6-max Seat #6 is the button
Seat 1: Xath76 ($10 in chips) 
Seat 2: Raquk ($24.08 in chips) 
Seat 3: Vaha379 ($10 in chips) 
Seat 4: Squashy22 ($12.37 in chips) 
Seat 5: WillyDePoeh ($7 in chips) 
Seat 6: Foky82 ($11.40 in chips) 
Xath76: posts small blind $0.05
Raquk: posts big blind $0.10
WillyDePoeh: posts big blind $0.10
*** HOLE CARDS ***
Vaha379: folds 
Squashy22: raises $0.35 to $0.45
WillyDePoeh: folds 
Foky82: folds 
Xath76: raises $1.10 to $1.55
Raquk: folds 
Squashy22: calls $1.10
*** FLOP *** [7c 2d 5h]
Xath76: bets $1.58
Squashy22: calls $1.58
*** TURN *** [7c 2d 5h] [6d]
Xath76: bets $3.09
Squashy22: calls $3.09
*** RIVER *** [7c 2d 5h 6d] [Jd]
Xath76: bets $3.78 and is all-in
Squashy22: calls $3.78
*** SHOW DOWN ***
Xath76: shows [Ac Qh] (high card Ace)
Squashy22: shows [Ad Qd] (a flush, Ace high)
Squashy22 collected $19.29 from pot
*** SUMMARY ***
Total pot $20.20 | Rake $0.91 
Board [7c 2d 5h 6d Jd]
Seat 1: Xath76 (small blind) showed [Ac Qh] and lost with high card Ace
Seat 2: Raquk (big blind) folded before Flop
Seat 3: Vaha379 folded before Flop (didn't bet)
Seat 4: Squashy22 showed [Ad Qd] and won ($19.29) with a flush, Ace high
Seat 5: WillyDePoeh folded before Flop (didn't bet)
Seat 6: Foky82 (button) folded before Flop (didn't bet)



PokerStars Hand #222953263064:  Hold'em No Limit ($0.05/$0.10 USD) - 2021/01/23 8:20:14 ET
Table 'Polydoros II' 6-max Seat #1 is the button
Seat 1: Xath76 ($10 in chips) 
Seat 2: Raquk ($23.98 in chips) 
Seat 3: Vaha379 ($10 in chips) 
Seat 4: Squashy22 ($21.66 in chips) 
Seat 5: WillyDePoeh ($6.90 in chips) 
Seat 6: Foky82 ($11.40 in chips) 
Raquk: posts small blind $0.05
Vaha379: posts big blind $0.10
*** HOLE CARDS ***
Squashy22: folds 
WillyDePoeh: folds 
Foky82: folds 
Xath76: folds 
Raquk: raises $0.20 to $0.30
Vaha379: calls $0.20
*** FLOP *** [6d Ac 7c]
Raquk: bets $0.40
Vaha379: raises $0.79 to $1.19
Raquk: folds 
Uncalled bet ($0.79) returned to Vaha379
Vaha379 collected $1.34 from pot
Vaha379: doesn't show hand 
*** SUMMARY ***
Total pot $1.40 | Rake $0.06 
Board [6d Ac 7c]
Seat 1: Xath76 (button) folded before Flop (didn't bet)
Seat 2: Raquk (small blind) folded on the Flop
Seat 3: Vaha379 (big blind) collected ($1.34)
Seat 4: Squashy22 folded before Flop (didn't bet)
Seat 5: WillyDePoeh folded before Flop (didn't bet)
Seat 6: Foky82 folded before Flop (didn't bet)



PokerStars Hand #222953277364:  Hold'em No Limit ($0.05/$0.10 USD) - 2021/01/23 8:20:47 ET
Table 'Polydoros II' 6-max Seat #2 is the button
Seat 1: Xath76 ($10 in chips) 
Seat 2: Raquk ($23.28 in chips) 
Seat 3: Vaha379 ($10.64 in chips) 
Seat 4: Squashy22 ($21.66 in chips) 
Seat 5: WillyDePoeh ($6.90 in chips) 
Seat 6: Foky82 ($11.40 in chips) 
Vaha379: posts small blind $0.05
Squashy22: posts big blind $0.10
*** HOLE CARDS ***
WillyDePoeh: folds 
Foky82: raises $0.20 to $0.30
Xath76: calls $0.30
Raquk: folds 
Vaha379: calls $0.25
Squashy22: folds 
*** FLOP *** [9d Jc 5c]
Vaha379: checks 
Foky82: checks 
Xath76: checks 
*** TURN *** [9d Jc 5c] [2d]
Vaha379: bets $0.88
Foky82: calls $0.88
Xath76: calls $0.88
*** RIVER *** [9d Jc 5c 2d] [7c]
Vaha379: bets $1.74
Foky82: folds 
Xath76: folds 
Uncalled bet ($1.74) returned to Vaha379
Vaha379 collected $3.48 from pot
Vaha379: doesn't show hand 
*** SUMMARY ***
Total pot $3.64 | Rake $0.16 
Board [9d Jc 5c 2d 7c]
Seat 1: Xath76 folded on the River
Seat 2: Raquk (button) folded before Flop (didn't bet)
Seat 3: Vaha379 (small blind) collected ($3.48)
Seat 4: Squashy22 (big blind) folded before Flop
Seat 5: WillyDePoeh folded before Flop (didn't bet)
Seat 6: Foky82 folded on the River



PokerStars Hand #222953301606:  Hold'em No Limit ($0.05/$0.10 USD) - 2021/01/23 8:21:43 ET
Table 'Polydoros II' 6-max Seat #3 is the button
Seat 1: Xath76 ($10 in chips) 
Seat 2: Raquk ($23.28 in chips) 
Seat 3: Vaha379 ($12.94 in chips) 
Seat 4: Squashy22 ($21.56 in chips) 
Seat 5: WillyDePoeh ($6.90 in chips) 
Seat 6: Foky82 ($10.22 in chips) 
Squashy22: posts small blind $0.05
WillyDePoeh: posts big blind $0.10
*** HOLE CARDS ***
Foky82: folds 
Xath76: folds 
Raquk: raises $0.40 to $0.50
Vaha379: folds 
Squashy22: calls $0.45
WillyDePoeh: folds 
*** FLOP *** [Kd Qd 4s]
Squashy22: checks 
Raquk: checks 
*** TURN *** [Kd Qd 4s] [Jc]
Squashy22: bets $0.45
Raquk: folds 
Uncalled bet ($0.45) returned to Squashy22
Squashy22 collected $1.05 from pot
Squashy22: doesn't show hand 
*** SUMMARY ***
Total pot $1.10 | Rake $0.05 
Board [Kd Qd 4s Jc]
Seat 1: Xath76 folded before Flop (didn't bet)
Seat 2: Raquk folded on the Turn
Seat 3: Vaha379 (button) folded before Flop (didn't bet)
Seat 4: Squashy22 (small blind) collected ($1.05)
Seat 5: WillyDePoeh (big blind) folded before Flop
Seat 6: Foky82 folded before Flop (didn't bet)



PokerStars Hand #222953315219:  Hold'em No Limit ($0.05/$0.10 USD) - 2021/01/23 8:22:15 ET
Table 'Polydoros II' 6-max Seat #4 is the button
Seat 1: Xath76 ($10 in chips) 
Seat 2: Raquk ($22.78 in chips) 
Seat 3: Vaha379 ($12.94 in chips) 
Seat 4: Squashy22 ($22.11 in chips) 
Seat 5: WillyDePoeh ($6.80 in chips) 
Seat 6: Foky82 ($10.22 in chips) 
WillyDePoeh: posts small blind $0.05
Foky82: posts big blind $0.10
*** HOLE CARDS ***
Xath76: folds 
Raquk: folds 
Vaha379: folds 
Squashy22: folds 
WillyDePoeh: folds 
Uncalled bet ($0.05) returned to Foky82
Foky82 collected $0.10 from pot
Foky82: doesn't show hand 
*** SUMMARY ***
Total pot $0.10 | Rake $0 
Seat 1: Xath76 folded before Flop (didn't bet)
Seat 2: Raquk folded before Flop (didn't bet)
Seat 3: Vaha379 folded before Flop (didn't bet)
Seat 4: Squashy22 (button) folded before Flop (didn't bet)
Seat 5: WillyDePoeh (small blind) folded before Flop
Seat 6: Foky82 (big blind) collected ($0.10)



PokerStars Hand #222953320458:  Hold'em No Limit ($0.05/$0.10 USD) - 2021/01/23 8:22:27 ET
Table 'Polydoros II' 6-max Seat #5 is the button
Seat 1: Xath76 ($10 in chips) 
Seat 2: Raquk ($22.78 in chips) 
Seat 3: Vaha379 ($12.94 in chips) 
Seat 4: Squashy22 ($22.11 in chips) 
Seat 5: WillyDePoeh ($6.75 in chips) 
Seat 6: Foky82 ($10.27 in chips) 
Foky82: posts small blind $0.05
Xath76: posts big blind $0.10
*** HOLE CARDS ***
Raquk: folds 
Vaha379: folds 
Squashy22: folds 
WillyDePoeh: raises $0.10 to $0.20
Foky82: raises $0.70 to $0.90
Xath76: folds 
WillyDePoeh: folds 
Uncalled bet ($0.70) returned to Foky82
Foky82 collected $0.50 from pot
Foky82: doesn't show hand 
*** SUMMARY ***
Total pot $0.50 | Rake $0 
Seat 1: Xath76 (big blind) folded before Flop
Seat 2: Raquk folded before Flop (didn't bet)
Seat 3: Vaha379 folded before Flop (didn't bet)
Seat 4: Squashy22 folded before Flop (didn't bet)
Seat 5: WillyDePoeh (button) folded before Flop
Seat 6: Foky82 (small blind) collected ($0.50)



PokerStars Hand #222953328731:  Hold'em No Limit ($0.05/$0.10 USD) - 2021/01/23 8:22:46 ET
Table 'Polydoros II' 6-max Seat #6 is the button
Seat 1: Xath76 ($10 in chips) 
Seat 2: Raquk ($22.78 in chips) 
Seat 3: Vaha379 ($12.94 in chips) 
Seat 4: Squashy22 ($22.11 in chips) 
Seat 5: WillyDePoeh ($6.55 in chips) 
Seat 6: Foky82 ($10.57 in chips) 
Xath76: posts small blind $0.05
Raquk: posts big blind $0.10
*** HOLE CARDS ***
Vaha379: folds 
Squashy22: folds 
WillyDePoeh: raises $0.20 to $0.30
Foky82: folds 
Xath76: folds 
Raquk: raises $0.20 to $0.50
WillyDePoeh: raises $0.30 to $0.80
Raquk: calls $0.30
*** FLOP *** [6s 5h 5d]
Raquk: bets $1.50
WillyDePoeh: raises $4.25 to $5.75 and is all-in
Raquk: folds 
Uncalled bet ($4.25) returned to WillyDePoeh
WillyDePoeh collected $4.44 from pot
WillyDePoeh: doesn't show hand 
*** SUMMARY ***
Total pot $4.65 | Rake $0.21 
Board [6s 5h 5d]
Seat 1: Xath76 (small blind) folded before Flop
Seat 2: Raquk (big blind) folded on the Flop
Seat 3: Vaha379 folded before Flop (didn't bet)
Seat 4: Squashy22 folded before Flop (didn't bet)
Seat 5: WillyDePoeh collected ($4.44)
Seat 6: Foky82 (button) folded before Flop (didn't bet)



PokerStars Hand #222953351575:  Hold'em No Limit ($0.05/$0.10 USD) - 2021/01/23 8:23:39 ET
Table 'Polydoros II' 6-max Seat #1 is the button
Seat 1: Xath76 ($10 in chips) 
Seat 2: Raquk ($20.48 in chips) 
Seat 3: Vaha379 ($12.94 in chips) 
Seat 4: Squashy22 ($22.11 in chips) 
Seat 5: WillyDePoeh ($8.69 in chips) 
Seat 6: Foky82 ($10.57 in chips) 
Raquk: posts small blind $0.05
Vaha379: posts big blind $0.10
*** HOLE CARDS ***
Squashy22: folds 
WillyDePoeh: folds 
Foky82: folds 
Xath76: folds 
Raquk: raises $0.20 to $0.30
Vaha379: folds 
Uncalled bet ($0.20) returned to Raquk
Raquk collected $0.20 from pot
Raquk: doesn't show hand 
*** SUMMARY ***
Total pot $0.20 | Rake $0 
Seat 1: Xath76 (button) folded before Flop (didn't bet)
Seat 2: Raquk (small blind) collected ($0.20)
Seat 3: Vaha379 (big blind) folded before Flop
Seat 4: Squashy22 folded before Flop (didn't bet)
Seat 5: WillyDePoeh folded before Flop (didn't bet)
Seat 6: Foky82 folded before Flop (didn't bet)



PokerStars Hand #222953358330:  Hold'em No Limit ($0.05/$0.10 USD) - 2021/01/23 8:23:54 ET
Table 'Polydoros II' 6-max Seat #2 is the button
Seat 1: Xath76 ($10 in chips) 
Seat 2: Raquk ($20.58 in chips) 
Seat 3: Vaha379 ($12.84 in chips) 
Seat 4: Squashy22 ($22.11 in chips) 
Seat 5: WillyDePoeh ($8.69 in chips) 
Seat 6: Foky82 ($10.57 in chips) 
Vaha379: posts small blind $0.05
Squashy22: posts big blind $0.10
*** HOLE CARDS ***
WillyDePoeh: raises $0.10 to $0.20
Foky82: folds 
Xath76: raises $0.55 to $0.75
Raquk: folds 
Vaha379: folds 
Squashy22: folds 
WillyDePoeh: folds 
Uncalled bet ($0.55) returned to Xath76
Xath76 collected $0.55 from pot
Xath76: doesn't show hand 
*** SUMMARY ***
Total pot $0.55 | Rake $0 
Seat 1: Xath76 collected ($0.55)
Seat 2: Raquk (button) folded before Flop (didn't bet)
Seat 3: Vaha379 (small blind) folded before Flop
Seat 4: Squashy22 (big blind) folded before Flop
Seat 5: WillyDePoeh folded before Flop
Seat 6: Foky82 folded before Flop (didn't bet)



PokerStars Hand #222953363836:  Hold'em No Limit ($0.05/$0.10 USD) - 2021/01/23 8:24:07 ET
Table 'Polydoros II' 6-max Seat #3 is the button
Seat 1: Xath76 ($10.35 in chips) 
Seat 2: Raquk ($20.58 in chips) 
Seat 3: Vaha379 ($12.79 in chips) 
Seat 4: Squashy22 ($22.01 in chips) 
Seat 5: WillyDePoeh ($8.49 in chips) 
Seat 6: Foky82 ($10.57 in chips) 
Squashy22: posts small blind $0.05
WillyDePoeh: posts big blind $0.10
*** HOLE CARDS ***
Foky82: folds 
Xath76: folds 
Raquk: raises $0.30 to $0.40
Vaha379: folds 
Squashy22: folds 
WillyDePoeh: folds 
Uncalled bet ($0.30) returned to Raquk
Raquk collected $0.25 from pot
Raquk: doesn't show hand 
*** SUMMARY ***
Total pot $0.25 | Rake $0 
Seat 1: Xath76 folded before Flop (didn't bet)
Seat 2: Raquk collected ($0.25)
Seat 3: Vaha379 (button) folded before Flop (didn't bet)
Seat 4: Squashy22 (small blind) folded before Flop
Seat 5: WillyDePoeh (big blind) folded before Flop
Seat 6: Foky82 folded before Flop (didn't bet)



PokerStars Hand #222953371783:  Hold'em No Limit ($0.05/$0.10 USD) - 2021/01/23 8:24:25 ET
Table 'Polydoros II' 6-max Seat #4 is the button
Seat 1: Xath76 ($10.35 in chips) 
Seat 2: Raquk ($20.73 in chips) 
Seat 3: Vaha379 ($12.79 in chips) 
Seat 4: Squashy22 ($21.96 in chips) 
Seat 5: WillyDePoeh ($8.39 in chips) 
Seat 6: Foky82 ($10.57 in chips) 
WillyDePoeh: posts small blind $0.05
Foky82: posts big blind $0.10
*** HOLE CARDS ***
Xath76: folds 
Raquk: folds 
Vaha379: folds 
Squashy22: folds 
WillyDePoeh: folds 
Uncalled bet ($0.05) returned to Foky82
Foky82 collected $0.10 from pot
Foky82: doesn't show hand 
*** SUMMARY ***
Total pot $0.10 | Rake $0 
Seat 1: Xath76 folded before Flop (didn't bet)
Seat 2: Raquk folded before Flop (didn't bet)
Seat 3: Vaha379 folded before Flop (didn't bet)
Seat 4: Squashy22 (button) folded before Flop (didn't bet)
Seat 5: WillyDePoeh (small blind) folded before Flop
Seat 6: Foky82 (big blind) collected ($0.10)



PokerStars Hand #222953376992:  Hold'em No Limit ($0.05/$0.10 USD) - 2021/01/23 8:24:38 ET
Table 'Polydoros II' 6-max Seat #5 is the button
Seat 1: Xath76 ($10.35 in chips) 
Seat 2: Raquk ($20.73 in chips) 
Seat 3: Vaha379 ($12.79 in chips) 
Seat 4: Squashy22 ($21.96 in chips) 
Seat 5: WillyDePoeh ($8.34 in chips) 
Seat 6: Foky82 ($10.62 in chips) 
Foky82: posts small blind $0.05
Xath76: posts big blind $0.10
*** HOLE CARDS ***
Raquk: raises $0.30 to $0.40
Vaha379: folds 
Squashy22: calls $0.40
WillyDePoeh: folds 
Foky82: folds 
Xath76: folds 
*** FLOP *** [5d 8d Kh]
Raquk: bets $0.60
Squashy22: folds 
Uncalled bet ($0.60) returned to Raquk
Raquk collected $0.91 from pot
Raquk: doesn't show hand 
*** SUMMARY ***
Total pot $0.95 | Rake $0.04 
Board [5d 8d Kh]
Seat 1: Xath76 (big blind) folded before Flop
Seat 2: Raquk collected ($0.91)
Seat 3: Vaha379 folded before Flop (didn't bet)
Seat 4: Squashy22 folded on the Flop
Seat 5: WillyDePoeh (button) folded before Flop (didn't bet)
Seat 6: Foky82 (small blind) folded before Flop



PokerStars Hand #222953386685:  Hold'em No Limit ($0.05/$0.10 USD) - 2021/01/23 8:25:00 ET
Table 'Polydoros II' 6-max Seat #6 is the button
Seat 1: Xath76 ($10.25 in chips) 
Seat 2: Raquk ($21.24 in chips) 
Seat 3: Vaha379 ($12.79 in chips) 
Seat 4: Squashy22 ($21.56 in chips) 
Seat 5: WillyDePoeh ($8.34 in chips) 
Seat 6: Foky82 ($10.57 in chips) 
Xath76: posts small blind $0.05
Raquk: posts big blind $0.10
*** HOLE CARDS ***
Vaha379: folds 
Squashy22: folds 
WillyDePoeh: raises $0.30 to $0.40
Foky82: folds 
Xath76: folds 
Raquk: folds 
Uncalled bet ($0.30) returned to WillyDePoeh
WillyDePoeh collected $0.25 from pot
WillyDePoeh: doesn't show hand 
*** SUMMARY ***
Total pot $0.25 | Rake $0 
Seat 1: Xath76 (small blind) folded before Flop
Seat 2: Raquk (big blind) folded before Flop
Seat 3: Vaha379 folded before Flop (didn't bet)
Seat 4: Squashy22 folded before Flop (didn't bet)
Seat 5: WillyDePoeh collected ($0.25)
Seat 6: Foky82 (button) folded before Flop (didn't bet)



PokerStars Hand #222953391566:  Hold'em No Limit ($0.05/$0.10 USD) - 2021/01/23 8:25:11 ET
Table 'Polydoros II' 6-max Seat #1 is the button
Seat 1: Xath76 ($10.20 in chips) 
Seat 3: Vaha379 ($12.79 in chips) 
Seat 4: Squashy22 ($21.56 in chips) 
Seat 5: WillyDePoeh ($8.49 in chips) 
Seat 6: Foky82 ($10.57 in chips) 
Vaha379: posts small blind $0.05
Squashy22: posts big blind $0.10
*** HOLE CARDS ***
WillyDePoeh: folds 
Raquk leaves the table
Foky82: raises $0.20 to $0.30
Xath76: calls $0.30
sepek84 joins the table at seat #2 
Vaha379: calls $0.25
Squashy22: raises $1.60 to $1.90
Foky82: folds 
Xath76: folds 
Vaha379: folds 
Uncalled bet ($1.60) returned to Squashy22
Squashy22 collected $1.20 from pot
Squashy22: doesn't show hand 
*** SUMMARY ***
Total pot $1.20 | Rake $0 
Seat 1: Xath76 (button) folded before Flop
Seat 3: Vaha379 (small blind) folded before Flop
Seat 4: Squashy22 (big blind) collected ($1.20)
Seat 5: WillyDePoeh folded before Flop (didn't bet)
Seat 6: Foky82 folded before Flop



PokerStars Hand #222953404636:  Hold'em No Limit ($0.05/$0.10 USD) - 2021/01/23 8:25:42 ET
Table 'Polydoros II' 6-max Seat #3 is the button
Seat 1: Xath76 ($10 in chips) 
Seat 2: sepek84 ($4 in chips) 
Seat 3: Vaha379 ($12.49 in chips) 
Seat 4: Squashy22 ($22.46 in chips) 
Seat 5: WillyDePoeh ($8.49 in chips) 
Seat 6: Foky82 ($10.27 in chips) 
Squashy22: posts small blind $0.05
WillyDePoeh: posts big blind $0.10
sepek84: posts big blind $0.10
*** HOLE CARDS ***
Foky82: folds 
Xath76: folds 
sepek84: checks 
Vaha379: folds 
Squashy22: folds 
WillyDePoeh: checks 
*** FLOP *** [Kd Kc Qc]
WillyDePoeh: bets $0.12
sepek84: folds 
Uncalled bet ($0.12) returned to WillyDePoeh
WillyDePoeh collected $0.24 from pot
WillyDePoeh: doesn't show hand 
*** SUMMARY ***
Total pot $0.25 | Rake $0.01 
Board [Kd Kc Qc]
Seat 1: Xath76 folded before Flop (didn't bet)
Seat 2: sepek84 folded on the Flop (didn't bet)
Seat 3: Vaha379 (button) folded before Flop (didn't bet)
Seat 4: Squashy22 (small blind) folded before Flop
Seat 5: WillyDePoeh (big blind) collected ($0.24)
Seat 6: Foky82 folded before Flop (didn't bet)



PokerStars Hand #222953416438:  Hold'em No Limit ($0.05/$0.10 USD) - 2021/01/23 8:26:09 ET
Table 'Polydoros II' 6-max Seat #4 is the button
Seat 1: Xath76 ($10 in chips) 
Seat 2: sepek84 ($3.90 in chips) 
Seat 3: Vaha379 ($12.49 in chips) 
Seat 4: Squashy22 ($22.41 in chips) 
Seat 5: WillyDePoeh ($8.63 in chips) 
Seat 6: Foky82 ($10.27 in chips) 
WillyDePoeh: posts small blind $0.05
Foky82: posts big blind $0.10
*** HOLE CARDS ***
Xath76: folds 
sepek84: folds 
Vaha379: folds 
Squashy22: folds 
WillyDePoeh: folds 
Uncalled bet ($0.05) returned to Foky82
Foky82 collected $0.10 from pot
Foky82: doesn't show hand 
*** SUMMARY ***
Total pot $0.10 | Rake $0 
Seat 1: Xath76 folded before Flop (didn't bet)
Seat 2: sepek84 folded before Flop (didn't bet)
Seat 3: Vaha379 folded before Flop (didn't bet)
Seat 4: Squashy22 (button) folded before Flop (didn't bet)
Seat 5: WillyDePoeh (small blind) folded before Flop
Seat 6: Foky82 (big blind) collected ($0.10)



PokerStars Hand #222953419763:  Hold'em No Limit ($0.05/$0.10 USD) - 2021/01/23 8:26:17 ET
Table 'Polydoros II' 6-max Seat #5 is the button
Seat 1: Xath76 ($10 in chips) 
Seat 2: sepek84 ($3.90 in chips) 
Seat 3: Vaha379 ($12.49 in chips) 
Seat 4: Squashy22 ($22.41 in chips) 
Seat 5: WillyDePoeh ($8.58 in chips) 
Seat 6: Foky82 ($10.32 in chips) 
Foky82: posts small blind $0.05
Xath76: posts big blind $0.10
*** HOLE CARDS ***
sepek84: folds 
Vaha379: folds 
Squashy22: raises $0.16 to $0.26
WillyDePoeh: folds 
Foky82: folds 
Xath76: folds 
Uncalled bet ($0.16) returned to Squashy22
Squashy22 collected $0.25 from pot
Squashy22: doesn't show hand 
*** SUMMARY ***
Total pot $0.25 | Rake $0 
Seat 1: Xath76 (big blind) folded before Flop
Seat 2: sepek84 folded before Flop (didn't bet)
Seat 3: Vaha379 folded before Flop (didn't bet)
Seat 4: Squashy22 collected ($0.25)
Seat 5: WillyDePoeh (button) folded before Flop (didn't bet)
Seat 6: Foky82 (small blind) folded before Flop



PokerStars Hand #222953425924:  Hold'em No Limit ($0.05/$0.10 USD) - 2021/01/23 8:26:31 ET
Table 'Polydoros II' 6-max Seat #6 is the button
Seat 1: Xath76 ($10 in chips) 
Seat 2: sepek84 ($3.90 in chips) 
Seat 3: Vaha379 ($12.49 in chips) 
Seat 4: Squashy22 ($22.56 in chips) 
Seat 5: WillyDePoeh ($8.58 in chips) 
Seat 6: Foky82 ($10.27 in chips) 
Xath76: posts small blind $0.05
sepek84: posts big blind $0.10
*** HOLE CARDS ***
Vaha379: raises $0.20 to $0.30
Squashy22: folds 
WillyDePoeh: folds 
Foky82: folds 
Xath76: folds 
sepek84: folds 
Uncalled bet ($0.20) returned to Vaha379
Vaha379 collected $0.25 from pot
Vaha379: doesn't show hand 
*** SUMMARY ***
Total pot $0.25 | Rake $0 
Seat 1: Xath76 (small blind) folded before Flop
Seat 2: sepek84 (big blind) folded before Flop
Seat 3: Vaha379 collected ($0.25)
Seat 4: Squashy22 folded before Flop (didn't bet)
Seat 5: WillyDePoeh folded before Flop (didn't bet)
Seat 6: Foky82 (button) folded before Flop (didn't bet)



PokerStars Hand #222953433737:  Hold'em No Limit ($0.05/$0.10 USD) - 2021/01/23 8:26:49 ET
Table 'Polydoros II' 6-max Seat #1 is the button
Seat 1: Xath76 ($10 in chips) 
Seat 2: sepek84 ($3.80 in chips) 
Seat 3: Vaha379 ($12.64 in chips) 
Seat 4: Squashy22 ($22.56 in chips) 
Seat 5: WillyDePoeh ($8.58 in chips) 
Seat 6: Foky82 ($10.27 in chips) 
sepek84: posts small blind $0.05
Vaha379: posts big blind $0.10
*** HOLE CARDS ***
Squashy22: folds 
WillyDePoeh: folds 
Foky82: folds 
Xath76: folds 
sepek84: calls $0.05
Vaha379: checks 
*** FLOP *** [Th Ah 7d]
sepek84: bets $0.10
Vaha379: folds 
Uncalled bet ($0.10) returned to sepek84
sepek84 collected $0.19 from pot
sepek84: doesn't show hand 
*** SUMMARY ***
Total pot $0.20 | Rake $0.01 
Board [Th Ah 7d]
Seat 1: Xath76 (button) folded before Flop (didn't bet)
Seat 2: sepek84 (small blind) collected ($0.19)
Seat 3: Vaha379 (big blind) folded on the Flop
Seat 4: Squashy22 folded before Flop (didn't bet)
Seat 5: WillyDePoeh folded before Flop (didn't bet)
Seat 6: Foky82 folded before Flop (didn't bet)



PokerStars Hand #222953442852:  Hold'em No Limit ($0.05/$0.10 USD) - 2021/01/23 8:27:10 ET
Table 'Polydoros II' 6-max Seat #2 is the button
Seat 1: Xath76 ($10 in chips) 
Seat 2: sepek84 ($3.89 in chips) 
Seat 3: Vaha379 ($12.54 in chips) 
Seat 4: Squashy22 ($22.56 in chips) 
Seat 5: WillyDePoeh ($8.58 in chips) 
Seat 6: Foky82 ($10.27 in chips) 
Vaha379: posts small blind $0.05
Squashy22: posts big blind $0.10
*** HOLE CARDS ***
WillyDePoeh: raises $0.10 to $0.20
Foky82: folds 
Xath76: folds 
sepek84: folds 
Vaha379: folds 
Squashy22: folds 
Uncalled bet ($0.10) returned to WillyDePoeh
WillyDePoeh collected $0.25 from pot
WillyDePoeh: doesn't show hand 
*** SUMMARY ***
Total pot $0.25 | Rake $0 
Seat 1: Xath76 folded before Flop (didn't bet)
Seat 2: sepek84 (button) folded before Flop (didn't bet)
Seat 3: Vaha379 (small blind) folded before Flop
Seat 4: Squashy22 (big blind) folded before Flop
Seat 5: WillyDePoeh collected ($0.25)
Seat 6: Foky82 folded before Flop (didn't bet)



PokerStars Hand #222953446019:  Hold'em No Limit ($0.05/$0.10 USD) - 2021/01/23 8:27:18 ET
Table 'Polydoros II' 6-max Seat #3 is the button
Seat 1: Xath76 ($10 in chips) 
Seat 2: sepek84 ($3.89 in chips) 
Seat 3: Vaha379 ($12.49 in chips) 
Seat 4: Squashy22 ($22.46 in chips) 
Seat 5: WillyDePoeh ($8.73 in chips) 
Seat 6: Foky82 ($10.27 in chips) 
Squashy22: posts small blind $0.05
WillyDePoeh: posts big blind $0.10
*** HOLE CARDS ***
Foky82: raises $0.20 to $0.30
Xath76: calls $0.30
sepek84: folds 
Vaha379: folds 
Squashy22: folds 
WillyDePoeh: calls $0.20
*** FLOP *** [9s Qc 2c]
WillyDePoeh: checks 
Foky82: checks 
Xath76: checks 
*** TURN *** [9s Qc 2c] [Kd]
WillyDePoeh: checks 
Foky82: checks 
Xath76: checks 
*** RIVER *** [9s Qc 2c Kd] [3d]
WillyDePoeh: checks 
Foky82: checks 
Xath76: checks 
*** SHOW DOWN ***
WillyDePoeh: shows [5h 6h] (high card King)
Foky82: shows [8s 8d] (a pair of Eights)
Xath76: mucks hand 
Foky82 collected $0.91 from pot
*** SUMMARY ***
Total pot $0.95 | Rake $0.04 
Board [9s Qc 2c Kd 3d]
Seat 1: Xath76 mucked
Seat 2: sepek84 folded before Flop (didn't bet)
Seat 3: Vaha379 (button) folded before Flop (didn't bet)
Seat 4: Squashy22 (small blind) folded before Flop
Seat 5: WillyDePoeh (big blind) showed [5h 6h] and lost with high card King
Seat 6: Foky82 showed [8s 8d] and won ($0.91) with a pair of Eights



PokerStars Hand #222953461708:  Hold'em No Limit ($0.05/$0.10 USD) - 2021/01/23 8:27:54 ET
Table 'Polydoros II' 6-max Seat #4 is the button
Seat 1: Xath76 ($10 in chips) 
Seat 2: sepek84 ($3.89 in chips) 
Seat 3: Vaha379 ($12.49 in chips) 
Seat 4: Squashy22 ($22.41 in chips) 
Seat 5: WillyDePoeh ($8.43 in chips) 
WillyDePoeh: posts small blind $0.05
Foky82: is sitting out 
Xath76: posts big blind $0.10
*** HOLE CARDS ***
sepek84: calls $0.10
Vaha379: folds 
Squashy22: folds 
WillyDePoeh: folds 
Xath76: checks 
*** FLOP *** [Qh As 9h]
Xath76: checks 
Foky82 leaves the table
sepek84: bets $0.10
Xath76: calls $0.10
*** TURN *** [Qh As 9h] [6s]
alexos04 joins the table at seat #6 
Xath76: checks 
sepek84: bets $0.20
Xath76: folds 
Uncalled bet ($0.20) returned to sepek84
sepek84 collected $0.43 from pot
sepek84: doesn't show hand 
*** SUMMARY ***
Total pot $0.45 | Rake $0.02 
Board [Qh As 9h 6s]
Seat 1: Xath76 (big blind) folded on the Turn
Seat 2: sepek84 collected ($0.43)
Seat 3: Vaha379 folded before Flop (didn't bet)
Seat 4: Squashy22 (button) folded before Flop (didn't bet)
Seat 5: WillyDePoeh (small blind) folded before Flop



PokerStars Hand #222953474307:  Hold'em No Limit ($0.05/$0.10 USD) - 2021/01/23 8:28:23 ET
Table 'Polydoros II' 6-max Seat #5 is the button
Seat 1: Xath76 ($10 in chips) 
Seat 2: sepek84 ($4.12 in chips) 
Seat 3: Vaha379 ($12.49 in chips) 
Seat 4: Squashy22 ($22.41 in chips) 
Seat 5: WillyDePoeh ($8.38 in chips) 
Xath76: posts small blind $0.05
sepek84: posts big blind $0.10
*** HOLE CARDS ***
Vaha379: raises $0.20 to $0.30
Squashy22: folds 
WillyDePoeh: calls $0.30
Xath76: calls $0.25
sepek84: calls $0.20
*** FLOP *** [Jh 6h 9c]
Xath76: checks 
sepek84: checks 
Vaha379: bets $0.47
WillyDePoeh: folds 
Xath76: folds 
sepek84: folds 
Uncalled bet ($0.47) returned to Vaha379
Vaha379 collected $1.15 from pot
Vaha379: doesn't show hand 
*** SUMMARY ***
Total pot $1.20 | Rake $0.05 
Board [Jh 6h 9c]
Seat 1: Xath76 (small blind) folded on the Flop
Seat 2: sepek84 (big blind) folded on the Flop
Seat 3: Vaha379 collected ($1.15)
Seat 4: Squashy22 folded before Flop (didn't bet)
Seat 5: WillyDePoeh (button) folded on the Flop



PokerStars Hand #222953485464:  Hold'em No Limit ($0.05/$0.10 USD) - 2021/01/23 8:28:48 ET
Table 'Polydoros II' 6-max Seat #1 is the button
Seat 1: Xath76 ($10 in chips) 
Seat 2: sepek84 ($3.82 in chips) 
Seat 3: Vaha379 ($13.34 in chips) 
Seat 4: Squashy22 ($22.41 in chips) 
Seat 5: WillyDePoeh ($8.08 in chips) 
sepek84: posts small blind $0.05
Vaha379: posts big blind $0.10
alexos04: sits out 
*** HOLE CARDS ***
Squashy22: folds 
WillyDePoeh: folds 
Xath76: folds 
sepek84: calls $0.05
Vaha379: raises $0.30 to $0.40
sepek84: calls $0.30
*** FLOP *** [Jd 9s 5d]
sepek84: checks 
Vaha379: checks 
*** TURN *** [Jd 9s 5d] [4h]
sepek84: bets $0.10
Vaha379: calls $0.10
*** RIVER *** [Jd 9s 5d 4h] [8d]
sepek84: bets $0.10
Vaha379: calls $0.10
*** SHOW DOWN ***
sepek84: shows [Th Jc] (a pair of Jacks)
Vaha379: mucks hand 
sepek84 collected $1.15 from pot
*** SUMMARY ***
Total pot $1.20 | Rake $0.05 
Board [Jd 9s 5d 4h 8d]
Seat 1: Xath76 (button) folded before Flop (didn't bet)
Seat 2: sepek84 (small blind) showed [Th Jc] and won ($1.15) with a pair of Jacks
Seat 3: Vaha379 (big blind) mucked
Seat 4: Squashy22 folded before Flop (didn't bet)
Seat 5: WillyDePoeh folded before Flop (didn't bet)



PokerStars Hand #222953499625:  Hold'em No Limit ($0.05/$0.10 USD) - 2021/01/23 8:29:21 ET
Table 'Polydoros II' 6-max Seat #2 is the button
Seat 1: Xath76 ($10 in chips) 
Seat 2: sepek84 ($4.37 in chips) 
Seat 3: Vaha379 ($12.74 in chips) 
Seat 4: Squashy22 ($22.41 in chips) 
Seat 5: WillyDePoeh ($8.08 in chips) 
Vaha379: posts small blind $0.05
Squashy22: posts big blind $0.10
alexos04: sits out 
*** HOLE CARDS ***
WillyDePoeh: raises $0.20 to $0.30
Xath76: folds 
sepek84: folds 
Vaha379: folds 
Squashy22: folds 
Uncalled bet ($0.20) returned to WillyDePoeh
WillyDePoeh collected $0.25 from pot
WillyDePoeh: doesn't show hand 
*** SUMMARY ***
Total pot $0.25 | Rake $0 
Seat 1: Xath76 folded before Flop (didn't bet)
Seat 2: sepek84 (button) folded before Flop (didn't bet)
Seat 3: Vaha379 (small blind) folded before Flop
Seat 4: Squashy22 (big blind) folded before Flop
Seat 5: WillyDePoeh collected ($0.25)



PokerStars Hand #222953503402:  Hold'em No Limit ($0.05/$0.10 USD) - 2021/01/23 8:29:29 ET
Table 'Polydoros II' 6-max Seat #3 is the button
Seat 1: Xath76 ($10 in chips) 
Seat 2: sepek84 ($4.37 in chips) 
Seat 3: Vaha379 ($12.69 in chips) 
Seat 4: Squashy22 ($22.31 in chips) 
Seat 5: WillyDePoeh ($8.23 in chips) 
Squashy22: posts small blind $0.05
WillyDePoeh: posts big blind $0.10
alexos04: sits out 
*** HOLE CARDS ***
Xath76: folds 
sepek84: folds 
Vaha379: folds 
Squashy22: raises $0.14 to $0.24
WillyDePoeh: folds 
Uncalled bet ($0.14) returned to Squashy22
Squashy22 collected $0.20 from pot
Squashy22: doesn't show hand 
*** SUMMARY ***
Total pot $0.20 | Rake $0 
Seat 1: Xath76 folded before Flop (didn't bet)
Seat 2: sepek84 folded before Flop (didn't bet)
Seat 3: Vaha379 (button) folded before Flop (didn't bet)
Seat 4: Squashy22 (small blind) collected ($0.20)
Seat 5: WillyDePoeh (big blind) folded before Flop



PokerStars Hand #222953510255:  Hold'em No Limit ($0.05/$0.10 USD) - 2021/01/23 8:29:45 ET
Table 'Polydoros II' 6-max Seat #4 is the button
Seat 1: Xath76 ($10 in chips) 
Seat 2: sepek84 ($4.37 in chips) 
Seat 3: Vaha379 ($12.69 in chips) 
Seat 4: Squashy22 ($22.41 in chips) 
Seat 5: WillyDePoeh ($8.13 in chips) 
Seat 6: alexos04 ($10 in chips) 
WillyDePoeh: posts small blind $0.05
alexos04: posts big blind $0.10
*** HOLE CARDS ***
Xath76: folds 
sepek84: folds 
Vaha379: raises $0.20 to $0.30
Squashy22: folds 
WillyDePoeh: folds 
alexos04: calls $0.20
*** FLOP *** [Js 7d 5s]
alexos04: checks 
Vaha379: bets $0.32
alexos04: calls $0.32
*** TURN *** [Js 7d 5s] [2h]
alexos04: checks 
Vaha379: checks 
*** RIVER *** [Js 7d 5s 2h] [4s]
alexos04: checks 
Vaha379: checks 
*** SHOW DOWN ***
alexos04: shows [8c 8d] (a pair of Eights)
Vaha379: mucks hand 
alexos04 collected $1.23 from pot
*** SUMMARY ***
Total pot $1.29 | Rake $0.06 
Board [Js 7d 5s 2h 4s]
Seat 1: Xath76 folded before Flop (didn't bet)
Seat 2: sepek84 folded before Flop (didn't bet)
Seat 3: Vaha379 mucked
Seat 4: Squashy22 (button) folded before Flop (didn't bet)
Seat 5: WillyDePoeh (small blind) folded before Flop
Seat 6: alexos04 (big blind) showed [8c 8d] and won ($1.23) with a pair of Eights



PokerStars Hand #222953536978:  Hold'em No Limit ($0.05/$0.10 USD) - 2021/01/23 8:30:45 ET
Table 'Polydoros II' 6-max Seat #5 is the button
Seat 1: Xath76 ($10 in chips) 
Seat 2: sepek84 ($4.37 in chips) 
Seat 3: Vaha379 ($12.07 in chips) 
Seat 4: Squashy22 ($22.41 in chips) 
Seat 5: WillyDePoeh ($8.08 in chips) 
Seat 6: alexos04 ($10.61 in chips) 
alexos04: posts small blind $0.05
Xath76: posts big blind $0.10
*** HOLE CARDS ***
sepek84: calls $0.10
Vaha379: folds 
Squashy22: folds 
WillyDePoeh: folds 
alexos04: folds 
Xath76: checks 
*** FLOP *** [Qc Kc 6c]
Xath76: checks 
sepek84: bets $0.10
Xath76: folds 
Uncalled bet ($0.10) returned to sepek84
sepek84 collected $0.24 from pot
sepek84: doesn't show hand 
*** SUMMARY ***
Total pot $0.25 | Rake $0.01 
Board [Qc Kc 6c]
Seat 1: Xath76 (big blind) folded on the Flop
Seat 2: sepek84 collected ($0.24)
Seat 3: Vaha379 folded before Flop (didn't bet)
Seat 4: Squashy22 folded before Flop (didn't bet)
Seat 5: WillyDePoeh (button) folded before Flop (didn't bet)
Seat 6: alexos04 (small blind) folded before Flop



PokerStars Hand #222953543104:  Hold'em No Limit ($0.05/$0.10 USD) - 2021/01/23 8:30:59 ET
Table 'Polydoros II' 6-max Seat #6 is the button
Seat 1: Xath76 ($10 in chips) 
Seat 2: sepek84 ($4.51 in chips) 
Seat 3: Vaha379 ($12.07 in chips) 
Seat 4: Squashy22 ($22.41 in chips) 
Seat 5: WillyDePoeh ($8.08 in chips) 
Seat 6: alexos04 ($10.56 in chips) 
Xath76: posts small blind $0.05
sepek84: posts big blind $0.10
*** HOLE CARDS ***
Vaha379: folds 
Squashy22: folds 
WillyDePoeh: folds 
alexos04: raises $0.20 to $0.30
Xath76: folds 
sepek84: folds 
Uncalled bet ($0.20) returned to alexos04
alexos04 collected $0.25 from pot
alexos04: doesn't show hand 
*** SUMMARY ***
Total pot $0.25 | Rake $0 
Seat 1: Xath76 (small blind) folded before Flop
Seat 2: sepek84 (big blind) folded before Flop
Seat 3: Vaha379 folded before Flop (didn't bet)
Seat 4: Squashy22 folded before Flop (didn't bet)
Seat 5: WillyDePoeh folded before Flop (didn't bet)
Seat 6: alexos04 (button) collected ($0.25)



PokerStars Hand #222953548547:  Hold'em No Limit ($0.05/$0.10 USD) - 2021/01/23 8:31:11 ET
Table 'Polydoros II' 6-max Seat #1 is the button
Seat 1: Xath76 ($10 in chips) 
Seat 2: sepek84 ($4.41 in chips) 
Seat 3: Vaha379 ($12.07 in chips) 
Seat 4: Squashy22 ($22.41 in chips) 
Seat 5: WillyDePoeh ($8.08 in chips) 
Seat 6: alexos04 ($10.71 in chips) 
sepek84: posts small blind $0.05
Vaha379: posts big blind $0.10
*** HOLE CARDS ***
Squashy22: raises $0.19 to $0.29
WillyDePoeh: folds 
alexos04: folds 
Xath76: folds 
sepek84: folds 
Vaha379: folds 
Uncalled bet ($0.19) returned to Squashy22
Squashy22 collected $0.25 from pot
Squashy22: doesn't show hand 
*** SUMMARY ***
Total pot $0.25 | Rake $0 
Seat 1: Xath76 (button) folded before Flop (didn't bet)
Seat 2: sepek84 (small blind) folded before Flop
Seat 3: Vaha379 (big blind) folded before Flop
Seat 4: Squashy22 collected ($0.25)
Seat 5: WillyDePoeh folded before Flop (didn't bet)
Seat 6: alexos04 folded before Flop (didn't bet)



PokerStars Hand #222953561603:  Hold'em No Limit ($0.05/$0.10 USD) - 2021/01/23 8:31:41 ET
Table 'Polydoros II' 6-max Seat #2 is the button
Seat 1: Xath76 ($10 in chips) 
Seat 2: sepek84 ($4.36 in chips) 
Seat 3: Vaha379 ($11.97 in chips) 
Seat 4: Squashy22 ($22.56 in chips) 
Seat 5: WillyDePoeh ($8.08 in chips) 
Seat 6: alexos04 ($10.71 in chips) 
Vaha379: posts small blind $0.05
Squashy22: posts big blind $0.10
*** HOLE CARDS ***
WillyDePoeh: raises $0.20 to $0.30
alexos04: calls $0.30
Xath76: calls $0.30
sepek84: folds 
Vaha379: folds 
Squashy22: folds 
*** FLOP *** [Td 5d 9h]
WillyDePoeh: bets $0.50
alexos04: calls $0.50
Xath76: calls $0.50
*** TURN *** [Td 5d 9h] [Ah]
WillyDePoeh: bets $1.10
alexos04: raises $2.40 to $3.50
Xath76: folds 
WillyDePoeh: raises $3.78 to $7.28 and is all-in
alexos04: calls $3.78
*** RIVER *** [Td 5d 9h Ah] [4c]
*** SHOW DOWN ***
WillyDePoeh: shows [Jd Ac] (a pair of Aces)
alexos04: shows [Ad 9d] (two pair, Aces and Nines)
alexos04 collected $16.34 from pot
*** SUMMARY ***
Total pot $17.11 | Rake $0.77 
Board [Td 5d 9h Ah 4c]
Seat 1: Xath76 folded on the Turn
Seat 2: sepek84 (button) folded before Flop (didn't bet)
Seat 3: Vaha379 (small blind) folded before Flop
Seat 4: Squashy22 (big blind) folded before Flop
Seat 5: WillyDePoeh showed [Jd Ac] and lost with a pair of Aces
Seat 6: alexos04 showed [Ad 9d] and won ($16.34) with two pair, Aces and Nines



PokerStars Hand #222953582341:  Hold'em No Limit ($0.05/$0.10 USD) - 2021/01/23 8:32:27 ET
Table 'Polydoros II' 6-max Seat #3 is the button
Seat 1: Xath76 ($10 in chips) 
Seat 2: sepek84 ($4.36 in chips) 
Seat 3: Vaha379 ($11.92 in chips) 
Seat 4: Squashy22 ($22.46 in chips) 
Seat 6: alexos04 ($18.97 in chips) 
Squashy22: posts small blind $0.05
alexos04: posts big blind $0.10
*** HOLE CARDS ***
Xath76: folds 
WillyDePoeh leaves the table
sepek84: raises $0.10 to $0.20
Vaha379: raises $0.55 to $0.75
Squashy22: folds 
alexos04: folds 
sepek84: folds 
Uncalled bet ($0.55) returned to Vaha379
Vaha379 collected $0.55 from pot
Vaha379: doesn't show hand 
*** SUMMARY ***
Total pot $0.55 | Rake $0 
Seat 1: Xath76 folded before Flop (didn't bet)
Seat 2: sepek84 folded before Flop
Seat 3: Vaha379 (button) collected ($0.55)
Seat 4: Squashy22 (small blind) folded before Flop
Seat 6: alexos04 (big blind) folded before Flop



PokerStars Hand #222953595756:  Hold'em No Limit ($0.05/$0.10 USD) - 2021/01/23 8:32:57 ET
Table 'Polydoros II' 6-max Seat #4 is the button
Seat 1: Xath76 ($10 in chips) 
Seat 2: sepek84 ($4.16 in chips) 
Seat 3: Vaha379 ($12.27 in chips) 
Seat 4: Squashy22 ($22.41 in chips) 
Seat 6: alexos04 ($18.87 in chips) 
alexos04: posts small blind $0.05
Xath76: posts big blind $0.10
*** HOLE CARDS ***
sepek84: folds 
Vaha379: folds 
Squashy22: raises $0.16 to $0.26
alexos04: folds 
Xath76: folds 
Uncalled bet ($0.16) returned to Squashy22
Squashy22 collected $0.25 from pot
Squashy22: doesn't show hand 
*** SUMMARY ***
Total pot $0.25 | Rake $0 
Seat 1: Xath76 (big blind) folded before Flop
Seat 2: sepek84 folded before Flop (didn't bet)
Seat 3: Vaha379 folded before Flop (didn't bet)
Seat 4: Squashy22 (button) collected ($0.25)
Seat 6: alexos04 (small blind) folded before Flop



PokerStars Hand #222953600380:  Hold'em No Limit ($0.05/$0.10 USD) - 2021/01/23 8:33:08 ET
Table 'Polydoros II' 6-max Seat #6 is the button
Seat 1: Xath76 ($10 in chips) 
Seat 2: sepek84 ($4.16 in chips) 
Seat 3: Vaha379 ($12.27 in chips) 
Seat 4: Squashy22 ($22.56 in chips) 
Seat 6: alexos04 ($18.82 in chips) 
Xath76: posts small blind $0.05
sepek84: posts big blind $0.10
*** HOLE CARDS ***
Vaha379: folds 
Squashy22: folds 
einsftw joins the table at seat #5 
alexos04: raises $0.20 to $0.30
Xath76: folds 
sepek84: calls $0.20
*** FLOP *** [8d Ts 5d]
sepek84: bets $0.20
alexos04: raises $0.70 to $0.90
sepek84: raises $2.96 to $3.86 and is all-in
alexos04: calls $2.96
*** TURN *** [8d Ts 5d] [5c]
*** RIVER *** [8d Ts 5d 5c] [Ac]
*** SHOW DOWN ***
sepek84: shows [7h Th] (two pair, Tens and Fives)
alexos04: shows [Tc As] (two pair, Aces and Tens)
alexos04 collected $7.99 from pot
*** SUMMARY ***
Total pot $8.37 | Rake $0.38 
Board [8d Ts 5d 5c Ac]
Seat 1: Xath76 (small blind) folded before Flop
Seat 2: sepek84 (big blind) showed [7h Th] and lost with two pair, Tens and Fives
Seat 3: Vaha379 folded before Flop (didn't bet)
Seat 4: Squashy22 folded before Flop (didn't bet)
Seat 6: alexos04 (button) showed [Tc As] and won ($7.99) with two pair, Aces and Tens



PokerStars Hand #222953624009:  Hold'em No Limit ($0.05/$0.10 USD) - 2021/01/23 8:34:01 ET
Table 'Polydoros II' 6-max Seat #1 is the button
Seat 1: Xath76 ($10 in chips) 
Seat 3: Vaha379 ($12.27 in chips) 
Seat 4: Squashy22 ($22.56 in chips) 
Seat 6: alexos04 ($22.65 in chips) 
Vaha379: posts small blind $0.05
Squashy22: posts big blind $0.10
einsftw: sits out 
*** HOLE CARDS ***
alexos04: raises $0.20 to $0.30
Xath76: folds 
Vaha379: folds 
Squashy22: folds 
Uncalled bet ($0.20) returned to alexos04
alexos04 collected $0.25 from pot
alexos04: doesn't show hand 
sepek84 leaves the table
*** SUMMARY ***
Total pot $0.25 | Rake $0 
Seat 1: Xath76 (button) folded before Flop (didn't bet)
Seat 3: Vaha379 (small blind) folded before Flop
Seat 4: Squashy22 (big blind) folded before Flop
Seat 6: alexos04 collected ($0.25)



PokerStars Hand #222953628438:  Hold'em No Limit ($0.05/$0.10 USD) - 2021/01/23 8:34:11 ET
Table 'Polydoros II' 6-max Seat #3 is the button
Seat 1: Xath76 ($10 in chips) 
Seat 3: Vaha379 ($12.22 in chips) 
Seat 4: Squashy22 ($22.46 in chips) 
Seat 5: einsftw ($10 in chips) 
Seat 6: alexos04 ($22.80 in chips) 
Squashy22: posts small blind $0.05
einsftw: posts big blind $0.10
*** HOLE CARDS ***
alexos04: raises $0.20 to $0.30
Xath76: folds 
Vaha379: folds 
Squashy22: folds 
einsftw: folds 
Uncalled bet ($0.20) returned to alexos04
alexos04 collected $0.25 from pot
alexos04: doesn't show hand 
*** SUMMARY ***
Total pot $0.25 | Rake $0 
Seat 1: Xath76 folded before Flop (didn't bet)
Seat 3: Vaha379 (button) folded before Flop (didn't bet)
Seat 4: Squashy22 (small blind) folded before Flop
Seat 5: einsftw (big blind) folded before Flop
Seat 6: alexos04 collected ($0.25)



PokerStars Hand #222953633248:  Hold'em No Limit ($0.05/$0.10 USD) - 2021/01/23 8:34:21 ET
Table 'Polydoros II' 6-max Seat #4 is the button
Seat 1: Xath76 ($10 in chips) 
Seat 3: Vaha379 ($12.22 in chips) 
Seat 4: Squashy22 ($22.41 in chips) 
Seat 5: einsftw ($10 in chips) 
Seat 6: alexos04 ($22.95 in chips) 
einsftw: posts small blind $0.05
alexos04: posts big blind $0.10
*** HOLE CARDS ***
Xath76: folds 
Vaha379: folds 
Squashy22: raises $0.16 to $0.26
einsftw: folds 
alexos04: folds 
Uncalled bet ($0.16) returned to Squashy22
Squashy22 collected $0.25 from pot
Squashy22: doesn't show hand 
*** SUMMARY ***
Total pot $0.25 | Rake $0 
Seat 1: Xath76 folded before Flop (didn't bet)
Seat 3: Vaha379 folded before Flop (didn't bet)
Seat 4: Squashy22 (button) collected ($0.25)
Seat 5: einsftw (small blind) folded before Flop
Seat 6: alexos04 (big blind) folded before Flop



PokerStars Hand #222953638729:  Hold'em No Limit ($0.05/$0.10 USD) - 2021/01/23 8:34:34 ET
Table 'Polydoros II' 6-max Seat #5 is the button
Seat 1: Xath76 ($10 in chips) 
Seat 3: Vaha379 ($12.22 in chips) 
Seat 4: Squashy22 ($22.56 in chips) 
Seat 5: einsftw ($10 in chips) 
Seat 6: alexos04 ($22.85 in chips) 
alexos04: posts small blind $0.05
Xath76: posts big blind $0.10
*** HOLE CARDS ***
Vaha379: folds 
Squashy22: folds 
einsftw: raises $0.12 to $0.22
alexos04: folds 
Xath76: folds 
Uncalled bet ($0.12) returned to einsftw
einsftw collected $0.25 from pot
einsftw: doesn't show hand 
*** SUMMARY ***
Total pot $0.25 | Rake $0 
Seat 1: Xath76 (big blind) folded before Flop
Seat 3: Vaha379 folded before Flop (didn't bet)
Seat 4: Squashy22 folded before Flop (didn't bet)
Seat 5: einsftw (button) collected ($0.25)
Seat 6: alexos04 (small blind) folded before Flop



PokerStars Hand #222953644910:  Hold'em No Limit ($0.05/$0.10 USD) - 2021/01/23 8:34:47 ET
Table 'Polydoros II' 6-max Seat #6 is the button
Seat 1: Xath76 ($10 in chips) 
Seat 3: Vaha379 ($12.22 in chips) 
Seat 4: Squashy22 ($22.56 in chips) 
Seat 5: einsftw ($10.15 in chips) 
Seat 6: alexos04 ($22.80 in chips) 
Xath76: posts small blind $0.05
Vaha379: posts big blind $0.10
*** HOLE CARDS ***
Squashy22: folds 
einsftw: folds 
alexos04: folds 
Xath76: folds 
Uncalled bet ($0.05) returned to Vaha379
Vaha379 collected $0.10 from pot
Vaha379: doesn't show hand 
*** SUMMARY ***
Total pot $0.10 | Rake $0 
Seat 1: Xath76 (small blind) folded before Flop
Seat 3: Vaha379 (big blind) collected ($0.10)
Seat 4: Squashy22 folded before Flop (didn't bet)
Seat 5: einsftw folded before Flop (didn't bet)
Seat 6: alexos04 (button) folded before Flop (didn't bet)



PokerStars Hand #222953651636:  Hold'em No Limit ($0.05/$0.10 USD) - 2021/01/23 8:35:02 ET
Table 'Polydoros II' 6-max Seat #1 is the button
Seat 1: Xath76 ($10 in chips) 
Seat 3: Vaha379 ($12.27 in chips) 
Seat 4: Squashy22 ($22.56 in chips) 
Seat 5: einsftw ($10.15 in chips) 
Seat 6: alexos04 ($22.80 in chips) 
Vaha379: posts small blind $0.05
Squashy22: posts big blind $0.10
*** HOLE CARDS ***
einsftw: folds 
alexos04: folds 
Xath76: folds 
Vaha379: folds 
Uncalled bet ($0.05) returned to Squashy22
Squashy22 collected $0.10 from pot
Squashy22: doesn't show hand 
*** SUMMARY ***
Total pot $0.10 | Rake $0 
Seat 1: Xath76 (button) folded before Flop (didn't bet)
Seat 3: Vaha379 (small blind) folded before Flop
Seat 4: Squashy22 (big blind) collected ($0.10)
Seat 5: einsftw folded before Flop (didn't bet)
Seat 6: alexos04 folded before Flop (didn't bet)



PokerStars Hand #222953654447:  Hold'em No Limit ($0.05/$0.10 USD) - 2021/01/23 8:35:09 ET
Table 'Polydoros II' 6-max Seat #3 is the button
Seat 1: Xath76 ($10 in chips) 
Seat 3: Vaha379 ($12.22 in chips) 
Seat 4: Squashy22 ($22.61 in chips) 
Seat 5: einsftw ($10.15 in chips) 
Seat 6: alexos04 ($22.80 in chips) 
Squashy22: posts small blind $0.05
einsftw: posts big blind $0.10
*** HOLE CARDS ***
alexos04: raises $0.20 to $0.30
Xath76: folds 
Vaha379: raises $0.75 to $1.05
Squashy22: folds 
einsftw: folds 
alexos04: folds 
Uncalled bet ($0.75) returned to Vaha379
Vaha379 collected $0.75 from pot
Vaha379: doesn't show hand 
*** SUMMARY ***
Total pot $0.75 | Rake $0 
Seat 1: Xath76 folded before Flop (didn't bet)
Seat 3: Vaha379 (button) collected ($0.75)
Seat 4: Squashy22 (small blind) folded before Flop
Seat 5: einsftw (big blind) folded before Flop
Seat 6: alexos04 folded before Flop



PokerStars Hand #222953662011:  Hold'em No Limit ($0.05/$0.10 USD) - 2021/01/23 8:35:26 ET
Table 'Polydoros II' 6-max Seat #4 is the button
Seat 1: Xath76 ($10 in chips) 
Seat 3: Vaha379 ($12.67 in chips) 
Seat 4: Squashy22 ($22.56 in chips) 
Seat 5: einsftw ($10.05 in chips) 
Seat 6: alexos04 ($22.50 in chips) 
einsftw: posts small blind $0.05
alexos04: posts big blind $0.10
*** HOLE CARDS ***
Xath76: folds 
voronin885 joins the table at seat #2 
Vaha379: folds 
Squashy22: folds 
einsftw: raises $0.12 to $0.22
alexos04: folds 
Uncalled bet ($0.12) returned to einsftw
einsftw collected $0.20 from pot
einsftw: doesn't show hand 
*** SUMMARY ***
Total pot $0.20 | Rake $0 
Seat 1: Xath76 folded before Flop (didn't bet)
Seat 3: Vaha379 folded before Flop (didn't bet)
Seat 4: Squashy22 (button) folded before Flop (didn't bet)
Seat 5: einsftw (small blind) collected ($0.20)
Seat 6: alexos04 (big blind) folded before Flop



PokerStars Hand #222953669644:  Hold'em No Limit ($0.05/$0.10 USD) - 2021/01/23 8:35:43 ET
Table 'Polydoros II' 6-max Seat #5 is the button
Seat 1: Xath76 ($10 in chips) 
Seat 3: Vaha379 ($12.67 in chips) 
Seat 4: Squashy22 ($22.56 in chips) 
Seat 5: einsftw ($10.15 in chips) 
Seat 6: alexos04 ($22.40 in chips) 
alexos04: posts small blind $0.05
Xath76: posts big blind $0.10
voronin885: sits out 
*** HOLE CARDS ***
Vaha379: folds 
Squashy22: folds 
einsftw: folds 
alexos04: folds 
Uncalled bet ($0.05) returned to Xath76
Xath76 collected $0.10 from pot
Xath76: doesn't show hand 
*** SUMMARY ***
Total pot $0.10 | Rake $0 
Seat 1: Xath76 (big blind) collected ($0.10)
Seat 3: Vaha379 folded before Flop (didn't bet)
Seat 4: Squashy22 folded before Flop (didn't bet)
Seat 5: einsftw (button) folded before Flop (didn't bet)
Seat 6: alexos04 (small blind) folded before Flop



PokerStars Hand #222953676678:  Hold'em No Limit ($0.05/$0.10 USD) - 2021/01/23 8:35:59 ET
Table 'Polydoros II' 6-max Seat #6 is the button
Seat 1: Xath76 ($10.05 in chips) 
Seat 2: voronin885 ($8 in chips) 
Seat 3: Vaha379 ($12.67 in chips) 
Seat 4: Squashy22 ($22.56 in chips) 
Seat 5: einsftw ($10.15 in chips) 
Seat 6: alexos04 ($22.35 in chips) 
Xath76: posts small blind $0.05
voronin885: posts big blind $0.10
*** HOLE CARDS ***
Vaha379: folds 
Squashy22: folds 
einsftw: folds 
alexos04: folds 
Xath76: folds 
Uncalled bet ($0.05) returned to voronin885
voronin885 collected $0.10 from pot
voronin885: doesn't show hand 
*** SUMMARY ***
Total pot $0.10 | Rake $0 
Seat 1: Xath76 (small blind) folded before Flop
Seat 2: voronin885 (big blind) collected ($0.10)
Seat 3: Vaha379 folded before Flop (didn't bet)
Seat 4: Squashy22 folded before Flop (didn't bet)
Seat 5: einsftw folded before Flop (didn't bet)
Seat 6: alexos04 (button) folded before Flop (didn't bet)



PokerStars Hand #222953683404:  Hold'em No Limit ($0.05/$0.10 USD) - 2021/01/23 8:36:14 ET
Table 'Polydoros II' 6-max Seat #1 is the button
Seat 1: Xath76 ($10 in chips) 
Seat 2: voronin885 ($8.05 in chips) 
Seat 3: Vaha379 ($12.67 in chips) 
Seat 4: Squashy22 ($22.56 in chips) 
Seat 5: einsftw ($10.15 in chips) 
Seat 6: alexos04 ($22.35 in chips) 
voronin885: posts small blind $0.05
Vaha379: posts big blind $0.10
*** HOLE CARDS ***
Squashy22: folds 
einsftw: folds 
alexos04: folds 
Xath76: folds 
voronin885: folds 
Uncalled bet ($0.05) returned to Vaha379
Vaha379 collected $0.10 from pot
Vaha379: doesn't show hand 
*** SUMMARY ***
Total pot $0.10 | Rake $0 
Seat 1: Xath76 (button) folded before Flop (didn't bet)
Seat 2: voronin885 (small blind) folded before Flop
Seat 3: Vaha379 (big blind) collected ($0.10)
Seat 4: Squashy22 folded before Flop (didn't bet)
Seat 5: einsftw folded before Flop (didn't bet)
Seat 6: alexos04 folded before Flop (didn't bet)



PokerStars Hand #222953688898:  Hold'em No Limit ($0.05/$0.10 USD) - 2021/01/23 8:36:26 ET
Table 'Polydoros II' 6-max Seat #2 is the button
Seat 1: Xath76 ($10 in chips) 
Seat 2: voronin885 ($8 in chips) 
Seat 3: Vaha379 ($12.72 in chips) 
Seat 4: Squashy22 ($22.56 in chips) 
Seat 5: einsftw ($10.15 in chips) 
Seat 6: alexos04 ($22.35 in chips) 
Vaha379: posts small blind $0.05
Squashy22: posts big blind $0.10
*** HOLE CARDS ***
einsftw: folds 
alexos04: folds 
Xath76: folds 
voronin885: folds 
Vaha379: folds 
Uncalled bet ($0.05) returned to Squashy22
Squashy22 collected $0.10 from pot
Squashy22: doesn't show hand 
*** SUMMARY ***
Total pot $0.10 | Rake $0 
Seat 1: Xath76 folded before Flop (didn't bet)
Seat 2: voronin885 (button) folded before Flop (didn't bet)
Seat 3: Vaha379 (small blind) folded before Flop
Seat 4: Squashy22 (big blind) collected ($0.10)
Seat 5: einsftw folded before Flop (didn't bet)
Seat 6: alexos04 folded before Flop (didn't bet)



PokerStars Hand #222953692135:  Hold'em No Limit ($0.05/$0.10 USD) - 2021/01/23 8:36:34 ET
Table 'Polydoros II' 6-max Seat #3 is the button
Seat 1: Xath76 ($10 in chips) 
Seat 2: voronin885 ($8 in chips) 
Seat 3: Vaha379 ($12.67 in chips) 
Seat 4: Squashy22 ($22.61 in chips) 
Seat 5: einsftw ($10.15 in chips) 
Seat 6: alexos04 ($22.35 in chips) 
Squashy22: posts small blind $0.05
einsftw: posts big blind $0.10
*** HOLE CARDS ***
alexos04: folds 
Xath76: folds 
voronin885: raises $0.25 to $0.35
Vaha379: folds 
Squashy22: raises $0.80 to $1.15
einsftw: folds 
voronin885: calls $0.80
*** FLOP *** [Tc Jh Jd]
Squashy22: bets $0.98
voronin885: folds 
Uncalled bet ($0.98) returned to Squashy22
Squashy22 collected $2.29 from pot
Squashy22: doesn't show hand 
*** SUMMARY ***
Total pot $2.40 | Rake $0.11 
Board [Tc Jh Jd]
Seat 1: Xath76 folded before Flop (didn't bet)
Seat 2: voronin885 folded on the Flop
Seat 3: Vaha379 (button) folded before Flop (didn't bet)
Seat 4: Squashy22 (small blind) collected ($2.29)
Seat 5: einsftw (big blind) folded before Flop
Seat 6: alexos04 folded before Flop (didn't bet)



PokerStars Hand #222953705242:  Hold'em No Limit ($0.05/$0.10 USD) - 2021/01/23 8:37:03 ET
Table 'Polydoros II' 6-max Seat #4 is the button
Seat 1: Xath76 ($10 in chips) 
Seat 2: voronin885 ($6.85 in chips) 
Seat 3: Vaha379 ($12.67 in chips) 
Seat 4: Squashy22 ($23.75 in chips) 
Seat 5: einsftw ($10.05 in chips) 
Seat 6: alexos04 ($22.35 in chips) 
einsftw: posts small blind $0.05
alexos04: posts big blind $0.10
*** HOLE CARDS ***
Xath76: raises $0.20 to $0.30
voronin885: calls $0.30
Vaha379: folds 
Squashy22: folds 
einsftw: folds 
alexos04: folds 
*** FLOP *** [9c 2d 2s]
Xath76: bets $0.36
voronin885: raises $0.36 to $0.72
Xath76: calls $0.36
*** TURN *** [9c 2d 2s] [Kc]
Xath76: checks 
voronin885: bets $2.09
Xath76: calls $2.09
*** RIVER *** [9c 2d 2s Kc] [7h]
Xath76: checks 
voronin885: bets $3.74 and is all-in
Xath76: folds 
Uncalled bet ($3.74) returned to voronin885
voronin885 collected $6.08 from pot
voronin885: doesn't show hand 
*** SUMMARY ***
Total pot $6.37 | Rake $0.29 
Board [9c 2d 2s Kc 7h]
Seat 1: Xath76 folded on the River
Seat 2: voronin885 collected ($6.08)
Seat 3: Vaha379 folded before Flop (didn't bet)
Seat 4: Squashy22 (button) folded before Flop (didn't bet)
Seat 5: einsftw (small blind) folded before Flop
Seat 6: alexos04 (big blind) folded before Flop



PokerStars Hand #222953721284:  Hold'em No Limit ($0.05/$0.10 USD) - 2021/01/23 8:37:39 ET
Table 'Polydoros II' 6-max Seat #5 is the button
Seat 1: Xath76 ($10 in chips) 
Seat 2: voronin885 ($9.82 in chips) 
Seat 3: Vaha379 ($12.67 in chips) 
Seat 4: Squashy22 ($23.75 in chips) 
Seat 5: einsftw ($10 in chips) 
Seat 6: alexos04 ($22.25 in chips) 
alexos04: posts small blind $0.05
Xath76: posts big blind $0.10
*** HOLE CARDS ***
voronin885: raises $0.25 to $0.35
Vaha379: folds 
Squashy22: folds 
einsftw: folds 
alexos04: folds 
Xath76: calls $0.25
*** FLOP *** [As 6c 7h]
Xath76: checks 
voronin885: bets $0.72
Xath76: folds 
Uncalled bet ($0.72) returned to voronin885
voronin885 collected $0.72 from pot
voronin885: doesn't show hand 
*** SUMMARY ***
Total pot $0.75 | Rake $0.03 
Board [As 6c 7h]
Seat 1: Xath76 (big blind) folded on the Flop
Seat 2: voronin885 collected ($0.72)
Seat 3: Vaha379 folded before Flop (didn't bet)
Seat 4: Squashy22 folded before Flop (didn't bet)
Seat 5: einsftw (button) folded before Flop (didn't bet)
Seat 6: alexos04 (small blind) folded before Flop



PokerStars Hand #222953735150:  Hold'em No Limit ($0.05/$0.10 USD) - 2021/01/23 8:38:10 ET
Table 'Polydoros II' 6-max Seat #6 is the button
Seat 1: Xath76 ($10 in chips) 
Seat 2: voronin885 ($10.19 in chips) 
Seat 3: Vaha379 ($12.67 in chips) 
Seat 4: Squashy22 ($23.75 in chips) 
Seat 5: einsftw ($10 in chips) 
Seat 6: alexos04 ($22.20 in chips) 
Xath76: posts small blind $0.05
voronin885: posts big blind $0.10
*** HOLE CARDS ***
Vaha379: folds 
Squashy22: folds 
einsftw: folds 
alexos04: raises $0.20 to $0.30
Xath76: folds 
voronin885: folds 
Uncalled bet ($0.20) returned to alexos04
alexos04 collected $0.25 from pot
alexos04: doesn't show hand 
*** SUMMARY ***
Total pot $0.25 | Rake $0 
Seat 1: Xath76 (small blind) folded before Flop
Seat 2: voronin885 (big blind) folded before Flop
Seat 3: Vaha379 folded before Flop (didn't bet)
Seat 4: Squashy22 folded before Flop (didn't bet)
Seat 5: einsftw folded before Flop (didn't bet)
Seat 6: alexos04 (button) collected ($0.25)



PokerStars Hand #222953741969:  Hold'em No Limit ($0.05/$0.10 USD) - 2021/01/23 8:38:26 ET
Table 'Polydoros II' 6-max Seat #1 is the button
Seat 1: Xath76 ($10 in chips) 
Seat 2: voronin885 ($10.09 in chips) 
Seat 3: Vaha379 ($12.67 in chips) 
Seat 4: Squashy22 ($23.75 in chips) 
Seat 5: einsftw ($10 in chips) 
Seat 6: alexos04 ($22.35 in chips) 
voronin885: posts small blind $0.05
Vaha379: posts big blind $0.10
*** HOLE CARDS ***
Squashy22: folds 
einsftw: raises $0.20 to $0.30
alexos04: raises $0.60 to $0.90
Xath76: folds 
voronin885: folds 
Vaha379: folds 
einsftw: folds 
Uncalled bet ($0.60) returned to alexos04
alexos04 collected $0.75 from pot
alexos04: doesn't show hand 
*** SUMMARY ***
Total pot $0.75 | Rake $0 
Seat 1: Xath76 (button) folded before Flop (didn't bet)
Seat 2: voronin885 (small blind) folded before Flop
Seat 3: Vaha379 (big blind) folded before Flop
Seat 4: Squashy22 folded before Flop (didn't bet)
Seat 5: einsftw folded before Flop
Seat 6: alexos04 collected ($0.75)



PokerStars Hand #222953749557:  Hold'em No Limit ($0.05/$0.10 USD) - 2021/01/23 8:38:43 ET
Table 'Polydoros II' 6-max Seat #2 is the button
Seat 1: Xath76 ($10 in chips) 
Seat 2: voronin885 ($10.04 in chips) 
Seat 3: Vaha379 ($12.57 in chips) 
Seat 4: Squashy22 ($23.75 in chips) 
Seat 5: einsftw ($10 in chips) 
Seat 6: alexos04 ($22.80 in chips) 
Vaha379: posts small blind $0.05
Squashy22: posts big blind $0.10
*** HOLE CARDS ***
einsftw: folds 
alexos04: folds 
Xath76: raises $0.20 to $0.30
voronin885: folds 
Vaha379: folds 
Squashy22: folds 
Uncalled bet ($0.20) returned to Xath76
Xath76 collected $0.25 from pot
Xath76: doesn't show hand 
*** SUMMARY ***
Total pot $0.25 | Rake $0 
Seat 1: Xath76 collected ($0.25)
Seat 2: voronin885 (button) folded before Flop (didn't bet)
Seat 3: Vaha379 (small blind) folded before Flop
Seat 4: Squashy22 (big blind) folded before Flop
Seat 5: einsftw folded before Flop (didn't bet)
Seat 6: alexos04 folded before Flop (didn't bet)



PokerStars Hand #222953753479:  Hold'em No Limit ($0.05/$0.10 USD) - 2021/01/23 8:38:52 ET
Table 'Polydoros II' 6-max Seat #3 is the button
Seat 1: Xath76 ($10.15 in chips) 
Seat 2: voronin885 ($10.04 in chips) 
Seat 3: Vaha379 ($12.52 in chips) 
Seat 4: Squashy22 ($23.65 in chips) 
Seat 5: einsftw ($10 in chips) 
Seat 6: alexos04 ($22.80 in chips) 
Squashy22: posts small blind $0.05
einsftw: posts big blind $0.10
*** HOLE CARDS ***
alexos04: folds 
Xath76: raises $0.20 to $0.30
voronin885: raises $0.20 to $0.50
Vaha379: folds 
Squashy22: folds 
einsftw: folds 
Xath76: calls $0.20
*** FLOP *** [5d 2d 8s]
Xath76: checks 
voronin885: bets $1.10
Xath76: folds 
Uncalled bet ($1.10) returned to voronin885
voronin885 collected $1.10 from pot
voronin885: doesn't show hand 
*** SUMMARY ***
Total pot $1.15 | Rake $0.05 
Board [5d 2d 8s]
Seat 1: Xath76 folded on the Flop
Seat 2: voronin885 collected ($1.10)
Seat 3: Vaha379 (button) folded before Flop (didn't bet)
Seat 4: Squashy22 (small blind) folded before Flop
Seat 5: einsftw (big blind) folded before Flop
Seat 6: alexos04 folded before Flop (didn't bet)



PokerStars Hand #222955336574:  Hold'em No Limit ($0.05/$0.10 USD) - 2021/01/23 9:34:31 ET
Table 'Polydoros II' 6-max Seat #1 is the button
Seat 1: Xath76 ($10.55 in chips) 
Seat 2: Lord_of_days ($10.60 in chips) 
Seat 3: fooledagain1 ($7.16 in chips) 
Seat 4: Squashy22 ($48.33 in chips) 
Seat 5: VanCleef322 ($13.77 in chips) 
Seat 6: alexos04 ($12.22 in chips) 
Lord_of_days: posts small blind $0.05
fooledagain1: posts big blind $0.10
*** HOLE CARDS ***
Squashy22: folds 
VanCleef322: folds 
alexos04: raises $0.20 to $0.30
Xath76: folds 
Lord_of_days: folds 
fooledagain1: raises $0.20 to $0.50
alexos04: calls $0.20
*** FLOP *** [4s 2h 6s]
fooledagain1: bets $2.50
alexos04: folds 
Uncalled bet ($2.50) returned to fooledagain1
fooledagain1 collected $1 from pot
fooledagain1: doesn't show hand 
*** SUMMARY ***
Total pot $1.05 | Rake $0.05 
Board [4s 2h 6s]
Seat 1: Xath76 (button) folded before Flop (didn't bet)
Seat 2: Lord_of_days (small blind) folded before Flop
Seat 3: fooledagain1 (big blind) collected ($1)
Seat 4: Squashy22 folded before Flop (didn't bet)
Seat 5: VanCleef322 folded before Flop (didn't bet)
Seat 6: alexos04 folded on the Flop



PokerStars Hand #222955349200:  Hold'em No Limit ($0.05/$0.10 USD) - 2021/01/23 9:34:56 ET
Table 'Polydoros II' 6-max Seat #2 is the button
Seat 1: Xath76 ($10.55 in chips) 
Seat 2: Lord_of_days ($10.55 in chips) 
Seat 3: fooledagain1 ($7.66 in chips) 
Seat 4: Squashy22 ($48.33 in chips) 
Seat 5: VanCleef322 ($13.77 in chips) 
Seat 6: alexos04 ($11.72 in chips) 
fooledagain1: posts small blind $0.05
Squashy22: posts big blind $0.10
*** HOLE CARDS ***
VanCleef322: folds 
alexos04: raises $0.20 to $0.30
Xath76: folds 
Lord_of_days: folds 
fooledagain1: folds 
Squashy22: folds 
Uncalled bet ($0.20) returned to alexos04
fooledagain1 leaves the table
alexos04 collected $0.25 from pot
alexos04: doesn't show hand 
*** SUMMARY ***
Total pot $0.25 | Rake $0 
Seat 1: Xath76 folded before Flop (didn't bet)
Seat 2: Lord_of_days (button) folded before Flop (didn't bet)
Seat 3: fooledagain1 (small blind) folded before Flop
Seat 4: Squashy22 (big blind) folded before Flop
Seat 5: VanCleef322 folded before Flop (didn't bet)
Seat 6: alexos04 collected ($0.25)



PokerStars Hand #222955356530:  Hold'em No Limit ($0.05/$0.10 USD) - 2021/01/23 9:35:10 ET
Table 'Polydoros II' 6-max Seat #4 is the button
Seat 1: Xath76 ($10.55 in chips) 
Seat 2: Lord_of_days ($10.55 in chips) 
Seat 4: Squashy22 ($48.23 in chips) 
Seat 5: VanCleef322 ($13.77 in chips) 
Seat 6: alexos04 ($11.87 in chips) 
VanCleef322: posts small blind $0.05
alexos04: posts big blind $0.10
*** HOLE CARDS ***
Xath76: folds 
alVatroos joins the table at seat #3 
Lord_of_days: raises $0.20 to $0.30
Squashy22: calls $0.30
VanCleef322: folds 
alexos04: calls $0.20
*** FLOP *** [8h Th Kd]
alexos04: checks 
Lord_of_days: bets $0.30
Squashy22: folds 
alexos04: calls $0.30
*** TURN *** [8h Th Kd] [5d]
alexos04: checks 
Lord_of_days: bets $1.21
alexos04: folds 
Uncalled bet ($1.21) returned to Lord_of_days
Lord_of_days collected $1.48 from pot
Lord_of_days: doesn't show hand 
*** SUMMARY ***
Total pot $1.55 | Rake $0.07 
Board [8h Th Kd 5d]
Seat 1: Xath76 folded before Flop (didn't bet)
Seat 2: Lord_of_days collected ($1.48)
Seat 4: Squashy22 (button) folded on the Flop
Seat 5: VanCleef322 (small blind) folded before Flop
Seat 6: alexos04 (big blind) folded on the Turn



PokerStars Hand #222955383041:  Hold'em No Limit ($0.05/$0.10 USD) - 2021/01/23 9:36:03 ET
Table 'Polydoros II' 6-max Seat #5 is the button
Seat 1: Xath76 ($10.55 in chips) 
Seat 2: Lord_of_days ($11.43 in chips) 
Seat 4: Squashy22 ($47.93 in chips) 
Seat 5: VanCleef322 ($13.72 in chips) 
Seat 6: alexos04 ($11.27 in chips) 
alexos04: posts small blind $0.05
Xath76: posts big blind $0.10
alVatroos: sits out 
*** HOLE CARDS ***
Lord_of_days: folds 
Squashy22: raises $0.16 to $0.26
alVatroos leaves the table
VanCleef322: folds 
AzulAzul999 joins the table at seat #3 
alexos04: folds 
Xath76: folds 
Uncalled bet ($0.16) returned to Squashy22
Squashy22 collected $0.25 from pot
Squashy22: doesn't show hand 
*** SUMMARY ***
Total pot $0.25 | Rake $0 
Seat 1: Xath76 (big blind) folded before Flop
Seat 2: Lord_of_days folded before Flop (didn't bet)
Seat 4: Squashy22 collected ($0.25)
Seat 5: VanCleef322 (button) folded before Flop (didn't bet)
Seat 6: alexos04 (small blind) folded before Flop



PokerStars Hand #222955392409:  Hold'em No Limit ($0.05/$0.10 USD) - 2021/01/23 9:36:22 ET
Table 'Polydoros II' 6-max Seat #6 is the button
Seat 1: Xath76 ($10.45 in chips) 
Seat 2: Lord_of_days ($11.43 in chips) 
Seat 4: Squashy22 ($48.08 in chips) 
Seat 5: VanCleef322 ($13.72 in chips) 
Seat 6: alexos04 ($11.22 in chips) 
Xath76: posts small blind $0.05
Lord_of_days: posts big blind $0.10
AzulAzul999: sits out 
*** HOLE CARDS ***
Squashy22: folds 
VanCleef322: folds 
alexos04: folds 
Xath76: folds 
Uncalled bet ($0.05) returned to Lord_of_days
Lord_of_days collected $0.10 from pot
Lord_of_days: doesn't show hand 
*** SUMMARY ***
Total pot $0.10 | Rake $0 
Seat 1: Xath76 (small blind) folded before Flop
Seat 2: Lord_of_days (big blind) collected ($0.10)
Seat 4: Squashy22 folded before Flop (didn't bet)
Seat 5: VanCleef322 folded before Flop (didn't bet)
Seat 6: alexos04 (button) folded before Flop (didn't bet)



PokerStars Hand #222955399728:  Hold'em No Limit ($0.05/$0.10 USD) - 2021/01/23 9:36:36 ET
Table 'Polydoros II' 6-max Seat #1 is the button
Seat 1: Xath76 ($10.40 in chips) 
Seat 2: Lord_of_days ($11.48 in chips) 
Seat 3: AzulAzul999 ($10 in chips) 
Seat 4: Squashy22 ($48.08 in chips) 
Seat 5: VanCleef322 ($13.72 in chips) 
Seat 6: alexos04 ($11.22 in chips) 
Lord_of_days: posts small blind $0.05
AzulAzul999: posts big blind $0.10
*** HOLE CARDS ***
Squashy22: folds 
VanCleef322: raises $0.15 to $0.25
alexos04: folds 
Xath76: folds 
Lord_of_days: calls $0.20
AzulAzul999: folds 
*** FLOP *** [8s 4s 6s]
Lord_of_days: checks 
VanCleef322: checks 
*** TURN *** [8s 4s 6s] [3h]
Lord_of_days: bets $0.20
VanCleef322: calls $0.20
*** RIVER *** [8s 4s 6s 3h] [7c]
Lord_of_days: checks 
VanCleef322: checks 
*** SHOW DOWN ***
Lord_of_days: shows [Ad 8d] (a pair of Eights)
VanCleef322: mucks hand 
Lord_of_days collected $0.96 from pot
*** SUMMARY ***
Total pot $1 | Rake $0.04 
Board [8s 4s 6s 3h 7c]
Seat 1: Xath76 (button) folded before Flop (didn't bet)
Seat 2: Lord_of_days (small blind) showed [Ad 8d] and won ($0.96) with a pair of Eights
Seat 3: AzulAzul999 (big blind) folded before Flop
Seat 4: Squashy22 folded before Flop (didn't bet)
Seat 5: VanCleef322 mucked
Seat 6: alexos04 folded before Flop (didn't bet)



PokerStars Hand #222955418337:  Hold'em No Limit ($0.05/$0.10 USD) - 2021/01/23 9:37:14 ET
Table 'Polydoros II' 6-max Seat #2 is the button
Seat 1: Xath76 ($10.40 in chips) 
Seat 2: Lord_of_days ($11.99 in chips) 
Seat 3: AzulAzul999 ($10 in chips) 
Seat 4: Squashy22 ($48.08 in chips) 
Seat 5: VanCleef322 ($13.27 in chips) 
Seat 6: alexos04 ($11.22 in chips) 
AzulAzul999: posts small blind $0.05
Squashy22: posts big blind $0.10
*** HOLE CARDS ***
VanCleef322: folds 
alexos04: folds 
Xath76: folds 
Lord_of_days: raises $0.20 to $0.30
AzulAzul999: folds 
Squashy22: calls $0.20
*** FLOP *** [2s 8s Td]
Squashy22: checks 
Lord_of_days: bets $0.20
Squashy22: folds 
Uncalled bet ($0.20) returned to Lord_of_days
Lord_of_days collected $0.62 from pot
Lord_of_days: doesn't show hand 
*** SUMMARY ***
Total pot $0.65 | Rake $0.03 
Board [2s 8s Td]
Seat 1: Xath76 folded before Flop (didn't bet)
Seat 2: Lord_of_days (button) collected ($0.62)
Seat 3: AzulAzul999 (small blind) folded before Flop
Seat 4: Squashy22 (big blind) folded on the Flop
Seat 5: VanCleef322 folded before Flop (didn't bet)
Seat 6: alexos04 folded before Flop (didn't bet)



PokerStars Hand #222955430088:  Hold'em No Limit ($0.05/$0.10 USD) - 2021/01/23 9:37:37 ET
Table 'Polydoros II' 6-max Seat #3 is the button
Seat 1: Xath76 ($10.40 in chips) 
Seat 2: Lord_of_days ($12.31 in chips) 
Seat 3: AzulAzul999 ($10 in chips) 
Seat 4: Squashy22 ($47.78 in chips) 
Seat 5: VanCleef322 ($13.27 in chips) 
Seat 6: alexos04 ($11.22 in chips) 
Squashy22: posts small blind $0.05
VanCleef322: posts big blind $0.10
*** HOLE CARDS ***
alexos04: folds 
Xath76: raises $0.20 to $0.30
Lord_of_days: folds 
AzulAzul999: calls $0.30
Squashy22: folds 
VanCleef322: folds 
*** FLOP *** [4s 2c 8s]
Xath76: bets $0.36
AzulAzul999: calls $0.36
*** TURN *** [4s 2c 8s] [Qc]
Xath76: bets $0.70
AzulAzul999: folds 
Uncalled bet ($0.70) returned to Xath76
Xath76 collected $1.40 from pot
Xath76: doesn't show hand 
*** SUMMARY ***
Total pot $1.47 | Rake $0.07 
Board [4s 2c 8s Qc]
Seat 1: Xath76 collected ($1.40)
Seat 2: Lord_of_days folded before Flop (didn't bet)
Seat 3: AzulAzul999 (button) folded on the Turn
Seat 4: Squashy22 (small blind) folded before Flop
Seat 5: VanCleef322 (big blind) folded before Flop
Seat 6: alexos04 folded before Flop (didn't bet)



PokerStars Hand #222955447659:  Hold'em No Limit ($0.05/$0.10 USD) - 2021/01/23 9:38:12 ET
Table 'Polydoros II' 6-max Seat #4 is the button
Seat 1: Xath76 ($11.14 in chips) 
Seat 2: Lord_of_days ($12.31 in chips) 
Seat 3: AzulAzul999 ($10 in chips) 
Seat 4: Squashy22 ($47.73 in chips) 
Seat 5: VanCleef322 ($13.17 in chips) 
Seat 6: alexos04 ($11.22 in chips) 
VanCleef322: posts small blind $0.05
alexos04: posts big blind $0.10
*** HOLE CARDS ***
Xath76: folds 
Lord_of_days: raises $0.20 to $0.30
AzulAzul999: raises $0.50 to $0.80
Squashy22: folds 
VanCleef322: folds 
alexos04: folds 
Lord_of_days: folds 
Uncalled bet ($0.50) returned to AzulAzul999
AzulAzul999 collected $0.75 from pot
AzulAzul999: doesn't show hand 
*** SUMMARY ***
Total pot $0.75 | Rake $0 
Seat 1: Xath76 folded before Flop (didn't bet)
Seat 2: Lord_of_days folded before Flop
Seat 3: AzulAzul999 collected ($0.75)
Seat 4: Squashy22 (button) folded before Flop (didn't bet)
Seat 5: VanCleef322 (small blind) folded before Flop
Seat 6: alexos04 (big blind) folded before Flop



PokerStars Hand #222955456244:  Hold'em No Limit ($0.05/$0.10 USD) - 2021/01/23 9:38:29 ET
Table 'Polydoros II' 6-max Seat #5 is the button
Seat 1: Xath76 ($11.14 in chips) 
Seat 2: Lord_of_days ($12.01 in chips) 
Seat 3: AzulAzul999 ($10.45 in chips) 
Seat 4: Squashy22 ($47.73 in chips) 
Seat 5: VanCleef322 ($13.12 in chips) 
Seat 6: alexos04 ($11.12 in chips) 
alexos04: posts small blind $0.05
Xath76: posts big blind $0.10
*** HOLE CARDS ***
Lord_of_days: raises $0.20 to $0.30
AzulAzul999: folds 
Squashy22: folds 
VanCleef322: folds 
alexos04: calls $0.25
Xath76: folds 
*** FLOP *** [7d 2s 4d]
alexos04: checks 
Lord_of_days: bets $0.22
alexos04: raises $0.68 to $0.90
Lord_of_days: folds 
Uncalled bet ($0.68) returned to alexos04
alexos04 collected $1.09 from pot
alexos04: doesn't show hand 
*** SUMMARY ***
Total pot $1.14 | Rake $0.05 
Board [7d 2s 4d]
Seat 1: Xath76 (big blind) folded before Flop
Seat 2: Lord_of_days folded on the Flop
Seat 3: AzulAzul999 folded before Flop (didn't bet)
Seat 4: Squashy22 folded before Flop (didn't bet)
Seat 5: VanCleef322 (button) folded before Flop (didn't bet)
Seat 6: alexos04 (small blind) collected ($1.09)



PokerStars Hand #222955475703:  Hold'em No Limit ($0.05/$0.10 USD) - 2021/01/23 9:39:08 ET
Table 'Polydoros II' 6-max Seat #6 is the button
Seat 1: Xath76 ($11.04 in chips) 
Seat 2: Lord_of_days ($11.49 in chips) 
Seat 3: AzulAzul999 ($10.45 in chips) 
Seat 4: Squashy22 ($47.73 in chips) 
Seat 5: VanCleef322 ($13.12 in chips) 
Seat 6: alexos04 ($11.69 in chips) 
Xath76: posts small blind $0.05
Lord_of_days: posts big blind $0.10
*** HOLE CARDS ***
AzulAzul999: folds 
AzulAzul999 leaves the table
Squashy22: folds 
VanCleef322: folds 
alexos04: folds 
Xath76: folds 
Uncalled bet ($0.05) returned to Lord_of_days
Lord_of_days collected $0.10 from pot
Lord_of_days: doesn't show hand 
*** SUMMARY ***
Total pot $0.10 | Rake $0 
Seat 1: Xath76 (small blind) folded before Flop
Seat 2: Lord_of_days (big blind) collected ($0.10)
Seat 3: AzulAzul999 folded before Flop (didn't bet)
Seat 4: Squashy22 folded before Flop (didn't bet)
Seat 5: VanCleef322 folded before Flop (didn't bet)
Seat 6: alexos04 (button) folded before Flop (didn't bet)



PokerStars Hand #222955480846:  Hold'em No Limit ($0.05/$0.10 USD) - 2021/01/23 9:39:18 ET
Table 'Polydoros II' 6-max Seat #1 is the button
Seat 1: Xath76 ($10.99 in chips) 
Seat 2: Lord_of_days ($11.54 in chips) 
Seat 4: Squashy22 ($47.73 in chips) 
Seat 5: VanCleef322 ($13.12 in chips) 
Seat 6: alexos04 ($11.69 in chips) 
Lord_of_days: posts small blind $0.05
Squashy22: posts big blind $0.10
*** HOLE CARDS ***
VanCleef322: folds 
alexos04: folds 
firstandsole joins the table at seat #3 
Xath76: folds 
Lord_of_days: folds 
Uncalled bet ($0.05) returned to Squashy22
Squashy22 collected $0.10 from pot
Squashy22: doesn't show hand 
*** SUMMARY ***
Total pot $0.10 | Rake $0 
Seat 1: Xath76 (button) folded before Flop (didn't bet)
Seat 2: Lord_of_days (small blind) folded before Flop
Seat 4: Squashy22 (big blind) collected ($0.10)
Seat 5: VanCleef322 folded before Flop (didn't bet)
Seat 6: alexos04 folded before Flop (didn't bet)



PokerStars Hand #222955484484:  Hold'em No Limit ($0.05/$0.10 USD) - 2021/01/23 9:39:25 ET
Table 'Polydoros II' 6-max Seat #2 is the button
Seat 1: Xath76 ($10.99 in chips) 
Seat 2: Lord_of_days ($11.49 in chips) 
Seat 4: Squashy22 ($47.78 in chips) 
Seat 5: VanCleef322 ($13.12 in chips) 
Seat 6: alexos04 ($11.69 in chips) 
Squashy22: posts small blind $0.05
VanCleef322: posts big blind $0.10
*** HOLE CARDS ***
alexos04: folds 
Xath76: folds 
Lord_of_days: folds 
Squashy22: folds 
Uncalled bet ($0.05) returned to VanCleef322
VanCleef322 collected $0.10 from pot
VanCleef322: doesn't show hand 
*** SUMMARY ***
Total pot $0.10 | Rake $0 
Seat 1: Xath76 folded before Flop (didn't bet)
Seat 2: Lord_of_days (button) folded before Flop (didn't bet)
Seat 4: Squashy22 (small blind) folded before Flop
Seat 5: VanCleef322 (big blind) collected ($0.10)
Seat 6: alexos04 folded before Flop (didn't bet)



PokerStars Hand #222955488043:  Hold'em No Limit ($0.05/$0.10 USD) - 2021/01/23 9:39:32 ET
Table 'Polydoros II' 6-max Seat #4 is the button
Seat 1: Xath76 ($10.99 in chips) 
Seat 2: Lord_of_days ($11.49 in chips) 
Seat 4: Squashy22 ($47.73 in chips) 
Seat 5: VanCleef322 ($13.17 in chips) 
Seat 6: alexos04 ($11.69 in chips) 
VanCleef322: posts small blind $0.05
alexos04: posts big blind $0.10
*** HOLE CARDS ***
Xath76: folds 
Lord_of_days: folds 
Squashy22: folds 
VanCleef322: folds 
Uncalled bet ($0.05) returned to alexos04
alexos04 collected $0.10 from pot
alexos04: doesn't show hand 
*** SUMMARY ***
Total pot $0.10 | Rake $0 
Seat 1: Xath76 folded before Flop (didn't bet)
Seat 2: Lord_of_days folded before Flop (didn't bet)
Seat 4: Squashy22 (button) folded before Flop (didn't bet)
Seat 5: VanCleef322 (small blind) folded before Flop
Seat 6: alexos04 (big blind) collected ($0.10)



PokerStars Hand #222955491479:  Hold'em No Limit ($0.05/$0.10 USD) - 2021/01/23 9:39:39 ET
Table 'Polydoros II' 6-max Seat #5 is the button
Seat 1: Xath76 ($10.99 in chips) 
Seat 2: Lord_of_days ($11.49 in chips) 
Seat 4: Squashy22 ($47.73 in chips) 
Seat 5: VanCleef322 ($13.12 in chips) 
Seat 6: alexos04 ($11.74 in chips) 
alexos04: posts small blind $0.05
Xath76: posts big blind $0.10
*** HOLE CARDS ***
Lord_of_days: folds 
Squashy22: raises $0.16 to $0.26
VanCleef322: folds 
alexos04: calls $0.21
Xath76: folds 
*** FLOP *** [6h Ks Kh]
alexos04: checks 
Squashy22: bets $0.25
alexos04: folds 
Uncalled bet ($0.25) returned to Squashy22
Squashy22 collected $0.59 from pot
Squashy22: doesn't show hand 
*** SUMMARY ***
Total pot $0.62 | Rake $0.03 
Board [6h Ks Kh]
Seat 1: Xath76 (big blind) folded before Flop
Seat 2: Lord_of_days folded before Flop (didn't bet)
Seat 4: Squashy22 collected ($0.59)
Seat 5: VanCleef322 (button) folded before Flop (didn't bet)
Seat 6: alexos04 (small blind) folded on the Flop



PokerStars Hand #222955505172:  Hold'em No Limit ($0.05/$0.10 USD) - 2021/01/23 9:40:06 ET
Table 'Polydoros II' 6-max Seat #6 is the button
Seat 2: Lord_of_days ($11.49 in chips) 
Seat 4: Squashy22 ($48.06 in chips) 
Seat 5: VanCleef322 ($13.12 in chips) 
Seat 6: alexos04 ($11.48 in chips) 
Lord_of_days: posts small blind $0.05
Squashy22: posts big blind $0.10
*** HOLE CARDS ***
VanCleef322: folds 
alexos04: raises $0.20 to $0.30
Xath76 leaves the table
Lord_of_days: folds 
Squashy22: folds 
Uncalled bet ($0.20) returned to alexos04
todd bonzales joins the table at seat #1 
alexos04 collected $0.25 from pot
alexos04: doesn't show hand 
*** SUMMARY ***
Total pot $0.25 | Rake $0 
Seat 2: Lord_of_days (small blind) folded before Flop
Seat 4: Squashy22 (big blind) folded before Flop
Seat 5: VanCleef322 folded before Flop (didn't bet)
Seat 6: alexos04 (button) collected ($0.25)



PokerStars Hand #222955512757:  Hold'em No Limit ($0.05/$0.10 USD) - 2021/01/23 9:40:21 ET
Table 'Polydoros II' 6-max Seat #2 is the button
Seat 2: Lord_of_days ($11.44 in chips) 
Seat 4: Squashy22 ($47.96 in chips) 
Seat 5: VanCleef322 ($13.12 in chips) 
Seat 6: alexos04 ($11.63 in chips) 
Squashy22: posts small blind $0.05
VanCleef322: posts big blind $0.10
todd bonzales: sits out 
*** HOLE CARDS ***
alexos04: folds 
Lord_of_days: folds 
Squashy22: folds 
Uncalled bet ($0.05) returned to VanCleef322
VanCleef322 collected $0.10 from pot
VanCleef322: doesn't show hand 
*** SUMMARY ***
Total pot $0.10 | Rake $0 
Seat 2: Lord_of_days (button) folded before Flop (didn't bet)
Seat 4: Squashy22 (small blind) folded before Flop
Seat 5: VanCleef322 (big blind) collected ($0.10)
Seat 6: alexos04 folded before Flop (didn't bet)



PokerStars Hand #222955515481:  Hold'em No Limit ($0.05/$0.10 USD) - 2021/01/23 9:40:27 ET
Table 'Polydoros II' 6-max Seat #4 is the button
Seat 1: todd bonzales ($8 in chips) 
Seat 2: Lord_of_days ($11.44 in chips) 
Seat 4: Squashy22 ($47.91 in chips) 
Seat 5: VanCleef322 ($13.17 in chips) 
Seat 6: alexos04 ($11.63 in chips) 
VanCleef322: posts small blind $0.05
alexos04: posts big blind $0.10
todd bonzales: posts big blind $0.10
*** HOLE CARDS ***
todd bonzales: checks 
Lord_of_days: folds 
Squashy22: folds 
VanCleef322: folds 
alexos04: checks 
*** FLOP *** [Ac 6c Ks]
alexos04: checks 
todd bonzales: checks 
*** TURN *** [Ac 6c Ks] [9d]
alexos04: checks 
todd bonzales: bets $0.24
alexos04: folds 
Uncalled bet ($0.24) returned to todd bonzales
todd bonzales collected $0.24 from pot
todd bonzales: doesn't show hand 
*** SUMMARY ***
Total pot $0.25 | Rake $0.01 
Board [Ac 6c Ks 9d]
Seat 1: todd bonzales collected ($0.24)
Seat 2: Lord_of_days folded before Flop (didn't bet)
Seat 4: Squashy22 (button) folded before Flop (didn't bet)
Seat 5: VanCleef322 (small blind) folded before Flop
Seat 6: alexos04 (big blind) folded on the Turn



PokerStars Hand #222955531721:  Hold'em No Limit ($0.05/$0.10 USD) - 2021/01/23 9:40:59 ET
Table 'Polydoros II' 6-max Seat #5 is the button
Seat 1: todd bonzales ($10 in chips) 
Seat 2: Lord_of_days ($11.44 in chips) 
Seat 4: Squashy22 ($47.91 in chips) 
Seat 5: VanCleef322 ($13.12 in chips) 
Seat 6: alexos04 ($11.53 in chips) 
alexos04: posts small blind $0.05
todd bonzales: posts big blind $0.10
*** HOLE CARDS ***
Lord_of_days: folds 
Squashy22: folds 
VanCleef322: folds 
alexos04: folds 
Uncalled bet ($0.05) returned to todd bonzales
todd bonzales collected $0.10 from pot
todd bonzales: doesn't show hand 
*** SUMMARY ***
Total pot $0.10 | Rake $0 
Seat 1: todd bonzales (big blind) collected ($0.10)
Seat 2: Lord_of_days folded before Flop (didn't bet)
Seat 4: Squashy22 folded before Flop (didn't bet)
Seat 5: VanCleef322 (button) folded before Flop (didn't bet)
Seat 6: alexos04 (small blind) folded before Flop



PokerStars Hand #222955534919:  Hold'em No Limit ($0.05/$0.10 USD) - 2021/01/23 9:41:05 ET
Table 'Polydoros II' 6-max Seat #6 is the button
Seat 1: todd bonzales ($10.05 in chips) 
Seat 2: Lord_of_days ($11.44 in chips) 
Seat 4: Squashy22 ($47.91 in chips) 
Seat 5: VanCleef322 ($13.12 in chips) 
Seat 6: alexos04 ($11.48 in chips) 
todd bonzales: posts small blind $0.05
Lord_of_days: posts big blind $0.10
*** HOLE CARDS ***
Squashy22: folds 
VanCleef322: folds 
alexos04: raises $0.20 to $0.30
todd bonzales: raises $0.20 to $0.50
Lord_of_days: folds 
alexos04: calls $0.20
*** FLOP *** [8c 9h Ts]
todd bonzales: bets $0.53
alexos04: calls $0.53
*** TURN *** [8c 9h Ts] [Td]
todd bonzales: checks 
alexos04: checks 
*** RIVER *** [8c 9h Ts Td] [5h]
todd bonzales: bets $1.40
alexos04: folds 
Uncalled bet ($1.40) returned to todd bonzales
todd bonzales collected $2.06 from pot
todd bonzales: doesn't show hand 
*** SUMMARY ***
Total pot $2.16 | Rake $0.10 
Board [8c 9h Ts Td 5h]
Seat 1: todd bonzales (small blind) collected ($2.06)
Seat 2: Lord_of_days (big blind) folded before Flop
Seat 4: Squashy22 folded before Flop (didn't bet)
Seat 5: VanCleef322 folded before Flop (didn't bet)
Seat 6: alexos04 (button) folded on the River



PokerStars Hand #222955568504:  Hold'em No Limit ($0.05/$0.10 USD) - 2021/01/23 9:42:12 ET
Table 'Polydoros II' 6-max Seat #1 is the button
Seat 1: todd bonzales ($11.08 in chips) 
Seat 2: Lord_of_days ($11.34 in chips) 
Seat 6: alexos04 ($10.45 in chips) 
Lord_of_days: posts small blind $0.05
Squashy22: is sitting out 
VanCleef322: is sitting out 
alexos04: posts big blind $0.10
*** HOLE CARDS ***
VanCleef322 leaves the table
todd bonzales: raises $0.10 to $0.20
firstandsole leaves the table
Squashy22 leaves the table
Lord_of_days: raises $0.50 to $0.70
alexos04: folds 
todd bonzales: calls $0.50
*** FLOP *** [7s 6h Ts]
Lord_of_days: bets $0.47
todd bonzales: calls $0.47
*** TURN *** [7s 6h Ts] [2h]
Lord_of_days: checks 
todd bonzales: checks 
*** RIVER *** [7s 6h Ts 2h] [2d]
Lord_of_days: checks 
todd bonzales: bets $2.33
Lord_of_days: calls $2.33
*** SHOW DOWN ***
todd bonzales: shows [Js 9s] (a pair of Deuces)
Lord_of_days: shows [Kd Ad] (a pair of Deuces - Ace kicker)
Lord_of_days collected $6.78 from pot
*** SUMMARY ***
Total pot $7.10 | Rake $0.32 
Board [7s 6h Ts 2h 2d]
Seat 1: todd bonzales (button) showed [Js 9s] and lost with a pair of Deuces
Seat 2: Lord_of_days (small blind) showed [Kd Ad] and won ($6.78) with a pair of Deuces
Seat 6: alexos04 (big blind) folded before Flop



PokerStars Hand #222955594965:  Hold'em No Limit ($0.05/$0.10 USD) - 2021/01/23 9:43:05 ET
Table 'Polydoros II' 6-max Seat #2 is the button
Seat 1: todd bonzales ($7.58 in chips) 
Seat 2: Lord_of_days ($14.62 in chips) 
Seat 6: alexos04 ($10.35 in chips) 
alexos04: posts small blind $0.05
todd bonzales: posts big blind $0.10
*** HOLE CARDS ***
Lord_of_days: raises $0.20 to $0.30
alexos04: folds 
todd bonzales: calls $0.20
*** FLOP *** [9d 2s 8s]
todd bonzales: checks 
Lord_of_days: bets $0.20
todd bonzales: folds 
Uncalled bet ($0.20) returned to Lord_of_days
Lord_of_days collected $0.62 from pot
Lord_of_days: doesn't show hand 
*** SUMMARY ***
Total pot $0.65 | Rake $0.03 
Board [9d 2s 8s]
Seat 1: todd bonzales (big blind) folded on the Flop
Seat 2: Lord_of_days (button) collected ($0.62)
Seat 6: alexos04 (small blind) folded before Flop



PokerStars Hand #222955603786:  Hold'em No Limit ($0.05/$0.10 USD) - 2021/01/23 9:43:22 ET
Table 'Polydoros II' 6-max Seat #6 is the button
Seat 1: todd bonzales ($7.28 in chips) 
Seat 2: Lord_of_days ($14.94 in chips) 
Seat 6: alexos04 ($10.30 in chips) 
todd bonzales: posts small blind $0.05
Lord_of_days: posts big blind $0.10
*** HOLE CARDS ***
alexos04: folds 
todd bonzales: folds 
Uncalled bet ($0.05) returned to Lord_of_days
Lord_of_days collected $0.10 from pot
Lord_of_days: doesn't show hand 
*** SUMMARY ***
Total pot $0.10 | Rake $0 
Seat 1: todd bonzales (small blind) folded before Flop
Seat 2: Lord_of_days (big blind) collected ($0.10)
Seat 6: alexos04 (button) folded before Flop (didn't bet)



PokerStars Hand #222955610145:  Hold'em No Limit ($0.05/$0.10 USD) - 2021/01/23 9:43:35 ET
Table 'Polydoros II' 6-max Seat #1 is the button
Seat 1: todd bonzales ($10 in chips) 
Seat 2: Lord_of_days ($14.99 in chips) 
Seat 6: alexos04 ($10.30 in chips) 
Lord_of_days: posts small blind $0.05
alexos04: posts big blind $0.10
*** HOLE CARDS ***
todd bonzales: calls $0.10
Lord_of_days: folds 
alexos04: raises $0.30 to $0.40
todd bonzales: folds 
Uncalled bet ($0.30) returned to alexos04
alexos04 collected $0.25 from pot
alexos04: doesn't show hand 
*** SUMMARY ***
Total pot $0.25 | Rake $0 
Seat 1: todd bonzales (button) folded before Flop
Seat 2: Lord_of_days (small blind) folded before Flop
Seat 6: alexos04 (big blind) collected ($0.25)



PokerStars Hand #222955619887:  Hold'em No Limit ($0.05/$0.10 USD) - 2021/01/23 9:43:54 ET
Table 'Polydoros II' 6-max Seat #2 is the button
Seat 1: todd bonzales ($9.90 in chips) 
Seat 2: Lord_of_days ($14.94 in chips) 
Seat 6: alexos04 ($10.45 in chips) 
alexos04: posts small blind $0.05
todd bonzales: posts big blind $0.10
*** HOLE CARDS ***
hornetsvp joins the table at seat #3 
Lord_of_days: raises $0.20 to $0.30
alexos04: folds 
todd bonzales: folds 
Uncalled bet ($0.20) returned to Lord_of_days
Lord_of_days collected $0.25 from pot
Lord_of_days: doesn't show hand 
*** SUMMARY ***
Total pot $0.25 | Rake $0 
Seat 1: todd bonzales (big blind) folded before Flop
Seat 2: Lord_of_days (button) collected ($0.25)
Seat 6: alexos04 (small blind) folded before Flop



PokerStars Hand #222956548293:  Hold'em No Limit ($0.05/$0.10 USD) - 2021/01/23 10:14:45 ET
Table 'Polydoros II' 6-max Seat #4 is the button
Seat 1: todd bonzales ($8.37 in chips) 
Seat 2: Lord_of_days ($13.57 in chips) 
Seat 3: zaharoff74 ($10.03 in chips) 
Seat 4: balisstica ($10.17 in chips) 
Seat 5: legendasheff ($10 in chips) 
Seat 6: alexos04 ($19.64 in chips) 
legendasheff: posts small blind $0.05
alexos04: posts big blind $0.10
*** HOLE CARDS ***
todd bonzales: calls $0.10
Lord_of_days: folds 
zaharoff74: folds 
balisstica: folds 
legendasheff: raises $0.25 to $0.35
alexos04: folds 
todd bonzales: calls $0.25
*** FLOP *** [6h 6d Qh]
legendasheff: bets $0.25
todd bonzales: calls $0.25
*** TURN *** [6h 6d Qh] [8d]
legendasheff: bets $0.41
todd bonzales: folds 
Uncalled bet ($0.41) returned to legendasheff
legendasheff collected $1.24 from pot
legendasheff: doesn't show hand 
*** SUMMARY ***
Total pot $1.30 | Rake $0.06 
Board [6h 6d Qh 8d]
Seat 1: todd bonzales folded on the Turn
Seat 2: Lord_of_days folded before Flop (didn't bet)
Seat 3: zaharoff74 folded before Flop (didn't bet)
Seat 4: balisstica (button) folded before Flop (didn't bet)
Seat 5: legendasheff (small blind) collected ($1.24)
Seat 6: alexos04 (big blind) folded before Flop



PokerStars Hand #222956569183:  Hold'em No Limit ($0.05/$0.10 USD) - 2021/01/23 10:15:24 ET
Table 'Polydoros II' 6-max Seat #5 is the button
Seat 1: todd bonzales ($7.77 in chips) 
Seat 2: Lord_of_days ($13.57 in chips) 
Seat 3: zaharoff74 ($10.03 in chips) 
Seat 4: balisstica ($10.17 in chips) 
Seat 5: legendasheff ($10.64 in chips) 
Seat 6: alexos04 ($19.54 in chips) 
alexos04: posts small blind $0.05
todd bonzales: posts big blind $0.10
*** HOLE CARDS ***
Lord_of_days: folds 
zaharoff74: folds 
balisstica: folds 
legendasheff: raises $0.15 to $0.25
alexos04: calls $0.20
todd bonzales: raises $7.52 to $7.77 and is all-in
legendasheff: folds 
alexos04: folds 
Uncalled bet ($7.52) returned to todd bonzales
todd bonzales collected $0.75 from pot
todd bonzales: doesn't show hand 
*** SUMMARY ***
Total pot $0.75 | Rake $0 
Seat 1: todd bonzales (big blind) collected ($0.75)
Seat 2: Lord_of_days folded before Flop (didn't bet)
Seat 3: zaharoff74 folded before Flop (didn't bet)
Seat 4: balisstica folded before Flop (didn't bet)
Seat 5: legendasheff (button) folded before Flop
Seat 6: alexos04 (small blind) folded before Flop



PokerStars Hand #222956588551:  Hold'em No Limit ($0.05/$0.10 USD) - 2021/01/23 10:16:00 ET
Table 'Polydoros II' 6-max Seat #6 is the button
Seat 1: todd bonzales ($8.27 in chips) 
Seat 2: Lord_of_days ($13.57 in chips) 
Seat 3: zaharoff74 ($10.03 in chips) 
Seat 4: balisstica ($10.17 in chips) 
Seat 5: legendasheff ($10.39 in chips) 
Seat 6: alexos04 ($19.29 in chips) 
todd bonzales: posts small blind $0.05
Lord_of_days: posts big blind $0.10
*** HOLE CARDS ***
zaharoff74: folds 
balisstica: folds 
legendasheff: folds 
alexos04: folds 
todd bonzales: folds 
Uncalled bet ($0.05) returned to Lord_of_days
Lord_of_days collected $0.10 from pot
Lord_of_days: doesn't show hand 
*** SUMMARY ***
Total pot $0.10 | Rake $0 
Seat 1: todd bonzales (small blind) folded before Flop
Seat 2: Lord_of_days (big blind) collected ($0.10)
Seat 3: zaharoff74 folded before Flop (didn't bet)
Seat 4: balisstica folded before Flop (didn't bet)
Seat 5: legendasheff folded before Flop (didn't bet)
Seat 6: alexos04 (button) folded before Flop (didn't bet)



PokerStars Hand #222956593370:  Hold'em No Limit ($0.05/$0.10 USD) - 2021/01/23 10:16:09 ET
Table 'Polydoros II' 6-max Seat #1 is the button
Seat 1: todd bonzales ($8.22 in chips) 
Seat 2: Lord_of_days ($13.62 in chips) 
Seat 3: zaharoff74 ($10.03 in chips) 
Seat 4: balisstica ($10.17 in chips) 
Seat 5: legendasheff ($10.39 in chips) 
Seat 6: alexos04 ($19.29 in chips) 
Lord_of_days: posts small blind $0.05
zaharoff74: posts big blind $0.10
*** HOLE CARDS ***
balisstica: raises $0.20 to $0.30
legendasheff: folds 
alexos04: folds 
todd bonzales: calls $0.30
Lord_of_days: folds 
zaharoff74: calls $0.20
*** FLOP *** [2h 3s Ts]
zaharoff74: checks 
balisstica: bets $0.30
todd bonzales: folds 
zaharoff74: calls $0.30
*** TURN *** [2h 3s Ts] [8s]
zaharoff74: checks 
balisstica: checks 
*** RIVER *** [2h 3s Ts 8s] [6c]
zaharoff74: checks 
balisstica: checks 
*** SHOW DOWN ***
zaharoff74: shows [Ac 2c] (a pair of Deuces)
balisstica: mucks hand 
zaharoff74 collected $1.48 from pot
*** SUMMARY ***
Total pot $1.55 | Rake $0.07 
Board [2h 3s Ts 8s 6c]
Seat 1: todd bonzales (button) folded on the Flop
Seat 2: Lord_of_days (small blind) folded before Flop
Seat 3: zaharoff74 (big blind) showed [Ac 2c] and won ($1.48) with a pair of Deuces
Seat 4: balisstica mucked
Seat 5: legendasheff folded before Flop (didn't bet)
Seat 6: alexos04 folded before Flop (didn't bet)



PokerStars Hand #222956611293:  Hold'em No Limit ($0.05/$0.10 USD) - 2021/01/23 10:16:43 ET
Table 'Polydoros II' 6-max Seat #2 is the button
Seat 1: todd bonzales ($7.92 in chips) 
Seat 2: Lord_of_days ($13.57 in chips) 
Seat 3: zaharoff74 ($10.91 in chips) 
Seat 4: balisstica ($10 in chips) 
Seat 5: legendasheff ($10.39 in chips) 
Seat 6: alexos04 ($19.29 in chips) 
zaharoff74: posts small blind $0.05
balisstica: posts big blind $0.10
*** HOLE CARDS ***
legendasheff: folds 
alexos04: raises $0.20 to $0.30
todd bonzales: calls $0.30
Lord_of_days: calls $0.30
zaharoff74: calls $0.25
balisstica: folds 
*** FLOP *** [9h 4s 3d]
zaharoff74: checks 
alexos04: checks 
todd bonzales: checks 
Lord_of_days: checks 
*** TURN *** [9h 4s 3d] [Ac]
zaharoff74: checks 
alexos04: bets $0.70
todd bonzales: raises $6.92 to $7.62 and is all-in
Lord_of_days: folds 
zaharoff74: folds 
alexos04: folds 
Uncalled bet ($6.92) returned to todd bonzales
todd bonzales collected $2.58 from pot
todd bonzales: doesn't show hand 
*** SUMMARY ***
Total pot $2.70 | Rake $0.12 
Board [9h 4s 3d Ac]
Seat 1: todd bonzales collected ($2.58)
Seat 2: Lord_of_days (button) folded on the Turn
Seat 3: zaharoff74 (small blind) folded on the Turn
Seat 4: balisstica (big blind) folded before Flop
Seat 5: legendasheff folded before Flop (didn't bet)
Seat 6: alexos04 folded on the Turn



PokerStars Hand #222956642989:  Hold'em No Limit ($0.05/$0.10 USD) - 2021/01/23 10:17:42 ET
Table 'Polydoros II' 6-max Seat #3 is the button
Seat 1: todd bonzales ($9.50 in chips) 
Seat 2: Lord_of_days ($13.27 in chips) 
Seat 3: zaharoff74 ($10.61 in chips) 
Seat 4: balisstica ($10 in chips) 
Seat 6: alexos04 ($18.29 in chips) 
balisstica: posts small blind $0.05
legendasheff: is sitting out 
alexos04: posts big blind $0.10
*** HOLE CARDS ***
legendasheff leaves the table
todd bonzales: calls $0.10
Lord_of_days: folds 
zaharoff74: folds 
balisstica: folds 
alexos04: checks 
*** FLOP *** [9s Kh 5h]
alexos04: checks 
todd bonzales: checks 
*** TURN *** [9s Kh 5h] [4h]
alexos04: checks 
todd bonzales: checks 
*** RIVER *** [9s Kh 5h 4h] [3s]
alexos04: checks 
todd bonzales: checks 
*** SHOW DOWN ***
alexos04: shows [3h 6d] (a pair of Threes)
todd bonzales: mucks hand 
alexos04 collected $0.24 from pot
*** SUMMARY ***
Total pot $0.25 | Rake $0.01 
Board [9s Kh 5h 4h 3s]
Seat 1: todd bonzales mucked
Seat 2: Lord_of_days folded before Flop (didn't bet)
Seat 3: zaharoff74 (button) folded before Flop (didn't bet)
Seat 4: balisstica (small blind) folded before Flop
Seat 6: alexos04 (big blind) showed [3h 6d] and won ($0.24) with a pair of Threes



PokerStars Hand #222956662305:  Hold'em No Limit ($0.05/$0.10 USD) - 2021/01/23 10:18:18 ET
Table 'Polydoros II' 6-max Seat #4 is the button
Seat 1: todd bonzales ($9.40 in chips) 
Seat 2: Lord_of_days ($13.27 in chips) 
Seat 3: zaharoff74 ($10.61 in chips) 
Seat 4: balisstica ($10 in chips) 
Seat 6: alexos04 ($18.43 in chips) 
alexos04: posts small blind $0.05
todd bonzales: posts big blind $0.10
*** HOLE CARDS ***
Lord_of_days: folds 
zaharoff74: folds 
balisstica: folds 
alexos04: raises $0.20 to $0.30
todd bonzales: folds 
Uncalled bet ($0.20) returned to alexos04
steinpilz1955 joins the table at seat #5 
alexos04 collected $0.20 from pot
alexos04: doesn't show hand 
*** SUMMARY ***
Total pot $0.20 | Rake $0 
Seat 1: todd bonzales (big blind) folded before Flop
Seat 2: Lord_of_days folded before Flop (didn't bet)
Seat 3: zaharoff74 folded before Flop (didn't bet)
Seat 4: balisstica (button) folded before Flop (didn't bet)
Seat 6: alexos04 (small blind) collected ($0.20)



PokerStars Hand #222956670274:  Hold'em No Limit ($0.05/$0.10 USD) - 2021/01/23 10:18:33 ET
Table 'Polydoros II' 6-max Seat #6 is the button
Seat 1: todd bonzales ($9.30 in chips) 
Seat 2: Lord_of_days ($13.27 in chips) 
Seat 3: zaharoff74 ($10.61 in chips) 
Seat 4: balisstica ($10 in chips) 
Seat 6: alexos04 ($18.53 in chips) 
todd bonzales: posts small blind $0.05
Lord_of_days: posts big blind $0.10
steinpilz1955: sits out 
*** HOLE CARDS ***
zaharoff74: folds 
balisstica: folds 
alexos04: folds 
todd bonzales: calls $0.05
Lord_of_days: checks 
*** FLOP *** [9h 2h Ad]
todd bonzales: checks 
Lord_of_days: checks 
*** TURN *** [9h 2h Ad] [Js]
todd bonzales: checks 
Lord_of_days: checks 
*** RIVER *** [9h 2h Ad Js] [6s]
todd bonzales: checks 
Lord_of_days: checks 
*** SHOW DOWN ***
todd bonzales: shows [3c 5c] (high card Ace)
Lord_of_days: shows [Td 4c] (high card Ace - Jack+Ten kicker)
Lord_of_days collected $0.19 from pot
*** SUMMARY ***
Total pot $0.20 | Rake $0.01 
Board [9h 2h Ad Js 6s]
Seat 1: todd bonzales (small blind) showed [3c 5c] and lost with high card Ace
Seat 2: Lord_of_days (big blind) showed [Td 4c] and won ($0.19) with high card Ace
Seat 3: zaharoff74 folded before Flop (didn't bet)
Seat 4: balisstica folded before Flop (didn't bet)
Seat 6: alexos04 (button) folded before Flop (didn't bet)



PokerStars Hand #222956685292:  Hold'em No Limit ($0.05/$0.10 USD) - 2021/01/23 10:19:01 ET
Table 'Polydoros II' 6-max Seat #1 is the button
Seat 1: todd bonzales ($9.20 in chips) 
Seat 2: Lord_of_days ($13.36 in chips) 
Seat 3: zaharoff74 ($10.61 in chips) 
Seat 4: balisstica ($10 in chips) 
Seat 6: alexos04 ($18.53 in chips) 
Lord_of_days: posts small blind $0.05
zaharoff74: posts big blind $0.10
steinpilz1955: sits out 
*** HOLE CARDS ***
balisstica has timed out
balisstica: folds 
alexos04: folds 
todd bonzales: folds 
Lord_of_days: folds 
Uncalled bet ($0.05) returned to zaharoff74
zaharoff74 collected $0.10 from pot
zaharoff74: doesn't show hand 
*** SUMMARY ***
Total pot $0.10 | Rake $0 
Seat 1: todd bonzales (button) folded before Flop (didn't bet)
Seat 2: Lord_of_days (small blind) folded before Flop
Seat 3: zaharoff74 (big blind) collected ($0.10)
Seat 4: balisstica folded before Flop (didn't bet)
Seat 6: alexos04 folded before Flop (didn't bet)



PokerStars Hand #222956695005:  Hold'em No Limit ($0.05/$0.10 USD) - 2021/01/23 10:19:19 ET
Table 'Polydoros II' 6-max Seat #2 is the button
Seat 1: todd bonzales ($9.20 in chips) 
Seat 2: Lord_of_days ($13.31 in chips) 
Seat 3: zaharoff74 ($10.66 in chips) 
Seat 4: balisstica ($10 in chips) 
Seat 6: alexos04 ($18.53 in chips) 
zaharoff74: posts small blind $0.05
balisstica: posts big blind $0.10
steinpilz1955: sits out 
*** HOLE CARDS ***
alexos04: raises $0.20 to $0.30
todd bonzales: calls $0.30
Lord_of_days: calls $0.30
zaharoff74: folds 
balisstica: folds 
*** FLOP *** [3c Kc 9c]
alexos04: bets $0.70
todd bonzales: calls $0.70
Lord_of_days: folds 
*** TURN *** [3c Kc 9c] [Ah]
alexos04: checks 
todd bonzales: bets $8.20 and is all-in
alexos04: calls $8.20
*** RIVER *** [3c Kc 9c Ah] [5h]
*** SHOW DOWN ***
alexos04: shows [Kh Ad] (two pair, Aces and Kings)
todd bonzales: shows [Ac 4h] (a pair of Aces)
alexos04 collected $18 from pot
todd bonzales cashed out the hand for $3.64 | Cash Out Fee $0.04
*** SUMMARY ***
Total pot $18.85 | Rake $0.85 
Board [3c Kc 9c Ah 5h]
Seat 1: todd bonzales showed [Ac 4h] and lost with a pair of Aces (cashed out).
Seat 2: Lord_of_days (button) folded on the Flop
Seat 3: zaharoff74 (small blind) folded before Flop
Seat 4: balisstica (big blind) folded before Flop
Seat 6: alexos04 showed [Kh Ad] and won ($18) with two pair, Aces and Kings



PokerStars Hand #222956724211:  Hold'em No Limit ($0.05/$0.10 USD) - 2021/01/23 10:20:14 ET
Table 'Polydoros II' 6-max Seat #3 is the button
Seat 1: todd bonzales ($3.64 in chips) 
Seat 2: Lord_of_days ($13.01 in chips) 
Seat 3: zaharoff74 ($10.61 in chips) 
Seat 4: balisstica ($10 in chips) 
Seat 5: steinpilz1955 ($8 in chips) 
Seat 6: alexos04 ($27.33 in chips) 
balisstica: posts small blind $0.05
steinpilz1955: posts big blind $0.10
*** HOLE CARDS ***
alexos04: folds 
todd bonzales: folds 
Lord_of_days: folds 
zaharoff74: folds 
balisstica: raises $0.20 to $0.30
steinpilz1955: calls $0.20
*** FLOP *** [Jh Jd 3c]
balisstica: bets $0.19
steinpilz1955: calls $0.19
*** TURN *** [Jh Jd 3c] [3h]
balisstica: checks 
steinpilz1955: bets $0.70
balisstica: folds 
Uncalled bet ($0.70) returned to steinpilz1955
steinpilz1955 collected $0.94 from pot
*** SUMMARY ***
Total pot $0.98 | Rake $0.04 
Board [Jh Jd 3c 3h]
Seat 1: todd bonzales folded before Flop (didn't bet)
Seat 2: Lord_of_days folded before Flop (didn't bet)
Seat 3: zaharoff74 (button) folded before Flop (didn't bet)
Seat 4: balisstica (small blind) folded on the Turn
Seat 5: steinpilz1955 (big blind) collected ($0.94)
Seat 6: alexos04 folded before Flop (didn't bet)



PokerStars Hand #222956754551:  Hold'em No Limit ($0.05/$0.10 USD) - 2021/01/23 10:21:10 ET
Table 'Polydoros II' 6-max Seat #4 is the button
Seat 1: todd bonzales ($3.64 in chips) 
Seat 2: Lord_of_days ($13.01 in chips) 
Seat 3: zaharoff74 ($10.61 in chips) 
Seat 4: balisstica ($10 in chips) 
Seat 5: steinpilz1955 ($8.45 in chips) 
Seat 6: alexos04 ($27.33 in chips) 
steinpilz1955: posts small blind $0.05
alexos04: posts big blind $0.10
*** HOLE CARDS ***
todd bonzales: folds 
Lord_of_days: raises $0.20 to $0.30
zaharoff74: folds 
balisstica: folds 
todd bonzales leaves the table
steinpilz1955: calls $0.25
alexos04: raises $1.20 to $1.50
Lord_of_days: folds 
poseidoporunbot joins the table at seat #1 
steinpilz1955: calls $1.20
*** FLOP *** [Tc 5c Jh]
steinpilz1955: checks 
alexos04: bets $1.60
steinpilz1955: raises $5.35 to $6.95 and is all-in
alexos04: calls $5.35
*** TURN *** [Tc 5c Jh] [As]
*** RIVER *** [Tc 5c Jh As] [4c]
*** SHOW DOWN ***
steinpilz1955: shows [Ts Jd] (two pair, Jacks and Tens)
alexos04: shows [Ks Kc] (a pair of Kings)
steinpilz1955 collected $16.43 from pot
*** SUMMARY ***
Total pot $17.20 | Rake $0.77 
Board [Tc 5c Jh As 4c]
Seat 1: todd bonzales folded before Flop (didn't bet)
Seat 2: Lord_of_days folded before Flop
Seat 3: zaharoff74 folded before Flop (didn't bet)
Seat 4: balisstica (button) folded before Flop (didn't bet)
Seat 5: steinpilz1955 (small blind) showed [Ts Jd] and won ($16.43) with two pair, Jacks and Tens
Seat 6: alexos04 (big blind) showed [Ks Kc] and lost with a pair of Kings



PokerStars Hand #222956784016:  Hold'em No Limit ($0.05/$0.10 USD) - 2021/01/23 10:22:05 ET
Table 'Polydoros II' 6-max Seat #5 is the button
Seat 1: poseidoporunbot ($10 in chips) 
Seat 2: Lord_of_days ($12.71 in chips) 
Seat 3: zaharoff74 ($10.61 in chips) 
Seat 4: balisstica ($10 in chips) 
Seat 5: steinpilz1955 ($16.43 in chips) 
Seat 6: alexos04 ($18.88 in chips) 
alexos04: posts small blind $0.05
poseidoporunbot: posts big blind $0.10
*** HOLE CARDS ***
Lord_of_days: folds 
zaharoff74: folds 
balisstica: folds 
steinpilz1955: calls $0.10
alexos04: folds 
poseidoporunbot: checks 
*** FLOP *** [5c Kc 6s]
poseidoporunbot: checks 
steinpilz1955: bets $0.30
poseidoporunbot: folds 
Uncalled bet ($0.30) returned to steinpilz1955
steinpilz1955 collected $0.24 from pot
*** SUMMARY ***
Total pot $0.25 | Rake $0.01 
Board [5c Kc 6s]
Seat 1: poseidoporunbot (big blind) folded on the Flop
Seat 2: Lord_of_days folded before Flop (didn't bet)
Seat 3: zaharoff74 folded before Flop (didn't bet)
Seat 4: balisstica folded before Flop (didn't bet)
Seat 5: steinpilz1955 (button) collected ($0.24)
Seat 6: alexos04 (small blind) folded before Flop



PokerStars Hand #222956798822:  Hold'em No Limit ($0.05/$0.10 USD) - 2021/01/23 10:22:33 ET
Table 'Polydoros II' 6-max Seat #6 is the button
Seat 1: poseidoporunbot ($10 in chips) 
Seat 2: Lord_of_days ($12.71 in chips) 
Seat 3: zaharoff74 ($10.61 in chips) 
Seat 4: balisstica ($10 in chips) 
Seat 5: steinpilz1955 ($16.57 in chips) 
Seat 6: alexos04 ($18.83 in chips) 
poseidoporunbot: posts small blind $0.05
Lord_of_days: posts big blind $0.10
*** HOLE CARDS ***
zaharoff74: folds 
balisstica: raises $0.20 to $0.30
steinpilz1955: calls $0.30
alexos04: folds 
poseidoporunbot: folds 
Lord_of_days: folds 
*** FLOP *** [Qs 9c 5c]
balisstica: bets $0.24
steinpilz1955: calls $0.24
*** TURN *** [Qs 9c 5c] [5h]
balisstica: checks 
steinpilz1955: checks 
*** RIVER *** [Qs 9c 5c 5h] [9h]
balisstica: checks 
steinpilz1955: bets $0.50
balisstica: folds 
Uncalled bet ($0.50) returned to steinpilz1955
steinpilz1955 collected $1.17 from pot
*** SUMMARY ***
Total pot $1.23 | Rake $0.06 
Board [Qs 9c 5c 5h 9h]
Seat 1: poseidoporunbot (small blind) folded before Flop
Seat 2: Lord_of_days (big blind) folded before Flop
Seat 3: zaharoff74 folded before Flop (didn't bet)
Seat 4: balisstica folded on the River
Seat 5: steinpilz1955 collected ($1.17)
Seat 6: alexos04 (button) folded before Flop (didn't bet)



PokerStars Hand #222956815929:  Hold'em No Limit ($0.05/$0.10 USD) - 2021/01/23 10:23:04 ET
Table 'Polydoros II' 6-max Seat #1 is the button
Seat 1: poseidoporunbot ($10 in chips) 
Seat 2: Lord_of_days ($12.61 in chips) 
Seat 3: zaharoff74 ($10.61 in chips) 
Seat 4: balisstica ($10 in chips) 
Seat 5: steinpilz1955 ($17.20 in chips) 
Seat 6: alexos04 ($18.83 in chips) 
Lord_of_days: posts small blind $0.05
zaharoff74: posts big blind $0.10
*** HOLE CARDS ***
balisstica: folds 
steinpilz1955: folds 
alexos04: folds 
poseidoporunbot: folds 
Lord_of_days: raises $0.20 to $0.30
zaharoff74: calls $0.20
*** FLOP *** [Ac Kc Td]
Lord_of_days: bets $0.19
zaharoff74: calls $0.19
*** TURN *** [Ac Kc Td] [As]
Lord_of_days: bets $0.77
zaharoff74: folds 
Uncalled bet ($0.77) returned to Lord_of_days
Lord_of_days collected $0.94 from pot
Lord_of_days: doesn't show hand 
*** SUMMARY ***
Total pot $0.98 | Rake $0.04 
Board [Ac Kc Td As]
Seat 1: poseidoporunbot (button) folded before Flop (didn't bet)
Seat 2: Lord_of_days (small blind) collected ($0.94)
Seat 3: zaharoff74 (big blind) folded on the Turn
Seat 4: balisstica folded before Flop (didn't bet)
Seat 5: steinpilz1955 folded before Flop (didn't bet)
Seat 6: alexos04 folded before Flop (didn't bet)



PokerStars Hand #222956834149:  Hold'em No Limit ($0.05/$0.10 USD) - 2021/01/23 10:23:38 ET
Table 'Polydoros II' 6-max Seat #2 is the button
Seat 1: poseidoporunbot ($10 in chips) 
Seat 2: Lord_of_days ($13.06 in chips) 
Seat 3: zaharoff74 ($10.12 in chips) 
Seat 4: balisstica ($10 in chips) 
Seat 5: steinpilz1955 ($17.20 in chips) 
Seat 6: alexos04 ($18.83 in chips) 
zaharoff74: posts small blind $0.05
balisstica: posts big blind $0.10
*** HOLE CARDS ***
steinpilz1955: raises $0.10 to $0.20
alexos04: raises $0.70 to $0.90
poseidoporunbot: folds 
Lord_of_days: folds 
zaharoff74: folds 
balisstica: folds 
steinpilz1955: calls $0.70
*** FLOP *** [3d 4c Qc]
steinpilz1955: checks 
alexos04: bets $1.10
steinpilz1955: calls $1.10
*** TURN *** [3d 4c Qc] [5h]
steinpilz1955: checks 
alexos04: checks 
*** RIVER *** [3d 4c Qc 5h] [3c]
steinpilz1955: bets $0.30
alexos04: calls $0.30
*** SHOW DOWN ***
steinpilz1955: shows [9s 9d] (two pair, Nines and Threes)
alexos04: mucks hand 
steinpilz1955 collected $4.54 from pot
*** SUMMARY ***
Total pot $4.75 | Rake $0.21 
Board [3d 4c Qc 5h 3c]
Seat 1: poseidoporunbot folded before Flop (didn't bet)
Seat 2: Lord_of_days (button) folded before Flop (didn't bet)
Seat 3: zaharoff74 (small blind) folded before Flop
Seat 4: balisstica (big blind) folded before Flop
Seat 5: steinpilz1955 showed [9s 9d] and won ($4.54) with two pair, Nines and Threes
Seat 6: alexos04 mucked



PokerStars Hand #222956868953:  Hold'em No Limit ($0.05/$0.10 USD) - 2021/01/23 10:24:42 ET
Table 'Polydoros II' 6-max Seat #3 is the button
Seat 1: poseidoporunbot ($10 in chips) 
Seat 2: Lord_of_days ($13.06 in chips) 
Seat 3: zaharoff74 ($10.07 in chips) 
Seat 4: balisstica ($10 in chips) 
Seat 5: steinpilz1955 ($19.44 in chips) 
Seat 6: alexos04 ($16.53 in chips) 
balisstica: posts small blind $0.05
steinpilz1955: posts big blind $0.10
*** HOLE CARDS ***
alexos04: folds 
poseidoporunbot: folds 
Lord_of_days: raises $0.20 to $0.30
zaharoff74: folds 
balisstica: folds 
steinpilz1955: calls $0.20
*** FLOP *** [6h 6s 7s]
steinpilz1955: checks 
Lord_of_days: bets $0.20
steinpilz1955: raises $0.20 to $0.40
Lord_of_days: folds 
Uncalled bet ($0.20) returned to steinpilz1955
steinpilz1955 collected $1 from pot
*** SUMMARY ***
Total pot $1.05 | Rake $0.05 
Board [6h 6s 7s]
Seat 1: poseidoporunbot folded before Flop (didn't bet)
Seat 2: Lord_of_days folded on the Flop
Seat 3: zaharoff74 (button) folded before Flop (didn't bet)
Seat 4: balisstica (small blind) folded before Flop
Seat 5: steinpilz1955 (big blind) collected ($1)
Seat 6: alexos04 folded before Flop (didn't bet)



PokerStars Hand #222956889773:  Hold'em No Limit ($0.05/$0.10 USD) - 2021/01/23 10:25:21 ET
Table 'Polydoros II' 6-max Seat #4 is the button
Seat 1: poseidoporunbot ($10 in chips) 
Seat 2: Lord_of_days ($12.56 in chips) 
Seat 3: zaharoff74 ($10.07 in chips) 
Seat 4: balisstica ($10 in chips) 
Seat 5: steinpilz1955 ($19.94 in chips) 
Seat 6: alexos04 ($16.53 in chips) 
steinpilz1955: posts small blind $0.05
alexos04: posts big blind $0.10
*** HOLE CARDS ***
poseidoporunbot: folds 
Lord_of_days: folds 
zaharoff74: folds 
balisstica: raises $0.15 to $0.25
steinpilz1955: calls $0.20
alexos04: calls $0.15
*** FLOP *** [9h 6d Jc]
steinpilz1955: checks 
alexos04: checks 
balisstica: checks 
*** TURN *** [9h 6d Jc] [5d]
steinpilz1955: checks 
alexos04: checks 
balisstica: bets $0.54
steinpilz1955: folds 
alexos04: folds 
Uncalled bet ($0.54) returned to balisstica
balisstica collected $0.72 from pot
balisstica: doesn't show hand 
*** SUMMARY ***
Total pot $0.75 | Rake $0.03 
Board [9h 6d Jc 5d]
Seat 1: poseidoporunbot folded before Flop (didn't bet)
Seat 2: Lord_of_days folded before Flop (didn't bet)
Seat 3: zaharoff74 folded before Flop (didn't bet)
Seat 4: balisstica (button) collected ($0.72)
Seat 5: steinpilz1955 (small blind) folded on the Turn
Seat 6: alexos04 (big blind) folded on the Turn



PokerStars Hand #222956927480:  Hold'em No Limit ($0.05/$0.10 USD) - 2021/01/23 10:26:30 ET
Table 'Polydoros II' 6-max Seat #5 is the button
Seat 1: poseidoporunbot ($10 in chips) 
Seat 2: Lord_of_days ($12.56 in chips) 
Seat 3: zaharoff74 ($10.07 in chips) 
Seat 4: balisstica ($10.47 in chips) 
Seat 5: steinpilz1955 ($19.69 in chips) 
Seat 6: alexos04 ($16.28 in chips) 
alexos04: posts small blind $0.05
poseidoporunbot: posts big blind $0.10
*** HOLE CARDS ***
Lord_of_days: folds 
zaharoff74: folds 
balisstica: folds 
steinpilz1955: raises $0.30 to $0.40
alexos04: calls $0.35
poseidoporunbot: folds 
*** FLOP *** [Ks 7s 7h]
alexos04: checks 
steinpilz1955: bets $0.50
alexos04: folds 
Uncalled bet ($0.50) returned to steinpilz1955
steinpilz1955 collected $0.86 from pot
*** SUMMARY ***
Total pot $0.90 | Rake $0.04 
Board [Ks 7s 7h]
Seat 1: poseidoporunbot (big blind) folded before Flop
Seat 2: Lord_of_days folded before Flop (didn't bet)
Seat 3: zaharoff74 folded before Flop (didn't bet)
Seat 4: balisstica folded before Flop (didn't bet)
Seat 5: steinpilz1955 (button) collected ($0.86)
Seat 6: alexos04 (small blind) folded on the Flop



PokerStars Hand #222956953087:  Hold'em No Limit ($0.05/$0.10 USD) - 2021/01/23 10:27:17 ET
Table 'Polydoros II' 6-max Seat #6 is the button
Seat 1: poseidoporunbot ($10 in chips) 
Seat 2: Lord_of_days ($12.56 in chips) 
Seat 3: zaharoff74 ($10.07 in chips) 
Seat 4: balisstica ($10.47 in chips) 
Seat 5: steinpilz1955 ($20.15 in chips) 
Seat 6: alexos04 ($15.88 in chips) 
poseidoporunbot: posts small blind $0.05
Lord_of_days: posts big blind $0.10
*** HOLE CARDS ***
zaharoff74: folds 
balisstica: folds 
steinpilz1955: folds 
alexos04: raises $0.30 to $0.40
poseidoporunbot: folds 
Lord_of_days: raises $1 to $1.40
alexos04: folds 
Uncalled bet ($1) returned to Lord_of_days
Lord_of_days collected $0.85 from pot
Lord_of_days: doesn't show hand 
*** SUMMARY ***
Total pot $0.85 | Rake $0 
Seat 1: poseidoporunbot (small blind) folded before Flop
Seat 2: Lord_of_days (big blind) collected ($0.85)
Seat 3: zaharoff74 folded before Flop (didn't bet)
Seat 4: balisstica folded before Flop (didn't bet)
Seat 5: steinpilz1955 folded before Flop (didn't bet)
Seat 6: alexos04 (button) folded before Flop



PokerStars Hand #222956974558:  Hold'em No Limit ($0.05/$0.10 USD) - 2021/01/23 10:27:57 ET
Table 'Polydoros II' 6-max Seat #1 is the button
Seat 1: poseidoporunbot ($10 in chips) 
Seat 2: Lord_of_days ($13.01 in chips) 
Seat 4: balisstica ($10.47 in chips) 
Seat 5: steinpilz1955 ($20.15 in chips) 
Seat 6: alexos04 ($15.48 in chips) 
Lord_of_days: posts small blind $0.05
zaharoff74: is sitting out 
balisstica: posts big blind $0.10
*** HOLE CARDS ***
steinpilz1955: folds 
alexos04: folds 
zaharoff74 leaves the table
poseidoporunbot: folds 
Lord_of_days: raises $0.20 to $0.30
balisstica: folds 
Uncalled bet ($0.20) returned to Lord_of_days
Lord_of_days collected $0.20 from pot
Lord_of_days: doesn't show hand 
*** SUMMARY ***
Total pot $0.20 | Rake $0 
Seat 1: poseidoporunbot (button) folded before Flop (didn't bet)
Seat 2: Lord_of_days (small blind) collected ($0.20)
Seat 4: balisstica (big blind) folded before Flop
Seat 5: steinpilz1955 folded before Flop (didn't bet)
Seat 6: alexos04 folded before Flop (didn't bet)



PokerStars Hand #222956983821:  Hold'em No Limit ($0.05/$0.10 USD) - 2021/01/23 10:28:13 ET
Table 'Polydoros II' 6-max Seat #2 is the button
Seat 1: poseidoporunbot ($10 in chips) 
Seat 2: Lord_of_days ($13.11 in chips) 
Seat 4: balisstica ($10.37 in chips) 
Seat 5: steinpilz1955 ($20.15 in chips) 
Seat 6: alexos04 ($15.48 in chips) 
balisstica: posts small blind $0.05
steinpilz1955: posts big blind $0.10
*** HOLE CARDS ***
marcin116 joins the table at seat #3 
alexos04: folds 
poseidoporunbot: folds 
Lord_of_days: raises $0.20 to $0.30
balisstica: folds 
steinpilz1955: folds 
Uncalled bet ($0.20) returned to Lord_of_days
Lord_of_days collected $0.25 from pot
Lord_of_days: doesn't show hand 
*** SUMMARY ***
Total pot $0.25 | Rake $0 
Seat 1: poseidoporunbot folded before Flop (didn't bet)
Seat 2: Lord_of_days (button) collected ($0.25)
Seat 4: balisstica (small blind) folded before Flop
Seat 5: steinpilz1955 (big blind) folded before Flop
Seat 6: alexos04 folded before Flop (didn't bet)



PokerStars Hand #222956989601:  Hold'em No Limit ($0.05/$0.10 USD) - 2021/01/23 10:28:24 ET
Table 'Polydoros II' 6-max Seat #4 is the button
Seat 1: poseidoporunbot ($10 in chips) 
Seat 2: Lord_of_days ($13.26 in chips) 
Seat 4: balisstica ($10.32 in chips) 
Seat 5: steinpilz1955 ($20.05 in chips) 
Seat 6: alexos04 ($15.48 in chips) 
steinpilz1955: posts small blind $0.05
alexos04: posts big blind $0.10
marcin116: sits out 
*** HOLE CARDS ***
poseidoporunbot: folds 
Lord_of_days: folds 
balisstica: raises $0.15 to $0.25
steinpilz1955: folds 
alexos04: folds 
Uncalled bet ($0.15) returned to balisstica
balisstica collected $0.25 from pot
balisstica: doesn't show hand 
*** SUMMARY ***
Total pot $0.25 | Rake $0 
Seat 1: poseidoporunbot folded before Flop (didn't bet)
Seat 2: Lord_of_days folded before Flop (didn't bet)
Seat 4: balisstica (button) collected ($0.25)
Seat 5: steinpilz1955 (small blind) folded before Flop
Seat 6: alexos04 (big blind) folded before Flop



PokerStars Hand #222957000248:  Hold'em No Limit ($0.05/$0.10 USD) - 2021/01/23 10:28:44 ET
Table 'Polydoros II' 6-max Seat #5 is the button
Seat 1: poseidoporunbot ($10 in chips) 
Seat 2: Lord_of_days ($13.26 in chips) 
Seat 4: balisstica ($10.47 in chips) 
Seat 5: steinpilz1955 ($20 in chips) 
Seat 6: alexos04 ($15.38 in chips) 
alexos04: posts small blind $0.05
poseidoporunbot: posts big blind $0.10
marcin116: sits out 
*** HOLE CARDS ***
Lord_of_days: folds 
balisstica: folds 
steinpilz1955: folds 
alexos04: raises $0.20 to $0.30
poseidoporunbot: raises $0.60 to $0.90
alexos04: calls $0.60
*** FLOP *** [5s Qs 9s]
alexos04: checks 
poseidoporunbot: checks 
*** TURN *** [5s Qs 9s] [2c]
alexos04: bets $1.10
poseidoporunbot: raises $1.80 to $2.90
alexos04: folds 
Uncalled bet ($1.80) returned to poseidoporunbot
poseidoporunbot collected $3.82 from pot
*** SUMMARY ***
Total pot $4 | Rake $0.18 
Board [5s Qs 9s 2c]
Seat 1: poseidoporunbot (big blind) collected ($3.82)
Seat 2: Lord_of_days folded before Flop (didn't bet)
Seat 4: balisstica folded before Flop (didn't bet)
Seat 5: steinpilz1955 (button) folded before Flop (didn't bet)
Seat 6: alexos04 (small blind) folded on the Turn



PokerStars Hand #222957046942:  Hold'em No Limit ($0.05/$0.10 USD) - 2021/01/23 10:30:10 ET
Table 'Polydoros II' 6-max Seat #6 is the button
Seat 1: poseidoporunbot ($11.82 in chips) 
Seat 2: Lord_of_days ($13.26 in chips) 
Seat 4: balisstica ($10.47 in chips) 
Seat 5: steinpilz1955 ($20 in chips) 
Seat 6: alexos04 ($13.38 in chips) 
poseidoporunbot: posts small blind $0.05
Lord_of_days: posts big blind $0.10
marcin116: sits out 
*** HOLE CARDS ***
balisstica: folds 
steinpilz1955: folds 
alexos04: folds 
poseidoporunbot: raises $0.20 to $0.30
Lord_of_days: calls $0.20
*** FLOP *** [4d As Ac]
poseidoporunbot: bets $0.14
Lord_of_days: calls $0.14
*** TURN *** [4d As Ac] [4s]
poseidoporunbot: bets $0.80
Lord_of_days: calls $0.80
*** RIVER *** [4d As Ac 4s] [Jd]
poseidoporunbot: checks 
Lord_of_days: checks 
*** SHOW DOWN ***
poseidoporunbot: shows [Qh Ah] (a full house, Aces full of Fours)
Lord_of_days: mucks hand 
poseidoporunbot collected $2.37 from pot
*** SUMMARY ***
Total pot $2.48 | Rake $0.11 
Board [4d As Ac 4s Jd]
Seat 1: poseidoporunbot (small blind) showed [Qh Ah] and won ($2.37) with a full house, Aces full of Fours
Seat 2: Lord_of_days (big blind) mucked
Seat 4: balisstica folded before Flop (didn't bet)
Seat 5: steinpilz1955 folded before Flop (didn't bet)
Seat 6: alexos04 (button) folded before Flop (didn't bet)



PokerStars Hand #222957081699:  Hold'em No Limit ($0.05/$0.10 USD) - 2021/01/23 10:31:01 ET
Table 'Polydoros II' 6-max Seat #1 is the button
Seat 1: poseidoporunbot ($12.95 in chips) 
Seat 2: Lord_of_days ($12.02 in chips) 
Seat 3: marcin116 ($10 in chips) 
Seat 4: balisstica ($10.47 in chips) 
Seat 5: steinpilz1955 ($20 in chips) 
Seat 6: alexos04 ($13.38 in chips) 
Lord_of_days: posts small blind $0.05
marcin116: posts big blind $0.10
*** HOLE CARDS ***
balisstica: folds 
steinpilz1955: folds 
alexos04: folds 
poseidoporunbot: folds 
Lord_of_days: folds 
Uncalled bet ($0.05) returned to marcin116
marcin116 collected $0.10 from pot
marcin116: doesn't show hand 
*** SUMMARY ***
Total pot $0.10 | Rake $0 
Seat 1: poseidoporunbot (button) folded before Flop (didn't bet)
Seat 2: Lord_of_days (small blind) folded before Flop
Seat 3: marcin116 (big blind) collected ($0.10)
Seat 4: balisstica folded before Flop (didn't bet)
Seat 5: steinpilz1955 folded before Flop (didn't bet)
Seat 6: alexos04 folded before Flop (didn't bet)



PokerStars Hand #222957085851:  Hold'em No Limit ($0.05/$0.10 USD) - 2021/01/23 10:31:08 ET
Table 'Polydoros II' 6-max Seat #2 is the button
Seat 1: poseidoporunbot ($12.95 in chips) 
Seat 2: Lord_of_days ($11.97 in chips) 
Seat 3: marcin116 ($10.05 in chips) 
Seat 4: balisstica ($10.47 in chips) 
Seat 5: steinpilz1955 ($20 in chips) 
Seat 6: alexos04 ($13.38 in chips) 
marcin116: posts small blind $0.05
balisstica: posts big blind $0.10
*** HOLE CARDS ***
steinpilz1955: folds 
alexos04: folds 
poseidoporunbot: folds 
Lord_of_days: raises $0.20 to $0.30
marcin116: folds 
balisstica: calls $0.20
*** FLOP *** [Jc 4s Th]
balisstica: checks 
Lord_of_days: bets $0.20
balisstica: calls $0.20
*** TURN *** [Jc 4s Th] [2c]
balisstica: checks 
Lord_of_days: checks 
*** RIVER *** [Jc 4s Th 2c] [8d]
balisstica: checks 
Lord_of_days: checks 
*** SHOW DOWN ***
balisstica: shows [Td Qd] (a pair of Tens)
Lord_of_days: mucks hand 
balisstica collected $1 from pot
*** SUMMARY ***
Total pot $1.05 | Rake $0.05 
Board [Jc 4s Th 2c 8d]
Seat 1: poseidoporunbot folded before Flop (didn't bet)
Seat 2: Lord_of_days (button) mucked
Seat 3: marcin116 (small blind) folded before Flop
Seat 4: balisstica (big blind) showed [Td Qd] and won ($1) with a pair of Tens
Seat 5: steinpilz1955 folded before Flop (didn't bet)
Seat 6: alexos04 folded before Flop (didn't bet)



PokerStars Hand #222957107582:  Hold'em No Limit ($0.05/$0.10 USD) - 2021/01/23 10:31:48 ET
Table 'Polydoros II' 6-max Seat #3 is the button
Seat 1: poseidoporunbot ($12.95 in chips) 
Seat 2: Lord_of_days ($11.47 in chips) 
Seat 3: marcin116 ($10 in chips) 
Seat 4: balisstica ($10.97 in chips) 
Seat 5: steinpilz1955 ($20 in chips) 
Seat 6: alexos04 ($13.38 in chips) 
balisstica: posts small blind $0.05
steinpilz1955: posts big blind $0.10
*** HOLE CARDS ***
alexos04: folds 
poseidoporunbot: folds 
Lord_of_days: folds 
marcin116: raises $0.25 to $0.35
balisstica: folds 
steinpilz1955: folds 
Uncalled bet ($0.25) returned to marcin116
marcin116 collected $0.25 from pot
marcin116: doesn't show hand 
*** SUMMARY ***
Total pot $0.25 | Rake $0 
Seat 1: poseidoporunbot folded before Flop (didn't bet)
Seat 2: Lord_of_days folded before Flop (didn't bet)
Seat 3: marcin116 (button) collected ($0.25)
Seat 4: balisstica (small blind) folded before Flop
Seat 5: steinpilz1955 (big blind) folded before Flop
Seat 6: alexos04 folded before Flop (didn't bet)



PokerStars Hand #222957114965:  Hold'em No Limit ($0.05/$0.10 USD) - 2021/01/23 10:32:02 ET
Table 'Polydoros II' 6-max Seat #4 is the button
Seat 1: poseidoporunbot ($12.95 in chips) 
Seat 2: Lord_of_days ($11.47 in chips) 
Seat 3: marcin116 ($10.15 in chips) 
Seat 4: balisstica ($10.92 in chips) 
Seat 5: steinpilz1955 ($19.90 in chips) 
Seat 6: alexos04 ($13.38 in chips) 
steinpilz1955: posts small blind $0.05
alexos04: posts big blind $0.10
*** HOLE CARDS ***
poseidoporunbot: folds 
Lord_of_days: folds 
marcin116: raises $0.25 to $0.35
balisstica: folds 
steinpilz1955: calls $0.30
alexos04: raises $1.15 to $1.50
marcin116: folds 
steinpilz1955: calls $1.15
*** FLOP *** [3h 9d 4d]
steinpilz1955: checks 
alexos04: bets $1.40
steinpilz1955: folds 
Uncalled bet ($1.40) returned to alexos04
alexos04 collected $3.20 from pot
alexos04: doesn't show hand 
*** SUMMARY ***
Total pot $3.35 | Rake $0.15 
Board [3h 9d 4d]
Seat 1: poseidoporunbot folded before Flop (didn't bet)
Seat 2: Lord_of_days folded before Flop (didn't bet)
Seat 3: marcin116 folded before Flop
Seat 4: balisstica (button) folded before Flop (didn't bet)
Seat 5: steinpilz1955 (small blind) folded on the Flop
Seat 6: alexos04 (big blind) collected ($3.20)



PokerStars Hand #222957137911:  Hold'em No Limit ($0.05/$0.10 USD) - 2021/01/23 10:32:43 ET
Table 'Polydoros II' 6-max Seat #5 is the button
Seat 1: poseidoporunbot ($12.95 in chips) 
Seat 2: Lord_of_days ($11.47 in chips) 
Seat 3: marcin116 ($10 in chips) 
Seat 4: balisstica ($10.92 in chips) 
Seat 5: steinpilz1955 ($18.40 in chips) 
Seat 6: alexos04 ($15.08 in chips) 
alexos04: posts small blind $0.05
poseidoporunbot: posts big blind $0.10
*** HOLE CARDS ***
Lord_of_days: folds 
marcin116: folds 
balisstica: folds 
steinpilz1955: raises $0.20 to $0.30
alexos04: calls $0.25
poseidoporunbot: folds 
*** FLOP *** [4s Jd Ts]
alexos04: checks 
steinpilz1955: bets $0.30
alexos04: calls $0.30
*** TURN *** [4s Jd Ts] [Ks]
alexos04: checks 
steinpilz1955: checks 
*** RIVER *** [4s Jd Ts Ks] [5s]
alexos04: checks 
steinpilz1955: bets $1
alexos04: folds 
Uncalled bet ($1) returned to steinpilz1955
steinpilz1955 collected $1.24 from pot
*** SUMMARY ***
Total pot $1.30 | Rake $0.06 
Board [4s Jd Ts Ks 5s]
Seat 1: poseidoporunbot (big blind) folded before Flop
Seat 2: Lord_of_days folded before Flop (didn't bet)
Seat 3: marcin116 folded before Flop (didn't bet)
Seat 4: balisstica folded before Flop (didn't bet)
Seat 5: steinpilz1955 (button) collected ($1.24)
Seat 6: alexos04 (small blind) folded on the River



PokerStars Hand #222957179410:  Hold'em No Limit ($0.05/$0.10 USD) - 2021/01/23 10:33:59 ET
Table 'Polydoros II' 6-max Seat #6 is the button
Seat 1: poseidoporunbot ($12.85 in chips) 
Seat 2: Lord_of_days ($11.47 in chips) 
Seat 3: marcin116 ($10 in chips) 
Seat 4: balisstica ($10.92 in chips) 
Seat 5: steinpilz1955 ($19.04 in chips) 
Seat 6: alexos04 ($14.48 in chips) 
poseidoporunbot: posts small blind $0.05
Lord_of_days: posts big blind $0.10
*** HOLE CARDS ***
marcin116: folds 
balisstica: folds 
steinpilz1955: calls $0.10
alexos04: folds 
poseidoporunbot: folds 
Lord_of_days: checks 
*** FLOP *** [6h Tc Kd]
Lord_of_days: checks 
steinpilz1955: checks 
*** TURN *** [6h Tc Kd] [5h]
Lord_of_days: checks 
steinpilz1955: bets $0.30
Lord_of_days: folds 
Uncalled bet ($0.30) returned to steinpilz1955
steinpilz1955 collected $0.24 from pot
*** SUMMARY ***
Total pot $0.25 | Rake $0.01 
Board [6h Tc Kd 5h]
Seat 1: poseidoporunbot (small blind) folded before Flop
Seat 2: Lord_of_days (big blind) folded on the Turn
Seat 3: marcin116 folded before Flop (didn't bet)
Seat 4: balisstica folded before Flop (didn't bet)
Seat 5: steinpilz1955 collected ($0.24)
Seat 6: alexos04 (button) folded before Flop (didn't bet)



PokerStars Hand #222957192035:  Hold'em No Limit ($0.05/$0.10 USD) - 2021/01/23 10:34:22 ET
Table 'Polydoros II' 6-max Seat #1 is the button
Seat 1: poseidoporunbot ($12.80 in chips) 
Seat 2: Lord_of_days ($11.37 in chips) 
Seat 3: marcin116 ($10 in chips) 
Seat 4: balisstica ($10.92 in chips) 
Seat 5: steinpilz1955 ($19.18 in chips) 
Seat 6: alexos04 ($14.48 in chips) 
Lord_of_days: posts small blind $0.05
marcin116: posts big blind $0.10
*** HOLE CARDS ***
balisstica: folds 
steinpilz1955: calls $0.10
alexos04: folds 
poseidoporunbot: folds 
Lord_of_days: folds 
marcin116: checks 
*** FLOP *** [Tc 9s Js]
marcin116: checks 
steinpilz1955: bets $0.50
marcin116: folds 
Uncalled bet ($0.50) returned to steinpilz1955
steinpilz1955 collected $0.24 from pot
*** SUMMARY ***
Total pot $0.25 | Rake $0.01 
Board [Tc 9s Js]
Seat 1: poseidoporunbot (button) folded before Flop (didn't bet)
Seat 2: Lord_of_days (small blind) folded before Flop
Seat 3: marcin116 (big blind) folded on the Flop
Seat 4: balisstica folded before Flop (didn't bet)
Seat 5: steinpilz1955 collected ($0.24)
Seat 6: alexos04 folded before Flop (didn't bet)



PokerStars Hand #222957207912:  Hold'em No Limit ($0.05/$0.10 USD) - 2021/01/23 10:34:50 ET
Table 'Polydoros II' 6-max Seat #2 is the button
Seat 1: poseidoporunbot ($12.80 in chips) 
Seat 2: Lord_of_days ($11.32 in chips) 
Seat 3: marcin116 ($10 in chips) 
Seat 5: steinpilz1955 ($19.32 in chips) 
Seat 6: alexos04 ($14.48 in chips) 
marcin116: posts small blind $0.05
balisstica: is sitting out 
steinpilz1955: posts big blind $0.10
*** HOLE CARDS ***
alexos04: raises $0.30 to $0.40
poseidoporunbot: folds 
Lord_of_days: folds 
marcin116: calls $0.35
steinpilz1955: folds 
*** FLOP *** [7d Jc 7c]
marcin116: checks 
alexos04: bets $0.30
marcin116: folds 
Uncalled bet ($0.30) returned to alexos04
alexos04 collected $0.86 from pot
alexos04: doesn't show hand 
*** SUMMARY ***
Total pot $0.90 | Rake $0.04 
Board [7d Jc 7c]
Seat 1: poseidoporunbot folded before Flop (didn't bet)
Seat 2: Lord_of_days (button) folded before Flop (didn't bet)
Seat 3: marcin116 (small blind) folded on the Flop
Seat 5: steinpilz1955 (big blind) folded before Flop
Seat 6: alexos04 collected ($0.86)



PokerStars Hand #222957231038:  Hold'em No Limit ($0.05/$0.10 USD) - 2021/01/23 10:35:33 ET
Table 'Polydoros II' 6-max Seat #3 is the button
Seat 1: poseidoporunbot ($12.80 in chips) 
Seat 2: Lord_of_days ($11.32 in chips) 
Seat 3: marcin116 ($10 in chips) 
Seat 5: steinpilz1955 ($19.22 in chips) 
Seat 6: alexos04 ($14.94 in chips) 
steinpilz1955: posts small blind $0.05
alexos04: posts big blind $0.10
*** HOLE CARDS ***
poseidoporunbot: folds 
Lord_of_days: folds 
marcin116: raises $0.25 to $0.35
steinpilz1955: calls $0.30
alexos04: folds 
*** FLOP *** [Ks Th Qd]
steinpilz1955: checks 
marcin116: checks 
*** TURN *** [Ks Th Qd] [Ah]
steinpilz1955: checks 
marcin116: bets $0.53
steinpilz1955: calls $0.53
*** RIVER *** [Ks Th Qd Ah] [Js]
steinpilz1955: bets $0.40
marcin116: calls $0.40
*** SHOW DOWN ***
steinpilz1955: shows [As 9h] (a straight, Ten to Ace)
marcin116: shows [9d Ad] (a straight, Ten to Ace)
steinpilz1955 collected $1.27 from pot
marcin116 collected $1.27 from pot
*** SUMMARY ***
Total pot $2.66 | Rake $0.12 
Board [Ks Th Qd Ah Js]
Seat 1: poseidoporunbot folded before Flop (didn't bet)
Seat 2: Lord_of_days folded before Flop (didn't bet)
Seat 3: marcin116 (button) showed [9d Ad] and won ($1.27) with a straight, Ten to Ace
Seat 5: steinpilz1955 (small blind) showed [As 9h] and won ($1.27) with a straight, Ten to Ace
Seat 6: alexos04 (big blind) folded before Flop



PokerStars Hand #222957259718:  Hold'em No Limit ($0.05/$0.10 USD) - 2021/01/23 10:36:25 ET
Table 'Polydoros II' 6-max Seat #5 is the button
Seat 1: poseidoporunbot ($12.80 in chips) 
Seat 2: Lord_of_days ($11.32 in chips) 
Seat 3: marcin116 ($10 in chips) 
Seat 5: steinpilz1955 ($19.21 in chips) 
Seat 6: alexos04 ($14.84 in chips) 
alexos04: posts small blind $0.05
poseidoporunbot: posts big blind $0.10
balisstica: sits out 
*** HOLE CARDS ***
Lord_of_days: folds 
marcin116: folds 
steinpilz1955: raises $0.20 to $0.30
alexos04: raises $0.60 to $0.90
poseidoporunbot: folds 
steinpilz1955: folds 
Uncalled bet ($0.60) returned to alexos04
alexos04 collected $0.70 from pot
alexos04: doesn't show hand 
*** SUMMARY ***
Total pot $0.70 | Rake $0 
Seat 1: poseidoporunbot (big blind) folded before Flop
Seat 2: Lord_of_days folded before Flop (didn't bet)
Seat 3: marcin116 folded before Flop (didn't bet)
Seat 5: steinpilz1955 (button) folded before Flop
Seat 6: alexos04 (small blind) collected ($0.70)



PokerStars Hand #222957271084:  Hold'em No Limit ($0.05/$0.10 USD) - 2021/01/23 10:36:45 ET
Table 'Polydoros II' 6-max Seat #6 is the button
Seat 1: poseidoporunbot ($12.70 in chips) 
Seat 2: Lord_of_days ($11.32 in chips) 
Seat 3: marcin116 ($10 in chips) 
Seat 5: steinpilz1955 ($18.91 in chips) 
Seat 6: alexos04 ($15.24 in chips) 
poseidoporunbot: posts small blind $0.05
Lord_of_days: posts big blind $0.10
balisstica: sits out 
*** HOLE CARDS ***
marcin116: folds 
steinpilz1955: calls $0.10
alexos04: folds 
poseidoporunbot: raises $0.40 to $0.50
Lord_of_days: folds 
steinpilz1955: calls $0.40
*** FLOP *** [Th Ts Qc]
poseidoporunbot: bets $0.35
steinpilz1955: raises $0.35 to $0.70
poseidoporunbot: folds 
Uncalled bet ($0.35) returned to steinpilz1955
steinpilz1955 collected $1.72 from pot
*** SUMMARY ***
Total pot $1.80 | Rake $0.08 
Board [Th Ts Qc]
Seat 1: poseidoporunbot (small blind) folded on the Flop
Seat 2: Lord_of_days (big blind) folded before Flop
Seat 3: marcin116 folded before Flop (didn't bet)
Seat 5: steinpilz1955 collected ($1.72)
Seat 6: alexos04 (button) folded before Flop (didn't bet)



PokerStars Hand #222957303185:  Hold'em No Limit ($0.05/$0.10 USD) - 2021/01/23 10:37:43 ET
Table 'Polydoros II' 6-max Seat #1 is the button
Seat 1: poseidoporunbot ($11.85 in chips) 
Seat 2: Lord_of_days ($11.22 in chips) 
Seat 3: marcin116 ($10 in chips) 
Seat 5: steinpilz1955 ($19.78 in chips) 
Seat 6: alexos04 ($15.24 in chips) 
Lord_of_days: posts small blind $0.05
marcin116: posts big blind $0.10
balisstica: sits out 
*** HOLE CARDS ***
steinpilz1955: calls $0.10
alexos04: raises $0.30 to $0.40
poseidoporunbot: folds 
Lord_of_days: folds 
marcin116: raises $0.95 to $1.35
steinpilz1955: folds 
alexos04: folds 
Uncalled bet ($0.95) returned to marcin116
marcin116 collected $0.95 from pot
marcin116: doesn't show hand 
*** SUMMARY ***
Total pot $0.95 | Rake $0 
Seat 1: poseidoporunbot (button) folded before Flop (didn't bet)
Seat 2: Lord_of_days (small blind) folded before Flop
Seat 3: marcin116 (big blind) collected ($0.95)
Seat 5: steinpilz1955 folded before Flop
Seat 6: alexos04 folded before Flop



PokerStars Hand #222957318258:  Hold'em No Limit ($0.05/$0.10 USD) - 2021/01/23 10:38:10 ET
Table 'Polydoros II' 6-max Seat #2 is the button
Seat 1: poseidoporunbot ($11.85 in chips) 
Seat 2: Lord_of_days ($11.17 in chips) 
Seat 3: marcin116 ($10.55 in chips) 
Seat 4: balisstica ($10.92 in chips) 
Seat 5: steinpilz1955 ($19.68 in chips) 
Seat 6: alexos04 ($14.84 in chips) 
marcin116: posts small blind $0.05
balisstica: posts big blind $0.10
*** HOLE CARDS ***
steinpilz1955: folds 
alexos04: folds 
poseidoporunbot: folds 
Lord_of_days: folds 
marcin116: raises $0.25 to $0.35
balisstica: calls $0.25
*** FLOP *** [2c 7s Tc]
marcin116: bets $0.50
balisstica: calls $0.50
*** TURN *** [2c 7s Tc] [Js]
marcin116: checks 
balisstica: checks 
*** RIVER *** [2c 7s Tc Js] [6c]
marcin116: checks 
balisstica: bets $2.50
marcin116: folds 
Uncalled bet ($2.50) returned to balisstica
balisstica collected $1.62 from pot
balisstica: doesn't show hand 
*** SUMMARY ***
Total pot $1.70 | Rake $0.08 
Board [2c 7s Tc Js 6c]
Seat 1: poseidoporunbot folded before Flop (didn't bet)
Seat 2: Lord_of_days (button) folded before Flop (didn't bet)
Seat 3: marcin116 (small blind) folded on the River
Seat 4: balisstica (big blind) collected ($1.62)
Seat 5: steinpilz1955 folded before Flop (didn't bet)
Seat 6: alexos04 folded before Flop (didn't bet)



PokerStars Hand #222957337904:  Hold'em No Limit ($0.05/$0.10 USD) - 2021/01/23 10:38:46 ET
Table 'Polydoros II' 6-max Seat #3 is the button
Seat 1: poseidoporunbot ($11.85 in chips) 
Seat 2: Lord_of_days ($11.17 in chips) 
Seat 3: marcin116 ($10 in chips) 
Seat 4: balisstica ($11.69 in chips) 
Seat 5: steinpilz1955 ($19.68 in chips) 
Seat 6: alexos04 ($14.84 in chips) 
balisstica: posts small blind $0.05
steinpilz1955: posts big blind $0.10
*** HOLE CARDS ***
alexos04: folds 
poseidoporunbot: folds 
Lord_of_days: raises $0.20 to $0.30
marcin116: folds 
balisstica: folds 
steinpilz1955: calls $0.20
*** FLOP *** [2h 8d 5d]
steinpilz1955: checks 
Lord_of_days: bets $0.20
steinpilz1955: calls $0.20
*** TURN *** [2h 8d 5d] [Th]
steinpilz1955: checks 
Lord_of_days: checks 
*** RIVER *** [2h 8d 5d Th] [Kd]
steinpilz1955: bets $0.70
Lord_of_days: folds 
Uncalled bet ($0.70) returned to steinpilz1955
steinpilz1955 collected $1 from pot
*** SUMMARY ***
Total pot $1.05 | Rake $0.05 
Board [2h 8d 5d Th Kd]
Seat 1: poseidoporunbot folded before Flop (didn't bet)
Seat 2: Lord_of_days folded on the River
Seat 3: marcin116 (button) folded before Flop (didn't bet)
Seat 4: balisstica (small blind) folded before Flop
Seat 5: steinpilz1955 (big blind) collected ($1)
Seat 6: alexos04 folded before Flop (didn't bet)



PokerStars Hand #222957362123:  Hold'em No Limit ($0.05/$0.10 USD) - 2021/01/23 10:39:31 ET
Table 'Polydoros II' 6-max Seat #4 is the button
Seat 1: poseidoporunbot ($11.85 in chips) 
Seat 2: Lord_of_days ($10.67 in chips) 
Seat 3: marcin116 ($10 in chips) 
Seat 4: balisstica ($11.64 in chips) 
Seat 5: steinpilz1955 ($20.18 in chips) 
Seat 6: alexos04 ($14.84 in chips) 
steinpilz1955: posts small blind $0.05
alexos04: posts big blind $0.10
*** HOLE CARDS ***
poseidoporunbot: folds 
Lord_of_days: raises $0.20 to $0.30
marcin116: folds 
balisstica: folds 
steinpilz1955: folds 
alexos04: folds 
Uncalled bet ($0.20) returned to Lord_of_days
Lord_of_days collected $0.25 from pot
Lord_of_days: doesn't show hand 
*** SUMMARY ***
Total pot $0.25 | Rake $0 
Seat 1: poseidoporunbot folded before Flop (didn't bet)
Seat 2: Lord_of_days collected ($0.25)
Seat 3: marcin116 folded before Flop (didn't bet)
Seat 4: balisstica (button) folded before Flop (didn't bet)
Seat 5: steinpilz1955 (small blind) folded before Flop
Seat 6: alexos04 (big blind) folded before Flop



PokerStars Hand #222957369566:  Hold'em No Limit ($0.05/$0.10 USD) - 2021/01/23 10:39:44 ET
Table 'Polydoros II' 6-max Seat #5 is the button
Seat 1: poseidoporunbot ($11.85 in chips) 
Seat 2: Lord_of_days ($10.82 in chips) 
Seat 3: marcin116 ($10 in chips) 
Seat 4: balisstica ($11.64 in chips) 
Seat 5: steinpilz1955 ($20.13 in chips) 
Seat 6: alexos04 ($14.74 in chips) 
alexos04: posts small blind $0.05
poseidoporunbot: posts big blind $0.10
*** HOLE CARDS ***
Lord_of_days: folds 
marcin116: folds 
balisstica: folds 
steinpilz1955: calls $0.10
alexos04: folds 
poseidoporunbot: raises $0.40 to $0.50
steinpilz1955: calls $0.40
*** FLOP *** [Qc Ad 9d]
poseidoporunbot: bets $0.25
steinpilz1955: folds 
Uncalled bet ($0.25) returned to poseidoporunbot
poseidoporunbot collected $1 from pot
*** SUMMARY ***
Total pot $1.05 | Rake $0.05 
Board [Qc Ad 9d]
Seat 1: poseidoporunbot (big blind) collected ($1)
Seat 2: Lord_of_days folded before Flop (didn't bet)
Seat 3: marcin116 folded before Flop (didn't bet)
Seat 4: balisstica folded before Flop (didn't bet)
Seat 5: steinpilz1955 (button) folded on the Flop
Seat 6: alexos04 (small blind) folded before Flop



PokerStars Hand #222957381204:  Hold'em No Limit ($0.05/$0.10 USD) - 2021/01/23 10:40:05 ET
Table 'Polydoros II' 6-max Seat #6 is the button
Seat 1: poseidoporunbot ($12.35 in chips) 
Seat 2: Lord_of_days ($10.82 in chips) 
Seat 3: marcin116 ($10 in chips) 
Seat 4: balisstica ($11.64 in chips) 
Seat 5: steinpilz1955 ($19.63 in chips) 
Seat 6: alexos04 ($14.69 in chips) 
poseidoporunbot: posts small blind $0.05
Lord_of_days: posts big blind $0.10
*** HOLE CARDS ***
marcin116: folds 
balisstica: folds 
steinpilz1955: calls $0.10
alexos04: folds 
poseidoporunbot: raises $0.40 to $0.50
Lord_of_days: folds 
steinpilz1955: calls $0.40
*** FLOP *** [6h 2c Ah]
poseidoporunbot: bets $0.26
steinpilz1955: calls $0.26
*** TURN *** [6h 2c Ah] [8s]
poseidoporunbot: checks 
steinpilz1955: bets $0.40
poseidoporunbot: folds 
Uncalled bet ($0.40) returned to steinpilz1955
steinpilz1955 collected $1.55 from pot
*** SUMMARY ***
Total pot $1.62 | Rake $0.07 
Board [6h 2c Ah 8s]
Seat 1: poseidoporunbot (small blind) folded on the Turn
Seat 2: Lord_of_days (big blind) folded before Flop
Seat 3: marcin116 folded before Flop (didn't bet)
Seat 4: balisstica folded before Flop (didn't bet)
Seat 5: steinpilz1955 collected ($1.55)
Seat 6: alexos04 (button) folded before Flop (didn't bet)



PokerStars Hand #222957408109:  Hold'em No Limit ($0.05/$0.10 USD) - 2021/01/23 10:40:54 ET
Table 'Polydoros II' 6-max Seat #1 is the button
Seat 1: poseidoporunbot ($11.59 in chips) 
Seat 2: Lord_of_days ($10.72 in chips) 
Seat 3: marcin116 ($10 in chips) 
Seat 4: balisstica ($11.64 in chips) 
Seat 5: steinpilz1955 ($20.42 in chips) 
Seat 6: alexos04 ($14.69 in chips) 
Lord_of_days: posts small blind $0.05
marcin116: posts big blind $0.10
*** HOLE CARDS ***
balisstica: folds 
steinpilz1955: folds 
alexos04: folds 
poseidoporunbot: folds 
Lord_of_days: raises $0.20 to $0.30
marcin116: folds 
Uncalled bet ($0.20) returned to Lord_of_days
Lord_of_days collected $0.20 from pot
Lord_of_days: doesn't show hand 
*** SUMMARY ***
Total pot $0.20 | Rake $0 
Seat 1: poseidoporunbot (button) folded before Flop (didn't bet)
Seat 2: Lord_of_days (small blind) collected ($0.20)
Seat 3: marcin116 (big blind) folded before Flop
Seat 4: balisstica folded before Flop (didn't bet)
Seat 5: steinpilz1955 folded before Flop (didn't bet)
Seat 6: alexos04 folded before Flop (didn't bet)



PokerStars Hand #222957419294:  Hold'em No Limit ($0.05/$0.10 USD) - 2021/01/23 10:41:14 ET
Table 'Polydoros II' 6-max Seat #2 is the button
Seat 1: poseidoporunbot ($11.59 in chips) 
Seat 2: Lord_of_days ($10.82 in chips) 
Seat 3: marcin116 ($10 in chips) 
Seat 4: balisstica ($11.64 in chips) 
Seat 5: steinpilz1955 ($20.42 in chips) 
Seat 6: alexos04 ($14.69 in chips) 
marcin116: posts small blind $0.05
balisstica: posts big blind $0.10
*** HOLE CARDS ***
steinpilz1955: calls $0.10
alexos04: folds 
poseidoporunbot: folds 
Lord_of_days: raises $0.30 to $0.40
marcin116: folds 
balisstica: folds 
steinpilz1955: calls $0.30
*** FLOP *** [Ts Kc 5s]
steinpilz1955: checks 
Lord_of_days: bets $0.30
steinpilz1955: calls $0.30
*** TURN *** [Ts Kc 5s] [Ac]
steinpilz1955: checks 
Lord_of_days: bets $0.80
steinpilz1955: calls $0.80
*** RIVER *** [Ts Kc 5s Ac] [6d]
steinpilz1955: checks 
Lord_of_days: bets $0.99
steinpilz1955: folds 
Uncalled bet ($0.99) returned to Lord_of_days
Lord_of_days collected $3.01 from pot
Lord_of_days: doesn't show hand 
*** SUMMARY ***
Total pot $3.15 | Rake $0.14 
Board [Ts Kc 5s Ac 6d]
Seat 1: poseidoporunbot folded before Flop (didn't bet)
Seat 2: Lord_of_days (button) collected ($3.01)
Seat 3: marcin116 (small blind) folded before Flop
Seat 4: balisstica (big blind) folded before Flop
Seat 5: steinpilz1955 folded on the River
Seat 6: alexos04 folded before Flop (didn't bet)



PokerStars Hand #222955707241:  Hold'em No Limit ($0.05/$0.10 USD) - 2021/01/23 9:46:48 ET
Table 'Polydoros II' 6-max Seat #6 is the button
Seat 1: todd bonzales ($10.52 in chips) 
Seat 2: Lord_of_days ($14.27 in chips) 
Seat 3: hornetsvp ($10 in chips) 
Seat 4: Maagic011 ($5.01 in chips) 
Seat 5: Poker_Axeman ($10.15 in chips) 
Seat 6: alexos04 ($10.41 in chips) 
todd bonzales: posts small blind $0.05
Lord_of_days: posts big blind $0.10
Maagic011: posts big blind $0.10
*** HOLE CARDS ***
hornetsvp: folds 
hornetsvp leaves the table
Maagic011: checks 
Burlica2013 joins the table at seat #3 
Poker_Axeman: raises $0.30 to $0.40
alexos04: calls $0.40
todd bonzales: folds 
Lord_of_days: folds 
Maagic011: calls $0.30
*** FLOP *** [8s 5d Qh]
Maagic011: checks 
Poker_Axeman: bets $0.65
alexos04: folds 
Maagic011: folds 
Uncalled bet ($0.65) returned to Poker_Axeman
Poker_Axeman collected $1.29 from pot
Poker_Axeman: doesn't show hand 
*** SUMMARY ***
Total pot $1.35 | Rake $0.06 
Board [8s 5d Qh]
Seat 1: todd bonzales (small blind) folded before Flop
Seat 2: Lord_of_days (big blind) folded before Flop
Seat 3: hornetsvp folded before Flop (didn't bet)
Seat 4: Maagic011 folded on the Flop
Seat 5: Poker_Axeman collected ($1.29)
Seat 6: alexos04 (button) folded on the Flop



PokerStars Hand #222956115222:  Hold'em No Limit ($0.05/$0.10 USD) - 2021/01/23 10:01:05 ET
Table 'Polydoros II' 6-max Seat #4 is the button
Seat 1: todd bonzales ($13.52 in chips) 
Seat 2: Lord_of_days ($13.63 in chips) 
Seat 3: zaharoff74 ($10 in chips) 
Seat 4: balisstica ($10.31 in chips) 
Seat 5: legendasheff ($10 in chips) 
Seat 6: alexos04 ($11.16 in chips) 
legendasheff: posts small blind $0.05
alexos04: posts big blind $0.10
*** HOLE CARDS ***
todd bonzales: calls $0.10
Lord_of_days: folds 
zaharoff74: folds 
balisstica: raises $0.40 to $0.50
legendasheff: folds 
alexos04: folds 
todd bonzales: folds 
Uncalled bet ($0.40) returned to balisstica
balisstica collected $0.35 from pot
balisstica: doesn't show hand 
*** SUMMARY ***
Total pot $0.35 | Rake $0 
Seat 1: todd bonzales folded before Flop
Seat 2: Lord_of_days folded before Flop (didn't bet)
Seat 3: zaharoff74 folded before Flop (didn't bet)
Seat 4: balisstica (button) collected ($0.35)
Seat 5: legendasheff (small blind) folded before Flop
Seat 6: alexos04 (big blind) folded before Flop



PokerStars Hand #222956127288:  Hold'em No Limit ($0.05/$0.10 USD) - 2021/01/23 10:01:31 ET
Table 'Polydoros II' 6-max Seat #5 is the button
Seat 1: todd bonzales ($13.42 in chips) 
Seat 2: Lord_of_days ($13.63 in chips) 
Seat 3: zaharoff74 ($10 in chips) 
Seat 4: balisstica ($10.56 in chips) 
Seat 5: legendasheff ($10 in chips) 
Seat 6: alexos04 ($11.06 in chips) 
alexos04: posts small blind $0.05
todd bonzales: posts big blind $0.10
*** HOLE CARDS ***
Lord_of_days: folds 
zaharoff74: folds 
balisstica: raises $0.20 to $0.30
legendasheff: folds 
alexos04: folds 
todd bonzales: folds 
Uncalled bet ($0.20) returned to balisstica
balisstica collected $0.25 from pot
balisstica: doesn't show hand 
*** SUMMARY ***
Total pot $0.25 | Rake $0 
Seat 1: todd bonzales (big blind) folded before Flop
Seat 2: Lord_of_days folded before Flop (didn't bet)
Seat 3: zaharoff74 folded before Flop (didn't bet)
Seat 4: balisstica collected ($0.25)
Seat 5: legendasheff (button) folded before Flop (didn't bet)
Seat 6: alexos04 (small blind) folded before Flop



PokerStars Hand #222956136897:  Hold'em No Limit ($0.05/$0.10 USD) - 2021/01/23 10:01:50 ET
Table 'Polydoros II' 6-max Seat #6 is the button
Seat 1: todd bonzales ($13.32 in chips) 
Seat 2: Lord_of_days ($13.63 in chips) 
Seat 3: zaharoff74 ($10 in chips) 
Seat 4: balisstica ($10.71 in chips) 
Seat 5: legendasheff ($10 in chips) 
Seat 6: alexos04 ($11.01 in chips) 
todd bonzales: posts small blind $0.05
Lord_of_days: posts big blind $0.10
*** HOLE CARDS ***
zaharoff74: folds 
balisstica: folds 
legendasheff: folds 
alexos04: folds 
todd bonzales: calls $0.05
Lord_of_days: checks 
*** FLOP *** [4c Kh 4d]
todd bonzales: checks 
Lord_of_days: checks 
*** TURN *** [4c Kh 4d] [Ac]
todd bonzales: checks 
Lord_of_days: checks 
*** RIVER *** [4c Kh 4d Ac] [Td]
todd bonzales: bets $0.19
Lord_of_days: folds 
Uncalled bet ($0.19) returned to todd bonzales
todd bonzales collected $0.19 from pot
todd bonzales: doesn't show hand 
*** SUMMARY ***
Total pot $0.20 | Rake $0.01 
Board [4c Kh 4d Ac Td]
Seat 1: todd bonzales (small blind) collected ($0.19)
Seat 2: Lord_of_days (big blind) folded on the River
Seat 3: zaharoff74 folded before Flop (didn't bet)
Seat 4: balisstica folded before Flop (didn't bet)
Seat 5: legendasheff folded before Flop (didn't bet)
Seat 6: alexos04 (button) folded before Flop (didn't bet)



PokerStars Hand #222956153221:  Hold'em No Limit ($0.05/$0.10 USD) - 2021/01/23 10:02:23 ET
Table 'Polydoros II' 6-max Seat #1 is the button
Seat 1: todd bonzales ($13.41 in chips) 
Seat 2: Lord_of_days ($13.53 in chips) 
Seat 3: zaharoff74 ($10 in chips) 
Seat 4: balisstica ($10.71 in chips) 
Seat 5: legendasheff ($10 in chips) 
Seat 6: alexos04 ($11.01 in chips) 
Lord_of_days: posts small blind $0.05
zaharoff74: posts big blind $0.10
*** HOLE CARDS ***
balisstica: folds 
legendasheff: folds 
alexos04: folds 
todd bonzales: folds 
Lord_of_days: folds 
Uncalled bet ($0.05) returned to zaharoff74
zaharoff74 collected $0.10 from pot
zaharoff74: doesn't show hand 
*** SUMMARY ***
Total pot $0.10 | Rake $0 
Seat 1: todd bonzales (button) folded before Flop (didn't bet)
Seat 2: Lord_of_days (small blind) folded before Flop
Seat 3: zaharoff74 (big blind) collected ($0.10)
Seat 4: balisstica folded before Flop (didn't bet)
Seat 5: legendasheff folded before Flop (didn't bet)
Seat 6: alexos04 folded before Flop (didn't bet)



PokerStars Hand #222956161582:  Hold'em No Limit ($0.05/$0.10 USD) - 2021/01/23 10:02:39 ET
Table 'Polydoros II' 6-max Seat #2 is the button
Seat 1: todd bonzales ($13.41 in chips) 
Seat 2: Lord_of_days ($13.48 in chips) 
Seat 3: zaharoff74 ($10.05 in chips) 
Seat 4: balisstica ($10.71 in chips) 
Seat 5: legendasheff ($10 in chips) 
Seat 6: alexos04 ($11.01 in chips) 
zaharoff74: posts small blind $0.05
balisstica: posts big blind $0.10
*** HOLE CARDS ***
legendasheff: raises $0.15 to $0.25
alexos04: folds 
todd bonzales: folds 
Lord_of_days: folds 
zaharoff74: folds 
balisstica: folds 
Uncalled bet ($0.15) returned to legendasheff
legendasheff collected $0.25 from pot
legendasheff: doesn't show hand 
*** SUMMARY ***
Total pot $0.25 | Rake $0 
Seat 1: todd bonzales folded before Flop (didn't bet)
Seat 2: Lord_of_days (button) folded before Flop (didn't bet)
Seat 3: zaharoff74 (small blind) folded before Flop
Seat 4: balisstica (big blind) folded before Flop
Seat 5: legendasheff collected ($0.25)
Seat 6: alexos04 folded before Flop (didn't bet)



PokerStars Hand #222956169592:  Hold'em No Limit ($0.05/$0.10 USD) - 2021/01/23 10:02:55 ET
Table 'Polydoros II' 6-max Seat #3 is the button
Seat 1: todd bonzales ($13.41 in chips) 
Seat 2: Lord_of_days ($13.48 in chips) 
Seat 3: zaharoff74 ($10 in chips) 
Seat 4: balisstica ($10.61 in chips) 
Seat 5: legendasheff ($10.15 in chips) 
Seat 6: alexos04 ($11.01 in chips) 
balisstica: posts small blind $0.05
legendasheff: posts big blind $0.10
*** HOLE CARDS ***
alexos04: folds 
todd bonzales: calls $0.10
Lord_of_days: folds 
zaharoff74: folds 
balisstica: raises $0.40 to $0.50
legendasheff: calls $0.40
todd bonzales: folds 
*** FLOP *** [Td 4d Jh]
balisstica: checks 
legendasheff: checks 
*** TURN *** [Td 4d Jh] [8c]
balisstica: checks 
legendasheff: bets $0.84
balisstica: folds 
Uncalled bet ($0.84) returned to legendasheff
legendasheff collected $1.05 from pot
legendasheff: doesn't show hand 
*** SUMMARY ***
Total pot $1.10 | Rake $0.05 
Board [Td 4d Jh 8c]
Seat 1: todd bonzales folded before Flop
Seat 2: Lord_of_days folded before Flop (didn't bet)
Seat 3: zaharoff74 (button) folded before Flop (didn't bet)
Seat 4: balisstica (small blind) folded on the Turn
Seat 5: legendasheff (big blind) collected ($1.05)
Seat 6: alexos04 folded before Flop (didn't bet)



PokerStars Hand #222956202189:  Hold'em No Limit ($0.05/$0.10 USD) - 2021/01/23 10:03:46 ET
Table 'Polydoros II' 6-max Seat #4 is the button
Seat 1: todd bonzales ($13.31 in chips) 
Seat 2: Lord_of_days ($13.48 in chips) 
Seat 3: zaharoff74 ($10 in chips) 
Seat 4: balisstica ($10.11 in chips) 
Seat 5: legendasheff ($10.70 in chips) 
Seat 6: alexos04 ($11.01 in chips) 
legendasheff: posts small blind $0.05
alexos04: posts big blind $0.10
*** HOLE CARDS ***
todd bonzales: calls $0.10
Lord_of_days: raises $0.30 to $0.40
zaharoff74: folds 
balisstica: folds 
legendasheff: calls $0.35
alexos04: folds 
todd bonzales: calls $0.30
*** FLOP *** [8c 8d 5s]
legendasheff: checks 
todd bonzales: checks 
Lord_of_days: bets $0.41
legendasheff: folds 
todd bonzales: folds 
Uncalled bet ($0.41) returned to Lord_of_days
Lord_of_days collected $1.24 from pot
Lord_of_days: doesn't show hand 
*** SUMMARY ***
Total pot $1.30 | Rake $0.06 
Board [8c 8d 5s]
Seat 1: todd bonzales folded on the Flop
Seat 2: Lord_of_days collected ($1.24)
Seat 3: zaharoff74 folded before Flop (didn't bet)
Seat 4: balisstica (button) folded before Flop (didn't bet)
Seat 5: legendasheff (small blind) folded on the Flop
Seat 6: alexos04 (big blind) folded before Flop



PokerStars Hand #222956224815:  Hold'em No Limit ($0.05/$0.10 USD) - 2021/01/23 10:04:30 ET
Table 'Polydoros II' 6-max Seat #5 is the button
Seat 1: todd bonzales ($12.91 in chips) 
Seat 2: Lord_of_days ($14.32 in chips) 
Seat 3: zaharoff74 ($10 in chips) 
Seat 4: balisstica ($10.11 in chips) 
Seat 5: legendasheff ($10.30 in chips) 
Seat 6: alexos04 ($10.91 in chips) 
alexos04: posts small blind $0.05
todd bonzales: posts big blind $0.10
*** HOLE CARDS ***
Lord_of_days: folds 
zaharoff74: folds 
balisstica: raises $0.20 to $0.30
legendasheff: folds 
alexos04: calls $0.25
todd bonzales: folds 
*** FLOP *** [Jd 7s 6d]
alexos04: checks 
balisstica: checks 
*** TURN *** [Jd 7s 6d] [2s]
alexos04: bets $0.40
balisstica: folds 
Uncalled bet ($0.40) returned to alexos04
alexos04 collected $0.67 from pot
alexos04: doesn't show hand 
*** SUMMARY ***
Total pot $0.70 | Rake $0.03 
Board [Jd 7s 6d 2s]
Seat 1: todd bonzales (big blind) folded before Flop
Seat 2: Lord_of_days folded before Flop (didn't bet)
Seat 3: zaharoff74 folded before Flop (didn't bet)
Seat 4: balisstica folded on the Turn
Seat 5: legendasheff (button) folded before Flop (didn't bet)
Seat 6: alexos04 (small blind) collected ($0.67)



PokerStars Hand #222956241234:  Hold'em No Limit ($0.05/$0.10 USD) - 2021/01/23 10:05:01 ET
Table 'Polydoros II' 6-max Seat #6 is the button
Seat 1: todd bonzales ($12.81 in chips) 
Seat 2: Lord_of_days ($14.32 in chips) 
Seat 3: zaharoff74 ($10 in chips) 
Seat 4: balisstica ($10 in chips) 
Seat 5: legendasheff ($10.30 in chips) 
Seat 6: alexos04 ($11.28 in chips) 
todd bonzales: posts small blind $0.05
Lord_of_days: posts big blind $0.10
*** HOLE CARDS ***
zaharoff74: folds 
balisstica: folds 
legendasheff: raises $0.15 to $0.25
alexos04: raises $0.65 to $0.90
todd bonzales: raises $0.65 to $1.55
Lord_of_days: folds 
legendasheff: folds 
alexos04: calls $0.65
*** FLOP *** [Qd 7c 4s]
todd bonzales: bets $3.29
alexos04: raises $6.44 to $9.73 and is all-in
todd bonzales: folds 
Uncalled bet ($6.44) returned to alexos04
alexos04 collected $9.58 from pot
alexos04: doesn't show hand 
*** SUMMARY ***
Total pot $10.03 | Rake $0.45 
Board [Qd 7c 4s]
Seat 1: todd bonzales (small blind) folded on the Flop
Seat 2: Lord_of_days (big blind) folded before Flop
Seat 3: zaharoff74 folded before Flop (didn't bet)
Seat 4: balisstica folded before Flop (didn't bet)
Seat 5: legendasheff folded before Flop
Seat 6: alexos04 (button) collected ($9.58)



PokerStars Hand #222956276083:  Hold'em No Limit ($0.05/$0.10 USD) - 2021/01/23 10:06:08 ET
Table 'Polydoros II' 6-max Seat #1 is the button
Seat 1: todd bonzales ($7.97 in chips) 
Seat 2: Lord_of_days ($14.22 in chips) 
Seat 3: zaharoff74 ($10 in chips) 
Seat 4: balisstica ($10 in chips) 
Seat 5: legendasheff ($10.05 in chips) 
Seat 6: alexos04 ($16.02 in chips) 
Lord_of_days: posts small blind $0.05
zaharoff74: posts big blind $0.10
*** HOLE CARDS ***
balisstica: folds 
legendasheff: folds 
alexos04: raises $0.20 to $0.30
todd bonzales: folds 
Lord_of_days: folds 
zaharoff74: folds 
Uncalled bet ($0.20) returned to alexos04
alexos04 collected $0.25 from pot
alexos04: doesn't show hand 
*** SUMMARY ***
Total pot $0.25 | Rake $0 
Seat 1: todd bonzales (button) folded before Flop (didn't bet)
Seat 2: Lord_of_days (small blind) folded before Flop
Seat 3: zaharoff74 (big blind) folded before Flop
Seat 4: balisstica folded before Flop (didn't bet)
Seat 5: legendasheff folded before Flop (didn't bet)
Seat 6: alexos04 collected ($0.25)



PokerStars Hand #222956283527:  Hold'em No Limit ($0.05/$0.10 USD) - 2021/01/23 10:06:22 ET
Table 'Polydoros II' 6-max Seat #2 is the button
Seat 1: todd bonzales ($7.97 in chips) 
Seat 2: Lord_of_days ($14.17 in chips) 
Seat 3: zaharoff74 ($10 in chips) 
Seat 4: balisstica ($10 in chips) 
Seat 5: legendasheff ($10.05 in chips) 
Seat 6: alexos04 ($16.17 in chips) 
zaharoff74: posts small blind $0.05
balisstica: posts big blind $0.10
*** HOLE CARDS ***
legendasheff: folds 
alexos04: raises $0.20 to $0.30
todd bonzales: calls $0.30
Lord_of_days: folds 
zaharoff74: folds 
balisstica: folds 
*** FLOP *** [9h 7d Kd]
alexos04: bets $0.30
todd bonzales: folds 
Uncalled bet ($0.30) returned to alexos04
alexos04 collected $0.72 from pot
alexos04: doesn't show hand 
*** SUMMARY ***
Total pot $0.75 | Rake $0.03 
Board [9h 7d Kd]
Seat 1: todd bonzales folded on the Flop
Seat 2: Lord_of_days (button) folded before Flop (didn't bet)
Seat 3: zaharoff74 (small blind) folded before Flop
Seat 4: balisstica (big blind) folded before Flop
Seat 5: legendasheff folded before Flop (didn't bet)
Seat 6: alexos04 collected ($0.72)



PokerStars Hand #222956300812:  Hold'em No Limit ($0.05/$0.10 USD) - 2021/01/23 10:06:55 ET
Table 'Polydoros II' 6-max Seat #3 is the button
Seat 1: todd bonzales ($7.67 in chips) 
Seat 2: Lord_of_days ($14.17 in chips) 
Seat 3: zaharoff74 ($10 in chips) 
Seat 4: balisstica ($10 in chips) 
Seat 5: legendasheff ($10.05 in chips) 
Seat 6: alexos04 ($16.59 in chips) 
balisstica: posts small blind $0.05
legendasheff: posts big blind $0.10
*** HOLE CARDS ***
alexos04: folds 
todd bonzales: folds 
Lord_of_days: raises $0.20 to $0.30
zaharoff74: folds 
balisstica: folds 
legendasheff: raises $0.90 to $1.20
Lord_of_days: folds 
Uncalled bet ($0.90) returned to legendasheff
legendasheff collected $0.65 from pot
legendasheff: doesn't show hand 
*** SUMMARY ***
Total pot $0.65 | Rake $0 
Seat 1: todd bonzales folded before Flop (didn't bet)
Seat 2: Lord_of_days folded before Flop
Seat 3: zaharoff74 (button) folded before Flop (didn't bet)
Seat 4: balisstica (small blind) folded before Flop
Seat 5: legendasheff (big blind) collected ($0.65)
Seat 6: alexos04 folded before Flop (didn't bet)



PokerStars Hand #222956313924:  Hold'em No Limit ($0.05/$0.10 USD) - 2021/01/23 10:07:20 ET
Table 'Polydoros II' 6-max Seat #4 is the button
Seat 1: todd bonzales ($7.67 in chips) 
Seat 2: Lord_of_days ($13.87 in chips) 
Seat 3: zaharoff74 ($10 in chips) 
Seat 4: balisstica ($10 in chips) 
Seat 5: legendasheff ($10.40 in chips) 
Seat 6: alexos04 ($16.59 in chips) 
legendasheff: posts small blind $0.05
alexos04: posts big blind $0.10
*** HOLE CARDS ***
todd bonzales: folds 
Lord_of_days: folds 
zaharoff74: folds 
balisstica: folds 
legendasheff: raises $0.15 to $0.25
alexos04: folds 
Uncalled bet ($0.15) returned to legendasheff
legendasheff collected $0.20 from pot
legendasheff: doesn't show hand 
*** SUMMARY ***
Total pot $0.20 | Rake $0 
Seat 1: todd bonzales folded before Flop (didn't bet)
Seat 2: Lord_of_days folded before Flop (didn't bet)
Seat 3: zaharoff74 folded before Flop (didn't bet)
Seat 4: balisstica (button) folded before Flop (didn't bet)
Seat 5: legendasheff (small blind) collected ($0.20)
Seat 6: alexos04 (big blind) folded before Flop



PokerStars Hand #222956323091:  Hold'em No Limit ($0.05/$0.10 USD) - 2021/01/23 10:07:37 ET
Table 'Polydoros II' 6-max Seat #5 is the button
Seat 1: todd bonzales ($7.67 in chips) 
Seat 2: Lord_of_days ($13.87 in chips) 
Seat 3: zaharoff74 ($10 in chips) 
Seat 4: balisstica ($10 in chips) 
Seat 5: legendasheff ($10.50 in chips) 
Seat 6: alexos04 ($16.49 in chips) 
alexos04: posts small blind $0.05
todd bonzales: posts big blind $0.10
*** HOLE CARDS ***
Lord_of_days: folds 
zaharoff74: folds 
balisstica: raises $0.20 to $0.30
legendasheff: folds 
alexos04: raises $0.60 to $0.90
todd bonzales: folds 
balisstica: raises $1.50 to $2.40
alexos04: calls $1.50
*** FLOP *** [6h 2c 3c]
alexos04: checks 
balisstica: checks 
*** TURN *** [6h 2c 3c] [2s]
alexos04: checks 
balisstica: checks 
*** RIVER *** [6h 2c 3c 2s] [9h]
alexos04: checks 
balisstica: checks 
*** SHOW DOWN ***
alexos04: shows [Qd Qh] (two pair, Queens and Deuces)
balisstica: mucks hand 
alexos04 collected $4.68 from pot
*** SUMMARY ***
Total pot $4.90 | Rake $0.22 
Board [6h 2c 3c 2s 9h]
Seat 1: todd bonzales (big blind) folded before Flop
Seat 2: Lord_of_days folded before Flop (didn't bet)
Seat 3: zaharoff74 folded before Flop (didn't bet)
Seat 4: balisstica mucked
Seat 5: legendasheff (button) folded before Flop (didn't bet)
Seat 6: alexos04 (small blind) showed [Qd Qh] and won ($4.68) with two pair, Queens and Deuces



PokerStars Hand #222956359492:  Hold'em No Limit ($0.05/$0.10 USD) - 2021/01/23 10:08:48 ET
Table 'Polydoros II' 6-max Seat #6 is the button
Seat 1: todd bonzales ($7.57 in chips) 
Seat 2: Lord_of_days ($13.87 in chips) 
Seat 3: zaharoff74 ($10 in chips) 
Seat 4: balisstica ($10 in chips) 
Seat 5: legendasheff ($10.50 in chips) 
Seat 6: alexos04 ($18.77 in chips) 
todd bonzales: posts small blind $0.05
Lord_of_days: posts big blind $0.10
*** HOLE CARDS ***
zaharoff74: folds 
balisstica: raises $0.20 to $0.30
legendasheff: folds 
alexos04: folds 
todd bonzales: calls $0.25
Lord_of_days: folds 
*** FLOP *** [Kc 7h 9h]
todd bonzales: checks 
balisstica: bets $0.22
todd bonzales: folds 
Uncalled bet ($0.22) returned to balisstica
balisstica collected $0.67 from pot
balisstica: doesn't show hand 
*** SUMMARY ***
Total pot $0.70 | Rake $0.03 
Board [Kc 7h 9h]
Seat 1: todd bonzales (small blind) folded on the Flop
Seat 2: Lord_of_days (big blind) folded before Flop
Seat 3: zaharoff74 folded before Flop (didn't bet)
Seat 4: balisstica collected ($0.67)
Seat 5: legendasheff folded before Flop (didn't bet)
Seat 6: alexos04 (button) folded before Flop (didn't bet)



PokerStars Hand #222956376333:  Hold'em No Limit ($0.05/$0.10 USD) - 2021/01/23 10:09:20 ET
Table 'Polydoros II' 6-max Seat #1 is the button
Seat 1: todd bonzales ($7.27 in chips) 
Seat 2: Lord_of_days ($13.77 in chips) 
Seat 3: zaharoff74 ($10 in chips) 
Seat 4: balisstica ($10.37 in chips) 
Seat 5: legendasheff ($10.50 in chips) 
Seat 6: alexos04 ($18.77 in chips) 
Lord_of_days: posts small blind $0.05
zaharoff74: posts big blind $0.10
*** HOLE CARDS ***
balisstica: folds 
legendasheff: raises $0.15 to $0.25
alexos04: folds 
todd bonzales: folds 
Lord_of_days: folds 
zaharoff74: calls $0.15
*** FLOP *** [Qh 6d 9d]
zaharoff74: checks 
legendasheff: checks 
*** TURN *** [Qh 6d 9d] [3h]
zaharoff74: checks 
legendasheff: checks 
*** RIVER *** [Qh 6d 9d 3h] [7c]
zaharoff74: checks 
legendasheff: checks 
*** SHOW DOWN ***
zaharoff74: shows [8d 8c] (a pair of Eights)
legendasheff: mucks hand 
zaharoff74 collected $0.53 from pot
*** SUMMARY ***
Total pot $0.55 | Rake $0.02 
Board [Qh 6d 9d 3h 7c]
Seat 1: todd bonzales (button) folded before Flop (didn't bet)
Seat 2: Lord_of_days (small blind) folded before Flop
Seat 3: zaharoff74 (big blind) showed [8d 8c] and won ($0.53) with a pair of Eights
Seat 4: balisstica folded before Flop (didn't bet)
Seat 5: legendasheff mucked
Seat 6: alexos04 folded before Flop (didn't bet)



PokerStars Hand #222956397175:  Hold'em No Limit ($0.05/$0.10 USD) - 2021/01/23 10:10:00 ET
Table 'Polydoros II' 6-max Seat #2 is the button
Seat 1: todd bonzales ($7.27 in chips) 
Seat 2: Lord_of_days ($13.72 in chips) 
Seat 3: zaharoff74 ($10.28 in chips) 
Seat 4: balisstica ($10.37 in chips) 
Seat 5: legendasheff ($10.25 in chips) 
Seat 6: alexos04 ($18.77 in chips) 
zaharoff74: posts small blind $0.05
balisstica: posts big blind $0.10
*** HOLE CARDS ***
legendasheff: folds 
alexos04: folds 
todd bonzales: raises $0.10 to $0.20
Lord_of_days: folds 
zaharoff74: folds 
balisstica: raises $0.40 to $0.60
todd bonzales: calls $0.40
*** FLOP *** [9s 9h Jc]
balisstica: bets $0.39
todd bonzales: raises $6.28 to $6.67 and is all-in
balisstica: folds 
Uncalled bet ($6.28) returned to todd bonzales
todd bonzales collected $1.94 from pot
todd bonzales: doesn't show hand 
*** SUMMARY ***
Total pot $2.03 | Rake $0.09 
Board [9s 9h Jc]
Seat 1: todd bonzales collected ($1.94)
Seat 2: Lord_of_days (button) folded before Flop (didn't bet)
Seat 3: zaharoff74 (small blind) folded before Flop
Seat 4: balisstica (big blind) folded on the Flop
Seat 5: legendasheff folded before Flop (didn't bet)
Seat 6: alexos04 folded before Flop (didn't bet)



PokerStars Hand #222956412592:  Hold'em No Limit ($0.05/$0.10 USD) - 2021/01/23 10:10:29 ET
Table 'Polydoros II' 6-max Seat #3 is the button
Seat 1: todd bonzales ($8.22 in chips) 
Seat 2: Lord_of_days ($13.72 in chips) 
Seat 3: zaharoff74 ($10.23 in chips) 
Seat 4: balisstica ($10 in chips) 
Seat 5: legendasheff ($10.25 in chips) 
Seat 6: alexos04 ($18.77 in chips) 
balisstica: posts small blind $0.05
legendasheff: posts big blind $0.10
*** HOLE CARDS ***
alexos04: folds 
todd bonzales: folds 
Lord_of_days: folds 
zaharoff74: folds 
balisstica: raises $0.20 to $0.30
legendasheff: folds 
Uncalled bet ($0.20) returned to balisstica
balisstica collected $0.20 from pot
balisstica: doesn't show hand 
*** SUMMARY ***
Total pot $0.20 | Rake $0 
Seat 1: todd bonzales folded before Flop (didn't bet)
Seat 2: Lord_of_days folded before Flop (didn't bet)
Seat 3: zaharoff74 (button) folded before Flop (didn't bet)
Seat 4: balisstica (small blind) collected ($0.20)
Seat 5: legendasheff (big blind) folded before Flop
Seat 6: alexos04 folded before Flop (didn't bet)



PokerStars Hand #222956420098:  Hold'em No Limit ($0.05/$0.10 USD) - 2021/01/23 10:10:43 ET
Table 'Polydoros II' 6-max Seat #4 is the button
Seat 1: todd bonzales ($8.22 in chips) 
Seat 2: Lord_of_days ($13.72 in chips) 
Seat 3: zaharoff74 ($10.23 in chips) 
Seat 4: balisstica ($10.10 in chips) 
Seat 5: legendasheff ($10.15 in chips) 
Seat 6: alexos04 ($18.77 in chips) 
legendasheff: posts small blind $0.05
alexos04: posts big blind $0.10
*** HOLE CARDS ***
todd bonzales: folds 
Lord_of_days: folds 
zaharoff74: folds 
balisstica: raises $0.15 to $0.25
legendasheff: calls $0.20
alexos04: raises $1.25 to $1.50
balisstica: folds 
legendasheff: folds 
Uncalled bet ($1.25) returned to alexos04
alexos04 collected $0.75 from pot
alexos04: doesn't show hand 
*** SUMMARY ***
Total pot $0.75 | Rake $0 
Seat 1: todd bonzales folded before Flop (didn't bet)
Seat 2: Lord_of_days folded before Flop (didn't bet)
Seat 3: zaharoff74 folded before Flop (didn't bet)
Seat 4: balisstica (button) folded before Flop
Seat 5: legendasheff (small blind) folded before Flop
Seat 6: alexos04 (big blind) collected ($0.75)



PokerStars Hand #222956438313:  Hold'em No Limit ($0.05/$0.10 USD) - 2021/01/23 10:11:18 ET
Table 'Polydoros II' 6-max Seat #5 is the button
Seat 1: todd bonzales ($8.22 in chips) 
Seat 2: Lord_of_days ($13.72 in chips) 
Seat 3: zaharoff74 ($10.23 in chips) 
Seat 4: balisstica ($10 in chips) 
Seat 5: legendasheff ($10 in chips) 
Seat 6: alexos04 ($19.27 in chips) 
alexos04: posts small blind $0.05
todd bonzales: posts big blind $0.10
*** HOLE CARDS ***
Lord_of_days: folds 
zaharoff74: raises $0.20 to $0.30
balisstica: folds 
legendasheff: folds 
alexos04: folds 
todd bonzales: folds 
Uncalled bet ($0.20) returned to zaharoff74
zaharoff74 collected $0.25 from pot
zaharoff74: doesn't show hand 
*** SUMMARY ***
Total pot $0.25 | Rake $0 
Seat 1: todd bonzales (big blind) folded before Flop
Seat 2: Lord_of_days folded before Flop (didn't bet)
Seat 3: zaharoff74 collected ($0.25)
Seat 4: balisstica folded before Flop (didn't bet)
Seat 5: legendasheff (button) folded before Flop (didn't bet)
Seat 6: alexos04 (small blind) folded before Flop



PokerStars Hand #222956447993:  Hold'em No Limit ($0.05/$0.10 USD) - 2021/01/23 10:11:36 ET
Table 'Polydoros II' 6-max Seat #6 is the button
Seat 1: todd bonzales ($8.12 in chips) 
Seat 2: Lord_of_days ($13.72 in chips) 
Seat 3: zaharoff74 ($10.38 in chips) 
Seat 4: balisstica ($10 in chips) 
Seat 5: legendasheff ($10 in chips) 
Seat 6: alexos04 ($19.22 in chips) 
todd bonzales: posts small blind $0.05
Lord_of_days: posts big blind $0.10
*** HOLE CARDS ***
zaharoff74: raises $0.20 to $0.30
balisstica: folds 
legendasheff: folds 
alexos04: folds 
todd bonzales: folds 
Lord_of_days: folds 
Uncalled bet ($0.20) returned to zaharoff74
zaharoff74 collected $0.25 from pot
zaharoff74: doesn't show hand 
*** SUMMARY ***
Total pot $0.25 | Rake $0 
Seat 1: todd bonzales (small blind) folded before Flop
Seat 2: Lord_of_days (big blind) folded before Flop
Seat 3: zaharoff74 collected ($0.25)
Seat 4: balisstica folded before Flop (didn't bet)
Seat 5: legendasheff folded before Flop (didn't bet)
Seat 6: alexos04 (button) folded before Flop (didn't bet)



PokerStars Hand #222956452636:  Hold'em No Limit ($0.05/$0.10 USD) - 2021/01/23 10:11:45 ET
Table 'Polydoros II' 6-max Seat #1 is the button
Seat 1: todd bonzales ($8.07 in chips) 
Seat 2: Lord_of_days ($13.62 in chips) 
Seat 3: zaharoff74 ($10.53 in chips) 
Seat 4: balisstica ($10 in chips) 
Seat 5: legendasheff ($10 in chips) 
Seat 6: alexos04 ($19.22 in chips) 
Lord_of_days: posts small blind $0.05
zaharoff74: posts big blind $0.10
*** HOLE CARDS ***
balisstica: raises $0.20 to $0.30
legendasheff: folds 
alexos04: folds 
todd bonzales: folds 
Lord_of_days: folds 
zaharoff74: folds 
Uncalled bet ($0.20) returned to balisstica
balisstica collected $0.25 from pot
balisstica: doesn't show hand 
*** SUMMARY ***
Total pot $0.25 | Rake $0 
Seat 1: todd bonzales (button) folded before Flop (didn't bet)
Seat 2: Lord_of_days (small blind) folded before Flop
Seat 3: zaharoff74 (big blind) folded before Flop
Seat 4: balisstica collected ($0.25)
Seat 5: legendasheff folded before Flop (didn't bet)
Seat 6: alexos04 folded before Flop (didn't bet)



PokerStars Hand #222956459704:  Hold'em No Limit ($0.05/$0.10 USD) - 2021/01/23 10:11:58 ET
Table 'Polydoros II' 6-max Seat #2 is the button
Seat 1: todd bonzales ($8.07 in chips) 
Seat 2: Lord_of_days ($13.57 in chips) 
Seat 3: zaharoff74 ($10.43 in chips) 
Seat 4: balisstica ($10.15 in chips) 
Seat 5: legendasheff ($10 in chips) 
Seat 6: alexos04 ($19.22 in chips) 
zaharoff74: posts small blind $0.05
balisstica: posts big blind $0.10
*** HOLE CARDS ***
legendasheff: raises $0.15 to $0.25
alexos04: folds 
todd bonzales: folds 
Lord_of_days: folds 
zaharoff74: folds 
balisstica: folds 
Uncalled bet ($0.15) returned to legendasheff
legendasheff collected $0.25 from pot
legendasheff: doesn't show hand 
*** SUMMARY ***
Total pot $0.25 | Rake $0 
Seat 1: todd bonzales folded before Flop (didn't bet)
Seat 2: Lord_of_days (button) folded before Flop (didn't bet)
Seat 3: zaharoff74 (small blind) folded before Flop
Seat 4: balisstica (big blind) folded before Flop
Seat 5: legendasheff collected ($0.25)
Seat 6: alexos04 folded before Flop (didn't bet)



PokerStars Hand #222956472603:  Hold'em No Limit ($0.05/$0.10 USD) - 2021/01/23 10:12:23 ET
Table 'Polydoros II' 6-max Seat #3 is the button
Seat 1: todd bonzales ($8.07 in chips) 
Seat 2: Lord_of_days ($13.57 in chips) 
Seat 3: zaharoff74 ($10.38 in chips) 
Seat 4: balisstica ($10.05 in chips) 
Seat 5: legendasheff ($10.15 in chips) 
Seat 6: alexos04 ($19.22 in chips) 
balisstica: posts small blind $0.05
legendasheff: posts big blind $0.10
*** HOLE CARDS ***
alexos04: raises $0.20 to $0.30
todd bonzales: calls $0.30
Lord_of_days: folds 
zaharoff74: folds 
balisstica: folds 
legendasheff: folds 
*** FLOP *** [2c 7c Ah]
alexos04: bets $0.40
todd bonzales: folds 
Uncalled bet ($0.40) returned to alexos04
alexos04 collected $0.72 from pot
alexos04: doesn't show hand 
*** SUMMARY ***
Total pot $0.75 | Rake $0.03 
Board [2c 7c Ah]
Seat 1: todd bonzales folded on the Flop
Seat 2: Lord_of_days folded before Flop (didn't bet)
Seat 3: zaharoff74 (button) folded before Flop (didn't bet)
Seat 4: balisstica (small blind) folded before Flop
Seat 5: legendasheff (big blind) folded before Flop
Seat 6: alexos04 collected ($0.72)



PokerStars Hand #222956492154:  Hold'em No Limit ($0.05/$0.10 USD) - 2021/01/23 10:12:59 ET
Table 'Polydoros II' 6-max Seat #4 is the button
Seat 1: todd bonzales ($7.77 in chips) 
Seat 2: Lord_of_days ($13.57 in chips) 
Seat 3: zaharoff74 ($10.38 in chips) 
Seat 4: balisstica ($10 in chips) 
Seat 5: legendasheff ($10.05 in chips) 
Seat 6: alexos04 ($19.64 in chips) 
legendasheff: posts small blind $0.05
alexos04: posts big blind $0.10
*** HOLE CARDS ***
todd bonzales: folds 
Lord_of_days: folds 
zaharoff74: folds 
balisstica: folds 
legendasheff: folds 
Uncalled bet ($0.05) returned to alexos04
alexos04 collected $0.10 from pot
alexos04: doesn't show hand 
*** SUMMARY ***
Total pot $0.10 | Rake $0 
Seat 1: todd bonzales folded before Flop (didn't bet)
Seat 2: Lord_of_days folded before Flop (didn't bet)
Seat 3: zaharoff74 folded before Flop (didn't bet)
Seat 4: balisstica (button) folded before Flop (didn't bet)
Seat 5: legendasheff (small blind) folded before Flop
Seat 6: alexos04 (big blind) collected ($0.10)



PokerStars Hand #222956498026:  Hold'em No Limit ($0.05/$0.10 USD) - 2021/01/23 10:13:10 ET
Table 'Polydoros II' 6-max Seat #5 is the button
Seat 1: todd bonzales ($7.77 in chips) 
Seat 2: Lord_of_days ($13.57 in chips) 
Seat 3: zaharoff74 ($10.38 in chips) 
Seat 4: balisstica ($10 in chips) 
Seat 5: legendasheff ($10 in chips) 
Seat 6: alexos04 ($19.69 in chips) 
alexos04: posts small blind $0.05
todd bonzales: posts big blind $0.10
*** HOLE CARDS ***
Lord_of_days: folds 
zaharoff74: folds 
balisstica: folds 
legendasheff: folds 
alexos04: folds 
Uncalled bet ($0.05) returned to todd bonzales
todd bonzales collected $0.10 from pot
todd bonzales: doesn't show hand 
*** SUMMARY ***
Total pot $0.10 | Rake $0 
Seat 1: todd bonzales (big blind) collected ($0.10)
Seat 2: Lord_of_days folded before Flop (didn't bet)
Seat 3: zaharoff74 folded before Flop (didn't bet)
Seat 4: balisstica folded before Flop (didn't bet)
Seat 5: legendasheff (button) folded before Flop (didn't bet)
Seat 6: alexos04 (small blind) folded before Flop



PokerStars Hand #222956505193:  Hold'em No Limit ($0.05/$0.10 USD) - 2021/01/23 10:13:24 ET
Table 'Polydoros II' 6-max Seat #6 is the button
Seat 1: todd bonzales ($7.82 in chips) 
Seat 2: Lord_of_days ($13.57 in chips) 
Seat 3: zaharoff74 ($10.38 in chips) 
Seat 4: balisstica ($10 in chips) 
Seat 5: legendasheff ($10 in chips) 
Seat 6: alexos04 ($19.64 in chips) 
todd bonzales: posts small blind $0.05
Lord_of_days: posts big blind $0.10
*** HOLE CARDS ***
zaharoff74: folds 
balisstica: raises $0.20 to $0.30
legendasheff: folds 
alexos04: folds 
todd bonzales: raises $7.52 to $7.82 and is all-in
Lord_of_days: folds 
balisstica: folds 
Uncalled bet ($7.52) returned to todd bonzales
todd bonzales collected $0.70 from pot
todd bonzales: doesn't show hand 
*** SUMMARY ***
Total pot $0.70 | Rake $0 
Seat 1: todd bonzales (small blind) collected ($0.70)
Seat 2: Lord_of_days (big blind) folded before Flop
Seat 3: zaharoff74 folded before Flop (didn't bet)
Seat 4: balisstica folded before Flop
Seat 5: legendasheff folded before Flop (didn't bet)
Seat 6: alexos04 (button) folded before Flop (didn't bet)



PokerStars Hand #222956517225:  Hold'em No Limit ($0.05/$0.10 USD) - 2021/01/23 10:13:46 ET
Table 'Polydoros II' 6-max Seat #1 is the button
Seat 1: todd bonzales ($8.22 in chips) 
Seat 2: Lord_of_days ($13.47 in chips) 
Seat 3: zaharoff74 ($10.38 in chips) 
Seat 4: balisstica ($10 in chips) 
Seat 5: legendasheff ($10 in chips) 
Seat 6: alexos04 ($19.64 in chips) 
Lord_of_days: posts small blind $0.05
zaharoff74: posts big blind $0.10
*** HOLE CARDS ***
balisstica: raises $0.20 to $0.30
legendasheff: folds 
alexos04: folds 
todd bonzales: folds 
Lord_of_days: folds 
zaharoff74: calls $0.20
*** FLOP *** [As 3h 9c]
zaharoff74: checks 
balisstica: bets $0.20
zaharoff74: folds 
Uncalled bet ($0.20) returned to balisstica
balisstica collected $0.62 from pot
balisstica: doesn't show hand 
*** SUMMARY ***
Total pot $0.65 | Rake $0.03 
Board [As 3h 9c]
Seat 1: todd bonzales (button) folded before Flop (didn't bet)
Seat 2: Lord_of_days (small blind) folded before Flop
Seat 3: zaharoff74 (big blind) folded on the Flop
Seat 4: balisstica collected ($0.62)
Seat 5: legendasheff folded before Flop (didn't bet)
Seat 6: alexos04 folded before Flop (didn't bet)



PokerStars Hand #222956529674:  Hold'em No Limit ($0.05/$0.10 USD) - 2021/01/23 10:14:10 ET
Table 'Polydoros II' 6-max Seat #2 is the button
Seat 1: todd bonzales ($8.22 in chips) 
Seat 2: Lord_of_days ($13.42 in chips) 
Seat 3: zaharoff74 ($10.08 in chips) 
Seat 4: balisstica ($10.32 in chips) 
Seat 5: legendasheff ($10 in chips) 
Seat 6: alexos04 ($19.64 in chips) 
zaharoff74: posts small blind $0.05
balisstica: posts big blind $0.10
*** HOLE CARDS ***
legendasheff: folds 
alexos04: folds 
todd bonzales: folds 
Lord_of_days: raises $0.20 to $0.30
zaharoff74: folds 
balisstica: folds 
Uncalled bet ($0.20) returned to Lord_of_days
Lord_of_days collected $0.25 from pot
Lord_of_days: doesn't show hand 
*** SUMMARY ***
Total pot $0.25 | Rake $0 
Seat 1: todd bonzales folded before Flop (didn't bet)
Seat 2: Lord_of_days (button) collected ($0.25)
Seat 3: zaharoff74 (small blind) folded before Flop
Seat 4: balisstica (big blind) folded before Flop
Seat 5: legendasheff folded before Flop (didn't bet)
Seat 6: alexos04 folded before Flop (didn't bet)



PokerStars Hand #222956536039:  Hold'em No Limit ($0.05/$0.10 USD) - 2021/01/23 10:14:22 ET
Table 'Polydoros II' 6-max Seat #3 is the button
Seat 1: todd bonzales ($8.22 in chips) 
Seat 2: Lord_of_days ($13.57 in chips) 
Seat 3: zaharoff74 ($10.03 in chips) 
Seat 4: balisstica ($10.22 in chips) 
Seat 5: legendasheff ($10 in chips) 
Seat 6: alexos04 ($19.64 in chips) 
balisstica: posts small blind $0.05
legendasheff: posts big blind $0.10
*** HOLE CARDS ***
alexos04: folds 
todd bonzales: raises $0.60 to $0.70
Lord_of_days: folds 
zaharoff74: folds 
balisstica: folds 
legendasheff: folds 
Uncalled bet ($0.60) returned to todd bonzales
todd bonzales collected $0.25 from pot
todd bonzales: doesn't show hand 
*** SUMMARY ***
Total pot $0.25 | Rake $0 
Seat 1: todd bonzales collected ($0.25)
Seat 2: Lord_of_days folded before Flop (didn't bet)
Seat 3: zaharoff74 (button) folded before Flop (didn't bet)
Seat 4: balisstica (small blind) folded before Flop
Seat 5: legendasheff (big blind) folded before Flop
Seat 6: alexos04 folded before Flop (didn't bet)



PokerStars Hand #222955622968:  Hold'em No Limit ($0.05/$0.10 USD) - 2021/01/23 9:44:00 ET
Table 'Polydoros II' 6-max Seat #6 is the button
Seat 1: todd bonzales ($9.80 in chips) 
Seat 2: Lord_of_days ($15.09 in chips) 
Seat 6: alexos04 ($10.40 in chips) 
todd bonzales: posts small blind $0.05
Lord_of_days: posts big blind $0.10
hornetsvp: sits out 
*** HOLE CARDS ***
Poker_Axeman joins the table at seat #5 
Timsan303van joins the table at seat #4 
alexos04: folds 
todd bonzales: folds 
Uncalled bet ($0.05) returned to Lord_of_days
Lord_of_days collected $0.10 from pot
Lord_of_days: doesn't show hand 
*** SUMMARY ***
Total pot $0.10 | Rake $0 
Seat 1: todd bonzales (small blind) folded before Flop
Seat 2: Lord_of_days (big blind) collected ($0.10)
Seat 6: alexos04 (button) folded before Flop (didn't bet)



PokerStars Hand #222955625561:  Hold'em No Limit ($0.05/$0.10 USD) - 2021/01/23 9:44:06 ET
Table 'Polydoros II' 6-max Seat #1 is the button
Seat 1: todd bonzales ($9.75 in chips) 
Seat 2: Lord_of_days ($15.14 in chips) 
Seat 3: hornetsvp ($8 in chips) 
Seat 6: alexos04 ($10.40 in chips) 
Lord_of_days: posts small blind $0.05
hornetsvp: posts big blind $0.10
Timsan303van: sits out 
Poker_Axeman: sits out 
*** HOLE CARDS ***
alexos04: raises $0.20 to $0.30
todd bonzales: folds 
Lord_of_days: raises $0.80 to $1.10
hornetsvp: folds 
alexos04: calls $0.80
*** FLOP *** [Td Kh 5h]
Lord_of_days: bets $0.73
alexos04: calls $0.73
*** TURN *** [Td Kh 5h] [Qs]
Lord_of_days: checks 
alexos04: checks 
*** RIVER *** [Td Kh 5h Qs] [3s]
Lord_of_days: checks 
alexos04: checks 
*** SHOW DOWN ***
Lord_of_days: shows [9c 9s] (a pair of Nines)
alexos04: shows [Js Jd] (a pair of Jacks)
alexos04 collected $3.59 from pot
*** SUMMARY ***
Total pot $3.76 | Rake $0.17 
Board [Td Kh 5h Qs 3s]
Seat 1: todd bonzales (button) folded before Flop (didn't bet)
Seat 2: Lord_of_days (small blind) showed [9c 9s] and lost with a pair of Nines
Seat 3: hornetsvp (big blind) folded before Flop
Seat 6: alexos04 showed [Js Jd] and won ($3.59) with a pair of Jacks



PokerStars Hand #222955655143:  Hold'em No Limit ($0.05/$0.10 USD) - 2021/01/23 9:45:05 ET
Table 'Polydoros II' 6-max Seat #2 is the button
Seat 1: todd bonzales ($9.75 in chips) 
Seat 2: Lord_of_days ($13.31 in chips) 
Seat 3: hornetsvp ($7.90 in chips) 
Seat 4: Timsan303van ($9 in chips) 
Seat 6: alexos04 ($12.16 in chips) 
hornetsvp: posts small blind $0.05
Timsan303van: posts big blind $0.10
Poker_Axeman: sits out 
*** HOLE CARDS ***
alexos04: raises $0.20 to $0.30
todd bonzales: folds 
Lord_of_days: raises $0.60 to $0.90
hornetsvp: folds 
Timsan303van: folds 
alexos04: calls $0.60
*** FLOP *** [8c 4s Qh]
alexos04: checks 
Lord_of_days: bets $0.61
alexos04: folds 
Uncalled bet ($0.61) returned to Lord_of_days
Lord_of_days collected $1.86 from pot
Lord_of_days: doesn't show hand 
*** SUMMARY ***
Total pot $1.95 | Rake $0.09 
Board [8c 4s Qh]
Seat 1: todd bonzales folded before Flop (didn't bet)
Seat 2: Lord_of_days (button) collected ($1.86)
Seat 3: hornetsvp (small blind) folded before Flop
Seat 4: Timsan303van (big blind) folded before Flop
Seat 6: alexos04 folded on the Flop



PokerStars Hand #222955674225:  Hold'em No Limit ($0.05/$0.10 USD) - 2021/01/23 9:45:42 ET
Table 'Polydoros II' 6-max Seat #3 is the button
Seat 1: todd bonzales ($9.75 in chips) 
Seat 2: Lord_of_days ($14.27 in chips) 
Seat 3: hornetsvp ($7.85 in chips) 
Seat 4: Timsan303van ($8.90 in chips) 
Seat 5: Poker_Axeman ($10 in chips) 
Seat 6: alexos04 ($11.26 in chips) 
Timsan303van: posts small blind $0.05
Poker_Axeman: posts big blind $0.10
*** HOLE CARDS ***
alexos04: raises $0.20 to $0.30
todd bonzales: raises $0.50 to $0.80
Lord_of_days: folds 
hornetsvp: folds 
Timsan303van: folds 
Poker_Axeman: folds 
alexos04: calls $0.50
*** FLOP *** [4s Jh 7d]
Timsan303van leaves the table
alexos04: checks 
todd bonzales: bets $1.80
Maagic011 joins the table at seat #4 
alexos04: folds 
Uncalled bet ($1.80) returned to todd bonzales
todd bonzales collected $1.67 from pot
todd bonzales: doesn't show hand 
*** SUMMARY ***
Total pot $1.75 | Rake $0.08 
Board [4s Jh 7d]
Seat 1: todd bonzales collected ($1.67)
Seat 2: Lord_of_days folded before Flop (didn't bet)
Seat 3: hornetsvp (button) folded before Flop (didn't bet)
Seat 4: Timsan303van (small blind) folded before Flop
Seat 5: Poker_Axeman (big blind) folded before Flop
Seat 6: alexos04 folded on the Flop



PokerStars Hand #222955699954:  Hold'em No Limit ($0.05/$0.10 USD) - 2021/01/23 9:46:33 ET
Table 'Polydoros II' 6-max Seat #5 is the button
Seat 1: todd bonzales ($10.62 in chips) 
Seat 2: Lord_of_days ($14.27 in chips) 
Seat 3: hornetsvp ($10 in chips) 
Seat 5: Poker_Axeman ($10 in chips) 
Seat 6: alexos04 ($10.46 in chips) 
alexos04: posts small blind $0.05
todd bonzales: posts big blind $0.10
Maagic011: sits out 
*** HOLE CARDS ***
Lord_of_days: folds 
hornetsvp: folds 
Poker_Axeman: raises $0.20 to $0.30
alexos04: folds 
todd bonzales: folds 
Uncalled bet ($0.20) returned to Poker_Axeman
Poker_Axeman collected $0.25 from pot
Poker_Axeman: doesn't show hand 
*** SUMMARY ***
Total pot $0.25 | Rake $0 
Seat 1: todd bonzales (big blind) folded before Flop
Seat 2: Lord_of_days folded before Flop (didn't bet)
Seat 3: hornetsvp folded before Flop (didn't bet)
Seat 5: Poker_Axeman (button) collected ($0.25)
Seat 6: alexos04 (small blind) folded before Flop



PokerStars Hand #222955725600:  Hold'em No Limit ($0.05/$0.10 USD) - 2021/01/23 9:47:24 ET
Table 'Polydoros II' 6-max Seat #1 is the button
Seat 1: todd bonzales ($10.47 in chips) 
Seat 2: Lord_of_days ($14.17 in chips) 
Seat 3: Burlica2013 ($10 in chips) 
Seat 4: Maagic011 ($4.61 in chips) 
Seat 5: Poker_Axeman ($11.04 in chips) 
Seat 6: alexos04 ($10.01 in chips) 
Lord_of_days: posts small blind $0.05
Burlica2013: posts big blind $0.10
*** HOLE CARDS ***
Maagic011: raises $0.10 to $0.20
Poker_Axeman: folds 
alexos04: folds 
todd bonzales: folds 
Lord_of_days: calls $0.15
Burlica2013: folds 
*** FLOP *** [6d 6c 7s]
Lord_of_days: checks 
Maagic011: bets $0.50
Lord_of_days: folds 
Uncalled bet ($0.50) returned to Maagic011
Maagic011 collected $0.48 from pot
Maagic011: doesn't show hand 
*** SUMMARY ***
Total pot $0.50 | Rake $0.02 
Board [6d 6c 7s]
Seat 1: todd bonzales (button) folded before Flop (didn't bet)
Seat 2: Lord_of_days (small blind) folded on the Flop
Seat 3: Burlica2013 (big blind) folded before Flop
Seat 4: Maagic011 collected ($0.48)
Seat 5: Poker_Axeman folded before Flop (didn't bet)
Seat 6: alexos04 folded before Flop (didn't bet)



PokerStars Hand #222955737657:  Hold'em No Limit ($0.05/$0.10 USD) - 2021/01/23 9:47:47 ET
Table 'Polydoros II' 6-max Seat #2 is the button
Seat 1: todd bonzales ($10.47 in chips) 
Seat 2: Lord_of_days ($13.97 in chips) 
Seat 3: Burlica2013 ($10 in chips) 
Seat 4: Maagic011 ($4.89 in chips) 
Seat 5: Poker_Axeman ($11.04 in chips) 
Seat 6: alexos04 ($10.01 in chips) 
Burlica2013: posts small blind $0.05
Maagic011: posts big blind $0.10
*** HOLE CARDS ***
Poker_Axeman: folds 
alexos04: folds 
todd bonzales: raises $0.10 to $0.20
Lord_of_days: folds 
Burlica2013: raises $0.80 to $1
Maagic011: folds 
todd bonzales: folds 
Uncalled bet ($0.80) returned to Burlica2013
Burlica2013 collected $0.50 from pot
*** SUMMARY ***
Total pot $0.50 | Rake $0 
Seat 1: todd bonzales folded before Flop
Seat 2: Lord_of_days (button) folded before Flop (didn't bet)
Seat 3: Burlica2013 (small blind) collected ($0.50)
Seat 4: Maagic011 (big blind) folded before Flop
Seat 5: Poker_Axeman folded before Flop (didn't bet)
Seat 6: alexos04 folded before Flop (didn't bet)



PokerStars Hand #222955750672:  Hold'em No Limit ($0.05/$0.10 USD) - 2021/01/23 9:48:12 ET
Table 'Polydoros II' 6-max Seat #3 is the button
Seat 1: todd bonzales ($10.27 in chips) 
Seat 2: Lord_of_days ($13.97 in chips) 
Seat 3: Burlica2013 ($10.30 in chips) 
Seat 4: Maagic011 ($4.79 in chips) 
Seat 5: Poker_Axeman ($11.04 in chips) 
Seat 6: alexos04 ($10.01 in chips) 
Maagic011: posts small blind $0.05
Poker_Axeman: posts big blind $0.10
*** HOLE CARDS ***
alexos04: raises $0.20 to $0.30
todd bonzales: folds 
Lord_of_days: folds 
Burlica2013: folds 
Maagic011: folds 
Poker_Axeman: folds 
Uncalled bet ($0.20) returned to alexos04
alexos04 collected $0.25 from pot
alexos04: doesn't show hand 
*** SUMMARY ***
Total pot $0.25 | Rake $0 
Seat 1: todd bonzales folded before Flop (didn't bet)
Seat 2: Lord_of_days folded before Flop (didn't bet)
Seat 3: Burlica2013 (button) folded before Flop (didn't bet)
Seat 4: Maagic011 (small blind) folded before Flop
Seat 5: Poker_Axeman (big blind) folded before Flop
Seat 6: alexos04 collected ($0.25)



PokerStars Hand #222957739869:  Hold'em No Limit ($0.05/$0.10 USD) - 2021/01/23 10:50:52 ET
Table 'Polydoros II' 6-max Seat #6 is the button
Seat 1: poseidoporunbot ($11.69 in chips) 
Seat 2: Lord_of_days ($11.28 in chips) 
Seat 3: marcin116 ($10.31 in chips) 
Seat 4: balisstica ($12.99 in chips) 
Seat 5: steinpilz1955 ($20.56 in chips) 
Seat 6: alexos04 ($13.11 in chips) 
poseidoporunbot: posts small blind $0.05
Lord_of_days: posts big blind $0.10
*** HOLE CARDS ***
marcin116: folds 
balisstica: folds 
steinpilz1955: calls $0.10
alexos04: folds 
poseidoporunbot: folds 
Lord_of_days: raises $0.30 to $0.40
steinpilz1955: calls $0.30
*** FLOP *** [Js 8d 8h]
Lord_of_days: bets $0.27
steinpilz1955: calls $0.27
*** TURN *** [Js 8d 8h] [4d]
Lord_of_days: bets $1
steinpilz1955: raises $1 to $2
Lord_of_days: folds 
Uncalled bet ($1) returned to steinpilz1955
steinpilz1955 collected $3.24 from pot
*** SUMMARY ***
Total pot $3.39 | Rake $0.15 
Board [Js 8d 8h 4d]
Seat 1: poseidoporunbot (small blind) folded before Flop
Seat 2: Lord_of_days (big blind) folded on the Turn
Seat 3: marcin116 folded before Flop (didn't bet)
Seat 4: balisstica folded before Flop (didn't bet)
Seat 5: steinpilz1955 collected ($3.24)
Seat 6: alexos04 (button) folded before Flop (didn't bet)



PokerStars Hand #222957767732:  Hold'em No Limit ($0.05/$0.10 USD) - 2021/01/23 10:51:42 ET
Table 'Polydoros II' 6-max Seat #1 is the button
Seat 1: poseidoporunbot ($11.64 in chips) 
Seat 2: Lord_of_days ($10 in chips) 
Seat 3: marcin116 ($10.31 in chips) 
Seat 4: balisstica ($12.99 in chips) 
Seat 5: steinpilz1955 ($22.13 in chips) 
Seat 6: alexos04 ($13.11 in chips) 
Lord_of_days: posts small blind $0.05
marcin116: posts big blind $0.10
*** HOLE CARDS ***
balisstica: folds 
steinpilz1955: folds 
alexos04: folds 
poseidoporunbot: folds 
Lord_of_days: raises $0.20 to $0.30
marcin116: folds 
Uncalled bet ($0.20) returned to Lord_of_days
Lord_of_days collected $0.20 from pot
Lord_of_days: doesn't show hand 
*** SUMMARY ***
Total pot $0.20 | Rake $0 
Seat 1: poseidoporunbot (button) folded before Flop (didn't bet)
Seat 2: Lord_of_days (small blind) collected ($0.20)
Seat 3: marcin116 (big blind) folded before Flop
Seat 4: balisstica folded before Flop (didn't bet)
Seat 5: steinpilz1955 folded before Flop (didn't bet)
Seat 6: alexos04 folded before Flop (didn't bet)



PokerStars Hand #222957778831:  Hold'em No Limit ($0.05/$0.10 USD) - 2021/01/23 10:52:02 ET
Table 'Polydoros II' 6-max Seat #2 is the button
Seat 1: poseidoporunbot ($11.64 in chips) 
Seat 2: Lord_of_days ($10.10 in chips) 
Seat 3: marcin116 ($10.21 in chips) 
Seat 4: balisstica ($12.99 in chips) 
Seat 5: steinpilz1955 ($22.13 in chips) 
Seat 6: alexos04 ($13.11 in chips) 
marcin116: posts small blind $0.05
balisstica: posts big blind $0.10
*** HOLE CARDS ***
steinpilz1955: calls $0.10
alexos04: folds 
poseidoporunbot: folds 
Lord_of_days: folds 
marcin116: folds 
balisstica: checks 
*** FLOP *** [4s 3h 5h]
balisstica: checks 
steinpilz1955: checks 
*** TURN *** [4s 3h 5h] [Jd]
balisstica: checks 
steinpilz1955: bets $0.40
balisstica: folds 
Uncalled bet ($0.40) returned to steinpilz1955
steinpilz1955 collected $0.24 from pot
*** SUMMARY ***
Total pot $0.25 | Rake $0.01 
Board [4s 3h 5h Jd]
Seat 1: poseidoporunbot folded before Flop (didn't bet)
Seat 2: Lord_of_days (button) folded before Flop (didn't bet)
Seat 3: marcin116 (small blind) folded before Flop
Seat 4: balisstica (big blind) folded on the Turn
Seat 5: steinpilz1955 collected ($0.24)
Seat 6: alexos04 folded before Flop (didn't bet)



PokerStars Hand #222957810290:  Hold'em No Limit ($0.05/$0.10 USD) - 2021/01/23 10:52:59 ET
Table 'Polydoros II' 6-max Seat #3 is the button
Seat 1: poseidoporunbot ($11.64 in chips) 
Seat 2: Lord_of_days ($10.10 in chips) 
Seat 3: marcin116 ($10.16 in chips) 
Seat 4: balisstica ($12.89 in chips) 
Seat 5: steinpilz1955 ($22.27 in chips) 
Seat 6: alexos04 ($13.11 in chips) 
balisstica: posts small blind $0.05
steinpilz1955: posts big blind $0.10
*** HOLE CARDS ***
alexos04: folds 
poseidoporunbot: folds 
Lord_of_days: folds 
marcin116: raises $0.25 to $0.35
balisstica: folds 
steinpilz1955: folds 
Uncalled bet ($0.25) returned to marcin116
marcin116 collected $0.25 from pot
marcin116: doesn't show hand 
*** SUMMARY ***
Total pot $0.25 | Rake $0 
Seat 1: poseidoporunbot folded before Flop (didn't bet)
Seat 2: Lord_of_days folded before Flop (didn't bet)
Seat 3: marcin116 (button) collected ($0.25)
Seat 4: balisstica (small blind) folded before Flop
Seat 5: steinpilz1955 (big blind) folded before Flop
Seat 6: alexos04 folded before Flop (didn't bet)



PokerStars Hand #222957817947:  Hold'em No Limit ($0.05/$0.10 USD) - 2021/01/23 10:53:13 ET
Table 'Polydoros II' 6-max Seat #4 is the button
Seat 1: poseidoporunbot ($11.64 in chips) 
Seat 2: Lord_of_days ($10.10 in chips) 
Seat 3: marcin116 ($10.31 in chips) 
Seat 4: balisstica ($12.84 in chips) 
Seat 5: steinpilz1955 ($22.17 in chips) 
Seat 6: alexos04 ($13.11 in chips) 
steinpilz1955: posts small blind $0.05
alexos04: posts big blind $0.10
*** HOLE CARDS ***
poseidoporunbot: folds 
Lord_of_days: folds 
marcin116: raises $0.30 to $0.40
balisstica: folds 
steinpilz1955: calls $0.35
alexos04: calls $0.30
*** FLOP *** [4d Ks 6d]
steinpilz1955: checks 
alexos04: checks 
marcin116: bets $0.86
steinpilz1955: folds 
alexos04: folds 
Uncalled bet ($0.86) returned to marcin116
marcin116 collected $1.15 from pot
marcin116: doesn't show hand 
*** SUMMARY ***
Total pot $1.20 | Rake $0.05 
Board [4d Ks 6d]
Seat 1: poseidoporunbot folded before Flop (didn't bet)
Seat 2: Lord_of_days folded before Flop (didn't bet)
Seat 3: marcin116 collected ($1.15)
Seat 4: balisstica (button) folded before Flop (didn't bet)
Seat 5: steinpilz1955 (small blind) folded on the Flop
Seat 6: alexos04 (big blind) folded on the Flop



PokerStars Hand #222957846665:  Hold'em No Limit ($0.05/$0.10 USD) - 2021/01/23 10:54:06 ET
Table 'Polydoros II' 6-max Seat #5 is the button
Seat 1: poseidoporunbot ($11.64 in chips) 
Seat 2: Lord_of_days ($10.10 in chips) 
Seat 3: marcin116 ($11.06 in chips) 
Seat 4: balisstica ($12.84 in chips) 
Seat 5: steinpilz1955 ($21.77 in chips) 
Seat 6: alexos04 ($12.71 in chips) 
alexos04: posts small blind $0.05
poseidoporunbot: posts big blind $0.10
*** HOLE CARDS ***
Lord_of_days: folds 
marcin116: folds 
balisstica: folds 
steinpilz1955: raises $0.20 to $0.30
alexos04: calls $0.25
poseidoporunbot: raises $1.20 to $1.50
steinpilz1955: calls $1.20
alexos04: folds 
*** FLOP *** [5d Th 7h]
poseidoporunbot: checks 
steinpilz1955: bets $0.50
poseidoporunbot: calls $0.50
*** TURN *** [5d Th 7h] [8h]
poseidoporunbot: checks 
steinpilz1955: bets $0.70
poseidoporunbot: folds 
Uncalled bet ($0.70) returned to steinpilz1955
steinpilz1955 collected $4.11 from pot
*** SUMMARY ***
Total pot $4.30 | Rake $0.19 
Board [5d Th 7h 8h]
Seat 1: poseidoporunbot (big blind) folded on the Turn
Seat 2: Lord_of_days folded before Flop (didn't bet)
Seat 3: marcin116 folded before Flop (didn't bet)
Seat 4: balisstica folded before Flop (didn't bet)
Seat 5: steinpilz1955 (button) collected ($4.11)
Seat 6: alexos04 (small blind) folded before Flop



PokerStars Hand #222957879214:  Hold'em No Limit ($0.05/$0.10 USD) - 2021/01/23 10:55:05 ET
Table 'Polydoros II' 6-max Seat #6 is the button
Seat 1: poseidoporunbot ($10 in chips) 
Seat 2: Lord_of_days ($10.10 in chips) 
Seat 3: marcin116 ($11.06 in chips) 
Seat 4: balisstica ($12.84 in chips) 
Seat 5: steinpilz1955 ($23.88 in chips) 
Seat 6: alexos04 ($12.41 in chips) 
poseidoporunbot: posts small blind $0.05
Lord_of_days: posts big blind $0.10
*** HOLE CARDS ***
marcin116: folds 
balisstica: folds 
steinpilz1955: calls $0.10
alexos04: folds 
poseidoporunbot: folds 
Lord_of_days: checks 
*** FLOP *** [6d Ks 2c]
Lord_of_days: checks 
steinpilz1955: bets $0.30
Lord_of_days: calls $0.30
*** TURN *** [6d Ks 2c] [3d]
Lord_of_days: checks 
steinpilz1955: checks 
*** RIVER *** [6d Ks 2c 3d] [6s]
Lord_of_days: checks 
steinpilz1955: bets $0.30
Lord_of_days: calls $0.30
*** SHOW DOWN ***
steinpilz1955: shows [5d Ah] (a pair of Sixes)
Lord_of_days: shows [Kh 4d] (two pair, Kings and Sixes)
Lord_of_days collected $1.38 from pot
*** SUMMARY ***
Total pot $1.45 | Rake $0.07 
Board [6d Ks 2c 3d 6s]
Seat 1: poseidoporunbot (small blind) folded before Flop
Seat 2: Lord_of_days (big blind) showed [Kh 4d] and won ($1.38) with two pair, Kings and Sixes
Seat 3: marcin116 folded before Flop (didn't bet)
Seat 4: balisstica folded before Flop (didn't bet)
Seat 5: steinpilz1955 showed [5d Ah] and lost with a pair of Sixes
Seat 6: alexos04 (button) folded before Flop (didn't bet)



PokerStars Hand #222957894791:  Hold'em No Limit ($0.05/$0.10 USD) - 2021/01/23 10:55:40 ET
Table 'Polydoros II' 6-max Seat #1 is the button
Seat 1: poseidoporunbot ($10 in chips) 
Seat 2: Lord_of_days ($10.78 in chips) 
Seat 3: marcin116 ($11.06 in chips) 
Seat 4: balisstica ($12.84 in chips) 
Seat 5: steinpilz1955 ($23.18 in chips) 
Seat 6: alexos04 ($12.41 in chips) 
Lord_of_days: posts small blind $0.05
marcin116: posts big blind $0.10
*** HOLE CARDS ***
balisstica: folds 
steinpilz1955: raises $0.30 to $0.40
alexos04: folds 
poseidoporunbot: folds 
Lord_of_days: folds 
marcin116: folds 
Uncalled bet ($0.30) returned to steinpilz1955
steinpilz1955 collected $0.25 from pot
*** SUMMARY ***
Total pot $0.25 | Rake $0 
Seat 1: poseidoporunbot (button) folded before Flop (didn't bet)
Seat 2: Lord_of_days (small blind) folded before Flop
Seat 3: marcin116 (big blind) folded before Flop
Seat 4: balisstica folded before Flop (didn't bet)
Seat 5: steinpilz1955 collected ($0.25)
Seat 6: alexos04 folded before Flop (didn't bet)



PokerStars Hand #222957901809:  Hold'em No Limit ($0.05/$0.10 USD) - 2021/01/23 10:55:57 ET
Table 'Polydoros II' 6-max Seat #2 is the button
Seat 1: poseidoporunbot ($10 in chips) 
Seat 2: Lord_of_days ($10.73 in chips) 
Seat 3: marcin116 ($10.96 in chips) 
Seat 4: balisstica ($12.84 in chips) 
Seat 5: steinpilz1955 ($23.33 in chips) 
Seat 6: alexos04 ($12.41 in chips) 
marcin116: posts small blind $0.05
balisstica: posts big blind $0.10
*** HOLE CARDS ***
steinpilz1955: calls $0.10
alexos04: folds 
poseidoporunbot: folds 
Lord_of_days: folds 
marcin116: folds 
balisstica: checks 
*** FLOP *** [Qh 6c Jd]
balisstica: checks 
steinpilz1955: bets $0.50
balisstica: folds 
Uncalled bet ($0.50) returned to steinpilz1955
steinpilz1955 collected $0.24 from pot
*** SUMMARY ***
Total pot $0.25 | Rake $0.01 
Board [Qh 6c Jd]
Seat 1: poseidoporunbot folded before Flop (didn't bet)
Seat 2: Lord_of_days (button) folded before Flop (didn't bet)
Seat 3: marcin116 (small blind) folded before Flop
Seat 4: balisstica (big blind) folded on the Flop
Seat 5: steinpilz1955 collected ($0.24)
Seat 6: alexos04 folded before Flop (didn't bet)



PokerStars Hand #222957923229:  Hold'em No Limit ($0.05/$0.10 USD) - 2021/01/23 10:56:45 ET
Table 'Polydoros II' 6-max Seat #3 is the button
Seat 1: poseidoporunbot ($10 in chips) 
Seat 2: Lord_of_days ($10.73 in chips) 
Seat 3: marcin116 ($10.91 in chips) 
Seat 4: balisstica ($12.74 in chips) 
Seat 5: steinpilz1955 ($23.47 in chips) 
Seat 6: alexos04 ($12.41 in chips) 
balisstica: posts small blind $0.05
steinpilz1955: posts big blind $0.10
*** HOLE CARDS ***
alexos04: folds 
poseidoporunbot: folds 
Lord_of_days: folds 
marcin116: raises $0.25 to $0.35
balisstica: folds 
steinpilz1955: calls $0.25
*** FLOP *** [3c Js 8c]
steinpilz1955: checks 
marcin116: checks 
*** TURN *** [3c Js 8c] [2d]
steinpilz1955: bets $0.80
marcin116: folds 
Uncalled bet ($0.80) returned to steinpilz1955
steinpilz1955 collected $0.72 from pot
*** SUMMARY ***
Total pot $0.75 | Rake $0.03 
Board [3c Js 8c 2d]
Seat 1: poseidoporunbot folded before Flop (didn't bet)
Seat 2: Lord_of_days folded before Flop (didn't bet)
Seat 3: marcin116 (button) folded on the Turn
Seat 4: balisstica (small blind) folded before Flop
Seat 5: steinpilz1955 (big blind) collected ($0.72)
Seat 6: alexos04 folded before Flop (didn't bet)



PokerStars Hand #222957947723:  Hold'em No Limit ($0.05/$0.10 USD) - 2021/01/23 10:57:41 ET
Table 'Polydoros II' 6-max Seat #4 is the button
Seat 1: poseidoporunbot ($10 in chips) 
Seat 2: Lord_of_days ($10.73 in chips) 
Seat 3: marcin116 ($10.56 in chips) 
Seat 4: balisstica ($12.69 in chips) 
Seat 5: steinpilz1955 ($23.84 in chips) 
Seat 6: alexos04 ($12.41 in chips) 
steinpilz1955: posts small blind $0.05
alexos04: posts big blind $0.10
*** HOLE CARDS ***
poseidoporunbot: folds 
Lord_of_days: folds 
marcin116: folds 
balisstica: raises $0.15 to $0.25
steinpilz1955: calls $0.20
alexos04: folds 
*** FLOP *** [6s 5c 4s]
steinpilz1955: checks 
balisstica: checks 
*** TURN *** [6s 5c 4s] [As]
steinpilz1955: checks 
balisstica: checks 
*** RIVER *** [6s 5c 4s As] [9c]
steinpilz1955: checks 
balisstica: bets $0.43
steinpilz1955: calls $0.43
*** SHOW DOWN ***
balisstica: shows [Ad Ac] (three of a kind, Aces)
steinpilz1955: mucks hand 
balisstica collected $1.39 from pot
*** SUMMARY ***
Total pot $1.46 | Rake $0.07 
Board [6s 5c 4s As 9c]
Seat 1: poseidoporunbot folded before Flop (didn't bet)
Seat 2: Lord_of_days folded before Flop (didn't bet)
Seat 3: marcin116 folded before Flop (didn't bet)
Seat 4: balisstica (button) showed [Ad Ac] and won ($1.39) with three of a kind, Aces
Seat 5: steinpilz1955 (small blind) mucked
Seat 6: alexos04 (big blind) folded before Flop



PokerStars Hand #222957960084:  Hold'em No Limit ($0.05/$0.10 USD) - 2021/01/23 10:58:09 ET
Table 'Polydoros II' 6-max Seat #6 is the button
Seat 1: poseidoporunbot ($10 in chips) 
Seat 2: Lord_of_days ($10.73 in chips) 
Seat 3: marcin116 ($10.56 in chips) 
Seat 4: balisstica ($13.40 in chips) 
Seat 6: alexos04 ($12.31 in chips) 
poseidoporunbot: posts small blind $0.05
Lord_of_days: posts big blind $0.10
*** HOLE CARDS ***
marcin116: folds 
stardrakee joins the table at seat #5 
balisstica: folds 
stardrakee leaves the table
alexos04: folds 
balisstica leaves the table
poseidoporunbot: raises $0.20 to $0.30
Lord_of_days: calls $0.20
*** FLOP *** [9d 4d 3s]
poseidoporunbot: checks 
Lord_of_days: bets $0.19
poseidoporunbot: folds 
Uncalled bet ($0.19) returned to Lord_of_days
Lord_of_days collected $0.57 from pot
Lord_of_days: doesn't show hand 
*** SUMMARY ***
Total pot $0.60 | Rake $0.03 
Board [9d 4d 3s]
Seat 1: poseidoporunbot (small blind) folded on the Flop
Seat 2: Lord_of_days (big blind) collected ($0.57)
Seat 3: marcin116 folded before Flop (didn't bet)
Seat 4: balisstica folded before Flop (didn't bet)
Seat 6: alexos04 (button) folded before Flop (didn't bet)



PokerStars Hand #222957973817:  Hold'em No Limit ($0.05/$0.10 USD) - 2021/01/23 10:58:41 ET
Table 'Polydoros II' 6-max Seat #1 is the button
Seat 1: poseidoporunbot ($10 in chips) 
Seat 2: Lord_of_days ($11 in chips) 
Seat 3: marcin116 ($10.56 in chips) 
Seat 6: alexos04 ($12.31 in chips) 
Lord_of_days: posts small blind $0.05
marcin116: posts big blind $0.10
*** HOLE CARDS ***
alexos04: folds 
poseidoporunbot: raises $0.15 to $0.25
Lord_of_days: folds 
marcin116: calls $0.15
*** FLOP *** [9h Ts 8d]
marcin116: checks 
poseidoporunbot: checks 
*** TURN *** [9h Ts 8d] [Js]
marcin116: bets $0.53
poseidoporunbot: calls $0.53
*** RIVER *** [9h Ts 8d Js] [Ad]
marcin116: bets $2.85
poseidoporunbot: folds 
Uncalled bet ($2.85) returned to marcin116
marcin116 collected $1.54 from pot
marcin116: doesn't show hand 
*** SUMMARY ***
Total pot $1.61 | Rake $0.07 
Board [9h Ts 8d Js Ad]
Seat 1: poseidoporunbot (button) folded on the River
Seat 2: Lord_of_days (small blind) folded before Flop
Seat 3: marcin116 (big blind) collected ($1.54)
Seat 6: alexos04 folded before Flop (didn't bet)



PokerStars Hand #222957992913:  Hold'em No Limit ($0.05/$0.10 USD) - 2021/01/23 10:59:22 ET
Table 'Polydoros II' 6-max Seat #2 is the button
Seat 1: poseidoporunbot ($10 in chips) 
Seat 2: Lord_of_days ($10.95 in chips) 
Seat 3: marcin116 ($11.32 in chips) 
Seat 6: alexos04 ($12.31 in chips) 
marcin116: posts small blind $0.05
alexos04: posts big blind $0.10
*** HOLE CARDS ***
poseidoporunbot: folds 
Lord_of_days: folds 
marcin116: folds 
Uncalled bet ($0.05) returned to alexos04
alexos04 collected $0.10 from pot
alexos04: doesn't show hand 
*** SUMMARY ***
Total pot $0.10 | Rake $0 
Seat 1: poseidoporunbot folded before Flop (didn't bet)
Seat 2: Lord_of_days (button) folded before Flop (didn't bet)
Seat 3: marcin116 (small blind) folded before Flop
Seat 6: alexos04 (big blind) collected ($0.10)



PokerStars Hand #222957997351:  Hold'em No Limit ($0.05/$0.10 USD) - 2021/01/23 10:59:32 ET
Table 'Polydoros II' 6-max Seat #3 is the button
Seat 1: poseidoporunbot ($10 in chips) 
Seat 2: Lord_of_days ($10.95 in chips) 
Seat 3: marcin116 ($11.27 in chips) 
Seat 6: alexos04 ($12.36 in chips) 
alexos04: posts small blind $0.05
poseidoporunbot: posts big blind $0.10
*** HOLE CARDS ***
Lord_of_days: folds 
marcin116: raises $0.25 to $0.35
alexos04: folds 
poseidoporunbot: folds 
Uncalled bet ($0.25) returned to marcin116
marcin116 collected $0.25 from pot
marcin116: doesn't show hand 
*** SUMMARY ***
Total pot $0.25 | Rake $0 
Seat 1: poseidoporunbot (big blind) folded before Flop
Seat 2: Lord_of_days folded before Flop (didn't bet)
Seat 3: marcin116 (button) collected ($0.25)
Seat 6: alexos04 (small blind) folded before Flop



PokerStars Hand #222958001737:  Hold'em No Limit ($0.05/$0.10 USD) - 2021/01/23 10:59:42 ET
Table 'Polydoros II' 6-max Seat #6 is the button
Seat 1: poseidoporunbot ($10 in chips) 
Seat 2: Lord_of_days ($10.95 in chips) 
Seat 3: marcin116 ($11.42 in chips) 
Seat 6: alexos04 ($12.31 in chips) 
poseidoporunbot: posts small blind $0.05
Lord_of_days: posts big blind $0.10
*** HOLE CARDS ***
marcin116: folds 
alexos04: raises $0.20 to $0.30
poseidoporunbot: folds 
Lord_of_days: folds 
Uncalled bet ($0.20) returned to alexos04
alexos04 collected $0.25 from pot
alexos04: doesn't show hand 
*** SUMMARY ***
Total pot $0.25 | Rake $0 
Seat 1: poseidoporunbot (small blind) folded before Flop
Seat 2: Lord_of_days (big blind) folded before Flop
Seat 3: marcin116 folded before Flop (didn't bet)
Seat 6: alexos04 (button) collected ($0.25)



PokerStars Hand #222958008167:  Hold'em No Limit ($0.05/$0.10 USD) - 2021/01/23 10:59:56 ET
Table 'Polydoros II' 6-max Seat #1 is the button
Seat 1: poseidoporunbot ($10 in chips) 
Seat 2: Lord_of_days ($10.85 in chips) 
Seat 6: alexos04 ($12.46 in chips) 
Lord_of_days: posts small blind $0.05
marcin116: is sitting out 
alexos04: posts big blind $0.10
*** HOLE CARDS ***
marcin116 leaves the table
poseidoporunbot: folds 
Lord_of_days: folds 
Uncalled bet ($0.05) returned to alexos04
alexos04 collected $0.10 from pot
alexos04: doesn't show hand 
*** SUMMARY ***
Total pot $0.10 | Rake $0 
Seat 1: poseidoporunbot (button) folded before Flop (didn't bet)
Seat 2: Lord_of_days (small blind) folded before Flop
Seat 6: alexos04 (big blind) collected ($0.10)



PokerStars Hand #222958011442:  Hold'em No Limit ($0.05/$0.10 USD) - 2021/01/23 11:00:04 ET
Table 'Polydoros II' 6-max Seat #6 is the button
Seat 2: Lord_of_days ($10.80 in chips) 
Seat 6: alexos04 ($12.51 in chips) 
alexos04: posts small blind $0.05
poseidoporunbot: is sitting out 
Lord_of_days: posts big blind $0.10
*** HOLE CARDS ***
alexos04: raises $0.20 to $0.30
Lord_of_days: raises $0.80 to $1.10
poseidoporunbot leaves the table
alexos04: calls $0.80
*** FLOP *** [5d 2s 3c]
densamara_63 joins the table at seat #3 
Lord_of_days: bets $0.69
alexos04: raises $1.21 to $1.90
Lord_of_days: folds 
Uncalled bet ($1.21) returned to alexos04
alexos04 collected $3.42 from pot
alexos04: doesn't show hand 
*** SUMMARY ***
Total pot $3.58 | Rake $0.16 
Board [5d 2s 3c]
Seat 2: Lord_of_days (big blind) folded on the Flop
Seat 6: alexos04 (button) (small blind) collected ($3.42)



PokerStars Hand #222958030038:  Hold'em No Limit ($0.05/$0.10 USD) - 2021/01/23 11:00:44 ET
Table 'Polydoros II' 6-max Seat #6 is the button
Seat 2: Lord_of_days ($10 in chips) 
Seat 3: densamara_63 ($10 in chips) 
Seat 6: alexos04 ($14.14 in chips) 
Lord_of_days: posts small blind $0.05
densamara_63: posts big blind $0.10
*** HOLE CARDS ***
alexos04: folds 
Lord_of_days: folds 
Uncalled bet ($0.05) returned to densamara_63
densamara_63 collected $0.10 from pot
*** SUMMARY ***
Total pot $0.10 | Rake $0 
Seat 2: Lord_of_days (small blind) folded before Flop
Seat 3: densamara_63 (big blind) collected ($0.10)
Seat 6: alexos04 (button) folded before Flop (didn't bet)



PokerStars Hand #222958034982:  Hold'em No Limit ($0.05/$0.10 USD) - 2021/01/23 11:00:54 ET
Table 'Polydoros II' 6-max Seat #2 is the button
Seat 2: Lord_of_days ($9.95 in chips) 
Seat 3: densamara_63 ($10.05 in chips) 
Seat 6: alexos04 ($14.14 in chips) 
densamara_63: posts small blind $0.05
alexos04: posts big blind $0.10
*** HOLE CARDS ***
Lord_of_days: folds 
densamara_63: raises $0.17 to $0.27
alexos04: raises $0.63 to $0.90
densamara_63: calls $0.63
*** FLOP *** [2h Kc 4s]
densamara_63: checks 
alexos04: bets $0.70
densamara_63: folds 
Uncalled bet ($0.70) returned to alexos04
alexos04 collected $1.72 from pot
alexos04: doesn't show hand 
*** SUMMARY ***
Total pot $1.80 | Rake $0.08 
Board [2h Kc 4s]
Seat 2: Lord_of_days (button) folded before Flop (didn't bet)
Seat 3: densamara_63 (small blind) folded on the Flop
Seat 6: alexos04 (big blind) collected ($1.72)



PokerStars Hand #222958048857:  Hold'em No Limit ($0.05/$0.10 USD) - 2021/01/23 11:01:22 ET
Table 'Polydoros II' 6-max Seat #3 is the button
Seat 2: Lord_of_days ($9.95 in chips) 
Seat 3: densamara_63 ($10 in chips) 
Seat 6: alexos04 ($14.96 in chips) 
alexos04: posts small blind $0.05
Lord_of_days: posts big blind $0.10
*** HOLE CARDS ***
densamara_63: folds 
alexos04: folds 
Uncalled bet ($0.05) returned to Lord_of_days
Lord_of_days collected $0.10 from pot
Lord_of_days: doesn't show hand 
*** SUMMARY ***
Total pot $0.10 | Rake $0 
Seat 2: Lord_of_days (big blind) collected ($0.10)
Seat 3: densamara_63 (button) folded before Flop (didn't bet)
Seat 6: alexos04 (small blind) folded before Flop



PokerStars Hand #222958058301:  Hold'em No Limit ($0.05/$0.10 USD) - 2021/01/23 11:01:39 ET
Table 'Polydoros II' 6-max Seat #6 is the button
Seat 2: Lord_of_days ($10 in chips) 
Seat 3: densamara_63 ($10 in chips) 
Seat 6: alexos04 ($14.91 in chips) 
Lord_of_days: posts small blind $0.05
densamara_63: posts big blind $0.10
*** HOLE CARDS ***
alexos04: raises $0.20 to $0.30
Lord_of_days: folds 
densamara_63: folds 
Uncalled bet ($0.20) returned to alexos04
alexos04 collected $0.25 from pot
alexos04: doesn't show hand 
*** SUMMARY ***
Total pot $0.25 | Rake $0 
Seat 2: Lord_of_days (small blind) folded before Flop
Seat 3: densamara_63 (big blind) folded before Flop
Seat 6: alexos04 (button) collected ($0.25)



PokerStars Hand #222958065270:  Hold'em No Limit ($0.05/$0.10 USD) - 2021/01/23 11:01:52 ET
Table 'Polydoros II' 6-max Seat #2 is the button
Seat 2: Lord_of_days ($9.95 in chips) 
Seat 3: densamara_63 ($10 in chips) 
Seat 6: alexos04 ($15.06 in chips) 
densamara_63: posts small blind $0.05
alexos04: posts big blind $0.10
*** HOLE CARDS ***
Lord_of_days: raises $0.20 to $0.30
densamara_63: folds 
alexos04: calls $0.20
*** FLOP *** [3s 8s Qh]
Clappasaur joins the table at seat #1 
alexos04: checks 
Lord_of_days: bets $0.20
alexos04: calls $0.20
*** TURN *** [3s 8s Qh] [7s]
alexos04: checks 
Lord_of_days: checks 
*** RIVER *** [3s 8s Qh 7s] [Td]
alexos04: checks 
Lord_of_days: checks 
*** SHOW DOWN ***
alexos04: shows [Ts Kh] (a pair of Tens)
Lord_of_days: mucks hand 
alexos04 collected $1 from pot
*** SUMMARY ***
Total pot $1.05 | Rake $0.05 
Board [3s 8s Qh 7s Td]
Seat 2: Lord_of_days (button) mucked
Seat 3: densamara_63 (small blind) folded before Flop
Seat 6: alexos04 (big blind) showed [Ts Kh] and won ($1) with a pair of Tens



PokerStars Hand #222958100120:  Hold'em No Limit ($0.05/$0.10 USD) - 2021/01/23 11:02:57 ET
Table 'Polydoros II' 6-max Seat #3 is the button
Seat 1: Clappasaur ($10 in chips) 
Seat 2: Lord_of_days ($10 in chips) 
Seat 3: densamara_63 ($10 in chips) 
Seat 6: alexos04 ($15.56 in chips) 
alexos04: posts small blind $0.05
Clappasaur: posts big blind $0.10
*** HOLE CARDS ***
Lord_of_days: folds 
densamara_63: raises $0.12 to $0.22
G oet Mestreech joins the table at seat #4 
appu001 joins the table at seat #5 
alexos04: raises $0.68 to $0.90
Clappasaur: folds 
densamara_63: folds 
Uncalled bet ($0.68) returned to alexos04
alexos04 collected $0.54 from pot
alexos04: doesn't show hand 
*** SUMMARY ***
Total pot $0.54 | Rake $0 
Seat 1: Clappasaur (big blind) folded before Flop
Seat 2: Lord_of_days folded before Flop (didn't bet)
Seat 3: densamara_63 (button) folded before Flop
Seat 6: alexos04 (small blind) collected ($0.54)



PokerStars Hand #222958113759:  Hold'em No Limit ($0.05/$0.10 USD) - 2021/01/23 11:03:22 ET
Table 'Polydoros II' 6-max Seat #6 is the button
Seat 1: Clappasaur ($9.90 in chips) 
Seat 2: Lord_of_days ($10 in chips) 
Seat 3: densamara_63 ($10 in chips) 
Seat 4: G oet Mestreech ($10 in chips) 
Seat 6: alexos04 ($15.88 in chips) 
Clappasaur: posts small blind $0.05
Lord_of_days: posts big blind $0.10
G oet Mestreech: posts big blind $0.10
appu001: sits out 
*** HOLE CARDS ***
densamara_63: raises $0.30 to $0.40
G oet Mestreech: calls $0.30
alexos04: folds 
Clappasaur: calls $0.35
Lord_of_days: folds 
*** FLOP *** [6h 5s Ah]
Clappasaur: checks 
densamara_63: checks 
G oet Mestreech: bets $0.40
Clappasaur: calls $0.40
densamara_63: calls $0.40
*** TURN *** [6h 5s Ah] [4h]
Clappasaur: checks 
densamara_63: checks 
G oet Mestreech: checks 
*** RIVER *** [6h 5s Ah 4h] [Ad]
Clappasaur: bets $1.50
densamara_63: calls $1.50
G oet Mestreech: folds 
*** SHOW DOWN ***
Clappasaur: shows [Ac 8s] (three of a kind, Aces)
densamara_63: mucks hand 
Clappasaur collected $5.25 from pot
*** SUMMARY ***
Total pot $5.50 | Rake $0.25 
Board [6h 5s Ah 4h Ad]
Seat 1: Clappasaur (small blind) showed [Ac 8s] and won ($5.25) with three of a kind, Aces
Seat 2: Lord_of_days (big blind) folded before Flop
Seat 3: densamara_63 mucked
Seat 4: G oet Mestreech folded on the River
Seat 6: alexos04 (button) folded before Flop (didn't bet)



PokerStars Hand #222958144403:  Hold'em No Limit ($0.05/$0.10 USD) - 2021/01/23 11:04:13 ET
Table 'Polydoros II' 6-max Seat #1 is the button
Seat 1: Clappasaur ($12.85 in chips) 
Seat 2: Lord_of_days ($9.90 in chips) 
Seat 3: densamara_63 ($10 in chips) 
Seat 4: G oet Mestreech ($9.20 in chips) 
Seat 5: appu001 ($10 in chips) 
Seat 6: alexos04 ($15.88 in chips) 
Lord_of_days: posts small blind $0.05
densamara_63: posts big blind $0.10
appu001: posts big blind $0.10
*** HOLE CARDS ***
G oet Mestreech: folds 
appu001: checks 
alexos04: raises $0.40 to $0.50
Clappasaur: folds 
Lord_of_days: raises $1.30 to $1.80
densamara_63: folds 
appu001: calls $1.70
alexos04: folds 
*** FLOP *** [3d 4c Qc]
Lord_of_days: bets $8.10 and is all-in
appu001: folds 
Uncalled bet ($8.10) returned to Lord_of_days
Lord_of_days collected $4.01 from pot
Lord_of_days: doesn't show hand 
*** SUMMARY ***
Total pot $4.20 | Rake $0.19 
Board [3d 4c Qc]
Seat 1: Clappasaur (button) folded before Flop (didn't bet)
Seat 2: Lord_of_days (small blind) collected ($4.01)
Seat 3: densamara_63 (big blind) folded before Flop
Seat 4: G oet Mestreech folded before Flop (didn't bet)
Seat 5: appu001 folded on the Flop
Seat 6: alexos04 folded before Flop



PokerStars Hand #222958166644:  Hold'em No Limit ($0.05/$0.10 USD) - 2021/01/23 11:04:52 ET
Table 'Polydoros II' 6-max Seat #2 is the button
Seat 1: Clappasaur ($12.85 in chips) 
Seat 2: Lord_of_days ($12.11 in chips) 
Seat 3: densamara_63 ($10 in chips) 
Seat 4: G oet Mestreech ($9.20 in chips) 
Seat 5: appu001 ($8.20 in chips) 
Seat 6: alexos04 ($15.38 in chips) 
densamara_63: posts small blind $0.05
G oet Mestreech: posts big blind $0.10
*** HOLE CARDS ***
appu001: calls $0.10
alexos04: folds 
Clappasaur: raises $0.20 to $0.30
Lord_of_days: folds 
densamara_63: folds 
G oet Mestreech: folds 
appu001: raises $0.20 to $0.50
Clappasaur: calls $0.20
*** FLOP *** [6h 8c Kh]
appu001: checks 
Clappasaur: checks 
*** TURN *** [6h 8c Kh] [Ac]
appu001: bets $0.50
Clappasaur: calls $0.50
*** RIVER *** [6h 8c Kh Ac] [5c]
appu001: bets $1.30
Clappasaur: folds 
Uncalled bet ($1.30) returned to appu001
appu001 collected $2.05 from pot
appu001: doesn't show hand 
*** SUMMARY ***
Total pot $2.15 | Rake $0.10 
Board [6h 8c Kh Ac 5c]
Seat 1: Clappasaur folded on the River
Seat 2: Lord_of_days (button) folded before Flop (didn't bet)
Seat 3: densamara_63 (small blind) folded before Flop
Seat 4: G oet Mestreech (big blind) folded before Flop
Seat 5: appu001 collected ($2.05)
Seat 6: alexos04 folded before Flop (didn't bet)



PokerStars Hand #222958184029:  Hold'em No Limit ($0.05/$0.10 USD) - 2021/01/23 11:05:22 ET
Table 'Polydoros II' 6-max Seat #3 is the button
Seat 1: Clappasaur ($11.85 in chips) 
Seat 2: Lord_of_days ($12.11 in chips) 
Seat 3: densamara_63 ($10 in chips) 
Seat 4: G oet Mestreech ($9.10 in chips) 
Seat 5: appu001 ($9.25 in chips) 
Seat 6: alexos04 ($15.38 in chips) 
G oet Mestreech: posts small blind $0.05
appu001: posts big blind $0.10
*** HOLE CARDS ***
alexos04: folds 
Clappasaur: folds 
Lord_of_days: raises $0.20 to $0.30
densamara_63: raises $0.60 to $0.90
G oet Mestreech: folds 
appu001: folds 
Lord_of_days: folds 
Uncalled bet ($0.60) returned to densamara_63
densamara_63 collected $0.75 from pot
*** SUMMARY ***
Total pot $0.75 | Rake $0 
Seat 1: Clappasaur folded before Flop (didn't bet)
Seat 2: Lord_of_days folded before Flop
Seat 3: densamara_63 (button) collected ($0.75)
Seat 4: G oet Mestreech (small blind) folded before Flop
Seat 5: appu001 (big blind) folded before Flop
Seat 6: alexos04 folded before Flop (didn't bet)



PokerStars Hand #222958194082:  Hold'em No Limit ($0.05/$0.10 USD) - 2021/01/23 11:05:39 ET
Table 'Polydoros II' 6-max Seat #4 is the button
Seat 1: Clappasaur ($11.85 in chips) 
Seat 2: Lord_of_days ($11.81 in chips) 
Seat 3: densamara_63 ($10.45 in chips) 
Seat 4: G oet Mestreech ($9.05 in chips) 
Seat 5: appu001 ($9.15 in chips) 
Seat 6: alexos04 ($15.38 in chips) 
appu001: posts small blind $0.05
alexos04: posts big blind $0.10
*** HOLE CARDS ***
Clappasaur: folds 
Lord_of_days: folds 
densamara_63: folds 
G oet Mestreech: folds 
appu001: calls $0.05
alexos04: checks 
*** FLOP *** [Ac 5s 2c]
appu001: checks 
alexos04: checks 
*** TURN *** [Ac 5s 2c] [Qc]
appu001: bets $0.60
alexos04: folds 
Uncalled bet ($0.60) returned to appu001
appu001 collected $0.19 from pot
appu001: doesn't show hand 
*** SUMMARY ***
Total pot $0.20 | Rake $0.01 
Board [Ac 5s 2c Qc]
Seat 1: Clappasaur folded before Flop (didn't bet)
Seat 2: Lord_of_days folded before Flop (didn't bet)
Seat 3: densamara_63 folded before Flop (didn't bet)
Seat 4: G oet Mestreech (button) folded before Flop (didn't bet)
Seat 5: appu001 (small blind) collected ($0.19)
Seat 6: alexos04 (big blind) folded on the Turn



PokerStars Hand #222958209686:  Hold'em No Limit ($0.05/$0.10 USD) - 2021/01/23 11:06:05 ET
Table 'Polydoros II' 6-max Seat #5 is the button
Seat 1: Clappasaur ($11.85 in chips) 
Seat 2: Lord_of_days ($11.81 in chips) 
Seat 3: densamara_63 ($10.45 in chips) 
Seat 4: G oet Mestreech ($9.05 in chips) 
Seat 5: appu001 ($9.24 in chips) 
Seat 6: alexos04 ($15.28 in chips) 
alexos04: posts small blind $0.05
Clappasaur: posts big blind $0.10
*** HOLE CARDS ***
Lord_of_days: folds 
densamara_63: folds 
G oet Mestreech: folds 
appu001: folds 
alexos04: raises $0.20 to $0.30
Clappasaur: calls $0.20
*** FLOP *** [6c 2d As]
alexos04: bets $0.40
Clappasaur: folds 
Uncalled bet ($0.40) returned to alexos04
alexos04 collected $0.57 from pot
alexos04: doesn't show hand 
*** SUMMARY ***
Total pot $0.60 | Rake $0.03 
Board [6c 2d As]
Seat 1: Clappasaur (big blind) folded on the Flop
Seat 2: Lord_of_days folded before Flop (didn't bet)
Seat 3: densamara_63 folded before Flop (didn't bet)
Seat 4: G oet Mestreech folded before Flop (didn't bet)
Seat 5: appu001 (button) folded before Flop (didn't bet)
Seat 6: alexos04 (small blind) collected ($0.57)



PokerStars Hand #222958224704:  Hold'em No Limit ($0.05/$0.10 USD) - 2021/01/23 11:06:30 ET
Table 'Polydoros II' 6-max Seat #6 is the button
Seat 1: Clappasaur ($11.55 in chips) 
Seat 2: Lord_of_days ($11.81 in chips) 
Seat 3: densamara_63 ($10.45 in chips) 
Seat 4: G oet Mestreech ($9.05 in chips) 
Seat 5: appu001 ($9.24 in chips) 
Seat 6: alexos04 ($15.55 in chips) 
Clappasaur: posts small blind $0.05
Lord_of_days: posts big blind $0.10
*** HOLE CARDS ***
densamara_63: calls $0.10
G oet Mestreech: folds 
appu001: folds 
alexos04: folds 
Clappasaur: calls $0.05
Lord_of_days: checks 
*** FLOP *** [8h 2d 3s]
Clappasaur: bets $0.20
Lord_of_days: raises $0.50 to $0.70
densamara_63: folds 
Clappasaur: calls $0.50
*** TURN *** [8h 2d 3s] [8c]
Clappasaur: checks 
Lord_of_days: checks 
*** RIVER *** [8h 2d 3s 8c] [3h]
Clappasaur: bets $0.40
Lord_of_days: folds 
Uncalled bet ($0.40) returned to Clappasaur
Clappasaur collected $1.62 from pot
Clappasaur: doesn't show hand 
*** SUMMARY ***
Total pot $1.70 | Rake $0.08 
Board [8h 2d 3s 8c 3h]
Seat 1: Clappasaur (small blind) collected ($1.62)
Seat 2: Lord_of_days (big blind) folded on the River
Seat 3: densamara_63 folded on the Flop
Seat 4: G oet Mestreech folded before Flop (didn't bet)
Seat 5: appu001 folded before Flop (didn't bet)
Seat 6: alexos04 (button) folded before Flop (didn't bet)



PokerStars Hand #222958247926:  Hold'em No Limit ($0.05/$0.10 USD) - 2021/01/23 11:07:09 ET
Table 'Polydoros II' 6-max Seat #1 is the button
Seat 1: Clappasaur ($12.37 in chips) 
Seat 2: Lord_of_days ($11.01 in chips) 
Seat 3: densamara_63 ($10.35 in chips) 
Seat 4: G oet Mestreech ($9.05 in chips) 
Seat 5: appu001 ($9.24 in chips) 
Seat 6: alexos04 ($15.55 in chips) 
Lord_of_days: posts small blind $0.05
densamara_63: posts big blind $0.10
*** HOLE CARDS ***
G oet Mestreech: folds 
appu001: raises $0.10 to $0.20
alexos04: folds 
Clappasaur: raises $0.40 to $0.60
Lord_of_days: folds 
densamara_63: folds 
appu001: calls $0.40
*** FLOP *** [Qd 6h 9c]
appu001: checks 
Clappasaur: bets $1
appu001: calls $1
*** TURN *** [Qd 6h 9c] [3s]
appu001: checks 
Clappasaur: bets $1.80
appu001: folds 
Uncalled bet ($1.80) returned to Clappasaur
Clappasaur collected $3.20 from pot
Clappasaur: doesn't show hand 
*** SUMMARY ***
Total pot $3.35 | Rake $0.15 
Board [Qd 6h 9c 3s]
Seat 1: Clappasaur (button) collected ($3.20)
Seat 2: Lord_of_days (small blind) folded before Flop
Seat 3: densamara_63 (big blind) folded before Flop
Seat 4: G oet Mestreech folded before Flop (didn't bet)
Seat 5: appu001 folded on the Turn
Seat 6: alexos04 folded before Flop (didn't bet)



PokerStars Hand #222958272760:  Hold'em No Limit ($0.05/$0.10 USD) - 2021/01/23 11:07:51 ET
Table 'Polydoros II' 6-max Seat #2 is the button
Seat 1: Clappasaur ($13.97 in chips) 
Seat 2: Lord_of_days ($10.96 in chips) 
Seat 3: densamara_63 ($10.25 in chips) 
Seat 4: G oet Mestreech ($9.05 in chips) 
Seat 5: appu001 ($7.64 in chips) 
Seat 6: alexos04 ($15.55 in chips) 
densamara_63: posts small blind $0.05
G oet Mestreech: posts big blind $0.10
*** HOLE CARDS ***
appu001: calls $0.10
alexos04: folds 
Clappasaur: raises $0.10 to $0.20
Lord_of_days: folds 
densamara_63: raises $0.90 to $1.10
G oet Mestreech: folds 
appu001: calls $1
Clappasaur: folds 
*** FLOP *** [6d 8s Jh]
densamara_63: bets $1.43
appu001: calls $1.43
*** TURN *** [6d 8s Jh] [5s]
densamara_63: checks 
appu001: bets $1.40
densamara_63: calls $1.40
*** RIVER *** [6d 8s Jh 5s] [4c]
densamara_63: checks 
appu001: bets $3.71 and is all-in
densamara_63: calls $3.71
*** SHOW DOWN ***
appu001: shows [7h Kc] (a straight, Four to Eight)
densamara_63: shows [Jd Qd] (a pair of Jacks)
appu001 collected $14.88 from pot
*** SUMMARY ***
Total pot $15.58 | Rake $0.70 
Board [6d 8s Jh 5s 4c]
Seat 1: Clappasaur folded before Flop
Seat 2: Lord_of_days (button) folded before Flop (didn't bet)
Seat 3: densamara_63 (small blind) showed [Jd Qd] and lost with a pair of Jacks
Seat 4: G oet Mestreech (big blind) folded before Flop
Seat 5: appu001 showed [7h Kc] and won ($14.88) with a straight, Four to Eight
Seat 6: alexos04 folded before Flop (didn't bet)



PokerStars Hand #222958301403:  Hold'em No Limit ($0.05/$0.10 USD) - 2021/01/23 11:08:39 ET
Table 'Polydoros II' 6-max Seat #3 is the button
Seat 1: Clappasaur ($13.77 in chips) 
Seat 2: Lord_of_days ($10.96 in chips) 
Seat 3: densamara_63 ($10 in chips) 
Seat 4: G oet Mestreech ($8.95 in chips) 
Seat 5: appu001 ($14.88 in chips) 
Seat 6: alexos04 ($15.55 in chips) 
G oet Mestreech: posts small blind $0.05
appu001: posts big blind $0.10
*** HOLE CARDS ***
alexos04: folds 
Clappasaur: folds 
Lord_of_days: raises $0.20 to $0.30
densamara_63: raises $0.60 to $0.90
G oet Mestreech: folds 
appu001: calls $0.80
Lord_of_days: folds 
*** FLOP *** [Kc 5h 8c]
appu001: checks 
densamara_63: bets $1.23
appu001: folds 
Uncalled bet ($1.23) returned to densamara_63
densamara_63 collected $2.05 from pot
*** SUMMARY ***
Total pot $2.15 | Rake $0.10 
Board [Kc 5h 8c]
Seat 1: Clappasaur folded before Flop (didn't bet)
Seat 2: Lord_of_days folded before Flop
Seat 3: densamara_63 (button) collected ($2.05)
Seat 4: G oet Mestreech (small blind) folded before Flop
Seat 5: appu001 (big blind) folded on the Flop
Seat 6: alexos04 folded before Flop (didn't bet)



PokerStars Hand #222958320594:  Hold'em No Limit ($0.05/$0.10 USD) - 2021/01/23 11:09:11 ET
Table 'Polydoros II' 6-max Seat #4 is the button
Seat 1: Clappasaur ($13.77 in chips) 
Seat 2: Lord_of_days ($10.66 in chips) 
Seat 3: densamara_63 ($11.15 in chips) 
Seat 4: G oet Mestreech ($8.90 in chips) 
Seat 5: appu001 ($13.98 in chips) 
Seat 6: alexos04 ($15.55 in chips) 
appu001: posts small blind $0.05
alexos04: posts big blind $0.10
*** HOLE CARDS ***
Clappasaur: raises $0.10 to $0.20
Lord_of_days: folds 
densamara_63: folds 
G oet Mestreech: folds 
appu001: raises $0.10 to $0.30
alexos04: folds 
Clappasaur: calls $0.10
*** FLOP *** [4h Ks As]
appu001: bets $0.67
Clappasaur: calls $0.67
*** TURN *** [4h Ks As] [6s]
appu001: checks 
Clappasaur: checks 
*** RIVER *** [4h Ks As 6s] [8s]
appu001: checks 
Clappasaur: bets $1
appu001: folds 
Uncalled bet ($1) returned to Clappasaur
Clappasaur collected $1.95 from pot
Clappasaur: doesn't show hand 
*** SUMMARY ***
Total pot $2.04 | Rake $0.09 
Board [4h Ks As 6s 8s]
Seat 1: Clappasaur collected ($1.95)
Seat 2: Lord_of_days folded before Flop (didn't bet)
Seat 3: densamara_63 folded before Flop (didn't bet)
Seat 4: G oet Mestreech (button) folded before Flop (didn't bet)
Seat 5: appu001 (small blind) folded on the River
Seat 6: alexos04 (big blind) folded before Flop



PokerStars Hand #222958346455:  Hold'em No Limit ($0.05/$0.10 USD) - 2021/01/23 11:09:54 ET
Table 'Polydoros II' 6-max Seat #5 is the button
Seat 1: Clappasaur ($14.75 in chips) 
Seat 2: Lord_of_days ($10.66 in chips) 
Seat 3: densamara_63 ($11.15 in chips) 
Seat 4: G oet Mestreech ($8.90 in chips) 
Seat 5: appu001 ($13.01 in chips) 
Seat 6: alexos04 ($15.45 in chips) 
alexos04: posts small blind $0.05
Clappasaur: posts big blind $0.10
*** HOLE CARDS ***
Lord_of_days: raises $0.20 to $0.30
densamara_63: folds 
G oet Mestreech: folds 
appu001: folds 
alexos04: folds 
Clappasaur: calls $0.20
*** FLOP *** [7s 6h 4d]
Clappasaur: checks 
Lord_of_days: bets $0.20
Clappasaur: calls $0.20
*** TURN *** [7s 6h 4d] [Jd]
Clappasaur: checks 
Lord_of_days: checks 
*** RIVER *** [7s 6h 4d Jd] [6s]
Clappasaur: checks 
Lord_of_days: bets $0.33
Clappasaur: folds 
Uncalled bet ($0.33) returned to Lord_of_days
Lord_of_days collected $1 from pot
Lord_of_days: doesn't show hand 
*** SUMMARY ***
Total pot $1.05 | Rake $0.05 
Board [7s 6h 4d Jd 6s]
Seat 1: Clappasaur (big blind) folded on the River
Seat 2: Lord_of_days collected ($1)
Seat 3: densamara_63 folded before Flop (didn't bet)
Seat 4: G oet Mestreech folded before Flop (didn't bet)
Seat 5: appu001 (button) folded before Flop (didn't bet)
Seat 6: alexos04 (small blind) folded before Flop



PokerStars Hand #222958372043:  Hold'em No Limit ($0.05/$0.10 USD) - 2021/01/23 11:10:37 ET
Table 'Polydoros II' 6-max Seat #6 is the button
Seat 1: Clappasaur ($14.25 in chips) 
Seat 2: Lord_of_days ($11.16 in chips) 
Seat 3: densamara_63 ($11.15 in chips) 
Seat 4: G oet Mestreech ($8.90 in chips) 
Seat 5: appu001 ($13.01 in chips) 
Seat 6: alexos04 ($15.40 in chips) 
Clappasaur: posts small blind $0.05
Lord_of_days: posts big blind $0.10
*** HOLE CARDS ***
densamara_63: folds 
G oet Mestreech: folds 
appu001: raises $0.10 to $0.20
alexos04: folds 
Clappasaur: calls $0.15
Lord_of_days: folds 
*** FLOP *** [3d 7d Ah]
G oet Mestreech leaves the table
Clappasaur: checks 
appu001: checks 
*** TURN *** [3d 7d Ah] [4d]
Clappasaur: checks 
appu001: checks 
*** RIVER *** [3d 7d Ah 4d] [Qs]
Clappasaur: checks 
appu001: bets $12.81 and is all-in
Cloud5918 joins the table at seat #4 
Clappasaur: folds 
Uncalled bet ($12.81) returned to appu001
appu001 collected $0.48 from pot
appu001: doesn't show hand 
*** SUMMARY ***
Total pot $0.50 | Rake $0.02 
Board [3d 7d Ah 4d Qs]
Seat 1: Clappasaur (small blind) folded on the River
Seat 2: Lord_of_days (big blind) folded before Flop
Seat 3: densamara_63 folded before Flop (didn't bet)
Seat 4: G oet Mestreech folded before Flop (didn't bet)
Seat 5: appu001 collected ($0.48)
Seat 6: alexos04 (button) folded before Flop (didn't bet)



PokerStars Hand #222958390215:  Hold'em No Limit ($0.05/$0.10 USD) - 2021/01/23 11:11:07 ET
Table 'Polydoros II' 6-max Seat #1 is the button
Seat 1: Clappasaur ($14.05 in chips) 
Seat 2: Lord_of_days ($11.06 in chips) 
Seat 3: densamara_63 ($11.15 in chips) 
Seat 5: appu001 ($13.29 in chips) 
Seat 6: alexos04 ($15.40 in chips) 
Lord_of_days: posts small blind $0.05
densamara_63: posts big blind $0.10
Cloud5918: sits out 
*** HOLE CARDS ***
appu001: folds 
alexos04: raises $0.20 to $0.30
Clappasaur: calls $0.30
Lord_of_days: calls $0.25
densamara_63: folds 
*** FLOP *** [8d 2s 7d]
Lord_of_days: checks 
alexos04: checks 
Clappasaur: checks 
*** TURN *** [8d 2s 7d] [Tc]
Lord_of_days: bets $0.32
alexos04: folds 
Clappasaur: calls $0.32
*** RIVER *** [8d 2s 7d Tc] [Ah]
Lord_of_days: checks 
Clappasaur: bets $1.20
Lord_of_days: folds 
Uncalled bet ($1.20) returned to Clappasaur
Clappasaur collected $1.57 from pot
Clappasaur: doesn't show hand 
*** SUMMARY ***
Total pot $1.64 | Rake $0.07 
Board [8d 2s 7d Tc Ah]
Seat 1: Clappasaur (button) collected ($1.57)
Seat 2: Lord_of_days (small blind) folded on the River
Seat 3: densamara_63 (big blind) folded before Flop
Seat 5: appu001 folded before Flop (didn't bet)
Seat 6: alexos04 folded on the Turn



PokerStars Hand #222958428707:  Hold'em No Limit ($0.05/$0.10 USD) - 2021/01/23 11:12:11 ET
Table 'Polydoros II' 6-max Seat #2 is the button
Seat 1: Clappasaur ($15 in chips) 
Seat 2: Lord_of_days ($10.44 in chips) 
Seat 3: densamara_63 ($11.05 in chips) 
Seat 4: Cloud5918 ($5.10 in chips) 
Seat 5: appu001 ($13.29 in chips) 
Seat 6: alexos04 ($15.10 in chips) 
densamara_63: posts small blind $0.05
Cloud5918: posts big blind $0.10
*** HOLE CARDS ***
appu001: calls $0.10
alexos04: folds 
Clappasaur: folds 
Lord_of_days: raises $0.30 to $0.40
densamara_63: calls $0.35
Cloud5918: calls $0.30
appu001: folds 
*** FLOP *** [Ac Tc Kd]
densamara_63: checks 
Cloud5918: checks 
Lord_of_days: bets $0.41
densamara_63: calls $0.41
Cloud5918: raises $4.29 to $4.70 and is all-in
Lord_of_days: folds 
densamara_63: folds 
Uncalled bet ($4.29) returned to Cloud5918
Cloud5918 collected $2.42 from pot
Cloud5918: doesn't show hand 
*** SUMMARY ***
Total pot $2.53 | Rake $0.11 
Board [Ac Tc Kd]
Seat 1: Clappasaur folded before Flop (didn't bet)
Seat 2: Lord_of_days (button) folded on the Flop
Seat 3: densamara_63 (small blind) folded on the Flop
Seat 4: Cloud5918 (big blind) collected ($2.42)
Seat 5: appu001 folded before Flop
Seat 6: alexos04 folded before Flop (didn't bet)



PokerStars Hand #222958458928:  Hold'em No Limit ($0.05/$0.10 USD) - 2021/01/23 11:13:01 ET
Table 'Polydoros II' 6-max Seat #3 is the button
Seat 1: Clappasaur ($15 in chips) 
Seat 2: Lord_of_days ($10 in chips) 
Seat 3: densamara_63 ($10.24 in chips) 
Seat 4: Cloud5918 ($6.71 in chips) 
Seat 5: appu001 ($13.19 in chips) 
Seat 6: alexos04 ($15.10 in chips) 
Cloud5918: posts small blind $0.05
appu001: posts big blind $0.10
*** HOLE CARDS ***
alexos04: folds 
Clappasaur: folds 
Lord_of_days: folds 
densamara_63: folds 
Cloud5918: calls $0.05
appu001: checks 
*** FLOP *** [Tc Ac 9h]
Cloud5918: checks 
appu001: bets $0.40
Cloud5918: calls $0.40
*** TURN *** [Tc Ac 9h] [Kh]
Cloud5918: checks 
appu001: bets $0.10
Cloud5918: calls $0.10
*** RIVER *** [Tc Ac 9h Kh] [Qh]
Cloud5918: bets $1.15
appu001: folds 
Uncalled bet ($1.15) returned to Cloud5918
Cloud5918 collected $1.15 from pot
Cloud5918: doesn't show hand 
*** SUMMARY ***
Total pot $1.20 | Rake $0.05 
Board [Tc Ac 9h Kh Qh]
Seat 1: Clappasaur folded before Flop (didn't bet)
Seat 2: Lord_of_days folded before Flop (didn't bet)
Seat 3: densamara_63 (button) folded before Flop (didn't bet)
Seat 4: Cloud5918 (small blind) collected ($1.15)
Seat 5: appu001 (big blind) folded on the River
Seat 6: alexos04 folded before Flop (didn't bet)



PokerStars Hand #222958491276:  Hold'em No Limit ($0.05/$0.10 USD) - 2021/01/23 11:13:47 ET
Table 'Polydoros II' 6-max Seat #4 is the button
Seat 1: Clappasaur ($15 in chips) 
Seat 2: Lord_of_days ($10 in chips) 
Seat 3: densamara_63 ($10.24 in chips) 
Seat 4: Cloud5918 ($7.26 in chips) 
Seat 5: appu001 ($12.59 in chips) 
Seat 6: alexos04 ($15.10 in chips) 
appu001: posts small blind $0.05
alexos04: posts big blind $0.10
*** HOLE CARDS ***
Clappasaur: raises $0.10 to $0.20
Lord_of_days: folds 
densamara_63: folds 
Cloud5918: folds 
appu001: calls $0.15
alexos04: calls $0.10
*** FLOP *** [Js 4h 9h]
appu001: checks 
alexos04: checks 
Clappasaur: bets $0.30
appu001: calls $0.30
alexos04: folds 
*** TURN *** [Js 4h 9h] [Th]
appu001: bets $0.10
Clappasaur: raises $0.70 to $0.80
appu001: calls $0.70
*** RIVER *** [Js 4h 9h Th] [Ks]
appu001: checks 
Clappasaur: bets $2
appu001: folds 
Uncalled bet ($2) returned to Clappasaur
Clappasaur collected $2.67 from pot
Clappasaur: doesn't show hand 
*** SUMMARY ***
Total pot $2.80 | Rake $0.13 
Board [Js 4h 9h Th Ks]
Seat 1: Clappasaur collected ($2.67)
Seat 2: Lord_of_days folded before Flop (didn't bet)
Seat 3: densamara_63 folded before Flop (didn't bet)
Seat 4: Cloud5918 (button) folded before Flop (didn't bet)
Seat 5: appu001 (small blind) folded on the River
Seat 6: alexos04 (big blind) folded on the Flop



PokerStars Hand #222958526291:  Hold'em No Limit ($0.05/$0.10 USD) - 2021/01/23 11:14:46 ET
Table 'Polydoros II' 6-max Seat #5 is the button
Seat 1: Clappasaur ($16.37 in chips) 
Seat 2: Lord_of_days ($10 in chips) 
Seat 3: densamara_63 ($10.24 in chips) 
Seat 4: Cloud5918 ($7.26 in chips) 
Seat 5: appu001 ($11.29 in chips) 
Seat 6: alexos04 ($14.90 in chips) 
alexos04: posts small blind $0.05
Clappasaur: posts big blind $0.10
*** HOLE CARDS ***
Lord_of_days: folds 
densamara_63: folds 
Cloud5918: raises $0.30 to $0.40
appu001: folds 
alexos04: calls $0.35
Clappasaur: calls $0.30
*** FLOP *** [Th 6d 3c]
alexos04: checks 
Clappasaur: checks 
Cloud5918: bets $0.70
alexos04: raises $1.30 to $2
Clappasaur: folds 
Cloud5918: folds 
Uncalled bet ($1.30) returned to alexos04
alexos04 collected $2.48 from pot
alexos04: doesn't show hand 
*** SUMMARY ***
Total pot $2.60 | Rake $0.12 
Board [Th 6d 3c]
Seat 1: Clappasaur (big blind) folded on the Flop
Seat 2: Lord_of_days folded before Flop (didn't bet)
Seat 3: densamara_63 folded before Flop (didn't bet)
Seat 4: Cloud5918 folded on the Flop
Seat 5: appu001 (button) folded before Flop (didn't bet)
Seat 6: alexos04 (small blind) collected ($2.48)



PokerStars Hand #222958557081:  Hold'em No Limit ($0.05/$0.10 USD) - 2021/01/23 11:15:36 ET
Table 'Polydoros II' 6-max Seat #6 is the button
Seat 1: Clappasaur ($15.97 in chips) 
Seat 2: Lord_of_days ($10 in chips) 
Seat 3: densamara_63 ($10.24 in chips) 
Seat 4: Cloud5918 ($6.16 in chips) 
Seat 5: appu001 ($11.29 in chips) 
Seat 6: alexos04 ($16.28 in chips) 
Clappasaur: posts small blind $0.05
Lord_of_days: posts big blind $0.10
*** HOLE CARDS ***
densamara_63: folds 
Cloud5918: calls $0.10
appu001: raises $0.10 to $0.20
alexos04: folds 
Clappasaur: folds 
Lord_of_days: folds 
Cloud5918: calls $0.10
*** FLOP *** [6h 7s 7d]
Cloud5918: checks 
appu001: bets $0.70
Cloud5918: folds 
Uncalled bet ($0.70) returned to appu001
appu001 collected $0.53 from pot
appu001: doesn't show hand 
*** SUMMARY ***
Total pot $0.55 | Rake $0.02 
Board [6h 7s 7d]
Seat 1: Clappasaur (small blind) folded before Flop
Seat 2: Lord_of_days (big blind) folded before Flop
Seat 3: densamara_63 folded before Flop (didn't bet)
Seat 4: Cloud5918 folded on the Flop
Seat 5: appu001 collected ($0.53)
Seat 6: alexos04 (button) folded before Flop (didn't bet)



PokerStars Hand #222958571160:  Hold'em No Limit ($0.05/$0.10 USD) - 2021/01/23 11:16:00 ET
Table 'Polydoros II' 6-max Seat #1 is the button
Seat 1: Clappasaur ($15.92 in chips) 
Seat 2: Lord_of_days ($9.90 in chips) 
Seat 3: densamara_63 ($10.24 in chips) 
Seat 4: Cloud5918 ($5.96 in chips) 
Seat 5: appu001 ($11.62 in chips) 
Seat 6: alexos04 ($16.28 in chips) 
Lord_of_days: posts small blind $0.05
densamara_63: posts big blind $0.10
*** HOLE CARDS ***
Cloud5918: folds 
appu001: calls $0.10
alexos04: folds 
Clappasaur: raises $0.20 to $0.30
Lord_of_days: folds 
densamara_63: raises $0.60 to $0.90
appu001: calls $0.80
Clappasaur: calls $0.60
*** FLOP *** [Jc 8d Ks]
densamara_63: checks 
appu001: checks 
Clappasaur: checks 
*** TURN *** [Jc 8d Ks] [9d]
densamara_63: bets $2.18
appu001: folds 
Clappasaur: folds 
Uncalled bet ($2.18) returned to densamara_63
densamara_63 collected $2.63 from pot
*** SUMMARY ***
Total pot $2.75 | Rake $0.12 
Board [Jc 8d Ks 9d]
Seat 1: Clappasaur (button) folded on the Turn
Seat 2: Lord_of_days (small blind) folded before Flop
Seat 3: densamara_63 (big blind) collected ($2.63)
Seat 4: Cloud5918 folded before Flop (didn't bet)
Seat 5: appu001 folded on the Turn
Seat 6: alexos04 folded before Flop (didn't bet)



PokerStars Hand #222958595991:  Hold'em No Limit ($0.05/$0.10 USD) - 2021/01/23 11:16:41 ET
Table 'Polydoros II' 6-max Seat #2 is the button
Seat 1: Clappasaur ($15.02 in chips) 
Seat 2: Lord_of_days ($10 in chips) 
Seat 3: densamara_63 ($11.97 in chips) 
Seat 4: Cloud5918 ($5.96 in chips) 
Seat 5: appu001 ($10.72 in chips) 
Seat 6: alexos04 ($16.28 in chips) 
densamara_63: posts small blind $0.05
Cloud5918: posts big blind $0.10
*** HOLE CARDS ***
appu001: folds 
alexos04: raises $0.20 to $0.30
Clappasaur: calls $0.30
Lord_of_days: folds 
densamara_63: folds 
Cloud5918: calls $0.20
*** FLOP *** [9c 4h Tc]
Cloud5918: checks 
alexos04: checks 
Clappasaur: checks 
*** TURN *** [9c 4h Tc] [3h]
Cloud5918: bets $0.50
alexos04: raises $1.60 to $2.10
Clappasaur: folds 
Cloud5918: folds 
Uncalled bet ($1.60) returned to alexos04
alexos04 collected $1.86 from pot
alexos04: doesn't show hand 
*** SUMMARY ***
Total pot $1.95 | Rake $0.09 
Board [9c 4h Tc 3h]
Seat 1: Clappasaur folded on the Turn
Seat 2: Lord_of_days (button) folded before Flop (didn't bet)
Seat 3: densamara_63 (small blind) folded before Flop
Seat 4: Cloud5918 (big blind) folded on the Turn
Seat 5: appu001 folded before Flop (didn't bet)
Seat 6: alexos04 collected ($1.86)



PokerStars Hand #222958624681:  Hold'em No Limit ($0.05/$0.10 USD) - 2021/01/23 11:17:29 ET
Table 'Polydoros II' 6-max Seat #3 is the button
Seat 1: Clappasaur ($14.72 in chips) 
Seat 2: Lord_of_days ($10 in chips) 
Seat 3: densamara_63 ($11.92 in chips) 
Seat 4: Cloud5918 ($5.16 in chips) 
Seat 5: appu001 ($10.72 in chips) 
Seat 6: alexos04 ($17.34 in chips) 
Cloud5918: posts small blind $0.05
appu001: posts big blind $0.10
*** HOLE CARDS ***
alexos04: folds 
Clappasaur: folds 
Lord_of_days: folds 
densamara_63: folds 
Cloud5918: raises $0.20 to $0.30
appu001: calls $0.20
*** FLOP *** [3h 4s 2h]
Cloud5918: bets $4.86 and is all-in
appu001: folds 
Uncalled bet ($4.86) returned to Cloud5918
Cloud5918 collected $0.57 from pot
Cloud5918: doesn't show hand 
*** SUMMARY ***
Total pot $0.60 | Rake $0.03 
Board [3h 4s 2h]
Seat 1: Clappasaur folded before Flop (didn't bet)
Seat 2: Lord_of_days folded before Flop (didn't bet)
Seat 3: densamara_63 (button) folded before Flop (didn't bet)
Seat 4: Cloud5918 (small blind) collected ($0.57)
Seat 5: appu001 (big blind) folded on the Flop
Seat 6: alexos04 folded before Flop (didn't bet)



PokerStars Hand #222958644630:  Hold'em No Limit ($0.05/$0.10 USD) - 2021/01/23 11:18:02 ET
Table 'Polydoros II' 6-max Seat #4 is the button
Seat 1: Clappasaur ($14.72 in chips) 
Seat 2: Lord_of_days ($10 in chips) 
Seat 3: densamara_63 ($11.92 in chips) 
Seat 4: Cloud5918 ($5.43 in chips) 
Seat 5: appu001 ($10.42 in chips) 
Seat 6: alexos04 ($17.34 in chips) 
appu001: posts small blind $0.05
alexos04: posts big blind $0.10
*** HOLE CARDS ***
Clappasaur: folds 
Lord_of_days: folds 
densamara_63: folds 
Cloud5918: folds 
appu001: folds 
Uncalled bet ($0.05) returned to alexos04
alexos04 collected $0.10 from pot
alexos04: doesn't show hand 
*** SUMMARY ***
Total pot $0.10 | Rake $0 
Seat 1: Clappasaur folded before Flop (didn't bet)
Seat 2: Lord_of_days folded before Flop (didn't bet)
Seat 3: densamara_63 folded before Flop (didn't bet)
Seat 4: Cloud5918 (button) folded before Flop (didn't bet)
Seat 5: appu001 (small blind) folded before Flop
Seat 6: alexos04 (big blind) collected ($0.10)



PokerStars Hand #222958652823:  Hold'em No Limit ($0.05/$0.10 USD) - 2021/01/23 11:18:16 ET
Table 'Polydoros II' 6-max Seat #5 is the button
Seat 1: Clappasaur ($14.72 in chips) 
Seat 2: Lord_of_days ($10 in chips) 
Seat 3: densamara_63 ($11.92 in chips) 
Seat 4: Cloud5918 ($5.43 in chips) 
Seat 5: appu001 ($10.37 in chips) 
Seat 6: alexos04 ($17.39 in chips) 
alexos04: posts small blind $0.05
Clappasaur: posts big blind $0.10
*** HOLE CARDS ***
Lord_of_days: folds 
densamara_63: folds 
Cloud5918: folds 
appu001: raises $0.10 to $0.20
alexos04: calls $0.15
Clappasaur: calls $0.10
*** FLOP *** [9s 3h 3d]
alexos04: checks 
Clappasaur: checks 
appu001: bets $0.10
alexos04: calls $0.10
Clappasaur: folds 
*** TURN *** [9s 3h 3d] [2d]
alexos04: checks 
appu001: bets $0.70
alexos04: folds 
Uncalled bet ($0.70) returned to appu001
appu001 collected $0.76 from pot
appu001: doesn't show hand 
*** SUMMARY ***
Total pot $0.80 | Rake $0.04 
Board [9s 3h 3d 2d]
Seat 1: Clappasaur (big blind) folded on the Flop
Seat 2: Lord_of_days folded before Flop (didn't bet)
Seat 3: densamara_63 folded before Flop (didn't bet)
Seat 4: Cloud5918 folded before Flop (didn't bet)
Seat 5: appu001 (button) collected ($0.76)
Seat 6: alexos04 (small blind) folded on the Turn



PokerStars Hand #222958686854:  Hold'em No Limit ($0.05/$0.10 USD) - 2021/01/23 11:19:12 ET
Table 'Polydoros II' 6-max Seat #6 is the button
Seat 1: Clappasaur ($14.52 in chips) 
Seat 2: Lord_of_days ($10 in chips) 
Seat 3: densamara_63 ($11.92 in chips) 
Seat 4: Cloud5918 ($5.43 in chips) 
Seat 5: appu001 ($10.83 in chips) 
Seat 6: alexos04 ($17.09 in chips) 
Clappasaur: posts small blind $0.05
Lord_of_days: posts big blind $0.10
*** HOLE CARDS ***
densamara_63: folds 
Cloud5918: folds 
appu001: raises $0.10 to $0.20
alexos04: folds 
Clappasaur: calls $0.15
Lord_of_days: calls $0.10
*** FLOP *** [4c Td 2c]
Clappasaur: checks 
Lord_of_days: checks 
appu001: bets $0.50
Clappasaur: folds 
Lord_of_days: raises $0.90 to $1.40
appu001: calls $0.90
*** TURN *** [4c Td 2c] [4h]
Lord_of_days: bets $1.76
appu001: calls $1.76
*** RIVER *** [4c Td 2c 4h] [3d]
Lord_of_days: bets $2.18
appu001: folds 
Uncalled bet ($2.18) returned to Lord_of_days
Lord_of_days collected $6.61 from pot
Lord_of_days: doesn't show hand 
*** SUMMARY ***
Total pot $6.92 | Rake $0.31 
Board [4c Td 2c 4h 3d]
Seat 1: Clappasaur (small blind) folded on the Flop
Seat 2: Lord_of_days (big blind) collected ($6.61)
Seat 3: densamara_63 folded before Flop (didn't bet)
Seat 4: Cloud5918 folded before Flop (didn't bet)
Seat 5: appu001 folded on the River
Seat 6: alexos04 (button) folded before Flop (didn't bet)



PokerStars Hand #222958715982:  Hold'em No Limit ($0.05/$0.10 USD) - 2021/01/23 11:20:01 ET
Table 'Polydoros II' 6-max Seat #1 is the button
Seat 1: Clappasaur ($14.32 in chips) 
Seat 2: Lord_of_days ($13.25 in chips) 
Seat 3: densamara_63 ($11.92 in chips) 
Seat 4: Cloud5918 ($5.43 in chips) 
Seat 5: appu001 ($7.47 in chips) 
Seat 6: alexos04 ($17.09 in chips) 
Lord_of_days: posts small blind $0.05
densamara_63: posts big blind $0.10
*** HOLE CARDS ***
Cloud5918: folds 
appu001: calls $0.10
alexos04: folds 
Clappasaur: folds 
Lord_of_days: folds 
densamara_63: checks 
*** FLOP *** [Jc 8s Ah]
densamara_63: bets $0.10
appu001: calls $0.10
*** TURN *** [Jc 8s Ah] [8c]
densamara_63: bets $0.36
appu001: calls $0.36
*** RIVER *** [Jc 8s Ah 8c] [2s]
densamara_63: bets $0.67
appu001: folds 
Uncalled bet ($0.67) returned to densamara_63
densamara_63 collected $1.12 from pot
*** SUMMARY ***
Total pot $1.17 | Rake $0.05 
Board [Jc 8s Ah 8c 2s]
Seat 1: Clappasaur (button) folded before Flop (didn't bet)
Seat 2: Lord_of_days (small blind) folded before Flop
Seat 3: densamara_63 (big blind) collected ($1.12)
Seat 4: Cloud5918 folded before Flop (didn't bet)
Seat 5: appu001 folded on the River
Seat 6: alexos04 folded before Flop (didn't bet)



PokerStars Hand #222958740401:  Hold'em No Limit ($0.05/$0.10 USD) - 2021/01/23 11:20:41 ET
Table 'Polydoros II' 6-max Seat #2 is the button
Seat 1: Clappasaur ($14.32 in chips) 
Seat 2: Lord_of_days ($13.20 in chips) 
Seat 3: densamara_63 ($12.48 in chips) 
Seat 4: Cloud5918 ($5.43 in chips) 
Seat 5: appu001 ($6.91 in chips) 
Seat 6: alexos04 ($17.09 in chips) 
densamara_63: posts small blind $0.05
Cloud5918: posts big blind $0.10
*** HOLE CARDS ***
appu001: folds 
alexos04: folds 
Clappasaur: folds 
Lord_of_days: raises $0.20 to $0.30
densamara_63: folds 
Cloud5918: calls $0.20
*** FLOP *** [7s 8h 7h]
Cloud5918: bets $0.50
Lord_of_days: folds 
Uncalled bet ($0.50) returned to Cloud5918
Cloud5918 collected $0.62 from pot
Cloud5918: doesn't show hand 
*** SUMMARY ***
Total pot $0.65 | Rake $0.03 
Board [7s 8h 7h]
Seat 1: Clappasaur folded before Flop (didn't bet)
Seat 2: Lord_of_days (button) folded on the Flop
Seat 3: densamara_63 (small blind) folded before Flop
Seat 4: Cloud5918 (big blind) collected ($0.62)
Seat 5: appu001 folded before Flop (didn't bet)
Seat 6: alexos04 folded before Flop (didn't bet)



PokerStars Hand #222958755614:  Hold'em No Limit ($0.05/$0.10 USD) - 2021/01/23 11:21:06 ET
Table 'Polydoros II' 6-max Seat #3 is the button
Seat 1: Clappasaur ($14.32 in chips) 
Seat 2: Lord_of_days ($12.90 in chips) 
Seat 3: densamara_63 ($12.43 in chips) 
Seat 4: Cloud5918 ($5.75 in chips) 
Seat 5: appu001 ($6.91 in chips) 
Seat 6: alexos04 ($17.09 in chips) 
Cloud5918: posts small blind $0.05
appu001: posts big blind $0.10
*** HOLE CARDS ***
alexos04: folds 
Clappasaur: folds 
Lord_of_days: folds 
densamara_63: folds 
Cloud5918: calls $0.05
appu001: checks 
*** FLOP *** [8s 2h 3h]
Cloud5918: checks 
appu001: checks 
*** TURN *** [8s 2h 3h] [Qs]
Cloud5918: bets $0.30
appu001: folds 
Uncalled bet ($0.30) returned to Cloud5918
Cloud5918 collected $0.19 from pot
Cloud5918: doesn't show hand 
*** SUMMARY ***
Total pot $0.20 | Rake $0.01 
Board [8s 2h 3h Qs]
Seat 1: Clappasaur folded before Flop (didn't bet)
Seat 2: Lord_of_days folded before Flop (didn't bet)
Seat 3: densamara_63 (button) folded before Flop (didn't bet)
Seat 4: Cloud5918 (small blind) collected ($0.19)
Seat 5: appu001 (big blind) folded on the Turn
Seat 6: alexos04 folded before Flop (didn't bet)



PokerStars Hand #222958772632:  Hold'em No Limit ($0.05/$0.10 USD) - 2021/01/23 11:21:34 ET
Table 'Polydoros II' 6-max Seat #4 is the button
Seat 1: Clappasaur ($14.32 in chips) 
Seat 2: Lord_of_days ($12.90 in chips) 
Seat 3: densamara_63 ($12.43 in chips) 
Seat 4: Cloud5918 ($5.84 in chips) 
Seat 5: appu001 ($6.81 in chips) 
Seat 6: alexos04 ($17.09 in chips) 
appu001: posts small blind $0.05
alexos04: posts big blind $0.10
*** HOLE CARDS ***
Clappasaur: folds 
Lord_of_days: folds 
densamara_63: folds 
Cloud5918: calls $0.10
appu001: raises $0.10 to $0.20
alexos04: folds 
Cloud5918: calls $0.10
*** FLOP *** [8h 7h 3s]
appu001: bets $0.50
Cloud5918: folds 
Uncalled bet ($0.50) returned to appu001
appu001 collected $0.48 from pot
appu001: doesn't show hand 
*** SUMMARY ***
Total pot $0.50 | Rake $0.02 
Board [8h 7h 3s]
Seat 1: Clappasaur folded before Flop (didn't bet)
Seat 2: Lord_of_days folded before Flop (didn't bet)
Seat 3: densamara_63 folded before Flop (didn't bet)
Seat 4: Cloud5918 (button) folded on the Flop
Seat 5: appu001 (small blind) collected ($0.48)
Seat 6: alexos04 (big blind) folded before Flop



PokerStars Hand #222958789958:  Hold'em No Limit ($0.05/$0.10 USD) - 2021/01/23 11:22:02 ET
Table 'Polydoros II' 6-max Seat #5 is the button
Seat 1: Clappasaur ($14.32 in chips) 
Seat 2: Lord_of_days ($12.90 in chips) 
Seat 3: densamara_63 ($12.43 in chips) 
Seat 4: Cloud5918 ($5.64 in chips) 
Seat 5: appu001 ($7.09 in chips) 
Seat 6: alexos04 ($16.99 in chips) 
alexos04: posts small blind $0.05
Clappasaur: posts big blind $0.10
*** HOLE CARDS ***
Lord_of_days: folds 
densamara_63: folds 
Cloud5918: folds 
appu001: calls $0.10
alexos04: folds 
Clappasaur: checks 
*** FLOP *** [8s Kh Qc]
Clappasaur: checks 
appu001: checks 
*** TURN *** [8s Kh Qc] [Js]
Clappasaur: bets $0.12
appu001: raises $0.88 to $1
Clappasaur: calls $0.88
*** RIVER *** [8s Kh Qc Js] [4h]
Clappasaur: checks 
appu001: bets $2
Clappasaur: folds 
Uncalled bet ($2) returned to appu001
appu001 collected $2.15 from pot
appu001: doesn't show hand 
*** SUMMARY ***
Total pot $2.25 | Rake $0.10 
Board [8s Kh Qc Js 4h]
Seat 1: Clappasaur (big blind) folded on the River
Seat 2: Lord_of_days folded before Flop (didn't bet)
Seat 3: densamara_63 folded before Flop (didn't bet)
Seat 4: Cloud5918 folded before Flop (didn't bet)
Seat 5: appu001 (button) collected ($2.15)
Seat 6: alexos04 (small blind) folded before Flop



PokerStars Hand #222958819185:  Hold'em No Limit ($0.05/$0.10 USD) - 2021/01/23 11:22:50 ET
Table 'Polydoros II' 6-max Seat #6 is the button
Seat 1: Clappasaur ($13.22 in chips) 
Seat 2: Lord_of_days ($12.90 in chips) 
Seat 3: densamara_63 ($12.43 in chips) 
Seat 4: Cloud5918 ($5.64 in chips) 
Seat 5: appu001 ($8.14 in chips) 
Seat 6: alexos04 ($16.94 in chips) 
Clappasaur: posts small blind $0.05
Lord_of_days: posts big blind $0.10
*** HOLE CARDS ***
densamara_63: folds 
Cloud5918: folds 
appu001: folds 
alexos04: raises $0.20 to $0.30
Clappasaur: folds 
Lord_of_days: calls $0.20
*** FLOP *** [3h 9h 8c]
Lord_of_days: checks 
alexos04: bets $0.40
Lord_of_days: raises $0.80 to $1.20
alexos04: folds 
Uncalled bet ($0.80) returned to Lord_of_days
Lord_of_days collected $1.38 from pot
Lord_of_days: doesn't show hand 
*** SUMMARY ***
Total pot $1.45 | Rake $0.07 
Board [3h 9h 8c]
Seat 1: Clappasaur (small blind) folded before Flop
Seat 2: Lord_of_days (big blind) collected ($1.38)
Seat 3: densamara_63 folded before Flop (didn't bet)
Seat 4: Cloud5918 folded before Flop (didn't bet)
Seat 5: appu001 folded before Flop (didn't bet)
Seat 6: alexos04 (button) folded on the Flop



PokerStars Hand #222958838891:  Hold'em No Limit ($0.05/$0.10 USD) - 2021/01/23 11:23:23 ET
Table 'Polydoros II' 6-max Seat #1 is the button
Seat 1: Clappasaur ($13.17 in chips) 
Seat 2: Lord_of_days ($13.58 in chips) 
Seat 3: densamara_63 ($12.43 in chips) 
Seat 4: Cloud5918 ($5.64 in chips) 
Seat 5: appu001 ($8.14 in chips) 
Seat 6: alexos04 ($16.24 in chips) 
Lord_of_days: posts small blind $0.05
densamara_63: posts big blind $0.10
*** HOLE CARDS ***
Cloud5918: calls $0.10
appu001: calls $0.10
alexos04: raises $0.40 to $0.50
Clappasaur: folds 
Lord_of_days: folds 
densamara_63: folds 
Cloud5918: folds 
appu001: calls $0.40
*** FLOP *** [3d 3h 7h]
appu001: checks 
alexos04: bets $0.60
appu001: raises $0.60 to $1.20
alexos04: folds 
Uncalled bet ($0.60) returned to appu001
appu001 collected $2.34 from pot
appu001: doesn't show hand 
*** SUMMARY ***
Total pot $2.45 | Rake $0.11 
Board [3d 3h 7h]
Seat 1: Clappasaur (button) folded before Flop (didn't bet)
Seat 2: Lord_of_days (small blind) folded before Flop
Seat 3: densamara_63 (big blind) folded before Flop
Seat 4: Cloud5918 folded before Flop
Seat 5: appu001 collected ($2.34)
Seat 6: alexos04 folded on the Flop



PokerStars Hand #222958860923:  Hold'em No Limit ($0.05/$0.10 USD) - 2021/01/23 11:23:59 ET
Table 'Polydoros II' 6-max Seat #2 is the button
Seat 1: Clappasaur ($13.17 in chips) 
Seat 2: Lord_of_days ($13.53 in chips) 
Seat 3: densamara_63 ($12.33 in chips) 
Seat 4: Cloud5918 ($5.54 in chips) 
Seat 5: appu001 ($9.38 in chips) 
Seat 6: alexos04 ($15.14 in chips) 
densamara_63: posts small blind $0.05
Cloud5918: posts big blind $0.10
*** HOLE CARDS ***
appu001: calls $0.10
alexos04: folds 
Clappasaur: raises $0.20 to $0.30
Lord_of_days: folds 
densamara_63: folds 
Cloud5918: calls $0.20
appu001: calls $0.20
*** FLOP *** [3d 4s Jc]
Cloud5918: checks 
appu001: checks 
Clappasaur: bets $0.50
Cloud5918: calls $0.50
appu001: calls $0.50
*** TURN *** [3d 4s Jc] [7s]
Cloud5918: checks 
appu001: checks 
Clappasaur: bets $1.60
Cloud5918: folds 
appu001: calls $1.60
*** RIVER *** [3d 4s Jc 7s] [8c]
appu001: checks 
Clappasaur: bets $3.10
appu001: folds 
Uncalled bet ($3.10) returned to Clappasaur
Clappasaur collected $5.40 from pot
Clappasaur: doesn't show hand 
*** SUMMARY ***
Total pot $5.65 | Rake $0.25 
Board [3d 4s Jc 7s 8c]
Seat 1: Clappasaur collected ($5.40)
Seat 2: Lord_of_days (button) folded before Flop (didn't bet)
Seat 3: densamara_63 (small blind) folded before Flop
Seat 4: Cloud5918 (big blind) folded on the Turn
Seat 5: appu001 folded on the River
Seat 6: alexos04 folded before Flop (didn't bet)



PokerStars Hand #222958906977:  Hold'em No Limit ($0.05/$0.10 USD) - 2021/01/23 11:25:15 ET
Table 'Polydoros II' 6-max Seat #3 is the button
Seat 1: Clappasaur ($16.17 in chips) 
Seat 2: Lord_of_days ($13.53 in chips) 
Seat 3: densamara_63 ($12.28 in chips) 
Seat 4: Cloud5918 ($4.74 in chips) 
Seat 5: appu001 ($6.98 in chips) 
Seat 6: alexos04 ($15.14 in chips) 
Cloud5918: posts small blind $0.05
appu001: posts big blind $0.10
*** HOLE CARDS ***
alexos04: folds 
Clappasaur: folds 
Lord_of_days: raises $0.20 to $0.30
densamara_63: calls $0.30
Cloud5918: calls $0.25
appu001: calls $0.20
*** FLOP *** [5c Kh 6s]
Cloud5918: checks 
appu001: checks 
Lord_of_days: bets $0.38
densamara_63: folds 
Cloud5918: folds 
appu001: calls $0.38
*** TURN *** [5c Kh 6s] [6h]
appu001: checks 
Lord_of_days: bets $1.10
appu001: calls $1.10
*** RIVER *** [5c Kh 6s 6h] [Tc]
appu001: checks 
Lord_of_days: bets $1.31
appu001: calls $1.31
*** SHOW DOWN ***
Lord_of_days: shows [Ks Qd] (two pair, Kings and Sixes)
appu001: mucks hand 
Lord_of_days collected $6.47 from pot
*** SUMMARY ***
Total pot $6.78 | Rake $0.31 
Board [5c Kh 6s 6h Tc]
Seat 1: Clappasaur folded before Flop (didn't bet)
Seat 2: Lord_of_days showed [Ks Qd] and won ($6.47) with two pair, Kings and Sixes
Seat 3: densamara_63 (button) folded on the Flop
Seat 4: Cloud5918 (small blind) folded on the Flop
Seat 5: appu001 (big blind) mucked
Seat 6: alexos04 folded before Flop (didn't bet)



PokerStars Hand #222958931450:  Hold'em No Limit ($0.05/$0.10 USD) - 2021/01/23 11:25:55 ET
Table 'Polydoros II' 6-max Seat #4 is the button
Seat 1: Clappasaur ($16.17 in chips) 
Seat 2: Lord_of_days ($16.91 in chips) 
Seat 3: densamara_63 ($11.98 in chips) 
Seat 4: Cloud5918 ($4.44 in chips) 
Seat 5: appu001 ($3.89 in chips) 
Seat 6: alexos04 ($15.14 in chips) 
appu001: posts small blind $0.05
alexos04: posts big blind $0.10
*** HOLE CARDS ***
Clappasaur: raises $0.10 to $0.20
Lord_of_days: folds 
densamara_63: folds 
Cloud5918: calls $0.20
appu001: calls $0.15
alexos04: calls $0.10
*** FLOP *** [Td 3h 8d]
appu001: bets $3.69 and is all-in
alexos04: folds 
Clappasaur: calls $3.69
Cloud5918: folds 
*** TURN *** [Td 3h 8d] [Qs]
*** RIVER *** [Td 3h 8d Qs] [8c]
*** SHOW DOWN ***
appu001: shows [3s 2d] (two pair, Eights and Threes)
Clappasaur: shows [Jc 9h] (a straight, Eight to Queen)
Clappasaur collected $7.81 from pot
*** SUMMARY ***
Total pot $8.18 | Rake $0.37 
Board [Td 3h 8d Qs 8c]
Seat 1: Clappasaur showed [Jc 9h] and won ($7.81) with a straight, Eight to Queen
Seat 2: Lord_of_days folded before Flop (didn't bet)
Seat 3: densamara_63 folded before Flop (didn't bet)
Seat 4: Cloud5918 (button) folded on the Flop
Seat 5: appu001 (small blind) showed [3s 2d] and lost with two pair, Eights and Threes
Seat 6: alexos04 (big blind) folded on the Flop



PokerStars Hand #222958969180:  Hold'em No Limit ($0.05/$0.10 USD) - 2021/01/23 11:26:53 ET
Table 'Polydoros II' 6-max Seat #6 is the button
Seat 1: Clappasaur ($20.09 in chips) 
Seat 2: Lord_of_days ($16.91 in chips) 
Seat 3: densamara_63 ($11.98 in chips) 
Seat 4: Cloud5918 ($4.24 in chips) 
Seat 6: alexos04 ($14.94 in chips) 
Clappasaur: posts small blind $0.05
Lord_of_days: posts big blind $0.10
*** HOLE CARDS ***
densamara_63: folds 
Cloud5918: folds 
alexos04: folds 
Clappasaur: raises $0.10 to $0.20
Lord_of_days: calls $0.10
*** FLOP *** [As Ad 3c]
Clappasaur: checks 
Lord_of_days: bets $0.13
Clappasaur: calls $0.13
*** TURN *** [As Ad 3c] [Td]
Clappasaur: checks 
Lord_of_days: bets $0.52
Clappasaur: folds 
Uncalled bet ($0.52) returned to Lord_of_days
Lord_of_days collected $0.63 from pot
Lord_of_days: doesn't show hand 
*** SUMMARY ***
Total pot $0.66 | Rake $0.03 
Board [As Ad 3c Td]
Seat 1: Clappasaur (small blind) folded on the Turn
Seat 2: Lord_of_days (big blind) collected ($0.63)
Seat 3: densamara_63 folded before Flop (didn't bet)
Seat 4: Cloud5918 folded before Flop (didn't bet)
Seat 6: alexos04 (button) folded before Flop (didn't bet)



PokerStars Hand #222958995383:  Hold'em No Limit ($0.05/$0.10 USD) - 2021/01/23 11:27:35 ET
Table 'Polydoros II' 6-max Seat #1 is the button
Seat 1: Clappasaur ($19.76 in chips) 
Seat 2: Lord_of_days ($17.21 in chips) 
Seat 3: densamara_63 ($11.98 in chips) 
Seat 4: Cloud5918 ($4.24 in chips) 
Seat 6: alexos04 ($14.94 in chips) 
Lord_of_days: posts small blind $0.05
densamara_63: posts big blind $0.10
*** HOLE CARDS ***
Cloud5918: calls $0.10
alexos04: folds 
Clappasaur: raises $0.20 to $0.30
Lord_of_days: folds 
densamara_63: folds 
Cloud5918: calls $0.20
*** FLOP *** [6c Jd Qd]
Cloud5918: checks 
Clappasaur: bets $0.40
Cloud5918: raises $0.50 to $0.90
Clappasaur: calls $0.50
*** TURN *** [6c Jd Qd] [Td]
Cloud5918: bets $1.50
Clappasaur: folds [Jc Ac]
Uncalled bet ($1.50) returned to Cloud5918
Cloud5918 collected $2.44 from pot
Cloud5918: doesn't show hand 
*** SUMMARY ***
Total pot $2.55 | Rake $0.11 
Board [6c Jd Qd Td]
Seat 1: Clappasaur (button) folded on the Turn
Seat 2: Lord_of_days (small blind) folded before Flop
Seat 3: densamara_63 (big blind) folded before Flop
Seat 4: Cloud5918 collected ($2.44)
Seat 6: alexos04 folded before Flop (didn't bet)



PokerStars Hand #222959042861:  Hold'em No Limit ($0.05/$0.10 USD) - 2021/01/23 11:28:53 ET
Table 'Polydoros II' 6-max Seat #2 is the button
Seat 1: Clappasaur ($18.56 in chips) 
Seat 2: Lord_of_days ($17.16 in chips) 
Seat 3: densamara_63 ($11.88 in chips) 
Seat 4: Cloud5918 ($5.48 in chips) 
Seat 5: appu001 ($4.88 in chips) 
Seat 6: alexos04 ($14.94 in chips) 
densamara_63: posts small blind $0.05
Cloud5918: posts big blind $0.10
*** HOLE CARDS ***
appu001: folds 
alexos04: raises $0.20 to $0.30
Clappasaur: calls $0.30
Lord_of_days: folds 
densamara_63: folds 
Cloud5918: calls $0.20
*** FLOP *** [3s 8d Ac]
Cloud5918: bets $0.50
alexos04: calls $0.50
Clappasaur: folds 
*** TURN *** [3s 8d Ac] [9s]
Cloud5918: checks 
alexos04: checks 
*** RIVER *** [3s 8d Ac 9s] [8h]
Cloud5918: checks 
alexos04: bets $0.70
Cloud5918: folds 
Uncalled bet ($0.70) returned to alexos04
alexos04 collected $1.86 from pot
alexos04: doesn't show hand 
*** SUMMARY ***
Total pot $1.95 | Rake $0.09 
Board [3s 8d Ac 9s 8h]
Seat 1: Clappasaur folded on the Flop
Seat 2: Lord_of_days (button) folded before Flop (didn't bet)
Seat 3: densamara_63 (small blind) folded before Flop
Seat 4: Cloud5918 (big blind) folded on the River
Seat 5: appu001 folded before Flop (didn't bet)
Seat 6: alexos04 collected ($1.86)



PokerStars Hand #222959078426:  Hold'em No Limit ($0.05/$0.10 USD) - 2021/01/23 11:29:49 ET
Table 'Polydoros II' 6-max Seat #3 is the button
Seat 1: Clappasaur ($18.26 in chips) 
Seat 2: Lord_of_days ($17.16 in chips) 
Seat 3: densamara_63 ($11.83 in chips) 
Seat 4: Cloud5918 ($4.68 in chips) 
Seat 5: appu001 ($4.88 in chips) 
Seat 6: alexos04 ($16 in chips) 
Cloud5918: posts small blind $0.05
appu001: posts big blind $0.10
*** HOLE CARDS ***
alexos04: folds 
Clappasaur: folds 
Lord_of_days: folds 
densamara_63: raises $0.12 to $0.22
Cloud5918: folds 
appu001: calls $0.12
*** FLOP *** [5d 4d Td]
appu001: checks 
densamara_63: bets $0.28
appu001: calls $0.28
*** TURN *** [5d 4d Td] [4h]
appu001: checks 
densamara_63: checks 
*** RIVER *** [5d 4d Td 4h] [3h]
appu001: bets $4.38 and is all-in
densamara_63: folds 
Uncalled bet ($4.38) returned to appu001
appu001 collected $1 from pot
appu001: doesn't show hand 
*** SUMMARY ***
Total pot $1.05 | Rake $0.05 
Board [5d 4d Td 4h 3h]
Seat 1: Clappasaur folded before Flop (didn't bet)
Seat 2: Lord_of_days folded before Flop (didn't bet)
Seat 3: densamara_63 (button) folded on the River
Seat 4: Cloud5918 (small blind) folded before Flop
Seat 5: appu001 (big blind) collected ($1)
Seat 6: alexos04 folded before Flop (didn't bet)



PokerStars Hand #222959112293:  Hold'em No Limit ($0.05/$0.10 USD) - 2021/01/23 11:30:44 ET
Table 'Polydoros II' 6-max Seat #4 is the button
Seat 1: Clappasaur ($18.26 in chips) 
Seat 2: Lord_of_days ($17.16 in chips) 
Seat 3: densamara_63 ($11.33 in chips) 
Seat 4: Cloud5918 ($4.63 in chips) 
Seat 5: appu001 ($5.38 in chips) 
Seat 6: alexos04 ($16 in chips) 
appu001: posts small blind $0.05
alexos04: posts big blind $0.10
*** HOLE CARDS ***
Clappasaur: raises $0.10 to $0.20
Lord_of_days: raises $0.40 to $0.60
densamara_63: folds 
Cloud5918: folds 
appu001: folds 
alexos04: folds 
Clappasaur: calls $0.40
*** FLOP *** [2s Ks Kc]
Clappasaur: checks 
Lord_of_days: bets $0.43
Clappasaur: folds 
Uncalled bet ($0.43) returned to Lord_of_days
Lord_of_days collected $1.29 from pot
Lord_of_days: doesn't show hand 
*** SUMMARY ***
Total pot $1.35 | Rake $0.06 
Board [2s Ks Kc]
Seat 1: Clappasaur folded on the Flop
Seat 2: Lord_of_days collected ($1.29)
Seat 3: densamara_63 folded before Flop (didn't bet)
Seat 4: Cloud5918 (button) folded before Flop (didn't bet)
Seat 5: appu001 (small blind) folded before Flop
Seat 6: alexos04 (big blind) folded before Flop



PokerStars Hand #222959130266:  Hold'em No Limit ($0.05/$0.10 USD) - 2021/01/23 11:31:14 ET
Table 'Polydoros II' 6-max Seat #5 is the button
Seat 1: Clappasaur ($17.66 in chips) 
Seat 2: Lord_of_days ($17.85 in chips) 
Seat 3: densamara_63 ($11.33 in chips) 
Seat 4: Cloud5918 ($4.63 in chips) 
Seat 5: appu001 ($5.33 in chips) 
Seat 6: alexos04 ($15.90 in chips) 
alexos04: posts small blind $0.05
Clappasaur: posts big blind $0.10
*** HOLE CARDS ***
Lord_of_days: folds 
densamara_63: raises $0.20 to $0.30
Cloud5918: raises $1 to $1.30
appu001: folds 
alexos04: folds 
Clappasaur: folds 
densamara_63: folds 
Uncalled bet ($1) returned to Cloud5918
Cloud5918 collected $0.75 from pot
Cloud5918: doesn't show hand 
*** SUMMARY ***
Total pot $0.75 | Rake $0 
Seat 1: Clappasaur (big blind) folded before Flop
Seat 2: Lord_of_days folded before Flop (didn't bet)
Seat 3: densamara_63 folded before Flop
Seat 4: Cloud5918 collected ($0.75)
Seat 5: appu001 (button) folded before Flop (didn't bet)
Seat 6: alexos04 (small blind) folded before Flop



PokerStars Hand #222959154374:  Hold'em No Limit ($0.05/$0.10 USD) - 2021/01/23 11:31:53 ET
Table 'Polydoros II' 6-max Seat #6 is the button
Seat 1: Clappasaur ($17.56 in chips) 
Seat 2: Lord_of_days ($17.85 in chips) 
Seat 3: densamara_63 ($11.03 in chips) 
Seat 4: Cloud5918 ($5.08 in chips) 
Seat 5: appu001 ($5.33 in chips) 
Seat 6: alexos04 ($15.85 in chips) 
Clappasaur: posts small blind $0.05
Lord_of_days: posts big blind $0.10
*** HOLE CARDS ***
densamara_63: raises $0.20 to $0.30
Cloud5918: folds 
appu001: folds 
alexos04: folds 
Clappasaur: calls $0.25
Lord_of_days: folds 
*** FLOP *** [3c Qs 4h]
Clappasaur: checks 
densamara_63: bets $0.23
Clappasaur: folds 
Uncalled bet ($0.23) returned to densamara_63
densamara_63 collected $0.67 from pot
*** SUMMARY ***
Total pot $0.70 | Rake $0.03 
Board [3c Qs 4h]
Seat 1: Clappasaur (small blind) folded on the Flop
Seat 2: Lord_of_days (big blind) folded before Flop
Seat 3: densamara_63 collected ($0.67)
Seat 4: Cloud5918 folded before Flop (didn't bet)
Seat 5: appu001 folded before Flop (didn't bet)
Seat 6: alexos04 (button) folded before Flop (didn't bet)



PokerStars Hand #222959174151:  Hold'em No Limit ($0.05/$0.10 USD) - 2021/01/23 11:32:25 ET
Table 'Polydoros II' 6-max Seat #1 is the button
Seat 1: Clappasaur ($17.26 in chips) 
Seat 2: Lord_of_days ($17.75 in chips) 
Seat 3: densamara_63 ($11.40 in chips) 
Seat 4: Cloud5918 ($5.08 in chips) 
Seat 5: appu001 ($5.33 in chips) 
Seat 6: alexos04 ($15.85 in chips) 
Lord_of_days: posts small blind $0.05
densamara_63: posts big blind $0.10
*** HOLE CARDS ***
Cloud5918: calls $0.10
appu001: calls $0.10
alexos04: folds 
Clappasaur: raises $0.20 to $0.30
Lord_of_days: folds 
densamara_63: calls $0.20
Cloud5918: raises $4.78 to $5.08 and is all-in
appu001: folds 
Clappasaur: folds 
densamara_63: folds 
Uncalled bet ($4.78) returned to Cloud5918
Cloud5918 collected $1.05 from pot
Cloud5918: doesn't show hand 
*** SUMMARY ***
Total pot $1.05 | Rake $0 
Seat 1: Clappasaur (button) folded before Flop
Seat 2: Lord_of_days (small blind) folded before Flop
Seat 3: densamara_63 (big blind) folded before Flop
Seat 4: Cloud5918 collected ($1.05)
Seat 5: appu001 folded before Flop
Seat 6: alexos04 folded before Flop (didn't bet)



PokerStars Hand #222959193101:  Hold'em No Limit ($0.05/$0.10 USD) - 2021/01/23 11:32:55 ET
Table 'Polydoros II' 6-max Seat #2 is the button
Seat 1: Clappasaur ($16.96 in chips) 
Seat 2: Lord_of_days ($17.70 in chips) 
Seat 3: densamara_63 ($11.10 in chips) 
Seat 4: Cloud5918 ($5.83 in chips) 
Seat 5: appu001 ($5.23 in chips) 
Seat 6: alexos04 ($15.85 in chips) 
densamara_63: posts small blind $0.05
Cloud5918: posts big blind $0.10
*** HOLE CARDS ***
appu001: raises $0.10 to $0.20
alexos04: folds 
Clappasaur: folds 
Lord_of_days: raises $0.40 to $0.60
densamara_63: raises $0.90 to $1.50
Cloud5918: folds 
appu001: calls $1.30
Lord_of_days: raises $2.90 to $4.40
densamara_63: folds 
appu001: calls $2.90
*** FLOP *** [8s 9h 7s]
appu001: bets $0.83 and is all-in
Lord_of_days: calls $0.83
*** TURN *** [8s 9h 7s] [8h]
*** RIVER *** [8s 9h 7s 8h] [Ah]
*** SHOW DOWN ***
appu001: shows [Th Qh] (a flush, Ace high)
Lord_of_days: shows [Kc Ad] (two pair, Aces and Eights)
appu001 collected $11.52 from pot
*** SUMMARY ***
Total pot $12.06 | Rake $0.54 
Board [8s 9h 7s 8h Ah]
Seat 1: Clappasaur folded before Flop (didn't bet)
Seat 2: Lord_of_days (button) showed [Kc Ad] and lost with two pair, Aces and Eights
Seat 3: densamara_63 (small blind) folded before Flop
Seat 4: Cloud5918 (big blind) folded before Flop
Seat 5: appu001 showed [Th Qh] and won ($11.52) with a flush, Ace high
Seat 6: alexos04 folded before Flop (didn't bet)



PokerStars Hand #222959229754:  Hold'em No Limit ($0.05/$0.10 USD) - 2021/01/23 11:33:55 ET
Table 'Polydoros II' 6-max Seat #3 is the button
Seat 1: Clappasaur ($16.96 in chips) 
Seat 2: Lord_of_days ($12.47 in chips) 
Seat 3: densamara_63 ($10 in chips) 
Seat 4: Cloud5918 ($5.73 in chips) 
Seat 5: appu001 ($11.52 in chips) 
Seat 6: alexos04 ($15.85 in chips) 
Cloud5918: posts small blind $0.05
appu001: posts big blind $0.10
*** HOLE CARDS ***
alexos04: folds 
Clappasaur: raises $0.20 to $0.30
Lord_of_days: folds 
densamara_63: calls $0.30
Cloud5918: calls $0.25
appu001: calls $0.20
*** FLOP *** [5d Js 9d]
Cloud5918: bets $0.57
appu001: folds 
Clappasaur: folds 
densamara_63: folds 
Uncalled bet ($0.57) returned to Cloud5918
Cloud5918 collected $1.15 from pot
Cloud5918: doesn't show hand 
*** SUMMARY ***
Total pot $1.20 | Rake $0.05 
Board [5d Js 9d]
Seat 1: Clappasaur folded on the Flop
Seat 2: Lord_of_days folded before Flop (didn't bet)
Seat 3: densamara_63 (button) folded on the Flop
Seat 4: Cloud5918 (small blind) collected ($1.15)
Seat 5: appu001 (big blind) folded on the Flop
Seat 6: alexos04 folded before Flop (didn't bet)



PokerStars Hand #222959257814:  Hold'em No Limit ($0.05/$0.10 USD) - 2021/01/23 11:34:40 ET
Table 'Polydoros II' 6-max Seat #4 is the button
Seat 1: Clappasaur ($16.66 in chips) 
Seat 2: Lord_of_days ($12.47 in chips) 
Seat 3: densamara_63 ($10 in chips) 
Seat 4: Cloud5918 ($6.58 in chips) 
Seat 5: appu001 ($11.22 in chips) 
Seat 6: alexos04 ($15.85 in chips) 
appu001: posts small blind $0.05
alexos04: posts big blind $0.10
*** HOLE CARDS ***
Clappasaur: raises $0.10 to $0.20
Lord_of_days: folds 
densamara_63: raises $0.70 to $0.90
Cloud5918: folds 
appu001: folds 
alexos04: folds 
Clappasaur: calls $0.70
*** FLOP *** [7h 5s Ah]
Clappasaur: checks 
densamara_63: bets $0.65
Clappasaur: calls $0.65
*** TURN *** [7h 5s Ah] [6c]
Clappasaur: checks 
densamara_63: checks 
*** RIVER *** [7h 5s Ah 6c] [Ks]
Clappasaur: checks 
densamara_63: checks 
*** SHOW DOWN ***
Clappasaur: shows [8d 9s] (a straight, Five to Nine)
densamara_63: mucks hand 
Clappasaur collected $3.10 from pot
*** SUMMARY ***
Total pot $3.25 | Rake $0.15 
Board [7h 5s Ah 6c Ks]
Seat 1: Clappasaur showed [8d 9s] and won ($3.10) with a straight, Five to Nine
Seat 2: Lord_of_days folded before Flop (didn't bet)
Seat 3: densamara_63 mucked
Seat 4: Cloud5918 (button) folded before Flop (didn't bet)
Seat 5: appu001 (small blind) folded before Flop
Seat 6: alexos04 (big blind) folded before Flop



PokerStars Hand #222959292411:  Hold'em No Limit ($0.05/$0.10 USD) - 2021/01/23 11:35:28 ET
Table 'Polydoros II' 6-max Seat #5 is the button
Seat 1: Clappasaur ($18.21 in chips) 
Seat 2: Lord_of_days ($12.47 in chips) 
Seat 3: densamara_63 ($10 in chips) 
Seat 4: Cloud5918 ($6.58 in chips) 
Seat 5: appu001 ($11.17 in chips) 
Seat 6: alexos04 ($15.75 in chips) 
alexos04: posts small blind $0.05
Clappasaur: posts big blind $0.10
*** HOLE CARDS ***
Lord_of_days: folds 
densamara_63: folds 
Cloud5918: folds 
appu001: raises $0.10 to $0.20
alexos04: folds 
Clappasaur: calls $0.10
*** FLOP *** [5h Ts Jh]
Clappasaur: checks 
appu001: checks 
*** TURN *** [5h Ts Jh] [8d]
Clappasaur: checks 
appu001: checks 
*** RIVER *** [5h Ts Jh 8d] [7d]
Clappasaur: checks 
appu001: bets $1
Clappasaur: folds 
Uncalled bet ($1) returned to appu001
appu001 collected $0.43 from pot
appu001: doesn't show hand 
*** SUMMARY ***
Total pot $0.45 | Rake $0.02 
Board [5h Ts Jh 8d 7d]
Seat 1: Clappasaur (big blind) folded on the River
Seat 2: Lord_of_days folded before Flop (didn't bet)
Seat 3: densamara_63 folded before Flop (didn't bet)
Seat 4: Cloud5918 folded before Flop (didn't bet)
Seat 5: appu001 (button) collected ($0.43)
Seat 6: alexos04 (small blind) folded before Flop



PokerStars Hand #222959312862:  Hold'em No Limit ($0.05/$0.10 USD) - 2021/01/23 11:36:01 ET
Table 'Polydoros II' 6-max Seat #6 is the button
Seat 1: Clappasaur ($18.01 in chips) 
Seat 2: Lord_of_days ($12.47 in chips) 
Seat 3: densamara_63 ($10 in chips) 
Seat 4: Cloud5918 ($6.58 in chips) 
Seat 5: appu001 ($11.40 in chips) 
Seat 6: alexos04 ($15.70 in chips) 
Clappasaur: posts small blind $0.05
Lord_of_days: posts big blind $0.10
*** HOLE CARDS ***
densamara_63: folds 
Cloud5918: folds 
appu001: raises $0.20 to $0.30
alexos04: folds 
Clappasaur: folds 
Lord_of_days: folds 
Uncalled bet ($0.20) returned to appu001
appu001 collected $0.25 from pot
appu001: doesn't show hand 
*** SUMMARY ***
Total pot $0.25 | Rake $0 
Seat 1: Clappasaur (small blind) folded before Flop
Seat 2: Lord_of_days (big blind) folded before Flop
Seat 3: densamara_63 folded before Flop (didn't bet)
Seat 4: Cloud5918 folded before Flop (didn't bet)
Seat 5: appu001 collected ($0.25)
Seat 6: alexos04 (button) folded before Flop (didn't bet)



PokerStars Hand #222959320345:  Hold'em No Limit ($0.05/$0.10 USD) - 2021/01/23 11:36:14 ET
Table 'Polydoros II' 6-max Seat #1 is the button
Seat 1: Clappasaur ($17.96 in chips) 
Seat 2: Lord_of_days ($12.37 in chips) 
Seat 3: densamara_63 ($10 in chips) 
Seat 4: Cloud5918 ($6.58 in chips) 
Seat 5: appu001 ($11.55 in chips) 
Seat 6: alexos04 ($15.70 in chips) 
Lord_of_days: posts small blind $0.05
densamara_63: posts big blind $0.10
*** HOLE CARDS ***
Cloud5918: folds 
appu001: calls $0.10
alexos04: raises $0.40 to $0.50
Clappasaur: raises $0.90 to $1.40
Lord_of_days: folds 
densamara_63: folds 
appu001: folds 
alexos04: folds 
Uncalled bet ($0.90) returned to Clappasaur
Clappasaur collected $1.25 from pot
Clappasaur: doesn't show hand 
*** SUMMARY ***
Total pot $1.25 | Rake $0 
Seat 1: Clappasaur (button) collected ($1.25)
Seat 2: Lord_of_days (small blind) folded before Flop
Seat 3: densamara_63 (big blind) folded before Flop
Seat 4: Cloud5918 folded before Flop (didn't bet)
Seat 5: appu001 folded before Flop
Seat 6: alexos04 folded before Flop



PokerStars Hand #222959337612:  Hold'em No Limit ($0.05/$0.10 USD) - 2021/01/23 11:36:42 ET
Table 'Polydoros II' 6-max Seat #2 is the button
Seat 1: Clappasaur ($18.71 in chips) 
Seat 2: Lord_of_days ($12.32 in chips) 
Seat 3: densamara_63 ($10 in chips) 
Seat 4: Cloud5918 ($6.58 in chips) 
Seat 5: appu001 ($11.45 in chips) 
Seat 6: alexos04 ($15.20 in chips) 
densamara_63: posts small blind $0.05
Cloud5918: posts big blind $0.10
*** HOLE CARDS ***
appu001: raises $0.10 to $0.20
alexos04: folds 
Clappasaur: folds 
Lord_of_days: folds 
densamara_63: folds 
Cloud5918: calls $0.10
*** FLOP *** [9h 6c 4c]
Cloud5918: checks 
appu001: bets $0.50
Cloud5918: folds 
Uncalled bet ($0.50) returned to appu001
appu001 collected $0.43 from pot
appu001: doesn't show hand 
*** SUMMARY ***
Total pot $0.45 | Rake $0.02 
Board [9h 6c 4c]
Seat 1: Clappasaur folded before Flop (didn't bet)
Seat 2: Lord_of_days (button) folded before Flop (didn't bet)
Seat 3: densamara_63 (small blind) folded before Flop
Seat 4: Cloud5918 (big blind) folded on the Flop
Seat 5: appu001 collected ($0.43)
Seat 6: alexos04 folded before Flop (didn't bet)



PokerStars Hand #222959352731:  Hold'em No Limit ($0.05/$0.10 USD) - 2021/01/23 11:37:07 ET
Table 'Polydoros II' 6-max Seat #3 is the button
Seat 1: Clappasaur ($18.71 in chips) 
Seat 2: Lord_of_days ($12.32 in chips) 
Seat 3: densamara_63 ($10 in chips) 
Seat 4: Cloud5918 ($6.38 in chips) 
Seat 5: appu001 ($11.68 in chips) 
Seat 6: alexos04 ($15.20 in chips) 
Cloud5918: posts small blind $0.05
appu001: posts big blind $0.10
*** HOLE CARDS ***
alexos04: folds 
Clappasaur: folds 
Lord_of_days: raises $0.20 to $0.30
alexos04 leaves the table
densamara_63: raises $0.60 to $0.90
Cloud5918: folds 
appu001: folds 
Lord_of_days: folds 
Uncalled bet ($0.60) returned to densamara_63
densamara_63 collected $0.75 from pot
*** SUMMARY ***
Total pot $0.75 | Rake $0 
Seat 1: Clappasaur folded before Flop (didn't bet)
Seat 2: Lord_of_days folded before Flop
Seat 3: densamara_63 (button) collected ($0.75)
Seat 4: Cloud5918 (small blind) folded before Flop
Seat 5: appu001 (big blind) folded before Flop
Seat 6: alexos04 folded before Flop (didn't bet)



PokerStars Hand #222959363364:  Hold'em No Limit ($0.05/$0.10 USD) - 2021/01/23 11:37:24 ET
Table 'Polydoros II' 6-max Seat #4 is the button
Seat 1: Clappasaur ($18.71 in chips) 
Seat 2: Lord_of_days ($12.02 in chips) 
Seat 3: densamara_63 ($10.45 in chips) 
Seat 4: Cloud5918 ($6.33 in chips) 
Seat 5: appu001 ($11.58 in chips) 
appu001: posts small blind $0.05
Clappasaur: posts big blind $0.10
*** HOLE CARDS ***
Lord_of_days: folds 
densamara_63: raises $0.20 to $0.30
MARTIIRA joins the table at seat #6 
Cloud5918: folds 
appu001: folds 
Clappasaur: calls $0.20
*** FLOP *** [Ah Qh Jc]
Clappasaur: checks 
densamara_63: bets $0.22
Clappasaur: calls $0.22
*** TURN *** [Ah Qh Jc] [7c]
Clappasaur: checks 
densamara_63: bets $0.86
Clappasaur: folds 
Uncalled bet ($0.86) returned to densamara_63
densamara_63 collected $1.04 from pot
*** SUMMARY ***
Total pot $1.09 | Rake $0.05 
Board [Ah Qh Jc 7c]
Seat 1: Clappasaur (big blind) folded on the Turn
Seat 2: Lord_of_days folded before Flop (didn't bet)
Seat 3: densamara_63 collected ($1.04)
Seat 4: Cloud5918 (button) folded before Flop (didn't bet)
Seat 5: appu001 (small blind) folded before Flop



PokerStars Hand #222959375716:  Hold'em No Limit ($0.05/$0.10 USD) - 2021/01/23 11:37:44 ET
Table 'Polydoros II' 6-max Seat #5 is the button
Seat 1: Clappasaur ($18.19 in chips) 
Seat 2: Lord_of_days ($12.02 in chips) 
Seat 3: densamara_63 ($10.97 in chips) 
Seat 4: Cloud5918 ($6.33 in chips) 
Seat 5: appu001 ($11.53 in chips) 
Clappasaur: posts small blind $0.05
Lord_of_days: posts big blind $0.10
*** HOLE CARDS ***
densamara_63: raises $0.20 to $0.30
Cloud5918: folds 
appu001: folds 
Clappasaur: calls $0.25
Lord_of_days: folds 
*** FLOP *** [Ts Jd 2s]
Clappasaur: checks 
densamara_63: bets $0.40
Clappasaur: calls $0.40
*** TURN *** [Ts Jd 2s] [9c]
Clappasaur: checks 
densamara_63: bets $1.19
Clappasaur: calls $1.19
*** RIVER *** [Ts Jd 2s 9c] [Jh]
Clappasaur: checks 
densamara_63: bets $2.23
Clappasaur: folds 
Uncalled bet ($2.23) returned to densamara_63
densamara_63 collected $3.71 from pot
*** SUMMARY ***
Total pot $3.88 | Rake $0.17 
Board [Ts Jd 2s 9c Jh]
Seat 1: Clappasaur (small blind) folded on the River
Seat 2: Lord_of_days (big blind) folded before Flop
Seat 3: densamara_63 collected ($3.71)
Seat 4: Cloud5918 folded before Flop (didn't bet)
Seat 5: appu001 (button) folded before Flop (didn't bet)



PokerStars Hand #222959408218:  Hold'em No Limit ($0.05/$0.10 USD) - 2021/01/23 11:38:37 ET
Table 'Polydoros II' 6-max Seat #1 is the button
Seat 1: Clappasaur ($16.30 in chips) 
Seat 2: Lord_of_days ($11.92 in chips) 
Seat 3: densamara_63 ($12.79 in chips) 
Seat 4: Cloud5918 ($6.33 in chips) 
Seat 5: appu001 ($11.53 in chips) 
Lord_of_days: posts small blind $0.05
densamara_63: posts big blind $0.10
MARTIIRA: sits out 
*** HOLE CARDS ***
Cloud5918: folds 
appu001: folds 
Clappasaur: raises $0.20 to $0.30
Lord_of_days: folds 
densamara_63: calls $0.20
*** FLOP *** [Td 6c Jd]
densamara_63: checks 
Clappasaur: bets $0.40
densamara_63: calls $0.40
*** TURN *** [Td 6c Jd] [4d]
densamara_63: checks 
Clappasaur: bets $0.90
densamara_63: folds 
Uncalled bet ($0.90) returned to Clappasaur
Clappasaur collected $1.38 from pot
Clappasaur: doesn't show hand 
*** SUMMARY ***
Total pot $1.45 | Rake $0.07 
Board [Td 6c Jd 4d]
Seat 1: Clappasaur (button) collected ($1.38)
Seat 2: Lord_of_days (small blind) folded before Flop
Seat 3: densamara_63 (big blind) folded on the Turn
Seat 4: Cloud5918 folded before Flop (didn't bet)
Seat 5: appu001 folded before Flop (didn't bet)



PokerStars Hand #222959425894:  Hold'em No Limit ($0.05/$0.10 USD) - 2021/01/23 11:39:06 ET
Table 'Polydoros II' 6-max Seat #2 is the button
Seat 1: Clappasaur ($16.98 in chips) 
Seat 2: Lord_of_days ($11.87 in chips) 
Seat 3: densamara_63 ($12.09 in chips) 
Seat 4: Cloud5918 ($6.33 in chips) 
Seat 5: appu001 ($11.53 in chips) 
densamara_63: posts small blind $0.05
Cloud5918: posts big blind $0.10
MARTIIRA: sits out 
*** HOLE CARDS ***
appu001: folds 
Clappasaur: raises $0.20 to $0.30
Lord_of_days: calls $0.30
densamara_63: calls $0.25
Cloud5918: folds 
*** FLOP *** [8h 3h 3s]
densamara_63: checks 
Clappasaur: bets $0.50
Lord_of_days: raises $0.80 to $1.30
densamara_63: folds 
Clappasaur: folds 
Uncalled bet ($0.80) returned to Lord_of_days
Lord_of_days collected $1.91 from pot
Lord_of_days: doesn't show hand 
*** SUMMARY ***
Total pot $2 | Rake $0.09 
Board [8h 3h 3s]
Seat 1: Clappasaur folded on the Flop
Seat 2: Lord_of_days (button) collected ($1.91)
Seat 3: densamara_63 (small blind) folded on the Flop
Seat 4: Cloud5918 (big blind) folded before Flop
Seat 5: appu001 folded before Flop (didn't bet)



PokerStars Hand #222959442084:  Hold'em No Limit ($0.05/$0.10 USD) - 2021/01/23 11:39:33 ET
Table 'Polydoros II' 6-max Seat #3 is the button
Seat 1: Clappasaur ($16.18 in chips) 
Seat 2: Lord_of_days ($12.98 in chips) 
Seat 3: densamara_63 ($11.79 in chips) 
Seat 4: Cloud5918 ($6.23 in chips) 
Seat 5: appu001 ($11.53 in chips) 
Cloud5918: posts small blind $0.05
appu001: posts big blind $0.10
MARTIIRA: sits out 
*** HOLE CARDS ***
Clappasaur: calls $0.10
Lord_of_days: folds 
densamara_63: raises $0.40 to $0.50
Cloud5918: folds 
appu001: raises $0.40 to $0.90
Clappasaur: folds 
densamara_63: calls $0.40
*** FLOP *** [9h 9s Th]
appu001: checks 
densamara_63: bets $0.65
appu001: calls $0.65
*** TURN *** [9h 9s Th] [Qc]
appu001: checks 
densamara_63: checks 
*** RIVER *** [9h 9s Th Qc] [Jh]
appu001: bets $4
densamara_63: folds 
Uncalled bet ($4) returned to appu001
appu001 collected $3.10 from pot
appu001: doesn't show hand 
*** SUMMARY ***
Total pot $3.25 | Rake $0.15 
Board [9h 9s Th Qc Jh]
Seat 1: Clappasaur folded before Flop
Seat 2: Lord_of_days folded before Flop (didn't bet)
Seat 3: densamara_63 (button) folded on the River
Seat 4: Cloud5918 (small blind) folded before Flop
Seat 5: appu001 (big blind) collected ($3.10)



PokerStars Hand #222959469988:  Hold'em No Limit ($0.05/$0.10 USD) - 2021/01/23 11:40:18 ET
Table 'Polydoros II' 6-max Seat #4 is the button
Seat 1: Clappasaur ($16.08 in chips) 
Seat 2: Lord_of_days ($12.98 in chips) 
Seat 3: densamara_63 ($10.24 in chips) 
Seat 4: Cloud5918 ($6.18 in chips) 
Seat 5: appu001 ($13.08 in chips) 
Seat 6: MARTIIRA ($10 in chips) 
appu001: posts small blind $0.05
MARTIIRA: posts big blind $0.10
*** HOLE CARDS ***
Clappasaur: raises $0.20 to $0.30
Lord_of_days: folds 
densamara_63: folds 
Cloud5918: folds 
appu001: folds 
MARTIIRA: folds 
Uncalled bet ($0.20) returned to Clappasaur
Clappasaur collected $0.25 from pot
Clappasaur: doesn't show hand 
*** SUMMARY ***
Total pot $0.25 | Rake $0 
Seat 1: Clappasaur collected ($0.25)
Seat 2: Lord_of_days folded before Flop (didn't bet)
Seat 3: densamara_63 folded before Flop (didn't bet)
Seat 4: Cloud5918 (button) folded before Flop (didn't bet)
Seat 5: appu001 (small blind) folded before Flop
Seat 6: MARTIIRA (big blind) folded before Flop



PokerStars Hand #222959478433:  Hold'em No Limit ($0.05/$0.10 USD) - 2021/01/23 11:40:32 ET
Table 'Polydoros II' 6-max Seat #5 is the button
Seat 1: Clappasaur ($16.23 in chips) 
Seat 2: Lord_of_days ($12.98 in chips) 
Seat 3: densamara_63 ($10.24 in chips) 
Seat 4: Cloud5918 ($6.18 in chips) 
Seat 5: appu001 ($13.03 in chips) 
Seat 6: MARTIIRA ($10 in chips) 
MARTIIRA: posts small blind $0.05
Clappasaur: posts big blind $0.10
*** HOLE CARDS ***
Lord_of_days: folds 
densamara_63: raises $0.20 to $0.30
Cloud5918: raises $5.88 to $6.18 and is all-in
appu001: folds 
MARTIIRA: calls $6.13
Clappasaur: folds 
densamara_63: folds 
*** FLOP *** [8s 7c 8h]
*** TURN *** [8s 7c 8h] [Tc]
*** RIVER *** [8s 7c 8h Tc] [Qs]
*** SHOW DOWN ***
MARTIIRA: shows [As Ad] (two pair, Aces and Eights)
Cloud5918: shows [Jc Js] (two pair, Jacks and Eights)
MARTIIRA collected $12.19 from pot
*** SUMMARY ***
Total pot $12.76 | Rake $0.57 
Board [8s 7c 8h Tc Qs]
Seat 1: Clappasaur (big blind) folded before Flop
Seat 2: Lord_of_days folded before Flop (didn't bet)
Seat 3: densamara_63 folded before Flop
Seat 4: Cloud5918 showed [Jc Js] and lost with two pair, Jacks and Eights
Seat 5: appu001 (button) folded before Flop (didn't bet)
Seat 6: MARTIIRA (small blind) showed [As Ad] and won ($12.19) with two pair, Aces and Eights



PokerStars Hand #222959501619:  Hold'em No Limit ($0.05/$0.10 USD) - 2021/01/23 11:41:09 ET
Table 'Polydoros II' 6-max Seat #6 is the button
Seat 1: Clappasaur ($16.13 in chips) 
Seat 2: Lord_of_days ($12.98 in chips) 
Seat 3: densamara_63 ($10 in chips) 
Seat 5: appu001 ($13.03 in chips) 
Seat 6: MARTIIRA ($16.01 in chips) 
Clappasaur: posts small blind $0.05
Lord_of_days: posts big blind $0.10
*** HOLE CARDS ***
densamara_63: folds 
appu001: calls $0.10
MARTIIRA: raises $0.30 to $0.40
Clappasaur: calls $0.35
Lord_of_days: folds 
appu001: calls $0.30
*** FLOP *** [9c 7s Js]
Clappasaur: checks 
appu001: checks 
MARTIIRA: bets $0.55
Clappasaur: calls $0.55
appu001: folds 
*** TURN *** [9c 7s Js] [As]
Clappasaur: checks 
MARTIIRA: bets $1.30
Clappasaur: folds 
Uncalled bet ($1.30) returned to MARTIIRA
MARTIIRA collected $2.29 from pot
MARTIIRA: doesn't show hand 
*** SUMMARY ***
Total pot $2.40 | Rake $0.11 
Board [9c 7s Js As]
Seat 1: Clappasaur (small blind) folded on the Turn
Seat 2: Lord_of_days (big blind) folded before Flop
Seat 3: densamara_63 folded before Flop (didn't bet)
Seat 5: appu001 folded on the Flop
Seat 6: MARTIIRA (button) collected ($2.29)



PokerStars Hand #222959534493:  Hold'em No Limit ($0.05/$0.10 USD) - 2021/01/23 11:42:03 ET
Table 'Polydoros II' 6-max Seat #1 is the button
Seat 1: Clappasaur ($15.18 in chips) 
Seat 2: Lord_of_days ($12.88 in chips) 
Seat 3: densamara_63 ($10 in chips) 
Seat 4: Cloud5918 ($5.46 in chips) 
Seat 5: appu001 ($12.63 in chips) 
Seat 6: MARTIIRA ($17.35 in chips) 
Lord_of_days: posts small blind $0.05
densamara_63: posts big blind $0.10
*** HOLE CARDS ***
Cloud5918: calls $0.10
appu001: calls $0.10
MARTIIRA: folds 
Clappasaur has timed out
Clappasaur: folds 
Lord_of_days: folds 
densamara_63: checks 
*** FLOP *** [2c 5d Jc]
densamara_63: checks 
Cloud5918: bets $0.40
appu001: calls $0.40
densamara_63: calls $0.40
*** TURN *** [2c 5d Jc] [4c]
densamara_63: checks 
Cloud5918: bets $0.74
appu001: calls $0.74
densamara_63: folds 
*** RIVER *** [2c 5d Jc 4c] [4s]
Cloud5918: bets $1.40
appu001: folds 
Uncalled bet ($1.40) returned to Cloud5918
Cloud5918 collected $2.89 from pot
Cloud5918: doesn't show hand 
*** SUMMARY ***
Total pot $3.03 | Rake $0.14 
Board [2c 5d Jc 4c 4s]
Seat 1: Clappasaur (button) folded before Flop (didn't bet)
Seat 2: Lord_of_days (small blind) folded before Flop
Seat 3: densamara_63 (big blind) folded on the Turn
Seat 4: Cloud5918 collected ($2.89)
Seat 5: appu001 folded on the River
Seat 6: MARTIIRA folded before Flop (didn't bet)



PokerStars Hand #222959570692:  Hold'em No Limit ($0.05/$0.10 USD) - 2021/01/23 11:43:02 ET
Table 'Polydoros II' 6-max Seat #2 is the button
Seat 1: Clappasaur ($15.18 in chips) 
Seat 2: Lord_of_days ($12.83 in chips) 
Seat 3: densamara_63 ($10 in chips) 
Seat 4: Cloud5918 ($7.11 in chips) 
Seat 5: appu001 ($11.39 in chips) 
Seat 6: MARTIIRA ($17.35 in chips) 
densamara_63: posts small blind $0.05
Cloud5918: posts big blind $0.10
*** HOLE CARDS ***
appu001: folds 
MARTIIRA: folds 
Clappasaur: folds 
Lord_of_days: raises $0.20 to $0.30
densamara_63: raises $0.60 to $0.90
Cloud5918: folds 
Lord_of_days: folds 
Uncalled bet ($0.60) returned to densamara_63
densamara_63 collected $0.70 from pot
*** SUMMARY ***
Total pot $0.70 | Rake $0 
Seat 1: Clappasaur folded before Flop (didn't bet)
Seat 2: Lord_of_days (button) folded before Flop
Seat 3: densamara_63 (small blind) collected ($0.70)
Seat 4: Cloud5918 (big blind) folded before Flop
Seat 5: appu001 folded before Flop (didn't bet)
Seat 6: MARTIIRA folded before Flop (didn't bet)



PokerStars Hand #222959585770:  Hold'em No Limit ($0.05/$0.10 USD) - 2021/01/23 11:43:26 ET
Table 'Polydoros II' 6-max Seat #3 is the button
Seat 1: Clappasaur ($15.18 in chips) 
Seat 2: Lord_of_days ($12.53 in chips) 
Seat 3: densamara_63 ($10.40 in chips) 
Seat 4: Cloud5918 ($7.01 in chips) 
Seat 5: appu001 ($11.39 in chips) 
Seat 6: MARTIIRA ($17.35 in chips) 
Cloud5918: posts small blind $0.05
appu001: posts big blind $0.10
*** HOLE CARDS ***
MARTIIRA: folds 
Clappasaur: raises $0.20 to $0.30
Lord_of_days: folds 
densamara_63: folds 
Cloud5918: calls $0.25
appu001: calls $0.20
*** FLOP *** [8d Js 9c]
Cloud5918: checks 
appu001: checks 
Clappasaur: bets $0.50
Cloud5918: calls $0.50
densamara_63 was removed from the table for failing to post
densamara_63 leaves the table
appu001: folds 
*** TURN *** [8d Js 9c] [4h]
DiskoDancer joins the table at seat #3 
Cloud5918: checks 
Clappasaur: bets $1.10
Cloud5918: folds 
Uncalled bet ($1.10) returned to Clappasaur
Clappasaur collected $1.81 from pot
Clappasaur: doesn't show hand 
*** SUMMARY ***
Total pot $1.90 | Rake $0.09 
Board [8d Js 9c 4h]
Seat 1: Clappasaur collected ($1.81)
Seat 2: Lord_of_days folded before Flop (didn't bet)
Seat 3: densamara_63 (button) folded before Flop (didn't bet)
Seat 4: Cloud5918 (small blind) folded on the Turn
Seat 5: appu001 (big blind) folded on the Flop
Seat 6: MARTIIRA folded before Flop (didn't bet)



PokerStars Hand #222959608847:  Hold'em No Limit ($0.05/$0.10 USD) - 2021/01/23 11:44:04 ET
Table 'Polydoros II' 6-max Seat #4 is the button
Seat 1: Clappasaur ($16.19 in chips) 
Seat 2: Lord_of_days ($12.53 in chips) 
Seat 4: Cloud5918 ($6.21 in chips) 
Seat 5: appu001 ($11.09 in chips) 
Seat 6: MARTIIRA ($17.35 in chips) 
appu001: posts small blind $0.05
MARTIIRA: posts big blind $0.10
DiskoDancer: sits out 
*** HOLE CARDS ***
Clappasaur: raises $0.10 to $0.20
Lord_of_days: folds 
Cloud5918: calls $0.20
appu001: folds 
MARTIIRA: folds 
*** FLOP *** [Qd Tc 9c]
Clappasaur: checks 
Cloud5918: bets $0.60
Clappasaur: folds 
Uncalled bet ($0.60) returned to Cloud5918
Cloud5918 collected $0.53 from pot
Cloud5918: doesn't show hand 
*** SUMMARY ***
Total pot $0.55 | Rake $0.02 
Board [Qd Tc 9c]
Seat 1: Clappasaur folded on the Flop
Seat 2: Lord_of_days folded before Flop (didn't bet)
Seat 4: Cloud5918 (button) collected ($0.53)
Seat 5: appu001 (small blind) folded before Flop
Seat 6: MARTIIRA (big blind) folded before Flop



PokerStars Hand #222959622379:  Hold'em No Limit ($0.05/$0.10 USD) - 2021/01/23 11:44:25 ET
Table 'Polydoros II' 6-max Seat #5 is the button
Seat 1: Clappasaur ($15.99 in chips) 
Seat 2: Lord_of_days ($12.53 in chips) 
Seat 4: Cloud5918 ($6.54 in chips) 
Seat 5: appu001 ($11.04 in chips) 
Seat 6: MARTIIRA ($17.25 in chips) 
MARTIIRA: posts small blind $0.05
Clappasaur: posts big blind $0.10
DiskoDancer: sits out 
*** HOLE CARDS ***
Lord_of_days: raises $0.20 to $0.30
Cloud5918: calls $0.30
appu001: folds 
MARTIIRA: folds 
Clappasaur: calls $0.20
*** FLOP *** [3d 7d Qc]
Clappasaur: checks 
Lord_of_days: bets $0.30
Cloud5918: raises $0.80 to $1.10
Clappasaur: folds 
Lord_of_days: folds 
Uncalled bet ($0.80) returned to Cloud5918
Cloud5918 collected $1.48 from pot
Cloud5918: doesn't show hand 
*** SUMMARY ***
Total pot $1.55 | Rake $0.07 
Board [3d 7d Qc]
Seat 1: Clappasaur (big blind) folded on the Flop
Seat 2: Lord_of_days folded on the Flop
Seat 4: Cloud5918 collected ($1.48)
Seat 5: appu001 (button) folded before Flop (didn't bet)
Seat 6: MARTIIRA (small blind) folded before Flop



PokerStars Hand #222959648086:  Hold'em No Limit ($0.05/$0.10 USD) - 2021/01/23 11:45:07 ET
Table 'Polydoros II' 6-max Seat #6 is the button
Seat 1: Clappasaur ($15.69 in chips) 
Seat 2: Lord_of_days ($11.93 in chips) 
Seat 4: Cloud5918 ($7.42 in chips) 
Seat 5: appu001 ($11.04 in chips) 
Seat 6: MARTIIRA ($17.20 in chips) 
Clappasaur: posts small blind $0.05
Lord_of_days: posts big blind $0.10
DiskoDancer: sits out 
*** HOLE CARDS ***
Cloud5918: calls $0.10
appu001: raises $0.10 to $0.20
MARTIIRA: folds 
Clappasaur: folds 
Lord_of_days: calls $0.10
Cloud5918: calls $0.10
*** FLOP *** [Kc 2s 8h]
Lord_of_days: checks 
Cloud5918: bets $0.40
appu001: raises $0.40 to $0.80
Lord_of_days: folds 
Cloud5918: folds 
Uncalled bet ($0.40) returned to appu001
appu001 collected $1.38 from pot
appu001: doesn't show hand 
*** SUMMARY ***
Total pot $1.45 | Rake $0.07 
Board [Kc 2s 8h]
Seat 1: Clappasaur (small blind) folded before Flop
Seat 2: Lord_of_days (big blind) folded on the Flop
Seat 4: Cloud5918 folded on the Flop
Seat 5: appu001 collected ($1.38)
Seat 6: MARTIIRA (button) folded before Flop (didn't bet)



PokerStars Hand #222959663570:  Hold'em No Limit ($0.05/$0.10 USD) - 2021/01/23 11:45:32 ET
Table 'Polydoros II' 6-max Seat #1 is the button
Seat 1: Clappasaur ($15.64 in chips) 
Seat 2: Lord_of_days ($11.73 in chips) 
Seat 3: DiskoDancer ($10 in chips) 
Seat 4: Cloud5918 ($6.82 in chips) 
Seat 5: appu001 ($11.82 in chips) 
Seat 6: MARTIIRA ($17.20 in chips) 
Lord_of_days: posts small blind $0.05
DiskoDancer: posts big blind $0.10
*** HOLE CARDS ***
Cloud5918: folds 
appu001: folds 
MARTIIRA: folds 
Clappasaur: raises $0.20 to $0.30
Lord_of_days: folds 
DiskoDancer: folds 
Uncalled bet ($0.20) returned to Clappasaur
Clappasaur collected $0.25 from pot
Clappasaur: doesn't show hand 
*** SUMMARY ***
Total pot $0.25 | Rake $0 
Seat 1: Clappasaur (button) collected ($0.25)
Seat 2: Lord_of_days (small blind) folded before Flop
Seat 3: DiskoDancer (big blind) folded before Flop
Seat 4: Cloud5918 folded before Flop (didn't bet)
Seat 5: appu001 folded before Flop (didn't bet)
Seat 6: MARTIIRA folded before Flop (didn't bet)



PokerStars Hand #222959685626:  Hold'em No Limit ($0.05/$0.10 USD) - 2021/01/23 11:46:08 ET
Table 'Polydoros II' 6-max Seat #2 is the button
Seat 1: Clappasaur ($15.79 in chips) 
Seat 2: Lord_of_days ($11.68 in chips) 
Seat 3: DiskoDancer ($10 in chips) 
Seat 4: Cloud5918 ($6.82 in chips) 
Seat 5: appu001 ($11.82 in chips) 
Seat 6: MARTIIRA ($17.20 in chips) 
DiskoDancer: posts small blind $0.05
Cloud5918: posts big blind $0.10
*** HOLE CARDS ***
appu001: raises $0.10 to $0.20
MARTIIRA: folds 
Clappasaur: calls $0.20
Lord_of_days: folds 
DiskoDancer: folds 
Cloud5918: calls $0.10
*** FLOP *** [6s Qc Js]
Cloud5918: checks 
appu001: bets $0.60
Clappasaur: folds 
Cloud5918: calls $0.60
*** TURN *** [6s Qc Js] [Qs]
Cloud5918: checks 
appu001: bets $0.60
Cloud5918: raises $5.42 to $6.02 and is all-in
appu001: calls $5.42
*** RIVER *** [6s Qc Js Qs] [Th]
*** SHOW DOWN ***
Cloud5918: shows [7s Qh] (three of a kind, Queens)
appu001: shows [As 2s] (a flush, Ace high)
appu001 collected $13.26 from pot
Cloud5918 cashed out the hand for $2.99 | Cash Out Fee $0.03
*** SUMMARY ***
Total pot $13.89 | Rake $0.63 
Board [6s Qc Js Qs Th]
Seat 1: Clappasaur folded on the Flop
Seat 2: Lord_of_days (button) folded before Flop (didn't bet)
Seat 3: DiskoDancer (small blind) folded before Flop
Seat 4: Cloud5918 (big blind) showed [7s Qh] and lost with three of a kind, Queens (cashed out).
Seat 5: appu001 showed [As 2s] and won ($13.26) with a flush, Ace high
Seat 6: MARTIIRA folded before Flop (didn't bet)



PokerStars Hand #222959724013:  Hold'em No Limit ($0.05/$0.10 USD) - 2021/01/23 11:47:10 ET
Table 'Polydoros II' 6-max Seat #3 is the button
Seat 1: Clappasaur ($15.59 in chips) 
Seat 2: Lord_of_days ($11.68 in chips) 
Seat 3: DiskoDancer ($10 in chips) 
Seat 4: Cloud5918 ($2.99 in chips) 
Seat 5: appu001 ($18.26 in chips) 
Seat 6: MARTIIRA ($17.20 in chips) 
Cloud5918: posts small blind $0.05
appu001: posts big blind $0.10
*** HOLE CARDS ***
MARTIIRA: folds 
Clappasaur: raises $0.20 to $0.30
Lord_of_days: folds 
DiskoDancer: folds 
Cloud5918: folds 
appu001: calls $0.20
*** FLOP *** [5c 9d 8c]
appu001: checks 
Clappasaur: bets $0.40
appu001: folds 
Uncalled bet ($0.40) returned to Clappasaur
Clappasaur collected $0.62 from pot
Clappasaur: doesn't show hand 
*** SUMMARY ***
Total pot $0.65 | Rake $0.03 
Board [5c 9d 8c]
Seat 1: Clappasaur collected ($0.62)
Seat 2: Lord_of_days folded before Flop (didn't bet)
Seat 3: DiskoDancer (button) folded before Flop (didn't bet)
Seat 4: Cloud5918 (small blind) folded before Flop
Seat 5: appu001 (big blind) folded on the Flop
Seat 6: MARTIIRA folded before Flop (didn't bet)



PokerStars Hand #222959743098:  Hold'em No Limit ($0.05/$0.10 USD) - 2021/01/23 11:47:41 ET
Table 'Polydoros II' 6-max Seat #4 is the button
Seat 1: Clappasaur ($15.91 in chips) 
Seat 2: Lord_of_days ($11.68 in chips) 
Seat 3: DiskoDancer ($10 in chips) 
Seat 4: Cloud5918 ($2.94 in chips) 
Seat 5: appu001 ($17.96 in chips) 
Seat 6: MARTIIRA ($17.20 in chips) 
appu001: posts small blind $0.05
MARTIIRA: posts big blind $0.10
*** HOLE CARDS ***
Clappasaur: folds 
Lord_of_days: raises $0.20 to $0.30
DiskoDancer: folds 
Cloud5918: calls $0.30
appu001: raises $0.20 to $0.50
MARTIIRA: folds 
Lord_of_days: raises $1.10 to $1.60
Cloud5918: folds 
appu001: calls $1.10
*** FLOP *** [Js Kc Tc]
appu001: bets $1
Lord_of_days: raises $1.60 to $2.60
appu001: raises $1.60 to $4.20
Lord_of_days: calls $1.60
*** TURN *** [Js Kc Tc] [5c]
appu001: checks 
Lord_of_days: bets $5.88 and is all-in
appu001: calls $5.88
*** RIVER *** [Js Kc Tc 5c] [Ts]
*** SHOW DOWN ***
appu001: shows [Jd Td] (a full house, Tens full of Jacks)
Lord_of_days: shows [Ah Ks] (two pair, Kings and Tens)
appu001 collected $22.69 from pot
*** SUMMARY ***
Total pot $23.76 | Rake $1.07 
Board [Js Kc Tc 5c Ts]
Seat 1: Clappasaur folded before Flop (didn't bet)
Seat 2: Lord_of_days showed [Ah Ks] and lost with two pair, Kings and Tens
Seat 3: DiskoDancer folded before Flop (didn't bet)
Seat 4: Cloud5918 (button) folded before Flop
Seat 5: appu001 (small blind) showed [Jd Td] and won ($22.69) with a full house, Tens full of Jacks
Seat 6: MARTIIRA (big blind) folded before Flop



PokerStars Hand #222959778230:  Hold'em No Limit ($0.05/$0.10 USD) - 2021/01/23 11:48:37 ET
Table 'Polydoros II' 6-max Seat #5 is the button
Seat 1: Clappasaur ($15.91 in chips) 
Seat 2: Lord_of_days ($10 in chips) 
Seat 3: DiskoDancer ($10 in chips) 
Seat 4: Cloud5918 ($2.64 in chips) 
Seat 5: appu001 ($28.97 in chips) 
Seat 6: MARTIIRA ($17.10 in chips) 
MARTIIRA: posts small blind $0.05
Clappasaur: posts big blind $0.10
*** HOLE CARDS ***
Lord_of_days: folds 
DiskoDancer: raises $0.15 to $0.25
Cloud5918: folds 
appu001: folds 
MARTIIRA: folds 
Clappasaur: folds 
Uncalled bet ($0.15) returned to DiskoDancer
DiskoDancer collected $0.25 from pot
DiskoDancer: doesn't show hand 
*** SUMMARY ***
Total pot $0.25 | Rake $0 
Seat 1: Clappasaur (big blind) folded before Flop
Seat 2: Lord_of_days folded before Flop (didn't bet)
Seat 3: DiskoDancer collected ($0.25)
Seat 4: Cloud5918 folded before Flop (didn't bet)
Seat 5: appu001 (button) folded before Flop (didn't bet)
Seat 6: MARTIIRA (small blind) folded before Flop



PokerStars Hand #222959788389:  Hold'em No Limit ($0.05/$0.10 USD) - 2021/01/23 11:48:54 ET
Table 'Polydoros II' 6-max Seat #6 is the button
Seat 1: Clappasaur ($15.81 in chips) 
Seat 2: Lord_of_days ($10 in chips) 
Seat 3: DiskoDancer ($10.15 in chips) 
Seat 4: Cloud5918 ($2.64 in chips) 
Seat 5: appu001 ($28.97 in chips) 
Seat 6: MARTIIRA ($17.05 in chips) 
Clappasaur: posts small blind $0.05
Lord_of_days: posts big blind $0.10
*** HOLE CARDS ***
DiskoDancer: folds 
Cloud5918: calls $0.10
appu001: calls $0.10
MARTIIRA: folds 
Clappasaur: raises $0.20 to $0.30
Lord_of_days: folds 
Cloud5918: raises $0.50 to $0.80
appu001: calls $0.70
Clappasaur: calls $0.50
*** FLOP *** [6h Qd 5c]
Clappasaur: checks 
Cloud5918: bets $1.84 and is all-in
appu001: calls $1.84
Clappasaur: calls $1.84
*** TURN *** [6h Qd 5c] [5s]
Clappasaur: checks 
appu001: checks 
*** RIVER *** [6h Qd 5c 5s] [8c]
Clappasaur: bets $3.83
appu001: calls $3.83
*** SHOW DOWN ***
Clappasaur: shows [Jd Qh] (two pair, Queens and Fives)
appu001: mucks hand 
Clappasaur collected $7.31 from side pot
Cloud5918: shows [Js Qs] (two pair, Queens and Fives)
Clappasaur collected $3.83 from main pot
Cloud5918 collected $3.83 from main pot
*** SUMMARY ***
Total pot $15.68 Main pot $7.66. Side pot $7.31. | Rake $0.71 
Board [6h Qd 5c 5s 8c]
Seat 1: Clappasaur (small blind) showed [Jd Qh] and won ($11.14) with two pair, Queens and Fives
Seat 2: Lord_of_days (big blind) folded before Flop
Seat 3: DiskoDancer folded before Flop (didn't bet)
Seat 4: Cloud5918 showed [Js Qs] and won ($3.83) with two pair, Queens and Fives
Seat 5: appu001 mucked
Seat 6: MARTIIRA (button) folded before Flop (didn't bet)



PokerStars Hand #222959820467:  Hold'em No Limit ($0.05/$0.10 USD) - 2021/01/23 11:49:45 ET
Table 'Polydoros II' 6-max Seat #1 is the button
Seat 1: Clappasaur ($20.48 in chips) 
Seat 2: Lord_of_days ($9.90 in chips) 
Seat 3: DiskoDancer ($10.15 in chips) 
Seat 4: Cloud5918 ($3.83 in chips) 
Seat 5: appu001 ($22.50 in chips) 
Seat 6: MARTIIRA ($17.05 in chips) 
Lord_of_days: posts small blind $0.05
DiskoDancer: posts big blind $0.10
*** HOLE CARDS ***
Cloud5918: calls $0.10
appu001: raises $0.10 to $0.20
MARTIIRA: folds 
Clappasaur: calls $0.20
Lord_of_days: folds 
DiskoDancer: raises $1.10 to $1.30
Cloud5918: folds 
appu001: calls $1.10
Clappasaur: folds 
*** FLOP *** [Qh 3c 2h]
DiskoDancer: checks 
appu001: checks 
*** TURN *** [Qh 3c 2h] [4c]
DiskoDancer: checks 
appu001: bets $2.40
DiskoDancer: calls $2.40
*** RIVER *** [Qh 3c 2h 4c] [3h]
DiskoDancer: checks 
appu001: bets $3.20
DiskoDancer: calls $3.20
*** SHOW DOWN ***
appu001: shows [Ac Qd] (two pair, Queens and Threes)
DiskoDancer: mucks hand 
appu001 collected $13.51 from pot
*** SUMMARY ***
Total pot $14.15 | Rake $0.64 
Board [Qh 3c 2h 4c 3h]
Seat 1: Clappasaur (button) folded before Flop
Seat 2: Lord_of_days (small blind) folded before Flop
Seat 3: DiskoDancer (big blind) mucked
Seat 4: Cloud5918 folded before Flop
Seat 5: appu001 showed [Ac Qd] and won ($13.51) with two pair, Queens and Threes
Seat 6: MARTIIRA folded before Flop (didn't bet)



PokerStars Hand #222959876051:  Hold'em No Limit ($0.05/$0.10 USD) - 2021/01/23 11:51:15 ET
Table 'Polydoros II' 6-max Seat #2 is the button
Seat 1: Clappasaur ($20.28 in chips) 
Seat 2: Lord_of_days ($10 in chips) 
Seat 4: Cloud5918 ($3.73 in chips) 
Seat 5: appu001 ($29.11 in chips) 
Seat 6: MARTIIRA ($17.05 in chips) 
DiskoDancer has timed out
DiskoDancer: is sitting out 
Cloud5918: posts small blind $0.05
appu001: posts big blind $0.10
*** HOLE CARDS ***
DiskoDancer is disconnected 
MARTIIRA: folds 
Clappasaur: raises $0.10 to $0.20
Lord_of_days: folds 
Cloud5918: calls $0.15
appu001: calls $0.10
*** FLOP *** [6h 2s 9d]
Cloud5918: checks 
appu001: bets $0.40
Clappasaur: folds 
Cloud5918: folds 
Uncalled bet ($0.40) returned to appu001
appu001 collected $0.57 from pot
appu001: doesn't show hand 
*** SUMMARY ***
Total pot $0.60 | Rake $0.03 
Board [6h 2s 9d]
Seat 1: Clappasaur folded on the Flop
Seat 2: Lord_of_days (button) folded before Flop (didn't bet)
Seat 4: Cloud5918 (small blind) folded on the Flop
Seat 5: appu001 (big blind) collected ($0.57)
Seat 6: MARTIIRA folded before Flop (didn't bet)



PokerStars Hand #222959991323:  Hold'em No Limit ($0.05/$0.10 USD) - 2021/01/23 11:54:12 ET
Table 'Polydoros II' 6-max Seat #5 is the button
Seat 1: Clappasaur ($22.90 in chips) 
Seat 2: Lord_of_days ($11.95 in chips) 
Seat 5: appu001 ($28.52 in chips) 
Seat 6: MARTIIRA ($16.12 in chips) 
MARTIIRA: posts small blind $0.05
Clappasaur: posts big blind $0.10
*** HOLE CARDS ***
Lord_of_days: folds 
appu001: calls $0.10
MARTIIRA: folds 
Clappasaur: raises $0.20 to $0.30
appu001: calls $0.20
*** FLOP *** [7h 4h Qs]
Clappasaur: checks 
appu001: bets $0.60
Clappasaur: folds 
Uncalled bet ($0.60) returned to appu001
appu001 collected $0.62 from pot
appu001: doesn't show hand 
*** SUMMARY ***
Total pot $0.65 | Rake $0.03 
Board [7h 4h Qs]
Seat 1: Clappasaur (big blind) folded on the Flop
Seat 2: Lord_of_days folded before Flop (didn't bet)
Seat 5: appu001 (button) collected ($0.62)
Seat 6: MARTIIRA (small blind) folded before Flop



PokerStars Hand #222960007200:  Hold'em No Limit ($0.05/$0.10 USD) - 2021/01/23 11:54:38 ET
Table 'Polydoros II' 6-max Seat #6 is the button
Seat 1: Clappasaur ($22.60 in chips) 
Seat 2: Lord_of_days ($11.95 in chips) 
Seat 5: appu001 ($28.84 in chips) 
Seat 6: MARTIIRA ($16.07 in chips) 
Clappasaur: posts small blind $0.05
Lord_of_days: posts big blind $0.10
DiskoDancer: sits out 
*** HOLE CARDS ***
appu001: calls $0.10
MARTIIRA: folds 
Clappasaur: folds 
Lord_of_days: raises $0.30 to $0.40
appu001: calls $0.30
*** FLOP *** [Ah Kc Ac]
Lord_of_days: bets $0.27
appu001: calls $0.27
*** TURN *** [Ah Kc Ac] [5c]
Lord_of_days: bets $1.09
appu001: folds 
Uncalled bet ($1.09) returned to Lord_of_days
Lord_of_days collected $1.33 from pot
Lord_of_days: doesn't show hand 
*** SUMMARY ***
Total pot $1.39 | Rake $0.06 
Board [Ah Kc Ac 5c]
Seat 1: Clappasaur (small blind) folded before Flop
Seat 2: Lord_of_days (big blind) collected ($1.33)
Seat 5: appu001 folded on the Turn
Seat 6: MARTIIRA (button) folded before Flop (didn't bet)



PokerStars Hand #222960025242:  Hold'em No Limit ($0.05/$0.10 USD) - 2021/01/23 11:55:07 ET
Table 'Polydoros II' 6-max Seat #1 is the button
Seat 1: Clappasaur ($22.55 in chips) 
Seat 2: Lord_of_days ($12.61 in chips) 
Seat 3: DiskoDancer ($10 in chips) 
Seat 5: appu001 ($28.17 in chips) 
Seat 6: MARTIIRA ($16.07 in chips) 
Lord_of_days: posts small blind $0.05
DiskoDancer: posts big blind $0.10
*** HOLE CARDS ***
appu001: folds 
MARTIIRA: raises $0.15 to $0.25
Clappasaur: calls $0.25
Lord_of_days: folds 
DiskoDancer: raises $1.27 to $1.52
MARTIIRA: folds 
Clappasaur: folds 
Uncalled bet ($1.27) returned to DiskoDancer
DiskoDancer collected $0.80 from pot
DiskoDancer: doesn't show hand 
*** SUMMARY ***
Total pot $0.80 | Rake $0 
Seat 1: Clappasaur (button) folded before Flop
Seat 2: Lord_of_days (small blind) folded before Flop
Seat 3: DiskoDancer (big blind) collected ($0.80)
Seat 5: appu001 folded before Flop (didn't bet)
Seat 6: MARTIIRA folded before Flop



PokerStars Hand #222960047718:  Hold'em No Limit ($0.05/$0.10 USD) - 2021/01/23 11:55:56 ET
Table 'Polydoros II' 6-max Seat #2 is the button
Seat 1: Clappasaur ($22.30 in chips) 
Seat 2: Lord_of_days ($12.56 in chips) 
Seat 3: DiskoDancer ($10.55 in chips) 
Seat 5: appu001 ($28.17 in chips) 
Seat 6: MARTIIRA ($15.82 in chips) 
DiskoDancer: posts small blind $0.05
appu001: posts big blind $0.10
*** HOLE CARDS ***
MARTIIRA: folds 
Clappasaur: raises $0.10 to $0.20
Lord_of_days: folds 
DiskoDancer: folds 
appu001: raises $0.10 to $0.30
Clappasaur: calls $0.10
*** FLOP *** [2d 6c Jc]
appu001: checks 
Clappasaur: bets $0.31
appu001: calls $0.31
*** TURN *** [2d 6c Jc] [4d]
appu001: bets $0.40
Clappasaur: calls $0.40
*** RIVER *** [2d 6c Jc 4d] [5s]
appu001: bets $8.70
Clappasaur: calls $8.70
*** SHOW DOWN ***
appu001: shows [3h Ad] (a straight, Deuce to Six)
Clappasaur: shows [3c 8c] (a straight, Deuce to Six)
appu001 collected $9.30 from pot
Clappasaur collected $9.29 from pot
*** SUMMARY ***
Total pot $19.47 | Rake $0.88 
Board [2d 6c Jc 4d 5s]
Seat 1: Clappasaur showed [3c 8c] and won ($9.29) with a straight, Deuce to Six
Seat 2: Lord_of_days (button) folded before Flop (didn't bet)
Seat 3: DiskoDancer (small blind) folded before Flop
Seat 5: appu001 (big blind) showed [3h Ad] and won ($9.30) with a straight, Deuce to Six
Seat 6: MARTIIRA folded before Flop (didn't bet)



PokerStars Hand #222960062967:  Hold'em No Limit ($0.05/$0.10 USD) - 2021/01/23 11:56:28 ET
Table 'Polydoros II' 6-max Seat #3 is the button
Seat 1: Clappasaur ($21.88 in chips) 
Seat 2: Lord_of_days ($12.56 in chips) 
Seat 3: DiskoDancer ($10.50 in chips) 
Seat 5: appu001 ($27.76 in chips) 
Seat 6: MARTIIRA ($15.82 in chips) 
appu001: posts small blind $0.05
MARTIIRA: posts big blind $0.10
*** HOLE CARDS ***
Clappasaur: folds 
Lord_of_days: folds 
DiskoDancer: raises $0.15 to $0.25
Cloud5918 leaves the table
appu001: raises $0.15 to $0.40
MARTIIRA: calls $0.30
DiskoDancer: calls $0.15
*** FLOP *** [Ks 8d 6d]
appu001: checks 
watersnow66 joins the table at seat #4 
MARTIIRA: checks 
DiskoDancer: checks 
*** TURN *** [Ks 8d 6d] [4d]
appu001: checks 
MARTIIRA: bets $0.76
DiskoDancer: folds 
appu001: folds 
Uncalled bet ($0.76) returned to MARTIIRA
MARTIIRA collected $1.15 from pot
MARTIIRA: doesn't show hand 
*** SUMMARY ***
Total pot $1.20 | Rake $0.05 
Board [Ks 8d 6d 4d]
Seat 1: Clappasaur folded before Flop (didn't bet)
Seat 2: Lord_of_days folded before Flop (didn't bet)
Seat 3: DiskoDancer (button) folded on the Turn
Seat 5: appu001 (small blind) folded on the Turn
Seat 6: MARTIIRA (big blind) collected ($1.15)



PokerStars Hand #222960084924:  Hold'em No Limit ($0.05/$0.10 USD) - 2021/01/23 11:57:16 ET
Table 'Polydoros II' 6-max Seat #5 is the button
Seat 1: Clappasaur ($21.88 in chips) 
Seat 2: Lord_of_days ($12.56 in chips) 
Seat 3: DiskoDancer ($10.10 in chips) 
Seat 5: appu001 ($27.36 in chips) 
Seat 6: MARTIIRA ($16.57 in chips) 
MARTIIRA: posts small blind $0.05
Clappasaur: posts big blind $0.10
watersnow66: sits out 
*** HOLE CARDS ***
Lord_of_days: raises $0.30 to $0.40
DiskoDancer: calls $0.40
appu001: calls $0.40
MARTIIRA: calls $0.35
Clappasaur: calls $0.30
*** FLOP *** [4c 2s 4s]
MARTIIRA: checks 
Clappasaur: checks 
Lord_of_days: bets $1.03
DiskoDancer: folds 
appu001: calls $1.03
MARTIIRA: folds 
Clappasaur: folds 
*** TURN *** [4c 2s 4s] [Qh]
Lord_of_days: checks 
appu001: bets $1.10
Lord_of_days: calls $1.10
*** RIVER *** [4c 2s 4s Qh] [6s]
Lord_of_days: checks 
appu001: checks 
*** SHOW DOWN ***
Lord_of_days: shows [9s 9h] (two pair, Nines and Fours)
appu001: mucks hand 
Lord_of_days collected $5.98 from pot
*** SUMMARY ***
Total pot $6.26 | Rake $0.28 
Board [4c 2s 4s Qh 6s]
Seat 1: Clappasaur (big blind) folded on the Flop
Seat 2: Lord_of_days showed [9s 9h] and won ($5.98) with two pair, Nines and Fours
Seat 3: DiskoDancer folded on the Flop
Seat 5: appu001 (button) mucked
Seat 6: MARTIIRA (small blind) folded on the Flop



PokerStars Hand #222960119045:  Hold'em No Limit ($0.05/$0.10 USD) - 2021/01/23 11:58:28 ET
Table 'Polydoros II' 6-max Seat #6 is the button
Seat 1: Clappasaur ($21.48 in chips) 
Seat 2: Lord_of_days ($16.01 in chips) 
Seat 3: DiskoDancer ($10 in chips) 
Seat 5: appu001 ($24.83 in chips) 
Seat 6: MARTIIRA ($16.17 in chips) 
Clappasaur: posts small blind $0.05
Lord_of_days: posts big blind $0.10
watersnow66: sits out 
*** HOLE CARDS ***
DiskoDancer: folds 
appu001: raises $0.30 to $0.40
MARTIIRA: folds 
Clappasaur: calls $0.35
Lord_of_days: folds 
*** FLOP *** [Qd Td Qh]
Clappasaur: checks 
appu001: checks 
*** TURN *** [Qd Td Qh] [7h]
Clappasaur: bets $0.10
appu001: calls $0.10
*** RIVER *** [Qd Td Qh 7h] [2c]
Clappasaur: bets $1.10
appu001: folds 
Uncalled bet ($1.10) returned to Clappasaur
Clappasaur collected $1.05 from pot
Clappasaur: doesn't show hand 
*** SUMMARY ***
Total pot $1.10 | Rake $0.05 
Board [Qd Td Qh 7h 2c]
Seat 1: Clappasaur (small blind) collected ($1.05)
Seat 2: Lord_of_days (big blind) folded before Flop
Seat 3: DiskoDancer folded before Flop (didn't bet)
Seat 5: appu001 folded on the River
Seat 6: MARTIIRA (button) folded before Flop (didn't bet)



PokerStars Hand #222960135389:  Hold'em No Limit ($0.05/$0.10 USD) - 2021/01/23 11:59:02 ET
Table 'Polydoros II' 6-max Seat #1 is the button
Seat 1: Clappasaur ($22.03 in chips) 
Seat 2: Lord_of_days ($15.91 in chips) 
Seat 3: DiskoDancer ($10 in chips) 
Seat 5: appu001 ($24.33 in chips) 
Seat 6: MARTIIRA ($16.17 in chips) 
Lord_of_days: posts small blind $0.05
DiskoDancer: posts big blind $0.10
watersnow66: sits out 
*** HOLE CARDS ***
appu001: folds 
MARTIIRA: raises $0.15 to $0.25
Clappasaur: calls $0.25
Lord_of_days: folds 
DiskoDancer: folds 
*** FLOP *** [Ts 5d Ks]
MARTIIRA: checks 
Clappasaur: checks 
*** TURN *** [Ts 5d Ks] [2s]
MARTIIRA: checks 
Clappasaur: checks 
*** RIVER *** [Ts 5d Ks 2s] [Th]
MARTIIRA: checks 
Clappasaur: checks 
*** SHOW DOWN ***
MARTIIRA: shows [Ah 3h] (a pair of Tens)
Clappasaur: mucks hand 
MARTIIRA collected $0.62 from pot
*** SUMMARY ***
Total pot $0.65 | Rake $0.03 
Board [Ts 5d Ks 2s Th]
Seat 1: Clappasaur (button) mucked
Seat 2: Lord_of_days (small blind) folded before Flop
Seat 3: DiskoDancer (big blind) folded before Flop
Seat 5: appu001 folded before Flop (didn't bet)
Seat 6: MARTIIRA showed [Ah 3h] and won ($0.62) with a pair of Tens



PokerStars Hand #222960160352:  Hold'em No Limit ($0.05/$0.10 USD) - 2021/01/23 11:59:55 ET
Table 'Polydoros II' 6-max Seat #2 is the button
Seat 1: Clappasaur ($21.78 in chips) 
Seat 2: Lord_of_days ($15.86 in chips) 
Seat 3: DiskoDancer ($10 in chips) 
Seat 4: watersnow66 ($10 in chips) 
Seat 5: appu001 ($24.33 in chips) 
Seat 6: MARTIIRA ($16.54 in chips) 
DiskoDancer: posts small blind $0.05
watersnow66: posts big blind $0.10
*** HOLE CARDS ***
appu001: calls $0.10
MARTIIRA: folds 
Clappasaur: folds 
Lord_of_days: raises $0.30 to $0.40
DiskoDancer: folds 
watersnow66: calls $0.30
appu001: calls $0.30
*** FLOP *** [6d Qs 9s]
watersnow66: checks 
appu001: bets $1
Lord_of_days: folds 
watersnow66: folds 
Uncalled bet ($1) returned to appu001
appu001 collected $1.19 from pot
appu001: doesn't show hand 
*** SUMMARY ***
Total pot $1.25 | Rake $0.06 
Board [6d Qs 9s]
Seat 1: Clappasaur folded before Flop (didn't bet)
Seat 2: Lord_of_days (button) folded on the Flop
Seat 3: DiskoDancer (small blind) folded before Flop
Seat 4: watersnow66 (big blind) folded on the Flop
Seat 5: appu001 collected ($1.19)
Seat 6: MARTIIRA folded before Flop (didn't bet)



PokerStars Hand #222960184422:  Hold'em No Limit ($0.05/$0.10 USD) - 2021/01/23 12:00:43 ET
Table 'Polydoros II' 6-max Seat #3 is the button
Seat 1: Clappasaur ($21.78 in chips) 
Seat 2: Lord_of_days ($15.46 in chips) 
Seat 3: DiskoDancer ($10 in chips) 
Seat 4: watersnow66 ($9.60 in chips) 
Seat 5: appu001 ($25.12 in chips) 
Seat 6: MARTIIRA ($16.54 in chips) 
watersnow66: posts small blind $0.05
appu001: posts big blind $0.10
*** HOLE CARDS ***
MARTIIRA: raises $0.15 to $0.25
Clappasaur: folds 
Lord_of_days: folds 
DiskoDancer: folds 
watersnow66: folds 
appu001: calls $0.15
*** FLOP *** [3c 2h 3h]
appu001: checks 
MARTIIRA: checks 
*** TURN *** [3c 2h 3h] [6h]
appu001: checks 
MARTIIRA: checks 
*** RIVER *** [3c 2h 3h 6h] [Ac]
appu001: checks 
MARTIIRA: bets $0.35
appu001: folds 
Uncalled bet ($0.35) returned to MARTIIRA
MARTIIRA collected $0.53 from pot
MARTIIRA: doesn't show hand 
*** SUMMARY ***
Total pot $0.55 | Rake $0.02 
Board [3c 2h 3h 6h Ac]
Seat 1: Clappasaur folded before Flop (didn't bet)
Seat 2: Lord_of_days folded before Flop (didn't bet)
Seat 3: DiskoDancer (button) folded before Flop (didn't bet)
Seat 4: watersnow66 (small blind) folded before Flop
Seat 5: appu001 (big blind) folded on the River
Seat 6: MARTIIRA collected ($0.53)



PokerStars Hand #222960212366:  Hold'em No Limit ($0.05/$0.10 USD) - 2021/01/23 12:01:19 ET
Table 'Polydoros II' 6-max Seat #4 is the button
Seat 1: Clappasaur ($21.78 in chips) 
Seat 2: Lord_of_days ($15.46 in chips) 
Seat 3: DiskoDancer ($10 in chips) 
Seat 4: watersnow66 ($9.55 in chips) 
Seat 5: appu001 ($24.87 in chips) 
Seat 6: MARTIIRA ($16.82 in chips) 
appu001: posts small blind $0.05
MARTIIRA: posts big blind $0.10
*** HOLE CARDS ***
Clappasaur: folds 
Lord_of_days: raises $0.20 to $0.30
DiskoDancer: folds 
watersnow66: folds 
appu001: folds 
MARTIIRA: folds 
Uncalled bet ($0.20) returned to Lord_of_days
Lord_of_days collected $0.25 from pot
Lord_of_days: doesn't show hand 
*** SUMMARY ***
Total pot $0.25 | Rake $0 
Seat 1: Clappasaur folded before Flop (didn't bet)
Seat 2: Lord_of_days collected ($0.25)
Seat 3: DiskoDancer folded before Flop (didn't bet)
Seat 4: watersnow66 (button) folded before Flop (didn't bet)
Seat 5: appu001 (small blind) folded before Flop
Seat 6: MARTIIRA (big blind) folded before Flop



PokerStars Hand #222960219498:  Hold'em No Limit ($0.05/$0.10 USD) - 2021/01/23 12:01:32 ET
Table 'Polydoros II' 6-max Seat #5 is the button
Seat 1: Clappasaur ($21.78 in chips) 
Seat 2: Lord_of_days ($15.61 in chips) 
Seat 3: DiskoDancer ($10 in chips) 
Seat 4: watersnow66 ($9.55 in chips) 
Seat 5: appu001 ($24.82 in chips) 
Seat 6: MARTIIRA ($16.72 in chips) 
MARTIIRA: posts small blind $0.05
Clappasaur: posts big blind $0.10
*** HOLE CARDS ***
Lord_of_days: folds 
DiskoDancer: folds 
watersnow66: folds 
appu001: calls $0.10
MARTIIRA: folds 
Clappasaur: checks 
*** FLOP *** [Qs Qd 9d]
Clappasaur: checks 
appu001: bets $0.40
Clappasaur: folds 
Uncalled bet ($0.40) returned to appu001
appu001 collected $0.24 from pot
appu001: doesn't show hand 
*** SUMMARY ***
Total pot $0.25 | Rake $0.01 
Board [Qs Qd 9d]
Seat 1: Clappasaur (big blind) folded on the Flop
Seat 2: Lord_of_days folded before Flop (didn't bet)
Seat 3: DiskoDancer folded before Flop (didn't bet)
Seat 4: watersnow66 folded before Flop (didn't bet)
Seat 5: appu001 (button) collected ($0.24)
Seat 6: MARTIIRA (small blind) folded before Flop



PokerStars Hand #222960234744:  Hold'em No Limit ($0.05/$0.10 USD) - 2021/01/23 12:01:57 ET
Table 'Polydoros II' 6-max Seat #6 is the button
Seat 1: Clappasaur ($21.68 in chips) 
Seat 2: Lord_of_days ($15.61 in chips) 
Seat 3: DiskoDancer ($10 in chips) 
Seat 4: watersnow66 ($9.55 in chips) 
Seat 5: appu001 ($24.96 in chips) 
Seat 6: MARTIIRA ($16.67 in chips) 
Clappasaur: posts small blind $0.05
Lord_of_days: posts big blind $0.10
*** HOLE CARDS ***
DiskoDancer: folds 
watersnow66: folds 
appu001: folds 
MARTIIRA: folds 
Clappasaur: raises $0.20 to $0.30
Lord_of_days: calls $0.20
*** FLOP *** [2d Tc Th]
Clappasaur: bets $0.30
Lord_of_days: calls $0.30
*** TURN *** [2d Tc Th] [9s]
Clappasaur: bets $0.70
Lord_of_days: folds 
Uncalled bet ($0.70) returned to Clappasaur
Clappasaur collected $1.15 from pot
Clappasaur: doesn't show hand 
*** SUMMARY ***
Total pot $1.20 | Rake $0.05 
Board [2d Tc Th 9s]
Seat 1: Clappasaur (small blind) collected ($1.15)
Seat 2: Lord_of_days (big blind) folded on the Turn
Seat 3: DiskoDancer folded before Flop (didn't bet)
Seat 4: watersnow66 folded before Flop (didn't bet)
Seat 5: appu001 folded before Flop (didn't bet)
Seat 6: MARTIIRA (button) folded before Flop (didn't bet)



PokerStars Hand #222960252632:  Hold'em No Limit ($0.05/$0.10 USD) - 2021/01/23 12:02:25 ET
Table 'Polydoros II' 6-max Seat #1 is the button
Seat 1: Clappasaur ($22.23 in chips) 
Seat 2: Lord_of_days ($15.01 in chips) 
Seat 3: DiskoDancer ($10 in chips) 
Seat 4: watersnow66 ($9.55 in chips) 
Seat 5: appu001 ($24.96 in chips) 
Seat 6: MARTIIRA ($16.67 in chips) 
Lord_of_days: posts small blind $0.05
DiskoDancer: posts big blind $0.10
*** HOLE CARDS ***
watersnow66: calls $0.10
appu001: folds 
MARTIIRA: folds 
Clappasaur: raises $0.20 to $0.30
Lord_of_days: calls $0.25
DiskoDancer: folds 
watersnow66: calls $0.20
*** FLOP *** [8d Jd 3s]
Lord_of_days: checks 
watersnow66: checks 
Clappasaur: bets $0.50
Lord_of_days: folds 
watersnow66: calls $0.50
*** TURN *** [8d Jd 3s] [Qs]
watersnow66: checks 
Clappasaur: bets $1.10
watersnow66: raises $1.30 to $2.40
Clappasaur: folds 
Uncalled bet ($1.30) returned to watersnow66
watersnow66 collected $4.01 from pot
*** SUMMARY ***
Total pot $4.20 | Rake $0.19 
Board [8d Jd 3s Qs]
Seat 1: Clappasaur (button) folded on the Turn
Seat 2: Lord_of_days (small blind) folded on the Flop
Seat 3: DiskoDancer (big blind) folded before Flop
Seat 4: watersnow66 collected ($4.01)
Seat 5: appu001 folded before Flop (didn't bet)
Seat 6: MARTIIRA folded before Flop (didn't bet)



PokerStars Hand #222960282758:  Hold'em No Limit ($0.05/$0.10 USD) - 2021/01/23 12:03:15 ET
Table 'Polydoros II' 6-max Seat #2 is the button
Seat 1: Clappasaur ($20.33 in chips) 
Seat 2: Lord_of_days ($14.71 in chips) 
Seat 3: DiskoDancer ($10 in chips) 
Seat 4: watersnow66 ($11.66 in chips) 
Seat 5: appu001 ($24.96 in chips) 
Seat 6: MARTIIRA ($16.67 in chips) 
DiskoDancer: posts small blind $0.05
watersnow66: posts big blind $0.10
*** HOLE CARDS ***
appu001: folds 
MARTIIRA: raises $0.15 to $0.25
Clappasaur: calls $0.25
Lord_of_days: folds 
DiskoDancer: folds 
watersnow66: folds 
*** FLOP *** [Jd 2s 3h]
MARTIIRA: checks 
Clappasaur: bets $0.40
MARTIIRA: folds 
Uncalled bet ($0.40) returned to Clappasaur
Clappasaur collected $0.62 from pot
Clappasaur: doesn't show hand 
*** SUMMARY ***
Total pot $0.65 | Rake $0.03 
Board [Jd 2s 3h]
Seat 1: Clappasaur collected ($0.62)
Seat 2: Lord_of_days (button) folded before Flop (didn't bet)
Seat 3: DiskoDancer (small blind) folded before Flop
Seat 4: watersnow66 (big blind) folded before Flop
Seat 5: appu001 folded before Flop (didn't bet)
Seat 6: MARTIIRA folded on the Flop



PokerStars Hand #222960305406:  Hold'em No Limit ($0.05/$0.10 USD) - 2021/01/23 12:03:50 ET
Table 'Polydoros II' 6-max Seat #3 is the button
Seat 1: Clappasaur ($20.70 in chips) 
Seat 2: Lord_of_days ($14.71 in chips) 
Seat 3: DiskoDancer ($10 in chips) 
Seat 4: watersnow66 ($11.56 in chips) 
Seat 5: appu001 ($24.96 in chips) 
Seat 6: MARTIIRA ($16.42 in chips) 
watersnow66: posts small blind $0.05
appu001: posts big blind $0.10
*** HOLE CARDS ***
MARTIIRA: folds 
Clappasaur: raises $0.10 to $0.20
Lord_of_days: folds 
DiskoDancer: calls $0.20
watersnow66: calls $0.15
appu001: calls $0.10
*** FLOP *** [Tc 5s 8d]
watersnow66: checks 
appu001: checks 
Clappasaur: checks 
DiskoDancer: bets $0.40
watersnow66: folds 
appu001: folds 
Clappasaur: folds 
Uncalled bet ($0.40) returned to DiskoDancer
DiskoDancer collected $0.76 from pot
DiskoDancer: doesn't show hand 
*** SUMMARY ***
Total pot $0.80 | Rake $0.04 
Board [Tc 5s 8d]
Seat 1: Clappasaur folded on the Flop
Seat 2: Lord_of_days folded before Flop (didn't bet)
Seat 3: DiskoDancer (button) collected ($0.76)
Seat 4: watersnow66 (small blind) folded on the Flop
Seat 5: appu001 (big blind) folded on the Flop
Seat 6: MARTIIRA folded before Flop (didn't bet)



PokerStars Hand #222960346196:  Hold'em No Limit ($0.05/$0.10 USD) - 2021/01/23 12:04:55 ET
Table 'Polydoros II' 6-max Seat #4 is the button
Seat 1: Clappasaur ($20.50 in chips) 
Seat 2: Lord_of_days ($14.71 in chips) 
Seat 3: DiskoDancer ($10.56 in chips) 
Seat 4: watersnow66 ($11.36 in chips) 
Seat 5: appu001 ($24.76 in chips) 
Seat 6: MARTIIRA ($16.42 in chips) 
appu001: posts small blind $0.05
MARTIIRA: posts big blind $0.10
*** HOLE CARDS ***
Clappasaur: folds 
Lord_of_days has timed out
Lord_of_days: folds 
DiskoDancer: folds 
watersnow66: calls $0.10
appu001: raises $0.30 to $0.40
MARTIIRA: calls $0.30
watersnow66: calls $0.30
*** FLOP *** [Jd 7s 7d]
appu001: checks 
MARTIIRA: checks 
watersnow66: checks 
*** TURN *** [Jd 7s 7d] [Js]
appu001: bets $0.50
MARTIIRA: calls $0.50
watersnow66: folds 
*** RIVER *** [Jd 7s 7d Js] [4c]
appu001: checks 
MARTIIRA: checks 
*** SHOW DOWN ***
appu001: shows [Ks 8s] (two pair, Jacks and Sevens)
MARTIIRA: shows [8h 8d] (two pair, Jacks and Eights)
MARTIIRA collected $2.10 from pot
*** SUMMARY ***
Total pot $2.20 | Rake $0.10 
Board [Jd 7s 7d Js 4c]
Seat 1: Clappasaur folded before Flop (didn't bet)
Seat 2: Lord_of_days folded before Flop (didn't bet)
Seat 3: DiskoDancer folded before Flop (didn't bet)
Seat 4: watersnow66 (button) folded on the Turn
Seat 5: appu001 (small blind) showed [Ks 8s] and lost with two pair, Jacks and Sevens
Seat 6: MARTIIRA (big blind) showed [8h 8d] and won ($2.10) with two pair, Jacks and Eights



PokerStars Hand #222960393687:  Hold'em No Limit ($0.05/$0.10 USD) - 2021/01/23 12:06:11 ET
Table 'Polydoros II' 6-max Seat #5 is the button
Seat 1: Clappasaur ($20.50 in chips) 
Seat 2: Lord_of_days ($14.71 in chips) 
Seat 3: DiskoDancer ($10.56 in chips) 
Seat 4: watersnow66 ($10.96 in chips) 
Seat 5: appu001 ($23.86 in chips) 
Seat 6: MARTIIRA ($17.62 in chips) 
MARTIIRA: posts small blind $0.05
Clappasaur: posts big blind $0.10
*** HOLE CARDS ***
Lord_of_days: folds 
DiskoDancer: folds 
watersnow66: folds 
appu001: raises $0.40 to $0.50
MARTIIRA: calls $0.45
Clappasaur: calls $0.40
*** FLOP *** [Ts 8h 3d]
MARTIIRA: checks 
Clappasaur: bets $0.80
appu001: calls $0.80
MARTIIRA: folds 
*** TURN *** [Ts 8h 3d] [7c]
Clappasaur: bets $1.60
appu001: calls $1.60
*** RIVER *** [Ts 8h 3d 7c] [Ac]
Clappasaur: bets $3.01
appu001: folds 
Uncalled bet ($3.01) returned to Clappasaur
Clappasaur collected $6.02 from pot
Clappasaur: doesn't show hand 
*** SUMMARY ***
Total pot $6.30 | Rake $0.28 
Board [Ts 8h 3d 7c Ac]
Seat 1: Clappasaur (big blind) collected ($6.02)
Seat 2: Lord_of_days folded before Flop (didn't bet)
Seat 3: DiskoDancer folded before Flop (didn't bet)
Seat 4: watersnow66 folded before Flop (didn't bet)
Seat 5: appu001 (button) folded on the River
Seat 6: MARTIIRA (small blind) folded on the Flop



PokerStars Hand #222960421005:  Hold'em No Limit ($0.05/$0.10 USD) - 2021/01/23 12:06:54 ET
Table 'Polydoros II' 6-max Seat #6 is the button
Seat 1: Clappasaur ($23.62 in chips) 
Seat 2: Lord_of_days ($14.71 in chips) 
Seat 3: DiskoDancer ($10.56 in chips) 
Seat 4: watersnow66 ($10.96 in chips) 
Seat 5: appu001 ($20.96 in chips) 
Seat 6: MARTIIRA ($17.12 in chips) 
Clappasaur: posts small blind $0.05
Lord_of_days: posts big blind $0.10
*** HOLE CARDS ***
DiskoDancer: folds 
watersnow66: folds 
appu001: raises $0.10 to $0.20
MARTIIRA: folds 
Clappasaur: folds 
Lord_of_days: calls $0.10
*** FLOP *** [6h 7d Ks]
Lord_of_days: checks 
appu001: checks 
*** TURN *** [6h 7d Ks] [7h]
Lord_of_days: checks 
appu001: bets $0.40
Lord_of_days: calls $0.40
*** RIVER *** [6h 7d Ks 7h] [7s]
Lord_of_days: checks 
appu001: bets $2.50
Lord_of_days: calls $2.50
*** SHOW DOWN ***
appu001: shows [Js 4s] (three of a kind, Sevens)
Lord_of_days: shows [5d 6d] (a full house, Sevens full of Sixes)
Lord_of_days collected $5.97 from pot
*** SUMMARY ***
Total pot $6.25 | Rake $0.28 
Board [6h 7d Ks 7h 7s]
Seat 1: Clappasaur (small blind) folded before Flop
Seat 2: Lord_of_days (big blind) showed [5d 6d] and won ($5.97) with a full house, Sevens full of Sixes
Seat 3: DiskoDancer folded before Flop (didn't bet)
Seat 4: watersnow66 folded before Flop (didn't bet)
Seat 5: appu001 showed [Js 4s] and lost with three of a kind, Sevens
Seat 6: MARTIIRA (button) folded before Flop (didn't bet)



PokerStars Hand #222960446626:  Hold'em No Limit ($0.05/$0.10 USD) - 2021/01/23 12:07:34 ET
Table 'Polydoros II' 6-max Seat #1 is the button
Seat 1: Clappasaur ($23.57 in chips) 
Seat 2: Lord_of_days ($17.58 in chips) 
Seat 3: DiskoDancer ($10.56 in chips) 
Seat 4: watersnow66 ($10.96 in chips) 
Seat 5: appu001 ($17.86 in chips) 
Seat 6: MARTIIRA ($17.12 in chips) 
Lord_of_days: posts small blind $0.05
DiskoDancer: posts big blind $0.10
*** HOLE CARDS ***
watersnow66: folds 
appu001: calls $0.10
MARTIIRA: raises $0.30 to $0.40
Clappasaur: folds 
Lord_of_days: folds 
DiskoDancer: folds 
appu001: calls $0.30
*** FLOP *** [Jd Kd 8s]
appu001: checks 
MARTIIRA: bets $0.60
appu001: folds 
Uncalled bet ($0.60) returned to MARTIIRA
MARTIIRA collected $0.91 from pot
MARTIIRA: doesn't show hand 
*** SUMMARY ***
Total pot $0.95 | Rake $0.04 
Board [Jd Kd 8s]
Seat 1: Clappasaur (button) folded before Flop (didn't bet)
Seat 2: Lord_of_days (small blind) folded before Flop
Seat 3: DiskoDancer (big blind) folded before Flop
Seat 4: watersnow66 folded before Flop (didn't bet)
Seat 5: appu001 folded on the Flop
Seat 6: MARTIIRA collected ($0.91)



PokerStars Hand #222960471862:  Hold'em No Limit ($0.05/$0.10 USD) - 2021/01/23 12:08:14 ET
Table 'Polydoros II' 6-max Seat #2 is the button
Seat 1: Clappasaur ($23.57 in chips) 
Seat 2: Lord_of_days ($17.53 in chips) 
Seat 3: DiskoDancer ($10.46 in chips) 
Seat 5: appu001 ($17.46 in chips) 
Seat 6: MARTIIRA ($17.63 in chips) 
DiskoDancer: posts small blind $0.05
appu001: posts big blind $0.10
*** HOLE CARDS ***
MARTIIRA: folds 
Clappasaur: folds 
Lord_of_days: raises $0.20 to $0.30
DiskoDancer: folds 
appu001: raises $0.20 to $0.50
Lord_of_days: calls $0.20
*** FLOP *** [2c Jd 9h]
appu001: bets $1
Lord_of_days: calls $1
*** TURN *** [2c Jd 9h] [7c]
appu001: bets $1
Lord_of_days: calls $1
*** RIVER *** [2c Jd 9h 7c] [3c]
appu001: checks 
Lord_of_days: checks 
*** SHOW DOWN ***
appu001: shows [Ks Qc] (high card King)
Lord_of_days: shows [9d Qh] (a pair of Nines)
Lord_of_days collected $4.82 from pot
*** SUMMARY ***
Total pot $5.05 | Rake $0.23 
Board [2c Jd 9h 7c 3c]
Seat 1: Clappasaur folded before Flop (didn't bet)
Seat 2: Lord_of_days (button) showed [9d Qh] and won ($4.82) with a pair of Nines
Seat 3: DiskoDancer (small blind) folded before Flop
Seat 5: appu001 (big blind) showed [Ks Qc] and lost with high card King
Seat 6: MARTIIRA folded before Flop (didn't bet)



PokerStars Hand #222960496087:  Hold'em No Limit ($0.05/$0.10 USD) - 2021/01/23 12:08:53 ET
Table 'Polydoros II' 6-max Seat #3 is the button
Seat 1: Clappasaur ($23.57 in chips) 
Seat 2: Lord_of_days ($19.85 in chips) 
Seat 3: DiskoDancer ($10.41 in chips) 
Seat 5: appu001 ($14.96 in chips) 
Seat 6: MARTIIRA ($17.63 in chips) 
appu001: posts small blind $0.05
MARTIIRA: posts big blind $0.10
*** HOLE CARDS ***
Clappasaur: raises $0.10 to $0.20
Lord_of_days: folds 
DiskoDancer: folds 
appu001: raises $0.50 to $0.70
MARTIIRA: folds 
Clappasaur: calls $0.50
*** FLOP *** [5c Js Qs]
appu001: checks 
Clappasaur: bets $0.80
appu001: calls $0.80
*** TURN *** [5c Js Qs] [6c]
appu001: checks 
Clappasaur: bets $1.80
appu001: folds 
Uncalled bet ($1.80) returned to Clappasaur
Clappasaur collected $2.96 from pot
Clappasaur: doesn't show hand 
*** SUMMARY ***
Total pot $3.10 | Rake $0.14 
Board [5c Js Qs 6c]
Seat 1: Clappasaur collected ($2.96)
Seat 2: Lord_of_days folded before Flop (didn't bet)
Seat 3: DiskoDancer (button) folded before Flop (didn't bet)
Seat 5: appu001 (small blind) folded on the Turn
Seat 6: MARTIIRA (big blind) folded before Flop



PokerStars Hand #222960519284:  Hold'em No Limit ($0.05/$0.10 USD) - 2021/01/23 12:09:30 ET
Table 'Polydoros II' 6-max Seat #5 is the button
Seat 1: Clappasaur ($25.03 in chips) 
Seat 2: Lord_of_days ($19.85 in chips) 
Seat 3: DiskoDancer ($10.41 in chips) 
Seat 5: appu001 ($13.46 in chips) 
Seat 6: MARTIIRA ($17.53 in chips) 
MARTIIRA: posts small blind $0.05
Clappasaur: posts big blind $0.10
*** HOLE CARDS ***
Lord_of_days: folds 
DiskoDancer: folds 
appu001: calls $0.10
MARTIIRA: folds 
Clappasaur: checks 
*** FLOP *** [6s 3d 5h]
Clappasaur: checks 
appu001: bets $0.50
Clappasaur: folds 
Uncalled bet ($0.50) returned to appu001
appu001 collected $0.24 from pot
appu001: doesn't show hand 
*** SUMMARY ***
Total pot $0.25 | Rake $0.01 
Board [6s 3d 5h]
Seat 1: Clappasaur (big blind) folded on the Flop
Seat 2: Lord_of_days folded before Flop (didn't bet)
Seat 3: DiskoDancer folded before Flop (didn't bet)
Seat 5: appu001 (button) collected ($0.24)
Seat 6: MARTIIRA (small blind) folded before Flop



PokerStars Hand #222960534482:  Hold'em No Limit ($0.05/$0.10 USD) - 2021/01/23 12:09:54 ET
Table 'Polydoros II' 6-max Seat #6 is the button
Seat 1: Clappasaur ($24.93 in chips) 
Seat 2: Lord_of_days ($19.85 in chips) 
Seat 3: DiskoDancer ($10.41 in chips) 
Seat 5: appu001 ($13.60 in chips) 
Seat 6: MARTIIRA ($17.48 in chips) 
Clappasaur: posts small blind $0.05
Lord_of_days: posts big blind $0.10
*** HOLE CARDS ***
DiskoDancer: folds 
appu001: calls $0.10
MARTIIRA: folds 
Clappasaur: folds 
Lord_of_days: checks 
*** FLOP *** [4h 5s Js]
Lord_of_days: checks 
appu001: bets $0.40
Lord_of_days: calls $0.40
*** TURN *** [4h 5s Js] [2s]
Lord_of_days: checks 
appu001: bets $3.20
Lord_of_days: folds 
Uncalled bet ($3.20) returned to appu001
appu001 collected $1 from pot
appu001: doesn't show hand 
*** SUMMARY ***
Total pot $1.05 | Rake $0.05 
Board [4h 5s Js 2s]
Seat 1: Clappasaur (small blind) folded before Flop
Seat 2: Lord_of_days (big blind) folded on the Turn
Seat 3: DiskoDancer folded before Flop (didn't bet)
Seat 5: appu001 collected ($1)
Seat 6: MARTIIRA (button) folded before Flop (didn't bet)



PokerStars Hand #222960549384:  Hold'em No Limit ($0.05/$0.10 USD) - 2021/01/23 12:10:17 ET
Table 'Polydoros II' 6-max Seat #1 is the button
Seat 1: Clappasaur ($24.88 in chips) 
Seat 2: Lord_of_days ($19.35 in chips) 
Seat 3: DiskoDancer ($10.41 in chips) 
Seat 5: appu001 ($14.10 in chips) 
Seat 6: MARTIIRA ($17.48 in chips) 
Lord_of_days: posts small blind $0.05
DiskoDancer: posts big blind $0.10
*** HOLE CARDS ***
appu001: folds 
MARTIIRA: folds 
Clappasaur: raises $0.20 to $0.30
Lord_of_days: raises $0.80 to $1.10
DiskoDancer: folds 
Clappasaur: calls $0.80
*** FLOP *** [2h Kc Js]
Lord_of_days: bets $0.73
Clappasaur: calls $0.73
*** TURN *** [2h Kc Js] [7d]
Lord_of_days: checks 
Clappasaur: checks 
*** RIVER *** [2h Kc Js 7d] [Tc]
Lord_of_days: bets $1.94
Clappasaur: calls $1.94
*** SHOW DOWN ***
Lord_of_days: shows [Td Jd] (two pair, Jacks and Tens)
Clappasaur: mucks hand 
Lord_of_days collected $7.30 from pot
*** SUMMARY ***
Total pot $7.64 | Rake $0.34 
Board [2h Kc Js 7d Tc]
Seat 1: Clappasaur (button) mucked
Seat 2: Lord_of_days (small blind) showed [Td Jd] and won ($7.30) with two pair, Jacks and Tens
Seat 3: DiskoDancer (big blind) folded before Flop
Seat 5: appu001 folded before Flop (didn't bet)
Seat 6: MARTIIRA folded before Flop (didn't bet)



PokerStars Hand #222960578580:  Hold'em No Limit ($0.05/$0.10 USD) - 2021/01/23 12:11:04 ET
Table 'Polydoros II' 6-max Seat #2 is the button
Seat 1: Clappasaur ($21.11 in chips) 
Seat 2: Lord_of_days ($22.88 in chips) 
Seat 3: DiskoDancer ($10.31 in chips) 
Seat 5: appu001 ($14.10 in chips) 
Seat 6: MARTIIRA ($17.48 in chips) 
DiskoDancer: posts small blind $0.05
appu001: posts big blind $0.10
*** HOLE CARDS ***
MARTIIRA: folds 
Clappasaur: raises $0.20 to $0.30
Lord_of_days: calls $0.30
DiskoDancer: folds 
appu001: raises $0.20 to $0.50
Clappasaur: raises $0.50 to $1
Lord_of_days: calls $0.70
appu001: calls $0.50
*** FLOP *** [3c Td Ac]
appu001: bets $0.70
Clappasaur: calls $0.70
Lord_of_days: folds 
*** TURN *** [3c Td Ac] [Kc]
appu001: bets $0.70
Clappasaur: raises $1.20 to $1.90
appu001: calls $1.20
*** RIVER *** [3c Td Ac Kc] [9h]
appu001: checks 
Clappasaur: bets $4.20
appu001: calls $4.20
*** SHOW DOWN ***
Clappasaur: shows [Kd Ks] (three of a kind, Kings)
appu001: mucks hand 
Clappasaur collected $15.90 from pot
*** SUMMARY ***
Total pot $16.65 | Rake $0.75 
Board [3c Td Ac Kc 9h]
Seat 1: Clappasaur showed [Kd Ks] and won ($15.90) with three of a kind, Kings
Seat 2: Lord_of_days (button) folded on the Flop
Seat 3: DiskoDancer (small blind) folded before Flop
Seat 5: appu001 (big blind) mucked
Seat 6: MARTIIRA folded before Flop (didn't bet)



PokerStars Hand #222960614388:  Hold'em No Limit ($0.05/$0.10 USD) - 2021/01/23 12:12:00 ET
Table 'Polydoros II' 6-max Seat #3 is the button
Seat 1: Clappasaur ($29.21 in chips) 
Seat 2: Lord_of_days ($21.88 in chips) 
Seat 3: DiskoDancer ($10.26 in chips) 
Seat 5: appu001 ($6.30 in chips) 
Seat 6: MARTIIRA ($17.48 in chips) 
appu001: posts small blind $0.05
MARTIIRA: posts big blind $0.10
*** HOLE CARDS ***
Clappasaur: folds 
Lord_of_days: folds 
DiskoDancer: raises $0.15 to $0.25
appu001: raises $0.25 to $0.50
MARTIIRA: folds 
DiskoDancer: calls $0.25
*** FLOP *** [Ts 8d 3h]
appu001: bets $0.50
DiskoDancer: folds 
Uncalled bet ($0.50) returned to appu001
appu001 collected $1.05 from pot
appu001: doesn't show hand 
*** SUMMARY ***
Total pot $1.10 | Rake $0.05 
Board [Ts 8d 3h]
Seat 1: Clappasaur folded before Flop (didn't bet)
Seat 2: Lord_of_days folded before Flop (didn't bet)
Seat 3: DiskoDancer (button) folded on the Flop
Seat 5: appu001 (small blind) collected ($1.05)
Seat 6: MARTIIRA (big blind) folded before Flop



PokerStars Hand #222960634752:  Hold'em No Limit ($0.05/$0.10 USD) - 2021/01/23 12:12:33 ET
Table 'Polydoros II' 6-max Seat #5 is the button
Seat 1: Clappasaur ($29.21 in chips) 
Seat 2: Lord_of_days ($21.88 in chips) 
Seat 3: DiskoDancer ($10 in chips) 
Seat 5: appu001 ($6.85 in chips) 
Seat 6: MARTIIRA ($17.38 in chips) 
MARTIIRA: posts small blind $0.05
Clappasaur: posts big blind $0.10
*** HOLE CARDS ***
Lord_of_days: folds 
DiskoDancer: folds 
appu001: raises $0.30 to $0.40
MARTIIRA: folds 
Clappasaur: raises $0.80 to $1.20
appu001: calls $0.80
*** FLOP *** [Ac 7c Jd]
Clappasaur: checks 
appu001: checks 
*** TURN *** [Ac 7c Jd] [6s]
Clappasaur: checks 
appu001: bets $1.10
Clappasaur: calls $1.10
*** RIVER *** [Ac 7c Jd 6s] [Jh]
Clappasaur: checks 
appu001: bets $4.55 and is all-in
Clappasaur: calls $4.55
*** SHOW DOWN ***
appu001: shows [As 9c] (two pair, Aces and Jacks)
Clappasaur: shows [Tc Ts] (two pair, Jacks and Tens)
appu001 collected $13.13 from pot
*** SUMMARY ***
Total pot $13.75 | Rake $0.62 
Board [Ac 7c Jd 6s Jh]
Seat 1: Clappasaur (big blind) showed [Tc Ts] and lost with two pair, Jacks and Tens
Seat 2: Lord_of_days folded before Flop (didn't bet)
Seat 3: DiskoDancer folded before Flop (didn't bet)
Seat 5: appu001 (button) showed [As 9c] and won ($13.13) with two pair, Aces and Jacks
Seat 6: MARTIIRA (small blind) folded before Flop



PokerStars Hand #222960665259:  Hold'em No Limit ($0.05/$0.10 USD) - 2021/01/23 12:13:19 ET
Table 'Polydoros II' 6-max Seat #6 is the button
Seat 1: Clappasaur ($22.36 in chips) 
Seat 2: Lord_of_days ($21.88 in chips) 
Seat 3: DiskoDancer ($10 in chips) 
Seat 5: appu001 ($13.13 in chips) 
Seat 6: MARTIIRA ($17.33 in chips) 
Clappasaur: posts small blind $0.05
Lord_of_days: posts big blind $0.10
*** HOLE CARDS ***
DiskoDancer: folds 
appu001: folds 
MARTIIRA: folds 
Clappasaur: folds 
Uncalled bet ($0.05) returned to Lord_of_days
Lord_of_days collected $0.10 from pot
Lord_of_days: doesn't show hand 
*** SUMMARY ***
Total pot $0.10 | Rake $0 
Seat 1: Clappasaur (small blind) folded before Flop
Seat 2: Lord_of_days (big blind) collected ($0.10)
Seat 3: DiskoDancer folded before Flop (didn't bet)
Seat 5: appu001 folded before Flop (didn't bet)
Seat 6: MARTIIRA (button) folded before Flop (didn't bet)



PokerStars Hand #222960682058:  Hold'em No Limit ($0.05/$0.10 USD) - 2021/01/23 12:13:46 ET
Table 'Polydoros II' 6-max Seat #1 is the button
Seat 1: Clappasaur ($22.31 in chips) 
Seat 2: Lord_of_days ($21.93 in chips) 
Seat 3: DiskoDancer ($10 in chips) 
Seat 5: appu001 ($13.13 in chips) 
Seat 6: MARTIIRA ($17.33 in chips) 
Lord_of_days: posts small blind $0.05
DiskoDancer: posts big blind $0.10
*** HOLE CARDS ***
appu001: folds 
MARTIIRA: folds 
Clappasaur: folds 
Lord_of_days: raises $0.20 to $0.30
DiskoDancer: folds 
Uncalled bet ($0.20) returned to Lord_of_days
Lord_of_days collected $0.20 from pot
Lord_of_days: doesn't show hand 
*** SUMMARY ***
Total pot $0.20 | Rake $0 
Seat 1: Clappasaur (button) folded before Flop (didn't bet)
Seat 2: Lord_of_days (small blind) collected ($0.20)
Seat 3: DiskoDancer (big blind) folded before Flop
Seat 5: appu001 folded before Flop (didn't bet)
Seat 6: MARTIIRA folded before Flop (didn't bet)



PokerStars Hand #222960690650:  Hold'em No Limit ($0.05/$0.10 USD) - 2021/01/23 12:13:59 ET
Table 'Polydoros II' 6-max Seat #2 is the button
Seat 1: Clappasaur ($22.31 in chips) 
Seat 2: Lord_of_days ($22.03 in chips) 
Seat 3: DiskoDancer ($10 in chips) 
Seat 4: watersnow66 ($10.96 in chips) 
Seat 5: appu001 ($13.13 in chips) 
Seat 6: MARTIIRA ($17.33 in chips) 
DiskoDancer: posts small blind $0.05
watersnow66: posts big blind $0.10
*** HOLE CARDS ***
appu001: folds 
MARTIIRA: folds 
Clappasaur: raises $0.20 to $0.30
Lord_of_days: folds 
DiskoDancer: folds 
watersnow66: folds 
Uncalled bet ($0.20) returned to Clappasaur
Clappasaur collected $0.25 from pot
Clappasaur: doesn't show hand 
*** SUMMARY ***
Total pot $0.25 | Rake $0 
Seat 1: Clappasaur collected ($0.25)
Seat 2: Lord_of_days (button) folded before Flop (didn't bet)
Seat 3: DiskoDancer (small blind) folded before Flop
Seat 4: watersnow66 (big blind) folded before Flop
Seat 5: appu001 folded before Flop (didn't bet)
Seat 6: MARTIIRA folded before Flop (didn't bet)



PokerStars Hand #222960699563:  Hold'em No Limit ($0.05/$0.10 USD) - 2021/01/23 12:14:14 ET
Table 'Polydoros II' 6-max Seat #3 is the button
Seat 1: Clappasaur ($22.46 in chips) 
Seat 2: Lord_of_days ($22.03 in chips) 
Seat 3: DiskoDancer ($10 in chips) 
Seat 4: watersnow66 ($10.86 in chips) 
Seat 5: appu001 ($13.13 in chips) 
Seat 6: MARTIIRA ($17.33 in chips) 
watersnow66: posts small blind $0.05
appu001: posts big blind $0.10
*** HOLE CARDS ***
MARTIIRA: folds 
Clappasaur: raises $0.20 to $0.30
Lord_of_days: raises $0.60 to $0.90
DiskoDancer: folds 
watersnow66: folds 
appu001: folds 
Clappasaur: calls $0.60
*** FLOP *** [Js Ac Kh]
Clappasaur: checks 
Lord_of_days: bets $0.61
Clappasaur: calls $0.61
*** TURN *** [Js Ac Kh] [2h]
Clappasaur: checks 
Lord_of_days: bets $2.48
Clappasaur: calls $2.48
*** RIVER *** [Js Ac Kh 2h] [4h]
Clappasaur: checks 
Lord_of_days: bets $4.19
Clappasaur: raises $14.28 to $18.47 and is all-in
Lord_of_days: calls $13.85 and is all-in
Uncalled bet ($0.43) returned to Clappasaur
*** SHOW DOWN ***
Clappasaur: shows [Th Qc] (a straight, Ten to Ace)
Lord_of_days: shows [Kd Ad] (two pair, Aces and Kings)
Clappasaur collected $42.71 from pot
*** SUMMARY ***
Total pot $44.21 | Rake $1.50 
Board [Js Ac Kh 2h 4h]
Seat 1: Clappasaur showed [Th Qc] and won ($42.71) with a straight, Ten to Ace
Seat 2: Lord_of_days showed [Kd Ad] and lost with two pair, Aces and Kings
Seat 3: DiskoDancer (button) folded before Flop (didn't bet)
Seat 4: watersnow66 (small blind) folded before Flop
Seat 5: appu001 (big blind) folded before Flop
Seat 6: MARTIIRA folded before Flop (didn't bet)



PokerStars Hand #222960753925:  Hold'em No Limit ($0.05/$0.10 USD) - 2021/01/23 12:15:40 ET
Table 'Polydoros II' 6-max Seat #4 is the button
Seat 1: Clappasaur ($43.14 in chips) 
Seat 2: Lord_of_days ($10 in chips) 
Seat 3: DiskoDancer ($10 in chips) 
Seat 4: watersnow66 ($10.81 in chips) 
Seat 5: appu001 ($13.03 in chips) 
Seat 6: MARTIIRA ($17.33 in chips) 
appu001: posts small blind $0.05
MARTIIRA: posts big blind $0.10
*** HOLE CARDS ***
Clappasaur: folds 
Lord_of_days: raises $0.20 to $0.30
DiskoDancer: folds 
watersnow66: calls $0.30
appu001: folds 
MARTIIRA: calls $0.20
*** FLOP *** [6d 7c 8s]
MARTIIRA: checks 
Lord_of_days: bets $0.30
watersnow66: calls $0.30
MARTIIRA: folds 
*** TURN *** [6d 7c 8s] [4h]
Lord_of_days: checks 
watersnow66: bets $0.74
Lord_of_days: folds 
Uncalled bet ($0.74) returned to watersnow66
watersnow66 collected $1.48 from pot
*** SUMMARY ***
Total pot $1.55 | Rake $0.07 
Board [6d 7c 8s 4h]
Seat 1: Clappasaur folded before Flop (didn't bet)
Seat 2: Lord_of_days folded on the Turn
Seat 3: DiskoDancer folded before Flop (didn't bet)
Seat 4: watersnow66 (button) collected ($1.48)
Seat 5: appu001 (small blind) folded before Flop
Seat 6: MARTIIRA (big blind) folded on the Flop



PokerStars Hand #222960797558:  Hold'em No Limit ($0.05/$0.10 USD) - 2021/01/23 12:16:48 ET
Table 'Polydoros II' 6-max Seat #5 is the button
Seat 1: Clappasaur ($43.14 in chips) 
Seat 2: Lord_of_days ($10 in chips) 
Seat 3: DiskoDancer ($10 in chips) 
Seat 4: watersnow66 ($11.69 in chips) 
Seat 5: appu001 ($12.98 in chips) 
Seat 6: MARTIIRA ($17.03 in chips) 
MARTIIRA: posts small blind $0.05
Clappasaur: posts big blind $0.10
*** HOLE CARDS ***
Lord_of_days: folds 
DiskoDancer: folds 
watersnow66: folds 
appu001: raises $0.10 to $0.20
MARTIIRA: folds 
Clappasaur: calls $0.10
*** FLOP *** [2s 8c 3s]
Clappasaur: bets $0.30
appu001: folds 
Uncalled bet ($0.30) returned to Clappasaur
Clappasaur collected $0.43 from pot
Clappasaur: doesn't show hand 
*** SUMMARY ***
Total pot $0.45 | Rake $0.02 
Board [2s 8c 3s]
Seat 1: Clappasaur (big blind) collected ($0.43)
Seat 2: Lord_of_days folded before Flop (didn't bet)
Seat 3: DiskoDancer folded before Flop (didn't bet)
Seat 4: watersnow66 folded before Flop (didn't bet)
Seat 5: appu001 (button) folded on the Flop
Seat 6: MARTIIRA (small blind) folded before Flop



PokerStars Hand #222960813404:  Hold'em No Limit ($0.05/$0.10 USD) - 2021/01/23 12:17:13 ET
Table 'Polydoros II' 6-max Seat #6 is the button
Seat 1: Clappasaur ($43.37 in chips) 
Seat 2: Lord_of_days ($10 in chips) 
Seat 3: DiskoDancer ($10 in chips) 
Seat 4: watersnow66 ($11.69 in chips) 
Seat 5: appu001 ($12.78 in chips) 
Seat 6: MARTIIRA ($16.98 in chips) 
Clappasaur: posts small blind $0.05
Lord_of_days: posts big blind $0.10
*** HOLE CARDS ***
DiskoDancer: folds 
watersnow66: folds 
appu001: raises $0.10 to $0.20
MARTIIRA: folds 
Clappasaur: calls $0.15
Lord_of_days: calls $0.10
*** FLOP *** [2d Ac 3c]
Clappasaur: checks 
Lord_of_days: checks 
appu001: bets $0.50
Clappasaur: folds 
Lord_of_days: folds 
Uncalled bet ($0.50) returned to appu001
appu001 collected $0.57 from pot
appu001: doesn't show hand 
*** SUMMARY ***
Total pot $0.60 | Rake $0.03 
Board [2d Ac 3c]
Seat 1: Clappasaur (small blind) folded on the Flop
Seat 2: Lord_of_days (big blind) folded on the Flop
Seat 3: DiskoDancer folded before Flop (didn't bet)
Seat 4: watersnow66 folded before Flop (didn't bet)
Seat 5: appu001 collected ($0.57)
Seat 6: MARTIIRA (button) folded before Flop (didn't bet)



PokerStars Hand #222960827477:  Hold'em No Limit ($0.05/$0.10 USD) - 2021/01/23 12:17:36 ET
Table 'Polydoros II' 6-max Seat #1 is the button
Seat 1: Clappasaur ($43.17 in chips) 
Seat 2: Lord_of_days ($10 in chips) 
Seat 3: DiskoDancer ($10 in chips) 
Seat 4: watersnow66 ($11.69 in chips) 
Seat 5: appu001 ($13.15 in chips) 
Seat 6: MARTIIRA ($16.98 in chips) 
Lord_of_days: posts small blind $0.05
DiskoDancer: posts big blind $0.10
*** HOLE CARDS ***
watersnow66: folds 
appu001: calls $0.10
MARTIIRA: folds 
Clappasaur: folds 
Lord_of_days: folds 
DiskoDancer: checks 
*** FLOP *** [Qs Jc 7d]
DiskoDancer: checks 
appu001: checks 
*** TURN *** [Qs Jc 7d] [Ah]
DiskoDancer: checks 
appu001: bets $0.60
DiskoDancer: folds 
Uncalled bet ($0.60) returned to appu001
appu001 collected $0.24 from pot
appu001: doesn't show hand 
*** SUMMARY ***
Total pot $0.25 | Rake $0.01 
Board [Qs Jc 7d Ah]
Seat 1: Clappasaur (button) folded before Flop (didn't bet)
Seat 2: Lord_of_days (small blind) folded before Flop
Seat 3: DiskoDancer (big blind) folded on the Turn
Seat 4: watersnow66 folded before Flop (didn't bet)
Seat 5: appu001 collected ($0.24)
Seat 6: MARTIIRA folded before Flop (didn't bet)



PokerStars Hand #222960845138:  Hold'em No Limit ($0.05/$0.10 USD) - 2021/01/23 12:18:04 ET
Table 'Polydoros II' 6-max Seat #2 is the button
Seat 1: Clappasaur ($43.17 in chips) 
Seat 2: Lord_of_days ($9.95 in chips) 
Seat 3: DiskoDancer ($10 in chips) 
Seat 4: watersnow66 ($11.69 in chips) 
Seat 5: appu001 ($13.29 in chips) 
Seat 6: MARTIIRA ($16.98 in chips) 
DiskoDancer: posts small blind $0.05
watersnow66: posts big blind $0.10
*** HOLE CARDS ***
appu001: calls $0.10
MARTIIRA: raises $0.30 to $0.40
Clappasaur: folds 
Lord_of_days: folds 
DiskoDancer: folds 
watersnow66: folds 
appu001: calls $0.30
*** FLOP *** [9d Qc 8s]
appu001: checks 
MARTIIRA: checks 
*** TURN *** [9d Qc 8s] [2s]
appu001: bets $0.40
MARTIIRA: folds 
Uncalled bet ($0.40) returned to appu001
MARTIIRA was removed from the table for failing to post
MARTIIRA leaves the table
appu001 collected $0.91 from pot
appu001: doesn't show hand 
*** SUMMARY ***
Total pot $0.95 | Rake $0.04 
Board [9d Qc 8s 2s]
Seat 1: Clappasaur folded before Flop (didn't bet)
Seat 2: Lord_of_days (button) folded before Flop (didn't bet)
Seat 3: DiskoDancer (small blind) folded before Flop
Seat 4: watersnow66 (big blind) folded before Flop
Seat 5: appu001 collected ($0.91)
Seat 6: MARTIIRA folded on the Turn



PokerStars Hand #222960875394:  Hold'em No Limit ($0.05/$0.10 USD) - 2021/01/23 12:18:48 ET
Table 'Polydoros II' 6-max Seat #3 is the button
Seat 1: Clappasaur ($43.17 in chips) 
Seat 2: Lord_of_days ($9.95 in chips) 
Seat 3: DiskoDancer ($10 in chips) 
Seat 4: watersnow66 ($11.59 in chips) 
Seat 5: appu001 ($13.80 in chips) 
watersnow66: posts small blind $0.05
appu001: posts big blind $0.10
*** HOLE CARDS ***
Clappasaur: raises $0.20 to $0.30
Ruman_One joins the table at seat #6 
Lord_of_days: raises $0.60 to $0.90
DiskoDancer: folds 
watersnow66: folds 
appu001: folds 
Clappasaur: calls $0.60
*** FLOP *** [9d 3h Js]
Clappasaur: checks 
Lord_of_days: bets $0.61
Clappasaur: calls $0.61
*** TURN *** [9d 3h Js] [9s]
Clappasaur: checks 
Lord_of_days: checks 
*** RIVER *** [9d 3h Js 9s] [2d]
Clappasaur: checks 
Lord_of_days: checks 
*** SHOW DOWN ***
Clappasaur: shows [Kc 3c] (two pair, Nines and Threes)
Lord_of_days: shows [8c 8s] (two pair, Nines and Eights)
Lord_of_days collected $3.03 from pot
*** SUMMARY ***
Total pot $3.17 | Rake $0.14 
Board [9d 3h Js 9s 2d]
Seat 1: Clappasaur showed [Kc 3c] and lost with two pair, Nines and Threes
Seat 2: Lord_of_days showed [8c 8s] and won ($3.03) with two pair, Nines and Eights
Seat 3: DiskoDancer (button) folded before Flop (didn't bet)
Seat 4: watersnow66 (small blind) folded before Flop
Seat 5: appu001 (big blind) folded before Flop



PokerStars Hand #222960897894:  Hold'em No Limit ($0.05/$0.10 USD) - 2021/01/23 12:19:24 ET
Table 'Polydoros II' 6-max Seat #4 is the button
Seat 1: Clappasaur ($41.66 in chips) 
Seat 2: Lord_of_days ($11.47 in chips) 
Seat 3: DiskoDancer ($10 in chips) 
Seat 4: watersnow66 ($11.54 in chips) 
Seat 5: appu001 ($13.70 in chips) 
Seat 6: Ruman_One ($10 in chips) 
appu001: posts small blind $0.05
Ruman_One: posts big blind $0.10
*** HOLE CARDS ***
Clappasaur: raises $0.20 to $0.30
Lord_of_days: folds 
DiskoDancer: folds 
watersnow66: folds 
appu001: raises $0.20 to $0.50
Ruman_One: folds 
Clappasaur: calls $0.20
*** FLOP *** [5c Qd Td]
appu001: checks 
Clappasaur: bets $0.53
appu001: calls $0.53
*** TURN *** [5c Qd Td] [5s]
appu001: checks 
Clappasaur: bets $1.20
appu001: folds 
Uncalled bet ($1.20) returned to Clappasaur
Clappasaur collected $2.06 from pot
Clappasaur: doesn't show hand 
*** SUMMARY ***
Total pot $2.16 | Rake $0.10 
Board [5c Qd Td 5s]
Seat 1: Clappasaur collected ($2.06)
Seat 2: Lord_of_days folded before Flop (didn't bet)
Seat 3: DiskoDancer folded before Flop (didn't bet)
Seat 4: watersnow66 (button) folded before Flop (didn't bet)
Seat 5: appu001 (small blind) folded on the Turn
Seat 6: Ruman_One (big blind) folded before Flop



PokerStars Hand #222960918659:  Hold'em No Limit ($0.05/$0.10 USD) - 2021/01/23 12:19:57 ET
Table 'Polydoros II' 6-max Seat #5 is the button
Seat 1: Clappasaur ($42.69 in chips) 
Seat 2: Lord_of_days ($11.47 in chips) 
Seat 3: DiskoDancer ($10 in chips) 
Seat 4: watersnow66 ($11.54 in chips) 
Seat 5: appu001 ($12.67 in chips) 
Seat 6: Ruman_One ($9.90 in chips) 
Ruman_One: posts small blind $0.05
Clappasaur: posts big blind $0.10
*** HOLE CARDS ***
Lord_of_days: folds 
DiskoDancer: folds 
watersnow66: folds 
appu001: calls $0.10
Ruman_One: raises $0.35 to $0.45
Clappasaur: folds 
appu001: calls $0.35
*** FLOP *** [Ac 3s Kd]
Ruman_One: bets $0.70
appu001: folds 
Uncalled bet ($0.70) returned to Ruman_One
Ruman_One collected $0.96 from pot
Ruman_One: doesn't show hand 
*** SUMMARY ***
Total pot $1 | Rake $0.04 
Board [Ac 3s Kd]
Seat 1: Clappasaur (big blind) folded before Flop
Seat 2: Lord_of_days folded before Flop (didn't bet)
Seat 3: DiskoDancer folded before Flop (didn't bet)
Seat 4: watersnow66 folded before Flop (didn't bet)
Seat 5: appu001 (button) folded on the Flop
Seat 6: Ruman_One (small blind) collected ($0.96)



PokerStars Hand #222960938897:  Hold'em No Limit ($0.05/$0.10 USD) - 2021/01/23 12:20:29 ET
Table 'Polydoros II' 6-max Seat #6 is the button
Seat 1: Clappasaur ($42.59 in chips) 
Seat 2: Lord_of_days ($11.47 in chips) 
Seat 3: DiskoDancer ($10 in chips) 
Seat 4: watersnow66 ($11.54 in chips) 
Seat 5: appu001 ($12.22 in chips) 
Seat 6: Ruman_One ($10.41 in chips) 
Clappasaur: posts small blind $0.05
Lord_of_days: posts big blind $0.10
*** HOLE CARDS ***
DiskoDancer: folds 
watersnow66: folds 
appu001: calls $0.10
Ruman_One: folds 
Clappasaur: folds 
Lord_of_days: checks 
*** FLOP *** [5s Kc 7h]
Lord_of_days: checks 
appu001: checks 
*** TURN *** [5s Kc 7h] [3h]
Lord_of_days: bets $0.50
appu001: folds 
Uncalled bet ($0.50) returned to Lord_of_days
Lord_of_days collected $0.24 from pot
Lord_of_days: doesn't show hand 
*** SUMMARY ***
Total pot $0.25 | Rake $0.01 
Board [5s Kc 7h 3h]
Seat 1: Clappasaur (small blind) folded before Flop
Seat 2: Lord_of_days (big blind) collected ($0.24)
Seat 3: DiskoDancer folded before Flop (didn't bet)
Seat 4: watersnow66 folded before Flop (didn't bet)
Seat 5: appu001 folded on the Turn
Seat 6: Ruman_One (button) folded before Flop (didn't bet)



PokerStars Hand #222960955238:  Hold'em No Limit ($0.05/$0.10 USD) - 2021/01/23 12:20:55 ET
Table 'Polydoros II' 6-max Seat #1 is the button
Seat 1: Clappasaur ($42.54 in chips) 
Seat 2: Lord_of_days ($11.61 in chips) 
Seat 3: DiskoDancer ($10 in chips) 
Seat 4: watersnow66 ($11.54 in chips) 
Seat 5: appu001 ($12.12 in chips) 
Seat 6: Ruman_One ($10.41 in chips) 
Lord_of_days: posts small blind $0.05
DiskoDancer: posts big blind $0.10
*** HOLE CARDS ***
watersnow66: folds 
appu001: folds 
Ruman_One: folds 
Clappasaur: raises $0.20 to $0.30
Lord_of_days: folds 
DiskoDancer: calls $0.20
*** FLOP *** [Kc Jd 3s]
DiskoDancer: checks 
Clappasaur: bets $0.20
DiskoDancer: calls $0.20
*** TURN *** [Kc Jd 3s] [9c]
DiskoDancer: checks 
Clappasaur: bets $0.60
DiskoDancer: calls $0.60
*** RIVER *** [Kc Jd 3s 9c] [2s]
DiskoDancer: checks 
Clappasaur: bets $1.90
DiskoDancer: calls $1.90
*** SHOW DOWN ***
Clappasaur: shows [Ac As] (a pair of Aces)
DiskoDancer: mucks hand 
Clappasaur collected $5.78 from pot
*** SUMMARY ***
Total pot $6.05 | Rake $0.27 
Board [Kc Jd 3s 9c 2s]
Seat 1: Clappasaur (button) showed [Ac As] and won ($5.78) with a pair of Aces
Seat 2: Lord_of_days (small blind) folded before Flop
Seat 3: DiskoDancer (big blind) mucked
Seat 4: watersnow66 folded before Flop (didn't bet)
Seat 5: appu001 folded before Flop (didn't bet)
Seat 6: Ruman_One folded before Flop (didn't bet)



PokerStars Hand #222961009132:  Hold'em No Limit ($0.05/$0.10 USD) - 2021/01/23 12:22:20 ET
Table 'Polydoros II' 6-max Seat #2 is the button
Seat 1: Clappasaur ($45.32 in chips) 
Seat 2: Lord_of_days ($11.56 in chips) 
Seat 3: DiskoDancer ($10 in chips) 
Seat 4: watersnow66 ($11.54 in chips) 
Seat 5: appu001 ($12.12 in chips) 
Seat 6: Ruman_One ($10.41 in chips) 
DiskoDancer: posts small blind $0.05
watersnow66: posts big blind $0.10
*** HOLE CARDS ***
appu001: calls $0.10
Ruman_One: folds 
Clappasaur: raises $0.10 to $0.20
Lord_of_days: raises $0.50 to $0.70
DiskoDancer: folds 
watersnow66: folds 
appu001: folds 
Clappasaur: calls $0.50
*** FLOP *** [3d Kd 2s]
Clappasaur: checks 
Lord_of_days: bets $0.52
Clappasaur: folds 
Uncalled bet ($0.52) returned to Lord_of_days
Lord_of_days collected $1.58 from pot
Lord_of_days: doesn't show hand 
*** SUMMARY ***
Total pot $1.65 | Rake $0.07 
Board [3d Kd 2s]
Seat 1: Clappasaur folded on the Flop
Seat 2: Lord_of_days (button) collected ($1.58)
Seat 3: DiskoDancer (small blind) folded before Flop
Seat 4: watersnow66 (big blind) folded before Flop
Seat 5: appu001 folded before Flop
Seat 6: Ruman_One folded before Flop (didn't bet)



PokerStars Hand #222961040999:  Hold'em No Limit ($0.05/$0.10 USD) - 2021/01/23 12:23:10 ET
Table 'Polydoros II' 6-max Seat #3 is the button
Seat 2: Lord_of_days ($12.44 in chips) 
Seat 3: DiskoDancer ($10 in chips) 
Seat 4: watersnow66 ($11.44 in chips) 
Seat 5: appu001 ($12.02 in chips) 
Seat 6: Ruman_One ($10.41 in chips) 
watersnow66: posts small blind $0.05
appu001: posts big blind $0.10
*** HOLE CARDS ***
Ruman_One: folds 
Lord_of_days: folds 
DiskoDancer: raises $0.15 to $0.25
Clappasaur leaves the table
watersnow66: calls $0.20
appu001: raises $0.15 to $0.40
Rainlol joins the table at seat #1 
DiskoDancer: calls $0.15
watersnow66: calls $0.15
*** FLOP *** [Kd Kh 7c]
watersnow66: checks 
appu001: checks 
DiskoDancer: checks 
*** TURN *** [Kd Kh 7c] [Qs]
watersnow66: checks 
appu001: checks 
DiskoDancer: checks 
*** RIVER *** [Kd Kh 7c Qs] [Ac]
watersnow66: checks 
appu001: checks 
DiskoDancer: checks 
*** SHOW DOWN ***
watersnow66: shows [5d 5s] (two pair, Kings and Fives)
appu001: mucks hand 
DiskoDancer: shows [7s 6h] (two pair, Kings and Sevens)
DiskoDancer collected $1.15 from pot
*** SUMMARY ***
Total pot $1.20 | Rake $0.05 
Board [Kd Kh 7c Qs Ac]
Seat 2: Lord_of_days folded before Flop (didn't bet)
Seat 3: DiskoDancer (button) showed [7s 6h] and won ($1.15) with two pair, Kings and Sevens
Seat 4: watersnow66 (small blind) showed [5d 5s] and lost with two pair, Kings and Fives
Seat 5: appu001 (big blind) mucked
Seat 6: Ruman_One folded before Flop (didn't bet)



PokerStars Hand #222961066984:  Hold'em No Limit ($0.05/$0.10 USD) - 2021/01/23 12:23:51 ET
Table 'Polydoros II' 6-max Seat #4 is the button
Seat 2: Lord_of_days ($12.44 in chips) 
Seat 3: DiskoDancer ($10.75 in chips) 
Seat 4: watersnow66 ($11.04 in chips) 
Seat 5: appu001 ($11.62 in chips) 
Seat 6: Ruman_One ($10.41 in chips) 
appu001: posts small blind $0.05
Ruman_One: posts big blind $0.10
Rainlol: sits out 
*** HOLE CARDS ***
Lord_of_days: folds 
DiskoDancer: folds 
watersnow66: folds 
appu001: raises $0.10 to $0.20
Ruman_One: raises $0.40 to $0.60
appu001: calls $0.40
*** FLOP *** [Jd Jc 7h]
appu001: checks 
Ruman_One: bets $0.63
appu001: calls $0.63
*** TURN *** [Jd Jc 7h] [8s]
appu001: checks 
Ruman_One: checks 
*** RIVER *** [Jd Jc 7h 8s] [6s]
appu001: bets $2.40
Ruman_One: folds 
Uncalled bet ($2.40) returned to appu001
appu001 collected $2.35 from pot
appu001: doesn't show hand 
*** SUMMARY ***
Total pot $2.46 | Rake $0.11 
Board [Jd Jc 7h 8s 6s]
Seat 2: Lord_of_days folded before Flop (didn't bet)
Seat 3: DiskoDancer folded before Flop (didn't bet)
Seat 4: watersnow66 (button) folded before Flop (didn't bet)
Seat 5: appu001 (small blind) collected ($2.35)
Seat 6: Ruman_One (big blind) folded on the River



PokerStars Hand #222961104341:  Hold'em No Limit ($0.05/$0.10 USD) - 2021/01/23 12:24:38 ET
Table 'Polydoros II' 6-max Seat #5 is the button
Seat 1: Rainlol ($10 in chips) 
Seat 2: Lord_of_days ($12.44 in chips) 
Seat 3: DiskoDancer ($10.75 in chips) 
Seat 4: watersnow66 ($11.04 in chips) 
Seat 5: appu001 ($12.74 in chips) 
Seat 6: Ruman_One ($9.18 in chips) 
Ruman_One: posts small blind $0.05
Rainlol: posts big blind $0.10
*** HOLE CARDS ***
Lord_of_days: folds 
DiskoDancer: folds 
watersnow66: folds 
appu001: raises $0.10 to $0.20
Ruman_One: calls $0.15
Rainlol: calls $0.10
*** FLOP *** [Ah 6d 2s]
Ruman_One: checks 
Rainlol: checks 
appu001: bets $0.10
Ruman_One: calls $0.10
Rainlol: calls $0.10
*** TURN *** [Ah 6d 2s] [9h]
Ruman_One: checks 
Rainlol: checks 
appu001: bets $0.50
Ruman_One: calls $0.50
Rainlol: folds 
*** RIVER *** [Ah 6d 2s 9h] [As]
Ruman_One: checks 
appu001: checks 
*** SHOW DOWN ***
Ruman_One: shows [Ad 7d] (three of a kind, Aces)
appu001: mucks hand 
Ruman_One collected $1.81 from pot
*** SUMMARY ***
Total pot $1.90 | Rake $0.09 
Board [Ah 6d 2s 9h As]
Seat 1: Rainlol (big blind) folded on the Turn
Seat 2: Lord_of_days folded before Flop (didn't bet)
Seat 3: DiskoDancer folded before Flop (didn't bet)
Seat 4: watersnow66 folded before Flop (didn't bet)
Seat 5: appu001 (button) mucked
Seat 6: Ruman_One (small blind) showed [Ad 7d] and won ($1.81) with three of a kind, Aces



PokerStars Hand #222961145642:  Hold'em No Limit ($0.05/$0.10 USD) - 2021/01/23 12:25:42 ET
Table 'Polydoros II' 6-max Seat #6 is the button
Seat 1: Rainlol ($9.70 in chips) 
Seat 2: Lord_of_days ($12.44 in chips) 
Seat 3: DiskoDancer ($10.75 in chips) 
Seat 4: watersnow66 ($11.04 in chips) 
Seat 5: appu001 ($11.94 in chips) 
Seat 6: Ruman_One ($10.19 in chips) 
Rainlol: posts small blind $0.05
Lord_of_days: posts big blind $0.10
*** HOLE CARDS ***
DiskoDancer: folds 
watersnow66: folds 
appu001: folds 
Ruman_One: raises $0.15 to $0.25
Rainlol: folds 
Lord_of_days: folds 
Uncalled bet ($0.15) returned to Ruman_One
Ruman_One collected $0.25 from pot
Ruman_One: doesn't show hand 
*** SUMMARY ***
Total pot $0.25 | Rake $0 
Seat 1: Rainlol (small blind) folded before Flop
Seat 2: Lord_of_days (big blind) folded before Flop
Seat 3: DiskoDancer folded before Flop (didn't bet)
Seat 4: watersnow66 folded before Flop (didn't bet)
Seat 5: appu001 folded before Flop (didn't bet)
Seat 6: Ruman_One (button) collected ($0.25)



PokerStars Hand #222961153812:  Hold'em No Limit ($0.05/$0.10 USD) - 2021/01/23 12:25:54 ET
Table 'Polydoros II' 6-max Seat #1 is the button
Seat 1: Rainlol ($10 in chips) 
Seat 2: Lord_of_days ($12.34 in chips) 
Seat 3: DiskoDancer ($10.75 in chips) 
Seat 4: watersnow66 ($11.04 in chips) 
Seat 5: appu001 ($11.94 in chips) 
Seat 6: Ruman_One ($10.34 in chips) 
Lord_of_days: posts small blind $0.05
DiskoDancer: posts big blind $0.10
*** HOLE CARDS ***
watersnow66: folds 
appu001: calls $0.10
Ruman_One: folds 
Rainlol: folds 
Lord_of_days: folds 
DiskoDancer: raises $0.40 to $0.50
appu001: calls $0.40
*** FLOP *** [Th 5d 7d]
DiskoDancer: bets $0.75
appu001: calls $0.75
*** TURN *** [Th 5d 7d] [Qs]
DiskoDancer: checks 
appu001: bets $1
DiskoDancer: calls $1
*** RIVER *** [Th 5d 7d Qs] [3h]
DiskoDancer: checks 
appu001: checks 
*** SHOW DOWN ***
DiskoDancer: shows [Js Jh] (a pair of Jacks)
appu001: mucks hand 
DiskoDancer collected $4.35 from pot
*** SUMMARY ***
Total pot $4.55 | Rake $0.20 
Board [Th 5d 7d Qs 3h]
Seat 1: Rainlol (button) folded before Flop (didn't bet)
Seat 2: Lord_of_days (small blind) folded before Flop
Seat 3: DiskoDancer (big blind) showed [Js Jh] and won ($4.35) with a pair of Jacks
Seat 4: watersnow66 folded before Flop (didn't bet)
Seat 5: appu001 mucked
Seat 6: Ruman_One folded before Flop (didn't bet)



PokerStars Hand #222961205521:  Hold'em No Limit ($0.05/$0.10 USD) - 2021/01/23 12:27:13 ET
Table 'Polydoros II' 6-max Seat #2 is the button
Seat 1: Rainlol ($10 in chips) 
Seat 2: Lord_of_days ($12.29 in chips) 
Seat 3: DiskoDancer ($12.85 in chips) 
Seat 4: watersnow66 ($11.04 in chips) 
Seat 5: appu001 ($9.69 in chips) 
Seat 6: Ruman_One ($10.34 in chips) 
DiskoDancer: posts small blind $0.05
watersnow66: posts big blind $0.10
*** HOLE CARDS ***
appu001: raises $0.30 to $0.40
Ruman_One: folds 
Rainlol: folds 
Lord_of_days: calls $0.40
DiskoDancer: folds 
watersnow66: folds 
*** FLOP *** [2c Jh Jc]
appu001: checks 
Lord_of_days: checks 
*** TURN *** [2c Jh Jc] [Ks]
appu001: bets $0.50
Lord_of_days: folds 
Uncalled bet ($0.50) returned to appu001
appu001 collected $0.91 from pot
appu001: doesn't show hand 
*** SUMMARY ***
Total pot $0.95 | Rake $0.04 
Board [2c Jh Jc Ks]
Seat 1: Rainlol folded before Flop (didn't bet)
Seat 2: Lord_of_days (button) folded on the Turn
Seat 3: DiskoDancer (small blind) folded before Flop
Seat 4: watersnow66 (big blind) folded before Flop
Seat 5: appu001 collected ($0.91)
Seat 6: Ruman_One folded before Flop (didn't bet)



PokerStars Hand #222961224587:  Hold'em No Limit ($0.05/$0.10 USD) - 2021/01/23 12:27:43 ET
Table 'Polydoros II' 6-max Seat #3 is the button
Seat 1: Rainlol ($10 in chips) 
Seat 2: Lord_of_days ($11.89 in chips) 
Seat 3: DiskoDancer ($12.80 in chips) 
Seat 4: watersnow66 ($10.94 in chips) 
Seat 5: appu001 ($10.20 in chips) 
Seat 6: Ruman_One ($10.34 in chips) 
watersnow66: posts small blind $0.05
appu001: posts big blind $0.10
*** HOLE CARDS ***
Ruman_One: folds 
Rainlol: raises $0.20 to $0.30
Lord_of_days: folds 
DiskoDancer: folds 
watersnow66: folds 
appu001: calls $0.20
*** FLOP *** [Kd 8c 3s]
appu001: checks 
Rainlol: checks 
*** TURN *** [Kd 8c 3s] [Jd]
appu001: bets $0.60
Rainlol: folds 
Uncalled bet ($0.60) returned to appu001
appu001 collected $0.62 from pot
appu001: doesn't show hand 
*** SUMMARY ***
Total pot $0.65 | Rake $0.03 
Board [Kd 8c 3s Jd]
Seat 1: Rainlol folded on the Turn
Seat 2: Lord_of_days folded before Flop (didn't bet)
Seat 3: DiskoDancer (button) folded before Flop (didn't bet)
Seat 4: watersnow66 (small blind) folded before Flop
Seat 5: appu001 (big blind) collected ($0.62)
Seat 6: Ruman_One folded before Flop (didn't bet)



PokerStars Hand #222961240385:  Hold'em No Limit ($0.05/$0.10 USD) - 2021/01/23 12:28:07 ET
Table 'Polydoros II' 6-max Seat #4 is the button
Seat 1: Rainlol ($9.70 in chips) 
Seat 2: Lord_of_days ($11.89 in chips) 
Seat 3: DiskoDancer ($12.80 in chips) 
Seat 4: watersnow66 ($10.89 in chips) 
Seat 5: appu001 ($10.52 in chips) 
Seat 6: Ruman_One ($10.34 in chips) 
appu001: posts small blind $0.05
Ruman_One: posts big blind $0.10
*** HOLE CARDS ***
Rainlol: folds 
Lord_of_days: folds 
DiskoDancer: folds 
watersnow66: folds 
appu001: raises $0.80 to $0.90
Ruman_One: folds 
Uncalled bet ($0.80) returned to appu001
appu001 collected $0.20 from pot
appu001: doesn't show hand 
*** SUMMARY ***
Total pot $0.20 | Rake $0 
Seat 1: Rainlol folded before Flop (didn't bet)
Seat 2: Lord_of_days folded before Flop (didn't bet)
Seat 3: DiskoDancer folded before Flop (didn't bet)
Seat 4: watersnow66 (button) folded before Flop (didn't bet)
Seat 5: appu001 (small blind) collected ($0.20)
Seat 6: Ruman_One (big blind) folded before Flop



PokerStars Hand #222961248740:  Hold'em No Limit ($0.05/$0.10 USD) - 2021/01/23 12:28:19 ET
Table 'Polydoros II' 6-max Seat #5 is the button
Seat 1: Rainlol ($9.70 in chips) 
Seat 2: Lord_of_days ($11.89 in chips) 
Seat 3: DiskoDancer ($12.80 in chips) 
Seat 4: watersnow66 ($10.89 in chips) 
Seat 5: appu001 ($10.62 in chips) 
Seat 6: Ruman_One ($10.24 in chips) 
Ruman_One: posts small blind $0.05
Rainlol: posts big blind $0.10
*** HOLE CARDS ***
Lord_of_days: folds 
DiskoDancer: folds 
watersnow66: folds 
appu001: folds 
Ruman_One: folds 
Uncalled bet ($0.05) returned to Rainlol
Rainlol collected $0.10 from pot
Rainlol: doesn't show hand 
*** SUMMARY ***
Total pot $0.10 | Rake $0 
Seat 1: Rainlol (big blind) collected ($0.10)
Seat 2: Lord_of_days folded before Flop (didn't bet)
Seat 3: DiskoDancer folded before Flop (didn't bet)
Seat 4: watersnow66 folded before Flop (didn't bet)
Seat 5: appu001 (button) folded before Flop (didn't bet)
Seat 6: Ruman_One (small blind) folded before Flop



PokerStars Hand #222961252765:  Hold'em No Limit ($0.05/$0.10 USD) - 2021/01/23 12:28:26 ET
Table 'Polydoros II' 6-max Seat #6 is the button
Seat 1: Rainlol ($9.75 in chips) 
Seat 2: Lord_of_days ($11.89 in chips) 
Seat 3: DiskoDancer ($12.80 in chips) 
Seat 4: watersnow66 ($10.89 in chips) 
Seat 5: appu001 ($10.62 in chips) 
Seat 6: Ruman_One ($10.19 in chips) 
Rainlol: posts small blind $0.05
Lord_of_days: posts big blind $0.10
*** HOLE CARDS ***
DiskoDancer: folds 
watersnow66: folds 
appu001: raises $0.50 to $0.60
Ruman_One: folds 
Rainlol: calls $0.55
Lord_of_days: folds 
*** FLOP *** [2s 5h 3c]
Rainlol: checks 
appu001: bets $0.60
Rainlol: folds 
Uncalled bet ($0.60) returned to appu001
appu001 collected $1.24 from pot
appu001: doesn't show hand 
*** SUMMARY ***
Total pot $1.30 | Rake $0.06 
Board [2s 5h 3c]
Seat 1: Rainlol (small blind) folded on the Flop
Seat 2: Lord_of_days (big blind) folded before Flop
Seat 3: DiskoDancer folded before Flop (didn't bet)
Seat 4: watersnow66 folded before Flop (didn't bet)
Seat 5: appu001 collected ($1.24)
Seat 6: Ruman_One (button) folded before Flop (didn't bet)



PokerStars Hand #222961267680:  Hold'em No Limit ($0.05/$0.10 USD) - 2021/01/23 12:28:49 ET
Table 'Polydoros II' 6-max Seat #1 is the button
Seat 1: Rainlol ($10 in chips) 
Seat 2: Lord_of_days ($11.79 in chips) 
Seat 3: DiskoDancer ($12.80 in chips) 
Seat 4: watersnow66 ($10.89 in chips) 
Seat 5: appu001 ($11.26 in chips) 
Seat 6: Ruman_One ($10.19 in chips) 
Lord_of_days: posts small blind $0.05
DiskoDancer: posts big blind $0.10
*** HOLE CARDS ***
watersnow66: folds 
appu001: calls $0.10
Ruman_One: calls $0.10
Rainlol: folds 
Lord_of_days: folds 
DiskoDancer: checks 
*** FLOP *** [2h 9s 2d]
DiskoDancer: checks 
appu001: checks 
Ruman_One: bets $0.25
DiskoDancer: folds 
appu001: folds 
Uncalled bet ($0.25) returned to Ruman_One
Ruman_One collected $0.33 from pot
Ruman_One: doesn't show hand 
*** SUMMARY ***
Total pot $0.35 | Rake $0.02 
Board [2h 9s 2d]
Seat 1: Rainlol (button) folded before Flop (didn't bet)
Seat 2: Lord_of_days (small blind) folded before Flop
Seat 3: DiskoDancer (big blind) folded on the Flop
Seat 4: watersnow66 folded before Flop (didn't bet)
Seat 5: appu001 folded on the Flop
Seat 6: Ruman_One collected ($0.33)



PokerStars Hand #222961287069:  Hold'em No Limit ($0.05/$0.10 USD) - 2021/01/23 12:29:19 ET
Table 'Polydoros II' 6-max Seat #2 is the button
Seat 1: Rainlol ($10 in chips) 
Seat 2: Lord_of_days ($11.74 in chips) 
Seat 3: DiskoDancer ($12.70 in chips) 
Seat 4: watersnow66 ($10.89 in chips) 
Seat 5: appu001 ($11.16 in chips) 
Seat 6: Ruman_One ($10.42 in chips) 
DiskoDancer: posts small blind $0.05
watersnow66: posts big blind $0.10
*** HOLE CARDS ***
appu001: raises $0.20 to $0.30
Ruman_One: folds 
Rainlol: folds 
Lord_of_days: folds 
DiskoDancer: folds 
watersnow66: folds 
Uncalled bet ($0.20) returned to appu001
appu001 collected $0.25 from pot
appu001: doesn't show hand 
*** SUMMARY ***
Total pot $0.25 | Rake $0 
Seat 1: Rainlol folded before Flop (didn't bet)
Seat 2: Lord_of_days (button) folded before Flop (didn't bet)
Seat 3: DiskoDancer (small blind) folded before Flop
Seat 4: watersnow66 (big blind) folded before Flop
Seat 5: appu001 collected ($0.25)
Seat 6: Ruman_One folded before Flop (didn't bet)



PokerStars Hand #222961299188:  Hold'em No Limit ($0.05/$0.10 USD) - 2021/01/23 12:29:37 ET
Table 'Polydoros II' 6-max Seat #3 is the button
Seat 1: Rainlol ($10 in chips) 
Seat 2: Lord_of_days ($11.74 in chips) 
Seat 3: DiskoDancer ($12.65 in chips) 
Seat 4: watersnow66 ($10.79 in chips) 
Seat 5: appu001 ($11.31 in chips) 
Seat 6: Ruman_One ($10.42 in chips) 
watersnow66: posts small blind $0.05
appu001: posts big blind $0.10
*** HOLE CARDS ***
Ruman_One: folds 
Rainlol: folds 
Lord_of_days: raises $0.20 to $0.30
DiskoDancer: raises $0.59 to $0.89
watersnow66: folds 
appu001: calls $0.79
Lord_of_days: calls $0.59
*** FLOP *** [6d Ks 6h]
appu001: checks 
Lord_of_days: checks 
DiskoDancer: bets $1.22
appu001: folds 
Lord_of_days: folds 
Uncalled bet ($1.22) returned to DiskoDancer
DiskoDancer collected $2.60 from pot
DiskoDancer: doesn't show hand 
*** SUMMARY ***
Total pot $2.72 | Rake $0.12 
Board [6d Ks 6h]
Seat 1: Rainlol folded before Flop (didn't bet)
Seat 2: Lord_of_days folded on the Flop
Seat 3: DiskoDancer (button) collected ($2.60)
Seat 4: watersnow66 (small blind) folded before Flop
Seat 5: appu001 (big blind) folded on the Flop
Seat 6: Ruman_One folded before Flop (didn't bet)



PokerStars Hand #222961329279:  Hold'em No Limit ($0.05/$0.10 USD) - 2021/01/23 12:30:23 ET
Table 'Polydoros II' 6-max Seat #4 is the button
Seat 1: Rainlol ($10 in chips) 
Seat 2: Lord_of_days ($10.85 in chips) 
Seat 3: DiskoDancer ($14.36 in chips) 
Seat 4: watersnow66 ($10.74 in chips) 
Seat 5: appu001 ($10.42 in chips) 
Seat 6: Ruman_One ($10.42 in chips) 
appu001: posts small blind $0.05
Ruman_One: posts big blind $0.10
*** HOLE CARDS ***
Rainlol: folds 
Lord_of_days: folds 
DiskoDancer: folds 
watersnow66 has timed out
watersnow66: folds 
appu001: raises $0.20 to $0.30
Ruman_One: calls $0.20
*** FLOP *** [8h 4d 7c]
appu001: bets $0.40
Ruman_One: folds 
Uncalled bet ($0.40) returned to appu001
appu001 collected $0.57 from pot
appu001: doesn't show hand 
*** SUMMARY ***
Total pot $0.60 | Rake $0.03 
Board [8h 4d 7c]
Seat 1: Rainlol folded before Flop (didn't bet)
Seat 2: Lord_of_days folded before Flop (didn't bet)
Seat 3: DiskoDancer folded before Flop (didn't bet)
Seat 4: watersnow66 (button) folded before Flop (didn't bet)
Seat 5: appu001 (small blind) collected ($0.57)
Seat 6: Ruman_One (big blind) folded on the Flop



PokerStars Hand #222961360121:  Hold'em No Limit ($0.05/$0.10 USD) - 2021/01/23 12:31:10 ET
Table 'Polydoros II' 6-max Seat #5 is the button
Seat 1: Rainlol ($10 in chips) 
Seat 2: Lord_of_days ($10.85 in chips) 
Seat 3: DiskoDancer ($14.36 in chips) 
Seat 4: watersnow66 ($10.74 in chips) 
Seat 5: appu001 ($10.69 in chips) 
Seat 6: Ruman_One ($10.12 in chips) 
Ruman_One: posts small blind $0.05
Rainlol: posts big blind $0.10
*** HOLE CARDS ***
Lord_of_days: folds 
DiskoDancer: raises $0.15 to $0.25
watersnow66: calls $0.25
appu001: calls $0.25
Ruman_One: folds 
Rainlol: folds 
*** FLOP *** [Qc 5s 7s]
DiskoDancer: checks 
watersnow66: bets $0.43
appu001: folds 
DiskoDancer: folds 
Uncalled bet ($0.43) returned to watersnow66
watersnow66 collected $0.86 from pot
*** SUMMARY ***
Total pot $0.90 | Rake $0.04 
Board [Qc 5s 7s]
Seat 1: Rainlol (big blind) folded before Flop
Seat 2: Lord_of_days folded before Flop (didn't bet)
Seat 3: DiskoDancer folded on the Flop
Seat 4: watersnow66 collected ($0.86)
Seat 5: appu001 (button) folded on the Flop
Seat 6: Ruman_One (small blind) folded before Flop



PokerStars Hand #222961376587:  Hold'em No Limit ($0.05/$0.10 USD) - 2021/01/23 12:31:34 ET
Table 'Polydoros II' 6-max Seat #6 is the button
Seat 1: Rainlol ($9.90 in chips) 
Seat 2: Lord_of_days ($10.85 in chips) 
Seat 3: DiskoDancer ($14.11 in chips) 
Seat 4: watersnow66 ($11.35 in chips) 
Seat 5: appu001 ($10.44 in chips) 
Seat 6: Ruman_One ($10.07 in chips) 
Rainlol: posts small blind $0.05
Lord_of_days: posts big blind $0.10
*** HOLE CARDS ***
DiskoDancer: folds 
watersnow66: folds 
appu001: folds 
Ruman_One: folds 
Rainlol: raises $0.20 to $0.30
Lord_of_days: folds 
Uncalled bet ($0.20) returned to Rainlol
Rainlol collected $0.20 from pot
Rainlol: doesn't show hand 
*** SUMMARY ***
Total pot $0.20 | Rake $0 
Seat 1: Rainlol (small blind) collected ($0.20)
Seat 2: Lord_of_days (big blind) folded before Flop
Seat 3: DiskoDancer folded before Flop (didn't bet)
Seat 4: watersnow66 folded before Flop (didn't bet)
Seat 5: appu001 folded before Flop (didn't bet)
Seat 6: Ruman_One (button) folded before Flop (didn't bet)



PokerStars Hand #222961389775:  Hold'em No Limit ($0.05/$0.10 USD) - 2021/01/23 12:31:54 ET
Table 'Polydoros II' 6-max Seat #1 is the button
Seat 1: Rainlol ($10 in chips) 
Seat 2: Lord_of_days ($10.75 in chips) 
Seat 3: DiskoDancer ($14.11 in chips) 
Seat 4: watersnow66 ($11.35 in chips) 
Seat 5: appu001 ($10.44 in chips) 
Seat 6: Ruman_One ($10.07 in chips) 
Lord_of_days: posts small blind $0.05
DiskoDancer: posts big blind $0.10
*** HOLE CARDS ***
watersnow66: folds 
appu001: raises $0.20 to $0.30
Ruman_One: folds 
Rainlol: folds 
Lord_of_days: folds 
DiskoDancer: folds 
Uncalled bet ($0.20) returned to appu001
appu001 collected $0.25 from pot
appu001: doesn't show hand 
*** SUMMARY ***
Total pot $0.25 | Rake $0 
Seat 1: Rainlol (button) folded before Flop (didn't bet)
Seat 2: Lord_of_days (small blind) folded before Flop
Seat 3: DiskoDancer (big blind) folded before Flop
Seat 4: watersnow66 folded before Flop (didn't bet)
Seat 5: appu001 collected ($0.25)
Seat 6: Ruman_One folded before Flop (didn't bet)



PokerStars Hand #222961403339:  Hold'em No Limit ($0.05/$0.10 USD) - 2021/01/23 12:32:15 ET
Table 'Polydoros II' 6-max Seat #2 is the button
Seat 1: Rainlol ($10 in chips) 
Seat 2: Lord_of_days ($10.70 in chips) 
Seat 3: DiskoDancer ($14.01 in chips) 
Seat 4: watersnow66 ($11.35 in chips) 
Seat 5: appu001 ($10.59 in chips) 
Seat 6: Ruman_One ($10.07 in chips) 
DiskoDancer: posts small blind $0.05
watersnow66: posts big blind $0.10
*** HOLE CARDS ***
appu001: calls $0.10
Ruman_One: folds 
Rainlol: folds 
Lord_of_days: folds 
DiskoDancer: folds 
watersnow66: checks 
*** FLOP *** [8h Tc Jh]
watersnow66: checks 
appu001: bets $0.70
watersnow66: folds 
Uncalled bet ($0.70) returned to appu001
appu001 collected $0.24 from pot
appu001: doesn't show hand 
*** SUMMARY ***
Total pot $0.25 | Rake $0.01 
Board [8h Tc Jh]
Seat 1: Rainlol folded before Flop (didn't bet)
Seat 2: Lord_of_days (button) folded before Flop (didn't bet)
Seat 3: DiskoDancer (small blind) folded before Flop
Seat 4: watersnow66 (big blind) folded on the Flop
Seat 5: appu001 collected ($0.24)
Seat 6: Ruman_One folded before Flop (didn't bet)



PokerStars Hand #222961425360:  Hold'em No Limit ($0.05/$0.10 USD) - 2021/01/23 12:32:48 ET
Table 'Polydoros II' 6-max Seat #3 is the button
Seat 1: Rainlol ($10 in chips) 
Seat 2: Lord_of_days ($10.70 in chips) 
Seat 3: DiskoDancer ($13.96 in chips) 
Seat 4: watersnow66 ($11.25 in chips) 
Seat 5: appu001 ($10.73 in chips) 
Seat 6: Ruman_One ($10.07 in chips) 
watersnow66: posts small blind $0.05
appu001: posts big blind $0.10
*** HOLE CARDS ***
Ruman_One: raises $0.15 to $0.25
Rainlol: folds 
Lord_of_days: folds 
DiskoDancer: calls $0.25
watersnow66: folds 
appu001: calls $0.15
*** FLOP *** [5s 4h Jd]
appu001: checks 
Ruman_One: bets $0.40
DiskoDancer: calls $0.40
appu001: folds 
*** TURN *** [5s 4h Jd] [5c]
Ruman_One: checks 
DiskoDancer: bets $0.93
Ruman_One: raises $1.36 to $2.29
DiskoDancer: folds 
Uncalled bet ($1.36) returned to Ruman_One
Ruman_One collected $3.30 from pot
Ruman_One: doesn't show hand 
*** SUMMARY ***
Total pot $3.46 | Rake $0.16 
Board [5s 4h Jd 5c]
Seat 1: Rainlol folded before Flop (didn't bet)
Seat 2: Lord_of_days folded before Flop (didn't bet)
Seat 3: DiskoDancer (button) folded on the Turn
Seat 4: watersnow66 (small blind) folded before Flop
Seat 5: appu001 (big blind) folded on the Flop
Seat 6: Ruman_One collected ($3.30)



PokerStars Hand #222961498149:  Hold'em No Limit ($0.05/$0.10 USD) - 2021/01/23 12:34:36 ET
Table 'Polydoros II' 6-max Seat #4 is the button
Seat 1: Rainlol ($10 in chips) 
Seat 2: Lord_of_days ($10.70 in chips) 
Seat 3: DiskoDancer ($12.38 in chips) 
Seat 4: watersnow66 ($11.20 in chips) 
Seat 5: appu001 ($10.48 in chips) 
Seat 6: Ruman_One ($11.79 in chips) 
appu001: posts small blind $0.05
Ruman_One: posts big blind $0.10
*** HOLE CARDS ***
Rainlol: folds 
Lord_of_days: folds 
DiskoDancer: folds 
watersnow66: calls $0.10
appu001: calls $0.05
Ruman_One: checks 
*** FLOP *** [6s 6h 9c]
appu001: checks 
Ruman_One: checks 
watersnow66: bets $0.15
appu001: calls $0.15
Ruman_One: folds 
*** TURN *** [6s 6h 9c] [7h]
appu001: checks 
watersnow66: bets $0.29
appu001: folds 
Uncalled bet ($0.29) returned to watersnow66
watersnow66 collected $0.57 from pot
*** SUMMARY ***
Total pot $0.60 | Rake $0.03 
Board [6s 6h 9c 7h]
Seat 1: Rainlol folded before Flop (didn't bet)
Seat 2: Lord_of_days folded before Flop (didn't bet)
Seat 3: DiskoDancer folded before Flop (didn't bet)
Seat 4: watersnow66 (button) collected ($0.57)
Seat 5: appu001 (small blind) folded on the Turn
Seat 6: Ruman_One (big blind) folded on the Flop



PokerStars Hand #222961533817:  Hold'em No Limit ($0.05/$0.10 USD) - 2021/01/23 12:35:30 ET
Table 'Polydoros II' 6-max Seat #5 is the button
Seat 1: Rainlol ($10 in chips) 
Seat 2: Lord_of_days ($10.70 in chips) 
Seat 3: DiskoDancer ($12.38 in chips) 
Seat 4: watersnow66 ($11.52 in chips) 
Seat 5: appu001 ($10.23 in chips) 
Seat 6: Ruman_One ($11.69 in chips) 
Ruman_One: posts small blind $0.05
Rainlol: posts big blind $0.10
*** HOLE CARDS ***
Lord_of_days: folds 
DiskoDancer: raises $0.15 to $0.25
watersnow66: folds 
appu001: folds 
Ruman_One: folds 
Rainlol: folds 
Uncalled bet ($0.15) returned to DiskoDancer
DiskoDancer collected $0.25 from pot
DiskoDancer: doesn't show hand 
*** SUMMARY ***
Total pot $0.25 | Rake $0 
Seat 1: Rainlol (big blind) folded before Flop
Seat 2: Lord_of_days folded before Flop (didn't bet)
Seat 3: DiskoDancer collected ($0.25)
Seat 4: watersnow66 folded before Flop (didn't bet)
Seat 5: appu001 (button) folded before Flop (didn't bet)
Seat 6: Ruman_One (small blind) folded before Flop



PokerStars Hand #222961543894:  Hold'em No Limit ($0.05/$0.10 USD) - 2021/01/23 12:35:45 ET
Table 'Polydoros II' 6-max Seat #6 is the button
Seat 1: Rainlol ($9.90 in chips) 
Seat 2: Lord_of_days ($10.70 in chips) 
Seat 3: DiskoDancer ($12.53 in chips) 
Seat 4: watersnow66 ($11.52 in chips) 
Seat 5: appu001 ($10.23 in chips) 
Seat 6: Ruman_One ($11.64 in chips) 
Rainlol: posts small blind $0.05
Lord_of_days: posts big blind $0.10
*** HOLE CARDS ***
DiskoDancer: folds 
watersnow66: folds 
appu001: raises $0.10 to $0.20
Ruman_One: folds 
Rainlol: folds 
Lord_of_days: folds 
Uncalled bet ($0.10) returned to appu001
appu001 collected $0.25 from pot
appu001: doesn't show hand 
*** SUMMARY ***
Total pot $0.25 | Rake $0 
Seat 1: Rainlol (small blind) folded before Flop
Seat 2: Lord_of_days (big blind) folded before Flop
Seat 3: DiskoDancer folded before Flop (didn't bet)
Seat 4: watersnow66 folded before Flop (didn't bet)
Seat 5: appu001 collected ($0.25)
Seat 6: Ruman_One (button) folded before Flop (didn't bet)



PokerStars Hand #222961550489:  Hold'em No Limit ($0.05/$0.10 USD) - 2021/01/23 12:35:54 ET
Table 'Polydoros II' 6-max Seat #1 is the button
Seat 1: Rainlol ($9.85 in chips) 
Seat 2: Lord_of_days ($10.60 in chips) 
Seat 3: DiskoDancer ($12.53 in chips) 
Seat 4: watersnow66 ($11.52 in chips) 
Seat 5: appu001 ($10.38 in chips) 
Seat 6: Ruman_One ($11.64 in chips) 
Lord_of_days: posts small blind $0.05
DiskoDancer: posts big blind $0.10
*** HOLE CARDS ***
watersnow66 has timed out
watersnow66: folds 
appu001: folds 
Ruman_One: raises $0.15 to $0.25
Rainlol: calls $0.25
Lord_of_days: folds 
DiskoDancer: calls $0.15
*** FLOP *** [Jc 7c 9c]
DiskoDancer: checks 
Ruman_One: bets $0.42
Rainlol: calls $0.42
DiskoDancer: folds 
*** TURN *** [Jc 7c 9c] [Kh]
Ruman_One: checks 
Rainlol: checks 
*** RIVER *** [Jc 7c 9c Kh] [Kd]
Ruman_One: bets $0.63
Rainlol: calls $0.63
*** SHOW DOWN ***
Ruman_One: shows [Qs Jh] (two pair, Kings and Jacks)
Rainlol: mucks hand 
Ruman_One collected $2.77 from pot
*** SUMMARY ***
Total pot $2.90 | Rake $0.13 
Board [Jc 7c 9c Kh Kd]
Seat 1: Rainlol (button) mucked
Seat 2: Lord_of_days (small blind) folded before Flop
Seat 3: DiskoDancer (big blind) folded on the Flop
Seat 4: watersnow66 folded before Flop (didn't bet)
Seat 5: appu001 folded before Flop (didn't bet)
Seat 6: Ruman_One showed [Qs Jh] and won ($2.77) with two pair, Kings and Jacks



PokerStars Hand #222961590417:  Hold'em No Limit ($0.05/$0.10 USD) - 2021/01/23 12:36:54 ET
Table 'Polydoros II' 6-max Seat #2 is the button
Seat 1: Rainlol ($10 in chips) 
Seat 2: Lord_of_days ($10.55 in chips) 
Seat 3: DiskoDancer ($12.28 in chips) 
Seat 4: watersnow66 ($11.52 in chips) 
Seat 5: appu001 ($10.38 in chips) 
Seat 6: Ruman_One ($13.11 in chips) 
DiskoDancer: posts small blind $0.05
watersnow66: posts big blind $0.10
*** HOLE CARDS ***
appu001: raises $0.10 to $0.20
Ruman_One: folds 
Rainlol: folds 
Lord_of_days: folds 
DiskoDancer: folds 
watersnow66: calls $0.10
*** FLOP *** [Kh Ad 2d]
watersnow66: checks 
appu001: bets $0.40
watersnow66: calls $0.40
*** TURN *** [Kh Ad 2d] [Kc]
watersnow66: checks 
appu001: checks 
*** RIVER *** [Kh Ad 2d Kc] [3h]
watersnow66: checks 
appu001: checks 
*** SHOW DOWN ***
watersnow66: shows [Js As] (two pair, Aces and Kings)
appu001: mucks hand 
watersnow66 collected $1.19 from pot
*** SUMMARY ***
Total pot $1.25 | Rake $0.06 
Board [Kh Ad 2d Kc 3h]
Seat 1: Rainlol folded before Flop (didn't bet)
Seat 2: Lord_of_days (button) folded before Flop (didn't bet)
Seat 3: DiskoDancer (small blind) folded before Flop
Seat 4: watersnow66 (big blind) showed [Js As] and won ($1.19) with two pair, Aces and Kings
Seat 5: appu001 mucked
Seat 6: Ruman_One folded before Flop (didn't bet)



PokerStars Hand #222961612382:  Hold'em No Limit ($0.05/$0.10 USD) - 2021/01/23 12:37:27 ET
Table 'Polydoros II' 6-max Seat #3 is the button
Seat 1: Rainlol ($10 in chips) 
Seat 2: Lord_of_days ($10.55 in chips) 
Seat 3: DiskoDancer ($12.23 in chips) 
Seat 4: watersnow66 ($12.11 in chips) 
Seat 5: appu001 ($9.78 in chips) 
Seat 6: Ruman_One ($13.11 in chips) 
watersnow66: posts small blind $0.05
appu001: posts big blind $0.10
*** HOLE CARDS ***
Ruman_One: raises $0.15 to $0.25
Rainlol: raises $0.65 to $0.90
Lord_of_days: folds 
DiskoDancer: folds 
watersnow66: folds 
appu001: folds 
Ruman_One: folds 
Uncalled bet ($0.65) returned to Rainlol
Rainlol collected $0.65 from pot
Rainlol: doesn't show hand 
*** SUMMARY ***
Total pot $0.65 | Rake $0 
Seat 1: Rainlol collected ($0.65)
Seat 2: Lord_of_days folded before Flop (didn't bet)
Seat 3: DiskoDancer (button) folded before Flop (didn't bet)
Seat 4: watersnow66 (small blind) folded before Flop
Seat 5: appu001 (big blind) folded before Flop
Seat 6: Ruman_One folded before Flop



PokerStars Hand #222961627464:  Hold'em No Limit ($0.05/$0.10 USD) - 2021/01/23 12:37:50 ET
Table 'Polydoros II' 6-max Seat #4 is the button
Seat 1: Rainlol ($10.40 in chips) 
Seat 2: Lord_of_days ($10.55 in chips) 
Seat 3: DiskoDancer ($12.23 in chips) 
Seat 4: watersnow66 ($12.06 in chips) 
Seat 5: appu001 ($9.68 in chips) 
Seat 6: Ruman_One ($12.86 in chips) 
appu001: posts small blind $0.05
Ruman_One: posts big blind $0.10
*** HOLE CARDS ***
Rainlol: folds 
Lord_of_days: folds 
DiskoDancer: folds 
watersnow66: folds 
appu001: calls $0.05
Ruman_One: checks 
*** FLOP *** [8h 9s 2h]
appu001: checks 
Ruman_One: checks 
*** TURN *** [8h 9s 2h] [5s]
appu001: checks 
Ruman_One: checks 
*** RIVER *** [8h 9s 2h 5s] [Js]
appu001: bets $5.50
Ruman_One: folds 
Uncalled bet ($5.50) returned to appu001
appu001 collected $0.19 from pot
appu001: doesn't show hand 
*** SUMMARY ***
Total pot $0.20 | Rake $0.01 
Board [8h 9s 2h 5s Js]
Seat 1: Rainlol folded before Flop (didn't bet)
Seat 2: Lord_of_days folded before Flop (didn't bet)
Seat 3: DiskoDancer folded before Flop (didn't bet)
Seat 4: watersnow66 (button) folded before Flop (didn't bet)
Seat 5: appu001 (small blind) collected ($0.19)
Seat 6: Ruman_One (big blind) folded on the River



PokerStars Hand #222961654845:  Hold'em No Limit ($0.05/$0.10 USD) - 2021/01/23 12:38:30 ET
Table 'Polydoros II' 6-max Seat #5 is the button
Seat 1: Rainlol ($10.40 in chips) 
Seat 2: Lord_of_days ($10.55 in chips) 
Seat 3: DiskoDancer ($12.23 in chips) 
Seat 4: watersnow66 ($12.06 in chips) 
Seat 5: appu001 ($9.77 in chips) 
Seat 6: Ruman_One ($12.76 in chips) 
Ruman_One: posts small blind $0.05
Rainlol: posts big blind $0.10
*** HOLE CARDS ***
Lord_of_days: folds 
DiskoDancer: folds 
watersnow66: folds 
appu001: raises $0.20 to $0.30
Ruman_One: raises $12.46 to $12.76 and is all-in
Rainlol: folds 
appu001: calls $9.47 and is all-in
Uncalled bet ($2.99) returned to Ruman_One
*** FLOP *** [2h As Kc]
*** TURN *** [2h As Kc] [Qd]
*** RIVER *** [2h As Kc Qd] [6d]
*** SHOW DOWN ***
Ruman_One: shows [Qc Qs] (three of a kind, Queens)
appu001: shows [Js Ks] (a pair of Kings)
Ruman_One collected $18.76 from pot
*** SUMMARY ***
Total pot $19.64 | Rake $0.88 
Board [2h As Kc Qd 6d]
Seat 1: Rainlol (big blind) folded before Flop
Seat 2: Lord_of_days folded before Flop (didn't bet)
Seat 3: DiskoDancer folded before Flop (didn't bet)
Seat 4: watersnow66 folded before Flop (didn't bet)
Seat 5: appu001 (button) showed [Js Ks] and lost with a pair of Kings
Seat 6: Ruman_One (small blind) showed [Qc Qs] and won ($18.76) with three of a kind, Queens



PokerStars Hand #222961678901:  Hold'em No Limit ($0.05/$0.10 USD) - 2021/01/23 12:39:06 ET
Table 'Polydoros II' 6-max Seat #6 is the button
Seat 1: Rainlol ($10.30 in chips) 
Seat 2: Lord_of_days ($10.55 in chips) 
Seat 3: DiskoDancer ($12.23 in chips) 
Seat 4: watersnow66 ($12.06 in chips) 
Seat 6: Ruman_One ($21.75 in chips) 
Rainlol: posts small blind $0.05
Lord_of_days: posts big blind $0.10
*** HOLE CARDS ***
DiskoDancer: raises $0.15 to $0.25
watersnow66: folds 
Ruman_One: folds 
Rainlol: folds 
Lord_of_days: folds 
Uncalled bet ($0.15) returned to DiskoDancer
DiskoDancer collected $0.25 from pot
DiskoDancer: doesn't show hand 
*** SUMMARY ***
Total pot $0.25 | Rake $0 
Seat 1: Rainlol (small blind) folded before Flop
Seat 2: Lord_of_days (big blind) folded before Flop
Seat 3: DiskoDancer collected ($0.25)
Seat 4: watersnow66 folded before Flop (didn't bet)
Seat 6: Ruman_One (button) folded before Flop (didn't bet)



PokerStars Hand #222961700190:  Hold'em No Limit ($0.05/$0.10 USD) - 2021/01/23 12:39:38 ET
Table 'Polydoros II' 6-max Seat #1 is the button
Seat 1: Rainlol ($10.25 in chips) 
Seat 2: Lord_of_days ($10.45 in chips) 
Seat 3: DiskoDancer ($12.38 in chips) 
Seat 4: watersnow66 ($12.06 in chips) 
Seat 6: Ruman_One ($21.75 in chips) 
Lord_of_days: posts small blind $0.05
DiskoDancer: posts big blind $0.10
*** HOLE CARDS ***
appu001 leaves the table
watersnow66 has timed out
watersnow66: folds 
Ruman_One: folds 
asaphookz joins the table at seat #5 
Rainlol: folds 
Lord_of_days: folds 
Uncalled bet ($0.05) returned to DiskoDancer
DiskoDancer collected $0.10 from pot
DiskoDancer: doesn't show hand 
*** SUMMARY ***
Total pot $0.10 | Rake $0 
Seat 1: Rainlol (button) folded before Flop (didn't bet)
Seat 2: Lord_of_days (small blind) folded before Flop
Seat 3: DiskoDancer (big blind) collected ($0.10)
Seat 4: watersnow66 folded before Flop (didn't bet)
Seat 6: Ruman_One folded before Flop (didn't bet)



PokerStars Hand #222961716379:  Hold'em No Limit ($0.05/$0.10 USD) - 2021/01/23 12:40:02 ET
Table 'Polydoros II' 6-max Seat #2 is the button
Seat 1: Rainlol ($10.25 in chips) 
Seat 2: Lord_of_days ($10.40 in chips) 
Seat 3: DiskoDancer ($12.43 in chips) 
Seat 4: watersnow66 ($12.06 in chips) 
Seat 6: Ruman_One ($21.75 in chips) 
DiskoDancer: posts small blind $0.05
watersnow66: posts big blind $0.10
asaphookz: sits out 
*** HOLE CARDS ***
Ruman_One: folds 
Rainlol: folds 
Lord_of_days: raises $0.20 to $0.30
DiskoDancer: raises $0.90 to $1.20
watersnow66: folds 
Lord_of_days: folds 
Uncalled bet ($0.90) returned to DiskoDancer
DiskoDancer collected $0.70 from pot
DiskoDancer: doesn't show hand 
*** SUMMARY ***
Total pot $0.70 | Rake $0 
Seat 1: Rainlol folded before Flop (didn't bet)
Seat 2: Lord_of_days (button) folded before Flop
Seat 3: DiskoDancer (small blind) collected ($0.70)
Seat 4: watersnow66 (big blind) folded before Flop
Seat 6: Ruman_One folded before Flop (didn't bet)



PokerStars Hand #222961729889:  Hold'em No Limit ($0.05/$0.10 USD) - 2021/01/23 12:40:22 ET
Table 'Polydoros II' 6-max Seat #3 is the button
Seat 1: Rainlol ($10.25 in chips) 
Seat 2: Lord_of_days ($10.10 in chips) 
Seat 3: DiskoDancer ($12.83 in chips) 
Seat 4: watersnow66 ($11.96 in chips) 
Seat 5: asaphookz ($10 in chips) 
Seat 6: Ruman_One ($21.75 in chips) 
watersnow66: posts small blind $0.05
asaphookz: posts big blind $0.10
*** HOLE CARDS ***
Ruman_One: folds 
Rainlol: folds 
Lord_of_days: folds 
Ruman_One leaves the table
DiskoDancer: raises $0.15 to $0.25
watersnow66: folds 
asaphookz: folds 
Uncalled bet ($0.15) returned to DiskoDancer
DiskoDancer collected $0.25 from pot
DiskoDancer: doesn't show hand 
*** SUMMARY ***
Total pot $0.25 | Rake $0 
Seat 1: Rainlol folded before Flop (didn't bet)
Seat 2: Lord_of_days folded before Flop (didn't bet)
Seat 3: DiskoDancer (button) collected ($0.25)
Seat 4: watersnow66 (small blind) folded before Flop
Seat 5: asaphookz (big blind) folded before Flop
Seat 6: Ruman_One folded before Flop (didn't bet)



PokerStars Hand #222961737684:  Hold'em No Limit ($0.05/$0.10 USD) - 2021/01/23 12:40:33 ET
Table 'Polydoros II' 6-max Seat #4 is the button
Seat 1: Rainlol ($10.25 in chips) 
Seat 2: Lord_of_days ($10.10 in chips) 
Seat 3: DiskoDancer ($12.98 in chips) 
Seat 4: watersnow66 ($11.91 in chips) 
Seat 5: asaphookz ($9.90 in chips) 
asaphookz: posts small blind $0.05
Rainlol: posts big blind $0.10
*** HOLE CARDS ***
Lord_of_days: folds 
DiskoDancer: folds 
buranela joins the table at seat #6 
watersnow66: folds 
Lord_of_days leaves the table
asaphookz: raises $0.12 to $0.22
Rainlol: folds 
Uncalled bet ($0.12) returned to asaphookz
asaphookz collected $0.20 from pot
*** SUMMARY ***
Total pot $0.20 | Rake $0 
Seat 1: Rainlol (big blind) folded before Flop
Seat 2: Lord_of_days folded before Flop (didn't bet)
Seat 3: DiskoDancer folded before Flop (didn't bet)
Seat 4: watersnow66 (button) folded before Flop (didn't bet)
Seat 5: asaphookz (small blind) collected ($0.20)



PokerStars Hand #222961744609:  Hold'em No Limit ($0.05/$0.10 USD) - 2021/01/23 12:40:44 ET
Table 'Polydoros II' 6-max Seat #5 is the button
Seat 1: Rainlol ($10.15 in chips) 
Seat 4: watersnow66 ($11.91 in chips) 
Seat 5: asaphookz ($10 in chips) 
Rainlol: posts small blind $0.05
DiskoDancer: is sitting out 
DiskoDancer leaves the table
watersnow66: posts big blind $0.10
*** HOLE CARDS ***
asaphookz: folds 
Rainlol: folds 
Uncalled bet ($0.05) returned to watersnow66
watersnow66 collected $0.10 from pot
*** SUMMARY ***
Total pot $0.10 | Rake $0 
Seat 1: Rainlol (small blind) folded before Flop
Seat 4: watersnow66 (big blind) collected ($0.10)
Seat 5: asaphookz (button) folded before Flop (didn't bet)



PokerStars Hand #222961748594:  Hold'em No Limit ($0.05/$0.10 USD) - 2021/01/23 12:40:49 ET
Table 'Polydoros II' 6-max Seat #1 is the button
Seat 1: Rainlol ($10.10 in chips) 
Seat 4: watersnow66 ($11.96 in chips) 
Seat 5: asaphookz ($10 in chips) 
watersnow66: posts small blind $0.05
asaphookz: posts big blind $0.10
buranela: sits out 
*** HOLE CARDS ***
Rainlol: folds 
watersnow66: calls $0.05
asaphookz: raises $0.25 to $0.35
AAAcostA joins the table at seat #3 
watersnow66: folds 
Uncalled bet ($0.25) returned to asaphookz
Viten'kA83 joins the table at seat #2 
asaphookz collected $0.20 from pot
*** SUMMARY ***
Total pot $0.20 | Rake $0 
Seat 1: Rainlol (button) folded before Flop (didn't bet)
Seat 4: watersnow66 (small blind) folded before Flop
Seat 5: asaphookz (big blind) collected ($0.20)



PokerStars Hand #222961759551:  Hold'em No Limit ($0.05/$0.10 USD) - 2021/01/23 12:41:05 ET
Table 'Polydoros II' 6-max Seat #4 is the button
Seat 1: Rainlol ($10.10 in chips) 
Seat 4: watersnow66 ($11.86 in chips) 
Seat 5: asaphookz ($10.10 in chips) 
Seat 6: buranela ($10 in chips) 
asaphookz: posts small blind $0.05
buranela: posts big blind $0.10
Viten'kA83: sits out 
AAAcostA: sits out 
*** HOLE CARDS ***
Rainlol: folds 
watersnow66: calls $0.10
asaphookz: folds 
buranela: checks 
*** FLOP *** [Qh 2h 6s]
buranela: checks 
watersnow66: checks 
*** TURN *** [Qh 2h 6s] [8d]
buranela: bets $0.18
watersnow66: folds 
Uncalled bet ($0.18) returned to buranela
buranela collected $0.24 from pot
*** SUMMARY ***
Total pot $0.25 | Rake $0.01 
Board [Qh 2h 6s 8d]
Seat 1: Rainlol folded before Flop (didn't bet)
Seat 4: watersnow66 (button) folded on the Turn
Seat 5: asaphookz (small blind) folded before Flop
Seat 6: buranela (big blind) collected ($0.24)



PokerStars Hand #222961783792:  Hold'em No Limit ($0.05/$0.10 USD) - 2021/01/23 12:41:42 ET
Table 'Polydoros II' 6-max Seat #5 is the button
Seat 1: Rainlol ($10.10 in chips) 
Seat 4: watersnow66 ($11.76 in chips) 
Seat 5: asaphookz ($10.05 in chips) 
Seat 6: buranela ($10.14 in chips) 
buranela: posts small blind $0.05
Rainlol: posts big blind $0.10
Viten'kA83: sits out 
AAAcostA: sits out 
*** HOLE CARDS ***
watersnow66: folds 
asaphookz: raises $0.12 to $0.22
buranela: folds 
Rainlol: raises $0.58 to $0.80
asaphookz: calls $0.58
*** FLOP *** [Kc 8d 6d]
Rainlol: bets $0.60
asaphookz: calls $0.60
*** TURN *** [Kc 8d 6d] [4s]
Rainlol: checks 
asaphookz: bets $1.50
Rainlol: folds 
Uncalled bet ($1.50) returned to asaphookz
asaphookz collected $2.72 from pot
*** SUMMARY ***
Total pot $2.85 | Rake $0.13 
Board [Kc 8d 6d 4s]
Seat 1: Rainlol (big blind) folded on the Turn
Seat 4: watersnow66 folded before Flop (didn't bet)
Seat 5: asaphookz (button) collected ($2.72)
Seat 6: buranela (small blind) folded before Flop



PokerStars Hand #222961903665:  Hold'em No Limit ($0.05/$0.10 USD) - 2021/01/23 12:44:40 ET
Table 'Polydoros II' 6-max Seat #2 is the button
Seat 1: Rainlol ($9.70 in chips) 
Seat 2: Viten'kA83 ($10 in chips) 
Seat 3: AAAcostA ($10 in chips) 
Seat 4: watersnow66 ($21.09 in chips) 
Seat 5: asaphookz ($11.37 in chips) 
Seat 6: buranela ($10.51 in chips) 
AAAcostA: posts small blind $0.05
watersnow66: posts big blind $0.10
*** HOLE CARDS ***
asaphookz: raises $0.12 to $0.22
buranela: folds 
Rainlol: folds 
Viten'kA83: folds 
AAAcostA: folds 
watersnow66: folds 
Uncalled bet ($0.12) returned to asaphookz
asaphookz collected $0.25 from pot
*** SUMMARY ***
Total pot $0.25 | Rake $0 
Seat 1: Rainlol folded before Flop (didn't bet)
Seat 2: Viten'kA83 (button) folded before Flop (didn't bet)
Seat 3: AAAcostA (small blind) folded before Flop
Seat 4: watersnow66 (big blind) folded before Flop
Seat 5: asaphookz collected ($0.25)
Seat 6: buranela folded before Flop (didn't bet)



PokerStars Hand #222961917555:  Hold'em No Limit ($0.05/$0.10 USD) - 2021/01/23 12:45:00 ET
Table 'Polydoros II' 6-max Seat #3 is the button
Seat 1: Rainlol ($9.70 in chips) 
Seat 2: Viten'kA83 ($10 in chips) 
Seat 3: AAAcostA ($10 in chips) 
Seat 4: watersnow66 ($20.99 in chips) 
Seat 5: asaphookz ($11.52 in chips) 
Seat 6: buranela ($10.51 in chips) 
watersnow66: posts small blind $0.05
asaphookz: posts big blind $0.10
*** HOLE CARDS ***
buranela: folds 
Rainlol: raises $0.20 to $0.30
Viten'kA83: folds 
AAAcostA: folds 
watersnow66: folds 
asaphookz: raises $0.60 to $0.90
buranela leaves the table
Rainlol: folds 
Uncalled bet ($0.60) returned to asaphookz
asaphookz collected $0.65 from pot
*** SUMMARY ***
Total pot $0.65 | Rake $0 
Seat 1: Rainlol folded before Flop
Seat 2: Viten'kA83 folded before Flop (didn't bet)
Seat 3: AAAcostA (button) folded before Flop (didn't bet)
Seat 4: watersnow66 (small blind) folded before Flop
Seat 5: asaphookz (big blind) collected ($0.65)
Seat 6: buranela folded before Flop (didn't bet)



PokerStars Hand #222961930774:  Hold'em No Limit ($0.05/$0.10 USD) - 2021/01/23 12:45:20 ET
Table 'Polydoros II' 6-max Seat #4 is the button
Seat 1: Rainlol ($10 in chips) 
Seat 2: Viten'kA83 ($10 in chips) 
Seat 3: AAAcostA ($10 in chips) 
Seat 4: watersnow66 ($20.94 in chips) 
Seat 5: asaphookz ($11.87 in chips) 
asaphookz: posts small blind $0.05
Rainlol: posts big blind $0.10
*** HOLE CARDS ***
Viten'kA83: folds 
1sau2sau3sau joins the table at seat #6 
AAAcostA: raises $0.20 to $0.30
watersnow66: folds 
asaphookz: folds 
Rainlol: folds 
Uncalled bet ($0.20) returned to AAAcostA
AAAcostA collected $0.25 from pot
AAAcostA: doesn't show hand 
*** SUMMARY ***
Total pot $0.25 | Rake $0 
Seat 1: Rainlol (big blind) folded before Flop
Seat 2: Viten'kA83 folded before Flop (didn't bet)
Seat 3: AAAcostA collected ($0.25)
Seat 4: watersnow66 (button) folded before Flop (didn't bet)
Seat 5: asaphookz (small blind) folded before Flop



PokerStars Hand #222961938192:  Hold'em No Limit ($0.05/$0.10 USD) - 2021/01/23 12:45:31 ET
Table 'Polydoros II' 6-max Seat #5 is the button
Seat 1: Rainlol ($9.90 in chips) 
Seat 2: Viten'kA83 ($10 in chips) 
Seat 3: AAAcostA ($10.15 in chips) 
Seat 4: watersnow66 ($20.94 in chips) 
Seat 5: asaphookz ($11.82 in chips) 
Rainlol: posts small blind $0.05
Viten'kA83: posts big blind $0.10
*** HOLE CARDS ***
AAAcostA: folds 
watersnow66 has timed out
watersnow66: folds 
asaphookz: folds 
Rainlol: folds 
Uncalled bet ($0.05) returned to Viten'kA83
Viten'kA83 collected $0.10 from pot
Viten'kA83: doesn't show hand 
*** SUMMARY ***
Total pot $0.10 | Rake $0 
Seat 1: Rainlol (small blind) folded before Flop
Seat 2: Viten'kA83 (big blind) collected ($0.10)
Seat 3: AAAcostA folded before Flop (didn't bet)
Seat 4: watersnow66 folded before Flop (didn't bet)
Seat 5: asaphookz (button) folded before Flop (didn't bet)



PokerStars Hand #222961950651:  Hold'em No Limit ($0.05/$0.10 USD) - 2021/01/23 12:45:49 ET
Table 'Polydoros II' 6-max Seat #1 is the button
Seat 1: Rainlol ($9.85 in chips) 
Seat 2: Viten'kA83 ($10.05 in chips) 
Seat 3: AAAcostA ($10.15 in chips) 
Seat 5: asaphookz ($11.82 in chips) 
Viten'kA83: posts small blind $0.05
AAAcostA: posts big blind $0.10
1sau2sau3sau: sits out 
*** HOLE CARDS ***
asaphookz: raises $0.12 to $0.22
Rainlol: folds 
Viten'kA83: folds 
AAAcostA: folds 
Uncalled bet ($0.12) returned to asaphookz
asaphookz collected $0.25 from pot
*** SUMMARY ***
Total pot $0.25 | Rake $0 
Seat 1: Rainlol (button) folded before Flop (didn't bet)
Seat 2: Viten'kA83 (small blind) folded before Flop
Seat 3: AAAcostA (big blind) folded before Flop
Seat 5: asaphookz collected ($0.25)



PokerStars Hand #222961963203:  Hold'em No Limit ($0.05/$0.10 USD) - 2021/01/23 12:46:08 ET
Table 'Polydoros II' 6-max Seat #2 is the button
Seat 1: Rainlol ($9.85 in chips) 
Seat 2: Viten'kA83 ($10 in chips) 
Seat 3: AAAcostA ($10.05 in chips) 
Seat 4: watersnow66 ($20.94 in chips) 
Seat 5: asaphookz ($11.97 in chips) 
AAAcostA: posts small blind $0.05
watersnow66: posts big blind $0.10
1sau2sau3sau: sits out 
*** HOLE CARDS ***
asaphookz: folds 
Rainlol: folds 
Viten'kA83: folds 
AAAcostA: raises $0.20 to $0.30
watersnow66: folds 
Uncalled bet ($0.20) returned to AAAcostA
AAAcostA collected $0.20 from pot
AAAcostA: doesn't show hand 
*** SUMMARY ***
Total pot $0.20 | Rake $0 
Seat 1: Rainlol folded before Flop (didn't bet)
Seat 2: Viten'kA83 (button) folded before Flop (didn't bet)
Seat 3: AAAcostA (small blind) collected ($0.20)
Seat 4: watersnow66 (big blind) folded before Flop
Seat 5: asaphookz folded before Flop (didn't bet)



PokerStars Hand #222961976662:  Hold'em No Limit ($0.05/$0.10 USD) - 2021/01/23 12:46:28 ET
Table 'Polydoros II' 6-max Seat #3 is the button
Seat 1: Rainlol ($9.85 in chips) 
Seat 2: Viten'kA83 ($10 in chips) 
Seat 3: AAAcostA ($10.15 in chips) 
Seat 4: watersnow66 ($20.84 in chips) 
Seat 5: asaphookz ($11.97 in chips) 
watersnow66: posts small blind $0.05
asaphookz: posts big blind $0.10
1sau2sau3sau: sits out 
*** HOLE CARDS ***
Rainlol: folds 
Viten'kA83: raises $0.20 to $0.30
AAAcostA: folds 
watersnow66: folds 
asaphookz: folds 
Uncalled bet ($0.20) returned to Viten'kA83
Viten'kA83 collected $0.25 from pot
Viten'kA83: doesn't show hand 
*** SUMMARY ***
Total pot $0.25 | Rake $0 
Seat 1: Rainlol folded before Flop (didn't bet)
Seat 2: Viten'kA83 collected ($0.25)
Seat 3: AAAcostA (button) folded before Flop (didn't bet)
Seat 4: watersnow66 (small blind) folded before Flop
Seat 5: asaphookz (big blind) folded before Flop



PokerStars Hand #222961987885:  Hold'em No Limit ($0.05/$0.10 USD) - 2021/01/23 12:46:44 ET
Table 'Polydoros II' 6-max Seat #4 is the button
Seat 1: Rainlol ($9.85 in chips) 
Seat 2: Viten'kA83 ($10.15 in chips) 
Seat 3: AAAcostA ($10.15 in chips) 
Seat 4: watersnow66 ($20.79 in chips) 
Seat 5: asaphookz ($11.87 in chips) 
Seat 6: 1sau2sau3sau ($6 in chips) 
asaphookz: posts small blind $0.05
1sau2sau3sau: posts big blind $0.10
*** HOLE CARDS ***
Rainlol: folds 
Viten'kA83: folds 
AAAcostA: raises $0.20 to $0.30
watersnow66: folds 
asaphookz: folds 
1sau2sau3sau: calls $0.20
*** FLOP *** [7s Td Jd]
1sau2sau3sau: checks 
AAAcostA: bets $0.19
1sau2sau3sau: calls $0.19
*** TURN *** [7s Td Jd] [7h]
1sau2sau3sau: checks 
AAAcostA: checks 
*** RIVER *** [7s Td Jd 7h] [8h]
1sau2sau3sau: bets $0.98
AAAcostA: folds 
Uncalled bet ($0.98) returned to 1sau2sau3sau
1sau2sau3sau collected $0.98 from pot
*** SUMMARY ***
Total pot $1.03 | Rake $0.05 
Board [7s Td Jd 7h 8h]
Seat 1: Rainlol folded before Flop (didn't bet)
Seat 2: Viten'kA83 folded before Flop (didn't bet)
Seat 3: AAAcostA folded on the River
Seat 4: watersnow66 (button) folded before Flop (didn't bet)
Seat 5: asaphookz (small blind) folded before Flop
Seat 6: 1sau2sau3sau (big blind) collected ($0.98)



PokerStars Hand #222962021273:  Hold'em No Limit ($0.05/$0.10 USD) - 2021/01/23 12:47:34 ET
Table 'Polydoros II' 6-max Seat #5 is the button
Seat 1: Rainlol ($9.85 in chips) 
Seat 2: Viten'kA83 ($10.15 in chips) 
Seat 3: AAAcostA ($10 in chips) 
Seat 4: watersnow66 ($20.79 in chips) 
Seat 5: asaphookz ($11.82 in chips) 
Seat 6: 1sau2sau3sau ($6.49 in chips) 
1sau2sau3sau: posts small blind $0.05
Rainlol: posts big blind $0.10
*** HOLE CARDS ***
Viten'kA83: folds 
AAAcostA: folds 
watersnow66: folds 
asaphookz: folds 
1sau2sau3sau: calls $0.05
Rainlol: checks 
*** FLOP *** [8s Td Th]
1sau2sau3sau: checks 
Rainlol: checks 
*** TURN *** [8s Td Th] [9s]
1sau2sau3sau: bets $0.19
Rainlol: folds 
Uncalled bet ($0.19) returned to 1sau2sau3sau
1sau2sau3sau collected $0.19 from pot
1sau2sau3sau: doesn't show hand 
*** SUMMARY ***
Total pot $0.20 | Rake $0.01 
Board [8s Td Th 9s]
Seat 1: Rainlol (big blind) folded on the Turn
Seat 2: Viten'kA83 folded before Flop (didn't bet)
Seat 3: AAAcostA folded before Flop (didn't bet)
Seat 4: watersnow66 folded before Flop (didn't bet)
Seat 5: asaphookz (button) folded before Flop (didn't bet)
Seat 6: 1sau2sau3sau (small blind) collected ($0.19)



PokerStars Hand #222962048608:  Hold'em No Limit ($0.05/$0.10 USD) - 2021/01/23 12:48:15 ET
Table 'Polydoros II' 6-max Seat #6 is the button
Seat 1: Rainlol ($9.75 in chips) 
Seat 2: Viten'kA83 ($10.15 in chips) 
Seat 3: AAAcostA ($10 in chips) 
Seat 4: watersnow66 ($20.79 in chips) 
Seat 5: asaphookz ($11.82 in chips) 
Seat 6: 1sau2sau3sau ($6.58 in chips) 
Rainlol: posts small blind $0.05
Viten'kA83: posts big blind $0.10
*** HOLE CARDS ***
AAAcostA: folds 
watersnow66: folds 
asaphookz: raises $0.12 to $0.22
1sau2sau3sau: calls $0.22
Rainlol: folds 
Viten'kA83: folds 
*** FLOP *** [2c 7d Jd]
asaphookz: bets $0.20
1sau2sau3sau: folds 
Uncalled bet ($0.20) returned to asaphookz
asaphookz collected $0.56 from pot
*** SUMMARY ***
Total pot $0.59 | Rake $0.03 
Board [2c 7d Jd]
Seat 1: Rainlol (small blind) folded before Flop
Seat 2: Viten'kA83 (big blind) folded before Flop
Seat 3: AAAcostA folded before Flop (didn't bet)
Seat 4: watersnow66 folded before Flop (didn't bet)
Seat 5: asaphookz collected ($0.56)
Seat 6: 1sau2sau3sau (button) folded on the Flop



PokerStars Hand #222962067718:  Hold'em No Limit ($0.05/$0.10 USD) - 2021/01/23 12:48:43 ET
Table 'Polydoros II' 6-max Seat #1 is the button
Seat 1: Rainlol ($9.70 in chips) 
Seat 2: Viten'kA83 ($10.05 in chips) 
Seat 3: AAAcostA ($10 in chips) 
Seat 4: watersnow66 ($20.79 in chips) 
Seat 5: asaphookz ($12.16 in chips) 
Seat 6: 1sau2sau3sau ($6.36 in chips) 
Viten'kA83: posts small blind $0.05
AAAcostA: posts big blind $0.10
*** HOLE CARDS ***
watersnow66 has timed out
watersnow66: folds 
asaphookz: raises $0.12 to $0.22
1sau2sau3sau: folds 
Rainlol: folds 
Viten'kA83: folds 
AAAcostA: calls $0.12
*** FLOP *** [Kd 8d 9c]
AAAcostA: checks 
asaphookz: bets $0.20
AAAcostA: folds 
Uncalled bet ($0.20) returned to asaphookz
asaphookz collected $0.47 from pot
*** SUMMARY ***
Total pot $0.49 | Rake $0.02 
Board [Kd 8d 9c]
Seat 1: Rainlol (button) folded before Flop (didn't bet)
Seat 2: Viten'kA83 (small blind) folded before Flop
Seat 3: AAAcostA (big blind) folded on the Flop
Seat 4: watersnow66 folded before Flop (didn't bet)
Seat 5: asaphookz collected ($0.47)
Seat 6: 1sau2sau3sau folded before Flop (didn't bet)



PokerStars Hand #222962093737:  Hold'em No Limit ($0.05/$0.10 USD) - 2021/01/23 12:49:21 ET
Table 'Polydoros II' 6-max Seat #2 is the button
Seat 1: Rainlol ($9.70 in chips) 
Seat 2: Viten'kA83 ($10 in chips) 
Seat 3: AAAcostA ($10 in chips) 
Seat 4: watersnow66 ($20.79 in chips) 
Seat 5: asaphookz ($12.41 in chips) 
Seat 6: 1sau2sau3sau ($6.36 in chips) 
AAAcostA: posts small blind $0.05
watersnow66: posts big blind $0.10
*** HOLE CARDS ***
asaphookz: raises $0.12 to $0.22
1sau2sau3sau: calls $0.22
Rainlol: folds 
Viten'kA83: raises $0.78 to $1
AAAcostA: folds 
watersnow66: folds 
asaphookz: folds 
1sau2sau3sau: calls $0.78
*** FLOP *** [3h Kh 4h]
1sau2sau3sau: checks 
Viten'kA83: bets $0.75
1sau2sau3sau: raises $4.61 to $5.36 and is all-in
Viten'kA83: calls $4.61
*** TURN *** [3h Kh 4h] [4s]
*** RIVER *** [3h Kh 4h 4s] [3d]
*** SHOW DOWN ***
1sau2sau3sau: shows [As Td] (two pair, Fours and Threes)
Viten'kA83: shows [Kc Ad] (two pair, Kings and Fours)
Viten'kA83 collected $12.50 from pot
*** SUMMARY ***
Total pot $13.09 | Rake $0.59 
Board [3h Kh 4h 4s 3d]
Seat 1: Rainlol folded before Flop (didn't bet)
Seat 2: Viten'kA83 (button) showed [Kc Ad] and won ($12.50) with two pair, Kings and Fours
Seat 3: AAAcostA (small blind) folded before Flop
Seat 4: watersnow66 (big blind) folded before Flop
Seat 5: asaphookz folded before Flop
Seat 6: 1sau2sau3sau showed [As Td] and lost with two pair, Fours and Threes



PokerStars Hand #222962133995:  Hold'em No Limit ($0.05/$0.10 USD) - 2021/01/23 12:50:21 ET
Table 'Polydoros II' 6-max Seat #3 is the button
Seat 1: Rainlol ($9.70 in chips) 
Seat 2: Viten'kA83 ($16.14 in chips) 
Seat 3: AAAcostA ($10 in chips) 
Seat 4: watersnow66 ($20.69 in chips) 
Seat 5: asaphookz ($12.19 in chips) 
watersnow66: posts small blind $0.05
asaphookz: posts big blind $0.10
*** HOLE CARDS ***
Rainlol: raises $0.20 to $0.30
Viten'kA83: folds 
AAAcostA: folds 
1sau2sau3sau leaves the table
watersnow66: folds 
asaphookz: calls $0.20
*** FLOP *** [2h 5d 4s]
asaphookz: checks 
andymal101 joins the table at seat #6 
Rainlol: bets $0.30
asaphookz: calls $0.30
*** TURN *** [2h 5d 4s] [Kh]
asaphookz: checks 
Rainlol: bets $0.70
asaphookz: folds 
Uncalled bet ($0.70) returned to Rainlol
Rainlol collected $1.19 from pot
Rainlol: doesn't show hand 
*** SUMMARY ***
Total pot $1.25 | Rake $0.06 
Board [2h 5d 4s Kh]
Seat 1: Rainlol collected ($1.19)
Seat 2: Viten'kA83 folded before Flop (didn't bet)
Seat 3: AAAcostA (button) folded before Flop (didn't bet)
Seat 4: watersnow66 (small blind) folded before Flop
Seat 5: asaphookz (big blind) folded on the Turn



PokerStars Hand #222962160992:  Hold'em No Limit ($0.05/$0.10 USD) - 2021/01/23 12:51:00 ET
Table 'Polydoros II' 6-max Seat #4 is the button
Seat 1: Rainlol ($10.29 in chips) 
Seat 2: Viten'kA83 ($16.14 in chips) 
Seat 3: AAAcostA ($10 in chips) 
Seat 4: watersnow66 ($20.64 in chips) 
Seat 5: asaphookz ($11.59 in chips) 
Seat 6: andymal101 ($10 in chips) 
asaphookz: posts small blind $0.05
andymal101: posts big blind $0.10
*** HOLE CARDS ***
Rainlol: folds 
Viten'kA83: folds 
AAAcostA: folds 
watersnow66: folds 
asaphookz: raises $0.12 to $0.22
andymal101: folds 
Uncalled bet ($0.12) returned to asaphookz
asaphookz collected $0.20 from pot
*** SUMMARY ***
Total pot $0.20 | Rake $0 
Seat 1: Rainlol folded before Flop (didn't bet)
Seat 2: Viten'kA83 folded before Flop (didn't bet)
Seat 3: AAAcostA folded before Flop (didn't bet)
Seat 4: watersnow66 (button) folded before Flop (didn't bet)
Seat 5: asaphookz (small blind) collected ($0.20)
Seat 6: andymal101 (big blind) folded before Flop



PokerStars Hand #222962170057:  Hold'em No Limit ($0.05/$0.10 USD) - 2021/01/23 12:51:14 ET
Table 'Polydoros II' 6-max Seat #5 is the button
Seat 1: Rainlol ($10.29 in chips) 
Seat 2: Viten'kA83 ($16.14 in chips) 
Seat 3: AAAcostA ($10 in chips) 
Seat 4: watersnow66 ($20.64 in chips) 
Seat 5: asaphookz ($11.69 in chips) 
Seat 6: andymal101 ($9.90 in chips) 
andymal101: posts small blind $0.05
Rainlol: posts big blind $0.10
*** HOLE CARDS ***
Viten'kA83: folds 
AAAcostA: raises $0.20 to $0.30
watersnow66: folds 
asaphookz: folds 
andymal101: folds 
Rainlol: folds 
Uncalled bet ($0.20) returned to AAAcostA
AAAcostA collected $0.25 from pot
AAAcostA: doesn't show hand 
*** SUMMARY ***
Total pot $0.25 | Rake $0 
Seat 1: Rainlol (big blind) folded before Flop
Seat 2: Viten'kA83 folded before Flop (didn't bet)
Seat 3: AAAcostA collected ($0.25)
Seat 4: watersnow66 folded before Flop (didn't bet)
Seat 5: asaphookz (button) folded before Flop (didn't bet)
Seat 6: andymal101 (small blind) folded before Flop



PokerStars Hand #222962177967:  Hold'em No Limit ($0.05/$0.10 USD) - 2021/01/23 12:51:26 ET
Table 'Polydoros II' 6-max Seat #6 is the button
Seat 1: Rainlol ($10.19 in chips) 
Seat 2: Viten'kA83 ($16.14 in chips) 
Seat 3: AAAcostA ($10.15 in chips) 
Seat 4: watersnow66 ($20.64 in chips) 
Seat 5: asaphookz ($11.69 in chips) 
Seat 6: andymal101 ($9.85 in chips) 
Rainlol: posts small blind $0.05
Viten'kA83: posts big blind $0.10
*** HOLE CARDS ***
AAAcostA: folds 
watersnow66: folds 
asaphookz: raises $0.12 to $0.22
andymal101: folds 
Rainlol: folds 
Viten'kA83: folds 
Uncalled bet ($0.12) returned to asaphookz
asaphookz collected $0.25 from pot
*** SUMMARY ***
Total pot $0.25 | Rake $0 
Seat 1: Rainlol (small blind) folded before Flop
Seat 2: Viten'kA83 (big blind) folded before Flop
Seat 3: AAAcostA folded before Flop (didn't bet)
Seat 4: watersnow66 folded before Flop (didn't bet)
Seat 5: asaphookz collected ($0.25)
Seat 6: andymal101 (button) folded before Flop (didn't bet)



PokerStars Hand #222962187386:  Hold'em No Limit ($0.05/$0.10 USD) - 2021/01/23 12:51:40 ET
Table 'Polydoros II' 6-max Seat #1 is the button
Seat 1: Rainlol ($10.14 in chips) 
Seat 2: Viten'kA83 ($16.04 in chips) 
Seat 3: AAAcostA ($10.15 in chips) 
Seat 4: watersnow66 ($20.64 in chips) 
Seat 5: asaphookz ($11.84 in chips) 
Seat 6: andymal101 ($9.85 in chips) 
Viten'kA83: posts small blind $0.05
AAAcostA: posts big blind $0.10
*** HOLE CARDS ***
watersnow66: folds 
asaphookz: folds 
andymal101: raises $0.20 to $0.30
Rainlol: folds 
Viten'kA83: folds 
AAAcostA: folds 
Uncalled bet ($0.20) returned to andymal101
andymal101 collected $0.25 from pot
andymal101: doesn't show hand 
*** SUMMARY ***
Total pot $0.25 | Rake $0 
Seat 1: Rainlol (button) folded before Flop (didn't bet)
Seat 2: Viten'kA83 (small blind) folded before Flop
Seat 3: AAAcostA (big blind) folded before Flop
Seat 4: watersnow66 folded before Flop (didn't bet)
Seat 5: asaphookz folded before Flop (didn't bet)
Seat 6: andymal101 collected ($0.25)



PokerStars Hand #222962198366:  Hold'em No Limit ($0.05/$0.10 USD) - 2021/01/23 12:51:56 ET
Table 'Polydoros II' 6-max Seat #2 is the button
Seat 1: Rainlol ($10.14 in chips) 
Seat 2: Viten'kA83 ($15.99 in chips) 
Seat 3: AAAcostA ($10.05 in chips) 
Seat 4: watersnow66 ($20.64 in chips) 
Seat 5: asaphookz ($11.84 in chips) 
Seat 6: andymal101 ($10 in chips) 
AAAcostA: posts small blind $0.05
watersnow66: posts big blind $0.10
*** HOLE CARDS ***
asaphookz: folds 
andymal101: folds 
Rainlol: folds 
Viten'kA83: folds 
AAAcostA: raises $0.20 to $0.30
watersnow66: calls $0.20
*** FLOP *** [8h Ah Jh]
AAAcostA: bets $0.30
watersnow66: folds 
Uncalled bet ($0.30) returned to AAAcostA
AAAcostA collected $0.57 from pot
AAAcostA: doesn't show hand 
*** SUMMARY ***
Total pot $0.60 | Rake $0.03 
Board [8h Ah Jh]
Seat 1: Rainlol folded before Flop (didn't bet)
Seat 2: Viten'kA83 (button) folded before Flop (didn't bet)
Seat 3: AAAcostA (small blind) collected ($0.57)
Seat 4: watersnow66 (big blind) folded on the Flop
Seat 5: asaphookz folded before Flop (didn't bet)
Seat 6: andymal101 folded before Flop (didn't bet)



PokerStars Hand #222962215084:  Hold'em No Limit ($0.05/$0.10 USD) - 2021/01/23 12:52:21 ET
Table 'Polydoros II' 6-max Seat #3 is the button
Seat 1: Rainlol ($10.14 in chips) 
Seat 2: Viten'kA83 ($15.99 in chips) 
Seat 3: AAAcostA ($10.32 in chips) 
Seat 4: watersnow66 ($20.34 in chips) 
Seat 5: asaphookz ($11.84 in chips) 
Seat 6: andymal101 ($10 in chips) 
watersnow66: posts small blind $0.05
asaphookz: posts big blind $0.10
*** HOLE CARDS ***
andymal101: folds 
Rainlol: folds 
Viten'kA83: folds 
AAAcostA: folds 
watersnow66: calls $0.05
asaphookz: checks 
*** FLOP *** [As 5c 3s]
watersnow66: checks 
asaphookz: checks 
*** TURN *** [As 5c 3s] [8c]
watersnow66: bets $0.10
asaphookz: calls $0.10
*** RIVER *** [As 5c 3s 8c] [8d]
watersnow66: checks 
asaphookz: bets $0.25
watersnow66: folds 
Uncalled bet ($0.25) returned to asaphookz
asaphookz collected $0.38 from pot
*** SUMMARY ***
Total pot $0.40 | Rake $0.02 
Board [As 5c 3s 8c 8d]
Seat 1: Rainlol folded before Flop (didn't bet)
Seat 2: Viten'kA83 folded before Flop (didn't bet)
Seat 3: AAAcostA (button) folded before Flop (didn't bet)
Seat 4: watersnow66 (small blind) folded on the River
Seat 5: asaphookz (big blind) collected ($0.38)
Seat 6: andymal101 folded before Flop (didn't bet)



PokerStars Hand #222962238267:  Hold'em No Limit ($0.05/$0.10 USD) - 2021/01/23 12:52:55 ET
Table 'Polydoros II' 6-max Seat #4 is the button
Seat 1: Rainlol ($10.14 in chips) 
Seat 2: Viten'kA83 ($15.99 in chips) 
Seat 3: AAAcostA ($10.32 in chips) 
Seat 4: watersnow66 ($20.14 in chips) 
Seat 5: asaphookz ($12.02 in chips) 
Seat 6: andymal101 ($10 in chips) 
asaphookz: posts small blind $0.05
andymal101: posts big blind $0.10
*** HOLE CARDS ***
Rainlol: folds 
Viten'kA83: raises $0.20 to $0.30
AAAcostA: folds 
watersnow66: folds 
asaphookz: folds 
andymal101: folds 
Uncalled bet ($0.20) returned to Viten'kA83
Viten'kA83 collected $0.25 from pot
Viten'kA83: doesn't show hand 
*** SUMMARY ***
Total pot $0.25 | Rake $0 
Seat 1: Rainlol folded before Flop (didn't bet)
Seat 2: Viten'kA83 collected ($0.25)
Seat 3: AAAcostA folded before Flop (didn't bet)
Seat 4: watersnow66 (button) folded before Flop (didn't bet)
Seat 5: asaphookz (small blind) folded before Flop
Seat 6: andymal101 (big blind) folded before Flop



PokerStars Hand #222962258436:  Hold'em No Limit ($0.05/$0.10 USD) - 2021/01/23 12:53:16 ET
Table 'Polydoros II' 6-max Seat #5 is the button
Seat 1: Rainlol ($10.14 in chips) 
Seat 2: Viten'kA83 ($16.14 in chips) 
Seat 3: AAAcostA ($10.32 in chips) 
Seat 4: watersnow66 ($20.14 in chips) 
Seat 5: asaphookz ($11.97 in chips) 
Seat 6: andymal101 ($9.90 in chips) 
andymal101: posts small blind $0.05
Rainlol: posts big blind $0.10
*** HOLE CARDS ***
Viten'kA83: folds 
AAAcostA: folds 
watersnow66: folds 
asaphookz: raises $0.12 to $0.22
andymal101: folds 
Rainlol: calls $0.12
*** FLOP *** [6c As 5d]
Rainlol: checks 
asaphookz: bets $0.16
Rainlol: folds 
Uncalled bet ($0.16) returned to asaphookz
asaphookz collected $0.47 from pot
*** SUMMARY ***
Total pot $0.49 | Rake $0.02 
Board [6c As 5d]
Seat 1: Rainlol (big blind) folded on the Flop
Seat 2: Viten'kA83 folded before Flop (didn't bet)
Seat 3: AAAcostA folded before Flop (didn't bet)
Seat 4: watersnow66 folded before Flop (didn't bet)
Seat 5: asaphookz (button) collected ($0.47)
Seat 6: andymal101 (small blind) folded before Flop



PokerStars Hand #222962275538:  Hold'em No Limit ($0.05/$0.10 USD) - 2021/01/23 12:53:41 ET
Table 'Polydoros II' 6-max Seat #6 is the button
Seat 1: Rainlol ($9.92 in chips) 
Seat 2: Viten'kA83 ($16.14 in chips) 
Seat 3: AAAcostA ($10.32 in chips) 
Seat 4: watersnow66 ($20.14 in chips) 
Seat 5: asaphookz ($12.22 in chips) 
Seat 6: andymal101 ($9.85 in chips) 
Rainlol: posts small blind $0.05
Viten'kA83: posts big blind $0.10
*** HOLE CARDS ***
AAAcostA: folds 
watersnow66: folds 
asaphookz: folds 
andymal101: raises $0.20 to $0.30
Rainlol: calls $0.25
Viten'kA83: folds 
*** FLOP *** [Js 3c 9c]
Rainlol: checks 
andymal101: bets $0.34
Rainlol: raises $0.76 to $1.10
andymal101: folds 
Uncalled bet ($0.76) returned to Rainlol
Rainlol collected $1.32 from pot
Rainlol: doesn't show hand 
*** SUMMARY ***
Total pot $1.38 | Rake $0.06 
Board [Js 3c 9c]
Seat 1: Rainlol (small blind) collected ($1.32)
Seat 2: Viten'kA83 (big blind) folded before Flop
Seat 3: AAAcostA folded before Flop (didn't bet)
Seat 4: watersnow66 folded before Flop (didn't bet)
Seat 5: asaphookz folded before Flop (didn't bet)
Seat 6: andymal101 (button) folded on the Flop



PokerStars Hand #222962302153:  Hold'em No Limit ($0.05/$0.10 USD) - 2021/01/23 12:54:21 ET
Table 'Polydoros II' 6-max Seat #1 is the button
Seat 1: Rainlol ($10.60 in chips) 
Seat 2: Viten'kA83 ($16.04 in chips) 
Seat 3: AAAcostA ($10.32 in chips) 
Seat 4: watersnow66 ($20.14 in chips) 
Seat 5: asaphookz ($12.22 in chips) 
Seat 6: andymal101 ($9.21 in chips) 
Viten'kA83: posts small blind $0.05
AAAcostA: posts big blind $0.10
*** HOLE CARDS ***
watersnow66: folds 
asaphookz: folds 
andymal101: folds 
Rainlol: folds 
Viten'kA83: raises $0.20 to $0.30
AAAcostA: folds 
Uncalled bet ($0.20) returned to Viten'kA83
Viten'kA83 collected $0.20 from pot
Viten'kA83: doesn't show hand 
*** SUMMARY ***
Total pot $0.20 | Rake $0 
Seat 1: Rainlol (button) folded before Flop (didn't bet)
Seat 2: Viten'kA83 (small blind) collected ($0.20)
Seat 3: AAAcostA (big blind) folded before Flop
Seat 4: watersnow66 folded before Flop (didn't bet)
Seat 5: asaphookz folded before Flop (didn't bet)
Seat 6: andymal101 folded before Flop (didn't bet)



PokerStars Hand #222962312200:  Hold'em No Limit ($0.05/$0.10 USD) - 2021/01/23 12:54:36 ET
Table 'Polydoros II' 6-max Seat #2 is the button
Seat 1: Rainlol ($10.60 in chips) 
Seat 2: Viten'kA83 ($16.14 in chips) 
Seat 3: AAAcostA ($10.22 in chips) 
Seat 4: watersnow66 ($20.14 in chips) 
Seat 5: asaphookz ($12.22 in chips) 
Seat 6: andymal101 ($9.21 in chips) 
AAAcostA: posts small blind $0.05
watersnow66: posts big blind $0.10
*** HOLE CARDS ***
asaphookz: folds 
andymal101: raises $0.20 to $0.30
Rainlol: folds 
Viten'kA83: folds 
AAAcostA: raises $0.70 to $1
watersnow66: folds 
andymal101: calls $0.70
*** FLOP *** [4h Js Jd]
AAAcostA: bets $1.51
andymal101: folds 
Uncalled bet ($1.51) returned to AAAcostA
AAAcostA collected $2.01 from pot
AAAcostA: doesn't show hand 
*** SUMMARY ***
Total pot $2.10 | Rake $0.09 
Board [4h Js Jd]
Seat 1: Rainlol folded before Flop (didn't bet)
Seat 2: Viten'kA83 (button) folded before Flop (didn't bet)
Seat 3: AAAcostA (small blind) collected ($2.01)
Seat 4: watersnow66 (big blind) folded before Flop
Seat 5: asaphookz folded before Flop (didn't bet)
Seat 6: andymal101 folded on the Flop



PokerStars Hand #222962342902:  Hold'em No Limit ($0.05/$0.10 USD) - 2021/01/23 12:55:26 ET
Table 'Polydoros II' 6-max Seat #3 is the button
Seat 1: Rainlol ($10.60 in chips) 
Seat 2: Viten'kA83 ($16.14 in chips) 
Seat 3: AAAcostA ($11.23 in chips) 
Seat 4: watersnow66 ($20.04 in chips) 
Seat 5: asaphookz ($12.22 in chips) 
Seat 6: andymal101 ($8.21 in chips) 
watersnow66: posts small blind $0.05
asaphookz: posts big blind $0.10
*** HOLE CARDS ***
andymal101: folds 
Rainlol: folds 
Viten'kA83: folds 
AAAcostA: folds 
watersnow66: folds 
Uncalled bet ($0.05) returned to asaphookz
asaphookz collected $0.10 from pot
*** SUMMARY ***
Total pot $0.10 | Rake $0 
Seat 1: Rainlol folded before Flop (didn't bet)
Seat 2: Viten'kA83 folded before Flop (didn't bet)
Seat 3: AAAcostA (button) folded before Flop (didn't bet)
Seat 4: watersnow66 (small blind) folded before Flop
Seat 5: asaphookz (big blind) collected ($0.10)
Seat 6: andymal101 folded before Flop (didn't bet)



PokerStars Hand #222962349518:  Hold'em No Limit ($0.05/$0.10 USD) - 2021/01/23 12:55:40 ET
Table 'Polydoros II' 6-max Seat #4 is the button
Seat 1: Rainlol ($10.60 in chips) 
Seat 2: Viten'kA83 ($16.14 in chips) 
Seat 3: AAAcostA ($11.23 in chips) 
Seat 4: watersnow66 ($19.99 in chips) 
Seat 5: asaphookz ($12.27 in chips) 
Seat 6: andymal101 ($8.21 in chips) 
asaphookz: posts small blind $0.05
andymal101: posts big blind $0.10
*** HOLE CARDS ***
Rainlol: raises $0.20 to $0.30
Viten'kA83: folds 
AAAcostA: folds 
watersnow66: folds 
asaphookz: folds 
andymal101: calls $0.20
*** FLOP *** [6s Td Ts]
andymal101: checks 
Rainlol: bets $0.31
andymal101: raises $0.31 to $0.62
Rainlol: calls $0.31
*** TURN *** [6s Td Ts] [Ks]
andymal101: bets $1.35
Rainlol: folds 
Uncalled bet ($1.35) returned to andymal101
andymal101 collected $1.80 from pot
andymal101: doesn't show hand 
*** SUMMARY ***
Total pot $1.89 | Rake $0.09 
Board [6s Td Ts Ks]
Seat 1: Rainlol folded on the Turn
Seat 2: Viten'kA83 folded before Flop (didn't bet)
Seat 3: AAAcostA folded before Flop (didn't bet)
Seat 4: watersnow66 (button) folded before Flop (didn't bet)
Seat 5: asaphookz (small blind) folded before Flop
Seat 6: andymal101 (big blind) collected ($1.80)



PokerStars Hand #222962366263:  Hold'em No Limit ($0.05/$0.10 USD) - 2021/01/23 12:56:14 ET
Table 'Polydoros II' 6-max Seat #5 is the button
Seat 2: Viten'kA83 ($16.14 in chips) 
Seat 3: AAAcostA ($11.23 in chips) 
Seat 4: watersnow66 ($19.99 in chips) 
Seat 5: asaphookz ($12.22 in chips) 
Seat 6: andymal101 ($9.09 in chips) 
andymal101: posts small blind $0.05
Rainlol: is sitting out 
Viten'kA83: posts big blind $0.10
*** HOLE CARDS ***
Rainlol leaves the table
AAAcostA: raises $0.20 to $0.30
watersnow66: folds 
asaphookz: folds 
andymal101: folds 
LocalFixer joins the table at seat #1 
Viten'kA83: calls $0.20
*** FLOP *** [Kd Kh Js]
Viten'kA83: checks 
AAAcostA: bets $0.19
Viten'kA83: folds 
Uncalled bet ($0.19) returned to AAAcostA
AAAcostA collected $0.62 from pot
AAAcostA: doesn't show hand 
*** SUMMARY ***
Total pot $0.65 | Rake $0.03 
Board [Kd Kh Js]
Seat 2: Viten'kA83 (big blind) folded on the Flop
Seat 3: AAAcostA collected ($0.62)
Seat 4: watersnow66 folded before Flop (didn't bet)
Seat 5: asaphookz (button) folded before Flop (didn't bet)
Seat 6: andymal101 (small blind) folded before Flop



PokerStars Hand #222962377869:  Hold'em No Limit ($0.05/$0.10 USD) - 2021/01/23 12:56:37 ET
Table 'Polydoros II' 6-max Seat #6 is the button
Seat 2: Viten'kA83 ($15.84 in chips) 
Seat 3: AAAcostA ($11.55 in chips) 
Seat 4: watersnow66 ($19.99 in chips) 
Seat 5: asaphookz ($12.22 in chips) 
Seat 6: andymal101 ($9.04 in chips) 
Viten'kA83: posts small blind $0.05
AAAcostA: posts big blind $0.10
*** HOLE CARDS ***
watersnow66: folds 
asaphookz: folds 
andymal101: folds 
Viten'kA83: calls $0.05
AAAcostA: checks 
*** FLOP *** [7s 9s As]
Viten'kA83: checks 
AAAcostA: checks 
*** TURN *** [7s 9s As] [6d]
Viten'kA83: bets $0.20
AAAcostA: calls $0.20
*** RIVER *** [7s 9s As 6d] [8c]
Viten'kA83: bets $0.43
AAAcostA: folds 
Uncalled bet ($0.43) returned to Viten'kA83
Viten'kA83 collected $0.57 from pot
Viten'kA83: doesn't show hand 
*** SUMMARY ***
Total pot $0.60 | Rake $0.03 
Board [7s 9s As 6d 8c]
Seat 2: Viten'kA83 (small blind) collected ($0.57)
Seat 3: AAAcostA (big blind) folded on the River
Seat 4: watersnow66 folded before Flop (didn't bet)
Seat 5: asaphookz folded before Flop (didn't bet)
Seat 6: andymal101 (button) folded before Flop (didn't bet)



PokerStars Hand #222962390878:  Hold'em No Limit ($0.05/$0.10 USD) - 2021/01/23 12:57:04 ET
Table 'Polydoros II' 6-max Seat #2 is the button
Seat 2: Viten'kA83 ($16.11 in chips) 
Seat 3: AAAcostA ($11.25 in chips) 
Seat 4: watersnow66 ($19.99 in chips) 
Seat 5: asaphookz ($12.22 in chips) 
Seat 6: andymal101 ($9.04 in chips) 
AAAcostA: posts small blind $0.05
watersnow66: posts big blind $0.10
LocalFixer: sits out 
*** HOLE CARDS ***
asaphookz: folds 
andymal101: raises $0.20 to $0.30
Viten'kA83: folds 
AAAcostA: calls $0.25
watersnow66: folds 
*** FLOP *** [Ad 8c 2s]
AAAcostA: checks 
andymal101: bets $0.50
AAAcostA: folds 
Uncalled bet ($0.50) returned to andymal101
andymal101 collected $0.67 from pot
andymal101: doesn't show hand 
*** SUMMARY ***
Total pot $0.70 | Rake $0.03 
Board [Ad 8c 2s]
Seat 2: Viten'kA83 (button) folded before Flop (didn't bet)
Seat 3: AAAcostA (small blind) folded on the Flop
Seat 4: watersnow66 (big blind) folded before Flop
Seat 5: asaphookz folded before Flop (didn't bet)
Seat 6: andymal101 collected ($0.67)



PokerStars Hand #222962405432:  Hold'em No Limit ($0.05/$0.10 USD) - 2021/01/23 12:57:33 ET
Table 'Polydoros II' 6-max Seat #3 is the button
Seat 2: Viten'kA83 ($16.11 in chips) 
Seat 3: AAAcostA ($10.95 in chips) 
Seat 4: watersnow66 ($19.89 in chips) 
Seat 5: asaphookz ($12.22 in chips) 
Seat 6: andymal101 ($9.41 in chips) 
watersnow66: posts small blind $0.05
asaphookz: posts big blind $0.10
LocalFixer: sits out 
*** HOLE CARDS ***
andymal101: folds 
Viten'kA83: folds 
AAAcostA: folds 
watersnow66: calls $0.05
asaphookz: raises $0.30 to $0.40
watersnow66: folds 
Uncalled bet ($0.30) returned to asaphookz
asaphookz collected $0.20 from pot
*** SUMMARY ***
Total pot $0.20 | Rake $0 
Seat 2: Viten'kA83 folded before Flop (didn't bet)
Seat 3: AAAcostA (button) folded before Flop (didn't bet)
Seat 4: watersnow66 (small blind) folded before Flop
Seat 5: asaphookz (big blind) collected ($0.20)
Seat 6: andymal101 folded before Flop (didn't bet)



PokerStars Hand #222962414675:  Hold'em No Limit ($0.05/$0.10 USD) - 2021/01/23 12:57:52 ET
Table 'Polydoros II' 6-max Seat #4 is the button
Seat 2: Viten'kA83 ($16.11 in chips) 
Seat 3: AAAcostA ($10.95 in chips) 
Seat 4: watersnow66 ($19.79 in chips) 
Seat 5: asaphookz ($12.32 in chips) 
Seat 6: andymal101 ($9.41 in chips) 
asaphookz: posts small blind $0.05
andymal101: posts big blind $0.10
LocalFixer: sits out 
*** HOLE CARDS ***
Viten'kA83: folds 
AAAcostA: folds 
watersnow66: folds 
asaphookz: raises $0.12 to $0.22
andymal101: folds 
Uncalled bet ($0.12) returned to asaphookz
asaphookz collected $0.20 from pot
*** SUMMARY ***
Total pot $0.20 | Rake $0 
Seat 2: Viten'kA83 folded before Flop (didn't bet)
Seat 3: AAAcostA folded before Flop (didn't bet)
Seat 4: watersnow66 (button) folded before Flop (didn't bet)
Seat 5: asaphookz (small blind) collected ($0.20)
Seat 6: andymal101 (big blind) folded before Flop



PokerStars Hand #222962421601:  Hold'em No Limit ($0.05/$0.10 USD) - 2021/01/23 12:58:05 ET
Table 'Polydoros II' 6-max Seat #5 is the button
Seat 1: LocalFixer ($10 in chips) 
Seat 2: Viten'kA83 ($16.11 in chips) 
Seat 3: AAAcostA ($10.95 in chips) 
Seat 4: watersnow66 ($19.79 in chips) 
Seat 5: asaphookz ($12.42 in chips) 
Seat 6: andymal101 ($9.31 in chips) 
andymal101: posts small blind $0.05
LocalFixer: posts big blind $0.10
*** HOLE CARDS ***
Viten'kA83: folds 
AAAcostA: folds 
watersnow66: calls $0.10
asaphookz: raises $0.25 to $0.35
andymal101: folds 
LocalFixer: folds 
watersnow66: folds 
Uncalled bet ($0.25) returned to asaphookz
asaphookz collected $0.35 from pot
*** SUMMARY ***
Total pot $0.35 | Rake $0 
Seat 1: LocalFixer (big blind) folded before Flop
Seat 2: Viten'kA83 folded before Flop (didn't bet)
Seat 3: AAAcostA folded before Flop (didn't bet)
Seat 4: watersnow66 folded before Flop
Seat 5: asaphookz (button) collected ($0.35)
Seat 6: andymal101 (small blind) folded before Flop



PokerStars Hand #222962434640:  Hold'em No Limit ($0.05/$0.10 USD) - 2021/01/23 12:58:32 ET
Table 'Polydoros II' 6-max Seat #6 is the button
Seat 1: LocalFixer ($10 in chips) 
Seat 2: Viten'kA83 ($16.11 in chips) 
Seat 3: AAAcostA ($10.95 in chips) 
Seat 4: watersnow66 ($19.69 in chips) 
Seat 5: asaphookz ($12.67 in chips) 
Seat 6: andymal101 ($9.26 in chips) 
LocalFixer: posts small blind $0.05
Viten'kA83: posts big blind $0.10
*** HOLE CARDS ***
AAAcostA: folds 
watersnow66: folds 
asaphookz: raises $0.12 to $0.22
andymal101: folds 
LocalFixer: folds 
Viten'kA83: folds 
Uncalled bet ($0.12) returned to asaphookz
asaphookz collected $0.25 from pot
*** SUMMARY ***
Total pot $0.25 | Rake $0 
Seat 1: LocalFixer (small blind) folded before Flop
Seat 2: Viten'kA83 (big blind) folded before Flop
Seat 3: AAAcostA folded before Flop (didn't bet)
Seat 4: watersnow66 folded before Flop (didn't bet)
Seat 5: asaphookz collected ($0.25)
Seat 6: andymal101 (button) folded before Flop (didn't bet)



PokerStars Hand #222962440536:  Hold'em No Limit ($0.05/$0.10 USD) - 2021/01/23 12:58:43 ET
Table 'Polydoros II' 6-max Seat #1 is the button
Seat 1: LocalFixer ($10 in chips) 
Seat 2: Viten'kA83 ($16.01 in chips) 
Seat 3: AAAcostA ($10.95 in chips) 
Seat 4: watersnow66 ($19.69 in chips) 
Seat 5: asaphookz ($12.82 in chips) 
Seat 6: andymal101 ($9.26 in chips) 
Viten'kA83: posts small blind $0.05
AAAcostA: posts big blind $0.10
*** HOLE CARDS ***
watersnow66: folds 
asaphookz: folds 
andymal101: raises $0.20 to $0.30
LocalFixer: folds 
Viten'kA83: folds 
AAAcostA: folds 
Uncalled bet ($0.20) returned to andymal101
andymal101 collected $0.25 from pot
andymal101: doesn't show hand 
*** SUMMARY ***
Total pot $0.25 | Rake $0 
Seat 1: LocalFixer (button) folded before Flop (didn't bet)
Seat 2: Viten'kA83 (small blind) folded before Flop
Seat 3: AAAcostA (big blind) folded before Flop
Seat 4: watersnow66 folded before Flop (didn't bet)
Seat 5: asaphookz folded before Flop (didn't bet)
Seat 6: andymal101 collected ($0.25)



PokerStars Hand #222962451095:  Hold'em No Limit ($0.05/$0.10 USD) - 2021/01/23 12:59:04 ET
Table 'Polydoros II' 6-max Seat #2 is the button
Seat 1: LocalFixer ($10 in chips) 
Seat 2: Viten'kA83 ($15.96 in chips) 
Seat 3: AAAcostA ($10.85 in chips) 
Seat 4: watersnow66 ($19.69 in chips) 
Seat 5: asaphookz ($12.82 in chips) 
Seat 6: andymal101 ($9.41 in chips) 
AAAcostA: posts small blind $0.05
watersnow66: posts big blind $0.10
*** HOLE CARDS ***
asaphookz: folds 
andymal101: folds 
LocalFixer: folds 
Viten'kA83: folds 
AAAcostA: raises $0.20 to $0.30
watersnow66: folds 
Uncalled bet ($0.20) returned to AAAcostA
AAAcostA collected $0.20 from pot
AAAcostA: doesn't show hand 
*** SUMMARY ***
Total pot $0.20 | Rake $0 
Seat 1: LocalFixer folded before Flop (didn't bet)
Seat 2: Viten'kA83 (button) folded before Flop (didn't bet)
Seat 3: AAAcostA (small blind) collected ($0.20)
Seat 4: watersnow66 (big blind) folded before Flop
Seat 5: asaphookz folded before Flop (didn't bet)
Seat 6: andymal101 folded before Flop (didn't bet)



PokerStars Hand #222962459590:  Hold'em No Limit ($0.05/$0.10 USD) - 2021/01/23 12:59:21 ET
Table 'Polydoros II' 6-max Seat #3 is the button
Seat 1: LocalFixer ($10 in chips) 
Seat 2: Viten'kA83 ($15.96 in chips) 
Seat 3: AAAcostA ($10.95 in chips) 
Seat 4: watersnow66 ($19.59 in chips) 
Seat 5: asaphookz ($12.82 in chips) 
Seat 6: andymal101 ($9.41 in chips) 
watersnow66: posts small blind $0.05
asaphookz: posts big blind $0.10
*** HOLE CARDS ***
andymal101: raises $0.20 to $0.30
LocalFixer: folds 
Viten'kA83: folds 
AAAcostA: folds 
watersnow66: folds 
asaphookz: folds 
Uncalled bet ($0.20) returned to andymal101
andymal101 collected $0.25 from pot
andymal101: doesn't show hand 
*** SUMMARY ***
Total pot $0.25 | Rake $0 
Seat 1: LocalFixer folded before Flop (didn't bet)
Seat 2: Viten'kA83 folded before Flop (didn't bet)
Seat 3: AAAcostA (button) folded before Flop (didn't bet)
Seat 4: watersnow66 (small blind) folded before Flop
Seat 5: asaphookz (big blind) folded before Flop
Seat 6: andymal101 collected ($0.25)



PokerStars Hand #222962467456:  Hold'em No Limit ($0.05/$0.10 USD) - 2021/01/23 12:59:37 ET
Table 'Polydoros II' 6-max Seat #4 is the button
Seat 1: LocalFixer ($10 in chips) 
Seat 2: Viten'kA83 ($15.96 in chips) 
Seat 3: AAAcostA ($10.95 in chips) 
Seat 4: watersnow66 ($19.54 in chips) 
Seat 5: asaphookz ($12.72 in chips) 
asaphookz: posts small blind $0.05
andymal101: is sitting out 
LocalFixer: posts big blind $0.10
*** HOLE CARDS ***
Viten'kA83: raises $0.20 to $0.30
AAAcostA: folds 
watersnow66: folds 
asaphookz: folds 
LocalFixer: folds 
Uncalled bet ($0.20) returned to Viten'kA83
Viten'kA83 collected $0.25 from pot
Viten'kA83: doesn't show hand 
*** SUMMARY ***
Total pot $0.25 | Rake $0 
Seat 1: LocalFixer (big blind) folded before Flop
Seat 2: Viten'kA83 collected ($0.25)
Seat 3: AAAcostA folded before Flop (didn't bet)
Seat 4: watersnow66 (button) folded before Flop (didn't bet)
Seat 5: asaphookz (small blind) folded before Flop



PokerStars Hand #222962478023:  Hold'em No Limit ($0.05/$0.10 USD) - 2021/01/23 12:59:58 ET
Table 'Polydoros II' 6-max Seat #5 is the button
Seat 1: LocalFixer ($10 in chips) 
Seat 2: Viten'kA83 ($16.11 in chips) 
Seat 3: AAAcostA ($10.95 in chips) 
Seat 4: watersnow66 ($19.54 in chips) 
Seat 5: asaphookz ($12.67 in chips) 
LocalFixer: posts small blind $0.05
Viten'kA83: posts big blind $0.10
*** HOLE CARDS ***
AAAcostA: folds 
watersnow66: folds 
asaphookz: folds 
LocalFixer: raises $0.15 to $0.25
Viten'kA83: folds 
Uncalled bet ($0.15) returned to LocalFixer
LocalFixer collected $0.20 from pot
LocalFixer: doesn't show hand 
*** SUMMARY ***
Total pot $0.20 | Rake $0 
Seat 1: LocalFixer (small blind) collected ($0.20)
Seat 2: Viten'kA83 (big blind) folded before Flop
Seat 3: AAAcostA folded before Flop (didn't bet)
Seat 4: watersnow66 folded before Flop (didn't bet)
Seat 5: asaphookz (button) folded before Flop (didn't bet)



PokerStars Hand #222962492600:  Hold'em No Limit ($0.05/$0.10 USD) - 2021/01/23 13:00:25 ET
Table 'Polydoros II' 6-max Seat #1 is the button
Seat 1: LocalFixer ($10.10 in chips) 
Seat 2: Viten'kA83 ($16.01 in chips) 
Seat 3: AAAcostA ($10.95 in chips) 
Seat 4: watersnow66 ($19.54 in chips) 
Seat 5: asaphookz ($12.67 in chips) 
Viten'kA83: posts small blind $0.05
AAAcostA: posts big blind $0.10
*** HOLE CARDS ***
watersnow66: folds 
asaphookz: folds 
LocalFixer: folds 
andymal101 leaves the table
Viten'kA83: calls $0.05
AAAcostA: checks 
*** FLOP *** [Ad Td 7c]
sapr.549 joins the table at seat #6 
Viten'kA83: checks 
AAAcostA: checks 
*** TURN *** [Ad Td 7c] [Jc]
Viten'kA83: checks 
AAAcostA: bets $0.20
Viten'kA83: calls $0.20
*** RIVER *** [Ad Td 7c Jc] [9d]
Viten'kA83: checks 
AAAcostA: checks 
*** SHOW DOWN ***
Viten'kA83: shows [2c 3c] (high card Ace)
AAAcostA: shows [9h 2s] (a pair of Nines)
AAAcostA collected $0.57 from pot
*** SUMMARY ***
Total pot $0.60 | Rake $0.03 
Board [Ad Td 7c Jc 9d]
Seat 1: LocalFixer (button) folded before Flop (didn't bet)
Seat 2: Viten'kA83 (small blind) showed [2c 3c] and lost with high card Ace
Seat 3: AAAcostA (big blind) showed [9h 2s] and won ($0.57) with a pair of Nines
Seat 4: watersnow66 folded before Flop (didn't bet)
Seat 5: asaphookz folded before Flop (didn't bet)



PokerStars Hand #222962520175:  Hold'em No Limit ($0.05/$0.10 USD) - 2021/01/23 13:01:14 ET
Table 'Polydoros II' 6-max Seat #2 is the button
Seat 1: LocalFixer ($10.10 in chips) 
Seat 2: Viten'kA83 ($15.71 in chips) 
Seat 3: AAAcostA ($11.22 in chips) 
Seat 4: watersnow66 ($19.54 in chips) 
Seat 5: asaphookz ($12.67 in chips) 
AAAcostA: posts small blind $0.05
watersnow66: posts big blind $0.10
sapr.549: sits out 
*** HOLE CARDS ***
asaphookz: folds 
LocalFixer: raises $0.20 to $0.30
Viten'kA83: calls $0.30
AAAcostA: folds 
watersnow66: calls $0.20
*** FLOP *** [Qh 8s Td]
watersnow66: checks 
LocalFixer: bets $0.50
Viten'kA83: folds 
watersnow66: folds 
Uncalled bet ($0.50) returned to LocalFixer
LocalFixer collected $0.91 from pot
LocalFixer: doesn't show hand 
*** SUMMARY ***
Total pot $0.95 | Rake $0.04 
Board [Qh 8s Td]
Seat 1: LocalFixer collected ($0.91)
Seat 2: Viten'kA83 (button) folded on the Flop
Seat 3: AAAcostA (small blind) folded before Flop
Seat 4: watersnow66 (big blind) folded on the Flop
Seat 5: asaphookz folded before Flop (didn't bet)



PokerStars Hand #222962536737:  Hold'em No Limit ($0.05/$0.10 USD) - 2021/01/23 13:01:42 ET
Table 'Polydoros II' 6-max Seat #3 is the button
Seat 1: LocalFixer ($10.71 in chips) 
Seat 2: Viten'kA83 ($15.41 in chips) 
Seat 3: AAAcostA ($11.17 in chips) 
Seat 4: watersnow66 ($19.24 in chips) 
Seat 5: asaphookz ($12.67 in chips) 
watersnow66: posts small blind $0.05
asaphookz: posts big blind $0.10
sapr.549: sits out 
*** HOLE CARDS ***
LocalFixer: folds 
Viten'kA83: folds 
AAAcostA: folds 
watersnow66: folds 
Uncalled bet ($0.05) returned to asaphookz
asaphookz collected $0.10 from pot
*** SUMMARY ***
Total pot $0.10 | Rake $0 
Seat 1: LocalFixer folded before Flop (didn't bet)
Seat 2: Viten'kA83 folded before Flop (didn't bet)
Seat 3: AAAcostA (button) folded before Flop (didn't bet)
Seat 4: watersnow66 (small blind) folded before Flop
Seat 5: asaphookz (big blind) collected ($0.10)



PokerStars Hand #222962540767:  Hold'em No Limit ($0.05/$0.10 USD) - 2021/01/23 13:01:48 ET
Table 'Polydoros II' 6-max Seat #4 is the button
Seat 1: LocalFixer ($10.71 in chips) 
Seat 2: Viten'kA83 ($15.41 in chips) 
Seat 3: AAAcostA ($11.17 in chips) 
Seat 4: watersnow66 ($19.19 in chips) 
Seat 5: asaphookz ($12.72 in chips) 
Seat 6: sapr.549 ($10 in chips) 
asaphookz: posts small blind $0.05
sapr.549: posts big blind $0.10
*** HOLE CARDS ***
LocalFixer: folds 
Viten'kA83: raises $0.20 to $0.30
AAAcostA: folds 
watersnow66: folds 
asaphookz: folds 
sapr.549: folds 
Uncalled bet ($0.20) returned to Viten'kA83
Viten'kA83 collected $0.25 from pot
Viten'kA83: doesn't show hand 
*** SUMMARY ***
Total pot $0.25 | Rake $0 
Seat 1: LocalFixer folded before Flop (didn't bet)
Seat 2: Viten'kA83 collected ($0.25)
Seat 3: AAAcostA folded before Flop (didn't bet)
Seat 4: watersnow66 (button) folded before Flop (didn't bet)
Seat 5: asaphookz (small blind) folded before Flop
Seat 6: sapr.549 (big blind) folded before Flop



PokerStars Hand #222962590222:  Hold'em No Limit ($0.05/$0.10 USD) - 2021/01/23 13:03:03 ET
Table 'Polydoros II' 6-max Seat #6 is the button
Seat 2: Viten'kA83 ($15.46 in chips) 
Seat 3: AAAcostA ($12.69 in chips) 
Seat 4: watersnow66 ($18.89 in chips) 
Seat 5: asaphookz ($11.47 in chips) 
Seat 6: sapr.549 ($9.85 in chips) 
Viten'kA83: posts small blind $0.05
AAAcostA: posts big blind $0.10
*** HOLE CARDS ***
LocalFixer leaves the table
watersnow66: folds 
asaphookz: raises $0.12 to $0.22
gho3 joins the table at seat #1 
sapr.549: calls $0.22
Viten'kA83: folds 
AAAcostA: folds 
*** FLOP *** [5c 2c 2h]
asaphookz: bets $0.18
sapr.549: folds 
Uncalled bet ($0.18) returned to asaphookz
asaphookz collected $0.56 from pot
*** SUMMARY ***
Total pot $0.59 | Rake $0.03 
Board [5c 2c 2h]
Seat 2: Viten'kA83 (small blind) folded before Flop
Seat 3: AAAcostA (big blind) folded before Flop
Seat 4: watersnow66 folded before Flop (didn't bet)
Seat 5: asaphookz collected ($0.56)
Seat 6: sapr.549 (button) folded on the Flop



PokerStars Hand #222962613504:  Hold'em No Limit ($0.05/$0.10 USD) - 2021/01/23 13:03:37 ET
Table 'Polydoros II' 6-max Seat #2 is the button
Seat 2: Viten'kA83 ($15.41 in chips) 
Seat 3: AAAcostA ($12.59 in chips) 
Seat 4: watersnow66 ($18.89 in chips) 
Seat 5: asaphookz ($11.81 in chips) 
Seat 6: sapr.549 ($9.63 in chips) 
AAAcostA: posts small blind $0.05
watersnow66: posts big blind $0.10
gho3: sits out 
*** HOLE CARDS ***
asaphookz: folds 
sapr.549: folds 
Viten'kA83: folds 
AAAcostA: folds 
Uncalled bet ($0.05) returned to watersnow66
watersnow66 collected $0.10 from pot
*** SUMMARY ***
Total pot $0.10 | Rake $0 
Seat 2: Viten'kA83 (button) folded before Flop (didn't bet)
Seat 3: AAAcostA (small blind) folded before Flop
Seat 4: watersnow66 (big blind) collected ($0.10)
Seat 5: asaphookz folded before Flop (didn't bet)
Seat 6: sapr.549 folded before Flop (didn't bet)



PokerStars Hand #222962620750:  Hold'em No Limit ($0.05/$0.10 USD) - 2021/01/23 13:03:48 ET
Table 'Polydoros II' 6-max Seat #3 is the button
Seat 2: Viten'kA83 ($15.41 in chips) 
Seat 3: AAAcostA ($12.54 in chips) 
Seat 4: watersnow66 ($18.94 in chips) 
Seat 5: asaphookz ($11.81 in chips) 
Seat 6: sapr.549 ($9.63 in chips) 
watersnow66: posts small blind $0.05
asaphookz: posts big blind $0.10
gho3: sits out 
*** HOLE CARDS ***
sapr.549: folds 
Viten'kA83: raises $0.20 to $0.30
AAAcostA: raises $0.60 to $0.90
watersnow66: folds 
asaphookz: calls $0.80
Viten'kA83: folds 
*** FLOP *** [2c 4s Qs]
asaphookz: checks 
AAAcostA: bets $1.09
asaphookz: folds 
Uncalled bet ($1.09) returned to AAAcostA
AAAcostA collected $2.05 from pot
AAAcostA: doesn't show hand 
*** SUMMARY ***
Total pot $2.15 | Rake $0.10 
Board [2c 4s Qs]
Seat 2: Viten'kA83 folded before Flop
Seat 3: AAAcostA (button) collected ($2.05)
Seat 4: watersnow66 (small blind) folded before Flop
Seat 5: asaphookz (big blind) folded on the Flop
Seat 6: sapr.549 folded before Flop (didn't bet)



PokerStars Hand #222962640096:  Hold'em No Limit ($0.05/$0.10 USD) - 2021/01/23 13:04:16 ET
Table 'Polydoros II' 6-max Seat #4 is the button
Seat 2: Viten'kA83 ($15.11 in chips) 
Seat 3: AAAcostA ($13.69 in chips) 
Seat 4: watersnow66 ($18.89 in chips) 
Seat 5: asaphookz ($10.91 in chips) 
Seat 6: sapr.549 ($9.63 in chips) 
asaphookz: posts small blind $0.05
sapr.549: posts big blind $0.10
gho3: sits out 
*** HOLE CARDS ***
Viten'kA83: raises $0.20 to $0.30
AAAcostA: folds 
watersnow66: folds 
asaphookz: folds 
sapr.549: calls $0.20
*** FLOP *** [2s 5h Qc]
sapr.549: checks 
Viten'kA83: bets $0.32
sapr.549: folds 
Uncalled bet ($0.32) returned to Viten'kA83
Viten'kA83 collected $0.62 from pot
Viten'kA83: doesn't show hand 
*** SUMMARY ***
Total pot $0.65 | Rake $0.03 
Board [2s 5h Qc]
Seat 2: Viten'kA83 collected ($0.62)
Seat 3: AAAcostA folded before Flop (didn't bet)
Seat 4: watersnow66 (button) folded before Flop (didn't bet)
Seat 5: asaphookz (small blind) folded before Flop
Seat 6: sapr.549 (big blind) folded on the Flop



PokerStars Hand #222962657047:  Hold'em No Limit ($0.05/$0.10 USD) - 2021/01/23 13:04:41 ET
Table 'Polydoros II' 6-max Seat #5 is the button
Seat 1: gho3 ($4.20 in chips) 
Seat 2: Viten'kA83 ($15.43 in chips) 
Seat 3: AAAcostA ($13.69 in chips) 
Seat 4: watersnow66 ($18.89 in chips) 
Seat 5: asaphookz ($10.86 in chips) 
Seat 6: sapr.549 ($9.33 in chips) 
sapr.549: posts small blind $0.05
gho3: posts big blind $0.10
*** HOLE CARDS ***
Viten'kA83: folds 
AAAcostA: folds 
watersnow66: folds 
asaphookz: folds 
sapr.549: folds 
Uncalled bet ($0.05) returned to gho3
gho3 collected $0.10 from pot
gho3: doesn't show hand 
*** SUMMARY ***
Total pot $0.10 | Rake $0 
Seat 1: gho3 (big blind) collected ($0.10)
Seat 2: Viten'kA83 folded before Flop (didn't bet)
Seat 3: AAAcostA folded before Flop (didn't bet)
Seat 4: watersnow66 folded before Flop (didn't bet)
Seat 5: asaphookz (button) folded before Flop (didn't bet)
Seat 6: sapr.549 (small blind) folded before Flop



PokerStars Hand #222962665062:  Hold'em No Limit ($0.05/$0.10 USD) - 2021/01/23 13:04:52 ET
Table 'Polydoros II' 6-max Seat #6 is the button
Seat 1: gho3 ($4.25 in chips) 
Seat 2: Viten'kA83 ($15.43 in chips) 
Seat 3: AAAcostA ($13.69 in chips) 
Seat 4: watersnow66 ($18.89 in chips) 
Seat 5: asaphookz ($10.86 in chips) 
Seat 6: sapr.549 ($9.28 in chips) 
gho3: posts small blind $0.05
Viten'kA83: posts big blind $0.10
*** HOLE CARDS ***
AAAcostA: folds 
watersnow66: folds 
asaphookz: folds 
sapr.549: folds 
gho3: folds 
Uncalled bet ($0.05) returned to Viten'kA83
Viten'kA83 collected $0.10 from pot
Viten'kA83: doesn't show hand 
*** SUMMARY ***
Total pot $0.10 | Rake $0 
Seat 1: gho3 (small blind) folded before Flop
Seat 2: Viten'kA83 (big blind) collected ($0.10)
Seat 3: AAAcostA folded before Flop (didn't bet)
Seat 4: watersnow66 folded before Flop (didn't bet)
Seat 5: asaphookz folded before Flop (didn't bet)
Seat 6: sapr.549 (button) folded before Flop (didn't bet)



PokerStars Hand #222962672439:  Hold'em No Limit ($0.05/$0.10 USD) - 2021/01/23 13:05:03 ET
Table 'Polydoros II' 6-max Seat #1 is the button
Seat 1: gho3 ($4.20 in chips) 
Seat 2: Viten'kA83 ($15.48 in chips) 
Seat 3: AAAcostA ($13.69 in chips) 
Seat 4: watersnow66 ($18.89 in chips) 
Seat 5: asaphookz ($10.86 in chips) 
Seat 6: sapr.549 ($9.28 in chips) 
Viten'kA83: posts small blind $0.05
AAAcostA: posts big blind $0.10
*** HOLE CARDS ***
watersnow66: folds 
asaphookz: folds 
sapr.549: folds 
gho3: raises $0.30 to $0.40
Viten'kA83 is disconnected 
Viten'kA83 is connected 
Viten'kA83: folds 
AAAcostA: calls $0.30
*** FLOP *** [4c Qs 5d]
AAAcostA: checks 
gho3: bets $0.81
AAAcostA: calls $0.81
*** TURN *** [4c Qs 5d] [3c]
AAAcostA: checks 
gho3: bets $2.99 and is all-in
AAAcostA: calls $2.99
*** RIVER *** [4c Qs 5d 3c] [Ks]
*** SHOW DOWN ***
AAAcostA: shows [Ts Qd] (a pair of Queens)
gho3: shows [Ac As] (a pair of Aces)
gho3 collected $8.07 from pot
*** SUMMARY ***
Total pot $8.45 | Rake $0.38 
Board [4c Qs 5d 3c Ks]
Seat 1: gho3 (button) showed [Ac As] and won ($8.07) with a pair of Aces
Seat 2: Viten'kA83 (small blind) folded before Flop
Seat 3: AAAcostA (big blind) showed [Ts Qd] and lost with a pair of Queens
Seat 4: watersnow66 folded before Flop (didn't bet)
Seat 5: asaphookz folded before Flop (didn't bet)
Seat 6: sapr.549 folded before Flop (didn't bet)



PokerStars Hand #222962718627:  Hold'em No Limit ($0.05/$0.10 USD) - 2021/01/23 13:06:09 ET
Table 'Polydoros II' 6-max Seat #2 is the button
Seat 1: gho3 ($8.07 in chips) 
Seat 2: Viten'kA83 ($15.43 in chips) 
Seat 3: AAAcostA ($10 in chips) 
Seat 4: watersnow66 ($18.89 in chips) 
Seat 5: asaphookz ($10.86 in chips) 
Seat 6: sapr.549 ($9.28 in chips) 
AAAcostA: posts small blind $0.05
watersnow66: posts big blind $0.10
*** HOLE CARDS ***
asaphookz: folds 
sapr.549: raises $0.15 to $0.25
gho3: folds 
Viten'kA83: folds 
AAAcostA: folds 
watersnow66: folds 
Uncalled bet ($0.15) returned to sapr.549
sapr.549 collected $0.25 from pot
sapr.549: doesn't show hand 
*** SUMMARY ***
Total pot $0.25 | Rake $0 
Seat 1: gho3 folded before Flop (didn't bet)
Seat 2: Viten'kA83 (button) folded before Flop (didn't bet)
Seat 3: AAAcostA (small blind) folded before Flop
Seat 4: watersnow66 (big blind) folded before Flop
Seat 5: asaphookz folded before Flop (didn't bet)
Seat 6: sapr.549 collected ($0.25)



PokerStars Hand #222962725862:  Hold'em No Limit ($0.05/$0.10 USD) - 2021/01/23 13:06:20 ET
Table 'Polydoros II' 6-max Seat #3 is the button
Seat 1: gho3 ($8.07 in chips) 
Seat 2: Viten'kA83 ($15.43 in chips) 
Seat 3: AAAcostA ($10 in chips) 
Seat 4: watersnow66 ($18.79 in chips) 
Seat 5: asaphookz ($10.86 in chips) 
Seat 6: sapr.549 ($9.43 in chips) 
watersnow66: posts small blind $0.05
asaphookz: posts big blind $0.10
*** HOLE CARDS ***
sapr.549: folds 
gho3: folds 
Viten'kA83: folds 
AAAcostA: folds 
watersnow66: raises $0.20 to $0.30
asaphookz: folds 
Uncalled bet ($0.20) returned to watersnow66
watersnow66 collected $0.20 from pot
*** SUMMARY ***
Total pot $0.20 | Rake $0 
Seat 1: gho3 folded before Flop (didn't bet)
Seat 2: Viten'kA83 folded before Flop (didn't bet)
Seat 3: AAAcostA (button) folded before Flop (didn't bet)
Seat 4: watersnow66 (small blind) collected ($0.20)
Seat 5: asaphookz (big blind) folded before Flop
Seat 6: sapr.549 folded before Flop (didn't bet)



PokerStars Hand #222962738568:  Hold'em No Limit ($0.05/$0.10 USD) - 2021/01/23 13:06:38 ET
Table 'Polydoros II' 6-max Seat #4 is the button
Seat 1: gho3 ($8.07 in chips) 
Seat 2: Viten'kA83 ($15.43 in chips) 
Seat 3: AAAcostA ($10 in chips) 
Seat 4: watersnow66 ($18.89 in chips) 
Seat 5: asaphookz ($10.76 in chips) 
Seat 6: sapr.549 ($9.43 in chips) 
asaphookz: posts small blind $0.05
sapr.549: posts big blind $0.10
*** HOLE CARDS ***
gho3: folds 
Viten'kA83: folds 
AAAcostA: raises $0.20 to $0.30
watersnow66: folds 
asaphookz: folds 
sapr.549: folds 
Uncalled bet ($0.20) returned to AAAcostA
AAAcostA collected $0.25 from pot
AAAcostA: doesn't show hand 
*** SUMMARY ***
Total pot $0.25 | Rake $0 
Seat 1: gho3 folded before Flop (didn't bet)
Seat 2: Viten'kA83 folded before Flop (didn't bet)
Seat 3: AAAcostA collected ($0.25)
Seat 4: watersnow66 (button) folded before Flop (didn't bet)
Seat 5: asaphookz (small blind) folded before Flop
Seat 6: sapr.549 (big blind) folded before Flop



PokerStars Hand #222962753241:  Hold'em No Limit ($0.05/$0.10 USD) - 2021/01/23 13:07:00 ET
Table 'Polydoros II' 6-max Seat #5 is the button
Seat 1: gho3 ($8.07 in chips) 
Seat 2: Viten'kA83 ($15.43 in chips) 
Seat 3: AAAcostA ($10.15 in chips) 
Seat 4: watersnow66 ($18.89 in chips) 
Seat 5: asaphookz ($10.71 in chips) 
Seat 6: sapr.549 ($9.33 in chips) 
sapr.549: posts small blind $0.05
gho3: posts big blind $0.10
*** HOLE CARDS ***
Viten'kA83: folds 
AAAcostA: folds 
watersnow66: folds 
asaphookz: folds 
sapr.549: folds 
Uncalled bet ($0.05) returned to gho3
gho3 collected $0.10 from pot
gho3: doesn't show hand 
*** SUMMARY ***
Total pot $0.10 | Rake $0 
Seat 1: gho3 (big blind) collected ($0.10)
Seat 2: Viten'kA83 folded before Flop (didn't bet)
Seat 3: AAAcostA folded before Flop (didn't bet)
Seat 4: watersnow66 folded before Flop (didn't bet)
Seat 5: asaphookz (button) folded before Flop (didn't bet)
Seat 6: sapr.549 (small blind) folded before Flop



PokerStars Hand #222962761870:  Hold'em No Limit ($0.05/$0.10 USD) - 2021/01/23 13:07:12 ET
Table 'Polydoros II' 6-max Seat #6 is the button
Seat 1: gho3 ($8.12 in chips) 
Seat 2: Viten'kA83 ($15.43 in chips) 
Seat 3: AAAcostA ($10.15 in chips) 
Seat 4: watersnow66 ($18.89 in chips) 
Seat 5: asaphookz ($10.71 in chips) 
Seat 6: sapr.549 ($9.28 in chips) 
gho3: posts small blind $0.05
Viten'kA83: posts big blind $0.10
*** HOLE CARDS ***
AAAcostA: raises $0.20 to $0.30
watersnow66: folds 
asaphookz: calls $0.30
sapr.549: folds 
gho3: calls $0.25
Viten'kA83: folds 
*** FLOP *** [Qd Ac 9c]
gho3: checks 
AAAcostA: bets $0.29
asaphookz: calls $0.29
gho3: folds 
*** TURN *** [Qd Ac 9c] [9s]
AAAcostA: checks 
asaphookz: checks 
*** RIVER *** [Qd Ac 9c 9s] [3c]
AAAcostA: checks 
asaphookz: checks 
*** SHOW DOWN ***
AAAcostA: shows [As Jh] (two pair, Aces and Nines)
asaphookz: mucks hand 
AAAcostA collected $1.51 from pot
*** SUMMARY ***
Total pot $1.58 | Rake $0.07 
Board [Qd Ac 9c 9s 3c]
Seat 1: gho3 (small blind) folded on the Flop
Seat 2: Viten'kA83 (big blind) folded before Flop
Seat 3: AAAcostA showed [As Jh] and won ($1.51) with two pair, Aces and Nines
Seat 4: watersnow66 folded before Flop (didn't bet)
Seat 5: asaphookz mucked
Seat 6: sapr.549 (button) folded before Flop (didn't bet)



PokerStars Hand #222962788119:  Hold'em No Limit ($0.05/$0.10 USD) - 2021/01/23 13:07:50 ET
Table 'Polydoros II' 6-max Seat #1 is the button
Seat 1: gho3 ($7.82 in chips) 
Seat 2: Viten'kA83 ($15.33 in chips) 
Seat 3: AAAcostA ($11.07 in chips) 
Seat 4: watersnow66 ($18.89 in chips) 
Seat 5: asaphookz ($10.12 in chips) 
Seat 6: sapr.549 ($9.28 in chips) 
Viten'kA83: posts small blind $0.05
AAAcostA: posts big blind $0.10
*** HOLE CARDS ***
watersnow66: calls $0.10
asaphookz: folds 
sapr.549: folds 
gho3: folds 
Viten'kA83: folds 
AAAcostA: checks 
*** FLOP *** [Kc Qh 9d]
AAAcostA: checks 
watersnow66: bets $0.12
AAAcostA: folds 
Uncalled bet ($0.12) returned to watersnow66
watersnow66 collected $0.24 from pot
*** SUMMARY ***
Total pot $0.25 | Rake $0.01 
Board [Kc Qh 9d]
Seat 1: gho3 (button) folded before Flop (didn't bet)
Seat 2: Viten'kA83 (small blind) folded before Flop
Seat 3: AAAcostA (big blind) folded on the Flop
Seat 4: watersnow66 collected ($0.24)
Seat 5: asaphookz folded before Flop (didn't bet)
Seat 6: sapr.549 folded before Flop (didn't bet)



PokerStars Hand #222962805592:  Hold'em No Limit ($0.05/$0.10 USD) - 2021/01/23 13:08:16 ET
Table 'Polydoros II' 6-max Seat #2 is the button
Seat 1: gho3 ($7.82 in chips) 
Seat 2: Viten'kA83 ($15.28 in chips) 
Seat 3: AAAcostA ($10.97 in chips) 
Seat 4: watersnow66 ($19.03 in chips) 
Seat 5: asaphookz ($10.12 in chips) 
Seat 6: sapr.549 ($9.28 in chips) 
AAAcostA: posts small blind $0.05
watersnow66: posts big blind $0.10
*** HOLE CARDS ***
asaphookz: raises $0.12 to $0.22
sapr.549: folds 
gho3: folds 
Viten'kA83: calls $0.22
AAAcostA: folds 
watersnow66: folds 
*** FLOP *** [9s 9c 5s]
asaphookz: bets $0.20
Viten'kA83: calls $0.20
*** TURN *** [9s 9c 5s] [8c]
asaphookz: bets $0.31
Viten'kA83: calls $0.31
*** RIVER *** [9s 9c 5s 8c] [8d]
asaphookz: bets $0.55
Viten'kA83: folds 
Uncalled bet ($0.55) returned to asaphookz
asaphookz collected $1.54 from pot
*** SUMMARY ***
Total pot $1.61 | Rake $0.07 
Board [9s 9c 5s 8c 8d]
Seat 1: gho3 folded before Flop (didn't bet)
Seat 2: Viten'kA83 (button) folded on the River
Seat 3: AAAcostA (small blind) folded before Flop
Seat 4: watersnow66 (big blind) folded before Flop
Seat 5: asaphookz collected ($1.54)
Seat 6: sapr.549 folded before Flop (didn't bet)



PokerStars Hand #222962832800:  Hold'em No Limit ($0.05/$0.10 USD) - 2021/01/23 13:08:55 ET
Table 'Polydoros II' 6-max Seat #3 is the button
Seat 1: gho3 ($7.82 in chips) 
Seat 2: Viten'kA83 ($14.55 in chips) 
Seat 3: AAAcostA ($10.92 in chips) 
Seat 4: watersnow66 ($18.93 in chips) 
Seat 5: asaphookz ($10.93 in chips) 
Seat 6: sapr.549 ($9.28 in chips) 
watersnow66: posts small blind $0.05
asaphookz: posts big blind $0.10
*** HOLE CARDS ***
sapr.549: folds 
gho3: folds 
Viten'kA83: folds 
AAAcostA: folds 
watersnow66: folds 
Uncalled bet ($0.05) returned to asaphookz
asaphookz collected $0.10 from pot
*** SUMMARY ***
Total pot $0.10 | Rake $0 
Seat 1: gho3 folded before Flop (didn't bet)
Seat 2: Viten'kA83 folded before Flop (didn't bet)
Seat 3: AAAcostA (button) folded before Flop (didn't bet)
Seat 4: watersnow66 (small blind) folded before Flop
Seat 5: asaphookz (big blind) collected ($0.10)
Seat 6: sapr.549 folded before Flop (didn't bet)



PokerStars Hand #222962837996:  Hold'em No Limit ($0.05/$0.10 USD) - 2021/01/23 13:09:03 ET
Table 'Polydoros II' 6-max Seat #4 is the button
Seat 1: gho3 ($7.82 in chips) 
Seat 2: Viten'kA83 ($14.55 in chips) 
Seat 3: AAAcostA ($10.92 in chips) 
Seat 4: watersnow66 ($18.88 in chips) 
Seat 5: asaphookz ($10.98 in chips) 
Seat 6: sapr.549 ($9.28 in chips) 
asaphookz: posts small blind $0.05
sapr.549: posts big blind $0.10
*** HOLE CARDS ***
gho3: folds 
Viten'kA83: folds 
AAAcostA: folds 
watersnow66: raises $0.20 to $0.30
asaphookz: folds 
sapr.549: folds 
Uncalled bet ($0.20) returned to watersnow66
watersnow66 collected $0.25 from pot
*** SUMMARY ***
Total pot $0.25 | Rake $0 
Seat 1: gho3 folded before Flop (didn't bet)
Seat 2: Viten'kA83 folded before Flop (didn't bet)
Seat 3: AAAcostA folded before Flop (didn't bet)
Seat 4: watersnow66 (button) collected ($0.25)
Seat 5: asaphookz (small blind) folded before Flop
Seat 6: sapr.549 (big blind) folded before Flop



PokerStars Hand #222962850229:  Hold'em No Limit ($0.05/$0.10 USD) - 2021/01/23 13:09:20 ET
Table 'Polydoros II' 6-max Seat #5 is the button
Seat 1: gho3 ($7.82 in chips) 
Seat 2: Viten'kA83 ($14.55 in chips) 
Seat 3: AAAcostA ($10.92 in chips) 
Seat 4: watersnow66 ($19.03 in chips) 
Seat 5: asaphookz ($10.93 in chips) 
Seat 6: sapr.549 ($9.18 in chips) 
sapr.549: posts small blind $0.05
gho3: posts big blind $0.10
*** HOLE CARDS ***
Viten'kA83: folds 
AAAcostA: folds 
watersnow66: folds 
asaphookz: folds 
sapr.549: raises $0.15 to $0.25
gho3: folds 
Uncalled bet ($0.15) returned to sapr.549
sapr.549 collected $0.20 from pot
sapr.549: doesn't show hand 
*** SUMMARY ***
Total pot $0.20 | Rake $0 
Seat 1: gho3 (big blind) folded before Flop
Seat 2: Viten'kA83 folded before Flop (didn't bet)
Seat 3: AAAcostA folded before Flop (didn't bet)
Seat 4: watersnow66 folded before Flop (didn't bet)
Seat 5: asaphookz (button) folded before Flop (didn't bet)
Seat 6: sapr.549 (small blind) collected ($0.20)



PokerStars Hand #222962866656:  Hold'em No Limit ($0.05/$0.10 USD) - 2021/01/23 13:09:44 ET
Table 'Polydoros II' 6-max Seat #6 is the button
Seat 1: gho3 ($7.72 in chips) 
Seat 3: AAAcostA ($10.92 in chips) 
Seat 4: watersnow66 ($19.03 in chips) 
Seat 5: asaphookz ($10.93 in chips) 
Seat 6: sapr.549 ($9.28 in chips) 
gho3: posts small blind $0.05
Viten'kA83: is sitting out 
Viten'kA83 leaves the table
AAAcostA: posts big blind $0.10
*** HOLE CARDS ***
Lisa86x52 joins the table at seat #2 
watersnow66: calls $0.10
asaphookz: folds 
sapr.549: raises $0.15 to $0.25
gho3: folds 
AAAcostA: folds 
watersnow66: calls $0.15
*** FLOP *** [4d 9h 2c]
watersnow66: checks 
sapr.549: bets $0.26
watersnow66: folds 
Uncalled bet ($0.26) returned to sapr.549
sapr.549 collected $0.62 from pot
sapr.549: doesn't show hand 
*** SUMMARY ***
Total pot $0.65 | Rake $0.03 
Board [4d 9h 2c]
Seat 1: gho3 (small blind) folded before Flop
Seat 3: AAAcostA (big blind) folded before Flop
Seat 4: watersnow66 folded on the Flop
Seat 5: asaphookz folded before Flop (didn't bet)
Seat 6: sapr.549 (button) collected ($0.62)



PokerStars Hand #222962882508:  Hold'em No Limit ($0.05/$0.10 USD) - 2021/01/23 13:10:08 ET
Table 'Polydoros II' 6-max Seat #1 is the button
Seat 1: gho3 ($7.67 in chips) 
Seat 3: AAAcostA ($10.82 in chips) 
Seat 4: watersnow66 ($18.78 in chips) 
Seat 5: asaphookz ($10.93 in chips) 
Seat 6: sapr.549 ($9.65 in chips) 
AAAcostA: posts small blind $0.05
watersnow66: posts big blind $0.10
*** HOLE CARDS ***
asaphookz: folds 
sapr.549: folds 
Lisa86x52 leaves the table
ramseskat joins the table at seat #2 
gho3: folds 
AAAcostA: folds 
Uncalled bet ($0.05) returned to watersnow66
watersnow66 collected $0.10 from pot
*** SUMMARY ***
Total pot $0.10 | Rake $0 
Seat 1: gho3 (button) folded before Flop (didn't bet)
Seat 3: AAAcostA (small blind) folded before Flop
Seat 4: watersnow66 (big blind) collected ($0.10)
Seat 5: asaphookz folded before Flop (didn't bet)
Seat 6: sapr.549 folded before Flop (didn't bet)



PokerStars Hand #222962892784:  Hold'em No Limit ($0.05/$0.10 USD) - 2021/01/23 13:10:23 ET
Table 'Polydoros II' 6-max Seat #3 is the button
Seat 1: gho3 ($7.67 in chips) 
Seat 3: AAAcostA ($10.77 in chips) 
Seat 4: watersnow66 ($18.83 in chips) 
Seat 5: asaphookz ($10.93 in chips) 
Seat 6: sapr.549 ($9.65 in chips) 
watersnow66: posts small blind $0.05
asaphookz: posts big blind $0.10
ramseskat: sits out 
*** HOLE CARDS ***
sapr.549: raises $0.15 to $0.25
gho3: folds 
AAAcostA: folds 
watersnow66: folds 
asaphookz: folds 
Uncalled bet ($0.15) returned to sapr.549
sapr.549 collected $0.25 from pot
sapr.549: doesn't show hand 
*** SUMMARY ***
Total pot $0.25 | Rake $0 
Seat 1: gho3 folded before Flop (didn't bet)
Seat 3: AAAcostA (button) folded before Flop (didn't bet)
Seat 4: watersnow66 (small blind) folded before Flop
Seat 5: asaphookz (big blind) folded before Flop
Seat 6: sapr.549 collected ($0.25)



PokerStars Hand #222962902062:  Hold'em No Limit ($0.05/$0.10 USD) - 2021/01/23 13:10:36 ET
Table 'Polydoros II' 6-max Seat #4 is the button
Seat 1: gho3 ($7.67 in chips) 
Seat 3: AAAcostA ($10.77 in chips) 
Seat 4: watersnow66 ($18.78 in chips) 
Seat 5: asaphookz ($10.83 in chips) 
Seat 6: sapr.549 ($9.80 in chips) 
asaphookz: posts small blind $0.05
sapr.549: posts big blind $0.10
ramseskat: sits out 
*** HOLE CARDS ***
gho3: folds 
AAAcostA: raises $0.20 to $0.30
watersnow66: folds 
asaphookz: folds 
sapr.549: folds 
Uncalled bet ($0.20) returned to AAAcostA
AAAcostA collected $0.25 from pot
*** SUMMARY ***
Total pot $0.25 | Rake $0 
Seat 1: gho3 folded before Flop (didn't bet)
Seat 3: AAAcostA collected ($0.25)
Seat 4: watersnow66 (button) folded before Flop (didn't bet)
Seat 5: asaphookz (small blind) folded before Flop
Seat 6: sapr.549 (big blind) folded before Flop



PokerStars Hand #222962913451:  Hold'em No Limit ($0.05/$0.10 USD) - 2021/01/23 13:10:53 ET
Table 'Polydoros II' 6-max Seat #5 is the button
Seat 1: gho3 ($7.67 in chips) 
Seat 3: AAAcostA ($10.92 in chips) 
Seat 4: watersnow66 ($18.78 in chips) 
Seat 5: asaphookz ($10.78 in chips) 
Seat 6: sapr.549 ($9.70 in chips) 
sapr.549: posts small blind $0.05
gho3: posts big blind $0.10
ramseskat: sits out 
*** HOLE CARDS ***
AAAcostA: folds 
watersnow66: folds 
asaphookz: folds 
sapr.549: folds 
Uncalled bet ($0.05) returned to gho3
gho3 collected $0.10 from pot
gho3: doesn't show hand 
*** SUMMARY ***
Total pot $0.10 | Rake $0 
Seat 1: gho3 (big blind) collected ($0.10)
Seat 3: AAAcostA folded before Flop (didn't bet)
Seat 4: watersnow66 folded before Flop (didn't bet)
Seat 5: asaphookz (button) folded before Flop (didn't bet)
Seat 6: sapr.549 (small blind) folded before Flop



PokerStars Hand #222962927088:  Hold'em No Limit ($0.05/$0.10 USD) - 2021/01/23 13:11:13 ET
Table 'Polydoros II' 6-max Seat #6 is the button
Seat 1: gho3 ($7.72 in chips) 
Seat 2: ramseskat ($10 in chips) 
Seat 3: AAAcostA ($10.92 in chips) 
Seat 4: watersnow66 ($18.78 in chips) 
Seat 5: asaphookz ($10.78 in chips) 
Seat 6: sapr.549 ($9.65 in chips) 
gho3: posts small blind $0.05
ramseskat: posts big blind $0.10
*** HOLE CARDS ***
AAAcostA: folds 
watersnow66: calls $0.10
asaphookz: folds 
sapr.549: folds 
gho3: folds 
ramseskat: checks 
*** FLOP *** [3h 8c Qs]
ramseskat: checks 
watersnow66: checks 
*** TURN *** [3h 8c Qs] [8h]
ramseskat: checks 
watersnow66: bets $0.12
ramseskat: folds 
Uncalled bet ($0.12) returned to watersnow66
watersnow66 collected $0.24 from pot
*** SUMMARY ***
Total pot $0.25 | Rake $0.01 
Board [3h 8c Qs 8h]
Seat 1: gho3 (small blind) folded before Flop
Seat 2: ramseskat (big blind) folded on the Turn
Seat 3: AAAcostA folded before Flop (didn't bet)
Seat 4: watersnow66 collected ($0.24)
Seat 5: asaphookz folded before Flop (didn't bet)
Seat 6: sapr.549 (button) folded before Flop (didn't bet)



PokerStars Hand #222962952742:  Hold'em No Limit ($0.05/$0.10 USD) - 2021/01/23 13:11:50 ET
Table 'Polydoros II' 6-max Seat #1 is the button
Seat 1: gho3 ($7.67 in chips) 
Seat 2: ramseskat ($10 in chips) 
Seat 3: AAAcostA ($10.92 in chips) 
Seat 4: watersnow66 ($18.92 in chips) 
Seat 5: asaphookz ($10.78 in chips) 
Seat 6: sapr.549 ($9.65 in chips) 
ramseskat: posts small blind $0.05
AAAcostA: posts big blind $0.10
*** HOLE CARDS ***
watersnow66: folds 
asaphookz: folds 
sapr.549: folds 
gho3: folds 
ramseskat: folds 
Uncalled bet ($0.05) returned to AAAcostA
AAAcostA collected $0.10 from pot
*** SUMMARY ***
Total pot $0.10 | Rake $0 
Seat 1: gho3 (button) folded before Flop (didn't bet)
Seat 2: ramseskat (small blind) folded before Flop
Seat 3: AAAcostA (big blind) collected ($0.10)
Seat 4: watersnow66 folded before Flop (didn't bet)
Seat 5: asaphookz folded before Flop (didn't bet)
Seat 6: sapr.549 folded before Flop (didn't bet)



PokerStars Hand #222962963452:  Hold'em No Limit ($0.05/$0.10 USD) - 2021/01/23 13:12:06 ET
Table 'Polydoros II' 6-max Seat #2 is the button
Seat 1: gho3 ($7.67 in chips) 
Seat 2: ramseskat ($10 in chips) 
Seat 3: AAAcostA ($10.97 in chips) 
Seat 4: watersnow66 ($18.92 in chips) 
Seat 5: asaphookz ($10.78 in chips) 
Seat 6: sapr.549 ($9.65 in chips) 
AAAcostA: posts small blind $0.05
watersnow66: posts big blind $0.10
*** HOLE CARDS ***
asaphookz: raises $0.12 to $0.22
sapr.549: calls $0.22
gho3: folds 
ramseskat: calls $0.22
AAAcostA: calls $0.17
watersnow66: calls $0.12
*** FLOP *** [3h 6c As]
AAAcostA: checks 
watersnow66: checks 
asaphookz: checks 
sapr.549: checks 
ramseskat: checks 
*** TURN *** [3h 6c As] [8d]
AAAcostA: bets $0.79
watersnow66: folds 
asaphookz: calls $0.79
sapr.549: folds 
ramseskat: folds 
*** RIVER *** [3h 6c As 8d] [2c]
AAAcostA: bets $3.84
asaphookz: calls $3.84
*** SHOW DOWN ***
AAAcostA: shows [3d 3c] (three of a kind, Threes)
asaphookz: mucks hand 
AAAcostA collected $9.89 from pot
*** SUMMARY ***
Total pot $10.36 | Rake $0.47 
Board [3h 6c As 8d 2c]
Seat 1: gho3 folded before Flop (didn't bet)
Seat 2: ramseskat (button) folded on the Turn
Seat 3: AAAcostA (small blind) showed [3d 3c] and won ($9.89) with three of a kind, Threes
Seat 4: watersnow66 (big blind) folded on the Turn
Seat 5: asaphookz mucked
Seat 6: sapr.549 folded on the Turn



PokerStars Hand #222962997778:  Hold'em No Limit ($0.05/$0.10 USD) - 2021/01/23 13:12:56 ET
Table 'Polydoros II' 6-max Seat #3 is the button
Seat 1: gho3 ($7.67 in chips) 
Seat 2: ramseskat ($10 in chips) 
Seat 3: AAAcostA ($16.01 in chips) 
Seat 4: watersnow66 ($18.70 in chips) 
Seat 5: asaphookz ($5.93 in chips) 
Seat 6: sapr.549 ($9.43 in chips) 
watersnow66: posts small blind $0.05
asaphookz: posts big blind $0.10
*** HOLE CARDS ***
sapr.549: folds 
gho3: folds 
ramseskat: folds 
AAAcostA: folds 
watersnow66: calls $0.05
asaphookz: checks 
*** FLOP *** [Kh 6c 4s]
watersnow66: checks 
asaphookz: checks 
*** TURN *** [Kh 6c 4s] [7s]
watersnow66: checks 
asaphookz: checks 
*** RIVER *** [Kh 6c 4s 7s] [Qs]
watersnow66: bets $0.10
asaphookz: calls $0.10
*** SHOW DOWN ***
watersnow66: shows [Td Qc] (a pair of Queens)
asaphookz: mucks hand 
watersnow66 collected $0.38 from pot
*** SUMMARY ***
Total pot $0.40 | Rake $0.02 
Board [Kh 6c 4s 7s Qs]
Seat 1: gho3 folded before Flop (didn't bet)
Seat 2: ramseskat folded before Flop (didn't bet)
Seat 3: AAAcostA (button) folded before Flop (didn't bet)
Seat 4: watersnow66 (small blind) showed [Td Qc] and won ($0.38) with a pair of Queens
Seat 5: asaphookz (big blind) mucked
Seat 6: sapr.549 folded before Flop (didn't bet)



PokerStars Hand #222963020086:  Hold'em No Limit ($0.05/$0.10 USD) - 2021/01/23 13:13:28 ET
Table 'Polydoros II' 6-max Seat #4 is the button
Seat 1: gho3 ($7.67 in chips) 
Seat 2: ramseskat ($10 in chips) 
Seat 3: AAAcostA ($16.01 in chips) 
Seat 4: watersnow66 ($18.88 in chips) 
Seat 5: asaphookz ($9.73 in chips) 
Seat 6: sapr.549 ($9.43 in chips) 
asaphookz: posts small blind $0.05
sapr.549: posts big blind $0.10
*** HOLE CARDS ***
gho3: folds 
ramseskat: folds 
AAAcostA: folds 
watersnow66: folds 
asaphookz: folds 
Uncalled bet ($0.05) returned to sapr.549
sapr.549 collected $0.10 from pot
sapr.549: doesn't show hand 
*** SUMMARY ***
Total pot $0.10 | Rake $0 
Seat 1: gho3 folded before Flop (didn't bet)
Seat 2: ramseskat folded before Flop (didn't bet)
Seat 3: AAAcostA folded before Flop (didn't bet)
Seat 4: watersnow66 (button) folded before Flop (didn't bet)
Seat 5: asaphookz (small blind) folded before Flop
Seat 6: sapr.549 (big blind) collected ($0.10)



PokerStars Hand #222963034546:  Hold'em No Limit ($0.05/$0.10 USD) - 2021/01/23 13:13:50 ET
Table 'Polydoros II' 6-max Seat #5 is the button
Seat 1: gho3 ($7.67 in chips) 
Seat 2: ramseskat ($10 in chips) 
Seat 3: AAAcostA ($16.01 in chips) 
Seat 4: watersnow66 ($18.88 in chips) 
Seat 5: asaphookz ($9.68 in chips) 
Seat 6: sapr.549 ($9.48 in chips) 
sapr.549: posts small blind $0.05
gho3: posts big blind $0.10
*** HOLE CARDS ***
ramseskat: folds 
AAAcostA: folds 
watersnow66: folds 
asaphookz: raises $0.12 to $0.22
sapr.549: folds 
gho3: calls $0.12
*** FLOP *** [Kd Th 4s]
gho3: checks 
asaphookz: checks 
*** TURN *** [Kd Th 4s] [8s]
gho3: checks 
asaphookz: bets $0.16
gho3: calls $0.16
*** RIVER *** [Kd Th 4s 8s] [7s]
gho3: checks 
asaphookz: bets $1.40
gho3: folds 
Uncalled bet ($1.40) returned to asaphookz
asaphookz collected $0.77 from pot
*** SUMMARY ***
Total pot $0.81 | Rake $0.04 
Board [Kd Th 4s 8s 7s]
Seat 1: gho3 (big blind) folded on the River
Seat 2: ramseskat folded before Flop (didn't bet)
Seat 3: AAAcostA folded before Flop (didn't bet)
Seat 4: watersnow66 folded before Flop (didn't bet)
Seat 5: asaphookz (button) collected ($0.77)
Seat 6: sapr.549 (small blind) folded before Flop



PokerStars Hand #222963059553:  Hold'em No Limit ($0.05/$0.10 USD) - 2021/01/23 13:14:27 ET
Table 'Polydoros II' 6-max Seat #6 is the button
Seat 1: gho3 ($7.29 in chips) 
Seat 2: ramseskat ($10 in chips) 
Seat 3: AAAcostA ($16.01 in chips) 
Seat 4: watersnow66 ($18.88 in chips) 
Seat 5: asaphookz ($10.07 in chips) 
Seat 6: sapr.549 ($9.43 in chips) 
gho3: posts small blind $0.05
ramseskat: posts big blind $0.10
*** HOLE CARDS ***
AAAcostA: folds 
watersnow66: folds 
asaphookz: folds 
sapr.549: folds 
gho3: folds 
Uncalled bet ($0.05) returned to ramseskat
ramseskat collected $0.10 from pot
ramseskat: doesn't show hand 
*** SUMMARY ***
Total pot $0.10 | Rake $0 
Seat 1: gho3 (small blind) folded before Flop
Seat 2: ramseskat (big blind) collected ($0.10)
Seat 3: AAAcostA folded before Flop (didn't bet)
Seat 4: watersnow66 folded before Flop (didn't bet)
Seat 5: asaphookz folded before Flop (didn't bet)
Seat 6: sapr.549 (button) folded before Flop (didn't bet)



PokerStars Hand #222963070617:  Hold'em No Limit ($0.05/$0.10 USD) - 2021/01/23 13:14:43 ET
Table 'Polydoros II' 6-max Seat #2 is the button
Seat 2: ramseskat ($10.05 in chips) 
Seat 3: AAAcostA ($16.01 in chips) 
Seat 4: watersnow66 ($18.88 in chips) 
Seat 5: asaphookz ($10.07 in chips) 
Seat 6: sapr.549 ($9.43 in chips) 
AAAcostA: posts small blind $0.05
watersnow66: posts big blind $0.10
*** HOLE CARDS ***
asaphookz: folds 
gho3 leaves the table
sapr.549: folds 
ramseskat: folds 
AAAcostA: folds 
Uncalled bet ($0.05) returned to watersnow66
watersnow66 collected $0.10 from pot
*** SUMMARY ***
Total pot $0.10 | Rake $0 
Seat 2: ramseskat (button) folded before Flop (didn't bet)
Seat 3: AAAcostA (small blind) folded before Flop
Seat 4: watersnow66 (big blind) collected ($0.10)
Seat 5: asaphookz folded before Flop (didn't bet)
Seat 6: sapr.549 folded before Flop (didn't bet)



PokerStars Hand #222963078219:  Hold'em No Limit ($0.05/$0.10 USD) - 2021/01/23 13:14:54 ET
Table 'Polydoros II' 6-max Seat #3 is the button
Seat 2: ramseskat ($10.05 in chips) 
Seat 3: AAAcostA ($15.96 in chips) 
Seat 4: watersnow66 ($18.93 in chips) 
Seat 5: asaphookz ($10.07 in chips) 
Seat 6: sapr.549 ($9.43 in chips) 
watersnow66: posts small blind $0.05
asaphookz: posts big blind $0.10
*** HOLE CARDS ***
sapr.549: folds 
ramseskat: folds 
AAAcostA: folds 
watersnow66: calls $0.05
asaphookz: raises $0.25 to $0.35
watersnow66: folds 
Uncalled bet ($0.25) returned to asaphookz
asaphookz collected $0.20 from pot
*** SUMMARY ***
Total pot $0.20 | Rake $0 
Seat 2: ramseskat folded before Flop (didn't bet)
Seat 3: AAAcostA (button) folded before Flop (didn't bet)
Seat 4: watersnow66 (small blind) folded before Flop
Seat 5: asaphookz (big blind) collected ($0.20)
Seat 6: sapr.549 folded before Flop (didn't bet)



PokerStars Hand #222963095858:  Hold'em No Limit ($0.05/$0.10 USD) - 2021/01/23 13:15:07 ET
Table 'Polydoros II' 6-max Seat #4 is the button
Seat 2: ramseskat ($10.05 in chips) 
Seat 3: AAAcostA ($15.96 in chips) 
Seat 4: watersnow66 ($18.83 in chips) 
Seat 5: asaphookz ($10.17 in chips) 
Seat 6: sapr.549 ($9.43 in chips) 
asaphookz: posts small blind $0.05
sapr.549: posts big blind $0.10
*** HOLE CARDS ***
ramseskat: folds 
AAAcostA: raises $0.20 to $0.30
watersnow66: folds 
asaphookz: folds 
sapr.549: folds 
Uncalled bet ($0.20) returned to AAAcostA
AAAcostA collected $0.25 from pot
AAAcostA: doesn't show hand 
*** SUMMARY ***
Total pot $0.25 | Rake $0 
Seat 2: ramseskat folded before Flop (didn't bet)
Seat 3: AAAcostA collected ($0.25)
Seat 4: watersnow66 (button) folded before Flop (didn't bet)
Seat 5: asaphookz (small blind) folded before Flop
Seat 6: sapr.549 (big blind) folded before Flop



PokerStars Hand #222963105152:  Hold'em No Limit ($0.05/$0.10 USD) - 2021/01/23 13:15:19 ET
Table 'Polydoros II' 6-max Seat #5 is the button
Seat 2: ramseskat ($10.05 in chips) 
Seat 3: AAAcostA ($16.11 in chips) 
Seat 4: watersnow66 ($18.83 in chips) 
Seat 5: asaphookz ($10.12 in chips) 
Seat 6: sapr.549 ($9.33 in chips) 
sapr.549: posts small blind $0.05
ramseskat: posts big blind $0.10
*** HOLE CARDS ***
AAAcostA: folds 
watersnow66: folds 
Viten'kA83 joins the table at seat #1 
asaphookz: raises $0.12 to $0.22
sapr.549: folds 
ramseskat: folds 
Uncalled bet ($0.12) returned to asaphookz
asaphookz collected $0.25 from pot
*** SUMMARY ***
Total pot $0.25 | Rake $0 
Seat 2: ramseskat (big blind) folded before Flop
Seat 3: AAAcostA folded before Flop (didn't bet)
Seat 4: watersnow66 folded before Flop (didn't bet)
Seat 5: asaphookz (button) collected ($0.25)
Seat 6: sapr.549 (small blind) folded before Flop



PokerStars Hand #222963118393:  Hold'em No Limit ($0.05/$0.10 USD) - 2021/01/23 13:15:37 ET
Table 'Polydoros II' 6-max Seat #6 is the button
Seat 2: ramseskat ($10 in chips) 
Seat 3: AAAcostA ($16.11 in chips) 
Seat 4: watersnow66 ($18.83 in chips) 
Seat 5: asaphookz ($10.27 in chips) 
Seat 6: sapr.549 ($9.28 in chips) 
ramseskat: posts small blind $0.05
AAAcostA: posts big blind $0.10
*** HOLE CARDS ***
watersnow66: folds 
asaphookz: folds 
sapr.549: folds 
ramseskat: folds 
Uncalled bet ($0.05) returned to AAAcostA
AAAcostA collected $0.10 from pot
AAAcostA: doesn't show hand 
*** SUMMARY ***
Total pot $0.10 | Rake $0 
Seat 2: ramseskat (small blind) folded before Flop
Seat 3: AAAcostA (big blind) collected ($0.10)
Seat 4: watersnow66 folded before Flop (didn't bet)
Seat 5: asaphookz folded before Flop (didn't bet)
Seat 6: sapr.549 (button) folded before Flop (didn't bet)



PokerStars Hand #222963125115:  Hold'em No Limit ($0.05/$0.10 USD) - 2021/01/23 13:15:46 ET
Table 'Polydoros II' 6-max Seat #2 is the button
Seat 2: ramseskat ($10 in chips) 
Seat 3: AAAcostA ($16.16 in chips) 
Seat 4: watersnow66 ($18.83 in chips) 
Seat 5: asaphookz ($10.27 in chips) 
Seat 6: sapr.549 ($9.28 in chips) 
AAAcostA: posts small blind $0.05
watersnow66: posts big blind $0.10
Viten'kA83: sits out 
*** HOLE CARDS ***
asaphookz: folds 
sapr.549: folds 
ramseskat: raises $0.20 to $0.30
AAAcostA: folds 
watersnow66: folds 
Uncalled bet ($0.20) returned to ramseskat
ramseskat collected $0.25 from pot
ramseskat: doesn't show hand 
*** SUMMARY ***
Total pot $0.25 | Rake $0 
Seat 2: ramseskat (button) collected ($0.25)
Seat 3: AAAcostA (small blind) folded before Flop
Seat 4: watersnow66 (big blind) folded before Flop
Seat 5: asaphookz folded before Flop (didn't bet)
Seat 6: sapr.549 folded before Flop (didn't bet)



PokerStars Hand #222963132998:  Hold'em No Limit ($0.05/$0.10 USD) - 2021/01/23 13:15:57 ET
Table 'Polydoros II' 6-max Seat #3 is the button
Seat 2: ramseskat ($10.15 in chips) 
Seat 3: AAAcostA ($16.11 in chips) 
Seat 4: watersnow66 ($18.73 in chips) 
Seat 5: asaphookz ($10.27 in chips) 
Seat 6: sapr.549 ($9.28 in chips) 
watersnow66: posts small blind $0.05
asaphookz: posts big blind $0.10
Viten'kA83: sits out 
*** HOLE CARDS ***
sapr.549: folds 
ramseskat: folds 
AAAcostA: folds 
watersnow66: folds 
Uncalled bet ($0.05) returned to asaphookz
asaphookz collected $0.10 from pot
*** SUMMARY ***
Total pot $0.10 | Rake $0 
Seat 2: ramseskat folded before Flop (didn't bet)
Seat 3: AAAcostA (button) folded before Flop (didn't bet)
Seat 4: watersnow66 (small blind) folded before Flop
Seat 5: asaphookz (big blind) collected ($0.10)
Seat 6: sapr.549 folded before Flop (didn't bet)



PokerStars Hand #222963141109:  Hold'em No Limit ($0.05/$0.10 USD) - 2021/01/23 13:16:08 ET
Table 'Polydoros II' 6-max Seat #4 is the button
Seat 2: ramseskat ($10.15 in chips) 
Seat 3: AAAcostA ($16.11 in chips) 
Seat 4: watersnow66 ($18.68 in chips) 
Seat 5: asaphookz ($10.32 in chips) 
Seat 6: sapr.549 ($9.28 in chips) 
asaphookz: posts small blind $0.05
sapr.549: posts big blind $0.10
Viten'kA83: sits out 
*** HOLE CARDS ***
ramseskat: folds 
AAAcostA: folds 
watersnow66: folds 
asaphookz: folds 
Uncalled bet ($0.05) returned to sapr.549
sapr.549 collected $0.10 from pot
sapr.549: doesn't show hand 
*** SUMMARY ***
Total pot $0.10 | Rake $0 
Seat 2: ramseskat folded before Flop (didn't bet)
Seat 3: AAAcostA folded before Flop (didn't bet)
Seat 4: watersnow66 (button) folded before Flop (didn't bet)
Seat 5: asaphookz (small blind) folded before Flop
Seat 6: sapr.549 (big blind) collected ($0.10)



PokerStars Hand #222963150326:  Hold'em No Limit ($0.05/$0.10 USD) - 2021/01/23 13:16:20 ET
Table 'Polydoros II' 6-max Seat #5 is the button
Seat 1: Viten'kA83 ($14.55 in chips) 
Seat 2: ramseskat ($10.15 in chips) 
Seat 3: AAAcostA ($16.11 in chips) 
Seat 4: watersnow66 ($18.68 in chips) 
Seat 5: asaphookz ($10.27 in chips) 
Seat 6: sapr.549 ($9.33 in chips) 
sapr.549: posts small blind $0.05
Viten'kA83: posts big blind $0.10
*** HOLE CARDS ***
ramseskat: folds 
AAAcostA: folds 
watersnow66: calls $0.10
asaphookz: folds 
sapr.549: folds 
Viten'kA83: checks 
*** FLOP *** [8c Js Qd]
Viten'kA83: checks 
watersnow66: checks 
*** TURN *** [8c Js Qd] [As]
Viten'kA83: checks 
watersnow66: checks 
*** RIVER *** [8c Js Qd As] [4c]
Viten'kA83: checks 
watersnow66: checks 
*** SHOW DOWN ***
Viten'kA83: shows [Th 7d] (high card Ace)
watersnow66: shows [5s 5c] (a pair of Fives)
watersnow66 collected $0.24 from pot
*** SUMMARY ***
Total pot $0.25 | Rake $0.01 
Board [8c Js Qd As 4c]
Seat 1: Viten'kA83 (big blind) showed [Th 7d] and lost with high card Ace
Seat 2: ramseskat folded before Flop (didn't bet)
Seat 3: AAAcostA folded before Flop (didn't bet)
Seat 4: watersnow66 showed [5s 5c] and won ($0.24) with a pair of Fives
Seat 5: asaphookz (button) folded before Flop (didn't bet)
Seat 6: sapr.549 (small blind) folded before Flop



PokerStars Hand #222963202574:  Hold'em No Limit ($0.05/$0.10 USD) - 2021/01/23 13:17:20 ET
Table 'Polydoros II' 6-max Seat #6 is the button
Seat 1: Viten'kA83 ($14.45 in chips) 
Seat 2: ramseskat ($10.15 in chips) 
Seat 3: AAAcostA ($16.11 in chips) 
Seat 4: watersnow66 ($18.82 in chips) 
Seat 5: asaphookz ($10.27 in chips) 
Seat 6: sapr.549 ($9.28 in chips) 
Viten'kA83: posts small blind $0.05
ramseskat: posts big blind $0.10
*** HOLE CARDS ***
AAAcostA: folds 
watersnow66: calls $0.10
asaphookz: folds 
sapr.549: folds 
Viten'kA83: raises $0.40 to $0.50
ramseskat: folds 
watersnow66: calls $0.40
*** FLOP *** [6h 3d 4c]
Viten'kA83: checks 
watersnow66: checks 
*** TURN *** [6h 3d 4c] [4d]
Viten'kA83: checks 
watersnow66: checks 
*** RIVER *** [6h 3d 4c 4d] [6c]
Viten'kA83: checks 
watersnow66: checks 
*** SHOW DOWN ***
Viten'kA83: shows [Kc Ad] (two pair, Sixes and Fours)
watersnow66: shows [Kh Ac] (two pair, Sixes and Fours)
Viten'kA83 collected $0.53 from pot
watersnow66 collected $0.52 from pot
*** SUMMARY ***
Total pot $1.10 | Rake $0.05 
Board [6h 3d 4c 4d 6c]
Seat 1: Viten'kA83 (small blind) showed [Kc Ad] and won ($0.53) with two pair, Sixes and Fours
Seat 2: ramseskat (big blind) folded before Flop
Seat 3: AAAcostA folded before Flop (didn't bet)
Seat 4: watersnow66 showed [Kh Ac] and won ($0.52) with two pair, Sixes and Fours
Seat 5: asaphookz folded before Flop (didn't bet)
Seat 6: sapr.549 (button) folded before Flop (didn't bet)



PokerStars Hand #222963250351:  Hold'em No Limit ($0.05/$0.10 USD) - 2021/01/23 13:18:24 ET
Table 'Polydoros II' 6-max Seat #1 is the button
Seat 1: Viten'kA83 ($14.48 in chips) 
Seat 2: ramseskat ($10.05 in chips) 
Seat 3: AAAcostA ($16.11 in chips) 
Seat 4: watersnow66 ($18.84 in chips) 
Seat 5: asaphookz ($10.27 in chips) 
Seat 6: sapr.549 ($9.28 in chips) 
ramseskat: posts small blind $0.05
AAAcostA: posts big blind $0.10
*** HOLE CARDS ***
watersnow66: calls $0.10
asaphookz: folds 
sapr.549: folds 
Viten'kA83: folds 
ramseskat: raises $0.30 to $0.40
AAAcostA: folds 
watersnow66: calls $0.30
*** FLOP *** [6s 2d 9h]
ramseskat: bets $0.55
watersnow66: folds 
Uncalled bet ($0.55) returned to ramseskat
ramseskat collected $0.86 from pot
ramseskat: doesn't show hand 
*** SUMMARY ***
Total pot $0.90 | Rake $0.04 
Board [6s 2d 9h]
Seat 1: Viten'kA83 (button) folded before Flop (didn't bet)
Seat 2: ramseskat (small blind) collected ($0.86)
Seat 3: AAAcostA (big blind) folded before Flop
Seat 4: watersnow66 folded on the Flop
Seat 5: asaphookz folded before Flop (didn't bet)
Seat 6: sapr.549 folded before Flop (didn't bet)



PokerStars Hand #222963272725:  Hold'em No Limit ($0.05/$0.10 USD) - 2021/01/23 13:18:54 ET
Table 'Polydoros II' 6-max Seat #2 is the button
Seat 1: Viten'kA83 ($14.48 in chips) 
Seat 2: ramseskat ($10.51 in chips) 
Seat 3: AAAcostA ($16.01 in chips) 
Seat 4: watersnow66 ($18.44 in chips) 
Seat 5: asaphookz ($10.27 in chips) 
Seat 6: sapr.549 ($9.28 in chips) 
AAAcostA: posts small blind $0.05
watersnow66: posts big blind $0.10
*** HOLE CARDS ***
asaphookz: folds 
sapr.549: raises $0.15 to $0.25
Viten'kA83: folds 
ramseskat: folds 
AAAcostA: folds 
watersnow66: folds 
Uncalled bet ($0.15) returned to sapr.549
sapr.549 collected $0.25 from pot
sapr.549: doesn't show hand 
*** SUMMARY ***
Total pot $0.25 | Rake $0 
Seat 1: Viten'kA83 folded before Flop (didn't bet)
Seat 2: ramseskat (button) folded before Flop (didn't bet)
Seat 3: AAAcostA (small blind) folded before Flop
Seat 4: watersnow66 (big blind) folded before Flop
Seat 5: asaphookz folded before Flop (didn't bet)
Seat 6: sapr.549 collected ($0.25)



PokerStars Hand #222963286125:  Hold'em No Limit ($0.05/$0.10 USD) - 2021/01/23 13:19:12 ET
Table 'Polydoros II' 6-max Seat #3 is the button
Seat 1: Viten'kA83 ($14.48 in chips) 
Seat 2: ramseskat ($10.51 in chips) 
Seat 3: AAAcostA ($15.96 in chips) 
Seat 4: watersnow66 ($18.34 in chips) 
Seat 6: sapr.549 ($9.43 in chips) 
watersnow66: posts small blind $0.05
asaphookz: is sitting out 
sapr.549: posts big blind $0.10
*** HOLE CARDS ***
Viten'kA83: raises $0.20 to $0.30
ramseskat: folds 
AAAcostA: folds 
watersnow66: calls $0.25
sapr.549: folds 
*** FLOP *** [3s Ks Jh]
watersnow66: checks 
Viten'kA83: bets $0.34
watersnow66: folds 
Uncalled bet ($0.34) returned to Viten'kA83
Viten'kA83 collected $0.67 from pot
Viten'kA83: doesn't show hand 
*** SUMMARY ***
Total pot $0.70 | Rake $0.03 
Board [3s Ks Jh]
Seat 1: Viten'kA83 collected ($0.67)
Seat 2: ramseskat folded before Flop (didn't bet)
Seat 3: AAAcostA (button) folded before Flop (didn't bet)
Seat 4: watersnow66 (small blind) folded on the Flop
Seat 6: sapr.549 (big blind) folded before Flop



PokerStars Hand #222963305682:  Hold'em No Limit ($0.05/$0.10 USD) - 2021/01/23 13:19:38 ET
Table 'Polydoros II' 6-max Seat #4 is the button
Seat 2: ramseskat ($10.51 in chips) 
Seat 3: AAAcostA ($15.96 in chips) 
Seat 4: watersnow66 ($18.04 in chips) 
Seat 6: sapr.549 ($9.33 in chips) 
sapr.549: posts small blind $0.05
Viten'kA83: is sitting out 
ramseskat: posts big blind $0.10
*** HOLE CARDS ***
Viten'kA83 leaves the table
AAAcostA: folds 
asaphookz leaves the table
watersnow66: folds 
sapr.549: raises $0.15 to $0.25
ramseskat: folds 
Uncalled bet ($0.15) returned to sapr.549
sapr.549 collected $0.20 from pot
sapr.549: doesn't show hand 
*** SUMMARY ***
Total pot $0.20 | Rake $0 
Seat 2: ramseskat (big blind) folded before Flop
Seat 3: AAAcostA folded before Flop (didn't bet)
Seat 4: watersnow66 (button) folded before Flop (didn't bet)
Seat 6: sapr.549 (small blind) collected ($0.20)



PokerStars Hand #222963319958:  Hold'em No Limit ($0.05/$0.10 USD) - 2021/01/23 13:19:57 ET
Table 'Polydoros II' 6-max Seat #6 is the button
Seat 2: ramseskat ($10.41 in chips) 
Seat 3: AAAcostA ($15.96 in chips) 
Seat 4: watersnow66 ($18.04 in chips) 
Seat 6: sapr.549 ($9.43 in chips) 
ramseskat: posts small blind $0.05
AAAcostA: posts big blind $0.10
*** HOLE CARDS ***
watersnow66: folds 
sapr.549: folds 
ramseskat: folds 
Uncalled bet ($0.05) returned to AAAcostA
AAAcostA collected $0.10 from pot
AAAcostA: doesn't show hand 
*** SUMMARY ***
Total pot $0.10 | Rake $0 
Seat 2: ramseskat (small blind) folded before Flop
Seat 3: AAAcostA (big blind) collected ($0.10)
Seat 4: watersnow66 folded before Flop (didn't bet)
Seat 6: sapr.549 (button) folded before Flop (didn't bet)



PokerStars Hand #222963326312:  Hold'em No Limit ($0.05/$0.10 USD) - 2021/01/23 13:20:06 ET
Table 'Polydoros II' 6-max Seat #2 is the button
Seat 2: ramseskat ($10.36 in chips) 
Seat 3: AAAcostA ($16.01 in chips) 
Seat 4: watersnow66 ($18.04 in chips) 
Seat 6: sapr.549 ($9.43 in chips) 
AAAcostA: posts small blind $0.05
watersnow66: posts big blind $0.10
*** HOLE CARDS ***
sapr.549: raises $0.15 to $0.25
Karl Edgar joins the table at seat #1 
ramseskat: folds 
LuckyTatia joins the table at seat #5 
AAAcostA: calls $0.20
watersnow66: folds 
*** FLOP *** [Ah 2d 7d]
AAAcostA: checks 
sapr.549: bets $0.24
AAAcostA: folds 
Uncalled bet ($0.24) returned to sapr.549
sapr.549 collected $0.57 from pot
sapr.549: doesn't show hand 
*** SUMMARY ***
Total pot $0.60 | Rake $0.03 
Board [Ah 2d 7d]
Seat 2: ramseskat (button) folded before Flop (didn't bet)
Seat 3: AAAcostA (small blind) folded on the Flop
Seat 4: watersnow66 (big blind) folded before Flop
Seat 6: sapr.549 collected ($0.57)



PokerStars Hand #222963348009:  Hold'em No Limit ($0.05/$0.10 USD) - 2021/01/23 13:20:35 ET
Table 'Polydoros II' 6-max Seat #3 is the button
Seat 2: ramseskat ($10.36 in chips) 
Seat 3: AAAcostA ($15.76 in chips) 
Seat 4: watersnow66 ($17.94 in chips) 
Seat 5: LuckyTatia ($10 in chips) 
Seat 6: sapr.549 ($9.75 in chips) 
watersnow66: posts small blind $0.05
LuckyTatia: posts big blind $0.10
Karl Edgar: sits out 
*** HOLE CARDS ***
sapr.549: folds 
ramseskat: folds 
AAAcostA: folds 
AAAcostA leaves the table
watersnow66: calls $0.05
LuckyTatia: checks 
*** FLOP *** [Ah Ks 4c]
pepuch19 joins the table at seat #3 
watersnow66: checks 
LuckyTatia: checks 
*** TURN *** [Ah Ks 4c] [5h]
watersnow66: checks 
LuckyTatia: checks 
*** RIVER *** [Ah Ks 4c 5h] [5c]
watersnow66: checks 
LuckyTatia: checks 
*** SHOW DOWN ***
watersnow66: shows [6c Jc] (a pair of Fives)
LuckyTatia: shows [Qc 2d] (a pair of Fives - Ace+King+Queen kicker)
LuckyTatia collected $0.19 from pot
*** SUMMARY ***
Total pot $0.20 | Rake $0.01 
Board [Ah Ks 4c 5h 5c]
Seat 2: ramseskat folded before Flop (didn't bet)
Seat 3: AAAcostA (button) folded before Flop (didn't bet)
Seat 4: watersnow66 (small blind) showed [6c Jc] and lost with a pair of Fives
Seat 5: LuckyTatia (big blind) showed [Qc 2d] and won ($0.19) with a pair of Fives
Seat 6: sapr.549 folded before Flop (didn't bet)



PokerStars Hand #222963376364:  Hold'em No Limit ($0.05/$0.10 USD) - 2021/01/23 13:21:12 ET
Table 'Polydoros II' 6-max Seat #4 is the button
Seat 2: ramseskat ($10.36 in chips) 
Seat 4: watersnow66 ($17.84 in chips) 
Seat 5: LuckyTatia ($10.09 in chips) 
Seat 6: sapr.549 ($9.75 in chips) 
LuckyTatia: posts small blind $0.05
sapr.549: posts big blind $0.10
Karl Edgar: sits out 
pepuch19: sits out 
*** HOLE CARDS ***
ramseskat: folds 
watersnow66: folds 
LuckyTatia: raises $0.10 to $0.20
sapr.549: calls $0.10
*** FLOP *** [6s As Td]
LuckyTatia: bets $0.19
sapr.549: folds 
Uncalled bet ($0.19) returned to LuckyTatia
LuckyTatia collected $0.38 from pot
*** SUMMARY ***
Total pot $0.40 | Rake $0.02 
Board [6s As Td]
Seat 2: ramseskat folded before Flop (didn't bet)
Seat 4: watersnow66 (button) folded before Flop (didn't bet)
Seat 5: LuckyTatia (small blind) collected ($0.38)
Seat 6: sapr.549 (big blind) folded on the Flop



PokerStars Hand #222963386711:  Hold'em No Limit ($0.05/$0.10 USD) - 2021/01/23 13:21:26 ET
Table 'Polydoros II' 6-max Seat #5 is the button
Seat 1: Karl Edgar ($10 in chips) 
Seat 2: ramseskat ($10.36 in chips) 
Seat 4: watersnow66 ($17.84 in chips) 
Seat 5: LuckyTatia ($10.27 in chips) 
Seat 6: sapr.549 ($9.55 in chips) 
sapr.549: posts small blind $0.05
Karl Edgar: posts big blind $0.10
pepuch19: sits out 
*** HOLE CARDS ***
ramseskat: folds 
watersnow66: folds 
LuckyTatia has timed out
LuckyTatia: folds 
sapr.549: raises $0.15 to $0.25
Karl Edgar: calls $0.15
*** FLOP *** [Qd Ac Ts]
sapr.549: bets $0.20
Karl Edgar: folds 
Uncalled bet ($0.20) returned to sapr.549
sapr.549 collected $0.48 from pot
sapr.549: doesn't show hand 
*** SUMMARY ***
Total pot $0.50 | Rake $0.02 
Board [Qd Ac Ts]
Seat 1: Karl Edgar (big blind) folded on the Flop
Seat 2: ramseskat folded before Flop (didn't bet)
Seat 4: watersnow66 folded before Flop (didn't bet)
Seat 5: LuckyTatia (button) folded before Flop (didn't bet)
Seat 6: sapr.549 (small blind) collected ($0.48)



PokerStars Hand #222963407162:  Hold'em No Limit ($0.05/$0.10 USD) - 2021/01/23 13:21:53 ET
Table 'Polydoros II' 6-max Seat #6 is the button
Seat 1: Karl Edgar ($10 in chips) 
Seat 2: ramseskat ($10.36 in chips) 
Seat 4: watersnow66 ($17.84 in chips) 
Seat 6: sapr.549 ($9.78 in chips) 
Karl Edgar: posts small blind $0.05
ramseskat: posts big blind $0.10
pepuch19: sits out 
*** HOLE CARDS ***
watersnow66: folds 
sapr.549: folds 
Karl Edgar: raises $0.15 to $0.25
ramseskat: folds 
Uncalled bet ($0.15) returned to Karl Edgar
Karl Edgar collected $0.20 from pot
Karl Edgar: doesn't show hand 
*** SUMMARY ***
Total pot $0.20 | Rake $0 
Seat 1: Karl Edgar (small blind) collected ($0.20)
Seat 2: ramseskat (big blind) folded before Flop
Seat 4: watersnow66 folded before Flop (didn't bet)
Seat 6: sapr.549 (button) folded before Flop (didn't bet)



PokerStars Hand #222963414839:  Hold'em No Limit ($0.05/$0.10 USD) - 2021/01/23 13:22:04 ET
Table 'Polydoros II' 6-max Seat #1 is the button
Seat 1: Karl Edgar ($10.10 in chips) 
Seat 2: ramseskat ($10.26 in chips) 
Seat 3: pepuch19 ($10 in chips) 
Seat 4: watersnow66 ($17.84 in chips) 
Seat 5: LuckyTatia ($10.27 in chips) 
Seat 6: sapr.549 ($9.78 in chips) 
ramseskat: posts small blind $0.05
pepuch19: posts big blind $0.10
*** HOLE CARDS ***
watersnow66: folds 
LuckyTatia: folds 
sapr.549: folds 
Karl Edgar: folds 
ramseskat: folds 
Uncalled bet ($0.05) returned to pepuch19
pepuch19 collected $0.10 from pot
pepuch19: doesn't show hand 
*** SUMMARY ***
Total pot $0.10 | Rake $0 
Seat 1: Karl Edgar (button) folded before Flop (didn't bet)
Seat 2: ramseskat (small blind) folded before Flop
Seat 3: pepuch19 (big blind) collected ($0.10)
Seat 4: watersnow66 folded before Flop (didn't bet)
Seat 5: LuckyTatia folded before Flop (didn't bet)
Seat 6: sapr.549 folded before Flop (didn't bet)



PokerStars Hand #222963420945:  Hold'em No Limit ($0.05/$0.10 USD) - 2021/01/23 13:22:12 ET
Table 'Polydoros II' 6-max Seat #2 is the button
Seat 1: Karl Edgar ($10.10 in chips) 
Seat 2: ramseskat ($10.21 in chips) 
Seat 3: pepuch19 ($10.05 in chips) 
Seat 4: watersnow66 ($17.84 in chips) 
Seat 5: LuckyTatia ($10.27 in chips) 
Seat 6: sapr.549 ($9.78 in chips) 
pepuch19: posts small blind $0.05
watersnow66: posts big blind $0.10
*** HOLE CARDS ***
LuckyTatia: folds 
sapr.549: folds 
Karl Edgar: folds 
ramseskat: raises $0.20 to $0.30
pepuch19: calls $0.25
watersnow66: folds 
*** FLOP *** [Jd 3c Ad]
pepuch19: checks 
ramseskat: bets $0.40
pepuch19: folds 
Uncalled bet ($0.40) returned to ramseskat
ramseskat collected $0.67 from pot
ramseskat: doesn't show hand 
*** SUMMARY ***
Total pot $0.70 | Rake $0.03 
Board [Jd 3c Ad]
Seat 1: Karl Edgar folded before Flop (didn't bet)
Seat 2: ramseskat (button) collected ($0.67)
Seat 3: pepuch19 (small blind) folded on the Flop
Seat 4: watersnow66 (big blind) folded before Flop
Seat 5: LuckyTatia folded before Flop (didn't bet)
Seat 6: sapr.549 folded before Flop (didn't bet)



PokerStars Hand #222963440958:  Hold'em No Limit ($0.05/$0.10 USD) - 2021/01/23 13:22:38 ET
Table 'Polydoros II' 6-max Seat #3 is the button
Seat 1: Karl Edgar ($10.10 in chips) 
Seat 2: ramseskat ($10.58 in chips) 
Seat 3: pepuch19 ($10 in chips) 
Seat 4: watersnow66 ($17.74 in chips) 
Seat 5: LuckyTatia ($10.27 in chips) 
Seat 6: sapr.549 ($9.78 in chips) 
watersnow66: posts small blind $0.05
LuckyTatia: posts big blind $0.10
*** HOLE CARDS ***
sapr.549: folds 
Karl Edgar: folds 
ramseskat: folds 
pepuch19: folds 
watersnow66: calls $0.05
LuckyTatia: raises $0.20 to $0.30
watersnow66: calls $0.20
*** FLOP *** [7c Kh As]
watersnow66: checks 
LuckyTatia: bets $0.38
watersnow66: folds 
Uncalled bet ($0.38) returned to LuckyTatia
LuckyTatia collected $0.57 from pot
*** SUMMARY ***
Total pot $0.60 | Rake $0.03 
Board [7c Kh As]
Seat 1: Karl Edgar folded before Flop (didn't bet)
Seat 2: ramseskat folded before Flop (didn't bet)
Seat 3: pepuch19 (button) folded before Flop (didn't bet)
Seat 4: watersnow66 (small blind) folded on the Flop
Seat 5: LuckyTatia (big blind) collected ($0.57)
Seat 6: sapr.549 folded before Flop (didn't bet)



PokerStars Hand #222963459605:  Hold'em No Limit ($0.05/$0.10 USD) - 2021/01/23 13:23:03 ET
Table 'Polydoros II' 6-max Seat #4 is the button
Seat 1: Karl Edgar ($10.10 in chips) 
Seat 2: ramseskat ($10.58 in chips) 
Seat 3: pepuch19 ($10 in chips) 
Seat 4: watersnow66 ($17.44 in chips) 
Seat 6: sapr.549 ($9.78 in chips) 
sapr.549: posts small blind $0.05
Karl Edgar: posts big blind $0.10
*** HOLE CARDS ***
ramseskat: folds 
pepuch19: raises $0.20 to $0.30
watersnow66: folds 
sapr.549: folds 
Karl Edgar: folds 
Uncalled bet ($0.20) returned to pepuch19
pepuch19 collected $0.25 from pot
pepuch19: doesn't show hand 
*** SUMMARY ***
Total pot $0.25 | Rake $0 
Seat 1: Karl Edgar (big blind) folded before Flop
Seat 2: ramseskat folded before Flop (didn't bet)
Seat 3: pepuch19 collected ($0.25)
Seat 4: watersnow66 (button) folded before Flop (didn't bet)
Seat 6: sapr.549 (small blind) folded before Flop



PokerStars Hand #222963467324:  Hold'em No Limit ($0.05/$0.10 USD) - 2021/01/23 13:23:13 ET
Table 'Polydoros II' 6-max Seat #6 is the button
Seat 1: Karl Edgar ($10 in chips) 
Seat 2: ramseskat ($10.58 in chips) 
Seat 3: pepuch19 ($10.15 in chips) 
Seat 4: watersnow66 ($17.44 in chips) 
Seat 6: sapr.549 ($9.73 in chips) 
Karl Edgar: posts small blind $0.05
ramseskat: posts big blind $0.10
*** HOLE CARDS ***
pepuch19: raises $0.20 to $0.30
watersnow66: folds 
Kim Stas93 joins the table at seat #5 
sapr.549: folds 
Karl Edgar: folds 
ramseskat: folds 
Uncalled bet ($0.20) returned to pepuch19
pepuch19 collected $0.25 from pot
pepuch19: doesn't show hand 
*** SUMMARY ***
Total pot $0.25 | Rake $0 
Seat 1: Karl Edgar (small blind) folded before Flop
Seat 2: ramseskat (big blind) folded before Flop
Seat 3: pepuch19 collected ($0.25)
Seat 4: watersnow66 folded before Flop (didn't bet)
Seat 6: sapr.549 (button) folded before Flop (didn't bet)



PokerStars Hand #222963474411:  Hold'em No Limit ($0.05/$0.10 USD) - 2021/01/23 13:23:23 ET
Table 'Polydoros II' 6-max Seat #1 is the button
Seat 1: Karl Edgar ($10 in chips) 
Seat 2: ramseskat ($10.48 in chips) 
Seat 3: pepuch19 ($10.30 in chips) 
Seat 4: watersnow66 ($17.44 in chips) 
Seat 6: sapr.549 ($9.73 in chips) 
ramseskat: posts small blind $0.05
pepuch19: posts big blind $0.10
Kim Stas93: sits out 
*** HOLE CARDS ***
watersnow66: folds 
sapr.549: folds 
Karl Edgar: folds 
ramseskat: raises $0.20 to $0.30
pepuch19: folds 
Uncalled bet ($0.20) returned to ramseskat
ramseskat collected $0.20 from pot
ramseskat: doesn't show hand 
*** SUMMARY ***
Total pot $0.20 | Rake $0 
Seat 1: Karl Edgar (button) folded before Flop (didn't bet)
Seat 2: ramseskat (small blind) collected ($0.20)
Seat 3: pepuch19 (big blind) folded before Flop
Seat 4: watersnow66 folded before Flop (didn't bet)
Seat 6: sapr.549 folded before Flop (didn't bet)



PokerStars Hand #222963487954:  Hold'em No Limit ($0.05/$0.10 USD) - 2021/01/23 13:23:40 ET
Table 'Polydoros II' 6-max Seat #2 is the button
Seat 1: Karl Edgar ($10 in chips) 
Seat 2: ramseskat ($10.58 in chips) 
Seat 3: pepuch19 ($10.20 in chips) 
Seat 4: watersnow66 ($17.44 in chips) 
Seat 6: sapr.549 ($9.73 in chips) 
pepuch19: posts small blind $0.05
watersnow66: posts big blind $0.10
Kim Stas93: sits out 
*** HOLE CARDS ***
sapr.549: folds 
Karl Edgar: raises $0.15 to $0.25
ramseskat: folds 
pepuch19: folds 
watersnow66: folds 
Uncalled bet ($0.15) returned to Karl Edgar
Karl Edgar collected $0.25 from pot
Karl Edgar: doesn't show hand 
*** SUMMARY ***
Total pot $0.25 | Rake $0 
Seat 1: Karl Edgar collected ($0.25)
Seat 2: ramseskat (button) folded before Flop (didn't bet)
Seat 3: pepuch19 (small blind) folded before Flop
Seat 4: watersnow66 (big blind) folded before Flop
Seat 6: sapr.549 folded before Flop (didn't bet)



PokerStars Hand #222963497519:  Hold'em No Limit ($0.05/$0.10 USD) - 2021/01/23 13:23:53 ET
Table 'Polydoros II' 6-max Seat #3 is the button
Seat 1: Karl Edgar ($10.15 in chips) 
Seat 2: ramseskat ($10.58 in chips) 
Seat 3: pepuch19 ($10.15 in chips) 
Seat 4: watersnow66 ($17.34 in chips) 
Seat 5: Kim Stas93 ($5 in chips) 
Seat 6: sapr.549 ($9.73 in chips) 
watersnow66: posts small blind $0.05
Kim Stas93: posts big blind $0.10
*** HOLE CARDS ***
sapr.549: folds 
Karl Edgar: folds 
ramseskat: folds 
pepuch19: folds 
watersnow66: folds 
Uncalled bet ($0.05) returned to Kim Stas93
Kim Stas93 collected $0.10 from pot
Kim Stas93: doesn't show hand 
*** SUMMARY ***
Total pot $0.10 | Rake $0 
Seat 1: Karl Edgar folded before Flop (didn't bet)
Seat 2: ramseskat folded before Flop (didn't bet)
Seat 3: pepuch19 (button) folded before Flop (didn't bet)
Seat 4: watersnow66 (small blind) folded before Flop
Seat 5: Kim Stas93 (big blind) collected ($0.10)
Seat 6: sapr.549 folded before Flop (didn't bet)



PokerStars Hand #222963505105:  Hold'em No Limit ($0.05/$0.10 USD) - 2021/01/23 13:24:03 ET
Table 'Polydoros II' 6-max Seat #4 is the button
Seat 1: Karl Edgar ($10.15 in chips) 
Seat 2: ramseskat ($10.58 in chips) 
Seat 3: pepuch19 ($10.15 in chips) 
Seat 4: watersnow66 ($17.29 in chips) 
Seat 5: Kim Stas93 ($5.05 in chips) 
Seat 6: sapr.549 ($9.73 in chips) 
Kim Stas93: posts small blind $0.05
sapr.549: posts big blind $0.10
*** HOLE CARDS ***
Karl Edgar: folds 
ramseskat: folds 
pepuch19: folds 
watersnow66: folds 
Kim Stas93: raises $0.10 to $0.20
sapr.549: calls $0.10
*** FLOP *** [Td Qh As]
Kim Stas93: checks 
sapr.549: checks 
*** TURN *** [Td Qh As] [8c]
Kim Stas93: checks 
sapr.549: checks 
*** RIVER *** [Td Qh As 8c] [9d]
Kim Stas93: checks 
sapr.549: checks 
*** SHOW DOWN ***
Kim Stas93: shows [7h 3h] (high card Ace)
sapr.549: shows [Ks 7s] (high card Ace - King kicker)
sapr.549 collected $0.38 from pot
*** SUMMARY ***
Total pot $0.40 | Rake $0.02 
Board [Td Qh As 8c 9d]
Seat 1: Karl Edgar folded before Flop (didn't bet)
Seat 2: ramseskat folded before Flop (didn't bet)
Seat 3: pepuch19 folded before Flop (didn't bet)
Seat 4: watersnow66 (button) folded before Flop (didn't bet)
Seat 5: Kim Stas93 (small blind) showed [7h 3h] and lost with high card Ace
Seat 6: sapr.549 (big blind) showed [Ks 7s] and won ($0.38) with high card Ace



PokerStars Hand #222963522483:  Hold'em No Limit ($0.05/$0.10 USD) - 2021/01/23 13:24:26 ET
Table 'Polydoros II' 6-max Seat #5 is the button
Seat 1: Karl Edgar ($10.15 in chips) 
Seat 2: ramseskat ($10.58 in chips) 
Seat 3: pepuch19 ($10.15 in chips) 
Seat 4: watersnow66 ($17.29 in chips) 
Seat 5: Kim Stas93 ($4.85 in chips) 
Seat 6: sapr.549 ($9.91 in chips) 
sapr.549: posts small blind $0.05
Karl Edgar: posts big blind $0.10
*** HOLE CARDS ***
ramseskat: folds 
pepuch19: folds 
watersnow66: folds 
Kim Stas93: folds 
sapr.549: raises $0.15 to $0.25
Karl Edgar: folds 
Uncalled bet ($0.15) returned to sapr.549
sapr.549 collected $0.20 from pot
*** SUMMARY ***
Total pot $0.20 | Rake $0 
Seat 1: Karl Edgar (big blind) folded before Flop
Seat 2: ramseskat folded before Flop (didn't bet)
Seat 3: pepuch19 folded before Flop (didn't bet)
Seat 4: watersnow66 folded before Flop (didn't bet)
Seat 5: Kim Stas93 (button) folded before Flop (didn't bet)
Seat 6: sapr.549 (small blind) collected ($0.20)



PokerStars Hand #222963532372:  Hold'em No Limit ($0.05/$0.10 USD) - 2021/01/23 13:24:39 ET
Table 'Polydoros II' 6-max Seat #6 is the button
Seat 1: Karl Edgar ($10.05 in chips) 
Seat 2: ramseskat ($10.58 in chips) 
Seat 3: pepuch19 ($10.15 in chips) 
Seat 4: watersnow66 ($17.29 in chips) 
Seat 5: Kim Stas93 ($4.85 in chips) 
Seat 6: sapr.549 ($10.01 in chips) 
Karl Edgar: posts small blind $0.05
ramseskat: posts big blind $0.10
*** HOLE CARDS ***
pepuch19: folds 
watersnow66: folds 
Kim Stas93: folds 
Kim Stas93 leaves the table
sapr.549: folds 
Karl Edgar: raises $0.15 to $0.25
ramseskat: folds 
Uncalled bet ($0.15) returned to Karl Edgar
Kim Stas93 joins the table at seat #5 
Karl Edgar collected $0.20 from pot
Karl Edgar: doesn't show hand 
*** SUMMARY ***
Total pot $0.20 | Rake $0 
Seat 1: Karl Edgar (small blind) collected ($0.20)
Seat 2: ramseskat (big blind) folded before Flop
Seat 3: pepuch19 folded before Flop (didn't bet)
Seat 4: watersnow66 folded before Flop (didn't bet)
Seat 5: Kim Stas93 folded before Flop (didn't bet)
Seat 6: sapr.549 (button) folded before Flop (didn't bet)



PokerStars Hand #222963544126:  Hold'em No Limit ($0.05/$0.10 USD) - 2021/01/23 13:24:55 ET
Table 'Polydoros II' 6-max Seat #1 is the button
Seat 1: Karl Edgar ($10.15 in chips) 
Seat 2: ramseskat ($10.48 in chips) 
Seat 3: pepuch19 ($10.15 in chips) 
Seat 4: watersnow66 ($17.29 in chips) 
Seat 6: sapr.549 ($10.01 in chips) 
ramseskat: posts small blind $0.05
pepuch19: posts big blind $0.10
Kim Stas93: is sitting out 
*** HOLE CARDS ***
Kim Stas93 leaves the table
watersnow66: folds 
Viten'kA83 joins the table at seat #5 
sapr.549: folds 
Karl Edgar: raises $0.10 to $0.20
ramseskat: folds 
pepuch19: calls $0.10
*** FLOP *** [2c Th Kc]
watersnow66 leaves the table
pepuch19: checks 
Karl Edgar: bets $0.22
pepuch19: calls $0.22
*** TURN *** [2c Th Kc] [Jc]
pepuch19: checks 
Karl Edgar: bets $0.70
pepuch19: calls $0.70
*** RIVER *** [2c Th Kc Jc] [Qh]
pepuch19: checks 
Karl Edgar: checks 
*** SHOW DOWN ***
pepuch19: shows [9c Kd] (a straight, Nine to King)
Karl Edgar: shows [Ah Qs] (a straight, Ten to Ace)
Karl Edgar collected $2.19 from pot
*** SUMMARY ***
Total pot $2.29 | Rake $0.10 
Board [2c Th Kc Jc Qh]
Seat 1: Karl Edgar (button) showed [Ah Qs] and won ($2.19) with a straight, Ten to Ace
Seat 2: ramseskat (small blind) folded before Flop
Seat 3: pepuch19 (big blind) showed [9c Kd] and lost with a straight, Nine to King
Seat 4: watersnow66 folded before Flop (didn't bet)
Seat 6: sapr.549 folded before Flop (didn't bet)



PokerStars Hand #222963592146:  Hold'em No Limit ($0.05/$0.10 USD) - 2021/01/23 13:25:58 ET
Table 'Polydoros II' 6-max Seat #2 is the button
Seat 1: Karl Edgar ($11.22 in chips) 
Seat 2: ramseskat ($10.43 in chips) 
Seat 3: pepuch19 ($10 in chips) 
Seat 5: Viten'kA83 ($14.85 in chips) 
Seat 6: sapr.549 ($10.01 in chips) 
pepuch19: posts small blind $0.05
Viten'kA83: posts big blind $0.10
*** HOLE CARDS ***
sapr.549: folds 
Karl Edgar: raises $0.15 to $0.25
ramseskat: folds 
pepuch19: folds 
Viten'kA83: folds 
Uncalled bet ($0.15) returned to Karl Edgar
Karl Edgar collected $0.25 from pot
Karl Edgar: doesn't show hand 
*** SUMMARY ***
Total pot $0.25 | Rake $0 
Seat 1: Karl Edgar collected ($0.25)
Seat 2: ramseskat (button) folded before Flop (didn't bet)
Seat 3: pepuch19 (small blind) folded before Flop
Seat 5: Viten'kA83 (big blind) folded before Flop
Seat 6: sapr.549 folded before Flop (didn't bet)



PokerStars Hand #222963610114:  Hold'em No Limit ($0.05/$0.10 USD) - 2021/01/23 13:26:22 ET
Table 'Polydoros II' 6-max Seat #3 is the button
Seat 1: Karl Edgar ($11.37 in chips) 
Seat 2: ramseskat ($10.43 in chips) 
Seat 3: pepuch19 ($10 in chips) 
Seat 5: Viten'kA83 ($14.75 in chips) 
Seat 6: sapr.549 ($10.01 in chips) 
Viten'kA83: posts small blind $0.05
sapr.549: posts big blind $0.10
*** HOLE CARDS ***
Karl Edgar: raises $0.20 to $0.30
ramseskat: folds 
pepuch19: folds 
Viten'kA83: folds 
sapr.549: calls $0.20
*** FLOP *** [5c 5d 8s]
sapr.549: checks 
Karl Edgar: bets $0.30
sapr.549: folds 
Uncalled bet ($0.30) returned to Karl Edgar
Karl Edgar collected $0.62 from pot
Karl Edgar: doesn't show hand 
*** SUMMARY ***
Total pot $0.65 | Rake $0.03 
Board [5c 5d 8s]
Seat 1: Karl Edgar collected ($0.62)
Seat 2: ramseskat folded before Flop (didn't bet)
Seat 3: pepuch19 (button) folded before Flop (didn't bet)
Seat 5: Viten'kA83 (small blind) folded before Flop
Seat 6: sapr.549 (big blind) folded on the Flop



PokerStars Hand #222963626783:  Hold'em No Limit ($0.05/$0.10 USD) - 2021/01/23 13:26:44 ET
Table 'Polydoros II' 6-max Seat #5 is the button
Seat 1: Karl Edgar ($11.69 in chips) 
Seat 2: ramseskat ($10.43 in chips) 
Seat 3: pepuch19 ($10 in chips) 
Seat 5: Viten'kA83 ($14.70 in chips) 
Seat 6: sapr.549 ($9.71 in chips) 
sapr.549: posts small blind $0.05
Karl Edgar: posts big blind $0.10
*** HOLE CARDS ***
ramseskat: folds 
pepuch19: folds 
Viten'kA83: folds 
sapr.549: folds 
Uncalled bet ($0.05) returned to Karl Edgar
Karl Edgar collected $0.10 from pot
Karl Edgar: doesn't show hand 
*** SUMMARY ***
Total pot $0.10 | Rake $0 
Seat 1: Karl Edgar (big blind) collected ($0.10)
Seat 2: ramseskat folded before Flop (didn't bet)
Seat 3: pepuch19 folded before Flop (didn't bet)
Seat 5: Viten'kA83 (button) folded before Flop (didn't bet)
Seat 6: sapr.549 (small blind) folded before Flop



PokerStars Hand #222963638930:  Hold'em No Limit ($0.05/$0.10 USD) - 2021/01/23 13:27:00 ET
Table 'Polydoros II' 6-max Seat #6 is the button
Seat 1: Karl Edgar ($11.74 in chips) 
Seat 2: ramseskat ($10.43 in chips) 
Seat 3: pepuch19 ($10 in chips) 
Seat 5: Viten'kA83 ($14.70 in chips) 
Seat 6: sapr.549 ($9.66 in chips) 
Karl Edgar: posts small blind $0.05
ramseskat: posts big blind $0.10
*** HOLE CARDS ***
pepuch19: folds 
Viten'kA83: folds 
sapr.549: folds 
Karl Edgar: folds 
Uncalled bet ($0.05) returned to ramseskat
ramseskat collected $0.10 from pot
ramseskat: doesn't show hand 
*** SUMMARY ***
Total pot $0.10 | Rake $0 
Seat 1: Karl Edgar (small blind) folded before Flop
Seat 2: ramseskat (big blind) collected ($0.10)
Seat 3: pepuch19 folded before Flop (didn't bet)
Seat 5: Viten'kA83 folded before Flop (didn't bet)
Seat 6: sapr.549 (button) folded before Flop (didn't bet)



PokerStars Hand #222963646611:  Hold'em No Limit ($0.05/$0.10 USD) - 2021/01/23 13:27:10 ET
Table 'Polydoros II' 6-max Seat #1 is the button
Seat 1: Karl Edgar ($11.69 in chips) 
Seat 2: ramseskat ($10.48 in chips) 
Seat 3: pepuch19 ($10 in chips) 
Seat 5: Viten'kA83 ($14.70 in chips) 
Seat 6: sapr.549 ($9.66 in chips) 
ramseskat: posts small blind $0.05
pepuch19: posts big blind $0.10
*** HOLE CARDS ***
Viten'kA83: folds 
sapr.549: folds 
Karl Edgar: raises $0.10 to $0.20
ramseskat: folds 
pepuch19: folds 
Uncalled bet ($0.10) returned to Karl Edgar
Karl Edgar collected $0.25 from pot
Karl Edgar: doesn't show hand 
*** SUMMARY ***
Total pot $0.25 | Rake $0 
Seat 1: Karl Edgar (button) collected ($0.25)
Seat 2: ramseskat (small blind) folded before Flop
Seat 3: pepuch19 (big blind) folded before Flop
Seat 5: Viten'kA83 folded before Flop (didn't bet)
Seat 6: sapr.549 folded before Flop (didn't bet)



PokerStars Hand #222963655897:  Hold'em No Limit ($0.05/$0.10 USD) - 2021/01/23 13:27:22 ET
Table 'Polydoros II' 6-max Seat #2 is the button
Seat 1: Karl Edgar ($11.84 in chips) 
Seat 2: ramseskat ($10.43 in chips) 
Seat 3: pepuch19 ($10 in chips) 
Seat 5: Viten'kA83 ($14.70 in chips) 
Seat 6: sapr.549 ($9.66 in chips) 
pepuch19: posts small blind $0.05
Viten'kA83: posts big blind $0.10
*** HOLE CARDS ***
sapr.549: folds 
Karl Edgar: folds 
ramseskat: raises $0.20 to $0.30
pepuch19: raises $0.70 to $1
Viten'kA83: folds 
ramseskat: folds 
Uncalled bet ($0.70) returned to pepuch19
pepuch19 collected $0.70 from pot
pepuch19: doesn't show hand 
*** SUMMARY ***
Total pot $0.70 | Rake $0 
Seat 1: Karl Edgar folded before Flop (didn't bet)
Seat 2: ramseskat (button) folded before Flop
Seat 3: pepuch19 (small blind) collected ($0.70)
Seat 5: Viten'kA83 (big blind) folded before Flop
Seat 6: sapr.549 folded before Flop (didn't bet)



PokerStars Hand #222963669640:  Hold'em No Limit ($0.05/$0.10 USD) - 2021/01/23 13:27:40 ET
Table 'Polydoros II' 6-max Seat #3 is the button
Seat 1: Karl Edgar ($11.84 in chips) 
Seat 2: ramseskat ($10.13 in chips) 
Seat 3: pepuch19 ($10.40 in chips) 
Seat 5: Viten'kA83 ($14.60 in chips) 
Seat 6: sapr.549 ($9.66 in chips) 
Viten'kA83: posts small blind $0.05
sapr.549: posts big blind $0.10
*** HOLE CARDS ***
Karl Edgar: raises $0.20 to $0.30
ramseskat: folds 
Dimitrii 30 joins the table at seat #4 
pepuch19: folds 
Viten'kA83: folds 
sapr.549: folds 
Uncalled bet ($0.20) returned to Karl Edgar
Karl Edgar collected $0.25 from pot
Karl Edgar: doesn't show hand 
*** SUMMARY ***
Total pot $0.25 | Rake $0 
Seat 1: Karl Edgar collected ($0.25)
Seat 2: ramseskat folded before Flop (didn't bet)
Seat 3: pepuch19 (button) folded before Flop (didn't bet)
Seat 5: Viten'kA83 (small blind) folded before Flop
Seat 6: sapr.549 (big blind) folded before Flop



PokerStars Hand #222963680112:  Hold'em No Limit ($0.05/$0.10 USD) - 2021/01/23 13:27:54 ET
Table 'Polydoros II' 6-max Seat #5 is the button
Seat 1: Karl Edgar ($11.99 in chips) 
Seat 2: ramseskat ($10.13 in chips) 
Seat 3: pepuch19 ($10.40 in chips) 
Seat 5: Viten'kA83 ($14.55 in chips) 
Seat 6: sapr.549 ($9.56 in chips) 
sapr.549: posts small blind $0.05
Karl Edgar: posts big blind $0.10
Dimitrii 30: sits out 
*** HOLE CARDS ***
ramseskat: raises $0.20 to $0.30
pepuch19: folds 
Viten'kA83: folds 
sapr.549: folds 
Karl Edgar: folds 
Uncalled bet ($0.20) returned to ramseskat
ramseskat collected $0.25 from pot
ramseskat: doesn't show hand 
*** SUMMARY ***
Total pot $0.25 | Rake $0 
Seat 1: Karl Edgar (big blind) folded before Flop
Seat 2: ramseskat collected ($0.25)
Seat 3: pepuch19 folded before Flop (didn't bet)
Seat 5: Viten'kA83 (button) folded before Flop (didn't bet)
Seat 6: sapr.549 (small blind) folded before Flop



PokerStars Hand #222963690228:  Hold'em No Limit ($0.05/$0.10 USD) - 2021/01/23 13:28:07 ET
Table 'Polydoros II' 6-max Seat #6 is the button
Seat 1: Karl Edgar ($11.89 in chips) 
Seat 2: ramseskat ($10.28 in chips) 
Seat 3: pepuch19 ($10.40 in chips) 
Seat 5: Viten'kA83 ($14.55 in chips) 
Seat 6: sapr.549 ($9.51 in chips) 
Karl Edgar: posts small blind $0.05
ramseskat: posts big blind $0.10
Dimitrii 30: sits out 
*** HOLE CARDS ***
pepuch19: raises $0.20 to $0.30
Viten'kA83: raises $0.60 to $0.90
sapr.549: folds 
Karl Edgar: folds 
ramseskat: folds 
pepuch19: folds 
Uncalled bet ($0.60) returned to Viten'kA83
Viten'kA83 collected $0.75 from pot
Viten'kA83: doesn't show hand 
*** SUMMARY ***
Total pot $0.75 | Rake $0 
Seat 1: Karl Edgar (small blind) folded before Flop
Seat 2: ramseskat (big blind) folded before Flop
Seat 3: pepuch19 folded before Flop
Seat 5: Viten'kA83 collected ($0.75)
Seat 6: sapr.549 (button) folded before Flop (didn't bet)



PokerStars Hand #222963702229:  Hold'em No Limit ($0.05/$0.10 USD) - 2021/01/23 13:28:23 ET
Table 'Polydoros II' 6-max Seat #1 is the button
Seat 1: Karl Edgar ($11.84 in chips) 
Seat 2: ramseskat ($10.18 in chips) 
Seat 3: pepuch19 ($10.10 in chips) 
Seat 5: Viten'kA83 ($15 in chips) 
Seat 6: sapr.549 ($9.51 in chips) 
ramseskat: posts small blind $0.05
pepuch19: posts big blind $0.10
Dimitrii 30: sits out 
*** HOLE CARDS ***
Viten'kA83: folds 
sapr.549: folds 
Karl Edgar: folds 
ramseskat: raises $0.20 to $0.30
pepuch19: calls $0.20
*** FLOP *** [7h 2d Jc]
ramseskat: bets $0.40
pepuch19: calls $0.40
*** TURN *** [7h 2d Jc] [9h]
ramseskat: bets $0.90
pepuch19: raises $1.66 to $2.56
ramseskat: folds 
Uncalled bet ($1.66) returned to pepuch19
pepuch19 collected $3.06 from pot
pepuch19: doesn't show hand 
*** SUMMARY ***
Total pot $3.20 | Rake $0.14 
Board [7h 2d Jc 9h]
Seat 1: Karl Edgar (button) folded before Flop (didn't bet)
Seat 2: ramseskat (small blind) folded on the Turn
Seat 3: pepuch19 (big blind) collected ($3.06)
Seat 5: Viten'kA83 folded before Flop (didn't bet)
Seat 6: sapr.549 folded before Flop (didn't bet)



PokerStars Hand #222963739800:  Hold'em No Limit ($0.05/$0.10 USD) - 2021/01/23 13:29:13 ET
Table 'Polydoros II' 6-max Seat #2 is the button
Seat 1: Karl Edgar ($11.84 in chips) 
Seat 2: ramseskat ($10 in chips) 
Seat 3: pepuch19 ($11.56 in chips) 
Seat 4: Dimitrii 30 ($8 in chips) 
Seat 5: Viten'kA83 ($15 in chips) 
Seat 6: sapr.549 ($9.51 in chips) 
pepuch19: posts small blind $0.05
Dimitrii 30: posts big blind $0.10
*** HOLE CARDS ***
Viten'kA83: folds 
sapr.549: raises $0.15 to $0.25
Karl Edgar: folds 
ramseskat: raises $0.65 to $0.90
pepuch19: folds 
Dimitrii 30: folds 
sapr.549: folds 
Uncalled bet ($0.65) returned to ramseskat
ramseskat collected $0.65 from pot
ramseskat: doesn't show hand 
*** SUMMARY ***
Total pot $0.65 | Rake $0 
Seat 1: Karl Edgar folded before Flop (didn't bet)
Seat 2: ramseskat (button) collected ($0.65)
Seat 3: pepuch19 (small blind) folded before Flop
Seat 4: Dimitrii 30 (big blind) folded before Flop
Seat 5: Viten'kA83 folded before Flop (didn't bet)
Seat 6: sapr.549 folded before Flop



PokerStars Hand #222963755316:  Hold'em No Limit ($0.05/$0.10 USD) - 2021/01/23 13:29:34 ET
Table 'Polydoros II' 6-max Seat #3 is the button
Seat 1: Karl Edgar ($11.84 in chips) 
Seat 2: ramseskat ($10.40 in chips) 
Seat 3: pepuch19 ($11.51 in chips) 
Seat 4: Dimitrii 30 ($8 in chips) 
Seat 5: Viten'kA83 ($15 in chips) 
Seat 6: sapr.549 ($9.26 in chips) 
Dimitrii 30: posts small blind $0.05
Viten'kA83: posts big blind $0.10
*** HOLE CARDS ***
sapr.549: folds 
Karl Edgar: folds 
ramseskat: folds 
pepuch19: folds 
Dimitrii 30: raises $0.20 to $0.30
Viten'kA83: folds 
Uncalled bet ($0.20) returned to Dimitrii 30
Dimitrii 30 collected $0.20 from pot
Dimitrii 30: doesn't show hand 
*** SUMMARY ***
Total pot $0.20 | Rake $0 
Seat 1: Karl Edgar folded before Flop (didn't bet)
Seat 2: ramseskat folded before Flop (didn't bet)
Seat 3: pepuch19 (button) folded before Flop (didn't bet)
Seat 4: Dimitrii 30 (small blind) collected ($0.20)
Seat 5: Viten'kA83 (big blind) folded before Flop
Seat 6: sapr.549 folded before Flop (didn't bet)



PokerStars Hand #222963764394:  Hold'em No Limit ($0.05/$0.10 USD) - 2021/01/23 13:29:46 ET
Table 'Polydoros II' 6-max Seat #4 is the button
Seat 1: Karl Edgar ($11.84 in chips) 
Seat 2: ramseskat ($10.40 in chips) 
Seat 3: pepuch19 ($11.51 in chips) 
Seat 4: Dimitrii 30 ($8.10 in chips) 
Seat 5: Viten'kA83 ($14.90 in chips) 
Seat 6: sapr.549 ($9.26 in chips) 
Viten'kA83: posts small blind $0.05
sapr.549: posts big blind $0.10
*** HOLE CARDS ***
Karl Edgar: folds 
ramseskat: folds 
pepuch19: folds 
Dimitrii 30: folds 
Viten'kA83: calls $0.05
sapr.549: checks 
*** FLOP *** [Qd Qs Js]
Viten'kA83: checks 
sapr.549: bets $0.11
Viten'kA83: folds 
Uncalled bet ($0.11) returned to sapr.549
sapr.549 collected $0.19 from pot
sapr.549: doesn't show hand 
*** SUMMARY ***
Total pot $0.20 | Rake $0.01 
Board [Qd Qs Js]
Seat 1: Karl Edgar folded before Flop (didn't bet)
Seat 2: ramseskat folded before Flop (didn't bet)
Seat 3: pepuch19 folded before Flop (didn't bet)
Seat 4: Dimitrii 30 (button) folded before Flop (didn't bet)
Seat 5: Viten'kA83 (small blind) folded on the Flop
Seat 6: sapr.549 (big blind) collected ($0.19)



PokerStars Hand #222963800599:  Hold'em No Limit ($0.05/$0.10 USD) - 2021/01/23 13:30:33 ET
Table 'Polydoros II' 6-max Seat #5 is the button
Seat 1: Karl Edgar ($11.84 in chips) 
Seat 2: ramseskat ($10.40 in chips) 
Seat 3: pepuch19 ($11.51 in chips) 
Seat 4: Dimitrii 30 ($8.10 in chips) 
Seat 5: Viten'kA83 ($14.80 in chips) 
Seat 6: sapr.549 ($9.35 in chips) 
sapr.549: posts small blind $0.05
Karl Edgar: posts big blind $0.10
*** HOLE CARDS ***
ramseskat: folds 
pepuch19: folds 
Dimitrii 30: folds 
Viten'kA83: folds 
sapr.549: folds 
Uncalled bet ($0.05) returned to Karl Edgar
Karl Edgar collected $0.10 from pot
Karl Edgar: doesn't show hand 
*** SUMMARY ***
Total pot $0.10 | Rake $0 
Seat 1: Karl Edgar (big blind) collected ($0.10)
Seat 2: ramseskat folded before Flop (didn't bet)
Seat 3: pepuch19 folded before Flop (didn't bet)
Seat 4: Dimitrii 30 folded before Flop (didn't bet)
Seat 5: Viten'kA83 (button) folded before Flop (didn't bet)
Seat 6: sapr.549 (small blind) folded before Flop



PokerStars Hand #222963808864:  Hold'em No Limit ($0.05/$0.10 USD) - 2021/01/23 13:30:44 ET
Table 'Polydoros II' 6-max Seat #6 is the button
Seat 1: Karl Edgar ($11.89 in chips) 
Seat 2: ramseskat ($10.40 in chips) 
Seat 3: pepuch19 ($11.51 in chips) 
Seat 4: Dimitrii 30 ($8.10 in chips) 
Seat 5: Viten'kA83 ($14.80 in chips) 
Seat 6: sapr.549 ($9.30 in chips) 
Karl Edgar: posts small blind $0.05
ramseskat: posts big blind $0.10
*** HOLE CARDS ***
pepuch19: folds 
Dimitrii 30: folds 
Viten'kA83: folds 
sapr.549: raises $0.15 to $0.25
Karl Edgar: folds 
ramseskat: folds 
Uncalled bet ($0.15) returned to sapr.549
sapr.549 collected $0.25 from pot
sapr.549: doesn't show hand 
*** SUMMARY ***
Total pot $0.25 | Rake $0 
Seat 1: Karl Edgar (small blind) folded before Flop
Seat 2: ramseskat (big blind) folded before Flop
Seat 3: pepuch19 folded before Flop (didn't bet)
Seat 4: Dimitrii 30 folded before Flop (didn't bet)
Seat 5: Viten'kA83 folded before Flop (didn't bet)
Seat 6: sapr.549 (button) collected ($0.25)



PokerStars Hand #222963818535:  Hold'em No Limit ($0.05/$0.10 USD) - 2021/01/23 13:30:56 ET
Table 'Polydoros II' 6-max Seat #1 is the button
Seat 1: Karl Edgar ($11.84 in chips) 
Seat 2: ramseskat ($10.30 in chips) 
Seat 3: pepuch19 ($11.51 in chips) 
Seat 4: Dimitrii 30 ($8.10 in chips) 
Seat 5: Viten'kA83 ($14.80 in chips) 
Seat 6: sapr.549 ($9.45 in chips) 
ramseskat: posts small blind $0.05
pepuch19: posts big blind $0.10
*** HOLE CARDS ***
Dimitrii 30: folds 
Viten'kA83: folds 
sapr.549: raises $0.15 to $0.25
Karl Edgar: folds 
ramseskat: folds 
pepuch19: calls $0.15
*** FLOP *** [Ac 2h Js]
pepuch19: checks 
sapr.549: bets $0.22
pepuch19: calls $0.22
*** TURN *** [Ac 2h Js] [4s]
pepuch19: checks 
sapr.549: bets $0.39
pepuch19: calls $0.39
*** RIVER *** [Ac 2h Js 4s] [Ks]
pepuch19: checks 
sapr.549: checks 
*** SHOW DOWN ***
pepuch19: shows [7d Ah] (a pair of Aces)
sapr.549: shows [Ad 9d] (a pair of Aces - King+Jack+Nine kicker)
sapr.549 collected $1.69 from pot
*** SUMMARY ***
Total pot $1.77 | Rake $0.08 
Board [Ac 2h Js 4s Ks]
Seat 1: Karl Edgar (button) folded before Flop (didn't bet)
Seat 2: ramseskat (small blind) folded before Flop
Seat 3: pepuch19 (big blind) showed [7d Ah] and lost with a pair of Aces
Seat 4: Dimitrii 30 folded before Flop (didn't bet)
Seat 5: Viten'kA83 folded before Flop (didn't bet)
Seat 6: sapr.549 showed [Ad 9d] and won ($1.69) with a pair of Aces



PokerStars Hand #222963850635:  Hold'em No Limit ($0.05/$0.10 USD) - 2021/01/23 13:31:37 ET
Table 'Polydoros II' 6-max Seat #2 is the button
Seat 1: Karl Edgar ($11.84 in chips) 
Seat 2: ramseskat ($10.25 in chips) 
Seat 3: pepuch19 ($10.65 in chips) 
Seat 4: Dimitrii 30 ($8.10 in chips) 
Seat 5: Viten'kA83 ($14.80 in chips) 
Seat 6: sapr.549 ($10.28 in chips) 
pepuch19: posts small blind $0.05
Dimitrii 30: posts big blind $0.10
*** HOLE CARDS ***
Viten'kA83: folds 
sapr.549: folds 
Karl Edgar: raises $0.15 to $0.25
ramseskat: folds 
pepuch19: folds 
Dimitrii 30: folds 
Uncalled bet ($0.15) returned to Karl Edgar
Karl Edgar collected $0.25 from pot
Karl Edgar: doesn't show hand 
*** SUMMARY ***
Total pot $0.25 | Rake $0 
Seat 1: Karl Edgar collected ($0.25)
Seat 2: ramseskat (button) folded before Flop (didn't bet)
Seat 3: pepuch19 (small blind) folded before Flop
Seat 4: Dimitrii 30 (big blind) folded before Flop
Seat 5: Viten'kA83 folded before Flop (didn't bet)
Seat 6: sapr.549 folded before Flop (didn't bet)



PokerStars Hand #222963859582:  Hold'em No Limit ($0.05/$0.10 USD) - 2021/01/23 13:31:48 ET
Table 'Polydoros II' 6-max Seat #3 is the button
Seat 1: Karl Edgar ($11.99 in chips) 
Seat 2: ramseskat ($10.25 in chips) 
Seat 3: pepuch19 ($10.60 in chips) 
Seat 4: Dimitrii 30 ($8 in chips) 
Dimitrii 30: posts small blind $0.05
Viten'kA83: is sitting out 
sapr.549: is sitting out 
sapr.549 leaves the table
Karl Edgar: posts big blind $0.10
*** HOLE CARDS ***
Viten'kA83 leaves the table
ramseskat: folds 
pepuch19: folds 
Dimitrii 30: folds 
Uncalled bet ($0.05) returned to Karl Edgar
Karl Edgar collected $0.10 from pot
Karl Edgar: doesn't show hand 
*** SUMMARY ***
Total pot $0.10 | Rake $0 
Seat 1: Karl Edgar (big blind) collected ($0.10)
Seat 2: ramseskat folded before Flop (didn't bet)
Seat 3: pepuch19 (button) folded before Flop (didn't bet)
Seat 4: Dimitrii 30 (small blind) folded before Flop



PokerStars Hand #222963864436:  Hold'em No Limit ($0.05/$0.10 USD) - 2021/01/23 13:31:55 ET
Table 'Polydoros II' 6-max Seat #4 is the button
Seat 1: Karl Edgar ($12.04 in chips) 
Seat 2: ramseskat ($10.25 in chips) 
Seat 3: pepuch19 ($10.60 in chips) 
Seat 4: Dimitrii 30 ($8 in chips) 
Karl Edgar: posts small blind $0.05
ramseskat: posts big blind $0.10
*** HOLE CARDS ***
pepuch19: raises $0.20 to $0.30
Dimitrii 30: folds 
Karl Edgar: folds 
ramseskat: calls $0.20
*** FLOP *** [6s 6c 9h]
ramseskat: checks 
pepuch19: bets $0.33
ramseskat: folds 
Uncalled bet ($0.33) returned to pepuch19
pepuch19 collected $0.62 from pot
pepuch19: doesn't show hand 
*** SUMMARY ***
Total pot $0.65 | Rake $0.03 
Board [6s 6c 9h]
Seat 1: Karl Edgar (small blind) folded before Flop
Seat 2: ramseskat (big blind) folded on the Flop
Seat 3: pepuch19 collected ($0.62)
Seat 4: Dimitrii 30 (button) folded before Flop (didn't bet)



PokerStars Hand #222963877778:  Hold'em No Limit ($0.05/$0.10 USD) - 2021/01/23 13:32:12 ET
Table 'Polydoros II' 6-max Seat #1 is the button
Seat 1: Karl Edgar ($11.99 in chips) 
Seat 2: ramseskat ($10 in chips) 
Seat 3: pepuch19 ($10.92 in chips) 
Seat 4: Dimitrii 30 ($8 in chips) 
ramseskat: posts small blind $0.05
pepuch19: posts big blind $0.10
*** HOLE CARDS ***
Dimitrii 30: folds 
Karl Edgar: folds 
Timakas joins the table at seat #5 
ramseskat: folds 
Uncalled bet ($0.05) returned to pepuch19
pepuch19 collected $0.10 from pot
pepuch19: doesn't show hand 
*** SUMMARY ***
Total pot $0.10 | Rake $0 
Seat 1: Karl Edgar (button) folded before Flop (didn't bet)
Seat 2: ramseskat (small blind) folded before Flop
Seat 3: pepuch19 (big blind) collected ($0.10)
Seat 4: Dimitrii 30 folded before Flop (didn't bet)



PokerStars Hand #222963884116:  Hold'em No Limit ($0.05/$0.10 USD) - 2021/01/23 13:32:20 ET
Table 'Polydoros II' 6-max Seat #2 is the button
Seat 1: Karl Edgar ($11.99 in chips) 
Seat 2: ramseskat ($10 in chips) 
Seat 3: pepuch19 ($10.97 in chips) 
Seat 4: Dimitrii 30 ($8 in chips) 
Seat 5: Timakas ($4 in chips) 
pepuch19: posts small blind $0.05
Dimitrii 30: posts big blind $0.10
Timakas: posts big blind $0.10
*** HOLE CARDS ***
Timakas: raises $0.10 to $0.20
Karl Edgar: folds 
r.hamburg1994 joins the table at seat #6 
ramseskat: folds 
pepuch19: folds 
Dimitrii 30: folds 
Uncalled bet ($0.10) returned to Timakas
Timakas collected $0.25 from pot
Timakas: doesn't show hand 
*** SUMMARY ***
Total pot $0.25 | Rake $0 
Seat 1: Karl Edgar folded before Flop (didn't bet)
Seat 2: ramseskat (button) folded before Flop (didn't bet)
Seat 3: pepuch19 (small blind) folded before Flop
Seat 4: Dimitrii 30 (big blind) folded before Flop
Seat 5: Timakas collected ($0.25)



PokerStars Hand #222963891645:  Hold'em No Limit ($0.05/$0.10 USD) - 2021/01/23 13:32:29 ET
Table 'Polydoros II' 6-max Seat #3 is the button
Seat 1: Karl Edgar ($11.99 in chips) 
Seat 2: ramseskat ($10 in chips) 
Seat 3: pepuch19 ($10.92 in chips) 
Seat 4: Dimitrii 30 ($8 in chips) 
Seat 5: Timakas ($4.15 in chips) 
Dimitrii 30: posts small blind $0.05
Timakas: posts big blind $0.10
r.hamburg1994: sits out 
*** HOLE CARDS ***
Karl Edgar: folds 
ramseskat: raises $0.20 to $0.30
pepuch19: calls $0.30
Dimitrii 30: folds 
Timakas: calls $0.20
*** FLOP *** [3h 2s Qs]
Timakas: bets $0.20
ramseskat: folds 
pepuch19: calls $0.20
*** TURN *** [3h 2s Qs] [Ts]
r.hamburg1994 leaves the table
Timakas: bets $0.60
pepuch19: calls $0.60
*** RIVER *** [3h 2s Qs Ts] [5h]
super040 joins the table at seat #6 
Timakas: bets $3.05 and is all-in
pepuch19: calls $3.05
*** SHOW DOWN ***
Timakas: shows [6d 9s] (high card Queen)
pepuch19: shows [Qd Js] (a pair of Queens)
pepuch19 collected $8.26 from pot
*** SUMMARY ***
Total pot $8.65 | Rake $0.39 
Board [3h 2s Qs Ts 5h]
Seat 1: Karl Edgar folded before Flop (didn't bet)
Seat 2: ramseskat folded on the Flop
Seat 3: pepuch19 (button) showed [Qd Js] and won ($8.26) with a pair of Queens
Seat 4: Dimitrii 30 (small blind) folded before Flop
Seat 5: Timakas (big blind) showed [6d 9s] and lost with high card Queen



PokerStars Hand #222963958282:  Hold'em No Limit ($0.05/$0.10 USD) - 2021/01/23 13:33:55 ET
Table 'Polydoros II' 6-max Seat #4 is the button
Seat 1: Karl Edgar ($11.99 in chips) 
Seat 3: pepuch19 ($15.03 in chips) 
Seat 4: Dimitrii 30 ($8 in chips) 
Karl Edgar: posts small blind $0.05
ramseskat: is sitting out 
pepuch19: posts big blind $0.10
*** HOLE CARDS ***
Dimitrii 30: folds 
Karl Edgar: folds 
Uncalled bet ($0.05) returned to pepuch19
pepuch19 collected $0.10 from pot
pepuch19: doesn't show hand 
*** SUMMARY ***
Total pot $0.10 | Rake $0 
Seat 1: Karl Edgar (small blind) folded before Flop
Seat 3: pepuch19 (big blind) collected ($0.10)
Seat 4: Dimitrii 30 (button) folded before Flop (didn't bet)



PokerStars Hand #222963963773:  Hold'em No Limit ($0.05/$0.10 USD) - 2021/01/23 13:34:02 ET
Table 'Polydoros II' 6-max Seat #1 is the button
Seat 1: Karl Edgar ($11.94 in chips) 
Seat 3: pepuch19 ($15.08 in chips) 
Seat 4: Dimitrii 30 ($8 in chips) 
Seat 6: super040 ($4.60 in chips) 
pepuch19: posts small blind $0.05
Dimitrii 30: posts big blind $0.10
super040: posts big blind $0.10
*** HOLE CARDS ***
super040: checks 
Karl Edgar: folds 
pepuch19: raises $0.40 to $0.50
Dimitrii 30: folds 
super040: folds 
Uncalled bet ($0.40) returned to pepuch19
pepuch19 collected $0.30 from pot
pepuch19: doesn't show hand 
*** SUMMARY ***
Total pot $0.30 | Rake $0 
Seat 1: Karl Edgar (button) folded before Flop (didn't bet)
Seat 3: pepuch19 (small blind) collected ($0.30)
Seat 4: Dimitrii 30 (big blind) folded before Flop
Seat 6: super040 folded before Flop (didn't bet)



PokerStars Hand #222963977009:  Hold'em No Limit ($0.05/$0.10 USD) - 2021/01/23 13:34:19 ET
Table 'Polydoros II' 6-max Seat #3 is the button
Seat 1: Karl Edgar ($11.94 in chips) 
Seat 3: pepuch19 ($15.28 in chips) 
Seat 4: Dimitrii 30 ($8 in chips) 
Seat 5: Timakas ($4 in chips) 
Seat 6: super040 ($4.50 in chips) 
Dimitrii 30: posts small blind $0.05
Timakas: posts big blind $0.10
*** HOLE CARDS ***
super040: calls $0.10
Karl Edgar: folds 
pepuch19: folds 
Dimitrii 30: folds 
ramseskat leaves the table
Timakas: checks 
*** FLOP *** [Ks 5d Qs]
Timakas: checks 
super040: bets $0.10
cruxua joins the table at seat #2 
Timakas: folds 
Uncalled bet ($0.10) returned to super040
super040 collected $0.24 from pot
super040: doesn't show hand 
*** SUMMARY ***
Total pot $0.25 | Rake $0.01 
Board [Ks 5d Qs]
Seat 1: Karl Edgar folded before Flop (didn't bet)
Seat 3: pepuch19 (button) folded before Flop (didn't bet)
Seat 4: Dimitrii 30 (small blind) folded before Flop
Seat 5: Timakas (big blind) folded on the Flop
Seat 6: super040 collected ($0.24)



PokerStars Hand #222963997181:  Hold'em No Limit ($0.05/$0.10 USD) - 2021/01/23 13:34:45 ET
Table 'Polydoros II' 6-max Seat #4 is the button
Seat 1: Karl Edgar ($11.94 in chips) 
Seat 3: pepuch19 ($15.28 in chips) 
Seat 4: Dimitrii 30 ($8 in chips) 
Seat 5: Timakas ($3.90 in chips) 
Seat 6: super040 ($4.64 in chips) 
Timakas: posts small blind $0.05
super040: posts big blind $0.10
cruxua: sits out 
*** HOLE CARDS ***
Karl Edgar: raises $0.20 to $0.30
pepuch19: folds 
Dimitrii 30: folds 
Timakas: raises $0.30 to $0.60
super040: folds 
Karl Edgar: calls $0.30
*** FLOP *** [7h As Jd]
Timakas: bets $1.40
Karl Edgar: folds 
Uncalled bet ($1.40) returned to Timakas
Timakas collected $1.24 from pot
Timakas: doesn't show hand 
*** SUMMARY ***
Total pot $1.30 | Rake $0.06 
Board [7h As Jd]
Seat 1: Karl Edgar folded on the Flop
Seat 3: pepuch19 folded before Flop (didn't bet)
Seat 4: Dimitrii 30 (button) folded before Flop (didn't bet)
Seat 5: Timakas (small blind) collected ($1.24)
Seat 6: super040 (big blind) folded before Flop



PokerStars Hand #222964031884:  Hold'em No Limit ($0.05/$0.10 USD) - 2021/01/23 13:35:29 ET
Table 'Polydoros II' 6-max Seat #5 is the button
Seat 1: Karl Edgar ($11.34 in chips) 
Seat 3: pepuch19 ($15.28 in chips) 
Seat 4: Dimitrii 30 ($8 in chips) 
Seat 5: Timakas ($4.54 in chips) 
Seat 6: super040 ($4.54 in chips) 
super040: posts small blind $0.05
Karl Edgar: posts big blind $0.10
cruxua: sits out 
*** HOLE CARDS ***
pepuch19: raises $0.20 to $0.30
Dimitrii 30: folds 
Timakas: folds 
super040: folds 
Karl Edgar: folds 
Uncalled bet ($0.20) returned to pepuch19
pepuch19 collected $0.25 from pot
pepuch19: doesn't show hand 
*** SUMMARY ***
Total pot $0.25 | Rake $0 
Seat 1: Karl Edgar (big blind) folded before Flop
Seat 3: pepuch19 collected ($0.25)
Seat 4: Dimitrii 30 folded before Flop (didn't bet)
Seat 5: Timakas (button) folded before Flop (didn't bet)
Seat 6: super040 (small blind) folded before Flop



PokerStars Hand #222964041637:  Hold'em No Limit ($0.05/$0.10 USD) - 2021/01/23 13:35:42 ET
Table 'Polydoros II' 6-max Seat #6 is the button
Seat 1: Karl Edgar ($11.24 in chips) 
Seat 2: cruxua ($10 in chips) 
Seat 3: pepuch19 ($15.43 in chips) 
Seat 4: Dimitrii 30 ($8 in chips) 
Seat 5: Timakas ($4.54 in chips) 
Seat 6: super040 ($4.49 in chips) 
Karl Edgar: posts small blind $0.05
cruxua: posts big blind $0.10
*** HOLE CARDS ***
pepuch19: folds 
Dimitrii 30: folds 
Timakas: raises $0.10 to $0.20
super040: folds 
Karl Edgar: folds 
cruxua: folds 
Uncalled bet ($0.10) returned to Timakas
Timakas collected $0.25 from pot
Timakas: doesn't show hand 
*** SUMMARY ***
Total pot $0.25 | Rake $0 
Seat 1: Karl Edgar (small blind) folded before Flop
Seat 2: cruxua (big blind) folded before Flop
Seat 3: pepuch19 folded before Flop (didn't bet)
Seat 4: Dimitrii 30 folded before Flop (didn't bet)
Seat 5: Timakas collected ($0.25)
Seat 6: super040 (button) folded before Flop (didn't bet)



PokerStars Hand #222964051446:  Hold'em No Limit ($0.05/$0.10 USD) - 2021/01/23 13:35:55 ET
Table 'Polydoros II' 6-max Seat #1 is the button
Seat 1: Karl Edgar ($11.19 in chips) 
Seat 2: cruxua ($10 in chips) 
Seat 3: pepuch19 ($15.43 in chips) 
Seat 4: Dimitrii 30 ($8 in chips) 
Seat 5: Timakas ($4.69 in chips) 
Seat 6: super040 ($4.49 in chips) 
cruxua: posts small blind $0.05
pepuch19: posts big blind $0.10
*** HOLE CARDS ***
Dimitrii 30: folds 
Timakas: calls $0.10
super040: folds 
Karl Edgar: folds 
cruxua: folds 
pepuch19: checks 
*** FLOP *** [7s 4d Ah]
pepuch19: checks 
Timakas: bets $0.20
pepuch19: folds 
Uncalled bet ($0.20) returned to Timakas
Timakas collected $0.24 from pot
Timakas: doesn't show hand 
*** SUMMARY ***
Total pot $0.25 | Rake $0.01 
Board [7s 4d Ah]
Seat 1: Karl Edgar (button) folded before Flop (didn't bet)
Seat 2: cruxua (small blind) folded before Flop
Seat 3: pepuch19 (big blind) folded on the Flop
Seat 4: Dimitrii 30 folded before Flop (didn't bet)
Seat 5: Timakas collected ($0.24)
Seat 6: super040 folded before Flop (didn't bet)



PokerStars Hand #222964068089:  Hold'em No Limit ($0.05/$0.10 USD) - 2021/01/23 13:36:16 ET
Table 'Polydoros II' 6-max Seat #2 is the button
Seat 1: Karl Edgar ($11.19 in chips) 
Seat 2: cruxua ($10 in chips) 
Seat 3: pepuch19 ($15.33 in chips) 
Seat 4: Dimitrii 30 ($8 in chips) 
Seat 5: Timakas ($4.83 in chips) 
Seat 6: super040 ($4.49 in chips) 
pepuch19: posts small blind $0.05
Dimitrii 30: posts big blind $0.10
*** HOLE CARDS ***
Timakas: raises $0.20 to $0.30
super040: calls $0.30
Karl Edgar: folds 
cruxua: folds 
pepuch19: folds 
Dimitrii 30: folds 
*** FLOP *** [Td 5h 4d]
Timakas: checks 
super040: bets $0.40
Timakas: folds 
Uncalled bet ($0.40) returned to super040
super040 collected $0.72 from pot
super040: doesn't show hand 
*** SUMMARY ***
Total pot $0.75 | Rake $0.03 
Board [Td 5h 4d]
Seat 1: Karl Edgar folded before Flop (didn't bet)
Seat 2: cruxua (button) folded before Flop (didn't bet)
Seat 3: pepuch19 (small blind) folded before Flop
Seat 4: Dimitrii 30 (big blind) folded before Flop
Seat 5: Timakas folded on the Flop
Seat 6: super040 collected ($0.72)



PokerStars Hand #222964100220:  Hold'em No Limit ($0.05/$0.10 USD) - 2021/01/23 13:36:58 ET
Table 'Polydoros II' 6-max Seat #3 is the button
Seat 1: Karl Edgar ($11.19 in chips) 
Seat 2: cruxua ($10 in chips) 
Seat 3: pepuch19 ($15.28 in chips) 
Seat 4: Dimitrii 30 ($8 in chips) 
Seat 5: Timakas ($4.53 in chips) 
Seat 6: super040 ($4.91 in chips) 
Dimitrii 30: posts small blind $0.05
Timakas: posts big blind $0.10
*** HOLE CARDS ***
super040: folds 
Karl Edgar: raises $0.20 to $0.30
cruxua: folds 
pepuch19: folds 
Dimitrii 30: folds 
Timakas: raises $0.20 to $0.50
Karl Edgar: calls $0.20
*** FLOP *** [9h 4c 3h]
Timakas: bets $0.50
Karl Edgar: folds 
Uncalled bet ($0.50) returned to Timakas
Timakas collected $1 from pot
Timakas: doesn't show hand 
*** SUMMARY ***
Total pot $1.05 | Rake $0.05 
Board [9h 4c 3h]
Seat 1: Karl Edgar folded on the Flop
Seat 2: cruxua folded before Flop (didn't bet)
Seat 3: pepuch19 (button) folded before Flop (didn't bet)
Seat 4: Dimitrii 30 (small blind) folded before Flop
Seat 5: Timakas (big blind) collected ($1)
Seat 6: super040 folded before Flop (didn't bet)



PokerStars Hand #222964118726:  Hold'em No Limit ($0.05/$0.10 USD) - 2021/01/23 13:37:22 ET
Table 'Polydoros II' 6-max Seat #4 is the button
Seat 1: Karl Edgar ($10.69 in chips) 
Seat 2: cruxua ($10 in chips) 
Seat 3: pepuch19 ($15.28 in chips) 
Seat 4: Dimitrii 30 ($8 in chips) 
Seat 5: Timakas ($5.03 in chips) 
Seat 6: super040 ($4.91 in chips) 
Timakas: posts small blind $0.05
super040: posts big blind $0.10
*** HOLE CARDS ***
Karl Edgar: raises $0.20 to $0.30
cruxua: folds 
pepuch19: folds 
Dimitrii 30: folds 
Timakas: calls $0.25
super040: folds 
*** FLOP *** [9s Ts 6c]
Timakas: bets $0.20
Karl Edgar: raises $0.50 to $0.70
Timakas: calls $0.50
*** TURN *** [9s Ts 6c] [Ah]
Timakas: bets $0.80
Karl Edgar: calls $0.80
*** RIVER *** [9s Ts 6c Ah] [3c]
Timakas: bets $3.23 and is all-in
Karl Edgar: calls $3.23
*** SHOW DOWN ***
Timakas: shows [7s Js] (high card Ace)
Karl Edgar: shows [Qh Th] (a pair of Tens)
Karl Edgar collected $9.70 from pot
*** SUMMARY ***
Total pot $10.16 | Rake $0.46 
Board [9s Ts 6c Ah 3c]
Seat 1: Karl Edgar showed [Qh Th] and won ($9.70) with a pair of Tens
Seat 2: cruxua folded before Flop (didn't bet)
Seat 3: pepuch19 folded before Flop (didn't bet)
Seat 4: Dimitrii 30 (button) folded before Flop (didn't bet)
Seat 5: Timakas (small blind) showed [7s Js] and lost with high card Ace
Seat 6: super040 (big blind) folded before Flop



PokerStars Hand #222964147774:  Hold'em No Limit ($0.05/$0.10 USD) - 2021/01/23 13:37:59 ET
Table 'Polydoros II' 6-max Seat #6 is the button
Seat 1: Karl Edgar ($15.36 in chips) 
Seat 2: cruxua ($10 in chips) 
Seat 3: pepuch19 ($15.28 in chips) 
Seat 4: Dimitrii 30 ($8 in chips) 
Seat 6: super040 ($4.81 in chips) 
Karl Edgar: posts small blind $0.05
cruxua: posts big blind $0.10
*** HOLE CARDS ***
pepuch19: raises $0.20 to $0.30
Timakas leaves the table
Dimitrii 30: raises $0.60 to $0.90
super040: folds 
uterkrm.ua joins the table at seat #5 
Karl Edgar: folds 
cruxua: folds 
pepuch19: calls $0.60
*** FLOP *** [9c 8s Tc]
pepuch19: checks 
Dimitrii 30: bets $0.93
pepuch19: folds 
Uncalled bet ($0.93) returned to Dimitrii 30
Dimitrii 30 collected $1.86 from pot
Dimitrii 30: doesn't show hand 
*** SUMMARY ***
Total pot $1.95 | Rake $0.09 
Board [9c 8s Tc]
Seat 1: Karl Edgar (small blind) folded before Flop
Seat 2: cruxua (big blind) folded before Flop
Seat 3: pepuch19 folded on the Flop
Seat 4: Dimitrii 30 collected ($1.86)
Seat 6: super040 (button) folded before Flop (didn't bet)



PokerStars Hand #222964174046:  Hold'em No Limit ($0.05/$0.10 USD) - 2021/01/23 13:38:33 ET
Table 'Polydoros II' 6-max Seat #1 is the button
Seat 1: Karl Edgar ($15.31 in chips) 
Seat 2: cruxua ($10 in chips) 
Seat 3: pepuch19 ($14.38 in chips) 
Seat 4: Dimitrii 30 ($8.96 in chips) 
Seat 6: super040 ($4.81 in chips) 
cruxua: posts small blind $0.05
pepuch19: posts big blind $0.10
uterkrm.ua: sits out 
*** HOLE CARDS ***
Dimitrii 30: folds 
super040: folds 
Karl Edgar: folds 
cruxua: folds 
Uncalled bet ($0.05) returned to pepuch19
pepuch19 collected $0.10 from pot
pepuch19: doesn't show hand 
*** SUMMARY ***
Total pot $0.10 | Rake $0 
Seat 1: Karl Edgar (button) folded before Flop (didn't bet)
Seat 2: cruxua (small blind) folded before Flop
Seat 3: pepuch19 (big blind) collected ($0.10)
Seat 4: Dimitrii 30 folded before Flop (didn't bet)
Seat 6: super040 folded before Flop (didn't bet)



PokerStars Hand #222964183184:  Hold'em No Limit ($0.05/$0.10 USD) - 2021/01/23 13:38:45 ET
Table 'Polydoros II' 6-max Seat #2 is the button
Seat 1: Karl Edgar ($15.31 in chips) 
Seat 2: cruxua ($10 in chips) 
Seat 3: pepuch19 ($14.43 in chips) 
Seat 4: Dimitrii 30 ($8.96 in chips) 
Seat 6: super040 ($4.81 in chips) 
pepuch19: posts small blind $0.05
Dimitrii 30: posts big blind $0.10
uterkrm.ua: sits out 
*** HOLE CARDS ***
super040: folds 
Karl Edgar: raises $0.15 to $0.25
cruxua: folds 
pepuch19: folds 
Dimitrii 30: calls $0.15
*** FLOP *** [Kc Kd 5d]
Dimitrii 30: checks 
Karl Edgar: bets $0.27
Dimitrii 30: calls $0.27
*** TURN *** [Kc Kd 5d] [Qh]
Dimitrii 30: checks 
Karl Edgar: bets $0.60
Dimitrii 30: folds 
Uncalled bet ($0.60) returned to Karl Edgar
Karl Edgar collected $1.04 from pot
Karl Edgar: doesn't show hand 
*** SUMMARY ***
Total pot $1.09 | Rake $0.05 
Board [Kc Kd 5d Qh]
Seat 1: Karl Edgar collected ($1.04)
Seat 2: cruxua (button) folded before Flop (didn't bet)
Seat 3: pepuch19 (small blind) folded before Flop
Seat 4: Dimitrii 30 (big blind) folded on the Turn
Seat 6: super040 folded before Flop (didn't bet)



PokerStars Hand #222964212428:  Hold'em No Limit ($0.05/$0.10 USD) - 2021/01/23 13:39:23 ET
Table 'Polydoros II' 6-max Seat #3 is the button
Seat 1: Karl Edgar ($15.83 in chips) 
Seat 2: cruxua ($10 in chips) 
Seat 3: pepuch19 ($14.38 in chips) 
Seat 4: Dimitrii 30 ($8.44 in chips) 
Seat 5: uterkrm.ua ($10 in chips) 
Seat 6: super040 ($4.81 in chips) 
Dimitrii 30: posts small blind $0.05
uterkrm.ua: posts big blind $0.10
*** HOLE CARDS ***
super040 has timed out
super040: folds 
Karl Edgar: folds 
cruxua: raises $0.20 to $0.30
pepuch19: calls $0.30
Dimitrii 30: folds 
uterkrm.ua: folds 
*** FLOP *** [5d Qc 7h]
cruxua: bets $0.54
pepuch19: folds 
Uncalled bet ($0.54) returned to cruxua
cruxua collected $0.72 from pot
cruxua: doesn't show hand 
*** SUMMARY ***
Total pot $0.75 | Rake $0.03 
Board [5d Qc 7h]
Seat 1: Karl Edgar folded before Flop (didn't bet)
Seat 2: cruxua collected ($0.72)
Seat 3: pepuch19 (button) folded on the Flop
Seat 4: Dimitrii 30 (small blind) folded before Flop
Seat 5: uterkrm.ua (big blind) folded before Flop
Seat 6: super040 folded before Flop (didn't bet)



PokerStars Hand #222964236732:  Hold'em No Limit ($0.05/$0.10 USD) - 2021/01/23 13:39:54 ET
Table 'Polydoros II' 6-max Seat #4 is the button
Seat 1: Karl Edgar ($15.83 in chips) 
Seat 2: cruxua ($10.42 in chips) 
Seat 3: pepuch19 ($14.08 in chips) 
Seat 4: Dimitrii 30 ($8.39 in chips) 
Seat 5: uterkrm.ua ($10 in chips) 
Seat 6: super040 ($4.81 in chips) 
uterkrm.ua: posts small blind $0.05
super040: posts big blind $0.10
*** HOLE CARDS ***
Karl Edgar: raises $0.20 to $0.30
cruxua: folds 
pepuch19: folds 
Dimitrii 30: folds 
uterkrm.ua: folds 
super040: calls $0.20
*** FLOP *** [Kd Ad 4s]
super040: bets $0.10
Karl Edgar: raises $0.30 to $0.40
super040: folds 
Uncalled bet ($0.30) returned to Karl Edgar
Karl Edgar collected $0.81 from pot
Karl Edgar: doesn't show hand 
*** SUMMARY ***
Total pot $0.85 | Rake $0.04 
Board [Kd Ad 4s]
Seat 1: Karl Edgar collected ($0.81)
Seat 2: cruxua folded before Flop (didn't bet)
Seat 3: pepuch19 folded before Flop (didn't bet)
Seat 4: Dimitrii 30 (button) folded before Flop (didn't bet)
Seat 5: uterkrm.ua (small blind) folded before Flop
Seat 6: super040 (big blind) folded on the Flop



PokerStars Hand #222964254212:  Hold'em No Limit ($0.05/$0.10 USD) - 2021/01/23 13:40:17 ET
Table 'Polydoros II' 6-max Seat #5 is the button
Seat 1: Karl Edgar ($16.24 in chips) 
Seat 2: cruxua ($10.42 in chips) 
Seat 3: pepuch19 ($14.08 in chips) 
Seat 4: Dimitrii 30 ($8.39 in chips) 
Seat 5: uterkrm.ua ($10 in chips) 
Seat 6: super040 ($4.41 in chips) 
super040: posts small blind $0.05
Karl Edgar: posts big blind $0.10
*** HOLE CARDS ***
cruxua: folds 
pepuch19: folds 
Dimitrii 30: folds 
cruxua leaves the table
uterkrm.ua: folds 
super040: calls $0.05
Karl Edgar: checks 
*** FLOP *** [Kc Td Jh]
super040: checks 
Karl Edgar: checks 
*** TURN *** [Kc Td Jh] [Jc]
super040: checks 
cranecatcher joins the table at seat #2 
Karl Edgar: bets $0.10
super040: folds 
Uncalled bet ($0.10) returned to Karl Edgar
Karl Edgar collected $0.19 from pot
Karl Edgar: doesn't show hand 
*** SUMMARY ***
Total pot $0.20 | Rake $0.01 
Board [Kc Td Jh Jc]
Seat 1: Karl Edgar (big blind) collected ($0.19)
Seat 2: cruxua folded before Flop (didn't bet)
Seat 3: pepuch19 folded before Flop (didn't bet)
Seat 4: Dimitrii 30 folded before Flop (didn't bet)
Seat 5: uterkrm.ua (button) folded before Flop (didn't bet)
Seat 6: super040 (small blind) folded on the Turn



PokerStars Hand #222964270515:  Hold'em No Limit ($0.05/$0.10 USD) - 2021/01/23 13:40:38 ET
Table 'Polydoros II' 6-max Seat #6 is the button
Seat 1: Karl Edgar ($16.33 in chips) 
Seat 2: cranecatcher ($10 in chips) 
Seat 3: pepuch19 ($14.08 in chips) 
Seat 4: Dimitrii 30 ($8.39 in chips) 
Seat 5: uterkrm.ua ($10 in chips) 
Seat 6: super040 ($4.31 in chips) 
Karl Edgar: posts small blind $0.05
cranecatcher: posts big blind $0.10
*** HOLE CARDS ***
pepuch19: folds 
Dimitrii 30: folds 
uterkrm.ua has timed out
uterkrm.ua: folds 
super040: calls $0.10
Karl Edgar: folds 
uterkrm.ua leaves the table
cranecatcher: checks 
*** FLOP *** [2s 7c Kd]
cranecatcher: checks 
super040: bets $0.10
cranecatcher: calls $0.10
*** TURN *** [2s 7c Kd] [9c]
cranecatcher: checks 
super040: bets $0.10
cranecatcher: calls $0.10
*** RIVER *** [2s 7c Kd 9c] [Jd]
cranecatcher: checks 
super040: bets $0.30
cranecatcher: calls $0.30
*** SHOW DOWN ***
super040: shows [Jh Js] (three of a kind, Jacks)
cranecatcher: mucks hand 
super040 collected $1.19 from pot
*** SUMMARY ***
Total pot $1.25 | Rake $0.06 
Board [2s 7c Kd 9c Jd]
Seat 1: Karl Edgar (small blind) folded before Flop
Seat 2: cranecatcher (big blind) mucked
Seat 3: pepuch19 folded before Flop (didn't bet)
Seat 4: Dimitrii 30 folded before Flop (didn't bet)
Seat 5: uterkrm.ua folded before Flop (didn't bet)
Seat 6: super040 (button) showed [Jh Js] and won ($1.19) with three of a kind, Jacks



PokerStars Hand #222964303820:  Hold'em No Limit ($0.05/$0.10 USD) - 2021/01/23 13:41:21 ET
Table 'Polydoros II' 6-max Seat #1 is the button
Seat 1: Karl Edgar ($16.28 in chips) 
Seat 2: cranecatcher ($10 in chips) 
Seat 3: pepuch19 ($14.08 in chips) 
Seat 4: Dimitrii 30 ($8.39 in chips) 
Seat 6: super040 ($4.90 in chips) 
cranecatcher: posts small blind $0.05
pepuch19: posts big blind $0.10
*** HOLE CARDS ***
kostya17380 joins the table at seat #5 
Dimitrii 30: folds 
super040: calls $0.10
Karl Edgar: raises $0.30 to $0.40
cranecatcher: folds 
pepuch19: raises $1 to $1.40
super040: folds 
Karl Edgar: folds 
Uncalled bet ($1) returned to pepuch19
pepuch19 collected $0.95 from pot
pepuch19: doesn't show hand 
*** SUMMARY ***
Total pot $0.95 | Rake $0 
Seat 1: Karl Edgar (button) folded before Flop
Seat 2: cranecatcher (small blind) folded before Flop
Seat 3: pepuch19 (big blind) collected ($0.95)
Seat 4: Dimitrii 30 folded before Flop (didn't bet)
Seat 6: super040 folded before Flop



PokerStars Hand #222964320568:  Hold'em No Limit ($0.05/$0.10 USD) - 2021/01/23 13:41:42 ET
Table 'Polydoros II' 6-max Seat #2 is the button
Seat 1: Karl Edgar ($15.88 in chips) 
Seat 2: cranecatcher ($10 in chips) 
Seat 3: pepuch19 ($14.63 in chips) 
Seat 4: Dimitrii 30 ($8.39 in chips) 
Seat 6: super040 ($4.80 in chips) 
pepuch19: posts small blind $0.05
Dimitrii 30: posts big blind $0.10
kostya17380: sits out 
*** HOLE CARDS ***
super040: calls $0.10
Karl Edgar: folds 
cranecatcher: folds 
pepuch19: calls $0.05
Dimitrii 30: checks 
*** FLOP *** [5c 5h 2c]
pepuch19: checks 
Dimitrii 30: checks 
super040: bets $0.20
pepuch19: folds 
Dimitrii 30: folds 
Uncalled bet ($0.20) returned to super040
super040 collected $0.29 from pot
super040: doesn't show hand 
*** SUMMARY ***
Total pot $0.30 | Rake $0.01 
Board [5c 5h 2c]
Seat 1: Karl Edgar folded before Flop (didn't bet)
Seat 2: cranecatcher (button) folded before Flop (didn't bet)
Seat 3: pepuch19 (small blind) folded on the Flop
Seat 4: Dimitrii 30 (big blind) folded on the Flop
Seat 6: super040 collected ($0.29)



PokerStars Hand #222964640214:  Hold'em No Limit ($0.05/$0.10 USD) - 2021/01/23 13:48:31 ET
Table 'Polydoros II' 6-max Seat #4 is the button
Seat 1: Karl Edgar ($13.68 in chips) 
Seat 2: cranecatcher ($12.93 in chips) 
Seat 3: pepuch19 ($14.38 in chips) 
Seat 4: Dimitrii 30 ($8 in chips) 
Seat 5: kostya17380 ($10.05 in chips) 
kostya17380: posts small blind $0.05
Karl Edgar: posts big blind $0.10
*** HOLE CARDS ***
cranecatcher: folds 
pepuch19: folds 
Dimitrii 30: folds 
kostya17380: raises $0.20 to $0.30
Karl Edgar: folds 
Uncalled bet ($0.20) returned to kostya17380
kostya17380 collected $0.20 from pot
kostya17380: doesn't show hand 
*** SUMMARY ***
Total pot $0.20 | Rake $0 
Seat 1: Karl Edgar (big blind) folded before Flop
Seat 2: cranecatcher folded before Flop (didn't bet)
Seat 3: pepuch19 folded before Flop (didn't bet)
Seat 4: Dimitrii 30 (button) folded before Flop (didn't bet)
Seat 5: kostya17380 (small blind) collected ($0.20)



PokerStars Hand #222964657456:  Hold'em No Limit ($0.05/$0.10 USD) - 2021/01/23 13:48:53 ET
Table 'Polydoros II' 6-max Seat #5 is the button
Seat 1: Karl Edgar ($13.58 in chips) 
Seat 2: cranecatcher ($12.93 in chips) 
Seat 3: pepuch19 ($14.38 in chips) 
Seat 4: Dimitrii 30 ($8 in chips) 
Seat 5: kostya17380 ($10.15 in chips) 
Karl Edgar: posts small blind $0.05
cranecatcher: posts big blind $0.10
*** HOLE CARDS ***
pepuch19: folds 
Dimitrii 30: folds 
kostya17380: raises $0.15 to $0.25
Karl Edgar: folds 
cranecatcher: calls $0.15
*** FLOP *** [Kh 7h 9c]
cranecatcher: checks 
kostya17380: bets $0.27
cranecatcher: calls $0.27
*** TURN *** [Kh 7h 9c] [Qd]
cranecatcher: checks 
kostya17380: bets $0.50
cranecatcher: folds 
Uncalled bet ($0.50) returned to kostya17380
kostya17380 collected $1.04 from pot
kostya17380: doesn't show hand 
*** SUMMARY ***
Total pot $1.09 | Rake $0.05 
Board [Kh 7h 9c Qd]
Seat 1: Karl Edgar (small blind) folded before Flop
Seat 2: cranecatcher (big blind) folded on the Turn
Seat 3: pepuch19 folded before Flop (didn't bet)
Seat 4: Dimitrii 30 folded before Flop (didn't bet)
Seat 5: kostya17380 (button) collected ($1.04)



PokerStars Hand #222964680685:  Hold'em No Limit ($0.05/$0.10 USD) - 2021/01/23 13:49:24 ET
Table 'Polydoros II' 6-max Seat #1 is the button
Seat 1: Karl Edgar ($13.53 in chips) 
Seat 2: cranecatcher ($12.41 in chips) 
Seat 3: pepuch19 ($14.38 in chips) 
Seat 4: Dimitrii 30 ($8 in chips) 
Seat 5: kostya17380 ($10.67 in chips) 
cranecatcher: posts small blind $0.05
pepuch19: posts big blind $0.10
super040: sits out 
*** HOLE CARDS ***
Dimitrii 30: folds 
kostya17380: raises $0.20 to $0.30
Karl Edgar: folds 
cranecatcher: folds 
pepuch19: folds 
Uncalled bet ($0.20) returned to kostya17380
kostya17380 collected $0.25 from pot
kostya17380: doesn't show hand 
*** SUMMARY ***
Total pot $0.25 | Rake $0 
Seat 1: Karl Edgar (button) folded before Flop (didn't bet)
Seat 2: cranecatcher (small blind) folded before Flop
Seat 3: pepuch19 (big blind) folded before Flop
Seat 4: Dimitrii 30 folded before Flop (didn't bet)
Seat 5: kostya17380 collected ($0.25)



PokerStars Hand #222964694173:  Hold'em No Limit ($0.05/$0.10 USD) - 2021/01/23 13:49:41 ET
Table 'Polydoros II' 6-max Seat #2 is the button
Seat 1: Karl Edgar ($13.53 in chips) 
Seat 2: cranecatcher ($12.36 in chips) 
Seat 3: pepuch19 ($14.28 in chips) 
Seat 4: Dimitrii 30 ($8 in chips) 
Seat 5: kostya17380 ($10.82 in chips) 
pepuch19: posts small blind $0.05
Dimitrii 30: posts big blind $0.10
super040: sits out 
*** HOLE CARDS ***
kostya17380: folds 
super040 leaves the table
Karl Edgar: folds 
cranecatcher: folds 
pepuch19: folds 
Uncalled bet ($0.05) returned to Dimitrii 30
Dimitrii 30 collected $0.10 from pot
Dimitrii 30: doesn't show hand 
*** SUMMARY ***
Total pot $0.10 | Rake $0 
Seat 1: Karl Edgar folded before Flop (didn't bet)
Seat 2: cranecatcher (button) folded before Flop (didn't bet)
Seat 3: pepuch19 (small blind) folded before Flop
Seat 4: Dimitrii 30 (big blind) collected ($0.10)
Seat 5: kostya17380 folded before Flop (didn't bet)



PokerStars Hand #222964703725:  Hold'em No Limit ($0.05/$0.10 USD) - 2021/01/23 13:49:54 ET
Table 'Polydoros II' 6-max Seat #3 is the button
Seat 1: Karl Edgar ($13.53 in chips) 
Seat 2: cranecatcher ($12.36 in chips) 
Seat 3: pepuch19 ($14.23 in chips) 
Seat 4: Dimitrii 30 ($8.05 in chips) 
Seat 5: kostya17380 ($10.82 in chips) 
Dimitrii 30: posts small blind $0.05
kostya17380: posts big blind $0.10
*** HOLE CARDS ***
Karl Edgar: folds 
cranecatcher: folds 
pepuch19: folds 
Tony Zhukov joins the table at seat #6 
Dimitrii 30: raises $0.20 to $0.30
kostya17380: folds 
Uncalled bet ($0.20) returned to Dimitrii 30
Dimitrii 30 collected $0.20 from pot
Dimitrii 30: doesn't show hand 
*** SUMMARY ***
Total pot $0.20 | Rake $0 
Seat 1: Karl Edgar folded before Flop (didn't bet)
Seat 2: cranecatcher folded before Flop (didn't bet)
Seat 3: pepuch19 (button) folded before Flop (didn't bet)
Seat 4: Dimitrii 30 (small blind) collected ($0.20)
Seat 5: kostya17380 (big blind) folded before Flop



PokerStars Hand #222964717596:  Hold'em No Limit ($0.05/$0.10 USD) - 2021/01/23 13:50:12 ET
Table 'Polydoros II' 6-max Seat #4 is the button
Seat 1: Karl Edgar ($13.53 in chips) 
Seat 2: cranecatcher ($12.36 in chips) 
Seat 3: pepuch19 ($14.23 in chips) 
Seat 4: Dimitrii 30 ($8.15 in chips) 
Seat 5: kostya17380 ($10.72 in chips) 
Seat 6: Tony Zhukov ($10 in chips) 
kostya17380: posts small blind $0.05
Tony Zhukov: posts big blind $0.10
*** HOLE CARDS ***
Karl Edgar: folds 
cranecatcher: folds 
pepuch19: raises $0.20 to $0.30
Dimitrii 30: folds 
kostya17380: folds 
Tony Zhukov: calls $0.20
*** FLOP *** [6d 5c 6c]
Tony Zhukov: checks 
pepuch19: bets $0.33
Tony Zhukov: folds 
Uncalled bet ($0.33) returned to pepuch19
pepuch19 collected $0.62 from pot
pepuch19: doesn't show hand 
*** SUMMARY ***
Total pot $0.65 | Rake $0.03 
Board [6d 5c 6c]
Seat 1: Karl Edgar folded before Flop (didn't bet)
Seat 2: cranecatcher folded before Flop (didn't bet)
Seat 3: pepuch19 collected ($0.62)
Seat 4: Dimitrii 30 (button) folded before Flop (didn't bet)
Seat 5: kostya17380 (small blind) folded before Flop
Seat 6: Tony Zhukov (big blind) folded on the Flop



PokerStars Hand #222964744209:  Hold'em No Limit ($0.05/$0.10 USD) - 2021/01/23 13:50:47 ET
Table 'Polydoros II' 6-max Seat #5 is the button
Seat 1: Karl Edgar ($13.53 in chips) 
Seat 2: cranecatcher ($12.36 in chips) 
Seat 3: pepuch19 ($14.55 in chips) 
Seat 4: Dimitrii 30 ($8.15 in chips) 
Seat 5: kostya17380 ($10.67 in chips) 
Seat 6: Tony Zhukov ($10 in chips) 
Tony Zhukov: posts small blind $0.05
Karl Edgar: posts big blind $0.10
*** HOLE CARDS ***
cranecatcher: raises $0.20 to $0.30
pepuch19: folds 
Dimitrii 30: folds 
kostya17380: folds 
Tony Zhukov: folds 
Karl Edgar: folds 
Uncalled bet ($0.20) returned to cranecatcher
cranecatcher collected $0.25 from pot
cranecatcher: doesn't show hand 
*** SUMMARY ***
Total pot $0.25 | Rake $0 
Seat 1: Karl Edgar (big blind) folded before Flop
Seat 2: cranecatcher collected ($0.25)
Seat 3: pepuch19 folded before Flop (didn't bet)
Seat 4: Dimitrii 30 folded before Flop (didn't bet)
Seat 5: kostya17380 (button) folded before Flop (didn't bet)
Seat 6: Tony Zhukov (small blind) folded before Flop



PokerStars Hand #222964757258:  Hold'em No Limit ($0.05/$0.10 USD) - 2021/01/23 13:51:04 ET
Table 'Polydoros II' 6-max Seat #6 is the button
Seat 1: Karl Edgar ($13.43 in chips) 
Seat 2: cranecatcher ($12.51 in chips) 
Seat 3: pepuch19 ($14.55 in chips) 
Seat 4: Dimitrii 30 ($8.15 in chips) 
Seat 5: kostya17380 ($10.67 in chips) 
Seat 6: Tony Zhukov ($10 in chips) 
Karl Edgar: posts small blind $0.05
cranecatcher: posts big blind $0.10
*** HOLE CARDS ***
pepuch19: folds 
Dimitrii 30: raises $0.15 to $0.25
kostya17380: folds 
Tony Zhukov: folds 
Karl Edgar: calls $0.20
cranecatcher: calls $0.15
*** FLOP *** [Qs 8h 8s]
Karl Edgar: checks 
cranecatcher: checks 
Dimitrii 30: bets $0.70
Karl Edgar: folds 
cranecatcher: folds 
Uncalled bet ($0.70) returned to Dimitrii 30
Dimitrii 30 collected $0.72 from pot
Dimitrii 30: doesn't show hand 
*** SUMMARY ***
Total pot $0.75 | Rake $0.03 
Board [Qs 8h 8s]
Seat 1: Karl Edgar (small blind) folded on the Flop
Seat 2: cranecatcher (big blind) folded on the Flop
Seat 3: pepuch19 folded before Flop (didn't bet)
Seat 4: Dimitrii 30 collected ($0.72)
Seat 5: kostya17380 folded before Flop (didn't bet)
Seat 6: Tony Zhukov (button) folded before Flop (didn't bet)



PokerStars Hand #222964783427:  Hold'em No Limit ($0.05/$0.10 USD) - 2021/01/23 13:51:38 ET
Table 'Polydoros II' 6-max Seat #1 is the button
Seat 1: Karl Edgar ($13.18 in chips) 
Seat 2: cranecatcher ($12.26 in chips) 
Seat 3: pepuch19 ($14.55 in chips) 
Seat 4: Dimitrii 30 ($8.62 in chips) 
Seat 5: kostya17380 ($10.67 in chips) 
Seat 6: Tony Zhukov ($10 in chips) 
cranecatcher: posts small blind $0.05
pepuch19: posts big blind $0.10
*** HOLE CARDS ***
Dimitrii 30: folds 
kostya17380: folds 
Tony Zhukov: folds 
Karl Edgar: folds 
cranecatcher: folds 
Uncalled bet ($0.05) returned to pepuch19
pepuch19 collected $0.10 from pot
pepuch19: doesn't show hand 
*** SUMMARY ***
Total pot $0.10 | Rake $0 
Seat 1: Karl Edgar (button) folded before Flop (didn't bet)
Seat 2: cranecatcher (small blind) folded before Flop
Seat 3: pepuch19 (big blind) collected ($0.10)
Seat 4: Dimitrii 30 folded before Flop (didn't bet)
Seat 5: kostya17380 folded before Flop (didn't bet)
Seat 6: Tony Zhukov folded before Flop (didn't bet)



PokerStars Hand #222964796285:  Hold'em No Limit ($0.05/$0.10 USD) - 2021/01/23 13:51:55 ET
Table 'Polydoros II' 6-max Seat #2 is the button
Seat 1: Karl Edgar ($13.18 in chips) 
Seat 2: cranecatcher ($12.21 in chips) 
Seat 3: pepuch19 ($14.60 in chips) 
Seat 4: Dimitrii 30 ($8.62 in chips) 
Seat 5: kostya17380 ($10.67 in chips) 
Seat 6: Tony Zhukov ($10 in chips) 
pepuch19: posts small blind $0.05
Dimitrii 30: posts big blind $0.10
*** HOLE CARDS ***
kostya17380: folds 
Tony Zhukov: folds 
Karl Edgar: folds 
cranecatcher: raises $0.20 to $0.30
pepuch19: folds 
Dimitrii 30: folds 
Uncalled bet ($0.20) returned to cranecatcher
cranecatcher collected $0.25 from pot
cranecatcher: doesn't show hand 
*** SUMMARY ***
Total pot $0.25 | Rake $0 
Seat 1: Karl Edgar folded before Flop (didn't bet)
Seat 2: cranecatcher (button) collected ($0.25)
Seat 3: pepuch19 (small blind) folded before Flop
Seat 4: Dimitrii 30 (big blind) folded before Flop
Seat 5: kostya17380 folded before Flop (didn't bet)
Seat 6: Tony Zhukov folded before Flop (didn't bet)



PokerStars Hand #222964804585:  Hold'em No Limit ($0.05/$0.10 USD) - 2021/01/23 13:52:06 ET
Table 'Polydoros II' 6-max Seat #3 is the button
Seat 1: Karl Edgar ($13.18 in chips) 
Seat 2: cranecatcher ($12.36 in chips) 
Seat 3: pepuch19 ($14.55 in chips) 
Seat 4: Dimitrii 30 ($8.52 in chips) 
Seat 5: kostya17380 ($10.67 in chips) 
Seat 6: Tony Zhukov ($10 in chips) 
Dimitrii 30: posts small blind $0.05
kostya17380: posts big blind $0.10
*** HOLE CARDS ***
Tony Zhukov: raises $0.15 to $0.25
Karl Edgar: calls $0.25
cranecatcher: calls $0.25
pepuch19: folds 
Dimitrii 30: folds 
kostya17380: folds 
*** FLOP *** [2d 4s 8c]
Tony Zhukov: checks 
Karl Edgar: checks 
cranecatcher: bets $0.43
Tony Zhukov: folds 
Karl Edgar: folds 
Uncalled bet ($0.43) returned to cranecatcher
cranecatcher collected $0.86 from pot
cranecatcher: doesn't show hand 
*** SUMMARY ***
Total pot $0.90 | Rake $0.04 
Board [2d 4s 8c]
Seat 1: Karl Edgar folded on the Flop
Seat 2: cranecatcher collected ($0.86)
Seat 3: pepuch19 (button) folded before Flop (didn't bet)
Seat 4: Dimitrii 30 (small blind) folded before Flop
Seat 5: kostya17380 (big blind) folded before Flop
Seat 6: Tony Zhukov folded on the Flop



PokerStars Hand #222964827571:  Hold'em No Limit ($0.05/$0.10 USD) - 2021/01/23 13:52:36 ET
Table 'Polydoros II' 6-max Seat #4 is the button
Seat 1: Karl Edgar ($12.93 in chips) 
Seat 2: cranecatcher ($12.97 in chips) 
Seat 3: pepuch19 ($14.55 in chips) 
Seat 4: Dimitrii 30 ($8.47 in chips) 
Seat 5: kostya17380 ($10.57 in chips) 
Seat 6: Tony Zhukov ($10 in chips) 
kostya17380: posts small blind $0.05
Tony Zhukov: posts big blind $0.10
*** HOLE CARDS ***
Karl Edgar: folds 
cranecatcher: folds 
pepuch19: folds 
Dimitrii 30: raises $0.15 to $0.25
kostya17380: raises $0.85 to $1.10
Tony Zhukov: folds 
Dimitrii 30: folds 
Uncalled bet ($0.85) returned to kostya17380
kostya17380 collected $0.60 from pot
kostya17380: doesn't show hand 
*** SUMMARY ***
Total pot $0.60 | Rake $0 
Seat 1: Karl Edgar folded before Flop (didn't bet)
Seat 2: cranecatcher folded before Flop (didn't bet)
Seat 3: pepuch19 folded before Flop (didn't bet)
Seat 4: Dimitrii 30 (button) folded before Flop
Seat 5: kostya17380 (small blind) collected ($0.60)
Seat 6: Tony Zhukov (big blind) folded before Flop



PokerStars Hand #222964859860:  Hold'em No Limit ($0.05/$0.10 USD) - 2021/01/23 13:53:19 ET
Table 'Polydoros II' 6-max Seat #5 is the button
Seat 1: Karl Edgar ($12.93 in chips) 
Seat 2: cranecatcher ($12.97 in chips) 
Seat 3: pepuch19 ($14.55 in chips) 
Seat 4: Dimitrii 30 ($8.22 in chips) 
Seat 5: kostya17380 ($10.92 in chips) 
Seat 6: Tony Zhukov ($10 in chips) 
Tony Zhukov: posts small blind $0.05
Karl Edgar: posts big blind $0.10
*** HOLE CARDS ***
cranecatcher: folds 
pepuch19: raises $0.20 to $0.30
Dimitrii 30: folds 
kostya17380: folds 
Tony Zhukov: folds 
Karl Edgar: calls $0.20
*** FLOP *** [6c 3s 2d]
Karl Edgar: checks 
pepuch19: checks 
*** TURN *** [6c 3s 2d] [2c]
Karl Edgar: bets $0.31
pepuch19: calls $0.31
*** RIVER *** [6c 3s 2d 2c] [9h]
Karl Edgar: bets $0.90
pepuch19: calls $0.90
*** SHOW DOWN ***
Karl Edgar: shows [8c 8d] (two pair, Eights and Deuces)
pepuch19: mucks hand 
Karl Edgar collected $2.93 from pot
*** SUMMARY ***
Total pot $3.07 | Rake $0.14 
Board [6c 3s 2d 2c 9h]
Seat 1: Karl Edgar (big blind) showed [8c 8d] and won ($2.93) with two pair, Eights and Deuces
Seat 2: cranecatcher folded before Flop (didn't bet)
Seat 3: pepuch19 mucked
Seat 4: Dimitrii 30 folded before Flop (didn't bet)
Seat 5: kostya17380 (button) folded before Flop (didn't bet)
Seat 6: Tony Zhukov (small blind) folded before Flop



PokerStars Hand #222964898035:  Hold'em No Limit ($0.05/$0.10 USD) - 2021/01/23 13:54:09 ET
Table 'Polydoros II' 6-max Seat #6 is the button
Seat 1: Karl Edgar ($14.35 in chips) 
Seat 3: pepuch19 ($13.04 in chips) 
Seat 4: Dimitrii 30 ($8.22 in chips) 
Seat 5: kostya17380 ($10.92 in chips) 
Seat 6: Tony Zhukov ($10 in chips) 
Karl Edgar: posts small blind $0.05
cranecatcher: is sitting out 
pepuch19: posts big blind $0.10
*** HOLE CARDS ***
Dimitrii 30: folds 
kostya17380: raises $0.15 to $0.25
cranecatcher leaves the table
Tony Zhukov: calls $0.25
Karl Edgar: folds 
pepuch19: raises $0.95 to $1.20
kostya17380: folds 
Tony Zhukov: folds 
Uncalled bet ($0.95) returned to pepuch19
pepuch19 collected $0.80 from pot
pepuch19: doesn't show hand 
*** SUMMARY ***
Total pot $0.80 | Rake $0 
Seat 1: Karl Edgar (small blind) folded before Flop
Seat 3: pepuch19 (big blind) collected ($0.80)
Seat 4: Dimitrii 30 folded before Flop (didn't bet)
Seat 5: kostya17380 folded before Flop
Seat 6: Tony Zhukov (button) folded before Flop



PokerStars Hand #222964912924:  Hold'em No Limit ($0.05/$0.10 USD) - 2021/01/23 13:54:29 ET
Table 'Polydoros II' 6-max Seat #1 is the button
Seat 1: Karl Edgar ($14.30 in chips) 
Seat 3: pepuch19 ($13.59 in chips) 
Seat 4: Dimitrii 30 ($8.22 in chips) 
Seat 5: kostya17380 ($10.67 in chips) 
Seat 6: Tony Zhukov ($10 in chips) 
pepuch19: posts small blind $0.05
Dimitrii 30: posts big blind $0.10
*** HOLE CARDS ***
kostya17380: folds 
Tony Zhukov: raises $0.15 to $0.25
Karl Edgar: folds 
pepuch19: folds 
GoodmanAR joins the table at seat #2 
Dimitrii 30: calls $0.15
*** FLOP *** [4d 7s Kc]
Dimitrii 30: checks 
Tony Zhukov: bets $0.17
Dimitrii 30: folds 
Uncalled bet ($0.17) returned to Tony Zhukov
Tony Zhukov collected $0.53 from pot
*** SUMMARY ***
Total pot $0.55 | Rake $0.02 
Board [4d 7s Kc]
Seat 1: Karl Edgar (button) folded before Flop (didn't bet)
Seat 3: pepuch19 (small blind) folded before Flop
Seat 4: Dimitrii 30 (big blind) folded on the Flop
Seat 5: kostya17380 folded before Flop (didn't bet)
Seat 6: Tony Zhukov collected ($0.53)



PokerStars Hand #222964932799:  Hold'em No Limit ($0.05/$0.10 USD) - 2021/01/23 13:54:55 ET
Table 'Polydoros II' 6-max Seat #3 is the button
Seat 1: Karl Edgar ($14.30 in chips) 
Seat 3: pepuch19 ($13.54 in chips) 
Seat 4: Dimitrii 30 ($8 in chips) 
Seat 5: kostya17380 ($10.67 in chips) 
Seat 6: Tony Zhukov ($10.28 in chips) 
Dimitrii 30: posts small blind $0.05
kostya17380: posts big blind $0.10
GoodmanAR: sits out 
*** HOLE CARDS ***
Tony Zhukov: folds 
Karl Edgar: folds 
pepuch19: raises $0.15 to $0.25
Dimitrii 30: raises $0.55 to $0.80
kostya17380: folds 
pepuch19: raises $1.20 to $2
Dimitrii 30: folds 
Uncalled bet ($1.20) returned to pepuch19
pepuch19 collected $1.70 from pot
pepuch19: doesn't show hand 
*** SUMMARY ***
Total pot $1.70 | Rake $0 
Seat 1: Karl Edgar folded before Flop (didn't bet)
Seat 3: pepuch19 (button) collected ($1.70)
Seat 4: Dimitrii 30 (small blind) folded before Flop
Seat 5: kostya17380 (big blind) folded before Flop
Seat 6: Tony Zhukov folded before Flop (didn't bet)



PokerStars Hand #222964956253:  Hold'em No Limit ($0.05/$0.10 USD) - 2021/01/23 13:55:36 ET
Table 'Polydoros II' 6-max Seat #4 is the button
Seat 1: Karl Edgar ($14.30 in chips) 
Seat 3: pepuch19 ($14.44 in chips) 
Seat 4: Dimitrii 30 ($8 in chips) 
Seat 5: kostya17380 ($10.57 in chips) 
Seat 6: Tony Zhukov ($10.28 in chips) 
kostya17380: posts small blind $0.05
Tony Zhukov: posts big blind $0.10
GoodmanAR: sits out 
*** HOLE CARDS ***
Karl Edgar: folds 
pepuch19: folds 
Dimitrii 30: folds 
kostya17380: raises $0.20 to $0.30
Tony Zhukov: folds 
Uncalled bet ($0.20) returned to kostya17380
kostya17380 collected $0.20 from pot
kostya17380: doesn't show hand 
*** SUMMARY ***
Total pot $0.20 | Rake $0 
Seat 1: Karl Edgar folded before Flop (didn't bet)
Seat 3: pepuch19 folded before Flop (didn't bet)
Seat 4: Dimitrii 30 (button) folded before Flop (didn't bet)
Seat 5: kostya17380 (small blind) collected ($0.20)
Seat 6: Tony Zhukov (big blind) folded before Flop



PokerStars Hand #222964962269:  Hold'em No Limit ($0.05/$0.10 USD) - 2021/01/23 13:55:49 ET
Table 'Polydoros II' 6-max Seat #5 is the button
Seat 1: Karl Edgar ($14.30 in chips) 
Seat 3: pepuch19 ($14.44 in chips) 
Seat 4: Dimitrii 30 ($8 in chips) 
Seat 5: kostya17380 ($10.67 in chips) 
Seat 6: Tony Zhukov ($10.18 in chips) 
Tony Zhukov: posts small blind $0.05
Karl Edgar: posts big blind $0.10
GoodmanAR: sits out 
*** HOLE CARDS ***
pepuch19: folds 
Dimitrii 30: raises $0.15 to $0.25
kostya17380: folds 
Tony Zhukov: folds 
Karl Edgar: folds 
Uncalled bet ($0.15) returned to Dimitrii 30
Dimitrii 30 collected $0.25 from pot
Dimitrii 30: doesn't show hand 
*** SUMMARY ***
Total pot $0.25 | Rake $0 
Seat 1: Karl Edgar (big blind) folded before Flop
Seat 3: pepuch19 folded before Flop (didn't bet)
Seat 4: Dimitrii 30 collected ($0.25)
Seat 5: kostya17380 (button) folded before Flop (didn't bet)
Seat 6: Tony Zhukov (small blind) folded before Flop



PokerStars Hand #222964967254:  Hold'em No Limit ($0.05/$0.10 USD) - 2021/01/23 13:55:59 ET
Table 'Polydoros II' 6-max Seat #6 is the button
Seat 1: Karl Edgar ($14.20 in chips) 
Seat 2: GoodmanAR ($10 in chips) 
Seat 3: pepuch19 ($14.44 in chips) 
Seat 4: Dimitrii 30 ($8.15 in chips) 
Seat 5: kostya17380 ($10.67 in chips) 
Seat 6: Tony Zhukov ($10.13 in chips) 
Karl Edgar: posts small blind $0.05
GoodmanAR: posts big blind $0.10
*** HOLE CARDS ***
pepuch19: folds 
Dimitrii 30: folds 
kostya17380: folds 
Tony Zhukov: raises $0.15 to $0.25
Karl Edgar: folds 
GoodmanAR: folds 
Uncalled bet ($0.15) returned to Tony Zhukov
Tony Zhukov collected $0.25 from pot
*** SUMMARY ***
Total pot $0.25 | Rake $0 
Seat 1: Karl Edgar (small blind) folded before Flop
Seat 2: GoodmanAR (big blind) folded before Flop
Seat 3: pepuch19 folded before Flop (didn't bet)
Seat 4: Dimitrii 30 folded before Flop (didn't bet)
Seat 5: kostya17380 folded before Flop (didn't bet)
Seat 6: Tony Zhukov (button) collected ($0.25)



PokerStars Hand #222964975914:  Hold'em No Limit ($0.05/$0.10 USD) - 2021/01/23 13:56:17 ET
Table 'Polydoros II' 6-max Seat #1 is the button
Seat 1: Karl Edgar ($14.15 in chips) 
Seat 2: GoodmanAR ($10 in chips) 
Seat 3: pepuch19 ($14.44 in chips) 
Seat 4: Dimitrii 30 ($8.15 in chips) 
Seat 5: kostya17380 ($10.67 in chips) 
Seat 6: Tony Zhukov ($10.28 in chips) 
GoodmanAR: posts small blind $0.05
pepuch19: posts big blind $0.10
*** HOLE CARDS ***
Dimitrii 30: folds 
kostya17380: folds 
Tony Zhukov: folds 
Karl Edgar: raises $0.10 to $0.20
GoodmanAR: folds 
pepuch19: folds 
Uncalled bet ($0.10) returned to Karl Edgar
Karl Edgar collected $0.25 from pot
Karl Edgar: doesn't show hand 
*** SUMMARY ***
Total pot $0.25 | Rake $0 
Seat 1: Karl Edgar (button) collected ($0.25)
Seat 2: GoodmanAR (small blind) folded before Flop
Seat 3: pepuch19 (big blind) folded before Flop
Seat 4: Dimitrii 30 folded before Flop (didn't bet)
Seat 5: kostya17380 folded before Flop (didn't bet)
Seat 6: Tony Zhukov folded before Flop (didn't bet)



PokerStars Hand #222964983604:  Hold'em No Limit ($0.05/$0.10 USD) - 2021/01/23 13:56:33 ET
Table 'Polydoros II' 6-max Seat #2 is the button
Seat 1: Karl Edgar ($14.30 in chips) 
Seat 2: GoodmanAR ($10 in chips) 
Seat 3: pepuch19 ($14.34 in chips) 
Seat 4: Dimitrii 30 ($8.15 in chips) 
Seat 5: kostya17380 ($10.67 in chips) 
Seat 6: Tony Zhukov ($10.28 in chips) 
pepuch19: posts small blind $0.05
Dimitrii 30: posts big blind $0.10
*** HOLE CARDS ***
kostya17380: raises $0.12 to $0.22
Tony Zhukov: folds 
Karl Edgar: folds 
GoodmanAR: folds 
pepuch19: folds 
Dimitrii 30: calls $0.12
*** FLOP *** [2s Ks 3s]
Dimitrii 30: checks 
kostya17380: checks 
*** TURN *** [2s Ks 3s] [5d]
Dimitrii 30: checks 
kostya17380: checks 
*** RIVER *** [2s Ks 3s 5d] [4h]
Dimitrii 30: checks 
kostya17380: bets $0.33
Dimitrii 30: folds 
Uncalled bet ($0.33) returned to kostya17380
kostya17380 collected $0.47 from pot
kostya17380: doesn't show hand 
*** SUMMARY ***
Total pot $0.49 | Rake $0.02 
Board [2s Ks 3s 5d 4h]
Seat 1: Karl Edgar folded before Flop (didn't bet)
Seat 2: GoodmanAR (button) folded before Flop (didn't bet)
Seat 3: pepuch19 (small blind) folded before Flop
Seat 4: Dimitrii 30 (big blind) folded on the River
Seat 5: kostya17380 collected ($0.47)
Seat 6: Tony Zhukov folded before Flop (didn't bet)



PokerStars Hand #222965007325:  Hold'em No Limit ($0.05/$0.10 USD) - 2021/01/23 13:57:22 ET
Table 'Polydoros II' 6-max Seat #3 is the button
Seat 1: Karl Edgar ($14.30 in chips) 
Seat 2: GoodmanAR ($10 in chips) 
Seat 3: pepuch19 ($14.29 in chips) 
Seat 4: Dimitrii 30 ($8 in chips) 
Dimitrii 30: posts small blind $0.05
kostya17380: is sitting out 
Tony Zhukov: is sitting out 
Karl Edgar: posts big blind $0.10
*** HOLE CARDS ***
GoodmanAR: folds 
pepuch19: raises $0.15 to $0.25
kostya17380 leaves the table
Dimitrii 30: folds 
Karl Edgar: folds 
Uncalled bet ($0.15) returned to pepuch19
pepuch19 collected $0.25 from pot
pepuch19: doesn't show hand 
*** SUMMARY ***
Total pot $0.25 | Rake $0 
Seat 1: Karl Edgar (big blind) folded before Flop
Seat 2: GoodmanAR folded before Flop (didn't bet)
Seat 3: pepuch19 (button) collected ($0.25)
Seat 4: Dimitrii 30 (small blind) folded before Flop



PokerStars Hand #222965012544:  Hold'em No Limit ($0.05/$0.10 USD) - 2021/01/23 13:57:33 ET
Table 'Polydoros II' 6-max Seat #4 is the button
Seat 1: Karl Edgar ($14.20 in chips) 
Seat 2: GoodmanAR ($10 in chips) 
Seat 3: pepuch19 ($14.44 in chips) 
Seat 4: Dimitrii 30 ($8 in chips) 
Karl Edgar: posts small blind $0.05
GoodmanAR: posts big blind $0.10
*** HOLE CARDS ***
pepuch19: folds 
Dimitrii 30: raises $0.15 to $0.25
Karl Edgar: folds 
GoodmanAR: folds 
Uncalled bet ($0.15) returned to Dimitrii 30
Dimitrii 30 collected $0.25 from pot
Dimitrii 30: doesn't show hand 
*** SUMMARY ***
Total pot $0.25 | Rake $0 
Seat 1: Karl Edgar (small blind) folded before Flop
Seat 2: GoodmanAR (big blind) folded before Flop
Seat 3: pepuch19 folded before Flop (didn't bet)
Seat 4: Dimitrii 30 (button) collected ($0.25)



PokerStars Hand #222965018284:  Hold'em No Limit ($0.05/$0.10 USD) - 2021/01/23 13:57:44 ET
Table 'Polydoros II' 6-max Seat #1 is the button
Seat 1: Karl Edgar ($14.15 in chips) 
Seat 2: GoodmanAR ($10 in chips) 
Seat 3: pepuch19 ($14.44 in chips) 
Seat 4: Dimitrii 30 ($8.15 in chips) 
GoodmanAR: posts small blind $0.05
pepuch19: posts big blind $0.10
*** HOLE CARDS ***
Dimitrii 30: folds 
Karl Edgar: folds 
GoodmanAR: folds 
Uncalled bet ($0.05) returned to pepuch19
pepuch19 collected $0.10 from pot
pepuch19: doesn't show hand 
*** SUMMARY ***
Total pot $0.10 | Rake $0 
Seat 1: Karl Edgar (button) folded before Flop (didn't bet)
Seat 2: GoodmanAR (small blind) folded before Flop
Seat 3: pepuch19 (big blind) collected ($0.10)
Seat 4: Dimitrii 30 folded before Flop (didn't bet)



PokerStars Hand #222965022627:  Hold'em No Limit ($0.05/$0.10 USD) - 2021/01/23 13:57:53 ET
Table 'Polydoros II' 6-max Seat #2 is the button
Seat 1: Karl Edgar ($14.15 in chips) 
Seat 2: GoodmanAR ($10 in chips) 
Seat 3: pepuch19 ($14.49 in chips) 
Seat 4: Dimitrii 30 ($8.15 in chips) 
pepuch19: posts small blind $0.05
Dimitrii 30: posts big blind $0.10
*** HOLE CARDS ***
Karl Edgar: folds 
GoodmanAR: raises $0.15 to $0.25
pepuch19: folds 
Dimitrii 30: folds 
Uncalled bet ($0.15) returned to GoodmanAR
GoodmanAR collected $0.25 from pot
GoodmanAR: doesn't show hand 
*** SUMMARY ***
Total pot $0.25 | Rake $0 
Seat 1: Karl Edgar folded before Flop (didn't bet)
Seat 2: GoodmanAR (button) collected ($0.25)
Seat 3: pepuch19 (small blind) folded before Flop
Seat 4: Dimitrii 30 (big blind) folded before Flop



PokerStars Hand #222965028445:  Hold'em No Limit ($0.05/$0.10 USD) - 2021/01/23 13:58:05 ET
Table 'Polydoros II' 6-max Seat #3 is the button
Seat 1: Karl Edgar ($14.15 in chips) 
Seat 2: GoodmanAR ($10.15 in chips) 
Seat 3: pepuch19 ($14.44 in chips) 
Seat 4: Dimitrii 30 ($8.05 in chips) 
Dimitrii 30: posts small blind $0.05
Karl Edgar: posts big blind $0.10
*** HOLE CARDS ***
GoodmanAR: folds 
Tony Zhukov leaves the table
pepuch19: folds 
Dimitrii 30: folds 
Uncalled bet ($0.05) returned to Karl Edgar
Karl Edgar collected $0.10 from pot
Karl Edgar: doesn't show hand 
*** SUMMARY ***
Total pot $0.10 | Rake $0 
Seat 1: Karl Edgar (big blind) collected ($0.10)
Seat 2: GoodmanAR folded before Flop (didn't bet)
Seat 3: pepuch19 (button) folded before Flop (didn't bet)
Seat 4: Dimitrii 30 (small blind) folded before Flop



PokerStars Hand #222965032143:  Hold'em No Limit ($0.05/$0.10 USD) - 2021/01/23 13:58:12 ET
Table 'Polydoros II' 6-max Seat #4 is the button
Seat 1: Karl Edgar ($14.20 in chips) 
Seat 2: GoodmanAR ($10.15 in chips) 
Seat 3: pepuch19 ($14.44 in chips) 
Seat 4: Dimitrii 30 ($8 in chips) 
Karl Edgar: posts small blind $0.05
GoodmanAR: posts big blind $0.10
*** HOLE CARDS ***
pepuch19: folds 
Dimitrii 30: folds 
Karl Edgar: folds 
Uncalled bet ($0.05) returned to GoodmanAR
GoodmanAR collected $0.10 from pot
GoodmanAR: doesn't show hand 
*** SUMMARY ***
Total pot $0.10 | Rake $0 
Seat 1: Karl Edgar (small blind) folded before Flop
Seat 2: GoodmanAR (big blind) collected ($0.10)
Seat 3: pepuch19 folded before Flop (didn't bet)
Seat 4: Dimitrii 30 (button) folded before Flop (didn't bet)



PokerStars Hand #222965034977:  Hold'em No Limit ($0.05/$0.10 USD) - 2021/01/23 13:58:18 ET
Table 'Polydoros II' 6-max Seat #1 is the button
Seat 1: Karl Edgar ($14.15 in chips) 
Seat 2: GoodmanAR ($10.20 in chips) 
Seat 3: pepuch19 ($14.44 in chips) 
Seat 4: Dimitrii 30 ($8 in chips) 
GoodmanAR: posts small blind $0.05
pepuch19: posts big blind $0.10
*** HOLE CARDS ***
Dimitrii 30: folds 
Karl Edgar: folds 
GoodmanAR: raises $0.20 to $0.30
pepuch19: folds 
Uncalled bet ($0.20) returned to GoodmanAR
GoodmanAR collected $0.20 from pot
GoodmanAR: doesn't show hand 
*** SUMMARY ***
Total pot $0.20 | Rake $0 
Seat 1: Karl Edgar (button) folded before Flop (didn't bet)
Seat 2: GoodmanAR (small blind) collected ($0.20)
Seat 3: pepuch19 (big blind) folded before Flop
Seat 4: Dimitrii 30 folded before Flop (didn't bet)



PokerStars Hand #222965043639:  Hold'em No Limit ($0.05/$0.10 USD) - 2021/01/23 13:58:36 ET
Table 'Polydoros II' 6-max Seat #2 is the button
Seat 1: Karl Edgar ($14.15 in chips) 
Seat 2: GoodmanAR ($10.30 in chips) 
Seat 3: pepuch19 ($14.34 in chips) 
Seat 4: Dimitrii 30 ($8 in chips) 
pepuch19: posts small blind $0.05
Dimitrii 30: posts big blind $0.10
*** HOLE CARDS ***
Karl Edgar: folds 
GoodmanAR: raises $0.15 to $0.25
pepuch19: folds 
Dimitrii 30: folds 
Uncalled bet ($0.15) returned to GoodmanAR
GoodmanAR collected $0.25 from pot
GoodmanAR: doesn't show hand 
*** SUMMARY ***
Total pot $0.25 | Rake $0 
Seat 1: Karl Edgar folded before Flop (didn't bet)
Seat 2: GoodmanAR (button) collected ($0.25)
Seat 3: pepuch19 (small blind) folded before Flop
Seat 4: Dimitrii 30 (big blind) folded before Flop



PokerStars Hand #222965048180:  Hold'em No Limit ($0.05/$0.10 USD) - 2021/01/23 13:58:45 ET
Table 'Polydoros II' 6-max Seat #3 is the button
Seat 1: Karl Edgar ($14.15 in chips) 
Seat 2: GoodmanAR ($10.45 in chips) 
Seat 3: pepuch19 ($14.29 in chips) 
Seat 4: Dimitrii 30 ($8 in chips) 
Dimitrii 30: posts small blind $0.05
Karl Edgar: posts big blind $0.10
*** HOLE CARDS ***
GoodmanAR: raises $0.20 to $0.30
pepuch19: folds 
Dimitrii 30: folds 
Karl Edgar: folds 
Uncalled bet ($0.20) returned to GoodmanAR
GoodmanAR collected $0.25 from pot
GoodmanAR: doesn't show hand 
*** SUMMARY ***
Total pot $0.25 | Rake $0 
Seat 1: Karl Edgar (big blind) folded before Flop
Seat 2: GoodmanAR collected ($0.25)
Seat 3: pepuch19 (button) folded before Flop (didn't bet)
Seat 4: Dimitrii 30 (small blind) folded before Flop



PokerStars Hand #222965052683:  Hold'em No Limit ($0.05/$0.10 USD) - 2021/01/23 13:58:54 ET
Table 'Polydoros II' 6-max Seat #4 is the button
Seat 1: Karl Edgar ($14.05 in chips) 
Seat 2: GoodmanAR ($10.60 in chips) 
Seat 3: pepuch19 ($14.29 in chips) 
Seat 4: Dimitrii 30 ($8 in chips) 
Karl Edgar: posts small blind $0.05
GoodmanAR: posts big blind $0.10
*** HOLE CARDS ***
pepuch19: folds 
Dimitrii 30: folds 
Karl Edgar: raises $0.15 to $0.25
Quatrehuith joins the table at seat #5 
GoodmanAR: raises $0.65 to $0.90
Karl Edgar: folds 
Uncalled bet ($0.65) returned to GoodmanAR
GoodmanAR collected $0.50 from pot
GoodmanAR: doesn't show hand 
*** SUMMARY ***
Total pot $0.50 | Rake $0 
Seat 1: Karl Edgar (small blind) folded before Flop
Seat 2: GoodmanAR (big blind) collected ($0.50)
Seat 3: pepuch19 folded before Flop (didn't bet)
Seat 4: Dimitrii 30 (button) folded before Flop (didn't bet)



PokerStars Hand #222965063293:  Hold'em No Limit ($0.05/$0.10 USD) - 2021/01/23 13:59:16 ET
Table 'Polydoros II' 6-max Seat #1 is the button
Seat 1: Karl Edgar ($13.80 in chips) 
Seat 2: GoodmanAR ($10.85 in chips) 
Seat 3: pepuch19 ($14.29 in chips) 
Seat 4: Dimitrii 30 ($8 in chips) 
GoodmanAR: posts small blind $0.05
pepuch19: posts big blind $0.10
Quatrehuith: sits out 
*** HOLE CARDS ***
kaisen75 joins the table at seat #6 
Dimitrii 30 has timed out
Dimitrii 30: folds 
Karl Edgar: raises $0.10 to $0.20
GoodmanAR: folds 
pepuch19: folds 
Uncalled bet ($0.10) returned to Karl Edgar
Karl Edgar collected $0.25 from pot
Karl Edgar: doesn't show hand 
*** SUMMARY ***
Total pot $0.25 | Rake $0 
Seat 1: Karl Edgar (button) collected ($0.25)
Seat 2: GoodmanAR (small blind) folded before Flop
Seat 3: pepuch19 (big blind) folded before Flop
Seat 4: Dimitrii 30 folded before Flop (didn't bet)



PokerStars Hand #222965074151:  Hold'em No Limit ($0.05/$0.10 USD) - 2021/01/23 13:59:38 ET
Table 'Polydoros II' 6-max Seat #2 is the button
Seat 1: Karl Edgar ($13.95 in chips) 
Seat 2: GoodmanAR ($10.80 in chips) 
Seat 3: pepuch19 ($14.19 in chips) 
Seat 4: Dimitrii 30 ($8 in chips) 
pepuch19: posts small blind $0.05
Dimitrii 30: posts big blind $0.10
Quatrehuith: sits out 
kaisen75: sits out 
*** HOLE CARDS ***
Karl Edgar: folds 
GoodmanAR: raises $0.15 to $0.25
pepuch19: raises $0.75 to $1
Dimitrii 30: folds 
GoodmanAR: folds 
Uncalled bet ($0.75) returned to pepuch19
pepuch19 collected $0.60 from pot
pepuch19: doesn't show hand 
*** SUMMARY ***
Total pot $0.60 | Rake $0 
Seat 1: Karl Edgar folded before Flop (didn't bet)
Seat 2: GoodmanAR (button) folded before Flop
Seat 3: pepuch19 (small blind) collected ($0.60)
Seat 4: Dimitrii 30 (big blind) folded before Flop



PokerStars Hand #222965086712:  Hold'em No Limit ($0.05/$0.10 USD) - 2021/01/23 14:00:03 ET
Table 'Polydoros II' 6-max Seat #3 is the button
Seat 1: Karl Edgar ($13.95 in chips) 
Seat 2: GoodmanAR ($10.55 in chips) 
Seat 3: pepuch19 ($14.54 in chips) 
Seat 4: Dimitrii 30 ($8 in chips) 
Seat 5: Quatrehuith ($10 in chips) 
Dimitrii 30: posts small blind $0.05
Quatrehuith: posts big blind $0.10
kaisen75: sits out 
*** HOLE CARDS ***
Karl Edgar: folds 
GoodmanAR: folds 
pepuch19: raises $0.15 to $0.25
Dimitrii 30: folds 
Quatrehuith: folds 
Uncalled bet ($0.15) returned to pepuch19
pepuch19 collected $0.25 from pot
pepuch19: doesn't show hand 
*** SUMMARY ***
Total pot $0.25 | Rake $0 
Seat 1: Karl Edgar folded before Flop (didn't bet)
Seat 2: GoodmanAR folded before Flop (didn't bet)
Seat 3: pepuch19 (button) collected ($0.25)
Seat 4: Dimitrii 30 (small blind) folded before Flop
Seat 5: Quatrehuith (big blind) folded before Flop



PokerStars Hand #222965095336:  Hold'em No Limit ($0.05/$0.10 USD) - 2021/01/23 14:00:18 ET
Table 'Polydoros II' 6-max Seat #4 is the button
Seat 1: Karl Edgar ($13.95 in chips) 
Seat 2: GoodmanAR ($10.55 in chips) 
Seat 3: pepuch19 ($14.69 in chips) 
Seat 4: Dimitrii 30 ($8 in chips) 
Seat 5: Quatrehuith ($10 in chips) 
Seat 6: kaisen75 ($10 in chips) 
Quatrehuith: posts small blind $0.05
kaisen75: posts big blind $0.10
*** HOLE CARDS ***
Karl Edgar: folds 
GoodmanAR: raises $0.20 to $0.30
pepuch19: folds 
Dimitrii 30: folds 
Quatrehuith: folds 
kaisen75: folds 
Uncalled bet ($0.20) returned to GoodmanAR
GoodmanAR collected $0.25 from pot
GoodmanAR: doesn't show hand 
*** SUMMARY ***
Total pot $0.25 | Rake $0 
Seat 1: Karl Edgar folded before Flop (didn't bet)
Seat 2: GoodmanAR collected ($0.25)
Seat 3: pepuch19 folded before Flop (didn't bet)
Seat 4: Dimitrii 30 (button) folded before Flop (didn't bet)
Seat 5: Quatrehuith (small blind) folded before Flop
Seat 6: kaisen75 (big blind) folded before Flop



PokerStars Hand #222965108106:  Hold'em No Limit ($0.05/$0.10 USD) - 2021/01/23 14:00:42 ET
Table 'Polydoros II' 6-max Seat #5 is the button
Seat 1: Karl Edgar ($13.95 in chips) 
Seat 2: GoodmanAR ($10.70 in chips) 
Seat 3: pepuch19 ($14.69 in chips) 
Seat 4: Dimitrii 30 ($8 in chips) 
Seat 5: Quatrehuith ($10 in chips) 
Seat 6: kaisen75 ($10 in chips) 
kaisen75: posts small blind $0.05
Karl Edgar: posts big blind $0.10
*** HOLE CARDS ***
GoodmanAR: folds 
pepuch19: folds 
Dimitrii 30: folds 
Quatrehuith: folds 
kaisen75: folds 
Uncalled bet ($0.05) returned to Karl Edgar
Karl Edgar collected $0.10 from pot
Karl Edgar: doesn't show hand 
*** SUMMARY ***
Total pot $0.10 | Rake $0 
Seat 1: Karl Edgar (big blind) collected ($0.10)
Seat 2: GoodmanAR folded before Flop (didn't bet)
Seat 3: pepuch19 folded before Flop (didn't bet)
Seat 4: Dimitrii 30 folded before Flop (didn't bet)
Seat 5: Quatrehuith (button) folded before Flop (didn't bet)
Seat 6: kaisen75 (small blind) folded before Flop



PokerStars Hand #222965112301:  Hold'em No Limit ($0.05/$0.10 USD) - 2021/01/23 14:00:50 ET
Table 'Polydoros II' 6-max Seat #6 is the button
Seat 1: Karl Edgar ($14 in chips) 
Seat 3: pepuch19 ($14.69 in chips) 
Seat 4: Dimitrii 30 ($8 in chips) 
Seat 5: Quatrehuith ($10 in chips) 
Seat 6: kaisen75 ($10 in chips) 
Karl Edgar: posts small blind $0.05
GoodmanAR: is sitting out 
GoodmanAR leaves the table
pepuch19: posts big blind $0.10
*** HOLE CARDS ***
Dimitrii 30: folds 
Quatrehuith: folds 
kaisen75: folds 
Karl Edgar: folds 
Uncalled bet ($0.05) returned to pepuch19
pepuch19 collected $0.10 from pot
pepuch19: doesn't show hand 
*** SUMMARY ***
Total pot $0.10 | Rake $0 
Seat 1: Karl Edgar (small blind) folded before Flop
Seat 3: pepuch19 (big blind) collected ($0.10)
Seat 4: Dimitrii 30 folded before Flop (didn't bet)
Seat 5: Quatrehuith folded before Flop (didn't bet)
Seat 6: kaisen75 (button) folded before Flop (didn't bet)



PokerStars Hand #222965123136:  Hold'em No Limit ($0.05/$0.10 USD) - 2021/01/23 14:01:08 ET
Table 'Polydoros II' 6-max Seat #1 is the button
Seat 1: Karl Edgar ($13.95 in chips) 
Seat 3: pepuch19 ($14.74 in chips) 
Seat 4: Dimitrii 30 ($8 in chips) 
Seat 5: Quatrehuith ($10 in chips) 
Seat 6: kaisen75 ($10 in chips) 
pepuch19: posts small blind $0.05
Dimitrii 30: posts big blind $0.10
*** HOLE CARDS ***
Quatrehuith: folds 
kaisen75: folds 
Karl Edgar: folds 
pepuch19: raises $0.20 to $0.30
Dimitrii 30: calls $0.20
*** FLOP *** [Jc Qs Qc]
Marocki joins the table at seat #2 
pepuch19: checks 
Dimitrii 30: checks 
*** TURN *** [Jc Qs Qc] [5h]
pepuch19: checks 
Dimitrii 30: bets $0.29
pepuch19: folds 
Uncalled bet ($0.29) returned to Dimitrii 30
Dimitrii 30 collected $0.57 from pot
Dimitrii 30: doesn't show hand 
*** SUMMARY ***
Total pot $0.60 | Rake $0.03 
Board [Jc Qs Qc 5h]
Seat 1: Karl Edgar (button) folded before Flop (didn't bet)
Seat 3: pepuch19 (small blind) folded on the Turn
Seat 4: Dimitrii 30 (big blind) collected ($0.57)
Seat 5: Quatrehuith folded before Flop (didn't bet)
Seat 6: kaisen75 folded before Flop (didn't bet)



PokerStars Hand #222965153412:  Hold'em No Limit ($0.05/$0.10 USD) - 2021/01/23 14:01:51 ET
Table 'Polydoros II' 6-max Seat #3 is the button
Seat 1: Karl Edgar ($13.95 in chips) 
Seat 3: pepuch19 ($14.44 in chips) 
Seat 4: Dimitrii 30 ($8.27 in chips) 
Seat 5: Quatrehuith ($10 in chips) 
Seat 6: kaisen75 ($10 in chips) 
Dimitrii 30: posts small blind $0.05
Quatrehuith: posts big blind $0.10
Marocki: sits out 
*** HOLE CARDS ***
kaisen75: raises $0.15 to $0.25
Karl Edgar: folds 
pepuch19: raises $0.65 to $0.90
Dimitrii 30: folds 
Quatrehuith: folds 
kaisen75: folds 
Uncalled bet ($0.65) returned to pepuch19
pepuch19 collected $0.65 from pot
pepuch19: doesn't show hand 
*** SUMMARY ***
Total pot $0.65 | Rake $0 
Seat 1: Karl Edgar folded before Flop (didn't bet)
Seat 3: pepuch19 (button) collected ($0.65)
Seat 4: Dimitrii 30 (small blind) folded before Flop
Seat 5: Quatrehuith (big blind) folded before Flop
Seat 6: kaisen75 folded before Flop



PokerStars Hand #222965186971:  Hold'em No Limit ($0.05/$0.10 USD) - 2021/01/23 14:02:28 ET
Table 'Polydoros II' 6-max Seat #4 is the button
Seat 1: Karl Edgar ($13.95 in chips) 
Seat 3: pepuch19 ($14.84 in chips) 
Seat 4: Dimitrii 30 ($8.22 in chips) 
Seat 5: Quatrehuith ($10 in chips) 
Seat 6: kaisen75 ($10 in chips) 
Quatrehuith: posts small blind $0.05
kaisen75: posts big blind $0.10
Marocki: sits out 
*** HOLE CARDS ***
Karl Edgar: folds 
pepuch19: folds 
Dimitrii 30: folds 
Quatrehuith: folds 
Uncalled bet ($0.05) returned to kaisen75
kaisen75 collected $0.10 from pot
kaisen75: doesn't show hand 
*** SUMMARY ***
Total pot $0.10 | Rake $0 
Seat 1: Karl Edgar folded before Flop (didn't bet)
Seat 3: pepuch19 folded before Flop (didn't bet)
Seat 4: Dimitrii 30 (button) folded before Flop (didn't bet)
Seat 5: Quatrehuith (small blind) folded before Flop
Seat 6: kaisen75 (big blind) collected ($0.10)



PokerStars Hand #222965194612:  Hold'em No Limit ($0.05/$0.10 USD) - 2021/01/23 14:02:37 ET
Table 'Polydoros II' 6-max Seat #5 is the button
Seat 1: Karl Edgar ($13.95 in chips) 
Seat 3: pepuch19 ($14.84 in chips) 
Seat 4: Dimitrii 30 ($8.22 in chips) 
Seat 5: Quatrehuith ($10 in chips) 
Seat 6: kaisen75 ($10.05 in chips) 
kaisen75: posts small blind $0.05
Karl Edgar: posts big blind $0.10
Marocki: sits out 
*** HOLE CARDS ***
pepuch19: folds 
Dimitrii 30: raises $0.15 to $0.25
Quatrehuith: folds 
kaisen75: raises $0.65 to $0.90
Karl Edgar: folds 
Dimitrii 30: folds 
Uncalled bet ($0.65) returned to kaisen75
kaisen75 collected $0.60 from pot
kaisen75: doesn't show hand 
*** SUMMARY ***
Total pot $0.60 | Rake $0 
Seat 1: Karl Edgar (big blind) folded before Flop
Seat 3: pepuch19 folded before Flop (didn't bet)
Seat 4: Dimitrii 30 folded before Flop
Seat 5: Quatrehuith (button) folded before Flop (didn't bet)
Seat 6: kaisen75 (small blind) collected ($0.60)



PokerStars Hand #222965211654:  Hold'em No Limit ($0.05/$0.10 USD) - 2021/01/23 14:02:59 ET
Table 'Polydoros II' 6-max Seat #6 is the button
Seat 1: Karl Edgar ($13.85 in chips) 
Seat 2: Marocki ($10 in chips) 
Seat 3: pepuch19 ($14.84 in chips) 
Seat 4: Dimitrii 30 ($8 in chips) 
Seat 5: Quatrehuith ($10 in chips) 
Seat 6: kaisen75 ($10.40 in chips) 
Karl Edgar: posts small blind $0.05
Marocki: posts big blind $0.10
*** HOLE CARDS ***
pepuch19: folds 
Dimitrii 30: folds 
Quatrehuith: folds 
kaisen75: folds 
Karl Edgar: raises $0.15 to $0.25
Marocki: folds 
Uncalled bet ($0.15) returned to Karl Edgar
Karl Edgar collected $0.20 from pot
Karl Edgar: doesn't show hand 
*** SUMMARY ***
Total pot $0.20 | Rake $0 
Seat 1: Karl Edgar (small blind) collected ($0.20)
Seat 2: Marocki (big blind) folded before Flop
Seat 3: pepuch19 folded before Flop (didn't bet)
Seat 4: Dimitrii 30 folded before Flop (didn't bet)
Seat 5: Quatrehuith folded before Flop (didn't bet)
Seat 6: kaisen75 (button) folded before Flop (didn't bet)



PokerStars Hand #222965227883:  Hold'em No Limit ($0.05/$0.10 USD) - 2021/01/23 14:03:20 ET
Table 'Polydoros II' 6-max Seat #1 is the button
Seat 1: Karl Edgar ($13.95 in chips) 
Seat 2: Marocki ($9.90 in chips) 
Seat 3: pepuch19 ($14.84 in chips) 
Seat 4: Dimitrii 30 ($8 in chips) 
Seat 5: Quatrehuith ($10 in chips) 
Seat 6: kaisen75 ($10.40 in chips) 
Marocki: posts small blind $0.05
pepuch19: posts big blind $0.10
*** HOLE CARDS ***
Dimitrii 30: folds 
Quatrehuith: folds 
kaisen75: folds 
Karl Edgar: folds 
Quatrehuith leaves the table
Marocki: calls $0.05
pepuch19: checks 
*** FLOP *** [4c 2d Ad]
Marocki: checks 
pepuch19: checks 
*** TURN *** [4c 2d Ad] [8c]
Quatrehuith joins the table at seat #5 
Marocki: checks 
pepuch19: bets $0.15
Marocki: folds 
Uncalled bet ($0.15) returned to pepuch19
pepuch19 collected $0.19 from pot
pepuch19: doesn't show hand 
*** SUMMARY ***
Total pot $0.20 | Rake $0.01 
Board [4c 2d Ad 8c]
Seat 1: Karl Edgar (button) folded before Flop (didn't bet)
Seat 2: Marocki (small blind) folded on the Turn
Seat 3: pepuch19 (big blind) collected ($0.19)
Seat 4: Dimitrii 30 folded before Flop (didn't bet)
Seat 5: Quatrehuith folded before Flop (didn't bet)
Seat 6: kaisen75 folded before Flop (didn't bet)



PokerStars Hand #222965266102:  Hold'em No Limit ($0.05/$0.10 USD) - 2021/01/23 14:04:09 ET
Table 'Polydoros II' 6-max Seat #2 is the button
Seat 1: Karl Edgar ($13.95 in chips) 
Seat 2: Marocki ($9.80 in chips) 
Seat 3: pepuch19 ($14.93 in chips) 
Seat 4: Dimitrii 30 ($8 in chips) 
Seat 6: kaisen75 ($10.40 in chips) 
pepuch19: posts small blind $0.05
Dimitrii 30: posts big blind $0.10
Quatrehuith: sits out 
*** HOLE CARDS ***
kaisen75: folds 
Karl Edgar: folds 
Marocki: raises $0.15 to $0.25
pepuch19: folds 
Dimitrii 30: folds 
Uncalled bet ($0.15) returned to Marocki
Marocki collected $0.25 from pot
*** SUMMARY ***
Total pot $0.25 | Rake $0 
Seat 1: Karl Edgar folded before Flop (didn't bet)
Seat 2: Marocki (button) collected ($0.25)
Seat 3: pepuch19 (small blind) folded before Flop
Seat 4: Dimitrii 30 (big blind) folded before Flop
Seat 6: kaisen75 folded before Flop (didn't bet)



PokerStars Hand #222965279935:  Hold'em No Limit ($0.05/$0.10 USD) - 2021/01/23 14:04:27 ET
Table 'Polydoros II' 6-max Seat #3 is the button
Seat 1: Karl Edgar ($13.95 in chips) 
Seat 2: Marocki ($9.95 in chips) 
Seat 3: pepuch19 ($14.88 in chips) 
Seat 4: Dimitrii 30 ($8 in chips) 
Seat 5: Quatrehuith ($10 in chips) 
Seat 6: kaisen75 ($10.40 in chips) 
Dimitrii 30: posts small blind $0.05
Quatrehuith: posts big blind $0.10
*** HOLE CARDS ***
kaisen75: folds 
Karl Edgar: folds 
Marocki: folds 
pepuch19: folds 
Dimitrii 30: folds 
Uncalled bet ($0.05) returned to Quatrehuith
Quatrehuith collected $0.10 from pot
Quatrehuith: doesn't show hand 
*** SUMMARY ***
Total pot $0.10 | Rake $0 
Seat 1: Karl Edgar folded before Flop (didn't bet)
Seat 2: Marocki folded before Flop (didn't bet)
Seat 3: pepuch19 (button) folded before Flop (didn't bet)
Seat 4: Dimitrii 30 (small blind) folded before Flop
Seat 5: Quatrehuith (big blind) collected ($0.10)
Seat 6: kaisen75 folded before Flop (didn't bet)



PokerStars Hand #222965290720:  Hold'em No Limit ($0.05/$0.10 USD) - 2021/01/23 14:04:41 ET
Table 'Polydoros II' 6-max Seat #4 is the button
Seat 1: Karl Edgar ($13.95 in chips) 
Seat 2: Marocki ($9.95 in chips) 
Seat 3: pepuch19 ($14.88 in chips) 
Seat 4: Dimitrii 30 ($8 in chips) 
Seat 5: Quatrehuith ($10.05 in chips) 
Quatrehuith: posts small blind $0.05
kaisen75: is sitting out 
Karl Edgar: posts big blind $0.10
*** HOLE CARDS ***
Marocki: folds 
pepuch19: folds 
Dimitrii 30: folds 
kaisen75 leaves the table
BetGuy69 joins the table at seat #6 
Quatrehuith: raises $0.20 to $0.30
Karl Edgar: folds 
Uncalled bet ($0.20) returned to Quatrehuith
Quatrehuith collected $0.20 from pot
Quatrehuith: doesn't show hand 
*** SUMMARY ***
Total pot $0.20 | Rake $0 
Seat 1: Karl Edgar (big blind) folded before Flop
Seat 2: Marocki folded before Flop (didn't bet)
Seat 3: pepuch19 folded before Flop (didn't bet)
Seat 4: Dimitrii 30 (button) folded before Flop (didn't bet)
Seat 5: Quatrehuith (small blind) collected ($0.20)



PokerStars Hand #222965308441:  Hold'em No Limit ($0.05/$0.10 USD) - 2021/01/23 14:05:03 ET
Table 'Polydoros II' 6-max Seat #5 is the button
Seat 1: Karl Edgar ($13.85 in chips) 
Seat 2: Marocki ($9.95 in chips) 
Seat 3: pepuch19 ($14.88 in chips) 
Seat 4: Dimitrii 30 ($8 in chips) 
Seat 5: Quatrehuith ($10.15 in chips) 
Karl Edgar: posts small blind $0.05
Marocki: posts big blind $0.10
*** HOLE CARDS ***
pepuch19: folds 
Dimitrii 30 has timed out
Dimitrii 30: folds 
Quatrehuith: raises $0.15 to $0.25
Karl Edgar: folds 
Marocki: raises $0.65 to $0.90
Quatrehuith: folds 
Uncalled bet ($0.65) returned to Marocki
Marocki collected $0.55 from pot
*** SUMMARY ***
Total pot $0.55 | Rake $0 
Seat 1: Karl Edgar (small blind) folded before Flop
Seat 2: Marocki (big blind) collected ($0.55)
Seat 3: pepuch19 folded before Flop (didn't bet)
Seat 4: Dimitrii 30 folded before Flop (didn't bet)
Seat 5: Quatrehuith (button) folded before Flop



PokerStars Hand #222965341481:  Hold'em No Limit ($0.05/$0.10 USD) - 2021/01/23 14:05:45 ET
Table 'Polydoros II' 6-max Seat #1 is the button
Seat 1: Karl Edgar ($13.80 in chips) 
Seat 2: Marocki ($10.25 in chips) 
Seat 3: pepuch19 ($14.88 in chips) 
Seat 4: Dimitrii 30 ($8 in chips) 
Seat 5: Quatrehuith ($10 in chips) 
Marocki: posts small blind $0.05
pepuch19: posts big blind $0.10
BetGuy69: sits out 
*** HOLE CARDS ***
Dimitrii 30: folds 
Quatrehuith: folds 
Karl Edgar: folds 
Quatrehuith leaves the table
Marocki: raises $0.20 to $0.30
TOLK78 joins the table at seat #5 
pepuch19: calls $0.20
*** FLOP *** [7d 3d Qd]
Marocki: checks 
pepuch19: checks 
*** TURN *** [7d 3d Qd] [4s]
Marocki: checks 
pepuch19: bets $0.30
Marocki: calls $0.30
*** RIVER *** [7d 3d Qd 4s] [8s]
Marocki: checks 
pepuch19: checks 
*** SHOW DOWN ***
Marocki: shows [5h Js] (high card Queen)
pepuch19: shows [Ks 7s] (a pair of Sevens)
pepuch19 collected $1.15 from pot
*** SUMMARY ***
Total pot $1.20 | Rake $0.05 
Board [7d 3d Qd 4s 8s]
Seat 1: Karl Edgar (button) folded before Flop (didn't bet)
Seat 2: Marocki (small blind) showed [5h Js] and lost with high card Queen
Seat 3: pepuch19 (big blind) showed [Ks 7s] and won ($1.15) with a pair of Sevens
Seat 4: Dimitrii 30 folded before Flop (didn't bet)
Seat 5: Quatrehuith folded before Flop (didn't bet)



PokerStars Hand #222965388270:  Hold'em No Limit ($0.05/$0.10 USD) - 2021/01/23 14:06:44 ET
Table 'Polydoros II' 6-max Seat #2 is the button
Seat 1: Karl Edgar ($13.80 in chips) 
Seat 2: Marocki ($9.65 in chips) 
Seat 3: pepuch19 ($15.43 in chips) 
Seat 4: Dimitrii 30 ($8 in chips) 
pepuch19: posts small blind $0.05
Dimitrii 30: posts big blind $0.10
TOLK78: sits out 
BetGuy69: sits out 
*** HOLE CARDS ***
Karl Edgar: raises $0.15 to $0.25
Marocki: folds 
pepuch19: folds 
Dimitrii 30: calls $0.15
*** FLOP *** [Ah 5s Qs]
TOLK78 leaves the table
handbrake333 joins the table at seat #5 
Dimitrii 30: checks 
Karl Edgar: checks 
*** TURN *** [Ah 5s Qs] [9s]
Dimitrii 30: checks 
Karl Edgar: bets $0.40
Dimitrii 30: folds 
Uncalled bet ($0.40) returned to Karl Edgar
Karl Edgar collected $0.53 from pot
Karl Edgar: doesn't show hand 
*** SUMMARY ***
Total pot $0.55 | Rake $0.02 
Board [Ah 5s Qs 9s]
Seat 1: Karl Edgar collected ($0.53)
Seat 2: Marocki (button) folded before Flop (didn't bet)
Seat 3: pepuch19 (small blind) folded before Flop
Seat 4: Dimitrii 30 (big blind) folded on the Turn



PokerStars Hand #222965448753:  Hold'em No Limit ($0.05/$0.10 USD) - 2021/01/23 14:08:00 ET
Table 'Polydoros II' 6-max Seat #3 is the button
Seat 1: Karl Edgar ($14.08 in chips) 
Seat 2: Marocki ($10 in chips) 
Seat 3: pepuch19 ($15.38 in chips) 
Seat 4: Dimitrii 30 ($8 in chips) 
Seat 5: handbrake333 ($10 in chips) 
Dimitrii 30: posts small blind $0.05
handbrake333: posts big blind $0.10
BetGuy69: sits out 
*** HOLE CARDS ***
Karl Edgar: folds 
Marocki: folds 
pepuch19: folds 
Dimitrii 30: folds 
Uncalled bet ($0.05) returned to handbrake333
handbrake333 collected $0.10 from pot
handbrake333: doesn't show hand 
*** SUMMARY ***
Total pot $0.10 | Rake $0 
Seat 1: Karl Edgar folded before Flop (didn't bet)
Seat 2: Marocki folded before Flop (didn't bet)
Seat 3: pepuch19 (button) folded before Flop (didn't bet)
Seat 4: Dimitrii 30 (small blind) folded before Flop
Seat 5: handbrake333 (big blind) collected ($0.10)



PokerStars Hand #222965460310:  Hold'em No Limit ($0.05/$0.10 USD) - 2021/01/23 14:08:14 ET
Table 'Polydoros II' 6-max Seat #4 is the button
Seat 1: Karl Edgar ($14.08 in chips) 
Seat 2: Marocki ($10 in chips) 
Seat 3: pepuch19 ($15.38 in chips) 
Seat 4: Dimitrii 30 ($8 in chips) 
Seat 5: handbrake333 ($10.05 in chips) 
Seat 6: BetGuy69 ($10 in chips) 
handbrake333: posts small blind $0.05
BetGuy69: posts big blind $0.10
*** HOLE CARDS ***
Karl Edgar: raises $0.20 to $0.30
Marocki: folds 
pepuch19: folds 
Dimitrii 30: raises $0.60 to $0.90
handbrake333: folds 
BetGuy69: folds 
Karl Edgar: folds 
Uncalled bet ($0.60) returned to Dimitrii 30
Dimitrii 30 collected $0.75 from pot
Dimitrii 30: doesn't show hand 
*** SUMMARY ***
Total pot $0.75 | Rake $0 
Seat 1: Karl Edgar folded before Flop
Seat 2: Marocki folded before Flop (didn't bet)
Seat 3: pepuch19 folded before Flop (didn't bet)
Seat 4: Dimitrii 30 (button) collected ($0.75)
Seat 5: handbrake333 (small blind) folded before Flop
Seat 6: BetGuy69 (big blind) folded before Flop



PokerStars Hand #222965476995:  Hold'em No Limit ($0.05/$0.10 USD) - 2021/01/23 14:08:35 ET
Table 'Polydoros II' 6-max Seat #5 is the button
Seat 1: Karl Edgar ($13.78 in chips) 
Seat 2: Marocki ($10 in chips) 
Seat 3: pepuch19 ($15.38 in chips) 
Seat 4: Dimitrii 30 ($8.45 in chips) 
Seat 5: handbrake333 ($10 in chips) 
Seat 6: BetGuy69 ($10 in chips) 
BetGuy69: posts small blind $0.05
Karl Edgar: posts big blind $0.10
*** HOLE CARDS ***
Marocki has timed out
Marocki: folds 
pepuch19: folds 
Dimitrii 30: folds 
handbrake333: raises $0.15 to $0.25
BetGuy69: folds 
Karl Edgar: folds 
Uncalled bet ($0.15) returned to handbrake333
handbrake333 collected $0.25 from pot
handbrake333: doesn't show hand 
*** SUMMARY ***
Total pot $0.25 | Rake $0 
Seat 1: Karl Edgar (big blind) folded before Flop
Seat 2: Marocki folded before Flop (didn't bet)
Seat 3: pepuch19 folded before Flop (didn't bet)
Seat 4: Dimitrii 30 folded before Flop (didn't bet)
Seat 5: handbrake333 (button) collected ($0.25)
Seat 6: BetGuy69 (small blind) folded before Flop



PokerStars Hand #222965499468:  Hold'em No Limit ($0.05/$0.10 USD) - 2021/01/23 14:09:04 ET
Table 'Polydoros II' 6-max Seat #6 is the button
Seat 1: Karl Edgar ($13.68 in chips) 
Seat 2: Marocki ($10 in chips) 
Seat 3: pepuch19 ($15.38 in chips) 
Seat 4: Dimitrii 30 ($8.45 in chips) 
Seat 5: handbrake333 ($10.15 in chips) 
Seat 6: BetGuy69 ($10 in chips) 
Karl Edgar: posts small blind $0.05
Marocki: posts big blind $0.10
*** HOLE CARDS ***
pepuch19: folds 
Dimitrii 30: folds 
handbrake333: folds 
BetGuy69: raises $0.15 to $0.25
Karl Edgar: folds 
Marocki: folds 
Uncalled bet ($0.15) returned to BetGuy69
BetGuy69 collected $0.25 from pot
BetGuy69: doesn't show hand 
*** SUMMARY ***
Total pot $0.25 | Rake $0 
Seat 1: Karl Edgar (small blind) folded before Flop
Seat 2: Marocki (big blind) folded before Flop
Seat 3: pepuch19 folded before Flop (didn't bet)
Seat 4: Dimitrii 30 folded before Flop (didn't bet)
Seat 5: handbrake333 folded before Flop (didn't bet)
Seat 6: BetGuy69 (button) collected ($0.25)



PokerStars Hand #222965517549:  Hold'em No Limit ($0.05/$0.10 USD) - 2021/01/23 14:09:26 ET
Table 'Polydoros II' 6-max Seat #1 is the button
Seat 1: Karl Edgar ($13.63 in chips) 
Seat 2: Marocki ($9.90 in chips) 
Seat 3: pepuch19 ($15.38 in chips) 
Seat 4: Dimitrii 30 ($8.45 in chips) 
Seat 5: handbrake333 ($10.15 in chips) 
Seat 6: BetGuy69 ($10.15 in chips) 
Marocki: posts small blind $0.05
pepuch19: posts big blind $0.10
*** HOLE CARDS ***
Dimitrii 30: folds 
handbrake333: folds 
BetGuy69: folds 
Karl Edgar: raises $0.10 to $0.20
Marocki: folds 
pepuch19: folds 
Uncalled bet ($0.10) returned to Karl Edgar
Karl Edgar collected $0.25 from pot
Karl Edgar: doesn't show hand 
*** SUMMARY ***
Total pot $0.25 | Rake $0 
Seat 1: Karl Edgar (button) collected ($0.25)
Seat 2: Marocki (small blind) folded before Flop
Seat 3: pepuch19 (big blind) folded before Flop
Seat 4: Dimitrii 30 folded before Flop (didn't bet)
Seat 5: handbrake333 folded before Flop (didn't bet)
Seat 6: BetGuy69 folded before Flop (didn't bet)



PokerStars Hand #222965535521:  Hold'em No Limit ($0.05/$0.10 USD) - 2021/01/23 14:09:49 ET
Table 'Polydoros II' 6-max Seat #2 is the button
Seat 1: Karl Edgar ($13.78 in chips) 
Seat 2: Marocki ($9.85 in chips) 
Seat 3: pepuch19 ($15.28 in chips) 
Seat 4: Dimitrii 30 ($8.45 in chips) 
Seat 5: handbrake333 ($10.15 in chips) 
Seat 6: BetGuy69 ($10.15 in chips) 
pepuch19: posts small blind $0.05
Dimitrii 30: posts big blind $0.10
*** HOLE CARDS ***
handbrake333: folds 
BetGuy69: folds 
Karl Edgar: raises $0.15 to $0.25
Marocki: folds 
pepuch19: folds 
Dimitrii 30: folds 
Uncalled bet ($0.15) returned to Karl Edgar
Karl Edgar collected $0.25 from pot
Karl Edgar: doesn't show hand 
*** SUMMARY ***
Total pot $0.25 | Rake $0 
Seat 1: Karl Edgar collected ($0.25)
Seat 2: Marocki (button) folded before Flop (didn't bet)
Seat 3: pepuch19 (small blind) folded before Flop
Seat 4: Dimitrii 30 (big blind) folded before Flop
Seat 5: handbrake333 folded before Flop (didn't bet)
Seat 6: BetGuy69 folded before Flop (didn't bet)



PokerStars Hand #222965545746:  Hold'em No Limit ($0.05/$0.10 USD) - 2021/01/23 14:10:02 ET
Table 'Polydoros II' 6-max Seat #3 is the button
Seat 1: Karl Edgar ($13.93 in chips) 
Seat 2: Marocki ($9.85 in chips) 
Seat 3: pepuch19 ($15.23 in chips) 
Seat 4: Dimitrii 30 ($8.35 in chips) 
Seat 5: handbrake333 ($10.15 in chips) 
Seat 6: BetGuy69 ($10.15 in chips) 
Dimitrii 30: posts small blind $0.05
handbrake333: posts big blind $0.10
*** HOLE CARDS ***
BetGuy69: folds 
Karl Edgar: folds 
BetGuy69 leaves the table
Marocki: folds 
buradin de joins the table at seat #6 
pepuch19: raises $0.15 to $0.25
Dimitrii 30: folds 
handbrake333: folds 
Uncalled bet ($0.15) returned to pepuch19
pepuch19 collected $0.25 from pot
pepuch19: doesn't show hand 
*** SUMMARY ***
Total pot $0.25 | Rake $0 
Seat 1: Karl Edgar folded before Flop (didn't bet)
Seat 2: Marocki folded before Flop (didn't bet)
Seat 3: pepuch19 (button) collected ($0.25)
Seat 4: Dimitrii 30 (small blind) folded before Flop
Seat 5: handbrake333 (big blind) folded before Flop
Seat 6: BetGuy69 folded before Flop (didn't bet)



PokerStars Hand #222965556739:  Hold'em No Limit ($0.05/$0.10 USD) - 2021/01/23 14:10:16 ET
Table 'Polydoros II' 6-max Seat #4 is the button
Seat 1: Karl Edgar ($13.93 in chips) 
Seat 2: Marocki ($9.85 in chips) 
Seat 3: pepuch19 ($15.38 in chips) 
Seat 4: Dimitrii 30 ($8.30 in chips) 
Seat 5: handbrake333 ($10.05 in chips) 
Seat 6: buradin de ($10 in chips) 
handbrake333: posts small blind $0.05
buradin de: posts big blind $0.10
*** HOLE CARDS ***
Karl Edgar: folds 
Marocki: folds 
pepuch19: folds 
Dimitrii 30: folds 
handbrake333: folds 
Uncalled bet ($0.05) returned to buradin de
buradin de collected $0.10 from pot
buradin de: doesn't show hand 
*** SUMMARY ***
Total pot $0.10 | Rake $0 
Seat 1: Karl Edgar folded before Flop (didn't bet)
Seat 2: Marocki folded before Flop (didn't bet)
Seat 3: pepuch19 folded before Flop (didn't bet)
Seat 4: Dimitrii 30 (button) folded before Flop (didn't bet)
Seat 5: handbrake333 (small blind) folded before Flop
Seat 6: buradin de (big blind) collected ($0.10)



PokerStars Hand #222965566844:  Hold'em No Limit ($0.05/$0.10 USD) - 2021/01/23 14:10:29 ET
Table 'Polydoros II' 6-max Seat #5 is the button
Seat 1: Karl Edgar ($13.93 in chips) 
Seat 2: Marocki ($9.85 in chips) 
Seat 3: pepuch19 ($15.38 in chips) 
Seat 4: Dimitrii 30 ($8.30 in chips) 
Seat 5: handbrake333 ($10 in chips) 
Seat 6: buradin de ($10.05 in chips) 
buradin de: posts small blind $0.05
Karl Edgar: posts big blind $0.10
*** HOLE CARDS ***
Marocki: folds 
pepuch19: folds 
Dimitrii 30: folds 
handbrake333: raises $0.15 to $0.25
buradin de: folds 
Karl Edgar: folds 
Uncalled bet ($0.15) returned to handbrake333
handbrake333 collected $0.25 from pot
handbrake333: doesn't show hand 
*** SUMMARY ***
Total pot $0.25 | Rake $0 
Seat 1: Karl Edgar (big blind) folded before Flop
Seat 2: Marocki folded before Flop (didn't bet)
Seat 3: pepuch19 folded before Flop (didn't bet)
Seat 4: Dimitrii 30 folded before Flop (didn't bet)
Seat 5: handbrake333 (button) collected ($0.25)
Seat 6: buradin de (small blind) folded before Flop



PokerStars Hand #222965580720:  Hold'em No Limit ($0.05/$0.10 USD) - 2021/01/23 14:10:46 ET
Table 'Polydoros II' 6-max Seat #6 is the button
Seat 1: Karl Edgar ($13.83 in chips) 
Seat 2: Marocki ($9.85 in chips) 
Seat 3: pepuch19 ($15.38 in chips) 
Seat 4: Dimitrii 30 ($8.30 in chips) 
Seat 5: handbrake333 ($10.15 in chips) 
Seat 6: buradin de ($10 in chips) 
Karl Edgar: posts small blind $0.05
Marocki: posts big blind $0.10
*** HOLE CARDS ***
pepuch19: raises $0.20 to $0.30
Dimitrii 30: folds 
handbrake333: folds 
buradin de: folds 
Karl Edgar: folds 
Marocki: calls $0.20
*** FLOP *** [Kc Ah Ts]
Marocki: checks 
pepuch19: checks 
*** TURN *** [Kc Ah Ts] [9d]
Marocki: checks 
pepuch19: bets $0.33
Marocki: folds 
Uncalled bet ($0.33) returned to pepuch19
pepuch19 collected $0.62 from pot
pepuch19: doesn't show hand 
*** SUMMARY ***
Total pot $0.65 | Rake $0.03 
Board [Kc Ah Ts 9d]
Seat 1: Karl Edgar (small blind) folded before Flop
Seat 2: Marocki (big blind) folded on the Turn
Seat 3: pepuch19 collected ($0.62)
Seat 4: Dimitrii 30 folded before Flop (didn't bet)
Seat 5: handbrake333 folded before Flop (didn't bet)
Seat 6: buradin de (button) folded before Flop (didn't bet)



PokerStars Hand #222965622130:  Hold'em No Limit ($0.05/$0.10 USD) - 2021/01/23 14:11:39 ET
Table 'Polydoros II' 6-max Seat #1 is the button
Seat 1: Karl Edgar ($13.78 in chips) 
Seat 2: Marocki ($9.55 in chips) 
Seat 3: pepuch19 ($15.70 in chips) 
Seat 4: Dimitrii 30 ($8.30 in chips) 
Seat 5: handbrake333 ($10.15 in chips) 
Seat 6: buradin de ($10 in chips) 
Marocki: posts small blind $0.05
pepuch19: posts big blind $0.10
*** HOLE CARDS ***
Dimitrii 30: folds 
handbrake333: folds 
buradin de: folds 
Karl Edgar: raises $0.10 to $0.20
Marocki: folds 
pepuch19: raises $0.60 to $0.80
Karl Edgar: folds 
Uncalled bet ($0.60) returned to pepuch19
pepuch19 collected $0.45 from pot
pepuch19: doesn't show hand 
*** SUMMARY ***
Total pot $0.45 | Rake $0 
Seat 1: Karl Edgar (button) folded before Flop
Seat 2: Marocki (small blind) folded before Flop
Seat 3: pepuch19 (big blind) collected ($0.45)
Seat 4: Dimitrii 30 folded before Flop (didn't bet)
Seat 5: handbrake333 folded before Flop (didn't bet)
Seat 6: buradin de folded before Flop (didn't bet)



PokerStars Hand #222965642603:  Hold'em No Limit ($0.05/$0.10 USD) - 2021/01/23 14:12:05 ET
Table 'Polydoros II' 6-max Seat #2 is the button
Seat 1: Karl Edgar ($13.58 in chips) 
Seat 2: Marocki ($9.50 in chips) 
Seat 3: pepuch19 ($15.95 in chips) 
Seat 4: Dimitrii 30 ($8.30 in chips) 
Seat 5: handbrake333 ($10.15 in chips) 
Seat 6: buradin de ($10 in chips) 
pepuch19: posts small blind $0.05
Dimitrii 30: posts big blind $0.10
*** HOLE CARDS ***
handbrake333: folds 
buradin de: folds 
Karl Edgar: raises $0.15 to $0.25
Marocki: folds 
pepuch19: folds 
Dimitrii 30: folds 
Uncalled bet ($0.15) returned to Karl Edgar
Karl Edgar collected $0.25 from pot
Karl Edgar: doesn't show hand 
*** SUMMARY ***
Total pot $0.25 | Rake $0 
Seat 1: Karl Edgar collected ($0.25)
Seat 2: Marocki (button) folded before Flop (didn't bet)
Seat 3: pepuch19 (small blind) folded before Flop
Seat 4: Dimitrii 30 (big blind) folded before Flop
Seat 5: handbrake333 folded before Flop (didn't bet)
Seat 6: buradin de folded before Flop (didn't bet)



PokerStars Hand #222965654852:  Hold'em No Limit ($0.05/$0.10 USD) - 2021/01/23 14:12:20 ET
Table 'Polydoros II' 6-max Seat #3 is the button
Seat 1: Karl Edgar ($13.73 in chips) 
Seat 2: Marocki ($10 in chips) 
Seat 3: pepuch19 ($15.90 in chips) 
Seat 4: Dimitrii 30 ($8.20 in chips) 
Seat 5: handbrake333 ($10.15 in chips) 
Seat 6: buradin de ($10 in chips) 
Dimitrii 30: posts small blind $0.05
handbrake333: posts big blind $0.10
*** HOLE CARDS ***
buradin de: folds 
Karl Edgar: folds 
Marocki: folds 
pepuch19: folds 
Dimitrii 30: folds 
Uncalled bet ($0.05) returned to handbrake333
handbrake333 collected $0.10 from pot
handbrake333: doesn't show hand 
*** SUMMARY ***
Total pot $0.10 | Rake $0 
Seat 1: Karl Edgar folded before Flop (didn't bet)
Seat 2: Marocki folded before Flop (didn't bet)
Seat 3: pepuch19 (button) folded before Flop (didn't bet)
Seat 4: Dimitrii 30 (small blind) folded before Flop
Seat 5: handbrake333 (big blind) collected ($0.10)
Seat 6: buradin de folded before Flop (didn't bet)



PokerStars Hand #222966930137:  Hold'em No Limit ($0.05/$0.10 USD) - 2021/01/23 14:39:02 ET
Table 'Polydoros II' 6-max Seat #6 is the button
Seat 1: Karl Edgar ($26.64 in chips) 
Seat 2: Marocki ($14.75 in chips) 
Seat 3: BazKaLT ($10.25 in chips) 
Seat 4: teddyKK ($10 in chips) 
Seat 5: handbrake333 ($10.15 in chips) 
Seat 6: mlhnfld ($4 in chips) 
Karl Edgar: posts small blind $0.05
Marocki: posts big blind $0.10
*** HOLE CARDS ***
BazKaLT: folds 
teddyKK: folds 
handbrake333: folds 
mlhnfld: calls $0.10
Karl Edgar: folds 
Marocki: checks 
*** FLOP *** [2s 5d Ac]
Marocki: checks 
mlhnfld: bets $0.12
Marocki: folds 
Uncalled bet ($0.12) returned to mlhnfld
mlhnfld collected $0.24 from pot
mlhnfld: doesn't show hand 
*** SUMMARY ***
Total pot $0.25 | Rake $0.01 
Board [2s 5d Ac]
Seat 1: Karl Edgar (small blind) folded before Flop
Seat 2: Marocki (big blind) folded on the Flop
Seat 3: BazKaLT folded before Flop (didn't bet)
Seat 4: teddyKK folded before Flop (didn't bet)
Seat 5: handbrake333 folded before Flop (didn't bet)
Seat 6: mlhnfld (button) collected ($0.24)



PokerStars Hand #222966953242:  Hold'em No Limit ($0.05/$0.10 USD) - 2021/01/23 14:39:31 ET
Table 'Polydoros II' 6-max Seat #1 is the button
Seat 1: Karl Edgar ($26.59 in chips) 
Seat 2: Marocki ($14.65 in chips) 
Seat 3: BazKaLT ($10.25 in chips) 
Seat 4: teddyKK ($10 in chips) 
Seat 5: handbrake333 ($10.15 in chips) 
Seat 6: mlhnfld ($4.14 in chips) 
Marocki: posts small blind $0.05
BazKaLT: posts big blind $0.10
*** HOLE CARDS ***
teddyKK: folds 
handbrake333: raises $0.20 to $0.30
mlhnfld: folds 
Karl Edgar: folds 
Marocki: folds 
BazKaLT: folds 
Uncalled bet ($0.20) returned to handbrake333
handbrake333 collected $0.25 from pot
handbrake333: doesn't show hand 
*** SUMMARY ***
Total pot $0.25 | Rake $0 
Seat 1: Karl Edgar (button) folded before Flop (didn't bet)
Seat 2: Marocki (small blind) folded before Flop
Seat 3: BazKaLT (big blind) folded before Flop
Seat 4: teddyKK folded before Flop (didn't bet)
Seat 5: handbrake333 collected ($0.25)
Seat 6: mlhnfld folded before Flop (didn't bet)



PokerStars Hand #222966972136:  Hold'em No Limit ($0.05/$0.10 USD) - 2021/01/23 14:39:55 ET
Table 'Polydoros II' 6-max Seat #2 is the button
Seat 1: Karl Edgar ($26.59 in chips) 
Seat 2: Marocki ($14.60 in chips) 
Seat 3: BazKaLT ($10.15 in chips) 
Seat 4: teddyKK ($10 in chips) 
Seat 5: handbrake333 ($10.30 in chips) 
Seat 6: mlhnfld ($4.14 in chips) 
BazKaLT: posts small blind $0.05
teddyKK: posts big blind $0.10
*** HOLE CARDS ***
handbrake333: folds 
mlhnfld: folds 
Karl Edgar: folds 
Marocki: raises $0.15 to $0.25
BazKaLT: folds 
teddyKK: folds 
Uncalled bet ($0.15) returned to Marocki
Marocki collected $0.25 from pot
*** SUMMARY ***
Total pot $0.25 | Rake $0 
Seat 1: Karl Edgar folded before Flop (didn't bet)
Seat 2: Marocki (button) collected ($0.25)
Seat 3: BazKaLT (small blind) folded before Flop
Seat 4: teddyKK (big blind) folded before Flop
Seat 5: handbrake333 folded before Flop (didn't bet)
Seat 6: mlhnfld folded before Flop (didn't bet)



PokerStars Hand #222966988268:  Hold'em No Limit ($0.05/$0.10 USD) - 2021/01/23 14:40:16 ET
Table 'Polydoros II' 6-max Seat #3 is the button
Seat 1: Karl Edgar ($26.59 in chips) 
Seat 2: Marocki ($14.75 in chips) 
Seat 3: BazKaLT ($10.10 in chips) 
Seat 4: teddyKK ($10 in chips) 
Seat 5: handbrake333 ($10.30 in chips) 
Seat 6: mlhnfld ($4.14 in chips) 
teddyKK: posts small blind $0.05
handbrake333: posts big blind $0.10
*** HOLE CARDS ***
mlhnfld: folds 
Karl Edgar: folds 
Marocki: raises $0.15 to $0.25
BazKaLT: folds 
teddyKK: folds 
handbrake333: folds 
Uncalled bet ($0.15) returned to Marocki
Marocki collected $0.25 from pot
*** SUMMARY ***
Total pot $0.25 | Rake $0 
Seat 1: Karl Edgar folded before Flop (didn't bet)
Seat 2: Marocki collected ($0.25)
Seat 3: BazKaLT (button) folded before Flop (didn't bet)
Seat 4: teddyKK (small blind) folded before Flop
Seat 5: handbrake333 (big blind) folded before Flop
Seat 6: mlhnfld folded before Flop (didn't bet)



PokerStars Hand #222967002096:  Hold'em No Limit ($0.05/$0.10 USD) - 2021/01/23 14:40:34 ET
Table 'Polydoros II' 6-max Seat #4 is the button
Seat 1: Karl Edgar ($26.59 in chips) 
Seat 2: Marocki ($14.90 in chips) 
Seat 3: BazKaLT ($10.10 in chips) 
Seat 4: teddyKK ($10 in chips) 
Seat 5: handbrake333 ($10.20 in chips) 
Seat 6: mlhnfld ($4.14 in chips) 
handbrake333: posts small blind $0.05
mlhnfld: posts big blind $0.10
*** HOLE CARDS ***
Karl Edgar: folds 
Marocki: raises $0.15 to $0.25
BazKaLT: folds 
teddyKK: folds 
handbrake333: folds 
mlhnfld: folds 
Uncalled bet ($0.15) returned to Marocki
Marocki collected $0.25 from pot
*** SUMMARY ***
Total pot $0.25 | Rake $0 
Seat 1: Karl Edgar folded before Flop (didn't bet)
Seat 2: Marocki collected ($0.25)
Seat 3: BazKaLT folded before Flop (didn't bet)
Seat 4: teddyKK (button) folded before Flop (didn't bet)
Seat 5: handbrake333 (small blind) folded before Flop
Seat 6: mlhnfld (big blind) folded before Flop



PokerStars Hand #222967027305:  Hold'em No Limit ($0.05/$0.10 USD) - 2021/01/23 14:41:06 ET
Table 'Polydoros II' 6-max Seat #5 is the button
Seat 1: Karl Edgar ($26.59 in chips) 
Seat 2: Marocki ($15.05 in chips) 
Seat 3: BazKaLT ($10.10 in chips) 
Seat 4: teddyKK ($10 in chips) 
Seat 5: handbrake333 ($10.15 in chips) 
Seat 6: mlhnfld ($4.04 in chips) 
mlhnfld: posts small blind $0.05
Karl Edgar: posts big blind $0.10
*** HOLE CARDS ***
Marocki: folds 
BazKaLT has timed out
BazKaLT: folds 
teddyKK: folds 
handbrake333: folds 
mlhnfld: folds 
Uncalled bet ($0.05) returned to Karl Edgar
Karl Edgar collected $0.10 from pot
Karl Edgar: doesn't show hand 
*** SUMMARY ***
Total pot $0.10 | Rake $0 
Seat 1: Karl Edgar (big blind) collected ($0.10)
Seat 2: Marocki folded before Flop (didn't bet)
Seat 3: BazKaLT folded before Flop (didn't bet)
Seat 4: teddyKK folded before Flop (didn't bet)
Seat 5: handbrake333 (button) folded before Flop (didn't bet)
Seat 6: mlhnfld (small blind) folded before Flop



PokerStars Hand #222967049358:  Hold'em No Limit ($0.05/$0.10 USD) - 2021/01/23 14:41:34 ET
Table 'Polydoros II' 6-max Seat #6 is the button
Seat 1: Karl Edgar ($26.64 in chips) 
Seat 2: Marocki ($15.05 in chips) 
Seat 3: BazKaLT ($10.10 in chips) 
Seat 4: teddyKK ($10 in chips) 
Seat 5: handbrake333 ($10.15 in chips) 
Seat 6: mlhnfld ($3.99 in chips) 
Karl Edgar: posts small blind $0.05
Marocki: posts big blind $0.10
*** HOLE CARDS ***
BazKaLT: folds 
teddyKK: raises $0.10 to $0.20
handbrake333: folds 
mlhnfld: raises $0.55 to $0.75
Karl Edgar: folds 
Marocki: folds 
teddyKK: calls $0.55
*** FLOP *** [7c 6c Kh]
teddyKK: checks 
mlhnfld: bets $0.79
teddyKK: raises $8.46 to $9.25 and is all-in
mlhnfld: folds 
Uncalled bet ($8.46) returned to teddyKK
teddyKK collected $3.08 from pot
teddyKK: doesn't show hand 
*** SUMMARY ***
Total pot $3.23 | Rake $0.15 
Board [7c 6c Kh]
Seat 1: Karl Edgar (small blind) folded before Flop
Seat 2: Marocki (big blind) folded before Flop
Seat 3: BazKaLT folded before Flop (didn't bet)
Seat 4: teddyKK collected ($3.08)
Seat 5: handbrake333 folded before Flop (didn't bet)
Seat 6: mlhnfld (button) folded on the Flop



PokerStars Hand #222961818454:  Hold'em No Limit ($0.05/$0.10 USD) - 2021/01/23 12:42:33 ET
Table 'Polydoros II' 6-max Seat #6 is the button
Seat 1: Rainlol ($10 in chips) 
Seat 2: Viten'kA83 ($10 in chips) 
Seat 4: watersnow66 ($11.76 in chips) 
Seat 5: asaphookz ($11.37 in chips) 
Seat 6: buranela ($10.09 in chips) 
Rainlol: posts small blind $0.05
Viten'kA83: posts big blind $0.10
AAAcostA: sits out 
*** HOLE CARDS ***
watersnow66: calls $0.10
asaphookz: folds 
buranela: raises $0.35 to $0.45
Rainlol: folds 
Viten'kA83: folds 
watersnow66: calls $0.35
*** FLOP *** [Ad Jd Ks]
watersnow66: checks 
buranela: bets $0.75
watersnow66: calls $0.75
*** TURN *** [Ad Jd Ks] [4c]
watersnow66: checks 
buranela: bets $2.10
watersnow66: calls $2.10
*** RIVER *** [Ad Jd Ks 4c] [Kh]
watersnow66: checks 
buranela: bets $6.79 and is all-in
watersnow66: calls $6.79
*** SHOW DOWN ***
buranela: shows [Td Qs] (a straight, Ten to Ace)
watersnow66: shows [Kc Ac] (a full house, Kings full of Aces)
watersnow66 collected $19.42 from pot
*** SUMMARY ***
Total pot $20.33 | Rake $0.91 
Board [Ad Jd Ks 4c Kh]
Seat 1: Rainlol (small blind) folded before Flop
Seat 2: Viten'kA83 (big blind) folded before Flop
Seat 4: watersnow66 showed [Kc Ac] and won ($19.42) with a full house, Kings full of Aces
Seat 5: asaphookz folded before Flop (didn't bet)
Seat 6: buranela (button) showed [Td Qs] and lost with a straight, Ten to Ace



PokerStars Hand #222961870540:  Hold'em No Limit ($0.05/$0.10 USD) - 2021/01/23 12:43:50 ET
Table 'Polydoros II' 6-max Seat #1 is the button
Seat 1: Rainlol ($9.95 in chips) 
Seat 2: Viten'kA83 ($10 in chips) 
Seat 3: AAAcostA ($10 in chips) 
Seat 4: watersnow66 ($21.09 in chips) 
Seat 5: asaphookz ($11.37 in chips) 
Seat 6: buranela ($10 in chips) 
Viten'kA83: posts small blind $0.05
AAAcostA: posts big blind $0.10
*** HOLE CARDS ***
watersnow66: folds 
asaphookz: folds 
buranela: raises $0.15 to $0.25
Rainlol: calls $0.25
Viten'kA83: folds 
AAAcostA: calls $0.15
*** FLOP *** [6h Tc 6s]
AAAcostA: checks 
buranela: bets $0.40
Rainlol: folds 
AAAcostA: folds 
Uncalled bet ($0.40) returned to buranela
buranela collected $0.76 from pot
*** SUMMARY ***
Total pot $0.80 | Rake $0.04 
Board [6h Tc 6s]
Seat 1: Rainlol (button) folded on the Flop
Seat 2: Viten'kA83 (small blind) folded before Flop
Seat 3: AAAcostA (big blind) folded on the Flop
Seat 4: watersnow66 folded before Flop (didn't bet)
Seat 5: asaphookz folded before Flop (didn't bet)
Seat 6: buranela collected ($0.76)



PokerStars Hand #222967099340:  Hold'em No Limit ($0.05/$0.10 USD) - 2021/01/23 14:42:38 ET
Table 'Polydoros II' 6-max Seat #1 is the button
Seat 1: Karl Edgar ($26.59 in chips) 
Seat 2: Marocki ($14.95 in chips) 
Seat 3: BazKaLT ($10.10 in chips) 
Seat 4: teddyKK ($11.54 in chips) 
Seat 5: handbrake333 ($10.15 in chips) 
Seat 6: mlhnfld ($2.45 in chips) 
Marocki: posts small blind $0.05
BazKaLT: posts big blind $0.10
*** HOLE CARDS ***
teddyKK: folds 
handbrake333: folds 
mlhnfld: folds 
Karl Edgar: folds 
Marocki: folds 
Uncalled bet ($0.05) returned to BazKaLT
BazKaLT collected $0.10 from pot
BazKaLT: doesn't show hand 
*** SUMMARY ***
Total pot $0.10 | Rake $0 
Seat 1: Karl Edgar (button) folded before Flop (didn't bet)
Seat 2: Marocki (small blind) folded before Flop
Seat 3: BazKaLT (big blind) collected ($0.10)
Seat 4: teddyKK folded before Flop (didn't bet)
Seat 5: handbrake333 folded before Flop (didn't bet)
Seat 6: mlhnfld folded before Flop (didn't bet)



PokerStars Hand #222967117831:  Hold'em No Limit ($0.05/$0.10 USD) - 2021/01/23 14:43:02 ET
Table 'Polydoros II' 6-max Seat #2 is the button
Seat 1: Karl Edgar ($26.59 in chips) 
Seat 2: Marocki ($14.90 in chips) 
Seat 3: BazKaLT ($10.15 in chips) 
Seat 4: teddyKK ($11.54 in chips) 
Seat 5: handbrake333 ($10.15 in chips) 
Seat 6: mlhnfld ($2.45 in chips) 
BazKaLT: posts small blind $0.05
teddyKK: posts big blind $0.10
*** HOLE CARDS ***
handbrake333: folds 
mlhnfld: calls $0.10
Karl Edgar: folds 
Marocki: folds 
BazKaLT: folds 
teddyKK: checks 
*** FLOP *** [6d 5d 2s]
teddyKK: bets $0.18
mlhnfld: folds 
Uncalled bet ($0.18) returned to teddyKK
teddyKK collected $0.24 from pot
teddyKK: doesn't show hand 
*** SUMMARY ***
Total pot $0.25 | Rake $0.01 
Board [6d 5d 2s]
Seat 1: Karl Edgar folded before Flop (didn't bet)
Seat 2: Marocki (button) folded before Flop (didn't bet)
Seat 3: BazKaLT (small blind) folded before Flop
Seat 4: teddyKK (big blind) collected ($0.24)
Seat 5: handbrake333 folded before Flop (didn't bet)
Seat 6: mlhnfld folded on the Flop



PokerStars Hand #222967137071:  Hold'em No Limit ($0.05/$0.10 USD) - 2021/01/23 14:43:26 ET
Table 'Polydoros II' 6-max Seat #3 is the button
Seat 1: Karl Edgar ($26.59 in chips) 
Seat 2: Marocki ($14.90 in chips) 
Seat 3: BazKaLT ($10.10 in chips) 
Seat 4: teddyKK ($11.68 in chips) 
Seat 5: handbrake333 ($10.15 in chips) 
Seat 6: mlhnfld ($2.35 in chips) 
teddyKK: posts small blind $0.05
handbrake333: posts big blind $0.10
*** HOLE CARDS ***
mlhnfld: folds 
Karl Edgar: folds 
Marocki: folds 
BazKaLT: raises $0.15 to $0.25
teddyKK: folds 
handbrake333: calls $0.15
*** FLOP *** [2c 6h Ah]
handbrake333: checks 
BazKaLT: bets $0.35
handbrake333: folds 
Uncalled bet ($0.35) returned to BazKaLT
BazKaLT collected $0.53 from pot
BazKaLT: doesn't show hand 
*** SUMMARY ***
Total pot $0.55 | Rake $0.02 
Board [2c 6h Ah]
Seat 1: Karl Edgar folded before Flop (didn't bet)
Seat 2: Marocki folded before Flop (didn't bet)
Seat 3: BazKaLT (button) collected ($0.53)
Seat 4: teddyKK (small blind) folded before Flop
Seat 5: handbrake333 (big blind) folded on the Flop
Seat 6: mlhnfld folded before Flop (didn't bet)



PokerStars Hand #222967155057:  Hold'em No Limit ($0.05/$0.10 USD) - 2021/01/23 14:43:49 ET
Table 'Polydoros II' 6-max Seat #4 is the button
Seat 1: Karl Edgar ($26.59 in chips) 
Seat 2: Marocki ($14.90 in chips) 
Seat 3: BazKaLT ($10.38 in chips) 
Seat 4: teddyKK ($11.63 in chips) 
Seat 5: handbrake333 ($10 in chips) 
Seat 6: mlhnfld ($2.35 in chips) 
handbrake333: posts small blind $0.05
mlhnfld: posts big blind $0.10
*** HOLE CARDS ***
Karl Edgar: folds 
Marocki: folds 
BazKaLT: raises $0.10 to $0.20
teddyKK: folds 
handbrake333: folds 
mlhnfld: folds 
Uncalled bet ($0.10) returned to BazKaLT
BazKaLT collected $0.25 from pot
BazKaLT: doesn't show hand 
*** SUMMARY ***
Total pot $0.25 | Rake $0 
Seat 1: Karl Edgar folded before Flop (didn't bet)
Seat 2: Marocki folded before Flop (didn't bet)
Seat 3: BazKaLT collected ($0.25)
Seat 4: teddyKK (button) folded before Flop (didn't bet)
Seat 5: handbrake333 (small blind) folded before Flop
Seat 6: mlhnfld (big blind) folded before Flop



PokerStars Hand #222967174928:  Hold'em No Limit ($0.05/$0.10 USD) - 2021/01/23 14:44:15 ET
Table 'Polydoros II' 6-max Seat #5 is the button
Seat 1: Karl Edgar ($26.59 in chips) 
Seat 2: Marocki ($14.90 in chips) 
Seat 3: BazKaLT ($10.53 in chips) 
Seat 4: teddyKK ($11.63 in chips) 
Seat 5: handbrake333 ($10 in chips) 
Seat 6: mlhnfld ($2.25 in chips) 
mlhnfld: posts small blind $0.05
Karl Edgar: posts big blind $0.10
*** HOLE CARDS ***
Marocki: folds 
BazKaLT: folds 
teddyKK: folds 
handbrake333: folds 
mlhnfld: folds 
Uncalled bet ($0.05) returned to Karl Edgar
Karl Edgar collected $0.10 from pot
Karl Edgar: doesn't show hand 
*** SUMMARY ***
Total pot $0.10 | Rake $0 
Seat 1: Karl Edgar (big blind) collected ($0.10)
Seat 2: Marocki folded before Flop (didn't bet)
Seat 3: BazKaLT folded before Flop (didn't bet)
Seat 4: teddyKK folded before Flop (didn't bet)
Seat 5: handbrake333 (button) folded before Flop (didn't bet)
Seat 6: mlhnfld (small blind) folded before Flop



PokerStars Hand #222967186042:  Hold'em No Limit ($0.05/$0.10 USD) - 2021/01/23 14:44:29 ET
Table 'Polydoros II' 6-max Seat #6 is the button
Seat 1: Karl Edgar ($26.64 in chips) 
Seat 2: Marocki ($14.90 in chips) 
Seat 3: BazKaLT ($10.53 in chips) 
Seat 4: teddyKK ($11.63 in chips) 
Seat 5: handbrake333 ($10 in chips) 
Seat 6: mlhnfld ($2.20 in chips) 
Karl Edgar: posts small blind $0.05
Marocki: posts big blind $0.10
*** HOLE CARDS ***
BazKaLT: folds 
teddyKK: folds 
handbrake333: folds 
mlhnfld: folds 
Karl Edgar: raises $0.15 to $0.25
Marocki: calls $0.15
*** FLOP *** [4d 6c Js]
Karl Edgar: bets $0.32
Marocki: folds 
Uncalled bet ($0.32) returned to Karl Edgar
Karl Edgar collected $0.48 from pot
Karl Edgar: doesn't show hand 
*** SUMMARY ***
Total pot $0.50 | Rake $0.02 
Board [4d 6c Js]
Seat 1: Karl Edgar (small blind) collected ($0.48)
Seat 2: Marocki (big blind) folded on the Flop
Seat 3: BazKaLT folded before Flop (didn't bet)
Seat 4: teddyKK folded before Flop (didn't bet)
Seat 5: handbrake333 folded before Flop (didn't bet)
Seat 6: mlhnfld (button) folded before Flop (didn't bet)



PokerStars Hand #222967215789:  Hold'em No Limit ($0.05/$0.10 USD) - 2021/01/23 14:45:07 ET
Table 'Polydoros II' 6-max Seat #1 is the button
Seat 1: Karl Edgar ($26.87 in chips) 
Seat 2: Marocki ($14.65 in chips) 
Seat 3: BazKaLT ($10.53 in chips) 
Seat 4: teddyKK ($11.63 in chips) 
Seat 5: handbrake333 ($10 in chips) 
Seat 6: mlhnfld ($2.20 in chips) 
Marocki: posts small blind $0.05
BazKaLT: posts big blind $0.10
*** HOLE CARDS ***
teddyKK: folds 
handbrake333: folds 
mlhnfld: raises $0.10 to $0.20
Karl Edgar: folds 
Marocki: folds 
BazKaLT: folds 
Uncalled bet ($0.10) returned to mlhnfld
mlhnfld collected $0.25 from pot
mlhnfld: doesn't show hand 
*** SUMMARY ***
Total pot $0.25 | Rake $0 
Seat 1: Karl Edgar (button) folded before Flop (didn't bet)
Seat 2: Marocki (small blind) folded before Flop
Seat 3: BazKaLT (big blind) folded before Flop
Seat 4: teddyKK folded before Flop (didn't bet)
Seat 5: handbrake333 folded before Flop (didn't bet)
Seat 6: mlhnfld collected ($0.25)



PokerStars Hand #222967224756:  Hold'em No Limit ($0.05/$0.10 USD) - 2021/01/23 14:45:19 ET
Table 'Polydoros II' 6-max Seat #2 is the button
Seat 1: Karl Edgar ($26.87 in chips) 
Seat 2: Marocki ($14.60 in chips) 
Seat 3: BazKaLT ($10.43 in chips) 
Seat 4: teddyKK ($11.63 in chips) 
Seat 5: handbrake333 ($10 in chips) 
Seat 6: mlhnfld ($2.35 in chips) 
BazKaLT: posts small blind $0.05
teddyKK: posts big blind $0.10
*** HOLE CARDS ***
handbrake333: folds 
mlhnfld: folds 
Karl Edgar: folds 
Marocki: folds 
BazKaLT: raises $0.15 to $0.25
teddyKK: folds 
Uncalled bet ($0.15) returned to BazKaLT
BazKaLT collected $0.20 from pot
BazKaLT: doesn't show hand 
*** SUMMARY ***
Total pot $0.20 | Rake $0 
Seat 1: Karl Edgar folded before Flop (didn't bet)
Seat 2: Marocki (button) folded before Flop (didn't bet)
Seat 3: BazKaLT (small blind) collected ($0.20)
Seat 4: teddyKK (big blind) folded before Flop
Seat 5: handbrake333 folded before Flop (didn't bet)
Seat 6: mlhnfld folded before Flop (didn't bet)



PokerStars Hand #222967235278:  Hold'em No Limit ($0.05/$0.10 USD) - 2021/01/23 14:45:32 ET
Table 'Polydoros II' 6-max Seat #3 is the button
Seat 1: Karl Edgar ($26.87 in chips) 
Seat 2: Marocki ($14.60 in chips) 
Seat 3: BazKaLT ($10.53 in chips) 
Seat 4: teddyKK ($11.53 in chips) 
Seat 5: handbrake333 ($10 in chips) 
Seat 6: mlhnfld ($2.35 in chips) 
teddyKK: posts small blind $0.05
handbrake333: posts big blind $0.10
*** HOLE CARDS ***
mlhnfld: folds 
Karl Edgar: raises $0.20 to $0.30
Marocki: folds 
BazKaLT: folds 
teddyKK: folds 
handbrake333: folds 
Uncalled bet ($0.20) returned to Karl Edgar
Karl Edgar collected $0.25 from pot
Karl Edgar: doesn't show hand 
*** SUMMARY ***
Total pot $0.25 | Rake $0 
Seat 1: Karl Edgar collected ($0.25)
Seat 2: Marocki folded before Flop (didn't bet)
Seat 3: BazKaLT (button) folded before Flop (didn't bet)
Seat 4: teddyKK (small blind) folded before Flop
Seat 5: handbrake333 (big blind) folded before Flop
Seat 6: mlhnfld folded before Flop (didn't bet)



PokerStars Hand #222967247188:  Hold'em No Limit ($0.05/$0.10 USD) - 2021/01/23 14:45:47 ET
Table 'Polydoros II' 6-max Seat #4 is the button
Seat 1: Karl Edgar ($27.02 in chips) 
Seat 2: Marocki ($14.60 in chips) 
Seat 3: BazKaLT ($10.53 in chips) 
Seat 4: teddyKK ($11.48 in chips) 
Seat 5: handbrake333 ($10 in chips) 
Seat 6: mlhnfld ($2.35 in chips) 
handbrake333: posts small blind $0.05
mlhnfld: posts big blind $0.10
*** HOLE CARDS ***
Karl Edgar: folds 
Marocki: folds 
BazKaLT: folds 
teddyKK: raises $0.20 to $0.30
handbrake333: folds 
mlhnfld: folds 
Uncalled bet ($0.20) returned to teddyKK
teddyKK collected $0.25 from pot
teddyKK: doesn't show hand 
*** SUMMARY ***
Total pot $0.25 | Rake $0 
Seat 1: Karl Edgar folded before Flop (didn't bet)
Seat 2: Marocki folded before Flop (didn't bet)
Seat 3: BazKaLT folded before Flop (didn't bet)
Seat 4: teddyKK (button) collected ($0.25)
Seat 5: handbrake333 (small blind) folded before Flop
Seat 6: mlhnfld (big blind) folded before Flop



PokerStars Hand #222967260664:  Hold'em No Limit ($0.05/$0.10 USD) - 2021/01/23 14:46:05 ET
Table 'Polydoros II' 6-max Seat #5 is the button
Seat 1: Karl Edgar ($27.02 in chips) 
Seat 2: Marocki ($14.60 in chips) 
Seat 3: BazKaLT ($10.53 in chips) 
Seat 4: teddyKK ($11.63 in chips) 
Seat 5: handbrake333 ($10 in chips) 
Seat 6: mlhnfld ($2.25 in chips) 
mlhnfld: posts small blind $0.05
Karl Edgar: posts big blind $0.10
*** HOLE CARDS ***
Marocki: folds 
BazKaLT: folds 
teddyKK: folds 
handbrake333: folds 
mlhnfld: raises $0.10 to $0.20
Karl Edgar: folds 
Uncalled bet ($0.10) returned to mlhnfld
mlhnfld collected $0.20 from pot
mlhnfld: doesn't show hand 
*** SUMMARY ***
Total pot $0.20 | Rake $0 
Seat 1: Karl Edgar (big blind) folded before Flop
Seat 2: Marocki folded before Flop (didn't bet)
Seat 3: BazKaLT folded before Flop (didn't bet)
Seat 4: teddyKK folded before Flop (didn't bet)
Seat 5: handbrake333 (button) folded before Flop (didn't bet)
Seat 6: mlhnfld (small blind) collected ($0.20)



PokerStars Hand #222967271028:  Hold'em No Limit ($0.05/$0.10 USD) - 2021/01/23 14:46:18 ET
Table 'Polydoros II' 6-max Seat #6 is the button
Seat 1: Karl Edgar ($26.92 in chips) 
Seat 2: Marocki ($14.60 in chips) 
Seat 3: BazKaLT ($10.53 in chips) 
Seat 4: teddyKK ($11.63 in chips) 
Seat 5: handbrake333 ($10 in chips) 
Seat 6: mlhnfld ($2.35 in chips) 
Karl Edgar: posts small blind $0.05
Marocki: posts big blind $0.10
*** HOLE CARDS ***
BazKaLT: folds 
teddyKK: folds 
handbrake333: folds 
mlhnfld: folds 
Karl Edgar: raises $0.15 to $0.25
Marocki: folds 
Uncalled bet ($0.15) returned to Karl Edgar
Karl Edgar collected $0.20 from pot
Karl Edgar: doesn't show hand 
*** SUMMARY ***
Total pot $0.20 | Rake $0 
Seat 1: Karl Edgar (small blind) collected ($0.20)
Seat 2: Marocki (big blind) folded before Flop
Seat 3: BazKaLT folded before Flop (didn't bet)
Seat 4: teddyKK folded before Flop (didn't bet)
Seat 5: handbrake333 folded before Flop (didn't bet)
Seat 6: mlhnfld (button) folded before Flop (didn't bet)



PokerStars Hand #222967284249:  Hold'em No Limit ($0.05/$0.10 USD) - 2021/01/23 14:46:35 ET
Table 'Polydoros II' 6-max Seat #1 is the button
Seat 1: Karl Edgar ($27.02 in chips) 
Seat 2: Marocki ($14.50 in chips) 
Seat 4: teddyKK ($11.63 in chips) 
Seat 5: handbrake333 ($10 in chips) 
Seat 6: mlhnfld ($2.35 in chips) 
Marocki: posts small blind $0.05
BazKaLT: is sitting out 
teddyKK: posts big blind $0.10
*** HOLE CARDS ***
handbrake333: folds 
BazKaLT leaves the table
mlhnfld: folds 
Karl Edgar: folds 
Marocki: folds 
Uncalled bet ($0.05) returned to teddyKK
teddyKK collected $0.10 from pot
teddyKK: doesn't show hand 
*** SUMMARY ***
Total pot $0.10 | Rake $0 
Seat 1: Karl Edgar (button) folded before Flop (didn't bet)
Seat 2: Marocki (small blind) folded before Flop
Seat 4: teddyKK (big blind) collected ($0.10)
Seat 5: handbrake333 folded before Flop (didn't bet)
Seat 6: mlhnfld folded before Flop (didn't bet)



PokerStars Hand #222967293692:  Hold'em No Limit ($0.05/$0.10 USD) - 2021/01/23 14:46:47 ET
Table 'Polydoros II' 6-max Seat #2 is the button
Seat 1: Karl Edgar ($27.02 in chips) 
Seat 2: Marocki ($14.45 in chips) 
Seat 4: teddyKK ($11.68 in chips) 
Seat 5: handbrake333 ($10 in chips) 
Seat 6: mlhnfld ($2.35 in chips) 
teddyKK: posts small blind $0.05
handbrake333: posts big blind $0.10
*** HOLE CARDS ***
Yurjevich joins the table at seat #3 
mlhnfld: folds 
Karl Edgar: folds 
Marocki: raises $0.15 to $0.25
teddyKK: folds 
Yurjevich leaves the table
handbrake333: folds 
Uncalled bet ($0.15) returned to Marocki
Marocki collected $0.25 from pot
*** SUMMARY ***
Total pot $0.25 | Rake $0 
Seat 1: Karl Edgar folded before Flop (didn't bet)
Seat 2: Marocki (button) collected ($0.25)
Seat 4: teddyKK (small blind) folded before Flop
Seat 5: handbrake333 (big blind) folded before Flop
Seat 6: mlhnfld folded before Flop (didn't bet)



