PokerStars Hand #222977464919:  Hold'em No Limit ($0.05/$0.10 USD) - 2021/01/23 18:21:34 ET
Table 'Lova III' 6-max Seat #6 is the button
Seat 1: capaoloko ($8.80 in chips) 
Seat 2: christhebeast66 ($11.13 in chips) 
Seat 3: pezao sp ($10.84 in chips) 
Seat 4: snooptea ($12.72 in chips) 
Seat 6: alexos04 ($10 in chips) 
capaoloko: posts small blind $0.05
christhebeast66: posts big blind $0.10
hempju1ce: sits out 
*** HOLE CARDS ***
pezao sp: folds 
snooptea: raises $0.18 to $0.28
alexos04: folds 
capaoloko: folds 
christhebeast66: calls $0.18
*** FLOP *** [Js Td As]
christhebeast66: bets $0.10
snooptea: calls $0.10
*** TURN *** [Js Td As] [Qd]
christhebeast66: bets $0.10
snooptea: calls $0.10
*** RIVER *** [Js Td As Qd] [Ah]
christhebeast66: bets $0.10
snooptea: raises $1.20 to $1.30
christhebeast66: folds 
Uncalled bet ($1.20) returned to snooptea
snooptea collected $1.16 from pot
*** SUMMARY ***
Total pot $1.21 | Rake $0.05 
Board [Js Td As Qd Ah]
Seat 1: capaoloko (small blind) folded before Flop
Seat 2: christhebeast66 (big blind) folded on the River
Seat 3: pezao sp folded before Flop (didn't bet)
Seat 4: snooptea collected ($1.16)
Seat 6: alexos04 (button) folded before Flop (didn't bet)



PokerStars Hand #222977508781:  Hold'em No Limit ($0.05/$0.10 USD) - 2021/01/23 18:22:40 ET
Table 'Lova III' 6-max Seat #1 is the button
Seat 1: capaoloko ($8.75 in chips) 
Seat 2: christhebeast66 ($10.55 in chips) 
Seat 3: pezao sp ($10.84 in chips) 
Seat 4: snooptea ($13.30 in chips) 
Seat 6: alexos04 ($10 in chips) 
christhebeast66: posts small blind $0.05
pezao sp: posts big blind $0.10
hempju1ce: sits out 
*** HOLE CARDS ***
snooptea: folds 
alexos04: folds 
capaoloko: folds 
christhebeast66: calls $0.05
pezao sp: checks 
*** FLOP *** [9c 7s Ah]
christhebeast66: bets $0.10
pezao sp: calls $0.10
*** TURN *** [9c 7s Ah] [Ts]
christhebeast66: bets $0.10
pezao sp: raises $0.40 to $0.50
christhebeast66: calls $0.40
*** RIVER *** [9c 7s Ah Ts] [7d]
christhebeast66: checks 
pezao sp: bets $1.01
christhebeast66: calls $1.01
*** SHOW DOWN ***
pezao sp: shows [6c 8s] (a straight, Six to Ten)
christhebeast66: mucks hand 
pezao sp collected $3.27 from pot
*** SUMMARY ***
Total pot $3.42 | Rake $0.15 
Board [9c 7s Ah Ts 7d]
Seat 1: capaoloko (button) folded before Flop (didn't bet)
Seat 2: christhebeast66 (small blind) mucked
Seat 3: pezao sp (big blind) showed [6c 8s] and won ($3.27) with a straight, Six to Ten
Seat 4: snooptea folded before Flop (didn't bet)
Seat 6: alexos04 folded before Flop (didn't bet)



PokerStars Hand #222977575518:  Hold'em No Limit ($0.05/$0.10 USD) - 2021/01/23 18:24:09 ET
Table 'Lova III' 6-max Seat #2 is the button
Seat 1: capaoloko ($8.75 in chips) 
Seat 2: christhebeast66 ($8.84 in chips) 
Seat 3: pezao sp ($12.40 in chips) 
Seat 4: snooptea ($13.30 in chips) 
Seat 6: alexos04 ($10 in chips) 
pezao sp: posts small blind $0.05
snooptea: posts big blind $0.10
hempju1ce: sits out 
*** HOLE CARDS ***
alexos04: raises $0.20 to $0.30
capaoloko: folds 
christhebeast66: calls $0.30
pezao sp: folds 
snooptea: folds 
*** FLOP *** [7h 2s 4s]
alexos04: bets $0.50
christhebeast66: folds 
Uncalled bet ($0.50) returned to alexos04
alexos04 collected $0.72 from pot
alexos04: doesn't show hand 
*** SUMMARY ***
Total pot $0.75 | Rake $0.03 
Board [7h 2s 4s]
Seat 1: capaoloko folded before Flop (didn't bet)
Seat 2: christhebeast66 (button) folded on the Flop
Seat 3: pezao sp (small blind) folded before Flop
Seat 4: snooptea (big blind) folded before Flop
Seat 6: alexos04 collected ($0.72)



PokerStars Hand #222977593380:  Hold'em No Limit ($0.05/$0.10 USD) - 2021/01/23 18:24:37 ET
Table 'Lova III' 6-max Seat #3 is the button
Seat 1: capaoloko ($8.75 in chips) 
Seat 2: christhebeast66 ($8.54 in chips) 
Seat 3: pezao sp ($12.35 in chips) 
Seat 4: snooptea ($13.20 in chips) 
Seat 5: hempju1ce ($10.14 in chips) 
Seat 6: alexos04 ($10.42 in chips) 
snooptea: posts small blind $0.05
hempju1ce: posts big blind $0.10
*** HOLE CARDS ***
alexos04: folds 
capaoloko: folds 
christhebeast66: calls $0.10
pezao sp: raises $0.30 to $0.40
snooptea: folds 
hempju1ce: folds 
christhebeast66: folds 
Uncalled bet ($0.30) returned to pezao sp
pezao sp collected $0.35 from pot
pezao sp: doesn't show hand 
*** SUMMARY ***
Total pot $0.35 | Rake $0 
Seat 1: capaoloko folded before Flop (didn't bet)
Seat 2: christhebeast66 folded before Flop
Seat 3: pezao sp (button) collected ($0.35)
Seat 4: snooptea (small blind) folded before Flop
Seat 5: hempju1ce (big blind) folded before Flop
Seat 6: alexos04 folded before Flop (didn't bet)



PokerStars Hand #222977614347:  Hold'em No Limit ($0.05/$0.10 USD) - 2021/01/23 18:25:09 ET
Table 'Lova III' 6-max Seat #4 is the button
Seat 1: capaoloko ($8.75 in chips) 
Seat 2: christhebeast66 ($8.44 in chips) 
Seat 3: pezao sp ($12.60 in chips) 
Seat 4: snooptea ($13.15 in chips) 
Seat 5: hempju1ce ($10.04 in chips) 
Seat 6: alexos04 ($10.42 in chips) 
hempju1ce: posts small blind $0.05
alexos04: posts big blind $0.10
*** HOLE CARDS ***
capaoloko has timed out
capaoloko: folds 
christhebeast66: calls $0.10
pezao sp: folds 
snooptea: folds 
hempju1ce: calls $0.05
alexos04: checks 
*** FLOP *** [5d 4d Js]
hempju1ce: checks 
alexos04: checks 
christhebeast66: checks 
*** TURN *** [5d 4d Js] [2d]
hempju1ce: checks 
alexos04: checks 
christhebeast66: bets $0.10
hempju1ce: raises $0.10 to $0.20
alexos04: folds 
christhebeast66: calls $0.10
*** RIVER *** [5d 4d Js 2d] [Ts]
hempju1ce: checks 
christhebeast66: checks 
*** SHOW DOWN ***
hempju1ce: shows [2c 2h] (three of a kind, Deuces)
christhebeast66: mucks hand 
hempju1ce collected $0.67 from pot
*** SUMMARY ***
Total pot $0.70 | Rake $0.03 
Board [5d 4d Js 2d Ts]
Seat 1: capaoloko folded before Flop (didn't bet)
Seat 2: christhebeast66 mucked
Seat 3: pezao sp folded before Flop (didn't bet)
Seat 4: snooptea (button) folded before Flop (didn't bet)
Seat 5: hempju1ce (small blind) showed [2c 2h] and won ($0.67) with three of a kind, Deuces
Seat 6: alexos04 (big blind) folded on the Turn



PokerStars Hand #222977664878:  Hold'em No Limit ($0.05/$0.10 USD) - 2021/01/23 18:26:26 ET
Table 'Lova III' 6-max Seat #5 is the button
Seat 1: capaoloko ($8.75 in chips) 
Seat 2: christhebeast66 ($8.14 in chips) 
Seat 3: pezao sp ($12.60 in chips) 
Seat 4: snooptea ($13.15 in chips) 
Seat 5: hempju1ce ($10.41 in chips) 
Seat 6: alexos04 ($10.32 in chips) 
alexos04: posts small blind $0.05
capaoloko: posts big blind $0.10
*** HOLE CARDS ***
christhebeast66: calls $0.10
pezao sp: folds 
snooptea: raises $0.17 to $0.27
hempju1ce: folds 
alexos04: folds 
capaoloko: calls $0.17
christhebeast66: folds 
*** FLOP *** [9s 5s 2h]
capaoloko has timed out
capaoloko: checks 
snooptea: bets $0.26
capaoloko: calls $0.26
*** TURN *** [9s 5s 2h] [Jd]
capaoloko: checks 
snooptea: bets $0.99
capaoloko: folds 
Uncalled bet ($0.99) returned to snooptea
snooptea collected $1.16 from pot
*** SUMMARY ***
Total pot $1.21 | Rake $0.05 
Board [9s 5s 2h Jd]
Seat 1: capaoloko (big blind) folded on the Turn
Seat 2: christhebeast66 folded before Flop
Seat 3: pezao sp folded before Flop (didn't bet)
Seat 4: snooptea collected ($1.16)
Seat 5: hempju1ce (button) folded before Flop (didn't bet)
Seat 6: alexos04 (small blind) folded before Flop



PokerStars Hand #222977729774:  Hold'em No Limit ($0.05/$0.10 USD) - 2021/01/23 18:28:05 ET
Table 'Lova III' 6-max Seat #6 is the button
Seat 1: capaoloko ($8.22 in chips) 
Seat 2: christhebeast66 ($8.04 in chips) 
Seat 3: pezao sp ($12.60 in chips) 
Seat 4: snooptea ($13.78 in chips) 
Seat 5: hempju1ce ($10.41 in chips) 
Seat 6: alexos04 ($10.27 in chips) 
capaoloko: posts small blind $0.05
christhebeast66: posts big blind $0.10
*** HOLE CARDS ***
pezao sp: folds 
snooptea: folds 
hempju1ce: folds 
alexos04: raises $0.20 to $0.30
capaoloko: folds 
christhebeast66: calls $0.20
*** FLOP *** [9d 4h 6h]
christhebeast66: checks 
alexos04: checks 
*** TURN *** [9d 4h 6h] [Qs]
christhebeast66: bets $0.10
alexos04: calls $0.10
*** RIVER *** [9d 4h 6h Qs] [Td]
christhebeast66: bets $0.10
alexos04: calls $0.10
*** SHOW DOWN ***
christhebeast66: shows [Qd 8s] (a pair of Queens)
alexos04: mucks hand 
christhebeast66 collected $1 from pot
*** SUMMARY ***
Total pot $1.05 | Rake $0.05 
Board [9d 4h 6h Qs Td]
Seat 1: capaoloko (small blind) folded before Flop
Seat 2: christhebeast66 (big blind) showed [Qd 8s] and won ($1) with a pair of Queens
Seat 3: pezao sp folded before Flop (didn't bet)
Seat 4: snooptea folded before Flop (didn't bet)
Seat 5: hempju1ce folded before Flop (didn't bet)
Seat 6: alexos04 (button) mucked



PokerStars Hand #222977775155:  Hold'em No Limit ($0.05/$0.10 USD) - 2021/01/23 18:29:14 ET
Table 'Lova III' 6-max Seat #1 is the button
Seat 1: capaoloko ($8.17 in chips) 
Seat 2: christhebeast66 ($8.54 in chips) 
Seat 3: pezao sp ($12.60 in chips) 
Seat 4: snooptea ($13.78 in chips) 
Seat 5: hempju1ce ($10.41 in chips) 
Seat 6: alexos04 ($10 in chips) 
christhebeast66: posts small blind $0.05
pezao sp: posts big blind $0.10
*** HOLE CARDS ***
snooptea has timed out
snooptea: folds 
hempju1ce: folds 
alexos04: folds 
capaoloko: folds 
christhebeast66: calls $0.05
pezao sp: checks 
*** FLOP *** [4d Ac 8s]
christhebeast66: checks 
pezao sp: checks 
*** TURN *** [4d Ac 8s] [Jc]
christhebeast66: bets $0.10
pezao sp: calls $0.10
*** RIVER *** [4d Ac 8s Jc] [Ad]
christhebeast66: bets $0.10
pezao sp: calls $0.10
*** SHOW DOWN ***
christhebeast66: shows [Tc 7s] (a pair of Aces)
pezao sp: shows [Kc 8h] (two pair, Aces and Eights)
pezao sp collected $0.57 from pot
*** SUMMARY ***
Total pot $0.60 | Rake $0.03 
Board [4d Ac 8s Jc Ad]
Seat 1: capaoloko (button) folded before Flop (didn't bet)
Seat 2: christhebeast66 (small blind) showed [Tc 7s] and lost with a pair of Aces
Seat 3: pezao sp (big blind) showed [Kc 8h] and won ($0.57) with two pair, Aces and Eights
Seat 4: snooptea folded before Flop (didn't bet)
Seat 5: hempju1ce folded before Flop (didn't bet)
Seat 6: alexos04 folded before Flop (didn't bet)



PokerStars Hand #222977821979:  Hold'em No Limit ($0.05/$0.10 USD) - 2021/01/23 18:30:26 ET
Table 'Lova III' 6-max Seat #2 is the button
Seat 1: capaoloko ($8.17 in chips) 
Seat 2: christhebeast66 ($8.24 in chips) 
Seat 3: pezao sp ($12.87 in chips) 
Seat 4: snooptea ($13.78 in chips) 
Seat 5: hempju1ce ($10.41 in chips) 
Seat 6: alexos04 ($10 in chips) 
pezao sp: posts small blind $0.05
snooptea: posts big blind $0.10
*** HOLE CARDS ***
hempju1ce has timed out
hempju1ce: folds 
alexos04: folds 
capaoloko: calls $0.10
christhebeast66: calls $0.10
pezao sp: calls $0.05
snooptea: raises $0.34 to $0.44
capaoloko: calls $0.34
christhebeast66: folds 
pezao sp: calls $0.34
*** FLOP *** [9c Ad 9s]
pezao sp: checks 
snooptea: bets $0.53
capaoloko: calls $0.53
pezao sp: folds 
*** TURN *** [9c Ad 9s] [7c]
snooptea: bets $1.80
capaoloko: calls $1.80
*** RIVER *** [9c Ad 9s 7c] [Tc]
snooptea: bets $2.10
capaoloko: raises $3.30 to $5.40 and is all-in
snooptea: folds 
Uncalled bet ($3.30) returned to capaoloko
capaoloko collected $9.82 from pot
capaoloko: doesn't show hand 
*** SUMMARY ***
Total pot $10.28 | Rake $0.46 
Board [9c Ad 9s 7c Tc]
Seat 1: capaoloko collected ($9.82)
Seat 2: christhebeast66 (button) folded before Flop
Seat 3: pezao sp (small blind) folded on the Flop
Seat 4: snooptea (big blind) folded on the River
Seat 5: hempju1ce folded before Flop (didn't bet)
Seat 6: alexos04 folded before Flop (didn't bet)



PokerStars Hand #222977899771:  Hold'em No Limit ($0.05/$0.10 USD) - 2021/01/23 18:32:25 ET
Table 'Lova III' 6-max Seat #3 is the button
Seat 1: capaoloko ($13.12 in chips) 
Seat 2: christhebeast66 ($8.14 in chips) 
Seat 3: pezao sp ($12.43 in chips) 
Seat 4: snooptea ($8.91 in chips) 
Seat 5: hempju1ce ($10.41 in chips) 
Seat 6: alexos04 ($10 in chips) 
snooptea: posts small blind $0.05
hempju1ce: posts big blind $0.10
*** HOLE CARDS ***
alexos04: folds 
capaoloko: calls $0.10
christhebeast66: calls $0.10
pezao sp: folds 
snooptea: calls $0.05
hempju1ce: checks 
*** FLOP *** [4s 8d 5s]
snooptea: checks 
hempju1ce: checks 
capaoloko: checks 
christhebeast66: checks 
*** TURN *** [4s 8d 5s] [2h]
snooptea: bets $0.25
hempju1ce: folds 
capaoloko: calls $0.25
christhebeast66: folds 
*** RIVER *** [4s 8d 5s 2h] [Tc]
snooptea: checks 
capaoloko: bets $0.40
snooptea: calls $0.40
*** SHOW DOWN ***
capaoloko: shows [3h Qc] (high card Queen)
snooptea: shows [9s 8c] (a pair of Eights)
snooptea collected $1.62 from pot
*** SUMMARY ***
Total pot $1.70 | Rake $0.08 
Board [4s 8d 5s 2h Tc]
Seat 1: capaoloko showed [3h Qc] and lost with high card Queen
Seat 2: christhebeast66 folded on the Turn
Seat 3: pezao sp (button) folded before Flop (didn't bet)
Seat 4: snooptea (small blind) showed [9s 8c] and won ($1.62) with a pair of Eights
Seat 5: hempju1ce (big blind) folded on the Turn
Seat 6: alexos04 folded before Flop (didn't bet)



PokerStars Hand #222977945719:  Hold'em No Limit ($0.05/$0.10 USD) - 2021/01/23 18:33:35 ET
Table 'Lova III' 6-max Seat #4 is the button
Seat 2: christhebeast66 ($8.04 in chips) 
Seat 3: pezao sp ($12.43 in chips) 
Seat 4: snooptea ($9.78 in chips) 
Seat 5: hempju1ce ($10.31 in chips) 
Seat 6: alexos04 ($10 in chips) 
hempju1ce: posts small blind $0.05
alexos04: posts big blind $0.10
*** HOLE CARDS ***
christhebeast66: calls $0.10
pezao sp: folds 
snooptea: folds 
hempju1ce: calls $0.05
alexos04: checks 
*** FLOP *** [4c Jh 5c]
hempju1ce: checks 
alexos04: checks 
christhebeast66: checks 
*** TURN *** [4c Jh 5c] [4d]
hempju1ce: checks 
alexos04: checks 
christhebeast66: bets $0.15
hempju1ce: folds 
alexos04: folds 
Uncalled bet ($0.15) returned to christhebeast66
christhebeast66 collected $0.29 from pot
christhebeast66: doesn't show hand 
*** SUMMARY ***
Total pot $0.30 | Rake $0.01 
Board [4c Jh 5c 4d]
Seat 2: christhebeast66 collected ($0.29)
Seat 3: pezao sp folded before Flop (didn't bet)
Seat 4: snooptea (button) folded before Flop (didn't bet)
Seat 5: hempju1ce (small blind) folded on the Turn
Seat 6: alexos04 (big blind) folded on the Turn



PokerStars Hand #222977988971:  Hold'em No Limit ($0.05/$0.10 USD) - 2021/01/23 18:34:41 ET
Table 'Lova III' 6-max Seat #5 is the button
Seat 2: christhebeast66 ($8.23 in chips) 
Seat 3: pezao sp ($12.43 in chips) 
Seat 4: snooptea ($9.78 in chips) 
Seat 5: hempju1ce ($10.21 in chips) 
Seat 6: alexos04 ($10 in chips) 
alexos04: posts small blind $0.05
christhebeast66: posts big blind $0.10
*** HOLE CARDS ***
pezao sp: folds 
snooptea: folds 
hempju1ce: folds 
alexos04: raises $0.20 to $0.30
christhebeast66: folds 
Uncalled bet ($0.20) returned to alexos04
alexos04 collected $0.20 from pot
alexos04: doesn't show hand 
*** SUMMARY ***
Total pot $0.20 | Rake $0 
Seat 2: christhebeast66 (big blind) folded before Flop
Seat 3: pezao sp folded before Flop (didn't bet)
Seat 4: snooptea folded before Flop (didn't bet)
Seat 5: hempju1ce (button) folded before Flop (didn't bet)
Seat 6: alexos04 (small blind) collected ($0.20)



PokerStars Hand #222978007663:  Hold'em No Limit ($0.05/$0.10 USD) - 2021/01/23 18:35:10 ET
Table 'Lova III' 6-max Seat #6 is the button
Seat 2: christhebeast66 ($8.13 in chips) 
Seat 3: pezao sp ($12.43 in chips) 
Seat 4: snooptea ($9.78 in chips) 
Seat 5: hempju1ce ($10.21 in chips) 
Seat 6: alexos04 ($10.10 in chips) 
christhebeast66: posts small blind $0.05
pezao sp: posts big blind $0.10
*** HOLE CARDS ***
snooptea: folds 
hempju1ce: calls $0.10
alexos04: raises $0.30 to $0.40
christhebeast66: folds 
pezao sp: folds 
hempju1ce: calls $0.30
*** FLOP *** [Qs 5s Qh]
hempju1ce: checks 
alexos04: checks 
*** TURN *** [Qs 5s Qh] [3h]
hempju1ce: checks 
alexos04: bets $0.50
hempju1ce: calls $0.50
*** RIVER *** [Qs 5s Qh 3h] [3c]
hempju1ce: bets $0.93
alexos04: folds 
Uncalled bet ($0.93) returned to hempju1ce
hempju1ce collected $1.86 from pot
hempju1ce: doesn't show hand 
*** SUMMARY ***
Total pot $1.95 | Rake $0.09 
Board [Qs 5s Qh 3h 3c]
Seat 2: christhebeast66 (small blind) folded before Flop
Seat 3: pezao sp (big blind) folded before Flop
Seat 4: snooptea folded before Flop (didn't bet)
Seat 5: hempju1ce collected ($1.86)
Seat 6: alexos04 (button) folded on the River



PokerStars Hand #222978057110:  Hold'em No Limit ($0.05/$0.10 USD) - 2021/01/23 18:36:26 ET
Table 'Lova III' 6-max Seat #2 is the button
Seat 2: christhebeast66 ($8.08 in chips) 
Seat 3: pezao sp ($12.33 in chips) 
Seat 4: snooptea ($9.78 in chips) 
Seat 5: hempju1ce ($11.17 in chips) 
Seat 6: alexos04 ($10 in chips) 
pezao sp: posts small blind $0.05
snooptea: posts big blind $0.10
*** HOLE CARDS ***
hempju1ce: folds 
alexos04: folds 
christhebeast66: calls $0.10
pezao sp: folds 
snooptea: checks 
*** FLOP *** [9s 5s Qs]
snooptea: checks 
christhebeast66: bets $0.10
snooptea: folds 
Uncalled bet ($0.10) returned to christhebeast66
christhebeast66 collected $0.24 from pot
christhebeast66: doesn't show hand 
*** SUMMARY ***
Total pot $0.25 | Rake $0.01 
Board [9s 5s Qs]
Seat 2: christhebeast66 (button) collected ($0.24)
Seat 3: pezao sp (small blind) folded before Flop
Seat 4: snooptea (big blind) folded on the Flop
Seat 5: hempju1ce folded before Flop (didn't bet)
Seat 6: alexos04 folded before Flop (didn't bet)



PokerStars Hand #222978094454:  Hold'em No Limit ($0.05/$0.10 USD) - 2021/01/23 18:37:24 ET
Table 'Lova III' 6-max Seat #3 is the button
Seat 3: pezao sp ($12.28 in chips) 
Seat 5: hempju1ce ($11.17 in chips) 
Seat 6: alexos04 ($10 in chips) 
hempju1ce: posts small blind $0.05
alexos04: posts big blind $0.10
*** HOLE CARDS ***
pezao sp: folds 
hempju1ce: folds 
Uncalled bet ($0.05) returned to alexos04
alexos04 collected $0.10 from pot
alexos04: doesn't show hand 
*** SUMMARY ***
Total pot $0.10 | Rake $0 
Seat 3: pezao sp (button) folded before Flop (didn't bet)
Seat 5: hempju1ce (small blind) folded before Flop
Seat 6: alexos04 (big blind) collected ($0.10)



PokerStars Hand #222978100759:  Hold'em No Limit ($0.05/$0.10 USD) - 2021/01/23 18:37:34 ET
Table 'Lova III' 6-max Seat #5 is the button
Seat 3: pezao sp ($12.28 in chips) 
Seat 5: hempju1ce ($11.12 in chips) 
Seat 6: alexos04 ($10.05 in chips) 
alexos04: posts small blind $0.05
pezao sp: posts big blind $0.10
*** HOLE CARDS ***
hempju1ce: folds 
alexos04: calls $0.05
pezao sp: checks 
*** FLOP *** [8c Qd 7d]
alexos04: checks 
pezao sp: bets $0.10
alexos04: calls $0.10
*** TURN *** [8c Qd 7d] [9d]
alexos04: checks 
pezao sp: checks 
*** RIVER *** [8c Qd 7d 9d] [Kd]
alexos04: checks 
pezao sp: checks 
*** SHOW DOWN ***
alexos04: shows [4c 5h] (high card King)
pezao sp: shows [Tc 8h] (a pair of Eights)
pezao sp collected $0.38 from pot
*** SUMMARY ***
Total pot $0.40 | Rake $0.02 
Board [8c Qd 7d 9d Kd]
Seat 3: pezao sp (big blind) showed [Tc 8h] and won ($0.38) with a pair of Eights
Seat 5: hempju1ce (button) folded before Flop (didn't bet)
Seat 6: alexos04 (small blind) showed [4c 5h] and lost with high card King



PokerStars Hand #222978143786:  Hold'em No Limit ($0.05/$0.10 USD) - 2021/01/23 18:38:41 ET
Table 'Lova III' 6-max Seat #6 is the button
Seat 3: pezao sp ($12.46 in chips) 
Seat 5: hempju1ce ($11.12 in chips) 
Seat 6: alexos04 ($10 in chips) 
pezao sp: posts small blind $0.05
hempju1ce: posts big blind $0.10
*** HOLE CARDS ***
alexos04: folds 
pezao sp: folds 
Uncalled bet ($0.05) returned to hempju1ce
hempju1ce collected $0.10 from pot
hempju1ce: doesn't show hand 
*** SUMMARY ***
Total pot $0.10 | Rake $0 
Seat 3: pezao sp (small blind) folded before Flop
Seat 5: hempju1ce (big blind) collected ($0.10)
Seat 6: alexos04 (button) folded before Flop (didn't bet)



PokerStars Hand #222978148934:  Hold'em No Limit ($0.05/$0.10 USD) - 2021/01/23 18:38:49 ET
Table 'Lova III' 6-max Seat #3 is the button
Seat 3: pezao sp ($12.41 in chips) 
Seat 5: hempju1ce ($11.17 in chips) 
Seat 6: alexos04 ($10 in chips) 
hempju1ce: posts small blind $0.05
alexos04: posts big blind $0.10
*** HOLE CARDS ***
pezao sp: folds 
hempju1ce: calls $0.05
alexos04: checks 
*** FLOP *** [Kh Jc 8d]
hempju1ce: checks 
alexos04: checks 
*** TURN *** [Kh Jc 8d] [Qc]
hempju1ce: bets $0.10
alexos04: raises $0.30 to $0.40
hempju1ce: raises $0.30 to $0.70
alexos04: calls $0.30
*** RIVER *** [Kh Jc 8d Qc] [8h]
hempju1ce: bets $1.53
alexos04: calls $1.53
*** SHOW DOWN ***
hempju1ce: shows [Qs 8s] (a full house, Eights full of Queens)
alexos04: mucks hand 
hempju1ce collected $4.45 from pot
*** SUMMARY ***
Total pot $4.66 | Rake $0.21 
Board [Kh Jc 8d Qc 8h]
Seat 3: pezao sp (button) folded before Flop (didn't bet)
Seat 5: hempju1ce (small blind) showed [Qs 8s] and won ($4.45) with a full house, Eights full of Queens
Seat 6: alexos04 (big blind) mucked



PokerStars Hand #222978183045:  Hold'em No Limit ($0.05/$0.10 USD) - 2021/01/23 18:39:42 ET
Table 'Lova III' 6-max Seat #5 is the button
Seat 1: capaoloko ($12.37 in chips) 
Seat 3: pezao sp ($12.41 in chips) 
Seat 5: hempju1ce ($13.29 in chips) 
Seat 6: alexos04 ($10 in chips) 
alexos04: posts small blind $0.05
capaoloko: posts big blind $0.10
*** HOLE CARDS ***
pezao sp: folds 
hempju1ce: folds 
alexos04: raises $0.20 to $0.30
capaoloko: folds 
Uncalled bet ($0.20) returned to alexos04
alexos04 collected $0.20 from pot
alexos04: doesn't show hand 
*** SUMMARY ***
Total pot $0.20 | Rake $0 
Seat 1: capaoloko (big blind) folded before Flop
Seat 3: pezao sp folded before Flop (didn't bet)
Seat 5: hempju1ce (button) folded before Flop (didn't bet)
Seat 6: alexos04 (small blind) collected ($0.20)



PokerStars Hand #222978188166:  Hold'em No Limit ($0.05/$0.10 USD) - 2021/01/23 18:39:50 ET
Table 'Lova III' 6-max Seat #6 is the button
Seat 3: pezao sp ($12.41 in chips) 
Seat 5: hempju1ce ($13.29 in chips) 
Seat 6: alexos04 ($10.10 in chips) 
pezao sp: posts small blind $0.05
hempju1ce: posts big blind $0.10
*** HOLE CARDS ***
alexos04: folds 
capaoloko leaves the table
pezao sp: raises $0.20 to $0.30
lisszz174 joins the table at seat #1 
hempju1ce: folds 
Uncalled bet ($0.20) returned to pezao sp
pezao sp collected $0.20 from pot
pezao sp: doesn't show hand 
*** SUMMARY ***
Total pot $0.20 | Rake $0 
Seat 3: pezao sp (small blind) collected ($0.20)
Seat 5: hempju1ce (big blind) folded before Flop
Seat 6: alexos04 (button) folded before Flop (didn't bet)



PokerStars Hand #222978198637:  Hold'em No Limit ($0.05/$0.10 USD) - 2021/01/23 18:40:06 ET
Table 'Lova III' 6-max Seat #3 is the button
Seat 3: pezao sp ($12.51 in chips) 
Seat 5: hempju1ce ($13.19 in chips) 
Seat 6: alexos04 ($10.10 in chips) 
hempju1ce: posts small blind $0.05
alexos04: posts big blind $0.10
lisszz174: sits out 
*** HOLE CARDS ***
pezao sp: folds 
hempju1ce: folds 
Uncalled bet ($0.05) returned to alexos04
alexos04 collected $0.10 from pot
alexos04: doesn't show hand 
*** SUMMARY ***
Total pot $0.10 | Rake $0 
Seat 3: pezao sp (button) folded before Flop (didn't bet)
Seat 5: hempju1ce (small blind) folded before Flop
Seat 6: alexos04 (big blind) collected ($0.10)



PokerStars Hand #222978205280:  Hold'em No Limit ($0.05/$0.10 USD) - 2021/01/23 18:40:17 ET
Table 'Lova III' 6-max Seat #5 is the button
Seat 1: lisszz174 ($10 in chips) 
Seat 3: pezao sp ($12.51 in chips) 
Seat 5: hempju1ce ($13.14 in chips) 
Seat 6: alexos04 ($10.15 in chips) 
alexos04: posts small blind $0.05
lisszz174: posts big blind $0.10
*** HOLE CARDS ***
pezao sp: raises $0.15 to $0.25
hempju1ce: folds 
alexos04: folds 
lisszz174: calls $0.15
*** FLOP *** [Jd 4h Kd]
lisszz174: bets $0.25
pezao sp: calls $0.25
*** TURN *** [Jd 4h Kd] [6d]
lisszz174: bets $0.25
pezao sp: calls $0.25
*** RIVER *** [Jd 4h Kd 6d] [5d]
lisszz174: bets $0.25
pezao sp: calls $0.25
*** SHOW DOWN ***
lisszz174: shows [9h Qh] (high card King)
pezao sp: shows [Ks Js] (two pair, Kings and Jacks)
pezao sp collected $1.96 from pot
*** SUMMARY ***
Total pot $2.05 | Rake $0.09 
Board [Jd 4h Kd 6d 5d]
Seat 1: lisszz174 (big blind) showed [9h Qh] and lost with high card King
Seat 3: pezao sp showed [Ks Js] and won ($1.96) with two pair, Kings and Jacks
Seat 5: hempju1ce (button) folded before Flop (didn't bet)
Seat 6: alexos04 (small blind) folded before Flop



PokerStars Hand #222978265723:  Hold'em No Limit ($0.05/$0.10 USD) - 2021/01/23 18:41:52 ET
Table 'Lova III' 6-max Seat #6 is the button
Seat 1: lisszz174 ($9 in chips) 
Seat 3: pezao sp ($13.47 in chips) 
Seat 5: hempju1ce ($13.14 in chips) 
Seat 6: alexos04 ($10.10 in chips) 
lisszz174: posts small blind $0.05
pezao sp: posts big blind $0.10
*** HOLE CARDS ***
hempju1ce: folds 
alexos04: raises $0.20 to $0.30
lisszz174: folds 
pezao sp: folds 
Uncalled bet ($0.20) returned to alexos04
alexos04 collected $0.25 from pot
alexos04: doesn't show hand 
*** SUMMARY ***
Total pot $0.25 | Rake $0 
Seat 1: lisszz174 (small blind) folded before Flop
Seat 3: pezao sp (big blind) folded before Flop
Seat 5: hempju1ce folded before Flop (didn't bet)
Seat 6: alexos04 (button) collected ($0.25)



PokerStars Hand #222978283763:  Hold'em No Limit ($0.05/$0.10 USD) - 2021/01/23 18:42:05 ET
Table 'Lova III' 6-max Seat #1 is the button
Seat 1: lisszz174 ($8.95 in chips) 
Seat 3: pezao sp ($13.37 in chips) 
Seat 5: hempju1ce ($13.14 in chips) 
Seat 6: alexos04 ($10.25 in chips) 
pezao sp: posts small blind $0.05
hempju1ce: posts big blind $0.10
*** HOLE CARDS ***
alexos04: raises $0.20 to $0.30
lisszz174: folds 
pezao sp: folds 
hempju1ce: folds 
Uncalled bet ($0.20) returned to alexos04
alexos04 collected $0.25 from pot
snooptea was removed from the table for failing to post
snooptea leaves the table
alexos04: doesn't show hand 
*** SUMMARY ***
Total pot $0.25 | Rake $0 
Seat 1: lisszz174 (button) folded before Flop (didn't bet)
Seat 3: pezao sp (small blind) folded before Flop
Seat 5: hempju1ce (big blind) folded before Flop
Seat 6: alexos04 collected ($0.25)



PokerStars Hand #222978826345:  Hold'em No Limit ($0.05/$0.10 USD) - 2021/01/23 18:57:18 ET
Table 'Lova III' 6-max Seat #6 is the button
Seat 1: kefsamkef ($9.94 in chips) 
Seat 2: Schengo90 ($5.57 in chips) 
Seat 4: Ricey923 ($14.43 in chips) 
Seat 6: alexos04 ($10.28 in chips) 
kefsamkef: posts small blind $0.05
Schengo90: posts big blind $0.10
hempju1ce: sits out 
*** HOLE CARDS ***
Ricey923: calls $0.10
alexos04: folds 
kefsamkef: raises $0.30 to $0.40
Schengo90: folds 
Ricey923: calls $0.30
*** FLOP *** [6h 5d 9d]
kefsamkef: bets $0.43
pezao sp leaves the table
Ricey923: calls $0.43
*** TURN *** [6h 5d 9d] [Js]
attilakorte joins the table at seat #3 
kefsamkef: bets $1.20
Ricey923: folds 
Uncalled bet ($1.20) returned to kefsamkef
kefsamkef collected $1.68 from pot
kefsamkef: doesn't show hand 
*** SUMMARY ***
Total pot $1.76 | Rake $0.08 
Board [6h 5d 9d Js]
Seat 1: kefsamkef (small blind) collected ($1.68)
Seat 2: Schengo90 (big blind) folded before Flop
Seat 4: Ricey923 folded on the Turn
Seat 6: alexos04 (button) folded before Flop (didn't bet)



PokerStars Hand #222978847254:  Hold'em No Limit ($0.05/$0.10 USD) - 2021/01/23 18:58:05 ET
Table 'Lova III' 6-max Seat #1 is the button
Seat 1: kefsamkef ($10.79 in chips) 
Seat 2: Schengo90 ($5.47 in chips) 
Seat 3: attilakorte ($10 in chips) 
Seat 4: Ricey923 ($13.60 in chips) 
Seat 6: alexos04 ($10.28 in chips) 
Schengo90: posts small blind $0.05
attilakorte: posts big blind $0.10
hempju1ce: sits out 
*** HOLE CARDS ***
Ricey923: raises $0.10 to $0.20
alexos04: folds 
kefsamkef: calls $0.20
Schengo90: raises $5.27 to $5.47 and is all-in
attilakorte: folds 
Ricey923: calls $5.27
kefsamkef: folds 
*** FLOP *** [9h 5s Jc]
*** TURN *** [9h 5s Jc] [5d]
*** RIVER *** [9h 5s Jc 5d] [Jd]
*** SHOW DOWN ***
Schengo90: shows [Qs Kh] (two pair, Jacks and Fives)
Ricey923: shows [4h 4c] (two pair, Jacks and Fives - lower kicker)
Schengo90 collected $10.73 from pot
*** SUMMARY ***
Total pot $11.24 | Rake $0.51 
Board [9h 5s Jc 5d Jd]
Seat 1: kefsamkef (button) folded before Flop
Seat 2: Schengo90 (small blind) showed [Qs Kh] and won ($10.73) with two pair, Jacks and Fives
Seat 3: attilakorte (big blind) folded before Flop
Seat 4: Ricey923 showed [4h 4c] and lost with two pair, Jacks and Fives
Seat 6: alexos04 folded before Flop (didn't bet)



PokerStars Hand #222978860457:  Hold'em No Limit ($0.05/$0.10 USD) - 2021/01/23 18:58:35 ET
Table 'Lova III' 6-max Seat #2 is the button
Seat 1: kefsamkef ($10.59 in chips) 
Seat 2: Schengo90 ($10.73 in chips) 
Seat 3: attilakorte ($10 in chips) 
Seat 4: Ricey923 ($8.13 in chips) 
Seat 6: alexos04 ($10.28 in chips) 
attilakorte: posts small blind $0.05
Ricey923: posts big blind $0.10
hempju1ce: sits out 
*** HOLE CARDS ***
alexos04: folds 
kefsamkef: folds 
Schengo90: folds 
attilakorte: folds 
Uncalled bet ($0.05) returned to Ricey923
Ricey923 collected $0.10 from pot
Ricey923: doesn't show hand 
*** SUMMARY ***
Total pot $0.10 | Rake $0 
Seat 1: kefsamkef folded before Flop (didn't bet)
Seat 2: Schengo90 (button) folded before Flop (didn't bet)
Seat 3: attilakorte (small blind) folded before Flop
Seat 4: Ricey923 (big blind) collected ($0.10)
Seat 6: alexos04 folded before Flop (didn't bet)



PokerStars Hand #222978865924:  Hold'em No Limit ($0.05/$0.10 USD) - 2021/01/23 18:58:47 ET
Table 'Lova III' 6-max Seat #3 is the button
Seat 1: kefsamkef ($10.59 in chips) 
Seat 2: Schengo90 ($10.73 in chips) 
Seat 3: attilakorte ($10 in chips) 
Seat 4: Ricey923 ($8.18 in chips) 
Seat 5: hempju1ce ($11.94 in chips) 
Seat 6: alexos04 ($10.28 in chips) 
Ricey923: posts small blind $0.05
hempju1ce: posts big blind $0.10
*** HOLE CARDS ***
alexos04: raises $0.20 to $0.30
kefsamkef: folds 
Schengo90: folds 
attilakorte: calls $0.30
Ricey923: calls $0.25
hempju1ce: calls $0.20
*** FLOP *** [6h Ad 8c]
Ricey923: checks 
hempju1ce: checks 
alexos04: checks 
attilakorte: checks 
*** TURN *** [6h Ad 8c] [6c]
Ricey923: checks 
hempju1ce: checks 
alexos04: checks 
attilakorte: checks 
*** RIVER *** [6h Ad 8c 6c] [Js]
Ricey923: checks 
hempju1ce: checks 
alexos04: checks 
attilakorte: checks 
*** SHOW DOWN ***
Ricey923: shows [Qh Kc] (a pair of Sixes)
hempju1ce: shows [Ts 8s] (two pair, Eights and Sixes)
alexos04: shows [9s 9d] (two pair, Nines and Sixes)
attilakorte: mucks hand 
alexos04 collected $1.15 from pot
*** SUMMARY ***
Total pot $1.20 | Rake $0.05 
Board [6h Ad 8c 6c Js]
Seat 1: kefsamkef folded before Flop (didn't bet)
Seat 2: Schengo90 folded before Flop (didn't bet)
Seat 3: attilakorte (button) mucked
Seat 4: Ricey923 (small blind) showed [Qh Kc] and lost with a pair of Sixes
Seat 5: hempju1ce (big blind) showed [Ts 8s] and lost with two pair, Eights and Sixes
Seat 6: alexos04 showed [9s 9d] and won ($1.15) with two pair, Nines and Sixes



PokerStars Hand #222978900422:  Hold'em No Limit ($0.05/$0.10 USD) - 2021/01/23 19:00:05 ET
Table 'Lova III' 6-max Seat #4 is the button
Seat 1: kefsamkef ($10.59 in chips) 
Seat 2: Schengo90 ($10.73 in chips) 
Seat 3: attilakorte ($10 in chips) 
Seat 4: Ricey923 ($7.88 in chips) 
Seat 5: hempju1ce ($11.64 in chips) 
Seat 6: alexos04 ($11.13 in chips) 
hempju1ce: posts small blind $0.05
alexos04: posts big blind $0.10
*** HOLE CARDS ***
kefsamkef: folds 
Schengo90: raises $0.15 to $0.25
attilakorte: folds 
Ricey923: folds 
hempju1ce: folds 
alexos04: folds 
Uncalled bet ($0.15) returned to Schengo90
Schengo90 collected $0.25 from pot
Schengo90: doesn't show hand 
*** SUMMARY ***
Total pot $0.25 | Rake $0 
Seat 1: kefsamkef folded before Flop (didn't bet)
Seat 2: Schengo90 collected ($0.25)
Seat 3: attilakorte folded before Flop (didn't bet)
Seat 4: Ricey923 (button) folded before Flop (didn't bet)
Seat 5: hempju1ce (small blind) folded before Flop
Seat 6: alexos04 (big blind) folded before Flop



PokerStars Hand #222978908851:  Hold'em No Limit ($0.05/$0.10 USD) - 2021/01/23 19:00:22 ET
Table 'Lova III' 6-max Seat #5 is the button
Seat 1: kefsamkef ($10.59 in chips) 
Seat 2: Schengo90 ($10.88 in chips) 
Seat 3: attilakorte ($10 in chips) 
Seat 4: Ricey923 ($7.88 in chips) 
Seat 5: hempju1ce ($11.59 in chips) 
Seat 6: alexos04 ($11.03 in chips) 
alexos04: posts small blind $0.05
kefsamkef: posts big blind $0.10
*** HOLE CARDS ***
Schengo90: folds 
attilakorte: folds 
Ricey923: calls $0.10
hempju1ce: folds 
alexos04: calls $0.05
kefsamkef: checks 
*** FLOP *** [2s 4s 7s]
alexos04: checks 
kefsamkef: checks 
Ricey923: bets $0.10
alexos04: folds 
kefsamkef: folds 
Uncalled bet ($0.10) returned to Ricey923
Ricey923 collected $0.29 from pot
Ricey923: doesn't show hand 
*** SUMMARY ***
Total pot $0.30 | Rake $0.01 
Board [2s 4s 7s]
Seat 1: kefsamkef (big blind) folded on the Flop
Seat 2: Schengo90 folded before Flop (didn't bet)
Seat 3: attilakorte folded before Flop (didn't bet)
Seat 4: Ricey923 collected ($0.29)
Seat 5: hempju1ce (button) folded before Flop (didn't bet)
Seat 6: alexos04 (small blind) folded on the Flop



PokerStars Hand #222978928167:  Hold'em No Limit ($0.05/$0.10 USD) - 2021/01/23 19:01:00 ET
Table 'Lova III' 6-max Seat #6 is the button
Seat 1: kefsamkef ($10.49 in chips) 
Seat 2: Schengo90 ($10.88 in chips) 
Seat 3: attilakorte ($10 in chips) 
Seat 4: Ricey923 ($8.07 in chips) 
Seat 5: hempju1ce ($11.59 in chips) 
Seat 6: alexos04 ($10.93 in chips) 
kefsamkef: posts small blind $0.05
Schengo90: posts big blind $0.10
*** HOLE CARDS ***
attilakorte: raises $0.12 to $0.22
Ricey923: calls $0.22
hempju1ce: folds 
alexos04: folds 
kefsamkef: folds 
Schengo90: calls $0.12
*** FLOP *** [5s Jh Ac]
Schengo90: checks 
attilakorte: bets $0.35
Ricey923: calls $0.35
Schengo90: folds 
*** TURN *** [5s Jh Ac] [Td]
attilakorte: bets $0.70
Ricey923: folds 
Uncalled bet ($0.70) returned to attilakorte
attilakorte collected $1.35 from pot
attilakorte: doesn't show hand 
*** SUMMARY ***
Total pot $1.41 | Rake $0.06 
Board [5s Jh Ac Td]
Seat 1: kefsamkef (small blind) folded before Flop
Seat 2: Schengo90 (big blind) folded on the Flop
Seat 3: attilakorte collected ($1.35)
Seat 4: Ricey923 folded on the Turn
Seat 5: hempju1ce folded before Flop (didn't bet)
Seat 6: alexos04 (button) folded before Flop (didn't bet)



PokerStars Hand #222978943193:  Hold'em No Limit ($0.05/$0.10 USD) - 2021/01/23 19:01:27 ET
Table 'Lova III' 6-max Seat #1 is the button
Seat 1: kefsamkef ($10.44 in chips) 
Seat 2: Schengo90 ($10.66 in chips) 
Seat 3: attilakorte ($10.78 in chips) 
Seat 4: Ricey923 ($7.50 in chips) 
Seat 5: hempju1ce ($11.59 in chips) 
Seat 6: alexos04 ($10.93 in chips) 
Schengo90: posts small blind $0.05
attilakorte: posts big blind $0.10
*** HOLE CARDS ***
Ricey923: raises $7.40 to $7.50 and is all-in
hempju1ce: folds 
alexos04: folds 
kefsamkef: folds 
Schengo90: folds 
attilakorte: folds 
Uncalled bet ($7.40) returned to Ricey923
Ricey923 collected $0.25 from pot
Ricey923: doesn't show hand 
*** SUMMARY ***
Total pot $0.25 | Rake $0 
Seat 1: kefsamkef (button) folded before Flop (didn't bet)
Seat 2: Schengo90 (small blind) folded before Flop
Seat 3: attilakorte (big blind) folded before Flop
Seat 4: Ricey923 collected ($0.25)
Seat 5: hempju1ce folded before Flop (didn't bet)
Seat 6: alexos04 folded before Flop (didn't bet)



PokerStars Hand #222978951478:  Hold'em No Limit ($0.05/$0.10 USD) - 2021/01/23 19:01:42 ET
Table 'Lova III' 6-max Seat #2 is the button
Seat 1: kefsamkef ($10.44 in chips) 
Seat 2: Schengo90 ($10.61 in chips) 
Seat 3: attilakorte ($10.68 in chips) 
Seat 4: Ricey923 ($7.65 in chips) 
Seat 5: hempju1ce ($11.59 in chips) 
Seat 6: alexos04 ($10.93 in chips) 
attilakorte: posts small blind $0.05
Ricey923: posts big blind $0.10
*** HOLE CARDS ***
hempju1ce: folds 
alexos04: raises $0.20 to $0.30
kefsamkef: calls $0.30
Schengo90: calls $0.30
attilakorte: folds 
Ricey923: calls $0.20
*** FLOP *** [9s 6h 6s]
Ricey923: checks 
alexos04: checks 
kefsamkef: checks 
Schengo90: checks 
*** TURN *** [9s 6h 6s] [Ks]
Ricey923: checks 
alexos04: checks 
kefsamkef: bets $0.60
Schengo90: folds 
Ricey923: folds 
alexos04: folds 
Uncalled bet ($0.60) returned to kefsamkef
kefsamkef collected $1.19 from pot
kefsamkef: doesn't show hand 
*** SUMMARY ***
Total pot $1.25 | Rake $0.06 
Board [9s 6h 6s Ks]
Seat 1: kefsamkef collected ($1.19)
Seat 2: Schengo90 (button) folded on the Turn
Seat 3: attilakorte (small blind) folded before Flop
Seat 4: Ricey923 (big blind) folded on the Turn
Seat 5: hempju1ce folded before Flop (didn't bet)
Seat 6: alexos04 folded on the Turn



PokerStars Hand #222978985970:  Hold'em No Limit ($0.05/$0.10 USD) - 2021/01/23 19:02:41 ET
Table 'Lova III' 6-max Seat #3 is the button
Seat 1: kefsamkef ($11.33 in chips) 
Seat 2: Schengo90 ($10.31 in chips) 
Seat 3: attilakorte ($10.63 in chips) 
Seat 4: Ricey923 ($7.35 in chips) 
Seat 5: hempju1ce ($11.59 in chips) 
Seat 6: alexos04 ($10.63 in chips) 
Ricey923: posts small blind $0.05
hempju1ce: posts big blind $0.10
*** HOLE CARDS ***
alexos04: raises $0.20 to $0.30
kefsamkef: folds 
Schengo90: calls $0.30
attilakorte: folds 
Ricey923: folds 
hempju1ce: folds 
*** FLOP *** [6h 9h 2c]
alexos04: bets $0.30
Schengo90: calls $0.30
*** TURN *** [6h 9h 2c] [5h]
alexos04: checks 
Schengo90: bets $0.74
alexos04: folds 
Uncalled bet ($0.74) returned to Schengo90
Schengo90 collected $1.29 from pot
Schengo90: doesn't show hand 
*** SUMMARY ***
Total pot $1.35 | Rake $0.06 
Board [6h 9h 2c 5h]
Seat 1: kefsamkef folded before Flop (didn't bet)
Seat 2: Schengo90 collected ($1.29)
Seat 3: attilakorte (button) folded before Flop (didn't bet)
Seat 4: Ricey923 (small blind) folded before Flop
Seat 5: hempju1ce (big blind) folded before Flop
Seat 6: alexos04 folded on the Turn



PokerStars Hand #222979017795:  Hold'em No Limit ($0.05/$0.10 USD) - 2021/01/23 19:03:36 ET
Table 'Lova III' 6-max Seat #4 is the button
Seat 1: kefsamkef ($11.33 in chips) 
Seat 2: Schengo90 ($11 in chips) 
Seat 3: attilakorte ($10.63 in chips) 
Seat 4: Ricey923 ($7.30 in chips) 
Seat 5: hempju1ce ($11.49 in chips) 
Seat 6: alexos04 ($10.03 in chips) 
hempju1ce: posts small blind $0.05
alexos04: posts big blind $0.10
*** HOLE CARDS ***
kefsamkef: folds 
Schengo90: folds 
attilakorte: folds 
Ricey923: folds 
hempju1ce: calls $0.05
alexos04: checks 
*** FLOP *** [Qc 4d 6h]
hempju1ce: checks 
alexos04: checks 
*** TURN *** [Qc 4d 6h] [Ah]
hempju1ce: bets $0.10
alexos04: folds 
Uncalled bet ($0.10) returned to hempju1ce
hempju1ce collected $0.19 from pot
hempju1ce: doesn't show hand 
*** SUMMARY ***
Total pot $0.20 | Rake $0.01 
Board [Qc 4d 6h Ah]
Seat 1: kefsamkef folded before Flop (didn't bet)
Seat 2: Schengo90 folded before Flop (didn't bet)
Seat 3: attilakorte folded before Flop (didn't bet)
Seat 4: Ricey923 (button) folded before Flop (didn't bet)
Seat 5: hempju1ce (small blind) collected ($0.19)
Seat 6: alexos04 (big blind) folded on the Turn



PokerStars Hand #222979037814:  Hold'em No Limit ($0.05/$0.10 USD) - 2021/01/23 19:04:11 ET
Table 'Lova III' 6-max Seat #5 is the button
Seat 1: kefsamkef ($11.33 in chips) 
Seat 2: Schengo90 ($11 in chips) 
Seat 3: attilakorte ($10.63 in chips) 
Seat 4: Ricey923 ($7.30 in chips) 
Seat 5: hempju1ce ($11.58 in chips) 
Seat 6: alexos04 ($10 in chips) 
alexos04: posts small blind $0.05
kefsamkef: posts big blind $0.10
*** HOLE CARDS ***
Schengo90: folds 
attilakorte: raises $0.12 to $0.22
Ricey923: folds 
hempju1ce: folds 
alexos04: folds 
kefsamkef: folds 
Uncalled bet ($0.12) returned to attilakorte
attilakorte collected $0.25 from pot
attilakorte: doesn't show hand 
*** SUMMARY ***
Total pot $0.25 | Rake $0 
Seat 1: kefsamkef (big blind) folded before Flop
Seat 2: Schengo90 folded before Flop (didn't bet)
Seat 3: attilakorte collected ($0.25)
Seat 4: Ricey923 folded before Flop (didn't bet)
Seat 5: hempju1ce (button) folded before Flop (didn't bet)
Seat 6: alexos04 (small blind) folded before Flop



PokerStars Hand #222979048636:  Hold'em No Limit ($0.05/$0.10 USD) - 2021/01/23 19:04:30 ET
Table 'Lova III' 6-max Seat #6 is the button
Seat 1: kefsamkef ($11.23 in chips) 
Seat 2: Schengo90 ($11 in chips) 
Seat 3: attilakorte ($10.78 in chips) 
Seat 4: Ricey923 ($7.30 in chips) 
Seat 5: hempju1ce ($11.58 in chips) 
Seat 6: alexos04 ($10 in chips) 
kefsamkef: posts small blind $0.05
Schengo90: posts big blind $0.10
*** HOLE CARDS ***
attilakorte: folds 
Ricey923: raises $0.10 to $0.20
hempju1ce: folds 
alexos04: folds 
kefsamkef: folds 
Schengo90: folds 
Uncalled bet ($0.10) returned to Ricey923
Ricey923 collected $0.25 from pot
Ricey923: doesn't show hand 
*** SUMMARY ***
Total pot $0.25 | Rake $0 
Seat 1: kefsamkef (small blind) folded before Flop
Seat 2: Schengo90 (big blind) folded before Flop
Seat 3: attilakorte folded before Flop (didn't bet)
Seat 4: Ricey923 collected ($0.25)
Seat 5: hempju1ce folded before Flop (didn't bet)
Seat 6: alexos04 (button) folded before Flop (didn't bet)



PokerStars Hand #222979059939:  Hold'em No Limit ($0.05/$0.10 USD) - 2021/01/23 19:04:49 ET
Table 'Lova III' 6-max Seat #1 is the button
Seat 1: kefsamkef ($11.18 in chips) 
Seat 2: Schengo90 ($10.90 in chips) 
Seat 3: attilakorte ($10.78 in chips) 
Seat 4: Ricey923 ($7.45 in chips) 
Seat 5: hempju1ce ($11.58 in chips) 
Seat 6: alexos04 ($10 in chips) 
Schengo90: posts small blind $0.05
attilakorte: posts big blind $0.10
*** HOLE CARDS ***
Ricey923: folds 
hempju1ce: folds 
alexos04: folds 
kefsamkef: raises $0.20 to $0.30
Schengo90: folds 
attilakorte: folds 
Uncalled bet ($0.20) returned to kefsamkef
kefsamkef collected $0.25 from pot
kefsamkef: doesn't show hand 
*** SUMMARY ***
Total pot $0.25 | Rake $0 
Seat 1: kefsamkef (button) collected ($0.25)
Seat 2: Schengo90 (small blind) folded before Flop
Seat 3: attilakorte (big blind) folded before Flop
Seat 4: Ricey923 folded before Flop (didn't bet)
Seat 5: hempju1ce folded before Flop (didn't bet)
Seat 6: alexos04 folded before Flop (didn't bet)



PokerStars Hand #222979077092:  Hold'em No Limit ($0.05/$0.10 USD) - 2021/01/23 19:05:07 ET
Table 'Lova III' 6-max Seat #2 is the button
Seat 1: kefsamkef ($11.33 in chips) 
Seat 2: Schengo90 ($10.85 in chips) 
Seat 3: attilakorte ($10.68 in chips) 
Seat 4: Ricey923 ($7.45 in chips) 
Seat 5: hempju1ce ($11.58 in chips) 
Seat 6: alexos04 ($10 in chips) 
attilakorte: posts small blind $0.05
Ricey923: posts big blind $0.10
*** HOLE CARDS ***
hempju1ce: calls $0.10
alexos04: folds 
kefsamkef: raises $0.20 to $0.30
Schengo90: folds 
attilakorte: calls $0.25
Ricey923: calls $0.20
hempju1ce: calls $0.20
*** FLOP *** [4s 2c Jh]
attilakorte: checks 
Ricey923: checks 
hempju1ce: checks 
kefsamkef: checks 
*** TURN *** [4s 2c Jh] [Jc]
attilakorte: checks 
Ricey923: checks 
hempju1ce: checks 
kefsamkef: bets $0.70
attilakorte: folds 
Ricey923: folds 
hempju1ce: folds 
Uncalled bet ($0.70) returned to kefsamkef
kefsamkef collected $1.15 from pot
kefsamkef: doesn't show hand 
*** SUMMARY ***
Total pot $1.20 | Rake $0.05 
Board [4s 2c Jh Jc]
Seat 1: kefsamkef collected ($1.15)
Seat 2: Schengo90 (button) folded before Flop (didn't bet)
Seat 3: attilakorte (small blind) folded on the Turn
Seat 4: Ricey923 (big blind) folded on the Turn
Seat 5: hempju1ce folded on the Turn
Seat 6: alexos04 folded before Flop (didn't bet)



PokerStars Hand #222979118882:  Hold'em No Limit ($0.05/$0.10 USD) - 2021/01/23 19:06:18 ET
Table 'Lova III' 6-max Seat #3 is the button
Seat 1: kefsamkef ($12.18 in chips) 
Seat 2: Schengo90 ($10.85 in chips) 
Seat 3: attilakorte ($10.38 in chips) 
Seat 4: Ricey923 ($7.15 in chips) 
Seat 5: hempju1ce ($11.28 in chips) 
Seat 6: alexos04 ($10 in chips) 
Ricey923: posts small blind $0.05
hempju1ce: posts big blind $0.10
*** HOLE CARDS ***
alexos04: folds 
kefsamkef: folds 
Schengo90: raises $0.20 to $0.30
attilakorte: folds 
Ricey923: raises $0.20 to $0.50
hempju1ce: folds 
Schengo90: raises $10.35 to $10.85 and is all-in
Ricey923: calls $6.65 and is all-in
Uncalled bet ($3.70) returned to Schengo90
*** FLOP *** [Tc Kh Qd]
*** TURN *** [Tc Kh Qd] [9c]
*** RIVER *** [Tc Kh Qd 9c] [Kd]
*** SHOW DOWN ***
Ricey923: shows [Js Jh] (a straight, Nine to King)
Schengo90: shows [As Kc] (three of a kind, Kings)
Ricey923 collected $13.75 from pot
*** SUMMARY ***
Total pot $14.40 | Rake $0.65 
Board [Tc Kh Qd 9c Kd]
Seat 1: kefsamkef folded before Flop (didn't bet)
Seat 2: Schengo90 showed [As Kc] and lost with three of a kind, Kings
Seat 3: attilakorte (button) folded before Flop (didn't bet)
Seat 4: Ricey923 (small blind) showed [Js Jh] and won ($13.75) with a straight, Nine to King
Seat 5: hempju1ce (big blind) folded before Flop
Seat 6: alexos04 folded before Flop (didn't bet)



PokerStars Hand #222979137066:  Hold'em No Limit ($0.05/$0.10 USD) - 2021/01/23 19:06:49 ET
Table 'Lova III' 6-max Seat #4 is the button
Seat 1: kefsamkef ($12.18 in chips) 
Seat 2: Schengo90 ($3.70 in chips) 
Seat 3: attilakorte ($10.38 in chips) 
Seat 4: Ricey923 ($13.75 in chips) 
Seat 5: hempju1ce ($11.18 in chips) 
Seat 6: alexos04 ($10 in chips) 
hempju1ce: posts small blind $0.05
alexos04: posts big blind $0.10
*** HOLE CARDS ***
kefsamkef: raises $0.20 to $0.30
Schengo90: folds 
attilakorte: folds 
Ricey923: folds 
hempju1ce: calls $0.25
alexos04: folds 
*** FLOP *** [8c Qd Kh]
hempju1ce: checks 
Ricey923 leaves the table
kefsamkef: bets $0.34
hempju1ce: calls $0.34
*** TURN *** [8c Qd Kh] [6h]
hempju1ce: checks 
Schengo90 leaves the table
kefsamkef: bets $0.66
hempju1ce: calls $0.66
*** RIVER *** [8c Qd Kh 6h] [4h]
hempju1ce: checks 
kefsamkef: checks 
*** SHOW DOWN ***
hempju1ce: shows [Qc Jc] (a pair of Queens)
kefsamkef: shows [Qs Ks] (two pair, Kings and Queens)
kefsamkef collected $2.58 from pot
Zimniy joins the table at seat #2 
*** SUMMARY ***
Total pot $2.70 | Rake $0.12 
Board [8c Qd Kh 6h 4h]
Seat 1: kefsamkef showed [Qs Ks] and won ($2.58) with two pair, Kings and Queens
Seat 2: Schengo90 folded before Flop (didn't bet)
Seat 3: attilakorte folded before Flop (didn't bet)
Seat 4: Ricey923 (button) folded before Flop (didn't bet)
Seat 5: hempju1ce (small blind) showed [Qc Jc] and lost with a pair of Queens
Seat 6: alexos04 (big blind) folded before Flop



PokerStars Hand #222979173623:  Hold'em No Limit ($0.05/$0.10 USD) - 2021/01/23 19:07:37 ET
Table 'Lova III' 6-max Seat #5 is the button
Seat 1: kefsamkef ($13.46 in chips) 
Seat 3: attilakorte ($10.38 in chips) 
Seat 5: hempju1ce ($9.88 in chips) 
Seat 6: alexos04 ($10 in chips) 
alexos04: posts small blind $0.05
kefsamkef: posts big blind $0.10
Zimniy: sits out 
*** HOLE CARDS ***
attilakorte: folds 
hempju1ce: folds 
wolfx6 joins the table at seat #4 
alexos04: folds 
Uncalled bet ($0.05) returned to kefsamkef
kefsamkef collected $0.10 from pot
kefsamkef: doesn't show hand 
*** SUMMARY ***
Total pot $0.10 | Rake $0 
Seat 1: kefsamkef (big blind) collected ($0.10)
Seat 3: attilakorte folded before Flop (didn't bet)
Seat 5: hempju1ce (button) folded before Flop (didn't bet)
Seat 6: alexos04 (small blind) folded before Flop



PokerStars Hand #222979178361:  Hold'em No Limit ($0.05/$0.10 USD) - 2021/01/23 19:07:45 ET
Table 'Lova III' 6-max Seat #6 is the button
Seat 1: kefsamkef ($13.51 in chips) 
Seat 2: Zimniy ($10 in chips) 
Seat 3: attilakorte ($10.38 in chips) 
Seat 5: hempju1ce ($9.88 in chips) 
Seat 6: alexos04 ($10 in chips) 
kefsamkef: posts small blind $0.05
Zimniy: posts big blind $0.10
wolfx6: sits out 
*** HOLE CARDS ***
attilakorte: folds 
hempju1ce: calls $0.10
alexos04: folds 
kefsamkef: folds 
Zimniy: checks 
*** FLOP *** [4h 9s Kd]
Zimniy: checks 
hempju1ce: checks 
*** TURN *** [4h 9s Kd] [6c]
Zimniy: bets $0.12
hempju1ce: folds 
Uncalled bet ($0.12) returned to Zimniy
Zimniy collected $0.24 from pot
Zimniy: doesn't show hand 
*** SUMMARY ***
Total pot $0.25 | Rake $0.01 
Board [4h 9s Kd 6c]
Seat 1: kefsamkef (small blind) folded before Flop
Seat 2: Zimniy (big blind) collected ($0.24)
Seat 3: attilakorte folded before Flop (didn't bet)
Seat 5: hempju1ce folded on the Turn
Seat 6: alexos04 (button) folded before Flop (didn't bet)



PokerStars Hand #222979190814:  Hold'em No Limit ($0.05/$0.10 USD) - 2021/01/23 19:08:07 ET
Table 'Lova III' 6-max Seat #1 is the button
Seat 1: kefsamkef ($13.46 in chips) 
Seat 2: Zimniy ($10.14 in chips) 
Seat 4: wolfx6 ($10 in chips) 
Seat 5: hempju1ce ($9.78 in chips) 
Seat 6: alexos04 ($10 in chips) 
Zimniy: posts small blind $0.05
attilakorte: is sitting out 
wolfx6: posts big blind $0.10
*** HOLE CARDS ***
hempju1ce: folds 
attilakorte leaves the table
alexos04: folds 
kefsamkef: folds 
Zimniy: folds 
Uncalled bet ($0.05) returned to wolfx6
wolfx6 collected $0.10 from pot
wolfx6: doesn't show hand 
*** SUMMARY ***
Total pot $0.10 | Rake $0 
Seat 1: kefsamkef (button) folded before Flop (didn't bet)
Seat 2: Zimniy (small blind) folded before Flop
Seat 4: wolfx6 (big blind) collected ($0.10)
Seat 5: hempju1ce folded before Flop (didn't bet)
Seat 6: alexos04 folded before Flop (didn't bet)



PokerStars Hand #222979202061:  Hold'em No Limit ($0.05/$0.10 USD) - 2021/01/23 19:08:27 ET
Table 'Lova III' 6-max Seat #2 is the button
Seat 1: kefsamkef ($13.46 in chips) 
Seat 2: Zimniy ($10.09 in chips) 
Seat 4: wolfx6 ($10.05 in chips) 
Seat 5: hempju1ce ($9.78 in chips) 
Seat 6: alexos04 ($10 in chips) 
wolfx6: posts small blind $0.05
hempju1ce: posts big blind $0.10
*** HOLE CARDS ***
alexos04: folds 
kefsamkef: folds 
Zimniy: raises $0.15 to $0.25
wolfx6: raises $0.25 to $0.50
hempju1ce: folds 
Zimniy: calls $0.25
*** FLOP *** [4d Js Jh]
wolfx6: bets $1.05
Zimniy: folds 
Uncalled bet ($1.05) returned to wolfx6
wolfx6 collected $1.05 from pot
wolfx6: doesn't show hand 
*** SUMMARY ***
Total pot $1.10 | Rake $0.05 
Board [4d Js Jh]
Seat 1: kefsamkef folded before Flop (didn't bet)
Seat 2: Zimniy (button) folded on the Flop
Seat 4: wolfx6 (small blind) collected ($1.05)
Seat 5: hempju1ce (big blind) folded before Flop
Seat 6: alexos04 folded before Flop (didn't bet)



PokerStars Hand #222979220893:  Hold'em No Limit ($0.05/$0.10 USD) - 2021/01/23 19:09:01 ET
Table 'Lova III' 6-max Seat #4 is the button
Seat 1: kefsamkef ($13.46 in chips) 
Seat 2: Zimniy ($10 in chips) 
Seat 4: wolfx6 ($10.60 in chips) 
Seat 5: hempju1ce ($9.68 in chips) 
Seat 6: alexos04 ($10 in chips) 
hempju1ce: posts small blind $0.05
alexos04: posts big blind $0.10
*** HOLE CARDS ***
kefsamkef: raises $0.20 to $0.30
Zimniy: calls $0.30
wolfx6: folds 
hempju1ce: calls $0.25
alexos04: folds 
*** FLOP *** [Ac 3d Tc]
hempju1ce: checks 
kefsamkef: checks 
albert riley joins the table at seat #3 
Zimniy: checks 
*** TURN *** [Ac 3d Tc] [2c]
hempju1ce: checks 
kefsamkef: bets $0.48
Zimniy: folds 
hempju1ce: folds 
Uncalled bet ($0.48) returned to kefsamkef
kefsamkef collected $0.96 from pot
kefsamkef: doesn't show hand 
*** SUMMARY ***
Total pot $1 | Rake $0.04 
Board [Ac 3d Tc 2c]
Seat 1: kefsamkef collected ($0.96)
Seat 2: Zimniy folded on the Turn
Seat 4: wolfx6 (button) folded before Flop (didn't bet)
Seat 5: hempju1ce (small blind) folded on the Turn
Seat 6: alexos04 (big blind) folded before Flop



PokerStars Hand #222979242051:  Hold'em No Limit ($0.05/$0.10 USD) - 2021/01/23 19:09:38 ET
Table 'Lova III' 6-max Seat #5 is the button
Seat 1: kefsamkef ($14.12 in chips) 
Seat 2: Zimniy ($10 in chips) 
Seat 3: albert riley ($10 in chips) 
Seat 4: wolfx6 ($10.60 in chips) 
Seat 5: hempju1ce ($9.38 in chips) 
Seat 6: alexos04 ($10 in chips) 
alexos04: posts small blind $0.05
kefsamkef: posts big blind $0.10
albert riley: posts big blind $0.10
*** HOLE CARDS ***
Zimniy: folds 
albert riley: raises $0.10 to $0.20
wolfx6: folds 
hempju1ce: raises $0.30 to $0.50
alexos04: folds 
kefsamkef: folds 
albert riley: calls $0.30
*** FLOP *** [7s 3d 6c]
albert riley: bets $0.55
hempju1ce: calls $0.55
*** TURN *** [7s 3d 6c] [6s]
albert riley: bets $2.15
hempju1ce: folds 
Uncalled bet ($2.15) returned to albert riley
albert riley collected $2.15 from pot
albert riley: doesn't show hand 
*** SUMMARY ***
Total pot $2.25 | Rake $0.10 
Board [7s 3d 6c 6s]
Seat 1: kefsamkef (big blind) folded before Flop
Seat 2: Zimniy folded before Flop (didn't bet)
Seat 3: albert riley collected ($2.15)
Seat 4: wolfx6 folded before Flop (didn't bet)
Seat 5: hempju1ce (button) folded on the Turn
Seat 6: alexos04 (small blind) folded before Flop



PokerStars Hand #222979270777:  Hold'em No Limit ($0.05/$0.10 USD) - 2021/01/23 19:10:29 ET
Table 'Lova III' 6-max Seat #6 is the button
Seat 1: kefsamkef ($14.02 in chips) 
Seat 2: Zimniy ($10 in chips) 
Seat 3: albert riley ($11.10 in chips) 
Seat 4: wolfx6 ($10.60 in chips) 
Seat 5: hempju1ce ($8.95 in chips) 
Seat 6: alexos04 ($10 in chips) 
kefsamkef: posts small blind $0.05
Zimniy: posts big blind $0.10
*** HOLE CARDS ***
albert riley: raises $0.10 to $0.20
wolfx6: folds 
hempju1ce: folds 
alexos04: folds 
kefsamkef: folds 
Zimniy: folds 
Uncalled bet ($0.10) returned to albert riley
albert riley collected $0.25 from pot
albert riley: doesn't show hand 
*** SUMMARY ***
Total pot $0.25 | Rake $0 
Seat 1: kefsamkef (small blind) folded before Flop
Seat 2: Zimniy (big blind) folded before Flop
Seat 3: albert riley collected ($0.25)
Seat 4: wolfx6 folded before Flop (didn't bet)
Seat 5: hempju1ce folded before Flop (didn't bet)
Seat 6: alexos04 (button) folded before Flop (didn't bet)



PokerStars Hand #222979279167:  Hold'em No Limit ($0.05/$0.10 USD) - 2021/01/23 19:10:44 ET
Table 'Lova III' 6-max Seat #1 is the button
Seat 1: kefsamkef ($13.97 in chips) 
Seat 2: Zimniy ($10 in chips) 
Seat 3: albert riley ($11.25 in chips) 
Seat 4: wolfx6 ($10.60 in chips) 
Seat 5: hempju1ce ($10 in chips) 
Seat 6: alexos04 ($10 in chips) 
Zimniy: posts small blind $0.05
albert riley: posts big blind $0.10
*** HOLE CARDS ***
wolfx6: calls $0.10
hempju1ce: raises $0.30 to $0.40
alexos04: folds 
kefsamkef: folds 
Zimniy: folds 
albert riley: calls $0.30
wolfx6: calls $0.30
*** FLOP *** [4d Ks Tc]
albert riley: checks 
wolfx6: bets $0.59
hempju1ce: calls $0.59
albert riley: folds 
*** TURN *** [4d Ks Tc] [4c]
wolfx6: bets $0.40
hempju1ce: calls $0.40
*** RIVER *** [4d Ks Tc 4c] [6h]
wolfx6: bets $1
hempju1ce: calls $1
*** SHOW DOWN ***
wolfx6: shows [Kc 4h] (a full house, Fours full of Kings)
hempju1ce: mucks hand 
wolfx6 collected $4.99 from pot
*** SUMMARY ***
Total pot $5.23 | Rake $0.24 
Board [4d Ks Tc 4c 6h]
Seat 1: kefsamkef (button) folded before Flop (didn't bet)
Seat 2: Zimniy (small blind) folded before Flop
Seat 3: albert riley (big blind) folded on the Flop
Seat 4: wolfx6 showed [Kc 4h] and won ($4.99) with a full house, Fours full of Kings
Seat 5: hempju1ce mucked
Seat 6: alexos04 folded before Flop (didn't bet)



PokerStars Hand #222979319428:  Hold'em No Limit ($0.05/$0.10 USD) - 2021/01/23 19:11:56 ET
Table 'Lova III' 6-max Seat #2 is the button
Seat 1: kefsamkef ($13.97 in chips) 
Seat 2: Zimniy ($10 in chips) 
Seat 3: albert riley ($10.85 in chips) 
Seat 4: wolfx6 ($13.20 in chips) 
Seat 5: hempju1ce ($7.61 in chips) 
Seat 6: alexos04 ($10 in chips) 
albert riley: posts small blind $0.05
wolfx6: posts big blind $0.10
*** HOLE CARDS ***
hempju1ce: raises $0.10 to $0.20
alexos04: folds 
kefsamkef: calls $0.20
Zimniy: folds 
albert riley: calls $0.15
wolfx6: calls $0.10
*** FLOP *** [Jc 6s 9c]
albert riley: checks 
wolfx6: checks 
hempju1ce: bets $0.76
kefsamkef: folds 
albert riley: folds 
wolfx6: folds 
Uncalled bet ($0.76) returned to hempju1ce
hempju1ce collected $0.76 from pot
hempju1ce: doesn't show hand 
*** SUMMARY ***
Total pot $0.80 | Rake $0.04 
Board [Jc 6s 9c]
Seat 1: kefsamkef folded on the Flop
Seat 2: Zimniy (button) folded before Flop (didn't bet)
Seat 3: albert riley (small blind) folded on the Flop
Seat 4: wolfx6 (big blind) folded on the Flop
Seat 5: hempju1ce collected ($0.76)
Seat 6: alexos04 folded before Flop (didn't bet)



PokerStars Hand #222979341121:  Hold'em No Limit ($0.05/$0.10 USD) - 2021/01/23 19:12:35 ET
Table 'Lova III' 6-max Seat #3 is the button
Seat 1: kefsamkef ($13.77 in chips) 
Seat 2: Zimniy ($10 in chips) 
Seat 3: albert riley ($10.65 in chips) 
Seat 4: wolfx6 ($13 in chips) 
Seat 5: hempju1ce ($8.17 in chips) 
Seat 6: alexos04 ($10 in chips) 
wolfx6: posts small blind $0.05
hempju1ce: posts big blind $0.10
*** HOLE CARDS ***
alexos04: folds 
kefsamkef: folds 
Zimniy: raises $0.15 to $0.25
albert riley: folds 
wolfx6: folds 
hempju1ce: calls $0.15
*** FLOP *** [Ts 2s Jd]
hempju1ce: checks 
wolfx6 leaves the table
Zimniy: bets $0.35
hempju1ce: folds 
Uncalled bet ($0.35) returned to Zimniy
Zimniy collected $0.53 from pot
Zimniy: doesn't show hand 
*** SUMMARY ***
Total pot $0.55 | Rake $0.02 
Board [Ts 2s Jd]
Seat 1: kefsamkef folded before Flop (didn't bet)
Seat 2: Zimniy collected ($0.53)
Seat 3: albert riley (button) folded before Flop (didn't bet)
Seat 4: wolfx6 (small blind) folded before Flop
Seat 5: hempju1ce (big blind) folded on the Flop
Seat 6: alexos04 folded before Flop (didn't bet)



PokerStars Hand #222979361617:  Hold'em No Limit ($0.05/$0.10 USD) - 2021/01/23 19:13:12 ET
Table 'Lova III' 6-max Seat #5 is the button
Seat 1: kefsamkef ($13.77 in chips) 
Seat 2: Zimniy ($10.28 in chips) 
Seat 3: albert riley ($10.65 in chips) 
Seat 5: hempju1ce ($7.92 in chips) 
Seat 6: alexos04 ($10 in chips) 
alexos04: posts small blind $0.05
kefsamkef: posts big blind $0.10
*** HOLE CARDS ***
Zimniy: folds 
Bakulia joins the table at seat #4 
albert riley: raises $0.30 to $0.40
hempju1ce: folds 
alexos04: calls $0.35
kefsamkef: folds 
*** FLOP *** [Tc Kd 8h]
alexos04: checks 
albert riley: bets $0.86
alexos04: folds 
Uncalled bet ($0.86) returned to albert riley
albert riley collected $0.86 from pot
albert riley: doesn't show hand 
*** SUMMARY ***
Total pot $0.90 | Rake $0.04 
Board [Tc Kd 8h]
Seat 1: kefsamkef (big blind) folded before Flop
Seat 2: Zimniy folded before Flop (didn't bet)
Seat 3: albert riley collected ($0.86)
Seat 5: hempju1ce (button) folded before Flop (didn't bet)
Seat 6: alexos04 (small blind) folded on the Flop



PokerStars Hand #222979385866:  Hold'em No Limit ($0.05/$0.10 USD) - 2021/01/23 19:13:55 ET
Table 'Lova III' 6-max Seat #6 is the button
Seat 1: kefsamkef ($13.67 in chips) 
Seat 2: Zimniy ($10.28 in chips) 
Seat 3: albert riley ($11.11 in chips) 
Seat 4: Bakulia ($8 in chips) 
Seat 5: hempju1ce ($7.92 in chips) 
Seat 6: alexos04 ($10 in chips) 
kefsamkef: posts small blind $0.05
Zimniy: posts big blind $0.10
Bakulia: posts big blind $0.10
*** HOLE CARDS ***
albert riley: raises $0.10 to $0.20
Bakulia: calls $0.10
hempju1ce: folds 
alexos04: folds 
kefsamkef: folds 
Zimniy: folds 
*** FLOP *** [5c 8h As]
albert riley: bets $0.53
Bakulia: folds 
Uncalled bet ($0.53) returned to albert riley
albert riley collected $0.53 from pot
albert riley: doesn't show hand 
*** SUMMARY ***
Total pot $0.55 | Rake $0.02 
Board [5c 8h As]
Seat 1: kefsamkef (small blind) folded before Flop
Seat 2: Zimniy (big blind) folded before Flop
Seat 3: albert riley collected ($0.53)
Seat 4: Bakulia folded on the Flop
Seat 5: hempju1ce folded before Flop (didn't bet)
Seat 6: alexos04 (button) folded before Flop (didn't bet)



PokerStars Hand #222979404313:  Hold'em No Limit ($0.05/$0.10 USD) - 2021/01/23 19:14:29 ET
Table 'Lova III' 6-max Seat #1 is the button
Seat 1: kefsamkef ($13.62 in chips) 
Seat 2: Zimniy ($10.18 in chips) 
Seat 3: albert riley ($11.44 in chips) 
Seat 4: Bakulia ($7.80 in chips) 
Seat 5: hempju1ce ($7.92 in chips) 
Seat 6: alexos04 ($10 in chips) 
Zimniy: posts small blind $0.05
albert riley: posts big blind $0.10
*** HOLE CARDS ***
Bakulia: calls $0.10
hempju1ce: folds 
alexos04: folds 
kefsamkef: folds 
Zimniy: folds 
albert riley: checks 
*** FLOP *** [6s 5c 4d]
albert riley: bets $0.12
Bakulia: calls $0.12
*** TURN *** [6s 5c 4d] [5d]
albert riley: bets $0.24
Bakulia: calls $0.24
*** RIVER *** [6s 5c 4d 5d] [9h]
albert riley: bets $0.93
Bakulia: folds 
Uncalled bet ($0.93) returned to albert riley
albert riley collected $0.93 from pot
albert riley: doesn't show hand 
*** SUMMARY ***
Total pot $0.97 | Rake $0.04 
Board [6s 5c 4d 5d 9h]
Seat 1: kefsamkef (button) folded before Flop (didn't bet)
Seat 2: Zimniy (small blind) folded before Flop
Seat 3: albert riley (big blind) collected ($0.93)
Seat 4: Bakulia folded on the River
Seat 5: hempju1ce folded before Flop (didn't bet)
Seat 6: alexos04 folded before Flop (didn't bet)



PokerStars Hand #222979437110:  Hold'em No Limit ($0.05/$0.10 USD) - 2021/01/23 19:15:28 ET
Table 'Lova III' 6-max Seat #2 is the button
Seat 1: kefsamkef ($13.62 in chips) 
Seat 2: Zimniy ($10.13 in chips) 
Seat 3: albert riley ($11.91 in chips) 
Seat 4: Bakulia ($7.34 in chips) 
Seat 5: hempju1ce ($10 in chips) 
Seat 6: alexos04 ($10 in chips) 
albert riley: posts small blind $0.05
Bakulia: posts big blind $0.10
*** HOLE CARDS ***
hempju1ce: folds 
alexos04: folds 
kefsamkef: folds 
Zimniy: folds 
albert riley: raises $0.10 to $0.20
Bakulia: calls $0.10
*** FLOP *** [Kd Ah Qd]
albert riley: bets $0.10
Bakulia: calls $0.10
*** TURN *** [Kd Ah Qd] [Tc]
albert riley: checks 
Bakulia: checks 
*** RIVER *** [Kd Ah Qd Tc] [5c]
albert riley: checks 
Bakulia: bets $0.28
albert riley: folds 
Uncalled bet ($0.28) returned to Bakulia
Bakulia collected $0.57 from pot
Bakulia: doesn't show hand 
*** SUMMARY ***
Total pot $0.60 | Rake $0.03 
Board [Kd Ah Qd Tc 5c]
Seat 1: kefsamkef folded before Flop (didn't bet)
Seat 2: Zimniy (button) folded before Flop (didn't bet)
Seat 3: albert riley (small blind) folded on the River
Seat 4: Bakulia (big blind) collected ($0.57)
Seat 5: hempju1ce folded before Flop (didn't bet)
Seat 6: alexos04 folded before Flop (didn't bet)



PokerStars Hand #222979461256:  Hold'em No Limit ($0.05/$0.10 USD) - 2021/01/23 19:16:12 ET
Table 'Lova III' 6-max Seat #3 is the button
Seat 1: kefsamkef ($13.62 in chips) 
Seat 2: Zimniy ($10.13 in chips) 
Seat 3: albert riley ($11.61 in chips) 
Seat 4: Bakulia ($7.61 in chips) 
Seat 5: hempju1ce ($10 in chips) 
Seat 6: alexos04 ($10 in chips) 
Bakulia: posts small blind $0.05
hempju1ce: posts big blind $0.10
*** HOLE CARDS ***
alexos04: folds 
kefsamkef: raises $0.20 to $0.30
Zimniy: folds 
albert riley: folds 
Bakulia: calls $0.25
hempju1ce: folds 
*** FLOP *** [3d Tc Td]
Bakulia: checks 
kefsamkef: checks 
*** TURN *** [3d Tc Td] [Th]
Bakulia: bets $0.23
kefsamkef: calls $0.23
*** RIVER *** [3d Tc Td Th] [Jc]
Bakulia: bets $0.55
kefsamkef: folds 
Uncalled bet ($0.55) returned to Bakulia
Bakulia collected $1.11 from pot
Bakulia: doesn't show hand 
*** SUMMARY ***
Total pot $1.16 | Rake $0.05 
Board [3d Tc Td Th Jc]
Seat 1: kefsamkef folded on the River
Seat 2: Zimniy folded before Flop (didn't bet)
Seat 3: albert riley (button) folded before Flop (didn't bet)
Seat 4: Bakulia (small blind) collected ($1.11)
Seat 5: hempju1ce (big blind) folded before Flop
Seat 6: alexos04 folded before Flop (didn't bet)



PokerStars Hand #222979482195:  Hold'em No Limit ($0.05/$0.10 USD) - 2021/01/23 19:16:51 ET
Table 'Lova III' 6-max Seat #4 is the button
Seat 1: kefsamkef ($13.09 in chips) 
Seat 2: Zimniy ($10.13 in chips) 
Seat 3: albert riley ($11.61 in chips) 
Seat 4: Bakulia ($8.19 in chips) 
Seat 5: hempju1ce ($9.90 in chips) 
Seat 6: alexos04 ($10 in chips) 
hempju1ce: posts small blind $0.05
alexos04: posts big blind $0.10
*** HOLE CARDS ***
kefsamkef: folds 
Zimniy: folds 
albert riley: raises $0.60 to $0.70
Bakulia: calls $0.70
hempju1ce: folds 
alexos04: folds 
*** FLOP *** [Ad 8c Qd]
albert riley: bets $1.48
Bakulia: folds 
Uncalled bet ($1.48) returned to albert riley
albert riley collected $1.48 from pot
albert riley: doesn't show hand 
*** SUMMARY ***
Total pot $1.55 | Rake $0.07 
Board [Ad 8c Qd]
Seat 1: kefsamkef folded before Flop (didn't bet)
Seat 2: Zimniy folded before Flop (didn't bet)
Seat 3: albert riley collected ($1.48)
Seat 4: Bakulia (button) folded on the Flop
Seat 5: hempju1ce (small blind) folded before Flop
Seat 6: alexos04 (big blind) folded before Flop



PokerStars Hand #222979499928:  Hold'em No Limit ($0.05/$0.10 USD) - 2021/01/23 19:17:23 ET
Table 'Lova III' 6-max Seat #5 is the button
Seat 1: kefsamkef ($13.09 in chips) 
Seat 2: Zimniy ($10.13 in chips) 
Seat 3: albert riley ($12.39 in chips) 
Seat 4: Bakulia ($7.49 in chips) 
Seat 5: hempju1ce ($9.85 in chips) 
Seat 6: alexos04 ($10 in chips) 
alexos04: posts small blind $0.05
kefsamkef: posts big blind $0.10
*** HOLE CARDS ***
Zimniy: folds 
albert riley: raises $0.10 to $0.20
Bakulia: folds 
hempju1ce: folds 
alexos04: folds 
kefsamkef: folds 
Uncalled bet ($0.10) returned to albert riley
albert riley collected $0.25 from pot
albert riley: doesn't show hand 
*** SUMMARY ***
Total pot $0.25 | Rake $0 
Seat 1: kefsamkef (big blind) folded before Flop
Seat 2: Zimniy folded before Flop (didn't bet)
Seat 3: albert riley collected ($0.25)
Seat 4: Bakulia folded before Flop (didn't bet)
Seat 5: hempju1ce (button) folded before Flop (didn't bet)
Seat 6: alexos04 (small blind) folded before Flop



PokerStars Hand #222979506305:  Hold'em No Limit ($0.05/$0.10 USD) - 2021/01/23 19:17:35 ET
Table 'Lova III' 6-max Seat #6 is the button
Seat 1: kefsamkef ($12.99 in chips) 
Seat 2: Zimniy ($10.13 in chips) 
Seat 3: albert riley ($12.54 in chips) 
Seat 4: Bakulia ($7.49 in chips) 
Seat 5: hempju1ce ($9.85 in chips) 
Seat 6: alexos04 ($10 in chips) 
kefsamkef: posts small blind $0.05
Zimniy: posts big blind $0.10
*** HOLE CARDS ***
albert riley: folds 
Bakulia: raises $0.20 to $0.30
hempju1ce: calls $0.30
alexos04: folds 
kefsamkef: raises $1 to $1.30
Zimniy: folds 
Bakulia: calls $1
hempju1ce: raises $8.55 to $9.85 and is all-in
kefsamkef: raises $3.14 to $12.99 and is all-in
Bakulia: calls $6.19 and is all-in
Uncalled bet ($3.14) returned to kefsamkef
*** FLOP *** [7c 3c 4s]
*** TURN *** [7c 3c 4s] [Jd]
*** RIVER *** [7c 3c 4s Jd] [5s]
*** SHOW DOWN ***
kefsamkef: shows [Td Ts] (a pair of Tens)
hempju1ce: shows [As Ac] (a pair of Aces)
hempju1ce collected $4.51 from side pot
Bakulia: shows [Ad Jh] (a pair of Jacks)
hempju1ce collected $21.55 from main pot
kefsamkef cashed out the hand for $4.91 | Cash Out Fee $0.05
*** SUMMARY ***
Total pot $27.29 Main pot $21.55. Side pot $4.51. | Rake $1.23 
Board [7c 3c 4s Jd 5s]
Seat 1: kefsamkef (small blind) showed [Td Ts] and lost with a pair of Tens (cashed out).
Seat 2: Zimniy (big blind) folded before Flop
Seat 3: albert riley folded before Flop (didn't bet)
Seat 4: Bakulia showed [Ad Jh] and lost with a pair of Jacks
Seat 5: hempju1ce showed [As Ac] and won ($26.06) with a pair of Aces
Seat 6: alexos04 (button) folded before Flop (didn't bet)



PokerStars Hand #222979541644:  Hold'em No Limit ($0.05/$0.10 USD) - 2021/01/23 19:18:40 ET
Table 'Lova III' 6-max Seat #1 is the button
Seat 1: kefsamkef ($8.05 in chips) 
Seat 2: Zimniy ($10.03 in chips) 
Seat 3: albert riley ($12.54 in chips) 
Seat 5: hempju1ce ($26.06 in chips) 
Seat 6: alexos04 ($10 in chips) 
Zimniy: posts small blind $0.05
albert riley: posts big blind $0.10
*** HOLE CARDS ***
hempju1ce: folds 
alexos04: folds 
kefsamkef: folds 
Zimniy: folds 
Uncalled bet ($0.05) returned to albert riley
albert riley collected $0.10 from pot
albert riley: doesn't show hand 
*** SUMMARY ***
Total pot $0.10 | Rake $0 
Seat 1: kefsamkef (button) folded before Flop (didn't bet)
Seat 2: Zimniy (small blind) folded before Flop
Seat 3: albert riley (big blind) collected ($0.10)
Seat 5: hempju1ce folded before Flop (didn't bet)
Seat 6: alexos04 folded before Flop (didn't bet)



PokerStars Hand #222979551289:  Hold'em No Limit ($0.05/$0.10 USD) - 2021/01/23 19:18:58 ET
Table 'Lova III' 6-max Seat #2 is the button
Seat 1: kefsamkef ($8.05 in chips) 
Seat 2: Zimniy ($10 in chips) 
Seat 3: albert riley ($12.59 in chips) 
Seat 4: Bakulia ($10 in chips) 
Seat 5: hempju1ce ($26.06 in chips) 
Seat 6: alexos04 ($10 in chips) 
albert riley: posts small blind $0.05
Bakulia: posts big blind $0.10
*** HOLE CARDS ***
hempju1ce: calls $0.10
alexos04: folds 
kefsamkef: folds 
Zimniy: folds 
albert riley: raises $0.20 to $0.30
Bakulia: calls $0.20
hempju1ce: calls $0.20
*** FLOP *** [Qd Td 3h]
albert riley: bets $0.86
Bakulia: calls $0.86
hempju1ce: folds 
*** TURN *** [Qd Td 3h] [7c]
kefsamkef leaves the table
and 07335 joins the table at seat #1 
albert riley: bets $11.43 and is all-in
Bakulia: folds 
Uncalled bet ($11.43) returned to albert riley
albert riley collected $2.50 from pot
albert riley: doesn't show hand 
*** SUMMARY ***
Total pot $2.62 | Rake $0.12 
Board [Qd Td 3h 7c]
Seat 1: kefsamkef folded before Flop (didn't bet)
Seat 2: Zimniy (button) folded before Flop (didn't bet)
Seat 3: albert riley (small blind) collected ($2.50)
Seat 4: Bakulia (big blind) folded on the Turn
Seat 5: hempju1ce folded on the Flop
Seat 6: alexos04 folded before Flop (didn't bet)



PokerStars Hand #222979579872:  Hold'em No Limit ($0.05/$0.10 USD) - 2021/01/23 19:19:51 ET
Table 'Lova III' 6-max Seat #3 is the button
Seat 2: Zimniy ($10 in chips) 
Seat 3: albert riley ($13.93 in chips) 
Seat 4: Bakulia ($8.84 in chips) 
Seat 5: hempju1ce ($25.76 in chips) 
Seat 6: alexos04 ($10 in chips) 
Bakulia: posts small blind $0.05
hempju1ce: posts big blind $0.10
and 07335: sits out 
*** HOLE CARDS ***
alexos04: raises $0.20 to $0.30
Zimniy: folds 
albert riley: folds 
Bakulia: calls $0.25
hempju1ce: calls $0.20
*** FLOP *** [Ts 4s 9d]
Bakulia: checks 
hempju1ce: checks 
alexos04: checks 
*** TURN *** [Ts 4s 9d] [6h]
Bakulia: bets $0.43
hempju1ce: folds 
alexos04: folds 
Uncalled bet ($0.43) returned to Bakulia
Bakulia collected $0.86 from pot
Bakulia: doesn't show hand 
*** SUMMARY ***
Total pot $0.90 | Rake $0.04 
Board [Ts 4s 9d 6h]
Seat 2: Zimniy folded before Flop (didn't bet)
Seat 3: albert riley (button) folded before Flop (didn't bet)
Seat 4: Bakulia (small blind) collected ($0.86)
Seat 5: hempju1ce (big blind) folded on the Turn
Seat 6: alexos04 folded on the Turn



PokerStars Hand #222979603170:  Hold'em No Limit ($0.05/$0.10 USD) - 2021/01/23 19:20:35 ET
Table 'Lova III' 6-max Seat #4 is the button
Seat 2: Zimniy ($10 in chips) 
Seat 3: albert riley ($13.93 in chips) 
Seat 4: Bakulia ($9.40 in chips) 
Seat 5: hempju1ce ($25.46 in chips) 
Seat 6: alexos04 ($10 in chips) 
hempju1ce: posts small blind $0.05
alexos04: posts big blind $0.10
and 07335: sits out 
*** HOLE CARDS ***
Zimniy: folds 
albert riley: raises $0.10 to $0.20
Bakulia: calls $0.20
hempju1ce: folds 
alexos04: calls $0.10
*** FLOP *** [3s 5d 9s]
alexos04: checks 
albert riley: bets $0.30
Bakulia: calls $0.30
alexos04: folds 
*** TURN *** [3s 5d 9s] [3d]
albert riley: bets $0.10
Bakulia: calls $0.10
*** RIVER *** [3s 5d 9s 3d] [5c]
albert riley: bets $1.38
Bakulia: folds 
Uncalled bet ($1.38) returned to albert riley
albert riley collected $1.38 from pot
albert riley: doesn't show hand 
*** SUMMARY ***
Total pot $1.45 | Rake $0.07 
Board [3s 5d 9s 3d 5c]
Seat 2: Zimniy folded before Flop (didn't bet)
Seat 3: albert riley collected ($1.38)
Seat 4: Bakulia (button) folded on the River
Seat 5: hempju1ce (small blind) folded before Flop
Seat 6: alexos04 (big blind) folded on the Flop



PokerStars Hand #222979634428:  Hold'em No Limit ($0.05/$0.10 USD) - 2021/01/23 19:21:33 ET
Table 'Lova III' 6-max Seat #5 is the button
Seat 1: and 07335 ($10 in chips) 
Seat 2: Zimniy ($10 in chips) 
Seat 3: albert riley ($14.71 in chips) 
Seat 4: Bakulia ($8.80 in chips) 
Seat 5: hempju1ce ($25.41 in chips) 
Seat 6: alexos04 ($10 in chips) 
alexos04: posts small blind $0.05
and 07335: posts big blind $0.10
*** HOLE CARDS ***
Zimniy: folds 
albert riley: calls $0.10
Bakulia: calls $0.10
hempju1ce: calls $0.10
alexos04: folds 
and 07335: checks 
*** FLOP *** [6d 4d 3h]
and 07335: bets $0.39
albert riley: raises $0.39 to $0.78
Bakulia: folds 
hempju1ce: folds 
and 07335: calls $0.39
*** TURN *** [6d 4d 3h] [6c]
and 07335: checks 
albert riley: bets $1.92
and 07335: calls $1.92
*** RIVER *** [6d 4d 3h 6c] [Ad]
and 07335: checks 
albert riley: bets $11.91 and is all-in
and 07335: folds 
Uncalled bet ($11.91) returned to albert riley
albert riley collected $5.59 from pot
albert riley: doesn't show hand 
*** SUMMARY ***
Total pot $5.85 | Rake $0.26 
Board [6d 4d 3h 6c Ad]
Seat 1: and 07335 (big blind) folded on the River
Seat 2: Zimniy folded before Flop (didn't bet)
Seat 3: albert riley collected ($5.59)
Seat 4: Bakulia folded on the Flop
Seat 5: hempju1ce (button) folded on the Flop
Seat 6: alexos04 (small blind) folded before Flop



PokerStars Hand #222979672756:  Hold'em No Limit ($0.05/$0.10 USD) - 2021/01/23 19:22:45 ET
Table 'Lova III' 6-max Seat #6 is the button
Seat 1: and 07335 ($10 in chips) 
Seat 2: Zimniy ($10 in chips) 
Seat 3: albert riley ($17.50 in chips) 
Seat 4: Bakulia ($8.70 in chips) 
Seat 5: hempju1ce ($25.31 in chips) 
Seat 6: alexos04 ($10 in chips) 
and 07335: posts small blind $0.05
Zimniy: posts big blind $0.10
*** HOLE CARDS ***
albert riley: calls $0.10
Bakulia: raises $0.10 to $0.20
hempju1ce: folds 
alexos04: calls $0.20
and 07335: folds 
Zimniy: calls $0.10
albert riley: calls $0.10
*** FLOP *** [Js 7h 9c]
Zimniy: checks 
albert riley: checks 
Bakulia: bets $0.40
alexos04: raises $0.70 to $1.10
Zimniy: calls $1.10
albert riley: folds 
Bakulia: folds 
*** TURN *** [Js 7h 9c] [4s]
Zimniy: checks 
alexos04: bets $1.30
Zimniy: calls $1.30
*** RIVER *** [Js 7h 9c 4s] [Qc]
Zimniy: bets $4.34
alexos04: folds 
Uncalled bet ($4.34) returned to Zimniy
Zimniy collected $5.78 from pot
Zimniy: doesn't show hand 
*** SUMMARY ***
Total pot $6.05 | Rake $0.27 
Board [Js 7h 9c 4s Qc]
Seat 1: and 07335 (small blind) folded before Flop
Seat 2: Zimniy (big blind) collected ($5.78)
Seat 3: albert riley folded on the Flop
Seat 4: Bakulia folded on the Flop
Seat 5: hempju1ce folded before Flop (didn't bet)
Seat 6: alexos04 (button) folded on the River



PokerStars Hand #222979733395:  Hold'em No Limit ($0.05/$0.10 USD) - 2021/01/23 19:24:39 ET
Table 'Lova III' 6-max Seat #1 is the button
Seat 1: and 07335 ($10 in chips) 
Seat 2: Zimniy ($13.18 in chips) 
Seat 3: albert riley ($17.30 in chips) 
Seat 4: Bakulia ($8.10 in chips) 
Seat 5: hempju1ce ($25.31 in chips) 
Seat 6: alexos04 ($10 in chips) 
Zimniy: posts small blind $0.05
albert riley: posts big blind $0.10
*** HOLE CARDS ***
Bakulia: calls $0.10
hempju1ce: raises $0.20 to $0.30
alexos04: folds 
and 07335: folds 
Zimniy: calls $0.25
albert riley: folds 
Bakulia: calls $0.20
*** FLOP *** [4h 8h Ks]
Zimniy: checks 
Bakulia: bets $0.38
hempju1ce: calls $0.38
Zimniy: folds 
*** TURN *** [4h 8h Ks] [Kh]
Bakulia: bets $0.74
hempju1ce: calls $0.74
*** RIVER *** [4h 8h Ks Kh] [9h]
Bakulia: bets $1.54
hempju1ce: folds 
Uncalled bet ($1.54) returned to Bakulia
Bakulia collected $3.09 from pot
Bakulia: doesn't show hand 
*** SUMMARY ***
Total pot $3.24 | Rake $0.15 
Board [4h 8h Ks Kh 9h]
Seat 1: and 07335 (button) folded before Flop (didn't bet)
Seat 2: Zimniy (small blind) folded on the Flop
Seat 3: albert riley (big blind) folded before Flop
Seat 4: Bakulia collected ($3.09)
Seat 5: hempju1ce folded on the River
Seat 6: alexos04 folded before Flop (didn't bet)



PokerStars Hand #222979771685:  Hold'em No Limit ($0.05/$0.10 USD) - 2021/01/23 19:25:52 ET
Table 'Lova III' 6-max Seat #2 is the button
Seat 1: and 07335 ($10 in chips) 
Seat 2: Zimniy ($12.88 in chips) 
Seat 3: albert riley ($17.20 in chips) 
Seat 4: Bakulia ($9.77 in chips) 
Seat 5: hempju1ce ($23.89 in chips) 
Seat 6: alexos04 ($10 in chips) 
albert riley: posts small blind $0.05
Bakulia: posts big blind $0.10
*** HOLE CARDS ***
hempju1ce: folds 
alexos04: folds 
and 07335: folds 
Zimniy: folds 
albert riley: raises $0.10 to $0.20
Bakulia: calls $0.10
*** FLOP *** [9h Qh Jc]
albert riley: bets $0.10
Bakulia: calls $0.10
*** TURN *** [9h Qh Jc] [7h]
albert riley: checks 
Bakulia: bets $0.28
albert riley: folds 
Uncalled bet ($0.28) returned to Bakulia
Bakulia collected $0.57 from pot
Bakulia: doesn't show hand 
*** SUMMARY ***
Total pot $0.60 | Rake $0.03 
Board [9h Qh Jc 7h]
Seat 1: and 07335 folded before Flop (didn't bet)
Seat 2: Zimniy (button) folded before Flop (didn't bet)
Seat 3: albert riley (small blind) folded on the Turn
Seat 4: Bakulia (big blind) collected ($0.57)
Seat 5: hempju1ce folded before Flop (didn't bet)
Seat 6: alexos04 folded before Flop (didn't bet)



PokerStars Hand #222979794568:  Hold'em No Limit ($0.05/$0.10 USD) - 2021/01/23 19:26:35 ET
Table 'Lova III' 6-max Seat #3 is the button
Seat 1: and 07335 ($10 in chips) 
Seat 2: Zimniy ($12.88 in chips) 
Seat 3: albert riley ($16.90 in chips) 
Seat 4: Bakulia ($10.04 in chips) 
Seat 5: hempju1ce ($23.89 in chips) 
Seat 6: alexos04 ($10 in chips) 
Bakulia: posts small blind $0.05
hempju1ce: posts big blind $0.10
*** HOLE CARDS ***
alexos04: folds 
and 07335: folds 
Zimniy: raises $0.15 to $0.25
albert riley: raises $0.15 to $0.40
Bakulia: calls $0.35
hempju1ce: folds 
Zimniy: calls $0.15
*** FLOP *** [3h Jh Ad]
Bakulia: checks 
Zimniy: checks 
albert riley: bets $0.62
Bakulia: folds 
Zimniy: calls $0.62
*** TURN *** [3h Jh Ad] [Kd]
Zimniy: checks 
albert riley: bets $3.30
Zimniy: folds 
Uncalled bet ($3.30) returned to albert riley
albert riley collected $2.43 from pot
albert riley: doesn't show hand 
*** SUMMARY ***
Total pot $2.54 | Rake $0.11 
Board [3h Jh Ad Kd]
Seat 1: and 07335 folded before Flop (didn't bet)
Seat 2: Zimniy folded on the Turn
Seat 3: albert riley (button) collected ($2.43)
Seat 4: Bakulia (small blind) folded on the Flop
Seat 5: hempju1ce (big blind) folded before Flop
Seat 6: alexos04 folded before Flop (didn't bet)



PokerStars Hand #222979848976:  Hold'em No Limit ($0.05/$0.10 USD) - 2021/01/23 19:28:14 ET
Table 'Lova III' 6-max Seat #4 is the button
Seat 1: and 07335 ($10 in chips) 
Seat 2: Zimniy ($11.86 in chips) 
Seat 3: albert riley ($18.31 in chips) 
Seat 4: Bakulia ($9.64 in chips) 
Seat 5: hempju1ce ($23.79 in chips) 
Seat 6: alexos04 ($10 in chips) 
hempju1ce: posts small blind $0.05
alexos04: posts big blind $0.10
*** HOLE CARDS ***
and 07335: folds 
Zimniy: folds 
albert riley: folds 
Bakulia: calls $0.10
hempju1ce: calls $0.05
alexos04: checks 
*** FLOP *** [Td 2d 5d]
hempju1ce: bets $0.14
alexos04: calls $0.14
Bakulia: calls $0.14
*** TURN *** [Td 2d 5d] [8d]
hempju1ce: checks 
alexos04: checks 
Bakulia: checks 
*** RIVER *** [Td 2d 5d 8d] [Ac]
hempju1ce: checks 
alexos04: bets $0.40
Bakulia: folds 
hempju1ce: calls $0.40
*** SHOW DOWN ***
alexos04: shows [5h Ad] (a flush, Ace high)
hempju1ce: mucks hand 
alexos04 collected $1.45 from pot
*** SUMMARY ***
Total pot $1.52 | Rake $0.07 
Board [Td 2d 5d 8d Ac]
Seat 1: and 07335 folded before Flop (didn't bet)
Seat 2: Zimniy folded before Flop (didn't bet)
Seat 3: albert riley folded before Flop (didn't bet)
Seat 4: Bakulia (button) folded on the River
Seat 5: hempju1ce (small blind) mucked
Seat 6: alexos04 (big blind) showed [5h Ad] and won ($1.45) with a flush, Ace high



PokerStars Hand #222979878218:  Hold'em No Limit ($0.05/$0.10 USD) - 2021/01/23 19:29:10 ET
Table 'Lova III' 6-max Seat #5 is the button
Seat 1: and 07335 ($10 in chips) 
Seat 2: Zimniy ($11.86 in chips) 
Seat 3: albert riley ($18.31 in chips) 
Seat 4: Bakulia ($9.40 in chips) 
Seat 5: hempju1ce ($23.15 in chips) 
Seat 6: alexos04 ($10.81 in chips) 
alexos04: posts small blind $0.05
and 07335: posts big blind $0.10
*** HOLE CARDS ***
Zimniy: folds 
albert riley: raises $0.20 to $0.30
Bakulia: calls $0.30
hempju1ce: folds 
alexos04: folds 
and 07335: folds 
*** FLOP *** [Qd 9s 8d]
albert riley: bets $0.72
Bakulia: raises $0.72 to $1.44
albert riley: raises $16.57 to $18.01 and is all-in
Bakulia: calls $7.66 and is all-in
Uncalled bet ($8.91) returned to albert riley
albert riley has timed out
*** TURN *** [Qd 9s 8d] [Js]
*** RIVER *** [Qd 9s 8d Js] [Jh]
*** SHOW DOWN ***
albert riley: shows [As Ad] (two pair, Aces and Jacks)
Bakulia: shows [Qs Ts] (a straight, Eight to Queen)
Bakulia cashed out the hand for $6.38 | Cash Out Fee $0.06
*** SUMMARY ***
Total pot $18.95 | Rake $0.85 
Board [Qd 9s 8d Js Jh]
Seat 1: and 07335 (big blind) folded before Flop
Seat 2: Zimniy folded before Flop (didn't bet)
Seat 3: albert riley showed [As Ad] and lost with two pair, Aces and Jacks
Seat 4: Bakulia showed [Qs Ts] and won ($18.10) with a straight, Eight to Queen (pot not awarded as player cashed out)
Seat 5: hempju1ce (button) folded before Flop (didn't bet)
Seat 6: alexos04 (small blind) folded before Flop



PokerStars Hand #222979917494:  Hold'em No Limit ($0.05/$0.10 USD) - 2021/01/23 19:30:25 ET
Table 'Lova III' 6-max Seat #6 is the button
Seat 1: and 07335 ($10 in chips) 
Seat 2: Zimniy ($11.86 in chips) 
Seat 3: albert riley ($8.91 in chips) 
Seat 4: Bakulia ($6.38 in chips) 
Seat 5: hempju1ce ($23.15 in chips) 
Seat 6: alexos04 ($10.76 in chips) 
and 07335: posts small blind $0.05
Zimniy: posts big blind $0.10
*** HOLE CARDS ***
albert riley: calls $0.10
Bakulia: calls $0.10
hempju1ce: raises $0.30 to $0.40
alexos04: folds 
and 07335: folds 
Zimniy: folds 
albert riley: calls $0.30
Bakulia: calls $0.30
*** FLOP *** [Ad 9s 5d]
albert riley: bets $1.29
Bakulia: folds 
hempju1ce: calls $1.29
*** TURN *** [Ad 9s 5d] [6d]
albert riley: bets $7.22 and is all-in
hempju1ce: folds 
Uncalled bet ($7.22) returned to albert riley
albert riley collected $3.75 from pot
albert riley: doesn't show hand 
*** SUMMARY ***
Total pot $3.93 | Rake $0.18 
Board [Ad 9s 5d 6d]
Seat 1: and 07335 (small blind) folded before Flop
Seat 2: Zimniy (big blind) folded before Flop
Seat 3: albert riley collected ($3.75)
Seat 4: Bakulia folded on the Flop
Seat 5: hempju1ce folded on the Turn
Seat 6: alexos04 (button) folded before Flop (didn't bet)



PokerStars Hand #222979961080:  Hold'em No Limit ($0.05/$0.10 USD) - 2021/01/23 19:31:50 ET
Table 'Lova III' 6-max Seat #1 is the button
Seat 1: and 07335 ($10 in chips) 
Seat 2: Zimniy ($11.76 in chips) 
Seat 3: albert riley ($10.97 in chips) 
Seat 4: Bakulia ($5.98 in chips) 
Seat 5: hempju1ce ($21.46 in chips) 
Seat 6: alexos04 ($10.76 in chips) 
Zimniy: posts small blind $0.05
albert riley: posts big blind $0.10
*** HOLE CARDS ***
Bakulia: raises $0.20 to $0.30
hempju1ce: folds 
alexos04: folds 
and 07335: raises $0.65 to $0.95
Zimniy: folds 
albert riley: calls $0.85
Bakulia: raises $2.10 to $3.05
and 07335: calls $2.10
albert riley: calls $2.10
*** FLOP *** [7c Th 6h]
albert riley: bets $7.92 and is all-in
Bakulia: calls $2.93 and is all-in
and 07335: calls $6.95 and is all-in
Uncalled bet ($0.97) returned to albert riley
*** TURN *** [7c Th 6h] [Qs]
*** RIVER *** [7c Th 6h Qs] [6s]
*** SHOW DOWN ***
albert riley: shows [8c 9c] (a straight, Six to Ten)
and 07335: shows [Qd Qh] (a full house, Queens full of Sixes)
and 07335 collected $7.68 from side pot
Bakulia: shows [Ah Kd] (a pair of Sixes)
and 07335 collected $17.18 from main pot
*** SUMMARY ***
Total pot $26.03 Main pot $17.18. Side pot $7.68. | Rake $1.17 
Board [7c Th 6h Qs 6s]
Seat 1: and 07335 (button) showed [Qd Qh] and won ($24.86) with a full house, Queens full of Sixes
Seat 2: Zimniy (small blind) folded before Flop
Seat 3: albert riley (big blind) showed [8c 9c] and lost with a straight, Six to Ten
Seat 4: Bakulia showed [Ah Kd] and lost with a pair of Sixes
Seat 5: hempju1ce folded before Flop (didn't bet)
Seat 6: alexos04 folded before Flop (didn't bet)



PokerStars Hand #222980005660:  Hold'em No Limit ($0.05/$0.10 USD) - 2021/01/23 19:33:01 ET
Table 'Lova III' 6-max Seat #2 is the button
Seat 1: and 07335 ($24.86 in chips) 
Seat 2: Zimniy ($11.71 in chips) 
Seat 3: albert riley ($0.97 in chips) 
Seat 5: hempju1ce ($21.46 in chips) 
Seat 6: alexos04 ($10.76 in chips) 
albert riley: posts small blind $0.05
hempju1ce: posts big blind $0.10
*** HOLE CARDS ***
Bakulia leaves the table
alexos04: folds 
and 07335: folds 
Zimniy: folds 
albert riley: raises $0.87 to $0.97 and is all-in
hempju1ce: calls $0.87
albert riley has timed out
*** FLOP *** [6h 9c 3c]
*** TURN *** [6h 9c 3c] [8c]
*** RIVER *** [6h 9c 3c 8c] [Td]
*** SHOW DOWN ***
albert riley: shows [Jh Js] (a pair of Jacks)
hempju1ce: shows [As 6c] (a pair of Sixes)
albert riley collected $1.85 from pot
*** SUMMARY ***
Total pot $1.94 | Rake $0.09 
Board [6h 9c 3c 8c Td]
Seat 1: and 07335 folded before Flop (didn't bet)
Seat 2: Zimniy (button) folded before Flop (didn't bet)
Seat 3: albert riley (small blind) showed [Jh Js] and won ($1.85) with a pair of Jacks
Seat 5: hempju1ce (big blind) showed [As 6c] and lost with a pair of Sixes
Seat 6: alexos04 folded before Flop (didn't bet)



PokerStars Hand #222980027553:  Hold'em No Limit ($0.05/$0.10 USD) - 2021/01/23 19:33:44 ET
Table 'Lova III' 6-max Seat #3 is the button
Seat 1: and 07335 ($24.86 in chips) 
Seat 2: Zimniy ($11.71 in chips) 
Seat 3: albert riley ($1.85 in chips) 
Seat 5: hempju1ce ($20.49 in chips) 
Seat 6: alexos04 ($10.76 in chips) 
hempju1ce: posts small blind $0.05
alexos04: posts big blind $0.10
*** HOLE CARDS ***
KiraLasVegas joins the table at seat #4 
and 07335: folds 
Zimniy: folds 
albert riley: raises $0.10 to $0.20
hempju1ce: raises $0.70 to $0.90
alexos04: folds 
albert riley: raises $0.95 to $1.85 and is all-in
hempju1ce: calls $0.95
*** FLOP *** [6c 2d 9c]
*** TURN *** [6c 2d 9c] [9s]
*** RIVER *** [6c 2d 9c 9s] [7s]
*** SHOW DOWN ***
hempju1ce: shows [9h Qh] (three of a kind, Nines)
albert riley: shows [7h 5h] (two pair, Nines and Sevens)
hempju1ce collected $3.63 from pot
*** SUMMARY ***
Total pot $3.80 | Rake $0.17 
Board [6c 2d 9c 9s 7s]
Seat 1: and 07335 folded before Flop (didn't bet)
Seat 2: Zimniy folded before Flop (didn't bet)
Seat 3: albert riley (button) showed [7h 5h] and lost with two pair, Nines and Sevens
Seat 5: hempju1ce (small blind) showed [9h Qh] and won ($3.63) with three of a kind, Nines
Seat 6: alexos04 (big blind) folded before Flop



PokerStars Hand #222980050923:  Hold'em No Limit ($0.05/$0.10 USD) - 2021/01/23 19:34:30 ET
Table 'Lova III' 6-max Seat #5 is the button
Seat 1: and 07335 ($24.86 in chips) 
Seat 2: Zimniy ($11.71 in chips) 
Seat 5: hempju1ce ($22.27 in chips) 
Seat 6: alexos04 ($10.66 in chips) 
alexos04: posts small blind $0.05
and 07335: posts big blind $0.10
KiraLasVegas: sits out 
*** HOLE CARDS ***
Zimniy: folds 
hempju1ce: folds 
alexos04: folds 
Uncalled bet ($0.05) returned to and 07335
and 07335 collected $0.10 from pot
and 07335: doesn't show hand 
*** SUMMARY ***
Total pot $0.10 | Rake $0 
Seat 1: and 07335 (big blind) collected ($0.10)
Seat 2: Zimniy folded before Flop (didn't bet)
Seat 5: hempju1ce (button) folded before Flop (didn't bet)
Seat 6: alexos04 (small blind) folded before Flop



PokerStars Hand #222980055914:  Hold'em No Limit ($0.05/$0.10 USD) - 2021/01/23 19:34:40 ET
Table 'Lova III' 6-max Seat #6 is the button
Seat 1: and 07335 ($24.91 in chips) 
Seat 2: Zimniy ($11.71 in chips) 
Seat 5: hempju1ce ($22.27 in chips) 
Seat 6: alexos04 ($10.61 in chips) 
and 07335: posts small blind $0.05
Zimniy: posts big blind $0.10
KiraLasVegas: sits out 
*** HOLE CARDS ***
hempju1ce: folds 
alexos04: folds 
and 07335: folds 
Uncalled bet ($0.05) returned to Zimniy
Zimniy collected $0.10 from pot
Zimniy: doesn't show hand 
*** SUMMARY ***
Total pot $0.10 | Rake $0 
Seat 1: and 07335 (small blind) folded before Flop
Seat 2: Zimniy (big blind) collected ($0.10)
Seat 5: hempju1ce folded before Flop (didn't bet)
Seat 6: alexos04 (button) folded before Flop (didn't bet)



PokerStars Hand #222980062315:  Hold'em No Limit ($0.05/$0.10 USD) - 2021/01/23 19:34:53 ET
Table 'Lova III' 6-max Seat #1 is the button
Seat 1: and 07335 ($24.86 in chips) 
Seat 2: Zimniy ($11.76 in chips) 
Seat 4: KiraLasVegas ($10 in chips) 
Seat 5: hempju1ce ($22.27 in chips) 
Seat 6: alexos04 ($10.61 in chips) 
Zimniy: posts small blind $0.05
KiraLasVegas: posts big blind $0.10
*** HOLE CARDS ***
hempju1ce: folds 
alexos04: folds 
and 07335: folds 
Zimniy: folds 
Uncalled bet ($0.05) returned to KiraLasVegas
KiraLasVegas collected $0.10 from pot
KiraLasVegas: doesn't show hand 
*** SUMMARY ***
Total pot $0.10 | Rake $0 
Seat 1: and 07335 (button) folded before Flop (didn't bet)
Seat 2: Zimniy (small blind) folded before Flop
Seat 4: KiraLasVegas (big blind) collected ($0.10)
Seat 5: hempju1ce folded before Flop (didn't bet)
Seat 6: alexos04 folded before Flop (didn't bet)



PokerStars Hand #222980067541:  Hold'em No Limit ($0.05/$0.10 USD) - 2021/01/23 19:35:03 ET
Table 'Lova III' 6-max Seat #2 is the button
Seat 1: and 07335 ($24.86 in chips) 
Seat 2: Zimniy ($11.71 in chips) 
Seat 4: KiraLasVegas ($10.05 in chips) 
Seat 5: hempju1ce ($22.27 in chips) 
Seat 6: alexos04 ($10.61 in chips) 
KiraLasVegas: posts small blind $0.05
hempju1ce: posts big blind $0.10
*** HOLE CARDS ***
albert riley leaves the table
alexos04: raises $0.20 to $0.30
and 07335: folds 
Zimniy: folds 
KiraLasVegas: folds 
hempju1ce: folds 
Uncalled bet ($0.20) returned to alexos04
alexos04 collected $0.25 from pot
alexos04: doesn't show hand 
*** SUMMARY ***
Total pot $0.25 | Rake $0 
Seat 1: and 07335 folded before Flop (didn't bet)
Seat 2: Zimniy (button) folded before Flop (didn't bet)
Seat 4: KiraLasVegas (small blind) folded before Flop
Seat 5: hempju1ce (big blind) folded before Flop
Seat 6: alexos04 collected ($0.25)



PokerStars Hand #222980075170:  Hold'em No Limit ($0.05/$0.10 USD) - 2021/01/23 19:35:18 ET
Table 'Lova III' 6-max Seat #4 is the button
Seat 1: and 07335 ($24.86 in chips) 
Seat 2: Zimniy ($11.71 in chips) 
Seat 4: KiraLasVegas ($10 in chips) 
Seat 5: hempju1ce ($22.17 in chips) 
Seat 6: alexos04 ($10.76 in chips) 
hempju1ce: posts small blind $0.05
alexos04: posts big blind $0.10
*** HOLE CARDS ***
and 07335: folds 
Zimniy: folds 
KiraLasVegas: folds 
and 07335 leaves the table
hempju1ce: calls $0.05
alexos04: checks 
*** FLOP *** [Td Ac 8h]
hempju1ce: checks 
alexos04: checks 
*** TURN *** [Td Ac 8h] [6d]
hempju1ce: checks 
Rosska(Rus) joins the table at seat #1 
alexos04: bets $0.20
hempju1ce: folds 
Uncalled bet ($0.20) returned to alexos04
alexos04 collected $0.19 from pot
alexos04: doesn't show hand 
*** SUMMARY ***
Total pot $0.20 | Rake $0.01 
Board [Td Ac 8h 6d]
Seat 1: and 07335 folded before Flop (didn't bet)
Seat 2: Zimniy folded before Flop (didn't bet)
Seat 4: KiraLasVegas (button) folded before Flop (didn't bet)
Seat 5: hempju1ce (small blind) folded on the Turn
Seat 6: alexos04 (big blind) collected ($0.19)



PokerStars Hand #222980091588:  Hold'em No Limit ($0.05/$0.10 USD) - 2021/01/23 19:35:51 ET
Table 'Lova III' 6-max Seat #5 is the button
Seat 1: Rosska(Rus) ($10 in chips) 
Seat 2: Zimniy ($11.71 in chips) 
Seat 4: KiraLasVegas ($10 in chips) 
Seat 5: hempju1ce ($22.07 in chips) 
Seat 6: alexos04 ($10.85 in chips) 
alexos04: posts small blind $0.05
Rosska(Rus): posts big blind $0.10
*** HOLE CARDS ***
Zimniy: folds 
KiraLasVegas: folds 
No1Sparkles joins the table at seat #3 
hempju1ce: folds 
alexos04: raises $0.20 to $0.30
Rosska(Rus): folds 
Uncalled bet ($0.20) returned to alexos04
alexos04 collected $0.20 from pot
alexos04: doesn't show hand 
*** SUMMARY ***
Total pot $0.20 | Rake $0 
Seat 1: Rosska(Rus) (big blind) folded before Flop
Seat 2: Zimniy folded before Flop (didn't bet)
Seat 4: KiraLasVegas folded before Flop (didn't bet)
Seat 5: hempju1ce (button) folded before Flop (didn't bet)
Seat 6: alexos04 (small blind) collected ($0.20)



PokerStars Hand #222980099841:  Hold'em No Limit ($0.05/$0.10 USD) - 2021/01/23 19:36:07 ET
Table 'Lova III' 6-max Seat #6 is the button
Seat 1: Rosska(Rus) ($10 in chips) 
Seat 3: No1Sparkles ($10 in chips) 
Seat 4: KiraLasVegas ($10 in chips) 
Seat 5: hempju1ce ($22.07 in chips) 
Seat 6: alexos04 ($10.95 in chips) 
Rosska(Rus): posts small blind $0.05
Zimniy: is sitting out 
No1Sparkles: posts big blind $0.10
*** HOLE CARDS ***
KiraLasVegas: folds 
hempju1ce: folds 
Zimniy leaves the table
alexos04: folds 
Rosska(Rus): folds 
Uncalled bet ($0.05) returned to No1Sparkles
No1Sparkles collected $0.10 from pot
No1Sparkles: doesn't show hand 
*** SUMMARY ***
Total pot $0.10 | Rake $0 
Seat 1: Rosska(Rus) (small blind) folded before Flop
Seat 3: No1Sparkles (big blind) collected ($0.10)
Seat 4: KiraLasVegas folded before Flop (didn't bet)
Seat 5: hempju1ce folded before Flop (didn't bet)
Seat 6: alexos04 (button) folded before Flop (didn't bet)



PokerStars Hand #222980104334:  Hold'em No Limit ($0.05/$0.10 USD) - 2021/01/23 19:36:16 ET
Table 'Lova III' 6-max Seat #1 is the button
Seat 1: Rosska(Rus) ($10 in chips) 
Seat 3: No1Sparkles ($10.05 in chips) 
Seat 4: KiraLasVegas ($10 in chips) 
Seat 5: hempju1ce ($22.07 in chips) 
Seat 6: alexos04 ($10.95 in chips) 
No1Sparkles: posts small blind $0.05
KiraLasVegas: posts big blind $0.10
*** HOLE CARDS ***
hempju1ce: folds 
alexos04: folds 
BCEM KAIOK joins the table at seat #2 
Rosska(Rus): folds 
No1Sparkles: folds 
Uncalled bet ($0.05) returned to KiraLasVegas
KiraLasVegas collected $0.10 from pot
KiraLasVegas: doesn't show hand 
*** SUMMARY ***
Total pot $0.10 | Rake $0 
Seat 1: Rosska(Rus) (button) folded before Flop (didn't bet)
Seat 3: No1Sparkles (small blind) folded before Flop
Seat 4: KiraLasVegas (big blind) collected ($0.10)
Seat 5: hempju1ce folded before Flop (didn't bet)
Seat 6: alexos04 folded before Flop (didn't bet)



PokerStars Hand #222980108145:  Hold'em No Limit ($0.05/$0.10 USD) - 2021/01/23 19:36:23 ET
Table 'Lova III' 6-max Seat #3 is the button
Seat 1: Rosska(Rus) ($10 in chips) 
Seat 3: No1Sparkles ($10 in chips) 
Seat 4: KiraLasVegas ($10.05 in chips) 
Seat 5: hempju1ce ($22.07 in chips) 
Seat 6: alexos04 ($10.95 in chips) 
KiraLasVegas: posts small blind $0.05
hempju1ce: posts big blind $0.10
BCEM KAIOK: sits out 
*** HOLE CARDS ***
alexos04: folds 
Rosska(Rus): folds 
No1Sparkles: folds 
KiraLasVegas: folds 
Uncalled bet ($0.05) returned to hempju1ce
hempju1ce collected $0.10 from pot
hempju1ce: doesn't show hand 
*** SUMMARY ***
Total pot $0.10 | Rake $0 
Seat 1: Rosska(Rus) folded before Flop (didn't bet)
Seat 3: No1Sparkles (button) folded before Flop (didn't bet)
Seat 4: KiraLasVegas (small blind) folded before Flop
Seat 5: hempju1ce (big blind) collected ($0.10)
Seat 6: alexos04 folded before Flop (didn't bet)



PokerStars Hand #222980114197:  Hold'em No Limit ($0.05/$0.10 USD) - 2021/01/23 19:36:36 ET
Table 'Lova III' 6-max Seat #4 is the button
Seat 1: Rosska(Rus) ($10 in chips) 
Seat 3: No1Sparkles ($10 in chips) 
Seat 4: KiraLasVegas ($10 in chips) 
Seat 5: hempju1ce ($22.12 in chips) 
Seat 6: alexos04 ($10.95 in chips) 
hempju1ce: posts small blind $0.05
alexos04: posts big blind $0.10
BCEM KAIOK: sits out 
*** HOLE CARDS ***
Rosska(Rus): folds 
No1Sparkles: folds 
KiraLasVegas: folds 
hempju1ce: calls $0.05
alexos04: checks 
*** FLOP *** [4s 2d 5d]
hempju1ce: bets $0.10
alexos04: folds 
Uncalled bet ($0.10) returned to hempju1ce
hempju1ce collected $0.19 from pot
hempju1ce: doesn't show hand 
*** SUMMARY ***
Total pot $0.20 | Rake $0.01 
Board [4s 2d 5d]
Seat 1: Rosska(Rus) folded before Flop (didn't bet)
Seat 3: No1Sparkles folded before Flop (didn't bet)
Seat 4: KiraLasVegas (button) folded before Flop (didn't bet)
Seat 5: hempju1ce (small blind) collected ($0.19)
Seat 6: alexos04 (big blind) folded on the Flop



PokerStars Hand #222980129953:  Hold'em No Limit ($0.05/$0.10 USD) - 2021/01/23 19:37:07 ET
Table 'Lova III' 6-max Seat #5 is the button
Seat 1: Rosska(Rus) ($10 in chips) 
Seat 3: No1Sparkles ($10 in chips) 
Seat 4: KiraLasVegas ($10 in chips) 
Seat 5: hempju1ce ($22.21 in chips) 
Seat 6: alexos04 ($10.85 in chips) 
alexos04: posts small blind $0.05
Rosska(Rus): posts big blind $0.10
BCEM KAIOK: sits out 
*** HOLE CARDS ***
No1Sparkles: folds 
KiraLasVegas: raises $0.15 to $0.25
hempju1ce: folds 
alexos04: folds 
Rosska(Rus): folds 
Uncalled bet ($0.15) returned to KiraLasVegas
KiraLasVegas collected $0.25 from pot
KiraLasVegas: doesn't show hand 
*** SUMMARY ***
Total pot $0.25 | Rake $0 
Seat 1: Rosska(Rus) (big blind) folded before Flop
Seat 3: No1Sparkles folded before Flop (didn't bet)
Seat 4: KiraLasVegas collected ($0.25)
Seat 5: hempju1ce (button) folded before Flop (didn't bet)
Seat 6: alexos04 (small blind) folded before Flop



PokerStars Hand #222980135069:  Hold'em No Limit ($0.05/$0.10 USD) - 2021/01/23 19:37:17 ET
Table 'Lova III' 6-max Seat #6 is the button
Seat 1: Rosska(Rus) ($10 in chips) 
Seat 2: BCEM KAIOK ($10 in chips) 
Seat 3: No1Sparkles ($10 in chips) 
Seat 4: KiraLasVegas ($10.15 in chips) 
Seat 5: hempju1ce ($22.21 in chips) 
Seat 6: alexos04 ($10.80 in chips) 
Rosska(Rus): posts small blind $0.05
BCEM KAIOK: posts big blind $0.10
*** HOLE CARDS ***
No1Sparkles: folds 
KiraLasVegas: folds 
hempju1ce: folds 
alexos04: folds 
Rosska(Rus): folds 
Uncalled bet ($0.05) returned to BCEM KAIOK
BCEM KAIOK collected $0.10 from pot
BCEM KAIOK: doesn't show hand 
*** SUMMARY ***
Total pot $0.10 | Rake $0 
Seat 1: Rosska(Rus) (small blind) folded before Flop
Seat 2: BCEM KAIOK (big blind) collected ($0.10)
Seat 3: No1Sparkles folded before Flop (didn't bet)
Seat 4: KiraLasVegas folded before Flop (didn't bet)
Seat 5: hempju1ce folded before Flop (didn't bet)
Seat 6: alexos04 (button) folded before Flop (didn't bet)



PokerStars Hand #222980140870:  Hold'em No Limit ($0.05/$0.10 USD) - 2021/01/23 19:37:28 ET
Table 'Lova III' 6-max Seat #1 is the button
Seat 1: Rosska(Rus) ($10 in chips) 
Seat 2: BCEM KAIOK ($10.05 in chips) 
Seat 3: No1Sparkles ($10 in chips) 
Seat 4: KiraLasVegas ($10.15 in chips) 
Seat 5: hempju1ce ($22.21 in chips) 
Seat 6: alexos04 ($10.80 in chips) 
BCEM KAIOK: posts small blind $0.05
No1Sparkles: posts big blind $0.10
*** HOLE CARDS ***
KiraLasVegas: folds 
hempju1ce: folds 
alexos04: folds 
Rosska(Rus): folds 
BCEM KAIOK: folds 
Uncalled bet ($0.05) returned to No1Sparkles
No1Sparkles collected $0.10 from pot
No1Sparkles: doesn't show hand 
*** SUMMARY ***
Total pot $0.10 | Rake $0 
Seat 1: Rosska(Rus) (button) folded before Flop (didn't bet)
Seat 2: BCEM KAIOK (small blind) folded before Flop
Seat 3: No1Sparkles (big blind) collected ($0.10)
Seat 4: KiraLasVegas folded before Flop (didn't bet)
Seat 5: hempju1ce folded before Flop (didn't bet)
Seat 6: alexos04 folded before Flop (didn't bet)



PokerStars Hand #222980145223:  Hold'em No Limit ($0.05/$0.10 USD) - 2021/01/23 19:37:37 ET
Table 'Lova III' 6-max Seat #2 is the button
Seat 1: Rosska(Rus) ($10 in chips) 
Seat 2: BCEM KAIOK ($10 in chips) 
Seat 3: No1Sparkles ($10.05 in chips) 
Seat 4: KiraLasVegas ($10.15 in chips) 
Seat 5: hempju1ce ($22.21 in chips) 
Seat 6: alexos04 ($10.80 in chips) 
No1Sparkles: posts small blind $0.05
KiraLasVegas: posts big blind $0.10
*** HOLE CARDS ***
hempju1ce: folds 
alexos04: folds 
Rosska(Rus): folds 
BCEM KAIOK: folds 
No1Sparkles: raises $0.20 to $0.30
KiraLasVegas: folds 
Uncalled bet ($0.20) returned to No1Sparkles
No1Sparkles collected $0.20 from pot
No1Sparkles: doesn't show hand 
*** SUMMARY ***
Total pot $0.20 | Rake $0 
Seat 1: Rosska(Rus) folded before Flop (didn't bet)
Seat 2: BCEM KAIOK (button) folded before Flop (didn't bet)
Seat 3: No1Sparkles (small blind) collected ($0.20)
Seat 4: KiraLasVegas (big blind) folded before Flop
Seat 5: hempju1ce folded before Flop (didn't bet)
Seat 6: alexos04 folded before Flop (didn't bet)



PokerStars Hand #222980153658:  Hold'em No Limit ($0.05/$0.10 USD) - 2021/01/23 19:37:54 ET
Table 'Lova III' 6-max Seat #3 is the button
Seat 1: Rosska(Rus) ($10 in chips) 
Seat 2: BCEM KAIOK ($10 in chips) 
Seat 3: No1Sparkles ($10.15 in chips) 
Seat 4: KiraLasVegas ($10.05 in chips) 
Seat 5: hempju1ce ($22.21 in chips) 
Seat 6: alexos04 ($10.80 in chips) 
KiraLasVegas: posts small blind $0.05
hempju1ce: posts big blind $0.10
*** HOLE CARDS ***
alexos04: folds 
Rosska(Rus): raises $0.20 to $0.30
BCEM KAIOK: calls $0.30
No1Sparkles: calls $0.30
KiraLasVegas: raises $1.50 to $1.80
hempju1ce: folds 
Rosska(Rus): calls $1.50
BCEM KAIOK: folds 
No1Sparkles: folds 
*** FLOP *** [Ah Kc Td]
KiraLasVegas: checks 
Rosska(Rus): bets $1.35
KiraLasVegas: folds 
Uncalled bet ($1.35) returned to Rosska(Rus)
Rosska(Rus) collected $4.11 from pot
Rosska(Rus): doesn't show hand 
*** SUMMARY ***
Total pot $4.30 | Rake $0.19 
Board [Ah Kc Td]
Seat 1: Rosska(Rus) collected ($4.11)
Seat 2: BCEM KAIOK folded before Flop
Seat 3: No1Sparkles (button) folded before Flop
Seat 4: KiraLasVegas (small blind) folded on the Flop
Seat 5: hempju1ce (big blind) folded before Flop
Seat 6: alexos04 folded before Flop (didn't bet)



PokerStars Hand #222980182344:  Hold'em No Limit ($0.05/$0.10 USD) - 2021/01/23 19:38:51 ET
Table 'Lova III' 6-max Seat #4 is the button
Seat 1: Rosska(Rus) ($12.31 in chips) 
Seat 2: BCEM KAIOK ($10 in chips) 
Seat 3: No1Sparkles ($10 in chips) 
Seat 4: KiraLasVegas ($10 in chips) 
Seat 5: hempju1ce ($22.11 in chips) 
Seat 6: alexos04 ($10.80 in chips) 
hempju1ce: posts small blind $0.05
alexos04: posts big blind $0.10
*** HOLE CARDS ***
Rosska(Rus): folds 
BCEM KAIOK: folds 
No1Sparkles: raises $0.20 to $0.30
KiraLasVegas: folds 
hempju1ce: folds 
alexos04: folds 
Uncalled bet ($0.20) returned to No1Sparkles
No1Sparkles collected $0.25 from pot
No1Sparkles: doesn't show hand 
*** SUMMARY ***
Total pot $0.25 | Rake $0 
Seat 1: Rosska(Rus) folded before Flop (didn't bet)
Seat 2: BCEM KAIOK folded before Flop (didn't bet)
Seat 3: No1Sparkles collected ($0.25)
Seat 4: KiraLasVegas (button) folded before Flop (didn't bet)
Seat 5: hempju1ce (small blind) folded before Flop
Seat 6: alexos04 (big blind) folded before Flop



PokerStars Hand #222980191358:  Hold'em No Limit ($0.05/$0.10 USD) - 2021/01/23 19:39:09 ET
Table 'Lova III' 6-max Seat #5 is the button
Seat 1: Rosska(Rus) ($12.31 in chips) 
Seat 2: BCEM KAIOK ($10 in chips) 
Seat 3: No1Sparkles ($10.15 in chips) 
Seat 4: KiraLasVegas ($10 in chips) 
Seat 5: hempju1ce ($22.06 in chips) 
Seat 6: alexos04 ($10.70 in chips) 
alexos04: posts small blind $0.05
Rosska(Rus): posts big blind $0.10
*** HOLE CARDS ***
BCEM KAIOK: folds 
No1Sparkles: folds 
KiraLasVegas: raises $0.15 to $0.25
hempju1ce: calls $0.25
alexos04: folds 
Rosska(Rus): folds 
*** FLOP *** [3h 3s Kc]
KiraLasVegas: bets $0.22
hempju1ce: calls $0.22
*** TURN *** [3h 3s Kc] [2d]
KiraLasVegas: bets $0.36
hempju1ce: raises $0.88 to $1.24
KiraLasVegas: folds 
Uncalled bet ($0.88) returned to hempju1ce
hempju1ce collected $1.73 from pot
hempju1ce: doesn't show hand 
*** SUMMARY ***
Total pot $1.81 | Rake $0.08 
Board [3h 3s Kc 2d]
Seat 1: Rosska(Rus) (big blind) folded before Flop
Seat 2: BCEM KAIOK folded before Flop (didn't bet)
Seat 3: No1Sparkles folded before Flop (didn't bet)
Seat 4: KiraLasVegas folded on the Turn
Seat 5: hempju1ce (button) collected ($1.73)
Seat 6: alexos04 (small blind) folded before Flop



PokerStars Hand #222980206151:  Hold'em No Limit ($0.05/$0.10 USD) - 2021/01/23 19:39:38 ET
Table 'Lova III' 6-max Seat #6 is the button
Seat 1: Rosska(Rus) ($12.21 in chips) 
Seat 2: BCEM KAIOK ($10 in chips) 
Seat 3: No1Sparkles ($10.15 in chips) 
Seat 4: KiraLasVegas ($10 in chips) 
Seat 5: hempju1ce ($22.96 in chips) 
Seat 6: alexos04 ($10.65 in chips) 
Rosska(Rus): posts small blind $0.05
BCEM KAIOK: posts big blind $0.10
*** HOLE CARDS ***
No1Sparkles: folds 
KiraLasVegas: folds 
hempju1ce: folds 
alexos04: folds 
Rosska(Rus): raises $0.20 to $0.30
BCEM KAIOK: folds 
Uncalled bet ($0.20) returned to Rosska(Rus)
Rosska(Rus) collected $0.20 from pot
Rosska(Rus): doesn't show hand 
*** SUMMARY ***
Total pot $0.20 | Rake $0 
Seat 1: Rosska(Rus) (small blind) collected ($0.20)
Seat 2: BCEM KAIOK (big blind) folded before Flop
Seat 3: No1Sparkles folded before Flop (didn't bet)
Seat 4: KiraLasVegas folded before Flop (didn't bet)
Seat 5: hempju1ce folded before Flop (didn't bet)
Seat 6: alexos04 (button) folded before Flop (didn't bet)



PokerStars Hand #222980218846:  Hold'em No Limit ($0.05/$0.10 USD) - 2021/01/23 19:40:04 ET
Table 'Lova III' 6-max Seat #1 is the button
Seat 1: Rosska(Rus) ($12.31 in chips) 
Seat 2: BCEM KAIOK ($10 in chips) 
Seat 3: No1Sparkles ($10.15 in chips) 
Seat 4: KiraLasVegas ($10 in chips) 
Seat 5: hempju1ce ($22.96 in chips) 
Seat 6: alexos04 ($10.65 in chips) 
BCEM KAIOK: posts small blind $0.05
No1Sparkles: posts big blind $0.10
*** HOLE CARDS ***
KiraLasVegas: folds 
hempju1ce: raises $0.30 to $0.40
alexos04: folds 
Rosska(Rus): folds 
BCEM KAIOK: folds 
No1Sparkles: folds 
Uncalled bet ($0.30) returned to hempju1ce
KiraLasVegas leaves the table
hempju1ce collected $0.25 from pot
hempju1ce: doesn't show hand 
*** SUMMARY ***
Total pot $0.25 | Rake $0 
Seat 1: Rosska(Rus) (button) folded before Flop (didn't bet)
Seat 2: BCEM KAIOK (small blind) folded before Flop
Seat 3: No1Sparkles (big blind) folded before Flop
Seat 4: KiraLasVegas folded before Flop (didn't bet)
Seat 5: hempju1ce collected ($0.25)
Seat 6: alexos04 folded before Flop (didn't bet)



PokerStars Hand #222980228036:  Hold'em No Limit ($0.05/$0.10 USD) - 2021/01/23 19:40:23 ET
Table 'Lova III' 6-max Seat #2 is the button
Seat 1: Rosska(Rus) ($12.31 in chips) 
Seat 2: BCEM KAIOK ($10 in chips) 
Seat 3: No1Sparkles ($10.05 in chips) 
Seat 5: hempju1ce ($23.11 in chips) 
Seat 6: alexos04 ($10.65 in chips) 
No1Sparkles: posts small blind $0.05
hempju1ce: posts big blind $0.10
*** HOLE CARDS ***
alexos04: folds 
Rosska(Rus): folds 
BCEM KAIOK: raises $0.20 to $0.30
No1Sparkles: folds 
hempju1ce: calls $0.20
*** FLOP *** [8s Jh Ad]
manganito17 joins the table at seat #4 
hempju1ce: checks 
BCEM KAIOK: checks 
*** TURN *** [8s Jh Ad] [2c]
hempju1ce: bets $0.20
BCEM KAIOK: calls $0.20
*** RIVER *** [8s Jh Ad 2c] [4h]
hempju1ce: bets $1.50
BCEM KAIOK: folds 
Uncalled bet ($1.50) returned to hempju1ce
hempju1ce collected $1 from pot
hempju1ce: doesn't show hand 
*** SUMMARY ***
Total pot $1.05 | Rake $0.05 
Board [8s Jh Ad 2c 4h]
Seat 1: Rosska(Rus) folded before Flop (didn't bet)
Seat 2: BCEM KAIOK (button) folded on the River
Seat 3: No1Sparkles (small blind) folded before Flop
Seat 5: hempju1ce (big blind) collected ($1)
Seat 6: alexos04 folded before Flop (didn't bet)



PokerStars Hand #222980258275:  Hold'em No Limit ($0.05/$0.10 USD) - 2021/01/23 19:41:23 ET
Table 'Lova III' 6-max Seat #3 is the button
Seat 1: Rosska(Rus) ($12.31 in chips) 
Seat 2: BCEM KAIOK ($10 in chips) 
Seat 3: No1Sparkles ($10 in chips) 
Seat 5: hempju1ce ($23.61 in chips) 
Seat 6: alexos04 ($10.65 in chips) 
hempju1ce: posts small blind $0.05
alexos04: posts big blind $0.10
*** HOLE CARDS ***
Rosska(Rus): raises $0.20 to $0.30
BCEM KAIOK: folds 
No1Sparkles: raises $0.60 to $0.90
hempju1ce: folds 
alexos04: folds 
Rosska(Rus): folds 
Uncalled bet ($0.60) returned to No1Sparkles
No1Sparkles collected $0.75 from pot
No1Sparkles: doesn't show hand 
*** SUMMARY ***
Total pot $0.75 | Rake $0 
Seat 1: Rosska(Rus) folded before Flop
Seat 2: BCEM KAIOK folded before Flop (didn't bet)
Seat 3: No1Sparkles (button) collected ($0.75)
Seat 5: hempju1ce (small blind) folded before Flop
Seat 6: alexos04 (big blind) folded before Flop



PokerStars Hand #222980265755:  Hold'em No Limit ($0.05/$0.10 USD) - 2021/01/23 19:41:38 ET
Table 'Lova III' 6-max Seat #5 is the button
Seat 1: Rosska(Rus) ($12.01 in chips) 
Seat 2: BCEM KAIOK ($10 in chips) 
Seat 3: No1Sparkles ($10.45 in chips) 
Seat 5: hempju1ce ($23.56 in chips) 
Seat 6: alexos04 ($10.55 in chips) 
alexos04: posts small blind $0.05
Rosska(Rus): posts big blind $0.10
manganito17: sits out 
*** HOLE CARDS ***
BCEM KAIOK: folds 
No1Sparkles: folds 
hempju1ce: calls $0.10
alexos04: raises $0.40 to $0.50
Rosska(Rus): folds 
hempju1ce: calls $0.40
*** FLOP *** [4d Ks Th]
alexos04: bets $0.50
hempju1ce: folds 
Uncalled bet ($0.50) returned to alexos04
alexos04 collected $1.05 from pot
alexos04: doesn't show hand 
*** SUMMARY ***
Total pot $1.10 | Rake $0.05 
Board [4d Ks Th]
Seat 1: Rosska(Rus) (big blind) folded before Flop
Seat 2: BCEM KAIOK folded before Flop (didn't bet)
Seat 3: No1Sparkles folded before Flop (didn't bet)
Seat 5: hempju1ce (button) folded on the Flop
Seat 6: alexos04 (small blind) collected ($1.05)



PokerStars Hand #222980281895:  Hold'em No Limit ($0.05/$0.10 USD) - 2021/01/23 19:42:11 ET
Table 'Lova III' 6-max Seat #6 is the button
Seat 1: Rosska(Rus) ($11.91 in chips) 
Seat 2: BCEM KAIOK ($10 in chips) 
Seat 3: No1Sparkles ($10.45 in chips) 
Seat 5: hempju1ce ($23.06 in chips) 
Seat 6: alexos04 ($11.10 in chips) 
Rosska(Rus): posts small blind $0.05
BCEM KAIOK: posts big blind $0.10
manganito17: sits out 
*** HOLE CARDS ***
No1Sparkles: folds 
hempju1ce: folds 
alexos04: folds 
Rosska(Rus): raises $0.20 to $0.30
BCEM KAIOK: calls $0.20
*** FLOP *** [9h 9c Kd]
Rosska(Rus): bets $0.19
BCEM KAIOK: calls $0.19
*** TURN *** [9h 9c Kd] [8h]
Rosska(Rus): bets $0.72
BCEM KAIOK: calls $0.72
*** RIVER *** [9h 9c Kd 8h] [Ad]
Rosska(Rus): checks 
BCEM KAIOK: checks 
*** SHOW DOWN ***
Rosska(Rus): shows [Jh Ts] (a pair of Nines)
BCEM KAIOK: shows [Kh Th] (two pair, Kings and Nines)
BCEM KAIOK collected $2.31 from pot
*** SUMMARY ***
Total pot $2.42 | Rake $0.11 
Board [9h 9c Kd 8h Ad]
Seat 1: Rosska(Rus) (small blind) showed [Jh Ts] and lost with a pair of Nines
Seat 2: BCEM KAIOK (big blind) showed [Kh Th] and won ($2.31) with two pair, Kings and Nines
Seat 3: No1Sparkles folded before Flop (didn't bet)
Seat 5: hempju1ce folded before Flop (didn't bet)
Seat 6: alexos04 (button) folded before Flop (didn't bet)



PokerStars Hand #222980299639:  Hold'em No Limit ($0.05/$0.10 USD) - 2021/01/23 19:42:48 ET
Table 'Lova III' 6-max Seat #1 is the button
Seat 1: Rosska(Rus) ($10.70 in chips) 
Seat 2: BCEM KAIOK ($11.10 in chips) 
Seat 3: No1Sparkles ($10.45 in chips) 
Seat 5: hempju1ce ($23.06 in chips) 
Seat 6: alexos04 ($11.10 in chips) 
BCEM KAIOK: posts small blind $0.05
No1Sparkles: posts big blind $0.10
manganito17: sits out 
*** HOLE CARDS ***
hempju1ce: raises $0.20 to $0.30
alexos04: folds 
Rosska(Rus): folds 
BCEM KAIOK: folds 
No1Sparkles: folds 
Uncalled bet ($0.20) returned to hempju1ce
hempju1ce collected $0.25 from pot
hempju1ce: doesn't show hand 
*** SUMMARY ***
Total pot $0.25 | Rake $0 
Seat 1: Rosska(Rus) (button) folded before Flop (didn't bet)
Seat 2: BCEM KAIOK (small blind) folded before Flop
Seat 3: No1Sparkles (big blind) folded before Flop
Seat 5: hempju1ce collected ($0.25)
Seat 6: alexos04 folded before Flop (didn't bet)



PokerStars Hand #222980304349:  Hold'em No Limit ($0.05/$0.10 USD) - 2021/01/23 19:42:57 ET
Table 'Lova III' 6-max Seat #2 is the button
Seat 1: Rosska(Rus) ($10.70 in chips) 
Seat 2: BCEM KAIOK ($11.05 in chips) 
Seat 3: No1Sparkles ($10.35 in chips) 
Seat 4: manganito17 ($10 in chips) 
Seat 5: hempju1ce ($23.21 in chips) 
Seat 6: alexos04 ($11.10 in chips) 
No1Sparkles: posts small blind $0.05
manganito17: posts big blind $0.10
*** HOLE CARDS ***
hempju1ce: folds 
alexos04: folds 
Rosska(Rus): raises $0.20 to $0.30
BCEM KAIOK: folds 
No1Sparkles: folds 
manganito17: calls $0.20
*** FLOP *** [9h 8c Jh]
manganito17: checks 
Rosska(Rus): checks 
*** TURN *** [9h 8c Jh] [Ah]
manganito17: bets $0.20
Rosska(Rus): folds 
Uncalled bet ($0.20) returned to manganito17
manganito17 collected $0.62 from pot
manganito17: doesn't show hand 
*** SUMMARY ***
Total pot $0.65 | Rake $0.03 
Board [9h 8c Jh Ah]
Seat 1: Rosska(Rus) folded on the Turn
Seat 2: BCEM KAIOK (button) folded before Flop (didn't bet)
Seat 3: No1Sparkles (small blind) folded before Flop
Seat 4: manganito17 (big blind) collected ($0.62)
Seat 5: hempju1ce folded before Flop (didn't bet)
Seat 6: alexos04 folded before Flop (didn't bet)



PokerStars Hand #222980323749:  Hold'em No Limit ($0.05/$0.10 USD) - 2021/01/23 19:43:37 ET
Table 'Lova III' 6-max Seat #3 is the button
Seat 1: Rosska(Rus) ($10.40 in chips) 
Seat 2: BCEM KAIOK ($11.05 in chips) 
Seat 3: No1Sparkles ($10.30 in chips) 
Seat 4: manganito17 ($10.32 in chips) 
Seat 5: hempju1ce ($23.21 in chips) 
Seat 6: alexos04 ($11.10 in chips) 
manganito17: posts small blind $0.05
hempju1ce: posts big blind $0.10
*** HOLE CARDS ***
alexos04: folds 
Rosska(Rus): raises $0.20 to $0.30
BCEM KAIOK: folds 
No1Sparkles: folds 
manganito17: folds 
hempju1ce: folds 
Uncalled bet ($0.20) returned to Rosska(Rus)
Rosska(Rus) collected $0.25 from pot
Rosska(Rus): doesn't show hand 
*** SUMMARY ***
Total pot $0.25 | Rake $0 
Seat 1: Rosska(Rus) collected ($0.25)
Seat 2: BCEM KAIOK folded before Flop (didn't bet)
Seat 3: No1Sparkles (button) folded before Flop (didn't bet)
Seat 4: manganito17 (small blind) folded before Flop
Seat 5: hempju1ce (big blind) folded before Flop
Seat 6: alexos04 folded before Flop (didn't bet)



PokerStars Hand #222980333804:  Hold'em No Limit ($0.05/$0.10 USD) - 2021/01/23 19:43:57 ET
Table 'Lova III' 6-max Seat #4 is the button
Seat 1: Rosska(Rus) ($10.55 in chips) 
Seat 2: BCEM KAIOK ($11.05 in chips) 
Seat 3: No1Sparkles ($10.30 in chips) 
Seat 4: manganito17 ($10.27 in chips) 
Seat 5: hempju1ce ($23.11 in chips) 
Seat 6: alexos04 ($11.10 in chips) 
hempju1ce: posts small blind $0.05
alexos04: posts big blind $0.10
*** HOLE CARDS ***
Rosska(Rus): folds 
BCEM KAIOK: folds 
No1Sparkles: folds 
manganito17: raises $0.20 to $0.30
hempju1ce: folds 
alexos04: folds 
Uncalled bet ($0.20) returned to manganito17
manganito17 collected $0.25 from pot
manganito17: doesn't show hand 
*** SUMMARY ***
Total pot $0.25 | Rake $0 
Seat 1: Rosska(Rus) folded before Flop (didn't bet)
Seat 2: BCEM KAIOK folded before Flop (didn't bet)
Seat 3: No1Sparkles folded before Flop (didn't bet)
Seat 4: manganito17 (button) collected ($0.25)
Seat 5: hempju1ce (small blind) folded before Flop
Seat 6: alexos04 (big blind) folded before Flop



PokerStars Hand #222980345891:  Hold'em No Limit ($0.05/$0.10 USD) - 2021/01/23 19:44:22 ET
Table 'Lova III' 6-max Seat #5 is the button
Seat 1: Rosska(Rus) ($10.55 in chips) 
Seat 2: BCEM KAIOK ($11.05 in chips) 
Seat 3: No1Sparkles ($10.30 in chips) 
Seat 4: manganito17 ($10.42 in chips) 
Seat 5: hempju1ce ($23.06 in chips) 
Seat 6: alexos04 ($11 in chips) 
alexos04: posts small blind $0.05
Rosska(Rus): posts big blind $0.10
*** HOLE CARDS ***
BCEM KAIOK: folds 
No1Sparkles: folds 
manganito17: folds 
hempju1ce: folds 
alexos04: folds 
Uncalled bet ($0.05) returned to Rosska(Rus)
Rosska(Rus) collected $0.10 from pot
Rosska(Rus): doesn't show hand 
*** SUMMARY ***
Total pot $0.10 | Rake $0 
Seat 1: Rosska(Rus) (big blind) collected ($0.10)
Seat 2: BCEM KAIOK folded before Flop (didn't bet)
Seat 3: No1Sparkles folded before Flop (didn't bet)
Seat 4: manganito17 folded before Flop (didn't bet)
Seat 5: hempju1ce (button) folded before Flop (didn't bet)
Seat 6: alexos04 (small blind) folded before Flop



PokerStars Hand #222980355361:  Hold'em No Limit ($0.05/$0.10 USD) - 2021/01/23 19:44:41 ET
Table 'Lova III' 6-max Seat #6 is the button
Seat 1: Rosska(Rus) ($10.60 in chips) 
Seat 2: BCEM KAIOK ($11.05 in chips) 
Seat 3: No1Sparkles ($10.30 in chips) 
Seat 4: manganito17 ($10.42 in chips) 
Seat 5: hempju1ce ($23.06 in chips) 
Seat 6: alexos04 ($10.95 in chips) 
Rosska(Rus): posts small blind $0.05
BCEM KAIOK: posts big blind $0.10
*** HOLE CARDS ***
No1Sparkles: folds 
manganito17: folds 
hempju1ce: folds 
alexos04: raises $0.20 to $0.30
Rosska(Rus): raises $0.90 to $1.20
BCEM KAIOK: folds 
alexos04: folds 
Uncalled bet ($0.90) returned to Rosska(Rus)
Rosska(Rus) collected $0.70 from pot
Rosska(Rus): doesn't show hand 
*** SUMMARY ***
Total pot $0.70 | Rake $0 
Seat 1: Rosska(Rus) (small blind) collected ($0.70)
Seat 2: BCEM KAIOK (big blind) folded before Flop
Seat 3: No1Sparkles folded before Flop (didn't bet)
Seat 4: manganito17 folded before Flop (didn't bet)
Seat 5: hempju1ce folded before Flop (didn't bet)
Seat 6: alexos04 (button) folded before Flop



PokerStars Hand #222980367916:  Hold'em No Limit ($0.05/$0.10 USD) - 2021/01/23 19:45:07 ET
Table 'Lova III' 6-max Seat #1 is the button
Seat 1: Rosska(Rus) ($11 in chips) 
Seat 2: BCEM KAIOK ($10.95 in chips) 
Seat 3: No1Sparkles ($10.30 in chips) 
Seat 4: manganito17 ($10.42 in chips) 
Seat 5: hempju1ce ($23.06 in chips) 
Seat 6: alexos04 ($10.65 in chips) 
BCEM KAIOK: posts small blind $0.05
No1Sparkles: posts big blind $0.10
*** HOLE CARDS ***
manganito17: folds 
hempju1ce: folds 
alexos04: raises $0.20 to $0.30
Rosska(Rus): folds 
BCEM KAIOK: raises $0.60 to $0.90
No1Sparkles: folds 
alexos04: folds 
Uncalled bet ($0.60) returned to BCEM KAIOK
BCEM KAIOK collected $0.70 from pot
BCEM KAIOK: doesn't show hand 
*** SUMMARY ***
Total pot $0.70 | Rake $0 
Seat 1: Rosska(Rus) (button) folded before Flop (didn't bet)
Seat 2: BCEM KAIOK (small blind) collected ($0.70)
Seat 3: No1Sparkles (big blind) folded before Flop
Seat 4: manganito17 folded before Flop (didn't bet)
Seat 5: hempju1ce folded before Flop (didn't bet)
Seat 6: alexos04 folded before Flop



PokerStars Hand #222980384399:  Hold'em No Limit ($0.05/$0.10 USD) - 2021/01/23 19:45:40 ET
Table 'Lova III' 6-max Seat #2 is the button
Seat 1: Rosska(Rus) ($11 in chips) 
Seat 2: BCEM KAIOK ($11.35 in chips) 
Seat 3: No1Sparkles ($10.20 in chips) 
Seat 4: manganito17 ($10.42 in chips) 
Seat 5: hempju1ce ($23.06 in chips) 
Seat 6: alexos04 ($10.35 in chips) 
No1Sparkles: posts small blind $0.05
manganito17: posts big blind $0.10
*** HOLE CARDS ***
hempju1ce: folds 
alexos04: folds 
Rosska(Rus): folds 
BCEM KAIOK: folds 
No1Sparkles: folds 
Uncalled bet ($0.05) returned to manganito17
manganito17 collected $0.10 from pot
manganito17: doesn't show hand 
*** SUMMARY ***
Total pot $0.10 | Rake $0 
Seat 1: Rosska(Rus) folded before Flop (didn't bet)
Seat 2: BCEM KAIOK (button) folded before Flop (didn't bet)
Seat 3: No1Sparkles (small blind) folded before Flop
Seat 4: manganito17 (big blind) collected ($0.10)
Seat 5: hempju1ce folded before Flop (didn't bet)
Seat 6: alexos04 folded before Flop (didn't bet)



PokerStars Hand #222980390848:  Hold'em No Limit ($0.05/$0.10 USD) - 2021/01/23 19:45:53 ET
Table 'Lova III' 6-max Seat #3 is the button
Seat 1: Rosska(Rus) ($11 in chips) 
Seat 2: BCEM KAIOK ($11.35 in chips) 
Seat 3: No1Sparkles ($10.15 in chips) 
Seat 4: manganito17 ($10.47 in chips) 
Seat 5: hempju1ce ($23.06 in chips) 
Seat 6: alexos04 ($10.35 in chips) 
manganito17: posts small blind $0.05
hempju1ce: posts big blind $0.10
*** HOLE CARDS ***
alexos04: folds 
Rosska(Rus): folds 
BCEM KAIOK: raises $0.20 to $0.30
No1Sparkles: folds 
manganito17: folds 
hempju1ce: calls $0.20
*** FLOP *** [5s 4d 8d]
hempju1ce: checks 
BCEM KAIOK: checks 
*** TURN *** [5s 4d 8d] [Js]
hempju1ce: bets $0.40
BCEM KAIOK: raises $0.60 to $1
hempju1ce: calls $0.60
*** RIVER *** [5s 4d 8d Js] [2d]
hempju1ce: bets $1.30
BCEM KAIOK: raises $8.75 to $10.05 and is all-in
hempju1ce: folds 
Uncalled bet ($8.75) returned to BCEM KAIOK
BCEM KAIOK collected $5.01 from pot
BCEM KAIOK: doesn't show hand 
*** SUMMARY ***
Total pot $5.25 | Rake $0.24 
Board [5s 4d 8d Js 2d]
Seat 1: Rosska(Rus) folded before Flop (didn't bet)
Seat 2: BCEM KAIOK collected ($5.01)
Seat 3: No1Sparkles (button) folded before Flop (didn't bet)
Seat 4: manganito17 (small blind) folded before Flop
Seat 5: hempju1ce (big blind) folded on the River
Seat 6: alexos04 folded before Flop (didn't bet)



PokerStars Hand #222980416207:  Hold'em No Limit ($0.05/$0.10 USD) - 2021/01/23 19:46:46 ET
Table 'Lova III' 6-max Seat #4 is the button
Seat 1: Rosska(Rus) ($11 in chips) 
Seat 2: BCEM KAIOK ($13.76 in chips) 
Seat 3: No1Sparkles ($10.15 in chips) 
Seat 4: manganito17 ($10.42 in chips) 
Seat 5: hempju1ce ($20.46 in chips) 
Seat 6: alexos04 ($10.35 in chips) 
hempju1ce: posts small blind $0.05
alexos04: posts big blind $0.10
*** HOLE CARDS ***
Rosska(Rus): folds 
BCEM KAIOK: folds 
No1Sparkles: folds 
manganito17: raises $0.20 to $0.30
hempju1ce: folds 
alexos04: folds 
Uncalled bet ($0.20) returned to manganito17
manganito17 collected $0.25 from pot
manganito17: doesn't show hand 
*** SUMMARY ***
Total pot $0.25 | Rake $0 
Seat 1: Rosska(Rus) folded before Flop (didn't bet)
Seat 2: BCEM KAIOK folded before Flop (didn't bet)
Seat 3: No1Sparkles folded before Flop (didn't bet)
Seat 4: manganito17 (button) collected ($0.25)
Seat 5: hempju1ce (small blind) folded before Flop
Seat 6: alexos04 (big blind) folded before Flop



PokerStars Hand #222980431423:  Hold'em No Limit ($0.05/$0.10 USD) - 2021/01/23 19:47:11 ET
Table 'Lova III' 6-max Seat #5 is the button
Seat 1: Rosska(Rus) ($11 in chips) 
Seat 2: BCEM KAIOK ($13.76 in chips) 
Seat 3: No1Sparkles ($10.15 in chips) 
Seat 4: manganito17 ($10.57 in chips) 
Seat 5: hempju1ce ($20.41 in chips) 
Seat 6: alexos04 ($10.25 in chips) 
alexos04: posts small blind $0.05
Rosska(Rus): posts big blind $0.10
*** HOLE CARDS ***
BCEM KAIOK: folds 
No1Sparkles: raises $0.20 to $0.30
manganito17: folds 
hempju1ce: calls $0.30
alexos04: folds 
Rosska(Rus): folds 
*** FLOP *** [3s Kd 7c]
No1Sparkles: checks 
hempju1ce: checks 
*** TURN *** [3s Kd 7c] [8d]
No1Sparkles: checks 
hempju1ce: checks 
*** RIVER *** [3s Kd 7c 8d] [Jc]
No1Sparkles: bets $0.36
hempju1ce: calls $0.36
*** SHOW DOWN ***
No1Sparkles: shows [Jh Qc] (a pair of Jacks)
hempju1ce: shows [Js Qs] (a pair of Jacks)
No1Sparkles collected $0.70 from pot
hempju1ce collected $0.70 from pot
*** SUMMARY ***
Total pot $1.47 | Rake $0.07 
Board [3s Kd 7c 8d Jc]
Seat 1: Rosska(Rus) (big blind) folded before Flop
Seat 2: BCEM KAIOK folded before Flop (didn't bet)
Seat 3: No1Sparkles showed [Jh Qc] and won ($0.70) with a pair of Jacks
Seat 4: manganito17 folded before Flop (didn't bet)
Seat 5: hempju1ce (button) showed [Js Qs] and won ($0.70) with a pair of Jacks
Seat 6: alexos04 (small blind) folded before Flop



PokerStars Hand #222980456122:  Hold'em No Limit ($0.05/$0.10 USD) - 2021/01/23 19:47:45 ET
Table 'Lova III' 6-max Seat #6 is the button
Seat 1: Rosska(Rus) ($10.90 in chips) 
Seat 2: BCEM KAIOK ($13.76 in chips) 
Seat 3: No1Sparkles ($10.19 in chips) 
Seat 4: manganito17 ($10.57 in chips) 
Seat 5: hempju1ce ($20.45 in chips) 
Seat 6: alexos04 ($10.20 in chips) 
Rosska(Rus): posts small blind $0.05
BCEM KAIOK: posts big blind $0.10
*** HOLE CARDS ***
No1Sparkles: folds 
manganito17: folds 
hempju1ce: folds 
alexos04: folds 
Rosska(Rus): folds 
Uncalled bet ($0.05) returned to BCEM KAIOK
BCEM KAIOK collected $0.10 from pot
BCEM KAIOK: doesn't show hand 
*** SUMMARY ***
Total pot $0.10 | Rake $0 
Seat 1: Rosska(Rus) (small blind) folded before Flop
Seat 2: BCEM KAIOK (big blind) collected ($0.10)
Seat 3: No1Sparkles folded before Flop (didn't bet)
Seat 4: manganito17 folded before Flop (didn't bet)
Seat 5: hempju1ce folded before Flop (didn't bet)
Seat 6: alexos04 (button) folded before Flop (didn't bet)



PokerStars Hand #222980463040:  Hold'em No Limit ($0.05/$0.10 USD) - 2021/01/23 19:47:59 ET
Table 'Lova III' 6-max Seat #1 is the button
Seat 1: Rosska(Rus) ($10.85 in chips) 
Seat 2: BCEM KAIOK ($13.81 in chips) 
Seat 3: No1Sparkles ($10.19 in chips) 
Seat 4: manganito17 ($10.57 in chips) 
Seat 5: hempju1ce ($20.45 in chips) 
Seat 6: alexos04 ($10.20 in chips) 
BCEM KAIOK: posts small blind $0.05
No1Sparkles: posts big blind $0.10
*** HOLE CARDS ***
manganito17: folds 
hempju1ce has timed out
hempju1ce: folds 
alexos04: folds 
Rosska(Rus): folds 
BCEM KAIOK: folds 
Uncalled bet ($0.05) returned to No1Sparkles
No1Sparkles collected $0.10 from pot
No1Sparkles: doesn't show hand 
*** SUMMARY ***
Total pot $0.10 | Rake $0 
Seat 1: Rosska(Rus) (button) folded before Flop (didn't bet)
Seat 2: BCEM KAIOK (small blind) folded before Flop
Seat 3: No1Sparkles (big blind) collected ($0.10)
Seat 4: manganito17 folded before Flop (didn't bet)
Seat 5: hempju1ce folded before Flop (didn't bet)
Seat 6: alexos04 folded before Flop (didn't bet)



PokerStars Hand #222980473851:  Hold'em No Limit ($0.05/$0.10 USD) - 2021/01/23 19:48:22 ET
Table 'Lova III' 6-max Seat #2 is the button
Seat 1: Rosska(Rus) ($10.85 in chips) 
Seat 2: BCEM KAIOK ($13.76 in chips) 
Seat 3: No1Sparkles ($10.24 in chips) 
Seat 4: manganito17 ($10.57 in chips) 
Seat 5: hempju1ce ($20.45 in chips) 
Seat 6: alexos04 ($10.20 in chips) 
No1Sparkles: posts small blind $0.05
manganito17: posts big blind $0.10
*** HOLE CARDS ***
hempju1ce: calls $0.10
alexos04: folds 
Rosska(Rus): raises $0.30 to $0.40
BCEM KAIOK: folds 
No1Sparkles: folds 
manganito17: folds 
hempju1ce: calls $0.30
*** FLOP *** [7s Qc 2d]
hempju1ce: checks 
Rosska(Rus): bets $0.70
hempju1ce: raises $1.40 to $2.10
Rosska(Rus): folds 
Uncalled bet ($1.40) returned to hempju1ce
hempju1ce collected $2.24 from pot
hempju1ce: doesn't show hand 
*** SUMMARY ***
Total pot $2.35 | Rake $0.11 
Board [7s Qc 2d]
Seat 1: Rosska(Rus) folded on the Flop
Seat 2: BCEM KAIOK (button) folded before Flop (didn't bet)
Seat 3: No1Sparkles (small blind) folded before Flop
Seat 4: manganito17 (big blind) folded before Flop
Seat 5: hempju1ce collected ($2.24)
Seat 6: alexos04 folded before Flop (didn't bet)



PokerStars Hand #222980497305:  Hold'em No Limit ($0.05/$0.10 USD) - 2021/01/23 19:49:10 ET
Table 'Lova III' 6-max Seat #3 is the button
Seat 1: Rosska(Rus) ($10 in chips) 
Seat 2: BCEM KAIOK ($13.76 in chips) 
Seat 3: No1Sparkles ($10.19 in chips) 
Seat 4: manganito17 ($10.47 in chips) 
Seat 5: hempju1ce ($21.59 in chips) 
Seat 6: alexos04 ($10.20 in chips) 
manganito17: posts small blind $0.05
hempju1ce: posts big blind $0.10
*** HOLE CARDS ***
alexos04: folds 
Rosska(Rus): folds 
BCEM KAIOK: folds 
No1Sparkles: raises $0.20 to $0.30
manganito17: folds 
hempju1ce: calls $0.20
*** FLOP *** [Qs 9s Jd]
hempju1ce: bets $0.50
No1Sparkles: folds 
Uncalled bet ($0.50) returned to hempju1ce
hempju1ce collected $0.62 from pot
hempju1ce: doesn't show hand 
*** SUMMARY ***
Total pot $0.65 | Rake $0.03 
Board [Qs 9s Jd]
Seat 1: Rosska(Rus) folded before Flop (didn't bet)
Seat 2: BCEM KAIOK folded before Flop (didn't bet)
Seat 3: No1Sparkles (button) folded on the Flop
Seat 4: manganito17 (small blind) folded before Flop
Seat 5: hempju1ce (big blind) collected ($0.62)
Seat 6: alexos04 folded before Flop (didn't bet)



PokerStars Hand #222980509595:  Hold'em No Limit ($0.05/$0.10 USD) - 2021/01/23 19:49:36 ET
Table 'Lova III' 6-max Seat #4 is the button
Seat 1: Rosska(Rus) ($10 in chips) 
Seat 2: BCEM KAIOK ($13.76 in chips) 
Seat 3: No1Sparkles ($10 in chips) 
Seat 4: manganito17 ($10.42 in chips) 
Seat 5: hempju1ce ($21.91 in chips) 
Seat 6: alexos04 ($10.20 in chips) 
hempju1ce: posts small blind $0.05
alexos04: posts big blind $0.10
*** HOLE CARDS ***
Rosska(Rus): raises $0.20 to $0.30
BCEM KAIOK: folds 
No1Sparkles: folds 
manganito17: folds 
hempju1ce: folds 
alexos04: folds 
Uncalled bet ($0.20) returned to Rosska(Rus)
Rosska(Rus) collected $0.25 from pot
Rosska(Rus): doesn't show hand 
*** SUMMARY ***
Total pot $0.25 | Rake $0 
Seat 1: Rosska(Rus) collected ($0.25)
Seat 2: BCEM KAIOK folded before Flop (didn't bet)
Seat 3: No1Sparkles folded before Flop (didn't bet)
Seat 4: manganito17 (button) folded before Flop (didn't bet)
Seat 5: hempju1ce (small blind) folded before Flop
Seat 6: alexos04 (big blind) folded before Flop



PokerStars Hand #222980524137:  Hold'em No Limit ($0.05/$0.10 USD) - 2021/01/23 19:50:07 ET
Table 'Lova III' 6-max Seat #5 is the button
Seat 1: Rosska(Rus) ($10.15 in chips) 
Seat 2: BCEM KAIOK ($13.76 in chips) 
Seat 3: No1Sparkles ($10 in chips) 
Seat 4: manganito17 ($10.42 in chips) 
Seat 5: hempju1ce ($21.86 in chips) 
Seat 6: alexos04 ($10.10 in chips) 
alexos04: posts small blind $0.05
Rosska(Rus): posts big blind $0.10
*** HOLE CARDS ***
BCEM KAIOK: folds 
No1Sparkles: folds 
manganito17: folds 
hempju1ce: raises $0.20 to $0.30
alexos04: folds 
Rosska(Rus): folds 
Uncalled bet ($0.20) returned to hempju1ce
hempju1ce collected $0.25 from pot
hempju1ce: doesn't show hand 
*** SUMMARY ***
Total pot $0.25 | Rake $0 
Seat 1: Rosska(Rus) (big blind) folded before Flop
Seat 2: BCEM KAIOK folded before Flop (didn't bet)
Seat 3: No1Sparkles folded before Flop (didn't bet)
Seat 4: manganito17 folded before Flop (didn't bet)
Seat 5: hempju1ce (button) collected ($0.25)
Seat 6: alexos04 (small blind) folded before Flop



PokerStars Hand #222980533623:  Hold'em No Limit ($0.05/$0.10 USD) - 2021/01/23 19:50:27 ET
Table 'Lova III' 6-max Seat #6 is the button
Seat 1: Rosska(Rus) ($10.05 in chips) 
Seat 2: BCEM KAIOK ($13.76 in chips) 
Seat 3: No1Sparkles ($10 in chips) 
Seat 4: manganito17 ($10.42 in chips) 
Seat 5: hempju1ce ($22.01 in chips) 
Seat 6: alexos04 ($10.05 in chips) 
Rosska(Rus): posts small blind $0.05
BCEM KAIOK: posts big blind $0.10
*** HOLE CARDS ***
No1Sparkles: folds 
manganito17: folds 
hempju1ce: folds 
alexos04: raises $0.20 to $0.30
Rosska(Rus): folds 
BCEM KAIOK: folds 
Uncalled bet ($0.20) returned to alexos04
alexos04 collected $0.25 from pot
alexos04: doesn't show hand 
*** SUMMARY ***
Total pot $0.25 | Rake $0 
Seat 1: Rosska(Rus) (small blind) folded before Flop
Seat 2: BCEM KAIOK (big blind) folded before Flop
Seat 3: No1Sparkles folded before Flop (didn't bet)
Seat 4: manganito17 folded before Flop (didn't bet)
Seat 5: hempju1ce folded before Flop (didn't bet)
Seat 6: alexos04 (button) collected ($0.25)



PokerStars Hand #222980539524:  Hold'em No Limit ($0.05/$0.10 USD) - 2021/01/23 19:50:39 ET
Table 'Lova III' 6-max Seat #1 is the button
Seat 1: Rosska(Rus) ($10 in chips) 
Seat 2: BCEM KAIOK ($13.66 in chips) 
Seat 3: No1Sparkles ($10 in chips) 
Seat 4: manganito17 ($10.42 in chips) 
Seat 5: hempju1ce ($22.01 in chips) 
Seat 6: alexos04 ($10.20 in chips) 
BCEM KAIOK: posts small blind $0.05
No1Sparkles: posts big blind $0.10
*** HOLE CARDS ***
manganito17: folds 
hempju1ce: folds 
alexos04: folds 
Rosska(Rus): folds 
BCEM KAIOK: raises $0.20 to $0.30
No1Sparkles: folds 
Uncalled bet ($0.20) returned to BCEM KAIOK
BCEM KAIOK collected $0.20 from pot
BCEM KAIOK: doesn't show hand 
*** SUMMARY ***
Total pot $0.20 | Rake $0 
Seat 1: Rosska(Rus) (button) folded before Flop (didn't bet)
Seat 2: BCEM KAIOK (small blind) collected ($0.20)
Seat 3: No1Sparkles (big blind) folded before Flop
Seat 4: manganito17 folded before Flop (didn't bet)
Seat 5: hempju1ce folded before Flop (didn't bet)
Seat 6: alexos04 folded before Flop (didn't bet)



PokerStars Hand #222980548755:  Hold'em No Limit ($0.05/$0.10 USD) - 2021/01/23 19:50:59 ET
Table 'Lova III' 6-max Seat #2 is the button
Seat 1: Rosska(Rus) ($10 in chips) 
Seat 2: BCEM KAIOK ($13.76 in chips) 
Seat 3: No1Sparkles ($10 in chips) 
Seat 4: manganito17 ($10.42 in chips) 
Seat 5: hempju1ce ($22.01 in chips) 
Seat 6: alexos04 ($10.20 in chips) 
No1Sparkles: posts small blind $0.05
manganito17: posts big blind $0.10
*** HOLE CARDS ***
hempju1ce: raises $0.20 to $0.30
alexos04: folds 
Rosska(Rus): folds 
BCEM KAIOK: folds 
No1Sparkles: folds 
manganito17: folds 
Uncalled bet ($0.20) returned to hempju1ce
hempju1ce collected $0.25 from pot
hempju1ce: doesn't show hand 
*** SUMMARY ***
Total pot $0.25 | Rake $0 
Seat 1: Rosska(Rus) folded before Flop (didn't bet)
Seat 2: BCEM KAIOK (button) folded before Flop (didn't bet)
Seat 3: No1Sparkles (small blind) folded before Flop
Seat 4: manganito17 (big blind) folded before Flop
Seat 5: hempju1ce collected ($0.25)
Seat 6: alexos04 folded before Flop (didn't bet)



PokerStars Hand #222980561643:  Hold'em No Limit ($0.05/$0.10 USD) - 2021/01/23 19:51:26 ET
Table 'Lova III' 6-max Seat #3 is the button
Seat 1: Rosska(Rus) ($10 in chips) 
Seat 2: BCEM KAIOK ($13.76 in chips) 
Seat 3: No1Sparkles ($10 in chips) 
Seat 4: manganito17 ($10.32 in chips) 
Seat 5: hempju1ce ($22.16 in chips) 
Seat 6: alexos04 ($10.20 in chips) 
manganito17: posts small blind $0.05
hempju1ce: posts big blind $0.10
*** HOLE CARDS ***
alexos04: raises $0.20 to $0.30
Rosska(Rus): folds 
BCEM KAIOK: folds 
No1Sparkles: folds 
manganito17: folds 
hempju1ce: calls $0.20
*** FLOP *** [Td 5c 9s]
hempju1ce: bets $0.31
alexos04: raises $0.59 to $0.90
hempju1ce: calls $0.59
*** TURN *** [Td 5c 9s] [7h]
hempju1ce: checks 
alexos04: bets $1.20
hempju1ce: calls $1.20
*** RIVER *** [Td 5c 9s 7h] [Qh]
hempju1ce: bets $3
alexos04: folds 
Uncalled bet ($3) returned to hempju1ce
hempju1ce collected $4.63 from pot
hempju1ce: doesn't show hand 
*** SUMMARY ***
Total pot $4.85 | Rake $0.22 
Board [Td 5c 9s 7h Qh]
Seat 1: Rosska(Rus) folded before Flop (didn't bet)
Seat 2: BCEM KAIOK folded before Flop (didn't bet)
Seat 3: No1Sparkles (button) folded before Flop (didn't bet)
Seat 4: manganito17 (small blind) folded before Flop
Seat 5: hempju1ce (big blind) collected ($4.63)
Seat 6: alexos04 folded on the River



PokerStars Hand #222980599266:  Hold'em No Limit ($0.05/$0.10 USD) - 2021/01/23 19:52:46 ET
Table 'Lova III' 6-max Seat #4 is the button
Seat 1: Rosska(Rus) ($10 in chips) 
Seat 2: BCEM KAIOK ($13.76 in chips) 
Seat 3: No1Sparkles ($10 in chips) 
Seat 4: manganito17 ($10.27 in chips) 
Seat 5: hempju1ce ($24.39 in chips) 
Seat 6: alexos04 ($10 in chips) 
hempju1ce: posts small blind $0.05
alexos04: posts big blind $0.10
*** HOLE CARDS ***
Rosska(Rus): folds 
BCEM KAIOK: folds 
No1Sparkles: folds 
manganito17: folds 
hempju1ce: folds 
Uncalled bet ($0.05) returned to alexos04
alexos04 collected $0.10 from pot
alexos04: doesn't show hand 
*** SUMMARY ***
Total pot $0.10 | Rake $0 
Seat 1: Rosska(Rus) folded before Flop (didn't bet)
Seat 2: BCEM KAIOK folded before Flop (didn't bet)
Seat 3: No1Sparkles folded before Flop (didn't bet)
Seat 4: manganito17 (button) folded before Flop (didn't bet)
Seat 5: hempju1ce (small blind) folded before Flop
Seat 6: alexos04 (big blind) collected ($0.10)



PokerStars Hand #222980606589:  Hold'em No Limit ($0.05/$0.10 USD) - 2021/01/23 19:53:01 ET
Table 'Lova III' 6-max Seat #5 is the button
Seat 1: Rosska(Rus) ($10 in chips) 
Seat 2: BCEM KAIOK ($13.76 in chips) 
Seat 3: No1Sparkles ($10 in chips) 
Seat 4: manganito17 ($10.27 in chips) 
Seat 5: hempju1ce ($24.34 in chips) 
Seat 6: alexos04 ($10.05 in chips) 
alexos04: posts small blind $0.05
Rosska(Rus): posts big blind $0.10
*** HOLE CARDS ***
BCEM KAIOK: folds 
No1Sparkles: folds 
manganito17: raises $0.15 to $0.25
hempju1ce: folds 
alexos04: folds 
Rosska(Rus): calls $0.15
*** FLOP *** [Qh Tc Jd]
Rosska(Rus): checks 
manganito17: bets $0.40
Rosska(Rus): calls $0.40
*** TURN *** [Qh Tc Jd] [9c]
Rosska(Rus): checks 
manganito17: bets $1.94
Rosska(Rus): folds 
Uncalled bet ($1.94) returned to manganito17
manganito17 collected $1.29 from pot
manganito17: doesn't show hand 
*** SUMMARY ***
Total pot $1.35 | Rake $0.06 
Board [Qh Tc Jd 9c]
Seat 1: Rosska(Rus) (big blind) folded on the Turn
Seat 2: BCEM KAIOK folded before Flop (didn't bet)
Seat 3: No1Sparkles folded before Flop (didn't bet)
Seat 4: manganito17 collected ($1.29)
Seat 5: hempju1ce (button) folded before Flop (didn't bet)
Seat 6: alexos04 (small blind) folded before Flop



PokerStars Hand #222980630937:  Hold'em No Limit ($0.05/$0.10 USD) - 2021/01/23 19:53:53 ET
Table 'Lova III' 6-max Seat #6 is the button
Seat 1: Rosska(Rus) ($10 in chips) 
Seat 2: BCEM KAIOK ($13.76 in chips) 
Seat 3: No1Sparkles ($10 in chips) 
Seat 4: manganito17 ($10.91 in chips) 
Seat 5: hempju1ce ($24.34 in chips) 
Seat 6: alexos04 ($10 in chips) 
Rosska(Rus): posts small blind $0.05
BCEM KAIOK: posts big blind $0.10
*** HOLE CARDS ***
No1Sparkles: folds 
manganito17: folds 
hempju1ce: folds 
alexos04: raises $0.20 to $0.30
Rosska(Rus): folds 
BCEM KAIOK: folds 
Uncalled bet ($0.20) returned to alexos04
alexos04 collected $0.25 from pot
alexos04: doesn't show hand 
*** SUMMARY ***
Total pot $0.25 | Rake $0 
Seat 1: Rosska(Rus) (small blind) folded before Flop
Seat 2: BCEM KAIOK (big blind) folded before Flop
Seat 3: No1Sparkles folded before Flop (didn't bet)
Seat 4: manganito17 folded before Flop (didn't bet)
Seat 5: hempju1ce folded before Flop (didn't bet)
Seat 6: alexos04 (button) collected ($0.25)



PokerStars Hand #222980637185:  Hold'em No Limit ($0.05/$0.10 USD) - 2021/01/23 19:54:06 ET
Table 'Lova III' 6-max Seat #1 is the button
Seat 1: Rosska(Rus) ($10 in chips) 
Seat 2: BCEM KAIOK ($13.66 in chips) 
Seat 3: No1Sparkles ($10 in chips) 
Seat 4: manganito17 ($10.91 in chips) 
Seat 5: hempju1ce ($24.34 in chips) 
Seat 6: alexos04 ($10.15 in chips) 
BCEM KAIOK: posts small blind $0.05
No1Sparkles: posts big blind $0.10
*** HOLE CARDS ***
manganito17 has timed out
manganito17: folds 
hempju1ce: folds 
alexos04: folds 
Rosska(Rus): folds 
BCEM KAIOK: raises $0.20 to $0.30
No1Sparkles: folds 
Uncalled bet ($0.20) returned to BCEM KAIOK
BCEM KAIOK collected $0.20 from pot
BCEM KAIOK: doesn't show hand 
*** SUMMARY ***
Total pot $0.20 | Rake $0 
Seat 1: Rosska(Rus) (button) folded before Flop (didn't bet)
Seat 2: BCEM KAIOK (small blind) collected ($0.20)
Seat 3: No1Sparkles (big blind) folded before Flop
Seat 4: manganito17 folded before Flop (didn't bet)
Seat 5: hempju1ce folded before Flop (didn't bet)
Seat 6: alexos04 folded before Flop (didn't bet)



PokerStars Hand #222980652204:  Hold'em No Limit ($0.05/$0.10 USD) - 2021/01/23 19:54:38 ET
Table 'Lova III' 6-max Seat #2 is the button
Seat 1: Rosska(Rus) ($10 in chips) 
Seat 2: BCEM KAIOK ($13.76 in chips) 
Seat 3: No1Sparkles ($10 in chips) 
Seat 4: manganito17 ($10.91 in chips) 
Seat 5: hempju1ce ($24.34 in chips) 
Seat 6: alexos04 ($10.15 in chips) 
No1Sparkles: posts small blind $0.05
manganito17: posts big blind $0.10
*** HOLE CARDS ***
hempju1ce: raises $0.20 to $0.30
alexos04: folds 
Rosska(Rus): folds 
BCEM KAIOK: folds 
No1Sparkles: folds 
manganito17: folds 
Uncalled bet ($0.20) returned to hempju1ce
hempju1ce collected $0.25 from pot
hempju1ce: doesn't show hand 
*** SUMMARY ***
Total pot $0.25 | Rake $0 
Seat 1: Rosska(Rus) folded before Flop (didn't bet)
Seat 2: BCEM KAIOK (button) folded before Flop (didn't bet)
Seat 3: No1Sparkles (small blind) folded before Flop
Seat 4: manganito17 (big blind) folded before Flop
Seat 5: hempju1ce collected ($0.25)
Seat 6: alexos04 folded before Flop (didn't bet)



PokerStars Hand #222980661486:  Hold'em No Limit ($0.05/$0.10 USD) - 2021/01/23 19:54:59 ET
Table 'Lova III' 6-max Seat #3 is the button
Seat 1: Rosska(Rus) ($10 in chips) 
Seat 2: BCEM KAIOK ($13.76 in chips) 
Seat 3: No1Sparkles ($10 in chips) 
Seat 4: manganito17 ($10.81 in chips) 
Seat 5: hempju1ce ($24.49 in chips) 
Seat 6: alexos04 ($10.15 in chips) 
manganito17: posts small blind $0.05
hempju1ce: posts big blind $0.10
*** HOLE CARDS ***
alexos04: folds 
Rosska(Rus): folds 
BCEM KAIOK: folds 
No1Sparkles: raises $0.20 to $0.30
manganito17: raises $0.70 to $1
hempju1ce: folds 
No1Sparkles: folds 
Uncalled bet ($0.70) returned to manganito17
manganito17 collected $0.70 from pot
manganito17: doesn't show hand 
*** SUMMARY ***
Total pot $0.70 | Rake $0 
Seat 1: Rosska(Rus) folded before Flop (didn't bet)
Seat 2: BCEM KAIOK folded before Flop (didn't bet)
Seat 3: No1Sparkles (button) folded before Flop
Seat 4: manganito17 (small blind) collected ($0.70)
Seat 5: hempju1ce (big blind) folded before Flop
Seat 6: alexos04 folded before Flop (didn't bet)



PokerStars Hand #222980670513:  Hold'em No Limit ($0.05/$0.10 USD) - 2021/01/23 19:55:20 ET
Table 'Lova III' 6-max Seat #4 is the button
Seat 1: Rosska(Rus) ($10 in chips) 
Seat 2: BCEM KAIOK ($13.76 in chips) 
Seat 3: No1Sparkles ($10 in chips) 
Seat 4: manganito17 ($11.21 in chips) 
Seat 5: hempju1ce ($24.39 in chips) 
Seat 6: alexos04 ($10.15 in chips) 
hempju1ce: posts small blind $0.05
alexos04: posts big blind $0.10
*** HOLE CARDS ***
Rosska(Rus): folds 
BCEM KAIOK: folds 
No1Sparkles: folds 
manganito17: raises $0.20 to $0.30
hempju1ce: calls $0.25
alexos04: calls $0.20
*** FLOP *** [Jc 8d Ac]
hempju1ce: checks 
alexos04: checks 
manganito17: bets $0.28
hempju1ce: calls $0.28
alexos04: calls $0.28
*** TURN *** [Jc 8d Ac] [Kh]
hempju1ce: checks 
alexos04: checks 
manganito17: checks 
*** RIVER *** [Jc 8d Ac Kh] [2d]
No1Sparkles was removed from the table for failing to post
No1Sparkles leaves the table
hempju1ce: bets $1.66
alexos04: folds 
manganito17: folds 
Uncalled bet ($1.66) returned to hempju1ce
hempju1ce collected $1.66 from pot
hempju1ce: doesn't show hand 
*** SUMMARY ***
Total pot $1.74 | Rake $0.08 
Board [Jc 8d Ac Kh 2d]
Seat 1: Rosska(Rus) folded before Flop (didn't bet)
Seat 2: BCEM KAIOK folded before Flop (didn't bet)
Seat 3: No1Sparkles folded before Flop (didn't bet)
Seat 4: manganito17 (button) folded on the River
Seat 5: hempju1ce (small blind) collected ($1.66)
Seat 6: alexos04 (big blind) folded on the River



PokerStars Hand #222980693047:  Hold'em No Limit ($0.05/$0.10 USD) - 2021/01/23 19:56:23 ET
Table 'Lova III' 6-max Seat #5 is the button
Seat 1: Rosska(Rus) ($10 in chips) 
Seat 4: manganito17 ($10.63 in chips) 
Seat 5: hempju1ce ($25.47 in chips) 
Seat 6: alexos04 ($10 in chips) 
alexos04: posts small blind $0.05
Rosska(Rus): posts big blind $0.10
*** HOLE CARDS ***
manganito17: folds 
hempju1ce: folds 
alexos04: folds 
Uncalled bet ($0.05) returned to Rosska(Rus)
Rosska(Rus) collected $0.10 from pot
Rosska(Rus): doesn't show hand 
*** SUMMARY ***
Total pot $0.10 | Rake $0 
Seat 1: Rosska(Rus) (big blind) collected ($0.10)
Seat 4: manganito17 folded before Flop (didn't bet)
Seat 5: hempju1ce (button) folded before Flop (didn't bet)
Seat 6: alexos04 (small blind) folded before Flop



PokerStars Hand #222980696043:  Hold'em No Limit ($0.05/$0.10 USD) - 2021/01/23 19:56:31 ET
Table 'Lova III' 6-max Seat #6 is the button
Seat 1: Rosska(Rus) ($10.05 in chips) 
Seat 4: manganito17 ($10.63 in chips) 
Seat 5: hempju1ce ($25.47 in chips) 
Seat 6: alexos04 ($10 in chips) 
Rosska(Rus): posts small blind $0.05
manganito17: posts big blind $0.10
*** HOLE CARDS ***
hempju1ce: folds 
alexos04: folds 
Rosska(Rus): raises $0.20 to $0.30
manganito17: folds 
Uncalled bet ($0.20) returned to Rosska(Rus)
Rosska(Rus) collected $0.20 from pot
Rosska(Rus): doesn't show hand 
*** SUMMARY ***
Total pot $0.20 | Rake $0 
Seat 1: Rosska(Rus) (small blind) collected ($0.20)
Seat 4: manganito17 (big blind) folded before Flop
Seat 5: hempju1ce folded before Flop (didn't bet)
Seat 6: alexos04 (button) folded before Flop (didn't bet)



PokerStars Hand #222980700698:  Hold'em No Limit ($0.05/$0.10 USD) - 2021/01/23 19:56:44 ET
Table 'Lova III' 6-max Seat #1 is the button
Seat 1: Rosska(Rus) ($10.15 in chips) 
Seat 4: manganito17 ($10.53 in chips) 
Seat 5: hempju1ce ($25.47 in chips) 
Seat 6: alexos04 ($10 in chips) 
manganito17: posts small blind $0.05
hempju1ce: posts big blind $0.10
*** HOLE CARDS ***
alexos04: folds 
Rosska(Rus): raises $0.20 to $0.30
manganito17: folds 
hempju1ce: raises $0.60 to $0.90
BCEM KAIOK leaves the table
Rosska(Rus): calls $0.60
*** FLOP *** [7c 6c 6s]
hempju1ce: bets $1.10
Rosska(Rus): calls $1.10
*** TURN *** [7c 6c 6s] [2s]
hempju1ce: bets $4
Rosska(Rus): folds 
Uncalled bet ($4) returned to hempju1ce
hempju1ce collected $3.87 from pot
hempju1ce: doesn't show hand 
*** SUMMARY ***
Total pot $4.05 | Rake $0.18 
Board [7c 6c 6s 2s]
Seat 1: Rosska(Rus) (button) folded on the Turn
Seat 4: manganito17 (small blind) folded before Flop
Seat 5: hempju1ce (big blind) collected ($3.87)
Seat 6: alexos04 folded before Flop (didn't bet)



PokerStars Hand #222980717048:  Hold'em No Limit ($0.05/$0.10 USD) - 2021/01/23 19:57:29 ET
Table 'Lova III' 6-max Seat #4 is the button
Seat 1: Rosska(Rus) ($10 in chips) 
Seat 4: manganito17 ($10.48 in chips) 
Seat 5: hempju1ce ($27.34 in chips) 
Seat 6: alexos04 ($10 in chips) 
hempju1ce: posts small blind $0.05
alexos04: posts big blind $0.10
*** HOLE CARDS ***
Rosska(Rus): raises $0.20 to $0.30
manganito17: folds 
hempju1ce: calls $0.25
alexos04: folds 
*** FLOP *** [9s 5s 6c]
hempju1ce: checks 
Rosska(Rus): checks 
*** TURN *** [9s 5s 6c] [Tc]
hempju1ce: bets $0.40
Rosska(Rus): folds 
Uncalled bet ($0.40) returned to hempju1ce
hempju1ce collected $0.67 from pot
hempju1ce: doesn't show hand 
*** SUMMARY ***
Total pot $0.70 | Rake $0.03 
Board [9s 5s 6c Tc]
Seat 1: Rosska(Rus) folded on the Turn
Seat 4: manganito17 (button) folded before Flop (didn't bet)
Seat 5: hempju1ce (small blind) collected ($0.67)
Seat 6: alexos04 (big blind) folded before Flop



PokerStars Hand #222980728452:  Hold'em No Limit ($0.05/$0.10 USD) - 2021/01/23 19:58:01 ET
Table 'Lova III' 6-max Seat #5 is the button
Seat 1: Rosska(Rus) ($10 in chips) 
Seat 4: manganito17 ($10.48 in chips) 
Seat 5: hempju1ce ($27.71 in chips) 
Seat 6: alexos04 ($10 in chips) 
alexos04: posts small blind $0.05
Rosska(Rus): posts big blind $0.10
*** HOLE CARDS ***
manganito17: raises $0.15 to $0.25
hempju1ce: folds 
alexos04: raises $0.65 to $0.90
Mammouth joins the table at seat #2 
Rosska(Rus): folds 
cwie210 joins the table at seat #3 
manganito17: raises $1.50 to $2.40
alexos04: calls $1.50
*** FLOP *** [8h 6h 7c]
alexos04: checks 
manganito17: bets $1.40
alexos04: raises $6.10 to $7.50
manganito17: folds 
Uncalled bet ($6.10) returned to alexos04
alexos04 collected $7.35 from pot
alexos04: doesn't show hand 
*** SUMMARY ***
Total pot $7.70 | Rake $0.35 
Board [8h 6h 7c]
Seat 1: Rosska(Rus) (big blind) folded before Flop
Seat 4: manganito17 folded on the Flop
Seat 5: hempju1ce (button) folded before Flop (didn't bet)
Seat 6: alexos04 (small blind) collected ($7.35)



PokerStars Hand #222980755149:  Hold'em No Limit ($0.05/$0.10 USD) - 2021/01/23 19:59:14 ET
Table 'Lova III' 6-max Seat #6 is the button
Seat 1: Rosska(Rus) ($10 in chips) 
Seat 2: Mammouth ($10 in chips) 
Seat 3: cwie210 ($8 in chips) 
Seat 4: manganito17 ($10 in chips) 
Seat 5: hempju1ce ($27.71 in chips) 
Seat 6: alexos04 ($13.55 in chips) 
Rosska(Rus): posts small blind $0.05
Mammouth: posts big blind $0.10
cwie210: posts big blind $0.10
*** HOLE CARDS ***
cwie210: checks 
manganito17: folds 
hempju1ce: folds 
alexos04: folds 
Rosska(Rus): folds 
Mammouth: checks 
*** FLOP *** [5d Ks Qs]
Mammouth: checks 
cwie210: bets $0.12
Mammouth: folds 
Uncalled bet ($0.12) returned to cwie210
cwie210 collected $0.24 from pot
cwie210: doesn't show hand 
*** SUMMARY ***
Total pot $0.25 | Rake $0.01 
Board [5d Ks Qs]
Seat 1: Rosska(Rus) (small blind) folded before Flop
Seat 2: Mammouth (big blind) folded on the Flop
Seat 3: cwie210 collected ($0.24)
Seat 4: manganito17 folded before Flop (didn't bet)
Seat 5: hempju1ce folded before Flop (didn't bet)
Seat 6: alexos04 (button) folded before Flop (didn't bet)



PokerStars Hand #222980764898:  Hold'em No Limit ($0.05/$0.10 USD) - 2021/01/23 19:59:41 ET
Table 'Lova III' 6-max Seat #1 is the button
Seat 1: Rosska(Rus) ($10 in chips) 
Seat 2: Mammouth ($10 in chips) 
Seat 3: cwie210 ($8.14 in chips) 
Seat 4: manganito17 ($10 in chips) 
Seat 5: hempju1ce ($27.71 in chips) 
Seat 6: alexos04 ($13.55 in chips) 
Mammouth: posts small blind $0.05
cwie210: posts big blind $0.10
*** HOLE CARDS ***
manganito17: raises $0.15 to $0.25
hempju1ce: calls $0.25
alexos04: folds 
Rosska(Rus): folds 
Mammouth: folds 
cwie210: folds 
*** FLOP *** [8c 8h 2h]
manganito17: checks 
hempju1ce: checks 
*** TURN *** [8c 8h 2h] [Qc]
manganito17: bets $0.47
hempju1ce: folds 
Uncalled bet ($0.47) returned to manganito17
manganito17 collected $0.62 from pot
manganito17: doesn't show hand 
*** SUMMARY ***
Total pot $0.65 | Rake $0.03 
Board [8c 8h 2h Qc]
Seat 1: Rosska(Rus) (button) folded before Flop (didn't bet)
Seat 2: Mammouth (small blind) folded before Flop
Seat 3: cwie210 (big blind) folded before Flop
Seat 4: manganito17 collected ($0.62)
Seat 5: hempju1ce folded on the Turn
Seat 6: alexos04 folded before Flop (didn't bet)



PokerStars Hand #222980778883:  Hold'em No Limit ($0.05/$0.10 USD) - 2021/01/23 20:00:18 ET
Table 'Lova III' 6-max Seat #2 is the button
Seat 1: Rosska(Rus) ($10 in chips) 
Seat 2: Mammouth ($10 in chips) 
Seat 3: cwie210 ($8.04 in chips) 
Seat 4: manganito17 ($10.37 in chips) 
Seat 5: hempju1ce ($27.46 in chips) 
Seat 6: alexos04 ($13.55 in chips) 
cwie210: posts small blind $0.05
manganito17: posts big blind $0.10
*** HOLE CARDS ***
hempju1ce: folds 
alexos04: raises $0.20 to $0.30
Rosska(Rus): raises $0.70 to $1
Mammouth: folds 
cwie210: folds 
manganito17: folds 
alexos04: calls $0.70
*** FLOP *** [Jc 4c Kc]
alexos04: checks 
Rosska(Rus): checks 
*** TURN *** [Jc 4c Kc] [7s]
alexos04: bets $1.10
Rosska(Rus): calls $1.10
*** RIVER *** [Jc 4c Kc 7s] [Ks]
alexos04: bets $2.50
Rosska(Rus): folds 
Uncalled bet ($2.50) returned to alexos04
alexos04 collected $4.15 from pot
alexos04: doesn't show hand 
*** SUMMARY ***
Total pot $4.35 | Rake $0.20 
Board [Jc 4c Kc 7s Ks]
Seat 1: Rosska(Rus) folded on the River
Seat 2: Mammouth (button) folded before Flop (didn't bet)
Seat 3: cwie210 (small blind) folded before Flop
Seat 4: manganito17 (big blind) folded before Flop
Seat 5: hempju1ce folded before Flop (didn't bet)
Seat 6: alexos04 collected ($4.15)



PokerStars Hand #222980801744:  Hold'em No Limit ($0.05/$0.10 USD) - 2021/01/23 20:01:12 ET
Table 'Lova III' 6-max Seat #3 is the button
Seat 1: Rosska(Rus) ($10 in chips) 
Seat 2: Mammouth ($10 in chips) 
Seat 3: cwie210 ($7.99 in chips) 
Seat 4: manganito17 ($10.27 in chips) 
Seat 5: hempju1ce ($27.46 in chips) 
Seat 6: alexos04 ($15.60 in chips) 
manganito17: posts small blind $0.05
hempju1ce: posts big blind $0.10
*** HOLE CARDS ***
alexos04: folds 
Rosska(Rus): folds 
Mammouth: folds 
cwie210: folds 
manganito17: raises $0.20 to $0.30
hempju1ce: raises $0.70 to $1
manganito17: folds 
Uncalled bet ($0.70) returned to hempju1ce
hempju1ce collected $0.60 from pot
hempju1ce: doesn't show hand 
*** SUMMARY ***
Total pot $0.60 | Rake $0 
Seat 1: Rosska(Rus) folded before Flop (didn't bet)
Seat 2: Mammouth folded before Flop (didn't bet)
Seat 3: cwie210 (button) folded before Flop (didn't bet)
Seat 4: manganito17 (small blind) folded before Flop
Seat 5: hempju1ce (big blind) collected ($0.60)
Seat 6: alexos04 folded before Flop (didn't bet)



PokerStars Hand #222980811246:  Hold'em No Limit ($0.05/$0.10 USD) - 2021/01/23 20:01:34 ET
Table 'Lova III' 6-max Seat #4 is the button
Seat 1: Rosska(Rus) ($10 in chips) 
Seat 2: Mammouth ($10 in chips) 
Seat 3: cwie210 ($7.99 in chips) 
Seat 4: manganito17 ($10 in chips) 
Seat 5: hempju1ce ($27.76 in chips) 
Seat 6: alexos04 ($15.60 in chips) 
hempju1ce: posts small blind $0.05
alexos04: posts big blind $0.10
*** HOLE CARDS ***
Rosska(Rus): folds 
Mammouth: raises $0.10 to $0.20
cwie210: folds 
manganito17: folds 
hempju1ce: folds 
alexos04: folds 
Uncalled bet ($0.10) returned to Mammouth
Mammouth collected $0.25 from pot
Mammouth: doesn't show hand 
*** SUMMARY ***
Total pot $0.25 | Rake $0 
Seat 1: Rosska(Rus) folded before Flop (didn't bet)
Seat 2: Mammouth collected ($0.25)
Seat 3: cwie210 folded before Flop (didn't bet)
Seat 4: manganito17 (button) folded before Flop (didn't bet)
Seat 5: hempju1ce (small blind) folded before Flop
Seat 6: alexos04 (big blind) folded before Flop



PokerStars Hand #222980824297:  Hold'em No Limit ($0.05/$0.10 USD) - 2021/01/23 20:02:03 ET
Table 'Lova III' 6-max Seat #5 is the button
Seat 1: Rosska(Rus) ($10 in chips) 
Seat 2: Mammouth ($10.15 in chips) 
Seat 3: cwie210 ($7.99 in chips) 
Seat 4: manganito17 ($10 in chips) 
Seat 5: hempju1ce ($27.71 in chips) 
Seat 6: alexos04 ($15.50 in chips) 
alexos04: posts small blind $0.05
Rosska(Rus): posts big blind $0.10
*** HOLE CARDS ***
Mammouth: folds 
cwie210: folds 
manganito17: folds 
hempju1ce: calls $0.10
alexos04: raises $0.40 to $0.50
Rosska(Rus): folds 
hempju1ce: folds 
Uncalled bet ($0.40) returned to alexos04
alexos04 collected $0.30 from pot
*** SUMMARY ***
Total pot $0.30 | Rake $0 
Seat 1: Rosska(Rus) (big blind) folded before Flop
Seat 2: Mammouth folded before Flop (didn't bet)
Seat 3: cwie210 folded before Flop (didn't bet)
Seat 4: manganito17 folded before Flop (didn't bet)
Seat 5: hempju1ce (button) folded before Flop
Seat 6: alexos04 (small blind) collected ($0.30)



PokerStars Hand #222982340566:  Hold'em No Limit ($0.05/$0.10 USD) - 2021/01/23 20:59:52 ET
Table 'Lova III' 6-max Seat #2 is the button
Seat 1: DontSleep111 ($10 in chips) 
Seat 2: Angie Senpai ($15.25 in chips) 
Seat 3: lucas-fmtm ($11.22 in chips) 
Seat 4: I find you ez ($10 in chips) 
Seat 5: hempju1ce ($31.34 in chips) 
Seat 6: AAAcostA ($10 in chips) 
lucas-fmtm: posts small blind $0.05
I find you ez: posts big blind $0.10
*** HOLE CARDS ***
hempju1ce: calls $0.10
AAAcostA: folds 
DontSleep111: folds 
Angie Senpai: folds 
lucas-fmtm: folds 
I find you ez: checks 
*** FLOP *** [6d 2s 9h]
I find you ez: bets $0.15
hempju1ce: calls $0.15
*** TURN *** [6d 2s 9h] [4d]
I find you ez: bets $0.35
hempju1ce: calls $0.35
*** RIVER *** [6d 2s 9h 4d] [9s]
I find you ez: bets $0.60
hempju1ce: raises $1.40 to $2
I find you ez: folds 
Uncalled bet ($1.40) returned to hempju1ce
hempju1ce collected $2.34 from pot
hempju1ce: doesn't show hand 
*** SUMMARY ***
Total pot $2.45 | Rake $0.11 
Board [6d 2s 9h 4d 9s]
Seat 1: DontSleep111 folded before Flop (didn't bet)
Seat 2: Angie Senpai (button) folded before Flop (didn't bet)
Seat 3: lucas-fmtm (small blind) folded before Flop
Seat 4: I find you ez (big blind) folded on the River
Seat 5: hempju1ce collected ($2.34)
Seat 6: AAAcostA folded before Flop (didn't bet)



PokerStars Hand #222982356533:  Hold'em No Limit ($0.05/$0.10 USD) - 2021/01/23 21:00:38 ET
Table 'Lova III' 6-max Seat #3 is the button
Seat 1: DontSleep111 ($10 in chips) 
Seat 2: Angie Senpai ($15.25 in chips) 
Seat 3: lucas-fmtm ($11.17 in chips) 
Seat 4: I find you ez ($10 in chips) 
Seat 5: hempju1ce ($32.48 in chips) 
Seat 6: AAAcostA ($10 in chips) 
I find you ez: posts small blind $0.05
hempju1ce: posts big blind $0.10
*** HOLE CARDS ***
AAAcostA: folds 
DontSleep111: folds 
Angie Senpai: raises $0.18 to $0.28
lucas-fmtm: folds 
I find you ez: calls $0.23
hempju1ce: folds 
*** FLOP *** [Qs Th Kd]
I find you ez: checks 
Angie Senpai: checks 
*** TURN *** [Qs Th Kd] [5h]
I find you ez: bets $0.40
Angie Senpai: calls $0.40
*** RIVER *** [Qs Th Kd 5h] [2h]
I find you ez: bets $0.95
Angie Senpai: raises $3.55 to $4.50
I find you ez: calls $3.55
*** SHOW DOWN ***
Angie Senpai: shows [8h Qh] (a flush, Queen high)
I find you ez: mucks hand 
Angie Senpai collected $9.99 from pot
*** SUMMARY ***
Total pot $10.46 | Rake $0.47 
Board [Qs Th Kd 5h 2h]
Seat 1: DontSleep111 folded before Flop (didn't bet)
Seat 2: Angie Senpai showed [8h Qh] and won ($9.99) with a flush, Queen high
Seat 3: lucas-fmtm (button) folded before Flop (didn't bet)
Seat 4: I find you ez (small blind) mucked
Seat 5: hempju1ce (big blind) folded before Flop
Seat 6: AAAcostA folded before Flop (didn't bet)



PokerStars Hand #222982396926:  Hold'em No Limit ($0.05/$0.10 USD) - 2021/01/23 21:01:44 ET
Table 'Lova III' 6-max Seat #4 is the button
Seat 1: DontSleep111 ($10 in chips) 
Seat 2: Angie Senpai ($20.06 in chips) 
Seat 3: lucas-fmtm ($11.17 in chips) 
Seat 4: I find you ez ($10 in chips) 
Seat 5: hempju1ce ($32.38 in chips) 
Seat 6: AAAcostA ($10 in chips) 
hempju1ce: posts small blind $0.05
AAAcostA: posts big blind $0.10
*** HOLE CARDS ***
DontSleep111: folds 
Angie Senpai: folds 
lucas-fmtm: folds 
I find you ez: folds 
hempju1ce: calls $0.05
AAAcostA: checks 
*** FLOP *** [Qh 4d 8d]
hempju1ce: checks 
AAAcostA: checks 
*** TURN *** [Qh 4d 8d] [5s]
hempju1ce: checks 
AAAcostA: checks 
*** RIVER *** [Qh 4d 8d 5s] [8c]
hempju1ce: bets $0.19
AAAcostA: folds 
Uncalled bet ($0.19) returned to hempju1ce
hempju1ce collected $0.19 from pot
hempju1ce: doesn't show hand 
*** SUMMARY ***
Total pot $0.20 | Rake $0.01 
Board [Qh 4d 8d 5s 8c]
Seat 1: DontSleep111 folded before Flop (didn't bet)
Seat 2: Angie Senpai folded before Flop (didn't bet)
Seat 3: lucas-fmtm folded before Flop (didn't bet)
Seat 4: I find you ez (button) folded before Flop (didn't bet)
Seat 5: hempju1ce (small blind) collected ($0.19)
Seat 6: AAAcostA (big blind) folded on the River



PokerStars Hand #222982410494:  Hold'em No Limit ($0.05/$0.10 USD) - 2021/01/23 21:02:16 ET
Table 'Lova III' 6-max Seat #5 is the button
Seat 1: DontSleep111 ($10 in chips) 
Seat 2: Angie Senpai ($20.06 in chips) 
Seat 3: lucas-fmtm ($11.17 in chips) 
Seat 4: I find you ez ($10 in chips) 
Seat 5: hempju1ce ($32.47 in chips) 
Seat 6: AAAcostA ($10 in chips) 
AAAcostA: posts small blind $0.05
DontSleep111: posts big blind $0.10
*** HOLE CARDS ***
Angie Senpai: folds 
lucas-fmtm: folds 
I find you ez: folds 
hempju1ce: folds 
AAAcostA: folds 
Uncalled bet ($0.05) returned to DontSleep111
DontSleep111 collected $0.10 from pot
DontSleep111: doesn't show hand 
*** SUMMARY ***
Total pot $0.10 | Rake $0 
Seat 1: DontSleep111 (big blind) collected ($0.10)
Seat 2: Angie Senpai folded before Flop (didn't bet)
Seat 3: lucas-fmtm folded before Flop (didn't bet)
Seat 4: I find you ez folded before Flop (didn't bet)
Seat 5: hempju1ce (button) folded before Flop (didn't bet)
Seat 6: AAAcostA (small blind) folded before Flop



PokerStars Hand #222982416395:  Hold'em No Limit ($0.05/$0.10 USD) - 2021/01/23 21:02:31 ET
Table 'Lova III' 6-max Seat #6 is the button
Seat 1: DontSleep111 ($10.05 in chips) 
Seat 2: Angie Senpai ($20.06 in chips) 
Seat 3: lucas-fmtm ($11.17 in chips) 
Seat 4: I find you ez ($10 in chips) 
Seat 5: hempju1ce ($32.47 in chips) 
Seat 6: AAAcostA ($10 in chips) 
DontSleep111: posts small blind $0.05
Angie Senpai: posts big blind $0.10
*** HOLE CARDS ***
lucas-fmtm: folds 
I find you ez: folds 
hempju1ce: folds 
AAAcostA: folds 
DontSleep111: folds 
Uncalled bet ($0.05) returned to Angie Senpai
Angie Senpai collected $0.10 from pot
Angie Senpai: doesn't show hand 
*** SUMMARY ***
Total pot $0.10 | Rake $0 
Seat 1: DontSleep111 (small blind) folded before Flop
Seat 2: Angie Senpai (big blind) collected ($0.10)
Seat 3: lucas-fmtm folded before Flop (didn't bet)
Seat 4: I find you ez folded before Flop (didn't bet)
Seat 5: hempju1ce folded before Flop (didn't bet)
Seat 6: AAAcostA (button) folded before Flop (didn't bet)



PokerStars Hand #222982421037:  Hold'em No Limit ($0.05/$0.10 USD) - 2021/01/23 21:02:42 ET
Table 'Lova III' 6-max Seat #1 is the button
Seat 1: DontSleep111 ($10 in chips) 
Seat 2: Angie Senpai ($20.11 in chips) 
Seat 3: lucas-fmtm ($11.17 in chips) 
Seat 4: I find you ez ($10 in chips) 
Seat 5: hempju1ce ($32.47 in chips) 
Seat 6: AAAcostA ($10 in chips) 
Angie Senpai: posts small blind $0.05
lucas-fmtm: posts big blind $0.10
*** HOLE CARDS ***
I find you ez: folds 
hempju1ce: raises $0.20 to $0.30
AAAcostA: folds 
DontSleep111: folds 
Angie Senpai: folds 
lucas-fmtm: calls $0.20
*** FLOP *** [Td 7h 6c]
lucas-fmtm: checks 
hempju1ce: bets $0.31
lucas-fmtm: folds 
Uncalled bet ($0.31) returned to hempju1ce
hempju1ce collected $0.62 from pot
hempju1ce: doesn't show hand 
*** SUMMARY ***
Total pot $0.65 | Rake $0.03 
Board [Td 7h 6c]
Seat 1: DontSleep111 (button) folded before Flop (didn't bet)
Seat 2: Angie Senpai (small blind) folded before Flop
Seat 3: lucas-fmtm (big blind) folded on the Flop
Seat 4: I find you ez folded before Flop (didn't bet)
Seat 5: hempju1ce collected ($0.62)
Seat 6: AAAcostA folded before Flop (didn't bet)



PokerStars Hand #222982438425:  Hold'em No Limit ($0.05/$0.10 USD) - 2021/01/23 21:03:24 ET
Table 'Lova III' 6-max Seat #2 is the button
Seat 1: DontSleep111 ($10 in chips) 
Seat 2: Angie Senpai ($20.06 in chips) 
Seat 3: lucas-fmtm ($10.87 in chips) 
Seat 4: I find you ez ($10 in chips) 
Seat 5: hempju1ce ($32.79 in chips) 
Seat 6: AAAcostA ($10 in chips) 
lucas-fmtm: posts small blind $0.05
I find you ez: posts big blind $0.10
*** HOLE CARDS ***
hempju1ce: raises $0.10 to $0.20
AAAcostA: folds 
DontSleep111: folds 
Angie Senpai: folds 
lucas-fmtm: folds 
I find you ez: calls $0.10
*** FLOP *** [3h 8d 8h]
I find you ez: checks 
hempju1ce: checks 
*** TURN *** [3h 8d 8h] [Kh]
I find you ez: bets $0.30
hempju1ce: folds 
Uncalled bet ($0.30) returned to I find you ez
I find you ez collected $0.43 from pot
I find you ez: doesn't show hand 
*** SUMMARY ***
Total pot $0.45 | Rake $0.02 
Board [3h 8d 8h Kh]
Seat 1: DontSleep111 folded before Flop (didn't bet)
Seat 2: Angie Senpai (button) folded before Flop (didn't bet)
Seat 3: lucas-fmtm (small blind) folded before Flop
Seat 4: I find you ez (big blind) collected ($0.43)
Seat 5: hempju1ce folded on the Turn
Seat 6: AAAcostA folded before Flop (didn't bet)



PokerStars Hand #222982452151:  Hold'em No Limit ($0.05/$0.10 USD) - 2021/01/23 21:03:57 ET
Table 'Lova III' 6-max Seat #3 is the button
Seat 1: DontSleep111 ($10 in chips) 
Seat 2: Angie Senpai ($20.06 in chips) 
Seat 3: lucas-fmtm ($10.82 in chips) 
Seat 4: I find you ez ($10.23 in chips) 
Seat 5: hempju1ce ($32.59 in chips) 
Seat 6: AAAcostA ($10 in chips) 
I find you ez: posts small blind $0.05
hempju1ce: posts big blind $0.10
*** HOLE CARDS ***
AAAcostA: folds 
DontSleep111: folds 
Angie Senpai: raises $0.18 to $0.28
lucas-fmtm: calls $0.28
I find you ez: folds 
hempju1ce: calls $0.18
*** FLOP *** [5c Jd 5h]
hempju1ce: bets $0.50
Angie Senpai: folds 
lucas-fmtm: folds 
Uncalled bet ($0.50) returned to hempju1ce
hempju1ce collected $0.85 from pot
hempju1ce: doesn't show hand 
*** SUMMARY ***
Total pot $0.89 | Rake $0.04 
Board [5c Jd 5h]
Seat 1: DontSleep111 folded before Flop (didn't bet)
Seat 2: Angie Senpai folded on the Flop
Seat 3: lucas-fmtm (button) folded on the Flop
Seat 4: I find you ez (small blind) folded before Flop
Seat 5: hempju1ce (big blind) collected ($0.85)
Seat 6: AAAcostA folded before Flop (didn't bet)



PokerStars Hand #222982469216:  Hold'em No Limit ($0.05/$0.10 USD) - 2021/01/23 21:04:38 ET
Table 'Lova III' 6-max Seat #4 is the button
Seat 1: DontSleep111 ($10 in chips) 
Seat 2: Angie Senpai ($19.78 in chips) 
Seat 3: lucas-fmtm ($10.54 in chips) 
Seat 4: I find you ez ($10.18 in chips) 
Seat 5: hempju1ce ($33.16 in chips) 
Seat 6: AAAcostA ($10 in chips) 
hempju1ce: posts small blind $0.05
AAAcostA: posts big blind $0.10
*** HOLE CARDS ***
DontSleep111: folds 
Angie Senpai: raises $0.18 to $0.28
lucas-fmtm: folds 
I find you ez: folds 
hempju1ce: calls $0.23
AAAcostA: folds 
*** FLOP *** [2s Td Qs]
hempju1ce: bets $0.31
Angie Senpai: calls $0.31
*** TURN *** [2s Td Qs] [Ac]
hempju1ce: checks 
Angie Senpai: bets $0.95
hempju1ce: folds 
Uncalled bet ($0.95) returned to Angie Senpai
Angie Senpai collected $1.22 from pot
Angie Senpai: doesn't show hand 
*** SUMMARY ***
Total pot $1.28 | Rake $0.06 
Board [2s Td Qs Ac]
Seat 1: DontSleep111 folded before Flop (didn't bet)
Seat 2: Angie Senpai collected ($1.22)
Seat 3: lucas-fmtm folded before Flop (didn't bet)
Seat 4: I find you ez (button) folded before Flop (didn't bet)
Seat 5: hempju1ce (small blind) folded on the Turn
Seat 6: AAAcostA (big blind) folded before Flop



PokerStars Hand #222982484363:  Hold'em No Limit ($0.05/$0.10 USD) - 2021/01/23 21:05:14 ET
Table 'Lova III' 6-max Seat #5 is the button
Seat 1: DontSleep111 ($10 in chips) 
Seat 2: Angie Senpai ($20.41 in chips) 
Seat 3: lucas-fmtm ($10.54 in chips) 
Seat 4: I find you ez ($10.18 in chips) 
Seat 5: hempju1ce ($32.57 in chips) 
Seat 6: AAAcostA ($10 in chips) 
AAAcostA: posts small blind $0.05
DontSleep111: posts big blind $0.10
*** HOLE CARDS ***
Angie Senpai: folds 
lucas-fmtm: folds 
I find you ez: raises $0.20 to $0.30
hempju1ce: calls $0.30
AAAcostA: folds 
DontSleep111: folds 
*** FLOP *** [2s 7s 3s]
I find you ez: bets $0.40
hempju1ce: folds 
Uncalled bet ($0.40) returned to I find you ez
I find you ez collected $0.72 from pot
I find you ez: doesn't show hand 
*** SUMMARY ***
Total pot $0.75 | Rake $0.03 
Board [2s 7s 3s]
Seat 1: DontSleep111 (big blind) folded before Flop
Seat 2: Angie Senpai folded before Flop (didn't bet)
Seat 3: lucas-fmtm folded before Flop (didn't bet)
Seat 4: I find you ez collected ($0.72)
Seat 5: hempju1ce (button) folded on the Flop
Seat 6: AAAcostA (small blind) folded before Flop



PokerStars Hand #222982494163:  Hold'em No Limit ($0.05/$0.10 USD) - 2021/01/23 21:05:38 ET
Table 'Lova III' 6-max Seat #6 is the button
Seat 1: DontSleep111 ($10 in chips) 
Seat 2: Angie Senpai ($20.41 in chips) 
Seat 3: lucas-fmtm ($10.54 in chips) 
Seat 4: I find you ez ($10.60 in chips) 
Seat 5: hempju1ce ($32.27 in chips) 
Seat 6: AAAcostA ($10 in chips) 
DontSleep111: posts small blind $0.05
Angie Senpai: posts big blind $0.10
*** HOLE CARDS ***
lucas-fmtm: folds 
I find you ez: folds 
hempju1ce: folds 
AAAcostA: raises $0.15 to $0.25
DontSleep111: folds 
Angie Senpai: calls $0.15
*** FLOP *** [Th 8s As]
Angie Senpai: checks 
AAAcostA: bets $0.16
Angie Senpai: raises $0.84 to $1
AAAcostA: folds 
Uncalled bet ($0.84) returned to Angie Senpai
Angie Senpai collected $0.83 from pot
Angie Senpai: doesn't show hand 
*** SUMMARY ***
Total pot $0.87 | Rake $0.04 
Board [Th 8s As]
Seat 1: DontSleep111 (small blind) folded before Flop
Seat 2: Angie Senpai (big blind) collected ($0.83)
Seat 3: lucas-fmtm folded before Flop (didn't bet)
Seat 4: I find you ez folded before Flop (didn't bet)
Seat 5: hempju1ce folded before Flop (didn't bet)
Seat 6: AAAcostA (button) folded on the Flop



PokerStars Hand #222982509439:  Hold'em No Limit ($0.05/$0.10 USD) - 2021/01/23 21:06:15 ET
Table 'Lova III' 6-max Seat #1 is the button
Seat 1: DontSleep111 ($10 in chips) 
Seat 2: Angie Senpai ($20.83 in chips) 
Seat 3: lucas-fmtm ($10.54 in chips) 
Seat 4: I find you ez ($10.60 in chips) 
Seat 5: hempju1ce ($32.27 in chips) 
Seat 6: AAAcostA ($10 in chips) 
Angie Senpai: posts small blind $0.05
lucas-fmtm: posts big blind $0.10
*** HOLE CARDS ***
I find you ez: folds 
hempju1ce: folds 
AAAcostA: folds 
DontSleep111: folds 
Angie Senpai: folds 
Uncalled bet ($0.05) returned to lucas-fmtm
lucas-fmtm collected $0.10 from pot
*** SUMMARY ***
Total pot $0.10 | Rake $0 
Seat 1: DontSleep111 (button) folded before Flop (didn't bet)
Seat 2: Angie Senpai (small blind) folded before Flop
Seat 3: lucas-fmtm (big blind) collected ($0.10)
Seat 4: I find you ez folded before Flop (didn't bet)
Seat 5: hempju1ce folded before Flop (didn't bet)
Seat 6: AAAcostA folded before Flop (didn't bet)



PokerStars Hand #222982513783:  Hold'em No Limit ($0.05/$0.10 USD) - 2021/01/23 21:06:25 ET
Table 'Lova III' 6-max Seat #2 is the button
Seat 1: DontSleep111 ($10 in chips) 
Seat 2: Angie Senpai ($20.78 in chips) 
Seat 3: lucas-fmtm ($10.59 in chips) 
Seat 4: I find you ez ($10.60 in chips) 
Seat 5: hempju1ce ($32.27 in chips) 
lucas-fmtm: posts small blind $0.05
I find you ez: posts big blind $0.10
*** HOLE CARDS ***
hempju1ce: raises $0.20 to $0.30
DontSleep111: folds 
Angie Senpai: folds 
lucas-fmtm: folds 
I find you ez: folds 
Uncalled bet ($0.20) returned to hempju1ce
hempju1ce collected $0.25 from pot
hempju1ce: doesn't show hand 
*** SUMMARY ***
Total pot $0.25 | Rake $0 
Seat 1: DontSleep111 folded before Flop (didn't bet)
Seat 2: Angie Senpai (button) folded before Flop (didn't bet)
Seat 3: lucas-fmtm (small blind) folded before Flop
Seat 4: I find you ez (big blind) folded before Flop
Seat 5: hempju1ce collected ($0.25)



PokerStars Hand #222982523024:  Hold'em No Limit ($0.05/$0.10 USD) - 2021/01/23 21:06:48 ET
Table 'Lova III' 6-max Seat #3 is the button
Seat 1: DontSleep111 ($10 in chips) 
Seat 2: Angie Senpai ($20.78 in chips) 
Seat 3: lucas-fmtm ($10.54 in chips) 
Seat 4: I find you ez ($10.50 in chips) 
Seat 5: hempju1ce ($32.42 in chips) 
I find you ez: posts small blind $0.05
hempju1ce: posts big blind $0.10
*** HOLE CARDS ***
DontSleep111: folds 
Angie Senpai: folds 
lucas-fmtm: raises $0.20 to $0.30
I find you ez: folds 
hempju1ce: raises $0.60 to $0.90
lucas-fmtm: folds 
Uncalled bet ($0.60) returned to hempju1ce
hempju1ce collected $0.65 from pot
hempju1ce: doesn't show hand 
*** SUMMARY ***
Total pot $0.65 | Rake $0 
Seat 1: DontSleep111 folded before Flop (didn't bet)
Seat 2: Angie Senpai folded before Flop (didn't bet)
Seat 3: lucas-fmtm (button) folded before Flop
Seat 4: I find you ez (small blind) folded before Flop
Seat 5: hempju1ce (big blind) collected ($0.65)



PokerStars Hand #222982533013:  Hold'em No Limit ($0.05/$0.10 USD) - 2021/01/23 21:07:12 ET
Table 'Lova III' 6-max Seat #4 is the button
Seat 1: DontSleep111 ($10 in chips) 
Seat 2: Angie Senpai ($20.78 in chips) 
Seat 3: lucas-fmtm ($10.24 in chips) 
Seat 4: I find you ez ($10.45 in chips) 
Seat 5: hempju1ce ($32.77 in chips) 
hempju1ce: posts small blind $0.05
DontSleep111: posts big blind $0.10
*** HOLE CARDS ***
Angie Senpai: folds 
lucas-fmtm: raises $0.20 to $0.30
I find you ez: folds 
hempju1ce: folds 
DontSleep111: folds 
Uncalled bet ($0.20) returned to lucas-fmtm
lucas-fmtm collected $0.25 from pot
*** SUMMARY ***
Total pot $0.25 | Rake $0 
Seat 1: DontSleep111 (big blind) folded before Flop
Seat 2: Angie Senpai folded before Flop (didn't bet)
Seat 3: lucas-fmtm collected ($0.25)
Seat 4: I find you ez (button) folded before Flop (didn't bet)
Seat 5: hempju1ce (small blind) folded before Flop



PokerStars Hand #222982541348:  Hold'em No Limit ($0.05/$0.10 USD) - 2021/01/23 21:07:32 ET
Table 'Lova III' 6-max Seat #5 is the button
Seat 1: DontSleep111 ($10 in chips) 
Seat 2: Angie Senpai ($20.78 in chips) 
Seat 3: lucas-fmtm ($10.39 in chips) 
Seat 4: I find you ez ($10.45 in chips) 
Seat 5: hempju1ce ($32.72 in chips) 
DontSleep111: posts small blind $0.05
Angie Senpai: posts big blind $0.10
*** HOLE CARDS ***
lucas-fmtm: folds 
I find you ez: raises $0.20 to $0.30
hempju1ce: folds 
DontSleep111: calls $0.25
Angie Senpai: folds 
*** FLOP *** [8d Qd 5s]
DontSleep111: checks 
I find you ez: bets $0.45
DontSleep111: calls $0.45
*** TURN *** [8d Qd 5s] [Ac]
DontSleep111: checks 
I find you ez: checks 
*** RIVER *** [8d Qd 5s Ac] [4s]
DontSleep111: bets $2.29
I find you ez: folds 
Uncalled bet ($2.29) returned to DontSleep111
DontSleep111 collected $1.53 from pot
DontSleep111: doesn't show hand 
*** SUMMARY ***
Total pot $1.60 | Rake $0.07 
Board [8d Qd 5s Ac 4s]
Seat 1: DontSleep111 (small blind) collected ($1.53)
Seat 2: Angie Senpai (big blind) folded before Flop
Seat 3: lucas-fmtm folded before Flop (didn't bet)
Seat 4: I find you ez folded on the River
Seat 5: hempju1ce (button) folded before Flop (didn't bet)



PokerStars Hand #222982563949:  Hold'em No Limit ($0.05/$0.10 USD) - 2021/01/23 21:08:26 ET
Table 'Lova III' 6-max Seat #1 is the button
Seat 1: DontSleep111 ($10.78 in chips) 
Seat 2: Angie Senpai ($20.68 in chips) 
Seat 3: lucas-fmtm ($10.39 in chips) 
Seat 4: I find you ez ($10 in chips) 
Seat 5: hempju1ce ($32.72 in chips) 
Angie Senpai: posts small blind $0.05
lucas-fmtm: posts big blind $0.10
AAAcostA: sits out 
*** HOLE CARDS ***
I find you ez: raises $0.30 to $0.40
hempju1ce: folds 
DontSleep111: folds 
Angie Senpai: folds 
lucas-fmtm: folds 
Uncalled bet ($0.30) returned to I find you ez
I find you ez collected $0.25 from pot
I find you ez: doesn't show hand 
*** SUMMARY ***
Total pot $0.25 | Rake $0 
Seat 1: DontSleep111 (button) folded before Flop (didn't bet)
Seat 2: Angie Senpai (small blind) folded before Flop
Seat 3: lucas-fmtm (big blind) folded before Flop
Seat 4: I find you ez collected ($0.25)
Seat 5: hempju1ce folded before Flop (didn't bet)



PokerStars Hand #222982569827:  Hold'em No Limit ($0.05/$0.10 USD) - 2021/01/23 21:08:41 ET
Table 'Lova III' 6-max Seat #2 is the button
Seat 1: DontSleep111 ($10.78 in chips) 
Seat 2: Angie Senpai ($20.63 in chips) 
Seat 3: lucas-fmtm ($10.29 in chips) 
Seat 4: I find you ez ($10.15 in chips) 
Seat 5: hempju1ce ($32.72 in chips) 
lucas-fmtm: posts small blind $0.05
I find you ez: posts big blind $0.10
AAAcostA: sits out 
*** HOLE CARDS ***
hempju1ce: calls $0.10
DontSleep111: folds 
Angie Senpai: folds 
lucas-fmtm: folds 
I find you ez: raises $0.35 to $0.45
hempju1ce: calls $0.35
*** FLOP *** [4h Kc 3c]
I find you ez: bets $0.45
hempju1ce: calls $0.45
*** TURN *** [4h Kc 3c] [Th]
I find you ez: checks 
hempju1ce: bets $1
I find you ez: calls $1
*** RIVER *** [4h Kc 3c Th] [Jh]
I find you ez: checks 
hempju1ce: bets $1.90
I find you ez: calls $1.90
*** SHOW DOWN ***
hempju1ce: shows [Tc Kd] (two pair, Kings and Tens)
I find you ez: mucks hand 
hempju1ce collected $7.31 from pot
*** SUMMARY ***
Total pot $7.65 | Rake $0.34 
Board [4h Kc 3c Th Jh]
Seat 1: DontSleep111 folded before Flop (didn't bet)
Seat 2: Angie Senpai (button) folded before Flop (didn't bet)
Seat 3: lucas-fmtm (small blind) folded before Flop
Seat 4: I find you ez (big blind) mucked
Seat 5: hempju1ce showed [Tc Kd] and won ($7.31) with two pair, Kings and Tens



PokerStars Hand #222982603414:  Hold'em No Limit ($0.05/$0.10 USD) - 2021/01/23 21:10:02 ET
Table 'Lova III' 6-max Seat #3 is the button
Seat 1: DontSleep111 ($10.78 in chips) 
Seat 2: Angie Senpai ($20.63 in chips) 
Seat 3: lucas-fmtm ($10.24 in chips) 
Seat 4: I find you ez ($10 in chips) 
Seat 5: hempju1ce ($36.23 in chips) 
I find you ez: posts small blind $0.05
hempju1ce: posts big blind $0.10
AAAcostA: sits out 
*** HOLE CARDS ***
DontSleep111: folds 
Angie Senpai: folds 
lucas-fmtm: raises $0.20 to $0.30
I find you ez: folds 
hempju1ce: folds 
Uncalled bet ($0.20) returned to lucas-fmtm
lucas-fmtm collected $0.25 from pot
*** SUMMARY ***
Total pot $0.25 | Rake $0 
Seat 1: DontSleep111 folded before Flop (didn't bet)
Seat 2: Angie Senpai folded before Flop (didn't bet)
Seat 3: lucas-fmtm (button) collected ($0.25)
Seat 4: I find you ez (small blind) folded before Flop
Seat 5: hempju1ce (big blind) folded before Flop



PokerStars Hand #222982612293:  Hold'em No Limit ($0.05/$0.10 USD) - 2021/01/23 21:10:23 ET
Table 'Lova III' 6-max Seat #4 is the button
Seat 1: DontSleep111 ($10.78 in chips) 
Seat 2: Angie Senpai ($20.63 in chips) 
Seat 3: lucas-fmtm ($10.39 in chips) 
Seat 4: I find you ez ($10 in chips) 
Seat 5: hempju1ce ($36.13 in chips) 
Seat 6: AAAcostA ($10 in chips) 
hempju1ce: posts small blind $0.05
AAAcostA: posts big blind $0.10
*** HOLE CARDS ***
DontSleep111: folds 
Angie Senpai: raises $0.18 to $0.28
lucas-fmtm: folds 
I find you ez: folds 
hempju1ce: folds 
AAAcostA: calls $0.18
*** FLOP *** [Kh 7d Qd]
AAAcostA: checks 
Angie Senpai: bets $0.35
AAAcostA: calls $0.35
*** TURN *** [Kh 7d Qd] [Tc]
AAAcostA: checks 
Angie Senpai: bets $0.85
AAAcostA: raises $2.21 to $3.06
Angie Senpai: calls $2.21
*** RIVER *** [Kh 7d Qd Tc] [5h]
AAAcostA: bets $6.31 and is all-in
Angie Senpai: folds 
Uncalled bet ($6.31) returned to AAAcostA
AAAcostA collected $7.10 from pot
AAAcostA: doesn't show hand 
*** SUMMARY ***
Total pot $7.43 | Rake $0.33 
Board [Kh 7d Qd Tc 5h]
Seat 1: DontSleep111 folded before Flop (didn't bet)
Seat 2: Angie Senpai folded on the River
Seat 3: lucas-fmtm folded before Flop (didn't bet)
Seat 4: I find you ez (button) folded before Flop (didn't bet)
Seat 5: hempju1ce (small blind) folded before Flop
Seat 6: AAAcostA (big blind) collected ($7.10)



PokerStars Hand #222982634378:  Hold'em No Limit ($0.05/$0.10 USD) - 2021/01/23 21:11:17 ET
Table 'Lova III' 6-max Seat #5 is the button
Seat 1: DontSleep111 ($10.78 in chips) 
Seat 2: Angie Senpai ($16.94 in chips) 
Seat 3: lucas-fmtm ($10.39 in chips) 
Seat 4: I find you ez ($10 in chips) 
Seat 5: hempju1ce ($36.08 in chips) 
Seat 6: AAAcostA ($13.41 in chips) 
AAAcostA: posts small blind $0.05
DontSleep111: posts big blind $0.10
*** HOLE CARDS ***
Angie Senpai: folds 
lucas-fmtm: raises $0.20 to $0.30
I find you ez: folds 
hempju1ce: folds 
AAAcostA: folds 
DontSleep111: folds 
Uncalled bet ($0.20) returned to lucas-fmtm
lucas-fmtm collected $0.25 from pot
*** SUMMARY ***
Total pot $0.25 | Rake $0 
Seat 1: DontSleep111 (big blind) folded before Flop
Seat 2: Angie Senpai folded before Flop (didn't bet)
Seat 3: lucas-fmtm collected ($0.25)
Seat 4: I find you ez folded before Flop (didn't bet)
Seat 5: hempju1ce (button) folded before Flop (didn't bet)
Seat 6: AAAcostA (small blind) folded before Flop



PokerStars Hand #222982646095:  Hold'em No Limit ($0.05/$0.10 USD) - 2021/01/23 21:11:45 ET
Table 'Lova III' 6-max Seat #6 is the button
Seat 1: DontSleep111 ($10.68 in chips) 
Seat 2: Angie Senpai ($16.94 in chips) 
Seat 3: lucas-fmtm ($10.54 in chips) 
Seat 4: I find you ez ($10 in chips) 
Seat 5: hempju1ce ($36.08 in chips) 
Seat 6: AAAcostA ($13.36 in chips) 
DontSleep111: posts small blind $0.05
Angie Senpai: posts big blind $0.10
*** HOLE CARDS ***
lucas-fmtm: folds 
I find you ez: raises $0.25 to $0.35
hempju1ce: folds 
AAAcostA: folds 
DontSleep111: folds 
Angie Senpai: calls $0.25
*** FLOP *** [3h Jc 9d]
Angie Senpai: checks 
I find you ez: bets $0.35
Angie Senpai: calls $0.35
*** TURN *** [3h Jc 9d] [7c]
Angie Senpai: checks 
I find you ez: bets $0.90
Angie Senpai: raises $1.90 to $2.80
I find you ez: folds 
Uncalled bet ($1.90) returned to Angie Senpai
Angie Senpai collected $3.10 from pot
Angie Senpai: doesn't show hand 
*** SUMMARY ***
Total pot $3.25 | Rake $0.15 
Board [3h Jc 9d 7c]
Seat 1: DontSleep111 (small blind) folded before Flop
Seat 2: Angie Senpai (big blind) collected ($3.10)
Seat 3: lucas-fmtm folded before Flop (didn't bet)
Seat 4: I find you ez folded on the Turn
Seat 5: hempju1ce folded before Flop (didn't bet)
Seat 6: AAAcostA (button) folded before Flop (didn't bet)



PokerStars Hand #222982678219:  Hold'em No Limit ($0.05/$0.10 USD) - 2021/01/23 21:12:52 ET
Table 'Lova III' 6-max Seat #1 is the button
Seat 1: DontSleep111 ($10.63 in chips) 
Seat 2: Angie Senpai ($18.44 in chips) 
Seat 3: lucas-fmtm ($10.54 in chips) 
Seat 4: I find you ez ($10 in chips) 
Seat 5: hempju1ce ($36.08 in chips) 
Seat 6: AAAcostA ($13.36 in chips) 
Angie Senpai: posts small blind $0.05
lucas-fmtm: posts big blind $0.10
*** HOLE CARDS ***
I find you ez: folds 
hempju1ce: folds 
AAAcostA: raises $0.20 to $0.30
DontSleep111: folds 
Angie Senpai: folds 
lucas-fmtm: folds 
Uncalled bet ($0.20) returned to AAAcostA
AAAcostA collected $0.25 from pot
AAAcostA: doesn't show hand 
*** SUMMARY ***
Total pot $0.25 | Rake $0 
Seat 1: DontSleep111 (button) folded before Flop (didn't bet)
Seat 2: Angie Senpai (small blind) folded before Flop
Seat 3: lucas-fmtm (big blind) folded before Flop
Seat 4: I find you ez folded before Flop (didn't bet)
Seat 5: hempju1ce folded before Flop (didn't bet)
Seat 6: AAAcostA collected ($0.25)



PokerStars Hand #222982683296:  Hold'em No Limit ($0.05/$0.10 USD) - 2021/01/23 21:13:05 ET
Table 'Lova III' 6-max Seat #2 is the button
Seat 1: DontSleep111 ($10.63 in chips) 
Seat 2: Angie Senpai ($18.39 in chips) 
Seat 3: lucas-fmtm ($10.44 in chips) 
Seat 4: I find you ez ($10 in chips) 
Seat 5: hempju1ce ($36.08 in chips) 
Seat 6: AAAcostA ($13.51 in chips) 
lucas-fmtm: posts small blind $0.05
I find you ez: posts big blind $0.10
*** HOLE CARDS ***
hempju1ce: folds 
AAAcostA: folds 
DontSleep111: folds 
Angie Senpai: raises $0.18 to $0.28
lucas-fmtm: folds 
I find you ez: folds 
Uncalled bet ($0.18) returned to Angie Senpai
Angie Senpai collected $0.25 from pot
Angie Senpai: doesn't show hand 
*** SUMMARY ***
Total pot $0.25 | Rake $0 
Seat 1: DontSleep111 folded before Flop (didn't bet)
Seat 2: Angie Senpai (button) collected ($0.25)
Seat 3: lucas-fmtm (small blind) folded before Flop
Seat 4: I find you ez (big blind) folded before Flop
Seat 5: hempju1ce folded before Flop (didn't bet)
Seat 6: AAAcostA folded before Flop (didn't bet)



PokerStars Hand #222982691725:  Hold'em No Limit ($0.05/$0.10 USD) - 2021/01/23 21:13:25 ET
Table 'Lova III' 6-max Seat #3 is the button
Seat 1: DontSleep111 ($10.63 in chips) 
Seat 2: Angie Senpai ($18.54 in chips) 
Seat 3: lucas-fmtm ($10.39 in chips) 
Seat 4: I find you ez ($10 in chips) 
Seat 5: hempju1ce ($36.08 in chips) 
Seat 6: AAAcostA ($13.51 in chips) 
I find you ez: posts small blind $0.05
hempju1ce: posts big blind $0.10
*** HOLE CARDS ***
AAAcostA: raises $0.20 to $0.30
DontSleep111: folds 
Angie Senpai: folds 
lucas-fmtm: folds 
I find you ez: calls $0.25
hempju1ce: folds 
*** FLOP *** [Qd 6h 5d]
I find you ez: checks 
AAAcostA: bets $0.36
I find you ez: raises $0.94 to $1.30
AAAcostA: calls $0.94
*** TURN *** [Qd 6h 5d] [Kh]
I find you ez: bets $2.10
AAAcostA: calls $2.10
*** RIVER *** [Qd 6h 5d Kh] [9s]
I find you ez: checks 
AAAcostA: bets $9.81 and is all-in
I find you ez: folds 
Uncalled bet ($9.81) returned to AAAcostA
AAAcostA collected $7.16 from pot
AAAcostA: doesn't show hand 
*** SUMMARY ***
Total pot $7.50 | Rake $0.34 
Board [Qd 6h 5d Kh 9s]
Seat 1: DontSleep111 folded before Flop (didn't bet)
Seat 2: Angie Senpai folded before Flop (didn't bet)
Seat 3: lucas-fmtm (button) folded before Flop (didn't bet)
Seat 4: I find you ez (small blind) folded on the River
Seat 5: hempju1ce (big blind) folded before Flop
Seat 6: AAAcostA collected ($7.16)



PokerStars Hand #222982723545:  Hold'em No Limit ($0.05/$0.10 USD) - 2021/01/23 21:14:43 ET
Table 'Lova III' 6-max Seat #4 is the button
Seat 1: DontSleep111 ($10.63 in chips) 
Seat 2: Angie Senpai ($18.54 in chips) 
Seat 3: lucas-fmtm ($10.39 in chips) 
Seat 4: I find you ez ($10 in chips) 
Seat 5: hempju1ce ($35.98 in chips) 
Seat 6: AAAcostA ($16.97 in chips) 
hempju1ce: posts small blind $0.05
AAAcostA: posts big blind $0.10
*** HOLE CARDS ***
DontSleep111: folds 
Angie Senpai: folds 
lucas-fmtm: folds 
I find you ez: raises $0.15 to $0.25
hempju1ce: folds 
AAAcostA: folds 
Uncalled bet ($0.15) returned to I find you ez
I find you ez collected $0.25 from pot
I find you ez: doesn't show hand 
*** SUMMARY ***
Total pot $0.25 | Rake $0 
Seat 1: DontSleep111 folded before Flop (didn't bet)
Seat 2: Angie Senpai folded before Flop (didn't bet)
Seat 3: lucas-fmtm folded before Flop (didn't bet)
Seat 4: I find you ez (button) collected ($0.25)
Seat 5: hempju1ce (small blind) folded before Flop
Seat 6: AAAcostA (big blind) folded before Flop



PokerStars Hand #222982729894:  Hold'em No Limit ($0.05/$0.10 USD) - 2021/01/23 21:14:59 ET
Table 'Lova III' 6-max Seat #5 is the button
Seat 1: DontSleep111 ($10.63 in chips) 
Seat 2: Angie Senpai ($18.54 in chips) 
Seat 3: lucas-fmtm ($10.39 in chips) 
Seat 4: I find you ez ($10.15 in chips) 
Seat 5: hempju1ce ($35.93 in chips) 
Seat 6: AAAcostA ($16.87 in chips) 
AAAcostA: posts small blind $0.05
DontSleep111: posts big blind $0.10
*** HOLE CARDS ***
Angie Senpai: folds 
lucas-fmtm: folds 
Angie Senpai leaves the table
I find you ez: folds 
hempju1ce: folds 
AAAcostA: folds 
Uncalled bet ($0.05) returned to DontSleep111
DontSleep111 collected $0.10 from pot
DontSleep111: doesn't show hand 
Do-Man22 joins the table at seat #2 
*** SUMMARY ***
Total pot $0.10 | Rake $0 
Seat 1: DontSleep111 (big blind) collected ($0.10)
Seat 2: Angie Senpai folded before Flop (didn't bet)
Seat 3: lucas-fmtm folded before Flop (didn't bet)
Seat 4: I find you ez folded before Flop (didn't bet)
Seat 5: hempju1ce (button) folded before Flop (didn't bet)
Seat 6: AAAcostA (small blind) folded before Flop



PokerStars Hand #222982735899:  Hold'em No Limit ($0.05/$0.10 USD) - 2021/01/23 21:15:13 ET
Table 'Lova III' 6-max Seat #6 is the button
Seat 1: DontSleep111 ($10.68 in chips) 
Seat 2: Do-Man22 ($10 in chips) 
Seat 3: lucas-fmtm ($10.39 in chips) 
Seat 4: I find you ez ($10.15 in chips) 
Seat 5: hempju1ce ($35.93 in chips) 
Seat 6: AAAcostA ($16.82 in chips) 
DontSleep111: posts small blind $0.05
Do-Man22: posts big blind $0.10
*** HOLE CARDS ***
lucas-fmtm: folds 
I find you ez: folds 
hempju1ce: folds 
AAAcostA: folds 
DontSleep111: folds 
Uncalled bet ($0.05) returned to Do-Man22
Do-Man22 collected $0.10 from pot
*** SUMMARY ***
Total pot $0.10 | Rake $0 
Seat 1: DontSleep111 (small blind) folded before Flop
Seat 2: Do-Man22 (big blind) collected ($0.10)
Seat 3: lucas-fmtm folded before Flop (didn't bet)
Seat 4: I find you ez folded before Flop (didn't bet)
Seat 5: hempju1ce folded before Flop (didn't bet)
Seat 6: AAAcostA (button) folded before Flop (didn't bet)



PokerStars Hand #222982739747:  Hold'em No Limit ($0.05/$0.10 USD) - 2021/01/23 21:15:23 ET
Table 'Lova III' 6-max Seat #1 is the button
Seat 1: DontSleep111 ($10.63 in chips) 
Seat 2: Do-Man22 ($10.05 in chips) 
Seat 3: lucas-fmtm ($10.39 in chips) 
Seat 4: I find you ez ($10.15 in chips) 
Seat 5: hempju1ce ($35.93 in chips) 
Seat 6: AAAcostA ($16.82 in chips) 
Do-Man22: posts small blind $0.05
lucas-fmtm: posts big blind $0.10
*** HOLE CARDS ***
I find you ez: folds 
hempju1ce: folds 
AAAcostA: folds 
DontSleep111: raises $0.15 to $0.25
Do-Man22: calls $0.20
lucas-fmtm: folds 
*** FLOP *** [Qs 4h Td]
Do-Man22: bets $0.29
DontSleep111: calls $0.29
*** TURN *** [Qs 4h Td] [3c]
Do-Man22: bets $0.30
DontSleep111: calls $0.30
*** RIVER *** [Qs 4h Td 3c] [Qd]
Do-Man22: bets $0.40
DontSleep111: calls $0.40
*** SHOW DOWN ***
Do-Man22: shows [Th Jc] (two pair, Queens and Tens)
DontSleep111: mucks hand 
Do-Man22 collected $2.46 from pot
*** SUMMARY ***
Total pot $2.58 | Rake $0.12 
Board [Qs 4h Td 3c Qd]
Seat 1: DontSleep111 (button) mucked
Seat 2: Do-Man22 (small blind) showed [Th Jc] and won ($2.46) with two pair, Queens and Tens
Seat 3: lucas-fmtm (big blind) folded before Flop
Seat 4: I find you ez folded before Flop (didn't bet)
Seat 5: hempju1ce folded before Flop (didn't bet)
Seat 6: AAAcostA folded before Flop (didn't bet)



PokerStars Hand #222982759083:  Hold'em No Limit ($0.05/$0.10 USD) - 2021/01/23 21:16:10 ET
Table 'Lova III' 6-max Seat #2 is the button
Seat 1: DontSleep111 ($10 in chips) 
Seat 2: Do-Man22 ($11.27 in chips) 
Seat 3: lucas-fmtm ($10.29 in chips) 
Seat 4: I find you ez ($10.15 in chips) 
Seat 5: hempju1ce ($35.93 in chips) 
Seat 6: AAAcostA ($16.82 in chips) 
lucas-fmtm: posts small blind $0.05
I find you ez: posts big blind $0.10
*** HOLE CARDS ***
hempju1ce: raises $0.10 to $0.20
AAAcostA: folds 
DontSleep111: calls $0.20
Do-Man22: raises $0.20 to $0.40
lucas-fmtm: folds 
I find you ez: raises $1.25 to $1.65
hempju1ce: calls $1.45
DontSleep111: folds 
Do-Man22: folds 
*** FLOP *** [5c 2s 6s]
I find you ez: bets $1.25
hempju1ce: calls $1.25
*** TURN *** [5c 2s 6s] [2d]
I find you ez: bets $2.05
hempju1ce: calls $2.05
*** RIVER *** [5c 2s 6s 2d] [8d]
I find you ez: bets $5.20 and is all-in
hempju1ce: calls $5.20
*** SHOW DOWN ***
I find you ez: shows [Kh Kc] (two pair, Kings and Deuces)
hempju1ce: shows [Qd Qc] (two pair, Queens and Deuces)
I find you ez collected $20.01 from pot
*** SUMMARY ***
Total pot $20.95 | Rake $0.94 
Board [5c 2s 6s 2d 8d]
Seat 1: DontSleep111 folded before Flop
Seat 2: Do-Man22 (button) folded before Flop
Seat 3: lucas-fmtm (small blind) folded before Flop
Seat 4: I find you ez (big blind) showed [Kh Kc] and won ($20.01) with two pair, Kings and Deuces
Seat 5: hempju1ce showed [Qd Qc] and lost with two pair, Queens and Deuces
Seat 6: AAAcostA folded before Flop (didn't bet)



PokerStars Hand #222982780064:  Hold'em No Limit ($0.05/$0.10 USD) - 2021/01/23 21:17:01 ET
Table 'Lova III' 6-max Seat #3 is the button
Seat 1: DontSleep111 ($10 in chips) 
Seat 2: Do-Man22 ($10.87 in chips) 
Seat 3: lucas-fmtm ($10.24 in chips) 
Seat 4: I find you ez ($20.01 in chips) 
Seat 5: hempju1ce ($25.78 in chips) 
Seat 6: AAAcostA ($16.82 in chips) 
I find you ez: posts small blind $0.05
hempju1ce: posts big blind $0.10
*** HOLE CARDS ***
AAAcostA: folds 
DontSleep111: folds 
Do-Man22: raises $0.30 to $0.40
lucas-fmtm: folds 
I find you ez: folds 
hempju1ce: folds 
Uncalled bet ($0.30) returned to Do-Man22
Do-Man22 collected $0.25 from pot
*** SUMMARY ***
Total pot $0.25 | Rake $0 
Seat 1: DontSleep111 folded before Flop (didn't bet)
Seat 2: Do-Man22 collected ($0.25)
Seat 3: lucas-fmtm (button) folded before Flop (didn't bet)
Seat 4: I find you ez (small blind) folded before Flop
Seat 5: hempju1ce (big blind) folded before Flop
Seat 6: AAAcostA folded before Flop (didn't bet)



PokerStars Hand #222982787474:  Hold'em No Limit ($0.05/$0.10 USD) - 2021/01/23 21:17:20 ET
Table 'Lova III' 6-max Seat #4 is the button
Seat 1: DontSleep111 ($10 in chips) 
Seat 2: Do-Man22 ($11.02 in chips) 
Seat 3: lucas-fmtm ($10.24 in chips) 
Seat 4: I find you ez ($19.96 in chips) 
Seat 5: hempju1ce ($25.68 in chips) 
Seat 6: AAAcostA ($16.82 in chips) 
hempju1ce: posts small blind $0.05
AAAcostA: posts big blind $0.10
*** HOLE CARDS ***
DontSleep111: folds 
Do-Man22: raises $0.40 to $0.50
lucas-fmtm: folds 
I find you ez: folds 
hempju1ce: folds 
AAAcostA: folds 
Uncalled bet ($0.40) returned to Do-Man22
Do-Man22 collected $0.25 from pot
*** SUMMARY ***
Total pot $0.25 | Rake $0 
Seat 1: DontSleep111 folded before Flop (didn't bet)
Seat 2: Do-Man22 collected ($0.25)
Seat 3: lucas-fmtm folded before Flop (didn't bet)
Seat 4: I find you ez (button) folded before Flop (didn't bet)
Seat 5: hempju1ce (small blind) folded before Flop
Seat 6: AAAcostA (big blind) folded before Flop



PokerStars Hand #222982792324:  Hold'em No Limit ($0.05/$0.10 USD) - 2021/01/23 21:17:32 ET
Table 'Lova III' 6-max Seat #5 is the button
Seat 1: DontSleep111 ($10 in chips) 
Seat 2: Do-Man22 ($11.17 in chips) 
Seat 3: lucas-fmtm ($10.24 in chips) 
Seat 4: I find you ez ($19.96 in chips) 
Seat 5: hempju1ce ($25.63 in chips) 
Seat 6: AAAcostA ($16.72 in chips) 
AAAcostA: posts small blind $0.05
DontSleep111: posts big blind $0.10
*** HOLE CARDS ***
Do-Man22: folds 
lucas-fmtm: folds 
I find you ez: raises $0.20 to $0.30
hempju1ce: folds 
AAAcostA: folds 
DontSleep111: folds 
Uncalled bet ($0.20) returned to I find you ez
I find you ez collected $0.25 from pot
I find you ez: doesn't show hand 
*** SUMMARY ***
Total pot $0.25 | Rake $0 
Seat 1: DontSleep111 (big blind) folded before Flop
Seat 2: Do-Man22 folded before Flop (didn't bet)
Seat 3: lucas-fmtm folded before Flop (didn't bet)
Seat 4: I find you ez collected ($0.25)
Seat 5: hempju1ce (button) folded before Flop (didn't bet)
Seat 6: AAAcostA (small blind) folded before Flop



PokerStars Hand #222982801367:  Hold'em No Limit ($0.05/$0.10 USD) - 2021/01/23 21:17:54 ET
Table 'Lova III' 6-max Seat #6 is the button
Seat 1: DontSleep111 ($10 in chips) 
Seat 2: Do-Man22 ($11.17 in chips) 
Seat 3: lucas-fmtm ($10.24 in chips) 
Seat 4: I find you ez ($20.11 in chips) 
Seat 5: hempju1ce ($25.63 in chips) 
Seat 6: AAAcostA ($16.67 in chips) 
DontSleep111: posts small blind $0.05
Do-Man22: posts big blind $0.10
*** HOLE CARDS ***
lucas-fmtm: folds 
I find you ez: raises $0.25 to $0.35
hempju1ce: folds 
AAAcostA: folds 
DontSleep111: folds 
Do-Man22: folds 
Uncalled bet ($0.25) returned to I find you ez
I find you ez collected $0.25 from pot
I find you ez: doesn't show hand 
*** SUMMARY ***
Total pot $0.25 | Rake $0 
Seat 1: DontSleep111 (small blind) folded before Flop
Seat 2: Do-Man22 (big blind) folded before Flop
Seat 3: lucas-fmtm folded before Flop (didn't bet)
Seat 4: I find you ez collected ($0.25)
Seat 5: hempju1ce folded before Flop (didn't bet)
Seat 6: AAAcostA (button) folded before Flop (didn't bet)



PokerStars Hand #222982810301:  Hold'em No Limit ($0.05/$0.10 USD) - 2021/01/23 21:18:07 ET
Table 'Lova III' 6-max Seat #1 is the button
Seat 1: DontSleep111 ($10 in chips) 
Seat 2: Do-Man22 ($11.07 in chips) 
Seat 3: lucas-fmtm ($10.24 in chips) 
Seat 4: I find you ez ($20.26 in chips) 
Seat 5: hempju1ce ($25.63 in chips) 
Seat 6: AAAcostA ($16.67 in chips) 
Do-Man22: posts small blind $0.05
lucas-fmtm: posts big blind $0.10
*** HOLE CARDS ***
I find you ez: raises $0.30 to $0.40
hempju1ce: folds 
AAAcostA: folds 
DontSleep111: raises $0.80 to $1.20
Do-Man22: folds 
lucas-fmtm: folds 
I find you ez: calls $0.80
*** FLOP *** [Jc Ah 6s]
I find you ez: checks 
DontSleep111: bets $0.49
I find you ez: calls $0.49
*** TURN *** [Jc Ah 6s] [Qs]
I find you ez: checks 
DontSleep111: checks 
*** RIVER *** [Jc Ah 6s Qs] [6d]
I find you ez: bets $1.10
DontSleep111: folds 
Uncalled bet ($1.10) returned to I find you ez
I find you ez collected $3.37 from pot
I find you ez: doesn't show hand 
*** SUMMARY ***
Total pot $3.53 | Rake $0.16 
Board [Jc Ah 6s Qs 6d]
Seat 1: DontSleep111 (button) folded on the River
Seat 2: Do-Man22 (small blind) folded before Flop
Seat 3: lucas-fmtm (big blind) folded before Flop
Seat 4: I find you ez collected ($3.37)
Seat 5: hempju1ce folded before Flop (didn't bet)
Seat 6: AAAcostA folded before Flop (didn't bet)



PokerStars Hand #222982829120:  Hold'em No Limit ($0.05/$0.10 USD) - 2021/01/23 21:18:53 ET
Table 'Lova III' 6-max Seat #2 is the button
Seat 1: DontSleep111 ($10 in chips) 
Seat 2: Do-Man22 ($11.02 in chips) 
Seat 3: lucas-fmtm ($10.14 in chips) 
Seat 4: I find you ez ($21.94 in chips) 
Seat 5: hempju1ce ($25.63 in chips) 
Seat 6: AAAcostA ($16.67 in chips) 
lucas-fmtm: posts small blind $0.05
I find you ez: posts big blind $0.10
*** HOLE CARDS ***
hempju1ce: raises $0.10 to $0.20
AAAcostA: folds 
DontSleep111: folds 
Do-Man22 has timed out
Do-Man22: folds 
lucas-fmtm: folds 
I find you ez: calls $0.10
*** FLOP *** [Td Ac 4s]
I find you ez: checks 
hempju1ce: checks 
*** TURN *** [Td Ac 4s] [7d]
I find you ez: checks 
hempju1ce: bets $0.20
I find you ez: folds 
Uncalled bet ($0.20) returned to hempju1ce
hempju1ce collected $0.43 from pot
hempju1ce: doesn't show hand 
*** SUMMARY ***
Total pot $0.45 | Rake $0.02 
Board [Td Ac 4s 7d]
Seat 1: DontSleep111 folded before Flop (didn't bet)
Seat 2: Do-Man22 (button) folded before Flop (didn't bet)
Seat 3: lucas-fmtm (small blind) folded before Flop
Seat 4: I find you ez (big blind) folded on the Turn
Seat 5: hempju1ce collected ($0.43)
Seat 6: AAAcostA folded before Flop (didn't bet)



PokerStars Hand #222982849531:  Hold'em No Limit ($0.05/$0.10 USD) - 2021/01/23 21:19:44 ET
Table 'Lova III' 6-max Seat #3 is the button
Seat 1: DontSleep111 ($10 in chips) 
Seat 2: Do-Man22 ($11.02 in chips) 
Seat 3: lucas-fmtm ($10.09 in chips) 
Seat 4: I find you ez ($21.74 in chips) 
Seat 5: hempju1ce ($25.86 in chips) 
Seat 6: AAAcostA ($16.67 in chips) 
I find you ez: posts small blind $0.05
hempju1ce: posts big blind $0.10
*** HOLE CARDS ***
AAAcostA: raises $0.20 to $0.30
DontSleep111: folds 
Do-Man22: calls $0.30
lucas-fmtm: calls $0.30
I find you ez: folds 
hempju1ce: folds 
*** FLOP *** [Ad Ah As]
AAAcostA: checks 
Do-Man22: checks 
lucas-fmtm: checks 
*** TURN *** [Ad Ah As] [8s]
AAAcostA: bets $0.30
Do-Man22: folds 
lucas-fmtm: calls $0.30
*** RIVER *** [Ad Ah As 8s] [Kh]
AAAcostA: checks 
lucas-fmtm: bets $0.52
AAAcostA: calls $0.52
*** SHOW DOWN ***
lucas-fmtm: shows [Js Ac] (four of a kind, Aces)
AAAcostA: mucks hand 
lucas-fmtm collected $2.57 from pot
*** SUMMARY ***
Total pot $2.69 | Rake $0.12 
Board [Ad Ah As 8s Kh]
Seat 1: DontSleep111 folded before Flop (didn't bet)
Seat 2: Do-Man22 folded on the Turn
Seat 3: lucas-fmtm (button) showed [Js Ac] and won ($2.57) with four of a kind, Aces
Seat 4: I find you ez (small blind) folded before Flop
Seat 5: hempju1ce (big blind) folded before Flop
Seat 6: AAAcostA mucked



PokerStars Hand #222982869695:  Hold'em No Limit ($0.05/$0.10 USD) - 2021/01/23 21:20:34 ET
Table 'Lova III' 6-max Seat #4 is the button
Seat 1: DontSleep111 ($10 in chips) 
Seat 2: Do-Man22 ($10.72 in chips) 
Seat 3: lucas-fmtm ($11.54 in chips) 
Seat 4: I find you ez ($21.69 in chips) 
Seat 5: hempju1ce ($25.76 in chips) 
Seat 6: AAAcostA ($15.55 in chips) 
hempju1ce: posts small blind $0.05
AAAcostA: posts big blind $0.10
*** HOLE CARDS ***
DontSleep111: folds 
Do-Man22: raises $0.30 to $0.40
lucas-fmtm: folds 
I find you ez: calls $0.40
hempju1ce: folds 
AAAcostA: folds 
*** FLOP *** [8h 5d Qh]
Do-Man22: bets $0.40
I find you ez: calls $0.40
*** TURN *** [8h 5d Qh] [5s]
Do-Man22: checks 
I find you ez: bets $0.85
Do-Man22: calls $0.85
*** RIVER *** [8h 5d Qh 5s] [6s]
Do-Man22: checks 
I find you ez: bets $1.65
Do-Man22: folds 
Uncalled bet ($1.65) returned to I find you ez
I find you ez collected $3.29 from pot
I find you ez: doesn't show hand 
*** SUMMARY ***
Total pot $3.45 | Rake $0.16 
Board [8h 5d Qh 5s 6s]
Seat 1: DontSleep111 folded before Flop (didn't bet)
Seat 2: Do-Man22 folded on the River
Seat 3: lucas-fmtm folded before Flop (didn't bet)
Seat 4: I find you ez (button) collected ($3.29)
Seat 5: hempju1ce (small blind) folded before Flop
Seat 6: AAAcostA (big blind) folded before Flop



PokerStars Hand #222982884008:  Hold'em No Limit ($0.05/$0.10 USD) - 2021/01/23 21:21:09 ET
Table 'Lova III' 6-max Seat #5 is the button
Seat 1: DontSleep111 ($10 in chips) 
Seat 2: Do-Man22 ($9.07 in chips) 
Seat 3: lucas-fmtm ($11.54 in chips) 
Seat 4: I find you ez ($23.33 in chips) 
Seat 5: hempju1ce ($25.71 in chips) 
Seat 6: AAAcostA ($15.45 in chips) 
AAAcostA: posts small blind $0.05
DontSleep111: posts big blind $0.10
*** HOLE CARDS ***
Do-Man22: folds 
lucas-fmtm: folds 
I find you ez: folds 
hempju1ce: raises $0.10 to $0.20
AAAcostA: folds 
DontSleep111: calls $0.10
*** FLOP *** [2s 5h 3s]
DontSleep111: checks 
hempju1ce: bets $0.10
DontSleep111: raises $0.32 to $0.42
hempju1ce: calls $0.32
*** TURN *** [2s 5h 3s] [6s]
DontSleep111: checks 
hempju1ce: bets $0.61
DontSleep111: calls $0.61
*** RIVER *** [2s 5h 3s 6s] [Qd]
DontSleep111: checks 
hempju1ce: checks 
*** SHOW DOWN ***
DontSleep111: shows [As 4h] (a straight, Deuce to Six)
hempju1ce: mucks hand 
DontSleep111 collected $2.40 from pot
*** SUMMARY ***
Total pot $2.51 | Rake $0.11 
Board [2s 5h 3s 6s Qd]
Seat 1: DontSleep111 (big blind) showed [As 4h] and won ($2.40) with a straight, Deuce to Six
Seat 2: Do-Man22 folded before Flop (didn't bet)
Seat 3: lucas-fmtm folded before Flop (didn't bet)
Seat 4: I find you ez folded before Flop (didn't bet)
Seat 5: hempju1ce (button) mucked
Seat 6: AAAcostA (small blind) folded before Flop



PokerStars Hand #222982899096:  Hold'em No Limit ($0.05/$0.10 USD) - 2021/01/23 21:21:47 ET
Table 'Lova III' 6-max Seat #6 is the button
Seat 1: DontSleep111 ($11.17 in chips) 
Seat 2: Do-Man22 ($10 in chips) 
Seat 3: lucas-fmtm ($11.54 in chips) 
Seat 4: I find you ez ($23.33 in chips) 
Seat 5: hempju1ce ($24.48 in chips) 
Seat 6: AAAcostA ($15.40 in chips) 
DontSleep111: posts small blind $0.05
Do-Man22: posts big blind $0.10
*** HOLE CARDS ***
lucas-fmtm: folds 
I find you ez: folds 
hempju1ce: calls $0.10
AAAcostA: folds 
DontSleep111: folds 
Do-Man22: checks 
*** FLOP *** [9h 8s 8h]
Do-Man22: bets $0.40
hempju1ce: folds 
Uncalled bet ($0.40) returned to Do-Man22
Do-Man22 collected $0.24 from pot
*** SUMMARY ***
Total pot $0.25 | Rake $0.01 
Board [9h 8s 8h]
Seat 1: DontSleep111 (small blind) folded before Flop
Seat 2: Do-Man22 (big blind) collected ($0.24)
Seat 3: lucas-fmtm folded before Flop (didn't bet)
Seat 4: I find you ez folded before Flop (didn't bet)
Seat 5: hempju1ce folded on the Flop
Seat 6: AAAcostA (button) folded before Flop (didn't bet)



PokerStars Hand #222982907048:  Hold'em No Limit ($0.05/$0.10 USD) - 2021/01/23 21:22:07 ET
Table 'Lova III' 6-max Seat #1 is the button
Seat 1: DontSleep111 ($11.12 in chips) 
Seat 2: Do-Man22 ($10.14 in chips) 
Seat 3: lucas-fmtm ($11.54 in chips) 
Seat 4: I find you ez ($23.33 in chips) 
Seat 5: hempju1ce ($24.38 in chips) 
Seat 6: AAAcostA ($15.40 in chips) 
Do-Man22: posts small blind $0.05
lucas-fmtm: posts big blind $0.10
*** HOLE CARDS ***
I find you ez has timed out
I find you ez: folds 
hempju1ce: calls $0.10
AAAcostA: folds 
DontSleep111: folds 
Do-Man22: calls $0.05
lucas-fmtm: checks 
*** FLOP *** [4h 7s 6h]
Do-Man22: checks 
lucas-fmtm: checks 
hempju1ce: checks 
*** TURN *** [4h 7s 6h] [Kc]
Do-Man22: bets $0.40
lucas-fmtm: folds 
hempju1ce: folds 
Uncalled bet ($0.40) returned to Do-Man22
Do-Man22 collected $0.29 from pot
*** SUMMARY ***
Total pot $0.30 | Rake $0.01 
Board [4h 7s 6h Kc]
Seat 1: DontSleep111 (button) folded before Flop (didn't bet)
Seat 2: Do-Man22 (small blind) collected ($0.29)
Seat 3: lucas-fmtm (big blind) folded on the Turn
Seat 4: I find you ez folded before Flop (didn't bet)
Seat 5: hempju1ce folded on the Turn
Seat 6: AAAcostA folded before Flop (didn't bet)



PokerStars Hand #222982925530:  Hold'em No Limit ($0.05/$0.10 USD) - 2021/01/23 21:22:53 ET
Table 'Lova III' 6-max Seat #2 is the button
Seat 1: DontSleep111 ($11.12 in chips) 
Seat 2: Do-Man22 ($10.33 in chips) 
Seat 3: lucas-fmtm ($11.44 in chips) 
Seat 4: I find you ez ($23.33 in chips) 
Seat 5: hempju1ce ($24.28 in chips) 
Seat 6: AAAcostA ($15.40 in chips) 
lucas-fmtm: posts small blind $0.05
I find you ez: posts big blind $0.10
*** HOLE CARDS ***
hempju1ce: raises $0.10 to $0.20
AAAcostA: folds 
DontSleep111: folds 
Do-Man22: calls $0.20
lucas-fmtm: folds 
I find you ez: raises $0.85 to $1.05
hempju1ce: folds 
Do-Man22: calls $0.85
*** FLOP *** [2h 4s 5h]
I find you ez: bets $0.75
Do-Man22: calls $0.75
*** TURN *** [2h 4s 5h] [Qd]
I find you ez: bets $2.45
Do-Man22: raises $2.55 to $5
I find you ez: calls $2.55
*** RIVER *** [2h 4s 5h Qd] [9d]
I find you ez: checks 
Do-Man22: checks 
*** SHOW DOWN ***
I find you ez: shows [Js Jc] (a pair of Jacks)
Do-Man22: mucks hand 
I find you ez collected $13.23 from pot
*** SUMMARY ***
Total pot $13.85 | Rake $0.62 
Board [2h 4s 5h Qd 9d]
Seat 1: DontSleep111 folded before Flop (didn't bet)
Seat 2: Do-Man22 (button) mucked
Seat 3: lucas-fmtm (small blind) folded before Flop
Seat 4: I find you ez (big blind) showed [Js Jc] and won ($13.23) with a pair of Jacks
Seat 5: hempju1ce folded before Flop
Seat 6: AAAcostA folded before Flop (didn't bet)



PokerStars Hand #222982952324:  Hold'em No Limit ($0.05/$0.10 USD) - 2021/01/23 21:23:43 ET
Table 'Lova III' 6-max Seat #3 is the button
Seat 1: DontSleep111 ($11.12 in chips) 
Seat 2: Do-Man22 ($3.53 in chips) 
Seat 3: lucas-fmtm ($11.39 in chips) 
Seat 4: I find you ez ($29.76 in chips) 
Seat 5: hempju1ce ($24.08 in chips) 
Seat 6: AAAcostA ($15.40 in chips) 
I find you ez: posts small blind $0.05
hempju1ce: posts big blind $0.10
*** HOLE CARDS ***
AAAcostA: folds 
DontSleep111: raises $0.15 to $0.25
Do-Man22: folds 
Do-Man22 leaves the table
lucas-fmtm: folds 
pudge.3096 joins the table at seat #2 
I find you ez: folds 
hempju1ce: calls $0.15
*** FLOP *** [Jh Ad 6c]
pudge.3096 leaves the table
hempju1ce: checks 
DontSleep111: checks 
*** TURN *** [Jh Ad 6c] [3c]
hempju1ce: bets $0.10
DontSleep111: folds 
Uncalled bet ($0.10) returned to hempju1ce
hempju1ce collected $0.53 from pot
hempju1ce: doesn't show hand 
*** SUMMARY ***
Total pot $0.55 | Rake $0.02 
Board [Jh Ad 6c 3c]
Seat 1: DontSleep111 folded on the Turn
Seat 2: Do-Man22 folded before Flop (didn't bet)
Seat 3: lucas-fmtm (button) folded before Flop (didn't bet)
Seat 4: I find you ez (small blind) folded before Flop
Seat 5: hempju1ce (big blind) collected ($0.53)
Seat 6: AAAcostA folded before Flop (didn't bet)



PokerStars Hand #222982969448:  Hold'em No Limit ($0.05/$0.10 USD) - 2021/01/23 21:24:08 ET
Table 'Lova III' 6-max Seat #4 is the button
Seat 1: DontSleep111 ($10.87 in chips) 
Seat 3: lucas-fmtm ($11.39 in chips) 
Seat 4: I find you ez ($29.71 in chips) 
Seat 5: hempju1ce ($24.36 in chips) 
Seat 6: AAAcostA ($15.40 in chips) 
hempju1ce: posts small blind $0.05
AAAcostA: posts big blind $0.10
*** HOLE CARDS ***
DontSleep111: raises $0.15 to $0.25
lucas-fmtm: folds 
I find you ez: folds 
hempju1ce: folds 
AAAcostA: calls $0.15
*** FLOP *** [Js 8s 4s]
AAAcostA: checks 
DontSleep111: bets $0.13
AAAcostA: folds 
Uncalled bet ($0.13) returned to DontSleep111
DontSleep111 collected $0.53 from pot
DontSleep111: doesn't show hand 
*** SUMMARY ***
Total pot $0.55 | Rake $0.02 
Board [Js 8s 4s]
Seat 1: DontSleep111 collected ($0.53)
Seat 3: lucas-fmtm folded before Flop (didn't bet)
Seat 4: I find you ez (button) folded before Flop (didn't bet)
Seat 5: hempju1ce (small blind) folded before Flop
Seat 6: AAAcostA (big blind) folded on the Flop



PokerStars Hand #222982984479:  Hold'em No Limit ($0.05/$0.10 USD) - 2021/01/23 21:24:46 ET
Table 'Lova III' 6-max Seat #5 is the button
Seat 1: DontSleep111 ($11.15 in chips) 
Seat 3: lucas-fmtm ($11.39 in chips) 
Seat 4: I find you ez ($29.71 in chips) 
Seat 5: hempju1ce ($24.31 in chips) 
Seat 6: AAAcostA ($15.15 in chips) 
AAAcostA: posts small blind $0.05
DontSleep111: posts big blind $0.10
*** HOLE CARDS ***
lucas-fmtm: folds 
I find you ez: folds 
hempju1ce: raises $0.20 to $0.30
AAAcostA: raises $0.60 to $0.90
DontSleep111: folds 
hempju1ce: folds 
Uncalled bet ($0.60) returned to AAAcostA
AAAcostA collected $0.70 from pot
AAAcostA: doesn't show hand 
*** SUMMARY ***
Total pot $0.70 | Rake $0 
Seat 1: DontSleep111 (big blind) folded before Flop
Seat 3: lucas-fmtm folded before Flop (didn't bet)
Seat 4: I find you ez folded before Flop (didn't bet)
Seat 5: hempju1ce (button) folded before Flop
Seat 6: AAAcostA (small blind) collected ($0.70)



PokerStars Hand #222982992903:  Hold'em No Limit ($0.05/$0.10 USD) - 2021/01/23 21:25:07 ET
Table 'Lova III' 6-max Seat #6 is the button
Seat 1: DontSleep111 ($11.05 in chips) 
Seat 3: lucas-fmtm ($11.39 in chips) 
Seat 4: I find you ez ($29.71 in chips) 
Seat 5: hempju1ce ($24.01 in chips) 
Seat 6: AAAcostA ($15.55 in chips) 
DontSleep111: posts small blind $0.05
lucas-fmtm: posts big blind $0.10
*** HOLE CARDS ***
I find you ez: folds 
hempju1ce: raises $0.10 to $0.20
AAAcostA: calls $0.20
DontSleep111: folds 
lucas-fmtm: calls $0.10
*** FLOP *** [3h 4s 5s]
lucas-fmtm: checks 
hempju1ce: checks 
AAAcostA: bets $0.19
lucas-fmtm: folds 
hempju1ce: calls $0.19
*** TURN *** [3h 4s 5s] [Ad]
hempju1ce: checks 
AAAcostA: bets $0.74
hempju1ce: calls $0.74
*** RIVER *** [3h 4s 5s Ad] [Ts]
hempju1ce: bets $2.40
TimikCska88 joins the table at seat #2 
AAAcostA: folds 
Uncalled bet ($2.40) returned to hempju1ce
hempju1ce collected $2.40 from pot
hempju1ce: doesn't show hand 
*** SUMMARY ***
Total pot $2.51 | Rake $0.11 
Board [3h 4s 5s Ad Ts]
Seat 1: DontSleep111 (small blind) folded before Flop
Seat 3: lucas-fmtm (big blind) folded on the Flop
Seat 4: I find you ez folded before Flop (didn't bet)
Seat 5: hempju1ce collected ($2.40)
Seat 6: AAAcostA (button) folded on the River



PokerStars Hand #222983035639:  Hold'em No Limit ($0.05/$0.10 USD) - 2021/01/23 21:26:56 ET
Table 'Lova III' 6-max Seat #1 is the button
Seat 1: DontSleep111 ($11 in chips) 
Seat 3: lucas-fmtm ($11.19 in chips) 
Seat 4: I find you ez ($29.71 in chips) 
Seat 5: hempju1ce ($25.28 in chips) 
Seat 6: AAAcostA ($14.42 in chips) 
lucas-fmtm: posts small blind $0.05
I find you ez: posts big blind $0.10
*** HOLE CARDS ***
hempju1ce: folds 
AAAcostA: raises $0.20 to $0.30
DontSleep111: calls $0.30
lucas-fmtm: folds 
I find you ez: folds 
*** FLOP *** [7h Jc 8c]
AAAcostA: checks 
DontSleep111: bets $0.50
AAAcostA: folds 
Uncalled bet ($0.50) returned to DontSleep111
DontSleep111 collected $0.72 from pot
DontSleep111: doesn't show hand 
*** SUMMARY ***
Total pot $0.75 | Rake $0.03 
Board [7h Jc 8c]
Seat 1: DontSleep111 (button) collected ($0.72)
Seat 3: lucas-fmtm (small blind) folded before Flop
Seat 4: I find you ez (big blind) folded before Flop
Seat 5: hempju1ce folded before Flop (didn't bet)
Seat 6: AAAcostA folded on the Flop



PokerStars Hand #222983045150:  Hold'em No Limit ($0.05/$0.10 USD) - 2021/01/23 21:27:20 ET
Table 'Lova III' 6-max Seat #3 is the button
Seat 1: DontSleep111 ($11.42 in chips) 
Seat 2: TimikCska88 ($6.25 in chips) 
Seat 3: lucas-fmtm ($11.14 in chips) 
Seat 4: I find you ez ($29.61 in chips) 
Seat 5: hempju1ce ($25.28 in chips) 
Seat 6: AAAcostA ($14.12 in chips) 
I find you ez: posts small blind $0.05
hempju1ce: posts big blind $0.10
TimikCska88: posts big blind $0.10
*** HOLE CARDS ***
AAAcostA: folds 
DontSleep111: raises $0.25 to $0.35
TimikCska88: folds 
lucas-fmtm: folds 
I find you ez: folds 
hempju1ce: folds 
Uncalled bet ($0.25) returned to DontSleep111
DontSleep111 collected $0.35 from pot
DontSleep111: doesn't show hand 
*** SUMMARY ***
Total pot $0.35 | Rake $0 
Seat 1: DontSleep111 collected ($0.35)
Seat 2: TimikCska88 folded before Flop (didn't bet)
Seat 3: lucas-fmtm (button) folded before Flop (didn't bet)
Seat 4: I find you ez (small blind) folded before Flop
Seat 5: hempju1ce (big blind) folded before Flop
Seat 6: AAAcostA folded before Flop (didn't bet)



PokerStars Hand #222983053827:  Hold'em No Limit ($0.05/$0.10 USD) - 2021/01/23 21:27:42 ET
Table 'Lova III' 6-max Seat #4 is the button
Seat 1: DontSleep111 ($11.67 in chips) 
Seat 2: TimikCska88 ($6.15 in chips) 
Seat 3: lucas-fmtm ($11.14 in chips) 
Seat 4: I find you ez ($29.56 in chips) 
Seat 5: hempju1ce ($25.18 in chips) 
Seat 6: AAAcostA ($14.12 in chips) 
hempju1ce: posts small blind $0.05
AAAcostA: posts big blind $0.10
*** HOLE CARDS ***
DontSleep111: folds 
TimikCska88: raises $0.10 to $0.20
lucas-fmtm: raises $0.40 to $0.60
I find you ez: folds 
hempju1ce: folds 
AAAcostA: folds 
TimikCska88: raises $5.55 to $6.15 and is all-in
lucas-fmtm: folds 
Uncalled bet ($5.55) returned to TimikCska88
TimikCska88 collected $1.35 from pot
TimikCska88: doesn't show hand 
*** SUMMARY ***
Total pot $1.35 | Rake $0 
Seat 1: DontSleep111 folded before Flop (didn't bet)
Seat 2: TimikCska88 collected ($1.35)
Seat 3: lucas-fmtm folded before Flop
Seat 4: I find you ez (button) folded before Flop (didn't bet)
Seat 5: hempju1ce (small blind) folded before Flop
Seat 6: AAAcostA (big blind) folded before Flop



PokerStars Hand #222983062115:  Hold'em No Limit ($0.05/$0.10 USD) - 2021/01/23 21:28:03 ET
Table 'Lova III' 6-max Seat #5 is the button
Seat 1: DontSleep111 ($11.67 in chips) 
Seat 2: TimikCska88 ($6.90 in chips) 
Seat 3: lucas-fmtm ($10.54 in chips) 
Seat 4: I find you ez ($29.56 in chips) 
Seat 5: hempju1ce ($25.13 in chips) 
Seat 6: AAAcostA ($14.02 in chips) 
AAAcostA: posts small blind $0.05
DontSleep111: posts big blind $0.10
*** HOLE CARDS ***
TimikCska88: raises $0.20 to $0.30
lucas-fmtm: folds 
I find you ez: folds 
hempju1ce: folds 
AAAcostA: calls $0.25
DontSleep111: calls $0.20
*** FLOP *** [Qs 4d 4c]
AAAcostA: checks 
DontSleep111: checks 
TimikCska88: bets $0.60
AAAcostA: folds 
DontSleep111: folds 
Uncalled bet ($0.60) returned to TimikCska88
TimikCska88 collected $0.86 from pot
TimikCska88: doesn't show hand 
*** SUMMARY ***
Total pot $0.90 | Rake $0.04 
Board [Qs 4d 4c]
Seat 1: DontSleep111 (big blind) folded on the Flop
Seat 2: TimikCska88 collected ($0.86)
Seat 3: lucas-fmtm folded before Flop (didn't bet)
Seat 4: I find you ez folded before Flop (didn't bet)
Seat 5: hempju1ce (button) folded before Flop (didn't bet)
Seat 6: AAAcostA (small blind) folded on the Flop



PokerStars Hand #222983076330:  Hold'em No Limit ($0.05/$0.10 USD) - 2021/01/23 21:28:40 ET
Table 'Lova III' 6-max Seat #6 is the button
Seat 1: DontSleep111 ($11.37 in chips) 
Seat 2: TimikCska88 ($7.46 in chips) 
Seat 3: lucas-fmtm ($10.54 in chips) 
Seat 4: I find you ez ($29.56 in chips) 
Seat 5: hempju1ce ($25.13 in chips) 
Seat 6: AAAcostA ($13.72 in chips) 
DontSleep111: posts small blind $0.05
TimikCska88: posts big blind $0.10
*** HOLE CARDS ***
lucas-fmtm: folds 
I find you ez: raises $0.25 to $0.35
hempju1ce: folds 
AAAcostA: folds 
DontSleep111: folds 
TimikCska88: raises $0.75 to $1.10
I find you ez: folds 
Uncalled bet ($0.75) returned to TimikCska88
TimikCska88 collected $0.75 from pot
TimikCska88: doesn't show hand 
*** SUMMARY ***
Total pot $0.75 | Rake $0 
Seat 1: DontSleep111 (small blind) folded before Flop
Seat 2: TimikCska88 (big blind) collected ($0.75)
Seat 3: lucas-fmtm folded before Flop (didn't bet)
Seat 4: I find you ez folded before Flop
Seat 5: hempju1ce folded before Flop (didn't bet)
Seat 6: AAAcostA (button) folded before Flop (didn't bet)



PokerStars Hand #222983083350:  Hold'em No Limit ($0.05/$0.10 USD) - 2021/01/23 21:28:57 ET
Table 'Lova III' 6-max Seat #1 is the button
Seat 1: DontSleep111 ($11.32 in chips) 
Seat 2: TimikCska88 ($7.86 in chips) 
Seat 3: lucas-fmtm ($10.54 in chips) 
Seat 4: I find you ez ($29.21 in chips) 
Seat 5: hempju1ce ($25.13 in chips) 
Seat 6: AAAcostA ($13.72 in chips) 
TimikCska88: posts small blind $0.05
lucas-fmtm: posts big blind $0.10
*** HOLE CARDS ***
I find you ez: raises $0.30 to $0.40
hempju1ce: folds 
AAAcostA: folds 
DontSleep111: folds 
TimikCska88: folds 
lucas-fmtm: folds 
Uncalled bet ($0.30) returned to I find you ez
I find you ez collected $0.25 from pot
I find you ez: doesn't show hand 
*** SUMMARY ***
Total pot $0.25 | Rake $0 
Seat 1: DontSleep111 (button) folded before Flop (didn't bet)
Seat 2: TimikCska88 (small blind) folded before Flop
Seat 3: lucas-fmtm (big blind) folded before Flop
Seat 4: I find you ez collected ($0.25)
Seat 5: hempju1ce folded before Flop (didn't bet)
Seat 6: AAAcostA folded before Flop (didn't bet)



PokerStars Hand #222983089847:  Hold'em No Limit ($0.05/$0.10 USD) - 2021/01/23 21:29:14 ET
Table 'Lova III' 6-max Seat #2 is the button
Seat 1: DontSleep111 ($11.32 in chips) 
Seat 2: TimikCska88 ($7.81 in chips) 
Seat 3: lucas-fmtm ($10.44 in chips) 
Seat 5: hempju1ce ($25.13 in chips) 
Seat 6: AAAcostA ($13.72 in chips) 
lucas-fmtm: posts small blind $0.05
I find you ez: is sitting out 
hempju1ce: posts big blind $0.10
*** HOLE CARDS ***
I find you ez leaves the table
AAAcostA: folds 
DontSleep111: raises $0.15 to $0.25
TimikCska88: raises $0.15 to $0.40
lucas-fmtm: folds 
hempju1ce: folds 
DontSleep111: calls $0.15
*** FLOP *** [Tc Kh Qs]
DontSleep111: checks 
TimikCska88: bets $0.46
DontSleep111: folds 
Uncalled bet ($0.46) returned to TimikCska88
TimikCska88 collected $0.91 from pot
TimikCska88: doesn't show hand 
*** SUMMARY ***
Total pot $0.95 | Rake $0.04 
Board [Tc Kh Qs]
Seat 1: DontSleep111 folded on the Flop
Seat 2: TimikCska88 (button) collected ($0.91)
Seat 3: lucas-fmtm (small blind) folded before Flop
Seat 5: hempju1ce (big blind) folded before Flop
Seat 6: AAAcostA folded before Flop (didn't bet)



PokerStars Hand #222983099888:  Hold'em No Limit ($0.05/$0.10 USD) - 2021/01/23 21:29:40 ET
Table 'Lova III' 6-max Seat #3 is the button
Seat 1: DontSleep111 ($10.92 in chips) 
Seat 2: TimikCska88 ($8.32 in chips) 
Seat 3: lucas-fmtm ($10.39 in chips) 
Seat 5: hempju1ce ($25.03 in chips) 
Seat 6: AAAcostA ($13.72 in chips) 
hempju1ce: posts small blind $0.05
AAAcostA: posts big blind $0.10
*** HOLE CARDS ***
DontSleep111: folds 
TimikCska88: folds 
lucas-fmtm: raises $0.20 to $0.30
hempju1ce: calls $0.25
AAAcostA: calls $0.20
*** FLOP *** [Qc 8d Ts]
hempju1ce: checks 
AAAcostA: checks 
lucas-fmtm: bets $0.58
hempju1ce: folds 
AAAcostA: calls $0.58
*** TURN *** [Qc 8d Ts] [Jc]
AAAcostA: checks 
lucas-fmtm: checks 
*** RIVER *** [Qc 8d Ts Jc] [Ks]
AAAcostA: bets $2.96
lucas-fmtm: folds 
Uncalled bet ($2.96) returned to AAAcostA
AAAcostA collected $1.97 from pot
AAAcostA: doesn't show hand 
*** SUMMARY ***
Total pot $2.06 | Rake $0.09 
Board [Qc 8d Ts Jc Ks]
Seat 1: DontSleep111 folded before Flop (didn't bet)
Seat 2: TimikCska88 folded before Flop (didn't bet)
Seat 3: lucas-fmtm (button) folded on the River
Seat 5: hempju1ce (small blind) folded on the Flop
Seat 6: AAAcostA (big blind) collected ($1.97)



PokerStars Hand #222983123827:  Hold'em No Limit ($0.05/$0.10 USD) - 2021/01/23 21:30:40 ET
Table 'Lova III' 6-max Seat #5 is the button
Seat 1: DontSleep111 ($10.92 in chips) 
Seat 2: TimikCska88 ($8.32 in chips) 
Seat 3: lucas-fmtm ($9.51 in chips) 
Seat 5: hempju1ce ($24.73 in chips) 
Seat 6: AAAcostA ($14.81 in chips) 
AAAcostA: posts small blind $0.05
DontSleep111: posts big blind $0.10
*** HOLE CARDS ***
TimikCska88: raises $0.20 to $0.30
lucas-fmtm: folds 
hempju1ce: calls $0.30
AAAcostA: calls $0.25
DontSleep111: folds 
*** FLOP *** [Kh Ts 2s]
the_humster joins the table at seat #4 
AAAcostA: checks 
TimikCska88: bets $0.20
hempju1ce: calls $0.20
AAAcostA: folds 
*** TURN *** [Kh Ts 2s] [3h]
TimikCska88: bets $0.30
hempju1ce: calls $0.30
*** RIVER *** [Kh Ts 2s 3h] [Th]
TimikCska88: bets $0.50
hempju1ce: raises $0.50 to $1
TimikCska88: raises $6.52 to $7.52 and is all-in
hempju1ce: calls $6.52
*** SHOW DOWN ***
TimikCska88: shows [Qd Tc] (three of a kind, Tens)
hempju1ce: shows [Ah 2h] (a flush, Ace high)
hempju1ce collected $16.27 from pot
*** SUMMARY ***
Total pot $17.04 | Rake $0.77 
Board [Kh Ts 2s 3h Th]
Seat 1: DontSleep111 (big blind) folded before Flop
Seat 2: TimikCska88 showed [Qd Tc] and lost with three of a kind, Tens
Seat 3: lucas-fmtm folded before Flop (didn't bet)
Seat 5: hempju1ce (button) showed [Ah 2h] and won ($16.27) with a flush, Ace high
Seat 6: AAAcostA (small blind) folded on the Flop



PokerStars Hand #222983139505:  Hold'em No Limit ($0.05/$0.10 USD) - 2021/01/23 21:31:20 ET
Table 'Lova III' 6-max Seat #6 is the button
Seat 1: DontSleep111 ($10.82 in chips) 
Seat 3: lucas-fmtm ($9.51 in chips) 
Seat 5: hempju1ce ($32.68 in chips) 
Seat 6: AAAcostA ($14.51 in chips) 
DontSleep111: posts small blind $0.05
lucas-fmtm: posts big blind $0.10
the_humster: sits out 
*** HOLE CARDS ***
hempju1ce: folds 
TimikCska88 leaves the table
AAAcostA: folds 
DontSleep111: folds 
Uncalled bet ($0.05) returned to lucas-fmtm
lucas-fmtm collected $0.10 from pot
*** SUMMARY ***
Total pot $0.10 | Rake $0 
Seat 1: DontSleep111 (small blind) folded before Flop
Seat 3: lucas-fmtm (big blind) collected ($0.10)
Seat 5: hempju1ce folded before Flop (didn't bet)
Seat 6: AAAcostA (button) folded before Flop (didn't bet)



PokerStars Hand #222983144301:  Hold'em No Limit ($0.05/$0.10 USD) - 2021/01/23 21:31:32 ET
Table 'Lova III' 6-max Seat #1 is the button
Seat 1: DontSleep111 ($10.77 in chips) 
Seat 3: lucas-fmtm ($9.56 in chips) 
Seat 4: the_humster ($10 in chips) 
Seat 5: hempju1ce ($32.68 in chips) 
Seat 6: AAAcostA ($14.51 in chips) 
lucas-fmtm: posts small blind $0.05
the_humster: posts big blind $0.10
*** HOLE CARDS ***
hempju1ce: folds 
AAAcostA: folds 
DontSleep111: raises $0.15 to $0.25
lucas-fmtm: folds 
the_humster: folds 
Uncalled bet ($0.15) returned to DontSleep111
DontSleep111 collected $0.25 from pot
DontSleep111: doesn't show hand 
*** SUMMARY ***
Total pot $0.25 | Rake $0 
Seat 1: DontSleep111 (button) collected ($0.25)
Seat 3: lucas-fmtm (small blind) folded before Flop
Seat 4: the_humster (big blind) folded before Flop
Seat 5: hempju1ce folded before Flop (didn't bet)
Seat 6: AAAcostA folded before Flop (didn't bet)



PokerStars Hand #222983150001:  Hold'em No Limit ($0.05/$0.10 USD) - 2021/01/23 21:31:47 ET
Table 'Lova III' 6-max Seat #3 is the button
Seat 1: DontSleep111 ($10.92 in chips) 
Seat 3: lucas-fmtm ($9.51 in chips) 
Seat 4: the_humster ($10 in chips) 
Seat 5: hempju1ce ($32.68 in chips) 
Seat 6: AAAcostA ($14.51 in chips) 
the_humster: posts small blind $0.05
hempju1ce: posts big blind $0.10
*** HOLE CARDS ***
AAAcostA: folds 
DontSleep111: raises $0.15 to $0.25
lucas-fmtm: folds 
the_humster: calls $0.20
hempju1ce: calls $0.15
*** FLOP *** [9h 7h 2c]
the_humster: checks 
hempju1ce: checks 
DontSleep111: checks 
*** TURN *** [9h 7h 2c] [6c]
the_humster: checks 
hempju1ce: checks 
DontSleep111: checks 
*** RIVER *** [9h 7h 2c 6c] [9d]
the_humster: checks 
hempju1ce: checks 
DontSleep111: checks 
*** SHOW DOWN ***
the_humster: shows [Jc Ts] (a pair of Nines)
hempju1ce: shows [Qs 6s] (two pair, Nines and Sixes)
DontSleep111: mucks hand 
hempju1ce collected $0.72 from pot
*** SUMMARY ***
Total pot $0.75 | Rake $0.03 
Board [9h 7h 2c 6c 9d]
Seat 1: DontSleep111 mucked
Seat 3: lucas-fmtm (button) folded before Flop (didn't bet)
Seat 4: the_humster (small blind) showed [Jc Ts] and lost with a pair of Nines
Seat 5: hempju1ce (big blind) showed [Qs 6s] and won ($0.72) with two pair, Nines and Sixes
Seat 6: AAAcostA folded before Flop (didn't bet)



PokerStars Hand #222983167001:  Hold'em No Limit ($0.05/$0.10 USD) - 2021/01/23 21:32:29 ET
Table 'Lova III' 6-max Seat #4 is the button
Seat 1: DontSleep111 ($10.67 in chips) 
Seat 3: lucas-fmtm ($9.51 in chips) 
Seat 4: the_humster ($10 in chips) 
Seat 5: hempju1ce ($33.15 in chips) 
Seat 6: AAAcostA ($14.51 in chips) 
hempju1ce: posts small blind $0.05
AAAcostA: posts big blind $0.10
*** HOLE CARDS ***
DontSleep111: folds 
lucas-fmtm: folds 
the_humster: folds 
hempju1ce: calls $0.05
AAAcostA: raises $0.30 to $0.40
hempju1ce: calls $0.30
*** FLOP *** [Jh 8d 7s]
hempju1ce: checks 
AAAcostA: bets $0.40
hempju1ce: calls $0.40
*** TURN *** [Jh 8d 7s] [Ts]
hempju1ce: checks 
AAAcostA: checks 
*** RIVER *** [Jh 8d 7s Ts] [Th]
hempju1ce: bets $1.53
AAAcostA: raises $3.44 to $4.97
hempju1ce: calls $3.44
*** SHOW DOWN ***
AAAcostA: shows [9s 9d] (a straight, Seven to Jack)
hempju1ce: shows [Kh 9c] (a straight, Seven to Jack)
hempju1ce collected $5.51 from pot
AAAcostA collected $5.51 from pot
*** SUMMARY ***
Total pot $11.54 | Rake $0.52 
Board [Jh 8d 7s Ts Th]
Seat 1: DontSleep111 folded before Flop (didn't bet)
Seat 3: lucas-fmtm folded before Flop (didn't bet)
Seat 4: the_humster (button) folded before Flop (didn't bet)
Seat 5: hempju1ce (small blind) showed [Kh 9c] and won ($5.51) with a straight, Seven to Jack
Seat 6: AAAcostA (big blind) showed [9s 9d] and won ($5.51) with a straight, Seven to Jack



PokerStars Hand #222983181963:  Hold'em No Limit ($0.05/$0.10 USD) - 2021/01/23 21:33:07 ET
Table 'Lova III' 6-max Seat #5 is the button
Seat 1: DontSleep111 ($10.67 in chips) 
Seat 3: lucas-fmtm ($9.51 in chips) 
Seat 4: the_humster ($10 in chips) 
Seat 5: hempju1ce ($32.89 in chips) 
Seat 6: AAAcostA ($14.25 in chips) 
AAAcostA: posts small blind $0.05
DontSleep111: posts big blind $0.10
*** HOLE CARDS ***
lucas-fmtm: folds 
the_humster: folds 
hempju1ce: folds 
AAAcostA: folds 
Uncalled bet ($0.05) returned to DontSleep111
DontSleep111 collected $0.10 from pot
DontSleep111: doesn't show hand 
*** SUMMARY ***
Total pot $0.10 | Rake $0 
Seat 1: DontSleep111 (big blind) collected ($0.10)
Seat 3: lucas-fmtm folded before Flop (didn't bet)
Seat 4: the_humster folded before Flop (didn't bet)
Seat 5: hempju1ce (button) folded before Flop (didn't bet)
Seat 6: AAAcostA (small blind) folded before Flop



PokerStars Hand #222983187134:  Hold'em No Limit ($0.05/$0.10 USD) - 2021/01/23 21:33:21 ET
Table 'Lova III' 6-max Seat #6 is the button
Seat 1: DontSleep111 ($10.72 in chips) 
Seat 3: lucas-fmtm ($9.51 in chips) 
Seat 4: the_humster ($10 in chips) 
Seat 5: hempju1ce ($32.89 in chips) 
Seat 6: AAAcostA ($14.20 in chips) 
DontSleep111: posts small blind $0.05
lucas-fmtm: posts big blind $0.10
*** HOLE CARDS ***
the_humster: folds 
hempju1ce: raises $0.20 to $0.30
AAAcostA: calls $0.30
DontSleep111: raises $1.20 to $1.50
lucas-fmtm: folds 
hempju1ce: folds 
AAAcostA: folds 
Uncalled bet ($1.20) returned to DontSleep111
DontSleep111 collected $1 from pot
DontSleep111: doesn't show hand 
*** SUMMARY ***
Total pot $1 | Rake $0 
Seat 1: DontSleep111 (small blind) collected ($1)
Seat 3: lucas-fmtm (big blind) folded before Flop
Seat 4: the_humster folded before Flop (didn't bet)
Seat 5: hempju1ce folded before Flop
Seat 6: AAAcostA (button) folded before Flop



PokerStars Hand #222983196338:  Hold'em No Limit ($0.05/$0.10 USD) - 2021/01/23 21:33:44 ET
Table 'Lova III' 6-max Seat #1 is the button
Seat 1: DontSleep111 ($11.42 in chips) 
Seat 3: lucas-fmtm ($9.41 in chips) 
Seat 4: the_humster ($10 in chips) 
Seat 5: hempju1ce ($32.59 in chips) 
Seat 6: AAAcostA ($13.90 in chips) 
lucas-fmtm: posts small blind $0.05
the_humster: posts big blind $0.10
*** HOLE CARDS ***
hempju1ce: folds 
AAAcostA: folds 
DontSleep111: raises $0.15 to $0.25
hempju1ce leaves the table
lucas-fmtm: folds 
the_humster: folds 
Uncalled bet ($0.15) returned to DontSleep111
DontSleep111 collected $0.25 from pot
DontSleep111: doesn't show hand 
*** SUMMARY ***
Total pot $0.25 | Rake $0 
Seat 1: DontSleep111 (button) collected ($0.25)
Seat 3: lucas-fmtm (small blind) folded before Flop
Seat 4: the_humster (big blind) folded before Flop
Seat 5: hempju1ce folded before Flop (didn't bet)
Seat 6: AAAcostA folded before Flop (didn't bet)



PokerStars Hand #222983203123:  Hold'em No Limit ($0.05/$0.10 USD) - 2021/01/23 21:33:55 ET
Table 'Lova III' 6-max Seat #3 is the button
Seat 1: DontSleep111 ($11.57 in chips) 
Seat 3: lucas-fmtm ($9.36 in chips) 
Seat 4: the_humster ($10 in chips) 
Seat 6: AAAcostA ($13.90 in chips) 
the_humster: posts small blind $0.05
AAAcostA: posts big blind $0.10
*** HOLE CARDS ***
DontSleep111: folds 
lucas-fmtm: raises $0.20 to $0.30
the_humster: raises $0.60 to $0.90
AAAcostA: folds 
lucas-fmtm: folds 
Uncalled bet ($0.60) returned to the_humster
the_humster collected $0.70 from pot
the_humster: doesn't show hand 
*** SUMMARY ***
Total pot $0.70 | Rake $0 
Seat 1: DontSleep111 folded before Flop (didn't bet)
Seat 3: lucas-fmtm (button) folded before Flop
Seat 4: the_humster (small blind) collected ($0.70)
Seat 6: AAAcostA (big blind) folded before Flop



PokerStars Hand #222983210267:  Hold'em No Limit ($0.05/$0.10 USD) - 2021/01/23 21:34:13 ET
Table 'Lova III' 6-max Seat #4 is the button
Seat 1: DontSleep111 ($11.57 in chips) 
Seat 3: lucas-fmtm ($9.06 in chips) 
Seat 4: the_humster ($10.40 in chips) 
Seat 6: AAAcostA ($13.80 in chips) 
AAAcostA: posts small blind $0.05
DontSleep111: posts big blind $0.10
*** HOLE CARDS ***
lucas-fmtm: raises $0.20 to $0.30
the_humster: folds 
AAAcostA: folds 
DontSleep111: folds 
Uncalled bet ($0.20) returned to lucas-fmtm
lucas-fmtm collected $0.25 from pot
*** SUMMARY ***
Total pot $0.25 | Rake $0 
Seat 1: DontSleep111 (big blind) folded before Flop
Seat 3: lucas-fmtm collected ($0.25)
Seat 4: the_humster (button) folded before Flop (didn't bet)
Seat 6: AAAcostA (small blind) folded before Flop



PokerStars Hand #222983214618:  Hold'em No Limit ($0.05/$0.10 USD) - 2021/01/23 21:34:24 ET
Table 'Lova III' 6-max Seat #6 is the button
Seat 1: DontSleep111 ($11.47 in chips) 
Seat 3: lucas-fmtm ($9.21 in chips) 
Seat 4: the_humster ($10.40 in chips) 
Seat 6: AAAcostA ($13.75 in chips) 
DontSleep111: posts small blind $0.05
lucas-fmtm: posts big blind $0.10
*** HOLE CARDS ***
the_humster: folds 
AAAcostA: folds 
DontSleep111: folds 
Uncalled bet ($0.05) returned to lucas-fmtm
lucas-fmtm collected $0.10 from pot
*** SUMMARY ***
Total pot $0.10 | Rake $0 
Seat 1: DontSleep111 (small blind) folded before Flop
Seat 3: lucas-fmtm (big blind) collected ($0.10)
Seat 4: the_humster folded before Flop (didn't bet)
Seat 6: AAAcostA (button) folded before Flop (didn't bet)



PokerStars Hand #222983219152:  Hold'em No Limit ($0.05/$0.10 USD) - 2021/01/23 21:34:36 ET
Table 'Lova III' 6-max Seat #1 is the button
Seat 1: DontSleep111 ($11.42 in chips) 
Seat 3: lucas-fmtm ($9.26 in chips) 
Seat 4: the_humster ($10.40 in chips) 
Seat 6: AAAcostA ($13.75 in chips) 
lucas-fmtm: posts small blind $0.05
the_humster: posts big blind $0.10
*** HOLE CARDS ***
AAAcostA: folds 
DontSleep111: folds 
lucas-fmtm: raises $0.20 to $0.30
the_humster: folds 
Uncalled bet ($0.20) returned to lucas-fmtm
lucas-fmtm collected $0.20 from pot
*** SUMMARY ***
Total pot $0.20 | Rake $0 
Seat 1: DontSleep111 (button) folded before Flop (didn't bet)
Seat 3: lucas-fmtm (small blind) collected ($0.20)
Seat 4: the_humster (big blind) folded before Flop
Seat 6: AAAcostA folded before Flop (didn't bet)



PokerStars Hand #222983223638:  Hold'em No Limit ($0.05/$0.10 USD) - 2021/01/23 21:34:47 ET
Table 'Lova III' 6-max Seat #3 is the button
Seat 1: DontSleep111 ($11.42 in chips) 
Seat 3: lucas-fmtm ($9.36 in chips) 
Seat 4: the_humster ($10.30 in chips) 
Seat 6: AAAcostA ($13.75 in chips) 
the_humster: posts small blind $0.05
AAAcostA: posts big blind $0.10
*** HOLE CARDS ***
DontSleep111: folds 
lucas-fmtm: raises $0.20 to $0.30
the_humster: calls $0.25
AAAcostA: folds 
*** FLOP *** [3d 8d Kc]
the_humster: checks 
lucas-fmtm: bets $0.34
the_humster: calls $0.34
*** TURN *** [3d 8d Kc] [Ac]
the_humster: checks 
lucas-fmtm: bets $0.88
the_humster: folds 
Uncalled bet ($0.88) returned to lucas-fmtm
lucas-fmtm collected $1.32 from pot
*** SUMMARY ***
Total pot $1.38 | Rake $0.06 
Board [3d 8d Kc Ac]
Seat 1: DontSleep111 folded before Flop (didn't bet)
Seat 3: lucas-fmtm (button) collected ($1.32)
Seat 4: the_humster (small blind) folded on the Turn
Seat 6: AAAcostA (big blind) folded before Flop



PokerStars Hand #222983238344:  Hold'em No Limit ($0.05/$0.10 USD) - 2021/01/23 21:35:24 ET
Table 'Lova III' 6-max Seat #4 is the button
Seat 1: DontSleep111 ($11.42 in chips) 
Seat 3: lucas-fmtm ($10.04 in chips) 
Seat 4: the_humster ($10 in chips) 
Seat 6: AAAcostA ($13.65 in chips) 
AAAcostA: posts small blind $0.05
DontSleep111: posts big blind $0.10
*** HOLE CARDS ***
lucas-fmtm: folds 
lucas-fmtm leaves the table
the_humster: folds 
AAAcostA: raises $0.20 to $0.30
0nix770 joins the table at seat #2 
DontSleep111: folds 
Uncalled bet ($0.20) returned to AAAcostA
AAAcostA collected $0.20 from pot
AAAcostA: doesn't show hand 
*** SUMMARY ***
Total pot $0.20 | Rake $0 
Seat 1: DontSleep111 (big blind) folded before Flop
Seat 3: lucas-fmtm folded before Flop (didn't bet)
Seat 4: the_humster (button) folded before Flop (didn't bet)
Seat 6: AAAcostA (small blind) collected ($0.20)



PokerStars Hand #222983246163:  Hold'em No Limit ($0.05/$0.10 USD) - 2021/01/23 21:35:44 ET
Table 'Lova III' 6-max Seat #1 is the button
Seat 1: DontSleep111 ($11.32 in chips) 
Seat 4: the_humster ($10 in chips) 
DontSleep111: posts small blind $0.05
the_humster: posts big blind $0.10
*** HOLE CARDS ***
DontSleep111: folds 
Uncalled bet ($0.05) returned to the_humster
0nix770 leaves the table
the_humster collected $0.10 from pot
the_humster: doesn't show hand 
*** SUMMARY ***
Total pot $0.10 | Rake $0 
Seat 1: DontSleep111 (button) (small blind) folded before Flop
Seat 4: the_humster (big blind) collected ($0.10)



PokerStars Hand #222980998533:  Hold'em No Limit ($0.05/$0.10 USD) - 2021/01/23 20:08:00 ET
Table 'Lova III' 6-max Seat #1 is the button
Seat 1: Rosska(Rus) ($10.78 in chips) 
Seat 2: saitam_06 ($10.05 in chips) 
Seat 4: manganito17 ($10 in chips) 
Seat 5: hempju1ce ($28.10 in chips) 
Seat 6: alexos04 ($14.60 in chips) 
saitam_06: posts small blind $0.05
manganito17: posts big blind $0.10
*** HOLE CARDS ***
hempju1ce: calls $0.10
alexos04: raises $0.40 to $0.50
Rosska(Rus): folds 
saitam_06: folds 
manganito17: folds 
hempju1ce: folds 
Uncalled bet ($0.40) returned to alexos04
alexos04 collected $0.35 from pot
cwie210 was removed from the table for failing to post
cwie210 leaves the table
alexos04: doesn't show hand 
*** SUMMARY ***
Total pot $0.35 | Rake $0 
Seat 1: Rosska(Rus) (button) folded before Flop (didn't bet)
Seat 2: saitam_06 (small blind) folded before Flop
Seat 4: manganito17 (big blind) folded before Flop
Seat 5: hempju1ce folded before Flop
Seat 6: alexos04 collected ($0.35)



PokerStars Hand #222981007742:  Hold'em No Limit ($0.05/$0.10 USD) - 2021/01/23 20:08:20 ET
Table 'Lova III' 6-max Seat #2 is the button
Seat 1: Rosska(Rus) ($10.78 in chips) 
Seat 2: saitam_06 ($10 in chips) 
Seat 4: manganito17 ($10 in chips) 
Seat 5: hempju1ce ($28 in chips) 
Seat 6: alexos04 ($14.85 in chips) 
manganito17: posts small blind $0.05
hempju1ce: posts big blind $0.10
*** HOLE CARDS ***
alexos04: folds 
Rosska(Rus): folds 
saitam_06: raises $0.15 to $0.25
manganito17: folds 
hempju1ce: folds 
Uncalled bet ($0.15) returned to saitam_06
saitam_06 collected $0.25 from pot
saitam_06: doesn't show hand 
*** SUMMARY ***
Total pot $0.25 | Rake $0 
Seat 1: Rosska(Rus) folded before Flop (didn't bet)
Seat 2: saitam_06 (button) collected ($0.25)
Seat 4: manganito17 (small blind) folded before Flop
Seat 5: hempju1ce (big blind) folded before Flop
Seat 6: alexos04 folded before Flop (didn't bet)



PokerStars Hand #222981023338:  Hold'em No Limit ($0.05/$0.10 USD) - 2021/01/23 20:08:33 ET
Table 'Lova III' 6-max Seat #4 is the button
Seat 1: Rosska(Rus) ($10.78 in chips) 
Seat 2: saitam_06 ($10.15 in chips) 
Seat 4: manganito17 ($10 in chips) 
Seat 5: hempju1ce ($27.90 in chips) 
hempju1ce: posts small blind $0.05
alexos04: is sitting out 
Rosska(Rus): posts big blind $0.10
*** HOLE CARDS ***
don24 joins the table at seat #3 
alexos04 leaves the table
saitam_06: folds 
manganito17: folds 
hempju1ce: calls $0.05
Rosska(Rus): raises $0.30 to $0.40
hempju1ce: calls $0.30
*** FLOP *** [5h Kh Tc]
KramSS joins the table at seat #6 
hempju1ce: bets $0.38
Rosska(Rus): raises $0.97 to $1.35
hempju1ce: folds 
Uncalled bet ($0.97) returned to Rosska(Rus)
Rosska(Rus) collected $1.49 from pot
Rosska(Rus): doesn't show hand 
*** SUMMARY ***
Total pot $1.56 | Rake $0.07 
Board [5h Kh Tc]
Seat 1: Rosska(Rus) (big blind) collected ($1.49)
Seat 2: saitam_06 folded before Flop (didn't bet)
Seat 4: manganito17 (button) folded before Flop (didn't bet)
Seat 5: hempju1ce (small blind) folded on the Flop



PokerStars Hand #222981038847:  Hold'em No Limit ($0.05/$0.10 USD) - 2021/01/23 20:09:07 ET
Table 'Lova III' 6-max Seat #5 is the button
Seat 1: Rosska(Rus) ($11.49 in chips) 
Seat 2: saitam_06 ($10.15 in chips) 
Seat 3: don24 ($10 in chips) 
Seat 4: manganito17 ($10 in chips) 
Seat 5: hempju1ce ($27.12 in chips) 
Rosska(Rus): posts small blind $0.05
saitam_06: posts big blind $0.10
don24: posts big blind $0.10
*** HOLE CARDS ***
don24: checks 
manganito17: folds 
hempju1ce: folds 
Rosska(Rus): folds 
saitam_06: checks 
*** FLOP *** [6h 8c Qh]
saitam_06: checks 
don24: checks 
*** TURN *** [6h 8c Qh] [Tc]
saitam_06: bets $0.18
don24: folds 
Uncalled bet ($0.18) returned to saitam_06
saitam_06 collected $0.24 from pot
saitam_06: doesn't show hand 
*** SUMMARY ***
Total pot $0.25 | Rake $0.01 
Board [6h 8c Qh Tc]
Seat 1: Rosska(Rus) (small blind) folded before Flop
Seat 2: saitam_06 (big blind) collected ($0.24)
Seat 3: don24 folded on the Turn (didn't bet)
Seat 4: manganito17 folded before Flop (didn't bet)
Seat 5: hempju1ce (button) folded before Flop (didn't bet)



PokerStars Hand #222981052311:  Hold'em No Limit ($0.05/$0.10 USD) - 2021/01/23 20:09:37 ET
Table 'Lova III' 6-max Seat #1 is the button
Seat 1: Rosska(Rus) ($11.44 in chips) 
Seat 2: saitam_06 ($10.29 in chips) 
Seat 3: don24 ($9.90 in chips) 
Seat 4: manganito17 ($10 in chips) 
Seat 5: hempju1ce ($27.12 in chips) 
saitam_06: posts small blind $0.05
don24: posts big blind $0.10
KramSS: sits out 
*** HOLE CARDS ***
manganito17: folds 
hempju1ce: raises $0.20 to $0.30
Rosska(Rus): folds 
saitam_06: folds 
don24: folds 
Uncalled bet ($0.20) returned to hempju1ce
hempju1ce collected $0.25 from pot
hempju1ce: doesn't show hand 
*** SUMMARY ***
Total pot $0.25 | Rake $0 
Seat 1: Rosska(Rus) (button) folded before Flop (didn't bet)
Seat 2: saitam_06 (small blind) folded before Flop
Seat 3: don24 (big blind) folded before Flop
Seat 4: manganito17 folded before Flop (didn't bet)
Seat 5: hempju1ce collected ($0.25)



PokerStars Hand #222981061647:  Hold'em No Limit ($0.05/$0.10 USD) - 2021/01/23 20:09:57 ET
Table 'Lova III' 6-max Seat #2 is the button
Seat 1: Rosska(Rus) ($11.44 in chips) 
Seat 2: saitam_06 ($10.24 in chips) 
Seat 3: don24 ($9.80 in chips) 
Seat 4: manganito17 ($10 in chips) 
Seat 5: hempju1ce ($27.27 in chips) 
don24: posts small blind $0.05
manganito17: posts big blind $0.10
KramSS: sits out 
*** HOLE CARDS ***
hempju1ce has timed out
hempju1ce: folds 
Rosska(Rus): raises $0.20 to $0.30
saitam_06: folds 
don24: folds 
manganito17: folds 
Uncalled bet ($0.20) returned to Rosska(Rus)
Rosska(Rus) collected $0.25 from pot
Rosska(Rus): doesn't show hand 
*** SUMMARY ***
Total pot $0.25 | Rake $0 
Seat 1: Rosska(Rus) collected ($0.25)
Seat 2: saitam_06 (button) folded before Flop (didn't bet)
Seat 3: don24 (small blind) folded before Flop
Seat 4: manganito17 (big blind) folded before Flop
Seat 5: hempju1ce folded before Flop (didn't bet)



PokerStars Hand #222981072305:  Hold'em No Limit ($0.05/$0.10 USD) - 2021/01/23 20:10:21 ET
Table 'Lova III' 6-max Seat #3 is the button
Seat 1: Rosska(Rus) ($11.59 in chips) 
Seat 2: saitam_06 ($10.24 in chips) 
Seat 3: don24 ($9.75 in chips) 
Seat 4: manganito17 ($10 in chips) 
Seat 6: KramSS ($10 in chips) 
manganito17: posts small blind $0.05
KramSS: posts big blind $0.10
*** HOLE CARDS ***
Rosska(Rus): folds 
saitam_06: folds 
don24: folds 
manganito17: folds 
Uncalled bet ($0.05) returned to KramSS
KramSS collected $0.10 from pot
KramSS: doesn't show hand 
*** SUMMARY ***
Total pot $0.10 | Rake $0 
Seat 1: Rosska(Rus) folded before Flop (didn't bet)
Seat 2: saitam_06 folded before Flop (didn't bet)
Seat 3: don24 (button) folded before Flop (didn't bet)
Seat 4: manganito17 (small blind) folded before Flop
Seat 6: KramSS (big blind) collected ($0.10)



PokerStars Hand #222981076409:  Hold'em No Limit ($0.05/$0.10 USD) - 2021/01/23 20:10:30 ET
Table 'Lova III' 6-max Seat #4 is the button
Seat 1: Rosska(Rus) ($11.59 in chips) 
Seat 2: saitam_06 ($10.24 in chips) 
Seat 3: don24 ($9.75 in chips) 
Seat 4: manganito17 ($10 in chips) 
Seat 6: KramSS ($10.05 in chips) 
KramSS: posts small blind $0.05
Rosska(Rus): posts big blind $0.10
*** HOLE CARDS ***
saitam_06: folds 
don24: raises $0.10 to $0.20
manganito17: folds 
KramSS: raises $0.70 to $0.90
Rosska(Rus): folds 
don24: raises $0.70 to $1.60
KramSS: calls $0.70
*** FLOP *** [Tc 4c 5s]
KramSS: checks 
don24: bets $1
KramSS: calls $1
*** TURN *** [Tc 4c 5s] [6s]
KramSS: checks 
don24: checks 
*** RIVER *** [Tc 4c 5s 6s] [Kh]
KramSS: bets $3.44
don24: calls $3.44
*** SHOW DOWN ***
KramSS: shows [As Ks] (a pair of Kings)
don24: mucks hand 
KramSS collected $11.63 from pot
*** SUMMARY ***
Total pot $12.18 | Rake $0.55 
Board [Tc 4c 5s 6s Kh]
Seat 1: Rosska(Rus) (big blind) folded before Flop
Seat 2: saitam_06 folded before Flop (didn't bet)
Seat 3: don24 mucked
Seat 4: manganito17 (button) folded before Flop (didn't bet)
Seat 6: KramSS (small blind) showed [As Ks] and won ($11.63) with a pair of Kings



PokerStars Hand #222981112149:  Hold'em No Limit ($0.05/$0.10 USD) - 2021/01/23 20:11:49 ET
Table 'Lova III' 6-max Seat #6 is the button
Seat 1: Rosska(Rus) ($11.49 in chips) 
Seat 2: saitam_06 ($10.24 in chips) 
Seat 3: don24 ($3.71 in chips) 
Seat 4: manganito17 ($10 in chips) 
Seat 6: KramSS ($15.64 in chips) 
Rosska(Rus): posts small blind $0.05
saitam_06: posts big blind $0.10
hempju1ce: sits out 
*** HOLE CARDS ***
don24: folds 
manganito17: folds 
don24 leaves the table
KramSS: raises $0.15 to $0.25
Rosska(Rus): raises $0.95 to $1.20
saitam_06: folds 
KramSS: folds 
Uncalled bet ($0.95) returned to Rosska(Rus)
Rosska(Rus) collected $0.60 from pot
Rosska(Rus): doesn't show hand 
*** SUMMARY ***
Total pot $0.60 | Rake $0 
Seat 1: Rosska(Rus) (small blind) collected ($0.60)
Seat 2: saitam_06 (big blind) folded before Flop
Seat 3: don24 folded before Flop (didn't bet)
Seat 4: manganito17 folded before Flop (didn't bet)
Seat 6: KramSS (button) folded before Flop



PokerStars Hand #222981122707:  Hold'em No Limit ($0.05/$0.10 USD) - 2021/01/23 20:12:13 ET
Table 'Lova III' 6-max Seat #1 is the button
Seat 1: Rosska(Rus) ($11.84 in chips) 
Seat 2: saitam_06 ($10.14 in chips) 
Seat 4: manganito17 ($10 in chips) 
Seat 6: KramSS ($15.39 in chips) 
saitam_06: posts small blind $0.05
manganito17: posts big blind $0.10
hempju1ce: sits out 
*** HOLE CARDS ***
KramSS: raises $0.20 to $0.30
Rosska(Rus): folds 
saitam_06: folds 
manganito17: calls $0.20
*** FLOP *** [5c 5d 8s]
manganito17: checks 
KramSS: bets $0.36
manganito17: folds 
Uncalled bet ($0.36) returned to KramSS
KramSS collected $0.62 from pot
KramSS: doesn't show hand 
*** SUMMARY ***
Total pot $0.65 | Rake $0.03 
Board [5c 5d 8s]
Seat 1: Rosska(Rus) (button) folded before Flop (didn't bet)
Seat 2: saitam_06 (small blind) folded before Flop
Seat 4: manganito17 (big blind) folded on the Flop
Seat 6: KramSS collected ($0.62)



PokerStars Hand #222981142274:  Hold'em No Limit ($0.05/$0.10 USD) - 2021/01/23 20:12:56 ET
Table 'Lova III' 6-max Seat #2 is the button
Seat 1: Rosska(Rus) ($11.84 in chips) 
Seat 2: saitam_06 ($10.09 in chips) 
Seat 4: manganito17 ($10 in chips) 
Seat 5: hempju1ce ($27.27 in chips) 
Seat 6: KramSS ($15.71 in chips) 
manganito17: posts small blind $0.05
hempju1ce: posts big blind $0.10
*** HOLE CARDS ***
KramSS: folds 
Rosska(Rus): folds 
KramSS leaves the table
saitam_06: raises $0.15 to $0.25
manganito17: folds 
hempju1ce: calls $0.15
*** FLOP *** [4c As 2s]
hempju1ce: checks 
saitam_06: bets $0.17
hempju1ce: raises $0.33 to $0.50
saitam_06: folds 
Uncalled bet ($0.33) returned to hempju1ce
hempju1ce collected $0.85 from pot
hempju1ce: doesn't show hand 
*** SUMMARY ***
Total pot $0.89 | Rake $0.04 
Board [4c As 2s]
Seat 1: Rosska(Rus) folded before Flop (didn't bet)
Seat 2: saitam_06 (button) folded on the Flop
Seat 4: manganito17 (small blind) folded before Flop
Seat 5: hempju1ce (big blind) collected ($0.85)
Seat 6: KramSS folded before Flop (didn't bet)



PokerStars Hand #222981162306:  Hold'em No Limit ($0.05/$0.10 USD) - 2021/01/23 20:13:41 ET
Table 'Lova III' 6-max Seat #4 is the button
Seat 1: Rosska(Rus) ($11.84 in chips) 
Seat 2: saitam_06 ($10 in chips) 
Seat 4: manganito17 ($10 in chips) 
Seat 5: hempju1ce ($27.70 in chips) 
hempju1ce: posts small blind $0.05
Rosska(Rus): posts big blind $0.10
*** HOLE CARDS ***
saitam_06: folds 
FacuLarrocca joins the table at seat #3 
manganito17: raises $0.20 to $0.30
hempju1ce: folds 
Rosska(Rus): folds 
Uncalled bet ($0.20) returned to manganito17
manganito17 collected $0.25 from pot
manganito17: doesn't show hand 
*** SUMMARY ***
Total pot $0.25 | Rake $0 
Seat 1: Rosska(Rus) (big blind) folded before Flop
Seat 2: saitam_06 folded before Flop (didn't bet)
Seat 4: manganito17 (button) collected ($0.25)
Seat 5: hempju1ce (small blind) folded before Flop



PokerStars Hand #222981168616:  Hold'em No Limit ($0.05/$0.10 USD) - 2021/01/23 20:13:55 ET
Table 'Lova III' 6-max Seat #5 is the button
Seat 1: Rosska(Rus) ($11.74 in chips) 
Seat 2: saitam_06 ($10 in chips) 
Seat 4: manganito17 ($10.15 in chips) 
Seat 5: hempju1ce ($27.65 in chips) 
Rosska(Rus): posts small blind $0.05
saitam_06: posts big blind $0.10
FacuLarrocca: sits out 
*** HOLE CARDS ***
manganito17: raises $0.15 to $0.25
hempju1ce: folds 
Rosska(Rus): folds 
saitam_06: folds 
Uncalled bet ($0.15) returned to manganito17
manganito17 collected $0.25 from pot
manganito17: doesn't show hand 
*** SUMMARY ***
Total pot $0.25 | Rake $0 
Seat 1: Rosska(Rus) (small blind) folded before Flop
Seat 2: saitam_06 (big blind) folded before Flop
Seat 4: manganito17 collected ($0.25)
Seat 5: hempju1ce (button) folded before Flop (didn't bet)



PokerStars Hand #222981174893:  Hold'em No Limit ($0.05/$0.10 USD) - 2021/01/23 20:14:09 ET
Table 'Lova III' 6-max Seat #1 is the button
Seat 1: Rosska(Rus) ($11.69 in chips) 
Seat 2: saitam_06 ($10 in chips) 
Seat 3: FacuLarrocca ($10 in chips) 
Seat 4: manganito17 ($10.30 in chips) 
Seat 5: hempju1ce ($27.65 in chips) 
saitam_06: posts small blind $0.05
FacuLarrocca: posts big blind $0.10
*** HOLE CARDS ***
manganito17: raises $0.15 to $0.25
hempju1ce: raises $0.35 to $0.60
Rosska(Rus): folds 
saitam_06: folds 
FacuLarrocca: folds 
AAAcostA joins the table at seat #6 
manganito17: calls $0.35
*** FLOP *** [4d Jh 8h]
manganito17: checks 
hempju1ce: bets $1
manganito17: folds 
Uncalled bet ($1) returned to hempju1ce
hempju1ce collected $1.29 from pot
hempju1ce: doesn't show hand 
*** SUMMARY ***
Total pot $1.35 | Rake $0.06 
Board [4d Jh 8h]
Seat 1: Rosska(Rus) (button) folded before Flop (didn't bet)
Seat 2: saitam_06 (small blind) folded before Flop
Seat 3: FacuLarrocca (big blind) folded before Flop
Seat 4: manganito17 folded on the Flop
Seat 5: hempju1ce collected ($1.29)



PokerStars Hand #222981199813:  Hold'em No Limit ($0.05/$0.10 USD) - 2021/01/23 20:15:04 ET
Table 'Lova III' 6-max Seat #2 is the button
Seat 1: Rosska(Rus) ($11.69 in chips) 
Seat 2: saitam_06 ($10 in chips) 
Seat 3: FacuLarrocca ($10 in chips) 
Seat 4: manganito17 ($10 in chips) 
Seat 5: hempju1ce ($28.34 in chips) 
FacuLarrocca: posts small blind $0.05
manganito17: posts big blind $0.10
AAAcostA: sits out 
*** HOLE CARDS ***
hempju1ce: folds 
Rosska(Rus): folds 
saitam_06: folds 
FacuLarrocca: folds 
Uncalled bet ($0.05) returned to manganito17
manganito17 collected $0.10 from pot
manganito17: doesn't show hand 
*** SUMMARY ***
Total pot $0.10 | Rake $0 
Seat 1: Rosska(Rus) folded before Flop (didn't bet)
Seat 2: saitam_06 (button) folded before Flop (didn't bet)
Seat 3: FacuLarrocca (small blind) folded before Flop
Seat 4: manganito17 (big blind) collected ($0.10)
Seat 5: hempju1ce folded before Flop (didn't bet)



PokerStars Hand #222981206558:  Hold'em No Limit ($0.05/$0.10 USD) - 2021/01/23 20:15:20 ET
Table 'Lova III' 6-max Seat #3 is the button
Seat 1: Rosska(Rus) ($11.69 in chips) 
Seat 2: saitam_06 ($10 in chips) 
Seat 3: FacuLarrocca ($10 in chips) 
Seat 4: manganito17 ($10.05 in chips) 
Seat 5: hempju1ce ($28.34 in chips) 
manganito17: posts small blind $0.05
hempju1ce: posts big blind $0.10
AAAcostA: sits out 
*** HOLE CARDS ***
Rosska(Rus): folds 
saitam_06: folds 
FacuLarrocca: folds 
manganito17: raises $0.20 to $0.30
hempju1ce: calls $0.20
*** FLOP *** [8h 8s Qd]
manganito17: checks 
hempju1ce: checks 
*** TURN *** [8h 8s Qd] [Jh]
manganito17: checks 
hempju1ce: bets $0.20
manganito17: folds 
Uncalled bet ($0.20) returned to hempju1ce
hempju1ce collected $0.57 from pot
hempju1ce: doesn't show hand 
*** SUMMARY ***
Total pot $0.60 | Rake $0.03 
Board [8h 8s Qd Jh]
Seat 1: Rosska(Rus) folded before Flop (didn't bet)
Seat 2: saitam_06 folded before Flop (didn't bet)
Seat 3: FacuLarrocca (button) folded before Flop (didn't bet)
Seat 4: manganito17 (small blind) folded on the Turn
Seat 5: hempju1ce (big blind) collected ($0.57)



PokerStars Hand #222981223196:  Hold'em No Limit ($0.05/$0.10 USD) - 2021/01/23 20:15:57 ET
Table 'Lova III' 6-max Seat #4 is the button
Seat 1: Rosska(Rus) ($11.69 in chips) 
Seat 2: saitam_06 ($10 in chips) 
Seat 3: FacuLarrocca ($10 in chips) 
Seat 4: manganito17 ($10 in chips) 
Seat 5: hempju1ce ($28.61 in chips) 
Seat 6: AAAcostA ($10 in chips) 
hempju1ce: posts small blind $0.05
AAAcostA: posts big blind $0.10
*** HOLE CARDS ***
Rosska(Rus): folds 
saitam_06: folds 
FacuLarrocca: folds 
manganito17: raises $0.20 to $0.30
hempju1ce: folds 
AAAcostA: folds 
Uncalled bet ($0.20) returned to manganito17
manganito17 collected $0.25 from pot
manganito17: doesn't show hand 
*** SUMMARY ***
Total pot $0.25 | Rake $0 
Seat 1: Rosska(Rus) folded before Flop (didn't bet)
Seat 2: saitam_06 folded before Flop (didn't bet)
Seat 3: FacuLarrocca folded before Flop (didn't bet)
Seat 4: manganito17 (button) collected ($0.25)
Seat 5: hempju1ce (small blind) folded before Flop
Seat 6: AAAcostA (big blind) folded before Flop



PokerStars Hand #222981229300:  Hold'em No Limit ($0.05/$0.10 USD) - 2021/01/23 20:16:11 ET
Table 'Lova III' 6-max Seat #5 is the button
Seat 1: Rosska(Rus) ($11.69 in chips) 
Seat 2: saitam_06 ($10 in chips) 
Seat 3: FacuLarrocca ($10 in chips) 
Seat 4: manganito17 ($10.15 in chips) 
Seat 5: hempju1ce ($28.56 in chips) 
Seat 6: AAAcostA ($10 in chips) 
AAAcostA: posts small blind $0.05
Rosska(Rus): posts big blind $0.10
*** HOLE CARDS ***
saitam_06: folds 
FacuLarrocca: folds 
manganito17: raises $0.15 to $0.25
hempju1ce: folds 
AAAcostA: folds 
Rosska(Rus): folds 
Uncalled bet ($0.15) returned to manganito17
manganito17 collected $0.25 from pot
manganito17: doesn't show hand 
*** SUMMARY ***
Total pot $0.25 | Rake $0 
Seat 1: Rosska(Rus) (big blind) folded before Flop
Seat 2: saitam_06 folded before Flop (didn't bet)
Seat 3: FacuLarrocca folded before Flop (didn't bet)
Seat 4: manganito17 collected ($0.25)
Seat 5: hempju1ce (button) folded before Flop (didn't bet)
Seat 6: AAAcostA (small blind) folded before Flop



PokerStars Hand #222981238921:  Hold'em No Limit ($0.05/$0.10 USD) - 2021/01/23 20:16:33 ET
Table 'Lova III' 6-max Seat #6 is the button
Seat 1: Rosska(Rus) ($11.59 in chips) 
Seat 2: saitam_06 ($10 in chips) 
Seat 3: FacuLarrocca ($10 in chips) 
Seat 4: manganito17 ($10.30 in chips) 
Seat 5: hempju1ce ($28.56 in chips) 
Seat 6: AAAcostA ($10 in chips) 
Rosska(Rus): posts small blind $0.05
saitam_06: posts big blind $0.10
*** HOLE CARDS ***
FacuLarrocca: folds 
manganito17: raises $0.15 to $0.25
hempju1ce: folds 
AAAcostA: folds 
Rosska(Rus): folds 
saitam_06: folds 
Uncalled bet ($0.15) returned to manganito17
manganito17 collected $0.25 from pot
manganito17: doesn't show hand 
*** SUMMARY ***
Total pot $0.25 | Rake $0 
Seat 1: Rosska(Rus) (small blind) folded before Flop
Seat 2: saitam_06 (big blind) folded before Flop
Seat 3: FacuLarrocca folded before Flop (didn't bet)
Seat 4: manganito17 collected ($0.25)
Seat 5: hempju1ce folded before Flop (didn't bet)
Seat 6: AAAcostA (button) folded before Flop (didn't bet)



PokerStars Hand #222981245726:  Hold'em No Limit ($0.05/$0.10 USD) - 2021/01/23 20:16:48 ET
Table 'Lova III' 6-max Seat #1 is the button
Seat 1: Rosska(Rus) ($11.54 in chips) 
Seat 2: saitam_06 ($10 in chips) 
Seat 3: FacuLarrocca ($10 in chips) 
Seat 4: manganito17 ($10.45 in chips) 
Seat 5: hempju1ce ($28.56 in chips) 
Seat 6: AAAcostA ($10 in chips) 
saitam_06: posts small blind $0.05
FacuLarrocca: posts big blind $0.10
*** HOLE CARDS ***
manganito17: folds 
hempju1ce: calls $0.10
AAAcostA: folds 
Rosska(Rus): folds 
saitam_06: folds 
FacuLarrocca: checks 
*** FLOP *** [9h Qd Js]
FacuLarrocca: checks 
hempju1ce: checks 
*** TURN *** [9h Qd Js] [5s]
FacuLarrocca: checks 
hempju1ce: checks 
*** RIVER *** [9h Qd Js 5s] [4h]
FacuLarrocca: checks 
hempju1ce: checks 
*** SHOW DOWN ***
FacuLarrocca: shows [Ah 8s] (high card Ace)
hempju1ce: mucks hand 
FacuLarrocca collected $0.24 from pot
*** SUMMARY ***
Total pot $0.25 | Rake $0.01 
Board [9h Qd Js 5s 4h]
Seat 1: Rosska(Rus) (button) folded before Flop (didn't bet)
Seat 2: saitam_06 (small blind) folded before Flop
Seat 3: FacuLarrocca (big blind) showed [Ah 8s] and won ($0.24) with high card Ace
Seat 4: manganito17 folded before Flop (didn't bet)
Seat 5: hempju1ce mucked
Seat 6: AAAcostA folded before Flop (didn't bet)



PokerStars Hand #222981258938:  Hold'em No Limit ($0.05/$0.10 USD) - 2021/01/23 20:17:18 ET
Table 'Lova III' 6-max Seat #2 is the button
Seat 1: Rosska(Rus) ($11.54 in chips) 
Seat 2: saitam_06 ($10 in chips) 
Seat 3: FacuLarrocca ($10.14 in chips) 
Seat 4: manganito17 ($10.45 in chips) 
Seat 5: hempju1ce ($28.46 in chips) 
Seat 6: AAAcostA ($10 in chips) 
FacuLarrocca: posts small blind $0.05
manganito17: posts big blind $0.10
*** HOLE CARDS ***
hempju1ce: folds 
AAAcostA: folds 
Rosska(Rus): folds 
saitam_06: folds 
FacuLarrocca: folds 
Uncalled bet ($0.05) returned to manganito17
manganito17 collected $0.10 from pot
manganito17: doesn't show hand 
*** SUMMARY ***
Total pot $0.10 | Rake $0 
Seat 1: Rosska(Rus) folded before Flop (didn't bet)
Seat 2: saitam_06 (button) folded before Flop (didn't bet)
Seat 3: FacuLarrocca (small blind) folded before Flop
Seat 4: manganito17 (big blind) collected ($0.10)
Seat 5: hempju1ce folded before Flop (didn't bet)
Seat 6: AAAcostA folded before Flop (didn't bet)



PokerStars Hand #222981271429:  Hold'em No Limit ($0.05/$0.10 USD) - 2021/01/23 20:17:46 ET
Table 'Lova III' 6-max Seat #3 is the button
Seat 1: Rosska(Rus) ($11.54 in chips) 
Seat 2: saitam_06 ($10 in chips) 
Seat 3: FacuLarrocca ($10.09 in chips) 
Seat 4: manganito17 ($10.50 in chips) 
Seat 5: hempju1ce ($28.46 in chips) 
Seat 6: AAAcostA ($10 in chips) 
manganito17: posts small blind $0.05
hempju1ce: posts big blind $0.10
*** HOLE CARDS ***
AAAcostA: folds 
Rosska(Rus): folds 
saitam_06: folds 
FacuLarrocca: folds 
manganito17: folds 
Uncalled bet ($0.05) returned to hempju1ce
hempju1ce collected $0.10 from pot
hempju1ce: doesn't show hand 
*** SUMMARY ***
Total pot $0.10 | Rake $0 
Seat 1: Rosska(Rus) folded before Flop (didn't bet)
Seat 2: saitam_06 folded before Flop (didn't bet)
Seat 3: FacuLarrocca (button) folded before Flop (didn't bet)
Seat 4: manganito17 (small blind) folded before Flop
Seat 5: hempju1ce (big blind) collected ($0.10)
Seat 6: AAAcostA folded before Flop (didn't bet)



PokerStars Hand #222981278453:  Hold'em No Limit ($0.05/$0.10 USD) - 2021/01/23 20:18:02 ET
Table 'Lova III' 6-max Seat #4 is the button
Seat 1: Rosska(Rus) ($11.54 in chips) 
Seat 2: saitam_06 ($10 in chips) 
Seat 3: FacuLarrocca ($10.09 in chips) 
Seat 4: manganito17 ($10.45 in chips) 
Seat 5: hempju1ce ($28.51 in chips) 
Seat 6: AAAcostA ($10 in chips) 
hempju1ce: posts small blind $0.05
AAAcostA: posts big blind $0.10
*** HOLE CARDS ***
Rosska(Rus): raises $0.20 to $0.30
saitam_06: folds 
FacuLarrocca: folds 
manganito17 has timed out
manganito17: folds 
hempju1ce: folds 
AAAcostA: folds 
Uncalled bet ($0.20) returned to Rosska(Rus)
Rosska(Rus) collected $0.25 from pot
Rosska(Rus): doesn't show hand 
*** SUMMARY ***
Total pot $0.25 | Rake $0 
Seat 1: Rosska(Rus) collected ($0.25)
Seat 2: saitam_06 folded before Flop (didn't bet)
Seat 3: FacuLarrocca folded before Flop (didn't bet)
Seat 4: manganito17 (button) folded before Flop (didn't bet)
Seat 5: hempju1ce (small blind) folded before Flop
Seat 6: AAAcostA (big blind) folded before Flop



PokerStars Hand #222981294720:  Hold'em No Limit ($0.05/$0.10 USD) - 2021/01/23 20:18:39 ET
Table 'Lova III' 6-max Seat #5 is the button
Seat 1: Rosska(Rus) ($11.69 in chips) 
Seat 2: saitam_06 ($10 in chips) 
Seat 3: FacuLarrocca ($10.09 in chips) 
Seat 5: hempju1ce ($28.46 in chips) 
Seat 6: AAAcostA ($10 in chips) 
AAAcostA: posts small blind $0.05
Rosska(Rus): posts big blind $0.10
*** HOLE CARDS ***
saitam_06: folds 
FacuLarrocca: raises $0.20 to $0.30
hempju1ce: folds 
AAAcostA: folds 
Rosska(Rus): folds 
Uncalled bet ($0.20) returned to FacuLarrocca
FacuLarrocca collected $0.25 from pot
FacuLarrocca: doesn't show hand 
*** SUMMARY ***
Total pot $0.25 | Rake $0 
Seat 1: Rosska(Rus) (big blind) folded before Flop
Seat 2: saitam_06 folded before Flop (didn't bet)
Seat 3: FacuLarrocca collected ($0.25)
Seat 5: hempju1ce (button) folded before Flop (didn't bet)
Seat 6: AAAcostA (small blind) folded before Flop



PokerStars Hand #222981302607:  Hold'em No Limit ($0.05/$0.10 USD) - 2021/01/23 20:18:57 ET
Table 'Lova III' 6-max Seat #6 is the button
Seat 1: Rosska(Rus) ($11.59 in chips) 
Seat 2: saitam_06 ($10 in chips) 
Seat 3: FacuLarrocca ($10.24 in chips) 
Seat 4: manganito17 ($10.45 in chips) 
Seat 5: hempju1ce ($28.46 in chips) 
Seat 6: AAAcostA ($10 in chips) 
Rosska(Rus): posts small blind $0.05
saitam_06: posts big blind $0.10
*** HOLE CARDS ***
FacuLarrocca: folds 
manganito17: folds 
hempju1ce: raises $0.10 to $0.20
AAAcostA: folds 
Rosska(Rus): folds 
saitam_06: calls $0.10
*** FLOP *** [Th Jh 3d]
saitam_06: checks 
hempju1ce: checks 
*** TURN *** [Th Jh 3d] [Tc]
saitam_06: bets $0.32
hempju1ce: folds 
Uncalled bet ($0.32) returned to saitam_06
saitam_06 collected $0.43 from pot
saitam_06: doesn't show hand 
*** SUMMARY ***
Total pot $0.45 | Rake $0.02 
Board [Th Jh 3d Tc]
Seat 1: Rosska(Rus) (small blind) folded before Flop
Seat 2: saitam_06 (big blind) collected ($0.43)
Seat 3: FacuLarrocca folded before Flop (didn't bet)
Seat 4: manganito17 folded before Flop (didn't bet)
Seat 5: hempju1ce folded on the Turn
Seat 6: AAAcostA (button) folded before Flop (didn't bet)



PokerStars Hand #222981314333:  Hold'em No Limit ($0.05/$0.10 USD) - 2021/01/23 20:19:24 ET
Table 'Lova III' 6-max Seat #1 is the button
Seat 1: Rosska(Rus) ($11.54 in chips) 
Seat 2: saitam_06 ($10.23 in chips) 
Seat 3: FacuLarrocca ($10.24 in chips) 
Seat 4: manganito17 ($10.45 in chips) 
Seat 5: hempju1ce ($28.26 in chips) 
Seat 6: AAAcostA ($10 in chips) 
saitam_06: posts small blind $0.05
FacuLarrocca: posts big blind $0.10
*** HOLE CARDS ***
manganito17: folds 
hempju1ce: raises $0.20 to $0.30
AAAcostA: folds 
Rosska(Rus): folds 
saitam_06: folds 
FacuLarrocca: folds 
Uncalled bet ($0.20) returned to hempju1ce
hempju1ce collected $0.25 from pot
hempju1ce: doesn't show hand 
*** SUMMARY ***
Total pot $0.25 | Rake $0 
Seat 1: Rosska(Rus) (button) folded before Flop (didn't bet)
Seat 2: saitam_06 (small blind) folded before Flop
Seat 3: FacuLarrocca (big blind) folded before Flop
Seat 4: manganito17 folded before Flop (didn't bet)
Seat 5: hempju1ce collected ($0.25)
Seat 6: AAAcostA folded before Flop (didn't bet)



PokerStars Hand #222981324316:  Hold'em No Limit ($0.05/$0.10 USD) - 2021/01/23 20:19:47 ET
Table 'Lova III' 6-max Seat #2 is the button
Seat 1: Rosska(Rus) ($11.54 in chips) 
Seat 2: saitam_06 ($10.18 in chips) 
Seat 3: FacuLarrocca ($10.14 in chips) 
Seat 4: manganito17 ($10.45 in chips) 
Seat 5: hempju1ce ($28.41 in chips) 
Seat 6: AAAcostA ($10 in chips) 
FacuLarrocca: posts small blind $0.05
manganito17: posts big blind $0.10
*** HOLE CARDS ***
hempju1ce: folds 
AAAcostA: folds 
Rosska(Rus): folds 
saitam_06: folds 
FacuLarrocca: raises $0.20 to $0.30
manganito17: calls $0.20
*** FLOP *** [Qc As 5h]
FacuLarrocca: checks 
manganito17: checks 
*** TURN *** [Qc As 5h] [5d]
FacuLarrocca: bets $0.43
manganito17: folds 
Uncalled bet ($0.43) returned to FacuLarrocca
FacuLarrocca collected $0.57 from pot
FacuLarrocca: doesn't show hand 
*** SUMMARY ***
Total pot $0.60 | Rake $0.03 
Board [Qc As 5h 5d]
Seat 1: Rosska(Rus) folded before Flop (didn't bet)
Seat 2: saitam_06 (button) folded before Flop (didn't bet)
Seat 3: FacuLarrocca (small blind) collected ($0.57)
Seat 4: manganito17 (big blind) folded on the Turn
Seat 5: hempju1ce folded before Flop (didn't bet)
Seat 6: AAAcostA folded before Flop (didn't bet)



PokerStars Hand #222981340148:  Hold'em No Limit ($0.05/$0.10 USD) - 2021/01/23 20:20:24 ET
Table 'Lova III' 6-max Seat #3 is the button
Seat 1: Rosska(Rus) ($11.54 in chips) 
Seat 2: saitam_06 ($10.18 in chips) 
Seat 3: FacuLarrocca ($10.41 in chips) 
Seat 4: manganito17 ($10.15 in chips) 
Seat 5: hempju1ce ($28.41 in chips) 
Seat 6: AAAcostA ($10 in chips) 
manganito17: posts small blind $0.05
hempju1ce: posts big blind $0.10
*** HOLE CARDS ***
AAAcostA: folds 
Rosska(Rus): raises $0.20 to $0.30
saitam_06: folds 
FacuLarrocca: folds 
manganito17: folds 
hempju1ce: folds 
Uncalled bet ($0.20) returned to Rosska(Rus)
Rosska(Rus) collected $0.25 from pot
Rosska(Rus): doesn't show hand 
*** SUMMARY ***
Total pot $0.25 | Rake $0 
Seat 1: Rosska(Rus) collected ($0.25)
Seat 2: saitam_06 folded before Flop (didn't bet)
Seat 3: FacuLarrocca (button) folded before Flop (didn't bet)
Seat 4: manganito17 (small blind) folded before Flop
Seat 5: hempju1ce (big blind) folded before Flop
Seat 6: AAAcostA folded before Flop (didn't bet)



PokerStars Hand #222981353626:  Hold'em No Limit ($0.05/$0.10 USD) - 2021/01/23 20:20:54 ET
Table 'Lova III' 6-max Seat #4 is the button
Seat 1: Rosska(Rus) ($11.69 in chips) 
Seat 2: saitam_06 ($10.18 in chips) 
Seat 3: FacuLarrocca ($10.41 in chips) 
Seat 4: manganito17 ($10.10 in chips) 
Seat 5: hempju1ce ($28.31 in chips) 
Seat 6: AAAcostA ($10 in chips) 
hempju1ce: posts small blind $0.05
AAAcostA: posts big blind $0.10
*** HOLE CARDS ***
Rosska(Rus): folds 
saitam_06: folds 
FacuLarrocca: folds 
manganito17: folds 
hempju1ce: folds 
Uncalled bet ($0.05) returned to AAAcostA
AAAcostA collected $0.10 from pot
*** SUMMARY ***
Total pot $0.10 | Rake $0 
Seat 1: Rosska(Rus) folded before Flop (didn't bet)
Seat 2: saitam_06 folded before Flop (didn't bet)
Seat 3: FacuLarrocca folded before Flop (didn't bet)
Seat 4: manganito17 (button) folded before Flop (didn't bet)
Seat 5: hempju1ce (small blind) folded before Flop
Seat 6: AAAcostA (big blind) collected ($0.10)



PokerStars Hand #222981362451:  Hold'em No Limit ($0.05/$0.10 USD) - 2021/01/23 20:21:14 ET
Table 'Lova III' 6-max Seat #5 is the button
Seat 1: Rosska(Rus) ($11.69 in chips) 
Seat 2: saitam_06 ($10.18 in chips) 
Seat 3: FacuLarrocca ($10.41 in chips) 
Seat 4: manganito17 ($10.10 in chips) 
Seat 5: hempju1ce ($28.26 in chips) 
Seat 6: AAAcostA ($10.05 in chips) 
AAAcostA: posts small blind $0.05
Rosska(Rus): posts big blind $0.10
*** HOLE CARDS ***
saitam_06: folds 
FacuLarrocca: folds 
manganito17: folds 
hempju1ce: calls $0.10
AAAcostA: folds 
Rosska(Rus): checks 
*** FLOP *** [8s Qc Ts]
Rosska(Rus): checks 
hempju1ce: checks 
*** TURN *** [8s Qc Ts] [6h]
Rosska(Rus): checks 
hempju1ce: checks 
*** RIVER *** [8s Qc Ts 6h] [3c]
Rosska(Rus): checks 
hempju1ce: bets $0.10
Rosska(Rus): folds 
Uncalled bet ($0.10) returned to hempju1ce
hempju1ce collected $0.24 from pot
hempju1ce: doesn't show hand 
*** SUMMARY ***
Total pot $0.25 | Rake $0.01 
Board [8s Qc Ts 6h 3c]
Seat 1: Rosska(Rus) (big blind) folded on the River
Seat 2: saitam_06 folded before Flop (didn't bet)
Seat 3: FacuLarrocca folded before Flop (didn't bet)
Seat 4: manganito17 folded before Flop (didn't bet)
Seat 5: hempju1ce (button) collected ($0.24)
Seat 6: AAAcostA (small blind) folded before Flop



PokerStars Hand #222981377290:  Hold'em No Limit ($0.05/$0.10 USD) - 2021/01/23 20:21:48 ET
Table 'Lova III' 6-max Seat #6 is the button
Seat 1: Rosska(Rus) ($11.59 in chips) 
Seat 2: saitam_06 ($10.18 in chips) 
Seat 3: FacuLarrocca ($10.41 in chips) 
Seat 4: manganito17 ($10.10 in chips) 
Seat 5: hempju1ce ($28.40 in chips) 
Seat 6: AAAcostA ($10 in chips) 
Rosska(Rus): posts small blind $0.05
saitam_06: posts big blind $0.10
*** HOLE CARDS ***
FacuLarrocca: raises $0.20 to $0.30
manganito17: folds 
hempju1ce: calls $0.30
AAAcostA: folds 
Rosska(Rus): folds 
saitam_06: folds 
*** FLOP *** [4h 9c Ah]
FacuLarrocca: checks 
hempju1ce: bets $0.50
FacuLarrocca: calls $0.50
*** TURN *** [4h 9c Ah] [5c]
FacuLarrocca: checks 
hempju1ce: bets $1
FacuLarrocca: folds 
Uncalled bet ($1) returned to hempju1ce
hempju1ce collected $1.67 from pot
hempju1ce: doesn't show hand 
*** SUMMARY ***
Total pot $1.75 | Rake $0.08 
Board [4h 9c Ah 5c]
Seat 1: Rosska(Rus) (small blind) folded before Flop
Seat 2: saitam_06 (big blind) folded before Flop
Seat 3: FacuLarrocca folded on the Turn
Seat 4: manganito17 folded before Flop (didn't bet)
Seat 5: hempju1ce collected ($1.67)
Seat 6: AAAcostA (button) folded before Flop (didn't bet)



PokerStars Hand #222981391153:  Hold'em No Limit ($0.05/$0.10 USD) - 2021/01/23 20:22:20 ET
Table 'Lova III' 6-max Seat #1 is the button
Seat 1: Rosska(Rus) ($11.54 in chips) 
Seat 2: saitam_06 ($10.08 in chips) 
Seat 3: FacuLarrocca ($10 in chips) 
Seat 4: manganito17 ($10.10 in chips) 
Seat 5: hempju1ce ($29.27 in chips) 
Seat 6: AAAcostA ($10 in chips) 
saitam_06: posts small blind $0.05
FacuLarrocca: posts big blind $0.10
*** HOLE CARDS ***
manganito17: folds 
hempju1ce: folds 
AAAcostA: raises $0.20 to $0.30
Rosska(Rus): folds 
saitam_06: folds 
FacuLarrocca: folds 
Uncalled bet ($0.20) returned to AAAcostA
AAAcostA collected $0.25 from pot
AAAcostA: doesn't show hand 
*** SUMMARY ***
Total pot $0.25 | Rake $0 
Seat 1: Rosska(Rus) (button) folded before Flop (didn't bet)
Seat 2: saitam_06 (small blind) folded before Flop
Seat 3: FacuLarrocca (big blind) folded before Flop
Seat 4: manganito17 folded before Flop (didn't bet)
Seat 5: hempju1ce folded before Flop (didn't bet)
Seat 6: AAAcostA collected ($0.25)



PokerStars Hand #222981398674:  Hold'em No Limit ($0.05/$0.10 USD) - 2021/01/23 20:22:38 ET
Table 'Lova III' 6-max Seat #2 is the button
Seat 1: Rosska(Rus) ($11.54 in chips) 
Seat 2: saitam_06 ($10.03 in chips) 
Seat 3: FacuLarrocca ($10 in chips) 
Seat 4: manganito17 ($10.10 in chips) 
Seat 5: hempju1ce ($29.27 in chips) 
Seat 6: AAAcostA ($10.15 in chips) 
FacuLarrocca: posts small blind $0.05
manganito17: posts big blind $0.10
*** HOLE CARDS ***
hempju1ce: folds 
AAAcostA: folds 
Rosska(Rus): raises $0.20 to $0.30
saitam_06: folds 
FacuLarrocca: folds 
manganito17: calls $0.20
*** FLOP *** [Jc 5d Tc]
manganito17: checks 
Rosska(Rus): bets $0.48
manganito17: calls $0.48
*** TURN *** [Jc 5d Tc] [Ks]
manganito17: checks 
Rosska(Rus): checks 
*** RIVER *** [Jc 5d Tc Ks] [As]
manganito17: checks 
Rosska(Rus): bets $1
manganito17: folds 
Uncalled bet ($1) returned to Rosska(Rus)
Rosska(Rus) collected $1.54 from pot
*** SUMMARY ***
Total pot $1.61 | Rake $0.07 
Board [Jc 5d Tc Ks As]
Seat 1: Rosska(Rus) collected ($1.54)
Seat 2: saitam_06 (button) folded before Flop (didn't bet)
Seat 3: FacuLarrocca (small blind) folded before Flop
Seat 4: manganito17 (big blind) folded on the River
Seat 5: hempju1ce folded before Flop (didn't bet)
Seat 6: AAAcostA folded before Flop (didn't bet)



PokerStars Hand #222981421036:  Hold'em No Limit ($0.05/$0.10 USD) - 2021/01/23 20:23:23 ET
Table 'Lova III' 6-max Seat #3 is the button
Seat 1: Rosska(Rus) ($12.30 in chips) 
Seat 2: saitam_06 ($10.03 in chips) 
Seat 3: FacuLarrocca ($10 in chips) 
Seat 4: manganito17 ($10 in chips) 
Seat 5: hempju1ce ($29.27 in chips) 
Seat 6: AAAcostA ($10.15 in chips) 
manganito17: posts small blind $0.05
hempju1ce: posts big blind $0.10
*** HOLE CARDS ***
AAAcostA: folds 
Rosska(Rus): raises $0.20 to $0.30
saitam_06: folds 
FacuLarrocca: folds 
manganito17: folds 
hempju1ce: calls $0.20
*** FLOP *** [5s 5h Qd]
hempju1ce: checks 
Rosska(Rus): checks 
*** TURN *** [5s 5h Qd] [2s]
hempju1ce: bets $0.40
Rosska(Rus): folds 
Uncalled bet ($0.40) returned to hempju1ce
hempju1ce collected $0.62 from pot
hempju1ce: doesn't show hand 
*** SUMMARY ***
Total pot $0.65 | Rake $0.03 
Board [5s 5h Qd 2s]
Seat 1: Rosska(Rus) folded on the Turn
Seat 2: saitam_06 folded before Flop (didn't bet)
Seat 3: FacuLarrocca (button) folded before Flop (didn't bet)
Seat 4: manganito17 (small blind) folded before Flop
Seat 5: hempju1ce (big blind) collected ($0.62)
Seat 6: AAAcostA folded before Flop (didn't bet)



PokerStars Hand #222981434148:  Hold'em No Limit ($0.05/$0.10 USD) - 2021/01/23 20:23:53 ET
Table 'Lova III' 6-max Seat #4 is the button
Seat 1: Rosska(Rus) ($12 in chips) 
Seat 2: saitam_06 ($10.03 in chips) 
Seat 3: FacuLarrocca ($10 in chips) 
Seat 4: manganito17 ($10 in chips) 
Seat 5: hempju1ce ($29.59 in chips) 
Seat 6: AAAcostA ($10.15 in chips) 
hempju1ce: posts small blind $0.05
AAAcostA: posts big blind $0.10
*** HOLE CARDS ***
Rosska(Rus): folds 
saitam_06: folds 
FacuLarrocca: folds 
manganito17: raises $0.20 to $0.30
hempju1ce: calls $0.25
AAAcostA: folds 
*** FLOP *** [3c 3s 2c]
hempju1ce: checks 
manganito17: checks 
*** TURN *** [3c 3s 2c] [7s]
hempju1ce: checks 
manganito17: checks 
*** RIVER *** [3c 3s 2c 7s] [5d]
hempju1ce: checks 
manganito17: checks 
*** SHOW DOWN ***
hempju1ce: shows [Tc Qd] (a pair of Threes)
manganito17: mucks hand 
hempju1ce collected $0.67 from pot
*** SUMMARY ***
Total pot $0.70 | Rake $0.03 
Board [3c 3s 2c 7s 5d]
Seat 1: Rosska(Rus) folded before Flop (didn't bet)
Seat 2: saitam_06 folded before Flop (didn't bet)
Seat 3: FacuLarrocca folded before Flop (didn't bet)
Seat 4: manganito17 (button) mucked
Seat 5: hempju1ce (small blind) showed [Tc Qd] and won ($0.67) with a pair of Threes
Seat 6: AAAcostA (big blind) folded before Flop



PokerStars Hand #222981459968:  Hold'em No Limit ($0.05/$0.10 USD) - 2021/01/23 20:24:52 ET
Table 'Lova III' 6-max Seat #5 is the button
Seat 1: Rosska(Rus) ($12 in chips) 
Seat 2: saitam_06 ($10.03 in chips) 
Seat 3: FacuLarrocca ($10 in chips) 
Seat 4: manganito17 ($10 in chips) 
Seat 5: hempju1ce ($29.96 in chips) 
Seat 6: AAAcostA ($10.05 in chips) 
AAAcostA: posts small blind $0.05
Rosska(Rus): posts big blind $0.10
*** HOLE CARDS ***
saitam_06: folds 
FacuLarrocca: raises $0.20 to $0.30
manganito17: folds 
hempju1ce: folds 
AAAcostA: calls $0.25
Rosska(Rus): folds 
*** FLOP *** [2s 7h Ac]
AAAcostA: checks 
FacuLarrocca: bets $0.22
AAAcostA: calls $0.22
*** TURN *** [2s 7h Ac] [9d]
AAAcostA: checks 
FacuLarrocca: checks 
*** RIVER *** [2s 7h Ac 9d] [As]
AAAcostA: bets $1
FacuLarrocca: calls $1
*** SHOW DOWN ***
AAAcostA: shows [Jh Th] (a pair of Aces)
FacuLarrocca: shows [9c Jc] (two pair, Aces and Nines)
FacuLarrocca collected $3 from pot
*** SUMMARY ***
Total pot $3.14 | Rake $0.14 
Board [2s 7h Ac 9d As]
Seat 1: Rosska(Rus) (big blind) folded before Flop
Seat 2: saitam_06 folded before Flop (didn't bet)
Seat 3: FacuLarrocca showed [9c Jc] and won ($3) with two pair, Aces and Nines
Seat 4: manganito17 folded before Flop (didn't bet)
Seat 5: hempju1ce (button) folded before Flop (didn't bet)
Seat 6: AAAcostA (small blind) showed [Jh Th] and lost with a pair of Aces



PokerStars Hand #222981482411:  Hold'em No Limit ($0.05/$0.10 USD) - 2021/01/23 20:25:43 ET
Table 'Lova III' 6-max Seat #6 is the button
Seat 1: Rosska(Rus) ($11.90 in chips) 
Seat 2: saitam_06 ($10.03 in chips) 
Seat 3: FacuLarrocca ($11.48 in chips) 
Seat 4: manganito17 ($10 in chips) 
Seat 5: hempju1ce ($29.96 in chips) 
Seat 6: AAAcostA ($10 in chips) 
Rosska(Rus): posts small blind $0.05
saitam_06: posts big blind $0.10
*** HOLE CARDS ***
FacuLarrocca: folds 
manganito17: folds 
hempju1ce: calls $0.10
AAAcostA: folds 
Rosska(Rus): raises $0.30 to $0.40
saitam_06: folds 
hempju1ce: folds 
Uncalled bet ($0.30) returned to Rosska(Rus)
Rosska(Rus) collected $0.30 from pot
Rosska(Rus): doesn't show hand 
*** SUMMARY ***
Total pot $0.30 | Rake $0 
Seat 1: Rosska(Rus) (small blind) collected ($0.30)
Seat 2: saitam_06 (big blind) folded before Flop
Seat 3: FacuLarrocca folded before Flop (didn't bet)
Seat 4: manganito17 folded before Flop (didn't bet)
Seat 5: hempju1ce folded before Flop
Seat 6: AAAcostA (button) folded before Flop (didn't bet)



PokerStars Hand #222981490375:  Hold'em No Limit ($0.05/$0.10 USD) - 2021/01/23 20:26:01 ET
Table 'Lova III' 6-max Seat #1 is the button
Seat 1: Rosska(Rus) ($12.10 in chips) 
Seat 2: saitam_06 ($10 in chips) 
Seat 3: FacuLarrocca ($11.48 in chips) 
Seat 4: manganito17 ($10 in chips) 
Seat 5: hempju1ce ($29.86 in chips) 
Seat 6: AAAcostA ($10 in chips) 
saitam_06: posts small blind $0.05
FacuLarrocca: posts big blind $0.10
*** HOLE CARDS ***
manganito17: folds 
hempju1ce: folds 
AAAcostA has timed out
AAAcostA: folds 
Rosska(Rus): folds 
saitam_06: folds 
Uncalled bet ($0.05) returned to FacuLarrocca
FacuLarrocca collected $0.10 from pot
FacuLarrocca: doesn't show hand 
*** SUMMARY ***
Total pot $0.10 | Rake $0 
Seat 1: Rosska(Rus) (button) folded before Flop (didn't bet)
Seat 2: saitam_06 (small blind) folded before Flop
Seat 3: FacuLarrocca (big blind) collected ($0.10)
Seat 4: manganito17 folded before Flop (didn't bet)
Seat 5: hempju1ce folded before Flop (didn't bet)
Seat 6: AAAcostA folded before Flop (didn't bet)



PokerStars Hand #222981501476:  Hold'em No Limit ($0.05/$0.10 USD) - 2021/01/23 20:26:26 ET
Table 'Lova III' 6-max Seat #2 is the button
Seat 1: Rosska(Rus) ($12.10 in chips) 
Seat 2: saitam_06 ($10 in chips) 
Seat 3: FacuLarrocca ($11.53 in chips) 
Seat 4: manganito17 ($10 in chips) 
Seat 5: hempju1ce ($29.86 in chips) 
Seat 6: AAAcostA ($10 in chips) 
FacuLarrocca: posts small blind $0.05
manganito17: posts big blind $0.10
*** HOLE CARDS ***
hempju1ce: calls $0.10
AAAcostA: folds 
Rosska(Rus): raises $0.30 to $0.40
saitam_06: folds 
FacuLarrocca: folds 
manganito17: folds 
hempju1ce: folds 
Uncalled bet ($0.30) returned to Rosska(Rus)
Rosska(Rus) collected $0.35 from pot
Rosska(Rus): doesn't show hand 
*** SUMMARY ***
Total pot $0.35 | Rake $0 
Seat 1: Rosska(Rus) collected ($0.35)
Seat 2: saitam_06 (button) folded before Flop (didn't bet)
Seat 3: FacuLarrocca (small blind) folded before Flop
Seat 4: manganito17 (big blind) folded before Flop
Seat 5: hempju1ce folded before Flop
Seat 6: AAAcostA folded before Flop (didn't bet)



PokerStars Hand #222981521100:  Hold'em No Limit ($0.05/$0.10 USD) - 2021/01/23 20:26:54 ET
Table 'Lova III' 6-max Seat #3 is the button
Seat 1: Rosska(Rus) ($12.35 in chips) 
Seat 2: saitam_06 ($10 in chips) 
Seat 3: FacuLarrocca ($11.48 in chips) 
Seat 4: manganito17 ($10 in chips) 
Seat 5: hempju1ce ($29.76 in chips) 
Seat 6: AAAcostA ($10 in chips) 
manganito17: posts small blind $0.05
hempju1ce: posts big blind $0.10
*** HOLE CARDS ***
AAAcostA has timed out
AAAcostA: folds 
Rosska(Rus): folds 
saitam_06: folds 
FacuLarrocca: folds 
manganito17: folds 
Uncalled bet ($0.05) returned to hempju1ce
hempju1ce collected $0.10 from pot
hempju1ce: doesn't show hand 
*** SUMMARY ***
Total pot $0.10 | Rake $0 
Seat 1: Rosska(Rus) folded before Flop (didn't bet)
Seat 2: saitam_06 folded before Flop (didn't bet)
Seat 3: FacuLarrocca (button) folded before Flop (didn't bet)
Seat 4: manganito17 (small blind) folded before Flop
Seat 5: hempju1ce (big blind) collected ($0.10)
Seat 6: AAAcostA folded before Flop (didn't bet)



PokerStars Hand #222981534178:  Hold'em No Limit ($0.05/$0.10 USD) - 2021/01/23 20:27:24 ET
Table 'Lova III' 6-max Seat #4 is the button
Seat 1: Rosska(Rus) ($12.35 in chips) 
Seat 2: saitam_06 ($10 in chips) 
Seat 3: FacuLarrocca ($11.48 in chips) 
Seat 4: manganito17 ($10 in chips) 
Seat 5: hempju1ce ($29.81 in chips) 
hempju1ce: posts small blind $0.05
Rosska(Rus): posts big blind $0.10
*** HOLE CARDS ***
saitam_06: folds 
FacuLarrocca: folds 
manganito17: raises $0.20 to $0.30
hempju1ce: folds 
Rosska(Rus): raises $0.90 to $1.20
manganito17: calls $0.90
*** FLOP *** [7c Kh 6d]
Rosska(Rus): bets $1.43
manganito17: folds 
Uncalled bet ($1.43) returned to Rosska(Rus)
Rosska(Rus) collected $2.34 from pot
Rosska(Rus): doesn't show hand 
*** SUMMARY ***
Total pot $2.45 | Rake $0.11 
Board [7c Kh 6d]
Seat 1: Rosska(Rus) (big blind) collected ($2.34)
Seat 2: saitam_06 folded before Flop (didn't bet)
Seat 3: FacuLarrocca folded before Flop (didn't bet)
Seat 4: manganito17 (button) folded on the Flop
Seat 5: hempju1ce (small blind) folded before Flop



PokerStars Hand #222981548410:  Hold'em No Limit ($0.05/$0.10 USD) - 2021/01/23 20:27:57 ET
Table 'Lova III' 6-max Seat #5 is the button
Seat 1: Rosska(Rus) ($13.49 in chips) 
Seat 2: saitam_06 ($10 in chips) 
Seat 3: FacuLarrocca ($11.48 in chips) 
Seat 4: manganito17 ($10 in chips) 
Seat 5: hempju1ce ($29.76 in chips) 
Rosska(Rus): posts small blind $0.05
saitam_06: posts big blind $0.10
*** HOLE CARDS ***
FacuLarrocca: folds 
manganito17: folds 
hempju1ce: raises $0.20 to $0.30
Rosska(Rus): folds 
saitam_06: folds 
Uncalled bet ($0.20) returned to hempju1ce
hempju1ce collected $0.25 from pot
hempju1ce: doesn't show hand 
*** SUMMARY ***
Total pot $0.25 | Rake $0 
Seat 1: Rosska(Rus) (small blind) folded before Flop
Seat 2: saitam_06 (big blind) folded before Flop
Seat 3: FacuLarrocca folded before Flop (didn't bet)
Seat 4: manganito17 folded before Flop (didn't bet)
Seat 5: hempju1ce (button) collected ($0.25)



PokerStars Hand #222981555707:  Hold'em No Limit ($0.05/$0.10 USD) - 2021/01/23 20:28:14 ET
Table 'Lova III' 6-max Seat #1 is the button
Seat 1: Rosska(Rus) ($13.44 in chips) 
Seat 2: saitam_06 ($10 in chips) 
Seat 3: FacuLarrocca ($11.48 in chips) 
Seat 4: manganito17 ($10 in chips) 
Seat 5: hempju1ce ($29.91 in chips) 
saitam_06: posts small blind $0.05
FacuLarrocca: posts big blind $0.10
AAAcostA is disconnected 
AAAcostA has timed out while disconnected
AAAcostA: is sitting out 
*** HOLE CARDS ***
manganito17: raises $0.15 to $0.25
hempju1ce: folds 
Rosska(Rus): folds 
saitam_06: folds 
FacuLarrocca: folds 
Uncalled bet ($0.15) returned to manganito17
manganito17 collected $0.25 from pot
manganito17: doesn't show hand 
*** SUMMARY ***
Total pot $0.25 | Rake $0 
Seat 1: Rosska(Rus) (button) folded before Flop (didn't bet)
Seat 2: saitam_06 (small blind) folded before Flop
Seat 3: FacuLarrocca (big blind) folded before Flop
Seat 4: manganito17 collected ($0.25)
Seat 5: hempju1ce folded before Flop (didn't bet)



PokerStars Hand #222981566402:  Hold'em No Limit ($0.05/$0.10 USD) - 2021/01/23 20:28:39 ET
Table 'Lova III' 6-max Seat #2 is the button
Seat 1: Rosska(Rus) ($13.44 in chips) 
Seat 2: saitam_06 ($10 in chips) 
Seat 3: FacuLarrocca ($11.38 in chips) 
Seat 4: manganito17 ($10.15 in chips) 
Seat 5: hempju1ce ($29.91 in chips) 
FacuLarrocca: posts small blind $0.05
manganito17: posts big blind $0.10
AAAcostA: sits out 
*** HOLE CARDS ***
hempju1ce: folds 
Rosska(Rus): folds 
saitam_06: folds 
FacuLarrocca: raises $0.20 to $0.30
manganito17: folds 
Uncalled bet ($0.20) returned to FacuLarrocca
FacuLarrocca collected $0.20 from pot
FacuLarrocca: doesn't show hand 
*** SUMMARY ***
Total pot $0.20 | Rake $0 
Seat 1: Rosska(Rus) folded before Flop (didn't bet)
Seat 2: saitam_06 (button) folded before Flop (didn't bet)
Seat 3: FacuLarrocca (small blind) collected ($0.20)
Seat 4: manganito17 (big blind) folded before Flop
Seat 5: hempju1ce folded before Flop (didn't bet)



PokerStars Hand #222981575703:  Hold'em No Limit ($0.05/$0.10 USD) - 2021/01/23 20:29:01 ET
Table 'Lova III' 6-max Seat #3 is the button
Seat 1: Rosska(Rus) ($13.44 in chips) 
Seat 2: saitam_06 ($10 in chips) 
Seat 3: FacuLarrocca ($11.48 in chips) 
Seat 4: manganito17 ($10.05 in chips) 
Seat 5: hempju1ce ($29.91 in chips) 
manganito17: posts small blind $0.05
hempju1ce: posts big blind $0.10
AAAcostA has timed out
AAAcostA: is sitting out 
*** HOLE CARDS ***
Rosska(Rus): folds 
saitam_06: folds 
FacuLarrocca: raises $0.15 to $0.25
AAAcostA is disconnected 
manganito17: folds 
hempju1ce: folds 
Uncalled bet ($0.15) returned to FacuLarrocca
FacuLarrocca collected $0.25 from pot
FacuLarrocca: doesn't show hand 
*** SUMMARY ***
Total pot $0.25 | Rake $0 
Seat 1: Rosska(Rus) folded before Flop (didn't bet)
Seat 2: saitam_06 folded before Flop (didn't bet)
Seat 3: FacuLarrocca (button) collected ($0.25)
Seat 4: manganito17 (small blind) folded before Flop
Seat 5: hempju1ce (big blind) folded before Flop



PokerStars Hand #222981589972:  Hold'em No Limit ($0.05/$0.10 USD) - 2021/01/23 20:29:35 ET
Table 'Lova III' 6-max Seat #4 is the button
Seat 1: Rosska(Rus) ($13.44 in chips) 
Seat 2: saitam_06 ($10 in chips) 
Seat 3: FacuLarrocca ($11.63 in chips) 
Seat 4: manganito17 ($10 in chips) 
Seat 5: hempju1ce ($29.81 in chips) 
hempju1ce: posts small blind $0.05
Rosska(Rus): posts big blind $0.10
*** HOLE CARDS ***
saitam_06: folds 
FacuLarrocca: raises $0.20 to $0.30
manganito17: folds 
hempju1ce: folds 
Rosska(Rus): folds 
Uncalled bet ($0.20) returned to FacuLarrocca
FacuLarrocca collected $0.25 from pot
FacuLarrocca: doesn't show hand 
*** SUMMARY ***
Total pot $0.25 | Rake $0 
Seat 1: Rosska(Rus) (big blind) folded before Flop
Seat 2: saitam_06 folded before Flop (didn't bet)
Seat 3: FacuLarrocca collected ($0.25)
Seat 4: manganito17 (button) folded before Flop (didn't bet)
Seat 5: hempju1ce (small blind) folded before Flop



PokerStars Hand #222981596160:  Hold'em No Limit ($0.05/$0.10 USD) - 2021/01/23 20:29:49 ET
Table 'Lova III' 6-max Seat #5 is the button
Seat 1: Rosska(Rus) ($13.34 in chips) 
Seat 2: saitam_06 ($10 in chips) 
Seat 3: FacuLarrocca ($11.78 in chips) 
Seat 4: manganito17 ($10 in chips) 
Seat 5: hempju1ce ($29.76 in chips) 
Rosska(Rus): posts small blind $0.05
saitam_06: posts big blind $0.10
*** HOLE CARDS ***
FacuLarrocca: raises $0.20 to $0.30
manganito17: folds 
hempju1ce: folds 
Rosska(Rus): raises $0.90 to $1.20
saitam_06: folds 
FacuLarrocca: folds 
Uncalled bet ($0.90) returned to Rosska(Rus)
Rosska(Rus) collected $0.70 from pot
Rosska(Rus): doesn't show hand 
*** SUMMARY ***
Total pot $0.70 | Rake $0 
Seat 1: Rosska(Rus) (small blind) collected ($0.70)
Seat 2: saitam_06 (big blind) folded before Flop
Seat 3: FacuLarrocca folded before Flop
Seat 4: manganito17 folded before Flop (didn't bet)
Seat 5: hempju1ce (button) folded before Flop (didn't bet)



PokerStars Hand #222981601394:  Hold'em No Limit ($0.05/$0.10 USD) - 2021/01/23 20:30:01 ET
Table 'Lova III' 6-max Seat #1 is the button
Seat 1: Rosska(Rus) ($13.74 in chips) 
Seat 2: saitam_06 ($10 in chips) 
Seat 3: FacuLarrocca ($11.48 in chips) 
Seat 4: manganito17 ($10 in chips) 
Seat 5: hempju1ce ($29.76 in chips) 
saitam_06: posts small blind $0.05
FacuLarrocca: posts big blind $0.10
*** HOLE CARDS ***
manganito17: folds 
hempju1ce: folds 
Rosska(Rus): raises $0.20 to $0.30
saitam_06: folds 
FacuLarrocca: calls $0.20
*** FLOP *** [9d 5h 2h]
FacuLarrocca: checks 
Rosska(Rus): checks 
*** TURN *** [9d 5h 2h] [8c]
FacuLarrocca: bets $0.47
Rosska(Rus): folds 
Uncalled bet ($0.47) returned to FacuLarrocca
FacuLarrocca collected $0.62 from pot
FacuLarrocca: doesn't show hand 
*** SUMMARY ***
Total pot $0.65 | Rake $0.03 
Board [9d 5h 2h 8c]
Seat 1: Rosska(Rus) (button) folded on the Turn
Seat 2: saitam_06 (small blind) folded before Flop
Seat 3: FacuLarrocca (big blind) collected ($0.62)
Seat 4: manganito17 folded before Flop (didn't bet)
Seat 5: hempju1ce folded before Flop (didn't bet)



PokerStars Hand #222981611957:  Hold'em No Limit ($0.05/$0.10 USD) - 2021/01/23 20:30:26 ET
Table 'Lova III' 6-max Seat #2 is the button
Seat 1: Rosska(Rus) ($13.44 in chips) 
Seat 2: saitam_06 ($10 in chips) 
Seat 3: FacuLarrocca ($11.80 in chips) 
Seat 4: manganito17 ($10 in chips) 
Seat 5: hempju1ce ($29.76 in chips) 
FacuLarrocca: posts small blind $0.05
manganito17: posts big blind $0.10
*** HOLE CARDS ***
hempju1ce: folds 
Rosska(Rus): folds 
saitam_06: folds 
FacuLarrocca: raises $0.20 to $0.30
manganito17: folds 
Uncalled bet ($0.20) returned to FacuLarrocca
FacuLarrocca collected $0.20 from pot
FacuLarrocca: doesn't show hand 
*** SUMMARY ***
Total pot $0.20 | Rake $0 
Seat 1: Rosska(Rus) folded before Flop (didn't bet)
Seat 2: saitam_06 (button) folded before Flop (didn't bet)
Seat 3: FacuLarrocca (small blind) collected ($0.20)
Seat 4: manganito17 (big blind) folded before Flop
Seat 5: hempju1ce folded before Flop (didn't bet)



PokerStars Hand #222981619300:  Hold'em No Limit ($0.05/$0.10 USD) - 2021/01/23 20:30:43 ET
Table 'Lova III' 6-max Seat #3 is the button
Seat 1: Rosska(Rus) ($13.44 in chips) 
Seat 2: saitam_06 ($10 in chips) 
Seat 3: FacuLarrocca ($11.90 in chips) 
Seat 4: manganito17 ($10 in chips) 
Seat 5: hempju1ce ($29.76 in chips) 
manganito17: posts small blind $0.05
hempju1ce: posts big blind $0.10
*** HOLE CARDS ***
Rosska(Rus): folds 
saitam_06: raises $0.15 to $0.25
FacuLarrocca: folds 
manganito17: folds 
hempju1ce: calls $0.15
*** FLOP *** [Qc 7h Kc]
hempju1ce: checks 
saitam_06: bets $0.27
hempju1ce: folds 
Uncalled bet ($0.27) returned to saitam_06
saitam_06 collected $0.53 from pot
saitam_06: doesn't show hand 
*** SUMMARY ***
Total pot $0.55 | Rake $0.02 
Board [Qc 7h Kc]
Seat 1: Rosska(Rus) folded before Flop (didn't bet)
Seat 2: saitam_06 collected ($0.53)
Seat 3: FacuLarrocca (button) folded before Flop (didn't bet)
Seat 4: manganito17 (small blind) folded before Flop
Seat 5: hempju1ce (big blind) folded on the Flop



PokerStars Hand #222981631995:  Hold'em No Limit ($0.05/$0.10 USD) - 2021/01/23 20:31:12 ET
Table 'Lova III' 6-max Seat #4 is the button
Seat 1: Rosska(Rus) ($13.44 in chips) 
Seat 2: saitam_06 ($10.28 in chips) 
Seat 3: FacuLarrocca ($11.90 in chips) 
Seat 4: manganito17 ($10 in chips) 
Seat 5: hempju1ce ($29.51 in chips) 
Seat 6: AAAcostA ($10 in chips) 
hempju1ce: posts small blind $0.05
AAAcostA: posts big blind $0.10
*** HOLE CARDS ***
Rosska(Rus): folds 
saitam_06: raises $0.15 to $0.25
FacuLarrocca: folds 
manganito17: folds 
hempju1ce: calls $0.20
AAAcostA: folds 
*** FLOP *** [9d Kc Kd]
hempju1ce: checks 
saitam_06: bets $0.19
hempju1ce: calls $0.19
*** TURN *** [9d Kc Kd] [6s]
hempju1ce: bets $0.70
saitam_06: calls $0.70
*** RIVER *** [9d Kc Kd 6s] [Tc]
hempju1ce: checks 
saitam_06: bets $1.30
hempju1ce: folds 
Uncalled bet ($1.30) returned to saitam_06
saitam_06 collected $2.27 from pot
saitam_06: doesn't show hand 
*** SUMMARY ***
Total pot $2.38 | Rake $0.11 
Board [9d Kc Kd 6s Tc]
Seat 1: Rosska(Rus) folded before Flop (didn't bet)
Seat 2: saitam_06 collected ($2.27)
Seat 3: FacuLarrocca folded before Flop (didn't bet)
Seat 4: manganito17 (button) folded before Flop (didn't bet)
Seat 5: hempju1ce (small blind) folded on the River
Seat 6: AAAcostA (big blind) folded before Flop



PokerStars Hand #222981654292:  Hold'em No Limit ($0.05/$0.10 USD) - 2021/01/23 20:32:03 ET
Table 'Lova III' 6-max Seat #5 is the button
Seat 1: Rosska(Rus) ($13.44 in chips) 
Seat 2: saitam_06 ($11.41 in chips) 
Seat 3: FacuLarrocca ($11.90 in chips) 
Seat 4: manganito17 ($10 in chips) 
Seat 5: hempju1ce ($28.37 in chips) 
Seat 6: AAAcostA ($10 in chips) 
AAAcostA: posts small blind $0.05
Rosska(Rus): posts big blind $0.10
*** HOLE CARDS ***
saitam_06: folds 
FacuLarrocca: folds 
manganito17: raises $0.15 to $0.25
hempju1ce: calls $0.25
AAAcostA: folds 
Rosska(Rus): folds 
*** FLOP *** [6s Kd Qh]
manganito17: bets $0.20
hempju1ce: calls $0.20
*** TURN *** [6s Kd Qh] [8s]
manganito17: checks 
hempju1ce: checks 
*** RIVER *** [6s Kd Qh 8s] [Tc]
manganito17: bets $0.75
hempju1ce: folds 
Uncalled bet ($0.75) returned to manganito17
manganito17 collected $1 from pot
manganito17: doesn't show hand 
*** SUMMARY ***
Total pot $1.05 | Rake $0.05 
Board [6s Kd Qh 8s Tc]
Seat 1: Rosska(Rus) (big blind) folded before Flop
Seat 2: saitam_06 folded before Flop (didn't bet)
Seat 3: FacuLarrocca folded before Flop (didn't bet)
Seat 4: manganito17 collected ($1)
Seat 5: hempju1ce (button) folded on the River
Seat 6: AAAcostA (small blind) folded before Flop



PokerStars Hand #222981674738:  Hold'em No Limit ($0.05/$0.10 USD) - 2021/01/23 20:32:51 ET
Table 'Lova III' 6-max Seat #6 is the button
Seat 1: Rosska(Rus) ($13.34 in chips) 
Seat 2: saitam_06 ($11.41 in chips) 
Seat 3: FacuLarrocca ($11.90 in chips) 
Seat 4: manganito17 ($10.55 in chips) 
Seat 5: hempju1ce ($27.92 in chips) 
Seat 6: AAAcostA ($10 in chips) 
Rosska(Rus): posts small blind $0.05
saitam_06: posts big blind $0.10
*** HOLE CARDS ***
FacuLarrocca: folds 
manganito17: folds 
hempju1ce: raises $0.20 to $0.30
AAAcostA: folds 
Rosska(Rus): calls $0.25
saitam_06: folds 
*** FLOP *** [7h 8c Ac]
Rosska(Rus): checks 
hempju1ce: checks 
*** TURN *** [7h 8c Ac] [Ks]
Rosska(Rus): bets $0.52
hempju1ce: folds 
Uncalled bet ($0.52) returned to Rosska(Rus)
Rosska(Rus) collected $0.67 from pot
Rosska(Rus): doesn't show hand 
*** SUMMARY ***
Total pot $0.70 | Rake $0.03 
Board [7h 8c Ac Ks]
Seat 1: Rosska(Rus) (small blind) collected ($0.67)
Seat 2: saitam_06 (big blind) folded before Flop
Seat 3: FacuLarrocca folded before Flop (didn't bet)
Seat 4: manganito17 folded before Flop (didn't bet)
Seat 5: hempju1ce folded on the Turn
Seat 6: AAAcostA (button) folded before Flop (didn't bet)



PokerStars Hand #222981690123:  Hold'em No Limit ($0.05/$0.10 USD) - 2021/01/23 20:33:27 ET
Table 'Lova III' 6-max Seat #1 is the button
Seat 1: Rosska(Rus) ($13.71 in chips) 
Seat 2: saitam_06 ($11.31 in chips) 
Seat 3: FacuLarrocca ($11.90 in chips) 
Seat 4: manganito17 ($10.55 in chips) 
Seat 5: hempju1ce ($27.62 in chips) 
Seat 6: AAAcostA ($10 in chips) 
saitam_06: posts small blind $0.05
FacuLarrocca: posts big blind $0.10
*** HOLE CARDS ***
manganito17: folds 
hempju1ce: raises $0.10 to $0.20
AAAcostA: folds 
Rosska(Rus): folds 
saitam_06: folds 
FacuLarrocca: calls $0.10
*** FLOP *** [5d Ah Ac]
FacuLarrocca: checks 
hempju1ce: checks 
*** TURN *** [5d Ah Ac] [Js]
FacuLarrocca: bets $0.32
hempju1ce: calls $0.32
*** RIVER *** [5d Ah Ac Js] [6h]
FacuLarrocca: checks 
hempju1ce: bets $0.52
FacuLarrocca: calls $0.52
*** SHOW DOWN ***
hempju1ce: shows [Jd 8d] (two pair, Aces and Jacks)
FacuLarrocca: mucks hand 
hempju1ce collected $2.03 from pot
*** SUMMARY ***
Total pot $2.13 | Rake $0.10 
Board [5d Ah Ac Js 6h]
Seat 1: Rosska(Rus) (button) folded before Flop (didn't bet)
Seat 2: saitam_06 (small blind) folded before Flop
Seat 3: FacuLarrocca (big blind) mucked
Seat 4: manganito17 folded before Flop (didn't bet)
Seat 5: hempju1ce showed [Jd 8d] and won ($2.03) with two pair, Aces and Jacks
Seat 6: AAAcostA folded before Flop (didn't bet)



PokerStars Hand #222981714148:  Hold'em No Limit ($0.05/$0.10 USD) - 2021/01/23 20:34:22 ET
Table 'Lova III' 6-max Seat #2 is the button
Seat 1: Rosska(Rus) ($13.71 in chips) 
Seat 2: saitam_06 ($11.26 in chips) 
Seat 3: FacuLarrocca ($10.86 in chips) 
Seat 4: manganito17 ($10.55 in chips) 
Seat 5: hempju1ce ($28.61 in chips) 
Seat 6: AAAcostA ($10 in chips) 
FacuLarrocca: posts small blind $0.05
manganito17: posts big blind $0.10
*** HOLE CARDS ***
hempju1ce: folds 
AAAcostA: folds 
Rosska(Rus): raises $0.20 to $0.30
saitam_06: folds 
FacuLarrocca: folds 
manganito17: calls $0.20
*** FLOP *** [Qh 9c 8h]
manganito17: checks 
Rosska(Rus): bets $0.48
manganito17: folds 
Uncalled bet ($0.48) returned to Rosska(Rus)
Rosska(Rus) collected $0.62 from pot
Rosska(Rus): doesn't show hand 
*** SUMMARY ***
Total pot $0.65 | Rake $0.03 
Board [Qh 9c 8h]
Seat 1: Rosska(Rus) collected ($0.62)
Seat 2: saitam_06 (button) folded before Flop (didn't bet)
Seat 3: FacuLarrocca (small blind) folded before Flop
Seat 4: manganito17 (big blind) folded on the Flop
Seat 5: hempju1ce folded before Flop (didn't bet)
Seat 6: AAAcostA folded before Flop (didn't bet)



PokerStars Hand #222981733198:  Hold'em No Limit ($0.05/$0.10 USD) - 2021/01/23 20:35:00 ET
Table 'Lova III' 6-max Seat #3 is the button
Seat 1: Rosska(Rus) ($14.03 in chips) 
Seat 2: saitam_06 ($11.26 in chips) 
Seat 3: FacuLarrocca ($10.81 in chips) 
Seat 4: manganito17 ($10.25 in chips) 
Seat 5: hempju1ce ($28.61 in chips) 
Seat 6: AAAcostA ($10 in chips) 
manganito17: posts small blind $0.05
hempju1ce: posts big blind $0.10
*** HOLE CARDS ***
AAAcostA: folds 
Rosska(Rus): folds 
saitam_06: folds 
FacuLarrocca: folds 
manganito17: raises $0.20 to $0.30
hempju1ce: calls $0.20
*** FLOP *** [8s Kc 6c]
manganito17: checks 
hempju1ce: bets $0.40
manganito17: folds 
Uncalled bet ($0.40) returned to hempju1ce
hempju1ce collected $0.57 from pot
hempju1ce: doesn't show hand 
*** SUMMARY ***
Total pot $0.60 | Rake $0.03 
Board [8s Kc 6c]
Seat 1: Rosska(Rus) folded before Flop (didn't bet)
Seat 2: saitam_06 folded before Flop (didn't bet)
Seat 3: FacuLarrocca (button) folded before Flop (didn't bet)
Seat 4: manganito17 (small blind) folded on the Flop
Seat 5: hempju1ce (big blind) collected ($0.57)
Seat 6: AAAcostA folded before Flop (didn't bet)



PokerStars Hand #222981749794:  Hold'em No Limit ($0.05/$0.10 USD) - 2021/01/23 20:35:39 ET
Table 'Lova III' 6-max Seat #4 is the button
Seat 1: Rosska(Rus) ($14.03 in chips) 
Seat 2: saitam_06 ($11.26 in chips) 
Seat 3: FacuLarrocca ($10.81 in chips) 
Seat 4: manganito17 ($10 in chips) 
Seat 5: hempju1ce ($28.88 in chips) 
Seat 6: AAAcostA ($10 in chips) 
hempju1ce: posts small blind $0.05
AAAcostA: posts big blind $0.10
*** HOLE CARDS ***
Rosska(Rus): folds 
saitam_06: folds 
FacuLarrocca: folds 
manganito17 has timed out
manganito17: folds 
hempju1ce: calls $0.05
AAAcostA: raises $0.40 to $0.50
hempju1ce: folds 
Uncalled bet ($0.40) returned to AAAcostA
AAAcostA collected $0.20 from pot
AAAcostA: doesn't show hand 
*** SUMMARY ***
Total pot $0.20 | Rake $0 
Seat 1: Rosska(Rus) folded before Flop (didn't bet)
Seat 2: saitam_06 folded before Flop (didn't bet)
Seat 3: FacuLarrocca folded before Flop (didn't bet)
Seat 4: manganito17 (button) folded before Flop (didn't bet)
Seat 5: hempju1ce (small blind) folded before Flop
Seat 6: AAAcostA (big blind) collected ($0.20)



PokerStars Hand #222981762048:  Hold'em No Limit ($0.05/$0.10 USD) - 2021/01/23 20:36:08 ET
Table 'Lova III' 6-max Seat #5 is the button
Seat 1: Rosska(Rus) ($14.03 in chips) 
Seat 2: saitam_06 ($11.26 in chips) 
Seat 3: FacuLarrocca ($10.81 in chips) 
Seat 4: manganito17 ($10 in chips) 
Seat 5: hempju1ce ($28.78 in chips) 
Seat 6: AAAcostA ($10.10 in chips) 
AAAcostA: posts small blind $0.05
Rosska(Rus): posts big blind $0.10
*** HOLE CARDS ***
saitam_06: folds 
FacuLarrocca: folds 
manganito17: folds 
hempju1ce: calls $0.10
AAAcostA: folds 
Rosska(Rus): raises $0.35 to $0.45
hempju1ce: folds 
Uncalled bet ($0.35) returned to Rosska(Rus)
Rosska(Rus) collected $0.25 from pot
Rosska(Rus): doesn't show hand 
*** SUMMARY ***
Total pot $0.25 | Rake $0 
Seat 1: Rosska(Rus) (big blind) collected ($0.25)
Seat 2: saitam_06 folded before Flop (didn't bet)
Seat 3: FacuLarrocca folded before Flop (didn't bet)
Seat 4: manganito17 folded before Flop (didn't bet)
Seat 5: hempju1ce (button) folded before Flop
Seat 6: AAAcostA (small blind) folded before Flop



PokerStars Hand #222981773829:  Hold'em No Limit ($0.05/$0.10 USD) - 2021/01/23 20:36:36 ET
Table 'Lova III' 6-max Seat #6 is the button
Seat 1: Rosska(Rus) ($14.18 in chips) 
Seat 2: saitam_06 ($11.26 in chips) 
Seat 3: FacuLarrocca ($10.81 in chips) 
Seat 4: manganito17 ($10 in chips) 
Seat 5: hempju1ce ($28.68 in chips) 
Seat 6: AAAcostA ($10.05 in chips) 
Rosska(Rus): posts small blind $0.05
saitam_06: posts big blind $0.10
*** HOLE CARDS ***
FacuLarrocca: folds 
FacuLarrocca leaves the table
manganito17: raises $0.15 to $0.25
hempju1ce: calls $0.25
AAAcostA: folds 
Rosska(Rus): folds 
saitam_06: calls $0.15
*** FLOP *** [Td 7h 8s]
syko74 joins the table at seat #3 
saitam_06: checks 
manganito17: checks 
hempju1ce: checks 
*** TURN *** [Td 7h 8s] [5h]
saitam_06: checks 
manganito17: checks 
hempju1ce: checks 
*** RIVER *** [Td 7h 8s 5h] [Ks]
saitam_06: bets $0.57
manganito17: calls $0.57
hempju1ce: folds 
*** SHOW DOWN ***
saitam_06: shows [6c Qc] (high card King)
manganito17: shows [Qh Kc] (a pair of Kings)
manganito17 collected $1.85 from pot
*** SUMMARY ***
Total pot $1.94 | Rake $0.09 
Board [Td 7h 8s 5h Ks]
Seat 1: Rosska(Rus) (small blind) folded before Flop
Seat 2: saitam_06 (big blind) showed [6c Qc] and lost with high card King
Seat 3: FacuLarrocca folded before Flop (didn't bet)
Seat 4: manganito17 showed [Qh Kc] and won ($1.85) with a pair of Kings
Seat 5: hempju1ce folded on the River
Seat 6: AAAcostA (button) folded before Flop (didn't bet)



PokerStars Hand #222981804798:  Hold'em No Limit ($0.05/$0.10 USD) - 2021/01/23 20:37:49 ET
Table 'Lova III' 6-max Seat #1 is the button
Seat 1: Rosska(Rus) ($14.13 in chips) 
Seat 2: saitam_06 ($10.44 in chips) 
Seat 3: syko74 ($10 in chips) 
Seat 4: manganito17 ($11.03 in chips) 
Seat 5: hempju1ce ($28.43 in chips) 
Seat 6: AAAcostA ($10.05 in chips) 
saitam_06: posts small blind $0.05
syko74: posts big blind $0.10
*** HOLE CARDS ***
manganito17: raises $0.15 to $0.25
hempju1ce: folds 
AAAcostA: folds 
Rosska(Rus): folds 
saitam_06: folds 
syko74: folds 
Uncalled bet ($0.15) returned to manganito17
manganito17 collected $0.25 from pot
manganito17: doesn't show hand 
*** SUMMARY ***
Total pot $0.25 | Rake $0 
Seat 1: Rosska(Rus) (button) folded before Flop (didn't bet)
Seat 2: saitam_06 (small blind) folded before Flop
Seat 3: syko74 (big blind) folded before Flop
Seat 4: manganito17 collected ($0.25)
Seat 5: hempju1ce folded before Flop (didn't bet)
Seat 6: AAAcostA folded before Flop (didn't bet)



PokerStars Hand #222981811145:  Hold'em No Limit ($0.05/$0.10 USD) - 2021/01/23 20:38:04 ET
Table 'Lova III' 6-max Seat #2 is the button
Seat 1: Rosska(Rus) ($14.13 in chips) 
Seat 2: saitam_06 ($10.39 in chips) 
Seat 3: syko74 ($10 in chips) 
Seat 4: manganito17 ($11.18 in chips) 
Seat 5: hempju1ce ($28.43 in chips) 
Seat 6: AAAcostA ($10.05 in chips) 
syko74: posts small blind $0.05
manganito17: posts big blind $0.10
*** HOLE CARDS ***
hempju1ce: folds 
AAAcostA: raises $0.20 to $0.30
Rosska(Rus): folds 
saitam_06: folds 
syko74: folds 
manganito17: folds 
Uncalled bet ($0.20) returned to AAAcostA
AAAcostA collected $0.25 from pot
AAAcostA: doesn't show hand 
*** SUMMARY ***
Total pot $0.25 | Rake $0 
Seat 1: Rosska(Rus) folded before Flop (didn't bet)
Seat 2: saitam_06 (button) folded before Flop (didn't bet)
Seat 3: syko74 (small blind) folded before Flop
Seat 4: manganito17 (big blind) folded before Flop
Seat 5: hempju1ce folded before Flop (didn't bet)
Seat 6: AAAcostA collected ($0.25)



PokerStars Hand #222981818845:  Hold'em No Limit ($0.05/$0.10 USD) - 2021/01/23 20:38:22 ET
Table 'Lova III' 6-max Seat #3 is the button
Seat 1: Rosska(Rus) ($14.13 in chips) 
Seat 2: saitam_06 ($10.39 in chips) 
Seat 3: syko74 ($10 in chips) 
Seat 4: manganito17 ($11.08 in chips) 
Seat 5: hempju1ce ($28.43 in chips) 
Seat 6: AAAcostA ($10.20 in chips) 
manganito17: posts small blind $0.05
hempju1ce: posts big blind $0.10
*** HOLE CARDS ***
AAAcostA: folds 
Rosska(Rus): raises $0.20 to $0.30
saitam_06: folds 
syko74: folds 
manganito17: folds 
hempju1ce: calls $0.20
*** FLOP *** [5h Kd 3h]
hempju1ce: checks 
Rosska(Rus): checks 
*** TURN *** [5h Kd 3h] [5c]
hempju1ce: checks 
Rosska(Rus): checks 
*** RIVER *** [5h Kd 3h 5c] [As]
hempju1ce: checks 
Rosska(Rus): checks 
*** SHOW DOWN ***
hempju1ce: shows [9h Jd] (a pair of Fives)
Rosska(Rus): shows [Qs Qc] (two pair, Queens and Fives)
Rosska(Rus) collected $0.62 from pot
*** SUMMARY ***
Total pot $0.65 | Rake $0.03 
Board [5h Kd 3h 5c As]
Seat 1: Rosska(Rus) showed [Qs Qc] and won ($0.62) with two pair, Queens and Fives
Seat 2: saitam_06 folded before Flop (didn't bet)
Seat 3: syko74 (button) folded before Flop (didn't bet)
Seat 4: manganito17 (small blind) folded before Flop
Seat 5: hempju1ce (big blind) showed [9h Jd] and lost with a pair of Fives
Seat 6: AAAcostA folded before Flop (didn't bet)



PokerStars Hand #222981839146:  Hold'em No Limit ($0.05/$0.10 USD) - 2021/01/23 20:39:04 ET
Table 'Lova III' 6-max Seat #4 is the button
Seat 1: Rosska(Rus) ($14.45 in chips) 
Seat 2: saitam_06 ($10.39 in chips) 
Seat 3: syko74 ($10 in chips) 
Seat 4: manganito17 ($11.03 in chips) 
Seat 5: hempju1ce ($28.13 in chips) 
Seat 6: AAAcostA ($10.20 in chips) 
hempju1ce: posts small blind $0.05
AAAcostA: posts big blind $0.10
*** HOLE CARDS ***
Rosska(Rus): folds 
saitam_06: folds 
syko74: folds 
manganito17: raises $0.20 to $0.30
hempju1ce: folds 
AAAcostA: folds 
Uncalled bet ($0.20) returned to manganito17
manganito17 collected $0.25 from pot
manganito17: doesn't show hand 
*** SUMMARY ***
Total pot $0.25 | Rake $0 
Seat 1: Rosska(Rus) folded before Flop (didn't bet)
Seat 2: saitam_06 folded before Flop (didn't bet)
Seat 3: syko74 folded before Flop (didn't bet)
Seat 4: manganito17 (button) collected ($0.25)
Seat 5: hempju1ce (small blind) folded before Flop
Seat 6: AAAcostA (big blind) folded before Flop



PokerStars Hand #222981848994:  Hold'em No Limit ($0.05/$0.10 USD) - 2021/01/23 20:39:27 ET
Table 'Lova III' 6-max Seat #5 is the button
Seat 1: Rosska(Rus) ($14.45 in chips) 
Seat 2: saitam_06 ($10.39 in chips) 
Seat 3: syko74 ($10 in chips) 
Seat 4: manganito17 ($11.18 in chips) 
Seat 5: hempju1ce ($28.08 in chips) 
Seat 6: AAAcostA ($10.10 in chips) 
AAAcostA: posts small blind $0.05
Rosska(Rus): posts big blind $0.10
*** HOLE CARDS ***
saitam_06: raises $0.15 to $0.25
syko74: folds 
manganito17: folds 
hempju1ce: folds 
AAAcostA: folds 
Rosska(Rus): folds 
Uncalled bet ($0.15) returned to saitam_06
saitam_06 collected $0.25 from pot
saitam_06: doesn't show hand 
*** SUMMARY ***
Total pot $0.25 | Rake $0 
Seat 1: Rosska(Rus) (big blind) folded before Flop
Seat 2: saitam_06 collected ($0.25)
Seat 3: syko74 folded before Flop (didn't bet)
Seat 4: manganito17 folded before Flop (didn't bet)
Seat 5: hempju1ce (button) folded before Flop (didn't bet)
Seat 6: AAAcostA (small blind) folded before Flop



PokerStars Hand #222981854766:  Hold'em No Limit ($0.05/$0.10 USD) - 2021/01/23 20:39:41 ET
Table 'Lova III' 6-max Seat #6 is the button
Seat 1: Rosska(Rus) ($14.35 in chips) 
Seat 2: saitam_06 ($10.54 in chips) 
Seat 3: syko74 ($10 in chips) 
Seat 4: manganito17 ($11.18 in chips) 
Seat 5: hempju1ce ($28.08 in chips) 
Seat 6: AAAcostA ($10.05 in chips) 
Rosska(Rus): posts small blind $0.05
saitam_06: posts big blind $0.10
*** HOLE CARDS ***
syko74: raises $0.20 to $0.30
manganito17: folds 
hempju1ce: calls $0.30
AAAcostA: folds 
Rosska(Rus): folds 
saitam_06: folds 
*** FLOP *** [9c Ac 5h]
syko74: bets $0.40
hempju1ce: calls $0.40
*** TURN *** [9c Ac 5h] [4c]
syko74: checks 
hempju1ce: bets $0.74
syko74: calls $0.74
*** RIVER *** [9c Ac 5h 4c] [8c]
syko74: checks 
hempju1ce: bets $1.44
syko74: raises $1.66 to $3.10
hempju1ce: calls $1.66
*** SHOW DOWN ***
syko74: shows [Qd Qc] (a flush, Ace high)
hempju1ce: shows [2c Kc] (a flush, Ace high - King higher)
hempju1ce collected $8.81 from pot
*** SUMMARY ***
Total pot $9.23 | Rake $0.42 
Board [9c Ac 5h 4c 8c]
Seat 1: Rosska(Rus) (small blind) folded before Flop
Seat 2: saitam_06 (big blind) folded before Flop
Seat 3: syko74 showed [Qd Qc] and lost with a flush, Ace high
Seat 4: manganito17 folded before Flop (didn't bet)
Seat 5: hempju1ce showed [2c Kc] and won ($8.81) with a flush, Ace high
Seat 6: AAAcostA (button) folded before Flop (didn't bet)



PokerStars Hand #222981884066:  Hold'em No Limit ($0.05/$0.10 USD) - 2021/01/23 20:40:50 ET
Table 'Lova III' 6-max Seat #1 is the button
Seat 1: Rosska(Rus) ($14.30 in chips) 
Seat 2: saitam_06 ($10.44 in chips) 
Seat 3: syko74 ($10 in chips) 
Seat 4: manganito17 ($11.18 in chips) 
Seat 5: hempju1ce ($32.35 in chips) 
Seat 6: AAAcostA ($10.05 in chips) 
saitam_06: posts small blind $0.05
syko74: posts big blind $0.10
*** HOLE CARDS ***
manganito17: folds 
hempju1ce: folds 
AAAcostA: folds 
Rosska(Rus): folds 
saitam_06: folds 
Uncalled bet ($0.05) returned to syko74
syko74 collected $0.10 from pot
*** SUMMARY ***
Total pot $0.10 | Rake $0 
Seat 1: Rosska(Rus) (button) folded before Flop (didn't bet)
Seat 2: saitam_06 (small blind) folded before Flop
Seat 3: syko74 (big blind) collected ($0.10)
Seat 4: manganito17 folded before Flop (didn't bet)
Seat 5: hempju1ce folded before Flop (didn't bet)
Seat 6: AAAcostA folded before Flop (didn't bet)



PokerStars Hand #222981893621:  Hold'em No Limit ($0.05/$0.10 USD) - 2021/01/23 20:41:13 ET
Table 'Lova III' 6-max Seat #2 is the button
Seat 1: Rosska(Rus) ($14.30 in chips) 
Seat 2: saitam_06 ($10.39 in chips) 
Seat 3: syko74 ($10.05 in chips) 
Seat 4: manganito17 ($11.18 in chips) 
Seat 5: hempju1ce ($32.35 in chips) 
Seat 6: AAAcostA ($10.05 in chips) 
syko74: posts small blind $0.05
manganito17: posts big blind $0.10
*** HOLE CARDS ***
hempju1ce: folds 
AAAcostA: folds 
Rosska(Rus): folds 
saitam_06: raises $0.15 to $0.25
syko74: folds 
manganito17: calls $0.15
*** FLOP *** [7h Th 5c]
manganito17: checks 
saitam_06: checks 
*** TURN *** [7h Th 5c] [4h]
manganito17: bets $0.40
saitam_06: calls $0.40
*** RIVER *** [7h Th 5c 4h] [Qc]
manganito17: checks 
saitam_06: bets $0.97
manganito17: calls $0.97
*** SHOW DOWN ***
saitam_06: shows [Ah 8c] (high card Ace)
manganito17: shows [Jh Qs] (a pair of Queens)
manganito17 collected $3.14 from pot
*** SUMMARY ***
Total pot $3.29 | Rake $0.15 
Board [7h Th 5c 4h Qc]
Seat 1: Rosska(Rus) folded before Flop (didn't bet)
Seat 2: saitam_06 (button) showed [Ah 8c] and lost with high card Ace
Seat 3: syko74 (small blind) folded before Flop
Seat 4: manganito17 (big blind) showed [Jh Qs] and won ($3.14) with a pair of Queens
Seat 5: hempju1ce folded before Flop (didn't bet)
Seat 6: AAAcostA folded before Flop (didn't bet)



PokerStars Hand #222981924431:  Hold'em No Limit ($0.05/$0.10 USD) - 2021/01/23 20:42:26 ET
Table 'Lova III' 6-max Seat #3 is the button
Seat 1: Rosska(Rus) ($14.30 in chips) 
Seat 2: saitam_06 ($10 in chips) 
Seat 3: syko74 ($10 in chips) 
Seat 4: manganito17 ($12.70 in chips) 
Seat 5: hempju1ce ($32.35 in chips) 
Seat 6: AAAcostA ($10.05 in chips) 
manganito17: posts small blind $0.05
hempju1ce: posts big blind $0.10
*** HOLE CARDS ***
AAAcostA: folds 
Rosska(Rus): folds 
saitam_06: raises $0.15 to $0.25
syko74: folds 
manganito17: folds 
hempju1ce: folds 
Uncalled bet ($0.15) returned to saitam_06
saitam_06 collected $0.25 from pot
saitam_06: doesn't show hand 
*** SUMMARY ***
Total pot $0.25 | Rake $0 
Seat 1: Rosska(Rus) folded before Flop (didn't bet)
Seat 2: saitam_06 collected ($0.25)
Seat 3: syko74 (button) folded before Flop (didn't bet)
Seat 4: manganito17 (small blind) folded before Flop
Seat 5: hempju1ce (big blind) folded before Flop
Seat 6: AAAcostA folded before Flop (didn't bet)



PokerStars Hand #222981931977:  Hold'em No Limit ($0.05/$0.10 USD) - 2021/01/23 20:42:44 ET
Table 'Lova III' 6-max Seat #4 is the button
Seat 1: Rosska(Rus) ($14.30 in chips) 
Seat 2: saitam_06 ($10.15 in chips) 
Seat 3: syko74 ($10 in chips) 
Seat 4: manganito17 ($12.65 in chips) 
Seat 5: hempju1ce ($32.25 in chips) 
Seat 6: AAAcostA ($10.05 in chips) 
hempju1ce: posts small blind $0.05
AAAcostA: posts big blind $0.10
*** HOLE CARDS ***
Rosska(Rus): folds 
saitam_06: folds 
syko74: raises $0.20 to $0.30
manganito17: folds 
hempju1ce: folds 
AAAcostA: folds 
Uncalled bet ($0.20) returned to syko74
syko74 collected $0.25 from pot
*** SUMMARY ***
Total pot $0.25 | Rake $0 
Seat 1: Rosska(Rus) folded before Flop (didn't bet)
Seat 2: saitam_06 folded before Flop (didn't bet)
Seat 3: syko74 collected ($0.25)
Seat 4: manganito17 (button) folded before Flop (didn't bet)
Seat 5: hempju1ce (small blind) folded before Flop
Seat 6: AAAcostA (big blind) folded before Flop



PokerStars Hand #222982205043:  Hold'em No Limit ($0.05/$0.10 USD) - 2021/01/23 20:53:19 ET
Table 'Lova III' 6-max Seat #4 is the button
Seat 1: DontSleep111 ($10.46 in chips) 
Seat 2: Angie Senpai ($11.28 in chips) 
Seat 3: father here ($10 in chips) 
Seat 4: manganito17 ($12.80 in chips) 
Seat 5: hempju1ce ($31.94 in chips) 
Seat 6: AAAcostA ($10.25 in chips) 
hempju1ce: posts small blind $0.05
AAAcostA: posts big blind $0.10
*** HOLE CARDS ***
DontSleep111: raises $0.15 to $0.25
Angie Senpai: raises $0.50 to $0.75
father here: folds 
manganito17: folds 
hempju1ce: folds 
AAAcostA: folds 
DontSleep111: raises $1.25 to $2
Angie Senpai: calls $1.25
*** FLOP *** [Ah Ts Ac]
DontSleep111: bets $0.59
Angie Senpai: calls $0.59
*** TURN *** [Ah Ts Ac] [3d]
DontSleep111: bets $1.78
Angie Senpai: calls $1.78
*** RIVER *** [Ah Ts Ac 3d] [2c]
DontSleep111: checks 
Angie Senpai: bets $6.91 and is all-in
DontSleep111: folds 
Uncalled bet ($6.91) returned to Angie Senpai
Angie Senpai collected $8.49 from pot
Angie Senpai: doesn't show hand 
*** SUMMARY ***
Total pot $8.89 | Rake $0.40 
Board [Ah Ts Ac 3d 2c]
Seat 1: DontSleep111 folded on the River
Seat 2: Angie Senpai collected ($8.49)
Seat 3: father here folded before Flop (didn't bet)
Seat 4: manganito17 (button) folded before Flop (didn't bet)
Seat 5: hempju1ce (small blind) folded before Flop
Seat 6: AAAcostA (big blind) folded before Flop



PokerStars Hand #222982238069:  Hold'em No Limit ($0.05/$0.10 USD) - 2021/01/23 20:54:41 ET
Table 'Lova III' 6-max Seat #5 is the button
Seat 1: DontSleep111 ($10 in chips) 
Seat 2: Angie Senpai ($15.40 in chips) 
Seat 3: father here ($10 in chips) 
Seat 4: manganito17 ($12.80 in chips) 
Seat 5: hempju1ce ($31.89 in chips) 
Seat 6: AAAcostA ($10.15 in chips) 
AAAcostA: posts small blind $0.05
DontSleep111: posts big blind $0.10
*** HOLE CARDS ***
Angie Senpai: folds 
father here: folds 
manganito17: raises $0.15 to $0.25
hempju1ce: folds 
AAAcostA: folds 
DontSleep111: calls $0.15
*** FLOP *** [Qc 9d 7h]
DontSleep111: checks 
manganito17: bets $0.17
DontSleep111: folds 
Uncalled bet ($0.17) returned to manganito17
manganito17 collected $0.53 from pot
manganito17: doesn't show hand 
*** SUMMARY ***
Total pot $0.55 | Rake $0.02 
Board [Qc 9d 7h]
Seat 1: DontSleep111 (big blind) folded on the Flop
Seat 2: Angie Senpai folded before Flop (didn't bet)
Seat 3: father here folded before Flop (didn't bet)
Seat 4: manganito17 collected ($0.53)
Seat 5: hempju1ce (button) folded before Flop (didn't bet)
Seat 6: AAAcostA (small blind) folded before Flop



PokerStars Hand #222982251307:  Hold'em No Limit ($0.05/$0.10 USD) - 2021/01/23 20:55:14 ET
Table 'Lova III' 6-max Seat #6 is the button
Seat 1: DontSleep111 ($10 in chips) 
Seat 2: Angie Senpai ($15.40 in chips) 
Seat 3: father here ($10 in chips) 
Seat 4: manganito17 ($13.08 in chips) 
Seat 5: hempju1ce ($31.89 in chips) 
Seat 6: AAAcostA ($10.10 in chips) 
DontSleep111: posts small blind $0.05
Angie Senpai: posts big blind $0.10
*** HOLE CARDS ***
father here: folds 
father here leaves the table
manganito17: folds 
hempju1ce: calls $0.10
AAAcostA: raises $0.40 to $0.50
DontSleep111: folds 
Angie Senpai: folds 
hempju1ce: folds 
Uncalled bet ($0.40) returned to AAAcostA
AAAcostA collected $0.35 from pot
*** SUMMARY ***
Total pot $0.35 | Rake $0 
Seat 1: DontSleep111 (small blind) folded before Flop
Seat 2: Angie Senpai (big blind) folded before Flop
Seat 3: father here folded before Flop (didn't bet)
Seat 4: manganito17 folded before Flop (didn't bet)
Seat 5: hempju1ce folded before Flop
Seat 6: AAAcostA (button) collected ($0.35)



PokerStars Hand #222982258591:  Hold'em No Limit ($0.05/$0.10 USD) - 2021/01/23 20:55:38 ET
Table 'Lova III' 6-max Seat #1 is the button
Seat 1: DontSleep111 ($10 in chips) 
Seat 2: Angie Senpai ($15.30 in chips) 
Seat 4: manganito17 ($13.08 in chips) 
Seat 5: hempju1ce ($31.79 in chips) 
Seat 6: AAAcostA ($10.35 in chips) 
Angie Senpai: posts small blind $0.05
manganito17: posts big blind $0.10
*** HOLE CARDS ***
hempju1ce: raises $0.20 to $0.30
AAAcostA: folds 
DontSleep111: folds 
Angie Senpai: folds 
manganito17: folds 
Uncalled bet ($0.20) returned to hempju1ce
hempju1ce collected $0.25 from pot
hempju1ce: doesn't show hand 
*** SUMMARY ***
Total pot $0.25 | Rake $0 
Seat 1: DontSleep111 (button) folded before Flop (didn't bet)
Seat 2: Angie Senpai (small blind) folded before Flop
Seat 4: manganito17 (big blind) folded before Flop
Seat 5: hempju1ce collected ($0.25)
Seat 6: AAAcostA folded before Flop (didn't bet)



PokerStars Hand #222982263885:  Hold'em No Limit ($0.05/$0.10 USD) - 2021/01/23 20:55:55 ET
Table 'Lova III' 6-max Seat #2 is the button
Seat 1: DontSleep111 ($10 in chips) 
Seat 2: Angie Senpai ($15.25 in chips) 
Seat 4: manganito17 ($12.98 in chips) 
Seat 5: hempju1ce ($31.94 in chips) 
Seat 6: AAAcostA ($10.35 in chips) 
manganito17: posts small blind $0.05
hempju1ce: posts big blind $0.10
*** HOLE CARDS ***
lucas-fmtm joins the table at seat #3 
AAAcostA: folds 
DontSleep111: folds 
Angie Senpai: folds 
manganito17: folds 
Uncalled bet ($0.05) returned to hempju1ce
hempju1ce collected $0.10 from pot
hempju1ce: doesn't show hand 
*** SUMMARY ***
Total pot $0.10 | Rake $0 
Seat 1: DontSleep111 folded before Flop (didn't bet)
Seat 2: Angie Senpai (button) folded before Flop (didn't bet)
Seat 4: manganito17 (small blind) folded before Flop
Seat 5: hempju1ce (big blind) collected ($0.10)
Seat 6: AAAcostA folded before Flop (didn't bet)



PokerStars Hand #222982267176:  Hold'em No Limit ($0.05/$0.10 USD) - 2021/01/23 20:56:05 ET
Table 'Lova III' 6-max Seat #4 is the button
Seat 1: DontSleep111 ($10 in chips) 
Seat 2: Angie Senpai ($15.25 in chips) 
Seat 4: manganito17 ($12.93 in chips) 
Seat 5: hempju1ce ($31.99 in chips) 
Seat 6: AAAcostA ($10.35 in chips) 
hempju1ce: posts small blind $0.05
AAAcostA: posts big blind $0.10
lucas-fmtm: sits out 
*** HOLE CARDS ***
DontSleep111: folds 
Angie Senpai: raises $0.18 to $0.28
manganito17: folds 
hempju1ce: folds 
AAAcostA: folds 
Uncalled bet ($0.18) returned to Angie Senpai
Angie Senpai collected $0.25 from pot
Angie Senpai: doesn't show hand 
*** SUMMARY ***
Total pot $0.25 | Rake $0 
Seat 1: DontSleep111 folded before Flop (didn't bet)
Seat 2: Angie Senpai collected ($0.25)
Seat 4: manganito17 (button) folded before Flop (didn't bet)
Seat 5: hempju1ce (small blind) folded before Flop
Seat 6: AAAcostA (big blind) folded before Flop



PokerStars Hand #222982275586:  Hold'em No Limit ($0.05/$0.10 USD) - 2021/01/23 20:56:25 ET
Table 'Lova III' 6-max Seat #5 is the button
Seat 1: DontSleep111 ($10 in chips) 
Seat 2: Angie Senpai ($15.40 in chips) 
Seat 3: lucas-fmtm ($10 in chips) 
Seat 4: manganito17 ($12.93 in chips) 
Seat 5: hempju1ce ($31.94 in chips) 
Seat 6: AAAcostA ($10.25 in chips) 
AAAcostA: posts small blind $0.05
DontSleep111: posts big blind $0.10
lucas-fmtm: posts big blind $0.10
*** HOLE CARDS ***
Angie Senpai: folds 
lucas-fmtm: raises $0.30 to $0.40
manganito17: folds 
hempju1ce: folds 
AAAcostA: folds 
DontSleep111: folds 
Uncalled bet ($0.30) returned to lucas-fmtm
lucas-fmtm collected $0.25 from pot
*** SUMMARY ***
Total pot $0.25 | Rake $0 
Seat 1: DontSleep111 (big blind) folded before Flop
Seat 2: Angie Senpai folded before Flop (didn't bet)
Seat 3: lucas-fmtm collected ($0.25)
Seat 4: manganito17 folded before Flop (didn't bet)
Seat 5: hempju1ce (button) folded before Flop (didn't bet)
Seat 6: AAAcostA (small blind) folded before Flop



PokerStars Hand #222982282365:  Hold'em No Limit ($0.05/$0.10 USD) - 2021/01/23 20:56:47 ET
Table 'Lova III' 6-max Seat #6 is the button
Seat 1: DontSleep111 ($10 in chips) 
Seat 2: Angie Senpai ($15.40 in chips) 
Seat 3: lucas-fmtm ($10.15 in chips) 
Seat 4: manganito17 ($12.93 in chips) 
Seat 5: hempju1ce ($31.94 in chips) 
Seat 6: AAAcostA ($10.20 in chips) 
DontSleep111: posts small blind $0.05
Angie Senpai: posts big blind $0.10
*** HOLE CARDS ***
lucas-fmtm: folds 
manganito17: folds 
hempju1ce: folds 
AAAcostA: folds 
DontSleep111: folds 
Uncalled bet ($0.05) returned to Angie Senpai
Angie Senpai collected $0.10 from pot
Angie Senpai: doesn't show hand 
*** SUMMARY ***
Total pot $0.10 | Rake $0 
Seat 1: DontSleep111 (small blind) folded before Flop
Seat 2: Angie Senpai (big blind) collected ($0.10)
Seat 3: lucas-fmtm folded before Flop (didn't bet)
Seat 4: manganito17 folded before Flop (didn't bet)
Seat 5: hempju1ce folded before Flop (didn't bet)
Seat 6: AAAcostA (button) folded before Flop (didn't bet)



PokerStars Hand #222982287217:  Hold'em No Limit ($0.05/$0.10 USD) - 2021/01/23 20:57:02 ET
Table 'Lova III' 6-max Seat #1 is the button
Seat 1: DontSleep111 ($10 in chips) 
Seat 2: Angie Senpai ($15.45 in chips) 
Seat 3: lucas-fmtm ($10.15 in chips) 
Seat 4: manganito17 ($12.93 in chips) 
Seat 5: hempju1ce ($31.94 in chips) 
Seat 6: AAAcostA ($10.20 in chips) 
Angie Senpai: posts small blind $0.05
lucas-fmtm: posts big blind $0.10
*** HOLE CARDS ***
manganito17: raises $0.15 to $0.25
hempju1ce: folds 
AAAcostA: folds 
DontSleep111: folds 
Angie Senpai: folds 
lucas-fmtm: folds 
Uncalled bet ($0.15) returned to manganito17
manganito17 collected $0.25 from pot
manganito17: doesn't show hand 
*** SUMMARY ***
Total pot $0.25 | Rake $0 
Seat 1: DontSleep111 (button) folded before Flop (didn't bet)
Seat 2: Angie Senpai (small blind) folded before Flop
Seat 3: lucas-fmtm (big blind) folded before Flop
Seat 4: manganito17 collected ($0.25)
Seat 5: hempju1ce folded before Flop (didn't bet)
Seat 6: AAAcostA folded before Flop (didn't bet)



PokerStars Hand #222982292894:  Hold'em No Limit ($0.05/$0.10 USD) - 2021/01/23 20:57:20 ET
Table 'Lova III' 6-max Seat #2 is the button
Seat 1: DontSleep111 ($10 in chips) 
Seat 2: Angie Senpai ($15.40 in chips) 
Seat 3: lucas-fmtm ($10.05 in chips) 
Seat 5: hempju1ce ($31.94 in chips) 
Seat 6: AAAcostA ($10.20 in chips) 
lucas-fmtm: posts small blind $0.05
hempju1ce: posts big blind $0.10
*** HOLE CARDS ***
AAAcostA: folds 
DontSleep111: folds 
Angie Senpai: folds 
lucas-fmtm: raises $0.20 to $0.30
hempju1ce: calls $0.20
*** FLOP *** [5d 7c Ad]
manganito17 leaves the table
lucas-fmtm: bets $0.38
hempju1ce: folds 
Uncalled bet ($0.38) returned to lucas-fmtm
lucas-fmtm collected $0.57 from pot
*** SUMMARY ***
Total pot $0.60 | Rake $0.03 
Board [5d 7c Ad]
Seat 1: DontSleep111 folded before Flop (didn't bet)
Seat 2: Angie Senpai (button) folded before Flop (didn't bet)
Seat 3: lucas-fmtm (small blind) collected ($0.57)
Seat 5: hempju1ce (big blind) folded on the Flop
Seat 6: AAAcostA folded before Flop (didn't bet)



PokerStars Hand #222982299480:  Hold'em No Limit ($0.05/$0.10 USD) - 2021/01/23 20:57:41 ET
Table 'Lova III' 6-max Seat #3 is the button
Seat 1: DontSleep111 ($10 in chips) 
Seat 2: Angie Senpai ($15.40 in chips) 
Seat 3: lucas-fmtm ($10.32 in chips) 
Seat 5: hempju1ce ($31.64 in chips) 
Seat 6: AAAcostA ($10.20 in chips) 
hempju1ce: posts small blind $0.05
AAAcostA: posts big blind $0.10
*** HOLE CARDS ***
DontSleep111: folds 
Angie Senpai: folds 
I find you ez joins the table at seat #4 
lucas-fmtm: folds 
hempju1ce: calls $0.05
AAAcostA: checks 
*** FLOP *** [3c Jd Jc]
hempju1ce: bets $0.10
AAAcostA: calls $0.10
*** TURN *** [3c Jd Jc] [4c]
hempju1ce: bets $0.19
AAAcostA: calls $0.19
*** RIVER *** [3c Jd Jc 4c] [Kd]
hempju1ce: bets $0.37
AAAcostA: folds 
Uncalled bet ($0.37) returned to hempju1ce
hempju1ce collected $0.74 from pot
hempju1ce: doesn't show hand 
*** SUMMARY ***
Total pot $0.78 | Rake $0.04 
Board [3c Jd Jc 4c Kd]
Seat 1: DontSleep111 folded before Flop (didn't bet)
Seat 2: Angie Senpai folded before Flop (didn't bet)
Seat 3: lucas-fmtm (button) folded before Flop (didn't bet)
Seat 5: hempju1ce (small blind) collected ($0.74)
Seat 6: AAAcostA (big blind) folded on the River



PokerStars Hand #222982312535:  Hold'em No Limit ($0.05/$0.10 USD) - 2021/01/23 20:58:23 ET
Table 'Lova III' 6-max Seat #5 is the button
Seat 1: DontSleep111 ($10 in chips) 
Seat 2: Angie Senpai ($15.40 in chips) 
Seat 3: lucas-fmtm ($10.32 in chips) 
Seat 5: hempju1ce ($31.99 in chips) 
Seat 6: AAAcostA ($10 in chips) 
AAAcostA: posts small blind $0.05
DontSleep111: posts big blind $0.10
I find you ez: sits out 
*** HOLE CARDS ***
Angie Senpai: folds 
lucas-fmtm: folds 
hempju1ce: calls $0.10
AAAcostA: folds 
DontSleep111: checks 
*** FLOP *** [9c Ad 8d]
DontSleep111: checks 
hempju1ce: checks 
*** TURN *** [9c Ad 8d] [Qs]
DontSleep111: checks 
hempju1ce: checks 
*** RIVER *** [9c Ad 8d Qs] [Ac]
DontSleep111: checks 
hempju1ce: checks 
*** SHOW DOWN ***
DontSleep111: shows [Jc 2d] (a pair of Aces)
hempju1ce: shows [3d Kd] (a pair of Aces - King kicker)
hempju1ce collected $0.24 from pot
*** SUMMARY ***
Total pot $0.25 | Rake $0.01 
Board [9c Ad 8d Qs Ac]
Seat 1: DontSleep111 (big blind) showed [Jc 2d] and lost with a pair of Aces
Seat 2: Angie Senpai folded before Flop (didn't bet)
Seat 3: lucas-fmtm folded before Flop (didn't bet)
Seat 5: hempju1ce (button) showed [3d Kd] and won ($0.24) with a pair of Aces
Seat 6: AAAcostA (small blind) folded before Flop



PokerStars Hand #222982323115:  Hold'em No Limit ($0.05/$0.10 USD) - 2021/01/23 20:58:56 ET
Table 'Lova III' 6-max Seat #6 is the button
Seat 1: DontSleep111 ($10 in chips) 
Seat 2: Angie Senpai ($15.40 in chips) 
Seat 3: lucas-fmtm ($10.32 in chips) 
Seat 5: hempju1ce ($32.13 in chips) 
Seat 6: AAAcostA ($10 in chips) 
DontSleep111: posts small blind $0.05
Angie Senpai: posts big blind $0.10
I find you ez: sits out 
*** HOLE CARDS ***
lucas-fmtm: folds 
hempju1ce: raises $0.30 to $0.40
AAAcostA: folds 
DontSleep111: folds 
Angie Senpai: folds 
Uncalled bet ($0.30) returned to hempju1ce
hempju1ce collected $0.25 from pot
hempju1ce: doesn't show hand 
*** SUMMARY ***
Total pot $0.25 | Rake $0 
Seat 1: DontSleep111 (small blind) folded before Flop
Seat 2: Angie Senpai (big blind) folded before Flop
Seat 3: lucas-fmtm folded before Flop (didn't bet)
Seat 5: hempju1ce collected ($0.25)
Seat 6: AAAcostA (button) folded before Flop (didn't bet)



PokerStars Hand #222982326851:  Hold'em No Limit ($0.05/$0.10 USD) - 2021/01/23 20:59:08 ET
Table 'Lova III' 6-max Seat #1 is the button
Seat 1: DontSleep111 ($10 in chips) 
Seat 2: Angie Senpai ($15.30 in chips) 
Seat 3: lucas-fmtm ($10.32 in chips) 
Seat 5: hempju1ce ($32.28 in chips) 
Seat 6: AAAcostA ($10 in chips) 
Angie Senpai: posts small blind $0.05
lucas-fmtm: posts big blind $0.10
I find you ez: sits out 
*** HOLE CARDS ***
hempju1ce: raises $0.10 to $0.20
AAAcostA: folds 
DontSleep111: folds 
Angie Senpai: folds 
lucas-fmtm: calls $0.10
*** FLOP *** [3s 4h 4d]
lucas-fmtm: checks 
hempju1ce: checks 
*** TURN *** [3s 4h 4d] [2h]
lucas-fmtm: checks 
hempju1ce: bets $0.20
lucas-fmtm: calls $0.20
*** RIVER *** [3s 4h 4d 2h] [7h]
lucas-fmtm: bets $0.54
hempju1ce: calls $0.54
*** SHOW DOWN ***
lucas-fmtm: shows [Th Qh] (a flush, Queen high)
hempju1ce: mucks hand 
lucas-fmtm collected $1.84 from pot
*** SUMMARY ***
Total pot $1.93 | Rake $0.09 
Board [3s 4h 4d 2h 7h]
Seat 1: DontSleep111 (button) folded before Flop (didn't bet)
Seat 2: Angie Senpai (small blind) folded before Flop
Seat 3: lucas-fmtm (big blind) showed [Th Qh] and won ($1.84) with a flush, Queen high
Seat 5: hempju1ce mucked
Seat 6: AAAcostA folded before Flop (didn't bet)



