PokerStars Hand #222943602359:  Hold'em No Limit ($0.05/$0.10 USD) - 2021/01/23 23:05:23 ET
Table 'Malzovia III' 6-max Seat #2 is the button
Seat 2: ildar87kzn ($10 in chips) 
Seat 3: AAAcostA ($10.05 in chips) 
Seat 4: Himik30 ($10 in chips) 
Seat 5: AvGeL ($13.07 in chips) 
Seat 6: PokerDroop ($22.11 in chips) 
AAAcostA: posts small blind $0.05
Himik30: posts big blind $0.10
*** HOLE CARDS ***
AvGeL: folds 
PokerDroop: folds 
ildar87kzn: folds 
AAAcostA: raises $0.20 to $0.30
Himik30: calls $0.20
*** FLOP *** [Js Qh Kh]
AAAcostA: checks 
Himik30: bets $0.38
AAAcostA: calls $0.38
*** TURN *** [Js Qh Kh] [Ks]
AAAcostA: checks 
Himik30: bets $0.70
AAAcostA: folds 
Uncalled bet ($0.70) returned to Himik30
Himik30 collected $1.30 from pot
Himik30: doesn't show hand 
*** SUMMARY ***
Total pot $1.36 | Rake $0.06 
Board [Js Qh Kh Ks]
Seat 2: ildar87kzn (button) folded before Flop (didn't bet)
Seat 3: AAAcostA (small blind) folded on the Turn
Seat 4: Himik30 (big blind) collected ($1.30)
Seat 5: AvGeL folded before Flop (didn't bet)
Seat 6: PokerDroop folded before Flop (didn't bet)



PokerStars Hand #222943617172:  Hold'em No Limit ($0.05/$0.10 USD) - 2021/01/23 23:06:09 ET
Table 'Malzovia III' 6-max Seat #3 is the button
Seat 2: ildar87kzn ($10 in chips) 
Seat 3: AAAcostA ($10 in chips) 
Seat 4: Himik30 ($10.62 in chips) 
Seat 5: AvGeL ($13.07 in chips) 
Seat 6: PokerDroop ($22.11 in chips) 
Himik30: posts small blind $0.05
AvGeL: posts big blind $0.10
*** HOLE CARDS ***
PokerDroop: folds 
ildar87kzn: raises $0.20 to $0.30
AAAcostA: raises $0.60 to $0.90
Himik30: folds 
AvGeL: folds 
ildar87kzn: folds 
Uncalled bet ($0.60) returned to AAAcostA
AAAcostA collected $0.75 from pot
AAAcostA: doesn't show hand 
*** SUMMARY ***
Total pot $0.75 | Rake $0 
Seat 2: ildar87kzn folded before Flop
Seat 3: AAAcostA (button) collected ($0.75)
Seat 4: Himik30 (small blind) folded before Flop
Seat 5: AvGeL (big blind) folded before Flop
Seat 6: PokerDroop folded before Flop (didn't bet)



PokerStars Hand #222943627661:  Hold'em No Limit ($0.05/$0.10 USD) - 2021/01/23 23:06:41 ET
Table 'Malzovia III' 6-max Seat #4 is the button
Seat 2: ildar87kzn ($10 in chips) 
Seat 3: AAAcostA ($10.45 in chips) 
Seat 4: Himik30 ($10.57 in chips) 
Seat 5: AvGeL ($12.97 in chips) 
Seat 6: PokerDroop ($22.11 in chips) 
AvGeL: posts small blind $0.05
PokerDroop: posts big blind $0.10
*** HOLE CARDS ***
ildar87kzn: folds 
AAAcostA: folds 
Himik30: raises $0.15 to $0.25
AvGeL: folds 
PokerDroop: calls $0.15
*** FLOP *** [4s Jh 5s]
PokerDroop: checks 
Himik30: bets $0.35
PokerDroop: calls $0.35
*** TURN *** [4s Jh 5s] [Kd]
PokerDroop: checks 
Himik30: checks 
*** RIVER *** [4s Jh 5s Kd] [Qs]
PokerDroop: bets $0.80
Himik30: folds 
Uncalled bet ($0.80) returned to PokerDroop
PokerDroop collected $1.19 from pot
PokerDroop: doesn't show hand 
*** SUMMARY ***
Total pot $1.25 | Rake $0.06 
Board [4s Jh 5s Kd Qs]
Seat 2: ildar87kzn folded before Flop (didn't bet)
Seat 3: AAAcostA folded before Flop (didn't bet)
Seat 4: Himik30 (button) folded on the River
Seat 5: AvGeL (small blind) folded before Flop
Seat 6: PokerDroop (big blind) collected ($1.19)



PokerStars Hand #222943641782:  Hold'em No Limit ($0.05/$0.10 USD) - 2021/01/23 23:07:25 ET
Table 'Malzovia III' 6-max Seat #5 is the button
Seat 2: ildar87kzn ($10 in chips) 
Seat 3: AAAcostA ($10.45 in chips) 
Seat 4: Himik30 ($9.97 in chips) 
Seat 5: AvGeL ($12.92 in chips) 
Seat 6: PokerDroop ($22.70 in chips) 
PokerDroop: posts small blind $0.05
ildar87kzn: posts big blind $0.10
*** HOLE CARDS ***
AAAcostA: folds 
Himik30: folds 
AvGeL: raises $0.10 to $0.20
PokerDroop: folds 
ildar87kzn: folds 
Uncalled bet ($0.10) returned to AvGeL
AvGeL collected $0.25 from pot
Vovan85656 was removed from the table for failing to post
Vovan85656 leaves the table
*** SUMMARY ***
Total pot $0.25 | Rake $0 
Seat 2: ildar87kzn (big blind) folded before Flop
Seat 3: AAAcostA folded before Flop (didn't bet)
Seat 4: Himik30 folded before Flop (didn't bet)
Seat 5: AvGeL (button) collected ($0.25)
Seat 6: PokerDroop (small blind) folded before Flop



PokerStars Hand #222943645936:  Hold'em No Limit ($0.05/$0.10 USD) - 2021/01/23 23:07:38 ET
Table 'Malzovia III' 6-max Seat #6 is the button
Seat 2: ildar87kzn ($10 in chips) 
Seat 3: AAAcostA ($10.45 in chips) 
Seat 4: Himik30 ($9.97 in chips) 
Seat 5: AvGeL ($13.07 in chips) 
Seat 6: PokerDroop ($22.65 in chips) 
ildar87kzn: posts small blind $0.05
AAAcostA: posts big blind $0.10
*** HOLE CARDS ***
Himik30: folds 
AvGeL: raises $0.15 to $0.25
PokerDroop: folds 
ildar87kzn: folds 
AAAcostA: folds 
Uncalled bet ($0.15) returned to AvGeL
AvGeL collected $0.25 from pot
philliekid24 joins the table at seat #1 
*** SUMMARY ***
Total pot $0.25 | Rake $0 
Seat 2: ildar87kzn (small blind) folded before Flop
Seat 3: AAAcostA (big blind) folded before Flop
Seat 4: Himik30 folded before Flop (didn't bet)
Seat 5: AvGeL collected ($0.25)
Seat 6: PokerDroop (button) folded before Flop (didn't bet)



PokerStars Hand #222943654613:  Hold'em No Limit ($0.05/$0.10 USD) - 2021/01/23 23:08:05 ET
Table 'Malzovia III' 6-max Seat #2 is the button
Seat 2: ildar87kzn ($10 in chips) 
Seat 3: AAAcostA ($10.35 in chips) 
Seat 4: Himik30 ($9.97 in chips) 
Seat 5: AvGeL ($13.22 in chips) 
Seat 6: PokerDroop ($22.65 in chips) 
AAAcostA: posts small blind $0.05
Himik30: posts big blind $0.10
philliekid24: sits out 
*** HOLE CARDS ***
AvGeL: folds 
PokerDroop: folds 
AvGeL leaves the table
ildar87kzn: raises $0.20 to $0.30
AAAcostA: folds 
Himik30: folds 
Uncalled bet ($0.20) returned to ildar87kzn
ildar87kzn collected $0.25 from pot
ildar87kzn: doesn't show hand 
*** SUMMARY ***
Total pot $0.25 | Rake $0 
Seat 2: ildar87kzn (button) collected ($0.25)
Seat 3: AAAcostA (small blind) folded before Flop
Seat 4: Himik30 (big blind) folded before Flop
Seat 5: AvGeL folded before Flop (didn't bet)
Seat 6: PokerDroop folded before Flop (didn't bet)



PokerStars Hand #222943661989:  Hold'em No Limit ($0.05/$0.10 USD) - 2021/01/23 23:08:28 ET
Table 'Malzovia III' 6-max Seat #3 is the button
Seat 1: philliekid24 ($10 in chips) 
Seat 2: ildar87kzn ($10.15 in chips) 
Seat 3: AAAcostA ($10.30 in chips) 
Seat 4: Himik30 ($9.87 in chips) 
Himik30: posts small blind $0.05
PokerDroop: is sitting out 
philliekid24: posts big blind $0.10
*** HOLE CARDS ***
ildar87kzn: folds 
PokerDroop leaves the table
AAAcostA: raises $0.15 to $0.25
Himik30: calls $0.20
philliekid24: raises $0.65 to $0.90
AAAcostA: folds 
Himik30: calls $0.65
*** FLOP *** [3d 4d 2c]
Himik30: checks 
philliekid24: bets $9.10 and is all-in
Himik30: calls $8.97 and is all-in
Uncalled bet ($0.13) returned to philliekid24
philliekid24 has timed out
*** TURN *** [3d 4d 2c] [2d]
*** RIVER *** [3d 4d 2c 2d] [Tc]
*** SHOW DOWN ***
Himik30: shows [3s 3h] (a full house, Threes full of Deuces)
philliekid24: shows [Ks Kd] (two pair, Kings and Deuces)
Himik30 cashed out the hand for $16.25 | Cash Out Fee $0.16
*** SUMMARY ***
Total pot $19.99 | Rake $0.90 
Board [3d 4d 2c 2d Tc]
Seat 1: philliekid24 (big blind) showed [Ks Kd] and lost with two pair, Kings and Deuces
Seat 2: ildar87kzn folded before Flop (didn't bet)
Seat 3: AAAcostA (button) folded before Flop
Seat 4: Himik30 (small blind) showed [3s 3h] and won ($19.09) with a full house, Threes full of Deuces (pot not awarded as player cashed out)



PokerStars Hand #222943682494:  Hold'em No Limit ($0.05/$0.10 USD) - 2021/01/23 23:09:31 ET
Table 'Malzovia III' 6-max Seat #4 is the button
Seat 1: philliekid24 ($0.13 in chips) 
Seat 2: ildar87kzn ($10.15 in chips) 
Seat 3: AAAcostA ($10.05 in chips) 
Seat 4: Himik30 ($16.25 in chips) 
philliekid24: posts small blind $0.05
ildar87kzn: posts big blind $0.10
*** HOLE CARDS ***
AAAcostA: folds 
Himik30: raises $0.10 to $0.20
philliekid24: folds 
ildar87kzn: folds 
Uncalled bet ($0.10) returned to Himik30
Himik30 collected $0.25 from pot
Himik30: doesn't show hand 
*** SUMMARY ***
Total pot $0.25 | Rake $0 
Seat 1: philliekid24 (small blind) folded before Flop
Seat 2: ildar87kzn (big blind) folded before Flop
Seat 3: AAAcostA folded before Flop (didn't bet)
Seat 4: Himik30 (button) collected ($0.25)



PokerStars Hand #222943686449:  Hold'em No Limit ($0.05/$0.10 USD) - 2021/01/23 23:09:43 ET
Table 'Malzovia III' 6-max Seat #2 is the button
Seat 2: ildar87kzn ($10.05 in chips) 
Seat 3: AAAcostA ($10.05 in chips) 
Seat 4: Himik30 ($16.40 in chips) 
AAAcostA: posts small blind $0.05
Himik30: posts big blind $0.10
*** HOLE CARDS ***
ildar87kzn: folds 
AAAcostA: folds 
Uncalled bet ($0.05) returned to Himik30
Himik30 collected $0.10 from pot
Himik30: doesn't show hand 
*** SUMMARY ***
Total pot $0.10 | Rake $0 
Seat 2: ildar87kzn (button) folded before Flop (didn't bet)
Seat 3: AAAcostA (small blind) folded before Flop
Seat 4: Himik30 (big blind) collected ($0.10)



PokerStars Hand #222943689267:  Hold'em No Limit ($0.05/$0.10 USD) - 2021/01/23 23:09:52 ET
Table 'Malzovia III' 6-max Seat #3 is the button
Seat 2: ildar87kzn ($10.05 in chips) 
Seat 3: AAAcostA ($10 in chips) 
Seat 4: Himik30 ($16.45 in chips) 
Himik30: posts small blind $0.05
ildar87kzn: posts big blind $0.10
*** HOLE CARDS ***
AAAcostA: folds 
Himik30: folds 
Uncalled bet ($0.05) returned to ildar87kzn
ildar87kzn collected $0.10 from pot
ildar87kzn: doesn't show hand 
*** SUMMARY ***
Total pot $0.10 | Rake $0 
Seat 2: ildar87kzn (big blind) collected ($0.10)
Seat 3: AAAcostA (button) folded before Flop (didn't bet)
Seat 4: Himik30 (small blind) folded before Flop



PokerStars Hand #222943692130:  Hold'em No Limit ($0.05/$0.10 USD) - 2021/01/23 23:10:01 ET
Table 'Malzovia III' 6-max Seat #2 is the button
Seat 2: ildar87kzn ($10.10 in chips) 
Seat 4: Himik30 ($16.40 in chips) 
ildar87kzn: posts small blind $0.05
philliekid24 leaves the table
AAAcostA has timed out
AAAcostA: is sitting out 
Himik30: posts big blind $0.10
*** HOLE CARDS ***
ildar87kzn: folds 
Uncalled bet ($0.05) returned to Himik30
Himik30 collected $0.10 from pot
Himik30: doesn't show hand 
*** SUMMARY ***
Total pot $0.10 | Rake $0 
Seat 2: ildar87kzn (button) (small blind) folded before Flop
Seat 4: Himik30 (big blind) collected ($0.10)



PokerStars Hand #222943696560:  Hold'em No Limit ($0.05/$0.10 USD) - 2021/01/23 23:10:15 ET
Table 'Malzovia III' 6-max Seat #4 is the button
Seat 2: ildar87kzn ($10.05 in chips) 
Seat 4: Himik30 ($16.45 in chips) 
Himik30: posts small blind $0.05
ildar87kzn: posts big blind $0.10
*** HOLE CARDS ***
Himik30: raises $0.15 to $0.25
ildar87kzn: folds 
Uncalled bet ($0.15) returned to Himik30
Himik30 collected $0.20 from pot
Himik30: doesn't show hand 
*** SUMMARY ***
Total pot $0.20 | Rake $0 
Seat 2: ildar87kzn (big blind) folded before Flop
Seat 4: Himik30 (button) (small blind) collected ($0.20)



PokerStars Hand #222943698923:  Hold'em No Limit ($0.05/$0.10 USD) - 2021/01/23 23:10:22 ET
Table 'Malzovia III' 6-max Seat #4 is the button
Seat 2: ildar87kzn ($10 in chips) 
Seat 3: AAAcostA ($10 in chips) 
Seat 4: Himik30 ($16.55 in chips) 
ildar87kzn: posts small blind $0.05
AAAcostA: posts big blind $0.10
*** HOLE CARDS ***
Himik30: folds 
ildar87kzn: folds 
Uncalled bet ($0.05) returned to AAAcostA
AAAcostA collected $0.10 from pot
*** SUMMARY ***
Total pot $0.10 | Rake $0 
Seat 2: ildar87kzn (small blind) folded before Flop
Seat 3: AAAcostA (big blind) collected ($0.10)
Seat 4: Himik30 (button) folded before Flop (didn't bet)



PokerStars Hand #222943702190:  Hold'em No Limit ($0.05/$0.10 USD) - 2021/01/23 23:10:30 ET
Table 'Malzovia III' 6-max Seat #2 is the button
Seat 2: ildar87kzn ($10 in chips) 
Seat 3: AAAcostA ($10.05 in chips) 
Seat 4: Himik30 ($16.55 in chips) 
AAAcostA: posts small blind $0.05
Himik30: posts big blind $0.10
*** HOLE CARDS ***
ildar87kzn: folds 
AAAcostA: raises $0.20 to $0.30
Himik30: calls $0.20
*** FLOP *** [Td Jh Jd]
AAAcostA: bets $0.14
Himik30: calls $0.14
*** TURN *** [Td Jh Jd] [Ks]
AAAcostA: bets $0.25
Himik30: folds 
Uncalled bet ($0.25) returned to AAAcostA
AAAcostA collected $0.84 from pot
*** SUMMARY ***
Total pot $0.88 | Rake $0.04 
Board [Td Jh Jd Ks]
Seat 2: ildar87kzn (button) folded before Flop (didn't bet)
Seat 3: AAAcostA (small blind) collected ($0.84)
Seat 4: Himik30 (big blind) folded on the Turn



PokerStars Hand #222943718403:  Hold'em No Limit ($0.05/$0.10 USD) - 2021/01/23 23:11:20 ET
Table 'Malzovia III' 6-max Seat #3 is the button
Seat 2: ildar87kzn ($10 in chips) 
Seat 3: AAAcostA ($10.45 in chips) 
Seat 4: Himik30 ($16.11 in chips) 
Himik30: posts small blind $0.05
ildar87kzn: posts big blind $0.10
*** HOLE CARDS ***
PurpLongshaft joins the table at seat #5 
AAAcostA: folds 
Himik30: raises $0.20 to $0.30
ildar87kzn: raises $0.60 to $0.90
Himik30: folds 
Uncalled bet ($0.60) returned to ildar87kzn
ildar87kzn collected $0.60 from pot
ildar87kzn: doesn't show hand 
*** SUMMARY ***
Total pot $0.60 | Rake $0 
Seat 2: ildar87kzn (big blind) collected ($0.60)
Seat 3: AAAcostA (button) folded before Flop (didn't bet)
Seat 4: Himik30 (small blind) folded before Flop



PokerStars Hand #222943730390:  Hold'em No Limit ($0.05/$0.10 USD) - 2021/01/23 23:11:46 ET
Table 'Malzovia III' 6-max Seat #4 is the button
Seat 2: ildar87kzn ($10.30 in chips) 
Seat 3: AAAcostA ($10.45 in chips) 
Seat 4: Himik30 ($15.81 in chips) 
ildar87kzn: posts small blind $0.05
AAAcostA: posts big blind $0.10
*** HOLE CARDS ***
Himik30: raises $0.15 to $0.25
ildar87kzn: folds 
AAAcostA: folds 
Uncalled bet ($0.15) returned to Himik30
Himik30 collected $0.25 from pot
Himik30: doesn't show hand 
*** SUMMARY ***
Total pot $0.25 | Rake $0 
Seat 2: ildar87kzn (small blind) folded before Flop
Seat 3: AAAcostA (big blind) folded before Flop
Seat 4: Himik30 (button) collected ($0.25)



PokerStars Hand #222943735126:  Hold'em No Limit ($0.05/$0.10 USD) - 2021/01/23 23:12:00 ET
Table 'Malzovia III' 6-max Seat #2 is the button
Seat 2: ildar87kzn ($10.25 in chips) 
Seat 3: AAAcostA ($10.35 in chips) 
Seat 4: Himik30 ($15.96 in chips) 
Seat 5: PurpLongshaft ($8 in chips) 
AAAcostA: posts small blind $0.05
Himik30: posts big blind $0.10
PurpLongshaft: posts big blind $0.10
*** HOLE CARDS ***
PurpLongshaft: checks 
ildar87kzn: raises $0.35 to $0.45
AAAcostA: folds 
Himik30: folds 
PurpLongshaft: calls $0.35
*** FLOP *** [8d 3d 6d]
PurpLongshaft: checks 
ildar87kzn: bets $0.60
PurpLongshaft: raises $0.60 to $1.20
ildar87kzn: folds 
Uncalled bet ($0.60) returned to PurpLongshaft
PurpLongshaft collected $2.15 from pot
PurpLongshaft: doesn't show hand 
*** SUMMARY ***
Total pot $2.25 | Rake $0.10 
Board [8d 3d 6d]
Seat 2: ildar87kzn (button) folded on the Flop
Seat 3: AAAcostA (small blind) folded before Flop
Seat 4: Himik30 (big blind) folded before Flop
Seat 5: PurpLongshaft collected ($2.15)



PokerStars Hand #222943747043:  Hold'em No Limit ($0.05/$0.10 USD) - 2021/01/23 23:12:38 ET
Table 'Malzovia III' 6-max Seat #3 is the button
Seat 2: ildar87kzn ($10 in chips) 
Seat 3: AAAcostA ($10.30 in chips) 
Seat 4: Himik30 ($15.86 in chips) 
Seat 5: PurpLongshaft ($9.10 in chips) 
Himik30: posts small blind $0.05
PurpLongshaft: posts big blind $0.10
*** HOLE CARDS ***
ildar87kzn: folds 
AAAcostA: raises $0.15 to $0.25
Himik30: folds 
PurpLongshaft: calls $0.15
*** FLOP *** [4d 3h 5d]
PurpLongshaft: checks 
AAAcostA: bets $0.28
PurpLongshaft: calls $0.28
*** TURN *** [4d 3h 5d] [Th]
PurpLongshaft: checks 
AAAcostA: bets $0.80
PurpLongshaft: folds 
Uncalled bet ($0.80) returned to AAAcostA
AAAcostA collected $1.06 from pot
AAAcostA: doesn't show hand 
*** SUMMARY ***
Total pot $1.11 | Rake $0.05 
Board [4d 3h 5d Th]
Seat 2: ildar87kzn folded before Flop (didn't bet)
Seat 3: AAAcostA (button) collected ($1.06)
Seat 4: Himik30 (small blind) folded before Flop
Seat 5: PurpLongshaft (big blind) folded on the Turn



PokerStars Hand #222943757831:  Hold'em No Limit ($0.05/$0.10 USD) - 2021/01/23 23:13:11 ET
Table 'Malzovia III' 6-max Seat #4 is the button
Seat 2: ildar87kzn ($10 in chips) 
Seat 3: AAAcostA ($10.83 in chips) 
Seat 4: Himik30 ($15.81 in chips) 
Seat 5: PurpLongshaft ($8.57 in chips) 
PurpLongshaft: posts small blind $0.05
ildar87kzn: posts big blind $0.10
*** HOLE CARDS ***
AAAcostA: folds 
Himik30: folds 
PurpLongshaft: calls $0.05
ildar87kzn: checks 
*** FLOP *** [Jh 8h Ah]
PurpLongshaft: checks 
ildar87kzn: checks 
*** TURN *** [Jh 8h Ah] [4c]
PurpLongshaft: checks 
Gorak2907 joins the table at seat #6 
ildar87kzn: checks 
*** RIVER *** [Jh 8h Ah 4c] [9d]
PurpLongshaft: checks 
ildar87kzn: checks 
*** SHOW DOWN ***
PurpLongshaft: shows [7c Ks] (high card Ace)
ildar87kzn: shows [7s 4h] (a pair of Fours)
ildar87kzn collected $0.19 from pot
*** SUMMARY ***
Total pot $0.20 | Rake $0.01 
Board [Jh 8h Ah 4c 9d]
Seat 2: ildar87kzn (big blind) showed [7s 4h] and won ($0.19) with a pair of Fours
Seat 3: AAAcostA folded before Flop (didn't bet)
Seat 4: Himik30 (button) folded before Flop (didn't bet)
Seat 5: PurpLongshaft (small blind) showed [7c Ks] and lost with high card Ace



PokerStars Hand #222943770790:  Hold'em No Limit ($0.05/$0.10 USD) - 2021/01/23 23:13:51 ET
Table 'Malzovia III' 6-max Seat #5 is the button
Seat 2: ildar87kzn ($10.09 in chips) 
Seat 3: AAAcostA ($10.83 in chips) 
Seat 4: Himik30 ($15.81 in chips) 
Seat 5: PurpLongshaft ($8.47 in chips) 
ildar87kzn: posts small blind $0.05
AAAcostA: posts big blind $0.10
*** HOLE CARDS ***
Himik30: folds 
PurpLongshaft: calls $0.10
ildar87kzn: folds 
AAAcostA: checks 
*** FLOP *** [Jc 8c 2d]
AAAcostA: checks 
PurpLongshaft: checks 
*** TURN *** [Jc 8c 2d] [Qs]
AAAcostA: checks 
PurpLongshaft: checks 
*** RIVER *** [Jc 8c 2d Qs] [Td]
AAAcostA: bets $0.18
PurpLongshaft: folds 
Uncalled bet ($0.18) returned to AAAcostA
AAAcostA collected $0.24 from pot
AAAcostA: doesn't show hand 
*** SUMMARY ***
Total pot $0.25 | Rake $0.01 
Board [Jc 8c 2d Qs Td]
Seat 2: ildar87kzn (small blind) folded before Flop
Seat 3: AAAcostA (big blind) collected ($0.24)
Seat 4: Himik30 folded before Flop (didn't bet)
Seat 5: PurpLongshaft (button) folded on the River



PokerStars Hand #222943779595:  Hold'em No Limit ($0.05/$0.10 USD) - 2021/01/23 23:14:19 ET
Table 'Malzovia III' 6-max Seat #2 is the button
Seat 2: ildar87kzn ($10.04 in chips) 
Seat 3: AAAcostA ($10.97 in chips) 
Seat 4: Himik30 ($15.81 in chips) 
Seat 5: PurpLongshaft ($8.37 in chips) 
Seat 6: Gorak2907 ($10 in chips) 
AAAcostA: posts small blind $0.05
Himik30: posts big blind $0.10
Gorak2907: posts big blind $0.10
*** HOLE CARDS ***
PurpLongshaft: calls $0.10
Gorak2907: checks 
ildar87kzn: raises $0.50 to $0.60
AAAcostA: folds 
Himik30: folds 
PurpLongshaft: calls $0.50
Gorak2907: calls $0.50
*** FLOP *** [5d 9h 5h]
PurpLongshaft: checks 
Gorak2907: checks 
ildar87kzn: bets $1.21
PurpLongshaft: folds 
Gorak2907: folds 
Uncalled bet ($1.21) returned to ildar87kzn
ildar87kzn collected $1.86 from pot
ildar87kzn: doesn't show hand 
*** SUMMARY ***
Total pot $1.95 | Rake $0.09 
Board [5d 9h 5h]
Seat 2: ildar87kzn (button) collected ($1.86)
Seat 3: AAAcostA (small blind) folded before Flop
Seat 4: Himik30 (big blind) folded before Flop
Seat 5: PurpLongshaft folded on the Flop
Seat 6: Gorak2907 folded on the Flop



PokerStars Hand #222943789833:  Hold'em No Limit ($0.05/$0.10 USD) - 2021/01/23 23:14:51 ET
Table 'Malzovia III' 6-max Seat #3 is the button
Seat 2: ildar87kzn ($11.30 in chips) 
Seat 3: AAAcostA ($10.92 in chips) 
Seat 4: Himik30 ($15.71 in chips) 
Seat 5: PurpLongshaft ($7.77 in chips) 
Seat 6: Gorak2907 ($10 in chips) 
Laker_Style joins the table at seat #1 
Himik30: posts small blind $0.05
PurpLongshaft: posts big blind $0.10
*** HOLE CARDS ***
Gorak2907: folds 
ildar87kzn: folds 
AAAcostA: folds 
Himik30: folds 
Uncalled bet ($0.05) returned to PurpLongshaft
PurpLongshaft collected $0.10 from pot
PurpLongshaft: doesn't show hand 
*** SUMMARY ***
Total pot $0.10 | Rake $0 
Seat 2: ildar87kzn folded before Flop (didn't bet)
Seat 3: AAAcostA (button) folded before Flop (didn't bet)
Seat 4: Himik30 (small blind) folded before Flop
Seat 5: PurpLongshaft (big blind) collected ($0.10)
Seat 6: Gorak2907 folded before Flop (didn't bet)



PokerStars Hand #222943792399:  Hold'em No Limit ($0.05/$0.10 USD) - 2021/01/23 23:14:59 ET
Table 'Malzovia III' 6-max Seat #4 is the button
Seat 2: ildar87kzn ($11.30 in chips) 
Seat 3: AAAcostA ($10.92 in chips) 
Seat 4: Himik30 ($15.66 in chips) 
Seat 5: PurpLongshaft ($7.82 in chips) 
Seat 6: Gorak2907 ($10 in chips) 
PurpLongshaft: posts small blind $0.05
Gorak2907: posts big blind $0.10
Laker_Style: sits out 
*** HOLE CARDS ***
ildar87kzn: folds 
AAAcostA: raises $0.20 to $0.30
Himik30: folds 
PurpLongshaft: calls $0.25
Gorak2907: folds 
*** FLOP *** [Th Ts Jh]
PurpLongshaft: checks 
AAAcostA: bets $0.36
PurpLongshaft: folds 
Uncalled bet ($0.36) returned to AAAcostA
AAAcostA collected $0.67 from pot
AAAcostA: doesn't show hand 
*** SUMMARY ***
Total pot $0.70 | Rake $0.03 
Board [Th Ts Jh]
Seat 2: ildar87kzn folded before Flop (didn't bet)
Seat 3: AAAcostA collected ($0.67)
Seat 4: Himik30 (button) folded before Flop (didn't bet)
Seat 5: PurpLongshaft (small blind) folded on the Flop
Seat 6: Gorak2907 (big blind) folded before Flop



PokerStars Hand #222943806756:  Hold'em No Limit ($0.05/$0.10 USD) - 2021/01/23 23:15:43 ET
Table 'Malzovia III' 6-max Seat #5 is the button
Seat 1: Laker_Style ($10 in chips) 
Seat 2: ildar87kzn ($11.30 in chips) 
Seat 3: AAAcostA ($11.29 in chips) 
Seat 4: Himik30 ($15.66 in chips) 
Seat 5: PurpLongshaft ($7.52 in chips) 
Seat 6: Gorak2907 ($10 in chips) 
Gorak2907: posts small blind $0.05
Laker_Style: posts big blind $0.10
*** HOLE CARDS ***
ildar87kzn: folds 
AAAcostA: folds 
Himik30: folds 
PurpLongshaft: calls $0.10
Gorak2907: raises $0.15 to $0.25
Laker_Style: folds 
PurpLongshaft: calls $0.15
*** FLOP *** [Ad 4s 6d]
Gorak2907: checks 
PurpLongshaft: bets $0.60
Gorak2907: folds 
Uncalled bet ($0.60) returned to PurpLongshaft
PurpLongshaft collected $0.57 from pot
PurpLongshaft: doesn't show hand 
*** SUMMARY ***
Total pot $0.60 | Rake $0.03 
Board [Ad 4s 6d]
Seat 1: Laker_Style (big blind) folded before Flop
Seat 2: ildar87kzn folded before Flop (didn't bet)
Seat 3: AAAcostA folded before Flop (didn't bet)
Seat 4: Himik30 folded before Flop (didn't bet)
Seat 5: PurpLongshaft (button) collected ($0.57)
Seat 6: Gorak2907 (small blind) folded on the Flop



PokerStars Hand #222943821148:  Hold'em No Limit ($0.05/$0.10 USD) - 2021/01/23 23:16:28 ET
Table 'Malzovia III' 6-max Seat #6 is the button
Seat 1: Laker_Style ($10 in chips) 
Seat 3: AAAcostA ($11.29 in chips) 
Seat 4: Himik30 ($15.66 in chips) 
Seat 5: PurpLongshaft ($7.84 in chips) 
Seat 6: Gorak2907 ($10 in chips) 
Laker_Style: posts small blind $0.05
AAAcostA: posts big blind $0.10
*** HOLE CARDS ***
Himik30: raises $0.15 to $0.25
PurpLongshaft: folds 
Gorak2907: folds 
Laker_Style: folds 
AAAcostA: calls $0.15
*** FLOP *** [4h 2d 9s]
AAAcostA: checks 
Himik30: checks 
*** TURN *** [4h 2d 9s] [Qh]
AAAcostA: checks 
Himik30: bets $0.35
AAAcostA: calls $0.35
*** RIVER *** [4h 2d 9s Qh] [Tc]
AAAcostA: checks 
Himik30: checks 
*** SHOW DOWN ***
AAAcostA: shows [Ad Th] (a pair of Tens)
Himik30: mucks hand 
AAAcostA collected $1.19 from pot
*** SUMMARY ***
Total pot $1.25 | Rake $0.06 
Board [4h 2d 9s Qh Tc]
Seat 1: Laker_Style (small blind) folded before Flop
Seat 3: AAAcostA (big blind) showed [Ad Th] and won ($1.19) with a pair of Tens
Seat 4: Himik30 mucked
Seat 5: PurpLongshaft folded before Flop (didn't bet)
Seat 6: Gorak2907 (button) folded before Flop (didn't bet)



PokerStars Hand #222943844568:  Hold'em No Limit ($0.05/$0.10 USD) - 2021/01/23 23:17:15 ET
Table 'Malzovia III' 6-max Seat #1 is the button
Seat 1: Laker_Style ($10 in chips) 
Seat 3: AAAcostA ($11.88 in chips) 
Seat 4: Himik30 ($15.06 in chips) 
Seat 5: PurpLongshaft ($7.84 in chips) 
Seat 6: Gorak2907 ($10 in chips) 
AAAcostA: posts small blind $0.05
Himik30: posts big blind $0.10
*** HOLE CARDS ***
PurpLongshaft: folds 
Gorak2907: folds 
Laker_Style: folds 
AAAcostA: folds 
Uncalled bet ($0.05) returned to Himik30
Himik30 collected $0.10 from pot
Himik30: doesn't show hand 
*** SUMMARY ***
Total pot $0.10 | Rake $0 
Seat 1: Laker_Style (button) folded before Flop (didn't bet)
Seat 3: AAAcostA (small blind) folded before Flop
Seat 4: Himik30 (big blind) collected ($0.10)
Seat 5: PurpLongshaft folded before Flop (didn't bet)
Seat 6: Gorak2907 folded before Flop (didn't bet)



PokerStars Hand #222943848995:  Hold'em No Limit ($0.05/$0.10 USD) - 2021/01/23 23:17:29 ET
Table 'Malzovia III' 6-max Seat #3 is the button
Seat 1: Laker_Style ($10 in chips) 
Seat 3: AAAcostA ($11.83 in chips) 
Seat 4: Himik30 ($15.11 in chips) 
Seat 5: PurpLongshaft ($7.84 in chips) 
Seat 6: Gorak2907 ($10 in chips) 
Himik30: posts small blind $0.05
PurpLongshaft: posts big blind $0.10
*** HOLE CARDS ***
Gorak2907: raises $0.15 to $0.25
Laker_Style: folds 
AAAcostA: calls $0.25
Himik30: calls $0.20
PurpLongshaft: folds 
*** FLOP *** [2c 5c 5s]
Himik30: checks 
Gorak2907: bets $0.40
AAAcostA: calls $0.40
Himik30: calls $0.40
*** TURN *** [2c 5c 5s] [Qc]
Himik30: checks 
Gorak2907: checks 
AAAcostA: checks 
*** RIVER *** [2c 5c 5s Qc] [Jh]
Himik30: checks 
Gorak2907: checks 
AAAcostA: checks 
*** SHOW DOWN ***
Himik30: shows [4c 3c] (a flush, Queen high)
Gorak2907: mucks hand 
AAAcostA: mucks hand 
Himik30 collected $1.96 from pot
*** SUMMARY ***
Total pot $2.05 | Rake $0.09 
Board [2c 5c 5s Qc Jh]
Seat 1: Laker_Style folded before Flop (didn't bet)
Seat 3: AAAcostA (button) mucked
Seat 4: Himik30 (small blind) showed [4c 3c] and won ($1.96) with a flush, Queen high
Seat 5: PurpLongshaft (big blind) folded before Flop
Seat 6: Gorak2907 mucked



PokerStars Hand #222943862624:  Hold'em No Limit ($0.05/$0.10 USD) - 2021/01/23 23:18:11 ET
Table 'Malzovia III' 6-max Seat #4 is the button
Seat 1: Laker_Style ($10 in chips) 
Seat 3: AAAcostA ($11.18 in chips) 
Seat 4: Himik30 ($16.42 in chips) 
Seat 5: PurpLongshaft ($7.74 in chips) 
Seat 6: Gorak2907 ($10 in chips) 
PurpLongshaft: posts small blind $0.05
Gorak2907: posts big blind $0.10
*** HOLE CARDS ***
Laker_Style: folds 
AAAcostA: raises $0.20 to $0.30
Himik30: folds 
PurpLongshaft: calls $0.25
Gorak2907: folds 
*** FLOP *** [Jh Qh As]
PurpLongshaft: checks 
AAAcostA: bets $0.36
PurpLongshaft: raises $0.36 to $0.72
AAAcostA: calls $0.36
*** TURN *** [Jh Qh As] [6c]
PurpLongshaft: checks 
AAAcostA: bets $1.53
PurpLongshaft: folds 
Uncalled bet ($1.53) returned to AAAcostA
AAAcostA collected $2.04 from pot
AAAcostA: doesn't show hand 
*** SUMMARY ***
Total pot $2.14 | Rake $0.10 
Board [Jh Qh As 6c]
Seat 1: Laker_Style folded before Flop (didn't bet)
Seat 3: AAAcostA collected ($2.04)
Seat 4: Himik30 (button) folded before Flop (didn't bet)
Seat 5: PurpLongshaft (small blind) folded on the Turn
Seat 6: Gorak2907 (big blind) folded before Flop



PokerStars Hand #222943880726:  Hold'em No Limit ($0.05/$0.10 USD) - 2021/01/23 23:18:45 ET
Table 'Malzovia III' 6-max Seat #5 is the button
Seat 1: Laker_Style ($10 in chips) 
Seat 3: AAAcostA ($12.20 in chips) 
Seat 4: Himik30 ($16.42 in chips) 
Seat 5: PurpLongshaft ($6.72 in chips) 
Seat 6: Gorak2907 ($10 in chips) 
Gorak2907: posts small blind $0.05
Laker_Style: posts big blind $0.10
*** HOLE CARDS ***
AAAcostA: raises $0.20 to $0.30
Himik30: folds 
PurpLongshaft: folds 
Gorak2907: raises $0.66 to $0.96
Laker_Style: folds 
AAAcostA: folds 
Uncalled bet ($0.66) returned to Gorak2907
Gorak2907 collected $0.70 from pot
*** SUMMARY ***
Total pot $0.70 | Rake $0 
Seat 1: Laker_Style (big blind) folded before Flop
Seat 3: AAAcostA folded before Flop
Seat 4: Himik30 folded before Flop (didn't bet)
Seat 5: PurpLongshaft (button) folded before Flop (didn't bet)
Seat 6: Gorak2907 (small blind) collected ($0.70)



PokerStars Hand #222943885152:  Hold'em No Limit ($0.05/$0.10 USD) - 2021/01/23 23:18:59 ET
Table 'Malzovia III' 6-max Seat #6 is the button
Seat 1: Laker_Style ($10 in chips) 
Seat 3: AAAcostA ($11.90 in chips) 
Seat 4: Himik30 ($16.42 in chips) 
Seat 5: PurpLongshaft ($6.72 in chips) 
Seat 6: Gorak2907 ($10.40 in chips) 
Laker_Style: posts small blind $0.05
AAAcostA: posts big blind $0.10
*** HOLE CARDS ***
Himik30: folds 
PurpLongshaft: folds 
Gorak2907: folds 
Laker_Style: raises $0.20 to $0.30
AAAcostA: folds 
Uncalled bet ($0.20) returned to Laker_Style
Laker_Style collected $0.20 from pot
Laker_Style: doesn't show hand 
*** SUMMARY ***
Total pot $0.20 | Rake $0 
Seat 1: Laker_Style (small blind) collected ($0.20)
Seat 3: AAAcostA (big blind) folded before Flop
Seat 4: Himik30 folded before Flop (didn't bet)
Seat 5: PurpLongshaft folded before Flop (didn't bet)
Seat 6: Gorak2907 (button) folded before Flop (didn't bet)



PokerStars Hand #222943888756:  Hold'em No Limit ($0.05/$0.10 USD) - 2021/01/23 23:19:10 ET
Table 'Malzovia III' 6-max Seat #1 is the button
Seat 1: Laker_Style ($10.10 in chips) 
Seat 3: AAAcostA ($11.80 in chips) 
Seat 4: Himik30 ($16.42 in chips) 
Seat 5: PurpLongshaft ($6.72 in chips) 
Seat 6: Gorak2907 ($10.40 in chips) 
AAAcostA: posts small blind $0.05
Himik30: posts big blind $0.10
*** HOLE CARDS ***
PurpLongshaft: calls $0.10
Gorak2907: raises $0.15 to $0.25
Laker_Style: folds 
AAAcostA: folds 
Himik30: folds 
PurpLongshaft: calls $0.15
*** FLOP *** [Js 5s 5d]
PurpLongshaft: checks 
Gorak2907: bets $0.31
PurpLongshaft: raises $0.31 to $0.62
Gorak2907: folds 
Uncalled bet ($0.31) returned to PurpLongshaft
PurpLongshaft collected $1.21 from pot
PurpLongshaft: doesn't show hand 
*** SUMMARY ***
Total pot $1.27 | Rake $0.06 
Board [Js 5s 5d]
Seat 1: Laker_Style (button) folded before Flop (didn't bet)
Seat 3: AAAcostA (small blind) folded before Flop
Seat 4: Himik30 (big blind) folded before Flop
Seat 5: PurpLongshaft collected ($1.21)
Seat 6: Gorak2907 folded on the Flop



PokerStars Hand #222943897369:  Hold'em No Limit ($0.05/$0.10 USD) - 2021/01/23 23:19:37 ET
Table 'Malzovia III' 6-max Seat #3 is the button
Seat 1: Laker_Style ($10.10 in chips) 
Seat 3: AAAcostA ($11.75 in chips) 
Seat 4: Himik30 ($16.32 in chips) 
Seat 5: PurpLongshaft ($7.37 in chips) 
Seat 6: Gorak2907 ($10 in chips) 
Himik30: posts small blind $0.05
PurpLongshaft: posts big blind $0.10
ildar87kzn: sits out 
*** HOLE CARDS ***
Gorak2907: raises $0.20 to $0.30
Laker_Style: folds 
AAAcostA: folds 
Himik30: folds 
PurpLongshaft: folds 
Uncalled bet ($0.20) returned to Gorak2907
Gorak2907 collected $0.25 from pot
*** SUMMARY ***
Total pot $0.25 | Rake $0 
Seat 1: Laker_Style folded before Flop (didn't bet)
Seat 3: AAAcostA (button) folded before Flop (didn't bet)
Seat 4: Himik30 (small blind) folded before Flop
Seat 5: PurpLongshaft (big blind) folded before Flop
Seat 6: Gorak2907 collected ($0.25)



PokerStars Hand #222943902651:  Hold'em No Limit ($0.05/$0.10 USD) - 2021/01/23 23:19:54 ET
Table 'Malzovia III' 6-max Seat #4 is the button
Seat 1: Laker_Style ($10.10 in chips) 
Seat 3: AAAcostA ($11.75 in chips) 
Seat 4: Himik30 ($16.27 in chips) 
Seat 5: PurpLongshaft ($7.27 in chips) 
Seat 6: Gorak2907 ($10.15 in chips) 
PurpLongshaft: posts small blind $0.05
Gorak2907: posts big blind $0.10
ildar87kzn: sits out 
*** HOLE CARDS ***
Laker_Style: folds 
AAAcostA: folds 
Himik30: raises $0.15 to $0.25
PurpLongshaft: calls $0.20
Gorak2907: folds 
*** FLOP *** [5s 6h 5c]
PurpLongshaft: checks 
Himik30: bets $0.40
PurpLongshaft: raises $0.40 to $0.80
Himik30: folds 
Uncalled bet ($0.40) returned to PurpLongshaft
PurpLongshaft collected $1.34 from pot
PurpLongshaft: doesn't show hand 
*** SUMMARY ***
Total pot $1.40 | Rake $0.06 
Board [5s 6h 5c]
Seat 1: Laker_Style folded before Flop (didn't bet)
Seat 3: AAAcostA folded before Flop (didn't bet)
Seat 4: Himik30 (button) folded on the Flop
Seat 5: PurpLongshaft (small blind) collected ($1.34)
Seat 6: Gorak2907 (big blind) folded before Flop



PokerStars Hand #222943915097:  Hold'em No Limit ($0.05/$0.10 USD) - 2021/01/23 23:20:33 ET
Table 'Malzovia III' 6-max Seat #5 is the button
Seat 2: ildar87kzn ($11.30 in chips) 
Seat 3: AAAcostA ($11.75 in chips) 
Seat 4: Himik30 ($15.62 in chips) 
Seat 5: PurpLongshaft ($7.96 in chips) 
Seat 6: Gorak2907 ($10.05 in chips) 
Gorak2907: posts small blind $0.05
Laker_Style: is sitting out 
ildar87kzn: posts big blind $0.10
*** HOLE CARDS ***
AAAcostA: raises $0.20 to $0.30
Himik30: folds 
PurpLongshaft: calls $0.30
Gorak2907: folds 
ildar87kzn: folds 
*** FLOP *** [7h Ah 9c]
AAAcostA: bets $0.22
PurpLongshaft: calls $0.22
*** TURN *** [7h Ah 9c] [5d]
AAAcostA: checks 
PurpLongshaft: checks 
*** RIVER *** [7h Ah 9c 5d] [2c]
AAAcostA: bets $0.86
PurpLongshaft: folds 
Uncalled bet ($0.86) returned to AAAcostA
AAAcostA collected $1.14 from pot
AAAcostA: doesn't show hand 
*** SUMMARY ***
Total pot $1.19 | Rake $0.05 
Board [7h Ah 9c 5d 2c]
Seat 2: ildar87kzn (big blind) folded before Flop
Seat 3: AAAcostA collected ($1.14)
Seat 4: Himik30 folded before Flop (didn't bet)
Seat 5: PurpLongshaft (button) folded on the River
Seat 6: Gorak2907 (small blind) folded before Flop



PokerStars Hand #222943925713:  Hold'em No Limit ($0.05/$0.10 USD) - 2021/01/23 23:21:07 ET
Table 'Malzovia III' 6-max Seat #6 is the button
Seat 2: ildar87kzn ($11.20 in chips) 
Seat 3: AAAcostA ($12.37 in chips) 
Seat 4: Himik30 ($15.62 in chips) 
Seat 5: PurpLongshaft ($7.44 in chips) 
Seat 6: Gorak2907 ($10 in chips) 
ildar87kzn: posts small blind $0.05
AAAcostA: posts big blind $0.10
*** HOLE CARDS ***
Himik30: folds 
PurpLongshaft: calls $0.10
Gorak2907: folds 
ildar87kzn: folds 
AAAcostA: checks 
*** FLOP *** [As 6h Tc]
AAAcostA: checks 
PurpLongshaft: checks 
*** TURN *** [As 6h Tc] [2h]
AAAcostA: checks 
PurpLongshaft: checks 
*** RIVER *** [As 6h Tc 2h] [Ah]
AAAcostA: checks 
PurpLongshaft: bets $0.10
AAAcostA: calls $0.10
*** SHOW DOWN ***
PurpLongshaft: shows [9s 8s] (a pair of Aces)
AAAcostA: shows [2d 5d] (two pair, Aces and Deuces)
AAAcostA collected $0.43 from pot
*** SUMMARY ***
Total pot $0.45 | Rake $0.02 
Board [As 6h Tc 2h Ah]
Seat 2: ildar87kzn (small blind) folded before Flop
Seat 3: AAAcostA (big blind) showed [2d 5d] and won ($0.43) with two pair, Aces and Deuces
Seat 4: Himik30 folded before Flop (didn't bet)
Seat 5: PurpLongshaft showed [9s 8s] and lost with a pair of Aces
Seat 6: Gorak2907 (button) folded before Flop (didn't bet)



PokerStars Hand #222943934638:  Hold'em No Limit ($0.05/$0.10 USD) - 2021/01/23 23:21:35 ET
Table 'Malzovia III' 6-max Seat #2 is the button
Seat 2: ildar87kzn ($11.15 in chips) 
Seat 3: AAAcostA ($12.60 in chips) 
Seat 4: Himik30 ($15.62 in chips) 
Seat 5: PurpLongshaft ($7.24 in chips) 
Seat 6: Gorak2907 ($10 in chips) 
AAAcostA: posts small blind $0.05
Himik30: posts big blind $0.10
*** HOLE CARDS ***
PurpLongshaft: folds 
Gorak2907: folds 
ildar87kzn: raises $0.20 to $0.30
AAAcostA: folds 
Himik30: folds 
Uncalled bet ($0.20) returned to ildar87kzn
ildar87kzn collected $0.25 from pot
ildar87kzn: doesn't show hand 
*** SUMMARY ***
Total pot $0.25 | Rake $0 
Seat 2: ildar87kzn (button) collected ($0.25)
Seat 3: AAAcostA (small blind) folded before Flop
Seat 4: Himik30 (big blind) folded before Flop
Seat 5: PurpLongshaft folded before Flop (didn't bet)
Seat 6: Gorak2907 folded before Flop (didn't bet)



PokerStars Hand #222943939160:  Hold'em No Limit ($0.05/$0.10 USD) - 2021/01/23 23:21:49 ET
Table 'Malzovia III' 6-max Seat #3 is the button
Seat 2: ildar87kzn ($11.30 in chips) 
Seat 3: AAAcostA ($12.55 in chips) 
Seat 4: Himik30 ($15.52 in chips) 
Seat 5: PurpLongshaft ($7.24 in chips) 
Seat 6: Gorak2907 ($10 in chips) 
Himik30: posts small blind $0.05
PurpLongshaft: posts big blind $0.10
*** HOLE CARDS ***
Gorak2907: raises $0.20 to $0.30
ildar87kzn: raises $0.90 to $1.20
AAAcostA: folds 
Himik30: folds 
PurpLongshaft: folds 
Gorak2907: calls $0.90
*** FLOP *** [4d 8d 4h]
Gorak2907: checks 
ildar87kzn: bets $10.10 and is all-in
Gorak2907: folds 
Uncalled bet ($10.10) returned to ildar87kzn
ildar87kzn collected $2.44 from pot
ildar87kzn: doesn't show hand 
*** SUMMARY ***
Total pot $2.55 | Rake $0.11 
Board [4d 8d 4h]
Seat 2: ildar87kzn collected ($2.44)
Seat 3: AAAcostA (button) folded before Flop (didn't bet)
Seat 4: Himik30 (small blind) folded before Flop
Seat 5: PurpLongshaft (big blind) folded before Flop
Seat 6: Gorak2907 folded on the Flop



PokerStars Hand #222943950806:  Hold'em No Limit ($0.05/$0.10 USD) - 2021/01/23 23:22:25 ET
Table 'Malzovia III' 6-max Seat #4 is the button
Seat 2: ildar87kzn ($12.54 in chips) 
Seat 3: AAAcostA ($12.55 in chips) 
Seat 4: Himik30 ($15.47 in chips) 
Seat 5: PurpLongshaft ($7.14 in chips) 
Seat 6: Gorak2907 ($10 in chips) 
PurpLongshaft: posts small blind $0.05
Gorak2907: posts big blind $0.10
Laker_Style: sits out 
*** HOLE CARDS ***
ildar87kzn: folds 
AAAcostA: folds 
Himik30: raises $0.15 to $0.25
PurpLongshaft: folds 
Gorak2907: raises $0.55 to $0.80
Himik30: raises $1.90 to $2.70
Gorak2907: folds 
Uncalled bet ($1.90) returned to Himik30
Himik30 collected $1.65 from pot
Himik30: doesn't show hand 
*** SUMMARY ***
Total pot $1.65 | Rake $0 
Seat 2: ildar87kzn folded before Flop (didn't bet)
Seat 3: AAAcostA folded before Flop (didn't bet)
Seat 4: Himik30 (button) collected ($1.65)
Seat 5: PurpLongshaft (small blind) folded before Flop
Seat 6: Gorak2907 (big blind) folded before Flop



PokerStars Hand #222943960044:  Hold'em No Limit ($0.05/$0.10 USD) - 2021/01/23 23:22:54 ET
Table 'Malzovia III' 6-max Seat #5 is the button
Seat 1: Laker_Style ($10.10 in chips) 
Seat 2: ildar87kzn ($12.54 in chips) 
Seat 3: AAAcostA ($12.55 in chips) 
Seat 4: Himik30 ($16.32 in chips) 
Seat 5: PurpLongshaft ($7.09 in chips) 
Seat 6: Gorak2907 ($10 in chips) 
Gorak2907: posts small blind $0.05
Laker_Style: posts big blind $0.10
*** HOLE CARDS ***
ildar87kzn: folds 
AAAcostA: folds 
Himik30: folds 
PurpLongshaft: folds 
Gorak2907: folds 
Uncalled bet ($0.05) returned to Laker_Style
Laker_Style collected $0.10 from pot
Laker_Style: doesn't show hand 
*** SUMMARY ***
Total pot $0.10 | Rake $0 
Seat 1: Laker_Style (big blind) collected ($0.10)
Seat 2: ildar87kzn folded before Flop (didn't bet)
Seat 3: AAAcostA folded before Flop (didn't bet)
Seat 4: Himik30 folded before Flop (didn't bet)
Seat 5: PurpLongshaft (button) folded before Flop (didn't bet)
Seat 6: Gorak2907 (small blind) folded before Flop



PokerStars Hand #222943963796:  Hold'em No Limit ($0.05/$0.10 USD) - 2021/01/23 23:23:06 ET
Table 'Malzovia III' 6-max Seat #6 is the button
Seat 1: Laker_Style ($10.15 in chips) 
Seat 2: ildar87kzn ($12.54 in chips) 
Seat 3: AAAcostA ($12.55 in chips) 
Seat 4: Himik30 ($16.32 in chips) 
Seat 5: PurpLongshaft ($7.09 in chips) 
Seat 6: Gorak2907 ($10 in chips) 
Laker_Style: posts small blind $0.05
ildar87kzn: posts big blind $0.10
*** HOLE CARDS ***
AAAcostA: folds 
Himik30: folds 
PurpLongshaft: calls $0.10
Gorak2907: raises $0.30 to $0.40
Laker_Style: folds 
ildar87kzn: folds 
PurpLongshaft: calls $0.30
*** FLOP *** [Jh Qc 2d]
PurpLongshaft: checks 
Gorak2907: bets $0.46
PurpLongshaft: raises $0.46 to $0.92
Gorak2907: calls $0.46
*** TURN *** [Jh Qc 2d] [3h]
PurpLongshaft: checks 
Gorak2907: checks 
*** RIVER *** [Jh Qc 2d 3h] [7d]
PurpLongshaft: bets $1
Gorak2907: folds 
Uncalled bet ($1) returned to PurpLongshaft
PurpLongshaft collected $2.66 from pot
PurpLongshaft: doesn't show hand 
*** SUMMARY ***
Total pot $2.79 | Rake $0.13 
Board [Jh Qc 2d 3h 7d]
Seat 1: Laker_Style (small blind) folded before Flop
Seat 2: ildar87kzn (big blind) folded before Flop
Seat 3: AAAcostA folded before Flop (didn't bet)
Seat 4: Himik30 folded before Flop (didn't bet)
Seat 5: PurpLongshaft collected ($2.66)
Seat 6: Gorak2907 (button) folded on the River



PokerStars Hand #222943976531:  Hold'em No Limit ($0.05/$0.10 USD) - 2021/01/23 23:23:46 ET
Table 'Malzovia III' 6-max Seat #1 is the button
Seat 1: Laker_Style ($10.10 in chips) 
Seat 2: ildar87kzn ($12.44 in chips) 
Seat 3: AAAcostA ($12.55 in chips) 
Seat 4: Himik30 ($16.32 in chips) 
Seat 5: PurpLongshaft ($8.43 in chips) 
Seat 6: Gorak2907 ($10 in chips) 
ildar87kzn: posts small blind $0.05
AAAcostA: posts big blind $0.10
*** HOLE CARDS ***
Himik30: raises $0.15 to $0.25
PurpLongshaft: calls $0.25
Gorak2907: raises $0.90 to $1.15
Laker_Style: folds 
ildar87kzn: folds 
AAAcostA: folds 
Himik30: folds 
PurpLongshaft: folds 
Uncalled bet ($0.90) returned to Gorak2907
Gorak2907 collected $0.90 from pot
*** SUMMARY ***
Total pot $0.90 | Rake $0 
Seat 1: Laker_Style (button) folded before Flop (didn't bet)
Seat 2: ildar87kzn (small blind) folded before Flop
Seat 3: AAAcostA (big blind) folded before Flop
Seat 4: Himik30 folded before Flop
Seat 5: PurpLongshaft folded before Flop
Seat 6: Gorak2907 collected ($0.90)



PokerStars Hand #222943989179:  Hold'em No Limit ($0.05/$0.10 USD) - 2021/01/23 23:24:26 ET
Table 'Malzovia III' 6-max Seat #2 is the button
Seat 1: Laker_Style ($10.10 in chips) 
Seat 2: ildar87kzn ($12.39 in chips) 
Seat 3: AAAcostA ($12.45 in chips) 
Seat 4: Himik30 ($16.07 in chips) 
Seat 5: PurpLongshaft ($8.18 in chips) 
Seat 6: Gorak2907 ($10.65 in chips) 
AAAcostA: posts small blind $0.05
Himik30: posts big blind $0.10
*** HOLE CARDS ***
PurpLongshaft: calls $0.10
Gorak2907: folds 
Laker_Style: folds 
ildar87kzn: folds 
AAAcostA: raises $0.40 to $0.50
Himik30: folds 
PurpLongshaft: calls $0.40
*** FLOP *** [Qs Kc 8c]
AAAcostA: bets $0.32
PurpLongshaft: folds 
Uncalled bet ($0.32) returned to AAAcostA
AAAcostA collected $1.05 from pot
AAAcostA: doesn't show hand 
*** SUMMARY ***
Total pot $1.10 | Rake $0.05 
Board [Qs Kc 8c]
Seat 1: Laker_Style folded before Flop (didn't bet)
Seat 2: ildar87kzn (button) folded before Flop (didn't bet)
Seat 3: AAAcostA (small blind) collected ($1.05)
Seat 4: Himik30 (big blind) folded before Flop
Seat 5: PurpLongshaft folded on the Flop
Seat 6: Gorak2907 folded before Flop (didn't bet)



PokerStars Hand #222944001514:  Hold'em No Limit ($0.05/$0.10 USD) - 2021/01/23 23:25:05 ET
Table 'Malzovia III' 6-max Seat #3 is the button
Seat 1: Laker_Style ($10.10 in chips) 
Seat 2: ildar87kzn ($12.39 in chips) 
Seat 3: AAAcostA ($13 in chips) 
Seat 4: Himik30 ($15.97 in chips) 
Seat 5: PurpLongshaft ($7.68 in chips) 
Seat 6: Gorak2907 ($10.65 in chips) 
Himik30: posts small blind $0.05
PurpLongshaft: posts big blind $0.10
*** HOLE CARDS ***
Gorak2907 has timed out
Gorak2907: folds 
Laker_Style has timed out
Laker_Style: folds 
Laker_Style was removed from the table for failing to post
Laker_Style leaves the table
ildar87kzn: folds 
AAAcostA: folds 
Himik30: folds 
Uncalled bet ($0.05) returned to PurpLongshaft
PurpLongshaft collected $0.10 from pot
PurpLongshaft: doesn't show hand 
*** SUMMARY ***
Total pot $0.10 | Rake $0 
Seat 1: Laker_Style folded before Flop (didn't bet)
Seat 2: ildar87kzn folded before Flop (didn't bet)
Seat 3: AAAcostA (button) folded before Flop (didn't bet)
Seat 4: Himik30 (small blind) folded before Flop
Seat 5: PurpLongshaft (big blind) collected ($0.10)
Seat 6: Gorak2907 folded before Flop (didn't bet)



PokerStars Hand #222944010312:  Hold'em No Limit ($0.05/$0.10 USD) - 2021/01/23 23:25:32 ET
Table 'Malzovia III' 6-max Seat #4 is the button
Seat 2: ildar87kzn ($12.39 in chips) 
Seat 3: AAAcostA ($13 in chips) 
Seat 4: Himik30 ($15.92 in chips) 
Seat 5: PurpLongshaft ($7.73 in chips) 
Seat 6: Gorak2907 ($10.65 in chips) 
PurpLongshaft: posts small blind $0.05
Gorak2907: posts big blind $0.10
*** HOLE CARDS ***
ildar87kzn: raises $0.20 to $0.30
AAAcostA: folds 
gresscrack joins the table at seat #1 
Himik30: folds 
PurpLongshaft: calls $0.25
Gorak2907: folds 
*** FLOP *** [3c 2h Jd]
PurpLongshaft: checks 
ildar87kzn: bets $0.50
PurpLongshaft: raises $0.50 to $1
ildar87kzn: calls $0.50
*** TURN *** [3c 2h Jd] [Ac]
PurpLongshaft: bets $1
ildar87kzn: raises $5.50 to $6.50
PurpLongshaft: folds 
Uncalled bet ($5.50) returned to ildar87kzn
ildar87kzn collected $4.49 from pot
ildar87kzn: doesn't show hand 
*** SUMMARY ***
Total pot $4.70 | Rake $0.21 
Board [3c 2h Jd Ac]
Seat 2: ildar87kzn collected ($4.49)
Seat 3: AAAcostA folded before Flop (didn't bet)
Seat 4: Himik30 (button) folded before Flop (didn't bet)
Seat 5: PurpLongshaft (small blind) folded on the Turn
Seat 6: Gorak2907 (big blind) folded before Flop



PokerStars Hand #222944028431:  Hold'em No Limit ($0.05/$0.10 USD) - 2021/01/23 23:26:29 ET
Table 'Malzovia III' 6-max Seat #5 is the button
Seat 1: gresscrack ($10 in chips) 
Seat 2: ildar87kzn ($14.58 in chips) 
Seat 3: AAAcostA ($13 in chips) 
Seat 4: Himik30 ($15.92 in chips) 
Seat 5: PurpLongshaft ($5.43 in chips) 
Seat 6: Gorak2907 ($10.55 in chips) 
Gorak2907: posts small blind $0.05
gresscrack: posts big blind $0.10
*** HOLE CARDS ***
ildar87kzn: folds 
AAAcostA: raises $0.20 to $0.30
Himik30: folds 
PurpLongshaft: calls $0.30
Gorak2907: folds 
gresscrack: folds 
*** FLOP *** [Kh 7s Jh]
Gorak2907 leaves the table
AAAcostA: checks 
PurpLongshaft: checks 
*** TURN *** [Kh 7s Jh] [3h]
AAAcostA: bets $0.54
PurpLongshaft: raises $0.54 to $1.08
AAAcostA: folds 
Uncalled bet ($0.54) returned to PurpLongshaft
PurpLongshaft collected $1.75 from pot
PurpLongshaft: doesn't show hand 
*** SUMMARY ***
Total pot $1.83 | Rake $0.08 
Board [Kh 7s Jh 3h]
Seat 1: gresscrack (big blind) folded before Flop
Seat 2: ildar87kzn folded before Flop (didn't bet)
Seat 3: AAAcostA folded on the Turn
Seat 4: Himik30 folded before Flop (didn't bet)
Seat 5: PurpLongshaft (button) collected ($1.75)
Seat 6: Gorak2907 (small blind) folded before Flop



PokerStars Hand #222944037243:  Hold'em No Limit ($0.05/$0.10 USD) - 2021/01/23 23:26:58 ET
Table 'Malzovia III' 6-max Seat #1 is the button
Seat 1: gresscrack ($10 in chips) 
Seat 2: ildar87kzn ($14.58 in chips) 
Seat 3: AAAcostA ($12.16 in chips) 
Seat 4: Himik30 ($15.92 in chips) 
Seat 5: PurpLongshaft ($6.34 in chips) 
ildar87kzn: posts small blind $0.05
AAAcostA: posts big blind $0.10
*** HOLE CARDS ***
Himik30: folds 
PurpLongshaft: calls $0.10
gresscrack: folds 
ildar87kzn: folds 
kjohnson1409 joins the table at seat #6 
AAAcostA: checks 
*** FLOP *** [2c Tc 4h]
AAAcostA: checks 
PurpLongshaft: checks 
*** TURN *** [2c Tc 4h] [2d]
AAAcostA: checks 
PurpLongshaft: checks 
*** RIVER *** [2c Tc 4h 2d] [Ad]
AAAcostA: bets $0.20
PurpLongshaft: folds 
Uncalled bet ($0.20) returned to AAAcostA
AAAcostA collected $0.24 from pot
AAAcostA: doesn't show hand 
*** SUMMARY ***
Total pot $0.25 | Rake $0.01 
Board [2c Tc 4h 2d Ad]
Seat 1: gresscrack (button) folded before Flop (didn't bet)
Seat 2: ildar87kzn (small blind) folded before Flop
Seat 3: AAAcostA (big blind) collected ($0.24)
Seat 4: Himik30 folded before Flop (didn't bet)
Seat 5: PurpLongshaft folded on the River



PokerStars Hand #222944047615:  Hold'em No Limit ($0.05/$0.10 USD) - 2021/01/23 23:27:31 ET
Table 'Malzovia III' 6-max Seat #2 is the button
Seat 1: gresscrack ($10 in chips) 
Seat 2: ildar87kzn ($14.53 in chips) 
Seat 3: AAAcostA ($12.30 in chips) 
Seat 4: Himik30 ($15.92 in chips) 
Seat 5: PurpLongshaft ($6.24 in chips) 
AAAcostA: posts small blind $0.05
Himik30: posts big blind $0.10
kjohnson1409: sits out 
*** HOLE CARDS ***
PurpLongshaft: folds 
gresscrack: folds 
ildar87kzn: folds 
AAAcostA: folds 
Uncalled bet ($0.05) returned to Himik30
Himik30 collected $0.10 from pot
Himik30: doesn't show hand 
*** SUMMARY ***
Total pot $0.10 | Rake $0 
Seat 1: gresscrack folded before Flop (didn't bet)
Seat 2: ildar87kzn (button) folded before Flop (didn't bet)
Seat 3: AAAcostA (small blind) folded before Flop
Seat 4: Himik30 (big blind) collected ($0.10)
Seat 5: PurpLongshaft folded before Flop (didn't bet)



PokerStars Hand #222944050084:  Hold'em No Limit ($0.05/$0.10 USD) - 2021/01/23 23:27:39 ET
Table 'Malzovia III' 6-max Seat #3 is the button
Seat 1: gresscrack ($10 in chips) 
Seat 2: ildar87kzn ($14.53 in chips) 
Seat 3: AAAcostA ($12.25 in chips) 
Seat 4: Himik30 ($15.97 in chips) 
Seat 5: PurpLongshaft ($6.24 in chips) 
Himik30: posts small blind $0.05
PurpLongshaft: posts big blind $0.10
kjohnson1409: sits out 
*** HOLE CARDS ***
gresscrack: folds 
ildar87kzn: raises $0.20 to $0.30
AAAcostA: folds 
Himik30: folds 
PurpLongshaft: calls $0.20
*** FLOP *** [3d 3h Qc]
PurpLongshaft: checks 
ildar87kzn: checks 
*** TURN *** [3d 3h Qc] [9h]
PurpLongshaft: bets $0.40
ildar87kzn: folds 
Uncalled bet ($0.40) returned to PurpLongshaft
PurpLongshaft collected $0.62 from pot
PurpLongshaft: doesn't show hand 
*** SUMMARY ***
Total pot $0.65 | Rake $0.03 
Board [3d 3h Qc 9h]
Seat 1: gresscrack folded before Flop (didn't bet)
Seat 2: ildar87kzn folded on the Turn
Seat 3: AAAcostA (button) folded before Flop (didn't bet)
Seat 4: Himik30 (small blind) folded before Flop
Seat 5: PurpLongshaft (big blind) collected ($0.62)



PokerStars Hand #222944061975:  Hold'em No Limit ($0.05/$0.10 USD) - 2021/01/23 23:28:18 ET
Table 'Malzovia III' 6-max Seat #4 is the button
Seat 1: gresscrack ($10 in chips) 
Seat 2: ildar87kzn ($14.23 in chips) 
Seat 3: AAAcostA ($12.25 in chips) 
Seat 4: Himik30 ($15.92 in chips) 
Seat 5: PurpLongshaft ($6.56 in chips) 
Seat 6: kjohnson1409 ($10 in chips) 
PurpLongshaft: posts small blind $0.05
kjohnson1409: posts big blind $0.10
*** HOLE CARDS ***
gresscrack: folds 
ildar87kzn: folds 
AAAcostA: folds 
Himik30: folds 
PurpLongshaft: folds 
Uncalled bet ($0.05) returned to kjohnson1409
kjohnson1409 collected $0.10 from pot
kjohnson1409: doesn't show hand 
*** SUMMARY ***
Total pot $0.10 | Rake $0 
Seat 1: gresscrack folded before Flop (didn't bet)
Seat 2: ildar87kzn folded before Flop (didn't bet)
Seat 3: AAAcostA folded before Flop (didn't bet)
Seat 4: Himik30 (button) folded before Flop (didn't bet)
Seat 5: PurpLongshaft (small blind) folded before Flop
Seat 6: kjohnson1409 (big blind) collected ($0.10)



PokerStars Hand #222944064734:  Hold'em No Limit ($0.05/$0.10 USD) - 2021/01/23 23:28:26 ET
Table 'Malzovia III' 6-max Seat #5 is the button
Seat 1: gresscrack ($10 in chips) 
Seat 2: ildar87kzn ($14.23 in chips) 
Seat 3: AAAcostA ($12.25 in chips) 
Seat 4: Himik30 ($15.92 in chips) 
Seat 5: PurpLongshaft ($6.51 in chips) 
Seat 6: kjohnson1409 ($10.05 in chips) 
kjohnson1409: posts small blind $0.05
gresscrack: posts big blind $0.10
*** HOLE CARDS ***
ildar87kzn: folds 
AAAcostA: raises $0.20 to $0.30
Himik30: folds 
PurpLongshaft: folds 
kjohnson1409: folds 
gresscrack: folds 
Uncalled bet ($0.20) returned to AAAcostA
AAAcostA collected $0.25 from pot
AAAcostA: doesn't show hand 
*** SUMMARY ***
Total pot $0.25 | Rake $0 
Seat 1: gresscrack (big blind) folded before Flop
Seat 2: ildar87kzn folded before Flop (didn't bet)
Seat 3: AAAcostA collected ($0.25)
Seat 4: Himik30 folded before Flop (didn't bet)
Seat 5: PurpLongshaft (button) folded before Flop (didn't bet)
Seat 6: kjohnson1409 (small blind) folded before Flop



PokerStars Hand #222944071363:  Hold'em No Limit ($0.05/$0.10 USD) - 2021/01/23 23:28:48 ET
Table 'Malzovia III' 6-max Seat #6 is the button
Seat 1: gresscrack ($10 in chips) 
Seat 2: ildar87kzn ($14.23 in chips) 
Seat 3: AAAcostA ($12.40 in chips) 
Seat 4: Himik30 ($15.92 in chips) 
Seat 5: PurpLongshaft ($6.51 in chips) 
Seat 6: kjohnson1409 ($10 in chips) 
gresscrack: posts small blind $0.05
ildar87kzn: posts big blind $0.10
*** HOLE CARDS ***
AAAcostA: folds 
Himik30: folds 
PurpLongshaft: folds 
kjohnson1409: raises $0.20 to $0.30
gresscrack: folds 
ildar87kzn: folds 
Uncalled bet ($0.20) returned to kjohnson1409
kjohnson1409 collected $0.25 from pot
kjohnson1409: doesn't show hand 
*** SUMMARY ***
Total pot $0.25 | Rake $0 
Seat 1: gresscrack (small blind) folded before Flop
Seat 2: ildar87kzn (big blind) folded before Flop
Seat 3: AAAcostA folded before Flop (didn't bet)
Seat 4: Himik30 folded before Flop (didn't bet)
Seat 5: PurpLongshaft folded before Flop (didn't bet)
Seat 6: kjohnson1409 (button) collected ($0.25)



PokerStars Hand #222944075438:  Hold'em No Limit ($0.05/$0.10 USD) - 2021/01/23 23:29:01 ET
Table 'Malzovia III' 6-max Seat #1 is the button
Seat 1: gresscrack ($10 in chips) 
Seat 2: ildar87kzn ($14.13 in chips) 
Seat 3: AAAcostA ($12.40 in chips) 
Seat 4: Himik30 ($15.92 in chips) 
Seat 5: PurpLongshaft ($6.51 in chips) 
Seat 6: kjohnson1409 ($10.15 in chips) 
ildar87kzn: posts small blind $0.05
AAAcostA: posts big blind $0.10
*** HOLE CARDS ***
Himik30: folds 
PurpLongshaft: calls $0.10
kjohnson1409: folds 
gresscrack: folds 
ildar87kzn: folds 
AAAcostA: raises $0.40 to $0.50
PurpLongshaft: raises $6.01 to $6.51 and is all-in
AAAcostA: calls $6.01
*** FLOP *** [4s Th 2c]
*** TURN *** [4s Th 2c] [9d]
*** RIVER *** [4s Th 2c 9d] [Kd]
*** SHOW DOWN ***
AAAcostA: shows [Js Jh] (a pair of Jacks)
PurpLongshaft: shows [9h Ks] (two pair, Kings and Nines)
PurpLongshaft collected $12.48 from pot
*** SUMMARY ***
Total pot $13.07 | Rake $0.59 
Board [4s Th 2c 9d Kd]
Seat 1: gresscrack (button) folded before Flop (didn't bet)
Seat 2: ildar87kzn (small blind) folded before Flop
Seat 3: AAAcostA (big blind) showed [Js Jh] and lost with a pair of Jacks
Seat 4: Himik30 folded before Flop (didn't bet)
Seat 5: PurpLongshaft showed [9h Ks] and won ($12.48) with two pair, Kings and Nines
Seat 6: kjohnson1409 folded before Flop (didn't bet)



PokerStars Hand #222944085569:  Hold'em No Limit ($0.05/$0.10 USD) - 2021/01/23 23:29:34 ET
Table 'Malzovia III' 6-max Seat #2 is the button
Seat 1: gresscrack ($10 in chips) 
Seat 2: ildar87kzn ($14.08 in chips) 
Seat 3: AAAcostA ($10 in chips) 
Seat 4: Himik30 ($15.92 in chips) 
Seat 5: PurpLongshaft ($12.48 in chips) 
Seat 6: kjohnson1409 ($10.15 in chips) 
AAAcostA: posts small blind $0.05
Himik30: posts big blind $0.10
*** HOLE CARDS ***
PurpLongshaft: calls $0.10
kjohnson1409: folds 
gresscrack: raises $0.40 to $0.50
ildar87kzn: folds 
AAAcostA: calls $0.45
Himik30: calls $0.40
PurpLongshaft: calls $0.40
*** FLOP *** [9c Kh Qc]
AAAcostA: checks 
Himik30: checks 
PurpLongshaft: bets $0.60
gresscrack: calls $0.60
AAAcostA: folds 
Himik30: calls $0.60
*** TURN *** [9c Kh Qc] [Jc]
Himik30: checks 
PurpLongshaft: bets $0.50
gresscrack: raises $1.53 to $2.03
Himik30: folds 
PurpLongshaft: calls $1.53
*** RIVER *** [9c Kh Qc Jc] [Kd]
PurpLongshaft: checks 
gresscrack: checks 
*** SHOW DOWN ***
PurpLongshaft: shows [Th Tc] (a straight, Nine to King)
gresscrack: shows [Ts Ac] (a straight, Ten to Ace)
gresscrack collected $7.51 from pot
*** SUMMARY ***
Total pot $7.86 | Rake $0.35 
Board [9c Kh Qc Jc Kd]
Seat 1: gresscrack showed [Ts Ac] and won ($7.51) with a straight, Ten to Ace
Seat 2: ildar87kzn (button) folded before Flop (didn't bet)
Seat 3: AAAcostA (small blind) folded on the Flop
Seat 4: Himik30 (big blind) folded on the Turn
Seat 5: PurpLongshaft showed [Th Tc] and lost with a straight, Nine to King
Seat 6: kjohnson1409 folded before Flop (didn't bet)



PokerStars Hand #222944113414:  Hold'em No Limit ($0.05/$0.10 USD) - 2021/01/23 23:30:56 ET
Table 'Malzovia III' 6-max Seat #3 is the button
Seat 1: gresscrack ($14.38 in chips) 
Seat 2: ildar87kzn ($14.08 in chips) 
Seat 3: AAAcostA ($10 in chips) 
Seat 4: Himik30 ($14.82 in chips) 
Seat 5: PurpLongshaft ($9.35 in chips) 
Seat 6: kjohnson1409 ($10.15 in chips) 
Himik30: posts small blind $0.05
PurpLongshaft: posts big blind $0.10
*** HOLE CARDS ***
kjohnson1409: folds 
gresscrack: folds 
ildar87kzn: folds 
AAAcostA: folds 
Himik30: folds 
Uncalled bet ($0.05) returned to PurpLongshaft
PurpLongshaft collected $0.10 from pot
PurpLongshaft: doesn't show hand 
*** SUMMARY ***
Total pot $0.10 | Rake $0 
Seat 1: gresscrack folded before Flop (didn't bet)
Seat 2: ildar87kzn folded before Flop (didn't bet)
Seat 3: AAAcostA (button) folded before Flop (didn't bet)
Seat 4: Himik30 (small blind) folded before Flop
Seat 5: PurpLongshaft (big blind) collected ($0.10)
Seat 6: kjohnson1409 folded before Flop (didn't bet)



PokerStars Hand #222944118225:  Hold'em No Limit ($0.05/$0.10 USD) - 2021/01/23 23:31:12 ET
Table 'Malzovia III' 6-max Seat #4 is the button
Seat 1: gresscrack ($14.38 in chips) 
Seat 2: ildar87kzn ($14.08 in chips) 
Seat 3: AAAcostA ($10 in chips) 
Seat 4: Himik30 ($14.77 in chips) 
Seat 5: PurpLongshaft ($9.40 in chips) 
Seat 6: kjohnson1409 ($10.15 in chips) 
PurpLongshaft: posts small blind $0.05
kjohnson1409: posts big blind $0.10
*** HOLE CARDS ***
gresscrack: raises $0.20 to $0.30
ildar87kzn: folds 
AAAcostA: folds 
Himik30: folds 
PurpLongshaft: calls $0.25
kjohnson1409: calls $0.20
*** FLOP *** [8c 3d 5c]
PurpLongshaft: checks 
kjohnson1409: bets $0.43
gresscrack: folds 
PurpLongshaft: folds 
Uncalled bet ($0.43) returned to kjohnson1409
kjohnson1409 collected $0.86 from pot
kjohnson1409: doesn't show hand 
*** SUMMARY ***
Total pot $0.90 | Rake $0.04 
Board [8c 3d 5c]
Seat 1: gresscrack folded on the Flop
Seat 2: ildar87kzn folded before Flop (didn't bet)
Seat 3: AAAcostA folded before Flop (didn't bet)
Seat 4: Himik30 (button) folded before Flop (didn't bet)
Seat 5: PurpLongshaft (small blind) folded on the Flop
Seat 6: kjohnson1409 (big blind) collected ($0.86)



PokerStars Hand #222944127159:  Hold'em No Limit ($0.05/$0.10 USD) - 2021/01/23 23:31:41 ET
Table 'Malzovia III' 6-max Seat #5 is the button
Seat 1: gresscrack ($14.08 in chips) 
Seat 2: ildar87kzn ($14.08 in chips) 
Seat 3: AAAcostA ($10 in chips) 
Seat 4: Himik30 ($14.77 in chips) 
Seat 5: PurpLongshaft ($9.10 in chips) 
Seat 6: kjohnson1409 ($10.71 in chips) 
kjohnson1409: posts small blind $0.05
gresscrack: posts big blind $0.10
*** HOLE CARDS ***
ildar87kzn: raises $0.20 to $0.30
AAAcostA: folds 
Himik30: folds 
PurpLongshaft: calls $0.30
kjohnson1409: folds 
gresscrack: calls $0.20
*** FLOP *** [2h 9d 8h]
gresscrack: checks 
ildar87kzn: bets $0.80
PurpLongshaft is disconnected 
PurpLongshaft is connected 
PurpLongshaft: folds 
gresscrack: folds 
Uncalled bet ($0.80) returned to ildar87kzn
ildar87kzn collected $0.91 from pot
ildar87kzn: doesn't show hand 
*** SUMMARY ***
Total pot $0.95 | Rake $0.04 
Board [2h 9d 8h]
Seat 1: gresscrack (big blind) folded on the Flop
Seat 2: ildar87kzn collected ($0.91)
Seat 3: AAAcostA folded before Flop (didn't bet)
Seat 4: Himik30 folded before Flop (didn't bet)
Seat 5: PurpLongshaft (button) folded on the Flop
Seat 6: kjohnson1409 (small blind) folded before Flop



PokerStars Hand #222944144849:  Hold'em No Limit ($0.05/$0.10 USD) - 2021/01/23 23:32:39 ET
Table 'Malzovia III' 6-max Seat #6 is the button
Seat 1: gresscrack ($13.78 in chips) 
Seat 2: ildar87kzn ($14.69 in chips) 
Seat 3: AAAcostA ($10 in chips) 
Seat 4: Himik30 ($14.77 in chips) 
Seat 5: PurpLongshaft ($8.80 in chips) 
Seat 6: kjohnson1409 ($10.66 in chips) 
gresscrack: posts small blind $0.05
ildar87kzn: posts big blind $0.10
*** HOLE CARDS ***
AAAcostA: folds 
Himik30: folds 
PurpLongshaft: calls $0.10
kjohnson1409: raises $0.30 to $0.40
gresscrack: folds 
ildar87kzn: raises $0.95 to $1.35
PurpLongshaft: folds 
kjohnson1409: raises $0.95 to $2.30
ildar87kzn: calls $0.95
*** FLOP *** [7c 6d 9c]
ildar87kzn: checks 
kjohnson1409: bets $4.54
ildar87kzn: folds 
Uncalled bet ($4.54) returned to kjohnson1409
kjohnson1409 collected $4.54 from pot
kjohnson1409: doesn't show hand 
*** SUMMARY ***
Total pot $4.75 | Rake $0.21 
Board [7c 6d 9c]
Seat 1: gresscrack (small blind) folded before Flop
Seat 2: ildar87kzn (big blind) folded on the Flop
Seat 3: AAAcostA folded before Flop (didn't bet)
Seat 4: Himik30 folded before Flop (didn't bet)
Seat 5: PurpLongshaft folded before Flop
Seat 6: kjohnson1409 (button) collected ($4.54)



PokerStars Hand #222944160960:  Hold'em No Limit ($0.05/$0.10 USD) - 2021/01/23 23:33:31 ET
Table 'Malzovia III' 6-max Seat #1 is the button
Seat 1: gresscrack ($13.73 in chips) 
Seat 2: ildar87kzn ($12.39 in chips) 
Seat 3: AAAcostA ($10 in chips) 
Seat 4: Himik30 ($14.77 in chips) 
Seat 5: PurpLongshaft ($8.70 in chips) 
Seat 6: kjohnson1409 ($12.90 in chips) 
ildar87kzn: posts small blind $0.05
AAAcostA: posts big blind $0.10
*** HOLE CARDS ***
Himik30: folds 
PurpLongshaft: folds 
kjohnson1409: folds 
gresscrack: folds 
ildar87kzn: folds 
Uncalled bet ($0.05) returned to AAAcostA
AAAcostA collected $0.10 from pot
AAAcostA: doesn't show hand 
*** SUMMARY ***
Total pot $0.10 | Rake $0 
Seat 1: gresscrack (button) folded before Flop (didn't bet)
Seat 2: ildar87kzn (small blind) folded before Flop
Seat 3: AAAcostA (big blind) collected ($0.10)
Seat 4: Himik30 folded before Flop (didn't bet)
Seat 5: PurpLongshaft folded before Flop (didn't bet)
Seat 6: kjohnson1409 folded before Flop (didn't bet)



PokerStars Hand #222944163586:  Hold'em No Limit ($0.05/$0.10 USD) - 2021/01/23 23:33:40 ET
Table 'Malzovia III' 6-max Seat #2 is the button
Seat 1: gresscrack ($13.73 in chips) 
Seat 2: ildar87kzn ($12.34 in chips) 
Seat 3: AAAcostA ($10.05 in chips) 
Seat 4: Himik30 ($14.77 in chips) 
Seat 5: PurpLongshaft ($8.70 in chips) 
Seat 6: kjohnson1409 ($12.90 in chips) 
AAAcostA: posts small blind $0.05
Himik30: posts big blind $0.10
*** HOLE CARDS ***
PurpLongshaft: calls $0.10
kjohnson1409: folds 
gresscrack: raises $0.40 to $0.50
ildar87kzn: folds 
AAAcostA: folds 
Himik30: calls $0.40
PurpLongshaft: calls $0.40
*** FLOP *** [Qh 2h Qd]
Himik30: checks 
PurpLongshaft: checks 
gresscrack: bets $0.49
Himik30: calls $0.49
PurpLongshaft: folds 
*** TURN *** [Qh 2h Qd] [Ad]
Himik30: checks 
gresscrack: checks 
*** RIVER *** [Qh 2h Qd Ad] [3d]
Himik30: checks 
gresscrack: bets $0.90
Himik30: calls $0.90
*** SHOW DOWN ***
gresscrack: shows [Ks Ah] (two pair, Aces and Queens)
Himik30: mucks hand 
gresscrack collected $4.14 from pot
*** SUMMARY ***
Total pot $4.33 | Rake $0.19 
Board [Qh 2h Qd Ad 3d]
Seat 1: gresscrack showed [Ks Ah] and won ($4.14) with two pair, Aces and Queens
Seat 2: ildar87kzn (button) folded before Flop (didn't bet)
Seat 3: AAAcostA (small blind) folded before Flop
Seat 4: Himik30 (big blind) mucked
Seat 5: PurpLongshaft folded on the Flop
Seat 6: kjohnson1409 folded before Flop (didn't bet)



PokerStars Hand #222944179862:  Hold'em No Limit ($0.05/$0.10 USD) - 2021/01/23 23:34:33 ET
Table 'Malzovia III' 6-max Seat #3 is the button
Seat 1: gresscrack ($15.98 in chips) 
Seat 2: ildar87kzn ($12.34 in chips) 
Seat 3: AAAcostA ($10 in chips) 
Seat 4: Himik30 ($12.88 in chips) 
Seat 5: PurpLongshaft ($8.20 in chips) 
Seat 6: kjohnson1409 ($12.90 in chips) 
Himik30: posts small blind $0.05
PurpLongshaft: posts big blind $0.10
*** HOLE CARDS ***
kjohnson1409: folds 
gresscrack: folds 
ildar87kzn: folds 
AAAcostA: folds 
Himik30: folds 
Uncalled bet ($0.05) returned to PurpLongshaft
PurpLongshaft collected $0.10 from pot
PurpLongshaft: doesn't show hand 
*** SUMMARY ***
Total pot $0.10 | Rake $0 
Seat 1: gresscrack folded before Flop (didn't bet)
Seat 2: ildar87kzn folded before Flop (didn't bet)
Seat 3: AAAcostA (button) folded before Flop (didn't bet)
Seat 4: Himik30 (small blind) folded before Flop
Seat 5: PurpLongshaft (big blind) collected ($0.10)
Seat 6: kjohnson1409 folded before Flop (didn't bet)



PokerStars Hand #222944182829:  Hold'em No Limit ($0.05/$0.10 USD) - 2021/01/23 23:34:43 ET
Table 'Malzovia III' 6-max Seat #4 is the button
Seat 1: gresscrack ($15.98 in chips) 
Seat 2: ildar87kzn ($12.34 in chips) 
Seat 3: AAAcostA ($10 in chips) 
Seat 4: Himik30 ($12.83 in chips) 
Seat 5: PurpLongshaft ($8.25 in chips) 
Seat 6: kjohnson1409 ($12.90 in chips) 
PurpLongshaft: posts small blind $0.05
kjohnson1409: posts big blind $0.10
*** HOLE CARDS ***
gresscrack: folds 
ildar87kzn: folds 
AAAcostA: folds 
Himik30: raises $0.15 to $0.25
PurpLongshaft: calls $0.20
kjohnson1409: folds 
*** FLOP *** [4h 9s Qh]
PurpLongshaft: bets $0.30
Himik30: folds 
Uncalled bet ($0.30) returned to PurpLongshaft
PurpLongshaft collected $0.57 from pot
PurpLongshaft: doesn't show hand 
*** SUMMARY ***
Total pot $0.60 | Rake $0.03 
Board [4h 9s Qh]
Seat 1: gresscrack folded before Flop (didn't bet)
Seat 2: ildar87kzn folded before Flop (didn't bet)
Seat 3: AAAcostA folded before Flop (didn't bet)
Seat 4: Himik30 (button) folded on the Flop
Seat 5: PurpLongshaft (small blind) collected ($0.57)
Seat 6: kjohnson1409 (big blind) folded before Flop



PokerStars Hand #222944195309:  Hold'em No Limit ($0.05/$0.10 USD) - 2021/01/23 23:35:14 ET
Table 'Malzovia III' 6-max Seat #5 is the button
Seat 1: gresscrack ($15.98 in chips) 
Seat 2: ildar87kzn ($12.34 in chips) 
Seat 3: AAAcostA ($10 in chips) 
Seat 4: Himik30 ($12.58 in chips) 
Seat 5: PurpLongshaft ($8.57 in chips) 
Seat 6: kjohnson1409 ($12.80 in chips) 
kjohnson1409: posts small blind $0.05
gresscrack: posts big blind $0.10
*** HOLE CARDS ***
ildar87kzn: folds 
AAAcostA: folds 
Himik30: raises $0.15 to $0.25
PurpLongshaft: calls $0.25
kjohnson1409: folds 
gresscrack: calls $0.15
*** FLOP *** [9s 9h 6s]
gresscrack: checks 
Himik30: checks 
PurpLongshaft: checks 
*** TURN *** [9s 9h 6s] [8d]
gresscrack: bets $0.19
Himik30: folds 
PurpLongshaft: raises $0.19 to $0.38
gresscrack: folds 
Uncalled bet ($0.19) returned to PurpLongshaft
PurpLongshaft collected $1.13 from pot
PurpLongshaft: doesn't show hand 
*** SUMMARY ***
Total pot $1.18 | Rake $0.05 
Board [9s 9h 6s 8d]
Seat 1: gresscrack (big blind) folded on the Turn
Seat 2: ildar87kzn folded before Flop (didn't bet)
Seat 3: AAAcostA folded before Flop (didn't bet)
Seat 4: Himik30 folded on the Turn
Seat 5: PurpLongshaft (button) collected ($1.13)
Seat 6: kjohnson1409 (small blind) folded before Flop



PokerStars Hand #222944206345:  Hold'em No Limit ($0.05/$0.10 USD) - 2021/01/23 23:35:50 ET
Table 'Malzovia III' 6-max Seat #6 is the button
Seat 1: gresscrack ($15.54 in chips) 
Seat 2: ildar87kzn ($12.34 in chips) 
Seat 3: AAAcostA ($10 in chips) 
Seat 4: Himik30 ($12.33 in chips) 
Seat 5: PurpLongshaft ($9.26 in chips) 
Seat 6: kjohnson1409 ($12.75 in chips) 
gresscrack: posts small blind $0.05
ildar87kzn: posts big blind $0.10
*** HOLE CARDS ***
AAAcostA: folds 
Himik30: folds 
PurpLongshaft: calls $0.10
kjohnson1409: raises $0.30 to $0.40
gresscrack: folds 
ildar87kzn: folds 
PurpLongshaft: calls $0.30
*** FLOP *** [9h Ah Qh]
PurpLongshaft: checks 
kjohnson1409: bets $0.30
PurpLongshaft: calls $0.30
*** TURN *** [9h Ah Qh] [3h]
PurpLongshaft: checks 
kjohnson1409: bets $0.30
PurpLongshaft: raises $0.30 to $0.60
kjohnson1409: folds 
Uncalled bet ($0.30) returned to PurpLongshaft
PurpLongshaft collected $2.05 from pot
PurpLongshaft: doesn't show hand 
*** SUMMARY ***
Total pot $2.15 | Rake $0.10 
Board [9h Ah Qh 3h]
Seat 1: gresscrack (small blind) folded before Flop
Seat 2: ildar87kzn (big blind) folded before Flop
Seat 3: AAAcostA folded before Flop (didn't bet)
Seat 4: Himik30 folded before Flop (didn't bet)
Seat 5: PurpLongshaft collected ($2.05)
Seat 6: kjohnson1409 (button) folded on the Turn



PokerStars Hand #222944224924:  Hold'em No Limit ($0.05/$0.10 USD) - 2021/01/23 23:36:52 ET
Table 'Malzovia III' 6-max Seat #1 is the button
Seat 1: gresscrack ($15.49 in chips) 
Seat 2: ildar87kzn ($12.24 in chips) 
Seat 3: AAAcostA ($10 in chips) 
Seat 4: Himik30 ($12.33 in chips) 
Seat 5: PurpLongshaft ($10.31 in chips) 
Seat 6: kjohnson1409 ($11.75 in chips) 
ildar87kzn: posts small blind $0.05
AAAcostA: posts big blind $0.10
*** HOLE CARDS ***
Himik30: folds 
PurpLongshaft: calls $0.10
kjohnson1409: folds 
gresscrack: folds 
ildar87kzn: raises $0.30 to $0.40
AAAcostA: folds 
PurpLongshaft: calls $0.30
*** FLOP *** [Qd 3h 3c]
ildar87kzn: bets $0.70
PurpLongshaft: folds 
Uncalled bet ($0.70) returned to ildar87kzn
ildar87kzn collected $0.86 from pot
ildar87kzn: doesn't show hand 
*** SUMMARY ***
Total pot $0.90 | Rake $0.04 
Board [Qd 3h 3c]
Seat 1: gresscrack (button) folded before Flop (didn't bet)
Seat 2: ildar87kzn (small blind) collected ($0.86)
Seat 3: AAAcostA (big blind) folded before Flop
Seat 4: Himik30 folded before Flop (didn't bet)
Seat 5: PurpLongshaft folded on the Flop
Seat 6: kjohnson1409 folded before Flop (didn't bet)



PokerStars Hand #222944233873:  Hold'em No Limit ($0.05/$0.10 USD) - 2021/01/23 23:37:22 ET
Table 'Malzovia III' 6-max Seat #2 is the button
Seat 1: gresscrack ($15.49 in chips) 
Seat 2: ildar87kzn ($12.70 in chips) 
Seat 3: AAAcostA ($10 in chips) 
Seat 4: Himik30 ($12.33 in chips) 
Seat 5: PurpLongshaft ($9.91 in chips) 
Seat 6: kjohnson1409 ($11.75 in chips) 
AAAcostA: posts small blind $0.05
Himik30: posts big blind $0.10
*** HOLE CARDS ***
PurpLongshaft: folds 
kjohnson1409: folds 
gresscrack: folds 
ildar87kzn: folds 
AAAcostA: folds 
Uncalled bet ($0.05) returned to Himik30
Himik30 collected $0.10 from pot
Himik30: doesn't show hand 
*** SUMMARY ***
Total pot $0.10 | Rake $0 
Seat 1: gresscrack folded before Flop (didn't bet)
Seat 2: ildar87kzn (button) folded before Flop (didn't bet)
Seat 3: AAAcostA (small blind) folded before Flop
Seat 4: Himik30 (big blind) collected ($0.10)
Seat 5: PurpLongshaft folded before Flop (didn't bet)
Seat 6: kjohnson1409 folded before Flop (didn't bet)



PokerStars Hand #222944238202:  Hold'em No Limit ($0.05/$0.10 USD) - 2021/01/23 23:37:36 ET
Table 'Malzovia III' 6-max Seat #3 is the button
Seat 1: gresscrack ($15.49 in chips) 
Seat 2: ildar87kzn ($12.70 in chips) 
Seat 3: AAAcostA ($10 in chips) 
Seat 4: Himik30 ($12.38 in chips) 
Seat 5: PurpLongshaft ($9.91 in chips) 
Seat 6: kjohnson1409 ($11.75 in chips) 
Himik30: posts small blind $0.05
PurpLongshaft: posts big blind $0.10
*** HOLE CARDS ***
kjohnson1409: folds 
gresscrack: folds 
ildar87kzn: raises $0.20 to $0.30
AAAcostA: folds 
Himik30: folds 
PurpLongshaft: calls $0.20
*** FLOP *** [3h 8c 9d]
PurpLongshaft: checks 
ildar87kzn: bets $0.40
PurpLongshaft: folds 
Uncalled bet ($0.40) returned to ildar87kzn
ildar87kzn collected $0.62 from pot
ildar87kzn: doesn't show hand 
*** SUMMARY ***
Total pot $0.65 | Rake $0.03 
Board [3h 8c 9d]
Seat 1: gresscrack folded before Flop (didn't bet)
Seat 2: ildar87kzn collected ($0.62)
Seat 3: AAAcostA (button) folded before Flop (didn't bet)
Seat 4: Himik30 (small blind) folded before Flop
Seat 5: PurpLongshaft (big blind) folded on the Flop
Seat 6: kjohnson1409 folded before Flop (didn't bet)



PokerStars Hand #222944250229:  Hold'em No Limit ($0.05/$0.10 USD) - 2021/01/23 23:38:16 ET
Table 'Malzovia III' 6-max Seat #4 is the button
Seat 1: gresscrack ($15.49 in chips) 
Seat 2: ildar87kzn ($13.02 in chips) 
Seat 3: AAAcostA ($10 in chips) 
Seat 4: Himik30 ($12.33 in chips) 
Seat 5: PurpLongshaft ($9.61 in chips) 
Seat 6: kjohnson1409 ($11.75 in chips) 
PurpLongshaft: posts small blind $0.05
kjohnson1409: posts big blind $0.10
*** HOLE CARDS ***
gresscrack: folds 
ildar87kzn: folds 
AAAcostA: folds 
Himik30: folds 
PurpLongshaft: folds 
Uncalled bet ($0.05) returned to kjohnson1409
kjohnson1409 collected $0.10 from pot
kjohnson1409: doesn't show hand 
*** SUMMARY ***
Total pot $0.10 | Rake $0 
Seat 1: gresscrack folded before Flop (didn't bet)
Seat 2: ildar87kzn folded before Flop (didn't bet)
Seat 3: AAAcostA folded before Flop (didn't bet)
Seat 4: Himik30 (button) folded before Flop (didn't bet)
Seat 5: PurpLongshaft (small blind) folded before Flop
Seat 6: kjohnson1409 (big blind) collected ($0.10)



PokerStars Hand #222944252686:  Hold'em No Limit ($0.05/$0.10 USD) - 2021/01/23 23:38:24 ET
Table 'Malzovia III' 6-max Seat #5 is the button
Seat 1: gresscrack ($15.49 in chips) 
Seat 2: ildar87kzn ($13.02 in chips) 
Seat 3: AAAcostA ($10 in chips) 
Seat 4: Himik30 ($12.33 in chips) 
Seat 5: PurpLongshaft ($9.56 in chips) 
Seat 6: kjohnson1409 ($11.80 in chips) 
kjohnson1409: posts small blind $0.05
gresscrack: posts big blind $0.10
*** HOLE CARDS ***
ildar87kzn: folds 
AAAcostA: folds 
Himik30: folds 
PurpLongshaft: calls $0.10
kjohnson1409: raises $0.30 to $0.40
gresscrack: calls $0.30
PurpLongshaft: folds 
*** FLOP *** [5s 6c Ks]
kjohnson1409: bets $0.20
gresscrack: calls $0.20
*** TURN *** [5s 6c Ks] [Jc]
kjohnson1409: bets $0.62
gresscrack: calls $0.62
*** RIVER *** [5s 6c Ks Jc] [Ah]
kjohnson1409: checks 
gresscrack: checks 
*** SHOW DOWN ***
kjohnson1409: shows [Jd 9s] (a pair of Jacks)
gresscrack: shows [Kh 9h] (a pair of Kings)
gresscrack collected $2.43 from pot
*** SUMMARY ***
Total pot $2.54 | Rake $0.11 
Board [5s 6c Ks Jc Ah]
Seat 1: gresscrack (big blind) showed [Kh 9h] and won ($2.43) with a pair of Kings
Seat 2: ildar87kzn folded before Flop (didn't bet)
Seat 3: AAAcostA folded before Flop (didn't bet)
Seat 4: Himik30 folded before Flop (didn't bet)
Seat 5: PurpLongshaft (button) folded before Flop
Seat 6: kjohnson1409 (small blind) showed [Jd 9s] and lost with a pair of Jacks



PokerStars Hand #222944273234:  Hold'em No Limit ($0.05/$0.10 USD) - 2021/01/23 23:39:32 ET
Table 'Malzovia III' 6-max Seat #6 is the button
Seat 1: gresscrack ($16.70 in chips) 
Seat 2: ildar87kzn ($13.02 in chips) 
Seat 3: AAAcostA ($10 in chips) 
Seat 4: Himik30 ($12.33 in chips) 
Seat 5: PurpLongshaft ($9.46 in chips) 
Seat 6: kjohnson1409 ($10.58 in chips) 
gresscrack: posts small blind $0.05
ildar87kzn: posts big blind $0.10
*** HOLE CARDS ***
AAAcostA: folds 
Himik30: folds 
PurpLongshaft: folds 
kjohnson1409: raises $0.20 to $0.30
gresscrack: folds 
ildar87kzn: calls $0.20
*** FLOP *** [5d 9s Jh]
PurpLongshaft leaves the table
ildar87kzn: checks 
Ifivecrypto joins the table at seat #5 
kjohnson1409: bets $0.41
ildar87kzn: folds 
Uncalled bet ($0.41) returned to kjohnson1409
kjohnson1409 collected $0.62 from pot
kjohnson1409: doesn't show hand 
*** SUMMARY ***
Total pot $0.65 | Rake $0.03 
Board [5d 9s Jh]
Seat 1: gresscrack (small blind) folded before Flop
Seat 2: ildar87kzn (big blind) folded on the Flop
Seat 3: AAAcostA folded before Flop (didn't bet)
Seat 4: Himik30 folded before Flop (didn't bet)
Seat 5: PurpLongshaft folded before Flop (didn't bet)
Seat 6: kjohnson1409 (button) collected ($0.62)



PokerStars Hand #222944285996:  Hold'em No Limit ($0.05/$0.10 USD) - 2021/01/23 23:40:14 ET
Table 'Malzovia III' 6-max Seat #1 is the button
Seat 1: gresscrack ($16.65 in chips) 
Seat 2: ildar87kzn ($12.72 in chips) 
Seat 4: Himik30 ($12.33 in chips) 
Seat 6: kjohnson1409 ($10.90 in chips) 
ildar87kzn: posts small blind $0.05
AAAcostA: is sitting out 
Himik30: posts big blind $0.10
AAAcostA leaves the table
Ifivecrypto: sits out 
*** HOLE CARDS ***
kjohnson1409: folds 
gresscrack: raises $0.20 to $0.30
ildar87kzn: folds 
Himik30: folds 
Uncalled bet ($0.20) returned to gresscrack
gresscrack collected $0.25 from pot
gresscrack: doesn't show hand 
*** SUMMARY ***
Total pot $0.25 | Rake $0 
Seat 1: gresscrack (button) collected ($0.25)
Seat 2: ildar87kzn (small blind) folded before Flop
Seat 4: Himik30 (big blind) folded before Flop
Seat 6: kjohnson1409 folded before Flop (didn't bet)



PokerStars Hand #222944289330:  Hold'em No Limit ($0.05/$0.10 USD) - 2021/01/23 23:40:25 ET
Table 'Malzovia III' 6-max Seat #2 is the button
Seat 1: gresscrack ($16.80 in chips) 
Seat 2: ildar87kzn ($12.67 in chips) 
Seat 4: Himik30 ($12.23 in chips) 
Seat 5: Ifivecrypto ($5.87 in chips) 
Seat 6: kjohnson1409 ($10.90 in chips) 
Himik30: posts small blind $0.05
Ifivecrypto: posts big blind $0.10
*** HOLE CARDS ***
kjohnson1409: folds 
gresscrack: folds 
ildar87kzn: folds 
Himik30: raises $0.20 to $0.30
Ifivecrypto: folds 
Uncalled bet ($0.20) returned to Himik30
Himik30 collected $0.20 from pot
Himik30: doesn't show hand 
*** SUMMARY ***
Total pot $0.20 | Rake $0 
Seat 1: gresscrack folded before Flop (didn't bet)
Seat 2: ildar87kzn (button) folded before Flop (didn't bet)
Seat 4: Himik30 (small blind) collected ($0.20)
Seat 5: Ifivecrypto (big blind) folded before Flop
Seat 6: kjohnson1409 folded before Flop (didn't bet)



PokerStars Hand #222944300392:  Hold'em No Limit ($0.05/$0.10 USD) - 2021/01/23 23:40:40 ET
Table 'Malzovia III' 6-max Seat #4 is the button
Seat 1: gresscrack ($16.80 in chips) 
Seat 2: ildar87kzn ($12.67 in chips) 
Seat 4: Himik30 ($12.33 in chips) 
Seat 5: Ifivecrypto ($5.77 in chips) 
Seat 6: kjohnson1409 ($10.90 in chips) 
Ifivecrypto: posts small blind $0.05
kjohnson1409: posts big blind $0.10
*** HOLE CARDS ***
Tony Zhukov joins the table at seat #3 
gresscrack: folds 
ildar87kzn: folds 
Himik30: raises $0.15 to $0.25
Ifivecrypto: calls $0.20
kjohnson1409: raises $0.15 to $0.40
Himik30: calls $0.15
Ifivecrypto: calls $0.15
*** FLOP *** [Th 7d 7s]
Ifivecrypto: checks 
kjohnson1409: bets $0.58
Himik30: calls $0.58
Ifivecrypto: folds 
*** TURN *** [Th 7d 7s] [7h]
kjohnson1409: checks 
Himik30: bets $1.13
kjohnson1409: calls $1.13
*** RIVER *** [Th 7d 7s 7h] [9c]
kjohnson1409: checks 
Himik30: checks 
*** SHOW DOWN ***
kjohnson1409: shows [Kc Ac] (three of a kind, Sevens)
Himik30: shows [Qh Td] (a full house, Sevens full of Tens)
Himik30 collected $4.41 from pot
*** SUMMARY ***
Total pot $4.62 | Rake $0.21 
Board [Th 7d 7s 7h 9c]
Seat 1: gresscrack folded before Flop (didn't bet)
Seat 2: ildar87kzn folded before Flop (didn't bet)
Seat 4: Himik30 (button) showed [Qh Td] and won ($4.41) with a full house, Sevens full of Tens
Seat 5: Ifivecrypto (small blind) folded on the Flop
Seat 6: kjohnson1409 (big blind) showed [Kc Ac] and lost with three of a kind, Sevens



PokerStars Hand #222944327351:  Hold'em No Limit ($0.05/$0.10 USD) - 2021/01/23 23:42:10 ET
Table 'Malzovia III' 6-max Seat #5 is the button
Seat 1: gresscrack ($16.80 in chips) 
Seat 2: ildar87kzn ($12.67 in chips) 
Seat 4: Himik30 ($14.63 in chips) 
Seat 5: Ifivecrypto ($5.37 in chips) 
Seat 6: kjohnson1409 ($8.79 in chips) 
kjohnson1409: posts small blind $0.05
gresscrack: posts big blind $0.10
Tony Zhukov: sits out 
*** HOLE CARDS ***
ildar87kzn: folds 
Himik30: folds 
Ifivecrypto: calls $0.10
kjohnson1409: raises $0.20 to $0.30
gresscrack: folds 
Ifivecrypto: folds 
Uncalled bet ($0.20) returned to kjohnson1409
kjohnson1409 collected $0.30 from pot
kjohnson1409: doesn't show hand 
*** SUMMARY ***
Total pot $0.30 | Rake $0 
Seat 1: gresscrack (big blind) folded before Flop
Seat 2: ildar87kzn folded before Flop (didn't bet)
Seat 4: Himik30 folded before Flop (didn't bet)
Seat 5: Ifivecrypto (button) folded before Flop
Seat 6: kjohnson1409 (small blind) collected ($0.30)



PokerStars Hand #222944334432:  Hold'em No Limit ($0.05/$0.10 USD) - 2021/01/23 23:42:34 ET
Table 'Malzovia III' 6-max Seat #6 is the button
Seat 1: gresscrack ($16.70 in chips) 
Seat 2: ildar87kzn ($12.67 in chips) 
Seat 4: Himik30 ($14.63 in chips) 
Seat 5: Ifivecrypto ($5.27 in chips) 
Seat 6: kjohnson1409 ($8.99 in chips) 
gresscrack: posts small blind $0.05
ildar87kzn: posts big blind $0.10
Tony Zhukov: sits out 
*** HOLE CARDS ***
Himik30: raises $0.15 to $0.25
Ifivecrypto: folds 
kjohnson1409: folds 
gresscrack: folds 
ildar87kzn: folds 
Uncalled bet ($0.15) returned to Himik30
Himik30 collected $0.25 from pot
Himik30: doesn't show hand 
*** SUMMARY ***
Total pot $0.25 | Rake $0 
Seat 1: gresscrack (small blind) folded before Flop
Seat 2: ildar87kzn (big blind) folded before Flop
Seat 4: Himik30 collected ($0.25)
Seat 5: Ifivecrypto folded before Flop (didn't bet)
Seat 6: kjohnson1409 (button) folded before Flop (didn't bet)



PokerStars Hand #222944341090:  Hold'em No Limit ($0.05/$0.10 USD) - 2021/01/23 23:42:56 ET
Table 'Malzovia III' 6-max Seat #1 is the button
Seat 1: gresscrack ($16.65 in chips) 
Seat 2: ildar87kzn ($12.57 in chips) 
Seat 3: Tony Zhukov ($10 in chips) 
Seat 4: Himik30 ($14.78 in chips) 
Seat 5: Ifivecrypto ($5.27 in chips) 
Seat 6: kjohnson1409 ($8.99 in chips) 
ildar87kzn: posts small blind $0.05
Tony Zhukov: posts big blind $0.10
*** HOLE CARDS ***
Himik30: folds 
Ifivecrypto: folds 
kjohnson1409: folds 
gresscrack: raises $0.20 to $0.30
ildar87kzn: folds 
Tony Zhukov: folds 
Uncalled bet ($0.20) returned to gresscrack
gresscrack collected $0.25 from pot
gresscrack: doesn't show hand 
*** SUMMARY ***
Total pot $0.25 | Rake $0 
Seat 1: gresscrack (button) collected ($0.25)
Seat 2: ildar87kzn (small blind) folded before Flop
Seat 3: Tony Zhukov (big blind) folded before Flop
Seat 4: Himik30 folded before Flop (didn't bet)
Seat 5: Ifivecrypto folded before Flop (didn't bet)
Seat 6: kjohnson1409 folded before Flop (didn't bet)



PokerStars Hand #222944347687:  Hold'em No Limit ($0.05/$0.10 USD) - 2021/01/23 23:43:18 ET
Table 'Malzovia III' 6-max Seat #2 is the button
Seat 1: gresscrack ($16.80 in chips) 
Seat 2: ildar87kzn ($12.52 in chips) 
Seat 3: Tony Zhukov ($10 in chips) 
Seat 4: Himik30 ($14.78 in chips) 
Seat 5: Ifivecrypto ($5.27 in chips) 
Seat 6: kjohnson1409 ($8.99 in chips) 
Tony Zhukov: posts small blind $0.05
Himik30: posts big blind $0.10
*** HOLE CARDS ***
Ifivecrypto: folds 
kjohnson1409: folds 
gresscrack: folds 
ildar87kzn: folds 
Tony Zhukov: raises $0.15 to $0.25
Himik30: folds 
Uncalled bet ($0.15) returned to Tony Zhukov
Tony Zhukov collected $0.20 from pot
*** SUMMARY ***
Total pot $0.20 | Rake $0 
Seat 1: gresscrack folded before Flop (didn't bet)
Seat 2: ildar87kzn (button) folded before Flop (didn't bet)
Seat 3: Tony Zhukov (small blind) collected ($0.20)
Seat 4: Himik30 (big blind) folded before Flop
Seat 5: Ifivecrypto folded before Flop (didn't bet)
Seat 6: kjohnson1409 folded before Flop (didn't bet)



PokerStars Hand #222944352008:  Hold'em No Limit ($0.05/$0.10 USD) - 2021/01/23 23:43:32 ET
Table 'Malzovia III' 6-max Seat #3 is the button
Seat 1: gresscrack ($16.80 in chips) 
Seat 2: ildar87kzn ($12.52 in chips) 
Seat 3: Tony Zhukov ($10.10 in chips) 
Seat 4: Himik30 ($14.68 in chips) 
Seat 5: Ifivecrypto ($5.27 in chips) 
Seat 6: kjohnson1409 ($8.99 in chips) 
Himik30: posts small blind $0.05
Ifivecrypto: posts big blind $0.10
*** HOLE CARDS ***
kjohnson1409: folds 
gresscrack: folds 
ildar87kzn: folds 
Tony Zhukov: folds 
Himik30: raises $0.20 to $0.30
Ifivecrypto: folds 
Uncalled bet ($0.20) returned to Himik30
Himik30 collected $0.20 from pot
Himik30: doesn't show hand 
*** SUMMARY ***
Total pot $0.20 | Rake $0 
Seat 1: gresscrack folded before Flop (didn't bet)
Seat 2: ildar87kzn folded before Flop (didn't bet)
Seat 3: Tony Zhukov (button) folded before Flop (didn't bet)
Seat 4: Himik30 (small blind) collected ($0.20)
Seat 5: Ifivecrypto (big blind) folded before Flop
Seat 6: kjohnson1409 folded before Flop (didn't bet)



PokerStars Hand #222944360317:  Hold'em No Limit ($0.05/$0.10 USD) - 2021/01/23 23:44:00 ET
Table 'Malzovia III' 6-max Seat #4 is the button
Seat 1: gresscrack ($16.80 in chips) 
Seat 2: ildar87kzn ($12.52 in chips) 
Seat 3: Tony Zhukov ($10.10 in chips) 
Seat 4: Himik30 ($14.78 in chips) 
Seat 5: Ifivecrypto ($5.17 in chips) 
Seat 6: kjohnson1409 ($8.99 in chips) 
Ifivecrypto: posts small blind $0.05
kjohnson1409: posts big blind $0.10
*** HOLE CARDS ***
gresscrack: folds 
ildar87kzn: folds 
Tony Zhukov: folds 
Himik30: folds 
gresscrack leaves the table
Ifivecrypto: calls $0.05
kjohnson1409: checks 
*** FLOP *** [3d 7c Ts]
Ifivecrypto: bets $0.10
kjohnson1409: folds 
Uncalled bet ($0.10) returned to Ifivecrypto
AvGeL joins the table at seat #1 
Ifivecrypto collected $0.19 from pot
Ifivecrypto: doesn't show hand 
*** SUMMARY ***
Total pot $0.20 | Rake $0.01 
Board [3d 7c Ts]
Seat 1: gresscrack folded before Flop (didn't bet)
Seat 2: ildar87kzn folded before Flop (didn't bet)
Seat 3: Tony Zhukov folded before Flop (didn't bet)
Seat 4: Himik30 (button) folded before Flop (didn't bet)
Seat 5: Ifivecrypto (small blind) collected ($0.19)
Seat 6: kjohnson1409 (big blind) folded on the Flop



PokerStars Hand #222944373742:  Hold'em No Limit ($0.05/$0.10 USD) - 2021/01/23 23:44:45 ET
Table 'Malzovia III' 6-max Seat #5 is the button
Seat 1: AvGeL ($13.22 in chips) 
Seat 2: ildar87kzn ($12.52 in chips) 
Seat 3: Tony Zhukov ($10.10 in chips) 
Seat 4: Himik30 ($14.78 in chips) 
Seat 5: Ifivecrypto ($5.26 in chips) 
Seat 6: kjohnson1409 ($8.89 in chips) 
kjohnson1409: posts small blind $0.05
AvGeL: posts big blind $0.10
*** HOLE CARDS ***
ildar87kzn: folds 
Tony Zhukov: folds 
Himik30: folds 
Ifivecrypto: folds 
kjohnson1409: raises $0.20 to $0.30
AvGeL: folds 
Uncalled bet ($0.20) returned to kjohnson1409
kjohnson1409 collected $0.20 from pot
kjohnson1409: doesn't show hand 
*** SUMMARY ***
Total pot $0.20 | Rake $0 
Seat 1: AvGeL (big blind) folded before Flop
Seat 2: ildar87kzn folded before Flop (didn't bet)
Seat 3: Tony Zhukov folded before Flop (didn't bet)
Seat 4: Himik30 folded before Flop (didn't bet)
Seat 5: Ifivecrypto (button) folded before Flop (didn't bet)
Seat 6: kjohnson1409 (small blind) collected ($0.20)



PokerStars Hand #222944383661:  Hold'em No Limit ($0.05/$0.10 USD) - 2021/01/23 23:45:18 ET
Table 'Malzovia III' 6-max Seat #6 is the button
Seat 1: AvGeL ($13.12 in chips) 
Seat 2: ildar87kzn ($12.52 in chips) 
Seat 3: Tony Zhukov ($10.10 in chips) 
Seat 4: Himik30 ($14.78 in chips) 
Seat 5: Ifivecrypto ($5.26 in chips) 
Seat 6: kjohnson1409 ($8.99 in chips) 
AvGeL: posts small blind $0.05
ildar87kzn: posts big blind $0.10
*** HOLE CARDS ***
Tony Zhukov: folds 
Himik30: folds 
Ifivecrypto: folds 
kjohnson1409: raises $0.20 to $0.30
AvGeL: folds 
ildar87kzn: folds 
Uncalled bet ($0.20) returned to kjohnson1409
kjohnson1409 collected $0.25 from pot
kjohnson1409: doesn't show hand 
*** SUMMARY ***
Total pot $0.25 | Rake $0 
Seat 1: AvGeL (small blind) folded before Flop
Seat 2: ildar87kzn (big blind) folded before Flop
Seat 3: Tony Zhukov folded before Flop (didn't bet)
Seat 4: Himik30 folded before Flop (didn't bet)
Seat 5: Ifivecrypto folded before Flop (didn't bet)
Seat 6: kjohnson1409 (button) collected ($0.25)



PokerStars Hand #222944391052:  Hold'em No Limit ($0.05/$0.10 USD) - 2021/01/23 23:45:43 ET
Table 'Malzovia III' 6-max Seat #1 is the button
Seat 1: AvGeL ($13.07 in chips) 
Seat 2: ildar87kzn ($12.42 in chips) 
Seat 3: Tony Zhukov ($10.10 in chips) 
Seat 4: Himik30 ($14.78 in chips) 
Seat 5: Ifivecrypto ($5.26 in chips) 
Seat 6: kjohnson1409 ($9.14 in chips) 
ildar87kzn: posts small blind $0.05
Tony Zhukov: posts big blind $0.10
*** HOLE CARDS ***
Himik30: folds 
Ifivecrypto: folds 
kjohnson1409: folds 
AvGeL: raises $0.10 to $0.20
ildar87kzn: folds 
Tony Zhukov: folds 
Uncalled bet ($0.10) returned to AvGeL
AvGeL collected $0.25 from pot
*** SUMMARY ***
Total pot $0.25 | Rake $0 
Seat 1: AvGeL (button) collected ($0.25)
Seat 2: ildar87kzn (small blind) folded before Flop
Seat 3: Tony Zhukov (big blind) folded before Flop
Seat 4: Himik30 folded before Flop (didn't bet)
Seat 5: Ifivecrypto folded before Flop (didn't bet)
Seat 6: kjohnson1409 folded before Flop (didn't bet)



PokerStars Hand #222944398691:  Hold'em No Limit ($0.05/$0.10 USD) - 2021/01/23 23:46:09 ET
Table 'Malzovia III' 6-max Seat #2 is the button
Seat 1: AvGeL ($13.22 in chips) 
Seat 2: ildar87kzn ($12.37 in chips) 
Seat 3: Tony Zhukov ($10 in chips) 
Seat 4: Himik30 ($14.78 in chips) 
Seat 5: Ifivecrypto ($5.26 in chips) 
Seat 6: kjohnson1409 ($9.14 in chips) 
Tony Zhukov: posts small blind $0.05
Himik30: posts big blind $0.10
*** HOLE CARDS ***
Ifivecrypto: folds 
kjohnson1409: folds 
AvGeL: folds 
ildar87kzn: raises $0.20 to $0.30
Tony Zhukov: folds 
Himik30: folds 
Uncalled bet ($0.20) returned to ildar87kzn
ildar87kzn collected $0.25 from pot
ildar87kzn: doesn't show hand 
*** SUMMARY ***
Total pot $0.25 | Rake $0 
Seat 1: AvGeL folded before Flop (didn't bet)
Seat 2: ildar87kzn (button) collected ($0.25)
Seat 3: Tony Zhukov (small blind) folded before Flop
Seat 4: Himik30 (big blind) folded before Flop
Seat 5: Ifivecrypto folded before Flop (didn't bet)
Seat 6: kjohnson1409 folded before Flop (didn't bet)



PokerStars Hand #222944407210:  Hold'em No Limit ($0.05/$0.10 USD) - 2021/01/23 23:46:38 ET
Table 'Malzovia III' 6-max Seat #3 is the button
Seat 1: AvGeL ($13.22 in chips) 
Seat 2: ildar87kzn ($12.52 in chips) 
Seat 3: Tony Zhukov ($10 in chips) 
Seat 4: Himik30 ($14.68 in chips) 
Seat 5: Ifivecrypto ($5.26 in chips) 
Seat 6: kjohnson1409 ($9.14 in chips) 
Himik30: posts small blind $0.05
Ifivecrypto: posts big blind $0.10
*** HOLE CARDS ***
kjohnson1409: folds 
AvGeL: raises $0.20 to $0.30
ildar87kzn: folds 
Tony Zhukov: folds 
Himik30: folds 
Ifivecrypto: folds 
Uncalled bet ($0.20) returned to AvGeL
AvGeL collected $0.25 from pot
*** SUMMARY ***
Total pot $0.25 | Rake $0 
Seat 1: AvGeL collected ($0.25)
Seat 2: ildar87kzn folded before Flop (didn't bet)
Seat 3: Tony Zhukov (button) folded before Flop (didn't bet)
Seat 4: Himik30 (small blind) folded before Flop
Seat 5: Ifivecrypto (big blind) folded before Flop
Seat 6: kjohnson1409 folded before Flop (didn't bet)



PokerStars Hand #222944414118:  Hold'em No Limit ($0.05/$0.10 USD) - 2021/01/23 23:47:01 ET
Table 'Malzovia III' 6-max Seat #4 is the button
Seat 1: AvGeL ($13.37 in chips) 
Seat 2: ildar87kzn ($12.52 in chips) 
Seat 3: Tony Zhukov ($10 in chips) 
Seat 4: Himik30 ($14.63 in chips) 
Seat 5: Ifivecrypto ($5.16 in chips) 
Seat 6: kjohnson1409 ($9.14 in chips) 
Ifivecrypto: posts small blind $0.05
kjohnson1409: posts big blind $0.10
*** HOLE CARDS ***
AvGeL: raises $0.20 to $0.30
ildar87kzn: folds 
Tony Zhukov: folds 
Himik30: folds 
Ifivecrypto: calls $0.25
kjohnson1409: folds 
*** FLOP *** [4d 6d 2d]
Ifivecrypto: checks 
AvGeL: bets $0.50
Ifivecrypto: folds 
Uncalled bet ($0.50) returned to AvGeL
AvGeL collected $0.67 from pot
*** SUMMARY ***
Total pot $0.70 | Rake $0.03 
Board [4d 6d 2d]
Seat 1: AvGeL collected ($0.67)
Seat 2: ildar87kzn folded before Flop (didn't bet)
Seat 3: Tony Zhukov folded before Flop (didn't bet)
Seat 4: Himik30 (button) folded before Flop (didn't bet)
Seat 5: Ifivecrypto (small blind) folded on the Flop
Seat 6: kjohnson1409 (big blind) folded before Flop



PokerStars Hand #222944424786:  Hold'em No Limit ($0.05/$0.10 USD) - 2021/01/23 23:47:37 ET
Table 'Malzovia III' 6-max Seat #5 is the button
Seat 1: AvGeL ($13.74 in chips) 
Seat 2: ildar87kzn ($12.52 in chips) 
Seat 3: Tony Zhukov ($10 in chips) 
Seat 4: Himik30 ($14.63 in chips) 
Seat 5: Ifivecrypto ($4.86 in chips) 
Seat 6: kjohnson1409 ($9.04 in chips) 
kjohnson1409: posts small blind $0.05
AvGeL: posts big blind $0.10
*** HOLE CARDS ***
ildar87kzn: folds 
Tony Zhukov: folds 
Himik30: raises $0.15 to $0.25
Ifivecrypto: calls $0.25
kjohnson1409: raises $0.15 to $0.40
AvGeL: raises $1.30 to $1.70
Himik30: folds 
Ifivecrypto: calls $1.45
kjohnson1409: calls $1.30
*** FLOP *** [9s Qh Qc]
kjohnson1409: bets $3.83
AvGeL: calls $3.83
Ifivecrypto: folds 
*** TURN *** [9s Qh Qc] [8d]
kjohnson1409: bets $3.51 and is all-in
AvGeL: calls $3.51
*** RIVER *** [9s Qh Qc 8d] [Jd]
*** SHOW DOWN ***
kjohnson1409: shows [Qd Kh] (three of a kind, Queens)
AvGeL: shows [Ah As] (two pair, Aces and Queens)
kjohnson1409 collected $19.13 from pot
*** SUMMARY ***
Total pot $20.03 | Rake $0.90 
Board [9s Qh Qc 8d Jd]
Seat 1: AvGeL (big blind) showed [Ah As] and lost with two pair, Aces and Queens
Seat 2: ildar87kzn folded before Flop (didn't bet)
Seat 3: Tony Zhukov folded before Flop (didn't bet)
Seat 4: Himik30 folded before Flop
Seat 5: Ifivecrypto (button) folded on the Flop
Seat 6: kjohnson1409 (small blind) showed [Qd Kh] and won ($19.13) with three of a kind, Queens



PokerStars Hand #222944445209:  Hold'em No Limit ($0.05/$0.10 USD) - 2021/01/23 23:48:46 ET
Table 'Malzovia III' 6-max Seat #6 is the button
Seat 1: AvGeL ($10 in chips) 
Seat 2: ildar87kzn ($12.52 in chips) 
Seat 3: Tony Zhukov ($10 in chips) 
Seat 4: Himik30 ($14.38 in chips) 
Seat 5: Ifivecrypto ($3.16 in chips) 
Seat 6: kjohnson1409 ($19.13 in chips) 
AvGeL: posts small blind $0.05
ildar87kzn: posts big blind $0.10
*** HOLE CARDS ***
Tony Zhukov: folds 
Himik30: folds 
Ifivecrypto: folds 
kjohnson1409: folds 
AvGeL: folds 
Uncalled bet ($0.05) returned to ildar87kzn
ildar87kzn collected $0.10 from pot
ildar87kzn: doesn't show hand 
*** SUMMARY ***
Total pot $0.10 | Rake $0 
Seat 1: AvGeL (small blind) folded before Flop
Seat 2: ildar87kzn (big blind) collected ($0.10)
Seat 3: Tony Zhukov folded before Flop (didn't bet)
Seat 4: Himik30 folded before Flop (didn't bet)
Seat 5: Ifivecrypto folded before Flop (didn't bet)
Seat 6: kjohnson1409 (button) folded before Flop (didn't bet)



PokerStars Hand #222944449328:  Hold'em No Limit ($0.05/$0.10 USD) - 2021/01/23 23:49:00 ET
Table 'Malzovia III' 6-max Seat #1 is the button
Seat 1: AvGeL ($10 in chips) 
Seat 2: ildar87kzn ($12.57 in chips) 
Seat 3: Tony Zhukov ($10 in chips) 
Seat 4: Himik30 ($14.38 in chips) 
Seat 5: Ifivecrypto ($3.16 in chips) 
Seat 6: kjohnson1409 ($19.13 in chips) 
ildar87kzn: posts small blind $0.05
Tony Zhukov: posts big blind $0.10
*** HOLE CARDS ***
Himik30: folds 
Himik30 leaves the table
Ifivecrypto: folds 
kjohnson1409: raises $0.20 to $0.30
AvGeL: folds 
ildar87kzn: folds 
Tony Zhukov: folds 
Uncalled bet ($0.20) returned to kjohnson1409
kjohnson1409 collected $0.25 from pot
kjohnson1409: doesn't show hand 
*** SUMMARY ***
Total pot $0.25 | Rake $0 
Seat 1: AvGeL (button) folded before Flop (didn't bet)
Seat 2: ildar87kzn (small blind) folded before Flop
Seat 3: Tony Zhukov (big blind) folded before Flop
Seat 4: Himik30 folded before Flop (didn't bet)
Seat 5: Ifivecrypto folded before Flop (didn't bet)
Seat 6: kjohnson1409 collected ($0.25)



PokerStars Hand #222944454404:  Hold'em No Limit ($0.05/$0.10 USD) - 2021/01/23 23:49:17 ET
Table 'Malzovia III' 6-max Seat #2 is the button
Seat 1: AvGeL ($10 in chips) 
Seat 2: ildar87kzn ($12.52 in chips) 
Seat 3: Tony Zhukov ($10 in chips) 
Seat 5: Ifivecrypto ($3.16 in chips) 
Seat 6: kjohnson1409 ($19.28 in chips) 
Tony Zhukov: posts small blind $0.05
Ifivecrypto: posts big blind $0.10
*** HOLE CARDS ***
kjohnson1409: folds 
AvGeL: raises $0.15 to $0.25
ildar87kzn: raises $0.65 to $0.90
Tony Zhukov: raises $1.25 to $2.15
Ifivecrypto: folds 
AvGeL: folds 
ildar87kzn: folds 
Uncalled bet ($1.25) returned to Tony Zhukov
Tony Zhukov collected $2.15 from pot
*** SUMMARY ***
Total pot $2.15 | Rake $0 
Seat 1: AvGeL folded before Flop
Seat 2: ildar87kzn (button) folded before Flop
Seat 3: Tony Zhukov (small blind) collected ($2.15)
Seat 5: Ifivecrypto (big blind) folded before Flop
Seat 6: kjohnson1409 folded before Flop (didn't bet)



PokerStars Hand #222944469023:  Hold'em No Limit ($0.05/$0.10 USD) - 2021/01/23 23:50:07 ET
Table 'Malzovia III' 6-max Seat #3 is the button
Seat 1: AvGeL ($10 in chips) 
Seat 2: ildar87kzn ($11.62 in chips) 
Seat 3: Tony Zhukov ($11.25 in chips) 
Seat 5: Ifivecrypto ($3.06 in chips) 
Seat 6: kjohnson1409 ($19.28 in chips) 
Ifivecrypto: posts small blind $0.05
kjohnson1409: posts big blind $0.10
*** HOLE CARDS ***
moopete joins the table at seat #4 
AvGeL has timed out
AvGeL: folds 
ildar87kzn: folds 
Tony Zhukov: folds 
Ifivecrypto: folds 
Uncalled bet ($0.05) returned to kjohnson1409
kjohnson1409 collected $0.10 from pot
kjohnson1409: doesn't show hand 
*** SUMMARY ***
Total pot $0.10 | Rake $0 
Seat 1: AvGeL folded before Flop (didn't bet)
Seat 2: ildar87kzn folded before Flop (didn't bet)
Seat 3: Tony Zhukov (button) folded before Flop (didn't bet)
Seat 5: Ifivecrypto (small blind) folded before Flop
Seat 6: kjohnson1409 (big blind) collected ($0.10)



PokerStars Hand #222944473147:  Hold'em No Limit ($0.05/$0.10 USD) - 2021/01/23 23:50:21 ET
Table 'Malzovia III' 6-max Seat #5 is the button
Seat 1: AvGeL ($10 in chips) 
Seat 2: ildar87kzn ($11.62 in chips) 
Seat 3: Tony Zhukov ($11.25 in chips) 
Seat 4: moopete ($10 in chips) 
Seat 5: Ifivecrypto ($3.01 in chips) 
Seat 6: kjohnson1409 ($19.33 in chips) 
kjohnson1409: posts small blind $0.05
AvGeL: posts big blind $0.10
moopete: posts big blind $0.10
*** HOLE CARDS ***
ildar87kzn: folds 
Tony Zhukov: raises $0.30 to $0.40
moopete: folds 
Ifivecrypto: calls $0.40
kjohnson1409: folds 
AvGeL: folds 
*** FLOP *** [5h 9c 9h]
Tony Zhukov: bets $0.55
Ifivecrypto: folds 
Uncalled bet ($0.55) returned to Tony Zhukov
Tony Zhukov collected $1 from pot
*** SUMMARY ***
Total pot $1.05 | Rake $0.05 
Board [5h 9c 9h]
Seat 1: AvGeL (big blind) folded before Flop
Seat 2: ildar87kzn folded before Flop (didn't bet)
Seat 3: Tony Zhukov collected ($1)
Seat 4: moopete folded before Flop (didn't bet)
Seat 5: Ifivecrypto (button) folded on the Flop
Seat 6: kjohnson1409 (small blind) folded before Flop



PokerStars Hand #222944485823:  Hold'em No Limit ($0.05/$0.10 USD) - 2021/01/23 23:51:04 ET
Table 'Malzovia III' 6-max Seat #6 is the button
Seat 1: AvGeL ($10 in chips) 
Seat 2: ildar87kzn ($11.62 in chips) 
Seat 3: Tony Zhukov ($11.85 in chips) 
Seat 4: moopete ($9.90 in chips) 
Seat 5: Ifivecrypto ($2.61 in chips) 
Seat 6: kjohnson1409 ($19.28 in chips) 
AvGeL: posts small blind $0.05
ildar87kzn: posts big blind $0.10
*** HOLE CARDS ***
Tony Zhukov: raises $0.20 to $0.30
moopete: folds 
Ifivecrypto: folds 
kjohnson1409: folds 
AvGeL: folds 
ildar87kzn: folds 
Uncalled bet ($0.20) returned to Tony Zhukov
Tony Zhukov collected $0.25 from pot
*** SUMMARY ***
Total pot $0.25 | Rake $0 
Seat 1: AvGeL (small blind) folded before Flop
Seat 2: ildar87kzn (big blind) folded before Flop
Seat 3: Tony Zhukov collected ($0.25)
Seat 4: moopete folded before Flop (didn't bet)
Seat 5: Ifivecrypto folded before Flop (didn't bet)
Seat 6: kjohnson1409 (button) folded before Flop (didn't bet)



PokerStars Hand #222944490079:  Hold'em No Limit ($0.05/$0.10 USD) - 2021/01/23 23:51:19 ET
Table 'Malzovia III' 6-max Seat #1 is the button
Seat 1: AvGeL ($10 in chips) 
Seat 2: ildar87kzn ($11.52 in chips) 
Seat 3: Tony Zhukov ($12 in chips) 
Seat 4: moopete ($9.90 in chips) 
Seat 5: Ifivecrypto ($2.61 in chips) 
Seat 6: kjohnson1409 ($19.28 in chips) 
ildar87kzn: posts small blind $0.05
Tony Zhukov: posts big blind $0.10
*** HOLE CARDS ***
moopete has timed out
moopete: folds 
Ifivecrypto: raises $2.51 to $2.61 and is all-in
kjohnson1409: folds 
AvGeL: folds 
ildar87kzn: folds 
Tony Zhukov: folds 
Uncalled bet ($2.51) returned to Ifivecrypto
Ifivecrypto collected $0.25 from pot
Ifivecrypto: doesn't show hand 
*** SUMMARY ***
Total pot $0.25 | Rake $0 
Seat 1: AvGeL (button) folded before Flop (didn't bet)
Seat 2: ildar87kzn (small blind) folded before Flop
Seat 3: Tony Zhukov (big blind) folded before Flop
Seat 4: moopete folded before Flop (didn't bet)
Seat 5: Ifivecrypto collected ($0.25)
Seat 6: kjohnson1409 folded before Flop (didn't bet)



PokerStars Hand #222944496486:  Hold'em No Limit ($0.05/$0.10 USD) - 2021/01/23 23:51:41 ET
Table 'Malzovia III' 6-max Seat #2 is the button
Seat 1: AvGeL ($10 in chips) 
Seat 2: ildar87kzn ($11.47 in chips) 
Seat 3: Tony Zhukov ($11.90 in chips) 
Seat 4: moopete ($9.90 in chips) 
Seat 5: Ifivecrypto ($2.76 in chips) 
Seat 6: kjohnson1409 ($19.28 in chips) 
Tony Zhukov: posts small blind $0.05
moopete: posts big blind $0.10
*** HOLE CARDS ***
Ifivecrypto: folds 
kjohnson1409: folds 
AvGeL: folds 
ildar87kzn: raises $0.20 to $0.30
Tony Zhukov: folds 
moopete: folds 
Uncalled bet ($0.20) returned to ildar87kzn
ildar87kzn collected $0.25 from pot
ildar87kzn: doesn't show hand 
*** SUMMARY ***
Total pot $0.25 | Rake $0 
Seat 1: AvGeL folded before Flop (didn't bet)
Seat 2: ildar87kzn (button) collected ($0.25)
Seat 3: Tony Zhukov (small blind) folded before Flop
Seat 4: moopete (big blind) folded before Flop
Seat 5: Ifivecrypto folded before Flop (didn't bet)
Seat 6: kjohnson1409 folded before Flop (didn't bet)



PokerStars Hand #222944503514:  Hold'em No Limit ($0.05/$0.10 USD) - 2021/01/23 23:52:06 ET
Table 'Malzovia III' 6-max Seat #3 is the button
Seat 1: AvGeL ($10 in chips) 
Seat 2: ildar87kzn ($11.62 in chips) 
Seat 3: Tony Zhukov ($11.85 in chips) 
Seat 4: moopete ($9.80 in chips) 
Seat 5: Ifivecrypto ($2.76 in chips) 
Seat 6: kjohnson1409 ($19.28 in chips) 
moopete: posts small blind $0.05
Ifivecrypto: posts big blind $0.10
*** HOLE CARDS ***
kjohnson1409: folds 
AvGeL: folds 
ildar87kzn: folds 
Tony Zhukov: raises $0.15 to $0.25
moopete: raises $0.55 to $0.80
Ifivecrypto: raises $1.96 to $2.76 and is all-in
Tony Zhukov: folds 
moopete: folds 
Uncalled bet ($1.96) returned to Ifivecrypto
Ifivecrypto collected $1.85 from pot
Ifivecrypto: doesn't show hand 
*** SUMMARY ***
Total pot $1.85 | Rake $0 
Seat 1: AvGeL folded before Flop (didn't bet)
Seat 2: ildar87kzn folded before Flop (didn't bet)
Seat 3: Tony Zhukov (button) folded before Flop
Seat 4: moopete (small blind) folded before Flop
Seat 5: Ifivecrypto (big blind) collected ($1.85)
Seat 6: kjohnson1409 folded before Flop (didn't bet)



PokerStars Hand #222944511931:  Hold'em No Limit ($0.05/$0.10 USD) - 2021/01/23 23:52:34 ET
Table 'Malzovia III' 6-max Seat #4 is the button
Seat 1: AvGeL ($10 in chips) 
Seat 2: ildar87kzn ($11.62 in chips) 
Seat 3: Tony Zhukov ($11.60 in chips) 
Seat 4: moopete ($9 in chips) 
Seat 5: Ifivecrypto ($3.81 in chips) 
Seat 6: kjohnson1409 ($19.28 in chips) 
Ifivecrypto: posts small blind $0.05
kjohnson1409: posts big blind $0.10
*** HOLE CARDS ***
AvGeL: folds 
ildar87kzn: folds 
Tony Zhukov: folds 
moopete: raises $0.40 to $0.50
Ifivecrypto: folds 
kjohnson1409: calls $0.40
*** FLOP *** [3c 6s 3s]
kjohnson1409: checks 
moopete: bets $1
kjohnson1409: folds 
Uncalled bet ($1) returned to moopete
moopete collected $1 from pot
moopete: doesn't show hand 
*** SUMMARY ***
Total pot $1.05 | Rake $0.05 
Board [3c 6s 3s]
Seat 1: AvGeL folded before Flop (didn't bet)
Seat 2: ildar87kzn folded before Flop (didn't bet)
Seat 3: Tony Zhukov folded before Flop (didn't bet)
Seat 4: moopete (button) collected ($1)
Seat 5: Ifivecrypto (small blind) folded before Flop
Seat 6: kjohnson1409 (big blind) folded on the Flop



PokerStars Hand #222944526045:  Hold'em No Limit ($0.05/$0.10 USD) - 2021/01/23 23:53:23 ET
Table 'Malzovia III' 6-max Seat #5 is the button
Seat 1: AvGeL ($10 in chips) 
Seat 2: ildar87kzn ($11.62 in chips) 
Seat 3: Tony Zhukov ($11.60 in chips) 
Seat 4: moopete ($9.50 in chips) 
Seat 5: Ifivecrypto ($3.76 in chips) 
Seat 6: kjohnson1409 ($18.78 in chips) 
kjohnson1409: posts small blind $0.05
AvGeL: posts big blind $0.10
*** HOLE CARDS ***
ildar87kzn: folds 
Tony Zhukov: raises $0.20 to $0.30
moopete: folds 
Ifivecrypto: folds 
kjohnson1409: folds 
AvGeL: folds 
Uncalled bet ($0.20) returned to Tony Zhukov
Tony Zhukov collected $0.25 from pot
*** SUMMARY ***
Total pot $0.25 | Rake $0 
Seat 1: AvGeL (big blind) folded before Flop
Seat 2: ildar87kzn folded before Flop (didn't bet)
Seat 3: Tony Zhukov collected ($0.25)
Seat 4: moopete folded before Flop (didn't bet)
Seat 5: Ifivecrypto (button) folded before Flop (didn't bet)
Seat 6: kjohnson1409 (small blind) folded before Flop



PokerStars Hand #222944532110:  Hold'em No Limit ($0.05/$0.10 USD) - 2021/01/23 23:53:44 ET
Table 'Malzovia III' 6-max Seat #6 is the button
Seat 1: AvGeL ($10 in chips) 
Seat 2: ildar87kzn ($11.62 in chips) 
Seat 3: Tony Zhukov ($11.75 in chips) 
Seat 4: moopete ($9.50 in chips) 
Seat 5: Ifivecrypto ($3.76 in chips) 
Seat 6: kjohnson1409 ($18.73 in chips) 
AvGeL: posts small blind $0.05
ildar87kzn: posts big blind $0.10
*** HOLE CARDS ***
Tony Zhukov: folds 
moopete: folds 
Ifivecrypto: folds 
Tony Zhukov leaves the table
kjohnson1409: raises $0.20 to $0.30
AvGeL: folds 
ildar87kzn: raises $0.70 to $1
kjohnson1409: folds 
Uncalled bet ($0.70) returned to ildar87kzn
ildar87kzn collected $0.65 from pot
ildar87kzn: doesn't show hand 
*** SUMMARY ***
Total pot $0.65 | Rake $0 
Seat 1: AvGeL (small blind) folded before Flop
Seat 2: ildar87kzn (big blind) collected ($0.65)
Seat 3: Tony Zhukov folded before Flop (didn't bet)
Seat 4: moopete folded before Flop (didn't bet)
Seat 5: Ifivecrypto folded before Flop (didn't bet)
Seat 6: kjohnson1409 (button) folded before Flop



PokerStars Hand #222944542379:  Hold'em No Limit ($0.05/$0.10 USD) - 2021/01/23 23:54:19 ET
Table 'Malzovia III' 6-max Seat #1 is the button
Seat 1: AvGeL ($10 in chips) 
Seat 2: ildar87kzn ($11.97 in chips) 
Seat 4: moopete ($9.50 in chips) 
Seat 5: Ifivecrypto ($3.76 in chips) 
Seat 6: kjohnson1409 ($18.43 in chips) 
ildar87kzn: posts small blind $0.05
moopete: posts big blind $0.10
*** HOLE CARDS ***
Ifivecrypto: folds 
kjohnson1409: raises $0.20 to $0.30
AvGeL: folds 
ildar87kzn: folds 
moopete: raises $0.70 to $1
kjohnson1409: calls $0.70
*** FLOP *** [5h 6h 7s]
moopete: bets $2
kjohnson1409: folds 
Uncalled bet ($2) returned to moopete
moopete collected $1.96 from pot
moopete: doesn't show hand 
*** SUMMARY ***
Total pot $2.05 | Rake $0.09 
Board [5h 6h 7s]
Seat 1: AvGeL (button) folded before Flop (didn't bet)
Seat 2: ildar87kzn (small blind) folded before Flop
Seat 4: moopete (big blind) collected ($1.96)
Seat 5: Ifivecrypto folded before Flop (didn't bet)
Seat 6: kjohnson1409 folded on the Flop



PokerStars Hand #222944560167:  Hold'em No Limit ($0.05/$0.10 USD) - 2021/01/23 23:55:09 ET
Table 'Malzovia III' 6-max Seat #2 is the button
Seat 1: AvGeL ($10 in chips) 
Seat 2: ildar87kzn ($11.92 in chips) 
Seat 4: moopete ($10.46 in chips) 
Seat 5: Ifivecrypto ($3.76 in chips) 
Seat 6: kjohnson1409 ($17.43 in chips) 
moopete: posts small blind $0.05
Ifivecrypto: posts big blind $0.10
*** HOLE CARDS ***
kjohnson1409: folds 
AvGeL: folds 
ildar87kzn: raises $0.20 to $0.30
moopete: folds 
Ger Cortes joins the table at seat #3 
Ifivecrypto: folds 
Uncalled bet ($0.20) returned to ildar87kzn
ildar87kzn collected $0.25 from pot
ildar87kzn: doesn't show hand 
*** SUMMARY ***
Total pot $0.25 | Rake $0 
Seat 1: AvGeL folded before Flop (didn't bet)
Seat 2: ildar87kzn (button) collected ($0.25)
Seat 4: moopete (small blind) folded before Flop
Seat 5: Ifivecrypto (big blind) folded before Flop
Seat 6: kjohnson1409 folded before Flop (didn't bet)



PokerStars Hand #222944566654:  Hold'em No Limit ($0.05/$0.10 USD) - 2021/01/23 23:55:39 ET
Table 'Malzovia III' 6-max Seat #4 is the button
Seat 1: AvGeL ($10 in chips) 
Seat 2: ildar87kzn ($12.07 in chips) 
Seat 4: moopete ($10.41 in chips) 
Seat 5: Ifivecrypto ($3.66 in chips) 
Seat 6: kjohnson1409 ($17.43 in chips) 
Ifivecrypto: posts small blind $0.05
kjohnson1409: posts big blind $0.10
Ger Cortes: sits out 
*** HOLE CARDS ***
AvGeL: folds 
ildar87kzn: folds 
moopete: folds 
Ifivecrypto: folds 
Uncalled bet ($0.05) returned to kjohnson1409
kjohnson1409 collected $0.10 from pot
kjohnson1409: doesn't show hand 
*** SUMMARY ***
Total pot $0.10 | Rake $0 
Seat 1: AvGeL folded before Flop (didn't bet)
Seat 2: ildar87kzn folded before Flop (didn't bet)
Seat 4: moopete (button) folded before Flop (didn't bet)
Seat 5: Ifivecrypto (small blind) folded before Flop
Seat 6: kjohnson1409 (big blind) collected ($0.10)



PokerStars Hand #222944569807:  Hold'em No Limit ($0.05/$0.10 USD) - 2021/01/23 23:55:54 ET
Table 'Malzovia III' 6-max Seat #5 is the button
Seat 1: AvGeL ($10 in chips) 
Seat 2: ildar87kzn ($12.07 in chips) 
Seat 4: moopete ($10.41 in chips) 
Seat 5: Ifivecrypto ($3.61 in chips) 
Seat 6: kjohnson1409 ($17.48 in chips) 
kjohnson1409: posts small blind $0.05
AvGeL: posts big blind $0.10
Ger Cortes: sits out 
*** HOLE CARDS ***
ildar87kzn: folds 
moopete: folds 
Ifivecrypto: folds 
kjohnson1409: raises $0.20 to $0.30
AvGeL: calls $0.20
*** FLOP *** [5c 4s Jd]
kjohnson1409: checks 
AvGeL: bets $0.29
kjohnson1409: folds 
Uncalled bet ($0.29) returned to AvGeL
AvGeL collected $0.57 from pot
*** SUMMARY ***
Total pot $0.60 | Rake $0.03 
Board [5c 4s Jd]
Seat 1: AvGeL (big blind) collected ($0.57)
Seat 2: ildar87kzn folded before Flop (didn't bet)
Seat 4: moopete folded before Flop (didn't bet)
Seat 5: Ifivecrypto (button) folded before Flop (didn't bet)
Seat 6: kjohnson1409 (small blind) folded on the Flop



PokerStars Hand #222944583442:  Hold'em No Limit ($0.05/$0.10 USD) - 2021/01/23 23:56:56 ET
Table 'Malzovia III' 6-max Seat #6 is the button
Seat 1: AvGeL ($10.27 in chips) 
Seat 2: ildar87kzn ($12.07 in chips) 
Seat 4: moopete ($10.41 in chips) 
Seat 5: Ifivecrypto ($3.61 in chips) 
Seat 6: kjohnson1409 ($17.18 in chips) 
AvGeL: posts small blind $0.05
ildar87kzn: posts big blind $0.10
Ger Cortes: sits out 
*** HOLE CARDS ***
moopete: raises $0.40 to $0.50
Ifivecrypto: raises $3.11 to $3.61 and is all-in
kjohnson1409: folds 
AvGeL: folds 
ildar87kzn: folds 
moopete: folds 
Uncalled bet ($3.11) returned to Ifivecrypto
Ifivecrypto collected $1.15 from pot
Ifivecrypto: doesn't show hand 
*** SUMMARY ***
Total pot $1.15 | Rake $0 
Seat 1: AvGeL (small blind) folded before Flop
Seat 2: ildar87kzn (big blind) folded before Flop
Seat 4: moopete folded before Flop
Seat 5: Ifivecrypto collected ($1.15)
Seat 6: kjohnson1409 (button) folded before Flop (didn't bet)



PokerStars Hand #222944588417:  Hold'em No Limit ($0.05/$0.10 USD) - 2021/01/23 23:57:19 ET
Table 'Malzovia III' 6-max Seat #1 is the button
Seat 1: AvGeL ($10.22 in chips) 
Seat 2: ildar87kzn ($11.97 in chips) 
Seat 3: Ger Cortes ($10 in chips) 
Seat 4: moopete ($9.91 in chips) 
Seat 5: Ifivecrypto ($4.26 in chips) 
Seat 6: kjohnson1409 ($17.18 in chips) 
ildar87kzn: posts small blind $0.05
Ger Cortes: posts big blind $0.10
*** HOLE CARDS ***
moopete: folds 
Ifivecrypto: folds 
kjohnson1409: folds 
AvGeL: raises $0.10 to $0.20
ildar87kzn: folds 
Ger Cortes: folds 
Uncalled bet ($0.10) returned to AvGeL
AvGeL collected $0.25 from pot
*** SUMMARY ***
Total pot $0.25 | Rake $0 
Seat 1: AvGeL (button) collected ($0.25)
Seat 2: ildar87kzn (small blind) folded before Flop
Seat 3: Ger Cortes (big blind) folded before Flop
Seat 4: moopete folded before Flop (didn't bet)
Seat 5: Ifivecrypto folded before Flop (didn't bet)
Seat 6: kjohnson1409 folded before Flop (didn't bet)



PokerStars Hand #222944592667:  Hold'em No Limit ($0.05/$0.10 USD) - 2021/01/23 23:57:39 ET
Table 'Malzovia III' 6-max Seat #2 is the button
Seat 1: AvGeL ($10.37 in chips) 
Seat 2: ildar87kzn ($11.92 in chips) 
Seat 3: Ger Cortes ($10 in chips) 
Seat 4: moopete ($9.91 in chips) 
Seat 5: Ifivecrypto ($4.26 in chips) 
Seat 6: kjohnson1409 ($17.18 in chips) 
Ger Cortes: posts small blind $0.05
moopete: posts big blind $0.10
*** HOLE CARDS ***
Ifivecrypto: folds 
kjohnson1409: raises $0.20 to $0.30
AvGeL: folds 
ildar87kzn: folds 
Ger Cortes: folds 
moopete: raises $0.70 to $1
kjohnson1409: calls $0.70
*** FLOP *** [4h 9s Qh]
moopete: bets $2
kjohnson1409: folds 
Uncalled bet ($2) returned to moopete
moopete collected $1.96 from pot
moopete: doesn't show hand 
*** SUMMARY ***
Total pot $2.05 | Rake $0.09 
Board [4h 9s Qh]
Seat 1: AvGeL folded before Flop (didn't bet)
Seat 2: ildar87kzn (button) folded before Flop (didn't bet)
Seat 3: Ger Cortes (small blind) folded before Flop
Seat 4: moopete (big blind) collected ($1.96)
Seat 5: Ifivecrypto folded before Flop (didn't bet)
Seat 6: kjohnson1409 folded on the Flop



PokerStars Hand #222944602469:  Hold'em No Limit ($0.05/$0.10 USD) - 2021/01/23 23:58:24 ET
Table 'Malzovia III' 6-max Seat #3 is the button
Seat 1: AvGeL ($10.37 in chips) 
Seat 2: ildar87kzn ($11.92 in chips) 
Seat 3: Ger Cortes ($10 in chips) 
Seat 4: moopete ($10.87 in chips) 
Seat 5: Ifivecrypto ($4.26 in chips) 
Seat 6: kjohnson1409 ($16.18 in chips) 
moopete: posts small blind $0.05
Ifivecrypto: posts big blind $0.10
*** HOLE CARDS ***
kjohnson1409: folds 
AvGeL: folds 
ildar87kzn: folds 
Ger Cortes: folds 
moopete: folds 
Uncalled bet ($0.05) returned to Ifivecrypto
moopete leaves the table
Ifivecrypto collected $0.10 from pot
Ifivecrypto: doesn't show hand 
*** SUMMARY ***
Total pot $0.10 | Rake $0 
Seat 1: AvGeL folded before Flop (didn't bet)
Seat 2: ildar87kzn folded before Flop (didn't bet)
Seat 3: Ger Cortes (button) folded before Flop (didn't bet)
Seat 4: moopete (small blind) folded before Flop
Seat 5: Ifivecrypto (big blind) collected ($0.10)
Seat 6: kjohnson1409 folded before Flop (didn't bet)



PokerStars Hand #222944605008:  Hold'em No Limit ($0.05/$0.10 USD) - 2021/01/23 23:58:36 ET
Table 'Malzovia III' 6-max Seat #5 is the button
Seat 1: AvGeL ($10.37 in chips) 
Seat 2: ildar87kzn ($11.92 in chips) 
Seat 3: Ger Cortes ($10 in chips) 
Seat 5: Ifivecrypto ($4.31 in chips) 
Seat 6: kjohnson1409 ($16.18 in chips) 
kjohnson1409: posts small blind $0.05
AvGeL: posts big blind $0.10
*** HOLE CARDS ***
ildar87kzn: folds 
Ger Cortes: folds 
Ifivecrypto: folds 
Renzo1529 joins the table at seat #4 
kjohnson1409: calls $0.05
AvGeL: checks 
*** FLOP *** [Ts Ah Ac]
kjohnson1409: bets $0.10
AvGeL: folds 
Uncalled bet ($0.10) returned to kjohnson1409
kjohnson1409 collected $0.19 from pot
kjohnson1409: doesn't show hand 
*** SUMMARY ***
Total pot $0.20 | Rake $0.01 
Board [Ts Ah Ac]
Seat 1: AvGeL (big blind) folded on the Flop
Seat 2: ildar87kzn folded before Flop (didn't bet)
Seat 3: Ger Cortes folded before Flop (didn't bet)
Seat 5: Ifivecrypto (button) folded before Flop (didn't bet)
Seat 6: kjohnson1409 (small blind) collected ($0.19)



PokerStars Hand #222944612755:  Hold'em No Limit ($0.05/$0.10 USD) - 2021/01/23 23:59:11 ET
Table 'Malzovia III' 6-max Seat #6 is the button
Seat 1: AvGeL ($10.27 in chips) 
Seat 2: ildar87kzn ($11.92 in chips) 
Seat 3: Ger Cortes ($10 in chips) 
Seat 5: Ifivecrypto ($4.31 in chips) 
Seat 6: kjohnson1409 ($16.27 in chips) 
AvGeL: posts small blind $0.05
ildar87kzn: posts big blind $0.10
Renzo1529: sits out 
*** HOLE CARDS ***
Ger Cortes: folds 
Ifivecrypto: folds 
kjohnson1409: folds 
AvGeL: folds 
Uncalled bet ($0.05) returned to ildar87kzn
ildar87kzn collected $0.10 from pot
ildar87kzn: doesn't show hand 
*** SUMMARY ***
Total pot $0.10 | Rake $0 
Seat 1: AvGeL (small blind) folded before Flop
Seat 2: ildar87kzn (big blind) collected ($0.10)
Seat 3: Ger Cortes folded before Flop (didn't bet)
Seat 5: Ifivecrypto folded before Flop (didn't bet)
Seat 6: kjohnson1409 (button) folded before Flop (didn't bet)



PokerStars Hand #222944615787:  Hold'em No Limit ($0.05/$0.10 USD) - 2021/01/23 23:59:25 ET
Table 'Malzovia III' 6-max Seat #1 is the button
Seat 1: AvGeL ($10.22 in chips) 
Seat 2: ildar87kzn ($11.97 in chips) 
Seat 3: Ger Cortes ($10 in chips) 
Seat 4: Renzo1529 ($10 in chips) 
Seat 5: Ifivecrypto ($4.31 in chips) 
Seat 6: kjohnson1409 ($16.27 in chips) 
ildar87kzn: posts small blind $0.05
Ger Cortes: posts big blind $0.10
Renzo1529: posts big blind $0.10
*** HOLE CARDS ***
Renzo1529: checks 
Ifivecrypto: folds 
kjohnson1409: folds 
AvGeL: folds 
ildar87kzn: folds 
Ger Cortes: checks 
*** FLOP *** [Qd 4h 6h]
Ger Cortes: checks 
Renzo1529: checks 
*** TURN *** [Qd 4h 6h] [Jh]
Ger Cortes: checks 
Renzo1529: bets $0.20
Ger Cortes: folds 
Uncalled bet ($0.20) returned to Renzo1529
Renzo1529 collected $0.24 from pot
Renzo1529: doesn't show hand 
*** SUMMARY ***
Total pot $0.25 | Rake $0.01 
Board [Qd 4h 6h Jh]
Seat 1: AvGeL (button) folded before Flop (didn't bet)
Seat 2: ildar87kzn (small blind) folded before Flop
Seat 3: Ger Cortes (big blind) folded on the Turn
Seat 4: Renzo1529 collected ($0.24)
Seat 5: Ifivecrypto folded before Flop (didn't bet)
Seat 6: kjohnson1409 folded before Flop (didn't bet)



PokerStars Hand #222943162604:  Hold'em No Limit ($0.05/$0.10 USD) - 2021/01/23 22:43:10 ET
Table 'Malzovia III' 6-max Seat #6 is the button
Seat 1: 1donkz0fks ($16.53 in chips) 
Seat 2: schoki77 ($8.32 in chips) 
Seat 3: KingPotNoodle ($11.62 in chips) 
Seat 6: PokerDroop ($11.56 in chips) 
1donkz0fks: posts small blind $0.05
schoki77: posts big blind $0.10
*** HOLE CARDS ***
KingPotNoodle: raises $0.20 to $0.30
PokerDroop: folds 
1donkz0fks: folds 
schoki77: folds 
Uncalled bet ($0.20) returned to KingPotNoodle
KingPotNoodle collected $0.25 from pot
KingPotNoodle: doesn't show hand 
*** SUMMARY ***
Total pot $0.25 | Rake $0 
Seat 1: 1donkz0fks (small blind) folded before Flop
Seat 2: schoki77 (big blind) folded before Flop
Seat 3: KingPotNoodle collected ($0.25)
Seat 6: PokerDroop (button) folded before Flop (didn't bet)



PokerStars Hand #222941804473:  Hold'em No Limit ($0.05/$0.10 USD) - 2021/01/23 21:42:56 ET
Table 'Malzovia III' 6-max Seat #1 is the button
Seat 1: 1donkz0fks ($12.30 in chips) 
Seat 2: oban005 ($13.12 in chips) 
Seat 3: mrgretty ($8.25 in chips) 
Seat 4: g1stav0br ($1.83 in chips) 
Seat 5: firstandsole ($12.78 in chips) 
Seat 6: proxt17 ($25.46 in chips) 
oban005: posts small blind $0.05
mrgretty: posts big blind $0.10
*** HOLE CARDS ***
g1stav0br: raises $0.20 to $0.30
firstandsole: folds 
proxt17: folds 
1donkz0fks: folds 
oban005: raises $0.90 to $1.20
mrgretty: folds 
g1stav0br: raises $0.63 to $1.83 and is all-in
oban005: calls $0.63
*** FLOP *** [Kd Td Qc]
*** TURN *** [Kd Td Qc] [7s]
*** RIVER *** [Kd Td Qc 7s] [4s]
*** SHOW DOWN ***
oban005: shows [Js Ks] (a pair of Kings)
g1stav0br: shows [Ts Ac] (a pair of Tens)
oban005 collected $3.59 from pot
*** SUMMARY ***
Total pot $3.76 | Rake $0.17 
Board [Kd Td Qc 7s 4s]
Seat 1: 1donkz0fks (button) folded before Flop (didn't bet)
Seat 2: oban005 (small blind) showed [Js Ks] and won ($3.59) with a pair of Kings
Seat 3: mrgretty (big blind) folded before Flop
Seat 4: g1stav0br showed [Ts Ac] and lost with a pair of Tens
Seat 5: firstandsole folded before Flop (didn't bet)
Seat 6: proxt17 folded before Flop (didn't bet)



PokerStars Hand #222941817963:  Hold'em No Limit ($0.05/$0.10 USD) - 2021/01/23 21:43:30 ET
Table 'Malzovia III' 6-max Seat #2 is the button
Seat 1: 1donkz0fks ($12.30 in chips) 
Seat 2: oban005 ($14.88 in chips) 
Seat 3: mrgretty ($8.15 in chips) 
Seat 5: firstandsole ($12.78 in chips) 
Seat 6: proxt17 ($25.46 in chips) 
mrgretty: posts small blind $0.05
firstandsole: posts big blind $0.10
*** HOLE CARDS ***
proxt17: raises $0.20 to $0.30
1donkz0fks: folds 
g1stav0br leaves the table
oban005: calls $0.30
mrgretty: folds 
firstandsole: folds 
*** FLOP *** [9d 5d Qs]
proxt17: bets $0.20
oban005: calls $0.20
*** TURN *** [9d 5d Qs] [7h]
proxt17: bets $0.85
oban005: folds 
Uncalled bet ($0.85) returned to proxt17
proxt17 collected $1.10 from pot
proxt17: doesn't show hand 
*** SUMMARY ***
Total pot $1.15 | Rake $0.05 
Board [9d 5d Qs 7h]
Seat 1: 1donkz0fks folded before Flop (didn't bet)
Seat 2: oban005 (button) folded on the Turn
Seat 3: mrgretty (small blind) folded before Flop
Seat 5: firstandsole (big blind) folded before Flop
Seat 6: proxt17 collected ($1.10)



PokerStars Hand #222941837306:  Hold'em No Limit ($0.05/$0.10 USD) - 2021/01/23 21:44:20 ET
Table 'Malzovia III' 6-max Seat #3 is the button
Seat 1: 1donkz0fks ($12.30 in chips) 
Seat 2: oban005 ($14.38 in chips) 
Seat 3: mrgretty ($8.10 in chips) 
Seat 5: firstandsole ($12.68 in chips) 
Seat 6: proxt17 ($26.06 in chips) 
firstandsole: posts small blind $0.05
proxt17: posts big blind $0.10
*** HOLE CARDS ***
1donkz0fks: folds 
oban005: folds 
mrgretty: folds 
firstandsole: folds 
Uncalled bet ($0.05) returned to proxt17
proxt17 collected $0.10 from pot
wizz99 joins the table at seat #4 
proxt17: doesn't show hand 
*** SUMMARY ***
Total pot $0.10 | Rake $0 
Seat 1: 1donkz0fks folded before Flop (didn't bet)
Seat 2: oban005 folded before Flop (didn't bet)
Seat 3: mrgretty (button) folded before Flop (didn't bet)
Seat 5: firstandsole (small blind) folded before Flop
Seat 6: proxt17 (big blind) collected ($0.10)



PokerStars Hand #222941841375:  Hold'em No Limit ($0.05/$0.10 USD) - 2021/01/23 21:44:30 ET
Table 'Malzovia III' 6-max Seat #5 is the button
Seat 1: 1donkz0fks ($12.30 in chips) 
Seat 2: oban005 ($14.38 in chips) 
Seat 3: mrgretty ($8.10 in chips) 
Seat 5: firstandsole ($12.63 in chips) 
Seat 6: proxt17 ($26.11 in chips) 
proxt17: posts small blind $0.05
1donkz0fks: posts big blind $0.10
wizz99: sits out 
*** HOLE CARDS ***
oban005: folds 
mrgretty: folds 
firstandsole: raises $0.20 to $0.30
proxt17: folds 
1donkz0fks: folds 
Uncalled bet ($0.20) returned to firstandsole
firstandsole collected $0.25 from pot
firstandsole: doesn't show hand 
*** SUMMARY ***
Total pot $0.25 | Rake $0 
Seat 1: 1donkz0fks (big blind) folded before Flop
Seat 2: oban005 folded before Flop (didn't bet)
Seat 3: mrgretty folded before Flop (didn't bet)
Seat 5: firstandsole (button) collected ($0.25)
Seat 6: proxt17 (small blind) folded before Flop



PokerStars Hand #222941849965:  Hold'em No Limit ($0.05/$0.10 USD) - 2021/01/23 21:44:52 ET
Table 'Malzovia III' 6-max Seat #6 is the button
Seat 1: 1donkz0fks ($12.20 in chips) 
Seat 2: oban005 ($14.38 in chips) 
Seat 3: mrgretty ($8.10 in chips) 
Seat 5: firstandsole ($12.78 in chips) 
Seat 6: proxt17 ($26.06 in chips) 
1donkz0fks: posts small blind $0.05
oban005: posts big blind $0.10
wizz99: sits out 
*** HOLE CARDS ***
mrgretty: raises $0.20 to $0.30
firstandsole: raises $0.70 to $1
proxt17: folds 
1donkz0fks: folds 
oban005: folds 
mrgretty: raises $2.15 to $3.15
firstandsole: raises $9.63 to $12.78 and is all-in
mrgretty: calls $4.95 and is all-in
Uncalled bet ($4.68) returned to firstandsole
*** FLOP *** [5h Qh 7d]
*** TURN *** [5h Qh 7d] [Ad]
*** RIVER *** [5h Qh 7d Ad] [Js]
*** SHOW DOWN ***
mrgretty: shows [As Ac] (three of a kind, Aces)
firstandsole: shows [Kc Kd] (a pair of Kings)
mrgretty cashed out the hand for $12.67 | Cash Out Fee $0.13
*** SUMMARY ***
Total pot $16.35 | Rake $0.74 
Board [5h Qh 7d Ad Js]
Seat 1: 1donkz0fks (small blind) folded before Flop
Seat 2: oban005 (big blind) folded before Flop
Seat 3: mrgretty showed [As Ac] and won ($15.61) with three of a kind, Aces (pot not awarded as player cashed out)
Seat 5: firstandsole showed [Kc Kd] and lost with a pair of Kings
Seat 6: proxt17 (button) folded before Flop (didn't bet)



PokerStars Hand #222941862182:  Hold'em No Limit ($0.05/$0.10 USD) - 2021/01/23 21:45:23 ET
Table 'Malzovia III' 6-max Seat #1 is the button
Seat 1: 1donkz0fks ($12.15 in chips) 
Seat 2: oban005 ($14.28 in chips) 
Seat 4: wizz99 ($8 in chips) 
Seat 5: firstandsole ($10 in chips) 
Seat 6: proxt17 ($26.06 in chips) 
oban005: posts small blind $0.05
mrgretty: is sitting out 
wizz99: posts big blind $0.10
*** HOLE CARDS ***
mrgretty leaves the table
firstandsole: folds 
proxt17: folds 
1donkz0fks: raises $0.20 to $0.30
oban005: raises $0.90 to $1.20
wizz99: folds 
1donkz0fks: folds 
Uncalled bet ($0.90) returned to oban005
oban005 collected $0.70 from pot
oban005: doesn't show hand 
*** SUMMARY ***
Total pot $0.70 | Rake $0 
Seat 1: 1donkz0fks (button) folded before Flop
Seat 2: oban005 (small blind) collected ($0.70)
Seat 4: wizz99 (big blind) folded before Flop
Seat 5: firstandsole folded before Flop (didn't bet)
Seat 6: proxt17 folded before Flop (didn't bet)



PokerStars Hand #222941873759:  Hold'em No Limit ($0.05/$0.10 USD) - 2021/01/23 21:45:53 ET
Table 'Malzovia III' 6-max Seat #2 is the button
Seat 1: 1donkz0fks ($11.85 in chips) 
Seat 2: oban005 ($14.68 in chips) 
Seat 4: wizz99 ($7.90 in chips) 
Seat 5: firstandsole ($10 in chips) 
Seat 6: proxt17 ($26.06 in chips) 
wizz99: posts small blind $0.05
firstandsole: posts big blind $0.10
*** HOLE CARDS ***
proxt17: folds 
1donkz0fks: folds 
oban005: raises $0.15 to $0.25
wizz99: calls $0.20
firstandsole: folds 
*** FLOP *** [2h 8d 7c]
wizz99: checks 
oban005: bets $0.31
wizz99: raises $0.89 to $1.20
oban005: folds 
Uncalled bet ($0.89) returned to wizz99
wizz99 collected $1.17 from pot
*** SUMMARY ***
Total pot $1.22 | Rake $0.05 
Board [2h 8d 7c]
Seat 1: 1donkz0fks folded before Flop (didn't bet)
Seat 2: oban005 (button) folded on the Flop
Seat 4: wizz99 (small blind) collected ($1.17)
Seat 5: firstandsole (big blind) folded before Flop
Seat 6: proxt17 folded before Flop (didn't bet)



PokerStars Hand #222941892019:  Hold'em No Limit ($0.05/$0.10 USD) - 2021/01/23 21:46:40 ET
Table 'Malzovia III' 6-max Seat #4 is the button
Seat 1: 1donkz0fks ($11.85 in chips) 
Seat 2: oban005 ($14.12 in chips) 
Seat 4: wizz99 ($8.51 in chips) 
Seat 5: firstandsole ($10 in chips) 
Seat 6: proxt17 ($26.06 in chips) 
firstandsole: posts small blind $0.05
proxt17: posts big blind $0.10
*** HOLE CARDS ***
1donkz0fks: folds 
oban005: folds 
wizz99: folds 
firstandsole: raises $0.20 to $0.30
proxt17: folds 
Uncalled bet ($0.20) returned to firstandsole
firstandsole collected $0.20 from pot
firstandsole: doesn't show hand 
*** SUMMARY ***
Total pot $0.20 | Rake $0 
Seat 1: 1donkz0fks folded before Flop (didn't bet)
Seat 2: oban005 folded before Flop (didn't bet)
Seat 4: wizz99 (button) folded before Flop (didn't bet)
Seat 5: firstandsole (small blind) collected ($0.20)
Seat 6: proxt17 (big blind) folded before Flop



PokerStars Hand #222941896131:  Hold'em No Limit ($0.05/$0.10 USD) - 2021/01/23 21:46:50 ET
Table 'Malzovia III' 6-max Seat #5 is the button
Seat 1: 1donkz0fks ($11.85 in chips) 
Seat 2: oban005 ($14.12 in chips) 
Seat 4: wizz99 ($8.51 in chips) 
Seat 5: firstandsole ($10.10 in chips) 
Seat 6: proxt17 ($25.96 in chips) 
proxt17: posts small blind $0.05
1donkz0fks: posts big blind $0.10
*** HOLE CARDS ***
oban005: folds 
wizz99: folds 
firstandsole: raises $0.20 to $0.30
proxt17: folds 
1donkz0fks: raises $0.80 to $1.10
firstandsole: folds 
Uncalled bet ($0.80) returned to 1donkz0fks
1donkz0fks collected $0.65 from pot
1donkz0fks: doesn't show hand 
*** SUMMARY ***
Total pot $0.65 | Rake $0 
Seat 1: 1donkz0fks (big blind) collected ($0.65)
Seat 2: oban005 folded before Flop (didn't bet)
Seat 4: wizz99 folded before Flop (didn't bet)
Seat 5: firstandsole (button) folded before Flop
Seat 6: proxt17 (small blind) folded before Flop



PokerStars Hand #222941903420:  Hold'em No Limit ($0.05/$0.10 USD) - 2021/01/23 21:47:09 ET
Table 'Malzovia III' 6-max Seat #6 is the button
Seat 1: 1donkz0fks ($12.20 in chips) 
Seat 4: wizz99 ($8.51 in chips) 
Seat 5: firstandsole ($10 in chips) 
Seat 6: proxt17 ($25.91 in chips) 
1donkz0fks: posts small blind $0.05
oban005: is sitting out 
wizz99: posts big blind $0.10
*** HOLE CARDS ***
oban005 leaves the table
firstandsole: raises $0.20 to $0.30
proxt17: folds 
1donkz0fks: calls $0.25
wizz99: folds 
*** FLOP *** [Ks Qs 2h]
1donkz0fks: checks 
firstandsole: bets $0.52
1donkz0fks: folds 
Uncalled bet ($0.52) returned to firstandsole
firstandsole collected $0.67 from pot
firstandsole: doesn't show hand 
*** SUMMARY ***
Total pot $0.70 | Rake $0.03 
Board [Ks Qs 2h]
Seat 1: 1donkz0fks (small blind) folded on the Flop
Seat 4: wizz99 (big blind) folded before Flop
Seat 5: firstandsole collected ($0.67)
Seat 6: proxt17 (button) folded before Flop (didn't bet)



PokerStars Hand #222941910550:  Hold'em No Limit ($0.05/$0.10 USD) - 2021/01/23 21:47:28 ET
Table 'Malzovia III' 6-max Seat #1 is the button
Seat 1: 1donkz0fks ($11.90 in chips) 
Seat 4: wizz99 ($8.41 in chips) 
Seat 6: proxt17 ($25.91 in chips) 
wizz99: posts small blind $0.05
firstandsole: is sitting out 
firstandsole leaves the table
proxt17: posts big blind $0.10
*** HOLE CARDS ***
1donkz0fks: folds 
wizz99: folds 
Uncalled bet ($0.05) returned to proxt17
proxt17 collected $0.10 from pot
proxt17: doesn't show hand 
KramSS joins the table at seat #5 
*** SUMMARY ***
Total pot $0.10 | Rake $0 
Seat 1: 1donkz0fks (button) folded before Flop (didn't bet)
Seat 4: wizz99 (small blind) folded before Flop
Seat 6: proxt17 (big blind) collected ($0.10)



PokerStars Hand #222941917228:  Hold'em No Limit ($0.05/$0.10 USD) - 2021/01/23 21:47:45 ET
Table 'Malzovia III' 6-max Seat #4 is the button
Seat 1: 1donkz0fks ($11.90 in chips) 
Seat 4: wizz99 ($8.36 in chips) 
Seat 6: proxt17 ($25.96 in chips) 
proxt17: posts small blind $0.05
1donkz0fks: posts big blind $0.10
*** HOLE CARDS ***
wizz99: folds 
proxt17: folds 
Uncalled bet ($0.05) returned to 1donkz0fks
1donkz0fks collected $0.10 from pot
1donkz0fks: doesn't show hand 
*** SUMMARY ***
Total pot $0.10 | Rake $0 
Seat 1: 1donkz0fks (big blind) collected ($0.10)
Seat 4: wizz99 (button) folded before Flop (didn't bet)
Seat 6: proxt17 (small blind) folded before Flop



PokerStars Hand #222941919565:  Hold'em No Limit ($0.05/$0.10 USD) - 2021/01/23 21:47:51 ET
Table 'Malzovia III' 6-max Seat #6 is the button
Seat 1: 1donkz0fks ($11.95 in chips) 
Seat 4: wizz99 ($8.36 in chips) 
Seat 6: proxt17 ($25.91 in chips) 
1donkz0fks: posts small blind $0.05
wizz99: posts big blind $0.10
KramSS: sits out 
*** HOLE CARDS ***
proxt17: folds 
1donkz0fks: folds 
Uncalled bet ($0.05) returned to wizz99
wizz99 collected $0.10 from pot
*** SUMMARY ***
Total pot $0.10 | Rake $0 
Seat 1: 1donkz0fks (small blind) folded before Flop
Seat 4: wizz99 (big blind) collected ($0.10)
Seat 6: proxt17 (button) folded before Flop (didn't bet)



PokerStars Hand #222941922361:  Hold'em No Limit ($0.05/$0.10 USD) - 2021/01/23 21:47:58 ET
Table 'Malzovia III' 6-max Seat #1 is the button
Seat 1: 1donkz0fks ($11.90 in chips) 
Seat 4: wizz99 ($8.41 in chips) 
Seat 5: KramSS ($10 in chips) 
Seat 6: proxt17 ($25.91 in chips) 
wizz99: posts small blind $0.05
KramSS: posts big blind $0.10
*** HOLE CARDS ***
proxt17: folds 
1donkz0fks: folds 
wizz99: raises $0.12 to $0.22
KramSS: calls $0.12
*** FLOP *** [Ad 8c 9h]
wizz99: bets $0.32
KramSS: folds 
Uncalled bet ($0.32) returned to wizz99
wizz99 collected $0.42 from pot
*** SUMMARY ***
Total pot $0.44 | Rake $0.02 
Board [Ad 8c 9h]
Seat 1: 1donkz0fks (button) folded before Flop (didn't bet)
Seat 4: wizz99 (small blind) collected ($0.42)
Seat 5: KramSS (big blind) folded on the Flop
Seat 6: proxt17 folded before Flop (didn't bet)



PokerStars Hand #222941933861:  Hold'em No Limit ($0.05/$0.10 USD) - 2021/01/23 21:48:28 ET
Table 'Malzovia III' 6-max Seat #4 is the button
Seat 1: 1donkz0fks ($11.90 in chips) 
Seat 4: wizz99 ($8.61 in chips) 
Seat 5: KramSS ($10 in chips) 
Seat 6: proxt17 ($25.91 in chips) 
KramSS: posts small blind $0.05
schoki77 joins the table at seat #2 
proxt17: posts big blind $0.10
*** HOLE CARDS ***
1donkz0fks: folds 
wizz99: folds 
KramSS: folds 
Uncalled bet ($0.05) returned to proxt17
proxt17 collected $0.10 from pot
proxt17: doesn't show hand 
*** SUMMARY ***
Total pot $0.10 | Rake $0 
Seat 1: 1donkz0fks folded before Flop (didn't bet)
Seat 4: wizz99 (button) folded before Flop (didn't bet)
Seat 5: KramSS (small blind) folded before Flop
Seat 6: proxt17 (big blind) collected ($0.10)



PokerStars Hand #222941936905:  Hold'em No Limit ($0.05/$0.10 USD) - 2021/01/23 21:48:36 ET
Table 'Malzovia III' 6-max Seat #5 is the button
Seat 1: 1donkz0fks ($11.90 in chips) 
Seat 4: wizz99 ($8.61 in chips) 
Seat 5: KramSS ($10 in chips) 
Seat 6: proxt17 ($25.96 in chips) 
proxt17: posts small blind $0.05
1donkz0fks: posts big blind $0.10
schoki77: sits out 
*** HOLE CARDS ***
wizz99: folds 
KramSS: raises $0.15 to $0.25
proxt17: folds 
1donkz0fks: folds 
Uncalled bet ($0.15) returned to KramSS
KramSS collected $0.25 from pot
KramSS: doesn't show hand 
*** SUMMARY ***
Total pot $0.25 | Rake $0 
Seat 1: 1donkz0fks (big blind) folded before Flop
Seat 4: wizz99 folded before Flop (didn't bet)
Seat 5: KramSS (button) collected ($0.25)
Seat 6: proxt17 (small blind) folded before Flop



PokerStars Hand #222941942932:  Hold'em No Limit ($0.05/$0.10 USD) - 2021/01/23 21:48:52 ET
Table 'Malzovia III' 6-max Seat #6 is the button
Seat 1: 1donkz0fks ($11.80 in chips) 
Seat 2: schoki77 ($5.60 in chips) 
Seat 4: wizz99 ($8.61 in chips) 
Seat 5: KramSS ($10.15 in chips) 
Seat 6: proxt17 ($25.91 in chips) 
1donkz0fks: posts small blind $0.05
schoki77: posts big blind $0.10
*** HOLE CARDS ***
wizz99: folds 
KramSS: folds 
ildar87kzn joins the table at seat #3 
proxt17: raises $0.20 to $0.30
1donkz0fks: folds 
schoki77: folds 
Uncalled bet ($0.20) returned to proxt17
proxt17 collected $0.25 from pot
*** SUMMARY ***
Total pot $0.25 | Rake $0 
Seat 1: 1donkz0fks (small blind) folded before Flop
Seat 2: schoki77 (big blind) folded before Flop
Seat 4: wizz99 folded before Flop (didn't bet)
Seat 5: KramSS folded before Flop (didn't bet)
Seat 6: proxt17 (button) collected ($0.25)



PokerStars Hand #222941948057:  Hold'em No Limit ($0.05/$0.10 USD) - 2021/01/23 21:49:05 ET
Table 'Malzovia III' 6-max Seat #1 is the button
Seat 1: 1donkz0fks ($11.75 in chips) 
Seat 2: schoki77 ($5.50 in chips) 
Seat 3: ildar87kzn ($10 in chips) 
Seat 4: wizz99 ($8.61 in chips) 
Seat 5: KramSS ($10.15 in chips) 
Seat 6: proxt17 ($26.06 in chips) 
schoki77: posts small blind $0.05
ildar87kzn: posts big blind $0.10
*** HOLE CARDS ***
wizz99: folds 
KramSS has timed out
KramSS: folds 
proxt17: folds 
1donkz0fks: raises $0.20 to $0.30
schoki77: calls $0.25
ildar87kzn: folds 
*** FLOP *** [Qs 7c 3h]
schoki77: checks 
KramSS leaves the table
1donkz0fks: bets $0.40
schoki77: folds 
Uncalled bet ($0.40) returned to 1donkz0fks
1donkz0fks collected $0.67 from pot
1donkz0fks: doesn't show hand 
*** SUMMARY ***
Total pot $0.70 | Rake $0.03 
Board [Qs 7c 3h]
Seat 1: 1donkz0fks (button) collected ($0.67)
Seat 2: schoki77 (small blind) folded on the Flop
Seat 3: ildar87kzn (big blind) folded before Flop
Seat 4: wizz99 folded before Flop (didn't bet)
Seat 5: KramSS folded before Flop (didn't bet)
Seat 6: proxt17 folded before Flop (didn't bet)



PokerStars Hand #222941961718:  Hold'em No Limit ($0.05/$0.10 USD) - 2021/01/23 21:49:40 ET
Table 'Malzovia III' 6-max Seat #2 is the button
Seat 1: 1donkz0fks ($12.12 in chips) 
Seat 2: schoki77 ($5.20 in chips) 
Seat 3: ildar87kzn ($10 in chips) 
Seat 4: wizz99 ($8.61 in chips) 
Seat 6: proxt17 ($26.06 in chips) 
ildar87kzn: posts small blind $0.05
wizz99: posts big blind $0.10
*** HOLE CARDS ***
proxt17: folds 
1donkz0fks: folds 
schoki77: folds 
Brian2471 joins the table at seat #5 
ildar87kzn: raises $0.20 to $0.30
wizz99: folds 
Uncalled bet ($0.20) returned to ildar87kzn
ildar87kzn collected $0.20 from pot
ildar87kzn: doesn't show hand 
*** SUMMARY ***
Total pot $0.20 | Rake $0 
Seat 1: 1donkz0fks folded before Flop (didn't bet)
Seat 2: schoki77 (button) folded before Flop (didn't bet)
Seat 3: ildar87kzn (small blind) collected ($0.20)
Seat 4: wizz99 (big blind) folded before Flop
Seat 6: proxt17 folded before Flop (didn't bet)



PokerStars Hand #222941968681:  Hold'em No Limit ($0.05/$0.10 USD) - 2021/01/23 21:49:58 ET
Table 'Malzovia III' 6-max Seat #3 is the button
Seat 1: 1donkz0fks ($12.12 in chips) 
Seat 2: schoki77 ($5.20 in chips) 
Seat 3: ildar87kzn ($10.10 in chips) 
Seat 4: wizz99 ($8.51 in chips) 
Seat 5: Brian2471 ($10 in chips) 
Seat 6: proxt17 ($26.06 in chips) 
wizz99: posts small blind $0.05
Brian2471: posts big blind $0.10
*** HOLE CARDS ***
proxt17: folds 
1donkz0fks: folds 
schoki77: raises $0.20 to $0.30
ildar87kzn: folds 
wizz99: calls $0.25
Brian2471: folds 
*** FLOP *** [2c 5h 3s]
wizz99: checks 
schoki77: bets $0.34
wizz99: raises $0.66 to $1
schoki77: folds 
Uncalled bet ($0.66) returned to wizz99
wizz99 collected $1.32 from pot
*** SUMMARY ***
Total pot $1.38 | Rake $0.06 
Board [2c 5h 3s]
Seat 1: 1donkz0fks folded before Flop (didn't bet)
Seat 2: schoki77 folded on the Flop
Seat 3: ildar87kzn (button) folded before Flop (didn't bet)
Seat 4: wizz99 (small blind) collected ($1.32)
Seat 5: Brian2471 (big blind) folded before Flop
Seat 6: proxt17 folded before Flop (didn't bet)



PokerStars Hand #222941988782:  Hold'em No Limit ($0.05/$0.10 USD) - 2021/01/23 21:50:51 ET
Table 'Malzovia III' 6-max Seat #4 is the button
Seat 1: 1donkz0fks ($12.12 in chips) 
Seat 2: schoki77 ($4.56 in chips) 
Seat 3: ildar87kzn ($10.10 in chips) 
Seat 4: wizz99 ($9.19 in chips) 
Seat 5: Brian2471 ($9.90 in chips) 
Seat 6: proxt17 ($26.06 in chips) 
Brian2471: posts small blind $0.05
proxt17: posts big blind $0.10
*** HOLE CARDS ***
1donkz0fks: folds 
schoki77: folds 
ildar87kzn: folds 
wizz99: folds 
Brian2471: calls $0.05
proxt17: raises $0.30 to $0.40
Brian2471: calls $0.30
*** FLOP *** [Ac 5d 2s]
Brian2471: checks 
proxt17: bets $0.58
Brian2471: folds 
Uncalled bet ($0.58) returned to proxt17
proxt17 collected $0.76 from pot
proxt17: doesn't show hand 
*** SUMMARY ***
Total pot $0.80 | Rake $0.04 
Board [Ac 5d 2s]
Seat 1: 1donkz0fks folded before Flop (didn't bet)
Seat 2: schoki77 folded before Flop (didn't bet)
Seat 3: ildar87kzn folded before Flop (didn't bet)
Seat 4: wizz99 (button) folded before Flop (didn't bet)
Seat 5: Brian2471 (small blind) folded on the Flop
Seat 6: proxt17 (big blind) collected ($0.76)



PokerStars Hand #222942042659:  Hold'em No Limit ($0.05/$0.10 USD) - 2021/01/23 21:53:12 ET
Table 'Malzovia III' 6-max Seat #6 is the button
Seat 1: 1donkz0fks ($16.81 in chips) 
Seat 2: schoki77 ($4.56 in chips) 
Seat 3: ildar87kzn ($10.10 in chips) 
Seat 4: wizz99 ($9.19 in chips) 
Seat 5: Brian2471 ($4.40 in chips) 
Seat 6: proxt17 ($26.37 in chips) 
1donkz0fks: posts small blind $0.05
schoki77: posts big blind $0.10
*** HOLE CARDS ***
ildar87kzn: folds 
wizz99: folds 
Brian2471: calls $0.10
proxt17: folds 
1donkz0fks: raises $0.20 to $0.30
schoki77: calls $0.20
Brian2471: calls $0.20
*** FLOP *** [Kd Js 6s]
1donkz0fks: checks 
schoki77: checks 
Brian2471: checks 
*** TURN *** [Kd Js 6s] [Ah]
proxt17 leaves the table
1donkz0fks: checks 
schoki77: checks 
Brian2471: checks 
*** RIVER *** [Kd Js 6s Ah] [Ks]
1donkz0fks: checks 
schoki77: bets $0.70
Brian2471: folds 
1donkz0fks: folds 
Uncalled bet ($0.70) returned to schoki77
schoki77 collected $0.86 from pot
schoki77: doesn't show hand 
*** SUMMARY ***
Total pot $0.90 | Rake $0.04 
Board [Kd Js 6s Ah Ks]
Seat 1: 1donkz0fks (small blind) folded on the River
Seat 2: schoki77 (big blind) collected ($0.86)
Seat 3: ildar87kzn folded before Flop (didn't bet)
Seat 4: wizz99 folded before Flop (didn't bet)
Seat 5: Brian2471 folded on the River
Seat 6: proxt17 (button) folded before Flop (didn't bet)



PokerStars Hand #222942075988:  Hold'em No Limit ($0.05/$0.10 USD) - 2021/01/23 21:54:38 ET
Table 'Malzovia III' 6-max Seat #1 is the button
Seat 1: 1donkz0fks ($16.51 in chips) 
Seat 2: schoki77 ($5.12 in chips) 
Seat 3: ildar87kzn ($10.10 in chips) 
Seat 4: wizz99 ($9.19 in chips) 
Seat 5: Brian2471 ($4.10 in chips) 
schoki77: posts small blind $0.05
ildar87kzn: posts big blind $0.10
*** HOLE CARDS ***
wizz99: folds 
Brian2471: calls $0.10
1donkz0fks: raises $0.20 to $0.30
schoki77: folds 
ildar87kzn: folds 
Brian2471: calls $0.20
*** FLOP *** [Tc 8d 5s]
Brian2471: checks 
1donkz0fks: bets $0.54
Brian2471: folds 
Uncalled bet ($0.54) returned to 1donkz0fks
1donkz0fks collected $0.72 from pot
1donkz0fks: doesn't show hand 
*** SUMMARY ***
Total pot $0.75 | Rake $0.03 
Board [Tc 8d 5s]
Seat 1: 1donkz0fks (button) collected ($0.72)
Seat 2: schoki77 (small blind) folded before Flop
Seat 3: ildar87kzn (big blind) folded before Flop
Seat 4: wizz99 folded before Flop (didn't bet)
Seat 5: Brian2471 folded on the Flop



PokerStars Hand #222942089680:  Hold'em No Limit ($0.05/$0.10 USD) - 2021/01/23 21:55:17 ET
Table 'Malzovia III' 6-max Seat #2 is the button
Seat 1: 1donkz0fks ($16.93 in chips) 
Seat 2: schoki77 ($5.07 in chips) 
Seat 3: ildar87kzn ($10 in chips) 
Seat 4: wizz99 ($9.19 in chips) 
Seat 5: Brian2471 ($3.80 in chips) 
ildar87kzn: posts small blind $0.05
wizz99: posts big blind $0.10
*** HOLE CARDS ***
Brian2471: calls $0.10
1donkz0fks: folds 
schoki77: folds 
ildar87kzn: calls $0.05
wizz99: checks 
*** FLOP *** [Ad Kd 4c]
ildar87kzn: checks 
wizz99: checks 
Brian2471: checks 
*** TURN *** [Ad Kd 4c] [As]
ildar87kzn: bets $0.19
wizz99: folds 
Brian2471: folds 
Uncalled bet ($0.19) returned to ildar87kzn
ildar87kzn collected $0.29 from pot
ildar87kzn: doesn't show hand 
*** SUMMARY ***
Total pot $0.30 | Rake $0.01 
Board [Ad Kd 4c As]
Seat 1: 1donkz0fks folded before Flop (didn't bet)
Seat 2: schoki77 (button) folded before Flop (didn't bet)
Seat 3: ildar87kzn (small blind) collected ($0.29)
Seat 4: wizz99 (big blind) folded on the Turn
Seat 5: Brian2471 folded on the Turn



PokerStars Hand #222942109712:  Hold'em No Limit ($0.05/$0.10 USD) - 2021/01/23 21:56:06 ET
Table 'Malzovia III' 6-max Seat #3 is the button
Seat 1: 1donkz0fks ($16.93 in chips) 
Seat 2: schoki77 ($5.07 in chips) 
Seat 3: ildar87kzn ($10.19 in chips) 
Seat 4: wizz99 ($9.09 in chips) 
Seat 5: Brian2471 ($3.70 in chips) 
wizz99: posts small blind $0.05
Brian2471: posts big blind $0.10
*** HOLE CARDS ***
1donkz0fks: folds 
schoki77: calls $0.10
ildar87kzn: folds 
wizz99: calls $0.05
Brian2471: checks 
*** FLOP *** [7c 4c 4h]
wizz99: checks 
starii13 joins the table at seat #6 
Brian2471: checks 
schoki77: bets $0.15
wizz99: folds 
Brian2471: folds 
Uncalled bet ($0.15) returned to schoki77
schoki77 collected $0.29 from pot
schoki77: doesn't show hand 
*** SUMMARY ***
Total pot $0.30 | Rake $0.01 
Board [7c 4c 4h]
Seat 1: 1donkz0fks folded before Flop (didn't bet)
Seat 2: schoki77 collected ($0.29)
Seat 3: ildar87kzn (button) folded before Flop (didn't bet)
Seat 4: wizz99 (small blind) folded on the Flop
Seat 5: Brian2471 (big blind) folded on the Flop



PokerStars Hand #222942120761:  Hold'em No Limit ($0.05/$0.10 USD) - 2021/01/23 21:56:45 ET
Table 'Malzovia III' 6-max Seat #4 is the button
Seat 1: 1donkz0fks ($16.93 in chips) 
Seat 2: schoki77 ($5.26 in chips) 
Seat 3: ildar87kzn ($10.19 in chips) 
Seat 4: wizz99 ($8.99 in chips) 
Seat 5: Brian2471 ($3.60 in chips) 
Seat 6: starii13 ($10 in chips) 
Brian2471: posts small blind $0.05
starii13: posts big blind $0.10
*** HOLE CARDS ***
1donkz0fks: folds 
schoki77: folds 
ildar87kzn: raises $0.20 to $0.30
wizz99: raises $0.70 to $1
Brian2471: folds 
starii13: calls $0.90
ildar87kzn: folds 
*** FLOP *** [5d Td 3c]
starii13: checks 
wizz99: bets $2.20
starii13: folds 
Uncalled bet ($2.20) returned to wizz99
wizz99 collected $2.24 from pot
*** SUMMARY ***
Total pot $2.35 | Rake $0.11 
Board [5d Td 3c]
Seat 1: 1donkz0fks folded before Flop (didn't bet)
Seat 2: schoki77 folded before Flop (didn't bet)
Seat 3: ildar87kzn folded before Flop
Seat 4: wizz99 (button) collected ($2.24)
Seat 5: Brian2471 (small blind) folded before Flop
Seat 6: starii13 (big blind) folded on the Flop



PokerStars Hand #222942132831:  Hold'em No Limit ($0.05/$0.10 USD) - 2021/01/23 21:57:28 ET
Table 'Malzovia III' 6-max Seat #5 is the button
Seat 1: 1donkz0fks ($16.93 in chips) 
Seat 2: schoki77 ($5.26 in chips) 
Seat 3: ildar87kzn ($10 in chips) 
Seat 4: wizz99 ($10.23 in chips) 
Seat 5: Brian2471 ($3.55 in chips) 
Seat 6: starii13 ($10 in chips) 
starii13: posts small blind $0.05
1donkz0fks: posts big blind $0.10
*** HOLE CARDS ***
schoki77: folds 
ildar87kzn: folds 
wizz99: raises $0.12 to $0.22
Brian2471: folds 
starii13: folds 
1donkz0fks: folds 
Uncalled bet ($0.12) returned to wizz99
wizz99 collected $0.25 from pot
*** SUMMARY ***
Total pot $0.25 | Rake $0 
Seat 1: 1donkz0fks (big blind) folded before Flop
Seat 2: schoki77 folded before Flop (didn't bet)
Seat 3: ildar87kzn folded before Flop (didn't bet)
Seat 4: wizz99 collected ($0.25)
Seat 5: Brian2471 (button) folded before Flop (didn't bet)
Seat 6: starii13 (small blind) folded before Flop



PokerStars Hand #222942140298:  Hold'em No Limit ($0.05/$0.10 USD) - 2021/01/23 21:57:54 ET
Table 'Malzovia III' 6-max Seat #6 is the button
Seat 1: 1donkz0fks ($16.83 in chips) 
Seat 2: schoki77 ($5.26 in chips) 
Seat 3: ildar87kzn ($10 in chips) 
Seat 4: wizz99 ($10.38 in chips) 
Seat 5: Brian2471 ($3.55 in chips) 
Seat 6: starii13 ($10 in chips) 
1donkz0fks: posts small blind $0.05
schoki77: posts big blind $0.10
*** HOLE CARDS ***
ildar87kzn: folds 
wizz99: folds 
Brian2471: calls $0.10
starii13: folds 
1donkz0fks: folds 
schoki77: checks 
*** FLOP *** [3h 2s Jd]
schoki77: checks 
Brian2471: checks 
*** TURN *** [3h 2s Jd] [5d]
schoki77: checks 
Brian2471: bets $0.20
schoki77: folds 
Uncalled bet ($0.20) returned to Brian2471
Brian2471 collected $0.24 from pot
Brian2471: doesn't show hand 
*** SUMMARY ***
Total pot $0.25 | Rake $0.01 
Board [3h 2s Jd 5d]
Seat 1: 1donkz0fks (small blind) folded before Flop
Seat 2: schoki77 (big blind) folded on the Turn
Seat 3: ildar87kzn folded before Flop (didn't bet)
Seat 4: wizz99 folded before Flop (didn't bet)
Seat 5: Brian2471 collected ($0.24)
Seat 6: starii13 (button) folded before Flop (didn't bet)



PokerStars Hand #222942150662:  Hold'em No Limit ($0.05/$0.10 USD) - 2021/01/23 21:58:31 ET
Table 'Malzovia III' 6-max Seat #1 is the button
Seat 1: 1donkz0fks ($16.78 in chips) 
Seat 2: schoki77 ($5.16 in chips) 
Seat 3: ildar87kzn ($10 in chips) 
Seat 4: wizz99 ($10.38 in chips) 
Seat 5: Brian2471 ($3.69 in chips) 
Seat 6: starii13 ($10 in chips) 
schoki77: posts small blind $0.05
ildar87kzn: posts big blind $0.10
*** HOLE CARDS ***
wizz99: folds 
Brian2471: raises $0.20 to $0.30
starii13: calls $0.30
1donkz0fks: folds 
schoki77: calls $0.25
ildar87kzn: folds 
*** FLOP *** [9s 7s 5h]
schoki77: checks 
Brian2471: bets $0.48
starii13: folds 
schoki77: folds 
Uncalled bet ($0.48) returned to Brian2471
Brian2471 collected $0.96 from pot
Brian2471: doesn't show hand 
*** SUMMARY ***
Total pot $1 | Rake $0.04 
Board [9s 7s 5h]
Seat 1: 1donkz0fks (button) folded before Flop (didn't bet)
Seat 2: schoki77 (small blind) folded on the Flop
Seat 3: ildar87kzn (big blind) folded before Flop
Seat 4: wizz99 folded before Flop (didn't bet)
Seat 5: Brian2471 collected ($0.96)
Seat 6: starii13 folded on the Flop



PokerStars Hand #222942160831:  Hold'em No Limit ($0.05/$0.10 USD) - 2021/01/23 21:59:08 ET
Table 'Malzovia III' 6-max Seat #2 is the button
Seat 1: 1donkz0fks ($16.78 in chips) 
Seat 2: schoki77 ($4.86 in chips) 
Seat 3: ildar87kzn ($10 in chips) 
Seat 4: wizz99 ($10.38 in chips) 
Seat 5: Brian2471 ($4.35 in chips) 
Seat 6: starii13 ($10 in chips) 
ildar87kzn: posts small blind $0.05
wizz99: posts big blind $0.10
*** HOLE CARDS ***
Brian2471 has timed out
Brian2471: folds 
starii13: folds 
1donkz0fks: raises $0.20 to $0.30
schoki77: folds 
ildar87kzn: folds 
wizz99: folds 
Uncalled bet ($0.20) returned to 1donkz0fks
1donkz0fks collected $0.25 from pot
1donkz0fks: doesn't show hand 
*** SUMMARY ***
Total pot $0.25 | Rake $0 
Seat 1: 1donkz0fks collected ($0.25)
Seat 2: schoki77 (button) folded before Flop (didn't bet)
Seat 3: ildar87kzn (small blind) folded before Flop
Seat 4: wizz99 (big blind) folded before Flop
Seat 5: Brian2471 folded before Flop (didn't bet)
Seat 6: starii13 folded before Flop (didn't bet)



PokerStars Hand #222942167318:  Hold'em No Limit ($0.05/$0.10 USD) - 2021/01/23 21:59:31 ET
Table 'Malzovia III' 6-max Seat #3 is the button
Seat 1: 1donkz0fks ($16.93 in chips) 
Seat 2: schoki77 ($4.86 in chips) 
Seat 3: ildar87kzn ($10 in chips) 
Seat 4: wizz99 ($10.28 in chips) 
Seat 5: Brian2471 ($4.35 in chips) 
Seat 6: starii13 ($10 in chips) 
wizz99: posts small blind $0.05
Brian2471: posts big blind $0.10
*** HOLE CARDS ***
starii13: folds 
1donkz0fks: folds 
schoki77: raises $0.20 to $0.30
ildar87kzn: folds 
wizz99: folds 
Brian2471: calls $0.20
*** FLOP *** [Ah 5s 9h]
Brian2471: checks 
schoki77: bets $0.31
Brian2471: calls $0.31
*** TURN *** [Ah 5s 9h] [Ac]
Brian2471: checks 
schoki77: checks 
*** RIVER *** [Ah 5s 9h Ac] [9s]
Brian2471: bets $0.60
schoki77: folds 
Uncalled bet ($0.60) returned to Brian2471
Brian2471 collected $1.21 from pot
Brian2471: doesn't show hand 
*** SUMMARY ***
Total pot $1.27 | Rake $0.06 
Board [Ah 5s 9h Ac 9s]
Seat 1: 1donkz0fks folded before Flop (didn't bet)
Seat 2: schoki77 folded on the River
Seat 3: ildar87kzn (button) folded before Flop (didn't bet)
Seat 4: wizz99 (small blind) folded before Flop
Seat 5: Brian2471 (big blind) collected ($1.21)
Seat 6: starii13 folded before Flop (didn't bet)



PokerStars Hand #222942189387:  Hold'em No Limit ($0.05/$0.10 USD) - 2021/01/23 22:00:42 ET
Table 'Malzovia III' 6-max Seat #4 is the button
Seat 1: 1donkz0fks ($16.93 in chips) 
Seat 2: schoki77 ($4.25 in chips) 
Seat 3: ildar87kzn ($10 in chips) 
Seat 4: wizz99 ($10.23 in chips) 
Seat 5: Brian2471 ($4.95 in chips) 
Seat 6: starii13 ($10 in chips) 
Brian2471: posts small blind $0.05
starii13: posts big blind $0.10
*** HOLE CARDS ***
1donkz0fks: folds 
schoki77: folds 
ildar87kzn: raises $0.20 to $0.30
wizz99: folds 
Brian2471: folds 
starii13: folds 
Uncalled bet ($0.20) returned to ildar87kzn
ildar87kzn collected $0.25 from pot
ildar87kzn: doesn't show hand 
*** SUMMARY ***
Total pot $0.25 | Rake $0 
Seat 1: 1donkz0fks folded before Flop (didn't bet)
Seat 2: schoki77 folded before Flop (didn't bet)
Seat 3: ildar87kzn collected ($0.25)
Seat 4: wizz99 (button) folded before Flop (didn't bet)
Seat 5: Brian2471 (small blind) folded before Flop
Seat 6: starii13 (big blind) folded before Flop



PokerStars Hand #222942195443:  Hold'em No Limit ($0.05/$0.10 USD) - 2021/01/23 22:00:58 ET
Table 'Malzovia III' 6-max Seat #5 is the button
Seat 1: 1donkz0fks ($16.93 in chips) 
Seat 2: schoki77 ($4.25 in chips) 
Seat 3: ildar87kzn ($10.15 in chips) 
Seat 4: wizz99 ($10.23 in chips) 
Seat 5: Brian2471 ($4.90 in chips) 
Seat 6: starii13 ($10 in chips) 
starii13: posts small blind $0.05
1donkz0fks: posts big blind $0.10
*** HOLE CARDS ***
schoki77: folds 
ildar87kzn: folds 
wizz99: folds 
Brian2471: folds 
starii13: folds 
Uncalled bet ($0.05) returned to 1donkz0fks
1donkz0fks collected $0.10 from pot
1donkz0fks: doesn't show hand 
*** SUMMARY ***
Total pot $0.10 | Rake $0 
Seat 1: 1donkz0fks (big blind) collected ($0.10)
Seat 2: schoki77 folded before Flop (didn't bet)
Seat 3: ildar87kzn folded before Flop (didn't bet)
Seat 4: wizz99 folded before Flop (didn't bet)
Seat 5: Brian2471 (button) folded before Flop (didn't bet)
Seat 6: starii13 (small blind) folded before Flop



PokerStars Hand #222942201477:  Hold'em No Limit ($0.05/$0.10 USD) - 2021/01/23 22:01:15 ET
Table 'Malzovia III' 6-max Seat #6 is the button
Seat 1: 1donkz0fks ($16.98 in chips) 
Seat 2: schoki77 ($4.25 in chips) 
Seat 3: ildar87kzn ($10.15 in chips) 
Seat 4: wizz99 ($10.23 in chips) 
Seat 5: Brian2471 ($4.90 in chips) 
Seat 6: starii13 ($10 in chips) 
1donkz0fks: posts small blind $0.05
schoki77: posts big blind $0.10
*** HOLE CARDS ***
ildar87kzn: folds 
wizz99: folds 
wizz99 leaves the table
Brian2471: folds 
starii13: folds 
1donkz0fks: folds 
Uncalled bet ($0.05) returned to schoki77
schoki77 collected $0.10 from pot
schoki77: doesn't show hand 
*** SUMMARY ***
Total pot $0.10 | Rake $0 
Seat 1: 1donkz0fks (small blind) folded before Flop
Seat 2: schoki77 (big blind) collected ($0.10)
Seat 3: ildar87kzn folded before Flop (didn't bet)
Seat 4: wizz99 folded before Flop (didn't bet)
Seat 5: Brian2471 folded before Flop (didn't bet)
Seat 6: starii13 (button) folded before Flop (didn't bet)



PokerStars Hand #222942208133:  Hold'em No Limit ($0.05/$0.10 USD) - 2021/01/23 22:01:32 ET
Table 'Malzovia III' 6-max Seat #1 is the button
Seat 1: 1donkz0fks ($16.93 in chips) 
Seat 2: schoki77 ($4.30 in chips) 
Seat 3: ildar87kzn ($10.15 in chips) 
Seat 5: Brian2471 ($4.90 in chips) 
Seat 6: starii13 ($10 in chips) 
schoki77: posts small blind $0.05
ildar87kzn: posts big blind $0.10
*** HOLE CARDS ***
fraternitati joins the table at seat #4 
Brian2471 has timed out
Brian2471: folds 
starii13: folds 
1donkz0fks: folds 
schoki77: raises $0.20 to $0.30
ildar87kzn: calls $0.20
*** FLOP *** [Ac 4h Tc]
schoki77: checks 
ildar87kzn: checks 
*** TURN *** [Ac 4h Tc] [7d]
schoki77: bets $0.29
ildar87kzn: folds 
Uncalled bet ($0.29) returned to schoki77
schoki77 collected $0.57 from pot
schoki77: doesn't show hand 
*** SUMMARY ***
Total pot $0.60 | Rake $0.03 
Board [Ac 4h Tc 7d]
Seat 1: 1donkz0fks (button) folded before Flop (didn't bet)
Seat 2: schoki77 (small blind) collected ($0.57)
Seat 3: ildar87kzn (big blind) folded on the Turn
Seat 5: Brian2471 folded before Flop (didn't bet)
Seat 6: starii13 folded before Flop (didn't bet)



PokerStars Hand #222942227050:  Hold'em No Limit ($0.05/$0.10 USD) - 2021/01/23 22:02:23 ET
Table 'Malzovia III' 6-max Seat #2 is the button
Seat 1: 1donkz0fks ($16.93 in chips) 
Seat 2: schoki77 ($4.57 in chips) 
Seat 3: ildar87kzn ($10 in chips) 
Seat 4: fraternitati ($10 in chips) 
Seat 5: Brian2471 ($4.90 in chips) 
Seat 6: starii13 ($10 in chips) 
ildar87kzn: posts small blind $0.05
fraternitati: posts big blind $0.10
*** HOLE CARDS ***
Brian2471: folds 
starii13: raises $0.20 to $0.30
1donkz0fks: folds 
schoki77: calls $0.30
ildar87kzn: folds 
fraternitati: folds 
*** FLOP *** [8h 7s Ad]
starii13: checks 
schoki77: checks 
*** TURN *** [8h 7s Ad] [7h]
starii13: bets $0.27
schoki77: folds 
Uncalled bet ($0.27) returned to starii13
starii13 collected $0.72 from pot
starii13: doesn't show hand 
*** SUMMARY ***
Total pot $0.75 | Rake $0.03 
Board [8h 7s Ad 7h]
Seat 1: 1donkz0fks folded before Flop (didn't bet)
Seat 2: schoki77 (button) folded on the Turn
Seat 3: ildar87kzn (small blind) folded before Flop
Seat 4: fraternitati (big blind) folded before Flop
Seat 5: Brian2471 folded before Flop (didn't bet)
Seat 6: starii13 collected ($0.72)



PokerStars Hand #222942242425:  Hold'em No Limit ($0.05/$0.10 USD) - 2021/01/23 22:03:02 ET
Table 'Malzovia III' 6-max Seat #3 is the button
Seat 1: 1donkz0fks ($16.93 in chips) 
Seat 2: schoki77 ($4.27 in chips) 
Seat 3: ildar87kzn ($10 in chips) 
Seat 4: fraternitati ($9.90 in chips) 
Seat 5: Brian2471 ($4.90 in chips) 
Seat 6: starii13 ($10.42 in chips) 
fraternitati: posts small blind $0.05
Brian2471: posts big blind $0.10
*** HOLE CARDS ***
starii13: folds 
1donkz0fks: folds 
schoki77: folds 
ildar87kzn: folds 
fraternitati: raises $0.20 to $0.30
starii13 leaves the table
Brian2471: raises $0.30 to $0.60
fraternitati: calls $0.30
*** FLOP *** [Js 6h Ts]
fraternitati: checks 
Brian2471: checks 
*** TURN *** [Js 6h Ts] [3c]
fraternitati: checks 
Brian2471: bets $0.40
fraternitati: calls $0.40
*** RIVER *** [Js 6h Ts 3c] [Jd]
fraternitati: checks 
Brian2471: bets $0.95
fraternitati: calls $0.95
*** SHOW DOWN ***
Brian2471: shows [Jc Jh] (four of a kind, Jacks)
fraternitati: mucks hand 
Brian2471 collected $3.72 from pot
*** SUMMARY ***
Total pot $3.90 | Rake $0.18 
Board [Js 6h Ts 3c Jd]
Seat 1: 1donkz0fks folded before Flop (didn't bet)
Seat 2: schoki77 folded before Flop (didn't bet)
Seat 3: ildar87kzn (button) folded before Flop (didn't bet)
Seat 4: fraternitati (small blind) mucked
Seat 5: Brian2471 (big blind) showed [Jc Jh] and won ($3.72) with four of a kind, Jacks
Seat 6: starii13 folded before Flop (didn't bet)



PokerStars Hand #222942267298:  Hold'em No Limit ($0.05/$0.10 USD) - 2021/01/23 22:04:07 ET
Table 'Malzovia III' 6-max Seat #4 is the button
Seat 1: 1donkz0fks ($16.93 in chips) 
Seat 2: schoki77 ($4.27 in chips) 
Seat 3: ildar87kzn ($10 in chips) 
Seat 4: fraternitati ($7.95 in chips) 
Seat 5: Brian2471 ($6.67 in chips) 
Brian2471: posts small blind $0.05
1donkz0fks: posts big blind $0.10
*** HOLE CARDS ***
schoki77: folds 
ildar87kzn: folds 
fraternitati: folds 
Brian2471: folds 
Uncalled bet ($0.05) returned to 1donkz0fks
1donkz0fks collected $0.10 from pot
1donkz0fks: doesn't show hand 
*** SUMMARY ***
Total pot $0.10 | Rake $0 
Seat 1: 1donkz0fks (big blind) collected ($0.10)
Seat 2: schoki77 folded before Flop (didn't bet)
Seat 3: ildar87kzn folded before Flop (didn't bet)
Seat 4: fraternitati (button) folded before Flop (didn't bet)
Seat 5: Brian2471 (small blind) folded before Flop



PokerStars Hand #222942275226:  Hold'em No Limit ($0.05/$0.10 USD) - 2021/01/23 22:04:28 ET
Table 'Malzovia III' 6-max Seat #5 is the button
Seat 1: 1donkz0fks ($16.98 in chips) 
Seat 2: schoki77 ($4.27 in chips) 
Seat 3: ildar87kzn ($10 in chips) 
Seat 4: fraternitati ($7.95 in chips) 
Seat 5: Brian2471 ($6.62 in chips) 
1donkz0fks: posts small blind $0.05
schoki77: posts big blind $0.10
*** HOLE CARDS ***
PokerDroop joins the table at seat #6 
ildar87kzn: folds 
fraternitati: folds 
Brian2471: calls $0.10
1donkz0fks: folds 
schoki77: checks 
*** FLOP *** [4d 5c Tc]
schoki77: checks 
Brian2471: checks 
*** TURN *** [4d 5c Tc] [Td]
schoki77: checks 
Brian2471: checks 
*** RIVER *** [4d 5c Tc Td] [Ts]
schoki77: checks 
Brian2471: checks 
*** SHOW DOWN ***
schoki77: shows [6s 9c] (three of a kind, Tens)
Brian2471: shows [Qh 3h] (three of a kind, Tens - Queen kicker)
Brian2471 collected $0.24 from pot
*** SUMMARY ***
Total pot $0.25 | Rake $0.01 
Board [4d 5c Tc Td Ts]
Seat 1: 1donkz0fks (small blind) folded before Flop
Seat 2: schoki77 (big blind) showed [6s 9c] and lost with three of a kind, Tens
Seat 3: ildar87kzn folded before Flop (didn't bet)
Seat 4: fraternitati folded before Flop (didn't bet)
Seat 5: Brian2471 (button) showed [Qh 3h] and won ($0.24) with three of a kind, Tens



PokerStars Hand #222942293779:  Hold'em No Limit ($0.05/$0.10 USD) - 2021/01/23 22:05:15 ET
Table 'Malzovia III' 6-max Seat #1 is the button
Seat 1: 1donkz0fks ($16.93 in chips) 
Seat 2: schoki77 ($4.17 in chips) 
Seat 3: ildar87kzn ($10 in chips) 
Seat 4: fraternitati ($7.95 in chips) 
Seat 5: Brian2471 ($6.76 in chips) 
schoki77: posts small blind $0.05
ildar87kzn: posts big blind $0.10
PokerDroop: sits out 
*** HOLE CARDS ***
fraternitati: folds 
Brian2471: folds 
1donkz0fks: folds 
schoki77: folds 
Uncalled bet ($0.05) returned to ildar87kzn
ildar87kzn collected $0.10 from pot
ildar87kzn: doesn't show hand 
*** SUMMARY ***
Total pot $0.10 | Rake $0 
Seat 1: 1donkz0fks (button) folded before Flop (didn't bet)
Seat 2: schoki77 (small blind) folded before Flop
Seat 3: ildar87kzn (big blind) collected ($0.10)
Seat 4: fraternitati folded before Flop (didn't bet)
Seat 5: Brian2471 folded before Flop (didn't bet)



PokerStars Hand #222942300486:  Hold'em No Limit ($0.05/$0.10 USD) - 2021/01/23 22:05:33 ET
Table 'Malzovia III' 6-max Seat #2 is the button
Seat 1: 1donkz0fks ($16.93 in chips) 
Seat 2: schoki77 ($4.12 in chips) 
Seat 3: ildar87kzn ($10.05 in chips) 
Seat 4: fraternitati ($7.95 in chips) 
Seat 5: Brian2471 ($6.76 in chips) 
ildar87kzn: posts small blind $0.05
fraternitati: posts big blind $0.10
PokerDroop: sits out 
*** HOLE CARDS ***
Brian2471: folds 
1donkz0fks: folds 
schoki77: raises $0.20 to $0.30
ildar87kzn: folds 
fraternitati: calls $0.20
*** FLOP *** [7d Ks 6s]
fraternitati: checks 
schoki77: bets $0.31
fraternitati: folds 
Uncalled bet ($0.31) returned to schoki77
schoki77 collected $0.62 from pot
schoki77: doesn't show hand 
*** SUMMARY ***
Total pot $0.65 | Rake $0.03 
Board [7d Ks 6s]
Seat 1: 1donkz0fks folded before Flop (didn't bet)
Seat 2: schoki77 (button) collected ($0.62)
Seat 3: ildar87kzn (small blind) folded before Flop
Seat 4: fraternitati (big blind) folded on the Flop
Seat 5: Brian2471 folded before Flop (didn't bet)



PokerStars Hand #222942308072:  Hold'em No Limit ($0.05/$0.10 USD) - 2021/01/23 22:05:53 ET
Table 'Malzovia III' 6-max Seat #3 is the button
Seat 1: 1donkz0fks ($16.93 in chips) 
Seat 2: schoki77 ($4.44 in chips) 
Seat 3: ildar87kzn ($10 in chips) 
Seat 4: fraternitati ($7.65 in chips) 
Seat 5: Brian2471 ($6.76 in chips) 
fraternitati: posts small blind $0.05
Brian2471: posts big blind $0.10
PokerDroop: sits out 
*** HOLE CARDS ***
1donkz0fks: folds 
schoki77: folds 
ildar87kzn: folds 
fraternitati: folds 
Uncalled bet ($0.05) returned to Brian2471
Brian2471 collected $0.10 from pot
Brian2471: doesn't show hand 
*** SUMMARY ***
Total pot $0.10 | Rake $0 
Seat 1: 1donkz0fks folded before Flop (didn't bet)
Seat 2: schoki77 folded before Flop (didn't bet)
Seat 3: ildar87kzn (button) folded before Flop (didn't bet)
Seat 4: fraternitati (small blind) folded before Flop
Seat 5: Brian2471 (big blind) collected ($0.10)



PokerStars Hand #222942313633:  Hold'em No Limit ($0.05/$0.10 USD) - 2021/01/23 22:06:08 ET
Table 'Malzovia III' 6-max Seat #4 is the button
Seat 1: 1donkz0fks ($16.93 in chips) 
Seat 2: schoki77 ($4.44 in chips) 
Seat 3: ildar87kzn ($10 in chips) 
Seat 4: fraternitati ($10 in chips) 
Seat 5: Brian2471 ($6.81 in chips) 
Seat 6: PokerDroop ($10 in chips) 
Brian2471: posts small blind $0.05
PokerDroop: posts big blind $0.10
*** HOLE CARDS ***
1donkz0fks: folds 
schoki77: folds 
ildar87kzn: folds 
fraternitati: folds 
Brian2471: calls $0.05
PokerDroop: checks 
*** FLOP *** [Qs 7s 5h]
Brian2471: checks 
PokerDroop: bets $0.10
Brian2471: calls $0.10
*** TURN *** [Qs 7s 5h] [6d]
Brian2471: checks 
PokerDroop: bets $0.20
Brian2471: raises $0.30 to $0.50
PokerDroop: folds 
Uncalled bet ($0.30) returned to Brian2471
Brian2471 collected $0.76 from pot
Brian2471: doesn't show hand 
*** SUMMARY ***
Total pot $0.80 | Rake $0.04 
Board [Qs 7s 5h 6d]
Seat 1: 1donkz0fks folded before Flop (didn't bet)
Seat 2: schoki77 folded before Flop (didn't bet)
Seat 3: ildar87kzn folded before Flop (didn't bet)
Seat 4: fraternitati (button) folded before Flop (didn't bet)
Seat 5: Brian2471 (small blind) collected ($0.76)
Seat 6: PokerDroop (big blind) folded on the Turn



PokerStars Hand #222942340509:  Hold'em No Limit ($0.05/$0.10 USD) - 2021/01/23 22:07:10 ET
Table 'Malzovia III' 6-max Seat #5 is the button
Seat 1: 1donkz0fks ($16.93 in chips) 
Seat 2: schoki77 ($4.44 in chips) 
Seat 3: ildar87kzn ($10 in chips) 
Seat 4: fraternitati ($10 in chips) 
Seat 5: Brian2471 ($7.17 in chips) 
Seat 6: PokerDroop ($9.60 in chips) 
PokerDroop: posts small blind $0.05
1donkz0fks: posts big blind $0.10
*** HOLE CARDS ***
schoki77: folds 
ildar87kzn: folds 
fraternitati: folds 
Brian2471 has timed out
Brian2471: folds 
PokerDroop: folds 
Uncalled bet ($0.05) returned to 1donkz0fks
1donkz0fks collected $0.10 from pot
1donkz0fks: doesn't show hand 
*** SUMMARY ***
Total pot $0.10 | Rake $0 
Seat 1: 1donkz0fks (big blind) collected ($0.10)
Seat 2: schoki77 folded before Flop (didn't bet)
Seat 3: ildar87kzn folded before Flop (didn't bet)
Seat 4: fraternitati folded before Flop (didn't bet)
Seat 5: Brian2471 (button) folded before Flop (didn't bet)
Seat 6: PokerDroop (small blind) folded before Flop



PokerStars Hand #222942355048:  Hold'em No Limit ($0.05/$0.10 USD) - 2021/01/23 22:07:48 ET
Table 'Malzovia III' 6-max Seat #6 is the button
Seat 1: 1donkz0fks ($16.98 in chips) 
Seat 2: schoki77 ($4.44 in chips) 
Seat 3: ildar87kzn ($10 in chips) 
Seat 4: fraternitati ($10 in chips) 
Seat 5: Brian2471 ($7.17 in chips) 
Seat 6: PokerDroop ($9.95 in chips) 
1donkz0fks: posts small blind $0.05
schoki77: posts big blind $0.10
*** HOLE CARDS ***
ildar87kzn: raises $0.20 to $0.30
fraternitati: folds 
Brian2471: calls $0.30
PokerDroop: folds 
1donkz0fks: folds 
schoki77: folds 
*** FLOP *** [3h 6s Jd]
ildar87kzn: checks 
Brian2471: bets $0.30
ildar87kzn: calls $0.30
*** TURN *** [3h 6s Jd] [Jh]
ildar87kzn: checks 
Brian2471: checks 
*** RIVER *** [3h 6s Jd Jh] [8s]
ildar87kzn: checks 
Brian2471: bets $0.74
ildar87kzn: folds 
Uncalled bet ($0.74) returned to Brian2471
Brian2471 collected $1.29 from pot
Brian2471: doesn't show hand 
*** SUMMARY ***
Total pot $1.35 | Rake $0.06 
Board [3h 6s Jd Jh 8s]
Seat 1: 1donkz0fks (small blind) folded before Flop
Seat 2: schoki77 (big blind) folded before Flop
Seat 3: ildar87kzn folded on the River
Seat 4: fraternitati folded before Flop (didn't bet)
Seat 5: Brian2471 collected ($1.29)
Seat 6: PokerDroop (button) folded before Flop (didn't bet)



PokerStars Hand #222942385619:  Hold'em No Limit ($0.05/$0.10 USD) - 2021/01/23 22:09:07 ET
Table 'Malzovia III' 6-max Seat #1 is the button
Seat 1: 1donkz0fks ($16.93 in chips) 
Seat 2: schoki77 ($4.34 in chips) 
Seat 3: ildar87kzn ($10 in chips) 
Seat 4: fraternitati ($10 in chips) 
Seat 5: Brian2471 ($7.86 in chips) 
Seat 6: PokerDroop ($9.95 in chips) 
schoki77: posts small blind $0.05
ildar87kzn: posts big blind $0.10
*** HOLE CARDS ***
fraternitati: raises $0.15 to $0.25
Brian2471: folds 
PokerDroop: folds 
1donkz0fks: calls $0.25
schoki77: calls $0.20
ildar87kzn has timed out
ildar87kzn: folds 
*** FLOP *** [8c 5c Kd]
schoki77: checks 
fraternitati: checks 
1donkz0fks: bets $0.61
schoki77: folds 
fraternitati: folds 
Uncalled bet ($0.61) returned to 1donkz0fks
1donkz0fks collected $0.81 from pot
1donkz0fks: doesn't show hand 
*** SUMMARY ***
Total pot $0.85 | Rake $0.04 
Board [8c 5c Kd]
Seat 1: 1donkz0fks (button) collected ($0.81)
Seat 2: schoki77 (small blind) folded on the Flop
Seat 3: ildar87kzn (big blind) folded before Flop
Seat 4: fraternitati folded on the Flop
Seat 5: Brian2471 folded before Flop (didn't bet)
Seat 6: PokerDroop folded before Flop (didn't bet)



PokerStars Hand #222942413766:  Hold'em No Limit ($0.05/$0.10 USD) - 2021/01/23 22:10:08 ET
Table 'Malzovia III' 6-max Seat #2 is the button
Seat 1: 1donkz0fks ($17.49 in chips) 
Seat 2: schoki77 ($4.09 in chips) 
Seat 4: fraternitati ($9.75 in chips) 
Seat 5: Brian2471 ($7.86 in chips) 
Seat 6: PokerDroop ($9.95 in chips) 
fraternitati: posts small blind $0.05
Brian2471: posts big blind $0.10
*** HOLE CARDS ***
PokerDroop: folds 
1donkz0fks: folds 
schoki77: folds 
fraternitati: raises $0.10 to $0.20
Brian2471: calls $0.10
*** FLOP *** [Kd 4c Ad]
fraternitati: bets $0.19
Brian2471: folds 
Uncalled bet ($0.19) returned to fraternitati
fraternitati collected $0.38 from pot
fraternitati: doesn't show hand 
*** SUMMARY ***
Total pot $0.40 | Rake $0.02 
Board [Kd 4c Ad]
Seat 1: 1donkz0fks folded before Flop (didn't bet)
Seat 2: schoki77 (button) folded before Flop (didn't bet)
Seat 4: fraternitati (small blind) collected ($0.38)
Seat 5: Brian2471 (big blind) folded on the Flop
Seat 6: PokerDroop folded before Flop (didn't bet)



PokerStars Hand #222942431712:  Hold'em No Limit ($0.05/$0.10 USD) - 2021/01/23 22:10:47 ET
Table 'Malzovia III' 6-max Seat #4 is the button
Seat 1: 1donkz0fks ($17.49 in chips) 
Seat 2: schoki77 ($4.09 in chips) 
Seat 4: fraternitati ($9.93 in chips) 
Seat 5: Brian2471 ($7.66 in chips) 
Seat 6: PokerDroop ($9.95 in chips) 
Brian2471: posts small blind $0.05
PokerDroop: posts big blind $0.10
ildar87kzn: sits out 
*** HOLE CARDS ***
1donkz0fks: raises $0.20 to $0.30
schoki77: folds 
fraternitati: folds 
Brian2471: folds 
PokerDroop: folds 
Uncalled bet ($0.20) returned to 1donkz0fks
1donkz0fks collected $0.25 from pot
1donkz0fks: doesn't show hand 
*** SUMMARY ***
Total pot $0.25 | Rake $0 
Seat 1: 1donkz0fks collected ($0.25)
Seat 2: schoki77 folded before Flop (didn't bet)
Seat 4: fraternitati (button) folded before Flop (didn't bet)
Seat 5: Brian2471 (small blind) folded before Flop
Seat 6: PokerDroop (big blind) folded before Flop



PokerStars Hand #222942438865:  Hold'em No Limit ($0.05/$0.10 USD) - 2021/01/23 22:11:06 ET
Table 'Malzovia III' 6-max Seat #5 is the button
Seat 1: 1donkz0fks ($17.64 in chips) 
Seat 2: schoki77 ($4.09 in chips) 
Seat 4: fraternitati ($9.93 in chips) 
Seat 5: Brian2471 ($7.61 in chips) 
Seat 6: PokerDroop ($9.85 in chips) 
PokerDroop: posts small blind $0.05
1donkz0fks: posts big blind $0.10
ildar87kzn: sits out 
*** HOLE CARDS ***
schoki77: calls $0.10
fraternitati: folds 
Brian2471: folds 
PokerDroop: calls $0.05
1donkz0fks: checks 
*** FLOP *** [Qd Ad As]
PokerDroop: checks 
1donkz0fks: checks 
schoki77: checks 
*** TURN *** [Qd Ad As] [Ac]
PokerDroop: bets $0.20
1donkz0fks: folds 
schoki77: calls $0.20
*** RIVER *** [Qd Ad As Ac] [8d]
PokerDroop: bets $0.40
schoki77: raises $1.60 to $2
PokerDroop: calls $1.60
*** SHOW DOWN ***
schoki77: shows [Jd Ah] (four of a kind, Aces)
PokerDroop: mucks hand 
schoki77 collected $4.49 from pot
*** SUMMARY ***
Total pot $4.70 | Rake $0.21 
Board [Qd Ad As Ac 8d]
Seat 1: 1donkz0fks (big blind) folded on the Turn
Seat 2: schoki77 showed [Jd Ah] and won ($4.49) with four of a kind, Aces
Seat 4: fraternitati folded before Flop (didn't bet)
Seat 5: Brian2471 (button) folded before Flop (didn't bet)
Seat 6: PokerDroop (small blind) mucked



PokerStars Hand #222942461634:  Hold'em No Limit ($0.05/$0.10 USD) - 2021/01/23 22:12:06 ET
Table 'Malzovia III' 6-max Seat #6 is the button
Seat 1: 1donkz0fks ($17.54 in chips) 
Seat 2: schoki77 ($6.28 in chips) 
Seat 4: fraternitati ($9.93 in chips) 
Seat 5: Brian2471 ($7.61 in chips) 
Seat 6: PokerDroop ($7.55 in chips) 
1donkz0fks: posts small blind $0.05
schoki77: posts big blind $0.10
ildar87kzn: sits out 
*** HOLE CARDS ***
fraternitati: folds 
Brian2471: raises $0.20 to $0.30
PokerDroop: calls $0.30
1donkz0fks: folds 
schoki77: calls $0.20
*** FLOP *** [8s Jc Th]
schoki77: checks 
Brian2471: bets $0.35
PokerDroop: calls $0.35
schoki77: folds 
*** TURN *** [8s Jc Th] [5h]
Brian2471: checks 
PokerDroop: checks 
*** RIVER *** [8s Jc Th 5h] [Kh]
Brian2471: bets $0.69
PokerDroop: calls $0.69
*** SHOW DOWN ***
Brian2471: shows [7s 8c] (a pair of Eights)
PokerDroop: shows [Qc Kd] (a pair of Kings)
PokerDroop collected $2.89 from pot
*** SUMMARY ***
Total pot $3.03 | Rake $0.14 
Board [8s Jc Th 5h Kh]
Seat 1: 1donkz0fks (small blind) folded before Flop
Seat 2: schoki77 (big blind) folded on the Flop
Seat 4: fraternitati folded before Flop (didn't bet)
Seat 5: Brian2471 showed [7s 8c] and lost with a pair of Eights
Seat 6: PokerDroop (button) showed [Qc Kd] and won ($2.89) with a pair of Kings



PokerStars Hand #222942486059:  Hold'em No Limit ($0.05/$0.10 USD) - 2021/01/23 22:13:11 ET
Table 'Malzovia III' 6-max Seat #1 is the button
Seat 1: 1donkz0fks ($17.49 in chips) 
Seat 2: schoki77 ($5.98 in chips) 
Seat 3: ildar87kzn ($10 in chips) 
Seat 4: fraternitati ($9.93 in chips) 
Seat 5: Brian2471 ($6.27 in chips) 
Seat 6: PokerDroop ($10 in chips) 
schoki77: posts small blind $0.05
ildar87kzn: posts big blind $0.10
*** HOLE CARDS ***
fraternitati: folds 
Brian2471: calls $0.10
PokerDroop: folds 
1donkz0fks: folds 
schoki77: calls $0.05
ildar87kzn: checks 
*** FLOP *** [3c Jh 8h]
schoki77: checks 
ildar87kzn: checks 
Brian2471: checks 
*** TURN *** [3c Jh 8h] [5d]
schoki77: checks 
ildar87kzn: checks 
Brian2471: checks 
*** RIVER *** [3c Jh 8h 5d] [3h]
schoki77: checks 
ildar87kzn: checks 
Brian2471: checks 
*** SHOW DOWN ***
schoki77: shows [5c Kd] (two pair, Fives and Threes)
ildar87kzn: mucks hand 
Brian2471: mucks hand 
schoki77 collected $0.29 from pot
*** SUMMARY ***
Total pot $0.30 | Rake $0.01 
Board [3c Jh 8h 5d 3h]
Seat 1: 1donkz0fks (button) folded before Flop (didn't bet)
Seat 2: schoki77 (small blind) showed [5c Kd] and won ($0.29) with two pair, Fives and Threes
Seat 3: ildar87kzn (big blind) mucked
Seat 4: fraternitati folded before Flop (didn't bet)
Seat 5: Brian2471 mucked
Seat 6: PokerDroop folded before Flop (didn't bet)



PokerStars Hand #222942505230:  Hold'em No Limit ($0.05/$0.10 USD) - 2021/01/23 22:14:02 ET
Table 'Malzovia III' 6-max Seat #2 is the button
Seat 1: 1donkz0fks ($17.49 in chips) 
Seat 2: schoki77 ($6.17 in chips) 
Seat 3: ildar87kzn ($10 in chips) 
Seat 4: fraternitati ($9.93 in chips) 
Seat 5: Brian2471 ($6.17 in chips) 
Seat 6: PokerDroop ($10 in chips) 
ildar87kzn: posts small blind $0.05
fraternitati: posts big blind $0.10
*** HOLE CARDS ***
Brian2471: folds 
Brian2471 leaves the table
PokerDroop: folds 
1donkz0fks: folds 
schoki77: raises $0.20 to $0.30
JaydaKizz joins the table at seat #5 
ildar87kzn: folds 
fraternitati: calls $0.20
*** FLOP *** [3h As 5s]
fraternitati: checks 
schoki77: bets $0.31
fraternitati: calls $0.31
*** TURN *** [3h As 5s] [Ac]
fraternitati: checks 
schoki77: checks 
*** RIVER *** [3h As 5s Ac] [5h]
fraternitati: checks 
schoki77: checks 
*** SHOW DOWN ***
fraternitati: shows [3s Ts] (two pair, Aces and Fives)
schoki77: shows [Qh Ks] (two pair, Aces and Fives - King kicker)
schoki77 collected $1.21 from pot
*** SUMMARY ***
Total pot $1.27 | Rake $0.06 
Board [3h As 5s Ac 5h]
Seat 1: 1donkz0fks folded before Flop (didn't bet)
Seat 2: schoki77 (button) showed [Qh Ks] and won ($1.21) with two pair, Aces and Fives
Seat 3: ildar87kzn (small blind) folded before Flop
Seat 4: fraternitati (big blind) showed [3s Ts] and lost with two pair, Aces and Fives
Seat 5: Brian2471 folded before Flop (didn't bet)
Seat 6: PokerDroop folded before Flop (didn't bet)



PokerStars Hand #222942518497:  Hold'em No Limit ($0.05/$0.10 USD) - 2021/01/23 22:14:38 ET
Table 'Malzovia III' 6-max Seat #3 is the button
Seat 1: 1donkz0fks ($17.49 in chips) 
Seat 2: schoki77 ($6.77 in chips) 
Seat 3: ildar87kzn ($10 in chips) 
Seat 4: fraternitati ($9.32 in chips) 
Seat 5: JaydaKizz ($4.21 in chips) 
Seat 6: PokerDroop ($10 in chips) 
fraternitati: posts small blind $0.05
JaydaKizz: posts big blind $0.10
*** HOLE CARDS ***
PokerDroop: folds 
1donkz0fks: folds 
schoki77: folds 
ildar87kzn: raises $0.20 to $0.30
fraternitati: calls $0.25
JaydaKizz: folds 
*** FLOP *** [7h 5d Td]
fraternitati: checks 
ildar87kzn: bets $0.34
fraternitati: calls $0.34
*** TURN *** [7h 5d Td] [4d]
fraternitati: checks 
ildar87kzn: bets $0.86
fraternitati: raises $7.82 to $8.68 and is all-in
ildar87kzn: folds 
Uncalled bet ($7.82) returned to fraternitati
fraternitati collected $2.96 from pot
fraternitati: doesn't show hand 
*** SUMMARY ***
Total pot $3.10 | Rake $0.14 
Board [7h 5d Td 4d]
Seat 1: 1donkz0fks folded before Flop (didn't bet)
Seat 2: schoki77 folded before Flop (didn't bet)
Seat 3: ildar87kzn (button) folded on the Turn
Seat 4: fraternitati (small blind) collected ($2.96)
Seat 5: JaydaKizz (big blind) folded before Flop
Seat 6: PokerDroop folded before Flop (didn't bet)



PokerStars Hand #222942536701:  Hold'em No Limit ($0.05/$0.10 USD) - 2021/01/23 22:15:20 ET
Table 'Malzovia III' 6-max Seat #4 is the button
Seat 1: 1donkz0fks ($17.49 in chips) 
Seat 2: schoki77 ($6.77 in chips) 
Seat 3: ildar87kzn ($10 in chips) 
Seat 4: fraternitati ($10.78 in chips) 
Seat 5: JaydaKizz ($4.11 in chips) 
Seat 6: PokerDroop ($10 in chips) 
JaydaKizz: posts small blind $0.05
PokerDroop: posts big blind $0.10
*** HOLE CARDS ***
1donkz0fks: folds 
schoki77: folds 
ildar87kzn: folds 
fraternitati: raises $0.20 to $0.30
JaydaKizz: calls $0.25
PokerDroop: calls $0.20
*** FLOP *** [7s Jc 9d]
JaydaKizz: bets $0.43
PokerDroop: folds 
fraternitati: calls $0.43
*** TURN *** [7s Jc 9d] [Jd]
JaydaKizz: bets $0.84
fraternitati: calls $0.84
*** RIVER *** [7s Jc 9d Jd] [8d]
JaydaKizz: bets $2.54 and is all-in
fraternitati: folds 
Uncalled bet ($2.54) returned to JaydaKizz
JaydaKizz collected $3.29 from pot
JaydaKizz: doesn't show hand 
*** SUMMARY ***
Total pot $3.44 | Rake $0.15 
Board [7s Jc 9d Jd 8d]
Seat 1: 1donkz0fks folded before Flop (didn't bet)
Seat 2: schoki77 folded before Flop (didn't bet)
Seat 3: ildar87kzn folded before Flop (didn't bet)
Seat 4: fraternitati (button) folded on the River
Seat 5: JaydaKizz (small blind) collected ($3.29)
Seat 6: PokerDroop (big blind) folded on the Flop



PokerStars Hand #222942558801:  Hold'em No Limit ($0.05/$0.10 USD) - 2021/01/23 22:16:19 ET
Table 'Malzovia III' 6-max Seat #5 is the button
Seat 1: 1donkz0fks ($17.49 in chips) 
Seat 2: schoki77 ($6.77 in chips) 
Seat 3: ildar87kzn ($10 in chips) 
Seat 4: fraternitati ($9.21 in chips) 
Seat 5: JaydaKizz ($5.83 in chips) 
Seat 6: PokerDroop ($9.70 in chips) 
PokerDroop: posts small blind $0.05
1donkz0fks: posts big blind $0.10
*** HOLE CARDS ***
schoki77: calls $0.10
ildar87kzn: folds 
fraternitati: folds 
JaydaKizz: folds 
PokerDroop: folds 
1donkz0fks: checks 
*** FLOP *** [As Kh 6s]
1donkz0fks: checks 
schoki77: bets $0.10
1donkz0fks: folds 
Uncalled bet ($0.10) returned to schoki77
schoki77 collected $0.24 from pot
schoki77: doesn't show hand 
*** SUMMARY ***
Total pot $0.25 | Rake $0.01 
Board [As Kh 6s]
Seat 1: 1donkz0fks (big blind) folded on the Flop
Seat 2: schoki77 collected ($0.24)
Seat 3: ildar87kzn folded before Flop (didn't bet)
Seat 4: fraternitati folded before Flop (didn't bet)
Seat 5: JaydaKizz (button) folded before Flop (didn't bet)
Seat 6: PokerDroop (small blind) folded before Flop



PokerStars Hand #222942571374:  Hold'em No Limit ($0.05/$0.10 USD) - 2021/01/23 22:16:53 ET
Table 'Malzovia III' 6-max Seat #6 is the button
Seat 1: 1donkz0fks ($17.39 in chips) 
Seat 2: schoki77 ($6.91 in chips) 
Seat 3: ildar87kzn ($10 in chips) 
Seat 4: fraternitati ($9.21 in chips) 
Seat 5: JaydaKizz ($5.83 in chips) 
Seat 6: PokerDroop ($9.65 in chips) 
1donkz0fks: posts small blind $0.05
schoki77: posts big blind $0.10
*** HOLE CARDS ***
ildar87kzn: folds 
fraternitati: raises $0.15 to $0.25
JaydaKizz: folds 
PokerDroop: calls $0.25
1donkz0fks: folds 
schoki77: folds 
*** FLOP *** [4c 2d Qc]
fraternitati: bets $0.31
PokerDroop: calls $0.31
*** TURN *** [4c 2d Qc] [8s]
fraternitati: checks 
PokerDroop: bets $0.60
fraternitati: folds 
Uncalled bet ($0.60) returned to PokerDroop
PokerDroop collected $1.21 from pot
PokerDroop: doesn't show hand 
*** SUMMARY ***
Total pot $1.27 | Rake $0.06 
Board [4c 2d Qc 8s]
Seat 1: 1donkz0fks (small blind) folded before Flop
Seat 2: schoki77 (big blind) folded before Flop
Seat 3: ildar87kzn folded before Flop (didn't bet)
Seat 4: fraternitati folded on the Turn
Seat 5: JaydaKizz folded before Flop (didn't bet)
Seat 6: PokerDroop (button) collected ($1.21)



PokerStars Hand #222942584085:  Hold'em No Limit ($0.05/$0.10 USD) - 2021/01/23 22:17:26 ET
Table 'Malzovia III' 6-max Seat #1 is the button
Seat 1: 1donkz0fks ($17.34 in chips) 
Seat 2: schoki77 ($6.81 in chips) 
Seat 3: ildar87kzn ($10 in chips) 
Seat 4: fraternitati ($8.65 in chips) 
Seat 5: JaydaKizz ($5.83 in chips) 
Seat 6: PokerDroop ($10.30 in chips) 
schoki77: posts small blind $0.05
ildar87kzn: posts big blind $0.10
*** HOLE CARDS ***
fraternitati: folds 
JaydaKizz: folds 
PokerDroop: folds 
1donkz0fks: folds 
schoki77: calls $0.05
ildar87kzn: checks 
*** FLOP *** [4h Jc 9h]
schoki77: bets $0.10
ildar87kzn: folds 
Uncalled bet ($0.10) returned to schoki77
schoki77 collected $0.19 from pot
schoki77: doesn't show hand 
*** SUMMARY ***
Total pot $0.20 | Rake $0.01 
Board [4h Jc 9h]
Seat 1: 1donkz0fks (button) folded before Flop (didn't bet)
Seat 2: schoki77 (small blind) collected ($0.19)
Seat 3: ildar87kzn (big blind) folded on the Flop
Seat 4: fraternitati folded before Flop (didn't bet)
Seat 5: JaydaKizz folded before Flop (didn't bet)
Seat 6: PokerDroop folded before Flop (didn't bet)



PokerStars Hand #222942596886:  Hold'em No Limit ($0.05/$0.10 USD) - 2021/01/23 22:18:01 ET
Table 'Malzovia III' 6-max Seat #2 is the button
Seat 1: 1donkz0fks ($17.34 in chips) 
Seat 2: schoki77 ($6.90 in chips) 
Seat 3: ildar87kzn ($10 in chips) 
Seat 4: fraternitati ($8.65 in chips) 
Seat 5: JaydaKizz ($5.83 in chips) 
Seat 6: PokerDroop ($10.30 in chips) 
ildar87kzn: posts small blind $0.05
fraternitati: posts big blind $0.10
*** HOLE CARDS ***
JaydaKizz: raises $0.10 to $0.20
PokerDroop: folds 
1donkz0fks: calls $0.20
schoki77: folds 
ildar87kzn: folds 
fraternitati: folds 
*** FLOP *** [Kd 7d 3c]
JaydaKizz: bets $0.27
1donkz0fks: calls $0.27
*** TURN *** [Kd 7d 3c] [Jh]
JaydaKizz: checks 
1donkz0fks: checks 
*** RIVER *** [Kd 7d 3c Jh] [4s]
JaydaKizz: checks 
1donkz0fks: checks 
*** SHOW DOWN ***
JaydaKizz: shows [Ah Qc] (high card Ace)
1donkz0fks: shows [5s 5h] (a pair of Fives)
1donkz0fks collected $1.04 from pot
*** SUMMARY ***
Total pot $1.09 | Rake $0.05 
Board [Kd 7d 3c Jh 4s]
Seat 1: 1donkz0fks showed [5s 5h] and won ($1.04) with a pair of Fives
Seat 2: schoki77 (button) folded before Flop (didn't bet)
Seat 3: ildar87kzn (small blind) folded before Flop
Seat 4: fraternitati (big blind) folded before Flop
Seat 5: JaydaKizz showed [Ah Qc] and lost with high card Ace
Seat 6: PokerDroop folded before Flop (didn't bet)



PokerStars Hand #222942619216:  Hold'em No Limit ($0.05/$0.10 USD) - 2021/01/23 22:18:40 ET
Table 'Malzovia III' 6-max Seat #3 is the button
Seat 1: 1donkz0fks ($17.91 in chips) 
Seat 2: schoki77 ($6.90 in chips) 
Seat 3: ildar87kzn ($10 in chips) 
Seat 4: fraternitati ($8.55 in chips) 
Seat 5: JaydaKizz ($5.36 in chips) 
Seat 6: PokerDroop ($10.30 in chips) 
fraternitati: posts small blind $0.05
JaydaKizz: posts big blind $0.10
*** HOLE CARDS ***
PokerDroop: folds 
1donkz0fks: raises $0.20 to $0.30
schoki77: calls $0.30
ildar87kzn: folds 
fraternitati: calls $0.25
JaydaKizz: calls $0.20
*** FLOP *** [Td 4s Ac]
fraternitati: checks 
JaydaKizz: checks 
1donkz0fks: bets $0.70
schoki77: folds 
fraternitati: calls $0.70
JaydaKizz: folds 
*** TURN *** [Td 4s Ac] [Jh]
fraternitati: checks 
1donkz0fks: checks 
*** RIVER *** [Td 4s Ac Jh] [9s]
fraternitati: checks 
1donkz0fks: checks 
*** SHOW DOWN ***
fraternitati: shows [5c As] (a pair of Aces)
1donkz0fks: shows [Qs Ah] (a pair of Aces - Queen kicker)
1donkz0fks collected $2.48 from pot
*** SUMMARY ***
Total pot $2.60 | Rake $0.12 
Board [Td 4s Ac Jh 9s]
Seat 1: 1donkz0fks showed [Qs Ah] and won ($2.48) with a pair of Aces
Seat 2: schoki77 folded on the Flop
Seat 3: ildar87kzn (button) folded before Flop (didn't bet)
Seat 4: fraternitati (small blind) showed [5c As] and lost with a pair of Aces
Seat 5: JaydaKizz (big blind) folded on the Flop
Seat 6: PokerDroop folded before Flop (didn't bet)



PokerStars Hand #222942637727:  Hold'em No Limit ($0.05/$0.10 USD) - 2021/01/23 22:19:29 ET
Table 'Malzovia III' 6-max Seat #4 is the button
Seat 1: 1donkz0fks ($19.39 in chips) 
Seat 2: schoki77 ($6.60 in chips) 
Seat 3: ildar87kzn ($10 in chips) 
Seat 4: fraternitati ($7.55 in chips) 
Seat 5: JaydaKizz ($5.06 in chips) 
Seat 6: PokerDroop ($10.30 in chips) 
JaydaKizz: posts small blind $0.05
PokerDroop: posts big blind $0.10
*** HOLE CARDS ***
1donkz0fks: folds 
schoki77: folds 
ildar87kzn: raises $0.20 to $0.30
fraternitati: folds 
JaydaKizz: folds 
PokerDroop: folds 
Uncalled bet ($0.20) returned to ildar87kzn
ildar87kzn collected $0.25 from pot
ildar87kzn: doesn't show hand 
*** SUMMARY ***
Total pot $0.25 | Rake $0 
Seat 1: 1donkz0fks folded before Flop (didn't bet)
Seat 2: schoki77 folded before Flop (didn't bet)
Seat 3: ildar87kzn collected ($0.25)
Seat 4: fraternitati (button) folded before Flop (didn't bet)
Seat 5: JaydaKizz (small blind) folded before Flop
Seat 6: PokerDroop (big blind) folded before Flop



PokerStars Hand #222942644456:  Hold'em No Limit ($0.05/$0.10 USD) - 2021/01/23 22:19:47 ET
Table 'Malzovia III' 6-max Seat #5 is the button
Seat 1: 1donkz0fks ($19.39 in chips) 
Seat 2: schoki77 ($6.60 in chips) 
Seat 3: ildar87kzn ($10.15 in chips) 
Seat 4: fraternitati ($7.55 in chips) 
Seat 5: JaydaKizz ($5.01 in chips) 
Seat 6: PokerDroop ($10.20 in chips) 
PokerDroop: posts small blind $0.05
1donkz0fks: posts big blind $0.10
*** HOLE CARDS ***
schoki77: folds 
ildar87kzn: folds 
fraternitati: folds 
JaydaKizz: folds 
PokerDroop: folds 
Uncalled bet ($0.05) returned to 1donkz0fks
1donkz0fks collected $0.10 from pot
1donkz0fks: doesn't show hand 
*** SUMMARY ***
Total pot $0.10 | Rake $0 
Seat 1: 1donkz0fks (big blind) collected ($0.10)
Seat 2: schoki77 folded before Flop (didn't bet)
Seat 3: ildar87kzn folded before Flop (didn't bet)
Seat 4: fraternitati folded before Flop (didn't bet)
Seat 5: JaydaKizz (button) folded before Flop (didn't bet)
Seat 6: PokerDroop (small blind) folded before Flop



PokerStars Hand #222942649224:  Hold'em No Limit ($0.05/$0.10 USD) - 2021/01/23 22:20:00 ET
Table 'Malzovia III' 6-max Seat #6 is the button
Seat 1: 1donkz0fks ($19.44 in chips) 
Seat 2: schoki77 ($6.60 in chips) 
Seat 3: ildar87kzn ($10.15 in chips) 
Seat 4: fraternitati ($7.55 in chips) 
Seat 5: JaydaKizz ($5.01 in chips) 
Seat 6: PokerDroop ($10.15 in chips) 
1donkz0fks: posts small blind $0.05
schoki77: posts big blind $0.10
*** HOLE CARDS ***
ildar87kzn: raises $0.20 to $0.30
fraternitati: calls $0.30
JaydaKizz: folds 
PokerDroop: calls $0.30
1donkz0fks: calls $0.25
schoki77: folds 
*** FLOP *** [Kc Jc 7d]
1donkz0fks: checks 
ildar87kzn: checks 
fraternitati: checks 
PokerDroop: bets $0.80
1donkz0fks: folds 
ildar87kzn: folds 
fraternitati: folds 
Uncalled bet ($0.80) returned to PokerDroop
PokerDroop collected $1.24 from pot
PokerDroop: doesn't show hand 
*** SUMMARY ***
Total pot $1.30 | Rake $0.06 
Board [Kc Jc 7d]
Seat 1: 1donkz0fks (small blind) folded on the Flop
Seat 2: schoki77 (big blind) folded before Flop
Seat 3: ildar87kzn folded on the Flop
Seat 4: fraternitati folded on the Flop
Seat 5: JaydaKizz folded before Flop (didn't bet)
Seat 6: PokerDroop (button) collected ($1.24)



PokerStars Hand #222942669489:  Hold'em No Limit ($0.05/$0.10 USD) - 2021/01/23 22:20:55 ET
Table 'Malzovia III' 6-max Seat #1 is the button
Seat 1: 1donkz0fks ($19.14 in chips) 
Seat 2: schoki77 ($6.50 in chips) 
Seat 4: fraternitati ($7.25 in chips) 
Seat 5: JaydaKizz ($5.01 in chips) 
Seat 6: PokerDroop ($11.09 in chips) 
schoki77: posts small blind $0.05
ildar87kzn: is sitting out 
fraternitati: posts big blind $0.10
*** HOLE CARDS ***
JaydaKizz: calls $0.10
PokerDroop: folds 
1donkz0fks: raises $0.20 to $0.30
schoki77: folds 
fraternitati: calls $0.20
JaydaKizz: calls $0.20
*** FLOP *** [As 8d 6s]
fraternitati: checks 
JaydaKizz: checks 
1donkz0fks: checks 
*** TURN *** [As 8d 6s] [Ah]
fraternitati: bets $0.46
JaydaKizz: calls $0.46
1donkz0fks: folds 
*** RIVER *** [As 8d 6s Ah] [Qh]
fraternitati: bets $1.19
JaydaKizz: calls $1.19
*** SHOW DOWN ***
fraternitati: shows [Td 9c] (a pair of Aces)
JaydaKizz: shows [9s Ad] (three of a kind, Aces)
JaydaKizz collected $4.06 from pot
*** SUMMARY ***
Total pot $4.25 | Rake $0.19 
Board [As 8d 6s Ah Qh]
Seat 1: 1donkz0fks (button) folded on the Turn
Seat 2: schoki77 (small blind) folded before Flop
Seat 4: fraternitati (big blind) showed [Td 9c] and lost with a pair of Aces
Seat 5: JaydaKizz showed [9s Ad] and won ($4.06) with three of a kind, Aces
Seat 6: PokerDroop folded before Flop (didn't bet)



PokerStars Hand #222942687546:  Hold'em No Limit ($0.05/$0.10 USD) - 2021/01/23 22:21:43 ET
Table 'Malzovia III' 6-max Seat #2 is the button
Seat 1: 1donkz0fks ($18.84 in chips) 
Seat 2: schoki77 ($6.45 in chips) 
Seat 4: fraternitati ($5.30 in chips) 
Seat 5: JaydaKizz ($7.12 in chips) 
Seat 6: PokerDroop ($11.09 in chips) 
fraternitati: posts small blind $0.05
JaydaKizz: posts big blind $0.10
*** HOLE CARDS ***
PokerDroop: folds 
1donkz0fks: folds 
schoki77: folds 
fraternitati: raises $0.10 to $0.20
JaydaKizz: calls $0.10
*** FLOP *** [2s Ac Ad]
fraternitati: checks 
JaydaKizz: checks 
*** TURN *** [2s Ac Ad] [4d]
fraternitati: bets $0.19
JaydaKizz: folds 
Uncalled bet ($0.19) returned to fraternitati
fraternitati collected $0.38 from pot
fraternitati: doesn't show hand 
*** SUMMARY ***
Total pot $0.40 | Rake $0.02 
Board [2s Ac Ad 4d]
Seat 1: 1donkz0fks folded before Flop (didn't bet)
Seat 2: schoki77 (button) folded before Flop (didn't bet)
Seat 4: fraternitati (small blind) collected ($0.38)
Seat 5: JaydaKizz (big blind) folded on the Turn
Seat 6: PokerDroop folded before Flop (didn't bet)



PokerStars Hand #222942695692:  Hold'em No Limit ($0.05/$0.10 USD) - 2021/01/23 22:22:05 ET
Table 'Malzovia III' 6-max Seat #4 is the button
Seat 1: 1donkz0fks ($18.84 in chips) 
Seat 2: schoki77 ($6.45 in chips) 
Seat 4: fraternitati ($5.48 in chips) 
Seat 5: JaydaKizz ($6.92 in chips) 
Seat 6: PokerDroop ($11.09 in chips) 
JaydaKizz: posts small blind $0.05
PokerDroop: posts big blind $0.10
*** HOLE CARDS ***
1donkz0fks: folds 
schoki77: folds 
fraternitati: folds 
JaydaKizz: raises $0.10 to $0.20
PokerDroop: calls $0.10
*** FLOP *** [6c 3d 4s]
JaydaKizz: checks 
PokerDroop: bets $0.20
JaydaKizz: folds 
Uncalled bet ($0.20) returned to PokerDroop
PokerDroop collected $0.38 from pot
PokerDroop: doesn't show hand 
*** SUMMARY ***
Total pot $0.40 | Rake $0.02 
Board [6c 3d 4s]
Seat 1: 1donkz0fks folded before Flop (didn't bet)
Seat 2: schoki77 folded before Flop (didn't bet)
Seat 4: fraternitati (button) folded before Flop (didn't bet)
Seat 5: JaydaKizz (small blind) folded on the Flop
Seat 6: PokerDroop (big blind) collected ($0.38)



PokerStars Hand #222942705878:  Hold'em No Limit ($0.05/$0.10 USD) - 2021/01/23 22:22:32 ET
Table 'Malzovia III' 6-max Seat #5 is the button
Seat 1: 1donkz0fks ($18.84 in chips) 
Seat 2: schoki77 ($6.45 in chips) 
Seat 4: fraternitati ($5.48 in chips) 
Seat 5: JaydaKizz ($6.72 in chips) 
Seat 6: PokerDroop ($11.27 in chips) 
PokerDroop: posts small blind $0.05
1donkz0fks: posts big blind $0.10
*** HOLE CARDS ***
schoki77: calls $0.10
fraternitati: folds 
JaydaKizz: folds 
PokerDroop: folds 
1donkz0fks: checks 
*** FLOP *** [3c 2s 7c]
1donkz0fks: checks 
schoki77: bets $0.10
ildar87kzn leaves the table
1donkz0fks: folds 
Uncalled bet ($0.10) returned to schoki77
schoki77 collected $0.24 from pot
schoki77: doesn't show hand 
*** SUMMARY ***
Total pot $0.25 | Rake $0.01 
Board [3c 2s 7c]
Seat 1: 1donkz0fks (big blind) folded on the Flop
Seat 2: schoki77 collected ($0.24)
Seat 4: fraternitati folded before Flop (didn't bet)
Seat 5: JaydaKizz (button) folded before Flop (didn't bet)
Seat 6: PokerDroop (small blind) folded before Flop



PokerStars Hand #222942719681:  Hold'em No Limit ($0.05/$0.10 USD) - 2021/01/23 22:23:10 ET
Table 'Malzovia III' 6-max Seat #6 is the button
Seat 1: 1donkz0fks ($18.74 in chips) 
Seat 2: schoki77 ($6.59 in chips) 
Seat 4: fraternitati ($5.48 in chips) 
Seat 5: JaydaKizz ($6.72 in chips) 
Seat 6: PokerDroop ($11.22 in chips) 
1donkz0fks: posts small blind $0.05
schoki77: posts big blind $0.10
*** HOLE CARDS ***
fraternitati: raises $0.20 to $0.30
JaydaKizz: calls $0.30
KingPotNoodle joins the table at seat #3 
PokerDroop: folds 
1donkz0fks: folds 
schoki77: folds 
*** FLOP *** [8h Jc 2c]
fraternitati: bets $0.36
JaydaKizz: calls $0.36
*** TURN *** [8h Jc 2c] [6d]
fraternitati: bets $0.93
JaydaKizz: folds 
Uncalled bet ($0.93) returned to fraternitati
fraternitati collected $1.40 from pot
fraternitati: doesn't show hand 
*** SUMMARY ***
Total pot $1.47 | Rake $0.07 
Board [8h Jc 2c 6d]
Seat 1: 1donkz0fks (small blind) folded before Flop
Seat 2: schoki77 (big blind) folded before Flop
Seat 4: fraternitati collected ($1.40)
Seat 5: JaydaKizz folded on the Turn
Seat 6: PokerDroop (button) folded before Flop (didn't bet)



PokerStars Hand #222942732689:  Hold'em No Limit ($0.05/$0.10 USD) - 2021/01/23 22:23:45 ET
Table 'Malzovia III' 6-max Seat #1 is the button
Seat 1: 1donkz0fks ($18.69 in chips) 
Seat 2: schoki77 ($6.49 in chips) 
Seat 3: KingPotNoodle ($10 in chips) 
Seat 4: fraternitati ($6.22 in chips) 
Seat 5: JaydaKizz ($6.06 in chips) 
Seat 6: PokerDroop ($11.22 in chips) 
schoki77: posts small blind $0.05
KingPotNoodle: posts big blind $0.10
*** HOLE CARDS ***
fraternitati: folds 
JaydaKizz: folds 
PokerDroop: folds 
1donkz0fks: folds 
schoki77: raises $0.20 to $0.30
KingPotNoodle: calls $0.20
*** FLOP *** [7c 7h Qs]
schoki77: checks 
KingPotNoodle: bets $0.29
schoki77: folds 
Uncalled bet ($0.29) returned to KingPotNoodle
KingPotNoodle collected $0.57 from pot
KingPotNoodle: doesn't show hand 
*** SUMMARY ***
Total pot $0.60 | Rake $0.03 
Board [7c 7h Qs]
Seat 1: 1donkz0fks (button) folded before Flop (didn't bet)
Seat 2: schoki77 (small blind) folded on the Flop
Seat 3: KingPotNoodle (big blind) collected ($0.57)
Seat 4: fraternitati folded before Flop (didn't bet)
Seat 5: JaydaKizz folded before Flop (didn't bet)
Seat 6: PokerDroop folded before Flop (didn't bet)



PokerStars Hand #222942742724:  Hold'em No Limit ($0.05/$0.10 USD) - 2021/01/23 22:24:13 ET
Table 'Malzovia III' 6-max Seat #2 is the button
Seat 1: 1donkz0fks ($18.69 in chips) 
Seat 2: schoki77 ($6.19 in chips) 
Seat 3: KingPotNoodle ($10.27 in chips) 
Seat 4: fraternitati ($6.22 in chips) 
Seat 5: JaydaKizz ($6.06 in chips) 
Seat 6: PokerDroop ($11.22 in chips) 
KingPotNoodle: posts small blind $0.05
fraternitati: posts big blind $0.10
*** HOLE CARDS ***
JaydaKizz: folds 
PokerDroop: folds 
1donkz0fks: folds 
schoki77: folds 
KingPotNoodle: folds 
Uncalled bet ($0.05) returned to fraternitati
fraternitati collected $0.10 from pot
fraternitati: doesn't show hand 
*** SUMMARY ***
Total pot $0.10 | Rake $0 
Seat 1: 1donkz0fks folded before Flop (didn't bet)
Seat 2: schoki77 (button) folded before Flop (didn't bet)
Seat 3: KingPotNoodle (small blind) folded before Flop
Seat 4: fraternitati (big blind) collected ($0.10)
Seat 5: JaydaKizz folded before Flop (didn't bet)
Seat 6: PokerDroop folded before Flop (didn't bet)



PokerStars Hand #222942747813:  Hold'em No Limit ($0.05/$0.10 USD) - 2021/01/23 22:24:26 ET
Table 'Malzovia III' 6-max Seat #3 is the button
Seat 1: 1donkz0fks ($18.69 in chips) 
Seat 2: schoki77 ($6.19 in chips) 
Seat 3: KingPotNoodle ($10.22 in chips) 
Seat 4: fraternitati ($6.27 in chips) 
Seat 5: JaydaKizz ($6.06 in chips) 
Seat 6: PokerDroop ($11.22 in chips) 
fraternitati: posts small blind $0.05
JaydaKizz: posts big blind $0.10
*** HOLE CARDS ***
PokerDroop: folds 
1donkz0fks: folds 
schoki77: folds 
KingPotNoodle: folds 
fraternitati: raises $0.15 to $0.25
JaydaKizz: calls $0.15
*** FLOP *** [Tc Qh 8s]
fraternitati: bets $0.24
JaydaKizz: calls $0.24
*** TURN *** [Tc Qh 8s] [2h]
fraternitati: bets $0.63
JaydaKizz: calls $0.63
*** RIVER *** [Tc Qh 8s 2h] [Kc]
fraternitati: bets $1.43
JaydaKizz: calls $1.43
*** SHOW DOWN ***
fraternitati: shows [Jh Qd] (a pair of Queens)
JaydaKizz: mucks hand 
fraternitati collected $4.87 from pot
*** SUMMARY ***
Total pot $5.10 | Rake $0.23 
Board [Tc Qh 8s 2h Kc]
Seat 1: 1donkz0fks folded before Flop (didn't bet)
Seat 2: schoki77 folded before Flop (didn't bet)
Seat 3: KingPotNoodle (button) folded before Flop (didn't bet)
Seat 4: fraternitati (small blind) showed [Jh Qd] and won ($4.87) with a pair of Queens
Seat 5: JaydaKizz (big blind) mucked
Seat 6: PokerDroop folded before Flop (didn't bet)



PokerStars Hand #222942765251:  Hold'em No Limit ($0.05/$0.10 USD) - 2021/01/23 22:25:14 ET
Table 'Malzovia III' 6-max Seat #4 is the button
Seat 1: 1donkz0fks ($18.69 in chips) 
Seat 2: schoki77 ($6.19 in chips) 
Seat 3: KingPotNoodle ($10.22 in chips) 
Seat 4: fraternitati ($8.59 in chips) 
Seat 5: JaydaKizz ($3.51 in chips) 
Seat 6: PokerDroop ($11.22 in chips) 
JaydaKizz: posts small blind $0.05
PokerDroop: posts big blind $0.10
*** HOLE CARDS ***
1donkz0fks: folds 
schoki77: raises $0.20 to $0.30
KingPotNoodle: folds 
fraternitati: folds 
JaydaKizz: calls $0.25
PokerDroop: folds 
*** FLOP *** [2d Td 3d]
JaydaKizz: checks 
schoki77: checks 
*** TURN *** [2d Td 3d] [3h]
JaydaKizz: checks 
schoki77: bets $0.34
JaydaKizz: calls $0.34
*** RIVER *** [2d Td 3d 3h] [7h]
JaydaKizz: checks 
schoki77: bets $1.50
JaydaKizz: folds 
Uncalled bet ($1.50) returned to schoki77
schoki77 collected $1.32 from pot
schoki77: doesn't show hand 
*** SUMMARY ***
Total pot $1.38 | Rake $0.06 
Board [2d Td 3d 3h 7h]
Seat 1: 1donkz0fks folded before Flop (didn't bet)
Seat 2: schoki77 collected ($1.32)
Seat 3: KingPotNoodle folded before Flop (didn't bet)
Seat 4: fraternitati (button) folded before Flop (didn't bet)
Seat 5: JaydaKizz (small blind) folded on the River
Seat 6: PokerDroop (big blind) folded before Flop



PokerStars Hand #222942782611:  Hold'em No Limit ($0.05/$0.10 USD) - 2021/01/23 22:26:01 ET
Table 'Malzovia III' 6-max Seat #5 is the button
Seat 1: 1donkz0fks ($18.69 in chips) 
Seat 2: schoki77 ($6.87 in chips) 
Seat 3: KingPotNoodle ($10.22 in chips) 
Seat 4: fraternitati ($8.59 in chips) 
Seat 5: JaydaKizz ($2.87 in chips) 
Seat 6: PokerDroop ($11.12 in chips) 
PokerDroop: posts small blind $0.05
1donkz0fks: posts big blind $0.10
*** HOLE CARDS ***
schoki77: raises $0.20 to $0.30
KingPotNoodle: folds 
fraternitati: folds 
JaydaKizz: calls $0.30
PokerDroop: calls $0.25
1donkz0fks: calls $0.20
*** FLOP *** [3s 4s 7s]
PokerDroop: checks 
1donkz0fks: checks 
schoki77: checks 
JaydaKizz: checks 
*** TURN *** [3s 4s 7s] [6d]
PokerDroop: bets $0.70
1donkz0fks: folds 
schoki77: folds 
JaydaKizz: folds 
Uncalled bet ($0.70) returned to PokerDroop
PokerDroop collected $1.15 from pot
PokerDroop: doesn't show hand 
*** SUMMARY ***
Total pot $1.20 | Rake $0.05 
Board [3s 4s 7s 6d]
Seat 1: 1donkz0fks (big blind) folded on the Turn
Seat 2: schoki77 folded on the Turn
Seat 3: KingPotNoodle folded before Flop (didn't bet)
Seat 4: fraternitati folded before Flop (didn't bet)
Seat 5: JaydaKizz (button) folded on the Turn
Seat 6: PokerDroop (small blind) collected ($1.15)



PokerStars Hand #222942807688:  Hold'em No Limit ($0.05/$0.10 USD) - 2021/01/23 22:27:11 ET
Table 'Malzovia III' 6-max Seat #6 is the button
Seat 1: 1donkz0fks ($18.39 in chips) 
Seat 2: schoki77 ($6.57 in chips) 
Seat 3: KingPotNoodle ($10.22 in chips) 
Seat 4: fraternitati ($8.59 in chips) 
Seat 5: JaydaKizz ($2.57 in chips) 
Seat 6: PokerDroop ($11.97 in chips) 
1donkz0fks: posts small blind $0.05
schoki77: posts big blind $0.10
*** HOLE CARDS ***
KingPotNoodle: folds 
fraternitati: raises $0.20 to $0.30
JaydaKizz: folds 
PokerDroop: folds 
1donkz0fks: calls $0.25
schoki77: folds 
*** FLOP *** [8c 4s 8d]
1donkz0fks: checks 
fraternitati: bets $0.34
1donkz0fks: calls $0.34
*** TURN *** [8c 4s 8d] [Kh]
1donkz0fks: checks 
fraternitati: checks 
*** RIVER *** [8c 4s 8d Kh] [4h]
1donkz0fks: checks 
fraternitati: bets $1.32
1donkz0fks: calls $1.32
*** SHOW DOWN ***
fraternitati: shows [Ad 4d] (a full house, Fours full of Eights)
1donkz0fks: mucks hand 
fraternitati collected $3.84 from pot
*** SUMMARY ***
Total pot $4.02 | Rake $0.18 
Board [8c 4s 8d Kh 4h]
Seat 1: 1donkz0fks (small blind) mucked
Seat 2: schoki77 (big blind) folded before Flop
Seat 3: KingPotNoodle folded before Flop (didn't bet)
Seat 4: fraternitati showed [Ad 4d] and won ($3.84) with a full house, Fours full of Eights
Seat 5: JaydaKizz folded before Flop (didn't bet)
Seat 6: PokerDroop (button) folded before Flop (didn't bet)



PokerStars Hand #222942825621:  Hold'em No Limit ($0.05/$0.10 USD) - 2021/01/23 22:27:59 ET
Table 'Malzovia III' 6-max Seat #1 is the button
Seat 1: 1donkz0fks ($16.43 in chips) 
Seat 2: schoki77 ($6.47 in chips) 
Seat 3: KingPotNoodle ($10.22 in chips) 
Seat 4: fraternitati ($10.47 in chips) 
Seat 5: JaydaKizz ($2.57 in chips) 
Seat 6: PokerDroop ($11.97 in chips) 
schoki77: posts small blind $0.05
KingPotNoodle: posts big blind $0.10
*** HOLE CARDS ***
fraternitati: folds 
JaydaKizz: folds 
PokerDroop: folds 
1donkz0fks: folds 
schoki77: folds 
Uncalled bet ($0.05) returned to KingPotNoodle
KingPotNoodle collected $0.10 from pot
KingPotNoodle: doesn't show hand 
*** SUMMARY ***
Total pot $0.10 | Rake $0 
Seat 1: 1donkz0fks (button) folded before Flop (didn't bet)
Seat 2: schoki77 (small blind) folded before Flop
Seat 3: KingPotNoodle (big blind) collected ($0.10)
Seat 4: fraternitati folded before Flop (didn't bet)
Seat 5: JaydaKizz folded before Flop (didn't bet)
Seat 6: PokerDroop folded before Flop (didn't bet)



PokerStars Hand #222942832335:  Hold'em No Limit ($0.05/$0.10 USD) - 2021/01/23 22:28:18 ET
Table 'Malzovia III' 6-max Seat #2 is the button
Seat 1: 1donkz0fks ($16.43 in chips) 
Seat 2: schoki77 ($6.42 in chips) 
Seat 3: KingPotNoodle ($10.27 in chips) 
Seat 4: fraternitati ($10.47 in chips) 
Seat 5: JaydaKizz ($2.57 in chips) 
Seat 6: PokerDroop ($11.97 in chips) 
KingPotNoodle: posts small blind $0.05
fraternitati: posts big blind $0.10
*** HOLE CARDS ***
JaydaKizz: folds 
PokerDroop: folds 
1donkz0fks: folds 
schoki77: folds 
KingPotNoodle: folds 
Uncalled bet ($0.05) returned to fraternitati
fraternitati collected $0.10 from pot
fraternitati: doesn't show hand 
*** SUMMARY ***
Total pot $0.10 | Rake $0 
Seat 1: 1donkz0fks folded before Flop (didn't bet)
Seat 2: schoki77 (button) folded before Flop (didn't bet)
Seat 3: KingPotNoodle (small blind) folded before Flop
Seat 4: fraternitati (big blind) collected ($0.10)
Seat 5: JaydaKizz folded before Flop (didn't bet)
Seat 6: PokerDroop folded before Flop (didn't bet)



PokerStars Hand #222942836863:  Hold'em No Limit ($0.05/$0.10 USD) - 2021/01/23 22:28:31 ET
Table 'Malzovia III' 6-max Seat #3 is the button
Seat 1: 1donkz0fks ($16.43 in chips) 
Seat 2: schoki77 ($6.42 in chips) 
Seat 3: KingPotNoodle ($10.22 in chips) 
Seat 4: fraternitati ($10.52 in chips) 
Seat 5: JaydaKizz ($2.57 in chips) 
Seat 6: PokerDroop ($11.97 in chips) 
fraternitati: posts small blind $0.05
JaydaKizz: posts big blind $0.10
*** HOLE CARDS ***
PokerDroop: folds 
1donkz0fks: folds 
schoki77: calls $0.10
KingPotNoodle: raises $0.40 to $0.50
fraternitati: calls $0.45
JaydaKizz: calls $0.40
schoki77: calls $0.40
*** FLOP *** [7c 9h 7d]
fraternitati: checks 
JaydaKizz: checks 
schoki77: bets $0.96
KingPotNoodle: folds 
fraternitati: folds 
JaydaKizz: folds 
Uncalled bet ($0.96) returned to schoki77
schoki77 collected $1.91 from pot
schoki77: doesn't show hand 
*** SUMMARY ***
Total pot $2 | Rake $0.09 
Board [7c 9h 7d]
Seat 1: 1donkz0fks folded before Flop (didn't bet)
Seat 2: schoki77 collected ($1.91)
Seat 3: KingPotNoodle (button) folded on the Flop
Seat 4: fraternitati (small blind) folded on the Flop
Seat 5: JaydaKizz (big blind) folded on the Flop
Seat 6: PokerDroop folded before Flop (didn't bet)



PokerStars Hand #222942850748:  Hold'em No Limit ($0.05/$0.10 USD) - 2021/01/23 22:29:09 ET
Table 'Malzovia III' 6-max Seat #4 is the button
Seat 1: 1donkz0fks ($16.43 in chips) 
Seat 2: schoki77 ($7.83 in chips) 
Seat 3: KingPotNoodle ($10 in chips) 
Seat 4: fraternitati ($10.02 in chips) 
Seat 5: JaydaKizz ($2.07 in chips) 
Seat 6: PokerDroop ($11.97 in chips) 
JaydaKizz: posts small blind $0.05
PokerDroop: posts big blind $0.10
*** HOLE CARDS ***
1donkz0fks: folds 
schoki77: calls $0.10
KingPotNoodle: folds 
fraternitati: raises $0.30 to $0.40
JaydaKizz: calls $0.35
PokerDroop: folds 
schoki77: calls $0.30
*** FLOP *** [8c 2s 8h]
JaydaKizz: bets $1.67 and is all-in
schoki77: folds 
fraternitati: calls $1.67
*** TURN *** [8c 2s 8h] [Jh]
*** RIVER *** [8c 2s 8h Jh] [Jc]
*** SHOW DOWN ***
JaydaKizz: shows [4d 4c] (two pair, Jacks and Eights)
fraternitati: shows [9s 9h] (two pair, Jacks and Nines)
fraternitati collected $4.43 from pot
*** SUMMARY ***
Total pot $4.64 | Rake $0.21 
Board [8c 2s 8h Jh Jc]
Seat 1: 1donkz0fks folded before Flop (didn't bet)
Seat 2: schoki77 folded on the Flop
Seat 3: KingPotNoodle folded before Flop (didn't bet)
Seat 4: fraternitati (button) showed [9s 9h] and won ($4.43) with two pair, Jacks and Nines
Seat 5: JaydaKizz (small blind) showed [4d 4c] and lost with two pair, Jacks and Eights
Seat 6: PokerDroop (big blind) folded before Flop



PokerStars Hand #222942878617:  Hold'em No Limit ($0.05/$0.10 USD) - 2021/01/23 22:30:05 ET
Table 'Malzovia III' 6-max Seat #6 is the button
Seat 1: 1donkz0fks ($16.43 in chips) 
Seat 2: schoki77 ($7.43 in chips) 
Seat 3: KingPotNoodle ($10 in chips) 
Seat 4: fraternitati ($12.38 in chips) 
Seat 6: PokerDroop ($11.87 in chips) 
1donkz0fks: posts small blind $0.05
schoki77: posts big blind $0.10
*** HOLE CARDS ***
JaydaKizz leaves the table
KingPotNoodle: folds 
JoelHunt007 joins the table at seat #5 
fraternitati: raises $0.15 to $0.25
PokerDroop: folds 
1donkz0fks: folds 
schoki77: calls $0.15
*** FLOP *** [8c 4h 4s]
schoki77: checks 
fraternitati: checks 
*** TURN *** [8c 4h 4s] [4d]
schoki77: checks 
fraternitati: checks 
*** RIVER *** [8c 4h 4s 4d] [7h]
schoki77: bets $0.27
fraternitati: calls $0.27
*** SHOW DOWN ***
schoki77: shows [Js Kd] (three of a kind, Fours)
fraternitati: shows [Kc Jd] (three of a kind, Fours)
schoki77 collected $0.52 from pot
fraternitati collected $0.52 from pot
*** SUMMARY ***
Total pot $1.09 | Rake $0.05 
Board [8c 4h 4s 4d 7h]
Seat 1: 1donkz0fks (small blind) folded before Flop
Seat 2: schoki77 (big blind) showed [Js Kd] and won ($0.52) with three of a kind, Fours
Seat 3: KingPotNoodle folded before Flop (didn't bet)
Seat 4: fraternitati showed [Kc Jd] and won ($0.52) with three of a kind, Fours
Seat 6: PokerDroop (button) folded before Flop (didn't bet)



PokerStars Hand #222942898881:  Hold'em No Limit ($0.05/$0.10 USD) - 2021/01/23 22:31:02 ET
Table 'Malzovia III' 6-max Seat #1 is the button
Seat 1: 1donkz0fks ($16.38 in chips) 
Seat 2: schoki77 ($7.43 in chips) 
Seat 3: KingPotNoodle ($10 in chips) 
Seat 4: fraternitati ($12.38 in chips) 
Seat 6: PokerDroop ($11.87 in chips) 
schoki77: posts small blind $0.05
KingPotNoodle: posts big blind $0.10
JoelHunt007: sits out 
*** HOLE CARDS ***
fraternitati: folds 
PokerDroop: folds 
1donkz0fks: folds 
schoki77: calls $0.05
KingPotNoodle: raises $0.40 to $0.50
schoki77: calls $0.40
*** FLOP *** [Js 9s Td]
schoki77: checks 
KingPotNoodle: bets $0.63
schoki77: calls $0.63
*** TURN *** [Js 9s Td] [3c]
schoki77: checks 
KingPotNoodle: bets $1.43
schoki77: calls $1.43
*** RIVER *** [Js 9s Td 3c] [3h]
schoki77: bets $4.87 and is all-in
KingPotNoodle: folds 
Uncalled bet ($4.87) returned to schoki77
schoki77 collected $4.89 from pot
schoki77: doesn't show hand 
*** SUMMARY ***
Total pot $5.12 | Rake $0.23 
Board [Js 9s Td 3c 3h]
Seat 1: 1donkz0fks (button) folded before Flop (didn't bet)
Seat 2: schoki77 (small blind) collected ($4.89)
Seat 3: KingPotNoodle (big blind) folded on the River
Seat 4: fraternitati folded before Flop (didn't bet)
Seat 6: PokerDroop folded before Flop (didn't bet)



PokerStars Hand #222942916112:  Hold'em No Limit ($0.05/$0.10 USD) - 2021/01/23 22:31:51 ET
Table 'Malzovia III' 6-max Seat #2 is the button
Seat 1: 1donkz0fks ($16.38 in chips) 
Seat 2: schoki77 ($9.76 in chips) 
Seat 3: KingPotNoodle ($10 in chips) 
Seat 4: fraternitati ($12.38 in chips) 
Seat 6: PokerDroop ($11.87 in chips) 
KingPotNoodle: posts small blind $0.05
fraternitati: posts big blind $0.10
JoelHunt007: sits out 
*** HOLE CARDS ***
PokerDroop: folds 
1donkz0fks: folds 
schoki77: folds 
KingPotNoodle: raises $0.20 to $0.30
fraternitati: folds 
Uncalled bet ($0.20) returned to KingPotNoodle
KingPotNoodle collected $0.20 from pot
KingPotNoodle: doesn't show hand 
*** SUMMARY ***
Total pot $0.20 | Rake $0 
Seat 1: 1donkz0fks folded before Flop (didn't bet)
Seat 2: schoki77 (button) folded before Flop (didn't bet)
Seat 3: KingPotNoodle (small blind) collected ($0.20)
Seat 4: fraternitati (big blind) folded before Flop
Seat 6: PokerDroop folded before Flop (didn't bet)



PokerStars Hand #222942922989:  Hold'em No Limit ($0.05/$0.10 USD) - 2021/01/23 22:32:10 ET
Table 'Malzovia III' 6-max Seat #3 is the button
Seat 1: 1donkz0fks ($16.38 in chips) 
Seat 2: schoki77 ($9.76 in chips) 
Seat 3: KingPotNoodle ($10.10 in chips) 
Seat 4: fraternitati ($12.28 in chips) 
Seat 5: JoelHunt007 ($10 in chips) 
Seat 6: PokerDroop ($11.87 in chips) 
fraternitati: posts small blind $0.05
JoelHunt007: posts big blind $0.10
*** HOLE CARDS ***
PokerDroop: raises $0.20 to $0.30
1donkz0fks: folds 
schoki77: calls $0.30
KingPotNoodle: raises $1.20 to $1.50
fraternitati: folds 
JoelHunt007: folds 
PokerDroop: folds 
schoki77: folds 
Uncalled bet ($1.20) returned to KingPotNoodle
KingPotNoodle collected $1.05 from pot
KingPotNoodle: doesn't show hand 
*** SUMMARY ***
Total pot $1.05 | Rake $0 
Seat 1: 1donkz0fks folded before Flop (didn't bet)
Seat 2: schoki77 folded before Flop
Seat 3: KingPotNoodle (button) collected ($1.05)
Seat 4: fraternitati (small blind) folded before Flop
Seat 5: JoelHunt007 (big blind) folded before Flop
Seat 6: PokerDroop folded before Flop



PokerStars Hand #222942936388:  Hold'em No Limit ($0.05/$0.10 USD) - 2021/01/23 22:32:47 ET
Table 'Malzovia III' 6-max Seat #4 is the button
Seat 1: 1donkz0fks ($16.38 in chips) 
Seat 2: schoki77 ($9.46 in chips) 
Seat 3: KingPotNoodle ($10.85 in chips) 
Seat 4: fraternitati ($12.23 in chips) 
Seat 5: JoelHunt007 ($10 in chips) 
Seat 6: PokerDroop ($11.57 in chips) 
JoelHunt007: posts small blind $0.05
PokerDroop: posts big blind $0.10
*** HOLE CARDS ***
1donkz0fks: folds 
schoki77: calls $0.10
KingPotNoodle: folds 
fraternitati: folds 
JoelHunt007: folds 
PokerDroop: checks 
*** FLOP *** [8h 4h 9s]
PokerDroop: checks 
schoki77: bets $0.24
PokerDroop: folds 
Uncalled bet ($0.24) returned to schoki77
schoki77 collected $0.24 from pot
schoki77: doesn't show hand 
*** SUMMARY ***
Total pot $0.25 | Rake $0.01 
Board [8h 4h 9s]
Seat 1: 1donkz0fks folded before Flop (didn't bet)
Seat 2: schoki77 collected ($0.24)
Seat 3: KingPotNoodle folded before Flop (didn't bet)
Seat 4: fraternitati (button) folded before Flop (didn't bet)
Seat 5: JoelHunt007 (small blind) folded before Flop
Seat 6: PokerDroop (big blind) folded on the Flop



PokerStars Hand #222942946404:  Hold'em No Limit ($0.05/$0.10 USD) - 2021/01/23 22:33:15 ET
Table 'Malzovia III' 6-max Seat #5 is the button
Seat 1: 1donkz0fks ($16.38 in chips) 
Seat 2: schoki77 ($9.60 in chips) 
Seat 3: KingPotNoodle ($10.85 in chips) 
Seat 4: fraternitati ($12.23 in chips) 
Seat 5: JoelHunt007 ($10 in chips) 
Seat 6: PokerDroop ($11.47 in chips) 
PokerDroop: posts small blind $0.05
1donkz0fks: posts big blind $0.10
*** HOLE CARDS ***
schoki77: folds 
KingPotNoodle: folds 
fraternitati: folds 
JoelHunt007: folds 
PokerDroop: folds 
Uncalled bet ($0.05) returned to 1donkz0fks
1donkz0fks collected $0.10 from pot
1donkz0fks: doesn't show hand 
*** SUMMARY ***
Total pot $0.10 | Rake $0 
Seat 1: 1donkz0fks (big blind) collected ($0.10)
Seat 2: schoki77 folded before Flop (didn't bet)
Seat 3: KingPotNoodle folded before Flop (didn't bet)
Seat 4: fraternitati folded before Flop (didn't bet)
Seat 5: JoelHunt007 (button) folded before Flop (didn't bet)
Seat 6: PokerDroop (small blind) folded before Flop



PokerStars Hand #222942950085:  Hold'em No Limit ($0.05/$0.10 USD) - 2021/01/23 22:33:25 ET
Table 'Malzovia III' 6-max Seat #6 is the button
Seat 1: 1donkz0fks ($16.43 in chips) 
Seat 2: schoki77 ($9.60 in chips) 
Seat 3: KingPotNoodle ($10.85 in chips) 
Seat 4: fraternitati ($12.23 in chips) 
Seat 5: JoelHunt007 ($10 in chips) 
Seat 6: PokerDroop ($11.42 in chips) 
1donkz0fks: posts small blind $0.05
schoki77: posts big blind $0.10
*** HOLE CARDS ***
KingPotNoodle: folds 
fraternitati: folds 
JoelHunt007: folds 
PokerDroop: folds 
1donkz0fks: folds 
Uncalled bet ($0.05) returned to schoki77
schoki77 collected $0.10 from pot
schoki77: doesn't show hand 
*** SUMMARY ***
Total pot $0.10 | Rake $0 
Seat 1: 1donkz0fks (small blind) folded before Flop
Seat 2: schoki77 (big blind) collected ($0.10)
Seat 3: KingPotNoodle folded before Flop (didn't bet)
Seat 4: fraternitati folded before Flop (didn't bet)
Seat 5: JoelHunt007 folded before Flop (didn't bet)
Seat 6: PokerDroop (button) folded before Flop (didn't bet)



PokerStars Hand #222942956475:  Hold'em No Limit ($0.05/$0.10 USD) - 2021/01/23 22:33:43 ET
Table 'Malzovia III' 6-max Seat #1 is the button
Seat 1: 1donkz0fks ($16.38 in chips) 
Seat 2: schoki77 ($9.65 in chips) 
Seat 3: KingPotNoodle ($10.85 in chips) 
Seat 4: fraternitati ($12.23 in chips) 
Seat 5: JoelHunt007 ($10 in chips) 
Seat 6: PokerDroop ($11.42 in chips) 
schoki77: posts small blind $0.05
KingPotNoodle: posts big blind $0.10
*** HOLE CARDS ***
fraternitati: raises $0.20 to $0.30
JoelHunt007: folds 
PokerDroop: calls $0.30
1donkz0fks: folds 
schoki77: calls $0.25
KingPotNoodle: folds 
*** FLOP *** [Kh 6d Ah]
schoki77: checks 
fraternitati: bets $0.64
PokerDroop: folds 
schoki77: folds 
Uncalled bet ($0.64) returned to fraternitati
fraternitati collected $0.96 from pot
fraternitati: doesn't show hand 
*** SUMMARY ***
Total pot $1 | Rake $0.04 
Board [Kh 6d Ah]
Seat 1: 1donkz0fks (button) folded before Flop (didn't bet)
Seat 2: schoki77 (small blind) folded on the Flop
Seat 3: KingPotNoodle (big blind) folded before Flop
Seat 4: fraternitati collected ($0.96)
Seat 5: JoelHunt007 folded before Flop (didn't bet)
Seat 6: PokerDroop folded on the Flop



PokerStars Hand #222942970268:  Hold'em No Limit ($0.05/$0.10 USD) - 2021/01/23 22:34:07 ET
Table 'Malzovia III' 6-max Seat #2 is the button
Seat 1: 1donkz0fks ($16.38 in chips) 
Seat 2: schoki77 ($9.35 in chips) 
Seat 3: KingPotNoodle ($10.75 in chips) 
Seat 4: fraternitati ($12.89 in chips) 
Seat 5: JoelHunt007 ($10 in chips) 
Seat 6: PokerDroop ($11.12 in chips) 
KingPotNoodle: posts small blind $0.05
fraternitati: posts big blind $0.10
*** HOLE CARDS ***
JoelHunt007: folds 
PokerDroop: folds 
1donkz0fks: folds 
schoki77: folds 
KingPotNoodle: raises $0.20 to $0.30
fraternitati: raises $0.40 to $0.70
KingPotNoodle: calls $0.40
*** FLOP *** [Jc 2d 8d]
KingPotNoodle: checks 
fraternitati: bets $0.89
KingPotNoodle: folds 
Uncalled bet ($0.89) returned to fraternitati
fraternitati collected $1.34 from pot
fraternitati: doesn't show hand 
*** SUMMARY ***
Total pot $1.40 | Rake $0.06 
Board [Jc 2d 8d]
Seat 1: 1donkz0fks folded before Flop (didn't bet)
Seat 2: schoki77 (button) folded before Flop (didn't bet)
Seat 3: KingPotNoodle (small blind) folded on the Flop
Seat 4: fraternitati (big blind) collected ($1.34)
Seat 5: JoelHunt007 folded before Flop (didn't bet)
Seat 6: PokerDroop folded before Flop (didn't bet)



PokerStars Hand #222942977933:  Hold'em No Limit ($0.05/$0.10 USD) - 2021/01/23 22:34:28 ET
Table 'Malzovia III' 6-max Seat #3 is the button
Seat 1: 1donkz0fks ($16.38 in chips) 
Seat 2: schoki77 ($9.35 in chips) 
Seat 3: KingPotNoodle ($10.05 in chips) 
Seat 4: fraternitati ($13.53 in chips) 
Seat 5: JoelHunt007 ($10 in chips) 
Seat 6: PokerDroop ($11.12 in chips) 
fraternitati: posts small blind $0.05
JoelHunt007: posts big blind $0.10
*** HOLE CARDS ***
PokerDroop: raises $0.20 to $0.30
1donkz0fks: folds 
schoki77: folds 
KingPotNoodle: folds 
fraternitati: folds 
JoelHunt007: folds 
Uncalled bet ($0.20) returned to PokerDroop
PokerDroop collected $0.25 from pot
PokerDroop: doesn't show hand 
*** SUMMARY ***
Total pot $0.25 | Rake $0 
Seat 1: 1donkz0fks folded before Flop (didn't bet)
Seat 2: schoki77 folded before Flop (didn't bet)
Seat 3: KingPotNoodle (button) folded before Flop (didn't bet)
Seat 4: fraternitati (small blind) folded before Flop
Seat 5: JoelHunt007 (big blind) folded before Flop
Seat 6: PokerDroop collected ($0.25)



PokerStars Hand #222942983311:  Hold'em No Limit ($0.05/$0.10 USD) - 2021/01/23 22:34:43 ET
Table 'Malzovia III' 6-max Seat #4 is the button
Seat 1: 1donkz0fks ($16.38 in chips) 
Seat 2: schoki77 ($9.35 in chips) 
Seat 3: KingPotNoodle ($10.05 in chips) 
Seat 4: fraternitati ($13.48 in chips) 
Seat 5: JoelHunt007 ($10 in chips) 
Seat 6: PokerDroop ($11.27 in chips) 
JoelHunt007: posts small blind $0.05
PokerDroop: posts big blind $0.10
*** HOLE CARDS ***
1donkz0fks: raises $0.20 to $0.30
schoki77: folds 
KingPotNoodle: folds 
fraternitati: folds 
JoelHunt007: folds 
PokerDroop: folds 
Uncalled bet ($0.20) returned to 1donkz0fks
1donkz0fks collected $0.25 from pot
1donkz0fks: doesn't show hand 
*** SUMMARY ***
Total pot $0.25 | Rake $0 
Seat 1: 1donkz0fks collected ($0.25)
Seat 2: schoki77 folded before Flop (didn't bet)
Seat 3: KingPotNoodle folded before Flop (didn't bet)
Seat 4: fraternitati (button) folded before Flop (didn't bet)
Seat 5: JoelHunt007 (small blind) folded before Flop
Seat 6: PokerDroop (big blind) folded before Flop



PokerStars Hand #222942992697:  Hold'em No Limit ($0.05/$0.10 USD) - 2021/01/23 22:35:09 ET
Table 'Malzovia III' 6-max Seat #5 is the button
Seat 1: 1donkz0fks ($16.53 in chips) 
Seat 2: schoki77 ($9.35 in chips) 
Seat 3: KingPotNoodle ($10.05 in chips) 
Seat 4: fraternitati ($13.48 in chips) 
Seat 5: JoelHunt007 ($10 in chips) 
Seat 6: PokerDroop ($11.17 in chips) 
PokerDroop: posts small blind $0.05
1donkz0fks: posts big blind $0.10
*** HOLE CARDS ***
schoki77: calls $0.10
KingPotNoodle: raises $0.55 to $0.65
fraternitati: folds 
JoelHunt007: folds 
PokerDroop: folds 
1donkz0fks: folds 
schoki77: folds 
Uncalled bet ($0.55) returned to KingPotNoodle
KingPotNoodle collected $0.35 from pot
KingPotNoodle: doesn't show hand 
*** SUMMARY ***
Total pot $0.35 | Rake $0 
Seat 1: 1donkz0fks (big blind) folded before Flop
Seat 2: schoki77 folded before Flop
Seat 3: KingPotNoodle collected ($0.35)
Seat 4: fraternitati folded before Flop (didn't bet)
Seat 5: JoelHunt007 (button) folded before Flop (didn't bet)
Seat 6: PokerDroop (small blind) folded before Flop



PokerStars Hand #222943001844:  Hold'em No Limit ($0.05/$0.10 USD) - 2021/01/23 22:35:35 ET
Table 'Malzovia III' 6-max Seat #6 is the button
Seat 1: 1donkz0fks ($16.43 in chips) 
Seat 2: schoki77 ($9.25 in chips) 
Seat 3: KingPotNoodle ($10.30 in chips) 
Seat 4: fraternitati ($13.48 in chips) 
Seat 5: JoelHunt007 ($10 in chips) 
Seat 6: PokerDroop ($11.12 in chips) 
1donkz0fks: posts small blind $0.05
schoki77: posts big blind $0.10
*** HOLE CARDS ***
KingPotNoodle: folds 
fraternitati: folds 
JoelHunt007: raises $0.20 to $0.30
PokerDroop: folds 
1donkz0fks: folds 
schoki77: folds 
Uncalled bet ($0.20) returned to JoelHunt007
JoelHunt007 collected $0.25 from pot
JoelHunt007: doesn't show hand 
*** SUMMARY ***
Total pot $0.25 | Rake $0 
Seat 1: 1donkz0fks (small blind) folded before Flop
Seat 2: schoki77 (big blind) folded before Flop
Seat 3: KingPotNoodle folded before Flop (didn't bet)
Seat 4: fraternitati folded before Flop (didn't bet)
Seat 5: JoelHunt007 collected ($0.25)
Seat 6: PokerDroop (button) folded before Flop (didn't bet)



PokerStars Hand #222943011581:  Hold'em No Limit ($0.05/$0.10 USD) - 2021/01/23 22:36:03 ET
Table 'Malzovia III' 6-max Seat #1 is the button
Seat 1: 1donkz0fks ($16.38 in chips) 
Seat 2: schoki77 ($9.15 in chips) 
Seat 3: KingPotNoodle ($10.30 in chips) 
Seat 4: fraternitati ($13.48 in chips) 
Seat 5: JoelHunt007 ($10.15 in chips) 
Seat 6: PokerDroop ($11.12 in chips) 
schoki77: posts small blind $0.05
KingPotNoodle: posts big blind $0.10
*** HOLE CARDS ***
fraternitati: folds 
JoelHunt007: folds 
PokerDroop: folds 
1donkz0fks: folds 
schoki77: raises $0.20 to $0.30
KingPotNoodle: calls $0.20
*** FLOP *** [Jc Ac 4s]
schoki77: checks 
KingPotNoodle: checks 
*** TURN *** [Jc Ac 4s] [8c]
schoki77: checks 
KingPotNoodle: checks 
*** RIVER *** [Jc Ac 4s 8c] [3s]
schoki77: bets $0.57
KingPotNoodle: folds 
Uncalled bet ($0.57) returned to schoki77
schoki77 collected $0.57 from pot
schoki77: doesn't show hand 
*** SUMMARY ***
Total pot $0.60 | Rake $0.03 
Board [Jc Ac 4s 8c 3s]
Seat 1: 1donkz0fks (button) folded before Flop (didn't bet)
Seat 2: schoki77 (small blind) collected ($0.57)
Seat 3: KingPotNoodle (big blind) folded on the River
Seat 4: fraternitati folded before Flop (didn't bet)
Seat 5: JoelHunt007 folded before Flop (didn't bet)
Seat 6: PokerDroop folded before Flop (didn't bet)



PokerStars Hand #222943024162:  Hold'em No Limit ($0.05/$0.10 USD) - 2021/01/23 22:36:38 ET
Table 'Malzovia III' 6-max Seat #2 is the button
Seat 1: 1donkz0fks ($16.38 in chips) 
Seat 2: schoki77 ($9.42 in chips) 
Seat 3: KingPotNoodle ($10 in chips) 
Seat 4: fraternitati ($13.48 in chips) 
Seat 5: JoelHunt007 ($10.15 in chips) 
Seat 6: PokerDroop ($11.12 in chips) 
KingPotNoodle: posts small blind $0.05
fraternitati: posts big blind $0.10
*** HOLE CARDS ***
JoelHunt007: folds 
PokerDroop: folds 
1donkz0fks: folds 
schoki77: folds 
KingPotNoodle: raises $0.20 to $0.30
fraternitati: raises $0.70 to $1
KingPotNoodle: calls $0.70
*** FLOP *** [3s Ah 3d]
KingPotNoodle: checks 
fraternitati: bets $0.96
KingPotNoodle: folds 
Uncalled bet ($0.96) returned to fraternitati
fraternitati collected $1.91 from pot
fraternitati: doesn't show hand 
*** SUMMARY ***
Total pot $2 | Rake $0.09 
Board [3s Ah 3d]
Seat 1: 1donkz0fks folded before Flop (didn't bet)
Seat 2: schoki77 (button) folded before Flop (didn't bet)
Seat 3: KingPotNoodle (small blind) folded on the Flop
Seat 4: fraternitati (big blind) collected ($1.91)
Seat 5: JoelHunt007 folded before Flop (didn't bet)
Seat 6: PokerDroop folded before Flop (didn't bet)



PokerStars Hand #222943037301:  Hold'em No Limit ($0.05/$0.10 USD) - 2021/01/23 22:37:16 ET
Table 'Malzovia III' 6-max Seat #3 is the button
Seat 1: 1donkz0fks ($16.38 in chips) 
Seat 2: schoki77 ($9.42 in chips) 
Seat 3: KingPotNoodle ($10 in chips) 
Seat 4: fraternitati ($14.39 in chips) 
Seat 5: JoelHunt007 ($10.15 in chips) 
Seat 6: PokerDroop ($11.12 in chips) 
fraternitati: posts small blind $0.05
JoelHunt007: posts big blind $0.10
*** HOLE CARDS ***
PokerDroop: calls $0.10
1donkz0fks: folds 
schoki77: folds 
KingPotNoodle: folds 
fraternitati: folds 
JoelHunt007: checks 
*** FLOP *** [4d 4c 3c]
JoelHunt007: checks 
PokerDroop: bets $0.10
JoelHunt007: calls $0.10
*** TURN *** [4d 4c 3c] [4h]
JoelHunt007: checks 
PokerDroop: checks 
*** RIVER *** [4d 4c 3c 4h] [9c]
JoelHunt007: bets $0.32
PokerDroop: calls $0.32
*** SHOW DOWN ***
JoelHunt007: shows [5s 6h] (three of a kind, Fours)
PokerDroop: shows [8h 9h] (a full house, Fours full of Nines)
PokerDroop collected $1.04 from pot
*** SUMMARY ***
Total pot $1.09 | Rake $0.05 
Board [4d 4c 3c 4h 9c]
Seat 1: 1donkz0fks folded before Flop (didn't bet)
Seat 2: schoki77 folded before Flop (didn't bet)
Seat 3: KingPotNoodle (button) folded before Flop (didn't bet)
Seat 4: fraternitati (small blind) folded before Flop
Seat 5: JoelHunt007 (big blind) showed [5s 6h] and lost with three of a kind, Fours
Seat 6: PokerDroop showed [8h 9h] and won ($1.04) with a full house, Fours full of Nines



PokerStars Hand #222943051945:  Hold'em No Limit ($0.05/$0.10 USD) - 2021/01/23 22:37:58 ET
Table 'Malzovia III' 6-max Seat #4 is the button
Seat 1: 1donkz0fks ($16.38 in chips) 
Seat 2: schoki77 ($9.42 in chips) 
Seat 3: KingPotNoodle ($10 in chips) 
Seat 4: fraternitati ($14.34 in chips) 
Seat 5: JoelHunt007 ($10 in chips) 
Seat 6: PokerDroop ($11.64 in chips) 
JoelHunt007: posts small blind $0.05
PokerDroop: posts big blind $0.10
*** HOLE CARDS ***
1donkz0fks: raises $0.20 to $0.30
schoki77: folds 
KingPotNoodle: folds 
fraternitati: folds 
JoelHunt007: folds 
PokerDroop: folds 
Uncalled bet ($0.20) returned to 1donkz0fks
1donkz0fks collected $0.25 from pot
1donkz0fks: doesn't show hand 
*** SUMMARY ***
Total pot $0.25 | Rake $0 
Seat 1: 1donkz0fks collected ($0.25)
Seat 2: schoki77 folded before Flop (didn't bet)
Seat 3: KingPotNoodle folded before Flop (didn't bet)
Seat 4: fraternitati (button) folded before Flop (didn't bet)
Seat 5: JoelHunt007 (small blind) folded before Flop
Seat 6: PokerDroop (big blind) folded before Flop



PokerStars Hand #222943057809:  Hold'em No Limit ($0.05/$0.10 USD) - 2021/01/23 22:38:15 ET
Table 'Malzovia III' 6-max Seat #5 is the button
Seat 1: 1donkz0fks ($16.53 in chips) 
Seat 2: schoki77 ($9.42 in chips) 
Seat 3: KingPotNoodle ($10 in chips) 
Seat 4: fraternitati ($14.34 in chips) 
Seat 5: JoelHunt007 ($10 in chips) 
Seat 6: PokerDroop ($11.54 in chips) 
PokerDroop: posts small blind $0.05
1donkz0fks: posts big blind $0.10
*** HOLE CARDS ***
schoki77: folds 
KingPotNoodle: folds 
fraternitati: folds 
JoelHunt007: folds 
PokerDroop: folds 
Uncalled bet ($0.05) returned to 1donkz0fks
1donkz0fks collected $0.10 from pot
1donkz0fks: doesn't show hand 
*** SUMMARY ***
Total pot $0.10 | Rake $0 
Seat 1: 1donkz0fks (big blind) collected ($0.10)
Seat 2: schoki77 folded before Flop (didn't bet)
Seat 3: KingPotNoodle folded before Flop (didn't bet)
Seat 4: fraternitati folded before Flop (didn't bet)
Seat 5: JoelHunt007 (button) folded before Flop (didn't bet)
Seat 6: PokerDroop (small blind) folded before Flop



PokerStars Hand #222943063520:  Hold'em No Limit ($0.05/$0.10 USD) - 2021/01/23 22:38:31 ET
Table 'Malzovia III' 6-max Seat #6 is the button
Seat 1: 1donkz0fks ($16.58 in chips) 
Seat 2: schoki77 ($9.42 in chips) 
Seat 3: KingPotNoodle ($10 in chips) 
Seat 4: fraternitati ($14.34 in chips) 
Seat 5: JoelHunt007 ($10 in chips) 
Seat 6: PokerDroop ($11.49 in chips) 
1donkz0fks: posts small blind $0.05
schoki77: posts big blind $0.10
*** HOLE CARDS ***
KingPotNoodle: folds 
fraternitati: folds 
JoelHunt007: folds 
PokerDroop: folds 
1donkz0fks: raises $0.20 to $0.30
schoki77: folds 
Uncalled bet ($0.20) returned to 1donkz0fks
1donkz0fks collected $0.20 from pot
1donkz0fks: doesn't show hand 
*** SUMMARY ***
Total pot $0.20 | Rake $0 
Seat 1: 1donkz0fks (small blind) collected ($0.20)
Seat 2: schoki77 (big blind) folded before Flop
Seat 3: KingPotNoodle folded before Flop (didn't bet)
Seat 4: fraternitati folded before Flop (didn't bet)
Seat 5: JoelHunt007 folded before Flop (didn't bet)
Seat 6: PokerDroop (button) folded before Flop (didn't bet)



PokerStars Hand #222943070843:  Hold'em No Limit ($0.05/$0.10 USD) - 2021/01/23 22:38:52 ET
Table 'Malzovia III' 6-max Seat #1 is the button
Seat 1: 1donkz0fks ($16.68 in chips) 
Seat 2: schoki77 ($9.32 in chips) 
Seat 3: KingPotNoodle ($10 in chips) 
Seat 4: fraternitati ($14.34 in chips) 
Seat 5: JoelHunt007 ($10 in chips) 
Seat 6: PokerDroop ($11.49 in chips) 
schoki77: posts small blind $0.05
KingPotNoodle: posts big blind $0.10
*** HOLE CARDS ***
fraternitati: raises $0.20 to $0.30
JoelHunt007: folds 
PokerDroop: folds 
1donkz0fks: folds 
schoki77: folds 
KingPotNoodle: folds 
Uncalled bet ($0.20) returned to fraternitati
fraternitati collected $0.25 from pot
fraternitati: doesn't show hand 
*** SUMMARY ***
Total pot $0.25 | Rake $0 
Seat 1: 1donkz0fks (button) folded before Flop (didn't bet)
Seat 2: schoki77 (small blind) folded before Flop
Seat 3: KingPotNoodle (big blind) folded before Flop
Seat 4: fraternitati collected ($0.25)
Seat 5: JoelHunt007 folded before Flop (didn't bet)
Seat 6: PokerDroop folded before Flop (didn't bet)



PokerStars Hand #222943077496:  Hold'em No Limit ($0.05/$0.10 USD) - 2021/01/23 22:39:11 ET
Table 'Malzovia III' 6-max Seat #2 is the button
Seat 1: 1donkz0fks ($16.68 in chips) 
Seat 2: schoki77 ($9.27 in chips) 
Seat 3: KingPotNoodle ($10 in chips) 
Seat 4: fraternitati ($14.49 in chips) 
Seat 5: JoelHunt007 ($10 in chips) 
Seat 6: PokerDroop ($11.49 in chips) 
KingPotNoodle: posts small blind $0.05
fraternitati: posts big blind $0.10
*** HOLE CARDS ***
JoelHunt007 has timed out
JoelHunt007: folds 
PokerDroop: raises $0.20 to $0.30
1donkz0fks: folds 
schoki77: folds 
KingPotNoodle: raises $0.80 to $1.10
fraternitati: folds 
PokerDroop: calls $0.80
*** FLOP *** [7h 9d 4s]
KingPotNoodle: bets $1.10
PokerDroop: folds 
Uncalled bet ($1.10) returned to KingPotNoodle
KingPotNoodle collected $2.20 from pot
KingPotNoodle: doesn't show hand 
*** SUMMARY ***
Total pot $2.30 | Rake $0.10 
Board [7h 9d 4s]
Seat 1: 1donkz0fks folded before Flop (didn't bet)
Seat 2: schoki77 (button) folded before Flop (didn't bet)
Seat 3: KingPotNoodle (small blind) collected ($2.20)
Seat 4: fraternitati (big blind) folded before Flop
Seat 5: JoelHunt007 folded before Flop (didn't bet)
Seat 6: PokerDroop folded on the Flop



PokerStars Hand #222943097733:  Hold'em No Limit ($0.05/$0.10 USD) - 2021/01/23 22:40:10 ET
Table 'Malzovia III' 6-max Seat #3 is the button
Seat 1: 1donkz0fks ($16.68 in chips) 
Seat 2: schoki77 ($9.27 in chips) 
Seat 3: KingPotNoodle ($11.10 in chips) 
Seat 4: fraternitati ($14.39 in chips) 
Seat 5: JoelHunt007 ($10 in chips) 
Seat 6: PokerDroop ($10.39 in chips) 
fraternitati: posts small blind $0.05
JoelHunt007: posts big blind $0.10
*** HOLE CARDS ***
PokerDroop: folds 
1donkz0fks: folds 
schoki77: folds 
KingPotNoodle: raises $0.20 to $0.30
fraternitati: calls $0.25
JoelHunt007: folds 
*** FLOP *** [Th 6h 9c]
fraternitati: checks 
KingPotNoodle: bets $0.44
fraternitati: folds 
Uncalled bet ($0.44) returned to KingPotNoodle
KingPotNoodle collected $0.67 from pot
KingPotNoodle: doesn't show hand 
*** SUMMARY ***
Total pot $0.70 | Rake $0.03 
Board [Th 6h 9c]
Seat 1: 1donkz0fks folded before Flop (didn't bet)
Seat 2: schoki77 folded before Flop (didn't bet)
Seat 3: KingPotNoodle (button) collected ($0.67)
Seat 4: fraternitati (small blind) folded on the Flop
Seat 5: JoelHunt007 (big blind) folded before Flop
Seat 6: PokerDroop folded before Flop (didn't bet)



PokerStars Hand #222943109873:  Hold'em No Limit ($0.05/$0.10 USD) - 2021/01/23 22:40:45 ET
Table 'Malzovia III' 6-max Seat #4 is the button
Seat 1: 1donkz0fks ($16.68 in chips) 
Seat 2: schoki77 ($9.27 in chips) 
Seat 3: KingPotNoodle ($11.47 in chips) 
Seat 4: fraternitati ($14.09 in chips) 
Seat 5: JoelHunt007 ($10 in chips) 
Seat 6: PokerDroop ($10.39 in chips) 
JoelHunt007: posts small blind $0.05
PokerDroop: posts big blind $0.10
*** HOLE CARDS ***
1donkz0fks: folds 
schoki77: folds 
KingPotNoodle: folds 
fraternitati: folds 
JoelHunt007: raises $0.20 to $0.30
PokerDroop: raises $0.60 to $0.90
JoelHunt007: folds 
Uncalled bet ($0.60) returned to PokerDroop
PokerDroop collected $0.60 from pot
PokerDroop: doesn't show hand 
*** SUMMARY ***
Total pot $0.60 | Rake $0 
Seat 1: 1donkz0fks folded before Flop (didn't bet)
Seat 2: schoki77 folded before Flop (didn't bet)
Seat 3: KingPotNoodle folded before Flop (didn't bet)
Seat 4: fraternitati (button) folded before Flop (didn't bet)
Seat 5: JoelHunt007 (small blind) folded before Flop
Seat 6: PokerDroop (big blind) collected ($0.60)



PokerStars Hand #222943122163:  Hold'em No Limit ($0.05/$0.10 USD) - 2021/01/23 22:41:20 ET
Table 'Malzovia III' 6-max Seat #5 is the button
Seat 1: 1donkz0fks ($16.68 in chips) 
Seat 2: schoki77 ($9.27 in chips) 
Seat 3: KingPotNoodle ($11.47 in chips) 
Seat 4: fraternitati ($14.09 in chips) 
Seat 5: JoelHunt007 ($10 in chips) 
Seat 6: PokerDroop ($10.69 in chips) 
PokerDroop: posts small blind $0.05
1donkz0fks: posts big blind $0.10
*** HOLE CARDS ***
schoki77: folds 
KingPotNoodle: folds 
fraternitati: raises $0.20 to $0.30
JoelHunt007: folds 
PokerDroop: folds 
1donkz0fks: folds 
Uncalled bet ($0.20) returned to fraternitati
fraternitati collected $0.25 from pot
fraternitati: doesn't show hand 
*** SUMMARY ***
Total pot $0.25 | Rake $0 
Seat 1: 1donkz0fks (big blind) folded before Flop
Seat 2: schoki77 folded before Flop (didn't bet)
Seat 3: KingPotNoodle folded before Flop (didn't bet)
Seat 4: fraternitati collected ($0.25)
Seat 5: JoelHunt007 (button) folded before Flop (didn't bet)
Seat 6: PokerDroop (small blind) folded before Flop



PokerStars Hand #222943131297:  Hold'em No Limit ($0.05/$0.10 USD) - 2021/01/23 22:41:46 ET
Table 'Malzovia III' 6-max Seat #6 is the button
Seat 1: 1donkz0fks ($16.58 in chips) 
Seat 2: schoki77 ($9.27 in chips) 
Seat 3: KingPotNoodle ($11.47 in chips) 
Seat 4: fraternitati ($14.24 in chips) 
Seat 5: JoelHunt007 ($10 in chips) 
Seat 6: PokerDroop ($10.64 in chips) 
1donkz0fks: posts small blind $0.05
schoki77: posts big blind $0.10
*** HOLE CARDS ***
KingPotNoodle: raises $0.20 to $0.30
fraternitati: folds 
JoelHunt007: folds 
PokerDroop: folds 
1donkz0fks: folds 
schoki77: folds 
Uncalled bet ($0.20) returned to KingPotNoodle
KingPotNoodle collected $0.25 from pot
KingPotNoodle: doesn't show hand 
*** SUMMARY ***
Total pot $0.25 | Rake $0 
Seat 1: 1donkz0fks (small blind) folded before Flop
Seat 2: schoki77 (big blind) folded before Flop
Seat 3: KingPotNoodle collected ($0.25)
Seat 4: fraternitati folded before Flop (didn't bet)
Seat 5: JoelHunt007 folded before Flop (didn't bet)
Seat 6: PokerDroop (button) folded before Flop (didn't bet)



PokerStars Hand #222943137448:  Hold'em No Limit ($0.05/$0.10 USD) - 2021/01/23 22:42:04 ET
Table 'Malzovia III' 6-max Seat #1 is the button
Seat 1: 1donkz0fks ($16.53 in chips) 
Seat 2: schoki77 ($9.17 in chips) 
Seat 3: KingPotNoodle ($11.62 in chips) 
Seat 4: fraternitati ($14.24 in chips) 
Seat 5: JoelHunt007 ($10 in chips) 
Seat 6: PokerDroop ($10.64 in chips) 
schoki77: posts small blind $0.05
KingPotNoodle: posts big blind $0.10
*** HOLE CARDS ***
fraternitati: folds 
JoelHunt007: folds 
PokerDroop: folds 
1donkz0fks: folds 
schoki77: folds 
Uncalled bet ($0.05) returned to KingPotNoodle
KingPotNoodle collected $0.10 from pot
KingPotNoodle: doesn't show hand 
*** SUMMARY ***
Total pot $0.10 | Rake $0 
Seat 1: 1donkz0fks (button) folded before Flop (didn't bet)
Seat 2: schoki77 (small blind) folded before Flop
Seat 3: KingPotNoodle (big blind) collected ($0.10)
Seat 4: fraternitati folded before Flop (didn't bet)
Seat 5: JoelHunt007 folded before Flop (didn't bet)
Seat 6: PokerDroop folded before Flop (didn't bet)



PokerStars Hand #222943327214:  Hold'em No Limit ($0.05/$0.10 USD) - 2021/01/23 22:50:47 ET
Table 'Malzovia III' 6-max Seat #2 is the button
Seat 1: Vovan85656 ($5.91 in chips) 
Seat 2: schoki77 ($8.78 in chips) 
Seat 3: KingPotNoodle ($11.50 in chips) 
Seat 4: Himik30 ($11.09 in chips) 
Seat 5: AvGeL ($10.38 in chips) 
Seat 6: PokerDroop ($9.72 in chips) 
KingPotNoodle: posts small blind $0.05
Himik30: posts big blind $0.10
*** HOLE CARDS ***
AvGeL: folds 
PokerDroop: raises $0.20 to $0.30
Vovan85656: calls $0.30
schoki77: calls $0.30
KingPotNoodle: calls $0.25
Himik30: folds 
*** FLOP *** [8h 4d 3s]
KingPotNoodle: checks 
PokerDroop: checks 
Vovan85656: bets $0.62
schoki77: calls $0.62
KingPotNoodle: raises $10.58 to $11.20 and is all-in
PokerDroop: folds 
Vovan85656: folds 
schoki77: calls $7.86 and is all-in
Uncalled bet ($2.72) returned to KingPotNoodle
*** TURN *** [8h 4d 3s] [7c]
*** RIVER *** [8h 4d 3s 7c] [6s]
*** SHOW DOWN ***
KingPotNoodle: shows [7d 8c] (two pair, Eights and Sevens)
schoki77: shows [4s 4h] (three of a kind, Fours)
schoki77 cashed out the hand for $17.27 | Cash Out Fee $0.17
*** SUMMARY ***
Total pot $18.88 | Rake $0.85 
Board [8h 4d 3s 7c 6s]
Seat 1: Vovan85656 folded on the Flop
Seat 2: schoki77 (button) showed [4s 4h] and won ($18.03) with three of a kind, Fours (pot not awarded as player cashed out)
Seat 3: KingPotNoodle (small blind) showed [7d 8c] and lost with two pair, Eights and Sevens
Seat 4: Himik30 (big blind) folded before Flop
Seat 5: AvGeL folded before Flop (didn't bet)
Seat 6: PokerDroop folded on the Flop



PokerStars Hand #222943354922:  Hold'em No Limit ($0.05/$0.10 USD) - 2021/01/23 22:51:48 ET
Table 'Malzovia III' 6-max Seat #3 is the button
Seat 1: Vovan85656 ($4.99 in chips) 
Seat 2: schoki77 ($17.27 in chips) 
Seat 3: KingPotNoodle ($10 in chips) 
Seat 4: Himik30 ($10.99 in chips) 
Seat 5: AvGeL ($10.38 in chips) 
Seat 6: PokerDroop ($10 in chips) 
Himik30: posts small blind $0.05
AvGeL: posts big blind $0.10
*** HOLE CARDS ***
PokerDroop: folds 
Vovan85656: folds 
schoki77: calls $0.10
KingPotNoodle: raises $0.40 to $0.50
Himik30: folds 
AvGeL: folds 
schoki77: calls $0.40
*** FLOP *** [3c 2s Td]
schoki77: checks 
KingPotNoodle: bets $1.10
schoki77: folds 
Uncalled bet ($1.10) returned to KingPotNoodle
KingPotNoodle collected $1.10 from pot
KingPotNoodle: doesn't show hand 
*** SUMMARY ***
Total pot $1.15 | Rake $0.05 
Board [3c 2s Td]
Seat 1: Vovan85656 folded before Flop (didn't bet)
Seat 2: schoki77 folded on the Flop
Seat 3: KingPotNoodle (button) collected ($1.10)
Seat 4: Himik30 (small blind) folded before Flop
Seat 5: AvGeL (big blind) folded before Flop
Seat 6: PokerDroop folded before Flop (didn't bet)



PokerStars Hand #222943367939:  Hold'em No Limit ($0.05/$0.10 USD) - 2021/01/23 22:52:27 ET
Table 'Malzovia III' 6-max Seat #4 is the button
Seat 1: Vovan85656 ($4.99 in chips) 
Seat 2: schoki77 ($16.77 in chips) 
Seat 3: KingPotNoodle ($10.60 in chips) 
Seat 4: Himik30 ($10.94 in chips) 
Seat 5: AvGeL ($10.28 in chips) 
Seat 6: PokerDroop ($10 in chips) 
AvGeL: posts small blind $0.05
PokerDroop: posts big blind $0.10
*** HOLE CARDS ***
Vovan85656: folds 
schoki77: folds 
KingPotNoodle: raises $0.20 to $0.30
Himik30: folds 
AvGeL: folds 
PokerDroop: folds 
Uncalled bet ($0.20) returned to KingPotNoodle
KingPotNoodle collected $0.25 from pot
KingPotNoodle: doesn't show hand 
*** SUMMARY ***
Total pot $0.25 | Rake $0 
Seat 1: Vovan85656 folded before Flop (didn't bet)
Seat 2: schoki77 folded before Flop (didn't bet)
Seat 3: KingPotNoodle collected ($0.25)
Seat 4: Himik30 (button) folded before Flop (didn't bet)
Seat 5: AvGeL (small blind) folded before Flop
Seat 6: PokerDroop (big blind) folded before Flop



PokerStars Hand #222943376108:  Hold'em No Limit ($0.05/$0.10 USD) - 2021/01/23 22:52:51 ET
Table 'Malzovia III' 6-max Seat #5 is the button
Seat 1: Vovan85656 ($4.99 in chips) 
Seat 2: schoki77 ($16.77 in chips) 
Seat 3: KingPotNoodle ($10.75 in chips) 
Seat 4: Himik30 ($10.94 in chips) 
Seat 5: AvGeL ($10.23 in chips) 
Seat 6: PokerDroop ($9.90 in chips) 
PokerDroop: posts small blind $0.05
Vovan85656: posts big blind $0.10
*** HOLE CARDS ***
schoki77: folds 
KingPotNoodle: folds 
Himik30: raises $0.15 to $0.25
AvGeL: folds 
PokerDroop: folds 
Vovan85656: calls $0.15
*** FLOP *** [5h Js 5s]
Vovan85656: checks 
Himik30: bets $0.30
Vovan85656: raises $1.13 to $1.43
Himik30: folds 
Uncalled bet ($1.13) returned to Vovan85656
Vovan85656 collected $1.10 from pot
Vovan85656: doesn't show hand 
*** SUMMARY ***
Total pot $1.15 | Rake $0.05 
Board [5h Js 5s]
Seat 1: Vovan85656 (big blind) collected ($1.10)
Seat 2: schoki77 folded before Flop (didn't bet)
Seat 3: KingPotNoodle folded before Flop (didn't bet)
Seat 4: Himik30 folded on the Flop
Seat 5: AvGeL (button) folded before Flop (didn't bet)
Seat 6: PokerDroop (small blind) folded before Flop



PokerStars Hand #222943388321:  Hold'em No Limit ($0.05/$0.10 USD) - 2021/01/23 22:53:27 ET
Table 'Malzovia III' 6-max Seat #6 is the button
Seat 1: Vovan85656 ($5.54 in chips) 
Seat 2: schoki77 ($16.77 in chips) 
Seat 3: KingPotNoodle ($10.75 in chips) 
Seat 4: Himik30 ($10.39 in chips) 
Seat 5: AvGeL ($10.23 in chips) 
Seat 6: PokerDroop ($9.85 in chips) 
Vovan85656: posts small blind $0.05
schoki77: posts big blind $0.10
*** HOLE CARDS ***
KingPotNoodle: folds 
Himik30: folds 
AvGeL: folds 
PokerDroop: folds 
Vovan85656: raises $0.20 to $0.30
schoki77: folds 
Uncalled bet ($0.20) returned to Vovan85656
Vovan85656 collected $0.20 from pot
Vovan85656: doesn't show hand 
*** SUMMARY ***
Total pot $0.20 | Rake $0 
Seat 1: Vovan85656 (small blind) collected ($0.20)
Seat 2: schoki77 (big blind) folded before Flop
Seat 3: KingPotNoodle folded before Flop (didn't bet)
Seat 4: Himik30 folded before Flop (didn't bet)
Seat 5: AvGeL folded before Flop (didn't bet)
Seat 6: PokerDroop (button) folded before Flop (didn't bet)



PokerStars Hand #222943394638:  Hold'em No Limit ($0.05/$0.10 USD) - 2021/01/23 22:53:46 ET
Table 'Malzovia III' 6-max Seat #1 is the button
Seat 1: Vovan85656 ($5.64 in chips) 
Seat 2: schoki77 ($16.67 in chips) 
Seat 3: KingPotNoodle ($10.75 in chips) 
Seat 4: Himik30 ($10.39 in chips) 
Seat 5: AvGeL ($10.23 in chips) 
Seat 6: PokerDroop ($9.85 in chips) 
schoki77: posts small blind $0.05
KingPotNoodle: posts big blind $0.10
*** HOLE CARDS ***
Himik30: folds 
AvGeL: folds 
PokerDroop has timed out
PokerDroop: folds 
Vovan85656: folds 
schoki77: folds 
Uncalled bet ($0.05) returned to KingPotNoodle
KingPotNoodle collected $0.10 from pot
KingPotNoodle: doesn't show hand 
*** SUMMARY ***
Total pot $0.10 | Rake $0 
Seat 1: Vovan85656 (button) folded before Flop (didn't bet)
Seat 2: schoki77 (small blind) folded before Flop
Seat 3: KingPotNoodle (big blind) collected ($0.10)
Seat 4: Himik30 folded before Flop (didn't bet)
Seat 5: AvGeL folded before Flop (didn't bet)
Seat 6: PokerDroop folded before Flop (didn't bet)



PokerStars Hand #222943401488:  Hold'em No Limit ($0.05/$0.10 USD) - 2021/01/23 22:54:07 ET
Table 'Malzovia III' 6-max Seat #2 is the button
Seat 1: Vovan85656 ($5.64 in chips) 
Seat 2: schoki77 ($16.62 in chips) 
Seat 3: KingPotNoodle ($10.80 in chips) 
Seat 4: Himik30 ($10.39 in chips) 
Seat 5: AvGeL ($10.23 in chips) 
KingPotNoodle: posts small blind $0.05
Himik30: posts big blind $0.10
*** HOLE CARDS ***
AvGeL: folds 
Vovan85656: calls $0.10
schoki77: folds 
KingPotNoodle: raises $0.80 to $0.90
Himik30: folds 
Vovan85656: calls $0.80
*** FLOP *** [Kc Ts 4c]
KingPotNoodle: bets $5.55
Vovan85656: calls $4.74 and is all-in
Uncalled bet ($0.81) returned to KingPotNoodle
*** TURN *** [Kc Ts 4c] [7h]
*** RIVER *** [Kc Ts 4c 7h] [6d]
*** SHOW DOWN ***
KingPotNoodle: shows [Ah 7d] (a pair of Sevens)
Vovan85656: shows [3d Td] (a pair of Tens)
Vovan85656 collected $10.87 from pot
*** SUMMARY ***
Total pot $11.38 | Rake $0.51 
Board [Kc Ts 4c 7h 6d]
Seat 1: Vovan85656 showed [3d Td] and won ($10.87) with a pair of Tens
Seat 2: schoki77 (button) folded before Flop (didn't bet)
Seat 3: KingPotNoodle (small blind) showed [Ah 7d] and lost with a pair of Sevens
Seat 4: Himik30 (big blind) folded before Flop
Seat 5: AvGeL folded before Flop (didn't bet)



PokerStars Hand #222943413711:  Hold'em No Limit ($0.05/$0.10 USD) - 2021/01/23 22:54:43 ET
Table 'Malzovia III' 6-max Seat #3 is the button
Seat 1: Vovan85656 ($10.87 in chips) 
Seat 2: schoki77 ($16.62 in chips) 
Seat 3: KingPotNoodle ($10 in chips) 
Seat 4: Himik30 ($10.29 in chips) 
Seat 5: AvGeL ($10.23 in chips) 
Seat 6: PokerDroop ($9.85 in chips) 
Himik30: posts small blind $0.05
AvGeL: posts big blind $0.10
*** HOLE CARDS ***
PokerDroop: folds 
Vovan85656: calls $0.10
schoki77: folds 
KingPotNoodle: raises $1 to $1.10
Himik30: folds 
AvGeL: folds 
Vovan85656: calls $1
*** FLOP *** [7h 6d 4s]
Vovan85656: checks 
KingPotNoodle: bets $2.24
Vovan85656: calls $2.24
*** TURN *** [7h 6d 4s] [7c]
Vovan85656: checks 
KingPotNoodle: bets $6.66 and is all-in
Vovan85656: calls $6.66
*** RIVER *** [7h 6d 4s 7c] [5h]
*** SHOW DOWN ***
Vovan85656: shows [Th Ts] (two pair, Tens and Sevens)
KingPotNoodle: shows [9d 3h] (a straight, Three to Seven)
KingPotNoodle collected $19.24 from pot
*** SUMMARY ***
Total pot $20.15 | Rake $0.91 
Board [7h 6d 4s 7c 5h]
Seat 1: Vovan85656 showed [Th Ts] and lost with two pair, Tens and Sevens
Seat 2: schoki77 folded before Flop (didn't bet)
Seat 3: KingPotNoodle (button) showed [9d 3h] and won ($19.24) with a straight, Three to Seven
Seat 4: Himik30 (small blind) folded before Flop
Seat 5: AvGeL (big blind) folded before Flop
Seat 6: PokerDroop folded before Flop (didn't bet)



PokerStars Hand #222943427920:  Hold'em No Limit ($0.05/$0.10 USD) - 2021/01/23 22:55:32 ET
Table 'Malzovia III' 6-max Seat #4 is the button
Seat 1: Vovan85656 ($0.87 in chips) 
Seat 2: schoki77 ($16.62 in chips) 
Seat 3: KingPotNoodle ($19.24 in chips) 
Seat 4: Himik30 ($10.24 in chips) 
Seat 5: AvGeL ($10.13 in chips) 
Seat 6: PokerDroop ($9.85 in chips) 
AvGeL: posts small blind $0.05
PokerDroop: posts big blind $0.10
*** HOLE CARDS ***
Vovan85656: raises $0.77 to $0.87 and is all-in
schoki77: calls $0.87
KingPotNoodle: folds 
Himik30: folds 
AvGeL: folds 
PokerDroop: folds 
*** FLOP *** [Qc 7c 3s]
*** TURN *** [Qc 7c 3s] [Jd]
*** RIVER *** [Qc 7c 3s Jd] [Jh]
*** SHOW DOWN ***
Vovan85656: shows [7d 6s] (two pair, Jacks and Sevens)
schoki77: shows [As Qh] (two pair, Queens and Jacks)
schoki77 collected $1.80 from pot
Vovan85656 cashed out the hand for $0.67 | Cash Out Fee $0.01
*** SUMMARY ***
Total pot $1.89 | Rake $0.09 
Board [Qc 7c 3s Jd Jh]
Seat 1: Vovan85656 showed [7d 6s] and lost with two pair, Jacks and Sevens (cashed out).
Seat 2: schoki77 showed [As Qh] and won ($1.80) with two pair, Queens and Jacks
Seat 3: KingPotNoodle folded before Flop (didn't bet)
Seat 4: Himik30 (button) folded before Flop (didn't bet)
Seat 5: AvGeL (small blind) folded before Flop
Seat 6: PokerDroop (big blind) folded before Flop



PokerStars Hand #222943438478:  Hold'em No Limit ($0.05/$0.10 USD) - 2021/01/23 22:56:14 ET
Table 'Malzovia III' 6-max Seat #5 is the button
Seat 1: Vovan85656 ($0.67 in chips) 
Seat 2: schoki77 ($17.55 in chips) 
Seat 3: KingPotNoodle ($19.24 in chips) 
Seat 4: Himik30 ($10.24 in chips) 
Seat 5: AvGeL ($10.08 in chips) 
Seat 6: PokerDroop ($9.75 in chips) 
PokerDroop: posts small blind $0.05
Vovan85656: posts big blind $0.10
*** HOLE CARDS ***
schoki77: folds 
KingPotNoodle: folds 
Himik30: raises $0.15 to $0.25
AvGeL: folds 
PokerDroop: folds 
Vovan85656: folds 
Uncalled bet ($0.15) returned to Himik30
Himik30 collected $0.25 from pot
Himik30: doesn't show hand 
*** SUMMARY ***
Total pot $0.25 | Rake $0 
Seat 1: Vovan85656 (big blind) folded before Flop
Seat 2: schoki77 folded before Flop (didn't bet)
Seat 3: KingPotNoodle folded before Flop (didn't bet)
Seat 4: Himik30 collected ($0.25)
Seat 5: AvGeL (button) folded before Flop (didn't bet)
Seat 6: PokerDroop (small blind) folded before Flop



PokerStars Hand #222943441279:  Hold'em No Limit ($0.05/$0.10 USD) - 2021/01/23 22:56:25 ET
Table 'Malzovia III' 6-max Seat #6 is the button
Seat 1: Vovan85656 ($0.57 in chips) 
Seat 2: schoki77 ($17.55 in chips) 
Seat 3: KingPotNoodle ($19.24 in chips) 
Seat 4: Himik30 ($10.39 in chips) 
Seat 5: AvGeL ($10.08 in chips) 
Seat 6: PokerDroop ($9.70 in chips) 
Vovan85656: posts small blind $0.05
schoki77: posts big blind $0.10
*** HOLE CARDS ***
KingPotNoodle: folds 
Himik30: folds 
AvGeL: folds 
PokerDroop: raises $0.20 to $0.30
Vovan85656: folds 
schoki77: folds 
Uncalled bet ($0.20) returned to PokerDroop
PokerDroop collected $0.25 from pot
PokerDroop: doesn't show hand 
*** SUMMARY ***
Total pot $0.25 | Rake $0 
Seat 1: Vovan85656 (small blind) folded before Flop
Seat 2: schoki77 (big blind) folded before Flop
Seat 3: KingPotNoodle folded before Flop (didn't bet)
Seat 4: Himik30 folded before Flop (didn't bet)
Seat 5: AvGeL folded before Flop (didn't bet)
Seat 6: PokerDroop (button) collected ($0.25)



PokerStars Hand #222943445702:  Hold'em No Limit ($0.05/$0.10 USD) - 2021/01/23 22:56:42 ET
Table 'Malzovia III' 6-max Seat #1 is the button
Seat 1: Vovan85656 ($0.52 in chips) 
Seat 2: schoki77 ($17.45 in chips) 
Seat 3: KingPotNoodle ($19.24 in chips) 
Seat 4: Himik30 ($10.39 in chips) 
Seat 5: AvGeL ($10.08 in chips) 
Seat 6: PokerDroop ($9.85 in chips) 
schoki77: posts small blind $0.05
KingPotNoodle: posts big blind $0.10
*** HOLE CARDS ***
Himik30: folds 
AvGeL: folds 
PokerDroop: folds 
Vovan85656: folds 
schoki77: calls $0.05
KingPotNoodle: raises $0.30 to $0.40
schoki77: calls $0.30
*** FLOP *** [Tc Jh 6h]
schoki77: checks 
KingPotNoodle: checks 
*** TURN *** [Tc Jh 6h] [7h]
schoki77: checks 
KingPotNoodle: checks 
*** RIVER *** [Tc Jh 6h 7h] [8h]
schoki77: checks 
KingPotNoodle: bets $0.38
schoki77: calls $0.38
*** SHOW DOWN ***
KingPotNoodle: shows [Qh 8c] (a flush, Queen high)
schoki77: mucks hand 
KingPotNoodle collected $1.49 from pot
*** SUMMARY ***
Total pot $1.56 | Rake $0.07 
Board [Tc Jh 6h 7h 8h]
Seat 1: Vovan85656 (button) folded before Flop (didn't bet)
Seat 2: schoki77 (small blind) mucked
Seat 3: KingPotNoodle (big blind) showed [Qh 8c] and won ($1.49) with a flush, Queen high
Seat 4: Himik30 folded before Flop (didn't bet)
Seat 5: AvGeL folded before Flop (didn't bet)
Seat 6: PokerDroop folded before Flop (didn't bet)



PokerStars Hand #222943454869:  Hold'em No Limit ($0.05/$0.10 USD) - 2021/01/23 22:57:18 ET
Table 'Malzovia III' 6-max Seat #2 is the button
Seat 1: Vovan85656 ($0.52 in chips) 
Seat 2: schoki77 ($16.67 in chips) 
Seat 3: KingPotNoodle ($19.95 in chips) 
Seat 4: Himik30 ($10.39 in chips) 
Seat 5: AvGeL ($10.08 in chips) 
Seat 6: PokerDroop ($9.85 in chips) 
KingPotNoodle: posts small blind $0.05
Himik30: posts big blind $0.10
*** HOLE CARDS ***
AvGeL: folds 
PokerDroop: folds 
Vovan85656: folds 
schoki77: calls $0.10
KingPotNoodle: raises $0.20 to $0.30
Himik30: raises $0.80 to $1.10
schoki77: folds 
KingPotNoodle: folds [Ah]
Uncalled bet ($0.80) returned to Himik30
Himik30 collected $0.70 from pot
Himik30: doesn't show hand 
*** SUMMARY ***
Total pot $0.70 | Rake $0 
Seat 1: Vovan85656 folded before Flop (didn't bet)
Seat 2: schoki77 (button) folded before Flop
Seat 3: KingPotNoodle (small blind) folded before Flop
Seat 4: Himik30 (big blind) collected ($0.70)
Seat 5: AvGeL folded before Flop (didn't bet)
Seat 6: PokerDroop folded before Flop (didn't bet)



PokerStars Hand #222943462715:  Hold'em No Limit ($0.05/$0.10 USD) - 2021/01/23 22:57:49 ET
Table 'Malzovia III' 6-max Seat #3 is the button
Seat 1: Vovan85656 ($0.52 in chips) 
Seat 2: schoki77 ($16.57 in chips) 
Seat 3: KingPotNoodle ($19.65 in chips) 
Seat 4: Himik30 ($10.79 in chips) 
Seat 5: AvGeL ($10.08 in chips) 
Seat 6: PokerDroop ($9.85 in chips) 
Himik30: posts small blind $0.05
AvGeL: posts big blind $0.10
*** HOLE CARDS ***
PokerDroop: folds 
Vovan85656: folds 
schoki77: calls $0.10
KingPotNoodle: raises $0.40 to $0.50
Himik30: folds 
AvGeL: folds 
schoki77: calls $0.40
*** FLOP *** [9h 8c 9s]
schoki77: checks 
KingPotNoodle: checks 
*** TURN *** [9h 8c 9s] [Kh]
schoki77: checks 
KingPotNoodle: checks 
*** RIVER *** [9h 8c 9s Kh] [Kc]
schoki77: bets $1.10
KingPotNoodle: folds 
Uncalled bet ($1.10) returned to schoki77
schoki77 collected $1.10 from pot
schoki77: doesn't show hand 
*** SUMMARY ***
Total pot $1.15 | Rake $0.05 
Board [9h 8c 9s Kh Kc]
Seat 1: Vovan85656 folded before Flop (didn't bet)
Seat 2: schoki77 collected ($1.10)
Seat 3: KingPotNoodle (button) folded on the River
Seat 4: Himik30 (small blind) folded before Flop
Seat 5: AvGeL (big blind) folded before Flop
Seat 6: PokerDroop folded before Flop (didn't bet)



PokerStars Hand #222943474939:  Hold'em No Limit ($0.05/$0.10 USD) - 2021/01/23 22:58:36 ET
Table 'Malzovia III' 6-max Seat #4 is the button
Seat 1: Vovan85656 ($0.52 in chips) 
Seat 2: schoki77 ($17.17 in chips) 
Seat 3: KingPotNoodle ($19.15 in chips) 
Seat 4: Himik30 ($10.74 in chips) 
Seat 5: AvGeL ($10 in chips) 
Seat 6: PokerDroop ($9.85 in chips) 
AvGeL: posts small blind $0.05
PokerDroop: posts big blind $0.10
*** HOLE CARDS ***
Vovan85656: raises $0.42 to $0.52 and is all-in
schoki77: folds 
KingPotNoodle: folds 
Himik30: folds 
AvGeL: folds 
PokerDroop: folds 
Uncalled bet ($0.42) returned to Vovan85656
Vovan85656 collected $0.25 from pot
*** SUMMARY ***
Total pot $0.25 | Rake $0 
Seat 1: Vovan85656 collected ($0.25)
Seat 2: schoki77 folded before Flop (didn't bet)
Seat 3: KingPotNoodle folded before Flop (didn't bet)
Seat 4: Himik30 (button) folded before Flop (didn't bet)
Seat 5: AvGeL (small blind) folded before Flop
Seat 6: PokerDroop (big blind) folded before Flop



PokerStars Hand #222943480384:  Hold'em No Limit ($0.05/$0.10 USD) - 2021/01/23 22:58:58 ET
Table 'Malzovia III' 6-max Seat #5 is the button
Seat 1: Vovan85656 ($0.67 in chips) 
Seat 2: schoki77 ($17.17 in chips) 
Seat 3: KingPotNoodle ($19.15 in chips) 
Seat 4: Himik30 ($10.74 in chips) 
Seat 5: AvGeL ($10 in chips) 
Seat 6: PokerDroop ($9.75 in chips) 
PokerDroop: posts small blind $0.05
Vovan85656: posts big blind $0.10
*** HOLE CARDS ***
schoki77: folds 
KingPotNoodle: folds 
Himik30: raises $0.15 to $0.25
AvGeL: folds 
PokerDroop: folds 
Vovan85656: calls $0.15
*** FLOP *** [Kc 3h Js]
Vovan85656: checks 
Himik30: checks 
*** TURN *** [Kc 3h Js] [6h]
Vovan85656: checks 
Himik30: bets $0.45
Vovan85656: calls $0.42 and is all-in
Uncalled bet ($0.03) returned to Himik30
*** RIVER *** [Kc 3h Js 6h] [2h]
*** SHOW DOWN ***
Vovan85656: shows [Th 4h] (a flush, Ten high)
Himik30: shows [8h 9h] (a flush, Nine high)
Vovan85656 collected $1.33 from pot
Himik30 cashed out the hand for $0.18
*** SUMMARY ***
Total pot $1.39 | Rake $0.06 
Board [Kc 3h Js 6h 2h]
Seat 1: Vovan85656 (big blind) showed [Th 4h] and won ($1.33) with a flush, Ten high
Seat 2: schoki77 folded before Flop (didn't bet)
Seat 3: KingPotNoodle folded before Flop (didn't bet)
Seat 4: Himik30 showed [8h 9h] and lost with a flush, Nine high (cashed out).
Seat 5: AvGeL (button) folded before Flop (didn't bet)
Seat 6: PokerDroop (small blind) folded before Flop



PokerStars Hand #222943493083:  Hold'em No Limit ($0.05/$0.10 USD) - 2021/01/23 22:59:47 ET
Table 'Malzovia III' 6-max Seat #6 is the button
Seat 1: Vovan85656 ($1.33 in chips) 
Seat 2: schoki77 ($17.17 in chips) 
Seat 3: KingPotNoodle ($19.15 in chips) 
Seat 4: Himik30 ($10.25 in chips) 
Seat 5: AvGeL ($10 in chips) 
Seat 6: PokerDroop ($9.70 in chips) 
Vovan85656: posts small blind $0.05
schoki77: posts big blind $0.10
*** HOLE CARDS ***
KingPotNoodle: folds 
Himik30: folds 
AvGeL: folds 
PokerDroop: folds 
Vovan85656: folds 
Uncalled bet ($0.05) returned to schoki77
schoki77 collected $0.10 from pot
schoki77: doesn't show hand 
*** SUMMARY ***
Total pot $0.10 | Rake $0 
Seat 1: Vovan85656 (small blind) folded before Flop
Seat 2: schoki77 (big blind) collected ($0.10)
Seat 3: KingPotNoodle folded before Flop (didn't bet)
Seat 4: Himik30 folded before Flop (didn't bet)
Seat 5: AvGeL folded before Flop (didn't bet)
Seat 6: PokerDroop (button) folded before Flop (didn't bet)



PokerStars Hand #222943499222:  Hold'em No Limit ($0.05/$0.10 USD) - 2021/01/23 23:00:10 ET
Table 'Malzovia III' 6-max Seat #1 is the button
Seat 1: Vovan85656 ($1.28 in chips) 
Seat 2: schoki77 ($17.22 in chips) 
Seat 4: Himik30 ($10.25 in chips) 
Seat 5: AvGeL ($10 in chips) 
Seat 6: PokerDroop ($9.70 in chips) 
schoki77: posts small blind $0.05
KingPotNoodle: is sitting out 
Himik30: posts big blind $0.10
*** HOLE CARDS ***
AvGeL: folds 
KingPotNoodle leaves the table
KingPotNoodle joins the table at seat #3 
PokerDroop: raises $0.20 to $0.30
KingPotNoodle leaves the table
Vovan85656: calls $0.30
schoki77: folds 
Himik30: folds 
*** FLOP *** [9d 6s Js]
PokerDroop: bets $1
Vovan85656: calls $0.98 and is all-in
Uncalled bet ($0.02) returned to PokerDroop
schoki77 leaves the table
*** TURN *** [9d 6s Js] [7h]
*** RIVER *** [9d 6s Js 7h] [8d]
*** SHOW DOWN ***
PokerDroop: shows [Th Ac] (a straight, Seven to Jack)
Vovan85656: shows [Jc Qd] (a pair of Jacks)
PokerDroop collected $2.59 from pot
*** SUMMARY ***
Total pot $2.71 | Rake $0.12 
Board [9d 6s Js 7h 8d]
Seat 1: Vovan85656 (button) showed [Jc Qd] and lost with a pair of Jacks
Seat 2: schoki77 (small blind) folded before Flop
Seat 4: Himik30 (big blind) folded before Flop
Seat 5: AvGeL folded before Flop (didn't bet)
Seat 6: PokerDroop showed [Th Ac] and won ($2.59) with a straight, Seven to Jack



PokerStars Hand #222943510492:  Hold'em No Limit ($0.05/$0.10 USD) - 2021/01/23 23:00:47 ET
Table 'Malzovia III' 6-max Seat #4 is the button
Seat 4: Himik30 ($10.15 in chips) 
Seat 5: AvGeL ($10 in chips) 
Seat 6: PokerDroop ($11.01 in chips) 
AvGeL: posts small blind $0.05
PokerDroop: posts big blind $0.10
*** HOLE CARDS ***
Himik30: folds 
AvGeL: folds 
Uncalled bet ($0.05) returned to PokerDroop
PokerDroop collected $0.10 from pot
PokerDroop: doesn't show hand 
*** SUMMARY ***
Total pot $0.10 | Rake $0 
Seat 4: Himik30 (button) folded before Flop (didn't bet)
Seat 5: AvGeL (small blind) folded before Flop
Seat 6: PokerDroop (big blind) collected ($0.10)



PokerStars Hand #222943512300:  Hold'em No Limit ($0.05/$0.10 USD) - 2021/01/23 23:00:53 ET
Table 'Malzovia III' 6-max Seat #5 is the button
Seat 4: Himik30 ($10.15 in chips) 
Seat 5: AvGeL ($10 in chips) 
Seat 6: PokerDroop ($11.06 in chips) 
PokerDroop: posts small blind $0.05
Himik30: posts big blind $0.10
*** HOLE CARDS ***
AvGeL: raises $0.10 to $0.20
PokerDroop: raises $0.40 to $0.60
Himik30: folds 
Vovan85656 is disconnected 
AvGeL: raises $1.30 to $1.90
PokerDroop: calls $1.30
*** FLOP *** [Ks 3d Jh]
PokerDroop: bets $2
AvGeL: folds 
Uncalled bet ($2) returned to PokerDroop
PokerDroop collected $3.72 from pot
PokerDroop: doesn't show hand 
*** SUMMARY ***
Total pot $3.90 | Rake $0.18 
Board [Ks 3d Jh]
Seat 4: Himik30 (big blind) folded before Flop
Seat 5: AvGeL (button) folded on the Flop
Seat 6: PokerDroop (small blind) collected ($3.72)



PokerStars Hand #222943524430:  Hold'em No Limit ($0.05/$0.10 USD) - 2021/01/23 23:01:31 ET
Table 'Malzovia III' 6-max Seat #6 is the button
Seat 4: Himik30 ($10.05 in chips) 
Seat 5: AvGeL ($10 in chips) 
Seat 6: PokerDroop ($12.88 in chips) 
Himik30: posts small blind $0.05
AvGeL: posts big blind $0.10
*** HOLE CARDS ***
ildar87kzn joins the table at seat #2 
PokerDroop: folds 
Himik30: raises $0.20 to $0.30
AvGeL: folds 
Uncalled bet ($0.20) returned to Himik30
Himik30 collected $0.20 from pot
Himik30: doesn't show hand 
*** SUMMARY ***
Total pot $0.20 | Rake $0 
Seat 4: Himik30 (small blind) collected ($0.20)
Seat 5: AvGeL (big blind) folded before Flop
Seat 6: PokerDroop (button) folded before Flop (didn't bet)



PokerStars Hand #222943527042:  Hold'em No Limit ($0.05/$0.10 USD) - 2021/01/23 23:01:39 ET
Table 'Malzovia III' 6-max Seat #4 is the button
Seat 4: Himik30 ($10.15 in chips) 
Seat 5: AvGeL ($10 in chips) 
Seat 6: PokerDroop ($12.88 in chips) 
AvGeL: posts small blind $0.05
PokerDroop: posts big blind $0.10
ildar87kzn: sits out 
*** HOLE CARDS ***
Himik30: folds 
AvGeL: folds 
Uncalled bet ($0.05) returned to PokerDroop
PokerDroop collected $0.10 from pot
PokerDroop: doesn't show hand 
*** SUMMARY ***
Total pot $0.10 | Rake $0 
Seat 4: Himik30 (button) folded before Flop (didn't bet)
Seat 5: AvGeL (small blind) folded before Flop
Seat 6: PokerDroop (big blind) collected ($0.10)



PokerStars Hand #222943529333:  Hold'em No Limit ($0.05/$0.10 USD) - 2021/01/23 23:01:46 ET
Table 'Malzovia III' 6-max Seat #5 is the button
Seat 2: ildar87kzn ($10 in chips) 
Seat 4: Himik30 ($10.15 in chips) 
Seat 5: AvGeL ($10 in chips) 
Seat 6: PokerDroop ($12.93 in chips) 
PokerDroop: posts small blind $0.05
ildar87kzn: posts big blind $0.10
*** HOLE CARDS ***
Himik30: folds 
AvGeL: folds 
AAAcostA joins the table at seat #3 
PokerDroop: folds 
Uncalled bet ($0.05) returned to ildar87kzn
ildar87kzn collected $0.10 from pot
ildar87kzn: doesn't show hand 
*** SUMMARY ***
Total pot $0.10 | Rake $0 
Seat 2: ildar87kzn (big blind) collected ($0.10)
Seat 4: Himik30 folded before Flop (didn't bet)
Seat 5: AvGeL (button) folded before Flop (didn't bet)
Seat 6: PokerDroop (small blind) folded before Flop



PokerStars Hand #222946254788:  Hold'em No Limit ($0.05/$0.10 USD) - 2021/01/23 1:42:49 ET
Table 'Malzovia III' 6-max Seat #5 is the button
Seat 1: Ironman_rus1 ($10 in chips) 
Seat 3: oksuz77 ($3.60 in chips) 
Seat 5: jgussev ($6 in chips) 
Ironman_rus1: posts small blind $0.05
oksuz77: posts big blind $0.10
*** HOLE CARDS ***
nuikak joins the table at seat #4 
jgussev: calls $0.10
Ironman_rus1: folds 
oksuz77: checks 
*** FLOP *** [9d 7h Ts]
Robmanhawha joins the table at seat #6 
oksuz77: bets $0.10
jgussev: calls $0.10
*** TURN *** [9d 7h Ts] [Kc]
oksuz77: bets $0.10
jgussev: calls $0.10
*** RIVER *** [9d 7h Ts Kc] [Qh]
oksuz77: bets $0.10
jgussev: calls $0.10
*** SHOW DOWN ***
oksuz77: shows [Jh 8c] (a straight, Nine to King)
jgussev: mucks hand 
oksuz77 collected $0.81 from pot
*** SUMMARY ***
Total pot $0.85 | Rake $0.04 
Board [9d 7h Ts Kc Qh]
Seat 1: Ironman_rus1 (small blind) folded before Flop
Seat 3: oksuz77 (big blind) showed [Jh 8c] and won ($0.81) with a straight, Nine to King
Seat 5: jgussev (button) mucked



PokerStars Hand #222946261612:  Hold'em No Limit ($0.05/$0.10 USD) - 2021/01/23 1:43:17 ET
Table 'Malzovia III' 6-max Seat #1 is the button
Seat 1: Ironman_rus1 ($10 in chips) 
Seat 3: oksuz77 ($4.01 in chips) 
Seat 4: nuikak ($10 in chips) 
Seat 5: jgussev ($5.60 in chips) 
Seat 6: Robmanhawha ($8 in chips) 
oksuz77: posts small blind $0.05
nuikak: posts big blind $0.10
Robmanhawha: posts big blind $0.10
*** HOLE CARDS ***
jgussev: folds 
Robmanhawha: checks 
Ironman_rus1: folds 
oksuz77: folds 
nuikak: checks 
*** FLOP *** [9d Td 3s]
nuikak: checks 
Robmanhawha: checks 
*** TURN *** [9d Td 3s] [Jh]
nuikak: checks 
Robmanhawha has timed out
Robmanhawha: checks 
*** RIVER *** [9d Td 3s Jh] [Jd]
nuikak: checks 
Robmanhawha: checks 
*** SHOW DOWN ***
nuikak: shows [Qh 2d] (a pair of Jacks)
Robmanhawha: shows [7c 3h] (two pair, Jacks and Threes)
Robmanhawha collected $0.24 from pot
*** SUMMARY ***
Total pot $0.25 | Rake $0.01 
Board [9d Td 3s Jh Jd]
Seat 1: Ironman_rus1 (button) folded before Flop (didn't bet)
Seat 3: oksuz77 (small blind) folded before Flop
Seat 4: nuikak (big blind) showed [Qh 2d] and lost with a pair of Jacks
Seat 5: jgussev folded before Flop (didn't bet)
Seat 6: Robmanhawha showed [7c 3h] and won ($0.24) with two pair, Jacks and Threes



PokerStars Hand #222946279034:  Hold'em No Limit ($0.05/$0.10 USD) - 2021/01/23 1:44:31 ET
Table 'Malzovia III' 6-max Seat #3 is the button
Seat 1: Ironman_rus1 ($10 in chips) 
Seat 3: oksuz77 ($3.96 in chips) 
Seat 4: nuikak ($9.90 in chips) 
Seat 5: jgussev ($5.60 in chips) 
Seat 6: Robmanhawha ($8.14 in chips) 
nuikak: posts small blind $0.05
jgussev: posts big blind $0.10
*** HOLE CARDS ***
Robmanhawha: folds 
Ironman_rus1: folds 
oksuz77: raises $0.10 to $0.20
nuikak: folds 
jgussev: calls $0.10
*** FLOP *** [4s Qs Qd]
jgussev: bets $0.22
oksuz77: calls $0.22
*** TURN *** [4s Qs Qd] [6d]
jgussev: bets $0.30
oksuz77: calls $0.30
*** RIVER *** [4s Qs Qd 6d] [9h]
jgussev: checks 
oksuz77: bets $0.30
jgussev: folds 
Uncalled bet ($0.30) returned to oksuz77
oksuz77 collected $1.42 from pot
oksuz77: doesn't show hand 
*** SUMMARY ***
Total pot $1.49 | Rake $0.07 
Board [4s Qs Qd 6d 9h]
Seat 1: Ironman_rus1 folded before Flop (didn't bet)
Seat 3: oksuz77 (button) collected ($1.42)
Seat 4: nuikak (small blind) folded before Flop
Seat 5: jgussev (big blind) folded on the River
Seat 6: Robmanhawha folded before Flop (didn't bet)



PokerStars Hand #222946293862:  Hold'em No Limit ($0.05/$0.10 USD) - 2021/01/23 1:45:34 ET
Table 'Malzovia III' 6-max Seat #4 is the button
Seat 1: Ironman_rus1 ($10 in chips) 
Seat 3: oksuz77 ($4.66 in chips) 
Seat 4: nuikak ($9.85 in chips) 
Seat 5: jgussev ($4.88 in chips) 
Seat 6: Robmanhawha ($8.14 in chips) 
jgussev: posts small blind $0.05
Robmanhawha: posts big blind $0.10
*** HOLE CARDS ***
Ironman_rus1: folds 
oksuz77: folds 
nuikak: folds 
jgussev: calls $0.05
Robmanhawha: raises $0.20 to $0.30
jgussev: calls $0.20
*** FLOP *** [2h 6d Jd]
jgussev: checks 
Robmanhawha: bets $1
jgussev: folds 
Uncalled bet ($1) returned to Robmanhawha
Robmanhawha collected $0.57 from pot
Robmanhawha: doesn't show hand 
*** SUMMARY ***
Total pot $0.60 | Rake $0.03 
Board [2h 6d Jd]
Seat 1: Ironman_rus1 folded before Flop (didn't bet)
Seat 3: oksuz77 folded before Flop (didn't bet)
Seat 4: nuikak (button) folded before Flop (didn't bet)
Seat 5: jgussev (small blind) folded on the Flop
Seat 6: Robmanhawha (big blind) collected ($0.57)



PokerStars Hand #222946301828:  Hold'em No Limit ($0.05/$0.10 USD) - 2021/01/23 1:46:08 ET
Table 'Malzovia III' 6-max Seat #5 is the button
Seat 1: Ironman_rus1 ($10 in chips) 
Seat 3: oksuz77 ($4.66 in chips) 
Seat 4: nuikak ($9.85 in chips) 
Seat 5: jgussev ($4.58 in chips) 
Seat 6: Robmanhawha ($8.41 in chips) 
Robmanhawha: posts small blind $0.05
Ironman_rus1: posts big blind $0.10
*** HOLE CARDS ***
oksuz77: raises $0.20 to $0.30
nuikak: folds 
jgussev: folds 
Robmanhawha: folds 
Ironman_rus1: folds 
Uncalled bet ($0.20) returned to oksuz77
oksuz77 collected $0.25 from pot
oksuz77: doesn't show hand 
*** SUMMARY ***
Total pot $0.25 | Rake $0 
Seat 1: Ironman_rus1 (big blind) folded before Flop
Seat 3: oksuz77 collected ($0.25)
Seat 4: nuikak folded before Flop (didn't bet)
Seat 5: jgussev (button) folded before Flop (didn't bet)
Seat 6: Robmanhawha (small blind) folded before Flop



PokerStars Hand #222946306362:  Hold'em No Limit ($0.05/$0.10 USD) - 2021/01/23 1:46:27 ET
Table 'Malzovia III' 6-max Seat #6 is the button
Seat 1: Ironman_rus1 ($10 in chips) 
Seat 3: oksuz77 ($4.81 in chips) 
Seat 4: nuikak ($9.85 in chips) 
Seat 5: jgussev ($4.58 in chips) 
Seat 6: Robmanhawha ($8.36 in chips) 
Ironman_rus1: posts small blind $0.05
oksuz77: posts big blind $0.10
*** HOLE CARDS ***
nuikak: folds 
jgussev: folds 
Robmanhawha: raises $0.10 to $0.20
Ironman_rus1: folds 
oksuz77: calls $0.10
*** FLOP *** [8s Ks 4h]
oksuz77: checks 
Robmanhawha: checks 
*** TURN *** [8s Ks 4h] [Ah]
oksuz77: bets $0.10
Robmanhawha has timed out
Robmanhawha: folds 
Uncalled bet ($0.10) returned to oksuz77
oksuz77 collected $0.43 from pot
oksuz77: doesn't show hand 
*** SUMMARY ***
Total pot $0.45 | Rake $0.02 
Board [8s Ks 4h Ah]
Seat 1: Ironman_rus1 (small blind) folded before Flop
Seat 3: oksuz77 (big blind) collected ($0.43)
Seat 4: nuikak folded before Flop (didn't bet)
Seat 5: jgussev folded before Flop (didn't bet)
Seat 6: Robmanhawha (button) folded on the Turn



PokerStars Hand #222946318401:  Hold'em No Limit ($0.05/$0.10 USD) - 2021/01/23 1:47:18 ET
Table 'Malzovia III' 6-max Seat #1 is the button
Seat 1: Ironman_rus1 ($10 in chips) 
Seat 3: oksuz77 ($5.04 in chips) 
Seat 4: nuikak ($9.85 in chips) 
Seat 5: jgussev ($4.58 in chips) 
oksuz77: posts small blind $0.05
nuikak: posts big blind $0.10
*** HOLE CARDS ***
jgussev: calls $0.10
Ironman_rus1: folds 
oksuz77: calls $0.05
nuikak: checks 
*** FLOP *** [Qc 3s Ad]
oksuz77: bets $0.10
nuikak: folds 
jgussev: folds 
Uncalled bet ($0.10) returned to oksuz77
oksuz77 collected $0.29 from pot
oksuz77: doesn't show hand 
*** SUMMARY ***
Total pot $0.30 | Rake $0.01 
Board [Qc 3s Ad]
Seat 1: Ironman_rus1 (button) folded before Flop (didn't bet)
Seat 3: oksuz77 (small blind) collected ($0.29)
Seat 4: nuikak (big blind) folded on the Flop
Seat 5: jgussev folded on the Flop



PokerStars Hand #222946323801:  Hold'em No Limit ($0.05/$0.10 USD) - 2021/01/23 1:47:41 ET
Table 'Malzovia III' 6-max Seat #3 is the button
Seat 1: Ironman_rus1 ($10 in chips) 
Seat 3: oksuz77 ($5.23 in chips) 
Seat 4: nuikak ($9.75 in chips) 
Seat 5: jgussev ($4.48 in chips) 
nuikak: posts small blind $0.05
jgussev: posts big blind $0.10
*** HOLE CARDS ***
Ironman_rus1: raises $0.20 to $0.30
oksuz77: folds 
nuikak: folds 
jgussev: folds 
Uncalled bet ($0.20) returned to Ironman_rus1
Ironman_rus1 collected $0.25 from pot
*** SUMMARY ***
Total pot $0.25 | Rake $0 
Seat 1: Ironman_rus1 collected ($0.25)
Seat 3: oksuz77 (button) folded before Flop (didn't bet)
Seat 4: nuikak (small blind) folded before Flop
Seat 5: jgussev (big blind) folded before Flop



PokerStars Hand #222946326926:  Hold'em No Limit ($0.05/$0.10 USD) - 2021/01/23 1:47:55 ET
Table 'Malzovia III' 6-max Seat #4 is the button
Seat 1: Ironman_rus1 ($10.15 in chips) 
Seat 3: oksuz77 ($5.23 in chips) 
Seat 4: nuikak ($9.70 in chips) 
Seat 5: jgussev ($4.38 in chips) 
jgussev: posts small blind $0.05
Ironman_rus1: posts big blind $0.10
*** HOLE CARDS ***
oksuz77: folds 
nuikak: folds 
jgussev: calls $0.05
Ironman_rus1: checks 
*** FLOP *** [8c 4s Qs]
jgussev: checks 
Ironman_rus1: checks 
*** TURN *** [8c 4s Qs] [7c]
jgussev: checks 
Ironman_rus1: checks 
*** RIVER *** [8c 4s Qs 7c] [5d]
jgussev: bets $0.19
Ironman_rus1: raises $0.21 to $0.40
jgussev: folds 
Uncalled bet ($0.21) returned to Ironman_rus1
Ironman_rus1 collected $0.55 from pot
*** SUMMARY ***
Total pot $0.58 | Rake $0.03 
Board [8c 4s Qs 7c 5d]
Seat 1: Ironman_rus1 (big blind) collected ($0.55)
Seat 3: oksuz77 folded before Flop (didn't bet)
Seat 4: nuikak (button) folded before Flop (didn't bet)
Seat 5: jgussev (small blind) folded on the River



PokerStars Hand #222946336624:  Hold'em No Limit ($0.05/$0.10 USD) - 2021/01/23 1:48:36 ET
Table 'Malzovia III' 6-max Seat #5 is the button
Seat 1: Ironman_rus1 ($10.41 in chips) 
Seat 3: oksuz77 ($5.23 in chips) 
Seat 4: nuikak ($9.70 in chips) 
Seat 5: jgussev ($4.09 in chips) 
Ironman_rus1: posts small blind $0.05
oksuz77: posts big blind $0.10
*** HOLE CARDS ***
nuikak: folds 
jgussev: calls $0.10
Ironman_rus1: folds 
oksuz77: checks 
*** FLOP *** [2c Kh 3d]
oksuz77: bets $0.10
jgussev: calls $0.10
*** TURN *** [2c Kh 3d] [5h]
oksuz77: bets $0.20
jgussev: calls $0.20
*** RIVER *** [2c Kh 3d 5h] [5d]
oksuz77: bets $0.80
jgussev: folds 
Uncalled bet ($0.80) returned to oksuz77
oksuz77 collected $0.81 from pot
oksuz77: doesn't show hand 
*** SUMMARY ***
Total pot $0.85 | Rake $0.04 
Board [2c Kh 3d 5h 5d]
Seat 1: Ironman_rus1 (small blind) folded before Flop
Seat 3: oksuz77 (big blind) collected ($0.81)
Seat 4: nuikak folded before Flop (didn't bet)
Seat 5: jgussev (button) folded on the River



PokerStars Hand #222946344197:  Hold'em No Limit ($0.05/$0.10 USD) - 2021/01/23 1:49:09 ET
Table 'Malzovia III' 6-max Seat #1 is the button
Seat 1: Ironman_rus1 ($10.36 in chips) 
Seat 3: oksuz77 ($5.64 in chips) 
Seat 4: nuikak ($9.70 in chips) 
Seat 5: jgussev ($3.69 in chips) 
Seat 6: Robmanhawha ($8.16 in chips) 
oksuz77: posts small blind $0.05
nuikak: posts big blind $0.10
Robmanhawha: posts small & big blinds $0.15
*** HOLE CARDS ***
jgussev: calls $0.10
Robmanhawha: checks 
Ironman_rus1: folds 
oksuz77: folds 
nuikak: checks 
*** FLOP *** [Th Jc Kh]
nuikak: checks 
jgussev: bets $0.10
Robmanhawha has timed out
Robmanhawha: folds 
nuikak: folds 
Uncalled bet ($0.10) returned to jgussev
jgussev collected $0.38 from pot
jgussev: doesn't show hand 
*** SUMMARY ***
Total pot $0.40 | Rake $0.02 
Board [Th Jc Kh]
Seat 1: Ironman_rus1 (button) folded before Flop (didn't bet)
Seat 3: oksuz77 (small blind) folded before Flop
Seat 4: nuikak (big blind) folded on the Flop
Seat 5: jgussev collected ($0.38)
Seat 6: Robmanhawha folded on the Flop (didn't bet)



PokerStars Hand #222946352788:  Hold'em No Limit ($0.05/$0.10 USD) - 2021/01/23 1:49:42 ET
Table 'Malzovia III' 6-max Seat #3 is the button
Seat 1: Ironman_rus1 ($10.36 in chips) 
Seat 3: oksuz77 ($5.59 in chips) 
Seat 4: nuikak ($9.60 in chips) 
Seat 5: jgussev ($3.97 in chips) 
nuikak: posts small blind $0.05
jgussev: posts big blind $0.10
*** HOLE CARDS ***
Ironman_rus1: folds 
oksuz77: folds 
nuikak: calls $0.05
jgussev: checks 
*** FLOP *** [Jc 5d 3s]
nuikak: checks 
jgussev: checks 
*** TURN *** [Jc 5d 3s] [4c]
nuikak: bets $0.20
jgussev: calls $0.20
*** RIVER *** [Jc 5d 3s 4c] [4d]
nuikak: checks 
jgussev: checks 
*** SHOW DOWN ***
nuikak: shows [6h 8d] (a pair of Fours)
jgussev: shows [6d Ts] (a pair of Fours - Jack+Ten kicker)
jgussev collected $0.57 from pot
*** SUMMARY ***
Total pot $0.60 | Rake $0.03 
Board [Jc 5d 3s 4c 4d]
Seat 1: Ironman_rus1 folded before Flop (didn't bet)
Seat 3: oksuz77 (button) folded before Flop (didn't bet)
Seat 4: nuikak (small blind) showed [6h 8d] and lost with a pair of Fours
Seat 5: jgussev (big blind) showed [6d Ts] and won ($0.57) with a pair of Fours



PokerStars Hand #222946360527:  Hold'em No Limit ($0.05/$0.10 USD) - 2021/01/23 1:50:16 ET
Table 'Malzovia III' 6-max Seat #4 is the button
Seat 1: Ironman_rus1 ($10.36 in chips) 
Seat 3: oksuz77 ($5.59 in chips) 
Seat 4: nuikak ($9.30 in chips) 
Seat 5: jgussev ($4.24 in chips) 
jgussev: posts small blind $0.05
Ironman_rus1: posts big blind $0.10
*** HOLE CARDS ***
oksuz77: folds 
nuikak: folds 
jgussev: calls $0.05
Ironman_rus1: checks 
*** FLOP *** [As 5h Qd]
jgussev: bets $0.20
Ironman_rus1: folds 
Uncalled bet ($0.20) returned to jgussev
jgussev collected $0.19 from pot
jgussev: doesn't show hand 
*** SUMMARY ***
Total pot $0.20 | Rake $0.01 
Board [As 5h Qd]
Seat 1: Ironman_rus1 (big blind) folded on the Flop
Seat 3: oksuz77 folded before Flop (didn't bet)
Seat 4: nuikak (button) folded before Flop (didn't bet)
Seat 5: jgussev (small blind) collected ($0.19)



PokerStars Hand #222946364702:  Hold'em No Limit ($0.05/$0.10 USD) - 2021/01/23 1:50:34 ET
Table 'Malzovia III' 6-max Seat #5 is the button
Seat 1: Ironman_rus1 ($10.26 in chips) 
Seat 3: oksuz77 ($5.59 in chips) 
Seat 4: nuikak ($9.30 in chips) 
Seat 5: jgussev ($4.33 in chips) 
Ironman_rus1: posts small blind $0.05
oksuz77: posts big blind $0.10
*** HOLE CARDS ***
nuikak: folds 
jgussev: calls $0.10
Ironman_rus1: folds 
oksuz77: checks 
*** FLOP *** [9c Ac 2d]
oksuz77: checks 
jgussev: bets $0.24
oksuz77: folds 
Uncalled bet ($0.24) returned to jgussev
jgussev collected $0.24 from pot
NeMaProbl3ma was removed from the table for failing to post
NeMaProbl3ma leaves the table
jgussev: doesn't show hand 
*** SUMMARY ***
Total pot $0.25 | Rake $0.01 
Board [9c Ac 2d]
Seat 1: Ironman_rus1 (small blind) folded before Flop
Seat 3: oksuz77 (big blind) folded on the Flop
Seat 4: nuikak folded before Flop (didn't bet)
Seat 5: jgussev (button) collected ($0.24)



PokerStars Hand #222946369042:  Hold'em No Limit ($0.05/$0.10 USD) - 2021/01/23 1:50:53 ET
Table 'Malzovia III' 6-max Seat #1 is the button
Seat 1: Ironman_rus1 ($10.21 in chips) 
Seat 3: oksuz77 ($5.49 in chips) 
Seat 4: nuikak ($9.30 in chips) 
Seat 5: jgussev ($4.47 in chips) 
oksuz77: posts small blind $0.05
nuikak: posts big blind $0.10
*** HOLE CARDS ***
jgussev: calls $0.10
Ironman_rus1: folds 
oksuz77: folds 
nuikak: checks 
*** FLOP *** [Qh Ac As]
nuikak: checks 
jgussev: bets $0.24
nuikak: folds 
Uncalled bet ($0.24) returned to jgussev
jgussev collected $0.24 from pot
jgussev: doesn't show hand 
*** SUMMARY ***
Total pot $0.25 | Rake $0.01 
Board [Qh Ac As]
Seat 1: Ironman_rus1 (button) folded before Flop (didn't bet)
Seat 3: oksuz77 (small blind) folded before Flop
Seat 4: nuikak (big blind) folded on the Flop
Seat 5: jgussev collected ($0.24)



PokerStars Hand #222946373889:  Hold'em No Limit ($0.05/$0.10 USD) - 2021/01/23 1:51:14 ET
Table 'Malzovia III' 6-max Seat #3 is the button
Seat 1: Ironman_rus1 ($10.21 in chips) 
Seat 3: oksuz77 ($5.44 in chips) 
Seat 4: nuikak ($9.20 in chips) 
Seat 5: jgussev ($4.61 in chips) 
nuikak: posts small blind $0.05
jgussev: posts big blind $0.10
Robmanhawha: sits out 
*** HOLE CARDS ***
Ironman_rus1: raises $0.20 to $0.30
oksuz77: folds 
nuikak: folds 
jgussev: folds 
Uncalled bet ($0.20) returned to Ironman_rus1
Ironman_rus1 collected $0.25 from pot
*** SUMMARY ***
Total pot $0.25 | Rake $0 
Seat 1: Ironman_rus1 collected ($0.25)
Seat 3: oksuz77 (button) folded before Flop (didn't bet)
Seat 4: nuikak (small blind) folded before Flop
Seat 5: jgussev (big blind) folded before Flop



PokerStars Hand #222946377028:  Hold'em No Limit ($0.05/$0.10 USD) - 2021/01/23 1:51:27 ET
Table 'Malzovia III' 6-max Seat #4 is the button
Seat 1: Ironman_rus1 ($10.36 in chips) 
Seat 3: oksuz77 ($5.44 in chips) 
Seat 4: nuikak ($9.15 in chips) 
Seat 5: jgussev ($4.51 in chips) 
Seat 6: Robmanhawha ($8.01 in chips) 
jgussev: posts small blind $0.05
Robmanhawha: posts big blind $0.10
*** HOLE CARDS ***
Ironman_rus1: folds 
oksuz77: folds 
nuikak: folds 
jgussev: calls $0.05
petrovichkag joins the table at seat #2 
Robmanhawha has timed out
Robmanhawha: checks 
*** FLOP *** [2c 5d Kd]
jgussev: checks 
Robmanhawha has timed out
Robmanhawha: checks 
*** TURN *** [2c 5d Kd] [3c]
jgussev: bets $0.10
Robmanhawha has timed out
Robmanhawha: folds 
Uncalled bet ($0.10) returned to jgussev
jgussev collected $0.19 from pot
jgussev: doesn't show hand 
*** SUMMARY ***
Total pot $0.20 | Rake $0.01 
Board [2c 5d Kd 3c]
Seat 1: Ironman_rus1 folded before Flop (didn't bet)
Seat 3: oksuz77 folded before Flop (didn't bet)
Seat 4: nuikak (button) folded before Flop (didn't bet)
Seat 5: jgussev (small blind) collected ($0.19)
Seat 6: Robmanhawha (big blind) folded on the Turn



PokerStars Hand #222946394616:  Hold'em No Limit ($0.05/$0.10 USD) - 2021/01/23 1:52:43 ET
Table 'Malzovia III' 6-max Seat #5 is the button
Seat 1: Ironman_rus1 ($10.36 in chips) 
Seat 2: petrovichkag ($16.35 in chips) 
Seat 3: oksuz77 ($5.44 in chips) 
Seat 4: nuikak ($9.15 in chips) 
Seat 5: jgussev ($4.60 in chips) 
Ironman_rus1: posts small blind $0.05
petrovichkag: posts big blind $0.10
*** HOLE CARDS ***
oksuz77: folds 
nuikak: folds 
jgussev: folds 
Ironman_rus1: folds 
Uncalled bet ($0.05) returned to petrovichkag
petrovichkag collected $0.10 from pot
petrovichkag: doesn't show hand 
*** SUMMARY ***
Total pot $0.10 | Rake $0 
Seat 1: Ironman_rus1 (small blind) folded before Flop
Seat 2: petrovichkag (big blind) collected ($0.10)
Seat 3: oksuz77 folded before Flop (didn't bet)
Seat 4: nuikak folded before Flop (didn't bet)
Seat 5: jgussev (button) folded before Flop (didn't bet)



PokerStars Hand #222946396107:  Hold'em No Limit ($0.05/$0.10 USD) - 2021/01/23 1:52:50 ET
Table 'Malzovia III' 6-max Seat #1 is the button
Seat 1: Ironman_rus1 ($10.31 in chips) 
Seat 2: petrovichkag ($16.40 in chips) 
Seat 3: oksuz77 ($5.44 in chips) 
Seat 4: nuikak ($9.15 in chips) 
Seat 5: jgussev ($4.60 in chips) 
petrovichkag: posts small blind $0.05
oksuz77: posts big blind $0.10
*** HOLE CARDS ***
nuikak: folds 
jgussev: folds 
Ironman_rus1: folds 
petrovichkag: folds 
Uncalled bet ($0.05) returned to oksuz77
oksuz77 collected $0.10 from pot
oksuz77: doesn't show hand 
*** SUMMARY ***
Total pot $0.10 | Rake $0 
Seat 1: Ironman_rus1 (button) folded before Flop (didn't bet)
Seat 2: petrovichkag (small blind) folded before Flop
Seat 3: oksuz77 (big blind) collected ($0.10)
Seat 4: nuikak folded before Flop (didn't bet)
Seat 5: jgussev folded before Flop (didn't bet)



PokerStars Hand #222946400371:  Hold'em No Limit ($0.05/$0.10 USD) - 2021/01/23 1:52:59 ET
Table 'Malzovia III' 6-max Seat #2 is the button
Seat 1: Ironman_rus1 ($10.31 in chips) 
Seat 2: petrovichkag ($16.35 in chips) 
Seat 3: oksuz77 ($5.49 in chips) 
Seat 4: nuikak ($9.15 in chips) 
Seat 5: jgussev ($4.60 in chips) 
oksuz77: posts small blind $0.05
nuikak: posts big blind $0.10
*** HOLE CARDS ***
jgussev: calls $0.10
Ironman_rus1: raises $0.30 to $0.40
petrovichkag: folds 
oksuz77: folds 
nuikak: folds 
jgussev: calls $0.30
*** FLOP *** [Qs 8h Ts]
jgussev: checks 
Ironman_rus1: bets $0.46
jgussev: folds 
Uncalled bet ($0.46) returned to Ironman_rus1
Ironman_rus1 collected $0.91 from pot
*** SUMMARY ***
Total pot $0.95 | Rake $0.04 
Board [Qs 8h Ts]
Seat 1: Ironman_rus1 collected ($0.91)
Seat 2: petrovichkag (button) folded before Flop (didn't bet)
Seat 3: oksuz77 (small blind) folded before Flop
Seat 4: nuikak (big blind) folded before Flop
Seat 5: jgussev folded on the Flop



PokerStars Hand #222946407060:  Hold'em No Limit ($0.05/$0.10 USD) - 2021/01/23 1:53:28 ET
Table 'Malzovia III' 6-max Seat #3 is the button
Seat 1: Ironman_rus1 ($10.82 in chips) 
Seat 2: petrovichkag ($16.35 in chips) 
Seat 3: oksuz77 ($5.44 in chips) 
Seat 4: nuikak ($9.05 in chips) 
Seat 5: jgussev ($4.20 in chips) 
nuikak: posts small blind $0.05
jgussev: posts big blind $0.10
*** HOLE CARDS ***
Ironman_rus1: raises $0.20 to $0.30
petrovichkag: folds 
oksuz77: folds 
nuikak: folds 
jgussev: calls $0.20
*** FLOP *** [6s 2d 5s]
jgussev: bets $0.31
Ironman_rus1: folds 
Uncalled bet ($0.31) returned to jgussev
jgussev collected $0.62 from pot
jgussev: doesn't show hand 
*** SUMMARY ***
Total pot $0.65 | Rake $0.03 
Board [6s 2d 5s]
Seat 1: Ironman_rus1 folded on the Flop
Seat 2: petrovichkag folded before Flop (didn't bet)
Seat 3: oksuz77 (button) folded before Flop (didn't bet)
Seat 4: nuikak (small blind) folded before Flop
Seat 5: jgussev (big blind) collected ($0.62)



PokerStars Hand #222946411654:  Hold'em No Limit ($0.05/$0.10 USD) - 2021/01/23 1:53:48 ET
Table 'Malzovia III' 6-max Seat #4 is the button
Seat 1: Ironman_rus1 ($10.52 in chips) 
Seat 2: petrovichkag ($16.35 in chips) 
Seat 3: oksuz77 ($5.44 in chips) 
Seat 4: nuikak ($9 in chips) 
Seat 5: jgussev ($4.52 in chips) 
jgussev: posts small blind $0.05
Ironman_rus1: posts big blind $0.10
*** HOLE CARDS ***
petrovichkag: folds 
oksuz77: raises $0.10 to $0.20
nuikak: raises $0.55 to $0.75
jgussev: folds 
Ironman_rus1: folds 
oksuz77: folds 
Uncalled bet ($0.55) returned to nuikak
nuikak collected $0.55 from pot
nuikak: doesn't show hand 
*** SUMMARY ***
Total pot $0.55 | Rake $0 
Seat 1: Ironman_rus1 (big blind) folded before Flop
Seat 2: petrovichkag folded before Flop (didn't bet)
Seat 3: oksuz77 folded before Flop
Seat 4: nuikak (button) collected ($0.55)
Seat 5: jgussev (small blind) folded before Flop



PokerStars Hand #222946414900:  Hold'em No Limit ($0.05/$0.10 USD) - 2021/01/23 1:54:02 ET
Table 'Malzovia III' 6-max Seat #5 is the button
Seat 1: Ironman_rus1 ($10.42 in chips) 
Seat 2: petrovichkag ($16.35 in chips) 
Seat 3: oksuz77 ($5.24 in chips) 
Seat 4: nuikak ($9.35 in chips) 
Seat 5: jgussev ($4.47 in chips) 
Ironman_rus1: posts small blind $0.05
petrovichkag: posts big blind $0.10
*** HOLE CARDS ***
oksuz77: folds 
nuikak: folds 
jgussev: folds 
Ironman_rus1: folds 
Uncalled bet ($0.05) returned to petrovichkag
petrovichkag collected $0.10 from pot
petrovichkag: doesn't show hand 
*** SUMMARY ***
Total pot $0.10 | Rake $0 
Seat 1: Ironman_rus1 (small blind) folded before Flop
Seat 2: petrovichkag (big blind) collected ($0.10)
Seat 3: oksuz77 folded before Flop (didn't bet)
Seat 4: nuikak folded before Flop (didn't bet)
Seat 5: jgussev (button) folded before Flop (didn't bet)



PokerStars Hand #222946417738:  Hold'em No Limit ($0.05/$0.10 USD) - 2021/01/23 1:54:14 ET
Table 'Malzovia III' 6-max Seat #1 is the button
Seat 1: Ironman_rus1 ($10.37 in chips) 
Seat 2: petrovichkag ($16.40 in chips) 
Seat 3: oksuz77 ($5.24 in chips) 
Seat 4: nuikak ($9.35 in chips) 
Seat 5: jgussev ($4.47 in chips) 
petrovichkag: posts small blind $0.05
oksuz77: posts big blind $0.10
*** HOLE CARDS ***
nuikak: folds 
jgussev: calls $0.10
Ironman_rus1: folds 
petrovichkag: folds 
oksuz77: checks 
*** FLOP *** [5c 6h Jh]
oksuz77: checks 
jgussev: bets $0.10
oksuz77: folds 
Uncalled bet ($0.10) returned to jgussev
jgussev collected $0.24 from pot
jgussev: doesn't show hand 
*** SUMMARY ***
Total pot $0.25 | Rake $0.01 
Board [5c 6h Jh]
Seat 1: Ironman_rus1 (button) folded before Flop (didn't bet)
Seat 2: petrovichkag (small blind) folded before Flop
Seat 3: oksuz77 (big blind) folded on the Flop
Seat 4: nuikak folded before Flop (didn't bet)
Seat 5: jgussev collected ($0.24)



PokerStars Hand #222946422185:  Hold'em No Limit ($0.05/$0.10 USD) - 2021/01/23 1:54:33 ET
Table 'Malzovia III' 6-max Seat #2 is the button
Seat 1: Ironman_rus1 ($10.37 in chips) 
Seat 2: petrovichkag ($16.35 in chips) 
Seat 3: oksuz77 ($5.14 in chips) 
Seat 4: nuikak ($9.35 in chips) 
Seat 5: jgussev ($4.61 in chips) 
oksuz77: posts small blind $0.05
nuikak: posts big blind $0.10
*** HOLE CARDS ***
jgussev: calls $0.10
Ironman_rus1: raises $0.30 to $0.40
petrovichkag: folds 
oksuz77: folds 
nuikak: folds 
jgussev: calls $0.30
*** FLOP *** [As 4c Ts]
jgussev: bets $0.40
Ironman_rus1: calls $0.40
*** TURN *** [As 4c Ts] [3s]
jgussev: bets $0.50
Ironman_rus1: folds 
Uncalled bet ($0.50) returned to jgussev
jgussev collected $1.67 from pot
jgussev: doesn't show hand 
*** SUMMARY ***
Total pot $1.75 | Rake $0.08 
Board [As 4c Ts 3s]
Seat 1: Ironman_rus1 folded on the Turn
Seat 2: petrovichkag (button) folded before Flop (didn't bet)
Seat 3: oksuz77 (small blind) folded before Flop
Seat 4: nuikak (big blind) folded before Flop
Seat 5: jgussev collected ($1.67)



PokerStars Hand #222946429963:  Hold'em No Limit ($0.05/$0.10 USD) - 2021/01/23 1:55:07 ET
Table 'Malzovia III' 6-max Seat #3 is the button
Seat 1: Ironman_rus1 ($10 in chips) 
Seat 2: petrovichkag ($16.35 in chips) 
Seat 3: oksuz77 ($5.09 in chips) 
Seat 4: nuikak ($9.25 in chips) 
Seat 5: jgussev ($5.48 in chips) 
nuikak: posts small blind $0.05
jgussev: posts big blind $0.10
*** HOLE CARDS ***
Ironman_rus1: folds 
petrovichkag: raises $0.14 to $0.24
oksuz77: folds 
nuikak: folds 
jgussev: calls $0.14
*** FLOP *** [2d 6h 6s]
jgussev: checks 
petrovichkag: bets $0.17
jgussev: calls $0.17
*** TURN *** [2d 6h 6s] [Qh]
jgussev: checks 
petrovichkag: bets $0.50
jgussev: calls $0.50
*** RIVER *** [2d 6h 6s Qh] [8d]
jgussev: checks 
petrovichkag: checks 
*** SHOW DOWN ***
jgussev: shows [2h 7c] (two pair, Sixes and Deuces)
petrovichkag: shows [9c 9h] (two pair, Nines and Sixes)
petrovichkag collected $1.79 from pot
*** SUMMARY ***
Total pot $1.87 | Rake $0.08 
Board [2d 6h 6s Qh 8d]
Seat 1: Ironman_rus1 folded before Flop (didn't bet)
Seat 2: petrovichkag showed [9c 9h] and won ($1.79) with two pair, Nines and Sixes
Seat 3: oksuz77 (button) folded before Flop (didn't bet)
Seat 4: nuikak (small blind) folded before Flop
Seat 5: jgussev (big blind) showed [2h 7c] and lost with two pair, Sixes and Deuces



PokerStars Hand #222946438274:  Hold'em No Limit ($0.05/$0.10 USD) - 2021/01/23 1:55:50 ET
Table 'Malzovia III' 6-max Seat #4 is the button
Seat 2: petrovichkag ($17.23 in chips) 
Seat 3: oksuz77 ($5.09 in chips) 
Seat 4: nuikak ($9.20 in chips) 
Seat 5: jgussev ($4.57 in chips) 
jgussev: posts small blind $0.05
Ironman_rus1: is sitting out 
Ironman_rus1 leaves the table
petrovichkag: posts big blind $0.10
*** HOLE CARDS ***
oksuz77: folds 
nuikak: raises $0.20 to $0.30
jgussev: calls $0.25
petrovichkag: folds 
*** FLOP *** [Ad 3d 4h]
jgussev: bets $0.10
nuikak: calls $0.10
*** TURN *** [Ad 3d 4h] [3c]
jgussev: bets $0.43
nuikak: folds 
Uncalled bet ($0.43) returned to jgussev
jgussev collected $0.86 from pot
jgussev: doesn't show hand 
*** SUMMARY ***
Total pot $0.90 | Rake $0.04 
Board [Ad 3d 4h 3c]
Seat 2: petrovichkag (big blind) folded before Flop
Seat 3: oksuz77 folded before Flop (didn't bet)
Seat 4: nuikak (button) folded on the Turn
Seat 5: jgussev (small blind) collected ($0.86)



PokerStars Hand #222946443234:  Hold'em No Limit ($0.05/$0.10 USD) - 2021/01/23 1:56:15 ET
Table 'Malzovia III' 6-max Seat #5 is the button
Seat 2: petrovichkag ($17.13 in chips) 
Seat 3: oksuz77 ($5.09 in chips) 
Seat 4: nuikak ($8.80 in chips) 
Seat 5: jgussev ($5.03 in chips) 
petrovichkag: posts small blind $0.05
oksuz77: posts big blind $0.10
*** HOLE CARDS ***
nuikak: folds 
jgussev: calls $0.10
petrovichkag: folds 
oksuz77: checks 
*** FLOP *** [2s Kd 2c]
nuikak leaves the table
oksuz77: checks 
jgussev: checks 
*** TURN *** [2s Kd 2c] [Th]
oksuz77: bets $0.10
jgussev: folds 
Uncalled bet ($0.10) returned to oksuz77
oksuz77 collected $0.24 from pot
oksuz77: doesn't show hand 
*** SUMMARY ***
Total pot $0.25 | Rake $0.01 
Board [2s Kd 2c Th]
Seat 2: petrovichkag (small blind) folded before Flop
Seat 3: oksuz77 (big blind) collected ($0.24)
Seat 4: nuikak folded before Flop (didn't bet)
Seat 5: jgussev (button) folded on the Turn



PokerStars Hand #222946447842:  Hold'em No Limit ($0.05/$0.10 USD) - 2021/01/23 1:56:39 ET
Table 'Malzovia III' 6-max Seat #2 is the button
Seat 2: petrovichkag ($17.08 in chips) 
Seat 3: oksuz77 ($5.23 in chips) 
Seat 5: jgussev ($4.93 in chips) 
oksuz77: posts small blind $0.05
jgussev: posts big blind $0.10
*** HOLE CARDS ***
petrovichkag: folds 
oksuz77: calls $0.05
jgussev: checks 
*** FLOP *** [7c 5c 4d]
oksuz77: checks 
jgussev: bets $0.10
oksuz77: folds 
Uncalled bet ($0.10) returned to jgussev
jgussev collected $0.19 from pot
jgussev: doesn't show hand 
*** SUMMARY ***
Total pot $0.20 | Rake $0.01 
Board [7c 5c 4d]
Seat 2: petrovichkag (button) folded before Flop (didn't bet)
Seat 3: oksuz77 (small blind) folded on the Flop
Seat 5: jgussev (big blind) collected ($0.19)



PokerStars Hand #222946451247:  Hold'em No Limit ($0.05/$0.10 USD) - 2021/01/23 1:56:57 ET
Table 'Malzovia III' 6-max Seat #3 is the button
Seat 2: petrovichkag ($17.08 in chips) 
Seat 3: oksuz77 ($5.13 in chips) 
Seat 5: jgussev ($5.02 in chips) 
jgussev: posts small blind $0.05
petrovichkag: posts big blind $0.10
*** HOLE CARDS ***
oksuz77: folds 
jgussev: raises $0.10 to $0.20
petrovichkag: folds 
Uncalled bet ($0.10) returned to jgussev
jgussev collected $0.20 from pot
Robmanhawha was removed from the table for failing to post
Robmanhawha leaves the table
jgussev: doesn't show hand 
*** SUMMARY ***
Total pot $0.20 | Rake $0 
Seat 2: petrovichkag (big blind) folded before Flop
Seat 3: oksuz77 (button) folded before Flop (didn't bet)
Seat 5: jgussev (small blind) collected ($0.20)



PokerStars Hand #222946452552:  Hold'em No Limit ($0.05/$0.10 USD) - 2021/01/23 1:57:04 ET
Table 'Malzovia III' 6-max Seat #5 is the button
Seat 2: petrovichkag ($16.98 in chips) 
Seat 3: oksuz77 ($5.13 in chips) 
Seat 5: jgussev ($5.12 in chips) 
petrovichkag: posts small blind $0.05
oksuz77: posts big blind $0.10
*** HOLE CARDS ***
jgussev: calls $0.10
petrovichkag: folds 
oksuz77: checks 
*** FLOP *** [Kd 2s 5d]
oksuz77: checks 
jgussev: bets $0.10
oksuz77: folds 
Uncalled bet ($0.10) returned to jgussev
jgussev collected $0.24 from pot
jgussev: doesn't show hand 
*** SUMMARY ***
Total pot $0.25 | Rake $0.01 
Board [Kd 2s 5d]
Seat 2: petrovichkag (small blind) folded before Flop
Seat 3: oksuz77 (big blind) folded on the Flop
Seat 5: jgussev (button) collected ($0.24)



PokerStars Hand #222946455691:  Hold'em No Limit ($0.05/$0.10 USD) - 2021/01/23 1:57:20 ET
Table 'Malzovia III' 6-max Seat #2 is the button
Seat 2: petrovichkag ($16.93 in chips) 
Seat 3: oksuz77 ($5.03 in chips) 
Seat 5: jgussev ($5.26 in chips) 
oksuz77: posts small blind $0.05
jgussev: posts big blind $0.10
*** HOLE CARDS ***
petrovichkag: folds 
oksuz77: folds 
Uncalled bet ($0.05) returned to jgussev
jgussev collected $0.10 from pot
jgussev: doesn't show hand 
*** SUMMARY ***
Total pot $0.10 | Rake $0 
Seat 2: petrovichkag (button) folded before Flop (didn't bet)
Seat 3: oksuz77 (small blind) folded before Flop
Seat 5: jgussev (big blind) collected ($0.10)



PokerStars Hand #222946456537:  Hold'em No Limit ($0.05/$0.10 USD) - 2021/01/23 1:57:24 ET
Table 'Malzovia III' 6-max Seat #3 is the button
Seat 2: petrovichkag ($16.93 in chips) 
Seat 3: oksuz77 ($4.98 in chips) 
Seat 5: jgussev ($5.31 in chips) 
jgussev: posts small blind $0.05
petrovichkag: posts big blind $0.10
*** HOLE CARDS ***
oksuz77: raises $0.10 to $0.20
jgussev: folds 
petrovichkag: calls $0.10
*** FLOP *** [6s 9d 6d]
petrovichkag: checks 
oksuz77: bets $0.10
petrovichkag: calls $0.10
*** TURN *** [6s 9d 6d] [4d]
petrovichkag: checks 
oksuz77: bets $0.10
jgussev leaves the table
petrovichkag: folds 
Uncalled bet ($0.10) returned to oksuz77
oksuz77 collected $0.62 from pot
oksuz77: doesn't show hand 
*** SUMMARY ***
Total pot $0.65 | Rake $0.03 
Board [6s 9d 6d 4d]
Seat 2: petrovichkag (big blind) folded on the Turn
Seat 3: oksuz77 (button) collected ($0.62)
Seat 5: jgussev (small blind) folded before Flop



PokerStars Hand #222946461376:  Hold'em No Limit ($0.05/$0.10 USD) - 2021/01/23 1:57:49 ET
Table 'Malzovia III' 6-max Seat #2 is the button
Seat 2: petrovichkag ($16.63 in chips) 
Seat 3: oksuz77 ($5.30 in chips) 
petrovichkag: posts small blind $0.05
oksuz77: posts big blind $0.10
*** HOLE CARDS ***
petrovichkag: folds 
Uncalled bet ($0.05) returned to oksuz77
oksuz77 collected $0.10 from pot
oksuz77: doesn't show hand 
*** SUMMARY ***
Total pot $0.10 | Rake $0 
Seat 2: petrovichkag (button) (small blind) folded before Flop
Seat 3: oksuz77 (big blind) collected ($0.10)



PokerStars Hand #222946462622:  Hold'em No Limit ($0.05/$0.10 USD) - 2021/01/23 1:57:56 ET
Table 'Malzovia III' 6-max Seat #3 is the button
Seat 2: petrovichkag ($16.58 in chips) 
Seat 3: oksuz77 ($5.35 in chips) 
oksuz77: posts small blind $0.05
petrovichkag: posts big blind $0.10
*** HOLE CARDS ***
oksuz77: raises $0.10 to $0.20
petrovichkag: folds 
Uncalled bet ($0.10) returned to oksuz77
oksuz77 collected $0.20 from pot
oksuz77: doesn't show hand 
*** SUMMARY ***
Total pot $0.20 | Rake $0 
Seat 2: petrovichkag (big blind) folded before Flop
Seat 3: oksuz77 (button) (small blind) collected ($0.20)



PokerStars Hand #222946463719:  Hold'em No Limit ($0.05/$0.10 USD) - 2021/01/23 1:58:01 ET
Table 'Malzovia III' 6-max Seat #2 is the button
Seat 2: petrovichkag ($16.48 in chips) 
Seat 3: oksuz77 ($5.45 in chips) 
petrovichkag: posts small blind $0.05
oksuz77: posts big blind $0.10
*** HOLE CARDS ***
petrovichkag: folds 
Uncalled bet ($0.05) returned to oksuz77
oksuz77 collected $0.10 from pot
oksuz77: doesn't show hand 
*** SUMMARY ***
Total pot $0.10 | Rake $0 
Seat 2: petrovichkag (button) (small blind) folded before Flop
Seat 3: oksuz77 (big blind) collected ($0.10)



PokerStars Hand #222946504202:  Hold'em No Limit ($0.05/$0.10 USD) - 2021/01/23 2:01:19 ET
Table 'Malzovia III' 6-max Seat #3 is the button
Seat 3: oksuz77 ($5.50 in chips) 
Seat 4: beastboy3690 ($10 in chips) 
oksuz77: posts small blind $0.05
beastboy3690: posts big blind $0.10
*** HOLE CARDS ***
oksuz77: calls $0.05
beastboy3690: checks 
*** FLOP *** [5c 6s Js]
beastboy3690: checks 
oksuz77: checks 
*** TURN *** [5c 6s Js] [2d]
beastboy3690: bets $0.12
oksuz77: folds 
Uncalled bet ($0.12) returned to beastboy3690
beastboy3690 collected $0.19 from pot
beastboy3690: doesn't show hand 
*** SUMMARY ***
Total pot $0.20 | Rake $0.01 
Board [5c 6s Js 2d]
Seat 3: oksuz77 (button) (small blind) folded on the Turn
Seat 4: beastboy3690 (big blind) collected ($0.19)



PokerStars Hand #222946509562:  Hold'em No Limit ($0.05/$0.10 USD) - 2021/01/23 2:01:43 ET
Table 'Malzovia III' 6-max Seat #4 is the button
Seat 3: oksuz77 ($5.40 in chips) 
Seat 4: beastboy3690 ($10.09 in chips) 
beastboy3690: posts small blind $0.05
oksuz77: posts big blind $0.10
*** HOLE CARDS ***
beastboy3690: folds 
Uncalled bet ($0.05) returned to oksuz77
oksuz77 collected $0.10 from pot
oksuz77: doesn't show hand 
*** SUMMARY ***
Total pot $0.10 | Rake $0 
Seat 3: oksuz77 (big blind) collected ($0.10)
Seat 4: beastboy3690 (button) (small blind) folded before Flop



PokerStars Hand #222946510939:  Hold'em No Limit ($0.05/$0.10 USD) - 2021/01/23 2:01:49 ET
Table 'Malzovia III' 6-max Seat #3 is the button
Seat 3: oksuz77 ($5.45 in chips) 
Seat 4: beastboy3690 ($10.04 in chips) 
oksuz77: posts small blind $0.05
beastboy3690: posts big blind $0.10
*** HOLE CARDS ***
oksuz77: calls $0.05
beastboy3690: raises $0.40 to $0.50
oksuz77: folds 
Uncalled bet ($0.40) returned to beastboy3690
beastboy3690 collected $0.20 from pot
beastboy3690: doesn't show hand 
*** SUMMARY ***
Total pot $0.20 | Rake $0 
Seat 3: oksuz77 (button) (small blind) folded before Flop
Seat 4: beastboy3690 (big blind) collected ($0.20)



PokerStars Hand #222946513058:  Hold'em No Limit ($0.05/$0.10 USD) - 2021/01/23 2:01:58 ET
Table 'Malzovia III' 6-max Seat #4 is the button
Seat 3: oksuz77 ($5.35 in chips) 
Seat 4: beastboy3690 ($10.14 in chips) 
beastboy3690: posts small blind $0.05
oksuz77: posts big blind $0.10
*** HOLE CARDS ***
beastboy3690: raises $0.15 to $0.25
oksuz77: folds 
Uncalled bet ($0.15) returned to beastboy3690
beastboy3690 collected $0.20 from pot
beastboy3690: doesn't show hand 
*** SUMMARY ***
Total pot $0.20 | Rake $0 
Seat 3: oksuz77 (big blind) folded before Flop
Seat 4: beastboy3690 (button) (small blind) collected ($0.20)



PokerStars Hand #222946515038:  Hold'em No Limit ($0.05/$0.10 USD) - 2021/01/23 2:02:06 ET
Table 'Malzovia III' 6-max Seat #3 is the button
Seat 3: oksuz77 ($5.25 in chips) 
Seat 4: beastboy3690 ($10.24 in chips) 
oksuz77: posts small blind $0.05
beastboy3690: posts big blind $0.10
*** HOLE CARDS ***
oksuz77: folds 
Uncalled bet ($0.05) returned to beastboy3690
beastboy3690 collected $0.10 from pot
beastboy3690: doesn't show hand 
*** SUMMARY ***
Total pot $0.10 | Rake $0 
Seat 3: oksuz77 (button) (small blind) folded before Flop
Seat 4: beastboy3690 (big blind) collected ($0.10)



PokerStars Hand #222946516176:  Hold'em No Limit ($0.05/$0.10 USD) - 2021/01/23 2:02:11 ET
Table 'Malzovia III' 6-max Seat #4 is the button
Seat 3: oksuz77 ($5.20 in chips) 
Seat 4: beastboy3690 ($10.29 in chips) 
beastboy3690: posts small blind $0.05
oksuz77: posts big blind $0.10
*** HOLE CARDS ***
beastboy3690: raises $0.15 to $0.25
oksuz77: calls $0.15
*** FLOP *** [6h Ah 5h]
oksuz77: bets $0.10
beastboy3690: folds 
Uncalled bet ($0.10) returned to oksuz77
oksuz77 collected $0.48 from pot
oksuz77: doesn't show hand 
*** SUMMARY ***
Total pot $0.50 | Rake $0.02 
Board [6h Ah 5h]
Seat 3: oksuz77 (big blind) collected ($0.48)
Seat 4: beastboy3690 (button) (small blind) folded on the Flop



PokerStars Hand #222946519986:  Hold'em No Limit ($0.05/$0.10 USD) - 2021/01/23 2:02:27 ET
Table 'Malzovia III' 6-max Seat #3 is the button
Seat 3: oksuz77 ($5.43 in chips) 
Seat 4: beastboy3690 ($10.04 in chips) 
oksuz77: posts small blind $0.05
beastboy3690: posts big blind $0.10
*** HOLE CARDS ***
oksuz77: folds 
Uncalled bet ($0.05) returned to beastboy3690
beastboy3690 collected $0.10 from pot
beastboy3690: doesn't show hand 
*** SUMMARY ***
Total pot $0.10 | Rake $0 
Seat 3: oksuz77 (button) (small blind) folded before Flop
Seat 4: beastboy3690 (big blind) collected ($0.10)



PokerStars Hand #222946521278:  Hold'em No Limit ($0.05/$0.10 USD) - 2021/01/23 2:02:33 ET
Table 'Malzovia III' 6-max Seat #4 is the button
Seat 3: oksuz77 ($5.38 in chips) 
Seat 4: beastboy3690 ($10.09 in chips) 
beastboy3690: posts small blind $0.05
oksuz77: posts big blind $0.10
*** HOLE CARDS ***
beastboy3690: folds 
Uncalled bet ($0.05) returned to oksuz77
oksuz77 collected $0.10 from pot
oksuz77: doesn't show hand 
*** SUMMARY ***
Total pot $0.10 | Rake $0 
Seat 3: oksuz77 (big blind) collected ($0.10)
Seat 4: beastboy3690 (button) (small blind) folded before Flop



PokerStars Hand #222946522347:  Hold'em No Limit ($0.05/$0.10 USD) - 2021/01/23 2:02:38 ET
Table 'Malzovia III' 6-max Seat #3 is the button
Seat 3: oksuz77 ($5.43 in chips) 
Seat 4: beastboy3690 ($10.04 in chips) 
oksuz77: posts small blind $0.05
beastboy3690: posts big blind $0.10
*** HOLE CARDS ***
oksuz77: calls $0.05
beastboy3690: raises $0.40 to $0.50
oksuz77: folds 
Uncalled bet ($0.40) returned to beastboy3690
beastboy3690 collected $0.20 from pot
beastboy3690: doesn't show hand 
*** SUMMARY ***
Total pot $0.20 | Rake $0 
Seat 3: oksuz77 (button) (small blind) folded before Flop
Seat 4: beastboy3690 (big blind) collected ($0.20)



PokerStars Hand #222946524876:  Hold'em No Limit ($0.05/$0.10 USD) - 2021/01/23 2:02:49 ET
Table 'Malzovia III' 6-max Seat #4 is the button
Seat 3: oksuz77 ($5.33 in chips) 
Seat 4: beastboy3690 ($10.14 in chips) 
beastboy3690: posts small blind $0.05
oksuz77: posts big blind $0.10
*** HOLE CARDS ***
beastboy3690: raises $0.15 to $0.25
oksuz77: calls $0.15
*** FLOP *** [Jh 5s 8c]
oksuz77: checks 
beastboy3690: bets $0.16
oksuz77: folds 
Uncalled bet ($0.16) returned to beastboy3690
beastboy3690 collected $0.48 from pot
beastboy3690: doesn't show hand 
*** SUMMARY ***
Total pot $0.50 | Rake $0.02 
Board [Jh 5s 8c]
Seat 3: oksuz77 (big blind) folded on the Flop
Seat 4: beastboy3690 (button) (small blind) collected ($0.48)



PokerStars Hand #222946528217:  Hold'em No Limit ($0.05/$0.10 USD) - 2021/01/23 2:03:03 ET
Table 'Malzovia III' 6-max Seat #3 is the button
Seat 3: oksuz77 ($5.08 in chips) 
Seat 4: beastboy3690 ($10.37 in chips) 
oksuz77: posts small blind $0.05
beastboy3690: posts big blind $0.10
*** HOLE CARDS ***
oksuz77: folds 
Uncalled bet ($0.05) returned to beastboy3690
beastboy3690 collected $0.10 from pot
beastboy3690: doesn't show hand 
*** SUMMARY ***
Total pot $0.10 | Rake $0 
Seat 3: oksuz77 (button) (small blind) folded before Flop
Seat 4: beastboy3690 (big blind) collected ($0.10)



PokerStars Hand #222946529413:  Hold'em No Limit ($0.05/$0.10 USD) - 2021/01/23 2:03:08 ET
Table 'Malzovia III' 6-max Seat #4 is the button
Seat 3: oksuz77 ($5.03 in chips) 
Seat 4: beastboy3690 ($10.42 in chips) 
beastboy3690: posts small blind $0.05
oksuz77: posts big blind $0.10
*** HOLE CARDS ***
beastboy3690: raises $0.15 to $0.25
oksuz77: folds 
Uncalled bet ($0.15) returned to beastboy3690
beastboy3690 collected $0.20 from pot
beastboy3690: doesn't show hand 
*** SUMMARY ***
Total pot $0.20 | Rake $0 
Seat 3: oksuz77 (big blind) folded before Flop
Seat 4: beastboy3690 (button) (small blind) collected ($0.20)



PokerStars Hand #222946531444:  Hold'em No Limit ($0.05/$0.10 USD) - 2021/01/23 2:03:17 ET
Table 'Malzovia III' 6-max Seat #3 is the button
Seat 3: oksuz77 ($4.93 in chips) 
Seat 4: beastboy3690 ($10.52 in chips) 
oksuz77: posts small blind $0.05
beastboy3690: posts big blind $0.10
*** HOLE CARDS ***
oksuz77: calls $0.05
beastboy3690: checks 
*** FLOP *** [Tc Jd 9s]
beastboy3690: checks 
oksuz77: bets $0.10
beastboy3690: calls $0.10
*** TURN *** [Tc Jd 9s] [8d]
beastboy3690: checks 
oksuz77: bets $0.20
beastboy3690: folds 
Uncalled bet ($0.20) returned to oksuz77
oksuz77 collected $0.38 from pot
oksuz77: doesn't show hand 
*** SUMMARY ***
Total pot $0.40 | Rake $0.02 
Board [Tc Jd 9s 8d]
Seat 3: oksuz77 (button) (small blind) collected ($0.38)
Seat 4: beastboy3690 (big blind) folded on the Turn



PokerStars Hand #222946546780:  Hold'em No Limit ($0.05/$0.10 USD) - 2021/01/23 2:03:47 ET
Table 'Malzovia III' 6-max Seat #4 is the button
Seat 3: oksuz77 ($5.11 in chips) 
Seat 4: beastboy3690 ($10.32 in chips) 
beastboy3690: posts small blind $0.05
oksuz77: posts big blind $0.10
*** HOLE CARDS ***
beastboy3690: raises $0.15 to $0.25
oksuz77: folds 
Uncalled bet ($0.15) returned to beastboy3690
beastboy3690 collected $0.20 from pot
beastboy3690: doesn't show hand 
*** SUMMARY ***
Total pot $0.20 | Rake $0 
Seat 3: oksuz77 (big blind) folded before Flop
Seat 4: beastboy3690 (button) (small blind) collected ($0.20)



PokerStars Hand #222946548584:  Hold'em No Limit ($0.05/$0.10 USD) - 2021/01/23 2:03:55 ET
Table 'Malzovia III' 6-max Seat #3 is the button
Seat 3: oksuz77 ($5.01 in chips) 
Seat 4: beastboy3690 ($10.42 in chips) 
oksuz77: posts small blind $0.05
beastboy3690: posts big blind $0.10
*** HOLE CARDS ***
oksuz77: folds 
Uncalled bet ($0.05) returned to beastboy3690
beastboy3690 collected $0.10 from pot
beastboy3690: doesn't show hand 
*** SUMMARY ***
Total pot $0.10 | Rake $0 
Seat 3: oksuz77 (button) (small blind) folded before Flop
Seat 4: beastboy3690 (big blind) collected ($0.10)



PokerStars Hand #222946549709:  Hold'em No Limit ($0.05/$0.10 USD) - 2021/01/23 2:04:00 ET
Table 'Malzovia III' 6-max Seat #4 is the button
Seat 3: oksuz77 ($4.96 in chips) 
Seat 4: beastboy3690 ($10.47 in chips) 
beastboy3690: posts small blind $0.05
oksuz77: posts big blind $0.10
*** HOLE CARDS ***
beastboy3690: raises $0.15 to $0.25
oksuz77: folds 
Uncalled bet ($0.15) returned to beastboy3690
beastboy3690 collected $0.20 from pot
beastboy3690: doesn't show hand 
*** SUMMARY ***
Total pot $0.20 | Rake $0 
Seat 3: oksuz77 (big blind) folded before Flop
Seat 4: beastboy3690 (button) (small blind) collected ($0.20)



PokerStars Hand #222946551128:  Hold'em No Limit ($0.05/$0.10 USD) - 2021/01/23 2:04:06 ET
Table 'Malzovia III' 6-max Seat #3 is the button
Seat 3: oksuz77 ($4.86 in chips) 
Seat 4: beastboy3690 ($10.57 in chips) 
oksuz77: posts small blind $0.05
beastboy3690: posts big blind $0.10
*** HOLE CARDS ***
oksuz77: folds 
Uncalled bet ($0.05) returned to beastboy3690
beastboy3690 collected $0.10 from pot
beastboy3690: doesn't show hand 
*** SUMMARY ***
Total pot $0.10 | Rake $0 
Seat 3: oksuz77 (button) (small blind) folded before Flop
Seat 4: beastboy3690 (big blind) collected ($0.10)



PokerStars Hand #222946552257:  Hold'em No Limit ($0.05/$0.10 USD) - 2021/01/23 2:04:11 ET
Table 'Malzovia III' 6-max Seat #4 is the button
Seat 3: oksuz77 ($4.81 in chips) 
Seat 4: beastboy3690 ($10.62 in chips) 
beastboy3690: posts small blind $0.05
oksuz77: posts big blind $0.10
*** HOLE CARDS ***
beastboy3690: raises $0.15 to $0.25
oksuz77: folds 
Uncalled bet ($0.15) returned to beastboy3690
beastboy3690 collected $0.20 from pot
beastboy3690: doesn't show hand 
*** SUMMARY ***
Total pot $0.20 | Rake $0 
Seat 3: oksuz77 (big blind) folded before Flop
Seat 4: beastboy3690 (button) (small blind) collected ($0.20)



PokerStars Hand #222946554195:  Hold'em No Limit ($0.05/$0.10 USD) - 2021/01/23 2:04:19 ET
Table 'Malzovia III' 6-max Seat #3 is the button
Seat 3: oksuz77 ($4.71 in chips) 
Seat 4: beastboy3690 ($10.72 in chips) 
oksuz77: posts small blind $0.05
beastboy3690: posts big blind $0.10
*** HOLE CARDS ***
oksuz77: folds 
Uncalled bet ($0.05) returned to beastboy3690
beastboy3690 collected $0.10 from pot
beastboy3690: doesn't show hand 
*** SUMMARY ***
Total pot $0.10 | Rake $0 
Seat 3: oksuz77 (button) (small blind) folded before Flop
Seat 4: beastboy3690 (big blind) collected ($0.10)



PokerStars Hand #222946555318:  Hold'em No Limit ($0.05/$0.10 USD) - 2021/01/23 2:04:24 ET
Table 'Malzovia III' 6-max Seat #4 is the button
Seat 3: oksuz77 ($4.66 in chips) 
Seat 4: beastboy3690 ($10.77 in chips) 
beastboy3690: posts small blind $0.05
oksuz77: posts big blind $0.10
*** HOLE CARDS ***
beastboy3690: raises $0.15 to $0.25
oksuz77: calls $0.15
*** FLOP *** [Ks 7s 4c]
oksuz77: bets $0.10
beastboy3690: calls $0.10
*** TURN *** [Ks 7s 4c] [As]
oksuz77: bets $0.10
razia92 joins the table at seat #1 
beastboy3690: raises $0.40 to $0.50
oksuz77: folds 
Uncalled bet ($0.40) returned to beastboy3690
beastboy3690 collected $0.86 from pot
beastboy3690: doesn't show hand 
*** SUMMARY ***
Total pot $0.90 | Rake $0.04 
Board [Ks 7s 4c As]
Seat 3: oksuz77 (big blind) folded on the Turn
Seat 4: beastboy3690 (button) (small blind) collected ($0.86)



PokerStars Hand #222946566347:  Hold'em No Limit ($0.05/$0.10 USD) - 2021/01/23 2:05:11 ET
Table 'Malzovia III' 6-max Seat #3 is the button
Seat 1: razia92 ($10 in chips) 
Seat 3: oksuz77 ($4.21 in chips) 
Seat 4: beastboy3690 ($11.18 in chips) 
beastboy3690: posts small blind $0.05
razia92: posts big blind $0.10
*** HOLE CARDS ***
oksuz77: calls $0.10
beastboy3690: calls $0.05
razia92: raises $0.20 to $0.30
oksuz77: folds 
beastboy3690: folds 
Uncalled bet ($0.20) returned to razia92
razia92 collected $0.30 from pot
razia92: doesn't show hand 
*** SUMMARY ***
Total pot $0.30 | Rake $0 
Seat 1: razia92 (big blind) collected ($0.30)
Seat 3: oksuz77 (button) folded before Flop
Seat 4: beastboy3690 (small blind) folded before Flop



PokerStars Hand #222946570905:  Hold'em No Limit ($0.05/$0.10 USD) - 2021/01/23 2:05:30 ET
Table 'Malzovia III' 6-max Seat #4 is the button
Seat 1: razia92 ($10.20 in chips) 
Seat 3: oksuz77 ($4.11 in chips) 
Seat 4: beastboy3690 ($11.08 in chips) 
razia92: posts small blind $0.05
oksuz77: posts big blind $0.10
*** HOLE CARDS ***
beastboy3690: folds 
razia92: raises $0.20 to $0.30
oksuz77: folds 
Uncalled bet ($0.20) returned to razia92
razia92 collected $0.20 from pot
razia92: doesn't show hand 
*** SUMMARY ***
Total pot $0.20 | Rake $0 
Seat 1: razia92 (small blind) collected ($0.20)
Seat 3: oksuz77 (big blind) folded before Flop
Seat 4: beastboy3690 (button) folded before Flop (didn't bet)



PokerStars Hand #222946573016:  Hold'em No Limit ($0.05/$0.10 USD) - 2021/01/23 2:05:39 ET
Table 'Malzovia III' 6-max Seat #1 is the button
Seat 1: razia92 ($10.30 in chips) 
Seat 3: oksuz77 ($4.01 in chips) 
Seat 4: beastboy3690 ($11.08 in chips) 
oksuz77: posts small blind $0.05
beastboy3690: posts big blind $0.10
*** HOLE CARDS ***
razia92: folds 
oksuz77: folds 
Uncalled bet ($0.05) returned to beastboy3690
beastboy3690 collected $0.10 from pot
beastboy3690: doesn't show hand 
*** SUMMARY ***
Total pot $0.10 | Rake $0 
Seat 1: razia92 (button) folded before Flop (didn't bet)
Seat 3: oksuz77 (small blind) folded before Flop
Seat 4: beastboy3690 (big blind) collected ($0.10)



PokerStars Hand #222946574494:  Hold'em No Limit ($0.05/$0.10 USD) - 2021/01/23 2:05:45 ET
Table 'Malzovia III' 6-max Seat #3 is the button
Seat 1: razia92 ($10.30 in chips) 
Seat 3: oksuz77 ($3.96 in chips) 
Seat 4: beastboy3690 ($11.13 in chips) 
beastboy3690: posts small blind $0.05
razia92: posts big blind $0.10
*** HOLE CARDS ***
oksuz77: folds 
beastboy3690: raises $0.20 to $0.30
razia92: calls $0.20
*** FLOP *** [5c 2c 4c]
beastboy3690: checks 
razia92: checks 
*** TURN *** [5c 2c 4c] [7c]
beastboy3690: checks 
razia92: bets $0.22
beastboy3690: folds 
Uncalled bet ($0.22) returned to razia92
razia92 collected $0.57 from pot
razia92: doesn't show hand 
*** SUMMARY ***
Total pot $0.60 | Rake $0.03 
Board [5c 2c 4c 7c]
Seat 1: razia92 (big blind) collected ($0.57)
Seat 3: oksuz77 (button) folded before Flop (didn't bet)
Seat 4: beastboy3690 (small blind) folded on the Turn



PokerStars Hand #222946586852:  Hold'em No Limit ($0.05/$0.10 USD) - 2021/01/23 2:06:38 ET
Table 'Malzovia III' 6-max Seat #4 is the button
Seat 1: razia92 ($10.57 in chips) 
Seat 3: oksuz77 ($3.96 in chips) 
Seat 4: beastboy3690 ($10.83 in chips) 
razia92: posts small blind $0.05
oksuz77: posts big blind $0.10
*** HOLE CARDS ***
beastboy3690: raises $0.15 to $0.25
razia92: calls $0.20
oksuz77: calls $0.15
*** FLOP *** [Qc 6s 4c]
razia92: checks 
oksuz77: bets $0.10
beastboy3690: raises $0.40 to $0.50
razia92: folds 
oksuz77: folds 
Uncalled bet ($0.40) returned to beastboy3690
beastboy3690 collected $0.91 from pot
beastboy3690: doesn't show hand 
*** SUMMARY ***
Total pot $0.95 | Rake $0.04 
Board [Qc 6s 4c]
Seat 1: razia92 (small blind) folded on the Flop
Seat 3: oksuz77 (big blind) folded on the Flop
Seat 4: beastboy3690 (button) collected ($0.91)



PokerStars Hand #222946598033:  Hold'em No Limit ($0.05/$0.10 USD) - 2021/01/23 2:07:25 ET
Table 'Malzovia III' 6-max Seat #1 is the button
Seat 1: razia92 ($10.32 in chips) 
Seat 3: oksuz77 ($3.61 in chips) 
Seat 4: beastboy3690 ($11.39 in chips) 
oksuz77: posts small blind $0.05
beastboy3690: posts big blind $0.10
*** HOLE CARDS ***
razia92: raises $0.20 to $0.30
oksuz77: folds 
beastboy3690: folds 
Uncalled bet ($0.20) returned to razia92
razia92 collected $0.25 from pot
razia92: doesn't show hand 
*** SUMMARY ***
Total pot $0.25 | Rake $0 
Seat 1: razia92 (button) collected ($0.25)
Seat 3: oksuz77 (small blind) folded before Flop
Seat 4: beastboy3690 (big blind) folded before Flop



PokerStars Hand #222946601975:  Hold'em No Limit ($0.05/$0.10 USD) - 2021/01/23 2:07:42 ET
Table 'Malzovia III' 6-max Seat #3 is the button
Seat 1: razia92 ($10.47 in chips) 
Seat 3: oksuz77 ($3.56 in chips) 
Seat 4: beastboy3690 ($11.29 in chips) 
beastboy3690: posts small blind $0.05
razia92: posts big blind $0.10
*** HOLE CARDS ***
oksuz77: folds 
beastboy3690: raises $0.20 to $0.30
razia92: calls $0.20
*** FLOP *** [8c 9d Ks]
beastboy3690: checks 
razia92: checks 
*** TURN *** [8c 9d Ks] [4d]
beastboy3690: bets $0.19
razia92: calls $0.19
*** RIVER *** [8c 9d Ks 4d] [Js]
beastboy3690: bets $0.60
razia92: folds 
Uncalled bet ($0.60) returned to beastboy3690
beastboy3690 collected $0.94 from pot
beastboy3690: doesn't show hand 
*** SUMMARY ***
Total pot $0.98 | Rake $0.04 
Board [8c 9d Ks 4d Js]
Seat 1: razia92 (big blind) folded on the River
Seat 3: oksuz77 (button) folded before Flop (didn't bet)
Seat 4: beastboy3690 (small blind) collected ($0.94)



PokerStars Hand #222946616821:  Hold'em No Limit ($0.05/$0.10 USD) - 2021/01/23 2:08:44 ET
Table 'Malzovia III' 6-max Seat #4 is the button
Seat 1: razia92 ($9.98 in chips) 
Seat 3: oksuz77 ($3.56 in chips) 
Seat 4: beastboy3690 ($11.74 in chips) 
razia92: posts small blind $0.05
oksuz77: posts big blind $0.10
*** HOLE CARDS ***
beastboy3690: raises $0.15 to $0.25
razia92: calls $0.20
oksuz77: folds 
*** FLOP *** [Kd Th Kc]
razia92: bets $0.10
beastboy3690: folds 
Uncalled bet ($0.10) returned to razia92
razia92 collected $0.57 from pot
razia92: doesn't show hand 
*** SUMMARY ***
Total pot $0.60 | Rake $0.03 
Board [Kd Th Kc]
Seat 1: razia92 (small blind) collected ($0.57)
Seat 3: oksuz77 (big blind) folded before Flop
Seat 4: beastboy3690 (button) folded on the Flop



PokerStars Hand #222946622416:  Hold'em No Limit ($0.05/$0.10 USD) - 2021/01/23 2:09:07 ET
Table 'Malzovia III' 6-max Seat #1 is the button
Seat 1: razia92 ($10.30 in chips) 
Seat 3: oksuz77 ($3.46 in chips) 
Seat 4: beastboy3690 ($11.49 in chips) 
oksuz77: posts small blind $0.05
beastboy3690: posts big blind $0.10
*** HOLE CARDS ***
razia92: folds 
oksuz77: folds 
Uncalled bet ($0.05) returned to beastboy3690
beastboy3690 collected $0.10 from pot
beastboy3690: doesn't show hand 
*** SUMMARY ***
Total pot $0.10 | Rake $0 
Seat 1: razia92 (button) folded before Flop (didn't bet)
Seat 3: oksuz77 (small blind) folded before Flop
Seat 4: beastboy3690 (big blind) collected ($0.10)



PokerStars Hand #222946623557:  Hold'em No Limit ($0.05/$0.10 USD) - 2021/01/23 2:09:13 ET
Table 'Malzovia III' 6-max Seat #3 is the button
Seat 1: razia92 ($10.30 in chips) 
Seat 3: oksuz77 ($3.41 in chips) 
Seat 4: beastboy3690 ($11.54 in chips) 
beastboy3690: posts small blind $0.05
razia92: posts big blind $0.10
*** HOLE CARDS ***
oksuz77: folds 
beastboy3690: raises $0.20 to $0.30
razia92: calls $0.20
*** FLOP *** [5h 9c 5c]
beastboy3690: bets $0.19
razia92: folds 
Uncalled bet ($0.19) returned to beastboy3690
beastboy3690 collected $0.57 from pot
beastboy3690: doesn't show hand 
*** SUMMARY ***
Total pot $0.60 | Rake $0.03 
Board [5h 9c 5c]
Seat 1: razia92 (big blind) folded on the Flop
Seat 3: oksuz77 (button) folded before Flop (didn't bet)
Seat 4: beastboy3690 (small blind) collected ($0.57)



PokerStars Hand #222946628410:  Hold'em No Limit ($0.05/$0.10 USD) - 2021/01/23 2:09:33 ET
Table 'Malzovia III' 6-max Seat #4 is the button
Seat 1: razia92 ($10 in chips) 
Seat 3: oksuz77 ($3.41 in chips) 
Seat 4: beastboy3690 ($11.81 in chips) 
razia92: posts small blind $0.05
oksuz77: posts big blind $0.10
*** HOLE CARDS ***
beastboy3690: folds 
razia92: raises $0.20 to $0.30
oksuz77: folds 
Uncalled bet ($0.20) returned to razia92
razia92 collected $0.20 from pot
razia92: doesn't show hand 
*** SUMMARY ***
Total pot $0.20 | Rake $0 
Seat 1: razia92 (small blind) collected ($0.20)
Seat 3: oksuz77 (big blind) folded before Flop
Seat 4: beastboy3690 (button) folded before Flop (didn't bet)



PokerStars Hand #222946629971:  Hold'em No Limit ($0.05/$0.10 USD) - 2021/01/23 2:09:40 ET
Table 'Malzovia III' 6-max Seat #1 is the button
Seat 1: razia92 ($10.10 in chips) 
Seat 3: oksuz77 ($3.31 in chips) 
Seat 4: beastboy3690 ($11.81 in chips) 
oksuz77: posts small blind $0.05
beastboy3690: posts big blind $0.10
*** HOLE CARDS ***
razia92: raises $0.20 to $0.30
oksuz77: folds 
beastboy3690: folds 
Uncalled bet ($0.20) returned to razia92
razia92 collected $0.25 from pot
razia92: doesn't show hand 
*** SUMMARY ***
Total pot $0.25 | Rake $0 
Seat 1: razia92 (button) collected ($0.25)
Seat 3: oksuz77 (small blind) folded before Flop
Seat 4: beastboy3690 (big blind) folded before Flop



PokerStars Hand #222946631590:  Hold'em No Limit ($0.05/$0.10 USD) - 2021/01/23 2:09:47 ET
Table 'Malzovia III' 6-max Seat #3 is the button
Seat 1: razia92 ($10.25 in chips) 
Seat 3: oksuz77 ($3.26 in chips) 
Seat 4: beastboy3690 ($11.71 in chips) 
beastboy3690: posts small blind $0.05
razia92: posts big blind $0.10
*** HOLE CARDS ***
oksuz77: folds 
beastboy3690: folds 
Uncalled bet ($0.05) returned to razia92
razia92 collected $0.10 from pot
razia92: doesn't show hand 
*** SUMMARY ***
Total pot $0.10 | Rake $0 
Seat 1: razia92 (big blind) collected ($0.10)
Seat 3: oksuz77 (button) folded before Flop (didn't bet)
Seat 4: beastboy3690 (small blind) folded before Flop



PokerStars Hand #222946632990:  Hold'em No Limit ($0.05/$0.10 USD) - 2021/01/23 2:09:53 ET
Table 'Malzovia III' 6-max Seat #4 is the button
Seat 1: razia92 ($10.30 in chips) 
Seat 3: oksuz77 ($3.26 in chips) 
Seat 4: beastboy3690 ($11.66 in chips) 
razia92: posts small blind $0.05
oksuz77: posts big blind $0.10
*** HOLE CARDS ***
beastboy3690: folds 
razia92: raises $0.20 to $0.30
oksuz77: folds 
Uncalled bet ($0.20) returned to razia92
razia92 collected $0.20 from pot
razia92: doesn't show hand 
*** SUMMARY ***
Total pot $0.20 | Rake $0 
Seat 1: razia92 (small blind) collected ($0.20)
Seat 3: oksuz77 (big blind) folded before Flop
Seat 4: beastboy3690 (button) folded before Flop (didn't bet)



PokerStars Hand #222946635008:  Hold'em No Limit ($0.05/$0.10 USD) - 2021/01/23 2:10:01 ET
Table 'Malzovia III' 6-max Seat #1 is the button
Seat 1: razia92 ($10.40 in chips) 
Seat 3: oksuz77 ($3.16 in chips) 
Seat 4: beastboy3690 ($11.66 in chips) 
oksuz77: posts small blind $0.05
beastboy3690: posts big blind $0.10
*** HOLE CARDS ***
razia92: raises $0.20 to $0.30
oksuz77: folds 
beastboy3690: folds 
Uncalled bet ($0.20) returned to razia92
razia92 collected $0.25 from pot
razia92: doesn't show hand 
*** SUMMARY ***
Total pot $0.25 | Rake $0 
Seat 1: razia92 (button) collected ($0.25)
Seat 3: oksuz77 (small blind) folded before Flop
Seat 4: beastboy3690 (big blind) folded before Flop



PokerStars Hand #222946637628:  Hold'em No Limit ($0.05/$0.10 USD) - 2021/01/23 2:10:12 ET
Table 'Malzovia III' 6-max Seat #3 is the button
Seat 1: razia92 ($10.55 in chips) 
Seat 3: oksuz77 ($3.11 in chips) 
Seat 4: beastboy3690 ($11.56 in chips) 
beastboy3690: posts small blind $0.05
razia92: posts big blind $0.10
*** HOLE CARDS ***
oksuz77: folds 
beastboy3690: raises $0.20 to $0.30
razia92: calls $0.20
*** FLOP *** [6s 9d 2s]
bliznec828 joins the table at seat #2 
beastboy3690: bets $0.19
razia92: folds 
Uncalled bet ($0.19) returned to beastboy3690
beastboy3690 collected $0.57 from pot
beastboy3690: doesn't show hand 
*** SUMMARY ***
Total pot $0.60 | Rake $0.03 
Board [6s 9d 2s]
Seat 1: razia92 (big blind) folded on the Flop
Seat 3: oksuz77 (button) folded before Flop (didn't bet)
Seat 4: beastboy3690 (small blind) collected ($0.57)



PokerStars Hand #222946643338:  Hold'em No Limit ($0.05/$0.10 USD) - 2021/01/23 2:10:37 ET
Table 'Malzovia III' 6-max Seat #4 is the button
Seat 1: razia92 ($10.25 in chips) 
Seat 2: bliznec828 ($10 in chips) 
Seat 3: oksuz77 ($3.11 in chips) 
Seat 4: beastboy3690 ($11.83 in chips) 
razia92: posts small blind $0.05
bliznec828: posts big blind $0.10
*** HOLE CARDS ***
oksuz77: folds 
beastboy3690: folds 
razia92: raises $0.20 to $0.30
bliznec828: folds 
Uncalled bet ($0.20) returned to razia92
razia92 collected $0.20 from pot
razia92: doesn't show hand 
*** SUMMARY ***
Total pot $0.20 | Rake $0 
Seat 1: razia92 (small blind) collected ($0.20)
Seat 2: bliznec828 (big blind) folded before Flop
Seat 3: oksuz77 folded before Flop (didn't bet)
Seat 4: beastboy3690 (button) folded before Flop (didn't bet)



PokerStars Hand #222946647771:  Hold'em No Limit ($0.05/$0.10 USD) - 2021/01/23 2:10:56 ET
Table 'Malzovia III' 6-max Seat #1 is the button
Seat 1: razia92 ($10.35 in chips) 
Seat 2: bliznec828 ($10 in chips) 
Seat 3: oksuz77 ($3.11 in chips) 
Seat 4: beastboy3690 ($11.83 in chips) 
bliznec828: posts small blind $0.05
oksuz77: posts big blind $0.10
*** HOLE CARDS ***
EdamameKD joins the table at seat #5 
beastboy3690: folds 
razia92: raises $0.20 to $0.30
bliznec828: folds 
oksuz77: folds 
Uncalled bet ($0.20) returned to razia92
razia92 collected $0.25 from pot
razia92: doesn't show hand 
*** SUMMARY ***
Total pot $0.25 | Rake $0 
Seat 1: razia92 (button) collected ($0.25)
Seat 2: bliznec828 (small blind) folded before Flop
Seat 3: oksuz77 (big blind) folded before Flop
Seat 4: beastboy3690 folded before Flop (didn't bet)



PokerStars Hand #222946649457:  Hold'em No Limit ($0.05/$0.10 USD) - 2021/01/23 2:11:03 ET
Table 'Malzovia III' 6-max Seat #2 is the button
Seat 1: razia92 ($10.50 in chips) 
Seat 2: bliznec828 ($10 in chips) 
Seat 3: oksuz77 ($3.01 in chips) 
Seat 4: beastboy3690 ($11.83 in chips) 
oksuz77: posts small blind $0.05
beastboy3690: posts big blind $0.10
EdamameKD: sits out 
*** HOLE CARDS ***
razia92: folds 
bliznec828: folds 
oksuz77: calls $0.05
beastboy3690: raises $0.30 to $0.40
oksuz77: folds 
Uncalled bet ($0.30) returned to beastboy3690
beastboy3690 collected $0.20 from pot
beastboy3690: doesn't show hand 
*** SUMMARY ***
Total pot $0.20 | Rake $0 
Seat 1: razia92 folded before Flop (didn't bet)
Seat 2: bliznec828 (button) folded before Flop (didn't bet)
Seat 3: oksuz77 (small blind) folded before Flop
Seat 4: beastboy3690 (big blind) collected ($0.20)



PokerStars Hand #222946653248:  Hold'em No Limit ($0.05/$0.10 USD) - 2021/01/23 2:11:19 ET
Table 'Malzovia III' 6-max Seat #3 is the button
Seat 1: razia92 ($10.50 in chips) 
Seat 2: bliznec828 ($10 in chips) 
Seat 3: oksuz77 ($2.91 in chips) 
Seat 4: beastboy3690 ($11.93 in chips) 
Seat 5: EdamameKD ($10 in chips) 
beastboy3690: posts small blind $0.05
EdamameKD: posts big blind $0.10
*** HOLE CARDS ***
razia92: folds 
el_buchkan joins the table at seat #6 
bliznec828: folds 
oksuz77: folds 
beastboy3690: raises $0.20 to $0.30
EdamameKD: calls $0.20
*** FLOP *** [Th 9d 3c]
beastboy3690: bets $0.19
EdamameKD: folds 
Uncalled bet ($0.19) returned to beastboy3690
beastboy3690 collected $0.57 from pot
beastboy3690: doesn't show hand 
*** SUMMARY ***
Total pot $0.60 | Rake $0.03 
Board [Th 9d 3c]
Seat 1: razia92 folded before Flop (didn't bet)
Seat 2: bliznec828 folded before Flop (didn't bet)
Seat 3: oksuz77 (button) folded before Flop (didn't bet)
Seat 4: beastboy3690 (small blind) collected ($0.57)
Seat 5: EdamameKD (big blind) folded on the Flop



PokerStars Hand #222946660891:  Hold'em No Limit ($0.05/$0.10 USD) - 2021/01/23 2:11:52 ET
Table 'Malzovia III' 6-max Seat #4 is the button
Seat 1: razia92 ($10.50 in chips) 
Seat 2: bliznec828 ($10 in chips) 
Seat 3: oksuz77 ($2.91 in chips) 
Seat 4: beastboy3690 ($12.20 in chips) 
Seat 5: EdamameKD ($9.70 in chips) 
Seat 6: el_buchkan ($10 in chips) 
EdamameKD: posts small blind $0.05
el_buchkan: posts big blind $0.10
*** HOLE CARDS ***
razia92: raises $0.20 to $0.30
bliznec828: folds 
oksuz77: calls $0.30
beastboy3690: folds 
EdamameKD: folds 
el_buchkan: raises $1.20 to $1.50
razia92: calls $1.20
oksuz77: folds 
*** FLOP *** [Qc 9h Kd]
el_buchkan: checks 
razia92: bets $1.60
el_buchkan: folds 
Uncalled bet ($1.60) returned to razia92
razia92 collected $3.20 from pot
razia92: doesn't show hand 
*** SUMMARY ***
Total pot $3.35 | Rake $0.15 
Board [Qc 9h Kd]
Seat 1: razia92 collected ($3.20)
Seat 2: bliznec828 folded before Flop (didn't bet)
Seat 3: oksuz77 folded before Flop
Seat 4: beastboy3690 (button) folded before Flop (didn't bet)
Seat 5: EdamameKD (small blind) folded before Flop
Seat 6: el_buchkan (big blind) folded on the Flop



PokerStars Hand #222946670619:  Hold'em No Limit ($0.05/$0.10 USD) - 2021/01/23 2:12:34 ET
Table 'Malzovia III' 6-max Seat #5 is the button
Seat 1: razia92 ($12.20 in chips) 
Seat 2: bliznec828 ($10 in chips) 
Seat 3: oksuz77 ($2.61 in chips) 
Seat 4: beastboy3690 ($12.20 in chips) 
Seat 5: EdamameKD ($9.65 in chips) 
Seat 6: el_buchkan ($10 in chips) 
el_buchkan: posts small blind $0.05
razia92: posts big blind $0.10
*** HOLE CARDS ***
bliznec828: folds 
oksuz77: calls $0.10
beastboy3690: folds 
EdamameKD: folds 
el_buchkan: folds 
razia92: checks 
*** FLOP *** [2s Jc Ac]
razia92: checks 
oksuz77: bets $0.10
razia92: folds 
Uncalled bet ($0.10) returned to oksuz77
oksuz77 collected $0.24 from pot
oksuz77: doesn't show hand 
*** SUMMARY ***
Total pot $0.25 | Rake $0.01 
Board [2s Jc Ac]
Seat 1: razia92 (big blind) folded on the Flop
Seat 2: bliznec828 folded before Flop (didn't bet)
Seat 3: oksuz77 collected ($0.24)
Seat 4: beastboy3690 folded before Flop (didn't bet)
Seat 5: EdamameKD (button) folded before Flop (didn't bet)
Seat 6: el_buchkan (small blind) folded before Flop



PokerStars Hand #222946675520:  Hold'em No Limit ($0.05/$0.10 USD) - 2021/01/23 2:12:55 ET
Table 'Malzovia III' 6-max Seat #6 is the button
Seat 1: razia92 ($12.10 in chips) 
Seat 2: bliznec828 ($10 in chips) 
Seat 3: oksuz77 ($2.75 in chips) 
Seat 4: beastboy3690 ($12.20 in chips) 
Seat 5: EdamameKD ($9.65 in chips) 
Seat 6: el_buchkan ($10 in chips) 
razia92: posts small blind $0.05
bliznec828: posts big blind $0.10
*** HOLE CARDS ***
oksuz77: folds 
beastboy3690: folds 
EdamameKD: folds 
el_buchkan: folds 
razia92: raises $0.20 to $0.30
bliznec828: calls $0.20
*** FLOP *** [8h 6c 2d]
razia92: bets $0.10
bliznec828: folds 
Uncalled bet ($0.10) returned to razia92
razia92 collected $0.57 from pot
razia92: doesn't show hand 
*** SUMMARY ***
Total pot $0.60 | Rake $0.03 
Board [8h 6c 2d]
Seat 1: razia92 (small blind) collected ($0.57)
Seat 2: bliznec828 (big blind) folded on the Flop
Seat 3: oksuz77 folded before Flop (didn't bet)
Seat 4: beastboy3690 folded before Flop (didn't bet)
Seat 5: EdamameKD folded before Flop (didn't bet)
Seat 6: el_buchkan (button) folded before Flop (didn't bet)



PokerStars Hand #222946682753:  Hold'em No Limit ($0.05/$0.10 USD) - 2021/01/23 2:13:26 ET
Table 'Malzovia III' 6-max Seat #1 is the button
Seat 1: razia92 ($12.37 in chips) 
Seat 2: bliznec828 ($10 in chips) 
Seat 3: oksuz77 ($2.75 in chips) 
Seat 4: beastboy3690 ($12.20 in chips) 
Seat 5: EdamameKD ($9.65 in chips) 
Seat 6: el_buchkan ($10 in chips) 
bliznec828: posts small blind $0.05
oksuz77: posts big blind $0.10
*** HOLE CARDS ***
beastboy3690: folds 
EdamameKD: calls $0.10
el_buchkan: folds 
razia92: folds 
bliznec828: calls $0.05
oksuz77: checks 
*** FLOP *** [Td 9s Qc]
bliznec828: checks 
oksuz77: checks 
EdamameKD: checks 
*** TURN *** [Td 9s Qc] [5h]
bliznec828: checks 
oksuz77: checks 
EdamameKD: checks 
*** RIVER *** [Td 9s Qc 5h] [Qh]
bliznec828: bets $0.10
oksuz77: folds 
EdamameKD: folds 
Uncalled bet ($0.10) returned to bliznec828
bliznec828 collected $0.29 from pot
bliznec828: doesn't show hand 
*** SUMMARY ***
Total pot $0.30 | Rake $0.01 
Board [Td 9s Qc 5h Qh]
Seat 1: razia92 (button) folded before Flop (didn't bet)
Seat 2: bliznec828 (small blind) collected ($0.29)
Seat 3: oksuz77 (big blind) folded on the River
Seat 4: beastboy3690 folded before Flop (didn't bet)
Seat 5: EdamameKD folded on the River
Seat 6: el_buchkan folded before Flop (didn't bet)



PokerStars Hand #222946690483:  Hold'em No Limit ($0.05/$0.10 USD) - 2021/01/23 2:13:59 ET
Table 'Malzovia III' 6-max Seat #2 is the button
Seat 1: razia92 ($12.37 in chips) 
Seat 2: bliznec828 ($10.19 in chips) 
Seat 3: oksuz77 ($2.65 in chips) 
Seat 4: beastboy3690 ($12.20 in chips) 
Seat 5: EdamameKD ($9.55 in chips) 
Seat 6: el_buchkan ($10 in chips) 
oksuz77: posts small blind $0.05
beastboy3690: posts big blind $0.10
*** HOLE CARDS ***
EdamameKD: folds 
el_buchkan: raises $0.20 to $0.30
razia92: folds 
bliznec828: folds 
oksuz77: folds 
beastboy3690: folds 
Uncalled bet ($0.20) returned to el_buchkan
el_buchkan collected $0.25 from pot
el_buchkan: doesn't show hand 
*** SUMMARY ***
Total pot $0.25 | Rake $0 
Seat 1: razia92 folded before Flop (didn't bet)
Seat 2: bliznec828 (button) folded before Flop (didn't bet)
Seat 3: oksuz77 (small blind) folded before Flop
Seat 4: beastboy3690 (big blind) folded before Flop
Seat 5: EdamameKD folded before Flop (didn't bet)
Seat 6: el_buchkan collected ($0.25)



PokerStars Hand #222946694649:  Hold'em No Limit ($0.05/$0.10 USD) - 2021/01/23 2:14:17 ET
Table 'Malzovia III' 6-max Seat #3 is the button
Seat 1: razia92 ($12.37 in chips) 
Seat 2: bliznec828 ($10.19 in chips) 
Seat 3: oksuz77 ($2.60 in chips) 
Seat 4: beastboy3690 ($12.10 in chips) 
Seat 5: EdamameKD ($9.55 in chips) 
Seat 6: el_buchkan ($10.15 in chips) 
beastboy3690: posts small blind $0.05
EdamameKD: posts big blind $0.10
*** HOLE CARDS ***
el_buchkan: folds 
razia92: raises $0.20 to $0.30
bliznec828: folds 
oksuz77: folds 
beastboy3690: folds 
EdamameKD: calls $0.20
*** FLOP *** [Th 8h 5c]
EdamameKD: bets $0.20
razia92: calls $0.20
*** TURN *** [Th 8h 5c] [Qh]
EdamameKD: bets $0.20
razia92: calls $0.20
*** RIVER *** [Th 8h 5c Qh] [4c]
EdamameKD: bets $0.30
razia92: raises $4.40 to $4.70
EdamameKD: folds 
Uncalled bet ($4.40) returned to razia92
razia92 collected $1.96 from pot
razia92: doesn't show hand 
*** SUMMARY ***
Total pot $2.05 | Rake $0.09 
Board [Th 8h 5c Qh 4c]
Seat 1: razia92 collected ($1.96)
Seat 2: bliznec828 folded before Flop (didn't bet)
Seat 3: oksuz77 (button) folded before Flop (didn't bet)
Seat 4: beastboy3690 (small blind) folded before Flop
Seat 5: EdamameKD (big blind) folded on the River
Seat 6: el_buchkan folded before Flop (didn't bet)



PokerStars Hand #222946705962:  Hold'em No Limit ($0.05/$0.10 USD) - 2021/01/23 2:15:06 ET
Table 'Malzovia III' 6-max Seat #4 is the button
Seat 1: razia92 ($13.33 in chips) 
Seat 2: bliznec828 ($10.19 in chips) 
Seat 3: oksuz77 ($2.60 in chips) 
Seat 4: beastboy3690 ($12.05 in chips) 
Seat 5: EdamameKD ($8.55 in chips) 
Seat 6: el_buchkan ($10.15 in chips) 
EdamameKD: posts small blind $0.05
el_buchkan: posts big blind $0.10
*** HOLE CARDS ***
razia92: folds 
bliznec828: folds 
oksuz77: folds 
beastboy3690: raises $0.15 to $0.25
EdamameKD: calls $0.20
el_buchkan: folds 
*** FLOP *** [Kh 7h 7s]
EdamameKD: checks 
beastboy3690: bets $0.19
EdamameKD: folds 
Uncalled bet ($0.19) returned to beastboy3690
beastboy3690 collected $0.57 from pot
beastboy3690: doesn't show hand 
razia92 leaves the table
*** SUMMARY ***
Total pot $0.60 | Rake $0.03 
Board [Kh 7h 7s]
Seat 1: razia92 folded before Flop (didn't bet)
Seat 2: bliznec828 folded before Flop (didn't bet)
Seat 3: oksuz77 folded before Flop (didn't bet)
Seat 4: beastboy3690 (button) collected ($0.57)
Seat 5: EdamameKD (small blind) folded on the Flop
Seat 6: el_buchkan (big blind) folded before Flop



PokerStars Hand #222946711364:  Hold'em No Limit ($0.05/$0.10 USD) - 2021/01/23 2:15:30 ET
Table 'Malzovia III' 6-max Seat #5 is the button
Seat 2: bliznec828 ($10.19 in chips) 
Seat 3: oksuz77 ($2.60 in chips) 
Seat 4: beastboy3690 ($12.37 in chips) 
Seat 5: EdamameKD ($8.30 in chips) 
Seat 6: el_buchkan ($10.05 in chips) 
el_buchkan: posts small blind $0.05
bliznec828: posts big blind $0.10
*** HOLE CARDS ***
oksuz77: folds 
beastboy3690: folds 
EdamameKD: folds 
el_buchkan: raises $0.20 to $0.30
bliznec828: folds 
Uncalled bet ($0.20) returned to el_buchkan
el_buchkan collected $0.20 from pot
el_buchkan: doesn't show hand 
*** SUMMARY ***
Total pot $0.20 | Rake $0 
Seat 2: bliznec828 (big blind) folded before Flop
Seat 3: oksuz77 folded before Flop (didn't bet)
Seat 4: beastboy3690 folded before Flop (didn't bet)
Seat 5: EdamameKD (button) folded before Flop (didn't bet)
Seat 6: el_buchkan (small blind) collected ($0.20)



PokerStars Hand #222946713434:  Hold'em No Limit ($0.05/$0.10 USD) - 2021/01/23 2:15:39 ET
Table 'Malzovia III' 6-max Seat #6 is the button
Seat 2: bliznec828 ($10.09 in chips) 
Seat 3: oksuz77 ($2.60 in chips) 
Seat 4: beastboy3690 ($12.37 in chips) 
Seat 5: EdamameKD ($8.30 in chips) 
Seat 6: el_buchkan ($10.15 in chips) 
bliznec828: posts small blind $0.05
oksuz77: posts big blind $0.10
*** HOLE CARDS ***
beastboy3690: folds 
EdamameKD: folds 
el_buchkan: folds 
bliznec828: raises $0.20 to $0.30
oksuz77: folds 
Uncalled bet ($0.20) returned to bliznec828
bliznec828 collected $0.20 from pot
bliznec828: doesn't show hand 
*** SUMMARY ***
Total pot $0.20 | Rake $0 
Seat 2: bliznec828 (small blind) collected ($0.20)
Seat 3: oksuz77 (big blind) folded before Flop
Seat 4: beastboy3690 folded before Flop (didn't bet)
Seat 5: EdamameKD folded before Flop (didn't bet)
Seat 6: el_buchkan (button) folded before Flop (didn't bet)



PokerStars Hand #222946715163:  Hold'em No Limit ($0.05/$0.10 USD) - 2021/01/23 2:15:46 ET
Table 'Malzovia III' 6-max Seat #2 is the button
Seat 2: bliznec828 ($10.19 in chips) 
Seat 3: oksuz77 ($2.50 in chips) 
Seat 4: beastboy3690 ($12.37 in chips) 
Seat 5: EdamameKD ($8.30 in chips) 
Seat 6: el_buchkan ($10.15 in chips) 
oksuz77: posts small blind $0.05
beastboy3690: posts big blind $0.10
*** HOLE CARDS ***
EdamameKD: folds 
el_buchkan: folds 
Bannnkai joins the table at seat #1 
bliznec828: folds 
oksuz77: calls $0.05
beastboy3690: checks 
*** FLOP *** [4c 6c 3d]
oksuz77: checks 
beastboy3690: bets $0.11
oksuz77: folds 
Uncalled bet ($0.11) returned to beastboy3690
beastboy3690 collected $0.19 from pot
beastboy3690: doesn't show hand 
*** SUMMARY ***
Total pot $0.20 | Rake $0.01 
Board [4c 6c 3d]
Seat 2: bliznec828 (button) folded before Flop (didn't bet)
Seat 3: oksuz77 (small blind) folded on the Flop
Seat 4: beastboy3690 (big blind) collected ($0.19)
Seat 5: EdamameKD folded before Flop (didn't bet)
Seat 6: el_buchkan folded before Flop (didn't bet)



PokerStars Hand #222946723510:  Hold'em No Limit ($0.05/$0.10 USD) - 2021/01/23 2:16:22 ET
Table 'Malzovia III' 6-max Seat #3 is the button
Seat 2: bliznec828 ($10.19 in chips) 
Seat 3: oksuz77 ($2.40 in chips) 
Seat 4: beastboy3690 ($12.46 in chips) 
Seat 5: EdamameKD ($8.30 in chips) 
Seat 6: el_buchkan ($10.15 in chips) 
beastboy3690: posts small blind $0.05
EdamameKD: posts big blind $0.10
Bannnkai: sits out 
*** HOLE CARDS ***
el_buchkan: raises $0.20 to $0.30
bliznec828: folds 
oksuz77: folds 
beastboy3690: raises $0.90 to $1.20
EdamameKD: folds 
el_buchkan: folds 
Uncalled bet ($0.90) returned to beastboy3690
beastboy3690 collected $0.70 from pot
beastboy3690: doesn't show hand 
*** SUMMARY ***
Total pot $0.70 | Rake $0 
Seat 2: bliznec828 folded before Flop (didn't bet)
Seat 3: oksuz77 (button) folded before Flop (didn't bet)
Seat 4: beastboy3690 (small blind) collected ($0.70)
Seat 5: EdamameKD (big blind) folded before Flop
Seat 6: el_buchkan folded before Flop



PokerStars Hand #222946728627:  Hold'em No Limit ($0.05/$0.10 USD) - 2021/01/23 2:16:44 ET
Table 'Malzovia III' 6-max Seat #4 is the button
Seat 2: bliznec828 ($10.19 in chips) 
Seat 3: oksuz77 ($2.40 in chips) 
Seat 4: beastboy3690 ($12.86 in chips) 
Seat 5: EdamameKD ($8.20 in chips) 
Seat 6: el_buchkan ($10 in chips) 
EdamameKD: posts small blind $0.05
el_buchkan: posts big blind $0.10
Bannnkai: sits out 
*** HOLE CARDS ***
bliznec828: folds 
oksuz77: folds 
beastboy3690: folds 
EdamameKD: raises $0.20 to $0.30
el_buchkan: folds 
Uncalled bet ($0.20) returned to EdamameKD
EdamameKD collected $0.20 from pot
EdamameKD: doesn't show hand 
*** SUMMARY ***
Total pot $0.20 | Rake $0 
Seat 2: bliznec828 folded before Flop (didn't bet)
Seat 3: oksuz77 folded before Flop (didn't bet)
Seat 4: beastboy3690 (button) folded before Flop (didn't bet)
Seat 5: EdamameKD (small blind) collected ($0.20)
Seat 6: el_buchkan (big blind) folded before Flop



PokerStars Hand #222946731459:  Hold'em No Limit ($0.05/$0.10 USD) - 2021/01/23 2:16:55 ET
Table 'Malzovia III' 6-max Seat #5 is the button
Seat 1: Bannnkai ($10 in chips) 
Seat 2: bliznec828 ($10.19 in chips) 
Seat 3: oksuz77 ($2.40 in chips) 
Seat 4: beastboy3690 ($12.86 in chips) 
Seat 5: EdamameKD ($8.30 in chips) 
Seat 6: el_buchkan ($10 in chips) 
el_buchkan: posts small blind $0.05
Bannnkai: posts big blind $0.10
*** HOLE CARDS ***
bliznec828: raises $0.20 to $0.30
oksuz77: folds 
beastboy3690: folds 
EdamameKD: folds 
el_buchkan: folds 
Bannnkai: calls $0.20
*** FLOP *** [Jh 2c 9d]
Bannnkai: checks 
bliznec828: bets $0.20
Bannnkai: folds 
Uncalled bet ($0.20) returned to bliznec828
bliznec828 collected $0.62 from pot
bliznec828: doesn't show hand 
*** SUMMARY ***
Total pot $0.65 | Rake $0.03 
Board [Jh 2c 9d]
Seat 1: Bannnkai (big blind) folded on the Flop
Seat 2: bliznec828 collected ($0.62)
Seat 3: oksuz77 folded before Flop (didn't bet)
Seat 4: beastboy3690 folded before Flop (didn't bet)
Seat 5: EdamameKD (button) folded before Flop (didn't bet)
Seat 6: el_buchkan (small blind) folded before Flop



PokerStars Hand #222946738081:  Hold'em No Limit ($0.05/$0.10 USD) - 2021/01/23 2:17:24 ET
Table 'Malzovia III' 6-max Seat #6 is the button
Seat 1: Bannnkai ($10 in chips) 
Seat 2: bliznec828 ($10.51 in chips) 
Seat 3: oksuz77 ($2.40 in chips) 
Seat 4: beastboy3690 ($12.86 in chips) 
Seat 5: EdamameKD ($8.30 in chips) 
Seat 6: el_buchkan ($10 in chips) 
Bannnkai: posts small blind $0.05
bliznec828: posts big blind $0.10
*** HOLE CARDS ***
oksuz77: calls $0.10
beastboy3690: folds 
EdamameKD: calls $0.10
el_buchkan: folds 
Bannnkai: folds 
bliznec828: checks 
*** FLOP *** [8c Js 9d]
bliznec828: checks 
oksuz77: bets $0.30
EdamameKD: folds 
bliznec828: folds 
Uncalled bet ($0.30) returned to oksuz77
oksuz77 collected $0.33 from pot
oksuz77: doesn't show hand 
*** SUMMARY ***
Total pot $0.35 | Rake $0.02 
Board [8c Js 9d]
Seat 1: Bannnkai (small blind) folded before Flop
Seat 2: bliznec828 (big blind) folded on the Flop
Seat 3: oksuz77 collected ($0.33)
Seat 4: beastboy3690 folded before Flop (didn't bet)
Seat 5: EdamameKD folded on the Flop
Seat 6: el_buchkan (button) folded before Flop (didn't bet)



PokerStars Hand #222946746508:  Hold'em No Limit ($0.05/$0.10 USD) - 2021/01/23 2:18:00 ET
Table 'Malzovia III' 6-max Seat #1 is the button
Seat 1: Bannnkai ($10 in chips) 
Seat 2: bliznec828 ($10.41 in chips) 
Seat 3: oksuz77 ($2.63 in chips) 
Seat 4: beastboy3690 ($12.86 in chips) 
Seat 5: EdamameKD ($8.20 in chips) 
Seat 6: el_buchkan ($10 in chips) 
bliznec828: posts small blind $0.05
oksuz77: posts big blind $0.10
*** HOLE CARDS ***
beastboy3690: raises $0.20 to $0.30
EdamameKD: folds 
el_buchkan: folds 
Bannnkai: folds 
bliznec828: folds 
oksuz77: folds 
Uncalled bet ($0.20) returned to beastboy3690
beastboy3690 collected $0.25 from pot
beastboy3690: doesn't show hand 
*** SUMMARY ***
Total pot $0.25 | Rake $0 
Seat 1: Bannnkai (button) folded before Flop (didn't bet)
Seat 2: bliznec828 (small blind) folded before Flop
Seat 3: oksuz77 (big blind) folded before Flop
Seat 4: beastboy3690 collected ($0.25)
Seat 5: EdamameKD folded before Flop (didn't bet)
Seat 6: el_buchkan folded before Flop (didn't bet)



PokerStars Hand #222946749096:  Hold'em No Limit ($0.05/$0.10 USD) - 2021/01/23 2:18:11 ET
Table 'Malzovia III' 6-max Seat #2 is the button
Seat 1: Bannnkai ($10 in chips) 
Seat 2: bliznec828 ($10.36 in chips) 
Seat 3: oksuz77 ($2.53 in chips) 
Seat 4: beastboy3690 ($13.01 in chips) 
Seat 5: EdamameKD ($8.20 in chips) 
Seat 6: el_buchkan ($10 in chips) 
oksuz77: posts small blind $0.05
beastboy3690: posts big blind $0.10
*** HOLE CARDS ***
EdamameKD: folds 
el_buchkan: folds 
Bannnkai: folds 
bliznec828: folds 
oksuz77: folds 
Uncalled bet ($0.05) returned to beastboy3690
beastboy3690 collected $0.10 from pot
beastboy3690: doesn't show hand 
*** SUMMARY ***
Total pot $0.10 | Rake $0 
Seat 1: Bannnkai folded before Flop (didn't bet)
Seat 2: bliznec828 (button) folded before Flop (didn't bet)
Seat 3: oksuz77 (small blind) folded before Flop
Seat 4: beastboy3690 (big blind) collected ($0.10)
Seat 5: EdamameKD folded before Flop (didn't bet)
Seat 6: el_buchkan folded before Flop (didn't bet)



PokerStars Hand #222946750571:  Hold'em No Limit ($0.05/$0.10 USD) - 2021/01/23 2:18:17 ET
Table 'Malzovia III' 6-max Seat #3 is the button
Seat 1: Bannnkai ($10 in chips) 
Seat 2: bliznec828 ($10.36 in chips) 
Seat 3: oksuz77 ($2.48 in chips) 
Seat 4: beastboy3690 ($13.06 in chips) 
Seat 5: EdamameKD ($8.20 in chips) 
Seat 6: el_buchkan ($10 in chips) 
beastboy3690: posts small blind $0.05
EdamameKD: posts big blind $0.10
*** HOLE CARDS ***
el_buchkan: folds 
Bannnkai: folds 
bliznec828: raises $0.15 to $0.25
oksuz77: calls $0.25
beastboy3690: folds 
EdamameKD: calls $0.15
*** FLOP *** [4d Ac 3d]
EdamameKD: bets $0.20
bliznec828: folds 
oksuz77: folds 
Uncalled bet ($0.20) returned to EdamameKD
EdamameKD collected $0.76 from pot
EdamameKD: doesn't show hand 
*** SUMMARY ***
Total pot $0.80 | Rake $0.04 
Board [4d Ac 3d]
Seat 1: Bannnkai folded before Flop (didn't bet)
Seat 2: bliznec828 folded on the Flop
Seat 3: oksuz77 (button) folded on the Flop
Seat 4: beastboy3690 (small blind) folded before Flop
Seat 5: EdamameKD (big blind) collected ($0.76)
Seat 6: el_buchkan folded before Flop (didn't bet)



PokerStars Hand #222946760303:  Hold'em No Limit ($0.05/$0.10 USD) - 2021/01/23 2:18:59 ET
Table 'Malzovia III' 6-max Seat #4 is the button
Seat 1: Bannnkai ($10 in chips) 
Seat 2: bliznec828 ($10.11 in chips) 
Seat 3: oksuz77 ($2.23 in chips) 
Seat 4: beastboy3690 ($13.01 in chips) 
Seat 5: EdamameKD ($8.71 in chips) 
Seat 6: el_buchkan ($10 in chips) 
EdamameKD: posts small blind $0.05
el_buchkan: posts big blind $0.10
*** HOLE CARDS ***
Bannnkai: folds 
bliznec828: folds 
oksuz77: folds 
beastboy3690: folds 
EdamameKD: folds 
Uncalled bet ($0.05) returned to el_buchkan
el_buchkan collected $0.10 from pot
el_buchkan: doesn't show hand 
*** SUMMARY ***
Total pot $0.10 | Rake $0 
Seat 1: Bannnkai folded before Flop (didn't bet)
Seat 2: bliznec828 folded before Flop (didn't bet)
Seat 3: oksuz77 folded before Flop (didn't bet)
Seat 4: beastboy3690 (button) folded before Flop (didn't bet)
Seat 5: EdamameKD (small blind) folded before Flop
Seat 6: el_buchkan (big blind) collected ($0.10)



PokerStars Hand #222946763225:  Hold'em No Limit ($0.05/$0.10 USD) - 2021/01/23 2:19:11 ET
Table 'Malzovia III' 6-max Seat #5 is the button
Seat 1: Bannnkai ($10 in chips) 
Seat 2: bliznec828 ($10.11 in chips) 
Seat 3: oksuz77 ($2.23 in chips) 
Seat 4: beastboy3690 ($13.01 in chips) 
Seat 5: EdamameKD ($8.66 in chips) 
Seat 6: el_buchkan ($10.05 in chips) 
el_buchkan: posts small blind $0.05
Bannnkai: posts big blind $0.10
*** HOLE CARDS ***
bliznec828: folds 
oksuz77: folds 
beastboy3690: raises $0.20 to $0.30
EdamameKD: folds 
el_buchkan: folds 
Bannnkai: folds 
Uncalled bet ($0.20) returned to beastboy3690
beastboy3690 collected $0.25 from pot
beastboy3690: doesn't show hand 
*** SUMMARY ***
Total pot $0.25 | Rake $0 
Seat 1: Bannnkai (big blind) folded before Flop
Seat 2: bliznec828 folded before Flop (didn't bet)
Seat 3: oksuz77 folded before Flop (didn't bet)
Seat 4: beastboy3690 collected ($0.25)
Seat 5: EdamameKD (button) folded before Flop (didn't bet)
Seat 6: el_buchkan (small blind) folded before Flop



PokerStars Hand #222946765351:  Hold'em No Limit ($0.05/$0.10 USD) - 2021/01/23 2:19:21 ET
Table 'Malzovia III' 6-max Seat #6 is the button
Seat 1: Bannnkai ($10 in chips) 
Seat 2: bliznec828 ($10.11 in chips) 
Seat 3: oksuz77 ($2.23 in chips) 
Seat 4: beastboy3690 ($13.16 in chips) 
Seat 5: EdamameKD ($8.66 in chips) 
Seat 6: el_buchkan ($10 in chips) 
Bannnkai: posts small blind $0.05
bliznec828: posts big blind $0.10
*** HOLE CARDS ***
oksuz77: folds 
beastboy3690: raises $0.20 to $0.30
EdamameKD: calls $0.30
el_buchkan: folds 
Bannnkai: folds 
bliznec828: folds 
*** FLOP *** [9d Th 4c]
beastboy3690: bets $0.36
EdamameKD: calls $0.36
*** TURN *** [9d Th 4c] [As]
beastboy3690: bets $1
EdamameKD: folds 
Uncalled bet ($1) returned to beastboy3690
beastboy3690 collected $1.40 from pot
beastboy3690: doesn't show hand 
*** SUMMARY ***
Total pot $1.47 | Rake $0.07 
Board [9d Th 4c As]
Seat 1: Bannnkai (small blind) folded before Flop
Seat 2: bliznec828 (big blind) folded before Flop
Seat 3: oksuz77 folded before Flop (didn't bet)
Seat 4: beastboy3690 collected ($1.40)
Seat 5: EdamameKD folded on the Turn
Seat 6: el_buchkan (button) folded before Flop (didn't bet)



PokerStars Hand #222946780396:  Hold'em No Limit ($0.05/$0.10 USD) - 2021/01/23 2:20:25 ET
Table 'Malzovia III' 6-max Seat #1 is the button
Seat 1: Bannnkai ($10 in chips) 
Seat 2: bliznec828 ($10.01 in chips) 
Seat 3: oksuz77 ($2.23 in chips) 
Seat 4: beastboy3690 ($13.90 in chips) 
Seat 5: EdamameKD ($8 in chips) 
Seat 6: el_buchkan ($10 in chips) 
bliznec828: posts small blind $0.05
oksuz77: posts big blind $0.10
*** HOLE CARDS ***
beastboy3690: folds 
EdamameKD: calls $0.10
el_buchkan: folds 
Bannnkai: folds 
bliznec828: folds 
oksuz77: checks 
*** FLOP *** [4d 9d 4c]
oksuz77: checks 
EdamameKD: bets $0.24
oksuz77: folds 
Uncalled bet ($0.24) returned to EdamameKD
EdamameKD collected $0.24 from pot
EdamameKD: doesn't show hand 
*** SUMMARY ***
Total pot $0.25 | Rake $0.01 
Board [4d 9d 4c]
Seat 1: Bannnkai (button) folded before Flop (didn't bet)
Seat 2: bliznec828 (small blind) folded before Flop
Seat 3: oksuz77 (big blind) folded on the Flop
Seat 4: beastboy3690 folded before Flop (didn't bet)
Seat 5: EdamameKD collected ($0.24)
Seat 6: el_buchkan folded before Flop (didn't bet)



PokerStars Hand #222946787097:  Hold'em No Limit ($0.05/$0.10 USD) - 2021/01/23 2:20:53 ET
Table 'Malzovia III' 6-max Seat #2 is the button
Seat 1: Bannnkai ($10 in chips) 
Seat 2: bliznec828 ($10 in chips) 
Seat 3: oksuz77 ($2.13 in chips) 
Seat 4: beastboy3690 ($13.90 in chips) 
Seat 5: EdamameKD ($8.14 in chips) 
Seat 6: el_buchkan ($10 in chips) 
oksuz77: posts small blind $0.05
beastboy3690: posts big blind $0.10
*** HOLE CARDS ***
EdamameKD: folds 
el_buchkan: folds 
Bannnkai: folds 
bliznec828: raises $0.15 to $0.25
oksuz77: calls $0.20
beastboy3690: calls $0.15
*** FLOP *** [Qh 2c 4h]
oksuz77: checks 
beastboy3690: checks 
bliznec828: bets $0.36
oksuz77: folds 
beastboy3690: calls $0.36
*** TURN *** [Qh 2c 4h] [Td]
beastboy3690: checks 
bliznec828: bets $0.93
beastboy3690: calls $0.93
*** RIVER *** [Qh 2c 4h Td] [6c]
beastboy3690: checks 
bliznec828: bets $3.90
beastboy3690: folds 
Uncalled bet ($3.90) returned to bliznec828
bliznec828 collected $3.18 from pot
bliznec828: doesn't show hand 
*** SUMMARY ***
Total pot $3.33 | Rake $0.15 
Board [Qh 2c 4h Td 6c]
Seat 1: Bannnkai folded before Flop (didn't bet)
Seat 2: bliznec828 (button) collected ($3.18)
Seat 3: oksuz77 (small blind) folded on the Flop
Seat 4: beastboy3690 (big blind) folded on the River
Seat 5: EdamameKD folded before Flop (didn't bet)
Seat 6: el_buchkan folded before Flop (didn't bet)



PokerStars Hand #222946810295:  Hold'em No Limit ($0.05/$0.10 USD) - 2021/01/23 2:22:33 ET
Table 'Malzovia III' 6-max Seat #3 is the button
Seat 1: Bannnkai ($10 in chips) 
Seat 2: bliznec828 ($11.64 in chips) 
Seat 3: oksuz77 ($1.88 in chips) 
Seat 4: beastboy3690 ($12.36 in chips) 
Seat 5: EdamameKD ($8.14 in chips) 
Seat 6: el_buchkan ($10 in chips) 
beastboy3690: posts small blind $0.05
EdamameKD: posts big blind $0.10
*** HOLE CARDS ***
el_buchkan: folds 
Bannnkai: folds 
bliznec828: raises $0.15 to $0.25
oksuz77: folds 
beastboy3690: folds 
EdamameKD: calls $0.15
*** FLOP *** [Th 2c Tc]
EdamameKD: checks 
bliznec828: bets $0.17
EdamameKD: calls $0.17
*** TURN *** [Th 2c Tc] [3h]
EdamameKD: checks 
bliznec828: bets $0.57
EdamameKD: calls $0.57
*** RIVER *** [Th 2c Tc 3h] [5s]
EdamameKD: checks 
bliznec828: checks 
*** SHOW DOWN ***
EdamameKD: shows [Ad 9d] (a pair of Tens)
bliznec828: mucks hand 
EdamameKD collected $1.94 from pot
*** SUMMARY ***
Total pot $2.03 | Rake $0.09 
Board [Th 2c Tc 3h 5s]
Seat 1: Bannnkai folded before Flop (didn't bet)
Seat 2: bliznec828 mucked
Seat 3: oksuz77 (button) folded before Flop (didn't bet)
Seat 4: beastboy3690 (small blind) folded before Flop
Seat 5: EdamameKD (big blind) showed [Ad 9d] and won ($1.94) with a pair of Tens
Seat 6: el_buchkan folded before Flop (didn't bet)



PokerStars Hand #222946821640:  Hold'em No Limit ($0.05/$0.10 USD) - 2021/01/23 2:23:22 ET
Table 'Malzovia III' 6-max Seat #4 is the button
Seat 1: Bannnkai ($10 in chips) 
Seat 2: bliznec828 ($10.65 in chips) 
Seat 3: oksuz77 ($1.88 in chips) 
Seat 4: beastboy3690 ($12.31 in chips) 
Seat 5: EdamameKD ($9.09 in chips) 
Seat 6: el_buchkan ($10 in chips) 
EdamameKD: posts small blind $0.05
el_buchkan: posts big blind $0.10
*** HOLE CARDS ***
Bannnkai: folds 
bliznec828: folds 
oksuz77: calls $0.10
beastboy3690: folds 
EdamameKD: folds 
el_buchkan: checks 
*** FLOP *** [Qc Jc Kh]
el_buchkan: checks 
oksuz77: bets $0.20
el_buchkan: folds 
Uncalled bet ($0.20) returned to oksuz77
oksuz77 collected $0.24 from pot
oksuz77: doesn't show hand 
*** SUMMARY ***
Total pot $0.25 | Rake $0.01 
Board [Qc Jc Kh]
Seat 1: Bannnkai folded before Flop (didn't bet)
Seat 2: bliznec828 folded before Flop (didn't bet)
Seat 3: oksuz77 collected ($0.24)
Seat 4: beastboy3690 (button) folded before Flop (didn't bet)
Seat 5: EdamameKD (small blind) folded before Flop
Seat 6: el_buchkan (big blind) folded on the Flop



PokerStars Hand #222946832204:  Hold'em No Limit ($0.05/$0.10 USD) - 2021/01/23 2:24:08 ET
Table 'Malzovia III' 6-max Seat #5 is the button
Seat 1: Bannnkai ($10 in chips) 
Seat 2: bliznec828 ($10.65 in chips) 
Seat 3: oksuz77 ($2.02 in chips) 
Seat 4: beastboy3690 ($12.31 in chips) 
Seat 5: EdamameKD ($9.04 in chips) 
Seat 6: el_buchkan ($10 in chips) 
el_buchkan: posts small blind $0.05
Bannnkai: posts big blind $0.10
*** HOLE CARDS ***
bliznec828: folds 
oksuz77: folds 
beastboy3690: raises $0.20 to $0.30
EdamameKD: folds 
el_buchkan: folds 
Bannnkai: folds 
Uncalled bet ($0.20) returned to beastboy3690
beastboy3690 collected $0.25 from pot
beastboy3690: doesn't show hand 
*** SUMMARY ***
Total pot $0.25 | Rake $0 
Seat 1: Bannnkai (big blind) folded before Flop
Seat 2: bliznec828 folded before Flop (didn't bet)
Seat 3: oksuz77 folded before Flop (didn't bet)
Seat 4: beastboy3690 collected ($0.25)
Seat 5: EdamameKD (button) folded before Flop (didn't bet)
Seat 6: el_buchkan (small blind) folded before Flop



PokerStars Hand #222946834338:  Hold'em No Limit ($0.05/$0.10 USD) - 2021/01/23 2:24:17 ET
Table 'Malzovia III' 6-max Seat #6 is the button
Seat 1: Bannnkai ($10 in chips) 
Seat 2: bliznec828 ($10.65 in chips) 
Seat 3: oksuz77 ($2.02 in chips) 
Seat 4: beastboy3690 ($12.46 in chips) 
Seat 5: EdamameKD ($9.04 in chips) 
Seat 6: el_buchkan ($10 in chips) 
Bannnkai: posts small blind $0.05
bliznec828: posts big blind $0.10
*** HOLE CARDS ***
oksuz77: folds 
beastboy3690: folds 
EdamameKD: folds 
el_buchkan: folds 
Bannnkai: raises $0.15 to $0.25
bliznec828: folds 
Uncalled bet ($0.15) returned to Bannnkai
Bannnkai collected $0.20 from pot
Bannnkai: doesn't show hand 
*** SUMMARY ***
Total pot $0.20 | Rake $0 
Seat 1: Bannnkai (small blind) collected ($0.20)
Seat 2: bliznec828 (big blind) folded before Flop
Seat 3: oksuz77 folded before Flop (didn't bet)
Seat 4: beastboy3690 folded before Flop (didn't bet)
Seat 5: EdamameKD folded before Flop (didn't bet)
Seat 6: el_buchkan (button) folded before Flop (didn't bet)



PokerStars Hand #222946836884:  Hold'em No Limit ($0.05/$0.10 USD) - 2021/01/23 2:24:28 ET
Table 'Malzovia III' 6-max Seat #1 is the button
Seat 1: Bannnkai ($10.10 in chips) 
Seat 2: bliznec828 ($10.55 in chips) 
Seat 3: oksuz77 ($2.02 in chips) 
Seat 4: beastboy3690 ($12.46 in chips) 
Seat 5: EdamameKD ($9.04 in chips) 
Seat 6: el_buchkan ($10 in chips) 
bliznec828: posts small blind $0.05
oksuz77: posts big blind $0.10
*** HOLE CARDS ***
beastboy3690: folds 
EdamameKD: folds 
el_buchkan: raises $0.20 to $0.30
Bannnkai: folds 
bliznec828: folds 
oksuz77: folds 
Uncalled bet ($0.20) returned to el_buchkan
el_buchkan collected $0.25 from pot
el_buchkan: doesn't show hand 
*** SUMMARY ***
Total pot $0.25 | Rake $0 
Seat 1: Bannnkai (button) folded before Flop (didn't bet)
Seat 2: bliznec828 (small blind) folded before Flop
Seat 3: oksuz77 (big blind) folded before Flop
Seat 4: beastboy3690 folded before Flop (didn't bet)
Seat 5: EdamameKD folded before Flop (didn't bet)
Seat 6: el_buchkan collected ($0.25)



PokerStars Hand #222946840489:  Hold'em No Limit ($0.05/$0.10 USD) - 2021/01/23 2:24:43 ET
Table 'Malzovia III' 6-max Seat #2 is the button
Seat 1: Bannnkai ($10.10 in chips) 
Seat 2: bliznec828 ($10.50 in chips) 
Seat 3: oksuz77 ($1.92 in chips) 
Seat 4: beastboy3690 ($12.46 in chips) 
Seat 5: EdamameKD ($9.04 in chips) 
Seat 6: el_buchkan ($10.15 in chips) 
oksuz77: posts small blind $0.05
beastboy3690: posts big blind $0.10
*** HOLE CARDS ***
EdamameKD: folds 
el_buchkan has timed out
el_buchkan: folds 
Bannnkai: folds 
bliznec828: raises $0.15 to $0.25
oksuz77: folds 
beastboy3690: calls $0.15
*** FLOP *** [2s Tc As]
beastboy3690: checks 
bliznec828: bets $0.17
beastboy3690: calls $0.17
*** TURN *** [2s Tc As] [7s]
beastboy3690: checks 
bliznec828: checks 
*** RIVER *** [2s Tc As 7s] [2h]
beastboy3690: bets $0.28
bliznec828: folds 
Uncalled bet ($0.28) returned to beastboy3690
beastboy3690 collected $0.85 from pot
beastboy3690: doesn't show hand 
*** SUMMARY ***
Total pot $0.89 | Rake $0.04 
Board [2s Tc As 7s 2h]
Seat 1: Bannnkai folded before Flop (didn't bet)
Seat 2: bliznec828 (button) folded on the River
Seat 3: oksuz77 (small blind) folded before Flop
Seat 4: beastboy3690 (big blind) collected ($0.85)
Seat 5: EdamameKD folded before Flop (didn't bet)
Seat 6: el_buchkan folded before Flop (didn't bet)



PokerStars Hand #222946857402:  Hold'em No Limit ($0.05/$0.10 USD) - 2021/01/23 2:25:57 ET
Table 'Malzovia III' 6-max Seat #3 is the button
Seat 1: Bannnkai ($10.10 in chips) 
Seat 2: bliznec828 ($10.08 in chips) 
Seat 3: oksuz77 ($1.87 in chips) 
Seat 4: beastboy3690 ($12.89 in chips) 
Seat 5: EdamameKD ($9.04 in chips) 
Seat 6: el_buchkan ($10.15 in chips) 
beastboy3690: posts small blind $0.05
EdamameKD: posts big blind $0.10
*** HOLE CARDS ***
el_buchkan: folds 
Bannnkai: folds 
bliznec828: raises $0.15 to $0.25
oksuz77: folds 
beastboy3690: folds 
EdamameKD: calls $0.15
*** FLOP *** [2s 2h 6s]
EdamameKD: bets $0.27
bliznec828: calls $0.27
*** TURN *** [2s 2h 6s] [Tc]
EdamameKD: bets $0.50
bliznec828: calls $0.50
*** RIVER *** [2s 2h 6s Tc] [Kh]
EdamameKD: checks 
bliznec828: bets $2.60
EdamameKD: folds 
Uncalled bet ($2.60) returned to bliznec828
bliznec828 collected $2 from pot
bliznec828: doesn't show hand 
*** SUMMARY ***
Total pot $2.09 | Rake $0.09 
Board [2s 2h 6s Tc Kh]
Seat 1: Bannnkai folded before Flop (didn't bet)
Seat 2: bliznec828 collected ($2)
Seat 3: oksuz77 (button) folded before Flop (didn't bet)
Seat 4: beastboy3690 (small blind) folded before Flop
Seat 5: EdamameKD (big blind) folded on the River
Seat 6: el_buchkan folded before Flop (didn't bet)



PokerStars Hand #222946869814:  Hold'em No Limit ($0.05/$0.10 USD) - 2021/01/23 2:26:51 ET
Table 'Malzovia III' 6-max Seat #4 is the button
Seat 1: Bannnkai ($10.10 in chips) 
Seat 2: bliznec828 ($11.06 in chips) 
Seat 3: oksuz77 ($1.87 in chips) 
Seat 4: beastboy3690 ($12.84 in chips) 
Seat 5: EdamameKD ($8.02 in chips) 
Seat 6: el_buchkan ($10.15 in chips) 
EdamameKD: posts small blind $0.05
el_buchkan: posts big blind $0.10
*** HOLE CARDS ***
Bannnkai: folds 
bliznec828: folds 
oksuz77: folds 
beastboy3690: raises $0.15 to $0.25
EdamameKD: folds 
el_buchkan: folds 
Uncalled bet ($0.15) returned to beastboy3690
beastboy3690 collected $0.25 from pot
beastboy3690: doesn't show hand 
*** SUMMARY ***
Total pot $0.25 | Rake $0 
Seat 1: Bannnkai folded before Flop (didn't bet)
Seat 2: bliznec828 folded before Flop (didn't bet)
Seat 3: oksuz77 folded before Flop (didn't bet)
Seat 4: beastboy3690 (button) collected ($0.25)
Seat 5: EdamameKD (small blind) folded before Flop
Seat 6: el_buchkan (big blind) folded before Flop



PokerStars Hand #222946874186:  Hold'em No Limit ($0.05/$0.10 USD) - 2021/01/23 2:27:10 ET
Table 'Malzovia III' 6-max Seat #5 is the button
Seat 1: Bannnkai ($10.10 in chips) 
Seat 2: bliznec828 ($11.06 in chips) 
Seat 3: oksuz77 ($1.87 in chips) 
Seat 4: beastboy3690 ($12.99 in chips) 
Seat 5: EdamameKD ($7.97 in chips) 
Seat 6: el_buchkan ($10.05 in chips) 
el_buchkan: posts small blind $0.05
Bannnkai: posts big blind $0.10
*** HOLE CARDS ***
bliznec828: raises $0.20 to $0.30
oksuz77: folds 
beastboy3690: folds 
EdamameKD: folds 
el_buchkan: folds 
Bannnkai: folds 
Uncalled bet ($0.20) returned to bliznec828
bliznec828 collected $0.25 from pot
bliznec828: doesn't show hand 
*** SUMMARY ***
Total pot $0.25 | Rake $0 
Seat 1: Bannnkai (big blind) folded before Flop
Seat 2: bliznec828 collected ($0.25)
Seat 3: oksuz77 folded before Flop (didn't bet)
Seat 4: beastboy3690 folded before Flop (didn't bet)
Seat 5: EdamameKD (button) folded before Flop (didn't bet)
Seat 6: el_buchkan (small blind) folded before Flop



PokerStars Hand #222946878197:  Hold'em No Limit ($0.05/$0.10 USD) - 2021/01/23 2:27:27 ET
Table 'Malzovia III' 6-max Seat #6 is the button
Seat 1: Bannnkai ($10 in chips) 
Seat 2: bliznec828 ($11.21 in chips) 
Seat 3: oksuz77 ($1.87 in chips) 
Seat 4: beastboy3690 ($12.99 in chips) 
Seat 5: EdamameKD ($7.97 in chips) 
Seat 6: el_buchkan ($10 in chips) 
Bannnkai: posts small blind $0.05
bliznec828: posts big blind $0.10
*** HOLE CARDS ***
oksuz77: folds 
beastboy3690: folds 
EdamameKD: folds 
el_buchkan: raises $0.15 to $0.25
Bannnkai: folds 
bliznec828: folds 
Uncalled bet ($0.15) returned to el_buchkan
el_buchkan collected $0.25 from pot
el_buchkan: doesn't show hand 
*** SUMMARY ***
Total pot $0.25 | Rake $0 
Seat 1: Bannnkai (small blind) folded before Flop
Seat 2: bliznec828 (big blind) folded before Flop
Seat 3: oksuz77 folded before Flop (didn't bet)
Seat 4: beastboy3690 folded before Flop (didn't bet)
Seat 5: EdamameKD folded before Flop (didn't bet)
Seat 6: el_buchkan (button) collected ($0.25)



PokerStars Hand #222946884404:  Hold'em No Limit ($0.05/$0.10 USD) - 2021/01/23 2:27:54 ET
Table 'Malzovia III' 6-max Seat #1 is the button
Seat 1: Bannnkai ($10 in chips) 
Seat 2: bliznec828 ($11.11 in chips) 
Seat 3: oksuz77 ($1.87 in chips) 
Seat 4: beastboy3690 ($12.99 in chips) 
Seat 5: EdamameKD ($7.97 in chips) 
Seat 6: el_buchkan ($10.15 in chips) 
bliznec828: posts small blind $0.05
oksuz77: posts big blind $0.10
*** HOLE CARDS ***
beastboy3690: folds 
EdamameKD: folds 
el_buchkan: raises $0.20 to $0.30
Bannnkai: folds 
bliznec828: raises $0.91 to $1.21
oksuz77: folds 
el_buchkan: folds 
Uncalled bet ($0.91) returned to bliznec828
bliznec828 collected $0.70 from pot
bliznec828: doesn't show hand 
*** SUMMARY ***
Total pot $0.70 | Rake $0 
Seat 1: Bannnkai (button) folded before Flop (didn't bet)
Seat 2: bliznec828 (small blind) collected ($0.70)
Seat 3: oksuz77 (big blind) folded before Flop
Seat 4: beastboy3690 folded before Flop (didn't bet)
Seat 5: EdamameKD folded before Flop (didn't bet)
Seat 6: el_buchkan folded before Flop



PokerStars Hand #222946892438:  Hold'em No Limit ($0.05/$0.10 USD) - 2021/01/23 2:28:28 ET
Table 'Malzovia III' 6-max Seat #2 is the button
Seat 1: Bannnkai ($10 in chips) 
Seat 2: bliznec828 ($11.51 in chips) 
Seat 3: oksuz77 ($1.77 in chips) 
Seat 4: beastboy3690 ($12.99 in chips) 
Seat 5: EdamameKD ($7.97 in chips) 
Seat 6: el_buchkan ($10 in chips) 
oksuz77: posts small blind $0.05
beastboy3690: posts big blind $0.10
*** HOLE CARDS ***
EdamameKD: folds 
el_buchkan: folds 
Bannnkai: raises $0.20 to $0.30
bliznec828: raises $0.80 to $1.10
oksuz77: folds 
beastboy3690: folds 
Bannnkai: folds 
Uncalled bet ($0.80) returned to bliznec828
bliznec828 collected $0.75 from pot
bliznec828: doesn't show hand 
*** SUMMARY ***
Total pot $0.75 | Rake $0 
Seat 1: Bannnkai folded before Flop
Seat 2: bliznec828 (button) collected ($0.75)
Seat 3: oksuz77 (small blind) folded before Flop
Seat 4: beastboy3690 (big blind) folded before Flop
Seat 5: EdamameKD folded before Flop (didn't bet)
Seat 6: el_buchkan folded before Flop (didn't bet)



PokerStars Hand #222946901742:  Hold'em No Limit ($0.05/$0.10 USD) - 2021/01/23 2:29:08 ET
Table 'Malzovia III' 6-max Seat #3 is the button
Seat 1: Bannnkai ($10 in chips) 
Seat 2: bliznec828 ($11.96 in chips) 
Seat 3: oksuz77 ($1.72 in chips) 
Seat 4: beastboy3690 ($12.89 in chips) 
Seat 5: EdamameKD ($7.97 in chips) 
Seat 6: el_buchkan ($10 in chips) 
beastboy3690: posts small blind $0.05
EdamameKD: posts big blind $0.10
*** HOLE CARDS ***
el_buchkan: folds 
Bannnkai: folds 
bliznec828: folds 
oksuz77: folds 
beastboy3690: folds 
Uncalled bet ($0.05) returned to EdamameKD
EdamameKD collected $0.10 from pot
EdamameKD: doesn't show hand 
*** SUMMARY ***
Total pot $0.10 | Rake $0 
Seat 1: Bannnkai folded before Flop (didn't bet)
Seat 2: bliznec828 folded before Flop (didn't bet)
Seat 3: oksuz77 (button) folded before Flop (didn't bet)
Seat 4: beastboy3690 (small blind) folded before Flop
Seat 5: EdamameKD (big blind) collected ($0.10)
Seat 6: el_buchkan folded before Flop (didn't bet)



PokerStars Hand #222946904539:  Hold'em No Limit ($0.05/$0.10 USD) - 2021/01/23 2:29:20 ET
Table 'Malzovia III' 6-max Seat #4 is the button
Seat 1: Bannnkai ($10 in chips) 
Seat 2: bliznec828 ($11.96 in chips) 
Seat 3: oksuz77 ($1.72 in chips) 
Seat 4: beastboy3690 ($12.84 in chips) 
Seat 5: EdamameKD ($8.02 in chips) 
Seat 6: el_buchkan ($10 in chips) 
EdamameKD: posts small blind $0.05
el_buchkan: posts big blind $0.10
*** HOLE CARDS ***
Bannnkai: folds 
bliznec828: folds 
oksuz77: folds 
beastboy3690: folds 
EdamameKD: raises $0.20 to $0.30
el_buchkan: folds 
Uncalled bet ($0.20) returned to EdamameKD
EdamameKD collected $0.20 from pot
EdamameKD: doesn't show hand 
*** SUMMARY ***
Total pot $0.20 | Rake $0 
Seat 1: Bannnkai folded before Flop (didn't bet)
Seat 2: bliznec828 folded before Flop (didn't bet)
Seat 3: oksuz77 folded before Flop (didn't bet)
Seat 4: beastboy3690 (button) folded before Flop (didn't bet)
Seat 5: EdamameKD (small blind) collected ($0.20)
Seat 6: el_buchkan (big blind) folded before Flop



PokerStars Hand #222946909995:  Hold'em No Limit ($0.05/$0.10 USD) - 2021/01/23 2:29:44 ET
Table 'Malzovia III' 6-max Seat #5 is the button
Seat 1: Bannnkai ($10 in chips) 
Seat 2: bliznec828 ($11.96 in chips) 
Seat 3: oksuz77 ($1.72 in chips) 
Seat 4: beastboy3690 ($12.84 in chips) 
Seat 5: EdamameKD ($8.12 in chips) 
Seat 6: el_buchkan ($10 in chips) 
el_buchkan: posts small blind $0.05
Bannnkai: posts big blind $0.10
*** HOLE CARDS ***
bliznec828: raises $0.20 to $0.30
oksuz77: folds 
beastboy3690: folds 
EdamameKD: folds 
el_buchkan: folds 
Bannnkai: calls $0.20
*** FLOP *** [6s 7s 9s]
Bannnkai: checks 
bliznec828: bets $0.20
Bannnkai: folds 
Uncalled bet ($0.20) returned to bliznec828
bliznec828 collected $0.62 from pot
bliznec828: doesn't show hand 
*** SUMMARY ***
Total pot $0.65 | Rake $0.03 
Board [6s 7s 9s]
Seat 1: Bannnkai (big blind) folded on the Flop
Seat 2: bliznec828 collected ($0.62)
Seat 3: oksuz77 folded before Flop (didn't bet)
Seat 4: beastboy3690 folded before Flop (didn't bet)
Seat 5: EdamameKD (button) folded before Flop (didn't bet)
Seat 6: el_buchkan (small blind) folded before Flop



PokerStars Hand #222946914506:  Hold'em No Limit ($0.05/$0.10 USD) - 2021/01/23 2:30:03 ET
Table 'Malzovia III' 6-max Seat #6 is the button
Seat 1: Bannnkai ($10 in chips) 
Seat 2: bliznec828 ($12.28 in chips) 
Seat 3: oksuz77 ($1.72 in chips) 
Seat 4: beastboy3690 ($12.84 in chips) 
Seat 5: EdamameKD ($8.12 in chips) 
Seat 6: el_buchkan ($10 in chips) 
Bannnkai: posts small blind $0.05
bliznec828: posts big blind $0.10
*** HOLE CARDS ***
oksuz77: folds 
beastboy3690: folds 
EdamameKD: folds 
el_buchkan: folds 
Bannnkai: raises $0.15 to $0.25
bliznec828: folds 
Uncalled bet ($0.15) returned to Bannnkai
Bannnkai collected $0.20 from pot
Bannnkai: doesn't show hand 
*** SUMMARY ***
Total pot $0.20 | Rake $0 
Seat 1: Bannnkai (small blind) collected ($0.20)
Seat 2: bliznec828 (big blind) folded before Flop
Seat 3: oksuz77 folded before Flop (didn't bet)
Seat 4: beastboy3690 folded before Flop (didn't bet)
Seat 5: EdamameKD folded before Flop (didn't bet)
Seat 6: el_buchkan (button) folded before Flop (didn't bet)



PokerStars Hand #222946916471:  Hold'em No Limit ($0.05/$0.10 USD) - 2021/01/23 2:30:11 ET
Table 'Malzovia III' 6-max Seat #1 is the button
Seat 1: Bannnkai ($10.10 in chips) 
Seat 2: bliznec828 ($12.18 in chips) 
Seat 3: oksuz77 ($1.72 in chips) 
Seat 4: beastboy3690 ($12.84 in chips) 
Seat 5: EdamameKD ($8.12 in chips) 
Seat 6: el_buchkan ($10 in chips) 
bliznec828: posts small blind $0.05
oksuz77: posts big blind $0.10
*** HOLE CARDS ***
beastboy3690: folds 
EdamameKD: calls $0.10
el_buchkan: folds 
Bannnkai: folds 
bliznec828: calls $0.05
oksuz77: checks 
*** FLOP *** [2h 2c 5s]
bliznec828: checks 
oksuz77: checks 
EdamameKD: bets $0.60
bliznec828: folds 
oksuz77: folds 
Uncalled bet ($0.60) returned to EdamameKD
EdamameKD collected $0.29 from pot
EdamameKD: doesn't show hand 
*** SUMMARY ***
Total pot $0.30 | Rake $0.01 
Board [2h 2c 5s]
Seat 1: Bannnkai (button) folded before Flop (didn't bet)
Seat 2: bliznec828 (small blind) folded on the Flop
Seat 3: oksuz77 (big blind) folded on the Flop
Seat 4: beastboy3690 folded before Flop (didn't bet)
Seat 5: EdamameKD collected ($0.29)
Seat 6: el_buchkan folded before Flop (didn't bet)



PokerStars Hand #222945375452:  Hold'em No Limit ($0.05/$0.10 USD) - 2021/01/23 0:43:58 ET
Table 'Malzovia III' 6-max Seat #5 is the button
Seat 1: AvGeL ($12.89 in chips) 
Seat 2: ildar87kzn ($10.15 in chips) 
Seat 3: gresscrack ($16.65 in chips) 
Seat 4: FeL.Ru ($15.11 in chips) 
Seat 5: whtocean ($10 in chips) 
Seat 6: kjohnson1409 ($9.08 in chips) 
kjohnson1409: posts small blind $0.05
AvGeL: posts big blind $0.10
*** HOLE CARDS ***
ildar87kzn: folds 
gresscrack: folds 
FeL.Ru: raises $0.20 to $0.30
whtocean: raises $0.60 to $0.90
kjohnson1409: folds 
AvGeL: folds 
FeL.Ru: folds 
Uncalled bet ($0.60) returned to whtocean
whtocean collected $0.75 from pot
whtocean: doesn't show hand 
*** SUMMARY ***
Total pot $0.75 | Rake $0 
Seat 1: AvGeL (big blind) folded before Flop
Seat 2: ildar87kzn folded before Flop (didn't bet)
Seat 3: gresscrack folded before Flop (didn't bet)
Seat 4: FeL.Ru folded before Flop
Seat 5: whtocean (button) collected ($0.75)
Seat 6: kjohnson1409 (small blind) folded before Flop



PokerStars Hand #222945381368:  Hold'em No Limit ($0.05/$0.10 USD) - 2021/01/23 0:44:21 ET
Table 'Malzovia III' 6-max Seat #6 is the button
Seat 1: AvGeL ($12.79 in chips) 
Seat 2: ildar87kzn ($10.15 in chips) 
Seat 3: gresscrack ($16.65 in chips) 
Seat 4: FeL.Ru ($14.81 in chips) 
Seat 5: whtocean ($10.45 in chips) 
Seat 6: kjohnson1409 ($9.03 in chips) 
AvGeL: posts small blind $0.05
ildar87kzn: posts big blind $0.10
*** HOLE CARDS ***
gresscrack: folds 
FeL.Ru: folds 
gresscrack leaves the table
whtocean: raises $0.15 to $0.25
oksuz77 joins the table at seat #3 
kjohnson1409: folds 
AvGeL: folds 
ildar87kzn: folds 
Uncalled bet ($0.15) returned to whtocean
whtocean collected $0.25 from pot
whtocean: doesn't show hand 
*** SUMMARY ***
Total pot $0.25 | Rake $0 
Seat 1: AvGeL (small blind) folded before Flop
Seat 2: ildar87kzn (big blind) folded before Flop
Seat 3: gresscrack folded before Flop (didn't bet)
Seat 4: FeL.Ru folded before Flop (didn't bet)
Seat 5: whtocean collected ($0.25)
Seat 6: kjohnson1409 (button) folded before Flop (didn't bet)



PokerStars Hand #222945388568:  Hold'em No Limit ($0.05/$0.10 USD) - 2021/01/23 0:44:48 ET
Table 'Malzovia III' 6-max Seat #1 is the button
Seat 1: AvGeL ($12.74 in chips) 
Seat 2: ildar87kzn ($10.05 in chips) 
Seat 3: oksuz77 ($10 in chips) 
Seat 4: FeL.Ru ($14.81 in chips) 
Seat 5: whtocean ($10.60 in chips) 
Seat 6: kjohnson1409 ($9.03 in chips) 
ildar87kzn: posts small blind $0.05
oksuz77: posts big blind $0.10
*** HOLE CARDS ***
FeL.Ru: folds 
whtocean: folds 
kjohnson1409: folds 
AvGeL: folds 
ildar87kzn: folds 
Uncalled bet ($0.05) returned to oksuz77
oksuz77 collected $0.10 from pot
oksuz77: doesn't show hand 
*** SUMMARY ***
Total pot $0.10 | Rake $0 
Seat 1: AvGeL (button) folded before Flop (didn't bet)
Seat 2: ildar87kzn (small blind) folded before Flop
Seat 3: oksuz77 (big blind) collected ($0.10)
Seat 4: FeL.Ru folded before Flop (didn't bet)
Seat 5: whtocean folded before Flop (didn't bet)
Seat 6: kjohnson1409 folded before Flop (didn't bet)



PokerStars Hand #222945393699:  Hold'em No Limit ($0.05/$0.10 USD) - 2021/01/23 0:45:08 ET
Table 'Malzovia III' 6-max Seat #2 is the button
Seat 1: AvGeL ($12.74 in chips) 
Seat 2: ildar87kzn ($10 in chips) 
Seat 3: oksuz77 ($10.05 in chips) 
Seat 4: FeL.Ru ($14.81 in chips) 
Seat 5: whtocean ($10.60 in chips) 
Seat 6: kjohnson1409 ($9.03 in chips) 
oksuz77: posts small blind $0.05
FeL.Ru: posts big blind $0.10
*** HOLE CARDS ***
whtocean: folds 
kjohnson1409: raises $0.20 to $0.30
AvGeL: folds 
ildar87kzn: folds 
oksuz77: folds 
FeL.Ru: calls $0.20
*** FLOP *** [As 4c 5d]
FeL.Ru: checks 
kjohnson1409: bets $0.31
FeL.Ru: calls $0.31
*** TURN *** [As 4c 5d] [2s]
FeL.Ru: bets $0.80
kjohnson1409: raises $1.87 to $2.67
FeL.Ru: raises $3.48 to $6.15
kjohnson1409: raises $2.27 to $8.42 and is all-in
FeL.Ru: calls $2.27
*** RIVER *** [As 4c 5d 2s] [2d]
*** SHOW DOWN ***
FeL.Ru: shows [3h 3d] (a straight, Ace to Five)
kjohnson1409: shows [Th Ac] (two pair, Aces and Deuces)
FeL.Ru collected $17.30 from pot
*** SUMMARY ***
Total pot $18.11 | Rake $0.81 
Board [As 4c 5d 2s 2d]
Seat 1: AvGeL folded before Flop (didn't bet)
Seat 2: ildar87kzn (button) folded before Flop (didn't bet)
Seat 3: oksuz77 (small blind) folded before Flop
Seat 4: FeL.Ru (big blind) showed [3h 3d] and won ($17.30) with a straight, Ace to Five
Seat 5: whtocean folded before Flop (didn't bet)
Seat 6: kjohnson1409 showed [Th Ac] and lost with two pair, Aces and Deuces



PokerStars Hand #222945416064:  Hold'em No Limit ($0.05/$0.10 USD) - 2021/01/23 0:46:35 ET
Table 'Malzovia III' 6-max Seat #3 is the button
Seat 1: AvGeL ($12.74 in chips) 
Seat 2: ildar87kzn ($10 in chips) 
Seat 3: oksuz77 ($10 in chips) 
Seat 4: FeL.Ru ($23.08 in chips) 
Seat 5: whtocean ($10.60 in chips) 
FeL.Ru: posts small blind $0.05
whtocean: posts big blind $0.10
*** HOLE CARDS ***
AvGeL: raises $0.20 to $0.30
ildar87kzn: folds 
oksuz77: raises $0.20 to $0.50
FeL.Ru: folds 
whtocean: folds 
AvGeL: calls $0.20
*** FLOP *** [Jd 4c 7s]
AvGeL: checks 
oksuz77: bets $0.10
AvGeL: calls $0.10
*** TURN *** [Jd 4c 7s] [2h]
AvGeL: checks 
oksuz77: bets $0.30
AvGeL: calls $0.30
*** RIVER *** [Jd 4c 7s 2h] [2s]
AvGeL: checks 
oksuz77: bets $2
AvGeL: folds 
Uncalled bet ($2) returned to oksuz77
kjohnson1409 leaves the table
oksuz77 collected $1.86 from pot
oksuz77: doesn't show hand 
*** SUMMARY ***
Total pot $1.95 | Rake $0.09 
Board [Jd 4c 7s 2h 2s]
Seat 1: AvGeL folded on the River
Seat 2: ildar87kzn folded before Flop (didn't bet)
Seat 3: oksuz77 (button) collected ($1.86)
Seat 4: FeL.Ru (small blind) folded before Flop
Seat 5: whtocean (big blind) folded before Flop



PokerStars Hand #222945425440:  Hold'em No Limit ($0.05/$0.10 USD) - 2021/01/23 0:47:12 ET
Table 'Malzovia III' 6-max Seat #4 is the button
Seat 1: AvGeL ($11.84 in chips) 
Seat 2: ildar87kzn ($10 in chips) 
Seat 3: oksuz77 ($10.96 in chips) 
Seat 4: FeL.Ru ($23.03 in chips) 
Seat 5: whtocean ($10.50 in chips) 
whtocean: posts small blind $0.05
AvGeL: posts big blind $0.10
*** HOLE CARDS ***
ildar87kzn: folds 
oksuz77: folds 
FeL.Ru: raises $0.20 to $0.30
whtocean: folds 
AvGeL: folds 
Uncalled bet ($0.20) returned to FeL.Ru
FeL.Ru collected $0.25 from pot
FeL.Ru: doesn't show hand 
*** SUMMARY ***
Total pot $0.25 | Rake $0 
Seat 1: AvGeL (big blind) folded before Flop
Seat 2: ildar87kzn folded before Flop (didn't bet)
Seat 3: oksuz77 folded before Flop (didn't bet)
Seat 4: FeL.Ru (button) collected ($0.25)
Seat 5: whtocean (small blind) folded before Flop



PokerStars Hand #222945429152:  Hold'em No Limit ($0.05/$0.10 USD) - 2021/01/23 0:47:26 ET
Table 'Malzovia III' 6-max Seat #5 is the button
Seat 1: AvGeL ($11.74 in chips) 
Seat 2: ildar87kzn ($10 in chips) 
Seat 3: oksuz77 ($10.96 in chips) 
Seat 4: FeL.Ru ($23.18 in chips) 
Seat 5: whtocean ($10.45 in chips) 
AvGeL: posts small blind $0.05
ildar87kzn: posts big blind $0.10
*** HOLE CARDS ***
oksuz77: folds 
FeL.Ru: folds 
whtocean: folds 
AvGeL: raises $0.20 to $0.30
ildar87kzn: folds 
Uncalled bet ($0.20) returned to AvGeL
AvGeL collected $0.20 from pot
*** SUMMARY ***
Total pot $0.20 | Rake $0 
Seat 1: AvGeL (small blind) collected ($0.20)
Seat 2: ildar87kzn (big blind) folded before Flop
Seat 3: oksuz77 folded before Flop (didn't bet)
Seat 4: FeL.Ru folded before Flop (didn't bet)
Seat 5: whtocean (button) folded before Flop (didn't bet)



PokerStars Hand #222945432900:  Hold'em No Limit ($0.05/$0.10 USD) - 2021/01/23 0:47:41 ET
Table 'Malzovia III' 6-max Seat #1 is the button
Seat 1: AvGeL ($11.84 in chips) 
Seat 2: ildar87kzn ($10 in chips) 
Seat 3: oksuz77 ($10.96 in chips) 
Seat 4: FeL.Ru ($23.18 in chips) 
Seat 5: whtocean ($10.45 in chips) 
ildar87kzn: posts small blind $0.05
oksuz77: posts big blind $0.10
*** HOLE CARDS ***
FeL.Ru: folds 
whtocean: raises $0.15 to $0.25
AvGeL: folds 
ildar87kzn: raises $0.75 to $1
oksuz77: folds 
Pokernan95 joins the table at seat #6 
whtocean: folds 
Uncalled bet ($0.75) returned to ildar87kzn
ildar87kzn collected $0.60 from pot
ildar87kzn: doesn't show hand 
*** SUMMARY ***
Total pot $0.60 | Rake $0 
Seat 1: AvGeL (button) folded before Flop (didn't bet)
Seat 2: ildar87kzn (small blind) collected ($0.60)
Seat 3: oksuz77 (big blind) folded before Flop
Seat 4: FeL.Ru folded before Flop (didn't bet)
Seat 5: whtocean folded before Flop



PokerStars Hand #222945439026:  Hold'em No Limit ($0.05/$0.10 USD) - 2021/01/23 0:48:05 ET
Table 'Malzovia III' 6-max Seat #2 is the button
Seat 1: AvGeL ($11.84 in chips) 
Seat 2: ildar87kzn ($10.35 in chips) 
Seat 3: oksuz77 ($10.86 in chips) 
Seat 4: FeL.Ru ($23.18 in chips) 
Seat 5: whtocean ($10.20 in chips) 
oksuz77: posts small blind $0.05
FeL.Ru: posts big blind $0.10
Pokernan95: sits out 
*** HOLE CARDS ***
whtocean: folds 
AvGeL: folds 
ildar87kzn: folds 
oksuz77: folds 
Uncalled bet ($0.05) returned to FeL.Ru
FeL.Ru collected $0.10 from pot
FeL.Ru: doesn't show hand 
*** SUMMARY ***
Total pot $0.10 | Rake $0 
Seat 1: AvGeL folded before Flop (didn't bet)
Seat 2: ildar87kzn (button) folded before Flop (didn't bet)
Seat 3: oksuz77 (small blind) folded before Flop
Seat 4: FeL.Ru (big blind) collected ($0.10)
Seat 5: whtocean folded before Flop (didn't bet)



PokerStars Hand #222945441089:  Hold'em No Limit ($0.05/$0.10 USD) - 2021/01/23 0:48:13 ET
Table 'Malzovia III' 6-max Seat #3 is the button
Seat 1: AvGeL ($11.84 in chips) 
Seat 2: ildar87kzn ($10.35 in chips) 
Seat 3: oksuz77 ($10.81 in chips) 
Seat 4: FeL.Ru ($23.23 in chips) 
Seat 5: whtocean ($10.20 in chips) 
FeL.Ru: posts small blind $0.05
whtocean: posts big blind $0.10
Pokernan95: sits out 
*** HOLE CARDS ***
AvGeL: folds 
ildar87kzn: folds 
oksuz77: folds 
FeL.Ru: raises $0.20 to $0.30
whtocean: calls $0.20
*** FLOP *** [7s Kc As]
FeL.Ru: bets $0.38
whtocean: calls $0.38
*** TURN *** [7s Kc As] [Js]
FeL.Ru: bets $0.85
whtocean: folds 
Uncalled bet ($0.85) returned to FeL.Ru
FeL.Ru collected $1.30 from pot
FeL.Ru: doesn't show hand 
*** SUMMARY ***
Total pot $1.36 | Rake $0.06 
Board [7s Kc As Js]
Seat 1: AvGeL folded before Flop (didn't bet)
Seat 2: ildar87kzn folded before Flop (didn't bet)
Seat 3: oksuz77 (button) folded before Flop (didn't bet)
Seat 4: FeL.Ru (small blind) collected ($1.30)
Seat 5: whtocean (big blind) folded on the Turn



PokerStars Hand #222945449001:  Hold'em No Limit ($0.05/$0.10 USD) - 2021/01/23 0:48:44 ET
Table 'Malzovia III' 6-max Seat #4 is the button
Seat 1: AvGeL ($11.84 in chips) 
Seat 2: ildar87kzn ($10.35 in chips) 
Seat 3: oksuz77 ($10.81 in chips) 
Seat 4: FeL.Ru ($23.85 in chips) 
Seat 5: whtocean ($10 in chips) 
Seat 6: Pokernan95 ($10 in chips) 
whtocean: posts small blind $0.05
Pokernan95: posts big blind $0.10
*** HOLE CARDS ***
AvGeL: folds 
ildar87kzn: folds 
oksuz77: folds 
FeL.Ru: folds 
whtocean: raises $0.15 to $0.25
Pokernan95: folds 
Uncalled bet ($0.15) returned to whtocean
whtocean collected $0.20 from pot
whtocean: doesn't show hand 
*** SUMMARY ***
Total pot $0.20 | Rake $0 
Seat 1: AvGeL folded before Flop (didn't bet)
Seat 2: ildar87kzn folded before Flop (didn't bet)
Seat 3: oksuz77 folded before Flop (didn't bet)
Seat 4: FeL.Ru (button) folded before Flop (didn't bet)
Seat 5: whtocean (small blind) collected ($0.20)
Seat 6: Pokernan95 (big blind) folded before Flop



PokerStars Hand #222945454182:  Hold'em No Limit ($0.05/$0.10 USD) - 2021/01/23 0:49:04 ET
Table 'Malzovia III' 6-max Seat #5 is the button
Seat 1: AvGeL ($11.84 in chips) 
Seat 2: ildar87kzn ($10.35 in chips) 
Seat 3: oksuz77 ($10.81 in chips) 
Seat 4: FeL.Ru ($23.85 in chips) 
Seat 5: whtocean ($10.10 in chips) 
Seat 6: Pokernan95 ($9.90 in chips) 
Pokernan95: posts small blind $0.05
AvGeL: posts big blind $0.10
*** HOLE CARDS ***
ildar87kzn: folds 
oksuz77: folds 
FeL.Ru: folds 
whtocean: raises $0.15 to $0.25
Pokernan95: folds 
AvGeL: calls $0.15
*** FLOP *** [4d 9c As]
AvGeL: checks 
whtocean: bets $0.19
AvGeL: calls $0.19
*** TURN *** [4d 9c As] [6h]
AvGeL: checks 
whtocean: checks 
*** RIVER *** [4d 9c As 6h] [7c]
AvGeL: bets $0.67
whtocean: folds 
Uncalled bet ($0.67) returned to AvGeL
AvGeL collected $0.89 from pot
*** SUMMARY ***
Total pot $0.93 | Rake $0.04 
Board [4d 9c As 6h 7c]
Seat 1: AvGeL (big blind) collected ($0.89)
Seat 2: ildar87kzn folded before Flop (didn't bet)
Seat 3: oksuz77 folded before Flop (didn't bet)
Seat 4: FeL.Ru folded before Flop (didn't bet)
Seat 5: whtocean (button) folded on the River
Seat 6: Pokernan95 (small blind) folded before Flop



PokerStars Hand #222945467292:  Hold'em No Limit ($0.05/$0.10 USD) - 2021/01/23 0:49:56 ET
Table 'Malzovia III' 6-max Seat #6 is the button
Seat 1: AvGeL ($12.29 in chips) 
Seat 2: ildar87kzn ($10.35 in chips) 
Seat 3: oksuz77 ($10.81 in chips) 
Seat 4: FeL.Ru ($23.85 in chips) 
Seat 5: whtocean ($10 in chips) 
Seat 6: Pokernan95 ($9.85 in chips) 
AvGeL: posts small blind $0.05
ildar87kzn: posts big blind $0.10
*** HOLE CARDS ***
oksuz77: folds 
FeL.Ru: folds 
whtocean: folds 
Pokernan95: folds 
AvGeL: raises $0.20 to $0.30
ildar87kzn: folds 
Uncalled bet ($0.20) returned to AvGeL
AvGeL collected $0.20 from pot
*** SUMMARY ***
Total pot $0.20 | Rake $0 
Seat 1: AvGeL (small blind) collected ($0.20)
Seat 2: ildar87kzn (big blind) folded before Flop
Seat 3: oksuz77 folded before Flop (didn't bet)
Seat 4: FeL.Ru folded before Flop (didn't bet)
Seat 5: whtocean folded before Flop (didn't bet)
Seat 6: Pokernan95 (button) folded before Flop (didn't bet)



PokerStars Hand #222945470107:  Hold'em No Limit ($0.05/$0.10 USD) - 2021/01/23 0:50:07 ET
Table 'Malzovia III' 6-max Seat #1 is the button
Seat 1: AvGeL ($12.39 in chips) 
Seat 2: ildar87kzn ($10.25 in chips) 
Seat 3: oksuz77 ($10.81 in chips) 
Seat 4: FeL.Ru ($23.85 in chips) 
Seat 5: whtocean ($10 in chips) 
Seat 6: Pokernan95 ($9.85 in chips) 
ildar87kzn: posts small blind $0.05
oksuz77: posts big blind $0.10
*** HOLE CARDS ***
FeL.Ru: folds 
whtocean: folds 
Pokernan95: folds 
AvGeL: raises $0.10 to $0.20
ildar87kzn: folds 
oksuz77: calls $0.10
*** FLOP *** [7h 3s Th]
oksuz77: checks 
AvGeL: bets $0.22
oksuz77: folds 
Uncalled bet ($0.22) returned to AvGeL
AvGeL collected $0.43 from pot
*** SUMMARY ***
Total pot $0.45 | Rake $0.02 
Board [7h 3s Th]
Seat 1: AvGeL (button) collected ($0.43)
Seat 2: ildar87kzn (small blind) folded before Flop
Seat 3: oksuz77 (big blind) folded on the Flop
Seat 4: FeL.Ru folded before Flop (didn't bet)
Seat 5: whtocean folded before Flop (didn't bet)
Seat 6: Pokernan95 folded before Flop (didn't bet)



PokerStars Hand #222945475526:  Hold'em No Limit ($0.05/$0.10 USD) - 2021/01/23 0:50:28 ET
Table 'Malzovia III' 6-max Seat #2 is the button
Seat 1: AvGeL ($12.62 in chips) 
Seat 2: ildar87kzn ($10.20 in chips) 
Seat 3: oksuz77 ($10.61 in chips) 
Seat 4: FeL.Ru ($23.85 in chips) 
Seat 5: whtocean ($10 in chips) 
Seat 6: Pokernan95 ($9.85 in chips) 
oksuz77: posts small blind $0.05
FeL.Ru: posts big blind $0.10
*** HOLE CARDS ***
whtocean: raises $0.20 to $0.30
Pokernan95: folds 
AvGeL: calls $0.30
ildar87kzn: folds 
oksuz77: folds 
FeL.Ru: folds 
*** FLOP *** [5s 5d 9s]
whtocean: checks 
AvGeL: bets $0.36
whtocean: folds 
Uncalled bet ($0.36) returned to AvGeL
AvGeL collected $0.72 from pot
*** SUMMARY ***
Total pot $0.75 | Rake $0.03 
Board [5s 5d 9s]
Seat 1: AvGeL collected ($0.72)
Seat 2: ildar87kzn (button) folded before Flop (didn't bet)
Seat 3: oksuz77 (small blind) folded before Flop
Seat 4: FeL.Ru (big blind) folded before Flop
Seat 5: whtocean folded on the Flop
Seat 6: Pokernan95 folded before Flop (didn't bet)



PokerStars Hand #222945483442:  Hold'em No Limit ($0.05/$0.10 USD) - 2021/01/23 0:51:00 ET
Table 'Malzovia III' 6-max Seat #3 is the button
Seat 1: AvGeL ($13.04 in chips) 
Seat 2: ildar87kzn ($10.20 in chips) 
Seat 3: oksuz77 ($10.56 in chips) 
Seat 4: FeL.Ru ($23.75 in chips) 
Seat 5: whtocean ($10 in chips) 
Seat 6: Pokernan95 ($9.85 in chips) 
FeL.Ru: posts small blind $0.05
whtocean: posts big blind $0.10
*** HOLE CARDS ***
Pokernan95: folds 
AvGeL: folds 
ildar87kzn: folds 
oksuz77: folds 
FeL.Ru: raises $0.20 to $0.30
whtocean: folds 
Uncalled bet ($0.20) returned to FeL.Ru
FeL.Ru collected $0.20 from pot
FeL.Ru: doesn't show hand 
*** SUMMARY ***
Total pot $0.20 | Rake $0 
Seat 1: AvGeL folded before Flop (didn't bet)
Seat 2: ildar87kzn folded before Flop (didn't bet)
Seat 3: oksuz77 (button) folded before Flop (didn't bet)
Seat 4: FeL.Ru (small blind) collected ($0.20)
Seat 5: whtocean (big blind) folded before Flop
Seat 6: Pokernan95 folded before Flop (didn't bet)



PokerStars Hand #222945491418:  Hold'em No Limit ($0.05/$0.10 USD) - 2021/01/23 0:51:31 ET
Table 'Malzovia III' 6-max Seat #4 is the button
Seat 1: AvGeL ($13.04 in chips) 
Seat 2: ildar87kzn ($10.20 in chips) 
Seat 3: oksuz77 ($10.56 in chips) 
Seat 4: FeL.Ru ($23.85 in chips) 
Seat 5: whtocean ($10 in chips) 
Seat 6: Pokernan95 ($9.85 in chips) 
whtocean: posts small blind $0.05
Pokernan95: posts big blind $0.10
*** HOLE CARDS ***
AvGeL: folds 
ildar87kzn: folds 
oksuz77: folds 
FeL.Ru: raises $0.20 to $0.30
whtocean: folds 
Pokernan95: folds 
Uncalled bet ($0.20) returned to FeL.Ru
FeL.Ru collected $0.25 from pot
FeL.Ru: doesn't show hand 
*** SUMMARY ***
Total pot $0.25 | Rake $0 
Seat 1: AvGeL folded before Flop (didn't bet)
Seat 2: ildar87kzn folded before Flop (didn't bet)
Seat 3: oksuz77 folded before Flop (didn't bet)
Seat 4: FeL.Ru (button) collected ($0.25)
Seat 5: whtocean (small blind) folded before Flop
Seat 6: Pokernan95 (big blind) folded before Flop



PokerStars Hand #222945495629:  Hold'em No Limit ($0.05/$0.10 USD) - 2021/01/23 0:51:48 ET
Table 'Malzovia III' 6-max Seat #5 is the button
Seat 1: AvGeL ($13.04 in chips) 
Seat 2: ildar87kzn ($10.20 in chips) 
Seat 3: oksuz77 ($10.56 in chips) 
Seat 4: FeL.Ru ($24 in chips) 
Seat 5: whtocean ($10 in chips) 
Seat 6: Pokernan95 ($9.75 in chips) 
Pokernan95: posts small blind $0.05
AvGeL: posts big blind $0.10
*** HOLE CARDS ***
ildar87kzn: raises $0.20 to $0.30
oksuz77: folds 
FeL.Ru: folds 
whtocean: folds 
Pokernan95: folds 
AvGeL: folds 
Uncalled bet ($0.20) returned to ildar87kzn
ildar87kzn collected $0.25 from pot
ildar87kzn: doesn't show hand 
*** SUMMARY ***
Total pot $0.25 | Rake $0 
Seat 1: AvGeL (big blind) folded before Flop
Seat 2: ildar87kzn collected ($0.25)
Seat 3: oksuz77 folded before Flop (didn't bet)
Seat 4: FeL.Ru folded before Flop (didn't bet)
Seat 5: whtocean (button) folded before Flop (didn't bet)
Seat 6: Pokernan95 (small blind) folded before Flop



PokerStars Hand #222945500457:  Hold'em No Limit ($0.05/$0.10 USD) - 2021/01/23 0:52:07 ET
Table 'Malzovia III' 6-max Seat #6 is the button
Seat 1: AvGeL ($12.94 in chips) 
Seat 2: ildar87kzn ($10.35 in chips) 
Seat 3: oksuz77 ($10.56 in chips) 
Seat 4: FeL.Ru ($24 in chips) 
Seat 5: whtocean ($10 in chips) 
Seat 6: Pokernan95 ($9.70 in chips) 
AvGeL: posts small blind $0.05
ildar87kzn: posts big blind $0.10
*** HOLE CARDS ***
oksuz77: folds 
FeL.Ru: folds 
whtocean: folds 
Pokernan95: folds 
AvGeL: folds 
Uncalled bet ($0.05) returned to ildar87kzn
ildar87kzn collected $0.10 from pot
ildar87kzn: doesn't show hand 
*** SUMMARY ***
Total pot $0.10 | Rake $0 
Seat 1: AvGeL (small blind) folded before Flop
Seat 2: ildar87kzn (big blind) collected ($0.10)
Seat 3: oksuz77 folded before Flop (didn't bet)
Seat 4: FeL.Ru folded before Flop (didn't bet)
Seat 5: whtocean folded before Flop (didn't bet)
Seat 6: Pokernan95 (button) folded before Flop (didn't bet)



PokerStars Hand #222945504594:  Hold'em No Limit ($0.05/$0.10 USD) - 2021/01/23 0:52:23 ET
Table 'Malzovia III' 6-max Seat #1 is the button
Seat 1: AvGeL ($12.89 in chips) 
Seat 2: ildar87kzn ($10.40 in chips) 
Seat 3: oksuz77 ($10.56 in chips) 
Seat 4: FeL.Ru ($24 in chips) 
Seat 5: whtocean ($10 in chips) 
Seat 6: Pokernan95 ($9.70 in chips) 
ildar87kzn: posts small blind $0.05
oksuz77: posts big blind $0.10
*** HOLE CARDS ***
FeL.Ru: folds 
whtocean: folds 
Pokernan95: folds 
AvGeL: raises $0.10 to $0.20
ildar87kzn: folds 
oksuz77: folds 
Uncalled bet ($0.10) returned to AvGeL
AvGeL collected $0.25 from pot
*** SUMMARY ***
Total pot $0.25 | Rake $0 
Seat 1: AvGeL (button) collected ($0.25)
Seat 2: ildar87kzn (small blind) folded before Flop
Seat 3: oksuz77 (big blind) folded before Flop
Seat 4: FeL.Ru folded before Flop (didn't bet)
Seat 5: whtocean folded before Flop (didn't bet)
Seat 6: Pokernan95 folded before Flop (didn't bet)



PokerStars Hand #222945508368:  Hold'em No Limit ($0.05/$0.10 USD) - 2021/01/23 0:52:38 ET
Table 'Malzovia III' 6-max Seat #2 is the button
Seat 1: AvGeL ($13.04 in chips) 
Seat 2: ildar87kzn ($10.35 in chips) 
Seat 3: oksuz77 ($10.46 in chips) 
Seat 4: FeL.Ru ($24 in chips) 
Seat 5: whtocean ($10 in chips) 
Seat 6: Pokernan95 ($9.70 in chips) 
oksuz77: posts small blind $0.05
FeL.Ru: posts big blind $0.10
*** HOLE CARDS ***
whtocean: folds 
Pokernan95: folds 
AvGeL: raises $0.15 to $0.25
ildar87kzn: folds 
oksuz77: folds 
FeL.Ru: calls $0.15
*** FLOP *** [6c 9h Tc]
FeL.Ru: bets $0.46
AvGeL: raises $0.74 to $1.20
FeL.Ru: raises $1.87 to $3.07
AvGeL: calls $1.87
*** TURN *** [6c 9h Tc] [8d]
FeL.Ru: bets $4.19
AvGeL: folds 
Uncalled bet ($4.19) returned to FeL.Ru
FeL.Ru collected $6.39 from pot
FeL.Ru: doesn't show hand 
*** SUMMARY ***
Total pot $6.69 | Rake $0.30 
Board [6c 9h Tc 8d]
Seat 1: AvGeL folded on the Turn
Seat 2: ildar87kzn (button) folded before Flop (didn't bet)
Seat 3: oksuz77 (small blind) folded before Flop
Seat 4: FeL.Ru (big blind) collected ($6.39)
Seat 5: whtocean folded before Flop (didn't bet)
Seat 6: Pokernan95 folded before Flop (didn't bet)



PokerStars Hand #222945527310:  Hold'em No Limit ($0.05/$0.10 USD) - 2021/01/23 0:53:24 ET
Table 'Malzovia III' 6-max Seat #3 is the button
Seat 1: AvGeL ($10 in chips) 
Seat 2: ildar87kzn ($10.35 in chips) 
Seat 3: oksuz77 ($10.41 in chips) 
Seat 4: FeL.Ru ($27.07 in chips) 
Seat 5: whtocean ($10 in chips) 
Seat 6: Pokernan95 ($9.70 in chips) 
FeL.Ru: posts small blind $0.05
whtocean: posts big blind $0.10
*** HOLE CARDS ***
Pokernan95: folds 
AvGeL: folds 
ildar87kzn: folds 
oksuz77: folds 
FeL.Ru: raises $0.20 to $0.30
whtocean: folds 
Uncalled bet ($0.20) returned to FeL.Ru
FeL.Ru collected $0.20 from pot
FeL.Ru: doesn't show hand 
*** SUMMARY ***
Total pot $0.20 | Rake $0 
Seat 1: AvGeL folded before Flop (didn't bet)
Seat 2: ildar87kzn folded before Flop (didn't bet)
Seat 3: oksuz77 (button) folded before Flop (didn't bet)
Seat 4: FeL.Ru (small blind) collected ($0.20)
Seat 5: whtocean (big blind) folded before Flop
Seat 6: Pokernan95 folded before Flop (didn't bet)



PokerStars Hand #222945530341:  Hold'em No Limit ($0.05/$0.10 USD) - 2021/01/23 0:53:36 ET
Table 'Malzovia III' 6-max Seat #4 is the button
Seat 1: AvGeL ($10 in chips) 
Seat 2: ildar87kzn ($10.35 in chips) 
Seat 3: oksuz77 ($10.41 in chips) 
Seat 4: FeL.Ru ($27.17 in chips) 
Seat 5: whtocean ($10 in chips) 
Seat 6: Pokernan95 ($9.70 in chips) 
whtocean: posts small blind $0.05
Pokernan95: posts big blind $0.10
*** HOLE CARDS ***
AvGeL: folds 
ildar87kzn: folds 
oksuz77: folds 
FeL.Ru: folds 
whtocean: raises $0.15 to $0.25
Pokernan95: calls $0.15
*** FLOP *** [3h Kd 3s]
whtocean: bets $0.25
Pokernan95: folds 
Uncalled bet ($0.25) returned to whtocean
whtocean collected $0.48 from pot
whtocean: doesn't show hand 
*** SUMMARY ***
Total pot $0.50 | Rake $0.02 
Board [3h Kd 3s]
Seat 1: AvGeL folded before Flop (didn't bet)
Seat 2: ildar87kzn folded before Flop (didn't bet)
Seat 3: oksuz77 folded before Flop (didn't bet)
Seat 4: FeL.Ru (button) folded before Flop (didn't bet)
Seat 5: whtocean (small blind) collected ($0.48)
Seat 6: Pokernan95 (big blind) folded on the Flop



PokerStars Hand #222945538515:  Hold'em No Limit ($0.05/$0.10 USD) - 2021/01/23 0:54:09 ET
Table 'Malzovia III' 6-max Seat #5 is the button
Seat 1: AvGeL ($10 in chips) 
Seat 2: ildar87kzn ($10.35 in chips) 
Seat 3: oksuz77 ($10.41 in chips) 
Seat 4: FeL.Ru ($27.17 in chips) 
Seat 5: whtocean ($10.23 in chips) 
Seat 6: Pokernan95 ($9.45 in chips) 
Pokernan95: posts small blind $0.05
AvGeL: posts big blind $0.10
*** HOLE CARDS ***
ildar87kzn: folds 
oksuz77: folds 
FeL.Ru: folds 
whtocean: raises $0.15 to $0.25
Pokernan95: folds 
AvGeL: folds 
Uncalled bet ($0.15) returned to whtocean
whtocean collected $0.25 from pot
whtocean: doesn't show hand 
*** SUMMARY ***
Total pot $0.25 | Rake $0 
Seat 1: AvGeL (big blind) folded before Flop
Seat 2: ildar87kzn folded before Flop (didn't bet)
Seat 3: oksuz77 folded before Flop (didn't bet)
Seat 4: FeL.Ru folded before Flop (didn't bet)
Seat 5: whtocean (button) collected ($0.25)
Seat 6: Pokernan95 (small blind) folded before Flop



PokerStars Hand #222945543770:  Hold'em No Limit ($0.05/$0.10 USD) - 2021/01/23 0:54:30 ET
Table 'Malzovia III' 6-max Seat #6 is the button
Seat 1: AvGeL ($10 in chips) 
Seat 2: ildar87kzn ($10.35 in chips) 
Seat 3: oksuz77 ($10.41 in chips) 
Seat 4: FeL.Ru ($27.17 in chips) 
Seat 5: whtocean ($10.38 in chips) 
Seat 6: Pokernan95 ($9.40 in chips) 
AvGeL: posts small blind $0.05
ildar87kzn: posts big blind $0.10
*** HOLE CARDS ***
oksuz77: folds 
FeL.Ru: raises $0.20 to $0.30
whtocean: folds 
Pokernan95: calls $0.30
AvGeL: raises $1 to $1.30
ildar87kzn: folds 
FeL.Ru: folds 
Pokernan95: folds 
Uncalled bet ($1) returned to AvGeL
AvGeL collected $1 from pot
*** SUMMARY ***
Total pot $1 | Rake $0 
Seat 1: AvGeL (small blind) collected ($1)
Seat 2: ildar87kzn (big blind) folded before Flop
Seat 3: oksuz77 folded before Flop (didn't bet)
Seat 4: FeL.Ru folded before Flop
Seat 5: whtocean folded before Flop (didn't bet)
Seat 6: Pokernan95 (button) folded before Flop



PokerStars Hand #222945549967:  Hold'em No Limit ($0.05/$0.10 USD) - 2021/01/23 0:54:55 ET
Table 'Malzovia III' 6-max Seat #1 is the button
Seat 1: AvGeL ($10.70 in chips) 
Seat 2: ildar87kzn ($10.25 in chips) 
Seat 3: oksuz77 ($10.41 in chips) 
Seat 4: FeL.Ru ($26.87 in chips) 
Seat 5: whtocean ($10.38 in chips) 
Seat 6: Pokernan95 ($9.10 in chips) 
ildar87kzn: posts small blind $0.05
oksuz77: posts big blind $0.10
*** HOLE CARDS ***
FeL.Ru: raises $0.20 to $0.30
whtocean: raises $0.60 to $0.90
Pokernan95: folds 
AvGeL: folds 
ildar87kzn: folds 
oksuz77: folds 
FeL.Ru: calls $0.60
*** FLOP *** [7c 2s 6s]
FeL.Ru: checks 
whtocean: checks 
*** TURN *** [7c 2s 6s] [3s]
FeL.Ru: bets $1.33
whtocean: folds 
Uncalled bet ($1.33) returned to FeL.Ru
FeL.Ru collected $1.86 from pot
FeL.Ru: doesn't show hand 
*** SUMMARY ***
Total pot $1.95 | Rake $0.09 
Board [7c 2s 6s 3s]
Seat 1: AvGeL (button) folded before Flop (didn't bet)
Seat 2: ildar87kzn (small blind) folded before Flop
Seat 3: oksuz77 (big blind) folded before Flop
Seat 4: FeL.Ru collected ($1.86)
Seat 5: whtocean folded on the Turn
Seat 6: Pokernan95 folded before Flop (didn't bet)



PokerStars Hand #222945558998:  Hold'em No Limit ($0.05/$0.10 USD) - 2021/01/23 0:55:37 ET
Table 'Malzovia III' 6-max Seat #2 is the button
Seat 1: AvGeL ($10.70 in chips) 
Seat 2: ildar87kzn ($10.20 in chips) 
Seat 3: oksuz77 ($10.31 in chips) 
Seat 4: FeL.Ru ($27.83 in chips) 
Seat 5: whtocean ($10 in chips) 
Seat 6: Pokernan95 ($9.10 in chips) 
oksuz77: posts small blind $0.05
FeL.Ru: posts big blind $0.10
*** HOLE CARDS ***
whtocean: folds 
Pokernan95: folds 
AvGeL: raises $0.15 to $0.25
ildar87kzn: raises $0.65 to $0.90
oksuz77: folds 
FeL.Ru: folds 
AvGeL: calls $0.65
*** FLOP *** [Qc 6d Qh]
AvGeL: checks 
ildar87kzn: bets $1.21
AvGeL: folds 
Uncalled bet ($1.21) returned to ildar87kzn
ildar87kzn collected $1.86 from pot
ildar87kzn: doesn't show hand 
*** SUMMARY ***
Total pot $1.95 | Rake $0.09 
Board [Qc 6d Qh]
Seat 1: AvGeL folded on the Flop
Seat 2: ildar87kzn (button) collected ($1.86)
Seat 3: oksuz77 (small blind) folded before Flop
Seat 4: FeL.Ru (big blind) folded before Flop
Seat 5: whtocean folded before Flop (didn't bet)
Seat 6: Pokernan95 folded before Flop (didn't bet)



PokerStars Hand #222945568957:  Hold'em No Limit ($0.05/$0.10 USD) - 2021/01/23 0:56:27 ET
Table 'Malzovia III' 6-max Seat #3 is the button
Seat 1: AvGeL ($10 in chips) 
Seat 2: ildar87kzn ($11.16 in chips) 
Seat 3: oksuz77 ($10.26 in chips) 
Seat 4: FeL.Ru ($27.73 in chips) 
Seat 5: whtocean ($10 in chips) 
Seat 6: Pokernan95 ($10 in chips) 
FeL.Ru: posts small blind $0.05
whtocean: posts big blind $0.10
*** HOLE CARDS ***
Pokernan95: folds 
AvGeL: folds 
ildar87kzn: raises $0.20 to $0.30
oksuz77: folds 
FeL.Ru: folds 
whtocean: folds 
Uncalled bet ($0.20) returned to ildar87kzn
ildar87kzn collected $0.25 from pot
ildar87kzn: doesn't show hand 
*** SUMMARY ***
Total pot $0.25 | Rake $0 
Seat 1: AvGeL folded before Flop (didn't bet)
Seat 2: ildar87kzn collected ($0.25)
Seat 3: oksuz77 (button) folded before Flop (didn't bet)
Seat 4: FeL.Ru (small blind) folded before Flop
Seat 5: whtocean (big blind) folded before Flop
Seat 6: Pokernan95 folded before Flop (didn't bet)



PokerStars Hand #222945572508:  Hold'em No Limit ($0.05/$0.10 USD) - 2021/01/23 0:56:45 ET
Table 'Malzovia III' 6-max Seat #4 is the button
Seat 1: AvGeL ($10 in chips) 
Seat 2: ildar87kzn ($11.31 in chips) 
Seat 3: oksuz77 ($10.26 in chips) 
Seat 4: FeL.Ru ($27.68 in chips) 
Seat 5: whtocean ($10 in chips) 
Seat 6: Pokernan95 ($10 in chips) 
whtocean: posts small blind $0.05
Pokernan95: posts big blind $0.10
*** HOLE CARDS ***
AvGeL: folds 
ildar87kzn: folds 
oksuz77: folds 
FeL.Ru: folds 
whtocean: raises $0.15 to $0.25
Pokernan95: folds 
Uncalled bet ($0.15) returned to whtocean
whtocean collected $0.20 from pot
whtocean: doesn't show hand 
*** SUMMARY ***
Total pot $0.20 | Rake $0 
Seat 1: AvGeL folded before Flop (didn't bet)
Seat 2: ildar87kzn folded before Flop (didn't bet)
Seat 3: oksuz77 folded before Flop (didn't bet)
Seat 4: FeL.Ru (button) folded before Flop (didn't bet)
Seat 5: whtocean (small blind) collected ($0.20)
Seat 6: Pokernan95 (big blind) folded before Flop



PokerStars Hand #222945577479:  Hold'em No Limit ($0.05/$0.10 USD) - 2021/01/23 0:57:10 ET
Table 'Malzovia III' 6-max Seat #5 is the button
Seat 1: AvGeL ($10 in chips) 
Seat 2: ildar87kzn ($11.31 in chips) 
Seat 3: oksuz77 ($10.26 in chips) 
Seat 4: FeL.Ru ($27.68 in chips) 
Seat 5: whtocean ($10.10 in chips) 
Seat 6: Pokernan95 ($9.90 in chips) 
Pokernan95: posts small blind $0.05
AvGeL: posts big blind $0.10
*** HOLE CARDS ***
ildar87kzn: raises $0.20 to $0.30
oksuz77: folds 
FeL.Ru: calls $0.30
whtocean: folds 
Pokernan95: folds 
AvGeL: calls $0.20
*** FLOP *** [8d 8s 3c]
AvGeL: checks 
ildar87kzn: bets $0.28
FeL.Ru: calls $0.28
AvGeL: calls $0.28
*** TURN *** [8d 8s 3c] [6d]
AvGeL: checks 
ildar87kzn: checks 
FeL.Ru: checks 
*** RIVER *** [8d 8s 3c 6d] [4h]
AvGeL: bets $1.28
ildar87kzn: folds 
FeL.Ru: folds 
Uncalled bet ($1.28) returned to AvGeL
AvGeL collected $1.71 from pot
*** SUMMARY ***
Total pot $1.79 | Rake $0.08 
Board [8d 8s 3c 6d 4h]
Seat 1: AvGeL (big blind) collected ($1.71)
Seat 2: ildar87kzn folded on the River
Seat 3: oksuz77 folded before Flop (didn't bet)
Seat 4: FeL.Ru folded on the River
Seat 5: whtocean (button) folded before Flop (didn't bet)
Seat 6: Pokernan95 (small blind) folded before Flop



PokerStars Hand #222945589589:  Hold'em No Limit ($0.05/$0.10 USD) - 2021/01/23 0:58:10 ET
Table 'Malzovia III' 6-max Seat #6 is the button
Seat 1: AvGeL ($11.13 in chips) 
Seat 2: ildar87kzn ($10.73 in chips) 
Seat 3: oksuz77 ($10.26 in chips) 
Seat 4: FeL.Ru ($27.10 in chips) 
Seat 5: whtocean ($10.10 in chips) 
Seat 6: Pokernan95 ($9.85 in chips) 
AvGeL: posts small blind $0.05
ildar87kzn: posts big blind $0.10
*** HOLE CARDS ***
oksuz77: folds 
FeL.Ru: folds 
whtocean: folds 
Pokernan95: folds 
AvGeL: raises $0.15 to $0.25
ildar87kzn: calls $0.15
*** FLOP *** [3s Ts 2s]
AvGeL: checks 
ildar87kzn: bets $0.15
AvGeL: calls $0.15
*** TURN *** [3s Ts 2s] [Qs]
AvGeL: checks 
ildar87kzn: checks 
*** RIVER *** [3s Ts 2s Qs] [8s]
AvGeL: checks 
ildar87kzn: bets $10.33 and is all-in
AvGeL: folds 
Uncalled bet ($10.33) returned to ildar87kzn
ildar87kzn collected $0.76 from pot
ildar87kzn: doesn't show hand 
*** SUMMARY ***
Total pot $0.80 | Rake $0.04 
Board [3s Ts 2s Qs 8s]
Seat 1: AvGeL (small blind) folded on the River
Seat 2: ildar87kzn (big blind) collected ($0.76)
Seat 3: oksuz77 folded before Flop (didn't bet)
Seat 4: FeL.Ru folded before Flop (didn't bet)
Seat 5: whtocean folded before Flop (didn't bet)
Seat 6: Pokernan95 (button) folded before Flop (didn't bet)



PokerStars Hand #222945598789:  Hold'em No Limit ($0.05/$0.10 USD) - 2021/01/23 0:58:56 ET
Table 'Malzovia III' 6-max Seat #1 is the button
Seat 1: AvGeL ($10.73 in chips) 
Seat 2: ildar87kzn ($11.09 in chips) 
Seat 3: oksuz77 ($10.26 in chips) 
Seat 4: FeL.Ru ($27.10 in chips) 
Seat 5: whtocean ($10.10 in chips) 
Seat 6: Pokernan95 ($9.85 in chips) 
ildar87kzn: posts small blind $0.05
oksuz77: posts big blind $0.10
*** HOLE CARDS ***
FeL.Ru: raises $0.20 to $0.30
whtocean: folds 
Pokernan95: folds 
AvGeL: folds 
ildar87kzn: folds 
oksuz77: folds 
Uncalled bet ($0.20) returned to FeL.Ru
FeL.Ru collected $0.25 from pot
FeL.Ru: doesn't show hand 
*** SUMMARY ***
Total pot $0.25 | Rake $0 
Seat 1: AvGeL (button) folded before Flop (didn't bet)
Seat 2: ildar87kzn (small blind) folded before Flop
Seat 3: oksuz77 (big blind) folded before Flop
Seat 4: FeL.Ru collected ($0.25)
Seat 5: whtocean folded before Flop (didn't bet)
Seat 6: Pokernan95 folded before Flop (didn't bet)



PokerStars Hand #222945601969:  Hold'em No Limit ($0.05/$0.10 USD) - 2021/01/23 0:59:12 ET
Table 'Malzovia III' 6-max Seat #2 is the button
Seat 1: AvGeL ($10.73 in chips) 
Seat 2: ildar87kzn ($11.04 in chips) 
Seat 3: oksuz77 ($10.16 in chips) 
Seat 4: FeL.Ru ($27.25 in chips) 
Seat 5: whtocean ($10.10 in chips) 
Seat 6: Pokernan95 ($9.85 in chips) 
oksuz77: posts small blind $0.05
FeL.Ru: posts big blind $0.10
*** HOLE CARDS ***
whtocean: folds 
Pokernan95: folds 
AvGeL: folds 
ildar87kzn: raises $0.20 to $0.30
oksuz77: folds 
FeL.Ru: calls $0.20
*** FLOP *** [Qd 4d 2h]
FeL.Ru: checks 
ildar87kzn: bets $0.19
FeL.Ru: folds 
Uncalled bet ($0.19) returned to ildar87kzn
ildar87kzn collected $0.62 from pot
ildar87kzn: doesn't show hand 
*** SUMMARY ***
Total pot $0.65 | Rake $0.03 
Board [Qd 4d 2h]
Seat 1: AvGeL folded before Flop (didn't bet)
Seat 2: ildar87kzn (button) collected ($0.62)
Seat 3: oksuz77 (small blind) folded before Flop
Seat 4: FeL.Ru (big blind) folded on the Flop
Seat 5: whtocean folded before Flop (didn't bet)
Seat 6: Pokernan95 folded before Flop (didn't bet)



PokerStars Hand #222945609024:  Hold'em No Limit ($0.05/$0.10 USD) - 2021/01/23 0:59:48 ET
Table 'Malzovia III' 6-max Seat #3 is the button
Seat 1: AvGeL ($10.73 in chips) 
Seat 2: ildar87kzn ($11.36 in chips) 
Seat 3: oksuz77 ($10.11 in chips) 
Seat 4: FeL.Ru ($26.95 in chips) 
Seat 5: whtocean ($10.10 in chips) 
Seat 6: Pokernan95 ($9.85 in chips) 
FeL.Ru: posts small blind $0.05
whtocean: posts big blind $0.10
*** HOLE CARDS ***
Pokernan95: folds 
AvGeL: folds 
ildar87kzn: folds 
oksuz77: folds 
FeL.Ru: raises $0.20 to $0.30
whtocean: folds 
Uncalled bet ($0.20) returned to FeL.Ru
FeL.Ru collected $0.20 from pot
FeL.Ru: doesn't show hand 
*** SUMMARY ***
Total pot $0.20 | Rake $0 
Seat 1: AvGeL folded before Flop (didn't bet)
Seat 2: ildar87kzn folded before Flop (didn't bet)
Seat 3: oksuz77 (button) folded before Flop (didn't bet)
Seat 4: FeL.Ru (small blind) collected ($0.20)
Seat 5: whtocean (big blind) folded before Flop
Seat 6: Pokernan95 folded before Flop (didn't bet)



PokerStars Hand #222945612266:  Hold'em No Limit ($0.05/$0.10 USD) - 2021/01/23 1:00:03 ET
Table 'Malzovia III' 6-max Seat #4 is the button
Seat 1: AvGeL ($10.73 in chips) 
Seat 2: ildar87kzn ($11.36 in chips) 
Seat 3: oksuz77 ($10.11 in chips) 
Seat 4: FeL.Ru ($27.05 in chips) 
Seat 5: whtocean ($10 in chips) 
Seat 6: Pokernan95 ($9.85 in chips) 
whtocean: posts small blind $0.05
Pokernan95: posts big blind $0.10
*** HOLE CARDS ***
AvGeL: folds 
ildar87kzn: raises $0.20 to $0.30
oksuz77: folds 
FeL.Ru: folds 
whtocean: folds 
Pokernan95: folds 
Uncalled bet ($0.20) returned to ildar87kzn
ildar87kzn collected $0.25 from pot
ildar87kzn: doesn't show hand 
*** SUMMARY ***
Total pot $0.25 | Rake $0 
Seat 1: AvGeL folded before Flop (didn't bet)
Seat 2: ildar87kzn collected ($0.25)
Seat 3: oksuz77 folded before Flop (didn't bet)
Seat 4: FeL.Ru (button) folded before Flop (didn't bet)
Seat 5: whtocean (small blind) folded before Flop
Seat 6: Pokernan95 (big blind) folded before Flop



PokerStars Hand #222945617191:  Hold'em No Limit ($0.05/$0.10 USD) - 2021/01/23 1:00:25 ET
Table 'Malzovia III' 6-max Seat #5 is the button
Seat 1: AvGeL ($10.73 in chips) 
Seat 2: ildar87kzn ($11.51 in chips) 
Seat 3: oksuz77 ($10.11 in chips) 
Seat 4: FeL.Ru ($27.05 in chips) 
Seat 5: whtocean ($10 in chips) 
Seat 6: Pokernan95 ($9.75 in chips) 
Pokernan95: posts small blind $0.05
AvGeL: posts big blind $0.10
*** HOLE CARDS ***
ildar87kzn: folds 
oksuz77: folds 
FeL.Ru: folds 
whtocean: folds 
Pokernan95: folds 
Uncalled bet ($0.05) returned to AvGeL
AvGeL collected $0.10 from pot
*** SUMMARY ***
Total pot $0.10 | Rake $0 
Seat 1: AvGeL (big blind) collected ($0.10)
Seat 2: ildar87kzn folded before Flop (didn't bet)
Seat 3: oksuz77 folded before Flop (didn't bet)
Seat 4: FeL.Ru folded before Flop (didn't bet)
Seat 5: whtocean (button) folded before Flop (didn't bet)
Seat 6: Pokernan95 (small blind) folded before Flop



PokerStars Hand #222945619571:  Hold'em No Limit ($0.05/$0.10 USD) - 2021/01/23 1:00:35 ET
Table 'Malzovia III' 6-max Seat #6 is the button
Seat 1: AvGeL ($10.78 in chips) 
Seat 2: ildar87kzn ($11.51 in chips) 
Seat 3: oksuz77 ($10.11 in chips) 
Seat 4: FeL.Ru ($27.05 in chips) 
Seat 5: whtocean ($10 in chips) 
Seat 6: Pokernan95 ($9.70 in chips) 
AvGeL: posts small blind $0.05
ildar87kzn: posts big blind $0.10
*** HOLE CARDS ***
oksuz77: folds 
FeL.Ru: folds 
whtocean: folds 
Pokernan95: folds 
AvGeL: folds 
Uncalled bet ($0.05) returned to ildar87kzn
ildar87kzn collected $0.10 from pot
ildar87kzn: doesn't show hand 
*** SUMMARY ***
Total pot $0.10 | Rake $0 
Seat 1: AvGeL (small blind) folded before Flop
Seat 2: ildar87kzn (big blind) collected ($0.10)
Seat 3: oksuz77 folded before Flop (didn't bet)
Seat 4: FeL.Ru folded before Flop (didn't bet)
Seat 5: whtocean folded before Flop (didn't bet)
Seat 6: Pokernan95 (button) folded before Flop (didn't bet)



PokerStars Hand #222945622373:  Hold'em No Limit ($0.05/$0.10 USD) - 2021/01/23 1:00:47 ET
Table 'Malzovia III' 6-max Seat #1 is the button
Seat 1: AvGeL ($10.73 in chips) 
Seat 2: ildar87kzn ($11.56 in chips) 
Seat 3: oksuz77 ($10.11 in chips) 
Seat 4: FeL.Ru ($27.05 in chips) 
Seat 5: whtocean ($10 in chips) 
Seat 6: Pokernan95 ($9.70 in chips) 
ildar87kzn: posts small blind $0.05
oksuz77: posts big blind $0.10
*** HOLE CARDS ***
FeL.Ru: folds 
whtocean: folds 
Pokernan95: folds 
AvGeL: raises $0.10 to $0.20
ildar87kzn: raises $1 to $1.20
oksuz77: folds 
AvGeL: folds 
Uncalled bet ($1) returned to ildar87kzn
ildar87kzn collected $0.50 from pot
ildar87kzn: doesn't show hand 
*** SUMMARY ***
Total pot $0.50 | Rake $0 
Seat 1: AvGeL (button) folded before Flop
Seat 2: ildar87kzn (small blind) collected ($0.50)
Seat 3: oksuz77 (big blind) folded before Flop
Seat 4: FeL.Ru folded before Flop (didn't bet)
Seat 5: whtocean folded before Flop (didn't bet)
Seat 6: Pokernan95 folded before Flop (didn't bet)



PokerStars Hand #222945626635:  Hold'em No Limit ($0.05/$0.10 USD) - 2021/01/23 1:01:05 ET
Table 'Malzovia III' 6-max Seat #2 is the button
Seat 1: AvGeL ($10.53 in chips) 
Seat 2: ildar87kzn ($11.86 in chips) 
Seat 3: oksuz77 ($10.01 in chips) 
Seat 4: FeL.Ru ($27.05 in chips) 
Seat 5: whtocean ($10 in chips) 
Seat 6: Pokernan95 ($9.70 in chips) 
oksuz77: posts small blind $0.05
FeL.Ru: posts big blind $0.10
*** HOLE CARDS ***
whtocean: raises $0.20 to $0.30
Pokernan95: calls $0.30
AvGeL: folds 
ildar87kzn: folds 
oksuz77: folds 
FeL.Ru: calls $0.20
*** FLOP *** [Th 9d Qc]
FeL.Ru: checks 
whtocean: bets $0.68
Pokernan95: calls $0.68
FeL.Ru: raises $1.48 to $2.16
whtocean: folds 
Pokernan95: calls $1.48
*** TURN *** [Th 9d Qc] [Ad]
FeL.Ru: bets $2.04
Pokernan95: raises $5.20 to $7.24 and is all-in
FeL.Ru: folds 
Uncalled bet ($5.20) returned to Pokernan95
Pokernan95 collected $9.58 from pot
Pokernan95: doesn't show hand 
*** SUMMARY ***
Total pot $10.03 | Rake $0.45 
Board [Th 9d Qc Ad]
Seat 1: AvGeL folded before Flop (didn't bet)
Seat 2: ildar87kzn (button) folded before Flop (didn't bet)
Seat 3: oksuz77 (small blind) folded before Flop
Seat 4: FeL.Ru (big blind) folded on the Turn
Seat 5: whtocean folded on the Flop
Seat 6: Pokernan95 collected ($9.58)



PokerStars Hand #222945645188:  Hold'em No Limit ($0.05/$0.10 USD) - 2021/01/23 1:02:22 ET
Table 'Malzovia III' 6-max Seat #3 is the button
Seat 1: AvGeL ($10.53 in chips) 
Seat 2: ildar87kzn ($11.86 in chips) 
Seat 3: oksuz77 ($9.96 in chips) 
Seat 4: FeL.Ru ($22.55 in chips) 
Seat 5: whtocean ($10 in chips) 
Seat 6: Pokernan95 ($14.78 in chips) 
FeL.Ru: posts small blind $0.05
whtocean: posts big blind $0.10
*** HOLE CARDS ***
Pokernan95: folds 
AvGeL: folds 
ildar87kzn: folds 
oksuz77: calls $0.10
FeL.Ru: raises $0.30 to $0.40
whtocean: folds 
oksuz77: calls $0.30
*** FLOP *** [Ad Kh 9h]
FeL.Ru: bets $0.53
oksuz77: folds 
Uncalled bet ($0.53) returned to FeL.Ru
FeL.Ru collected $0.86 from pot
FeL.Ru: doesn't show hand 
*** SUMMARY ***
Total pot $0.90 | Rake $0.04 
Board [Ad Kh 9h]
Seat 1: AvGeL folded before Flop (didn't bet)
Seat 2: ildar87kzn folded before Flop (didn't bet)
Seat 3: oksuz77 (button) folded on the Flop
Seat 4: FeL.Ru (small blind) collected ($0.86)
Seat 5: whtocean (big blind) folded before Flop
Seat 6: Pokernan95 folded before Flop (didn't bet)



PokerStars Hand #222945654580:  Hold'em No Limit ($0.05/$0.10 USD) - 2021/01/23 1:03:00 ET
Table 'Malzovia III' 6-max Seat #4 is the button
Seat 1: AvGeL ($10.53 in chips) 
Seat 2: ildar87kzn ($11.86 in chips) 
Seat 3: oksuz77 ($9.56 in chips) 
Seat 4: FeL.Ru ($23.01 in chips) 
Seat 5: whtocean ($10 in chips) 
Seat 6: Pokernan95 ($14.78 in chips) 
whtocean: posts small blind $0.05
Pokernan95: posts big blind $0.10
*** HOLE CARDS ***
AvGeL: folds 
ildar87kzn: folds 
oksuz77: raises $0.10 to $0.20
FeL.Ru: raises $0.40 to $0.60
whtocean: folds 
Pokernan95: folds 
oksuz77: calls $0.40
*** FLOP *** [Jd Tc 6d]
oksuz77: bets $0.20
FeL.Ru: calls $0.20
*** TURN *** [Jd Tc 6d] [Qd]
oksuz77: bets $0.30
FeL.Ru: calls $0.30
*** RIVER *** [Jd Tc 6d Qd] [2s]
oksuz77: bets $0.50
FeL.Ru: folds 
Uncalled bet ($0.50) returned to oksuz77
oksuz77 collected $2.24 from pot
oksuz77: doesn't show hand 
*** SUMMARY ***
Total pot $2.35 | Rake $0.11 
Board [Jd Tc 6d Qd 2s]
Seat 1: AvGeL folded before Flop (didn't bet)
Seat 2: ildar87kzn folded before Flop (didn't bet)
Seat 3: oksuz77 collected ($2.24)
Seat 4: FeL.Ru (button) folded on the River
Seat 5: whtocean (small blind) folded before Flop
Seat 6: Pokernan95 (big blind) folded before Flop



PokerStars Hand #222945664666:  Hold'em No Limit ($0.05/$0.10 USD) - 2021/01/23 1:03:42 ET
Table 'Malzovia III' 6-max Seat #5 is the button
Seat 1: AvGeL ($10.53 in chips) 
Seat 2: ildar87kzn ($11.86 in chips) 
Seat 3: oksuz77 ($10.70 in chips) 
Seat 4: FeL.Ru ($21.91 in chips) 
Seat 5: whtocean ($10 in chips) 
Seat 6: Pokernan95 ($14.68 in chips) 
Pokernan95: posts small blind $0.05
AvGeL: posts big blind $0.10
*** HOLE CARDS ***
ildar87kzn: raises $0.20 to $0.30
oksuz77: folds 
FeL.Ru: folds 
whtocean: folds 
Pokernan95: folds 
AvGeL: calls $0.20
*** FLOP *** [7h 2h 6s]
AvGeL: checks 
ildar87kzn: bets $0.40
AvGeL: folds 
Uncalled bet ($0.40) returned to ildar87kzn
ildar87kzn collected $0.62 from pot
ildar87kzn: doesn't show hand 
*** SUMMARY ***
Total pot $0.65 | Rake $0.03 
Board [7h 2h 6s]
Seat 1: AvGeL (big blind) folded on the Flop
Seat 2: ildar87kzn collected ($0.62)
Seat 3: oksuz77 folded before Flop (didn't bet)
Seat 4: FeL.Ru folded before Flop (didn't bet)
Seat 5: whtocean (button) folded before Flop (didn't bet)
Seat 6: Pokernan95 (small blind) folded before Flop



PokerStars Hand #222945673645:  Hold'em No Limit ($0.05/$0.10 USD) - 2021/01/23 1:04:18 ET
Table 'Malzovia III' 6-max Seat #6 is the button
Seat 1: AvGeL ($10.23 in chips) 
Seat 2: ildar87kzn ($12.18 in chips) 
Seat 3: oksuz77 ($10.70 in chips) 
Seat 4: FeL.Ru ($21.91 in chips) 
Seat 5: whtocean ($10 in chips) 
Seat 6: Pokernan95 ($14.63 in chips) 
AvGeL: posts small blind $0.05
ildar87kzn: posts big blind $0.10
*** HOLE CARDS ***
oksuz77: folds 
FeL.Ru: raises $0.20 to $0.30
whtocean: folds 
Pokernan95: folds 
AvGeL: folds 
ildar87kzn: calls $0.20
*** FLOP *** [Jd 8c 5c]
ildar87kzn: checks 
FeL.Ru: bets $0.41
ildar87kzn: calls $0.41
*** TURN *** [Jd 8c 5c] [2h]
ildar87kzn: checks 
FeL.Ru: checks 
*** RIVER *** [Jd 8c 5c 2h] [Jc]
ildar87kzn: bets $0.71
FeL.Ru: calls $0.71
*** SHOW DOWN ***
ildar87kzn: shows [Td Ts] (two pair, Jacks and Tens)
FeL.Ru: shows [Jh Tc] (three of a kind, Jacks)
FeL.Ru collected $2.76 from pot
*** SUMMARY ***
Total pot $2.89 | Rake $0.13 
Board [Jd 8c 5c 2h Jc]
Seat 1: AvGeL (small blind) folded before Flop
Seat 2: ildar87kzn (big blind) showed [Td Ts] and lost with two pair, Jacks and Tens
Seat 3: oksuz77 folded before Flop (didn't bet)
Seat 4: FeL.Ru showed [Jh Tc] and won ($2.76) with three of a kind, Jacks
Seat 5: whtocean folded before Flop (didn't bet)
Seat 6: Pokernan95 (button) folded before Flop (didn't bet)



PokerStars Hand #222945689952:  Hold'em No Limit ($0.05/$0.10 USD) - 2021/01/23 1:05:23 ET
Table 'Malzovia III' 6-max Seat #1 is the button
Seat 1: AvGeL ($10.18 in chips) 
Seat 2: ildar87kzn ($10.76 in chips) 
Seat 3: oksuz77 ($10.70 in chips) 
Seat 4: FeL.Ru ($23.25 in chips) 
Seat 5: whtocean ($10 in chips) 
Seat 6: Pokernan95 ($14.63 in chips) 
ildar87kzn: posts small blind $0.05
oksuz77: posts big blind $0.10
*** HOLE CARDS ***
FeL.Ru: folds 
whtocean: raises $0.20 to $0.30
Pokernan95: folds 
AvGeL: folds 
ildar87kzn: folds 
oksuz77: folds 
Uncalled bet ($0.20) returned to whtocean
whtocean collected $0.25 from pot
whtocean: doesn't show hand 
*** SUMMARY ***
Total pot $0.25 | Rake $0 
Seat 1: AvGeL (button) folded before Flop (didn't bet)
Seat 2: ildar87kzn (small blind) folded before Flop
Seat 3: oksuz77 (big blind) folded before Flop
Seat 4: FeL.Ru folded before Flop (didn't bet)
Seat 5: whtocean collected ($0.25)
Seat 6: Pokernan95 folded before Flop (didn't bet)



PokerStars Hand #222945692710:  Hold'em No Limit ($0.05/$0.10 USD) - 2021/01/23 1:05:34 ET
Table 'Malzovia III' 6-max Seat #2 is the button
Seat 1: AvGeL ($10.18 in chips) 
Seat 2: ildar87kzn ($10.71 in chips) 
Seat 3: oksuz77 ($10.60 in chips) 
Seat 4: FeL.Ru ($23.25 in chips) 
Seat 5: whtocean ($10.15 in chips) 
Seat 6: Pokernan95 ($14.63 in chips) 
oksuz77: posts small blind $0.05
FeL.Ru: posts big blind $0.10
*** HOLE CARDS ***
whtocean: raises $0.20 to $0.30
Pokernan95: raises $0.60 to $0.90
AvGeL: folds 
ildar87kzn: folds 
oksuz77: folds 
FeL.Ru: folds 
whtocean: folds 
Uncalled bet ($0.60) returned to Pokernan95
Pokernan95 collected $0.75 from pot
Pokernan95: doesn't show hand 
*** SUMMARY ***
Total pot $0.75 | Rake $0 
Seat 1: AvGeL folded before Flop (didn't bet)
Seat 2: ildar87kzn (button) folded before Flop (didn't bet)
Seat 3: oksuz77 (small blind) folded before Flop
Seat 4: FeL.Ru (big blind) folded before Flop
Seat 5: whtocean folded before Flop
Seat 6: Pokernan95 collected ($0.75)



PokerStars Hand #222945697871:  Hold'em No Limit ($0.05/$0.10 USD) - 2021/01/23 1:05:54 ET
Table 'Malzovia III' 6-max Seat #3 is the button
Seat 1: AvGeL ($10.18 in chips) 
Seat 2: ildar87kzn ($10.71 in chips) 
Seat 3: oksuz77 ($10.55 in chips) 
Seat 4: FeL.Ru ($23.15 in chips) 
Seat 5: whtocean ($10 in chips) 
Seat 6: Pokernan95 ($15.08 in chips) 
FeL.Ru: posts small blind $0.05
whtocean: posts big blind $0.10
*** HOLE CARDS ***
Pokernan95: folds 
AvGeL: folds 
ildar87kzn: folds 
oksuz77: folds 
FeL.Ru: raises $0.20 to $0.30
whtocean: calls $0.20
*** FLOP *** [Th Kd 8s]
FeL.Ru: bets $0.38
whtocean: folds 
Uncalled bet ($0.38) returned to FeL.Ru
FeL.Ru collected $0.57 from pot
FeL.Ru: doesn't show hand 
*** SUMMARY ***
Total pot $0.60 | Rake $0.03 
Board [Th Kd 8s]
Seat 1: AvGeL folded before Flop (didn't bet)
Seat 2: ildar87kzn folded before Flop (didn't bet)
Seat 3: oksuz77 (button) folded before Flop (didn't bet)
Seat 4: FeL.Ru (small blind) collected ($0.57)
Seat 5: whtocean (big blind) folded on the Flop
Seat 6: Pokernan95 folded before Flop (didn't bet)



PokerStars Hand #222945703414:  Hold'em No Limit ($0.05/$0.10 USD) - 2021/01/23 1:06:16 ET
Table 'Malzovia III' 6-max Seat #4 is the button
Seat 1: AvGeL ($10.18 in chips) 
Seat 2: ildar87kzn ($10.71 in chips) 
Seat 3: oksuz77 ($10.55 in chips) 
Seat 4: FeL.Ru ($23.42 in chips) 
Seat 5: whtocean ($10 in chips) 
Seat 6: Pokernan95 ($15.08 in chips) 
whtocean: posts small blind $0.05
Pokernan95: posts big blind $0.10
*** HOLE CARDS ***
AvGeL: folds 
ildar87kzn: folds 
oksuz77: folds 
FeL.Ru: raises $0.20 to $0.30
whtocean: folds 
Pokernan95: folds 
Uncalled bet ($0.20) returned to FeL.Ru
FeL.Ru collected $0.25 from pot
FeL.Ru: doesn't show hand 
*** SUMMARY ***
Total pot $0.25 | Rake $0 
Seat 1: AvGeL folded before Flop (didn't bet)
Seat 2: ildar87kzn folded before Flop (didn't bet)
Seat 3: oksuz77 folded before Flop (didn't bet)
Seat 4: FeL.Ru (button) collected ($0.25)
Seat 5: whtocean (small blind) folded before Flop
Seat 6: Pokernan95 (big blind) folded before Flop



PokerStars Hand #222945705863:  Hold'em No Limit ($0.05/$0.10 USD) - 2021/01/23 1:06:26 ET
Table 'Malzovia III' 6-max Seat #5 is the button
Seat 1: AvGeL ($10.18 in chips) 
Seat 2: ildar87kzn ($10.71 in chips) 
Seat 3: oksuz77 ($10.55 in chips) 
Seat 4: FeL.Ru ($23.57 in chips) 
Seat 5: whtocean ($10 in chips) 
Seat 6: Pokernan95 ($14.98 in chips) 
Pokernan95: posts small blind $0.05
AvGeL: posts big blind $0.10
*** HOLE CARDS ***
ildar87kzn: folds 
oksuz77: folds 
FeL.Ru: folds 
whtocean: folds 
Pokernan95: folds 
Uncalled bet ($0.05) returned to AvGeL
AvGeL collected $0.10 from pot
*** SUMMARY ***
Total pot $0.10 | Rake $0 
Seat 1: AvGeL (big blind) collected ($0.10)
Seat 2: ildar87kzn folded before Flop (didn't bet)
Seat 3: oksuz77 folded before Flop (didn't bet)
Seat 4: FeL.Ru folded before Flop (didn't bet)
Seat 5: whtocean (button) folded before Flop (didn't bet)
Seat 6: Pokernan95 (small blind) folded before Flop



PokerStars Hand #222945708860:  Hold'em No Limit ($0.05/$0.10 USD) - 2021/01/23 1:06:38 ET
Table 'Malzovia III' 6-max Seat #6 is the button
Seat 1: AvGeL ($10.23 in chips) 
Seat 2: ildar87kzn ($10.71 in chips) 
Seat 3: oksuz77 ($10.55 in chips) 
Seat 4: FeL.Ru ($23.57 in chips) 
Seat 5: whtocean ($10 in chips) 
Seat 6: Pokernan95 ($14.93 in chips) 
AvGeL: posts small blind $0.05
ildar87kzn: posts big blind $0.10
*** HOLE CARDS ***
oksuz77: folds 
FeL.Ru: folds 
whtocean: raises $0.15 to $0.25
Pokernan95: raises $0.45 to $0.70
AvGeL: folds 
ildar87kzn: folds 
whtocean: raises $1.55 to $2.25
Pokernan95: folds 
Uncalled bet ($1.55) returned to whtocean
whtocean collected $1.55 from pot
whtocean: doesn't show hand 
*** SUMMARY ***
Total pot $1.55 | Rake $0 
Seat 1: AvGeL (small blind) folded before Flop
Seat 2: ildar87kzn (big blind) folded before Flop
Seat 3: oksuz77 folded before Flop (didn't bet)
Seat 4: FeL.Ru folded before Flop (didn't bet)
Seat 5: whtocean collected ($1.55)
Seat 6: Pokernan95 (button) folded before Flop



PokerStars Hand #222945713201:  Hold'em No Limit ($0.05/$0.10 USD) - 2021/01/23 1:06:55 ET
Table 'Malzovia III' 6-max Seat #1 is the button
Seat 1: AvGeL ($10.18 in chips) 
Seat 2: ildar87kzn ($10.61 in chips) 
Seat 3: oksuz77 ($10.55 in chips) 
Seat 4: FeL.Ru ($23.57 in chips) 
Seat 5: whtocean ($10.85 in chips) 
Seat 6: Pokernan95 ($14.23 in chips) 
ildar87kzn: posts small blind $0.05
oksuz77: posts big blind $0.10
*** HOLE CARDS ***
FeL.Ru: folds 
whtocean: raises $0.20 to $0.30
Pokernan95: folds 
AvGeL: folds 
ildar87kzn: folds 
oksuz77: folds 
Uncalled bet ($0.20) returned to whtocean
whtocean collected $0.25 from pot
whtocean: doesn't show hand 
*** SUMMARY ***
Total pot $0.25 | Rake $0 
Seat 1: AvGeL (button) folded before Flop (didn't bet)
Seat 2: ildar87kzn (small blind) folded before Flop
Seat 3: oksuz77 (big blind) folded before Flop
Seat 4: FeL.Ru folded before Flop (didn't bet)
Seat 5: whtocean collected ($0.25)
Seat 6: Pokernan95 folded before Flop (didn't bet)



PokerStars Hand #222945719634:  Hold'em No Limit ($0.05/$0.10 USD) - 2021/01/23 1:07:21 ET
Table 'Malzovia III' 6-max Seat #2 is the button
Seat 1: AvGeL ($10.18 in chips) 
Seat 2: ildar87kzn ($10.56 in chips) 
Seat 3: oksuz77 ($10.45 in chips) 
Seat 4: FeL.Ru ($23.57 in chips) 
Seat 5: whtocean ($11 in chips) 
Seat 6: Pokernan95 ($14.23 in chips) 
oksuz77: posts small blind $0.05
FeL.Ru: posts big blind $0.10
*** HOLE CARDS ***
whtocean: folds 
Pokernan95: folds 
AvGeL: folds 
ildar87kzn: raises $0.20 to $0.30
oksuz77: folds 
FeL.Ru: folds 
Uncalled bet ($0.20) returned to ildar87kzn
ildar87kzn collected $0.25 from pot
ildar87kzn: doesn't show hand 
*** SUMMARY ***
Total pot $0.25 | Rake $0 
Seat 1: AvGeL folded before Flop (didn't bet)
Seat 2: ildar87kzn (button) collected ($0.25)
Seat 3: oksuz77 (small blind) folded before Flop
Seat 4: FeL.Ru (big blind) folded before Flop
Seat 5: whtocean folded before Flop (didn't bet)
Seat 6: Pokernan95 folded before Flop (didn't bet)



PokerStars Hand #222945723673:  Hold'em No Limit ($0.05/$0.10 USD) - 2021/01/23 1:07:37 ET
Table 'Malzovia III' 6-max Seat #3 is the button
Seat 1: AvGeL ($10.18 in chips) 
Seat 2: ildar87kzn ($10.71 in chips) 
Seat 3: oksuz77 ($10.40 in chips) 
Seat 4: FeL.Ru ($23.47 in chips) 
Seat 5: whtocean ($11 in chips) 
Seat 6: Pokernan95 ($14.23 in chips) 
FeL.Ru: posts small blind $0.05
whtocean: posts big blind $0.10
*** HOLE CARDS ***
Pokernan95: folds 
AvGeL: folds 
ildar87kzn: folds 
oksuz77: folds 
FeL.Ru: raises $0.20 to $0.30
whtocean: calls $0.20
*** FLOP *** [8h 4s Qs]
FeL.Ru: checks 
whtocean: bets $0.37
FeL.Ru: folds 
Uncalled bet ($0.37) returned to whtocean
whtocean collected $0.57 from pot
whtocean: doesn't show hand 
*** SUMMARY ***
Total pot $0.60 | Rake $0.03 
Board [8h 4s Qs]
Seat 1: AvGeL folded before Flop (didn't bet)
Seat 2: ildar87kzn folded before Flop (didn't bet)
Seat 3: oksuz77 (button) folded before Flop (didn't bet)
Seat 4: FeL.Ru (small blind) folded on the Flop
Seat 5: whtocean (big blind) collected ($0.57)
Seat 6: Pokernan95 folded before Flop (didn't bet)



PokerStars Hand #222945730738:  Hold'em No Limit ($0.05/$0.10 USD) - 2021/01/23 1:08:05 ET
Table 'Malzovia III' 6-max Seat #4 is the button
Seat 1: AvGeL ($10.18 in chips) 
Seat 2: ildar87kzn ($10.71 in chips) 
Seat 3: oksuz77 ($10.40 in chips) 
Seat 4: FeL.Ru ($23.17 in chips) 
Seat 5: whtocean ($11.27 in chips) 
Seat 6: Pokernan95 ($14.23 in chips) 
whtocean: posts small blind $0.05
Pokernan95: posts big blind $0.10
*** HOLE CARDS ***
AvGeL: raises $0.20 to $0.30
ildar87kzn: folds 
oksuz77: folds 
FeL.Ru: folds 
whtocean: folds 
Pokernan95: folds 
Uncalled bet ($0.20) returned to AvGeL
AvGeL collected $0.25 from pot
*** SUMMARY ***
Total pot $0.25 | Rake $0 
Seat 1: AvGeL collected ($0.25)
Seat 2: ildar87kzn folded before Flop (didn't bet)
Seat 3: oksuz77 folded before Flop (didn't bet)
Seat 4: FeL.Ru (button) folded before Flop (didn't bet)
Seat 5: whtocean (small blind) folded before Flop
Seat 6: Pokernan95 (big blind) folded before Flop



PokerStars Hand #222945734087:  Hold'em No Limit ($0.05/$0.10 USD) - 2021/01/23 1:08:19 ET
Table 'Malzovia III' 6-max Seat #5 is the button
Seat 1: AvGeL ($10.33 in chips) 
Seat 2: ildar87kzn ($10.71 in chips) 
Seat 3: oksuz77 ($10.40 in chips) 
Seat 4: FeL.Ru ($23.17 in chips) 
Seat 5: whtocean ($11.22 in chips) 
Seat 6: Pokernan95 ($14.13 in chips) 
Pokernan95: posts small blind $0.05
AvGeL: posts big blind $0.10
*** HOLE CARDS ***
ildar87kzn: folds 
oksuz77: folds 
FeL.Ru: raises $0.20 to $0.30
whtocean: folds 
Pokernan95: folds 
AvGeL: folds 
Uncalled bet ($0.20) returned to FeL.Ru
FeL.Ru collected $0.25 from pot
FeL.Ru: doesn't show hand 
*** SUMMARY ***
Total pot $0.25 | Rake $0 
Seat 1: AvGeL (big blind) folded before Flop
Seat 2: ildar87kzn folded before Flop (didn't bet)
Seat 3: oksuz77 folded before Flop (didn't bet)
Seat 4: FeL.Ru collected ($0.25)
Seat 5: whtocean (button) folded before Flop (didn't bet)
Seat 6: Pokernan95 (small blind) folded before Flop



PokerStars Hand #222945738712:  Hold'em No Limit ($0.05/$0.10 USD) - 2021/01/23 1:08:37 ET
Table 'Malzovia III' 6-max Seat #6 is the button
Seat 1: AvGeL ($10.23 in chips) 
Seat 2: ildar87kzn ($10.71 in chips) 
Seat 3: oksuz77 ($10.40 in chips) 
Seat 4: FeL.Ru ($23.32 in chips) 
Seat 5: whtocean ($11.22 in chips) 
Seat 6: Pokernan95 ($14.08 in chips) 
AvGeL: posts small blind $0.05
ildar87kzn: posts big blind $0.10
*** HOLE CARDS ***
oksuz77: calls $0.10
FeL.Ru: folds 
whtocean: raises $0.25 to $0.35
Pokernan95: folds 
AvGeL: folds 
ildar87kzn: folds 
oksuz77: calls $0.25
*** FLOP *** [Jc 5s 2c]
oksuz77: bets $0.10
whtocean: raises $0.54 to $0.64
oksuz77: calls $0.54
*** TURN *** [Jc 5s 2c] [Ts]
oksuz77: bets $0.20
whtocean: calls $0.20
*** RIVER *** [Jc 5s 2c Ts] [Ah]
oksuz77: bets $0.20
whtocean: calls $0.20
*** SHOW DOWN ***
oksuz77: shows [Tc Kc] (a pair of Tens)
whtocean: mucks hand 
oksuz77 collected $2.80 from pot
*** SUMMARY ***
Total pot $2.93 | Rake $0.13 
Board [Jc 5s 2c Ts Ah]
Seat 1: AvGeL (small blind) folded before Flop
Seat 2: ildar87kzn (big blind) folded before Flop
Seat 3: oksuz77 showed [Tc Kc] and won ($2.80) with a pair of Tens
Seat 4: FeL.Ru folded before Flop (didn't bet)
Seat 5: whtocean mucked
Seat 6: Pokernan95 (button) folded before Flop (didn't bet)



PokerStars Hand #222945747623:  Hold'em No Limit ($0.05/$0.10 USD) - 2021/01/23 1:09:13 ET
Table 'Malzovia III' 6-max Seat #1 is the button
Seat 1: AvGeL ($10.18 in chips) 
Seat 2: ildar87kzn ($10.61 in chips) 
Seat 3: oksuz77 ($11.81 in chips) 
Seat 4: FeL.Ru ($23.32 in chips) 
Seat 5: whtocean ($10 in chips) 
Seat 6: Pokernan95 ($14.08 in chips) 
ildar87kzn: posts small blind $0.05
oksuz77: posts big blind $0.10
*** HOLE CARDS ***
FeL.Ru: raises $0.20 to $0.30
whtocean: folds 
Pokernan95: folds 
AvGeL: folds 
ildar87kzn: raises $0.90 to $1.20
oksuz77: folds 
FeL.Ru: folds 
Uncalled bet ($0.90) returned to ildar87kzn
ildar87kzn collected $0.70 from pot
ildar87kzn: doesn't show hand 
*** SUMMARY ***
Total pot $0.70 | Rake $0 
Seat 1: AvGeL (button) folded before Flop (didn't bet)
Seat 2: ildar87kzn (small blind) collected ($0.70)
Seat 3: oksuz77 (big blind) folded before Flop
Seat 4: FeL.Ru folded before Flop
Seat 5: whtocean folded before Flop (didn't bet)
Seat 6: Pokernan95 folded before Flop (didn't bet)



PokerStars Hand #222945753724:  Hold'em No Limit ($0.05/$0.10 USD) - 2021/01/23 1:09:38 ET
Table 'Malzovia III' 6-max Seat #2 is the button
Seat 1: AvGeL ($10.18 in chips) 
Seat 2: ildar87kzn ($11.01 in chips) 
Seat 3: oksuz77 ($11.71 in chips) 
Seat 5: whtocean ($10 in chips) 
Seat 6: Pokernan95 ($14.08 in chips) 
oksuz77: posts small blind $0.05
FeL.Ru: is sitting out 
whtocean: posts big blind $0.10
*** HOLE CARDS ***
Pokernan95: folds 
AvGeL: folds 
ildar87kzn: raises $0.10 to $0.20
oksuz77: folds 
whtocean: calls $0.10
*** FLOP *** [5h 8h 7c]
whtocean: checks 
ildar87kzn: bets $0.13
whtocean: raises $0.37 to $0.50
FeL.Ru leaves the table
ildar87kzn: folds 
Uncalled bet ($0.37) returned to whtocean
whtocean collected $0.68 from pot
whtocean: doesn't show hand 
*** SUMMARY ***
Total pot $0.71 | Rake $0.03 
Board [5h 8h 7c]
Seat 1: AvGeL folded before Flop (didn't bet)
Seat 2: ildar87kzn (button) folded on the Flop
Seat 3: oksuz77 (small blind) folded before Flop
Seat 5: whtocean (big blind) collected ($0.68)
Seat 6: Pokernan95 folded before Flop (didn't bet)



PokerStars Hand #222945762540:  Hold'em No Limit ($0.05/$0.10 USD) - 2021/01/23 1:10:14 ET
Table 'Malzovia III' 6-max Seat #3 is the button
Seat 1: AvGeL ($10.18 in chips) 
Seat 2: ildar87kzn ($10.68 in chips) 
Seat 3: oksuz77 ($11.66 in chips) 
Seat 5: whtocean ($10.35 in chips) 
Seat 6: Pokernan95 ($14.08 in chips) 
whtocean: posts small blind $0.05
Pokernan95: posts big blind $0.10
*** HOLE CARDS ***
AvGeL: folds 
ildar87kzn: raises $0.20 to $0.30
oksuz77: calls $0.30
whtocean: folds 
Pokernan95: folds 
*** FLOP *** [Kd 9s Jd]
ildar87kzn: checks 
oksuz77: bets $0.20
ildar87kzn: raises $1.12 to $1.32
oksuz77: calls $1.12
*** TURN *** [Kd 9s Jd] [4s]
ildar87kzn: checks 
oksuz77: bets $0.30
ildar87kzn: raises $3.84 to $4.14
oksuz77: folds 
Uncalled bet ($3.84) returned to ildar87kzn
ildar87kzn collected $3.81 from pot
ildar87kzn: doesn't show hand 
*** SUMMARY ***
Total pot $3.99 | Rake $0.18 
Board [Kd 9s Jd 4s]
Seat 1: AvGeL folded before Flop (didn't bet)
Seat 2: ildar87kzn collected ($3.81)
Seat 3: oksuz77 (button) folded on the Turn
Seat 5: whtocean (small blind) folded before Flop
Seat 6: Pokernan95 (big blind) folded before Flop



PokerStars Hand #222945787496:  Hold'em No Limit ($0.05/$0.10 USD) - 2021/01/23 1:11:14 ET
Table 'Malzovia III' 6-max Seat #5 is the button
Seat 1: AvGeL ($10.18 in chips) 
Seat 2: ildar87kzn ($12.57 in chips) 
Seat 3: oksuz77 ($9.74 in chips) 
Seat 5: whtocean ($10.30 in chips) 
Seat 6: Pokernan95 ($13.98 in chips) 
Pokernan95: posts small blind $0.05
AvGeL: posts big blind $0.10
*** HOLE CARDS ***
ildar87kzn: folds 
oksuz77: folds 
whtocean: folds 
Pokernan95: folds 
Uncalled bet ($0.05) returned to AvGeL
AvGeL collected $0.10 from pot
*** SUMMARY ***
Total pot $0.10 | Rake $0 
Seat 1: AvGeL (big blind) collected ($0.10)
Seat 2: ildar87kzn folded before Flop (didn't bet)
Seat 3: oksuz77 folded before Flop (didn't bet)
Seat 5: whtocean (button) folded before Flop (didn't bet)
Seat 6: Pokernan95 (small blind) folded before Flop



PokerStars Hand #222945792156:  Hold'em No Limit ($0.05/$0.10 USD) - 2021/01/23 1:11:32 ET
Table 'Malzovia III' 6-max Seat #6 is the button
Seat 1: AvGeL ($10.23 in chips) 
Seat 3: oksuz77 ($9.74 in chips) 
Seat 5: whtocean ($10.30 in chips) 
Seat 6: Pokernan95 ($13.93 in chips) 
AvGeL: posts small blind $0.05
ildar87kzn: is sitting out 
oksuz77: posts big blind $0.10
*** HOLE CARDS ***
whtocean: folds 
Pokernan95: folds 
AvGeL: folds 
Uncalled bet ($0.05) returned to oksuz77
oksuz77 collected $0.10 from pot
oksuz77: doesn't show hand 
*** SUMMARY ***
Total pot $0.10 | Rake $0 
Seat 1: AvGeL (small blind) folded before Flop
Seat 3: oksuz77 (big blind) collected ($0.10)
Seat 5: whtocean folded before Flop (didn't bet)
Seat 6: Pokernan95 (button) folded before Flop (didn't bet)



PokerStars Hand #222945793830:  Hold'em No Limit ($0.05/$0.10 USD) - 2021/01/23 1:11:39 ET
Table 'Malzovia III' 6-max Seat #1 is the button
Seat 1: AvGeL ($10.18 in chips) 
Seat 3: oksuz77 ($9.79 in chips) 
Seat 5: whtocean ($10.30 in chips) 
Seat 6: Pokernan95 ($13.93 in chips) 
oksuz77: posts small blind $0.05
whtocean: posts big blind $0.10
*** HOLE CARDS ***
Pokernan95: folds 
AvGeL: raises $0.10 to $0.20
oksuz77: folds 
whtocean: calls $0.10
*** FLOP *** [2d 8c 6s]
whtocean: checks 
AvGeL: bets $0.32
whtocean: raises $0.57 to $0.89
AvGeL: folds 
Uncalled bet ($0.57) returned to whtocean
whtocean collected $1.04 from pot
whtocean: doesn't show hand 
*** SUMMARY ***
Total pot $1.09 | Rake $0.05 
Board [2d 8c 6s]
Seat 1: AvGeL (button) folded on the Flop
Seat 3: oksuz77 (small blind) folded before Flop
Seat 5: whtocean (big blind) collected ($1.04)
Seat 6: Pokernan95 folded before Flop (didn't bet)



PokerStars Hand #222945800951:  Hold'em No Limit ($0.05/$0.10 USD) - 2021/01/23 1:12:08 ET
Table 'Malzovia III' 6-max Seat #3 is the button
Seat 1: AvGeL ($10 in chips) 
Seat 3: oksuz77 ($9.74 in chips) 
Seat 5: whtocean ($10.82 in chips) 
Seat 6: Pokernan95 ($13.93 in chips) 
whtocean: posts small blind $0.05
Pokernan95: posts big blind $0.10
*** HOLE CARDS ***
AvGeL: raises $0.20 to $0.30
oksuz77: folds 
whtocean: folds 
Pokernan95: folds 
Uncalled bet ($0.20) returned to AvGeL
AvGeL collected $0.25 from pot
*** SUMMARY ***
Total pot $0.25 | Rake $0 
Seat 1: AvGeL collected ($0.25)
Seat 3: oksuz77 (button) folded before Flop (didn't bet)
Seat 5: whtocean (small blind) folded before Flop
Seat 6: Pokernan95 (big blind) folded before Flop



PokerStars Hand #222945802684:  Hold'em No Limit ($0.05/$0.10 USD) - 2021/01/23 1:12:15 ET
Table 'Malzovia III' 6-max Seat #5 is the button
Seat 1: AvGeL ($10.15 in chips) 
Seat 3: oksuz77 ($9.74 in chips) 
Seat 5: whtocean ($10.77 in chips) 
Seat 6: Pokernan95 ($13.83 in chips) 
Pokernan95: posts small blind $0.05
AvGeL: posts big blind $0.10
*** HOLE CARDS ***
oksuz77: calls $0.10
whtocean: raises $0.30 to $0.40
Pokernan95: calls $0.35
AvGeL: folds 
oksuz77: calls $0.30
*** FLOP *** [2c Ah 8h]
Pokernan95: checks 
oksuz77: checks 
whtocean: bets $0.66
Pokernan95: raises $0.94 to $1.60
oksuz77: folds 
whtocean: folds 
Uncalled bet ($0.94) returned to Pokernan95
Pokernan95 collected $2.50 from pot
Pokernan95: doesn't show hand 
*** SUMMARY ***
Total pot $2.62 | Rake $0.12 
Board [2c Ah 8h]
Seat 1: AvGeL (big blind) folded before Flop
Seat 3: oksuz77 folded on the Flop
Seat 5: whtocean (button) folded on the Flop
Seat 6: Pokernan95 (small blind) collected ($2.50)



PokerStars Hand #222945809325:  Hold'em No Limit ($0.05/$0.10 USD) - 2021/01/23 1:12:42 ET
Table 'Malzovia III' 6-max Seat #6 is the button
Seat 1: AvGeL ($10.05 in chips) 
Seat 3: oksuz77 ($9.34 in chips) 
Seat 5: whtocean ($10 in chips) 
Seat 6: Pokernan95 ($15.27 in chips) 
AvGeL: posts small blind $0.05
oksuz77: posts big blind $0.10
*** HOLE CARDS ***
whtocean: folds 
Pokernan95: folds 
AvGeL: raises $0.20 to $0.30
oksuz77: calls $0.20
*** FLOP *** [4c 8h 5d]
AvGeL: bets $0.43
oksuz77: folds 
Uncalled bet ($0.43) returned to AvGeL
AvGeL collected $0.57 from pot
*** SUMMARY ***
Total pot $0.60 | Rake $0.03 
Board [4c 8h 5d]
Seat 1: AvGeL (small blind) collected ($0.57)
Seat 3: oksuz77 (big blind) folded on the Flop
Seat 5: whtocean folded before Flop (didn't bet)
Seat 6: Pokernan95 (button) folded before Flop (didn't bet)



PokerStars Hand #222945812895:  Hold'em No Limit ($0.05/$0.10 USD) - 2021/01/23 1:12:57 ET
Table 'Malzovia III' 6-max Seat #1 is the button
Seat 1: AvGeL ($10.32 in chips) 
Seat 3: oksuz77 ($9.04 in chips) 
Seat 6: Pokernan95 ($15.27 in chips) 
oksuz77: posts small blind $0.05
whtocean: is sitting out 
whtocean leaves the table
Pokernan95: posts big blind $0.10
*** HOLE CARDS ***
AvGeL: folds 
oksuz77: folds 
Uncalled bet ($0.05) returned to Pokernan95
Pokernan95 collected $0.10 from pot
Pokernan95: doesn't show hand 
*** SUMMARY ***
Total pot $0.10 | Rake $0 
Seat 1: AvGeL (button) folded before Flop (didn't bet)
Seat 3: oksuz77 (small blind) folded before Flop
Seat 6: Pokernan95 (big blind) collected ($0.10)



PokerStars Hand #222945814403:  Hold'em No Limit ($0.05/$0.10 USD) - 2021/01/23 1:13:03 ET
Table 'Malzovia III' 6-max Seat #6 is the button
Seat 3: oksuz77 ($8.99 in chips) 
Seat 6: Pokernan95 ($15.32 in chips) 
Pokernan95: posts small blind $0.05
AvGeL: is sitting out 
oksuz77: posts big blind $0.10
*** HOLE CARDS ***
Pokernan95: folds 
Uncalled bet ($0.05) returned to oksuz77
oksuz77 collected $0.10 from pot
oksuz77: doesn't show hand 
*** SUMMARY ***
Total pot $0.10 | Rake $0 
Seat 3: oksuz77 (big blind) collected ($0.10)
Seat 6: Pokernan95 (button) (small blind) folded before Flop



PokerStars Hand #222945815406:  Hold'em No Limit ($0.05/$0.10 USD) - 2021/01/23 1:13:07 ET
Table 'Malzovia III' 6-max Seat #3 is the button
Seat 3: oksuz77 ($9.04 in chips) 
Seat 6: Pokernan95 ($15.27 in chips) 
oksuz77: posts small blind $0.05
Pokernan95: posts big blind $0.10
*** HOLE CARDS ***
oksuz77: folds 
Uncalled bet ($0.05) returned to Pokernan95
Pokernan95 collected $0.10 from pot
Pokernan95: doesn't show hand 
*** SUMMARY ***
Total pot $0.10 | Rake $0 
Seat 3: oksuz77 (button) (small blind) folded before Flop
Seat 6: Pokernan95 (big blind) collected ($0.10)



PokerStars Hand #222945816579:  Hold'em No Limit ($0.05/$0.10 USD) - 2021/01/23 1:13:12 ET
Table 'Malzovia III' 6-max Seat #6 is the button
Seat 3: oksuz77 ($8.99 in chips) 
Seat 6: Pokernan95 ($15.32 in chips) 
Pokernan95: posts small blind $0.05
oksuz77: posts big blind $0.10
*** HOLE CARDS ***
Pokernan95: raises $0.20 to $0.30
oksuz77: folds 
Uncalled bet ($0.20) returned to Pokernan95
Pokernan95 collected $0.20 from pot
Pokernan95: doesn't show hand 
*** SUMMARY ***
Total pot $0.20 | Rake $0 
Seat 3: oksuz77 (big blind) folded before Flop
Seat 6: Pokernan95 (button) (small blind) collected ($0.20)



PokerStars Hand #222945818682:  Hold'em No Limit ($0.05/$0.10 USD) - 2021/01/23 1:13:20 ET
Table 'Malzovia III' 6-max Seat #3 is the button
Seat 1: AvGeL ($10.32 in chips) 
Seat 3: oksuz77 ($8.89 in chips) 
Seat 6: Pokernan95 ($15.42 in chips) 
Pokernan95: posts small blind $0.05
AvGeL: posts big blind $0.10
*** HOLE CARDS ***
oksuz77: calls $0.10
Pokernan95: folds 
AvGeL: checks 
*** FLOP *** [9d 2d 6c]
AvGeL: checks 
oksuz77: checks 
*** TURN *** [9d 2d 6c] [5s]
AvGeL: bets $0.18
oksuz77: folds 
Uncalled bet ($0.18) returned to AvGeL
AvGeL collected $0.24 from pot
*** SUMMARY ***
Total pot $0.25 | Rake $0.01 
Board [9d 2d 6c 5s]
Seat 1: AvGeL (big blind) collected ($0.24)
Seat 3: oksuz77 (button) folded on the Turn
Seat 6: Pokernan95 (small blind) folded before Flop



PokerStars Hand #222945821649:  Hold'em No Limit ($0.05/$0.10 USD) - 2021/01/23 1:13:32 ET
Table 'Malzovia III' 6-max Seat #6 is the button
Seat 1: AvGeL ($10.46 in chips) 
Seat 3: oksuz77 ($8.79 in chips) 
Seat 6: Pokernan95 ($15.37 in chips) 
AvGeL: posts small blind $0.05
oksuz77: posts big blind $0.10
*** HOLE CARDS ***
Pokernan95: folds 
AvGeL: folds 
Uncalled bet ($0.05) returned to oksuz77
oksuz77 collected $0.10 from pot
oksuz77: doesn't show hand 
*** SUMMARY ***
Total pot $0.10 | Rake $0 
Seat 1: AvGeL (small blind) folded before Flop
Seat 3: oksuz77 (big blind) collected ($0.10)
Seat 6: Pokernan95 (button) folded before Flop (didn't bet)



PokerStars Hand #222945822889:  Hold'em No Limit ($0.05/$0.10 USD) - 2021/01/23 1:13:37 ET
Table 'Malzovia III' 6-max Seat #1 is the button
Seat 1: AvGeL ($10.41 in chips) 
Seat 3: oksuz77 ($8.84 in chips) 
Seat 6: Pokernan95 ($15.37 in chips) 
oksuz77: posts small blind $0.05
Pokernan95: posts big blind $0.10
*** HOLE CARDS ***
AvGeL: raises $0.10 to $0.20
oksuz77: folds 
Pokernan95: folds 
Uncalled bet ($0.10) returned to AvGeL
Pokernan95 leaves the table
AvGeL collected $0.25 from pot
*** SUMMARY ***
Total pot $0.25 | Rake $0 
Seat 1: AvGeL (button) collected ($0.25)
Seat 3: oksuz77 (small blind) folded before Flop
Seat 6: Pokernan95 (big blind) folded before Flop



PokerStars Hand #222945825147:  Hold'em No Limit ($0.05/$0.10 USD) - 2021/01/23 1:13:47 ET
Table 'Malzovia III' 6-max Seat #3 is the button
Seat 1: AvGeL ($10.56 in chips) 
Seat 3: oksuz77 ($8.79 in chips) 
oksuz77: posts small blind $0.05
AvGeL: posts big blind $0.10
*** HOLE CARDS ***
oksuz77: folds 
Uncalled bet ($0.05) returned to AvGeL
AvGeL collected $0.10 from pot
*** SUMMARY ***
Total pot $0.10 | Rake $0 
Seat 1: AvGeL (big blind) collected ($0.10)
Seat 3: oksuz77 (button) (small blind) folded before Flop



PokerStars Hand #222945826278:  Hold'em No Limit ($0.05/$0.10 USD) - 2021/01/23 1:13:51 ET
Table 'Malzovia III' 6-max Seat #1 is the button
Seat 1: AvGeL ($10.61 in chips) 
Seat 3: oksuz77 ($8.74 in chips) 
AvGeL: posts small blind $0.05
oksuz77: posts big blind $0.10
*** HOLE CARDS ***
AvGeL: raises $0.10 to $0.20
oksuz77: calls $0.10
*** FLOP *** [2h Td 8c]
oksuz77: checks 
AvGeL: bets $0.29
oksuz77: folds 
Uncalled bet ($0.29) returned to AvGeL
AvGeL collected $0.38 from pot
*** SUMMARY ***
Total pot $0.40 | Rake $0.02 
Board [2h Td 8c]
Seat 1: AvGeL (button) (small blind) collected ($0.38)
Seat 3: oksuz77 (big blind) folded on the Flop



PokerStars Hand #222945829970:  Hold'em No Limit ($0.05/$0.10 USD) - 2021/01/23 1:14:06 ET
Table 'Malzovia III' 6-max Seat #3 is the button
Seat 1: AvGeL ($10.79 in chips) 
Seat 3: oksuz77 ($8.54 in chips) 
oksuz77: posts small blind $0.05
AvGeL: posts big blind $0.10
*** HOLE CARDS ***
oksuz77: raises $0.10 to $0.20
AvGeL: folds 
Uncalled bet ($0.10) returned to oksuz77
oksuz77 collected $0.20 from pot
oksuz77: doesn't show hand 
*** SUMMARY ***
Total pot $0.20 | Rake $0 
Seat 1: AvGeL (big blind) folded before Flop
Seat 3: oksuz77 (button) (small blind) collected ($0.20)



PokerStars Hand #222945831997:  Hold'em No Limit ($0.05/$0.10 USD) - 2021/01/23 1:14:14 ET
Table 'Malzovia III' 6-max Seat #1 is the button
Seat 1: AvGeL ($10.69 in chips) 
Seat 3: oksuz77 ($8.64 in chips) 
AvGeL: posts small blind $0.05
oksuz77: posts big blind $0.10
*** HOLE CARDS ***
AvGeL: raises $0.10 to $0.20
oksuz77: folds 
Uncalled bet ($0.10) returned to AvGeL
AvGeL collected $0.20 from pot
*** SUMMARY ***
Total pot $0.20 | Rake $0 
Seat 1: AvGeL (button) (small blind) collected ($0.20)
Seat 3: oksuz77 (big blind) folded before Flop



PokerStars Hand #222945833317:  Hold'em No Limit ($0.05/$0.10 USD) - 2021/01/23 1:14:20 ET
Table 'Malzovia III' 6-max Seat #3 is the button
Seat 1: AvGeL ($10.79 in chips) 
Seat 3: oksuz77 ($8.54 in chips) 
oksuz77: posts small blind $0.05
AvGeL: posts big blind $0.10
*** HOLE CARDS ***
oksuz77: folds 
Uncalled bet ($0.05) returned to AvGeL
AvGeL collected $0.10 from pot
*** SUMMARY ***
Total pot $0.10 | Rake $0 
Seat 1: AvGeL (big blind) collected ($0.10)
Seat 3: oksuz77 (button) (small blind) folded before Flop



PokerStars Hand #222945834567:  Hold'em No Limit ($0.05/$0.10 USD) - 2021/01/23 1:14:25 ET
Table 'Malzovia III' 6-max Seat #1 is the button
Seat 1: AvGeL ($10.84 in chips) 
Seat 3: oksuz77 ($8.49 in chips) 
AvGeL: posts small blind $0.05
oksuz77: posts big blind $0.10
*** HOLE CARDS ***
AvGeL: raises $0.10 to $0.20
oksuz77: calls $0.10
*** FLOP *** [3h Td 6c]
oksuz77: bets $0.20
AvGeL: folds 
Uncalled bet ($0.20) returned to oksuz77
oksuz77 collected $0.38 from pot
oksuz77: doesn't show hand 
*** SUMMARY ***
Total pot $0.40 | Rake $0.02 
Board [3h Td 6c]
Seat 1: AvGeL (button) (small blind) folded on the Flop
Seat 3: oksuz77 (big blind) collected ($0.38)



PokerStars Hand #222945837972:  Hold'em No Limit ($0.05/$0.10 USD) - 2021/01/23 1:14:39 ET
Table 'Malzovia III' 6-max Seat #3 is the button
Seat 1: AvGeL ($10.64 in chips) 
Seat 3: oksuz77 ($8.67 in chips) 
oksuz77: posts small blind $0.05
AvGeL: posts big blind $0.10
*** HOLE CARDS ***
oksuz77: raises $0.10 to $0.20
AvGeL: folds 
Uncalled bet ($0.10) returned to oksuz77
oksuz77 collected $0.20 from pot
oksuz77: doesn't show hand 
*** SUMMARY ***
Total pot $0.20 | Rake $0 
Seat 1: AvGeL (big blind) folded before Flop
Seat 3: oksuz77 (button) (small blind) collected ($0.20)



PokerStars Hand #222945840505:  Hold'em No Limit ($0.05/$0.10 USD) - 2021/01/23 1:14:49 ET
Table 'Malzovia III' 6-max Seat #1 is the button
Seat 1: AvGeL ($10.54 in chips) 
Seat 3: oksuz77 ($8.77 in chips) 
AvGeL: posts small blind $0.05
oksuz77: posts big blind $0.10
*** HOLE CARDS ***
AvGeL: folds 
Uncalled bet ($0.05) returned to oksuz77
oksuz77 collected $0.10 from pot
oksuz77: doesn't show hand 
*** SUMMARY ***
Total pot $0.10 | Rake $0 
Seat 1: AvGeL (button) (small blind) folded before Flop
Seat 3: oksuz77 (big blind) collected ($0.10)



PokerStars Hand #222945842907:  Hold'em No Limit ($0.05/$0.10 USD) - 2021/01/23 1:14:59 ET
Table 'Malzovia III' 6-max Seat #3 is the button
Seat 1: AvGeL ($10.49 in chips) 
Seat 3: oksuz77 ($8.82 in chips) 
oksuz77: posts small blind $0.05
AvGeL: posts big blind $0.10
*** HOLE CARDS ***
oksuz77: calls $0.05
AvGeL: raises $0.35 to $0.45
oksuz77: folds 
Uncalled bet ($0.35) returned to AvGeL
AvGeL collected $0.20 from pot
*** SUMMARY ***
Total pot $0.20 | Rake $0 
Seat 1: AvGeL (big blind) collected ($0.20)
Seat 3: oksuz77 (button) (small blind) folded before Flop



PokerStars Hand #222945845949:  Hold'em No Limit ($0.05/$0.10 USD) - 2021/01/23 1:15:10 ET
Table 'Malzovia III' 6-max Seat #1 is the button
Seat 1: AvGeL ($10.59 in chips) 
Seat 3: oksuz77 ($8.72 in chips) 
AvGeL: posts small blind $0.05
oksuz77: posts big blind $0.10
*** HOLE CARDS ***
AvGeL: raises $0.10 to $0.20
oksuz77: folds 
Uncalled bet ($0.10) returned to AvGeL
AvGeL collected $0.20 from pot
*** SUMMARY ***
Total pot $0.20 | Rake $0 
Seat 1: AvGeL (button) (small blind) collected ($0.20)
Seat 3: oksuz77 (big blind) folded before Flop



PokerStars Hand #222945847653:  Hold'em No Limit ($0.05/$0.10 USD) - 2021/01/23 1:15:17 ET
Table 'Malzovia III' 6-max Seat #3 is the button
Seat 1: AvGeL ($10.69 in chips) 
Seat 3: oksuz77 ($8.62 in chips) 
oksuz77: posts small blind $0.05
AvGeL: posts big blind $0.10
*** HOLE CARDS ***
oksuz77: folds 
Uncalled bet ($0.05) returned to AvGeL
AvGeL collected $0.10 from pot
*** SUMMARY ***
Total pot $0.10 | Rake $0 
Seat 1: AvGeL (big blind) collected ($0.10)
Seat 3: oksuz77 (button) (small blind) folded before Flop



PokerStars Hand #222945848774:  Hold'em No Limit ($0.05/$0.10 USD) - 2021/01/23 1:15:22 ET
Table 'Malzovia III' 6-max Seat #1 is the button
Seat 1: AvGeL ($10.74 in chips) 
Seat 3: oksuz77 ($8.57 in chips) 
AvGeL: posts small blind $0.05
oksuz77: posts big blind $0.10
*** HOLE CARDS ***
AvGeL: raises $0.20 to $0.30
oksuz77: folds 
Uncalled bet ($0.20) returned to AvGeL
AvGeL collected $0.20 from pot
*** SUMMARY ***
Total pot $0.20 | Rake $0 
Seat 1: AvGeL (button) (small blind) collected ($0.20)
Seat 3: oksuz77 (big blind) folded before Flop



PokerStars Hand #222945850131:  Hold'em No Limit ($0.05/$0.10 USD) - 2021/01/23 1:15:27 ET
Table 'Malzovia III' 6-max Seat #3 is the button
Seat 1: AvGeL ($10.84 in chips) 
Seat 3: oksuz77 ($8.47 in chips) 
oksuz77: posts small blind $0.05
AvGeL: posts big blind $0.10
*** HOLE CARDS ***
oksuz77: calls $0.05
AvGeL: checks 
*** FLOP *** [Ac 4d 2s]
AvGeL: checks 
oksuz77: checks 
*** TURN *** [Ac 4d 2s] [Kc]
AvGeL: bets $0.14
oksuz77: folds 
Uncalled bet ($0.14) returned to AvGeL
AvGeL collected $0.19 from pot
*** SUMMARY ***
Total pot $0.20 | Rake $0.01 
Board [Ac 4d 2s Kc]
Seat 1: AvGeL (big blind) collected ($0.19)
Seat 3: oksuz77 (button) (small blind) folded on the Turn



PokerStars Hand #222945853734:  Hold'em No Limit ($0.05/$0.10 USD) - 2021/01/23 1:15:42 ET
Table 'Malzovia III' 6-max Seat #1 is the button
Seat 1: AvGeL ($10.93 in chips) 
Seat 3: oksuz77 ($8.37 in chips) 
AvGeL: posts small blind $0.05
oksuz77: posts big blind $0.10
*** HOLE CARDS ***
AvGeL: raises $0.10 to $0.20
oksuz77: calls $0.10
*** FLOP *** [6s Ah 2d]
oksuz77: checks 
AvGeL: bets $0.19
oksuz77: folds 
Uncalled bet ($0.19) returned to AvGeL
AvGeL collected $0.38 from pot
*** SUMMARY ***
Total pot $0.40 | Rake $0.02 
Board [6s Ah 2d]
Seat 1: AvGeL (button) (small blind) collected ($0.38)
Seat 3: oksuz77 (big blind) folded on the Flop



PokerStars Hand #222945858296:  Hold'em No Limit ($0.05/$0.10 USD) - 2021/01/23 1:16:01 ET
Table 'Malzovia III' 6-max Seat #3 is the button
Seat 1: AvGeL ($11.11 in chips) 
Seat 3: oksuz77 ($8.17 in chips) 
oksuz77: posts small blind $0.05
AvGeL: posts big blind $0.10
*** HOLE CARDS ***
oksuz77: raises $0.10 to $0.20
AvGeL: folds 
Uncalled bet ($0.10) returned to oksuz77
oksuz77 collected $0.20 from pot
oksuz77: doesn't show hand 
*** SUMMARY ***
Total pot $0.20 | Rake $0 
Seat 1: AvGeL (big blind) folded before Flop
Seat 3: oksuz77 (button) (small blind) collected ($0.20)



PokerStars Hand #222945859783:  Hold'em No Limit ($0.05/$0.10 USD) - 2021/01/23 1:16:07 ET
Table 'Malzovia III' 6-max Seat #1 is the button
Seat 1: AvGeL ($11.01 in chips) 
Seat 3: oksuz77 ($8.27 in chips) 
AvGeL: posts small blind $0.05
oksuz77: posts big blind $0.10
*** HOLE CARDS ***
AvGeL: raises $0.10 to $0.20
oksuz77: folds 
Uncalled bet ($0.10) returned to AvGeL
AvGeL collected $0.20 from pot
*** SUMMARY ***
Total pot $0.20 | Rake $0 
Seat 1: AvGeL (button) (small blind) collected ($0.20)
Seat 3: oksuz77 (big blind) folded before Flop



PokerStars Hand #222945861577:  Hold'em No Limit ($0.05/$0.10 USD) - 2021/01/23 1:16:14 ET
Table 'Malzovia III' 6-max Seat #3 is the button
Seat 1: AvGeL ($11.11 in chips) 
Seat 3: oksuz77 ($8.17 in chips) 
oksuz77: posts small blind $0.05
AvGeL: posts big blind $0.10
*** HOLE CARDS ***
oksuz77: folds 
Uncalled bet ($0.05) returned to AvGeL
AvGeL collected $0.10 from pot
*** SUMMARY ***
Total pot $0.10 | Rake $0 
Seat 1: AvGeL (big blind) collected ($0.10)
Seat 3: oksuz77 (button) (small blind) folded before Flop



PokerStars Hand #222945862815:  Hold'em No Limit ($0.05/$0.10 USD) - 2021/01/23 1:16:19 ET
Table 'Malzovia III' 6-max Seat #1 is the button
Seat 1: AvGeL ($11.16 in chips) 
Seat 3: oksuz77 ($8.12 in chips) 
AvGeL: posts small blind $0.05
oksuz77: posts big blind $0.10
*** HOLE CARDS ***
AvGeL: raises $0.10 to $0.20
oksuz77: folds 
Uncalled bet ($0.10) returned to AvGeL
AvGeL collected $0.20 from pot
*** SUMMARY ***
Total pot $0.20 | Rake $0 
Seat 1: AvGeL (button) (small blind) collected ($0.20)
Seat 3: oksuz77 (big blind) folded before Flop



PokerStars Hand #222945864540:  Hold'em No Limit ($0.05/$0.10 USD) - 2021/01/23 1:16:26 ET
Table 'Malzovia III' 6-max Seat #3 is the button
Seat 1: AvGeL ($11.26 in chips) 
Seat 3: oksuz77 ($8.02 in chips) 
oksuz77: posts small blind $0.05
AvGeL: posts big blind $0.10
*** HOLE CARDS ***
oksuz77: calls $0.05
AvGeL: raises $0.35 to $0.45
oksuz77: folds 
Uncalled bet ($0.35) returned to AvGeL
AvGeL collected $0.20 from pot
*** SUMMARY ***
Total pot $0.20 | Rake $0 
Seat 1: AvGeL (big blind) collected ($0.20)
Seat 3: oksuz77 (button) (small blind) folded before Flop



PokerStars Hand #222945866811:  Hold'em No Limit ($0.05/$0.10 USD) - 2021/01/23 1:16:35 ET
Table 'Malzovia III' 6-max Seat #1 is the button
Seat 1: AvGeL ($11.36 in chips) 
Seat 3: oksuz77 ($7.92 in chips) 
AvGeL: posts small blind $0.05
oksuz77: posts big blind $0.10
*** HOLE CARDS ***
AvGeL: raises $0.10 to $0.20
oksuz77: calls $0.10
*** FLOP *** [Tc 9s 7c]
oksuz77: bets $0.20
AvGeL: folds 
Uncalled bet ($0.20) returned to oksuz77
oksuz77 collected $0.38 from pot
oksuz77: doesn't show hand 
*** SUMMARY ***
Total pot $0.40 | Rake $0.02 
Board [Tc 9s 7c]
Seat 1: AvGeL (button) (small blind) folded on the Flop
Seat 3: oksuz77 (big blind) collected ($0.38)



PokerStars Hand #222945870099:  Hold'em No Limit ($0.05/$0.10 USD) - 2021/01/23 1:16:48 ET
Table 'Malzovia III' 6-max Seat #3 is the button
Seat 1: AvGeL ($11.16 in chips) 
Seat 3: oksuz77 ($8.10 in chips) 
oksuz77: posts small blind $0.05
AvGeL: posts big blind $0.10
*** HOLE CARDS ***
oksuz77: folds 
Uncalled bet ($0.05) returned to AvGeL
AvGeL collected $0.10 from pot
*** SUMMARY ***
Total pot $0.10 | Rake $0 
Seat 1: AvGeL (big blind) collected ($0.10)
Seat 3: oksuz77 (button) (small blind) folded before Flop



PokerStars Hand #222945871246:  Hold'em No Limit ($0.05/$0.10 USD) - 2021/01/23 1:16:53 ET
Table 'Malzovia III' 6-max Seat #1 is the button
Seat 1: AvGeL ($11.21 in chips) 
Seat 3: oksuz77 ($8.05 in chips) 
AvGeL: posts small blind $0.05
oksuz77: posts big blind $0.10
*** HOLE CARDS ***
AvGeL: raises $0.10 to $0.20
oksuz77: folds 
Uncalled bet ($0.10) returned to AvGeL
AvGeL collected $0.20 from pot
*** SUMMARY ***
Total pot $0.20 | Rake $0 
Seat 1: AvGeL (button) (small blind) collected ($0.20)
Seat 3: oksuz77 (big blind) folded before Flop



PokerStars Hand #222945880760:  Hold'em No Limit ($0.05/$0.10 USD) - 2021/01/23 1:16:59 ET
Table 'Malzovia III' 6-max Seat #3 is the button
Seat 1: AvGeL ($11.31 in chips) 
Seat 3: oksuz77 ($7.95 in chips) 
oksuz77: posts small blind $0.05
AvGeL: posts big blind $0.10
*** HOLE CARDS ***
oksuz77: folds 
Uncalled bet ($0.05) returned to AvGeL
AvGeL collected $0.10 from pot
*** SUMMARY ***
Total pot $0.10 | Rake $0 
Seat 1: AvGeL (big blind) collected ($0.10)
Seat 3: oksuz77 (button) (small blind) folded before Flop



PokerStars Hand #222945881876:  Hold'em No Limit ($0.05/$0.10 USD) - 2021/01/23 1:17:03 ET
Table 'Malzovia III' 6-max Seat #3 is the button
Seat 1: AvGeL ($11.36 in chips) 
Seat 2: ildar87kzn ($12.57 in chips) 
Seat 3: oksuz77 ($7.90 in chips) 
AvGeL: posts small blind $0.05
ildar87kzn: posts big blind $0.10
*** HOLE CARDS ***
oksuz77: folds 
AvGeL: folds 
Uncalled bet ($0.05) returned to ildar87kzn
ildar87kzn collected $0.10 from pot
ildar87kzn: doesn't show hand 
*** SUMMARY ***
Total pot $0.10 | Rake $0 
Seat 1: AvGeL (small blind) folded before Flop
Seat 2: ildar87kzn (big blind) collected ($0.10)
Seat 3: oksuz77 (button) folded before Flop (didn't bet)



PokerStars Hand #222945883763:  Hold'em No Limit ($0.05/$0.10 USD) - 2021/01/23 1:17:11 ET
Table 'Malzovia III' 6-max Seat #1 is the button
Seat 1: AvGeL ($11.31 in chips) 
Seat 2: ildar87kzn ($12.62 in chips) 
Seat 3: oksuz77 ($7.90 in chips) 
ildar87kzn: posts small blind $0.05
oksuz77: posts big blind $0.10
*** HOLE CARDS ***
AvGeL: folds 
ildar87kzn: raises $0.20 to $0.30
oksuz77: folds 
Uncalled bet ($0.20) returned to ildar87kzn
ildar87kzn collected $0.20 from pot
ildar87kzn: doesn't show hand 
*** SUMMARY ***
Total pot $0.20 | Rake $0 
Seat 1: AvGeL (button) folded before Flop (didn't bet)
Seat 2: ildar87kzn (small blind) collected ($0.20)
Seat 3: oksuz77 (big blind) folded before Flop



PokerStars Hand #222945886211:  Hold'em No Limit ($0.05/$0.10 USD) - 2021/01/23 1:17:21 ET
Table 'Malzovia III' 6-max Seat #2 is the button
Seat 1: AvGeL ($11.31 in chips) 
Seat 2: ildar87kzn ($12.72 in chips) 
Seat 3: oksuz77 ($7.80 in chips) 
oksuz77: posts small blind $0.05
AvGeL: posts big blind $0.10
*** HOLE CARDS ***
ildar87kzn: folds 
oksuz77: calls $0.05
AvGeL: raises $0.10 to $0.20
oksuz77: folds 
Uncalled bet ($0.10) returned to AvGeL
AvGeL collected $0.20 from pot
*** SUMMARY ***
Total pot $0.20 | Rake $0 
Seat 1: AvGeL (big blind) collected ($0.20)
Seat 2: ildar87kzn (button) folded before Flop (didn't bet)
Seat 3: oksuz77 (small blind) folded before Flop



PokerStars Hand #222945889559:  Hold'em No Limit ($0.05/$0.10 USD) - 2021/01/23 1:17:34 ET
Table 'Malzovia III' 6-max Seat #1 is the button
Seat 1: AvGeL ($11.41 in chips) 
Seat 3: oksuz77 ($7.70 in chips) 
AvGeL: posts small blind $0.05
ildar87kzn: is sitting out 
oksuz77: posts big blind $0.10
*** HOLE CARDS ***
AvGeL: raises $0.10 to $0.20
oksuz77: folds 
Uncalled bet ($0.10) returned to AvGeL
AvGeL collected $0.20 from pot
*** SUMMARY ***
Total pot $0.20 | Rake $0 
Seat 1: AvGeL (button) (small blind) collected ($0.20)
Seat 3: oksuz77 (big blind) folded before Flop



PokerStars Hand #222945891645:  Hold'em No Limit ($0.05/$0.10 USD) - 2021/01/23 1:17:43 ET
Table 'Malzovia III' 6-max Seat #3 is the button
Seat 1: AvGeL ($11.51 in chips) 
Seat 3: oksuz77 ($7.60 in chips) 
oksuz77: posts small blind $0.05
AvGeL: posts big blind $0.10
*** HOLE CARDS ***
oksuz77: folds 
Uncalled bet ($0.05) returned to AvGeL
AvGeL collected $0.10 from pot
*** SUMMARY ***
Total pot $0.10 | Rake $0 
Seat 1: AvGeL (big blind) collected ($0.10)
Seat 3: oksuz77 (button) (small blind) folded before Flop



PokerStars Hand #222945892809:  Hold'em No Limit ($0.05/$0.10 USD) - 2021/01/23 1:17:47 ET
Table 'Malzovia III' 6-max Seat #1 is the button
Seat 1: AvGeL ($11.56 in chips) 
Seat 3: oksuz77 ($7.55 in chips) 
AvGeL: posts small blind $0.05
oksuz77: posts big blind $0.10
*** HOLE CARDS ***
ildar87kzn leaves the table
AvGeL: folds 
Uncalled bet ($0.05) returned to oksuz77
oksuz77 collected $0.10 from pot
oksuz77: doesn't show hand 
*** SUMMARY ***
Total pot $0.10 | Rake $0 
Seat 1: AvGeL (button) (small blind) folded before Flop
Seat 3: oksuz77 (big blind) collected ($0.10)



PokerStars Hand #222945894523:  Hold'em No Limit ($0.05/$0.10 USD) - 2021/01/23 1:17:55 ET
Table 'Malzovia III' 6-max Seat #3 is the button
Seat 1: AvGeL ($11.51 in chips) 
Seat 3: oksuz77 ($7.60 in chips) 
oksuz77: posts small blind $0.05
AvGeL: posts big blind $0.10
*** HOLE CARDS ***
oksuz77: raises $0.10 to $0.20
AvGeL: folds 
Uncalled bet ($0.10) returned to oksuz77
oksuz77 collected $0.20 from pot
oksuz77: doesn't show hand 
*** SUMMARY ***
Total pot $0.20 | Rake $0 
Seat 1: AvGeL (big blind) folded before Flop
Seat 3: oksuz77 (button) (small blind) collected ($0.20)



PokerStars Hand #222945895966:  Hold'em No Limit ($0.05/$0.10 USD) - 2021/01/23 1:18:01 ET
Table 'Malzovia III' 6-max Seat #1 is the button
Seat 1: AvGeL ($11.41 in chips) 
Seat 3: oksuz77 ($7.70 in chips) 
AvGeL: posts small blind $0.05
oksuz77: posts big blind $0.10
*** HOLE CARDS ***
AvGeL: raises $0.10 to $0.20
oksuz77: folds 
Uncalled bet ($0.10) returned to AvGeL
AvGeL collected $0.20 from pot
*** SUMMARY ***
Total pot $0.20 | Rake $0 
Seat 1: AvGeL (button) (small blind) collected ($0.20)
Seat 3: oksuz77 (big blind) folded before Flop



PokerStars Hand #222945897399:  Hold'em No Limit ($0.05/$0.10 USD) - 2021/01/23 1:18:07 ET
Table 'Malzovia III' 6-max Seat #3 is the button
Seat 1: AvGeL ($11.51 in chips) 
Seat 3: oksuz77 ($7.60 in chips) 
oksuz77: posts small blind $0.05
AvGeL: posts big blind $0.10
*** HOLE CARDS ***
oksuz77: folds 
Uncalled bet ($0.05) returned to AvGeL
AvGeL collected $0.10 from pot
*** SUMMARY ***
Total pot $0.10 | Rake $0 
Seat 1: AvGeL (big blind) collected ($0.10)
Seat 3: oksuz77 (button) (small blind) folded before Flop



PokerStars Hand #222945898533:  Hold'em No Limit ($0.05/$0.10 USD) - 2021/01/23 1:18:11 ET
Table 'Malzovia III' 6-max Seat #1 is the button
Seat 1: AvGeL ($11.56 in chips) 
Seat 3: oksuz77 ($7.55 in chips) 
AvGeL: posts small blind $0.05
oksuz77: posts big blind $0.10
*** HOLE CARDS ***
AvGeL: folds 
Uncalled bet ($0.05) returned to oksuz77
oksuz77 collected $0.10 from pot
oksuz77: doesn't show hand 
*** SUMMARY ***
Total pot $0.10 | Rake $0 
Seat 1: AvGeL (button) (small blind) folded before Flop
Seat 3: oksuz77 (big blind) collected ($0.10)



PokerStars Hand #222945899571:  Hold'em No Limit ($0.05/$0.10 USD) - 2021/01/23 1:18:15 ET
Table 'Malzovia III' 6-max Seat #3 is the button
Seat 1: AvGeL ($11.51 in chips) 
Seat 3: oksuz77 ($7.60 in chips) 
oksuz77: posts small blind $0.05
AvGeL: posts big blind $0.10
*** HOLE CARDS ***
oksuz77: raises $0.10 to $0.20
AvGeL: folds 
Uncalled bet ($0.10) returned to oksuz77
oksuz77 collected $0.20 from pot
oksuz77: doesn't show hand 
*** SUMMARY ***
Total pot $0.20 | Rake $0 
Seat 1: AvGeL (big blind) folded before Flop
Seat 3: oksuz77 (button) (small blind) collected ($0.20)



PokerStars Hand #222945901355:  Hold'em No Limit ($0.05/$0.10 USD) - 2021/01/23 1:18:22 ET
Table 'Malzovia III' 6-max Seat #1 is the button
Seat 1: AvGeL ($11.41 in chips) 
Seat 3: oksuz77 ($7.70 in chips) 
AvGeL: posts small blind $0.05
oksuz77: posts big blind $0.10
*** HOLE CARDS ***
AvGeL: raises $0.10 to $0.20
oksuz77: folds 
Uncalled bet ($0.10) returned to AvGeL
AvGeL collected $0.20 from pot
*** SUMMARY ***
Total pot $0.20 | Rake $0 
Seat 1: AvGeL (button) (small blind) collected ($0.20)
Seat 3: oksuz77 (big blind) folded before Flop



PokerStars Hand #222945902605:  Hold'em No Limit ($0.05/$0.10 USD) - 2021/01/23 1:18:27 ET
Table 'Malzovia III' 6-max Seat #3 is the button
Seat 1: AvGeL ($11.51 in chips) 
Seat 3: oksuz77 ($7.60 in chips) 
oksuz77: posts small blind $0.05
AvGeL: posts big blind $0.10
*** HOLE CARDS ***
oksuz77: folds 
Uncalled bet ($0.05) returned to AvGeL
AvGeL collected $0.10 from pot
*** SUMMARY ***
Total pot $0.10 | Rake $0 
Seat 1: AvGeL (big blind) collected ($0.10)
Seat 3: oksuz77 (button) (small blind) folded before Flop



PokerStars Hand #222945903740:  Hold'em No Limit ($0.05/$0.10 USD) - 2021/01/23 1:18:32 ET
Table 'Malzovia III' 6-max Seat #1 is the button
Seat 1: AvGeL ($11.56 in chips) 
Seat 3: oksuz77 ($7.55 in chips) 
AvGeL: posts small blind $0.05
oksuz77: posts big blind $0.10
*** HOLE CARDS ***
AvGeL: raises $0.10 to $0.20
oksuz77: folds 
Uncalled bet ($0.10) returned to AvGeL
AvGeL collected $0.20 from pot
*** SUMMARY ***
Total pot $0.20 | Rake $0 
Seat 1: AvGeL (button) (small blind) collected ($0.20)
Seat 3: oksuz77 (big blind) folded before Flop



PokerStars Hand #222945905024:  Hold'em No Limit ($0.05/$0.10 USD) - 2021/01/23 1:18:37 ET
Table 'Malzovia III' 6-max Seat #3 is the button
Seat 1: AvGeL ($11.66 in chips) 
Seat 3: oksuz77 ($7.45 in chips) 
oksuz77: posts small blind $0.05
AvGeL: posts big blind $0.10
*** HOLE CARDS ***
oksuz77: folds 
Uncalled bet ($0.05) returned to AvGeL
AvGeL collected $0.10 from pot
*** SUMMARY ***
Total pot $0.10 | Rake $0 
Seat 1: AvGeL (big blind) collected ($0.10)
Seat 3: oksuz77 (button) (small blind) folded before Flop



PokerStars Hand #222945906124:  Hold'em No Limit ($0.05/$0.10 USD) - 2021/01/23 1:18:42 ET
Table 'Malzovia III' 6-max Seat #1 is the button
Seat 1: AvGeL ($11.71 in chips) 
Seat 3: oksuz77 ($7.40 in chips) 
AvGeL: posts small blind $0.05
oksuz77: posts big blind $0.10
*** HOLE CARDS ***
AvGeL: raises $0.20 to $0.30
oksuz77: folds 
Uncalled bet ($0.20) returned to AvGeL
AvGeL collected $0.20 from pot
*** SUMMARY ***
Total pot $0.20 | Rake $0 
Seat 1: AvGeL (button) (small blind) collected ($0.20)
Seat 3: oksuz77 (big blind) folded before Flop



PokerStars Hand #222945907438:  Hold'em No Limit ($0.05/$0.10 USD) - 2021/01/23 1:18:47 ET
Table 'Malzovia III' 6-max Seat #3 is the button
Seat 1: AvGeL ($11.81 in chips) 
Seat 3: oksuz77 ($7.30 in chips) 
oksuz77: posts small blind $0.05
AvGeL: posts big blind $0.10
*** HOLE CARDS ***
oksuz77: folds 
Uncalled bet ($0.05) returned to AvGeL
AvGeL collected $0.10 from pot
*** SUMMARY ***
Total pot $0.10 | Rake $0 
Seat 1: AvGeL (big blind) collected ($0.10)
Seat 3: oksuz77 (button) (small blind) folded before Flop



PokerStars Hand #222945908592:  Hold'em No Limit ($0.05/$0.10 USD) - 2021/01/23 1:18:52 ET
Table 'Malzovia III' 6-max Seat #1 is the button
Seat 1: AvGeL ($11.86 in chips) 
Seat 3: oksuz77 ($7.25 in chips) 
AvGeL: posts small blind $0.05
oksuz77: posts big blind $0.10
*** HOLE CARDS ***
AvGeL: folds 
Uncalled bet ($0.05) returned to oksuz77
oksuz77 collected $0.10 from pot
oksuz77: doesn't show hand 
*** SUMMARY ***
Total pot $0.10 | Rake $0 
Seat 1: AvGeL (button) (small blind) folded before Flop
Seat 3: oksuz77 (big blind) collected ($0.10)



PokerStars Hand #222945909413:  Hold'em No Limit ($0.05/$0.10 USD) - 2021/01/23 1:18:55 ET
Table 'Malzovia III' 6-max Seat #3 is the button
Seat 1: AvGeL ($11.81 in chips) 
Seat 3: oksuz77 ($7.30 in chips) 
oksuz77: posts small blind $0.05
AvGeL: posts big blind $0.10
*** HOLE CARDS ***
oksuz77: calls $0.05
AvGeL: raises $0.20 to $0.30
oksuz77: calls $0.20
*** FLOP *** [3h Qd 9d]
AvGeL: bets $0.43
oksuz77: folds 
Uncalled bet ($0.43) returned to AvGeL
AvGeL collected $0.57 from pot
*** SUMMARY ***
Total pot $0.60 | Rake $0.03 
Board [3h Qd 9d]
Seat 1: AvGeL (big blind) collected ($0.57)
Seat 3: oksuz77 (button) (small blind) folded on the Flop



PokerStars Hand #222945913608:  Hold'em No Limit ($0.05/$0.10 USD) - 2021/01/23 1:19:13 ET
Table 'Malzovia III' 6-max Seat #1 is the button
Seat 1: AvGeL ($12.08 in chips) 
Seat 3: oksuz77 ($7 in chips) 
AvGeL: posts small blind $0.05
oksuz77: posts big blind $0.10
*** HOLE CARDS ***
AvGeL: raises $0.20 to $0.30
oksuz77: raises $0.20 to $0.50
AvGeL: raises $11.58 to $12.08 and is all-in
oksuz77: calls $6.50 and is all-in
Uncalled bet ($5.08) returned to AvGeL
*** FLOP *** [9h Td Js]
*** TURN *** [9h Td Js] [5s]
*** RIVER *** [9h Td Js 5s] [9d]
*** SHOW DOWN ***
oksuz77: shows [Kc As] (a pair of Nines)
AvGeL: shows [Ad Kh] (a pair of Nines)
oksuz77 collected $6.75 from pot
AvGeL collected $6.75 from pot
*** SUMMARY ***
Total pot $14 | Rake $0.50 
Board [9h Td Js 5s 9d]
Seat 1: AvGeL (button) (small blind) showed [Ad Kh] and won ($6.75) with a pair of Nines
Seat 3: oksuz77 (big blind) showed [Kc As] and won ($6.75) with a pair of Nines



PokerStars Hand #222945919094:  Hold'em No Limit ($0.05/$0.10 USD) - 2021/01/23 1:19:36 ET
Table 'Malzovia III' 6-max Seat #3 is the button
Seat 1: AvGeL ($11.83 in chips) 
Seat 3: oksuz77 ($6.75 in chips) 
oksuz77: posts small blind $0.05
AvGeL: posts big blind $0.10
*** HOLE CARDS ***
oksuz77: folds 
Uncalled bet ($0.05) returned to AvGeL
AvGeL collected $0.10 from pot
*** SUMMARY ***
Total pot $0.10 | Rake $0 
Seat 1: AvGeL (big blind) collected ($0.10)
Seat 3: oksuz77 (button) (small blind) folded before Flop



PokerStars Hand #222945920321:  Hold'em No Limit ($0.05/$0.10 USD) - 2021/01/23 1:19:41 ET
Table 'Malzovia III' 6-max Seat #1 is the button
Seat 1: AvGeL ($11.88 in chips) 
Seat 3: oksuz77 ($6.70 in chips) 
AvGeL: posts small blind $0.05
oksuz77: posts big blind $0.10
*** HOLE CARDS ***
AvGeL: raises $0.10 to $0.20
oksuz77: calls $0.10
*** FLOP *** [5s 5c 7c]
oksuz77: checks 
AvGeL: bets $0.29
oksuz77: folds 
Uncalled bet ($0.29) returned to AvGeL
AvGeL collected $0.38 from pot
*** SUMMARY ***
Total pot $0.40 | Rake $0.02 
Board [5s 5c 7c]
Seat 1: AvGeL (button) (small blind) collected ($0.38)
Seat 3: oksuz77 (big blind) folded on the Flop



PokerStars Hand #222945923339:  Hold'em No Limit ($0.05/$0.10 USD) - 2021/01/23 1:19:53 ET
Table 'Malzovia III' 6-max Seat #3 is the button
Seat 1: AvGeL ($12.06 in chips) 
Seat 3: oksuz77 ($6.50 in chips) 
oksuz77: posts small blind $0.05
MrBearJew joins the table at seat #4 
AvGeL: posts big blind $0.10
*** HOLE CARDS ***
oksuz77: raises $0.10 to $0.20
AvGeL: calls $0.10
*** FLOP *** [7d Td 8c]
AvGeL: checks 
oksuz77: checks 
*** TURN *** [7d Td 8c] [Th]
AvGeL: checks 
oksuz77: checks 
*** RIVER *** [7d Td 8c Th] [6d]
AvGeL: checks 
oksuz77: checks 
*** SHOW DOWN ***
AvGeL: shows [Kc 2c] (a pair of Tens)
oksuz77: shows [Ah 5h] (a pair of Tens - Ace kicker)
oksuz77 collected $0.38 from pot
*** SUMMARY ***
Total pot $0.40 | Rake $0.02 
Board [7d Td 8c Th 6d]
Seat 1: AvGeL (big blind) showed [Kc 2c] and lost with a pair of Tens
Seat 3: oksuz77 (button) (small blind) showed [Ah 5h] and won ($0.38) with a pair of Tens



PokerStars Hand #222945930742:  Hold'em No Limit ($0.05/$0.10 USD) - 2021/01/23 1:20:23 ET
Table 'Malzovia III' 6-max Seat #1 is the button
Seat 1: AvGeL ($11.86 in chips) 
Seat 3: oksuz77 ($6.68 in chips) 
Seat 4: MrBearJew ($10 in chips) 
oksuz77: posts small blind $0.05
MrBearJew: posts big blind $0.10
*** HOLE CARDS ***
AvGeL: folds 
oksuz77: raises $0.10 to $0.20
MrBearJew: calls $0.10
*** FLOP *** [4c Ks Jd]
oksuz77: checks 
MrBearJew: checks 
*** TURN *** [4c Ks Jd] [9d]
oksuz77: bets $0.10
MrBearJew: calls $0.10
*** RIVER *** [4c Ks Jd 9d] [2d]
NeMaProbl3ma joins the table at seat #2 
oksuz77: checks 
MrBearJew: bets $9.70 and is all-in
oksuz77: folds 
Uncalled bet ($9.70) returned to MrBearJew
MrBearJew collected $0.57 from pot
*** SUMMARY ***
Total pot $0.60 | Rake $0.03 
Board [4c Ks Jd 9d 2d]
Seat 1: AvGeL (button) folded before Flop (didn't bet)
Seat 3: oksuz77 (small blind) folded on the River
Seat 4: MrBearJew (big blind) collected ($0.57)



PokerStars Hand #222945935827:  Hold'em No Limit ($0.05/$0.10 USD) - 2021/01/23 1:20:44 ET
Table 'Malzovia III' 6-max Seat #3 is the button
Seat 1: AvGeL ($11.86 in chips) 
Seat 2: NeMaProbl3ma ($8 in chips) 
Seat 3: oksuz77 ($6.38 in chips) 
Seat 4: MrBearJew ($10.27 in chips) 
MrBearJew: posts small blind $0.05
AvGeL: posts big blind $0.10
NeMaProbl3ma: posts big blind $0.10
*** HOLE CARDS ***
NeMaProbl3ma: checks 
oksuz77: raises $0.10 to $0.20
MrBearJew: folds 
AvGeL: folds 
petrovichkag joins the table at seat #5 
NeMaProbl3ma: raises $0.10 to $0.30
oksuz77: calls $0.10
*** FLOP *** [8c 3d Kc]
NeMaProbl3ma: checks 
oksuz77: bets $0.10
NeMaProbl3ma: calls $0.10
*** TURN *** [8c 3d Kc] [6c]
NeMaProbl3ma: checks 
oksuz77: checks 
*** RIVER *** [8c 3d Kc 6c] [Jd]
NeMaProbl3ma: bets $0.50
oksuz77: folds 
Uncalled bet ($0.50) returned to NeMaProbl3ma
NeMaProbl3ma collected $0.91 from pot
NeMaProbl3ma: doesn't show hand 
*** SUMMARY ***
Total pot $0.95 | Rake $0.04 
Board [8c 3d Kc 6c Jd]
Seat 1: AvGeL (big blind) folded before Flop
Seat 2: NeMaProbl3ma collected ($0.91)
Seat 3: oksuz77 (button) folded on the River
Seat 4: MrBearJew (small blind) folded before Flop



PokerStars Hand #222945948525:  Hold'em No Limit ($0.05/$0.10 USD) - 2021/01/23 1:21:36 ET
Table 'Malzovia III' 6-max Seat #4 is the button
Seat 1: AvGeL ($11.76 in chips) 
Seat 2: NeMaProbl3ma ($8.51 in chips) 
Seat 3: oksuz77 ($5.98 in chips) 
Seat 4: MrBearJew ($10.22 in chips) 
AvGeL: posts small blind $0.05
NeMaProbl3ma: posts big blind $0.10
*** HOLE CARDS ***
oksuz77: raises $0.10 to $0.20
MrBearJew: calls $0.20
AvGeL: folds 
NeMaProbl3ma: calls $0.10
*** FLOP *** [6d 7c 9c]
YURufina joins the table at seat #6 
NeMaProbl3ma: bets $0.10
oksuz77: folds 
MrBearJew: raises $0.20 to $0.30
NeMaProbl3ma: raises $0.20 to $0.50
MrBearJew: folds 
Uncalled bet ($0.20) returned to NeMaProbl3ma
NeMaProbl3ma collected $1.19 from pot
NeMaProbl3ma: doesn't show hand 
*** SUMMARY ***
Total pot $1.25 | Rake $0.06 
Board [6d 7c 9c]
Seat 1: AvGeL (small blind) folded before Flop
Seat 2: NeMaProbl3ma (big blind) collected ($1.19)
Seat 3: oksuz77 folded on the Flop
Seat 4: MrBearJew (button) folded on the Flop



PokerStars Hand #222946015586:  Hold'em No Limit ($0.05/$0.10 USD) - 2021/01/23 1:26:13 ET
Table 'Malzovia III' 6-max Seat #3 is the button
Seat 1: AvGeL ($11.39 in chips) 
Seat 2: NeMaProbl3ma ($8.33 in chips) 
Seat 3: oksuz77 ($6.28 in chips) 
Seat 4: MrBearJew ($9.42 in chips) 
Seat 5: petrovichkag ($10.42 in chips) 
Seat 6: YURufina ($10.15 in chips) 
MrBearJew: posts small blind $0.05
petrovichkag: posts big blind $0.10
*** HOLE CARDS ***
YURufina: folds 
AvGeL: raises $0.20 to $0.30
NeMaProbl3ma: folds 
oksuz77: folds 
MrBearJew: calls $0.25
petrovichkag: folds 
*** FLOP *** [9d 3c 5s]
MrBearJew: checks 
AvGeL: bets $0.34
MrBearJew: calls $0.34
*** TURN *** [9d 3c 5s] [2s]
MrBearJew: checks 
AvGeL: bets $0.66
MrBearJew: folds 
Uncalled bet ($0.66) returned to AvGeL
AvGeL collected $1.32 from pot
*** SUMMARY ***
Total pot $1.38 | Rake $0.06 
Board [9d 3c 5s 2s]
Seat 1: AvGeL collected ($1.32)
Seat 2: NeMaProbl3ma folded before Flop (didn't bet)
Seat 3: oksuz77 (button) folded before Flop (didn't bet)
Seat 4: MrBearJew (small blind) folded on the Turn
Seat 5: petrovichkag (big blind) folded before Flop
Seat 6: YURufina folded before Flop (didn't bet)



PokerStars Hand #222946023784:  Hold'em No Limit ($0.05/$0.10 USD) - 2021/01/23 1:26:47 ET
Table 'Malzovia III' 6-max Seat #4 is the button
Seat 1: AvGeL ($12.07 in chips) 
Seat 2: NeMaProbl3ma ($8.33 in chips) 
Seat 3: oksuz77 ($6.28 in chips) 
Seat 4: MrBearJew ($8.78 in chips) 
Seat 5: petrovichkag ($10.32 in chips) 
Seat 6: YURufina ($10.15 in chips) 
petrovichkag: posts small blind $0.05
YURufina: posts big blind $0.10
*** HOLE CARDS ***
AvGeL: folds 
NeMaProbl3ma: raises $0.10 to $0.20
oksuz77: folds 
MrBearJew: calls $0.20
petrovichkag: folds 
YURufina: folds 
*** FLOP *** [5s Qh 7d]
NeMaProbl3ma: checks 
MrBearJew: bets $0.27
NeMaProbl3ma: calls $0.27
*** TURN *** [5s Qh 7d] [As]
NeMaProbl3ma: checks 
MrBearJew: checks 
*** RIVER *** [5s Qh 7d As] [6s]
NeMaProbl3ma: checks 
MrBearJew: checks 
*** SHOW DOWN ***
NeMaProbl3ma: shows [9d Kd] (high card Ace)
MrBearJew: shows [4d 6d] (a pair of Sixes)
MrBearJew collected $1.04 from pot
*** SUMMARY ***
Total pot $1.09 | Rake $0.05 
Board [5s Qh 7d As 6s]
Seat 1: AvGeL folded before Flop (didn't bet)
Seat 2: NeMaProbl3ma showed [9d Kd] and lost with high card Ace
Seat 3: oksuz77 folded before Flop (didn't bet)
Seat 4: MrBearJew (button) showed [4d 6d] and won ($1.04) with a pair of Sixes
Seat 5: petrovichkag (small blind) folded before Flop
Seat 6: YURufina (big blind) folded before Flop



PokerStars Hand #222946033479:  Hold'em No Limit ($0.05/$0.10 USD) - 2021/01/23 1:27:28 ET
Table 'Malzovia III' 6-max Seat #5 is the button
Seat 1: AvGeL ($12.07 in chips) 
Seat 2: NeMaProbl3ma ($7.86 in chips) 
Seat 3: oksuz77 ($6.28 in chips) 
Seat 4: MrBearJew ($9.35 in chips) 
Seat 5: petrovichkag ($10.27 in chips) 
Seat 6: YURufina ($10.05 in chips) 
YURufina: posts small blind $0.05
AvGeL: posts big blind $0.10
*** HOLE CARDS ***
NeMaProbl3ma: folds 
oksuz77: calls $0.10
MrBearJew: folds 
petrovichkag: folds 
YURufina: calls $0.05
AvGeL: checks 
*** FLOP *** [9h 4c 4d]
YURufina: checks 
AvGeL: checks 
oksuz77: checks 
*** TURN *** [9h 4c 4d] [Qs]
YURufina: bets $0.16
AvGeL: folds 
oksuz77: calls $0.16
*** RIVER *** [9h 4c 4d Qs] [Js]
YURufina: bets $0.89
oksuz77: calls $0.89
*** SHOW DOWN ***
YURufina: shows [8d Td] (a straight, Eight to Queen)
oksuz77: mucks hand 
YURufina collected $2.29 from pot
*** SUMMARY ***
Total pot $2.40 | Rake $0.11 
Board [9h 4c 4d Qs Js]
Seat 1: AvGeL (big blind) folded on the Turn
Seat 2: NeMaProbl3ma folded before Flop (didn't bet)
Seat 3: oksuz77 mucked
Seat 4: MrBearJew folded before Flop (didn't bet)
Seat 5: petrovichkag (button) folded before Flop (didn't bet)
Seat 6: YURufina (small blind) showed [8d Td] and won ($2.29) with a straight, Eight to Queen



PokerStars Hand #222946046509:  Hold'em No Limit ($0.05/$0.10 USD) - 2021/01/23 1:28:22 ET
Table 'Malzovia III' 6-max Seat #6 is the button
Seat 1: AvGeL ($11.97 in chips) 
Seat 2: NeMaProbl3ma ($7.86 in chips) 
Seat 3: oksuz77 ($5.13 in chips) 
Seat 4: MrBearJew ($9.35 in chips) 
Seat 5: petrovichkag ($10.27 in chips) 
Seat 6: YURufina ($11.19 in chips) 
AvGeL: posts small blind $0.05
NeMaProbl3ma: posts big blind $0.10
*** HOLE CARDS ***
oksuz77: folds 
MrBearJew: raises $0.10 to $0.20
petrovichkag: folds 
YURufina: folds 
AvGeL: folds 
NeMaProbl3ma: calls $0.10
*** FLOP *** [Ad 2h 9h]
NeMaProbl3ma: checks 
MrBearJew: checks 
*** TURN *** [Ad 2h 9h] [8s]
NeMaProbl3ma: bets $0.20
MrBearJew: calls $0.20
*** RIVER *** [Ad 2h 9h 8s] [Jh]
NeMaProbl3ma: checks 
MrBearJew: checks 
*** SHOW DOWN ***
NeMaProbl3ma: shows [8c Tc] (a pair of Eights)
MrBearJew: shows [6d 9d] (a pair of Nines)
MrBearJew collected $0.81 from pot
*** SUMMARY ***
Total pot $0.85 | Rake $0.04 
Board [Ad 2h 9h 8s Jh]
Seat 1: AvGeL (small blind) folded before Flop
Seat 2: NeMaProbl3ma (big blind) showed [8c Tc] and lost with a pair of Eights
Seat 3: oksuz77 folded before Flop (didn't bet)
Seat 4: MrBearJew showed [6d 9d] and won ($0.81) with a pair of Nines
Seat 5: petrovichkag folded before Flop (didn't bet)
Seat 6: YURufina (button) folded before Flop (didn't bet)



PokerStars Hand #222946057126:  Hold'em No Limit ($0.05/$0.10 USD) - 2021/01/23 1:29:06 ET
Table 'Malzovia III' 6-max Seat #1 is the button
Seat 1: AvGeL ($11.92 in chips) 
Seat 2: NeMaProbl3ma ($7.46 in chips) 
Seat 3: oksuz77 ($5.13 in chips) 
Seat 4: MrBearJew ($9.76 in chips) 
Seat 5: petrovichkag ($10.27 in chips) 
Seat 6: YURufina ($11.19 in chips) 
NeMaProbl3ma: posts small blind $0.05
oksuz77: posts big blind $0.10
*** HOLE CARDS ***
MrBearJew: folds 
petrovichkag: folds 
YURufina: raises $0.14 to $0.24
AvGeL: folds 
NeMaProbl3ma: raises $0.16 to $0.40
oksuz77: folds 
YURufina: raises $10.79 to $11.19 and is all-in
NeMaProbl3ma: folds 
Uncalled bet ($10.79) returned to YURufina
YURufina collected $0.90 from pot
*** SUMMARY ***
Total pot $0.90 | Rake $0 
Seat 1: AvGeL (button) folded before Flop (didn't bet)
Seat 2: NeMaProbl3ma (small blind) folded before Flop
Seat 3: oksuz77 (big blind) folded before Flop
Seat 4: MrBearJew folded before Flop (didn't bet)
Seat 5: petrovichkag folded before Flop (didn't bet)
Seat 6: YURufina collected ($0.90)



PokerStars Hand #222946064683:  Hold'em No Limit ($0.05/$0.10 USD) - 2021/01/23 1:29:36 ET
Table 'Malzovia III' 6-max Seat #2 is the button
Seat 1: AvGeL ($11.92 in chips) 
Seat 2: NeMaProbl3ma ($7.06 in chips) 
Seat 3: oksuz77 ($5.03 in chips) 
Seat 4: MrBearJew ($9.76 in chips) 
Seat 5: petrovichkag ($10.27 in chips) 
Seat 6: YURufina ($11.69 in chips) 
oksuz77: posts small blind $0.05
MrBearJew: posts big blind $0.10
*** HOLE CARDS ***
petrovichkag: folds 
YURufina: folds 
AvGeL: folds 
NeMaProbl3ma: calls $0.10
oksuz77: folds 
MrBearJew: checks 
*** FLOP *** [Jh 9c 6d]
MrBearJew: bets $0.10
NeMaProbl3ma: folds 
Uncalled bet ($0.10) returned to MrBearJew
MrBearJew collected $0.24 from pot
*** SUMMARY ***
Total pot $0.25 | Rake $0.01 
Board [Jh 9c 6d]
Seat 1: AvGeL folded before Flop (didn't bet)
Seat 2: NeMaProbl3ma (button) folded on the Flop
Seat 3: oksuz77 (small blind) folded before Flop
Seat 4: MrBearJew (big blind) collected ($0.24)
Seat 5: petrovichkag folded before Flop (didn't bet)
Seat 6: YURufina folded before Flop (didn't bet)



PokerStars Hand #222946075066:  Hold'em No Limit ($0.05/$0.10 USD) - 2021/01/23 1:30:19 ET
Table 'Malzovia III' 6-max Seat #3 is the button
Seat 1: AvGeL ($11.92 in chips) 
Seat 2: NeMaProbl3ma ($6.96 in chips) 
Seat 3: oksuz77 ($4.98 in chips) 
Seat 4: MrBearJew ($9.90 in chips) 
Seat 5: petrovichkag ($10.27 in chips) 
Seat 6: YURufina ($11.69 in chips) 
MrBearJew: posts small blind $0.05
petrovichkag: posts big blind $0.10
*** HOLE CARDS ***
YURufina: folds 
AvGeL: raises $0.20 to $0.30
NeMaProbl3ma: folds 
oksuz77: folds 
MrBearJew: folds 
petrovichkag: folds 
Uncalled bet ($0.20) returned to AvGeL
AvGeL collected $0.25 from pot
*** SUMMARY ***
Total pot $0.25 | Rake $0 
Seat 1: AvGeL collected ($0.25)
Seat 2: NeMaProbl3ma folded before Flop (didn't bet)
Seat 3: oksuz77 (button) folded before Flop (didn't bet)
Seat 4: MrBearJew (small blind) folded before Flop
Seat 5: petrovichkag (big blind) folded before Flop
Seat 6: YURufina folded before Flop (didn't bet)



PokerStars Hand #222946077923:  Hold'em No Limit ($0.05/$0.10 USD) - 2021/01/23 1:30:31 ET
Table 'Malzovia III' 6-max Seat #4 is the button
Seat 1: AvGeL ($12.07 in chips) 
Seat 2: NeMaProbl3ma ($6.96 in chips) 
Seat 3: oksuz77 ($4.98 in chips) 
Seat 4: MrBearJew ($9.85 in chips) 
Seat 5: petrovichkag ($10.17 in chips) 
Seat 6: YURufina ($11.69 in chips) 
petrovichkag: posts small blind $0.05
YURufina: posts big blind $0.10
*** HOLE CARDS ***
AvGeL: folds 
NeMaProbl3ma: raises $0.10 to $0.20
oksuz77: folds 
MrBearJew: folds 
petrovichkag: folds 
YURufina: calls $0.10
*** FLOP *** [5d Kc 8d]
YURufina: checks 
NeMaProbl3ma: bets $0.20
YURufina: raises $0.62 to $0.82
NeMaProbl3ma: calls $0.62
*** TURN *** [5d Kc 8d] [9h]
YURufina: checks 
NeMaProbl3ma: checks 
*** RIVER *** [5d Kc 8d 9h] [Kh]
YURufina: bets $0.66
NeMaProbl3ma: calls $0.66
*** SHOW DOWN ***
YURufina: shows [Kd 7d] (three of a kind, Kings)
NeMaProbl3ma: mucks hand 
YURufina collected $3.26 from pot
*** SUMMARY ***
Total pot $3.41 | Rake $0.15 
Board [5d Kc 8d 9h Kh]
Seat 1: AvGeL folded before Flop (didn't bet)
Seat 2: NeMaProbl3ma mucked
Seat 3: oksuz77 folded before Flop (didn't bet)
Seat 4: MrBearJew (button) folded before Flop (didn't bet)
Seat 5: petrovichkag (small blind) folded before Flop
Seat 6: YURufina (big blind) showed [Kd 7d] and won ($3.26) with three of a kind, Kings



PokerStars Hand #222946091328:  Hold'em No Limit ($0.05/$0.10 USD) - 2021/01/23 1:31:25 ET
Table 'Malzovia III' 6-max Seat #5 is the button
Seat 1: AvGeL ($12.07 in chips) 
Seat 2: NeMaProbl3ma ($5.28 in chips) 
Seat 3: oksuz77 ($4.98 in chips) 
Seat 4: MrBearJew ($9.85 in chips) 
Seat 5: petrovichkag ($10.12 in chips) 
Seat 6: YURufina ($13.27 in chips) 
YURufina: posts small blind $0.05
AvGeL: posts big blind $0.10
*** HOLE CARDS ***
NeMaProbl3ma: raises $0.20 to $0.30
oksuz77: folds 
MrBearJew: folds 
petrovichkag: calls $0.30
YURufina: folds 
AvGeL: folds 
*** FLOP *** [As Qd 3d]
NeMaProbl3ma: checks 
petrovichkag: checks 
*** TURN *** [As Qd 3d] [9c]
NeMaProbl3ma: bets $0.36
petrovichkag: raises $1.12 to $1.48
NeMaProbl3ma: calls $1.12
*** RIVER *** [As Qd 3d 9c] [7s]
NeMaProbl3ma: checks 
petrovichkag: bets $2.90
NeMaProbl3ma: calls $2.90
*** SHOW DOWN ***
petrovichkag: shows [9d 9h] (three of a kind, Nines)
NeMaProbl3ma: mucks hand 
petrovichkag collected $9.08 from pot
*** SUMMARY ***
Total pot $9.51 | Rake $0.43 
Board [As Qd 3d 9c 7s]
Seat 1: AvGeL (big blind) folded before Flop
Seat 2: NeMaProbl3ma mucked
Seat 3: oksuz77 folded before Flop (didn't bet)
Seat 4: MrBearJew folded before Flop (didn't bet)
Seat 5: petrovichkag (button) showed [9d 9h] and won ($9.08) with three of a kind, Nines
Seat 6: YURufina (small blind) folded before Flop



PokerStars Hand #222946108140:  Hold'em No Limit ($0.05/$0.10 USD) - 2021/01/23 1:32:35 ET
Table 'Malzovia III' 6-max Seat #6 is the button
Seat 1: AvGeL ($11.97 in chips) 
Seat 2: NeMaProbl3ma ($0.60 in chips) 
Seat 3: oksuz77 ($4.98 in chips) 
Seat 4: MrBearJew ($9.85 in chips) 
Seat 5: petrovichkag ($14.52 in chips) 
Seat 6: YURufina ($13.22 in chips) 
AvGeL: posts small blind $0.05
NeMaProbl3ma: posts big blind $0.10
*** HOLE CARDS ***
oksuz77: folds 
MrBearJew: raises $0.20 to $0.30
petrovichkag: folds 
YURufina: folds 
AvGeL: folds 
NeMaProbl3ma: folds 
Uncalled bet ($0.20) returned to MrBearJew
MrBearJew collected $0.25 from pot
*** SUMMARY ***
Total pot $0.25 | Rake $0 
Seat 1: AvGeL (small blind) folded before Flop
Seat 2: NeMaProbl3ma (big blind) folded before Flop
Seat 3: oksuz77 folded before Flop (didn't bet)
Seat 4: MrBearJew collected ($0.25)
Seat 5: petrovichkag folded before Flop (didn't bet)
Seat 6: YURufina (button) folded before Flop (didn't bet)



PokerStars Hand #222946112176:  Hold'em No Limit ($0.05/$0.10 USD) - 2021/01/23 1:32:51 ET
Table 'Malzovia III' 6-max Seat #1 is the button
Seat 1: AvGeL ($11.92 in chips) 
Seat 2: NeMaProbl3ma ($0.50 in chips) 
Seat 3: oksuz77 ($4.98 in chips) 
Seat 4: MrBearJew ($10 in chips) 
Seat 5: petrovichkag ($14.52 in chips) 
Seat 6: YURufina ($13.22 in chips) 
NeMaProbl3ma: posts small blind $0.05
oksuz77: posts big blind $0.10
*** HOLE CARDS ***
MrBearJew: folds 
petrovichkag: folds 
YURufina: folds 
AvGeL: raises $0.10 to $0.20
NeMaProbl3ma: raises $0.30 to $0.50 and is all-in
oksuz77: folds 
AvGeL: calls $0.30
*** FLOP *** [Kd Qd 2d]
*** TURN *** [Kd Qd 2d] [9d]
*** RIVER *** [Kd Qd 2d 9d] [2h]
*** SHOW DOWN ***
NeMaProbl3ma: shows [Ad Jd] (a flush, Ace high)
AvGeL: shows [Th Ah] (a pair of Deuces)
NeMaProbl3ma collected $1.05 from pot
*** SUMMARY ***
Total pot $1.10 | Rake $0.05 
Board [Kd Qd 2d 9d 2h]
Seat 1: AvGeL (button) showed [Th Ah] and lost with a pair of Deuces
Seat 2: NeMaProbl3ma (small blind) showed [Ad Jd] and won ($1.05) with a flush, Ace high
Seat 3: oksuz77 (big blind) folded before Flop
Seat 4: MrBearJew folded before Flop (didn't bet)
Seat 5: petrovichkag folded before Flop (didn't bet)
Seat 6: YURufina folded before Flop (didn't bet)



PokerStars Hand #222946120615:  Hold'em No Limit ($0.05/$0.10 USD) - 2021/01/23 1:33:26 ET
Table 'Malzovia III' 6-max Seat #2 is the button
Seat 1: AvGeL ($11.42 in chips) 
Seat 2: NeMaProbl3ma ($1.05 in chips) 
Seat 3: oksuz77 ($4.88 in chips) 
Seat 4: MrBearJew ($10 in chips) 
Seat 5: petrovichkag ($14.52 in chips) 
Seat 6: YURufina ($13.22 in chips) 
oksuz77: posts small blind $0.05
MrBearJew: posts big blind $0.10
*** HOLE CARDS ***
petrovichkag: raises $0.14 to $0.24
YURufina: folds 
AvGeL: folds 
NeMaProbl3ma: folds 
oksuz77: calls $0.19
MrBearJew: calls $0.14
*** FLOP *** [8c 9h Qh]
oksuz77: checks 
MrBearJew: checks 
petrovichkag: bets $0.54
oksuz77: folds 
MrBearJew: calls $0.54
*** TURN *** [8c 9h Qh] [3c]
MrBearJew: checks 
petrovichkag: bets $1.34
MrBearJew: calls $1.34
*** RIVER *** [8c 9h Qh 3c] [7s]
MrBearJew: checks 
petrovichkag: checks 
*** SHOW DOWN ***
MrBearJew: shows [Td Th] (a pair of Tens)
petrovichkag: shows [Ah Ac] (a pair of Aces)
petrovichkag collected $4.28 from pot
*** SUMMARY ***
Total pot $4.48 | Rake $0.20 
Board [8c 9h Qh 3c 7s]
Seat 1: AvGeL folded before Flop (didn't bet)
Seat 2: NeMaProbl3ma (button) folded before Flop (didn't bet)
Seat 3: oksuz77 (small blind) folded on the Flop
Seat 4: MrBearJew (big blind) showed [Td Th] and lost with a pair of Tens
Seat 5: petrovichkag showed [Ah Ac] and won ($4.28) with a pair of Aces
Seat 6: YURufina folded before Flop (didn't bet)



PokerStars Hand #222946127794:  Hold'em No Limit ($0.05/$0.10 USD) - 2021/01/23 1:33:56 ET
Table 'Malzovia III' 6-max Seat #3 is the button
Seat 1: AvGeL ($11.42 in chips) 
Seat 2: NeMaProbl3ma ($1.05 in chips) 
Seat 3: oksuz77 ($4.64 in chips) 
Seat 4: MrBearJew ($7.88 in chips) 
Seat 5: petrovichkag ($16.68 in chips) 
Seat 6: YURufina ($13.22 in chips) 
MrBearJew: posts small blind $0.05
petrovichkag: posts big blind $0.10
*** HOLE CARDS ***
YURufina: raises $0.16 to $0.26
AvGeL: folds 
NeMaProbl3ma: calls $0.26
oksuz77: folds 
MrBearJew: folds 
petrovichkag: calls $0.16
*** FLOP *** [Jc As 5c]
petrovichkag: checks 
YURufina: checks 
NeMaProbl3ma: bets $0.30
petrovichkag: calls $0.30
YURufina: folds 
*** TURN *** [Jc As 5c] [2c]
petrovichkag: checks 
NeMaProbl3ma: bets $0.49 and is all-in
petrovichkag: calls $0.49
*** RIVER *** [Jc As 5c 2c] [Ac]
*** SHOW DOWN ***
petrovichkag: shows [8c Kc] (a flush, Ace high)
NeMaProbl3ma: shows [Ah 2h] (a full house, Aces full of Deuces)
NeMaProbl3ma collected $2.30 from pot
*** SUMMARY ***
Total pot $2.41 | Rake $0.11 
Board [Jc As 5c 2c Ac]
Seat 1: AvGeL folded before Flop (didn't bet)
Seat 2: NeMaProbl3ma showed [Ah 2h] and won ($2.30) with a full house, Aces full of Deuces
Seat 3: oksuz77 (button) folded before Flop (didn't bet)
Seat 4: MrBearJew (small blind) folded before Flop
Seat 5: petrovichkag (big blind) showed [8c Kc] and lost with a flush, Ace high
Seat 6: YURufina folded on the Flop



PokerStars Hand #222946136501:  Hold'em No Limit ($0.05/$0.10 USD) - 2021/01/23 1:34:32 ET
Table 'Malzovia III' 6-max Seat #4 is the button
Seat 1: AvGeL ($11.42 in chips) 
Seat 2: NeMaProbl3ma ($2.30 in chips) 
Seat 3: oksuz77 ($4.64 in chips) 
Seat 4: MrBearJew ($7.83 in chips) 
Seat 5: petrovichkag ($15.63 in chips) 
Seat 6: YURufina ($12.96 in chips) 
petrovichkag: posts small blind $0.05
YURufina: posts big blind $0.10
*** HOLE CARDS ***
AvGeL: folds 
NeMaProbl3ma: calls $0.10
oksuz77: calls $0.10
MrBearJew: calls $0.10
petrovichkag: folds 
YURufina: checks 
*** FLOP *** [8s 4h 6d]
YURufina: checks 
NeMaProbl3ma: bets $0.22
oksuz77: folds 
MrBearJew: folds 
YURufina: calls $0.22
*** TURN *** [8s 4h 6d] [4d]
YURufina: checks 
NeMaProbl3ma: bets $0.20
YURufina: raises $0.94 to $1.14
NeMaProbl3ma: calls $0.94
*** RIVER *** [8s 4h 6d 4d] [2c]
YURufina: bets $1.01
NeMaProbl3ma: folds 
Uncalled bet ($1.01) returned to YURufina
YURufina collected $3.03 from pot
*** SUMMARY ***
Total pot $3.17 | Rake $0.14 
Board [8s 4h 6d 4d 2c]
Seat 1: AvGeL folded before Flop (didn't bet)
Seat 2: NeMaProbl3ma folded on the River
Seat 3: oksuz77 folded on the Flop
Seat 4: MrBearJew (button) folded on the Flop
Seat 5: petrovichkag (small blind) folded before Flop
Seat 6: YURufina (big blind) collected ($3.03)



PokerStars Hand #222946150173:  Hold'em No Limit ($0.05/$0.10 USD) - 2021/01/23 1:35:29 ET
Table 'Malzovia III' 6-max Seat #5 is the button
Seat 1: AvGeL ($11.42 in chips) 
Seat 2: NeMaProbl3ma ($0.84 in chips) 
Seat 3: oksuz77 ($4.54 in chips) 
Seat 4: MrBearJew ($7.73 in chips) 
Seat 5: petrovichkag ($15.58 in chips) 
Seat 6: YURufina ($14.53 in chips) 
YURufina: posts small blind $0.05
AvGeL: posts big blind $0.10
*** HOLE CARDS ***
NeMaProbl3ma: calls $0.10
oksuz77: folds 
MrBearJew: calls $0.10
petrovichkag: folds 
YURufina: folds 
AvGeL: checks 
*** FLOP *** [7s Kc 9c]
AvGeL: checks 
NeMaProbl3ma: checks 
MrBearJew: checks 
*** TURN *** [7s Kc 9c] [5c]
AvGeL: checks 
NeMaProbl3ma: checks 
MrBearJew: bets $0.33
AvGeL: folds 
NeMaProbl3ma: calls $0.33
*** RIVER *** [7s Kc 9c 5c] [6c]
NeMaProbl3ma: checks 
MrBearJew: bets $0.96
NeMaProbl3ma: folds 
Uncalled bet ($0.96) returned to MrBearJew
MrBearJew collected $0.96 from pot
*** SUMMARY ***
Total pot $1.01 | Rake $0.05 
Board [7s Kc 9c 5c 6c]
Seat 1: AvGeL (big blind) folded on the Turn
Seat 2: NeMaProbl3ma folded on the River
Seat 3: oksuz77 folded before Flop (didn't bet)
Seat 4: MrBearJew collected ($0.96)
Seat 5: petrovichkag (button) folded before Flop (didn't bet)
Seat 6: YURufina (small blind) folded before Flop



PokerStars Hand #222946162263:  Hold'em No Limit ($0.05/$0.10 USD) - 2021/01/23 1:36:20 ET
Table 'Malzovia III' 6-max Seat #6 is the button
Seat 1: AvGeL ($11.32 in chips) 
Seat 2: NeMaProbl3ma ($0.41 in chips) 
Seat 3: oksuz77 ($4.54 in chips) 
Seat 4: MrBearJew ($8.26 in chips) 
Seat 5: petrovichkag ($15.58 in chips) 
Seat 6: YURufina ($14.48 in chips) 
AvGeL: posts small blind $0.05
NeMaProbl3ma: posts big blind $0.10
*** HOLE CARDS ***
oksuz77: calls $0.10
MrBearJew: folds 
petrovichkag: raises $0.30 to $0.40
YURufina: folds 
AvGeL: folds 
NeMaProbl3ma: folds 
oksuz77: calls $0.30
*** FLOP *** [Kh As Ah]
oksuz77: checks 
petrovichkag: bets $0.30
oksuz77: folds 
Uncalled bet ($0.30) returned to petrovichkag
petrovichkag collected $0.91 from pot
petrovichkag: doesn't show hand 
*** SUMMARY ***
Total pot $0.95 | Rake $0.04 
Board [Kh As Ah]
Seat 1: AvGeL (small blind) folded before Flop
Seat 2: NeMaProbl3ma (big blind) folded before Flop
Seat 3: oksuz77 folded on the Flop
Seat 4: MrBearJew folded before Flop (didn't bet)
Seat 5: petrovichkag collected ($0.91)
Seat 6: YURufina (button) folded before Flop (didn't bet)



PokerStars Hand #222946168396:  Hold'em No Limit ($0.05/$0.10 USD) - 2021/01/23 1:36:45 ET
Table 'Malzovia III' 6-max Seat #1 is the button
Seat 1: AvGeL ($11.27 in chips) 
Seat 2: NeMaProbl3ma ($0.31 in chips) 
Seat 3: oksuz77 ($4.14 in chips) 
Seat 4: MrBearJew ($8.26 in chips) 
Seat 5: petrovichkag ($16.09 in chips) 
Seat 6: YURufina ($14.48 in chips) 
NeMaProbl3ma: posts small blind $0.05
oksuz77: posts big blind $0.10
*** HOLE CARDS ***
MrBearJew: folds 
petrovichkag: folds 
YURufina: folds 
AvGeL: raises $0.20 to $0.30
NeMaProbl3ma: calls $0.25
oksuz77: calls $0.20
*** FLOP *** [Jc 9c 5d]
NeMaProbl3ma: checks 
oksuz77: bets $0.10
AvGeL: raises $0.80 to $0.90
NeMaProbl3ma: calls $0.01 and is all-in
oksuz77: folds 
Uncalled bet ($0.80) returned to AvGeL
*** TURN *** [Jc 9c 5d] [6s]
*** RIVER *** [Jc 9c 5d 6s] [8s]
*** SHOW DOWN ***
AvGeL: shows [Qc Qs] (a pair of Queens)
AvGeL collected $0.17 from side pot
NeMaProbl3ma: shows [Kh 2c] (high card King)
AvGeL collected $0.89 from main pot
*** SUMMARY ***
Total pot $1.11 Main pot $0.89. Side pot $0.17. | Rake $0.05 
Board [Jc 9c 5d 6s 8s]
Seat 1: AvGeL (button) showed [Qc Qs] and won ($1.06) with a pair of Queens
Seat 2: NeMaProbl3ma (small blind) showed [Kh 2c] and lost with high card King
Seat 3: oksuz77 (big blind) folded on the Flop
Seat 4: MrBearJew folded before Flop (didn't bet)
Seat 5: petrovichkag folded before Flop (didn't bet)
Seat 6: YURufina folded before Flop (didn't bet)



PokerStars Hand #222946179088:  Hold'em No Limit ($0.05/$0.10 USD) - 2021/01/23 1:37:30 ET
Table 'Malzovia III' 6-max Seat #3 is the button
Seat 1: AvGeL ($11.93 in chips) 
Seat 3: oksuz77 ($3.74 in chips) 
Seat 4: MrBearJew ($8.26 in chips) 
Seat 5: petrovichkag ($16.09 in chips) 
Seat 6: YURufina ($14.48 in chips) 
MrBearJew: posts small blind $0.05
petrovichkag: posts big blind $0.10
*** HOLE CARDS ***
YURufina: folds 
AvGeL: folds 
oksuz77: folds 
MrBearJew: raises $0.20 to $0.30
petrovichkag: folds 
Uncalled bet ($0.20) returned to MrBearJew
MrBearJew collected $0.20 from pot
*** SUMMARY ***
Total pot $0.20 | Rake $0 
Seat 1: AvGeL folded before Flop (didn't bet)
Seat 3: oksuz77 (button) folded before Flop (didn't bet)
Seat 4: MrBearJew (small blind) collected ($0.20)
Seat 5: petrovichkag (big blind) folded before Flop
Seat 6: YURufina folded before Flop (didn't bet)



PokerStars Hand #222946180807:  Hold'em No Limit ($0.05/$0.10 USD) - 2021/01/23 1:37:37 ET
Table 'Malzovia III' 6-max Seat #4 is the button
Seat 1: AvGeL ($11.93 in chips) 
Seat 3: oksuz77 ($3.74 in chips) 
Seat 4: MrBearJew ($8.36 in chips) 
Seat 5: petrovichkag ($15.99 in chips) 
Seat 6: YURufina ($14.48 in chips) 
petrovichkag: posts small blind $0.05
YURufina: posts big blind $0.10
*** HOLE CARDS ***
AvGeL: raises $0.20 to $0.30
oksuz77: folds 
MrBearJew: folds 
petrovichkag: folds 
YURufina: folds 
Uncalled bet ($0.20) returned to AvGeL
AvGeL collected $0.25 from pot
*** SUMMARY ***
Total pot $0.25 | Rake $0 
Seat 1: AvGeL collected ($0.25)
Seat 3: oksuz77 folded before Flop (didn't bet)
Seat 4: MrBearJew (button) folded before Flop (didn't bet)
Seat 5: petrovichkag (small blind) folded before Flop
Seat 6: YURufina (big blind) folded before Flop



PokerStars Hand #222946182681:  Hold'em No Limit ($0.05/$0.10 USD) - 2021/01/23 1:37:46 ET
Table 'Malzovia III' 6-max Seat #5 is the button
Seat 1: AvGeL ($12.08 in chips) 
Seat 3: oksuz77 ($3.74 in chips) 
Seat 4: MrBearJew ($8.36 in chips) 
Seat 5: petrovichkag ($15.94 in chips) 
Seat 6: YURufina ($14.38 in chips) 
YURufina: posts small blind $0.05
AvGeL: posts big blind $0.10
*** HOLE CARDS ***
oksuz77: folds 
MrBearJew: folds 
petrovichkag: folds 
YURufina: raises $0.16 to $0.26
AvGeL: folds 
Uncalled bet ($0.16) returned to YURufina
YURufina collected $0.20 from pot
*** SUMMARY ***
Total pot $0.20 | Rake $0 
Seat 1: AvGeL (big blind) folded before Flop
Seat 3: oksuz77 folded before Flop (didn't bet)
Seat 4: MrBearJew folded before Flop (didn't bet)
Seat 5: petrovichkag (button) folded before Flop (didn't bet)
Seat 6: YURufina (small blind) collected ($0.20)



PokerStars Hand #222946189856:  Hold'em No Limit ($0.05/$0.10 USD) - 2021/01/23 1:38:15 ET
Table 'Malzovia III' 6-max Seat #6 is the button
Seat 1: AvGeL ($11.98 in chips) 
Seat 3: oksuz77 ($3.74 in chips) 
Seat 4: MrBearJew ($8.36 in chips) 
Seat 5: petrovichkag ($15.94 in chips) 
Seat 6: YURufina ($14.48 in chips) 
AvGeL: posts small blind $0.05
oksuz77: posts big blind $0.10
*** HOLE CARDS ***
MrBearJew: folds 
petrovichkag: folds 
YURufina: folds 
AvGeL: folds 
Uncalled bet ($0.05) returned to oksuz77
oksuz77 collected $0.10 from pot
oksuz77: doesn't show hand 
*** SUMMARY ***
Total pot $0.10 | Rake $0 
Seat 1: AvGeL (small blind) folded before Flop
Seat 3: oksuz77 (big blind) collected ($0.10)
Seat 4: MrBearJew folded before Flop (didn't bet)
Seat 5: petrovichkag folded before Flop (didn't bet)
Seat 6: YURufina (button) folded before Flop (didn't bet)



PokerStars Hand #222946192658:  Hold'em No Limit ($0.05/$0.10 USD) - 2021/01/23 1:38:27 ET
Table 'Malzovia III' 6-max Seat #1 is the button
Seat 1: AvGeL ($11.93 in chips) 
Seat 3: oksuz77 ($3.79 in chips) 
Seat 4: MrBearJew ($8.36 in chips) 
Seat 5: petrovichkag ($15.94 in chips) 
Seat 6: YURufina ($14.48 in chips) 
oksuz77: posts small blind $0.05
MrBearJew: posts big blind $0.10
*** HOLE CARDS ***
petrovichkag: raises $0.14 to $0.24
YURufina: folds 
AvGeL: folds 
oksuz77: calls $0.19
MrBearJew: folds 
*** FLOP *** [9s Jd 7s]
MrBearJew leaves the table
oksuz77: checks 
Dumbass2012 joins the table at seat #4 
petrovichkag: bets $0.18
oksuz77: folds 
Uncalled bet ($0.18) returned to petrovichkag
petrovichkag collected $0.55 from pot
petrovichkag: doesn't show hand 
*** SUMMARY ***
Total pot $0.58 | Rake $0.03 
Board [9s Jd 7s]
Seat 1: AvGeL (button) folded before Flop (didn't bet)
Seat 3: oksuz77 (small blind) folded on the Flop
Seat 4: MrBearJew (big blind) folded before Flop
Seat 5: petrovichkag collected ($0.55)
Seat 6: YURufina folded before Flop (didn't bet)



PokerStars Hand #222946198781:  Hold'em No Limit ($0.05/$0.10 USD) - 2021/01/23 1:38:53 ET
Table 'Malzovia III' 6-max Seat #3 is the button
Seat 1: AvGeL ($11.93 in chips) 
Seat 3: oksuz77 ($3.55 in chips) 
Seat 5: petrovichkag ($16.25 in chips) 
petrovichkag: posts small blind $0.05
YURufina: is sitting out 
AvGeL: posts big blind $0.10
*** HOLE CARDS ***
oksuz77: folds 
YURufina leaves the table
petrovichkag: raises $0.20 to $0.30
AvGeL: folds 
Uncalled bet ($0.20) returned to petrovichkag
petrovichkag collected $0.20 from pot
petrovichkag: doesn't show hand 
*** SUMMARY ***
Total pot $0.20 | Rake $0 
Seat 1: AvGeL (big blind) folded before Flop
Seat 3: oksuz77 (button) folded before Flop (didn't bet)
Seat 5: petrovichkag (small blind) collected ($0.20)



PokerStars Hand #222946201100:  Hold'em No Limit ($0.05/$0.10 USD) - 2021/01/23 1:39:03 ET
Table 'Malzovia III' 6-max Seat #5 is the button
Seat 1: AvGeL ($11.83 in chips) 
Seat 3: oksuz77 ($3.55 in chips) 
Seat 5: petrovichkag ($16.35 in chips) 
AvGeL: posts small blind $0.05
oksuz77: posts big blind $0.10
Dumbass2012: sits out 
*** HOLE CARDS ***
petrovichkag: folds 
petrovichkag leaves the table
AvGeL: folds 
Uncalled bet ($0.05) returned to oksuz77
oksuz77 collected $0.10 from pot
oksuz77: doesn't show hand 
*** SUMMARY ***
Total pot $0.10 | Rake $0 
Seat 1: AvGeL (small blind) folded before Flop
Seat 3: oksuz77 (big blind) collected ($0.10)
Seat 5: petrovichkag (button) folded before Flop (didn't bet)



PokerStars Hand #222946202677:  Hold'em No Limit ($0.05/$0.10 USD) - 2021/01/23 1:39:09 ET
Table 'Malzovia III' 6-max Seat #1 is the button
Seat 1: AvGeL ($11.78 in chips) 
Seat 3: oksuz77 ($3.60 in chips) 
Seat 4: Dumbass2012 ($10 in chips) 
oksuz77: posts small blind $0.05
Dumbass2012: posts big blind $0.10
*** HOLE CARDS ***
AvGeL: raises $0.20 to $0.30
oksuz77: folds 
Dumbass2012: folds 
Uncalled bet ($0.20) returned to AvGeL
AvGeL collected $0.25 from pot
*** SUMMARY ***
Total pot $0.25 | Rake $0 
Seat 1: AvGeL (button) collected ($0.25)
Seat 3: oksuz77 (small blind) folded before Flop
Seat 4: Dumbass2012 (big blind) folded before Flop



PokerStars Hand #222946205146:  Hold'em No Limit ($0.05/$0.10 USD) - 2021/01/23 1:39:20 ET
Table 'Malzovia III' 6-max Seat #3 is the button
Seat 1: AvGeL ($11.93 in chips) 
Seat 3: oksuz77 ($3.55 in chips) 
Seat 4: Dumbass2012 ($10 in chips) 
Dumbass2012: posts small blind $0.05
AvGeL: posts big blind $0.10
*** HOLE CARDS ***
oksuz77: folds 
Dumbass2012: folds 
Uncalled bet ($0.05) returned to AvGeL
AvGeL collected $0.10 from pot
*** SUMMARY ***
Total pot $0.10 | Rake $0 
Seat 1: AvGeL (big blind) collected ($0.10)
Seat 3: oksuz77 (button) folded before Flop (didn't bet)
Seat 4: Dumbass2012 (small blind) folded before Flop



PokerStars Hand #222946207426:  Hold'em No Limit ($0.05/$0.10 USD) - 2021/01/23 1:39:29 ET
Table 'Malzovia III' 6-max Seat #4 is the button
Seat 1: AvGeL ($11.98 in chips) 
Seat 3: oksuz77 ($3.55 in chips) 
Seat 4: Dumbass2012 ($10 in chips) 
AvGeL: posts small blind $0.05
oksuz77: posts big blind $0.10
*** HOLE CARDS ***
Dumbass2012: folds 
AvGeL: folds 
Uncalled bet ($0.05) returned to oksuz77
oksuz77 collected $0.10 from pot
oksuz77: doesn't show hand 
*** SUMMARY ***
Total pot $0.10 | Rake $0 
Seat 1: AvGeL (small blind) folded before Flop
Seat 3: oksuz77 (big blind) collected ($0.10)
Seat 4: Dumbass2012 (button) folded before Flop (didn't bet)



PokerStars Hand #222945029332:  Hold'em No Limit ($0.05/$0.10 USD) - 2021/01/23 0:23:03 ET
Table 'Malzovia III' 6-max Seat #6 is the button
Seat 1: AvGeL ($13.04 in chips) 
Seat 2: ildar87kzn ($10.25 in chips) 
Seat 3: prokkky ($5.40 in chips) 
Seat 4: FeL.Ru ($8.97 in chips) 
Seat 5: Ifivecrypto ($8 in chips) 
Seat 6: kjohnson1409 ($13.80 in chips) 
AvGeL: posts small blind $0.05
ildar87kzn: posts big blind $0.10
*** HOLE CARDS ***
prokkky: raises $0.10 to $0.20
FeL.Ru: folds 
Ifivecrypto: folds 
kjohnson1409: folds 
AvGeL: folds 
ildar87kzn: folds 
Uncalled bet ($0.10) returned to prokkky
prokkky collected $0.25 from pot
prokkky: doesn't show hand 
*** SUMMARY ***
Total pot $0.25 | Rake $0 
Seat 1: AvGeL (small blind) folded before Flop
Seat 2: ildar87kzn (big blind) folded before Flop
Seat 3: prokkky collected ($0.25)
Seat 4: FeL.Ru folded before Flop (didn't bet)
Seat 5: Ifivecrypto folded before Flop (didn't bet)
Seat 6: kjohnson1409 (button) folded before Flop (didn't bet)



PokerStars Hand #222946991543:  Hold'em No Limit ($0.05/$0.10 USD) - 2021/01/23 2:35:31 ET
Table 'Malzovia III' 6-max Seat #4 is the button
Seat 1: Bannnkai ($10.10 in chips) 
Seat 3: oksuz77 ($1.52 in chips) 
Seat 4: beastboy3690 ($19.78 in chips) 
Seat 6: el_buchkan ($10.05 in chips) 
el_buchkan: posts small blind $0.05
Bannnkai: posts big blind $0.10
*** HOLE CARDS ***
oksuz77: folds 
beastboy3690: folds 
el_buchkan: raises $0.20 to $0.30
Bannnkai: calls $0.20
*** FLOP *** [6c Kc 4c]
el_buchkan: bets $0.23
Bannnkai: calls $0.23
*** TURN *** [6c Kc 4c] [5d]
el_buchkan: checks 
Bannnkai: bets $0.53
el_buchkan: folds 
Uncalled bet ($0.53) returned to Bannnkai
Bannnkai collected $1.01 from pot
Bannnkai: doesn't show hand 
*** SUMMARY ***
Total pot $1.06 | Rake $0.05 
Board [6c Kc 4c 5d]
Seat 1: Bannnkai (big blind) collected ($1.01)
Seat 3: oksuz77 folded before Flop (didn't bet)
Seat 4: beastboy3690 (button) folded before Flop (didn't bet)
Seat 6: el_buchkan (small blind) folded on the Turn



PokerStars Hand #222947004192:  Hold'em No Limit ($0.05/$0.10 USD) - 2021/01/23 2:36:26 ET
Table 'Malzovia III' 6-max Seat #6 is the button
Seat 1: Bannnkai ($10.58 in chips) 
Seat 3: oksuz77 ($1.52 in chips) 
Seat 4: beastboy3690 ($19.78 in chips) 
Seat 6: el_buchkan ($10 in chips) 
Bannnkai: posts small blind $0.05
oksuz77: posts big blind $0.10
*** HOLE CARDS ***
beastboy3690: folds 
el_buchkan: folds 
Bannnkai: folds 
Uncalled bet ($0.05) returned to oksuz77
oksuz77 collected $0.10 from pot
oksuz77: doesn't show hand 
*** SUMMARY ***
Total pot $0.10 | Rake $0 
Seat 1: Bannnkai (small blind) folded before Flop
Seat 3: oksuz77 (big blind) collected ($0.10)
Seat 4: beastboy3690 folded before Flop (didn't bet)
Seat 6: el_buchkan (button) folded before Flop (didn't bet)



PokerStars Hand #222947009046:  Hold'em No Limit ($0.05/$0.10 USD) - 2021/01/23 2:36:47 ET
Table 'Malzovia III' 6-max Seat #1 is the button
Seat 1: Bannnkai ($10.53 in chips) 
Seat 3: oksuz77 ($1.57 in chips) 
Seat 4: beastboy3690 ($19.78 in chips) 
Seat 6: el_buchkan ($10 in chips) 
oksuz77: posts small blind $0.05
beastboy3690: posts big blind $0.10
*** HOLE CARDS ***
el_buchkan: folds 
Bannnkai: folds 
oksuz77: folds 
Uncalled bet ($0.05) returned to beastboy3690
beastboy3690 collected $0.10 from pot
beastboy3690: doesn't show hand 
*** SUMMARY ***
Total pot $0.10 | Rake $0 
Seat 1: Bannnkai (button) folded before Flop (didn't bet)
Seat 3: oksuz77 (small blind) folded before Flop
Seat 4: beastboy3690 (big blind) collected ($0.10)
Seat 6: el_buchkan folded before Flop (didn't bet)



PokerStars Hand #222947013150:  Hold'em No Limit ($0.05/$0.10 USD) - 2021/01/23 2:37:05 ET
Table 'Malzovia III' 6-max Seat #3 is the button
Seat 1: Bannnkai ($10.53 in chips) 
Seat 3: oksuz77 ($1.52 in chips) 
Seat 4: beastboy3690 ($19.83 in chips) 
Seat 6: el_buchkan ($10 in chips) 
beastboy3690: posts small blind $0.05
el_buchkan: posts big blind $0.10
*** HOLE CARDS ***
Bannnkai: folds 
oksuz77: raises $1.42 to $1.52 and is all-in
beastboy3690: folds 
el_buchkan: folds 
Uncalled bet ($1.42) returned to oksuz77
oksuz77 collected $0.25 from pot
oksuz77: doesn't show hand 
*** SUMMARY ***
Total pot $0.25 | Rake $0 
Seat 1: Bannnkai folded before Flop (didn't bet)
Seat 3: oksuz77 (button) collected ($0.25)
Seat 4: beastboy3690 (small blind) folded before Flop
Seat 6: el_buchkan (big blind) folded before Flop



PokerStars Hand #222947018024:  Hold'em No Limit ($0.05/$0.10 USD) - 2021/01/23 2:37:26 ET
Table 'Malzovia III' 6-max Seat #4 is the button
Seat 1: Bannnkai ($10.53 in chips) 
Seat 3: oksuz77 ($1.67 in chips) 
Seat 4: beastboy3690 ($19.78 in chips) 
Seat 6: el_buchkan ($10 in chips) 
el_buchkan: posts small blind $0.05
Bannnkai: posts big blind $0.10
*** HOLE CARDS ***
oksuz77: folds 
beastboy3690: raises $0.15 to $0.25
el_buchkan: folds 
Bannnkai: folds 
Uncalled bet ($0.15) returned to beastboy3690
beastboy3690 collected $0.25 from pot
beastboy3690: doesn't show hand 
*** SUMMARY ***
Total pot $0.25 | Rake $0 
Seat 1: Bannnkai (big blind) folded before Flop
Seat 3: oksuz77 folded before Flop (didn't bet)
Seat 4: beastboy3690 (button) collected ($0.25)
Seat 6: el_buchkan (small blind) folded before Flop



PokerStars Hand #222947020294:  Hold'em No Limit ($0.05/$0.10 USD) - 2021/01/23 2:37:36 ET
Table 'Malzovia III' 6-max Seat #6 is the button
Seat 1: Bannnkai ($10.43 in chips) 
Seat 3: oksuz77 ($1.67 in chips) 
Seat 4: beastboy3690 ($19.93 in chips) 
Seat 6: el_buchkan ($10 in chips) 
Bannnkai: posts small blind $0.05
oksuz77: posts big blind $0.10
*** HOLE CARDS ***
beastboy3690: raises $0.20 to $0.30
el_buchkan: folds 
Bannnkai: folds 
oksuz77: folds 
Uncalled bet ($0.20) returned to beastboy3690
beastboy3690 collected $0.25 from pot
beastboy3690: doesn't show hand 
*** SUMMARY ***
Total pot $0.25 | Rake $0 
Seat 1: Bannnkai (small blind) folded before Flop
Seat 3: oksuz77 (big blind) folded before Flop
Seat 4: beastboy3690 collected ($0.25)
Seat 6: el_buchkan (button) folded before Flop (didn't bet)



PokerStars Hand #222947024055:  Hold'em No Limit ($0.05/$0.10 USD) - 2021/01/23 2:37:52 ET
Table 'Malzovia III' 6-max Seat #1 is the button
Seat 1: Bannnkai ($10.38 in chips) 
Seat 3: oksuz77 ($1.57 in chips) 
Seat 4: beastboy3690 ($20.08 in chips) 
Seat 6: el_buchkan ($10 in chips) 
oksuz77: posts small blind $0.05
beastboy3690: posts big blind $0.10
*** HOLE CARDS ***
el_buchkan: folds 
Bannnkai: folds 
oksuz77: folds 
Uncalled bet ($0.05) returned to beastboy3690
beastboy3690 collected $0.10 from pot
beastboy3690: doesn't show hand 
*** SUMMARY ***
Total pot $0.10 | Rake $0 
Seat 1: Bannnkai (button) folded before Flop (didn't bet)
Seat 3: oksuz77 (small blind) folded before Flop
Seat 4: beastboy3690 (big blind) collected ($0.10)
Seat 6: el_buchkan folded before Flop (didn't bet)



PokerStars Hand #222947025878:  Hold'em No Limit ($0.05/$0.10 USD) - 2021/01/23 2:38:00 ET
Table 'Malzovia III' 6-max Seat #3 is the button
Seat 1: Bannnkai ($10.38 in chips) 
Seat 3: oksuz77 ($1.52 in chips) 
Seat 4: beastboy3690 ($20.13 in chips) 
Seat 6: el_buchkan ($10 in chips) 
beastboy3690: posts small blind $0.05
el_buchkan: posts big blind $0.10
*** HOLE CARDS ***
Bannnkai: raises $0.20 to $0.30
oksuz77: folds 
beastboy3690: folds 
el_buchkan: folds 
Uncalled bet ($0.20) returned to Bannnkai
Bannnkai collected $0.25 from pot
Bannnkai: doesn't show hand 
*** SUMMARY ***
Total pot $0.25 | Rake $0 
Seat 1: Bannnkai collected ($0.25)
Seat 3: oksuz77 (button) folded before Flop (didn't bet)
Seat 4: beastboy3690 (small blind) folded before Flop
Seat 6: el_buchkan (big blind) folded before Flop



PokerStars Hand #222947029860:  Hold'em No Limit ($0.05/$0.10 USD) - 2021/01/23 2:38:17 ET
Table 'Malzovia III' 6-max Seat #4 is the button
Seat 1: Bannnkai ($10.53 in chips) 
Seat 3: oksuz77 ($1.52 in chips) 
Seat 4: beastboy3690 ($20.08 in chips) 
Seat 6: el_buchkan ($10 in chips) 
el_buchkan: posts small blind $0.05
Bannnkai: posts big blind $0.10
*** HOLE CARDS ***
oksuz77: folds 
Alexandr.mh joins the table at seat #5 
beastboy3690: raises $0.15 to $0.25
DrLevty joins the table at seat #2 
el_buchkan: calls $0.20
Bannnkai: folds 
*** FLOP *** [9h Qd 8d]
el_buchkan: checks 
beastboy3690: checks 
*** TURN *** [9h Qd 8d] [4h]
el_buchkan: bets $0.10
beastboy3690: folds 
Uncalled bet ($0.10) returned to el_buchkan
el_buchkan collected $0.57 from pot
el_buchkan: doesn't show hand 
*** SUMMARY ***
Total pot $0.60 | Rake $0.03 
Board [9h Qd 8d 4h]
Seat 1: Bannnkai (big blind) folded before Flop
Seat 3: oksuz77 folded before Flop (didn't bet)
Seat 4: beastboy3690 (button) folded on the Turn
Seat 6: el_buchkan (small blind) collected ($0.57)



PokerStars Hand #222947038918:  Hold'em No Limit ($0.05/$0.10 USD) - 2021/01/23 2:38:57 ET
Table 'Malzovia III' 6-max Seat #6 is the button
Seat 1: Bannnkai ($10.43 in chips) 
Seat 2: DrLevty ($10 in chips) 
Seat 3: oksuz77 ($1.52 in chips) 
Seat 4: beastboy3690 ($19.83 in chips) 
Seat 6: el_buchkan ($10.32 in chips) 
Bannnkai: posts small blind $0.05
DrLevty: posts big blind $0.10
Alexandr.mh: sits out 
*** HOLE CARDS ***
oksuz77: folds 
beastboy3690: raises $0.20 to $0.30
el_buchkan: folds 
Bannnkai: folds 
DrLevty: folds 
Uncalled bet ($0.20) returned to beastboy3690
beastboy3690 collected $0.25 from pot
beastboy3690: doesn't show hand 
*** SUMMARY ***
Total pot $0.25 | Rake $0 
Seat 1: Bannnkai (small blind) folded before Flop
Seat 2: DrLevty (big blind) folded before Flop
Seat 3: oksuz77 folded before Flop (didn't bet)
Seat 4: beastboy3690 collected ($0.25)
Seat 6: el_buchkan (button) folded before Flop (didn't bet)



PokerStars Hand #222947041854:  Hold'em No Limit ($0.05/$0.10 USD) - 2021/01/23 2:39:09 ET
Table 'Malzovia III' 6-max Seat #1 is the button
Seat 1: Bannnkai ($10.38 in chips) 
Seat 2: DrLevty ($10 in chips) 
Seat 3: oksuz77 ($1.52 in chips) 
Seat 4: beastboy3690 ($19.98 in chips) 
Seat 6: el_buchkan ($10.32 in chips) 
DrLevty: posts small blind $0.05
oksuz77: posts big blind $0.10
Alexandr.mh: sits out 
*** HOLE CARDS ***
Alexandr.mh leaves the table
beastboy3690: folds 
el_buchkan: folds 
Bannnkai: folds 
DrLevty: folds 
Uncalled bet ($0.05) returned to oksuz77
oksuz77 collected $0.10 from pot
oksuz77: doesn't show hand 
*** SUMMARY ***
Total pot $0.10 | Rake $0 
Seat 1: Bannnkai (button) folded before Flop (didn't bet)
Seat 2: DrLevty (small blind) folded before Flop
Seat 3: oksuz77 (big blind) collected ($0.10)
Seat 4: beastboy3690 folded before Flop (didn't bet)
Seat 6: el_buchkan folded before Flop (didn't bet)



PokerStars Hand #222947043726:  Hold'em No Limit ($0.05/$0.10 USD) - 2021/01/23 2:39:17 ET
Table 'Malzovia III' 6-max Seat #2 is the button
Seat 1: Bannnkai ($10.38 in chips) 
Seat 2: DrLevty ($10 in chips) 
Seat 3: oksuz77 ($1.57 in chips) 
Seat 4: beastboy3690 ($19.98 in chips) 
Seat 6: el_buchkan ($10.32 in chips) 
oksuz77: posts small blind $0.05
beastboy3690: posts big blind $0.10
*** HOLE CARDS ***
el_buchkan: folds 
Bannnkai: folds 
DrLevty: raises $0.20 to $0.30
oksuz77: folds 
levktv joins the table at seat #5 
beastboy3690: calls $0.20
*** FLOP *** [4s Jh Kd]
beastboy3690: checks 
DrLevty: bets $0.20
beastboy3690: folds 
Uncalled bet ($0.20) returned to DrLevty
DrLevty collected $0.62 from pot
DrLevty: doesn't show hand 
*** SUMMARY ***
Total pot $0.65 | Rake $0.03 
Board [4s Jh Kd]
Seat 1: Bannnkai folded before Flop (didn't bet)
Seat 2: DrLevty (button) collected ($0.62)
Seat 3: oksuz77 (small blind) folded before Flop
Seat 4: beastboy3690 (big blind) folded on the Flop
Seat 6: el_buchkan folded before Flop (didn't bet)



PokerStars Hand #222947056270:  Hold'em No Limit ($0.05/$0.10 USD) - 2021/01/23 2:40:11 ET
Table 'Malzovia III' 6-max Seat #3 is the button
Seat 1: Bannnkai ($10.38 in chips) 
Seat 2: DrLevty ($10.32 in chips) 
Seat 3: oksuz77 ($1.52 in chips) 
Seat 4: beastboy3690 ($19.68 in chips) 
Seat 5: levktv ($6.10 in chips) 
Seat 6: el_buchkan ($10.32 in chips) 
beastboy3690: posts small blind $0.05
levktv: posts big blind $0.10
*** HOLE CARDS ***
el_buchkan: raises $0.20 to $0.30
Bannnkai: folds 
DrLevty: folds 
oksuz77: folds 
beastboy3690: raises $0.90 to $1.20
levktv: folds 
el_buchkan: raises $2.50 to $3.70
beastboy3690: folds 
Uncalled bet ($2.50) returned to el_buchkan
el_buchkan collected $2.50 from pot
el_buchkan: doesn't show hand 
*** SUMMARY ***
Total pot $2.50 | Rake $0 
Seat 1: Bannnkai folded before Flop (didn't bet)
Seat 2: DrLevty folded before Flop (didn't bet)
Seat 3: oksuz77 (button) folded before Flop (didn't bet)
Seat 4: beastboy3690 (small blind) folded before Flop
Seat 5: levktv (big blind) folded before Flop
Seat 6: el_buchkan collected ($2.50)



PokerStars Hand #222947063419:  Hold'em No Limit ($0.05/$0.10 USD) - 2021/01/23 2:40:43 ET
Table 'Malzovia III' 6-max Seat #4 is the button
Seat 1: Bannnkai ($10.38 in chips) 
Seat 2: DrLevty ($10.32 in chips) 
Seat 3: oksuz77 ($1.52 in chips) 
Seat 4: beastboy3690 ($18.48 in chips) 
Seat 5: levktv ($6 in chips) 
Seat 6: el_buchkan ($11.62 in chips) 
levktv: posts small blind $0.05
el_buchkan: posts big blind $0.10
*** HOLE CARDS ***
Bannnkai: folds 
DrLevty: raises $0.20 to $0.30
oksuz77: folds 
beastboy3690: folds 
levktv: folds 
el_buchkan: folds 
Uncalled bet ($0.20) returned to DrLevty
DrLevty collected $0.25 from pot
DrLevty: doesn't show hand 
*** SUMMARY ***
Total pot $0.25 | Rake $0 
Seat 1: Bannnkai folded before Flop (didn't bet)
Seat 2: DrLevty collected ($0.25)
Seat 3: oksuz77 folded before Flop (didn't bet)
Seat 4: beastboy3690 (button) folded before Flop (didn't bet)
Seat 5: levktv (small blind) folded before Flop
Seat 6: el_buchkan (big blind) folded before Flop



PokerStars Hand #222947067724:  Hold'em No Limit ($0.05/$0.10 USD) - 2021/01/23 2:41:01 ET
Table 'Malzovia III' 6-max Seat #5 is the button
Seat 1: Bannnkai ($10.38 in chips) 
Seat 2: DrLevty ($10.47 in chips) 
Seat 3: oksuz77 ($1.52 in chips) 
Seat 4: beastboy3690 ($18.48 in chips) 
Seat 5: levktv ($5.95 in chips) 
Seat 6: el_buchkan ($11.52 in chips) 
el_buchkan: posts small blind $0.05
Bannnkai: posts big blind $0.10
*** HOLE CARDS ***
DrLevty: folds 
oksuz77: folds 
beastboy3690: folds 
levktv: folds 
el_buchkan: raises $0.20 to $0.30
Bannnkai: raises $0.60 to $0.90
el_buchkan: folds 
Uncalled bet ($0.60) returned to Bannnkai
Bannnkai collected $0.60 from pot
Bannnkai: doesn't show hand 
*** SUMMARY ***
Total pot $0.60 | Rake $0 
Seat 1: Bannnkai (big blind) collected ($0.60)
Seat 2: DrLevty folded before Flop (didn't bet)
Seat 3: oksuz77 folded before Flop (didn't bet)
Seat 4: beastboy3690 folded before Flop (didn't bet)
Seat 5: levktv (button) folded before Flop (didn't bet)
Seat 6: el_buchkan (small blind) folded before Flop



PokerStars Hand #222947079137:  Hold'em No Limit ($0.05/$0.10 USD) - 2021/01/23 2:41:50 ET
Table 'Malzovia III' 6-max Seat #6 is the button
Seat 1: Bannnkai ($10.68 in chips) 
Seat 2: DrLevty ($10.47 in chips) 
Seat 3: oksuz77 ($1.52 in chips) 
Seat 4: beastboy3690 ($18.48 in chips) 
Seat 5: levktv ($5.95 in chips) 
Seat 6: el_buchkan ($11.22 in chips) 
Bannnkai: posts small blind $0.05
DrLevty: posts big blind $0.10
*** HOLE CARDS ***
oksuz77: folds 
beastboy3690: folds 
levktv: folds 
el_buchkan: raises $0.15 to $0.25
Bannnkai: folds 
DrLevty: folds 
Uncalled bet ($0.15) returned to el_buchkan
el_buchkan collected $0.25 from pot
el_buchkan: doesn't show hand 
*** SUMMARY ***
Total pot $0.25 | Rake $0 
Seat 1: Bannnkai (small blind) folded before Flop
Seat 2: DrLevty (big blind) folded before Flop
Seat 3: oksuz77 folded before Flop (didn't bet)
Seat 4: beastboy3690 folded before Flop (didn't bet)
Seat 5: levktv folded before Flop (didn't bet)
Seat 6: el_buchkan (button) collected ($0.25)



PokerStars Hand #222947083263:  Hold'em No Limit ($0.05/$0.10 USD) - 2021/01/23 2:42:08 ET
Table 'Malzovia III' 6-max Seat #1 is the button
Seat 1: Bannnkai ($10.63 in chips) 
Seat 2: DrLevty ($10.37 in chips) 
Seat 3: oksuz77 ($1.52 in chips) 
Seat 4: beastboy3690 ($18.48 in chips) 
Seat 5: levktv ($5.95 in chips) 
Seat 6: el_buchkan ($11.37 in chips) 
DrLevty: posts small blind $0.05
oksuz77: posts big blind $0.10
*** HOLE CARDS ***
beastboy3690: folds 
levktv: folds 
el_buchkan: folds 
Bannnkai: raises $0.15 to $0.25
DrLevty: folds 
oksuz77: raises $1.27 to $1.52 and is all-in
Bannnkai: folds 
Uncalled bet ($1.27) returned to oksuz77
oksuz77 collected $0.55 from pot
oksuz77: doesn't show hand 
*** SUMMARY ***
Total pot $0.55 | Rake $0 
Seat 1: Bannnkai (button) folded before Flop
Seat 2: DrLevty (small blind) folded before Flop
Seat 3: oksuz77 (big blind) collected ($0.55)
Seat 4: beastboy3690 folded before Flop (didn't bet)
Seat 5: levktv folded before Flop (didn't bet)
Seat 6: el_buchkan folded before Flop (didn't bet)



PokerStars Hand #222947091157:  Hold'em No Limit ($0.05/$0.10 USD) - 2021/01/23 2:42:43 ET
Table 'Malzovia III' 6-max Seat #2 is the button
Seat 1: Bannnkai ($10.38 in chips) 
Seat 2: DrLevty ($10.32 in chips) 
Seat 3: oksuz77 ($1.82 in chips) 
Seat 4: beastboy3690 ($18.48 in chips) 
Seat 5: levktv ($5.95 in chips) 
Seat 6: el_buchkan ($11.37 in chips) 
oksuz77: posts small blind $0.05
beastboy3690: posts big blind $0.10
*** HOLE CARDS ***
levktv: folds 
el_buchkan: folds 
Bannnkai: folds 
DrLevty: raises $0.20 to $0.30
oksuz77: folds 
beastboy3690: folds 
Uncalled bet ($0.20) returned to DrLevty
DrLevty collected $0.25 from pot
DrLevty: doesn't show hand 
*** SUMMARY ***
Total pot $0.25 | Rake $0 
Seat 1: Bannnkai folded before Flop (didn't bet)
Seat 2: DrLevty (button) collected ($0.25)
Seat 3: oksuz77 (small blind) folded before Flop
Seat 4: beastboy3690 (big blind) folded before Flop
Seat 5: levktv folded before Flop (didn't bet)
Seat 6: el_buchkan folded before Flop (didn't bet)



PokerStars Hand #222947094080:  Hold'em No Limit ($0.05/$0.10 USD) - 2021/01/23 2:42:55 ET
Table 'Malzovia III' 6-max Seat #3 is the button
Seat 1: Bannnkai ($10.38 in chips) 
Seat 2: DrLevty ($10.47 in chips) 
Seat 3: oksuz77 ($1.77 in chips) 
Seat 4: beastboy3690 ($18.38 in chips) 
Seat 5: levktv ($5.95 in chips) 
Seat 6: el_buchkan ($11.37 in chips) 
beastboy3690: posts small blind $0.05
levktv: posts big blind $0.10
*** HOLE CARDS ***
el_buchkan: folds 
Bannnkai: folds 
DrLevty: folds 
oksuz77: folds 
beastboy3690: raises $0.20 to $0.30
levktv: folds 
Uncalled bet ($0.20) returned to beastboy3690
beastboy3690 collected $0.20 from pot
beastboy3690: doesn't show hand 
*** SUMMARY ***
Total pot $0.20 | Rake $0 
Seat 1: Bannnkai folded before Flop (didn't bet)
Seat 2: DrLevty folded before Flop (didn't bet)
Seat 3: oksuz77 (button) folded before Flop (didn't bet)
Seat 4: beastboy3690 (small blind) collected ($0.20)
Seat 5: levktv (big blind) folded before Flop
Seat 6: el_buchkan folded before Flop (didn't bet)



PokerStars Hand #222947097902:  Hold'em No Limit ($0.05/$0.10 USD) - 2021/01/23 2:43:12 ET
Table 'Malzovia III' 6-max Seat #4 is the button
Seat 1: Bannnkai ($10.38 in chips) 
Seat 2: DrLevty ($10.47 in chips) 
Seat 3: oksuz77 ($1.77 in chips) 
Seat 4: beastboy3690 ($18.48 in chips) 
Seat 5: levktv ($5.85 in chips) 
Seat 6: el_buchkan ($11.37 in chips) 
levktv: posts small blind $0.05
el_buchkan: posts big blind $0.10
*** HOLE CARDS ***
Bannnkai: folds 
DrLevty: folds 
oksuz77: folds 
beastboy3690: folds 
levktv: folds 
Uncalled bet ($0.05) returned to el_buchkan
el_buchkan collected $0.10 from pot
el_buchkan: doesn't show hand 
*** SUMMARY ***
Total pot $0.10 | Rake $0 
Seat 1: Bannnkai folded before Flop (didn't bet)
Seat 2: DrLevty folded before Flop (didn't bet)
Seat 3: oksuz77 folded before Flop (didn't bet)
Seat 4: beastboy3690 (button) folded before Flop (didn't bet)
Seat 5: levktv (small blind) folded before Flop
Seat 6: el_buchkan (big blind) collected ($0.10)



PokerStars Hand #222947100640:  Hold'em No Limit ($0.05/$0.10 USD) - 2021/01/23 2:43:24 ET
Table 'Malzovia III' 6-max Seat #5 is the button
Seat 1: Bannnkai ($10.38 in chips) 
Seat 2: DrLevty ($10.47 in chips) 
Seat 3: oksuz77 ($1.77 in chips) 
Seat 4: beastboy3690 ($18.48 in chips) 
Seat 5: levktv ($5.80 in chips) 
Seat 6: el_buchkan ($11.42 in chips) 
el_buchkan: posts small blind $0.05
Bannnkai: posts big blind $0.10
*** HOLE CARDS ***
DrLevty: folds 
oksuz77: folds 
beastboy3690: folds 
levktv: folds 
el_buchkan: raises $0.20 to $0.30
Bannnkai: folds 
Uncalled bet ($0.20) returned to el_buchkan
el_buchkan collected $0.20 from pot
el_buchkan: doesn't show hand 
*** SUMMARY ***
Total pot $0.20 | Rake $0 
Seat 1: Bannnkai (big blind) folded before Flop
Seat 2: DrLevty folded before Flop (didn't bet)
Seat 3: oksuz77 folded before Flop (didn't bet)
Seat 4: beastboy3690 folded before Flop (didn't bet)
Seat 5: levktv (button) folded before Flop (didn't bet)
Seat 6: el_buchkan (small blind) collected ($0.20)



PokerStars Hand #222947106690:  Hold'em No Limit ($0.05/$0.10 USD) - 2021/01/23 2:43:50 ET
Table 'Malzovia III' 6-max Seat #6 is the button
Seat 1: Bannnkai ($10.28 in chips) 
Seat 2: DrLevty ($10.47 in chips) 
Seat 3: oksuz77 ($1.77 in chips) 
Seat 4: beastboy3690 ($18.48 in chips) 
Seat 5: levktv ($5.80 in chips) 
Seat 6: el_buchkan ($11.52 in chips) 
Bannnkai: posts small blind $0.05
DrLevty: posts big blind $0.10
*** HOLE CARDS ***
oksuz77: folds 
beastboy3690: folds 
levktv: raises $0.20 to $0.30
el_buchkan: folds 
Bannnkai: folds 
DrLevty: calls $0.20
*** FLOP *** [Kh 7d 3s]
DrLevty: checks 
levktv: bets $0.25
DrLevty: folds 
Uncalled bet ($0.25) returned to levktv
levktv collected $0.62 from pot
levktv: doesn't show hand 
*** SUMMARY ***
Total pot $0.65 | Rake $0.03 
Board [Kh 7d 3s]
Seat 1: Bannnkai (small blind) folded before Flop
Seat 2: DrLevty (big blind) folded on the Flop
Seat 3: oksuz77 folded before Flop (didn't bet)
Seat 4: beastboy3690 folded before Flop (didn't bet)
Seat 5: levktv collected ($0.62)
Seat 6: el_buchkan (button) folded before Flop (didn't bet)



PokerStars Hand #222947113192:  Hold'em No Limit ($0.05/$0.10 USD) - 2021/01/23 2:44:18 ET
Table 'Malzovia III' 6-max Seat #1 is the button
Seat 1: Bannnkai ($10.23 in chips) 
Seat 2: DrLevty ($10.17 in chips) 
Seat 3: oksuz77 ($1.77 in chips) 
Seat 4: beastboy3690 ($18.48 in chips) 
Seat 5: levktv ($6.12 in chips) 
Seat 6: el_buchkan ($11.52 in chips) 
DrLevty: posts small blind $0.05
oksuz77: posts big blind $0.10
*** HOLE CARDS ***
beastboy3690: folds 
levktv: raises $0.20 to $0.30
el_buchkan: folds 
Bannnkai: folds 
DrLevty: folds 
oksuz77: folds 
Uncalled bet ($0.20) returned to levktv
levktv collected $0.25 from pot
levktv: doesn't show hand 
*** SUMMARY ***
Total pot $0.25 | Rake $0 
Seat 1: Bannnkai (button) folded before Flop (didn't bet)
Seat 2: DrLevty (small blind) folded before Flop
Seat 3: oksuz77 (big blind) folded before Flop
Seat 4: beastboy3690 folded before Flop (didn't bet)
Seat 5: levktv collected ($0.25)
Seat 6: el_buchkan folded before Flop (didn't bet)



PokerStars Hand #222947117021:  Hold'em No Limit ($0.05/$0.10 USD) - 2021/01/23 2:44:34 ET
Table 'Malzovia III' 6-max Seat #2 is the button
Seat 1: Bannnkai ($10.23 in chips) 
Seat 2: DrLevty ($10.12 in chips) 
Seat 3: oksuz77 ($1.67 in chips) 
Seat 4: beastboy3690 ($18.48 in chips) 
Seat 5: levktv ($6.27 in chips) 
Seat 6: el_buchkan ($11.52 in chips) 
oksuz77: posts small blind $0.05
beastboy3690: posts big blind $0.10
*** HOLE CARDS ***
levktv: folds 
el_buchkan: folds 
Bannnkai: folds 
DrLevty: raises $0.20 to $0.30
oksuz77: folds 
beastboy3690: folds 
Uncalled bet ($0.20) returned to DrLevty
DrLevty collected $0.25 from pot
DrLevty: doesn't show hand 
*** SUMMARY ***
Total pot $0.25 | Rake $0 
Seat 1: Bannnkai folded before Flop (didn't bet)
Seat 2: DrLevty (button) collected ($0.25)
Seat 3: oksuz77 (small blind) folded before Flop
Seat 4: beastboy3690 (big blind) folded before Flop
Seat 5: levktv folded before Flop (didn't bet)
Seat 6: el_buchkan folded before Flop (didn't bet)



PokerStars Hand #222947120385:  Hold'em No Limit ($0.05/$0.10 USD) - 2021/01/23 2:44:49 ET
Table 'Malzovia III' 6-max Seat #3 is the button
Seat 1: Bannnkai ($10.23 in chips) 
Seat 2: DrLevty ($10.27 in chips) 
Seat 3: oksuz77 ($1.62 in chips) 
Seat 4: beastboy3690 ($18.38 in chips) 
Seat 5: levktv ($6.27 in chips) 
Seat 6: el_buchkan ($11.52 in chips) 
beastboy3690: posts small blind $0.05
levktv: posts big blind $0.10
*** HOLE CARDS ***
el_buchkan: folds 
Bannnkai: folds 
DrLevty: folds 
oksuz77: folds 
beastboy3690: raises $0.20 to $0.30
levktv: calls $0.20
*** FLOP *** [Ac Ks 3c]
beastboy3690: bets $0.19
levktv: calls $0.19
*** TURN *** [Ac Ks 3c] [6d]
beastboy3690: checks 
levktv: bets $0.38
beastboy3690: folds 
Uncalled bet ($0.38) returned to levktv
levktv collected $0.94 from pot
levktv: doesn't show hand 
*** SUMMARY ***
Total pot $0.98 | Rake $0.04 
Board [Ac Ks 3c 6d]
Seat 1: Bannnkai folded before Flop (didn't bet)
Seat 2: DrLevty folded before Flop (didn't bet)
Seat 3: oksuz77 (button) folded before Flop (didn't bet)
Seat 4: beastboy3690 (small blind) folded on the Turn
Seat 5: levktv (big blind) collected ($0.94)
Seat 6: el_buchkan folded before Flop (didn't bet)



PokerStars Hand #222947129228:  Hold'em No Limit ($0.05/$0.10 USD) - 2021/01/23 2:45:27 ET
Table 'Malzovia III' 6-max Seat #4 is the button
Seat 1: Bannnkai ($10.23 in chips) 
Seat 2: DrLevty ($10.27 in chips) 
Seat 3: oksuz77 ($1.62 in chips) 
Seat 4: beastboy3690 ($17.89 in chips) 
Seat 5: levktv ($6.72 in chips) 
Seat 6: el_buchkan ($11.52 in chips) 
levktv: posts small blind $0.05
el_buchkan: posts big blind $0.10
*** HOLE CARDS ***
Bannnkai: folds 
DrLevty: folds 
oksuz77: folds 
beastboy3690: folds 
levktv: folds 
Uncalled bet ($0.05) returned to el_buchkan
el_buchkan collected $0.10 from pot
el_buchkan: doesn't show hand 
*** SUMMARY ***
Total pot $0.10 | Rake $0 
Seat 1: Bannnkai folded before Flop (didn't bet)
Seat 2: DrLevty folded before Flop (didn't bet)
Seat 3: oksuz77 folded before Flop (didn't bet)
Seat 4: beastboy3690 (button) folded before Flop (didn't bet)
Seat 5: levktv (small blind) folded before Flop
Seat 6: el_buchkan (big blind) collected ($0.10)



PokerStars Hand #222947131952:  Hold'em No Limit ($0.05/$0.10 USD) - 2021/01/23 2:45:38 ET
Table 'Malzovia III' 6-max Seat #5 is the button
Seat 1: Bannnkai ($10.23 in chips) 
Seat 2: DrLevty ($10.27 in chips) 
Seat 3: oksuz77 ($1.62 in chips) 
Seat 4: beastboy3690 ($17.89 in chips) 
Seat 5: levktv ($6.67 in chips) 
Seat 6: el_buchkan ($11.57 in chips) 
el_buchkan: posts small blind $0.05
Bannnkai: posts big blind $0.10
*** HOLE CARDS ***
DrLevty: folds 
oksuz77: raises $1.52 to $1.62 and is all-in
beastboy3690: folds 
levktv: folds 
el_buchkan: folds 
Bannnkai: folds 
Uncalled bet ($1.52) returned to oksuz77
oksuz77 collected $0.25 from pot
oksuz77: doesn't show hand 
*** SUMMARY ***
Total pot $0.25 | Rake $0 
Seat 1: Bannnkai (big blind) folded before Flop
Seat 2: DrLevty folded before Flop (didn't bet)
Seat 3: oksuz77 collected ($0.25)
Seat 4: beastboy3690 folded before Flop (didn't bet)
Seat 5: levktv (button) folded before Flop (didn't bet)
Seat 6: el_buchkan (small blind) folded before Flop



PokerStars Hand #222947137296:  Hold'em No Limit ($0.05/$0.10 USD) - 2021/01/23 2:46:01 ET
Table 'Malzovia III' 6-max Seat #6 is the button
Seat 1: Bannnkai ($10.13 in chips) 
Seat 2: DrLevty ($10.27 in chips) 
Seat 3: oksuz77 ($1.77 in chips) 
Seat 4: beastboy3690 ($17.89 in chips) 
Seat 5: levktv ($6.67 in chips) 
Seat 6: el_buchkan ($11.52 in chips) 
Bannnkai: posts small blind $0.05
DrLevty: posts big blind $0.10
*** HOLE CARDS ***
oksuz77: folds 
beastboy3690: folds 
levktv: folds 
el_buchkan: raises $0.15 to $0.25
Bannnkai: folds 
DrLevty: calls $0.15
*** FLOP *** [3c Td Jd]
DrLevty: checks 
el_buchkan: bets $0.42
DrLevty: folds 
Uncalled bet ($0.42) returned to el_buchkan
el_buchkan collected $0.53 from pot
el_buchkan: doesn't show hand 
*** SUMMARY ***
Total pot $0.55 | Rake $0.02 
Board [3c Td Jd]
Seat 1: Bannnkai (small blind) folded before Flop
Seat 2: DrLevty (big blind) folded on the Flop
Seat 3: oksuz77 folded before Flop (didn't bet)
Seat 4: beastboy3690 folded before Flop (didn't bet)
Seat 5: levktv folded before Flop (didn't bet)
Seat 6: el_buchkan (button) collected ($0.53)



PokerStars Hand #222947142653:  Hold'em No Limit ($0.05/$0.10 USD) - 2021/01/23 2:46:23 ET
Table 'Malzovia III' 6-max Seat #1 is the button
Seat 1: Bannnkai ($10.08 in chips) 
Seat 2: DrLevty ($10.02 in chips) 
Seat 3: oksuz77 ($1.77 in chips) 
Seat 4: beastboy3690 ($17.89 in chips) 
Seat 5: levktv ($6.67 in chips) 
Seat 6: el_buchkan ($11.80 in chips) 
DrLevty: posts small blind $0.05
oksuz77: posts big blind $0.10
*** HOLE CARDS ***
beastboy3690: folds 
levktv: folds 
el_buchkan: raises $0.20 to $0.30
Bannnkai: folds 
DrLevty: folds 
oksuz77: folds 
Uncalled bet ($0.20) returned to el_buchkan
el_buchkan collected $0.25 from pot
el_buchkan: doesn't show hand 
*** SUMMARY ***
Total pot $0.25 | Rake $0 
Seat 1: Bannnkai (button) folded before Flop (didn't bet)
Seat 2: DrLevty (small blind) folded before Flop
Seat 3: oksuz77 (big blind) folded before Flop
Seat 4: beastboy3690 folded before Flop (didn't bet)
Seat 5: levktv folded before Flop (didn't bet)
Seat 6: el_buchkan collected ($0.25)



PokerStars Hand #222947144887:  Hold'em No Limit ($0.05/$0.10 USD) - 2021/01/23 2:46:33 ET
Table 'Malzovia III' 6-max Seat #2 is the button
Seat 1: Bannnkai ($10.08 in chips) 
Seat 2: DrLevty ($10 in chips) 
Seat 3: oksuz77 ($1.67 in chips) 
Seat 4: beastboy3690 ($17.89 in chips) 
Seat 5: levktv ($6.67 in chips) 
Seat 6: el_buchkan ($11.95 in chips) 
oksuz77: posts small blind $0.05
beastboy3690: posts big blind $0.10
*** HOLE CARDS ***
levktv: raises $0.20 to $0.30
el_buchkan: folds 
Bannnkai has timed out
Bannnkai: folds 
DrLevty: folds 
oksuz77: folds 
beastboy3690: folds 
Uncalled bet ($0.20) returned to levktv
levktv collected $0.25 from pot
levktv: doesn't show hand 
*** SUMMARY ***
Total pot $0.25 | Rake $0 
Seat 1: Bannnkai folded before Flop (didn't bet)
Seat 2: DrLevty (button) folded before Flop (didn't bet)
Seat 3: oksuz77 (small blind) folded before Flop
Seat 4: beastboy3690 (big blind) folded before Flop
Seat 5: levktv collected ($0.25)
Seat 6: el_buchkan folded before Flop (didn't bet)



PokerStars Hand #222944624010:  Hold'em No Limit ($0.05/$0.10 USD) - 2021/01/23 0:00:03 ET
Table 'Malzovia III' 6-max Seat #2 is the button
Seat 1: AvGeL ($10.22 in chips) 
Seat 2: ildar87kzn ($11.92 in chips) 
Seat 3: Ger Cortes ($10 in chips) 
Seat 4: Renzo1529 ($10.14 in chips) 
Seat 5: Ifivecrypto ($4.31 in chips) 
Seat 6: kjohnson1409 ($16.27 in chips) 
Ger Cortes: posts small blind $0.05
Renzo1529: posts big blind $0.10
*** HOLE CARDS ***
Ifivecrypto: calls $0.10
kjohnson1409: folds 
AvGeL: folds 
ildar87kzn: raises $0.35 to $0.45
Ger Cortes: folds 
Renzo1529: folds 
Ifivecrypto: calls $0.35
*** FLOP *** [9h Ah Js]
Ifivecrypto: checks 
ildar87kzn: bets $0.51
Ifivecrypto: calls $0.51
*** TURN *** [9h Ah Js] [7d]
Ifivecrypto: bets $3.35 and is all-in
ildar87kzn: folds 
Uncalled bet ($3.35) returned to Ifivecrypto
Ifivecrypto collected $1.98 from pot
Ifivecrypto: doesn't show hand 
*** SUMMARY ***
Total pot $2.07 | Rake $0.09 
Board [9h Ah Js 7d]
Seat 1: AvGeL folded before Flop (didn't bet)
Seat 2: ildar87kzn (button) folded on the Turn
Seat 3: Ger Cortes (small blind) folded before Flop
Seat 4: Renzo1529 (big blind) folded before Flop
Seat 5: Ifivecrypto collected ($1.98)
Seat 6: kjohnson1409 folded before Flop (didn't bet)



PokerStars Hand #222944654833:  Hold'em No Limit ($0.05/$0.10 USD) - 2021/01/23 0:01:24 ET
Table 'Malzovia III' 6-max Seat #3 is the button
Seat 1: AvGeL ($10.22 in chips) 
Seat 2: ildar87kzn ($10.96 in chips) 
Seat 3: Ger Cortes ($10 in chips) 
Seat 4: Renzo1529 ($10.04 in chips) 
Seat 5: Ifivecrypto ($5.33 in chips) 
Seat 6: kjohnson1409 ($16.27 in chips) 
Renzo1529: posts small blind $0.05
Ifivecrypto: posts big blind $0.10
*** HOLE CARDS ***
kjohnson1409: folds 
AvGeL: folds 
ildar87kzn: folds 
Ger Cortes: folds 
Renzo1529: folds 
Uncalled bet ($0.05) returned to Ifivecrypto
Ifivecrypto collected $0.10 from pot
Ifivecrypto: doesn't show hand 
*** SUMMARY ***
Total pot $0.10 | Rake $0 
Seat 1: AvGeL folded before Flop (didn't bet)
Seat 2: ildar87kzn folded before Flop (didn't bet)
Seat 3: Ger Cortes (button) folded before Flop (didn't bet)
Seat 4: Renzo1529 (small blind) folded before Flop
Seat 5: Ifivecrypto (big blind) collected ($0.10)
Seat 6: kjohnson1409 folded before Flop (didn't bet)



PokerStars Hand #222944663490:  Hold'em No Limit ($0.05/$0.10 USD) - 2021/01/23 0:01:55 ET
Table 'Malzovia III' 6-max Seat #4 is the button
Seat 1: AvGeL ($10.22 in chips) 
Seat 2: ildar87kzn ($10.96 in chips) 
Seat 3: Ger Cortes ($10 in chips) 
Seat 4: Renzo1529 ($9.99 in chips) 
Seat 5: Ifivecrypto ($5.38 in chips) 
Seat 6: kjohnson1409 ($16.27 in chips) 
Ifivecrypto: posts small blind $0.05
kjohnson1409: posts big blind $0.10
*** HOLE CARDS ***
AvGeL: folds 
ildar87kzn: folds 
Ger Cortes: folds 
Renzo1529: folds 
Ifivecrypto: folds 
Uncalled bet ($0.05) returned to kjohnson1409
kjohnson1409 collected $0.10 from pot
kjohnson1409: doesn't show hand 
*** SUMMARY ***
Total pot $0.10 | Rake $0 
Seat 1: AvGeL folded before Flop (didn't bet)
Seat 2: ildar87kzn folded before Flop (didn't bet)
Seat 3: Ger Cortes folded before Flop (didn't bet)
Seat 4: Renzo1529 (button) folded before Flop (didn't bet)
Seat 5: Ifivecrypto (small blind) folded before Flop
Seat 6: kjohnson1409 (big blind) collected ($0.10)



PokerStars Hand #222944668412:  Hold'em No Limit ($0.05/$0.10 USD) - 2021/01/23 0:02:13 ET
Table 'Malzovia III' 6-max Seat #5 is the button
Seat 1: AvGeL ($10.22 in chips) 
Seat 2: ildar87kzn ($10.96 in chips) 
Seat 3: Ger Cortes ($10 in chips) 
Seat 4: Renzo1529 ($9.99 in chips) 
Seat 5: Ifivecrypto ($5.33 in chips) 
Seat 6: kjohnson1409 ($16.32 in chips) 
kjohnson1409: posts small blind $0.05
AvGeL: posts big blind $0.10
*** HOLE CARDS ***
ildar87kzn: folds 
Ger Cortes: raises $0.15 to $0.25
Renzo1529: folds 
Ifivecrypto: folds 
kjohnson1409: folds 
AvGeL: folds 
Uncalled bet ($0.15) returned to Ger Cortes
Ger Cortes collected $0.25 from pot
*** SUMMARY ***
Total pot $0.25 | Rake $0 
Seat 1: AvGeL (big blind) folded before Flop
Seat 2: ildar87kzn folded before Flop (didn't bet)
Seat 3: Ger Cortes collected ($0.25)
Seat 4: Renzo1529 folded before Flop (didn't bet)
Seat 5: Ifivecrypto (button) folded before Flop (didn't bet)
Seat 6: kjohnson1409 (small blind) folded before Flop



PokerStars Hand #222944675211:  Hold'em No Limit ($0.05/$0.10 USD) - 2021/01/23 0:02:37 ET
Table 'Malzovia III' 6-max Seat #6 is the button
Seat 1: AvGeL ($10.12 in chips) 
Seat 2: ildar87kzn ($10.96 in chips) 
Seat 3: Ger Cortes ($10.15 in chips) 
Seat 4: Renzo1529 ($9.99 in chips) 
Seat 5: Ifivecrypto ($5.33 in chips) 
Seat 6: kjohnson1409 ($16.27 in chips) 
AvGeL: posts small blind $0.05
ildar87kzn: posts big blind $0.10
*** HOLE CARDS ***
Ger Cortes: folds 
Renzo1529: calls $0.10
Ifivecrypto: folds 
kjohnson1409: folds 
AvGeL: folds 
ildar87kzn: raises $0.60 to $0.70
Renzo1529: folds 
Uncalled bet ($0.60) returned to ildar87kzn
ildar87kzn collected $0.25 from pot
ildar87kzn: doesn't show hand 
*** SUMMARY ***
Total pot $0.25 | Rake $0 
Seat 1: AvGeL (small blind) folded before Flop
Seat 2: ildar87kzn (big blind) collected ($0.25)
Seat 3: Ger Cortes folded before Flop (didn't bet)
Seat 4: Renzo1529 folded before Flop
Seat 5: Ifivecrypto folded before Flop (didn't bet)
Seat 6: kjohnson1409 (button) folded before Flop (didn't bet)



PokerStars Hand #222944685157:  Hold'em No Limit ($0.05/$0.10 USD) - 2021/01/23 0:03:13 ET
Table 'Malzovia III' 6-max Seat #1 is the button
Seat 1: AvGeL ($10.07 in chips) 
Seat 2: ildar87kzn ($11.11 in chips) 
Seat 3: Ger Cortes ($10.15 in chips) 
Seat 4: Renzo1529 ($9.89 in chips) 
Seat 5: Ifivecrypto ($5.33 in chips) 
Seat 6: kjohnson1409 ($16.27 in chips) 
ildar87kzn: posts small blind $0.05
Ger Cortes: posts big blind $0.10
*** HOLE CARDS ***
Renzo1529: folds 
Ifivecrypto: folds 
kjohnson1409: folds 
AvGeL: folds 
ildar87kzn: folds 
Uncalled bet ($0.05) returned to Ger Cortes
Ger Cortes collected $0.10 from pot
*** SUMMARY ***
Total pot $0.10 | Rake $0 
Seat 1: AvGeL (button) folded before Flop (didn't bet)
Seat 2: ildar87kzn (small blind) folded before Flop
Seat 3: Ger Cortes (big blind) collected ($0.10)
Seat 4: Renzo1529 folded before Flop (didn't bet)
Seat 5: Ifivecrypto folded before Flop (didn't bet)
Seat 6: kjohnson1409 folded before Flop (didn't bet)



PokerStars Hand #222944689980:  Hold'em No Limit ($0.05/$0.10 USD) - 2021/01/23 0:03:30 ET
Table 'Malzovia III' 6-max Seat #2 is the button
Seat 1: AvGeL ($10.07 in chips) 
Seat 2: ildar87kzn ($11.06 in chips) 
Seat 3: Ger Cortes ($10.20 in chips) 
Seat 4: Renzo1529 ($9.89 in chips) 
Seat 5: Ifivecrypto ($5.33 in chips) 
Seat 6: kjohnson1409 ($16.27 in chips) 
Ger Cortes: posts small blind $0.05
Renzo1529: posts big blind $0.10
*** HOLE CARDS ***
Ifivecrypto: folds 
kjohnson1409: folds 
AvGeL: raises $0.15 to $0.25
ildar87kzn: folds 
Ger Cortes: folds 
Renzo1529: calls $0.15
*** FLOP *** [9c 9h Qh]
Renzo1529: checks 
AvGeL: bets $0.27
Renzo1529: folds 
Uncalled bet ($0.27) returned to AvGeL
AvGeL collected $0.53 from pot
*** SUMMARY ***
Total pot $0.55 | Rake $0.02 
Board [9c 9h Qh]
Seat 1: AvGeL collected ($0.53)
Seat 2: ildar87kzn (button) folded before Flop (didn't bet)
Seat 3: Ger Cortes (small blind) folded before Flop
Seat 4: Renzo1529 (big blind) folded on the Flop
Seat 5: Ifivecrypto folded before Flop (didn't bet)
Seat 6: kjohnson1409 folded before Flop (didn't bet)



PokerStars Hand #222944707665:  Hold'em No Limit ($0.05/$0.10 USD) - 2021/01/23 0:03:57 ET
Table 'Malzovia III' 6-max Seat #3 is the button
Seat 1: AvGeL ($10.35 in chips) 
Seat 2: ildar87kzn ($11.06 in chips) 
Seat 3: Ger Cortes ($10.15 in chips) 
Seat 4: Renzo1529 ($9.64 in chips) 
Seat 5: Ifivecrypto ($5.33 in chips) 
Seat 6: kjohnson1409 ($16.27 in chips) 
Renzo1529: posts small blind $0.05
Ifivecrypto: posts big blind $0.10
*** HOLE CARDS ***
kjohnson1409: raises $0.20 to $0.30
AvGeL: raises $0.60 to $0.90
ildar87kzn: folds 
Ger Cortes: folds 
Renzo1529: folds 
Ifivecrypto: calls $0.80
kjohnson1409: folds 
*** FLOP *** [8h Td Ad]
Ifivecrypto: checks 
AvGeL: bets $1.03
Ifivecrypto: calls $1.03
*** TURN *** [8h Td Ad] [Jc]
Ifivecrypto: bets $3.40 and is all-in
AvGeL: folds 
Uncalled bet ($3.40) returned to Ifivecrypto
Ifivecrypto collected $4.02 from pot
Ifivecrypto: doesn't show hand 
*** SUMMARY ***
Total pot $4.21 | Rake $0.19 
Board [8h Td Ad Jc]
Seat 1: AvGeL folded on the Turn
Seat 2: ildar87kzn folded before Flop (didn't bet)
Seat 3: Ger Cortes (button) folded before Flop (didn't bet)
Seat 4: Renzo1529 (small blind) folded before Flop
Seat 5: Ifivecrypto (big blind) collected ($4.02)
Seat 6: kjohnson1409 folded before Flop



PokerStars Hand #222944742195:  Hold'em No Limit ($0.05/$0.10 USD) - 2021/01/23 0:05:59 ET
Table 'Malzovia III' 6-max Seat #4 is the button
Seat 1: AvGeL ($10 in chips) 
Seat 2: ildar87kzn ($11.06 in chips) 
Seat 3: Ger Cortes ($10.15 in chips) 
Seat 4: Renzo1529 ($9.59 in chips) 
Seat 5: Ifivecrypto ($7.42 in chips) 
Seat 6: kjohnson1409 ($15.97 in chips) 
Ifivecrypto: posts small blind $0.05
kjohnson1409: posts big blind $0.10
*** HOLE CARDS ***
AvGeL: folds 
ildar87kzn: folds 
Ger Cortes: folds 
Renzo1529: raises $0.10 to $0.20
Ifivecrypto: folds 
kjohnson1409: raises $0.20 to $0.40
Renzo1529: calls $0.20
*** FLOP *** [3d 2s 8s]
kjohnson1409: bets $0.61
Renzo1529: folds 
Uncalled bet ($0.61) returned to kjohnson1409
kjohnson1409 collected $0.81 from pot
kjohnson1409: doesn't show hand 
*** SUMMARY ***
Total pot $0.85 | Rake $0.04 
Board [3d 2s 8s]
Seat 1: AvGeL folded before Flop (didn't bet)
Seat 2: ildar87kzn folded before Flop (didn't bet)
Seat 3: Ger Cortes folded before Flop (didn't bet)
Seat 4: Renzo1529 (button) folded on the Flop
Seat 5: Ifivecrypto (small blind) folded before Flop
Seat 6: kjohnson1409 (big blind) collected ($0.81)



PokerStars Hand #222944750824:  Hold'em No Limit ($0.05/$0.10 USD) - 2021/01/23 0:06:29 ET
Table 'Malzovia III' 6-max Seat #5 is the button
Seat 1: AvGeL ($10 in chips) 
Seat 2: ildar87kzn ($11.06 in chips) 
Seat 3: Ger Cortes ($10.15 in chips) 
Seat 4: Renzo1529 ($9.19 in chips) 
Seat 5: Ifivecrypto ($7.37 in chips) 
Seat 6: kjohnson1409 ($16.38 in chips) 
kjohnson1409: posts small blind $0.05
AvGeL: posts big blind $0.10
*** HOLE CARDS ***
ildar87kzn: folds 
Ger Cortes: raises $0.15 to $0.25
Renzo1529: folds 
Ifivecrypto: folds 
kjohnson1409: folds 
AvGeL: raises $0.75 to $1
Ger Cortes: folds 
Uncalled bet ($0.75) returned to AvGeL
AvGeL collected $0.55 from pot
*** SUMMARY ***
Total pot $0.55 | Rake $0 
Seat 1: AvGeL (big blind) collected ($0.55)
Seat 2: ildar87kzn folded before Flop (didn't bet)
Seat 3: Ger Cortes folded before Flop
Seat 4: Renzo1529 folded before Flop (didn't bet)
Seat 5: Ifivecrypto (button) folded before Flop (didn't bet)
Seat 6: kjohnson1409 (small blind) folded before Flop



PokerStars Hand #222944763824:  Hold'em No Limit ($0.05/$0.10 USD) - 2021/01/23 0:07:14 ET
Table 'Malzovia III' 6-max Seat #6 is the button
Seat 1: AvGeL ($10.30 in chips) 
Seat 2: ildar87kzn ($11.06 in chips) 
Seat 3: Ger Cortes ($10 in chips) 
Seat 4: Renzo1529 ($9.19 in chips) 
Seat 5: Ifivecrypto ($7.37 in chips) 
Seat 6: kjohnson1409 ($16.33 in chips) 
AvGeL: posts small blind $0.05
ildar87kzn: posts big blind $0.10
*** HOLE CARDS ***
Ger Cortes: folds 
Renzo1529: folds 
Ifivecrypto: calls $0.10
kjohnson1409: folds 
AvGeL: folds 
ildar87kzn: checks 
*** FLOP *** [2h Ks 2s]
ildar87kzn: bets $0.24
Ifivecrypto: folds 
Uncalled bet ($0.24) returned to ildar87kzn
ildar87kzn collected $0.24 from pot
ildar87kzn: doesn't show hand 
*** SUMMARY ***
Total pot $0.25 | Rake $0.01 
Board [2h Ks 2s]
Seat 1: AvGeL (small blind) folded before Flop
Seat 2: ildar87kzn (big blind) collected ($0.24)
Seat 3: Ger Cortes folded before Flop (didn't bet)
Seat 4: Renzo1529 folded before Flop (didn't bet)
Seat 5: Ifivecrypto folded on the Flop
Seat 6: kjohnson1409 (button) folded before Flop (didn't bet)



PokerStars Hand #222944773910:  Hold'em No Limit ($0.05/$0.10 USD) - 2021/01/23 0:07:50 ET
Table 'Malzovia III' 6-max Seat #1 is the button
Seat 1: AvGeL ($10.25 in chips) 
Seat 2: ildar87kzn ($11.20 in chips) 
Seat 3: Ger Cortes ($10 in chips) 
Seat 4: Renzo1529 ($9.19 in chips) 
Seat 5: Ifivecrypto ($7.27 in chips) 
Seat 6: kjohnson1409 ($16.33 in chips) 
ildar87kzn: posts small blind $0.05
Ger Cortes: posts big blind $0.10
*** HOLE CARDS ***
Renzo1529: folds 
Renzo1529 leaves the table
Ifivecrypto: folds 
kjohnson1409: folds 
FeL.Ru joins the table at seat #4 
AvGeL has timed out
AvGeL: folds 
ildar87kzn: folds 
Uncalled bet ($0.05) returned to Ger Cortes
Ger Cortes collected $0.10 from pot
*** SUMMARY ***
Total pot $0.10 | Rake $0 
Seat 1: AvGeL (button) folded before Flop (didn't bet)
Seat 2: ildar87kzn (small blind) folded before Flop
Seat 3: Ger Cortes (big blind) collected ($0.10)
Seat 4: Renzo1529 folded before Flop (didn't bet)
Seat 5: Ifivecrypto folded before Flop (didn't bet)
Seat 6: kjohnson1409 folded before Flop (didn't bet)



PokerStars Hand #222944780686:  Hold'em No Limit ($0.05/$0.10 USD) - 2021/01/23 0:08:13 ET
Table 'Malzovia III' 6-max Seat #2 is the button
Seat 2: ildar87kzn ($11.15 in chips) 
Seat 3: Ger Cortes ($10.05 in chips) 
Seat 4: FeL.Ru ($10 in chips) 
Seat 5: Ifivecrypto ($7.27 in chips) 
Seat 6: kjohnson1409 ($16.33 in chips) 
Ger Cortes: posts small blind $0.05
FeL.Ru: posts big blind $0.10
*** HOLE CARDS ***
Ifivecrypto: folds 
kjohnson1409: raises $0.10 to $0.20
ildar87kzn: folds 
Ger Cortes: folds 
FeL.Ru: folds 
Uncalled bet ($0.10) returned to kjohnson1409
kjohnson1409 collected $0.25 from pot
kjohnson1409: doesn't show hand 
*** SUMMARY ***
Total pot $0.25 | Rake $0 
Seat 2: ildar87kzn (button) folded before Flop (didn't bet)
Seat 3: Ger Cortes (small blind) folded before Flop
Seat 4: FeL.Ru (big blind) folded before Flop
Seat 5: Ifivecrypto folded before Flop (didn't bet)
Seat 6: kjohnson1409 collected ($0.25)



PokerStars Hand #222944785888:  Hold'em No Limit ($0.05/$0.10 USD) - 2021/01/23 0:08:31 ET
Table 'Malzovia III' 6-max Seat #3 is the button
Seat 1: AvGeL ($10.25 in chips) 
Seat 2: ildar87kzn ($11.15 in chips) 
Seat 3: Ger Cortes ($10 in chips) 
Seat 4: FeL.Ru ($9.90 in chips) 
Seat 5: Ifivecrypto ($7.27 in chips) 
Seat 6: kjohnson1409 ($16.48 in chips) 
FeL.Ru: posts small blind $0.05
Ifivecrypto: posts big blind $0.10
*** HOLE CARDS ***
kjohnson1409: raises $0.20 to $0.30
AvGeL: folds 
ildar87kzn: folds 
Ger Cortes: calls $0.30
FeL.Ru: folds 
Ifivecrypto: calls $0.20
*** FLOP *** [Qd Ah Tc]
Ifivecrypto: checks 
kjohnson1409: checks 
Ger Cortes: bets $0.50
Ifivecrypto: folds 
kjohnson1409: folds 
Uncalled bet ($0.50) returned to Ger Cortes
Ger Cortes collected $0.91 from pot
*** SUMMARY ***
Total pot $0.95 | Rake $0.04 
Board [Qd Ah Tc]
Seat 1: AvGeL folded before Flop (didn't bet)
Seat 2: ildar87kzn folded before Flop (didn't bet)
Seat 3: Ger Cortes (button) collected ($0.91)
Seat 4: FeL.Ru (small blind) folded before Flop
Seat 5: Ifivecrypto (big blind) folded on the Flop
Seat 6: kjohnson1409 folded on the Flop



PokerStars Hand #222944804335:  Hold'em No Limit ($0.05/$0.10 USD) - 2021/01/23 0:09:37 ET
Table 'Malzovia III' 6-max Seat #4 is the button
Seat 1: AvGeL ($10.25 in chips) 
Seat 2: ildar87kzn ($11.15 in chips) 
Seat 3: Ger Cortes ($10.61 in chips) 
Seat 4: FeL.Ru ($9.85 in chips) 
Seat 5: Ifivecrypto ($6.97 in chips) 
Seat 6: kjohnson1409 ($16.18 in chips) 
Ifivecrypto: posts small blind $0.05
kjohnson1409: posts big blind $0.10
*** HOLE CARDS ***
AvGeL: raises $0.20 to $0.30
ildar87kzn: folds 
Ger Cortes: folds 
FeL.Ru: folds 
Ifivecrypto: folds 
kjohnson1409: folds 
Uncalled bet ($0.20) returned to AvGeL
AvGeL collected $0.25 from pot
*** SUMMARY ***
Total pot $0.25 | Rake $0 
Seat 1: AvGeL collected ($0.25)
Seat 2: ildar87kzn folded before Flop (didn't bet)
Seat 3: Ger Cortes folded before Flop (didn't bet)
Seat 4: FeL.Ru (button) folded before Flop (didn't bet)
Seat 5: Ifivecrypto (small blind) folded before Flop
Seat 6: kjohnson1409 (big blind) folded before Flop



PokerStars Hand #222944809184:  Hold'em No Limit ($0.05/$0.10 USD) - 2021/01/23 0:09:54 ET
Table 'Malzovia III' 6-max Seat #5 is the button
Seat 1: AvGeL ($10.40 in chips) 
Seat 2: ildar87kzn ($11.15 in chips) 
Seat 3: Ger Cortes ($10.61 in chips) 
Seat 4: FeL.Ru ($9.85 in chips) 
Seat 5: Ifivecrypto ($6.92 in chips) 
Seat 6: kjohnson1409 ($16.08 in chips) 
kjohnson1409: posts small blind $0.05
AvGeL: posts big blind $0.10
*** HOLE CARDS ***
ildar87kzn: folds 
Ger Cortes: raises $0.15 to $0.25
FeL.Ru has timed out
FeL.Ru: folds 
Ifivecrypto: folds 
FeL.Ru is disconnected 
kjohnson1409: calls $0.20
AvGeL: folds 
*** FLOP *** [4d 8c 6c]
kjohnson1409: checks 
Ger Cortes: checks 
*** TURN *** [4d 8c 6c] [3d]
kjohnson1409: bets $0.29
Ger Cortes: calls $0.29
*** RIVER *** [4d 8c 6c 3d] [9h]
kjohnson1409: bets $0.57
Ger Cortes: raises $0.93 to $1.50
kjohnson1409: calls $0.93
*** SHOW DOWN ***
Ger Cortes: shows [Kh Ks] (a pair of Kings)
kjohnson1409: mucks hand 
Ger Cortes collected $3.99 from pot
*** SUMMARY ***
Total pot $4.18 | Rake $0.19 
Board [4d 8c 6c 3d 9h]
Seat 1: AvGeL (big blind) folded before Flop
Seat 2: ildar87kzn folded before Flop (didn't bet)
Seat 3: Ger Cortes showed [Kh Ks] and won ($3.99) with a pair of Kings
Seat 4: FeL.Ru folded before Flop (didn't bet)
Seat 5: Ifivecrypto (button) folded before Flop (didn't bet)
Seat 6: kjohnson1409 (small blind) mucked



PokerStars Hand #222944836339:  Hold'em No Limit ($0.05/$0.10 USD) - 2021/01/23 0:11:31 ET
Table 'Malzovia III' 6-max Seat #6 is the button
Seat 1: AvGeL ($10.30 in chips) 
Seat 2: ildar87kzn ($11.15 in chips) 
Seat 3: Ger Cortes ($12.56 in chips) 
Seat 4: FeL.Ru ($9.85 in chips) 
Seat 5: Ifivecrypto ($6.92 in chips) 
Seat 6: kjohnson1409 ($14.04 in chips) 
AvGeL: posts small blind $0.05
ildar87kzn: posts big blind $0.10
*** HOLE CARDS ***
Ger Cortes: folds 
FeL.Ru: folds 
Ifivecrypto has timed out
Ifivecrypto: folds 
kjohnson1409: folds 
AvGeL: raises $0.20 to $0.30
ildar87kzn: folds 
Uncalled bet ($0.20) returned to AvGeL
AvGeL collected $0.20 from pot
*** SUMMARY ***
Total pot $0.20 | Rake $0 
Seat 1: AvGeL (small blind) collected ($0.20)
Seat 2: ildar87kzn (big blind) folded before Flop
Seat 3: Ger Cortes folded before Flop (didn't bet)
Seat 4: FeL.Ru folded before Flop (didn't bet)
Seat 5: Ifivecrypto folded before Flop (didn't bet)
Seat 6: kjohnson1409 (button) folded before Flop (didn't bet)



PokerStars Hand #222944843889:  Hold'em No Limit ($0.05/$0.10 USD) - 2021/01/23 0:11:57 ET
Table 'Malzovia III' 6-max Seat #1 is the button
Seat 1: AvGeL ($10.40 in chips) 
Seat 2: ildar87kzn ($11.05 in chips) 
Seat 4: FeL.Ru ($9.85 in chips) 
Seat 6: kjohnson1409 ($14.04 in chips) 
ildar87kzn: posts small blind $0.05
Ger Cortes: is sitting out 
FeL.Ru: posts big blind $0.10
*** HOLE CARDS ***
kjohnson1409: raises $0.20 to $0.30
AvGeL: folds 
ildar87kzn: raises $0.90 to $1.20
FeL.Ru: folds 
kjohnson1409: folds 
Uncalled bet ($0.90) returned to ildar87kzn
ildar87kzn collected $0.70 from pot
ildar87kzn: doesn't show hand 
*** SUMMARY ***
Total pot $0.70 | Rake $0 
Seat 1: AvGeL (button) folded before Flop (didn't bet)
Seat 2: ildar87kzn (small blind) collected ($0.70)
Seat 4: FeL.Ru (big blind) folded before Flop
Seat 6: kjohnson1409 folded before Flop



PokerStars Hand #222944850090:  Hold'em No Limit ($0.05/$0.10 USD) - 2021/01/23 0:12:20 ET
Table 'Malzovia III' 6-max Seat #2 is the button
Seat 1: AvGeL ($10.40 in chips) 
Seat 2: ildar87kzn ($11.45 in chips) 
Seat 4: FeL.Ru ($9.75 in chips) 
Seat 6: kjohnson1409 ($13.74 in chips) 
FeL.Ru: posts small blind $0.05
kjohnson1409: posts big blind $0.10
*** HOLE CARDS ***
AvGeL: folds 
ildar87kzn: folds 
FeL.Ru: folds 
Uncalled bet ($0.05) returned to kjohnson1409
kjohnson1409 collected $0.10 from pot
kjohnson1409: doesn't show hand 
*** SUMMARY ***
Total pot $0.10 | Rake $0 
Seat 1: AvGeL folded before Flop (didn't bet)
Seat 2: ildar87kzn (button) folded before Flop (didn't bet)
Seat 4: FeL.Ru (small blind) folded before Flop
Seat 6: kjohnson1409 (big blind) collected ($0.10)



PokerStars Hand #222944854510:  Hold'em No Limit ($0.05/$0.10 USD) - 2021/01/23 0:12:36 ET
Table 'Malzovia III' 6-max Seat #4 is the button
Seat 1: AvGeL ($10.40 in chips) 
Seat 2: ildar87kzn ($11.45 in chips) 
Seat 4: FeL.Ru ($9.70 in chips) 
Seat 6: kjohnson1409 ($13.79 in chips) 
kjohnson1409: posts small blind $0.05
AvGeL: posts big blind $0.10
Ger Cortes: sits out 
*** HOLE CARDS ***
ildar87kzn: raises $0.20 to $0.30
FeL.Ru: folds 
kjohnson1409: folds 
AvGeL: raises $1.40 to $1.70
ildar87kzn: folds 
Uncalled bet ($1.40) returned to AvGeL
AvGeL collected $0.65 from pot
*** SUMMARY ***
Total pot $0.65 | Rake $0 
Seat 1: AvGeL (big blind) collected ($0.65)
Seat 2: ildar87kzn folded before Flop
Seat 4: FeL.Ru (button) folded before Flop (didn't bet)
Seat 6: kjohnson1409 (small blind) folded before Flop



PokerStars Hand #222944862237:  Hold'em No Limit ($0.05/$0.10 USD) - 2021/01/23 0:13:03 ET
Table 'Malzovia III' 6-max Seat #6 is the button
Seat 1: AvGeL ($10.75 in chips) 
Seat 2: ildar87kzn ($11.15 in chips) 
Seat 4: FeL.Ru ($9.70 in chips) 
Seat 6: kjohnson1409 ($13.74 in chips) 
AvGeL: posts small blind $0.05
ildar87kzn: posts big blind $0.10
Ger Cortes: sits out 
*** HOLE CARDS ***
FeL.Ru: folds 
kjohnson1409: folds 
AvGeL: raises $0.20 to $0.30
ildar87kzn: folds 
Uncalled bet ($0.20) returned to AvGeL
AvGeL collected $0.20 from pot
*** SUMMARY ***
Total pot $0.20 | Rake $0 
Seat 1: AvGeL (small blind) collected ($0.20)
Seat 2: ildar87kzn (big blind) folded before Flop
Seat 4: FeL.Ru folded before Flop (didn't bet)
Seat 6: kjohnson1409 (button) folded before Flop (didn't bet)



PokerStars Hand #222944865392:  Hold'em No Limit ($0.05/$0.10 USD) - 2021/01/23 0:13:14 ET
Table 'Malzovia III' 6-max Seat #1 is the button
Seat 1: AvGeL ($10.85 in chips) 
Seat 2: ildar87kzn ($11.05 in chips) 
Seat 3: Ger Cortes ($12.56 in chips) 
Seat 4: FeL.Ru ($9.70 in chips) 
Seat 6: kjohnson1409 ($13.74 in chips) 
ildar87kzn: posts small blind $0.05
Ger Cortes: posts big blind $0.10
*** HOLE CARDS ***
FeL.Ru: folds 
kjohnson1409: folds 
AvGeL: folds 
ildar87kzn: raises $0.20 to $0.30
Ger Cortes: folds 
Uncalled bet ($0.20) returned to ildar87kzn
ildar87kzn collected $0.20 from pot
ildar87kzn: doesn't show hand 
*** SUMMARY ***
Total pot $0.20 | Rake $0 
Seat 1: AvGeL (button) folded before Flop (didn't bet)
Seat 2: ildar87kzn (small blind) collected ($0.20)
Seat 3: Ger Cortes (big blind) folded before Flop
Seat 4: FeL.Ru folded before Flop (didn't bet)
Seat 6: kjohnson1409 folded before Flop (didn't bet)



PokerStars Hand #222944869742:  Hold'em No Limit ($0.05/$0.10 USD) - 2021/01/23 0:13:29 ET
Table 'Malzovia III' 6-max Seat #2 is the button
Seat 1: AvGeL ($10.85 in chips) 
Seat 2: ildar87kzn ($11.15 in chips) 
Seat 3: Ger Cortes ($12.46 in chips) 
Seat 4: FeL.Ru ($9.70 in chips) 
Seat 6: kjohnson1409 ($13.74 in chips) 
Ger Cortes: posts small blind $0.05
FeL.Ru: posts big blind $0.10
*** HOLE CARDS ***
kjohnson1409: folds 
AvGeL: raises $0.15 to $0.25
ildar87kzn: folds 
Ger Cortes: folds 
FeL.Ru: folds 
Uncalled bet ($0.15) returned to AvGeL
AvGeL collected $0.25 from pot
*** SUMMARY ***
Total pot $0.25 | Rake $0 
Seat 1: AvGeL collected ($0.25)
Seat 2: ildar87kzn (button) folded before Flop (didn't bet)
Seat 3: Ger Cortes (small blind) folded before Flop
Seat 4: FeL.Ru (big blind) folded before Flop
Seat 6: kjohnson1409 folded before Flop (didn't bet)



PokerStars Hand #222944873863:  Hold'em No Limit ($0.05/$0.10 USD) - 2021/01/23 0:13:44 ET
Table 'Malzovia III' 6-max Seat #3 is the button
Seat 1: AvGeL ($11 in chips) 
Seat 2: ildar87kzn ($11.15 in chips) 
Seat 3: Ger Cortes ($12.41 in chips) 
Seat 4: FeL.Ru ($9.60 in chips) 
Seat 6: kjohnson1409 ($13.74 in chips) 
FeL.Ru: posts small blind $0.05
kjohnson1409: posts big blind $0.10
*** HOLE CARDS ***
AvGeL: folds 
ildar87kzn: raises $0.20 to $0.30
Ger Cortes: folds 
FeL.Ru: folds 
kjohnson1409: folds 
Uncalled bet ($0.20) returned to ildar87kzn
ildar87kzn collected $0.25 from pot
ildar87kzn: doesn't show hand 
*** SUMMARY ***
Total pot $0.25 | Rake $0 
Seat 1: AvGeL folded before Flop (didn't bet)
Seat 2: ildar87kzn collected ($0.25)
Seat 3: Ger Cortes (button) folded before Flop (didn't bet)
Seat 4: FeL.Ru (small blind) folded before Flop
Seat 6: kjohnson1409 (big blind) folded before Flop



PokerStars Hand #222944879653:  Hold'em No Limit ($0.05/$0.10 USD) - 2021/01/23 0:14:04 ET
Table 'Malzovia III' 6-max Seat #4 is the button
Seat 1: AvGeL ($11 in chips) 
Seat 2: ildar87kzn ($11.30 in chips) 
Seat 3: Ger Cortes ($12.41 in chips) 
Seat 4: FeL.Ru ($9.55 in chips) 
Seat 6: kjohnson1409 ($13.64 in chips) 
kjohnson1409: posts small blind $0.05
AvGeL: posts big blind $0.10
*** HOLE CARDS ***
ildar87kzn: folds 
Ger Cortes: raises $0.15 to $0.25
FeL.Ru: calls $0.25
kjohnson1409: folds 
AvGeL: folds 
*** FLOP *** [4s 7c 3c]
Ger Cortes: checks 
FeL.Ru: bets $0.41
Ger Cortes: folds 
Uncalled bet ($0.41) returned to FeL.Ru
FeL.Ru collected $0.62 from pot
FeL.Ru: doesn't show hand 
*** SUMMARY ***
Total pot $0.65 | Rake $0.03 
Board [4s 7c 3c]
Seat 1: AvGeL (big blind) folded before Flop
Seat 2: ildar87kzn folded before Flop (didn't bet)
Seat 3: Ger Cortes folded on the Flop
Seat 4: FeL.Ru (button) collected ($0.62)
Seat 6: kjohnson1409 (small blind) folded before Flop



PokerStars Hand #222944888215:  Hold'em No Limit ($0.05/$0.10 USD) - 2021/01/23 0:14:35 ET
Table 'Malzovia III' 6-max Seat #6 is the button
Seat 1: AvGeL ($10.90 in chips) 
Seat 2: ildar87kzn ($11.30 in chips) 
Seat 3: Ger Cortes ($12.16 in chips) 
Seat 4: FeL.Ru ($9.92 in chips) 
Seat 6: kjohnson1409 ($13.59 in chips) 
AvGeL: posts small blind $0.05
ildar87kzn: posts big blind $0.10
*** HOLE CARDS ***
Ger Cortes: folds 
FeL.Ru: raises $0.20 to $0.30
kjohnson1409: folds 
AvGeL: raises $0.85 to $1.15
ildar87kzn: folds 
FeL.Ru: calls $0.85
*** FLOP *** [4d 3s Qh]
AvGeL: bets $0.95
FeL.Ru: calls $0.95
*** TURN *** [4d 3s Qh] [5c]
AvGeL: bets $3.08
FeL.Ru: folds 
Uncalled bet ($3.08) returned to AvGeL
AvGeL collected $4.11 from pot
*** SUMMARY ***
Total pot $4.30 | Rake $0.19 
Board [4d 3s Qh 5c]
Seat 1: AvGeL (small blind) collected ($4.11)
Seat 2: ildar87kzn (big blind) folded before Flop
Seat 3: Ger Cortes folded before Flop (didn't bet)
Seat 4: FeL.Ru folded on the Turn
Seat 6: kjohnson1409 (button) folded before Flop (didn't bet)



PokerStars Hand #222944899587:  Hold'em No Limit ($0.05/$0.10 USD) - 2021/01/23 0:15:15 ET
Table 'Malzovia III' 6-max Seat #1 is the button
Seat 1: AvGeL ($12.91 in chips) 
Seat 2: ildar87kzn ($11.20 in chips) 
Seat 3: Ger Cortes ($12.16 in chips) 
Seat 4: FeL.Ru ($7.82 in chips) 
Seat 6: kjohnson1409 ($13.59 in chips) 
ildar87kzn: posts small blind $0.05
Ger Cortes: posts big blind $0.10
*** HOLE CARDS ***
FeL.Ru: folds 
kjohnson1409: folds 
AvGeL: raises $0.10 to $0.20
ildar87kzn: folds 
Ger Cortes: folds 
Uncalled bet ($0.10) returned to AvGeL
AvGeL collected $0.25 from pot
*** SUMMARY ***
Total pot $0.25 | Rake $0 
Seat 1: AvGeL (button) collected ($0.25)
Seat 2: ildar87kzn (small blind) folded before Flop
Seat 3: Ger Cortes (big blind) folded before Flop
Seat 4: FeL.Ru folded before Flop (didn't bet)
Seat 6: kjohnson1409 folded before Flop (didn't bet)



PokerStars Hand #222944904642:  Hold'em No Limit ($0.05/$0.10 USD) - 2021/01/23 0:15:34 ET
Table 'Malzovia III' 6-max Seat #2 is the button
Seat 1: AvGeL ($13.06 in chips) 
Seat 2: ildar87kzn ($11.15 in chips) 
Seat 3: Ger Cortes ($12.06 in chips) 
Seat 4: FeL.Ru ($7.82 in chips) 
Seat 6: kjohnson1409 ($13.59 in chips) 
Ger Cortes: posts small blind $0.05
FeL.Ru: posts big blind $0.10
*** HOLE CARDS ***
kjohnson1409: folds 
AvGeL: folds 
ildar87kzn: folds 
Ger Cortes: raises $0.20 to $0.30
FeL.Ru: calls $0.20
*** FLOP *** [Jc Jd Th]
Ger Cortes: checks 
FeL.Ru: bets $0.28
Ger Cortes: folds 
Uncalled bet ($0.28) returned to FeL.Ru
FeL.Ru collected $0.57 from pot
FeL.Ru: doesn't show hand 
*** SUMMARY ***
Total pot $0.60 | Rake $0.03 
Board [Jc Jd Th]
Seat 1: AvGeL folded before Flop (didn't bet)
Seat 2: ildar87kzn (button) folded before Flop (didn't bet)
Seat 3: Ger Cortes (small blind) folded on the Flop
Seat 4: FeL.Ru (big blind) collected ($0.57)
Seat 6: kjohnson1409 folded before Flop (didn't bet)



PokerStars Hand #222944912067:  Hold'em No Limit ($0.05/$0.10 USD) - 2021/01/23 0:16:01 ET
Table 'Malzovia III' 6-max Seat #3 is the button
Seat 1: AvGeL ($13.06 in chips) 
Seat 2: ildar87kzn ($11.15 in chips) 
Seat 3: Ger Cortes ($11.76 in chips) 
Seat 4: FeL.Ru ($8.09 in chips) 
Seat 6: kjohnson1409 ($13.59 in chips) 
FeL.Ru: posts small blind $0.05
kjohnson1409: posts big blind $0.10
*** HOLE CARDS ***
AvGeL: folds 
ildar87kzn: folds 
Ger Cortes: folds 
FeL.Ru: raises $0.20 to $0.30
kjohnson1409: raises $0.20 to $0.50
FeL.Ru: calls $0.20
*** FLOP *** [2s 2h 4c]
FeL.Ru: checks 
kjohnson1409: bets $0.72
FeL.Ru: folds 
Uncalled bet ($0.72) returned to kjohnson1409
kjohnson1409 collected $0.96 from pot
kjohnson1409: doesn't show hand 
*** SUMMARY ***
Total pot $1 | Rake $0.04 
Board [2s 2h 4c]
Seat 1: AvGeL folded before Flop (didn't bet)
Seat 2: ildar87kzn folded before Flop (didn't bet)
Seat 3: Ger Cortes (button) folded before Flop (didn't bet)
Seat 4: FeL.Ru (small blind) folded on the Flop
Seat 6: kjohnson1409 (big blind) collected ($0.96)



PokerStars Hand #222944919672:  Hold'em No Limit ($0.05/$0.10 USD) - 2021/01/23 0:16:28 ET
Table 'Malzovia III' 6-max Seat #4 is the button
Seat 1: AvGeL ($13.06 in chips) 
Seat 2: ildar87kzn ($11.15 in chips) 
Seat 3: Ger Cortes ($11.76 in chips) 
Seat 4: FeL.Ru ($7.59 in chips) 
Seat 6: kjohnson1409 ($14.05 in chips) 
kjohnson1409: posts small blind $0.05
AvGeL: posts big blind $0.10
*** HOLE CARDS ***
ildar87kzn: folds 
Ger Cortes: folds 
FeL.Ru: raises $0.20 to $0.30
kjohnson1409: folds 
AvGeL: folds 
Uncalled bet ($0.20) returned to FeL.Ru
FeL.Ru collected $0.25 from pot
FeL.Ru: doesn't show hand 
*** SUMMARY ***
Total pot $0.25 | Rake $0 
Seat 1: AvGeL (big blind) folded before Flop
Seat 2: ildar87kzn folded before Flop (didn't bet)
Seat 3: Ger Cortes folded before Flop (didn't bet)
Seat 4: FeL.Ru (button) collected ($0.25)
Seat 6: kjohnson1409 (small blind) folded before Flop



PokerStars Hand #222944925037:  Hold'em No Limit ($0.05/$0.10 USD) - 2021/01/23 0:16:48 ET
Table 'Malzovia III' 6-max Seat #6 is the button
Seat 1: AvGeL ($12.96 in chips) 
Seat 2: ildar87kzn ($11.15 in chips) 
Seat 3: Ger Cortes ($11.76 in chips) 
Seat 4: FeL.Ru ($7.74 in chips) 
Seat 6: kjohnson1409 ($14 in chips) 
AvGeL: posts small blind $0.05
ildar87kzn: posts big blind $0.10
Ifivecrypto: sits out 
*** HOLE CARDS ***
Ger Cortes: folds 
FeL.Ru: folds 
kjohnson1409: folds 
AvGeL: raises $0.20 to $0.30
ildar87kzn: folds 
Uncalled bet ($0.20) returned to AvGeL
AvGeL collected $0.20 from pot
*** SUMMARY ***
Total pot $0.20 | Rake $0 
Seat 1: AvGeL (small blind) collected ($0.20)
Seat 2: ildar87kzn (big blind) folded before Flop
Seat 3: Ger Cortes folded before Flop (didn't bet)
Seat 4: FeL.Ru folded before Flop (didn't bet)
Seat 6: kjohnson1409 (button) folded before Flop (didn't bet)



PokerStars Hand #222944928666:  Hold'em No Limit ($0.05/$0.10 USD) - 2021/01/23 0:17:01 ET
Table 'Malzovia III' 6-max Seat #1 is the button
Seat 1: AvGeL ($13.06 in chips) 
Seat 2: ildar87kzn ($11.05 in chips) 
Seat 3: Ger Cortes ($11.76 in chips) 
Seat 4: FeL.Ru ($7.74 in chips) 
Seat 6: kjohnson1409 ($14 in chips) 
ildar87kzn: posts small blind $0.05
Ger Cortes: posts big blind $0.10
Ifivecrypto: sits out 
*** HOLE CARDS ***
FeL.Ru: folds 
kjohnson1409: folds 
AvGeL: raises $0.10 to $0.20
ildar87kzn: folds 
Ger Cortes: calls $0.10
*** FLOP *** [9d 8h 9h]
Ger Cortes: checks 
AvGeL: bets $0.32
Ger Cortes: folds 
Uncalled bet ($0.32) returned to AvGeL
AvGeL collected $0.43 from pot
*** SUMMARY ***
Total pot $0.45 | Rake $0.02 
Board [9d 8h 9h]
Seat 1: AvGeL (button) collected ($0.43)
Seat 2: ildar87kzn (small blind) folded before Flop
Seat 3: Ger Cortes (big blind) folded on the Flop
Seat 4: FeL.Ru folded before Flop (didn't bet)
Seat 6: kjohnson1409 folded before Flop (didn't bet)



PokerStars Hand #222944936791:  Hold'em No Limit ($0.05/$0.10 USD) - 2021/01/23 0:17:30 ET
Table 'Malzovia III' 6-max Seat #2 is the button
Seat 1: AvGeL ($13.29 in chips) 
Seat 2: ildar87kzn ($11 in chips) 
Seat 3: Ger Cortes ($11.56 in chips) 
Seat 4: FeL.Ru ($7.74 in chips) 
Seat 5: Ifivecrypto ($6.92 in chips) 
Seat 6: kjohnson1409 ($14 in chips) 
Ger Cortes: posts small blind $0.05
FeL.Ru: posts big blind $0.10
Ifivecrypto: posts small & big blinds $0.15
*** HOLE CARDS ***
Ifivecrypto: checks 
kjohnson1409: folds 
AvGeL: folds 
ildar87kzn: folds 
Ger Cortes: folds 
FeL.Ru: raises $0.40 to $0.50
Ifivecrypto: raises $6.37 to $6.87 and is all-in
FeL.Ru: folds 
Uncalled bet ($6.37) returned to Ifivecrypto
Ifivecrypto collected $1.10 from pot
Ifivecrypto: doesn't show hand 
*** SUMMARY ***
Total pot $1.10 | Rake $0 
Seat 1: AvGeL folded before Flop (didn't bet)
Seat 2: ildar87kzn (button) folded before Flop (didn't bet)
Seat 3: Ger Cortes (small blind) folded before Flop
Seat 4: FeL.Ru (big blind) folded before Flop
Seat 5: Ifivecrypto collected ($1.10)
Seat 6: kjohnson1409 folded before Flop (didn't bet)



PokerStars Hand #222945004933:  Hold'em No Limit ($0.05/$0.10 USD) - 2021/01/23 0:21:33 ET
Table 'Malzovia III' 6-max Seat #5 is the button
Seat 1: AvGeL ($13.14 in chips) 
Seat 2: ildar87kzn ($10.25 in chips) 
Seat 3: prokkky ($6.10 in chips) 
Seat 4: FeL.Ru ($8.97 in chips) 
Seat 5: Ifivecrypto ($7.17 in chips) 
Seat 6: kjohnson1409 ($13.90 in chips) 
kjohnson1409: posts small blind $0.05
AvGeL: posts big blind $0.10
*** HOLE CARDS ***
ildar87kzn: folds 
prokkky: calls $0.10
FeL.Ru: folds 
Ifivecrypto: calls $0.10
kjohnson1409: calls $0.05
AvGeL: checks 
*** FLOP *** [Ah 9h 6c]
kjohnson1409: checks 
AvGeL: checks 
prokkky: bets $0.20
Ifivecrypto: calls $0.20
kjohnson1409: folds 
AvGeL: folds 
*** TURN *** [Ah 9h 6c] [7h]
prokkky: bets $0.20
Ifivecrypto: calls $0.20
*** RIVER *** [Ah 9h 6c 7h] [Th]
prokkky: bets $0.20
Ifivecrypto: raises $6.47 to $6.67 and is all-in
prokkky: folds 
Uncalled bet ($6.47) returned to Ifivecrypto
Ifivecrypto collected $1.53 from pot
Ifivecrypto: doesn't show hand 
*** SUMMARY ***
Total pot $1.60 | Rake $0.07 
Board [Ah 9h 6c 7h Th]
Seat 1: AvGeL (big blind) folded on the Flop
Seat 2: ildar87kzn folded before Flop (didn't bet)
Seat 3: prokkky folded on the River
Seat 4: FeL.Ru folded before Flop (didn't bet)
Seat 5: Ifivecrypto (button) collected ($1.53)
Seat 6: kjohnson1409 (small blind) folded on the Flop



PokerStars Hand #222945036990:  Hold'em No Limit ($0.05/$0.10 USD) - 2021/01/23 0:23:31 ET
Table 'Malzovia III' 6-max Seat #1 is the button
Seat 1: AvGeL ($12.99 in chips) 
Seat 2: ildar87kzn ($10.15 in chips) 
Seat 3: prokkky ($5.55 in chips) 
Seat 4: FeL.Ru ($8.97 in chips) 
Seat 5: Ifivecrypto ($8 in chips) 
Seat 6: kjohnson1409 ($13.80 in chips) 
ildar87kzn: posts small blind $0.05
prokkky: posts big blind $0.10
*** HOLE CARDS ***
FeL.Ru: folds 
Ifivecrypto: calls $0.10
kjohnson1409: folds 
AvGeL: folds 
ildar87kzn: calls $0.05
prokkky: checks 
*** FLOP *** [Kc Qh 8s]
ildar87kzn: checks 
prokkky: checks 
Ifivecrypto: checks 
*** TURN *** [Kc Qh 8s] [Th]
ildar87kzn: bets $0.19
prokkky: folds 
Ifivecrypto: folds 
Uncalled bet ($0.19) returned to ildar87kzn
ildar87kzn collected $0.29 from pot
ildar87kzn: doesn't show hand 
*** SUMMARY ***
Total pot $0.30 | Rake $0.01 
Board [Kc Qh 8s Th]
Seat 1: AvGeL (button) folded before Flop (didn't bet)
Seat 2: ildar87kzn (small blind) collected ($0.29)
Seat 3: prokkky (big blind) folded on the Turn
Seat 4: FeL.Ru folded before Flop (didn't bet)
Seat 5: Ifivecrypto folded on the Turn
Seat 6: kjohnson1409 folded before Flop (didn't bet)



PokerStars Hand #222945048454:  Hold'em No Limit ($0.05/$0.10 USD) - 2021/01/23 0:24:12 ET
Table 'Malzovia III' 6-max Seat #2 is the button
Seat 1: AvGeL ($12.99 in chips) 
Seat 2: ildar87kzn ($10.34 in chips) 
Seat 3: prokkky ($5.45 in chips) 
Seat 4: FeL.Ru ($8.97 in chips) 
Seat 5: Ifivecrypto ($7.90 in chips) 
Seat 6: kjohnson1409 ($13.80 in chips) 
prokkky: posts small blind $0.05
FeL.Ru: posts big blind $0.10
*** HOLE CARDS ***
Ifivecrypto: calls $0.10
kjohnson1409: raises $0.30 to $0.40
AvGeL: folds 
ildar87kzn: folds 
prokkky: folds 
FeL.Ru: folds 
Ifivecrypto: raises $7.50 to $7.90 and is all-in
kjohnson1409: folds 
Uncalled bet ($7.50) returned to Ifivecrypto
Ifivecrypto collected $0.95 from pot
Ifivecrypto: doesn't show hand 
*** SUMMARY ***
Total pot $0.95 | Rake $0 
Seat 1: AvGeL folded before Flop (didn't bet)
Seat 2: ildar87kzn (button) folded before Flop (didn't bet)
Seat 3: prokkky (small blind) folded before Flop
Seat 4: FeL.Ru (big blind) folded before Flop
Seat 5: Ifivecrypto collected ($0.95)
Seat 6: kjohnson1409 folded before Flop



PokerStars Hand #222945060615:  Hold'em No Limit ($0.05/$0.10 USD) - 2021/01/23 0:24:57 ET
Table 'Malzovia III' 6-max Seat #3 is the button
Seat 1: AvGeL ($12.99 in chips) 
Seat 2: ildar87kzn ($10.34 in chips) 
Seat 3: prokkky ($5.40 in chips) 
Seat 4: FeL.Ru ($8.87 in chips) 
Seat 5: Ifivecrypto ($8.45 in chips) 
Seat 6: kjohnson1409 ($13.40 in chips) 
FeL.Ru: posts small blind $0.05
Ifivecrypto: posts big blind $0.10
*** HOLE CARDS ***
kjohnson1409: folds 
AvGeL: raises $0.20 to $0.30
ildar87kzn: folds 
prokkky: calls $0.30
FeL.Ru: folds 
Ifivecrypto: calls $0.20
*** FLOP *** [9c Jc 2c]
Ifivecrypto: bets $0.30
AvGeL: folds 
prokkky: folds 
Uncalled bet ($0.30) returned to Ifivecrypto
Ifivecrypto collected $0.91 from pot
Ifivecrypto: doesn't show hand 
*** SUMMARY ***
Total pot $0.95 | Rake $0.04 
Board [9c Jc 2c]
Seat 1: AvGeL folded on the Flop
Seat 2: ildar87kzn folded before Flop (didn't bet)
Seat 3: prokkky (button) folded on the Flop
Seat 4: FeL.Ru (small blind) folded before Flop
Seat 5: Ifivecrypto (big blind) collected ($0.91)
Seat 6: kjohnson1409 folded before Flop (didn't bet)



PokerStars Hand #222945071878:  Hold'em No Limit ($0.05/$0.10 USD) - 2021/01/23 0:25:37 ET
Table 'Malzovia III' 6-max Seat #4 is the button
Seat 1: AvGeL ($12.69 in chips) 
Seat 2: ildar87kzn ($10.34 in chips) 
Seat 3: prokkky ($5.10 in chips) 
Seat 4: FeL.Ru ($8.82 in chips) 
Seat 5: Ifivecrypto ($9.06 in chips) 
Seat 6: kjohnson1409 ($13.40 in chips) 
Ifivecrypto: posts small blind $0.05
kjohnson1409: posts big blind $0.10
*** HOLE CARDS ***
AvGeL: folds 
ildar87kzn: raises $0.20 to $0.30
prokkky: calls $0.30
FeL.Ru: folds 
Ifivecrypto: folds 
kjohnson1409: folds 
*** FLOP *** [3c 8s Ad]
ildar87kzn: bets $0.37
prokkky: calls $0.37
*** TURN *** [3c 8s Ad] [9d]
ildar87kzn: checks 
prokkky: checks 
*** RIVER *** [3c 8s Ad 9d] [7c]
ildar87kzn: checks 
prokkky: checks 
*** SHOW DOWN ***
ildar87kzn: shows [4d 4s] (a pair of Fours)
prokkky: shows [Td Th] (a pair of Tens)
prokkky collected $1.42 from pot
*** SUMMARY ***
Total pot $1.49 | Rake $0.07 
Board [3c 8s Ad 9d 7c]
Seat 1: AvGeL folded before Flop (didn't bet)
Seat 2: ildar87kzn showed [4d 4s] and lost with a pair of Fours
Seat 3: prokkky showed [Td Th] and won ($1.42) with a pair of Tens
Seat 4: FeL.Ru (button) folded before Flop (didn't bet)
Seat 5: Ifivecrypto (small blind) folded before Flop
Seat 6: kjohnson1409 (big blind) folded before Flop



PokerStars Hand #222945083764:  Hold'em No Limit ($0.05/$0.10 USD) - 2021/01/23 0:26:21 ET
Table 'Malzovia III' 6-max Seat #5 is the button
Seat 1: AvGeL ($12.69 in chips) 
Seat 2: ildar87kzn ($10 in chips) 
Seat 3: prokkky ($5.85 in chips) 
Seat 4: FeL.Ru ($8.82 in chips) 
Seat 5: Ifivecrypto ($9.01 in chips) 
Seat 6: kjohnson1409 ($13.30 in chips) 
kjohnson1409: posts small blind $0.05
AvGeL: posts big blind $0.10
*** HOLE CARDS ***
ildar87kzn: folds 
prokkky: folds 
FeL.Ru: raises $0.20 to $0.30
Ifivecrypto: calls $0.30
kjohnson1409: folds 
AvGeL: calls $0.20
*** FLOP *** [7c 6c Jh]
AvGeL: checks 
FeL.Ru: checks 
Ifivecrypto: bets $8.71 and is all-in
AvGeL: folds 
FeL.Ru: folds 
Uncalled bet ($8.71) returned to Ifivecrypto
Ifivecrypto collected $0.91 from pot
Ifivecrypto: doesn't show hand 
*** SUMMARY ***
Total pot $0.95 | Rake $0.04 
Board [7c 6c Jh]
Seat 1: AvGeL (big blind) folded on the Flop
Seat 2: ildar87kzn folded before Flop (didn't bet)
Seat 3: prokkky folded before Flop (didn't bet)
Seat 4: FeL.Ru folded on the Flop
Seat 5: Ifivecrypto (button) collected ($0.91)
Seat 6: kjohnson1409 (small blind) folded before Flop



PokerStars Hand #222945095860:  Hold'em No Limit ($0.05/$0.10 USD) - 2021/01/23 0:27:05 ET
Table 'Malzovia III' 6-max Seat #6 is the button
Seat 1: AvGeL ($12.39 in chips) 
Seat 2: ildar87kzn ($10 in chips) 
Seat 3: prokkky ($5.85 in chips) 
Seat 4: FeL.Ru ($8.52 in chips) 
Seat 5: Ifivecrypto ($9.62 in chips) 
Seat 6: kjohnson1409 ($13.25 in chips) 
AvGeL: posts small blind $0.05
ildar87kzn: posts big blind $0.10
*** HOLE CARDS ***
prokkky: folds 
FeL.Ru: folds 
Ifivecrypto: folds 
kjohnson1409: folds 
AvGeL: raises $0.20 to $0.30
ildar87kzn: calls $0.20
*** FLOP *** [Jd Ks 5d]
AvGeL: bets $0.29
ildar87kzn: folds 
Uncalled bet ($0.29) returned to AvGeL
AvGeL collected $0.57 from pot
*** SUMMARY ***
Total pot $0.60 | Rake $0.03 
Board [Jd Ks 5d]
Seat 1: AvGeL (small blind) collected ($0.57)
Seat 2: ildar87kzn (big blind) folded on the Flop
Seat 3: prokkky folded before Flop (didn't bet)
Seat 4: FeL.Ru folded before Flop (didn't bet)
Seat 5: Ifivecrypto folded before Flop (didn't bet)
Seat 6: kjohnson1409 (button) folded before Flop (didn't bet)



PokerStars Hand #222945104394:  Hold'em No Limit ($0.05/$0.10 USD) - 2021/01/23 0:27:36 ET
Table 'Malzovia III' 6-max Seat #1 is the button
Seat 1: AvGeL ($12.66 in chips) 
Seat 2: ildar87kzn ($10 in chips) 
Seat 3: prokkky ($5.85 in chips) 
Seat 4: FeL.Ru ($8.52 in chips) 
Seat 5: Ifivecrypto ($9.62 in chips) 
Seat 6: kjohnson1409 ($13.25 in chips) 
ildar87kzn: posts small blind $0.05
prokkky: posts big blind $0.10
*** HOLE CARDS ***
FeL.Ru: folds 
Ifivecrypto: folds 
kjohnson1409: folds 
AvGeL: raises $0.10 to $0.20
ildar87kzn: folds 
prokkky: calls $0.10
*** FLOP *** [3d 6c 4c]
prokkky: checks 
AvGeL: checks 
*** TURN *** [3d 6c 4c] [Ks]
prokkky: checks 
AvGeL: checks 
*** RIVER *** [3d 6c 4c Ks] [5s]
prokkky: bets $0.30
AvGeL: folds 
Uncalled bet ($0.30) returned to prokkky
prokkky collected $0.43 from pot
prokkky: doesn't show hand 
*** SUMMARY ***
Total pot $0.45 | Rake $0.02 
Board [3d 6c 4c Ks 5s]
Seat 1: AvGeL (button) folded on the River
Seat 2: ildar87kzn (small blind) folded before Flop
Seat 3: prokkky (big blind) collected ($0.43)
Seat 4: FeL.Ru folded before Flop (didn't bet)
Seat 5: Ifivecrypto folded before Flop (didn't bet)
Seat 6: kjohnson1409 folded before Flop (didn't bet)



PokerStars Hand #222945120293:  Hold'em No Limit ($0.05/$0.10 USD) - 2021/01/23 0:28:34 ET
Table 'Malzovia III' 6-max Seat #2 is the button
Seat 1: AvGeL ($12.46 in chips) 
Seat 2: ildar87kzn ($10 in chips) 
Seat 3: prokkky ($6.08 in chips) 
Seat 4: FeL.Ru ($8.52 in chips) 
Seat 5: Ifivecrypto ($9.62 in chips) 
Seat 6: kjohnson1409 ($13.25 in chips) 
prokkky: posts small blind $0.05
FeL.Ru: posts big blind $0.10
*** HOLE CARDS ***
Ifivecrypto: calls $0.10
kjohnson1409: folds 
AvGeL: raises $0.15 to $0.25
ildar87kzn: folds 
prokkky: folds 
FeL.Ru: calls $0.15
Ifivecrypto: calls $0.15
*** FLOP *** [8d Kc 6s]
FeL.Ru: checks 
Ifivecrypto: checks 
AvGeL: checks 
*** TURN *** [8d Kc 6s] [Td]
FeL.Ru: bets $0.48
Ifivecrypto: folds 
AvGeL: folds 
Uncalled bet ($0.48) returned to FeL.Ru
FeL.Ru collected $0.76 from pot
FeL.Ru: doesn't show hand 
*** SUMMARY ***
Total pot $0.80 | Rake $0.04 
Board [8d Kc 6s Td]
Seat 1: AvGeL folded on the Turn
Seat 2: ildar87kzn (button) folded before Flop (didn't bet)
Seat 3: prokkky (small blind) folded before Flop
Seat 4: FeL.Ru (big blind) collected ($0.76)
Seat 5: Ifivecrypto folded on the Turn
Seat 6: kjohnson1409 folded before Flop (didn't bet)



PokerStars Hand #222945138494:  Hold'em No Limit ($0.05/$0.10 USD) - 2021/01/23 0:29:21 ET
Table 'Malzovia III' 6-max Seat #3 is the button
Seat 1: AvGeL ($12.21 in chips) 
Seat 2: ildar87kzn ($10 in chips) 
Seat 3: prokkky ($6.03 in chips) 
Seat 4: FeL.Ru ($9.03 in chips) 
Seat 5: Ifivecrypto ($9.37 in chips) 
Seat 6: kjohnson1409 ($13.25 in chips) 
FeL.Ru: posts small blind $0.05
Ifivecrypto: posts big blind $0.10
*** HOLE CARDS ***
kjohnson1409: folds 
AvGeL: folds 
ildar87kzn: folds 
prokkky: folds 
FeL.Ru: folds 
Uncalled bet ($0.05) returned to Ifivecrypto
Ifivecrypto collected $0.10 from pot
Ifivecrypto: doesn't show hand 
*** SUMMARY ***
Total pot $0.10 | Rake $0 
Seat 1: AvGeL folded before Flop (didn't bet)
Seat 2: ildar87kzn folded before Flop (didn't bet)
Seat 3: prokkky (button) folded before Flop (didn't bet)
Seat 4: FeL.Ru (small blind) folded before Flop
Seat 5: Ifivecrypto (big blind) collected ($0.10)
Seat 6: kjohnson1409 folded before Flop (didn't bet)



PokerStars Hand #222945142691:  Hold'em No Limit ($0.05/$0.10 USD) - 2021/01/23 0:29:36 ET
Table 'Malzovia III' 6-max Seat #4 is the button
Seat 1: AvGeL ($12.21 in chips) 
Seat 2: ildar87kzn ($10 in chips) 
Seat 3: prokkky ($6.03 in chips) 
Seat 4: FeL.Ru ($8.98 in chips) 
Seat 5: Ifivecrypto ($9.42 in chips) 
Seat 6: kjohnson1409 ($13.25 in chips) 
Ifivecrypto: posts small blind $0.05
kjohnson1409: posts big blind $0.10
*** HOLE CARDS ***
AvGeL: folds 
ildar87kzn: folds 
prokkky: raises $0.10 to $0.20
FeL.Ru: folds 
Ifivecrypto: folds 
kjohnson1409: calls $0.10
*** FLOP *** [7h Th 9d]
kjohnson1409: checks 
prokkky: bets $0.20
kjohnson1409: folds 
Uncalled bet ($0.20) returned to prokkky
prokkky collected $0.43 from pot
prokkky: doesn't show hand 
*** SUMMARY ***
Total pot $0.45 | Rake $0.02 
Board [7h Th 9d]
Seat 1: AvGeL folded before Flop (didn't bet)
Seat 2: ildar87kzn folded before Flop (didn't bet)
Seat 3: prokkky collected ($0.43)
Seat 4: FeL.Ru (button) folded before Flop (didn't bet)
Seat 5: Ifivecrypto (small blind) folded before Flop
Seat 6: kjohnson1409 (big blind) folded on the Flop



PokerStars Hand #222945151973:  Hold'em No Limit ($0.05/$0.10 USD) - 2021/01/23 0:30:11 ET
Table 'Malzovia III' 6-max Seat #5 is the button
Seat 1: AvGeL ($12.21 in chips) 
Seat 2: ildar87kzn ($10 in chips) 
Seat 3: prokkky ($6.26 in chips) 
Seat 4: FeL.Ru ($8.98 in chips) 
Seat 5: Ifivecrypto ($9.37 in chips) 
Seat 6: kjohnson1409 ($13.05 in chips) 
kjohnson1409: posts small blind $0.05
AvGeL: posts big blind $0.10
*** HOLE CARDS ***
ildar87kzn: folds 
prokkky: folds 
FeL.Ru: raises $0.20 to $0.30
prokkky leaves the table
Ifivecrypto: folds 
kjohnson1409: folds 
AvGeL: folds 
Uncalled bet ($0.20) returned to FeL.Ru
FeL.Ru collected $0.25 from pot
FeL.Ru: doesn't show hand 
*** SUMMARY ***
Total pot $0.25 | Rake $0 
Seat 1: AvGeL (big blind) folded before Flop
Seat 2: ildar87kzn folded before Flop (didn't bet)
Seat 3: prokkky folded before Flop (didn't bet)
Seat 4: FeL.Ru collected ($0.25)
Seat 5: Ifivecrypto (button) folded before Flop (didn't bet)
Seat 6: kjohnson1409 (small blind) folded before Flop



PokerStars Hand #222945158563:  Hold'em No Limit ($0.05/$0.10 USD) - 2021/01/23 0:30:35 ET
Table 'Malzovia III' 6-max Seat #6 is the button
Seat 1: AvGeL ($12.11 in chips) 
Seat 2: ildar87kzn ($10 in chips) 
Seat 4: FeL.Ru ($9.13 in chips) 
Seat 5: Ifivecrypto ($9.37 in chips) 
Seat 6: kjohnson1409 ($13 in chips) 
AvGeL: posts small blind $0.05
ildar87kzn: posts big blind $0.10
*** HOLE CARDS ***
FeL.Ru: folds 
Ifivecrypto: folds 
kjohnson1409: folds 
AvGeL: folds 
Uncalled bet ($0.05) returned to ildar87kzn
ildar87kzn collected $0.10 from pot
ildar87kzn: doesn't show hand 
*** SUMMARY ***
Total pot $0.10 | Rake $0 
Seat 1: AvGeL (small blind) folded before Flop
Seat 2: ildar87kzn (big blind) collected ($0.10)
Seat 4: FeL.Ru folded before Flop (didn't bet)
Seat 5: Ifivecrypto folded before Flop (didn't bet)
Seat 6: kjohnson1409 (button) folded before Flop (didn't bet)



PokerStars Hand #222945161883:  Hold'em No Limit ($0.05/$0.10 USD) - 2021/01/23 0:30:47 ET
Table 'Malzovia III' 6-max Seat #1 is the button
Seat 1: AvGeL ($12.06 in chips) 
Seat 2: ildar87kzn ($10.05 in chips) 
Seat 4: FeL.Ru ($9.13 in chips) 
Seat 5: Ifivecrypto ($9.37 in chips) 
Seat 6: kjohnson1409 ($13 in chips) 
ildar87kzn: posts small blind $0.05
FeL.Ru: posts big blind $0.10
*** HOLE CARDS ***
Ifivecrypto has timed out
Ifivecrypto: folds 
kjohnson1409: raises $0.20 to $0.30
AvGeL: folds 
ildar87kzn: raises $0.90 to $1.20
FeL.Ru: folds 
kjohnson1409: folds 
Uncalled bet ($0.90) returned to ildar87kzn
ildar87kzn collected $0.70 from pot
ildar87kzn: doesn't show hand 
*** SUMMARY ***
Total pot $0.70 | Rake $0 
Seat 1: AvGeL (button) folded before Flop (didn't bet)
Seat 2: ildar87kzn (small blind) collected ($0.70)
Seat 4: FeL.Ru (big blind) folded before Flop
Seat 5: Ifivecrypto folded before Flop (didn't bet)
Seat 6: kjohnson1409 folded before Flop



PokerStars Hand #222945172826:  Hold'em No Limit ($0.05/$0.10 USD) - 2021/01/23 0:31:27 ET
Table 'Malzovia III' 6-max Seat #2 is the button
Seat 1: AvGeL ($12.06 in chips) 
Seat 2: ildar87kzn ($10.45 in chips) 
Seat 4: FeL.Ru ($9.03 in chips) 
Seat 5: Ifivecrypto ($9.37 in chips) 
Seat 6: kjohnson1409 ($12.70 in chips) 
FeL.Ru: posts small blind $0.05
Ifivecrypto: posts big blind $0.10
*** HOLE CARDS ***
kjohnson1409: folds 
AvGeL: raises $0.15 to $0.25
ildar87kzn: folds 
FeL.Ru: folds 
Ifivecrypto: calls $0.15
*** FLOP *** [8d 7d 6h]
Ifivecrypto: checks 
AvGeL: bets $0.27
Ifivecrypto: calls $0.27
*** TURN *** [8d 7d 6h] [9s]
Ifivecrypto: checks 
AvGeL: bets $0.52
gresscrack joins the table at seat #3 
Ifivecrypto: raises $8.33 to $8.85 and is all-in
AvGeL: folds 
Uncalled bet ($8.33) returned to Ifivecrypto
Ifivecrypto collected $2.03 from pot
Ifivecrypto: doesn't show hand 
*** SUMMARY ***
Total pot $2.13 | Rake $0.10 
Board [8d 7d 6h 9s]
Seat 1: AvGeL folded on the Turn
Seat 2: ildar87kzn (button) folded before Flop (didn't bet)
Seat 4: FeL.Ru (small blind) folded before Flop
Seat 5: Ifivecrypto (big blind) collected ($2.03)
Seat 6: kjohnson1409 folded before Flop (didn't bet)



PokerStars Hand #222945189207:  Hold'em No Limit ($0.05/$0.10 USD) - 2021/01/23 0:32:28 ET
Table 'Malzovia III' 6-max Seat #4 is the button
Seat 1: AvGeL ($11.02 in chips) 
Seat 2: ildar87kzn ($10.45 in chips) 
Seat 4: FeL.Ru ($8.98 in chips) 
Seat 5: Ifivecrypto ($10.36 in chips) 
Seat 6: kjohnson1409 ($12.70 in chips) 
Ifivecrypto: posts small blind $0.05
kjohnson1409: posts big blind $0.10
gresscrack: sits out 
*** HOLE CARDS ***
AvGeL: raises $0.20 to $0.30
ildar87kzn: folds 
FeL.Ru: calls $0.30
Ifivecrypto: calls $0.25
kjohnson1409: folds 
*** FLOP *** [Qh 9h 7c]
Ifivecrypto: checks 
AvGeL: checks 
FeL.Ru: checks 
*** TURN *** [Qh 9h 7c] [8d]
Ifivecrypto: checks 
AvGeL: checks 
FeL.Ru: bets $0.58
Ifivecrypto: calls $0.58
AvGeL: folds 
*** RIVER *** [Qh 9h 7c 8d] [9s]
Ifivecrypto: checks 
FeL.Ru: checks 
*** SHOW DOWN ***
Ifivecrypto: shows [Qc 2c] (two pair, Queens and Nines)
FeL.Ru: mucks hand 
Ifivecrypto collected $2.06 from pot
*** SUMMARY ***
Total pot $2.16 | Rake $0.10 
Board [Qh 9h 7c 8d 9s]
Seat 1: AvGeL folded on the Turn
Seat 2: ildar87kzn folded before Flop (didn't bet)
Seat 4: FeL.Ru (button) mucked
Seat 5: Ifivecrypto (small blind) showed [Qc 2c] and won ($2.06) with two pair, Queens and Nines
Seat 6: kjohnson1409 (big blind) folded before Flop



PokerStars Hand #222945212044:  Hold'em No Limit ($0.05/$0.10 USD) - 2021/01/23 0:33:52 ET
Table 'Malzovia III' 6-max Seat #5 is the button
Seat 1: AvGeL ($10.72 in chips) 
Seat 2: ildar87kzn ($10.45 in chips) 
Seat 4: FeL.Ru ($8.10 in chips) 
Seat 5: Ifivecrypto ($11.54 in chips) 
Seat 6: kjohnson1409 ($12.60 in chips) 
kjohnson1409: posts small blind $0.05
AvGeL: posts big blind $0.10
gresscrack: sits out 
*** HOLE CARDS ***
ildar87kzn: folds 
FeL.Ru: folds 
Ifivecrypto: folds 
kjohnson1409: raises $0.20 to $0.30
AvGeL: folds 
Uncalled bet ($0.20) returned to kjohnson1409
kjohnson1409 collected $0.20 from pot
kjohnson1409: doesn't show hand 
*** SUMMARY ***
Total pot $0.20 | Rake $0 
Seat 1: AvGeL (big blind) folded before Flop
Seat 2: ildar87kzn folded before Flop (didn't bet)
Seat 4: FeL.Ru folded before Flop (didn't bet)
Seat 5: Ifivecrypto (button) folded before Flop (didn't bet)
Seat 6: kjohnson1409 (small blind) collected ($0.20)



PokerStars Hand #222945217508:  Hold'em No Limit ($0.05/$0.10 USD) - 2021/01/23 0:34:13 ET
Table 'Malzovia III' 6-max Seat #6 is the button
Seat 1: AvGeL ($10.62 in chips) 
Seat 2: ildar87kzn ($10.45 in chips) 
Seat 4: FeL.Ru ($8.10 in chips) 
Seat 5: Ifivecrypto ($11.54 in chips) 
Seat 6: kjohnson1409 ($12.70 in chips) 
AvGeL: posts small blind $0.05
ildar87kzn: posts big blind $0.10
gresscrack: sits out 
*** HOLE CARDS ***
FeL.Ru: folds 
Ifivecrypto: folds 
kjohnson1409: folds 
AvGeL: raises $0.20 to $0.30
ildar87kzn: calls $0.20
*** FLOP *** [As 3c 4s]
AvGeL: bets $0.29
ildar87kzn: folds 
Uncalled bet ($0.29) returned to AvGeL
AvGeL collected $0.57 from pot
*** SUMMARY ***
Total pot $0.60 | Rake $0.03 
Board [As 3c 4s]
Seat 1: AvGeL (small blind) collected ($0.57)
Seat 2: ildar87kzn (big blind) folded on the Flop
Seat 4: FeL.Ru folded before Flop (didn't bet)
Seat 5: Ifivecrypto folded before Flop (didn't bet)
Seat 6: kjohnson1409 (button) folded before Flop (didn't bet)



PokerStars Hand #222945225663:  Hold'em No Limit ($0.05/$0.10 USD) - 2021/01/23 0:34:43 ET
Table 'Malzovia III' 6-max Seat #1 is the button
Seat 1: AvGeL ($10.89 in chips) 
Seat 2: ildar87kzn ($10.15 in chips) 
Seat 3: gresscrack ($16.80 in chips) 
Seat 4: FeL.Ru ($8.10 in chips) 
Seat 5: Ifivecrypto ($11.54 in chips) 
Seat 6: kjohnson1409 ($12.70 in chips) 
ildar87kzn: posts small blind $0.05
gresscrack: posts big blind $0.10
*** HOLE CARDS ***
FeL.Ru: folds 
Ifivecrypto: folds 
kjohnson1409: folds 
AvGeL: raises $0.10 to $0.20
ildar87kzn: folds 
gresscrack: folds 
Uncalled bet ($0.10) returned to AvGeL
AvGeL collected $0.25 from pot
*** SUMMARY ***
Total pot $0.25 | Rake $0 
Seat 1: AvGeL (button) collected ($0.25)
Seat 2: ildar87kzn (small blind) folded before Flop
Seat 3: gresscrack (big blind) folded before Flop
Seat 4: FeL.Ru folded before Flop (didn't bet)
Seat 5: Ifivecrypto folded before Flop (didn't bet)
Seat 6: kjohnson1409 folded before Flop (didn't bet)



PokerStars Hand #222945229786:  Hold'em No Limit ($0.05/$0.10 USD) - 2021/01/23 0:34:59 ET
Table 'Malzovia III' 6-max Seat #2 is the button
Seat 1: AvGeL ($11.04 in chips) 
Seat 2: ildar87kzn ($10.10 in chips) 
Seat 3: gresscrack ($16.70 in chips) 
Seat 4: FeL.Ru ($8.10 in chips) 
Seat 5: Ifivecrypto ($11.54 in chips) 
Seat 6: kjohnson1409 ($12.70 in chips) 
gresscrack: posts small blind $0.05
FeL.Ru: posts big blind $0.10
*** HOLE CARDS ***
Ifivecrypto: calls $0.10
kjohnson1409: raises $0.20 to $0.30
AvGeL: calls $0.30
ildar87kzn: raises $1 to $1.30
gresscrack: folds 
FeL.Ru: folds 
Ifivecrypto: folds 
kjohnson1409: folds 
AvGeL: calls $1
*** FLOP *** [5s 8c Jh]
AvGeL: checks 
ildar87kzn: checks 
*** TURN *** [5s 8c Jh] [4d]
AvGeL: bets $1.51
ildar87kzn: folds 
Uncalled bet ($1.51) returned to AvGeL
AvGeL collected $3.01 from pot
*** SUMMARY ***
Total pot $3.15 | Rake $0.14 
Board [5s 8c Jh 4d]
Seat 1: AvGeL collected ($3.01)
Seat 2: ildar87kzn (button) folded on the Turn
Seat 3: gresscrack (small blind) folded before Flop
Seat 4: FeL.Ru (big blind) folded before Flop
Seat 5: Ifivecrypto folded before Flop
Seat 6: kjohnson1409 folded before Flop



PokerStars Hand #222945242954:  Hold'em No Limit ($0.05/$0.10 USD) - 2021/01/23 0:35:48 ET
Table 'Malzovia III' 6-max Seat #3 is the button
Seat 1: AvGeL ($12.75 in chips) 
Seat 2: ildar87kzn ($10 in chips) 
Seat 3: gresscrack ($16.65 in chips) 
Seat 4: FeL.Ru ($8 in chips) 
Seat 5: Ifivecrypto ($11.44 in chips) 
Seat 6: kjohnson1409 ($12.40 in chips) 
FeL.Ru: posts small blind $0.05
Ifivecrypto: posts big blind $0.10
*** HOLE CARDS ***
kjohnson1409: folds 
AvGeL: raises $0.20 to $0.30
ildar87kzn: folds 
gresscrack: folds 
FeL.Ru: folds 
Ifivecrypto: folds 
Uncalled bet ($0.20) returned to AvGeL
AvGeL collected $0.25 from pot
*** SUMMARY ***
Total pot $0.25 | Rake $0 
Seat 1: AvGeL collected ($0.25)
Seat 2: ildar87kzn folded before Flop (didn't bet)
Seat 3: gresscrack (button) folded before Flop (didn't bet)
Seat 4: FeL.Ru (small blind) folded before Flop
Seat 5: Ifivecrypto (big blind) folded before Flop
Seat 6: kjohnson1409 folded before Flop (didn't bet)



PokerStars Hand #222945247460:  Hold'em No Limit ($0.05/$0.10 USD) - 2021/01/23 0:36:05 ET
Table 'Malzovia III' 6-max Seat #4 is the button
Seat 1: AvGeL ($12.90 in chips) 
Seat 2: ildar87kzn ($10 in chips) 
Seat 3: gresscrack ($16.65 in chips) 
Seat 4: FeL.Ru ($7.95 in chips) 
Seat 5: Ifivecrypto ($11.34 in chips) 
Seat 6: kjohnson1409 ($12.40 in chips) 
Ifivecrypto: posts small blind $0.05
kjohnson1409: posts big blind $0.10
*** HOLE CARDS ***
AvGeL: raises $0.20 to $0.30
ildar87kzn: folds 
gresscrack: folds 
FeL.Ru: calls $0.30
Ifivecrypto: folds 
kjohnson1409: folds 
*** FLOP *** [5h Tc 9c]
AvGeL: bets $0.36
FeL.Ru: calls $0.36
*** TURN *** [5h Tc 9c] [5d]
AvGeL: checks 
FeL.Ru: bets $0.80
AvGeL: calls $0.80
*** RIVER *** [5h Tc 9c 5d] [4s]
AvGeL: checks 
FeL.Ru: bets $2.06
AvGeL: calls $2.06
*** SHOW DOWN ***
FeL.Ru: shows [Qh Jd] (a pair of Fives)
AvGeL: shows [6s 6d] (two pair, Sixes and Fives)
AvGeL collected $6.87 from pot
*** SUMMARY ***
Total pot $7.19 | Rake $0.32 
Board [5h Tc 9c 5d 4s]
Seat 1: AvGeL showed [6s 6d] and won ($6.87) with two pair, Sixes and Fives
Seat 2: ildar87kzn folded before Flop (didn't bet)
Seat 3: gresscrack folded before Flop (didn't bet)
Seat 4: FeL.Ru (button) showed [Qh Jd] and lost with a pair of Fives
Seat 5: Ifivecrypto (small blind) folded before Flop
Seat 6: kjohnson1409 (big blind) folded before Flop



PokerStars Hand #222945261190:  Hold'em No Limit ($0.05/$0.10 USD) - 2021/01/23 0:36:57 ET
Table 'Malzovia III' 6-max Seat #5 is the button
Seat 1: AvGeL ($16.25 in chips) 
Seat 2: ildar87kzn ($10 in chips) 
Seat 3: gresscrack ($16.65 in chips) 
Seat 4: FeL.Ru ($4.43 in chips) 
Seat 5: Ifivecrypto ($11.29 in chips) 
Seat 6: kjohnson1409 ($12.30 in chips) 
kjohnson1409: posts small blind $0.05
AvGeL: posts big blind $0.10
*** HOLE CARDS ***
ildar87kzn: folds 
gresscrack: folds 
FeL.Ru: folds 
Ifivecrypto: calls $0.10
kjohnson1409: raises $0.30 to $0.40
AvGeL: folds 
Ifivecrypto: calls $0.30
*** FLOP *** [Kc 3d 4c]
kjohnson1409: bets $0.43
Ifivecrypto: calls $0.43
*** TURN *** [Kc 3d 4c] [2c]
kjohnson1409: bets $1.68
Ifivecrypto: raises $8.78 to $10.46 and is all-in
kjohnson1409: folds 
Uncalled bet ($8.78) returned to Ifivecrypto
Ifivecrypto collected $4.89 from pot
Ifivecrypto: doesn't show hand 
*** SUMMARY ***
Total pot $5.12 | Rake $0.23 
Board [Kc 3d 4c 2c]
Seat 1: AvGeL (big blind) folded before Flop
Seat 2: ildar87kzn folded before Flop (didn't bet)
Seat 3: gresscrack folded before Flop (didn't bet)
Seat 4: FeL.Ru folded before Flop (didn't bet)
Seat 5: Ifivecrypto (button) collected ($4.89)
Seat 6: kjohnson1409 (small blind) folded on the Turn



PokerStars Hand #222945278013:  Hold'em No Limit ($0.05/$0.10 USD) - 2021/01/23 0:38:00 ET
Table 'Malzovia III' 6-max Seat #6 is the button
Seat 1: AvGeL ($16.15 in chips) 
Seat 2: ildar87kzn ($10 in chips) 
Seat 3: gresscrack ($16.65 in chips) 
Seat 4: FeL.Ru ($10 in chips) 
Seat 5: Ifivecrypto ($13.67 in chips) 
Seat 6: kjohnson1409 ($9.79 in chips) 
AvGeL: posts small blind $0.05
ildar87kzn: posts big blind $0.10
*** HOLE CARDS ***
gresscrack: raises $0.20 to $0.30
FeL.Ru: folds 
Ifivecrypto: folds 
kjohnson1409: folds 
AvGeL: folds 
ildar87kzn: folds 
Uncalled bet ($0.20) returned to gresscrack
gresscrack collected $0.25 from pot
gresscrack: doesn't show hand 
*** SUMMARY ***
Total pot $0.25 | Rake $0 
Seat 1: AvGeL (small blind) folded before Flop
Seat 2: ildar87kzn (big blind) folded before Flop
Seat 3: gresscrack collected ($0.25)
Seat 4: FeL.Ru folded before Flop (didn't bet)
Seat 5: Ifivecrypto folded before Flop (didn't bet)
Seat 6: kjohnson1409 (button) folded before Flop (didn't bet)



PokerStars Hand #222945284472:  Hold'em No Limit ($0.05/$0.10 USD) - 2021/01/23 0:38:24 ET
Table 'Malzovia III' 6-max Seat #1 is the button
Seat 1: AvGeL ($16.10 in chips) 
Seat 2: ildar87kzn ($10 in chips) 
Seat 3: gresscrack ($16.80 in chips) 
Seat 4: FeL.Ru ($10 in chips) 
Seat 5: Ifivecrypto ($13.67 in chips) 
Seat 6: kjohnson1409 ($9.79 in chips) 
ildar87kzn: posts small blind $0.05
gresscrack: posts big blind $0.10
*** HOLE CARDS ***
FeL.Ru: raises $0.20 to $0.30
Ifivecrypto: calls $0.30
kjohnson1409: folds 
AvGeL: calls $0.30
ildar87kzn: folds 
gresscrack: folds 
*** FLOP *** [7s Qs 5c]
FeL.Ru: checks 
Ifivecrypto: checks 
AvGeL: checks 
*** TURN *** [7s Qs 5c] [3c]
FeL.Ru: checks 
Ifivecrypto: checks 
AvGeL: bets $0.75
FeL.Ru: folds 
Ifivecrypto: folds 
Uncalled bet ($0.75) returned to AvGeL
AvGeL collected $1 from pot
*** SUMMARY ***
Total pot $1.05 | Rake $0.05 
Board [7s Qs 5c 3c]
Seat 1: AvGeL (button) collected ($1)
Seat 2: ildar87kzn (small blind) folded before Flop
Seat 3: gresscrack (big blind) folded before Flop
Seat 4: FeL.Ru folded on the Turn
Seat 5: Ifivecrypto folded on the Turn
Seat 6: kjohnson1409 folded before Flop (didn't bet)



PokerStars Hand #222945300372:  Hold'em No Limit ($0.05/$0.10 USD) - 2021/01/23 0:39:25 ET
Table 'Malzovia III' 6-max Seat #2 is the button
Seat 1: AvGeL ($16.80 in chips) 
Seat 2: ildar87kzn ($10 in chips) 
Seat 3: gresscrack ($16.70 in chips) 
Seat 4: FeL.Ru ($9.70 in chips) 
Seat 5: Ifivecrypto ($13.37 in chips) 
Seat 6: kjohnson1409 ($9.79 in chips) 
gresscrack: posts small blind $0.05
FeL.Ru: posts big blind $0.10
*** HOLE CARDS ***
Ifivecrypto: folds 
kjohnson1409: folds 
AvGeL: folds 
ildar87kzn: folds 
gresscrack: raises $0.20 to $0.30
FeL.Ru: folds 
Uncalled bet ($0.20) returned to gresscrack
gresscrack collected $0.20 from pot
gresscrack: doesn't show hand 
*** SUMMARY ***
Total pot $0.20 | Rake $0 
Seat 1: AvGeL folded before Flop (didn't bet)
Seat 2: ildar87kzn (button) folded before Flop (didn't bet)
Seat 3: gresscrack (small blind) collected ($0.20)
Seat 4: FeL.Ru (big blind) folded before Flop
Seat 5: Ifivecrypto folded before Flop (didn't bet)
Seat 6: kjohnson1409 folded before Flop (didn't bet)



PokerStars Hand #222945304180:  Hold'em No Limit ($0.05/$0.10 USD) - 2021/01/23 0:39:39 ET
Table 'Malzovia III' 6-max Seat #3 is the button
Seat 1: AvGeL ($16.80 in chips) 
Seat 2: ildar87kzn ($10 in chips) 
Seat 3: gresscrack ($16.80 in chips) 
Seat 4: FeL.Ru ($9.60 in chips) 
Seat 5: Ifivecrypto ($13.37 in chips) 
Seat 6: kjohnson1409 ($9.79 in chips) 
FeL.Ru: posts small blind $0.05
Ifivecrypto: posts big blind $0.10
*** HOLE CARDS ***
kjohnson1409: folds 
AvGeL: folds 
ildar87kzn: folds 
gresscrack: folds 
FeL.Ru: raises $0.20 to $0.30
Ifivecrypto: calls $0.20
*** FLOP *** [Tc 5h Td]
FeL.Ru: checks 
Ifivecrypto: checks 
*** TURN *** [Tc 5h Td] [9s]
FeL.Ru: bets $0.38
Ifivecrypto: folds 
Uncalled bet ($0.38) returned to FeL.Ru
FeL.Ru collected $0.57 from pot
FeL.Ru: doesn't show hand 
*** SUMMARY ***
Total pot $0.60 | Rake $0.03 
Board [Tc 5h Td 9s]
Seat 1: AvGeL folded before Flop (didn't bet)
Seat 2: ildar87kzn folded before Flop (didn't bet)
Seat 3: gresscrack (button) folded before Flop (didn't bet)
Seat 4: FeL.Ru (small blind) collected ($0.57)
Seat 5: Ifivecrypto (big blind) folded on the Turn
Seat 6: kjohnson1409 folded before Flop (didn't bet)



PokerStars Hand #222945314148:  Hold'em No Limit ($0.05/$0.10 USD) - 2021/01/23 0:40:17 ET
Table 'Malzovia III' 6-max Seat #4 is the button
Seat 1: AvGeL ($16.80 in chips) 
Seat 2: ildar87kzn ($10 in chips) 
Seat 3: gresscrack ($16.80 in chips) 
Seat 4: FeL.Ru ($9.87 in chips) 
Seat 5: Ifivecrypto ($13.07 in chips) 
Seat 6: kjohnson1409 ($9.79 in chips) 
Ifivecrypto: posts small blind $0.05
kjohnson1409: posts big blind $0.10
*** HOLE CARDS ***
AvGeL: raises $0.20 to $0.30
ildar87kzn: folds 
gresscrack: folds 
FeL.Ru: calls $0.30
Ifivecrypto: folds 
kjohnson1409: calls $0.20
*** FLOP *** [4d 9c Kc]
Ifivecrypto leaves the table
kjohnson1409: checks 
D.Komarov joins the table at seat #5 
AvGeL: bets $0.46
FeL.Ru: calls $0.46
kjohnson1409: calls $0.46
*** TURN *** [4d 9c Kc] [Qd]
kjohnson1409: checks 
AvGeL: bets $1.35
FeL.Ru: calls $1.35
kjohnson1409: folds 
*** RIVER *** [4d 9c Kc Qd] [5d]
AvGeL: checks 
FeL.Ru: bets $1.90
D.Komarov leaves the table
AvGeL: calls $1.90
*** SHOW DOWN ***
FeL.Ru: shows [Qc Ks] (two pair, Kings and Queens)
AvGeL: mucks hand 
whtocean joins the table at seat #5 
FeL.Ru collected $8.43 from pot
*** SUMMARY ***
Total pot $8.83 | Rake $0.40 
Board [4d 9c Kc Qd 5d]
Seat 1: AvGeL mucked
Seat 2: ildar87kzn folded before Flop (didn't bet)
Seat 3: gresscrack folded before Flop (didn't bet)
Seat 4: FeL.Ru (button) showed [Qc Ks] and won ($8.43) with two pair, Kings and Queens
Seat 5: Ifivecrypto (small blind) folded before Flop
Seat 6: kjohnson1409 (big blind) folded on the Turn



PokerStars Hand #222945337360:  Hold'em No Limit ($0.05/$0.10 USD) - 2021/01/23 0:41:45 ET
Table 'Malzovia III' 6-max Seat #6 is the button
Seat 1: AvGeL ($12.79 in chips) 
Seat 2: ildar87kzn ($10 in chips) 
Seat 3: gresscrack ($16.80 in chips) 
Seat 4: FeL.Ru ($14.29 in chips) 
Seat 6: kjohnson1409 ($9.03 in chips) 
AvGeL: posts small blind $0.05
ildar87kzn: posts big blind $0.10
whtocean: sits out 
*** HOLE CARDS ***
gresscrack: folds 
FeL.Ru: folds 
kjohnson1409: folds 
AvGeL: folds 
Uncalled bet ($0.05) returned to ildar87kzn
ildar87kzn collected $0.10 from pot
ildar87kzn: doesn't show hand 
*** SUMMARY ***
Total pot $0.10 | Rake $0 
Seat 1: AvGeL (small blind) folded before Flop
Seat 2: ildar87kzn (big blind) collected ($0.10)
Seat 3: gresscrack folded before Flop (didn't bet)
Seat 4: FeL.Ru folded before Flop (didn't bet)
Seat 6: kjohnson1409 (button) folded before Flop (didn't bet)



PokerStars Hand #222945340510:  Hold'em No Limit ($0.05/$0.10 USD) - 2021/01/23 0:41:57 ET
Table 'Malzovia III' 6-max Seat #1 is the button
Seat 1: AvGeL ($12.74 in chips) 
Seat 2: ildar87kzn ($10.05 in chips) 
Seat 3: gresscrack ($16.80 in chips) 
Seat 4: FeL.Ru ($14.29 in chips) 
Seat 6: kjohnson1409 ($9.03 in chips) 
ildar87kzn: posts small blind $0.05
gresscrack: posts big blind $0.10
whtocean: sits out 
*** HOLE CARDS ***
FeL.Ru: folds 
kjohnson1409: folds 
AvGeL: raises $0.10 to $0.20
ildar87kzn: folds 
gresscrack: folds 
Uncalled bet ($0.10) returned to AvGeL
AvGeL collected $0.25 from pot
*** SUMMARY ***
Total pot $0.25 | Rake $0 
Seat 1: AvGeL (button) collected ($0.25)
Seat 2: ildar87kzn (small blind) folded before Flop
Seat 3: gresscrack (big blind) folded before Flop
Seat 4: FeL.Ru folded before Flop (didn't bet)
Seat 6: kjohnson1409 folded before Flop (didn't bet)



PokerStars Hand #222945348274:  Hold'em No Limit ($0.05/$0.10 USD) - 2021/01/23 0:42:27 ET
Table 'Malzovia III' 6-max Seat #2 is the button
Seat 1: AvGeL ($12.89 in chips) 
Seat 2: ildar87kzn ($10 in chips) 
Seat 3: gresscrack ($16.70 in chips) 
Seat 4: FeL.Ru ($14.29 in chips) 
Seat 6: kjohnson1409 ($9.03 in chips) 
gresscrack: posts small blind $0.05
FeL.Ru: posts big blind $0.10
whtocean: sits out 
*** HOLE CARDS ***
kjohnson1409 has timed out
kjohnson1409: folds 
AvGeL: folds 
ildar87kzn: raises $0.20 to $0.30
gresscrack: folds 
FeL.Ru: raises $0.60 to $0.90
ildar87kzn: calls $0.60
*** FLOP *** [9c Jh 7c]
FeL.Ru: bets $1.18
ildar87kzn: folds 
Uncalled bet ($1.18) returned to FeL.Ru
FeL.Ru collected $1.77 from pot
FeL.Ru: doesn't show hand 
*** SUMMARY ***
Total pot $1.85 | Rake $0.08 
Board [9c Jh 7c]
Seat 1: AvGeL folded before Flop (didn't bet)
Seat 2: ildar87kzn (button) folded on the Flop
Seat 3: gresscrack (small blind) folded before Flop
Seat 4: FeL.Ru (big blind) collected ($1.77)
Seat 6: kjohnson1409 folded before Flop (didn't bet)



PokerStars Hand #222945364420:  Hold'em No Limit ($0.05/$0.10 USD) - 2021/01/23 0:43:15 ET
Table 'Malzovia III' 6-max Seat #3 is the button
Seat 1: AvGeL ($12.89 in chips) 
Seat 2: ildar87kzn ($10 in chips) 
Seat 3: gresscrack ($16.65 in chips) 
Seat 4: FeL.Ru ($15.16 in chips) 
Seat 5: whtocean ($10 in chips) 
Seat 6: kjohnson1409 ($9.03 in chips) 
FeL.Ru: posts small blind $0.05
whtocean: posts big blind $0.10
*** HOLE CARDS ***
kjohnson1409: folds 
AvGeL: folds 
ildar87kzn: raises $0.20 to $0.30
gresscrack: folds 
FeL.Ru: folds 
whtocean: folds 
Uncalled bet ($0.20) returned to ildar87kzn
ildar87kzn collected $0.25 from pot
ildar87kzn: doesn't show hand 
*** SUMMARY ***
Total pot $0.25 | Rake $0 
Seat 1: AvGeL folded before Flop (didn't bet)
Seat 2: ildar87kzn collected ($0.25)
Seat 3: gresscrack (button) folded before Flop (didn't bet)
Seat 4: FeL.Ru (small blind) folded before Flop
Seat 5: whtocean (big blind) folded before Flop
Seat 6: kjohnson1409 folded before Flop (didn't bet)



PokerStars Hand #222947155719:  Hold'em No Limit ($0.05/$0.10 USD) - 2021/01/23 2:47:19 ET
Table 'Malzovia III' 6-max Seat #3 is the button
Seat 1: Bannnkai ($10.08 in chips) 
Seat 2: DrLevty ($10 in chips) 
Seat 3: oksuz77 ($1.62 in chips) 
Seat 4: beastboy3690 ($17.79 in chips) 
Seat 5: levktv ($6.82 in chips) 
Seat 6: el_buchkan ($11.95 in chips) 
beastboy3690: posts small blind $0.05
levktv: posts big blind $0.10
*** HOLE CARDS ***
el_buchkan: raises $0.20 to $0.30
Bannnkai: folds 
DrLevty: folds 
oksuz77: folds 
beastboy3690: folds 
levktv: calls $0.20
*** FLOP *** [Jd 5h Qc]
levktv: checks 
el_buchkan: checks 
*** TURN *** [Jd 5h Qc] [Tc]
levktv: bets $0.25
el_buchkan: folds 
Uncalled bet ($0.25) returned to levktv
levktv collected $0.62 from pot
levktv: doesn't show hand 
*** SUMMARY ***
Total pot $0.65 | Rake $0.03 
Board [Jd 5h Qc Tc]
Seat 1: Bannnkai folded before Flop (didn't bet)
Seat 2: DrLevty folded before Flop (didn't bet)
Seat 3: oksuz77 (button) folded before Flop (didn't bet)
Seat 4: beastboy3690 (small blind) folded before Flop
Seat 5: levktv (big blind) collected ($0.62)
Seat 6: el_buchkan folded on the Turn



PokerStars Hand #222947167043:  Hold'em No Limit ($0.05/$0.10 USD) - 2021/01/23 2:48:07 ET
Table 'Malzovia III' 6-max Seat #4 is the button
Seat 1: Bannnkai ($10.08 in chips) 
Seat 2: DrLevty ($10 in chips) 
Seat 3: oksuz77 ($1.62 in chips) 
Seat 4: beastboy3690 ($17.74 in chips) 
Seat 5: levktv ($7.14 in chips) 
Seat 6: el_buchkan ($11.65 in chips) 
levktv: posts small blind $0.05
el_buchkan: posts big blind $0.10
*** HOLE CARDS ***
Bannnkai has timed out
Bannnkai: folds 
DrLevty: folds 
oksuz77: folds 
beastboy3690: raises $0.15 to $0.25
levktv: folds 
el_buchkan: calls $0.15
*** FLOP *** [Js Qh 4s]
Bannnkai leaves the table
Rebellion195 joins the table at seat #1 
el_buchkan: bets $0.30
beastboy3690: raises $0.90 to $1.20
el_buchkan: folds 
Uncalled bet ($0.90) returned to beastboy3690
beastboy3690 collected $1.10 from pot
beastboy3690: doesn't show hand 
*** SUMMARY ***
Total pot $1.15 | Rake $0.05 
Board [Js Qh 4s]
Seat 1: Bannnkai folded before Flop (didn't bet)
Seat 2: DrLevty folded before Flop (didn't bet)
Seat 3: oksuz77 folded before Flop (didn't bet)
Seat 4: beastboy3690 (button) collected ($1.10)
Seat 5: levktv (small blind) folded before Flop
Seat 6: el_buchkan (big blind) folded on the Flop



PokerStars Hand #222947178877:  Hold'em No Limit ($0.05/$0.10 USD) - 2021/01/23 2:48:57 ET
Table 'Malzovia III' 6-max Seat #5 is the button
Seat 1: Rebellion195 ($10 in chips) 
Seat 2: DrLevty ($10 in chips) 
Seat 3: oksuz77 ($1.62 in chips) 
Seat 4: beastboy3690 ($18.29 in chips) 
Seat 5: levktv ($7.09 in chips) 
Seat 6: el_buchkan ($11.10 in chips) 
el_buchkan: posts small blind $0.05
Rebellion195: posts big blind $0.10
*** HOLE CARDS ***
DrLevty: raises $0.20 to $0.30
oksuz77: folds 
beastboy3690: folds 
levktv: folds 
el_buchkan: folds 
Rebellion195: calls $0.20
*** FLOP *** [8c Qc 4c]
Rebellion195: checks 
DrLevty: bets $0.20
Rebellion195: calls $0.20
*** TURN *** [8c Qc 4c] [Ts]
Rebellion195: checks 
DrLevty: bets $0.67
Rebellion195: calls $0.67
*** RIVER *** [8c Qc 4c Ts] [5d]
Rebellion195: checks 
DrLevty: checks 
*** SHOW DOWN ***
Rebellion195: shows [Jd 8d] (a pair of Eights)
DrLevty: shows [Ks Qd] (a pair of Queens)
DrLevty collected $2.28 from pot
*** SUMMARY ***
Total pot $2.39 | Rake $0.11 
Board [8c Qc 4c Ts 5d]
Seat 1: Rebellion195 (big blind) showed [Jd 8d] and lost with a pair of Eights
Seat 2: DrLevty showed [Ks Qd] and won ($2.28) with a pair of Queens
Seat 3: oksuz77 folded before Flop (didn't bet)
Seat 4: beastboy3690 folded before Flop (didn't bet)
Seat 5: levktv (button) folded before Flop (didn't bet)
Seat 6: el_buchkan (small blind) folded before Flop



PokerStars Hand #222947194851:  Hold'em No Limit ($0.05/$0.10 USD) - 2021/01/23 2:50:06 ET
Table 'Malzovia III' 6-max Seat #6 is the button
Seat 1: Rebellion195 ($8.83 in chips) 
Seat 2: DrLevty ($11.11 in chips) 
Seat 3: oksuz77 ($1.62 in chips) 
Seat 4: beastboy3690 ($18.29 in chips) 
Seat 5: levktv ($7.09 in chips) 
Seat 6: el_buchkan ($11.05 in chips) 
Rebellion195: posts small blind $0.05
DrLevty: posts big blind $0.10
*** HOLE CARDS ***
oksuz77: folds 
beastboy3690: folds 
levktv: folds 
el_buchkan: raises $0.15 to $0.25
Rebellion195: calls $0.20
DrLevty: calls $0.15
*** FLOP *** [5d 3d 7d]
Rebellion195: checks 
DrLevty: checks 
el_buchkan: checks 
*** TURN *** [5d 3d 7d] [Kc]
Rebellion195: bets $0.36
DrLevty: folds 
el_buchkan: calls $0.36
*** RIVER *** [5d 3d 7d Kc] [5c]
Rebellion195: bets $0.70
el_buchkan: calls $0.70
*** SHOW DOWN ***
Rebellion195: shows [As Qh] (a pair of Fives)
el_buchkan: shows [9h Ks] (two pair, Kings and Fives)
el_buchkan collected $2.74 from pot
*** SUMMARY ***
Total pot $2.87 | Rake $0.13 
Board [5d 3d 7d Kc 5c]
Seat 1: Rebellion195 (small blind) showed [As Qh] and lost with a pair of Fives
Seat 2: DrLevty (big blind) folded on the Turn
Seat 3: oksuz77 folded before Flop (didn't bet)
Seat 4: beastboy3690 folded before Flop (didn't bet)
Seat 5: levktv folded before Flop (didn't bet)
Seat 6: el_buchkan (button) showed [9h Ks] and won ($2.74) with two pair, Kings and Fives



PokerStars Hand #222947218816:  Hold'em No Limit ($0.05/$0.10 USD) - 2021/01/23 2:51:29 ET
Table 'Malzovia III' 6-max Seat #1 is the button
Seat 1: Rebellion195 ($7.52 in chips) 
Seat 2: DrLevty ($10.86 in chips) 
Seat 3: oksuz77 ($1.62 in chips) 
Seat 4: beastboy3690 ($18.29 in chips) 
Seat 5: levktv ($7.09 in chips) 
Seat 6: el_buchkan ($12.48 in chips) 
DrLevty: posts small blind $0.05
oksuz77: posts big blind $0.10
*** HOLE CARDS ***
beastboy3690: folds 
beastboy3690 leaves the table
levktv: folds 
el_buchkan: raises $0.20 to $0.30
Rebellion195: folds 
DrLevty: folds 
oksuz77: raises $1.32 to $1.62 and is all-in
el_buchkan: calls $1.32
*** FLOP *** [Kd 8c 6s]
*** TURN *** [Kd 8c 6s] [Kc]
*** RIVER *** [Kd 8c 6s Kc] [2d]
*** SHOW DOWN ***
oksuz77: shows [Kh Qs] (three of a kind, Kings)
el_buchkan: shows [As 8s] (two pair, Kings and Eights)
Lord_Antoan joins the table at seat #4 
oksuz77 collected $3.14 from pot
*** SUMMARY ***
Total pot $3.29 | Rake $0.15 
Board [Kd 8c 6s Kc 2d]
Seat 1: Rebellion195 (button) folded before Flop (didn't bet)
Seat 2: DrLevty (small blind) folded before Flop
Seat 3: oksuz77 (big blind) showed [Kh Qs] and won ($3.14) with three of a kind, Kings
Seat 4: beastboy3690 folded before Flop (didn't bet)
Seat 5: levktv folded before Flop (didn't bet)
Seat 6: el_buchkan showed [As 8s] and lost with two pair, Kings and Eights



PokerStars Hand #222947226347:  Hold'em No Limit ($0.05/$0.10 USD) - 2021/01/23 2:52:01 ET
Table 'Malzovia III' 6-max Seat #2 is the button
Seat 1: Rebellion195 ($7.52 in chips) 
Seat 2: DrLevty ($10.81 in chips) 
Seat 3: oksuz77 ($3.14 in chips) 
Seat 4: Lord_Antoan ($10 in chips) 
Seat 5: levktv ($7.09 in chips) 
Seat 6: el_buchkan ($10.86 in chips) 
oksuz77: posts small blind $0.05
Lord_Antoan: posts big blind $0.10
*** HOLE CARDS ***
levktv: raises $0.20 to $0.30
el_buchkan: folds 
Rebellion195: folds 
DrLevty: raises $0.60 to $0.90
oksuz77: folds 
Lord_Antoan: folds 
levktv: raises $0.60 to $1.50
DrLevty: calls $0.60
*** FLOP *** [2h Kc Tc]
levktv: bets $1.20
DrLevty: calls $1.20
*** TURN *** [2h Kc Tc] [9c]
levktv: checks 
DrLevty: checks 
*** RIVER *** [2h Kc Tc 9c] [6h]
levktv: bets $2.12
DrLevty: raises $5.99 to $8.11 and is all-in
levktv: folds 
Uncalled bet ($5.99) returned to DrLevty
DrLevty collected $9.35 from pot
DrLevty: doesn't show hand 
*** SUMMARY ***
Total pot $9.79 | Rake $0.44 
Board [2h Kc Tc 9c 6h]
Seat 1: Rebellion195 folded before Flop (didn't bet)
Seat 2: DrLevty (button) collected ($9.35)
Seat 3: oksuz77 (small blind) folded before Flop
Seat 4: Lord_Antoan (big blind) folded before Flop
Seat 5: levktv folded on the River
Seat 6: el_buchkan folded before Flop (didn't bet)



PokerStars Hand #222947237125:  Hold'em No Limit ($0.05/$0.10 USD) - 2021/01/23 2:52:47 ET
Table 'Malzovia III' 6-max Seat #3 is the button
Seat 1: Rebellion195 ($7.52 in chips) 
Seat 2: DrLevty ($15.34 in chips) 
Seat 3: oksuz77 ($3.09 in chips) 
Seat 4: Lord_Antoan ($10 in chips) 
Seat 5: levktv ($2.27 in chips) 
Seat 6: el_buchkan ($10.86 in chips) 
Lord_Antoan: posts small blind $0.05
levktv: posts big blind $0.10
*** HOLE CARDS ***
el_buchkan: folds 
Rebellion195: folds 
DrLevty: raises $0.20 to $0.30
oksuz77: folds 
Lord_Antoan: folds 
levktv: calls $0.20
*** FLOP *** [5s 3s Kh]
levktv: checks 
DrLevty: bets $0.20
levktv: calls $0.20
*** TURN *** [5s 3s Kh] [8d]
levktv: checks 
DrLevty: checks 
*** RIVER *** [5s 3s Kh 8d] [6d]
levktv: bets $0.40
DrLevty: folds 
Uncalled bet ($0.40) returned to levktv
levktv collected $1 from pot
levktv: doesn't show hand 
*** SUMMARY ***
Total pot $1.05 | Rake $0.05 
Board [5s 3s Kh 8d 6d]
Seat 1: Rebellion195 folded before Flop (didn't bet)
Seat 2: DrLevty folded on the River
Seat 3: oksuz77 (button) folded before Flop (didn't bet)
Seat 4: Lord_Antoan (small blind) folded before Flop
Seat 5: levktv (big blind) collected ($1)
Seat 6: el_buchkan folded before Flop (didn't bet)



PokerStars Hand #222947243958:  Hold'em No Limit ($0.05/$0.10 USD) - 2021/01/23 2:53:17 ET
Table 'Malzovia III' 6-max Seat #4 is the button
Seat 1: Rebellion195 ($7.52 in chips) 
Seat 2: DrLevty ($14.84 in chips) 
Seat 3: oksuz77 ($3.09 in chips) 
Seat 4: Lord_Antoan ($10 in chips) 
Seat 5: levktv ($2.77 in chips) 
Seat 6: el_buchkan ($10.86 in chips) 
levktv: posts small blind $0.05
el_buchkan: posts big blind $0.10
*** HOLE CARDS ***
Rebellion195: folds 
DrLevty: folds 
oksuz77: folds 
Lord_Antoan: folds 
levktv: folds 
Uncalled bet ($0.05) returned to el_buchkan
el_buchkan collected $0.10 from pot
el_buchkan: doesn't show hand 
*** SUMMARY ***
Total pot $0.10 | Rake $0 
Seat 1: Rebellion195 folded before Flop (didn't bet)
Seat 2: DrLevty folded before Flop (didn't bet)
Seat 3: oksuz77 folded before Flop (didn't bet)
Seat 4: Lord_Antoan (button) folded before Flop (didn't bet)
Seat 5: levktv (small blind) folded before Flop
Seat 6: el_buchkan (big blind) collected ($0.10)



PokerStars Hand #222947246046:  Hold'em No Limit ($0.05/$0.10 USD) - 2021/01/23 2:53:26 ET
Table 'Malzovia III' 6-max Seat #5 is the button
Seat 1: Rebellion195 ($7.52 in chips) 
Seat 2: DrLevty ($14.84 in chips) 
Seat 3: oksuz77 ($3.09 in chips) 
Seat 4: Lord_Antoan ($10 in chips) 
Seat 5: levktv ($2.72 in chips) 
Seat 6: el_buchkan ($10.91 in chips) 
el_buchkan: posts small blind $0.05
Rebellion195: posts big blind $0.10
*** HOLE CARDS ***
DrLevty: folds 
oksuz77: folds 
Lord_Antoan: folds 
levktv: folds 
el_buchkan: raises $0.20 to $0.30
Rebellion195: calls $0.20
*** FLOP *** [2s Kd Qs]
el_buchkan: checks 
Rebellion195: bets $0.28
el_buchkan: folds 
Uncalled bet ($0.28) returned to Rebellion195
Rebellion195 collected $0.57 from pot
Rebellion195: doesn't show hand 
*** SUMMARY ***
Total pot $0.60 | Rake $0.03 
Board [2s Kd Qs]
Seat 1: Rebellion195 (big blind) collected ($0.57)
Seat 2: DrLevty folded before Flop (didn't bet)
Seat 3: oksuz77 folded before Flop (didn't bet)
Seat 4: Lord_Antoan folded before Flop (didn't bet)
Seat 5: levktv (button) folded before Flop (didn't bet)
Seat 6: el_buchkan (small blind) folded on the Flop



PokerStars Hand #222947252483:  Hold'em No Limit ($0.05/$0.10 USD) - 2021/01/23 2:53:54 ET
Table 'Malzovia III' 6-max Seat #6 is the button
Seat 1: Rebellion195 ($7.79 in chips) 
Seat 2: DrLevty ($14.84 in chips) 
Seat 3: oksuz77 ($3.09 in chips) 
Seat 4: Lord_Antoan ($10 in chips) 
Seat 5: levktv ($5.12 in chips) 
Seat 6: el_buchkan ($10.61 in chips) 
Rebellion195: posts small blind $0.05
DrLevty: posts big blind $0.10
*** HOLE CARDS ***
oksuz77: folds 
Lord_Antoan: folds 
levktv: raises $0.20 to $0.30
el_buchkan: folds 
Rebellion195: folds 
DrLevty: calls $0.20
*** FLOP *** [Ac 7s 4d]
DrLevty: checks 
levktv: bets $0.25
DrLevty: calls $0.25
*** TURN *** [Ac 7s 4d] [Qd]
DrLevty: checks 
levktv: checks 
*** RIVER *** [Ac 7s 4d Qd] [Kc]
DrLevty: checks 
levktv: bets $0.73
DrLevty: folds 
Uncalled bet ($0.73) returned to levktv
levktv collected $1.10 from pot
levktv: doesn't show hand 
*** SUMMARY ***
Total pot $1.15 | Rake $0.05 
Board [Ac 7s 4d Qd Kc]
Seat 1: Rebellion195 (small blind) folded before Flop
Seat 2: DrLevty (big blind) folded on the River
Seat 3: oksuz77 folded before Flop (didn't bet)
Seat 4: Lord_Antoan folded before Flop (didn't bet)
Seat 5: levktv collected ($1.10)
Seat 6: el_buchkan (button) folded before Flop (didn't bet)



PokerStars Hand #222947263345:  Hold'em No Limit ($0.05/$0.10 USD) - 2021/01/23 2:54:40 ET
Table 'Malzovia III' 6-max Seat #1 is the button
Seat 1: Rebellion195 ($7.74 in chips) 
Seat 2: DrLevty ($14.29 in chips) 
Seat 3: oksuz77 ($3.09 in chips) 
Seat 4: Lord_Antoan ($10 in chips) 
Seat 5: levktv ($5.67 in chips) 
Seat 6: el_buchkan ($10.61 in chips) 
DrLevty: posts small blind $0.05
oksuz77: posts big blind $0.10
*** HOLE CARDS ***
Lord_Antoan: raises $0.20 to $0.30
levktv: folds 
el_buchkan: folds 
Rebellion195: folds 
DrLevty: raises $1.05 to $1.35
oksuz77: folds 
Lord_Antoan: folds 
Uncalled bet ($1.05) returned to DrLevty
DrLevty collected $0.70 from pot
DrLevty: doesn't show hand 
*** SUMMARY ***
Total pot $0.70 | Rake $0 
Seat 1: Rebellion195 (button) folded before Flop (didn't bet)
Seat 2: DrLevty (small blind) collected ($0.70)
Seat 3: oksuz77 (big blind) folded before Flop
Seat 4: Lord_Antoan folded before Flop
Seat 5: levktv folded before Flop (didn't bet)
Seat 6: el_buchkan folded before Flop (didn't bet)



PokerStars Hand #222947269314:  Hold'em No Limit ($0.05/$0.10 USD) - 2021/01/23 2:55:06 ET
Table 'Malzovia III' 6-max Seat #2 is the button
Seat 1: Rebellion195 ($7.74 in chips) 
Seat 2: DrLevty ($14.69 in chips) 
Seat 3: oksuz77 ($2.99 in chips) 
Seat 4: Lord_Antoan ($10 in chips) 
Seat 5: levktv ($5.67 in chips) 
Seat 6: el_buchkan ($10.61 in chips) 
oksuz77: posts small blind $0.05
Lord_Antoan: posts big blind $0.10
*** HOLE CARDS ***
levktv: folds 
el_buchkan: folds 
Rebellion195: folds 
DrLevty: folds 
oksuz77: folds 
Uncalled bet ($0.05) returned to Lord_Antoan
Lord_Antoan collected $0.10 from pot
Lord_Antoan: doesn't show hand 
*** SUMMARY ***
Total pot $0.10 | Rake $0 
Seat 1: Rebellion195 folded before Flop (didn't bet)
Seat 2: DrLevty (button) folded before Flop (didn't bet)
Seat 3: oksuz77 (small blind) folded before Flop
Seat 4: Lord_Antoan (big blind) collected ($0.10)
Seat 5: levktv folded before Flop (didn't bet)
Seat 6: el_buchkan folded before Flop (didn't bet)



PokerStars Hand #222947270968:  Hold'em No Limit ($0.05/$0.10 USD) - 2021/01/23 2:55:14 ET
Table 'Malzovia III' 6-max Seat #3 is the button
Seat 1: Rebellion195 ($7.74 in chips) 
Seat 2: DrLevty ($14.69 in chips) 
Seat 3: oksuz77 ($2.94 in chips) 
Seat 4: Lord_Antoan ($10.05 in chips) 
Seat 5: levktv ($5.67 in chips) 
Seat 6: el_buchkan ($10.61 in chips) 
Lord_Antoan: posts small blind $0.05
levktv: posts big blind $0.10
*** HOLE CARDS ***
el_buchkan: folds 
Rebellion195: raises $0.20 to $0.30
DrLevty: folds 
oksuz77: folds 
Lord_Antoan: folds 
levktv: folds 
Uncalled bet ($0.20) returned to Rebellion195
Rebellion195 collected $0.25 from pot
Rebellion195: doesn't show hand 
*** SUMMARY ***
Total pot $0.25 | Rake $0 
Seat 1: Rebellion195 collected ($0.25)
Seat 2: DrLevty folded before Flop (didn't bet)
Seat 3: oksuz77 (button) folded before Flop (didn't bet)
Seat 4: Lord_Antoan (small blind) folded before Flop
Seat 5: levktv (big blind) folded before Flop
Seat 6: el_buchkan folded before Flop (didn't bet)



PokerStars Hand #222947276316:  Hold'em No Limit ($0.05/$0.10 USD) - 2021/01/23 2:55:41 ET
Table 'Malzovia III' 6-max Seat #4 is the button
Seat 1: Rebellion195 ($7.89 in chips) 
Seat 2: DrLevty ($14.69 in chips) 
Seat 3: oksuz77 ($2.94 in chips) 
Seat 4: Lord_Antoan ($10 in chips) 
Seat 5: levktv ($5.57 in chips) 
Seat 6: el_buchkan ($10.61 in chips) 
levktv: posts small blind $0.05
el_buchkan: posts big blind $0.10
*** HOLE CARDS ***
Rebellion195: folds 
DrLevty: folds 
oksuz77: folds 
Lord_Antoan: folds 
levktv: calls $0.05
el_buchkan: raises $0.25 to $0.35
levktv: calls $0.25
*** FLOP *** [Ah 6s Kh]
levktv: checks 
el_buchkan: checks 
*** TURN *** [Ah 6s Kh] [Ts]
levktv: bets $0.27
el_buchkan: calls $0.27
*** RIVER *** [Ah 6s Kh Ts] [Kd]
levktv: bets $0.47
el_buchkan: calls $0.47
*** SHOW DOWN ***
levktv: shows [9s 7c] (a pair of Kings)
el_buchkan: shows [As 4d] (two pair, Aces and Kings)
el_buchkan collected $2.08 from pot
*** SUMMARY ***
Total pot $2.18 | Rake $0.10 
Board [Ah 6s Kh Ts Kd]
Seat 1: Rebellion195 folded before Flop (didn't bet)
Seat 2: DrLevty folded before Flop (didn't bet)
Seat 3: oksuz77 folded before Flop (didn't bet)
Seat 4: Lord_Antoan (button) folded before Flop (didn't bet)
Seat 5: levktv (small blind) showed [9s 7c] and lost with a pair of Kings
Seat 6: el_buchkan (big blind) showed [As 4d] and won ($2.08) with two pair, Aces and Kings



PokerStars Hand #222947286861:  Hold'em No Limit ($0.05/$0.10 USD) - 2021/01/23 2:56:35 ET
Table 'Malzovia III' 6-max Seat #5 is the button
Seat 1: Rebellion195 ($7.89 in chips) 
Seat 2: DrLevty ($14.69 in chips) 
Seat 3: oksuz77 ($2.94 in chips) 
Seat 4: Lord_Antoan ($10 in chips) 
Seat 5: levktv ($4.48 in chips) 
Seat 6: el_buchkan ($11.60 in chips) 
el_buchkan: posts small blind $0.05
Rebellion195: posts big blind $0.10
*** HOLE CARDS ***
DrLevty: folds 
oksuz77: calls $0.10
Lord_Antoan: folds 
levktv: calls $0.10
el_buchkan: raises $0.50 to $0.60
Rebellion195: folds 
oksuz77: folds 
levktv: folds 
Uncalled bet ($0.50) returned to el_buchkan
el_buchkan collected $0.40 from pot
el_buchkan: doesn't show hand 
*** SUMMARY ***
Total pot $0.40 | Rake $0 
Seat 1: Rebellion195 (big blind) folded before Flop
Seat 2: DrLevty folded before Flop (didn't bet)
Seat 3: oksuz77 folded before Flop
Seat 4: Lord_Antoan folded before Flop (didn't bet)
Seat 5: levktv (button) folded before Flop
Seat 6: el_buchkan (small blind) collected ($0.40)



PokerStars Hand #222947290729:  Hold'em No Limit ($0.05/$0.10 USD) - 2021/01/23 2:56:55 ET
Table 'Malzovia III' 6-max Seat #6 is the button
Seat 1: Rebellion195 ($7.79 in chips) 
Seat 2: DrLevty ($14.69 in chips) 
Seat 3: oksuz77 ($2.84 in chips) 
Seat 4: Lord_Antoan ($10 in chips) 
Seat 5: levktv ($4.38 in chips) 
Seat 6: el_buchkan ($11.90 in chips) 
Rebellion195: posts small blind $0.05
DrLevty: posts big blind $0.10
*** HOLE CARDS ***
oksuz77: folds 
Lord_Antoan: folds 
levktv: folds 
el_buchkan: folds 
Rebellion195: raises $0.20 to $0.30
DrLevty: calls $0.20
*** FLOP *** [Ad Th 9d]
Rebellion195: bets $0.28
DrLevty: calls $0.28
*** TURN *** [Ad Th 9d] [6s]
Rebellion195: checks 
DrLevty: checks 
*** RIVER *** [Ad Th 9d 6s] [Jc]
Rebellion195: bets $0.55
DrLevty: calls $0.55
*** SHOW DOWN ***
Rebellion195: shows [As 7c] (a pair of Aces)
DrLevty: shows [Js 9h] (two pair, Jacks and Nines)
DrLevty collected $2.16 from pot
*** SUMMARY ***
Total pot $2.26 | Rake $0.10 
Board [Ad Th 9d 6s Jc]
Seat 1: Rebellion195 (small blind) showed [As 7c] and lost with a pair of Aces
Seat 2: DrLevty (big blind) showed [Js 9h] and won ($2.16) with two pair, Jacks and Nines
Seat 3: oksuz77 folded before Flop (didn't bet)
Seat 4: Lord_Antoan folded before Flop (didn't bet)
Seat 5: levktv folded before Flop (didn't bet)
Seat 6: el_buchkan (button) folded before Flop (didn't bet)



PokerStars Hand #222947302854:  Hold'em No Limit ($0.05/$0.10 USD) - 2021/01/23 2:57:56 ET
Table 'Malzovia III' 6-max Seat #1 is the button
Seat 1: Rebellion195 ($6.66 in chips) 
Seat 2: DrLevty ($15.72 in chips) 
Seat 3: oksuz77 ($2.84 in chips) 
Seat 4: Lord_Antoan ($10 in chips) 
Seat 5: levktv ($4.38 in chips) 
Seat 6: el_buchkan ($11.90 in chips) 
DrLevty: posts small blind $0.05
oksuz77: posts big blind $0.10
*** HOLE CARDS ***
Lord_Antoan: folds 
levktv: folds 
el_buchkan: folds 
Rebellion195: folds 
DrLevty: folds 
Uncalled bet ($0.05) returned to oksuz77
oksuz77 collected $0.10 from pot
oksuz77: doesn't show hand 
*** SUMMARY ***
Total pot $0.10 | Rake $0 
Seat 1: Rebellion195 (button) folded before Flop (didn't bet)
Seat 2: DrLevty (small blind) folded before Flop
Seat 3: oksuz77 (big blind) collected ($0.10)
Seat 4: Lord_Antoan folded before Flop (didn't bet)
Seat 5: levktv folded before Flop (didn't bet)
Seat 6: el_buchkan folded before Flop (didn't bet)



PokerStars Hand #222947304963:  Hold'em No Limit ($0.05/$0.10 USD) - 2021/01/23 2:58:07 ET
Table 'Malzovia III' 6-max Seat #2 is the button
Seat 1: Rebellion195 ($6.66 in chips) 
Seat 2: DrLevty ($15.67 in chips) 
Seat 3: oksuz77 ($2.89 in chips) 
Seat 4: Lord_Antoan ($10 in chips) 
Seat 5: levktv ($4.38 in chips) 
Seat 6: el_buchkan ($11.90 in chips) 
oksuz77: posts small blind $0.05
Lord_Antoan: posts big blind $0.10
*** HOLE CARDS ***
levktv: folds 
el_buchkan: folds 
Rebellion195: calls $0.10
DrLevty: folds 
DrLevty leaves the table
oksuz77: calls $0.05
Lord_Antoan: checks 
*** FLOP *** [3s 8h Jd]
joeyjojoash joins the table at seat #2 
oksuz77: checks 
Lord_Antoan: checks 
Rebellion195: bets $0.20
oksuz77: folds 
Lord_Antoan: calls $0.20
*** TURN *** [3s 8h Jd] [2h]
Lord_Antoan: checks 
Rebellion195: bets $0.40
Lord_Antoan: calls $0.40
*** RIVER *** [3s 8h Jd 2h] [5h]
Lord_Antoan: checks 
Rebellion195: checks 
*** SHOW DOWN ***
Lord_Antoan: shows [Ah 8d] (a pair of Eights)
Rebellion195: mucks hand 
Lord_Antoan collected $1.43 from pot
*** SUMMARY ***
Total pot $1.50 | Rake $0.07 
Board [3s 8h Jd 2h 5h]
Seat 1: Rebellion195 mucked
Seat 2: DrLevty (button) folded before Flop (didn't bet)
Seat 3: oksuz77 (small blind) folded on the Flop
Seat 4: Lord_Antoan (big blind) showed [Ah 8d] and won ($1.43) with a pair of Eights
Seat 5: levktv folded before Flop (didn't bet)
Seat 6: el_buchkan folded before Flop (didn't bet)



PokerStars Hand #222947321349:  Hold'em No Limit ($0.05/$0.10 USD) - 2021/01/23 2:59:30 ET
Table 'Malzovia III' 6-max Seat #3 is the button
Seat 1: Rebellion195 ($5.96 in chips) 
Seat 2: joeyjojoash ($10 in chips) 
Seat 3: oksuz77 ($2.79 in chips) 
Seat 4: Lord_Antoan ($10.73 in chips) 
Seat 5: levktv ($4.38 in chips) 
Seat 6: el_buchkan ($11.90 in chips) 
Lord_Antoan: posts small blind $0.05
levktv: posts big blind $0.10
joeyjojoash: posts big blind $0.10
*** HOLE CARDS ***
el_buchkan: folds 
Rebellion195: folds 
joeyjojoash: raises $0.20 to $0.30
oksuz77: folds 
Lord_Antoan: folds 
levktv: folds 
Uncalled bet ($0.20) returned to joeyjojoash
joeyjojoash collected $0.25 from pot
joeyjojoash: doesn't show hand 
*** SUMMARY ***
Total pot $0.25 | Rake $0 
Seat 1: Rebellion195 folded before Flop (didn't bet)
Seat 2: joeyjojoash collected ($0.25)
Seat 3: oksuz77 (button) folded before Flop (didn't bet)
Seat 4: Lord_Antoan (small blind) folded before Flop
Seat 5: levktv (big blind) folded before Flop
Seat 6: el_buchkan folded before Flop (didn't bet)



PokerStars Hand #222947326186:  Hold'em No Limit ($0.05/$0.10 USD) - 2021/01/23 2:59:55 ET
Table 'Malzovia III' 6-max Seat #4 is the button
Seat 1: Rebellion195 ($5.96 in chips) 
Seat 2: joeyjojoash ($10.15 in chips) 
Seat 3: oksuz77 ($2.79 in chips) 
Seat 4: Lord_Antoan ($10.68 in chips) 
Seat 5: levktv ($4.28 in chips) 
Seat 6: el_buchkan ($11.90 in chips) 
levktv: posts small blind $0.05
el_buchkan: posts big blind $0.10
*** HOLE CARDS ***
Rebellion195: folds 
joeyjojoash: folds 
oksuz77: folds 
Lord_Antoan: raises $0.20 to $0.30
levktv: folds 
el_buchkan: folds 
Uncalled bet ($0.20) returned to Lord_Antoan
Lord_Antoan collected $0.25 from pot
Lord_Antoan: doesn't show hand 
*** SUMMARY ***
Total pot $0.25 | Rake $0 
Seat 1: Rebellion195 folded before Flop (didn't bet)
Seat 2: joeyjojoash folded before Flop (didn't bet)
Seat 3: oksuz77 folded before Flop (didn't bet)
Seat 4: Lord_Antoan (button) collected ($0.25)
Seat 5: levktv (small blind) folded before Flop
Seat 6: el_buchkan (big blind) folded before Flop



PokerStars Hand #222947331085:  Hold'em No Limit ($0.05/$0.10 USD) - 2021/01/23 3:00:19 ET
Table 'Malzovia III' 6-max Seat #5 is the button
Seat 1: Rebellion195 ($5.96 in chips) 
Seat 2: joeyjojoash ($10.15 in chips) 
Seat 3: oksuz77 ($2.79 in chips) 
Seat 4: Lord_Antoan ($10.83 in chips) 
Seat 5: levktv ($4.23 in chips) 
Seat 6: el_buchkan ($11.80 in chips) 
el_buchkan: posts small blind $0.05
Rebellion195: posts big blind $0.10
*** HOLE CARDS ***
joeyjojoash: raises $0.10 to $0.20
oksuz77: folds 
Lord_Antoan: folds 
levktv: raises $0.55 to $0.75
el_buchkan: folds 
Rebellion195: raises $0.85 to $1.60
joeyjojoash: folds 
levktv: calls $0.85
*** FLOP *** [3d Qc 3h]
Rebellion195: checks 
levktv: checks 
*** TURN *** [3d Qc 3h] [Qs]
Rebellion195: bets $2.70
levktv: calls $2.63 and is all-in
Uncalled bet ($0.07) returned to Rebellion195
*** RIVER *** [3d Qc 3h Qs] [6s]
*** SHOW DOWN ***
Rebellion195: shows [Jh Jc] (two pair, Queens and Jacks)
levktv: shows [As Kc] (two pair, Queens and Threes)
Rebellion195 cashed out the hand for $6.93 | Cash Out Fee $0.07
*** SUMMARY ***
Total pot $8.71 | Rake $0.39 
Board [3d Qc 3h Qs 6s]
Seat 1: Rebellion195 (big blind) showed [Jh Jc] and won ($8.32) with two pair, Queens and Jacks (pot not awarded as player cashed out)
Seat 2: joeyjojoash folded before Flop
Seat 3: oksuz77 folded before Flop (didn't bet)
Seat 4: Lord_Antoan folded before Flop (didn't bet)
Seat 5: levktv (button) showed [As Kc] and lost with two pair, Queens and Threes
Seat 6: el_buchkan (small blind) folded before Flop



PokerStars Hand #222947345979:  Hold'em No Limit ($0.05/$0.10 USD) - 2021/01/23 3:01:27 ET
Table 'Malzovia III' 6-max Seat #6 is the button
Seat 1: Rebellion195 ($8.66 in chips) 
Seat 2: joeyjojoash ($9.95 in chips) 
Seat 3: oksuz77 ($2.79 in chips) 
Seat 4: Lord_Antoan ($10.83 in chips) 
Seat 6: el_buchkan ($11.75 in chips) 
Rebellion195: posts small blind $0.05
joeyjojoash: posts big blind $0.10
*** HOLE CARDS ***
oksuz77: calls $0.10
levktv leaves the table
Lord_Antoan: folds 
el_buchkan: folds 
MostlyGravy joins the table at seat #5 
Rebellion195: folds 
joeyjojoash: checks 
*** FLOP *** [As Js 4s]
joeyjojoash: checks 
oksuz77: bets $0.10
joeyjojoash: calls $0.10
*** TURN *** [As Js 4s] [2h]
joeyjojoash: checks 
oksuz77: bets $0.10
joeyjojoash: calls $0.10
*** RIVER *** [As Js 4s 2h] [3c]
joeyjojoash: checks 
oksuz77: bets $0.30
joeyjojoash: calls $0.30
*** SHOW DOWN ***
oksuz77: shows [Ac 2c] (two pair, Aces and Deuces)
joeyjojoash: mucks hand 
oksuz77 collected $1.19 from pot
*** SUMMARY ***
Total pot $1.25 | Rake $0.06 
Board [As Js 4s 2h 3c]
Seat 1: Rebellion195 (small blind) folded before Flop
Seat 2: joeyjojoash (big blind) mucked
Seat 3: oksuz77 showed [Ac 2c] and won ($1.19) with two pair, Aces and Deuces
Seat 4: Lord_Antoan folded before Flop (didn't bet)
Seat 6: el_buchkan (button) folded before Flop (didn't bet)



PokerStars Hand #222947358094:  Hold'em No Limit ($0.05/$0.10 USD) - 2021/01/23 3:02:21 ET
Table 'Malzovia III' 6-max Seat #1 is the button
Seat 1: Rebellion195 ($8.61 in chips) 
Seat 2: joeyjojoash ($9.35 in chips) 
Seat 3: oksuz77 ($3.38 in chips) 
Seat 4: Lord_Antoan ($10.83 in chips) 
Seat 6: el_buchkan ($11.75 in chips) 
joeyjojoash: posts small blind $0.05
oksuz77: posts big blind $0.10
MostlyGravy: sits out 
*** HOLE CARDS ***
Lord_Antoan: folds 
el_buchkan: folds 
Rebellion195: raises $0.20 to $0.30
joeyjojoash: calls $0.25
oksuz77: folds 
*** FLOP *** [As 8d 4c]
joeyjojoash: checks 
Rebellion195: bets $0.33
joeyjojoash: folds 
Uncalled bet ($0.33) returned to Rebellion195
Rebellion195 collected $0.67 from pot
Rebellion195: doesn't show hand 
*** SUMMARY ***
Total pot $0.70 | Rake $0.03 
Board [As 8d 4c]
Seat 1: Rebellion195 (button) collected ($0.67)
Seat 2: joeyjojoash (small blind) folded on the Flop
Seat 3: oksuz77 (big blind) folded before Flop
Seat 4: Lord_Antoan folded before Flop (didn't bet)
Seat 6: el_buchkan folded before Flop (didn't bet)



PokerStars Hand #222947364330:  Hold'em No Limit ($0.05/$0.10 USD) - 2021/01/23 3:02:48 ET
Table 'Malzovia III' 6-max Seat #2 is the button
Seat 1: Rebellion195 ($8.98 in chips) 
Seat 2: joeyjojoash ($9.05 in chips) 
Seat 3: oksuz77 ($3.28 in chips) 
Seat 4: Lord_Antoan ($10.83 in chips) 
Seat 6: el_buchkan ($11.75 in chips) 
oksuz77: posts small blind $0.05
Lord_Antoan: posts big blind $0.10
MostlyGravy: sits out 
*** HOLE CARDS ***
el_buchkan: folds 
Rebellion195: raises $0.20 to $0.30
joeyjojoash: folds 
oksuz77: folds 
Lord_Antoan: folds 
Uncalled bet ($0.20) returned to Rebellion195
Rebellion195 collected $0.25 from pot
Rebellion195: doesn't show hand 
*** SUMMARY ***
Total pot $0.25 | Rake $0 
Seat 1: Rebellion195 collected ($0.25)
Seat 2: joeyjojoash (button) folded before Flop (didn't bet)
Seat 3: oksuz77 (small blind) folded before Flop
Seat 4: Lord_Antoan (big blind) folded before Flop
Seat 6: el_buchkan folded before Flop (didn't bet)



PokerStars Hand #222947368045:  Hold'em No Limit ($0.05/$0.10 USD) - 2021/01/23 3:03:04 ET
Table 'Malzovia III' 6-max Seat #3 is the button
Seat 1: Rebellion195 ($9.13 in chips) 
Seat 2: joeyjojoash ($10 in chips) 
Seat 3: oksuz77 ($3.23 in chips) 
Seat 4: Lord_Antoan ($10.73 in chips) 
Seat 5: MostlyGravy ($10 in chips) 
Seat 6: el_buchkan ($11.75 in chips) 
Lord_Antoan: posts small blind $0.05
MostlyGravy: posts big blind $0.10
*** HOLE CARDS ***
el_buchkan: folds 
Rebellion195: raises $0.20 to $0.30
joeyjojoash: folds 
oksuz77: folds 
Lord_Antoan: folds 
MostlyGravy: raises $9.70 to $10 and is all-in
Rebellion195: folds 
Uncalled bet ($9.70) returned to MostlyGravy
MostlyGravy collected $0.65 from pot
MostlyGravy: doesn't show hand 
*** SUMMARY ***
Total pot $0.65 | Rake $0 
Seat 1: Rebellion195 folded before Flop
Seat 2: joeyjojoash folded before Flop (didn't bet)
Seat 3: oksuz77 (button) folded before Flop (didn't bet)
Seat 4: Lord_Antoan (small blind) folded before Flop
Seat 5: MostlyGravy (big blind) collected ($0.65)
Seat 6: el_buchkan folded before Flop (didn't bet)



PokerStars Hand #222947375354:  Hold'em No Limit ($0.05/$0.10 USD) - 2021/01/23 3:03:36 ET
Table 'Malzovia III' 6-max Seat #4 is the button
Seat 1: Rebellion195 ($8.83 in chips) 
Seat 2: joeyjojoash ($10 in chips) 
Seat 3: oksuz77 ($3.23 in chips) 
Seat 4: Lord_Antoan ($10.68 in chips) 
Seat 5: MostlyGravy ($10.35 in chips) 
Seat 6: el_buchkan ($11.75 in chips) 
MostlyGravy: posts small blind $0.05
el_buchkan: posts big blind $0.10
*** HOLE CARDS ***
Rebellion195: folds 
joeyjojoash: calls $0.10
oksuz77: folds 
Lord_Antoan: raises $0.30 to $0.40
MostlyGravy: calls $0.35
el_buchkan: folds 
joeyjojoash: calls $0.30
*** FLOP *** [4s Kc 4d]
MostlyGravy: checks 
joeyjojoash: checks 
Lord_Antoan: bets $0.50
MostlyGravy: raises $1 to $1.50
joeyjojoash: folds 
Lord_Antoan: folds 
Uncalled bet ($1) returned to MostlyGravy
MostlyGravy collected $2.20 from pot
MostlyGravy: doesn't show hand 
*** SUMMARY ***
Total pot $2.30 | Rake $0.10 
Board [4s Kc 4d]
Seat 1: Rebellion195 folded before Flop (didn't bet)
Seat 2: joeyjojoash folded on the Flop
Seat 3: oksuz77 folded before Flop (didn't bet)
Seat 4: Lord_Antoan (button) folded on the Flop
Seat 5: MostlyGravy (small blind) collected ($2.20)
Seat 6: el_buchkan (big blind) folded before Flop



PokerStars Hand #222947391915:  Hold'em No Limit ($0.05/$0.10 USD) - 2021/01/23 3:04:47 ET
Table 'Malzovia III' 6-max Seat #5 is the button
Seat 1: Rebellion195 ($8.83 in chips) 
Seat 2: joeyjojoash ($9.60 in chips) 
Seat 3: oksuz77 ($3.23 in chips) 
Seat 4: Lord_Antoan ($10 in chips) 
Seat 5: MostlyGravy ($11.65 in chips) 
Seat 6: el_buchkan ($11.65 in chips) 
el_buchkan: posts small blind $0.05
Rebellion195: posts big blind $0.10
*** HOLE CARDS ***
joeyjojoash: raises $0.20 to $0.30
oksuz77: folds 
Lord_Antoan: calls $0.30
MostlyGravy: raises $0.90 to $1.20
el_buchkan: folds 
Rebellion195: folds 
joeyjojoash: calls $0.90
Lord_Antoan: calls $0.90
*** FLOP *** [Jd 9h 3c]
joeyjojoash: checks 
Lord_Antoan: checks 
MostlyGravy: bets $1.79
joeyjojoash: folds 
Lord_Antoan: folds 
Uncalled bet ($1.79) returned to MostlyGravy
MostlyGravy collected $3.58 from pot
MostlyGravy: doesn't show hand 
*** SUMMARY ***
Total pot $3.75 | Rake $0.17 
Board [Jd 9h 3c]
Seat 1: Rebellion195 (big blind) folded before Flop
Seat 2: joeyjojoash folded on the Flop
Seat 3: oksuz77 folded before Flop (didn't bet)
Seat 4: Lord_Antoan folded on the Flop
Seat 5: MostlyGravy (button) collected ($3.58)
Seat 6: el_buchkan (small blind) folded before Flop



PokerStars Hand #222947405961:  Hold'em No Limit ($0.05/$0.10 USD) - 2021/01/23 3:05:47 ET
Table 'Malzovia III' 6-max Seat #6 is the button
Seat 1: Rebellion195 ($8.73 in chips) 
Seat 2: joeyjojoash ($8.40 in chips) 
Seat 3: oksuz77 ($3.23 in chips) 
Seat 4: Lord_Antoan ($10 in chips) 
Seat 5: MostlyGravy ($14.03 in chips) 
Seat 6: el_buchkan ($11.60 in chips) 
Rebellion195: posts small blind $0.05
joeyjojoash: posts big blind $0.10
*** HOLE CARDS ***
oksuz77: calls $0.10
Lord_Antoan: folds 
MostlyGravy: folds 
el_buchkan: folds 
Rebellion195: calls $0.05
joeyjojoash: folds 
*** FLOP *** [Qh Ts Jc]
joeyjojoash leaves the table
Rebellion195: checks 
oksuz77: bets $0.20
Impostore1988 joins the table at seat #2 
Rebellion195: folds 
Uncalled bet ($0.20) returned to oksuz77
oksuz77 collected $0.29 from pot
oksuz77: doesn't show hand 
*** SUMMARY ***
Total pot $0.30 | Rake $0.01 
Board [Qh Ts Jc]
Seat 1: Rebellion195 (small blind) folded on the Flop
Seat 2: joeyjojoash (big blind) folded before Flop
Seat 3: oksuz77 collected ($0.29)
Seat 4: Lord_Antoan folded before Flop (didn't bet)
Seat 5: MostlyGravy folded before Flop (didn't bet)
Seat 6: el_buchkan (button) folded before Flop (didn't bet)



PokerStars Hand #222947412767:  Hold'em No Limit ($0.05/$0.10 USD) - 2021/01/23 3:06:17 ET
Table 'Malzovia III' 6-max Seat #1 is the button
Seat 1: Rebellion195 ($8.63 in chips) 
Seat 3: oksuz77 ($3.42 in chips) 
Seat 4: Lord_Antoan ($10 in chips) 
Seat 5: MostlyGravy ($14.03 in chips) 
Seat 6: el_buchkan ($11.60 in chips) 
oksuz77: posts small blind $0.05
Lord_Antoan: posts big blind $0.10
*** HOLE CARDS ***
MostlyGravy: calls $0.10
el_buchkan: folds 
Rebellion195: calls $0.10
oksuz77: folds 
Lord_Antoan: raises $0.50 to $0.60
MostlyGravy: calls $0.50
Rebellion195: calls $0.50
*** FLOP *** [4d Ad Jc]
Lord_Antoan: bets $0.97
MostlyGravy: raises $0.97 to $1.94
Rebellion195: folds 
Lord_Antoan: raises $2.06 to $4
MostlyGravy: calls $2.06
*** TURN *** [4d Ad Jc] [3c]
Lord_Antoan: checks 
MostlyGravy: bets $9.43 and is all-in
Lord_Antoan: folds 
Uncalled bet ($9.43) returned to MostlyGravy
MostlyGravy collected $9.41 from pot
MostlyGravy: doesn't show hand 
*** SUMMARY ***
Total pot $9.85 | Rake $0.44 
Board [4d Ad Jc 3c]
Seat 1: Rebellion195 (button) folded on the Flop
Seat 3: oksuz77 (small blind) folded before Flop
Seat 4: Lord_Antoan (big blind) folded on the Turn
Seat 5: MostlyGravy collected ($9.41)
Seat 6: el_buchkan folded before Flop (didn't bet)



PokerStars Hand #222947440443:  Hold'em No Limit ($0.05/$0.10 USD) - 2021/01/23 3:08:16 ET
Table 'Malzovia III' 6-max Seat #3 is the button
Seat 1: Rebellion195 ($8.03 in chips) 
Seat 3: oksuz77 ($3.37 in chips) 
Seat 4: Lord_Antoan ($10 in chips) 
Seat 5: MostlyGravy ($18.84 in chips) 
Seat 6: el_buchkan ($11.60 in chips) 
Lord_Antoan: posts small blind $0.05
MostlyGravy: posts big blind $0.10
Impostore1988: sits out 
*** HOLE CARDS ***
el_buchkan: folds 
Rebellion195: folds 
oksuz77: raises $3.27 to $3.37 and is all-in
Lord_Antoan: folds 
MostlyGravy: folds 
Uncalled bet ($3.27) returned to oksuz77
oksuz77 collected $0.25 from pot
oksuz77: doesn't show hand 
*** SUMMARY ***
Total pot $0.25 | Rake $0 
Seat 1: Rebellion195 folded before Flop (didn't bet)
Seat 3: oksuz77 (button) collected ($0.25)
Seat 4: Lord_Antoan (small blind) folded before Flop
Seat 5: MostlyGravy (big blind) folded before Flop
Seat 6: el_buchkan folded before Flop (didn't bet)



PokerStars Hand #222947447372:  Hold'em No Limit ($0.05/$0.10 USD) - 2021/01/23 3:08:46 ET
Table 'Malzovia III' 6-max Seat #4 is the button
Seat 1: Rebellion195 ($8.03 in chips) 
Seat 3: oksuz77 ($3.52 in chips) 
Seat 4: Lord_Antoan ($10 in chips) 
Seat 5: MostlyGravy ($18.74 in chips) 
Seat 6: el_buchkan ($11.60 in chips) 
MostlyGravy: posts small blind $0.05
el_buchkan: posts big blind $0.10
Impostore1988: sits out 
*** HOLE CARDS ***
Rebellion195: folds 
oksuz77: folds 
Lord_Antoan: folds 
MostlyGravy: calls $0.05
el_buchkan: raises $0.30 to $0.40
MostlyGravy: folds 
Uncalled bet ($0.30) returned to el_buchkan
el_buchkan collected $0.20 from pot
el_buchkan: doesn't show hand 
*** SUMMARY ***
Total pot $0.20 | Rake $0 
Seat 1: Rebellion195 folded before Flop (didn't bet)
Seat 3: oksuz77 folded before Flop (didn't bet)
Seat 4: Lord_Antoan (button) folded before Flop (didn't bet)
Seat 5: MostlyGravy (small blind) folded before Flop
Seat 6: el_buchkan (big blind) collected ($0.20)



PokerStars Hand #222947451978:  Hold'em No Limit ($0.05/$0.10 USD) - 2021/01/23 3:09:06 ET
Table 'Malzovia III' 6-max Seat #5 is the button
Seat 1: Rebellion195 ($8.03 in chips) 
Seat 3: oksuz77 ($3.52 in chips) 
Seat 4: Lord_Antoan ($10 in chips) 
Seat 5: MostlyGravy ($18.64 in chips) 
Seat 6: el_buchkan ($11.70 in chips) 
el_buchkan: posts small blind $0.05
Rebellion195: posts big blind $0.10
Impostore1988: sits out 
*** HOLE CARDS ***
oksuz77: folds 
Lord_Antoan: raises $0.20 to $0.30
MostlyGravy: folds 
el_buchkan: folds 
Rebellion195: calls $0.20
*** FLOP *** [3h Tc 3d]
Rebellion195: checks 
Lord_Antoan: bets $0.30
Rebellion195: folds 
Uncalled bet ($0.30) returned to Lord_Antoan
Lord_Antoan collected $0.62 from pot
Lord_Antoan: doesn't show hand 
*** SUMMARY ***
Total pot $0.65 | Rake $0.03 
Board [3h Tc 3d]
Seat 1: Rebellion195 (big blind) folded on the Flop
Seat 3: oksuz77 folded before Flop (didn't bet)
Seat 4: Lord_Antoan collected ($0.62)
Seat 5: MostlyGravy (button) folded before Flop (didn't bet)
Seat 6: el_buchkan (small blind) folded before Flop



PokerStars Hand #222947466078:  Hold'em No Limit ($0.05/$0.10 USD) - 2021/01/23 3:10:06 ET
Table 'Malzovia III' 6-max Seat #6 is the button
Seat 1: Rebellion195 ($7.73 in chips) 
Seat 2: Impostore1988 ($10 in chips) 
Seat 3: oksuz77 ($3.52 in chips) 
Seat 4: Lord_Antoan ($10.32 in chips) 
Seat 5: MostlyGravy ($18.64 in chips) 
Seat 6: el_buchkan ($11.65 in chips) 
Rebellion195: posts small blind $0.05
Impostore1988: posts big blind $0.10
*** HOLE CARDS ***
oksuz77: folds 
Lord_Antoan: raises $0.20 to $0.30
MostlyGravy: folds 
el_buchkan: folds 
Rebellion195: folds 
Impostore1988: folds 
Uncalled bet ($0.20) returned to Lord_Antoan
Lord_Antoan collected $0.25 from pot
Lord_Antoan: doesn't show hand 
*** SUMMARY ***
Total pot $0.25 | Rake $0 
Seat 1: Rebellion195 (small blind) folded before Flop
Seat 2: Impostore1988 (big blind) folded before Flop
Seat 3: oksuz77 folded before Flop (didn't bet)
Seat 4: Lord_Antoan collected ($0.25)
Seat 5: MostlyGravy folded before Flop (didn't bet)
Seat 6: el_buchkan (button) folded before Flop (didn't bet)



PokerStars Hand #222947469482:  Hold'em No Limit ($0.05/$0.10 USD) - 2021/01/23 3:10:21 ET
Table 'Malzovia III' 6-max Seat #1 is the button
Seat 1: Rebellion195 ($7.68 in chips) 
Seat 2: Impostore1988 ($9.90 in chips) 
Seat 3: oksuz77 ($3.52 in chips) 
Seat 4: Lord_Antoan ($10.47 in chips) 
Seat 5: MostlyGravy ($18.64 in chips) 
Seat 6: el_buchkan ($11.65 in chips) 
Impostore1988: posts small blind $0.05
oksuz77: posts big blind $0.10
*** HOLE CARDS ***
Lord_Antoan: folds 
MostlyGravy: raises $0.20 to $0.30
el_buchkan: folds 
Rebellion195: folds 
Impostore1988: folds 
oksuz77: calls $0.20
*** FLOP *** [8c Ts 9h]
oksuz77: bets $0.10
MostlyGravy: calls $0.10
*** TURN *** [8c Ts 9h] [7c]
oksuz77: bets $0.30
MostlyGravy: calls $0.30
*** RIVER *** [8c Ts 9h 7c] [As]
oksuz77: checks 
MostlyGravy: checks 
*** SHOW DOWN ***
oksuz77: shows [Qc Kd] (high card Ace)
MostlyGravy: shows [6h Ac] (a straight, Six to Ten)
MostlyGravy collected $1.38 from pot
*** SUMMARY ***
Total pot $1.45 | Rake $0.07 
Board [8c Ts 9h 7c As]
Seat 1: Rebellion195 (button) folded before Flop (didn't bet)
Seat 2: Impostore1988 (small blind) folded before Flop
Seat 3: oksuz77 (big blind) showed [Qc Kd] and lost with high card Ace
Seat 4: Lord_Antoan folded before Flop (didn't bet)
Seat 5: MostlyGravy showed [6h Ac] and won ($1.38) with a straight, Six to Ten
Seat 6: el_buchkan folded before Flop (didn't bet)



PokerStars Hand #222947487662:  Hold'em No Limit ($0.05/$0.10 USD) - 2021/01/23 3:11:39 ET
Table 'Malzovia III' 6-max Seat #2 is the button
Seat 1: Rebellion195 ($7.68 in chips) 
Seat 2: Impostore1988 ($9.85 in chips) 
Seat 3: oksuz77 ($2.82 in chips) 
Seat 4: Lord_Antoan ($10.47 in chips) 
Seat 5: MostlyGravy ($19.32 in chips) 
Seat 6: el_buchkan ($11.65 in chips) 
oksuz77: posts small blind $0.05
Lord_Antoan: posts big blind $0.10
*** HOLE CARDS ***
MostlyGravy: raises $0.10 to $0.20
el_buchkan: folds 
Rebellion195: calls $0.20
Impostore1988: calls $0.20
oksuz77: folds 
Lord_Antoan: folds 
*** FLOP *** [9h 2c 7c]
MostlyGravy: bets $0.20
Rebellion195: folds 
Impostore1988: calls $0.20
*** TURN *** [9h 2c 7c] [5h]
MostlyGravy: checks 
Impostore1988: checks 
*** RIVER *** [9h 2c 7c 5h] [6h]
MostlyGravy: bets $0.50
Impostore1988: calls $0.50
*** SHOW DOWN ***
MostlyGravy: shows [3h 3d] (a pair of Threes)
Impostore1988: shows [8h 8d] (a straight, Five to Nine)
Impostore1988 collected $2.05 from pot
*** SUMMARY ***
Total pot $2.15 | Rake $0.10 
Board [9h 2c 7c 5h 6h]
Seat 1: Rebellion195 folded on the Flop
Seat 2: Impostore1988 (button) showed [8h 8d] and won ($2.05) with a straight, Five to Nine
Seat 3: oksuz77 (small blind) folded before Flop
Seat 4: Lord_Antoan (big blind) folded before Flop
Seat 5: MostlyGravy showed [3h 3d] and lost with a pair of Threes
Seat 6: el_buchkan folded before Flop (didn't bet)



PokerStars Hand #222947505171:  Hold'em No Limit ($0.05/$0.10 USD) - 2021/01/23 3:12:53 ET
Table 'Malzovia III' 6-max Seat #3 is the button
Seat 1: Rebellion195 ($7.48 in chips) 
Seat 2: Impostore1988 ($11 in chips) 
Seat 3: oksuz77 ($2.77 in chips) 
Seat 4: Lord_Antoan ($10.37 in chips) 
Seat 5: MostlyGravy ($18.42 in chips) 
Seat 6: el_buchkan ($11.65 in chips) 
Lord_Antoan: posts small blind $0.05
MostlyGravy: posts big blind $0.10
*** HOLE CARDS ***
el_buchkan: raises $0.20 to $0.30
Rebellion195: folds 
Impostore1988: calls $0.30
oksuz77: calls $0.30
Lord_Antoan: folds 
MostlyGravy: calls $0.20
*** FLOP *** [3c 3d 2h]
MostlyGravy: checks 
el_buchkan: checks 
Impostore1988: checks 
oksuz77: checks 
*** TURN *** [3c 3d 2h] [Kc]
MostlyGravy: checks 
el_buchkan: checks 
Impostore1988: checks 
oksuz77: bets $0.20
MostlyGravy: calls $0.20
el_buchkan: calls $0.20
Impostore1988: folds 
*** RIVER *** [3c 3d 2h Kc] [Ks]
MostlyGravy: bets $0.30
el_buchkan: calls $0.30
oksuz77: raises $1.97 to $2.27 and is all-in
MostlyGravy: folds 
el_buchkan: folds 
Uncalled bet ($1.97) returned to oksuz77
oksuz77 collected $2.63 from pot
oksuz77: doesn't show hand 
*** SUMMARY ***
Total pot $2.75 | Rake $0.12 
Board [3c 3d 2h Kc Ks]
Seat 1: Rebellion195 folded before Flop (didn't bet)
Seat 2: Impostore1988 folded on the Turn
Seat 3: oksuz77 (button) collected ($2.63)
Seat 4: Lord_Antoan (small blind) folded before Flop
Seat 5: MostlyGravy (big blind) folded on the River
Seat 6: el_buchkan folded on the River



PokerStars Hand #222947527760:  Hold'em No Limit ($0.05/$0.10 USD) - 2021/01/23 3:14:28 ET
Table 'Malzovia III' 6-max Seat #4 is the button
Seat 2: Impostore1988 ($10.70 in chips) 
Seat 3: oksuz77 ($4.60 in chips) 
Seat 4: Lord_Antoan ($10.32 in chips) 
Seat 5: MostlyGravy ($17.62 in chips) 
Seat 6: el_buchkan ($10.85 in chips) 
MostlyGravy: posts small blind $0.05
el_buchkan: posts big blind $0.10
*** HOLE CARDS ***
Impostore1988: raises $0.10 to $0.20
oksuz77: folds 
Lord_Antoan: folds 
MostlyGravy: folds 
el_buchkan: folds 
Uncalled bet ($0.10) returned to Impostore1988
Impostore1988 collected $0.25 from pot
Impostore1988: doesn't show hand 
*** SUMMARY ***
Total pot $0.25 | Rake $0 
Seat 2: Impostore1988 collected ($0.25)
Seat 3: oksuz77 folded before Flop (didn't bet)
Seat 4: Lord_Antoan (button) folded before Flop (didn't bet)
Seat 5: MostlyGravy (small blind) folded before Flop
Seat 6: el_buchkan (big blind) folded before Flop



PokerStars Hand #222947530728:  Hold'em No Limit ($0.05/$0.10 USD) - 2021/01/23 3:14:40 ET
Table 'Malzovia III' 6-max Seat #5 is the button
Seat 2: Impostore1988 ($10.85 in chips) 
Seat 3: oksuz77 ($4.60 in chips) 
Seat 4: Lord_Antoan ($10.32 in chips) 
Seat 5: MostlyGravy ($17.57 in chips) 
Seat 6: el_buchkan ($10.75 in chips) 
el_buchkan: posts small blind $0.05
Impostore1988: posts big blind $0.10
*** HOLE CARDS ***
oksuz77: calls $0.10
Lord_Antoan: folds 
MostlyGravy: calls $0.10
el_buchkan: folds 
Impostore1988: raises $0.40 to $0.50
oksuz77: calls $0.40
MostlyGravy: folds 
*** FLOP *** [2d 4d 9c]
Impostore1988: checks 
oksuz77: checks 
*** TURN *** [2d 4d 9c] [3c]
Impostore1988: checks 
oksuz77: bets $0.30
Impostore1988: folds 
Uncalled bet ($0.30) returned to oksuz77
oksuz77 collected $1.10 from pot
oksuz77: doesn't show hand 
*** SUMMARY ***
Total pot $1.15 | Rake $0.05 
Board [2d 4d 9c 3c]
Seat 2: Impostore1988 (big blind) folded on the Turn
Seat 3: oksuz77 collected ($1.10)
Seat 4: Lord_Antoan folded before Flop (didn't bet)
Seat 5: MostlyGravy (button) folded before Flop
Seat 6: el_buchkan (small blind) folded before Flop



PokerStars Hand #222947541523:  Hold'em No Limit ($0.05/$0.10 USD) - 2021/01/23 3:15:26 ET
Table 'Malzovia III' 6-max Seat #6 is the button
Seat 2: Impostore1988 ($10.35 in chips) 
Seat 3: oksuz77 ($5.20 in chips) 
Seat 4: Lord_Antoan ($10.32 in chips) 
Seat 5: MostlyGravy ($17.47 in chips) 
Seat 6: el_buchkan ($10.70 in chips) 
Impostore1988: posts small blind $0.05
oksuz77: posts big blind $0.10
*** HOLE CARDS ***
Lord_Antoan: folds 
MostlyGravy: folds 
el_buchkan: folds 
Impostore1988: folds 
Uncalled bet ($0.05) returned to oksuz77
oksuz77 collected $0.10 from pot
oksuz77: doesn't show hand 
*** SUMMARY ***
Total pot $0.10 | Rake $0 
Seat 2: Impostore1988 (small blind) folded before Flop
Seat 3: oksuz77 (big blind) collected ($0.10)
Seat 4: Lord_Antoan folded before Flop (didn't bet)
Seat 5: MostlyGravy folded before Flop (didn't bet)
Seat 6: el_buchkan (button) folded before Flop (didn't bet)



PokerStars Hand #222947545366:  Hold'em No Limit ($0.05/$0.10 USD) - 2021/01/23 3:15:42 ET
Table 'Malzovia III' 6-max Seat #2 is the button
Seat 2: Impostore1988 ($10.30 in chips) 
Seat 3: oksuz77 ($5.25 in chips) 
Seat 4: Lord_Antoan ($10.32 in chips) 
Seat 5: MostlyGravy ($17.47 in chips) 
Seat 6: el_buchkan ($10.70 in chips) 
oksuz77: posts small blind $0.05
Lord_Antoan: posts big blind $0.10
Rebellion195: sits out 
*** HOLE CARDS ***
MostlyGravy: raises $0.20 to $0.30
el_buchkan: folds 
Impostore1988: folds 
oksuz77: folds 
Lord_Antoan: folds 
Uncalled bet ($0.20) returned to MostlyGravy
MostlyGravy collected $0.25 from pot
MostlyGravy: doesn't show hand 
*** SUMMARY ***
Total pot $0.25 | Rake $0 
Seat 2: Impostore1988 (button) folded before Flop (didn't bet)
Seat 3: oksuz77 (small blind) folded before Flop
Seat 4: Lord_Antoan (big blind) folded before Flop
Seat 5: MostlyGravy collected ($0.25)
Seat 6: el_buchkan folded before Flop (didn't bet)



PokerStars Hand #222947549394:  Hold'em No Limit ($0.05/$0.10 USD) - 2021/01/23 3:15:59 ET
Table 'Malzovia III' 6-max Seat #3 is the button
Seat 2: Impostore1988 ($10.30 in chips) 
Seat 3: oksuz77 ($5.20 in chips) 
Seat 4: Lord_Antoan ($10.22 in chips) 
Seat 5: MostlyGravy ($17.62 in chips) 
Seat 6: el_buchkan ($10.70 in chips) 
Lord_Antoan: posts small blind $0.05
MostlyGravy: posts big blind $0.10
Rebellion195: sits out 
*** HOLE CARDS ***
el_buchkan: folds 
Impostore1988: folds 
oksuz77: folds 
Lord_Antoan: folds 
Uncalled bet ($0.05) returned to MostlyGravy
MostlyGravy collected $0.10 from pot
MostlyGravy: doesn't show hand 
*** SUMMARY ***
Total pot $0.10 | Rake $0 
Seat 2: Impostore1988 folded before Flop (didn't bet)
Seat 3: oksuz77 (button) folded before Flop (didn't bet)
Seat 4: Lord_Antoan (small blind) folded before Flop
Seat 5: MostlyGravy (big blind) collected ($0.10)
Seat 6: el_buchkan folded before Flop (didn't bet)



PokerStars Hand #222947552141:  Hold'em No Limit ($0.05/$0.10 USD) - 2021/01/23 3:16:10 ET
Table 'Malzovia III' 6-max Seat #4 is the button
Seat 2: Impostore1988 ($10.30 in chips) 
Seat 3: oksuz77 ($5.20 in chips) 
Seat 4: Lord_Antoan ($10.17 in chips) 
Seat 5: MostlyGravy ($17.67 in chips) 
Seat 6: el_buchkan ($10.70 in chips) 
MostlyGravy: posts small blind $0.05
el_buchkan: posts big blind $0.10
Rebellion195: sits out 
*** HOLE CARDS ***
Impostore1988: folds 
oksuz77: folds 
Lord_Antoan: folds 
MostlyGravy: raises $0.20 to $0.30
el_buchkan: folds 
Uncalled bet ($0.20) returned to MostlyGravy
MostlyGravy collected $0.20 from pot
MostlyGravy: doesn't show hand 
*** SUMMARY ***
Total pot $0.20 | Rake $0 
Seat 2: Impostore1988 folded before Flop (didn't bet)
Seat 3: oksuz77 folded before Flop (didn't bet)
Seat 4: Lord_Antoan (button) folded before Flop (didn't bet)
Seat 5: MostlyGravy (small blind) collected ($0.20)
Seat 6: el_buchkan (big blind) folded before Flop



PokerStars Hand #222947556074:  Hold'em No Limit ($0.05/$0.10 USD) - 2021/01/23 3:16:26 ET
Table 'Malzovia III' 6-max Seat #5 is the button
Seat 1: Rebellion195 ($7.48 in chips) 
Seat 2: Impostore1988 ($10.30 in chips) 
Seat 3: oksuz77 ($5.20 in chips) 
Seat 4: Lord_Antoan ($10.17 in chips) 
Seat 5: MostlyGravy ($17.77 in chips) 
Seat 6: el_buchkan ($10.60 in chips) 
el_buchkan: posts small blind $0.05
Rebellion195: posts big blind $0.10
*** HOLE CARDS ***
Impostore1988: folds 
oksuz77: folds 
Lord_Antoan: folds 
MostlyGravy: raises $0.30 to $0.40
el_buchkan: folds 
Rebellion195: calls $0.30
*** FLOP *** [5h 5s 9s]
Rebellion195: bets $0.40
MostlyGravy: calls $0.40
*** TURN *** [5h 5s 9s] [Ks]
Rebellion195: bets $1.58
MostlyGravy: folds 
Uncalled bet ($1.58) returned to Rebellion195
Rebellion195 collected $1.58 from pot
Rebellion195: doesn't show hand 
*** SUMMARY ***
Total pot $1.65 | Rake $0.07 
Board [5h 5s 9s Ks]
Seat 1: Rebellion195 (big blind) collected ($1.58)
Seat 2: Impostore1988 folded before Flop (didn't bet)
Seat 3: oksuz77 folded before Flop (didn't bet)
Seat 4: Lord_Antoan folded before Flop (didn't bet)
Seat 5: MostlyGravy (button) folded on the Turn
Seat 6: el_buchkan (small blind) folded before Flop



PokerStars Hand #222947574510:  Hold'em No Limit ($0.05/$0.10 USD) - 2021/01/23 3:17:44 ET
Table 'Malzovia III' 6-max Seat #6 is the button
Seat 1: Rebellion195 ($8.26 in chips) 
Seat 2: Impostore1988 ($10.30 in chips) 
Seat 3: oksuz77 ($5.20 in chips) 
Seat 4: Lord_Antoan ($10.17 in chips) 
Seat 5: MostlyGravy ($16.97 in chips) 
Seat 6: el_buchkan ($10.55 in chips) 
Rebellion195: posts small blind $0.05
Impostore1988: posts big blind $0.10
*** HOLE CARDS ***
oksuz77: folds 
Lord_Antoan: folds 
MostlyGravy: raises $0.10 to $0.20
el_buchkan: raises $0.60 to $0.80
Rebellion195: folds 
Impostore1988: folds 
MostlyGravy: folds 
Uncalled bet ($0.60) returned to el_buchkan
el_buchkan collected $0.55 from pot
el_buchkan: doesn't show hand 
*** SUMMARY ***
Total pot $0.55 | Rake $0 
Seat 1: Rebellion195 (small blind) folded before Flop
Seat 2: Impostore1988 (big blind) folded before Flop
Seat 3: oksuz77 folded before Flop (didn't bet)
Seat 4: Lord_Antoan folded before Flop (didn't bet)
Seat 5: MostlyGravy folded before Flop
Seat 6: el_buchkan (button) collected ($0.55)



PokerStars Hand #222947581216:  Hold'em No Limit ($0.05/$0.10 USD) - 2021/01/23 3:18:12 ET
Table 'Malzovia III' 6-max Seat #1 is the button
Seat 1: Rebellion195 ($8.21 in chips) 
Seat 2: Impostore1988 ($10.20 in chips) 
Seat 3: oksuz77 ($5.20 in chips) 
Seat 4: Lord_Antoan ($10.17 in chips) 
Seat 5: MostlyGravy ($16.77 in chips) 
Seat 6: el_buchkan ($10.90 in chips) 
Impostore1988: posts small blind $0.05
oksuz77: posts big blind $0.10
*** HOLE CARDS ***
Lord_Antoan: folds 
MostlyGravy: folds 
el_buchkan: folds 
Rebellion195: folds 
Impostore1988: raises $0.20 to $0.30
oksuz77: folds 
Uncalled bet ($0.20) returned to Impostore1988
Impostore1988 collected $0.20 from pot
Impostore1988: doesn't show hand 
*** SUMMARY ***
Total pot $0.20 | Rake $0 
Seat 1: Rebellion195 (button) folded before Flop (didn't bet)
Seat 2: Impostore1988 (small blind) collected ($0.20)
Seat 3: oksuz77 (big blind) folded before Flop
Seat 4: Lord_Antoan folded before Flop (didn't bet)
Seat 5: MostlyGravy folded before Flop (didn't bet)
Seat 6: el_buchkan folded before Flop (didn't bet)



PokerStars Hand #222947584815:  Hold'em No Limit ($0.05/$0.10 USD) - 2021/01/23 3:18:27 ET
Table 'Malzovia III' 6-max Seat #2 is the button
Seat 1: Rebellion195 ($8.21 in chips) 
Seat 2: Impostore1988 ($10.30 in chips) 
Seat 3: oksuz77 ($5.10 in chips) 
Seat 4: Lord_Antoan ($10.17 in chips) 
Seat 5: MostlyGravy ($16.77 in chips) 
Seat 6: el_buchkan ($10.90 in chips) 
oksuz77: posts small blind $0.05
Lord_Antoan: posts big blind $0.10
*** HOLE CARDS ***
MostlyGravy: folds 
el_buchkan: folds 
Rebellion195: folds 
Impostore1988: folds 
oksuz77: calls $0.05
Lord_Antoan: raises $0.30 to $0.40
oksuz77: folds 
Uncalled bet ($0.30) returned to Lord_Antoan
Lord_Antoan collected $0.20 from pot
Lord_Antoan: doesn't show hand 
*** SUMMARY ***
Total pot $0.20 | Rake $0 
Seat 1: Rebellion195 folded before Flop (didn't bet)
Seat 2: Impostore1988 (button) folded before Flop (didn't bet)
Seat 3: oksuz77 (small blind) folded before Flop
Seat 4: Lord_Antoan (big blind) collected ($0.20)
Seat 5: MostlyGravy folded before Flop (didn't bet)
Seat 6: el_buchkan folded before Flop (didn't bet)



PokerStars Hand #222947587951:  Hold'em No Limit ($0.05/$0.10 USD) - 2021/01/23 3:18:40 ET
Table 'Malzovia III' 6-max Seat #3 is the button
Seat 1: Rebellion195 ($8.21 in chips) 
Seat 2: Impostore1988 ($10.30 in chips) 
Seat 3: oksuz77 ($5 in chips) 
Seat 4: Lord_Antoan ($10.27 in chips) 
Seat 5: MostlyGravy ($16.77 in chips) 
Seat 6: el_buchkan ($10.90 in chips) 
Lord_Antoan: posts small blind $0.05
MostlyGravy: posts big blind $0.10
*** HOLE CARDS ***
el_buchkan: folds 
Rebellion195: raises $0.20 to $0.30
Impostore1988: folds 
oksuz77: folds 
Lord_Antoan: folds 
MostlyGravy: folds 
Uncalled bet ($0.20) returned to Rebellion195
Rebellion195 collected $0.25 from pot
Rebellion195: doesn't show hand 
*** SUMMARY ***
Total pot $0.25 | Rake $0 
Seat 1: Rebellion195 collected ($0.25)
Seat 2: Impostore1988 folded before Flop (didn't bet)
Seat 3: oksuz77 (button) folded before Flop (didn't bet)
Seat 4: Lord_Antoan (small blind) folded before Flop
Seat 5: MostlyGravy (big blind) folded before Flop
Seat 6: el_buchkan folded before Flop (didn't bet)



PokerStars Hand #222947592672:  Hold'em No Limit ($0.05/$0.10 USD) - 2021/01/23 3:19:00 ET
Table 'Malzovia III' 6-max Seat #4 is the button
Seat 1: Rebellion195 ($8.36 in chips) 
Seat 2: Impostore1988 ($10.30 in chips) 
Seat 3: oksuz77 ($5 in chips) 
Seat 4: Lord_Antoan ($10.22 in chips) 
Seat 5: MostlyGravy ($16.67 in chips) 
Seat 6: el_buchkan ($10.90 in chips) 
MostlyGravy: posts small blind $0.05
el_buchkan: posts big blind $0.10
*** HOLE CARDS ***
Rebellion195: raises $0.20 to $0.30
Impostore1988: folds 
oksuz77: folds 
Lord_Antoan: folds 
MostlyGravy: calls $0.25
el_buchkan: folds 
*** FLOP *** [8h Jd Js]
MostlyGravy: bets $0.63
Rebellion195: calls $0.63
*** TURN *** [8h Jd Js] [2h]
MostlyGravy: bets $0.93
Rebellion195: folds 
Uncalled bet ($0.93) returned to MostlyGravy
MostlyGravy collected $1.87 from pot
MostlyGravy: doesn't show hand 
*** SUMMARY ***
Total pot $1.96 | Rake $0.09 
Board [8h Jd Js 2h]
Seat 1: Rebellion195 folded on the Turn
Seat 2: Impostore1988 folded before Flop (didn't bet)
Seat 3: oksuz77 folded before Flop (didn't bet)
Seat 4: Lord_Antoan (button) folded before Flop (didn't bet)
Seat 5: MostlyGravy (small blind) collected ($1.87)
Seat 6: el_buchkan (big blind) folded before Flop



PokerStars Hand #222947605836:  Hold'em No Limit ($0.05/$0.10 USD) - 2021/01/23 3:19:55 ET
Table 'Malzovia III' 6-max Seat #5 is the button
Seat 1: Rebellion195 ($7.43 in chips) 
Seat 2: Impostore1988 ($10.30 in chips) 
Seat 3: oksuz77 ($5 in chips) 
Seat 4: Lord_Antoan ($10.22 in chips) 
Seat 5: MostlyGravy ($17.61 in chips) 
Seat 6: el_buchkan ($10.80 in chips) 
el_buchkan: posts small blind $0.05
Rebellion195: posts big blind $0.10
*** HOLE CARDS ***
Impostore1988: folds 
oksuz77: folds 
Lord_Antoan: folds 
MostlyGravy: folds 
el_buchkan: raises $0.20 to $0.30
Rebellion195: folds 
Uncalled bet ($0.20) returned to el_buchkan
el_buchkan collected $0.20 from pot
el_buchkan: doesn't show hand 
*** SUMMARY ***
Total pot $0.20 | Rake $0 
Seat 1: Rebellion195 (big blind) folded before Flop
Seat 2: Impostore1988 folded before Flop (didn't bet)
Seat 3: oksuz77 folded before Flop (didn't bet)
Seat 4: Lord_Antoan folded before Flop (didn't bet)
Seat 5: MostlyGravy (button) folded before Flop (didn't bet)
Seat 6: el_buchkan (small blind) collected ($0.20)



PokerStars Hand #222947612607:  Hold'em No Limit ($0.05/$0.10 USD) - 2021/01/23 3:20:23 ET
Table 'Malzovia III' 6-max Seat #6 is the button
Seat 1: Rebellion195 ($7.33 in chips) 
Seat 2: Impostore1988 ($10.30 in chips) 
Seat 3: oksuz77 ($5 in chips) 
Seat 4: Lord_Antoan ($10.22 in chips) 
Seat 5: MostlyGravy ($17.61 in chips) 
Seat 6: el_buchkan ($10.90 in chips) 
Rebellion195: posts small blind $0.05
Impostore1988: posts big blind $0.10
*** HOLE CARDS ***
oksuz77: folds 
Lord_Antoan: folds 
MostlyGravy: folds 
el_buchkan: folds 
Rebellion195: raises $0.20 to $0.30
Impostore1988: folds 
Uncalled bet ($0.20) returned to Rebellion195
Rebellion195 collected $0.20 from pot
Rebellion195: doesn't show hand 
*** SUMMARY ***
Total pot $0.20 | Rake $0 
Seat 1: Rebellion195 (small blind) collected ($0.20)
Seat 2: Impostore1988 (big blind) folded before Flop
Seat 3: oksuz77 folded before Flop (didn't bet)
Seat 4: Lord_Antoan folded before Flop (didn't bet)
Seat 5: MostlyGravy folded before Flop (didn't bet)
Seat 6: el_buchkan (button) folded before Flop (didn't bet)



PokerStars Hand #222947616359:  Hold'em No Limit ($0.05/$0.10 USD) - 2021/01/23 3:20:38 ET
Table 'Malzovia III' 6-max Seat #1 is the button
Seat 1: Rebellion195 ($7.43 in chips) 
Seat 2: Impostore1988 ($10.20 in chips) 
Seat 3: oksuz77 ($5 in chips) 
Seat 4: Lord_Antoan ($10.22 in chips) 
Seat 5: MostlyGravy ($17.61 in chips) 
Seat 6: el_buchkan ($10.90 in chips) 
Impostore1988: posts small blind $0.05
oksuz77: posts big blind $0.10
*** HOLE CARDS ***
Lord_Antoan: folds 
MostlyGravy: folds 
el_buchkan: raises $0.20 to $0.30
Rebellion195: folds 
Impostore1988: folds 
oksuz77: folds 
Uncalled bet ($0.20) returned to el_buchkan
el_buchkan collected $0.25 from pot
el_buchkan: doesn't show hand 
*** SUMMARY ***
Total pot $0.25 | Rake $0 
Seat 1: Rebellion195 (button) folded before Flop (didn't bet)
Seat 2: Impostore1988 (small blind) folded before Flop
Seat 3: oksuz77 (big blind) folded before Flop
Seat 4: Lord_Antoan folded before Flop (didn't bet)
Seat 5: MostlyGravy folded before Flop (didn't bet)
Seat 6: el_buchkan collected ($0.25)



PokerStars Hand #222947619733:  Hold'em No Limit ($0.05/$0.10 USD) - 2021/01/23 3:20:53 ET
Table 'Malzovia III' 6-max Seat #2 is the button
Seat 1: Rebellion195 ($7.43 in chips) 
Seat 2: Impostore1988 ($10.15 in chips) 
Seat 3: oksuz77 ($4.90 in chips) 
Seat 4: Lord_Antoan ($10.22 in chips) 
Seat 5: MostlyGravy ($17.61 in chips) 
Seat 6: el_buchkan ($11.05 in chips) 
oksuz77: posts small blind $0.05
Lord_Antoan: posts big blind $0.10
*** HOLE CARDS ***
MostlyGravy: folds 
el_buchkan: folds 
Rebellion195: folds 
Impostore1988: raises $0.20 to $0.30
oksuz77: folds 
Lord_Antoan: folds 
Uncalled bet ($0.20) returned to Impostore1988
Impostore1988 collected $0.25 from pot
Impostore1988: doesn't show hand 
*** SUMMARY ***
Total pot $0.25 | Rake $0 
Seat 1: Rebellion195 folded before Flop (didn't bet)
Seat 2: Impostore1988 (button) collected ($0.25)
Seat 3: oksuz77 (small blind) folded before Flop
Seat 4: Lord_Antoan (big blind) folded before Flop
Seat 5: MostlyGravy folded before Flop (didn't bet)
Seat 6: el_buchkan folded before Flop (didn't bet)



PokerStars Hand #222947624495:  Hold'em No Limit ($0.05/$0.10 USD) - 2021/01/23 3:21:12 ET
Table 'Malzovia III' 6-max Seat #3 is the button
Seat 1: Rebellion195 ($7.43 in chips) 
Seat 2: Impostore1988 ($10.30 in chips) 
Seat 3: oksuz77 ($4.85 in chips) 
Seat 4: Lord_Antoan ($10.12 in chips) 
Seat 5: MostlyGravy ($17.61 in chips) 
Seat 6: el_buchkan ($11.05 in chips) 
Lord_Antoan: posts small blind $0.05
MostlyGravy: posts big blind $0.10
*** HOLE CARDS ***
el_buchkan: folds 
Rebellion195: folds 
Impostore1988: folds 
oksuz77: folds 
Lord_Antoan: folds 
Uncalled bet ($0.05) returned to MostlyGravy
MostlyGravy collected $0.10 from pot
MostlyGravy: doesn't show hand 
*** SUMMARY ***
Total pot $0.10 | Rake $0 
Seat 1: Rebellion195 folded before Flop (didn't bet)
Seat 2: Impostore1988 folded before Flop (didn't bet)
Seat 3: oksuz77 (button) folded before Flop (didn't bet)
Seat 4: Lord_Antoan (small blind) folded before Flop
Seat 5: MostlyGravy (big blind) collected ($0.10)
Seat 6: el_buchkan folded before Flop (didn't bet)



PokerStars Hand #222947626921:  Hold'em No Limit ($0.05/$0.10 USD) - 2021/01/23 3:21:23 ET
Table 'Malzovia III' 6-max Seat #4 is the button
Seat 1: Rebellion195 ($7.43 in chips) 
Seat 2: Impostore1988 ($10.30 in chips) 
Seat 3: oksuz77 ($4.85 in chips) 
Seat 4: Lord_Antoan ($10.07 in chips) 
Seat 5: MostlyGravy ($17.66 in chips) 
Seat 6: el_buchkan ($11.05 in chips) 
MostlyGravy: posts small blind $0.05
el_buchkan: posts big blind $0.10
*** HOLE CARDS ***
Rebellion195: folds 
Impostore1988: folds 
oksuz77: folds 
Lord_Antoan: folds 
MostlyGravy: raises $0.20 to $0.30
el_buchkan: folds 
Uncalled bet ($0.20) returned to MostlyGravy
MostlyGravy collected $0.20 from pot
MostlyGravy: doesn't show hand 
*** SUMMARY ***
Total pot $0.20 | Rake $0 
Seat 1: Rebellion195 folded before Flop (didn't bet)
Seat 2: Impostore1988 folded before Flop (didn't bet)
Seat 3: oksuz77 folded before Flop (didn't bet)
Seat 4: Lord_Antoan (button) folded before Flop (didn't bet)
Seat 5: MostlyGravy (small blind) collected ($0.20)
Seat 6: el_buchkan (big blind) folded before Flop



PokerStars Hand #222947632179:  Hold'em No Limit ($0.05/$0.10 USD) - 2021/01/23 3:21:45 ET
Table 'Malzovia III' 6-max Seat #5 is the button
Seat 1: Rebellion195 ($7.43 in chips) 
Seat 2: Impostore1988 ($10.30 in chips) 
Seat 3: oksuz77 ($4.85 in chips) 
Seat 4: Lord_Antoan ($10.07 in chips) 
Seat 5: MostlyGravy ($17.76 in chips) 
Seat 6: el_buchkan ($10.95 in chips) 
el_buchkan: posts small blind $0.05
Rebellion195: posts big blind $0.10
*** HOLE CARDS ***
Impostore1988 has timed out
Impostore1988: folds 
oksuz77: folds 
Lord_Antoan: folds 
MostlyGravy: folds 
el_buchkan: raises $0.20 to $0.30
Rebellion195: folds 
Uncalled bet ($0.20) returned to el_buchkan
el_buchkan collected $0.20 from pot
el_buchkan: doesn't show hand 
*** SUMMARY ***
Total pot $0.20 | Rake $0 
Seat 1: Rebellion195 (big blind) folded before Flop
Seat 2: Impostore1988 folded before Flop (didn't bet)
Seat 3: oksuz77 folded before Flop (didn't bet)
Seat 4: Lord_Antoan folded before Flop (didn't bet)
Seat 5: MostlyGravy (button) folded before Flop (didn't bet)
Seat 6: el_buchkan (small blind) collected ($0.20)



PokerStars Hand #222947637384:  Hold'em No Limit ($0.05/$0.10 USD) - 2021/01/23 3:22:06 ET
Table 'Malzovia III' 6-max Seat #6 is the button
Seat 1: Rebellion195 ($7.33 in chips) 
Seat 3: oksuz77 ($4.85 in chips) 
Seat 4: Lord_Antoan ($10.07 in chips) 
Seat 5: MostlyGravy ($17.76 in chips) 
Seat 6: el_buchkan ($11.05 in chips) 
Rebellion195: posts small blind $0.05
oksuz77: posts big blind $0.10
*** HOLE CARDS ***
Lord_Antoan: folds 
MostlyGravy: folds 
el_buchkan: folds 
Rebellion195: folds 
Uncalled bet ($0.05) returned to oksuz77
oksuz77 collected $0.10 from pot
oksuz77: doesn't show hand 
*** SUMMARY ***
Total pot $0.10 | Rake $0 
Seat 1: Rebellion195 (small blind) folded before Flop
Seat 3: oksuz77 (big blind) collected ($0.10)
Seat 4: Lord_Antoan folded before Flop (didn't bet)
Seat 5: MostlyGravy folded before Flop (didn't bet)
Seat 6: el_buchkan (button) folded before Flop (didn't bet)



PokerStars Hand #222947640986:  Hold'em No Limit ($0.05/$0.10 USD) - 2021/01/23 3:22:22 ET
Table 'Malzovia III' 6-max Seat #1 is the button
Seat 1: Rebellion195 ($7.28 in chips) 
Seat 3: oksuz77 ($4.90 in chips) 
Seat 4: Lord_Antoan ($10.07 in chips) 
Seat 5: MostlyGravy ($17.76 in chips) 
Seat 6: el_buchkan ($11.05 in chips) 
oksuz77: posts small blind $0.05
Lord_Antoan: posts big blind $0.10
*** HOLE CARDS ***
MostlyGravy: calls $0.10
el_buchkan: folds 
Rebellion195: folds 
oksuz77: folds 
Lord_Antoan: checks 
*** FLOP *** [As 9d 5c]
Lord_Antoan: checks 
MostlyGravy: bets $0.12
Lord_Antoan: folds 
Uncalled bet ($0.12) returned to MostlyGravy
MostlyGravy collected $0.24 from pot
MostlyGravy: doesn't show hand 
*** SUMMARY ***
Total pot $0.25 | Rake $0.01 
Board [As 9d 5c]
Seat 1: Rebellion195 (button) folded before Flop (didn't bet)
Seat 3: oksuz77 (small blind) folded before Flop
Seat 4: Lord_Antoan (big blind) folded on the Flop
Seat 5: MostlyGravy collected ($0.24)
Seat 6: el_buchkan folded before Flop (didn't bet)



PokerStars Hand #222947646576:  Hold'em No Limit ($0.05/$0.10 USD) - 2021/01/23 3:22:45 ET
Table 'Malzovia III' 6-max Seat #3 is the button
Seat 1: Rebellion195 ($7.28 in chips) 
Seat 3: oksuz77 ($4.85 in chips) 
Seat 4: Lord_Antoan ($10 in chips) 
Seat 5: MostlyGravy ($17.90 in chips) 
Seat 6: el_buchkan ($11.05 in chips) 
Lord_Antoan: posts small blind $0.05
MostlyGravy: posts big blind $0.10
Impostore1988: sits out 
*** HOLE CARDS ***
el_buchkan: folds 
Rebellion195: folds 
oksuz77: folds 
Lord_Antoan: raises $0.20 to $0.30
MostlyGravy: folds 
Uncalled bet ($0.20) returned to Lord_Antoan
Lord_Antoan collected $0.20 from pot
Lord_Antoan: doesn't show hand 
*** SUMMARY ***
Total pot $0.20 | Rake $0 
Seat 1: Rebellion195 folded before Flop (didn't bet)
Seat 3: oksuz77 (button) folded before Flop (didn't bet)
Seat 4: Lord_Antoan (small blind) collected ($0.20)
Seat 5: MostlyGravy (big blind) folded before Flop
Seat 6: el_buchkan folded before Flop (didn't bet)



PokerStars Hand #222947650145:  Hold'em No Limit ($0.05/$0.10 USD) - 2021/01/23 3:23:00 ET
Table 'Malzovia III' 6-max Seat #4 is the button
Seat 1: Rebellion195 ($7.28 in chips) 
Seat 3: oksuz77 ($4.85 in chips) 
Seat 4: Lord_Antoan ($10.10 in chips) 
Seat 5: MostlyGravy ($17.80 in chips) 
MostlyGravy: posts small blind $0.05
el_buchkan: is sitting out 
Rebellion195: posts big blind $0.10
Impostore1988: sits out 
*** HOLE CARDS ***
oksuz77: folds 
Lord_Antoan: folds 
MostlyGravy: raises $0.10 to $0.20
el_buchkan leaves the table
Rebellion195: folds 
Uncalled bet ($0.10) returned to MostlyGravy
MostlyGravy collected $0.20 from pot
MostlyGravy: doesn't show hand 
*** SUMMARY ***
Total pot $0.20 | Rake $0 
Seat 1: Rebellion195 (big blind) folded before Flop
Seat 3: oksuz77 folded before Flop (didn't bet)
Seat 4: Lord_Antoan (button) folded before Flop (didn't bet)
Seat 5: MostlyGravy (small blind) collected ($0.20)



PokerStars Hand #222947652654:  Hold'em No Limit ($0.05/$0.10 USD) - 2021/01/23 3:23:10 ET
Table 'Malzovia III' 6-max Seat #5 is the button
Seat 1: Rebellion195 ($7.18 in chips) 
Seat 2: Impostore1988 ($10.30 in chips) 
Seat 3: oksuz77 ($4.85 in chips) 
Seat 4: Lord_Antoan ($10.10 in chips) 
Seat 5: MostlyGravy ($17.90 in chips) 
Rebellion195: posts small blind $0.05
Impostore1988: posts big blind $0.10
*** HOLE CARDS ***
oksuz77: calls $0.10
Lord_Antoan: raises $0.30 to $0.40
MostlyGravy: folds 
Rebellion195: calls $0.35
Impostore1988: folds 
oksuz77: calls $0.30
*** FLOP *** [9s 5d 4s]
Rebellion195: checks 
oksuz77: checks 
Lord_Antoan: bets $0.50
Gcervis1990 joins the table at seat #6 
Rebellion195: folds 
oksuz77: folds 
Uncalled bet ($0.50) returned to Lord_Antoan
Lord_Antoan collected $1.24 from pot
Lord_Antoan: doesn't show hand 
*** SUMMARY ***
Total pot $1.30 | Rake $0.06 
Board [9s 5d 4s]
Seat 1: Rebellion195 (small blind) folded on the Flop
Seat 2: Impostore1988 (big blind) folded before Flop
Seat 3: oksuz77 folded on the Flop
Seat 4: Lord_Antoan collected ($1.24)
Seat 5: MostlyGravy (button) folded before Flop (didn't bet)



PokerStars Hand #222947666653:  Hold'em No Limit ($0.05/$0.10 USD) - 2021/01/23 3:24:09 ET
Table 'Malzovia III' 6-max Seat #1 is the button
Seat 1: Rebellion195 ($6.78 in chips) 
Seat 2: Impostore1988 ($10.20 in chips) 
Seat 3: oksuz77 ($4.45 in chips) 
Seat 4: Lord_Antoan ($10.94 in chips) 
Seat 5: MostlyGravy ($17.90 in chips) 
Seat 6: Gcervis1990 ($6.81 in chips) 
Impostore1988: posts small blind $0.05
oksuz77: posts big blind $0.10
Gcervis1990: posts big blind $0.10
*** HOLE CARDS ***
Lord_Antoan: raises $0.30 to $0.40
MostlyGravy: folds 
Gcervis1990: calls $0.30
Rebellion195: folds 
Impostore1988: folds 
oksuz77: folds 
*** FLOP *** [Qc Ks Ad]
Lord_Antoan: bets $0.32
Gcervis1990: calls $0.32
*** TURN *** [Qc Ks Ad] [5c]
Lord_Antoan: bets $0.80
Gcervis1990: raises $0.80 to $1.60
Lord_Antoan: calls $0.80
*** RIVER *** [Qc Ks Ad 5c] [2h]
Lord_Antoan: checks 
Gcervis1990: bets $4.49 and is all-in
Lord_Antoan: calls $4.49
*** SHOW DOWN ***
Gcervis1990: shows [Kh 8d] (a pair of Kings)
Lord_Antoan: shows [Ac Qs] (two pair, Aces and Queens)
Lord_Antoan collected $13.15 from pot
*** SUMMARY ***
Total pot $13.77 | Rake $0.62 
Board [Qc Ks Ad 5c 2h]
Seat 1: Rebellion195 (button) folded before Flop (didn't bet)
Seat 2: Impostore1988 (small blind) folded before Flop
Seat 3: oksuz77 (big blind) folded before Flop
Seat 4: Lord_Antoan showed [Ac Qs] and won ($13.15) with two pair, Aces and Queens
Seat 5: MostlyGravy folded before Flop (didn't bet)
Seat 6: Gcervis1990 showed [Kh 8d] and lost with a pair of Kings



PokerStars Hand #222947683477:  Hold'em No Limit ($0.05/$0.10 USD) - 2021/01/23 3:25:19 ET
Table 'Malzovia III' 6-max Seat #2 is the button
Seat 1: Rebellion195 ($6.78 in chips) 
Seat 2: Impostore1988 ($10.15 in chips) 
Seat 3: oksuz77 ($4.35 in chips) 
Seat 4: Lord_Antoan ($17.28 in chips) 
Seat 5: MostlyGravy ($17.90 in chips) 
oksuz77: posts small blind $0.05
Lord_Antoan: posts big blind $0.10
*** HOLE CARDS ***
MostlyGravy: calls $0.10
Rebellion195: folds 
Impostore1988: folds 
oksuz77: folds 
Lord_Antoan: checks 
*** FLOP *** [6s Td Ad]
Lord_Antoan: checks 
Gcervis1990 leaves the table
MostlyGravy: bets $0.12
Lord_Antoan: folds 
Uncalled bet ($0.12) returned to MostlyGravy
MostlyGravy collected $0.24 from pot
MostlyGravy: doesn't show hand 
Lord_Antoan leaves the table
*** SUMMARY ***
Total pot $0.25 | Rake $0.01 
Board [6s Td Ad]
Seat 1: Rebellion195 folded before Flop (didn't bet)
Seat 2: Impostore1988 (button) folded before Flop (didn't bet)
Seat 3: oksuz77 (small blind) folded before Flop
Seat 4: Lord_Antoan (big blind) folded on the Flop
Seat 5: MostlyGravy collected ($0.24)



PokerStars Hand #222947689239:  Hold'em No Limit ($0.05/$0.10 USD) - 2021/01/23 3:25:43 ET
Table 'Malzovia III' 6-max Seat #3 is the button
Seat 1: Rebellion195 ($6.78 in chips) 
Seat 2: Impostore1988 ($10.15 in chips) 
Seat 3: oksuz77 ($4.30 in chips) 
Seat 5: MostlyGravy ($18.04 in chips) 
MostlyGravy: posts small blind $0.05
Rebellion195: posts big blind $0.10
*** HOLE CARDS ***
Lord_Antoan joins the table at seat #6 
Impostore1988: raises $0.10 to $0.20
oksuz77: folds 
MostlyGravy: folds 
Rebellion195: calls $0.10
*** FLOP *** [5d 8d 7h]
Rebellion195: bets $0.21
Impostore1988: folds 
Uncalled bet ($0.21) returned to Rebellion195
Rebellion195 collected $0.43 from pot
Rebellion195: doesn't show hand 
*** SUMMARY ***
Total pot $0.45 | Rake $0.02 
Board [5d 8d 7h]
Seat 1: Rebellion195 (big blind) collected ($0.43)
Seat 2: Impostore1988 folded on the Flop
Seat 3: oksuz77 (button) folded before Flop (didn't bet)
Seat 5: MostlyGravy (small blind) folded before Flop



PokerStars Hand #222947696861:  Hold'em No Limit ($0.05/$0.10 USD) - 2021/01/23 3:26:14 ET
Table 'Malzovia III' 6-max Seat #5 is the button
Seat 1: Rebellion195 ($7.01 in chips) 
Seat 2: Impostore1988 ($9.95 in chips) 
Seat 3: oksuz77 ($4.30 in chips) 
Seat 5: MostlyGravy ($17.99 in chips) 
Rebellion195: posts small blind $0.05
Impostore1988: posts big blind $0.10
*** HOLE CARDS ***
oksuz77: folds 
MostlyGravy: raises $0.20 to $0.30
Rebellion195: folds 
Impostore1988: folds 
Uncalled bet ($0.20) returned to MostlyGravy
Gera_kega joins the table at seat #4 
MostlyGravy collected $0.25 from pot
MostlyGravy: doesn't show hand 
*** SUMMARY ***
Total pot $0.25 | Rake $0 
Seat 1: Rebellion195 (small blind) folded before Flop
Seat 2: Impostore1988 (big blind) folded before Flop
Seat 3: oksuz77 folded before Flop (didn't bet)
Seat 5: MostlyGravy (button) collected ($0.25)



PokerStars Hand #222947699161:  Hold'em No Limit ($0.05/$0.10 USD) - 2021/01/23 3:26:24 ET
Table 'Malzovia III' 6-max Seat #1 is the button
Seat 1: Rebellion195 ($6.96 in chips) 
Seat 2: Impostore1988 ($9.85 in chips) 
Seat 3: oksuz77 ($4.30 in chips) 
Seat 5: MostlyGravy ($18.14 in chips) 
Seat 6: Lord_Antoan ($17.18 in chips) 
Impostore1988: posts small blind $0.05
oksuz77: posts big blind $0.10
Gera_kega: sits out 
Lord_Antoan: posts big blind $0.10
*** HOLE CARDS ***
MostlyGravy: folds 
Lord_Antoan: raises $0.20 to $0.30
Rebellion195: folds 
Impostore1988: raises $0.50 to $0.80
oksuz77: folds 
Lord_Antoan: folds 
Uncalled bet ($0.50) returned to Impostore1988
Impostore1988 collected $0.70 from pot
Impostore1988: doesn't show hand 
*** SUMMARY ***
Total pot $0.70 | Rake $0 
Seat 1: Rebellion195 (button) folded before Flop (didn't bet)
Seat 2: Impostore1988 (small blind) collected ($0.70)
Seat 3: oksuz77 (big blind) folded before Flop
Seat 5: MostlyGravy folded before Flop (didn't bet)
Seat 6: Lord_Antoan folded before Flop



PokerStars Hand #222947704705:  Hold'em No Limit ($0.05/$0.10 USD) - 2021/01/23 3:26:46 ET
Table 'Malzovia III' 6-max Seat #2 is the button
Seat 1: Rebellion195 ($6.96 in chips) 
Seat 2: Impostore1988 ($10.25 in chips) 
Seat 3: oksuz77 ($4.20 in chips) 
Seat 4: Gera_kega ($4 in chips) 
Seat 5: MostlyGravy ($18.14 in chips) 
Seat 6: Lord_Antoan ($16.88 in chips) 
oksuz77: posts small blind $0.05
Gera_kega: posts big blind $0.10
*** HOLE CARDS ***
MostlyGravy: calls $0.10
Lord_Antoan: raises $0.30 to $0.40
Rebellion195: folds 
Impostore1988: folds 
oksuz77: folds 
Gera_kega: folds 
MostlyGravy: folds 
Uncalled bet ($0.30) returned to Lord_Antoan
Lord_Antoan collected $0.35 from pot
Lord_Antoan: doesn't show hand 
*** SUMMARY ***
Total pot $0.35 | Rake $0 
Seat 1: Rebellion195 folded before Flop (didn't bet)
Seat 2: Impostore1988 (button) folded before Flop (didn't bet)
Seat 3: oksuz77 (small blind) folded before Flop
Seat 4: Gera_kega (big blind) folded before Flop
Seat 5: MostlyGravy folded before Flop
Seat 6: Lord_Antoan collected ($0.35)



PokerStars Hand #222947708461:  Hold'em No Limit ($0.05/$0.10 USD) - 2021/01/23 3:27:02 ET
Table 'Malzovia III' 6-max Seat #3 is the button
Seat 1: Rebellion195 ($6.96 in chips) 
Seat 2: Impostore1988 ($10.25 in chips) 
Seat 3: oksuz77 ($4.15 in chips) 
Seat 4: Gera_kega ($3.90 in chips) 
Seat 5: MostlyGravy ($18.04 in chips) 
Seat 6: Lord_Antoan ($17.13 in chips) 
Gera_kega: posts small blind $0.05
MostlyGravy: posts big blind $0.10
*** HOLE CARDS ***
Lord_Antoan: folds 
Rebellion195: raises $0.20 to $0.30
Impostore1988: folds 
oksuz77: folds 
Gera_kega: folds 
MostlyGravy: folds 
Uncalled bet ($0.20) returned to Rebellion195
Rebellion195 collected $0.25 from pot
Rebellion195: doesn't show hand 
*** SUMMARY ***
Total pot $0.25 | Rake $0 
Seat 1: Rebellion195 collected ($0.25)
Seat 2: Impostore1988 folded before Flop (didn't bet)
Seat 3: oksuz77 (button) folded before Flop (didn't bet)
Seat 4: Gera_kega (small blind) folded before Flop
Seat 5: MostlyGravy (big blind) folded before Flop
Seat 6: Lord_Antoan folded before Flop (didn't bet)



PokerStars Hand #222947711772:  Hold'em No Limit ($0.05/$0.10 USD) - 2021/01/23 3:27:16 ET
Table 'Malzovia III' 6-max Seat #4 is the button
Seat 1: Rebellion195 ($7.11 in chips) 
Seat 2: Impostore1988 ($10.25 in chips) 
Seat 3: oksuz77 ($4.15 in chips) 
Seat 4: Gera_kega ($3.85 in chips) 
Seat 5: MostlyGravy ($17.94 in chips) 
Seat 6: Lord_Antoan ($17.13 in chips) 
MostlyGravy: posts small blind $0.05
Lord_Antoan: posts big blind $0.10
*** HOLE CARDS ***
Rebellion195: folds 
Impostore1988: folds 
oksuz77: folds 
Gera_kega: raises $0.20 to $0.30
MostlyGravy: raises $0.20 to $0.50
Lord_Antoan: folds 
Gera_kega: calls $0.20
*** FLOP *** [9h Td 5c]
MostlyGravy: bets $0.52
Gera_kega: calls $0.52
*** TURN *** [9h Td 5c] [9d]
MostlyGravy: bets $1.02
Gera_kega: calls $1.02
*** RIVER *** [9h Td 5c 9d] [Qh]
MostlyGravy: bets $15.90 and is all-in
Gera_kega: calls $1.81 and is all-in
Uncalled bet ($14.09) returned to MostlyGravy
*** SHOW DOWN ***
MostlyGravy: shows [As Ad] (two pair, Aces and Nines)
Gera_kega: shows [Qc Ks] (two pair, Queens and Nines)
MostlyGravy collected $7.45 from pot
*** SUMMARY ***
Total pot $7.80 | Rake $0.35 
Board [9h Td 5c 9d Qh]
Seat 1: Rebellion195 folded before Flop (didn't bet)
Seat 2: Impostore1988 folded before Flop (didn't bet)
Seat 3: oksuz77 folded before Flop (didn't bet)
Seat 4: Gera_kega (button) showed [Qc Ks] and lost with two pair, Queens and Nines
Seat 5: MostlyGravy (small blind) showed [As Ad] and won ($7.45) with two pair, Aces and Nines
Seat 6: Lord_Antoan (big blind) folded before Flop



PokerStars Hand #222947723130:  Hold'em No Limit ($0.05/$0.10 USD) - 2021/01/23 3:28:03 ET
Table 'Malzovia III' 6-max Seat #5 is the button
Seat 1: Rebellion195 ($7.11 in chips) 
Seat 2: Impostore1988 ($10.25 in chips) 
Seat 3: oksuz77 ($4.15 in chips) 
Seat 5: MostlyGravy ($21.54 in chips) 
Seat 6: Lord_Antoan ($17.03 in chips) 
Lord_Antoan: posts small blind $0.05
Rebellion195: posts big blind $0.10
*** HOLE CARDS ***
Impostore1988: folds 
oksuz77: folds 
MostlyGravy: raises $0.20 to $0.30
Lord_Antoan: folds 
Rebellion195: folds 
Uncalled bet ($0.20) returned to MostlyGravy
MostlyGravy collected $0.25 from pot
*** SUMMARY ***
Total pot $0.25 | Rake $0 
Seat 1: Rebellion195 (big blind) folded before Flop
Seat 2: Impostore1988 folded before Flop (didn't bet)
Seat 3: oksuz77 folded before Flop (didn't bet)
Seat 5: MostlyGravy (button) collected ($0.25)
Seat 6: Lord_Antoan (small blind) folded before Flop



PokerStars Hand #222947729125:  Hold'em No Limit ($0.05/$0.10 USD) - 2021/01/23 3:28:28 ET
Table 'Malzovia III' 6-max Seat #6 is the button
Seat 1: Rebellion195 ($7.01 in chips) 
Seat 2: Impostore1988 ($10.25 in chips) 
Seat 3: oksuz77 ($4.15 in chips) 
Seat 4: Gera_kega ($4 in chips) 
Seat 5: MostlyGravy ($21.69 in chips) 
Seat 6: Lord_Antoan ($16.98 in chips) 
Rebellion195: posts small blind $0.05
Impostore1988: posts big blind $0.10
*** HOLE CARDS ***
oksuz77: folds 
Gera_kega: folds 
MostlyGravy: raises $0.30 to $0.40
Lord_Antoan: calls $0.40
Rebellion195: folds 
Impostore1988: folds 
*** FLOP *** [Jc Td 2c]
MostlyGravy: bets $0.20
Lord_Antoan: raises $0.30 to $0.50
MostlyGravy: folds 
Uncalled bet ($0.30) returned to Lord_Antoan
Lord_Antoan collected $1.29 from pot
Lord_Antoan: doesn't show hand 
*** SUMMARY ***
Total pot $1.35 | Rake $0.06 
Board [Jc Td 2c]
Seat 1: Rebellion195 (small blind) folded before Flop
Seat 2: Impostore1988 (big blind) folded before Flop
Seat 3: oksuz77 folded before Flop (didn't bet)
Seat 4: Gera_kega folded before Flop (didn't bet)
Seat 5: MostlyGravy folded on the Flop
Seat 6: Lord_Antoan (button) collected ($1.29)



PokerStars Hand #222947752004:  Hold'em No Limit ($0.05/$0.10 USD) - 2021/01/23 3:29:33 ET
Table 'Malzovia III' 6-max Seat #1 is the button
Seat 1: Rebellion195 ($6.96 in chips) 
Seat 2: Impostore1988 ($10.15 in chips) 
Seat 3: oksuz77 ($4.15 in chips) 
Seat 4: Gera_kega ($4 in chips) 
Seat 5: MostlyGravy ($21.09 in chips) 
Seat 6: Lord_Antoan ($17.67 in chips) 
Impostore1988: posts small blind $0.05
oksuz77: posts big blind $0.10
*** HOLE CARDS ***
Gera_kega: raises $0.10 to $0.20
MostlyGravy: calls $0.20
Lord_Antoan: folds 
Rebellion195: calls $0.20
Impostore1988: folds 
oksuz77: folds 
*** FLOP *** [Jh 2s 8d]
Gera_kega: checks 
MostlyGravy: checks 
Rebellion195: bets $0.72
Gera_kega: folds 
MostlyGravy: folds 
Uncalled bet ($0.72) returned to Rebellion195
Rebellion195 collected $0.72 from pot
Rebellion195: doesn't show hand 
*** SUMMARY ***
Total pot $0.75 | Rake $0.03 
Board [Jh 2s 8d]
Seat 1: Rebellion195 (button) collected ($0.72)
Seat 2: Impostore1988 (small blind) folded before Flop
Seat 3: oksuz77 (big blind) folded before Flop
Seat 4: Gera_kega folded on the Flop
Seat 5: MostlyGravy folded on the Flop
Seat 6: Lord_Antoan folded before Flop (didn't bet)



PokerStars Hand #222947760509:  Hold'em No Limit ($0.05/$0.10 USD) - 2021/01/23 3:30:09 ET
Table 'Malzovia III' 6-max Seat #2 is the button
Seat 1: Rebellion195 ($7.48 in chips) 
Seat 2: Impostore1988 ($10.10 in chips) 
Seat 3: oksuz77 ($4.05 in chips) 
Seat 4: Gera_kega ($3.80 in chips) 
Seat 5: MostlyGravy ($20.89 in chips) 
Seat 6: Lord_Antoan ($17.67 in chips) 
oksuz77: posts small blind $0.05
Gera_kega: posts big blind $0.10
*** HOLE CARDS ***
MostlyGravy: calls $0.10
Lord_Antoan: folds 
Rebellion195: folds 
Impostore1988: folds 
oksuz77: folds 
Gera_kega: checks 
*** FLOP *** [5d Js 5s]
Gera_kega: checks 
MostlyGravy: bets $0.32
Gera_kega: folds 
Uncalled bet ($0.32) returned to MostlyGravy
MostlyGravy collected $0.24 from pot
MostlyGravy: doesn't show hand 
*** SUMMARY ***
Total pot $0.25 | Rake $0.01 
Board [5d Js 5s]
Seat 1: Rebellion195 folded before Flop (didn't bet)
Seat 2: Impostore1988 (button) folded before Flop (didn't bet)
Seat 3: oksuz77 (small blind) folded before Flop
Seat 4: Gera_kega (big blind) folded on the Flop
Seat 5: MostlyGravy collected ($0.24)
Seat 6: Lord_Antoan folded before Flop (didn't bet)



PokerStars Hand #222947766348:  Hold'em No Limit ($0.05/$0.10 USD) - 2021/01/23 3:30:32 ET
Table 'Malzovia III' 6-max Seat #3 is the button
Seat 1: Rebellion195 ($7.48 in chips) 
Seat 2: Impostore1988 ($10.10 in chips) 
Seat 3: oksuz77 ($4 in chips) 
Seat 4: Gera_kega ($3.70 in chips) 
Seat 5: MostlyGravy ($21.03 in chips) 
Seat 6: Lord_Antoan ($17.67 in chips) 
Gera_kega: posts small blind $0.05
MostlyGravy: posts big blind $0.10
*** HOLE CARDS ***
Lord_Antoan: folds 
Rebellion195: raises $0.20 to $0.30
Impostore1988: calls $0.30
oksuz77: folds 
Gera_kega: folds 
MostlyGravy: calls $0.20
*** FLOP *** [4d 7c Qc]
MostlyGravy: bets $0.75
Rebellion195: raises $0.75 to $1.50
Impostore1988: calls $1.50
MostlyGravy: folds 
*** TURN *** [4d 7c Qc] [5d]
Rebellion195: checks 
Impostore1988: checks 
*** RIVER *** [4d 7c Qc 5d] [4s]
Rebellion195: bets $4.49
Impostore1988: folds 
Uncalled bet ($4.49) returned to Rebellion195
Rebellion195 collected $4.49 from pot
Rebellion195: doesn't show hand 
*** SUMMARY ***
Total pot $4.70 | Rake $0.21 
Board [4d 7c Qc 5d 4s]
Seat 1: Rebellion195 collected ($4.49)
Seat 2: Impostore1988 folded on the River
Seat 3: oksuz77 (button) folded before Flop (didn't bet)
Seat 4: Gera_kega (small blind) folded before Flop
Seat 5: MostlyGravy (big blind) folded on the Flop
Seat 6: Lord_Antoan folded before Flop (didn't bet)



PokerStars Hand #222947783635:  Hold'em No Limit ($0.05/$0.10 USD) - 2021/01/23 3:31:43 ET
Table 'Malzovia III' 6-max Seat #4 is the button
Seat 1: Rebellion195 ($10.17 in chips) 
Seat 2: Impostore1988 ($8.30 in chips) 
Seat 3: oksuz77 ($4 in chips) 
Seat 4: Gera_kega ($3.65 in chips) 
Seat 5: MostlyGravy ($19.98 in chips) 
Seat 6: Lord_Antoan ($17.67 in chips) 
MostlyGravy: posts small blind $0.05
Lord_Antoan: posts big blind $0.10
*** HOLE CARDS ***
Rebellion195: folds 
Impostore1988: folds 
oksuz77: folds 
Gera_kega: calls $0.10
MostlyGravy: calls $0.05
Lord_Antoan: checks 
*** FLOP *** [2c Jc Ts]
MostlyGravy: checks 
Lord_Antoan: checks 
Gera_kega: checks 
*** TURN *** [2c Jc Ts] [9d]
MostlyGravy: checks 
Lord_Antoan: checks 
Gera_kega: checks 
*** RIVER *** [2c Jc Ts 9d] [Jd]
MostlyGravy: bets $0.34
Lord_Antoan: folds 
Gera_kega: folds 
Uncalled bet ($0.34) returned to MostlyGravy
MostlyGravy collected $0.29 from pot
MostlyGravy: doesn't show hand 
*** SUMMARY ***
Total pot $0.30 | Rake $0.01 
Board [2c Jc Ts 9d Jd]
Seat 1: Rebellion195 folded before Flop (didn't bet)
Seat 2: Impostore1988 folded before Flop (didn't bet)
Seat 3: oksuz77 folded before Flop (didn't bet)
Seat 4: Gera_kega (button) folded on the River
Seat 5: MostlyGravy (small blind) collected ($0.29)
Seat 6: Lord_Antoan (big blind) folded on the River



PokerStars Hand #222947803187:  Hold'em No Limit ($0.05/$0.10 USD) - 2021/01/23 3:32:37 ET
Table 'Malzovia III' 6-max Seat #5 is the button
Seat 1: Rebellion195 ($10.17 in chips) 
Seat 2: Impostore1988 ($10 in chips) 
Seat 3: oksuz77 ($4 in chips) 
Seat 4: Gera_kega ($3.55 in chips) 
Seat 5: MostlyGravy ($20.17 in chips) 
Seat 6: Lord_Antoan ($17.57 in chips) 
Lord_Antoan: posts small blind $0.05
Rebellion195: posts big blind $0.10
*** HOLE CARDS ***
Impostore1988: raises $0.10 to $0.20
oksuz77: folds 
Gera_kega: calls $0.20
MostlyGravy: calls $0.20
Lord_Antoan: folds 
Rebellion195: folds 
*** FLOP *** [Ad Jd 9s]
Impostore1988: checks 
Gera_kega: bets $0.20
MostlyGravy: folds 
Impostore1988: folds 
Uncalled bet ($0.20) returned to Gera_kega
Gera_kega collected $0.72 from pot
Gera_kega: doesn't show hand 
*** SUMMARY ***
Total pot $0.75 | Rake $0.03 
Board [Ad Jd 9s]
Seat 1: Rebellion195 (big blind) folded before Flop
Seat 2: Impostore1988 folded on the Flop
Seat 3: oksuz77 folded before Flop (didn't bet)
Seat 4: Gera_kega collected ($0.72)
Seat 5: MostlyGravy (button) folded on the Flop
Seat 6: Lord_Antoan (small blind) folded before Flop



PokerStars Hand #222947810808:  Hold'em No Limit ($0.05/$0.10 USD) - 2021/01/23 3:33:09 ET
Table 'Malzovia III' 6-max Seat #6 is the button
Seat 1: Rebellion195 ($10.07 in chips) 
Seat 2: Impostore1988 ($9.80 in chips) 
Seat 3: oksuz77 ($4 in chips) 
Seat 4: Gera_kega ($4.07 in chips) 
Seat 5: MostlyGravy ($19.97 in chips) 
Seat 6: Lord_Antoan ($17.52 in chips) 
Rebellion195: posts small blind $0.05
Impostore1988: posts big blind $0.10
*** HOLE CARDS ***
oksuz77: folds 
Gera_kega: folds 
MostlyGravy: folds 
Lord_Antoan: folds 
Rebellion195: folds 
Uncalled bet ($0.05) returned to Impostore1988
Impostore1988 collected $0.10 from pot
Impostore1988: doesn't show hand 
*** SUMMARY ***
Total pot $0.10 | Rake $0 
Seat 1: Rebellion195 (small blind) folded before Flop
Seat 2: Impostore1988 (big blind) collected ($0.10)
Seat 3: oksuz77 folded before Flop (didn't bet)
Seat 4: Gera_kega folded before Flop (didn't bet)
Seat 5: MostlyGravy folded before Flop (didn't bet)
Seat 6: Lord_Antoan (button) folded before Flop (didn't bet)



PokerStars Hand #222947812698:  Hold'em No Limit ($0.05/$0.10 USD) - 2021/01/23 3:33:17 ET
Table 'Malzovia III' 6-max Seat #1 is the button
Seat 1: Rebellion195 ($10.02 in chips) 
Seat 2: Impostore1988 ($9.85 in chips) 
Seat 3: oksuz77 ($4 in chips) 
Seat 4: Gera_kega ($4.07 in chips) 
Seat 5: MostlyGravy ($19.97 in chips) 
Seat 6: Lord_Antoan ($17.52 in chips) 
Impostore1988: posts small blind $0.05
oksuz77: posts big blind $0.10
*** HOLE CARDS ***
Gera_kega: raises $0.10 to $0.20
MostlyGravy: calls $0.20
Lord_Antoan: folds 
Rebellion195: calls $0.20
Impostore1988: folds 
oksuz77: calls $0.10
*** FLOP *** [Kh Ks Kc]
oksuz77: checks 
Gera_kega: checks 
MostlyGravy: checks 
Rebellion195: bets $0.60
oksuz77: folds 
Gera_kega: calls $0.60
MostlyGravy: folds 
*** TURN *** [Kh Ks Kc] [6h]
Gera_kega: checks 
Rebellion195: checks 
*** RIVER *** [Kh Ks Kc 6h] [Qd]
Gera_kega: bets $1.96
Rebellion195: calls $1.96
*** SHOW DOWN ***
Gera_kega: shows [Kd 8d] (four of a kind, Kings)
Rebellion195: mucks hand 
Gera_kega collected $5.70 from pot
*** SUMMARY ***
Total pot $5.97 | Rake $0.27 
Board [Kh Ks Kc 6h Qd]
Seat 1: Rebellion195 (button) mucked
Seat 2: Impostore1988 (small blind) folded before Flop
Seat 3: oksuz77 (big blind) folded on the Flop
Seat 4: Gera_kega showed [Kd 8d] and won ($5.70) with four of a kind, Kings
Seat 5: MostlyGravy folded on the Flop
Seat 6: Lord_Antoan folded before Flop (didn't bet)



PokerStars Hand #222947832513:  Hold'em No Limit ($0.05/$0.10 USD) - 2021/01/23 3:34:38 ET
Table 'Malzovia III' 6-max Seat #2 is the button
Seat 1: Rebellion195 ($7.26 in chips) 
Seat 2: Impostore1988 ($9.80 in chips) 
Seat 3: oksuz77 ($3.80 in chips) 
Seat 4: Gera_kega ($7.01 in chips) 
Seat 5: MostlyGravy ($19.77 in chips) 
Seat 6: Lord_Antoan ($17.52 in chips) 
oksuz77: posts small blind $0.05
Gera_kega: posts big blind $0.10
*** HOLE CARDS ***
MostlyGravy: calls $0.10
Lord_Antoan: folds 
Rebellion195: calls $0.10
Impostore1988: folds 
oksuz77: folds 
Gera_kega: checks 
*** FLOP *** [6d Qc Ah]
Gera_kega: checks 
MostlyGravy: checks 
Rebellion195: checks 
*** TURN *** [6d Qc Ah] [2d]
Gera_kega: checks 
MostlyGravy: bets $0.33
Rebellion195: calls $0.33
Gera_kega: folds 
*** RIVER *** [6d Qc Ah 2d] [Ks]
MostlyGravy: checks 
Rebellion195: bets $0.48
MostlyGravy: folds 
Uncalled bet ($0.48) returned to Rebellion195
Rebellion195 collected $0.96 from pot
Rebellion195: doesn't show hand 
*** SUMMARY ***
Total pot $1.01 | Rake $0.05 
Board [6d Qc Ah 2d Ks]
Seat 1: Rebellion195 collected ($0.96)
Seat 2: Impostore1988 (button) folded before Flop (didn't bet)
Seat 3: oksuz77 (small blind) folded before Flop
Seat 4: Gera_kega (big blind) folded on the Turn
Seat 5: MostlyGravy folded on the River
Seat 6: Lord_Antoan folded before Flop (didn't bet)



PokerStars Hand #222947849522:  Hold'em No Limit ($0.05/$0.10 USD) - 2021/01/23 3:35:48 ET
Table 'Malzovia III' 6-max Seat #3 is the button
Seat 1: Rebellion195 ($7.79 in chips) 
Seat 2: Impostore1988 ($9.80 in chips) 
Seat 3: oksuz77 ($3.75 in chips) 
Seat 4: Gera_kega ($6.91 in chips) 
Seat 5: MostlyGravy ($19.34 in chips) 
Seat 6: Lord_Antoan ($17.52 in chips) 
Gera_kega: posts small blind $0.05
MostlyGravy: posts big blind $0.10
*** HOLE CARDS ***
Lord_Antoan: raises $0.20 to $0.30
Rebellion195: folds 
Impostore1988: folds 
oksuz77: folds 
Gera_kega: folds 
MostlyGravy: calls $0.20
*** FLOP *** [2s Ah 8c]
MostlyGravy: bets $0.31
Lord_Antoan: calls $0.31
*** TURN *** [2s Ah 8c] [9h]
MostlyGravy: bets $0.10
Lord_Antoan: raises $0.50 to $0.60
MostlyGravy: raises $0.60 to $1.20
Lord_Antoan: calls $0.60
*** RIVER *** [2s Ah 8c 9h] [Qh]
MostlyGravy: bets $3.50
Lord_Antoan: calls $3.50
*** SHOW DOWN ***
MostlyGravy: shows [Tc 8d] (a pair of Eights)
Lord_Antoan: shows [Ac Kh] (a pair of Aces)
Lord_Antoan collected $10.19 from pot
*** SUMMARY ***
Total pot $10.67 | Rake $0.48 
Board [2s Ah 8c 9h Qh]
Seat 1: Rebellion195 folded before Flop (didn't bet)
Seat 2: Impostore1988 folded before Flop (didn't bet)
Seat 3: oksuz77 (button) folded before Flop (didn't bet)
Seat 4: Gera_kega (small blind) folded before Flop
Seat 5: MostlyGravy (big blind) showed [Tc 8d] and lost with a pair of Eights
Seat 6: Lord_Antoan showed [Ac Kh] and won ($10.19) with a pair of Aces



PokerStars Hand #222947877741:  Hold'em No Limit ($0.05/$0.10 USD) - 2021/01/23 3:37:43 ET
Table 'Malzovia III' 6-max Seat #4 is the button
Seat 1: Rebellion195 ($7.79 in chips) 
Seat 2: Impostore1988 ($9.80 in chips) 
Seat 3: oksuz77 ($3.75 in chips) 
Seat 4: Gera_kega ($6.86 in chips) 
Seat 5: MostlyGravy ($14.03 in chips) 
Seat 6: Lord_Antoan ($22.40 in chips) 
MostlyGravy: posts small blind $0.05
Lord_Antoan: posts big blind $0.10
*** HOLE CARDS ***
Rebellion195: raises $0.20 to $0.30
Impostore1988: folds 
oksuz77: folds 
Gera_kega: calls $0.30
MostlyGravy: folds 
Lord_Antoan: folds 
*** FLOP *** [5c 7h As]
Rebellion195: bets $0.36
Gera_kega: calls $0.36
*** TURN *** [5c 7h As] [Td]
Rebellion195: checks 
Gera_kega: checks 
*** RIVER *** [5c 7h As Td] [Qd]
Rebellion195: checks 
Gera_kega: bets $0.30
Rebellion195: calls $0.30
*** SHOW DOWN ***
Gera_kega: shows [Ac 4c] (a pair of Aces)
Rebellion195: mucks hand 
Gera_kega collected $1.98 from pot
*** SUMMARY ***
Total pot $2.07 | Rake $0.09 
Board [5c 7h As Td Qd]
Seat 1: Rebellion195 mucked
Seat 2: Impostore1988 folded before Flop (didn't bet)
Seat 3: oksuz77 folded before Flop (didn't bet)
Seat 4: Gera_kega (button) showed [Ac 4c] and won ($1.98) with a pair of Aces
Seat 5: MostlyGravy (small blind) folded before Flop
Seat 6: Lord_Antoan (big blind) folded before Flop



PokerStars Hand #222947893033:  Hold'em No Limit ($0.05/$0.10 USD) - 2021/01/23 3:38:47 ET
Table 'Malzovia III' 6-max Seat #5 is the button
Seat 1: Rebellion195 ($6.83 in chips) 
Seat 2: Impostore1988 ($9.80 in chips) 
Seat 3: oksuz77 ($3.75 in chips) 
Seat 4: Gera_kega ($7.88 in chips) 
Seat 5: MostlyGravy ($13.98 in chips) 
Seat 6: Lord_Antoan ($22.30 in chips) 
Lord_Antoan: posts small blind $0.05
Rebellion195: posts big blind $0.10
*** HOLE CARDS ***
Impostore1988: raises $0.10 to $0.20
oksuz77: folds 
Gera_kega: folds 
MostlyGravy: calls $0.20
Lord_Antoan: raises $0.90 to $1.10
Rebellion195: calls $1
Impostore1988: calls $0.90
MostlyGravy: folds 
*** FLOP *** [Ts Ad 4c]
Lord_Antoan: checks 
Rebellion195: bets $1.67
Impostore1988: folds 
Lord_Antoan: folds 
Uncalled bet ($1.67) returned to Rebellion195
Rebellion195 collected $3.34 from pot
Rebellion195: doesn't show hand 
*** SUMMARY ***
Total pot $3.50 | Rake $0.16 
Board [Ts Ad 4c]
Seat 1: Rebellion195 (big blind) collected ($3.34)
Seat 2: Impostore1988 folded on the Flop
Seat 3: oksuz77 folded before Flop (didn't bet)
Seat 4: Gera_kega folded before Flop (didn't bet)
Seat 5: MostlyGravy (button) folded before Flop
Seat 6: Lord_Antoan (small blind) folded on the Flop



PokerStars Hand #222947909593:  Hold'em No Limit ($0.05/$0.10 USD) - 2021/01/23 3:39:55 ET
Table 'Malzovia III' 6-max Seat #6 is the button
Seat 1: Rebellion195 ($9.07 in chips) 
Seat 2: Impostore1988 ($10 in chips) 
Seat 3: oksuz77 ($3.75 in chips) 
Seat 4: Gera_kega ($7.88 in chips) 
Seat 5: MostlyGravy ($13.78 in chips) 
Seat 6: Lord_Antoan ($21.20 in chips) 
Rebellion195: posts small blind $0.05
Impostore1988: posts big blind $0.10
*** HOLE CARDS ***
oksuz77: folds 
Gera_kega: folds 
MostlyGravy: raises $0.20 to $0.30
Lord_Antoan: folds 
Rebellion195: calls $0.25
Impostore1988: folds 
*** FLOP *** [Qh 6h Jh]
Rebellion195: checks 
MostlyGravy: bets $0.67
Rebellion195: calls $0.67
*** TURN *** [Qh 6h Jh] [5h]
Rebellion195: checks 
MostlyGravy: bets $1.07
Rebellion195: raises $7.03 to $8.10 and is all-in
MostlyGravy: folds 
Uncalled bet ($7.03) returned to Rebellion195
Rebellion195 collected $3.99 from pot
Rebellion195: doesn't show hand 
*** SUMMARY ***
Total pot $4.18 | Rake $0.19 
Board [Qh 6h Jh 5h]
Seat 1: Rebellion195 (small blind) collected ($3.99)
Seat 2: Impostore1988 (big blind) folded before Flop
Seat 3: oksuz77 folded before Flop (didn't bet)
Seat 4: Gera_kega folded before Flop (didn't bet)
Seat 5: MostlyGravy folded on the Turn
Seat 6: Lord_Antoan (button) folded before Flop (didn't bet)



PokerStars Hand #222947936081:  Hold'em No Limit ($0.05/$0.10 USD) - 2021/01/23 3:41:44 ET
Table 'Malzovia III' 6-max Seat #1 is the button
Seat 1: Rebellion195 ($11.02 in chips) 
Seat 2: Impostore1988 ($9.90 in chips) 
Seat 3: oksuz77 ($3.75 in chips) 
Seat 4: Gera_kega ($7.88 in chips) 
Seat 5: MostlyGravy ($11.74 in chips) 
Seat 6: Lord_Antoan ($21.20 in chips) 
Impostore1988: posts small blind $0.05
oksuz77: posts big blind $0.10
*** HOLE CARDS ***
Gera_kega: folds 
MostlyGravy: folds 
Lord_Antoan: raises $0.20 to $0.30
Rebellion195: calls $0.30
Impostore1988: folds 
oksuz77: folds 
*** FLOP *** [As 6d 2c]
Lord_Antoan: bets $0.25
Rebellion195: folds 
Uncalled bet ($0.25) returned to Lord_Antoan
Lord_Antoan collected $0.72 from pot
Lord_Antoan: doesn't show hand 
*** SUMMARY ***
Total pot $0.75 | Rake $0.03 
Board [As 6d 2c]
Seat 1: Rebellion195 (button) folded on the Flop
Seat 2: Impostore1988 (small blind) folded before Flop
Seat 3: oksuz77 (big blind) folded before Flop
Seat 4: Gera_kega folded before Flop (didn't bet)
Seat 5: MostlyGravy folded before Flop (didn't bet)
Seat 6: Lord_Antoan collected ($0.72)



PokerStars Hand #222947943790:  Hold'em No Limit ($0.05/$0.10 USD) - 2021/01/23 3:42:16 ET
Table 'Malzovia III' 6-max Seat #2 is the button
Seat 1: Rebellion195 ($10.72 in chips) 
Seat 2: Impostore1988 ($9.85 in chips) 
Seat 3: oksuz77 ($3.65 in chips) 
Seat 4: Gera_kega ($7.88 in chips) 
Seat 5: MostlyGravy ($11.74 in chips) 
Seat 6: Lord_Antoan ($21.62 in chips) 
oksuz77: posts small blind $0.05
Gera_kega: posts big blind $0.10
*** HOLE CARDS ***
MostlyGravy: folds 
Lord_Antoan: folds 
Rebellion195: folds 
Impostore1988: folds 
oksuz77: folds 
Uncalled bet ($0.05) returned to Gera_kega
Gera_kega collected $0.10 from pot
Gera_kega: doesn't show hand 
*** SUMMARY ***
Total pot $0.10 | Rake $0 
Seat 1: Rebellion195 folded before Flop (didn't bet)
Seat 2: Impostore1988 (button) folded before Flop (didn't bet)
Seat 3: oksuz77 (small blind) folded before Flop
Seat 4: Gera_kega (big blind) collected ($0.10)
Seat 5: MostlyGravy folded before Flop (didn't bet)
Seat 6: Lord_Antoan folded before Flop (didn't bet)



PokerStars Hand #222947945694:  Hold'em No Limit ($0.05/$0.10 USD) - 2021/01/23 3:42:24 ET
Table 'Malzovia III' 6-max Seat #3 is the button
Seat 1: Rebellion195 ($10.72 in chips) 
Seat 2: Impostore1988 ($9.85 in chips) 
Seat 3: oksuz77 ($3.60 in chips) 
Seat 4: Gera_kega ($7.93 in chips) 
Seat 5: MostlyGravy ($11.74 in chips) 
Seat 6: Lord_Antoan ($21.62 in chips) 
Gera_kega: posts small blind $0.05
MostlyGravy: posts big blind $0.10
*** HOLE CARDS ***
Lord_Antoan: folds 
Rebellion195: folds 
Impostore1988: folds 
oksuz77: calls $0.10
Gera_kega: calls $0.05
MostlyGravy: checks 
*** FLOP *** [8h Kd Qs]
Gera_kega: checks 
MostlyGravy: checks 
oksuz77: bets $0.10
Gera_kega: calls $0.10
MostlyGravy: folds 
*** TURN *** [8h Kd Qs] [7h]
Gera_kega: checks 
oksuz77: bets $0.20
Gera_kega: calls $0.20
*** RIVER *** [8h Kd Qs 7h] [3s]
Gera_kega: bets $0.43
oksuz77: folds 
Uncalled bet ($0.43) returned to Gera_kega
Gera_kega collected $0.86 from pot
Gera_kega: doesn't show hand 
*** SUMMARY ***
Total pot $0.90 | Rake $0.04 
Board [8h Kd Qs 7h 3s]
Seat 1: Rebellion195 folded before Flop (didn't bet)
Seat 2: Impostore1988 folded before Flop (didn't bet)
Seat 3: oksuz77 (button) folded on the River
Seat 4: Gera_kega (small blind) collected ($0.86)
Seat 5: MostlyGravy (big blind) folded on the Flop
Seat 6: Lord_Antoan folded before Flop (didn't bet)



PokerStars Hand #222947955541:  Hold'em No Limit ($0.05/$0.10 USD) - 2021/01/23 3:43:04 ET
Table 'Malzovia III' 6-max Seat #4 is the button
Seat 1: Rebellion195 ($10.72 in chips) 
Seat 2: Impostore1988 ($9.85 in chips) 
Seat 3: oksuz77 ($3.20 in chips) 
Seat 4: Gera_kega ($8.39 in chips) 
Seat 5: MostlyGravy ($11.64 in chips) 
Seat 6: Lord_Antoan ($21.62 in chips) 
MostlyGravy: posts small blind $0.05
Lord_Antoan: posts big blind $0.10
*** HOLE CARDS ***
Rebellion195: folds 
Impostore1988: raises $0.20 to $0.30
oksuz77: folds 
Gera_kega: folds 
MostlyGravy: raises $0.70 to $1
Lord_Antoan: calls $0.90
Impostore1988: calls $0.70
*** FLOP *** [As 2c 8h]
Gera_kega leaves the table
llosjone joins the table at seat #4 
MostlyGravy: bets $1.93
Lord_Antoan: folds 
Impostore1988: calls $1.93
*** TURN *** [As 2c 8h] [Jc]
MostlyGravy has timed out
MostlyGravy: checks 
Impostore1988: bets $0.10
MostlyGravy: calls $0.10
*** RIVER *** [As 2c 8h Jc] [8d]
MostlyGravy: checks 
Impostore1988: bets $2.40
MostlyGravy: folds 
Uncalled bet ($2.40) returned to Impostore1988
Impostore1988 collected $6.74 from pot
Impostore1988: doesn't show hand 
*** SUMMARY ***
Total pot $7.06 | Rake $0.32 
Board [As 2c 8h Jc 8d]
Seat 1: Rebellion195 folded before Flop (didn't bet)
Seat 2: Impostore1988 collected ($6.74)
Seat 3: oksuz77 folded before Flop (didn't bet)
Seat 4: Gera_kega (button) folded before Flop (didn't bet)
Seat 5: MostlyGravy (small blind) folded on the River
Seat 6: Lord_Antoan (big blind) folded on the Flop



PokerStars Hand #222947985641:  Hold'em No Limit ($0.05/$0.10 USD) - 2021/01/23 3:45:06 ET
Table 'Malzovia III' 6-max Seat #5 is the button
Seat 1: Rebellion195 ($10.72 in chips) 
Seat 2: Impostore1988 ($13.56 in chips) 
Seat 3: oksuz77 ($3.20 in chips) 
Seat 5: MostlyGravy ($8.61 in chips) 
Seat 6: Lord_Antoan ($20.62 in chips) 
Lord_Antoan: posts small blind $0.05
Rebellion195: posts big blind $0.10
llosjone: sits out 
*** HOLE CARDS ***
Impostore1988: folds 
oksuz77: folds 
MostlyGravy: raises $0.10 to $0.20
Lord_Antoan: raises $0.85 to $1.05
Rebellion195: folds 
MostlyGravy: calls $0.85
*** FLOP *** [3d 5c 5s]
Lord_Antoan: checks 
MostlyGravy: bets $2.50
Lord_Antoan: folds 
Uncalled bet ($2.50) returned to MostlyGravy
MostlyGravy collected $2.10 from pot
MostlyGravy: doesn't show hand 
*** SUMMARY ***
Total pot $2.20 | Rake $0.10 
Board [3d 5c 5s]
Seat 1: Rebellion195 (big blind) folded before Flop
Seat 2: Impostore1988 folded before Flop (didn't bet)
Seat 3: oksuz77 folded before Flop (didn't bet)
Seat 5: MostlyGravy (button) collected ($2.10)
Seat 6: Lord_Antoan (small blind) folded on the Flop



PokerStars Hand #222947996488:  Hold'em No Limit ($0.05/$0.10 USD) - 2021/01/23 3:45:50 ET
Table 'Malzovia III' 6-max Seat #6 is the button
Seat 1: Rebellion195 ($10.62 in chips) 
Seat 3: oksuz77 ($3.20 in chips) 
Seat 5: MostlyGravy ($9.66 in chips) 
Seat 6: Lord_Antoan ($19.57 in chips) 
Rebellion195: posts small blind $0.05
Impostore1988: is sitting out 
oksuz77: posts big blind $0.10
llosjone: sits out 
*** HOLE CARDS ***
MostlyGravy: calls $0.10
Lord_Antoan: raises $0.40 to $0.50
Rebellion195: folds 
oksuz77: folds 
MostlyGravy: calls $0.40
*** FLOP *** [7s Qd 3d]
MostlyGravy: checks 
Lord_Antoan: bets $0.61
MostlyGravy: folds 
Uncalled bet ($0.61) returned to Lord_Antoan
Lord_Antoan collected $1.10 from pot
Lord_Antoan: doesn't show hand 
*** SUMMARY ***
Total pot $1.15 | Rake $0.05 
Board [7s Qd 3d]
Seat 1: Rebellion195 (small blind) folded before Flop
Seat 3: oksuz77 (big blind) folded before Flop
Seat 5: MostlyGravy folded on the Flop
Seat 6: Lord_Antoan (button) collected ($1.10)



PokerStars Hand #222948010543:  Hold'em No Limit ($0.05/$0.10 USD) - 2021/01/23 3:46:47 ET
Table 'Malzovia III' 6-max Seat #1 is the button
Seat 1: Rebellion195 ($10.57 in chips) 
Seat 3: oksuz77 ($3.10 in chips) 
Seat 4: llosjone ($10 in chips) 
Seat 5: MostlyGravy ($9.16 in chips) 
Seat 6: Lord_Antoan ($20.17 in chips) 
oksuz77: posts small blind $0.05
llosjone: posts big blind $0.10
*** HOLE CARDS ***
MostlyGravy: folds 
Lord_Antoan: folds 
Rebellion195: calls $0.10
oksuz77: folds 
llosjone: checks 
*** FLOP *** [8c Ad 5d]
llosjone: checks 
Rebellion195: checks 
*** TURN *** [8c Ad 5d] [Qd]
llosjone: checks 
Rebellion195: bets $0.12
llosjone: folds 
Uncalled bet ($0.12) returned to Rebellion195
Rebellion195 collected $0.24 from pot
Rebellion195: doesn't show hand 
*** SUMMARY ***
Total pot $0.25 | Rake $0.01 
Board [8c Ad 5d Qd]
Seat 1: Rebellion195 (button) collected ($0.24)
Seat 3: oksuz77 (small blind) folded before Flop
Seat 4: llosjone (big blind) folded on the Turn
Seat 5: MostlyGravy folded before Flop (didn't bet)
Seat 6: Lord_Antoan folded before Flop (didn't bet)



PokerStars Hand #222948928709:  Hold'em No Limit ($0.05/$0.10 USD) - 2021/01/23 4:46:12 ET
Table 'Malzovia III' 6-max Seat #6 is the button
Seat 1: schnu111 ($10 in chips) 
Seat 4: llosjone ($11.87 in chips) 
Seat 5: MostlyGravy ($25.26 in chips) 
Seat 6: negritos81 ($12.27 in chips) 
schnu111: posts small blind $0.05
llosjone: posts big blind $0.10
*** HOLE CARDS ***
MostlyGravy: calls $0.10
negritos81: folds 
schnu111: calls $0.05
llosjone: checks 
*** FLOP *** [5s 2d Ks]
romanromanro joins the table at seat #2 
schnu111: checks 
llosjone: checks 
Eneichik joins the table at seat #3 
MostlyGravy: bets $0.24
schnu111: folds 
llosjone: calls $0.24
*** TURN *** [5s 2d Ks] [Ac]
llosjone: checks 
MostlyGravy has timed out
MostlyGravy: checks 
*** RIVER *** [5s 2d Ks Ac] [4c]
llosjone: checks 
MostlyGravy: bets $0.74
llosjone: calls $0.74
*** SHOW DOWN ***
MostlyGravy: shows [5d 3d] (a straight, Ace to Five)
llosjone: mucks hand 
MostlyGravy collected $2.16 from pot
*** SUMMARY ***
Total pot $2.26 | Rake $0.10 
Board [5s 2d Ks Ac 4c]
Seat 1: schnu111 (small blind) folded on the Flop
Seat 4: llosjone (big blind) mucked
Seat 5: MostlyGravy showed [5d 3d] and won ($2.16) with a straight, Ace to Five
Seat 6: negritos81 (button) folded before Flop (didn't bet)



PokerStars Hand #222948955014:  Hold'em No Limit ($0.05/$0.10 USD) - 2021/01/23 4:47:44 ET
Table 'Malzovia III' 6-max Seat #1 is the button
Seat 1: schnu111 ($10 in chips) 
Seat 4: llosjone ($10.79 in chips) 
Seat 5: MostlyGravy ($26.34 in chips) 
Seat 6: negritos81 ($12.27 in chips) 
llosjone: posts small blind $0.05
MostlyGravy: posts big blind $0.10
*** HOLE CARDS ***
negritos81 has timed out
negritos81: folds 
schnu111: folds 
llosjone: folds 
Uncalled bet ($0.05) returned to MostlyGravy
MostlyGravy collected $0.10 from pot
MostlyGravy: doesn't show hand 
*** SUMMARY ***
Total pot $0.10 | Rake $0 
Seat 1: schnu111 (button) folded before Flop (didn't bet)
Seat 4: llosjone (small blind) folded before Flop
Seat 5: MostlyGravy (big blind) collected ($0.10)
Seat 6: negritos81 folded before Flop (didn't bet)



PokerStars Hand #222948073215:  Hold'em No Limit ($0.05/$0.10 USD) - 2021/01/23 3:51:00 ET
Table 'Malzovia III' 6-max Seat #4 is the button
Seat 1: Rebellion195 ($23.08 in chips) 
Seat 3: bracs111 ($5.46 in chips) 
Seat 4: llosjone ($9.45 in chips) 
Seat 5: MostlyGravy ($13.51 in chips) 
MostlyGravy: posts small blind $0.05
Lord_Antoan: is sitting out 
Rebellion195: posts big blind $0.10
Impostore1988: sits out 
bracs111: posts big blind $0.10
*** HOLE CARDS ***
bracs111: checks 
llosjone: folds 
Lord_Antoan leaves the table
MostlyGravy: calls $0.05
Rebellion195: checks 
*** FLOP *** [4d 7s 8c]
Gissbon joins the table at seat #6 
MostlyGravy: bets $0.10
Rebellion195: calls $0.10
bracs111: calls $0.10
*** TURN *** [4d 7s 8c] [Qd]
MostlyGravy: checks 
Rebellion195: bets $0.57
bracs111: calls $0.57
MostlyGravy: folds 
*** RIVER *** [4d 7s 8c Qd] [5s]
Rebellion195: checks 
bracs111: bets $0.83
Rebellion195: folds 
Uncalled bet ($0.83) returned to bracs111
bracs111 collected $1.66 from pot
bracs111: doesn't show hand 
*** SUMMARY ***
Total pot $1.74 | Rake $0.08 
Board [4d 7s 8c Qd 5s]
Seat 1: Rebellion195 (big blind) folded on the River
Seat 3: bracs111 collected ($1.66)
Seat 4: llosjone (button) folded before Flop (didn't bet)
Seat 5: MostlyGravy (small blind) folded on the Turn



PokerStars Hand #222948093702:  Hold'em No Limit ($0.05/$0.10 USD) - 2021/01/23 3:52:23 ET
Table 'Malzovia III' 6-max Seat #5 is the button
Seat 1: Rebellion195 ($22.31 in chips) 
Seat 2: Impostore1988 ($13.56 in chips) 
Seat 3: bracs111 ($6.35 in chips) 
Seat 4: llosjone ($9.45 in chips) 
Seat 5: MostlyGravy ($13.31 in chips) 
Rebellion195: posts small blind $0.05
Impostore1988: posts big blind $0.10
*** HOLE CARDS ***
bracs111: folds 
llosjone: folds 
MostlyGravy: calls $0.10
Rebellion195: calls $0.05
Impostore1988: checks 
*** FLOP *** [7h Qs 8h]
Rebellion195: checks 
Impostore1988: checks 
MostlyGravy: checks 
*** TURN *** [7h Qs 8h] [9d]
Rebellion195: bets $0.14
Impostore1988: folds 
MostlyGravy: folds 
Uncalled bet ($0.14) returned to Rebellion195
Rebellion195 collected $0.29 from pot
Rebellion195: doesn't show hand 
*** SUMMARY ***
Total pot $0.30 | Rake $0.01 
Board [7h Qs 8h 9d]
Seat 1: Rebellion195 (small blind) collected ($0.29)
Seat 2: Impostore1988 (big blind) folded on the Turn
Seat 3: bracs111 folded before Flop (didn't bet)
Seat 4: llosjone folded before Flop (didn't bet)
Seat 5: MostlyGravy (button) folded on the Turn



PokerStars Hand #222948110473:  Hold'em No Limit ($0.05/$0.10 USD) - 2021/01/23 3:53:30 ET
Table 'Malzovia III' 6-max Seat #1 is the button
Seat 1: Rebellion195 ($22.50 in chips) 
Seat 2: Impostore1988 ($13.46 in chips) 
Seat 3: bracs111 ($6.35 in chips) 
Seat 4: llosjone ($9.45 in chips) 
Seat 5: MostlyGravy ($13.21 in chips) 
Impostore1988: posts small blind $0.05
bracs111: posts big blind $0.10
Gissbon: sits out 
*** HOLE CARDS ***
llosjone: folds 
MostlyGravy: folds 
Rebellion195: calls $0.10
Impostore1988: calls $0.05
bracs111: raises $0.20 to $0.30
Rebellion195: calls $0.20
Impostore1988: calls $0.20
*** FLOP *** [8s 5s Jd]
Impostore1988: checks 
bracs111: checks 
Rebellion195: checks 
*** TURN *** [8s 5s Jd] [6c]
Impostore1988: checks 
bracs111: bets $0.43
Rebellion195: calls $0.43
Impostore1988: folds 
*** RIVER *** [8s 5s Jd 6c] [Kh]
bracs111: bets $1.68
Rebellion195: folds 
Uncalled bet ($1.68) returned to bracs111
bracs111 collected $1.68 from pot
bracs111: doesn't show hand 
*** SUMMARY ***
Total pot $1.76 | Rake $0.08 
Board [8s 5s Jd 6c Kh]
Seat 1: Rebellion195 (button) folded on the River
Seat 2: Impostore1988 (small blind) folded on the Turn
Seat 3: bracs111 (big blind) collected ($1.68)
Seat 4: llosjone folded before Flop (didn't bet)
Seat 5: MostlyGravy folded before Flop (didn't bet)



PokerStars Hand #222948124048:  Hold'em No Limit ($0.05/$0.10 USD) - 2021/01/23 3:54:25 ET
Table 'Malzovia III' 6-max Seat #2 is the button
Seat 1: Rebellion195 ($21.77 in chips) 
Seat 2: Impostore1988 ($13.16 in chips) 
Seat 3: bracs111 ($7.30 in chips) 
Seat 4: llosjone ($9.45 in chips) 
Seat 5: MostlyGravy ($13.21 in chips) 
bracs111: posts small blind $0.05
llosjone: posts big blind $0.10
Gissbon: sits out 
*** HOLE CARDS ***
MostlyGravy: raises $0.20 to $0.30
Rebellion195: calls $0.30
Impostore1988: folds 
bracs111: folds 
llosjone: folds 
*** FLOP *** [6h 4c 4s]
MostlyGravy: bets $0.72
Rebellion195: folds 
Uncalled bet ($0.72) returned to MostlyGravy
MostlyGravy collected $0.72 from pot
MostlyGravy: doesn't show hand 
*** SUMMARY ***
Total pot $0.75 | Rake $0.03 
Board [6h 4c 4s]
Seat 1: Rebellion195 folded on the Flop
Seat 2: Impostore1988 (button) folded before Flop (didn't bet)
Seat 3: bracs111 (small blind) folded before Flop
Seat 4: llosjone (big blind) folded before Flop
Seat 5: MostlyGravy collected ($0.72)



PokerStars Hand #222948133198:  Hold'em No Limit ($0.05/$0.10 USD) - 2021/01/23 3:55:03 ET
Table 'Malzovia III' 6-max Seat #3 is the button
Seat 1: Rebellion195 ($21.47 in chips) 
Seat 2: Impostore1988 ($13.16 in chips) 
Seat 3: bracs111 ($7.25 in chips) 
Seat 4: llosjone ($9.35 in chips) 
Seat 5: MostlyGravy ($13.63 in chips) 
llosjone: posts small blind $0.05
MostlyGravy: posts big blind $0.10
Gissbon: sits out 
*** HOLE CARDS ***
Rebellion195: raises $0.20 to $0.30
Impostore1988: folds 
bracs111: calls $0.30
llosjone: folds 
MostlyGravy: folds 
*** FLOP *** [9d 9s Kc]
Rebellion195: checks 
bracs111: checks 
*** TURN *** [9d 9s Kc] [Qd]
Rebellion195: bets $0.50
bracs111: calls $0.50
*** RIVER *** [9d 9s Kc Qd] [5s]
Rebellion195: bets $0.83
bracs111: calls $0.83
*** SHOW DOWN ***
Rebellion195: shows [8d Kd] (two pair, Kings and Nines)
bracs111: mucks hand 
Rebellion195 collected $3.26 from pot
*** SUMMARY ***
Total pot $3.41 | Rake $0.15 
Board [9d 9s Kc Qd 5s]
Seat 1: Rebellion195 showed [8d Kd] and won ($3.26) with two pair, Kings and Nines
Seat 2: Impostore1988 folded before Flop (didn't bet)
Seat 3: bracs111 (button) mucked
Seat 4: llosjone (small blind) folded before Flop
Seat 5: MostlyGravy (big blind) folded before Flop



PokerStars Hand #222948143459:  Hold'em No Limit ($0.05/$0.10 USD) - 2021/01/23 3:55:52 ET
Table 'Malzovia III' 6-max Seat #4 is the button
Seat 1: Rebellion195 ($23.10 in chips) 
Seat 2: Impostore1988 ($13.16 in chips) 
Seat 3: bracs111 ($5.62 in chips) 
Seat 4: llosjone ($9.30 in chips) 
Seat 5: MostlyGravy ($13.53 in chips) 
Seat 6: Gissbon ($10 in chips) 
MostlyGravy: posts small blind $0.05
Gissbon: posts big blind $0.10
*** HOLE CARDS ***
Rebellion195: folds 
Impostore1988: folds 
bracs111: folds 
llosjone: raises $0.15 to $0.25
MostlyGravy: calls $0.20
Gissbon: folds 
*** FLOP *** [2d Qd Qh]
MostlyGravy: bets $0.57
llosjone: folds 
Uncalled bet ($0.57) returned to MostlyGravy
MostlyGravy collected $0.57 from pot
MostlyGravy: doesn't show hand 
*** SUMMARY ***
Total pot $0.60 | Rake $0.03 
Board [2d Qd Qh]
Seat 1: Rebellion195 folded before Flop (didn't bet)
Seat 2: Impostore1988 folded before Flop (didn't bet)
Seat 3: bracs111 folded before Flop (didn't bet)
Seat 4: llosjone (button) folded on the Flop
Seat 5: MostlyGravy (small blind) collected ($0.57)
Seat 6: Gissbon (big blind) folded before Flop



PokerStars Hand #222948153437:  Hold'em No Limit ($0.05/$0.10 USD) - 2021/01/23 3:56:40 ET
Table 'Malzovia III' 6-max Seat #5 is the button
Seat 1: Rebellion195 ($23.10 in chips) 
Seat 2: Impostore1988 ($13.16 in chips) 
Seat 3: bracs111 ($5.62 in chips) 
Seat 4: llosjone ($9.05 in chips) 
Seat 5: MostlyGravy ($13.85 in chips) 
Seat 6: Gissbon ($10 in chips) 
Gissbon: posts small blind $0.05
Rebellion195: posts big blind $0.10
*** HOLE CARDS ***
Impostore1988: folds 
bracs111: raises $0.20 to $0.30
llosjone: folds 
MostlyGravy: folds 
Gissbon: folds 
Rebellion195: calls $0.20
*** FLOP *** [Js As Qs]
Rebellion195: checks 
bracs111: checks 
*** TURN *** [Js As Qs] [Ah]
Rebellion195: checks 
bracs111: bets $0.31
Rebellion195: calls $0.31
*** RIVER *** [Js As Qs Ah] [2d]
Rebellion195: bets $0.70
bracs111: calls $0.70
*** SHOW DOWN ***
Rebellion195: shows [9s Ad] (three of a kind, Aces)
bracs111: mucks hand 
Rebellion195 collected $2.55 from pot
*** SUMMARY ***
Total pot $2.67 | Rake $0.12 
Board [Js As Qs Ah 2d]
Seat 1: Rebellion195 (big blind) showed [9s Ad] and won ($2.55) with three of a kind, Aces
Seat 2: Impostore1988 folded before Flop (didn't bet)
Seat 3: bracs111 mucked
Seat 4: llosjone folded before Flop (didn't bet)
Seat 5: MostlyGravy (button) folded before Flop (didn't bet)
Seat 6: Gissbon (small blind) folded before Flop



PokerStars Hand #222948164467:  Hold'em No Limit ($0.05/$0.10 USD) - 2021/01/23 3:57:33 ET
Table 'Malzovia III' 6-max Seat #6 is the button
Seat 1: Rebellion195 ($24.34 in chips) 
Seat 2: Impostore1988 ($13.16 in chips) 
Seat 3: bracs111 ($4.31 in chips) 
Seat 4: llosjone ($9.05 in chips) 
Seat 5: MostlyGravy ($13.85 in chips) 
Seat 6: Gissbon ($10 in chips) 
Rebellion195: posts small blind $0.05
Impostore1988: posts big blind $0.10
*** HOLE CARDS ***
bracs111: folds 
llosjone: folds 
MostlyGravy: folds 
Gissbon: folds 
Rebellion195: calls $0.05
Impostore1988: checks 
*** FLOP *** [3d 5s Th]
Rebellion195: checks 
Impostore1988: checks 
*** TURN *** [3d 5s Th] [4d]
Rebellion195: checks 
Impostore1988: bets $0.10
Rebellion195: calls $0.10
*** RIVER *** [3d 5s Th 4d] [Tc]
Rebellion195: checks 
Impostore1988: checks 
*** SHOW DOWN ***
Rebellion195: shows [8d Ah] (a pair of Tens)
Impostore1988: shows [9h 5d] (two pair, Tens and Fives)
Impostore1988 collected $0.38 from pot
*** SUMMARY ***
Total pot $0.40 | Rake $0.02 
Board [3d 5s Th 4d Tc]
Seat 1: Rebellion195 (small blind) showed [8d Ah] and lost with a pair of Tens
Seat 2: Impostore1988 (big blind) showed [9h 5d] and won ($0.38) with two pair, Tens and Fives
Seat 3: bracs111 folded before Flop (didn't bet)
Seat 4: llosjone folded before Flop (didn't bet)
Seat 5: MostlyGravy folded before Flop (didn't bet)
Seat 6: Gissbon (button) folded before Flop (didn't bet)



PokerStars Hand #222948174326:  Hold'em No Limit ($0.05/$0.10 USD) - 2021/01/23 3:58:20 ET
Table 'Malzovia III' 6-max Seat #1 is the button
Seat 1: Rebellion195 ($24.14 in chips) 
Seat 2: Impostore1988 ($13.34 in chips) 
Seat 3: bracs111 ($4.31 in chips) 
Seat 4: llosjone ($9.05 in chips) 
Seat 5: MostlyGravy ($13.85 in chips) 
Seat 6: Gissbon ($10 in chips) 
Impostore1988: posts small blind $0.05
bracs111: posts big blind $0.10
*** HOLE CARDS ***
llosjone: folds 
MostlyGravy: folds 
Gissbon: folds 
Rebellion195: folds 
Impostore1988: folds 
Uncalled bet ($0.05) returned to bracs111
bracs111 collected $0.10 from pot
bracs111: doesn't show hand 
*** SUMMARY ***
Total pot $0.10 | Rake $0 
Seat 1: Rebellion195 (button) folded before Flop (didn't bet)
Seat 2: Impostore1988 (small blind) folded before Flop
Seat 3: bracs111 (big blind) collected ($0.10)
Seat 4: llosjone folded before Flop (didn't bet)
Seat 5: MostlyGravy folded before Flop (didn't bet)
Seat 6: Gissbon folded before Flop (didn't bet)



PokerStars Hand #222948176649:  Hold'em No Limit ($0.05/$0.10 USD) - 2021/01/23 3:58:31 ET
Table 'Malzovia III' 6-max Seat #2 is the button
Seat 1: Rebellion195 ($24.14 in chips) 
Seat 2: Impostore1988 ($13.29 in chips) 
Seat 3: bracs111 ($4.36 in chips) 
Seat 4: llosjone ($9.05 in chips) 
Seat 5: MostlyGravy ($13.85 in chips) 
Seat 6: Gissbon ($10 in chips) 
bracs111: posts small blind $0.05
llosjone: posts big blind $0.10
*** HOLE CARDS ***
MostlyGravy: raises $0.10 to $0.20
Gissbon: folds 
Rebellion195: folds 
Impostore1988: folds 
bracs111: calls $0.15
llosjone: calls $0.10
*** FLOP *** [Qh 7h Td]
bracs111: checks 
llosjone: checks 
MostlyGravy: bets $0.28
bracs111: calls $0.28
llosjone: folds 
*** TURN *** [Qh 7h Td] [Jd]
bracs111: checks 
MostlyGravy: checks 
*** RIVER *** [Qh 7h Td Jd] [3s]
bracs111: checks 
MostlyGravy: bets $0.55
bracs111: folds 
Uncalled bet ($0.55) returned to MostlyGravy
MostlyGravy collected $1.11 from pot
MostlyGravy: doesn't show hand 
*** SUMMARY ***
Total pot $1.16 | Rake $0.05 
Board [Qh 7h Td Jd 3s]
Seat 1: Rebellion195 folded before Flop (didn't bet)
Seat 2: Impostore1988 (button) folded before Flop (didn't bet)
Seat 3: bracs111 (small blind) folded on the River
Seat 4: llosjone (big blind) folded on the Flop
Seat 5: MostlyGravy collected ($1.11)
Seat 6: Gissbon folded before Flop (didn't bet)



PokerStars Hand #222948189787:  Hold'em No Limit ($0.05/$0.10 USD) - 2021/01/23 3:59:32 ET
Table 'Malzovia III' 6-max Seat #3 is the button
Seat 1: Rebellion195 ($24.14 in chips) 
Seat 2: Impostore1988 ($13.29 in chips) 
Seat 3: bracs111 ($3.88 in chips) 
Seat 4: llosjone ($8.85 in chips) 
Seat 5: MostlyGravy ($14.48 in chips) 
Seat 6: Gissbon ($10 in chips) 
llosjone: posts small blind $0.05
MostlyGravy: posts big blind $0.10
*** HOLE CARDS ***
Gissbon: folds 
Rebellion195: raises $0.20 to $0.30
Impostore1988: folds 
bracs111: calls $0.30
llosjone: folds 
MostlyGravy: folds 
*** FLOP *** [Jd 6h Qs]
Rebellion195: checks 
bracs111: checks 
*** TURN *** [Jd 6h Qs] [4h]
Rebellion195: checks 
bracs111: bets $0.36
Rebellion195: calls $0.36
*** RIVER *** [Jd 6h Qs 4h] [6s]
Rebellion195: bets $0.80
bracs111: raises $1.50 to $2.30
Rebellion195: calls $1.50
*** SHOW DOWN ***
bracs111: shows [6c Ad] (three of a kind, Sixes)
Rebellion195: mucks hand 
bracs111 collected $5.80 from pot
*** SUMMARY ***
Total pot $6.07 | Rake $0.27 
Board [Jd 6h Qs 4h 6s]
Seat 1: Rebellion195 mucked
Seat 2: Impostore1988 folded before Flop (didn't bet)
Seat 3: bracs111 (button) showed [6c Ad] and won ($5.80) with three of a kind, Sixes
Seat 4: llosjone (small blind) folded before Flop
Seat 5: MostlyGravy (big blind) folded before Flop
Seat 6: Gissbon folded before Flop (didn't bet)



PokerStars Hand #222948207040:  Hold'em No Limit ($0.05/$0.10 USD) - 2021/01/23 4:00:49 ET
Table 'Malzovia III' 6-max Seat #4 is the button
Seat 1: Rebellion195 ($21.18 in chips) 
Seat 2: Impostore1988 ($13.29 in chips) 
Seat 3: bracs111 ($6.72 in chips) 
Seat 4: llosjone ($8.80 in chips) 
Seat 5: MostlyGravy ($14.38 in chips) 
Seat 6: Gissbon ($10 in chips) 
MostlyGravy: posts small blind $0.05
Gissbon: posts big blind $0.10
*** HOLE CARDS ***
Rebellion195: folds 
Rebellion195 leaves the table
Impostore1988: folds 
bracs111: calls $0.10
llosjone: folds 
MostlyGravy: calls $0.05
Gissbon: checks 
*** FLOP *** [Kd Jc Kc]
MostlyGravy: checks 
Gissbon: checks 
bracs111: bets $0.14
MostlyGravy: folds 
Gissbon: folds 
Uncalled bet ($0.14) returned to bracs111
bracs111 collected $0.29 from pot
bracs111: doesn't show hand 
*** SUMMARY ***
Total pot $0.30 | Rake $0.01 
Board [Kd Jc Kc]
Seat 1: Rebellion195 folded before Flop (didn't bet)
Seat 2: Impostore1988 folded before Flop (didn't bet)
Seat 3: bracs111 collected ($0.29)
Seat 4: llosjone (button) folded before Flop (didn't bet)
Seat 5: MostlyGravy (small blind) folded on the Flop
Seat 6: Gissbon (big blind) folded on the Flop



PokerStars Hand #222948216596:  Hold'em No Limit ($0.05/$0.10 USD) - 2021/01/23 4:01:27 ET
Table 'Malzovia III' 6-max Seat #5 is the button
Seat 2: Impostore1988 ($13.29 in chips) 
Seat 3: bracs111 ($6.91 in chips) 
Seat 4: llosjone ($8.80 in chips) 
Seat 5: MostlyGravy ($14.28 in chips) 
Seat 6: Gissbon ($10 in chips) 
Gissbon: posts small blind $0.05
Impostore1988: posts big blind $0.10
*** HOLE CARDS ***
bracs111: raises $0.20 to $0.30
llosjone: folds 
MostlyGravy: calls $0.30
Gissbon: folds 
Impostore1988: folds 
*** FLOP *** [5c Ah 6c]
algelissss joins the table at seat #1 
bracs111: checks 
MostlyGravy: bets $0.36
bracs111: calls $0.36
*** TURN *** [5c Ah 6c] [Td]
bracs111: checks 
MostlyGravy: checks 
*** RIVER *** [5c Ah 6c Td] [5d]
bracs111: checks 
MostlyGravy: checks 
*** SHOW DOWN ***
bracs111: shows [2s 4d] (a pair of Fives)
MostlyGravy: shows [Ac 8h] (two pair, Aces and Fives)
MostlyGravy collected $1.40 from pot
*** SUMMARY ***
Total pot $1.47 | Rake $0.07 
Board [5c Ah 6c Td 5d]
Seat 2: Impostore1988 (big blind) folded before Flop
Seat 3: bracs111 showed [2s 4d] and lost with a pair of Fives
Seat 4: llosjone folded before Flop (didn't bet)
Seat 5: MostlyGravy (button) showed [Ac 8h] and won ($1.40) with two pair, Aces and Fives
Seat 6: Gissbon (small blind) folded before Flop



PokerStars Hand #222948226224:  Hold'em No Limit ($0.05/$0.10 USD) - 2021/01/23 4:02:06 ET
Table 'Malzovia III' 6-max Seat #6 is the button
Seat 2: Impostore1988 ($13.19 in chips) 
Seat 3: bracs111 ($6.25 in chips) 
Seat 4: llosjone ($10 in chips) 
Seat 5: MostlyGravy ($15.02 in chips) 
Seat 6: Gissbon ($10 in chips) 
Impostore1988: posts small blind $0.05
bracs111: posts big blind $0.10
*** HOLE CARDS ***
llosjone: folds 
MostlyGravy: raises $0.10 to $0.20
Gissbon: folds 
Impostore1988: folds 
bracs111: calls $0.10
*** FLOP *** [7d 9d 3c]
bracs111: checks 
MostlyGravy: bets $0.21
bracs111: calls $0.21
*** TURN *** [7d 9d 3c] [6s]
bracs111: bets $0.41
MostlyGravy: calls $0.41
*** RIVER *** [7d 9d 3c 6s] [As]
algelissss leaves the table
bracs111: bets $0.80
schnu111 joins the table at seat #1 
MostlyGravy: raises $2 to $2.80
bracs111: calls $2
*** SHOW DOWN ***
MostlyGravy: shows [Ah 7c] (two pair, Aces and Sevens)
bracs111: mucks hand 
MostlyGravy collected $6.96 from pot
*** SUMMARY ***
Total pot $7.29 | Rake $0.33 
Board [7d 9d 3c 6s As]
Seat 2: Impostore1988 (small blind) folded before Flop
Seat 3: bracs111 (big blind) mucked
Seat 4: llosjone folded before Flop (didn't bet)
Seat 5: MostlyGravy showed [Ah 7c] and won ($6.96) with two pair, Aces and Sevens
Seat 6: Gissbon (button) folded before Flop (didn't bet)



PokerStars Hand #222948239069:  Hold'em No Limit ($0.05/$0.10 USD) - 2021/01/23 4:02:57 ET
Table 'Malzovia III' 6-max Seat #2 is the button
Seat 2: Impostore1988 ($13.14 in chips) 
Seat 3: bracs111 ($2.63 in chips) 
Seat 4: llosjone ($10 in chips) 
Seat 5: MostlyGravy ($18.36 in chips) 
Seat 6: Gissbon ($10 in chips) 
bracs111: posts small blind $0.05
llosjone: posts big blind $0.10
schnu111: sits out 
*** HOLE CARDS ***
MostlyGravy: raises $0.10 to $0.20
Gissbon: folds 
Impostore1988: folds 
bracs111: calls $0.15
llosjone: folds 
*** FLOP *** [6c 4h Ah]
bracs111: checks 
MostlyGravy: checks 
*** TURN *** [6c 4h Ah] [Ad]
bracs111: bets $0.20
MostlyGravy: calls $0.20
*** RIVER *** [6c 4h Ah Ad] [3c]
bracs111: checks 
MostlyGravy: bets $0.43
bracs111: calls $0.43
*** SHOW DOWN ***
MostlyGravy: shows [Jh Qh] (a pair of Aces)
bracs111: shows [8s 4s] (two pair, Aces and Fours)
bracs111 collected $1.68 from pot
*** SUMMARY ***
Total pot $1.76 | Rake $0.08 
Board [6c 4h Ah Ad 3c]
Seat 2: Impostore1988 (button) folded before Flop (didn't bet)
Seat 3: bracs111 (small blind) showed [8s 4s] and won ($1.68) with two pair, Aces and Fours
Seat 4: llosjone (big blind) folded before Flop
Seat 5: MostlyGravy showed [Jh Qh] and lost with a pair of Aces
Seat 6: Gissbon folded before Flop (didn't bet)



PokerStars Hand #222948253626:  Hold'em No Limit ($0.05/$0.10 USD) - 2021/01/23 4:03:54 ET
Table 'Malzovia III' 6-max Seat #3 is the button
Seat 2: Impostore1988 ($13.14 in chips) 
Seat 3: bracs111 ($3.48 in chips) 
Seat 4: llosjone ($9.90 in chips) 
Seat 5: MostlyGravy ($17.53 in chips) 
Seat 6: Gissbon ($10 in chips) 
llosjone: posts small blind $0.05
MostlyGravy: posts big blind $0.10
schnu111: sits out 
*** HOLE CARDS ***
Gissbon: folds 
Impostore1988: raises $0.10 to $0.20
bracs111: folds 
llosjone: folds 
MostlyGravy: calls $0.10
*** FLOP *** [6h 8c 5c]
MostlyGravy: bets $0.10
Impostore1988: folds 
Uncalled bet ($0.10) returned to MostlyGravy
MostlyGravy collected $0.43 from pot
MostlyGravy: doesn't show hand 
*** SUMMARY ***
Total pot $0.45 | Rake $0.02 
Board [6h 8c 5c]
Seat 2: Impostore1988 folded on the Flop
Seat 3: bracs111 (button) folded before Flop (didn't bet)
Seat 4: llosjone (small blind) folded before Flop
Seat 5: MostlyGravy (big blind) collected ($0.43)
Seat 6: Gissbon folded before Flop (didn't bet)



PokerStars Hand #222948257787:  Hold'em No Limit ($0.05/$0.10 USD) - 2021/01/23 4:04:11 ET
Table 'Malzovia III' 6-max Seat #4 is the button
Seat 2: Impostore1988 ($12.94 in chips) 
Seat 3: bracs111 ($3.48 in chips) 
Seat 4: llosjone ($9.85 in chips) 
Seat 5: MostlyGravy ($17.76 in chips) 
Seat 6: Gissbon ($10 in chips) 
MostlyGravy: posts small blind $0.05
Gissbon: posts big blind $0.10
schnu111: sits out 
*** HOLE CARDS ***
Impostore1988: folds 
bracs111: folds 
llosjone: folds 
MostlyGravy: raises $0.20 to $0.30
Gissbon: folds 
Uncalled bet ($0.20) returned to MostlyGravy
MostlyGravy collected $0.20 from pot
MostlyGravy: doesn't show hand 
*** SUMMARY ***
Total pot $0.20 | Rake $0 
Seat 2: Impostore1988 folded before Flop (didn't bet)
Seat 3: bracs111 folded before Flop (didn't bet)
Seat 4: llosjone (button) folded before Flop (didn't bet)
Seat 5: MostlyGravy (small blind) collected ($0.20)
Seat 6: Gissbon (big blind) folded before Flop



PokerStars Hand #222948264228:  Hold'em No Limit ($0.05/$0.10 USD) - 2021/01/23 4:04:36 ET
Table 'Malzovia III' 6-max Seat #5 is the button
Seat 1: schnu111 ($10 in chips) 
Seat 2: Impostore1988 ($12.94 in chips) 
Seat 3: bracs111 ($3.48 in chips) 
Seat 4: llosjone ($9.85 in chips) 
Seat 5: MostlyGravy ($17.86 in chips) 
Seat 6: Gissbon ($10 in chips) 
Gissbon: posts small blind $0.05
schnu111: posts big blind $0.10
*** HOLE CARDS ***
Impostore1988: folds 
bracs111: raises $0.20 to $0.30
llosjone: folds 
MostlyGravy: calls $0.30
Gissbon: folds 
schnu111: calls $0.20
*** FLOP *** [Jc 7h Qh]
schnu111: checks 
bracs111: bets $0.45
MostlyGravy: calls $0.45
schnu111: folds 
*** TURN *** [Jc 7h Qh] [9c]
bracs111: checks 
MostlyGravy: checks 
*** RIVER *** [Jc 7h Qh 9c] [As]
bracs111: bets $0.88
MostlyGravy: calls $0.88
*** SHOW DOWN ***
bracs111: shows [Qd Ts] (a pair of Queens)
MostlyGravy: shows [Td Ac] (a pair of Aces)
MostlyGravy collected $3.45 from pot
*** SUMMARY ***
Total pot $3.61 | Rake $0.16 
Board [Jc 7h Qh 9c As]
Seat 1: schnu111 (big blind) folded on the Flop
Seat 2: Impostore1988 folded before Flop (didn't bet)
Seat 3: bracs111 showed [Qd Ts] and lost with a pair of Queens
Seat 4: llosjone folded before Flop (didn't bet)
Seat 5: MostlyGravy (button) showed [Td Ac] and won ($3.45) with a pair of Aces
Seat 6: Gissbon (small blind) folded before Flop



PokerStars Hand #222948286123:  Hold'em No Limit ($0.05/$0.10 USD) - 2021/01/23 4:06:02 ET
Table 'Malzovia III' 6-max Seat #6 is the button
Seat 1: schnu111 ($10 in chips) 
Seat 2: Impostore1988 ($12.94 in chips) 
Seat 3: bracs111 ($1.85 in chips) 
Seat 4: llosjone ($9.85 in chips) 
Seat 5: MostlyGravy ($19.68 in chips) 
Seat 6: Gissbon ($10 in chips) 
schnu111: posts small blind $0.05
Impostore1988: posts big blind $0.10
*** HOLE CARDS ***
bracs111: raises $0.20 to $0.30
llosjone: folds 
MostlyGravy: calls $0.30
Gissbon: folds 
schnu111: folds 
Impostore1988: folds 
*** FLOP *** [8c 7h Kh]
bracs111: checks 
MostlyGravy: checks 
*** TURN *** [8c 7h Kh] [2d]
bracs111: checks 
MostlyGravy: bets $0.36
bracs111: folds 
Uncalled bet ($0.36) returned to MostlyGravy
MostlyGravy collected $0.72 from pot
MostlyGravy: doesn't show hand 
*** SUMMARY ***
Total pot $0.75 | Rake $0.03 
Board [8c 7h Kh 2d]
Seat 1: schnu111 (small blind) folded before Flop
Seat 2: Impostore1988 (big blind) folded before Flop
Seat 3: bracs111 folded on the Turn
Seat 4: llosjone folded before Flop (didn't bet)
Seat 5: MostlyGravy collected ($0.72)
Seat 6: Gissbon (button) folded before Flop (didn't bet)



PokerStars Hand #222948297570:  Hold'em No Limit ($0.05/$0.10 USD) - 2021/01/23 4:06:47 ET
Table 'Malzovia III' 6-max Seat #1 is the button
Seat 1: schnu111 ($10 in chips) 
Seat 2: Impostore1988 ($12.84 in chips) 
Seat 3: bracs111 ($1.55 in chips) 
Seat 4: llosjone ($9.85 in chips) 
Seat 5: MostlyGravy ($20.10 in chips) 
Seat 6: Gissbon ($10 in chips) 
Impostore1988: posts small blind $0.05
bracs111: posts big blind $0.10
*** HOLE CARDS ***
llosjone: raises $0.15 to $0.25
MostlyGravy: calls $0.25
Gissbon: folds 
schnu111: calls $0.25
Impostore1988: folds 
bracs111: calls $0.15
*** FLOP *** [9c Jh 5s]
bracs111: checks 
llosjone: checks 
MostlyGravy: bets $0.70
schnu111: folds 
bracs111: calls $0.70
llosjone: folds 
*** TURN *** [9c Jh 5s] [6s]
bracs111: checks 
MostlyGravy: bets $19.15 and is all-in
bracs111: calls $0.60 and is all-in
Uncalled bet ($18.55) returned to MostlyGravy
*** RIVER *** [9c Jh 5s 6s] [5c]
*** SHOW DOWN ***
bracs111: shows [Ks 5h] (three of a kind, Fives)
MostlyGravy: shows [Jd Qh] (two pair, Jacks and Fives)
bracs111 cashed out the hand for $0.40
MostlyGravy cashed out the hand for $3.06 | Cash Out Fee $0.03
*** SUMMARY ***
Total pot $3.65 | Rake $0.16 
Board [9c Jh 5s 6s 5c]
Seat 1: schnu111 (button) folded on the Flop
Seat 2: Impostore1988 (small blind) folded before Flop
Seat 3: bracs111 (big blind) showed [Ks 5h] and won ($3.49) with three of a kind, Fives (pot not awarded as player cashed out)
Seat 4: llosjone folded on the Flop
Seat 5: MostlyGravy showed [Jd Qh] and lost with two pair, Jacks and Fives (cashed out).
Seat 6: Gissbon folded before Flop (didn't bet)



PokerStars Hand #222948312831:  Hold'em No Limit ($0.05/$0.10 USD) - 2021/01/23 4:07:47 ET
Table 'Malzovia III' 6-max Seat #2 is the button
Seat 1: schnu111 ($10 in chips) 
Seat 2: Impostore1988 ($12.79 in chips) 
Seat 3: bracs111 ($0.40 in chips) 
Seat 4: llosjone ($9.60 in chips) 
Seat 5: MostlyGravy ($21.61 in chips) 
Seat 6: Gissbon ($10 in chips) 
bracs111: posts small blind $0.05
llosjone: posts big blind $0.10
*** HOLE CARDS ***
MostlyGravy: calls $0.10
Gissbon: folds 
schnu111: folds 
Impostore1988: folds 
bracs111: calls $0.05
llosjone: checks 
*** FLOP *** [Jd 9c Qh]
bracs111: checks 
llosjone: checks 
MostlyGravy: checks 
*** TURN *** [Jd 9c Qh] [6c]
bracs111: bets $0.14
llosjone: folds 
MostlyGravy: raises $0.14 to $0.28
bracs111: calls $0.14
*** RIVER *** [Jd 9c Qh 6c] [9s]
bracs111: bets $0.02 and is all-in
MostlyGravy: calls $0.02
*** SHOW DOWN ***
bracs111: shows [Tc 9d] (three of a kind, Nines)
MostlyGravy: shows [Td Kh] (a straight, Nine to King)
MostlyGravy collected $0.86 from pot
*** SUMMARY ***
Total pot $0.90 | Rake $0.04 
Board [Jd 9c Qh 6c 9s]
Seat 1: schnu111 folded before Flop (didn't bet)
Seat 2: Impostore1988 (button) folded before Flop (didn't bet)
Seat 3: bracs111 (small blind) showed [Tc 9d] and lost with three of a kind, Nines
Seat 4: llosjone (big blind) folded on the Turn
Seat 5: MostlyGravy showed [Td Kh] and won ($0.86) with a straight, Nine to King
Seat 6: Gissbon folded before Flop (didn't bet)



PokerStars Hand #222948328220:  Hold'em No Limit ($0.05/$0.10 USD) - 2021/01/23 4:08:46 ET
Table 'Malzovia III' 6-max Seat #4 is the button
Seat 1: schnu111 ($10 in chips) 
Seat 2: Impostore1988 ($12.79 in chips) 
Seat 4: llosjone ($9.50 in chips) 
Seat 5: MostlyGravy ($22.07 in chips) 
Seat 6: Gissbon ($10 in chips) 
MostlyGravy: posts small blind $0.05
Gissbon: posts big blind $0.10
*** HOLE CARDS ***
schnu111: folds 
Impostore1988: folds 
llosjone: raises $0.15 to $0.25
MostlyGravy: calls $0.20
Gissbon: folds 
*** FLOP *** [Jc 5h 3d]
MostlyGravy: bets $0.28
bracs111 leaves the table
llosjone: calls $0.28
*** TURN *** [Jc 5h 3d] [2d]
MostlyGravy: bets $0.10
llosjone: raises $0.43 to $0.53
MostlyGravy: calls $0.43
*** RIVER *** [Jc 5h 3d 2d] [6d]
fuzinger joins the table at seat #3 
MostlyGravy: checks 
llosjone: checks 
*** SHOW DOWN ***
MostlyGravy: shows [Ad Th] (high card Ace)
llosjone: shows [9d 9c] (a pair of Nines)
llosjone collected $2.12 from pot
*** SUMMARY ***
Total pot $2.22 | Rake $0.10 
Board [Jc 5h 3d 2d 6d]
Seat 1: schnu111 folded before Flop (didn't bet)
Seat 2: Impostore1988 folded before Flop (didn't bet)
Seat 4: llosjone (button) showed [9d 9c] and won ($2.12) with a pair of Nines
Seat 5: MostlyGravy (small blind) showed [Ad Th] and lost with high card Ace
Seat 6: Gissbon (big blind) folded before Flop



PokerStars Hand #222948346415:  Hold'em No Limit ($0.05/$0.10 USD) - 2021/01/23 4:09:57 ET
Table 'Malzovia III' 6-max Seat #5 is the button
Seat 1: schnu111 ($10 in chips) 
Seat 2: Impostore1988 ($12.79 in chips) 
Seat 4: llosjone ($10.56 in chips) 
Seat 5: MostlyGravy ($21.01 in chips) 
Seat 6: Gissbon ($10 in chips) 
Gissbon: posts small blind $0.05
schnu111: posts big blind $0.10
fuzinger: sits out 
*** HOLE CARDS ***
Impostore1988: raises $0.10 to $0.20
llosjone: folds 
MostlyGravy: folds 
Gissbon: folds 
schnu111: folds 
Uncalled bet ($0.10) returned to Impostore1988
Impostore1988 collected $0.25 from pot
Impostore1988: doesn't show hand 
*** SUMMARY ***
Total pot $0.25 | Rake $0 
Seat 1: schnu111 (big blind) folded before Flop
Seat 2: Impostore1988 collected ($0.25)
Seat 4: llosjone folded before Flop (didn't bet)
Seat 5: MostlyGravy (button) folded before Flop (didn't bet)
Seat 6: Gissbon (small blind) folded before Flop



PokerStars Hand #222948350447:  Hold'em No Limit ($0.05/$0.10 USD) - 2021/01/23 4:10:12 ET
Table 'Malzovia III' 6-max Seat #6 is the button
Seat 1: schnu111 ($10 in chips) 
Seat 2: Impostore1988 ($12.94 in chips) 
Seat 4: llosjone ($10.56 in chips) 
Seat 5: MostlyGravy ($21.01 in chips) 
Seat 6: Gissbon ($10 in chips) 
schnu111: posts small blind $0.05
Impostore1988: posts big blind $0.10
fuzinger: sits out 
*** HOLE CARDS ***
llosjone: folds 
MostlyGravy: raises $0.30 to $0.40
Gissbon: folds 
schnu111: folds 
Impostore1988: folds 
Uncalled bet ($0.30) returned to MostlyGravy
MostlyGravy collected $0.25 from pot
MostlyGravy: doesn't show hand 
*** SUMMARY ***
Total pot $0.25 | Rake $0 
Seat 1: schnu111 (small blind) folded before Flop
Seat 2: Impostore1988 (big blind) folded before Flop
Seat 4: llosjone folded before Flop (didn't bet)
Seat 5: MostlyGravy collected ($0.25)
Seat 6: Gissbon (button) folded before Flop (didn't bet)



PokerStars Hand #222948354627:  Hold'em No Limit ($0.05/$0.10 USD) - 2021/01/23 4:10:29 ET
Table 'Malzovia III' 6-max Seat #1 is the button
Seat 1: schnu111 ($10 in chips) 
Seat 2: Impostore1988 ($12.84 in chips) 
Seat 3: fuzinger ($10 in chips) 
Seat 4: llosjone ($10.56 in chips) 
Seat 5: MostlyGravy ($21.16 in chips) 
Seat 6: Gissbon ($10 in chips) 
Impostore1988: posts small blind $0.05
fuzinger: posts big blind $0.10
*** HOLE CARDS ***
llosjone: folds 
MostlyGravy: folds 
Gissbon: raises $0.15 to $0.25
schnu111: raises $0.65 to $0.90
Impostore1988: folds 
fuzinger: folds 
Gissbon: calls $0.65
*** FLOP *** [2h 2d 4s]
Gissbon: checks 
schnu111: bets $0.93
Gissbon: calls $0.93
*** TURN *** [2h 2d 4s] [2c]
Gissbon: checks 
schnu111: checks 
*** RIVER *** [2h 2d 4s 2c] [Th]
Gissbon: bets $1.46
schnu111: folds 
Uncalled bet ($1.46) returned to Gissbon
Gissbon collected $3.64 from pot
*** SUMMARY ***
Total pot $3.81 | Rake $0.17 
Board [2h 2d 4s 2c Th]
Seat 1: schnu111 (button) folded on the River
Seat 2: Impostore1988 (small blind) folded before Flop
Seat 3: fuzinger (big blind) folded before Flop
Seat 4: llosjone folded before Flop (didn't bet)
Seat 5: MostlyGravy folded before Flop (didn't bet)
Seat 6: Gissbon collected ($3.64)



PokerStars Hand #222948364964:  Hold'em No Limit ($0.05/$0.10 USD) - 2021/01/23 4:11:09 ET
Table 'Malzovia III' 6-max Seat #2 is the button
Seat 1: schnu111 ($10 in chips) 
Seat 2: Impostore1988 ($12.79 in chips) 
Seat 3: fuzinger ($10 in chips) 
Seat 4: llosjone ($10.56 in chips) 
Seat 5: MostlyGravy ($21.16 in chips) 
Seat 6: Gissbon ($11.81 in chips) 
fuzinger: posts small blind $0.05
llosjone: posts big blind $0.10
*** HOLE CARDS ***
MostlyGravy: folds 
Gissbon: folds 
schnu111: folds 
Impostore1988: folds 
fuzinger: folds 
Uncalled bet ($0.05) returned to llosjone
llosjone collected $0.10 from pot
llosjone: doesn't show hand 
*** SUMMARY ***
Total pot $0.10 | Rake $0 
Seat 1: schnu111 folded before Flop (didn't bet)
Seat 2: Impostore1988 (button) folded before Flop (didn't bet)
Seat 3: fuzinger (small blind) folded before Flop
Seat 4: llosjone (big blind) collected ($0.10)
Seat 5: MostlyGravy folded before Flop (didn't bet)
Seat 6: Gissbon folded before Flop (didn't bet)



PokerStars Hand #222948368812:  Hold'em No Limit ($0.05/$0.10 USD) - 2021/01/23 4:11:24 ET
Table 'Malzovia III' 6-max Seat #3 is the button
Seat 1: schnu111 ($10 in chips) 
Seat 2: Impostore1988 ($12.79 in chips) 
Seat 3: fuzinger ($10 in chips) 
Seat 4: llosjone ($10.61 in chips) 
Seat 5: MostlyGravy ($21.16 in chips) 
Seat 6: Gissbon ($11.81 in chips) 
llosjone: posts small blind $0.05
MostlyGravy: posts big blind $0.10
*** HOLE CARDS ***
Gissbon: folds 
schnu111: raises $0.20 to $0.30
Impostore1988: folds 
fuzinger: folds 
llosjone: calls $0.25
MostlyGravy: calls $0.20
*** FLOP *** [Ac Ah 7d]
llosjone: bets $0.37
MostlyGravy: calls $0.37
schnu111: folds 
*** TURN *** [Ac Ah 7d] [Qh]
Impostore1988 leaves the table
Mr.KlonkAlot joins the table at seat #2 
llosjone: bets $0.68
MostlyGravy: folds 
Uncalled bet ($0.68) returned to llosjone
llosjone collected $1.57 from pot
llosjone: doesn't show hand 
*** SUMMARY ***
Total pot $1.64 | Rake $0.07 
Board [Ac Ah 7d Qh]
Seat 1: schnu111 folded on the Flop
Seat 2: Impostore1988 folded before Flop (didn't bet)
Seat 3: fuzinger (button) folded before Flop (didn't bet)
Seat 4: llosjone (small blind) collected ($1.57)
Seat 5: MostlyGravy (big blind) folded on the Turn
Seat 6: Gissbon folded before Flop (didn't bet)



PokerStars Hand #222948389877:  Hold'em No Limit ($0.05/$0.10 USD) - 2021/01/23 4:12:46 ET
Table 'Malzovia III' 6-max Seat #4 is the button
Seat 1: schnu111 ($10 in chips) 
Seat 3: fuzinger ($10 in chips) 
Seat 4: llosjone ($11.51 in chips) 
Seat 5: MostlyGravy ($20.49 in chips) 
Seat 6: Gissbon ($11.81 in chips) 
MostlyGravy: posts small blind $0.05
Gissbon: posts big blind $0.10
Mr.KlonkAlot: sits out 
*** HOLE CARDS ***
schnu111: folds 
fuzinger: raises $0.30 to $0.40
llosjone: folds 
MostlyGravy: folds 
Gissbon: folds 
Uncalled bet ($0.30) returned to fuzinger
fuzinger collected $0.25 from pot
fuzinger: doesn't show hand 
*** SUMMARY ***
Total pot $0.25 | Rake $0 
Seat 1: schnu111 folded before Flop (didn't bet)
Seat 3: fuzinger collected ($0.25)
Seat 4: llosjone (button) folded before Flop (didn't bet)
Seat 5: MostlyGravy (small blind) folded before Flop
Seat 6: Gissbon (big blind) folded before Flop



PokerStars Hand #222948393071:  Hold'em No Limit ($0.05/$0.10 USD) - 2021/01/23 4:12:58 ET
Table 'Malzovia III' 6-max Seat #5 is the button
Seat 1: schnu111 ($10 in chips) 
Seat 3: fuzinger ($10.15 in chips) 
Seat 4: llosjone ($11.51 in chips) 
Seat 5: MostlyGravy ($20.44 in chips) 
Seat 6: Gissbon ($11.71 in chips) 
Gissbon: posts small blind $0.05
schnu111: posts big blind $0.10
Mr.KlonkAlot: sits out 
*** HOLE CARDS ***
fuzinger: folds 
llosjone: raises $0.15 to $0.25
MostlyGravy: folds 
Gissbon: folds 
schnu111: calls $0.15
*** FLOP *** [As Th 5d]
schnu111: checks 
llosjone: bets $0.17
schnu111: raises $0.58 to $0.75
llosjone: folds 
Uncalled bet ($0.58) returned to schnu111
schnu111 collected $0.85 from pot
schnu111: doesn't show hand 
*** SUMMARY ***
Total pot $0.89 | Rake $0.04 
Board [As Th 5d]
Seat 1: schnu111 (big blind) collected ($0.85)
Seat 3: fuzinger folded before Flop (didn't bet)
Seat 4: llosjone folded on the Flop
Seat 5: MostlyGravy (button) folded before Flop (didn't bet)
Seat 6: Gissbon (small blind) folded before Flop



PokerStars Hand #222948400056:  Hold'em No Limit ($0.05/$0.10 USD) - 2021/01/23 4:13:26 ET
Table 'Malzovia III' 6-max Seat #6 is the button
Seat 1: schnu111 ($10.43 in chips) 
Seat 2: Mr.KlonkAlot ($10 in chips) 
Seat 3: fuzinger ($10.15 in chips) 
Seat 4: llosjone ($11.09 in chips) 
Seat 5: MostlyGravy ($20.44 in chips) 
Seat 6: Gissbon ($11.66 in chips) 
schnu111: posts small blind $0.05
Mr.KlonkAlot: posts big blind $0.10
*** HOLE CARDS ***
fuzinger: folds 
llosjone: raises $0.15 to $0.25
MostlyGravy: folds 
Gissbon: folds 
schnu111: folds 
Mr.KlonkAlot: calls $0.15
*** FLOP *** [3s Qh Ah]
Mr.KlonkAlot: checks 
llosjone: bets $0.17
Mr.KlonkAlot: raises $0.38 to $0.55
llosjone: calls $0.38
*** TURN *** [3s Qh Ah] [6d]
Mr.KlonkAlot: bets $1
llosjone: folds 
Uncalled bet ($1) returned to Mr.KlonkAlot
Mr.KlonkAlot collected $1.58 from pot
Mr.KlonkAlot: doesn't show hand 
*** SUMMARY ***
Total pot $1.65 | Rake $0.07 
Board [3s Qh Ah 6d]
Seat 1: schnu111 (small blind) folded before Flop
Seat 2: Mr.KlonkAlot (big blind) collected ($1.58)
Seat 3: fuzinger folded before Flop (didn't bet)
Seat 4: llosjone folded on the Turn
Seat 5: MostlyGravy folded before Flop (didn't bet)
Seat 6: Gissbon (button) folded before Flop (didn't bet)



PokerStars Hand #222948410145:  Hold'em No Limit ($0.05/$0.10 USD) - 2021/01/23 4:14:05 ET
Table 'Malzovia III' 6-max Seat #1 is the button
Seat 1: schnu111 ($10.38 in chips) 
Seat 2: Mr.KlonkAlot ($10.78 in chips) 
Seat 3: fuzinger ($10.15 in chips) 
Seat 4: llosjone ($10.29 in chips) 
Seat 5: MostlyGravy ($20.44 in chips) 
Seat 6: Gissbon ($11.66 in chips) 
Mr.KlonkAlot: posts small blind $0.05
fuzinger: posts big blind $0.10
*** HOLE CARDS ***
llosjone: folds 
MostlyGravy: folds 
Gissbon: raises $0.15 to $0.25
schnu111: folds 
Mr.KlonkAlot: folds 
fuzinger: folds 
Uncalled bet ($0.15) returned to Gissbon
Gissbon collected $0.25 from pot
*** SUMMARY ***
Total pot $0.25 | Rake $0 
Seat 1: schnu111 (button) folded before Flop (didn't bet)
Seat 2: Mr.KlonkAlot (small blind) folded before Flop
Seat 3: fuzinger (big blind) folded before Flop
Seat 4: llosjone folded before Flop (didn't bet)
Seat 5: MostlyGravy folded before Flop (didn't bet)
Seat 6: Gissbon collected ($0.25)



PokerStars Hand #222948414796:  Hold'em No Limit ($0.05/$0.10 USD) - 2021/01/23 4:14:23 ET
Table 'Malzovia III' 6-max Seat #2 is the button
Seat 1: schnu111 ($10.38 in chips) 
Seat 2: Mr.KlonkAlot ($10.73 in chips) 
Seat 3: fuzinger ($10.05 in chips) 
Seat 4: llosjone ($10.29 in chips) 
Seat 5: MostlyGravy ($20.44 in chips) 
Seat 6: Gissbon ($11.81 in chips) 
fuzinger: posts small blind $0.05
llosjone: posts big blind $0.10
*** HOLE CARDS ***
MostlyGravy: folds 
Gissbon: folds 
schnu111: raises $0.20 to $0.30
Mr.KlonkAlot: calls $0.30
fuzinger: folds 
llosjone: calls $0.20
*** FLOP *** [Kd Ks 8d]
llosjone: checks 
schnu111: bets $0.68
Mr.KlonkAlot: raises $0.92 to $1.60
llosjone: folds 
schnu111: folds 
Uncalled bet ($0.92) returned to Mr.KlonkAlot
Mr.KlonkAlot collected $2.21 from pot
Mr.KlonkAlot: doesn't show hand 
*** SUMMARY ***
Total pot $2.31 | Rake $0.10 
Board [Kd Ks 8d]
Seat 1: schnu111 folded on the Flop
Seat 2: Mr.KlonkAlot (button) collected ($2.21)
Seat 3: fuzinger (small blind) folded before Flop
Seat 4: llosjone (big blind) folded on the Flop
Seat 5: MostlyGravy folded before Flop (didn't bet)
Seat 6: Gissbon folded before Flop (didn't bet)



PokerStars Hand #222948423817:  Hold'em No Limit ($0.05/$0.10 USD) - 2021/01/23 4:14:57 ET
Table 'Malzovia III' 6-max Seat #3 is the button
Seat 1: schnu111 ($10 in chips) 
Seat 2: Mr.KlonkAlot ($11.96 in chips) 
Seat 3: fuzinger ($10 in chips) 
Seat 4: llosjone ($9.99 in chips) 
Seat 5: MostlyGravy ($20.44 in chips) 
Seat 6: Gissbon ($11.81 in chips) 
llosjone: posts small blind $0.05
MostlyGravy: posts big blind $0.10
*** HOLE CARDS ***
Gissbon: folds 
schnu111: folds 
Mr.KlonkAlot: raises $0.30 to $0.40
fuzinger: folds 
llosjone: folds 
MostlyGravy: calls $0.30
*** FLOP *** [7h Ah Jd]
MostlyGravy: checks 
Mr.KlonkAlot: bets $0.55
MostlyGravy: calls $0.55
*** TURN *** [7h Ah Jd] [Jc]
MostlyGravy: checks 
Mr.KlonkAlot: checks 
*** RIVER *** [7h Ah Jd Jc] [Td]
MostlyGravy: bets $2.83
Mr.KlonkAlot: folds 
Uncalled bet ($2.83) returned to MostlyGravy
MostlyGravy collected $1.86 from pot
MostlyGravy: doesn't show hand 
*** SUMMARY ***
Total pot $1.95 | Rake $0.09 
Board [7h Ah Jd Jc Td]
Seat 1: schnu111 folded before Flop (didn't bet)
Seat 2: Mr.KlonkAlot folded on the River
Seat 3: fuzinger (button) folded before Flop (didn't bet)
Seat 4: llosjone (small blind) folded before Flop
Seat 5: MostlyGravy (big blind) collected ($1.86)
Seat 6: Gissbon folded before Flop (didn't bet)



PokerStars Hand #222948451803:  Hold'em No Limit ($0.05/$0.10 USD) - 2021/01/23 4:16:45 ET
Table 'Malzovia III' 6-max Seat #4 is the button
Seat 1: schnu111 ($10 in chips) 
Seat 2: Mr.KlonkAlot ($11.01 in chips) 
Seat 3: fuzinger ($10 in chips) 
Seat 4: llosjone ($9.94 in chips) 
Seat 5: MostlyGravy ($21.35 in chips) 
MostlyGravy: posts small blind $0.05
Gissbon: is sitting out 
schnu111: posts big blind $0.10
*** HOLE CARDS ***
Mr.KlonkAlot: folds 
Gissbon leaves the table
fuzinger: folds 
llosjone: folds 
MostlyGravy: calls $0.05
schnu111: checks 
*** FLOP *** [8s 7h Ah]
MostlyGravy: bets $0.19
schnu111: folds 
Uncalled bet ($0.19) returned to MostlyGravy
MostlyGravy collected $0.19 from pot
MostlyGravy: doesn't show hand 
*** SUMMARY ***
Total pot $0.20 | Rake $0.01 
Board [8s 7h Ah]
Seat 1: schnu111 (big blind) folded on the Flop
Seat 2: Mr.KlonkAlot folded before Flop (didn't bet)
Seat 3: fuzinger folded before Flop (didn't bet)
Seat 4: llosjone (button) folded before Flop (didn't bet)
Seat 5: MostlyGravy (small blind) collected ($0.19)



PokerStars Hand #222948460720:  Hold'em No Limit ($0.05/$0.10 USD) - 2021/01/23 4:17:20 ET
Table 'Malzovia III' 6-max Seat #5 is the button
Seat 1: schnu111 ($10 in chips) 
Seat 2: Mr.KlonkAlot ($11.01 in chips) 
Seat 3: fuzinger ($10 in chips) 
Seat 4: llosjone ($9.94 in chips) 
Seat 5: MostlyGravy ($21.44 in chips) 
schnu111: posts small blind $0.05
Mr.KlonkAlot: posts big blind $0.10
*** HOLE CARDS ***
fuzinger: folds 
llosjone: folds 
MostlyGravy: calls $0.10
schnu111: folds 
Mr.KlonkAlot: checks 
*** FLOP *** [9s 3c 5s]
Mr.KlonkAlot: checks 
MostlyGravy: bets $0.10
negritos81 joins the table at seat #6 
Mr.KlonkAlot: folds 
Uncalled bet ($0.10) returned to MostlyGravy
MostlyGravy collected $0.24 from pot
MostlyGravy: doesn't show hand 
*** SUMMARY ***
Total pot $0.25 | Rake $0.01 
Board [9s 3c 5s]
Seat 1: schnu111 (small blind) folded before Flop
Seat 2: Mr.KlonkAlot (big blind) folded on the Flop
Seat 3: fuzinger folded before Flop (didn't bet)
Seat 4: llosjone folded before Flop (didn't bet)
Seat 5: MostlyGravy (button) collected ($0.24)



PokerStars Hand #222948466301:  Hold'em No Limit ($0.05/$0.10 USD) - 2021/01/23 4:17:41 ET
Table 'Malzovia III' 6-max Seat #1 is the button
Seat 1: schnu111 ($10 in chips) 
Seat 2: Mr.KlonkAlot ($10.91 in chips) 
Seat 3: fuzinger ($10 in chips) 
Seat 4: llosjone ($9.94 in chips) 
Seat 5: MostlyGravy ($21.58 in chips) 
Mr.KlonkAlot: posts small blind $0.05
fuzinger: posts big blind $0.10
negritos81: sits out 
*** HOLE CARDS ***
llosjone: folds 
MostlyGravy: folds 
schnu111: folds 
Mr.KlonkAlot: raises $0.20 to $0.30
fuzinger: folds 
Uncalled bet ($0.20) returned to Mr.KlonkAlot
Mr.KlonkAlot collected $0.20 from pot
Mr.KlonkAlot: doesn't show hand 
*** SUMMARY ***
Total pot $0.20 | Rake $0 
Seat 1: schnu111 (button) folded before Flop (didn't bet)
Seat 2: Mr.KlonkAlot (small blind) collected ($0.20)
Seat 3: fuzinger (big blind) folded before Flop
Seat 4: llosjone folded before Flop (didn't bet)
Seat 5: MostlyGravy folded before Flop (didn't bet)



PokerStars Hand #222948470548:  Hold'em No Limit ($0.05/$0.10 USD) - 2021/01/23 4:17:57 ET
Table 'Malzovia III' 6-max Seat #2 is the button
Seat 1: schnu111 ($10 in chips) 
Seat 2: Mr.KlonkAlot ($11.01 in chips) 
Seat 3: fuzinger ($10 in chips) 
Seat 4: llosjone ($9.94 in chips) 
Seat 5: MostlyGravy ($21.58 in chips) 
fuzinger: posts small blind $0.05
llosjone: posts big blind $0.10
negritos81: sits out 
*** HOLE CARDS ***
MostlyGravy has timed out
MostlyGravy: folds 
schnu111: folds 
Mr.KlonkAlot: folds 
fuzinger: raises $0.20 to $0.30
llosjone: folds 
Uncalled bet ($0.20) returned to fuzinger
fuzinger collected $0.20 from pot
fuzinger: doesn't show hand 
*** SUMMARY ***
Total pot $0.20 | Rake $0 
Seat 1: schnu111 folded before Flop (didn't bet)
Seat 2: Mr.KlonkAlot (button) folded before Flop (didn't bet)
Seat 3: fuzinger (small blind) collected ($0.20)
Seat 4: llosjone (big blind) folded before Flop
Seat 5: MostlyGravy folded before Flop (didn't bet)



PokerStars Hand #222948477029:  Hold'em No Limit ($0.05/$0.10 USD) - 2021/01/23 4:18:22 ET
Table 'Malzovia III' 6-max Seat #3 is the button
Seat 1: schnu111 ($10 in chips) 
Seat 2: Mr.KlonkAlot ($11.01 in chips) 
Seat 3: fuzinger ($10.10 in chips) 
Seat 4: llosjone ($9.84 in chips) 
Seat 5: MostlyGravy ($21.58 in chips) 
llosjone: posts small blind $0.05
MostlyGravy: posts big blind $0.10
negritos81: sits out 
*** HOLE CARDS ***
schnu111: folds 
Mr.KlonkAlot: raises $0.30 to $0.40
fuzinger: folds 
llosjone: folds 
MostlyGravy: calls $0.30
*** FLOP *** [Qh 7c 2h]
MostlyGravy: checks 
Mr.KlonkAlot: bets $0.61
MostlyGravy: raises $1.02 to $1.63
Mr.KlonkAlot: folds 
Uncalled bet ($1.02) returned to MostlyGravy
MostlyGravy collected $1.98 from pot
MostlyGravy: doesn't show hand 
*** SUMMARY ***
Total pot $2.07 | Rake $0.09 
Board [Qh 7c 2h]
Seat 1: schnu111 folded before Flop (didn't bet)
Seat 2: Mr.KlonkAlot folded on the Flop
Seat 3: fuzinger (button) folded before Flop (didn't bet)
Seat 4: llosjone (small blind) folded before Flop
Seat 5: MostlyGravy (big blind) collected ($1.98)



PokerStars Hand #222948485720:  Hold'em No Limit ($0.05/$0.10 USD) - 2021/01/23 4:18:55 ET
Table 'Malzovia III' 6-max Seat #4 is the button
Seat 1: schnu111 ($10 in chips) 
Seat 2: Mr.KlonkAlot ($10 in chips) 
Seat 3: fuzinger ($10.10 in chips) 
Seat 4: llosjone ($9.79 in chips) 
Seat 5: MostlyGravy ($22.55 in chips) 
Seat 6: negritos81 ($10 in chips) 
MostlyGravy: posts small blind $0.05
negritos81: posts big blind $0.10
*** HOLE CARDS ***
schnu111: folds 
Mr.KlonkAlot: raises $0.30 to $0.40
fuzinger: folds 
llosjone: calls $0.40
MostlyGravy: folds 
negritos81: folds 
*** FLOP *** [As 4h Ks]
Mr.KlonkAlot: bets $0.68
llosjone: folds 
Uncalled bet ($0.68) returned to Mr.KlonkAlot
Mr.KlonkAlot collected $0.91 from pot
Mr.KlonkAlot: doesn't show hand 
*** SUMMARY ***
Total pot $0.95 | Rake $0.04 
Board [As 4h Ks]
Seat 1: schnu111 folded before Flop (didn't bet)
Seat 2: Mr.KlonkAlot collected ($0.91)
Seat 3: fuzinger folded before Flop (didn't bet)
Seat 4: llosjone (button) folded on the Flop
Seat 5: MostlyGravy (small blind) folded before Flop
Seat 6: negritos81 (big blind) folded before Flop



PokerStars Hand #222948492929:  Hold'em No Limit ($0.05/$0.10 USD) - 2021/01/23 4:19:22 ET
Table 'Malzovia III' 6-max Seat #5 is the button
Seat 1: schnu111 ($10 in chips) 
Seat 2: Mr.KlonkAlot ($10.51 in chips) 
Seat 3: fuzinger ($10.10 in chips) 
Seat 4: llosjone ($9.39 in chips) 
Seat 5: MostlyGravy ($22.50 in chips) 
Seat 6: negritos81 ($10 in chips) 
negritos81: posts small blind $0.05
schnu111: posts big blind $0.10
*** HOLE CARDS ***
Mr.KlonkAlot: raises $0.30 to $0.40
fuzinger: folds 
llosjone: folds 
MostlyGravy: calls $0.40
negritos81: folds 
schnu111: folds 
*** FLOP *** [7c 8c Qh]
Mr.KlonkAlot: checks 
MostlyGravy: bets $1.31
Mr.KlonkAlot: folds 
Uncalled bet ($1.31) returned to MostlyGravy
MostlyGravy collected $0.91 from pot
MostlyGravy: doesn't show hand 
*** SUMMARY ***
Total pot $0.95 | Rake $0.04 
Board [7c 8c Qh]
Seat 1: schnu111 (big blind) folded before Flop
Seat 2: Mr.KlonkAlot folded on the Flop
Seat 3: fuzinger folded before Flop (didn't bet)
Seat 4: llosjone folded before Flop (didn't bet)
Seat 5: MostlyGravy (button) collected ($0.91)
Seat 6: negritos81 (small blind) folded before Flop



PokerStars Hand #222948503585:  Hold'em No Limit ($0.05/$0.10 USD) - 2021/01/23 4:20:03 ET
Table 'Malzovia III' 6-max Seat #6 is the button
Seat 1: schnu111 ($10 in chips) 
Seat 2: Mr.KlonkAlot ($10.11 in chips) 
Seat 3: fuzinger ($10.10 in chips) 
Seat 4: llosjone ($10 in chips) 
Seat 5: MostlyGravy ($23.01 in chips) 
Seat 6: negritos81 ($10 in chips) 
schnu111: posts small blind $0.05
Mr.KlonkAlot: posts big blind $0.10
*** HOLE CARDS ***
fuzinger: raises $0.25 to $0.35
llosjone: folds 
MostlyGravy: raises $0.25 to $0.60
negritos81: raises $1.20 to $1.80
schnu111: folds 
Mr.KlonkAlot: folds 
fuzinger: folds 
MostlyGravy: calls $1.20
*** FLOP *** [Ks 4h Jh]
MostlyGravy: checks 
negritos81: bets $1.29
MostlyGravy: folds 
Uncalled bet ($1.29) returned to negritos81
negritos81 collected $3.92 from pot
negritos81: doesn't show hand 
*** SUMMARY ***
Total pot $4.10 | Rake $0.18 
Board [Ks 4h Jh]
Seat 1: schnu111 (small blind) folded before Flop
Seat 2: Mr.KlonkAlot (big blind) folded before Flop
Seat 3: fuzinger folded before Flop
Seat 4: llosjone folded before Flop (didn't bet)
Seat 5: MostlyGravy folded on the Flop
Seat 6: negritos81 (button) collected ($3.92)



PokerStars Hand #222948522539:  Hold'em No Limit ($0.05/$0.10 USD) - 2021/01/23 4:21:14 ET
Table 'Malzovia III' 6-max Seat #1 is the button
Seat 1: schnu111 ($10 in chips) 
Seat 2: Mr.KlonkAlot ($10.01 in chips) 
Seat 3: fuzinger ($10 in chips) 
Seat 4: llosjone ($10 in chips) 
Seat 5: MostlyGravy ($21.21 in chips) 
Seat 6: negritos81 ($12.12 in chips) 
Mr.KlonkAlot: posts small blind $0.05
fuzinger: posts big blind $0.10
*** HOLE CARDS ***
llosjone: raises $0.15 to $0.25
MostlyGravy: folds 
negritos81: folds 
schnu111: folds 
Mr.KlonkAlot: calls $0.20
fuzinger: folds 
*** FLOP *** [3c 3d 4h]
Mr.KlonkAlot: checks 
llosjone: bets $0.25
Mr.KlonkAlot: folds 
Uncalled bet ($0.25) returned to llosjone
llosjone collected $0.57 from pot
llosjone: doesn't show hand 
*** SUMMARY ***
Total pot $0.60 | Rake $0.03 
Board [3c 3d 4h]
Seat 1: schnu111 (button) folded before Flop (didn't bet)
Seat 2: Mr.KlonkAlot (small blind) folded on the Flop
Seat 3: fuzinger (big blind) folded before Flop
Seat 4: llosjone collected ($0.57)
Seat 5: MostlyGravy folded before Flop (didn't bet)
Seat 6: negritos81 folded before Flop (didn't bet)



PokerStars Hand #222948528569:  Hold'em No Limit ($0.05/$0.10 USD) - 2021/01/23 4:21:37 ET
Table 'Malzovia III' 6-max Seat #2 is the button
Seat 1: schnu111 ($10 in chips) 
Seat 2: Mr.KlonkAlot ($9.76 in chips) 
Seat 3: fuzinger ($10 in chips) 
Seat 4: llosjone ($10.32 in chips) 
Seat 5: MostlyGravy ($21.21 in chips) 
Seat 6: negritos81 ($12.12 in chips) 
fuzinger: posts small blind $0.05
llosjone: posts big blind $0.10
*** HOLE CARDS ***
MostlyGravy: raises $0.10 to $0.20
negritos81: folds 
schnu111: folds 
Mr.KlonkAlot: calls $0.20
fuzinger: folds 
llosjone: folds 
*** FLOP *** [Jh 7c Qc]
MostlyGravy: checks 
Mr.KlonkAlot: checks 
*** TURN *** [Jh 7c Qc] [Jc]
MostlyGravy: bets $0.26
Mr.KlonkAlot: folds 
Uncalled bet ($0.26) returned to MostlyGravy
MostlyGravy collected $0.53 from pot
MostlyGravy: doesn't show hand 
*** SUMMARY ***
Total pot $0.55 | Rake $0.02 
Board [Jh 7c Qc Jc]
Seat 1: schnu111 folded before Flop (didn't bet)
Seat 2: Mr.KlonkAlot (button) folded on the Turn
Seat 3: fuzinger (small blind) folded before Flop
Seat 4: llosjone (big blind) folded before Flop
Seat 5: MostlyGravy collected ($0.53)
Seat 6: negritos81 folded before Flop (didn't bet)



PokerStars Hand #222948537554:  Hold'em No Limit ($0.05/$0.10 USD) - 2021/01/23 4:22:12 ET
Table 'Malzovia III' 6-max Seat #3 is the button
Seat 1: schnu111 ($10 in chips) 
Seat 2: Mr.KlonkAlot ($9.56 in chips) 
Seat 3: fuzinger ($10 in chips) 
Seat 4: llosjone ($10.22 in chips) 
Seat 5: MostlyGravy ($21.54 in chips) 
Seat 6: negritos81 ($12.12 in chips) 
llosjone: posts small blind $0.05
MostlyGravy: posts big blind $0.10
*** HOLE CARDS ***
negritos81: folds 
schnu111: raises $0.20 to $0.30
Mr.KlonkAlot: folds 
fuzinger: folds 
llosjone: folds 
MostlyGravy: calls $0.20
*** FLOP *** [9s 3h 2c]
MostlyGravy: bets $0.41
schnu111: raises $0.96 to $1.37
MostlyGravy: folds 
Uncalled bet ($0.96) returned to schnu111
schnu111 collected $1.40 from pot
schnu111: doesn't show hand 
*** SUMMARY ***
Total pot $1.47 | Rake $0.07 
Board [9s 3h 2c]
Seat 1: schnu111 collected ($1.40)
Seat 2: Mr.KlonkAlot folded before Flop (didn't bet)
Seat 3: fuzinger (button) folded before Flop (didn't bet)
Seat 4: llosjone (small blind) folded before Flop
Seat 5: MostlyGravy (big blind) folded on the Flop
Seat 6: negritos81 folded before Flop (didn't bet)



PokerStars Hand #222948551257:  Hold'em No Limit ($0.05/$0.10 USD) - 2021/01/23 4:23:04 ET
Table 'Malzovia III' 6-max Seat #4 is the button
Seat 1: schnu111 ($10.69 in chips) 
Seat 2: Mr.KlonkAlot ($9.56 in chips) 
Seat 3: fuzinger ($10 in chips) 
Seat 4: llosjone ($10.17 in chips) 
Seat 5: MostlyGravy ($20.83 in chips) 
Seat 6: negritos81 ($12.12 in chips) 
MostlyGravy: posts small blind $0.05
negritos81: posts big blind $0.10
*** HOLE CARDS ***
schnu111: folds 
Mr.KlonkAlot: folds 
fuzinger: folds 
llosjone: folds 
MostlyGravy: calls $0.05
negritos81: checks 
*** FLOP *** [5s 9s 3d]
MostlyGravy: checks 
negritos81: checks 
*** TURN *** [5s 9s 3d] [Kd]
MostlyGravy: bets $0.30
negritos81: folds 
Uncalled bet ($0.30) returned to MostlyGravy
MostlyGravy collected $0.19 from pot
MostlyGravy: doesn't show hand 
*** SUMMARY ***
Total pot $0.20 | Rake $0.01 
Board [5s 9s 3d Kd]
Seat 1: schnu111 folded before Flop (didn't bet)
Seat 2: Mr.KlonkAlot folded before Flop (didn't bet)
Seat 3: fuzinger folded before Flop (didn't bet)
Seat 4: llosjone (button) folded before Flop (didn't bet)
Seat 5: MostlyGravy (small blind) collected ($0.19)
Seat 6: negritos81 (big blind) folded on the Turn



PokerStars Hand #222948565538:  Hold'em No Limit ($0.05/$0.10 USD) - 2021/01/23 4:23:58 ET
Table 'Malzovia III' 6-max Seat #5 is the button
Seat 1: schnu111 ($10.69 in chips) 
Seat 2: Mr.KlonkAlot ($9.56 in chips) 
Seat 3: fuzinger ($10 in chips) 
Seat 4: llosjone ($10.17 in chips) 
Seat 5: MostlyGravy ($20.92 in chips) 
Seat 6: negritos81 ($12.02 in chips) 
negritos81: posts small blind $0.05
schnu111: posts big blind $0.10
*** HOLE CARDS ***
Mr.KlonkAlot: folds 
fuzinger: folds 
llosjone: raises $0.15 to $0.25
MostlyGravy: folds 
negritos81: folds 
schnu111: folds 
Uncalled bet ($0.15) returned to llosjone
llosjone collected $0.25 from pot
llosjone: doesn't show hand 
*** SUMMARY ***
Total pot $0.25 | Rake $0 
Seat 1: schnu111 (big blind) folded before Flop
Seat 2: Mr.KlonkAlot folded before Flop (didn't bet)
Seat 3: fuzinger folded before Flop (didn't bet)
Seat 4: llosjone collected ($0.25)
Seat 5: MostlyGravy (button) folded before Flop (didn't bet)
Seat 6: negritos81 (small blind) folded before Flop



PokerStars Hand #222948570029:  Hold'em No Limit ($0.05/$0.10 USD) - 2021/01/23 4:24:15 ET
Table 'Malzovia III' 6-max Seat #6 is the button
Seat 1: schnu111 ($10.59 in chips) 
Seat 2: Mr.KlonkAlot ($9.56 in chips) 
Seat 3: fuzinger ($10 in chips) 
Seat 4: llosjone ($10.32 in chips) 
Seat 5: MostlyGravy ($20.92 in chips) 
Seat 6: negritos81 ($11.97 in chips) 
schnu111: posts small blind $0.05
Mr.KlonkAlot: posts big blind $0.10
*** HOLE CARDS ***
fuzinger: folds 
llosjone: folds 
MostlyGravy: raises $0.20 to $0.30
negritos81: folds 
schnu111: folds 
Mr.KlonkAlot: raises $0.60 to $0.90
MostlyGravy: calls $0.60
*** FLOP *** [9h 3d 5s]
Mr.KlonkAlot: bets $1.33
MostlyGravy: folds 
Uncalled bet ($1.33) returned to Mr.KlonkAlot
Mr.KlonkAlot collected $1.77 from pot
Mr.KlonkAlot: doesn't show hand 
*** SUMMARY ***
Total pot $1.85 | Rake $0.08 
Board [9h 3d 5s]
Seat 1: schnu111 (small blind) folded before Flop
Seat 2: Mr.KlonkAlot (big blind) collected ($1.77)
Seat 3: fuzinger folded before Flop (didn't bet)
Seat 4: llosjone folded before Flop (didn't bet)
Seat 5: MostlyGravy folded on the Flop
Seat 6: negritos81 (button) folded before Flop (didn't bet)



PokerStars Hand #222948582337:  Hold'em No Limit ($0.05/$0.10 USD) - 2021/01/23 4:25:02 ET
Table 'Malzovia III' 6-max Seat #1 is the button
Seat 1: schnu111 ($10.54 in chips) 
Seat 2: Mr.KlonkAlot ($10.43 in chips) 
Seat 3: fuzinger ($10 in chips) 
Seat 4: llosjone ($10.32 in chips) 
Seat 5: MostlyGravy ($20.02 in chips) 
Seat 6: negritos81 ($11.97 in chips) 
Mr.KlonkAlot: posts small blind $0.05
fuzinger: posts big blind $0.10
*** HOLE CARDS ***
llosjone: folds 
MostlyGravy: folds 
negritos81: folds 
schnu111: folds 
Mr.KlonkAlot: raises $0.20 to $0.30
fuzinger: folds 
Uncalled bet ($0.20) returned to Mr.KlonkAlot
Mr.KlonkAlot collected $0.20 from pot
Mr.KlonkAlot: doesn't show hand 
*** SUMMARY ***
Total pot $0.20 | Rake $0 
Seat 1: schnu111 (button) folded before Flop (didn't bet)
Seat 2: Mr.KlonkAlot (small blind) collected ($0.20)
Seat 3: fuzinger (big blind) folded before Flop
Seat 4: llosjone folded before Flop (didn't bet)
Seat 5: MostlyGravy folded before Flop (didn't bet)
Seat 6: negritos81 folded before Flop (didn't bet)



PokerStars Hand #222948587373:  Hold'em No Limit ($0.05/$0.10 USD) - 2021/01/23 4:25:21 ET
Table 'Malzovia III' 6-max Seat #2 is the button
Seat 1: schnu111 ($10.54 in chips) 
Seat 2: Mr.KlonkAlot ($10.53 in chips) 
Seat 3: fuzinger ($10 in chips) 
Seat 4: llosjone ($10.32 in chips) 
Seat 5: MostlyGravy ($20.02 in chips) 
Seat 6: negritos81 ($11.97 in chips) 
fuzinger: posts small blind $0.05
llosjone: posts big blind $0.10
*** HOLE CARDS ***
MostlyGravy: calls $0.10
negritos81: folds 
schnu111: raises $0.30 to $0.40
Mr.KlonkAlot: folds 
fuzinger: folds 
llosjone: folds 
MostlyGravy: calls $0.30
*** FLOP *** [As 2c 3d]
MostlyGravy: checks 
schnu111: checks 
*** TURN *** [As 2c 3d] [7d]
MostlyGravy: bets $0.45
schnu111: folds 
Uncalled bet ($0.45) returned to MostlyGravy
MostlyGravy collected $0.91 from pot
MostlyGravy: doesn't show hand 
*** SUMMARY ***
Total pot $0.95 | Rake $0.04 
Board [As 2c 3d 7d]
Seat 1: schnu111 folded on the Turn
Seat 2: Mr.KlonkAlot (button) folded before Flop (didn't bet)
Seat 3: fuzinger (small blind) folded before Flop
Seat 4: llosjone (big blind) folded before Flop
Seat 5: MostlyGravy collected ($0.91)
Seat 6: negritos81 folded before Flop (didn't bet)



PokerStars Hand #222948599791:  Hold'em No Limit ($0.05/$0.10 USD) - 2021/01/23 4:26:09 ET
Table 'Malzovia III' 6-max Seat #3 is the button
Seat 1: schnu111 ($10.14 in chips) 
Seat 2: Mr.KlonkAlot ($10.53 in chips) 
Seat 3: fuzinger ($10 in chips) 
Seat 4: llosjone ($10.22 in chips) 
Seat 5: MostlyGravy ($20.53 in chips) 
Seat 6: negritos81 ($11.97 in chips) 
llosjone: posts small blind $0.05
MostlyGravy: posts big blind $0.10
*** HOLE CARDS ***
negritos81: folds 
schnu111: raises $0.20 to $0.30
Mr.KlonkAlot: folds 
fuzinger: folds 
llosjone: folds 
MostlyGravy: calls $0.20
*** FLOP *** [Ah 6s 3h]
MostlyGravy: bets $0.31
schnu111: folds 
Uncalled bet ($0.31) returned to MostlyGravy
MostlyGravy collected $0.62 from pot
MostlyGravy: doesn't show hand 
*** SUMMARY ***
Total pot $0.65 | Rake $0.03 
Board [Ah 6s 3h]
Seat 1: schnu111 folded on the Flop
Seat 2: Mr.KlonkAlot folded before Flop (didn't bet)
Seat 3: fuzinger (button) folded before Flop (didn't bet)
Seat 4: llosjone (small blind) folded before Flop
Seat 5: MostlyGravy (big blind) collected ($0.62)
Seat 6: negritos81 folded before Flop (didn't bet)



PokerStars Hand #222948608311:  Hold'em No Limit ($0.05/$0.10 USD) - 2021/01/23 4:26:42 ET
Table 'Malzovia III' 6-max Seat #4 is the button
Seat 1: schnu111 ($10 in chips) 
Seat 2: Mr.KlonkAlot ($10.53 in chips) 
Seat 3: fuzinger ($10 in chips) 
Seat 4: llosjone ($10.17 in chips) 
Seat 5: MostlyGravy ($20.85 in chips) 
Seat 6: negritos81 ($11.97 in chips) 
MostlyGravy: posts small blind $0.05
negritos81: posts big blind $0.10
*** HOLE CARDS ***
schnu111: folds 
Mr.KlonkAlot: folds 
fuzinger: folds 
llosjone: folds 
MostlyGravy: raises $0.20 to $0.30
negritos81: folds 
Uncalled bet ($0.20) returned to MostlyGravy
MostlyGravy collected $0.20 from pot
MostlyGravy: doesn't show hand 
*** SUMMARY ***
Total pot $0.20 | Rake $0 
Seat 1: schnu111 folded before Flop (didn't bet)
Seat 2: Mr.KlonkAlot folded before Flop (didn't bet)
Seat 3: fuzinger folded before Flop (didn't bet)
Seat 4: llosjone (button) folded before Flop (didn't bet)
Seat 5: MostlyGravy (small blind) collected ($0.20)
Seat 6: negritos81 (big blind) folded before Flop



PokerStars Hand #222948612651:  Hold'em No Limit ($0.05/$0.10 USD) - 2021/01/23 4:26:58 ET
Table 'Malzovia III' 6-max Seat #5 is the button
Seat 1: schnu111 ($10 in chips) 
Seat 2: Mr.KlonkAlot ($10.53 in chips) 
Seat 3: fuzinger ($10 in chips) 
Seat 4: llosjone ($10.17 in chips) 
Seat 5: MostlyGravy ($20.95 in chips) 
Seat 6: negritos81 ($11.87 in chips) 
negritos81: posts small blind $0.05
schnu111: posts big blind $0.10
*** HOLE CARDS ***
Mr.KlonkAlot: folds 
fuzinger: folds 
llosjone: folds 
MostlyGravy: raises $0.10 to $0.20
negritos81: folds 
schnu111: calls $0.10
*** FLOP *** [Qs Ac 6h]
schnu111: checks 
MostlyGravy: bets $0.31
schnu111: calls $0.31
*** TURN *** [Qs Ac 6h] [4s]
schnu111: checks 
MostlyGravy: checks 
*** RIVER *** [Qs Ac 6h 4s] [Ah]
schnu111: checks 
MostlyGravy: bets $0.60
schnu111: folds 
Uncalled bet ($0.60) returned to MostlyGravy
MostlyGravy collected $1.02 from pot
MostlyGravy: doesn't show hand 
*** SUMMARY ***
Total pot $1.07 | Rake $0.05 
Board [Qs Ac 6h 4s Ah]
Seat 1: schnu111 (big blind) folded on the River
Seat 2: Mr.KlonkAlot folded before Flop (didn't bet)
Seat 3: fuzinger folded before Flop (didn't bet)
Seat 4: llosjone folded before Flop (didn't bet)
Seat 5: MostlyGravy (button) collected ($1.02)
Seat 6: negritos81 (small blind) folded before Flop



PokerStars Hand #222948626932:  Hold'em No Limit ($0.05/$0.10 USD) - 2021/01/23 4:27:53 ET
Table 'Malzovia III' 6-max Seat #6 is the button
Seat 1: schnu111 ($10 in chips) 
Seat 2: Mr.KlonkAlot ($10.53 in chips) 
Seat 3: fuzinger ($10 in chips) 
Seat 4: llosjone ($10.17 in chips) 
Seat 5: MostlyGravy ($21.46 in chips) 
Seat 6: negritos81 ($11.82 in chips) 
schnu111: posts small blind $0.05
Mr.KlonkAlot: posts big blind $0.10
*** HOLE CARDS ***
fuzinger: raises $0.25 to $0.35
llosjone: folds 
MostlyGravy: folds 
negritos81: folds 
schnu111: folds 
Mr.KlonkAlot: folds 
Uncalled bet ($0.25) returned to fuzinger
fuzinger collected $0.25 from pot
fuzinger: doesn't show hand 
*** SUMMARY ***
Total pot $0.25 | Rake $0 
Seat 1: schnu111 (small blind) folded before Flop
Seat 2: Mr.KlonkAlot (big blind) folded before Flop
Seat 3: fuzinger collected ($0.25)
Seat 4: llosjone folded before Flop (didn't bet)
Seat 5: MostlyGravy folded before Flop (didn't bet)
Seat 6: negritos81 (button) folded before Flop (didn't bet)



PokerStars Hand #222948631275:  Hold'em No Limit ($0.05/$0.10 USD) - 2021/01/23 4:28:09 ET
Table 'Malzovia III' 6-max Seat #1 is the button
Seat 1: schnu111 ($10 in chips) 
Seat 2: Mr.KlonkAlot ($10.43 in chips) 
Seat 3: fuzinger ($10.15 in chips) 
Seat 4: llosjone ($10.17 in chips) 
Seat 5: MostlyGravy ($21.46 in chips) 
Seat 6: negritos81 ($11.82 in chips) 
Mr.KlonkAlot: posts small blind $0.05
fuzinger: posts big blind $0.10
*** HOLE CARDS ***
llosjone: folds 
MostlyGravy: folds 
negritos81: folds 
schnu111: raises $0.15 to $0.25
Mr.KlonkAlot: folds 
fuzinger: calls $0.15
*** FLOP *** [2c 2d Td]
fuzinger: bets $0.35
schnu111: folds 
Uncalled bet ($0.35) returned to fuzinger
fuzinger collected $0.53 from pot
fuzinger: doesn't show hand 
*** SUMMARY ***
Total pot $0.55 | Rake $0.02 
Board [2c 2d Td]
Seat 1: schnu111 (button) folded on the Flop
Seat 2: Mr.KlonkAlot (small blind) folded before Flop
Seat 3: fuzinger (big blind) collected ($0.53)
Seat 4: llosjone folded before Flop (didn't bet)
Seat 5: MostlyGravy folded before Flop (didn't bet)
Seat 6: negritos81 folded before Flop (didn't bet)



PokerStars Hand #222948641280:  Hold'em No Limit ($0.05/$0.10 USD) - 2021/01/23 4:28:47 ET
Table 'Malzovia III' 6-max Seat #2 is the button
Seat 1: schnu111 ($10 in chips) 
Seat 2: Mr.KlonkAlot ($10.38 in chips) 
Seat 3: fuzinger ($10.43 in chips) 
Seat 4: llosjone ($10.17 in chips) 
Seat 5: MostlyGravy ($21.46 in chips) 
Seat 6: negritos81 ($11.82 in chips) 
fuzinger: posts small blind $0.05
llosjone: posts big blind $0.10
*** HOLE CARDS ***
MostlyGravy: calls $0.10
negritos81: folds 
schnu111: folds 
Mr.KlonkAlot: calls $0.10
fuzinger: folds 
llosjone: raises $0.15 to $0.25
MostlyGravy: calls $0.15
Mr.KlonkAlot: folds 
*** FLOP *** [6s Js 8s]
llosjone: checks 
MostlyGravy: bets $0.31
llosjone: folds 
Uncalled bet ($0.31) returned to MostlyGravy
MostlyGravy collected $0.62 from pot
MostlyGravy: doesn't show hand 
*** SUMMARY ***
Total pot $0.65 | Rake $0.03 
Board [6s Js 8s]
Seat 1: schnu111 folded before Flop (didn't bet)
Seat 2: Mr.KlonkAlot (button) folded before Flop
Seat 3: fuzinger (small blind) folded before Flop
Seat 4: llosjone (big blind) folded on the Flop
Seat 5: MostlyGravy collected ($0.62)
Seat 6: negritos81 folded before Flop (didn't bet)



PokerStars Hand #222948652588:  Hold'em No Limit ($0.05/$0.10 USD) - 2021/01/23 4:29:30 ET
Table 'Malzovia III' 6-max Seat #3 is the button
Seat 1: schnu111 ($10 in chips) 
Seat 2: Mr.KlonkAlot ($10.28 in chips) 
Seat 3: fuzinger ($10.38 in chips) 
Seat 4: llosjone ($9.92 in chips) 
Seat 5: MostlyGravy ($21.83 in chips) 
Seat 6: negritos81 ($11.82 in chips) 
llosjone: posts small blind $0.05
MostlyGravy: posts big blind $0.10
*** HOLE CARDS ***
negritos81: folds 
schnu111: folds 
Mr.KlonkAlot: folds 
fuzinger: folds 
llosjone: folds 
Uncalled bet ($0.05) returned to MostlyGravy
MostlyGravy collected $0.10 from pot
MostlyGravy: doesn't show hand 
*** SUMMARY ***
Total pot $0.10 | Rake $0 
Seat 1: schnu111 folded before Flop (didn't bet)
Seat 2: Mr.KlonkAlot folded before Flop (didn't bet)
Seat 3: fuzinger (button) folded before Flop (didn't bet)
Seat 4: llosjone (small blind) folded before Flop
Seat 5: MostlyGravy (big blind) collected ($0.10)
Seat 6: negritos81 folded before Flop (didn't bet)



PokerStars Hand #222948655607:  Hold'em No Limit ($0.05/$0.10 USD) - 2021/01/23 4:29:41 ET
Table 'Malzovia III' 6-max Seat #4 is the button
Seat 1: schnu111 ($10 in chips) 
Seat 2: Mr.KlonkAlot ($10.28 in chips) 
Seat 3: fuzinger ($10.38 in chips) 
Seat 4: llosjone ($9.87 in chips) 
Seat 5: MostlyGravy ($21.88 in chips) 
Seat 6: negritos81 ($11.82 in chips) 
MostlyGravy: posts small blind $0.05
negritos81: posts big blind $0.10
*** HOLE CARDS ***
schnu111: folds 
Mr.KlonkAlot: folds 
fuzinger: raises $0.25 to $0.35
llosjone: folds 
MostlyGravy: folds 
negritos81: raises $0.85 to $1.20
fuzinger: folds 
Uncalled bet ($0.85) returned to negritos81
negritos81 collected $0.75 from pot
negritos81: doesn't show hand 
*** SUMMARY ***
Total pot $0.75 | Rake $0 
Seat 1: schnu111 folded before Flop (didn't bet)
Seat 2: Mr.KlonkAlot folded before Flop (didn't bet)
Seat 3: fuzinger folded before Flop
Seat 4: llosjone (button) folded before Flop (didn't bet)
Seat 5: MostlyGravy (small blind) folded before Flop
Seat 6: negritos81 (big blind) collected ($0.75)



PokerStars Hand #222948662408:  Hold'em No Limit ($0.05/$0.10 USD) - 2021/01/23 4:30:06 ET
Table 'Malzovia III' 6-max Seat #5 is the button
Seat 1: schnu111 ($10 in chips) 
Seat 2: Mr.KlonkAlot ($10.28 in chips) 
Seat 3: fuzinger ($10.03 in chips) 
Seat 4: llosjone ($9.87 in chips) 
Seat 5: MostlyGravy ($21.83 in chips) 
Seat 6: negritos81 ($12.22 in chips) 
negritos81: posts small blind $0.05
schnu111: posts big blind $0.10
*** HOLE CARDS ***
Mr.KlonkAlot: raises $0.30 to $0.40
fuzinger: folds 
llosjone: folds 
MostlyGravy: folds 
negritos81: folds 
schnu111: folds 
Uncalled bet ($0.30) returned to Mr.KlonkAlot
Mr.KlonkAlot collected $0.25 from pot
Mr.KlonkAlot: doesn't show hand 
*** SUMMARY ***
Total pot $0.25 | Rake $0 
Seat 1: schnu111 (big blind) folded before Flop
Seat 2: Mr.KlonkAlot collected ($0.25)
Seat 3: fuzinger folded before Flop (didn't bet)
Seat 4: llosjone folded before Flop (didn't bet)
Seat 5: MostlyGravy (button) folded before Flop (didn't bet)
Seat 6: negritos81 (small blind) folded before Flop



PokerStars Hand #222948669325:  Hold'em No Limit ($0.05/$0.10 USD) - 2021/01/23 4:30:32 ET
Table 'Malzovia III' 6-max Seat #6 is the button
Seat 1: schnu111 ($10 in chips) 
Seat 2: Mr.KlonkAlot ($10.43 in chips) 
Seat 3: fuzinger ($10.03 in chips) 
Seat 4: llosjone ($9.87 in chips) 
Seat 5: MostlyGravy ($21.83 in chips) 
Seat 6: negritos81 ($12.17 in chips) 
schnu111: posts small blind $0.05
Mr.KlonkAlot: posts big blind $0.10
*** HOLE CARDS ***
fuzinger: folds 
llosjone: raises $0.15 to $0.25
MostlyGravy: folds 
negritos81: folds 
schnu111: folds 
Mr.KlonkAlot: folds 
Uncalled bet ($0.15) returned to llosjone
llosjone collected $0.25 from pot
llosjone: doesn't show hand 
*** SUMMARY ***
Total pot $0.25 | Rake $0 
Seat 1: schnu111 (small blind) folded before Flop
Seat 2: Mr.KlonkAlot (big blind) folded before Flop
Seat 3: fuzinger folded before Flop (didn't bet)
Seat 4: llosjone collected ($0.25)
Seat 5: MostlyGravy folded before Flop (didn't bet)
Seat 6: negritos81 (button) folded before Flop (didn't bet)



PokerStars Hand #222948674692:  Hold'em No Limit ($0.05/$0.10 USD) - 2021/01/23 4:30:52 ET
Table 'Malzovia III' 6-max Seat #1 is the button
Seat 1: schnu111 ($10 in chips) 
Seat 2: Mr.KlonkAlot ($10.33 in chips) 
Seat 3: fuzinger ($10.03 in chips) 
Seat 4: llosjone ($10.02 in chips) 
Seat 5: MostlyGravy ($21.83 in chips) 
Seat 6: negritos81 ($12.17 in chips) 
Mr.KlonkAlot: posts small blind $0.05
fuzinger: posts big blind $0.10
*** HOLE CARDS ***
llosjone: folds 
MostlyGravy: raises $0.30 to $0.40
negritos81: folds 
schnu111: calls $0.40
Mr.KlonkAlot: raises $0.80 to $1.20
fuzinger: folds 
MostlyGravy: calls $0.80
schnu111: calls $0.80
*** FLOP *** [3h Qh Kd]
Mr.KlonkAlot: checks 
MostlyGravy: bets $1.76
schnu111: folds 
Mr.KlonkAlot: folds 
Uncalled bet ($1.76) returned to MostlyGravy
MostlyGravy collected $3.53 from pot
MostlyGravy: doesn't show hand 
*** SUMMARY ***
Total pot $3.70 | Rake $0.17 
Board [3h Qh Kd]
Seat 1: schnu111 (button) folded on the Flop
Seat 2: Mr.KlonkAlot (small blind) folded on the Flop
Seat 3: fuzinger (big blind) folded before Flop
Seat 4: llosjone folded before Flop (didn't bet)
Seat 5: MostlyGravy collected ($3.53)
Seat 6: negritos81 folded before Flop (didn't bet)



PokerStars Hand #222948690637:  Hold'em No Limit ($0.05/$0.10 USD) - 2021/01/23 4:31:52 ET
Table 'Malzovia III' 6-max Seat #2 is the button
Seat 1: schnu111 ($10 in chips) 
Seat 2: Mr.KlonkAlot ($9.13 in chips) 
Seat 3: fuzinger ($10 in chips) 
Seat 4: llosjone ($10.02 in chips) 
Seat 5: MostlyGravy ($24.16 in chips) 
Seat 6: negritos81 ($12.17 in chips) 
fuzinger: posts small blind $0.05
llosjone: posts big blind $0.10
*** HOLE CARDS ***
MostlyGravy: raises $0.40 to $0.50
negritos81: folds 
schnu111: folds 
Mr.KlonkAlot: folds 
fuzinger: folds 
llosjone: folds 
Uncalled bet ($0.40) returned to MostlyGravy
MostlyGravy collected $0.25 from pot
MostlyGravy: doesn't show hand 
*** SUMMARY ***
Total pot $0.25 | Rake $0 
Seat 1: schnu111 folded before Flop (didn't bet)
Seat 2: Mr.KlonkAlot (button) folded before Flop (didn't bet)
Seat 3: fuzinger (small blind) folded before Flop
Seat 4: llosjone (big blind) folded before Flop
Seat 5: MostlyGravy collected ($0.25)
Seat 6: negritos81 folded before Flop (didn't bet)



PokerStars Hand #222948694277:  Hold'em No Limit ($0.05/$0.10 USD) - 2021/01/23 4:32:06 ET
Table 'Malzovia III' 6-max Seat #3 is the button
Seat 1: schnu111 ($10 in chips) 
Seat 2: Mr.KlonkAlot ($9.13 in chips) 
Seat 3: fuzinger ($10 in chips) 
Seat 4: llosjone ($9.92 in chips) 
Seat 5: MostlyGravy ($24.31 in chips) 
Seat 6: negritos81 ($12.17 in chips) 
llosjone: posts small blind $0.05
MostlyGravy: posts big blind $0.10
*** HOLE CARDS ***
negritos81: folds 
schnu111: folds 
Mr.KlonkAlot: raises $0.30 to $0.40
fuzinger: folds 
llosjone: folds 
MostlyGravy: calls $0.30
*** FLOP *** [8c 6c 3c]
MostlyGravy: checks 
Mr.KlonkAlot: checks 
*** TURN *** [8c 6c 3c] [Th]
MostlyGravy: bets $0.40
Mr.KlonkAlot: folds 
Uncalled bet ($0.40) returned to MostlyGravy
MostlyGravy collected $0.81 from pot
MostlyGravy: doesn't show hand 
*** SUMMARY ***
Total pot $0.85 | Rake $0.04 
Board [8c 6c 3c Th]
Seat 1: schnu111 folded before Flop (didn't bet)
Seat 2: Mr.KlonkAlot folded on the Turn
Seat 3: fuzinger (button) folded before Flop (didn't bet)
Seat 4: llosjone (small blind) folded before Flop
Seat 5: MostlyGravy (big blind) collected ($0.81)
Seat 6: negritos81 folded before Flop (didn't bet)



PokerStars Hand #222948706846:  Hold'em No Limit ($0.05/$0.10 USD) - 2021/01/23 4:32:53 ET
Table 'Malzovia III' 6-max Seat #4 is the button
Seat 1: schnu111 ($10 in chips) 
Seat 2: Mr.KlonkAlot ($8.73 in chips) 
Seat 3: fuzinger ($10 in chips) 
Seat 4: llosjone ($9.87 in chips) 
Seat 5: MostlyGravy ($24.72 in chips) 
Seat 6: negritos81 ($12.17 in chips) 
MostlyGravy: posts small blind $0.05
negritos81: posts big blind $0.10
*** HOLE CARDS ***
schnu111: folds 
Mr.KlonkAlot: folds 
fuzinger: raises $0.25 to $0.35
llosjone: folds 
MostlyGravy: calls $0.30
negritos81: folds 
*** FLOP *** [6h 3s 9d]
MostlyGravy: bets $0.38
fuzinger: folds 
Uncalled bet ($0.38) returned to MostlyGravy
MostlyGravy collected $0.76 from pot
MostlyGravy: doesn't show hand 
*** SUMMARY ***
Total pot $0.80 | Rake $0.04 
Board [6h 3s 9d]
Seat 1: schnu111 folded before Flop (didn't bet)
Seat 2: Mr.KlonkAlot folded before Flop (didn't bet)
Seat 3: fuzinger folded on the Flop
Seat 4: llosjone (button) folded before Flop (didn't bet)
Seat 5: MostlyGravy (small blind) collected ($0.76)
Seat 6: negritos81 (big blind) folded before Flop



PokerStars Hand #222948720366:  Hold'em No Limit ($0.05/$0.10 USD) - 2021/01/23 4:33:44 ET
Table 'Malzovia III' 6-max Seat #5 is the button
Seat 1: schnu111 ($10 in chips) 
Seat 2: Mr.KlonkAlot ($8.73 in chips) 
Seat 3: fuzinger ($10 in chips) 
Seat 4: llosjone ($9.87 in chips) 
Seat 5: MostlyGravy ($25.13 in chips) 
Seat 6: negritos81 ($12.07 in chips) 
negritos81: posts small blind $0.05
schnu111: posts big blind $0.10
*** HOLE CARDS ***
Mr.KlonkAlot: folds 
fuzinger: folds 
llosjone: folds 
MostlyGravy: raises $0.35 to $0.45
negritos81: folds 
schnu111: folds 
Uncalled bet ($0.35) returned to MostlyGravy
MostlyGravy collected $0.25 from pot
MostlyGravy: doesn't show hand 
*** SUMMARY ***
Total pot $0.25 | Rake $0 
Seat 1: schnu111 (big blind) folded before Flop
Seat 2: Mr.KlonkAlot folded before Flop (didn't bet)
Seat 3: fuzinger folded before Flop (didn't bet)
Seat 4: llosjone folded before Flop (didn't bet)
Seat 5: MostlyGravy (button) collected ($0.25)
Seat 6: negritos81 (small blind) folded before Flop



PokerStars Hand #222948728840:  Hold'em No Limit ($0.05/$0.10 USD) - 2021/01/23 4:34:16 ET
Table 'Malzovia III' 6-max Seat #6 is the button
Seat 1: schnu111 ($10 in chips) 
Seat 2: Mr.KlonkAlot ($8.73 in chips) 
Seat 3: fuzinger ($10 in chips) 
Seat 4: llosjone ($9.87 in chips) 
Seat 5: MostlyGravy ($25.28 in chips) 
Seat 6: negritos81 ($12.02 in chips) 
schnu111: posts small blind $0.05
Mr.KlonkAlot: posts big blind $0.10
*** HOLE CARDS ***
fuzinger: raises $0.25 to $0.35
llosjone: folds 
MostlyGravy: folds 
negritos81: folds 
schnu111: folds 
Mr.KlonkAlot: calls $0.25
*** FLOP *** [9s 3s 7s]
Mr.KlonkAlot: bets $0.54
fuzinger: folds 
Uncalled bet ($0.54) returned to Mr.KlonkAlot
Mr.KlonkAlot collected $0.72 from pot
Mr.KlonkAlot: doesn't show hand 
*** SUMMARY ***
Total pot $0.75 | Rake $0.03 
Board [9s 3s 7s]
Seat 1: schnu111 (small blind) folded before Flop
Seat 2: Mr.KlonkAlot (big blind) collected ($0.72)
Seat 3: fuzinger folded on the Flop
Seat 4: llosjone folded before Flop (didn't bet)
Seat 5: MostlyGravy folded before Flop (didn't bet)
Seat 6: negritos81 (button) folded before Flop (didn't bet)



PokerStars Hand #222948736631:  Hold'em No Limit ($0.05/$0.10 USD) - 2021/01/23 4:34:45 ET
Table 'Malzovia III' 6-max Seat #1 is the button
Seat 1: schnu111 ($10 in chips) 
Seat 2: Mr.KlonkAlot ($9.10 in chips) 
Seat 3: fuzinger ($10 in chips) 
Seat 4: llosjone ($9.87 in chips) 
Seat 5: MostlyGravy ($25.28 in chips) 
Seat 6: negritos81 ($12.02 in chips) 
Mr.KlonkAlot: posts small blind $0.05
fuzinger: posts big blind $0.10
*** HOLE CARDS ***
llosjone: folds 
MostlyGravy: calls $0.10
negritos81: folds 
schnu111: raises $0.30 to $0.40
Mr.KlonkAlot: folds 
fuzinger: folds 
MostlyGravy: folds 
Uncalled bet ($0.30) returned to schnu111
schnu111 collected $0.35 from pot
schnu111: doesn't show hand 
*** SUMMARY ***
Total pot $0.35 | Rake $0 
Seat 1: schnu111 (button) collected ($0.35)
Seat 2: Mr.KlonkAlot (small blind) folded before Flop
Seat 3: fuzinger (big blind) folded before Flop
Seat 4: llosjone folded before Flop (didn't bet)
Seat 5: MostlyGravy folded before Flop
Seat 6: negritos81 folded before Flop (didn't bet)



PokerStars Hand #222948743430:  Hold'em No Limit ($0.05/$0.10 USD) - 2021/01/23 4:35:10 ET
Table 'Malzovia III' 6-max Seat #2 is the button
Seat 1: schnu111 ($10.25 in chips) 
Seat 2: Mr.KlonkAlot ($9.05 in chips) 
Seat 3: fuzinger ($10 in chips) 
Seat 4: llosjone ($9.87 in chips) 
Seat 5: MostlyGravy ($25.18 in chips) 
Seat 6: negritos81 ($12.02 in chips) 
fuzinger: posts small blind $0.05
llosjone: posts big blind $0.10
*** HOLE CARDS ***
MostlyGravy: folds 
negritos81: folds 
schnu111: folds 
Mr.KlonkAlot: folds 
fuzinger: folds 
Uncalled bet ($0.05) returned to llosjone
llosjone collected $0.10 from pot
llosjone: doesn't show hand 
*** SUMMARY ***
Total pot $0.10 | Rake $0 
Seat 1: schnu111 folded before Flop (didn't bet)
Seat 2: Mr.KlonkAlot (button) folded before Flop (didn't bet)
Seat 3: fuzinger (small blind) folded before Flop
Seat 4: llosjone (big blind) collected ($0.10)
Seat 5: MostlyGravy folded before Flop (didn't bet)
Seat 6: negritos81 folded before Flop (didn't bet)



PokerStars Hand #222948746871:  Hold'em No Limit ($0.05/$0.10 USD) - 2021/01/23 4:35:23 ET
Table 'Malzovia III' 6-max Seat #3 is the button
Seat 1: schnu111 ($10.25 in chips) 
Seat 2: Mr.KlonkAlot ($9.05 in chips) 
Seat 3: fuzinger ($10 in chips) 
Seat 4: llosjone ($9.92 in chips) 
Seat 5: MostlyGravy ($25.18 in chips) 
Seat 6: negritos81 ($12.02 in chips) 
llosjone: posts small blind $0.05
MostlyGravy: posts big blind $0.10
*** HOLE CARDS ***
negritos81: folds 
schnu111: folds 
Mr.KlonkAlot: raises $0.30 to $0.40
fuzinger: folds 
llosjone: folds 
MostlyGravy: folds 
Uncalled bet ($0.30) returned to Mr.KlonkAlot
Mr.KlonkAlot collected $0.25 from pot
Mr.KlonkAlot: doesn't show hand 
*** SUMMARY ***
Total pot $0.25 | Rake $0 
Seat 1: schnu111 folded before Flop (didn't bet)
Seat 2: Mr.KlonkAlot collected ($0.25)
Seat 3: fuzinger (button) folded before Flop (didn't bet)
Seat 4: llosjone (small blind) folded before Flop
Seat 5: MostlyGravy (big blind) folded before Flop
Seat 6: negritos81 folded before Flop (didn't bet)



PokerStars Hand #222948753202:  Hold'em No Limit ($0.05/$0.10 USD) - 2021/01/23 4:35:47 ET
Table 'Malzovia III' 6-max Seat #4 is the button
Seat 1: schnu111 ($10.25 in chips) 
Seat 2: Mr.KlonkAlot ($9.20 in chips) 
Seat 3: fuzinger ($10 in chips) 
Seat 4: llosjone ($9.87 in chips) 
Seat 5: MostlyGravy ($25.08 in chips) 
Seat 6: negritos81 ($12.02 in chips) 
MostlyGravy: posts small blind $0.05
negritos81: posts big blind $0.10
*** HOLE CARDS ***
schnu111: folds 
Mr.KlonkAlot: raises $0.30 to $0.40
fuzinger: folds 
llosjone: folds 
MostlyGravy: calls $0.35
negritos81: folds 
*** FLOP *** [Kd As Ac]
MostlyGravy: bets $1.03
Mr.KlonkAlot: folds 
Uncalled bet ($1.03) returned to MostlyGravy
MostlyGravy collected $0.86 from pot
MostlyGravy: doesn't show hand 
*** SUMMARY ***
Total pot $0.90 | Rake $0.04 
Board [Kd As Ac]
Seat 1: schnu111 folded before Flop (didn't bet)
Seat 2: Mr.KlonkAlot folded on the Flop
Seat 3: fuzinger folded before Flop (didn't bet)
Seat 4: llosjone (button) folded before Flop (didn't bet)
Seat 5: MostlyGravy (small blind) collected ($0.86)
Seat 6: negritos81 (big blind) folded before Flop



PokerStars Hand #222948767323:  Hold'em No Limit ($0.05/$0.10 USD) - 2021/01/23 4:36:39 ET
Table 'Malzovia III' 6-max Seat #5 is the button
Seat 1: schnu111 ($10.25 in chips) 
Seat 2: Mr.KlonkAlot ($8.80 in chips) 
Seat 3: fuzinger ($10 in chips) 
Seat 4: llosjone ($9.87 in chips) 
Seat 5: MostlyGravy ($25.54 in chips) 
Seat 6: negritos81 ($11.92 in chips) 
negritos81: posts small blind $0.05
schnu111: posts big blind $0.10
*** HOLE CARDS ***
Mr.KlonkAlot: raises $0.30 to $0.40
fuzinger: folds 
llosjone: folds 
MostlyGravy: calls $0.40
negritos81: folds 
schnu111: calls $0.30
*** FLOP *** [Jd 7h 6s]
schnu111: checks 
Mr.KlonkAlot: checks 
MostlyGravy: bets $0.59
schnu111: calls $0.59
Mr.KlonkAlot: folds 
*** TURN *** [Jd 7h 6s] [Ac]
schnu111: checks 
MostlyGravy: bets $0.66
schnu111: calls $0.66
*** RIVER *** [Jd 7h 6s Ac] [Ts]
schnu111: checks 
MostlyGravy: checks 
*** SHOW DOWN ***
schnu111: shows [Jh Kc] (a pair of Jacks)
MostlyGravy: shows [Js Kh] (a pair of Jacks)
schnu111 collected $1.79 from pot
MostlyGravy collected $1.79 from pot
*** SUMMARY ***
Total pot $3.75 | Rake $0.17 
Board [Jd 7h 6s Ac Ts]
Seat 1: schnu111 (big blind) showed [Jh Kc] and won ($1.79) with a pair of Jacks
Seat 2: Mr.KlonkAlot folded on the Flop
Seat 3: fuzinger folded before Flop (didn't bet)
Seat 4: llosjone folded before Flop (didn't bet)
Seat 5: MostlyGravy (button) showed [Js Kh] and won ($1.79) with a pair of Jacks
Seat 6: negritos81 (small blind) folded before Flop



PokerStars Hand #222948788893:  Hold'em No Limit ($0.05/$0.10 USD) - 2021/01/23 4:37:58 ET
Table 'Malzovia III' 6-max Seat #6 is the button
Seat 1: schnu111 ($10.39 in chips) 
Seat 2: Mr.KlonkAlot ($8.40 in chips) 
Seat 3: fuzinger ($10 in chips) 
Seat 4: llosjone ($9.87 in chips) 
Seat 5: MostlyGravy ($25.68 in chips) 
Seat 6: negritos81 ($11.87 in chips) 
schnu111: posts small blind $0.05
Mr.KlonkAlot: posts big blind $0.10
*** HOLE CARDS ***
fuzinger: folds 
llosjone: folds 
MostlyGravy: calls $0.10
negritos81: folds 
schnu111: folds 
Mr.KlonkAlot: checks 
*** FLOP *** [8c 5c Jd]
Mr.KlonkAlot: checks 
MostlyGravy: checks 
*** TURN *** [8c 5c Jd] [8h]
Mr.KlonkAlot: checks 
MostlyGravy: bets $0.22
Mr.KlonkAlot: folds 
Uncalled bet ($0.22) returned to MostlyGravy
MostlyGravy collected $0.24 from pot
MostlyGravy: doesn't show hand 
*** SUMMARY ***
Total pot $0.25 | Rake $0.01 
Board [8c 5c Jd 8h]
Seat 1: schnu111 (small blind) folded before Flop
Seat 2: Mr.KlonkAlot (big blind) folded on the Turn
Seat 3: fuzinger folded before Flop (didn't bet)
Seat 4: llosjone folded before Flop (didn't bet)
Seat 5: MostlyGravy collected ($0.24)
Seat 6: negritos81 (button) folded before Flop (didn't bet)



PokerStars Hand #222948802001:  Hold'em No Limit ($0.05/$0.10 USD) - 2021/01/23 4:38:47 ET
Table 'Malzovia III' 6-max Seat #1 is the button
Seat 1: schnu111 ($10.34 in chips) 
Seat 2: Mr.KlonkAlot ($8.30 in chips) 
Seat 3: fuzinger ($10 in chips) 
Seat 4: llosjone ($9.87 in chips) 
Seat 5: MostlyGravy ($25.82 in chips) 
Seat 6: negritos81 ($11.87 in chips) 
Mr.KlonkAlot: posts small blind $0.05
fuzinger: posts big blind $0.10
*** HOLE CARDS ***
llosjone: folds 
MostlyGravy: calls $0.10
negritos81: folds 
schnu111: raises $0.30 to $0.40
Mr.KlonkAlot: folds 
fuzinger: folds 
MostlyGravy: folds 
Uncalled bet ($0.30) returned to schnu111
schnu111 collected $0.35 from pot
schnu111: doesn't show hand 
*** SUMMARY ***
Total pot $0.35 | Rake $0 
Seat 1: schnu111 (button) collected ($0.35)
Seat 2: Mr.KlonkAlot (small blind) folded before Flop
Seat 3: fuzinger (big blind) folded before Flop
Seat 4: llosjone folded before Flop (didn't bet)
Seat 5: MostlyGravy folded before Flop
Seat 6: negritos81 folded before Flop (didn't bet)



PokerStars Hand #222948808055:  Hold'em No Limit ($0.05/$0.10 USD) - 2021/01/23 4:39:09 ET
Table 'Malzovia III' 6-max Seat #2 is the button
Seat 1: schnu111 ($10.59 in chips) 
Seat 2: Mr.KlonkAlot ($8.25 in chips) 
Seat 3: fuzinger ($10 in chips) 
Seat 4: llosjone ($9.87 in chips) 
Seat 5: MostlyGravy ($25.72 in chips) 
Seat 6: negritos81 ($11.87 in chips) 
fuzinger: posts small blind $0.05
llosjone: posts big blind $0.10
*** HOLE CARDS ***
MostlyGravy has timed out
MostlyGravy: folds 
negritos81: folds 
schnu111: folds 
Mr.KlonkAlot: folds 
fuzinger: folds 
Uncalled bet ($0.05) returned to llosjone
llosjone collected $0.10 from pot
llosjone: doesn't show hand 
*** SUMMARY ***
Total pot $0.10 | Rake $0 
Seat 1: schnu111 folded before Flop (didn't bet)
Seat 2: Mr.KlonkAlot (button) folded before Flop (didn't bet)
Seat 3: fuzinger (small blind) folded before Flop
Seat 4: llosjone (big blind) collected ($0.10)
Seat 5: MostlyGravy folded before Flop (didn't bet)
Seat 6: negritos81 folded before Flop (didn't bet)



PokerStars Hand #222948812578:  Hold'em No Limit ($0.05/$0.10 USD) - 2021/01/23 4:39:26 ET
Table 'Malzovia III' 6-max Seat #3 is the button
Seat 1: schnu111 ($10.59 in chips) 
Seat 2: Mr.KlonkAlot ($8.25 in chips) 
Seat 3: fuzinger ($10 in chips) 
Seat 4: llosjone ($9.92 in chips) 
Seat 5: MostlyGravy ($25.72 in chips) 
Seat 6: negritos81 ($11.87 in chips) 
llosjone: posts small blind $0.05
MostlyGravy: posts big blind $0.10
*** HOLE CARDS ***
negritos81: folds 
schnu111: folds 
Mr.KlonkAlot: raises $0.30 to $0.40
fuzinger: folds 
llosjone: folds 
MostlyGravy: folds 
Uncalled bet ($0.30) returned to Mr.KlonkAlot
Mr.KlonkAlot collected $0.25 from pot
Mr.KlonkAlot: doesn't show hand 
*** SUMMARY ***
Total pot $0.25 | Rake $0 
Seat 1: schnu111 folded before Flop (didn't bet)
Seat 2: Mr.KlonkAlot collected ($0.25)
Seat 3: fuzinger (button) folded before Flop (didn't bet)
Seat 4: llosjone (small blind) folded before Flop
Seat 5: MostlyGravy (big blind) folded before Flop
Seat 6: negritos81 folded before Flop (didn't bet)



PokerStars Hand #222948818153:  Hold'em No Limit ($0.05/$0.10 USD) - 2021/01/23 4:39:46 ET
Table 'Malzovia III' 6-max Seat #4 is the button
Seat 1: schnu111 ($10.59 in chips) 
Seat 2: Mr.KlonkAlot ($8.40 in chips) 
Seat 3: fuzinger ($10 in chips) 
Seat 4: llosjone ($9.87 in chips) 
Seat 5: MostlyGravy ($25.62 in chips) 
Seat 6: negritos81 ($11.87 in chips) 
MostlyGravy: posts small blind $0.05
negritos81: posts big blind $0.10
*** HOLE CARDS ***
schnu111: folds 
Mr.KlonkAlot: raises $0.30 to $0.40
fuzinger: folds 
llosjone: folds 
MostlyGravy: folds 
negritos81: raises $0.80 to $1.20
Mr.KlonkAlot: folds 
Uncalled bet ($0.80) returned to negritos81
negritos81 collected $0.85 from pot
negritos81: doesn't show hand 
*** SUMMARY ***
Total pot $0.85 | Rake $0 
Seat 1: schnu111 folded before Flop (didn't bet)
Seat 2: Mr.KlonkAlot folded before Flop
Seat 3: fuzinger folded before Flop (didn't bet)
Seat 4: llosjone (button) folded before Flop (didn't bet)
Seat 5: MostlyGravy (small blind) folded before Flop
Seat 6: negritos81 (big blind) collected ($0.85)



PokerStars Hand #222948824534:  Hold'em No Limit ($0.05/$0.10 USD) - 2021/01/23 4:40:09 ET
Table 'Malzovia III' 6-max Seat #5 is the button
Seat 1: schnu111 ($10.59 in chips) 
Seat 2: Mr.KlonkAlot ($8 in chips) 
Seat 3: fuzinger ($10 in chips) 
Seat 4: llosjone ($9.87 in chips) 
Seat 5: MostlyGravy ($25.57 in chips) 
Seat 6: negritos81 ($12.32 in chips) 
negritos81: posts small blind $0.05
schnu111: posts big blind $0.10
*** HOLE CARDS ***
Mr.KlonkAlot: raises $0.30 to $0.40
fuzinger: folds 
llosjone: folds 
MostlyGravy: folds 
negritos81: folds 
schnu111: folds 
Uncalled bet ($0.30) returned to Mr.KlonkAlot
Mr.KlonkAlot collected $0.25 from pot
Mr.KlonkAlot: doesn't show hand 
*** SUMMARY ***
Total pot $0.25 | Rake $0 
Seat 1: schnu111 (big blind) folded before Flop
Seat 2: Mr.KlonkAlot collected ($0.25)
Seat 3: fuzinger folded before Flop (didn't bet)
Seat 4: llosjone folded before Flop (didn't bet)
Seat 5: MostlyGravy (button) folded before Flop (didn't bet)
Seat 6: negritos81 (small blind) folded before Flop



PokerStars Hand #222948829012:  Hold'em No Limit ($0.05/$0.10 USD) - 2021/01/23 4:40:25 ET
Table 'Malzovia III' 6-max Seat #6 is the button
Seat 1: schnu111 ($10.49 in chips) 
Seat 2: Mr.KlonkAlot ($8.15 in chips) 
Seat 3: fuzinger ($10 in chips) 
Seat 4: llosjone ($9.87 in chips) 
Seat 5: MostlyGravy ($25.57 in chips) 
Seat 6: negritos81 ($12.27 in chips) 
schnu111: posts small blind $0.05
Mr.KlonkAlot: posts big blind $0.10
*** HOLE CARDS ***
fuzinger: folds 
llosjone: folds 
MostlyGravy: folds 
negritos81: raises $0.20 to $0.30
schnu111: folds 
Mr.KlonkAlot: folds 
Uncalled bet ($0.20) returned to negritos81
negritos81 collected $0.25 from pot
negritos81: doesn't show hand 
*** SUMMARY ***
Total pot $0.25 | Rake $0 
Seat 1: schnu111 (small blind) folded before Flop
Seat 2: Mr.KlonkAlot (big blind) folded before Flop
Seat 3: fuzinger folded before Flop (didn't bet)
Seat 4: llosjone folded before Flop (didn't bet)
Seat 5: MostlyGravy folded before Flop (didn't bet)
Seat 6: negritos81 (button) collected ($0.25)



PokerStars Hand #222948833618:  Hold'em No Limit ($0.05/$0.10 USD) - 2021/01/23 4:40:42 ET
Table 'Malzovia III' 6-max Seat #1 is the button
Seat 1: schnu111 ($10.44 in chips) 
Seat 2: Mr.KlonkAlot ($8.05 in chips) 
Seat 4: llosjone ($9.87 in chips) 
Seat 5: MostlyGravy ($25.57 in chips) 
Seat 6: negritos81 ($12.42 in chips) 
Mr.KlonkAlot: posts small blind $0.05
fuzinger: is sitting out 
llosjone: posts big blind $0.10
*** HOLE CARDS ***
MostlyGravy: raises $0.10 to $0.20
negritos81: folds 
schnu111: calls $0.20
Mr.KlonkAlot: calls $0.15
llosjone: calls $0.10
*** FLOP *** [5s 6d 5h]
Mr.KlonkAlot: bets $0.57
llosjone: folds 
MostlyGravy: calls $0.57
schnu111: folds 
*** TURN *** [5s 6d 5h] [3c]
Mr.KlonkAlot: checks 
MostlyGravy: bets $0.30
Mr.KlonkAlot: calls $0.30
*** RIVER *** [5s 6d 5h 3c] [8d]
Mr.KlonkAlot: checks 
MostlyGravy: checks 
*** SHOW DOWN ***
Mr.KlonkAlot: shows [6h 8h] (two pair, Eights and Sixes)
MostlyGravy: mucks hand 
Mr.KlonkAlot collected $2.43 from pot
fuzinger leaves the table
*** SUMMARY ***
Total pot $2.54 | Rake $0.11 
Board [5s 6d 5h 3c 8d]
Seat 1: schnu111 (button) folded on the Flop
Seat 2: Mr.KlonkAlot (small blind) showed [6h 8h] and won ($2.43) with two pair, Eights and Sixes
Seat 4: llosjone (big blind) folded on the Flop
Seat 5: MostlyGravy mucked
Seat 6: negritos81 folded before Flop (didn't bet)



PokerStars Hand #222948854266:  Hold'em No Limit ($0.05/$0.10 USD) - 2021/01/23 4:41:56 ET
Table 'Malzovia III' 6-max Seat #2 is the button
Seat 1: schnu111 ($10.24 in chips) 
Seat 2: Mr.KlonkAlot ($9.41 in chips) 
Seat 4: llosjone ($9.67 in chips) 
Seat 5: MostlyGravy ($24.50 in chips) 
Seat 6: negritos81 ($12.42 in chips) 
llosjone: posts small blind $0.05
MostlyGravy: posts big blind $0.10
*** HOLE CARDS ***
negritos81: folds 
schnu111: folds 
Mr.KlonkAlot: raises $0.30 to $0.40
llosjone: calls $0.35
MostlyGravy: folds 
*** FLOP *** [Tc Jd 5h]
llosjone: checks 
Mr.KlonkAlot: bets $0.70
llosjone: calls $0.70
*** TURN *** [Tc Jd 5h] [Qc]
llosjone: checks 
Mr.KlonkAlot: bets $1.65
llosjone: calls $1.65
*** RIVER *** [Tc Jd 5h Qc] [Ts]
llosjone: bets $6.92 and is all-in
Mr.KlonkAlot: folds 
Uncalled bet ($6.92) returned to llosjone
llosjone collected $5.35 from pot
llosjone: doesn't show hand 
*** SUMMARY ***
Total pot $5.60 | Rake $0.25 
Board [Tc Jd 5h Qc Ts]
Seat 1: schnu111 folded before Flop (didn't bet)
Seat 2: Mr.KlonkAlot (button) folded on the River
Seat 4: llosjone (small blind) collected ($5.35)
Seat 5: MostlyGravy (big blind) folded before Flop
Seat 6: negritos81 folded before Flop (didn't bet)



PokerStars Hand #222948869532:  Hold'em No Limit ($0.05/$0.10 USD) - 2021/01/23 4:42:41 ET
Table 'Malzovia III' 6-max Seat #4 is the button
Seat 1: schnu111 ($10.24 in chips) 
Seat 2: Mr.KlonkAlot ($6.66 in chips) 
Seat 4: llosjone ($12.27 in chips) 
Seat 5: MostlyGravy ($24.40 in chips) 
Seat 6: negritos81 ($12.42 in chips) 
MostlyGravy: posts small blind $0.05
negritos81: posts big blind $0.10
*** HOLE CARDS ***
schnu111: folds 
Mr.KlonkAlot: raises $0.30 to $0.40
llosjone: calls $0.40
MostlyGravy: folds 
negritos81: folds 
*** FLOP *** [5h 6d 5d]
Mr.KlonkAlot: bets $0.68
llosjone: folds 
Uncalled bet ($0.68) returned to Mr.KlonkAlot
Mr.KlonkAlot collected $0.91 from pot
Mr.KlonkAlot: doesn't show hand 
*** SUMMARY ***
Total pot $0.95 | Rake $0.04 
Board [5h 6d 5d]
Seat 1: schnu111 folded before Flop (didn't bet)
Seat 2: Mr.KlonkAlot collected ($0.91)
Seat 4: llosjone (button) folded on the Flop
Seat 5: MostlyGravy (small blind) folded before Flop
Seat 6: negritos81 (big blind) folded before Flop



PokerStars Hand #222948878092:  Hold'em No Limit ($0.05/$0.10 USD) - 2021/01/23 4:43:12 ET
Table 'Malzovia III' 6-max Seat #5 is the button
Seat 1: schnu111 ($10.24 in chips) 
Seat 2: Mr.KlonkAlot ($7.17 in chips) 
Seat 4: llosjone ($11.87 in chips) 
Seat 5: MostlyGravy ($24.35 in chips) 
Seat 6: negritos81 ($12.32 in chips) 
negritos81: posts small blind $0.05
schnu111: posts big blind $0.10
*** HOLE CARDS ***
Mr.KlonkAlot: folds 
llosjone: raises $0.15 to $0.25
Mr.KlonkAlot leaves the table
MostlyGravy: folds 
negritos81: folds 
schnu111: folds 
Uncalled bet ($0.15) returned to llosjone
llosjone collected $0.25 from pot
llosjone: doesn't show hand 
*** SUMMARY ***
Total pot $0.25 | Rake $0 
Seat 1: schnu111 (big blind) folded before Flop
Seat 2: Mr.KlonkAlot folded before Flop (didn't bet)
Seat 4: llosjone collected ($0.25)
Seat 5: MostlyGravy (button) folded before Flop (didn't bet)
Seat 6: negritos81 (small blind) folded before Flop



PokerStars Hand #222949515192:  Hold'em No Limit ($0.05/$0.10 USD) - 2021/01/23 5:20:16 ET
Table 'Malzovia III' 6-max Seat #3 is the button
Seat 1: schnu111 ($10.94 in chips) 
Seat 2: kimmarusa ($13.76 in chips) 
Seat 3: GrinZwe91! ($11.18 in chips) 
Seat 4: stylepointxoxo ($11.08 in chips) 
Seat 5: MostlyGravy ($23.29 in chips) 
Seat 6: negritos81 ($11.14 in chips) 
stylepointxoxo: posts small blind $0.05
MostlyGravy: posts big blind $0.10
*** HOLE CARDS ***
negritos81: folds 
schnu111: folds 
kimmarusa: folds 
GrinZwe91!: folds 
stylepointxoxo: folds 
Uncalled bet ($0.05) returned to MostlyGravy
MostlyGravy collected $0.10 from pot
*** SUMMARY ***
Total pot $0.10 | Rake $0 
Seat 1: schnu111 folded before Flop (didn't bet)
Seat 2: kimmarusa folded before Flop (didn't bet)
Seat 3: GrinZwe91! (button) folded before Flop (didn't bet)
Seat 4: stylepointxoxo (small blind) folded before Flop
Seat 5: MostlyGravy (big blind) collected ($0.10)
Seat 6: negritos81 folded before Flop (didn't bet)



PokerStars Hand #222949938285:  Hold'em No Limit ($0.05/$0.10 USD) - 2021/01/23 5:43:08 ET
Table 'Malzovia III' 6-max Seat #2 is the button
Seat 1: favourble ($10 in chips) 
Seat 2: kimmarusa ($15.27 in chips) 
Seat 3: GrinZwe91! ($10.85 in chips) 
Seat 4: PaoloGod ($5.09 in chips) 
Seat 6: Findingfishy ($7.58 in chips) 
GrinZwe91!: posts small blind $0.05
PaoloGod: posts big blind $0.10
PizzaTonnoNL: sits out 
*** HOLE CARDS ***
Findingfishy: folds 
favourble: folds 
kimmarusa: raises $0.20 to $0.30
GrinZwe91!: folds 
PaoloGod: raises $0.20 to $0.50
kimmarusa: calls $0.20
*** FLOP *** [8s 3c 3s]
PaoloGod: checks 
kimmarusa: checks 
*** TURN *** [8s 3c 3s] [4h]
PaoloGod: checks 
kimmarusa: checks 
*** RIVER *** [8s 3c 3s 4h] [6d]
PaoloGod: bets $1.20
kimmarusa: folds 
Uncalled bet ($1.20) returned to PaoloGod
PaoloGod collected $1 from pot
PaoloGod: doesn't show hand 
*** SUMMARY ***
Total pot $1.05 | Rake $0.05 
Board [8s 3c 3s 4h 6d]
Seat 1: favourble folded before Flop (didn't bet)
Seat 2: kimmarusa (button) folded on the River
Seat 3: GrinZwe91! (small blind) folded before Flop
Seat 4: PaoloGod (big blind) collected ($1)
Seat 6: Findingfishy folded before Flop (didn't bet)



PokerStars Hand #222949955317:  Hold'em No Limit ($0.05/$0.10 USD) - 2021/01/23 5:44:03 ET
Table 'Malzovia III' 6-max Seat #3 is the button
Seat 1: favourble ($10 in chips) 
Seat 2: kimmarusa ($14.77 in chips) 
Seat 3: GrinZwe91! ($10.80 in chips) 
Seat 4: PaoloGod ($5.59 in chips) 
Seat 5: PizzaTonnoNL ($10 in chips) 
Seat 6: Findingfishy ($7.58 in chips) 
PaoloGod: posts small blind $0.05
PizzaTonnoNL: posts big blind $0.10
*** HOLE CARDS ***
Findingfishy: folds 
favourble: folds 
kimmarusa: raises $0.20 to $0.30
GrinZwe91!: folds 
PaoloGod: calls $0.25
PizzaTonnoNL: folds 
*** FLOP *** [3s 7h 2d]
PaoloGod: checks 
kimmarusa: bets $0.40
PaoloGod: calls $0.40
*** TURN *** [3s 7h 2d] [8h]
PaoloGod: checks 
kimmarusa: bets $0.90
PaoloGod: calls $0.90
*** RIVER *** [3s 7h 2d 8h] [Ts]
PaoloGod: bets $0.10
kimmarusa: calls $0.10
*** SHOW DOWN ***
PaoloGod: shows [2c 3c] (two pair, Threes and Deuces)
kimmarusa: mucks hand 
PaoloGod collected $3.34 from pot
*** SUMMARY ***
Total pot $3.50 | Rake $0.16 
Board [3s 7h 2d 8h Ts]
Seat 1: favourble folded before Flop (didn't bet)
Seat 2: kimmarusa mucked
Seat 3: GrinZwe91! (button) folded before Flop (didn't bet)
Seat 4: PaoloGod (small blind) showed [2c 3c] and won ($3.34) with two pair, Threes and Deuces
Seat 5: PizzaTonnoNL (big blind) folded before Flop
Seat 6: Findingfishy folded before Flop (didn't bet)



PokerStars Hand #222949975697:  Hold'em No Limit ($0.05/$0.10 USD) - 2021/01/23 5:45:08 ET
Table 'Malzovia III' 6-max Seat #4 is the button
Seat 1: favourble ($10 in chips) 
Seat 2: kimmarusa ($13.07 in chips) 
Seat 3: GrinZwe91! ($10.80 in chips) 
Seat 4: PaoloGod ($7.23 in chips) 
Seat 5: PizzaTonnoNL ($10 in chips) 
Seat 6: Findingfishy ($7.58 in chips) 
PizzaTonnoNL: posts small blind $0.05
Findingfishy: posts big blind $0.10
*** HOLE CARDS ***
favourble: folds 
kimmarusa: folds 
GrinZwe91!: folds 
PaoloGod: calls $0.10
PizzaTonnoNL: calls $0.05
Findingfishy: checks 
*** FLOP *** [Ts 4h 2d]
PizzaTonnoNL: checks 
Findingfishy: bets $0.10
PaoloGod: calls $0.10
PizzaTonnoNL: folds 
*** TURN *** [Ts 4h 2d] [Ks]
Findingfishy: bets $0.24
PaoloGod: calls $0.24
*** RIVER *** [Ts 4h 2d Ks] [Qs]
Findingfishy: checks 
PaoloGod: bets $1.20
Findingfishy: folds 
Uncalled bet ($1.20) returned to PaoloGod
PaoloGod collected $0.94 from pot
PaoloGod: doesn't show hand 
*** SUMMARY ***
Total pot $0.98 | Rake $0.04 
Board [Ts 4h 2d Ks Qs]
Seat 1: favourble folded before Flop (didn't bet)
Seat 2: kimmarusa folded before Flop (didn't bet)
Seat 3: GrinZwe91! folded before Flop (didn't bet)
Seat 4: PaoloGod (button) collected ($0.94)
Seat 5: PizzaTonnoNL (small blind) folded on the Flop
Seat 6: Findingfishy (big blind) folded on the River



PokerStars Hand #222949994839:  Hold'em No Limit ($0.05/$0.10 USD) - 2021/01/23 5:46:08 ET
Table 'Malzovia III' 6-max Seat #5 is the button
Seat 1: favourble ($10 in chips) 
Seat 2: kimmarusa ($13.07 in chips) 
Seat 3: GrinZwe91! ($10.80 in chips) 
Seat 4: PaoloGod ($7.73 in chips) 
Seat 5: PizzaTonnoNL ($10 in chips) 
Seat 6: Findingfishy ($7.14 in chips) 
Findingfishy: posts small blind $0.05
favourble: posts big blind $0.10
*** HOLE CARDS ***
kimmarusa: raises $0.20 to $0.30
GrinZwe91!: raises $0.60 to $0.90
PaoloGod: folds 
PizzaTonnoNL: folds 
Findingfishy: folds 
favourble: folds 
kimmarusa: folds 
Uncalled bet ($0.60) returned to GrinZwe91!
GrinZwe91! collected $0.75 from pot
GrinZwe91!: doesn't show hand 
*** SUMMARY ***
Total pot $0.75 | Rake $0 
Seat 1: favourble (big blind) folded before Flop
Seat 2: kimmarusa folded before Flop
Seat 3: GrinZwe91! collected ($0.75)
Seat 4: PaoloGod folded before Flop (didn't bet)
Seat 5: PizzaTonnoNL (button) folded before Flop (didn't bet)
Seat 6: Findingfishy (small blind) folded before Flop



PokerStars Hand #222948959217:  Hold'em No Limit ($0.05/$0.10 USD) - 2021/01/23 4:47:59 ET
Table 'Malzovia III' 6-max Seat #4 is the button
Seat 1: schnu111 ($10 in chips) 
Seat 4: llosjone ($10.74 in chips) 
Seat 5: MostlyGravy ($26.39 in chips) 
MostlyGravy: posts small blind $0.05
schnu111: posts big blind $0.10
romanromanro: sits out 
Eneichik: sits out 
*** HOLE CARDS ***
llosjone: folds 
MostlyGravy: calls $0.05
schnu111: raises $0.20 to $0.30
MostlyGravy: calls $0.20
*** FLOP *** [6c 8c 5s]
MostlyGravy: bets $0.10
schnu111: calls $0.10
*** TURN *** [6c 8c 5s] [3d]
MostlyGravy: bets $0.38
schnu111: folds 
Uncalled bet ($0.38) returned to MostlyGravy
MostlyGravy collected $0.76 from pot
MostlyGravy: doesn't show hand 
*** SUMMARY ***
Total pot $0.80 | Rake $0.04 
Board [6c 8c 5s 3d]
Seat 1: schnu111 (big blind) folded on the Turn
Seat 4: llosjone (button) folded before Flop (didn't bet)
Seat 5: MostlyGravy (small blind) collected ($0.76)



PokerStars Hand #222948973051:  Hold'em No Limit ($0.05/$0.10 USD) - 2021/01/23 4:48:49 ET
Table 'Malzovia III' 6-max Seat #5 is the button
Seat 1: schnu111 ($10 in chips) 
Seat 2: romanromanro ($10 in chips) 
Seat 4: llosjone ($10.74 in chips) 
Seat 5: MostlyGravy ($26.75 in chips) 
schnu111: posts small blind $0.05
romanromanro: posts big blind $0.10
Eneichik: sits out 
*** HOLE CARDS ***
llosjone: raises $0.15 to $0.25
MostlyGravy: folds 
schnu111: folds 
romanromanro: calls $0.15
*** FLOP *** [Js 6c As]
romanromanro: checks 
llosjone: checks 
*** TURN *** [Js 6c As] [3h]
romanromanro: bets $0.17
llosjone: calls $0.17
*** RIVER *** [Js 6c As 3h] [7s]
romanromanro: checks 
llosjone: checks 
*** SHOW DOWN ***
romanromanro: shows [9h Jh] (a pair of Jacks)
llosjone: mucks hand 
romanromanro collected $0.85 from pot
*** SUMMARY ***
Total pot $0.89 | Rake $0.04 
Board [Js 6c As 3h 7s]
Seat 1: schnu111 (small blind) folded before Flop
Seat 2: romanromanro (big blind) showed [9h Jh] and won ($0.85) with a pair of Jacks
Seat 4: llosjone mucked
Seat 5: MostlyGravy (button) folded before Flop (didn't bet)



PokerStars Hand #222948982822:  Hold'em No Limit ($0.05/$0.10 USD) - 2021/01/23 4:49:23 ET
Table 'Malzovia III' 6-max Seat #1 is the button
Seat 1: schnu111 ($10 in chips) 
Seat 2: romanromanro ($10.43 in chips) 
Seat 3: Eneichik ($4 in chips) 
Seat 4: llosjone ($10.32 in chips) 
Seat 5: MostlyGravy ($26.75 in chips) 
romanromanro: posts small blind $0.05
Eneichik: posts big blind $0.10
negritos81: sits out 
*** HOLE CARDS ***
llosjone: folds 
MostlyGravy: folds 
schnu111: folds 
romanromanro: raises $0.15 to $0.25
Eneichik: folds 
Uncalled bet ($0.15) returned to romanromanro
romanromanro collected $0.20 from pot
romanromanro: doesn't show hand 
*** SUMMARY ***
Total pot $0.20 | Rake $0 
Seat 1: schnu111 (button) folded before Flop (didn't bet)
Seat 2: romanromanro (small blind) collected ($0.20)
Seat 3: Eneichik (big blind) folded before Flop
Seat 4: llosjone folded before Flop (didn't bet)
Seat 5: MostlyGravy folded before Flop (didn't bet)



PokerStars Hand #222948986513:  Hold'em No Limit ($0.05/$0.10 USD) - 2021/01/23 4:49:36 ET
Table 'Malzovia III' 6-max Seat #2 is the button
Seat 1: schnu111 ($10 in chips) 
Seat 2: romanromanro ($10.53 in chips) 
Seat 3: Eneichik ($3.90 in chips) 
Seat 4: llosjone ($10.32 in chips) 
Seat 5: MostlyGravy ($26.75 in chips) 
Eneichik: posts small blind $0.05
llosjone: posts big blind $0.10
negritos81: sits out 
*** HOLE CARDS ***
MostlyGravy has timed out
MostlyGravy: folds 
schnu111: folds 
romanromanro: folds 
Eneichik: calls $0.05
llosjone: raises $0.20 to $0.30
Eneichik: calls $0.20
*** FLOP *** [6c 9s 8c]
Eneichik: bets $0.29
llosjone: calls $0.29
*** TURN *** [6c 9s 8c] [6h]
Eneichik: bets $0.60
llosjone: calls $0.60
*** RIVER *** [6c 9s 8c 6h] [4h]
Eneichik: bets $1.50
llosjone: calls $1.50
*** SHOW DOWN ***
Eneichik: shows [Td 6s] (three of a kind, Sixes)
llosjone: mucks hand 
Eneichik collected $5.14 from pot
*** SUMMARY ***
Total pot $5.38 | Rake $0.24 
Board [6c 9s 8c 6h 4h]
Seat 1: schnu111 folded before Flop (didn't bet)
Seat 2: romanromanro (button) folded before Flop (didn't bet)
Seat 3: Eneichik (small blind) showed [Td 6s] and won ($5.14) with three of a kind, Sixes
Seat 4: llosjone (big blind) mucked
Seat 5: MostlyGravy folded before Flop (didn't bet)



PokerStars Hand #222949002207:  Hold'em No Limit ($0.05/$0.10 USD) - 2021/01/23 4:50:32 ET
Table 'Malzovia III' 6-max Seat #3 is the button
Seat 1: schnu111 ($10 in chips) 
Seat 2: romanromanro ($10.53 in chips) 
Seat 3: Eneichik ($6.35 in chips) 
Seat 4: llosjone ($7.63 in chips) 
Seat 5: MostlyGravy ($26.75 in chips) 
llosjone: posts small blind $0.05
MostlyGravy: posts big blind $0.10
negritos81: sits out 
*** HOLE CARDS ***
schnu111: folds 
romanromanro: folds 
Eneichik: calls $0.10
llosjone: folds 
MostlyGravy: checks 
*** FLOP *** [Kc 5c 6d]
llosjone leaves the table
MostlyGravy: bets $0.10
Eneichik: folds 
Uncalled bet ($0.10) returned to MostlyGravy
MostlyGravy collected $0.24 from pot
MostlyGravy: doesn't show hand 
*** SUMMARY ***
Total pot $0.25 | Rake $0.01 
Board [Kc 5c 6d]
Seat 1: schnu111 folded before Flop (didn't bet)
Seat 2: romanromanro folded before Flop (didn't bet)
Seat 3: Eneichik (button) folded on the Flop
Seat 4: llosjone (small blind) folded before Flop
Seat 5: MostlyGravy (big blind) collected ($0.24)



PokerStars Hand #222949010252:  Hold'em No Limit ($0.05/$0.10 USD) - 2021/01/23 4:51:00 ET
Table 'Malzovia III' 6-max Seat #5 is the button
Seat 1: schnu111 ($10 in chips) 
Seat 2: romanromanro ($10.53 in chips) 
Seat 3: Eneichik ($6.25 in chips) 
Seat 5: MostlyGravy ($26.89 in chips) 
schnu111: posts small blind $0.05
romanromanro: posts big blind $0.10
*** HOLE CARDS ***
Eneichik: folds 
MostlyGravy: folds 
schnu111: folds 
Uncalled bet ($0.05) returned to romanromanro
romanromanro collected $0.10 from pot
romanromanro: doesn't show hand 
*** SUMMARY ***
Total pot $0.10 | Rake $0 
Seat 1: schnu111 (small blind) folded before Flop
Seat 2: romanromanro (big blind) collected ($0.10)
Seat 3: Eneichik folded before Flop (didn't bet)
Seat 5: MostlyGravy (button) folded before Flop (didn't bet)



PokerStars Hand #222949013068:  Hold'em No Limit ($0.05/$0.10 USD) - 2021/01/23 4:51:10 ET
Table 'Malzovia III' 6-max Seat #1 is the button
Seat 1: schnu111 ($10 in chips) 
Seat 2: romanromanro ($10.58 in chips) 
Seat 3: Eneichik ($6.25 in chips) 
Seat 5: MostlyGravy ($26.89 in chips) 
romanromanro: posts small blind $0.05
Eneichik: posts big blind $0.10
negritos81: sits out 
*** HOLE CARDS ***
MostlyGravy: folds 
schnu111: folds 
romanromanro: raises $0.20 to $0.30
Eneichik: calls $0.20
*** FLOP *** [2h 7h 5h]
romanromanro: bets $0.25
Eneichik: raises $0.54 to $0.79
bladezymcteague joins the table at seat #4 
romanromanro: calls $0.54
*** TURN *** [2h 7h 5h] [As]
romanromanro: checks 
Eneichik: bets $2.08
romanromanro: raises $7.41 to $9.49 and is all-in
Eneichik: calls $3.08 and is all-in
Uncalled bet ($4.33) returned to romanromanro
*** RIVER *** [2h 7h 5h As] [3h]
*** SHOW DOWN ***
romanromanro: shows [2s 2c] (three of a kind, Deuces)
Eneichik: shows [5s 5d] (three of a kind, Fives)
Eneichik collected $11.94 from pot
*** SUMMARY ***
Total pot $12.50 | Rake $0.56 
Board [2h 7h 5h As 3h]
Seat 1: schnu111 (button) folded before Flop (didn't bet)
Seat 2: romanromanro (small blind) showed [2s 2c] and lost with three of a kind, Deuces
Seat 3: Eneichik (big blind) showed [5s 5d] and won ($11.94) with three of a kind, Fives
Seat 5: MostlyGravy folded before Flop (didn't bet)



PokerStars Hand #222949023897:  Hold'em No Limit ($0.05/$0.10 USD) - 2021/01/23 4:51:48 ET
Table 'Malzovia III' 6-max Seat #2 is the button
Seat 1: schnu111 ($10 in chips) 
Seat 2: romanromanro ($10 in chips) 
Seat 3: Eneichik ($11.94 in chips) 
Seat 4: bladezymcteague ($8 in chips) 
Seat 5: MostlyGravy ($26.89 in chips) 
Eneichik: posts small blind $0.05
bladezymcteague: posts big blind $0.10
negritos81: sits out 
*** HOLE CARDS ***
MostlyGravy: raises $0.10 to $0.20
schnu111: folds 
romanromanro: folds 
Eneichik: calls $0.15
bladezymcteague: folds 
*** FLOP *** [6h Th 7h]
Eneichik: bets $0.24
MostlyGravy: calls $0.24
*** TURN *** [6h Th 7h] [4c]
Eneichik: bets $0.50
MostlyGravy: folds 
Uncalled bet ($0.50) returned to Eneichik
Eneichik collected $0.94 from pot
Eneichik: doesn't show hand 
*** SUMMARY ***
Total pot $0.98 | Rake $0.04 
Board [6h Th 7h 4c]
Seat 1: schnu111 folded before Flop (didn't bet)
Seat 2: romanromanro (button) folded before Flop (didn't bet)
Seat 3: Eneichik (small blind) collected ($0.94)
Seat 4: bladezymcteague (big blind) folded before Flop
Seat 5: MostlyGravy folded on the Turn



PokerStars Hand #222949039020:  Hold'em No Limit ($0.05/$0.10 USD) - 2021/01/23 4:52:42 ET
Table 'Malzovia III' 6-max Seat #3 is the button
Seat 1: schnu111 ($10 in chips) 
Seat 2: romanromanro ($10 in chips) 
Seat 3: Eneichik ($12.44 in chips) 
Seat 4: bladezymcteague ($10 in chips) 
Seat 5: MostlyGravy ($26.45 in chips) 
bladezymcteague: posts small blind $0.05
MostlyGravy: posts big blind $0.10
negritos81: sits out 
*** HOLE CARDS ***
schnu111: raises $0.20 to $0.30
romanromanro: folds 
Eneichik: folds 
Eneichik leaves the table
GrinZwe91! joins the table at seat #3 
bladezymcteague: calls $0.25
MostlyGravy: folds 
*** FLOP *** [Ts Kh 5h]
bladezymcteague: bets $0.34
schnu111: raises $0.68 to $1.02
bladezymcteague: calls $0.68
*** TURN *** [Ts Kh 5h] [Js]
bladezymcteague: checks 
romanromanro was removed from the table for failing to post
romanromanro leaves the table
schnu111: bets $1.75
kimmarusa joins the table at seat #2 
bladezymcteague: calls $1.75
*** RIVER *** [Ts Kh 5h Js] [9d]
bladezymcteague: checks 
schnu111: checks 
*** SHOW DOWN ***
bladezymcteague: shows [Ah 8h] (high card Ace)
schnu111: shows [Td Kc] (two pair, Kings and Tens)
schnu111 collected $5.96 from pot
*** SUMMARY ***
Total pot $6.24 | Rake $0.28 
Board [Ts Kh 5h Js 9d]
Seat 1: schnu111 showed [Td Kc] and won ($5.96) with two pair, Kings and Tens
Seat 2: romanromanro folded before Flop (didn't bet)
Seat 3: Eneichik (button) folded before Flop (didn't bet)
Seat 4: bladezymcteague (small blind) showed [Ah 8h] and lost with high card Ace
Seat 5: MostlyGravy (big blind) folded before Flop



PokerStars Hand #222949057529:  Hold'em No Limit ($0.05/$0.10 USD) - 2021/01/23 4:53:47 ET
Table 'Malzovia III' 6-max Seat #4 is the button
Seat 1: schnu111 ($12.89 in chips) 
Seat 4: bladezymcteague ($6.93 in chips) 
Seat 5: MostlyGravy ($26.35 in chips) 
Seat 6: negritos81 ($12.27 in chips) 
MostlyGravy: posts small blind $0.05
negritos81: posts big blind $0.10
kimmarusa: sits out 
GrinZwe91!: sits out 
*** HOLE CARDS ***
schnu111: folds 
bladezymcteague: calls $0.10
MostlyGravy: raises $0.20 to $0.30
negritos81: folds 
bladezymcteague: folds 
Uncalled bet ($0.20) returned to MostlyGravy
MostlyGravy collected $0.30 from pot
MostlyGravy: doesn't show hand 
*** SUMMARY ***
Total pot $0.30 | Rake $0 
Seat 1: schnu111 folded before Flop (didn't bet)
Seat 4: bladezymcteague (button) folded before Flop
Seat 5: MostlyGravy (small blind) collected ($0.30)
Seat 6: negritos81 (big blind) folded before Flop



PokerStars Hand #222949066646:  Hold'em No Limit ($0.05/$0.10 USD) - 2021/01/23 4:54:19 ET
Table 'Malzovia III' 6-max Seat #5 is the button
Seat 1: schnu111 ($12.89 in chips) 
Seat 4: bladezymcteague ($9.90 in chips) 
Seat 5: MostlyGravy ($26.55 in chips) 
Seat 6: negritos81 ($12.17 in chips) 
negritos81: posts small blind $0.05
schnu111: posts big blind $0.10
kimmarusa: sits out 
GrinZwe91!: sits out 
*** HOLE CARDS ***
bladezymcteague: calls $0.10
MostlyGravy: folds 
negritos81: folds 
schnu111: checks 
*** FLOP *** [4c 6c Th]
schnu111: checks 
bladezymcteague: checks 
*** TURN *** [4c 6c Th] [4s]
schnu111: checks 
bladezymcteague: checks 
*** RIVER *** [4c 6c Th 4s] [Td]
schnu111: bets $0.18
bladezymcteague: calls $0.18
*** SHOW DOWN ***
schnu111: shows [8h Tc] (a full house, Tens full of Fours)
bladezymcteague: mucks hand 
schnu111 collected $0.58 from pot
*** SUMMARY ***
Total pot $0.61 | Rake $0.03 
Board [4c 6c Th 4s Td]
Seat 1: schnu111 (big blind) showed [8h Tc] and won ($0.58) with a full house, Tens full of Fours
Seat 4: bladezymcteague mucked
Seat 5: MostlyGravy (button) folded before Flop (didn't bet)
Seat 6: negritos81 (small blind) folded before Flop



PokerStars Hand #222949076075:  Hold'em No Limit ($0.05/$0.10 USD) - 2021/01/23 4:54:53 ET
Table 'Malzovia III' 6-max Seat #6 is the button
Seat 1: schnu111 ($13.19 in chips) 
Seat 2: kimmarusa ($8 in chips) 
Seat 4: bladezymcteague ($9.62 in chips) 
Seat 5: MostlyGravy ($26.55 in chips) 
Seat 6: negritos81 ($12.12 in chips) 
schnu111: posts small blind $0.05
kimmarusa: posts big blind $0.10
GrinZwe91!: sits out 
*** HOLE CARDS ***
bladezymcteague: folds 
MostlyGravy: folds 
negritos81: raises $0.20 to $0.30
schnu111: folds 
kimmarusa: calls $0.20
*** FLOP *** [2s 8d As]
kimmarusa: checks 
negritos81: bets $0.20
kimmarusa: folds 
Uncalled bet ($0.20) returned to negritos81
negritos81 collected $0.62 from pot
negritos81: doesn't show hand 
*** SUMMARY ***
Total pot $0.65 | Rake $0.03 
Board [2s 8d As]
Seat 1: schnu111 (small blind) folded before Flop
Seat 2: kimmarusa (big blind) folded on the Flop
Seat 4: bladezymcteague folded before Flop (didn't bet)
Seat 5: MostlyGravy folded before Flop (didn't bet)
Seat 6: negritos81 (button) collected ($0.62)



PokerStars Hand #222949085233:  Hold'em No Limit ($0.05/$0.10 USD) - 2021/01/23 4:55:29 ET
Table 'Malzovia III' 6-max Seat #1 is the button
Seat 1: schnu111 ($13.14 in chips) 
Seat 2: kimmarusa ($7.70 in chips) 
Seat 3: GrinZwe91! ($10 in chips) 
Seat 4: bladezymcteague ($9.62 in chips) 
Seat 5: MostlyGravy ($26.55 in chips) 
Seat 6: negritos81 ($12.44 in chips) 
kimmarusa: posts small blind $0.05
GrinZwe91!: posts big blind $0.10
*** HOLE CARDS ***
bladezymcteague: folds 
MostlyGravy: raises $0.10 to $0.20
negritos81: folds 
schnu111: folds 
kimmarusa: folds 
GrinZwe91!: folds 
Uncalled bet ($0.10) returned to MostlyGravy
MostlyGravy collected $0.25 from pot
MostlyGravy: doesn't show hand 
*** SUMMARY ***
Total pot $0.25 | Rake $0 
Seat 1: schnu111 (button) folded before Flop (didn't bet)
Seat 2: kimmarusa (small blind) folded before Flop
Seat 3: GrinZwe91! (big blind) folded before Flop
Seat 4: bladezymcteague folded before Flop (didn't bet)
Seat 5: MostlyGravy collected ($0.25)
Seat 6: negritos81 folded before Flop (didn't bet)



PokerStars Hand #222949090477:  Hold'em No Limit ($0.05/$0.10 USD) - 2021/01/23 4:55:51 ET
Table 'Malzovia III' 6-max Seat #2 is the button
Seat 1: schnu111 ($13.14 in chips) 
Seat 2: kimmarusa ($7.65 in chips) 
Seat 3: GrinZwe91! ($10 in chips) 
Seat 4: bladezymcteague ($9.62 in chips) 
Seat 5: MostlyGravy ($26.70 in chips) 
Seat 6: negritos81 ($12.44 in chips) 
GrinZwe91!: posts small blind $0.05
bladezymcteague: posts big blind $0.10
*** HOLE CARDS ***
MostlyGravy: folds 
negritos81: folds 
schnu111: folds 
kimmarusa: raises $0.20 to $0.30
GrinZwe91!: folds 
bladezymcteague: folds 
Uncalled bet ($0.20) returned to kimmarusa
kimmarusa collected $0.25 from pot
kimmarusa: doesn't show hand 
*** SUMMARY ***
Total pot $0.25 | Rake $0 
Seat 1: schnu111 folded before Flop (didn't bet)
Seat 2: kimmarusa (button) collected ($0.25)
Seat 3: GrinZwe91! (small blind) folded before Flop
Seat 4: bladezymcteague (big blind) folded before Flop
Seat 5: MostlyGravy folded before Flop (didn't bet)
Seat 6: negritos81 folded before Flop (didn't bet)



PokerStars Hand #222949094300:  Hold'em No Limit ($0.05/$0.10 USD) - 2021/01/23 4:56:07 ET
Table 'Malzovia III' 6-max Seat #3 is the button
Seat 1: schnu111 ($13.14 in chips) 
Seat 2: kimmarusa ($7.80 in chips) 
Seat 3: GrinZwe91! ($10 in chips) 
Seat 4: bladezymcteague ($9.52 in chips) 
Seat 5: MostlyGravy ($26.70 in chips) 
Seat 6: negritos81 ($12.44 in chips) 
bladezymcteague: posts small blind $0.05
MostlyGravy: posts big blind $0.10
*** HOLE CARDS ***
negritos81: folds 
schnu111: raises $0.20 to $0.30
kimmarusa: folds 
GrinZwe91!: folds 
bladezymcteague: folds 
MostlyGravy: calls $0.20
*** FLOP *** [7s 4c 4d]
MostlyGravy: bets $0.31
schnu111: folds 
Uncalled bet ($0.31) returned to MostlyGravy
MostlyGravy collected $0.62 from pot
MostlyGravy: doesn't show hand 
*** SUMMARY ***
Total pot $0.65 | Rake $0.03 
Board [7s 4c 4d]
Seat 1: schnu111 folded on the Flop
Seat 2: kimmarusa folded before Flop (didn't bet)
Seat 3: GrinZwe91! (button) folded before Flop (didn't bet)
Seat 4: bladezymcteague (small blind) folded before Flop
Seat 5: MostlyGravy (big blind) collected ($0.62)
Seat 6: negritos81 folded before Flop (didn't bet)



PokerStars Hand #222949102768:  Hold'em No Limit ($0.05/$0.10 USD) - 2021/01/23 4:56:43 ET
Table 'Malzovia III' 6-max Seat #4 is the button
Seat 1: schnu111 ($12.84 in chips) 
Seat 2: kimmarusa ($7.80 in chips) 
Seat 3: GrinZwe91! ($10 in chips) 
Seat 4: bladezymcteague ($9.47 in chips) 
Seat 5: MostlyGravy ($27.02 in chips) 
Seat 6: negritos81 ($12.44 in chips) 
MostlyGravy: posts small blind $0.05
negritos81: posts big blind $0.10
*** HOLE CARDS ***
schnu111: folds 
kimmarusa: folds 
GrinZwe91!: raises $0.20 to $0.30
bladezymcteague: calls $0.30
MostlyGravy: calls $0.25
negritos81: folds 
*** FLOP *** [2c Qd Qs]
MostlyGravy: checks 
GrinZwe91!: checks 
bladezymcteague: checks 
*** TURN *** [2c Qd Qs] [Jd]
MostlyGravy: bets $0.48
GrinZwe91!: folds 
bladezymcteague: folds 
Uncalled bet ($0.48) returned to MostlyGravy
MostlyGravy collected $0.96 from pot
MostlyGravy: doesn't show hand 
*** SUMMARY ***
Total pot $1 | Rake $0.04 
Board [2c Qd Qs Jd]
Seat 1: schnu111 folded before Flop (didn't bet)
Seat 2: kimmarusa folded before Flop (didn't bet)
Seat 3: GrinZwe91! folded on the Turn
Seat 4: bladezymcteague (button) folded on the Turn
Seat 5: MostlyGravy (small blind) collected ($0.96)
Seat 6: negritos81 (big blind) folded before Flop



PokerStars Hand #222949115551:  Hold'em No Limit ($0.05/$0.10 USD) - 2021/01/23 4:57:36 ET
Table 'Malzovia III' 6-max Seat #5 is the button
Seat 1: schnu111 ($12.84 in chips) 
Seat 2: kimmarusa ($7.80 in chips) 
Seat 3: GrinZwe91! ($10 in chips) 
Seat 4: bladezymcteague ($9.17 in chips) 
Seat 5: MostlyGravy ($27.68 in chips) 
Seat 6: negritos81 ($12.34 in chips) 
negritos81: posts small blind $0.05
schnu111: posts big blind $0.10
*** HOLE CARDS ***
kimmarusa: folds 
GrinZwe91!: raises $0.20 to $0.30
bladezymcteague: folds 
MostlyGravy: folds 
negritos81: folds 
schnu111: folds 
Uncalled bet ($0.20) returned to GrinZwe91!
GrinZwe91! collected $0.25 from pot
GrinZwe91!: doesn't show hand 
*** SUMMARY ***
Total pot $0.25 | Rake $0 
Seat 1: schnu111 (big blind) folded before Flop
Seat 2: kimmarusa folded before Flop (didn't bet)
Seat 3: GrinZwe91! collected ($0.25)
Seat 4: bladezymcteague folded before Flop (didn't bet)
Seat 5: MostlyGravy (button) folded before Flop (didn't bet)
Seat 6: negritos81 (small blind) folded before Flop



PokerStars Hand #222949119422:  Hold'em No Limit ($0.05/$0.10 USD) - 2021/01/23 4:57:52 ET
Table 'Malzovia III' 6-max Seat #6 is the button
Seat 1: schnu111 ($12.74 in chips) 
Seat 2: kimmarusa ($7.80 in chips) 
Seat 3: GrinZwe91! ($10.15 in chips) 
Seat 4: bladezymcteague ($9.17 in chips) 
Seat 5: MostlyGravy ($27.68 in chips) 
Seat 6: negritos81 ($12.29 in chips) 
schnu111: posts small blind $0.05
kimmarusa: posts big blind $0.10
*** HOLE CARDS ***
GrinZwe91!: folds 
bladezymcteague: folds 
MostlyGravy: folds 
negritos81: folds 
schnu111: raises $0.15 to $0.25
kimmarusa: calls $0.15
*** FLOP *** [Jh 9c Js]
schnu111: bets $0.36
kimmarusa: calls $0.36
*** TURN *** [Jh 9c Js] [3d]
schnu111: checks 
kimmarusa: checks 
*** RIVER *** [Jh 9c Js 3d] [6c]
schnu111: checks 
kimmarusa: bets $0.60
schnu111: raises $0.60 to $1.20
kimmarusa: raises $1.60 to $2.80
schnu111: calls $1.60
*** SHOW DOWN ***
kimmarusa: shows [Jc 9s] (a full house, Jacks full of Nines)
schnu111: mucks hand 
kimmarusa collected $6.51 from pot
*** SUMMARY ***
Total pot $6.82 | Rake $0.31 
Board [Jh 9c Js 3d 6c]
Seat 1: schnu111 (small blind) mucked
Seat 2: kimmarusa (big blind) showed [Jc 9s] and won ($6.51) with a full house, Jacks full of Nines
Seat 3: GrinZwe91! folded before Flop (didn't bet)
Seat 4: bladezymcteague folded before Flop (didn't bet)
Seat 5: MostlyGravy folded before Flop (didn't bet)
Seat 6: negritos81 (button) folded before Flop (didn't bet)



PokerStars Hand #222949134848:  Hold'em No Limit ($0.05/$0.10 USD) - 2021/01/23 4:58:56 ET
Table 'Malzovia III' 6-max Seat #1 is the button
Seat 1: schnu111 ($10 in chips) 
Seat 2: kimmarusa ($10.90 in chips) 
Seat 3: GrinZwe91! ($10.15 in chips) 
Seat 4: bladezymcteague ($9.17 in chips) 
Seat 5: MostlyGravy ($27.68 in chips) 
Seat 6: negritos81 ($12.29 in chips) 
kimmarusa: posts small blind $0.05
GrinZwe91!: posts big blind $0.10
*** HOLE CARDS ***
bladezymcteague: folds 
MostlyGravy: raises $0.20 to $0.30
negritos81: raises $0.80 to $1.10
schnu111: folds 
kimmarusa: folds 
GrinZwe91!: raises $2 to $3.10
MostlyGravy: folds 
negritos81: folds 
Uncalled bet ($2) returned to GrinZwe91!
GrinZwe91! collected $2.55 from pot
GrinZwe91!: doesn't show hand 
*** SUMMARY ***
Total pot $2.55 | Rake $0 
Seat 1: schnu111 (button) folded before Flop (didn't bet)
Seat 2: kimmarusa (small blind) folded before Flop
Seat 3: GrinZwe91! (big blind) collected ($2.55)
Seat 4: bladezymcteague folded before Flop (didn't bet)
Seat 5: MostlyGravy folded before Flop
Seat 6: negritos81 folded before Flop



PokerStars Hand #222949148417:  Hold'em No Limit ($0.05/$0.10 USD) - 2021/01/23 4:59:53 ET
Table 'Malzovia III' 6-max Seat #2 is the button
Seat 1: schnu111 ($10 in chips) 
Seat 2: kimmarusa ($10.85 in chips) 
Seat 3: GrinZwe91! ($11.60 in chips) 
Seat 4: bladezymcteague ($9.17 in chips) 
Seat 5: MostlyGravy ($27.38 in chips) 
Seat 6: negritos81 ($11.19 in chips) 
GrinZwe91!: posts small blind $0.05
bladezymcteague: posts big blind $0.10
*** HOLE CARDS ***
MostlyGravy: calls $0.10
negritos81: folds 
schnu111: folds 
kimmarusa: folds 
GrinZwe91!: folds 
bladezymcteague: checks 
*** FLOP *** [Kd Ac 2s]
bladezymcteague: checks 
MostlyGravy: bets $0.24
bladezymcteague: folds 
Uncalled bet ($0.24) returned to MostlyGravy
MostlyGravy collected $0.24 from pot
MostlyGravy: doesn't show hand 
*** SUMMARY ***
Total pot $0.25 | Rake $0.01 
Board [Kd Ac 2s]
Seat 1: schnu111 folded before Flop (didn't bet)
Seat 2: kimmarusa (button) folded before Flop (didn't bet)
Seat 3: GrinZwe91! (small blind) folded before Flop
Seat 4: bladezymcteague (big blind) folded on the Flop
Seat 5: MostlyGravy collected ($0.24)
Seat 6: negritos81 folded before Flop (didn't bet)



PokerStars Hand #222949154937:  Hold'em No Limit ($0.05/$0.10 USD) - 2021/01/23 5:00:19 ET
Table 'Malzovia III' 6-max Seat #3 is the button
Seat 1: schnu111 ($10 in chips) 
Seat 2: kimmarusa ($10.85 in chips) 
Seat 3: GrinZwe91! ($11.55 in chips) 
Seat 4: bladezymcteague ($9.07 in chips) 
Seat 5: MostlyGravy ($27.52 in chips) 
bladezymcteague: posts small blind $0.05
MostlyGravy: posts big blind $0.10
*** HOLE CARDS ***
schnu111: folds 
kimmarusa: folds 
GrinZwe91!: raises $0.20 to $0.30
bladezymcteague: folds 
MostlyGravy: calls $0.20
*** FLOP *** [Qd Ah 7c]
MostlyGravy: bets $0.31
GrinZwe91!: folds 
Uncalled bet ($0.31) returned to MostlyGravy
MostlyGravy collected $0.62 from pot
MostlyGravy: doesn't show hand 
*** SUMMARY ***
Total pot $0.65 | Rake $0.03 
Board [Qd Ah 7c]
Seat 1: schnu111 folded before Flop (didn't bet)
Seat 2: kimmarusa folded before Flop (didn't bet)
Seat 3: GrinZwe91! (button) folded on the Flop
Seat 4: bladezymcteague (small blind) folded before Flop
Seat 5: MostlyGravy (big blind) collected ($0.62)



PokerStars Hand #222949167495:  Hold'em No Limit ($0.05/$0.10 USD) - 2021/01/23 5:01:06 ET
Table 'Malzovia III' 6-max Seat #4 is the button
Seat 1: schnu111 ($10 in chips) 
Seat 2: kimmarusa ($10.85 in chips) 
Seat 3: GrinZwe91! ($11.25 in chips) 
Seat 4: bladezymcteague ($9.02 in chips) 
Seat 5: MostlyGravy ($27.84 in chips) 
MostlyGravy: posts small blind $0.05
schnu111: posts big blind $0.10
*** HOLE CARDS ***
kimmarusa: folds 
GrinZwe91!: folds 
bladezymcteague: folds 
MostlyGravy: raises $0.10 to $0.20
schnu111: folds 
Uncalled bet ($0.10) returned to MostlyGravy
MostlyGravy collected $0.20 from pot
MostlyGravy: doesn't show hand 
*** SUMMARY ***
Total pot $0.20 | Rake $0 
Seat 1: schnu111 (big blind) folded before Flop
Seat 2: kimmarusa folded before Flop (didn't bet)
Seat 3: GrinZwe91! folded before Flop (didn't bet)
Seat 4: bladezymcteague (button) folded before Flop (didn't bet)
Seat 5: MostlyGravy (small blind) collected ($0.20)



PokerStars Hand #222949172311:  Hold'em No Limit ($0.05/$0.10 USD) - 2021/01/23 5:01:23 ET
Table 'Malzovia III' 6-max Seat #5 is the button
Seat 1: schnu111 ($10 in chips) 
Seat 2: kimmarusa ($10.85 in chips) 
Seat 3: GrinZwe91! ($11.25 in chips) 
Seat 4: bladezymcteague ($9.02 in chips) 
Seat 5: MostlyGravy ($27.94 in chips) 
schnu111: posts small blind $0.05
kimmarusa: posts big blind $0.10
*** HOLE CARDS ***
GrinZwe91!: raises $0.20 to $0.30
bladezymcteague: folds 
MostlyGravy: folds 
schnu111: folds 
kimmarusa: calls $0.20
*** FLOP *** [7c 9s 9h]
kimmarusa: checks 
GrinZwe91!: bets $0.31
kimmarusa: folds 
Uncalled bet ($0.31) returned to GrinZwe91!
GrinZwe91! collected $0.62 from pot
GrinZwe91!: doesn't show hand 
*** SUMMARY ***
Total pot $0.65 | Rake $0.03 
Board [7c 9s 9h]
Seat 1: schnu111 (small blind) folded before Flop
Seat 2: kimmarusa (big blind) folded on the Flop
Seat 3: GrinZwe91! collected ($0.62)
Seat 4: bladezymcteague folded before Flop (didn't bet)
Seat 5: MostlyGravy (button) folded before Flop (didn't bet)



PokerStars Hand #222949182926:  Hold'em No Limit ($0.05/$0.10 USD) - 2021/01/23 5:02:00 ET
Table 'Malzovia III' 6-max Seat #1 is the button
Seat 1: schnu111 ($10 in chips) 
Seat 2: kimmarusa ($10.55 in chips) 
Seat 3: GrinZwe91! ($11.57 in chips) 
Seat 4: bladezymcteague ($9.02 in chips) 
Seat 5: MostlyGravy ($27.94 in chips) 
kimmarusa: posts small blind $0.05
GrinZwe91!: posts big blind $0.10
negritos81: sits out 
*** HOLE CARDS ***
bladezymcteague: calls $0.10
MostlyGravy: folds 
schnu111: folds 
kimmarusa: folds 
GrinZwe91!: checks 
*** FLOP *** [5d 3c Qc]
GrinZwe91!: checks 
bladezymcteague: checks 
*** TURN *** [5d 3c Qc] [4d]
GrinZwe91!: bets $0.12
bladezymcteague: calls $0.12
*** RIVER *** [5d 3c Qc 4d] [4h]
GrinZwe91!: checks 
bladezymcteague: checks 
*** SHOW DOWN ***
GrinZwe91!: shows [5c 9c] (two pair, Fives and Fours)
bladezymcteague: mucks hand 
GrinZwe91! collected $0.47 from pot
*** SUMMARY ***
Total pot $0.49 | Rake $0.02 
Board [5d 3c Qc 4d 4h]
Seat 1: schnu111 (button) folded before Flop (didn't bet)
Seat 2: kimmarusa (small blind) folded before Flop
Seat 3: GrinZwe91! (big blind) showed [5c 9c] and won ($0.47) with two pair, Fives and Fours
Seat 4: bladezymcteague mucked
Seat 5: MostlyGravy folded before Flop (didn't bet)



PokerStars Hand #222949194240:  Hold'em No Limit ($0.05/$0.10 USD) - 2021/01/23 5:02:39 ET
Table 'Malzovia III' 6-max Seat #2 is the button
Seat 1: schnu111 ($10 in chips) 
Seat 2: kimmarusa ($10.50 in chips) 
Seat 3: GrinZwe91! ($11.82 in chips) 
Seat 4: bladezymcteague ($8.80 in chips) 
Seat 5: MostlyGravy ($27.94 in chips) 
GrinZwe91!: posts small blind $0.05
bladezymcteague: posts big blind $0.10
negritos81: sits out 
*** HOLE CARDS ***
MostlyGravy: raises $0.10 to $0.20
schnu111: folds 
kimmarusa: folds 
GrinZwe91!: folds 
bladezymcteague: folds 
Uncalled bet ($0.10) returned to MostlyGravy
MostlyGravy collected $0.25 from pot
MostlyGravy: doesn't show hand 
*** SUMMARY ***
Total pot $0.25 | Rake $0 
Seat 1: schnu111 folded before Flop (didn't bet)
Seat 2: kimmarusa (button) folded before Flop (didn't bet)
Seat 3: GrinZwe91! (small blind) folded before Flop
Seat 4: bladezymcteague (big blind) folded before Flop
Seat 5: MostlyGravy collected ($0.25)



PokerStars Hand #222949198283:  Hold'em No Limit ($0.05/$0.10 USD) - 2021/01/23 5:02:53 ET
Table 'Malzovia III' 6-max Seat #3 is the button
Seat 1: schnu111 ($10 in chips) 
Seat 2: kimmarusa ($10.50 in chips) 
Seat 3: GrinZwe91! ($11.77 in chips) 
Seat 4: bladezymcteague ($8.70 in chips) 
Seat 5: MostlyGravy ($28.09 in chips) 
bladezymcteague: posts small blind $0.05
MostlyGravy: posts big blind $0.10
negritos81: sits out 
*** HOLE CARDS ***
schnu111: folds 
kimmarusa: folds 
GrinZwe91!: raises $0.20 to $0.30
bladezymcteague: folds 
MostlyGravy: calls $0.20
*** FLOP *** [Js Tc Kh]
MostlyGravy: checks 
GrinZwe91!: bets $0.47
MostlyGravy: folds 
Uncalled bet ($0.47) returned to GrinZwe91!
GrinZwe91! collected $0.62 from pot
GrinZwe91!: doesn't show hand 
*** SUMMARY ***
Total pot $0.65 | Rake $0.03 
Board [Js Tc Kh]
Seat 1: schnu111 folded before Flop (didn't bet)
Seat 2: kimmarusa folded before Flop (didn't bet)
Seat 3: GrinZwe91! (button) collected ($0.62)
Seat 4: bladezymcteague (small blind) folded before Flop
Seat 5: MostlyGravy (big blind) folded on the Flop



PokerStars Hand #222949211606:  Hold'em No Limit ($0.05/$0.10 USD) - 2021/01/23 5:03:38 ET
Table 'Malzovia III' 6-max Seat #4 is the button
Seat 1: schnu111 ($10 in chips) 
Seat 2: kimmarusa ($10.50 in chips) 
Seat 3: GrinZwe91! ($12.09 in chips) 
Seat 4: bladezymcteague ($8.65 in chips) 
Seat 5: MostlyGravy ($27.79 in chips) 
Seat 6: negritos81 ($11.19 in chips) 
MostlyGravy: posts small blind $0.05
negritos81: posts big blind $0.10
*** HOLE CARDS ***
schnu111: folds 
kimmarusa: folds 
GrinZwe91!: folds 
bladezymcteague: folds 
MostlyGravy: raises $0.10 to $0.20
negritos81: calls $0.10
*** FLOP *** [8d 9c Kc]
MostlyGravy: bets $0.29
negritos81: calls $0.29
*** TURN *** [8d 9c Kc] [7c]
MostlyGravy: checks 
negritos81: checks 
*** RIVER *** [8d 9c Kc 7c] [9h]
MostlyGravy has timed out
MostlyGravy: checks 
negritos81: checks 
*** SHOW DOWN ***
MostlyGravy: shows [4s 2c] (a pair of Nines)
negritos81: shows [Td Ac] (a pair of Nines - Ace kicker)
negritos81 collected $0.94 from pot
*** SUMMARY ***
Total pot $0.98 | Rake $0.04 
Board [8d 9c Kc 7c 9h]
Seat 1: schnu111 folded before Flop (didn't bet)
Seat 2: kimmarusa folded before Flop (didn't bet)
Seat 3: GrinZwe91! folded before Flop (didn't bet)
Seat 4: bladezymcteague (button) folded before Flop (didn't bet)
Seat 5: MostlyGravy (small blind) showed [4s 2c] and lost with a pair of Nines
Seat 6: negritos81 (big blind) showed [Td Ac] and won ($0.94) with a pair of Nines



PokerStars Hand #222949243535:  Hold'em No Limit ($0.05/$0.10 USD) - 2021/01/23 5:05:27 ET
Table 'Malzovia III' 6-max Seat #5 is the button
Seat 1: schnu111 ($10 in chips) 
Seat 2: kimmarusa ($10.50 in chips) 
Seat 3: GrinZwe91! ($12.09 in chips) 
Seat 4: bladezymcteague ($8.65 in chips) 
Seat 5: MostlyGravy ($27.30 in chips) 
Seat 6: negritos81 ($11.64 in chips) 
negritos81: posts small blind $0.05
schnu111: posts big blind $0.10
*** HOLE CARDS ***
kimmarusa: folds 
GrinZwe91!: folds 
bladezymcteague: calls $0.10
MostlyGravy: folds 
negritos81: folds 
schnu111: checks 
*** FLOP *** [4s 9c 8s]
schnu111: checks 
bladezymcteague: checks 
*** TURN *** [4s 9c 8s] [Qd]
schnu111: checks 
bladezymcteague: bets $0.10
schnu111: folds 
Uncalled bet ($0.10) returned to bladezymcteague
bladezymcteague collected $0.24 from pot
bladezymcteague: doesn't show hand 
*** SUMMARY ***
Total pot $0.25 | Rake $0.01 
Board [4s 9c 8s Qd]
Seat 1: schnu111 (big blind) folded on the Turn
Seat 2: kimmarusa folded before Flop (didn't bet)
Seat 3: GrinZwe91! folded before Flop (didn't bet)
Seat 4: bladezymcteague collected ($0.24)
Seat 5: MostlyGravy (button) folded before Flop (didn't bet)
Seat 6: negritos81 (small blind) folded before Flop



PokerStars Hand #222949257085:  Hold'em No Limit ($0.05/$0.10 USD) - 2021/01/23 5:06:14 ET
Table 'Malzovia III' 6-max Seat #6 is the button
Seat 1: schnu111 ($10 in chips) 
Seat 2: kimmarusa ($10.50 in chips) 
Seat 3: GrinZwe91! ($12.09 in chips) 
Seat 4: bladezymcteague ($8.79 in chips) 
Seat 5: MostlyGravy ($27.30 in chips) 
Seat 6: negritos81 ($11.59 in chips) 
schnu111: posts small blind $0.05
kimmarusa: posts big blind $0.10
*** HOLE CARDS ***
GrinZwe91!: folds 
bladezymcteague: raises $0.20 to $0.30
MostlyGravy: folds 
negritos81: folds 
schnu111: raises $0.70 to $1
kimmarusa: folds 
bladezymcteague: calls $0.70
*** FLOP *** [5c 6s As]
schnu111: bets $1.34
bladezymcteague: raises $6.45 to $7.79 and is all-in
schnu111: folds 
Uncalled bet ($6.45) returned to bladezymcteague
bladezymcteague collected $4.56 from pot
bladezymcteague: doesn't show hand 
*** SUMMARY ***
Total pot $4.78 | Rake $0.22 
Board [5c 6s As]
Seat 1: schnu111 (small blind) folded on the Flop
Seat 2: kimmarusa (big blind) folded before Flop
Seat 3: GrinZwe91! folded before Flop (didn't bet)
Seat 4: bladezymcteague collected ($4.56)
Seat 5: MostlyGravy folded before Flop (didn't bet)
Seat 6: negritos81 (button) folded before Flop (didn't bet)



PokerStars Hand #222949272949:  Hold'em No Limit ($0.05/$0.10 USD) - 2021/01/23 5:07:08 ET
Table 'Malzovia III' 6-max Seat #1 is the button
Seat 1: schnu111 ($10 in chips) 
Seat 2: kimmarusa ($10.40 in chips) 
Seat 3: GrinZwe91! ($12.09 in chips) 
Seat 4: bladezymcteague ($11.01 in chips) 
Seat 5: MostlyGravy ($27.30 in chips) 
Seat 6: negritos81 ($11.59 in chips) 
kimmarusa: posts small blind $0.05
GrinZwe91!: posts big blind $0.10
*** HOLE CARDS ***
bladezymcteague: folds 
MostlyGravy: folds 
negritos81: folds 
schnu111: folds 
kimmarusa: folds 
Uncalled bet ($0.05) returned to GrinZwe91!
GrinZwe91! collected $0.10 from pot
GrinZwe91!: doesn't show hand 
*** SUMMARY ***
Total pot $0.10 | Rake $0 
Seat 1: schnu111 (button) folded before Flop (didn't bet)
Seat 2: kimmarusa (small blind) folded before Flop
Seat 3: GrinZwe91! (big blind) collected ($0.10)
Seat 4: bladezymcteague folded before Flop (didn't bet)
Seat 5: MostlyGravy folded before Flop (didn't bet)
Seat 6: negritos81 folded before Flop (didn't bet)



PokerStars Hand #222949276217:  Hold'em No Limit ($0.05/$0.10 USD) - 2021/01/23 5:07:19 ET
Table 'Malzovia III' 6-max Seat #2 is the button
Seat 1: schnu111 ($10 in chips) 
Seat 2: kimmarusa ($10.35 in chips) 
Seat 3: GrinZwe91! ($12.14 in chips) 
Seat 4: bladezymcteague ($11.01 in chips) 
Seat 5: MostlyGravy ($27.30 in chips) 
Seat 6: negritos81 ($11.59 in chips) 
GrinZwe91!: posts small blind $0.05
bladezymcteague: posts big blind $0.10
*** HOLE CARDS ***
MostlyGravy: calls $0.10
negritos81: folds 
schnu111: folds 
kimmarusa: raises $0.30 to $0.40
GrinZwe91!: folds 
bladezymcteague: folds 
MostlyGravy: calls $0.30
*** FLOP *** [9s 6s 9c]
MostlyGravy: bets $0.35
kimmarusa: raises $0.55 to $0.90
MostlyGravy: calls $0.55
*** TURN *** [9s 6s 9c] [6c]
MostlyGravy: checks 
kimmarusa: checks 
*** RIVER *** [9s 6s 9c 6c] [2h]
MostlyGravy: bets $1.50
kimmarusa: raises $2.50 to $4
MostlyGravy: folds 
Uncalled bet ($2.50) returned to kimmarusa
kimmarusa collected $5.49 from pot
kimmarusa: doesn't show hand 
*** SUMMARY ***
Total pot $5.75 | Rake $0.26 
Board [9s 6s 9c 6c 2h]
Seat 1: schnu111 folded before Flop (didn't bet)
Seat 2: kimmarusa (button) collected ($5.49)
Seat 3: GrinZwe91! (small blind) folded before Flop
Seat 4: bladezymcteague (big blind) folded before Flop
Seat 5: MostlyGravy folded on the River
Seat 6: negritos81 folded before Flop (didn't bet)



PokerStars Hand #222949316596:  Hold'em No Limit ($0.05/$0.10 USD) - 2021/01/23 5:09:37 ET
Table 'Malzovia III' 6-max Seat #3 is the button
Seat 1: schnu111 ($10 in chips) 
Seat 2: kimmarusa ($13.04 in chips) 
Seat 3: GrinZwe91! ($12.09 in chips) 
Seat 4: bladezymcteague ($10.91 in chips) 
Seat 5: MostlyGravy ($24.50 in chips) 
Seat 6: negritos81 ($11.59 in chips) 
bladezymcteague: posts small blind $0.05
MostlyGravy: posts big blind $0.10
*** HOLE CARDS ***
negritos81: folds 
schnu111: raises $0.20 to $0.30
kimmarusa: calls $0.30
GrinZwe91!: calls $0.30
bladezymcteague: calls $0.25
MostlyGravy: calls $0.20
*** FLOP *** [2h Ad Ts]
bladezymcteague: checks 
MostlyGravy: checks 
schnu111: checks 
kimmarusa: bets $0.90
GrinZwe91!: folds 
bladezymcteague: folds 
MostlyGravy: folds 
schnu111: folds 
Uncalled bet ($0.90) returned to kimmarusa
kimmarusa collected $1.43 from pot
kimmarusa: doesn't show hand 
*** SUMMARY ***
Total pot $1.50 | Rake $0.07 
Board [2h Ad Ts]
Seat 1: schnu111 folded on the Flop
Seat 2: kimmarusa collected ($1.43)
Seat 3: GrinZwe91! (button) folded on the Flop
Seat 4: bladezymcteague (small blind) folded on the Flop
Seat 5: MostlyGravy (big blind) folded on the Flop
Seat 6: negritos81 folded before Flop (didn't bet)



PokerStars Hand #222949332641:  Hold'em No Limit ($0.05/$0.10 USD) - 2021/01/23 5:10:31 ET
Table 'Malzovia III' 6-max Seat #4 is the button
Seat 1: schnu111 ($10 in chips) 
Seat 2: kimmarusa ($14.17 in chips) 
Seat 3: GrinZwe91! ($11.79 in chips) 
Seat 4: bladezymcteague ($10.61 in chips) 
Seat 5: MostlyGravy ($24.20 in chips) 
Seat 6: negritos81 ($11.59 in chips) 
MostlyGravy: posts small blind $0.05
negritos81: posts big blind $0.10
*** HOLE CARDS ***
schnu111: raises $0.20 to $0.30
kimmarusa: calls $0.30
GrinZwe91!: folds 
bladezymcteague: calls $0.30
MostlyGravy: folds 
negritos81: folds 
*** FLOP *** [Ac 3s Js]
schnu111: bets $0.75
kimmarusa: calls $0.75
bladezymcteague: folds 
*** TURN *** [Ac 3s Js] [5d]
schnu111: bets $1.83
kimmarusa: folds 
Uncalled bet ($1.83) returned to schnu111
schnu111 collected $2.44 from pot
schnu111: doesn't show hand 
*** SUMMARY ***
Total pot $2.55 | Rake $0.11 
Board [Ac 3s Js 5d]
Seat 1: schnu111 collected ($2.44)
Seat 2: kimmarusa folded on the Turn
Seat 3: GrinZwe91! folded before Flop (didn't bet)
Seat 4: bladezymcteague (button) folded on the Flop
Seat 5: MostlyGravy (small blind) folded before Flop
Seat 6: negritos81 (big blind) folded before Flop



PokerStars Hand #222949346073:  Hold'em No Limit ($0.05/$0.10 USD) - 2021/01/23 5:11:17 ET
Table 'Malzovia III' 6-max Seat #5 is the button
Seat 1: schnu111 ($11.39 in chips) 
Seat 2: kimmarusa ($13.12 in chips) 
Seat 3: GrinZwe91! ($11.79 in chips) 
Seat 4: bladezymcteague ($10.31 in chips) 
Seat 5: MostlyGravy ($24.15 in chips) 
Seat 6: negritos81 ($11.49 in chips) 
negritos81: posts small blind $0.05
schnu111: posts big blind $0.10
*** HOLE CARDS ***
kimmarusa: raises $0.20 to $0.30
GrinZwe91!: raises $0.60 to $0.90
bladezymcteague: folds 
MostlyGravy: folds 
negritos81: folds 
schnu111: folds 
kimmarusa: folds 
Uncalled bet ($0.60) returned to GrinZwe91!
GrinZwe91! collected $0.75 from pot
GrinZwe91!: doesn't show hand 
*** SUMMARY ***
Total pot $0.75 | Rake $0 
Seat 1: schnu111 (big blind) folded before Flop
Seat 2: kimmarusa folded before Flop
Seat 3: GrinZwe91! collected ($0.75)
Seat 4: bladezymcteague folded before Flop (didn't bet)
Seat 5: MostlyGravy (button) folded before Flop (didn't bet)
Seat 6: negritos81 (small blind) folded before Flop



PokerStars Hand #222949357099:  Hold'em No Limit ($0.05/$0.10 USD) - 2021/01/23 5:11:54 ET
Table 'Malzovia III' 6-max Seat #6 is the button
Seat 1: schnu111 ($11.29 in chips) 
Seat 2: kimmarusa ($12.82 in chips) 
Seat 3: GrinZwe91! ($12.24 in chips) 
Seat 4: bladezymcteague ($10.31 in chips) 
Seat 5: MostlyGravy ($24.15 in chips) 
Seat 6: negritos81 ($11.44 in chips) 
schnu111: posts small blind $0.05
kimmarusa: posts big blind $0.10
*** HOLE CARDS ***
GrinZwe91!: folds 
bladezymcteague: calls $0.10
MostlyGravy: calls $0.10
negritos81: folds 
schnu111: folds 
kimmarusa: checks 
*** FLOP *** [6d Kc 5h]
kimmarusa: bets $0.20
bladezymcteague: folds 
MostlyGravy: calls $0.20
*** TURN *** [6d Kc 5h] [4d]
kimmarusa: bets $0.40
MostlyGravy: raises $0.40 to $0.80
kimmarusa: calls $0.40
*** RIVER *** [6d Kc 5h 4d] [Qh]
kimmarusa: checks 
MostlyGravy: checks 
*** SHOW DOWN ***
kimmarusa: shows [7d Kd] (a pair of Kings)
MostlyGravy: mucks hand 
kimmarusa collected $2.24 from pot
*** SUMMARY ***
Total pot $2.35 | Rake $0.11 
Board [6d Kc 5h 4d Qh]
Seat 1: schnu111 (small blind) folded before Flop
Seat 2: kimmarusa (big blind) showed [7d Kd] and won ($2.24) with a pair of Kings
Seat 3: GrinZwe91! folded before Flop (didn't bet)
Seat 4: bladezymcteague folded on the Flop
Seat 5: MostlyGravy mucked
Seat 6: negritos81 (button) folded before Flop (didn't bet)



PokerStars Hand #222949381361:  Hold'em No Limit ($0.05/$0.10 USD) - 2021/01/23 5:13:16 ET
Table 'Malzovia III' 6-max Seat #1 is the button
Seat 1: schnu111 ($11.24 in chips) 
Seat 2: kimmarusa ($13.96 in chips) 
Seat 3: GrinZwe91! ($12.24 in chips) 
Seat 4: bladezymcteague ($10.21 in chips) 
Seat 5: MostlyGravy ($23.05 in chips) 
Seat 6: negritos81 ($11.44 in chips) 
kimmarusa: posts small blind $0.05
GrinZwe91!: posts big blind $0.10
*** HOLE CARDS ***
bladezymcteague: folds 
MostlyGravy: folds 
negritos81: folds 
schnu111: folds 
kimmarusa: raises $0.20 to $0.30
GrinZwe91!: folds 
Uncalled bet ($0.20) returned to kimmarusa
kimmarusa collected $0.20 from pot
*** SUMMARY ***
Total pot $0.20 | Rake $0 
Seat 1: schnu111 (button) folded before Flop (didn't bet)
Seat 2: kimmarusa (small blind) collected ($0.20)
Seat 3: GrinZwe91! (big blind) folded before Flop
Seat 4: bladezymcteague folded before Flop (didn't bet)
Seat 5: MostlyGravy folded before Flop (didn't bet)
Seat 6: negritos81 folded before Flop (didn't bet)



PokerStars Hand #222949387374:  Hold'em No Limit ($0.05/$0.10 USD) - 2021/01/23 5:13:37 ET
Table 'Malzovia III' 6-max Seat #2 is the button
Seat 1: schnu111 ($11.24 in chips) 
Seat 2: kimmarusa ($14.06 in chips) 
Seat 3: GrinZwe91! ($12.14 in chips) 
Seat 4: bladezymcteague ($10.21 in chips) 
Seat 5: MostlyGravy ($23.05 in chips) 
Seat 6: negritos81 ($11.44 in chips) 
GrinZwe91!: posts small blind $0.05
bladezymcteague: posts big blind $0.10
*** HOLE CARDS ***
MostlyGravy: folds 
negritos81: folds 
schnu111: folds 
kimmarusa is connected 
kimmarusa has timed out
kimmarusa: folds 
GrinZwe91!: folds 
Uncalled bet ($0.05) returned to bladezymcteague
bladezymcteague collected $0.10 from pot
bladezymcteague: doesn't show hand 
*** SUMMARY ***
Total pot $0.10 | Rake $0 
Seat 1: schnu111 folded before Flop (didn't bet)
Seat 2: kimmarusa (button) folded before Flop (didn't bet)
Seat 3: GrinZwe91! (small blind) folded before Flop
Seat 4: bladezymcteague (big blind) collected ($0.10)
Seat 5: MostlyGravy folded before Flop (didn't bet)
Seat 6: negritos81 folded before Flop (didn't bet)



PokerStars Hand #222949397053:  Hold'em No Limit ($0.05/$0.10 USD) - 2021/01/23 5:14:10 ET
Table 'Malzovia III' 6-max Seat #3 is the button
Seat 1: schnu111 ($11.24 in chips) 
Seat 2: kimmarusa ($14.06 in chips) 
Seat 3: GrinZwe91! ($12.09 in chips) 
Seat 4: bladezymcteague ($10.26 in chips) 
Seat 5: MostlyGravy ($23.05 in chips) 
Seat 6: negritos81 ($11.44 in chips) 
bladezymcteague: posts small blind $0.05
MostlyGravy: posts big blind $0.10
*** HOLE CARDS ***
negritos81: folds 
schnu111: folds 
kimmarusa: folds 
GrinZwe91!: folds 
bladezymcteague: calls $0.05
MostlyGravy: raises $0.20 to $0.30
bladezymcteague: calls $0.20
*** FLOP *** [3d 8s 4d]
bladezymcteague: bets $0.57
MostlyGravy: folds 
Uncalled bet ($0.57) returned to bladezymcteague
bladezymcteague collected $0.57 from pot
bladezymcteague: doesn't show hand 
*** SUMMARY ***
Total pot $0.60 | Rake $0.03 
Board [3d 8s 4d]
Seat 1: schnu111 folded before Flop (didn't bet)
Seat 2: kimmarusa folded before Flop (didn't bet)
Seat 3: GrinZwe91! (button) folded before Flop (didn't bet)
Seat 4: bladezymcteague (small blind) collected ($0.57)
Seat 5: MostlyGravy (big blind) folded on the Flop
Seat 6: negritos81 folded before Flop (didn't bet)



PokerStars Hand #222949406463:  Hold'em No Limit ($0.05/$0.10 USD) - 2021/01/23 5:14:42 ET
Table 'Malzovia III' 6-max Seat #4 is the button
Seat 1: schnu111 ($11.24 in chips) 
Seat 2: kimmarusa ($14.06 in chips) 
Seat 3: GrinZwe91! ($12.09 in chips) 
Seat 4: bladezymcteague ($10.53 in chips) 
Seat 5: MostlyGravy ($22.75 in chips) 
Seat 6: negritos81 ($11.44 in chips) 
MostlyGravy: posts small blind $0.05
negritos81: posts big blind $0.10
*** HOLE CARDS ***
schnu111: folds 
kimmarusa: raises $0.20 to $0.30
GrinZwe91!: folds 
bladezymcteague: folds 
bladezymcteague leaves the table
MostlyGravy: calls $0.25
negritos81: folds 
*** FLOP *** [Ks Kc 9s]
stylepointxoxo joins the table at seat #4 
MostlyGravy: bets $0.33
kimmarusa: folds 
Uncalled bet ($0.33) returned to MostlyGravy
MostlyGravy collected $0.67 from pot
MostlyGravy: doesn't show hand 
*** SUMMARY ***
Total pot $0.70 | Rake $0.03 
Board [Ks Kc 9s]
Seat 1: schnu111 folded before Flop (didn't bet)
Seat 2: kimmarusa folded on the Flop
Seat 3: GrinZwe91! folded before Flop (didn't bet)
Seat 4: bladezymcteague (button) folded before Flop (didn't bet)
Seat 5: MostlyGravy (small blind) collected ($0.67)
Seat 6: negritos81 (big blind) folded before Flop



PokerStars Hand #222949419463:  Hold'em No Limit ($0.05/$0.10 USD) - 2021/01/23 5:15:26 ET
Table 'Malzovia III' 6-max Seat #5 is the button
Seat 1: schnu111 ($11.24 in chips) 
Seat 2: kimmarusa ($13.76 in chips) 
Seat 3: GrinZwe91! ($12.09 in chips) 
Seat 5: MostlyGravy ($23.12 in chips) 
Seat 6: negritos81 ($11.34 in chips) 
negritos81: posts small blind $0.05
schnu111: posts big blind $0.10
stylepointxoxo: sits out 
*** HOLE CARDS ***
kimmarusa: folds 
GrinZwe91!: raises $0.20 to $0.30
MostlyGravy: calls $0.30
negritos81: folds 
schnu111: folds 
*** FLOP *** [2h As 8d]
GrinZwe91!: checks 
MostlyGravy: bets $0.46
GrinZwe91!: calls $0.46
*** TURN *** [2h As 8d] [Ac]
GrinZwe91!: checks 
MostlyGravy: bets $0.79
GrinZwe91!: folds 
Uncalled bet ($0.79) returned to MostlyGravy
MostlyGravy collected $1.59 from pot
MostlyGravy: doesn't show hand 
*** SUMMARY ***
Total pot $1.67 | Rake $0.08 
Board [2h As 8d Ac]
Seat 1: schnu111 (big blind) folded before Flop
Seat 2: kimmarusa folded before Flop (didn't bet)
Seat 3: GrinZwe91! folded on the Turn
Seat 5: MostlyGravy (button) collected ($1.59)
Seat 6: negritos81 (small blind) folded before Flop



PokerStars Hand #222949433914:  Hold'em No Limit ($0.05/$0.10 USD) - 2021/01/23 5:16:15 ET
Table 'Malzovia III' 6-max Seat #6 is the button
Seat 1: schnu111 ($11.14 in chips) 
Seat 2: kimmarusa ($13.76 in chips) 
Seat 3: GrinZwe91! ($11.33 in chips) 
Seat 5: MostlyGravy ($23.95 in chips) 
Seat 6: negritos81 ($11.29 in chips) 
schnu111: posts small blind $0.05
kimmarusa: posts big blind $0.10
stylepointxoxo: sits out 
*** HOLE CARDS ***
GrinZwe91!: folds 
MostlyGravy: folds 
negritos81: folds 
schnu111: folds 
Uncalled bet ($0.05) returned to kimmarusa
kimmarusa collected $0.10 from pot
kimmarusa: doesn't show hand 
*** SUMMARY ***
Total pot $0.10 | Rake $0 
Seat 1: schnu111 (small blind) folded before Flop
Seat 2: kimmarusa (big blind) collected ($0.10)
Seat 3: GrinZwe91! folded before Flop (didn't bet)
Seat 5: MostlyGravy folded before Flop (didn't bet)
Seat 6: negritos81 (button) folded before Flop (didn't bet)



PokerStars Hand #222949439862:  Hold'em No Limit ($0.05/$0.10 USD) - 2021/01/23 5:16:34 ET
Table 'Malzovia III' 6-max Seat #1 is the button
Seat 1: schnu111 ($11.09 in chips) 
Seat 2: kimmarusa ($13.81 in chips) 
Seat 3: GrinZwe91! ($11.33 in chips) 
Seat 5: MostlyGravy ($23.95 in chips) 
Seat 6: negritos81 ($11.29 in chips) 
kimmarusa: posts small blind $0.05
GrinZwe91!: posts big blind $0.10
stylepointxoxo: sits out 
*** HOLE CARDS ***
MostlyGravy: raises $0.20 to $0.30
negritos81: folds 
schnu111: folds 
kimmarusa: folds 
GrinZwe91!: folds 
Uncalled bet ($0.20) returned to MostlyGravy
MostlyGravy collected $0.25 from pot
MostlyGravy: doesn't show hand 
*** SUMMARY ***
Total pot $0.25 | Rake $0 
Seat 1: schnu111 (button) folded before Flop (didn't bet)
Seat 2: kimmarusa (small blind) folded before Flop
Seat 3: GrinZwe91! (big blind) folded before Flop
Seat 5: MostlyGravy collected ($0.25)
Seat 6: negritos81 folded before Flop (didn't bet)



PokerStars Hand #222949455273:  Hold'em No Limit ($0.05/$0.10 USD) - 2021/01/23 5:16:56 ET
Table 'Malzovia III' 6-max Seat #2 is the button
Seat 1: schnu111 ($11.09 in chips) 
Seat 2: kimmarusa ($13.76 in chips) 
Seat 3: GrinZwe91! ($11.23 in chips) 
Seat 4: stylepointxoxo ($10 in chips) 
Seat 5: MostlyGravy ($24.10 in chips) 
Seat 6: negritos81 ($11.29 in chips) 
GrinZwe91!: posts small blind $0.05
stylepointxoxo: posts big blind $0.10
*** HOLE CARDS ***
MostlyGravy: raises $0.10 to $0.20
negritos81: folds 
schnu111: folds 
kimmarusa: folds 
GrinZwe91!: folds 
stylepointxoxo: calls $0.10
*** FLOP *** [Td 9c 8h]
stylepointxoxo: checks 
MostlyGravy: bets $0.21
stylepointxoxo: calls $0.21
*** TURN *** [Td 9c 8h] [5s]
stylepointxoxo: checks 
MostlyGravy: checks 
*** RIVER *** [Td 9c 8h 5s] [2h]
stylepointxoxo: bets $0.40
MostlyGravy: folds 
Uncalled bet ($0.40) returned to stylepointxoxo
stylepointxoxo collected $0.83 from pot
stylepointxoxo: doesn't show hand 
*** SUMMARY ***
Total pot $0.87 | Rake $0.04 
Board [Td 9c 8h 5s 2h]
Seat 1: schnu111 folded before Flop (didn't bet)
Seat 2: kimmarusa (button) folded before Flop (didn't bet)
Seat 3: GrinZwe91! (small blind) folded before Flop
Seat 4: stylepointxoxo (big blind) collected ($0.83)
Seat 5: MostlyGravy folded on the River
Seat 6: negritos81 folded before Flop (didn't bet)



PokerStars Hand #222949469549:  Hold'em No Limit ($0.05/$0.10 USD) - 2021/01/23 5:17:44 ET
Table 'Malzovia III' 6-max Seat #3 is the button
Seat 1: schnu111 ($11.09 in chips) 
Seat 2: kimmarusa ($13.76 in chips) 
Seat 3: GrinZwe91! ($11.18 in chips) 
Seat 4: stylepointxoxo ($10.42 in chips) 
Seat 5: MostlyGravy ($23.69 in chips) 
Seat 6: negritos81 ($11.29 in chips) 
stylepointxoxo: posts small blind $0.05
MostlyGravy: posts big blind $0.10
*** HOLE CARDS ***
negritos81 has timed out
negritos81: folds 
schnu111: folds 
kimmarusa: folds 
GrinZwe91!: folds 
stylepointxoxo: raises $0.20 to $0.30
MostlyGravy: calls $0.20
*** FLOP *** [4c 2s Td]
stylepointxoxo: bets $0.20
kimmarusa is disconnected 
MostlyGravy: calls $0.20
*** TURN *** [4c 2s Td] [Kh]
stylepointxoxo: bets $0.71
MostlyGravy: folds 
Uncalled bet ($0.71) returned to stylepointxoxo
stylepointxoxo collected $0.96 from pot
stylepointxoxo: doesn't show hand 
*** SUMMARY ***
Total pot $1 | Rake $0.04 
Board [4c 2s Td Kh]
Seat 1: schnu111 folded before Flop (didn't bet)
Seat 2: kimmarusa folded before Flop (didn't bet)
Seat 3: GrinZwe91! (button) folded before Flop (didn't bet)
Seat 4: stylepointxoxo (small blind) collected ($0.96)
Seat 5: MostlyGravy (big blind) folded on the Turn
Seat 6: negritos81 folded before Flop (didn't bet)



PokerStars Hand #222949487976:  Hold'em No Limit ($0.05/$0.10 USD) - 2021/01/23 5:18:46 ET
Table 'Malzovia III' 6-max Seat #4 is the button
Seat 1: schnu111 ($11.09 in chips) 
Seat 2: kimmarusa ($13.76 in chips) 
Seat 3: GrinZwe91! ($11.18 in chips) 
Seat 4: stylepointxoxo ($10.88 in chips) 
Seat 5: MostlyGravy ($23.19 in chips) 
Seat 6: negritos81 ($11.29 in chips) 
MostlyGravy: posts small blind $0.05
negritos81: posts big blind $0.10
*** HOLE CARDS ***
schnu111: folds 
kimmarusa: raises $0.20 to $0.30
GrinZwe91!: folds 
stylepointxoxo: folds 
MostlyGravy: folds 
negritos81: folds 
Uncalled bet ($0.20) returned to kimmarusa
kimmarusa collected $0.25 from pot
kimmarusa: doesn't show hand 
*** SUMMARY ***
Total pot $0.25 | Rake $0 
Seat 1: schnu111 folded before Flop (didn't bet)
Seat 2: kimmarusa collected ($0.25)
Seat 3: GrinZwe91! folded before Flop (didn't bet)
Seat 4: stylepointxoxo (button) folded before Flop (didn't bet)
Seat 5: MostlyGravy (small blind) folded before Flop
Seat 6: negritos81 (big blind) folded before Flop



PokerStars Hand #222949492251:  Hold'em No Limit ($0.05/$0.10 USD) - 2021/01/23 5:19:00 ET
Table 'Malzovia III' 6-max Seat #5 is the button
Seat 1: schnu111 ($11.09 in chips) 
Seat 2: kimmarusa ($13.91 in chips) 
Seat 3: GrinZwe91! ($11.18 in chips) 
Seat 4: stylepointxoxo ($10.88 in chips) 
Seat 5: MostlyGravy ($23.14 in chips) 
Seat 6: negritos81 ($11.19 in chips) 
negritos81: posts small blind $0.05
schnu111: posts big blind $0.10
*** HOLE CARDS ***
kimmarusa: folds 
GrinZwe91!: folds 
stylepointxoxo: folds 
MostlyGravy: raises $0.30 to $0.40
negritos81: folds 
schnu111: folds 
Uncalled bet ($0.30) returned to MostlyGravy
MostlyGravy collected $0.25 from pot
MostlyGravy: doesn't show hand 
*** SUMMARY ***
Total pot $0.25 | Rake $0 
Seat 1: schnu111 (big blind) folded before Flop
Seat 2: kimmarusa folded before Flop (didn't bet)
Seat 3: GrinZwe91! folded before Flop (didn't bet)
Seat 4: stylepointxoxo folded before Flop (didn't bet)
Seat 5: MostlyGravy (button) collected ($0.25)
Seat 6: negritos81 (small blind) folded before Flop



PokerStars Hand #222949499315:  Hold'em No Limit ($0.05/$0.10 USD) - 2021/01/23 5:19:24 ET
Table 'Malzovia III' 6-max Seat #6 is the button
Seat 1: schnu111 ($10.99 in chips) 
Seat 2: kimmarusa ($13.91 in chips) 
Seat 3: GrinZwe91! ($11.18 in chips) 
Seat 4: stylepointxoxo ($10.88 in chips) 
Seat 5: MostlyGravy ($23.29 in chips) 
Seat 6: negritos81 ($11.14 in chips) 
schnu111: posts small blind $0.05
kimmarusa: posts big blind $0.10
*** HOLE CARDS ***
GrinZwe91! has timed out
GrinZwe91!: folds 
stylepointxoxo: raises $0.15 to $0.25
MostlyGravy: folds 
negritos81: folds 
schnu111: folds 
kimmarusa: folds 
Uncalled bet ($0.15) returned to stylepointxoxo
stylepointxoxo collected $0.25 from pot
stylepointxoxo: doesn't show hand 
*** SUMMARY ***
Total pot $0.25 | Rake $0 
Seat 1: schnu111 (small blind) folded before Flop
Seat 2: kimmarusa (big blind) folded before Flop
Seat 3: GrinZwe91! folded before Flop (didn't bet)
Seat 4: stylepointxoxo collected ($0.25)
Seat 5: MostlyGravy folded before Flop (didn't bet)
Seat 6: negritos81 (button) folded before Flop (didn't bet)



PokerStars Hand #222949507624:  Hold'em No Limit ($0.05/$0.10 USD) - 2021/01/23 5:19:51 ET
Table 'Malzovia III' 6-max Seat #1 is the button
Seat 1: schnu111 ($10.94 in chips) 
Seat 2: kimmarusa ($13.81 in chips) 
Seat 3: GrinZwe91! ($11.18 in chips) 
Seat 4: stylepointxoxo ($11.03 in chips) 
Seat 5: MostlyGravy ($23.29 in chips) 
Seat 6: negritos81 ($11.14 in chips) 
kimmarusa: posts small blind $0.05
GrinZwe91!: posts big blind $0.10
*** HOLE CARDS ***
stylepointxoxo: folds 
MostlyGravy: folds 
negritos81: folds 
schnu111: folds 
kimmarusa: folds 
Uncalled bet ($0.05) returned to GrinZwe91!
GrinZwe91! collected $0.10 from pot
GrinZwe91!: doesn't show hand 
*** SUMMARY ***
Total pot $0.10 | Rake $0 
Seat 1: schnu111 (button) folded before Flop (didn't bet)
Seat 2: kimmarusa (small blind) folded before Flop
Seat 3: GrinZwe91! (big blind) collected ($0.10)
Seat 4: stylepointxoxo folded before Flop (didn't bet)
Seat 5: MostlyGravy folded before Flop (didn't bet)
Seat 6: negritos81 folded before Flop (didn't bet)



PokerStars Hand #222949511706:  Hold'em No Limit ($0.05/$0.10 USD) - 2021/01/23 5:20:05 ET
Table 'Malzovia III' 6-max Seat #2 is the button
Seat 1: schnu111 ($10.94 in chips) 
Seat 2: kimmarusa ($13.76 in chips) 
Seat 3: GrinZwe91! ($11.23 in chips) 
Seat 4: stylepointxoxo ($11.03 in chips) 
Seat 5: MostlyGravy ($23.29 in chips) 
Seat 6: negritos81 ($11.14 in chips) 
GrinZwe91!: posts small blind $0.05
stylepointxoxo: posts big blind $0.10
*** HOLE CARDS ***
MostlyGravy: folds 
negritos81: folds 
schnu111: folds 
kimmarusa: folds 
GrinZwe91!: folds 
Uncalled bet ($0.05) returned to stylepointxoxo
stylepointxoxo collected $0.10 from pot
stylepointxoxo: doesn't show hand 
*** SUMMARY ***
Total pot $0.10 | Rake $0 
Seat 1: schnu111 folded before Flop (didn't bet)
Seat 2: kimmarusa (button) folded before Flop (didn't bet)
Seat 3: GrinZwe91! (small blind) folded before Flop
Seat 4: stylepointxoxo (big blind) collected ($0.10)
Seat 5: MostlyGravy folded before Flop (didn't bet)
Seat 6: negritos81 folded before Flop (didn't bet)



PokerStars Hand #222949519358:  Hold'em No Limit ($0.05/$0.10 USD) - 2021/01/23 5:20:30 ET
Table 'Malzovia III' 6-max Seat #4 is the button
Seat 1: schnu111 ($10.94 in chips) 
Seat 2: kimmarusa ($13.76 in chips) 
Seat 3: GrinZwe91! ($11.18 in chips) 
Seat 4: stylepointxoxo ($11.03 in chips) 
Seat 5: MostlyGravy ($23.34 in chips) 
Seat 6: negritos81 ($11.14 in chips) 
MostlyGravy: posts small blind $0.05
negritos81: posts big blind $0.10
*** HOLE CARDS ***
schnu111: raises $0.20 to $0.30
kimmarusa: folds 
GrinZwe91!: folds 
stylepointxoxo: folds 
MostlyGravy: folds 
negritos81: folds 
Uncalled bet ($0.20) returned to schnu111
schnu111 collected $0.25 from pot
schnu111: doesn't show hand 
*** SUMMARY ***
Total pot $0.25 | Rake $0 
Seat 1: schnu111 collected ($0.25)
Seat 2: kimmarusa folded before Flop (didn't bet)
Seat 3: GrinZwe91! folded before Flop (didn't bet)
Seat 4: stylepointxoxo (button) folded before Flop (didn't bet)
Seat 5: MostlyGravy (small blind) folded before Flop
Seat 6: negritos81 (big blind) folded before Flop



PokerStars Hand #222949524037:  Hold'em No Limit ($0.05/$0.10 USD) - 2021/01/23 5:20:46 ET
Table 'Malzovia III' 6-max Seat #5 is the button
Seat 1: schnu111 ($11.09 in chips) 
Seat 2: kimmarusa ($13.76 in chips) 
Seat 3: GrinZwe91! ($11.18 in chips) 
Seat 4: stylepointxoxo ($11.03 in chips) 
Seat 5: MostlyGravy ($23.29 in chips) 
Seat 6: negritos81 ($11.04 in chips) 
negritos81: posts small blind $0.05
schnu111: posts big blind $0.10
*** HOLE CARDS ***
kimmarusa: folds 
GrinZwe91!: folds 
stylepointxoxo: folds 
MostlyGravy: raises $0.20 to $0.30
negritos81: folds 
schnu111: calls $0.20
*** FLOP *** [7c 8c Qc]
schnu111: checks 
MostlyGravy: bets $0.62
schnu111: calls $0.62
*** TURN *** [7c 8c Qc] [Jc]
schnu111: checks 
MostlyGravy: checks 
*** RIVER *** [7c 8c Qc Jc] [9c]
schnu111: checks 
MostlyGravy: checks 
*** SHOW DOWN ***
schnu111: shows [7d 7s] (a flush, Queen high)
MostlyGravy: shows [Ts 2s] (a flush, Queen high)
schnu111 collected $0.90 from pot
MostlyGravy collected $0.90 from pot
*** SUMMARY ***
Total pot $1.89 | Rake $0.09 
Board [7c 8c Qc Jc 9c]
Seat 1: schnu111 (big blind) showed [7d 7s] and won ($0.90) with a flush, Queen high
Seat 2: kimmarusa folded before Flop (didn't bet)
Seat 3: GrinZwe91! folded before Flop (didn't bet)
Seat 4: stylepointxoxo folded before Flop (didn't bet)
Seat 5: MostlyGravy (button) showed [Ts 2s] and won ($0.90) with a flush, Queen high
Seat 6: negritos81 (small blind) folded before Flop



PokerStars Hand #222949543118:  Hold'em No Limit ($0.05/$0.10 USD) - 2021/01/23 5:21:49 ET
Table 'Malzovia III' 6-max Seat #6 is the button
Seat 1: schnu111 ($11.07 in chips) 
Seat 2: kimmarusa ($13.76 in chips) 
Seat 3: GrinZwe91! ($11.18 in chips) 
Seat 4: stylepointxoxo ($11.03 in chips) 
Seat 5: MostlyGravy ($23.27 in chips) 
Seat 6: negritos81 ($10.99 in chips) 
schnu111: posts small blind $0.05
kimmarusa: posts big blind $0.10
*** HOLE CARDS ***
GrinZwe91!: folds 
stylepointxoxo: folds 
MostlyGravy: folds 
negritos81: folds 
schnu111: folds 
Uncalled bet ($0.05) returned to kimmarusa
kimmarusa collected $0.10 from pot
kimmarusa: doesn't show hand 
*** SUMMARY ***
Total pot $0.10 | Rake $0 
Seat 1: schnu111 (small blind) folded before Flop
Seat 2: kimmarusa (big blind) collected ($0.10)
Seat 3: GrinZwe91! folded before Flop (didn't bet)
Seat 4: stylepointxoxo folded before Flop (didn't bet)
Seat 5: MostlyGravy folded before Flop (didn't bet)
Seat 6: negritos81 (button) folded before Flop (didn't bet)



PokerStars Hand #222949546989:  Hold'em No Limit ($0.05/$0.10 USD) - 2021/01/23 5:22:02 ET
Table 'Malzovia III' 6-max Seat #1 is the button
Seat 1: schnu111 ($11.02 in chips) 
Seat 2: kimmarusa ($13.81 in chips) 
Seat 3: GrinZwe91! ($11.18 in chips) 
Seat 4: stylepointxoxo ($11.03 in chips) 
Seat 5: MostlyGravy ($23.27 in chips) 
Seat 6: negritos81 ($10.99 in chips) 
kimmarusa: posts small blind $0.05
GrinZwe91!: posts big blind $0.10
*** HOLE CARDS ***
stylepointxoxo: folds 
MostlyGravy: folds 
negritos81: folds 
schnu111: folds 
kimmarusa: raises $0.20 to $0.30
GrinZwe91!: folds 
Uncalled bet ($0.20) returned to kimmarusa
kimmarusa collected $0.20 from pot
kimmarusa: doesn't show hand 
*** SUMMARY ***
Total pot $0.20 | Rake $0 
Seat 1: schnu111 (button) folded before Flop (didn't bet)
Seat 2: kimmarusa (small blind) collected ($0.20)
Seat 3: GrinZwe91! (big blind) folded before Flop
Seat 4: stylepointxoxo folded before Flop (didn't bet)
Seat 5: MostlyGravy folded before Flop (didn't bet)
Seat 6: negritos81 folded before Flop (didn't bet)



PokerStars Hand #222949553841:  Hold'em No Limit ($0.05/$0.10 USD) - 2021/01/23 5:22:24 ET
Table 'Malzovia III' 6-max Seat #2 is the button
Seat 1: schnu111 ($11.02 in chips) 
Seat 2: kimmarusa ($13.91 in chips) 
Seat 3: GrinZwe91! ($11.08 in chips) 
Seat 4: stylepointxoxo ($11.03 in chips) 
Seat 5: MostlyGravy ($23.27 in chips) 
Seat 6: negritos81 ($10.99 in chips) 
GrinZwe91!: posts small blind $0.05
stylepointxoxo: posts big blind $0.10
*** HOLE CARDS ***
MostlyGravy: folds 
negritos81: folds 
schnu111: folds 
kimmarusa: folds 
GrinZwe91!: folds 
Uncalled bet ($0.05) returned to stylepointxoxo
stylepointxoxo collected $0.10 from pot
stylepointxoxo: doesn't show hand 
*** SUMMARY ***
Total pot $0.10 | Rake $0 
Seat 1: schnu111 folded before Flop (didn't bet)
Seat 2: kimmarusa (button) folded before Flop (didn't bet)
Seat 3: GrinZwe91! (small blind) folded before Flop
Seat 4: stylepointxoxo (big blind) collected ($0.10)
Seat 5: MostlyGravy folded before Flop (didn't bet)
Seat 6: negritos81 folded before Flop (didn't bet)



PokerStars Hand #222949556738:  Hold'em No Limit ($0.05/$0.10 USD) - 2021/01/23 5:22:34 ET
Table 'Malzovia III' 6-max Seat #3 is the button
Seat 1: schnu111 ($11.02 in chips) 
Seat 2: kimmarusa ($13.91 in chips) 
Seat 3: GrinZwe91! ($11.03 in chips) 
Seat 4: stylepointxoxo ($11.08 in chips) 
Seat 5: MostlyGravy ($23.27 in chips) 
Seat 6: negritos81 ($10.99 in chips) 
stylepointxoxo: posts small blind $0.05
MostlyGravy: posts big blind $0.10
*** HOLE CARDS ***
negritos81 has timed out
negritos81: folds 
schnu111: raises $0.20 to $0.30
kimmarusa: folds 
GrinZwe91!: calls $0.30
stylepointxoxo: folds 
MostlyGravy: folds 
*** FLOP *** [Qs 6d Kc]
schnu111: checks 
GrinZwe91! is disconnected 
GrinZwe91! is connected 
GrinZwe91!: bets $0.40
schnu111: calls $0.40
*** TURN *** [Qs 6d Kc] [Qc]
schnu111: checks 
GrinZwe91!: checks 
*** RIVER *** [Qs 6d Kc Qc] [Td]
schnu111: checks 
GrinZwe91!: checks 
*** SHOW DOWN ***
schnu111: shows [5c 6c] (two pair, Queens and Sixes)
GrinZwe91!: shows [Ac Tc] (two pair, Queens and Tens)
GrinZwe91! collected $1.48 from pot
*** SUMMARY ***
Total pot $1.55 | Rake $0.07 
Board [Qs 6d Kc Qc Td]
Seat 1: schnu111 showed [5c 6c] and lost with two pair, Queens and Sixes
Seat 2: kimmarusa folded before Flop (didn't bet)
Seat 3: GrinZwe91! (button) showed [Ac Tc] and won ($1.48) with two pair, Queens and Tens
Seat 4: stylepointxoxo (small blind) folded before Flop
Seat 5: MostlyGravy (big blind) folded before Flop
Seat 6: negritos81 folded before Flop (didn't bet)



PokerStars Hand #222949583740:  Hold'em No Limit ($0.05/$0.10 USD) - 2021/01/23 5:24:03 ET
Table 'Malzovia III' 6-max Seat #4 is the button
Seat 2: kimmarusa ($13.91 in chips) 
Seat 3: GrinZwe91! ($11.81 in chips) 
Seat 4: stylepointxoxo ($11.03 in chips) 
Seat 5: MostlyGravy ($23.17 in chips) 
MostlyGravy: posts small blind $0.05
schnu111: is sitting out 
kimmarusa: posts big blind $0.10
*** HOLE CARDS ***
GrinZwe91!: folds 
schnu111 leaves the table
stylepointxoxo has timed out
stylepointxoxo: folds 
MostlyGravy: folds 
Uncalled bet ($0.05) returned to kimmarusa
kimmarusa collected $0.10 from pot
kimmarusa: doesn't show hand 
*** SUMMARY ***
Total pot $0.10 | Rake $0 
Seat 2: kimmarusa (big blind) collected ($0.10)
Seat 3: GrinZwe91! folded before Flop (didn't bet)
Seat 4: stylepointxoxo (button) folded before Flop (didn't bet)
Seat 5: MostlyGravy (small blind) folded before Flop



PokerStars Hand #222949589744:  Hold'em No Limit ($0.05/$0.10 USD) - 2021/01/23 5:24:23 ET
Table 'Malzovia III' 6-max Seat #5 is the button
Seat 2: kimmarusa ($13.96 in chips) 
Seat 3: GrinZwe91! ($11.81 in chips) 
Seat 4: stylepointxoxo ($11.03 in chips) 
Seat 5: MostlyGravy ($23.12 in chips) 
kimmarusa: posts small blind $0.05
GrinZwe91!: posts big blind $0.10
*** HOLE CARDS ***
stylepointxoxo: raises $0.15 to $0.25
MostlyGravy: folds 
kimmarusa: folds 
GrinZwe91!: folds 
Uncalled bet ($0.15) returned to stylepointxoxo
stylepointxoxo collected $0.25 from pot
Sheva26Rus joins the table at seat #1 
stylepointxoxo: doesn't show hand 
*** SUMMARY ***
Total pot $0.25 | Rake $0 
Seat 2: kimmarusa (small blind) folded before Flop
Seat 3: GrinZwe91! (big blind) folded before Flop
Seat 4: stylepointxoxo collected ($0.25)
Seat 5: MostlyGravy (button) folded before Flop (didn't bet)



PokerStars Hand #222949592911:  Hold'em No Limit ($0.05/$0.10 USD) - 2021/01/23 5:24:33 ET
Table 'Malzovia III' 6-max Seat #2 is the button
Seat 2: kimmarusa ($13.91 in chips) 
Seat 3: GrinZwe91! ($11.71 in chips) 
Seat 4: stylepointxoxo ($11.18 in chips) 
Seat 5: MostlyGravy ($23.12 in chips) 
GrinZwe91!: posts small blind $0.05
stylepointxoxo: posts big blind $0.10
Sheva26Rus: sits out 
*** HOLE CARDS ***
Sheva26Rus leaves the table
MostlyGravy: raises $0.20 to $0.30
kimmarusa: calls $0.30
favourble joins the table at seat #1 
GrinZwe91!: folds 
stylepointxoxo: calls $0.20
*** FLOP *** [7c Qc 8h]
stylepointxoxo: checks 
MostlyGravy: checks 
kimmarusa: checks 
*** TURN *** [7c Qc 8h] [9s]
stylepointxoxo: bets $0.67
MostlyGravy: folds 
kimmarusa: folds 
Uncalled bet ($0.67) returned to stylepointxoxo
stylepointxoxo collected $0.91 from pot
stylepointxoxo: doesn't show hand 
*** SUMMARY ***
Total pot $0.95 | Rake $0.04 
Board [7c Qc 8h 9s]
Seat 2: kimmarusa (button) folded on the Turn
Seat 3: GrinZwe91! (small blind) folded before Flop
Seat 4: stylepointxoxo (big blind) collected ($0.91)
Seat 5: MostlyGravy folded on the Turn



PokerStars Hand #222949607027:  Hold'em No Limit ($0.05/$0.10 USD) - 2021/01/23 5:25:20 ET
Table 'Malzovia III' 6-max Seat #3 is the button
Seat 2: kimmarusa ($13.61 in chips) 
Seat 3: GrinZwe91! ($11.66 in chips) 
Seat 4: stylepointxoxo ($11.79 in chips) 
Seat 5: MostlyGravy ($22.82 in chips) 
stylepointxoxo: posts small blind $0.05
MostlyGravy: posts big blind $0.10
negritos81: sits out 
favourble: sits out 
*** HOLE CARDS ***
kimmarusa: raises $0.20 to $0.30
GrinZwe91!: folds 
stylepointxoxo: folds 
MostlyGravy: calls $0.20
*** FLOP *** [8c 4c 2h]
MostlyGravy: bets $0.62
kimmarusa: calls $0.62
*** TURN *** [8c 4c 2h] [2s]
MostlyGravy: bets $1.80
kimmarusa: folds 
Uncalled bet ($1.80) returned to MostlyGravy
MostlyGravy collected $1.80 from pot
MostlyGravy: doesn't show hand 
*** SUMMARY ***
Total pot $1.89 | Rake $0.09 
Board [8c 4c 2h 2s]
Seat 2: kimmarusa folded on the Turn
Seat 3: GrinZwe91! (button) folded before Flop (didn't bet)
Seat 4: stylepointxoxo (small blind) folded before Flop
Seat 5: MostlyGravy (big blind) collected ($1.80)



PokerStars Hand #222949619803:  Hold'em No Limit ($0.05/$0.10 USD) - 2021/01/23 5:26:01 ET
Table 'Malzovia III' 6-max Seat #4 is the button
Seat 2: kimmarusa ($12.69 in chips) 
Seat 3: GrinZwe91! ($11.66 in chips) 
Seat 4: stylepointxoxo ($11.74 in chips) 
Seat 5: MostlyGravy ($23.70 in chips) 
Seat 6: negritos81 ($10.99 in chips) 
MostlyGravy: posts small blind $0.05
negritos81: posts big blind $0.10
favourble: sits out 
*** HOLE CARDS ***
kimmarusa: folds 
GrinZwe91!: folds 
stylepointxoxo: raises $0.15 to $0.25
MostlyGravy: calls $0.20
negritos81: folds 
*** FLOP *** [2d 4s 2h]
MostlyGravy: bets $0.28
stylepointxoxo: calls $0.28
*** TURN *** [2d 4s 2h] [7d]
MostlyGravy: bets $0.55
stylepointxoxo: folds 
Uncalled bet ($0.55) returned to MostlyGravy
MostlyGravy collected $1.11 from pot
MostlyGravy: doesn't show hand 
*** SUMMARY ***
Total pot $1.16 | Rake $0.05 
Board [2d 4s 2h 7d]
Seat 2: kimmarusa folded before Flop (didn't bet)
Seat 3: GrinZwe91! folded before Flop (didn't bet)
Seat 4: stylepointxoxo (button) folded on the Turn
Seat 5: MostlyGravy (small blind) collected ($1.11)
Seat 6: negritos81 (big blind) folded before Flop



PokerStars Hand #222949635167:  Hold'em No Limit ($0.05/$0.10 USD) - 2021/01/23 5:26:52 ET
Table 'Malzovia III' 6-max Seat #5 is the button
Seat 1: favourble ($10 in chips) 
Seat 2: kimmarusa ($12.69 in chips) 
Seat 3: GrinZwe91! ($11.66 in chips) 
Seat 4: stylepointxoxo ($11.21 in chips) 
Seat 5: MostlyGravy ($24.28 in chips) 
Seat 6: negritos81 ($10.89 in chips) 
negritos81: posts small blind $0.05
favourble: posts big blind $0.10
*** HOLE CARDS ***
kimmarusa: raises $0.20 to $0.30
GrinZwe91!: folds 
stylepointxoxo: folds 
MostlyGravy: calls $0.30
negritos81: folds 
favourble: calls $0.20
*** FLOP *** [Ks 9s 2c]
favourble: checks 
kimmarusa: checks 
MostlyGravy: checks 
*** TURN *** [Ks 9s 2c] [Ts]
favourble: checks 
kimmarusa: checks 
MostlyGravy: checks 
*** RIVER *** [Ks 9s 2c Ts] [5c]
favourble: bets $0.46
kimmarusa: folds 
MostlyGravy: folds 
Uncalled bet ($0.46) returned to favourble
favourble collected $0.91 from pot
*** SUMMARY ***
Total pot $0.95 | Rake $0.04 
Board [Ks 9s 2c Ts 5c]
Seat 1: favourble (big blind) collected ($0.91)
Seat 2: kimmarusa folded on the River
Seat 3: GrinZwe91! folded before Flop (didn't bet)
Seat 4: stylepointxoxo folded before Flop (didn't bet)
Seat 5: MostlyGravy (button) folded on the River
Seat 6: negritos81 (small blind) folded before Flop



PokerStars Hand #222949652765:  Hold'em No Limit ($0.05/$0.10 USD) - 2021/01/23 5:27:50 ET
Table 'Malzovia III' 6-max Seat #6 is the button
Seat 1: favourble ($10.61 in chips) 
Seat 3: GrinZwe91! ($11.66 in chips) 
Seat 4: stylepointxoxo ($11.21 in chips) 
Seat 5: MostlyGravy ($23.98 in chips) 
Seat 6: negritos81 ($10.84 in chips) 
favourble: posts small blind $0.05
kimmarusa: is sitting out 
GrinZwe91!: posts big blind $0.10
*** HOLE CARDS ***
stylepointxoxo: folds 
MostlyGravy: raises $0.10 to $0.20
negritos81: folds 
favourble: folds 
GrinZwe91!: folds 
Uncalled bet ($0.10) returned to MostlyGravy
MostlyGravy collected $0.25 from pot
MostlyGravy: doesn't show hand 
*** SUMMARY ***
Total pot $0.25 | Rake $0 
Seat 1: favourble (small blind) folded before Flop
Seat 3: GrinZwe91! (big blind) folded before Flop
Seat 4: stylepointxoxo folded before Flop (didn't bet)
Seat 5: MostlyGravy collected ($0.25)
Seat 6: negritos81 (button) folded before Flop (didn't bet)



PokerStars Hand #222949656703:  Hold'em No Limit ($0.05/$0.10 USD) - 2021/01/23 5:28:03 ET
Table 'Malzovia III' 6-max Seat #1 is the button
Seat 1: favourble ($10.56 in chips) 
Seat 3: GrinZwe91! ($11.56 in chips) 
Seat 4: stylepointxoxo ($11.21 in chips) 
Seat 5: MostlyGravy ($24.13 in chips) 
Seat 6: negritos81 ($10.84 in chips) 
GrinZwe91!: posts small blind $0.05
stylepointxoxo: posts big blind $0.10
*** HOLE CARDS ***
MostlyGravy: folds 
negritos81: raises $0.20 to $0.30
favourble: folds 
GrinZwe91!: folds 
stylepointxoxo: calls $0.20
*** FLOP *** [5c 3s 8d]
stylepointxoxo: checks 
negritos81: bets $0.20
stylepointxoxo: calls $0.20
*** TURN *** [5c 3s 8d] [8c]
stylepointxoxo: bets $0.70
negritos81: folds 
Uncalled bet ($0.70) returned to stylepointxoxo
negritos81 was removed from the table for failing to post
negritos81 leaves the table
stylepointxoxo collected $1 from pot
stylepointxoxo: doesn't show hand 
*** SUMMARY ***
Total pot $1.05 | Rake $0.05 
Board [5c 3s 8d 8c]
Seat 1: favourble (button) folded before Flop (didn't bet)
Seat 3: GrinZwe91! (small blind) folded before Flop
Seat 4: stylepointxoxo (big blind) collected ($1)
Seat 5: MostlyGravy folded before Flop (didn't bet)
Seat 6: negritos81 folded on the Turn



PokerStars Hand #222949672778:  Hold'em No Limit ($0.05/$0.10 USD) - 2021/01/23 5:28:55 ET
Table 'Malzovia III' 6-max Seat #3 is the button
Seat 1: favourble ($10.56 in chips) 
Seat 3: GrinZwe91! ($11.51 in chips) 
Seat 4: stylepointxoxo ($11.71 in chips) 
Seat 5: MostlyGravy ($24.13 in chips) 
stylepointxoxo: posts small blind $0.05
MostlyGravy: posts big blind $0.10
*** HOLE CARDS ***
favourble: raises $0.15 to $0.25
GrinZwe91!: folds 
RD462oo1 joins the table at seat #6 
stylepointxoxo: folds 
MostlyGravy: calls $0.15
*** FLOP *** [3h Kh Ts]
MostlyGravy: checks 
favourble: bets $0.16
MostlyGravy: calls $0.16
*** TURN *** [3h Kh Ts] [9h]
MostlyGravy: checks 
favourble: checks 
*** RIVER *** [3h Kh Ts 9h] [3s]
MostlyGravy: bets $1.01
favourble: folds 
Uncalled bet ($1.01) returned to MostlyGravy
MostlyGravy collected $0.83 from pot
MostlyGravy: doesn't show hand 
*** SUMMARY ***
Total pot $0.87 | Rake $0.04 
Board [3h Kh Ts 9h 3s]
Seat 1: favourble folded on the River
Seat 3: GrinZwe91! (button) folded before Flop (didn't bet)
Seat 4: stylepointxoxo (small blind) folded before Flop
Seat 5: MostlyGravy (big blind) collected ($0.83)



PokerStars Hand #222949693167:  Hold'em No Limit ($0.05/$0.10 USD) - 2021/01/23 5:30:02 ET
Table 'Malzovia III' 6-max Seat #4 is the button
Seat 1: favourble ($10.15 in chips) 
Seat 3: GrinZwe91! ($11.51 in chips) 
Seat 4: stylepointxoxo ($11.66 in chips) 
Seat 5: MostlyGravy ($24.55 in chips) 
Seat 6: RD462oo1 ($5.71 in chips) 
MostlyGravy: posts small blind $0.05
RD462oo1: posts big blind $0.10
*** HOLE CARDS ***
favourble: folds 
GrinZwe91!: folds 
stylepointxoxo: folds 
MostlyGravy: raises $0.10 to $0.20
RD462oo1: raises $0.10 to $0.30
MostlyGravy: calls $0.10
*** FLOP *** [2s 6d 7h]
MostlyGravy: checks 
RD462oo1: bets $0.28
MostlyGravy: calls $0.28
*** TURN *** [2s 6d 7h] [3h]
MostlyGravy: checks 
RD462oo1: checks 
*** RIVER *** [2s 6d 7h 3h] [9h]
stylepointxoxo leaves the table
MostlyGravy: bets $1.11
RD462oo1: folds 
Uncalled bet ($1.11) returned to MostlyGravy
MostlyGravy collected $1.11 from pot
MostlyGravy: doesn't show hand 
*** SUMMARY ***
Total pot $1.16 | Rake $0.05 
Board [2s 6d 7h 3h 9h]
Seat 1: favourble folded before Flop (didn't bet)
Seat 3: GrinZwe91! folded before Flop (didn't bet)
Seat 4: stylepointxoxo (button) folded before Flop (didn't bet)
Seat 5: MostlyGravy (small blind) collected ($1.11)
Seat 6: RD462oo1 (big blind) folded on the River



PokerStars Hand #222949709533:  Hold'em No Limit ($0.05/$0.10 USD) - 2021/01/23 5:30:56 ET
Table 'Malzovia III' 6-max Seat #5 is the button
Seat 1: favourble ($10.15 in chips) 
Seat 3: GrinZwe91! ($11.51 in chips) 
Seat 5: MostlyGravy ($25.08 in chips) 
Seat 6: RD462oo1 ($5.13 in chips) 
RD462oo1: posts small blind $0.05
favourble: posts big blind $0.10
*** HOLE CARDS ***
GrinZwe91!: folds 
MostlyGravy: folds 
RD462oo1: raises $0.10 to $0.20
favourble: folds 
Uncalled bet ($0.10) returned to RD462oo1
RD462oo1 collected $0.20 from pot
RD462oo1: doesn't show hand 
*** SUMMARY ***
Total pot $0.20 | Rake $0 
Seat 1: favourble (big blind) folded before Flop
Seat 3: GrinZwe91! folded before Flop (didn't bet)
Seat 5: MostlyGravy (button) folded before Flop (didn't bet)
Seat 6: RD462oo1 (small blind) collected ($0.20)



PokerStars Hand #222949713974:  Hold'em No Limit ($0.05/$0.10 USD) - 2021/01/23 5:31:10 ET
Table 'Malzovia III' 6-max Seat #6 is the button
Seat 1: favourble ($10.05 in chips) 
Seat 3: GrinZwe91! ($11.51 in chips) 
Seat 5: MostlyGravy ($25.08 in chips) 
Seat 6: RD462oo1 ($5.23 in chips) 
favourble: posts small blind $0.05
GrinZwe91!: posts big blind $0.10
*** HOLE CARDS ***
MostlyGravy: raises $0.20 to $0.30
RD462oo1: folds 
favourble: folds 
PaoloGod joins the table at seat #4 
GrinZwe91!: calls $0.20
*** FLOP *** [9c 3d Qc]
GrinZwe91!: checks 
MostlyGravy: checks 
*** TURN *** [9c 3d Qc] [9d]
GrinZwe91!: bets $0.31
MostlyGravy: calls $0.31
*** RIVER *** [9c 3d Qc 9d] [5c]
GrinZwe91!: bets $0.70
MostlyGravy: raises $1.31 to $2.01
GrinZwe91!: folds 
Uncalled bet ($1.31) returned to MostlyGravy
MostlyGravy collected $2.55 from pot
MostlyGravy: doesn't show hand 
*** SUMMARY ***
Total pot $2.67 | Rake $0.12 
Board [9c 3d Qc 9d 5c]
Seat 1: favourble (small blind) folded before Flop
Seat 3: GrinZwe91! (big blind) folded on the River
Seat 5: MostlyGravy collected ($2.55)
Seat 6: RD462oo1 (button) folded before Flop (didn't bet)



PokerStars Hand #222949735165:  Hold'em No Limit ($0.05/$0.10 USD) - 2021/01/23 5:32:19 ET
Table 'Malzovia III' 6-max Seat #1 is the button
Seat 1: favourble ($10 in chips) 
Seat 3: GrinZwe91! ($10.20 in chips) 
Seat 4: PaoloGod ($5 in chips) 
Seat 5: MostlyGravy ($26.32 in chips) 
Seat 6: RD462oo1 ($5.23 in chips) 
GrinZwe91!: posts small blind $0.05
PaoloGod: posts big blind $0.10
*** HOLE CARDS ***
MostlyGravy: raises $0.20 to $0.30
RD462oo1: raises $0.20 to $0.50
favourble: folds 
GrinZwe91!: folds 
PaoloGod: folds 
MostlyGravy: calls $0.20
*** FLOP *** [4s 3c 4d]
MostlyGravy: checks 
RD462oo1: bets $1.10
MostlyGravy: folds 
Uncalled bet ($1.10) returned to RD462oo1
RD462oo1 collected $1.10 from pot
RD462oo1: doesn't show hand 
*** SUMMARY ***
Total pot $1.15 | Rake $0.05 
Board [4s 3c 4d]
Seat 1: favourble (button) folded before Flop (didn't bet)
Seat 3: GrinZwe91! (small blind) folded before Flop
Seat 4: PaoloGod (big blind) folded before Flop
Seat 5: MostlyGravy folded on the Flop
Seat 6: RD462oo1 collected ($1.10)



PokerStars Hand #222949747676:  Hold'em No Limit ($0.05/$0.10 USD) - 2021/01/23 5:32:59 ET
Table 'Malzovia III' 6-max Seat #3 is the button
Seat 1: favourble ($10 in chips) 
Seat 3: GrinZwe91! ($10.15 in chips) 
Seat 4: PaoloGod ($4.90 in chips) 
Seat 5: MostlyGravy ($25.82 in chips) 
Seat 6: RD462oo1 ($5.83 in chips) 
PaoloGod: posts small blind $0.05
MostlyGravy: posts big blind $0.10
*** HOLE CARDS ***
RD462oo1: folds 
favourble: raises $0.15 to $0.25
GrinZwe91!: calls $0.25
PaoloGod: calls $0.20
MostlyGravy: calls $0.15
*** FLOP *** [8h Jh 7c]
PaoloGod: checks 
MostlyGravy: checks 
favourble: checks 
GrinZwe91!: bets $0.60
PaoloGod: calls $0.60
MostlyGravy: folds 
favourble: folds 
*** TURN *** [8h Jh 7c] [Js]
PaoloGod: checks 
GrinZwe91!: checks 
*** RIVER *** [8h Jh 7c Js] [4s]
PaoloGod: bets $1.20
GrinZwe91!: folds 
Uncalled bet ($1.20) returned to PaoloGod
PaoloGod collected $2.10 from pot
PaoloGod: doesn't show hand 
*** SUMMARY ***
Total pot $2.20 | Rake $0.10 
Board [8h Jh 7c Js 4s]
Seat 1: favourble folded on the Flop
Seat 3: GrinZwe91! (button) folded on the River
Seat 4: PaoloGod (small blind) collected ($2.10)
Seat 5: MostlyGravy (big blind) folded on the Flop
Seat 6: RD462oo1 folded before Flop (didn't bet)



PokerStars Hand #222949777308:  Hold'em No Limit ($0.05/$0.10 USD) - 2021/01/23 5:34:35 ET
Table 'Malzovia III' 6-max Seat #4 is the button
Seat 1: favourble ($10 in chips) 
Seat 3: GrinZwe91! ($10 in chips) 
Seat 4: PaoloGod ($6.15 in chips) 
Seat 5: MostlyGravy ($25.57 in chips) 
Seat 6: RD462oo1 ($5.83 in chips) 
MostlyGravy: posts small blind $0.05
RD462oo1: posts big blind $0.10
kimmarusa: sits out 
*** HOLE CARDS ***
favourble: folds 
GrinZwe91!: raises $0.20 to $0.30
PaoloGod: folds 
MostlyGravy: calls $0.25
RD462oo1: folds 
*** FLOP *** [9s Qc 4s]
MostlyGravy: bets $0.67
GrinZwe91!: folds 
Uncalled bet ($0.67) returned to MostlyGravy
MostlyGravy collected $0.67 from pot
MostlyGravy: doesn't show hand 
*** SUMMARY ***
Total pot $0.70 | Rake $0.03 
Board [9s Qc 4s]
Seat 1: favourble folded before Flop (didn't bet)
Seat 3: GrinZwe91! folded on the Flop
Seat 4: PaoloGod (button) folded before Flop (didn't bet)
Seat 5: MostlyGravy (small blind) collected ($0.67)
Seat 6: RD462oo1 (big blind) folded before Flop



PokerStars Hand #222949789940:  Hold'em No Limit ($0.05/$0.10 USD) - 2021/01/23 5:35:15 ET
Table 'Malzovia III' 6-max Seat #5 is the button
Seat 1: favourble ($10 in chips) 
Seat 3: GrinZwe91! ($10 in chips) 
Seat 4: PaoloGod ($6.15 in chips) 
Seat 5: MostlyGravy ($25.94 in chips) 
Seat 6: RD462oo1 ($5.73 in chips) 
RD462oo1: posts small blind $0.05
favourble: posts big blind $0.10
kimmarusa: sits out 
*** HOLE CARDS ***
GrinZwe91!: folds 
PaoloGod: calls $0.10
MostlyGravy: folds 
RD462oo1: raises $0.10 to $0.20
favourble: calls $0.10
PaoloGod: calls $0.10
*** FLOP *** [7h 8c 9s]
RD462oo1: checks 
favourble: checks 
PaoloGod: checks 
*** TURN *** [7h 8c 9s] [7s]
RD462oo1: checks 
favourble: bets $0.17
PaoloGod: folds 
RD462oo1: calls $0.17
*** RIVER *** [7h 8c 9s 7s] [3d]
RD462oo1: bets $0.45
favourble: folds 
Uncalled bet ($0.45) returned to RD462oo1
RD462oo1 collected $0.90 from pot
RD462oo1: doesn't show hand 
*** SUMMARY ***
Total pot $0.94 | Rake $0.04 
Board [7h 8c 9s 7s 3d]
Seat 1: favourble (big blind) folded on the River
Seat 3: GrinZwe91! folded before Flop (didn't bet)
Seat 4: PaoloGod folded on the Turn
Seat 5: MostlyGravy (button) folded before Flop (didn't bet)
Seat 6: RD462oo1 (small blind) collected ($0.90)



PokerStars Hand #222949808580:  Hold'em No Limit ($0.05/$0.10 USD) - 2021/01/23 5:36:14 ET
Table 'Malzovia III' 6-max Seat #6 is the button
Seat 1: favourble ($10 in chips) 
Seat 2: kimmarusa ($12.39 in chips) 
Seat 3: GrinZwe91! ($10 in chips) 
Seat 4: PaoloGod ($5.95 in chips) 
Seat 5: MostlyGravy ($25.94 in chips) 
Seat 6: RD462oo1 ($6.26 in chips) 
favourble: posts small blind $0.05
kimmarusa: posts big blind $0.10
*** HOLE CARDS ***
GrinZwe91!: folds 
PaoloGod: raises $0.10 to $0.20
MostlyGravy: folds 
RD462oo1: folds 
favourble: folds 
kimmarusa: raises $0.70 to $0.90
PaoloGod: calls $0.70
*** FLOP *** [8s Js 3d]
kimmarusa: bets $1.10
PaoloGod: folds 
Uncalled bet ($1.10) returned to kimmarusa
kimmarusa collected $1.77 from pot
kimmarusa: doesn't show hand 
*** SUMMARY ***
Total pot $1.85 | Rake $0.08 
Board [8s Js 3d]
Seat 1: favourble (small blind) folded before Flop
Seat 2: kimmarusa (big blind) collected ($1.77)
Seat 3: GrinZwe91! folded before Flop (didn't bet)
Seat 4: PaoloGod folded on the Flop
Seat 5: MostlyGravy folded before Flop (didn't bet)
Seat 6: RD462oo1 (button) folded before Flop (didn't bet)



PokerStars Hand #222949819957:  Hold'em No Limit ($0.05/$0.10 USD) - 2021/01/23 5:36:51 ET
Table 'Malzovia III' 6-max Seat #1 is the button
Seat 1: favourble ($10 in chips) 
Seat 2: kimmarusa ($13.26 in chips) 
Seat 3: GrinZwe91! ($10 in chips) 
Seat 4: PaoloGod ($5.05 in chips) 
Seat 5: MostlyGravy ($25.94 in chips) 
Seat 6: RD462oo1 ($6.26 in chips) 
kimmarusa: posts small blind $0.05
GrinZwe91!: posts big blind $0.10
*** HOLE CARDS ***
PaoloGod: calls $0.10
MostlyGravy: raises $0.10 to $0.20
RD462oo1: folds 
favourble: folds 
kimmarusa: folds 
GrinZwe91!: raises $0.70 to $0.90
PaoloGod: folds 
MostlyGravy: folds 
Uncalled bet ($0.70) returned to GrinZwe91!
GrinZwe91! collected $0.55 from pot
GrinZwe91!: doesn't show hand 
*** SUMMARY ***
Total pot $0.55 | Rake $0 
Seat 1: favourble (button) folded before Flop (didn't bet)
Seat 2: kimmarusa (small blind) folded before Flop
Seat 3: GrinZwe91! (big blind) collected ($0.55)
Seat 4: PaoloGod folded before Flop
Seat 5: MostlyGravy folded before Flop
Seat 6: RD462oo1 folded before Flop (didn't bet)



PokerStars Hand #222949828305:  Hold'em No Limit ($0.05/$0.10 USD) - 2021/01/23 5:37:17 ET
Table 'Malzovia III' 6-max Seat #2 is the button
Seat 1: favourble ($10 in chips) 
Seat 2: kimmarusa ($13.21 in chips) 
Seat 3: GrinZwe91! ($10.35 in chips) 
Seat 4: PaoloGod ($4.95 in chips) 
Seat 5: MostlyGravy ($25.74 in chips) 
Seat 6: RD462oo1 ($6.26 in chips) 
GrinZwe91!: posts small blind $0.05
PaoloGod: posts big blind $0.10
*** HOLE CARDS ***
MostlyGravy: raises $0.30 to $0.40
RD462oo1: calls $0.40
favourble: folds 
kimmarusa: calls $0.40
GrinZwe91!: folds 
PaoloGod: calls $0.30
*** FLOP *** [2s 3d As]
PaoloGod: checks 
MostlyGravy: bets $0.59
RD462oo1: folds 
kimmarusa: raises $0.71 to $1.30
PaoloGod: folds 
MostlyGravy: calls $0.71
*** TURN *** [2s 3d As] [6s]
MostlyGravy: checks 
kimmarusa: bets $2.10
RD462oo1 leaves the table
Findingfishy joins the table at seat #6 
MostlyGravy: folds 
Uncalled bet ($2.10) returned to kimmarusa
kimmarusa collected $4.06 from pot
kimmarusa: doesn't show hand 
*** SUMMARY ***
Total pot $4.25 | Rake $0.19 
Board [2s 3d As 6s]
Seat 1: favourble folded before Flop (didn't bet)
Seat 2: kimmarusa (button) collected ($4.06)
Seat 3: GrinZwe91! (small blind) folded before Flop
Seat 4: PaoloGod (big blind) folded on the Flop
Seat 5: MostlyGravy folded on the Turn
Seat 6: RD462oo1 folded on the Flop



PokerStars Hand #222949868809:  Hold'em No Limit ($0.05/$0.10 USD) - 2021/01/23 5:39:26 ET
Table 'Malzovia III' 6-max Seat #3 is the button
Seat 1: favourble ($10 in chips) 
Seat 2: kimmarusa ($15.57 in chips) 
Seat 3: GrinZwe91! ($10.30 in chips) 
Seat 4: PaoloGod ($4.55 in chips) 
Seat 5: MostlyGravy ($24.04 in chips) 
PaoloGod: posts small blind $0.05
MostlyGravy: posts big blind $0.10
Findingfishy: sits out 
*** HOLE CARDS ***
favourble: raises $0.15 to $0.25
kimmarusa: folds 
GrinZwe91!: folds 
PaoloGod: folds 
MostlyGravy: folds 
Uncalled bet ($0.15) returned to favourble
favourble collected $0.25 from pot
*** SUMMARY ***
Total pot $0.25 | Rake $0 
Seat 1: favourble collected ($0.25)
Seat 2: kimmarusa folded before Flop (didn't bet)
Seat 3: GrinZwe91! (button) folded before Flop (didn't bet)
Seat 4: PaoloGod (small blind) folded before Flop
Seat 5: MostlyGravy (big blind) folded before Flop



PokerStars Hand #222949874883:  Hold'em No Limit ($0.05/$0.10 USD) - 2021/01/23 5:39:45 ET
Table 'Malzovia III' 6-max Seat #4 is the button
Seat 1: favourble ($10.15 in chips) 
Seat 2: kimmarusa ($15.57 in chips) 
Seat 3: GrinZwe91! ($10.30 in chips) 
Seat 4: PaoloGod ($4.50 in chips) 
Seat 5: MostlyGravy ($23.94 in chips) 
Seat 6: Findingfishy ($8 in chips) 
MostlyGravy: posts small blind $0.05
Findingfishy: posts big blind $0.10
*** HOLE CARDS ***
favourble: folds 
kimmarusa: folds 
GrinZwe91!: folds 
PaoloGod has timed out
PaoloGod: folds 
MostlyGravy: raises $0.20 to $0.30
Findingfishy: folds 
Uncalled bet ($0.20) returned to MostlyGravy
MostlyGravy collected $0.20 from pot
MostlyGravy: doesn't show hand 
*** SUMMARY ***
Total pot $0.20 | Rake $0 
Seat 1: favourble folded before Flop (didn't bet)
Seat 2: kimmarusa folded before Flop (didn't bet)
Seat 3: GrinZwe91! folded before Flop (didn't bet)
Seat 4: PaoloGod (button) folded before Flop (didn't bet)
Seat 5: MostlyGravy (small blind) collected ($0.20)
Seat 6: Findingfishy (big blind) folded before Flop



PokerStars Hand #222949884716:  Hold'em No Limit ($0.05/$0.10 USD) - 2021/01/23 5:40:16 ET
Table 'Malzovia III' 6-max Seat #5 is the button
Seat 1: favourble ($10.15 in chips) 
Seat 2: kimmarusa ($15.57 in chips) 
Seat 3: GrinZwe91! ($10.30 in chips) 
Seat 5: MostlyGravy ($24.04 in chips) 
Seat 6: Findingfishy ($7.90 in chips) 
Findingfishy: posts small blind $0.05
favourble: posts big blind $0.10
*** HOLE CARDS ***
kimmarusa: folds 
GrinZwe91!: raises $0.20 to $0.30
MostlyGravy: folds 
Findingfishy: folds 
favourble: folds 
Uncalled bet ($0.20) returned to GrinZwe91!
GrinZwe91! collected $0.25 from pot
GrinZwe91!: doesn't show hand 
*** SUMMARY ***
Total pot $0.25 | Rake $0 
Seat 1: favourble (big blind) folded before Flop
Seat 2: kimmarusa folded before Flop (didn't bet)
Seat 3: GrinZwe91! collected ($0.25)
Seat 5: MostlyGravy (button) folded before Flop (didn't bet)
Seat 6: Findingfishy (small blind) folded before Flop



PokerStars Hand #222949888873:  Hold'em No Limit ($0.05/$0.10 USD) - 2021/01/23 5:40:30 ET
Table 'Malzovia III' 6-max Seat #6 is the button
Seat 1: favourble ($10.05 in chips) 
Seat 2: kimmarusa ($15.57 in chips) 
Seat 3: GrinZwe91! ($10.45 in chips) 
Seat 4: PaoloGod ($4.50 in chips) 
Seat 5: MostlyGravy ($24.04 in chips) 
Seat 6: Findingfishy ($7.85 in chips) 
favourble: posts small blind $0.05
kimmarusa: posts big blind $0.10
*** HOLE CARDS ***
GrinZwe91!: folds 
PaoloGod: calls $0.10
MostlyGravy: folds 
Findingfishy: calls $0.10
favourble: folds 
kimmarusa: checks 
*** FLOP *** [Jd 3h 7d]
kimmarusa: checks 
PaoloGod: checks 
Findingfishy: bets $0.17
kimmarusa: folds 
PaoloGod: calls $0.17
*** TURN *** [Jd 3h 7d] [Ah]
PaoloGod: checks 
Findingfishy: checks 
*** RIVER *** [Jd 3h 7d Ah] [5s]
PaoloGod: bets $0.30
Findingfishy: folds 
Uncalled bet ($0.30) returned to PaoloGod
PaoloGod collected $0.66 from pot
PaoloGod: doesn't show hand 
*** SUMMARY ***
Total pot $0.69 | Rake $0.03 
Board [Jd 3h 7d Ah 5s]
Seat 1: favourble (small blind) folded before Flop
Seat 2: kimmarusa (big blind) folded on the Flop
Seat 3: GrinZwe91! folded before Flop (didn't bet)
Seat 4: PaoloGod collected ($0.66)
Seat 5: MostlyGravy folded before Flop (didn't bet)
Seat 6: Findingfishy (button) folded on the River



PokerStars Hand #222949907289:  Hold'em No Limit ($0.05/$0.10 USD) - 2021/01/23 5:41:29 ET
Table 'Malzovia III' 6-max Seat #1 is the button
Seat 1: favourble ($10 in chips) 
Seat 3: GrinZwe91! ($10.45 in chips) 
Seat 4: PaoloGod ($4.89 in chips) 
Seat 5: MostlyGravy ($24.04 in chips) 
Seat 6: Findingfishy ($7.58 in chips) 
kimmarusa has timed out
kimmarusa: is sitting out 
GrinZwe91!: posts small blind $0.05
PaoloGod: posts big blind $0.10
*** HOLE CARDS ***
MostlyGravy: folds 
kimmarusa is disconnected 
Findingfishy: folds 
favourble: raises $0.15 to $0.25
MostlyGravy leaves the table
GrinZwe91!: raises $0.65 to $0.90
PaoloGod: folds 
favourble: folds 
Uncalled bet ($0.65) returned to GrinZwe91!
GrinZwe91! collected $0.60 from pot
GrinZwe91!: doesn't show hand 
*** SUMMARY ***
Total pot $0.60 | Rake $0 
Seat 1: favourble (button) folded before Flop
Seat 3: GrinZwe91! (small blind) collected ($0.60)
Seat 4: PaoloGod (big blind) folded before Flop
Seat 5: MostlyGravy folded before Flop (didn't bet)
Seat 6: Findingfishy folded before Flop (didn't bet)



PokerStars Hand #222949918666:  Hold'em No Limit ($0.05/$0.10 USD) - 2021/01/23 5:42:05 ET
Table 'Malzovia III' 6-max Seat #3 is the button
Seat 1: favourble ($10 in chips) 
Seat 2: kimmarusa ($15.47 in chips) 
Seat 3: GrinZwe91! ($10.80 in chips) 
Seat 4: PaoloGod ($4.79 in chips) 
Seat 6: Findingfishy ($7.58 in chips) 
PaoloGod: posts small blind $0.05
Findingfishy: posts big blind $0.10
kimmarusa: posts small blind $0.05
*** HOLE CARDS ***
favourble: folds 
kimmarusa: folds 
GrinZwe91!: folds 
PaoloGod: raises $0.20 to $0.30
Findingfishy: folds 
Uncalled bet ($0.20) returned to PaoloGod
PaoloGod collected $0.25 from pot
PaoloGod: doesn't show hand 
*** SUMMARY ***
Total pot $0.25 | Rake $0 
Seat 1: favourble folded before Flop (didn't bet)
Seat 2: kimmarusa folded before Flop (didn't bet)
Seat 3: GrinZwe91! (button) folded before Flop (didn't bet)
Seat 4: PaoloGod (small blind) collected ($0.25)
Seat 6: Findingfishy (big blind) folded before Flop



PokerStars Hand #222949924327:  Hold'em No Limit ($0.05/$0.10 USD) - 2021/01/23 5:42:24 ET
Table 'Malzovia III' 6-max Seat #4 is the button
Seat 1: favourble ($10 in chips) 
Seat 2: kimmarusa ($15.42 in chips) 
Seat 3: GrinZwe91! ($10.80 in chips) 
Seat 4: PaoloGod ($4.94 in chips) 
Seat 6: Findingfishy ($7.48 in chips) 
Findingfishy: posts small blind $0.05
favourble: posts big blind $0.10
*** HOLE CARDS ***
kimmarusa: folds 
GrinZwe91!: folds 
PaoloGod: raises $0.20 to $0.30
Findingfishy: folds 
favourble: folds 
Uncalled bet ($0.20) returned to PaoloGod
PaoloGod collected $0.25 from pot
PaoloGod: doesn't show hand 
*** SUMMARY ***
Total pot $0.25 | Rake $0 
Seat 1: favourble (big blind) folded before Flop
Seat 2: kimmarusa folded before Flop (didn't bet)
Seat 3: GrinZwe91! folded before Flop (didn't bet)
Seat 4: PaoloGod (button) collected ($0.25)
Seat 6: Findingfishy (small blind) folded before Flop



PokerStars Hand #222949928553:  Hold'em No Limit ($0.05/$0.10 USD) - 2021/01/23 5:42:37 ET
Table 'Malzovia III' 6-max Seat #6 is the button
Seat 1: favourble ($10 in chips) 
Seat 2: kimmarusa ($15.42 in chips) 
Seat 3: GrinZwe91! ($10.80 in chips) 
Seat 4: PaoloGod ($5.09 in chips) 
Seat 6: Findingfishy ($7.43 in chips) 
favourble: posts small blind $0.05
kimmarusa: posts big blind $0.10
*** HOLE CARDS ***
GrinZwe91!: raises $0.20 to $0.30
PaoloGod: folds 
Findingfishy: folds 
favourble: folds 
kimmarusa: folds 
Uncalled bet ($0.20) returned to GrinZwe91!
GrinZwe91! collected $0.25 from pot
GrinZwe91!: doesn't show hand 
*** SUMMARY ***
Total pot $0.25 | Rake $0 
Seat 1: favourble (small blind) folded before Flop
Seat 2: kimmarusa (big blind) folded before Flop
Seat 3: GrinZwe91! collected ($0.25)
Seat 4: PaoloGod folded before Flop (didn't bet)
Seat 6: Findingfishy (button) folded before Flop (didn't bet)



PokerStars Hand #222949932633:  Hold'em No Limit ($0.05/$0.10 USD) - 2021/01/23 5:42:50 ET
Table 'Malzovia III' 6-max Seat #1 is the button
Seat 1: favourble ($10 in chips) 
Seat 2: kimmarusa ($15.32 in chips) 
Seat 3: GrinZwe91! ($10.95 in chips) 
Seat 4: PaoloGod ($5.09 in chips) 
Seat 6: Findingfishy ($7.43 in chips) 
kimmarusa: posts small blind $0.05
GrinZwe91!: posts big blind $0.10
*** HOLE CARDS ***
PaoloGod: folds 
Findingfishy: raises $0.20 to $0.30
favourble: folds 
PizzaTonnoNL joins the table at seat #5 
kimmarusa: folds 
GrinZwe91!: folds 
Uncalled bet ($0.20) returned to Findingfishy
Findingfishy collected $0.25 from pot
Findingfishy: doesn't show hand 
*** SUMMARY ***
Total pot $0.25 | Rake $0 
Seat 1: favourble (button) folded before Flop (didn't bet)
Seat 2: kimmarusa (small blind) folded before Flop
Seat 3: GrinZwe91! (big blind) folded before Flop
Seat 4: PaoloGod folded before Flop (didn't bet)
Seat 6: Findingfishy collected ($0.25)



PokerStars Hand #222950166395:  Hold'em No Limit ($0.05/$0.10 USD) - 2021/01/23 5:55:12 ET
Table 'Malzovia III' 6-max Seat #5 is the button
Seat 2: kimmarusa ($17.57 in chips) 
Seat 3: GrinZwe91! ($11.88 in chips) 
Seat 5: PizzaTonnoNL ($13.74 in chips) 
kimmarusa: posts small blind $0.05
GrinZwe91!: posts big blind $0.10
*** HOLE CARDS ***
PizzaTonnoNL: raises $0.20 to $0.30
kimmarusa: folds 
GrinZwe91!: folds 
Uncalled bet ($0.20) returned to PizzaTonnoNL
PizzaTonnoNL collected $0.25 from pot
*** SUMMARY ***
Total pot $0.25 | Rake $0 
Seat 2: kimmarusa (small blind) folded before Flop
Seat 3: GrinZwe91! (big blind) folded before Flop
Seat 5: PizzaTonnoNL (button) collected ($0.25)



PokerStars Hand #222950168564:  Hold'em No Limit ($0.05/$0.10 USD) - 2021/01/23 5:55:20 ET
Table 'Malzovia III' 6-max Seat #2 is the button
Seat 2: kimmarusa ($17.52 in chips) 
Seat 3: GrinZwe91! ($11.78 in chips) 
Seat 5: PizzaTonnoNL ($13.89 in chips) 
GrinZwe91!: posts small blind $0.05
PizzaTonnoNL: posts big blind $0.10
*** HOLE CARDS ***
kimmarusa: folds 
GrinZwe91!: folds 
Uncalled bet ($0.05) returned to PizzaTonnoNL
PizzaTonnoNL collected $0.10 from pot
*** SUMMARY ***
Total pot $0.10 | Rake $0 
Seat 2: kimmarusa (button) folded before Flop (didn't bet)
Seat 3: GrinZwe91! (small blind) folded before Flop
Seat 5: PizzaTonnoNL (big blind) collected ($0.10)



PokerStars Hand #222950170265:  Hold'em No Limit ($0.05/$0.10 USD) - 2021/01/23 5:55:26 ET
Table 'Malzovia III' 6-max Seat #5 is the button
Seat 3: GrinZwe91! ($11.73 in chips) 
Seat 5: PizzaTonnoNL ($13.94 in chips) 
PizzaTonnoNL: posts small blind $0.05
kimmarusa: is sitting out 
GrinZwe91!: posts big blind $0.10
*** HOLE CARDS ***
kimmarusa leaves the table
PizzaTonnoNL: folds 
Uncalled bet ($0.05) returned to GrinZwe91!
GrinZwe91! collected $0.10 from pot
GrinZwe91!: doesn't show hand 
*** SUMMARY ***
Total pot $0.10 | Rake $0 
Seat 3: GrinZwe91! (big blind) collected ($0.10)
Seat 5: PizzaTonnoNL (button) (small blind) folded before Flop



PokerStars Hand #222950171426:  Hold'em No Limit ($0.05/$0.10 USD) - 2021/01/23 5:55:30 ET
Table 'Malzovia III' 6-max Seat #3 is the button
Seat 3: GrinZwe91! ($11.78 in chips) 
Seat 5: PizzaTonnoNL ($13.89 in chips) 
GrinZwe91!: posts small blind $0.05
PizzaTonnoNL: posts big blind $0.10
*** HOLE CARDS ***
GrinZwe91!: folds 
Uncalled bet ($0.05) returned to PizzaTonnoNL
PizzaTonnoNL collected $0.10 from pot
*** SUMMARY ***
Total pot $0.10 | Rake $0 
Seat 3: GrinZwe91! (button) (small blind) folded before Flop
Seat 5: PizzaTonnoNL (big blind) collected ($0.10)



PokerStars Hand #222950172479:  Hold'em No Limit ($0.05/$0.10 USD) - 2021/01/23 5:55:34 ET
Table 'Malzovia III' 6-max Seat #5 is the button
Seat 3: GrinZwe91! ($11.73 in chips) 
Seat 5: PizzaTonnoNL ($13.94 in chips) 
PizzaTonnoNL: posts small blind $0.05
GrinZwe91!: posts big blind $0.10
*** HOLE CARDS ***
PizzaTonnoNL: raises $0.20 to $0.30
GrinZwe91!: folds 
Uncalled bet ($0.20) returned to PizzaTonnoNL
PizzaTonnoNL collected $0.20 from pot
*** SUMMARY ***
Total pot $0.20 | Rake $0 
Seat 3: GrinZwe91! (big blind) folded before Flop
Seat 5: PizzaTonnoNL (button) (small blind) collected ($0.20)



PokerStars Hand #222950174803:  Hold'em No Limit ($0.05/$0.10 USD) - 2021/01/23 5:55:42 ET
Table 'Malzovia III' 6-max Seat #3 is the button
Seat 3: GrinZwe91! ($11.63 in chips) 
Seat 5: PizzaTonnoNL ($14.04 in chips) 
GrinZwe91!: posts small blind $0.05
PizzaTonnoNL: posts big blind $0.10
*** HOLE CARDS ***
GrinZwe91!: raises $0.20 to $0.30
PizzaTonnoNL: folds 
Uncalled bet ($0.20) returned to GrinZwe91!
GrinZwe91! collected $0.20 from pot
GrinZwe91!: doesn't show hand 
*** SUMMARY ***
Total pot $0.20 | Rake $0 
Seat 3: GrinZwe91! (button) (small blind) collected ($0.20)
Seat 5: PizzaTonnoNL (big blind) folded before Flop



PokerStars Hand #222950030819:  Hold'em No Limit ($0.05/$0.10 USD) - 2021/01/23 5:48:01 ET
Table 'Malzovia III' 6-max Seat #1 is the button
Seat 1: favourble ($10 in chips) 
Seat 2: kimmarusa ($12.37 in chips) 
Seat 3: GrinZwe91! ($11.25 in chips) 
Seat 4: PaoloGod ($3.56 in chips) 
Seat 5: PizzaTonnoNL ($14.22 in chips) 
Seat 6: Findingfishy ($7.09 in chips) 
kimmarusa: posts small blind $0.05
GrinZwe91!: posts big blind $0.10
*** HOLE CARDS ***
PaoloGod: calls $0.10
PizzaTonnoNL: folds 
Findingfishy: calls $0.10
favourble: folds 
kimmarusa: calls $0.05
GrinZwe91!: checks 
*** FLOP *** [Qc 2s 5d]
kimmarusa: checks 
GrinZwe91!: checks 
PaoloGod: bets $0.10
Findingfishy: raises $0.20 to $0.30
kimmarusa: folds 
GrinZwe91!: folds 
PaoloGod: calls $0.20
*** TURN *** [Qc 2s 5d] [7d]
PaoloGod: checks 
Findingfishy: bets $0.80
PaoloGod: folds 
Uncalled bet ($0.80) returned to Findingfishy
Findingfishy collected $0.96 from pot
Findingfishy: doesn't show hand 
*** SUMMARY ***
Total pot $1 | Rake $0.04 
Board [Qc 2s 5d 7d]
Seat 1: favourble (button) folded before Flop (didn't bet)
Seat 2: kimmarusa (small blind) folded on the Flop
Seat 3: GrinZwe91! (big blind) folded on the Flop
Seat 4: PaoloGod folded on the Turn
Seat 5: PizzaTonnoNL folded before Flop (didn't bet)
Seat 6: Findingfishy collected ($0.96)



PokerStars Hand #222950048458:  Hold'em No Limit ($0.05/$0.10 USD) - 2021/01/23 5:48:57 ET
Table 'Malzovia III' 6-max Seat #2 is the button
Seat 1: favourble ($10 in chips) 
Seat 2: kimmarusa ($12.27 in chips) 
Seat 3: GrinZwe91! ($11.15 in chips) 
Seat 4: PaoloGod ($3.16 in chips) 
Seat 5: PizzaTonnoNL ($14.22 in chips) 
Seat 6: Findingfishy ($7.65 in chips) 
GrinZwe91!: posts small blind $0.05
PaoloGod: posts big blind $0.10
*** HOLE CARDS ***
PizzaTonnoNL: folds 
Findingfishy: folds 
favourble: folds 
kimmarusa: raises $0.20 to $0.30
GrinZwe91!: folds 
PaoloGod: folds 
Uncalled bet ($0.20) returned to kimmarusa
kimmarusa collected $0.25 from pot
kimmarusa: doesn't show hand 
*** SUMMARY ***
Total pot $0.25 | Rake $0 
Seat 1: favourble folded before Flop (didn't bet)
Seat 2: kimmarusa (button) collected ($0.25)
Seat 3: GrinZwe91! (small blind) folded before Flop
Seat 4: PaoloGod (big blind) folded before Flop
Seat 5: PizzaTonnoNL folded before Flop (didn't bet)
Seat 6: Findingfishy folded before Flop (didn't bet)



PokerStars Hand #222950056981:  Hold'em No Limit ($0.05/$0.10 USD) - 2021/01/23 5:49:24 ET
Table 'Malzovia III' 6-max Seat #3 is the button
Seat 1: favourble ($10 in chips) 
Seat 2: kimmarusa ($12.42 in chips) 
Seat 3: GrinZwe91! ($11.10 in chips) 
Seat 4: PaoloGod ($3.06 in chips) 
Seat 5: PizzaTonnoNL ($14.22 in chips) 
Seat 6: Findingfishy ($7.65 in chips) 
PaoloGod: posts small blind $0.05
PizzaTonnoNL: posts big blind $0.10
*** HOLE CARDS ***
Findingfishy: folds 
favourble: raises $0.15 to $0.25
kimmarusa: calls $0.25
GrinZwe91!: folds 
PaoloGod: calls $0.20
PizzaTonnoNL: folds 
*** FLOP *** [2h 2d 3c]
PaoloGod: bets $0.40
favourble: raises $0.48 to $0.88
kimmarusa: folds 
PaoloGod: calls $0.48
*** TURN *** [2h 2d 3c] [Jc]
PaoloGod: bets $0.60
Findingfishy leaves the table
favourble: raises $8.27 to $8.87 and is all-in
PaoloGod: calls $1.33 and is all-in
Uncalled bet ($6.94) returned to favourble
*** RIVER *** [2h 2d 3c Jc] [Kh]
*** SHOW DOWN ***
PaoloGod: shows [7h Jh] (two pair, Jacks and Deuces)
favourble: shows [9s 9c] (two pair, Nines and Deuces)
PaoloGod collected $6.18 from pot
*** SUMMARY ***
Total pot $6.47 | Rake $0.29 
Board [2h 2d 3c Jc Kh]
Seat 1: favourble showed [9s 9c] and lost with two pair, Nines and Deuces
Seat 2: kimmarusa folded on the Flop
Seat 3: GrinZwe91! (button) folded before Flop (didn't bet)
Seat 4: PaoloGod (small blind) showed [7h Jh] and won ($6.18) with two pair, Jacks and Deuces
Seat 5: PizzaTonnoNL (big blind) folded before Flop
Seat 6: Findingfishy folded before Flop (didn't bet)



PokerStars Hand #222950078634:  Hold'em No Limit ($0.05/$0.10 USD) - 2021/01/23 5:50:32 ET
Table 'Malzovia III' 6-max Seat #4 is the button
Seat 1: favourble ($10 in chips) 
Seat 2: kimmarusa ($12.17 in chips) 
Seat 3: GrinZwe91! ($11.10 in chips) 
Seat 4: PaoloGod ($6.18 in chips) 
Seat 5: PizzaTonnoNL ($14.12 in chips) 
PizzaTonnoNL: posts small blind $0.05
favourble: posts big blind $0.10
*** HOLE CARDS ***
kimmarusa: folds 
GrinZwe91!: folds 
PaoloGod: folds 
PizzaTonnoNL: raises $0.20 to $0.30
favourble: calls $0.20
*** FLOP *** [Ac 5s 9c]
PizzaTonnoNL: checks 
favourble: bets $0.17
PizzaTonnoNL: folds 
Uncalled bet ($0.17) returned to favourble
favourble collected $0.57 from pot
*** SUMMARY ***
Total pot $0.60 | Rake $0.03 
Board [Ac 5s 9c]
Seat 1: favourble (big blind) collected ($0.57)
Seat 2: kimmarusa folded before Flop (didn't bet)
Seat 3: GrinZwe91! folded before Flop (didn't bet)
Seat 4: PaoloGod (button) folded before Flop (didn't bet)
Seat 5: PizzaTonnoNL (small blind) folded on the Flop



PokerStars Hand #222950086917:  Hold'em No Limit ($0.05/$0.10 USD) - 2021/01/23 5:50:59 ET
Table 'Malzovia III' 6-max Seat #5 is the button
Seat 1: favourble ($10.27 in chips) 
Seat 2: kimmarusa ($12.17 in chips) 
Seat 3: GrinZwe91! ($11.10 in chips) 
Seat 4: PaoloGod ($6.18 in chips) 
Seat 5: PizzaTonnoNL ($13.82 in chips) 
favourble: posts small blind $0.05
kimmarusa: posts big blind $0.10
*** HOLE CARDS ***
GrinZwe91!: folds 
PaoloGod: calls $0.10
PizzaTonnoNL: raises $0.20 to $0.30
favourble: folds 
kimmarusa: folds 
PaoloGod: calls $0.20
*** FLOP *** [Ah 3c 4c]
PaoloGod: bets $0.36
PizzaTonnoNL: folds 
Uncalled bet ($0.36) returned to PaoloGod
PaoloGod collected $0.72 from pot
PaoloGod: doesn't show hand 
*** SUMMARY ***
Total pot $0.75 | Rake $0.03 
Board [Ah 3c 4c]
Seat 1: favourble (small blind) folded before Flop
Seat 2: kimmarusa (big blind) folded before Flop
Seat 3: GrinZwe91! folded before Flop (didn't bet)
Seat 4: PaoloGod collected ($0.72)
Seat 5: PizzaTonnoNL (button) folded on the Flop



PokerStars Hand #222950101510:  Hold'em No Limit ($0.05/$0.10 USD) - 2021/01/23 5:51:46 ET
Table 'Malzovia III' 6-max Seat #1 is the button
Seat 1: favourble ($10.22 in chips) 
Seat 2: kimmarusa ($12.07 in chips) 
Seat 3: GrinZwe91! ($11.10 in chips) 
Seat 4: PaoloGod ($6.60 in chips) 
Seat 5: PizzaTonnoNL ($13.52 in chips) 
kimmarusa: posts small blind $0.05
GrinZwe91!: posts big blind $0.10
*** HOLE CARDS ***
PaoloGod: folds 
PizzaTonnoNL: folds 
favourble: raises $0.15 to $0.25
kimmarusa: folds 
GrinZwe91!: folds 
Uncalled bet ($0.15) returned to favourble
favourble collected $0.25 from pot
*** SUMMARY ***
Total pot $0.25 | Rake $0 
Seat 1: favourble (button) collected ($0.25)
Seat 2: kimmarusa (small blind) folded before Flop
Seat 3: GrinZwe91! (big blind) folded before Flop
Seat 4: PaoloGod folded before Flop (didn't bet)
Seat 5: PizzaTonnoNL folded before Flop (didn't bet)



PokerStars Hand #222950106137:  Hold'em No Limit ($0.05/$0.10 USD) - 2021/01/23 5:52:00 ET
Table 'Malzovia III' 6-max Seat #2 is the button
Seat 1: favourble ($10.37 in chips) 
Seat 2: kimmarusa ($12.02 in chips) 
Seat 3: GrinZwe91! ($11 in chips) 
Seat 4: PaoloGod ($6.60 in chips) 
Seat 5: PizzaTonnoNL ($13.52 in chips) 
GrinZwe91!: posts small blind $0.05
PaoloGod: posts big blind $0.10
*** HOLE CARDS ***
PizzaTonnoNL: folds 
favourble: folds 
Metalaito joins the table at seat #6 
kimmarusa: raises $0.20 to $0.30
GrinZwe91!: folds 
PaoloGod: calls $0.20
*** FLOP *** [4h Js Jh]
PaoloGod: checks 
kimmarusa: bets $0.40
PaoloGod: calls $0.40
*** TURN *** [4h Js Jh] [7s]
PaoloGod: checks 
kimmarusa: bets $0.90
PaoloGod: raises $0.90 to $1.80
kimmarusa: calls $0.90
*** RIVER *** [4h Js Jh 7s] [8s]
PaoloGod: bets $4.10 and is all-in
kimmarusa: calls $4.10
*** SHOW DOWN ***
PaoloGod: shows [7c Qd] (two pair, Jacks and Sevens)
kimmarusa: shows [Td Jc] (three of a kind, Jacks)
kimmarusa collected $12.65 from pot
*** SUMMARY ***
Total pot $13.25 | Rake $0.60 
Board [4h Js Jh 7s 8s]
Seat 1: favourble folded before Flop (didn't bet)
Seat 2: kimmarusa (button) showed [Td Jc] and won ($12.65) with three of a kind, Jacks
Seat 3: GrinZwe91! (small blind) folded before Flop
Seat 4: PaoloGod (big blind) showed [7c Qd] and lost with two pair, Jacks and Sevens
Seat 5: PizzaTonnoNL folded before Flop (didn't bet)



PokerStars Hand #222950125517:  Hold'em No Limit ($0.05/$0.10 USD) - 2021/01/23 5:53:02 ET
Table 'Malzovia III' 6-max Seat #3 is the button
Seat 1: favourble ($10.37 in chips) 
Seat 2: kimmarusa ($18.07 in chips) 
Seat 3: GrinZwe91! ($10.95 in chips) 
Seat 5: PizzaTonnoNL ($13.52 in chips) 
Seat 6: Metalaito ($10 in chips) 
PizzaTonnoNL: posts small blind $0.05
Metalaito: posts big blind $0.10
*** HOLE CARDS ***
favourble: folds 
kimmarusa: folds 
GrinZwe91!: folds 
PaoloGod leaves the table
PizzaTonnoNL: folds 
Uncalled bet ($0.05) returned to Metalaito
Metalaito collected $0.10 from pot
Metalaito: doesn't show hand 
*** SUMMARY ***
Total pot $0.10 | Rake $0 
Seat 1: favourble folded before Flop (didn't bet)
Seat 2: kimmarusa folded before Flop (didn't bet)
Seat 3: GrinZwe91! (button) folded before Flop (didn't bet)
Seat 5: PizzaTonnoNL (small blind) folded before Flop
Seat 6: Metalaito (big blind) collected ($0.10)



PokerStars Hand #222950128191:  Hold'em No Limit ($0.05/$0.10 USD) - 2021/01/23 5:53:10 ET
Table 'Malzovia III' 6-max Seat #5 is the button
Seat 1: favourble ($10.37 in chips) 
Seat 2: kimmarusa ($18.07 in chips) 
Seat 3: GrinZwe91! ($10.95 in chips) 
Seat 5: PizzaTonnoNL ($13.47 in chips) 
Seat 6: Metalaito ($10.05 in chips) 
Metalaito: posts small blind $0.05
favourble: posts big blind $0.10
*** HOLE CARDS ***
kimmarusa: folds 
GrinZwe91!: folds 
PizzaTonnoNL: folds 
Metalaito has timed out
Metalaito: folds 
Uncalled bet ($0.05) returned to favourble
favourble collected $0.10 from pot
*** SUMMARY ***
Total pot $0.10 | Rake $0 
Seat 1: favourble (big blind) collected ($0.10)
Seat 2: kimmarusa folded before Flop (didn't bet)
Seat 3: GrinZwe91! folded before Flop (didn't bet)
Seat 5: PizzaTonnoNL (button) folded before Flop (didn't bet)
Seat 6: Metalaito (small blind) folded before Flop



PokerStars Hand #222950138557:  Hold'em No Limit ($0.05/$0.10 USD) - 2021/01/23 5:53:43 ET
Table 'Malzovia III' 6-max Seat #1 is the button
Seat 1: favourble ($10.42 in chips) 
Seat 2: kimmarusa ($18.07 in chips) 
Seat 3: GrinZwe91! ($10.95 in chips) 
Seat 5: PizzaTonnoNL ($13.47 in chips) 
kimmarusa: posts small blind $0.05
GrinZwe91!: posts big blind $0.10
*** HOLE CARDS ***
PizzaTonnoNL: folds 
favourble: raises $0.15 to $0.25
kimmarusa: calls $0.20
GrinZwe91!: calls $0.15
*** FLOP *** [Qs Ad 7h]
kimmarusa: checks 
GrinZwe91!: checks 
favourble: bets $0.22
kimmarusa: folds 
GrinZwe91!: calls $0.22
*** TURN *** [Qs Ad 7h] [Qc]
GrinZwe91!: checks 
favourble: checks 
*** RIVER *** [Qs Ad 7h Qc] [4d]
GrinZwe91!: checks 
favourble: bets $0.34
GrinZwe91!: calls $0.34
*** SHOW DOWN ***
favourble: shows [Js 5s] (a pair of Queens)
GrinZwe91!: shows [Ah 8h] (two pair, Aces and Queens)
GrinZwe91! collected $1.79 from pot
*** SUMMARY ***
Total pot $1.87 | Rake $0.08 
Board [Qs Ad 7h Qc 4d]
Seat 1: favourble (button) showed [Js 5s] and lost with a pair of Queens
Seat 2: kimmarusa (small blind) folded on the Flop
Seat 3: GrinZwe91! (big blind) showed [Ah 8h] and won ($1.79) with two pair, Aces and Queens
Seat 5: PizzaTonnoNL folded before Flop (didn't bet)



PokerStars Hand #222950153450:  Hold'em No Limit ($0.05/$0.10 USD) - 2021/01/23 5:54:30 ET
Table 'Malzovia III' 6-max Seat #2 is the button
Seat 1: favourble ($10 in chips) 
Seat 2: kimmarusa ($17.82 in chips) 
Seat 3: GrinZwe91! ($11.93 in chips) 
Seat 5: PizzaTonnoNL ($13.47 in chips) 
GrinZwe91!: posts small blind $0.05
PizzaTonnoNL: posts big blind $0.10
*** HOLE CARDS ***
favourble: folds 
kimmarusa: raises $0.20 to $0.30
GrinZwe91!: folds 
PizzaTonnoNL: calls $0.20
*** FLOP *** [9c 6d 2d]
PizzaTonnoNL: checks 
kimmarusa: checks 
*** TURN *** [9c 6d 2d] [Ts]
PizzaTonnoNL: bets $0.20
kimmarusa: folds 
Uncalled bet ($0.20) returned to PizzaTonnoNL
PizzaTonnoNL collected $0.62 from pot
*** SUMMARY ***
Total pot $0.65 | Rake $0.03 
Board [9c 6d 2d Ts]
Seat 1: favourble folded before Flop (didn't bet)
Seat 2: kimmarusa (button) folded on the Turn
Seat 3: GrinZwe91! (small blind) folded before Flop
Seat 5: PizzaTonnoNL (big blind) collected ($0.62)



PokerStars Hand #222950163773:  Hold'em No Limit ($0.05/$0.10 USD) - 2021/01/23 5:55:03 ET
Table 'Malzovia III' 6-max Seat #3 is the button
Seat 2: kimmarusa ($17.52 in chips) 
Seat 3: GrinZwe91! ($11.88 in chips) 
Seat 5: PizzaTonnoNL ($13.79 in chips) 
PizzaTonnoNL: posts small blind $0.05
favourble: is sitting out 
kimmarusa: posts big blind $0.10
*** HOLE CARDS ***
GrinZwe91!: folds 
favourble leaves the table
PizzaTonnoNL: folds 
Uncalled bet ($0.05) returned to kimmarusa
kimmarusa collected $0.10 from pot
kimmarusa: doesn't show hand 
*** SUMMARY ***
Total pot $0.10 | Rake $0 
Seat 2: kimmarusa (big blind) collected ($0.10)
Seat 3: GrinZwe91! (button) folded before Flop (didn't bet)
Seat 5: PizzaTonnoNL (small blind) folded before Flop



PokerStars Hand #222961969118:  Hold'em No Limit ($0.05/$0.10 USD) - 2021/01/23 12:46:17 ET
Table 'Malzovia' 6-max Seat #6 is the button
Seat 1: Marian0P ($13 in chips) 
Seat 2: MrLopov ($6.70 in chips) 
Seat 3: Donkey1996 ($13.74 in chips) 
Seat 4: Himik30 ($15.69 in chips) 
Seat 5: Rdalonso ($10.40 in chips) 
Seat 6: DMiller100 ($6.78 in chips) 
Marian0P: posts small blind $0.05
MrLopov: posts big blind $0.10
*** HOLE CARDS ***
Donkey1996: folds 
Himik30: folds 
Rdalonso: folds 
DMiller100: raises $0.10 to $0.20
Marian0P: folds 
MrLopov: calls $0.10
*** FLOP *** [2s Qh 6s]
MrLopov: checks 
DMiller100: bets $0.40
MrLopov: calls $0.40
*** TURN *** [2s Qh 6s] [Jh]
MrLopov: checks 
DMiller100: checks 
*** RIVER *** [2s Qh 6s Jh] [Jd]
MrLopov: checks 
DMiller100: bets $1.20
MrLopov: folds 
Uncalled bet ($1.20) returned to DMiller100
DMiller100 collected $1.19 from pot
*** SUMMARY ***
Total pot $1.25 | Rake $0.06 
Board [2s Qh 6s Jh Jd]
Seat 1: Marian0P (small blind) folded before Flop
Seat 2: MrLopov (big blind) folded on the River
Seat 3: Donkey1996 folded before Flop (didn't bet)
Seat 4: Himik30 folded before Flop (didn't bet)
Seat 5: Rdalonso folded before Flop (didn't bet)
Seat 6: DMiller100 (button) collected ($1.19)



PokerStars Hand #222961995838:  Hold'em No Limit ($0.05/$0.10 USD) - 2021/01/23 12:46:56 ET
Table 'Malzovia' 6-max Seat #1 is the button
Seat 1: Marian0P ($12.95 in chips) 
Seat 2: MrLopov ($6.10 in chips) 
Seat 3: Donkey1996 ($13.74 in chips) 
Seat 4: Himik30 ($15.69 in chips) 
Seat 5: Rdalonso ($10.40 in chips) 
Seat 6: DMiller100 ($7.37 in chips) 
MrLopov: posts small blind $0.05
Donkey1996: posts big blind $0.10
*** HOLE CARDS ***
Himik30: calls $0.10
Rdalonso: folds 
DMiller100: folds 
Marian0P: folds 
MrLopov: calls $0.05
Donkey1996: checks 
*** FLOP *** [9d 2s 5h]
MrLopov: checks 
Donkey1996: bets $0.20
Himik30: folds 
MrLopov: calls $0.20
*** TURN *** [9d 2s 5h] [6s]
MrLopov: checks 
Donkey1996: bets $0.55
MrLopov: calls $0.55
*** RIVER *** [9d 2s 5h 6s] [Kc]
MrLopov: bets $1.72
Donkey1996: raises $6.91 to $8.63
MrLopov: folds 
Uncalled bet ($6.91) returned to Donkey1996
Donkey1996 collected $5 from pot
Donkey1996: doesn't show hand 
*** SUMMARY ***
Total pot $5.24 | Rake $0.24 
Board [9d 2s 5h 6s Kc]
Seat 1: Marian0P (button) folded before Flop (didn't bet)
Seat 2: MrLopov (small blind) folded on the River
Seat 3: Donkey1996 (big blind) collected ($5)
Seat 4: Himik30 folded on the Flop
Seat 5: Rdalonso folded before Flop (didn't bet)
Seat 6: DMiller100 folded before Flop (didn't bet)



PokerStars Hand #222960801157:  Hold'em No Limit ($0.05/$0.10 USD) - 2021/01/23 12:16:54 ET
Table 'Malzovia' 6-max Seat #2 is the button
Seat 2: CCOleni ($4.14 in chips) 
Seat 5: Burlica2013 ($10 in chips) 
CCOleni: posts small blind $0.05
Burlica2013: posts big blind $0.10
*** HOLE CARDS ***
Marian0P joins the table at seat #1 
Lergik joins the table at seat #6 
CCOleni: folds 
Uncalled bet ($0.05) returned to Burlica2013
Himik30 joins the table at seat #4 
Burlica2013 collected $0.10 from pot
*** SUMMARY ***
Total pot $0.10 | Rake $0 
Seat 2: CCOleni (button) (small blind) folded before Flop
Seat 5: Burlica2013 (big blind) collected ($0.10)



PokerStars Hand #222961394408:  Hold'em No Limit ($0.05/$0.10 USD) - 2021/01/23 12:32:01 ET
Table 'Malzovia' 6-max Seat #2 is the button
Seat 1: Marian0P ($10 in chips) 
Seat 2: MrLopov ($9.61 in chips) 
Seat 3: Donkey1996 ($11.79 in chips) 
Seat 4: Himik30 ($15.20 in chips) 
Seat 5: k s ivan4 ($10 in chips) 
Donkey1996: posts small blind $0.05
Himik30: posts big blind $0.10
*** HOLE CARDS ***
k s ivan4: folds 
Marian0P: folds 
MrLopov: calls $0.10
Donkey1996: calls $0.05
Himik30: checks 
*** FLOP *** [6d Qc 6c]
Donkey1996: checks 
Himik30: checks 
MrLopov: checks 
*** TURN *** [6d Qc 6c] [9s]
Donkey1996: checks 
Himik30: checks 
MrLopov: checks 
*** RIVER *** [6d Qc 6c 9s] [4c]
Donkey1996: checks 
Himik30: checks 
MrLopov: checks 
*** SHOW DOWN ***
Donkey1996: shows [Kc Th] (a pair of Sixes)
Himik30: mucks hand 
MrLopov: mucks hand 
Donkey1996 collected $0.29 from pot
*** SUMMARY ***
Total pot $0.30 | Rake $0.01 
Board [6d Qc 6c 9s 4c]
Seat 1: Marian0P folded before Flop (didn't bet)
Seat 2: MrLopov (button) mucked
Seat 3: Donkey1996 (small blind) showed [Kc Th] and won ($0.29) with a pair of Sixes
Seat 4: Himik30 (big blind) mucked
Seat 5: k s ivan4 folded before Flop (didn't bet)



PokerStars Hand #222961414250:  Hold'em No Limit ($0.05/$0.10 USD) - 2021/01/23 12:32:31 ET
Table 'Malzovia' 6-max Seat #3 is the button
Seat 1: Marian0P ($10 in chips) 
Seat 2: MrLopov ($9.51 in chips) 
Seat 3: Donkey1996 ($11.98 in chips) 
Seat 4: Himik30 ($15.10 in chips) 
Seat 5: k s ivan4 ($10 in chips) 
Himik30: posts small blind $0.05
k s ivan4: posts big blind $0.10
*** HOLE CARDS ***
Marian0P: raises $0.20 to $0.30
MrLopov: folds 
Donkey1996: folds 
Himik30: folds 
k s ivan4: folds 
Uncalled bet ($0.20) returned to Marian0P
Marian0P collected $0.25 from pot
ochapman999 joins the table at seat #6 
*** SUMMARY ***
Total pot $0.25 | Rake $0 
Seat 1: Marian0P collected ($0.25)
Seat 2: MrLopov folded before Flop (didn't bet)
Seat 3: Donkey1996 (button) folded before Flop (didn't bet)
Seat 4: Himik30 (small blind) folded before Flop
Seat 5: k s ivan4 (big blind) folded before Flop



PokerStars Hand #222961422323:  Hold'em No Limit ($0.05/$0.10 USD) - 2021/01/23 12:32:43 ET
Table 'Malzovia' 6-max Seat #4 is the button
Seat 1: Marian0P ($10.15 in chips) 
Seat 2: MrLopov ($9.51 in chips) 
Seat 3: Donkey1996 ($11.98 in chips) 
Seat 4: Himik30 ($15.05 in chips) 
Seat 5: k s ivan4 ($10 in chips) 
Seat 6: ochapman999 ($10 in chips) 
k s ivan4: posts small blind $0.05
ochapman999: posts big blind $0.10
*** HOLE CARDS ***
Marian0P: folds 
MrLopov has timed out
MrLopov: folds 
Donkey1996: folds 
Himik30: folds 
k s ivan4: folds 
Uncalled bet ($0.05) returned to ochapman999
ochapman999 collected $0.10 from pot
ochapman999: doesn't show hand 
*** SUMMARY ***
Total pot $0.10 | Rake $0 
Seat 1: Marian0P folded before Flop (didn't bet)
Seat 2: MrLopov folded before Flop (didn't bet)
Seat 3: Donkey1996 folded before Flop (didn't bet)
Seat 4: Himik30 (button) folded before Flop (didn't bet)
Seat 5: k s ivan4 (small blind) folded before Flop
Seat 6: ochapman999 (big blind) collected ($0.10)



PokerStars Hand #222961433087:  Hold'em No Limit ($0.05/$0.10 USD) - 2021/01/23 12:32:59 ET
Table 'Malzovia' 6-max Seat #5 is the button
Seat 1: Marian0P ($10.15 in chips) 
Seat 3: Donkey1996 ($11.98 in chips) 
Seat 4: Himik30 ($15.05 in chips) 
Seat 5: k s ivan4 ($10 in chips) 
Seat 6: ochapman999 ($10.05 in chips) 
ochapman999: posts small blind $0.05
Marian0P: posts big blind $0.10
*** HOLE CARDS ***
Donkey1996: folds 
Himik30: folds 
k s ivan4: raises $0.15 to $0.25
ochapman999: folds 
Marian0P: folds 
Uncalled bet ($0.15) returned to k s ivan4
k s ivan4 collected $0.25 from pot
*** SUMMARY ***
Total pot $0.25 | Rake $0 
Seat 1: Marian0P (big blind) folded before Flop
Seat 3: Donkey1996 folded before Flop (didn't bet)
Seat 4: Himik30 folded before Flop (didn't bet)
Seat 5: k s ivan4 (button) collected ($0.25)
Seat 6: ochapman999 (small blind) folded before Flop



PokerStars Hand #222961441258:  Hold'em No Limit ($0.05/$0.10 USD) - 2021/01/23 12:33:11 ET
Table 'Malzovia' 6-max Seat #6 is the button
Seat 1: Marian0P ($10.05 in chips) 
Seat 2: MrLopov ($9.51 in chips) 
Seat 3: Donkey1996 ($11.98 in chips) 
Seat 4: Himik30 ($15.05 in chips) 
Seat 5: k s ivan4 ($10.15 in chips) 
Seat 6: ochapman999 ($10 in chips) 
Marian0P: posts small blind $0.05
MrLopov: posts big blind $0.10
*** HOLE CARDS ***
Donkey1996: folds 
Himik30: folds 
k s ivan4: folds 
ochapman999: calls $0.10
Marian0P: folds 
MrLopov: raises $0.10 to $0.20
ochapman999: calls $0.10
*** FLOP *** [Ks Ac 9s]
MrLopov: bets $0.43
ochapman999: folds 
Uncalled bet ($0.43) returned to MrLopov
MrLopov collected $0.43 from pot
MrLopov: doesn't show hand 
*** SUMMARY ***
Total pot $0.45 | Rake $0.02 
Board [Ks Ac 9s]
Seat 1: Marian0P (small blind) folded before Flop
Seat 2: MrLopov (big blind) collected ($0.43)
Seat 3: Donkey1996 folded before Flop (didn't bet)
Seat 4: Himik30 folded before Flop (didn't bet)
Seat 5: k s ivan4 folded before Flop (didn't bet)
Seat 6: ochapman999 (button) folded on the Flop



PokerStars Hand #222961457625:  Hold'em No Limit ($0.05/$0.10 USD) - 2021/01/23 12:33:36 ET
Table 'Malzovia' 6-max Seat #1 is the button
Seat 1: Marian0P ($10 in chips) 
Seat 2: MrLopov ($9.74 in chips) 
Seat 3: Donkey1996 ($11.98 in chips) 
Seat 4: Himik30 ($15.05 in chips) 
Seat 5: k s ivan4 ($10.15 in chips) 
Seat 6: ochapman999 ($9.80 in chips) 
MrLopov: posts small blind $0.05
Donkey1996: posts big blind $0.10
*** HOLE CARDS ***
Himik30: raises $0.15 to $0.25
k s ivan4: folds 
ochapman999: calls $0.25
Marian0P: folds 
MrLopov: calls $0.20
Donkey1996: folds 
*** FLOP *** [6h Jc 7c]
MrLopov: checks 
Himik30: bets $0.40
ochapman999: folds 
MrLopov: calls $0.40
*** TURN *** [6h Jc 7c] [2s]
MrLopov: checks 
Himik30: bets $1
MrLopov: folds 
Uncalled bet ($1) returned to Himik30
Himik30 collected $1.58 from pot
Himik30: doesn't show hand 
*** SUMMARY ***
Total pot $1.65 | Rake $0.07 
Board [6h Jc 7c 2s]
Seat 1: Marian0P (button) folded before Flop (didn't bet)
Seat 2: MrLopov (small blind) folded on the Turn
Seat 3: Donkey1996 (big blind) folded before Flop
Seat 4: Himik30 collected ($1.58)
Seat 5: k s ivan4 folded before Flop (didn't bet)
Seat 6: ochapman999 folded on the Flop



PokerStars Hand #222961485098:  Hold'em No Limit ($0.05/$0.10 USD) - 2021/01/23 12:34:17 ET
Table 'Malzovia' 6-max Seat #2 is the button
Seat 1: Marian0P ($10 in chips) 
Seat 2: MrLopov ($9.09 in chips) 
Seat 3: Donkey1996 ($11.88 in chips) 
Seat 4: Himik30 ($15.98 in chips) 
Seat 5: k s ivan4 ($10.15 in chips) 
Seat 6: ochapman999 ($9.55 in chips) 
Donkey1996: posts small blind $0.05
Himik30: posts big blind $0.10
*** HOLE CARDS ***
k s ivan4: folds 
ochapman999: folds 
ochapman999 leaves the table
Marian0P: folds 
MrLopov: calls $0.10
Donkey1996: calls $0.05
Himik30: checks 
*** FLOP *** [Qd 2s 5c]
DMiller100 joins the table at seat #6 
Donkey1996: checks 
Himik30: bets $0.15
MrLopov: raises $0.59 to $0.74
Donkey1996: folds 
Himik30: calls $0.59
*** TURN *** [Qd 2s 5c] [3d]
Himik30: checks 
MrLopov: checks 
*** RIVER *** [Qd 2s 5c 3d] [Jc]
Himik30: bets $0.70
MrLopov: calls $0.70
*** SHOW DOWN ***
Himik30: shows [Ah Qs] (a pair of Queens)
MrLopov: mucks hand 
Himik30 collected $3.04 from pot
*** SUMMARY ***
Total pot $3.18 | Rake $0.14 
Board [Qd 2s 5c 3d Jc]
Seat 1: Marian0P folded before Flop (didn't bet)
Seat 2: MrLopov (button) mucked
Seat 3: Donkey1996 (small blind) folded on the Flop
Seat 4: Himik30 (big blind) showed [Ah Qs] and won ($3.04) with a pair of Queens
Seat 5: k s ivan4 folded before Flop (didn't bet)
Seat 6: ochapman999 folded before Flop (didn't bet)



PokerStars Hand #222961523010:  Hold'em No Limit ($0.05/$0.10 USD) - 2021/01/23 12:35:13 ET
Table 'Malzovia' 6-max Seat #3 is the button
Seat 1: Marian0P ($10 in chips) 
Seat 2: MrLopov ($7.55 in chips) 
Seat 3: Donkey1996 ($11.78 in chips) 
Seat 4: Himik30 ($17.48 in chips) 
Seat 5: k s ivan4 ($10.15 in chips) 
Seat 6: DMiller100 ($10 in chips) 
Himik30: posts small blind $0.05
k s ivan4: posts big blind $0.10
DMiller100: posts big blind $0.10
*** HOLE CARDS ***
DMiller100: checks 
Marian0P: folds 
MrLopov: calls $0.10
Donkey1996: folds 
Himik30: folds 
k s ivan4: checks 
*** FLOP *** [Jh 3c Jc]
k s ivan4: checks 
DMiller100: checks 
MrLopov: checks 
*** TURN *** [Jh 3c Jc] [4s]
k s ivan4: checks 
DMiller100: checks 
MrLopov: bets $0.33
k s ivan4: folds 
DMiller100: folds 
Uncalled bet ($0.33) returned to MrLopov
MrLopov collected $0.33 from pot
MrLopov: doesn't show hand 
*** SUMMARY ***
Total pot $0.35 | Rake $0.02 
Board [Jh 3c Jc 4s]
Seat 1: Marian0P folded before Flop (didn't bet)
Seat 2: MrLopov collected ($0.33)
Seat 3: Donkey1996 (button) folded before Flop (didn't bet)
Seat 4: Himik30 (small blind) folded before Flop
Seat 5: k s ivan4 (big blind) folded on the Turn
Seat 6: DMiller100 folded on the Turn (didn't bet)



PokerStars Hand #222961547434:  Hold'em No Limit ($0.05/$0.10 USD) - 2021/01/23 12:35:50 ET
Table 'Malzovia' 6-max Seat #4 is the button
Seat 1: Marian0P ($10 in chips) 
Seat 2: MrLopov ($7.78 in chips) 
Seat 3: Donkey1996 ($11.78 in chips) 
Seat 4: Himik30 ($17.43 in chips) 
Seat 5: k s ivan4 ($10.05 in chips) 
Seat 6: DMiller100 ($9.90 in chips) 
k s ivan4: posts small blind $0.05
DMiller100: posts big blind $0.10
*** HOLE CARDS ***
Marian0P: raises $0.20 to $0.30
MrLopov: folds 
Donkey1996: folds 
Himik30: folds 
k s ivan4: folds 
DMiller100: calls $0.20
*** FLOP *** [8h As Jh]
DMiller100: bets $0.30
Marian0P: calls $0.30
*** TURN *** [8h As Jh] [3c]
DMiller100: checks 
Marian0P: bets $0.40
DMiller100: calls $0.40
*** RIVER *** [8h As Jh 3c] [Qs]
DMiller100: bets $0.98
Marian0P: calls $0.98
*** SHOW DOWN ***
DMiller100: shows [4s Ah] (a pair of Aces)
Marian0P: shows [Ts Ad] (a pair of Aces - Queen+Jack+Ten kicker)
Marian0P collected $3.83 from pot
*** SUMMARY ***
Total pot $4.01 | Rake $0.18 
Board [8h As Jh 3c Qs]
Seat 1: Marian0P showed [Ts Ad] and won ($3.83) with a pair of Aces
Seat 2: MrLopov folded before Flop (didn't bet)
Seat 3: Donkey1996 folded before Flop (didn't bet)
Seat 4: Himik30 (button) folded before Flop (didn't bet)
Seat 5: k s ivan4 (small blind) folded before Flop
Seat 6: DMiller100 (big blind) showed [4s Ah] and lost with a pair of Aces



PokerStars Hand #222961577402:  Hold'em No Limit ($0.05/$0.10 USD) - 2021/01/23 12:36:34 ET
Table 'Malzovia' 6-max Seat #5 is the button
Seat 1: Marian0P ($11.85 in chips) 
Seat 2: MrLopov ($7.78 in chips) 
Seat 3: Donkey1996 ($11.78 in chips) 
Seat 4: Himik30 ($17.43 in chips) 
Seat 5: k s ivan4 ($10 in chips) 
Seat 6: DMiller100 ($7.92 in chips) 
DMiller100: posts small blind $0.05
Marian0P: posts big blind $0.10
*** HOLE CARDS ***
MrLopov: folds 
Donkey1996: folds 
Himik30: folds 
k s ivan4: raises $0.15 to $0.25
DMiller100: calls $0.20
Marian0P: folds 
*** FLOP *** [6h 3c 3s]
DMiller100: checks 
k s ivan4: checks 
*** TURN *** [6h 3c 3s] [6s]
DMiller100: checks 
k s ivan4: bets $0.31
DMiller100: folds 
Uncalled bet ($0.31) returned to k s ivan4
k s ivan4 collected $0.57 from pot
*** SUMMARY ***
Total pot $0.60 | Rake $0.03 
Board [6h 3c 3s 6s]
Seat 1: Marian0P (big blind) folded before Flop
Seat 2: MrLopov folded before Flop (didn't bet)
Seat 3: Donkey1996 folded before Flop (didn't bet)
Seat 4: Himik30 folded before Flop (didn't bet)
Seat 5: k s ivan4 (button) collected ($0.57)
Seat 6: DMiller100 (small blind) folded on the Turn



PokerStars Hand #222961599413:  Hold'em No Limit ($0.05/$0.10 USD) - 2021/01/23 12:37:08 ET
Table 'Malzovia' 6-max Seat #6 is the button
Seat 1: Marian0P ($11.75 in chips) 
Seat 2: MrLopov ($7.78 in chips) 
Seat 3: Donkey1996 ($11.78 in chips) 
Seat 4: Himik30 ($17.43 in chips) 
Seat 5: k s ivan4 ($10.32 in chips) 
Seat 6: DMiller100 ($7.67 in chips) 
Marian0P: posts small blind $0.05
MrLopov: posts big blind $0.10
*** HOLE CARDS ***
Donkey1996: folds 
Himik30: folds 
k s ivan4: folds 
DMiller100: folds 
Marian0P: raises $0.20 to $0.30
MrLopov: calls $0.20
*** FLOP *** [8h 9s Ts]
Marian0P: bets $0.18
MrLopov: folds 
Uncalled bet ($0.18) returned to Marian0P
Marian0P collected $0.57 from pot
Marian0P: doesn't show hand 
*** SUMMARY ***
Total pot $0.60 | Rake $0.03 
Board [8h 9s Ts]
Seat 1: Marian0P (small blind) collected ($0.57)
Seat 2: MrLopov (big blind) folded on the Flop
Seat 3: Donkey1996 folded before Flop (didn't bet)
Seat 4: Himik30 folded before Flop (didn't bet)
Seat 5: k s ivan4 folded before Flop (didn't bet)
Seat 6: DMiller100 (button) folded before Flop (didn't bet)



PokerStars Hand #222961614684:  Hold'em No Limit ($0.05/$0.10 USD) - 2021/01/23 12:37:30 ET
Table 'Malzovia' 6-max Seat #1 is the button
Seat 1: Marian0P ($12.02 in chips) 
Seat 2: MrLopov ($7.48 in chips) 
Seat 3: Donkey1996 ($11.78 in chips) 
Seat 4: Himik30 ($17.43 in chips) 
Seat 5: k s ivan4 ($10.32 in chips) 
Seat 6: DMiller100 ($7.67 in chips) 
MrLopov: posts small blind $0.05
Donkey1996: posts big blind $0.10
*** HOLE CARDS ***
Himik30: folds 
k s ivan4: folds 
DMiller100: folds 
Marian0P: folds 
MrLopov: raises $0.10 to $0.20
Donkey1996: folds 
Uncalled bet ($0.10) returned to MrLopov
MrLopov collected $0.20 from pot
MrLopov: doesn't show hand 
*** SUMMARY ***
Total pot $0.20 | Rake $0 
Seat 1: Marian0P (button) folded before Flop (didn't bet)
Seat 2: MrLopov (small blind) collected ($0.20)
Seat 3: Donkey1996 (big blind) folded before Flop
Seat 4: Himik30 folded before Flop (didn't bet)
Seat 5: k s ivan4 folded before Flop (didn't bet)
Seat 6: DMiller100 folded before Flop (didn't bet)



PokerStars Hand #222961622982:  Hold'em No Limit ($0.05/$0.10 USD) - 2021/01/23 12:37:43 ET
Table 'Malzovia' 6-max Seat #2 is the button
Seat 1: Marian0P ($12.02 in chips) 
Seat 2: MrLopov ($7.58 in chips) 
Seat 3: Donkey1996 ($11.68 in chips) 
Seat 4: Himik30 ($17.43 in chips) 
Seat 5: k s ivan4 ($10.32 in chips) 
Seat 6: DMiller100 ($7.67 in chips) 
Donkey1996: posts small blind $0.05
Himik30: posts big blind $0.10
*** HOLE CARDS ***
k s ivan4: folds 
DMiller100: folds 
Marian0P: folds 
MrLopov: folds 
Donkey1996: raises $0.20 to $0.30
Himik30: calls $0.20
*** FLOP *** [7c 8s 8c]
Donkey1996: bets $0.19
Himik30: raises $0.21 to $0.40
Donkey1996: calls $0.21
*** TURN *** [7c 8s 8c] [3s]
Donkey1996: checks 
Himik30: checks 
*** RIVER *** [7c 8s 8c 3s] [4h]
Donkey1996: checks 
Himik30: bets $0.90
Donkey1996: calls $0.90
*** SHOW DOWN ***
Himik30: shows [Ad 5d] (a pair of Eights)
Donkey1996: shows [Ac Tc] (a pair of Eights - Ace+Ten kicker)
Donkey1996 collected $3.06 from pot
*** SUMMARY ***
Total pot $3.20 | Rake $0.14 
Board [7c 8s 8c 3s 4h]
Seat 1: Marian0P folded before Flop (didn't bet)
Seat 2: MrLopov (button) folded before Flop (didn't bet)
Seat 3: Donkey1996 (small blind) showed [Ac Tc] and won ($3.06) with a pair of Eights
Seat 4: Himik30 (big blind) showed [Ad 5d] and lost with a pair of Eights
Seat 5: k s ivan4 folded before Flop (didn't bet)
Seat 6: DMiller100 folded before Flop (didn't bet)



PokerStars Hand #222961655025:  Hold'em No Limit ($0.05/$0.10 USD) - 2021/01/23 12:38:31 ET
Table 'Malzovia' 6-max Seat #3 is the button
Seat 1: Marian0P ($12.02 in chips) 
Seat 2: MrLopov ($7.58 in chips) 
Seat 3: Donkey1996 ($13.14 in chips) 
Seat 4: Himik30 ($15.83 in chips) 
Seat 5: k s ivan4 ($10.32 in chips) 
Seat 6: DMiller100 ($7.67 in chips) 
Himik30: posts small blind $0.05
k s ivan4: posts big blind $0.10
*** HOLE CARDS ***
DMiller100: calls $0.10
Marian0P: raises $0.40 to $0.50
MrLopov: folds 
Donkey1996: folds 
Himik30: folds 
k s ivan4: folds 
DMiller100: calls $0.40
*** FLOP *** [Qs 3h 8s]
DMiller100: checks 
Marian0P: bets $0.34
DMiller100: calls $0.34
*** TURN *** [Qs 3h 8s] [Tc]
DMiller100: checks 
Marian0P: bets $1.60
DMiller100: folds 
Uncalled bet ($1.60) returned to Marian0P
Marian0P collected $1.75 from pot
Marian0P: doesn't show hand 
*** SUMMARY ***
Total pot $1.83 | Rake $0.08 
Board [Qs 3h 8s Tc]
Seat 1: Marian0P collected ($1.75)
Seat 2: MrLopov folded before Flop (didn't bet)
Seat 3: Donkey1996 (button) folded before Flop (didn't bet)
Seat 4: Himik30 (small blind) folded before Flop
Seat 5: k s ivan4 (big blind) folded before Flop
Seat 6: DMiller100 folded on the Turn



PokerStars Hand #222961684313:  Hold'em No Limit ($0.05/$0.10 USD) - 2021/01/23 12:39:14 ET
Table 'Malzovia' 6-max Seat #4 is the button
Seat 1: Marian0P ($12.93 in chips) 
Seat 2: MrLopov ($7.58 in chips) 
Seat 3: Donkey1996 ($13.14 in chips) 
Seat 4: Himik30 ($15.78 in chips) 
Seat 5: k s ivan4 ($10.22 in chips) 
Seat 6: DMiller100 ($6.83 in chips) 
k s ivan4: posts small blind $0.05
DMiller100: posts big blind $0.10
*** HOLE CARDS ***
Marian0P: folds 
MrLopov: folds 
Donkey1996: folds 
Himik30: raises $0.15 to $0.25
k s ivan4: raises $0.60 to $0.85
DMiller100: folds 
Himik30: folds 
Uncalled bet ($0.60) returned to k s ivan4
k s ivan4 collected $0.60 from pot
*** SUMMARY ***
Total pot $0.60 | Rake $0 
Seat 1: Marian0P folded before Flop (didn't bet)
Seat 2: MrLopov folded before Flop (didn't bet)
Seat 3: Donkey1996 folded before Flop (didn't bet)
Seat 4: Himik30 (button) folded before Flop
Seat 5: k s ivan4 (small blind) collected ($0.60)
Seat 6: DMiller100 (big blind) folded before Flop



PokerStars Hand #222961698018:  Hold'em No Limit ($0.05/$0.10 USD) - 2021/01/23 12:39:34 ET
Table 'Malzovia' 6-max Seat #5 is the button
Seat 1: Marian0P ($12.93 in chips) 
Seat 2: MrLopov ($7.58 in chips) 
Seat 3: Donkey1996 ($13.14 in chips) 
Seat 4: Himik30 ($15.53 in chips) 
Seat 5: k s ivan4 ($10.57 in chips) 
Seat 6: DMiller100 ($6.73 in chips) 
DMiller100: posts small blind $0.05
Marian0P: posts big blind $0.10
*** HOLE CARDS ***
MrLopov: folds 
Donkey1996: folds 
Himik30: folds 
k s ivan4: folds 
DMiller100: folds 
Uncalled bet ($0.05) returned to Marian0P
Marian0P collected $0.10 from pot
Marian0P: doesn't show hand 
*** SUMMARY ***
Total pot $0.10 | Rake $0 
Seat 1: Marian0P (big blind) collected ($0.10)
Seat 2: MrLopov folded before Flop (didn't bet)
Seat 3: Donkey1996 folded before Flop (didn't bet)
Seat 4: Himik30 folded before Flop (didn't bet)
Seat 5: k s ivan4 (button) folded before Flop (didn't bet)
Seat 6: DMiller100 (small blind) folded before Flop



PokerStars Hand #222961705037:  Hold'em No Limit ($0.05/$0.10 USD) - 2021/01/23 12:39:45 ET
Table 'Malzovia' 6-max Seat #6 is the button
Seat 1: Marian0P ($12.98 in chips) 
Seat 2: MrLopov ($7.58 in chips) 
Seat 3: Donkey1996 ($13.14 in chips) 
Seat 4: Himik30 ($15.53 in chips) 
Seat 5: k s ivan4 ($10.57 in chips) 
Seat 6: DMiller100 ($6.68 in chips) 
Marian0P: posts small blind $0.05
MrLopov: posts big blind $0.10
*** HOLE CARDS ***
Donkey1996: folds 
Himik30: folds 
k s ivan4: folds 
DMiller100: folds 
Marian0P: raises $0.20 to $0.30
MrLopov: calls $0.20
*** FLOP *** [Ts 6c 9h]
Marian0P: checks 
MrLopov: checks 
*** TURN *** [Ts 6c 9h] [Jd]
Marian0P: checks 
MrLopov: checks 
*** RIVER *** [Ts 6c 9h Jd] [6h]
Marian0P: checks 
MrLopov: checks 
*** SHOW DOWN ***
Marian0P: shows [Kd 9c] (two pair, Nines and Sixes)
MrLopov: mucks hand 
Marian0P collected $0.57 from pot
*** SUMMARY ***
Total pot $0.60 | Rake $0.03 
Board [Ts 6c 9h Jd 6h]
Seat 1: Marian0P (small blind) showed [Kd 9c] and won ($0.57) with two pair, Nines and Sixes
Seat 2: MrLopov (big blind) mucked
Seat 3: Donkey1996 folded before Flop (didn't bet)
Seat 4: Himik30 folded before Flop (didn't bet)
Seat 5: k s ivan4 folded before Flop (didn't bet)
Seat 6: DMiller100 (button) folded before Flop (didn't bet)



PokerStars Hand #222961729520:  Hold'em No Limit ($0.05/$0.10 USD) - 2021/01/23 12:40:21 ET
Table 'Malzovia' 6-max Seat #1 is the button
Seat 1: Marian0P ($13.25 in chips) 
Seat 2: MrLopov ($7.28 in chips) 
Seat 3: Donkey1996 ($13.14 in chips) 
Seat 4: Himik30 ($15.53 in chips) 
Seat 5: k s ivan4 ($10.57 in chips) 
Seat 6: DMiller100 ($6.68 in chips) 
MrLopov: posts small blind $0.05
Donkey1996: posts big blind $0.10
*** HOLE CARDS ***
Himik30: folds 
k s ivan4: folds 
DMiller100: raises $0.10 to $0.20
Marian0P: folds 
MrLopov: calls $0.15
Donkey1996: folds 
*** FLOP *** [Qd Ah Js]
MrLopov: checks 
DMiller100: bets $0.20
MrLopov: folds 
Uncalled bet ($0.20) returned to DMiller100
DMiller100 collected $0.48 from pot
*** SUMMARY ***
Total pot $0.50 | Rake $0.02 
Board [Qd Ah Js]
Seat 1: Marian0P (button) folded before Flop (didn't bet)
Seat 2: MrLopov (small blind) folded on the Flop
Seat 3: Donkey1996 (big blind) folded before Flop
Seat 4: Himik30 folded before Flop (didn't bet)
Seat 5: k s ivan4 folded before Flop (didn't bet)
Seat 6: DMiller100 collected ($0.48)



PokerStars Hand #222961746318:  Hold'em No Limit ($0.05/$0.10 USD) - 2021/01/23 12:40:46 ET
Table 'Malzovia' 6-max Seat #2 is the button
Seat 1: Marian0P ($13.25 in chips) 
Seat 2: MrLopov ($7.08 in chips) 
Seat 3: Donkey1996 ($13.04 in chips) 
Seat 4: Himik30 ($15.53 in chips) 
Seat 5: k s ivan4 ($10.57 in chips) 
Seat 6: DMiller100 ($6.96 in chips) 
Donkey1996: posts small blind $0.05
Himik30: posts big blind $0.10
*** HOLE CARDS ***
k s ivan4: folds 
DMiller100: folds 
Marian0P: folds 
MrLopov: calls $0.10
Donkey1996: calls $0.05
Himik30: checks 
*** FLOP *** [Kh As Kd]
Donkey1996: checks 
Himik30: checks 
MrLopov: bets $0.29
Donkey1996: calls $0.29
Himik30: folds 
*** TURN *** [Kh As Kd] [9d]
Donkey1996: checks 
MrLopov: bets $0.84
Donkey1996: calls $0.84
*** RIVER *** [Kh As Kd 9d] [8d]
Donkey1996: checks 
MrLopov: checks 
*** SHOW DOWN ***
Donkey1996: shows [Ad 6d] (a flush, Ace high)
MrLopov: mucks hand 
Donkey1996 collected $2.44 from pot
*** SUMMARY ***
Total pot $2.56 | Rake $0.12 
Board [Kh As Kd 9d 8d]
Seat 1: Marian0P folded before Flop (didn't bet)
Seat 2: MrLopov (button) mucked
Seat 3: Donkey1996 (small blind) showed [Ad 6d] and won ($2.44) with a flush, Ace high
Seat 4: Himik30 (big blind) folded on the Flop
Seat 5: k s ivan4 folded before Flop (didn't bet)
Seat 6: DMiller100 folded before Flop (didn't bet)



PokerStars Hand #222961781499:  Hold'em No Limit ($0.05/$0.10 USD) - 2021/01/23 12:41:38 ET
Table 'Malzovia' 6-max Seat #3 is the button
Seat 1: Marian0P ($13.25 in chips) 
Seat 2: MrLopov ($5.85 in chips) 
Seat 3: Donkey1996 ($14.25 in chips) 
Seat 4: Himik30 ($15.43 in chips) 
Seat 5: k s ivan4 ($10.57 in chips) 
Seat 6: DMiller100 ($6.96 in chips) 
Himik30: posts small blind $0.05
k s ivan4: posts big blind $0.10
*** HOLE CARDS ***
DMiller100: folds 
Marian0P: folds 
MrLopov: calls $0.10
Donkey1996: folds 
Himik30: folds 
k s ivan4: checks 
*** FLOP *** [Ah 7s 9h]
k s ivan4: checks 
MrLopov: checks 
*** TURN *** [Ah 7s 9h] [2c]
k s ivan4: checks 
MrLopov: checks 
*** RIVER *** [Ah 7s 9h 2c] [Jc]
k s ivan4: checks 
MrLopov: checks 
*** SHOW DOWN ***
k s ivan4: shows [Qh 2s] (a pair of Deuces)
MrLopov: mucks hand 
k s ivan4 collected $0.24 from pot
*** SUMMARY ***
Total pot $0.25 | Rake $0.01 
Board [Ah 7s 9h 2c Jc]
Seat 1: Marian0P folded before Flop (didn't bet)
Seat 2: MrLopov mucked
Seat 3: Donkey1996 (button) folded before Flop (didn't bet)
Seat 4: Himik30 (small blind) folded before Flop
Seat 5: k s ivan4 (big blind) showed [Qh 2s] and won ($0.24) with a pair of Deuces
Seat 6: DMiller100 folded before Flop (didn't bet)



PokerStars Hand #222961800530:  Hold'em No Limit ($0.05/$0.10 USD) - 2021/01/23 12:42:06 ET
Table 'Malzovia' 6-max Seat #4 is the button
Seat 1: Marian0P ($13.25 in chips) 
Seat 2: MrLopov ($5.75 in chips) 
Seat 3: Donkey1996 ($14.25 in chips) 
Seat 4: Himik30 ($15.38 in chips) 
Seat 5: k s ivan4 ($10.71 in chips) 
Seat 6: DMiller100 ($6.96 in chips) 
k s ivan4: posts small blind $0.05
DMiller100: posts big blind $0.10
*** HOLE CARDS ***
Marian0P: folds 
MrLopov: folds 
Donkey1996: raises $0.20 to $0.30
Himik30: folds 
k s ivan4: folds 
DMiller100: folds 
Uncalled bet ($0.20) returned to Donkey1996
Donkey1996 collected $0.25 from pot
Donkey1996: doesn't show hand 
*** SUMMARY ***
Total pot $0.25 | Rake $0 
Seat 1: Marian0P folded before Flop (didn't bet)
Seat 2: MrLopov folded before Flop (didn't bet)
Seat 3: Donkey1996 collected ($0.25)
Seat 4: Himik30 (button) folded before Flop (didn't bet)
Seat 5: k s ivan4 (small blind) folded before Flop
Seat 6: DMiller100 (big blind) folded before Flop



PokerStars Hand #222961809135:  Hold'em No Limit ($0.05/$0.10 USD) - 2021/01/23 12:42:19 ET
Table 'Malzovia' 6-max Seat #5 is the button
Seat 1: Marian0P ($13.25 in chips) 
Seat 2: MrLopov ($5.75 in chips) 
Seat 3: Donkey1996 ($14.40 in chips) 
Seat 4: Himik30 ($15.38 in chips) 
Seat 5: k s ivan4 ($10.66 in chips) 
Seat 6: DMiller100 ($6.86 in chips) 
DMiller100: posts small blind $0.05
Marian0P: posts big blind $0.10
*** HOLE CARDS ***
MrLopov: calls $0.10
Donkey1996: raises $0.30 to $0.40
Himik30: folds 
k s ivan4: folds 
DMiller100: folds 
Marian0P: folds 
k s ivan4 leaves the table
MrLopov: calls $0.30
*** FLOP *** [Ah 6d 3c]
MrLopov: checks 
Rdalonso joins the table at seat #5 
Donkey1996: checks 
*** TURN *** [Ah 6d 3c] [2s]
MrLopov: checks 
Donkey1996: checks 
*** RIVER *** [Ah 6d 3c 2s] [As]
MrLopov: checks 
Donkey1996: checks 
*** SHOW DOWN ***
MrLopov: shows [4d 4s] (two pair, Aces and Fours)
Donkey1996: mucks hand 
MrLopov collected $0.91 from pot
*** SUMMARY ***
Total pot $0.95 | Rake $0.04 
Board [Ah 6d 3c 2s As]
Seat 1: Marian0P (big blind) folded before Flop
Seat 2: MrLopov showed [4d 4s] and won ($0.91) with two pair, Aces and Fours
Seat 3: Donkey1996 mucked
Seat 4: Himik30 folded before Flop (didn't bet)
Seat 5: k s ivan4 (button) folded before Flop (didn't bet)
Seat 6: DMiller100 (small blind) folded before Flop



PokerStars Hand #222961835162:  Hold'em No Limit ($0.05/$0.10 USD) - 2021/01/23 12:42:58 ET
Table 'Malzovia' 6-max Seat #6 is the button
Seat 1: Marian0P ($13.15 in chips) 
Seat 2: MrLopov ($6.26 in chips) 
Seat 3: Donkey1996 ($14 in chips) 
Seat 4: Himik30 ($15.38 in chips) 
Seat 6: DMiller100 ($6.81 in chips) 
Marian0P: posts small blind $0.05
MrLopov: posts big blind $0.10
Rdalonso: sits out 
*** HOLE CARDS ***
Donkey1996: raises $0.20 to $0.30
Himik30: folds 
DMiller100: calls $0.30
Marian0P: folds 
MrLopov: folds 
*** FLOP *** [2h 5c Ac]
Donkey1996: checks 
DMiller100: bets $0.30
Donkey1996: folds 
Uncalled bet ($0.30) returned to DMiller100
DMiller100 collected $0.72 from pot
*** SUMMARY ***
Total pot $0.75 | Rake $0.03 
Board [2h 5c Ac]
Seat 1: Marian0P (small blind) folded before Flop
Seat 2: MrLopov (big blind) folded before Flop
Seat 3: Donkey1996 folded on the Flop
Seat 4: Himik30 folded before Flop (didn't bet)
Seat 6: DMiller100 (button) collected ($0.72)



PokerStars Hand #222961850233:  Hold'em No Limit ($0.05/$0.10 USD) - 2021/01/23 12:43:20 ET
Table 'Malzovia' 6-max Seat #1 is the button
Seat 1: Marian0P ($13.10 in chips) 
Seat 2: MrLopov ($6.16 in chips) 
Seat 3: Donkey1996 ($13.70 in chips) 
Seat 4: Himik30 ($15.38 in chips) 
Seat 6: DMiller100 ($7.23 in chips) 
MrLopov: posts small blind $0.05
Donkey1996: posts big blind $0.10
Rdalonso: sits out 
*** HOLE CARDS ***
Himik30: folds 
DMiller100: folds 
Marian0P: folds 
MrLopov: calls $0.05
Donkey1996: checks 
*** FLOP *** [Th Kd 7d]
MrLopov: checks 
Donkey1996: bets $0.13
MrLopov: folds 
Uncalled bet ($0.13) returned to Donkey1996
Donkey1996 collected $0.19 from pot
Donkey1996: doesn't show hand 
*** SUMMARY ***
Total pot $0.20 | Rake $0.01 
Board [Th Kd 7d]
Seat 1: Marian0P (button) folded before Flop (didn't bet)
Seat 2: MrLopov (small blind) folded on the Flop
Seat 3: Donkey1996 (big blind) collected ($0.19)
Seat 4: Himik30 folded before Flop (didn't bet)
Seat 6: DMiller100 folded before Flop (didn't bet)



PokerStars Hand #222961868600:  Hold'em No Limit ($0.05/$0.10 USD) - 2021/01/23 12:43:47 ET
Table 'Malzovia' 6-max Seat #2 is the button
Seat 1: Marian0P ($13.10 in chips) 
Seat 2: MrLopov ($6.06 in chips) 
Seat 3: Donkey1996 ($13.79 in chips) 
Seat 4: Himik30 ($15.38 in chips) 
Seat 6: DMiller100 ($7.23 in chips) 
Donkey1996: posts small blind $0.05
Himik30: posts big blind $0.10
Rdalonso: sits out 
*** HOLE CARDS ***
DMiller100: raises $0.20 to $0.30
Marian0P: folds 
MrLopov: calls $0.30
Donkey1996: folds 
Himik30: calls $0.20
*** FLOP *** [9s Js 4d]
Himik30: checks 
DMiller100: checks 
MrLopov: checks 
*** TURN *** [9s Js 4d] [6s]
Himik30: checks 
DMiller100: checks 
MrLopov: checks 
*** RIVER *** [9s Js 4d 6s] [5h]
Himik30: checks 
DMiller100: checks 
MrLopov: checks 
*** SHOW DOWN ***
Himik30: shows [As 5d] (a pair of Fives)
DMiller100: mucks hand 
MrLopov: mucks hand 
Himik30 collected $0.91 from pot
*** SUMMARY ***
Total pot $0.95 | Rake $0.04 
Board [9s Js 4d 6s 5h]
Seat 1: Marian0P folded before Flop (didn't bet)
Seat 2: MrLopov (button) mucked
Seat 3: Donkey1996 (small blind) folded before Flop
Seat 4: Himik30 (big blind) showed [As 5d] and won ($0.91) with a pair of Fives
Seat 6: DMiller100 mucked



PokerStars Hand #222961897207:  Hold'em No Limit ($0.05/$0.10 USD) - 2021/01/23 12:44:30 ET
Table 'Malzovia' 6-max Seat #3 is the button
Seat 1: Marian0P ($13.10 in chips) 
Seat 2: MrLopov ($5.76 in chips) 
Seat 3: Donkey1996 ($13.74 in chips) 
Seat 4: Himik30 ($15.99 in chips) 
Seat 5: Rdalonso ($10 in chips) 
Seat 6: DMiller100 ($6.93 in chips) 
Himik30: posts small blind $0.05
Rdalonso: posts big blind $0.10
*** HOLE CARDS ***
DMiller100: folds 
Marian0P: folds 
MrLopov: calls $0.10
Donkey1996: folds 
Himik30: folds 
Rdalonso: raises $0.40 to $0.50
MrLopov: calls $0.40
*** FLOP *** [6d Jd Ks]
Rdalonso: bets $0.33
MrLopov: calls $0.33
*** TURN *** [6d Jd Ks] [2c]
Rdalonso: checks 
MrLopov: checks 
*** RIVER *** [6d Jd Ks 2c] [Kd]
Rdalonso: checks 
MrLopov: checks 
*** SHOW DOWN ***
Rdalonso: shows [8s 9s] (a pair of Kings)
MrLopov: shows [Jh 9h] (two pair, Kings and Jacks)
MrLopov collected $1.63 from pot
*** SUMMARY ***
Total pot $1.71 | Rake $0.08 
Board [6d Jd Ks 2c Kd]
Seat 1: Marian0P folded before Flop (didn't bet)
Seat 2: MrLopov showed [Jh 9h] and won ($1.63) with two pair, Kings and Jacks
Seat 3: Donkey1996 (button) folded before Flop (didn't bet)
Seat 4: Himik30 (small blind) folded before Flop
Seat 5: Rdalonso (big blind) showed [8s 9s] and lost with a pair of Kings
Seat 6: DMiller100 folded before Flop (didn't bet)



PokerStars Hand #222961930929:  Hold'em No Limit ($0.05/$0.10 USD) - 2021/01/23 12:45:20 ET
Table 'Malzovia' 6-max Seat #4 is the button
Seat 1: Marian0P ($13.10 in chips) 
Seat 2: MrLopov ($6.56 in chips) 
Seat 3: Donkey1996 ($13.74 in chips) 
Seat 4: Himik30 ($15.94 in chips) 
Seat 5: Rdalonso ($10 in chips) 
Seat 6: DMiller100 ($6.93 in chips) 
Rdalonso: posts small blind $0.05
DMiller100: posts big blind $0.10
*** HOLE CARDS ***
Marian0P: folds 
MrLopov: calls $0.10
Donkey1996: folds 
Himik30: folds 
Rdalonso: folds 
DMiller100: checks 
*** FLOP *** [3s As 8s]
DMiller100: checks 
MrLopov: bets $0.10
DMiller100: folds 
Uncalled bet ($0.10) returned to MrLopov
MrLopov collected $0.24 from pot
MrLopov: doesn't show hand 
*** SUMMARY ***
Total pot $0.25 | Rake $0.01 
Board [3s As 8s]
Seat 1: Marian0P folded before Flop (didn't bet)
Seat 2: MrLopov collected ($0.24)
Seat 3: Donkey1996 folded before Flop (didn't bet)
Seat 4: Himik30 (button) folded before Flop (didn't bet)
Seat 5: Rdalonso (small blind) folded before Flop
Seat 6: DMiller100 (big blind) folded on the Flop



PokerStars Hand #222961949785:  Hold'em No Limit ($0.05/$0.10 USD) - 2021/01/23 12:45:48 ET
Table 'Malzovia' 6-max Seat #5 is the button
Seat 1: Marian0P ($13.10 in chips) 
Seat 2: MrLopov ($6.70 in chips) 
Seat 3: Donkey1996 ($13.74 in chips) 
Seat 4: Himik30 ($15.94 in chips) 
Seat 5: Rdalonso ($10 in chips) 
Seat 6: DMiller100 ($6.83 in chips) 
DMiller100: posts small blind $0.05
Marian0P: posts big blind $0.10
*** HOLE CARDS ***
MrLopov: folds 
Donkey1996: folds 
Himik30: raises $0.15 to $0.25
Rdalonso: raises $0.55 to $0.80
DMiller100: folds 
Marian0P: folds 
Himik30: folds 
Uncalled bet ($0.55) returned to Rdalonso
Rdalonso collected $0.65 from pot
Rdalonso: doesn't show hand 
*** SUMMARY ***
Total pot $0.65 | Rake $0 
Seat 1: Marian0P (big blind) folded before Flop
Seat 2: MrLopov folded before Flop (didn't bet)
Seat 3: Donkey1996 folded before Flop (didn't bet)
Seat 4: Himik30 folded before Flop
Seat 5: Rdalonso (button) collected ($0.65)
Seat 6: DMiller100 (small blind) folded before Flop



PokerStars Hand #222962525044:  Hold'em No Limit ($0.05/$0.10 USD) - 2021/01/23 13:01:23 ET
Table 'Malzovia' 6-max Seat #4 is the button
Seat 1: sapr.549 ($10 in chips) 
Seat 2: Buinstra16 ($9.90 in chips) 
Seat 3: Donkey1996 ($12.63 in chips) 
Seat 4: Himik30 ($19.28 in chips) 
Seat 6: O.G.Michael ($11.80 in chips) 
O.G.Michael: posts small blind $0.05
sapr.549: posts big blind $0.10
*** HOLE CARDS ***
Rdalonso leaves the table
Buinstra16: folds 
Donkey1996: raises $0.20 to $0.30
Himik30: folds 
O.G.Michael: folds 
sapr.549: folds 
Uncalled bet ($0.20) returned to Donkey1996
Donkey1996 collected $0.25 from pot
Donkey1996: doesn't show hand 
*** SUMMARY ***
Total pot $0.25 | Rake $0 
Seat 1: sapr.549 (big blind) folded before Flop
Seat 2: Buinstra16 folded before Flop (didn't bet)
Seat 3: Donkey1996 collected ($0.25)
Seat 4: Himik30 (button) folded before Flop (didn't bet)
Seat 6: O.G.Michael (small blind) folded before Flop



PokerStars Hand #222962533325:  Hold'em No Limit ($0.05/$0.10 USD) - 2021/01/23 13:01:36 ET
Table 'Malzovia' 6-max Seat #6 is the button
Seat 1: sapr.549 ($9.90 in chips) 
Seat 2: Buinstra16 ($9.90 in chips) 
Seat 3: Donkey1996 ($12.78 in chips) 
Seat 4: Himik30 ($19.28 in chips) 
Seat 6: O.G.Michael ($11.75 in chips) 
sapr.549: posts small blind $0.05
Buinstra16: posts big blind $0.10
*** HOLE CARDS ***
Donkey1996: folds 
Himik30: raises $0.15 to $0.25
O.G.Michael: folds 
sapr.549: raises $0.42 to $0.67
Buinstra16: folds 
Himik30: calls $0.42
*** FLOP *** [8c Qd 8d]
sapr.549: bets $0.97
Himik30: folds 
Uncalled bet ($0.97) returned to sapr.549
sapr.549 collected $1.38 from pot
sapr.549: doesn't show hand 
*** SUMMARY ***
Total pot $1.44 | Rake $0.06 
Board [8c Qd 8d]
Seat 1: sapr.549 (small blind) collected ($1.38)
Seat 2: Buinstra16 (big blind) folded before Flop
Seat 3: Donkey1996 folded before Flop (didn't bet)
Seat 4: Himik30 folded on the Flop
Seat 6: O.G.Michael (button) folded before Flop (didn't bet)



PokerStars Hand #222962550264:  Hold'em No Limit ($0.05/$0.10 USD) - 2021/01/23 13:02:03 ET
Table 'Malzovia' 6-max Seat #1 is the button
Seat 1: sapr.549 ($10.61 in chips) 
Seat 2: Buinstra16 ($9.80 in chips) 
Seat 4: Himik30 ($18.61 in chips) 
Seat 6: O.G.Michael ($11.75 in chips) 
Buinstra16: posts small blind $0.05
Donkey1996: is sitting out 
Himik30: posts big blind $0.10
*** HOLE CARDS ***
O.G.Michael: folds 
sapr.549: raises $0.15 to $0.25
Buinstra16: raises $0.35 to $0.60
Himik30: folds 
sapr.549: folds 
Uncalled bet ($0.35) returned to Buinstra16
Buinstra16 collected $0.60 from pot
Buinstra16: doesn't show hand 
*** SUMMARY ***
Total pot $0.60 | Rake $0 
Seat 1: sapr.549 (button) folded before Flop
Seat 2: Buinstra16 (small blind) collected ($0.60)
Seat 4: Himik30 (big blind) folded before Flop
Seat 6: O.G.Michael folded before Flop (didn't bet)



PokerStars Hand #222962559691:  Hold'em No Limit ($0.05/$0.10 USD) - 2021/01/23 13:02:18 ET
Table 'Malzovia' 6-max Seat #2 is the button
Seat 1: sapr.549 ($10.36 in chips) 
Seat 2: Buinstra16 ($10.15 in chips) 
Seat 4: Himik30 ($18.51 in chips) 
Himik30: posts small blind $0.05
O.G.Michael: is sitting out 
sapr.549: posts big blind $0.10
*** HOLE CARDS ***
Buinstra16: calls $0.10
Himik30: calls $0.05
sapr.549: checks 
*** FLOP *** [Kh Qd Qh]
Himik30: checks 
sapr.549: checks 
auaets joins the table at seat #5 
Buinstra16: checks 
*** TURN *** [Kh Qd Qh] [2c]
Himik30: checks 
sapr.549: checks 
Buinstra16: checks 
*** RIVER *** [Kh Qd Qh 2c] [5d]
Himik30: checks 
sapr.549: checks 
Buinstra16: checks 
*** SHOW DOWN ***
Himik30: shows [9c 8c] (a pair of Queens)
sapr.549: mucks hand 
Buinstra16: shows [2d 4d] (two pair, Queens and Deuces)
Buinstra16 collected $0.29 from pot
*** SUMMARY ***
Total pot $0.30 | Rake $0.01 
Board [Kh Qd Qh 2c 5d]
Seat 1: sapr.549 (big blind) mucked
Seat 2: Buinstra16 (button) showed [2d 4d] and won ($0.29) with two pair, Queens and Deuces
Seat 4: Himik30 (small blind) showed [9c 8c] and lost with a pair of Queens



PokerStars Hand #222962590338:  Hold'em No Limit ($0.05/$0.10 USD) - 2021/01/23 13:03:03 ET
Table 'Malzovia' 6-max Seat #4 is the button
Seat 1: sapr.549 ($10.26 in chips) 
Seat 2: Buinstra16 ($10.34 in chips) 
Seat 4: Himik30 ($18.41 in chips) 
sapr.549: posts small blind $0.05
Buinstra16: posts big blind $0.10
*** HOLE CARDS ***
Himik30: folds 
Donkey1996 leaves the table
sapr.549: folds 
Uncalled bet ($0.05) returned to Buinstra16
Buinstra16 collected $0.10 from pot
Buinstra16: doesn't show hand 
*** SUMMARY ***
Total pot $0.10 | Rake $0 
Seat 1: sapr.549 (small blind) folded before Flop
Seat 2: Buinstra16 (big blind) collected ($0.10)
Seat 4: Himik30 (button) folded before Flop (didn't bet)



PokerStars Hand #222962594454:  Hold'em No Limit ($0.05/$0.10 USD) - 2021/01/23 13:03:09 ET
Table 'Malzovia' 6-max Seat #1 is the button
Seat 1: sapr.549 ($10.21 in chips) 
Seat 2: Buinstra16 ($10.39 in chips) 
Seat 4: Himik30 ($18.41 in chips) 
Buinstra16: posts small blind $0.05
Himik30: posts big blind $0.10
auaets: sits out 
*** HOLE CARDS ***
sapr.549: folds 
Fifilaplum joins the table at seat #3 
Buinstra16: folds 
Uncalled bet ($0.05) returned to Himik30
Himik30 collected $0.10 from pot
Himik30: doesn't show hand 
*** SUMMARY ***
Total pot $0.10 | Rake $0 
Seat 1: sapr.549 (button) folded before Flop (didn't bet)
Seat 2: Buinstra16 (small blind) folded before Flop
Seat 4: Himik30 (big blind) collected ($0.10)



PokerStars Hand #222962601408:  Hold'em No Limit ($0.05/$0.10 USD) - 2021/01/23 13:03:19 ET
Table 'Malzovia' 6-max Seat #2 is the button
Seat 1: sapr.549 ($10.21 in chips) 
Seat 2: Buinstra16 ($10.34 in chips) 
Seat 4: Himik30 ($18.46 in chips) 
Seat 5: auaets ($4 in chips) 
Himik30: posts small blind $0.05
auaets: posts big blind $0.10
*** HOLE CARDS ***
sapr.549: raises $0.15 to $0.25
Buinstra16: calls $0.25
Himik30: folds 
auaets has timed out
auaets: folds 
*** FLOP *** [Qc Kh 7h]
sapr.549: checks 
Buinstra16: checks 
*** TURN *** [Qc Kh 7h] [8s]
sapr.549: checks 
Buinstra16: checks 
*** RIVER *** [Qc Kh 7h 8s] [8d]
sapr.549: checks 
Buinstra16: checks 
*** SHOW DOWN ***
sapr.549: shows [3s 3d] (two pair, Eights and Threes)
Buinstra16: mucks hand 
sapr.549 collected $0.62 from pot
*** SUMMARY ***
Total pot $0.65 | Rake $0.03 
Board [Qc Kh 7h 8s 8d]
Seat 1: sapr.549 showed [3s 3d] and won ($0.62) with two pair, Eights and Threes
Seat 2: Buinstra16 (button) mucked
Seat 4: Himik30 (small blind) folded before Flop
Seat 5: auaets (big blind) folded before Flop



PokerStars Hand #222962641473:  Hold'em No Limit ($0.05/$0.10 USD) - 2021/01/23 13:04:18 ET
Table 'Malzovia' 6-max Seat #4 is the button
Seat 1: sapr.549 ($10.58 in chips) 
Seat 2: Buinstra16 ($10.09 in chips) 
Seat 4: Himik30 ($18.41 in chips) 
Seat 5: auaets ($3.90 in chips) 
auaets: posts small blind $0.05
sapr.549: posts big blind $0.10
Fifilaplum: sits out 
*** HOLE CARDS ***
Buinstra16: raises $0.20 to $0.30
Himik30: calls $0.30
auaets has timed out
auaets: folds 
sapr.549: folds 
*** FLOP *** [3s Th 8d]
Buinstra16: checks 
Himik30: checks 
*** TURN *** [3s Th 8d] [5d]
Buinstra16: bets $0.35
Himik30: folds 
Uncalled bet ($0.35) returned to Buinstra16
Buinstra16 collected $0.72 from pot
Buinstra16: doesn't show hand 
*** SUMMARY ***
Total pot $0.75 | Rake $0.03 
Board [3s Th 8d 5d]
Seat 1: sapr.549 (big blind) folded before Flop
Seat 2: Buinstra16 collected ($0.72)
Seat 4: Himik30 (button) folded on the Turn
Seat 5: auaets (small blind) folded before Flop



PokerStars Hand #222962682189:  Hold'em No Limit ($0.05/$0.10 USD) - 2021/01/23 13:05:17 ET
Table 'Malzovia' 6-max Seat #5 is the button
Seat 1: sapr.549 ($10.48 in chips) 
Seat 2: Buinstra16 ($10.51 in chips) 
Seat 4: Himik30 ($18.11 in chips) 
Seat 5: auaets ($3.85 in chips) 
sapr.549: posts small blind $0.05
Buinstra16: posts big blind $0.10
Fifilaplum: sits out 
*** HOLE CARDS ***
Himik30: folds 
auaets has timed out
auaets: folds 
sapr.549: folds 
Uncalled bet ($0.05) returned to Buinstra16
Buinstra16 collected $0.10 from pot
Buinstra16: doesn't show hand 
*** SUMMARY ***
Total pot $0.10 | Rake $0 
Seat 1: sapr.549 (small blind) folded before Flop
Seat 2: Buinstra16 (big blind) collected ($0.10)
Seat 4: Himik30 folded before Flop (didn't bet)
Seat 5: auaets (button) folded before Flop (didn't bet)



PokerStars Hand #222962693596:  Hold'em No Limit ($0.05/$0.10 USD) - 2021/01/23 13:05:33 ET
Table 'Malzovia' 6-max Seat #1 is the button
Seat 1: sapr.549 ($10.43 in chips) 
Seat 2: Buinstra16 ($10.56 in chips) 
Seat 3: Fifilaplum ($10 in chips) 
Seat 4: Himik30 ($18.11 in chips) 
Buinstra16: posts small blind $0.05
Fifilaplum: posts big blind $0.10
*** HOLE CARDS ***
Himik30: folds 
sapr.549: folds 
Buinstra16: folds 
Uncalled bet ($0.05) returned to Fifilaplum
Fifilaplum collected $0.10 from pot
Fifilaplum: doesn't show hand 
*** SUMMARY ***
Total pot $0.10 | Rake $0 
Seat 1: sapr.549 (button) folded before Flop (didn't bet)
Seat 2: Buinstra16 (small blind) folded before Flop
Seat 3: Fifilaplum (big blind) collected ($0.10)
Seat 4: Himik30 folded before Flop (didn't bet)



PokerStars Hand #222962698120:  Hold'em No Limit ($0.05/$0.10 USD) - 2021/01/23 13:05:40 ET
Table 'Malzovia' 6-max Seat #2 is the button
Seat 1: sapr.549 ($10.43 in chips) 
Seat 2: Buinstra16 ($10.51 in chips) 
Seat 3: Fifilaplum ($10.05 in chips) 
Seat 4: Himik30 ($18.11 in chips) 
Fifilaplum: posts small blind $0.05
Himik30: posts big blind $0.10
*** HOLE CARDS ***
sapr.549: folds 
Buinstra16: raises $0.10 to $0.20
Fifilaplum: folds 
Himik30: calls $0.10
*** FLOP *** [Tc Jd 4h]
Himik30: checks 
Buinstra16: bets $0.10
Himik30: raises $0.20 to $0.30
Buinstra16: calls $0.20
*** TURN *** [Tc Jd 4h] [Ah]
Himik30: checks 
Buinstra16: checks 
*** RIVER *** [Tc Jd 4h Ah] [4s]
Himik30: checks 
Buinstra16: checks 
*** SHOW DOWN ***
Himik30: shows [5d Kc] (a pair of Fours)
Buinstra16: shows [8d Jh] (two pair, Jacks and Fours)
Buinstra16 collected $1 from pot
*** SUMMARY ***
Total pot $1.05 | Rake $0.05 
Board [Tc Jd 4h Ah 4s]
Seat 1: sapr.549 folded before Flop (didn't bet)
Seat 2: Buinstra16 (button) showed [8d Jh] and won ($1) with two pair, Jacks and Fours
Seat 3: Fifilaplum (small blind) folded before Flop
Seat 4: Himik30 (big blind) showed [5d Kc] and lost with a pair of Fours



PokerStars Hand #222962744445:  Hold'em No Limit ($0.05/$0.10 USD) - 2021/01/23 13:06:47 ET
Table 'Malzovia' 6-max Seat #3 is the button
Seat 1: sapr.549 ($10.43 in chips) 
Seat 2: Buinstra16 ($11.01 in chips) 
Seat 3: Fifilaplum ($10 in chips) 
Seat 4: Himik30 ($17.61 in chips) 
Seat 5: auaets ($3.85 in chips) 
Himik30: posts small blind $0.05
auaets: posts big blind $0.10
*** HOLE CARDS ***
sapr.549: folds 
Buinstra16: calls $0.10
Fifilaplum: folds 
Himik30: calls $0.05
auaets: checks 
*** FLOP *** [Qh Qd 5d]
Himik30: checks 
auaets: checks 
Buinstra16: checks 
*** TURN *** [Qh Qd 5d] [6s]
Himik30: checks 
auaets: checks 
Buinstra16: checks 
*** RIVER *** [Qh Qd 5d 6s] [7d]
Himik30: bets $0.15
auaets: folds 
Buinstra16: folds 
Uncalled bet ($0.15) returned to Himik30
Himik30 collected $0.29 from pot
Himik30: doesn't show hand 
*** SUMMARY ***
Total pot $0.30 | Rake $0.01 
Board [Qh Qd 5d 6s 7d]
Seat 1: sapr.549 folded before Flop (didn't bet)
Seat 2: Buinstra16 folded on the River
Seat 3: Fifilaplum (button) folded before Flop (didn't bet)
Seat 4: Himik30 (small blind) collected ($0.29)
Seat 5: auaets (big blind) folded on the River



PokerStars Hand #222962780746:  Hold'em No Limit ($0.05/$0.10 USD) - 2021/01/23 13:07:40 ET
Table 'Malzovia' 6-max Seat #4 is the button
Seat 1: sapr.549 ($10.43 in chips) 
Seat 2: Buinstra16 ($10.91 in chips) 
Seat 3: Fifilaplum ($10 in chips) 
Seat 4: Himik30 ($17.80 in chips) 
Seat 5: auaets ($3.75 in chips) 
Seat 6: O.G.Michael ($11.75 in chips) 
auaets: posts small blind $0.05
O.G.Michael: posts big blind $0.10
*** HOLE CARDS ***
sapr.549: folds 
Buinstra16: raises $0.30 to $0.40
Fifilaplum: folds 
Himik30: folds 
auaets: folds 
O.G.Michael: calls $0.30
*** FLOP *** [Ks 5h 9c]
O.G.Michael: checks 
Buinstra16: bets $0.50
O.G.Michael: calls $0.50
*** TURN *** [Ks 5h 9c] [4s]
O.G.Michael: checks 
Buinstra16: bets $0.80
O.G.Michael: raises $1.60 to $2.40
Buinstra16: calls $1.60
*** RIVER *** [Ks 5h 9c 4s] [As]
O.G.Michael: checks 
Buinstra16: checks 
*** SHOW DOWN ***
O.G.Michael: shows [7d 6d] (high card Ace)
Buinstra16: shows [Qh Qd] (a pair of Queens)
Buinstra16 collected $6.35 from pot
*** SUMMARY ***
Total pot $6.65 | Rake $0.30 
Board [Ks 5h 9c 4s As]
Seat 1: sapr.549 folded before Flop (didn't bet)
Seat 2: Buinstra16 showed [Qh Qd] and won ($6.35) with a pair of Queens
Seat 3: Fifilaplum folded before Flop (didn't bet)
Seat 4: Himik30 (button) folded before Flop (didn't bet)
Seat 5: auaets (small blind) folded before Flop
Seat 6: O.G.Michael (big blind) showed [7d 6d] and lost with high card Ace



PokerStars Hand #222962814193:  Hold'em No Limit ($0.05/$0.10 USD) - 2021/01/23 13:08:28 ET
Table 'Malzovia' 6-max Seat #5 is the button
Seat 1: sapr.549 ($10.43 in chips) 
Seat 2: Buinstra16 ($13.96 in chips) 
Seat 3: Fifilaplum ($10 in chips) 
Seat 4: Himik30 ($17.80 in chips) 
Seat 5: auaets ($3.70 in chips) 
Seat 6: O.G.Michael ($10 in chips) 
O.G.Michael: posts small blind $0.05
sapr.549: posts big blind $0.10
*** HOLE CARDS ***
Buinstra16: raises $0.20 to $0.30
Fifilaplum: folds 
Himik30: calls $0.30
auaets: folds 
O.G.Michael: folds 
sapr.549: calls $0.20
*** FLOP *** [2s Qs Ts]
sapr.549: checks 
Buinstra16: checks 
Himik30: bets $0.40
sapr.549: folds 
Buinstra16: folds 
Uncalled bet ($0.40) returned to Himik30
Himik30 collected $0.91 from pot
Himik30: doesn't show hand 
*** SUMMARY ***
Total pot $0.95 | Rake $0.04 
Board [2s Qs Ts]
Seat 1: sapr.549 (big blind) folded on the Flop
Seat 2: Buinstra16 folded on the Flop
Seat 3: Fifilaplum folded before Flop (didn't bet)
Seat 4: Himik30 collected ($0.91)
Seat 5: auaets (button) folded before Flop (didn't bet)
Seat 6: O.G.Michael (small blind) folded before Flop



PokerStars Hand #222962834436:  Hold'em No Limit ($0.05/$0.10 USD) - 2021/01/23 13:08:58 ET
Table 'Malzovia' 6-max Seat #6 is the button
Seat 1: sapr.549 ($10.13 in chips) 
Seat 2: Buinstra16 ($13.66 in chips) 
Seat 3: Fifilaplum ($10 in chips) 
Seat 4: Himik30 ($18.41 in chips) 
Seat 5: auaets ($3.70 in chips) 
Seat 6: O.G.Michael ($10 in chips) 
sapr.549: posts small blind $0.05
Buinstra16: posts big blind $0.10
*** HOLE CARDS ***
Fifilaplum: folds 
Himik30: folds 
auaets: folds 
O.G.Michael: raises $0.15 to $0.25
sapr.549: folds 
Buinstra16: calls $0.15
*** FLOP *** [5c Ad 6c]
Buinstra16: bets $0.30
O.G.Michael: calls $0.30
*** TURN *** [5c Ad 6c] [Th]
Buinstra16: checks 
O.G.Michael: checks 
*** RIVER *** [5c Ad 6c Th] [3s]
Buinstra16: checks 
O.G.Michael: checks 
*** SHOW DOWN ***
Buinstra16: shows [Kh 4h] (high card Ace)
O.G.Michael: shows [7h 5h] (a pair of Fives)
O.G.Michael collected $1.10 from pot
*** SUMMARY ***
Total pot $1.15 | Rake $0.05 
Board [5c Ad 6c Th 3s]
Seat 1: sapr.549 (small blind) folded before Flop
Seat 2: Buinstra16 (big blind) showed [Kh 4h] and lost with high card Ace
Seat 3: Fifilaplum folded before Flop (didn't bet)
Seat 4: Himik30 folded before Flop (didn't bet)
Seat 5: auaets folded before Flop (didn't bet)
Seat 6: O.G.Michael (button) showed [7h 5h] and won ($1.10) with a pair of Fives



PokerStars Hand #222962868277:  Hold'em No Limit ($0.05/$0.10 USD) - 2021/01/23 13:09:47 ET
Table 'Malzovia' 6-max Seat #1 is the button
Seat 1: sapr.549 ($10.08 in chips) 
Seat 2: Buinstra16 ($13.11 in chips) 
Seat 3: Fifilaplum ($10 in chips) 
Seat 4: Himik30 ($18.41 in chips) 
Seat 5: auaets ($3.70 in chips) 
Seat 6: O.G.Michael ($10.55 in chips) 
Buinstra16: posts small blind $0.05
Fifilaplum: posts big blind $0.10
*** HOLE CARDS ***
Himik30: folds 
auaets: folds 
O.G.Michael: folds 
sapr.549: folds 
Buinstra16: folds 
Uncalled bet ($0.05) returned to Fifilaplum
Fifilaplum collected $0.10 from pot
Fifilaplum: doesn't show hand 
*** SUMMARY ***
Total pot $0.10 | Rake $0 
Seat 1: sapr.549 (button) folded before Flop (didn't bet)
Seat 2: Buinstra16 (small blind) folded before Flop
Seat 3: Fifilaplum (big blind) collected ($0.10)
Seat 4: Himik30 folded before Flop (didn't bet)
Seat 5: auaets folded before Flop (didn't bet)
Seat 6: O.G.Michael folded before Flop (didn't bet)



PokerStars Hand #222962878896:  Hold'em No Limit ($0.05/$0.10 USD) - 2021/01/23 13:10:02 ET
Table 'Malzovia' 6-max Seat #2 is the button
Seat 1: sapr.549 ($10.08 in chips) 
Seat 2: Buinstra16 ($13.06 in chips) 
Seat 3: Fifilaplum ($10.05 in chips) 
Seat 4: Himik30 ($18.41 in chips) 
Seat 5: auaets ($3.70 in chips) 
Seat 6: O.G.Michael ($10.55 in chips) 
Fifilaplum: posts small blind $0.05
Himik30: posts big blind $0.10
*** HOLE CARDS ***
auaets: calls $0.10
O.G.Michael: folds 
sapr.549: folds 
Buinstra16: raises $0.20 to $0.30
Fifilaplum: folds 
Himik30: calls $0.20
auaets: calls $0.20
*** FLOP *** [3s 6h Js]
Himik30: checks 
auaets: checks 
Buinstra16: bets $0.40
Himik30: calls $0.40
auaets: folds 
*** TURN *** [3s 6h Js] [7s]
Himik30: checks 
Buinstra16: bets $0.90
Himik30: calls $0.90
*** RIVER *** [3s 6h Js 7s] [3d]
Himik30: checks 
Buinstra16: bets $2.20
Himik30: folds 
Uncalled bet ($2.20) returned to Buinstra16
Buinstra16 collected $3.39 from pot
Buinstra16: doesn't show hand 
*** SUMMARY ***
Total pot $3.55 | Rake $0.16 
Board [3s 6h Js 7s 3d]
Seat 1: sapr.549 folded before Flop (didn't bet)
Seat 2: Buinstra16 (button) collected ($3.39)
Seat 3: Fifilaplum (small blind) folded before Flop
Seat 4: Himik30 (big blind) folded on the River
Seat 5: auaets folded on the Flop
Seat 6: O.G.Michael folded before Flop (didn't bet)



PokerStars Hand #222962930942:  Hold'em No Limit ($0.05/$0.10 USD) - 2021/01/23 13:11:18 ET
Table 'Malzovia' 6-max Seat #3 is the button
Seat 1: sapr.549 ($10.08 in chips) 
Seat 3: Fifilaplum ($10 in chips) 
Seat 4: Himik30 ($16.81 in chips) 
Seat 5: auaets ($3.40 in chips) 
Seat 6: O.G.Michael ($10.55 in chips) 
Himik30: posts small blind $0.05
auaets: posts big blind $0.10
*** HOLE CARDS ***
O.G.Michael: raises $0.15 to $0.25
sapr.549: folds 
Fifilaplum: folds 
Himik30: folds 
auaets: raises $0.95 to $1.20
O.G.Michael: folds 
Uncalled bet ($0.95) returned to auaets
auaets collected $0.55 from pot
auaets: doesn't show hand 
*** SUMMARY ***
Total pot $0.55 | Rake $0 
Seat 1: sapr.549 folded before Flop (didn't bet)
Seat 3: Fifilaplum (button) folded before Flop (didn't bet)
Seat 4: Himik30 (small blind) folded before Flop
Seat 5: auaets (big blind) collected ($0.55)
Seat 6: O.G.Michael folded before Flop



PokerStars Hand #222962942467:  Hold'em No Limit ($0.05/$0.10 USD) - 2021/01/23 13:11:35 ET
Table 'Malzovia' 6-max Seat #4 is the button
Seat 1: sapr.549 ($10.08 in chips) 
Seat 3: Fifilaplum ($10 in chips) 
Seat 4: Himik30 ($16.76 in chips) 
Seat 5: auaets ($3.70 in chips) 
auaets: posts small blind $0.05
O.G.Michael: is sitting out 
sapr.549: posts big blind $0.10
*** HOLE CARDS ***
O.G.Michael leaves the table
Fifilaplum: raises $0.15 to $0.25
Himik30: folds 
auaets: folds 
sapr.549: folds 
Uncalled bet ($0.15) returned to Fifilaplum
Fifilaplum collected $0.25 from pot
Fifilaplum: doesn't show hand 
*** SUMMARY ***
Total pot $0.25 | Rake $0 
Seat 1: sapr.549 (big blind) folded before Flop
Seat 3: Fifilaplum collected ($0.25)
Seat 4: Himik30 (button) folded before Flop (didn't bet)
Seat 5: auaets (small blind) folded before Flop



PokerStars Hand #222962949081:  Hold'em No Limit ($0.05/$0.10 USD) - 2021/01/23 13:11:45 ET
Table 'Malzovia' 6-max Seat #5 is the button
Seat 1: sapr.549 ($9.98 in chips) 
Seat 3: Fifilaplum ($10.15 in chips) 
Seat 4: Himik30 ($16.76 in chips) 
Seat 5: auaets ($3.65 in chips) 
sapr.549: posts small blind $0.05
Fifilaplum: posts big blind $0.10
*** HOLE CARDS ***
Himik30: folds 
Acedan1369 joins the table at seat #6 
auaets: folds 
sapr.549: folds 
Uncalled bet ($0.05) returned to Fifilaplum
Fifilaplum collected $0.10 from pot
Fifilaplum: doesn't show hand 
*** SUMMARY ***
Total pot $0.10 | Rake $0 
Seat 1: sapr.549 (small blind) folded before Flop
Seat 3: Fifilaplum (big blind) collected ($0.10)
Seat 4: Himik30 folded before Flop (didn't bet)
Seat 5: auaets (button) folded before Flop (didn't bet)



PokerStars Hand #222962953956:  Hold'em No Limit ($0.05/$0.10 USD) - 2021/01/23 13:11:52 ET
Table 'Malzovia' 6-max Seat #1 is the button
Seat 1: sapr.549 ($9.93 in chips) 
Seat 3: Fifilaplum ($10.20 in chips) 
Seat 4: Himik30 ($16.76 in chips) 
Seat 5: auaets ($3.65 in chips) 
Fifilaplum: posts small blind $0.05
Himik30: posts big blind $0.10
Acedan1369: sits out 
*** HOLE CARDS ***
auaets: calls $0.10
sapr.549: folds 
Fifilaplum: folds 
Himik30: checks 
*** FLOP *** [Ad Qd 7c]
Himik30: checks 
auaets: bets $0.10
Himik30: calls $0.10
*** TURN *** [Ad Qd 7c] [3d]
Himik30: checks 
auaets: bets $0.10
Himik30: calls $0.10
*** RIVER *** [Ad Qd 7c 3d] [9h]
Himik30: checks 
auaets: bets $0.10
Himik30: folds 
Uncalled bet ($0.10) returned to auaets
auaets collected $0.62 from pot
auaets: doesn't show hand 
*** SUMMARY ***
Total pot $0.65 | Rake $0.03 
Board [Ad Qd 7c 3d 9h]
Seat 1: sapr.549 (button) folded before Flop (didn't bet)
Seat 3: Fifilaplum (small blind) folded before Flop
Seat 4: Himik30 (big blind) folded on the River
Seat 5: auaets collected ($0.62)



PokerStars Hand #222962972732:  Hold'em No Limit ($0.05/$0.10 USD) - 2021/01/23 13:12:19 ET
Table 'Malzovia' 6-max Seat #3 is the button
Seat 1: sapr.549 ($9.93 in chips) 
Seat 3: Fifilaplum ($10.15 in chips) 
Seat 4: Himik30 ($16.46 in chips) 
Seat 5: auaets ($3.97 in chips) 
Himik30: posts small blind $0.05
auaets: posts big blind $0.10
Acedan1369: sits out 
*** HOLE CARDS ***
sapr.549: folds 
Fifilaplum: folds 
Himik30: raises $0.20 to $0.30
auaets: calls $0.20
*** FLOP *** [7h 3d Th]
Himik30: checks 
auaets: bets $0.67
Himik30: folds 
Uncalled bet ($0.67) returned to auaets
auaets collected $0.57 from pot
auaets: doesn't show hand 
*** SUMMARY ***
Total pot $0.60 | Rake $0.03 
Board [7h 3d Th]
Seat 1: sapr.549 folded before Flop (didn't bet)
Seat 3: Fifilaplum (button) folded before Flop (didn't bet)
Seat 4: Himik30 (small blind) folded on the Flop
Seat 5: auaets (big blind) collected ($0.57)



PokerStars Hand #222962990737:  Hold'em No Limit ($0.05/$0.10 USD) - 2021/01/23 13:12:45 ET
Table 'Malzovia' 6-max Seat #4 is the button
Seat 1: sapr.549 ($9.93 in chips) 
Seat 3: Fifilaplum ($10.15 in chips) 
Seat 4: Himik30 ($16.16 in chips) 
Seat 5: auaets ($4.24 in chips) 
Seat 6: Acedan1369 ($10 in chips) 
auaets: posts small blind $0.05
Acedan1369: posts big blind $0.10
*** HOLE CARDS ***
sapr.549: folds 
Fifilaplum: folds 
Himik30: folds 
auaets: folds 
Uncalled bet ($0.05) returned to Acedan1369
Acedan1369 collected $0.10 from pot
Acedan1369: doesn't show hand 
*** SUMMARY ***
Total pot $0.10 | Rake $0 
Seat 1: sapr.549 folded before Flop (didn't bet)
Seat 3: Fifilaplum folded before Flop (didn't bet)
Seat 4: Himik30 (button) folded before Flop (didn't bet)
Seat 5: auaets (small blind) folded before Flop
Seat 6: Acedan1369 (big blind) collected ($0.10)



PokerStars Hand #222962997198:  Hold'em No Limit ($0.05/$0.10 USD) - 2021/01/23 13:12:55 ET
Table 'Malzovia' 6-max Seat #5 is the button
Seat 1: sapr.549 ($9.93 in chips) 
Seat 3: Fifilaplum ($10.15 in chips) 
Seat 4: Himik30 ($16.16 in chips) 
Seat 5: auaets ($4.19 in chips) 
Seat 6: Acedan1369 ($10.05 in chips) 
Acedan1369: posts small blind $0.05
sapr.549: posts big blind $0.10
*** HOLE CARDS ***
Fifilaplum: folds 
Himik30: raises $0.15 to $0.25
auaets: folds 
Acedan1369: calls $0.20
sapr.549: calls $0.15
*** FLOP *** [8s 2s Ks]
Acedan1369: checks 
sapr.549: checks 
Himik30: bets $0.36
Acedan1369: calls $0.36
sapr.549: folds 
*** TURN *** [8s 2s Ks] [Kc]
Acedan1369: checks 
Himik30: checks 
*** RIVER *** [8s 2s Ks Kc] [Js]
Acedan1369: checks 
Himik30: bets $0.70
Acedan1369: folds 
Uncalled bet ($0.70) returned to Himik30
Himik30 collected $1.40 from pot
Himik30: doesn't show hand 
*** SUMMARY ***
Total pot $1.47 | Rake $0.07 
Board [8s 2s Ks Kc Js]
Seat 1: sapr.549 (big blind) folded on the Flop
Seat 3: Fifilaplum folded before Flop (didn't bet)
Seat 4: Himik30 collected ($1.40)
Seat 5: auaets (button) folded before Flop (didn't bet)
Seat 6: Acedan1369 (small blind) folded on the River



PokerStars Hand #222963041352:  Hold'em No Limit ($0.05/$0.10 USD) - 2021/01/23 13:13:59 ET
Table 'Malzovia' 6-max Seat #6 is the button
Seat 1: sapr.549 ($9.68 in chips) 
Seat 3: Fifilaplum ($10.15 in chips) 
Seat 4: Himik30 ($16.95 in chips) 
Seat 5: auaets ($4.19 in chips) 
Seat 6: Acedan1369 ($10 in chips) 
sapr.549: posts small blind $0.05
Fifilaplum: posts big blind $0.10
*** HOLE CARDS ***
Himik30: calls $0.10
auaets: folds 
Acedan1369: folds 
sapr.549: folds 
Fifilaplum: checks 
*** FLOP *** [Jd 8s Kc]
Fifilaplum: checks 
Himik30: bets $0.10
Fifilaplum: folds 
Uncalled bet ($0.10) returned to Himik30
Himik30 collected $0.24 from pot
Himik30: doesn't show hand 
*** SUMMARY ***
Total pot $0.25 | Rake $0.01 
Board [Jd 8s Kc]
Seat 1: sapr.549 (small blind) folded before Flop
Seat 3: Fifilaplum (big blind) folded on the Flop
Seat 4: Himik30 collected ($0.24)
Seat 5: auaets folded before Flop (didn't bet)
Seat 6: Acedan1369 (button) folded before Flop (didn't bet)



PokerStars Hand #222963066012:  Hold'em No Limit ($0.05/$0.10 USD) - 2021/01/23 13:14:36 ET
Table 'Malzovia' 6-max Seat #1 is the button
Seat 1: sapr.549 ($9.63 in chips) 
Seat 3: Fifilaplum ($10.05 in chips) 
Seat 4: Himik30 ($17.09 in chips) 
Seat 5: auaets ($4.19 in chips) 
Seat 6: Acedan1369 ($10 in chips) 
Fifilaplum: posts small blind $0.05
Himik30: posts big blind $0.10
*** HOLE CARDS ***
auaets: folds 
Acedan1369: folds 
sapr.549: raises $0.15 to $0.25
Fifilaplum: folds 
Himik30: calls $0.15
*** FLOP *** [Kd As 8c]
Himik30: checks 
sapr.549: checks 
*** TURN *** [Kd As 8c] [5d]
Himik30: bets $0.27
sapr.549: folds 
Uncalled bet ($0.27) returned to Himik30
Himik30 collected $0.53 from pot
Himik30: doesn't show hand 
*** SUMMARY ***
Total pot $0.55 | Rake $0.02 
Board [Kd As 8c 5d]
Seat 1: sapr.549 (button) folded on the Turn
Seat 3: Fifilaplum (small blind) folded before Flop
Seat 4: Himik30 (big blind) collected ($0.53)
Seat 5: auaets folded before Flop (didn't bet)
Seat 6: Acedan1369 folded before Flop (didn't bet)



PokerStars Hand #222963100795:  Hold'em No Limit ($0.05/$0.10 USD) - 2021/01/23 13:15:13 ET
Table 'Malzovia' 6-max Seat #3 is the button
Seat 1: sapr.549 ($9.38 in chips) 
Seat 2: Buinstra16 ($14.85 in chips) 
Seat 3: Fifilaplum ($10 in chips) 
Seat 4: Himik30 ($17.37 in chips) 
Seat 5: auaets ($4.19 in chips) 
Seat 6: Acedan1369 ($10 in chips) 
Himik30: posts small blind $0.05
auaets: posts big blind $0.10
Buinstra16: posts small & big blinds $0.15
*** HOLE CARDS ***
Acedan1369: raises $0.20 to $0.30
sapr.549: folds 
Buinstra16: calls $0.20
Fifilaplum: folds 
Himik30: calls $0.25
auaets: folds 
*** FLOP *** [4h Jh 6s]
Himik30: checks 
Acedan1369: bets $0.45
Buinstra16: folds 
Himik30: folds 
Uncalled bet ($0.45) returned to Acedan1369
Acedan1369 collected $1 from pot
Acedan1369: doesn't show hand 
*** SUMMARY ***
Total pot $1.05 | Rake $0.05 
Board [4h Jh 6s]
Seat 1: sapr.549 folded before Flop (didn't bet)
Seat 2: Buinstra16 folded on the Flop
Seat 3: Fifilaplum (button) folded before Flop (didn't bet)
Seat 4: Himik30 (small blind) folded on the Flop
Seat 5: auaets (big blind) folded before Flop
Seat 6: Acedan1369 collected ($1)



PokerStars Hand #222963134992:  Hold'em No Limit ($0.05/$0.10 USD) - 2021/01/23 13:16:00 ET
Table 'Malzovia' 6-max Seat #4 is the button
Seat 1: sapr.549 ($9.38 in chips) 
Seat 2: Buinstra16 ($14.50 in chips) 
Seat 3: Fifilaplum ($10 in chips) 
Seat 4: Himik30 ($17.07 in chips) 
Seat 5: auaets ($4.09 in chips) 
Seat 6: Acedan1369 ($10.70 in chips) 
auaets: posts small blind $0.05
Acedan1369: posts big blind $0.10
*** HOLE CARDS ***
sapr.549: folds 
Buinstra16: raises $0.20 to $0.30
Fifilaplum: folds 
Himik30: folds 
auaets: folds 
Acedan1369: folds 
Uncalled bet ($0.20) returned to Buinstra16
Buinstra16 collected $0.25 from pot
Buinstra16: doesn't show hand 
*** SUMMARY ***
Total pot $0.25 | Rake $0 
Seat 1: sapr.549 folded before Flop (didn't bet)
Seat 2: Buinstra16 collected ($0.25)
Seat 3: Fifilaplum folded before Flop (didn't bet)
Seat 4: Himik30 (button) folded before Flop (didn't bet)
Seat 5: auaets (small blind) folded before Flop
Seat 6: Acedan1369 (big blind) folded before Flop



PokerStars Hand #222963144214:  Hold'em No Limit ($0.05/$0.10 USD) - 2021/01/23 13:16:12 ET
Table 'Malzovia' 6-max Seat #5 is the button
Seat 1: sapr.549 ($9.38 in chips) 
Seat 2: Buinstra16 ($14.65 in chips) 
Seat 3: Fifilaplum ($10 in chips) 
Seat 4: Himik30 ($17.07 in chips) 
Seat 5: auaets ($4.04 in chips) 
Seat 6: Acedan1369 ($10.60 in chips) 
Acedan1369: posts small blind $0.05
sapr.549: posts big blind $0.10
*** HOLE CARDS ***
Buinstra16: calls $0.10
Fifilaplum: raises $0.25 to $0.35
Himik30: folds 
auaets: folds 
Acedan1369: calls $0.30
sapr.549: folds 
Buinstra16: calls $0.25
*** FLOP *** [Kd 6c 3s]
Acedan1369: checks 
Buinstra16: checks 
Fifilaplum: bets $0.50
Acedan1369: calls $0.50
Buinstra16: folds 
*** TURN *** [Kd 6c 3s] [4s]
Acedan1369: bets $1.54
Fifilaplum: folds 
Uncalled bet ($1.54) returned to Acedan1369
Acedan1369 collected $2.05 from pot
Acedan1369: doesn't show hand 
*** SUMMARY ***
Total pot $2.15 | Rake $0.10 
Board [Kd 6c 3s 4s]
Seat 1: sapr.549 (big blind) folded before Flop
Seat 2: Buinstra16 folded on the Flop
Seat 3: Fifilaplum folded on the Turn
Seat 4: Himik30 folded before Flop (didn't bet)
Seat 5: auaets (button) folded before Flop (didn't bet)
Seat 6: Acedan1369 (small blind) collected ($2.05)



PokerStars Hand #222963199650:  Hold'em No Limit ($0.05/$0.10 USD) - 2021/01/23 13:17:16 ET
Table 'Malzovia' 6-max Seat #6 is the button
Seat 1: sapr.549 ($9.28 in chips) 
Seat 2: Buinstra16 ($14.30 in chips) 
Seat 3: Fifilaplum ($10 in chips) 
Seat 4: Himik30 ($17.07 in chips) 
Seat 5: auaets ($4.04 in chips) 
Seat 6: Acedan1369 ($11.80 in chips) 
sapr.549: posts small blind $0.05
Buinstra16: posts big blind $0.10
*** HOLE CARDS ***
Fifilaplum: raises $0.15 to $0.25
Himik30: folds 
auaets: folds 
Acedan1369: folds 
sapr.549: folds 
Buinstra16: folds 
Uncalled bet ($0.15) returned to Fifilaplum
Fifilaplum collected $0.25 from pot
Fifilaplum: doesn't show hand 
*** SUMMARY ***
Total pot $0.25 | Rake $0 
Seat 1: sapr.549 (small blind) folded before Flop
Seat 2: Buinstra16 (big blind) folded before Flop
Seat 3: Fifilaplum collected ($0.25)
Seat 4: Himik30 folded before Flop (didn't bet)
Seat 5: auaets folded before Flop (didn't bet)
Seat 6: Acedan1369 (button) folded before Flop (didn't bet)



PokerStars Hand #222963215624:  Hold'em No Limit ($0.05/$0.10 USD) - 2021/01/23 13:17:38 ET
Table 'Malzovia' 6-max Seat #1 is the button
Seat 1: sapr.549 ($9.23 in chips) 
Seat 2: Buinstra16 ($14.20 in chips) 
Seat 3: Fifilaplum ($10.15 in chips) 
Seat 4: Himik30 ($17.07 in chips) 
Seat 5: auaets ($4.04 in chips) 
Seat 6: Acedan1369 ($11.80 in chips) 
Buinstra16: posts small blind $0.05
Fifilaplum: posts big blind $0.10
*** HOLE CARDS ***
Himik30: folds 
auaets: calls $0.10
Acedan1369 has timed out
Acedan1369: folds 
sapr.549: calls $0.10
Buinstra16: raises $0.40 to $0.50
Fifilaplum: folds 
auaets: calls $0.40
sapr.549: calls $0.40
*** FLOP *** [5d 2s 4c]
Buinstra16: bets $0.80
auaets: raises $2.74 to $3.54 and is all-in
sapr.549: folds 
Buinstra16: calls $2.74
*** TURN *** [5d 2s 4c] [2c]
*** RIVER *** [5d 2s 4c 2c] [6s]
*** SHOW DOWN ***
Buinstra16: shows [Ad Ks] (a pair of Deuces)
auaets: shows [5c 3c] (a straight, Deuce to Six)
auaets collected $8.29 from pot
*** SUMMARY ***
Total pot $8.68 | Rake $0.39 
Board [5d 2s 4c 2c 6s]
Seat 1: sapr.549 (button) folded on the Flop
Seat 2: Buinstra16 (small blind) showed [Ad Ks] and lost with a pair of Deuces
Seat 3: Fifilaplum (big blind) folded before Flop
Seat 4: Himik30 folded before Flop (didn't bet)
Seat 5: auaets showed [5c 3c] and won ($8.29) with a straight, Deuce to Six
Seat 6: Acedan1369 folded before Flop (didn't bet)



PokerStars Hand #222963257036:  Hold'em No Limit ($0.05/$0.10 USD) - 2021/01/23 13:18:33 ET
Table 'Malzovia' 6-max Seat #2 is the button
Seat 1: sapr.549 ($8.73 in chips) 
Seat 2: Buinstra16 ($10.16 in chips) 
Seat 3: Fifilaplum ($10.05 in chips) 
Seat 4: Himik30 ($17.07 in chips) 
Seat 5: auaets ($8.29 in chips) 
Seat 6: Acedan1369 ($11.80 in chips) 
Fifilaplum: posts small blind $0.05
Himik30: posts big blind $0.10
*** HOLE CARDS ***
auaets: folds 
Acedan1369: folds 
sapr.549: raises $0.15 to $0.25
Buinstra16: folds 
Fifilaplum: raises $0.75 to $1
Himik30: folds 
sapr.549: calls $0.75
*** FLOP *** [Ad 2c 3s]
Fifilaplum: checks 
sapr.549: bets $0.83
Fifilaplum: folds 
Uncalled bet ($0.83) returned to sapr.549
sapr.549 collected $2.01 from pot
sapr.549: doesn't show hand 
*** SUMMARY ***
Total pot $2.10 | Rake $0.09 
Board [Ad 2c 3s]
Seat 1: sapr.549 collected ($2.01)
Seat 2: Buinstra16 (button) folded before Flop (didn't bet)
Seat 3: Fifilaplum (small blind) folded on the Flop
Seat 4: Himik30 (big blind) folded before Flop
Seat 5: auaets folded before Flop (didn't bet)
Seat 6: Acedan1369 folded before Flop (didn't bet)



PokerStars Hand #222963286779:  Hold'em No Limit ($0.05/$0.10 USD) - 2021/01/23 13:19:13 ET
Table 'Malzovia' 6-max Seat #3 is the button
Seat 1: sapr.549 ($9.74 in chips) 
Seat 2: Buinstra16 ($10.16 in chips) 
Seat 3: Fifilaplum ($10 in chips) 
Seat 4: Himik30 ($16.97 in chips) 
Seat 5: auaets ($8.29 in chips) 
Seat 6: Acedan1369 ($11.80 in chips) 
Himik30: posts small blind $0.05
auaets: posts big blind $0.10
*** HOLE CARDS ***
Acedan1369: folds 
sapr.549: folds 
Buinstra16: folds 
Fifilaplum: raises $0.15 to $0.25
Himik30: folds 
auaets: folds 
Uncalled bet ($0.15) returned to Fifilaplum
Fifilaplum collected $0.25 from pot
Fifilaplum: doesn't show hand 
*** SUMMARY ***
Total pot $0.25 | Rake $0 
Seat 1: sapr.549 folded before Flop (didn't bet)
Seat 2: Buinstra16 folded before Flop (didn't bet)
Seat 3: Fifilaplum (button) collected ($0.25)
Seat 4: Himik30 (small blind) folded before Flop
Seat 5: auaets (big blind) folded before Flop
Seat 6: Acedan1369 folded before Flop (didn't bet)



PokerStars Hand #222963304062:  Hold'em No Limit ($0.05/$0.10 USD) - 2021/01/23 13:19:36 ET
Table 'Malzovia' 6-max Seat #4 is the button
Seat 1: sapr.549 ($9.74 in chips) 
Seat 2: Buinstra16 ($10.16 in chips) 
Seat 3: Fifilaplum ($10.15 in chips) 
Seat 4: Himik30 ($16.92 in chips) 
Seat 5: auaets ($8.19 in chips) 
Seat 6: Acedan1369 ($11.80 in chips) 
auaets: posts small blind $0.05
Acedan1369: posts big blind $0.10
*** HOLE CARDS ***
sapr.549: folds 
Buinstra16: calls $0.10
Fifilaplum: folds 
Himik30: raises $0.35 to $0.45
auaets: folds 
Acedan1369: folds 
Buinstra16: folds 
Uncalled bet ($0.35) returned to Himik30
Himik30 collected $0.35 from pot
Himik30: doesn't show hand 
*** SUMMARY ***
Total pot $0.35 | Rake $0 
Seat 1: sapr.549 folded before Flop (didn't bet)
Seat 2: Buinstra16 folded before Flop
Seat 3: Fifilaplum folded before Flop (didn't bet)
Seat 4: Himik30 (button) collected ($0.35)
Seat 5: auaets (small blind) folded before Flop
Seat 6: Acedan1369 (big blind) folded before Flop



PokerStars Hand #222963320778:  Hold'em No Limit ($0.05/$0.10 USD) - 2021/01/23 13:19:58 ET
Table 'Malzovia' 6-max Seat #5 is the button
Seat 1: sapr.549 ($9.74 in chips) 
Seat 2: Buinstra16 ($10.06 in chips) 
Seat 3: Fifilaplum ($10.15 in chips) 
Seat 4: Himik30 ($17.17 in chips) 
Seat 5: auaets ($8.14 in chips) 
Seat 6: Acedan1369 ($11.70 in chips) 
Acedan1369: posts small blind $0.05
sapr.549: posts big blind $0.10
*** HOLE CARDS ***
Buinstra16: folds 
Fifilaplum: folds 
Himik30: folds 
auaets: folds 
Acedan1369: folds 
Uncalled bet ($0.05) returned to sapr.549
sapr.549 collected $0.10 from pot
sapr.549: doesn't show hand 
*** SUMMARY ***
Total pot $0.10 | Rake $0 
Seat 1: sapr.549 (big blind) collected ($0.10)
Seat 2: Buinstra16 folded before Flop (didn't bet)
Seat 3: Fifilaplum folded before Flop (didn't bet)
Seat 4: Himik30 folded before Flop (didn't bet)
Seat 5: auaets (button) folded before Flop (didn't bet)
Seat 6: Acedan1369 (small blind) folded before Flop



PokerStars Hand #222963327462:  Hold'em No Limit ($0.05/$0.10 USD) - 2021/01/23 13:20:07 ET
Table 'Malzovia' 6-max Seat #6 is the button
Seat 1: sapr.549 ($9.79 in chips) 
Seat 2: Buinstra16 ($10.06 in chips) 
Seat 3: Fifilaplum ($10.15 in chips) 
Seat 4: Himik30 ($17.17 in chips) 
Seat 5: auaets ($8.14 in chips) 
Seat 6: Acedan1369 ($11.65 in chips) 
sapr.549: posts small blind $0.05
Buinstra16: posts big blind $0.10
*** HOLE CARDS ***
Fifilaplum: folds 
Himik30: folds 
auaets: calls $0.10
Acedan1369: raises $0.20 to $0.30
sapr.549: folds 
Buinstra16: folds 
auaets: raises $1.05 to $1.35
Acedan1369: folds 
Uncalled bet ($1.05) returned to auaets
auaets collected $0.75 from pot
auaets: doesn't show hand 
*** SUMMARY ***
Total pot $0.75 | Rake $0 
Seat 1: sapr.549 (small blind) folded before Flop
Seat 2: Buinstra16 (big blind) folded before Flop
Seat 3: Fifilaplum folded before Flop (didn't bet)
Seat 4: Himik30 folded before Flop (didn't bet)
Seat 5: auaets collected ($0.75)
Seat 6: Acedan1369 (button) folded before Flop



PokerStars Hand #222963349810:  Hold'em No Limit ($0.05/$0.10 USD) - 2021/01/23 13:20:37 ET
Table 'Malzovia' 6-max Seat #1 is the button
Seat 1: sapr.549 ($9.74 in chips) 
Seat 2: Buinstra16 ($9.96 in chips) 
Seat 3: Fifilaplum ($10.15 in chips) 
Seat 4: Himik30 ($17.17 in chips) 
Seat 5: auaets ($8.59 in chips) 
Seat 6: Acedan1369 ($11.35 in chips) 
Buinstra16: posts small blind $0.05
Fifilaplum: posts big blind $0.10
*** HOLE CARDS ***
Himik30: folds 
auaets: folds 
Acedan1369: raises $0.15 to $0.25
sapr.549: folds 
Buinstra16: folds 
Fifilaplum: calls $0.15
*** FLOP *** [9d As 5d]
auaets leaves the table
Fifilaplum: checks 
DuNNo101 joins the table at seat #5 
Acedan1369: bets $0.24
Fifilaplum: raises $0.51 to $0.75
Acedan1369: folds 
Uncalled bet ($0.51) returned to Fifilaplum
Fifilaplum collected $0.98 from pot
Fifilaplum: doesn't show hand 
*** SUMMARY ***
Total pot $1.03 | Rake $0.05 
Board [9d As 5d]
Seat 1: sapr.549 (button) folded before Flop (didn't bet)
Seat 2: Buinstra16 (small blind) folded before Flop
Seat 3: Fifilaplum (big blind) collected ($0.98)
Seat 4: Himik30 folded before Flop (didn't bet)
Seat 5: auaets folded before Flop (didn't bet)
Seat 6: Acedan1369 folded on the Flop



PokerStars Hand #222963374033:  Hold'em No Limit ($0.05/$0.10 USD) - 2021/01/23 13:21:09 ET
Table 'Malzovia' 6-max Seat #2 is the button
Seat 1: sapr.549 ($9.74 in chips) 
Seat 2: Buinstra16 ($9.91 in chips) 
Seat 3: Fifilaplum ($10.64 in chips) 
Seat 4: Himik30 ($17.17 in chips) 
Seat 5: DuNNo101 ($8 in chips) 
Seat 6: Acedan1369 ($10.86 in chips) 
Fifilaplum: posts small blind $0.05
Himik30: posts big blind $0.10
DuNNo101: posts big blind $0.10
*** HOLE CARDS ***
DuNNo101: checks 
Acedan1369: raises $0.20 to $0.30
sapr.549: folds 
Buinstra16: folds 
Fifilaplum: folds 
Himik30: folds 
DuNNo101: folds 
Uncalled bet ($0.20) returned to Acedan1369
Acedan1369 collected $0.35 from pot
Acedan1369: doesn't show hand 
*** SUMMARY ***
Total pot $0.35 | Rake $0 
Seat 1: sapr.549 folded before Flop (didn't bet)
Seat 2: Buinstra16 (button) folded before Flop (didn't bet)
Seat 3: Fifilaplum (small blind) folded before Flop
Seat 4: Himik30 (big blind) folded before Flop
Seat 5: DuNNo101 folded before Flop (didn't bet)
Seat 6: Acedan1369 collected ($0.35)



PokerStars Hand #222963385423:  Hold'em No Limit ($0.05/$0.10 USD) - 2021/01/23 13:21:24 ET
Table 'Malzovia' 6-max Seat #3 is the button
Seat 1: sapr.549 ($9.74 in chips) 
Seat 2: Buinstra16 ($9.91 in chips) 
Seat 3: Fifilaplum ($10.59 in chips) 
Seat 4: Himik30 ($17.07 in chips) 
Seat 5: DuNNo101 ($7.90 in chips) 
Seat 6: Acedan1369 ($11.11 in chips) 
Himik30: posts small blind $0.05
DuNNo101: posts big blind $0.10
*** HOLE CARDS ***
Acedan1369: folds 
sapr.549: folds 
Buinstra16: folds 
Fifilaplum: raises $0.15 to $0.25
Himik30: raises $0.80 to $1.05
DuNNo101: folds 
Fifilaplum: folds 
Uncalled bet ($0.80) returned to Himik30
DuNNo101 leaves the table
Himik30 collected $0.60 from pot
Himik30: doesn't show hand 
*** SUMMARY ***
Total pot $0.60 | Rake $0 
Seat 1: sapr.549 folded before Flop (didn't bet)
Seat 2: Buinstra16 folded before Flop (didn't bet)
Seat 3: Fifilaplum (button) folded before Flop
Seat 4: Himik30 (small blind) collected ($0.60)
Seat 5: DuNNo101 (big blind) folded before Flop
Seat 6: Acedan1369 folded before Flop (didn't bet)



PokerStars Hand #222963399422:  Hold'em No Limit ($0.05/$0.10 USD) - 2021/01/23 13:21:43 ET
Table 'Malzovia' 6-max Seat #4 is the button
Seat 1: sapr.549 ($9.74 in chips) 
Seat 2: Buinstra16 ($9.91 in chips) 
Seat 3: Fifilaplum ($10.34 in chips) 
Seat 4: Himik30 ($17.42 in chips) 
Seat 6: Acedan1369 ($11.11 in chips) 
Acedan1369: posts small blind $0.05
sapr.549: posts big blind $0.10
*** HOLE CARDS ***
Buinstra16: folds 
Fifilaplum: folds 
Himik30: folds 
Acedan1369: raises $0.15 to $0.25
sapr.549: folds 
Uncalled bet ($0.15) returned to Acedan1369
Acedan1369 collected $0.20 from pot
Acedan1369: doesn't show hand 
*** SUMMARY ***
Total pot $0.20 | Rake $0 
Seat 1: sapr.549 (big blind) folded before Flop
Seat 2: Buinstra16 folded before Flop (didn't bet)
Seat 3: Fifilaplum folded before Flop (didn't bet)
Seat 4: Himik30 (button) folded before Flop (didn't bet)
Seat 6: Acedan1369 (small blind) collected ($0.20)



PokerStars Hand #222963410471:  Hold'em No Limit ($0.05/$0.10 USD) - 2021/01/23 13:21:58 ET
Table 'Malzovia' 6-max Seat #6 is the button
Seat 1: sapr.549 ($9.64 in chips) 
Seat 2: Buinstra16 ($9.91 in chips) 
Seat 3: Fifilaplum ($10.34 in chips) 
Seat 4: Himik30 ($17.42 in chips) 
Seat 6: Acedan1369 ($11.21 in chips) 
sapr.549: posts small blind $0.05
Buinstra16: posts big blind $0.10
*** HOLE CARDS ***
Fifilaplum: raises $0.15 to $0.25
Himik30: folds 
Acedan1369: raises $0.60 to $0.85
sapr.549: folds 
Buinstra16: folds 
Fifilaplum: calls $0.60
*** FLOP *** [7h Ah Qc]
Fifilaplum: checks 
Acedan1369: bets $0.80
Fifilaplum: raises $2.20 to $3
Acedan1369: folds 
Uncalled bet ($2.20) returned to Fifilaplum
Fifilaplum collected $3.29 from pot
Fifilaplum: doesn't show hand 
DerGraf 0815 joins the table at seat #5 
*** SUMMARY ***
Total pot $3.45 | Rake $0.16 
Board [7h Ah Qc]
Seat 1: sapr.549 (small blind) folded before Flop
Seat 2: Buinstra16 (big blind) folded before Flop
Seat 3: Fifilaplum collected ($3.29)
Seat 4: Himik30 folded before Flop (didn't bet)
Seat 6: Acedan1369 (button) folded on the Flop



PokerStars Hand #222963455819:  Hold'em No Limit ($0.05/$0.10 USD) - 2021/01/23 13:22:58 ET
Table 'Malzovia' 6-max Seat #1 is the button
Seat 1: sapr.549 ($9.59 in chips) 
Seat 2: Buinstra16 ($9.81 in chips) 
Seat 3: Fifilaplum ($11.98 in chips) 
Seat 4: Himik30 ($17.42 in chips) 
Seat 6: Acedan1369 ($10 in chips) 
Buinstra16: posts small blind $0.05
Fifilaplum: posts big blind $0.10
DerGraf 0815: sits out 
*** HOLE CARDS ***
Himik30: folds 
Acedan1369: folds 
sapr.549: folds 
Buinstra16: raises $0.20 to $0.30
Fifilaplum: folds 
Uncalled bet ($0.20) returned to Buinstra16
Buinstra16 collected $0.20 from pot
Buinstra16: doesn't show hand 
*** SUMMARY ***
Total pot $0.20 | Rake $0 
Seat 1: sapr.549 (button) folded before Flop (didn't bet)
Seat 2: Buinstra16 (small blind) collected ($0.20)
Seat 3: Fifilaplum (big blind) folded before Flop
Seat 4: Himik30 folded before Flop (didn't bet)
Seat 6: Acedan1369 folded before Flop (didn't bet)



PokerStars Hand #222963466067:  Hold'em No Limit ($0.05/$0.10 USD) - 2021/01/23 13:23:12 ET
Table 'Malzovia' 6-max Seat #2 is the button
Seat 1: sapr.549 ($9.59 in chips) 
Seat 2: Buinstra16 ($9.91 in chips) 
Seat 3: Fifilaplum ($11.88 in chips) 
Seat 4: Himik30 ($17.42 in chips) 
Seat 5: DerGraf 0815 ($5.95 in chips) 
Seat 6: Acedan1369 ($10 in chips) 
Fifilaplum: posts small blind $0.05
Himik30: posts big blind $0.10
DerGraf 0815: posts big blind $0.10
*** HOLE CARDS ***
DerGraf 0815: raises $0.25 to $0.35
Acedan1369: folds 
sapr.549: folds 
Buinstra16: folds 
Fifilaplum: folds 
Himik30: calls $0.25
*** FLOP *** [7s 3h Td]
Himik30: checks 
DerGraf 0815: bets $0.72
Himik30: folds 
Uncalled bet ($0.72) returned to DerGraf 0815
DerGraf 0815 collected $0.72 from pot
DerGraf 0815: doesn't show hand 
*** SUMMARY ***
Total pot $0.75 | Rake $0.03 
Board [7s 3h Td]
Seat 1: sapr.549 folded before Flop (didn't bet)
Seat 2: Buinstra16 (button) folded before Flop (didn't bet)
Seat 3: Fifilaplum (small blind) folded before Flop
Seat 4: Himik30 (big blind) folded on the Flop
Seat 5: DerGraf 0815 collected ($0.72)
Seat 6: Acedan1369 folded before Flop (didn't bet)



PokerStars Hand #222963487373:  Hold'em No Limit ($0.05/$0.10 USD) - 2021/01/23 13:23:40 ET
Table 'Malzovia' 6-max Seat #3 is the button
Seat 1: sapr.549 ($9.59 in chips) 
Seat 2: Buinstra16 ($9.91 in chips) 
Seat 3: Fifilaplum ($11.83 in chips) 
Seat 4: Himik30 ($17.07 in chips) 
Seat 5: DerGraf 0815 ($6.32 in chips) 
Seat 6: Acedan1369 ($10 in chips) 
Himik30: posts small blind $0.05
DerGraf 0815: posts big blind $0.10
*** HOLE CARDS ***
Acedan1369: folds 
sapr.549: folds 
Buinstra16: folds 
Fifilaplum: raises $0.15 to $0.25
Himik30: folds 
DerGraf 0815: calls $0.15
*** FLOP *** [8s 7d Qh]
DerGraf 0815: checks 
Fifilaplum: bets $0.16
DerGraf 0815: calls $0.16
*** TURN *** [8s 7d Qh] [Ac]
DerGraf 0815: checks 
Fifilaplum: bets $0.50
DerGraf 0815: folds 
Uncalled bet ($0.50) returned to Fifilaplum
Fifilaplum collected $0.83 from pot
Fifilaplum: doesn't show hand 
*** SUMMARY ***
Total pot $0.87 | Rake $0.04 
Board [8s 7d Qh Ac]
Seat 1: sapr.549 folded before Flop (didn't bet)
Seat 2: Buinstra16 folded before Flop (didn't bet)
Seat 3: Fifilaplum (button) collected ($0.83)
Seat 4: Himik30 (small blind) folded before Flop
Seat 5: DerGraf 0815 (big blind) folded on the Turn
Seat 6: Acedan1369 folded before Flop (didn't bet)



PokerStars Hand #222963509320:  Hold'em No Limit ($0.05/$0.10 USD) - 2021/01/23 13:24:08 ET
Table 'Malzovia' 6-max Seat #4 is the button
Seat 1: sapr.549 ($9.59 in chips) 
Seat 2: Buinstra16 ($9.91 in chips) 
Seat 3: Fifilaplum ($12.25 in chips) 
Seat 4: Himik30 ($17.02 in chips) 
Seat 5: DerGraf 0815 ($5.91 in chips) 
Seat 6: Acedan1369 ($10 in chips) 
DerGraf 0815: posts small blind $0.05
Acedan1369: posts big blind $0.10
*** HOLE CARDS ***
sapr.549: folds 
Buinstra16: folds 
Fifilaplum: raises $0.15 to $0.25
Himik30: folds 
DerGraf 0815: raises $0.60 to $0.85
Acedan1369: folds 
Fifilaplum: calls $0.60
*** FLOP *** [5d Qc Ac]
DerGraf 0815: bets $5.06 and is all-in
Fifilaplum: folds 
Uncalled bet ($5.06) returned to DerGraf 0815
DerGraf 0815 collected $1.72 from pot
DerGraf 0815: doesn't show hand 
*** SUMMARY ***
Total pot $1.80 | Rake $0.08 
Board [5d Qc Ac]
Seat 1: sapr.549 folded before Flop (didn't bet)
Seat 2: Buinstra16 folded before Flop (didn't bet)
Seat 3: Fifilaplum folded on the Flop
Seat 4: Himik30 (button) folded before Flop (didn't bet)
Seat 5: DerGraf 0815 (small blind) collected ($1.72)
Seat 6: Acedan1369 (big blind) folded before Flop



PokerStars Hand #222963526875:  Hold'em No Limit ($0.05/$0.10 USD) - 2021/01/23 13:24:32 ET
Table 'Malzovia' 6-max Seat #5 is the button
Seat 1: sapr.549 ($9.59 in chips) 
Seat 2: Buinstra16 ($9.91 in chips) 
Seat 3: Fifilaplum ($11.40 in chips) 
Seat 4: Himik30 ($17.02 in chips) 
Seat 5: DerGraf 0815 ($6.78 in chips) 
Seat 6: Acedan1369 ($10 in chips) 
Acedan1369: posts small blind $0.05
sapr.549: posts big blind $0.10
*** HOLE CARDS ***
Buinstra16: raises $0.20 to $0.30
Fifilaplum: folds 
Himik30: folds 
DerGraf 0815: calls $0.30
Acedan1369: folds 
sapr.549: folds 
*** FLOP *** [Ts Kh 7c]
Buinstra16: checks 
DerGraf 0815: bets $0.72
Buinstra16: folds 
Uncalled bet ($0.72) returned to DerGraf 0815
DerGraf 0815 collected $0.72 from pot
DerGraf 0815: doesn't show hand 
*** SUMMARY ***
Total pot $0.75 | Rake $0.03 
Board [Ts Kh 7c]
Seat 1: sapr.549 (big blind) folded before Flop
Seat 2: Buinstra16 folded on the Flop
Seat 3: Fifilaplum folded before Flop (didn't bet)
Seat 4: Himik30 folded before Flop (didn't bet)
Seat 5: DerGraf 0815 (button) collected ($0.72)
Seat 6: Acedan1369 (small blind) folded before Flop



PokerStars Hand #222963543240:  Hold'em No Limit ($0.05/$0.10 USD) - 2021/01/23 13:24:53 ET
Table 'Malzovia' 6-max Seat #6 is the button
Seat 1: sapr.549 ($9.49 in chips) 
Seat 2: Buinstra16 ($9.61 in chips) 
Seat 3: Fifilaplum ($11.40 in chips) 
Seat 4: Himik30 ($17.02 in chips) 
Seat 5: DerGraf 0815 ($7.20 in chips) 
Seat 6: Acedan1369 ($10 in chips) 
sapr.549: posts small blind $0.05
Buinstra16: posts big blind $0.10
*** HOLE CARDS ***
Fifilaplum: folds 
Himik30: folds 
DerGraf 0815: calls $0.10
Acedan1369: folds 
sapr.549: folds 
Buinstra16: checks 
*** FLOP *** [Ts 3h Qc]
Buinstra16: checks 
DerGraf 0815: checks 
*** TURN *** [Ts 3h Qc] [3c]
Buinstra16: checks 
DerGraf 0815: checks 
*** RIVER *** [Ts 3h Qc 3c] [5c]
Buinstra16: checks 
DerGraf 0815: checks 
*** SHOW DOWN ***
Buinstra16: shows [6h Kc] (a pair of Threes)
DerGraf 0815: mucks hand 
Buinstra16 collected $0.24 from pot
*** SUMMARY ***
Total pot $0.25 | Rake $0.01 
Board [Ts 3h Qc 3c 5c]
Seat 1: sapr.549 (small blind) folded before Flop
Seat 2: Buinstra16 (big blind) showed [6h Kc] and won ($0.24) with a pair of Threes
Seat 3: Fifilaplum folded before Flop (didn't bet)
Seat 4: Himik30 folded before Flop (didn't bet)
Seat 5: DerGraf 0815 mucked
Seat 6: Acedan1369 (button) folded before Flop (didn't bet)



PokerStars Hand #222963562549:  Hold'em No Limit ($0.05/$0.10 USD) - 2021/01/23 13:25:19 ET
Table 'Malzovia' 6-max Seat #1 is the button
Seat 1: sapr.549 ($9.44 in chips) 
Seat 2: Buinstra16 ($9.75 in chips) 
Seat 3: Fifilaplum ($11.40 in chips) 
Seat 4: Himik30 ($17.02 in chips) 
Seat 5: DerGraf 0815 ($7.10 in chips) 
Seat 6: Acedan1369 ($10 in chips) 
Buinstra16: posts small blind $0.05
Fifilaplum: posts big blind $0.10
*** HOLE CARDS ***
Himik30: calls $0.10
DerGraf 0815: folds 
Acedan1369: raises $0.20 to $0.30
sapr.549: folds 
Buinstra16: calls $0.25
Fifilaplum: folds 
Himik30: calls $0.20
*** FLOP *** [2h Td Kd]
Buinstra16: checks 
Himik30: checks 
Acedan1369: bets $0.72
Buinstra16: folds 
Himik30: calls $0.72
*** TURN *** [2h Td Kd] [6d]
Himik30: checks 
Acedan1369: checks 
*** RIVER *** [2h Td Kd 6d] [Th]
Himik30: bets $1
Acedan1369: folds 
Uncalled bet ($1) returned to Himik30
Himik30 collected $2.33 from pot
Himik30: doesn't show hand 
*** SUMMARY ***
Total pot $2.44 | Rake $0.11 
Board [2h Td Kd 6d Th]
Seat 1: sapr.549 (button) folded before Flop (didn't bet)
Seat 2: Buinstra16 (small blind) folded on the Flop
Seat 3: Fifilaplum (big blind) folded before Flop
Seat 4: Himik30 collected ($2.33)
Seat 5: DerGraf 0815 folded before Flop (didn't bet)
Seat 6: Acedan1369 folded on the River



PokerStars Hand #222963625681:  Hold'em No Limit ($0.05/$0.10 USD) - 2021/01/23 13:26:42 ET
Table 'Malzovia' 6-max Seat #2 is the button
Seat 1: sapr.549 ($9.44 in chips) 
Seat 2: Buinstra16 ($9.45 in chips) 
Seat 3: Fifilaplum ($11.30 in chips) 
Seat 4: Himik30 ($18.33 in chips) 
Seat 5: DerGraf 0815 ($7.10 in chips) 
Seat 6: Acedan1369 ($10 in chips) 
Fifilaplum: posts small blind $0.05
Himik30: posts big blind $0.10
*** HOLE CARDS ***
DerGraf 0815: calls $0.10
Acedan1369: folds 
sapr.549: folds 
Buinstra16: raises $0.20 to $0.30
Fifilaplum: folds 
Himik30: calls $0.20
DerGraf 0815: folds 
*** FLOP *** [7h 4h 6h]
Himik30: checks 
DerGraf 0815 leaves the table
Buinstra16: checks 
*** TURN *** [7h 4h 6h] [Th]
Himik30: checks 
Buinstra16: bets $0.30
Gantoris235 joins the table at seat #5 
Himik30: calls $0.30
*** RIVER *** [7h 4h 6h Th] [Kc]
Himik30: checks 
Buinstra16: checks 
*** SHOW DOWN ***
Himik30: shows [2d 2h] (a flush, Ten high)
Buinstra16: mucks hand 
Himik30 collected $1.29 from pot
*** SUMMARY ***
Total pot $1.35 | Rake $0.06 
Board [7h 4h 6h Th Kc]
Seat 1: sapr.549 folded before Flop (didn't bet)
Seat 2: Buinstra16 (button) mucked
Seat 3: Fifilaplum (small blind) folded before Flop
Seat 4: Himik30 (big blind) showed [2d 2h] and won ($1.29) with a flush, Ten high
Seat 5: DerGraf 0815 folded before Flop
Seat 6: Acedan1369 folded before Flop (didn't bet)



PokerStars Hand #222963679864:  Hold'em No Limit ($0.05/$0.10 USD) - 2021/01/23 13:27:54 ET
Table 'Malzovia' 6-max Seat #3 is the button
Seat 1: sapr.549 ($9.44 in chips) 
Seat 2: Buinstra16 ($8.85 in chips) 
Seat 3: Fifilaplum ($11.25 in chips) 
Seat 4: Himik30 ($19.02 in chips) 
Seat 5: Gantoris235 ($10 in chips) 
Seat 6: Acedan1369 ($10 in chips) 
Himik30: posts small blind $0.05
Gantoris235: posts big blind $0.10
*** HOLE CARDS ***
Acedan1369: raises $0.15 to $0.25
sapr.549: folds 
Buinstra16: calls $0.25
Fifilaplum: folds 
Himik30: calls $0.20
Gantoris235: folds 
*** FLOP *** [Qc 9s As]
Himik30: checks 
Acedan1369: bets $0.36
Buinstra16: folds 
Himik30: calls $0.36
*** TURN *** [Qc 9s As] [2c]
Himik30: checks 
Acedan1369: checks 
*** RIVER *** [Qc 9s As 2c] [Tc]
Himik30: checks 
Acedan1369: checks 
*** SHOW DOWN ***
Himik30: shows [Jc Kc] (a flush, King high)
Acedan1369: mucks hand 
Himik30 collected $1.50 from pot
*** SUMMARY ***
Total pot $1.57 | Rake $0.07 
Board [Qc 9s As 2c Tc]
Seat 1: sapr.549 folded before Flop (didn't bet)
Seat 2: Buinstra16 folded on the Flop
Seat 3: Fifilaplum (button) folded before Flop (didn't bet)
Seat 4: Himik30 (small blind) showed [Jc Kc] and won ($1.50) with a flush, King high
Seat 5: Gantoris235 (big blind) folded before Flop
Seat 6: Acedan1369 mucked



PokerStars Hand #222963731503:  Hold'em No Limit ($0.05/$0.10 USD) - 2021/01/23 13:29:02 ET
Table 'Malzovia' 6-max Seat #4 is the button
Seat 1: sapr.549 ($9.44 in chips) 
Seat 2: Buinstra16 ($8.60 in chips) 
Seat 3: Fifilaplum ($11.25 in chips) 
Seat 4: Himik30 ($19.91 in chips) 
Seat 5: Gantoris235 ($10 in chips) 
Seat 6: Acedan1369 ($10 in chips) 
Gantoris235: posts small blind $0.05
Acedan1369: posts big blind $0.10
*** HOLE CARDS ***
sapr.549: folds 
Buinstra16: raises $0.20 to $0.30
Fifilaplum: folds 
Himik30: folds 
Gantoris235: raises $0.70 to $1
Acedan1369: calls $0.90
Buinstra16: calls $0.70
*** FLOP *** [As 3c 4h]
Gantoris235: bets $0.95
Acedan1369: raises $1.45 to $2.40
Buinstra16: folds 
Gantoris235: folds 
Uncalled bet ($1.45) returned to Acedan1369
Acedan1369 collected $4.68 from pot
Acedan1369: doesn't show hand 
*** SUMMARY ***
Total pot $4.90 | Rake $0.22 
Board [As 3c 4h]
Seat 1: sapr.549 folded before Flop (didn't bet)
Seat 2: Buinstra16 folded on the Flop
Seat 3: Fifilaplum folded before Flop (didn't bet)
Seat 4: Himik30 (button) folded before Flop (didn't bet)
Seat 5: Gantoris235 (small blind) folded on the Flop
Seat 6: Acedan1369 (big blind) collected ($4.68)



PokerStars Hand #222963790466:  Hold'em No Limit ($0.05/$0.10 USD) - 2021/01/23 13:30:19 ET
Table 'Malzovia' 6-max Seat #5 is the button
Seat 1: sapr.549 ($9.44 in chips) 
Seat 2: Buinstra16 ($7.60 in chips) 
Seat 3: Fifilaplum ($11.25 in chips) 
Seat 4: Himik30 ($19.91 in chips) 
Seat 5: Gantoris235 ($10 in chips) 
Seat 6: Acedan1369 ($12.73 in chips) 
Acedan1369: posts small blind $0.05
sapr.549: posts big blind $0.10
*** HOLE CARDS ***
Buinstra16: folds 
Fifilaplum: folds 
Himik30: folds 
Gantoris235: folds 
Acedan1369: folds 
Uncalled bet ($0.05) returned to sapr.549
sapr.549 collected $0.10 from pot
sapr.549: doesn't show hand 
Buinstra16 leaves the table
*** SUMMARY ***
Total pot $0.10 | Rake $0 
Seat 1: sapr.549 (big blind) collected ($0.10)
Seat 2: Buinstra16 folded before Flop (didn't bet)
Seat 3: Fifilaplum folded before Flop (didn't bet)
Seat 4: Himik30 folded before Flop (didn't bet)
Seat 5: Gantoris235 (button) folded before Flop (didn't bet)
Seat 6: Acedan1369 (small blind) folded before Flop



PokerStars Hand #222963796603:  Hold'em No Limit ($0.05/$0.10 USD) - 2021/01/23 13:30:27 ET
Table 'Malzovia' 6-max Seat #6 is the button
Seat 1: sapr.549 ($9.49 in chips) 
Seat 3: Fifilaplum ($11.25 in chips) 
Seat 4: Himik30 ($19.91 in chips) 
Seat 5: Gantoris235 ($10 in chips) 
Seat 6: Acedan1369 ($12.68 in chips) 
sapr.549: posts small blind $0.05
Fifilaplum: posts big blind $0.10
*** HOLE CARDS ***
Himik30: folds 
Gantoris235: raises $0.15 to $0.25
Acedan1369: folds 
sapr.549: folds 
Fifilaplum: folds 
Uncalled bet ($0.15) returned to Gantoris235
Gantoris235 collected $0.25 from pot
Gantoris235: doesn't show hand 
*** SUMMARY ***
Total pot $0.25 | Rake $0 
Seat 1: sapr.549 (small blind) folded before Flop
Seat 3: Fifilaplum (big blind) folded before Flop
Seat 4: Himik30 folded before Flop (didn't bet)
Seat 5: Gantoris235 collected ($0.25)
Seat 6: Acedan1369 (button) folded before Flop (didn't bet)



PokerStars Hand #222963810351:  Hold'em No Limit ($0.05/$0.10 USD) - 2021/01/23 13:30:45 ET
Table 'Malzovia' 6-max Seat #1 is the button
Seat 1: sapr.549 ($9.44 in chips) 
Seat 3: Fifilaplum ($11.15 in chips) 
Seat 4: Himik30 ($19.91 in chips) 
Seat 5: Gantoris235 ($10.15 in chips) 
Seat 6: Acedan1369 ($12.68 in chips) 
Fifilaplum: posts small blind $0.05
Himik30: posts big blind $0.10
*** HOLE CARDS ***
Gantoris235: folds 
Acedan1369: folds 
sapr.549: folds 
Fifilaplum: folds 
Uncalled bet ($0.05) returned to Himik30
Himik30 collected $0.10 from pot
Himik30: doesn't show hand 
*** SUMMARY ***
Total pot $0.10 | Rake $0 
Seat 1: sapr.549 (button) folded before Flop (didn't bet)
Seat 3: Fifilaplum (small blind) folded before Flop
Seat 4: Himik30 (big blind) collected ($0.10)
Seat 5: Gantoris235 folded before Flop (didn't bet)
Seat 6: Acedan1369 folded before Flop (didn't bet)



PokerStars Hand #222963820724:  Hold'em No Limit ($0.05/$0.10 USD) - 2021/01/23 13:30:59 ET
Table 'Malzovia' 6-max Seat #3 is the button
Seat 1: sapr.549 ($9.44 in chips) 
Seat 3: Fifilaplum ($11.10 in chips) 
Seat 4: Himik30 ($19.96 in chips) 
Seat 5: Gantoris235 ($10.15 in chips) 
Seat 6: Acedan1369 ($12.68 in chips) 
Himik30: posts small blind $0.05
Gantoris235: posts big blind $0.10
*** HOLE CARDS ***
Acedan1369: folds 
GrizzlyOP joins the table at seat #2 
sapr.549: folds 
Fifilaplum: raises $0.15 to $0.25
Himik30: folds 
Gantoris235: folds 
Uncalled bet ($0.15) returned to Fifilaplum
Fifilaplum collected $0.25 from pot
Fifilaplum: doesn't show hand 
*** SUMMARY ***
Total pot $0.25 | Rake $0 
Seat 1: sapr.549 folded before Flop (didn't bet)
Seat 3: Fifilaplum (button) collected ($0.25)
Seat 4: Himik30 (small blind) folded before Flop
Seat 5: Gantoris235 (big blind) folded before Flop
Seat 6: Acedan1369 folded before Flop (didn't bet)



PokerStars Hand #222963827537:  Hold'em No Limit ($0.05/$0.10 USD) - 2021/01/23 13:31:07 ET
Table 'Malzovia' 6-max Seat #4 is the button
Seat 1: sapr.549 ($9.44 in chips) 
Seat 2: GrizzlyOP ($10 in chips) 
Seat 3: Fifilaplum ($11.25 in chips) 
Seat 4: Himik30 ($19.91 in chips) 
Seat 5: Gantoris235 ($10.05 in chips) 
Seat 6: Acedan1369 ($12.68 in chips) 
Gantoris235: posts small blind $0.05
Acedan1369: posts big blind $0.10
GrizzlyOP: posts big blind $0.10
*** HOLE CARDS ***
sapr.549: folds 
GrizzlyOP: raises $0.10 to $0.20
Fifilaplum: folds 
Himik30: folds 
Gantoris235: folds 
Acedan1369: folds 
Uncalled bet ($0.10) returned to GrizzlyOP
GrizzlyOP collected $0.25 from pot
GrizzlyOP: doesn't show hand 
*** SUMMARY ***
Total pot $0.25 | Rake $0 
Seat 1: sapr.549 folded before Flop (didn't bet)
Seat 2: GrizzlyOP collected ($0.25)
Seat 3: Fifilaplum folded before Flop (didn't bet)
Seat 4: Himik30 (button) folded before Flop (didn't bet)
Seat 5: Gantoris235 (small blind) folded before Flop
Seat 6: Acedan1369 (big blind) folded before Flop



PokerStars Hand #222963841699:  Hold'em No Limit ($0.05/$0.10 USD) - 2021/01/23 13:31:25 ET
Table 'Malzovia' 6-max Seat #5 is the button
Seat 1: sapr.549 ($9.44 in chips) 
Seat 2: GrizzlyOP ($10.15 in chips) 
Seat 3: Fifilaplum ($11.25 in chips) 
Seat 4: Himik30 ($19.91 in chips) 
Seat 5: Gantoris235 ($10 in chips) 
Seat 6: Acedan1369 ($12.58 in chips) 
Acedan1369: posts small blind $0.05
sapr.549: posts big blind $0.10
*** HOLE CARDS ***
GrizzlyOP has timed out
GrizzlyOP: folds 
Fifilaplum: folds 
Himik30: raises $0.15 to $0.25
Gantoris235: folds 
Acedan1369: folds 
sapr.549: folds 
Uncalled bet ($0.15) returned to Himik30
Himik30 collected $0.25 from pot
Himik30: doesn't show hand 
*** SUMMARY ***
Total pot $0.25 | Rake $0 
Seat 1: sapr.549 (big blind) folded before Flop
Seat 2: GrizzlyOP folded before Flop (didn't bet)
Seat 3: Fifilaplum folded before Flop (didn't bet)
Seat 4: Himik30 collected ($0.25)
Seat 5: Gantoris235 (button) folded before Flop (didn't bet)
Seat 6: Acedan1369 (small blind) folded before Flop



PokerStars Hand #222963855602:  Hold'em No Limit ($0.05/$0.10 USD) - 2021/01/23 13:31:43 ET
Table 'Malzovia' 6-max Seat #6 is the button
Seat 1: sapr.549 ($9.34 in chips) 
Seat 2: GrizzlyOP ($10.15 in chips) 
Seat 3: Fifilaplum ($11.25 in chips) 
Seat 4: Himik30 ($20.06 in chips) 
Seat 5: Gantoris235 ($10 in chips) 
Seat 6: Acedan1369 ($12.53 in chips) 
sapr.549: posts small blind $0.05
GrizzlyOP: posts big blind $0.10
*** HOLE CARDS ***
Fifilaplum: folds 
Himik30: folds 
Gantoris235: folds 
Acedan1369: raises $0.15 to $0.25
sapr.549: folds 
GrizzlyOP: calls $0.15
*** FLOP *** [8h 7h Jh]
GrizzlyOP: bets $0.10
Acedan1369: raises $0.55 to $0.65
GrizzlyOP: calls $0.55
*** TURN *** [8h 7h Jh] [6c]
GrizzlyOP: bets $0.80
Acedan1369: raises $1.52 to $2.32
GrizzlyOP: calls $1.52
*** RIVER *** [8h 7h Jh 6c] [Td]
GrizzlyOP: bets $3.80
Acedan1369: raises $5.51 to $9.31 and is all-in
GrizzlyOP: calls $3.13 and is all-in
Uncalled bet ($2.38) returned to Acedan1369
*** SHOW DOWN ***
Acedan1369: shows [Qh 9h] (a flush, Queen high)
GrizzlyOP: shows [Ts Jd] (two pair, Jacks and Tens)
Acedan1369 collected $19.43 from pot
*** SUMMARY ***
Total pot $20.35 | Rake $0.92 
Board [8h 7h Jh 6c Td]
Seat 1: sapr.549 (small blind) folded before Flop
Seat 2: GrizzlyOP (big blind) showed [Ts Jd] and lost with two pair, Jacks and Tens
Seat 3: Fifilaplum folded before Flop (didn't bet)
Seat 4: Himik30 folded before Flop (didn't bet)
Seat 5: Gantoris235 folded before Flop (didn't bet)
Seat 6: Acedan1369 (button) showed [Qh 9h] and won ($19.43) with a flush, Queen high



PokerStars Hand #222963889346:  Hold'em No Limit ($0.05/$0.10 USD) - 2021/01/23 13:32:26 ET
Table 'Malzovia' 6-max Seat #1 is the button
Seat 1: sapr.549 ($9.29 in chips) 
Seat 3: Fifilaplum ($11.25 in chips) 
Seat 4: Himik30 ($20.06 in chips) 
Seat 5: Gantoris235 ($10 in chips) 
Seat 6: Acedan1369 ($21.81 in chips) 
Fifilaplum: posts small blind $0.05
Himik30: posts big blind $0.10
*** HOLE CARDS ***
Gantoris235 has timed out
Gantoris235: folds 
Acedan1369: folds 
sapr.549: folds 
Fifilaplum: folds 
Uncalled bet ($0.05) returned to Himik30
Himik30 collected $0.10 from pot
Himik30: doesn't show hand 
*** SUMMARY ***
Total pot $0.10 | Rake $0 
Seat 1: sapr.549 (button) folded before Flop (didn't bet)
Seat 3: Fifilaplum (small blind) folded before Flop
Seat 4: Himik30 (big blind) collected ($0.10)
Seat 5: Gantoris235 folded before Flop (didn't bet)
Seat 6: Acedan1369 folded before Flop (didn't bet)



PokerStars Hand #222963904499:  Hold'em No Limit ($0.05/$0.10 USD) - 2021/01/23 13:32:46 ET
Table 'Malzovia' 6-max Seat #3 is the button
Seat 1: sapr.549 ($9.29 in chips) 
Seat 3: Fifilaplum ($11.20 in chips) 
Seat 4: Himik30 ($20.11 in chips) 
Seat 6: Acedan1369 ($21.81 in chips) 
Himik30: posts small blind $0.05
Acedan1369: posts big blind $0.10
*** HOLE CARDS ***
sapr.549: folds 
Fifilaplum: folds 
Himik30: folds 
Uncalled bet ($0.05) returned to Acedan1369
Acedan1369 collected $0.10 from pot
Acedan1369: doesn't show hand 
*** SUMMARY ***
Total pot $0.10 | Rake $0 
Seat 1: sapr.549 folded before Flop (didn't bet)
Seat 3: Fifilaplum (button) folded before Flop (didn't bet)
Seat 4: Himik30 (small blind) folded before Flop
Seat 6: Acedan1369 (big blind) collected ($0.10)



PokerStars Hand #222963915332:  Hold'em No Limit ($0.05/$0.10 USD) - 2021/01/23 13:33:00 ET
Table 'Malzovia' 6-max Seat #4 is the button
Seat 1: sapr.549 ($9.29 in chips) 
Seat 3: Fifilaplum ($11.20 in chips) 
Seat 4: Himik30 ($20.06 in chips) 
Seat 6: Acedan1369 ($21.86 in chips) 
Acedan1369: posts small blind $0.05
sapr.549: posts big blind $0.10
*** HOLE CARDS ***
Fifilaplum: folds 
Himik30: raises $0.15 to $0.25
Acedan1369: calls $0.20
sapr.549: folds 
*** FLOP *** [Ts 5c 7s]
Acedan1369: checks 
Himik30: checks 
*** TURN *** [Ts 5c 7s] [Jc]
Acedan1369: bets $0.43
Himik30: folds 
Uncalled bet ($0.43) returned to Acedan1369
Acedan1369 collected $0.57 from pot
Acedan1369: doesn't show hand 
*** SUMMARY ***
Total pot $0.60 | Rake $0.03 
Board [Ts 5c 7s Jc]
Seat 1: sapr.549 (big blind) folded before Flop
Seat 3: Fifilaplum folded before Flop (didn't bet)
Seat 4: Himik30 (button) folded on the Turn
Seat 6: Acedan1369 (small blind) collected ($0.57)



PokerStars Hand #222963965308:  Hold'em No Limit ($0.05/$0.10 USD) - 2021/01/23 13:34:04 ET
Table 'Malzovia' 6-max Seat #6 is the button
Seat 1: sapr.549 ($9.19 in chips) 
Seat 2: GrizzlyOP ($5.14 in chips) 
Seat 3: Fifilaplum ($11.20 in chips) 
Seat 4: Himik30 ($19.81 in chips) 
Seat 5: Gantoris235 ($10 in chips) 
Seat 6: Acedan1369 ($22.18 in chips) 
sapr.549: posts small blind $0.05
GrizzlyOP: posts big blind $0.10
Gantoris235: posts small & big blinds $0.15
*** HOLE CARDS ***
Fifilaplum: folds 
Himik30: raises $0.20 to $0.30
Gantoris235: folds 
Acedan1369: calls $0.30
sapr.549: folds 
GrizzlyOP: calls $0.20
*** FLOP *** [Jd 6d 4s]
GrizzlyOP: checks 
Himik30: bets $0.50
Acedan1369: calls $0.50
GrizzlyOP: folds 
*** TURN *** [Jd 6d 4s] [Qs]
Himik30: bets $1.20
Acedan1369: calls $1.20
*** RIVER *** [Jd 6d 4s Qs] [9d]
Himik30: checks 
Acedan1369: bets $6.24
Himik30: folds 
Uncalled bet ($6.24) returned to Acedan1369
Acedan1369 collected $4.30 from pot
Acedan1369: doesn't show hand 
*** SUMMARY ***
Total pot $4.50 | Rake $0.20 
Board [Jd 6d 4s Qs 9d]
Seat 1: sapr.549 (small blind) folded before Flop
Seat 2: GrizzlyOP (big blind) folded on the Flop
Seat 3: Fifilaplum folded before Flop (didn't bet)
Seat 4: Himik30 folded on the River
Seat 5: Gantoris235 folded before Flop (didn't bet)
Seat 6: Acedan1369 (button) collected ($4.30)



PokerStars Hand #222964032143:  Hold'em No Limit ($0.05/$0.10 USD) - 2021/01/23 13:35:30 ET
Table 'Malzovia' 6-max Seat #1 is the button
Seat 1: sapr.549 ($9.14 in chips) 
Seat 2: GrizzlyOP ($4.84 in chips) 
Seat 3: Fifilaplum ($11.20 in chips) 
Seat 4: Himik30 ($17.81 in chips) 
Seat 5: Gantoris235 ($10 in chips) 
Seat 6: Acedan1369 ($24.48 in chips) 
GrizzlyOP: posts small blind $0.05
Fifilaplum: posts big blind $0.10
*** HOLE CARDS ***
Himik30: folds 
Gantoris235: raises $0.15 to $0.25
Acedan1369: raises $0.60 to $0.85
sapr.549: folds 
GrizzlyOP: folds 
Fifilaplum: folds 
Gantoris235: folds 
Uncalled bet ($0.60) returned to Acedan1369
Acedan1369 collected $0.65 from pot
Acedan1369: doesn't show hand 
*** SUMMARY ***
Total pot $0.65 | Rake $0 
Seat 1: sapr.549 (button) folded before Flop (didn't bet)
Seat 2: GrizzlyOP (small blind) folded before Flop
Seat 3: Fifilaplum (big blind) folded before Flop
Seat 4: Himik30 folded before Flop (didn't bet)
Seat 5: Gantoris235 folded before Flop
Seat 6: Acedan1369 collected ($0.65)



PokerStars Hand #222964054129:  Hold'em No Limit ($0.05/$0.10 USD) - 2021/01/23 13:35:58 ET
Table 'Malzovia' 6-max Seat #2 is the button
Seat 1: sapr.549 ($9.14 in chips) 
Seat 2: GrizzlyOP ($4.79 in chips) 
Seat 3: Fifilaplum ($11.10 in chips) 
Seat 4: Himik30 ($17.81 in chips) 
Seat 5: Gantoris235 ($10 in chips) 
Seat 6: Acedan1369 ($24.88 in chips) 
Fifilaplum: posts small blind $0.05
Himik30: posts big blind $0.10
*** HOLE CARDS ***
Gantoris235: folds 
Acedan1369: folds 
sapr.549: folds 
GrizzlyOP: calls $0.10
Fifilaplum: raises $0.30 to $0.40
Himik30: calls $0.30
GrizzlyOP: raises $0.30 to $0.70
Fifilaplum: calls $0.30
Himik30: calls $0.30
*** FLOP *** [9d Qc 7d]
Fifilaplum: checks 
Himik30: checks 
GrizzlyOP: bets $0.50
Fifilaplum: folds 
Himik30: folds 
Uncalled bet ($0.50) returned to GrizzlyOP
GrizzlyOP collected $2.01 from pot
GrizzlyOP: doesn't show hand 
*** SUMMARY ***
Total pot $2.10 | Rake $0.09 
Board [9d Qc 7d]
Seat 1: sapr.549 folded before Flop (didn't bet)
Seat 2: GrizzlyOP (button) collected ($2.01)
Seat 3: Fifilaplum (small blind) folded on the Flop
Seat 4: Himik30 (big blind) folded on the Flop
Seat 5: Gantoris235 folded before Flop (didn't bet)
Seat 6: Acedan1369 folded before Flop (didn't bet)



PokerStars Hand #222964087782:  Hold'em No Limit ($0.05/$0.10 USD) - 2021/01/23 13:36:42 ET
Table 'Malzovia' 6-max Seat #3 is the button
Seat 1: sapr.549 ($9.14 in chips) 
Seat 2: GrizzlyOP ($6.10 in chips) 
Seat 3: Fifilaplum ($10.40 in chips) 
Seat 4: Himik30 ($17.11 in chips) 
Seat 6: Acedan1369 ($24.88 in chips) 
Himik30: posts small blind $0.05
Gantoris235: is sitting out 
Acedan1369: posts big blind $0.10
*** HOLE CARDS ***
Gantoris235 leaves the table
sapr.549: folds 
GrizzlyOP: calls $0.10
Fifilaplum: raises $0.25 to $0.35
Himik30: folds 
Acedan1369: folds 
GrizzlyOP: folds 
Uncalled bet ($0.25) returned to Fifilaplum
Fifilaplum collected $0.35 from pot
Fifilaplum: doesn't show hand 
*** SUMMARY ***
Total pot $0.35 | Rake $0 
Seat 1: sapr.549 folded before Flop (didn't bet)
Seat 2: GrizzlyOP folded before Flop
Seat 3: Fifilaplum (button) collected ($0.35)
Seat 4: Himik30 (small blind) folded before Flop
Seat 6: Acedan1369 (big blind) folded before Flop



PokerStars Hand #222964099859:  Hold'em No Limit ($0.05/$0.10 USD) - 2021/01/23 13:36:57 ET
Table 'Malzovia' 6-max Seat #4 is the button
Seat 1: sapr.549 ($9.14 in chips) 
Seat 2: GrizzlyOP ($6 in chips) 
Seat 3: Fifilaplum ($10.65 in chips) 
Seat 4: Himik30 ($17.06 in chips) 
Seat 6: Acedan1369 ($24.78 in chips) 
Acedan1369: posts small blind $0.05
sapr.549: posts big blind $0.10
*** HOLE CARDS ***
GrizzlyOP: calls $0.10
joaogiordano joins the table at seat #5 
Fifilaplum: folds 
Himik30: folds 
Acedan1369: calls $0.05
sapr.549: checks 
*** FLOP *** [8c Jh 4h]
Acedan1369: checks 
sapr.549: bets $0.16
GrizzlyOP: folds 
Acedan1369: calls $0.16
*** TURN *** [8c Jh 4h] [7h]
Acedan1369: checks 
sapr.549: checks 
*** RIVER *** [8c Jh 4h 7h] [2d]
Acedan1369: bets $0.10
sapr.549: calls $0.10
*** SHOW DOWN ***
Acedan1369: shows [9h 8s] (a pair of Eights)
sapr.549: shows [Th Js] (a pair of Jacks)
sapr.549 collected $0.78 from pot
*** SUMMARY ***
Total pot $0.82 | Rake $0.04 
Board [8c Jh 4h 7h 2d]
Seat 1: sapr.549 (big blind) showed [Th Js] and won ($0.78) with a pair of Jacks
Seat 2: GrizzlyOP folded on the Flop
Seat 3: Fifilaplum folded before Flop (didn't bet)
Seat 4: Himik30 (button) folded before Flop (didn't bet)
Seat 6: Acedan1369 (small blind) showed [9h 8s] and lost with a pair of Eights



PokerStars Hand #222964136074:  Hold'em No Limit ($0.05/$0.10 USD) - 2021/01/23 13:37:44 ET
Table 'Malzovia' 6-max Seat #6 is the button
Seat 1: sapr.549 ($9.56 in chips) 
Seat 2: GrizzlyOP ($5.90 in chips) 
Seat 3: Fifilaplum ($10.65 in chips) 
Seat 4: Himik30 ($17.06 in chips) 
Seat 5: joaogiordano ($10 in chips) 
Seat 6: Acedan1369 ($24.42 in chips) 
sapr.549: posts small blind $0.05
GrizzlyOP: posts big blind $0.10
joaogiordano: posts big blind $0.10
*** HOLE CARDS ***
Fifilaplum: folds 
Himik30: folds 
joaogiordano: checks 
Acedan1369: folds 
sapr.549: raises $0.26 to $0.36
GrizzlyOP: calls $0.26
joaogiordano: folds 
*** FLOP *** [Kc 7d Th]
sapr.549: checks 
GrizzlyOP: bets $0.50
sapr.549: calls $0.50
*** TURN *** [Kc 7d Th] [Ah]
sapr.549: bets $8.70 and is all-in
GrizzlyOP: calls $5.04 and is all-in
Uncalled bet ($3.66) returned to sapr.549
*** RIVER *** [Kc 7d Th Ah] [6c]
*** SHOW DOWN ***
sapr.549: shows [Td Tc] (three of a kind, Tens)
GrizzlyOP: shows [7c Ad] (two pair, Aces and Sevens)
sapr.549 cashed out the hand for $10.74 | Cash Out Fee $0.11
*** SUMMARY ***
Total pot $11.90 | Rake $0.54 
Board [Kc 7d Th Ah 6c]
Seat 1: sapr.549 (small blind) showed [Td Tc] and won ($11.36) with three of a kind, Tens (pot not awarded as player cashed out)
Seat 2: GrizzlyOP (big blind) showed [7c Ad] and lost with two pair, Aces and Sevens
Seat 3: Fifilaplum folded before Flop (didn't bet)
Seat 4: Himik30 folded before Flop (didn't bet)
Seat 5: joaogiordano folded before Flop (didn't bet)
Seat 6: Acedan1369 (button) folded before Flop (didn't bet)



PokerStars Hand #222964167682:  Hold'em No Limit ($0.05/$0.10 USD) - 2021/01/23 13:38:25 ET
Table 'Malzovia' 6-max Seat #1 is the button
Seat 1: sapr.549 ($14.40 in chips) 
Seat 3: Fifilaplum ($10.65 in chips) 
Seat 4: Himik30 ($17.06 in chips) 
Seat 5: joaogiordano ($9.90 in chips) 
Seat 6: Acedan1369 ($24.42 in chips) 
Fifilaplum: posts small blind $0.05
Himik30: posts big blind $0.10
*** HOLE CARDS ***
joaogiordano: folds 
GrizzlyOP leaves the table
Acedan1369 has timed out
Acedan1369: folds 
sapr.549: raises $0.15 to $0.25
Fifilaplum: raises $0.75 to $1
Himik30: folds 
sapr.549: calls $0.75
*** FLOP *** [Ad 7c Kc]
Fifilaplum: checks 
Impostore1988 joins the table at seat #2 
sapr.549: checks 
*** TURN *** [Ad 7c Kc] [2s]
Fifilaplum: checks 
sapr.549: checks 
*** RIVER *** [Ad 7c Kc 2s] [Qs]
Fifilaplum: bets $0.70
sapr.549: folds 
Uncalled bet ($0.70) returned to Fifilaplum
Fifilaplum collected $2.01 from pot
Fifilaplum: doesn't show hand 
*** SUMMARY ***
Total pot $2.10 | Rake $0.09 
Board [Ad 7c Kc 2s Qs]
Seat 1: sapr.549 (button) folded on the River
Seat 3: Fifilaplum (small blind) collected ($2.01)
Seat 4: Himik30 (big blind) folded before Flop
Seat 5: joaogiordano folded before Flop (didn't bet)
Seat 6: Acedan1369 folded before Flop (didn't bet)



PokerStars Hand #222964197920:  Hold'em No Limit ($0.05/$0.10 USD) - 2021/01/23 13:39:04 ET
Table 'Malzovia' 6-max Seat #3 is the button
Seat 1: sapr.549 ($13.40 in chips) 
Seat 3: Fifilaplum ($11.66 in chips) 
Seat 4: Himik30 ($16.96 in chips) 
Seat 5: joaogiordano ($9.90 in chips) 
Seat 6: Acedan1369 ($24.42 in chips) 
Himik30: posts small blind $0.05
joaogiordano: posts big blind $0.10
Impostore1988: sits out 
*** HOLE CARDS ***
Acedan1369 has timed out
Acedan1369: folds 
sapr.549: folds 
Fifilaplum: raises $0.15 to $0.25
Himik30: raises $0.65 to $0.90
joaogiordano: calls $0.80
Fifilaplum: raises $2.10 to $3
Himik30: folds 
joaogiordano: folds 
Uncalled bet ($2.10) returned to Fifilaplum
Fifilaplum collected $2.70 from pot
Fifilaplum: doesn't show hand 
*** SUMMARY ***
Total pot $2.70 | Rake $0 
Seat 1: sapr.549 folded before Flop (didn't bet)
Seat 3: Fifilaplum (button) collected ($2.70)
Seat 4: Himik30 (small blind) folded before Flop
Seat 5: joaogiordano (big blind) folded before Flop
Seat 6: Acedan1369 folded before Flop (didn't bet)



PokerStars Hand #222964240285:  Hold'em No Limit ($0.05/$0.10 USD) - 2021/01/23 13:39:59 ET
Table 'Malzovia' 6-max Seat #4 is the button
Seat 1: sapr.549 ($13.40 in chips) 
Seat 3: Fifilaplum ($13.46 in chips) 
Seat 4: Himik30 ($16.06 in chips) 
Seat 5: joaogiordano ($9 in chips) 
Seat 6: Acedan1369 ($24.42 in chips) 
joaogiordano: posts small blind $0.05
Acedan1369: posts big blind $0.10
Impostore1988: sits out 
*** HOLE CARDS ***
sapr.549: folds 
Fifilaplum: folds 
Himik30: folds 
joaogiordano: calls $0.05
Acedan1369: checks 
*** FLOP *** [4h 5c Ad]
joaogiordano: checks 
Acedan1369: checks 
*** TURN *** [4h 5c Ad] [2h]
joaogiordano: checks 
Acedan1369: checks 
*** RIVER *** [4h 5c Ad 2h] [8c]
joaogiordano: checks 
Acedan1369: checks 
*** SHOW DOWN ***
joaogiordano: shows [Js Qh] (high card Ace)
Acedan1369: mucks hand 
joaogiordano collected $0.19 from pot
*** SUMMARY ***
Total pot $0.20 | Rake $0.01 
Board [4h 5c Ad 2h 8c]
Seat 1: sapr.549 folded before Flop (didn't bet)
Seat 3: Fifilaplum folded before Flop (didn't bet)
Seat 4: Himik30 (button) folded before Flop (didn't bet)
Seat 5: joaogiordano (small blind) showed [Js Qh] and won ($0.19) with high card Ace
Seat 6: Acedan1369 (big blind) mucked



PokerStars Hand #222964284868:  Hold'em No Limit ($0.05/$0.10 USD) - 2021/01/23 13:40:56 ET
Table 'Malzovia' 6-max Seat #5 is the button
Seat 1: sapr.549 ($13.40 in chips) 
Seat 3: Fifilaplum ($13.46 in chips) 
Seat 4: Himik30 ($16.06 in chips) 
Seat 5: joaogiordano ($9.09 in chips) 
Seat 6: Acedan1369 ($24.32 in chips) 
Acedan1369: posts small blind $0.05
sapr.549: posts big blind $0.10
Impostore1988: sits out 
*** HOLE CARDS ***
Fifilaplum: folds 
Himik30: folds 
joaogiordano: calls $0.10
Acedan1369: calls $0.05
sapr.549: checks 
*** FLOP *** [Jc 8c 3h]
Acedan1369: checks 
sapr.549: checks 
joaogiordano: bets $0.20
Acedan1369: folds 
sapr.549: folds 
Uncalled bet ($0.20) returned to joaogiordano
joaogiordano collected $0.29 from pot
joaogiordano: doesn't show hand 
*** SUMMARY ***
Total pot $0.30 | Rake $0.01 
Board [Jc 8c 3h]
Seat 1: sapr.549 (big blind) folded on the Flop
Seat 3: Fifilaplum folded before Flop (didn't bet)
Seat 4: Himik30 folded before Flop (didn't bet)
Seat 5: joaogiordano (button) collected ($0.29)
Seat 6: Acedan1369 (small blind) folded on the Flop



PokerStars Hand #222964305452:  Hold'em No Limit ($0.05/$0.10 USD) - 2021/01/23 13:41:23 ET
Table 'Malzovia' 6-max Seat #6 is the button
Seat 1: sapr.549 ($13.30 in chips) 
Seat 2: Impostore1988 ($10 in chips) 
Seat 3: Fifilaplum ($13.46 in chips) 
Seat 4: Himik30 ($16.06 in chips) 
Seat 5: joaogiordano ($9.28 in chips) 
Seat 6: Acedan1369 ($24.22 in chips) 
sapr.549: posts small blind $0.05
Impostore1988: posts big blind $0.10
*** HOLE CARDS ***
Fifilaplum: folds 
Himik30: folds 
joaogiordano: calls $0.10
Acedan1369: folds 
sapr.549: folds 
Impostore1988: checks 
*** FLOP *** [4h 8d 8c]
Impostore1988: bets $0.24
joaogiordano: calls $0.24
*** TURN *** [4h 8d 8c] [Ks]
Impostore1988: bets $0.70
joaogiordano: calls $0.70
*** RIVER *** [4h 8d 8c Ks] [3c]
Impostore1988: bets $2.03
joaogiordano: folds 
Uncalled bet ($2.03) returned to Impostore1988
Impostore1988 collected $2.03 from pot
Impostore1988: doesn't show hand 
*** SUMMARY ***
Total pot $2.13 | Rake $0.10 
Board [4h 8d 8c Ks 3c]
Seat 1: sapr.549 (small blind) folded before Flop
Seat 2: Impostore1988 (big blind) collected ($2.03)
Seat 3: Fifilaplum folded before Flop (didn't bet)
Seat 4: Himik30 folded before Flop (didn't bet)
Seat 5: joaogiordano folded on the River
Seat 6: Acedan1369 (button) folded before Flop (didn't bet)



PokerStars Hand #222964335741:  Hold'em No Limit ($0.05/$0.10 USD) - 2021/01/23 13:42:02 ET
Table 'Malzovia' 6-max Seat #1 is the button
Seat 1: sapr.549 ($13.25 in chips) 
Seat 2: Impostore1988 ($10.99 in chips) 
Seat 3: Fifilaplum ($13.46 in chips) 
Seat 4: Himik30 ($16.06 in chips) 
Seat 5: joaogiordano ($8.24 in chips) 
Seat 6: Acedan1369 ($24.22 in chips) 
Impostore1988: posts small blind $0.05
Fifilaplum: posts big blind $0.10
*** HOLE CARDS ***
Himik30: folds 
joaogiordano: calls $0.10
Acedan1369: folds 
sapr.549: folds 
Impostore1988: folds 
Fifilaplum: checks 
*** FLOP *** [Ts 9c 9d]
Fifilaplum: checks 
joaogiordano: checks 
*** TURN *** [Ts 9c 9d] [Qd]
Fifilaplum: checks 
joaogiordano: checks 
*** RIVER *** [Ts 9c 9d Qd] [8h]
Fifilaplum: checks 
joaogiordano: checks 
*** SHOW DOWN ***
Fifilaplum: shows [7s 2c] (a pair of Nines)
joaogiordano: shows [6s 6c] (two pair, Nines and Sixes)
joaogiordano collected $0.24 from pot
*** SUMMARY ***
Total pot $0.25 | Rake $0.01 
Board [Ts 9c 9d Qd 8h]
Seat 1: sapr.549 (button) folded before Flop (didn't bet)
Seat 2: Impostore1988 (small blind) folded before Flop
Seat 3: Fifilaplum (big blind) showed [7s 2c] and lost with a pair of Nines
Seat 4: Himik30 folded before Flop (didn't bet)
Seat 5: joaogiordano showed [6s 6c] and won ($0.24) with two pair, Nines and Sixes
Seat 6: Acedan1369 folded before Flop (didn't bet)



PokerStars Hand #222964353233:  Hold'em No Limit ($0.05/$0.10 USD) - 2021/01/23 13:42:25 ET
Table 'Malzovia' 6-max Seat #2 is the button
Seat 1: sapr.549 ($13.25 in chips) 
Seat 2: Impostore1988 ($10.94 in chips) 
Seat 3: Fifilaplum ($13.36 in chips) 
Seat 4: Himik30 ($16.06 in chips) 
Seat 5: joaogiordano ($8.38 in chips) 
Seat 6: Acedan1369 ($24.22 in chips) 
Fifilaplum: posts small blind $0.05
Himik30: posts big blind $0.10
*** HOLE CARDS ***
joaogiordano: folds 
Acedan1369: folds 
sapr.549: raises $0.15 to $0.25
Impostore1988: folds 
Fifilaplum: folds 
Himik30: folds 
Uncalled bet ($0.15) returned to sapr.549
sapr.549 collected $0.25 from pot
sapr.549: doesn't show hand 
*** SUMMARY ***
Total pot $0.25 | Rake $0 
Seat 1: sapr.549 collected ($0.25)
Seat 2: Impostore1988 (button) folded before Flop (didn't bet)
Seat 3: Fifilaplum (small blind) folded before Flop
Seat 4: Himik30 (big blind) folded before Flop
Seat 5: joaogiordano folded before Flop (didn't bet)
Seat 6: Acedan1369 folded before Flop (didn't bet)



PokerStars Hand #222964362802:  Hold'em No Limit ($0.05/$0.10 USD) - 2021/01/23 13:42:37 ET
Table 'Malzovia' 6-max Seat #3 is the button
Seat 1: sapr.549 ($13.40 in chips) 
Seat 2: Impostore1988 ($10.94 in chips) 
Seat 3: Fifilaplum ($13.31 in chips) 
Seat 4: Himik30 ($15.96 in chips) 
Seat 5: joaogiordano ($8.38 in chips) 
Seat 6: Acedan1369 ($24.22 in chips) 
Himik30: posts small blind $0.05
joaogiordano: posts big blind $0.10
*** HOLE CARDS ***
Acedan1369: folds 
sapr.549: folds 
Impostore1988: raises $0.10 to $0.20
Fifilaplum: folds 
Himik30: calls $0.15
joaogiordano: folds 
*** FLOP *** [9s Kd 6c]
Himik30: checks 
Impostore1988: checks 
*** TURN *** [9s Kd 6c] [Qh]
Himik30: bets $0.25
Impostore1988: folds 
Uncalled bet ($0.25) returned to Himik30
Himik30 collected $0.48 from pot
Himik30: doesn't show hand 
*** SUMMARY ***
Total pot $0.50 | Rake $0.02 
Board [9s Kd 6c Qh]
Seat 1: sapr.549 folded before Flop (didn't bet)
Seat 2: Impostore1988 folded on the Turn
Seat 3: Fifilaplum (button) folded before Flop (didn't bet)
Seat 4: Himik30 (small blind) collected ($0.48)
Seat 5: joaogiordano (big blind) folded before Flop
Seat 6: Acedan1369 folded before Flop (didn't bet)



PokerStars Hand #222964384525:  Hold'em No Limit ($0.05/$0.10 USD) - 2021/01/23 13:43:05 ET
Table 'Malzovia' 6-max Seat #4 is the button
Seat 1: sapr.549 ($13.40 in chips) 
Seat 2: Impostore1988 ($10.74 in chips) 
Seat 3: Fifilaplum ($13.31 in chips) 
Seat 4: Himik30 ($16.24 in chips) 
Seat 5: joaogiordano ($8.28 in chips) 
Seat 6: Acedan1369 ($24.22 in chips) 
joaogiordano: posts small blind $0.05
Acedan1369: posts big blind $0.10
*** HOLE CARDS ***
sapr.549: folds 
Impostore1988: folds 
Fifilaplum: folds 
Himik30: raises $0.15 to $0.25
joaogiordano: folds 
Acedan1369: folds 
Uncalled bet ($0.15) returned to Himik30
Himik30 collected $0.25 from pot
Himik30: doesn't show hand 
*** SUMMARY ***
Total pot $0.25 | Rake $0 
Seat 1: sapr.549 folded before Flop (didn't bet)
Seat 2: Impostore1988 folded before Flop (didn't bet)
Seat 3: Fifilaplum folded before Flop (didn't bet)
Seat 4: Himik30 (button) collected ($0.25)
Seat 5: joaogiordano (small blind) folded before Flop
Seat 6: Acedan1369 (big blind) folded before Flop



PokerStars Hand #222964399064:  Hold'em No Limit ($0.05/$0.10 USD) - 2021/01/23 13:43:24 ET
Table 'Malzovia' 6-max Seat #5 is the button
Seat 1: sapr.549 ($13.40 in chips) 
Seat 2: Impostore1988 ($10.74 in chips) 
Seat 3: Fifilaplum ($13.31 in chips) 
Seat 4: Himik30 ($16.39 in chips) 
Seat 5: joaogiordano ($8.23 in chips) 
Seat 6: Acedan1369 ($24.12 in chips) 
Acedan1369: posts small blind $0.05
sapr.549: posts big blind $0.10
*** HOLE CARDS ***
Impostore1988: folds 
Fifilaplum: folds 
Himik30: raises $0.15 to $0.25
joaogiordano: folds 
Acedan1369: folds 
sapr.549: folds 
Uncalled bet ($0.15) returned to Himik30
Himik30 collected $0.25 from pot
Himik30: doesn't show hand 
*** SUMMARY ***
Total pot $0.25 | Rake $0 
Seat 1: sapr.549 (big blind) folded before Flop
Seat 2: Impostore1988 folded before Flop (didn't bet)
Seat 3: Fifilaplum folded before Flop (didn't bet)
Seat 4: Himik30 collected ($0.25)
Seat 5: joaogiordano (button) folded before Flop (didn't bet)
Seat 6: Acedan1369 (small blind) folded before Flop



PokerStars Hand #222964413923:  Hold'em No Limit ($0.05/$0.10 USD) - 2021/01/23 13:43:43 ET
Table 'Malzovia' 6-max Seat #6 is the button
Seat 1: sapr.549 ($13.30 in chips) 
Seat 2: Impostore1988 ($10.74 in chips) 
Seat 3: Fifilaplum ($13.31 in chips) 
Seat 4: Himik30 ($16.54 in chips) 
Seat 5: joaogiordano ($8.23 in chips) 
Seat 6: Acedan1369 ($24.07 in chips) 
sapr.549: posts small blind $0.05
Impostore1988: posts big blind $0.10
*** HOLE CARDS ***
Fifilaplum: folds 
Himik30: folds 
joaogiordano: folds 
Acedan1369 has timed out
Acedan1369: folds 
sapr.549: folds 
Uncalled bet ($0.05) returned to Impostore1988
Impostore1988 collected $0.10 from pot
Impostore1988: doesn't show hand 
*** SUMMARY ***
Total pot $0.10 | Rake $0 
Seat 1: sapr.549 (small blind) folded before Flop
Seat 2: Impostore1988 (big blind) collected ($0.10)
Seat 3: Fifilaplum folded before Flop (didn't bet)
Seat 4: Himik30 folded before Flop (didn't bet)
Seat 5: joaogiordano folded before Flop (didn't bet)
Seat 6: Acedan1369 (button) folded before Flop (didn't bet)



PokerStars Hand #222964434337:  Hold'em No Limit ($0.05/$0.10 USD) - 2021/01/23 13:44:02 ET
Table 'Malzovia' 6-max Seat #1 is the button
Seat 1: sapr.549 ($13.25 in chips) 
Seat 2: Impostore1988 ($10.79 in chips) 
Seat 3: Fifilaplum ($13.31 in chips) 
Seat 4: Himik30 ($16.54 in chips) 
Seat 5: joaogiordano ($8.23 in chips) 
Impostore1988: posts small blind $0.05
Fifilaplum: posts big blind $0.10
*** HOLE CARDS ***
Himik30: folds 
joaogiordano: folds 
sapr.549: folds 
Impostore1988: raises $0.10 to $0.20
Fifilaplum: calls $0.10
*** FLOP *** [6s Js 4h]
Impostore1988: checks 
Fifilaplum: bets $0.23
Impostore1988: folds 
Uncalled bet ($0.23) returned to Fifilaplum
Fifilaplum collected $0.38 from pot
Fifilaplum: doesn't show hand 
*** SUMMARY ***
Total pot $0.40 | Rake $0.02 
Board [6s Js 4h]
Seat 1: sapr.549 (button) folded before Flop (didn't bet)
Seat 2: Impostore1988 (small blind) folded on the Flop
Seat 3: Fifilaplum (big blind) collected ($0.38)
Seat 4: Himik30 folded before Flop (didn't bet)
Seat 5: joaogiordano folded before Flop (didn't bet)



PokerStars Hand #222964457248:  Hold'em No Limit ($0.05/$0.10 USD) - 2021/01/23 13:44:31 ET
Table 'Malzovia' 6-max Seat #2 is the button
Seat 1: sapr.549 ($13.25 in chips) 
Seat 2: Impostore1988 ($10.59 in chips) 
Seat 3: Fifilaplum ($13.49 in chips) 
Seat 4: Himik30 ($16.54 in chips) 
Seat 5: joaogiordano ($8.23 in chips) 
Seat 6: Acedan1369 ($24.07 in chips) 
Fifilaplum: posts small blind $0.05
Himik30: posts big blind $0.10
*** HOLE CARDS ***
joaogiordano: folds 
Acedan1369: folds 
sapr.549: folds 
Impostore1988: folds 
Fifilaplum: raises $0.20 to $0.30
Himik30: calls $0.20
*** FLOP *** [2h Tc Jh]
Fifilaplum: checks 
Himik30: bets $0.38
Fifilaplum: calls $0.38
*** TURN *** [2h Tc Jh] [6d]
Fifilaplum: checks 
Himik30: bets $0.87
Fifilaplum: calls $0.87
*** RIVER *** [2h Tc Jh 6d] [Qh]
Fifilaplum: checks 
Himik30: bets $1.48
Fifilaplum: folds 
Uncalled bet ($1.48) returned to Himik30
Himik30 collected $2.96 from pot
Himik30: doesn't show hand 
*** SUMMARY ***
Total pot $3.10 | Rake $0.14 
Board [2h Tc Jh 6d Qh]
Seat 1: sapr.549 folded before Flop (didn't bet)
Seat 2: Impostore1988 (button) folded before Flop (didn't bet)
Seat 3: Fifilaplum (small blind) folded on the River
Seat 4: Himik30 (big blind) collected ($2.96)
Seat 5: joaogiordano folded before Flop (didn't bet)
Seat 6: Acedan1369 folded before Flop (didn't bet)



PokerStars Hand #222964497239:  Hold'em No Limit ($0.05/$0.10 USD) - 2021/01/23 13:45:23 ET
Table 'Malzovia' 6-max Seat #3 is the button
Seat 1: sapr.549 ($13.25 in chips) 
Seat 2: Impostore1988 ($10.59 in chips) 
Seat 3: Fifilaplum ($11.94 in chips) 
Seat 4: Himik30 ($17.95 in chips) 
Seat 5: joaogiordano ($8.23 in chips) 
Seat 6: Acedan1369 ($24.07 in chips) 
Himik30: posts small blind $0.05
joaogiordano: posts big blind $0.10
*** HOLE CARDS ***
Acedan1369: folds 
sapr.549: folds 
Impostore1988: folds 
Fifilaplum: raises $0.15 to $0.25
Himik30: folds 
joaogiordano: calls $0.15
*** FLOP *** [8h 3h Kh]
Himik30 leaves the table
joaogiordano: checks 
Fifilaplum: bets $0.16
joaogiordano: folds 
Uncalled bet ($0.16) returned to Fifilaplum
Fifilaplum collected $0.53 from pot
Fifilaplum: doesn't show hand 
*** SUMMARY ***
Total pot $0.55 | Rake $0.02 
Board [8h 3h Kh]
Seat 1: sapr.549 folded before Flop (didn't bet)
Seat 2: Impostore1988 folded before Flop (didn't bet)
Seat 3: Fifilaplum (button) collected ($0.53)
Seat 4: Himik30 (small blind) folded before Flop
Seat 5: joaogiordano (big blind) folded on the Flop
Seat 6: Acedan1369 folded before Flop (didn't bet)



PokerStars Hand #222964521983:  Hold'em No Limit ($0.05/$0.10 USD) - 2021/01/23 13:45:55 ET
Table 'Malzovia' 6-max Seat #5 is the button
Seat 1: sapr.549 ($13.25 in chips) 
Seat 2: Impostore1988 ($10.59 in chips) 
Seat 3: Fifilaplum ($12.22 in chips) 
Seat 5: joaogiordano ($7.98 in chips) 
Seat 6: Acedan1369 ($24.07 in chips) 
Acedan1369: posts small blind $0.05
sapr.549: posts big blind $0.10
*** HOLE CARDS ***
Impostore1988: raises $0.10 to $0.20
Fifilaplum: folds 
Indangeriam joins the table at seat #4 
joaogiordano: calls $0.20
Acedan1369: folds 
sapr.549: folds 
*** FLOP *** [Ad 3h 6h]
Impostore1988: checks 
joaogiordano: checks 
*** TURN *** [Ad 3h 6h] [6d]
Impostore1988: checks 
joaogiordano: checks 
*** RIVER *** [Ad 3h 6h 6d] [7h]
Impostore1988: checks 
joaogiordano: bets $0.40
Impostore1988: folds 
Uncalled bet ($0.40) returned to joaogiordano
joaogiordano collected $0.53 from pot
joaogiordano: doesn't show hand 
*** SUMMARY ***
Total pot $0.55 | Rake $0.02 
Board [Ad 3h 6h 6d 7h]
Seat 1: sapr.549 (big blind) folded before Flop
Seat 2: Impostore1988 folded on the River
Seat 3: Fifilaplum folded before Flop (didn't bet)
Seat 5: joaogiordano (button) collected ($0.53)
Seat 6: Acedan1369 (small blind) folded before Flop



PokerStars Hand #222964555665:  Hold'em No Limit ($0.05/$0.10 USD) - 2021/01/23 13:46:40 ET
Table 'Malzovia' 6-max Seat #6 is the button
Seat 1: sapr.549 ($13.15 in chips) 
Seat 2: Impostore1988 ($10.39 in chips) 
Seat 3: Fifilaplum ($12.22 in chips) 
Seat 5: joaogiordano ($8.31 in chips) 
Seat 6: Acedan1369 ($24.02 in chips) 
sapr.549: posts small blind $0.05
Impostore1988: posts big blind $0.10
Indangeriam: sits out 
*** HOLE CARDS ***
Fifilaplum: raises $0.15 to $0.25
joaogiordano: folds 
Acedan1369: calls $0.25
sapr.549: folds 
Impostore1988: folds 
*** FLOP *** [6h 2c 5h]
Fifilaplum: checks 
Acedan1369: bets $0.47
Fifilaplum: folds 
Uncalled bet ($0.47) returned to Acedan1369
Acedan1369 collected $0.62 from pot
Acedan1369: doesn't show hand 
*** SUMMARY ***
Total pot $0.65 | Rake $0.03 
Board [6h 2c 5h]
Seat 1: sapr.549 (small blind) folded before Flop
Seat 2: Impostore1988 (big blind) folded before Flop
Seat 3: Fifilaplum folded on the Flop
Seat 5: joaogiordano folded before Flop (didn't bet)
Seat 6: Acedan1369 (button) collected ($0.62)



PokerStars Hand #222964584449:  Hold'em No Limit ($0.05/$0.10 USD) - 2021/01/23 13:47:17 ET
Table 'Malzovia' 6-max Seat #1 is the button
Seat 1: sapr.549 ($13.10 in chips) 
Seat 2: Impostore1988 ($10.29 in chips) 
Seat 3: Fifilaplum ($11.97 in chips) 
Seat 5: joaogiordano ($8.31 in chips) 
Seat 6: Acedan1369 ($24.39 in chips) 
Impostore1988: posts small blind $0.05
Fifilaplum: posts big blind $0.10
Indangeriam: sits out 
*** HOLE CARDS ***
joaogiordano: folds 
Acedan1369: raises $0.15 to $0.25
sapr.549: folds 
Impostore1988: folds 
Fifilaplum: folds 
Uncalled bet ($0.15) returned to Acedan1369
Acedan1369 collected $0.25 from pot
Acedan1369: doesn't show hand 
*** SUMMARY ***
Total pot $0.25 | Rake $0 
Seat 1: sapr.549 (button) folded before Flop (didn't bet)
Seat 2: Impostore1988 (small blind) folded before Flop
Seat 3: Fifilaplum (big blind) folded before Flop
Seat 5: joaogiordano folded before Flop (didn't bet)
Seat 6: Acedan1369 collected ($0.25)



PokerStars Hand #222964596483:  Hold'em No Limit ($0.05/$0.10 USD) - 2021/01/23 13:47:33 ET
Table 'Malzovia' 6-max Seat #2 is the button
Seat 1: sapr.549 ($13.10 in chips) 
Seat 2: Impostore1988 ($10.24 in chips) 
Seat 3: Fifilaplum ($11.87 in chips) 
Seat 4: Indangeriam ($10 in chips) 
Seat 5: joaogiordano ($8.31 in chips) 
Seat 6: Acedan1369 ($24.54 in chips) 
Fifilaplum: posts small blind $0.05
Indangeriam: posts big blind $0.10
*** HOLE CARDS ***
joaogiordano: folds 
Acedan1369: folds 
sapr.549: folds 
Impostore1988: folds 
Fifilaplum: folds 
Uncalled bet ($0.05) returned to Indangeriam
Indangeriam collected $0.10 from pot
Indangeriam: doesn't show hand 
*** SUMMARY ***
Total pot $0.10 | Rake $0 
Seat 1: sapr.549 folded before Flop (didn't bet)
Seat 2: Impostore1988 (button) folded before Flop (didn't bet)
Seat 3: Fifilaplum (small blind) folded before Flop
Seat 4: Indangeriam (big blind) collected ($0.10)
Seat 5: joaogiordano folded before Flop (didn't bet)
Seat 6: Acedan1369 folded before Flop (didn't bet)



PokerStars Hand #222962036720:  Hold'em No Limit ($0.05/$0.10 USD) - 2021/01/23 12:47:57 ET
Table 'Malzovia' 6-max Seat #2 is the button
Seat 1: Marian0P ($12.95 in chips) 
Seat 2: MrLopov ($3.53 in chips) 
Seat 3: Donkey1996 ($16.17 in chips) 
Seat 4: Himik30 ($15.59 in chips) 
Seat 5: Rdalonso ($10.40 in chips) 
Seat 6: DMiller100 ($7.37 in chips) 
Donkey1996: posts small blind $0.05
Himik30: posts big blind $0.10
*** HOLE CARDS ***
Rdalonso: folds 
DMiller100: raises $0.10 to $0.20
Marian0P: folds 
MrLopov: folds 
Donkey1996: folds 
Himik30: calls $0.10
*** FLOP *** [7h 9d 3s]
Himik30: bets $0.10
DMiller100: raises $0.20 to $0.30
Himik30: calls $0.20
*** TURN *** [7h 9d 3s] [Qc]
Himik30: checks 
DMiller100: bets $1
Himik30: raises $1.50 to $2.50
DMiller100: calls $1.50
*** RIVER *** [7h 9d 3s Qc] [2h]
Himik30: bets $2.95
DMiller100: raises $1.42 to $4.37 and is all-in
Himik30: calls $1.42
*** SHOW DOWN ***
DMiller100: shows [Ah Ad] (a pair of Aces)
Himik30: shows [7s 7c] (three of a kind, Sevens)
Himik30 collected $14.12 from pot
*** SUMMARY ***
Total pot $14.79 | Rake $0.67 
Board [7h 9d 3s Qc 2h]
Seat 1: Marian0P folded before Flop (didn't bet)
Seat 2: MrLopov (button) folded before Flop (didn't bet)
Seat 3: Donkey1996 (small blind) folded before Flop
Seat 4: Himik30 (big blind) showed [7s 7c] and won ($14.12) with three of a kind, Sevens
Seat 5: Rdalonso folded before Flop (didn't bet)
Seat 6: DMiller100 showed [Ah Ad] and lost with a pair of Aces



PokerStars Hand #222962077843:  Hold'em No Limit ($0.05/$0.10 USD) - 2021/01/23 12:48:58 ET
Table 'Malzovia' 6-max Seat #3 is the button
Seat 1: Marian0P ($12.95 in chips) 
Seat 2: MrLopov ($3.53 in chips) 
Seat 3: Donkey1996 ($16.12 in chips) 
Seat 4: Himik30 ($22.34 in chips) 
Seat 5: Rdalonso ($10.40 in chips) 
Himik30: posts small blind $0.05
Rdalonso: posts big blind $0.10
*** HOLE CARDS ***
Marian0P: raises $0.20 to $0.30
DMiller100 leaves the table
O.G.Michael joins the table at seat #6 
MrLopov: folds 
Donkey1996: folds 
Himik30: calls $0.25
Rdalonso: folds 
*** FLOP *** [Qd 4c Kh]
Himik30: checks 
Marian0P: checks 
*** TURN *** [Qd 4c Kh] [8s]
Himik30: checks 
Marian0P: bets $0.34
Himik30: folds 
Uncalled bet ($0.34) returned to Marian0P
Marian0P collected $0.67 from pot
Marian0P: doesn't show hand 
*** SUMMARY ***
Total pot $0.70 | Rake $0.03 
Board [Qd 4c Kh 8s]
Seat 1: Marian0P collected ($0.67)
Seat 2: MrLopov folded before Flop (didn't bet)
Seat 3: Donkey1996 (button) folded before Flop (didn't bet)
Seat 4: Himik30 (small blind) folded on the Turn
Seat 5: Rdalonso (big blind) folded before Flop



PokerStars Hand #222962109356:  Hold'em No Limit ($0.05/$0.10 USD) - 2021/01/23 12:49:44 ET
Table 'Malzovia' 6-max Seat #4 is the button
Seat 1: Marian0P ($13.32 in chips) 
Seat 2: MrLopov ($3.53 in chips) 
Seat 3: Donkey1996 ($16.12 in chips) 
Seat 4: Himik30 ($22.04 in chips) 
Seat 5: Rdalonso ($10.30 in chips) 
Seat 6: O.G.Michael ($10 in chips) 
Rdalonso: posts small blind $0.05
O.G.Michael: posts big blind $0.10
*** HOLE CARDS ***
Marian0P: folds 
MrLopov: calls $0.10
Donkey1996: folds 
Himik30: folds 
Rdalonso: raises $0.40 to $0.50
O.G.Michael: folds 
MrLopov: raises $3.03 to $3.53 and is all-in
Rdalonso: calls $3.03
*** FLOP *** [5d 2s 3c]
*** TURN *** [5d 2s 3c] [Tc]
*** RIVER *** [5d 2s 3c Tc] [6d]
*** SHOW DOWN ***
Rdalonso: shows [Kc As] (high card Ace)
MrLopov: shows [Qd Qc] (a pair of Queens)
MrLopov collected $6.84 from pot
*** SUMMARY ***
Total pot $7.16 | Rake $0.32 
Board [5d 2s 3c Tc 6d]
Seat 1: Marian0P folded before Flop (didn't bet)
Seat 2: MrLopov showed [Qd Qc] and won ($6.84) with a pair of Queens
Seat 3: Donkey1996 folded before Flop (didn't bet)
Seat 4: Himik30 (button) folded before Flop (didn't bet)
Seat 5: Rdalonso (small blind) showed [Kc As] and lost with high card Ace
Seat 6: O.G.Michael (big blind) folded before Flop



PokerStars Hand #222962132320:  Hold'em No Limit ($0.05/$0.10 USD) - 2021/01/23 12:50:19 ET
Table 'Malzovia' 6-max Seat #5 is the button
Seat 1: Marian0P ($13.32 in chips) 
Seat 2: MrLopov ($6.84 in chips) 
Seat 3: Donkey1996 ($16.12 in chips) 
Seat 4: Himik30 ($22.04 in chips) 
Seat 5: Rdalonso ($10 in chips) 
Seat 6: O.G.Michael ($10 in chips) 
O.G.Michael: posts small blind $0.05
Marian0P: posts big blind $0.10
*** HOLE CARDS ***
MrLopov: calls $0.10
Donkey1996: folds 
Himik30: folds 
Rdalonso: folds 
O.G.Michael: folds 
Marian0P: checks 
*** FLOP *** [Jh 7c 7h]
Marian0P: checks 
MrLopov: checks 
*** TURN *** [Jh 7c 7h] [Js]
Marian0P: checks 
MrLopov: checks 
*** RIVER *** [Jh 7c 7h Js] [Td]
Marian0P: checks 
MrLopov: bets $0.24
Marian0P: folds 
Uncalled bet ($0.24) returned to MrLopov
MrLopov collected $0.24 from pot
MrLopov: doesn't show hand 
*** SUMMARY ***
Total pot $0.25 | Rake $0.01 
Board [Jh 7c 7h Js Td]
Seat 1: Marian0P (big blind) folded on the River
Seat 2: MrLopov collected ($0.24)
Seat 3: Donkey1996 folded before Flop (didn't bet)
Seat 4: Himik30 folded before Flop (didn't bet)
Seat 5: Rdalonso (button) folded before Flop (didn't bet)
Seat 6: O.G.Michael (small blind) folded before Flop



PokerStars Hand #222962154871:  Hold'em No Limit ($0.05/$0.10 USD) - 2021/01/23 12:50:52 ET
Table 'Malzovia' 6-max Seat #6 is the button
Seat 1: Marian0P ($13.22 in chips) 
Seat 2: MrLopov ($6.98 in chips) 
Seat 3: Donkey1996 ($16.12 in chips) 
Seat 4: Himik30 ($22.04 in chips) 
Seat 5: Rdalonso ($10 in chips) 
Seat 6: O.G.Michael ($10 in chips) 
Marian0P: posts small blind $0.05
MrLopov: posts big blind $0.10
*** HOLE CARDS ***
Donkey1996: folds 
Himik30: folds 
Rdalonso: raises $0.20 to $0.30
O.G.Michael: folds 
Marian0P: folds 
MrLopov: calls $0.20
*** FLOP *** [5s 8c 9c]
MrLopov: checks 
Rdalonso: checks 
*** TURN *** [5s 8c 9c] [Kd]
MrLopov: checks 
Rdalonso: checks 
*** RIVER *** [5s 8c 9c Kd] [5c]
MrLopov: checks 
Rdalonso: checks 
*** SHOW DOWN ***
MrLopov: shows [6h Ac] (a pair of Fives)
Rdalonso: shows [2h 2d] (two pair, Fives and Deuces)
Rdalonso collected $0.62 from pot
*** SUMMARY ***
Total pot $0.65 | Rake $0.03 
Board [5s 8c 9c Kd 5c]
Seat 1: Marian0P (small blind) folded before Flop
Seat 2: MrLopov (big blind) showed [6h Ac] and lost with a pair of Fives
Seat 3: Donkey1996 folded before Flop (didn't bet)
Seat 4: Himik30 folded before Flop (didn't bet)
Seat 5: Rdalonso showed [2h 2d] and won ($0.62) with two pair, Fives and Deuces
Seat 6: O.G.Michael (button) folded before Flop (didn't bet)



PokerStars Hand #222962178619:  Hold'em No Limit ($0.05/$0.10 USD) - 2021/01/23 12:51:27 ET
Table 'Malzovia' 6-max Seat #1 is the button
Seat 1: Marian0P ($13.17 in chips) 
Seat 2: MrLopov ($6.68 in chips) 
Seat 3: Donkey1996 ($16.12 in chips) 
Seat 4: Himik30 ($22.04 in chips) 
Seat 5: Rdalonso ($10.32 in chips) 
Seat 6: O.G.Michael ($10 in chips) 
MrLopov: posts small blind $0.05
Donkey1996: posts big blind $0.10
*** HOLE CARDS ***
Himik30: folds 
Rdalonso: raises $0.20 to $0.30
O.G.Michael: folds 
Marian0P: folds 
MrLopov: folds 
Donkey1996: raises $0.90 to $1.20
Rdalonso: folds 
Uncalled bet ($0.90) returned to Donkey1996
Donkey1996 collected $0.65 from pot
Donkey1996: doesn't show hand 
*** SUMMARY ***
Total pot $0.65 | Rake $0 
Seat 1: Marian0P (button) folded before Flop (didn't bet)
Seat 2: MrLopov (small blind) folded before Flop
Seat 3: Donkey1996 (big blind) collected ($0.65)
Seat 4: Himik30 folded before Flop (didn't bet)
Seat 5: Rdalonso folded before Flop
Seat 6: O.G.Michael folded before Flop (didn't bet)



PokerStars Hand #222962192332:  Hold'em No Limit ($0.05/$0.10 USD) - 2021/01/23 12:51:47 ET
Table 'Malzovia' 6-max Seat #2 is the button
Seat 1: Marian0P ($13.17 in chips) 
Seat 2: MrLopov ($6.63 in chips) 
Seat 3: Donkey1996 ($16.47 in chips) 
Seat 4: Himik30 ($22.04 in chips) 
Seat 5: Rdalonso ($10.02 in chips) 
Seat 6: O.G.Michael ($10 in chips) 
Donkey1996: posts small blind $0.05
Himik30: posts big blind $0.10
*** HOLE CARDS ***
Rdalonso: raises $0.20 to $0.30
O.G.Michael: folds 
Marian0P: folds 
MrLopov: folds 
Donkey1996: raises $0.90 to $1.20
Himik30: folds 
Rdalonso: folds 
Uncalled bet ($0.90) returned to Donkey1996
Donkey1996 collected $0.70 from pot
Donkey1996: doesn't show hand 
*** SUMMARY ***
Total pot $0.70 | Rake $0 
Seat 1: Marian0P folded before Flop (didn't bet)
Seat 2: MrLopov (button) folded before Flop (didn't bet)
Seat 3: Donkey1996 (small blind) collected ($0.70)
Seat 4: Himik30 (big blind) folded before Flop
Seat 5: Rdalonso folded before Flop
Seat 6: O.G.Michael folded before Flop (didn't bet)



PokerStars Hand #222962206845:  Hold'em No Limit ($0.05/$0.10 USD) - 2021/01/23 12:52:09 ET
Table 'Malzovia' 6-max Seat #3 is the button
Seat 1: Marian0P ($13.17 in chips) 
Seat 2: MrLopov ($6.63 in chips) 
Seat 3: Donkey1996 ($16.87 in chips) 
Seat 4: Himik30 ($21.94 in chips) 
Seat 5: Rdalonso ($10 in chips) 
Seat 6: O.G.Michael ($10 in chips) 
Himik30: posts small blind $0.05
Rdalonso: posts big blind $0.10
*** HOLE CARDS ***
O.G.Michael: folds 
Marian0P: folds 
MrLopov: folds 
Donkey1996: folds 
Himik30: folds 
Uncalled bet ($0.05) returned to Rdalonso
Rdalonso collected $0.10 from pot
Rdalonso: doesn't show hand 
*** SUMMARY ***
Total pot $0.10 | Rake $0 
Seat 1: Marian0P folded before Flop (didn't bet)
Seat 2: MrLopov folded before Flop (didn't bet)
Seat 3: Donkey1996 (button) folded before Flop (didn't bet)
Seat 4: Himik30 (small blind) folded before Flop
Seat 5: Rdalonso (big blind) collected ($0.10)
Seat 6: O.G.Michael folded before Flop (didn't bet)



PokerStars Hand #222962213414:  Hold'em No Limit ($0.05/$0.10 USD) - 2021/01/23 12:52:18 ET
Table 'Malzovia' 6-max Seat #4 is the button
Seat 1: Marian0P ($13.17 in chips) 
Seat 2: MrLopov ($6.63 in chips) 
Seat 3: Donkey1996 ($16.87 in chips) 
Seat 4: Himik30 ($21.89 in chips) 
Seat 5: Rdalonso ($10.05 in chips) 
Seat 6: O.G.Michael ($10 in chips) 
Rdalonso: posts small blind $0.05
O.G.Michael: posts big blind $0.10
*** HOLE CARDS ***
Marian0P: raises $0.20 to $0.30
MrLopov: folds 
Donkey1996: folds 
Himik30: folds 
Rdalonso: folds 
O.G.Michael: folds 
Uncalled bet ($0.20) returned to Marian0P
Marian0P collected $0.25 from pot
Marian0P: doesn't show hand 
*** SUMMARY ***
Total pot $0.25 | Rake $0 
Seat 1: Marian0P collected ($0.25)
Seat 2: MrLopov folded before Flop (didn't bet)
Seat 3: Donkey1996 folded before Flop (didn't bet)
Seat 4: Himik30 (button) folded before Flop (didn't bet)
Seat 5: Rdalonso (small blind) folded before Flop
Seat 6: O.G.Michael (big blind) folded before Flop



PokerStars Hand #222962220078:  Hold'em No Limit ($0.05/$0.10 USD) - 2021/01/23 12:52:28 ET
Table 'Malzovia' 6-max Seat #5 is the button
Seat 1: Marian0P ($13.32 in chips) 
Seat 2: MrLopov ($6.63 in chips) 
Seat 3: Donkey1996 ($16.87 in chips) 
Seat 4: Himik30 ($21.89 in chips) 
Seat 5: Rdalonso ($10 in chips) 
Seat 6: O.G.Michael ($10 in chips) 
O.G.Michael: posts small blind $0.05
Marian0P: posts big blind $0.10
*** HOLE CARDS ***
MrLopov: folds 
Donkey1996: folds 
Himik30: folds 
Rdalonso: folds 
O.G.Michael: folds 
Uncalled bet ($0.05) returned to Marian0P
Marian0P collected $0.10 from pot
Marian0P: doesn't show hand 
*** SUMMARY ***
Total pot $0.10 | Rake $0 
Seat 1: Marian0P (big blind) collected ($0.10)
Seat 2: MrLopov folded before Flop (didn't bet)
Seat 3: Donkey1996 folded before Flop (didn't bet)
Seat 4: Himik30 folded before Flop (didn't bet)
Seat 5: Rdalonso (button) folded before Flop (didn't bet)
Seat 6: O.G.Michael (small blind) folded before Flop



PokerStars Hand #222962227763:  Hold'em No Limit ($0.05/$0.10 USD) - 2021/01/23 12:52:40 ET
Table 'Malzovia' 6-max Seat #6 is the button
Seat 1: Marian0P ($13.37 in chips) 
Seat 2: MrLopov ($6.63 in chips) 
Seat 3: Donkey1996 ($16.87 in chips) 
Seat 4: Himik30 ($21.89 in chips) 
Seat 5: Rdalonso ($10 in chips) 
Seat 6: O.G.Michael ($10 in chips) 
Marian0P: posts small blind $0.05
MrLopov: posts big blind $0.10
*** HOLE CARDS ***
Donkey1996: folds 
Himik30: folds 
Rdalonso: folds 
O.G.Michael: folds 
Marian0P: raises $0.20 to $0.30
MrLopov: calls $0.20
*** FLOP *** [8h 2s 2h]
Marian0P: bets $0.18
MrLopov: folds 
Uncalled bet ($0.18) returned to Marian0P
Marian0P collected $0.57 from pot
Marian0P: doesn't show hand 
*** SUMMARY ***
Total pot $0.60 | Rake $0.03 
Board [8h 2s 2h]
Seat 1: Marian0P (small blind) collected ($0.57)
Seat 2: MrLopov (big blind) folded on the Flop
Seat 3: Donkey1996 folded before Flop (didn't bet)
Seat 4: Himik30 folded before Flop (didn't bet)
Seat 5: Rdalonso folded before Flop (didn't bet)
Seat 6: O.G.Michael (button) folded before Flop (didn't bet)



PokerStars Hand #222962251689:  Hold'em No Limit ($0.05/$0.10 USD) - 2021/01/23 12:53:05 ET
Table 'Malzovia' 6-max Seat #1 is the button
Seat 1: Marian0P ($13.64 in chips) 
Seat 2: MrLopov ($6.33 in chips) 
Seat 3: Donkey1996 ($16.87 in chips) 
Seat 4: Himik30 ($21.89 in chips) 
Seat 5: Rdalonso ($10 in chips) 
Seat 6: O.G.Michael ($10 in chips) 
MrLopov: posts small blind $0.05
Donkey1996: posts big blind $0.10
*** HOLE CARDS ***
Himik30: folds 
Rdalonso: folds 
O.G.Michael: folds 
Marian0P: raises $0.14 to $0.24
MrLopov: folds 
Donkey1996: folds 
Uncalled bet ($0.14) returned to Marian0P
Marian0P collected $0.25 from pot
Marian0P: doesn't show hand 
*** SUMMARY ***
Total pot $0.25 | Rake $0 
Seat 1: Marian0P (button) collected ($0.25)
Seat 2: MrLopov (small blind) folded before Flop
Seat 3: Donkey1996 (big blind) folded before Flop
Seat 4: Himik30 folded before Flop (didn't bet)
Seat 5: Rdalonso folded before Flop (didn't bet)
Seat 6: O.G.Michael folded before Flop (didn't bet)



PokerStars Hand #222962264217:  Hold'em No Limit ($0.05/$0.10 USD) - 2021/01/23 12:53:24 ET
Table 'Malzovia' 6-max Seat #2 is the button
Seat 1: Marian0P ($13.79 in chips) 
Seat 2: MrLopov ($6.28 in chips) 
Seat 3: Donkey1996 ($16.77 in chips) 
Seat 4: Himik30 ($21.89 in chips) 
Seat 5: Rdalonso ($10 in chips) 
Seat 6: O.G.Michael ($10 in chips) 
Donkey1996: posts small blind $0.05
Himik30: posts big blind $0.10
*** HOLE CARDS ***
Rdalonso: folds 
O.G.Michael: folds 
Marian0P: folds 
MrLopov: folds 
Donkey1996: raises $0.20 to $0.30
Himik30: calls $0.20
*** FLOP *** [8d 8s 7s]
Donkey1996: checks 
Himik30: checks 
*** TURN *** [8d 8s 7s] [5d]
Donkey1996: checks 
Himik30: checks 
*** RIVER *** [8d 8s 7s 5d] [Ad]
Donkey1996: checks 
Himik30: checks 
*** SHOW DOWN ***
Donkey1996: shows [Ac 6h] (two pair, Aces and Eights)
Himik30: mucks hand 
Donkey1996 collected $0.57 from pot
*** SUMMARY ***
Total pot $0.60 | Rake $0.03 
Board [8d 8s 7s 5d Ad]
Seat 1: Marian0P folded before Flop (didn't bet)
Seat 2: MrLopov (button) folded before Flop (didn't bet)
Seat 3: Donkey1996 (small blind) showed [Ac 6h] and won ($0.57) with two pair, Aces and Eights
Seat 4: Himik30 (big blind) mucked
Seat 5: Rdalonso folded before Flop (didn't bet)
Seat 6: O.G.Michael folded before Flop (didn't bet)



PokerStars Hand #222962280709:  Hold'em No Limit ($0.05/$0.10 USD) - 2021/01/23 12:53:49 ET
Table 'Malzovia' 6-max Seat #3 is the button
Seat 1: Marian0P ($13.79 in chips) 
Seat 2: MrLopov ($6.28 in chips) 
Seat 3: Donkey1996 ($17.04 in chips) 
Seat 4: Himik30 ($21.59 in chips) 
Seat 5: Rdalonso ($10 in chips) 
Seat 6: O.G.Michael ($10 in chips) 
Himik30: posts small blind $0.05
Rdalonso: posts big blind $0.10
*** HOLE CARDS ***
O.G.Michael: folds 
Marian0P: folds 
MrLopov: calls $0.10
Donkey1996: folds 
Himik30: folds 
Rdalonso: checks 
*** FLOP *** [Th 2s Jc]
Rdalonso: bets $0.17
MrLopov: calls $0.17
*** TURN *** [Th 2s Jc] [Kd]
Rdalonso: checks 
MrLopov: bets $0.56
Rdalonso: calls $0.56
*** RIVER *** [Th 2s Jc Kd] [7d]
Rdalonso: checks 
MrLopov: bets $1.63
Rdalonso: folds 
Uncalled bet ($1.63) returned to MrLopov
MrLopov collected $1.63 from pot
MrLopov: doesn't show hand 
*** SUMMARY ***
Total pot $1.71 | Rake $0.08 
Board [Th 2s Jc Kd 7d]
Seat 1: Marian0P folded before Flop (didn't bet)
Seat 2: MrLopov collected ($1.63)
Seat 3: Donkey1996 (button) folded before Flop (didn't bet)
Seat 4: Himik30 (small blind) folded before Flop
Seat 5: Rdalonso (big blind) folded on the River
Seat 6: O.G.Michael folded before Flop (didn't bet)



PokerStars Hand #222962310585:  Hold'em No Limit ($0.05/$0.10 USD) - 2021/01/23 12:54:33 ET
Table 'Malzovia' 6-max Seat #4 is the button
Seat 1: Marian0P ($13.79 in chips) 
Seat 2: MrLopov ($7.08 in chips) 
Seat 3: Donkey1996 ($17.04 in chips) 
Seat 4: Himik30 ($21.54 in chips) 
Seat 5: Rdalonso ($10 in chips) 
Seat 6: O.G.Michael ($10 in chips) 
Rdalonso: posts small blind $0.05
O.G.Michael: posts big blind $0.10
*** HOLE CARDS ***
Marian0P: folds 
MrLopov: folds 
Donkey1996: folds 
Himik30: folds 
Rdalonso: folds 
Uncalled bet ($0.05) returned to O.G.Michael
O.G.Michael collected $0.10 from pot
*** SUMMARY ***
Total pot $0.10 | Rake $0 
Seat 1: Marian0P folded before Flop (didn't bet)
Seat 2: MrLopov folded before Flop (didn't bet)
Seat 3: Donkey1996 folded before Flop (didn't bet)
Seat 4: Himik30 (button) folded before Flop (didn't bet)
Seat 5: Rdalonso (small blind) folded before Flop
Seat 6: O.G.Michael (big blind) collected ($0.10)



PokerStars Hand #222962316315:  Hold'em No Limit ($0.05/$0.10 USD) - 2021/01/23 12:54:42 ET
Table 'Malzovia' 6-max Seat #5 is the button
Seat 1: Marian0P ($13.79 in chips) 
Seat 2: MrLopov ($7.08 in chips) 
Seat 3: Donkey1996 ($17.04 in chips) 
Seat 4: Himik30 ($21.54 in chips) 
Seat 5: Rdalonso ($10 in chips) 
Seat 6: O.G.Michael ($10.05 in chips) 
O.G.Michael: posts small blind $0.05
Marian0P: posts big blind $0.10
*** HOLE CARDS ***
MrLopov: calls $0.10
Donkey1996: folds 
Himik30: folds 
Rdalonso: folds 
O.G.Michael: folds 
Marian0P: checks 
*** FLOP *** [6c Td Ad]
Marian0P: checks 
MrLopov: checks 
*** TURN *** [6c Td Ad] [Jh]
Marian0P: checks 
MrLopov: checks 
*** RIVER *** [6c Td Ad Jh] [5s]
Marian0P: checks 
MrLopov: checks 
*** SHOW DOWN ***
Marian0P: shows [3h 6h] (a pair of Sixes)
MrLopov: mucks hand 
Marian0P collected $0.24 from pot
*** SUMMARY ***
Total pot $0.25 | Rake $0.01 
Board [6c Td Ad Jh 5s]
Seat 1: Marian0P (big blind) showed [3h 6h] and won ($0.24) with a pair of Sixes
Seat 2: MrLopov mucked
Seat 3: Donkey1996 folded before Flop (didn't bet)
Seat 4: Himik30 folded before Flop (didn't bet)
Seat 5: Rdalonso (button) folded before Flop (didn't bet)
Seat 6: O.G.Michael (small blind) folded before Flop



PokerStars Hand #222962335282:  Hold'em No Limit ($0.05/$0.10 USD) - 2021/01/23 12:55:11 ET
Table 'Malzovia' 6-max Seat #6 is the button
Seat 1: Marian0P ($13.93 in chips) 
Seat 2: MrLopov ($6.98 in chips) 
Seat 3: Donkey1996 ($17.04 in chips) 
Seat 4: Himik30 ($21.54 in chips) 
Seat 5: Rdalonso ($10 in chips) 
Seat 6: O.G.Michael ($10 in chips) 
Marian0P: posts small blind $0.05
MrLopov: posts big blind $0.10
*** HOLE CARDS ***
Donkey1996: raises $0.20 to $0.30
Himik30: folds 
Rdalonso: folds 
O.G.Michael: folds 
Marian0P: folds 
MrLopov: calls $0.20
*** FLOP *** [2c Ac 9h]
MrLopov: checks 
Donkey1996: checks 
*** TURN *** [2c Ac 9h] [Ah]
MrLopov: bets $0.62
Donkey1996: calls $0.62
*** RIVER *** [2c Ac 9h Ah] [6c]
MrLopov: checks 
Donkey1996: checks 
*** SHOW DOWN ***
MrLopov: shows [7d 7c] (two pair, Aces and Sevens)
Donkey1996: mucks hand 
MrLopov collected $1.80 from pot
*** SUMMARY ***
Total pot $1.89 | Rake $0.09 
Board [2c Ac 9h Ah 6c]
Seat 1: Marian0P (small blind) folded before Flop
Seat 2: MrLopov (big blind) showed [7d 7c] and won ($1.80) with two pair, Aces and Sevens
Seat 3: Donkey1996 mucked
Seat 4: Himik30 folded before Flop (didn't bet)
Seat 5: Rdalonso folded before Flop (didn't bet)
Seat 6: O.G.Michael (button) folded before Flop (didn't bet)



PokerStars Hand #222962351121:  Hold'em No Limit ($0.05/$0.10 USD) - 2021/01/23 12:55:43 ET
Table 'Malzovia' 6-max Seat #1 is the button
Seat 1: Marian0P ($13.88 in chips) 
Seat 2: MrLopov ($7.86 in chips) 
Seat 3: Donkey1996 ($16.12 in chips) 
Seat 4: Himik30 ($21.54 in chips) 
Seat 5: Rdalonso ($10 in chips) 
Seat 6: O.G.Michael ($10 in chips) 
MrLopov: posts small blind $0.05
Donkey1996: posts big blind $0.10
*** HOLE CARDS ***
Himik30: folds 
Rdalonso: folds 
O.G.Michael: folds 
Marian0P: folds 
MrLopov: calls $0.05
Donkey1996: checks 
*** FLOP *** [6h Jc Th]
MrLopov: checks 
Donkey1996: checks 
*** TURN *** [6h Jc Th] [Qc]
MrLopov: checks 
Donkey1996: checks 
*** RIVER *** [6h Jc Th Qc] [Qd]
MrLopov: checks 
Donkey1996: checks 
*** SHOW DOWN ***
MrLopov: shows [4c 4d] (two pair, Queens and Fours)
Donkey1996: mucks hand 
MrLopov collected $0.19 from pot
*** SUMMARY ***
Total pot $0.20 | Rake $0.01 
Board [6h Jc Th Qc Qd]
Seat 1: Marian0P (button) folded before Flop (didn't bet)
Seat 2: MrLopov (small blind) showed [4c 4d] and won ($0.19) with two pair, Queens and Fours
Seat 3: Donkey1996 (big blind) mucked
Seat 4: Himik30 folded before Flop (didn't bet)
Seat 5: Rdalonso folded before Flop (didn't bet)
Seat 6: O.G.Michael folded before Flop (didn't bet)



PokerStars Hand #222962363403:  Hold'em No Limit ($0.05/$0.10 USD) - 2021/01/23 12:56:08 ET
Table 'Malzovia' 6-max Seat #2 is the button
Seat 1: Marian0P ($13.88 in chips) 
Seat 2: MrLopov ($7.95 in chips) 
Seat 3: Donkey1996 ($16.02 in chips) 
Seat 4: Himik30 ($21.54 in chips) 
Seat 5: Rdalonso ($10 in chips) 
Seat 6: O.G.Michael ($10 in chips) 
Donkey1996: posts small blind $0.05
Himik30: posts big blind $0.10
*** HOLE CARDS ***
Rdalonso: raises $0.20 to $0.30
O.G.Michael: folds 
Marian0P: folds 
MrLopov: folds 
Donkey1996: folds 
Himik30: calls $0.20
*** FLOP *** [4d 5c Qd]
Himik30: checks 
Rdalonso: bets $0.20
Himik30: folds 
Uncalled bet ($0.20) returned to Rdalonso
Rdalonso collected $0.62 from pot
Rdalonso: doesn't show hand 
*** SUMMARY ***
Total pot $0.65 | Rake $0.03 
Board [4d 5c Qd]
Seat 1: Marian0P folded before Flop (didn't bet)
Seat 2: MrLopov (button) folded before Flop (didn't bet)
Seat 3: Donkey1996 (small blind) folded before Flop
Seat 4: Himik30 (big blind) folded on the Flop
Seat 5: Rdalonso collected ($0.62)
Seat 6: O.G.Michael folded before Flop (didn't bet)



PokerStars Hand #222962373946:  Hold'em No Limit ($0.05/$0.10 USD) - 2021/01/23 12:56:29 ET
Table 'Malzovia' 6-max Seat #3 is the button
Seat 1: Marian0P ($13.88 in chips) 
Seat 2: MrLopov ($7.95 in chips) 
Seat 3: Donkey1996 ($15.97 in chips) 
Seat 4: Himik30 ($21.24 in chips) 
Seat 5: Rdalonso ($10.32 in chips) 
Seat 6: O.G.Michael ($10 in chips) 
Himik30: posts small blind $0.05
Rdalonso: posts big blind $0.10
*** HOLE CARDS ***
O.G.Michael: folds 
Marian0P: folds 
MrLopov: folds 
Donkey1996: raises $0.20 to $0.30
Himik30: folds 
Rdalonso: folds 
Uncalled bet ($0.20) returned to Donkey1996
Donkey1996 collected $0.25 from pot
Donkey1996: doesn't show hand 
*** SUMMARY ***
Total pot $0.25 | Rake $0 
Seat 1: Marian0P folded before Flop (didn't bet)
Seat 2: MrLopov folded before Flop (didn't bet)
Seat 3: Donkey1996 (button) collected ($0.25)
Seat 4: Himik30 (small blind) folded before Flop
Seat 5: Rdalonso (big blind) folded before Flop
Seat 6: O.G.Michael folded before Flop (didn't bet)



PokerStars Hand #222962378861:  Hold'em No Limit ($0.05/$0.10 USD) - 2021/01/23 12:56:39 ET
Table 'Malzovia' 6-max Seat #4 is the button
Seat 1: Marian0P ($13.88 in chips) 
Seat 2: MrLopov ($7.95 in chips) 
Seat 3: Donkey1996 ($16.12 in chips) 
Seat 4: Himik30 ($21.19 in chips) 
Seat 5: Rdalonso ($10.22 in chips) 
Seat 6: O.G.Michael ($10 in chips) 
Rdalonso: posts small blind $0.05
O.G.Michael: posts big blind $0.10
*** HOLE CARDS ***
Marian0P: folds 
MrLopov: raises $0.10 to $0.20
Donkey1996: folds 
Himik30: raises $0.30 to $0.50
Rdalonso: folds 
O.G.Michael: folds 
MrLopov: calls $0.30
*** FLOP *** [Kc 9c Kh]
MrLopov: checks 
Himik30: checks 
*** TURN *** [Kc 9c Kh] [3d]
MrLopov: bets $1.10
Himik30: folds 
Uncalled bet ($1.10) returned to MrLopov
MrLopov collected $1.10 from pot
MrLopov: doesn't show hand 
*** SUMMARY ***
Total pot $1.15 | Rake $0.05 
Board [Kc 9c Kh 3d]
Seat 1: Marian0P folded before Flop (didn't bet)
Seat 2: MrLopov collected ($1.10)
Seat 3: Donkey1996 folded before Flop (didn't bet)
Seat 4: Himik30 (button) folded on the Turn
Seat 5: Rdalonso (small blind) folded before Flop
Seat 6: O.G.Michael (big blind) folded before Flop



PokerStars Hand #222962402484:  Hold'em No Limit ($0.05/$0.10 USD) - 2021/01/23 12:57:27 ET
Table 'Malzovia' 6-max Seat #5 is the button
Seat 1: Marian0P ($13.88 in chips) 
Seat 2: MrLopov ($8.55 in chips) 
Seat 3: Donkey1996 ($16.12 in chips) 
Seat 4: Himik30 ($20.69 in chips) 
Seat 5: Rdalonso ($10.17 in chips) 
Seat 6: O.G.Michael ($10 in chips) 
O.G.Michael: posts small blind $0.05
Marian0P: posts big blind $0.10
*** HOLE CARDS ***
MrLopov: calls $0.10
Donkey1996: raises $0.30 to $0.40
Himik30: folds 
Rdalonso: raises $0.80 to $1.20
O.G.Michael: folds 
Marian0P: folds 
MrLopov: folds 
Donkey1996: calls $0.80
*** FLOP *** [5c 8d 2s]
Donkey1996: checks 
Rdalonso: bets $0.83
Donkey1996: calls $0.83
*** TURN *** [5c 8d 2s] [3c]
Donkey1996: checks 
Rdalonso: bets $1.36
Donkey1996: calls $1.36
*** RIVER *** [5c 8d 2s 3c] [Th]
Donkey1996: checks 
Rdalonso: bets $6.78 and is all-in
Donkey1996: folds 
Uncalled bet ($6.78) returned to Rdalonso
Rdalonso collected $6.71 from pot
Rdalonso: doesn't show hand 
*** SUMMARY ***
Total pot $7.03 | Rake $0.32 
Board [5c 8d 2s 3c Th]
Seat 1: Marian0P (big blind) folded before Flop
Seat 2: MrLopov folded before Flop
Seat 3: Donkey1996 folded on the River
Seat 4: Himik30 folded before Flop (didn't bet)
Seat 5: Rdalonso (button) collected ($6.71)
Seat 6: O.G.Michael (small blind) folded before Flop



PokerStars Hand #222962450050:  Hold'em No Limit ($0.05/$0.10 USD) - 2021/01/23 12:59:02 ET
Table 'Malzovia' 6-max Seat #6 is the button
Seat 1: Marian0P ($13.78 in chips) 
Seat 2: MrLopov ($8.45 in chips) 
Seat 3: Donkey1996 ($12.73 in chips) 
Seat 4: Himik30 ($20.69 in chips) 
Seat 5: Rdalonso ($13.49 in chips) 
Seat 6: O.G.Michael ($10 in chips) 
Marian0P: posts small blind $0.05
MrLopov: posts big blind $0.10
*** HOLE CARDS ***
Donkey1996: folds 
Himik30: folds 
Rdalonso: raises $0.20 to $0.30
O.G.Michael: folds 
Marian0P: folds 
MrLopov: calls $0.20
*** FLOP *** [4s 5s Ts]
MrLopov: checks 
Rdalonso: bets $0.31
MrLopov: calls $0.31
*** TURN *** [4s 5s Ts] [3c]
MrLopov: checks 
Rdalonso: bets $0.85
MrLopov: calls $0.85
*** RIVER *** [4s 5s Ts 3c] [9s]
MrLopov: checks 
Rdalonso: checks 
*** SHOW DOWN ***
MrLopov: shows [Th 4h] (two pair, Tens and Fours)
Rdalonso: shows [Qh Qs] (a flush, Queen high)
Rdalonso collected $2.84 from pot
*** SUMMARY ***
Total pot $2.97 | Rake $0.13 
Board [4s 5s Ts 3c 9s]
Seat 1: Marian0P (small blind) folded before Flop
Seat 2: MrLopov (big blind) showed [Th 4h] and lost with two pair, Tens and Fours
Seat 3: Donkey1996 folded before Flop (didn't bet)
Seat 4: Himik30 folded before Flop (didn't bet)
Seat 5: Rdalonso showed [Qh Qs] and won ($2.84) with a flush, Queen high
Seat 6: O.G.Michael (button) folded before Flop (didn't bet)



PokerStars Hand #222962476090:  Hold'em No Limit ($0.05/$0.10 USD) - 2021/01/23 12:59:54 ET
Table 'Malzovia' 6-max Seat #1 is the button
Seat 1: Marian0P ($13.73 in chips) 
Seat 2: MrLopov ($6.99 in chips) 
Seat 3: Donkey1996 ($12.73 in chips) 
Seat 4: Himik30 ($20.69 in chips) 
Seat 5: Rdalonso ($14.87 in chips) 
Seat 6: O.G.Michael ($10 in chips) 
MrLopov: posts small blind $0.05
Donkey1996: posts big blind $0.10
*** HOLE CARDS ***
Himik30: raises $0.15 to $0.25
Rdalonso: folds 
O.G.Michael: calls $0.25
Marian0P: folds 
MrLopov: folds 
Donkey1996: folds 
*** FLOP *** [7s Kh Qs]
MrLopov leaves the table
Himik30: bets $0.41
O.G.Michael: calls $0.41
*** TURN *** [7s Kh Qs] [8d]
Marian0P leaves the table
Buinstra16 joins the table at seat #2 
Himik30: bets $0.70
O.G.Michael: calls $0.70
*** RIVER *** [7s Kh Qs 8d] [5d]
Himik30: checks 
sapr.549 joins the table at seat #1 
O.G.Michael: bets $1.50
Himik30: folds 
Uncalled bet ($1.50) returned to O.G.Michael
O.G.Michael collected $2.74 from pot
*** SUMMARY ***
Total pot $2.87 | Rake $0.13 
Board [7s Kh Qs 8d 5d]
Seat 1: Marian0P (button) folded before Flop (didn't bet)
Seat 2: MrLopov (small blind) folded before Flop
Seat 3: Donkey1996 (big blind) folded before Flop
Seat 4: Himik30 folded on the River
Seat 5: Rdalonso folded before Flop (didn't bet)
Seat 6: O.G.Michael collected ($2.74)



PokerStars Hand #222962505329:  Hold'em No Limit ($0.05/$0.10 USD) - 2021/01/23 13:00:49 ET
Table 'Malzovia' 6-max Seat #3 is the button
Seat 2: Buinstra16 ($10 in chips) 
Seat 3: Donkey1996 ($12.63 in chips) 
Seat 4: Himik30 ($19.33 in chips) 
Seat 5: Rdalonso ($14.87 in chips) 
Seat 6: O.G.Michael ($11.38 in chips) 
Himik30: posts small blind $0.05
Rdalonso: posts big blind $0.10
sapr.549: sits out 
Buinstra16: posts big blind $0.10
*** HOLE CARDS ***
O.G.Michael: raises $0.20 to $0.30
Buinstra16: folds 
Donkey1996: folds 
Himik30: folds 
Rdalonso: calls $0.20
*** FLOP *** [Kh 3h 6h]
Rdalonso: checks 
O.G.Michael: bets $0.36
Rdalonso: folds 
Uncalled bet ($0.36) returned to O.G.Michael
O.G.Michael collected $0.72 from pot
*** SUMMARY ***
Total pot $0.75 | Rake $0.03 
Board [Kh 3h 6h]
Seat 2: Buinstra16 folded before Flop (didn't bet)
Seat 3: Donkey1996 (button) folded before Flop (didn't bet)
Seat 4: Himik30 (small blind) folded before Flop
Seat 5: Rdalonso (big blind) folded on the Flop
Seat 6: O.G.Michael collected ($0.72)



PokerStars Hand #222964606923:  Hold'em No Limit ($0.05/$0.10 USD) - 2021/01/23 13:47:47 ET
Table 'Malzovia' 6-max Seat #3 is the button
Seat 1: sapr.549 ($13.10 in chips) 
Seat 2: Impostore1988 ($10.24 in chips) 
Seat 3: Fifilaplum ($11.82 in chips) 
Seat 4: Indangeriam ($10.05 in chips) 
Seat 5: joaogiordano ($8.31 in chips) 
Seat 6: Acedan1369 ($24.54 in chips) 
Indangeriam: posts small blind $0.05
joaogiordano: posts big blind $0.10
*** HOLE CARDS ***
Acedan1369: folds 
sapr.549: folds 
Impostore1988: raises $0.10 to $0.20
Fifilaplum: folds 
Indangeriam: folds 
joaogiordano: calls $0.10
*** FLOP *** [6s As 9h]
joaogiordano: checks 
Impostore1988: bets $0.22
joaogiordano: calls $0.22
*** TURN *** [6s As 9h] [3s]
joaogiordano: checks 
Impostore1988: checks 
*** RIVER *** [6s As 9h 3s] [Jh]
joaogiordano: bets $0.80
Impostore1988: folds 
Uncalled bet ($0.80) returned to joaogiordano
joaogiordano collected $0.85 from pot
joaogiordano: doesn't show hand 
*** SUMMARY ***
Total pot $0.89 | Rake $0.04 
Board [6s As 9h 3s Jh]
Seat 1: sapr.549 folded before Flop (didn't bet)
Seat 2: Impostore1988 folded on the River
Seat 3: Fifilaplum (button) folded before Flop (didn't bet)
Seat 4: Indangeriam (small blind) folded before Flop
Seat 5: joaogiordano (big blind) collected ($0.85)
Seat 6: Acedan1369 folded before Flop (didn't bet)



PokerStars Hand #222964640337:  Hold'em No Limit ($0.05/$0.10 USD) - 2021/01/23 13:48:31 ET
Table 'Malzovia' 6-max Seat #4 is the button
Seat 1: sapr.549 ($13.10 in chips) 
Seat 2: Impostore1988 ($9.82 in chips) 
Seat 3: Fifilaplum ($11.82 in chips) 
Seat 4: Indangeriam ($10 in chips) 
Seat 5: joaogiordano ($8.74 in chips) 
Seat 6: Acedan1369 ($24.54 in chips) 
joaogiordano: posts small blind $0.05
Acedan1369: posts big blind $0.10
*** HOLE CARDS ***
sapr.549: folds 
Impostore1988: folds 
Fifilaplum: raises $0.15 to $0.25
Indangeriam: folds 
joaogiordano: folds 
Acedan1369: calls $0.15
*** FLOP *** [2s 9h Ah]
Acedan1369: bets $0.40
Fifilaplum: folds 
Uncalled bet ($0.40) returned to Acedan1369
Acedan1369 collected $0.53 from pot
Acedan1369: doesn't show hand 
*** SUMMARY ***
Total pot $0.55 | Rake $0.02 
Board [2s 9h Ah]
Seat 1: sapr.549 folded before Flop (didn't bet)
Seat 2: Impostore1988 folded before Flop (didn't bet)
Seat 3: Fifilaplum folded on the Flop
Seat 4: Indangeriam (button) folded before Flop (didn't bet)
Seat 5: joaogiordano (small blind) folded before Flop
Seat 6: Acedan1369 (big blind) collected ($0.53)



PokerStars Hand #222964672658:  Hold'em No Limit ($0.05/$0.10 USD) - 2021/01/23 13:49:13 ET
Table 'Malzovia' 6-max Seat #5 is the button
Seat 1: sapr.549 ($13.10 in chips) 
Seat 2: Impostore1988 ($9.82 in chips) 
Seat 3: Fifilaplum ($11.57 in chips) 
Seat 4: Indangeriam ($10 in chips) 
Seat 5: joaogiordano ($8.69 in chips) 
Seat 6: Acedan1369 ($24.82 in chips) 
Acedan1369: posts small blind $0.05
sapr.549: posts big blind $0.10
*** HOLE CARDS ***
Impostore1988: raises $0.20 to $0.30
Fifilaplum: folds 
Indangeriam: folds 
joaogiordano: folds 
Acedan1369: folds 
sapr.549: folds 
Uncalled bet ($0.20) returned to Impostore1988
Impostore1988 collected $0.25 from pot
Impostore1988: doesn't show hand 
*** SUMMARY ***
Total pot $0.25 | Rake $0 
Seat 1: sapr.549 (big blind) folded before Flop
Seat 2: Impostore1988 collected ($0.25)
Seat 3: Fifilaplum folded before Flop (didn't bet)
Seat 4: Indangeriam folded before Flop (didn't bet)
Seat 5: joaogiordano (button) folded before Flop (didn't bet)
Seat 6: Acedan1369 (small blind) folded before Flop



PokerStars Hand #222964685093:  Hold'em No Limit ($0.05/$0.10 USD) - 2021/01/23 13:49:30 ET
Table 'Malzovia' 6-max Seat #6 is the button
Seat 1: sapr.549 ($13 in chips) 
Seat 2: Impostore1988 ($9.97 in chips) 
Seat 3: Fifilaplum ($11.57 in chips) 
Seat 4: Indangeriam ($10 in chips) 
Seat 5: joaogiordano ($8.69 in chips) 
Seat 6: Acedan1369 ($24.77 in chips) 
sapr.549: posts small blind $0.05
Impostore1988: posts big blind $0.10
*** HOLE CARDS ***
Fifilaplum: folds 
Indangeriam: folds 
joaogiordano: calls $0.10
Acedan1369: folds 
sapr.549: raises $0.26 to $0.36
Impostore1988: folds 
joaogiordano: calls $0.26
*** FLOP *** [Jc Kc 3d]
sapr.549: checks 
joaogiordano: checks 
*** TURN *** [Jc Kc 3d] [Ah]
sapr.549: bets $0.32
joaogiordano: calls $0.32
*** RIVER *** [Jc Kc 3d Ah] [Jd]
sapr.549: checks 
joaogiordano: bets $0.40
sapr.549: raises $0.91 to $1.31
joaogiordano: raises $0.91 to $2.22
sapr.549: calls $0.91
*** SHOW DOWN ***
joaogiordano: shows [3s 3c] (a full house, Threes full of Jacks)
sapr.549: mucks hand 
joaogiordano collected $5.63 from pot
*** SUMMARY ***
Total pot $5.90 | Rake $0.27 
Board [Jc Kc 3d Ah Jd]
Seat 1: sapr.549 (small blind) mucked
Seat 2: Impostore1988 (big blind) folded before Flop
Seat 3: Fifilaplum folded before Flop (didn't bet)
Seat 4: Indangeriam folded before Flop (didn't bet)
Seat 5: joaogiordano showed [3s 3c] and won ($5.63) with a full house, Threes full of Jacks
Seat 6: Acedan1369 (button) folded before Flop (didn't bet)



PokerStars Hand #222964717616:  Hold'em No Limit ($0.05/$0.10 USD) - 2021/01/23 13:50:12 ET
Table 'Malzovia' 6-max Seat #1 is the button
Seat 1: sapr.549 ($10.10 in chips) 
Seat 2: Impostore1988 ($9.87 in chips) 
Seat 3: Fifilaplum ($11.57 in chips) 
Seat 4: Indangeriam ($10 in chips) 
Seat 5: joaogiordano ($11.42 in chips) 
Seat 6: Acedan1369 ($24.77 in chips) 
Impostore1988: posts small blind $0.05
Fifilaplum: posts big blind $0.10
*** HOLE CARDS ***
Indangeriam: folds 
joaogiordano: folds 
Acedan1369: folds 
sapr.549: folds 
Impostore1988: folds 
Uncalled bet ($0.05) returned to Fifilaplum
Fifilaplum collected $0.10 from pot
Fifilaplum: doesn't show hand 
*** SUMMARY ***
Total pot $0.10 | Rake $0 
Seat 1: sapr.549 (button) folded before Flop (didn't bet)
Seat 2: Impostore1988 (small blind) folded before Flop
Seat 3: Fifilaplum (big blind) collected ($0.10)
Seat 4: Indangeriam folded before Flop (didn't bet)
Seat 5: joaogiordano folded before Flop (didn't bet)
Seat 6: Acedan1369 folded before Flop (didn't bet)



PokerStars Hand #222964730087:  Hold'em No Limit ($0.05/$0.10 USD) - 2021/01/23 13:50:29 ET
Table 'Malzovia' 6-max Seat #2 is the button
Seat 1: sapr.549 ($10.10 in chips) 
Seat 2: Impostore1988 ($9.82 in chips) 
Seat 3: Fifilaplum ($11.62 in chips) 
Seat 4: Indangeriam ($10 in chips) 
Seat 5: joaogiordano ($11.42 in chips) 
Seat 6: Acedan1369 ($24.77 in chips) 
Fifilaplum: posts small blind $0.05
Indangeriam: posts big blind $0.10
*** HOLE CARDS ***
joaogiordano: calls $0.10
Acedan1369: folds 
sapr.549: folds 
Impostore1988: raises $0.60 to $0.70
Fifilaplum: folds 
Indangeriam: folds 
joaogiordano: calls $0.60
*** FLOP *** [7s Ks 9d]
joaogiordano: checks 
Impostore1988: bets $0.74
joaogiordano: folds 
Uncalled bet ($0.74) returned to Impostore1988
Impostore1988 collected $1.48 from pot
Impostore1988: doesn't show hand 
*** SUMMARY ***
Total pot $1.55 | Rake $0.07 
Board [7s Ks 9d]
Seat 1: sapr.549 folded before Flop (didn't bet)
Seat 2: Impostore1988 (button) collected ($1.48)
Seat 3: Fifilaplum (small blind) folded before Flop
Seat 4: Indangeriam (big blind) folded before Flop
Seat 5: joaogiordano folded on the Flop
Seat 6: Acedan1369 folded before Flop (didn't bet)



PokerStars Hand #222964762127:  Hold'em No Limit ($0.05/$0.10 USD) - 2021/01/23 13:51:10 ET
Table 'Malzovia' 6-max Seat #3 is the button
Seat 1: sapr.549 ($10.10 in chips) 
Seat 2: Impostore1988 ($10.60 in chips) 
Seat 3: Fifilaplum ($11.57 in chips) 
Seat 4: Indangeriam ($10 in chips) 
Seat 5: joaogiordano ($10.72 in chips) 
Seat 6: Acedan1369 ($24.77 in chips) 
Indangeriam: posts small blind $0.05
joaogiordano: posts big blind $0.10
*** HOLE CARDS ***
Acedan1369: folds 
sapr.549: folds 
Impostore1988: raises $0.10 to $0.20
Fifilaplum: folds 
Indangeriam: folds 
joaogiordano: folds 
Uncalled bet ($0.10) returned to Impostore1988
Impostore1988 collected $0.25 from pot
Impostore1988: doesn't show hand 
*** SUMMARY ***
Total pot $0.25 | Rake $0 
Seat 1: sapr.549 folded before Flop (didn't bet)
Seat 2: Impostore1988 collected ($0.25)
Seat 3: Fifilaplum (button) folded before Flop (didn't bet)
Seat 4: Indangeriam (small blind) folded before Flop
Seat 5: joaogiordano (big blind) folded before Flop
Seat 6: Acedan1369 folded before Flop (didn't bet)



PokerStars Hand #222964770001:  Hold'em No Limit ($0.05/$0.10 USD) - 2021/01/23 13:51:21 ET
Table 'Malzovia' 6-max Seat #4 is the button
Seat 1: sapr.549 ($10.10 in chips) 
Seat 2: Impostore1988 ($10.75 in chips) 
Seat 4: Indangeriam ($10 in chips) 
Seat 5: joaogiordano ($10.62 in chips) 
Seat 6: Acedan1369 ($24.77 in chips) 
joaogiordano: posts small blind $0.05
Acedan1369: posts big blind $0.10
*** HOLE CARDS ***
sapr.549: folds 
Impostore1988: raises $0.20 to $0.30
Indangeriam: folds 
joaogiordano: folds 
Acedan1369: folds 
Uncalled bet ($0.20) returned to Impostore1988
Impostore1988 collected $0.25 from pot
Impostore1988: doesn't show hand 
*** SUMMARY ***
Total pot $0.25 | Rake $0 
Seat 1: sapr.549 folded before Flop (didn't bet)
Seat 2: Impostore1988 collected ($0.25)
Seat 4: Indangeriam (button) folded before Flop (didn't bet)
Seat 5: joaogiordano (small blind) folded before Flop
Seat 6: Acedan1369 (big blind) folded before Flop



PokerStars Hand #222964784772:  Hold'em No Limit ($0.05/$0.10 USD) - 2021/01/23 13:51:40 ET
Table 'Malzovia' 6-max Seat #5 is the button
Seat 1: sapr.549 ($10.10 in chips) 
Seat 2: Impostore1988 ($10.90 in chips) 
Seat 4: Indangeriam ($10 in chips) 
Seat 5: joaogiordano ($10.57 in chips) 
Seat 6: Acedan1369 ($24.67 in chips) 
Acedan1369: posts small blind $0.05
sapr.549: posts big blind $0.10
*** HOLE CARDS ***
Impostore1988: folds 
Indangeriam: raises $0.20 to $0.30
joaogiordano: folds 
Acedan1369: folds 
sapr.549: calls $0.20
*** FLOP *** [4d 7h Qc]
sapr.549: checks 
Indangeriam: bets $0.50
sapr.549: folds 
Uncalled bet ($0.50) returned to Indangeriam
Indangeriam collected $0.62 from pot
Indangeriam: doesn't show hand 
*** SUMMARY ***
Total pot $0.65 | Rake $0.03 
Board [4d 7h Qc]
Seat 1: sapr.549 (big blind) folded on the Flop
Seat 2: Impostore1988 folded before Flop (didn't bet)
Seat 4: Indangeriam collected ($0.62)
Seat 5: joaogiordano (button) folded before Flop (didn't bet)
Seat 6: Acedan1369 (small blind) folded before Flop



PokerStars Hand #222964806906:  Hold'em No Limit ($0.05/$0.10 USD) - 2021/01/23 13:52:09 ET
Table 'Malzovia' 6-max Seat #6 is the button
Seat 1: sapr.549 ($9.80 in chips) 
Seat 2: Impostore1988 ($10.90 in chips) 
Seat 4: Indangeriam ($10.32 in chips) 
Seat 5: joaogiordano ($10.57 in chips) 
Seat 6: Acedan1369 ($24.62 in chips) 
sapr.549: posts small blind $0.05
Impostore1988: posts big blind $0.10
*** HOLE CARDS ***
Fifilaplum leaves the table
Indangeriam: folds 
joaogiordano: folds 
Acedan1369: folds 
sapr.549: folds 
Uncalled bet ($0.05) returned to Impostore1988
Impostore1988 collected $0.10 from pot
Impostore1988: doesn't show hand 
*** SUMMARY ***
Total pot $0.10 | Rake $0 
Seat 1: sapr.549 (small blind) folded before Flop
Seat 2: Impostore1988 (big blind) collected ($0.10)
Seat 4: Indangeriam folded before Flop (didn't bet)
Seat 5: joaogiordano folded before Flop (didn't bet)
Seat 6: Acedan1369 (button) folded before Flop (didn't bet)



PokerStars Hand #222964818850:  Hold'em No Limit ($0.05/$0.10 USD) - 2021/01/23 13:52:25 ET
Table 'Malzovia' 6-max Seat #1 is the button
Seat 1: sapr.549 ($9.75 in chips) 
Seat 2: Impostore1988 ($10.95 in chips) 
Seat 4: Indangeriam ($10.32 in chips) 
Seat 5: joaogiordano ($10.57 in chips) 
Seat 6: Acedan1369 ($24.62 in chips) 
Impostore1988: posts small blind $0.05
Indangeriam: posts big blind $0.10
*** HOLE CARDS ***
joaogiordano: folds 
Acedan1369: folds 
sapr.549: folds 
Impostore1988: folds 
Uncalled bet ($0.05) returned to Indangeriam
Indangeriam collected $0.10 from pot
Indangeriam: doesn't show hand 
*** SUMMARY ***
Total pot $0.10 | Rake $0 
Seat 1: sapr.549 (button) folded before Flop (didn't bet)
Seat 2: Impostore1988 (small blind) folded before Flop
Seat 4: Indangeriam (big blind) collected ($0.10)
Seat 5: joaogiordano folded before Flop (didn't bet)
Seat 6: Acedan1369 folded before Flop (didn't bet)



PokerStars Hand #222964824509:  Hold'em No Limit ($0.05/$0.10 USD) - 2021/01/23 13:52:32 ET
Table 'Malzovia' 6-max Seat #2 is the button
Seat 1: sapr.549 ($9.75 in chips) 
Seat 2: Impostore1988 ($10.90 in chips) 
Seat 4: Indangeriam ($10.37 in chips) 
Seat 5: joaogiordano ($10.57 in chips) 
Seat 6: Acedan1369 ($24.62 in chips) 
Indangeriam: posts small blind $0.05
joaogiordano: posts big blind $0.10
*** HOLE CARDS ***
Acedan1369: raises $0.15 to $0.25
sapr.549: folds 
Impostore1988: folds 
Indangeriam: folds 
joaogiordano: folds 
Uncalled bet ($0.15) returned to Acedan1369
Acedan1369 collected $0.25 from pot
Acedan1369: doesn't show hand 
*** SUMMARY ***
Total pot $0.25 | Rake $0 
Seat 1: sapr.549 folded before Flop (didn't bet)
Seat 2: Impostore1988 (button) folded before Flop (didn't bet)
Seat 4: Indangeriam (small blind) folded before Flop
Seat 5: joaogiordano (big blind) folded before Flop
Seat 6: Acedan1369 collected ($0.25)



PokerStars Hand #222964833294:  Hold'em No Limit ($0.05/$0.10 USD) - 2021/01/23 13:52:44 ET
Table 'Malzovia' 6-max Seat #4 is the button
Seat 1: sapr.549 ($9.75 in chips) 
Seat 2: Impostore1988 ($10.90 in chips) 
Seat 4: Indangeriam ($10.32 in chips) 
Seat 5: joaogiordano ($10.47 in chips) 
Seat 6: Acedan1369 ($24.77 in chips) 
joaogiordano: posts small blind $0.05
Acedan1369: posts big blind $0.10
*** HOLE CARDS ***
sapr.549: folds 
Impostore1988: folds 
Indangeriam: raises $0.20 to $0.30
joaogiordano: folds 
Acedan1369: calls $0.20
*** FLOP *** [Tc 4c 2s]
Acedan1369: checks 
Indangeriam: bets $0.40
Acedan1369: raises $0.80 to $1.20
meteor9867 joins the table at seat #3 
Indangeriam: folds 
Uncalled bet ($0.80) returned to Acedan1369
Acedan1369 collected $1.38 from pot
Acedan1369: doesn't show hand 
*** SUMMARY ***
Total pot $1.45 | Rake $0.07 
Board [Tc 4c 2s]
Seat 1: sapr.549 folded before Flop (didn't bet)
Seat 2: Impostore1988 folded before Flop (didn't bet)
Seat 4: Indangeriam (button) folded on the Flop
Seat 5: joaogiordano (small blind) folded before Flop
Seat 6: Acedan1369 (big blind) collected ($1.38)



PokerStars Hand #222964856634:  Hold'em No Limit ($0.05/$0.10 USD) - 2021/01/23 13:53:14 ET
Table 'Malzovia' 6-max Seat #5 is the button
Seat 1: sapr.549 ($9.75 in chips) 
Seat 2: Impostore1988 ($10.90 in chips) 
Seat 4: Indangeriam ($10 in chips) 
Seat 5: joaogiordano ($10.42 in chips) 
Seat 6: Acedan1369 ($25.45 in chips) 
Acedan1369: posts small blind $0.05
sapr.549: posts big blind $0.10
meteor9867: sits out 
*** HOLE CARDS ***
Impostore1988: folds 
Indangeriam: raises $0.20 to $0.30
joaogiordano: folds 
Acedan1369: folds 
sapr.549: folds 
Uncalled bet ($0.20) returned to Indangeriam
Indangeriam collected $0.25 from pot
Indangeriam: doesn't show hand 
*** SUMMARY ***
Total pot $0.25 | Rake $0 
Seat 1: sapr.549 (big blind) folded before Flop
Seat 2: Impostore1988 folded before Flop (didn't bet)
Seat 4: Indangeriam collected ($0.25)
Seat 5: joaogiordano (button) folded before Flop (didn't bet)
Seat 6: Acedan1369 (small blind) folded before Flop



PokerStars Hand #222964868297:  Hold'em No Limit ($0.05/$0.10 USD) - 2021/01/23 13:53:30 ET
Table 'Malzovia' 6-max Seat #6 is the button
Seat 1: sapr.549 ($9.65 in chips) 
Seat 2: Impostore1988 ($10.90 in chips) 
Seat 4: Indangeriam ($10.15 in chips) 
Seat 5: joaogiordano ($10.42 in chips) 
Seat 6: Acedan1369 ($25.40 in chips) 
sapr.549: posts small blind $0.05
Impostore1988: posts big blind $0.10
meteor9867: sits out 
*** HOLE CARDS ***
Indangeriam: folds 
joaogiordano: folds 
Acedan1369: folds 
sapr.549: folds 
Uncalled bet ($0.05) returned to Impostore1988
Impostore1988 collected $0.10 from pot
Impostore1988: doesn't show hand 
*** SUMMARY ***
Total pot $0.10 | Rake $0 
Seat 1: sapr.549 (small blind) folded before Flop
Seat 2: Impostore1988 (big blind) collected ($0.10)
Seat 4: Indangeriam folded before Flop (didn't bet)
Seat 5: joaogiordano folded before Flop (didn't bet)
Seat 6: Acedan1369 (button) folded before Flop (didn't bet)



PokerStars Hand #222964875432:  Hold'em No Limit ($0.05/$0.10 USD) - 2021/01/23 13:53:39 ET
Table 'Malzovia' 6-max Seat #1 is the button
Seat 1: sapr.549 ($9.60 in chips) 
Seat 2: Impostore1988 ($10.95 in chips) 
Seat 3: meteor9867 ($10 in chips) 
Seat 4: Indangeriam ($10.15 in chips) 
Seat 5: joaogiordano ($10.42 in chips) 
Seat 6: Acedan1369 ($25.40 in chips) 
Impostore1988: posts small blind $0.05
meteor9867: posts big blind $0.10
*** HOLE CARDS ***
Indangeriam: calls $0.10
joaogiordano: raises $0.10 to $0.20
Acedan1369: folds 
sapr.549: calls $0.20
Impostore1988: folds 
meteor9867: folds 
Indangeriam: calls $0.10
*** FLOP *** [8c 9s 8h]
Indangeriam: checks 
joaogiordano: checks 
sapr.549: checks 
*** TURN *** [8c 9s 8h] [Jd]
Indangeriam: checks 
joaogiordano: checks 
sapr.549: checks 
*** RIVER *** [8c 9s 8h Jd] [Tc]
Indangeriam: checks 
joaogiordano: bets $0.40
sapr.549: folds 
Indangeriam: folds 
Uncalled bet ($0.40) returned to joaogiordano
joaogiordano collected $0.72 from pot
joaogiordano: doesn't show hand 
*** SUMMARY ***
Total pot $0.75 | Rake $0.03 
Board [8c 9s 8h Jd Tc]
Seat 1: sapr.549 (button) folded on the River
Seat 2: Impostore1988 (small blind) folded before Flop
Seat 3: meteor9867 (big blind) folded before Flop
Seat 4: Indangeriam folded on the River
Seat 5: joaogiordano collected ($0.72)
Seat 6: Acedan1369 folded before Flop (didn't bet)



PokerStars Hand #222964911853:  Hold'em No Limit ($0.05/$0.10 USD) - 2021/01/23 13:54:27 ET
Table 'Malzovia' 6-max Seat #2 is the button
Seat 1: sapr.549 ($9.40 in chips) 
Seat 2: Impostore1988 ($10.90 in chips) 
Seat 3: meteor9867 ($10 in chips) 
Seat 4: Indangeriam ($10 in chips) 
Seat 5: joaogiordano ($10.94 in chips) 
Seat 6: Acedan1369 ($25.40 in chips) 
meteor9867: posts small blind $0.05
Indangeriam: posts big blind $0.10
*** HOLE CARDS ***
joaogiordano: folds 
Acedan1369: folds 
sapr.549: folds 
Impostore1988: folds 
meteor9867: raises $0.15 to $0.25
Indangeriam: folds 
Uncalled bet ($0.15) returned to meteor9867
meteor9867 collected $0.20 from pot
meteor9867: doesn't show hand 
*** SUMMARY ***
Total pot $0.20 | Rake $0 
Seat 1: sapr.549 folded before Flop (didn't bet)
Seat 2: Impostore1988 (button) folded before Flop (didn't bet)
Seat 3: meteor9867 (small blind) collected ($0.20)
Seat 4: Indangeriam (big blind) folded before Flop
Seat 5: joaogiordano folded before Flop (didn't bet)
Seat 6: Acedan1369 folded before Flop (didn't bet)



PokerStars Hand #222964921519:  Hold'em No Limit ($0.05/$0.10 USD) - 2021/01/23 13:54:40 ET
Table 'Malzovia' 6-max Seat #3 is the button
Seat 1: sapr.549 ($9.40 in chips) 
Seat 2: Impostore1988 ($10.90 in chips) 
Seat 3: meteor9867 ($10.10 in chips) 
Seat 4: Indangeriam ($10 in chips) 
Seat 5: joaogiordano ($10.94 in chips) 
Seat 6: Acedan1369 ($25.40 in chips) 
Indangeriam: posts small blind $0.05
joaogiordano: posts big blind $0.10
*** HOLE CARDS ***
Acedan1369: folds 
sapr.549: folds 
Impostore1988: raises $0.20 to $0.30
meteor9867: folds 
Indangeriam: folds 
joaogiordano: calls $0.20
*** FLOP *** [6c 4s Qh]
joaogiordano: checks 
Impostore1988: bets $0.62
joaogiordano: calls $0.62
*** TURN *** [6c 4s Qh] [4h]
joaogiordano: checks 
Impostore1988: bets $1.50
joaogiordano: calls $1.50
*** RIVER *** [6c 4s Qh 4h] [4d]
joaogiordano: bets $2
Impostore1988: raises $6.48 to $8.48 and is all-in
joaogiordano: calls $6.48
*** SHOW DOWN ***
Impostore1988: shows [Kd Kh] (a full house, Fours full of Kings)
joaogiordano: shows [7c 4c] (four of a kind, Fours)
joaogiordano collected $20.87 from pot
*** SUMMARY ***
Total pot $21.85 | Rake $0.98 
Board [6c 4s Qh 4h 4d]
Seat 1: sapr.549 folded before Flop (didn't bet)
Seat 2: Impostore1988 showed [Kd Kh] and lost with a full house, Fours full of Kings
Seat 3: meteor9867 (button) folded before Flop (didn't bet)
Seat 4: Indangeriam (small blind) folded before Flop
Seat 5: joaogiordano (big blind) showed [7c 4c] and won ($20.87) with four of a kind, Fours
Seat 6: Acedan1369 folded before Flop (didn't bet)



PokerStars Hand #222964965559:  Hold'em No Limit ($0.05/$0.10 USD) - 2021/01/23 13:55:56 ET
Table 'Malzovia' 6-max Seat #4 is the button
Seat 1: sapr.549 ($9.40 in chips) 
Seat 2: Impostore1988 ($10 in chips) 
Seat 3: meteor9867 ($10.10 in chips) 
Seat 4: Indangeriam ($10 in chips) 
Seat 5: joaogiordano ($20.91 in chips) 
Seat 6: Acedan1369 ($25.40 in chips) 
joaogiordano: posts small blind $0.05
Acedan1369: posts big blind $0.10
*** HOLE CARDS ***
sapr.549: folds 
Impostore1988: folds 
meteor9867: folds 
Indangeriam: folds 
joaogiordano: calls $0.05
Acedan1369: checks 
*** FLOP *** [Js Kd Jc]
joaogiordano: checks 
Acedan1369: checks 
*** TURN *** [Js Kd Jc] [6h]
joaogiordano: bets $0.50
Acedan1369: folds 
Uncalled bet ($0.50) returned to joaogiordano
joaogiordano collected $0.19 from pot
joaogiordano: doesn't show hand 
*** SUMMARY ***
Total pot $0.20 | Rake $0.01 
Board [Js Kd Jc 6h]
Seat 1: sapr.549 folded before Flop (didn't bet)
Seat 2: Impostore1988 folded before Flop (didn't bet)
Seat 3: meteor9867 folded before Flop (didn't bet)
Seat 4: Indangeriam (button) folded before Flop (didn't bet)
Seat 5: joaogiordano (small blind) collected ($0.19)
Seat 6: Acedan1369 (big blind) folded on the Turn



PokerStars Hand #222964986342:  Hold'em No Limit ($0.05/$0.10 USD) - 2021/01/23 13:56:39 ET
Table 'Malzovia' 6-max Seat #5 is the button
Seat 1: sapr.549 ($9.40 in chips) 
Seat 2: Impostore1988 ($10 in chips) 
Seat 3: meteor9867 ($10.10 in chips) 
Seat 4: Indangeriam ($10 in chips) 
Seat 5: joaogiordano ($21 in chips) 
Seat 6: Acedan1369 ($25.30 in chips) 
Acedan1369: posts small blind $0.05
sapr.549: posts big blind $0.10
*** HOLE CARDS ***
Impostore1988: folds 
meteor9867: folds 
Indangeriam: folds 
joaogiordano: folds 
Acedan1369: raises $0.15 to $0.25
sapr.549: raises $0.68 to $0.93
Acedan1369: calls $0.68
*** FLOP *** [7s Kc Kd]
Acedan1369: checks 
joaogiordano leaves the table
sapr.549: checks 
*** TURN *** [7s Kc Kd] [Kh]
Acedan1369: bets $0.30
sapr.549: folds 
Uncalled bet ($0.30) returned to Acedan1369
Acedan1369 collected $1.78 from pot
Acedan1369: doesn't show hand 
*** SUMMARY ***
Total pot $1.86 | Rake $0.08 
Board [7s Kc Kd Kh]
Seat 1: sapr.549 (big blind) folded on the Turn
Seat 2: Impostore1988 folded before Flop (didn't bet)
Seat 3: meteor9867 folded before Flop (didn't bet)
Seat 4: Indangeriam folded before Flop (didn't bet)
Seat 5: joaogiordano (button) folded before Flop (didn't bet)
Seat 6: Acedan1369 (small blind) collected ($1.78)



PokerStars Hand #222965004432:  Hold'em No Limit ($0.05/$0.10 USD) - 2021/01/23 13:57:16 ET
Table 'Malzovia' 6-max Seat #6 is the button
Seat 1: sapr.549 ($8.47 in chips) 
Seat 2: Impostore1988 ($10 in chips) 
Seat 3: meteor9867 ($10.10 in chips) 
Seat 4: Indangeriam ($10 in chips) 
Seat 6: Acedan1369 ($26.15 in chips) 
sapr.549: posts small blind $0.05
Impostore1988: posts big blind $0.10
*** HOLE CARDS ***
meteor9867: folds 
Indangeriam: folds 
M0rganLeFaye joins the table at seat #5 
Acedan1369: folds 
sapr.549: raises $0.15 to $0.25
Impostore1988: calls $0.15
*** FLOP *** [6d 8d 9h]
sapr.549: checks 
Impostore1988: checks 
*** TURN *** [6d 8d 9h] [4h]
sapr.549: bets $0.20
Impostore1988: calls $0.20
*** RIVER *** [6d 8d 9h 4h] [Js]
sapr.549: bets $0.57
Impostore1988: raises $2.93 to $3.50
sapr.549: folds 
Uncalled bet ($2.93) returned to Impostore1988
Impostore1988 collected $1.95 from pot
Impostore1988: doesn't show hand 
*** SUMMARY ***
Total pot $2.04 | Rake $0.09 
Board [6d 8d 9h 4h Js]
Seat 1: sapr.549 (small blind) folded on the River
Seat 2: Impostore1988 (big blind) collected ($1.95)
Seat 3: meteor9867 folded before Flop (didn't bet)
Seat 4: Indangeriam folded before Flop (didn't bet)
Seat 6: Acedan1369 (button) folded before Flop (didn't bet)



PokerStars Hand #222965025527:  Hold'em No Limit ($0.05/$0.10 USD) - 2021/01/23 13:57:59 ET
Table 'Malzovia' 6-max Seat #1 is the button
Seat 1: sapr.549 ($7.45 in chips) 
Seat 2: Impostore1988 ($10.93 in chips) 
Seat 3: meteor9867 ($10.10 in chips) 
Seat 4: Indangeriam ($10 in chips) 
Seat 6: Acedan1369 ($26.15 in chips) 
Impostore1988: posts small blind $0.05
meteor9867: posts big blind $0.10
M0rganLeFaye: sits out 
*** HOLE CARDS ***
Indangeriam: raises $0.20 to $0.30
Acedan1369: raises $0.55 to $0.85
sapr.549: folds 
Impostore1988: folds 
meteor9867: folds 
Indangeriam: calls $0.55
*** FLOP *** [Jd 5s Th]
Indangeriam: checks 
Acedan1369: bets $0.80
Indangeriam: raises $1.20 to $2
Acedan1369: raises $23.30 to $25.30 and is all-in
Indangeriam: folds 
Uncalled bet ($23.30) returned to Acedan1369
Acedan1369 collected $5.59 from pot
Acedan1369: doesn't show hand 
*** SUMMARY ***
Total pot $5.85 | Rake $0.26 
Board [Jd 5s Th]
Seat 1: sapr.549 (button) folded before Flop (didn't bet)
Seat 2: Impostore1988 (small blind) folded before Flop
Seat 3: meteor9867 (big blind) folded before Flop
Seat 4: Indangeriam folded on the Flop
Seat 6: Acedan1369 collected ($5.59)



PokerStars Hand #222965051397:  Hold'em No Limit ($0.05/$0.10 USD) - 2021/01/23 13:58:52 ET
Table 'Malzovia' 6-max Seat #2 is the button
Seat 1: sapr.549 ($7.45 in chips) 
Seat 2: Impostore1988 ($10.88 in chips) 
Seat 3: meteor9867 ($10 in chips) 
Seat 4: Indangeriam ($10 in chips) 
Seat 6: Acedan1369 ($28.89 in chips) 
meteor9867: posts small blind $0.05
Indangeriam: posts big blind $0.10
M0rganLeFaye: sits out 
*** HOLE CARDS ***
Acedan1369: folds 
sapr.549: folds 
Impostore1988: folds 
meteor9867: raises $0.15 to $0.25
Indangeriam: folds 
Uncalled bet ($0.15) returned to meteor9867
meteor9867 collected $0.20 from pot
meteor9867: doesn't show hand 
*** SUMMARY ***
Total pot $0.20 | Rake $0 
Seat 1: sapr.549 folded before Flop (didn't bet)
Seat 2: Impostore1988 (button) folded before Flop (didn't bet)
Seat 3: meteor9867 (small blind) collected ($0.20)
Seat 4: Indangeriam (big blind) folded before Flop
Seat 6: Acedan1369 folded before Flop (didn't bet)



PokerStars Hand #222965065198:  Hold'em No Limit ($0.05/$0.10 USD) - 2021/01/23 13:59:20 ET
Table 'Malzovia' 6-max Seat #3 is the button
Seat 1: sapr.549 ($7.45 in chips) 
Seat 2: Impostore1988 ($10.88 in chips) 
Seat 3: meteor9867 ($10.10 in chips) 
Seat 4: Indangeriam ($10 in chips) 
Seat 5: M0rganLeFaye ($10 in chips) 
Seat 6: Acedan1369 ($28.89 in chips) 
Indangeriam: posts small blind $0.05
M0rganLeFaye: posts big blind $0.10
*** HOLE CARDS ***
Acedan1369: folds 
sapr.549: raises $0.20 to $0.30
Impostore1988: folds 
meteor9867: folds 
Indangeriam: folds 
M0rganLeFaye: folds 
Uncalled bet ($0.20) returned to sapr.549
sapr.549 collected $0.25 from pot
sapr.549: doesn't show hand 
*** SUMMARY ***
Total pot $0.25 | Rake $0 
Seat 1: sapr.549 collected ($0.25)
Seat 2: Impostore1988 folded before Flop (didn't bet)
Seat 3: meteor9867 (button) folded before Flop (didn't bet)
Seat 4: Indangeriam (small blind) folded before Flop
Seat 5: M0rganLeFaye (big blind) folded before Flop
Seat 6: Acedan1369 folded before Flop (didn't bet)



PokerStars Hand #222965072710:  Hold'em No Limit ($0.05/$0.10 USD) - 2021/01/23 13:59:35 ET
Table 'Malzovia' 6-max Seat #4 is the button
Seat 1: sapr.549 ($7.60 in chips) 
Seat 2: Impostore1988 ($10.88 in chips) 
Seat 3: meteor9867 ($10.10 in chips) 
Seat 4: Indangeriam ($10 in chips) 
Seat 5: M0rganLeFaye ($9.90 in chips) 
Seat 6: Acedan1369 ($28.89 in chips) 
M0rganLeFaye: posts small blind $0.05
Acedan1369: posts big blind $0.10
*** HOLE CARDS ***
sapr.549: folds 
Impostore1988: folds 
meteor9867: raises $0.15 to $0.25
Indangeriam: folds 
M0rganLeFaye: folds 
Acedan1369: calls $0.15
*** FLOP *** [8d Qc 8c]
Acedan1369: checks 
meteor9867: bets $0.22
Acedan1369: calls $0.22
*** TURN *** [8d Qc 8c] [3s]
Acedan1369: checks 
meteor9867: bets $0.63
Acedan1369: calls $0.63
*** RIVER *** [8d Qc 8c 3s] [Qd]
Acedan1369: bets $1.61
meteor9867: folds 
Uncalled bet ($1.61) returned to Acedan1369
Acedan1369 collected $2.15 from pot
Acedan1369: doesn't show hand 
*** SUMMARY ***
Total pot $2.25 | Rake $0.10 
Board [8d Qc 8c 3s Qd]
Seat 1: sapr.549 folded before Flop (didn't bet)
Seat 2: Impostore1988 folded before Flop (didn't bet)
Seat 3: meteor9867 folded on the River
Seat 4: Indangeriam (button) folded before Flop (didn't bet)
Seat 5: M0rganLeFaye (small blind) folded before Flop
Seat 6: Acedan1369 (big blind) collected ($2.15)



PokerStars Hand #222965101575:  Hold'em No Limit ($0.05/$0.10 USD) - 2021/01/23 14:00:30 ET
Table 'Malzovia' 6-max Seat #5 is the button
Seat 1: sapr.549 ($7.60 in chips) 
Seat 2: Impostore1988 ($10.88 in chips) 
Seat 3: meteor9867 ($10 in chips) 
Seat 4: Indangeriam ($10 in chips) 
Seat 5: M0rganLeFaye ($9.85 in chips) 
Seat 6: Acedan1369 ($29.94 in chips) 
Acedan1369: posts small blind $0.05
sapr.549: posts big blind $0.10
*** HOLE CARDS ***
Impostore1988: folds 
meteor9867: folds 
Indangeriam: folds 
M0rganLeFaye: raises $0.15 to $0.25
Acedan1369: folds 
sapr.549: folds 
Uncalled bet ($0.15) returned to M0rganLeFaye
M0rganLeFaye collected $0.25 from pot
*** SUMMARY ***
Total pot $0.25 | Rake $0 
Seat 1: sapr.549 (big blind) folded before Flop
Seat 2: Impostore1988 folded before Flop (didn't bet)
Seat 3: meteor9867 folded before Flop (didn't bet)
Seat 4: Indangeriam folded before Flop (didn't bet)
Seat 5: M0rganLeFaye (button) collected ($0.25)
Seat 6: Acedan1369 (small blind) folded before Flop



PokerStars Hand #222965113642:  Hold'em No Limit ($0.05/$0.10 USD) - 2021/01/23 14:00:52 ET
Table 'Malzovia' 6-max Seat #6 is the button
Seat 1: sapr.549 ($7.50 in chips) 
Seat 2: Impostore1988 ($10.88 in chips) 
Seat 3: meteor9867 ($10 in chips) 
Seat 4: Indangeriam ($10 in chips) 
Seat 5: M0rganLeFaye ($10 in chips) 
Seat 6: Acedan1369 ($29.89 in chips) 
sapr.549: posts small blind $0.05
Impostore1988: posts big blind $0.10
*** HOLE CARDS ***
meteor9867: folds 
Indangeriam: folds 
M0rganLeFaye: folds 
Acedan1369: folds 
sapr.549: folds 
Uncalled bet ($0.05) returned to Impostore1988
Impostore1988 collected $0.10 from pot
Impostore1988: doesn't show hand 
*** SUMMARY ***
Total pot $0.10 | Rake $0 
Seat 1: sapr.549 (small blind) folded before Flop
Seat 2: Impostore1988 (big blind) collected ($0.10)
Seat 3: meteor9867 folded before Flop (didn't bet)
Seat 4: Indangeriam folded before Flop (didn't bet)
Seat 5: M0rganLeFaye folded before Flop (didn't bet)
Seat 6: Acedan1369 (button) folded before Flop (didn't bet)



PokerStars Hand #222965119680:  Hold'em No Limit ($0.05/$0.10 USD) - 2021/01/23 14:01:03 ET
Table 'Malzovia' 6-max Seat #1 is the button
Seat 1: sapr.549 ($7.45 in chips) 
Seat 2: Impostore1988 ($10.93 in chips) 
Seat 3: meteor9867 ($10 in chips) 
Seat 4: Indangeriam ($10 in chips) 
Seat 5: M0rganLeFaye ($10 in chips) 
Seat 6: Acedan1369 ($29.89 in chips) 
Impostore1988: posts small blind $0.05
meteor9867: posts big blind $0.10
*** HOLE CARDS ***
Indangeriam: raises $0.20 to $0.30
M0rganLeFaye: folds 
Acedan1369: folds 
sapr.549: folds 
Impostore1988: calls $0.25
meteor9867: folds 
*** FLOP *** [3c 6h Qs]
Impostore1988: bets $0.67
Indangeriam: folds 
Uncalled bet ($0.67) returned to Impostore1988
Impostore1988 collected $0.67 from pot
Impostore1988: doesn't show hand 
*** SUMMARY ***
Total pot $0.70 | Rake $0.03 
Board [3c 6h Qs]
Seat 1: sapr.549 (button) folded before Flop (didn't bet)
Seat 2: Impostore1988 (small blind) collected ($0.67)
Seat 3: meteor9867 (big blind) folded before Flop
Seat 4: Indangeriam folded on the Flop
Seat 5: M0rganLeFaye folded before Flop (didn't bet)
Seat 6: Acedan1369 folded before Flop (didn't bet)



PokerStars Hand #222965146362:  Hold'em No Limit ($0.05/$0.10 USD) - 2021/01/23 14:01:42 ET
Table 'Malzovia' 6-max Seat #2 is the button
Seat 1: sapr.549 ($7.45 in chips) 
Seat 2: Impostore1988 ($11.30 in chips) 
Seat 3: meteor9867 ($10 in chips) 
Seat 4: Indangeriam ($10 in chips) 
Seat 5: M0rganLeFaye ($10 in chips) 
Seat 6: Acedan1369 ($29.89 in chips) 
meteor9867: posts small blind $0.05
Indangeriam: posts big blind $0.10
*** HOLE CARDS ***
M0rganLeFaye: folds 
Acedan1369: folds 
sapr.549: folds 
Impostore1988: folds 
meteor9867: raises $0.15 to $0.25
Indangeriam: folds 
Uncalled bet ($0.15) returned to meteor9867
meteor9867 collected $0.20 from pot
meteor9867: doesn't show hand 
*** SUMMARY ***
Total pot $0.20 | Rake $0 
Seat 1: sapr.549 folded before Flop (didn't bet)
Seat 2: Impostore1988 (button) folded before Flop (didn't bet)
Seat 3: meteor9867 (small blind) collected ($0.20)
Seat 4: Indangeriam (big blind) folded before Flop
Seat 5: M0rganLeFaye folded before Flop (didn't bet)
Seat 6: Acedan1369 folded before Flop (didn't bet)



PokerStars Hand #222965160752:  Hold'em No Limit ($0.05/$0.10 USD) - 2021/01/23 14:02:01 ET
Table 'Malzovia' 6-max Seat #3 is the button
Seat 1: sapr.549 ($7.45 in chips) 
Seat 2: Impostore1988 ($11.30 in chips) 
Seat 3: meteor9867 ($10.10 in chips) 
Seat 4: Indangeriam ($10 in chips) 
Seat 5: M0rganLeFaye ($10 in chips) 
Seat 6: Acedan1369 ($29.89 in chips) 
Indangeriam: posts small blind $0.05
M0rganLeFaye: posts big blind $0.10
*** HOLE CARDS ***
Acedan1369: folds 
sapr.549: folds 
Impostore1988: folds 
meteor9867: folds 
Indangeriam: folds 
Uncalled bet ($0.05) returned to M0rganLeFaye
M0rganLeFaye collected $0.10 from pot
*** SUMMARY ***
Total pot $0.10 | Rake $0 
Seat 1: sapr.549 folded before Flop (didn't bet)
Seat 2: Impostore1988 folded before Flop (didn't bet)
Seat 3: meteor9867 (button) folded before Flop (didn't bet)
Seat 4: Indangeriam (small blind) folded before Flop
Seat 5: M0rganLeFaye (big blind) collected ($0.10)
Seat 6: Acedan1369 folded before Flop (didn't bet)



PokerStars Hand #222965170371:  Hold'em No Limit ($0.05/$0.10 USD) - 2021/01/23 14:02:14 ET
Table 'Malzovia' 6-max Seat #4 is the button
Seat 1: sapr.549 ($7.45 in chips) 
Seat 2: Impostore1988 ($11.30 in chips) 
Seat 3: meteor9867 ($10.10 in chips) 
Seat 4: Indangeriam ($10 in chips) 
Seat 5: M0rganLeFaye ($10.05 in chips) 
Seat 6: Acedan1369 ($29.89 in chips) 
M0rganLeFaye: posts small blind $0.05
Acedan1369: posts big blind $0.10
*** HOLE CARDS ***
sapr.549: raises $0.20 to $0.30
Impostore1988: folds 
meteor9867: folds 
Indangeriam: folds 
M0rganLeFaye: folds 
Acedan1369: calls $0.20
*** FLOP *** [Jc Ac 6d]
Acedan1369: checks 
sapr.549: checks 
*** TURN *** [Jc Ac 6d] [3s]
Acedan1369: checks 
sapr.549: checks 
*** RIVER *** [Jc Ac 6d 3s] [Kh]
Acedan1369: checks 
sapr.549: checks 
*** SHOW DOWN ***
Acedan1369: shows [Qd 8d] (high card Ace)
sapr.549: shows [7d 7s] (a pair of Sevens)
sapr.549 collected $0.62 from pot
*** SUMMARY ***
Total pot $0.65 | Rake $0.03 
Board [Jc Ac 6d 3s Kh]
Seat 1: sapr.549 showed [7d 7s] and won ($0.62) with a pair of Sevens
Seat 2: Impostore1988 folded before Flop (didn't bet)
Seat 3: meteor9867 folded before Flop (didn't bet)
Seat 4: Indangeriam (button) folded before Flop (didn't bet)
Seat 5: M0rganLeFaye (small blind) folded before Flop
Seat 6: Acedan1369 (big blind) showed [Qd 8d] and lost with high card Ace



PokerStars Hand #222965202597:  Hold'em No Limit ($0.05/$0.10 USD) - 2021/01/23 14:02:48 ET
Table 'Malzovia' 6-max Seat #5 is the button
Seat 1: sapr.549 ($7.77 in chips) 
Seat 2: Impostore1988 ($11.30 in chips) 
Seat 3: meteor9867 ($10.10 in chips) 
Seat 4: Indangeriam ($10 in chips) 
Seat 5: M0rganLeFaye ($10 in chips) 
Seat 6: Acedan1369 ($29.59 in chips) 
Acedan1369: posts small blind $0.05
sapr.549: posts big blind $0.10
*** HOLE CARDS ***
Impostore1988: raises $0.10 to $0.20
meteor9867: folds 
Indangeriam: folds 
M0rganLeFaye: folds 
Acedan1369: folds 
sapr.549: calls $0.10
*** FLOP *** [6h 2h 3h]
sapr.549: checks 
Impostore1988: checks 
*** TURN *** [6h 2h 3h] [6s]
sapr.549: checks 
Impostore1988: checks 
*** RIVER *** [6h 2h 3h 6s] [Kd]
sapr.549: checks 
Impostore1988: bets $0.22
sapr.549: folds 
Uncalled bet ($0.22) returned to Impostore1988
Impostore1988 collected $0.43 from pot
Impostore1988: doesn't show hand 
*** SUMMARY ***
Total pot $0.45 | Rake $0.02 
Board [6h 2h 3h 6s Kd]
Seat 1: sapr.549 (big blind) folded on the River
Seat 2: Impostore1988 collected ($0.43)
Seat 3: meteor9867 folded before Flop (didn't bet)
Seat 4: Indangeriam folded before Flop (didn't bet)
Seat 5: M0rganLeFaye (button) folded before Flop (didn't bet)
Seat 6: Acedan1369 (small blind) folded before Flop



PokerStars Hand #222965224593:  Hold'em No Limit ($0.05/$0.10 USD) - 2021/01/23 14:03:16 ET
Table 'Malzovia' 6-max Seat #6 is the button
Seat 1: sapr.549 ($7.57 in chips) 
Seat 2: Impostore1988 ($11.53 in chips) 
Seat 3: meteor9867 ($10.10 in chips) 
Seat 4: Indangeriam ($10 in chips) 
Seat 5: M0rganLeFaye ($10 in chips) 
Seat 6: Acedan1369 ($29.54 in chips) 
sapr.549: posts small blind $0.05
Impostore1988: posts big blind $0.10
*** HOLE CARDS ***
meteor9867: raises $0.15 to $0.25
Indangeriam: raises $0.85 to $1.10
M0rganLeFaye: folds 
Acedan1369: folds 
sapr.549: folds 
Impostore1988: folds 
meteor9867: folds 
Uncalled bet ($0.85) returned to Indangeriam
Indangeriam collected $0.65 from pot
Indangeriam: doesn't show hand 
*** SUMMARY ***
Total pot $0.65 | Rake $0 
Seat 1: sapr.549 (small blind) folded before Flop
Seat 2: Impostore1988 (big blind) folded before Flop
Seat 3: meteor9867 folded before Flop
Seat 4: Indangeriam collected ($0.65)
Seat 5: M0rganLeFaye folded before Flop (didn't bet)
Seat 6: Acedan1369 (button) folded before Flop (didn't bet)



PokerStars Hand #222965243532:  Hold'em No Limit ($0.05/$0.10 USD) - 2021/01/23 14:03:40 ET
Table 'Malzovia' 6-max Seat #1 is the button
Seat 1: sapr.549 ($7.52 in chips) 
Seat 2: Impostore1988 ($11.43 in chips) 
Seat 3: meteor9867 ($10 in chips) 
Seat 4: Indangeriam ($10.40 in chips) 
Seat 5: M0rganLeFaye ($10 in chips) 
Seat 6: Acedan1369 ($29.54 in chips) 
Impostore1988: posts small blind $0.05
meteor9867: posts big blind $0.10
*** HOLE CARDS ***
Indangeriam: folds 
M0rganLeFaye: folds 
Acedan1369: folds 
sapr.549: folds 
Impostore1988: raises $0.20 to $0.30
meteor9867: folds 
Uncalled bet ($0.20) returned to Impostore1988
Impostore1988 collected $0.20 from pot
Impostore1988: doesn't show hand 
*** SUMMARY ***
Total pot $0.20 | Rake $0 
Seat 1: sapr.549 (button) folded before Flop (didn't bet)
Seat 2: Impostore1988 (small blind) collected ($0.20)
Seat 3: meteor9867 (big blind) folded before Flop
Seat 4: Indangeriam folded before Flop (didn't bet)
Seat 5: M0rganLeFaye folded before Flop (didn't bet)
Seat 6: Acedan1369 folded before Flop (didn't bet)



PokerStars Hand #222965257863:  Hold'em No Limit ($0.05/$0.10 USD) - 2021/01/23 14:03:59 ET
Table 'Malzovia' 6-max Seat #2 is the button
Seat 1: sapr.549 ($7.52 in chips) 
Seat 2: Impostore1988 ($11.53 in chips) 
Seat 3: meteor9867 ($10 in chips) 
Seat 4: Indangeriam ($10.40 in chips) 
Seat 5: M0rganLeFaye ($10 in chips) 
Seat 6: Acedan1369 ($29.54 in chips) 
meteor9867: posts small blind $0.05
Indangeriam: posts big blind $0.10
*** HOLE CARDS ***
M0rganLeFaye: folds 
Acedan1369: folds 
sapr.549: folds 
Impostore1988: folds 
meteor9867: folds 
Uncalled bet ($0.05) returned to Indangeriam
Indangeriam collected $0.10 from pot
Indangeriam: doesn't show hand 
*** SUMMARY ***
Total pot $0.10 | Rake $0 
Seat 1: sapr.549 folded before Flop (didn't bet)
Seat 2: Impostore1988 (button) folded before Flop (didn't bet)
Seat 3: meteor9867 (small blind) folded before Flop
Seat 4: Indangeriam (big blind) collected ($0.10)
Seat 5: M0rganLeFaye folded before Flop (didn't bet)
Seat 6: Acedan1369 folded before Flop (didn't bet)



PokerStars Hand #222965267604:  Hold'em No Limit ($0.05/$0.10 USD) - 2021/01/23 14:04:11 ET
Table 'Malzovia' 6-max Seat #3 is the button
Seat 1: sapr.549 ($7.52 in chips) 
Seat 2: Impostore1988 ($11.53 in chips) 
Seat 3: meteor9867 ($10 in chips) 
Seat 4: Indangeriam ($10.45 in chips) 
Seat 5: M0rganLeFaye ($10 in chips) 
Seat 6: Acedan1369 ($29.54 in chips) 
Indangeriam: posts small blind $0.05
M0rganLeFaye: posts big blind $0.10
*** HOLE CARDS ***
Acedan1369: folds 
sapr.549: folds 
Impostore1988: folds 
meteor9867: folds 
Indangeriam: folds 
Uncalled bet ($0.05) returned to M0rganLeFaye
M0rganLeFaye collected $0.10 from pot
*** SUMMARY ***
Total pot $0.10 | Rake $0 
Seat 1: sapr.549 folded before Flop (didn't bet)
Seat 2: Impostore1988 folded before Flop (didn't bet)
Seat 3: meteor9867 (button) folded before Flop (didn't bet)
Seat 4: Indangeriam (small blind) folded before Flop
Seat 5: M0rganLeFaye (big blind) collected ($0.10)
Seat 6: Acedan1369 folded before Flop (didn't bet)



PokerStars Hand #222965275916:  Hold'em No Limit ($0.05/$0.10 USD) - 2021/01/23 14:04:22 ET
Table 'Malzovia' 6-max Seat #4 is the button
Seat 1: sapr.549 ($7.52 in chips) 
Seat 2: Impostore1988 ($11.53 in chips) 
Seat 3: meteor9867 ($10 in chips) 
Seat 4: Indangeriam ($10.40 in chips) 
Seat 5: M0rganLeFaye ($10.05 in chips) 
Seat 6: Acedan1369 ($29.54 in chips) 
M0rganLeFaye: posts small blind $0.05
Acedan1369: posts big blind $0.10
*** HOLE CARDS ***
sapr.549: folds 
Impostore1988: folds 
meteor9867: folds 
Indangeriam: raises $0.20 to $0.30
M0rganLeFaye: folds 
Acedan1369: calls $0.20
*** FLOP *** [8h 8c Jd]
Acedan1369: checks 
Indangeriam: checks 
*** TURN *** [8h 8c Jd] [4s]
Acedan1369: bets $0.28
Indangeriam: folds 
Uncalled bet ($0.28) returned to Acedan1369
Acedan1369 collected $0.62 from pot
Acedan1369: doesn't show hand 
*** SUMMARY ***
Total pot $0.65 | Rake $0.03 
Board [8h 8c Jd 4s]
Seat 1: sapr.549 folded before Flop (didn't bet)
Seat 2: Impostore1988 folded before Flop (didn't bet)
Seat 3: meteor9867 folded before Flop (didn't bet)
Seat 4: Indangeriam (button) folded on the Turn
Seat 5: M0rganLeFaye (small blind) folded before Flop
Seat 6: Acedan1369 (big blind) collected ($0.62)



PokerStars Hand #222965297708:  Hold'em No Limit ($0.05/$0.10 USD) - 2021/01/23 14:04:49 ET
Table 'Malzovia' 6-max Seat #5 is the button
Seat 1: sapr.549 ($7.52 in chips) 
Seat 2: Impostore1988 ($11.53 in chips) 
Seat 3: meteor9867 ($10 in chips) 
Seat 4: Indangeriam ($10.10 in chips) 
Seat 5: M0rganLeFaye ($10 in chips) 
Seat 6: Acedan1369 ($29.86 in chips) 
Acedan1369: posts small blind $0.05
sapr.549: posts big blind $0.10
*** HOLE CARDS ***
Impostore1988: raises $0.20 to $0.30
meteor9867: folds 
Indangeriam: folds 
M0rganLeFaye: raises $0.70 to $1
Acedan1369: folds 
sapr.549: folds 
Impostore1988: raises $2.50 to $3.50
M0rganLeFaye: calls $2.50
*** FLOP *** [Ah 6h 4d]
Impostore1988: checks 
M0rganLeFaye: bets $6.50 and is all-in
Impostore1988: folds 
Uncalled bet ($6.50) returned to M0rganLeFaye
M0rganLeFaye collected $6.83 from pot
*** SUMMARY ***
Total pot $7.15 | Rake $0.32 
Board [Ah 6h 4d]
Seat 1: sapr.549 (big blind) folded before Flop
Seat 2: Impostore1988 folded on the Flop
Seat 3: meteor9867 folded before Flop (didn't bet)
Seat 4: Indangeriam folded before Flop (didn't bet)
Seat 5: M0rganLeFaye (button) collected ($6.83)
Seat 6: Acedan1369 (small blind) folded before Flop



PokerStars Hand #222965336245:  Hold'em No Limit ($0.05/$0.10 USD) - 2021/01/23 14:05:38 ET
Table 'Malzovia' 6-max Seat #6 is the button
Seat 1: sapr.549 ($7.42 in chips) 
Seat 2: Impostore1988 ($8.03 in chips) 
Seat 3: meteor9867 ($10 in chips) 
Seat 4: Indangeriam ($10.10 in chips) 
Seat 5: M0rganLeFaye ($13.33 in chips) 
Seat 6: Acedan1369 ($29.81 in chips) 
sapr.549: posts small blind $0.05
Impostore1988: posts big blind $0.10
*** HOLE CARDS ***
meteor9867: folds 
Indangeriam: folds 
M0rganLeFaye: folds 
Acedan1369: raises $0.15 to $0.25
sapr.549: folds 
Impostore1988: folds 
Uncalled bet ($0.15) returned to Acedan1369
Acedan1369 collected $0.25 from pot
Acedan1369: doesn't show hand 
*** SUMMARY ***
Total pot $0.25 | Rake $0 
Seat 1: sapr.549 (small blind) folded before Flop
Seat 2: Impostore1988 (big blind) folded before Flop
Seat 3: meteor9867 folded before Flop (didn't bet)
Seat 4: Indangeriam folded before Flop (didn't bet)
Seat 5: M0rganLeFaye folded before Flop (didn't bet)
Seat 6: Acedan1369 (button) collected ($0.25)



PokerStars Hand #222965345141:  Hold'em No Limit ($0.05/$0.10 USD) - 2021/01/23 14:05:49 ET
Table 'Malzovia' 6-max Seat #1 is the button
Seat 1: sapr.549 ($7.37 in chips) 
Seat 2: Impostore1988 ($9.90 in chips) 
Seat 4: Indangeriam ($10.10 in chips) 
Seat 5: M0rganLeFaye ($13.33 in chips) 
Seat 6: Acedan1369 ($29.96 in chips) 
Impostore1988: posts small blind $0.05
meteor9867: is sitting out 
Indangeriam: posts big blind $0.10
*** HOLE CARDS ***
meteor9867 leaves the table
M0rganLeFaye: folds 
Acedan1369: folds 
sapr.549: folds 
Impostore1988: folds 
Uncalled bet ($0.05) returned to Indangeriam
Indangeriam collected $0.10 from pot
Indangeriam: doesn't show hand 
*** SUMMARY ***
Total pot $0.10 | Rake $0 
Seat 1: sapr.549 (button) folded before Flop (didn't bet)
Seat 2: Impostore1988 (small blind) folded before Flop
Seat 4: Indangeriam (big blind) collected ($0.10)
Seat 5: M0rganLeFaye folded before Flop (didn't bet)
Seat 6: Acedan1369 folded before Flop (didn't bet)



PokerStars Hand #222965358030:  Hold'em No Limit ($0.05/$0.10 USD) - 2021/01/23 14:06:05 ET
Table 'Malzovia' 6-max Seat #2 is the button
Seat 1: sapr.549 ($7.37 in chips) 
Seat 2: Impostore1988 ($9.85 in chips) 
Seat 4: Indangeriam ($10.15 in chips) 
Seat 5: M0rganLeFaye ($13.33 in chips) 
Seat 6: Acedan1369 ($29.96 in chips) 
Indangeriam: posts small blind $0.05
M0rganLeFaye: posts big blind $0.10
*** HOLE CARDS ***
Acedan1369: folds 
sapr.549: folds 
hardouin joins the table at seat #3 
Impostore1988: raises $0.20 to $0.30
Indangeriam: folds 
M0rganLeFaye: calls $0.20
*** FLOP *** [5d 6s 2c]
M0rganLeFaye: checks 
Impostore1988: bets $0.62
M0rganLeFaye: calls $0.62
*** TURN *** [5d 6s 2c] [6c]
M0rganLeFaye: checks 
Impostore1988: bets $0.90
M0rganLeFaye: calls $0.90
*** RIVER *** [5d 6s 2c 6c] [4h]
Indangeriam leaves the table
M0rganLeFaye: checks 
Impostore1988: checks 
*** SHOW DOWN ***
M0rganLeFaye: shows [7d 7h] (two pair, Sevens and Sixes)
Impostore1988: shows [Jc Jh] (two pair, Jacks and Sixes)
Impostore1988 collected $3.52 from pot
*** SUMMARY ***
Total pot $3.69 | Rake $0.17 
Board [5d 6s 2c 6c 4h]
Seat 1: sapr.549 folded before Flop (didn't bet)
Seat 2: Impostore1988 (button) showed [Jc Jh] and won ($3.52) with two pair, Jacks and Sixes
Seat 4: Indangeriam (small blind) folded before Flop
Seat 5: M0rganLeFaye (big blind) showed [7d 7h] and lost with two pair, Sevens and Sixes
Seat 6: Acedan1369 folded before Flop (didn't bet)



PokerStars Hand #222965407350:  Hold'em No Limit ($0.05/$0.10 USD) - 2021/01/23 14:07:07 ET
Table 'Malzovia' 6-max Seat #5 is the button
Seat 1: sapr.549 ($7.37 in chips) 
Seat 2: Impostore1988 ($11.55 in chips) 
Seat 5: M0rganLeFaye ($11.51 in chips) 
Seat 6: Acedan1369 ($29.96 in chips) 
Acedan1369: posts small blind $0.05
sapr.549: posts big blind $0.10
hardouin: sits out 
*** HOLE CARDS ***
Impostore1988: folds 
ahmet_vs joins the table at seat #4 
M0rganLeFaye: raises $0.15 to $0.25
ahmet_vs leaves the table
Acedan1369: folds 
sapr.549: raises $0.72 to $0.97
M0rganLeFaye: calls $0.72
*** FLOP *** [Kh Ts 6h]
sapr.549: bets $0.79
steinpilz1955 joins the table at seat #4 
M0rganLeFaye: calls $0.79
*** TURN *** [Kh Ts 6h] [Qc]
sapr.549: checks 
M0rganLeFaye: bets $2.73
sapr.549: calls $2.73
*** RIVER *** [Kh Ts 6h Qc] [Th]
sapr.549: bets $2.88 and is all-in
M0rganLeFaye: calls $2.88
*** SHOW DOWN ***
sapr.549: shows [Ah Qh] (a flush, Ace high)
M0rganLeFaye: shows [Jd As] (a straight, Ten to Ace)
sapr.549 collected $14.12 from pot
*** SUMMARY ***
Total pot $14.79 | Rake $0.67 
Board [Kh Ts 6h Qc Th]
Seat 1: sapr.549 (big blind) showed [Ah Qh] and won ($14.12) with a flush, Ace high
Seat 2: Impostore1988 folded before Flop (didn't bet)
Seat 5: M0rganLeFaye (button) showed [Jd As] and lost with a straight, Ten to Ace
Seat 6: Acedan1369 (small blind) folded before Flop



PokerStars Hand #222965490802:  Hold'em No Limit ($0.05/$0.10 USD) - 2021/01/23 14:08:53 ET
Table 'Malzovia' 6-max Seat #6 is the button
Seat 1: sapr.549 ($14.12 in chips) 
Seat 2: Impostore1988 ($11.55 in chips) 
Seat 5: M0rganLeFaye ($10 in chips) 
Seat 6: Acedan1369 ($29.91 in chips) 
sapr.549: posts small blind $0.05
Impostore1988: posts big blind $0.10
hardouin: sits out 
steinpilz1955: sits out 
*** HOLE CARDS ***
M0rganLeFaye: folds 
Acedan1369: folds 
sapr.549: folds 
Uncalled bet ($0.05) returned to Impostore1988
Impostore1988 collected $0.10 from pot
Impostore1988: doesn't show hand 
*** SUMMARY ***
Total pot $0.10 | Rake $0 
Seat 1: sapr.549 (small blind) folded before Flop
Seat 2: Impostore1988 (big blind) collected ($0.10)
Seat 5: M0rganLeFaye folded before Flop (didn't bet)
Seat 6: Acedan1369 (button) folded before Flop (didn't bet)



PokerStars Hand #222965501066:  Hold'em No Limit ($0.05/$0.10 USD) - 2021/01/23 14:09:06 ET
Table 'Malzovia' 6-max Seat #1 is the button
Seat 1: sapr.549 ($14.07 in chips) 
Seat 2: Impostore1988 ($11.60 in chips) 
Seat 3: hardouin ($10 in chips) 
Seat 5: M0rganLeFaye ($10 in chips) 
Seat 6: Acedan1369 ($29.91 in chips) 
Impostore1988: posts small blind $0.05
hardouin: posts big blind $0.10
steinpilz1955: sits out 
*** HOLE CARDS ***
M0rganLeFaye: folds 
Acedan1369: folds 
sapr.549: folds 
Impostore1988: raises $0.20 to $0.30
hardouin: folds 
Uncalled bet ($0.20) returned to Impostore1988
Impostore1988 collected $0.20 from pot
Impostore1988: doesn't show hand 
*** SUMMARY ***
Total pot $0.20 | Rake $0 
Seat 1: sapr.549 (button) folded before Flop (didn't bet)
Seat 2: Impostore1988 (small blind) collected ($0.20)
Seat 3: hardouin (big blind) folded before Flop
Seat 5: M0rganLeFaye folded before Flop (didn't bet)
Seat 6: Acedan1369 folded before Flop (didn't bet)



PokerStars Hand #222965513208:  Hold'em No Limit ($0.05/$0.10 USD) - 2021/01/23 14:09:21 ET
Table 'Malzovia' 6-max Seat #2 is the button
Seat 1: sapr.549 ($14.07 in chips) 
Seat 2: Impostore1988 ($11.70 in chips) 
Seat 3: hardouin ($9.90 in chips) 
Seat 4: steinpilz1955 ($8 in chips) 
Seat 5: M0rganLeFaye ($10 in chips) 
Seat 6: Acedan1369 ($29.91 in chips) 
hardouin: posts small blind $0.05
steinpilz1955: posts big blind $0.10
*** HOLE CARDS ***
M0rganLeFaye: folds 
Acedan1369: folds 
sapr.549: folds 
Impostore1988: folds 
hardouin: folds 
Uncalled bet ($0.05) returned to steinpilz1955
steinpilz1955 collected $0.10 from pot
*** SUMMARY ***
Total pot $0.10 | Rake $0 
Seat 1: sapr.549 folded before Flop (didn't bet)
Seat 2: Impostore1988 (button) folded before Flop (didn't bet)
Seat 3: hardouin (small blind) folded before Flop
Seat 4: steinpilz1955 (big blind) collected ($0.10)
Seat 5: M0rganLeFaye folded before Flop (didn't bet)
Seat 6: Acedan1369 folded before Flop (didn't bet)



PokerStars Hand #222965524018:  Hold'em No Limit ($0.05/$0.10 USD) - 2021/01/23 14:09:34 ET
Table 'Malzovia' 6-max Seat #3 is the button
Seat 1: sapr.549 ($14.07 in chips) 
Seat 2: Impostore1988 ($11.70 in chips) 
Seat 3: hardouin ($9.85 in chips) 
Seat 4: steinpilz1955 ($8.05 in chips) 
Seat 5: M0rganLeFaye ($10 in chips) 
Seat 6: Acedan1369 ($29.91 in chips) 
steinpilz1955: posts small blind $0.05
M0rganLeFaye: posts big blind $0.10
*** HOLE CARDS ***
Acedan1369: folds 
sapr.549: folds 
Impostore1988: folds 
hardouin: folds 
steinpilz1955: calls $0.05
M0rganLeFaye: checks 
*** FLOP *** [Qh 3h Tc]
steinpilz1955: bets $0.30
M0rganLeFaye: folds 
Uncalled bet ($0.30) returned to steinpilz1955
steinpilz1955 collected $0.19 from pot
*** SUMMARY ***
Total pot $0.20 | Rake $0.01 
Board [Qh 3h Tc]
Seat 1: sapr.549 folded before Flop (didn't bet)
Seat 2: Impostore1988 folded before Flop (didn't bet)
Seat 3: hardouin (button) folded before Flop (didn't bet)
Seat 4: steinpilz1955 (small blind) collected ($0.19)
Seat 5: M0rganLeFaye (big blind) folded on the Flop
Seat 6: Acedan1369 folded before Flop (didn't bet)



PokerStars Hand #222965547826:  Hold'em No Limit ($0.05/$0.10 USD) - 2021/01/23 14:10:05 ET
Table 'Malzovia' 6-max Seat #4 is the button
Seat 1: sapr.549 ($14.07 in chips) 
Seat 2: Impostore1988 ($11.70 in chips) 
Seat 3: hardouin ($9.85 in chips) 
Seat 4: steinpilz1955 ($8.14 in chips) 
Seat 5: M0rganLeFaye ($9.90 in chips) 
Seat 6: Acedan1369 ($29.91 in chips) 
M0rganLeFaye: posts small blind $0.05
Acedan1369: posts big blind $0.10
*** HOLE CARDS ***
sapr.549: folds 
Impostore1988: folds 
hardouin: folds 
steinpilz1955: folds 
M0rganLeFaye: folds 
Uncalled bet ($0.05) returned to Acedan1369
Acedan1369 collected $0.10 from pot
Acedan1369: doesn't show hand 
*** SUMMARY ***
Total pot $0.10 | Rake $0 
Seat 1: sapr.549 folded before Flop (didn't bet)
Seat 2: Impostore1988 folded before Flop (didn't bet)
Seat 3: hardouin folded before Flop (didn't bet)
Seat 4: steinpilz1955 (button) folded before Flop (didn't bet)
Seat 5: M0rganLeFaye (small blind) folded before Flop
Seat 6: Acedan1369 (big blind) collected ($0.10)



PokerStars Hand #222965555854:  Hold'em No Limit ($0.05/$0.10 USD) - 2021/01/23 14:10:15 ET
Table 'Malzovia' 6-max Seat #5 is the button
Seat 1: sapr.549 ($14.07 in chips) 
Seat 2: Impostore1988 ($11.70 in chips) 
Seat 3: hardouin ($9.85 in chips) 
Seat 4: steinpilz1955 ($8.14 in chips) 
Seat 5: M0rganLeFaye ($9.85 in chips) 
Seat 6: Acedan1369 ($29.96 in chips) 
Acedan1369: posts small blind $0.05
sapr.549: posts big blind $0.10
*** HOLE CARDS ***
Impostore1988: folds 
hardouin: folds 
steinpilz1955: calls $0.10
M0rganLeFaye: folds 
Acedan1369: folds 
sapr.549: checks 
*** FLOP *** [3c Jd Jc]
sapr.549: checks 
steinpilz1955: checks 
*** TURN *** [3c Jd Jc] [2d]
sapr.549: checks 
steinpilz1955: checks 
*** RIVER *** [3c Jd Jc 2d] [Td]
sapr.549: bets $0.16
steinpilz1955: calls $0.16
*** SHOW DOWN ***
sapr.549: shows [3s Ts] (two pair, Jacks and Tens)
steinpilz1955: shows [Th Qh] (two pair, Jacks and Tens - Queen kicker)
steinpilz1955 collected $0.54 from pot
*** SUMMARY ***
Total pot $0.57 | Rake $0.03 
Board [3c Jd Jc 2d Td]
Seat 1: sapr.549 (big blind) showed [3s Ts] and lost with two pair, Jacks and Tens
Seat 2: Impostore1988 folded before Flop (didn't bet)
Seat 3: hardouin folded before Flop (didn't bet)
Seat 4: steinpilz1955 showed [Th Qh] and won ($0.54) with two pair, Jacks and Tens
Seat 5: M0rganLeFaye (button) folded before Flop (didn't bet)
Seat 6: Acedan1369 (small blind) folded before Flop



PokerStars Hand #222965586122:  Hold'em No Limit ($0.05/$0.10 USD) - 2021/01/23 14:10:53 ET
Table 'Malzovia' 6-max Seat #6 is the button
Seat 1: sapr.549 ($13.81 in chips) 
Seat 2: Impostore1988 ($11.70 in chips) 
Seat 3: hardouin ($9.85 in chips) 
Seat 4: steinpilz1955 ($8.42 in chips) 
Seat 5: M0rganLeFaye ($9.85 in chips) 
Seat 6: Acedan1369 ($29.91 in chips) 
sapr.549: posts small blind $0.05
Impostore1988: posts big blind $0.10
*** HOLE CARDS ***
hardouin: raises $0.20 to $0.30
steinpilz1955: calls $0.30
M0rganLeFaye: folds 
Acedan1369: folds 
sapr.549: folds 
Impostore1988: folds 
*** FLOP *** [4c 5s 5c]
hardouin: bets $0.36
steinpilz1955: calls $0.36
*** TURN *** [4c 5s 5c] [Ah]
hardouin: checks 
steinpilz1955: checks 
*** RIVER *** [4c 5s 5c Ah] [3s]
hardouin: bets $1.40
steinpilz1955: raises $1.70 to $3.10
hardouin: raises $5.20 to $8.30
steinpilz1955: calls $4.66 and is all-in
Uncalled bet ($0.54) returned to hardouin
*** SHOW DOWN ***
hardouin: shows [3c 3d] (a full house, Threes full of Fives)
steinpilz1955: shows [6s 2s] (a straight, Deuce to Six)
hardouin collected $16.23 from pot
*** SUMMARY ***
Total pot $16.99 | Rake $0.76 
Board [4c 5s 5c Ah 3s]
Seat 1: sapr.549 (small blind) folded before Flop
Seat 2: Impostore1988 (big blind) folded before Flop
Seat 3: hardouin showed [3c 3d] and won ($16.23) with a full house, Threes full of Fives
Seat 4: steinpilz1955 showed [6s 2s] and lost with a straight, Deuce to Six
Seat 5: M0rganLeFaye folded before Flop (didn't bet)
Seat 6: Acedan1369 (button) folded before Flop (didn't bet)



PokerStars Hand #222965649742:  Hold'em No Limit ($0.05/$0.10 USD) - 2021/01/23 14:12:14 ET
Table 'Malzovia' 6-max Seat #1 is the button
Seat 1: sapr.549 ($13.76 in chips) 
Seat 2: Impostore1988 ($11.60 in chips) 
Seat 3: hardouin ($17.66 in chips) 
Seat 5: M0rganLeFaye ($9.85 in chips) 
Seat 6: Acedan1369 ($29.91 in chips) 
Impostore1988: posts small blind $0.05
hardouin: posts big blind $0.10
*** HOLE CARDS ***
M0rganLeFaye: folds 
Acedan1369: folds 
sapr.549: folds 
Impostore1988: raises $0.10 to $0.20
hardouin: folds 
Uncalled bet ($0.10) returned to Impostore1988
Impostore1988 collected $0.20 from pot
Impostore1988: doesn't show hand 
*** SUMMARY ***
Total pot $0.20 | Rake $0 
Seat 1: sapr.549 (button) folded before Flop (didn't bet)
Seat 2: Impostore1988 (small blind) collected ($0.20)
Seat 3: hardouin (big blind) folded before Flop
Seat 5: M0rganLeFaye folded before Flop (didn't bet)
Seat 6: Acedan1369 folded before Flop (didn't bet)



PokerStars Hand #222965663046:  Hold'em No Limit ($0.05/$0.10 USD) - 2021/01/23 14:12:31 ET
Table 'Malzovia' 6-max Seat #2 is the button
Seat 1: sapr.549 ($13.76 in chips) 
Seat 2: Impostore1988 ($11.70 in chips) 
Seat 3: hardouin ($17.56 in chips) 
Seat 4: steinpilz1955 ($10 in chips) 
Seat 5: M0rganLeFaye ($9.85 in chips) 
Seat 6: Acedan1369 ($29.91 in chips) 
hardouin: posts small blind $0.05
steinpilz1955: posts big blind $0.10
*** HOLE CARDS ***
M0rganLeFaye: folds 
Acedan1369: folds 
sapr.549: raises $0.15 to $0.25
Impostore1988: folds 
hardouin: folds 
steinpilz1955: calls $0.15
*** FLOP *** [Jh 9s 5c]
steinpilz1955: checks 
sapr.549: bets $0.35
steinpilz1955: calls $0.35
*** TURN *** [Jh 9s 5c] [Kh]
steinpilz1955: checks 
sapr.549: checks 
*** RIVER *** [Jh 9s 5c Kh] [4h]
steinpilz1955: bets $1.50
sapr.549: folds 
Uncalled bet ($1.50) returned to steinpilz1955
steinpilz1955 collected $1.19 from pot
*** SUMMARY ***
Total pot $1.25 | Rake $0.06 
Board [Jh 9s 5c Kh 4h]
Seat 1: sapr.549 folded on the River
Seat 2: Impostore1988 (button) folded before Flop (didn't bet)
Seat 3: hardouin (small blind) folded before Flop
Seat 4: steinpilz1955 (big blind) collected ($1.19)
Seat 5: M0rganLeFaye folded before Flop (didn't bet)
Seat 6: Acedan1369 folded before Flop (didn't bet)



PokerStars Hand #222965710079:  Hold'em No Limit ($0.05/$0.10 USD) - 2021/01/23 14:13:30 ET
Table 'Malzovia' 6-max Seat #3 is the button
Seat 1: sapr.549 ($13.16 in chips) 
Seat 2: Impostore1988 ($11.70 in chips) 
Seat 3: hardouin ($17.51 in chips) 
Seat 4: steinpilz1955 ($10.59 in chips) 
Seat 5: M0rganLeFaye ($9.85 in chips) 
Seat 6: Acedan1369 ($29.91 in chips) 
steinpilz1955: posts small blind $0.05
M0rganLeFaye: posts big blind $0.10
*** HOLE CARDS ***
Acedan1369: folds 
sapr.549: folds 
Impostore1988: raises $0.10 to $0.20
hardouin: folds 
steinpilz1955: folds 
M0rganLeFaye: calls $0.10
*** FLOP *** [8d Qh Qs]
M0rganLeFaye: checks 
Impostore1988: bets $0.22
M0rganLeFaye: raises $0.98 to $1.20
Impostore1988: folds 
Uncalled bet ($0.98) returned to M0rganLeFaye
M0rganLeFaye collected $0.85 from pot
*** SUMMARY ***
Total pot $0.89 | Rake $0.04 
Board [8d Qh Qs]
Seat 1: sapr.549 folded before Flop (didn't bet)
Seat 2: Impostore1988 folded on the Flop
Seat 3: hardouin (button) folded before Flop (didn't bet)
Seat 4: steinpilz1955 (small blind) folded before Flop
Seat 5: M0rganLeFaye (big blind) collected ($0.85)
Seat 6: Acedan1369 folded before Flop (didn't bet)



PokerStars Hand #222965742392:  Hold'em No Limit ($0.05/$0.10 USD) - 2021/01/23 14:14:11 ET
Table 'Malzovia' 6-max Seat #4 is the button
Seat 1: sapr.549 ($13.16 in chips) 
Seat 2: Impostore1988 ($11.28 in chips) 
Seat 3: hardouin ($17.51 in chips) 
Seat 4: steinpilz1955 ($10.54 in chips) 
Seat 5: M0rganLeFaye ($10.28 in chips) 
Seat 6: Acedan1369 ($29.91 in chips) 
M0rganLeFaye: posts small blind $0.05
Acedan1369: posts big blind $0.10
*** HOLE CARDS ***
sapr.549: folds 
Impostore1988: raises $0.20 to $0.30
hardouin: folds 
steinpilz1955: raises $0.50 to $0.80
M0rganLeFaye: folds 
Acedan1369: calls $0.70
Impostore1988: calls $0.50
*** FLOP *** [9h 4d Td]
Acedan1369: checks 
Impostore1988: checks 
steinpilz1955: bets $0.40
Acedan1369: calls $0.40
Impostore1988: raises $0.90 to $1.30
steinpilz1955: calls $0.90
Acedan1369: folds 
*** TURN *** [9h 4d Td] [Ah]
Impostore1988: bets $1.60
steinpilz1955: calls $1.60
*** RIVER *** [9h 4d Td Ah] [2c]
Impostore1988: checks 
steinpilz1955: checks 
*** SHOW DOWN ***
Impostore1988: shows [Qd Kd] (high card Ace)
steinpilz1955: shows [As Kh] (a pair of Aces)
steinpilz1955 collected $8.26 from pot
*** SUMMARY ***
Total pot $8.65 | Rake $0.39 
Board [9h 4d Td Ah 2c]
Seat 1: sapr.549 folded before Flop (didn't bet)
Seat 2: Impostore1988 showed [Qd Kd] and lost with high card Ace
Seat 3: hardouin folded before Flop (didn't bet)
Seat 4: steinpilz1955 (button) showed [As Kh] and won ($8.26) with a pair of Aces
Seat 5: M0rganLeFaye (small blind) folded before Flop
Seat 6: Acedan1369 (big blind) folded on the Flop



PokerStars Hand #222965791170:  Hold'em No Limit ($0.05/$0.10 USD) - 2021/01/23 14:15:12 ET
Table 'Malzovia' 6-max Seat #5 is the button
Seat 1: sapr.549 ($13.16 in chips) 
Seat 2: Impostore1988 ($7.58 in chips) 
Seat 3: hardouin ($17.51 in chips) 
Seat 4: steinpilz1955 ($15.10 in chips) 
Seat 5: M0rganLeFaye ($10.23 in chips) 
Seat 6: Acedan1369 ($28.71 in chips) 
Acedan1369: posts small blind $0.05
sapr.549: posts big blind $0.10
*** HOLE CARDS ***
Impostore1988: folds 
hardouin: folds 
steinpilz1955: folds 
M0rganLeFaye: folds 
Acedan1369: raises $0.15 to $0.25
sapr.549: folds 
Uncalled bet ($0.15) returned to Acedan1369
Acedan1369 collected $0.20 from pot
Acedan1369: doesn't show hand 
*** SUMMARY ***
Total pot $0.20 | Rake $0 
Seat 1: sapr.549 (big blind) folded before Flop
Seat 2: Impostore1988 folded before Flop (didn't bet)
Seat 3: hardouin folded before Flop (didn't bet)
Seat 4: steinpilz1955 folded before Flop (didn't bet)
Seat 5: M0rganLeFaye (button) folded before Flop (didn't bet)
Seat 6: Acedan1369 (small blind) collected ($0.20)



PokerStars Hand #222965803301:  Hold'em No Limit ($0.05/$0.10 USD) - 2021/01/23 14:15:28 ET
Table 'Malzovia' 6-max Seat #6 is the button
Seat 1: sapr.549 ($13.06 in chips) 
Seat 2: Impostore1988 ($10 in chips) 
Seat 3: hardouin ($17.51 in chips) 
Seat 4: steinpilz1955 ($15.10 in chips) 
Seat 5: M0rganLeFaye ($10.23 in chips) 
Seat 6: Acedan1369 ($28.81 in chips) 
sapr.549: posts small blind $0.05
Impostore1988: posts big blind $0.10
*** HOLE CARDS ***
hardouin: raises $0.20 to $0.30
steinpilz1955: folds 
M0rganLeFaye: folds 
Acedan1369: folds 
sapr.549: folds 
Impostore1988: folds 
Uncalled bet ($0.20) returned to hardouin
hardouin collected $0.25 from pot
hardouin: doesn't show hand 
*** SUMMARY ***
Total pot $0.25 | Rake $0 
Seat 1: sapr.549 (small blind) folded before Flop
Seat 2: Impostore1988 (big blind) folded before Flop
Seat 3: hardouin collected ($0.25)
Seat 4: steinpilz1955 folded before Flop (didn't bet)
Seat 5: M0rganLeFaye folded before Flop (didn't bet)
Seat 6: Acedan1369 (button) folded before Flop (didn't bet)



PokerStars Hand #222965817295:  Hold'em No Limit ($0.05/$0.10 USD) - 2021/01/23 14:15:45 ET
Table 'Malzovia' 6-max Seat #1 is the button
Seat 1: sapr.549 ($13.01 in chips) 
Seat 2: Impostore1988 ($9.90 in chips) 
Seat 3: hardouin ($17.66 in chips) 
Seat 4: steinpilz1955 ($15.10 in chips) 
Seat 5: M0rganLeFaye ($10.23 in chips) 
Seat 6: Acedan1369 ($28.81 in chips) 
Impostore1988: posts small blind $0.05
hardouin: posts big blind $0.10
*** HOLE CARDS ***
steinpilz1955: folds 
M0rganLeFaye: folds 
Acedan1369: folds 
sapr.549: folds 
Impostore1988: folds 
Uncalled bet ($0.05) returned to hardouin
hardouin collected $0.10 from pot
hardouin: doesn't show hand 
*** SUMMARY ***
Total pot $0.10 | Rake $0 
Seat 1: sapr.549 (button) folded before Flop (didn't bet)
Seat 2: Impostore1988 (small blind) folded before Flop
Seat 3: hardouin (big blind) collected ($0.10)
Seat 4: steinpilz1955 folded before Flop (didn't bet)
Seat 5: M0rganLeFaye folded before Flop (didn't bet)
Seat 6: Acedan1369 folded before Flop (didn't bet)



PokerStars Hand #222965829082:  Hold'em No Limit ($0.05/$0.10 USD) - 2021/01/23 14:16:00 ET
Table 'Malzovia' 6-max Seat #2 is the button
Seat 1: sapr.549 ($13.01 in chips) 
Seat 2: Impostore1988 ($9.85 in chips) 
Seat 3: hardouin ($17.71 in chips) 
Seat 4: steinpilz1955 ($15.10 in chips) 
Seat 5: M0rganLeFaye ($10.23 in chips) 
Seat 6: Acedan1369 ($28.81 in chips) 
hardouin: posts small blind $0.05
steinpilz1955: posts big blind $0.10
*** HOLE CARDS ***
M0rganLeFaye: folds 
Acedan1369: folds 
sapr.549: folds 
Impostore1988: raises $0.10 to $0.20
hardouin: raises $0.50 to $0.70
steinpilz1955: calls $0.60
Impostore1988: calls $0.50
*** FLOP *** [6h 5c Tc]
hardouin: checks 
steinpilz1955: checks 
Impostore1988: checks 
*** TURN *** [6h 5c Tc] [Th]
hardouin: checks 
steinpilz1955: bets $0.50
Impostore1988: folds 
hardouin: calls $0.50
*** RIVER *** [6h 5c Tc Th] [2h]
hardouin: checks 
steinpilz1955: checks 
*** SHOW DOWN ***
hardouin: shows [As Kd] (a pair of Tens)
steinpilz1955: mucks hand 
hardouin collected $2.96 from pot
*** SUMMARY ***
Total pot $3.10 | Rake $0.14 
Board [6h 5c Tc Th 2h]
Seat 1: sapr.549 folded before Flop (didn't bet)
Seat 2: Impostore1988 (button) folded on the Turn
Seat 3: hardouin (small blind) showed [As Kd] and won ($2.96) with a pair of Tens
Seat 4: steinpilz1955 (big blind) mucked
Seat 5: M0rganLeFaye folded before Flop (didn't bet)
Seat 6: Acedan1369 folded before Flop (didn't bet)



PokerStars Hand #222965887750:  Hold'em No Limit ($0.05/$0.10 USD) - 2021/01/23 14:17:12 ET
Table 'Malzovia' 6-max Seat #3 is the button
Seat 1: sapr.549 ($13.01 in chips) 
Seat 2: Impostore1988 ($10 in chips) 
Seat 3: hardouin ($19.47 in chips) 
Seat 4: steinpilz1955 ($13.90 in chips) 
Seat 5: M0rganLeFaye ($10.23 in chips) 
Seat 6: Acedan1369 ($28.81 in chips) 
steinpilz1955: posts small blind $0.05
M0rganLeFaye: posts big blind $0.10
*** HOLE CARDS ***
Acedan1369: folds 
sapr.549: raises $0.20 to $0.30
Impostore1988: folds 
hardouin: folds 
steinpilz1955: folds 
M0rganLeFaye: calls $0.20
*** FLOP *** [As 9c Th]
M0rganLeFaye: checks 
sapr.549: bets $0.25
M0rganLeFaye: calls $0.25
*** TURN *** [As 9c Th] [6s]
M0rganLeFaye: checks 
sapr.549: checks 
*** RIVER *** [As 9c Th 6s] [Js]
M0rganLeFaye: checks 
sapr.549: checks 
*** SHOW DOWN ***
M0rganLeFaye: shows [Ad Jh] (two pair, Aces and Jacks)
sapr.549: mucks hand 
M0rganLeFaye collected $1.10 from pot
*** SUMMARY ***
Total pot $1.15 | Rake $0.05 
Board [As 9c Th 6s Js]
Seat 1: sapr.549 mucked
Seat 2: Impostore1988 folded before Flop (didn't bet)
Seat 3: hardouin (button) folded before Flop (didn't bet)
Seat 4: steinpilz1955 (small blind) folded before Flop
Seat 5: M0rganLeFaye (big blind) showed [Ad Jh] and won ($1.10) with two pair, Aces and Jacks
Seat 6: Acedan1369 folded before Flop (didn't bet)



PokerStars Hand #222965931316:  Hold'em No Limit ($0.05/$0.10 USD) - 2021/01/23 14:18:07 ET
Table 'Malzovia' 6-max Seat #4 is the button
Seat 1: sapr.549 ($12.46 in chips) 
Seat 2: Impostore1988 ($10 in chips) 
Seat 3: hardouin ($19.47 in chips) 
Seat 4: steinpilz1955 ($13.85 in chips) 
Seat 5: M0rganLeFaye ($10.78 in chips) 
Seat 6: Acedan1369 ($28.81 in chips) 
M0rganLeFaye: posts small blind $0.05
Acedan1369: posts big blind $0.10
*** HOLE CARDS ***
sapr.549: folds 
Impostore1988: folds 
hardouin: folds 
steinpilz1955: folds 
M0rganLeFaye: folds 
Uncalled bet ($0.05) returned to Acedan1369
Acedan1369 collected $0.10 from pot
Acedan1369: doesn't show hand 
*** SUMMARY ***
Total pot $0.10 | Rake $0 
Seat 1: sapr.549 folded before Flop (didn't bet)
Seat 2: Impostore1988 folded before Flop (didn't bet)
Seat 3: hardouin folded before Flop (didn't bet)
Seat 4: steinpilz1955 (button) folded before Flop (didn't bet)
Seat 5: M0rganLeFaye (small blind) folded before Flop
Seat 6: Acedan1369 (big blind) collected ($0.10)



PokerStars Hand #222965942964:  Hold'em No Limit ($0.05/$0.10 USD) - 2021/01/23 14:18:21 ET
Table 'Malzovia' 6-max Seat #5 is the button
Seat 1: sapr.549 ($12.46 in chips) 
Seat 2: Impostore1988 ($10 in chips) 
Seat 3: hardouin ($19.47 in chips) 
Seat 4: steinpilz1955 ($13.85 in chips) 
Seat 5: M0rganLeFaye ($10.73 in chips) 
Seat 6: Acedan1369 ($28.86 in chips) 
Acedan1369: posts small blind $0.05
sapr.549: posts big blind $0.10
*** HOLE CARDS ***
Impostore1988: folds 
hardouin: folds 
steinpilz1955: calls $0.10
M0rganLeFaye: folds 
Acedan1369: folds 
sapr.549: checks 
*** FLOP *** [As 2d 9h]
sapr.549: checks 
steinpilz1955: checks 
*** TURN *** [As 2d 9h] [6c]
sapr.549: checks 
steinpilz1955: bets $0.40
sapr.549: folds 
Uncalled bet ($0.40) returned to steinpilz1955
steinpilz1955 collected $0.24 from pot
*** SUMMARY ***
Total pot $0.25 | Rake $0.01 
Board [As 2d 9h 6c]
Seat 1: sapr.549 (big blind) folded on the Turn
Seat 2: Impostore1988 folded before Flop (didn't bet)
Seat 3: hardouin folded before Flop (didn't bet)
Seat 4: steinpilz1955 collected ($0.24)
Seat 5: M0rganLeFaye (button) folded before Flop (didn't bet)
Seat 6: Acedan1369 (small blind) folded before Flop



PokerStars Hand #222965966950:  Hold'em No Limit ($0.05/$0.10 USD) - 2021/01/23 14:18:52 ET
Table 'Malzovia' 6-max Seat #6 is the button
Seat 1: sapr.549 ($12.36 in chips) 
Seat 2: Impostore1988 ($10 in chips) 
Seat 3: hardouin ($19.47 in chips) 
Seat 4: steinpilz1955 ($13.99 in chips) 
Seat 5: M0rganLeFaye ($10.73 in chips) 
Seat 6: Acedan1369 ($28.81 in chips) 
sapr.549: posts small blind $0.05
Impostore1988: posts big blind $0.10
*** HOLE CARDS ***
hardouin: folds 
steinpilz1955: folds 
M0rganLeFaye: folds 
Acedan1369: folds 
sapr.549: folds 
Uncalled bet ($0.05) returned to Impostore1988
Impostore1988 collected $0.10 from pot
Impostore1988: doesn't show hand 
*** SUMMARY ***
Total pot $0.10 | Rake $0 
Seat 1: sapr.549 (small blind) folded before Flop
Seat 2: Impostore1988 (big blind) collected ($0.10)
Seat 3: hardouin folded before Flop (didn't bet)
Seat 4: steinpilz1955 folded before Flop (didn't bet)
Seat 5: M0rganLeFaye folded before Flop (didn't bet)
Seat 6: Acedan1369 (button) folded before Flop (didn't bet)



PokerStars Hand #222965981696:  Hold'em No Limit ($0.05/$0.10 USD) - 2021/01/23 14:19:10 ET
Table 'Malzovia' 6-max Seat #1 is the button
Seat 1: sapr.549 ($12.31 in chips) 
Seat 2: Impostore1988 ($10.05 in chips) 
Seat 3: hardouin ($19.47 in chips) 
Seat 4: steinpilz1955 ($13.99 in chips) 
Seat 5: M0rganLeFaye ($10.73 in chips) 
Seat 6: Acedan1369 ($28.81 in chips) 
Impostore1988: posts small blind $0.05
hardouin: posts big blind $0.10
*** HOLE CARDS ***
steinpilz1955: folds 
M0rganLeFaye: raises $0.15 to $0.25
Acedan1369: folds 
sapr.549: folds 
Impostore1988: folds 
hardouin: folds 
Uncalled bet ($0.15) returned to M0rganLeFaye
M0rganLeFaye collected $0.25 from pot
*** SUMMARY ***
Total pot $0.25 | Rake $0 
Seat 1: sapr.549 (button) folded before Flop (didn't bet)
Seat 2: Impostore1988 (small blind) folded before Flop
Seat 3: hardouin (big blind) folded before Flop
Seat 4: steinpilz1955 folded before Flop (didn't bet)
Seat 5: M0rganLeFaye collected ($0.25)
Seat 6: Acedan1369 folded before Flop (didn't bet)



PokerStars Hand #222966005485:  Hold'em No Limit ($0.05/$0.10 USD) - 2021/01/23 14:19:41 ET
Table 'Malzovia' 6-max Seat #2 is the button
Seat 1: sapr.549 ($12.31 in chips) 
Seat 2: Impostore1988 ($10 in chips) 
Seat 3: hardouin ($19.37 in chips) 
Seat 4: steinpilz1955 ($13.99 in chips) 
Seat 5: M0rganLeFaye ($10.88 in chips) 
Seat 6: Acedan1369 ($28.81 in chips) 
hardouin: posts small blind $0.05
steinpilz1955: posts big blind $0.10
*** HOLE CARDS ***
M0rganLeFaye: folds 
Acedan1369: folds 
sapr.549: folds 
Impostore1988: raises $0.10 to $0.20
hardouin: folds 
steinpilz1955: calls $0.10
*** FLOP *** [6c 3d 6s]
steinpilz1955: checks 
Impostore1988: checks 
*** TURN *** [6c 3d 6s] [8c]
steinpilz1955: bets $0.50
Impostore1988: folds 
Uncalled bet ($0.50) returned to steinpilz1955
steinpilz1955 collected $0.43 from pot
*** SUMMARY ***
Total pot $0.45 | Rake $0.02 
Board [6c 3d 6s 8c]
Seat 1: sapr.549 folded before Flop (didn't bet)
Seat 2: Impostore1988 (button) folded on the Turn
Seat 3: hardouin (small blind) folded before Flop
Seat 4: steinpilz1955 (big blind) collected ($0.43)
Seat 5: M0rganLeFaye folded before Flop (didn't bet)
Seat 6: Acedan1369 folded before Flop (didn't bet)



PokerStars Hand #222966029563:  Hold'em No Limit ($0.05/$0.10 USD) - 2021/01/23 14:20:11 ET
Table 'Malzovia' 6-max Seat #3 is the button
Seat 1: sapr.549 ($12.31 in chips) 
Seat 2: Impostore1988 ($9.80 in chips) 
Seat 3: hardouin ($19.32 in chips) 
Seat 4: steinpilz1955 ($14.22 in chips) 
Seat 5: M0rganLeFaye ($10.88 in chips) 
Seat 6: Acedan1369 ($28.81 in chips) 
steinpilz1955: posts small blind $0.05
M0rganLeFaye: posts big blind $0.10
*** HOLE CARDS ***
Acedan1369: folds 
sapr.549: folds 
Impostore1988: raises $0.20 to $0.30
hardouin: folds 
steinpilz1955: folds 
M0rganLeFaye: calls $0.20
*** FLOP *** [3h As 5c]
M0rganLeFaye: checks 
Impostore1988: bets $0.10
M0rganLeFaye: calls $0.10
*** TURN *** [3h As 5c] [3s]
M0rganLeFaye: bets $0.49
Impostore1988: folds 
Uncalled bet ($0.49) returned to M0rganLeFaye
M0rganLeFaye collected $0.81 from pot
*** SUMMARY ***
Total pot $0.85 | Rake $0.04 
Board [3h As 5c 3s]
Seat 1: sapr.549 folded before Flop (didn't bet)
Seat 2: Impostore1988 folded on the Turn
Seat 3: hardouin (button) folded before Flop (didn't bet)
Seat 4: steinpilz1955 (small blind) folded before Flop
Seat 5: M0rganLeFaye (big blind) collected ($0.81)
Seat 6: Acedan1369 folded before Flop (didn't bet)



PokerStars Hand #222966062864:  Hold'em No Limit ($0.05/$0.10 USD) - 2021/01/23 14:20:54 ET
Table 'Malzovia' 6-max Seat #4 is the button
Seat 1: sapr.549 ($12.31 in chips) 
Seat 2: Impostore1988 ($9.40 in chips) 
Seat 3: hardouin ($19.32 in chips) 
Seat 4: steinpilz1955 ($14.17 in chips) 
Seat 5: M0rganLeFaye ($11.29 in chips) 
Seat 6: Acedan1369 ($28.81 in chips) 
M0rganLeFaye: posts small blind $0.05
Acedan1369: posts big blind $0.10
*** HOLE CARDS ***
sapr.549: folds 
Impostore1988: folds 
hardouin: folds 
steinpilz1955: folds 
M0rganLeFaye: folds 
Uncalled bet ($0.05) returned to Acedan1369
Acedan1369 collected $0.10 from pot
Acedan1369: doesn't show hand 
*** SUMMARY ***
Total pot $0.10 | Rake $0 
Seat 1: sapr.549 folded before Flop (didn't bet)
Seat 2: Impostore1988 folded before Flop (didn't bet)
Seat 3: hardouin folded before Flop (didn't bet)
Seat 4: steinpilz1955 (button) folded before Flop (didn't bet)
Seat 5: M0rganLeFaye (small blind) folded before Flop
Seat 6: Acedan1369 (big blind) collected ($0.10)



PokerStars Hand #222966070444:  Hold'em No Limit ($0.05/$0.10 USD) - 2021/01/23 14:21:04 ET
Table 'Malzovia' 6-max Seat #5 is the button
Seat 1: sapr.549 ($12.31 in chips) 
Seat 2: Impostore1988 ($9.40 in chips) 
Seat 3: hardouin ($19.32 in chips) 
Seat 4: steinpilz1955 ($14.17 in chips) 
Seat 5: M0rganLeFaye ($11.24 in chips) 
Seat 6: Acedan1369 ($28.86 in chips) 
Acedan1369: posts small blind $0.05
sapr.549: posts big blind $0.10
*** HOLE CARDS ***
Impostore1988: folds 
hardouin: folds 
steinpilz1955: calls $0.10
M0rganLeFaye: calls $0.10
Acedan1369: folds 
sapr.549: checks 
*** FLOP *** [4h 7c Ks]
sapr.549: checks 
steinpilz1955: bets $0.30
M0rganLeFaye: folds 
sapr.549: folds 
Uncalled bet ($0.30) returned to steinpilz1955
steinpilz1955 collected $0.33 from pot
*** SUMMARY ***
Total pot $0.35 | Rake $0.02 
Board [4h 7c Ks]
Seat 1: sapr.549 (big blind) folded on the Flop
Seat 2: Impostore1988 folded before Flop (didn't bet)
Seat 3: hardouin folded before Flop (didn't bet)
Seat 4: steinpilz1955 collected ($0.33)
Seat 5: M0rganLeFaye (button) folded on the Flop
Seat 6: Acedan1369 (small blind) folded before Flop



PokerStars Hand #222966116467:  Hold'em No Limit ($0.05/$0.10 USD) - 2021/01/23 14:21:58 ET
Table 'Malzovia' 6-max Seat #6 is the button
Seat 1: sapr.549 ($12.21 in chips) 
Seat 2: Impostore1988 ($9.40 in chips) 
Seat 3: hardouin ($19.32 in chips) 
Seat 4: steinpilz1955 ($14.40 in chips) 
Seat 5: M0rganLeFaye ($11.14 in chips) 
Seat 6: Acedan1369 ($28.81 in chips) 
sapr.549: posts small blind $0.05
Impostore1988: posts big blind $0.10
*** HOLE CARDS ***
hardouin: folds 
steinpilz1955: folds 
M0rganLeFaye: raises $0.15 to $0.25
Acedan1369: folds 
sapr.549: calls $0.20
Impostore1988: calls $0.15
*** FLOP *** [3s 3h 8s]
sapr.549: checks 
Impostore1988: checks 
M0rganLeFaye: checks 
*** TURN *** [3s 3h 8s] [Tc]
sapr.549: bets $0.48
Impostore1988: calls $0.48
M0rganLeFaye: calls $0.48
*** RIVER *** [3s 3h 8s Tc] [7d]
sapr.549: checks 
Impostore1988: checks 
M0rganLeFaye: checks 
*** SHOW DOWN ***
sapr.549: shows [Ac 3c] (three of a kind, Threes)
Impostore1988: mucks hand 
M0rganLeFaye: mucks hand 
sapr.549 collected $2.09 from pot
*** SUMMARY ***
Total pot $2.19 | Rake $0.10 
Board [3s 3h 8s Tc 7d]
Seat 1: sapr.549 (small blind) showed [Ac 3c] and won ($2.09) with three of a kind, Threes
Seat 2: Impostore1988 (big blind) mucked
Seat 3: hardouin folded before Flop (didn't bet)
Seat 4: steinpilz1955 folded before Flop (didn't bet)
Seat 5: M0rganLeFaye mucked
Seat 6: Acedan1369 (button) folded before Flop (didn't bet)



PokerStars Hand #222966154777:  Hold'em No Limit ($0.05/$0.10 USD) - 2021/01/23 14:22:47 ET
Table 'Malzovia' 6-max Seat #1 is the button
Seat 1: sapr.549 ($13.57 in chips) 
Seat 2: Impostore1988 ($8.67 in chips) 
Seat 3: hardouin ($19.32 in chips) 
Seat 4: steinpilz1955 ($14.40 in chips) 
Seat 5: M0rganLeFaye ($10.41 in chips) 
Seat 6: Acedan1369 ($28.81 in chips) 
Impostore1988: posts small blind $0.05
hardouin: posts big blind $0.10
*** HOLE CARDS ***
steinpilz1955: raises $0.20 to $0.30
M0rganLeFaye: folds 
Acedan1369: raises $0.55 to $0.85
sapr.549: folds 
Impostore1988: folds 
hardouin: folds 
steinpilz1955: calls $0.55
*** FLOP *** [4c 5d Kh]
steinpilz1955: checks 
Acedan1369: checks 
*** TURN *** [4c 5d Kh] [Qh]
steinpilz1955: bets $0.40
Acedan1369: folds 
Uncalled bet ($0.40) returned to steinpilz1955
steinpilz1955 collected $1.77 from pot
*** SUMMARY ***
Total pot $1.85 | Rake $0.08 
Board [4c 5d Kh Qh]
Seat 1: sapr.549 (button) folded before Flop (didn't bet)
Seat 2: Impostore1988 (small blind) folded before Flop
Seat 3: hardouin (big blind) folded before Flop
Seat 4: steinpilz1955 collected ($1.77)
Seat 5: M0rganLeFaye folded before Flop (didn't bet)
Seat 6: Acedan1369 folded on the Turn



PokerStars Hand #222966197357:  Hold'em No Limit ($0.05/$0.10 USD) - 2021/01/23 14:23:41 ET
Table 'Malzovia' 6-max Seat #2 is the button
Seat 1: sapr.549 ($13.57 in chips) 
Seat 2: Impostore1988 ($8.62 in chips) 
Seat 3: hardouin ($19.22 in chips) 
Seat 4: steinpilz1955 ($15.32 in chips) 
Seat 5: M0rganLeFaye ($10.41 in chips) 
Seat 6: Acedan1369 ($27.96 in chips) 
hardouin: posts small blind $0.05
steinpilz1955: posts big blind $0.10
*** HOLE CARDS ***
M0rganLeFaye: folds 
Acedan1369: folds 
sapr.549: folds 
Impostore1988: raises $0.10 to $0.20
hardouin: raises $0.50 to $0.70
steinpilz1955 is disconnected 
steinpilz1955 has timed out while disconnected
steinpilz1955: folds 
Impostore1988: folds 
Uncalled bet ($0.50) returned to hardouin
hardouin collected $0.50 from pot
hardouin: doesn't show hand 
*** SUMMARY ***
Total pot $0.50 | Rake $0 
Seat 1: sapr.549 folded before Flop (didn't bet)
Seat 2: Impostore1988 (button) folded before Flop
Seat 3: hardouin (small blind) collected ($0.50)
Seat 4: steinpilz1955 (big blind) folded before Flop
Seat 5: M0rganLeFaye folded before Flop (didn't bet)
Seat 6: Acedan1369 folded before Flop (didn't bet)



PokerStars Hand #222966235609:  Hold'em No Limit ($0.05/$0.10 USD) - 2021/01/23 14:24:31 ET
Table 'Malzovia' 6-max Seat #3 is the button
Seat 1: sapr.549 ($13.57 in chips) 
Seat 2: Impostore1988 ($10 in chips) 
Seat 3: hardouin ($19.52 in chips) 
Seat 5: M0rganLeFaye ($10.41 in chips) 
Seat 6: Acedan1369 ($27.96 in chips) 
M0rganLeFaye: posts small blind $0.05
Acedan1369: posts big blind $0.10
*** HOLE CARDS ***
sapr.549: folds 
Impostore1988: folds 
hardouin: folds 
M0rganLeFaye: raises $0.15 to $0.25
Acedan1369: folds 
Uncalled bet ($0.15) returned to M0rganLeFaye
M0rganLeFaye collected $0.20 from pot
*** SUMMARY ***
Total pot $0.20 | Rake $0 
Seat 1: sapr.549 folded before Flop (didn't bet)
Seat 2: Impostore1988 folded before Flop (didn't bet)
Seat 3: hardouin (button) folded before Flop (didn't bet)
Seat 5: M0rganLeFaye (small blind) collected ($0.20)
Seat 6: Acedan1369 (big blind) folded before Flop



PokerStars Hand #222966247740:  Hold'em No Limit ($0.05/$0.10 USD) - 2021/01/23 14:24:46 ET
Table 'Malzovia' 6-max Seat #5 is the button
Seat 1: sapr.549 ($13.57 in chips) 
Seat 2: Impostore1988 ($10 in chips) 
Seat 3: hardouin ($19.52 in chips) 
Seat 5: M0rganLeFaye ($10.51 in chips) 
Seat 6: Acedan1369 ($27.86 in chips) 
Acedan1369: posts small blind $0.05
sapr.549: posts big blind $0.10
*** HOLE CARDS ***
Impostore1988: folds 
hardouin: folds 
M0rganLeFaye: folds 
Acedan1369: raises $0.15 to $0.25
sapr.549: folds 
Uncalled bet ($0.15) returned to Acedan1369
Acedan1369 collected $0.20 from pot
Acedan1369: doesn't show hand 
*** SUMMARY ***
Total pot $0.20 | Rake $0 
Seat 1: sapr.549 (big blind) folded before Flop
Seat 2: Impostore1988 folded before Flop (didn't bet)
Seat 3: hardouin folded before Flop (didn't bet)
Seat 5: M0rganLeFaye (button) folded before Flop (didn't bet)
Seat 6: Acedan1369 (small blind) collected ($0.20)



PokerStars Hand #222966262190:  Hold'em No Limit ($0.05/$0.10 USD) - 2021/01/23 14:25:04 ET
Table 'Malzovia' 6-max Seat #6 is the button
Seat 1: sapr.549 ($13.47 in chips) 
Seat 2: Impostore1988 ($10 in chips) 
Seat 3: hardouin ($19.52 in chips) 
Seat 5: M0rganLeFaye ($10.51 in chips) 
Seat 6: Acedan1369 ($27.96 in chips) 
sapr.549: posts small blind $0.05
Impostore1988: posts big blind $0.10
*** HOLE CARDS ***
hardouin: folds 
M0rganLeFaye: folds 
Acedan1369: raises $0.15 to $0.25
sapr.549: folds 
Impostore1988: folds 
Uncalled bet ($0.15) returned to Acedan1369
Acedan1369 collected $0.25 from pot
Acedan1369: doesn't show hand 
*** SUMMARY ***
Total pot $0.25 | Rake $0 
Seat 1: sapr.549 (small blind) folded before Flop
Seat 2: Impostore1988 (big blind) folded before Flop
Seat 3: hardouin folded before Flop (didn't bet)
Seat 5: M0rganLeFaye folded before Flop (didn't bet)
Seat 6: Acedan1369 (button) collected ($0.25)



PokerStars Hand #222966272531:  Hold'em No Limit ($0.05/$0.10 USD) - 2021/01/23 14:25:17 ET
Table 'Malzovia' 6-max Seat #1 is the button
Seat 1: sapr.549 ($13.42 in chips) 
Seat 2: Impostore1988 ($9.90 in chips) 
Seat 3: hardouin ($19.52 in chips) 
Seat 5: M0rganLeFaye ($10.51 in chips) 
Seat 6: Acedan1369 ($28.11 in chips) 
Impostore1988: posts small blind $0.05
hardouin: posts big blind $0.10
*** HOLE CARDS ***
M0rganLeFaye: folds 
Acedan1369: folds 
sapr.549: raises $0.15 to $0.25
Impostore1988: folds 
hardouin: folds 
Uncalled bet ($0.15) returned to sapr.549
sapr.549 collected $0.25 from pot
sapr.549: doesn't show hand 
*** SUMMARY ***
Total pot $0.25 | Rake $0 
Seat 1: sapr.549 (button) collected ($0.25)
Seat 2: Impostore1988 (small blind) folded before Flop
Seat 3: hardouin (big blind) folded before Flop
Seat 5: M0rganLeFaye folded before Flop (didn't bet)
Seat 6: Acedan1369 folded before Flop (didn't bet)



PokerStars Hand #222966285109:  Hold'em No Limit ($0.05/$0.10 USD) - 2021/01/23 14:25:34 ET
Table 'Malzovia' 6-max Seat #2 is the button
Seat 1: sapr.549 ($13.57 in chips) 
Seat 2: Impostore1988 ($9.85 in chips) 
Seat 3: hardouin ($19.42 in chips) 
Seat 5: M0rganLeFaye ($10.51 in chips) 
Seat 6: Acedan1369 ($28.11 in chips) 
hardouin: posts small blind $0.05
M0rganLeFaye: posts big blind $0.10
*** HOLE CARDS ***
Acedan1369: folds 
sapr.549: folds 
Impostore1988: folds 
hardouin: raises $0.20 to $0.30
M0rganLeFaye: folds 
Uncalled bet ($0.20) returned to hardouin
hardouin collected $0.20 from pot
hardouin: doesn't show hand 
*** SUMMARY ***
Total pot $0.20 | Rake $0 
Seat 1: sapr.549 folded before Flop (didn't bet)
Seat 2: Impostore1988 (button) folded before Flop (didn't bet)
Seat 3: hardouin (small blind) collected ($0.20)
Seat 5: M0rganLeFaye (big blind) folded before Flop
Seat 6: Acedan1369 folded before Flop (didn't bet)



PokerStars Hand #222966304626:  Hold'em No Limit ($0.05/$0.10 USD) - 2021/01/23 14:25:59 ET
Table 'Malzovia' 6-max Seat #3 is the button
Seat 1: sapr.549 ($13.57 in chips) 
Seat 2: Impostore1988 ($9.85 in chips) 
Seat 3: hardouin ($19.52 in chips) 
Seat 5: M0rganLeFaye ($10.41 in chips) 
Seat 6: Acedan1369 ($28.11 in chips) 
M0rganLeFaye: posts small blind $0.05
Acedan1369: posts big blind $0.10
*** HOLE CARDS ***
sapr.549: folds 
Impostore1988: folds 
hardouin: folds 
M0rganLeFaye: raises $0.15 to $0.25
Acedan1369: folds 
Uncalled bet ($0.15) returned to M0rganLeFaye
M0rganLeFaye collected $0.20 from pot
*** SUMMARY ***
Total pot $0.20 | Rake $0 
Seat 1: sapr.549 folded before Flop (didn't bet)
Seat 2: Impostore1988 folded before Flop (didn't bet)
Seat 3: hardouin (button) folded before Flop (didn't bet)
Seat 5: M0rganLeFaye (small blind) collected ($0.20)
Seat 6: Acedan1369 (big blind) folded before Flop



PokerStars Hand #222966319543:  Hold'em No Limit ($0.05/$0.10 USD) - 2021/01/23 14:26:18 ET
Table 'Malzovia' 6-max Seat #5 is the button
Seat 1: sapr.549 ($13.57 in chips) 
Seat 2: Impostore1988 ($9.85 in chips) 
Seat 3: hardouin ($19.52 in chips) 
Seat 5: M0rganLeFaye ($10.51 in chips) 
Seat 6: Acedan1369 ($28.01 in chips) 
Acedan1369: posts small blind $0.05
sapr.549: posts big blind $0.10
steinpilz1955: sits out 
*** HOLE CARDS ***
Impostore1988: folds 
hardouin: folds 
M0rganLeFaye: folds 
Acedan1369: raises $0.15 to $0.25
sapr.549: calls $0.15
*** FLOP *** [Tc 6h 7d]
Acedan1369: bets $0.22
sapr.549: calls $0.22
*** TURN *** [Tc 6h 7d] [3c]
Acedan1369: checks 
sapr.549: checks 
*** RIVER *** [Tc 6h 7d 3c] [9h]
Acedan1369: checks 
sapr.549: bets $0.60
Acedan1369: calls $0.60
*** SHOW DOWN ***
sapr.549: shows [8s Ts] (a straight, Six to Ten)
Acedan1369: mucks hand 
sapr.549 collected $2.04 from pot
*** SUMMARY ***
Total pot $2.14 | Rake $0.10 
Board [Tc 6h 7d 3c 9h]
Seat 1: sapr.549 (big blind) showed [8s Ts] and won ($2.04) with a straight, Six to Ten
Seat 2: Impostore1988 folded before Flop (didn't bet)
Seat 3: hardouin folded before Flop (didn't bet)
Seat 5: M0rganLeFaye (button) folded before Flop (didn't bet)
Seat 6: Acedan1369 (small blind) mucked



PokerStars Hand #222966345474:  Hold'em No Limit ($0.05/$0.10 USD) - 2021/01/23 14:26:52 ET
Table 'Malzovia' 6-max Seat #6 is the button
Seat 1: sapr.549 ($14.54 in chips) 
Seat 2: Impostore1988 ($9.85 in chips) 
Seat 3: hardouin ($19.52 in chips) 
Seat 4: steinpilz1955 ($15.22 in chips) 
Seat 5: M0rganLeFaye ($10.51 in chips) 
Seat 6: Acedan1369 ($26.94 in chips) 
sapr.549: posts small blind $0.05
Impostore1988: posts big blind $0.10
steinpilz1955: posts small & big blinds $0.15
*** HOLE CARDS ***
hardouin: folds 
steinpilz1955: checks 
M0rganLeFaye: folds 
Acedan1369: folds 
sapr.549: calls $0.05
Impostore1988: checks 
*** FLOP *** [7s Ts 9c]
sapr.549: bets $0.22
Impostore1988: folds 
steinpilz1955: folds 
Uncalled bet ($0.22) returned to sapr.549
sapr.549 collected $0.33 from pot
sapr.549: doesn't show hand 
*** SUMMARY ***
Total pot $0.35 | Rake $0.02 
Board [7s Ts 9c]
Seat 1: sapr.549 (small blind) collected ($0.33)
Seat 2: Impostore1988 (big blind) folded on the Flop
Seat 3: hardouin folded before Flop (didn't bet)
Seat 4: steinpilz1955 folded on the Flop (didn't bet)
Seat 5: M0rganLeFaye folded before Flop (didn't bet)
Seat 6: Acedan1369 (button) folded before Flop (didn't bet)



PokerStars Hand #222966388496:  Hold'em No Limit ($0.05/$0.10 USD) - 2021/01/23 14:27:40 ET
Table 'Malzovia' 6-max Seat #1 is the button
Seat 1: sapr.549 ($14.77 in chips) 
Seat 2: Impostore1988 ($9.75 in chips) 
Seat 3: hardouin ($19.52 in chips) 
Seat 4: steinpilz1955 ($15.07 in chips) 
Seat 5: M0rganLeFaye ($10.51 in chips) 
Seat 6: Acedan1369 ($26.94 in chips) 
Impostore1988: posts small blind $0.05
hardouin: posts big blind $0.10
*** HOLE CARDS ***
steinpilz1955: calls $0.10
M0rganLeFaye: folds 
Acedan1369: raises $0.30 to $0.40
sapr.549: folds 
Impostore1988: raises $0.80 to $1.20
hardouin: folds 
steinpilz1955: folds 
Acedan1369: folds 
Uncalled bet ($0.80) returned to Impostore1988
Impostore1988 collected $1 from pot
Impostore1988: doesn't show hand 
*** SUMMARY ***
Total pot $1 | Rake $0 
Seat 1: sapr.549 (button) folded before Flop (didn't bet)
Seat 2: Impostore1988 (small blind) collected ($1)
Seat 3: hardouin (big blind) folded before Flop
Seat 4: steinpilz1955 folded before Flop
Seat 5: M0rganLeFaye folded before Flop (didn't bet)
Seat 6: Acedan1369 folded before Flop



PokerStars Hand #222966405866:  Hold'em No Limit ($0.05/$0.10 USD) - 2021/01/23 14:28:03 ET
Table 'Malzovia' 6-max Seat #2 is the button
Seat 1: sapr.549 ($14.77 in chips) 
Seat 2: Impostore1988 ($10.35 in chips) 
Seat 3: hardouin ($19.42 in chips) 
Seat 4: steinpilz1955 ($14.97 in chips) 
Seat 5: M0rganLeFaye ($10.51 in chips) 
Seat 6: Acedan1369 ($26.54 in chips) 
hardouin: posts small blind $0.05
steinpilz1955: posts big blind $0.10
*** HOLE CARDS ***
M0rganLeFaye: folds 
Acedan1369: raises $0.15 to $0.25
sapr.549: folds 
Impostore1988: folds 
hardouin: folds 
steinpilz1955: calls $0.15
*** FLOP *** [Ks 8c Tc]
steinpilz1955: bets $0.40
Acedan1369: calls $0.40
*** TURN *** [Ks 8c Tc] [5h]
steinpilz1955: checks 
Acedan1369: bets $0.97
steinpilz1955: folds 
Uncalled bet ($0.97) returned to Acedan1369
Acedan1369 collected $1.29 from pot
Acedan1369: doesn't show hand 
*** SUMMARY ***
Total pot $1.35 | Rake $0.06 
Board [Ks 8c Tc 5h]
Seat 1: sapr.549 folded before Flop (didn't bet)
Seat 2: Impostore1988 (button) folded before Flop (didn't bet)
Seat 3: hardouin (small blind) folded before Flop
Seat 4: steinpilz1955 (big blind) folded on the Turn
Seat 5: M0rganLeFaye folded before Flop (didn't bet)
Seat 6: Acedan1369 collected ($1.29)



PokerStars Hand #222966435981:  Hold'em No Limit ($0.05/$0.10 USD) - 2021/01/23 14:28:42 ET
Table 'Malzovia' 6-max Seat #3 is the button
Seat 1: sapr.549 ($14.77 in chips) 
Seat 2: Impostore1988 ($10.35 in chips) 
Seat 3: hardouin ($19.37 in chips) 
Seat 4: steinpilz1955 ($14.32 in chips) 
Seat 5: M0rganLeFaye ($10.51 in chips) 
Seat 6: Acedan1369 ($27.18 in chips) 
steinpilz1955: posts small blind $0.05
M0rganLeFaye: posts big blind $0.10
*** HOLE CARDS ***
Acedan1369: folds 
sapr.549: folds 
Impostore1988: raises $0.10 to $0.20
hardouin: folds 
steinpilz1955: calls $0.15
M0rganLeFaye: folds 
*** FLOP *** [3c 2s Qc]
steinpilz1955: checks 
Impostore1988: bets $0.24
steinpilz1955: calls $0.24
*** TURN *** [3c 2s Qc] [2d]
steinpilz1955: checks 
Impostore1988: checks 
*** RIVER *** [3c 2s Qc 2d] [2c]
steinpilz1955: bets $0.40
Impostore1988: folds 
Uncalled bet ($0.40) returned to steinpilz1955
steinpilz1955 collected $0.94 from pot
*** SUMMARY ***
Total pot $0.98 | Rake $0.04 
Board [3c 2s Qc 2d 2c]
Seat 1: sapr.549 folded before Flop (didn't bet)
Seat 2: Impostore1988 folded on the River
Seat 3: hardouin (button) folded before Flop (didn't bet)
Seat 4: steinpilz1955 (small blind) collected ($0.94)
Seat 5: M0rganLeFaye (big blind) folded before Flop
Seat 6: Acedan1369 folded before Flop (didn't bet)



PokerStars Hand #222966467027:  Hold'em No Limit ($0.05/$0.10 USD) - 2021/01/23 14:29:22 ET
Table 'Malzovia' 6-max Seat #4 is the button
Seat 1: sapr.549 ($14.77 in chips) 
Seat 2: Impostore1988 ($9.91 in chips) 
Seat 3: hardouin ($19.37 in chips) 
Seat 4: steinpilz1955 ($14.82 in chips) 
Seat 5: M0rganLeFaye ($10.41 in chips) 
Seat 6: Acedan1369 ($27.18 in chips) 
M0rganLeFaye: posts small blind $0.05
Acedan1369: posts big blind $0.10
*** HOLE CARDS ***
sapr.549: folds 
Impostore1988: folds 
hardouin: folds 
steinpilz1955: raises $0.20 to $0.30
M0rganLeFaye: folds 
Acedan1369: folds 
Uncalled bet ($0.20) returned to steinpilz1955
steinpilz1955 collected $0.25 from pot
*** SUMMARY ***
Total pot $0.25 | Rake $0 
Seat 1: sapr.549 folded before Flop (didn't bet)
Seat 2: Impostore1988 folded before Flop (didn't bet)
Seat 3: hardouin folded before Flop (didn't bet)
Seat 4: steinpilz1955 (button) collected ($0.25)
Seat 5: M0rganLeFaye (small blind) folded before Flop
Seat 6: Acedan1369 (big blind) folded before Flop



PokerStars Hand #222966476281:  Hold'em No Limit ($0.05/$0.10 USD) - 2021/01/23 14:29:34 ET
Table 'Malzovia' 6-max Seat #5 is the button
Seat 1: sapr.549 ($14.77 in chips) 
Seat 2: Impostore1988 ($9.91 in chips) 
Seat 3: hardouin ($19.37 in chips) 
Seat 4: steinpilz1955 ($14.97 in chips) 
Seat 5: M0rganLeFaye ($10.36 in chips) 
Seat 6: Acedan1369 ($27.08 in chips) 
Acedan1369: posts small blind $0.05
sapr.549: posts big blind $0.10
*** HOLE CARDS ***
Impostore1988: raises $0.10 to $0.20
hardouin: folds 
steinpilz1955: folds 
M0rganLeFaye: calls $0.20
Acedan1369: folds 
sapr.549: folds 
*** FLOP *** [2s 4s 4h]
Impostore1988: bets $0.27
M0rganLeFaye: raises $0.64 to $0.91
Impostore1988: calls $0.64
*** TURN *** [2s 4s 4h] [6s]
Impostore1988: checks 
M0rganLeFaye: bets $1.36
Impostore1988: calls $1.36
*** RIVER *** [2s 4s 4h 6s] [Ad]
Impostore1988: checks 
M0rganLeFaye: checks 
*** SHOW DOWN ***
Impostore1988: shows [5d 5h] (two pair, Fives and Fours)
M0rganLeFaye: shows [7d 7s] (two pair, Sevens and Fours)
M0rganLeFaye collected $4.86 from pot
*** SUMMARY ***
Total pot $5.09 | Rake $0.23 
Board [2s 4s 4h 6s Ad]
Seat 1: sapr.549 (big blind) folded before Flop
Seat 2: Impostore1988 showed [5d 5h] and lost with two pair, Fives and Fours
Seat 3: hardouin folded before Flop (didn't bet)
Seat 4: steinpilz1955 folded before Flop (didn't bet)
Seat 5: M0rganLeFaye (button) showed [7d 7s] and won ($4.86) with two pair, Sevens and Fours
Seat 6: Acedan1369 (small blind) folded before Flop



PokerStars Hand #222966517065:  Hold'em No Limit ($0.05/$0.10 USD) - 2021/01/23 14:30:14 ET
Table 'Malzovia' 6-max Seat #6 is the button
Seat 1: sapr.549 ($14.67 in chips) 
Seat 2: Impostore1988 ($7.44 in chips) 
Seat 3: hardouin ($19.37 in chips) 
Seat 4: steinpilz1955 ($14.97 in chips) 
Seat 5: M0rganLeFaye ($12.75 in chips) 
Seat 6: Acedan1369 ($27.03 in chips) 
sapr.549: posts small blind $0.05
Impostore1988: posts big blind $0.10
*** HOLE CARDS ***
hardouin: folds 
steinpilz1955: raises $0.20 to $0.30
M0rganLeFaye: folds 
Acedan1369: folds 
sapr.549: calls $0.25
Impostore1988: folds 
*** FLOP *** [5c 9c 9s]
sapr.549: checks 
steinpilz1955: bets $0.50
sapr.549: folds 
Uncalled bet ($0.50) returned to steinpilz1955
steinpilz1955 collected $0.67 from pot
*** SUMMARY ***
Total pot $0.70 | Rake $0.03 
Board [5c 9c 9s]
Seat 1: sapr.549 (small blind) folded on the Flop
Seat 2: Impostore1988 (big blind) folded before Flop
Seat 3: hardouin folded before Flop (didn't bet)
Seat 4: steinpilz1955 collected ($0.67)
Seat 5: M0rganLeFaye folded before Flop (didn't bet)
Seat 6: Acedan1369 (button) folded before Flop (didn't bet)



PokerStars Hand #222966535259:  Hold'em No Limit ($0.05/$0.10 USD) - 2021/01/23 14:30:38 ET
Table 'Malzovia' 6-max Seat #1 is the button
Seat 1: sapr.549 ($14.37 in chips) 
Seat 2: Impostore1988 ($10 in chips) 
Seat 3: hardouin ($19.37 in chips) 
Seat 4: steinpilz1955 ($15.34 in chips) 
Seat 5: M0rganLeFaye ($12.75 in chips) 
Seat 6: Acedan1369 ($27.03 in chips) 
Impostore1988: posts small blind $0.05
hardouin: posts big blind $0.10
*** HOLE CARDS ***
steinpilz1955: calls $0.10
M0rganLeFaye: folds 
Acedan1369: folds 
sapr.549: raises $0.25 to $0.35
Impostore1988: folds 
hardouin: folds 
steinpilz1955: calls $0.25
*** FLOP *** [9c 9d 2d]
steinpilz1955: checks 
sapr.549: bets $0.33
steinpilz1955: calls $0.33
*** TURN *** [9c 9d 2d] [Td]
steinpilz1955: checks 
sapr.549: checks 
*** RIVER *** [9c 9d 2d Td] [Qs]
steinpilz1955: bets $0.30
sapr.549: calls $0.30
*** SHOW DOWN ***
steinpilz1955: shows [Tc Ac] (two pair, Tens and Nines)
sapr.549: mucks hand 
steinpilz1955 collected $2.02 from pot
*** SUMMARY ***
Total pot $2.11 | Rake $0.09 
Board [9c 9d 2d Td Qs]
Seat 1: sapr.549 (button) mucked
Seat 2: Impostore1988 (small blind) folded before Flop
Seat 3: hardouin (big blind) folded before Flop
Seat 4: steinpilz1955 showed [Tc Ac] and won ($2.02) with two pair, Tens and Nines
Seat 5: M0rganLeFaye folded before Flop (didn't bet)
Seat 6: Acedan1369 folded before Flop (didn't bet)



PokerStars Hand #222966565603:  Hold'em No Limit ($0.05/$0.10 USD) - 2021/01/23 14:31:17 ET
Table 'Malzovia' 6-max Seat #2 is the button
Seat 1: sapr.549 ($13.39 in chips) 
Seat 2: Impostore1988 ($9.95 in chips) 
Seat 3: hardouin ($19.27 in chips) 
Seat 4: steinpilz1955 ($16.38 in chips) 
Seat 5: M0rganLeFaye ($12.75 in chips) 
Seat 6: Acedan1369 ($27.03 in chips) 
hardouin: posts small blind $0.05
steinpilz1955: posts big blind $0.10
*** HOLE CARDS ***
M0rganLeFaye: raises $0.20 to $0.30
Acedan1369: folds 
sapr.549: folds 
Impostore1988: folds 
hardouin: folds 
steinpilz1955: folds 
Uncalled bet ($0.20) returned to M0rganLeFaye
M0rganLeFaye collected $0.25 from pot
*** SUMMARY ***
Total pot $0.25 | Rake $0 
Seat 1: sapr.549 folded before Flop (didn't bet)
Seat 2: Impostore1988 (button) folded before Flop (didn't bet)
Seat 3: hardouin (small blind) folded before Flop
Seat 4: steinpilz1955 (big blind) folded before Flop
Seat 5: M0rganLeFaye collected ($0.25)
Seat 6: Acedan1369 folded before Flop (didn't bet)



PokerStars Hand #222966579653:  Hold'em No Limit ($0.05/$0.10 USD) - 2021/01/23 14:31:35 ET
Table 'Malzovia' 6-max Seat #3 is the button
Seat 1: sapr.549 ($13.39 in chips) 
Seat 2: Impostore1988 ($9.95 in chips) 
Seat 3: hardouin ($19.22 in chips) 
Seat 4: steinpilz1955 ($16.28 in chips) 
Seat 5: M0rganLeFaye ($12.90 in chips) 
Seat 6: Acedan1369 ($27.03 in chips) 
steinpilz1955: posts small blind $0.05
M0rganLeFaye: posts big blind $0.10
*** HOLE CARDS ***
Acedan1369: folds 
sapr.549: folds 
Impostore1988: folds 
hardouin: folds 
steinpilz1955: calls $0.05
M0rganLeFaye: checks 
*** FLOP *** [Kh Js Kd]
steinpilz1955: checks 
M0rganLeFaye: checks 
*** TURN *** [Kh Js Kd] [7s]
steinpilz1955: checks 
M0rganLeFaye: checks 
*** RIVER *** [Kh Js Kd 7s] [8h]
steinpilz1955: checks 
M0rganLeFaye: checks 
*** SHOW DOWN ***
steinpilz1955: shows [6d 5c] (a pair of Kings)
M0rganLeFaye: shows [4h Td] (a pair of Kings - Jack+Ten kicker)
M0rganLeFaye collected $0.19 from pot
*** SUMMARY ***
Total pot $0.20 | Rake $0.01 
Board [Kh Js Kd 7s 8h]
Seat 1: sapr.549 folded before Flop (didn't bet)
Seat 2: Impostore1988 folded before Flop (didn't bet)
Seat 3: hardouin (button) folded before Flop (didn't bet)
Seat 4: steinpilz1955 (small blind) showed [6d 5c] and lost with a pair of Kings
Seat 5: M0rganLeFaye (big blind) showed [4h Td] and won ($0.19) with a pair of Kings
Seat 6: Acedan1369 folded before Flop (didn't bet)



PokerStars Hand #222966613559:  Hold'em No Limit ($0.05/$0.10 USD) - 2021/01/23 14:32:18 ET
Table 'Malzovia' 6-max Seat #4 is the button
Seat 1: sapr.549 ($13.39 in chips) 
Seat 2: Impostore1988 ($9.95 in chips) 
Seat 3: hardouin ($19.22 in chips) 
Seat 4: steinpilz1955 ($16.18 in chips) 
Seat 5: M0rganLeFaye ($12.99 in chips) 
Seat 6: Acedan1369 ($27.03 in chips) 
M0rganLeFaye: posts small blind $0.05
Acedan1369: posts big blind $0.10
*** HOLE CARDS ***
sapr.549: folds 
Impostore1988: folds 
hardouin: folds 
steinpilz1955: folds 
M0rganLeFaye: folds 
Uncalled bet ($0.05) returned to Acedan1369
Acedan1369 collected $0.10 from pot
Acedan1369: doesn't show hand 
*** SUMMARY ***
Total pot $0.10 | Rake $0 
Seat 1: sapr.549 folded before Flop (didn't bet)
Seat 2: Impostore1988 folded before Flop (didn't bet)
Seat 3: hardouin folded before Flop (didn't bet)
Seat 4: steinpilz1955 (button) folded before Flop (didn't bet)
Seat 5: M0rganLeFaye (small blind) folded before Flop
Seat 6: Acedan1369 (big blind) collected ($0.10)



PokerStars Hand #222966621454:  Hold'em No Limit ($0.05/$0.10 USD) - 2021/01/23 14:32:28 ET
Table 'Malzovia' 6-max Seat #5 is the button
Seat 1: sapr.549 ($13.39 in chips) 
Seat 2: Impostore1988 ($9.95 in chips) 
Seat 3: hardouin ($19.22 in chips) 
Seat 4: steinpilz1955 ($16.18 in chips) 
Seat 5: M0rganLeFaye ($12.94 in chips) 
Seat 6: Acedan1369 ($27.08 in chips) 
Acedan1369: posts small blind $0.05
sapr.549: posts big blind $0.10
*** HOLE CARDS ***
Impostore1988: folds 
hardouin: folds 
steinpilz1955: calls $0.10
M0rganLeFaye: folds 
Acedan1369: folds 
sapr.549: checks 
*** FLOP *** [Jc 8h 2s]
sapr.549: checks 
steinpilz1955: bets $0.30
sapr.549: folds 
Uncalled bet ($0.30) returned to steinpilz1955
steinpilz1955 collected $0.24 from pot
*** SUMMARY ***
Total pot $0.25 | Rake $0.01 
Board [Jc 8h 2s]
Seat 1: sapr.549 (big blind) folded on the Flop
Seat 2: Impostore1988 folded before Flop (didn't bet)
Seat 3: hardouin folded before Flop (didn't bet)
Seat 4: steinpilz1955 collected ($0.24)
Seat 5: M0rganLeFaye (button) folded before Flop (didn't bet)
Seat 6: Acedan1369 (small blind) folded before Flop



PokerStars Hand #222966639807:  Hold'em No Limit ($0.05/$0.10 USD) - 2021/01/23 14:32:51 ET
Table 'Malzovia' 6-max Seat #6 is the button
Seat 1: sapr.549 ($13.29 in chips) 
Seat 2: Impostore1988 ($9.95 in chips) 
Seat 3: hardouin ($19.22 in chips) 
Seat 4: steinpilz1955 ($16.32 in chips) 
Seat 5: M0rganLeFaye ($12.94 in chips) 
Seat 6: Acedan1369 ($27.03 in chips) 
sapr.549: posts small blind $0.05
Impostore1988: posts big blind $0.10
*** HOLE CARDS ***
hardouin: folds 
steinpilz1955: folds 
M0rganLeFaye: folds 
Acedan1369: folds 
sapr.549: folds 
Uncalled bet ($0.05) returned to Impostore1988
Impostore1988 collected $0.10 from pot
Impostore1988: doesn't show hand 
*** SUMMARY ***
Total pot $0.10 | Rake $0 
Seat 1: sapr.549 (small blind) folded before Flop
Seat 2: Impostore1988 (big blind) collected ($0.10)
Seat 3: hardouin folded before Flop (didn't bet)
Seat 4: steinpilz1955 folded before Flop (didn't bet)
Seat 5: M0rganLeFaye folded before Flop (didn't bet)
Seat 6: Acedan1369 (button) folded before Flop (didn't bet)



PokerStars Hand #222966647077:  Hold'em No Limit ($0.05/$0.10 USD) - 2021/01/23 14:33:00 ET
Table 'Malzovia' 6-max Seat #1 is the button
Seat 1: sapr.549 ($13.24 in chips) 
Seat 2: Impostore1988 ($10 in chips) 
Seat 3: hardouin ($19.22 in chips) 
Seat 4: steinpilz1955 ($16.32 in chips) 
Seat 5: M0rganLeFaye ($12.94 in chips) 
Seat 6: Acedan1369 ($27.03 in chips) 
Impostore1988: posts small blind $0.05
hardouin: posts big blind $0.10
*** HOLE CARDS ***
steinpilz1955: calls $0.10
M0rganLeFaye: folds 
Acedan1369: folds 
sapr.549: folds 
Impostore1988: raises $0.20 to $0.30
hardouin: folds 
steinpilz1955: calls $0.20
*** FLOP *** [Kc 8d 5s]
Impostore1988: checks 
steinpilz1955: checks 
*** TURN *** [Kc 8d 5s] [Td]
Impostore1988: checks 
steinpilz1955: bets $0.50
Impostore1988: folds 
Uncalled bet ($0.50) returned to steinpilz1955
steinpilz1955 collected $0.67 from pot
*** SUMMARY ***
Total pot $0.70 | Rake $0.03 
Board [Kc 8d 5s Td]
Seat 1: sapr.549 (button) folded before Flop (didn't bet)
Seat 2: Impostore1988 (small blind) folded on the Turn
Seat 3: hardouin (big blind) folded before Flop
Seat 4: steinpilz1955 collected ($0.67)
Seat 5: M0rganLeFaye folded before Flop (didn't bet)
Seat 6: Acedan1369 folded before Flop (didn't bet)



PokerStars Hand #222966676057:  Hold'em No Limit ($0.05/$0.10 USD) - 2021/01/23 14:33:37 ET
Table 'Malzovia' 6-max Seat #2 is the button
Seat 1: sapr.549 ($13.24 in chips) 
Seat 2: Impostore1988 ($9.70 in chips) 
Seat 3: hardouin ($19.12 in chips) 
Seat 4: steinpilz1955 ($16.69 in chips) 
Seat 5: M0rganLeFaye ($12.94 in chips) 
Seat 6: Acedan1369 ($27.03 in chips) 
hardouin: posts small blind $0.05
steinpilz1955: posts big blind $0.10
*** HOLE CARDS ***
M0rganLeFaye: folds 
Acedan1369: folds 
sapr.549: folds 
Impostore1988: folds 
hardouin: folds 
Uncalled bet ($0.05) returned to steinpilz1955
steinpilz1955 collected $0.10 from pot
*** SUMMARY ***
Total pot $0.10 | Rake $0 
Seat 1: sapr.549 folded before Flop (didn't bet)
Seat 2: Impostore1988 (button) folded before Flop (didn't bet)
Seat 3: hardouin (small blind) folded before Flop
Seat 4: steinpilz1955 (big blind) collected ($0.10)
Seat 5: M0rganLeFaye folded before Flop (didn't bet)
Seat 6: Acedan1369 folded before Flop (didn't bet)



PokerStars Hand #222966685469:  Hold'em No Limit ($0.05/$0.10 USD) - 2021/01/23 14:33:49 ET
Table 'Malzovia' 6-max Seat #3 is the button
Seat 1: sapr.549 ($13.24 in chips) 
Seat 2: Impostore1988 ($9.70 in chips) 
Seat 3: hardouin ($19.07 in chips) 
Seat 4: steinpilz1955 ($16.74 in chips) 
Seat 5: M0rganLeFaye ($12.94 in chips) 
Seat 6: Acedan1369 ($27.03 in chips) 
steinpilz1955: posts small blind $0.05
M0rganLeFaye: posts big blind $0.10
*** HOLE CARDS ***
Acedan1369: raises $0.15 to $0.25
sapr.549: folds 
Impostore1988: folds 
hardouin: folds 
steinpilz1955: calls $0.20
M0rganLeFaye: calls $0.15
*** FLOP *** [Tc 8c 2c]
steinpilz1955: checks 
M0rganLeFaye: bets $0.43
Acedan1369: folds 
steinpilz1955: folds 
Uncalled bet ($0.43) returned to M0rganLeFaye
M0rganLeFaye collected $0.72 from pot
*** SUMMARY ***
Total pot $0.75 | Rake $0.03 
Board [Tc 8c 2c]
Seat 1: sapr.549 folded before Flop (didn't bet)
Seat 2: Impostore1988 folded before Flop (didn't bet)
Seat 3: hardouin (button) folded before Flop (didn't bet)
Seat 4: steinpilz1955 (small blind) folded on the Flop
Seat 5: M0rganLeFaye (big blind) collected ($0.72)
Seat 6: Acedan1369 folded on the Flop



PokerStars Hand #222966712849:  Hold'em No Limit ($0.05/$0.10 USD) - 2021/01/23 14:34:25 ET
Table 'Malzovia' 6-max Seat #4 is the button
Seat 1: sapr.549 ($13.24 in chips) 
Seat 2: Impostore1988 ($9.70 in chips) 
Seat 3: hardouin ($19.07 in chips) 
Seat 4: steinpilz1955 ($16.49 in chips) 
Seat 5: M0rganLeFaye ($13.41 in chips) 
Seat 6: Acedan1369 ($26.78 in chips) 
M0rganLeFaye: posts small blind $0.05
Acedan1369: posts big blind $0.10
*** HOLE CARDS ***
sapr.549: folds 
Impostore1988: folds 
hardouin: folds 
steinpilz1955: calls $0.10
M0rganLeFaye: folds 
Acedan1369: checks 
*** FLOP *** [Kd 5h 9c]
Acedan1369: checks 
steinpilz1955: checks 
*** TURN *** [Kd 5h 9c] [3s]
Acedan1369: checks 
steinpilz1955: bets $0.40
Acedan1369: folds 
Uncalled bet ($0.40) returned to steinpilz1955
steinpilz1955 collected $0.24 from pot
*** SUMMARY ***
Total pot $0.25 | Rake $0.01 
Board [Kd 5h 9c 3s]
Seat 1: sapr.549 folded before Flop (didn't bet)
Seat 2: Impostore1988 folded before Flop (didn't bet)
Seat 3: hardouin folded before Flop (didn't bet)
Seat 4: steinpilz1955 (button) collected ($0.24)
Seat 5: M0rganLeFaye (small blind) folded before Flop
Seat 6: Acedan1369 (big blind) folded on the Turn



PokerStars Hand #222966729408:  Hold'em No Limit ($0.05/$0.10 USD) - 2021/01/23 14:34:46 ET
Table 'Malzovia' 6-max Seat #5 is the button
Seat 1: sapr.549 ($13.24 in chips) 
Seat 2: Impostore1988 ($9.70 in chips) 
Seat 3: hardouin ($19.07 in chips) 
Seat 4: steinpilz1955 ($16.63 in chips) 
Seat 5: M0rganLeFaye ($13.36 in chips) 
Seat 6: Acedan1369 ($26.68 in chips) 
Acedan1369: posts small blind $0.05
sapr.549: posts big blind $0.10
*** HOLE CARDS ***
Impostore1988: folds 
hardouin: folds 
steinpilz1955: folds 
M0rganLeFaye: folds 
Acedan1369: raises $0.15 to $0.25
sapr.549: folds 
Uncalled bet ($0.15) returned to Acedan1369
Acedan1369 collected $0.20 from pot
Acedan1369: doesn't show hand 
*** SUMMARY ***
Total pot $0.20 | Rake $0 
Seat 1: sapr.549 (big blind) folded before Flop
Seat 2: Impostore1988 folded before Flop (didn't bet)
Seat 3: hardouin folded before Flop (didn't bet)
Seat 4: steinpilz1955 folded before Flop (didn't bet)
Seat 5: M0rganLeFaye (button) folded before Flop (didn't bet)
Seat 6: Acedan1369 (small blind) collected ($0.20)



PokerStars Hand #222966741942:  Hold'em No Limit ($0.05/$0.10 USD) - 2021/01/23 14:35:02 ET
Table 'Malzovia' 6-max Seat #6 is the button
Seat 1: sapr.549 ($13.14 in chips) 
Seat 2: Impostore1988 ($9.70 in chips) 
Seat 3: hardouin ($19.07 in chips) 
Seat 4: steinpilz1955 ($16.63 in chips) 
Seat 5: M0rganLeFaye ($13.36 in chips) 
Seat 6: Acedan1369 ($26.78 in chips) 
sapr.549: posts small blind $0.05
Impostore1988: posts big blind $0.10
*** HOLE CARDS ***
hardouin: folds 
steinpilz1955: folds 
M0rganLeFaye: folds 
Acedan1369: folds 
sapr.549: raises $0.10 to $0.20
Impostore1988: folds 
Uncalled bet ($0.10) returned to sapr.549
sapr.549 collected $0.20 from pot
sapr.549: doesn't show hand 
*** SUMMARY ***
Total pot $0.20 | Rake $0 
Seat 1: sapr.549 (small blind) collected ($0.20)
Seat 2: Impostore1988 (big blind) folded before Flop
Seat 3: hardouin folded before Flop (didn't bet)
Seat 4: steinpilz1955 folded before Flop (didn't bet)
Seat 5: M0rganLeFaye folded before Flop (didn't bet)
Seat 6: Acedan1369 (button) folded before Flop (didn't bet)



PokerStars Hand #222966753147:  Hold'em No Limit ($0.05/$0.10 USD) - 2021/01/23 14:35:16 ET
Table 'Malzovia' 6-max Seat #1 is the button
Seat 1: sapr.549 ($13.24 in chips) 
Seat 2: Impostore1988 ($9.60 in chips) 
Seat 3: hardouin ($19.07 in chips) 
Seat 4: steinpilz1955 ($16.63 in chips) 
Seat 5: M0rganLeFaye ($13.36 in chips) 
Seat 6: Acedan1369 ($26.78 in chips) 
Impostore1988: posts small blind $0.05
hardouin: posts big blind $0.10
*** HOLE CARDS ***
steinpilz1955: calls $0.10
M0rganLeFaye: folds 
Acedan1369: folds 
sapr.549: folds 
Impostore1988: folds 
hardouin: checks 
*** FLOP *** [Tc Ac 9h]
hardouin: checks 
steinpilz1955: bets $0.30
hardouin: folds 
Uncalled bet ($0.30) returned to steinpilz1955
steinpilz1955 collected $0.24 from pot
*** SUMMARY ***
Total pot $0.25 | Rake $0.01 
Board [Tc Ac 9h]
Seat 1: sapr.549 (button) folded before Flop (didn't bet)
Seat 2: Impostore1988 (small blind) folded before Flop
Seat 3: hardouin (big blind) folded on the Flop
Seat 4: steinpilz1955 collected ($0.24)
Seat 5: M0rganLeFaye folded before Flop (didn't bet)
Seat 6: Acedan1369 folded before Flop (didn't bet)



PokerStars Hand #222966772038:  Hold'em No Limit ($0.05/$0.10 USD) - 2021/01/23 14:35:40 ET
Table 'Malzovia' 6-max Seat #2 is the button
Seat 1: sapr.549 ($13.24 in chips) 
Seat 2: Impostore1988 ($9.55 in chips) 
Seat 3: hardouin ($18.97 in chips) 
Seat 4: steinpilz1955 ($16.77 in chips) 
Seat 5: M0rganLeFaye ($13.36 in chips) 
Seat 6: Acedan1369 ($26.78 in chips) 
hardouin: posts small blind $0.05
steinpilz1955: posts big blind $0.10
*** HOLE CARDS ***
M0rganLeFaye: folds 
Acedan1369: folds 
sapr.549: folds 
Impostore1988: folds 
hardouin: folds 
Uncalled bet ($0.05) returned to steinpilz1955
steinpilz1955 collected $0.10 from pot
*** SUMMARY ***
Total pot $0.10 | Rake $0 
Seat 1: sapr.549 folded before Flop (didn't bet)
Seat 2: Impostore1988 (button) folded before Flop (didn't bet)
Seat 3: hardouin (small blind) folded before Flop
Seat 4: steinpilz1955 (big blind) collected ($0.10)
Seat 5: M0rganLeFaye folded before Flop (didn't bet)
Seat 6: Acedan1369 folded before Flop (didn't bet)



PokerStars Hand #222966784062:  Hold'em No Limit ($0.05/$0.10 USD) - 2021/01/23 14:35:56 ET
Table 'Malzovia' 6-max Seat #3 is the button
Seat 1: sapr.549 ($13.24 in chips) 
Seat 2: Impostore1988 ($9.55 in chips) 
Seat 3: hardouin ($18.92 in chips) 
Seat 4: steinpilz1955 ($16.82 in chips) 
Seat 5: M0rganLeFaye ($13.36 in chips) 
Seat 6: Acedan1369 ($26.78 in chips) 
steinpilz1955: posts small blind $0.05
M0rganLeFaye: posts big blind $0.10
*** HOLE CARDS ***
Acedan1369: folds 
sapr.549: folds 
Impostore1988: folds 
hardouin: folds 
steinpilz1955: raises $0.20 to $0.30
M0rganLeFaye: raises $0.80 to $1.10
steinpilz1955: calls $0.80
*** FLOP *** [2d 3d 5c]
steinpilz1955: checks 
M0rganLeFaye: bets $1.68
steinpilz1955: folds 
Uncalled bet ($1.68) returned to M0rganLeFaye
M0rganLeFaye collected $2.10 from pot
*** SUMMARY ***
Total pot $2.20 | Rake $0.10 
Board [2d 3d 5c]
Seat 1: sapr.549 folded before Flop (didn't bet)
Seat 2: Impostore1988 folded before Flop (didn't bet)
Seat 3: hardouin (button) folded before Flop (didn't bet)
Seat 4: steinpilz1955 (small blind) folded on the Flop
Seat 5: M0rganLeFaye (big blind) collected ($2.10)
Seat 6: Acedan1369 folded before Flop (didn't bet)



PokerStars Hand #222966820878:  Hold'em No Limit ($0.05/$0.10 USD) - 2021/01/23 14:36:42 ET
Table 'Malzovia' 6-max Seat #4 is the button
Seat 1: sapr.549 ($13.24 in chips) 
Seat 2: Impostore1988 ($9.55 in chips) 
Seat 3: hardouin ($18.92 in chips) 
Seat 4: steinpilz1955 ($15.72 in chips) 
Seat 5: M0rganLeFaye ($14.36 in chips) 
M0rganLeFaye: posts small blind $0.05
sapr.549: posts big blind $0.10
*** HOLE CARDS ***
Impostore1988: folds 
hardouin: folds 
steinpilz1955: folds 
M0rganLeFaye: folds 
Uncalled bet ($0.05) returned to sapr.549
sapr.549 collected $0.10 from pot
sapr.549: doesn't show hand 
*** SUMMARY ***
Total pot $0.10 | Rake $0 
Seat 1: sapr.549 (big blind) collected ($0.10)
Seat 2: Impostore1988 folded before Flop (didn't bet)
Seat 3: hardouin folded before Flop (didn't bet)
Seat 4: steinpilz1955 (button) folded before Flop (didn't bet)
Seat 5: M0rganLeFaye (small blind) folded before Flop



PokerStars Hand #222966827806:  Hold'em No Limit ($0.05/$0.10 USD) - 2021/01/23 14:36:51 ET
Table 'Malzovia' 6-max Seat #5 is the button
Seat 1: sapr.549 ($13.29 in chips) 
Seat 2: Impostore1988 ($9.55 in chips) 
Seat 3: hardouin ($18.92 in chips) 
Seat 4: steinpilz1955 ($15.72 in chips) 
Seat 5: M0rganLeFaye ($14.31 in chips) 
sapr.549: posts small blind $0.05
Impostore1988: posts big blind $0.10
*** HOLE CARDS ***
hardouin: folds 
steinpilz1955: folds 
M0rganLeFaye: folds 
sapr.549: folds 
Uncalled bet ($0.05) returned to Impostore1988
Impostore1988 collected $0.10 from pot
Impostore1988: doesn't show hand 
*** SUMMARY ***
Total pot $0.10 | Rake $0 
Seat 1: sapr.549 (small blind) folded before Flop
Seat 2: Impostore1988 (big blind) collected ($0.10)
Seat 3: hardouin folded before Flop (didn't bet)
Seat 4: steinpilz1955 folded before Flop (didn't bet)
Seat 5: M0rganLeFaye (button) folded before Flop (didn't bet)



PokerStars Hand #222966842822:  Hold'em No Limit ($0.05/$0.10 USD) - 2021/01/23 14:37:10 ET
Table 'Malzovia' 6-max Seat #1 is the button
Seat 1: sapr.549 ($13.24 in chips) 
Seat 2: Impostore1988 ($9.60 in chips) 
Seat 3: hardouin ($18.92 in chips) 
Seat 4: steinpilz1955 ($15.72 in chips) 
Seat 5: M0rganLeFaye ($14.31 in chips) 
Seat 6: Acedan1369 ($26.78 in chips) 
Impostore1988: posts small blind $0.05
hardouin: posts big blind $0.10
Acedan1369: posts small & big blinds $0.15
*** HOLE CARDS ***
steinpilz1955: calls $0.10
M0rganLeFaye: raises $0.30 to $0.40
Acedan1369: folds 
sapr.549: folds 
Impostore1988: folds 
hardouin: folds 
steinpilz1955: calls $0.30
*** FLOP *** [8s 2c Qc]
steinpilz1955: checks 
M0rganLeFaye: checks 
*** TURN *** [8s 2c Qc] [Ac]
steinpilz1955: checks 
M0rganLeFaye: bets $0.32
steinpilz1955: folds 
Uncalled bet ($0.32) returned to M0rganLeFaye
M0rganLeFaye collected $1.05 from pot
*** SUMMARY ***
Total pot $1.10 | Rake $0.05 
Board [8s 2c Qc Ac]
Seat 1: sapr.549 (button) folded before Flop (didn't bet)
Seat 2: Impostore1988 (small blind) folded before Flop
Seat 3: hardouin (big blind) folded before Flop
Seat 4: steinpilz1955 folded on the Turn
Seat 5: M0rganLeFaye collected ($1.05)
Seat 6: Acedan1369 folded before Flop (didn't bet)



PokerStars Hand #222966896565:  Hold'em No Limit ($0.05/$0.10 USD) - 2021/01/23 14:38:19 ET
Table 'Malzovia' 6-max Seat #2 is the button
Seat 1: sapr.549 ($13.24 in chips) 
Seat 2: Impostore1988 ($9.55 in chips) 
Seat 3: hardouin ($18.82 in chips) 
Seat 4: steinpilz1955 ($15.32 in chips) 
Seat 5: M0rganLeFaye ($14.96 in chips) 
Seat 6: Acedan1369 ($26.63 in chips) 
hardouin: posts small blind $0.05
steinpilz1955: posts big blind $0.10
*** HOLE CARDS ***
M0rganLeFaye: folds 
Acedan1369: raises $0.15 to $0.25
sapr.549: folds 
Impostore1988: calls $0.25
hardouin: folds 
steinpilz1955: folds 
*** FLOP *** [Qd 4d 3h]
Acedan1369: checks 
Impostore1988: bets $0.31
Acedan1369: raises $0.79 to $1.10
Impostore1988: folds 
Uncalled bet ($0.79) returned to Acedan1369
Acedan1369 collected $1.21 from pot
Acedan1369: doesn't show hand 
*** SUMMARY ***
Total pot $1.27 | Rake $0.06 
Board [Qd 4d 3h]
Seat 1: sapr.549 folded before Flop (didn't bet)
Seat 2: Impostore1988 (button) folded on the Flop
Seat 3: hardouin (small blind) folded before Flop
Seat 4: steinpilz1955 (big blind) folded before Flop
Seat 5: M0rganLeFaye folded before Flop (didn't bet)
Seat 6: Acedan1369 collected ($1.21)



PokerStars Hand #222966936126:  Hold'em No Limit ($0.05/$0.10 USD) - 2021/01/23 14:39:10 ET
Table 'Malzovia' 6-max Seat #3 is the button
Seat 1: sapr.549 ($13.24 in chips) 
Seat 2: Impostore1988 ($8.99 in chips) 
Seat 3: hardouin ($18.77 in chips) 
Seat 4: steinpilz1955 ($15.22 in chips) 
Seat 6: Acedan1369 ($27.28 in chips) 
steinpilz1955: posts small blind $0.05
Acedan1369: posts big blind $0.10
*** HOLE CARDS ***
sapr.549: raises $0.20 to $0.30
Impostore1988: folds 
hardouin: folds 
steinpilz1955: folds 
Acedan1369: folds 
Uncalled bet ($0.20) returned to sapr.549
sapr.549 collected $0.25 from pot
sapr.549: doesn't show hand 
*** SUMMARY ***
Total pot $0.25 | Rake $0 
Seat 1: sapr.549 collected ($0.25)
Seat 2: Impostore1988 folded before Flop (didn't bet)
Seat 3: hardouin (button) folded before Flop (didn't bet)
Seat 4: steinpilz1955 (small blind) folded before Flop
Seat 6: Acedan1369 (big blind) folded before Flop



PokerStars Hand #222966952190:  Hold'em No Limit ($0.05/$0.10 USD) - 2021/01/23 14:39:30 ET
Table 'Malzovia' 6-max Seat #4 is the button
Seat 1: sapr.549 ($13.39 in chips) 
Seat 2: Impostore1988 ($10 in chips) 
Seat 3: hardouin ($18.77 in chips) 
Seat 4: steinpilz1955 ($15.17 in chips) 
Seat 6: Acedan1369 ($27.18 in chips) 
Acedan1369: posts small blind $0.05
sapr.549: posts big blind $0.10
*** HOLE CARDS ***
Impostore1988: folds 
hardouin: folds 
steinpilz1955 is disconnected 
steinpilz1955 has timed out while disconnected
steinpilz1955: folds 
Acedan1369: folds 
Uncalled bet ($0.05) returned to sapr.549
sapr.549 collected $0.10 from pot
sapr.549: doesn't show hand 
*** SUMMARY ***
Total pot $0.10 | Rake $0 
Seat 1: sapr.549 (big blind) collected ($0.10)
Seat 2: Impostore1988 folded before Flop (didn't bet)
Seat 3: hardouin folded before Flop (didn't bet)
Seat 4: steinpilz1955 (button) folded before Flop (didn't bet)
Seat 6: Acedan1369 (small blind) folded before Flop



PokerStars Hand #222966971146:  Hold'em No Limit ($0.05/$0.10 USD) - 2021/01/23 14:39:54 ET
Table 'Malzovia' 6-max Seat #6 is the button
Seat 1: sapr.549 ($13.44 in chips) 
Seat 2: Impostore1988 ($10 in chips) 
Seat 3: hardouin ($18.77 in chips) 
Seat 6: Acedan1369 ($27.13 in chips) 
sapr.549: posts small blind $0.05
Impostore1988: posts big blind $0.10
M0rganLeFaye: sits out 
*** HOLE CARDS ***
hardouin: folds 
Acedan1369: raises $0.15 to $0.25
sapr.549: folds 
Impostore1988: folds 
Uncalled bet ($0.15) returned to Acedan1369
Acedan1369 collected $0.25 from pot
Acedan1369: doesn't show hand 
*** SUMMARY ***
Total pot $0.25 | Rake $0 
Seat 1: sapr.549 (small blind) folded before Flop
Seat 2: Impostore1988 (big blind) folded before Flop
Seat 3: hardouin folded before Flop (didn't bet)
Seat 6: Acedan1369 (button) collected ($0.25)



PokerStars Hand #222966983523:  Hold'em No Limit ($0.05/$0.10 USD) - 2021/01/23 14:40:10 ET
Table 'Malzovia' 6-max Seat #1 is the button
Seat 1: sapr.549 ($13.39 in chips) 
Seat 2: Impostore1988 ($9.90 in chips) 
Seat 3: hardouin ($18.77 in chips) 
Seat 6: Acedan1369 ($27.28 in chips) 
Impostore1988: posts small blind $0.05
hardouin: posts big blind $0.10
M0rganLeFaye: sits out 
*** HOLE CARDS ***
Acedan1369: folds 
sapr.549: folds 
Impostore1988: folds 
Uncalled bet ($0.05) returned to hardouin
hardouin collected $0.10 from pot
hardouin: doesn't show hand 
*** SUMMARY ***
Total pot $0.10 | Rake $0 
Seat 1: sapr.549 (button) folded before Flop (didn't bet)
Seat 2: Impostore1988 (small blind) folded before Flop
Seat 3: hardouin (big blind) collected ($0.10)
Seat 6: Acedan1369 folded before Flop (didn't bet)



PokerStars Hand #222966990554:  Hold'em No Limit ($0.05/$0.10 USD) - 2021/01/23 14:40:19 ET
Table 'Malzovia' 6-max Seat #2 is the button
Seat 1: sapr.549 ($13.39 in chips) 
Seat 2: Impostore1988 ($9.85 in chips) 
Seat 3: hardouin ($18.82 in chips) 
Seat 5: M0rganLeFaye ($14.96 in chips) 
Seat 6: Acedan1369 ($27.28 in chips) 
hardouin: posts small blind $0.05
M0rganLeFaye: posts big blind $0.10
*** HOLE CARDS ***
Acedan1369: raises $0.15 to $0.25
sapr.549: folds 
Impostore1988: folds 
hardouin: calls $0.20
M0rganLeFaye: folds 
*** FLOP *** [6s 6h Ac]
hardouin: checks 
Acedan1369: checks 
*** TURN *** [6s 6h Ac] [As]
hardouin: checks 
Acedan1369: checks 
*** RIVER *** [6s 6h Ac As] [Kh]
hardouin: checks 
Acedan1369: checks 
*** SHOW DOWN ***
hardouin: shows [4c 4d] (two pair, Aces and Sixes)
Acedan1369: shows [8h Th] (two pair, Aces and Sixes)
hardouin collected $0.29 from pot
Acedan1369 collected $0.28 from pot
*** SUMMARY ***
Total pot $0.60 | Rake $0.03 
Board [6s 6h Ac As Kh]
Seat 1: sapr.549 folded before Flop (didn't bet)
Seat 2: Impostore1988 (button) folded before Flop (didn't bet)
Seat 3: hardouin (small blind) showed [4c 4d] and won ($0.29) with two pair, Aces and Sixes
Seat 5: M0rganLeFaye (big blind) folded before Flop
Seat 6: Acedan1369 showed [8h Th] and won ($0.28) with two pair, Aces and Sixes



PokerStars Hand #222967030047:  Hold'em No Limit ($0.05/$0.10 USD) - 2021/01/23 14:41:10 ET
Table 'Malzovia' 6-max Seat #3 is the button
Seat 1: sapr.549 ($13.39 in chips) 
Seat 2: Impostore1988 ($9.85 in chips) 
Seat 3: hardouin ($18.86 in chips) 
Seat 5: M0rganLeFaye ($14.86 in chips) 
Seat 6: Acedan1369 ($27.31 in chips) 
M0rganLeFaye: posts small blind $0.05
Acedan1369: posts big blind $0.10
*** HOLE CARDS ***
sapr.549: folds 
Impostore1988: folds 
hardouin: raises $0.15 to $0.25
M0rganLeFaye: folds 
Acedan1369: calls $0.15
*** FLOP *** [Kh Js 3s]
Acedan1369: checks 
hardouin: bets $0.27
Acedan1369: folds 
Uncalled bet ($0.27) returned to hardouin
hardouin collected $0.53 from pot
hardouin: doesn't show hand 
*** SUMMARY ***
Total pot $0.55 | Rake $0.02 
Board [Kh Js 3s]
Seat 1: sapr.549 folded before Flop (didn't bet)
Seat 2: Impostore1988 folded before Flop (didn't bet)
Seat 3: hardouin (button) collected ($0.53)
Seat 5: M0rganLeFaye (small blind) folded before Flop
Seat 6: Acedan1369 (big blind) folded on the Flop



PokerStars Hand #222967050869:  Hold'em No Limit ($0.05/$0.10 USD) - 2021/01/23 14:41:36 ET
Table 'Malzovia' 6-max Seat #5 is the button
Seat 1: sapr.549 ($13.39 in chips) 
Seat 2: Impostore1988 ($9.85 in chips) 
Seat 3: hardouin ($19.14 in chips) 
Seat 5: M0rganLeFaye ($14.81 in chips) 
Seat 6: Acedan1369 ($27.06 in chips) 
Acedan1369: posts small blind $0.05
sapr.549: posts big blind $0.10
*** HOLE CARDS ***
Impostore1988: folds 
hardouin: folds 
M0rganLeFaye: folds 
Acedan1369: folds 
Uncalled bet ($0.05) returned to sapr.549
sapr.549 collected $0.10 from pot
sapr.549: doesn't show hand 
*** SUMMARY ***
Total pot $0.10 | Rake $0 
Seat 1: sapr.549 (big blind) collected ($0.10)
Seat 2: Impostore1988 folded before Flop (didn't bet)
Seat 3: hardouin folded before Flop (didn't bet)
Seat 5: M0rganLeFaye (button) folded before Flop (didn't bet)
Seat 6: Acedan1369 (small blind) folded before Flop



PokerStars Hand #222967064606:  Hold'em No Limit ($0.05/$0.10 USD) - 2021/01/23 14:41:54 ET
Table 'Malzovia' 6-max Seat #6 is the button
Seat 1: sapr.549 ($13.44 in chips) 
Seat 2: Impostore1988 ($9.85 in chips) 
Seat 3: hardouin ($19.14 in chips) 
Seat 5: M0rganLeFaye ($14.81 in chips) 
Seat 6: Acedan1369 ($27.01 in chips) 
sapr.549: posts small blind $0.05
Impostore1988: posts big blind $0.10
*** HOLE CARDS ***
hardouin: folds 
M0rganLeFaye: raises $0.15 to $0.25
Acedan1369: folds 
sapr.549: folds 
Impostore1988: folds 
Uncalled bet ($0.15) returned to M0rganLeFaye
M0rganLeFaye collected $0.25 from pot
*** SUMMARY ***
Total pot $0.25 | Rake $0 
Seat 1: sapr.549 (small blind) folded before Flop
Seat 2: Impostore1988 (big blind) folded before Flop
Seat 3: hardouin folded before Flop (didn't bet)
Seat 5: M0rganLeFaye collected ($0.25)
Seat 6: Acedan1369 (button) folded before Flop (didn't bet)



PokerStars Hand #222967083872:  Hold'em No Limit ($0.05/$0.10 USD) - 2021/01/23 14:42:18 ET
Table 'Malzovia' 6-max Seat #1 is the button
Seat 1: sapr.549 ($13.39 in chips) 
Seat 2: Impostore1988 ($9.75 in chips) 
Seat 3: hardouin ($19.14 in chips) 
Seat 5: M0rganLeFaye ($14.96 in chips) 
Seat 6: Acedan1369 ($27.01 in chips) 
Impostore1988: posts small blind $0.05
hardouin: posts big blind $0.10
*** HOLE CARDS ***
M0rganLeFaye: folds 
Acedan1369: folds 
sapr.549: folds 
Impostore1988: folds 
Uncalled bet ($0.05) returned to hardouin
hardouin collected $0.10 from pot
hardouin: doesn't show hand 
*** SUMMARY ***
Total pot $0.10 | Rake $0 
Seat 1: sapr.549 (button) folded before Flop (didn't bet)
Seat 2: Impostore1988 (small blind) folded before Flop
Seat 3: hardouin (big blind) collected ($0.10)
Seat 5: M0rganLeFaye folded before Flop (didn't bet)
Seat 6: Acedan1369 folded before Flop (didn't bet)



PokerStars Hand #222967094930:  Hold'em No Limit ($0.05/$0.10 USD) - 2021/01/23 14:42:32 ET
Table 'Malzovia' 6-max Seat #2 is the button
Seat 1: sapr.549 ($13.39 in chips) 
Seat 2: Impostore1988 ($9.70 in chips) 
Seat 3: hardouin ($19.19 in chips) 
Seat 5: M0rganLeFaye ($14.96 in chips) 
Seat 6: Acedan1369 ($27.01 in chips) 
hardouin: posts small blind $0.05
M0rganLeFaye: posts big blind $0.10
*** HOLE CARDS ***
Acedan1369: folds 
sapr.549: folds 
Impostore1988: folds 
hardouin: folds 
Uncalled bet ($0.05) returned to M0rganLeFaye
M0rganLeFaye collected $0.10 from pot
*** SUMMARY ***
Total pot $0.10 | Rake $0 
Seat 1: sapr.549 folded before Flop (didn't bet)
Seat 2: Impostore1988 (button) folded before Flop (didn't bet)
Seat 3: hardouin (small blind) folded before Flop
Seat 5: M0rganLeFaye (big blind) collected ($0.10)
Seat 6: Acedan1369 folded before Flop (didn't bet)



PokerStars Hand #222967106005:  Hold'em No Limit ($0.05/$0.10 USD) - 2021/01/23 14:42:46 ET
Table 'Malzovia' 6-max Seat #3 is the button
Seat 1: sapr.549 ($13.39 in chips) 
Seat 2: Impostore1988 ($9.70 in chips) 
Seat 3: hardouin ($19.14 in chips) 
Seat 5: M0rganLeFaye ($15.01 in chips) 
Seat 6: Acedan1369 ($27.01 in chips) 
M0rganLeFaye: posts small blind $0.05
Acedan1369: posts big blind $0.10
*** HOLE CARDS ***
sapr.549: folds 
Impostore1988: folds 
hardouin: folds 
M0rganLeFaye: folds 
Uncalled bet ($0.05) returned to Acedan1369
Acedan1369 collected $0.10 from pot
Acedan1369: doesn't show hand 
*** SUMMARY ***
Total pot $0.10 | Rake $0 
Seat 1: sapr.549 folded before Flop (didn't bet)
Seat 2: Impostore1988 folded before Flop (didn't bet)
Seat 3: hardouin (button) folded before Flop (didn't bet)
Seat 5: M0rganLeFaye (small blind) folded before Flop
Seat 6: Acedan1369 (big blind) collected ($0.10)



PokerStars Hand #222967115444:  Hold'em No Limit ($0.05/$0.10 USD) - 2021/01/23 14:42:59 ET
Table 'Malzovia' 6-max Seat #5 is the button
Seat 1: sapr.549 ($13.39 in chips) 
Seat 2: Impostore1988 ($9.70 in chips) 
Seat 3: hardouin ($19.14 in chips) 
Seat 5: M0rganLeFaye ($14.96 in chips) 
Seat 6: Acedan1369 ($27.06 in chips) 
Acedan1369: posts small blind $0.05
sapr.549: posts big blind $0.10
*** HOLE CARDS ***
Impostore1988: folds 
hardouin: folds 
M0rganLeFaye: folds 
Acedan1369: raises $0.15 to $0.25
sapr.549: calls $0.15
*** FLOP *** [7s Jc 3h]
Acedan1369: checks 
sapr.549: checks 
*** TURN *** [7s Jc 3h] [As]
Acedan1369: checks 
sapr.549: checks 
*** RIVER *** [7s Jc 3h As] [3c]
Acedan1369: checks 
sapr.549: bets $0.32
Acedan1369: calls $0.32
*** SHOW DOWN ***
sapr.549: shows [5c 6c] (a pair of Threes)
Acedan1369: shows [Kh Js] (two pair, Jacks and Threes)
Acedan1369 collected $1.09 from pot
*** SUMMARY ***
Total pot $1.14 | Rake $0.05 
Board [7s Jc 3h As 3c]
Seat 1: sapr.549 (big blind) showed [5c 6c] and lost with a pair of Threes
Seat 2: Impostore1988 folded before Flop (didn't bet)
Seat 3: hardouin folded before Flop (didn't bet)
Seat 5: M0rganLeFaye (button) folded before Flop (didn't bet)
Seat 6: Acedan1369 (small blind) showed [Kh Js] and won ($1.09) with two pair, Jacks and Threes



PokerStars Hand #222967160814:  Hold'em No Limit ($0.05/$0.10 USD) - 2021/01/23 14:43:57 ET
Table 'Malzovia' 6-max Seat #6 is the button
Seat 1: sapr.549 ($12.82 in chips) 
Seat 2: Impostore1988 ($9.70 in chips) 
Seat 3: hardouin ($19.14 in chips) 
Seat 5: M0rganLeFaye ($14.96 in chips) 
Seat 6: Acedan1369 ($27.58 in chips) 
sapr.549: posts small blind $0.05
Impostore1988: posts big blind $0.10
steinpilz1955: sits out 
*** HOLE CARDS ***
hardouin: folds 
M0rganLeFaye: folds 
Acedan1369: folds 
sapr.549: raises $0.15 to $0.25
Impostore1988: folds 
Uncalled bet ($0.15) returned to sapr.549
sapr.549 collected $0.20 from pot
sapr.549: doesn't show hand 
*** SUMMARY ***
Total pot $0.20 | Rake $0 
Seat 1: sapr.549 (small blind) collected ($0.20)
Seat 2: Impostore1988 (big blind) folded before Flop
Seat 3: hardouin folded before Flop (didn't bet)
Seat 5: M0rganLeFaye folded before Flop (didn't bet)
Seat 6: Acedan1369 (button) folded before Flop (didn't bet)



PokerStars Hand #222967171518:  Hold'em No Limit ($0.05/$0.10 USD) - 2021/01/23 14:44:10 ET
Table 'Malzovia' 6-max Seat #1 is the button
Seat 1: sapr.549 ($12.92 in chips) 
Seat 2: Impostore1988 ($9.60 in chips) 
Seat 3: hardouin ($19.14 in chips) 
Seat 5: M0rganLeFaye ($14.96 in chips) 
Seat 6: Acedan1369 ($27.58 in chips) 
Impostore1988: posts small blind $0.05
hardouin: posts big blind $0.10
steinpilz1955: sits out 
*** HOLE CARDS ***
M0rganLeFaye: folds 
Acedan1369: folds 
sapr.549: folds 
Impostore1988: folds 
Uncalled bet ($0.05) returned to hardouin
hardouin collected $0.10 from pot
hardouin: doesn't show hand 
*** SUMMARY ***
Total pot $0.10 | Rake $0 
Seat 1: sapr.549 (button) folded before Flop (didn't bet)
Seat 2: Impostore1988 (small blind) folded before Flop
Seat 3: hardouin (big blind) collected ($0.10)
Seat 5: M0rganLeFaye folded before Flop (didn't bet)
Seat 6: Acedan1369 folded before Flop (didn't bet)



PokerStars Hand #222967179364:  Hold'em No Limit ($0.05/$0.10 USD) - 2021/01/23 14:44:20 ET
Table 'Malzovia' 6-max Seat #2 is the button
Seat 1: sapr.549 ($12.92 in chips) 
Seat 2: Impostore1988 ($9.55 in chips) 
Seat 3: hardouin ($19.19 in chips) 
Seat 4: steinpilz1955 ($15.17 in chips) 
Seat 5: M0rganLeFaye ($14.96 in chips) 
Seat 6: Acedan1369 ($27.58 in chips) 
hardouin: posts small blind $0.05
steinpilz1955: posts big blind $0.10
*** HOLE CARDS ***
M0rganLeFaye: folds 
Acedan1369: raises $0.15 to $0.25
sapr.549: folds 
Impostore1988: folds 
hardouin: folds 
steinpilz1955: folds 
Uncalled bet ($0.15) returned to Acedan1369
Acedan1369 collected $0.25 from pot
Acedan1369: doesn't show hand 
*** SUMMARY ***
Total pot $0.25 | Rake $0 
Seat 1: sapr.549 folded before Flop (didn't bet)
Seat 2: Impostore1988 (button) folded before Flop (didn't bet)
Seat 3: hardouin (small blind) folded before Flop
Seat 4: steinpilz1955 (big blind) folded before Flop
Seat 5: M0rganLeFaye folded before Flop (didn't bet)
Seat 6: Acedan1369 collected ($0.25)



PokerStars Hand #222967192972:  Hold'em No Limit ($0.05/$0.10 USD) - 2021/01/23 14:44:38 ET
Table 'Malzovia' 6-max Seat #3 is the button
Seat 1: sapr.549 ($12.92 in chips) 
Seat 2: Impostore1988 ($9.55 in chips) 
Seat 3: hardouin ($19.14 in chips) 
Seat 4: steinpilz1955 ($15.07 in chips) 
Seat 5: M0rganLeFaye ($14.96 in chips) 
Seat 6: Acedan1369 ($27.73 in chips) 
steinpilz1955: posts small blind $0.05
M0rganLeFaye: posts big blind $0.10
*** HOLE CARDS ***
Acedan1369: folds 
sapr.549: folds 
Impostore1988: folds 
hardouin: folds 
steinpilz1955: calls $0.05
M0rganLeFaye: checks 
*** FLOP *** [Td 5d Ts]
steinpilz1955: checks 
M0rganLeFaye: bets $0.10
steinpilz1955: calls $0.10
*** TURN *** [Td 5d Ts] [Th]
steinpilz1955: checks 
M0rganLeFaye: bets $0.10
steinpilz1955: calls $0.10
*** RIVER *** [Td 5d Ts Th] [7c]
steinpilz1955: bets $0.30
M0rganLeFaye: calls $0.30
*** SHOW DOWN ***
steinpilz1955: shows [7h Kd] (a full house, Tens full of Sevens)
M0rganLeFaye: mucks hand 
steinpilz1955 collected $1.15 from pot
*** SUMMARY ***
Total pot $1.20 | Rake $0.05 
Board [Td 5d Ts Th 7c]
Seat 1: sapr.549 folded before Flop (didn't bet)
Seat 2: Impostore1988 folded before Flop (didn't bet)
Seat 3: hardouin (button) folded before Flop (didn't bet)
Seat 4: steinpilz1955 (small blind) showed [7h Kd] and won ($1.15) with a full house, Tens full of Sevens
Seat 5: M0rganLeFaye (big blind) mucked
Seat 6: Acedan1369 folded before Flop (didn't bet)



PokerStars Hand #222967235261:  Hold'em No Limit ($0.05/$0.10 USD) - 2021/01/23 14:45:32 ET
Table 'Malzovia' 6-max Seat #4 is the button
Seat 1: sapr.549 ($12.92 in chips) 
Seat 2: Impostore1988 ($9.55 in chips) 
Seat 3: hardouin ($19.14 in chips) 
Seat 4: steinpilz1955 ($15.62 in chips) 
Seat 5: M0rganLeFaye ($14.36 in chips) 
Seat 6: Acedan1369 ($27.73 in chips) 
M0rganLeFaye: posts small blind $0.05
Acedan1369: posts big blind $0.10
*** HOLE CARDS ***
sapr.549: folds 
Impostore1988: folds 
hardouin: folds 
steinpilz1955: folds 
M0rganLeFaye: raises $0.15 to $0.25
Acedan1369: raises $0.60 to $0.85
M0rganLeFaye: calls $0.60
*** FLOP *** [Td 8h Kc]
M0rganLeFaye: checks 
Acedan1369: bets $0.73
Impostore1988 leaves the table
AAA_set_nh joins the table at seat #2 
M0rganLeFaye: calls $0.73
*** TURN *** [Td 8h Kc] [8s]
M0rganLeFaye: checks 
Acedan1369: bets $1
M0rganLeFaye: calls $1
*** RIVER *** [Td 8h Kc 8s] [Qc]
M0rganLeFaye: checks 
Acedan1369: bets $2.80
M0rganLeFaye: calls $2.80
*** SHOW DOWN ***
Acedan1369: shows [Ac 6d] (a pair of Eights)
M0rganLeFaye: shows [Jc 8c] (three of a kind, Eights)
M0rganLeFaye collected $10.28 from pot
*** SUMMARY ***
Total pot $10.76 | Rake $0.48 
Board [Td 8h Kc 8s Qc]
Seat 1: sapr.549 folded before Flop (didn't bet)
Seat 2: Impostore1988 folded before Flop (didn't bet)
Seat 3: hardouin folded before Flop (didn't bet)
Seat 4: steinpilz1955 (button) folded before Flop (didn't bet)
Seat 5: M0rganLeFaye (small blind) showed [Jc 8c] and won ($10.28) with three of a kind, Eights
Seat 6: Acedan1369 (big blind) showed [Ac 6d] and lost with a pair of Eights



PokerStars Hand #222967322314:  Hold'em No Limit ($0.05/$0.10 USD) - 2021/01/23 14:47:24 ET
Table 'Malzovia' 6-max Seat #5 is the button
Seat 1: sapr.549 ($12.92 in chips) 
Seat 3: hardouin ($19.14 in chips) 
Seat 4: steinpilz1955 ($15.62 in chips) 
Seat 5: M0rganLeFaye ($19.26 in chips) 
Seat 6: Acedan1369 ($22.35 in chips) 
Acedan1369: posts small blind $0.05
sapr.549: posts big blind $0.10
AAA_set_nh: sits out 
*** HOLE CARDS ***
hardouin: folds 
steinpilz1955: folds 
M0rganLeFaye: folds 
Acedan1369: folds 
Uncalled bet ($0.05) returned to sapr.549
sapr.549 collected $0.10 from pot
sapr.549: doesn't show hand 
*** SUMMARY ***
Total pot $0.10 | Rake $0 
Seat 1: sapr.549 (big blind) collected ($0.10)
Seat 3: hardouin folded before Flop (didn't bet)
Seat 4: steinpilz1955 folded before Flop (didn't bet)
Seat 5: M0rganLeFaye (button) folded before Flop (didn't bet)
Seat 6: Acedan1369 (small blind) folded before Flop



PokerStars Hand #222968559891:  Hold'em No Limit ($0.05/$0.10 USD) - 2021/01/23 15:14:34 ET
Table 'Malzovia' 6-max Seat #5 is the button
Seat 1: sapr.549 ($6.68 in chips) 
Seat 2: ganryu76 ($10.18 in chips) 
Seat 4: steinpilz1955 ($11.06 in chips) 
Seat 5: VisirMartin ($10.65 in chips) 
Seat 6: Acedan1369 ($26.47 in chips) 
Acedan1369: posts small blind $0.05
sapr.549: posts big blind $0.10
*** HOLE CARDS ***
ganryu76: folds 
steinpilz1955: raises $0.20 to $0.30
VisirMartin: folds 
Acedan1369: folds 
sapr.549: folds 
Uncalled bet ($0.20) returned to steinpilz1955
steinpilz1955 collected $0.25 from pot
*** SUMMARY ***
Total pot $0.25 | Rake $0 
Seat 1: sapr.549 (big blind) folded before Flop
Seat 2: ganryu76 folded before Flop (didn't bet)
Seat 4: steinpilz1955 collected ($0.25)
Seat 5: VisirMartin (button) folded before Flop (didn't bet)
Seat 6: Acedan1369 (small blind) folded before Flop



PokerStars Hand #222968577315:  Hold'em No Limit ($0.05/$0.10 USD) - 2021/01/23 15:14:55 ET
Table 'Malzovia' 6-max Seat #6 is the button
Seat 1: sapr.549 ($6.58 in chips) 
Seat 2: ganryu76 ($10.18 in chips) 
Seat 4: steinpilz1955 ($11.21 in chips) 
Seat 5: VisirMartin ($10.65 in chips) 
Seat 6: Acedan1369 ($26.42 in chips) 
sapr.549: posts small blind $0.05
ganryu76: posts big blind $0.10
*** HOLE CARDS ***
steinpilz1955: folds 
VisirMartin: folds 
Acedan1369: folds 
sapr.549: folds 
Uncalled bet ($0.05) returned to ganryu76
ganryu76 collected $0.10 from pot
ganryu76: doesn't show hand 
*** SUMMARY ***
Total pot $0.10 | Rake $0 
Seat 1: sapr.549 (small blind) folded before Flop
Seat 2: ganryu76 (big blind) collected ($0.10)
Seat 4: steinpilz1955 folded before Flop (didn't bet)
Seat 5: VisirMartin folded before Flop (didn't bet)
Seat 6: Acedan1369 (button) folded before Flop (didn't bet)



PokerStars Hand #222968588272:  Hold'em No Limit ($0.05/$0.10 USD) - 2021/01/23 15:15:08 ET
Table 'Malzovia' 6-max Seat #1 is the button
Seat 1: sapr.549 ($6.53 in chips) 
Seat 2: ganryu76 ($10.23 in chips) 
Seat 4: steinpilz1955 ($11.21 in chips) 
Seat 5: VisirMartin ($10.65 in chips) 
Seat 6: Acedan1369 ($26.42 in chips) 
ganryu76: posts small blind $0.05
steinpilz1955: posts big blind $0.10
*** HOLE CARDS ***
VisirMartin: folds 
Acedan1369: folds 
sapr.549: folds 
ganryu76: folds 
Uncalled bet ($0.05) returned to steinpilz1955
steinpilz1955 collected $0.10 from pot
*** SUMMARY ***
Total pot $0.10 | Rake $0 
Seat 1: sapr.549 (button) folded before Flop (didn't bet)
Seat 2: ganryu76 (small blind) folded before Flop
Seat 4: steinpilz1955 (big blind) collected ($0.10)
Seat 5: VisirMartin folded before Flop (didn't bet)
Seat 6: Acedan1369 folded before Flop (didn't bet)



PokerStars Hand #222968602367:  Hold'em No Limit ($0.05/$0.10 USD) - 2021/01/23 15:15:23 ET
Table 'Malzovia' 6-max Seat #2 is the button
Seat 1: sapr.549 ($6.53 in chips) 
Seat 2: ganryu76 ($10.18 in chips) 
Seat 4: steinpilz1955 ($11.26 in chips) 
Seat 5: VisirMartin ($10.65 in chips) 
Seat 6: Acedan1369 ($26.42 in chips) 
steinpilz1955: posts small blind $0.05
VisirMartin: posts big blind $0.10
*** HOLE CARDS ***
Acedan1369: folds 
sapr.549: raises $0.12 to $0.22
ganryu76: calls $0.22
steinpilz1955: calls $0.17
VisirMartin: folds 
*** FLOP *** [7c 5c 8d]
steinpilz1955: checks 
sapr.549: bets $0.64
ganryu76: folds 
steinpilz1955: calls $0.64
*** TURN *** [7c 5c 8d] [Qc]
steinpilz1955: checks 
sapr.549: checks 
*** RIVER *** [7c 5c 8d Qc] [Ks]
steinpilz1955: checks 
sapr.549: bets $1.72
steinpilz1955: folds 
Uncalled bet ($1.72) returned to sapr.549
sapr.549 collected $1.95 from pot
sapr.549: doesn't show hand 
*** SUMMARY ***
Total pot $2.04 | Rake $0.09 
Board [7c 5c 8d Qc Ks]
Seat 1: sapr.549 collected ($1.95)
Seat 2: ganryu76 (button) folded on the Flop
Seat 4: steinpilz1955 (small blind) folded on the River
Seat 5: VisirMartin (big blind) folded before Flop
Seat 6: Acedan1369 folded before Flop (didn't bet)



PokerStars Hand #222968653689:  Hold'em No Limit ($0.05/$0.10 USD) - 2021/01/23 15:16:24 ET
Table 'Malzovia' 6-max Seat #4 is the button
Seat 1: sapr.549 ($7.62 in chips) 
Seat 2: ganryu76 ($10 in chips) 
Seat 4: steinpilz1955 ($10.40 in chips) 
Seat 5: VisirMartin ($10.55 in chips) 
Seat 6: Acedan1369 ($26.42 in chips) 
VisirMartin: posts small blind $0.05
Acedan1369: posts big blind $0.10
*** HOLE CARDS ***
sapr.549: folds 
ganryu76: folds 
steinpilz1955: raises $0.30 to $0.40
VisirMartin: calls $0.35
Acedan1369: calls $0.30
*** FLOP *** [Ts As Kd]
VisirMartin: bets $0.75
Acedan1369: folds 
steinpilz1955: calls $0.75
*** TURN *** [Ts As Kd] [7h]
VisirMartin: bets $1.68
steinpilz1955: calls $1.68
*** RIVER *** [Ts As Kd 7h] [8c]
VisirMartin: checks 
steinpilz1955: bets $4.60
VisirMartin: calls $4.60
*** SHOW DOWN ***
steinpilz1955: shows [7s Js] (a pair of Sevens)
VisirMartin: shows [Th Kc] (two pair, Kings and Tens)
VisirMartin collected $14.57 from pot
*** SUMMARY ***
Total pot $15.26 | Rake $0.69 
Board [Ts As Kd 7h 8c]
Seat 1: sapr.549 folded before Flop (didn't bet)
Seat 2: ganryu76 folded before Flop (didn't bet)
Seat 4: steinpilz1955 (button) showed [7s Js] and lost with a pair of Sevens
Seat 5: VisirMartin (small blind) showed [Th Kc] and won ($14.57) with two pair, Kings and Tens
Seat 6: Acedan1369 (big blind) folded on the Flop



PokerStars Hand #222968712987:  Hold'em No Limit ($0.05/$0.10 USD) - 2021/01/23 15:17:33 ET
Table 'Malzovia' 6-max Seat #5 is the button
Seat 1: sapr.549 ($7.62 in chips) 
Seat 2: ganryu76 ($10 in chips) 
Seat 5: VisirMartin ($17.69 in chips) 
Seat 6: Acedan1369 ($26.02 in chips) 
Acedan1369: posts small blind $0.05
sapr.549: posts big blind $0.10
*** HOLE CARDS ***
ganryu76: folds 
VisirMartin: folds 
Acedan1369: folds 
Uncalled bet ($0.05) returned to sapr.549
sapr.549 collected $0.10 from pot
sapr.549: doesn't show hand 
*** SUMMARY ***
Total pot $0.10 | Rake $0 
Seat 1: sapr.549 (big blind) collected ($0.10)
Seat 2: ganryu76 folded before Flop (didn't bet)
Seat 5: VisirMartin (button) folded before Flop (didn't bet)
Seat 6: Acedan1369 (small blind) folded before Flop



PokerStars Hand #222968728996:  Hold'em No Limit ($0.05/$0.10 USD) - 2021/01/23 15:17:52 ET
Table 'Malzovia' 6-max Seat #6 is the button
Seat 1: sapr.549 ($7.67 in chips) 
Seat 2: ganryu76 ($10 in chips) 
Seat 5: VisirMartin ($17.69 in chips) 
Seat 6: Acedan1369 ($25.97 in chips) 
sapr.549: posts small blind $0.05
ganryu76: posts big blind $0.10
*** HOLE CARDS ***
VisirMartin: folds 
Acedan1369: raises $0.15 to $0.25
sapr.549: folds 
ganryu76: folds 
Uncalled bet ($0.15) returned to Acedan1369
Acedan1369 collected $0.25 from pot
Acedan1369: doesn't show hand 
*** SUMMARY ***
Total pot $0.25 | Rake $0 
Seat 1: sapr.549 (small blind) folded before Flop
Seat 2: ganryu76 (big blind) folded before Flop
Seat 5: VisirMartin folded before Flop (didn't bet)
Seat 6: Acedan1369 (button) collected ($0.25)



PokerStars Hand #222968744253:  Hold'em No Limit ($0.05/$0.10 USD) - 2021/01/23 15:18:10 ET
Table 'Malzovia' 6-max Seat #1 is the button
Seat 1: sapr.549 ($7.62 in chips) 
Seat 2: ganryu76 ($10 in chips) 
Seat 6: Acedan1369 ($26.12 in chips) 
ganryu76: posts small blind $0.05
VisirMartin: is sitting out 
Acedan1369: posts big blind $0.10
*** HOLE CARDS ***
sapr.549: folds 
ganryu76: folds 
Uncalled bet ($0.05) returned to Acedan1369
Acedan1369 collected $0.10 from pot
hardouin was removed from the table for failing to post
hardouin leaves the table
Acedan1369: doesn't show hand 
*** SUMMARY ***
Total pot $0.10 | Rake $0 
Seat 1: sapr.549 (button) folded before Flop (didn't bet)
Seat 2: ganryu76 (small blind) folded before Flop
Seat 6: Acedan1369 (big blind) collected ($0.10)



PokerStars Hand #222968750344:  Hold'em No Limit ($0.05/$0.10 USD) - 2021/01/23 15:18:17 ET
Table 'Malzovia' 6-max Seat #2 is the button
Seat 1: sapr.549 ($7.62 in chips) 
Seat 2: ganryu76 ($10 in chips) 
Seat 6: Acedan1369 ($26.17 in chips) 
Acedan1369: posts small blind $0.05
sapr.549: posts big blind $0.10
*** HOLE CARDS ***
ganryu76: folds 
Acedan1369: raises $0.15 to $0.25
sapr.549: folds 
Uncalled bet ($0.15) returned to Acedan1369
Acedan1369 collected $0.20 from pot
Acedan1369: doesn't show hand 
*** SUMMARY ***
Total pot $0.20 | Rake $0 
Seat 1: sapr.549 (big blind) folded before Flop
Seat 2: ganryu76 (button) folded before Flop (didn't bet)
Seat 6: Acedan1369 (small blind) collected ($0.20)



PokerStars Hand #222968761045:  Hold'em No Limit ($0.05/$0.10 USD) - 2021/01/23 15:18:30 ET
Table 'Malzovia' 6-max Seat #6 is the button
Seat 1: sapr.549 ($7.52 in chips) 
Seat 2: ganryu76 ($10 in chips) 
Seat 6: Acedan1369 ($26.27 in chips) 
sapr.549: posts small blind $0.05
ganryu76: posts big blind $0.10
*** HOLE CARDS ***
Acedan1369: raises $0.15 to $0.25
sapr.549: folds 
mario0887 joins the table at seat #3 
ganryu76: raises $0.75 to $1
Acedan1369: calls $0.75
*** FLOP *** [Ts 9h 5c]
ganryu76: bets $1.40
iwant2bking joins the table at seat #4 
Acedan1369: folds 
Uncalled bet ($1.40) returned to ganryu76
ganryu76 collected $1.96 from pot
ganryu76: doesn't show hand 
*** SUMMARY ***
Total pot $2.05 | Rake $0.09 
Board [Ts 9h 5c]
Seat 1: sapr.549 (small blind) folded before Flop
Seat 2: ganryu76 (big blind) collected ($1.96)
Seat 6: Acedan1369 (button) folded on the Flop



PokerStars Hand #222968796252:  Hold'em No Limit ($0.05/$0.10 USD) - 2021/01/23 15:19:11 ET
Table 'Malzovia' 6-max Seat #1 is the button
Seat 1: sapr.549 ($7.47 in chips) 
Seat 2: ganryu76 ($10.96 in chips) 
Seat 3: mario0887 ($10 in chips) 
Seat 6: Acedan1369 ($25.27 in chips) 
ganryu76: posts small blind $0.05
mario0887: posts big blind $0.10
iwant2bking: sits out 
*** HOLE CARDS ***
Acedan1369: folds 
sapr.549: folds 
ganryu76: folds 
Uncalled bet ($0.05) returned to mario0887
mario0887 collected $0.10 from pot
mario0887: doesn't show hand 
*** SUMMARY ***
Total pot $0.10 | Rake $0 
Seat 1: sapr.549 (button) folded before Flop (didn't bet)
Seat 2: ganryu76 (small blind) folded before Flop
Seat 3: mario0887 (big blind) collected ($0.10)
Seat 6: Acedan1369 folded before Flop (didn't bet)



PokerStars Hand #222968804659:  Hold'em No Limit ($0.05/$0.10 USD) - 2021/01/23 15:19:21 ET
Table 'Malzovia' 6-max Seat #3 is the button
Seat 1: sapr.549 ($7.47 in chips) 
Seat 3: mario0887 ($10.05 in chips) 
Seat 6: Acedan1369 ($25.27 in chips) 
Acedan1369: posts small blind $0.05
sapr.549: posts big blind $0.10
*** HOLE CARDS ***
mario0887: folds 
Acedan1369: raises $0.15 to $0.25
VisirMartin leaves the table
sapr.549: folds 
Uncalled bet ($0.15) returned to Acedan1369
Acedan1369 collected $0.20 from pot
Acedan1369: doesn't show hand 
Gissbon joins the table at seat #5 
*** SUMMARY ***
Total pot $0.20 | Rake $0 
Seat 1: sapr.549 (big blind) folded before Flop
Seat 3: mario0887 (button) folded before Flop (didn't bet)
Seat 6: Acedan1369 (small blind) collected ($0.20)



PokerStars Hand #222968815148:  Hold'em No Limit ($0.05/$0.10 USD) - 2021/01/23 15:19:33 ET
Table 'Malzovia' 6-max Seat #6 is the button
Seat 1: sapr.549 ($7.37 in chips) 
Seat 2: ganryu76 ($10.91 in chips) 
Seat 3: mario0887 ($10.05 in chips) 
Seat 6: Acedan1369 ($25.37 in chips) 
sapr.549: posts small blind $0.05
ganryu76: posts big blind $0.10
iwant2bking: sits out 
*** HOLE CARDS ***
mario0887: folds 
Acedan1369: folds 
sapr.549: folds 
Uncalled bet ($0.05) returned to ganryu76
ganryu76 collected $0.10 from pot
ganryu76: doesn't show hand 
*** SUMMARY ***
Total pot $0.10 | Rake $0 
Seat 1: sapr.549 (small blind) folded before Flop
Seat 2: ganryu76 (big blind) collected ($0.10)
Seat 3: mario0887 folded before Flop (didn't bet)
Seat 6: Acedan1369 (button) folded before Flop (didn't bet)



PokerStars Hand #222968823779:  Hold'em No Limit ($0.05/$0.10 USD) - 2021/01/23 15:19:43 ET
Table 'Malzovia' 6-max Seat #1 is the button
Seat 1: sapr.549 ($7.32 in chips) 
Seat 2: ganryu76 ($10.96 in chips) 
Seat 3: mario0887 ($10.05 in chips) 
Seat 6: Acedan1369 ($25.37 in chips) 
ganryu76: posts small blind $0.05
mario0887: posts big blind $0.10
iwant2bking: sits out 
Gissbon: sits out 
*** HOLE CARDS ***
Acedan1369: folds 
sapr.549: folds 
ganryu76: folds 
Uncalled bet ($0.05) returned to mario0887
mario0887 collected $0.10 from pot
mario0887: doesn't show hand 
*** SUMMARY ***
Total pot $0.10 | Rake $0 
Seat 1: sapr.549 (button) folded before Flop (didn't bet)
Seat 2: ganryu76 (small blind) folded before Flop
Seat 3: mario0887 (big blind) collected ($0.10)
Seat 6: Acedan1369 folded before Flop (didn't bet)



PokerStars Hand #222968832583:  Hold'em No Limit ($0.05/$0.10 USD) - 2021/01/23 15:19:53 ET
Table 'Malzovia' 6-max Seat #2 is the button
Seat 1: sapr.549 ($7.32 in chips) 
Seat 2: ganryu76 ($10.91 in chips) 
Seat 3: mario0887 ($10.10 in chips) 
Seat 4: iwant2bking ($8 in chips) 
Seat 6: Acedan1369 ($25.37 in chips) 
mario0887: posts small blind $0.05
iwant2bking: posts big blind $0.10
Gissbon: sits out 
*** HOLE CARDS ***
Acedan1369: folds 
sapr.549: raises $0.15 to $0.25
ganryu76: folds 
mario0887: folds 
iwant2bking: folds 
Uncalled bet ($0.15) returned to sapr.549
sapr.549 collected $0.25 from pot
sapr.549: doesn't show hand 
*** SUMMARY ***
Total pot $0.25 | Rake $0 
Seat 1: sapr.549 collected ($0.25)
Seat 2: ganryu76 (button) folded before Flop (didn't bet)
Seat 3: mario0887 (small blind) folded before Flop
Seat 4: iwant2bking (big blind) folded before Flop
Seat 6: Acedan1369 folded before Flop (didn't bet)



PokerStars Hand #222968861298:  Hold'em No Limit ($0.05/$0.10 USD) - 2021/01/23 15:20:27 ET
Table 'Malzovia' 6-max Seat #3 is the button
Seat 1: sapr.549 ($7.47 in chips) 
Seat 2: ganryu76 ($10.91 in chips) 
Seat 3: mario0887 ($10.05 in chips) 
Seat 4: iwant2bking ($7.90 in chips) 
Seat 5: Gissbon ($10 in chips) 
Seat 6: Acedan1369 ($25.37 in chips) 
iwant2bking: posts small blind $0.05
Gissbon: posts big blind $0.10
*** HOLE CARDS ***
Acedan1369: folds 
sapr.549: folds 
ganryu76: raises $0.15 to $0.25
mario0887: folds 
iwant2bking has timed out
iwant2bking: folds 
Gissbon: folds 
Uncalled bet ($0.15) returned to ganryu76
ganryu76 collected $0.25 from pot
ganryu76: doesn't show hand 
*** SUMMARY ***
Total pot $0.25 | Rake $0 
Seat 1: sapr.549 folded before Flop (didn't bet)
Seat 2: ganryu76 collected ($0.25)
Seat 3: mario0887 (button) folded before Flop (didn't bet)
Seat 4: iwant2bking (small blind) folded before Flop
Seat 5: Gissbon (big blind) folded before Flop
Seat 6: Acedan1369 folded before Flop (didn't bet)



PokerStars Hand #222968897195:  Hold'em No Limit ($0.05/$0.10 USD) - 2021/01/23 15:21:08 ET
Table 'Malzovia' 6-max Seat #4 is the button
Seat 1: sapr.549 ($7.47 in chips) 
Seat 2: ganryu76 ($11.06 in chips) 
Seat 3: mario0887 ($10.05 in chips) 
Seat 4: iwant2bking ($7.85 in chips) 
Seat 5: Gissbon ($10 in chips) 
Seat 6: Acedan1369 ($25.37 in chips) 
Gissbon: posts small blind $0.05
Acedan1369: posts big blind $0.10
*** HOLE CARDS ***
sapr.549: raises $0.15 to $0.25
ganryu76: folds 
mario0887: folds 
iwant2bking has timed out
iwant2bking: folds 
Gissbon: folds 
Acedan1369: calls $0.15
*** FLOP *** [Kh 3s 8h]
Acedan1369: checks 
sapr.549: checks 
*** TURN *** [Kh 3s 8h] [6c]
Acedan1369: bets $0.40
sapr.549: folds 
Uncalled bet ($0.40) returned to Acedan1369
Acedan1369 collected $0.53 from pot
Acedan1369: doesn't show hand 
*** SUMMARY ***
Total pot $0.55 | Rake $0.02 
Board [Kh 3s 8h 6c]
Seat 1: sapr.549 folded on the Turn
Seat 2: ganryu76 folded before Flop (didn't bet)
Seat 3: mario0887 folded before Flop (didn't bet)
Seat 4: iwant2bking (button) folded before Flop (didn't bet)
Seat 5: Gissbon (small blind) folded before Flop
Seat 6: Acedan1369 (big blind) collected ($0.53)



PokerStars Hand #222968932062:  Hold'em No Limit ($0.05/$0.10 USD) - 2021/01/23 15:21:49 ET
Table 'Malzovia' 6-max Seat #5 is the button
Seat 1: sapr.549 ($7.22 in chips) 
Seat 2: ganryu76 ($11.06 in chips) 
Seat 3: mario0887 ($10.05 in chips) 
Seat 4: iwant2bking ($7.85 in chips) 
Seat 5: Gissbon ($10 in chips) 
Seat 6: Acedan1369 ($25.65 in chips) 
Acedan1369: posts small blind $0.05
sapr.549: posts big blind $0.10
*** HOLE CARDS ***
ganryu76: folds 
mario0887: folds 
iwant2bking: folds 
Gissbon: folds 
Acedan1369: folds 
Uncalled bet ($0.05) returned to sapr.549
sapr.549 collected $0.10 from pot
sapr.549: doesn't show hand 
*** SUMMARY ***
Total pot $0.10 | Rake $0 
Seat 1: sapr.549 (big blind) collected ($0.10)
Seat 2: ganryu76 folded before Flop (didn't bet)
Seat 3: mario0887 folded before Flop (didn't bet)
Seat 4: iwant2bking folded before Flop (didn't bet)
Seat 5: Gissbon (button) folded before Flop (didn't bet)
Seat 6: Acedan1369 (small blind) folded before Flop



PokerStars Hand #222968949237:  Hold'em No Limit ($0.05/$0.10 USD) - 2021/01/23 15:22:09 ET
Table 'Malzovia' 6-max Seat #6 is the button
Seat 1: sapr.549 ($7.27 in chips) 
Seat 2: ganryu76 ($11.06 in chips) 
Seat 3: mario0887 ($10.05 in chips) 
Seat 4: iwant2bking ($7.85 in chips) 
Seat 5: Gissbon ($10 in chips) 
Seat 6: Acedan1369 ($25.60 in chips) 
sapr.549: posts small blind $0.05
ganryu76: posts big blind $0.10
*** HOLE CARDS ***
mario0887: folds 
iwant2bking: raises $0.10 to $0.20
Gissbon: folds 
Acedan1369: folds 
sapr.549: folds 
ganryu76: calls $0.10
*** FLOP *** [6s 2h Kd]
ganryu76: checks 
iwant2bking: bets $0.20
ganryu76: folds 
Uncalled bet ($0.20) returned to iwant2bking
iwant2bking collected $0.43 from pot
iwant2bking: doesn't show hand 
*** SUMMARY ***
Total pot $0.45 | Rake $0.02 
Board [6s 2h Kd]
Seat 1: sapr.549 (small blind) folded before Flop
Seat 2: ganryu76 (big blind) folded on the Flop
Seat 3: mario0887 folded before Flop (didn't bet)
Seat 4: iwant2bking collected ($0.43)
Seat 5: Gissbon folded before Flop (didn't bet)
Seat 6: Acedan1369 (button) folded before Flop (didn't bet)



PokerStars Hand #222968980253:  Hold'em No Limit ($0.05/$0.10 USD) - 2021/01/23 15:22:44 ET
Table 'Malzovia' 6-max Seat #1 is the button
Seat 1: sapr.549 ($7.22 in chips) 
Seat 2: ganryu76 ($10.86 in chips) 
Seat 3: mario0887 ($10.05 in chips) 
Seat 4: iwant2bking ($8.08 in chips) 
Seat 5: Gissbon ($10 in chips) 
Seat 6: Acedan1369 ($25.60 in chips) 
ganryu76: posts small blind $0.05
mario0887: posts big blind $0.10
*** HOLE CARDS ***
iwant2bking has timed out
iwant2bking: folds 
Gissbon: folds 
Acedan1369: raises $0.15 to $0.25
sapr.549: folds 
ganryu76: folds 
mario0887: calls $0.15
*** FLOP *** [7d 4d 7s]
mario0887: bets $0.10
Acedan1369: folds 
Uncalled bet ($0.10) returned to mario0887
mario0887 collected $0.53 from pot
mario0887: doesn't show hand 
*** SUMMARY ***
Total pot $0.55 | Rake $0.02 
Board [7d 4d 7s]
Seat 1: sapr.549 (button) folded before Flop (didn't bet)
Seat 2: ganryu76 (small blind) folded before Flop
Seat 3: mario0887 (big blind) collected ($0.53)
Seat 4: iwant2bking folded before Flop (didn't bet)
Seat 5: Gissbon folded before Flop (didn't bet)
Seat 6: Acedan1369 folded on the Flop



PokerStars Hand #222969032817:  Hold'em No Limit ($0.05/$0.10 USD) - 2021/01/23 15:23:45 ET
Table 'Malzovia' 6-max Seat #2 is the button
Seat 1: sapr.549 ($7.22 in chips) 
Seat 2: ganryu76 ($10.81 in chips) 
Seat 3: mario0887 ($10.33 in chips) 
Seat 4: iwant2bking ($8.08 in chips) 
Seat 5: Gissbon ($10 in chips) 
Seat 6: Acedan1369 ($25.35 in chips) 
mario0887: posts small blind $0.05
iwant2bking: posts big blind $0.10
*** HOLE CARDS ***
Gissbon: folds 
Acedan1369: folds 
sapr.549: folds 
ganryu76: folds 
mario0887: folds 
Uncalled bet ($0.05) returned to iwant2bking
iwant2bking collected $0.10 from pot
iwant2bking: doesn't show hand 
*** SUMMARY ***
Total pot $0.10 | Rake $0 
Seat 1: sapr.549 folded before Flop (didn't bet)
Seat 2: ganryu76 (button) folded before Flop (didn't bet)
Seat 3: mario0887 (small blind) folded before Flop
Seat 4: iwant2bking (big blind) collected ($0.10)
Seat 5: Gissbon folded before Flop (didn't bet)
Seat 6: Acedan1369 folded before Flop (didn't bet)



PokerStars Hand #222969046579:  Hold'em No Limit ($0.05/$0.10 USD) - 2021/01/23 15:24:02 ET
Table 'Malzovia' 6-max Seat #3 is the button
Seat 1: sapr.549 ($7.22 in chips) 
Seat 2: ganryu76 ($10.81 in chips) 
Seat 3: mario0887 ($10.28 in chips) 
Seat 4: iwant2bking ($8.13 in chips) 
Seat 5: Gissbon ($10 in chips) 
Seat 6: Acedan1369 ($25.35 in chips) 
iwant2bking: posts small blind $0.05
Gissbon: posts big blind $0.10
*** HOLE CARDS ***
Acedan1369: folds 
sapr.549: folds 
ganryu76: folds 
mario0887: folds 
iwant2bking: folds 
Uncalled bet ($0.05) returned to Gissbon
Gissbon collected $0.10 from pot
Gissbon: doesn't show hand 
*** SUMMARY ***
Total pot $0.10 | Rake $0 
Seat 1: sapr.549 folded before Flop (didn't bet)
Seat 2: ganryu76 folded before Flop (didn't bet)
Seat 3: mario0887 (button) folded before Flop (didn't bet)
Seat 4: iwant2bking (small blind) folded before Flop
Seat 5: Gissbon (big blind) collected ($0.10)
Seat 6: Acedan1369 folded before Flop (didn't bet)



PokerStars Hand #222969053769:  Hold'em No Limit ($0.05/$0.10 USD) - 2021/01/23 15:24:10 ET
Table 'Malzovia' 6-max Seat #4 is the button
Seat 1: sapr.549 ($7.22 in chips) 
Seat 2: ganryu76 ($10.81 in chips) 
Seat 3: mario0887 ($10.28 in chips) 
Seat 4: iwant2bking ($8.08 in chips) 
Seat 5: Gissbon ($10.05 in chips) 
Seat 6: Acedan1369 ($25.35 in chips) 
Gissbon: posts small blind $0.05
Acedan1369: posts big blind $0.10
*** HOLE CARDS ***
sapr.549: folds 
ganryu76: folds 
mario0887: folds 
iwant2bking: folds 
Gissbon: raises $0.20 to $0.30
Acedan1369: raises $0.55 to $0.85
Gissbon: folds 
Uncalled bet ($0.55) returned to Acedan1369
Acedan1369 collected $0.60 from pot
Acedan1369: doesn't show hand 
*** SUMMARY ***
Total pot $0.60 | Rake $0 
Seat 1: sapr.549 folded before Flop (didn't bet)
Seat 2: ganryu76 folded before Flop (didn't bet)
Seat 3: mario0887 folded before Flop (didn't bet)
Seat 4: iwant2bking (button) folded before Flop (didn't bet)
Seat 5: Gissbon (small blind) folded before Flop
Seat 6: Acedan1369 (big blind) collected ($0.60)



PokerStars Hand #222969075026:  Hold'em No Limit ($0.05/$0.10 USD) - 2021/01/23 15:24:35 ET
Table 'Malzovia' 6-max Seat #5 is the button
Seat 1: sapr.549 ($7.22 in chips) 
Seat 2: ganryu76 ($10.81 in chips) 
Seat 3: mario0887 ($10.28 in chips) 
Seat 4: iwant2bking ($8.08 in chips) 
Seat 5: Gissbon ($10 in chips) 
Seat 6: Acedan1369 ($25.65 in chips) 
Acedan1369: posts small blind $0.05
sapr.549: posts big blind $0.10
*** HOLE CARDS ***
ganryu76: folds 
mario0887: folds 
iwant2bking: raises $0.20 to $0.30
Gissbon: folds 
Acedan1369: folds 
sapr.549: raises $0.57 to $0.87
iwant2bking: calls $0.57
*** FLOP *** [Jd Qs As]
sapr.549: bets $0.71
iwant2bking: raises $0.71 to $1.42
sapr.549: calls $0.71
*** TURN *** [Jd Qs As] [7d]
sapr.549: bets $4.93 and is all-in
iwant2bking: calls $4.93
*** RIVER *** [Jd Qs As 7d] [Ts]
*** SHOW DOWN ***
sapr.549: shows [Kh Ah] (a straight, Ten to Ace)
iwant2bking: shows [6c Ac] (a pair of Aces)
sapr.549 cashed out the hand for $12.77 | Cash Out Fee $0.13
*** SUMMARY ***
Total pot $14.49 | Rake $0.65 
Board [Jd Qs As 7d Ts]
Seat 1: sapr.549 (big blind) showed [Kh Ah] and won ($13.84) with a straight, Ten to Ace (pot not awarded as player cashed out)
Seat 2: ganryu76 folded before Flop (didn't bet)
Seat 3: mario0887 folded before Flop (didn't bet)
Seat 4: iwant2bking showed [6c Ac] and lost with a pair of Aces
Seat 5: Gissbon (button) folded before Flop (didn't bet)
Seat 6: Acedan1369 (small blind) folded before Flop



PokerStars Hand #222969125549:  Hold'em No Limit ($0.05/$0.10 USD) - 2021/01/23 15:25:34 ET
Table 'Malzovia' 6-max Seat #6 is the button
Seat 1: sapr.549 ($12.77 in chips) 
Seat 2: ganryu76 ($10.81 in chips) 
Seat 3: mario0887 ($10.28 in chips) 
Seat 4: iwant2bking ($0.86 in chips) 
Seat 5: Gissbon ($10 in chips) 
Seat 6: Acedan1369 ($25.60 in chips) 
sapr.549: posts small blind $0.05
ganryu76: posts big blind $0.10
*** HOLE CARDS ***
mario0887: folds 
iwant2bking: raises $0.76 to $0.86 and is all-in
Gissbon: folds 
Acedan1369: folds 
sapr.549: folds 
ganryu76: calls $0.76
*** FLOP *** [Qc Th Js]
*** TURN *** [Qc Th Js] [Td]
*** RIVER *** [Qc Th Js Td] [3c]
*** SHOW DOWN ***
ganryu76: shows [Qd Kc] (two pair, Queens and Tens)
iwant2bking: shows [4c Qh] (two pair, Queens and Tens - lower kicker)
ganryu76 collected $1.69 from pot
*** SUMMARY ***
Total pot $1.77 | Rake $0.08 
Board [Qc Th Js Td 3c]
Seat 1: sapr.549 (small blind) folded before Flop
Seat 2: ganryu76 (big blind) showed [Qd Kc] and won ($1.69) with two pair, Queens and Tens
Seat 3: mario0887 folded before Flop (didn't bet)
Seat 4: iwant2bking showed [4c Qh] and lost with two pair, Queens and Tens
Seat 5: Gissbon folded before Flop (didn't bet)
Seat 6: Acedan1369 (button) folded before Flop (didn't bet)



PokerStars Hand #222969151141:  Hold'em No Limit ($0.05/$0.10 USD) - 2021/01/23 15:26:03 ET
Table 'Malzovia' 6-max Seat #1 is the button
Seat 1: sapr.549 ($12.72 in chips) 
Seat 2: ganryu76 ($11.64 in chips) 
Seat 3: mario0887 ($10.28 in chips) 
Seat 5: Gissbon ($10 in chips) 
Seat 6: Acedan1369 ($25.60 in chips) 
ganryu76: posts small blind $0.05
mario0887: posts big blind $0.10
*** HOLE CARDS ***
Gissbon: folds 
Acedan1369: raises $0.15 to $0.25
sapr.549: folds 
ganryu76: folds 
iwant2bking leaves the table
mario0887: folds 
Uncalled bet ($0.15) returned to Acedan1369
Acedan1369 collected $0.25 from pot
Acedan1369: doesn't show hand 
*** SUMMARY ***
Total pot $0.25 | Rake $0 
Seat 1: sapr.549 (button) folded before Flop (didn't bet)
Seat 2: ganryu76 (small blind) folded before Flop
Seat 3: mario0887 (big blind) folded before Flop
Seat 5: Gissbon folded before Flop (didn't bet)
Seat 6: Acedan1369 collected ($0.25)



PokerStars Hand #222969166708:  Hold'em No Limit ($0.05/$0.10 USD) - 2021/01/23 15:26:21 ET
Table 'Malzovia' 6-max Seat #2 is the button
Seat 1: sapr.549 ($12.72 in chips) 
Seat 2: ganryu76 ($11.59 in chips) 
Seat 3: mario0887 ($10.18 in chips) 
Seat 5: Gissbon ($10 in chips) 
Seat 6: Acedan1369 ($25.75 in chips) 
mario0887: posts small blind $0.05
Gissbon: posts big blind $0.10
*** HOLE CARDS ***
Acedan1369: folds 
sapr.549: folds 
ganryu76: folds 
Dosa994 joins the table at seat #4 
mario0887: raises $0.30 to $0.40
Gissbon: calls $0.30
*** FLOP *** [2c 2h Ad]
mario0887: bets $0.25
Gissbon: calls $0.25
*** TURN *** [2c 2h Ad] [As]
mario0887: bets $0.41
Gissbon: calls $0.41
*** RIVER *** [2c 2h Ad As] [Td]
mario0887: checks 
Gissbon: bets $0.81
mario0887: calls $0.81
*** SHOW DOWN ***
Gissbon: shows [Ah 6h] (a full house, Aces full of Deuces)
mario0887: mucks hand 
Gissbon collected $3.57 from pot
*** SUMMARY ***
Total pot $3.74 | Rake $0.17 
Board [2c 2h Ad As Td]
Seat 1: sapr.549 folded before Flop (didn't bet)
Seat 2: ganryu76 (button) folded before Flop (didn't bet)
Seat 3: mario0887 (small blind) mucked
Seat 5: Gissbon (big blind) showed [Ah 6h] and won ($3.57) with a full house, Aces full of Deuces
Seat 6: Acedan1369 folded before Flop (didn't bet)



PokerStars Hand #222969208866:  Hold'em No Limit ($0.05/$0.10 USD) - 2021/01/23 15:27:11 ET
Table 'Malzovia' 6-max Seat #3 is the button
Seat 1: sapr.549 ($12.72 in chips) 
Seat 2: ganryu76 ($11.59 in chips) 
Seat 3: mario0887 ($8.31 in chips) 
Seat 5: Gissbon ($11.70 in chips) 
Seat 6: Acedan1369 ($25.75 in chips) 
Gissbon: posts small blind $0.05
Acedan1369: posts big blind $0.10
*** HOLE CARDS ***
sapr.549: folds 
ganryu76: raises $0.15 to $0.25
mario0887: folds 
Gissbon: folds 
Acedan1369: folds 
Uncalled bet ($0.15) returned to ganryu76
ganryu76 collected $0.25 from pot
ganryu76: doesn't show hand 
*** SUMMARY ***
Total pot $0.25 | Rake $0 
Seat 1: sapr.549 folded before Flop (didn't bet)
Seat 2: ganryu76 collected ($0.25)
Seat 3: mario0887 (button) folded before Flop (didn't bet)
Seat 5: Gissbon (small blind) folded before Flop
Seat 6: Acedan1369 (big blind) folded before Flop



PokerStars Hand #222969226845:  Hold'em No Limit ($0.05/$0.10 USD) - 2021/01/23 15:27:32 ET
Table 'Malzovia' 6-max Seat #5 is the button
Seat 1: sapr.549 ($12.72 in chips) 
Seat 2: ganryu76 ($11.74 in chips) 
Seat 3: mario0887 ($8.31 in chips) 
Seat 5: Gissbon ($11.65 in chips) 
Seat 6: Acedan1369 ($25.65 in chips) 
Acedan1369: posts small blind $0.05
sapr.549: posts big blind $0.10
Dosa994: sits out 
*** HOLE CARDS ***
ganryu76: folds 
mario0887 has timed out
mario0887: folds 
Gissbon: folds 
Acedan1369: folds 
Uncalled bet ($0.05) returned to sapr.549
sapr.549 collected $0.10 from pot
sapr.549: doesn't show hand 
*** SUMMARY ***
Total pot $0.10 | Rake $0 
Seat 1: sapr.549 (big blind) collected ($0.10)
Seat 2: ganryu76 folded before Flop (didn't bet)
Seat 3: mario0887 folded before Flop (didn't bet)
Seat 5: Gissbon (button) folded before Flop (didn't bet)
Seat 6: Acedan1369 (small blind) folded before Flop



PokerStars Hand #222969245776:  Hold'em No Limit ($0.05/$0.10 USD) - 2021/01/23 15:27:54 ET
Table 'Malzovia' 6-max Seat #6 is the button
Seat 1: sapr.549 ($12.77 in chips) 
Seat 2: ganryu76 ($11.74 in chips) 
Seat 3: mario0887 ($8.31 in chips) 
Seat 5: Gissbon ($11.65 in chips) 
Seat 6: Acedan1369 ($25.60 in chips) 
sapr.549: posts small blind $0.05
ganryu76: posts big blind $0.10
Dosa994: sits out 
*** HOLE CARDS ***
mario0887: folds 
Gissbon: raises $0.15 to $0.25
Acedan1369: folds 
sapr.549: folds 
ganryu76: folds 
Uncalled bet ($0.15) returned to Gissbon
Gissbon collected $0.25 from pot
Gissbon: doesn't show hand 
*** SUMMARY ***
Total pot $0.25 | Rake $0 
Seat 1: sapr.549 (small blind) folded before Flop
Seat 2: ganryu76 (big blind) folded before Flop
Seat 3: mario0887 folded before Flop (didn't bet)
Seat 5: Gissbon collected ($0.25)
Seat 6: Acedan1369 (button) folded before Flop (didn't bet)



PokerStars Hand #222969268643:  Hold'em No Limit ($0.05/$0.10 USD) - 2021/01/23 15:28:21 ET
Table 'Malzovia' 6-max Seat #1 is the button
Seat 1: sapr.549 ($12.72 in chips) 
Seat 2: ganryu76 ($11.64 in chips) 
Seat 3: mario0887 ($8.31 in chips) 
Seat 5: Gissbon ($11.80 in chips) 
Seat 6: Acedan1369 ($25.60 in chips) 
ganryu76: posts small blind $0.05
mario0887: posts big blind $0.10
Dosa994: sits out 
*** HOLE CARDS ***
Gissbon: folds 
Acedan1369: folds 
sapr.549: folds 
ganryu76: raises $0.25 to $0.35
mario0887: folds 
Uncalled bet ($0.25) returned to ganryu76
ganryu76 collected $0.20 from pot
ganryu76: doesn't show hand 
*** SUMMARY ***
Total pot $0.20 | Rake $0 
Seat 1: sapr.549 (button) folded before Flop (didn't bet)
Seat 2: ganryu76 (small blind) collected ($0.20)
Seat 3: mario0887 (big blind) folded before Flop
Seat 5: Gissbon folded before Flop (didn't bet)
Seat 6: Acedan1369 folded before Flop (didn't bet)



PokerStars Hand #222969288520:  Hold'em No Limit ($0.05/$0.10 USD) - 2021/01/23 15:28:44 ET
Table 'Malzovia' 6-max Seat #2 is the button
Seat 1: sapr.549 ($12.72 in chips) 
Seat 2: ganryu76 ($11.74 in chips) 
Seat 3: mario0887 ($8.21 in chips) 
Seat 4: Dosa994 ($8 in chips) 
Seat 5: Gissbon ($11.80 in chips) 
Seat 6: Acedan1369 ($25.60 in chips) 
mario0887: posts small blind $0.05
Dosa994: posts big blind $0.10
*** HOLE CARDS ***
Gissbon: folds 
Acedan1369: folds 
sapr.549: folds 
ganryu76: raises $0.15 to $0.25
mario0887: folds 
Dosa994: folds 
Uncalled bet ($0.15) returned to ganryu76
ganryu76 collected $0.25 from pot
ganryu76: doesn't show hand 
*** SUMMARY ***
Total pot $0.25 | Rake $0 
Seat 1: sapr.549 folded before Flop (didn't bet)
Seat 2: ganryu76 (button) collected ($0.25)
Seat 3: mario0887 (small blind) folded before Flop
Seat 4: Dosa994 (big blind) folded before Flop
Seat 5: Gissbon folded before Flop (didn't bet)
Seat 6: Acedan1369 folded before Flop (didn't bet)



PokerStars Hand #222969303307:  Hold'em No Limit ($0.05/$0.10 USD) - 2021/01/23 15:29:01 ET
Table 'Malzovia' 6-max Seat #3 is the button
Seat 1: sapr.549 ($12.72 in chips) 
Seat 2: ganryu76 ($11.89 in chips) 
Seat 3: mario0887 ($8.16 in chips) 
Seat 4: Dosa994 ($7.90 in chips) 
Seat 5: Gissbon ($11.80 in chips) 
Seat 6: Acedan1369 ($25.60 in chips) 
Dosa994: posts small blind $0.05
Gissbon: posts big blind $0.10
*** HOLE CARDS ***
Acedan1369: folds 
sapr.549: folds 
ganryu76: folds 
mario0887: folds 
Dosa994: calls $0.05
Gissbon: checks 
*** FLOP *** [Kc 6c 2c]
Dosa994: checks 
Gissbon: checks 
*** TURN *** [Kc 6c 2c] [6s]
Dosa994: bets $0.10
Gissbon: folds 
Uncalled bet ($0.10) returned to Dosa994
Dosa994 collected $0.19 from pot
Dosa994: doesn't show hand 
*** SUMMARY ***
Total pot $0.20 | Rake $0.01 
Board [Kc 6c 2c 6s]
Seat 1: sapr.549 folded before Flop (didn't bet)
Seat 2: ganryu76 folded before Flop (didn't bet)
Seat 3: mario0887 (button) folded before Flop (didn't bet)
Seat 4: Dosa994 (small blind) collected ($0.19)
Seat 5: Gissbon (big blind) folded on the Turn
Seat 6: Acedan1369 folded before Flop (didn't bet)



PokerStars Hand #222969341393:  Hold'em No Limit ($0.05/$0.10 USD) - 2021/01/23 15:29:45 ET
Table 'Malzovia' 6-max Seat #4 is the button
Seat 1: sapr.549 ($12.72 in chips) 
Seat 2: ganryu76 ($11.89 in chips) 
Seat 3: mario0887 ($8.16 in chips) 
Seat 4: Dosa994 ($7.99 in chips) 
Seat 5: Gissbon ($11.70 in chips) 
Seat 6: Acedan1369 ($25.60 in chips) 
Gissbon: posts small blind $0.05
Acedan1369: posts big blind $0.10
*** HOLE CARDS ***
sapr.549: folds 
ganryu76: folds 
mario0887: folds 
Dosa994: calls $0.10
Gissbon: folds 
Acedan1369: raises $0.30 to $0.40
Dosa994: calls $0.30
*** FLOP *** [6d 9s 8s]
Acedan1369: checks 
Dosa994: bets $0.30
Acedan1369: folds 
Uncalled bet ($0.30) returned to Dosa994
Dosa994 collected $0.81 from pot
Dosa994: doesn't show hand 
*** SUMMARY ***
Total pot $0.85 | Rake $0.04 
Board [6d 9s 8s]
Seat 1: sapr.549 folded before Flop (didn't bet)
Seat 2: ganryu76 folded before Flop (didn't bet)
Seat 3: mario0887 folded before Flop (didn't bet)
Seat 4: Dosa994 (button) collected ($0.81)
Seat 5: Gissbon (small blind) folded before Flop
Seat 6: Acedan1369 (big blind) folded on the Flop



PokerStars Hand #222969372683:  Hold'em No Limit ($0.05/$0.10 USD) - 2021/01/23 15:30:21 ET
Table 'Malzovia' 6-max Seat #5 is the button
Seat 2: ganryu76 ($11.89 in chips) 
Seat 3: mario0887 ($8.16 in chips) 
Seat 4: Dosa994 ($8.40 in chips) 
Seat 5: Gissbon ($11.65 in chips) 
Seat 6: Acedan1369 ($25.20 in chips) 
Acedan1369: posts small blind $0.05
sapr.549: is sitting out 
sapr.549 leaves the table
ganryu76: posts big blind $0.10
*** HOLE CARDS ***
mario0887: folds 
Dosa994: calls $0.10
Gissbon: folds 
Acedan1369: calls $0.05
ganryu76: checks 
*** FLOP *** [Kd 7s 3c]
Acedan1369: checks 
ganryu76: checks 
Dosa994: checks 
*** TURN *** [Kd 7s 3c] [4h]
Acedan1369: checks 
ganryu76: checks 
Dosa994: bets $0.20
Acedan1369: folds 
ganryu76: folds 
Uncalled bet ($0.20) returned to Dosa994
Dosa994 collected $0.29 from pot
Dosa994: doesn't show hand 
*** SUMMARY ***
Total pot $0.30 | Rake $0.01 
Board [Kd 7s 3c 4h]
Seat 2: ganryu76 (big blind) folded on the Turn
Seat 3: mario0887 folded before Flop (didn't bet)
Seat 4: Dosa994 collected ($0.29)
Seat 5: Gissbon (button) folded before Flop (didn't bet)
Seat 6: Acedan1369 (small blind) folded on the Turn



PokerStars Hand #222969434201:  Hold'em No Limit ($0.05/$0.10 USD) - 2021/01/23 15:31:19 ET
Table 'Malzovia' 6-max Seat #6 is the button
Seat 2: ganryu76 ($11.79 in chips) 
Seat 3: mario0887 ($8.16 in chips) 
Seat 4: Dosa994 ($8.59 in chips) 
Seat 5: Gissbon ($11.65 in chips) 
Seat 6: Acedan1369 ($25.10 in chips) 
ganryu76: posts small blind $0.05
mario0887: posts big blind $0.10
*** HOLE CARDS ***
Dosa994: folds 
Gissbon: raises $0.30 to $0.40
Acedan1369: folds 
ganryu76: folds 
mario0887: folds 
Uncalled bet ($0.30) returned to Gissbon
Gissbon collected $0.25 from pot
Gissbon: doesn't show hand 
*** SUMMARY ***
Total pot $0.25 | Rake $0 
Seat 2: ganryu76 (small blind) folded before Flop
Seat 3: mario0887 (big blind) folded before Flop
Seat 4: Dosa994 folded before Flop (didn't bet)
Seat 5: Gissbon collected ($0.25)
Seat 6: Acedan1369 (button) folded before Flop (didn't bet)



PokerStars Hand #222969447515:  Hold'em No Limit ($0.05/$0.10 USD) - 2021/01/23 15:31:35 ET
Table 'Malzovia' 6-max Seat #2 is the button
Seat 2: ganryu76 ($11.74 in chips) 
Seat 3: mario0887 ($8.06 in chips) 
Seat 4: Dosa994 ($8.59 in chips) 
Seat 5: Gissbon ($11.80 in chips) 
Seat 6: Acedan1369 ($25.10 in chips) 
mario0887: posts small blind $0.05
Dosa994: posts big blind $0.10
*** HOLE CARDS ***
Gissbon: folds 
cispray100 joins the table at seat #1 
Acedan1369: raises $0.15 to $0.25
ganryu76: folds 
mario0887: folds 
Dosa994: calls $0.15
*** FLOP *** [7s 8c Ac]
Dosa994: bets $0.20
Acedan1369: raises $0.50 to $0.70
Dosa994: folds 
Uncalled bet ($0.50) returned to Acedan1369
Acedan1369 collected $0.91 from pot
Acedan1369: doesn't show hand 
*** SUMMARY ***
Total pot $0.95 | Rake $0.04 
Board [7s 8c Ac]
Seat 2: ganryu76 (button) folded before Flop (didn't bet)
Seat 3: mario0887 (small blind) folded before Flop
Seat 4: Dosa994 (big blind) folded on the Flop
Seat 5: Gissbon folded before Flop (didn't bet)
Seat 6: Acedan1369 collected ($0.91)



PokerStars Hand #222969472605:  Hold'em No Limit ($0.05/$0.10 USD) - 2021/01/23 15:32:04 ET
Table 'Malzovia' 6-max Seat #3 is the button
Seat 1: cispray100 ($10 in chips) 
Seat 2: ganryu76 ($11.74 in chips) 
Seat 3: mario0887 ($8.01 in chips) 
Seat 4: Dosa994 ($8.14 in chips) 
Seat 5: Gissbon ($11.80 in chips) 
Seat 6: Acedan1369 ($25.56 in chips) 
Dosa994: posts small blind $0.05
Gissbon: posts big blind $0.10
cispray100: posts big blind $0.10
*** HOLE CARDS ***
Acedan1369: folds 
cispray100: raises $0.25 to $0.35
ganryu76: folds 
mario0887: folds 
Dosa994: folds 
Gissbon: folds 
Uncalled bet ($0.25) returned to cispray100
cispray100 collected $0.25 from pot
cispray100: doesn't show hand 
*** SUMMARY ***
Total pot $0.25 | Rake $0 
Seat 1: cispray100 collected ($0.25)
Seat 2: ganryu76 folded before Flop (didn't bet)
Seat 3: mario0887 (button) folded before Flop (didn't bet)
Seat 4: Dosa994 (small blind) folded before Flop
Seat 5: Gissbon (big blind) folded before Flop
Seat 6: Acedan1369 folded before Flop (didn't bet)



PokerStars Hand #222969486757:  Hold'em No Limit ($0.05/$0.10 USD) - 2021/01/23 15:32:20 ET
Table 'Malzovia' 6-max Seat #4 is the button
Seat 1: cispray100 ($10.15 in chips) 
Seat 2: ganryu76 ($11.74 in chips) 
Seat 3: mario0887 ($8.01 in chips) 
Seat 4: Dosa994 ($8.09 in chips) 
Seat 5: Gissbon ($11.70 in chips) 
Seat 6: Acedan1369 ($25.56 in chips) 
Gissbon: posts small blind $0.05
Acedan1369: posts big blind $0.10
*** HOLE CARDS ***
cispray100: calls $0.10
ganryu76: folds 
mario0887: folds 
Dosa994: calls $0.10
Gissbon: folds 
Acedan1369: raises $0.40 to $0.50
cispray100: calls $0.40
Dosa994: calls $0.40
*** FLOP *** [9s Kd 8d]
Acedan1369: bets $1.11
cispray100: calls $1.11
Dosa994: folds 
*** TURN *** [9s Kd 8d] [6c]
Acedan1369: bets $2.70
cispray100: calls $2.70
*** RIVER *** [9s Kd 8d 6c] [5h]
Acedan1369: checks 
cispray100: bets $4.38
Acedan1369: calls $4.38
*** SHOW DOWN ***
cispray100: shows [8s 5s] (two pair, Eights and Fives)
Acedan1369: mucks hand 
cispray100 collected $17.12 from pot
*** SUMMARY ***
Total pot $17.93 | Rake $0.81 
Board [9s Kd 8d 6c 5h]
Seat 1: cispray100 showed [8s 5s] and won ($17.12) with two pair, Eights and Fives
Seat 2: ganryu76 folded before Flop (didn't bet)
Seat 3: mario0887 folded before Flop (didn't bet)
Seat 4: Dosa994 (button) folded on the Flop
Seat 5: Gissbon (small blind) folded before Flop
Seat 6: Acedan1369 (big blind) mucked



PokerStars Hand #222969515062:  Hold'em No Limit ($0.05/$0.10 USD) - 2021/01/23 15:32:53 ET
Table 'Malzovia' 6-max Seat #5 is the button
Seat 1: cispray100 ($18.58 in chips) 
Seat 2: ganryu76 ($11.74 in chips) 
Seat 3: mario0887 ($8.01 in chips) 
Seat 4: Dosa994 ($7.59 in chips) 
Seat 5: Gissbon ($11.65 in chips) 
Seat 6: Acedan1369 ($16.87 in chips) 
Acedan1369: posts small blind $0.05
cispray100: posts big blind $0.10
*** HOLE CARDS ***
ganryu76: folds 
mario0887: raises $0.15 to $0.25
Dosa994: calls $0.25
Gissbon: folds 
Acedan1369: folds 
cispray100: folds 
*** FLOP *** [3s 9c 6d]
mario0887: bets $0.30
Dosa994: calls $0.30
*** TURN *** [3s 9c 6d] [9h]
mario0887: bets $0.89
Dosa994: folds 
Uncalled bet ($0.89) returned to mario0887
mario0887 collected $1.19 from pot
mario0887: doesn't show hand 
*** SUMMARY ***
Total pot $1.25 | Rake $0.06 
Board [3s 9c 6d 9h]
Seat 1: cispray100 (big blind) folded before Flop
Seat 2: ganryu76 folded before Flop (didn't bet)
Seat 3: mario0887 collected ($1.19)
Seat 4: Dosa994 folded on the Turn
Seat 5: Gissbon (button) folded before Flop (didn't bet)
Seat 6: Acedan1369 (small blind) folded before Flop



PokerStars Hand #222969548219:  Hold'em No Limit ($0.05/$0.10 USD) - 2021/01/23 15:33:32 ET
Table 'Malzovia' 6-max Seat #6 is the button
Seat 1: cispray100 ($18.48 in chips) 
Seat 2: ganryu76 ($11.74 in chips) 
Seat 3: mario0887 ($8.65 in chips) 
Seat 4: Dosa994 ($7.04 in chips) 
Seat 5: Gissbon ($11.65 in chips) 
Seat 6: Acedan1369 ($16.82 in chips) 
cispray100: posts small blind $0.05
ganryu76: posts big blind $0.10
*** HOLE CARDS ***
mario0887: folds 
Dosa994: calls $0.10
Gissbon: raises $0.30 to $0.40
Acedan1369: folds 
cispray100: folds 
ganryu76: folds 
Dosa994: folds 
Uncalled bet ($0.30) returned to Gissbon
cispray100 leaves the table
Gissbon collected $0.35 from pot
Gissbon: doesn't show hand 
*** SUMMARY ***
Total pot $0.35 | Rake $0 
Seat 1: cispray100 (small blind) folded before Flop
Seat 2: ganryu76 (big blind) folded before Flop
Seat 3: mario0887 folded before Flop (didn't bet)
Seat 4: Dosa994 folded before Flop
Seat 5: Gissbon collected ($0.35)
Seat 6: Acedan1369 (button) folded before Flop (didn't bet)



PokerStars Hand #222969561712:  Hold'em No Limit ($0.05/$0.10 USD) - 2021/01/23 15:33:48 ET
Table 'Malzovia' 6-max Seat #2 is the button
Seat 2: ganryu76 ($11.64 in chips) 
Seat 3: mario0887 ($8.65 in chips) 
Seat 4: Dosa994 ($6.94 in chips) 
Seat 5: Gissbon ($11.90 in chips) 
Seat 6: Acedan1369 ($16.82 in chips) 
mario0887: posts small blind $0.05
Dosa994: posts big blind $0.10
*** HOLE CARDS ***
Gissbon: folds 
Acedan1369: folds 
alexcost joins the table at seat #1 
ganryu76: folds 
mario0887: raises $0.15 to $0.25
Dosa994: folds 
Uncalled bet ($0.15) returned to mario0887
mario0887 collected $0.20 from pot
mario0887: doesn't show hand 
*** SUMMARY ***
Total pot $0.20 | Rake $0 
Seat 2: ganryu76 (button) folded before Flop (didn't bet)
Seat 3: mario0887 (small blind) collected ($0.20)
Seat 4: Dosa994 (big blind) folded before Flop
Seat 5: Gissbon folded before Flop (didn't bet)
Seat 6: Acedan1369 folded before Flop (didn't bet)



PokerStars Hand #222969577501:  Hold'em No Limit ($0.05/$0.10 USD) - 2021/01/23 15:34:06 ET
Table 'Malzovia' 6-max Seat #3 is the button
Seat 1: alexcost ($5.77 in chips) 
Seat 2: ganryu76 ($11.64 in chips) 
Seat 3: mario0887 ($8.75 in chips) 
Seat 4: Dosa994 ($6.84 in chips) 
Seat 5: Gissbon ($11.90 in chips) 
Seat 6: Acedan1369 ($16.82 in chips) 
Dosa994: posts small blind $0.05
Gissbon: posts big blind $0.10
alexcost: posts big blind $0.10
*** HOLE CARDS ***
Acedan1369: folds 
alexcost: checks 
ganryu76: folds 
mario0887: folds 
Dosa994: calls $0.05
Gissbon: checks 
*** FLOP *** [Td 4s As]
Dosa994: checks 
Gissbon: checks 
alexcost: checks 
*** TURN *** [Td 4s As] [7d]
Dosa994: bets $0.30
Gissbon: folds 
alexcost: calls $0.30
*** RIVER *** [Td 4s As 7d] [4d]
Dosa994: bets $0.50
alexcost: folds 
Uncalled bet ($0.50) returned to Dosa994
Dosa994 collected $0.86 from pot
Dosa994: doesn't show hand 
*** SUMMARY ***
Total pot $0.90 | Rake $0.04 
Board [Td 4s As 7d 4d]
Seat 1: alexcost folded on the River
Seat 2: ganryu76 folded before Flop (didn't bet)
Seat 3: mario0887 (button) folded before Flop (didn't bet)
Seat 4: Dosa994 (small blind) collected ($0.86)
Seat 5: Gissbon (big blind) folded on the Turn
Seat 6: Acedan1369 folded before Flop (didn't bet)



PokerStars Hand #222969606850:  Hold'em No Limit ($0.05/$0.10 USD) - 2021/01/23 15:34:40 ET
Table 'Malzovia' 6-max Seat #4 is the button
Seat 1: alexcost ($5.37 in chips) 
Seat 2: ganryu76 ($11.64 in chips) 
Seat 3: mario0887 ($8.75 in chips) 
Seat 4: Dosa994 ($7.30 in chips) 
Seat 5: Gissbon ($11.80 in chips) 
Seat 6: Acedan1369 ($16.82 in chips) 
Gissbon: posts small blind $0.05
Acedan1369: posts big blind $0.10
*** HOLE CARDS ***
alexcost: folds 
ganryu76: folds 
mario0887: folds 
Dosa994: calls $0.10
Gissbon: folds 
Acedan1369: checks 
*** FLOP *** [Ac 3c As]
Acedan1369: checks 
Dosa994: checks 
*** TURN *** [Ac 3c As] [9s]
Acedan1369: checks 
Dosa994: checks 
*** RIVER *** [Ac 3c As 9s] [7s]
Acedan1369: checks 
Dosa994: checks 
*** SHOW DOWN ***
Acedan1369: shows [Ts 5d] (a pair of Aces)
Dosa994: shows [Qd 8s] (a pair of Aces - Queen kicker)
Dosa994 collected $0.24 from pot
*** SUMMARY ***
Total pot $0.25 | Rake $0.01 
Board [Ac 3c As 9s 7s]
Seat 1: alexcost folded before Flop (didn't bet)
Seat 2: ganryu76 folded before Flop (didn't bet)
Seat 3: mario0887 folded before Flop (didn't bet)
Seat 4: Dosa994 (button) showed [Qd 8s] and won ($0.24) with a pair of Aces
Seat 5: Gissbon (small blind) folded before Flop
Seat 6: Acedan1369 (big blind) showed [Ts 5d] and lost with a pair of Aces



PokerStars Hand #222969701254:  Hold'em No Limit ($0.05/$0.10 USD) - 2021/01/23 15:36:29 ET
Table 'Malzovia' 6-max Seat #5 is the button
Seat 1: alexcost ($5.37 in chips) 
Seat 2: ganryu76 ($11.64 in chips) 
Seat 3: mario0887 ($8.75 in chips) 
Seat 4: Dosa994 ($7.44 in chips) 
Seat 5: Gissbon ($11.75 in chips) 
Seat 6: Acedan1369 ($16.72 in chips) 
Acedan1369: posts small blind $0.05
alexcost: posts big blind $0.10
*** HOLE CARDS ***
ganryu76: folds 
mario0887: folds 
Dosa994: calls $0.10
Gissbon: calls $0.10
Acedan1369: raises $0.30 to $0.40
alexcost: folds 
Dosa994: calls $0.30
Gissbon: calls $0.30
*** FLOP *** [6d 8s 4c]
Acedan1369: checks 
Dosa994: bets $0.40
Gissbon: folds 
Acedan1369: calls $0.40
*** TURN *** [6d 8s 4c] [9d]
Acedan1369: checks 
Dosa994: bets $0.40
Acedan1369: calls $0.40
*** RIVER *** [6d 8s 4c 9d] [6s]
Acedan1369: checks 
Dosa994: bets $0.50
Acedan1369: folds 
Uncalled bet ($0.50) returned to Dosa994
Dosa994 collected $2.77 from pot
Dosa994: doesn't show hand 
*** SUMMARY ***
Total pot $2.90 | Rake $0.13 
Board [6d 8s 4c 9d 6s]
Seat 1: alexcost (big blind) folded before Flop
Seat 2: ganryu76 folded before Flop (didn't bet)
Seat 3: mario0887 folded before Flop (didn't bet)
Seat 4: Dosa994 collected ($2.77)
Seat 5: Gissbon (button) folded on the Flop
Seat 6: Acedan1369 (small blind) folded on the River



PokerStars Hand #222969747167:  Hold'em No Limit ($0.05/$0.10 USD) - 2021/01/23 15:37:23 ET
Table 'Malzovia' 6-max Seat #6 is the button
Seat 1: alexcost ($5.27 in chips) 
Seat 2: ganryu76 ($11.64 in chips) 
Seat 3: mario0887 ($8.75 in chips) 
Seat 4: Dosa994 ($9.01 in chips) 
Seat 5: Gissbon ($11.35 in chips) 
Seat 6: Acedan1369 ($15.52 in chips) 
alexcost: posts small blind $0.05
ganryu76: posts big blind $0.10
*** HOLE CARDS ***
mario0887: raises $0.15 to $0.25
Dosa994: folds 
Gissbon: folds 
Acedan1369: folds 
alexcost: folds 
ganryu76: folds 
Uncalled bet ($0.15) returned to mario0887
mario0887 collected $0.25 from pot
mario0887: doesn't show hand 
*** SUMMARY ***
Total pot $0.25 | Rake $0 
Seat 1: alexcost (small blind) folded before Flop
Seat 2: ganryu76 (big blind) folded before Flop
Seat 3: mario0887 collected ($0.25)
Seat 4: Dosa994 folded before Flop (didn't bet)
Seat 5: Gissbon folded before Flop (didn't bet)
Seat 6: Acedan1369 (button) folded before Flop (didn't bet)



PokerStars Hand #222969762851:  Hold'em No Limit ($0.05/$0.10 USD) - 2021/01/23 15:37:41 ET
Table 'Malzovia' 6-max Seat #1 is the button
Seat 1: alexcost ($5.22 in chips) 
Seat 2: ganryu76 ($11.54 in chips) 
Seat 3: mario0887 ($8.90 in chips) 
Seat 4: Dosa994 ($9.01 in chips) 
Seat 5: Gissbon ($11.35 in chips) 
Seat 6: Acedan1369 ($15.52 in chips) 
ganryu76: posts small blind $0.05
mario0887: posts big blind $0.10
*** HOLE CARDS ***
Dosa994: calls $0.10
Gissbon: folds 
Acedan1369: folds 
alexcost: folds 
ganryu76: calls $0.05
mario0887: checks 
*** FLOP *** [6s 3c Ks]
ganryu76: checks 
mario0887: checks 
Dosa994: checks 
*** TURN *** [6s 3c Ks] [Jc]
ganryu76: checks 
mario0887: checks 
Dosa994: bets $0.20
ganryu76: folds 
mario0887: folds 
Uncalled bet ($0.20) returned to Dosa994
Dosa994 collected $0.29 from pot
Dosa994: doesn't show hand 
*** SUMMARY ***
Total pot $0.30 | Rake $0.01 
Board [6s 3c Ks Jc]
Seat 1: alexcost (button) folded before Flop (didn't bet)
Seat 2: ganryu76 (small blind) folded on the Turn
Seat 3: mario0887 (big blind) folded on the Turn
Seat 4: Dosa994 collected ($0.29)
Seat 5: Gissbon folded before Flop (didn't bet)
Seat 6: Acedan1369 folded before Flop (didn't bet)



PokerStars Hand #222969797486:  Hold'em No Limit ($0.05/$0.10 USD) - 2021/01/23 15:38:22 ET
Table 'Malzovia' 6-max Seat #2 is the button
Seat 1: alexcost ($5.22 in chips) 
Seat 2: ganryu76 ($11.44 in chips) 
Seat 3: mario0887 ($8.80 in chips) 
Seat 4: Dosa994 ($9.20 in chips) 
Seat 5: Gissbon ($11.35 in chips) 
Seat 6: Acedan1369 ($15.52 in chips) 
mario0887: posts small blind $0.05
Dosa994: posts big blind $0.10
*** HOLE CARDS ***
Gissbon: folds 
Acedan1369: folds 
alexcost: raises $0.20 to $0.30
ganryu76: folds 
mario0887: folds 
Dosa994: folds 
Uncalled bet ($0.20) returned to alexcost
alexcost collected $0.25 from pot
alexcost: doesn't show hand 
*** SUMMARY ***
Total pot $0.25 | Rake $0 
Seat 1: alexcost collected ($0.25)
Seat 2: ganryu76 (button) folded before Flop (didn't bet)
Seat 3: mario0887 (small blind) folded before Flop
Seat 4: Dosa994 (big blind) folded before Flop
Seat 5: Gissbon folded before Flop (didn't bet)
Seat 6: Acedan1369 folded before Flop (didn't bet)



PokerStars Hand #222969809870:  Hold'em No Limit ($0.05/$0.10 USD) - 2021/01/23 15:38:36 ET
Table 'Malzovia' 6-max Seat #3 is the button
Seat 1: alexcost ($5.37 in chips) 
Seat 2: ganryu76 ($11.44 in chips) 
Seat 3: mario0887 ($8.75 in chips) 
Seat 4: Dosa994 ($9.10 in chips) 
Seat 5: Gissbon ($11.35 in chips) 
Seat 6: Acedan1369 ($15.52 in chips) 
Dosa994: posts small blind $0.05
Gissbon: posts big blind $0.10
*** HOLE CARDS ***
Acedan1369: folds 
alexcost: folds 
ganryu76: folds 
mario0887: folds 
Dosa994: calls $0.05
Gissbon: checks 
*** FLOP *** [Kc Qc 5d]
Dosa994: bets $0.20
Gissbon: folds 
Uncalled bet ($0.20) returned to Dosa994
Dosa994 collected $0.19 from pot
Dosa994: doesn't show hand 
*** SUMMARY ***
Total pot $0.20 | Rake $0.01 
Board [Kc Qc 5d]
Seat 1: alexcost folded before Flop (didn't bet)
Seat 2: ganryu76 folded before Flop (didn't bet)
Seat 3: mario0887 (button) folded before Flop (didn't bet)
Seat 4: Dosa994 (small blind) collected ($0.19)
Seat 5: Gissbon (big blind) folded on the Flop
Seat 6: Acedan1369 folded before Flop (didn't bet)



PokerStars Hand #222969842009:  Hold'em No Limit ($0.05/$0.10 USD) - 2021/01/23 15:39:06 ET
Table 'Malzovia' 6-max Seat #4 is the button
Seat 1: alexcost ($5.37 in chips) 
Seat 2: ganryu76 ($11.44 in chips) 
Seat 3: mario0887 ($8.75 in chips) 
Seat 4: Dosa994 ($9.19 in chips) 
Seat 5: Gissbon ($11.25 in chips) 
Seat 6: Acedan1369 ($15.52 in chips) 
Gissbon: posts small blind $0.05
Acedan1369: posts big blind $0.10
*** HOLE CARDS ***
alexcost: calls $0.10
ganryu76: folds 
mario0887: folds 
Dosa994: calls $0.10
Gissbon: folds 
Acedan1369: checks 
*** FLOP *** [Kd Ah Tc]
Acedan1369: checks 
alexcost: checks 
Dosa994: checks 
*** TURN *** [Kd Ah Tc] [5h]
Acedan1369: bets $0.25
alexcost: calls $0.25
Dosa994: folds 
*** RIVER *** [Kd Ah Tc 5h] [3h]
Acedan1369: bets $0.61
alexcost: folds 
Uncalled bet ($0.61) returned to Acedan1369
Acedan1369 collected $0.81 from pot
Acedan1369: doesn't show hand 
*** SUMMARY ***
Total pot $0.85 | Rake $0.04 
Board [Kd Ah Tc 5h 3h]
Seat 1: alexcost folded on the River
Seat 2: ganryu76 folded before Flop (didn't bet)
Seat 3: mario0887 folded before Flop (didn't bet)
Seat 4: Dosa994 (button) folded on the Turn
Seat 5: Gissbon (small blind) folded before Flop
Seat 6: Acedan1369 (big blind) collected ($0.81)



PokerStars Hand #222969914907:  Hold'em No Limit ($0.05/$0.10 USD) - 2021/01/23 15:40:32 ET
Table 'Malzovia' 6-max Seat #5 is the button
Seat 1: alexcost ($5.02 in chips) 
Seat 2: ganryu76 ($11.44 in chips) 
Seat 3: mario0887 ($8.75 in chips) 
Seat 4: Dosa994 ($9.09 in chips) 
Seat 5: Gissbon ($11.20 in chips) 
Seat 6: Acedan1369 ($15.98 in chips) 
Acedan1369: posts small blind $0.05
alexcost: posts big blind $0.10
*** HOLE CARDS ***
ganryu76: folds 
mario0887: folds 
Dosa994: calls $0.10
Gissbon: folds 
Acedan1369: folds 
alexcost: checks 
*** FLOP *** [6h Qs 7s]
alexcost: checks 
Dosa994: bets $0.10
alexcost: folds 
Uncalled bet ($0.10) returned to Dosa994
Dosa994 collected $0.24 from pot
Dosa994: doesn't show hand 
*** SUMMARY ***
Total pot $0.25 | Rake $0.01 
Board [6h Qs 7s]
Seat 1: alexcost (big blind) folded on the Flop
Seat 2: ganryu76 folded before Flop (didn't bet)
Seat 3: mario0887 folded before Flop (didn't bet)
Seat 4: Dosa994 collected ($0.24)
Seat 5: Gissbon (button) folded before Flop (didn't bet)
Seat 6: Acedan1369 (small blind) folded before Flop



PokerStars Hand #222969937626:  Hold'em No Limit ($0.05/$0.10 USD) - 2021/01/23 15:40:59 ET
Table 'Malzovia' 6-max Seat #6 is the button
Seat 1: alexcost ($4.92 in chips) 
Seat 2: ganryu76 ($11.44 in chips) 
Seat 3: mario0887 ($8.75 in chips) 
Seat 4: Dosa994 ($9.23 in chips) 
Seat 5: Gissbon ($11.20 in chips) 
Seat 6: Acedan1369 ($15.93 in chips) 
alexcost: posts small blind $0.05
ganryu76: posts big blind $0.10
*** HOLE CARDS ***
mario0887: folds 
Dosa994: calls $0.10
Gissbon: folds 
Acedan1369: raises $0.30 to $0.40
alexcost: folds 
ganryu76: folds 
Dosa994: folds 
Uncalled bet ($0.30) returned to Acedan1369
Acedan1369 collected $0.35 from pot
Acedan1369: doesn't show hand 
*** SUMMARY ***
Total pot $0.35 | Rake $0 
Seat 1: alexcost (small blind) folded before Flop
Seat 2: ganryu76 (big blind) folded before Flop
Seat 3: mario0887 folded before Flop (didn't bet)
Seat 4: Dosa994 folded before Flop
Seat 5: Gissbon folded before Flop (didn't bet)
Seat 6: Acedan1369 (button) collected ($0.35)



PokerStars Hand #222969950250:  Hold'em No Limit ($0.05/$0.10 USD) - 2021/01/23 15:41:14 ET
Table 'Malzovia' 6-max Seat #1 is the button
Seat 1: alexcost ($4.87 in chips) 
Seat 2: ganryu76 ($11.34 in chips) 
Seat 3: mario0887 ($8.75 in chips) 
Seat 4: Dosa994 ($9.13 in chips) 
Seat 5: Gissbon ($11.20 in chips) 
Seat 6: Acedan1369 ($16.18 in chips) 
ganryu76: posts small blind $0.05
mario0887: posts big blind $0.10
*** HOLE CARDS ***
Dosa994: raises $0.10 to $0.20
Gissbon: folds 
Acedan1369: calls $0.20
alexcost: folds 
ganryu76: folds 
mario0887: calls $0.10
*** FLOP *** [Td Jc 4h]
mario0887: checks 
Dosa994: bets $0.20
Acedan1369: folds 
mario0887: calls $0.20
*** TURN *** [Td Jc 4h] [3d]
mario0887: checks 
Dosa994: bets $0.50
mario0887: folds 
Uncalled bet ($0.50) returned to Dosa994
Dosa994 collected $1 from pot
Dosa994: doesn't show hand 
*** SUMMARY ***
Total pot $1.05 | Rake $0.05 
Board [Td Jc 4h 3d]
Seat 1: alexcost (button) folded before Flop (didn't bet)
Seat 2: ganryu76 (small blind) folded before Flop
Seat 3: mario0887 (big blind) folded on the Turn
Seat 4: Dosa994 collected ($1)
Seat 5: Gissbon folded before Flop (didn't bet)
Seat 6: Acedan1369 folded on the Flop



PokerStars Hand #222970000488:  Hold'em No Limit ($0.05/$0.10 USD) - 2021/01/23 15:42:14 ET
Table 'Malzovia' 6-max Seat #2 is the button
Seat 1: alexcost ($4.87 in chips) 
Seat 2: ganryu76 ($11.29 in chips) 
Seat 3: mario0887 ($8.35 in chips) 
Seat 4: Dosa994 ($9.73 in chips) 
Seat 5: Gissbon ($11.20 in chips) 
Seat 6: Acedan1369 ($15.98 in chips) 
mario0887: posts small blind $0.05
Dosa994: posts big blind $0.10
*** HOLE CARDS ***
Gissbon: raises $0.15 to $0.25
Acedan1369: folds 
alexcost: calls $0.25
ganryu76: folds 
mario0887: folds 
Dosa994: calls $0.15
*** FLOP *** [3s 2h 9c]
Dosa994: checks 
Gissbon: bets $0.30
alexcost: calls $0.30
Dosa994: folds 
*** TURN *** [3s 2h 9c] [Ah]
Gissbon: checks 
alexcost: bets $0.30
Gissbon: calls $0.30
*** RIVER *** [3s 2h 9c Ah] [6c]
Gissbon: checks 
alexcost: bets $0.30
Gissbon: calls $0.30
*** SHOW DOWN ***
alexcost: shows [Kh Jc] (high card Ace)
Gissbon: shows [Th Ts] (a pair of Tens)
Gissbon collected $2.48 from pot
*** SUMMARY ***
Total pot $2.60 | Rake $0.12 
Board [3s 2h 9c Ah 6c]
Seat 1: alexcost showed [Kh Jc] and lost with high card Ace
Seat 2: ganryu76 (button) folded before Flop (didn't bet)
Seat 3: mario0887 (small blind) folded before Flop
Seat 4: Dosa994 (big blind) folded on the Flop
Seat 5: Gissbon showed [Th Ts] and won ($2.48) with a pair of Tens
Seat 6: Acedan1369 folded before Flop (didn't bet)



PokerStars Hand #222970052497:  Hold'em No Limit ($0.05/$0.10 USD) - 2021/01/23 15:43:15 ET
Table 'Malzovia' 6-max Seat #3 is the button
Seat 1: alexcost ($3.72 in chips) 
Seat 2: ganryu76 ($11.29 in chips) 
Seat 3: mario0887 ($8.30 in chips) 
Seat 4: Dosa994 ($9.48 in chips) 
Seat 5: Gissbon ($12.53 in chips) 
Seat 6: Acedan1369 ($15.98 in chips) 
Dosa994: posts small blind $0.05
Gissbon: posts big blind $0.10
*** HOLE CARDS ***
Acedan1369: folds 
alexcost: folds 
ganryu76: folds 
mario0887: folds 
Dosa994: calls $0.05
Gissbon: checks 
*** FLOP *** [6c 9h 5h]
Dosa994: checks 
Gissbon: bets $0.10
Dosa994: folds 
Uncalled bet ($0.10) returned to Gissbon
Gissbon collected $0.19 from pot
Gissbon: doesn't show hand 
*** SUMMARY ***
Total pot $0.20 | Rake $0.01 
Board [6c 9h 5h]
Seat 1: alexcost folded before Flop (didn't bet)
Seat 2: ganryu76 folded before Flop (didn't bet)
Seat 3: mario0887 (button) folded before Flop (didn't bet)
Seat 4: Dosa994 (small blind) folded on the Flop
Seat 5: Gissbon (big blind) collected ($0.19)
Seat 6: Acedan1369 folded before Flop (didn't bet)



PokerStars Hand #222970087421:  Hold'em No Limit ($0.05/$0.10 USD) - 2021/01/23 15:43:57 ET
Table 'Malzovia' 6-max Seat #4 is the button
Seat 1: alexcost ($3.72 in chips) 
Seat 2: ganryu76 ($11.29 in chips) 
Seat 3: mario0887 ($8.30 in chips) 
Seat 4: Dosa994 ($9.38 in chips) 
Seat 5: Gissbon ($12.62 in chips) 
Seat 6: Acedan1369 ($15.98 in chips) 
Gissbon: posts small blind $0.05
Acedan1369: posts big blind $0.10
*** HOLE CARDS ***
alexcost: folds 
ganryu76: folds 
mario0887: raises $0.15 to $0.25
Dosa994: folds 
Gissbon: folds 
Acedan1369: raises $0.60 to $0.85
mario0887: folds 
Uncalled bet ($0.60) returned to Acedan1369
Acedan1369 collected $0.55 from pot
Acedan1369: doesn't show hand 
*** SUMMARY ***
Total pot $0.55 | Rake $0 
Seat 1: alexcost folded before Flop (didn't bet)
Seat 2: ganryu76 folded before Flop (didn't bet)
Seat 3: mario0887 folded before Flop
Seat 4: Dosa994 (button) folded before Flop (didn't bet)
Seat 5: Gissbon (small blind) folded before Flop
Seat 6: Acedan1369 (big blind) collected ($0.55)



PokerStars Hand #222970108358:  Hold'em No Limit ($0.05/$0.10 USD) - 2021/01/23 15:44:22 ET
Table 'Malzovia' 6-max Seat #5 is the button
Seat 1: alexcost ($3.72 in chips) 
Seat 2: ganryu76 ($11.29 in chips) 
Seat 3: mario0887 ($8.05 in chips) 
Seat 4: Dosa994 ($9.38 in chips) 
Seat 5: Gissbon ($12.57 in chips) 
Seat 6: Acedan1369 ($16.28 in chips) 
Acedan1369: posts small blind $0.05
alexcost: posts big blind $0.10
*** HOLE CARDS ***
ganryu76: folds 
mario0887: folds 
Dosa994: folds 
Gissbon: folds 
Acedan1369: folds 
Uncalled bet ($0.05) returned to alexcost
alexcost collected $0.10 from pot
alexcost: doesn't show hand 
*** SUMMARY ***
Total pot $0.10 | Rake $0 
Seat 1: alexcost (big blind) collected ($0.10)
Seat 2: ganryu76 folded before Flop (didn't bet)
Seat 3: mario0887 folded before Flop (didn't bet)
Seat 4: Dosa994 folded before Flop (didn't bet)
Seat 5: Gissbon (button) folded before Flop (didn't bet)
Seat 6: Acedan1369 (small blind) folded before Flop



PokerStars Hand #222970120255:  Hold'em No Limit ($0.05/$0.10 USD) - 2021/01/23 15:44:36 ET
Table 'Malzovia' 6-max Seat #6 is the button
Seat 1: alexcost ($3.77 in chips) 
Seat 2: ganryu76 ($11.29 in chips) 
Seat 3: mario0887 ($8.05 in chips) 
Seat 4: Dosa994 ($9.38 in chips) 
Seat 5: Gissbon ($12.57 in chips) 
Seat 6: Acedan1369 ($16.23 in chips) 
alexcost: posts small blind $0.05
ganryu76: posts big blind $0.10
*** HOLE CARDS ***
mario0887: raises $0.15 to $0.25
Dosa994: folds 
Gissbon: raises $0.50 to $0.75
Acedan1369: folds 
alexcost: calls $0.70
ganryu76: folds 
mario0887: calls $0.50
*** FLOP *** [3h 8c Kd]
alexcost: checks 
mario0887: checks 
Gissbon: checks 
*** TURN *** [3h 8c Kd] [8s]
alexcost: bets $1.12
mario0887: folds 
Gissbon: folds 
Uncalled bet ($1.12) returned to alexcost
alexcost collected $2.24 from pot
alexcost: doesn't show hand 
*** SUMMARY ***
Total pot $2.35 | Rake $0.11 
Board [3h 8c Kd 8s]
Seat 1: alexcost (small blind) collected ($2.24)
Seat 2: ganryu76 (big blind) folded before Flop
Seat 3: mario0887 folded on the Turn
Seat 4: Dosa994 folded before Flop (didn't bet)
Seat 5: Gissbon folded on the Turn
Seat 6: Acedan1369 (button) folded before Flop (didn't bet)



PokerStars Hand #222970162330:  Hold'em No Limit ($0.05/$0.10 USD) - 2021/01/23 15:45:26 ET
Table 'Malzovia' 6-max Seat #1 is the button
Seat 1: alexcost ($5.26 in chips) 
Seat 2: ganryu76 ($11.19 in chips) 
Seat 3: mario0887 ($7.30 in chips) 
Seat 4: Dosa994 ($9.38 in chips) 
Seat 5: Gissbon ($11.82 in chips) 
Seat 6: Acedan1369 ($16.23 in chips) 
ganryu76: posts small blind $0.05
mario0887: posts big blind $0.10
*** HOLE CARDS ***
Dosa994: folds 
Gissbon: folds 
Acedan1369: folds 
alexcost: raises $0.20 to $0.30
ganryu76: folds 
mario0887: calls $0.20
*** FLOP *** [Qd 8s Th]
mario0887: checks 
alexcost: checks 
*** TURN *** [Qd 8s Th] [8h]
mario0887: bets $0.20
alexcost: calls $0.20
*** RIVER *** [Qd 8s Th 8h] [6c]
mario0887: bets $1
alexcost: folds 
Uncalled bet ($1) returned to mario0887
mario0887 collected $1 from pot
mario0887: doesn't show hand 
*** SUMMARY ***
Total pot $1.05 | Rake $0.05 
Board [Qd 8s Th 8h 6c]
Seat 1: alexcost (button) folded on the River
Seat 2: ganryu76 (small blind) folded before Flop
Seat 3: mario0887 (big blind) collected ($1)
Seat 4: Dosa994 folded before Flop (didn't bet)
Seat 5: Gissbon folded before Flop (didn't bet)
Seat 6: Acedan1369 folded before Flop (didn't bet)



PokerStars Hand #222970221130:  Hold'em No Limit ($0.05/$0.10 USD) - 2021/01/23 15:46:36 ET
Table 'Malzovia' 6-max Seat #2 is the button
Seat 1: alexcost ($4.76 in chips) 
Seat 2: ganryu76 ($11.14 in chips) 
Seat 3: mario0887 ($7.80 in chips) 
Seat 4: Dosa994 ($9.38 in chips) 
Seat 5: Gissbon ($11.82 in chips) 
Seat 6: Acedan1369 ($16.23 in chips) 
mario0887: posts small blind $0.05
Dosa994: posts big blind $0.10
*** HOLE CARDS ***
Gissbon: folds 
Acedan1369: folds 
alexcost: calls $0.10
ganryu76: folds 
mario0887: folds 
Dosa994: checks 
*** FLOP *** [Jh 4s 8s]
Dosa994: checks 
alexcost: checks 
*** TURN *** [Jh 4s 8s] [5s]
Dosa994: bets $0.20
alexcost: folds 
Uncalled bet ($0.20) returned to Dosa994
Dosa994 collected $0.24 from pot
Dosa994: doesn't show hand 
*** SUMMARY ***
Total pot $0.25 | Rake $0.01 
Board [Jh 4s 8s 5s]
Seat 1: alexcost folded on the Turn
Seat 2: ganryu76 (button) folded before Flop (didn't bet)
Seat 3: mario0887 (small blind) folded before Flop
Seat 4: Dosa994 (big blind) collected ($0.24)
Seat 5: Gissbon folded before Flop (didn't bet)
Seat 6: Acedan1369 folded before Flop (didn't bet)



PokerStars Hand #222970249669:  Hold'em No Limit ($0.05/$0.10 USD) - 2021/01/23 15:47:10 ET
Table 'Malzovia' 6-max Seat #3 is the button
Seat 1: alexcost ($4.66 in chips) 
Seat 2: ganryu76 ($11.14 in chips) 
Seat 3: mario0887 ($7.75 in chips) 
Seat 4: Dosa994 ($9.52 in chips) 
Seat 5: Gissbon ($11.82 in chips) 
Seat 6: Acedan1369 ($16.23 in chips) 
Dosa994: posts small blind $0.05
Gissbon: posts big blind $0.10
*** HOLE CARDS ***
Acedan1369: raises $0.15 to $0.25
alexcost: calls $0.25
ganryu76: folds 
mario0887: folds 
Dosa994: folds 
Gissbon: folds 
*** FLOP *** [Ks 4s 4h]
Acedan1369: checks 
alexcost: checks 
*** TURN *** [Ks 4s 4h] [Ad]
Acedan1369: bets $0.47
alexcost: folds 
Uncalled bet ($0.47) returned to Acedan1369
Acedan1369 collected $0.62 from pot
Acedan1369: doesn't show hand 
*** SUMMARY ***
Total pot $0.65 | Rake $0.03 
Board [Ks 4s 4h Ad]
Seat 1: alexcost folded on the Turn
Seat 2: ganryu76 folded before Flop (didn't bet)
Seat 3: mario0887 (button) folded before Flop (didn't bet)
Seat 4: Dosa994 (small blind) folded before Flop
Seat 5: Gissbon (big blind) folded before Flop
Seat 6: Acedan1369 collected ($0.62)



PokerStars Hand #222967331627:  Hold'em No Limit ($0.05/$0.10 USD) - 2021/01/23 14:47:36 ET
Table 'Malzovia' 6-max Seat #6 is the button
Seat 1: sapr.549 ($12.97 in chips) 
Seat 2: AAA_set_nh ($10 in chips) 
Seat 3: hardouin ($19.14 in chips) 
Seat 4: steinpilz1955 ($15.62 in chips) 
Seat 5: M0rganLeFaye ($19.26 in chips) 
Seat 6: Acedan1369 ($22.30 in chips) 
sapr.549: posts small blind $0.05
AAA_set_nh: posts big blind $0.10
*** HOLE CARDS ***
hardouin: folds 
steinpilz1955: calls $0.10
M0rganLeFaye: calls $0.10
Acedan1369: calls $0.10
sapr.549: folds 
AAA_set_nh: checks 
*** FLOP *** [9h 6c Kh]
AAA_set_nh: checks 
steinpilz1955: checks 
M0rganLeFaye: checks 
Acedan1369: checks 
*** TURN *** [9h 6c Kh] [Ts]
AAA_set_nh: checks 
steinpilz1955: bets $0.30
M0rganLeFaye: folds 
Acedan1369: calls $0.30
AAA_set_nh: folds 
*** RIVER *** [9h 6c Kh Ts] [Qd]
steinpilz1955: checks 
Acedan1369: bets $0.75
steinpilz1955: folds 
Uncalled bet ($0.75) returned to Acedan1369
Acedan1369 collected $1 from pot
Acedan1369: doesn't show hand 
*** SUMMARY ***
Total pot $1.05 | Rake $0.05 
Board [9h 6c Kh Ts Qd]
Seat 1: sapr.549 (small blind) folded before Flop
Seat 2: AAA_set_nh (big blind) folded on the Turn
Seat 3: hardouin folded before Flop (didn't bet)
Seat 4: steinpilz1955 folded on the River
Seat 5: M0rganLeFaye folded on the Turn
Seat 6: Acedan1369 (button) collected ($1)



PokerStars Hand #222967376436:  Hold'em No Limit ($0.05/$0.10 USD) - 2021/01/23 14:48:34 ET
Table 'Malzovia' 6-max Seat #1 is the button
Seat 1: sapr.549 ($12.92 in chips) 
Seat 2: AAA_set_nh ($10 in chips) 
Seat 3: hardouin ($19.14 in chips) 
Seat 4: steinpilz1955 ($15.22 in chips) 
Seat 5: M0rganLeFaye ($19.16 in chips) 
Seat 6: Acedan1369 ($22.90 in chips) 
AAA_set_nh: posts small blind $0.05
hardouin: posts big blind $0.10
*** HOLE CARDS ***
steinpilz1955: raises $0.30 to $0.40
M0rganLeFaye: folds 
Acedan1369: raises $0.80 to $1.20
sapr.549: folds 
AAA_set_nh: folds 
hardouin: folds 
steinpilz1955: calls $0.80
*** FLOP *** [6c 4h Tc]
steinpilz1955: checks 
Acedan1369: bets $1.83
steinpilz1955: calls $1.83
*** TURN *** [6c 4h Tc] [Jh]
steinpilz1955: checks 
Acedan1369: checks 
*** RIVER *** [6c 4h Tc Jh] [9s]
steinpilz1955: bets $0.30
Acedan1369: raises $2.94 to $3.24
steinpilz1955: folds 
Uncalled bet ($2.94) returned to Acedan1369
Acedan1369 collected $6.50 from pot
Acedan1369: doesn't show hand 
*** SUMMARY ***
Total pot $6.81 | Rake $0.31 
Board [6c 4h Tc Jh 9s]
Seat 1: sapr.549 (button) folded before Flop (didn't bet)
Seat 2: AAA_set_nh (small blind) folded before Flop
Seat 3: hardouin (big blind) folded before Flop
Seat 4: steinpilz1955 folded on the River
Seat 5: M0rganLeFaye folded before Flop (didn't bet)
Seat 6: Acedan1369 collected ($6.50)



PokerStars Hand #222967428211:  Hold'em No Limit ($0.05/$0.10 USD) - 2021/01/23 14:49:41 ET
Table 'Malzovia' 6-max Seat #2 is the button
Seat 1: sapr.549 ($12.92 in chips) 
Seat 2: AAA_set_nh ($10 in chips) 
Seat 3: hardouin ($19.04 in chips) 
Seat 4: steinpilz1955 ($11.89 in chips) 
Seat 5: M0rganLeFaye ($19.16 in chips) 
Seat 6: Acedan1369 ($26.07 in chips) 
hardouin: posts small blind $0.05
steinpilz1955: posts big blind $0.10
*** HOLE CARDS ***
M0rganLeFaye: raises $0.15 to $0.25
Acedan1369: folds 
sapr.549: folds 
AAA_set_nh: raises $0.50 to $0.75
hardouin: folds 
steinpilz1955: calls $0.65
M0rganLeFaye: folds 
*** FLOP *** [6s Ac 6c]
steinpilz1955: checks 
AAA_set_nh: bets $1.30
steinpilz1955: calls $1.30
*** TURN *** [6s Ac 6c] [Ah]
steinpilz1955: checks 
AAA_set_nh: bets $1.40
steinpilz1955: calls $1.40
*** RIVER *** [6s Ac 6c Ah] [Tc]
steinpilz1955: bets $8.44 and is all-in
AAA_set_nh: calls $6.55 and is all-in
Uncalled bet ($1.89) returned to steinpilz1955
*** SHOW DOWN ***
steinpilz1955: shows [9c 7c] (a flush, Ace high)
AAA_set_nh: shows [Ad Jd] (a full house, Aces full of Sixes)
AAA_set_nh collected $19.39 from pot
*** SUMMARY ***
Total pot $20.30 | Rake $0.91 
Board [6s Ac 6c Ah Tc]
Seat 1: sapr.549 folded before Flop (didn't bet)
Seat 2: AAA_set_nh (button) showed [Ad Jd] and won ($19.39) with a full house, Aces full of Sixes
Seat 3: hardouin (small blind) folded before Flop
Seat 4: steinpilz1955 (big blind) showed [9c 7c] and lost with a flush, Ace high
Seat 5: M0rganLeFaye folded before Flop
Seat 6: Acedan1369 folded before Flop (didn't bet)



PokerStars Hand #222967466152:  Hold'em No Limit ($0.05/$0.10 USD) - 2021/01/23 14:50:31 ET
Table 'Malzovia' 6-max Seat #3 is the button
Seat 1: sapr.549 ($12.92 in chips) 
Seat 2: AAA_set_nh ($19.39 in chips) 
Seat 3: hardouin ($18.99 in chips) 
Seat 4: steinpilz1955 ($1.89 in chips) 
Seat 5: M0rganLeFaye ($18.91 in chips) 
Seat 6: Acedan1369 ($26.07 in chips) 
steinpilz1955: posts small blind $0.05
M0rganLeFaye: posts big blind $0.10
*** HOLE CARDS ***
Acedan1369: folds 
sapr.549: folds 
AAA_set_nh: raises $0.10 to $0.20
hardouin: raises $0.40 to $0.60
steinpilz1955: calls $0.55
M0rganLeFaye: folds 
AAA_set_nh: folds 
*** FLOP *** [9s 9d 4d]
steinpilz1955: checks 
hardouin: bets $0.71
steinpilz1955: folds 
Uncalled bet ($0.71) returned to hardouin
hardouin collected $1.43 from pot
hardouin: doesn't show hand 
*** SUMMARY ***
Total pot $1.50 | Rake $0.07 
Board [9s 9d 4d]
Seat 1: sapr.549 folded before Flop (didn't bet)
Seat 2: AAA_set_nh folded before Flop
Seat 3: hardouin (button) collected ($1.43)
Seat 4: steinpilz1955 (small blind) folded on the Flop
Seat 5: M0rganLeFaye (big blind) folded before Flop
Seat 6: Acedan1369 folded before Flop (didn't bet)



PokerStars Hand #222967499240:  Hold'em No Limit ($0.05/$0.10 USD) - 2021/01/23 14:51:14 ET
Table 'Malzovia' 6-max Seat #4 is the button
Seat 1: sapr.549 ($12.92 in chips) 
Seat 2: AAA_set_nh ($19.19 in chips) 
Seat 3: hardouin ($19.82 in chips) 
Seat 4: steinpilz1955 ($7.62 in chips) 
Seat 5: M0rganLeFaye ($18.81 in chips) 
Seat 6: Acedan1369 ($26.07 in chips) 
M0rganLeFaye: posts small blind $0.05
Acedan1369: posts big blind $0.10
*** HOLE CARDS ***
sapr.549: folds 
AAA_set_nh: folds 
hardouin: folds 
steinpilz1955: folds 
M0rganLeFaye: folds 
Uncalled bet ($0.05) returned to Acedan1369
Acedan1369 collected $0.10 from pot
Acedan1369: doesn't show hand 
*** SUMMARY ***
Total pot $0.10 | Rake $0 
Seat 1: sapr.549 folded before Flop (didn't bet)
Seat 2: AAA_set_nh folded before Flop (didn't bet)
Seat 3: hardouin folded before Flop (didn't bet)
Seat 4: steinpilz1955 (button) folded before Flop (didn't bet)
Seat 5: M0rganLeFaye (small blind) folded before Flop
Seat 6: Acedan1369 (big blind) collected ($0.10)



PokerStars Hand #222967508548:  Hold'em No Limit ($0.05/$0.10 USD) - 2021/01/23 14:51:26 ET
Table 'Malzovia' 6-max Seat #5 is the button
Seat 1: sapr.549 ($12.92 in chips) 
Seat 2: AAA_set_nh ($19.19 in chips) 
Seat 3: hardouin ($19.82 in chips) 
Seat 4: steinpilz1955 ($7.62 in chips) 
Seat 5: M0rganLeFaye ($18.76 in chips) 
Seat 6: Acedan1369 ($26.12 in chips) 
Acedan1369: posts small blind $0.05
sapr.549: posts big blind $0.10
*** HOLE CARDS ***
AAA_set_nh: folds 
hardouin: folds 
steinpilz1955: raises $0.20 to $0.30
M0rganLeFaye: calls $0.30
Acedan1369: folds 
sapr.549: folds 
*** FLOP *** [8c 6h 5s]
steinpilz1955: checks 
M0rganLeFaye: checks 
*** TURN *** [8c 6h 5s] [5c]
steinpilz1955: checks 
M0rganLeFaye: checks 
*** RIVER *** [8c 6h 5s 5c] [8s]
steinpilz1955: checks 
M0rganLeFaye: bets $1.20
steinpilz1955: folds 
Uncalled bet ($1.20) returned to M0rganLeFaye
M0rganLeFaye collected $0.72 from pot
*** SUMMARY ***
Total pot $0.75 | Rake $0.03 
Board [8c 6h 5s 5c 8s]
Seat 1: sapr.549 (big blind) folded before Flop
Seat 2: AAA_set_nh folded before Flop (didn't bet)
Seat 3: hardouin folded before Flop (didn't bet)
Seat 4: steinpilz1955 folded on the River
Seat 5: M0rganLeFaye (button) collected ($0.72)
Seat 6: Acedan1369 (small blind) folded before Flop



PokerStars Hand #222967560123:  Hold'em No Limit ($0.05/$0.10 USD) - 2021/01/23 14:52:33 ET
Table 'Malzovia' 6-max Seat #6 is the button
Seat 1: sapr.549 ($12.82 in chips) 
Seat 2: AAA_set_nh ($19.19 in chips) 
Seat 3: hardouin ($19.82 in chips) 
Seat 4: steinpilz1955 ($9.70 in chips) 
Seat 5: M0rganLeFaye ($19.18 in chips) 
Seat 6: Acedan1369 ($26.07 in chips) 
sapr.549: posts small blind $0.05
AAA_set_nh: posts big blind $0.10
*** HOLE CARDS ***
hardouin: folds 
steinpilz1955: raises $0.20 to $0.30
M0rganLeFaye: folds 
Acedan1369: folds 
sapr.549: raises $0.62 to $0.92
AAA_set_nh: folds 
steinpilz1955: raises $0.62 to $1.54
sapr.549: calls $0.62
*** FLOP *** [Jc 2d Th]
sapr.549: checks 
steinpilz1955: bets $2.80
sapr.549: calls $2.80
*** TURN *** [Jc 2d Th] [5s]
sapr.549: checks 
steinpilz1955: bets $5.36 and is all-in
sapr.549: folds 
Uncalled bet ($5.36) returned to steinpilz1955
steinpilz1955 collected $8.38 from pot
*** SUMMARY ***
Total pot $8.78 | Rake $0.40 
Board [Jc 2d Th 5s]
Seat 1: sapr.549 (small blind) folded on the Turn
Seat 2: AAA_set_nh (big blind) folded before Flop
Seat 3: hardouin folded before Flop (didn't bet)
Seat 4: steinpilz1955 collected ($8.38)
Seat 5: M0rganLeFaye folded before Flop (didn't bet)
Seat 6: Acedan1369 (button) folded before Flop (didn't bet)



PokerStars Hand #222967602758:  Hold'em No Limit ($0.05/$0.10 USD) - 2021/01/23 14:53:28 ET
Table 'Malzovia' 6-max Seat #1 is the button
Seat 1: sapr.549 ($8.48 in chips) 
Seat 2: AAA_set_nh ($19.09 in chips) 
Seat 3: hardouin ($19.82 in chips) 
Seat 4: steinpilz1955 ($13.74 in chips) 
Seat 5: M0rganLeFaye ($19.18 in chips) 
Seat 6: Acedan1369 ($26.07 in chips) 
AAA_set_nh: posts small blind $0.05
hardouin: posts big blind $0.10
*** HOLE CARDS ***
steinpilz1955: calls $0.10
M0rganLeFaye: folds 
Acedan1369: folds 
sapr.549: folds 
AAA_set_nh: folds 
hardouin: checks 
*** FLOP *** [Js Kc 9h]
hardouin: checks 
steinpilz1955: checks 
*** TURN *** [Js Kc 9h] [4s]
hardouin: checks 
steinpilz1955: checks 
*** RIVER *** [Js Kc 9h 4s] [4h]
hardouin: checks 
steinpilz1955: checks 
*** SHOW DOWN ***
hardouin: shows [8c 5h] (a pair of Fours)
steinpilz1955: shows [2d Ad] (a pair of Fours - Ace kicker)
steinpilz1955 collected $0.24 from pot
*** SUMMARY ***
Total pot $0.25 | Rake $0.01 
Board [Js Kc 9h 4s 4h]
Seat 1: sapr.549 (button) folded before Flop (didn't bet)
Seat 2: AAA_set_nh (small blind) folded before Flop
Seat 3: hardouin (big blind) showed [8c 5h] and lost with a pair of Fours
Seat 4: steinpilz1955 showed [2d Ad] and won ($0.24) with a pair of Fours
Seat 5: M0rganLeFaye folded before Flop (didn't bet)
Seat 6: Acedan1369 folded before Flop (didn't bet)



PokerStars Hand #222967641957:  Hold'em No Limit ($0.05/$0.10 USD) - 2021/01/23 14:54:11 ET
Table 'Malzovia' 6-max Seat #2 is the button
Seat 1: sapr.549 ($8.48 in chips) 
Seat 2: AAA_set_nh ($19.04 in chips) 
Seat 3: hardouin ($19.72 in chips) 
Seat 4: steinpilz1955 ($13.88 in chips) 
Seat 5: M0rganLeFaye ($19.18 in chips) 
Seat 6: Acedan1369 ($26.07 in chips) 
hardouin: posts small blind $0.05
steinpilz1955: posts big blind $0.10
*** HOLE CARDS ***
M0rganLeFaye: folds 
Acedan1369: folds 
sapr.549: folds 
AAA_set_nh: raises $0.10 to $0.20
hardouin: folds 
steinpilz1955: calls $0.10
*** FLOP *** [5h 6d 8c]
steinpilz1955: checks 
AAA_set_nh: bets $0.29
steinpilz1955: calls $0.29
*** TURN *** [5h 6d 8c] [Js]
steinpilz1955: checks 
AAA_set_nh: checks 
*** RIVER *** [5h 6d 8c Js] [Td]
steinpilz1955: checks 
AAA_set_nh: checks 
*** SHOW DOWN ***
steinpilz1955: shows [Kd 5c] (a pair of Fives)
AAA_set_nh: shows [8d Qd] (a pair of Eights)
AAA_set_nh collected $0.98 from pot
*** SUMMARY ***
Total pot $1.03 | Rake $0.05 
Board [5h 6d 8c Js Td]
Seat 1: sapr.549 folded before Flop (didn't bet)
Seat 2: AAA_set_nh (button) showed [8d Qd] and won ($0.98) with a pair of Eights
Seat 3: hardouin (small blind) folded before Flop
Seat 4: steinpilz1955 (big blind) showed [Kd 5c] and lost with a pair of Fives
Seat 5: M0rganLeFaye folded before Flop (didn't bet)
Seat 6: Acedan1369 folded before Flop (didn't bet)



PokerStars Hand #222967676926:  Hold'em No Limit ($0.05/$0.10 USD) - 2021/01/23 14:54:56 ET
Table 'Malzovia' 6-max Seat #3 is the button
Seat 1: sapr.549 ($8.48 in chips) 
Seat 2: AAA_set_nh ($19.53 in chips) 
Seat 3: hardouin ($19.67 in chips) 
Seat 4: steinpilz1955 ($13.39 in chips) 
Seat 5: M0rganLeFaye ($19.18 in chips) 
Seat 6: Acedan1369 ($26.07 in chips) 
steinpilz1955: posts small blind $0.05
M0rganLeFaye: posts big blind $0.10
*** HOLE CARDS ***
Acedan1369: folds 
sapr.549: folds 
AAA_set_nh: folds 
hardouin: raises $0.15 to $0.25
steinpilz1955: calls $0.20
M0rganLeFaye: calls $0.15
*** FLOP *** [8c As 2c]
steinpilz1955: checks 
M0rganLeFaye: checks 
hardouin: checks 
*** TURN *** [8c As 2c] [Qc]
steinpilz1955: bets $0.30
M0rganLeFaye: calls $0.30
hardouin: raises $0.60 to $0.90
steinpilz1955: folds 
M0rganLeFaye: calls $0.60
*** RIVER *** [8c As 2c Qc] [Th]
M0rganLeFaye: bets $1.63
hardouin: raises $3.26 to $4.89
M0rganLeFaye: folds 
Uncalled bet ($3.26) returned to hardouin
hardouin collected $5.84 from pot
hardouin: doesn't show hand 
*** SUMMARY ***
Total pot $6.11 | Rake $0.27 
Board [8c As 2c Qc Th]
Seat 1: sapr.549 folded before Flop (didn't bet)
Seat 2: AAA_set_nh folded before Flop (didn't bet)
Seat 3: hardouin (button) collected ($5.84)
Seat 4: steinpilz1955 (small blind) folded on the Turn
Seat 5: M0rganLeFaye (big blind) folded on the River
Seat 6: Acedan1369 folded before Flop (didn't bet)



PokerStars Hand #222967753371:  Hold'em No Limit ($0.05/$0.10 USD) - 2021/01/23 14:57:14 ET
Table 'Malzovia' 6-max Seat #4 is the button
Seat 1: sapr.549 ($8.48 in chips) 
Seat 2: AAA_set_nh ($19.53 in chips) 
Seat 3: hardouin ($22.73 in chips) 
Seat 4: steinpilz1955 ($12.84 in chips) 
Seat 5: M0rganLeFaye ($16.40 in chips) 
Seat 6: Acedan1369 ($26.07 in chips) 
M0rganLeFaye: posts small blind $0.05
Acedan1369: posts big blind $0.10
*** HOLE CARDS ***
sapr.549: folds 
AAA_set_nh: folds 
hardouin: folds 
steinpilz1955: folds 
M0rganLeFaye: folds 
Uncalled bet ($0.05) returned to Acedan1369
Acedan1369 collected $0.10 from pot
Acedan1369: doesn't show hand 
*** SUMMARY ***
Total pot $0.10 | Rake $0 
Seat 1: sapr.549 folded before Flop (didn't bet)
Seat 2: AAA_set_nh folded before Flop (didn't bet)
Seat 3: hardouin folded before Flop (didn't bet)
Seat 4: steinpilz1955 (button) folded before Flop (didn't bet)
Seat 5: M0rganLeFaye (small blind) folded before Flop
Seat 6: Acedan1369 (big blind) collected ($0.10)



PokerStars Hand #222967757900:  Hold'em No Limit ($0.05/$0.10 USD) - 2021/01/23 14:57:23 ET
Table 'Malzovia' 6-max Seat #5 is the button
Seat 1: sapr.549 ($8.48 in chips) 
Seat 2: AAA_set_nh ($19.53 in chips) 
Seat 3: hardouin ($22.73 in chips) 
Seat 4: steinpilz1955 ($12.84 in chips) 
Seat 5: M0rganLeFaye ($16.35 in chips) 
Seat 6: Acedan1369 ($26.12 in chips) 
Acedan1369: posts small blind $0.05
sapr.549: posts big blind $0.10
*** HOLE CARDS ***
AAA_set_nh: folds 
hardouin: folds 
steinpilz1955: raises $0.20 to $0.30
M0rganLeFaye: folds 
Acedan1369: folds 
sapr.549: folds 
Uncalled bet ($0.20) returned to steinpilz1955
steinpilz1955 collected $0.25 from pot
*** SUMMARY ***
Total pot $0.25 | Rake $0 
Seat 1: sapr.549 (big blind) folded before Flop
Seat 2: AAA_set_nh folded before Flop (didn't bet)
Seat 3: hardouin folded before Flop (didn't bet)
Seat 4: steinpilz1955 collected ($0.25)
Seat 5: M0rganLeFaye (button) folded before Flop (didn't bet)
Seat 6: Acedan1369 (small blind) folded before Flop



PokerStars Hand #222967767286:  Hold'em No Limit ($0.05/$0.10 USD) - 2021/01/23 14:57:40 ET
Table 'Malzovia' 6-max Seat #6 is the button
Seat 1: sapr.549 ($8.38 in chips) 
Seat 2: AAA_set_nh ($19.53 in chips) 
Seat 3: hardouin ($22.73 in chips) 
Seat 4: steinpilz1955 ($12.99 in chips) 
Seat 5: M0rganLeFaye ($16.35 in chips) 
Seat 6: Acedan1369 ($26.07 in chips) 
sapr.549: posts small blind $0.05
AAA_set_nh: posts big blind $0.10
*** HOLE CARDS ***
hardouin: folds 
steinpilz1955: folds 
M0rganLeFaye: folds 
Acedan1369: raises $0.15 to $0.25
sapr.549: folds 
AAA_set_nh: folds 
Uncalled bet ($0.15) returned to Acedan1369
Acedan1369 collected $0.25 from pot
Acedan1369: doesn't show hand 
*** SUMMARY ***
Total pot $0.25 | Rake $0 
Seat 1: sapr.549 (small blind) folded before Flop
Seat 2: AAA_set_nh (big blind) folded before Flop
Seat 3: hardouin folded before Flop (didn't bet)
Seat 4: steinpilz1955 folded before Flop (didn't bet)
Seat 5: M0rganLeFaye folded before Flop (didn't bet)
Seat 6: Acedan1369 (button) collected ($0.25)



PokerStars Hand #222967775392:  Hold'em No Limit ($0.05/$0.10 USD) - 2021/01/23 14:57:56 ET
Table 'Malzovia' 6-max Seat #1 is the button
Seat 1: sapr.549 ($8.33 in chips) 
Seat 2: AAA_set_nh ($19.43 in chips) 
Seat 3: hardouin ($22.73 in chips) 
Seat 4: steinpilz1955 ($12.99 in chips) 
Seat 5: M0rganLeFaye ($16.35 in chips) 
Seat 6: Acedan1369 ($26.22 in chips) 
AAA_set_nh: posts small blind $0.05
hardouin: posts big blind $0.10
*** HOLE CARDS ***
steinpilz1955: calls $0.10
M0rganLeFaye: folds 
Acedan1369: folds 
sapr.549: folds 
M0rganLeFaye leaves the table
AAA_set_nh: calls $0.05
hardouin: checks 
*** FLOP *** [2d Tc 6s]
AAA_set_nh: checks 
hardouin: checks 
VisirMartin joins the table at seat #5 
steinpilz1955: checks 
*** TURN *** [2d Tc 6s] [2s]
AAA_set_nh: checks 
hardouin: checks 
steinpilz1955: checks 
*** RIVER *** [2d Tc 6s 2s] [Th]
AAA_set_nh: checks 
hardouin: checks 
steinpilz1955: checks 
*** SHOW DOWN ***
AAA_set_nh: shows [9d Qh] (two pair, Tens and Deuces)
hardouin: shows [Kd Jc] (two pair, Tens and Deuces - King kicker)
steinpilz1955: mucks hand 
hardouin collected $0.29 from pot
*** SUMMARY ***
Total pot $0.30 | Rake $0.01 
Board [2d Tc 6s 2s Th]
Seat 1: sapr.549 (button) folded before Flop (didn't bet)
Seat 2: AAA_set_nh (small blind) showed [9d Qh] and lost with two pair, Tens and Deuces
Seat 3: hardouin (big blind) showed [Kd Jc] and won ($0.29) with two pair, Tens and Deuces
Seat 4: steinpilz1955 mucked
Seat 5: M0rganLeFaye folded before Flop (didn't bet)
Seat 6: Acedan1369 folded before Flop (didn't bet)



PokerStars Hand #222967805146:  Hold'em No Limit ($0.05/$0.10 USD) - 2021/01/23 14:58:51 ET
Table 'Malzovia' 6-max Seat #2 is the button
Seat 1: sapr.549 ($8.33 in chips) 
Seat 2: AAA_set_nh ($19.33 in chips) 
Seat 3: hardouin ($22.92 in chips) 
Seat 4: steinpilz1955 ($12.89 in chips) 
Seat 6: Acedan1369 ($26.22 in chips) 
hardouin: posts small blind $0.05
steinpilz1955: posts big blind $0.10
VisirMartin: sits out 
*** HOLE CARDS ***
Acedan1369: raises $0.15 to $0.25
sapr.549: folds 
AAA_set_nh: folds 
hardouin: folds 
steinpilz1955: folds 
Uncalled bet ($0.15) returned to Acedan1369
Acedan1369 collected $0.25 from pot
Acedan1369: doesn't show hand 
*** SUMMARY ***
Total pot $0.25 | Rake $0 
Seat 1: sapr.549 folded before Flop (didn't bet)
Seat 2: AAA_set_nh (button) folded before Flop (didn't bet)
Seat 3: hardouin (small blind) folded before Flop
Seat 4: steinpilz1955 (big blind) folded before Flop
Seat 6: Acedan1369 collected ($0.25)



PokerStars Hand #222967814179:  Hold'em No Limit ($0.05/$0.10 USD) - 2021/01/23 14:59:08 ET
Table 'Malzovia' 6-max Seat #3 is the button
Seat 1: sapr.549 ($8.33 in chips) 
Seat 2: AAA_set_nh ($19.33 in chips) 
Seat 3: hardouin ($22.87 in chips) 
Seat 4: steinpilz1955 ($12.79 in chips) 
Seat 5: VisirMartin ($7 in chips) 
Seat 6: Acedan1369 ($26.37 in chips) 
steinpilz1955: posts small blind $0.05
VisirMartin: posts big blind $0.10
*** HOLE CARDS ***
Acedan1369: folds 
sapr.549: folds 
AAA_set_nh: folds 
hardouin: folds 
steinpilz1955: calls $0.05
VisirMartin: raises $0.20 to $0.30
steinpilz1955: calls $0.20
*** FLOP *** [7c Kc 2c]
steinpilz1955: checks 
VisirMartin: bets $0.29
steinpilz1955: calls $0.29
*** TURN *** [7c Kc 2c] [4c]
steinpilz1955: checks 
VisirMartin: checks 
*** RIVER *** [7c Kc 2c 4c] [Qc]
steinpilz1955: bets $0.30
VisirMartin: calls $0.30
*** SHOW DOWN ***
steinpilz1955: shows [Tc 3c] (a flush, King high)
VisirMartin: shows [Jc 8c] (a flush, King high - Jack higher)
VisirMartin collected $1.70 from pot
*** SUMMARY ***
Total pot $1.78 | Rake $0.08 
Board [7c Kc 2c 4c Qc]
Seat 1: sapr.549 folded before Flop (didn't bet)
Seat 2: AAA_set_nh folded before Flop (didn't bet)
Seat 3: hardouin (button) folded before Flop (didn't bet)
Seat 4: steinpilz1955 (small blind) showed [Tc 3c] and lost with a flush, King high
Seat 5: VisirMartin (big blind) showed [Jc 8c] and won ($1.70) with a flush, King high
Seat 6: Acedan1369 folded before Flop (didn't bet)



PokerStars Hand #222967844441:  Hold'em No Limit ($0.05/$0.10 USD) - 2021/01/23 15:00:03 ET
Table 'Malzovia' 6-max Seat #4 is the button
Seat 1: sapr.549 ($8.33 in chips) 
Seat 2: AAA_set_nh ($19.33 in chips) 
Seat 3: hardouin ($22.87 in chips) 
Seat 4: steinpilz1955 ($11.90 in chips) 
Seat 5: VisirMartin ($7.81 in chips) 
Seat 6: Acedan1369 ($26.37 in chips) 
VisirMartin: posts small blind $0.05
Acedan1369: posts big blind $0.10
*** HOLE CARDS ***
sapr.549: folds 
AAA_set_nh: folds 
hardouin: folds 
steinpilz1955: folds 
VisirMartin: folds 
Uncalled bet ($0.05) returned to Acedan1369
Acedan1369 collected $0.10 from pot
Acedan1369: doesn't show hand 
*** SUMMARY ***
Total pot $0.10 | Rake $0 
Seat 1: sapr.549 folded before Flop (didn't bet)
Seat 2: AAA_set_nh folded before Flop (didn't bet)
Seat 3: hardouin folded before Flop (didn't bet)
Seat 4: steinpilz1955 (button) folded before Flop (didn't bet)
Seat 5: VisirMartin (small blind) folded before Flop
Seat 6: Acedan1369 (big blind) collected ($0.10)



PokerStars Hand #222967851043:  Hold'em No Limit ($0.05/$0.10 USD) - 2021/01/23 15:00:15 ET
Table 'Malzovia' 6-max Seat #5 is the button
Seat 1: sapr.549 ($8.33 in chips) 
Seat 2: AAA_set_nh ($19.33 in chips) 
Seat 3: hardouin ($22.87 in chips) 
Seat 4: steinpilz1955 ($11.90 in chips) 
Seat 5: VisirMartin ($7.76 in chips) 
Seat 6: Acedan1369 ($26.42 in chips) 
Acedan1369: posts small blind $0.05
sapr.549: posts big blind $0.10
*** HOLE CARDS ***
AAA_set_nh: folds 
hardouin: folds 
steinpilz1955: folds 
VisirMartin: folds 
Acedan1369: raises $0.15 to $0.25
sapr.549: folds 
Uncalled bet ($0.15) returned to Acedan1369
Acedan1369 collected $0.20 from pot
Acedan1369: doesn't show hand 
*** SUMMARY ***
Total pot $0.20 | Rake $0 
Seat 1: sapr.549 (big blind) folded before Flop
Seat 2: AAA_set_nh folded before Flop (didn't bet)
Seat 3: hardouin folded before Flop (didn't bet)
Seat 4: steinpilz1955 folded before Flop (didn't bet)
Seat 5: VisirMartin (button) folded before Flop (didn't bet)
Seat 6: Acedan1369 (small blind) collected ($0.20)



PokerStars Hand #222967859168:  Hold'em No Limit ($0.05/$0.10 USD) - 2021/01/23 15:00:29 ET
Table 'Malzovia' 6-max Seat #6 is the button
Seat 1: sapr.549 ($8.23 in chips) 
Seat 2: AAA_set_nh ($19.33 in chips) 
Seat 3: hardouin ($22.87 in chips) 
Seat 4: steinpilz1955 ($11.90 in chips) 
Seat 5: VisirMartin ($7.76 in chips) 
Seat 6: Acedan1369 ($26.52 in chips) 
sapr.549: posts small blind $0.05
AAA_set_nh: posts big blind $0.10
*** HOLE CARDS ***
hardouin: raises $0.20 to $0.30
steinpilz1955: raises $0.40 to $0.70
VisirMartin: folds 
Acedan1369: folds 
sapr.549: folds 
AAA_set_nh: folds 
hardouin: calls $0.40
*** FLOP *** [Th Jc 9c]
hardouin: checks 
steinpilz1955 has timed out
steinpilz1955: checks 
*** TURN *** [Th Jc 9c] [6h]
hardouin: bets $1.48
steinpilz1955: folds 
Uncalled bet ($1.48) returned to hardouin
hardouin collected $1.48 from pot
hardouin: doesn't show hand 
*** SUMMARY ***
Total pot $1.55 | Rake $0.07 
Board [Th Jc 9c 6h]
Seat 1: sapr.549 (small blind) folded before Flop
Seat 2: AAA_set_nh (big blind) folded before Flop
Seat 3: hardouin collected ($1.48)
Seat 4: steinpilz1955 folded on the Turn
Seat 5: VisirMartin folded before Flop (didn't bet)
Seat 6: Acedan1369 (button) folded before Flop (didn't bet)



PokerStars Hand #222967941783:  Hold'em No Limit ($0.05/$0.10 USD) - 2021/01/23 15:02:19 ET
Table 'Malzovia' 6-max Seat #1 is the button
Seat 1: sapr.549 ($8.18 in chips) 
Seat 2: AAA_set_nh ($19.23 in chips) 
Seat 4: steinpilz1955 ($11.20 in chips) 
Seat 5: VisirMartin ($7.76 in chips) 
Seat 6: Acedan1369 ($26.52 in chips) 
AAA_set_nh: posts small blind $0.05
hardouin: is sitting out 
steinpilz1955: posts big blind $0.10
*** HOLE CARDS ***
VisirMartin: folds 
Acedan1369: folds 
sapr.549: folds 
AAA_set_nh: raises $0.20 to $0.30
steinpilz1955: calls $0.20
*** FLOP *** [4c Qc 7c]
AAA_set_nh: checks 
steinpilz1955: bets $0.40
AAA_set_nh: calls $0.40
*** TURN *** [4c Qc 7c] [Qh]
AAA_set_nh: checks 
steinpilz1955: checks 
*** RIVER *** [4c Qc 7c Qh] [3c]
AAA_set_nh: checks 
steinpilz1955: checks 
*** SHOW DOWN ***
AAA_set_nh: shows [9c Jh] (a flush, Queen high)
steinpilz1955: mucks hand 
AAA_set_nh collected $1.34 from pot
*** SUMMARY ***
Total pot $1.40 | Rake $0.06 
Board [4c Qc 7c Qh 3c]
Seat 1: sapr.549 (button) folded before Flop (didn't bet)
Seat 2: AAA_set_nh (small blind) showed [9c Jh] and won ($1.34) with a flush, Queen high
Seat 4: steinpilz1955 (big blind) mucked
Seat 5: VisirMartin folded before Flop (didn't bet)
Seat 6: Acedan1369 folded before Flop (didn't bet)



PokerStars Hand #222967965754:  Hold'em No Limit ($0.05/$0.10 USD) - 2021/01/23 15:02:49 ET
Table 'Malzovia' 6-max Seat #2 is the button
Seat 1: sapr.549 ($8.18 in chips) 
Seat 2: AAA_set_nh ($19.87 in chips) 
Seat 4: steinpilz1955 ($10.50 in chips) 
Seat 5: VisirMartin ($7.76 in chips) 
Seat 6: Acedan1369 ($26.52 in chips) 
steinpilz1955: posts small blind $0.05
VisirMartin: posts big blind $0.10
*** HOLE CARDS ***
Acedan1369: raises $0.15 to $0.25
sapr.549: folds 
AAA_set_nh: folds 
steinpilz1955: folds 
VisirMartin: calls $0.15
*** FLOP *** [5d 5s Tc]
VisirMartin: checks 
Acedan1369: bets $0.24
VisirMartin: folds 
Uncalled bet ($0.24) returned to Acedan1369
Acedan1369 collected $0.53 from pot
Acedan1369: doesn't show hand 
*** SUMMARY ***
Total pot $0.55 | Rake $0.02 
Board [5d 5s Tc]
Seat 1: sapr.549 folded before Flop (didn't bet)
Seat 2: AAA_set_nh (button) folded before Flop (didn't bet)
Seat 4: steinpilz1955 (small blind) folded before Flop
Seat 5: VisirMartin (big blind) folded on the Flop
Seat 6: Acedan1369 collected ($0.53)



PokerStars Hand #222967987918:  Hold'em No Limit ($0.05/$0.10 USD) - 2021/01/23 15:03:16 ET
Table 'Malzovia' 6-max Seat #4 is the button
Seat 1: sapr.549 ($8.18 in chips) 
Seat 2: AAA_set_nh ($19.87 in chips) 
Seat 4: steinpilz1955 ($10.45 in chips) 
Seat 5: VisirMartin ($7.51 in chips) 
Seat 6: Acedan1369 ($26.80 in chips) 
VisirMartin: posts small blind $0.05
Acedan1369: posts big blind $0.10
*** HOLE CARDS ***
sapr.549: folds 
AAA_set_nh: raises $0.15 to $0.25
steinpilz1955: folds 
VisirMartin: calls $0.20
Acedan1369: folds 
*** FLOP *** [4h Th 6s]
VisirMartin: bets $0.37
AAA_set_nh: folds 
Uncalled bet ($0.37) returned to VisirMartin
VisirMartin collected $0.57 from pot
VisirMartin: doesn't show hand 
*** SUMMARY ***
Total pot $0.60 | Rake $0.03 
Board [4h Th 6s]
Seat 1: sapr.549 folded before Flop (didn't bet)
Seat 2: AAA_set_nh folded on the Flop
Seat 4: steinpilz1955 (button) folded before Flop (didn't bet)
Seat 5: VisirMartin (small blind) collected ($0.57)
Seat 6: Acedan1369 (big blind) folded before Flop



PokerStars Hand #222968016327:  Hold'em No Limit ($0.05/$0.10 USD) - 2021/01/23 15:03:52 ET
Table 'Malzovia' 6-max Seat #5 is the button
Seat 1: sapr.549 ($8.18 in chips) 
Seat 2: AAA_set_nh ($19.62 in chips) 
Seat 4: steinpilz1955 ($10.45 in chips) 
Seat 5: VisirMartin ($7.83 in chips) 
Seat 6: Acedan1369 ($26.70 in chips) 
Acedan1369: posts small blind $0.05
sapr.549: posts big blind $0.10
*** HOLE CARDS ***
AAA_set_nh: folds 
steinpilz1955: calls $0.10
VisirMartin: folds 
Acedan1369: raises $0.20 to $0.30
sapr.549: calls $0.20
steinpilz1955: calls $0.20
*** FLOP *** [Ks Qs 9h]
Acedan1369: checks 
sapr.549: checks 
steinpilz1955: bets $0.40
Acedan1369: calls $0.40
sapr.549: calls $0.40
*** TURN *** [Ks Qs 9h] [Ac]
Acedan1369: checks 
sapr.549: checks 
steinpilz1955: checks 
*** RIVER *** [Ks Qs 9h Ac] [3d]
Acedan1369: checks 
sapr.549: checks 
steinpilz1955: bets $0.50
Acedan1369: calls $0.50
sapr.549: folds 
*** SHOW DOWN ***
steinpilz1955: shows [3s Kc] (two pair, Kings and Threes)
Acedan1369: mucks hand 
steinpilz1955 collected $2.96 from pot
*** SUMMARY ***
Total pot $3.10 | Rake $0.14 
Board [Ks Qs 9h Ac 3d]
Seat 1: sapr.549 (big blind) folded on the River
Seat 2: AAA_set_nh folded before Flop (didn't bet)
Seat 4: steinpilz1955 showed [3s Kc] and won ($2.96) with two pair, Kings and Threes
Seat 5: VisirMartin (button) folded before Flop (didn't bet)
Seat 6: Acedan1369 (small blind) mucked



PokerStars Hand #222968087003:  Hold'em No Limit ($0.05/$0.10 USD) - 2021/01/23 15:05:18 ET
Table 'Malzovia' 6-max Seat #6 is the button
Seat 1: sapr.549 ($7.48 in chips) 
Seat 2: AAA_set_nh ($19.62 in chips) 
Seat 4: steinpilz1955 ($12.21 in chips) 
Seat 5: VisirMartin ($7.83 in chips) 
Seat 6: Acedan1369 ($25.50 in chips) 
sapr.549: posts small blind $0.05
AAA_set_nh: posts big blind $0.10
*** HOLE CARDS ***
steinpilz1955: calls $0.10
VisirMartin: folds 
Acedan1369: folds 
sapr.549: folds 
AAA_set_nh: checks 
*** FLOP *** [8s 3s 9c]
AAA_set_nh: bets $0.16
steinpilz1955: calls $0.16
*** TURN *** [8s 3s 9c] [4c]
AAA_set_nh: bets $0.36
steinpilz1955: calls $0.36
*** RIVER *** [8s 3s 9c 4c] [Kd]
AAA_set_nh: bets $1.10
steinpilz1955: calls $1.10
*** SHOW DOWN ***
AAA_set_nh: shows [Kc 8d] (two pair, Kings and Eights)
steinpilz1955: mucks hand 
AAA_set_nh collected $3.33 from pot
*** SUMMARY ***
Total pot $3.49 | Rake $0.16 
Board [8s 3s 9c 4c Kd]
Seat 1: sapr.549 (small blind) folded before Flop
Seat 2: AAA_set_nh (big blind) showed [Kc 8d] and won ($3.33) with two pair, Kings and Eights
Seat 4: steinpilz1955 mucked
Seat 5: VisirMartin folded before Flop (didn't bet)
Seat 6: Acedan1369 (button) folded before Flop (didn't bet)



PokerStars Hand #222968116812:  Hold'em No Limit ($0.05/$0.10 USD) - 2021/01/23 15:05:53 ET
Table 'Malzovia' 6-max Seat #1 is the button
Seat 1: sapr.549 ($7.43 in chips) 
Seat 2: AAA_set_nh ($21.23 in chips) 
Seat 4: steinpilz1955 ($10.49 in chips) 
Seat 5: VisirMartin ($7.83 in chips) 
Seat 6: Acedan1369 ($25.50 in chips) 
AAA_set_nh: posts small blind $0.05
steinpilz1955: posts big blind $0.10
*** HOLE CARDS ***
VisirMartin: folds 
Acedan1369: raises $0.15 to $0.25
sapr.549: folds 
AAA_set_nh: folds 
steinpilz1955: raises $0.65 to $0.90
Acedan1369: calls $0.65
*** FLOP *** [Kc 3h 6s]
steinpilz1955: bets $0.50
Acedan1369: folds 
Uncalled bet ($0.50) returned to steinpilz1955
steinpilz1955 collected $1.77 from pot
*** SUMMARY ***
Total pot $1.85 | Rake $0.08 
Board [Kc 3h 6s]
Seat 1: sapr.549 (button) folded before Flop (didn't bet)
Seat 2: AAA_set_nh (small blind) folded before Flop
Seat 4: steinpilz1955 (big blind) collected ($1.77)
Seat 5: VisirMartin folded before Flop (didn't bet)
Seat 6: Acedan1369 folded on the Flop



PokerStars Hand #222968137970:  Hold'em No Limit ($0.05/$0.10 USD) - 2021/01/23 15:06:19 ET
Table 'Malzovia' 6-max Seat #2 is the button
Seat 1: sapr.549 ($7.43 in chips) 
Seat 2: AAA_set_nh ($21.18 in chips) 
Seat 4: steinpilz1955 ($11.36 in chips) 
Seat 5: VisirMartin ($7.83 in chips) 
Seat 6: Acedan1369 ($24.60 in chips) 
steinpilz1955: posts small blind $0.05
VisirMartin: posts big blind $0.10
*** HOLE CARDS ***
Acedan1369: raises $0.15 to $0.25
sapr.549: folds 
AAA_set_nh: folds 
steinpilz1955: calls $0.20
VisirMartin: folds 
*** FLOP *** [2d Ks Tc]
steinpilz1955: checks 
Acedan1369: bets $0.43
steinpilz1955: calls $0.43
*** TURN *** [2d Ks Tc] [2h]
steinpilz1955: checks 
Acedan1369: bets $1.04
steinpilz1955: folds 
Uncalled bet ($1.04) returned to Acedan1369
Acedan1369 collected $1.39 from pot
Acedan1369: doesn't show hand 
*** SUMMARY ***
Total pot $1.46 | Rake $0.07 
Board [2d Ks Tc 2h]
Seat 1: sapr.549 folded before Flop (didn't bet)
Seat 2: AAA_set_nh (button) folded before Flop (didn't bet)
Seat 4: steinpilz1955 (small blind) folded on the Turn
Seat 5: VisirMartin (big blind) folded before Flop
Seat 6: Acedan1369 collected ($1.39)



PokerStars Hand #222968161883:  Hold'em No Limit ($0.05/$0.10 USD) - 2021/01/23 15:06:47 ET
Table 'Malzovia' 6-max Seat #4 is the button
Seat 1: sapr.549 ($7.43 in chips) 
Seat 2: AAA_set_nh ($21.18 in chips) 
Seat 4: steinpilz1955 ($10.68 in chips) 
Seat 5: VisirMartin ($7.73 in chips) 
Seat 6: Acedan1369 ($25.31 in chips) 
VisirMartin: posts small blind $0.05
Acedan1369: posts big blind $0.10
*** HOLE CARDS ***
sapr.549: folds 
AAA_set_nh: raises $0.15 to $0.25
steinpilz1955: calls $0.25
VisirMartin: folds 
Acedan1369: folds 
*** FLOP *** [2c 8h Ts]
AAA_set_nh: checks 
steinpilz1955: bets $0.40
AAA_set_nh: folds 
Uncalled bet ($0.40) returned to steinpilz1955
steinpilz1955 collected $0.62 from pot
*** SUMMARY ***
Total pot $0.65 | Rake $0.03 
Board [2c 8h Ts]
Seat 1: sapr.549 folded before Flop (didn't bet)
Seat 2: AAA_set_nh folded on the Flop
Seat 4: steinpilz1955 (button) collected ($0.62)
Seat 5: VisirMartin (small blind) folded before Flop
Seat 6: Acedan1369 (big blind) folded before Flop



PokerStars Hand #222968177215:  Hold'em No Limit ($0.05/$0.10 USD) - 2021/01/23 15:07:06 ET
Table 'Malzovia' 6-max Seat #5 is the button
Seat 1: sapr.549 ($7.43 in chips) 
Seat 2: AAA_set_nh ($20.93 in chips) 
Seat 4: steinpilz1955 ($11.05 in chips) 
Seat 5: VisirMartin ($7.68 in chips) 
Seat 6: Acedan1369 ($25.21 in chips) 
Acedan1369: posts small blind $0.05
sapr.549: posts big blind $0.10
*** HOLE CARDS ***
AAA_set_nh: folds 
steinpilz1955: folds 
VisirMartin: folds 
Acedan1369: folds 
Uncalled bet ($0.05) returned to sapr.549
sapr.549 collected $0.10 from pot
sapr.549: doesn't show hand 
*** SUMMARY ***
Total pot $0.10 | Rake $0 
Seat 1: sapr.549 (big blind) collected ($0.10)
Seat 2: AAA_set_nh folded before Flop (didn't bet)
Seat 4: steinpilz1955 folded before Flop (didn't bet)
Seat 5: VisirMartin (button) folded before Flop (didn't bet)
Seat 6: Acedan1369 (small blind) folded before Flop



PokerStars Hand #222968187671:  Hold'em No Limit ($0.05/$0.10 USD) - 2021/01/23 15:07:18 ET
Table 'Malzovia' 6-max Seat #6 is the button
Seat 1: sapr.549 ($7.48 in chips) 
Seat 2: AAA_set_nh ($20.93 in chips) 
Seat 4: steinpilz1955 ($11.05 in chips) 
Seat 5: VisirMartin ($7.68 in chips) 
Seat 6: Acedan1369 ($25.16 in chips) 
sapr.549: posts small blind $0.05
AAA_set_nh: posts big blind $0.10
*** HOLE CARDS ***
steinpilz1955: folds 
VisirMartin: raises $0.20 to $0.30
Acedan1369: raises $0.55 to $0.85
sapr.549: folds 
AAA_set_nh: folds 
VisirMartin: calls $0.55
*** FLOP *** [Td 2h 4s]
VisirMartin: checks 
Acedan1369: bets $1.33
VisirMartin: folds 
Uncalled bet ($1.33) returned to Acedan1369
Acedan1369 collected $1.77 from pot
Acedan1369: doesn't show hand 
*** SUMMARY ***
Total pot $1.85 | Rake $0.08 
Board [Td 2h 4s]
Seat 1: sapr.549 (small blind) folded before Flop
Seat 2: AAA_set_nh (big blind) folded before Flop
Seat 4: steinpilz1955 folded before Flop (didn't bet)
Seat 5: VisirMartin folded on the Flop
Seat 6: Acedan1369 (button) collected ($1.77)



PokerStars Hand #222968230590:  Hold'em No Limit ($0.05/$0.10 USD) - 2021/01/23 15:08:09 ET
Table 'Malzovia' 6-max Seat #1 is the button
Seat 1: sapr.549 ($7.43 in chips) 
Seat 2: AAA_set_nh ($20.83 in chips) 
Seat 4: steinpilz1955 ($11.05 in chips) 
Seat 5: VisirMartin ($6.83 in chips) 
Seat 6: Acedan1369 ($26.08 in chips) 
AAA_set_nh: posts small blind $0.05
steinpilz1955: posts big blind $0.10
*** HOLE CARDS ***
VisirMartin: folds 
Acedan1369: raises $0.15 to $0.25
sapr.549: folds 
AAA_set_nh: folds 
steinpilz1955: calls $0.15
*** FLOP *** [5c Qc 9h]
steinpilz1955: checks 
Acedan1369: bets $0.24
steinpilz1955: calls $0.24
*** TURN *** [5c Qc 9h] [2c]
steinpilz1955: checks 
Acedan1369: checks 
*** RIVER *** [5c Qc 9h 2c] [9c]
steinpilz1955: bets $2.40
Acedan1369: folds 
Uncalled bet ($2.40) returned to steinpilz1955
steinpilz1955 collected $0.98 from pot
*** SUMMARY ***
Total pot $1.03 | Rake $0.05 
Board [5c Qc 9h 2c 9c]
Seat 1: sapr.549 (button) folded before Flop (didn't bet)
Seat 2: AAA_set_nh (small blind) folded before Flop
Seat 4: steinpilz1955 (big blind) collected ($0.98)
Seat 5: VisirMartin folded before Flop (didn't bet)
Seat 6: Acedan1369 folded on the River



PokerStars Hand #222968267223:  Hold'em No Limit ($0.05/$0.10 USD) - 2021/01/23 15:08:53 ET
Table 'Malzovia' 6-max Seat #2 is the button
Seat 1: sapr.549 ($7.43 in chips) 
Seat 2: AAA_set_nh ($20.78 in chips) 
Seat 4: steinpilz1955 ($11.54 in chips) 
Seat 5: VisirMartin ($7.83 in chips) 
Seat 6: Acedan1369 ($25.59 in chips) 
steinpilz1955: posts small blind $0.05
VisirMartin: posts big blind $0.10
*** HOLE CARDS ***
Acedan1369: folds 
sapr.549: raises $0.15 to $0.25
AAA_set_nh: folds 
steinpilz1955: calls $0.20
VisirMartin: folds 
*** FLOP *** [6d 7c Tc]
steinpilz1955: checks 
sapr.549: bets $0.24
steinpilz1955: calls $0.24
*** TURN *** [6d 7c Tc] [7h]
steinpilz1955: bets $0.60
sapr.549: folds 
Uncalled bet ($0.60) returned to steinpilz1955
steinpilz1955 collected $1.03 from pot
*** SUMMARY ***
Total pot $1.08 | Rake $0.05 
Board [6d 7c Tc 7h]
Seat 1: sapr.549 folded on the Turn
Seat 2: AAA_set_nh (button) folded before Flop (didn't bet)
Seat 4: steinpilz1955 (small blind) collected ($1.03)
Seat 5: VisirMartin (big blind) folded before Flop
Seat 6: Acedan1369 folded before Flop (didn't bet)



PokerStars Hand #222968301987:  Hold'em No Limit ($0.05/$0.10 USD) - 2021/01/23 15:09:35 ET
Table 'Malzovia' 6-max Seat #4 is the button
Seat 1: sapr.549 ($6.94 in chips) 
Seat 2: AAA_set_nh ($20.78 in chips) 
Seat 4: steinpilz1955 ($12.08 in chips) 
Seat 5: VisirMartin ($7.73 in chips) 
Seat 6: Acedan1369 ($25.59 in chips) 
VisirMartin: posts small blind $0.05
Acedan1369: posts big blind $0.10
*** HOLE CARDS ***
sapr.549: folds 
AAA_set_nh: raises $0.15 to $0.25
steinpilz1955: calls $0.25
VisirMartin: folds 
Acedan1369: calls $0.15
*** FLOP *** [2c 7d 6c]
Acedan1369: checks 
AAA_set_nh: checks 
steinpilz1955: checks 
*** TURN *** [2c 7d 6c] [9s]
Acedan1369: bets $0.57
AAA_set_nh: folds 
steinpilz1955: calls $0.57
*** RIVER *** [2c 7d 6c 9s] [2h]
Acedan1369: checks 
steinpilz1955: checks 
*** SHOW DOWN ***
Acedan1369: shows [8c 8d] (two pair, Eights and Deuces)
steinpilz1955: mucks hand 
Acedan1369 collected $1.85 from pot
*** SUMMARY ***
Total pot $1.94 | Rake $0.09 
Board [2c 7d 6c 9s 2h]
Seat 1: sapr.549 folded before Flop (didn't bet)
Seat 2: AAA_set_nh folded on the Turn
Seat 4: steinpilz1955 (button) mucked
Seat 5: VisirMartin (small blind) folded before Flop
Seat 6: Acedan1369 (big blind) showed [8c 8d] and won ($1.85) with two pair, Eights and Deuces



PokerStars Hand #222968334345:  Hold'em No Limit ($0.05/$0.10 USD) - 2021/01/23 15:10:13 ET
Table 'Malzovia' 6-max Seat #5 is the button
Seat 1: sapr.549 ($6.94 in chips) 
Seat 2: AAA_set_nh ($20.53 in chips) 
Seat 4: steinpilz1955 ($11.26 in chips) 
Seat 5: VisirMartin ($7.68 in chips) 
Seat 6: Acedan1369 ($26.62 in chips) 
Acedan1369: posts small blind $0.05
sapr.549: posts big blind $0.10
*** HOLE CARDS ***
AAA_set_nh: folds 
steinpilz1955: calls $0.10
VisirMartin: folds 
Acedan1369: folds 
sapr.549: checks 
*** FLOP *** [Qd Ad Ah]
sapr.549: bets $0.10
steinpilz1955: folds 
Uncalled bet ($0.10) returned to sapr.549
sapr.549 collected $0.24 from pot
sapr.549: doesn't show hand 
*** SUMMARY ***
Total pot $0.25 | Rake $0.01 
Board [Qd Ad Ah]
Seat 1: sapr.549 (big blind) collected ($0.24)
Seat 2: AAA_set_nh folded before Flop (didn't bet)
Seat 4: steinpilz1955 folded on the Flop
Seat 5: VisirMartin (button) folded before Flop (didn't bet)
Seat 6: Acedan1369 (small blind) folded before Flop



PokerStars Hand #222968359393:  Hold'em No Limit ($0.05/$0.10 USD) - 2021/01/23 15:10:43 ET
Table 'Malzovia' 6-max Seat #6 is the button
Seat 1: sapr.549 ($7.08 in chips) 
Seat 3: hardouin ($23.65 in chips) 
Seat 4: steinpilz1955 ($11.16 in chips) 
Seat 5: VisirMartin ($10 in chips) 
Seat 6: Acedan1369 ($26.57 in chips) 
sapr.549: posts small blind $0.05
AAA_set_nh: is sitting out 
AAA_set_nh leaves the table
hardouin: posts big blind $0.10
*** HOLE CARDS ***
ganryu76 joins the table at seat #2 
steinpilz1955 has timed out
steinpilz1955: folds 
VisirMartin: folds 
Acedan1369: folds 
sapr.549: folds 
Uncalled bet ($0.05) returned to hardouin
hardouin collected $0.10 from pot
hardouin: doesn't show hand 
*** SUMMARY ***
Total pot $0.10 | Rake $0 
Seat 1: sapr.549 (small blind) folded before Flop
Seat 3: hardouin (big blind) collected ($0.10)
Seat 4: steinpilz1955 folded before Flop (didn't bet)
Seat 5: VisirMartin folded before Flop (didn't bet)
Seat 6: Acedan1369 (button) folded before Flop (didn't bet)



PokerStars Hand #222968375719:  Hold'em No Limit ($0.05/$0.10 USD) - 2021/01/23 15:11:02 ET
Table 'Malzovia' 6-max Seat #1 is the button
Seat 1: sapr.549 ($7.03 in chips) 
Seat 3: hardouin ($23.70 in chips) 
Seat 5: VisirMartin ($10 in chips) 
Seat 6: Acedan1369 ($26.57 in chips) 
hardouin: posts small blind $0.05
VisirMartin: posts big blind $0.10
*** HOLE CARDS ***
Acedan1369: folds 
sapr.549: folds 
hardouin: raises $0.20 to $0.30
VisirMartin: raises $0.70 to $1
hardouin: folds 
Uncalled bet ($0.70) returned to VisirMartin
VisirMartin collected $0.60 from pot
VisirMartin: doesn't show hand 
*** SUMMARY ***
Total pot $0.60 | Rake $0 
Seat 1: sapr.549 (button) folded before Flop (didn't bet)
Seat 3: hardouin (small blind) folded before Flop
Seat 5: VisirMartin (big blind) collected ($0.60)
Seat 6: Acedan1369 folded before Flop (didn't bet)



PokerStars Hand #222968410726:  Hold'em No Limit ($0.05/$0.10 USD) - 2021/01/23 15:11:44 ET
Table 'Malzovia' 6-max Seat #3 is the button
Seat 1: sapr.549 ($7.03 in chips) 
Seat 3: hardouin ($23.40 in chips) 
Seat 5: VisirMartin ($10.30 in chips) 
Seat 6: Acedan1369 ($26.57 in chips) 
VisirMartin: posts small blind $0.05
Acedan1369: posts big blind $0.10
ganryu76: sits out 
*** HOLE CARDS ***
sapr.549: folds 
hardouin: folds 
VisirMartin: raises $0.20 to $0.30
Acedan1369: folds 
Uncalled bet ($0.20) returned to VisirMartin
VisirMartin collected $0.20 from pot
VisirMartin: doesn't show hand 
*** SUMMARY ***
Total pot $0.20 | Rake $0 
Seat 1: sapr.549 folded before Flop (didn't bet)
Seat 3: hardouin (button) folded before Flop (didn't bet)
Seat 5: VisirMartin (small blind) collected ($0.20)
Seat 6: Acedan1369 (big blind) folded before Flop



PokerStars Hand #222968420808:  Hold'em No Limit ($0.05/$0.10 USD) - 2021/01/23 15:11:56 ET
Table 'Malzovia' 6-max Seat #5 is the button
Seat 1: sapr.549 ($7.03 in chips) 
Seat 3: hardouin ($23.40 in chips) 
Seat 5: VisirMartin ($10.40 in chips) 
Seat 6: Acedan1369 ($26.47 in chips) 
Acedan1369: posts small blind $0.05
sapr.549: posts big blind $0.10
ganryu76: sits out 
*** HOLE CARDS ***
hardouin: folds 
VisirMartin: raises $0.20 to $0.30
Acedan1369: folds 
sapr.549: folds 
Uncalled bet ($0.20) returned to VisirMartin
VisirMartin collected $0.25 from pot
VisirMartin: doesn't show hand 
*** SUMMARY ***
Total pot $0.25 | Rake $0 
Seat 1: sapr.549 (big blind) folded before Flop
Seat 3: hardouin folded before Flop (didn't bet)
Seat 5: VisirMartin (button) collected ($0.25)
Seat 6: Acedan1369 (small blind) folded before Flop



PokerStars Hand #222968438612:  Hold'em No Limit ($0.05/$0.10 USD) - 2021/01/23 15:12:09 ET
Table 'Malzovia' 6-max Seat #6 is the button
Seat 1: sapr.549 ($6.93 in chips) 
Seat 2: ganryu76 ($10 in chips) 
Seat 3: hardouin ($23.40 in chips) 
Seat 5: VisirMartin ($10.55 in chips) 
Seat 6: Acedan1369 ($26.42 in chips) 
sapr.549: posts small blind $0.05
ganryu76: posts big blind $0.10
*** HOLE CARDS ***
hardouin: folds 
VisirMartin: folds 
Acedan1369: folds 
sapr.549: folds 
Uncalled bet ($0.05) returned to ganryu76
ganryu76 collected $0.10 from pot
ganryu76: doesn't show hand 
*** SUMMARY ***
Total pot $0.10 | Rake $0 
Seat 1: sapr.549 (small blind) folded before Flop
Seat 2: ganryu76 (big blind) collected ($0.10)
Seat 3: hardouin folded before Flop (didn't bet)
Seat 5: VisirMartin folded before Flop (didn't bet)
Seat 6: Acedan1369 (button) folded before Flop (didn't bet)



PokerStars Hand #222968446686:  Hold'em No Limit ($0.05/$0.10 USD) - 2021/01/23 15:12:18 ET
Table 'Malzovia' 6-max Seat #1 is the button
Seat 1: sapr.549 ($6.88 in chips) 
Seat 2: ganryu76 ($10.05 in chips) 
Seat 6: Acedan1369 ($26.42 in chips) 
ganryu76: posts small blind $0.05
hardouin: is sitting out 
VisirMartin: is sitting out 
Acedan1369: posts big blind $0.10
*** HOLE CARDS ***
sapr.549: folds 
ganryu76: folds 
Uncalled bet ($0.05) returned to Acedan1369
Acedan1369 collected $0.10 from pot
Acedan1369: doesn't show hand 
*** SUMMARY ***
Total pot $0.10 | Rake $0 
Seat 1: sapr.549 (button) folded before Flop (didn't bet)
Seat 2: ganryu76 (small blind) folded before Flop
Seat 6: Acedan1369 (big blind) collected ($0.10)



PokerStars Hand #222968454021:  Hold'em No Limit ($0.05/$0.10 USD) - 2021/01/23 15:12:27 ET
Table 'Malzovia' 6-max Seat #2 is the button
Seat 1: sapr.549 ($6.88 in chips) 
Seat 2: ganryu76 ($10 in chips) 
Seat 6: Acedan1369 ($26.47 in chips) 
Acedan1369: posts small blind $0.05
sapr.549: posts big blind $0.10
*** HOLE CARDS ***
ganryu76: folds 
Acedan1369: raises $0.15 to $0.25
sapr.549: folds 
Uncalled bet ($0.15) returned to Acedan1369
Acedan1369 collected $0.20 from pot
Acedan1369: doesn't show hand 
*** SUMMARY ***
Total pot $0.20 | Rake $0 
Seat 1: sapr.549 (big blind) folded before Flop
Seat 2: ganryu76 (button) folded before Flop (didn't bet)
Seat 6: Acedan1369 (small blind) collected ($0.20)



PokerStars Hand #222968464665:  Hold'em No Limit ($0.05/$0.10 USD) - 2021/01/23 15:12:40 ET
Table 'Malzovia' 6-max Seat #6 is the button
Seat 1: sapr.549 ($6.78 in chips) 
Seat 2: ganryu76 ($10 in chips) 
Seat 6: Acedan1369 ($26.57 in chips) 
sapr.549: posts small blind $0.05
ganryu76: posts big blind $0.10
*** HOLE CARDS ***
Acedan1369: folds 
sapr.549: raises $0.15 to $0.25
ganryu76: calls $0.15
*** FLOP *** [3h Js 6d]
sapr.549: checks 
ganryu76: checks 
*** TURN *** [3h Js 6d] [5c]
sapr.549: checks 
ganryu76: bets $0.36
sapr.549: folds 
Uncalled bet ($0.36) returned to ganryu76
ganryu76 collected $0.48 from pot
ganryu76: doesn't show hand 
*** SUMMARY ***
Total pot $0.50 | Rake $0.02 
Board [3h Js 6d 5c]
Seat 1: sapr.549 (small blind) folded on the Turn
Seat 2: ganryu76 (big blind) collected ($0.48)
Seat 6: Acedan1369 (button) folded before Flop (didn't bet)



PokerStars Hand #222968509230:  Hold'em No Limit ($0.05/$0.10 USD) - 2021/01/23 15:13:33 ET
Table 'Malzovia' 6-max Seat #1 is the button
Seat 1: sapr.549 ($6.53 in chips) 
Seat 2: ganryu76 ($10.23 in chips) 
Seat 4: steinpilz1955 ($11.16 in chips) 
Seat 6: Acedan1369 ($26.57 in chips) 
ganryu76: posts small blind $0.05
steinpilz1955: posts big blind $0.10
VisirMartin: sits out 
*** HOLE CARDS ***
Acedan1369: folds 
sapr.549: folds 
ganryu76: folds 
Uncalled bet ($0.05) returned to steinpilz1955
steinpilz1955 collected $0.10 from pot
*** SUMMARY ***
Total pot $0.10 | Rake $0 
Seat 1: sapr.549 (button) folded before Flop (didn't bet)
Seat 2: ganryu76 (small blind) folded before Flop
Seat 4: steinpilz1955 (big blind) collected ($0.10)
Seat 6: Acedan1369 folded before Flop (didn't bet)



PokerStars Hand #222968514668:  Hold'em No Limit ($0.05/$0.10 USD) - 2021/01/23 15:13:39 ET
Table 'Malzovia' 6-max Seat #2 is the button
Seat 1: sapr.549 ($6.53 in chips) 
Seat 2: ganryu76 ($10.18 in chips) 
Seat 4: steinpilz1955 ($11.21 in chips) 
Seat 5: VisirMartin ($10.55 in chips) 
Seat 6: Acedan1369 ($26.57 in chips) 
steinpilz1955: posts small blind $0.05
VisirMartin: posts big blind $0.10
*** HOLE CARDS ***
Acedan1369: folds 
sapr.549: raises $0.20 to $0.30
ganryu76: folds 
steinpilz1955: folds 
VisirMartin: folds 
Uncalled bet ($0.20) returned to sapr.549
sapr.549 collected $0.25 from pot
sapr.549: doesn't show hand 
*** SUMMARY ***
Total pot $0.25 | Rake $0 
Seat 1: sapr.549 collected ($0.25)
Seat 2: ganryu76 (button) folded before Flop (didn't bet)
Seat 4: steinpilz1955 (small blind) folded before Flop
Seat 5: VisirMartin (big blind) folded before Flop
Seat 6: Acedan1369 folded before Flop (didn't bet)



PokerStars Hand #222968538163:  Hold'em No Limit ($0.05/$0.10 USD) - 2021/01/23 15:14:08 ET
Table 'Malzovia' 6-max Seat #4 is the button
Seat 1: sapr.549 ($6.68 in chips) 
Seat 2: ganryu76 ($10.18 in chips) 
Seat 4: steinpilz1955 ($11.16 in chips) 
Seat 5: VisirMartin ($10.45 in chips) 
Seat 6: Acedan1369 ($26.57 in chips) 
VisirMartin: posts small blind $0.05
Acedan1369: posts big blind $0.10
*** HOLE CARDS ***
sapr.549: folds 
ganryu76: folds 
steinpilz1955: calls $0.10
VisirMartin: raises $0.40 to $0.50
Acedan1369: folds 
steinpilz1955: folds 
Uncalled bet ($0.40) returned to VisirMartin
VisirMartin collected $0.30 from pot
VisirMartin: doesn't show hand 
*** SUMMARY ***
Total pot $0.30 | Rake $0 
Seat 1: sapr.549 folded before Flop (didn't bet)
Seat 2: ganryu76 folded before Flop (didn't bet)
Seat 4: steinpilz1955 (button) folded before Flop
Seat 5: VisirMartin (small blind) collected ($0.30)
Seat 6: Acedan1369 (big blind) folded before Flop



PokerStars Hand #222970294031:  Hold'em No Limit ($0.05/$0.10 USD) - 2021/01/23 15:48:03 ET
Table 'Malzovia' 6-max Seat #4 is the button
Seat 1: alexcost ($4.41 in chips) 
Seat 2: ganryu76 ($11.14 in chips) 
Seat 3: mario0887 ($7.75 in chips) 
Seat 4: Dosa994 ($9.47 in chips) 
Seat 5: Gissbon ($11.72 in chips) 
Seat 6: Acedan1369 ($16.60 in chips) 
Gissbon: posts small blind $0.05
Acedan1369: posts big blind $0.10
*** HOLE CARDS ***
alexcost: calls $0.10
ganryu76: folds 
mario0887: folds 
Dosa994: calls $0.10
Gissbon: folds 
Acedan1369: checks 
*** FLOP *** [Jd 8d 7s]
Acedan1369: checks 
alexcost: bets $0.30
Dosa994: calls $0.30
Acedan1369: calls $0.30
*** TURN *** [Jd 8d 7s] [4h]
Acedan1369: checks 
alexcost: bets $0.30
Dosa994: raises $0.30 to $0.60
Acedan1369: calls $0.60
alexcost: calls $0.30
*** RIVER *** [Jd 8d 7s 4h] [9d]
Acedan1369: checks 
alexcost: checks 
Dosa994: bets $1.40
Acedan1369 has timed out
Acedan1369: folds 
alexcost: raises $2.01 to $3.41 and is all-in
Dosa994: calls $2.01
*** SHOW DOWN ***
alexcost: shows [6d Kd] (a flush, King high)
Dosa994: shows [Td 9h] (a straight, Seven to Jack)
alexcost collected $9.43 from pot
*** SUMMARY ***
Total pot $9.87 | Rake $0.44 
Board [Jd 8d 7s 4h 9d]
Seat 1: alexcost showed [6d Kd] and won ($9.43) with a flush, King high
Seat 2: ganryu76 folded before Flop (didn't bet)
Seat 3: mario0887 folded before Flop (didn't bet)
Seat 4: Dosa994 (button) showed [Td 9h] and lost with a straight, Seven to Jack
Seat 5: Gissbon (small blind) folded before Flop
Seat 6: Acedan1369 (big blind) folded on the River



PokerStars Hand #222970396843:  Hold'em No Limit ($0.05/$0.10 USD) - 2021/01/23 15:50:07 ET
Table 'Malzovia' 6-max Seat #5 is the button
Seat 1: alexcost ($9.43 in chips) 
Seat 2: ganryu76 ($11.14 in chips) 
Seat 3: mario0887 ($7.75 in chips) 
Seat 4: Dosa994 ($5.06 in chips) 
Seat 5: Gissbon ($11.67 in chips) 
Seat 6: Acedan1369 ($15.60 in chips) 
Acedan1369: posts small blind $0.05
alexcost: posts big blind $0.10
*** HOLE CARDS ***
ganryu76: folds 
mario0887: folds 
Dosa994: calls $0.10
Gissbon: folds 
Acedan1369: folds 
alexcost: checks 
*** FLOP *** [Th 4s Qd]
alexcost: checks 
Dosa994: checks 
*** TURN *** [Th 4s Qd] [Tc]
alexcost: checks 
Dosa994: bets $0.10
alexcost: folds 
Uncalled bet ($0.10) returned to Dosa994
Dosa994 collected $0.24 from pot
Dosa994: doesn't show hand 
*** SUMMARY ***
Total pot $0.25 | Rake $0.01 
Board [Th 4s Qd Tc]
Seat 1: alexcost (big blind) folded on the Turn
Seat 2: ganryu76 folded before Flop (didn't bet)
Seat 3: mario0887 folded before Flop (didn't bet)
Seat 4: Dosa994 collected ($0.24)
Seat 5: Gissbon (button) folded before Flop (didn't bet)
Seat 6: Acedan1369 (small blind) folded before Flop



PokerStars Hand #222970421849:  Hold'em No Limit ($0.05/$0.10 USD) - 2021/01/23 15:50:37 ET
Table 'Malzovia' 6-max Seat #6 is the button
Seat 1: alexcost ($9.33 in chips) 
Seat 2: ganryu76 ($11.14 in chips) 
Seat 3: mario0887 ($7.75 in chips) 
Seat 4: Dosa994 ($5.20 in chips) 
Seat 5: Gissbon ($11.67 in chips) 
Seat 6: Acedan1369 ($15.55 in chips) 
alexcost: posts small blind $0.05
ganryu76: posts big blind $0.10
*** HOLE CARDS ***
mario0887: raises $0.10 to $0.20
Dosa994: calls $0.20
Gissbon: folds 
Acedan1369: calls $0.20
alexcost: folds 
ganryu76: folds 
*** FLOP *** [Ts 6d Ac]
mario0887: bets $0.24
Dosa994: raises $0.24 to $0.48
Acedan1369: calls $0.48
mario0887: calls $0.24
*** TURN *** [Ts 6d Ac] [3d]
mario0887: checks 
Dosa994: bets $1
Acedan1369 has timed out
Acedan1369: folds 
mario0887: folds 
Uncalled bet ($1) returned to Dosa994
Dosa994 collected $2.09 from pot
Dosa994: doesn't show hand 
*** SUMMARY ***
Total pot $2.19 | Rake $0.10 
Board [Ts 6d Ac 3d]
Seat 1: alexcost (small blind) folded before Flop
Seat 2: ganryu76 (big blind) folded before Flop
Seat 3: mario0887 folded on the Turn
Seat 4: Dosa994 collected ($2.09)
Seat 5: Gissbon folded before Flop (didn't bet)
Seat 6: Acedan1369 (button) folded on the Turn



PokerStars Hand #222970479269:  Hold'em No Limit ($0.05/$0.10 USD) - 2021/01/23 15:51:46 ET
Table 'Malzovia' 6-max Seat #1 is the button
Seat 1: alexcost ($9.28 in chips) 
Seat 2: ganryu76 ($11.04 in chips) 
Seat 3: mario0887 ($7.07 in chips) 
Seat 4: Dosa994 ($6.61 in chips) 
Seat 5: Gissbon ($11.67 in chips) 
ganryu76: posts small blind $0.05
mario0887: posts big blind $0.10
*** HOLE CARDS ***
Dosa994: calls $0.10
Gissbon: folds 
alexcost: calls $0.10
ganryu76: folds 
mario0887: checks 
*** FLOP *** [4s 7d Ts]
mario0887: checks 
Dosa994: checks 
alexcost: bets $0.30
mario0887: calls $0.30
Dosa994: folds 
*** TURN *** [4s 7d Ts] [4d]
mario0887: checks 
alexcost: bets $0.30
mario0887: raises $0.50 to $0.80
alexcost: calls $0.50
*** RIVER *** [4s 7d Ts 4d] [2h]
mario0887: checks 
alexcost: checks 
*** SHOW DOWN ***
mario0887: shows [6d Td] (two pair, Tens and Fours)
alexcost: mucks hand 
mario0887 collected $2.44 from pot
*** SUMMARY ***
Total pot $2.55 | Rake $0.11 
Board [4s 7d Ts 4d 2h]
Seat 1: alexcost (button) mucked
Seat 2: ganryu76 (small blind) folded before Flop
Seat 3: mario0887 (big blind) showed [6d Td] and won ($2.44) with two pair, Tens and Fours
Seat 4: Dosa994 folded on the Flop
Seat 5: Gissbon folded before Flop (didn't bet)



PokerStars Hand #222970516607:  Hold'em No Limit ($0.05/$0.10 USD) - 2021/01/23 15:52:31 ET
Table 'Malzovia' 6-max Seat #2 is the button
Seat 1: alexcost ($8.08 in chips) 
Seat 2: ganryu76 ($10.99 in chips) 
Seat 3: mario0887 ($8.31 in chips) 
Seat 4: Dosa994 ($6.51 in chips) 
Seat 5: Gissbon ($11.67 in chips) 
Seat 6: Acedan1369 ($14.87 in chips) 
mario0887: posts small blind $0.05
Dosa994: posts big blind $0.10
*** HOLE CARDS ***
Gissbon: folds 
Acedan1369: folds 
alexcost: folds 
ganryu76: folds 
mario0887: raises $0.15 to $0.25
Dosa994: folds 
Uncalled bet ($0.15) returned to mario0887
mario0887 collected $0.20 from pot
mario0887: doesn't show hand 
*** SUMMARY ***
Total pot $0.20 | Rake $0 
Seat 1: alexcost folded before Flop (didn't bet)
Seat 2: ganryu76 (button) folded before Flop (didn't bet)
Seat 3: mario0887 (small blind) collected ($0.20)
Seat 4: Dosa994 (big blind) folded before Flop
Seat 5: Gissbon folded before Flop (didn't bet)
Seat 6: Acedan1369 folded before Flop (didn't bet)



PokerStars Hand #222970537118:  Hold'em No Limit ($0.05/$0.10 USD) - 2021/01/23 15:52:55 ET
Table 'Malzovia' 6-max Seat #3 is the button
Seat 1: alexcost ($8.08 in chips) 
Seat 2: ganryu76 ($10.99 in chips) 
Seat 3: mario0887 ($8.41 in chips) 
Seat 4: Dosa994 ($6.41 in chips) 
Seat 5: Gissbon ($11.67 in chips) 
Seat 6: Acedan1369 ($14.87 in chips) 
Dosa994: posts small blind $0.05
Gissbon: posts big blind $0.10
*** HOLE CARDS ***
Acedan1369: folds 
alexcost: calls $0.10
ganryu76: folds 
mario0887: raises $0.15 to $0.25
Dosa994: folds 
Gissbon: folds 
alexcost: calls $0.15
*** FLOP *** [Td 4h 8d]
alexcost: checks 
mario0887: bets $0.20
alexcost: calls $0.20
*** TURN *** [Td 4h 8d] [As]
alexcost: checks 
mario0887: bets $0.75
alexcost: folds 
Uncalled bet ($0.75) returned to mario0887
mario0887 collected $1 from pot
mario0887: doesn't show hand 
*** SUMMARY ***
Total pot $1.05 | Rake $0.05 
Board [Td 4h 8d As]
Seat 1: alexcost folded on the Turn
Seat 2: ganryu76 folded before Flop (didn't bet)
Seat 3: mario0887 (button) collected ($1)
Seat 4: Dosa994 (small blind) folded before Flop
Seat 5: Gissbon (big blind) folded before Flop
Seat 6: Acedan1369 folded before Flop (didn't bet)



PokerStars Hand #222970577456:  Hold'em No Limit ($0.05/$0.10 USD) - 2021/01/23 15:53:43 ET
Table 'Malzovia' 6-max Seat #4 is the button
Seat 1: alexcost ($7.63 in chips) 
Seat 2: ganryu76 ($10.99 in chips) 
Seat 3: mario0887 ($8.96 in chips) 
Seat 4: Dosa994 ($6.36 in chips) 
Seat 5: Gissbon ($11.57 in chips) 
Seat 6: Acedan1369 ($14.87 in chips) 
Gissbon: posts small blind $0.05
Acedan1369: posts big blind $0.10
*** HOLE CARDS ***
alexcost: calls $0.10
ganryu76: folds 
mario0887: folds 
Dosa994: calls $0.10
Gissbon: folds 
Acedan1369: raises $0.30 to $0.40
alexcost: calls $0.30
Dosa994: calls $0.30
*** FLOP *** [2h Ad 6d]
Acedan1369: bets $0.54
alexcost: calls $0.54
Dosa994: folds 
*** TURN *** [2h Ad 6d] [5h]
Acedan1369: bets $1.67
alexcost: folds 
Uncalled bet ($1.67) returned to Acedan1369
Acedan1369 collected $2.23 from pot
Acedan1369: doesn't show hand 
*** SUMMARY ***
Total pot $2.33 | Rake $0.10 
Board [2h Ad 6d 5h]
Seat 1: alexcost folded on the Turn
Seat 2: ganryu76 folded before Flop (didn't bet)
Seat 3: mario0887 folded before Flop (didn't bet)
Seat 4: Dosa994 (button) folded on the Flop
Seat 5: Gissbon (small blind) folded before Flop
Seat 6: Acedan1369 (big blind) collected ($2.23)



PokerStars Hand #222970617440:  Hold'em No Limit ($0.05/$0.10 USD) - 2021/01/23 15:54:32 ET
Table 'Malzovia' 6-max Seat #5 is the button
Seat 1: alexcost ($6.69 in chips) 
Seat 2: ganryu76 ($10.99 in chips) 
Seat 3: mario0887 ($8.96 in chips) 
Seat 4: Dosa994 ($5.96 in chips) 
Seat 5: Gissbon ($11.52 in chips) 
Seat 6: Acedan1369 ($16.16 in chips) 
Acedan1369: posts small blind $0.05
alexcost: posts big blind $0.10
*** HOLE CARDS ***
ganryu76: folds 
mario0887: folds 
Dosa994: calls $0.10
Gissbon: raises $0.30 to $0.40
Acedan1369: folds 
alexcost: folds 
Dosa994: folds 
Uncalled bet ($0.30) returned to Gissbon
Gissbon collected $0.35 from pot
Gissbon: doesn't show hand 
*** SUMMARY ***
Total pot $0.35 | Rake $0 
Seat 1: alexcost (big blind) folded before Flop
Seat 2: ganryu76 folded before Flop (didn't bet)
Seat 3: mario0887 folded before Flop (didn't bet)
Seat 4: Dosa994 folded before Flop
Seat 5: Gissbon (button) collected ($0.35)
Seat 6: Acedan1369 (small blind) folded before Flop



PokerStars Hand #222970632773:  Hold'em No Limit ($0.05/$0.10 USD) - 2021/01/23 15:54:51 ET
Table 'Malzovia' 6-max Seat #6 is the button
Seat 2: ganryu76 ($10.99 in chips) 
Seat 3: mario0887 ($8.96 in chips) 
Seat 4: Dosa994 ($5.86 in chips) 
Seat 5: Gissbon ($11.77 in chips) 
Seat 6: Acedan1369 ($16.11 in chips) 
ganryu76: posts small blind $0.05
mario0887: posts big blind $0.10
*** HOLE CARDS ***
Dosa994: raises $0.10 to $0.20
Gissbon: folds 
Acedan1369: folds 
ganryu76: calls $0.15
mario0887: folds 
*** FLOP *** [3d 8s 9s]
ganryu76: checks 
Dosa994: bets $0.30
ganryu76: calls $0.30
*** TURN *** [3d 8s 9s] [Qs]
ganryu76: checks 
Dosa994: bets $1
ganryu76: folds 
Uncalled bet ($1) returned to Dosa994
Dosa994 collected $1.05 from pot
Dosa994: doesn't show hand 
*** SUMMARY ***
Total pot $1.10 | Rake $0.05 
Board [3d 8s 9s Qs]
Seat 2: ganryu76 (small blind) folded on the Turn
Seat 3: mario0887 (big blind) folded before Flop
Seat 4: Dosa994 collected ($1.05)
Seat 5: Gissbon folded before Flop (didn't bet)
Seat 6: Acedan1369 (button) folded before Flop (didn't bet)



PokerStars Hand #222970668907:  Hold'em No Limit ($0.05/$0.10 USD) - 2021/01/23 15:55:47 ET
Table 'Malzovia' 6-max Seat #2 is the button
Seat 2: ganryu76 ($10.49 in chips) 
Seat 3: mario0887 ($8.86 in chips) 
Seat 4: Dosa994 ($6.41 in chips) 
Seat 5: Gissbon ($11.77 in chips) 
Seat 6: Acedan1369 ($16.11 in chips) 
mario0887: posts small blind $0.05
Dosa994: posts big blind $0.10
*** HOLE CARDS ***
Gissbon: folds 
Acedan1369: raises $0.15 to $0.25
ganryu76: folds 
mario0887: folds 
Dosa994: folds 
Uncalled bet ($0.15) returned to Acedan1369
Acedan1369 collected $0.25 from pot
Acedan1369: doesn't show hand 
*** SUMMARY ***
Total pot $0.25 | Rake $0 
Seat 2: ganryu76 (button) folded before Flop (didn't bet)
Seat 3: mario0887 (small blind) folded before Flop
Seat 4: Dosa994 (big blind) folded before Flop
Seat 5: Gissbon folded before Flop (didn't bet)
Seat 6: Acedan1369 collected ($0.25)



PokerStars Hand #222970680438:  Hold'em No Limit ($0.05/$0.10 USD) - 2021/01/23 15:55:58 ET
Table 'Malzovia' 6-max Seat #3 is the button
Seat 2: ganryu76 ($10.49 in chips) 
Seat 3: mario0887 ($8.81 in chips) 
Seat 4: Dosa994 ($6.31 in chips) 
Seat 5: Gissbon ($11.77 in chips) 
Seat 6: Acedan1369 ($16.26 in chips) 
Dosa994: posts small blind $0.05
Gissbon: posts big blind $0.10
*** HOLE CARDS ***
Acedan1369: folds 
ganryu76: raises $0.15 to $0.25
mario0887: folds 
Dosa994: calls $0.20
Gissbon: folds 
*** FLOP *** [Kc Js 8d]
Dosa994: checks 
ganryu76: bets $0.43
Dosa994: folds 
Uncalled bet ($0.43) returned to ganryu76
ganryu76 collected $0.57 from pot
ganryu76: doesn't show hand 
*** SUMMARY ***
Total pot $0.60 | Rake $0.03 
Board [Kc Js 8d]
Seat 2: ganryu76 collected ($0.57)
Seat 3: mario0887 (button) folded before Flop (didn't bet)
Seat 4: Dosa994 (small blind) folded on the Flop
Seat 5: Gissbon (big blind) folded before Flop
Seat 6: Acedan1369 folded before Flop (didn't bet)



PokerStars Hand #222970696094:  Hold'em No Limit ($0.05/$0.10 USD) - 2021/01/23 15:56:26 ET
Table 'Malzovia' 6-max Seat #4 is the button
Seat 2: ganryu76 ($10.81 in chips) 
Seat 3: mario0887 ($8.81 in chips) 
Seat 4: Dosa994 ($6.06 in chips) 
Seat 5: Gissbon ($11.67 in chips) 
Seat 6: Acedan1369 ($16.26 in chips) 
Gissbon: posts small blind $0.05
Acedan1369: posts big blind $0.10
*** HOLE CARDS ***
ganryu76: raises $0.20 to $0.30
mario0887: folds 
Dosa994: folds 
Gissbon: folds 
Acedan1369: folds 
Uncalled bet ($0.20) returned to ganryu76
ganryu76 collected $0.25 from pot
ganryu76: doesn't show hand 
*** SUMMARY ***
Total pot $0.25 | Rake $0 
Seat 2: ganryu76 collected ($0.25)
Seat 3: mario0887 folded before Flop (didn't bet)
Seat 4: Dosa994 (button) folded before Flop (didn't bet)
Seat 5: Gissbon (small blind) folded before Flop
Seat 6: Acedan1369 (big blind) folded before Flop



PokerStars Hand #222970703164:  Hold'em No Limit ($0.05/$0.10 USD) - 2021/01/23 15:56:38 ET
Table 'Malzovia' 6-max Seat #5 is the button
Seat 2: ganryu76 ($10.96 in chips) 
Seat 3: mario0887 ($8.81 in chips) 
Seat 4: Dosa994 ($6.06 in chips) 
Seat 5: Gissbon ($11.62 in chips) 
Seat 6: Acedan1369 ($16.16 in chips) 
Acedan1369: posts small blind $0.05
ganryu76: posts big blind $0.10
*** HOLE CARDS ***
mario0887: folds 
Dosa994: folds 
Gissbon: raises $0.15 to $0.25
Acedan1369: folds 
ganryu76: raises $0.85 to $1.10
Gissbon: folds 
Uncalled bet ($0.85) returned to ganryu76
ganryu76 collected $0.55 from pot
ganryu76: doesn't show hand 
*** SUMMARY ***
Total pot $0.55 | Rake $0 
Seat 2: ganryu76 (big blind) collected ($0.55)
Seat 3: mario0887 folded before Flop (didn't bet)
Seat 4: Dosa994 folded before Flop (didn't bet)
Seat 5: Gissbon (button) folded before Flop
Seat 6: Acedan1369 (small blind) folded before Flop



PokerStars Hand #222970719827:  Hold'em No Limit ($0.05/$0.10 USD) - 2021/01/23 15:57:08 ET
Table 'Malzovia' 6-max Seat #6 is the button
Seat 2: ganryu76 ($11.26 in chips) 
Seat 3: mario0887 ($8.81 in chips) 
Seat 4: Dosa994 ($6.06 in chips) 
Seat 5: Gissbon ($11.37 in chips) 
Seat 6: Acedan1369 ($16.11 in chips) 
ganryu76: posts small blind $0.05
mario0887: posts big blind $0.10
*** HOLE CARDS ***
Dosa994: raises $0.10 to $0.20
Gissbon: folds 
Acedan1369: folds 
ganryu76: folds 
mario0887: calls $0.10
*** FLOP *** [9c 4d Jh]
mario0887: checks 
Dosa994: bets $0.30
mario0887: calls $0.30
*** TURN *** [9c 4d Jh] [7d]
mario0887: checks 
Dosa994: checks 
*** RIVER *** [9c 4d Jh 7d] [5d]
mario0887: checks 
Dosa994: bets $0.20
mario0887: raises $0.40 to $0.60
Dosa994: folds 
Uncalled bet ($0.40) returned to mario0887
mario0887 collected $1.38 from pot
mario0887: doesn't show hand 
*** SUMMARY ***
Total pot $1.45 | Rake $0.07 
Board [9c 4d Jh 7d 5d]
Seat 2: ganryu76 (small blind) folded before Flop
Seat 3: mario0887 (big blind) collected ($1.38)
Seat 4: Dosa994 folded on the River
Seat 5: Gissbon folded before Flop (didn't bet)
Seat 6: Acedan1369 (button) folded before Flop (didn't bet)



PokerStars Hand #222970744155:  Hold'em No Limit ($0.05/$0.10 USD) - 2021/01/23 15:57:50 ET
Table 'Malzovia' 6-max Seat #2 is the button
Seat 2: ganryu76 ($11.21 in chips) 
Seat 3: mario0887 ($9.49 in chips) 
Seat 4: Dosa994 ($5.36 in chips) 
Seat 5: Gissbon ($11.37 in chips) 
Seat 6: Acedan1369 ($16.11 in chips) 
mario0887: posts small blind $0.05
Dosa994: posts big blind $0.10
*** HOLE CARDS ***
Gissbon: raises $0.15 to $0.25
Acedan1369: folds 
ganryu76: folds 
mario0887: folds 
Dosa994: raises $0.15 to $0.40
Gissbon: calls $0.15
*** FLOP *** [7h 7d Th]
Dosa994: bets $0.30
Gissbon: calls $0.30
*** TURN *** [7h 7d Th] [Kc]
Dosa994: bets $1
Gissbon: folds 
Uncalled bet ($1) returned to Dosa994
Dosa994 collected $1.38 from pot
Dosa994: doesn't show hand 
*** SUMMARY ***
Total pot $1.45 | Rake $0.07 
Board [7h 7d Th Kc]
Seat 2: ganryu76 (button) folded before Flop (didn't bet)
Seat 3: mario0887 (small blind) folded before Flop
Seat 4: Dosa994 (big blind) collected ($1.38)
Seat 5: Gissbon folded on the Turn
Seat 6: Acedan1369 folded before Flop (didn't bet)



PokerStars Hand #222970767715:  Hold'em No Limit ($0.05/$0.10 USD) - 2021/01/23 15:58:32 ET
Table 'Malzovia' 6-max Seat #3 is the button
Seat 1: alexcost ($6.59 in chips) 
Seat 2: ganryu76 ($11.21 in chips) 
Seat 3: mario0887 ($9.44 in chips) 
Seat 4: Dosa994 ($6.04 in chips) 
Seat 5: Gissbon ($10.67 in chips) 
Seat 6: Acedan1369 ($16.11 in chips) 
Dosa994: posts small blind $0.05
Gissbon: posts big blind $0.10
alexcost: posts small & big blinds $0.15
*** HOLE CARDS ***
Acedan1369: folds 
alexcost: checks 
ganryu76: folds 
mario0887: folds 
Dosa994: raises $0.20 to $0.30
Gissbon: folds 
alexcost: calls $0.20
*** FLOP *** [Jh Jd 6d]
Dosa994: bets $0.30
alexcost: calls $0.30
*** TURN *** [Jh Jd 6d] [Qd]
Dosa994: bets $1
alexcost: calls $1
*** RIVER *** [Jh Jd 6d Qd] [Th]
Dosa994: bets $4.44 and is all-in
alexcost: calls $4.44
*** SHOW DOWN ***
Dosa994: shows [7c Qc] (two pair, Queens and Jacks)
alexcost: shows [Qs Jc] (a full house, Jacks full of Queens)
alexcost collected $11.68 from pot
*** SUMMARY ***
Total pot $12.23 | Rake $0.55 
Board [Jh Jd 6d Qd Th]
Seat 1: alexcost showed [Qs Jc] and won ($11.68) with a full house, Jacks full of Queens
Seat 2: ganryu76 folded before Flop (didn't bet)
Seat 3: mario0887 (button) folded before Flop (didn't bet)
Seat 4: Dosa994 (small blind) showed [7c Qc] and lost with two pair, Queens and Jacks
Seat 5: Gissbon (big blind) folded before Flop
Seat 6: Acedan1369 folded before Flop (didn't bet)



PokerStars Hand #222970801360:  Hold'em No Limit ($0.05/$0.10 USD) - 2021/01/23 15:59:31 ET
Table 'Malzovia' 6-max Seat #5 is the button
Seat 1: alexcost ($12.18 in chips) 
Seat 2: ganryu76 ($11.21 in chips) 
Seat 3: mario0887 ($9.44 in chips) 
Seat 5: Gissbon ($10.57 in chips) 
Seat 6: Acedan1369 ($16.11 in chips) 
Acedan1369: posts small blind $0.05
alexcost: posts big blind $0.10
*** HOLE CARDS ***
ganryu76: folds 
mario0887: folds 
Gissbon: raises $0.15 to $0.25
Dosa994 leaves the table
Acedan1369: raises $0.60 to $0.85
alexcost: folds 
Gissbon: calls $0.60
*** FLOP *** [2c Kd 7h]
Acedan1369: bets $0.77
Gissbon: folds 
Uncalled bet ($0.77) returned to Acedan1369
Acedan1369 collected $1.72 from pot
Acedan1369: doesn't show hand 
*** SUMMARY ***
Total pot $1.80 | Rake $0.08 
Board [2c Kd 7h]
Seat 1: alexcost (big blind) folded before Flop
Seat 2: ganryu76 folded before Flop (didn't bet)
Seat 3: mario0887 folded before Flop (didn't bet)
Seat 5: Gissbon (button) folded on the Flop
Seat 6: Acedan1369 (small blind) collected ($1.72)



PokerStars Hand #222970825479:  Hold'em No Limit ($0.05/$0.10 USD) - 2021/01/23 16:00:12 ET
Table 'Malzovia' 6-max Seat #6 is the button
Seat 1: alexcost ($12.08 in chips) 
Seat 2: ganryu76 ($11.21 in chips) 
Seat 3: mario0887 ($9.44 in chips) 
Seat 5: Gissbon ($10 in chips) 
Seat 6: Acedan1369 ($16.98 in chips) 
alexcost: posts small blind $0.05
ganryu76: posts big blind $0.10
*** HOLE CARDS ***
mario0887: folds 
Gissbon: folds 
Acedan1369: folds 
alexcost: calls $0.05
ganryu76: checks 
*** FLOP *** [9s 6d 7h]
alexcost: bets $0.30
Albertin97 joins the table at seat #4 
ganryu76: folds 
Uncalled bet ($0.30) returned to alexcost
alexcost collected $0.19 from pot
alexcost: doesn't show hand 
*** SUMMARY ***
Total pot $0.20 | Rake $0.01 
Board [9s 6d 7h]
Seat 1: alexcost (small blind) collected ($0.19)
Seat 2: ganryu76 (big blind) folded on the Flop
Seat 3: mario0887 folded before Flop (didn't bet)
Seat 5: Gissbon folded before Flop (didn't bet)
Seat 6: Acedan1369 (button) folded before Flop (didn't bet)



PokerStars Hand #222970842083:  Hold'em No Limit ($0.05/$0.10 USD) - 2021/01/23 16:00:39 ET
Table 'Malzovia' 6-max Seat #1 is the button
Seat 1: alexcost ($12.17 in chips) 
Seat 2: ganryu76 ($11.11 in chips) 
Seat 3: mario0887 ($9.44 in chips) 
Seat 5: Gissbon ($10 in chips) 
Seat 6: Acedan1369 ($16.98 in chips) 
ganryu76: posts small blind $0.05
mario0887: posts big blind $0.10
Albertin97: sits out 
*** HOLE CARDS ***
Gissbon: folds 
Acedan1369: raises $0.15 to $0.25
alexcost: calls $0.25
ganryu76: folds 
mario0887: folds 
*** FLOP *** [7d 6h 8d]
Acedan1369: bets $0.47
alexcost: calls $0.47
*** TURN *** [7d 6h 8d] [Ac]
Acedan1369: bets $1.14
alexcost: folds 
Uncalled bet ($1.14) returned to Acedan1369
Acedan1369 collected $1.52 from pot
Acedan1369: doesn't show hand 
*** SUMMARY ***
Total pot $1.59 | Rake $0.07 
Board [7d 6h 8d Ac]
Seat 1: alexcost (button) folded on the Turn
Seat 2: ganryu76 (small blind) folded before Flop
Seat 3: mario0887 (big blind) folded before Flop
Seat 5: Gissbon folded before Flop (didn't bet)
Seat 6: Acedan1369 collected ($1.52)



PokerStars Hand #222970865711:  Hold'em No Limit ($0.05/$0.10 USD) - 2021/01/23 16:01:15 ET
Table 'Malzovia' 6-max Seat #2 is the button
Seat 1: alexcost ($11.45 in chips) 
Seat 2: ganryu76 ($11.06 in chips) 
Seat 3: mario0887 ($9.34 in chips) 
Seat 4: Albertin97 ($6.10 in chips) 
Seat 5: Gissbon ($10 in chips) 
Seat 6: Acedan1369 ($17.78 in chips) 
mario0887: posts small blind $0.05
Albertin97: posts big blind $0.10
*** HOLE CARDS ***
Gissbon: folds 
Acedan1369: folds 
alexcost: folds 
ganryu76: raises $0.15 to $0.25
alexcost leaves the table
mario0887: folds 
Albertin97: folds 
Uncalled bet ($0.15) returned to ganryu76
ganryu76 collected $0.25 from pot
ganryu76: doesn't show hand 
*** SUMMARY ***
Total pot $0.25 | Rake $0 
Seat 1: alexcost folded before Flop (didn't bet)
Seat 2: ganryu76 (button) collected ($0.25)
Seat 3: mario0887 (small blind) folded before Flop
Seat 4: Albertin97 (big blind) folded before Flop
Seat 5: Gissbon folded before Flop (didn't bet)
Seat 6: Acedan1369 folded before Flop (didn't bet)



PokerStars Hand #222970873988:  Hold'em No Limit ($0.05/$0.10 USD) - 2021/01/23 16:01:27 ET
Table 'Malzovia' 6-max Seat #3 is the button
Seat 2: ganryu76 ($11.21 in chips) 
Seat 3: mario0887 ($9.29 in chips) 
Seat 4: Albertin97 ($6 in chips) 
Seat 5: Gissbon ($10 in chips) 
Seat 6: Acedan1369 ($17.78 in chips) 
Albertin97: posts small blind $0.05
Gissbon: posts big blind $0.10
*** HOLE CARDS ***
Acedan1369: raises $0.15 to $0.25
ganryu76: folds 
mario0887: folds 
Albertin97: folds 
Gissbon: folds 
Uncalled bet ($0.15) returned to Acedan1369
Acedan1369 collected $0.25 from pot
Acedan1369: doesn't show hand 
*** SUMMARY ***
Total pot $0.25 | Rake $0 
Seat 2: ganryu76 folded before Flop (didn't bet)
Seat 3: mario0887 (button) folded before Flop (didn't bet)
Seat 4: Albertin97 (small blind) folded before Flop
Seat 5: Gissbon (big blind) folded before Flop
Seat 6: Acedan1369 collected ($0.25)



PokerStars Hand #222970888176:  Hold'em No Limit ($0.05/$0.10 USD) - 2021/01/23 16:01:46 ET
Table 'Malzovia' 6-max Seat #4 is the button
Seat 2: ganryu76 ($11.21 in chips) 
Seat 3: mario0887 ($9.29 in chips) 
Seat 4: Albertin97 ($5.95 in chips) 
Seat 5: Gissbon ($10 in chips) 
Seat 6: Acedan1369 ($17.93 in chips) 
Gissbon: posts small blind $0.05
Acedan1369: posts big blind $0.10
*** HOLE CARDS ***
ganryu76: folds 
mario0887: folds 
Albertin97: calls $0.10
Gissbon: raises $0.40 to $0.50
Acedan1369: folds 
Albertin97: calls $0.40
*** FLOP *** [Tc Jh Qd]
Gissbon: bets $0.42
Albertin97: folds 
Uncalled bet ($0.42) returned to Gissbon
Gissbon collected $1.05 from pot
Gissbon: doesn't show hand 
*** SUMMARY ***
Total pot $1.10 | Rake $0.05 
Board [Tc Jh Qd]
Seat 2: ganryu76 folded before Flop (didn't bet)
Seat 3: mario0887 folded before Flop (didn't bet)
Seat 4: Albertin97 (button) folded on the Flop
Seat 5: Gissbon (small blind) collected ($1.05)
Seat 6: Acedan1369 (big blind) folded before Flop



PokerStars Hand #222970904878:  Hold'em No Limit ($0.05/$0.10 USD) - 2021/01/23 16:02:08 ET
Table 'Malzovia' 6-max Seat #5 is the button
Seat 2: ganryu76 ($11.21 in chips) 
Seat 3: mario0887 ($9.29 in chips) 
Seat 4: Albertin97 ($5.45 in chips) 
Seat 5: Gissbon ($10.55 in chips) 
Seat 6: Acedan1369 ($17.83 in chips) 
Acedan1369: posts small blind $0.05
ganryu76: posts big blind $0.10
*** HOLE CARDS ***
mario0887: folds 
Albertin97: raises $0.20 to $0.30
Gissbon: folds 
Acedan1369: folds 
ganryu76: calls $0.20
*** FLOP *** [9h Td 3s]
ganryu76: checks 
Albertin97: checks 
*** TURN *** [9h Td 3s] [5h]
ganryu76: bets $0.34
Albertin97: calls $0.34
*** RIVER *** [9h Td 3s 5h] [2s]
ganryu76: bets $0.70
Albertin97: folds 
Uncalled bet ($0.70) returned to ganryu76
ganryu76 collected $1.27 from pot
ganryu76: doesn't show hand 
*** SUMMARY ***
Total pot $1.33 | Rake $0.06 
Board [9h Td 3s 5h 2s]
Seat 2: ganryu76 (big blind) collected ($1.27)
Seat 3: mario0887 folded before Flop (didn't bet)
Seat 4: Albertin97 folded on the River
Seat 5: Gissbon (button) folded before Flop (didn't bet)
Seat 6: Acedan1369 (small blind) folded before Flop



PokerStars Hand #222970949141:  Hold'em No Limit ($0.05/$0.10 USD) - 2021/01/23 16:03:03 ET
Table 'Malzovia' 6-max Seat #6 is the button
Seat 2: ganryu76 ($11.84 in chips) 
Seat 3: mario0887 ($9.29 in chips) 
Seat 4: Albertin97 ($4.81 in chips) 
Seat 5: Gissbon ($10.55 in chips) 
Seat 6: Acedan1369 ($17.78 in chips) 
borisjoka joins the table at seat #1 
ganryu76: posts small blind $0.05
mario0887: posts big blind $0.10
*** HOLE CARDS ***
Albertin97: calls $0.10
Gissbon: folds 
Acedan1369: raises $0.30 to $0.40
ganryu76: folds 
mario0887: calls $0.30
Albertin97: calls $0.30
*** FLOP *** [8c 5d Th]
mario0887: checks 
Albertin97: bets $0.20
Acedan1369 has timed out
Acedan1369: folds 
mario0887: calls $0.20
*** TURN *** [8c 5d Th] [8d]
mario0887: checks 
Albertin97: checks 
*** RIVER *** [8c 5d Th 8d] [Ts]
mario0887: checks 
Albertin97: bets $0.30
mario0887: folds 
Uncalled bet ($0.30) returned to Albertin97
Albertin97 collected $1.58 from pot
Albertin97: doesn't show hand 
*** SUMMARY ***
Total pot $1.65 | Rake $0.07 
Board [8c 5d Th 8d Ts]
Seat 2: ganryu76 (small blind) folded before Flop
Seat 3: mario0887 (big blind) folded on the River
Seat 4: Albertin97 collected ($1.58)
Seat 5: Gissbon folded before Flop (didn't bet)
Seat 6: Acedan1369 (button) folded on the Flop



PokerStars Hand #222971013160:  Hold'em No Limit ($0.05/$0.10 USD) - 2021/01/23 16:04:21 ET
Table 'Malzovia' 6-max Seat #2 is the button
Seat 1: borisjoka ($4 in chips) 
Seat 2: ganryu76 ($11.79 in chips) 
Seat 3: mario0887 ($8.69 in chips) 
Seat 4: Albertin97 ($5.79 in chips) 
Seat 5: Gissbon ($10.55 in chips) 
Seat 6: Acedan1369 ($17.38 in chips) 
mario0887: posts small blind $0.05
Albertin97: posts big blind $0.10
borisjoka: posts big blind $0.10
*** HOLE CARDS ***
Gissbon: folds 
Acedan1369: folds 
borisjoka: checks 
ganryu76: raises $0.15 to $0.25
mario0887: folds 
Albertin97: calls $0.15
borisjoka: calls $0.15
*** FLOP *** [4c 3s 5c]
Albertin97: checks 
borisjoka: checks 
ganryu76: bets $0.57
Albertin97: folds 
borisjoka: folds 
Uncalled bet ($0.57) returned to ganryu76
ganryu76 collected $0.76 from pot
ganryu76: doesn't show hand 
*** SUMMARY ***
Total pot $0.80 | Rake $0.04 
Board [4c 3s 5c]
Seat 1: borisjoka folded on the Flop
Seat 2: ganryu76 (button) collected ($0.76)
Seat 3: mario0887 (small blind) folded before Flop
Seat 4: Albertin97 (big blind) folded on the Flop
Seat 5: Gissbon folded before Flop (didn't bet)
Seat 6: Acedan1369 folded before Flop (didn't bet)



PokerStars Hand #222971041847:  Hold'em No Limit ($0.05/$0.10 USD) - 2021/01/23 16:04:56 ET
Table 'Malzovia' 6-max Seat #3 is the button
Seat 1: borisjoka ($3.75 in chips) 
Seat 2: ganryu76 ($12.30 in chips) 
Seat 3: mario0887 ($8.64 in chips) 
Seat 4: Albertin97 ($5.54 in chips) 
Seat 5: Gissbon ($10.55 in chips) 
Seat 6: Acedan1369 ($17.38 in chips) 
Albertin97: posts small blind $0.05
Gissbon: posts big blind $0.10
*** HOLE CARDS ***
Acedan1369: folds 
borisjoka: calls $0.10
ganryu76: folds 
mario0887: raises $0.20 to $0.30
Albertin97: folds 
Gissbon: folds 
borisjoka: calls $0.20
*** FLOP *** [6s Qs Qc]
borisjoka: bets $0.10
mario0887: raises $0.30 to $0.40
borisjoka: calls $0.30
*** TURN *** [6s Qs Qc] [5s]
borisjoka: checks 
mario0887: bets $1.11
borisjoka: calls $1.11
*** RIVER *** [6s Qs Qc 5s] [4c]
borisjoka: bets $0.30
mario0887: raises $6.53 to $6.83 and is all-in
borisjoka: calls $1.64 and is all-in
Uncalled bet ($4.89) returned to mario0887
*** SHOW DOWN ***
mario0887: shows [Qh Ks] (three of a kind, Queens)
borisjoka: shows [Jh 6c] (two pair, Queens and Sixes)
mario0887 collected $7.31 from pot
*** SUMMARY ***
Total pot $7.65 | Rake $0.34 
Board [6s Qs Qc 5s 4c]
Seat 1: borisjoka showed [Jh 6c] and lost with two pair, Queens and Sixes
Seat 2: ganryu76 folded before Flop (didn't bet)
Seat 3: mario0887 (button) showed [Qh Ks] and won ($7.31) with three of a kind, Queens
Seat 4: Albertin97 (small blind) folded before Flop
Seat 5: Gissbon (big blind) folded before Flop
Seat 6: Acedan1369 folded before Flop (didn't bet)



PokerStars Hand #222971108383:  Hold'em No Limit ($0.05/$0.10 USD) - 2021/01/23 16:06:15 ET
Table 'Malzovia' 6-max Seat #4 is the button
Seat 2: ganryu76 ($12.30 in chips) 
Seat 3: mario0887 ($12.20 in chips) 
Seat 4: Albertin97 ($5.49 in chips) 
Seat 5: Gissbon ($10.45 in chips) 
Seat 6: Acedan1369 ($17.38 in chips) 
Gissbon: posts small blind $0.05
Acedan1369: posts big blind $0.10
*** HOLE CARDS ***
ganryu76: folds 
mario0887 has timed out
mario0887: folds 
Albertin97: folds 
Gissbon: folds 
Uncalled bet ($0.05) returned to Acedan1369
Acedan1369 collected $0.10 from pot
Acedan1369: doesn't show hand 
borisjoka leaves the table
*** SUMMARY ***
Total pot $0.10 | Rake $0 
Seat 2: ganryu76 folded before Flop (didn't bet)
Seat 3: mario0887 folded before Flop (didn't bet)
Seat 4: Albertin97 (button) folded before Flop (didn't bet)
Seat 5: Gissbon (small blind) folded before Flop
Seat 6: Acedan1369 (big blind) collected ($0.10)



PokerStars Hand #222971125105:  Hold'em No Limit ($0.05/$0.10 USD) - 2021/01/23 16:06:35 ET
Table 'Malzovia' 6-max Seat #5 is the button
Seat 2: ganryu76 ($12.30 in chips) 
Seat 3: mario0887 ($12.20 in chips) 
Seat 4: Albertin97 ($5.49 in chips) 
Seat 5: Gissbon ($10.40 in chips) 
Seat 6: Acedan1369 ($17.43 in chips) 
Acedan1369: posts small blind $0.05
ganryu76: posts big blind $0.10
*** HOLE CARDS ***
mario0887: folds 
Albertin97: folds 
Gissbon: folds 
rojovivo17 joins the table at seat #1 
Acedan1369: folds 
Uncalled bet ($0.05) returned to ganryu76
ganryu76 collected $0.10 from pot
ganryu76: doesn't show hand 
*** SUMMARY ***
Total pot $0.10 | Rake $0 
Seat 2: ganryu76 (big blind) collected ($0.10)
Seat 3: mario0887 folded before Flop (didn't bet)
Seat 4: Albertin97 folded before Flop (didn't bet)
Seat 5: Gissbon (button) folded before Flop (didn't bet)
Seat 6: Acedan1369 (small blind) folded before Flop



PokerStars Hand #222971158327:  Hold'em No Limit ($0.05/$0.10 USD) - 2021/01/23 16:07:15 ET
Table 'Malzovia' 6-max Seat #6 is the button
Seat 2: ganryu76 ($12.35 in chips) 
Seat 3: mario0887 ($12.20 in chips) 
Seat 4: Albertin97 ($5.49 in chips) 
Seat 5: Gissbon ($10.40 in chips) 
Seat 6: Acedan1369 ($17.38 in chips) 
ganryu76: posts small blind $0.05
mario0887: posts big blind $0.10
*** HOLE CARDS ***
Albertin97: folds 
Gissbon: folds 
Acedan1369: folds 
ganryu76: raises $0.25 to $0.35
mario0887: calls $0.25
*** FLOP *** [4s 9h Js]
ganryu76: bets $0.50
mario0887: calls $0.50
*** TURN *** [4s 9h Js] [Ac]
ganryu76: bets $1.22
mario0887: folds 
Uncalled bet ($1.22) returned to ganryu76
ganryu76 collected $1.62 from pot
ganryu76: doesn't show hand 
*** SUMMARY ***
Total pot $1.70 | Rake $0.08 
Board [4s 9h Js Ac]
Seat 2: ganryu76 (small blind) collected ($1.62)
Seat 3: mario0887 (big blind) folded on the Turn
Seat 4: Albertin97 folded before Flop (didn't bet)
Seat 5: Gissbon folded before Flop (didn't bet)
Seat 6: Acedan1369 (button) folded before Flop (didn't bet)



PokerStars Hand #222971216445:  Hold'em No Limit ($0.05/$0.10 USD) - 2021/01/23 16:08:25 ET
Table 'Malzovia' 6-max Seat #2 is the button
Seat 2: ganryu76 ($13.12 in chips) 
Seat 3: mario0887 ($11.35 in chips) 
Seat 4: Albertin97 ($5.49 in chips) 
Seat 5: Gissbon ($10.40 in chips) 
Seat 6: Acedan1369 ($17.38 in chips) 
mario0887: posts small blind $0.05
Albertin97: posts big blind $0.10
rojovivo17: sits out 
*** HOLE CARDS ***
Gissbon: folds 
Gissbon leaves the table
Acedan1369: raises $0.15 to $0.25
KiraLasVegas joins the table at seat #5 
ganryu76: calls $0.25
mario0887: folds 
Albertin97: folds 
*** FLOP *** [Qd Kd Qs]
Acedan1369: bets $0.28
ganryu76: calls $0.28
*** TURN *** [Qd Kd Qs] [Js]
Acedan1369: bets $0.87
ganryu76: raises $0.87 to $1.74
Acedan1369: calls $0.87
*** RIVER *** [Qd Kd Qs Js] [5c]
Acedan1369: checks 
ganryu76: checks 
*** SHOW DOWN ***
Acedan1369: shows [Td Ah] (a straight, Ten to Ace)
ganryu76: mucks hand 
Acedan1369 collected $4.48 from pot
*** SUMMARY ***
Total pot $4.69 | Rake $0.21 
Board [Qd Kd Qs Js 5c]
Seat 2: ganryu76 (button) mucked
Seat 3: mario0887 (small blind) folded before Flop
Seat 4: Albertin97 (big blind) folded before Flop
Seat 5: Gissbon folded before Flop (didn't bet)
Seat 6: Acedan1369 showed [Td Ah] and won ($4.48) with a straight, Ten to Ace



PokerStars Hand #222971271328:  Hold'em No Limit ($0.05/$0.10 USD) - 2021/01/23 16:09:31 ET
Table 'Malzovia' 6-max Seat #3 is the button
Seat 2: ganryu76 ($10.85 in chips) 
Seat 3: mario0887 ($11.30 in chips) 
Seat 4: Albertin97 ($5.39 in chips) 
Seat 5: KiraLasVegas ($10 in chips) 
Seat 6: Acedan1369 ($19.59 in chips) 
Albertin97: posts small blind $0.05
KiraLasVegas: posts big blind $0.10
rojovivo17: sits out 
*** HOLE CARDS ***
Acedan1369: raises $0.15 to $0.25
ganryu76: calls $0.25
mario0887: folds 
Albertin97: calls $0.20
KiraLasVegas: folds 
*** FLOP *** [6s 9d 7c]
Albertin97: checks 
Acedan1369: bets $0.61
ganryu76: calls $0.61
Albertin97: calls $0.61
*** TURN *** [6s 9d 7c] [8h]
Albertin97: checks 
Acedan1369: checks 
ganryu76: checks 
*** RIVER *** [6s 9d 7c 8h] [8s]
Albertin97: bets $0.20
Acedan1369: calls $0.20
ganryu76: raises $1.90 to $2.10
Albertin97: folds 
Acedan1369: folds 
Uncalled bet ($1.90) returned to ganryu76
ganryu76 collected $3.13 from pot
ganryu76: doesn't show hand 
*** SUMMARY ***
Total pot $3.28 | Rake $0.15 
Board [6s 9d 7c 8h 8s]
Seat 2: ganryu76 collected ($3.13)
Seat 3: mario0887 (button) folded before Flop (didn't bet)
Seat 4: Albertin97 (small blind) folded on the River
Seat 5: KiraLasVegas (big blind) folded before Flop
Seat 6: Acedan1369 folded on the River



PokerStars Hand #222971354822:  Hold'em No Limit ($0.05/$0.10 USD) - 2021/01/23 16:11:11 ET
Table 'Malzovia' 6-max Seat #4 is the button
Seat 1: rojovivo17 ($10 in chips) 
Seat 2: ganryu76 ($12.92 in chips) 
Seat 3: mario0887 ($11.30 in chips) 
Seat 4: Albertin97 ($4.33 in chips) 
Seat 5: KiraLasVegas ($10 in chips) 
KiraLasVegas: posts small blind $0.05
rojovivo17: posts big blind $0.10
*** HOLE CARDS ***
ganryu76: folds 
mario0887: folds 
Albertin97: calls $0.10
KiraLasVegas: folds 
rojovivo17: checks 
*** FLOP *** [4c 3s Ks]
rojovivo17: checks 
Albertin97: bets $0.10
rojovivo17: folds 
Uncalled bet ($0.10) returned to Albertin97
Albertin97 collected $0.24 from pot
Albertin97: doesn't show hand 
*** SUMMARY ***
Total pot $0.25 | Rake $0.01 
Board [4c 3s Ks]
Seat 1: rojovivo17 (big blind) folded on the Flop
Seat 2: ganryu76 folded before Flop (didn't bet)
Seat 3: mario0887 folded before Flop (didn't bet)
Seat 4: Albertin97 (button) collected ($0.24)
Seat 5: KiraLasVegas (small blind) folded before Flop



PokerStars Hand #222971371152:  Hold'em No Limit ($0.05/$0.10 USD) - 2021/01/23 16:11:30 ET
Table 'Malzovia' 6-max Seat #5 is the button
Seat 1: rojovivo17 ($10 in chips) 
Seat 2: ganryu76 ($12.92 in chips) 
Seat 3: mario0887 ($11.30 in chips) 
Seat 4: Albertin97 ($4.47 in chips) 
Seat 5: KiraLasVegas ($10 in chips) 
rojovivo17: posts small blind $0.05
ganryu76: posts big blind $0.10
*** HOLE CARDS ***
mario0887: folds 
Albertin97: folds 
KiraLasVegas: raises $0.15 to $0.25
rojovivo17: folds 
ganryu76: raises $0.85 to $1.10
KiraLasVegas: folds 
Uncalled bet ($0.85) returned to ganryu76
ganryu76 collected $0.55 from pot
ganryu76: doesn't show hand 
*** SUMMARY ***
Total pot $0.55 | Rake $0 
Seat 1: rojovivo17 (small blind) folded before Flop
Seat 2: ganryu76 (big blind) collected ($0.55)
Seat 3: mario0887 folded before Flop (didn't bet)
Seat 4: Albertin97 folded before Flop (didn't bet)
Seat 5: KiraLasVegas (button) folded before Flop



PokerStars Hand #222971388393:  Hold'em No Limit ($0.05/$0.10 USD) - 2021/01/23 16:11:51 ET
Table 'Malzovia' 6-max Seat #1 is the button
Seat 1: rojovivo17 ($10 in chips) 
Seat 2: ganryu76 ($13.22 in chips) 
Seat 3: mario0887 ($11.30 in chips) 
Seat 4: Albertin97 ($4.47 in chips) 
Seat 5: KiraLasVegas ($10 in chips) 
ganryu76: posts small blind $0.05
mario0887: posts big blind $0.10
*** HOLE CARDS ***
Albertin97: folds 
KiraLasVegas: folds 
rojovivo17: folds 
ganryu76: raises $0.25 to $0.35
mario0887: folds 
Uncalled bet ($0.25) returned to ganryu76
ganryu76 collected $0.20 from pot
ganryu76: doesn't show hand 
*** SUMMARY ***
Total pot $0.20 | Rake $0 
Seat 1: rojovivo17 (button) folded before Flop (didn't bet)
Seat 2: ganryu76 (small blind) collected ($0.20)
Seat 3: mario0887 (big blind) folded before Flop
Seat 4: Albertin97 folded before Flop (didn't bet)
Seat 5: KiraLasVegas folded before Flop (didn't bet)



PokerStars Hand #222971407349:  Hold'em No Limit ($0.05/$0.10 USD) - 2021/01/23 16:12:14 ET
Table 'Malzovia' 6-max Seat #2 is the button
Seat 1: rojovivo17 ($10 in chips) 
Seat 2: ganryu76 ($13.32 in chips) 
Seat 3: mario0887 ($11.20 in chips) 
Seat 4: Albertin97 ($4.47 in chips) 
Seat 5: KiraLasVegas ($10 in chips) 
mario0887: posts small blind $0.05
Albertin97: posts big blind $0.10
*** HOLE CARDS ***
KiraLasVegas: folds 
KiraLasVegas leaves the table
rojovivo17: folds 
ganryu76: folds 
mario0887: folds 
Uncalled bet ($0.05) returned to Albertin97
Albertin97 collected $0.10 from pot
Albertin97: doesn't show hand 
*** SUMMARY ***
Total pot $0.10 | Rake $0 
Seat 1: rojovivo17 folded before Flop (didn't bet)
Seat 2: ganryu76 (button) folded before Flop (didn't bet)
Seat 3: mario0887 (small blind) folded before Flop
Seat 4: Albertin97 (big blind) collected ($0.10)
Seat 5: KiraLasVegas folded before Flop (didn't bet)



PokerStars Hand #222971416451:  Hold'em No Limit ($0.05/$0.10 USD) - 2021/01/23 16:12:25 ET
Table 'Malzovia' 6-max Seat #3 is the button
Seat 1: rojovivo17 ($10 in chips) 
Seat 2: ganryu76 ($13.32 in chips) 
Seat 3: mario0887 ($11.15 in chips) 
Seat 4: Albertin97 ($4.52 in chips) 
Albertin97: posts small blind $0.05
rojovivo17: posts big blind $0.10
*** HOLE CARDS ***
ganryu76: folds 
mario0887: folds 
Albertin97: raises $0.20 to $0.30
rojovivo17: folds 
Uncalled bet ($0.20) returned to Albertin97
Albertin97 collected $0.20 from pot
Albertin97: doesn't show hand 
*** SUMMARY ***
Total pot $0.20 | Rake $0 
Seat 1: rojovivo17 (big blind) folded before Flop
Seat 2: ganryu76 folded before Flop (didn't bet)
Seat 3: mario0887 (button) folded before Flop (didn't bet)
Seat 4: Albertin97 (small blind) collected ($0.20)



PokerStars Hand #222971427678:  Hold'em No Limit ($0.05/$0.10 USD) - 2021/01/23 16:12:39 ET
Table 'Malzovia' 6-max Seat #4 is the button
Seat 1: rojovivo17 ($10 in chips) 
Seat 2: ganryu76 ($13.32 in chips) 
Seat 3: mario0887 ($11.15 in chips) 
Seat 4: Albertin97 ($4.62 in chips) 
rojovivo17: posts small blind $0.05
ganryu76: posts big blind $0.10
*** HOLE CARDS ***
mario0887: raises $0.15 to $0.25
Albertin97: folds 
rojovivo17: folds 
ganryu76: folds 
Uncalled bet ($0.15) returned to mario0887
mario0887 collected $0.25 from pot
mario0887: doesn't show hand 
*** SUMMARY ***
Total pot $0.25 | Rake $0 
Seat 1: rojovivo17 (small blind) folded before Flop
Seat 2: ganryu76 (big blind) folded before Flop
Seat 3: mario0887 collected ($0.25)
Seat 4: Albertin97 (button) folded before Flop (didn't bet)



PokerStars Hand #222971435879:  Hold'em No Limit ($0.05/$0.10 USD) - 2021/01/23 16:12:49 ET
Table 'Malzovia' 6-max Seat #1 is the button
Seat 1: rojovivo17 ($10 in chips) 
Seat 2: ganryu76 ($13.22 in chips) 
Seat 3: mario0887 ($11.30 in chips) 
Seat 4: Albertin97 ($4.62 in chips) 
ganryu76: posts small blind $0.05
mario0887: posts big blind $0.10
*** HOLE CARDS ***
Albertin97: calls $0.10
rojovivo17: raises $0.30 to $0.40
ganryu76: folds 
mario0887: calls $0.30
Albertin97: folds 
*** FLOP *** [5d Ts 2s]
mario0887: checks 
rojovivo17: bets $0.30
mario0887: calls $0.30
*** TURN *** [5d Ts 2s] [Tc]
tab1988242 joins the table at seat #5 
mario0887: checks 
rojovivo17: checks 
*** RIVER *** [5d Ts 2s Tc] [Jh]
mario0887: bets $0.50
rojovivo17: folds 
Uncalled bet ($0.50) returned to mario0887
mario0887 collected $1.48 from pot
mario0887: doesn't show hand 
*** SUMMARY ***
Total pot $1.55 | Rake $0.07 
Board [5d Ts 2s Tc Jh]
Seat 1: rojovivo17 (button) folded on the River
Seat 2: ganryu76 (small blind) folded before Flop
Seat 3: mario0887 (big blind) collected ($1.48)
Seat 4: Albertin97 folded before Flop



PokerStars Hand #222971488634:  Hold'em No Limit ($0.05/$0.10 USD) - 2021/01/23 16:13:44 ET
Table 'Malzovia' 6-max Seat #2 is the button
Seat 1: rojovivo17 ($10 in chips) 
Seat 2: ganryu76 ($13.17 in chips) 
Seat 3: mario0887 ($12.08 in chips) 
Seat 4: Albertin97 ($4.52 in chips) 
mario0887: posts small blind $0.05
Albertin97: posts big blind $0.10
tab1988242: sits out 
*** HOLE CARDS ***
rojovivo17: raises $0.20 to $0.30
ganryu76: calls $0.30
mario0887: folds 
Albertin97: calls $0.20
*** FLOP *** [3h 8h 6s]
Albertin97: checks 
rojovivo17: checks 
Acedan1369 leaves the table
ganryu76: checks 
*** TURN *** [3h 8h 6s] [4s]
Albertin97: bets $0.20
Black Wolf Poa joins the table at seat #6 
rojovivo17: raises $0.40 to $0.60
ganryu76: folds 
Albertin97: calls $0.40
*** RIVER *** [3h 8h 6s 4s] [As]
Albertin97: checks 
rojovivo17: bets $1.03
Albertin97: calls $1.03
*** SHOW DOWN ***
rojovivo17: shows [6d 6c] (three of a kind, Sixes)
Albertin97: shows [9s 3s] (a flush, Ace high)
Albertin97 collected $4.02 from pot
*** SUMMARY ***
Total pot $4.21 | Rake $0.19 
Board [3h 8h 6s 4s As]
Seat 1: rojovivo17 showed [6d 6c] and lost with three of a kind, Sixes
Seat 2: ganryu76 (button) folded on the Turn
Seat 3: mario0887 (small blind) folded before Flop
Seat 4: Albertin97 (big blind) showed [9s 3s] and won ($4.02) with a flush, Ace high



PokerStars Hand #222971525873:  Hold'em No Limit ($0.05/$0.10 USD) - 2021/01/23 16:14:29 ET
Table 'Malzovia' 6-max Seat #3 is the button
Seat 1: rojovivo17 ($10 in chips) 
Seat 2: ganryu76 ($12.87 in chips) 
Seat 3: mario0887 ($12.03 in chips) 
Seat 4: Albertin97 ($6.61 in chips) 
Seat 5: tab1988242 ($10 in chips) 
Albertin97: posts small blind $0.05
tab1988242: posts big blind $0.10
Black Wolf Poa: sits out 
*** HOLE CARDS ***
rojovivo17: folds 
ganryu76: folds 
mario0887: folds 
Albertin97: calls $0.05
tab1988242: raises $0.20 to $0.30
Albertin97: folds 
Uncalled bet ($0.20) returned to tab1988242
tab1988242 collected $0.20 from pot
tab1988242: doesn't show hand 
*** SUMMARY ***
Total pot $0.20 | Rake $0 
Seat 1: rojovivo17 folded before Flop (didn't bet)
Seat 2: ganryu76 folded before Flop (didn't bet)
Seat 3: mario0887 (button) folded before Flop (didn't bet)
Seat 4: Albertin97 (small blind) folded before Flop
Seat 5: tab1988242 (big blind) collected ($0.20)



PokerStars Hand #222971540968:  Hold'em No Limit ($0.05/$0.10 USD) - 2021/01/23 16:14:47 ET
Table 'Malzovia' 6-max Seat #4 is the button
Seat 1: rojovivo17 ($10 in chips) 
Seat 2: ganryu76 ($12.87 in chips) 
Seat 3: mario0887 ($12.03 in chips) 
Seat 4: Albertin97 ($6.51 in chips) 
Seat 5: tab1988242 ($10.10 in chips) 
Seat 6: Black Wolf Poa ($8.75 in chips) 
tab1988242: posts small blind $0.05
Black Wolf Poa: posts big blind $0.10
*** HOLE CARDS ***
rojovivo17: raises $0.20 to $0.30
ganryu76: folds 
mario0887: folds 
Albertin97: calls $0.30
tab1988242: calls $0.25
Black Wolf Poa: calls $0.20
*** FLOP *** [4c Jd Kd]
tab1988242: checks 
Black Wolf Poa: checks 
rojovivo17: bets $0.58
Albertin97: calls $0.58
tab1988242: calls $0.58
Black Wolf Poa: calls $0.58
*** TURN *** [4c Jd Kd] [6s]
tab1988242: checks 
Black Wolf Poa: checks 
rojovivo17: bets $2.22
Albertin97: folds 
tab1988242: folds 
Black Wolf Poa: folds 
Uncalled bet ($2.22) returned to rojovivo17
rojovivo17 collected $3.36 from pot
rojovivo17: doesn't show hand 
*** SUMMARY ***
Total pot $3.52 | Rake $0.16 
Board [4c Jd Kd 6s]
Seat 1: rojovivo17 collected ($3.36)
Seat 2: ganryu76 folded before Flop (didn't bet)
Seat 3: mario0887 folded before Flop (didn't bet)
Seat 4: Albertin97 (button) folded on the Turn
Seat 5: tab1988242 (small blind) folded on the Turn
Seat 6: Black Wolf Poa (big blind) folded on the Turn



PokerStars Hand #222971621262:  Hold'em No Limit ($0.05/$0.10 USD) - 2021/01/23 16:16:21 ET
Table 'Malzovia' 6-max Seat #5 is the button
Seat 1: rojovivo17 ($12.48 in chips) 
Seat 2: ganryu76 ($12.87 in chips) 
Seat 3: mario0887 ($12.03 in chips) 
Seat 4: Albertin97 ($5.63 in chips) 
Seat 5: tab1988242 ($10 in chips) 
Seat 6: Black Wolf Poa ($7.87 in chips) 
Black Wolf Poa: posts small blind $0.05
rojovivo17: posts big blind $0.10
*** HOLE CARDS ***
ganryu76: raises $0.20 to $0.30
mario0887: calls $0.30
Albertin97: folds 
Albertin97 leaves the table
tab1988242 has timed out
tab1988242: folds 
Black Wolf Poa: calls $0.25
rojovivo17: folds 
*** FLOP *** [Qh 6h Td]
Black Wolf Poa: bets $0.50
ganryu76: folds 
mario0887: folds 
Uncalled bet ($0.50) returned to Black Wolf Poa
Black Wolf Poa collected $0.96 from pot
Black Wolf Poa: doesn't show hand 
*** SUMMARY ***
Total pot $1 | Rake $0.04 
Board [Qh 6h Td]
Seat 1: rojovivo17 (big blind) folded before Flop
Seat 2: ganryu76 folded on the Flop
Seat 3: mario0887 folded on the Flop
Seat 4: Albertin97 folded before Flop (didn't bet)
Seat 5: tab1988242 (button) folded before Flop (didn't bet)
Seat 6: Black Wolf Poa (small blind) collected ($0.96)



PokerStars Hand #222971662713:  Hold'em No Limit ($0.05/$0.10 USD) - 2021/01/23 16:17:09 ET
Table 'Malzovia' 6-max Seat #6 is the button
Seat 1: rojovivo17 ($12.38 in chips) 
Seat 2: ganryu76 ($12.57 in chips) 
Seat 3: mario0887 ($11.73 in chips) 
Seat 5: tab1988242 ($10 in chips) 
Seat 6: Black Wolf Poa ($8.53 in chips) 
rojovivo17: posts small blind $0.05
ganryu76: posts big blind $0.10
*** HOLE CARDS ***
wallANCAP joins the table at seat #4 
mario0887: folds 
tab1988242: folds 
Black Wolf Poa: calls $0.10
rojovivo17: raises $0.30 to $0.40
ganryu76: folds 
Black Wolf Poa: calls $0.30
*** FLOP *** [5h 2h 2s]
rojovivo17: checks 
Black Wolf Poa: checks 
*** TURN *** [5h 2h 2s] [4s]
rojovivo17: checks 
Black Wolf Poa: checks 
*** RIVER *** [5h 2h 2s 4s] [5s]
rojovivo17: checks 
Black Wolf Poa: checks 
*** SHOW DOWN ***
rojovivo17: shows [Jc Kd] (two pair, Fives and Deuces)
Black Wolf Poa: mucks hand 
rojovivo17 collected $0.86 from pot
*** SUMMARY ***
Total pot $0.90 | Rake $0.04 
Board [5h 2h 2s 4s 5s]
Seat 1: rojovivo17 (small blind) showed [Jc Kd] and won ($0.86) with two pair, Fives and Deuces
Seat 2: ganryu76 (big blind) folded before Flop
Seat 3: mario0887 folded before Flop (didn't bet)
Seat 5: tab1988242 folded before Flop (didn't bet)
Seat 6: Black Wolf Poa (button) mucked



PokerStars Hand #222971698818:  Hold'em No Limit ($0.05/$0.10 USD) - 2021/01/23 16:17:51 ET
Table 'Malzovia' 6-max Seat #1 is the button
Seat 1: rojovivo17 ($12.84 in chips) 
Seat 2: ganryu76 ($12.47 in chips) 
Seat 3: mario0887 ($11.73 in chips) 
Seat 5: tab1988242 ($10 in chips) 
Seat 6: Black Wolf Poa ($8.13 in chips) 
ganryu76: posts small blind $0.05
mario0887: posts big blind $0.10
wallANCAP: sits out 
*** HOLE CARDS ***
tab1988242: folds 
Black Wolf Poa: calls $0.10
rojovivo17 has timed out
rojovivo17: folds 
ganryu76: folds 
mario0887: checks 
*** FLOP *** [2d Th 3d]
mario0887: bets $0.10
Black Wolf Poa: calls $0.10
*** TURN *** [2d Th 3d] [Ah]
mario0887: bets $0.14
Black Wolf Poa: calls $0.14
*** RIVER *** [2d Th 3d Ah] [9s]
mario0887: bets $0.53
Black Wolf Poa: folds 
Uncalled bet ($0.53) returned to mario0887
mario0887 collected $0.70 from pot
mario0887: doesn't show hand 
*** SUMMARY ***
Total pot $0.73 | Rake $0.03 
Board [2d Th 3d Ah 9s]
Seat 1: rojovivo17 (button) folded before Flop (didn't bet)
Seat 2: ganryu76 (small blind) folded before Flop
Seat 3: mario0887 (big blind) collected ($0.70)
Seat 5: tab1988242 folded before Flop (didn't bet)
Seat 6: Black Wolf Poa folded on the River



PokerStars Hand #222971739845:  Hold'em No Limit ($0.05/$0.10 USD) - 2021/01/23 16:18:38 ET
Table 'Malzovia' 6-max Seat #2 is the button
Seat 1: rojovivo17 ($12.84 in chips) 
Seat 2: ganryu76 ($12.42 in chips) 
Seat 3: mario0887 ($12.09 in chips) 
Seat 4: wallANCAP ($5 in chips) 
Seat 5: tab1988242 ($10 in chips) 
Seat 6: Black Wolf Poa ($7.79 in chips) 
mario0887: posts small blind $0.05
wallANCAP: posts big blind $0.10
*** HOLE CARDS ***
tab1988242: folds 
Black Wolf Poa: calls $0.10
rojovivo17: folds 
ganryu76: folds 
mario0887: raises $0.20 to $0.30
wallANCAP: calls $0.20
Black Wolf Poa: calls $0.20
*** FLOP *** [3h 7s Jd]
mario0887: bets $0.28
wallANCAP: folds 
Black Wolf Poa: calls $0.28
*** TURN *** [3h 7s Jd] [Ks]
mario0887: bets $0.46
Black Wolf Poa: folds 
Uncalled bet ($0.46) returned to mario0887
mario0887 collected $1.39 from pot
mario0887: doesn't show hand 
*** SUMMARY ***
Total pot $1.46 | Rake $0.07 
Board [3h 7s Jd Ks]
Seat 1: rojovivo17 folded before Flop (didn't bet)
Seat 2: ganryu76 (button) folded before Flop (didn't bet)
Seat 3: mario0887 (small blind) collected ($1.39)
Seat 4: wallANCAP (big blind) folded on the Flop
Seat 5: tab1988242 folded before Flop (didn't bet)
Seat 6: Black Wolf Poa folded on the Turn



PokerStars Hand #222971775589:  Hold'em No Limit ($0.05/$0.10 USD) - 2021/01/23 16:19:20 ET
Table 'Malzovia' 6-max Seat #3 is the button
Seat 1: rojovivo17 ($12.84 in chips) 
Seat 2: ganryu76 ($12.42 in chips) 
Seat 3: mario0887 ($12.90 in chips) 
Seat 4: wallANCAP ($4.70 in chips) 
Seat 5: tab1988242 ($10 in chips) 
Seat 6: Black Wolf Poa ($7.21 in chips) 
wallANCAP: posts small blind $0.05
tab1988242: posts big blind $0.10
*** HOLE CARDS ***
Black Wolf Poa: calls $0.10
rojovivo17: folds 
ganryu76: folds 
mario0887: folds 
wallANCAP: folds 
tab1988242: checks 
*** FLOP *** [4d 6h Qs]
tab1988242: checks 
Black Wolf Poa: checks 
*** TURN *** [4d 6h Qs] [8s]
tab1988242: checks 
Black Wolf Poa: bets $0.30
tab1988242: folds 
Uncalled bet ($0.30) returned to Black Wolf Poa
Black Wolf Poa collected $0.24 from pot
Black Wolf Poa: doesn't show hand 
*** SUMMARY ***
Total pot $0.25 | Rake $0.01 
Board [4d 6h Qs 8s]
Seat 1: rojovivo17 folded before Flop (didn't bet)
Seat 2: ganryu76 folded before Flop (didn't bet)
Seat 3: mario0887 (button) folded before Flop (didn't bet)
Seat 4: wallANCAP (small blind) folded before Flop
Seat 5: tab1988242 (big blind) folded on the Turn
Seat 6: Black Wolf Poa collected ($0.24)



PokerStars Hand #222971803527:  Hold'em No Limit ($0.05/$0.10 USD) - 2021/01/23 16:19:52 ET
Table 'Malzovia' 6-max Seat #4 is the button
Seat 1: rojovivo17 ($12.84 in chips) 
Seat 2: ganryu76 ($12.42 in chips) 
Seat 3: mario0887 ($12.90 in chips) 
Seat 4: wallANCAP ($4.65 in chips) 
Seat 5: tab1988242 ($10 in chips) 
Seat 6: Black Wolf Poa ($7.35 in chips) 
tab1988242: posts small blind $0.05
Black Wolf Poa: posts big blind $0.10
*** HOLE CARDS ***
rojovivo17: folds 
ganryu76: raises $0.20 to $0.30
mario0887: folds 
wallANCAP: folds 
tab1988242: folds 
Black Wolf Poa: calls $0.20
*** FLOP *** [Kh Ac Ah]
Black Wolf Poa: checks 
ganryu76: bets $0.34
Black Wolf Poa: folds 
Uncalled bet ($0.34) returned to ganryu76
ganryu76 collected $0.62 from pot
ganryu76: doesn't show hand 
*** SUMMARY ***
Total pot $0.65 | Rake $0.03 
Board [Kh Ac Ah]
Seat 1: rojovivo17 folded before Flop (didn't bet)
Seat 2: ganryu76 collected ($0.62)
Seat 3: mario0887 folded before Flop (didn't bet)
Seat 4: wallANCAP (button) folded before Flop (didn't bet)
Seat 5: tab1988242 (small blind) folded before Flop
Seat 6: Black Wolf Poa (big blind) folded on the Flop



PokerStars Hand #222971829164:  Hold'em No Limit ($0.05/$0.10 USD) - 2021/01/23 16:20:22 ET
Table 'Malzovia' 6-max Seat #5 is the button
Seat 1: rojovivo17 ($12.84 in chips) 
Seat 2: ganryu76 ($12.74 in chips) 
Seat 3: mario0887 ($12.90 in chips) 
Seat 4: wallANCAP ($4.65 in chips) 
Seat 5: tab1988242 ($10 in chips) 
Seat 6: Black Wolf Poa ($7.05 in chips) 
Black Wolf Poa: posts small blind $0.05
rojovivo17: posts big blind $0.10
*** HOLE CARDS ***
ganryu76: folds 
mario0887: folds 
wallANCAP: folds 
tab1988242: folds 
Black Wolf Poa: calls $0.05
rojovivo17: checks 
*** FLOP *** [2h Jd 7c]
Black Wolf Poa: checks 
rojovivo17: bets $0.10
Black Wolf Poa: calls $0.10
*** TURN *** [2h Jd 7c] [8d]
Black Wolf Poa: bets $0.20
rojovivo17: raises $0.50 to $0.70
Black Wolf Poa: folds 
Uncalled bet ($0.50) returned to rojovivo17
rojovivo17 collected $0.76 from pot
rojovivo17: doesn't show hand 
*** SUMMARY ***
Total pot $0.80 | Rake $0.04 
Board [2h Jd 7c 8d]
Seat 1: rojovivo17 (big blind) collected ($0.76)
Seat 2: ganryu76 folded before Flop (didn't bet)
Seat 3: mario0887 folded before Flop (didn't bet)
Seat 4: wallANCAP folded before Flop (didn't bet)
Seat 5: tab1988242 (button) folded before Flop (didn't bet)
Seat 6: Black Wolf Poa (small blind) folded on the Turn



PokerStars Hand #222971863530:  Hold'em No Limit ($0.05/$0.10 USD) - 2021/01/23 16:21:02 ET
Table 'Malzovia' 6-max Seat #6 is the button
Seat 1: rojovivo17 ($13.20 in chips) 
Seat 2: ganryu76 ($12.74 in chips) 
Seat 3: mario0887 ($12.90 in chips) 
Seat 4: wallANCAP ($4.65 in chips) 
Seat 5: tab1988242 ($10 in chips) 
Seat 6: Black Wolf Poa ($6.65 in chips) 
rojovivo17: posts small blind $0.05
ganryu76: posts big blind $0.10
*** HOLE CARDS ***
mario0887: folds 
wallANCAP: calls $0.10
tab1988242: folds 
Black Wolf Poa: calls $0.10
rojovivo17: calls $0.05
ganryu76: checks 
*** FLOP *** [Jd 8c 7d]
rojovivo17: checks 
ganryu76: checks 
wallANCAP: bets $0.30
Black Wolf Poa: calls $0.30
rojovivo17: folds 
ganryu76: folds 
*** TURN *** [Jd 8c 7d] [9s]
wallANCAP: bets $0.70
Black Wolf Poa: calls $0.70
*** RIVER *** [Jd 8c 7d 9s] [Tc]
wallANCAP: bets $2
Black Wolf Poa: raises $3.55 to $5.55 and is all-in
wallANCAP: calls $1.55 and is all-in
Uncalled bet ($2) returned to Black Wolf Poa
*** SHOW DOWN ***
Black Wolf Poa: shows [6c 4h] (a straight, Seven to Jack)
wallANCAP: shows [Kd Qd] (a straight, Nine to King)
wallANCAP collected $9.07 from pot
*** SUMMARY ***
Total pot $9.50 | Rake $0.43 
Board [Jd 8c 7d 9s Tc]
Seat 1: rojovivo17 (small blind) folded on the Flop
Seat 2: ganryu76 (big blind) folded on the Flop
Seat 3: mario0887 folded before Flop (didn't bet)
Seat 4: wallANCAP showed [Kd Qd] and won ($9.07) with a straight, Nine to King
Seat 5: tab1988242 folded before Flop (didn't bet)
Seat 6: Black Wolf Poa (button) showed [6c 4h] and lost with a straight, Seven to Jack



PokerStars Hand #222971917507:  Hold'em No Limit ($0.05/$0.10 USD) - 2021/01/23 16:22:04 ET
Table 'Malzovia' 6-max Seat #1 is the button
Seat 1: rojovivo17 ($13.10 in chips) 
Seat 2: ganryu76 ($12.64 in chips) 
Seat 3: mario0887 ($12.90 in chips) 
Seat 4: wallANCAP ($9.07 in chips) 
Seat 5: tab1988242 ($10 in chips) 
Seat 6: Black Wolf Poa ($2 in chips) 
ganryu76: posts small blind $0.05
mario0887: posts big blind $0.10
*** HOLE CARDS ***
wallANCAP: folds 
tab1988242: folds 
wallANCAP leaves the table
Black Wolf Poa: raises $0.85 to $0.95
rojovivo17: raises $1.15 to $2.10
ganryu76: folds 
mario0887: folds 
Black Wolf Poa: calls $1.05 and is all-in
Uncalled bet ($0.10) returned to rojovivo17
*** FLOP *** [Jc 6d 8s]
*** TURN *** [Jc 6d 8s] [Ah]
*** RIVER *** [Jc 6d 8s Ah] [3s]
*** SHOW DOWN ***
Black Wolf Poa: shows [6s 4s] (a pair of Sixes)
rojovivo17: shows [Qh Ac] (a pair of Aces)
rojovivo17 collected $3.96 from pot
*** SUMMARY ***
Total pot $4.15 | Rake $0.19 
Board [Jc 6d 8s Ah 3s]
Seat 1: rojovivo17 (button) showed [Qh Ac] and won ($3.96) with a pair of Aces
Seat 2: ganryu76 (small blind) folded before Flop
Seat 3: mario0887 (big blind) folded before Flop
Seat 4: wallANCAP folded before Flop (didn't bet)
Seat 5: tab1988242 folded before Flop (didn't bet)
Seat 6: Black Wolf Poa showed [6s 4s] and lost with a pair of Sixes



PokerStars Hand #222971946917:  Hold'em No Limit ($0.05/$0.10 USD) - 2021/01/23 16:22:39 ET
Table 'Malzovia' 6-max Seat #2 is the button
Seat 1: rojovivo17 ($15.06 in chips) 
Seat 2: ganryu76 ($12.59 in chips) 
Seat 3: mario0887 ($12.80 in chips) 
Seat 5: tab1988242 ($10 in chips) 
mario0887: posts small blind $0.05
tab1988242: posts big blind $0.10
*** HOLE CARDS ***
rojovivo17: folds 
ganryu76: raises $0.15 to $0.25
Black Wolf Poa leaves the table
mario0887: folds 
tab1988242: folds 
Uncalled bet ($0.15) returned to ganryu76
ganryu76 collected $0.25 from pot
ganryu76: doesn't show hand 
*** SUMMARY ***
Total pot $0.25 | Rake $0 
Seat 1: rojovivo17 folded before Flop (didn't bet)
Seat 2: ganryu76 (button) collected ($0.25)
Seat 3: mario0887 (small blind) folded before Flop
Seat 5: tab1988242 (big blind) folded before Flop



PokerStars Hand #222971957510:  Hold'em No Limit ($0.05/$0.10 USD) - 2021/01/23 16:22:51 ET
Table 'Malzovia' 6-max Seat #3 is the button
Seat 1: rojovivo17 ($15.06 in chips) 
Seat 2: ganryu76 ($12.74 in chips) 
Seat 3: mario0887 ($12.75 in chips) 
Seat 5: tab1988242 ($10 in chips) 
tab1988242: posts small blind $0.05
rojovivo17: posts big blind $0.10
*** HOLE CARDS ***
ganryu76: folds 
mario0887: raises $0.15 to $0.25
tab1988242: folds 
rojovivo17: folds 
Uncalled bet ($0.15) returned to mario0887
mario0887 collected $0.25 from pot
mario0887: doesn't show hand 
*** SUMMARY ***
Total pot $0.25 | Rake $0 
Seat 1: rojovivo17 (big blind) folded before Flop
Seat 2: ganryu76 folded before Flop (didn't bet)
Seat 3: mario0887 (button) collected ($0.25)
Seat 5: tab1988242 (small blind) folded before Flop



PokerStars Hand #222971972296:  Hold'em No Limit ($0.05/$0.10 USD) - 2021/01/23 16:23:09 ET
Table 'Malzovia' 6-max Seat #5 is the button
Seat 1: rojovivo17 ($14.96 in chips) 
Seat 3: mario0887 ($12.90 in chips) 
Seat 5: tab1988242 ($10 in chips) 
rojovivo17: posts small blind $0.05
ganryu76: is sitting out 
mario0887: posts big blind $0.10
*** HOLE CARDS ***
tab1988242: raises $0.20 to $0.30
rojovivo17: folds 
mario0887: folds 
Uncalled bet ($0.20) returned to tab1988242
tab1988242 collected $0.25 from pot
tab1988242: doesn't show hand 
Just_Million joins the table at seat #4 
*** SUMMARY ***
Total pot $0.25 | Rake $0 
Seat 1: rojovivo17 (small blind) folded before Flop
Seat 3: mario0887 (big blind) folded before Flop
Seat 5: tab1988242 (button) collected ($0.25)



PokerStars Hand #222971991719:  Hold'em No Limit ($0.05/$0.10 USD) - 2021/01/23 16:23:23 ET
Table 'Malzovia' 6-max Seat #1 is the button
Seat 1: rojovivo17 ($14.91 in chips) 
Seat 3: mario0887 ($12.80 in chips) 
Seat 4: Just_Million ($10 in chips) 
Seat 5: tab1988242 ($10.15 in chips) 
mario0887: posts small blind $0.05
Just_Million: posts big blind $0.10
*** HOLE CARDS ***
ganryu76 leaves the table
tab1988242: folds 
rojovivo17: raises $0.15 to $0.25
NikosVeniz joins the table at seat #2 
mario0887: folds 
Just_Million: folds 
Uncalled bet ($0.15) returned to rojovivo17
rojovivo17 collected $0.25 from pot
rojovivo17: doesn't show hand 
*** SUMMARY ***
Total pot $0.25 | Rake $0 
Seat 1: rojovivo17 (button) collected ($0.25)
Seat 3: mario0887 (small blind) folded before Flop
Seat 4: Just_Million (big blind) folded before Flop
Seat 5: tab1988242 folded before Flop (didn't bet)



PokerStars Hand #222972002395:  Hold'em No Limit ($0.05/$0.10 USD) - 2021/01/23 16:23:36 ET
Table 'Malzovia' 6-max Seat #3 is the button
Seat 1: rojovivo17 ($15.06 in chips) 
Seat 3: mario0887 ($12.75 in chips) 
Seat 4: Just_Million ($10 in chips) 
Seat 5: tab1988242 ($10.15 in chips) 
Just_Million: posts small blind $0.05
tab1988242: posts big blind $0.10
NikosVeniz: sits out 
*** HOLE CARDS ***
mackeeeeeeeeeee joins the table at seat #6 
rojovivo17: folds 
mario0887: folds 
Just_Million: folds 
Uncalled bet ($0.05) returned to tab1988242
tab1988242 collected $0.10 from pot
tab1988242: doesn't show hand 
*** SUMMARY ***
Total pot $0.10 | Rake $0 
Seat 1: rojovivo17 folded before Flop (didn't bet)
Seat 3: mario0887 (button) folded before Flop (didn't bet)
Seat 4: Just_Million (small blind) folded before Flop
Seat 5: tab1988242 (big blind) collected ($0.10)



PokerStars Hand #222972009313:  Hold'em No Limit ($0.05/$0.10 USD) - 2021/01/23 16:23:44 ET
Table 'Malzovia' 6-max Seat #4 is the button
Seat 1: rojovivo17 ($15.06 in chips) 
Seat 2: NikosVeniz ($10 in chips) 
Seat 3: mario0887 ($12.75 in chips) 
Seat 4: Just_Million ($10 in chips) 
Seat 5: tab1988242 ($10.20 in chips) 
Seat 6: mackeeeeeeeeeee ($10 in chips) 
tab1988242: posts small blind $0.05
mackeeeeeeeeeee: posts big blind $0.10
NikosVeniz: posts big blind $0.10
*** HOLE CARDS ***
rojovivo17: folds 
NikosVeniz: checks 
mario0887: folds 
Just_Million: folds 
tab1988242: raises $0.20 to $0.30
mackeeeeeeeeeee: folds 
NikosVeniz: raises $0.20 to $0.50
tab1988242: calls $0.20
*** FLOP *** [2s Kd 3s]
tab1988242: checks 
NikosVeniz: bets $0.52
tab1988242: calls $0.52
*** TURN *** [2s Kd 3s] [Ts]
tab1988242: checks 
NikosVeniz: bets $8.98 and is all-in
tab1988242: folds 
Uncalled bet ($8.98) returned to NikosVeniz
NikosVeniz collected $2.04 from pot
NikosVeniz: doesn't show hand 
*** SUMMARY ***
Total pot $2.14 | Rake $0.10 
Board [2s Kd 3s Ts]
Seat 1: rojovivo17 folded before Flop (didn't bet)
Seat 2: NikosVeniz collected ($2.04)
Seat 3: mario0887 folded before Flop (didn't bet)
Seat 4: Just_Million (button) folded before Flop (didn't bet)
Seat 5: tab1988242 (small blind) folded on the Turn
Seat 6: mackeeeeeeeeeee (big blind) folded before Flop



PokerStars Hand #222972074244:  Hold'em No Limit ($0.05/$0.10 USD) - 2021/01/23 16:25:00 ET
Table 'Malzovia' 6-max Seat #5 is the button
Seat 1: rojovivo17 ($15.06 in chips) 
Seat 2: NikosVeniz ($11.02 in chips) 
Seat 3: mario0887 ($12.75 in chips) 
Seat 4: Just_Million ($10 in chips) 
Seat 5: tab1988242 ($10 in chips) 
Seat 6: mackeeeeeeeeeee ($9.90 in chips) 
mackeeeeeeeeeee: posts small blind $0.05
rojovivo17: posts big blind $0.10
*** HOLE CARDS ***
NikosVeniz: calls $0.10
mario0887: folds 
Just_Million: folds 
tab1988242: folds 
mackeeeeeeeeeee: calls $0.05
rojovivo17: checks 
*** FLOP *** [Qc 6h 7c]
mackeeeeeeeeeee: checks 
rojovivo17: checks 
NikosVeniz: checks 
*** TURN *** [Qc 6h 7c] [5s]
mackeeeeeeeeeee: checks 
rojovivo17: checks 
NikosVeniz: checks 
*** RIVER *** [Qc 6h 7c 5s] [8s]
mackeeeeeeeeeee: checks 
rojovivo17: bets $0.15
NikosVeniz: folds 
mackeeeeeeeeeee: raises $1.25 to $1.40
rojovivo17: calls $1.25
*** SHOW DOWN ***
mackeeeeeeeeeee: shows [Tc 9s] (a straight, Six to Ten)
rojovivo17: mucks hand 
mackeeeeeeeeeee collected $2.96 from pot
*** SUMMARY ***
Total pot $3.10 | Rake $0.14 
Board [Qc 6h 7c 5s 8s]
Seat 1: rojovivo17 (big blind) mucked
Seat 2: NikosVeniz folded on the River
Seat 3: mario0887 folded before Flop (didn't bet)
Seat 4: Just_Million folded before Flop (didn't bet)
Seat 5: tab1988242 (button) folded before Flop (didn't bet)
Seat 6: mackeeeeeeeeeee (small blind) showed [Tc 9s] and won ($2.96) with a straight, Six to Ten



PokerStars Hand #222972118215:  Hold'em No Limit ($0.05/$0.10 USD) - 2021/01/23 16:25:52 ET
Table 'Malzovia' 6-max Seat #6 is the button
Seat 1: rojovivo17 ($13.56 in chips) 
Seat 2: NikosVeniz ($10.92 in chips) 
Seat 3: mario0887 ($12.75 in chips) 
Seat 4: Just_Million ($10 in chips) 
Seat 5: tab1988242 ($10 in chips) 
Seat 6: mackeeeeeeeeeee ($11.36 in chips) 
rojovivo17: posts small blind $0.05
NikosVeniz: posts big blind $0.10
*** HOLE CARDS ***
mario0887: folds 
Just_Million: folds 
tab1988242: folds 
mackeeeeeeeeeee: calls $0.10
rojovivo17: folds 
NikosVeniz: raises $0.10 to $0.20
mackeeeeeeeeeee: calls $0.10
*** FLOP *** [6d Td Kh]
NikosVeniz: bets $0.21
mackeeeeeeeeeee: calls $0.21
*** TURN *** [6d Td Kh] [2c]
NikosVeniz: bets $0.41
mackeeeeeeeeeee: calls $0.41
*** RIVER *** [6d Td Kh 2c] [4c]
NikosVeniz: checks 
mackeeeeeeeeeee: checks 
*** SHOW DOWN ***
NikosVeniz: shows [Ac Qc] (high card Ace)
mackeeeeeeeeeee: shows [Jd Th] (a pair of Tens)
mackeeeeeeeeeee collected $1.61 from pot
*** SUMMARY ***
Total pot $1.69 | Rake $0.08 
Board [6d Td Kh 2c 4c]
Seat 1: rojovivo17 (small blind) folded before Flop
Seat 2: NikosVeniz (big blind) showed [Ac Qc] and lost with high card Ace
Seat 3: mario0887 folded before Flop (didn't bet)
Seat 4: Just_Million folded before Flop (didn't bet)
Seat 5: tab1988242 folded before Flop (didn't bet)
Seat 6: mackeeeeeeeeeee (button) showed [Jd Th] and won ($1.61) with a pair of Tens



PokerStars Hand #222972151762:  Hold'em No Limit ($0.05/$0.10 USD) - 2021/01/23 16:26:32 ET
Table 'Malzovia' 6-max Seat #1 is the button
Seat 1: rojovivo17 ($13.51 in chips) 
Seat 2: NikosVeniz ($10.10 in chips) 
Seat 3: mario0887 ($12.75 in chips) 
Seat 4: Just_Million ($10 in chips) 
Seat 5: tab1988242 ($10 in chips) 
Seat 6: mackeeeeeeeeeee ($12.15 in chips) 
NikosVeniz: posts small blind $0.05
mario0887: posts big blind $0.10
*** HOLE CARDS ***
Just_Million: folds 
tab1988242: raises $0.20 to $0.30
mackeeeeeeeeeee: calls $0.30
rojovivo17: folds 
NikosVeniz: raises $0.20 to $0.50
mario0887: folds 
tab1988242: raises $0.70 to $1.20
mackeeeeeeeeeee: calls $0.90
NikosVeniz: calls $0.70
*** FLOP *** [Ts Kc 4s]
NikosVeniz: checks 
tab1988242: bets $1.77
mackeeeeeeeeeee: folds 
NikosVeniz: calls $1.77
*** TURN *** [Ts Kc 4s] [Kh]
NikosVeniz: checks 
tab1988242: checks 
*** RIVER *** [Ts Kc 4s Kh] [8d]
NikosVeniz: checks 
tab1988242: bets $0.10
NikosVeniz: folds 
Uncalled bet ($0.10) returned to tab1988242
tab1988242 collected $6.91 from pot
tab1988242: doesn't show hand 
*** SUMMARY ***
Total pot $7.24 | Rake $0.33 
Board [Ts Kc 4s Kh 8d]
Seat 1: rojovivo17 (button) folded before Flop (didn't bet)
Seat 2: NikosVeniz (small blind) folded on the River
Seat 3: mario0887 (big blind) folded before Flop
Seat 4: Just_Million folded before Flop (didn't bet)
Seat 5: tab1988242 collected ($6.91)
Seat 6: mackeeeeeeeeeee folded on the Flop



PokerStars Hand #222972218977:  Hold'em No Limit ($0.05/$0.10 USD) - 2021/01/23 16:27:51 ET
Table 'Malzovia' 6-max Seat #2 is the button
Seat 1: rojovivo17 ($13.51 in chips) 
Seat 2: NikosVeniz ($7.13 in chips) 
Seat 3: mario0887 ($12.65 in chips) 
Seat 4: Just_Million ($10 in chips) 
Seat 5: tab1988242 ($13.94 in chips) 
Seat 6: mackeeeeeeeeeee ($10.95 in chips) 
mario0887: posts small blind $0.05
Just_Million: posts big blind $0.10
*** HOLE CARDS ***
tab1988242: folds 
mackeeeeeeeeeee: calls $0.10
rojovivo17: raises $0.40 to $0.50
NikosVeniz: raises $0.40 to $0.90
mario0887: folds 
Just_Million: folds 
mackeeeeeeeeeee: folds 
rojovivo17: calls $0.40
*** FLOP *** [6d 5c 2s]
rojovivo17: checks 
NikosVeniz: bets $0.98
rojovivo17: raises $0.98 to $1.96
NikosVeniz: calls $0.98
*** TURN *** [6d 5c 2s] [Ad]
rojovivo17: checks 
NikosVeniz: checks 
*** RIVER *** [6d 5c 2s Ad] [4s]
rojovivo17: bets $4.80
NikosVeniz: folds 
Uncalled bet ($4.80) returned to rojovivo17
rojovivo17 collected $5.70 from pot
rojovivo17: doesn't show hand 
*** SUMMARY ***
Total pot $5.97 | Rake $0.27 
Board [6d 5c 2s Ad 4s]
Seat 1: rojovivo17 collected ($5.70)
Seat 2: NikosVeniz (button) folded on the River
Seat 3: mario0887 (small blind) folded before Flop
Seat 4: Just_Million (big blind) folded before Flop
Seat 5: tab1988242 folded before Flop (didn't bet)
Seat 6: mackeeeeeeeeeee folded before Flop



PokerStars Hand #222972257395:  Hold'em No Limit ($0.05/$0.10 USD) - 2021/01/23 16:28:36 ET
Table 'Malzovia' 6-max Seat #3 is the button
Seat 1: rojovivo17 ($16.35 in chips) 
Seat 2: NikosVeniz ($4.27 in chips) 
Seat 3: mario0887 ($12.60 in chips) 
Seat 4: Just_Million ($10 in chips) 
Seat 5: tab1988242 ($13.94 in chips) 
Seat 6: mackeeeeeeeeeee ($10.85 in chips) 
Just_Million: posts small blind $0.05
tab1988242: posts big blind $0.10
*** HOLE CARDS ***
mackeeeeeeeeeee: folds 
rojovivo17: folds 
NikosVeniz: folds 
mario0887: folds 
Just_Million: folds 
Uncalled bet ($0.05) returned to tab1988242
tab1988242 collected $0.10 from pot
tab1988242: doesn't show hand 
*** SUMMARY ***
Total pot $0.10 | Rake $0 
Seat 1: rojovivo17 folded before Flop (didn't bet)
Seat 2: NikosVeniz folded before Flop (didn't bet)
Seat 3: mario0887 (button) folded before Flop (didn't bet)
Seat 4: Just_Million (small blind) folded before Flop
Seat 5: tab1988242 (big blind) collected ($0.10)
Seat 6: mackeeeeeeeeeee folded before Flop (didn't bet)



PokerStars Hand #222972270350:  Hold'em No Limit ($0.05/$0.10 USD) - 2021/01/23 16:28:51 ET
Table 'Malzovia' 6-max Seat #4 is the button
Seat 1: rojovivo17 ($16.35 in chips) 
Seat 2: NikosVeniz ($4.27 in chips) 
Seat 3: mario0887 ($12.60 in chips) 
Seat 4: Just_Million ($10 in chips) 
Seat 5: tab1988242 ($13.99 in chips) 
Seat 6: mackeeeeeeeeeee ($10.85 in chips) 
tab1988242: posts small blind $0.05
mackeeeeeeeeeee: posts big blind $0.10
*** HOLE CARDS ***
rojovivo17: folds 
NikosVeniz: folds 
mario0887: folds 
Just_Million: raises $0.10 to $0.20
tab1988242: folds 
mackeeeeeeeeeee: calls $0.10
*** FLOP *** [Ac Qh Jc]
mackeeeeeeeeeee: checks 
Just_Million: checks 
*** TURN *** [Ac Qh Jc] [As]
mackeeeeeeeeeee: checks 
Just_Million: checks 
*** RIVER *** [Ac Qh Jc As] [5h]
mackeeeeeeeeeee: checks 
Just_Million: checks 
*** SHOW DOWN ***
mackeeeeeeeeeee: shows [8h Ks] (a pair of Aces)
Just_Million: shows [3h 3s] (two pair, Aces and Threes)
Just_Million collected $0.43 from pot
*** SUMMARY ***
Total pot $0.45 | Rake $0.02 
Board [Ac Qh Jc As 5h]
Seat 1: rojovivo17 folded before Flop (didn't bet)
Seat 2: NikosVeniz folded before Flop (didn't bet)
Seat 3: mario0887 folded before Flop (didn't bet)
Seat 4: Just_Million (button) showed [3h 3s] and won ($0.43) with two pair, Aces and Threes
Seat 5: tab1988242 (small blind) folded before Flop
Seat 6: mackeeeeeeeeeee (big blind) showed [8h Ks] and lost with a pair of Aces



PokerStars Hand #222972298876:  Hold'em No Limit ($0.05/$0.10 USD) - 2021/01/23 16:29:25 ET
Table 'Malzovia' 6-max Seat #5 is the button
Seat 1: rojovivo17 ($16.35 in chips) 
Seat 2: NikosVeniz ($4.27 in chips) 
Seat 3: mario0887 ($12.60 in chips) 
Seat 4: Just_Million ($10.23 in chips) 
Seat 5: tab1988242 ($13.94 in chips) 
Seat 6: mackeeeeeeeeeee ($10.65 in chips) 
mackeeeeeeeeeee: posts small blind $0.05
rojovivo17: posts big blind $0.10
*** HOLE CARDS ***
NikosVeniz: calls $0.10
mario0887: folds 
Just_Million: folds 
tab1988242: folds 
mackeeeeeeeeeee: calls $0.05
rojovivo17: checks 
*** FLOP *** [8s Qd 3s]
mackeeeeeeeeeee: checks 
rojovivo17: checks 
NikosVeniz: bets $0.14
mackeeeeeeeeeee: folds 
rojovivo17: calls $0.14
*** TURN *** [8s Qd 3s] [8d]
rojovivo17: checks 
NikosVeniz: checks 
*** RIVER *** [8s Qd 3s 8d] [7d]
rojovivo17: checks 
NikosVeniz: bets $0.55
rojovivo17: calls $0.55
*** SHOW DOWN ***
NikosVeniz: shows [Jh 8c] (three of a kind, Eights)
rojovivo17: mucks hand 
NikosVeniz collected $1.60 from pot
*** SUMMARY ***
Total pot $1.68 | Rake $0.08 
Board [8s Qd 3s 8d 7d]
Seat 1: rojovivo17 (big blind) mucked
Seat 2: NikosVeniz showed [Jh 8c] and won ($1.60) with three of a kind, Eights
Seat 3: mario0887 folded before Flop (didn't bet)
Seat 4: Just_Million folded before Flop (didn't bet)
Seat 5: tab1988242 (button) folded before Flop (didn't bet)
Seat 6: mackeeeeeeeeeee (small blind) folded on the Flop



PokerStars Hand #222972342268:  Hold'em No Limit ($0.05/$0.10 USD) - 2021/01/23 16:30:15 ET
Table 'Malzovia' 6-max Seat #6 is the button
Seat 1: rojovivo17 ($15.56 in chips) 
Seat 2: NikosVeniz ($5.08 in chips) 
Seat 3: mario0887 ($12.60 in chips) 
Seat 4: Just_Million ($10.23 in chips) 
Seat 5: tab1988242 ($13.94 in chips) 
Seat 6: mackeeeeeeeeeee ($10.55 in chips) 
rojovivo17: posts small blind $0.05
NikosVeniz: posts big blind $0.10
*** HOLE CARDS ***
mario0887: folds 
Just_Million: raises $0.20 to $0.30
tab1988242: folds 
mackeeeeeeeeeee: folds 
rojovivo17: folds 
NikosVeniz: calls $0.20
*** FLOP *** [9h Jd Ks]
NikosVeniz: checks 
Just_Million: checks 
*** TURN *** [9h Jd Ks] [Qc]
NikosVeniz: checks 
Just_Million: checks 
*** RIVER *** [9h Jd Ks Qc] [3d]
NikosVeniz: bets $4.78 and is all-in
Just_Million: folds 
Uncalled bet ($4.78) returned to NikosVeniz
NikosVeniz collected $0.62 from pot
NikosVeniz: doesn't show hand 
*** SUMMARY ***
Total pot $0.65 | Rake $0.03 
Board [9h Jd Ks Qc 3d]
Seat 1: rojovivo17 (small blind) folded before Flop
Seat 2: NikosVeniz (big blind) collected ($0.62)
Seat 3: mario0887 folded before Flop (didn't bet)
Seat 4: Just_Million folded on the River
Seat 5: tab1988242 folded before Flop (didn't bet)
Seat 6: mackeeeeeeeeeee (button) folded before Flop (didn't bet)



PokerStars Hand #222972389358:  Hold'em No Limit ($0.05/$0.10 USD) - 2021/01/23 16:31:06 ET
Table 'Malzovia' 6-max Seat #1 is the button
Seat 1: rojovivo17 ($15.51 in chips) 
Seat 2: NikosVeniz ($5.40 in chips) 
Seat 3: mario0887 ($12.60 in chips) 
Seat 4: Just_Million ($10 in chips) 
Seat 5: tab1988242 ($13.94 in chips) 
Seat 6: mackeeeeeeeeeee ($10.55 in chips) 
NikosVeniz: posts small blind $0.05
mario0887: posts big blind $0.10
*** HOLE CARDS ***
Just_Million: folds 
tab1988242: folds 
mackeeeeeeeeeee: calls $0.10
rojovivo17: folds 
NikosVeniz: calls $0.05
mario0887: checks 
*** FLOP *** [3h 4h Kc]
NikosVeniz: checks 
mario0887: bets $0.10
mackeeeeeeeeeee: folds 
NikosVeniz: folds 
Uncalled bet ($0.10) returned to mario0887
mario0887 collected $0.29 from pot
mario0887: doesn't show hand 
*** SUMMARY ***
Total pot $0.30 | Rake $0.01 
Board [3h 4h Kc]
Seat 1: rojovivo17 (button) folded before Flop (didn't bet)
Seat 2: NikosVeniz (small blind) folded on the Flop
Seat 3: mario0887 (big blind) collected ($0.29)
Seat 4: Just_Million folded before Flop (didn't bet)
Seat 5: tab1988242 folded before Flop (didn't bet)
Seat 6: mackeeeeeeeeeee folded on the Flop



PokerStars Hand #222972409245:  Hold'em No Limit ($0.05/$0.10 USD) - 2021/01/23 16:31:30 ET
Table 'Malzovia' 6-max Seat #2 is the button
Seat 1: rojovivo17 ($15.51 in chips) 
Seat 2: NikosVeniz ($5.30 in chips) 
Seat 3: mario0887 ($12.79 in chips) 
Seat 4: Just_Million ($10 in chips) 
Seat 5: tab1988242 ($13.94 in chips) 
Seat 6: mackeeeeeeeeeee ($10.45 in chips) 
mario0887: posts small blind $0.05
Just_Million: posts big blind $0.10
*** HOLE CARDS ***
tab1988242: folds 
mackeeeeeeeeeee: raises $0.10 to $0.20
rojovivo17: folds 
NikosVeniz: raises $0.10 to $0.30
mario0887: folds 
Just_Million: folds 
mackeeeeeeeeeee: calls $0.10
*** FLOP *** [8h Jh Qd]
mackeeeeeeeeeee: checks 
NikosVeniz: bets $0.36
mackeeeeeeeeeee: folds 
Uncalled bet ($0.36) returned to NikosVeniz
NikosVeniz collected $0.72 from pot
NikosVeniz: doesn't show hand 
*** SUMMARY ***
Total pot $0.75 | Rake $0.03 
Board [8h Jh Qd]
Seat 1: rojovivo17 folded before Flop (didn't bet)
Seat 2: NikosVeniz (button) collected ($0.72)
Seat 3: mario0887 (small blind) folded before Flop
Seat 4: Just_Million (big blind) folded before Flop
Seat 5: tab1988242 folded before Flop (didn't bet)
Seat 6: mackeeeeeeeeeee folded on the Flop



PokerStars Hand #222972429424:  Hold'em No Limit ($0.05/$0.10 USD) - 2021/01/23 16:31:53 ET
Table 'Malzovia' 6-max Seat #3 is the button
Seat 1: rojovivo17 ($15.51 in chips) 
Seat 2: NikosVeniz ($5.72 in chips) 
Seat 3: mario0887 ($12.74 in chips) 
Seat 4: Just_Million ($10 in chips) 
Seat 5: tab1988242 ($13.94 in chips) 
Seat 6: mackeeeeeeeeeee ($10.15 in chips) 
Just_Million: posts small blind $0.05
tab1988242: posts big blind $0.10
*** HOLE CARDS ***
mackeeeeeeeeeee: calls $0.10
rojovivo17: folds 
NikosVeniz: calls $0.10
mario0887: folds 
Just_Million: folds 
tab1988242: checks 
*** FLOP *** [9h 5h Td]
tab1988242: checks 
mackeeeeeeeeeee: checks 
NikosVeniz: checks 
*** TURN *** [9h 5h Td] [6h]
tab1988242: checks 
mackeeeeeeeeeee: checks 
NikosVeniz: checks 
*** RIVER *** [9h 5h Td 6h] [7h]
tab1988242: checks 
mackeeeeeeeeeee: checks 
NikosVeniz: checks 
*** SHOW DOWN ***
tab1988242: shows [9d 3c] (a pair of Nines)
mackeeeeeeeeeee: mucks hand 
NikosVeniz: mucks hand 
tab1988242 collected $0.33 from pot
*** SUMMARY ***
Total pot $0.35 | Rake $0.02 
Board [9h 5h Td 6h 7h]
Seat 1: rojovivo17 folded before Flop (didn't bet)
Seat 2: NikosVeniz mucked
Seat 3: mario0887 (button) folded before Flop (didn't bet)
Seat 4: Just_Million (small blind) folded before Flop
Seat 5: tab1988242 (big blind) showed [9d 3c] and won ($0.33) with a pair of Nines
Seat 6: mackeeeeeeeeeee mucked



PokerStars Hand #222972461592:  Hold'em No Limit ($0.05/$0.10 USD) - 2021/01/23 16:32:31 ET
Table 'Malzovia' 6-max Seat #4 is the button
Seat 1: rojovivo17 ($15.51 in chips) 
Seat 2: NikosVeniz ($5.62 in chips) 
Seat 3: mario0887 ($12.74 in chips) 
Seat 4: Just_Million ($10 in chips) 
Seat 5: tab1988242 ($14.17 in chips) 
Seat 6: mackeeeeeeeeeee ($10.05 in chips) 
tab1988242: posts small blind $0.05
mackeeeeeeeeeee: posts big blind $0.10
*** HOLE CARDS ***
rojovivo17: folds 
NikosVeniz: folds 
mario0887: raises $0.15 to $0.25
Just_Million: folds 
tab1988242: folds 
mackeeeeeeeeeee: folds 
Uncalled bet ($0.15) returned to mario0887
mario0887 collected $0.25 from pot
mario0887: doesn't show hand 
*** SUMMARY ***
Total pot $0.25 | Rake $0 
Seat 1: rojovivo17 folded before Flop (didn't bet)
Seat 2: NikosVeniz folded before Flop (didn't bet)
Seat 3: mario0887 collected ($0.25)
Seat 4: Just_Million (button) folded before Flop (didn't bet)
Seat 5: tab1988242 (small blind) folded before Flop
Seat 6: mackeeeeeeeeeee (big blind) folded before Flop



PokerStars Hand #222972476009:  Hold'em No Limit ($0.05/$0.10 USD) - 2021/01/23 16:32:48 ET
Table 'Malzovia' 6-max Seat #5 is the button
Seat 1: rojovivo17 ($15.51 in chips) 
Seat 2: NikosVeniz ($5.62 in chips) 
Seat 3: mario0887 ($12.89 in chips) 
Seat 4: Just_Million ($10 in chips) 
Seat 5: tab1988242 ($14.12 in chips) 
Seat 6: mackeeeeeeeeeee ($9.95 in chips) 
mackeeeeeeeeeee: posts small blind $0.05
rojovivo17: posts big blind $0.10
*** HOLE CARDS ***
NikosVeniz: raises $0.10 to $0.20
mario0887: calls $0.20
Just_Million: folds 
tab1988242: folds 
mackeeeeeeeeeee: folds 
rojovivo17: folds 
*** FLOP *** [Js 2s 6h]
NikosVeniz: bets $0.10
mario0887: calls $0.10
*** TURN *** [Js 2s 6h] [Ad]
NikosVeniz: bets $0.36
mario0887: folds 
Uncalled bet ($0.36) returned to NikosVeniz
NikosVeniz collected $0.72 from pot
NikosVeniz: doesn't show hand 
*** SUMMARY ***
Total pot $0.75 | Rake $0.03 
Board [Js 2s 6h Ad]
Seat 1: rojovivo17 (big blind) folded before Flop
Seat 2: NikosVeniz collected ($0.72)
Seat 3: mario0887 folded on the Turn
Seat 4: Just_Million folded before Flop (didn't bet)
Seat 5: tab1988242 (button) folded before Flop (didn't bet)
Seat 6: mackeeeeeeeeeee (small blind) folded before Flop



PokerStars Hand #222972510503:  Hold'em No Limit ($0.05/$0.10 USD) - 2021/01/23 16:33:29 ET
Table 'Malzovia' 6-max Seat #6 is the button
Seat 1: rojovivo17 ($15.41 in chips) 
Seat 2: NikosVeniz ($6.04 in chips) 
Seat 3: mario0887 ($12.59 in chips) 
Seat 4: Just_Million ($10 in chips) 
Seat 5: tab1988242 ($14.12 in chips) 
Seat 6: mackeeeeeeeeeee ($9.90 in chips) 
rojovivo17: posts small blind $0.05
NikosVeniz: posts big blind $0.10
*** HOLE CARDS ***
mario0887: raises $0.15 to $0.25
Just_Million: folds 
tab1988242: raises $0.65 to $0.90
mackeeeeeeeeeee: folds 
rojovivo17: folds 
NikosVeniz: calls $0.80
mario0887: folds 
*** FLOP *** [Ts Ks 9c]
NikosVeniz: checks 
tab1988242: checks 
*** TURN *** [Ts Ks 9c] [9h]
NikosVeniz: checks 
tab1988242: checks 
*** RIVER *** [Ts Ks 9c 9h] [8d]
NikosVeniz: checks 
tab1988242: checks 
*** SHOW DOWN ***
NikosVeniz: shows [3h 5h] (a pair of Nines)
tab1988242: shows [Js Jd] (two pair, Jacks and Nines)
tab1988242 collected $2.01 from pot
*** SUMMARY ***
Total pot $2.10 | Rake $0.09 
Board [Ts Ks 9c 9h 8d]
Seat 1: rojovivo17 (small blind) folded before Flop
Seat 2: NikosVeniz (big blind) showed [3h 5h] and lost with a pair of Nines
Seat 3: mario0887 folded before Flop
Seat 4: Just_Million folded before Flop (didn't bet)
Seat 5: tab1988242 showed [Js Jd] and won ($2.01) with two pair, Jacks and Nines
Seat 6: mackeeeeeeeeeee (button) folded before Flop (didn't bet)



PokerStars Hand #222972562533:  Hold'em No Limit ($0.05/$0.10 USD) - 2021/01/23 16:34:31 ET
Table 'Malzovia' 6-max Seat #1 is the button
Seat 1: rojovivo17 ($15.36 in chips) 
Seat 2: NikosVeniz ($5.14 in chips) 
Seat 3: mario0887 ($12.34 in chips) 
Seat 4: Just_Million ($10 in chips) 
Seat 5: tab1988242 ($15.23 in chips) 
Seat 6: mackeeeeeeeeeee ($9.90 in chips) 
NikosVeniz: posts small blind $0.05
mario0887: posts big blind $0.10
*** HOLE CARDS ***
Just_Million: folds 
tab1988242: folds 
mackeeeeeeeeeee: raises $0.10 to $0.20
rojovivo17: folds 
NikosVeniz: raises $0.10 to $0.30
mario0887: folds 
mackeeeeeeeeeee: calls $0.10
*** FLOP *** [9c 2s Jc]
NikosVeniz: bets $0.33
mackeeeeeeeeeee: folds 
Uncalled bet ($0.33) returned to NikosVeniz
NikosVeniz collected $0.67 from pot
NikosVeniz: doesn't show hand 
*** SUMMARY ***
Total pot $0.70 | Rake $0.03 
Board [9c 2s Jc]
Seat 1: rojovivo17 (button) folded before Flop (didn't bet)
Seat 2: NikosVeniz (small blind) collected ($0.67)
Seat 3: mario0887 (big blind) folded before Flop
Seat 4: Just_Million folded before Flop (didn't bet)
Seat 5: tab1988242 folded before Flop (didn't bet)
Seat 6: mackeeeeeeeeeee folded on the Flop



PokerStars Hand #222972578635:  Hold'em No Limit ($0.05/$0.10 USD) - 2021/01/23 16:34:50 ET
Table 'Malzovia' 6-max Seat #2 is the button
Seat 1: rojovivo17 ($15.36 in chips) 
Seat 2: NikosVeniz ($5.51 in chips) 
Seat 3: mario0887 ($12.24 in chips) 
Seat 4: Just_Million ($10 in chips) 
Seat 5: tab1988242 ($15.23 in chips) 
Seat 6: mackeeeeeeeeeee ($9.60 in chips) 
mario0887: posts small blind $0.05
Just_Million: posts big blind $0.10
*** HOLE CARDS ***
tab1988242: folds 
mackeeeeeeeeeee: raises $0.80 to $0.90
rojovivo17: raises $1.40 to $2.30
NikosVeniz: folds 
mario0887: folds 
Just_Million: folds 
mackeeeeeeeeeee: raises $7.30 to $9.60 and is all-in
rojovivo17: calls $7.30
*** FLOP *** [5s 4c 3c]
*** TURN *** [5s 4c 3c] [Ks]
*** RIVER *** [5s 4c 3c Ks] [9d]
*** SHOW DOWN ***
mackeeeeeeeeeee: shows [2d 2s] (a pair of Deuces)
rojovivo17: shows [Qd Qs] (a pair of Queens)
rojovivo17 collected $18.48 from pot
*** SUMMARY ***
Total pot $19.35 | Rake $0.87 
Board [5s 4c 3c Ks 9d]
Seat 1: rojovivo17 showed [Qd Qs] and won ($18.48) with a pair of Queens
Seat 2: NikosVeniz (button) folded before Flop (didn't bet)
Seat 3: mario0887 (small blind) folded before Flop
Seat 4: Just_Million (big blind) folded before Flop
Seat 5: tab1988242 folded before Flop (didn't bet)
Seat 6: mackeeeeeeeeeee showed [2d 2s] and lost with a pair of Deuces



PokerStars Hand #222972619385:  Hold'em No Limit ($0.05/$0.10 USD) - 2021/01/23 16:35:39 ET
Table 'Malzovia' 6-max Seat #3 is the button
Seat 1: rojovivo17 ($24.24 in chips) 
Seat 2: NikosVeniz ($5.51 in chips) 
Seat 3: mario0887 ($12.19 in chips) 
Seat 4: Just_Million ($10 in chips) 
Seat 5: tab1988242 ($15.23 in chips) 
Just_Million: posts small blind $0.05
tab1988242: posts big blind $0.10
*** HOLE CARDS ***
rojovivo17: folds 
NikosVeniz: folds 
mario0887: folds 
Just_Million: folds 
Uncalled bet ($0.05) returned to tab1988242
tab1988242 collected $0.10 from pot
tab1988242: doesn't show hand 
*** SUMMARY ***
Total pot $0.10 | Rake $0 
Seat 1: rojovivo17 folded before Flop (didn't bet)
Seat 2: NikosVeniz folded before Flop (didn't bet)
Seat 3: mario0887 (button) folded before Flop (didn't bet)
Seat 4: Just_Million (small blind) folded before Flop
Seat 5: tab1988242 (big blind) collected ($0.10)



PokerStars Hand #222972626273:  Hold'em No Limit ($0.05/$0.10 USD) - 2021/01/23 16:35:47 ET
Table 'Malzovia' 6-max Seat #4 is the button
Seat 1: rojovivo17 ($24.24 in chips) 
Seat 2: NikosVeniz ($5.51 in chips) 
Seat 3: mario0887 ($12.19 in chips) 
Seat 4: Just_Million ($10 in chips) 
Seat 5: tab1988242 ($15.28 in chips) 
Seat 6: mackeeeeeeeeeee ($10 in chips) 
tab1988242: posts small blind $0.05
mackeeeeeeeeeee: posts big blind $0.10
*** HOLE CARDS ***
rojovivo17: folds 
NikosVeniz: calls $0.10
mario0887: folds 
Just_Million: folds 
tab1988242: folds 
mackeeeeeeeeeee: checks 
*** FLOP *** [7s 2d 7d]
mackeeeeeeeeeee: checks 
NikosVeniz: bets $0.12
mackeeeeeeeeeee: folds 
Uncalled bet ($0.12) returned to NikosVeniz
NikosVeniz collected $0.24 from pot
NikosVeniz: doesn't show hand 
*** SUMMARY ***
Total pot $0.25 | Rake $0.01 
Board [7s 2d 7d]
Seat 1: rojovivo17 folded before Flop (didn't bet)
Seat 2: NikosVeniz collected ($0.24)
Seat 3: mario0887 folded before Flop (didn't bet)
Seat 4: Just_Million (button) folded before Flop (didn't bet)
Seat 5: tab1988242 (small blind) folded before Flop
Seat 6: mackeeeeeeeeeee (big blind) folded on the Flop



PokerStars Hand #222972643018:  Hold'em No Limit ($0.05/$0.10 USD) - 2021/01/23 16:36:07 ET
Table 'Malzovia' 6-max Seat #5 is the button
Seat 1: rojovivo17 ($24.24 in chips) 
Seat 2: NikosVeniz ($5.65 in chips) 
Seat 3: mario0887 ($12.19 in chips) 
Seat 4: Just_Million ($10 in chips) 
Seat 5: tab1988242 ($15.23 in chips) 
Seat 6: mackeeeeeeeeeee ($9.90 in chips) 
mackeeeeeeeeeee: posts small blind $0.05
rojovivo17: posts big blind $0.10
*** HOLE CARDS ***
NikosVeniz: folds 
mario0887: raises $0.15 to $0.25
Just_Million: raises $0.65 to $0.90
tab1988242: folds 
mackeeeeeeeeeee: folds 
rojovivo17: folds 
mario0887: folds 
Uncalled bet ($0.65) returned to Just_Million
Just_Million collected $0.65 from pot
Just_Million: doesn't show hand 
*** SUMMARY ***
Total pot $0.65 | Rake $0 
Seat 1: rojovivo17 (big blind) folded before Flop
Seat 2: NikosVeniz folded before Flop (didn't bet)
Seat 3: mario0887 folded before Flop
Seat 4: Just_Million collected ($0.65)
Seat 5: tab1988242 (button) folded before Flop (didn't bet)
Seat 6: mackeeeeeeeeeee (small blind) folded before Flop



PokerStars Hand #222972666901:  Hold'em No Limit ($0.05/$0.10 USD) - 2021/01/23 16:36:36 ET
Table 'Malzovia' 6-max Seat #6 is the button
Seat 1: rojovivo17 ($24.14 in chips) 
Seat 2: NikosVeniz ($5.65 in chips) 
Seat 3: mario0887 ($11.94 in chips) 
Seat 4: Just_Million ($10.40 in chips) 
Seat 5: tab1988242 ($15.23 in chips) 
Seat 6: mackeeeeeeeeeee ($9.85 in chips) 
rojovivo17: posts small blind $0.05
NikosVeniz: posts big blind $0.10
*** HOLE CARDS ***
mario0887: folds 
Just_Million: folds 
tab1988242: folds 
mackeeeeeeeeeee: folds 
rojovivo17: folds 
Uncalled bet ($0.05) returned to NikosVeniz
NikosVeniz collected $0.10 from pot
NikosVeniz: doesn't show hand 
*** SUMMARY ***
Total pot $0.10 | Rake $0 
Seat 1: rojovivo17 (small blind) folded before Flop
Seat 2: NikosVeniz (big blind) collected ($0.10)
Seat 3: mario0887 folded before Flop (didn't bet)
Seat 4: Just_Million folded before Flop (didn't bet)
Seat 5: tab1988242 folded before Flop (didn't bet)
Seat 6: mackeeeeeeeeeee (button) folded before Flop (didn't bet)



PokerStars Hand #222972675451:  Hold'em No Limit ($0.05/$0.10 USD) - 2021/01/23 16:36:46 ET
Table 'Malzovia' 6-max Seat #1 is the button
Seat 1: rojovivo17 ($24.09 in chips) 
Seat 2: NikosVeniz ($5.70 in chips) 
Seat 3: mario0887 ($11.94 in chips) 
Seat 4: Just_Million ($10.40 in chips) 
Seat 5: tab1988242 ($15.23 in chips) 
Seat 6: mackeeeeeeeeeee ($9.85 in chips) 
NikosVeniz: posts small blind $0.05
mario0887: posts big blind $0.10
*** HOLE CARDS ***
Just_Million: folds 
tab1988242 has timed out
tab1988242: folds 
mackeeeeeeeeeee: raises $0.50 to $0.60
rojovivo17: folds 
NikosVeniz: calls $0.55
mario0887: folds 
*** FLOP *** [8h Qc 3d]
NikosVeniz: checks 
mackeeeeeeeeeee: bets $1.24
NikosVeniz: raises $1.86 to $3.10
mackeeeeeeeeeee: calls $1.86
*** TURN *** [8h Qc 3d] [7d]
NikosVeniz: checks 
mackeeeeeeeeeee: checks 
*** RIVER *** [8h Qc 3d 7d] [6s]
NikosVeniz: bets $2 and is all-in
mackeeeeeeeeeee: folds 
Uncalled bet ($2) returned to NikosVeniz
NikosVeniz collected $7.16 from pot
NikosVeniz: doesn't show hand 
*** SUMMARY ***
Total pot $7.50 | Rake $0.34 
Board [8h Qc 3d 7d 6s]
Seat 1: rojovivo17 (button) folded before Flop (didn't bet)
Seat 2: NikosVeniz (small blind) collected ($7.16)
Seat 3: mario0887 (big blind) folded before Flop
Seat 4: Just_Million folded before Flop (didn't bet)
Seat 5: tab1988242 folded before Flop (didn't bet)
Seat 6: mackeeeeeeeeeee folded on the River



PokerStars Hand #222972730543:  Hold'em No Limit ($0.05/$0.10 USD) - 2021/01/23 16:37:51 ET
Table 'Malzovia' 6-max Seat #2 is the button
Seat 1: rojovivo17 ($24.09 in chips) 
Seat 2: NikosVeniz ($9.16 in chips) 
Seat 3: mario0887 ($11.84 in chips) 
Seat 4: Just_Million ($10.40 in chips) 
Seat 5: tab1988242 ($15.23 in chips) 
Seat 6: mackeeeeeeeeeee ($10 in chips) 
mario0887: posts small blind $0.05
Just_Million: posts big blind $0.10
*** HOLE CARDS ***
tab1988242: folds 
mackeeeeeeeeeee: calls $0.10
rojovivo17: folds 
NikosVeniz: folds 
mario0887: calls $0.05
Just_Million: checks 
*** FLOP *** [4d Qc As]
mario0887: bets $0.10
Just_Million: folds 
mackeeeeeeeeeee: folds 
Uncalled bet ($0.10) returned to mario0887
mario0887 collected $0.29 from pot
mario0887: doesn't show hand 
*** SUMMARY ***
Total pot $0.30 | Rake $0.01 
Board [4d Qc As]
Seat 1: rojovivo17 folded before Flop (didn't bet)
Seat 2: NikosVeniz (button) folded before Flop (didn't bet)
Seat 3: mario0887 (small blind) collected ($0.29)
Seat 4: Just_Million (big blind) folded on the Flop
Seat 5: tab1988242 folded before Flop (didn't bet)
Seat 6: mackeeeeeeeeeee folded on the Flop



PokerStars Hand #222972748856:  Hold'em No Limit ($0.05/$0.10 USD) - 2021/01/23 16:38:13 ET
Table 'Malzovia' 6-max Seat #3 is the button
Seat 1: rojovivo17 ($24.09 in chips) 
Seat 2: NikosVeniz ($9.16 in chips) 
Seat 3: mario0887 ($12.03 in chips) 
Seat 4: Just_Million ($10.30 in chips) 
Seat 5: tab1988242 ($15.23 in chips) 
Seat 6: mackeeeeeeeeeee ($9.90 in chips) 
Just_Million: posts small blind $0.05
tab1988242: posts big blind $0.10
*** HOLE CARDS ***
mackeeeeeeeeeee: folds 
rojovivo17: folds 
NikosVeniz: calls $0.10
mario0887: folds 
Just_Million: calls $0.05
tab1988242: checks 
*** FLOP *** [5c Qs Qd]
Just_Million: checks 
tab1988242: checks 
NikosVeniz: checks 
*** TURN *** [5c Qs Qd] [9c]
Just_Million: checks 
tab1988242: checks 
NikosVeniz: checks 
*** RIVER *** [5c Qs Qd 9c] [Jc]
Just_Million: checks 
tab1988242: checks 
NikosVeniz: checks 
*** SHOW DOWN ***
Just_Million: shows [9s Tc] (two pair, Queens and Nines)
tab1988242: shows [7h Jh] (two pair, Queens and Jacks)
NikosVeniz: mucks hand 
tab1988242 collected $0.29 from pot
*** SUMMARY ***
Total pot $0.30 | Rake $0.01 
Board [5c Qs Qd 9c Jc]
Seat 1: rojovivo17 folded before Flop (didn't bet)
Seat 2: NikosVeniz mucked
Seat 3: mario0887 (button) folded before Flop (didn't bet)
Seat 4: Just_Million (small blind) showed [9s Tc] and lost with two pair, Queens and Nines
Seat 5: tab1988242 (big blind) showed [7h Jh] and won ($0.29) with two pair, Queens and Jacks
Seat 6: mackeeeeeeeeeee folded before Flop (didn't bet)



PokerStars Hand #222972783541:  Hold'em No Limit ($0.05/$0.10 USD) - 2021/01/23 16:38:55 ET
Table 'Malzovia' 6-max Seat #4 is the button
Seat 1: rojovivo17 ($24.09 in chips) 
Seat 2: NikosVeniz ($9.06 in chips) 
Seat 3: mario0887 ($12.03 in chips) 
Seat 4: Just_Million ($10.20 in chips) 
Seat 5: tab1988242 ($15.42 in chips) 
Seat 6: mackeeeeeeeeeee ($9.90 in chips) 
tab1988242: posts small blind $0.05
mackeeeeeeeeeee: posts big blind $0.10
*** HOLE CARDS ***
rojovivo17: folds 
NikosVeniz: calls $0.10
mario0887: folds 
Just_Million: raises $0.35 to $0.45
tab1988242: folds 
mackeeeeeeeeeee: folds 
NikosVeniz: calls $0.35
*** FLOP *** [3d Js 6h]
NikosVeniz: checks 
Just_Million: bets $0.60
NikosVeniz: calls $0.60
*** TURN *** [3d Js 6h] [Jh]
NikosVeniz: checks 
Just_Million: checks 
*** RIVER *** [3d Js 6h Jh] [3c]
NikosVeniz: bets $8.01 and is all-in
Just_Million: folds 
Uncalled bet ($8.01) returned to NikosVeniz
NikosVeniz collected $2.15 from pot
NikosVeniz: doesn't show hand 
*** SUMMARY ***
Total pot $2.25 | Rake $0.10 
Board [3d Js 6h Jh 3c]
Seat 1: rojovivo17 folded before Flop (didn't bet)
Seat 2: NikosVeniz collected ($2.15)
Seat 3: mario0887 folded before Flop (didn't bet)
Seat 4: Just_Million (button) folded on the River
Seat 5: tab1988242 (small blind) folded before Flop
Seat 6: mackeeeeeeeeeee (big blind) folded before Flop



PokerStars Hand #222972823692:  Hold'em No Limit ($0.05/$0.10 USD) - 2021/01/23 16:39:44 ET
Table 'Malzovia' 6-max Seat #5 is the button
Seat 1: rojovivo17 ($24.09 in chips) 
Seat 2: NikosVeniz ($10.16 in chips) 
Seat 3: mario0887 ($12.03 in chips) 
Seat 4: Just_Million ($10 in chips) 
Seat 5: tab1988242 ($15.37 in chips) 
Seat 6: mackeeeeeeeeeee ($9.80 in chips) 
mackeeeeeeeeeee: posts small blind $0.05
rojovivo17: posts big blind $0.10
*** HOLE CARDS ***
NikosVeniz: folds 
mario0887: folds 
Just_Million: raises $0.15 to $0.25
tab1988242: folds 
mackeeeeeeeeeee: folds 
rojovivo17: folds 
Uncalled bet ($0.15) returned to Just_Million
Just_Million collected $0.25 from pot
Just_Million: doesn't show hand 
*** SUMMARY ***
Total pot $0.25 | Rake $0 
Seat 1: rojovivo17 (big blind) folded before Flop
Seat 2: NikosVeniz folded before Flop (didn't bet)
Seat 3: mario0887 folded before Flop (didn't bet)
Seat 4: Just_Million collected ($0.25)
Seat 5: tab1988242 (button) folded before Flop (didn't bet)
Seat 6: mackeeeeeeeeeee (small blind) folded before Flop



PokerStars Hand #222972855471:  Hold'em No Limit ($0.05/$0.10 USD) - 2021/01/23 16:40:10 ET
Table 'Malzovia' 6-max Seat #6 is the button
Seat 1: rojovivo17 ($23.99 in chips) 
Seat 2: NikosVeniz ($10.16 in chips) 
Seat 3: mario0887 ($12.03 in chips) 
Seat 4: Just_Million ($10.15 in chips) 
Seat 5: tab1988242 ($15.37 in chips) 
Seat 6: mackeeeeeeeeeee ($9.75 in chips) 
rojovivo17: posts small blind $0.05
NikosVeniz: posts big blind $0.10
*** HOLE CARDS ***
mario0887 has timed out
mario0887: folds 
Just_Million: folds 
tab1988242: folds 
mackeeeeeeeeeee has timed out
mackeeeeeeeeeee: folds 
rojovivo17: folds 
Uncalled bet ($0.05) returned to NikosVeniz
NikosVeniz collected $0.10 from pot
NikosVeniz: doesn't show hand 
*** SUMMARY ***
Total pot $0.10 | Rake $0 
Seat 1: rojovivo17 (small blind) folded before Flop
Seat 2: NikosVeniz (big blind) collected ($0.10)
Seat 3: mario0887 folded before Flop (didn't bet)
Seat 4: Just_Million folded before Flop (didn't bet)
Seat 5: tab1988242 folded before Flop (didn't bet)
Seat 6: mackeeeeeeeeeee (button) folded before Flop (didn't bet)



PokerStars Hand #222972879926:  Hold'em No Limit ($0.05/$0.10 USD) - 2021/01/23 16:40:40 ET
Table 'Malzovia' 6-max Seat #1 is the button
Seat 1: rojovivo17 ($23.94 in chips) 
Seat 2: NikosVeniz ($10.21 in chips) 
Seat 3: mario0887 ($12.03 in chips) 
Seat 4: Just_Million ($10.15 in chips) 
Seat 5: tab1988242 ($15.37 in chips) 
NikosVeniz: posts small blind $0.05
mario0887: posts big blind $0.10
*** HOLE CARDS ***
Just_Million: folds 
tab1988242: folds 
rojovivo17: folds 
NikosVeniz: raises $0.10 to $0.20
mario0887: raises $0.60 to $0.80
NikosVeniz: raises $0.60 to $1.40
mario0887: calls $0.60
*** FLOP *** [9d 6h Ac]
NikosVeniz: checks 
mario0887: checks 
*** TURN *** [9d 6h Ac] [Jh]
NikosVeniz: checks 
mario0887: bets $0.88
NikosVeniz: raises $4.43 to $5.31
mario0887: folds 
Uncalled bet ($4.43) returned to NikosVeniz
NikosVeniz collected $4.35 from pot
NikosVeniz: doesn't show hand 
*** SUMMARY ***
Total pot $4.56 | Rake $0.21 
Board [9d 6h Ac Jh]
Seat 1: rojovivo17 (button) folded before Flop (didn't bet)
Seat 2: NikosVeniz (small blind) collected ($4.35)
Seat 3: mario0887 (big blind) folded on the Turn
Seat 4: Just_Million folded before Flop (didn't bet)
Seat 5: tab1988242 folded before Flop (didn't bet)



PokerStars Hand #222972937985:  Hold'em No Limit ($0.05/$0.10 USD) - 2021/01/23 16:41:50 ET
Table 'Malzovia' 6-max Seat #2 is the button
Seat 1: rojovivo17 ($23.94 in chips) 
Seat 2: NikosVeniz ($12.28 in chips) 
Seat 3: mario0887 ($10 in chips) 
Seat 4: Just_Million ($10.15 in chips) 
Seat 5: tab1988242 ($15.37 in chips) 
Seat 6: mackeeeeeeeeeee ($9.75 in chips) 
mario0887: posts small blind $0.05
Just_Million: posts big blind $0.10
*** HOLE CARDS ***
tab1988242: folds 
mackeeeeeeeeeee: raises $0.20 to $0.30
rojovivo17: folds 
NikosVeniz: calls $0.30
mario0887: calls $0.25
Just_Million: folds 
*** FLOP *** [4s 7h 9h]
mario0887: checks 
mackeeeeeeeeeee: bets $0.48
NikosVeniz: calls $0.48
mario0887: calls $0.48
*** TURN *** [4s 7h 9h] [Kh]
mario0887: checks 
mackeeeeeeeeeee: bets $0.10
NikosVeniz: raises $0.10 to $0.20
mario0887: folds 
mackeeeeeeeeeee: calls $0.10
*** RIVER *** [4s 7h 9h Kh] [6c]
mackeeeeeeeeeee: bets $2.71
NikosVeniz: raises $2.71 to $5.42
mackeeeeeeeeeee: raises $3.21 to $8.63
NikosVeniz: raises $2.67 to $11.30 and is all-in
mackeeeeeeeeeee: calls $0.14 and is all-in
Uncalled bet ($2.53) returned to NikosVeniz
*** SHOW DOWN ***
NikosVeniz: shows [Kc 7d] (two pair, Kings and Sevens)
mackeeeeeeeeeee: shows [As 7s] (a pair of Sevens)
NikosVeniz collected $19.46 from pot
*** SUMMARY ***
Total pot $20.38 | Rake $0.92 
Board [4s 7h 9h Kh 6c]
Seat 1: rojovivo17 folded before Flop (didn't bet)
Seat 2: NikosVeniz (button) showed [Kc 7d] and won ($19.46) with two pair, Kings and Sevens
Seat 3: mario0887 (small blind) folded on the Turn
Seat 4: Just_Million (big blind) folded before Flop
Seat 5: tab1988242 folded before Flop (didn't bet)
Seat 6: mackeeeeeeeeeee showed [As 7s] and lost with a pair of Sevens



PokerStars Hand #222973013426:  Hold'em No Limit ($0.05/$0.10 USD) - 2021/01/23 16:43:22 ET
Table 'Malzovia' 6-max Seat #3 is the button
Seat 1: rojovivo17 ($23.94 in chips) 
Seat 2: NikosVeniz ($21.99 in chips) 
Seat 3: mario0887 ($10 in chips) 
Seat 4: Just_Million ($10.05 in chips) 
Seat 5: tab1988242 ($15.37 in chips) 
Just_Million: posts small blind $0.05
tab1988242: posts big blind $0.10
*** HOLE CARDS ***
rojovivo17: folds 
mackeeeeeeeeeee is disconnected 
NikosVeniz: calls $0.10
mario0887: raises $0.15 to $0.25
Just_Million: folds 
tab1988242: folds 
NikosVeniz: calls $0.15
*** FLOP *** [Tc 3d 9s]
NikosVeniz: checks 
mario0887: bets $0.20
NikosVeniz: folds 
Uncalled bet ($0.20) returned to mario0887
mario0887 collected $0.62 from pot
mario0887: doesn't show hand 
*** SUMMARY ***
Total pot $0.65 | Rake $0.03 
Board [Tc 3d 9s]
Seat 1: rojovivo17 folded before Flop (didn't bet)
Seat 2: NikosVeniz folded on the Flop
Seat 3: mario0887 (button) collected ($0.62)
Seat 4: Just_Million (small blind) folded before Flop
Seat 5: tab1988242 (big blind) folded before Flop



PokerStars Hand #222973046560:  Hold'em No Limit ($0.05/$0.10 USD) - 2021/01/23 16:44:03 ET
Table 'Malzovia' 6-max Seat #4 is the button
Seat 1: rojovivo17 ($23.94 in chips) 
Seat 2: NikosVeniz ($21.74 in chips) 
Seat 3: mario0887 ($10.37 in chips) 
Seat 4: Just_Million ($10 in chips) 
Seat 5: tab1988242 ($15.27 in chips) 
tab1988242: posts small blind $0.05
rojovivo17: posts big blind $0.10
*** HOLE CARDS ***
NikosVeniz: raises $0.10 to $0.20
mario0887: folds 
Just_Million: folds 
tab1988242: folds 
rojovivo17: calls $0.10
*** FLOP *** [Ac 4c 3s]
rojovivo17: checks 
NikosVeniz: bets $0.21
rojovivo17: folds 
Uncalled bet ($0.21) returned to NikosVeniz
NikosVeniz collected $0.43 from pot
NikosVeniz: doesn't show hand 
*** SUMMARY ***
Total pot $0.45 | Rake $0.02 
Board [Ac 4c 3s]
Seat 1: rojovivo17 (big blind) folded on the Flop
Seat 2: NikosVeniz collected ($0.43)
Seat 3: mario0887 folded before Flop (didn't bet)
Seat 4: Just_Million (button) folded before Flop (didn't bet)
Seat 5: tab1988242 (small blind) folded before Flop



PokerStars Hand #222973067364:  Hold'em No Limit ($0.05/$0.10 USD) - 2021/01/23 16:44:28 ET
Table 'Malzovia' 6-max Seat #5 is the button
Seat 1: rojovivo17 ($23.74 in chips) 
Seat 2: NikosVeniz ($21.97 in chips) 
Seat 3: mario0887 ($10.37 in chips) 
Seat 4: Just_Million ($10 in chips) 
Seat 5: tab1988242 ($15.22 in chips) 
rojovivo17: posts small blind $0.05
NikosVeniz: posts big blind $0.10
*** HOLE CARDS ***
mario0887: folds 
Just_Million: folds 
tab1988242: folds 
rojovivo17: folds 
Uncalled bet ($0.05) returned to NikosVeniz
NikosVeniz collected $0.10 from pot
NikosVeniz: doesn't show hand 
*** SUMMARY ***
Total pot $0.10 | Rake $0 
Seat 1: rojovivo17 (small blind) folded before Flop
Seat 2: NikosVeniz (big blind) collected ($0.10)
Seat 3: mario0887 folded before Flop (didn't bet)
Seat 4: Just_Million folded before Flop (didn't bet)
Seat 5: tab1988242 (button) folded before Flop (didn't bet)



PokerStars Hand #222973073921:  Hold'em No Limit ($0.05/$0.10 USD) - 2021/01/23 16:44:36 ET
Table 'Malzovia' 6-max Seat #1 is the button
Seat 1: rojovivo17 ($23.69 in chips) 
Seat 2: NikosVeniz ($22.02 in chips) 
Seat 3: mario0887 ($10.37 in chips) 
Seat 4: Just_Million ($10 in chips) 
Seat 5: tab1988242 ($15.22 in chips) 
NikosVeniz: posts small blind $0.05
mario0887: posts big blind $0.10
*** HOLE CARDS ***
Just_Million: folds 
tab1988242: folds 
rojovivo17: folds 
NikosVeniz: raises $0.10 to $0.20
mario0887: calls $0.10
*** FLOP *** [9c 6h 2d]
NikosVeniz: bets $0.19
mario0887: folds 
Uncalled bet ($0.19) returned to NikosVeniz
NikosVeniz collected $0.38 from pot
NikosVeniz: doesn't show hand 
*** SUMMARY ***
Total pot $0.40 | Rake $0.02 
Board [9c 6h 2d]
Seat 1: rojovivo17 (button) folded before Flop (didn't bet)
Seat 2: NikosVeniz (small blind) collected ($0.38)
Seat 3: mario0887 (big blind) folded on the Flop
Seat 4: Just_Million folded before Flop (didn't bet)
Seat 5: tab1988242 folded before Flop (didn't bet)



PokerStars Hand #222973089044:  Hold'em No Limit ($0.05/$0.10 USD) - 2021/01/23 16:44:55 ET
Table 'Malzovia' 6-max Seat #2 is the button
Seat 1: rojovivo17 ($23.69 in chips) 
Seat 2: NikosVeniz ($22.20 in chips) 
Seat 3: mario0887 ($10.17 in chips) 
Seat 4: Just_Million ($10 in chips) 
Seat 5: tab1988242 ($15.22 in chips) 
mario0887: posts small blind $0.05
Just_Million: posts big blind $0.10
*** HOLE CARDS ***
tab1988242: folds 
rojovivo17: folds 
NikosVeniz: folds 
mario0887: raises $0.15 to $0.25
Just_Million: folds 
Uncalled bet ($0.15) returned to mario0887
mario0887 collected $0.20 from pot
mario0887: doesn't show hand 
*** SUMMARY ***
Total pot $0.20 | Rake $0 
Seat 1: rojovivo17 folded before Flop (didn't bet)
Seat 2: NikosVeniz (button) folded before Flop (didn't bet)
Seat 3: mario0887 (small blind) collected ($0.20)
Seat 4: Just_Million (big blind) folded before Flop
Seat 5: tab1988242 folded before Flop (didn't bet)



PokerStars Hand #222973099212:  Hold'em No Limit ($0.05/$0.10 USD) - 2021/01/23 16:45:07 ET
Table 'Malzovia' 6-max Seat #3 is the button
Seat 1: rojovivo17 ($23.69 in chips) 
Seat 2: NikosVeniz ($22.20 in chips) 
Seat 3: mario0887 ($10.27 in chips) 
Seat 4: Just_Million ($10 in chips) 
Seat 5: tab1988242 ($15.22 in chips) 
Just_Million: posts small blind $0.05
tab1988242: posts big blind $0.10
*** HOLE CARDS ***
rojovivo17: folds 
NikosVeniz: folds 
mario0887: folds 
Just_Million: folds 
Uncalled bet ($0.05) returned to tab1988242
tab1988242 collected $0.10 from pot
tab1988242: doesn't show hand 
*** SUMMARY ***
Total pot $0.10 | Rake $0 
Seat 1: rojovivo17 folded before Flop (didn't bet)
Seat 2: NikosVeniz folded before Flop (didn't bet)
Seat 3: mario0887 (button) folded before Flop (didn't bet)
Seat 4: Just_Million (small blind) folded before Flop
Seat 5: tab1988242 (big blind) collected ($0.10)



PokerStars Hand #222973105204:  Hold'em No Limit ($0.05/$0.10 USD) - 2021/01/23 16:45:14 ET
Table 'Malzovia' 6-max Seat #4 is the button
Seat 1: rojovivo17 ($23.69 in chips) 
Seat 2: NikosVeniz ($22.20 in chips) 
Seat 3: mario0887 ($10.27 in chips) 
Seat 4: Just_Million ($10 in chips) 
Seat 5: tab1988242 ($15.27 in chips) 
tab1988242: posts small blind $0.05
rojovivo17: posts big blind $0.10
*** HOLE CARDS ***
NikosVeniz: raises $0.10 to $0.20
mario0887: folds 
Just_Million: calls $0.20
tab1988242: folds 
rojovivo17: calls $0.10
*** FLOP *** [4d Ah Td]
rojovivo17: checks 
NikosVeniz: bets $0.10
Just_Million: calls $0.10
rojovivo17: calls $0.10
*** TURN *** [4d Ah Td] [4c]
rojovivo17: checks 
NikosVeniz: bets $0.45
Just_Million: folds 
rojovivo17: folds 
Uncalled bet ($0.45) returned to NikosVeniz
NikosVeniz collected $0.91 from pot
NikosVeniz: doesn't show hand 
*** SUMMARY ***
Total pot $0.95 | Rake $0.04 
Board [4d Ah Td 4c]
Seat 1: rojovivo17 (big blind) folded on the Turn
Seat 2: NikosVeniz collected ($0.91)
Seat 3: mario0887 folded before Flop (didn't bet)
Seat 4: Just_Million (button) folded on the Turn
Seat 5: tab1988242 (small blind) folded before Flop



PokerStars Hand #222973141914:  Hold'em No Limit ($0.05/$0.10 USD) - 2021/01/23 16:45:58 ET
Table 'Malzovia' 6-max Seat #5 is the button
Seat 1: rojovivo17 ($23.39 in chips) 
Seat 2: NikosVeniz ($22.81 in chips) 
Seat 3: mario0887 ($10.27 in chips) 
Seat 4: Just_Million ($10 in chips) 
Seat 5: tab1988242 ($15.22 in chips) 
rojovivo17: posts small blind $0.05
NikosVeniz: posts big blind $0.10
*** HOLE CARDS ***
mario0887: raises $0.15 to $0.25
Just_Million: folds 
tab1988242: folds 
rojovivo17: folds 
NikosVeniz: raises $0.15 to $0.40
mario0887: calls $0.15
*** FLOP *** [9s 8s Th]
NikosVeniz: checks 
mario0887: bets $0.27
NikosVeniz: raises $0.68 to $0.95
mario0887: raises $1.65 to $2.60
NikosVeniz: raises $1.65 to $4.25
mario0887: raises $5.62 to $9.87 and is all-in
NikosVeniz: calls $5.62
*** TURN *** [9s 8s Th] [As]
*** RIVER *** [9s 8s Th As] [9c]
*** SHOW DOWN ***
NikosVeniz: shows [Kd Td] (two pair, Tens and Nines)
mario0887: shows [Ts Js] (a flush, Ace high)
mario0887 cashed out the hand for $12.41 | Cash Out Fee $0.13
*** SUMMARY ***
Total pot $20.59 | Rake $0.93 
Board [9s 8s Th As 9c]
Seat 1: rojovivo17 (small blind) folded before Flop
Seat 2: NikosVeniz (big blind) showed [Kd Td] and lost with two pair, Tens and Nines
Seat 3: mario0887 showed [Ts Js] and won ($19.66) with a flush, Ace high (pot not awarded as player cashed out)
Seat 4: Just_Million folded before Flop (didn't bet)
Seat 5: tab1988242 (button) folded before Flop (didn't bet)



PokerStars Hand #222973193083:  Hold'em No Limit ($0.05/$0.10 USD) - 2021/01/23 16:47:00 ET
Table 'Malzovia' 6-max Seat #1 is the button
Seat 1: rojovivo17 ($23.34 in chips) 
Seat 2: NikosVeniz ($12.54 in chips) 
Seat 3: mario0887 ($12.41 in chips) 
Seat 4: Just_Million ($10 in chips) 
Seat 5: tab1988242 ($15.22 in chips) 
NikosVeniz: posts small blind $0.05
mario0887: posts big blind $0.10
*** HOLE CARDS ***
Just_Million: folds 
tab1988242: folds 
rojovivo17: folds 
NikosVeniz: calls $0.05
mario0887: checks 
*** FLOP *** [4h Js 6c]
NikosVeniz: bets $0.10
mario0887: folds 
Uncalled bet ($0.10) returned to NikosVeniz
NikosVeniz collected $0.19 from pot
NikosVeniz: doesn't show hand 
*** SUMMARY ***
Total pot $0.20 | Rake $0.01 
Board [4h Js 6c]
Seat 1: rojovivo17 (button) folded before Flop (didn't bet)
Seat 2: NikosVeniz (small blind) collected ($0.19)
Seat 3: mario0887 (big blind) folded on the Flop
Seat 4: Just_Million folded before Flop (didn't bet)
Seat 5: tab1988242 folded before Flop (didn't bet)



PokerStars Hand #222973218389:  Hold'em No Limit ($0.05/$0.10 USD) - 2021/01/23 16:47:30 ET
Table 'Malzovia' 6-max Seat #2 is the button
Seat 1: rojovivo17 ($23.34 in chips) 
Seat 2: NikosVeniz ($12.63 in chips) 
Seat 3: mario0887 ($12.31 in chips) 
Seat 4: Just_Million ($10 in chips) 
Seat 5: tab1988242 ($15.22 in chips) 
mario0887: posts small blind $0.05
Just_Million: posts big blind $0.10
*** HOLE CARDS ***
tab1988242: folds 
rojovivo17: folds 
NikosVeniz: folds 
mario0887: folds 
Uncalled bet ($0.05) returned to Just_Million
Just_Million collected $0.10 from pot
Just_Million: doesn't show hand 
*** SUMMARY ***
Total pot $0.10 | Rake $0 
Seat 1: rojovivo17 folded before Flop (didn't bet)
Seat 2: NikosVeniz (button) folded before Flop (didn't bet)
Seat 3: mario0887 (small blind) folded before Flop
Seat 4: Just_Million (big blind) collected ($0.10)
Seat 5: tab1988242 folded before Flop (didn't bet)



PokerStars Hand #222973223882:  Hold'em No Limit ($0.05/$0.10 USD) - 2021/01/23 16:47:36 ET
Table 'Malzovia' 6-max Seat #3 is the button
Seat 1: rojovivo17 ($23.34 in chips) 
Seat 2: NikosVeniz ($12.63 in chips) 
Seat 3: mario0887 ($12.26 in chips) 
Seat 4: Just_Million ($10.05 in chips) 
Seat 5: tab1988242 ($15.22 in chips) 
Just_Million: posts small blind $0.05
tab1988242: posts big blind $0.10
*** HOLE CARDS ***
rojovivo17: raises $0.20 to $0.30
NikosVeniz: folds 
mario0887: folds 
Just_Million: folds 
tab1988242: raises $0.60 to $0.90
rojovivo17: calls $0.60
*** FLOP *** [As 7h 9d]
tab1988242: bets $0.53
rojovivo17: calls $0.53
*** TURN *** [As 7h 9d] [6h]
tab1988242: bets $3
rojovivo17: calls $3
*** RIVER *** [As 7h 9d 6h] [Ac]
tab1988242: checks 
rojovivo17: checks 
*** SHOW DOWN ***
tab1988242: shows [6s 7s] (two pair, Aces and Sevens)
rojovivo17: mucks hand 
tab1988242 collected $8.51 from pot
*** SUMMARY ***
Total pot $8.91 | Rake $0.40 
Board [As 7h 9d 6h Ac]
Seat 1: rojovivo17 mucked
Seat 2: NikosVeniz folded before Flop (didn't bet)
Seat 3: mario0887 (button) folded before Flop (didn't bet)
Seat 4: Just_Million (small blind) folded before Flop
Seat 5: tab1988242 (big blind) showed [6s 7s] and won ($8.51) with two pair, Aces and Sevens



PokerStars Hand #222973334988:  Hold'em No Limit ($0.05/$0.10 USD) - 2021/01/23 16:49:48 ET
Table 'Malzovia' 6-max Seat #4 is the button
Seat 1: rojovivo17 ($18.91 in chips) 
Seat 2: NikosVeniz ($12.63 in chips) 
Seat 3: mario0887 ($12.26 in chips) 
Seat 4: Just_Million ($10 in chips) 
Seat 5: tab1988242 ($19.30 in chips) 
tab1988242: posts small blind $0.05
rojovivo17: posts big blind $0.10
*** HOLE CARDS ***
NikosVeniz: calls $0.10
mario0887: folds 
Just_Million: folds 
tab1988242: folds 
rojovivo17: checks 
*** FLOP *** [9h 7s 6s]
rojovivo17: bets $0.10
NikosVeniz: raises $0.22 to $0.32
rojovivo17: calls $0.22
*** TURN *** [9h 7s 6s] [Ac]
rojovivo17: checks 
NikosVeniz: bets $0.42
rojovivo17: calls $0.42
*** RIVER *** [9h 7s 6s Ac] [2h]
rojovivo17: checks 
NikosVeniz: checks 
*** SHOW DOWN ***
rojovivo17: shows [8h 7c] (a pair of Sevens)
NikosVeniz: mucks hand 
rojovivo17 collected $1.65 from pot
*** SUMMARY ***
Total pot $1.73 | Rake $0.08 
Board [9h 7s 6s Ac 2h]
Seat 1: rojovivo17 (big blind) showed [8h 7c] and won ($1.65) with a pair of Sevens
Seat 2: NikosVeniz mucked
Seat 3: mario0887 folded before Flop (didn't bet)
Seat 4: Just_Million (button) folded before Flop (didn't bet)
Seat 5: tab1988242 (small blind) folded before Flop



PokerStars Hand #222973380020:  Hold'em No Limit ($0.05/$0.10 USD) - 2021/01/23 16:50:42 ET
Table 'Malzovia' 6-max Seat #5 is the button
Seat 1: rojovivo17 ($19.72 in chips) 
Seat 2: NikosVeniz ($11.79 in chips) 
Seat 3: mario0887 ($12.26 in chips) 
Seat 4: Just_Million ($10 in chips) 
Seat 5: tab1988242 ($19.25 in chips) 
rojovivo17: posts small blind $0.05
NikosVeniz: posts big blind $0.10
*** HOLE CARDS ***
mario0887: folds 
Just_Million: folds 
tab1988242: folds 
rojovivo17: folds 
Uncalled bet ($0.05) returned to NikosVeniz
NikosVeniz collected $0.10 from pot
NikosVeniz: doesn't show hand 
*** SUMMARY ***
Total pot $0.10 | Rake $0 
Seat 1: rojovivo17 (small blind) folded before Flop
Seat 2: NikosVeniz (big blind) collected ($0.10)
Seat 3: mario0887 folded before Flop (didn't bet)
Seat 4: Just_Million folded before Flop (didn't bet)
Seat 5: tab1988242 (button) folded before Flop (didn't bet)



PokerStars Hand #222973396554:  Hold'em No Limit ($0.05/$0.10 USD) - 2021/01/23 16:51:02 ET
Table 'Malzovia' 6-max Seat #1 is the button
Seat 1: rojovivo17 ($19.67 in chips) 
Seat 2: NikosVeniz ($11.84 in chips) 
Seat 3: mario0887 ($12.26 in chips) 
Seat 4: Just_Million ($10 in chips) 
Seat 5: tab1988242 ($19.25 in chips) 
NikosVeniz: posts small blind $0.05
mario0887: posts big blind $0.10
*** HOLE CARDS ***
Just_Million: folds 
tab1988242: folds 
rojovivo17: folds 
NikosVeniz: calls $0.05
mario0887: checks 
*** FLOP *** [Qs Td 6c]
NikosVeniz: checks 
mario0887: bets $0.10
NikosVeniz: folds 
Uncalled bet ($0.10) returned to mario0887
mario0887 collected $0.19 from pot
mario0887: doesn't show hand 
*** SUMMARY ***
Total pot $0.20 | Rake $0.01 
Board [Qs Td 6c]
Seat 1: rojovivo17 (button) folded before Flop (didn't bet)
Seat 2: NikosVeniz (small blind) folded on the Flop
Seat 3: mario0887 (big blind) collected ($0.19)
Seat 4: Just_Million folded before Flop (didn't bet)
Seat 5: tab1988242 folded before Flop (didn't bet)



PokerStars Hand #222973414900:  Hold'em No Limit ($0.05/$0.10 USD) - 2021/01/23 16:51:24 ET
Table 'Malzovia' 6-max Seat #2 is the button
Seat 1: rojovivo17 ($19.67 in chips) 
Seat 2: NikosVeniz ($11.74 in chips) 
Seat 3: mario0887 ($12.35 in chips) 
Seat 4: Just_Million ($10 in chips) 
Seat 5: tab1988242 ($19.25 in chips) 
mario0887: posts small blind $0.05
Just_Million: posts big blind $0.10
*** HOLE CARDS ***
tab1988242: folds 
rojovivo17: folds 
NikosVeniz: calls $0.10
mario0887: folds 
Just_Million: checks 
*** FLOP *** [8c 2s 7d]
Just_Million: checks 
NikosVeniz: checks 
*** TURN *** [8c 2s 7d] [7s]
Just_Million: bets $0.15
NikosVeniz: raises $0.15 to $0.30
Just_Million: calls $0.15
*** RIVER *** [8c 2s 7d 7s] [Kd]
Just_Million: checks 
NikosVeniz: checks 
*** SHOW DOWN ***
Just_Million: shows [9h Tc] (a pair of Sevens)
NikosVeniz: shows [6d Qd] (a pair of Sevens - King+Queen kicker)
NikosVeniz collected $0.81 from pot
*** SUMMARY ***
Total pot $0.85 | Rake $0.04 
Board [8c 2s 7d 7s Kd]
Seat 1: rojovivo17 folded before Flop (didn't bet)
Seat 2: NikosVeniz (button) showed [6d Qd] and won ($0.81) with a pair of Sevens
Seat 3: mario0887 (small blind) folded before Flop
Seat 4: Just_Million (big blind) showed [9h Tc] and lost with a pair of Sevens
Seat 5: tab1988242 folded before Flop (didn't bet)



PokerStars Hand #222973449367:  Hold'em No Limit ($0.05/$0.10 USD) - 2021/01/23 16:52:05 ET
Table 'Malzovia' 6-max Seat #3 is the button
Seat 1: rojovivo17 ($19.67 in chips) 
Seat 2: NikosVeniz ($12.15 in chips) 
Seat 3: mario0887 ($12.30 in chips) 
Seat 4: Just_Million ($10 in chips) 
Seat 5: tab1988242 ($19.25 in chips) 
Just_Million: posts small blind $0.05
tab1988242: posts big blind $0.10
*** HOLE CARDS ***
rojovivo17: folds 
NikosVeniz: calls $0.10
mario0887: folds 
Just_Million: folds 
tab1988242: raises $0.20 to $0.30
NikosVeniz: calls $0.20
*** FLOP *** [Kh 3d 7h]
tab1988242: checks 
NikosVeniz: checks 
*** TURN *** [Kh 3d 7h] [2h]
tab1988242: checks 
NikosVeniz: checks 
*** RIVER *** [Kh 3d 7h 2h] [Ts]
tab1988242: bets $0.93
NikosVeniz: folds 
Uncalled bet ($0.93) returned to tab1988242
tab1988242 collected $0.62 from pot
tab1988242: doesn't show hand 
*** SUMMARY ***
Total pot $0.65 | Rake $0.03 
Board [Kh 3d 7h 2h Ts]
Seat 1: rojovivo17 folded before Flop (didn't bet)
Seat 2: NikosVeniz folded on the River
Seat 3: mario0887 (button) folded before Flop (didn't bet)
Seat 4: Just_Million (small blind) folded before Flop
Seat 5: tab1988242 (big blind) collected ($0.62)



PokerStars Hand #222973496649:  Hold'em No Limit ($0.05/$0.10 USD) - 2021/01/23 16:53:01 ET
Table 'Malzovia' 6-max Seat #4 is the button
Seat 1: rojovivo17 ($19.67 in chips) 
Seat 2: NikosVeniz ($11.85 in chips) 
Seat 3: mario0887 ($12.30 in chips) 
Seat 4: Just_Million ($10 in chips) 
Seat 5: tab1988242 ($19.57 in chips) 
tab1988242: posts small blind $0.05
rojovivo17: posts big blind $0.10
*** HOLE CARDS ***
NikosVeniz: folds 
mario0887: folds 
Just_Million: folds 
tab1988242: raises $0.20 to $0.30
rojovivo17: calls $0.20
*** FLOP *** [3h 5d 7h]
mackeeeeeeeeeee was removed from the table for failing to post
mackeeeeeeeeeee leaves the table
tab1988242: bets $0.29
rojovivo17: folds 
Uncalled bet ($0.29) returned to tab1988242
tab1988242 collected $0.57 from pot
tab1988242: doesn't show hand 
*** SUMMARY ***
Total pot $0.60 | Rake $0.03 
Board [3h 5d 7h]
Seat 1: rojovivo17 (big blind) folded on the Flop
Seat 2: NikosVeniz folded before Flop (didn't bet)
Seat 3: mario0887 folded before Flop (didn't bet)
Seat 4: Just_Million (button) folded before Flop (didn't bet)
Seat 5: tab1988242 (small blind) collected ($0.57)



PokerStars Hand #222973522417:  Hold'em No Limit ($0.05/$0.10 USD) - 2021/01/23 16:53:32 ET
Table 'Malzovia' 6-max Seat #5 is the button
Seat 1: rojovivo17 ($19.37 in chips) 
Seat 2: NikosVeniz ($11.85 in chips) 
Seat 3: mario0887 ($12.30 in chips) 
Seat 4: Just_Million ($10 in chips) 
Seat 5: tab1988242 ($19.84 in chips) 
rojovivo17: posts small blind $0.05
NikosVeniz: posts big blind $0.10
*** HOLE CARDS ***
mario0887: folds 
Hooch321 joins the table at seat #6 
Just_Million: raises $0.15 to $0.25
tab1988242: folds 
rojovivo17: folds 
NikosVeniz: raises $0.15 to $0.40
Just_Million: calls $0.15
*** FLOP *** [4d As Kd]
NikosVeniz: checks 
Just_Million: checks 
*** TURN *** [4d As Kd] [6s]
NikosVeniz: bets $0.20
Just_Million: calls $0.20
*** RIVER *** [4d As Kd 6s] [5h]
NikosVeniz: bets $1.19
Just_Million: folds 
Uncalled bet ($1.19) returned to NikosVeniz
NikosVeniz collected $1.19 from pot
*** SUMMARY ***
Total pot $1.25 | Rake $0.06 
Board [4d As Kd 6s 5h]
Seat 1: rojovivo17 (small blind) folded before Flop
Seat 2: NikosVeniz (big blind) collected ($1.19)
Seat 3: mario0887 folded before Flop (didn't bet)
Seat 4: Just_Million folded on the River
Seat 5: tab1988242 (button) folded before Flop (didn't bet)



PokerStars Hand #222973561592:  Hold'em No Limit ($0.05/$0.10 USD) - 2021/01/23 16:54:20 ET
Table 'Malzovia' 6-max Seat #1 is the button
Seat 1: rojovivo17 ($19.32 in chips) 
Seat 2: NikosVeniz ($12.44 in chips) 
Seat 3: mario0887 ($12.30 in chips) 
Seat 4: Just_Million ($10 in chips) 
Seat 5: tab1988242 ($19.84 in chips) 
NikosVeniz: posts small blind $0.05
mario0887: posts big blind $0.10
Hooch321: sits out 
*** HOLE CARDS ***
Hooch321 leaves the table
Just_Million: folds 
tab1988242: folds 
rojovivo17: folds 
NikosVeniz: calls $0.05
mario0887: raises $0.20 to $0.30
NikosVeniz: calls $0.20
*** FLOP *** [Kd 8s Ah]
NikosVeniz: checks 
mario0887: bets $0.19
NikosVeniz: raises $0.19 to $0.38
mario0887: calls $0.19
*** TURN *** [Kd 8s Ah] [5d]
NikosVeniz: checks 
mario0887: bets $0.98
NikosVeniz: raises $1.63 to $2.61
mario0887: folds 
Uncalled bet ($1.63) returned to NikosVeniz
NikosVeniz collected $3.17 from pot
NikosVeniz: doesn't show hand 
*** SUMMARY ***
Total pot $3.32 | Rake $0.15 
Board [Kd 8s Ah 5d]
Seat 1: rojovivo17 (button) folded before Flop (didn't bet)
Seat 2: NikosVeniz (small blind) collected ($3.17)
Seat 3: mario0887 (big blind) folded on the Turn
Seat 4: Just_Million folded before Flop (didn't bet)
Seat 5: tab1988242 folded before Flop (didn't bet)



PokerStars Hand #222973604818:  Hold'em No Limit ($0.05/$0.10 USD) - 2021/01/23 16:55:13 ET
Table 'Malzovia' 6-max Seat #2 is the button
Seat 1: rojovivo17 ($19.32 in chips) 
Seat 2: NikosVeniz ($13.95 in chips) 
Seat 3: mario0887 ($10.64 in chips) 
Seat 4: Just_Million ($10 in chips) 
Seat 5: tab1988242 ($19.84 in chips) 
mario0887: posts small blind $0.05
Just_Million: posts big blind $0.10
*** HOLE CARDS ***
tab1988242: raises $0.20 to $0.30
rojovivo17: calls $0.30
NikosVeniz: folds 
mario0887: folds 
Just_Million: folds 
*** FLOP *** [Qh Jh 6c]
tab1988242: bets $0.54
rojovivo17: calls $0.54
*** TURN *** [Qh Jh 6c] [6d]
tab1988242: bets $1.31
rojovivo17: raises $1.39 to $2.70
tab1988242: calls $1.39
*** RIVER *** [Qh Jh 6c 6d] [4s]
bedniereba joins the table at seat #6 
tab1988242: checks 
rojovivo17: bets $4.40
tab1988242: raises $11.90 to $16.30 and is all-in
rojovivo17: calls $11.38 and is all-in
Uncalled bet ($0.52) returned to tab1988242
*** SHOW DOWN ***
tab1988242: shows [Jc Jd] (a full house, Jacks full of Sixes)
rojovivo17: shows [5h 6h] (three of a kind, Sixes)
tab1988242 collected $37.29 from pot
*** SUMMARY ***
Total pot $38.79 | Rake $1.50 
Board [Qh Jh 6c 6d 4s]
Seat 1: rojovivo17 showed [5h 6h] and lost with three of a kind, Sixes
Seat 2: NikosVeniz (button) folded before Flop (didn't bet)
Seat 3: mario0887 (small blind) folded before Flop
Seat 4: Just_Million (big blind) folded before Flop
Seat 5: tab1988242 showed [Jc Jd] and won ($37.29) with a full house, Jacks full of Sixes



PokerStars Hand #222973687057:  Hold'em No Limit ($0.05/$0.10 USD) - 2021/01/23 16:57:37 ET
Table 'Malzovia' 6-max Seat #3 is the button
Seat 1: rojovivo17 ($10 in chips) 
Seat 2: NikosVeniz ($13.95 in chips) 
Seat 3: mario0887 ($10.59 in chips) 
Seat 4: Just_Million ($10 in chips) 
Seat 5: tab1988242 ($37.81 in chips) 
Seat 6: bedniereba ($6.84 in chips) 
Just_Million: posts small blind $0.05
tab1988242: posts big blind $0.10
bedniereba: posts big blind $0.10
*** HOLE CARDS ***
bedniereba: checks 
rojovivo17: folds 
rojovivo17 leaves the table
NikosVeniz: calls $0.10
mario0887: folds 
Just_Million: folds 
tab1988242: checks 
*** FLOP *** [8c 6c Qs]
tab1988242: checks 
bedniereba: checks 
NikosVeniz: bets $0.16
tab1988242: folds 
bedniereba: folds 
Uncalled bet ($0.16) returned to NikosVeniz
Lucky HoBBiT joins the table at seat #1 
NikosVeniz collected $0.33 from pot
NikosVeniz: doesn't show hand 
*** SUMMARY ***
Total pot $0.35 | Rake $0.02 
Board [8c 6c Qs]
Seat 1: rojovivo17 folded before Flop (didn't bet)
Seat 2: NikosVeniz collected ($0.33)
Seat 3: mario0887 (button) folded before Flop (didn't bet)
Seat 4: Just_Million (small blind) folded before Flop
Seat 5: tab1988242 (big blind) folded on the Flop
Seat 6: bedniereba folded on the Flop (didn't bet)



PokerStars Hand #222973703668:  Hold'em No Limit ($0.05/$0.10 USD) - 2021/01/23 16:58:05 ET
Table 'Malzovia' 6-max Seat #4 is the button
Seat 3: mario0887 ($10.59 in chips) 
Seat 4: Just_Million ($10 in chips) 
Seat 5: tab1988242 ($37.71 in chips) 
Seat 6: bedniereba ($6.74 in chips) 
tab1988242: posts small blind $0.05
bedniereba: posts big blind $0.10
Lucky HoBBiT: sits out 
*** HOLE CARDS ***
mario0887: folds 
Just_Million: raises $0.10 to $0.20
tab1988242: folds 
bedniereba: calls $0.10
*** FLOP *** [9s 5h 3c]
bedniereba: checks 
Just_Million: bets $0.25
bedniereba: calls $0.25
*** TURN *** [9s 5h 3c] [Kd]
bedniereba: checks 
Just_Million: bets $0.50
bedniereba: folds 
Uncalled bet ($0.50) returned to Just_Million
Just_Million collected $0.91 from pot
Just_Million: doesn't show hand 
*** SUMMARY ***
Total pot $0.95 | Rake $0.04 
Board [9s 5h 3c Kd]
Seat 3: mario0887 folded before Flop (didn't bet)
Seat 4: Just_Million (button) collected ($0.91)
Seat 5: tab1988242 (small blind) folded before Flop
Seat 6: bedniereba (big blind) folded on the Turn



PokerStars Hand #222973719285:  Hold'em No Limit ($0.05/$0.10 USD) - 2021/01/23 16:58:33 ET
Table 'Malzovia' 6-max Seat #5 is the button
Seat 1: Lucky HoBBiT ($10 in chips) 
Seat 3: mario0887 ($10.59 in chips) 
Seat 4: Just_Million ($10.46 in chips) 
Seat 5: tab1988242 ($37.66 in chips) 
Seat 6: bedniereba ($6.29 in chips) 
bedniereba: posts small blind $0.05
Lucky HoBBiT: posts big blind $0.10
*** HOLE CARDS ***
mario0887: folds 
Just_Million: folds 
tab1988242: folds 
bedniereba: raises $0.20 to $0.30
Lucky HoBBiT: raises $9.70 to $10 and is all-in
bedniereba: folds 
Uncalled bet ($9.70) returned to Lucky HoBBiT
Lucky HoBBiT collected $0.60 from pot
Lucky HoBBiT: doesn't show hand 
*** SUMMARY ***
Total pot $0.60 | Rake $0 
Seat 1: Lucky HoBBiT (big blind) collected ($0.60)
Seat 3: mario0887 folded before Flop (didn't bet)
Seat 4: Just_Million folded before Flop (didn't bet)
Seat 5: tab1988242 (button) folded before Flop (didn't bet)
Seat 6: bedniereba (small blind) folded before Flop



PokerStars Hand #222973732354:  Hold'em No Limit ($0.05/$0.10 USD) - 2021/01/23 16:58:55 ET
Table 'Malzovia' 6-max Seat #6 is the button
Seat 1: Lucky HoBBiT ($10.30 in chips) 
Seat 3: mario0887 ($10.59 in chips) 
Seat 4: Just_Million ($10.46 in chips) 
Seat 5: tab1988242 ($37.66 in chips) 
Seat 6: bedniereba ($5.99 in chips) 
Lucky HoBBiT: posts small blind $0.05
mario0887: posts big blind $0.10
*** HOLE CARDS ***
Just_Million: folds 
tab1988242: folds 
bedniereba: raises $0.20 to $0.30
Lucky HoBBiT: folds 
mario0887: raises $0.60 to $0.90
bedniereba: calls $0.60
*** FLOP *** [2h 9d 6c]
mario0887: bets $0.58
bedniereba: calls $0.58
*** TURN *** [2h 9d 6c] [Tc]
mario0887: bets $0.95
bedniereba: calls $0.95
*** RIVER *** [2h 9d 6c Tc] [7h]
mario0887: checks 
bedniereba: checks 
*** SHOW DOWN ***
mario0887: shows [Ah Qs] (high card Ace)
bedniereba: shows [3s 3h] (a pair of Threes)
bedniereba collected $4.69 from pot
*** SUMMARY ***
Total pot $4.91 | Rake $0.22 
Board [2h 9d 6c Tc 7h]
Seat 1: Lucky HoBBiT (small blind) folded before Flop
Seat 3: mario0887 (big blind) showed [Ah Qs] and lost with high card Ace
Seat 4: Just_Million folded before Flop (didn't bet)
Seat 5: tab1988242 folded before Flop (didn't bet)
Seat 6: bedniereba (button) showed [3s 3h] and won ($4.69) with a pair of Threes



PokerStars Hand #222973752674:  Hold'em No Limit ($0.05/$0.10 USD) - 2021/01/23 16:59:30 ET
Table 'Malzovia' 6-max Seat #1 is the button
Seat 1: Lucky HoBBiT ($10.25 in chips) 
Seat 3: mario0887 ($9.93 in chips) 
Seat 4: Just_Million ($10.46 in chips) 
Seat 5: tab1988242 ($37.66 in chips) 
Seat 6: bedniereba ($8.25 in chips) 
mario0887: posts small blind $0.05
Just_Million: posts big blind $0.10
*** HOLE CARDS ***
tab1988242: raises $0.20 to $0.30
bedniereba: folds 
Lucky HoBBiT: folds 
mario0887: calls $0.25
Just_Million: folds 
*** FLOP *** [8h 2h Jh]
mario0887: checks 
tab1988242: checks 
*** TURN *** [8h 2h Jh] [7d]
mario0887: bets $0.22
tab1988242: raises $0.33 to $0.55
mario0887: folds 
Uncalled bet ($0.33) returned to tab1988242
tab1988242 collected $1.09 from pot
tab1988242: doesn't show hand 
*** SUMMARY ***
Total pot $1.14 | Rake $0.05 
Board [8h 2h Jh 7d]
Seat 1: Lucky HoBBiT (button) folded before Flop (didn't bet)
Seat 3: mario0887 (small blind) folded on the Turn
Seat 4: Just_Million (big blind) folded before Flop
Seat 5: tab1988242 collected ($1.09)
Seat 6: bedniereba folded before Flop (didn't bet)



PokerStars Hand #222973772047:  Hold'em No Limit ($0.05/$0.10 USD) - 2021/01/23 17:00:03 ET
Table 'Malzovia' 6-max Seat #3 is the button
Seat 1: Lucky HoBBiT ($10.25 in chips) 
Seat 3: mario0887 ($9.41 in chips) 
Seat 4: Just_Million ($10.36 in chips) 
Seat 5: tab1988242 ($38.23 in chips) 
Seat 6: bedniereba ($8.25 in chips) 
Just_Million: posts small blind $0.05
tab1988242: posts big blind $0.10
NikosVeniz: sits out 
*** HOLE CARDS ***
bedniereba has timed out
bedniereba: folds 
Lucky HoBBiT: folds 
mario0887: raises $0.15 to $0.25
Just_Million: folds 
tab1988242: folds 
Uncalled bet ($0.15) returned to mario0887
mario0887 collected $0.25 from pot
mario0887: doesn't show hand 
*** SUMMARY ***
Total pot $0.25 | Rake $0 
Seat 1: Lucky HoBBiT folded before Flop (didn't bet)
Seat 3: mario0887 (button) collected ($0.25)
Seat 4: Just_Million (small blind) folded before Flop
Seat 5: tab1988242 (big blind) folded before Flop
Seat 6: bedniereba folded before Flop (didn't bet)



PokerStars Hand #222973782215:  Hold'em No Limit ($0.05/$0.10 USD) - 2021/01/23 17:00:19 ET
Table 'Malzovia' 6-max Seat #4 is the button
Seat 1: Lucky HoBBiT ($10.25 in chips) 
Seat 2: NikosVeniz ($14.18 in chips) 
Seat 3: mario0887 ($10 in chips) 
Seat 4: Just_Million ($10.31 in chips) 
Seat 5: tab1988242 ($38.13 in chips) 
Seat 6: bedniereba ($8.25 in chips) 
tab1988242: posts small blind $0.05
bedniereba: posts big blind $0.10
NikosVeniz: posts small & big blinds $0.15
*** HOLE CARDS ***
Lucky HoBBiT: raises $0.35 to $0.45
NikosVeniz: calls $0.35
mario0887: folds 
mario0887 leaves the table
Just_Million: folds 
tab1988242: folds 
bedniereba: calls $0.35
*** FLOP *** [9h Ac 8s]
bedniereba: checks 
Lucky HoBBiT: checks 
NikosVeniz: checks 
*** TURN *** [9h Ac 8s] [Ad]
bedniereba: bets $0.69
Lucky HoBBiT: folds 
NikosVeniz: folds 
Uncalled bet ($0.69) returned to bedniereba
bedniereba collected $1.38 from pot
bedniereba: doesn't show hand 
*** SUMMARY ***
Total pot $1.45 | Rake $0.07 
Board [9h Ac 8s Ad]
Seat 1: Lucky HoBBiT folded on the Turn
Seat 2: NikosVeniz folded on the Turn
Seat 3: mario0887 folded before Flop (didn't bet)
Seat 4: Just_Million (button) folded before Flop (didn't bet)
Seat 5: tab1988242 (small blind) folded before Flop
Seat 6: bedniereba (big blind) collected ($1.38)



PokerStars Hand #222973802963:  Hold'em No Limit ($0.05/$0.10 USD) - 2021/01/23 17:00:51 ET
Table 'Malzovia' 6-max Seat #5 is the button
Seat 1: Lucky HoBBiT ($10 in chips) 
Seat 2: NikosVeniz ($13.68 in chips) 
Seat 4: Just_Million ($10.31 in chips) 
Seat 5: tab1988242 ($38.08 in chips) 
Seat 6: bedniereba ($9.18 in chips) 
bedniereba: posts small blind $0.05
Lucky HoBBiT: posts big blind $0.10
*** HOLE CARDS ***
NikosVeniz: calls $0.10
Just_Million: calls $0.10
tab1988242: folds 
bin600implus joins the table at seat #3 
bedniereba: calls $0.05
Lucky HoBBiT: checks 
*** FLOP *** [Kc 6h 9c]
bedniereba: bets $0.19
Lucky HoBBiT: folds 
NikosVeniz: calls $0.19
Just_Million: raises $1.01 to $1.20
bedniereba: folds 
NikosVeniz: calls $1.01
*** TURN *** [Kc 6h 9c] [7d]
NikosVeniz: checks 
Just_Million: checks 
*** RIVER *** [Kc 6h 9c 7d] [9h]
NikosVeniz: checks 
Just_Million: checks 
*** SHOW DOWN ***
NikosVeniz: shows [Jd Qc] (a pair of Nines)
Just_Million: shows [6c 4c] (two pair, Nines and Sixes)
Just_Million collected $2.86 from pot
*** SUMMARY ***
Total pot $2.99 | Rake $0.13 
Board [Kc 6h 9c 7d 9h]
Seat 1: Lucky HoBBiT (big blind) folded on the Flop
Seat 2: NikosVeniz showed [Jd Qc] and lost with a pair of Nines
Seat 4: Just_Million showed [6c 4c] and won ($2.86) with two pair, Nines and Sixes
Seat 5: tab1988242 (button) folded before Flop (didn't bet)
Seat 6: bedniereba (small blind) folded on the Flop



PokerStars Hand #222973852184:  Hold'em No Limit ($0.05/$0.10 USD) - 2021/01/23 17:01:55 ET
Table 'Malzovia' 6-max Seat #6 is the button
Seat 1: Lucky HoBBiT ($10 in chips) 
Seat 2: NikosVeniz ($12.38 in chips) 
Seat 4: Just_Million ($11.87 in chips) 
Seat 5: tab1988242 ($38.08 in chips) 
Seat 6: bedniereba ($8.89 in chips) 
Lucky HoBBiT: posts small blind $0.05
NikosVeniz: posts big blind $0.10
bin600implus: sits out 
*** HOLE CARDS ***
Just_Million: folds 
tab1988242: folds 
bedniereba: folds 
Lucky HoBBiT: raises $0.20 to $0.30
NikosVeniz: calls $0.20
*** FLOP *** [5c Ah 7s]
Lucky HoBBiT: bets $0.39
NikosVeniz: folds 
Uncalled bet ($0.39) returned to Lucky HoBBiT
Lucky HoBBiT collected $0.57 from pot
Lucky HoBBiT: doesn't show hand 
*** SUMMARY ***
Total pot $0.60 | Rake $0.03 
Board [5c Ah 7s]
Seat 1: Lucky HoBBiT (small blind) collected ($0.57)
Seat 2: NikosVeniz (big blind) folded on the Flop
Seat 4: Just_Million folded before Flop (didn't bet)
Seat 5: tab1988242 folded before Flop (didn't bet)
Seat 6: bedniereba (button) folded before Flop (didn't bet)



PokerStars Hand #222973866569:  Hold'em No Limit ($0.05/$0.10 USD) - 2021/01/23 17:02:12 ET
Table 'Malzovia' 6-max Seat #1 is the button
Seat 1: Lucky HoBBiT ($10.27 in chips) 
Seat 2: NikosVeniz ($12.08 in chips) 
Seat 3: bin600implus ($10 in chips) 
Seat 4: Just_Million ($11.87 in chips) 
Seat 5: tab1988242 ($38.08 in chips) 
Seat 6: bedniereba ($8.89 in chips) 
NikosVeniz: posts small blind $0.05
bin600implus: posts big blind $0.10
*** HOLE CARDS ***
Just_Million: folds 
tab1988242: folds 
bedniereba: raises $0.20 to $0.30
Lucky HoBBiT: folds 
NikosVeniz: calls $0.25
bin600implus: folds 
*** FLOP *** [4h Ad Kc]
NikosVeniz: checks 
bedniereba: bets $0.33
NikosVeniz: folds 
Uncalled bet ($0.33) returned to bedniereba
bedniereba collected $0.67 from pot
bedniereba: doesn't show hand 
*** SUMMARY ***
Total pot $0.70 | Rake $0.03 
Board [4h Ad Kc]
Seat 1: Lucky HoBBiT (button) folded before Flop (didn't bet)
Seat 2: NikosVeniz (small blind) folded on the Flop
Seat 3: bin600implus (big blind) folded before Flop
Seat 4: Just_Million folded before Flop (didn't bet)
Seat 5: tab1988242 folded before Flop (didn't bet)
Seat 6: bedniereba collected ($0.67)



PokerStars Hand #222973882627:  Hold'em No Limit ($0.05/$0.10 USD) - 2021/01/23 17:02:32 ET
Table 'Malzovia' 6-max Seat #2 is the button
Seat 1: Lucky HoBBiT ($10.27 in chips) 
Seat 2: NikosVeniz ($11.78 in chips) 
Seat 3: bin600implus ($9.90 in chips) 
Seat 4: Just_Million ($11.87 in chips) 
Seat 5: tab1988242 ($38.08 in chips) 
Seat 6: bedniereba ($9.26 in chips) 
bin600implus: posts small blind $0.05
Just_Million: posts big blind $0.10
*** HOLE CARDS ***
tab1988242: folds 
bedniereba: folds 
Lucky HoBBiT: raises $0.15 to $0.25
NikosVeniz: calls $0.25
bin600implus: folds 
Just_Million: folds 
*** FLOP *** [Ah 2c 9c]
Lucky HoBBiT: checks 
NikosVeniz: checks 
*** TURN *** [Ah 2c 9c] [8c]
Lucky HoBBiT: bets $0.25
NikosVeniz: folds 
Uncalled bet ($0.25) returned to Lucky HoBBiT
Lucky HoBBiT collected $0.62 from pot
Lucky HoBBiT: doesn't show hand 
*** SUMMARY ***
Total pot $0.65 | Rake $0.03 
Board [Ah 2c 9c 8c]
Seat 1: Lucky HoBBiT collected ($0.62)
Seat 2: NikosVeniz (button) folded on the Turn
Seat 3: bin600implus (small blind) folded before Flop
Seat 4: Just_Million (big blind) folded before Flop
Seat 5: tab1988242 folded before Flop (didn't bet)
Seat 6: bedniereba folded before Flop (didn't bet)



PokerStars Hand #222973898959:  Hold'em No Limit ($0.05/$0.10 USD) - 2021/01/23 17:02:52 ET
Table 'Malzovia' 6-max Seat #3 is the button
Seat 1: Lucky HoBBiT ($10.64 in chips) 
Seat 2: NikosVeniz ($11.53 in chips) 
Seat 3: bin600implus ($9.85 in chips) 
Seat 4: Just_Million ($11.77 in chips) 
Seat 5: tab1988242 ($38.08 in chips) 
Seat 6: bedniereba ($9.26 in chips) 
Just_Million: posts small blind $0.05
tab1988242: posts big blind $0.10
*** HOLE CARDS ***
bedniereba: folds 
Lucky HoBBiT: folds 
NikosVeniz: raises $0.10 to $0.20
bin600implus: folds 
Just_Million: folds 
tab1988242: folds 
Uncalled bet ($0.10) returned to NikosVeniz
NikosVeniz collected $0.25 from pot
NikosVeniz: doesn't show hand 
*** SUMMARY ***
Total pot $0.25 | Rake $0 
Seat 1: Lucky HoBBiT folded before Flop (didn't bet)
Seat 2: NikosVeniz collected ($0.25)
Seat 3: bin600implus (button) folded before Flop (didn't bet)
Seat 4: Just_Million (small blind) folded before Flop
Seat 5: tab1988242 (big blind) folded before Flop
Seat 6: bedniereba folded before Flop (didn't bet)



PokerStars Hand #222973909922:  Hold'em No Limit ($0.05/$0.10 USD) - 2021/01/23 17:03:05 ET
Table 'Malzovia' 6-max Seat #4 is the button
Seat 1: Lucky HoBBiT ($10.64 in chips) 
Seat 2: NikosVeniz ($11.68 in chips) 
Seat 3: bin600implus ($9.85 in chips) 
Seat 4: Just_Million ($11.72 in chips) 
Seat 5: tab1988242 ($37.98 in chips) 
Seat 6: bedniereba ($9.26 in chips) 
tab1988242: posts small blind $0.05
bedniereba: posts big blind $0.10
*** HOLE CARDS ***
Lucky HoBBiT: folds 
NikosVeniz: folds 
bin600implus: raises $0.20 to $0.30
Just_Million: folds 
tab1988242: folds 
bedniereba: calls $0.20
*** FLOP *** [6h 2c Ad]
bedniereba: checks 
bin600implus: bets $0.31
bedniereba: calls $0.31
*** TURN *** [6h 2c Ad] [Tc]
bedniereba: checks 
bin600implus: bets $0.60
bedniereba: folds 
Uncalled bet ($0.60) returned to bin600implus
bin600implus collected $1.21 from pot
bin600implus: doesn't show hand 
*** SUMMARY ***
Total pot $1.27 | Rake $0.06 
Board [6h 2c Ad Tc]
Seat 1: Lucky HoBBiT folded before Flop (didn't bet)
Seat 2: NikosVeniz folded before Flop (didn't bet)
Seat 3: bin600implus collected ($1.21)
Seat 4: Just_Million (button) folded before Flop (didn't bet)
Seat 5: tab1988242 (small blind) folded before Flop
Seat 6: bedniereba (big blind) folded on the Turn



PokerStars Hand #222973941652:  Hold'em No Limit ($0.05/$0.10 USD) - 2021/01/23 17:03:42 ET
Table 'Malzovia' 6-max Seat #5 is the button
Seat 1: Lucky HoBBiT ($10.64 in chips) 
Seat 2: NikosVeniz ($11.68 in chips) 
Seat 3: bin600implus ($10.45 in chips) 
Seat 4: Just_Million ($11.72 in chips) 
Seat 5: tab1988242 ($37.93 in chips) 
Seat 6: bedniereba ($8.65 in chips) 
bedniereba: posts small blind $0.05
Lucky HoBBiT: posts big blind $0.10
*** HOLE CARDS ***
NikosVeniz: calls $0.10
bin600implus: calls $0.10
Just_Million: calls $0.10
tab1988242: folds 
bedniereba: calls $0.05
Lucky HoBBiT: checks 
*** FLOP *** [4d 2d Ad]
bedniereba: checks 
Lucky HoBBiT: checks 
NikosVeniz: checks 
bin600implus: bets $0.24
Just_Million: calls $0.24
bedniereba: folds 
Lucky HoBBiT: folds 
NikosVeniz: calls $0.24
*** TURN *** [4d 2d Ad] [7s]
NikosVeniz: checks 
bin600implus: checks 
Just_Million: bets $0.80
NikosVeniz: calls $0.80
tab1988242 leaves the table
bin600implus: folds 
*** RIVER *** [4d 2d Ad 7s] [Tc]
NikosVeniz: bets $1.34
aman kumar joins the table at seat #5 
Just_Million: folds 
Uncalled bet ($1.34) returned to NikosVeniz
NikosVeniz collected $2.69 from pot
NikosVeniz: doesn't show hand 
*** SUMMARY ***
Total pot $2.82 | Rake $0.13 
Board [4d 2d Ad 7s Tc]
Seat 1: Lucky HoBBiT (big blind) folded on the Flop
Seat 2: NikosVeniz collected ($2.69)
Seat 3: bin600implus folded on the Turn
Seat 4: Just_Million folded on the River
Seat 5: tab1988242 (button) folded before Flop (didn't bet)
Seat 6: bedniereba (small blind) folded on the Flop



PokerStars Hand #222974033305:  Hold'em No Limit ($0.05/$0.10 USD) - 2021/01/23 17:05:08 ET
Table 'Malzovia' 6-max Seat #6 is the button
Seat 1: Lucky HoBBiT ($10.54 in chips) 
Seat 2: NikosVeniz ($13.23 in chips) 
Seat 3: bin600implus ($10.11 in chips) 
Seat 4: Just_Million ($10.58 in chips) 
Seat 6: bedniereba ($8.55 in chips) 
Lucky HoBBiT: posts small blind $0.05
NikosVeniz: posts big blind $0.10
aman kumar: sits out 
*** HOLE CARDS ***
bin600implus: folds 
Just_Million: folds 
bedniereba: calls $0.10
Lucky HoBBiT: raises $0.35 to $0.45
NikosVeniz: folds 
bedniereba: calls $0.35
*** FLOP *** [7c 4h 9c]
Lucky HoBBiT: checks 
bedniereba: checks 
*** TURN *** [7c 4h 9c] [Td]
Lucky HoBBiT: checks 
bedniereba: checks 
*** RIVER *** [7c 4h 9c Td] [4c]
Lucky HoBBiT: checks 
bedniereba: checks 
*** SHOW DOWN ***
Lucky HoBBiT: shows [As 4s] (three of a kind, Fours)
bedniereba: mucks hand 
Lucky HoBBiT collected $0.96 from pot
*** SUMMARY ***
Total pot $1 | Rake $0.04 
Board [7c 4h 9c Td 4c]
Seat 1: Lucky HoBBiT (small blind) showed [As 4s] and won ($0.96) with three of a kind, Fours
Seat 2: NikosVeniz (big blind) folded before Flop
Seat 3: bin600implus folded before Flop (didn't bet)
Seat 4: Just_Million folded before Flop (didn't bet)
Seat 6: bedniereba (button) mucked



PokerStars Hand #222974056864:  Hold'em No Limit ($0.05/$0.10 USD) - 2021/01/23 17:05:36 ET
Table 'Malzovia' 6-max Seat #1 is the button
Seat 1: Lucky HoBBiT ($11.05 in chips) 
Seat 2: NikosVeniz ($13.13 in chips) 
Seat 3: bin600implus ($10.11 in chips) 
Seat 4: Just_Million ($10.58 in chips) 
Seat 6: bedniereba ($8.10 in chips) 
NikosVeniz: posts small blind $0.05
bin600implus: posts big blind $0.10
aman kumar: sits out 
*** HOLE CARDS ***
Just_Million: folds 
bedniereba: calls $0.10
Lucky HoBBiT: folds 
NikosVeniz: calls $0.05
bin600implus: raises $0.30 to $0.40
bedniereba: calls $0.30
NikosVeniz: calls $0.30
*** FLOP *** [2h 9h 8h]
NikosVeniz: checks 
bin600implus: checks 
bedniereba: bets $0.57
NikosVeniz: folds 
bin600implus: calls $0.57
*** TURN *** [2h 9h 8h] [9d]
bin600implus: checks 
bedniereba: bets $0.70
bin600implus: calls $0.70
*** RIVER *** [2h 9h 8h 9d] [Tc]
bin600implus: checks 
bedniereba: checks 
*** SHOW DOWN ***
bin600implus: shows [Ad Kd] (a pair of Nines)
bedniereba: shows [Qh 9s] (three of a kind, Nines)
bedniereba collected $3.57 from pot
*** SUMMARY ***
Total pot $3.74 | Rake $0.17 
Board [2h 9h 8h 9d Tc]
Seat 1: Lucky HoBBiT (button) folded before Flop (didn't bet)
Seat 2: NikosVeniz (small blind) folded on the Flop
Seat 3: bin600implus (big blind) showed [Ad Kd] and lost with a pair of Nines
Seat 4: Just_Million folded before Flop (didn't bet)
Seat 6: bedniereba showed [Qh 9s] and won ($3.57) with three of a kind, Nines



PokerStars Hand #222974100164:  Hold'em No Limit ($0.05/$0.10 USD) - 2021/01/23 17:06:28 ET
Table 'Malzovia' 6-max Seat #2 is the button
Seat 1: Lucky HoBBiT ($11.05 in chips) 
Seat 2: NikosVeniz ($12.73 in chips) 
Seat 3: bin600implus ($8.44 in chips) 
Seat 4: Just_Million ($10.58 in chips) 
Seat 6: bedniereba ($10 in chips) 
bin600implus: posts small blind $0.05
Just_Million: posts big blind $0.10
aman kumar: sits out 
*** HOLE CARDS ***
bedniereba: raises $0.20 to $0.30
Lucky HoBBiT: folds 
NikosVeniz: calls $0.30
bin600implus: folds 
Just_Million: calls $0.20
*** FLOP *** [3s Th Qd]
Just_Million: checks 
bedniereba: checks 
NikosVeniz: checks 
*** TURN *** [3s Th Qd] [9d]
Just_Million: bets $0.65
bedniereba: calls $0.65
NikosVeniz: folds 
*** RIVER *** [3s Th Qd 9d] [Ac]
Just_Million: checks 
bedniereba: bets $0.77
Just_Million: calls $0.77
*** SHOW DOWN ***
bedniereba: shows [Ad 8d] (a pair of Aces)
Just_Million: mucks hand 
bedniereba collected $3.62 from pot
*** SUMMARY ***
Total pot $3.79 | Rake $0.17 
Board [3s Th Qd 9d Ac]
Seat 1: Lucky HoBBiT folded before Flop (didn't bet)
Seat 2: NikosVeniz (button) folded on the Turn
Seat 3: bin600implus (small blind) folded before Flop
Seat 4: Just_Million (big blind) mucked
Seat 6: bedniereba showed [Ad 8d] and won ($3.62) with a pair of Aces



PokerStars Hand #222974159479:  Hold'em No Limit ($0.05/$0.10 USD) - 2021/01/23 17:07:39 ET
Table 'Malzovia' 6-max Seat #3 is the button
Seat 1: Lucky HoBBiT ($11.05 in chips) 
Seat 2: NikosVeniz ($12.43 in chips) 
Seat 3: bin600implus ($8.39 in chips) 
Seat 4: Just_Million ($10 in chips) 
Seat 5: aman kumar ($10 in chips) 
Seat 6: bedniereba ($11.90 in chips) 
Just_Million: posts small blind $0.05
aman kumar: posts big blind $0.10
*** HOLE CARDS ***
bedniereba: raises $0.20 to $0.30
Lucky HoBBiT: folds 
NikosVeniz: folds 
bin600implus: raises $0.60 to $0.90
Just_Million: folds 
aman kumar: folds 
bedniereba: calls $0.60
*** FLOP *** [9s 7d Ks]
bedniereba: checks 
bin600implus: bets $1.03
bedniereba: calls $1.03
*** TURN *** [9s 7d Ks] [9c]
bedniereba: checks 
bin600implus: bets $1.91
bedniereba: calls $1.91
*** RIVER *** [9s 7d Ks 9c] [6c]
bedniereba: checks 
bin600implus: bets $4.55 and is all-in
bedniereba: calls $4.55
*** SHOW DOWN ***
bin600implus: shows [As Ad] (two pair, Aces and Nines)
bedniereba: shows [Kh Tc] (two pair, Kings and Nines)
bin600implus collected $16.17 from pot
*** SUMMARY ***
Total pot $16.93 | Rake $0.76 
Board [9s 7d Ks 9c 6c]
Seat 1: Lucky HoBBiT folded before Flop (didn't bet)
Seat 2: NikosVeniz folded before Flop (didn't bet)
Seat 3: bin600implus (button) showed [As Ad] and won ($16.17) with two pair, Aces and Nines
Seat 4: Just_Million (small blind) folded before Flop
Seat 5: aman kumar (big blind) folded before Flop
Seat 6: bedniereba showed [Kh Tc] and lost with two pair, Kings and Nines



PokerStars Hand #222974207272:  Hold'em No Limit ($0.05/$0.10 USD) - 2021/01/23 17:08:37 ET
Table 'Malzovia' 6-max Seat #4 is the button
Seat 1: Lucky HoBBiT ($11.05 in chips) 
Seat 2: NikosVeniz ($12.43 in chips) 
Seat 3: bin600implus ($16.17 in chips) 
Seat 4: Just_Million ($10 in chips) 
Seat 5: aman kumar ($10 in chips) 
Seat 6: bedniereba ($3.51 in chips) 
aman kumar: posts small blind $0.05
bedniereba: posts big blind $0.10
*** HOLE CARDS ***
Lucky HoBBiT: folds 
NikosVeniz: calls $0.10
bin600implus: folds 
Just_Million: folds 
aman kumar: folds 
bedniereba: checks 
*** FLOP *** [Ks 9s Tc]
bedniereba: checks 
NikosVeniz: bets $0.12
bedniereba: folds 
Uncalled bet ($0.12) returned to NikosVeniz
NikosVeniz collected $0.24 from pot
NikosVeniz: doesn't show hand 
*** SUMMARY ***
Total pot $0.25 | Rake $0.01 
Board [Ks 9s Tc]
Seat 1: Lucky HoBBiT folded before Flop (didn't bet)
Seat 2: NikosVeniz collected ($0.24)
Seat 3: bin600implus folded before Flop (didn't bet)
Seat 4: Just_Million (button) folded before Flop (didn't bet)
Seat 5: aman kumar (small blind) folded before Flop
Seat 6: bedniereba (big blind) folded on the Flop



PokerStars Hand #222974225002:  Hold'em No Limit ($0.05/$0.10 USD) - 2021/01/23 17:08:58 ET
Table 'Malzovia' 6-max Seat #5 is the button
Seat 1: Lucky HoBBiT ($11.05 in chips) 
Seat 2: NikosVeniz ($12.57 in chips) 
Seat 3: bin600implus ($16.17 in chips) 
Seat 4: Just_Million ($10 in chips) 
Seat 5: aman kumar ($10 in chips) 
Seat 6: bedniereba ($3.41 in chips) 
bedniereba: posts small blind $0.05
Lucky HoBBiT: posts big blind $0.10
*** HOLE CARDS ***
NikosVeniz: calls $0.10
bin600implus: folds 
Just_Million: folds 
aman kumar: folds 
bedniereba: raises $0.30 to $0.40
Lucky HoBBiT: folds 
NikosVeniz: calls $0.30
*** FLOP *** [Js Qc 7s]
bedniereba: bets $0.43
NikosVeniz: folds 
Uncalled bet ($0.43) returned to bedniereba
bedniereba collected $0.86 from pot
bedniereba: doesn't show hand 
*** SUMMARY ***
Total pot $0.90 | Rake $0.04 
Board [Js Qc 7s]
Seat 1: Lucky HoBBiT (big blind) folded before Flop
Seat 2: NikosVeniz folded on the Flop
Seat 3: bin600implus folded before Flop (didn't bet)
Seat 4: Just_Million folded before Flop (didn't bet)
Seat 5: aman kumar (button) folded before Flop (didn't bet)
Seat 6: bedniereba (small blind) collected ($0.86)



PokerStars Hand #222974250248:  Hold'em No Limit ($0.05/$0.10 USD) - 2021/01/23 17:09:29 ET
Table 'Malzovia' 6-max Seat #6 is the button
Seat 1: Lucky HoBBiT ($10.95 in chips) 
Seat 2: NikosVeniz ($12.17 in chips) 
Seat 3: bin600implus ($16.17 in chips) 
Seat 4: Just_Million ($10 in chips) 
Seat 5: aman kumar ($10 in chips) 
Seat 6: bedniereba ($3.87 in chips) 
Lucky HoBBiT: posts small blind $0.05
NikosVeniz: posts big blind $0.10
*** HOLE CARDS ***
bin600implus: folds 
Just_Million: folds 
aman kumar: folds 
bedniereba: raises $0.20 to $0.30
Lucky HoBBiT: folds 
NikosVeniz: calls $0.20
*** FLOP *** [Ad 3d 6d]
NikosVeniz: checks 
bedniereba: checks 
*** TURN *** [Ad 3d 6d] [Kh]
NikosVeniz: checks 
bedniereba: bets $0.30
NikosVeniz: calls $0.30
*** RIVER *** [Ad 3d 6d Kh] [Kd]
NikosVeniz: checks 
bedniereba: bets $1.49
NikosVeniz: folds 
Uncalled bet ($1.49) returned to bedniereba
bedniereba collected $1.19 from pot
bedniereba: doesn't show hand 
*** SUMMARY ***
Total pot $1.25 | Rake $0.06 
Board [Ad 3d 6d Kh Kd]
Seat 1: Lucky HoBBiT (small blind) folded before Flop
Seat 2: NikosVeniz (big blind) folded on the River
Seat 3: bin600implus folded before Flop (didn't bet)
Seat 4: Just_Million folded before Flop (didn't bet)
Seat 5: aman kumar folded before Flop (didn't bet)
Seat 6: bedniereba (button) collected ($1.19)



PokerStars Hand #222974285980:  Hold'em No Limit ($0.05/$0.10 USD) - 2021/01/23 17:10:12 ET
Table 'Malzovia' 6-max Seat #1 is the button
Seat 1: Lucky HoBBiT ($10.90 in chips) 
Seat 2: NikosVeniz ($11.57 in chips) 
Seat 3: bin600implus ($16.17 in chips) 
Seat 4: Just_Million ($10 in chips) 
Seat 5: aman kumar ($10 in chips) 
Seat 6: bedniereba ($4.46 in chips) 
NikosVeniz: posts small blind $0.05
bin600implus: posts big blind $0.10
*** HOLE CARDS ***
Just_Million: folds 
aman kumar: raises $0.10 to $0.20
bedniereba: calls $0.20
Lucky HoBBiT: folds 
NikosVeniz: calls $0.15
bin600implus: calls $0.10
*** FLOP *** [4c Th Qc]
NikosVeniz: checks 
bin600implus: checks 
aman kumar: bets $0.50
bedniereba: folds 
NikosVeniz: folds 
bin600implus: calls $0.50
*** TURN *** [4c Th Qc] [6h]
bin600implus: checks 
aman kumar: checks 
*** RIVER *** [4c Th Qc 6h] [5c]
bin600implus: checks 
aman kumar: bets $1.10
bin600implus: folds 
Uncalled bet ($1.10) returned to aman kumar
aman kumar collected $1.72 from pot
aman kumar: doesn't show hand 
*** SUMMARY ***
Total pot $1.80 | Rake $0.08 
Board [4c Th Qc 6h 5c]
Seat 1: Lucky HoBBiT (button) folded before Flop (didn't bet)
Seat 2: NikosVeniz (small blind) folded on the Flop
Seat 3: bin600implus (big blind) folded on the River
Seat 4: Just_Million folded before Flop (didn't bet)
Seat 5: aman kumar collected ($1.72)
Seat 6: bedniereba folded on the Flop



PokerStars Hand #222974325866:  Hold'em No Limit ($0.05/$0.10 USD) - 2021/01/23 17:11:00 ET
Table 'Malzovia' 6-max Seat #2 is the button
Seat 1: Lucky HoBBiT ($10.90 in chips) 
Seat 2: NikosVeniz ($11.37 in chips) 
Seat 3: bin600implus ($15.47 in chips) 
Seat 4: Just_Million ($10 in chips) 
Seat 5: aman kumar ($11.02 in chips) 
Seat 6: bedniereba ($4.26 in chips) 
bin600implus: posts small blind $0.05
Just_Million: posts big blind $0.10
*** HOLE CARDS ***
aman kumar: folds 
bedniereba: calls $0.10
Lucky HoBBiT: folds 
NikosVeniz: raises $0.10 to $0.20
bin600implus: calls $0.15
Just_Million: folds 
bedniereba: calls $0.10
*** FLOP *** [7d 8h Jd]
bin600implus: checks 
bedniereba: checks 
NikosVeniz: bets $0.10
bin600implus: calls $0.10
bedniereba: calls $0.10
*** TURN *** [7d 8h Jd] [8c]
bin600implus: checks 
bedniereba: checks 
NikosVeniz: checks 
*** RIVER *** [7d 8h Jd 8c] [Qd]
bin600implus: checks 
bedniereba: checks 
NikosVeniz: checks 
*** SHOW DOWN ***
bin600implus: shows [3d 2d] (a flush, Queen high)
bedniereba: mucks hand 
NikosVeniz: mucks hand 
bin600implus collected $0.96 from pot
*** SUMMARY ***
Total pot $1 | Rake $0.04 
Board [7d 8h Jd 8c Qd]
Seat 1: Lucky HoBBiT folded before Flop (didn't bet)
Seat 2: NikosVeniz (button) mucked
Seat 3: bin600implus (small blind) showed [3d 2d] and won ($0.96) with a flush, Queen high
Seat 4: Just_Million (big blind) folded before Flop
Seat 5: aman kumar folded before Flop (didn't bet)
Seat 6: bedniereba mucked



PokerStars Hand #222974365642:  Hold'em No Limit ($0.05/$0.10 USD) - 2021/01/23 17:11:48 ET
Table 'Malzovia' 6-max Seat #3 is the button
Seat 1: Lucky HoBBiT ($10.90 in chips) 
Seat 2: NikosVeniz ($11.07 in chips) 
Seat 3: bin600implus ($16.13 in chips) 
Seat 4: Just_Million ($10 in chips) 
Seat 5: aman kumar ($11.02 in chips) 
Seat 6: bedniereba ($3.96 in chips) 
Just_Million: posts small blind $0.05
aman kumar: posts big blind $0.10
*** HOLE CARDS ***
bedniereba: calls $0.10
Lucky HoBBiT: folds 
NikosVeniz: raises $0.10 to $0.20
bin600implus: folds 
Just_Million: folds 
aman kumar: folds 
bedniereba: calls $0.10
*** FLOP *** [6h 6c Ad]
bedniereba: checks 
NikosVeniz: checks 
*** TURN *** [6h 6c Ad] [2d]
bedniereba: bets $0.26
NikosVeniz: calls $0.26
*** RIVER *** [6h 6c Ad 2d] [Qc]
bedniereba: checks 
NikosVeniz: checks 
*** SHOW DOWN ***
bedniereba: shows [Kh 7s] (a pair of Sixes)
NikosVeniz: mucks hand 
bedniereba collected $1.02 from pot
*** SUMMARY ***
Total pot $1.07 | Rake $0.05 
Board [6h 6c Ad 2d Qc]
Seat 1: Lucky HoBBiT folded before Flop (didn't bet)
Seat 2: NikosVeniz mucked
Seat 3: bin600implus (button) folded before Flop (didn't bet)
Seat 4: Just_Million (small blind) folded before Flop
Seat 5: aman kumar (big blind) folded before Flop
Seat 6: bedniereba showed [Kh 7s] and won ($1.02) with a pair of Sixes



PokerStars Hand #222974408418:  Hold'em No Limit ($0.05/$0.10 USD) - 2021/01/23 17:12:39 ET
Table 'Malzovia' 6-max Seat #4 is the button
Seat 1: Lucky HoBBiT ($10.90 in chips) 
Seat 2: NikosVeniz ($10.61 in chips) 
Seat 3: bin600implus ($16.13 in chips) 
Seat 4: Just_Million ($10 in chips) 
Seat 5: aman kumar ($10.92 in chips) 
Seat 6: bedniereba ($4.52 in chips) 
aman kumar: posts small blind $0.05
bedniereba: posts big blind $0.10
*** HOLE CARDS ***
Lucky HoBBiT: folds 
NikosVeniz: calls $0.10
bin600implus: calls $0.10
Just_Million: folds 
aman kumar: folds 
bedniereba: checks 
*** FLOP *** [9d Qh 5d]
bedniereba: bets $0.33
NikosVeniz: raises $0.33 to $0.66
bin600implus: calls $0.66
bedniereba: calls $0.33
*** TURN *** [9d Qh 5d] [2d]
bedniereba: checks 
NikosVeniz: bets $0.10
bin600implus: raises $1.22 to $1.32
bedniereba: calls $1.32
NikosVeniz: calls $1.22
*** RIVER *** [9d Qh 5d 2d] [6h]
bedniereba: checks 
NikosVeniz: checks 
bin600implus: bets $3
bedniereba: folds 
NikosVeniz: calls $3
*** SHOW DOWN ***
bin600implus: shows [7d Ad] (a flush, Ace high)
NikosVeniz: mucks hand 
bin600implus collected $11.74 from pot
*** SUMMARY ***
Total pot $12.29 | Rake $0.55 
Board [9d Qh 5d 2d 6h]
Seat 1: Lucky HoBBiT folded before Flop (didn't bet)
Seat 2: NikosVeniz mucked
Seat 3: bin600implus showed [7d Ad] and won ($11.74) with a flush, Ace high
Seat 4: Just_Million (button) folded before Flop (didn't bet)
Seat 5: aman kumar (small blind) folded before Flop
Seat 6: bedniereba (big blind) folded on the River



PokerStars Hand #222974470947:  Hold'em No Limit ($0.05/$0.10 USD) - 2021/01/23 17:13:56 ET
Table 'Malzovia' 6-max Seat #5 is the button
Seat 1: Lucky HoBBiT ($10.90 in chips) 
Seat 2: NikosVeniz ($5.53 in chips) 
Seat 3: bin600implus ($22.79 in chips) 
Seat 4: Just_Million ($10 in chips) 
Seat 5: aman kumar ($10.87 in chips) 
Seat 6: bedniereba ($2.44 in chips) 
bedniereba: posts small blind $0.05
Lucky HoBBiT: posts big blind $0.10
*** HOLE CARDS ***
NikosVeniz: calls $0.10
bin600implus: raises $0.30 to $0.40
Just_Million: folds 
aman kumar: folds 
bedniereba: folds 
Lucky HoBBiT: folds 
NikosVeniz: raises $0.30 to $0.70
bin600implus: raises $1.30 to $2
NikosVeniz: raises $1.30 to $3.30
bin600implus: raises $19.49 to $22.79 and is all-in
NikosVeniz: calls $2.23 and is all-in
Uncalled bet ($17.26) returned to bin600implus
*** FLOP *** [Ac Qc Ad]
*** TURN *** [Ac Qc Ad] [Jc]
*** RIVER *** [Ac Qc Ad Jc] [9c]
*** SHOW DOWN ***
NikosVeniz: shows [Ah Qd] (a full house, Aces full of Queens)
bin600implus: shows [Qh Qs] (a full house, Queens full of Aces)
NikosVeniz collected $10.71 from pot
bin600implus cashed out the hand for $7.38 | Cash Out Fee $0.07
*** SUMMARY ***
Total pot $11.21 | Rake $0.50 
Board [Ac Qc Ad Jc 9c]
Seat 1: Lucky HoBBiT (big blind) folded before Flop
Seat 2: NikosVeniz showed [Ah Qd] and won ($10.71) with a full house, Aces full of Queens
Seat 3: bin600implus showed [Qh Qs] and lost with a full house, Queens full of Aces (cashed out).
Seat 4: Just_Million folded before Flop (didn't bet)
Seat 5: aman kumar (button) folded before Flop (didn't bet)
Seat 6: bedniereba (small blind) folded before Flop



PokerStars Hand #222974527218:  Hold'em No Limit ($0.05/$0.10 USD) - 2021/01/23 17:15:04 ET
Table 'Malzovia' 6-max Seat #6 is the button
Seat 1: Lucky HoBBiT ($10.80 in chips) 
Seat 2: NikosVeniz ($10.71 in chips) 
Seat 3: bin600implus ($24.64 in chips) 
Seat 4: Just_Million ($10 in chips) 
Seat 5: aman kumar ($10.87 in chips) 
Seat 6: bedniereba ($2.39 in chips) 
Lucky HoBBiT: posts small blind $0.05
NikosVeniz: posts big blind $0.10
*** HOLE CARDS ***
bin600implus: folds 
Just_Million: folds 
aman kumar: raises $0.10 to $0.20
bedniereba: folds 
Lucky HoBBiT: folds 
NikosVeniz: calls $0.10
*** FLOP *** [3d 5s 3c]
NikosVeniz: bets $0.10
aman kumar: raises $0.30 to $0.40
NikosVeniz: raises $0.30 to $0.70
aman kumar: calls $0.30
*** TURN *** [3d 5s 3c] [2c]
NikosVeniz: checks 
aman kumar: checks 
*** RIVER *** [3d 5s 3c 2c] [Kc]
NikosVeniz: bets $2.57
aman kumar: raises $7.40 to $9.97 and is all-in
NikosVeniz: calls $7.24 and is all-in
Uncalled bet ($0.16) returned to aman kumar
*** SHOW DOWN ***
aman kumar: shows [Kd Ks] (a full house, Kings full of Threes)
NikosVeniz: shows [2s 3s] (a full house, Threes full of Deuces)
aman kumar collected $20.50 from pot
*** SUMMARY ***
Total pot $21.47 | Rake $0.97 
Board [3d 5s 3c 2c Kc]
Seat 1: Lucky HoBBiT (small blind) folded before Flop
Seat 2: NikosVeniz (big blind) showed [2s 3s] and lost with a full house, Threes full of Deuces
Seat 3: bin600implus folded before Flop (didn't bet)
Seat 4: Just_Million folded before Flop (didn't bet)
Seat 5: aman kumar showed [Kd Ks] and won ($20.50) with a full house, Kings full of Threes
Seat 6: bedniereba (button) folded before Flop (didn't bet)



PokerStars Hand #222974585637:  Hold'em No Limit ($0.05/$0.10 USD) - 2021/01/23 17:16:15 ET
Table 'Malzovia' 6-max Seat #1 is the button
Seat 1: Lucky HoBBiT ($10.75 in chips) 
Seat 3: bin600implus ($24.64 in chips) 
Seat 4: Just_Million ($10 in chips) 
Seat 5: aman kumar ($20.66 in chips) 
Seat 6: bedniereba ($2.39 in chips) 
bin600implus: posts small blind $0.05
Just_Million: posts big blind $0.10
*** HOLE CARDS ***
aman kumar: folds 
bedniereba: calls $0.10
Lucky HoBBiT: folds 
bin600implus: folds 
Just_Million: checks 
*** FLOP *** [Jh 8s 3c]
Just_Million: checks 
bedniereba: bets $0.10
Just_Million: folds 
Uncalled bet ($0.10) returned to bedniereba
bedniereba collected $0.24 from pot
bedniereba: doesn't show hand 
*** SUMMARY ***
Total pot $0.25 | Rake $0.01 
Board [Jh 8s 3c]
Seat 1: Lucky HoBBiT (button) folded before Flop (didn't bet)
Seat 3: bin600implus (small blind) folded before Flop
Seat 4: Just_Million (big blind) folded on the Flop
Seat 5: aman kumar folded before Flop (didn't bet)
Seat 6: bedniereba collected ($0.24)



PokerStars Hand #222974604814:  Hold'em No Limit ($0.05/$0.10 USD) - 2021/01/23 17:16:38 ET
Table 'Malzovia' 6-max Seat #3 is the button
Seat 1: Lucky HoBBiT ($10.75 in chips) 
Seat 2: NikosVeniz ($10 in chips) 
Seat 3: bin600implus ($24.59 in chips) 
Seat 4: Just_Million ($10 in chips) 
Seat 5: aman kumar ($20.66 in chips) 
Seat 6: bedniereba ($2.53 in chips) 
Just_Million: posts small blind $0.05
aman kumar: posts big blind $0.10
NikosVeniz: posts small blind $0.05
*** HOLE CARDS ***
bedniereba: folds 
Lucky HoBBiT: folds 
NikosVeniz: calls $0.10
bin600implus: folds 
Just_Million: calls $0.05
aman kumar: checks 
*** FLOP *** [3c Jd 6h]
Just_Million: checks 
aman kumar: checks 
NikosVeniz: checks 
*** TURN *** [3c Jd 6h] [Qs]
Just_Million: checks 
aman kumar: checks 
NikosVeniz: checks 
*** RIVER *** [3c Jd 6h Qs] [4d]
Just_Million: checks 
aman kumar: checks 
NikosVeniz: checks 
*** SHOW DOWN ***
Just_Million: shows [Kh 9s] (high card King)
aman kumar: shows [Ts Kc] (high card King - Queen+Jack+Ten kicker)
NikosVeniz: shows [9c Ad] (high card Ace)
NikosVeniz collected $0.33 from pot
*** SUMMARY ***
Total pot $0.35 | Rake $0.02 
Board [3c Jd 6h Qs 4d]
Seat 1: Lucky HoBBiT folded before Flop (didn't bet)
Seat 2: NikosVeniz showed [9c Ad] and won ($0.33) with high card Ace
Seat 3: bin600implus (button) folded before Flop (didn't bet)
Seat 4: Just_Million (small blind) showed [Kh 9s] and lost with high card King
Seat 5: aman kumar (big blind) showed [Ts Kc] and lost with high card King
Seat 6: bedniereba folded before Flop (didn't bet)



PokerStars Hand #222974640106:  Hold'em No Limit ($0.05/$0.10 USD) - 2021/01/23 17:17:21 ET
Table 'Malzovia' 6-max Seat #4 is the button
Seat 1: Lucky HoBBiT ($10.75 in chips) 
Seat 2: NikosVeniz ($10.18 in chips) 
Seat 3: bin600implus ($24.59 in chips) 
Seat 4: Just_Million ($10 in chips) 
Seat 5: aman kumar ($20.56 in chips) 
Seat 6: bedniereba ($2.53 in chips) 
aman kumar: posts small blind $0.05
bedniereba: posts big blind $0.10
*** HOLE CARDS ***
Lucky HoBBiT: folds 
NikosVeniz: folds 
bin600implus: folds 
Just_Million: folds 
aman kumar: raises $0.20 to $0.30
bedniereba: calls $0.20
*** FLOP *** [Qd 4s Td]
aman kumar: checks 
bedniereba: checks 
*** TURN *** [Qd 4s Td] [2c]
aman kumar: bets $0.30
bedniereba: folds 
Uncalled bet ($0.30) returned to aman kumar
aman kumar collected $0.57 from pot
aman kumar: doesn't show hand 
*** SUMMARY ***
Total pot $0.60 | Rake $0.03 
Board [Qd 4s Td 2c]
Seat 1: Lucky HoBBiT folded before Flop (didn't bet)
Seat 2: NikosVeniz folded before Flop (didn't bet)
Seat 3: bin600implus folded before Flop (didn't bet)
Seat 4: Just_Million (button) folded before Flop (didn't bet)
Seat 5: aman kumar (small blind) collected ($0.57)
Seat 6: bedniereba (big blind) folded on the Turn



PokerStars Hand #222974662175:  Hold'em No Limit ($0.05/$0.10 USD) - 2021/01/23 17:17:47 ET
Table 'Malzovia' 6-max Seat #5 is the button
Seat 1: Lucky HoBBiT ($10.75 in chips) 
Seat 2: NikosVeniz ($10.18 in chips) 
Seat 3: bin600implus ($24.59 in chips) 
Seat 4: Just_Million ($10 in chips) 
Seat 5: aman kumar ($20.83 in chips) 
Seat 6: bedniereba ($2.23 in chips) 
bedniereba: posts small blind $0.05
Lucky HoBBiT: posts big blind $0.10
*** HOLE CARDS ***
NikosVeniz: folds 
bin600implus: folds 
Just_Million: folds 
aman kumar: raises $0.15 to $0.25
bedniereba: calls $0.20
Lucky HoBBiT: calls $0.15
*** FLOP *** [8s 8c Tc]
bedniereba: checks 
Lucky HoBBiT: checks 
aman kumar: checks 
*** TURN *** [8s 8c Tc] [6s]
bedniereba: bets $0.36
Lucky HoBBiT: folds 
aman kumar: folds 
Uncalled bet ($0.36) returned to bedniereba
bedniereba collected $0.72 from pot
bedniereba: doesn't show hand 
*** SUMMARY ***
Total pot $0.75 | Rake $0.03 
Board [8s 8c Tc 6s]
Seat 1: Lucky HoBBiT (big blind) folded on the Turn
Seat 2: NikosVeniz folded before Flop (didn't bet)
Seat 3: bin600implus folded before Flop (didn't bet)
Seat 4: Just_Million folded before Flop (didn't bet)
Seat 5: aman kumar (button) folded on the Turn
Seat 6: bedniereba (small blind) collected ($0.72)



PokerStars Hand #222974691227:  Hold'em No Limit ($0.05/$0.10 USD) - 2021/01/23 17:18:23 ET
Table 'Malzovia' 6-max Seat #6 is the button
Seat 1: Lucky HoBBiT ($10.50 in chips) 
Seat 2: NikosVeniz ($10.18 in chips) 
Seat 3: bin600implus ($24.59 in chips) 
Seat 4: Just_Million ($10 in chips) 
Seat 5: aman kumar ($20.58 in chips) 
Seat 6: bedniereba ($2.70 in chips) 
Lucky HoBBiT: posts small blind $0.05
NikosVeniz: posts big blind $0.10
*** HOLE CARDS ***
bin600implus: folds 
Just_Million: folds 
aman kumar: raises $0.10 to $0.20
bedniereba: calls $0.20
Lucky HoBBiT: raises $0.85 to $1.05
NikosVeniz: folds 
aman kumar: folds 
bedniereba: folds 
Uncalled bet ($0.85) returned to Lucky HoBBiT
Lucky HoBBiT collected $0.70 from pot
Lucky HoBBiT: doesn't show hand 
*** SUMMARY ***
Total pot $0.70 | Rake $0 
Seat 1: Lucky HoBBiT (small blind) collected ($0.70)
Seat 2: NikosVeniz (big blind) folded before Flop
Seat 3: bin600implus folded before Flop (didn't bet)
Seat 4: Just_Million folded before Flop (didn't bet)
Seat 5: aman kumar folded before Flop
Seat 6: bedniereba (button) folded before Flop



PokerStars Hand #222974712074:  Hold'em No Limit ($0.05/$0.10 USD) - 2021/01/23 17:18:48 ET
Table 'Malzovia' 6-max Seat #1 is the button
Seat 1: Lucky HoBBiT ($11 in chips) 
Seat 2: NikosVeniz ($10.08 in chips) 
Seat 3: bin600implus ($24.59 in chips) 
Seat 4: Just_Million ($10 in chips) 
Seat 5: aman kumar ($20.38 in chips) 
Seat 6: bedniereba ($2.50 in chips) 
NikosVeniz: posts small blind $0.05
bin600implus: posts big blind $0.10
*** HOLE CARDS ***
Just_Million: folds 
aman kumar: folds 
bedniereba: calls $0.10
Lucky HoBBiT: raises $0.35 to $0.45
NikosVeniz: folds 
bin600implus: folds 
bedniereba: calls $0.35
*** FLOP *** [8c Qh 8d]
bedniereba: checks 
Lucky HoBBiT: bets $0.85
bedniereba: folds 
Uncalled bet ($0.85) returned to Lucky HoBBiT
Lucky HoBBiT collected $1 from pot
Lucky HoBBiT: doesn't show hand 
*** SUMMARY ***
Total pot $1.05 | Rake $0.05 
Board [8c Qh 8d]
Seat 1: Lucky HoBBiT (button) collected ($1)
Seat 2: NikosVeniz (small blind) folded before Flop
Seat 3: bin600implus (big blind) folded before Flop
Seat 4: Just_Million folded before Flop (didn't bet)
Seat 5: aman kumar folded before Flop (didn't bet)
Seat 6: bedniereba folded on the Flop



PokerStars Hand #222974729637:  Hold'em No Limit ($0.05/$0.10 USD) - 2021/01/23 17:19:10 ET
Table 'Malzovia' 6-max Seat #2 is the button
Seat 1: Lucky HoBBiT ($11.55 in chips) 
Seat 2: NikosVeniz ($10.03 in chips) 
Seat 3: bin600implus ($24.49 in chips) 
Seat 4: Just_Million ($10 in chips) 
Seat 5: aman kumar ($20.38 in chips) 
Seat 6: bedniereba ($2.05 in chips) 
bin600implus: posts small blind $0.05
Just_Million: posts big blind $0.10
*** HOLE CARDS ***
aman kumar: folds 
bedniereba: folds 
Lucky HoBBiT: raises $0.15 to $0.25
NikosVeniz: raises $0.15 to $0.40
bin600implus: folds 
Just_Million: folds 
Lucky HoBBiT: calls $0.15
*** FLOP *** [6h Ks 5d]
Lucky HoBBiT: checks 
NikosVeniz: bets $0.25
Lucky HoBBiT: folds 
Uncalled bet ($0.25) returned to NikosVeniz
NikosVeniz collected $0.91 from pot
NikosVeniz: doesn't show hand 
*** SUMMARY ***
Total pot $0.95 | Rake $0.04 
Board [6h Ks 5d]
Seat 1: Lucky HoBBiT folded on the Flop
Seat 2: NikosVeniz (button) collected ($0.91)
Seat 3: bin600implus (small blind) folded before Flop
Seat 4: Just_Million (big blind) folded before Flop
Seat 5: aman kumar folded before Flop (didn't bet)
Seat 6: bedniereba folded before Flop (didn't bet)



PokerStars Hand #222974763044:  Hold'em No Limit ($0.05/$0.10 USD) - 2021/01/23 17:19:51 ET
Table 'Malzovia' 6-max Seat #3 is the button
Seat 1: Lucky HoBBiT ($11.15 in chips) 
Seat 2: NikosVeniz ($10.54 in chips) 
Seat 3: bin600implus ($24.44 in chips) 
Seat 4: Just_Million ($10 in chips) 
Seat 5: aman kumar ($20.38 in chips) 
Seat 6: bedniereba ($2.05 in chips) 
Just_Million: posts small blind $0.05
aman kumar: posts big blind $0.10
*** HOLE CARDS ***
bedniereba: folds 
Lucky HoBBiT: folds 
NikosVeniz: calls $0.10
bin600implus: folds 
Just_Million: calls $0.05
aman kumar: checks 
*** FLOP *** [8s 6h 9s]
Just_Million: checks 
aman kumar: checks 
NikosVeniz: checks 
*** TURN *** [8s 6h 9s] [Js]
Just_Million: checks 
aman kumar: checks 
NikosVeniz: checks 
*** RIVER *** [8s 6h 9s Js] [Ad]
Just_Million: checks 
aman kumar: checks 
NikosVeniz: checks 
*** SHOW DOWN ***
Just_Million: shows [Ts Kh] (high card Ace)
aman kumar: shows [8d 3h] (a pair of Eights)
NikosVeniz: mucks hand 
aman kumar collected $0.29 from pot
*** SUMMARY ***
Total pot $0.30 | Rake $0.01 
Board [8s 6h 9s Js Ad]
Seat 1: Lucky HoBBiT folded before Flop (didn't bet)
Seat 2: NikosVeniz mucked
Seat 3: bin600implus (button) folded before Flop (didn't bet)
Seat 4: Just_Million (small blind) showed [Ts Kh] and lost with high card Ace
Seat 5: aman kumar (big blind) showed [8d 3h] and won ($0.29) with a pair of Eights
Seat 6: bedniereba folded before Flop (didn't bet)



PokerStars Hand #222974797154:  Hold'em No Limit ($0.05/$0.10 USD) - 2021/01/23 17:20:33 ET
Table 'Malzovia' 6-max Seat #4 is the button
Seat 1: Lucky HoBBiT ($11.15 in chips) 
Seat 2: NikosVeniz ($10.44 in chips) 
Seat 3: bin600implus ($24.44 in chips) 
Seat 4: Just_Million ($10 in chips) 
Seat 5: aman kumar ($20.57 in chips) 
Seat 6: bedniereba ($2.05 in chips) 
aman kumar: posts small blind $0.05
bedniereba: posts big blind $0.10
*** HOLE CARDS ***
Lucky HoBBiT: folds 
NikosVeniz: calls $0.10
bin600implus: folds 
Just_Million: calls $0.10
aman kumar: folds 
bedniereba: checks 
*** FLOP *** [Th Tc 2s]
bedniereba: checks 
NikosVeniz: checks 
Just_Million: checks 
*** TURN *** [Th Tc 2s] [Qs]
bedniereba: checks 
NikosVeniz: checks 
Just_Million: bets $0.20
bedniereba: folds 
NikosVeniz: calls $0.20
*** RIVER *** [Th Tc 2s Qs] [8c]
NikosVeniz: checks 
Just_Million: bets $0.40
NikosVeniz: folds 
Uncalled bet ($0.40) returned to Just_Million
Just_Million collected $0.72 from pot
Just_Million: doesn't show hand 
*** SUMMARY ***
Total pot $0.75 | Rake $0.03 
Board [Th Tc 2s Qs 8c]
Seat 1: Lucky HoBBiT folded before Flop (didn't bet)
Seat 2: NikosVeniz folded on the River
Seat 3: bin600implus folded before Flop (didn't bet)
Seat 4: Just_Million (button) collected ($0.72)
Seat 5: aman kumar (small blind) folded before Flop
Seat 6: bedniereba (big blind) folded on the Turn



PokerStars Hand #222974845311:  Hold'em No Limit ($0.05/$0.10 USD) - 2021/01/23 17:21:32 ET
Table 'Malzovia' 6-max Seat #5 is the button
Seat 1: Lucky HoBBiT ($11.15 in chips) 
Seat 2: NikosVeniz ($10.14 in chips) 
Seat 3: bin600implus ($24.44 in chips) 
Seat 4: Just_Million ($10.42 in chips) 
Seat 5: aman kumar ($20.52 in chips) 
Seat 6: bedniereba ($1.95 in chips) 
bedniereba: posts small blind $0.05
Lucky HoBBiT: posts big blind $0.10
*** HOLE CARDS ***
NikosVeniz: calls $0.10
bin600implus: raises $0.20 to $0.30
Just_Million: folds 
aman kumar: folds 
bedniereba: folds 
Lucky HoBBiT: calls $0.20
NikosVeniz: calls $0.20
*** FLOP *** [5h Ah Jh]
Lucky HoBBiT: checks 
NikosVeniz: checks 
bin600implus: bets $0.45
Lucky HoBBiT: folds 
NikosVeniz: folds 
Uncalled bet ($0.45) returned to bin600implus
bin600implus collected $0.91 from pot
bin600implus: doesn't show hand 
*** SUMMARY ***
Total pot $0.95 | Rake $0.04 
Board [5h Ah Jh]
Seat 1: Lucky HoBBiT (big blind) folded on the Flop
Seat 2: NikosVeniz folded on the Flop
Seat 3: bin600implus collected ($0.91)
Seat 4: Just_Million folded before Flop (didn't bet)
Seat 5: aman kumar (button) folded before Flop (didn't bet)
Seat 6: bedniereba (small blind) folded before Flop



PokerStars Hand #222974872832:  Hold'em No Limit ($0.05/$0.10 USD) - 2021/01/23 17:22:06 ET
Table 'Malzovia' 6-max Seat #6 is the button
Seat 1: Lucky HoBBiT ($10.85 in chips) 
Seat 2: NikosVeniz ($9.84 in chips) 
Seat 3: bin600implus ($25.05 in chips) 
Seat 4: Just_Million ($10.42 in chips) 
Seat 5: aman kumar ($20.52 in chips) 
Seat 6: bedniereba ($1.90 in chips) 
Lucky HoBBiT: posts small blind $0.05
NikosVeniz: posts big blind $0.10
*** HOLE CARDS ***
bin600implus: folds 
Just_Million: folds 
aman kumar: raises $0.10 to $0.20
bedniereba: raises $0.30 to $0.50
Lucky HoBBiT: folds 
NikosVeniz: folds 
aman kumar: folds 
Uncalled bet ($0.30) returned to bedniereba
bedniereba collected $0.55 from pot
bedniereba: doesn't show hand 
*** SUMMARY ***
Total pot $0.55 | Rake $0 
Seat 1: Lucky HoBBiT (small blind) folded before Flop
Seat 2: NikosVeniz (big blind) folded before Flop
Seat 3: bin600implus folded before Flop (didn't bet)
Seat 4: Just_Million folded before Flop (didn't bet)
Seat 5: aman kumar folded before Flop
Seat 6: bedniereba (button) collected ($0.55)



PokerStars Hand #222974892956:  Hold'em No Limit ($0.05/$0.10 USD) - 2021/01/23 17:22:31 ET
Table 'Malzovia' 6-max Seat #1 is the button
Seat 1: Lucky HoBBiT ($10.80 in chips) 
Seat 2: NikosVeniz ($9.74 in chips) 
Seat 3: bin600implus ($25.05 in chips) 
Seat 4: Just_Million ($10.42 in chips) 
Seat 5: aman kumar ($20.32 in chips) 
Seat 6: bedniereba ($2.25 in chips) 
NikosVeniz: posts small blind $0.05
bin600implus: posts big blind $0.10
*** HOLE CARDS ***
Just_Million: folds 
aman kumar: raises $0.10 to $0.20
bedniereba: folds 
Lucky HoBBiT: folds 
NikosVeniz: calls $0.15
bin600implus: calls $0.10
*** FLOP *** [Ad 7s 2h]
NikosVeniz: bets $0.10
bin600implus: calls $0.10
aman kumar: folds 
*** TURN *** [Ad 7s 2h] [3s]
NikosVeniz: checks 
bin600implus: checks 
*** RIVER *** [Ad 7s 2h 3s] [Jh]
NikosVeniz: bets $0.10
bin600implus: calls $0.10
*** SHOW DOWN ***
NikosVeniz: shows [Ts Qs] (high card Ace)
bin600implus: shows [Th Tc] (a pair of Tens)
bin600implus collected $0.96 from pot
*** SUMMARY ***
Total pot $1 | Rake $0.04 
Board [Ad 7s 2h 3s Jh]
Seat 1: Lucky HoBBiT (button) folded before Flop (didn't bet)
Seat 2: NikosVeniz (small blind) showed [Ts Qs] and lost with high card Ace
Seat 3: bin600implus (big blind) showed [Th Tc] and won ($0.96) with a pair of Tens
Seat 4: Just_Million folded before Flop (didn't bet)
Seat 5: aman kumar folded on the Flop
Seat 6: bedniereba folded before Flop (didn't bet)



PokerStars Hand #222974924730:  Hold'em No Limit ($0.05/$0.10 USD) - 2021/01/23 17:23:10 ET
Table 'Malzovia' 6-max Seat #2 is the button
Seat 1: Lucky HoBBiT ($10.80 in chips) 
Seat 2: NikosVeniz ($9.34 in chips) 
Seat 3: bin600implus ($25.61 in chips) 
Seat 4: Just_Million ($10.42 in chips) 
Seat 5: aman kumar ($20.12 in chips) 
Seat 6: bedniereba ($2.25 in chips) 
bin600implus: posts small blind $0.05
Just_Million: posts big blind $0.10
*** HOLE CARDS ***
aman kumar: folds 
bedniereba: folds 
Lucky HoBBiT: folds 
NikosVeniz: calls $0.10
bin600implus: raises $0.10 to $0.20
Just_Million: folds 
NikosVeniz: calls $0.10
*** FLOP *** [Qd 7h 3d]
bin600implus: bets $0.24
NikosVeniz: calls $0.24
*** TURN *** [Qd 7h 3d] [Ks]
bin600implus: bets $0.47
NikosVeniz: calls $0.47
*** RIVER *** [Qd 7h 3d Ks] [6h]
bin600implus: bets $0.10
NikosVeniz: calls $0.10
*** SHOW DOWN ***
bin600implus: shows [Td 7d] (a pair of Sevens)
NikosVeniz: shows [Jh 7s] (a pair of Sevens - King+Queen+Jack kicker)
NikosVeniz collected $2.02 from pot
*** SUMMARY ***
Total pot $2.12 | Rake $0.10 
Board [Qd 7h 3d Ks 6h]
Seat 1: Lucky HoBBiT folded before Flop (didn't bet)
Seat 2: NikosVeniz (button) showed [Jh 7s] and won ($2.02) with a pair of Sevens
Seat 3: bin600implus (small blind) showed [Td 7d] and lost with a pair of Sevens
Seat 4: Just_Million (big blind) folded before Flop
Seat 5: aman kumar folded before Flop (didn't bet)
Seat 6: bedniereba folded before Flop (didn't bet)



PokerStars Hand #222974957979:  Hold'em No Limit ($0.05/$0.10 USD) - 2021/01/23 17:23:51 ET
Table 'Malzovia' 6-max Seat #3 is the button
Seat 1: Lucky HoBBiT ($10.80 in chips) 
Seat 2: NikosVeniz ($10.35 in chips) 
Seat 3: bin600implus ($24.60 in chips) 
Seat 4: Just_Million ($10.32 in chips) 
Seat 5: aman kumar ($20.12 in chips) 
Seat 6: bedniereba ($2.25 in chips) 
Just_Million: posts small blind $0.05
aman kumar: posts big blind $0.10
*** HOLE CARDS ***
bedniereba: calls $0.10
Lucky HoBBiT: raises $0.35 to $0.45
NikosVeniz: calls $0.45
bin600implus: folds 
Just_Million: folds 
aman kumar: folds 
bedniereba: calls $0.35
*** FLOP *** [2c Jc 5d]
bedniereba: checks 
Lucky HoBBiT: bets $0.97
NikosVeniz: folds 
bedniereba: folds 
Uncalled bet ($0.97) returned to Lucky HoBBiT
Lucky HoBBiT collected $1.43 from pot
Lucky HoBBiT: doesn't show hand 
*** SUMMARY ***
Total pot $1.50 | Rake $0.07 
Board [2c Jc 5d]
Seat 1: Lucky HoBBiT collected ($1.43)
Seat 2: NikosVeniz folded on the Flop
Seat 3: bin600implus (button) folded before Flop (didn't bet)
Seat 4: Just_Million (small blind) folded before Flop
Seat 5: aman kumar (big blind) folded before Flop
Seat 6: bedniereba folded on the Flop



PokerStars Hand #222974979069:  Hold'em No Limit ($0.05/$0.10 USD) - 2021/01/23 17:24:17 ET
Table 'Malzovia' 6-max Seat #4 is the button
Seat 1: Lucky HoBBiT ($11.78 in chips) 
Seat 2: NikosVeniz ($9.90 in chips) 
Seat 3: bin600implus ($24.60 in chips) 
Seat 4: Just_Million ($10.27 in chips) 
Seat 5: aman kumar ($20.02 in chips) 
Seat 6: bedniereba ($1.80 in chips) 
aman kumar: posts small blind $0.05
bedniereba: posts big blind $0.10
*** HOLE CARDS ***
Lucky HoBBiT: folds 
NikosVeniz: calls $0.10
bin600implus: calls $0.10
Just_Million: folds 
aman kumar: folds 
bedniereba: checks 
*** FLOP *** [2h 4h 6c]
bedniereba: checks 
NikosVeniz: checks 
bin600implus: bets $0.33
bedniereba: calls $0.33
NikosVeniz: folds 
*** TURN *** [2h 4h 6c] [As]
bedniereba: checks 
bin600implus: checks 
*** RIVER *** [2h 4h 6c As] [6h]
bedniereba: bets $0.58
bin600implus: calls $0.58
*** SHOW DOWN ***
bedniereba: shows [3d 9d] (a pair of Sixes)
bin600implus: shows [5s 5h] (two pair, Sixes and Fives)
bin600implus collected $2.07 from pot
*** SUMMARY ***
Total pot $2.17 | Rake $0.10 
Board [2h 4h 6c As 6h]
Seat 1: Lucky HoBBiT folded before Flop (didn't bet)
Seat 2: NikosVeniz folded on the Flop
Seat 3: bin600implus showed [5s 5h] and won ($2.07) with two pair, Sixes and Fives
Seat 4: Just_Million (button) folded before Flop (didn't bet)
Seat 5: aman kumar (small blind) folded before Flop
Seat 6: bedniereba (big blind) showed [3d 9d] and lost with a pair of Sixes



PokerStars Hand #222975021786:  Hold'em No Limit ($0.05/$0.10 USD) - 2021/01/23 17:25:10 ET
Table 'Malzovia' 6-max Seat #5 is the button
Seat 1: Lucky HoBBiT ($11.78 in chips) 
Seat 2: NikosVeniz ($9.80 in chips) 
Seat 3: bin600implus ($25.66 in chips) 
Seat 4: Just_Million ($10.27 in chips) 
Seat 5: aman kumar ($19.97 in chips) 
Seat 6: bedniereba ($0.79 in chips) 
bedniereba: posts small blind $0.05
Lucky HoBBiT: posts big blind $0.10
*** HOLE CARDS ***
NikosVeniz: calls $0.10
bin600implus: calls $0.10
Just_Million: folds 
aman kumar: folds 
bedniereba: folds 
Lucky HoBBiT: checks 
*** FLOP *** [Td Qd Th]
Lucky HoBBiT: checks 
NikosVeniz: bets $0.10
bin600implus: calls $0.10
Lucky HoBBiT: folds 
*** TURN *** [Td Qd Th] [Jc]
NikosVeniz: bets $0.10
bin600implus: calls $0.10
*** RIVER *** [Td Qd Th Jc] [5d]
NikosVeniz: bets $0.10
bin600implus: raises $0.20 to $0.30
NikosVeniz: calls $0.20
*** SHOW DOWN ***
bin600implus: shows [Ad 7d] (a flush, Ace high)
NikosVeniz: mucks hand 
bin600implus collected $1.29 from pot
*** SUMMARY ***
Total pot $1.35 | Rake $0.06 
Board [Td Qd Th Jc 5d]
Seat 1: Lucky HoBBiT (big blind) folded on the Flop
Seat 2: NikosVeniz mucked
Seat 3: bin600implus showed [Ad 7d] and won ($1.29) with a flush, Ace high
Seat 4: Just_Million folded before Flop (didn't bet)
Seat 5: aman kumar (button) folded before Flop (didn't bet)
Seat 6: bedniereba (small blind) folded before Flop



PokerStars Hand #222975049274:  Hold'em No Limit ($0.05/$0.10 USD) - 2021/01/23 17:25:44 ET
Table 'Malzovia' 6-max Seat #6 is the button
Seat 1: Lucky HoBBiT ($11.68 in chips) 
Seat 2: NikosVeniz ($9.20 in chips) 
Seat 3: bin600implus ($26.35 in chips) 
Seat 4: Just_Million ($10.27 in chips) 
Seat 5: aman kumar ($19.97 in chips) 
Seat 6: bedniereba ($0.74 in chips) 
Lucky HoBBiT: posts small blind $0.05
NikosVeniz: posts big blind $0.10
*** HOLE CARDS ***
bin600implus: calls $0.10
Just_Million: folds 
aman kumar: raises $0.20 to $0.30
bedniereba: calls $0.30
Lucky HoBBiT: folds 
NikosVeniz: folds 
bin600implus: calls $0.20
*** FLOP *** [6s Kd 7h]
bin600implus: checks 
aman kumar: bets $0.33
bedniereba: folds 
bin600implus: calls $0.33
*** TURN *** [6s Kd 7h] [6h]
bin600implus: checks 
aman kumar: checks 
*** RIVER *** [6s Kd 7h 6h] [4d]
bin600implus: checks 
aman kumar: checks 
*** SHOW DOWN ***
bin600implus: shows [5h 5s] (two pair, Sixes and Fives)
aman kumar: mucks hand 
bin600implus collected $1.63 from pot
*** SUMMARY ***
Total pot $1.71 | Rake $0.08 
Board [6s Kd 7h 6h 4d]
Seat 1: Lucky HoBBiT (small blind) folded before Flop
Seat 2: NikosVeniz (big blind) folded before Flop
Seat 3: bin600implus showed [5h 5s] and won ($1.63) with two pair, Sixes and Fives
Seat 4: Just_Million folded before Flop (didn't bet)
Seat 5: aman kumar mucked
Seat 6: bedniereba (button) folded on the Flop



PokerStars Hand #222975076858:  Hold'em No Limit ($0.05/$0.10 USD) - 2021/01/23 17:26:19 ET
Table 'Malzovia' 6-max Seat #1 is the button
Seat 1: Lucky HoBBiT ($11.63 in chips) 
Seat 2: NikosVeniz ($9.10 in chips) 
Seat 3: bin600implus ($27.35 in chips) 
Seat 4: Just_Million ($10.27 in chips) 
Seat 5: aman kumar ($19.34 in chips) 
Seat 6: bedniereba ($0.44 in chips) 
NikosVeniz: posts small blind $0.05
bin600implus: posts big blind $0.10
*** HOLE CARDS ***
Just_Million: folds 
aman kumar: folds 
bedniereba: raises $0.34 to $0.44 and is all-in
Lucky HoBBiT: calls $0.44
NikosVeniz: calls $0.39
bin600implus: folds 
*** FLOP *** [Qc Tc 2h]
NikosVeniz: bets $0.68
Lucky HoBBiT: calls $0.68
*** TURN *** [Qc Tc 2h] [4c]
NikosVeniz: checks 
Lucky HoBBiT: checks 
*** RIVER *** [Qc Tc 2h 4c] [Kd]
NikosVeniz: bets $2.65
Lucky HoBBiT: calls $2.65
*** SHOW DOWN ***
NikosVeniz: shows [Qh 4s] (two pair, Queens and Fours)
Lucky HoBBiT: shows [Jc Ah] (a straight, Ten to Ace)
Lucky HoBBiT collected $6.36 from side pot
bedniereba: mucks hand 
Lucky HoBBiT collected $1.36 from main pot
*** SUMMARY ***
Total pot $8.08 Main pot $1.36. Side pot $6.36. | Rake $0.36 
Board [Qc Tc 2h 4c Kd]
Seat 1: Lucky HoBBiT (button) showed [Jc Ah] and won ($7.72) with a straight, Ten to Ace
Seat 2: NikosVeniz (small blind) showed [Qh 4s] and lost with two pair, Queens and Fours
Seat 3: bin600implus (big blind) folded before Flop
Seat 4: Just_Million folded before Flop (didn't bet)
Seat 5: aman kumar folded before Flop (didn't bet)
Seat 6: bedniereba mucked



PokerStars Hand #222975111555:  Hold'em No Limit ($0.05/$0.10 USD) - 2021/01/23 17:27:01 ET
Table 'Malzovia' 6-max Seat #2 is the button
Seat 1: Lucky HoBBiT ($15.58 in chips) 
Seat 2: NikosVeniz ($5.33 in chips) 
Seat 3: bin600implus ($27.25 in chips) 
Seat 4: Just_Million ($10.27 in chips) 
Seat 5: aman kumar ($19.34 in chips) 
bin600implus: posts small blind $0.05
Just_Million: posts big blind $0.10
*** HOLE CARDS ***
aman kumar: folds 
Lucky HoBBiT: folds 
NikosVeniz: raises $0.10 to $0.20
bin600implus: folds 
bedniereba leaves the table
Zimniy joins the table at seat #6 
Just_Million: calls $0.10
*** FLOP *** [Qh 9d Tc]
Just_Million: checks 
NikosVeniz: bets $0.43
Just_Million: folds 
Uncalled bet ($0.43) returned to NikosVeniz
NikosVeniz collected $0.43 from pot
NikosVeniz: doesn't show hand 
*** SUMMARY ***
Total pot $0.45 | Rake $0.02 
Board [Qh 9d Tc]
Seat 1: Lucky HoBBiT folded before Flop (didn't bet)
Seat 2: NikosVeniz (button) collected ($0.43)
Seat 3: bin600implus (small blind) folded before Flop
Seat 4: Just_Million (big blind) folded on the Flop
Seat 5: aman kumar folded before Flop (didn't bet)



PokerStars Hand #222975135966:  Hold'em No Limit ($0.05/$0.10 USD) - 2021/01/23 17:27:32 ET
Table 'Malzovia' 6-max Seat #3 is the button
Seat 1: Lucky HoBBiT ($15.58 in chips) 
Seat 2: NikosVeniz ($5.56 in chips) 
Seat 3: bin600implus ($27.20 in chips) 
Seat 4: Just_Million ($10.07 in chips) 
Seat 5: aman kumar ($19.34 in chips) 
Just_Million: posts small blind $0.05
aman kumar: posts big blind $0.10
Zimniy: sits out 
*** HOLE CARDS ***
Lucky HoBBiT: folds 
NikosVeniz: calls $0.10
bin600implus: raises $0.20 to $0.30
Just_Million: folds 
aman kumar: folds 
NikosVeniz: calls $0.20
*** FLOP *** [Ks Kc Ah]
NikosVeniz: checks 
bin600implus: bets $0.36
NikosVeniz: folds 
Uncalled bet ($0.36) returned to bin600implus
bin600implus collected $0.72 from pot
bin600implus: doesn't show hand 
*** SUMMARY ***
Total pot $0.75 | Rake $0.03 
Board [Ks Kc Ah]
Seat 1: Lucky HoBBiT folded before Flop (didn't bet)
Seat 2: NikosVeniz folded on the Flop
Seat 3: bin600implus (button) collected ($0.72)
Seat 4: Just_Million (small blind) folded before Flop
Seat 5: aman kumar (big blind) folded before Flop



PokerStars Hand #222975166194:  Hold'em No Limit ($0.05/$0.10 USD) - 2021/01/23 17:28:06 ET
Table 'Malzovia' 6-max Seat #4 is the button
Seat 1: Lucky HoBBiT ($15.58 in chips) 
Seat 2: NikosVeniz ($5.26 in chips) 
Seat 3: bin600implus ($27.62 in chips) 
Seat 4: Just_Million ($10.02 in chips) 
Seat 5: aman kumar ($19.24 in chips) 
Seat 6: Zimniy ($10 in chips) 
aman kumar: posts small blind $0.05
Zimniy: posts big blind $0.10
*** HOLE CARDS ***
Lucky HoBBiT: folds 
NikosVeniz: folds 
bin600implus: raises $0.20 to $0.30
Just_Million: folds 
aman kumar: folds 
Zimniy: folds 
Uncalled bet ($0.20) returned to bin600implus
bin600implus collected $0.25 from pot
bin600implus: doesn't show hand 
*** SUMMARY ***
Total pot $0.25 | Rake $0 
Seat 1: Lucky HoBBiT folded before Flop (didn't bet)
Seat 2: NikosVeniz folded before Flop (didn't bet)
Seat 3: bin600implus collected ($0.25)
Seat 4: Just_Million (button) folded before Flop (didn't bet)
Seat 5: aman kumar (small blind) folded before Flop
Seat 6: Zimniy (big blind) folded before Flop



PokerStars Hand #222975177700:  Hold'em No Limit ($0.05/$0.10 USD) - 2021/01/23 17:28:21 ET
Table 'Malzovia' 6-max Seat #5 is the button
Seat 1: Lucky HoBBiT ($15.58 in chips) 
Seat 2: NikosVeniz ($5.26 in chips) 
Seat 3: bin600implus ($27.77 in chips) 
Seat 4: Just_Million ($10.02 in chips) 
Seat 5: aman kumar ($19.19 in chips) 
Seat 6: Zimniy ($10 in chips) 
Zimniy: posts small blind $0.05
Lucky HoBBiT: posts big blind $0.10
*** HOLE CARDS ***
NikosVeniz: calls $0.10
bin600implus: folds 
Just_Million: folds 
aman kumar: folds 
Zimniy: folds 
Lucky HoBBiT: checks 
*** FLOP *** [9h 2d 3c]
Lucky HoBBiT: checks 
NikosVeniz: bets $0.10
Lucky HoBBiT: calls $0.10
*** TURN *** [9h 2d 3c] [Jc]
Lucky HoBBiT: checks 
NikosVeniz: bets $0.21
Lucky HoBBiT: folds 
Uncalled bet ($0.21) returned to NikosVeniz
NikosVeniz collected $0.43 from pot
NikosVeniz: doesn't show hand 
*** SUMMARY ***
Total pot $0.45 | Rake $0.02 
Board [9h 2d 3c Jc]
Seat 1: Lucky HoBBiT (big blind) folded on the Turn
Seat 2: NikosVeniz collected ($0.43)
Seat 3: bin600implus folded before Flop (didn't bet)
Seat 4: Just_Million folded before Flop (didn't bet)
Seat 5: aman kumar (button) folded before Flop (didn't bet)
Seat 6: Zimniy (small blind) folded before Flop



PokerStars Hand #222975197326:  Hold'em No Limit ($0.05/$0.10 USD) - 2021/01/23 17:28:45 ET
Table 'Malzovia' 6-max Seat #6 is the button
Seat 1: Lucky HoBBiT ($15.38 in chips) 
Seat 2: NikosVeniz ($5.49 in chips) 
Seat 3: bin600implus ($27.77 in chips) 
Seat 4: Just_Million ($10.02 in chips) 
Seat 5: aman kumar ($19.19 in chips) 
Seat 6: Zimniy ($10 in chips) 
Lucky HoBBiT: posts small blind $0.05
NikosVeniz: posts big blind $0.10
*** HOLE CARDS ***
bin600implus: folds 
Just_Million: folds 
Just_Million leaves the table
aman kumar: folds 
Zimniy: raises $0.15 to $0.25
Lucky HoBBiT: raises $0.70 to $0.95
NikosVeniz: raises $0.70 to $1.65
Christasm joins the table at seat #4 
Zimniy: folds 
Lucky HoBBiT: raises $13.73 to $15.38 and is all-in
NikosVeniz: calls $3.84 and is all-in
Uncalled bet ($9.89) returned to Lucky HoBBiT
*** FLOP *** [8c 8s 4d]
*** TURN *** [8c 8s 4d] [7d]
*** RIVER *** [8c 8s 4d 7d] [3h]
*** SHOW DOWN ***
Lucky HoBBiT: shows [Ks As] (a pair of Eights)
NikosVeniz: shows [Qd Kh] (a pair of Eights - lower kicker)
Lucky HoBBiT collected $10.72 from pot
*** SUMMARY ***
Total pot $11.23 | Rake $0.51 
Board [8c 8s 4d 7d 3h]
Seat 1: Lucky HoBBiT (small blind) showed [Ks As] and won ($10.72) with a pair of Eights
Seat 2: NikosVeniz (big blind) showed [Qd Kh] and lost with a pair of Eights
Seat 3: bin600implus folded before Flop (didn't bet)
Seat 4: Just_Million folded before Flop (didn't bet)
Seat 5: aman kumar folded before Flop (didn't bet)
Seat 6: Zimniy (button) folded before Flop



PokerStars Hand #222975223467:  Hold'em No Limit ($0.05/$0.10 USD) - 2021/01/23 17:29:18 ET
Table 'Malzovia' 6-max Seat #1 is the button
Seat 1: Lucky HoBBiT ($20.61 in chips) 
Seat 3: bin600implus ($27.77 in chips) 
Seat 4: Christasm ($10 in chips) 
Seat 5: aman kumar ($19.19 in chips) 
Seat 6: Zimniy ($10 in chips) 
bin600implus: posts small blind $0.05
Christasm: posts big blind $0.10
*** HOLE CARDS ***
aman kumar: raises $0.10 to $0.20
Zimniy: folds 
Lucky HoBBiT: raises $0.25 to $0.45
bin600implus: folds 
Christasm: folds 
aman kumar: calls $0.25
*** FLOP *** [Ks As Jh]
aman kumar: checks 
Lucky HoBBiT: checks 
*** TURN *** [Ks As Jh] [9s]
aman kumar: checks 
Lucky HoBBiT: checks 
*** RIVER *** [Ks As Jh 9s] [8d]
aman kumar: checks 
Lucky HoBBiT: checks 
*** SHOW DOWN ***
aman kumar: shows [4h Ah] (a pair of Aces)
Lucky HoBBiT: mucks hand 
aman kumar collected $1 from pot
*** SUMMARY ***
Total pot $1.05 | Rake $0.05 
Board [Ks As Jh 9s 8d]
Seat 1: Lucky HoBBiT (button) mucked
Seat 3: bin600implus (small blind) folded before Flop
Seat 4: Christasm (big blind) folded before Flop
Seat 5: aman kumar showed [4h Ah] and won ($1) with a pair of Aces
Seat 6: Zimniy folded before Flop (didn't bet)



PokerStars Hand #222975256348:  Hold'em No Limit ($0.05/$0.10 USD) - 2021/01/23 17:30:00 ET
Table 'Malzovia' 6-max Seat #4 is the button
Seat 1: Lucky HoBBiT ($20.16 in chips) 
Seat 2: NikosVeniz ($10 in chips) 
Seat 4: Christasm ($10 in chips) 
Seat 5: aman kumar ($19.74 in chips) 
Seat 6: Zimniy ($10 in chips) 
aman kumar: posts small blind $0.05
Zimniy: posts big blind $0.10
NikosVeniz: posts small blind $0.05
*** HOLE CARDS ***
Lucky HoBBiT: folds 
NikosVeniz: calls $0.10
Christasm: raises $0.40 to $0.50
aman kumar: folds 
Zimniy: folds 
NikosVeniz: calls $0.40
*** FLOP *** [4c 9h 3c]
NikosVeniz: checks 
Christasm: checks 
*** TURN *** [4c 9h 3c] [9c]
NikosVeniz: checks 
Christasm: bets $0.58
NikosVeniz: calls $0.58
*** RIVER *** [4c 9h 3c 9c] [9s]
NikosVeniz: checks 
Christasm: bets $1.40
NikosVeniz: folds 
Uncalled bet ($1.40) returned to Christasm
Christasm collected $2.25 from pot
Christasm: doesn't show hand 
*** SUMMARY ***
Total pot $2.36 | Rake $0.11 
Board [4c 9h 3c 9c 9s]
Seat 1: Lucky HoBBiT folded before Flop (didn't bet)
Seat 2: NikosVeniz folded on the River
Seat 4: Christasm (button) collected ($2.25)
Seat 5: aman kumar (small blind) folded before Flop
Seat 6: Zimniy (big blind) folded before Flop



PokerStars Hand #222975317796:  Hold'em No Limit ($0.05/$0.10 USD) - 2021/01/23 17:31:18 ET
Table 'Malzovia' 6-max Seat #5 is the button
Seat 1: Lucky HoBBiT ($20.16 in chips) 
Seat 2: NikosVeniz ($8.87 in chips) 
Seat 4: Christasm ($11.17 in chips) 
Seat 5: aman kumar ($19.69 in chips) 
Seat 6: Zimniy ($10 in chips) 
Zimniy: posts small blind $0.05
Lucky HoBBiT: posts big blind $0.10
*** HOLE CARDS ***
NikosVeniz: calls $0.10
Christasm has timed out
Christasm: folds 
aman kumar: raises $0.20 to $0.30
Zimniy: folds 
Lucky HoBBiT: folds 
NikosVeniz: calls $0.20
*** FLOP *** [Js Jd 3s]
NikosVeniz: checks 
aman kumar: bets $0.24
NikosVeniz: calls $0.24
*** TURN *** [Js Jd 3s] [8h]
NikosVeniz: checks 
aman kumar: checks 
*** RIVER *** [Js Jd 3s 8h] [Qd]
NikosVeniz: bets $1.17
aman kumar: folds 
Uncalled bet ($1.17) returned to NikosVeniz
NikosVeniz collected $1.17 from pot
NikosVeniz: doesn't show hand 
*** SUMMARY ***
Total pot $1.23 | Rake $0.06 
Board [Js Jd 3s 8h Qd]
Seat 1: Lucky HoBBiT (big blind) folded before Flop
Seat 2: NikosVeniz collected ($1.17)
Seat 4: Christasm folded before Flop (didn't bet)
Seat 5: aman kumar (button) folded on the River
Seat 6: Zimniy (small blind) folded before Flop



PokerStars Hand #222975353238:  Hold'em No Limit ($0.05/$0.10 USD) - 2021/01/23 17:32:03 ET
Table 'Malzovia' 6-max Seat #6 is the button
Seat 1: Lucky HoBBiT ($20.06 in chips) 
Seat 2: NikosVeniz ($9.50 in chips) 
Seat 4: Christasm ($11.17 in chips) 
Seat 5: aman kumar ($19.15 in chips) 
Seat 6: Zimniy ($10 in chips) 
Lucky HoBBiT: posts small blind $0.05
NikosVeniz: posts big blind $0.10
*** HOLE CARDS ***
Christasm: folds 
aman kumar: folds 
Zimniy: folds 
Lucky HoBBiT: raises $0.20 to $0.30
NikosVeniz: raises $0.20 to $0.50
Lucky HoBBiT: calls $0.20
*** FLOP *** [9s Tc 6h]
Lucky HoBBiT: checks 
NikosVeniz: checks 
*** TURN *** [9s Tc 6h] [7c]
Lucky HoBBiT: checks 
NikosVeniz: bets $0.48
Lucky HoBBiT: folds 
Uncalled bet ($0.48) returned to NikosVeniz
NikosVeniz collected $0.96 from pot
NikosVeniz: doesn't show hand 
*** SUMMARY ***
Total pot $1 | Rake $0.04 
Board [9s Tc 6h 7c]
Seat 1: Lucky HoBBiT (small blind) folded on the Turn
Seat 2: NikosVeniz (big blind) collected ($0.96)
Seat 4: Christasm folded before Flop (didn't bet)
Seat 5: aman kumar folded before Flop (didn't bet)
Seat 6: Zimniy (button) folded before Flop (didn't bet)



PokerStars Hand #222975374432:  Hold'em No Limit ($0.05/$0.10 USD) - 2021/01/23 17:32:29 ET
Table 'Malzovia' 6-max Seat #1 is the button
Seat 1: Lucky HoBBiT ($19.56 in chips) 
Seat 2: NikosVeniz ($9.96 in chips) 
Seat 4: Christasm ($11.17 in chips) 
Seat 5: aman kumar ($19.15 in chips) 
Seat 6: Zimniy ($10 in chips) 
NikosVeniz: posts small blind $0.05
Christasm: posts big blind $0.10
*** HOLE CARDS ***
aman kumar: folds 
Zimniy: folds 
Lucky HoBBiT: raises $0.15 to $0.25
NikosVeniz: calls $0.20
Christasm: folds 
*** FLOP *** [5s 4s 9s]
NikosVeniz: checks 
Lucky HoBBiT: checks 
*** TURN *** [5s 4s 9s] [8s]
NikosVeniz: bets $0.28
Lucky HoBBiT: folds 
Uncalled bet ($0.28) returned to NikosVeniz
NikosVeniz collected $0.57 from pot
NikosVeniz: doesn't show hand 
*** SUMMARY ***
Total pot $0.60 | Rake $0.03 
Board [5s 4s 9s 8s]
Seat 1: Lucky HoBBiT (button) folded on the Turn
Seat 2: NikosVeniz (small blind) collected ($0.57)
Seat 4: Christasm (big blind) folded before Flop
Seat 5: aman kumar folded before Flop (didn't bet)
Seat 6: Zimniy folded before Flop (didn't bet)



PokerStars Hand #222975401859:  Hold'em No Limit ($0.05/$0.10 USD) - 2021/01/23 17:33:04 ET
Table 'Malzovia' 6-max Seat #2 is the button
Seat 1: Lucky HoBBiT ($19.31 in chips) 
Seat 2: NikosVeniz ($10.28 in chips) 
Seat 4: Christasm ($11.07 in chips) 
Seat 5: aman kumar ($19.15 in chips) 
Seat 6: Zimniy ($10 in chips) 
Christasm: posts small blind $0.05
aman kumar: posts big blind $0.10
*** HOLE CARDS ***
Zimniy: folds 
Lucky HoBBiT: folds 
NikosVeniz: folds 
Christasm: raises $0.10 to $0.20
aman kumar: raises $0.40 to $0.60
Christasm: folds 
Uncalled bet ($0.40) returned to aman kumar
aman kumar collected $0.40 from pot
aman kumar: doesn't show hand 
*** SUMMARY ***
Total pot $0.40 | Rake $0 
Seat 1: Lucky HoBBiT folded before Flop (didn't bet)
Seat 2: NikosVeniz (button) folded before Flop (didn't bet)
Seat 4: Christasm (small blind) folded before Flop
Seat 5: aman kumar (big blind) collected ($0.40)
Seat 6: Zimniy folded before Flop (didn't bet)



PokerStars Hand #222975424440:  Hold'em No Limit ($0.05/$0.10 USD) - 2021/01/23 17:33:33 ET
Table 'Malzovia' 6-max Seat #4 is the button
Seat 1: Lucky HoBBiT ($19.31 in chips) 
Seat 2: NikosVeniz ($10.28 in chips) 
Seat 4: Christasm ($10.87 in chips) 
Seat 5: aman kumar ($19.35 in chips) 
Seat 6: Zimniy ($10 in chips) 
aman kumar: posts small blind $0.05
Zimniy: posts big blind $0.10
*** HOLE CARDS ***
Lucky HoBBiT: folds 
NikosVeniz: folds 
Christasm: raises $0.10 to $0.20
aman kumar: raises $0.60 to $0.80
Zimniy: folds 
Christasm: folds 
Uncalled bet ($0.60) returned to aman kumar
aman kumar collected $0.50 from pot
aman kumar: doesn't show hand 
*** SUMMARY ***
Total pot $0.50 | Rake $0 
Seat 1: Lucky HoBBiT folded before Flop (didn't bet)
Seat 2: NikosVeniz folded before Flop (didn't bet)
Seat 4: Christasm (button) folded before Flop
Seat 5: aman kumar (small blind) collected ($0.50)
Seat 6: Zimniy (big blind) folded before Flop



PokerStars Hand #222975438382:  Hold'em No Limit ($0.05/$0.10 USD) - 2021/01/23 17:33:51 ET
Table 'Malzovia' 6-max Seat #5 is the button
Seat 1: Lucky HoBBiT ($19.31 in chips) 
Seat 2: NikosVeniz ($10.28 in chips) 
Seat 4: Christasm ($10.67 in chips) 
Seat 5: aman kumar ($19.65 in chips) 
Seat 6: Zimniy ($10 in chips) 
Zimniy: posts small blind $0.05
Lucky HoBBiT: posts big blind $0.10
*** HOLE CARDS ***
NikosVeniz: raises $0.10 to $0.20
Christasm: folds 
aman kumar: raises $0.60 to $0.80
Zimniy: folds 
Lucky HoBBiT: folds 
NikosVeniz: calls $0.60
*** FLOP *** [Td Ad Qd]
NikosVeniz: bets $0.83
aman kumar: calls $0.83
*** TURN *** [Td Ad Qd] [Qc]
NikosVeniz: bets $1.63
aman kumar: folds 
Uncalled bet ($1.63) returned to NikosVeniz
NikosVeniz collected $3.26 from pot
NikosVeniz: doesn't show hand 
*** SUMMARY ***
Total pot $3.41 | Rake $0.15 
Board [Td Ad Qd Qc]
Seat 1: Lucky HoBBiT (big blind) folded before Flop
Seat 2: NikosVeniz collected ($3.26)
Seat 4: Christasm folded before Flop (didn't bet)
Seat 5: aman kumar (button) folded on the Turn
Seat 6: Zimniy (small blind) folded before Flop



PokerStars Hand #222975473119:  Hold'em No Limit ($0.05/$0.10 USD) - 2021/01/23 17:34:35 ET
Table 'Malzovia' 6-max Seat #6 is the button
Seat 1: Lucky HoBBiT ($19.21 in chips) 
Seat 2: NikosVeniz ($11.91 in chips) 
Seat 4: Christasm ($10.67 in chips) 
Seat 5: aman kumar ($18.02 in chips) 
Seat 6: Zimniy ($10 in chips) 
Lucky HoBBiT: posts small blind $0.05
NikosVeniz: posts big blind $0.10
*** HOLE CARDS ***
Christasm: folds 
aman kumar: folds 
Zimniy: raises $0.15 to $0.25
Lucky HoBBiT: folds 
NikosVeniz: raises $0.15 to $0.40
Zimniy: calls $0.15
*** FLOP *** [6h 6d 7h]
NikosVeniz: bets $0.40
Zimniy: folds 
Uncalled bet ($0.40) returned to NikosVeniz
NikosVeniz collected $0.81 from pot
NikosVeniz: doesn't show hand 
*** SUMMARY ***
Total pot $0.85 | Rake $0.04 
Board [6h 6d 7h]
Seat 1: Lucky HoBBiT (small blind) folded before Flop
Seat 2: NikosVeniz (big blind) collected ($0.81)
Seat 4: Christasm folded before Flop (didn't bet)
Seat 5: aman kumar folded before Flop (didn't bet)
Seat 6: Zimniy (button) folded on the Flop



PokerStars Hand #222975496642:  Hold'em No Limit ($0.05/$0.10 USD) - 2021/01/23 17:35:05 ET
Table 'Malzovia' 6-max Seat #1 is the button
Seat 1: Lucky HoBBiT ($19.16 in chips) 
Seat 2: NikosVeniz ($12.32 in chips) 
Seat 4: Christasm ($10.67 in chips) 
Seat 5: aman kumar ($18.02 in chips) 
Seat 6: Zimniy ($10 in chips) 
NikosVeniz: posts small blind $0.05
Christasm: posts big blind $0.10
*** HOLE CARDS ***
aman kumar: folds 
Zimniy: folds 
Lucky HoBBiT: raises $0.15 to $0.25
NikosVeniz: calls $0.20
Christasm: calls $0.15
*** FLOP *** [Qs Ac 2d]
NikosVeniz: bets $0.36
Christasm: calls $0.36
Lucky HoBBiT: calls $0.36
*** TURN *** [Qs Ac 2d] [Ah]
NikosVeniz: bets $0.10
Christasm: calls $0.10
Lucky HoBBiT: raises $0.82 to $0.92
NikosVeniz: calls $0.82
Christasm: calls $0.82
*** RIVER *** [Qs Ac 2d Ah] [6s]
NikosVeniz: checks 
Christasm: checks 
Lucky HoBBiT: bets $3.15
NikosVeniz: calls $3.15
Christasm: folds 
*** SHOW DOWN ***
Lucky HoBBiT: shows [6c As] (a full house, Aces full of Sixes)
NikosVeniz: mucks hand 
Lucky HoBBiT collected $10.40 from pot
*** SUMMARY ***
Total pot $10.89 | Rake $0.49 
Board [Qs Ac 2d Ah 6s]
Seat 1: Lucky HoBBiT (button) showed [6c As] and won ($10.40) with a full house, Aces full of Sixes
Seat 2: NikosVeniz (small blind) mucked
Seat 4: Christasm (big blind) folded on the River
Seat 5: aman kumar folded before Flop (didn't bet)
Seat 6: Zimniy folded before Flop (didn't bet)



PokerStars Hand #222975568547:  Hold'em No Limit ($0.05/$0.10 USD) - 2021/01/23 17:36:25 ET
Table 'Malzovia' 6-max Seat #2 is the button
Seat 1: Lucky HoBBiT ($24.88 in chips) 
Seat 2: NikosVeniz ($7.64 in chips) 
Seat 4: Christasm ($10 in chips) 
Seat 5: aman kumar ($18.02 in chips) 
Seat 6: Zimniy ($10 in chips) 
Christasm: posts small blind $0.05
aman kumar: posts big blind $0.10
*** HOLE CARDS ***
Zimniy: folds 
Lucky HoBBiT: folds 
NikosVeniz: calls $0.10
Christasm: calls $0.05
aman kumar: checks 
*** FLOP *** [8c 6h 5s]
Christasm: checks 
aman kumar: checks 
NikosVeniz: bets $0.14
Christasm: calls $0.14
aman kumar: folds 
*** TURN *** [8c 6h 5s] [4s]
Christasm: checks 
NikosVeniz: bets $0.27
Christasm: calls $0.27
*** RIVER *** [8c 6h 5s 4s] [4c]
Christasm: checks 
NikosVeniz: checks 
*** SHOW DOWN ***
Christasm: shows [Kh 9c] (a pair of Fours)
NikosVeniz: shows [Ad 6c] (two pair, Sixes and Fours)
NikosVeniz collected $1.07 from pot
*** SUMMARY ***
Total pot $1.12 | Rake $0.05 
Board [8c 6h 5s 4s 4c]
Seat 1: Lucky HoBBiT folded before Flop (didn't bet)
Seat 2: NikosVeniz (button) showed [Ad 6c] and won ($1.07) with two pair, Sixes and Fours
Seat 4: Christasm (small blind) showed [Kh 9c] and lost with a pair of Fours
Seat 5: aman kumar (big blind) folded on the Flop
Seat 6: Zimniy folded before Flop (didn't bet)



PokerStars Hand #222975607982:  Hold'em No Limit ($0.05/$0.10 USD) - 2021/01/23 17:37:16 ET
Table 'Malzovia' 6-max Seat #4 is the button
Seat 1: Lucky HoBBiT ($24.88 in chips) 
Seat 2: NikosVeniz ($8.20 in chips) 
Seat 4: Christasm ($10 in chips) 
Seat 5: aman kumar ($17.92 in chips) 
Seat 6: Zimniy ($10 in chips) 
aman kumar: posts small blind $0.05
Zimniy: posts big blind $0.10
bin600implus: sits out 
*** HOLE CARDS ***
Lucky HoBBiT: folds 
NikosVeniz: raises $0.10 to $0.20
Christasm: calls $0.20
aman kumar: folds 
Zimniy: folds 
*** FLOP *** [Ad 6h 4s]
NikosVeniz: checks 
Christasm: checks 
*** TURN *** [Ad 6h 4s] [2s]
NikosVeniz: checks 
Christasm: checks 
*** RIVER *** [Ad 6h 4s 2s] [7h]
NikosVeniz: checks 
Christasm: bets $0.30
NikosVeniz: folds 
Uncalled bet ($0.30) returned to Christasm
Christasm collected $0.53 from pot
Christasm: doesn't show hand 
*** SUMMARY ***
Total pot $0.55 | Rake $0.02 
Board [Ad 6h 4s 2s 7h]
Seat 1: Lucky HoBBiT folded before Flop (didn't bet)
Seat 2: NikosVeniz folded on the River
Seat 4: Christasm (button) collected ($0.53)
Seat 5: aman kumar (small blind) folded before Flop
Seat 6: Zimniy (big blind) folded before Flop



PokerStars Hand #222975641169:  Hold'em No Limit ($0.05/$0.10 USD) - 2021/01/23 17:37:59 ET
Table 'Malzovia' 6-max Seat #5 is the button
Seat 1: Lucky HoBBiT ($24.88 in chips) 
Seat 2: NikosVeniz ($8 in chips) 
Seat 4: Christasm ($10.33 in chips) 
Seat 5: aman kumar ($17.87 in chips) 
Seat 6: Zimniy ($10 in chips) 
Zimniy: posts small blind $0.05
Lucky HoBBiT: posts big blind $0.10
bin600implus: sits out 
*** HOLE CARDS ***
NikosVeniz: calls $0.10
Christasm: folds 
aman kumar: folds 
Zimniy: raises $0.40 to $0.50
Lucky HoBBiT: folds 
NikosVeniz: calls $0.40
*** FLOP *** [3c 8s Kc]
Zimniy: bets $0.53
NikosVeniz: folds 
Uncalled bet ($0.53) returned to Zimniy
Zimniy collected $1.05 from pot
Zimniy: doesn't show hand 
*** SUMMARY ***
Total pot $1.10 | Rake $0.05 
Board [3c 8s Kc]
Seat 1: Lucky HoBBiT (big blind) folded before Flop
Seat 2: NikosVeniz folded on the Flop
Seat 4: Christasm folded before Flop (didn't bet)
Seat 5: aman kumar (button) folded before Flop (didn't bet)
Seat 6: Zimniy (small blind) collected ($1.05)



PokerStars Hand #222975668277:  Hold'em No Limit ($0.05/$0.10 USD) - 2021/01/23 17:38:35 ET
Table 'Malzovia' 6-max Seat #6 is the button
Seat 1: Lucky HoBBiT ($24.78 in chips) 
Seat 2: NikosVeniz ($7.50 in chips) 
Seat 4: Christasm ($10.33 in chips) 
Seat 5: aman kumar ($17.87 in chips) 
Seat 6: Zimniy ($10.55 in chips) 
Lucky HoBBiT: posts small blind $0.05
NikosVeniz: posts big blind $0.10
bin600implus: sits out 
*** HOLE CARDS ***
Christasm: folds 
aman kumar: folds 
Zimniy: folds 
Lucky HoBBiT: folds 
Uncalled bet ($0.05) returned to NikosVeniz
NikosVeniz collected $0.10 from pot
NikosVeniz: doesn't show hand 
*** SUMMARY ***
Total pot $0.10 | Rake $0 
Seat 1: Lucky HoBBiT (small blind) folded before Flop
Seat 2: NikosVeniz (big blind) collected ($0.10)
Seat 4: Christasm folded before Flop (didn't bet)
Seat 5: aman kumar folded before Flop (didn't bet)
Seat 6: Zimniy (button) folded before Flop (didn't bet)



PokerStars Hand #222975678919:  Hold'em No Limit ($0.05/$0.10 USD) - 2021/01/23 17:38:49 ET
Table 'Malzovia' 6-max Seat #1 is the button
Seat 1: Lucky HoBBiT ($24.73 in chips) 
Seat 2: NikosVeniz ($7.55 in chips) 
Seat 3: bin600implus ($27.72 in chips) 
Seat 4: Christasm ($10.33 in chips) 
Seat 5: aman kumar ($17.87 in chips) 
Seat 6: Zimniy ($10.55 in chips) 
NikosVeniz: posts small blind $0.05
bin600implus: posts big blind $0.10
*** HOLE CARDS ***
Christasm: folds 
aman kumar: folds 
Zimniy: folds 
Lucky HoBBiT: raises $0.15 to $0.25
NikosVeniz: folds 
bin600implus: calls $0.15
*** FLOP *** [8h Qh 2s]
bin600implus: checks 
Lucky HoBBiT: bets $0.19
bin600implus: folds 
Uncalled bet ($0.19) returned to Lucky HoBBiT
Lucky HoBBiT collected $0.53 from pot
Lucky HoBBiT: doesn't show hand 
*** SUMMARY ***
Total pot $0.55 | Rake $0.02 
Board [8h Qh 2s]
Seat 1: Lucky HoBBiT (button) collected ($0.53)
Seat 2: NikosVeniz (small blind) folded before Flop
Seat 3: bin600implus (big blind) folded on the Flop
Seat 4: Christasm folded before Flop (didn't bet)
Seat 5: aman kumar folded before Flop (didn't bet)
Seat 6: Zimniy folded before Flop (didn't bet)



PokerStars Hand #222975698331:  Hold'em No Limit ($0.05/$0.10 USD) - 2021/01/23 17:39:14 ET
Table 'Malzovia' 6-max Seat #2 is the button
Seat 1: Lucky HoBBiT ($25.01 in chips) 
Seat 2: NikosVeniz ($7.50 in chips) 
Seat 3: bin600implus ($27.47 in chips) 
Seat 4: Christasm ($10.33 in chips) 
Seat 5: aman kumar ($17.87 in chips) 
Seat 6: Zimniy ($10.55 in chips) 
bin600implus: posts small blind $0.05
Christasm: posts big blind $0.10
*** HOLE CARDS ***
aman kumar: raises $0.10 to $0.20
Zimniy: folds 
Lucky HoBBiT: folds 
NikosVeniz: calls $0.20
bin600implus: folds 
Christasm: calls $0.10
*** FLOP *** [As Kd 6s]
Christasm: checks 
aman kumar: checks 
NikosVeniz: bets $0.31
Christasm: folds 
aman kumar: folds 
Uncalled bet ($0.31) returned to NikosVeniz
NikosVeniz collected $0.62 from pot
NikosVeniz: doesn't show hand 
*** SUMMARY ***
Total pot $0.65 | Rake $0.03 
Board [As Kd 6s]
Seat 1: Lucky HoBBiT folded before Flop (didn't bet)
Seat 2: NikosVeniz (button) collected ($0.62)
Seat 3: bin600implus (small blind) folded before Flop
Seat 4: Christasm (big blind) folded on the Flop
Seat 5: aman kumar folded on the Flop
Seat 6: Zimniy folded before Flop (didn't bet)



PokerStars Hand #222975731219:  Hold'em No Limit ($0.05/$0.10 USD) - 2021/01/23 17:39:57 ET
Table 'Malzovia' 6-max Seat #3 is the button
Seat 1: Lucky HoBBiT ($25.01 in chips) 
Seat 2: NikosVeniz ($7.92 in chips) 
Seat 3: bin600implus ($27.42 in chips) 
Seat 4: Christasm ($10.13 in chips) 
Seat 6: Zimniy ($10.55 in chips) 
Christasm: posts small blind $0.05
aman kumar: is sitting out 
Zimniy: posts big blind $0.10
*** HOLE CARDS ***
aman kumar leaves the table
Lucky HoBBiT: raises $0.20 to $0.30
NikosVeniz: raises $0.20 to $0.50
No1Sparkles joins the table at seat #5 
bin600implus: folds 
Christasm: folds 
Zimniy: folds 
Lucky HoBBiT: calls $0.20
*** FLOP *** [Qh 8c 6s]
Lucky HoBBiT: checks 
NikosVeniz: bets $0.55
Lucky HoBBiT: folds 
Uncalled bet ($0.55) returned to NikosVeniz
NikosVeniz collected $1.10 from pot
NikosVeniz: doesn't show hand 
*** SUMMARY ***
Total pot $1.15 | Rake $0.05 
Board [Qh 8c 6s]
Seat 1: Lucky HoBBiT folded on the Flop
Seat 2: NikosVeniz collected ($1.10)
Seat 3: bin600implus (button) folded before Flop (didn't bet)
Seat 4: Christasm (small blind) folded before Flop
Seat 6: Zimniy (big blind) folded before Flop



PokerStars Hand #222975752158:  Hold'em No Limit ($0.05/$0.10 USD) - 2021/01/23 17:40:24 ET
Table 'Malzovia' 6-max Seat #4 is the button
Seat 1: Lucky HoBBiT ($24.51 in chips) 
Seat 2: NikosVeniz ($8.52 in chips) 
Seat 3: bin600implus ($27.42 in chips) 
Seat 4: Christasm ($10.08 in chips) 
Seat 6: Zimniy ($10.45 in chips) 
Zimniy: posts small blind $0.05
Lucky HoBBiT: posts big blind $0.10
*** HOLE CARDS ***
NikosVeniz: calls $0.10
bin600implus: raises $0.20 to $0.30
Christasm: folds 
Zimniy: folds 
Lucky HoBBiT: folds 
NikosVeniz: calls $0.20
*** FLOP *** [4s 4h 3s]
NikosVeniz: bets $0.36
bin600implus: folds 
Uncalled bet ($0.36) returned to NikosVeniz
NikosVeniz collected $0.72 from pot
NikosVeniz: doesn't show hand 
*** SUMMARY ***
Total pot $0.75 | Rake $0.03 
Board [4s 4h 3s]
Seat 1: Lucky HoBBiT (big blind) folded before Flop
Seat 2: NikosVeniz collected ($0.72)
Seat 3: bin600implus folded on the Flop
Seat 4: Christasm (button) folded before Flop (didn't bet)
Seat 6: Zimniy (small blind) folded before Flop



PokerStars Hand #222975782295:  Hold'em No Limit ($0.05/$0.10 USD) - 2021/01/23 17:41:03 ET
Table 'Malzovia' 6-max Seat #6 is the button
Seat 1: Lucky HoBBiT ($24.41 in chips) 
Seat 2: NikosVeniz ($8.94 in chips) 
Seat 3: bin600implus ($27.12 in chips) 
Seat 4: Christasm ($10.08 in chips) 
Seat 6: Zimniy ($10.40 in chips) 
Lucky HoBBiT: posts small blind $0.05
NikosVeniz: posts big blind $0.10
No1Sparkles: sits out 
*** HOLE CARDS ***
bin600implus: folds 
Christasm: folds 
Zimniy: folds 
Lucky HoBBiT: folds 
Uncalled bet ($0.05) returned to NikosVeniz
NikosVeniz collected $0.10 from pot
NikosVeniz: doesn't show hand 
*** SUMMARY ***
Total pot $0.10 | Rake $0 
Seat 1: Lucky HoBBiT (small blind) folded before Flop
Seat 2: NikosVeniz (big blind) collected ($0.10)
Seat 3: bin600implus folded before Flop (didn't bet)
Seat 4: Christasm folded before Flop (didn't bet)
Seat 6: Zimniy (button) folded before Flop (didn't bet)



PokerStars Hand #222975789876:  Hold'em No Limit ($0.05/$0.10 USD) - 2021/01/23 17:41:13 ET
Table 'Malzovia' 6-max Seat #1 is the button
Seat 1: Lucky HoBBiT ($24.36 in chips) 
Seat 2: NikosVeniz ($8.99 in chips) 
Seat 3: bin600implus ($27.12 in chips) 
Seat 4: Christasm ($10.08 in chips) 
Seat 6: Zimniy ($10.40 in chips) 
NikosVeniz: posts small blind $0.05
bin600implus: posts big blind $0.10
No1Sparkles: sits out 
*** HOLE CARDS ***
Christasm: folds 
Zimniy: folds 
Lucky HoBBiT: folds 
NikosVeniz: calls $0.05
bin600implus: checks 
*** FLOP *** [Ad 5c As]
NikosVeniz: checks 
bin600implus: bets $0.19
NikosVeniz: folds 
Uncalled bet ($0.19) returned to bin600implus
bin600implus collected $0.19 from pot
bin600implus: doesn't show hand 
*** SUMMARY ***
Total pot $0.20 | Rake $0.01 
Board [Ad 5c As]
Seat 1: Lucky HoBBiT (button) folded before Flop (didn't bet)
Seat 2: NikosVeniz (small blind) folded on the Flop
Seat 3: bin600implus (big blind) collected ($0.19)
Seat 4: Christasm folded before Flop (didn't bet)
Seat 6: Zimniy folded before Flop (didn't bet)



PokerStars Hand #222975812980:  Hold'em No Limit ($0.05/$0.10 USD) - 2021/01/23 17:41:44 ET
Table 'Malzovia' 6-max Seat #2 is the button
Seat 1: Lucky HoBBiT ($24.36 in chips) 
Seat 2: NikosVeniz ($8.89 in chips) 
Seat 3: bin600implus ($27.21 in chips) 
Seat 4: Christasm ($10.08 in chips) 
Seat 6: Zimniy ($10.40 in chips) 
bin600implus: posts small blind $0.05
Christasm: posts big blind $0.10
No1Sparkles: sits out 
*** HOLE CARDS ***
Zimniy: folds 
Lucky HoBBiT: folds 
NikosVeniz: calls $0.10
bin600implus: folds 
Christasm: checks 
*** FLOP *** [Jc Jd Kc]
Christasm: checks 
NikosVeniz: bets $0.12
Christasm: folds 
Uncalled bet ($0.12) returned to NikosVeniz
NikosVeniz collected $0.24 from pot
NikosVeniz: doesn't show hand 
*** SUMMARY ***
Total pot $0.25 | Rake $0.01 
Board [Jc Jd Kc]
Seat 1: Lucky HoBBiT folded before Flop (didn't bet)
Seat 2: NikosVeniz (button) collected ($0.24)
Seat 3: bin600implus (small blind) folded before Flop
Seat 4: Christasm (big blind) folded on the Flop
Seat 6: Zimniy folded before Flop (didn't bet)



PokerStars Hand #222975830897:  Hold'em No Limit ($0.05/$0.10 USD) - 2021/01/23 17:42:07 ET
Table 'Malzovia' 6-max Seat #3 is the button
Seat 1: Lucky HoBBiT ($24.36 in chips) 
Seat 2: NikosVeniz ($9.03 in chips) 
Seat 3: bin600implus ($27.16 in chips) 
Seat 4: Christasm ($10 in chips) 
Seat 5: No1Sparkles ($10 in chips) 
Seat 6: Zimniy ($10.40 in chips) 
Christasm: posts small blind $0.05
No1Sparkles: posts big blind $0.10
*** HOLE CARDS ***
Zimniy: folds 
Lucky HoBBiT: folds 
NikosVeniz: raises $0.10 to $0.20
bin600implus: folds 
Christasm: folds 
No1Sparkles: folds 
Uncalled bet ($0.10) returned to NikosVeniz
NikosVeniz collected $0.25 from pot
NikosVeniz: doesn't show hand 
*** SUMMARY ***
Total pot $0.25 | Rake $0 
Seat 1: Lucky HoBBiT folded before Flop (didn't bet)
Seat 2: NikosVeniz collected ($0.25)
Seat 3: bin600implus (button) folded before Flop (didn't bet)
Seat 4: Christasm (small blind) folded before Flop
Seat 5: No1Sparkles (big blind) folded before Flop
Seat 6: Zimniy folded before Flop (didn't bet)



PokerStars Hand #222975844245:  Hold'em No Limit ($0.05/$0.10 USD) - 2021/01/23 17:42:24 ET
Table 'Malzovia' 6-max Seat #4 is the button
Seat 1: Lucky HoBBiT ($24.36 in chips) 
Seat 2: NikosVeniz ($9.18 in chips) 
Seat 3: bin600implus ($27.16 in chips) 
Seat 4: Christasm ($10 in chips) 
Seat 5: No1Sparkles ($10 in chips) 
Seat 6: Zimniy ($10.40 in chips) 
No1Sparkles: posts small blind $0.05
Zimniy: posts big blind $0.10
*** HOLE CARDS ***
Lucky HoBBiT: raises $0.20 to $0.30
NikosVeniz: calls $0.30
bin600implus: folds 
Christasm: calls $0.30
No1Sparkles: folds 
Zimniy: calls $0.20
*** FLOP *** [Ts 3d 3h]
Zimniy: checks 
Lucky HoBBiT: checks 
NikosVeniz: checks 
Christasm: bets $0.60
Zimniy: folds 
Lucky HoBBiT: folds 
NikosVeniz: folds 
Uncalled bet ($0.60) returned to Christasm
Christasm collected $1.19 from pot
Christasm: doesn't show hand 
*** SUMMARY ***
Total pot $1.25 | Rake $0.06 
Board [Ts 3d 3h]
Seat 1: Lucky HoBBiT folded on the Flop
Seat 2: NikosVeniz folded on the Flop
Seat 3: bin600implus folded before Flop (didn't bet)
Seat 4: Christasm (button) collected ($1.19)
Seat 5: No1Sparkles (small blind) folded before Flop
Seat 6: Zimniy (big blind) folded on the Flop



PokerStars Hand #222975889781:  Hold'em No Limit ($0.05/$0.10 USD) - 2021/01/23 17:43:24 ET
Table 'Malzovia' 6-max Seat #5 is the button
Seat 1: Lucky HoBBiT ($24.06 in chips) 
Seat 2: NikosVeniz ($8.88 in chips) 
Seat 3: bin600implus ($27.16 in chips) 
Seat 4: Christasm ($10.89 in chips) 
Seat 5: No1Sparkles ($10 in chips) 
Seat 6: Zimniy ($10.10 in chips) 
Zimniy: posts small blind $0.05
Lucky HoBBiT: posts big blind $0.10
*** HOLE CARDS ***
NikosVeniz: calls $0.10
bin600implus: raises $0.30 to $0.40
Christasm: folds 
No1Sparkles: folds 
Zimniy: folds 
Lucky HoBBiT: calls $0.30
NikosVeniz: calls $0.30
*** FLOP *** [Ts Kd 3h]
Lucky HoBBiT: checks 
NikosVeniz: checks 
bin600implus: bets $0.59
Lucky HoBBiT: folds 
NikosVeniz: folds 
Uncalled bet ($0.59) returned to bin600implus
bin600implus collected $1.19 from pot
bin600implus: doesn't show hand 
*** SUMMARY ***
Total pot $1.25 | Rake $0.06 
Board [Ts Kd 3h]
Seat 1: Lucky HoBBiT (big blind) folded on the Flop
Seat 2: NikosVeniz folded on the Flop
Seat 3: bin600implus collected ($1.19)
Seat 4: Christasm folded before Flop (didn't bet)
Seat 5: No1Sparkles (button) folded before Flop (didn't bet)
Seat 6: Zimniy (small blind) folded before Flop



PokerStars Hand #222975915097:  Hold'em No Limit ($0.05/$0.10 USD) - 2021/01/23 17:43:57 ET
Table 'Malzovia' 6-max Seat #6 is the button
Seat 1: Lucky HoBBiT ($23.66 in chips) 
Seat 2: NikosVeniz ($8.48 in chips) 
Seat 3: bin600implus ($27.95 in chips) 
Seat 4: Christasm ($10.89 in chips) 
Seat 5: No1Sparkles ($10 in chips) 
Seat 6: Zimniy ($10.05 in chips) 
Lucky HoBBiT: posts small blind $0.05
NikosVeniz: posts big blind $0.10
*** HOLE CARDS ***
bin600implus: folds 
Christasm has timed out
Christasm: folds 
No1Sparkles: raises $0.20 to $0.30
Zimniy: folds 
Lucky HoBBiT: folds 
NikosVeniz: calls $0.20
*** FLOP *** [7d 3d 2d]
NikosVeniz: checks 
No1Sparkles: bets $0.20
NikosVeniz: calls $0.20
*** TURN *** [7d 3d 2d] [3h]
NikosVeniz: bets $0.10
No1Sparkles: calls $0.10
*** RIVER *** [7d 3d 2d 3h] [Th]
NikosVeniz: checks 
No1Sparkles: checks 
*** SHOW DOWN ***
NikosVeniz: shows [9c 7h] (two pair, Sevens and Threes)
No1Sparkles: mucks hand 
NikosVeniz collected $1.19 from pot
*** SUMMARY ***
Total pot $1.25 | Rake $0.06 
Board [7d 3d 2d 3h Th]
Seat 1: Lucky HoBBiT (small blind) folded before Flop
Seat 2: NikosVeniz (big blind) showed [9c 7h] and won ($1.19) with two pair, Sevens and Threes
Seat 3: bin600implus folded before Flop (didn't bet)
Seat 4: Christasm folded before Flop (didn't bet)
Seat 5: No1Sparkles mucked
Seat 6: Zimniy (button) folded before Flop (didn't bet)



PokerStars Hand #222975972533:  Hold'em No Limit ($0.05/$0.10 USD) - 2021/01/23 17:45:13 ET
Table 'Malzovia' 6-max Seat #1 is the button
Seat 1: Lucky HoBBiT ($23.61 in chips) 
Seat 2: NikosVeniz ($9.07 in chips) 
Seat 3: bin600implus ($27.95 in chips) 
Seat 4: Christasm ($10.89 in chips) 
Seat 5: No1Sparkles ($10 in chips) 
Seat 6: Zimniy ($10.05 in chips) 
NikosVeniz: posts small blind $0.05
bin600implus: posts big blind $0.10
*** HOLE CARDS ***
Christasm: folds 
No1Sparkles: folds 
Zimniy: raises $0.15 to $0.25
Lucky HoBBiT: folds 
NikosVeniz: calls $0.20
bin600implus: folds 
*** FLOP *** [Kh Jc Ad]
NikosVeniz: checks 
Zimniy: checks 
*** TURN *** [Kh Jc Ad] [Qd]
NikosVeniz: checks 
Zimniy: bets $0.38
NikosVeniz: folds 
Uncalled bet ($0.38) returned to Zimniy
Zimniy collected $0.57 from pot
Zimniy: doesn't show hand 
*** SUMMARY ***
Total pot $0.60 | Rake $0.03 
Board [Kh Jc Ad Qd]
Seat 1: Lucky HoBBiT (button) folded before Flop (didn't bet)
Seat 2: NikosVeniz (small blind) folded on the Turn
Seat 3: bin600implus (big blind) folded before Flop
Seat 4: Christasm folded before Flop (didn't bet)
Seat 5: No1Sparkles folded before Flop (didn't bet)
Seat 6: Zimniy collected ($0.57)



PokerStars Hand #222976001092:  Hold'em No Limit ($0.05/$0.10 USD) - 2021/01/23 17:45:52 ET
Table 'Malzovia' 6-max Seat #2 is the button
Seat 1: Lucky HoBBiT ($23.61 in chips) 
Seat 2: NikosVeniz ($8.82 in chips) 
Seat 3: bin600implus ($27.85 in chips) 
Seat 4: Christasm ($10.89 in chips) 
Seat 5: No1Sparkles ($10 in chips) 
Seat 6: Zimniy ($10.37 in chips) 
bin600implus: posts small blind $0.05
Christasm: posts big blind $0.10
*** HOLE CARDS ***
No1Sparkles: folds 
Zimniy: folds 
Lucky HoBBiT: folds 
NikosVeniz: folds 
bin600implus: calls $0.05
Christasm: checks 
*** FLOP *** [Td Tc Th]
bin600implus: checks 
Christasm: checks 
*** TURN *** [Td Tc Th] [8c]
bin600implus: checks 
Christasm: bets $0.10
bin600implus: calls $0.10
*** RIVER *** [Td Tc Th 8c] [7d]
bin600implus: checks 
Christasm: checks 
*** SHOW DOWN ***
bin600implus: shows [Jh 5h] (three of a kind, Tens)
Christasm: shows [4c 7c] (a full house, Tens full of Sevens)
Christasm collected $0.38 from pot
*** SUMMARY ***
Total pot $0.40 | Rake $0.02 
Board [Td Tc Th 8c 7d]
Seat 1: Lucky HoBBiT folded before Flop (didn't bet)
Seat 2: NikosVeniz (button) folded before Flop (didn't bet)
Seat 3: bin600implus (small blind) showed [Jh 5h] and lost with three of a kind, Tens
Seat 4: Christasm (big blind) showed [4c 7c] and won ($0.38) with a full house, Tens full of Sevens
Seat 5: No1Sparkles folded before Flop (didn't bet)
Seat 6: Zimniy folded before Flop (didn't bet)



PokerStars Hand #222976440806:  Hold'em No Limit ($0.05/$0.10 USD) - 2021/01/23 17:56:07 ET
Table 'Malzovia' 6-max Seat #6 is the button
Seat 1: Lucky HoBBiT ($24.27 in chips) 
Seat 2: NikosVeniz ($14.26 in chips) 
Seat 3: bin600implus ($27.92 in chips) 
Seat 4: Christasm ($10 in chips) 
Seat 5: No1Sparkles ($10 in chips) 
Seat 6: Zimniy ($10 in chips) 
Lucky HoBBiT: posts small blind $0.05
NikosVeniz: posts big blind $0.10
*** HOLE CARDS ***
bin600implus: folds 
Christasm: folds 
No1Sparkles: raises $0.20 to $0.30
Zimniy: folds 
Lucky HoBBiT: folds 
NikosVeniz: calls $0.20
*** FLOP *** [Kc Td 9d]
NikosVeniz: checks 
No1Sparkles: bets $0.31
NikosVeniz: folds 
Uncalled bet ($0.31) returned to No1Sparkles
No1Sparkles collected $0.62 from pot
No1Sparkles: doesn't show hand 
*** SUMMARY ***
Total pot $0.65 | Rake $0.03 
Board [Kc Td 9d]
Seat 1: Lucky HoBBiT (small blind) folded before Flop
Seat 2: NikosVeniz (big blind) folded on the Flop
Seat 3: bin600implus folded before Flop (didn't bet)
Seat 4: Christasm folded before Flop (didn't bet)
Seat 5: No1Sparkles collected ($0.62)
Seat 6: Zimniy (button) folded before Flop (didn't bet)



PokerStars Hand #222976461099:  Hold'em No Limit ($0.05/$0.10 USD) - 2021/01/23 17:56:45 ET
Table 'Malzovia' 6-max Seat #1 is the button
Seat 1: Lucky HoBBiT ($24.22 in chips) 
Seat 2: NikosVeniz ($13.96 in chips) 
Seat 3: bin600implus ($27.92 in chips) 
Seat 4: Christasm ($10 in chips) 
Seat 5: No1Sparkles ($10.32 in chips) 
Seat 6: Zimniy ($10 in chips) 
NikosVeniz: posts small blind $0.05
bin600implus: posts big blind $0.10
*** HOLE CARDS ***
Christasm: folds 
No1Sparkles: folds 
Zimniy: raises $0.15 to $0.25
Lucky HoBBiT: folds 
NikosVeniz: raises $0.15 to $0.40
bin600implus: folds 
Zimniy: raises $1.20 to $1.60
NikosVeniz: calls $1.20
*** FLOP *** [3h Jh 6s]
NikosVeniz: bets $0.10
Zimniy: calls $0.10
*** TURN *** [3h Jh 6s] [4d]
NikosVeniz: bets $1.67
Zimniy: folds 
Uncalled bet ($1.67) returned to NikosVeniz
NikosVeniz collected $3.34 from pot
NikosVeniz: doesn't show hand 
*** SUMMARY ***
Total pot $3.50 | Rake $0.16 
Board [3h Jh 6s 4d]
Seat 1: Lucky HoBBiT (button) folded before Flop (didn't bet)
Seat 2: NikosVeniz (small blind) collected ($3.34)
Seat 3: bin600implus (big blind) folded before Flop
Seat 4: Christasm folded before Flop (didn't bet)
Seat 5: No1Sparkles folded before Flop (didn't bet)
Seat 6: Zimniy folded on the Turn



PokerStars Hand #222976488926:  Hold'em No Limit ($0.05/$0.10 USD) - 2021/01/23 17:57:37 ET
Table 'Malzovia' 6-max Seat #2 is the button
Seat 1: Lucky HoBBiT ($24.22 in chips) 
Seat 2: NikosVeniz ($15.60 in chips) 
Seat 3: bin600implus ($27.82 in chips) 
Seat 4: Christasm ($10 in chips) 
Seat 5: No1Sparkles ($10.32 in chips) 
Seat 6: Zimniy ($10 in chips) 
bin600implus: posts small blind $0.05
Christasm: posts big blind $0.10
*** HOLE CARDS ***
No1Sparkles: folds 
Zimniy: folds 
Lucky HoBBiT: folds 
NikosVeniz: folds 
bin600implus: raises $0.20 to $0.30
Christasm: calls $0.20
*** FLOP *** [4s Jd 2s]
bin600implus: bets $0.28
Christasm: folds 
Uncalled bet ($0.28) returned to bin600implus
bin600implus collected $0.57 from pot
*** SUMMARY ***
Total pot $0.60 | Rake $0.03 
Board [4s Jd 2s]
Seat 1: Lucky HoBBiT folded before Flop (didn't bet)
Seat 2: NikosVeniz (button) folded before Flop (didn't bet)
Seat 3: bin600implus (small blind) collected ($0.57)
Seat 4: Christasm (big blind) folded on the Flop
Seat 5: No1Sparkles folded before Flop (didn't bet)
Seat 6: Zimniy folded before Flop (didn't bet)



PokerStars Hand #222976506541:  Hold'em No Limit ($0.05/$0.10 USD) - 2021/01/23 17:58:10 ET
Table 'Malzovia' 6-max Seat #3 is the button
Seat 1: Lucky HoBBiT ($24.22 in chips) 
Seat 2: NikosVeniz ($15.60 in chips) 
Seat 3: bin600implus ($28.09 in chips) 
Seat 4: Christasm ($10 in chips) 
Seat 5: No1Sparkles ($10.32 in chips) 
Seat 6: Zimniy ($10 in chips) 
Christasm: posts small blind $0.05
No1Sparkles: posts big blind $0.10
*** HOLE CARDS ***
Zimniy: folds 
Lucky HoBBiT: raises $0.20 to $0.30
NikosVeniz: folds 
bin600implus: calls $0.30
Christasm: folds 
No1Sparkles: calls $0.20
*** FLOP *** [As 9c 4c]
No1Sparkles: checks 
Lucky HoBBiT: bets $0.62
bin600implus: calls $0.62
No1Sparkles: folds 
*** TURN *** [As 9c 4c] [3c]
Lucky HoBBiT: checks 
bin600implus: bets $1.04
Lucky HoBBiT: folds 
Uncalled bet ($1.04) returned to bin600implus
bin600implus collected $2.09 from pot
bin600implus: doesn't show hand 
*** SUMMARY ***
Total pot $2.19 | Rake $0.10 
Board [As 9c 4c 3c]
Seat 1: Lucky HoBBiT folded on the Turn
Seat 2: NikosVeniz folded before Flop (didn't bet)
Seat 3: bin600implus (button) collected ($2.09)
Seat 4: Christasm (small blind) folded before Flop
Seat 5: No1Sparkles (big blind) folded on the Flop
Seat 6: Zimniy folded before Flop (didn't bet)



PokerStars Hand #222976529284:  Hold'em No Limit ($0.05/$0.10 USD) - 2021/01/23 17:58:53 ET
Table 'Malzovia' 6-max Seat #4 is the button
Seat 1: Lucky HoBBiT ($23.30 in chips) 
Seat 2: NikosVeniz ($15.60 in chips) 
Seat 3: bin600implus ($29.26 in chips) 
Seat 4: Christasm ($10 in chips) 
Seat 5: No1Sparkles ($10.02 in chips) 
Seat 6: Zimniy ($10 in chips) 
No1Sparkles: posts small blind $0.05
Zimniy: posts big blind $0.10
*** HOLE CARDS ***
Lucky HoBBiT: folds 
NikosVeniz: calls $0.10
bin600implus: calls $0.10
Christasm: raises $0.45 to $0.55
No1Sparkles: folds 
Zimniy: folds 
NikosVeniz: folds 
bin600implus: folds 
Uncalled bet ($0.45) returned to Christasm
Christasm collected $0.45 from pot
Christasm: doesn't show hand 
*** SUMMARY ***
Total pot $0.45 | Rake $0 
Seat 1: Lucky HoBBiT folded before Flop (didn't bet)
Seat 2: NikosVeniz folded before Flop
Seat 3: bin600implus folded before Flop
Seat 4: Christasm (button) collected ($0.45)
Seat 5: No1Sparkles (small blind) folded before Flop
Seat 6: Zimniy (big blind) folded before Flop



PokerStars Hand #222976539766:  Hold'em No Limit ($0.05/$0.10 USD) - 2021/01/23 17:59:12 ET
Table 'Malzovia' 6-max Seat #5 is the button
Seat 1: Lucky HoBBiT ($23.30 in chips) 
Seat 2: NikosVeniz ($15.50 in chips) 
Seat 3: bin600implus ($29.16 in chips) 
Seat 4: Christasm ($10.35 in chips) 
Seat 5: No1Sparkles ($10 in chips) 
Seat 6: Zimniy ($10 in chips) 
Zimniy: posts small blind $0.05
Lucky HoBBiT: posts big blind $0.10
*** HOLE CARDS ***
NikosVeniz: folds 
bin600implus: folds 
Christasm: raises $0.20 to $0.30
No1Sparkles: folds 
Zimniy: folds 
Lucky HoBBiT: folds 
Uncalled bet ($0.20) returned to Christasm
Christasm collected $0.25 from pot
Christasm: doesn't show hand 
*** SUMMARY ***
Total pot $0.25 | Rake $0 
Seat 1: Lucky HoBBiT (big blind) folded before Flop
Seat 2: NikosVeniz folded before Flop (didn't bet)
Seat 3: bin600implus folded before Flop (didn't bet)
Seat 4: Christasm collected ($0.25)
Seat 5: No1Sparkles (button) folded before Flop (didn't bet)
Seat 6: Zimniy (small blind) folded before Flop



PokerStars Hand #222976550465:  Hold'em No Limit ($0.05/$0.10 USD) - 2021/01/23 17:59:24 ET
Table 'Malzovia' 6-max Seat #6 is the button
Seat 1: Lucky HoBBiT ($23.20 in chips) 
Seat 2: NikosVeniz ($15.50 in chips) 
Seat 3: bin600implus ($29.16 in chips) 
Seat 4: Christasm ($10.50 in chips) 
Seat 5: No1Sparkles ($10 in chips) 
Seat 6: Zimniy ($10 in chips) 
Lucky HoBBiT: posts small blind $0.05
NikosVeniz: posts big blind $0.10
*** HOLE CARDS ***
bin600implus: folds 
Christasm: raises $0.20 to $0.30
No1Sparkles: calls $0.30
Zimniy: folds 
Lucky HoBBiT: folds 
NikosVeniz: folds 
*** FLOP *** [Qc Ks 2h]
Christasm: bets $0.36
No1Sparkles: folds 
Uncalled bet ($0.36) returned to Christasm
Christasm collected $0.72 from pot
Christasm: doesn't show hand 
*** SUMMARY ***
Total pot $0.75 | Rake $0.03 
Board [Qc Ks 2h]
Seat 1: Lucky HoBBiT (small blind) folded before Flop
Seat 2: NikosVeniz (big blind) folded before Flop
Seat 3: bin600implus folded before Flop (didn't bet)
Seat 4: Christasm collected ($0.72)
Seat 5: No1Sparkles folded on the Flop
Seat 6: Zimniy (button) folded before Flop (didn't bet)



PokerStars Hand #222976563153:  Hold'em No Limit ($0.05/$0.10 USD) - 2021/01/23 17:59:48 ET
Table 'Malzovia' 6-max Seat #1 is the button
Seat 1: Lucky HoBBiT ($23.15 in chips) 
Seat 2: NikosVeniz ($15.40 in chips) 
Seat 3: bin600implus ($29.16 in chips) 
Seat 4: Christasm ($10.92 in chips) 
Seat 5: No1Sparkles ($10 in chips) 
Seat 6: Zimniy ($10 in chips) 
NikosVeniz: posts small blind $0.05
bin600implus: posts big blind $0.10
*** HOLE CARDS ***
Christasm: folds 
No1Sparkles: folds 
Zimniy: folds 
Lucky HoBBiT: folds 
NikosVeniz: calls $0.05
bin600implus: raises $0.20 to $0.30
NikosVeniz: calls $0.20
*** FLOP *** [6d 4c As]
NikosVeniz: checks 
bin600implus: bets $0.57
NikosVeniz: folds 
Uncalled bet ($0.57) returned to bin600implus
bin600implus collected $0.57 from pot
bin600implus: doesn't show hand 
*** SUMMARY ***
Total pot $0.60 | Rake $0.03 
Board [6d 4c As]
Seat 1: Lucky HoBBiT (button) folded before Flop (didn't bet)
Seat 2: NikosVeniz (small blind) folded on the Flop
Seat 3: bin600implus (big blind) collected ($0.57)
Seat 4: Christasm folded before Flop (didn't bet)
Seat 5: No1Sparkles folded before Flop (didn't bet)
Seat 6: Zimniy folded before Flop (didn't bet)



PokerStars Hand #222976586122:  Hold'em No Limit ($0.05/$0.10 USD) - 2021/01/23 18:00:29 ET
Table 'Malzovia' 6-max Seat #2 is the button
Seat 2: NikosVeniz ($15.10 in chips) 
Seat 3: bin600implus ($29.43 in chips) 
Seat 5: No1Sparkles ($10 in chips) 
Seat 6: Zimniy ($10 in chips) 
bin600implus: posts small blind $0.05
Christasm: is sitting out 
No1Sparkles: posts big blind $0.10
*** HOLE CARDS ***
Zimniy: folds 
NikosVeniz: raises $0.10 to $0.20
bin600implus: calls $0.15
No1Sparkles: folds 
*** FLOP *** [Jd 8d 6h]
bin600implus: checks 
NikosVeniz: bets $0.24
bin600implus: folds 
Uncalled bet ($0.24) returned to NikosVeniz
NikosVeniz collected $0.48 from pot
NikosVeniz: doesn't show hand 
*** SUMMARY ***
Total pot $0.50 | Rake $0.02 
Board [Jd 8d 6h]
Seat 2: NikosVeniz (button) collected ($0.48)
Seat 3: bin600implus (small blind) folded on the Flop
Seat 5: No1Sparkles (big blind) folded before Flop
Seat 6: Zimniy folded before Flop (didn't bet)



PokerStars Hand #222976616207:  Hold'em No Limit ($0.05/$0.10 USD) - 2021/01/23 18:01:17 ET
Table 'Malzovia' 6-max Seat #3 is the button
Seat 2: NikosVeniz ($15.38 in chips) 
Seat 3: bin600implus ($29.23 in chips) 
Seat 5: No1Sparkles ($10 in chips) 
Seat 6: Zimniy ($10 in chips) 
No1Sparkles: posts small blind $0.05
Zimniy: posts big blind $0.10
*** HOLE CARDS ***
NikosVeniz: folds 
bin600implus: folds 
No1Sparkles: folds 
Uncalled bet ($0.05) returned to Zimniy
Zimniy collected $0.10 from pot
Zimniy: doesn't show hand 
*** SUMMARY ***
Total pot $0.10 | Rake $0 
Seat 2: NikosVeniz folded before Flop (didn't bet)
Seat 3: bin600implus (button) folded before Flop (didn't bet)
Seat 5: No1Sparkles (small blind) folded before Flop
Seat 6: Zimniy (big blind) collected ($0.10)



PokerStars Hand #222976625420:  Hold'em No Limit ($0.05/$0.10 USD) - 2021/01/23 18:01:31 ET
Table 'Malzovia' 6-max Seat #5 is the button
Seat 2: NikosVeniz ($15.38 in chips) 
Seat 3: bin600implus ($29.23 in chips) 
Seat 5: No1Sparkles ($10 in chips) 
Seat 6: Zimniy ($10.05 in chips) 
Zimniy: posts small blind $0.05
NikosVeniz: posts big blind $0.10
*** HOLE CARDS ***
bin600implus: folds 
No1Sparkles: raises $0.20 to $0.30
Zimniy: folds 
NikosVeniz: calls $0.20
*** FLOP *** [7s 2s Jd]
NikosVeniz: checks 
No1Sparkles: checks 
*** TURN *** [7s 2s Jd] [6h]
NikosVeniz: checks 
No1Sparkles: checks 
*** RIVER *** [7s 2s Jd 6h] [8h]
NikosVeniz: checks 
No1Sparkles: bets $0.47
NikosVeniz: folds 
Uncalled bet ($0.47) returned to No1Sparkles
No1Sparkles collected $0.62 from pot
No1Sparkles: doesn't show hand 
*** SUMMARY ***
Total pot $0.65 | Rake $0.03 
Board [7s 2s Jd 6h 8h]
Seat 2: NikosVeniz (big blind) folded on the River
Seat 3: bin600implus folded before Flop (didn't bet)
Seat 5: No1Sparkles (button) collected ($0.62)
Seat 6: Zimniy (small blind) folded before Flop



PokerStars Hand #222976651427:  Hold'em No Limit ($0.05/$0.10 USD) - 2021/01/23 18:02:10 ET
Table 'Malzovia' 6-max Seat #6 is the button
Seat 2: NikosVeniz ($15.08 in chips) 
Seat 3: bin600implus ($29.23 in chips) 
Seat 5: No1Sparkles ($10.32 in chips) 
Seat 6: Zimniy ($10 in chips) 
NikosVeniz: posts small blind $0.05
bin600implus: posts big blind $0.10
*** HOLE CARDS ***
No1Sparkles: folds 
Zimniy: folds 
NikosVeniz: calls $0.05
bin600implus: raises $0.20 to $0.30
NikosVeniz: calls $0.20
*** FLOP *** [9c Th 8d]
NikosVeniz: checks 
bin600implus: bets $0.28
NikosVeniz: calls $0.28
*** TURN *** [9c Th 8d] [6h]
NikosVeniz: bets $0.10
bin600implus: raises $0.70 to $0.80
NikosVeniz: raises $0.70 to $1.50
bin600implus: raises $3 to $4.50
NikosVeniz: raises $3 to $7.50
bin600implus: raises $21.15 to $28.65 and is all-in
NikosVeniz: calls $7 and is all-in
Uncalled bet ($14.15) returned to bin600implus
*** RIVER *** [9c Th 8d 6h] [Ah]
*** SHOW DOWN ***
NikosVeniz: shows [Jh 7c] (a straight, Seven to Jack)
bin600implus: shows [7h 7d] (a straight, Six to Ten)
NikosVeniz collected $29.16 from pot
bin600implus cashed out the hand for $0.98 | Cash Out Fee $0.01
*** SUMMARY ***
Total pot $30.16 | Rake $1 
Board [9c Th 8d 6h Ah]
Seat 2: NikosVeniz (small blind) showed [Jh 7c] and won ($29.16) with a straight, Seven to Jack
Seat 3: bin600implus (big blind) showed [7h 7d] and lost with a straight, Six to Ten (cashed out).
Seat 5: No1Sparkles folded before Flop (didn't bet)
Seat 6: Zimniy (button) folded before Flop (didn't bet)



PokerStars Hand #222976734451:  Hold'em No Limit ($0.05/$0.10 USD) - 2021/01/23 18:04:08 ET
Table 'Malzovia' 6-max Seat #2 is the button
Seat 2: NikosVeniz ($29.16 in chips) 
Seat 3: bin600implus ($15.13 in chips) 
Seat 5: No1Sparkles ($10.32 in chips) 
Seat 6: Zimniy ($10 in chips) 
bin600implus: posts small blind $0.05
No1Sparkles: posts big blind $0.10
Lucky HoBBiT: sits out 
*** HOLE CARDS ***
Zimniy: folds 
NikosVeniz: folds 
bin600implus: raises $0.20 to $0.30
No1Sparkles: folds 
Uncalled bet ($0.20) returned to bin600implus
bin600implus collected $0.20 from pot
bin600implus: doesn't show hand 
*** SUMMARY ***
Total pot $0.20 | Rake $0 
Seat 2: NikosVeniz (button) folded before Flop (didn't bet)
Seat 3: bin600implus (small blind) collected ($0.20)
Seat 5: No1Sparkles (big blind) folded before Flop
Seat 6: Zimniy folded before Flop (didn't bet)



PokerStars Hand #222976745663:  Hold'em No Limit ($0.05/$0.10 USD) - 2021/01/23 18:04:24 ET
Table 'Malzovia' 6-max Seat #3 is the button
Seat 2: NikosVeniz ($29.16 in chips) 
Seat 3: bin600implus ($15.23 in chips) 
Seat 5: No1Sparkles ($10.22 in chips) 
Seat 6: Zimniy ($10 in chips) 
No1Sparkles: posts small blind $0.05
Zimniy: posts big blind $0.10
Lucky HoBBiT: sits out 
*** HOLE CARDS ***
NikosVeniz: folds 
bin600implus: raises $0.20 to $0.30
No1Sparkles: folds 
Zimniy: folds 
Uncalled bet ($0.20) returned to bin600implus
bin600implus collected $0.25 from pot
bin600implus: doesn't show hand 
*** SUMMARY ***
Total pot $0.25 | Rake $0 
Seat 2: NikosVeniz folded before Flop (didn't bet)
Seat 3: bin600implus (button) collected ($0.25)
Seat 5: No1Sparkles (small blind) folded before Flop
Seat 6: Zimniy (big blind) folded before Flop



PokerStars Hand #222976760302:  Hold'em No Limit ($0.05/$0.10 USD) - 2021/01/23 18:04:45 ET
Table 'Malzovia' 6-max Seat #5 is the button
Seat 1: Lucky HoBBiT ($23.15 in chips) 
Seat 2: NikosVeniz ($29.16 in chips) 
Seat 3: bin600implus ($15.38 in chips) 
Seat 5: No1Sparkles ($10.17 in chips) 
Seat 6: Zimniy ($10 in chips) 
Zimniy: posts small blind $0.05
Lucky HoBBiT: posts big blind $0.10
*** HOLE CARDS ***
NikosVeniz has timed out
NikosVeniz: folds 
bin600implus: folds 
No1Sparkles: raises $0.20 to $0.30
Zimniy: folds 
Lucky HoBBiT: folds 
Uncalled bet ($0.20) returned to No1Sparkles
No1Sparkles collected $0.25 from pot
No1Sparkles: doesn't show hand 
*** SUMMARY ***
Total pot $0.25 | Rake $0 
Seat 1: Lucky HoBBiT (big blind) folded before Flop
Seat 2: NikosVeniz folded before Flop (didn't bet)
Seat 3: bin600implus folded before Flop (didn't bet)
Seat 5: No1Sparkles (button) collected ($0.25)
Seat 6: Zimniy (small blind) folded before Flop



PokerStars Hand #222976776732:  Hold'em No Limit ($0.05/$0.10 USD) - 2021/01/23 18:05:08 ET
Table 'Malzovia' 6-max Seat #6 is the button
Seat 1: Lucky HoBBiT ($23.05 in chips) 
Seat 2: NikosVeniz ($29.16 in chips) 
Seat 3: bin600implus ($15.38 in chips) 
Seat 5: No1Sparkles ($10.32 in chips) 
Seat 6: Zimniy ($10 in chips) 
Lucky HoBBiT: posts small blind $0.05
NikosVeniz: posts big blind $0.10
*** HOLE CARDS ***
bin600implus: folds 
No1Sparkles: folds 
Zimniy: folds 
Lucky HoBBiT: raises $0.20 to $0.30
NikosVeniz: calls $0.20
*** FLOP *** [6s Qd Ah]
Lucky HoBBiT: checks 
NikosVeniz: checks 
*** TURN *** [6s Qd Ah] [9s]
Lucky HoBBiT: bets $0.57
NikosVeniz: folds 
Uncalled bet ($0.57) returned to Lucky HoBBiT
Lucky HoBBiT collected $0.57 from pot
Lucky HoBBiT: doesn't show hand 
*** SUMMARY ***
Total pot $0.60 | Rake $0.03 
Board [6s Qd Ah 9s]
Seat 1: Lucky HoBBiT (small blind) collected ($0.57)
Seat 2: NikosVeniz (big blind) folded on the Turn
Seat 3: bin600implus folded before Flop (didn't bet)
Seat 5: No1Sparkles folded before Flop (didn't bet)
Seat 6: Zimniy (button) folded before Flop (didn't bet)



PokerStars Hand #222976797135:  Hold'em No Limit ($0.05/$0.10 USD) - 2021/01/23 18:05:36 ET
Table 'Malzovia' 6-max Seat #1 is the button
Seat 1: Lucky HoBBiT ($23.32 in chips) 
Seat 2: NikosVeniz ($28.86 in chips) 
Seat 3: bin600implus ($15.38 in chips) 
Seat 5: No1Sparkles ($10.32 in chips) 
Seat 6: Zimniy ($10 in chips) 
NikosVeniz: posts small blind $0.05
bin600implus: posts big blind $0.10
*** HOLE CARDS ***
No1Sparkles: folds 
Zimniy: raises $0.15 to $0.25
Lucky HoBBiT: calls $0.25
NikosVeniz: calls $0.20
bin600implus: calls $0.15
*** FLOP *** [7s Jc 3h]
NikosVeniz: bets $0.48
bin600implus: folds 
Zimniy: folds 
Lucky HoBBiT: calls $0.48
*** TURN *** [7s Jc 3h] [Js]
NikosVeniz: checks 
Lucky HoBBiT: checks 
*** RIVER *** [7s Jc 3h Js] [9h]
NikosVeniz: checks 
Lucky HoBBiT: bets $1.45
NikosVeniz: folds 
Uncalled bet ($1.45) returned to Lucky HoBBiT
Lucky HoBBiT collected $1.87 from pot
Lucky HoBBiT: doesn't show hand 
*** SUMMARY ***
Total pot $1.96 | Rake $0.09 
Board [7s Jc 3h Js 9h]
Seat 1: Lucky HoBBiT (button) collected ($1.87)
Seat 2: NikosVeniz (small blind) folded on the River
Seat 3: bin600implus (big blind) folded on the Flop
Seat 5: No1Sparkles folded before Flop (didn't bet)
Seat 6: Zimniy folded on the Flop



PokerStars Hand #222976842903:  Hold'em No Limit ($0.05/$0.10 USD) - 2021/01/23 18:06:42 ET
Table 'Malzovia' 6-max Seat #2 is the button
Seat 1: Lucky HoBBiT ($24.46 in chips) 
Seat 2: NikosVeniz ($28.13 in chips) 
Seat 3: bin600implus ($15.13 in chips) 
Seat 5: No1Sparkles ($10.32 in chips) 
Seat 6: Zimniy ($10 in chips) 
bin600implus: posts small blind $0.05
No1Sparkles: posts big blind $0.10
*** HOLE CARDS ***
Zimniy: folds 
Lucky HoBBiT: folds 
NikosVeniz: calls $0.10
bin600implus: calls $0.05
No1Sparkles has timed out
No1Sparkles: checks 
*** FLOP *** [3h 6h 5d]
bin600implus: checks 
No1Sparkles has timed out
No1Sparkles: checks 
NikosVeniz: checks 
*** TURN *** [3h 6h 5d] [8s]
bin600implus: checks 
No1Sparkles has timed out
No1Sparkles: checks 
NikosVeniz: bets $0.14
bin600implus: folds 
No1Sparkles has timed out
No1Sparkles: folds 
Uncalled bet ($0.14) returned to NikosVeniz
NikosVeniz collected $0.29 from pot
NikosVeniz: doesn't show hand 
*** SUMMARY ***
Total pot $0.30 | Rake $0.01 
Board [3h 6h 5d 8s]
Seat 1: Lucky HoBBiT folded before Flop (didn't bet)
Seat 2: NikosVeniz (button) collected ($0.29)
Seat 3: bin600implus (small blind) folded on the Turn
Seat 5: No1Sparkles (big blind) folded on the Turn
Seat 6: Zimniy folded before Flop (didn't bet)



PokerStars Hand #222976950070:  Hold'em No Limit ($0.05/$0.10 USD) - 2021/01/23 18:09:15 ET
Table 'Malzovia' 6-max Seat #3 is the button
Seat 1: Lucky HoBBiT ($24.46 in chips) 
Seat 2: NikosVeniz ($28.32 in chips) 
Seat 3: bin600implus ($15.03 in chips) 
Seat 6: Zimniy ($10 in chips) 
Zimniy: posts small blind $0.05
Lucky HoBBiT: posts big blind $0.10
*** HOLE CARDS ***
NikosVeniz: calls $0.10
bin600implus: calls $0.10
Zimniy: folds 
Lucky HoBBiT: checks 
*** FLOP *** [2h Jc Ah]
Lucky HoBBiT: checks 
NikosVeniz: checks 
bin600implus: checks 
*** TURN *** [2h Jc Ah] [Ac]
Lucky HoBBiT: bets $0.33
NikosVeniz: folds 
bin600implus: folds 
Uncalled bet ($0.33) returned to Lucky HoBBiT
Lucky HoBBiT collected $0.33 from pot
Lucky HoBBiT: doesn't show hand 
*** SUMMARY ***
Total pot $0.35 | Rake $0.02 
Board [2h Jc Ah Ac]
Seat 1: Lucky HoBBiT (big blind) collected ($0.33)
Seat 2: NikosVeniz folded on the Turn
Seat 3: bin600implus (button) folded on the Turn
Seat 6: Zimniy (small blind) folded before Flop



PokerStars Hand #222976990813:  Hold'em No Limit ($0.05/$0.10 USD) - 2021/01/23 18:09:56 ET
Table 'Malzovia' 6-max Seat #6 is the button
Seat 1: Lucky HoBBiT ($24.69 in chips) 
Seat 3: bin600implus ($14.93 in chips) 
Seat 6: Zimniy ($10 in chips) 
Lucky HoBBiT: posts small blind $0.05
bin600implus: posts big blind $0.10
Christasm: sits out 
*** HOLE CARDS ***
NikosVeniz leaves the table
Zimniy: raises $0.15 to $0.25
Lucky HoBBiT: folds 
bin600implus: calls $0.15
*** FLOP *** [2h 8h 4h]
bin600implus: checks 
Zimniy: bets $0.27
bin600implus: folds 
Uncalled bet ($0.27) returned to Zimniy
Zimniy collected $0.53 from pot
Zimniy: doesn't show hand 
*** SUMMARY ***
Total pot $0.55 | Rake $0.02 
Board [2h 8h 4h]
Seat 1: Lucky HoBBiT (small blind) folded before Flop
Seat 3: bin600implus (big blind) folded on the Flop
Seat 6: Zimniy (button) collected ($0.53)



PokerStars Hand #222977009592:  Hold'em No Limit ($0.05/$0.10 USD) - 2021/01/23 18:10:24 ET
Table 'Malzovia' 6-max Seat #1 is the button
Seat 1: Lucky HoBBiT ($24.64 in chips) 
Seat 3: bin600implus ($14.68 in chips) 
Seat 4: Christasm ($10.92 in chips) 
Seat 6: Zimniy ($10.28 in chips) 
cwie210 joins the table at seat #2 
bin600implus: posts small blind $0.05
Christasm: posts big blind $0.10
*** HOLE CARDS ***
Zimniy: folds 
Lucky HoBBiT: raises $0.15 to $0.25
bin600implus: calls $0.20
Christasm: folds 
*** FLOP *** [9d Ks 6c]
bin600implus: checks 
Lucky HoBBiT: bets $0.39
bin600implus: folds 
Uncalled bet ($0.39) returned to Lucky HoBBiT
Lucky HoBBiT collected $0.57 from pot
Lucky HoBBiT: doesn't show hand 
*** SUMMARY ***
Total pot $0.60 | Rake $0.03 
Board [9d Ks 6c]
Seat 1: Lucky HoBBiT (button) collected ($0.57)
Seat 3: bin600implus (small blind) folded on the Flop
Seat 4: Christasm (big blind) folded before Flop
Seat 6: Zimniy folded before Flop (didn't bet)



PokerStars Hand #222977024366:  Hold'em No Limit ($0.05/$0.10 USD) - 2021/01/23 18:10:45 ET
Table 'Malzovia' 6-max Seat #3 is the button
Seat 2: cwie210 ($8 in chips) 
Seat 3: bin600implus ($14.43 in chips) 
Seat 4: Christasm ($10.82 in chips) 
Christasm: posts small blind $0.05
Zimniy: is sitting out 
Lucky HoBBiT: is sitting out 
cwie210: posts big blind $0.10
*** HOLE CARDS ***
Zimniy leaves the table
bin600implus: raises $0.20 to $0.30
Lucky HoBBiT leaves the table
Christasm: folds 
cwie210 is disconnected 
cwie210 has timed out while disconnected
cwie210: folds 
Uncalled bet ($0.20) returned to bin600implus
bin600implus collected $0.25 from pot
bin600implus: doesn't show hand 
*** SUMMARY ***
Total pot $0.25 | Rake $0 
Seat 2: cwie210 (big blind) folded before Flop
Seat 3: bin600implus (button) collected ($0.25)
Seat 4: Christasm (small blind) folded before Flop



PokerStars Hand #222977042155:  Hold'em No Limit ($0.05/$0.10 USD) - 2021/01/23 18:11:11 ET
Table 'Malzovia' 6-max Seat #4 is the button
Seat 3: bin600implus ($14.58 in chips) 
Seat 4: Christasm ($10.77 in chips) 
Christasm: posts small blind $0.05
bin600implus: posts big blind $0.10
*** HOLE CARDS ***
Christasm: raises $0.10 to $0.20
bin600implus: calls $0.10
*** FLOP *** [8c 7c Kc]
bin600implus: checks 
Christasm: checks 
*** TURN *** [8c 7c Kc] [6s]
bin600implus: checks 
Christasm: checks 
*** RIVER *** [8c 7c Kc 6s] [9d]
bin600implus: bets $0.38
Christasm: folds 
Uncalled bet ($0.38) returned to bin600implus
bin600implus collected $0.38 from pot
bin600implus: doesn't show hand 
*** SUMMARY ***
Total pot $0.40 | Rake $0.02 
Board [8c 7c Kc 6s 9d]
Seat 3: bin600implus (big blind) collected ($0.38)
Seat 4: Christasm (button) (small blind) folded on the River



PokerStars Hand #222976038498:  Hold'em No Limit ($0.05/$0.10 USD) - 2021/01/23 17:46:41 ET
Table 'Malzovia' 6-max Seat #3 is the button
Seat 1: Lucky HoBBiT ($23.61 in chips) 
Seat 2: NikosVeniz ($8.82 in chips) 
Seat 3: bin600implus ($27.65 in chips) 
Seat 4: Christasm ($11.07 in chips) 
Seat 5: No1Sparkles ($10 in chips) 
Seat 6: Zimniy ($10.37 in chips) 
Christasm: posts small blind $0.05
No1Sparkles: posts big blind $0.10
*** HOLE CARDS ***
Zimniy: folds 
Lucky HoBBiT: folds 
NikosVeniz: calls $0.10
bin600implus: raises $0.30 to $0.40
Christasm: calls $0.35
No1Sparkles: folds 
NikosVeniz: calls $0.30
*** FLOP *** [5s Kc 8d]
Christasm: checks 
NikosVeniz: bets $0.10
bin600implus: raises $0.92 to $1.02
Christasm: calls $1.02
NikosVeniz: calls $0.92
*** TURN *** [5s Kc 8d] [8c]
Christasm: checks 
NikosVeniz: bets $2.08
bin600implus: folds 
Christasm: calls $2.08
*** RIVER *** [5s Kc 8d 8c] [9c]
Christasm: checks 
NikosVeniz: bets $5.32 and is all-in
Christasm: folds 
Uncalled bet ($5.32) returned to NikosVeniz
NikosVeniz collected $8.14 from pot
NikosVeniz: doesn't show hand 
*** SUMMARY ***
Total pot $8.52 | Rake $0.38 
Board [5s Kc 8d 8c 9c]
Seat 1: Lucky HoBBiT folded before Flop (didn't bet)
Seat 2: NikosVeniz collected ($8.14)
Seat 3: bin600implus (button) folded on the Turn
Seat 4: Christasm (small blind) folded on the River
Seat 5: No1Sparkles (big blind) folded before Flop
Seat 6: Zimniy folded before Flop (didn't bet)



PokerStars Hand #222976096899:  Hold'em No Limit ($0.05/$0.10 USD) - 2021/01/23 17:48:00 ET
Table 'Malzovia' 6-max Seat #4 is the button
Seat 1: Lucky HoBBiT ($23.61 in chips) 
Seat 2: NikosVeniz ($13.46 in chips) 
Seat 3: bin600implus ($26.23 in chips) 
Seat 4: Christasm ($10 in chips) 
Seat 5: No1Sparkles ($10 in chips) 
Seat 6: Zimniy ($10.37 in chips) 
No1Sparkles: posts small blind $0.05
Zimniy: posts big blind $0.10
*** HOLE CARDS ***
Lucky HoBBiT: folds 
NikosVeniz: calls $0.10
bin600implus: folds 
Christasm: raises $0.40 to $0.50
No1Sparkles: folds 
Zimniy: folds 
NikosVeniz: folds 
Uncalled bet ($0.40) returned to Christasm
Christasm collected $0.35 from pot
Christasm: doesn't show hand 
*** SUMMARY ***
Total pot $0.35 | Rake $0 
Seat 1: Lucky HoBBiT folded before Flop (didn't bet)
Seat 2: NikosVeniz folded before Flop
Seat 3: bin600implus folded before Flop (didn't bet)
Seat 4: Christasm (button) collected ($0.35)
Seat 5: No1Sparkles (small blind) folded before Flop
Seat 6: Zimniy (big blind) folded before Flop



PokerStars Hand #222976115524:  Hold'em No Limit ($0.05/$0.10 USD) - 2021/01/23 17:48:25 ET
Table 'Malzovia' 6-max Seat #5 is the button
Seat 1: Lucky HoBBiT ($23.61 in chips) 
Seat 2: NikosVeniz ($13.36 in chips) 
Seat 3: bin600implus ($26.23 in chips) 
Seat 4: Christasm ($10.25 in chips) 
Seat 5: No1Sparkles ($10 in chips) 
Seat 6: Zimniy ($10.27 in chips) 
Zimniy: posts small blind $0.05
Lucky HoBBiT: posts big blind $0.10
*** HOLE CARDS ***
NikosVeniz has timed out
NikosVeniz: folds 
bin600implus: folds 
Christasm: folds 
No1Sparkles: folds 
Zimniy: raises $0.20 to $0.30
Lucky HoBBiT: folds 
Uncalled bet ($0.20) returned to Zimniy
Zimniy collected $0.20 from pot
Zimniy: doesn't show hand 
*** SUMMARY ***
Total pot $0.20 | Rake $0 
Seat 1: Lucky HoBBiT (big blind) folded before Flop
Seat 2: NikosVeniz folded before Flop (didn't bet)
Seat 3: bin600implus folded before Flop (didn't bet)
Seat 4: Christasm folded before Flop (didn't bet)
Seat 5: No1Sparkles (button) folded before Flop (didn't bet)
Seat 6: Zimniy (small blind) collected ($0.20)



PokerStars Hand #222976135948:  Hold'em No Limit ($0.05/$0.10 USD) - 2021/01/23 17:48:52 ET
Table 'Malzovia' 6-max Seat #6 is the button
Seat 1: Lucky HoBBiT ($23.51 in chips) 
Seat 2: NikosVeniz ($13.36 in chips) 
Seat 3: bin600implus ($26.23 in chips) 
Seat 4: Christasm ($10.25 in chips) 
Seat 5: No1Sparkles ($10 in chips) 
Seat 6: Zimniy ($10.37 in chips) 
Lucky HoBBiT: posts small blind $0.05
NikosVeniz: posts big blind $0.10
*** HOLE CARDS ***
bin600implus: folds 
Christasm: raises $0.40 to $0.50
No1Sparkles: folds 
Zimniy: folds 
Lucky HoBBiT: folds 
NikosVeniz: calls $0.40
*** FLOP *** [2h Jd 8h]
NikosVeniz: checks 
Christasm: bets $0.50
NikosVeniz: folds 
Uncalled bet ($0.50) returned to Christasm
Christasm collected $1 from pot
Christasm: doesn't show hand 
*** SUMMARY ***
Total pot $1.05 | Rake $0.05 
Board [2h Jd 8h]
Seat 1: Lucky HoBBiT (small blind) folded before Flop
Seat 2: NikosVeniz (big blind) folded on the Flop
Seat 3: bin600implus folded before Flop (didn't bet)
Seat 4: Christasm collected ($1)
Seat 5: No1Sparkles folded before Flop (didn't bet)
Seat 6: Zimniy (button) folded before Flop (didn't bet)



PokerStars Hand #222976160965:  Hold'em No Limit ($0.05/$0.10 USD) - 2021/01/23 17:49:26 ET
Table 'Malzovia' 6-max Seat #1 is the button
Seat 1: Lucky HoBBiT ($23.46 in chips) 
Seat 2: NikosVeniz ($12.86 in chips) 
Seat 3: bin600implus ($26.23 in chips) 
Seat 4: Christasm ($10.75 in chips) 
Seat 5: No1Sparkles ($10 in chips) 
Seat 6: Zimniy ($10.37 in chips) 
NikosVeniz: posts small blind $0.05
bin600implus: posts big blind $0.10
*** HOLE CARDS ***
Christasm: folds 
No1Sparkles: folds 
Zimniy: folds 
Lucky HoBBiT: raises $0.15 to $0.25
NikosVeniz: calls $0.20
bin600implus: folds 
*** FLOP *** [As Qh Ah]
NikosVeniz: checks 
Lucky HoBBiT: bets $0.20
NikosVeniz: calls $0.20
*** TURN *** [As Qh Ah] [3d]
NikosVeniz: checks 
Lucky HoBBiT: checks 
*** RIVER *** [As Qh Ah 3d] [9c]
NikosVeniz: checks 
Lucky HoBBiT: checks 
*** SHOW DOWN ***
NikosVeniz: shows [4d Ks] (a pair of Aces)
Lucky HoBBiT: shows [6s Qs] (two pair, Aces and Queens)
Lucky HoBBiT collected $0.96 from pot
*** SUMMARY ***
Total pot $1 | Rake $0.04 
Board [As Qh Ah 3d 9c]
Seat 1: Lucky HoBBiT (button) showed [6s Qs] and won ($0.96) with two pair, Aces and Queens
Seat 2: NikosVeniz (small blind) showed [4d Ks] and lost with a pair of Aces
Seat 3: bin600implus (big blind) folded before Flop
Seat 4: Christasm folded before Flop (didn't bet)
Seat 5: No1Sparkles folded before Flop (didn't bet)
Seat 6: Zimniy folded before Flop (didn't bet)



PokerStars Hand #222976190742:  Hold'em No Limit ($0.05/$0.10 USD) - 2021/01/23 17:50:06 ET
Table 'Malzovia' 6-max Seat #2 is the button
Seat 1: Lucky HoBBiT ($23.97 in chips) 
Seat 2: NikosVeniz ($12.41 in chips) 
Seat 3: bin600implus ($26.13 in chips) 
Seat 4: Christasm ($10.75 in chips) 
Seat 5: No1Sparkles ($10 in chips) 
Seat 6: Zimniy ($10.37 in chips) 
bin600implus: posts small blind $0.05
Christasm: posts big blind $0.10
*** HOLE CARDS ***
No1Sparkles: folds 
Zimniy: folds 
Lucky HoBBiT: folds 
NikosVeniz: calls $0.10
bin600implus: calls $0.05
Christasm: checks 
*** FLOP *** [4c Qc 9h]
bin600implus: checks 
Christasm: checks 
NikosVeniz: bets $0.14
bin600implus: folds 
Christasm: calls $0.14
*** TURN *** [4c Qc 9h] [6s]
Christasm: checks 
NikosVeniz: bets $0.27
Christasm: calls $0.27
*** RIVER *** [4c Qc 9h 6s] [7c]
Christasm: checks 
NikosVeniz: bets $0.53
Christasm: calls $0.53
*** SHOW DOWN ***
NikosVeniz: shows [8d Qh] (a pair of Queens)
Christasm: mucks hand 
NikosVeniz collected $2.08 from pot
*** SUMMARY ***
Total pot $2.18 | Rake $0.10 
Board [4c Qc 9h 6s 7c]
Seat 1: Lucky HoBBiT folded before Flop (didn't bet)
Seat 2: NikosVeniz (button) showed [8d Qh] and won ($2.08) with a pair of Queens
Seat 3: bin600implus (small blind) folded on the Flop
Seat 4: Christasm (big blind) mucked
Seat 5: No1Sparkles folded before Flop (didn't bet)
Seat 6: Zimniy folded before Flop (didn't bet)



PokerStars Hand #222976227820:  Hold'em No Limit ($0.05/$0.10 USD) - 2021/01/23 17:50:57 ET
Table 'Malzovia' 6-max Seat #3 is the button
Seat 1: Lucky HoBBiT ($23.97 in chips) 
Seat 2: NikosVeniz ($13.45 in chips) 
Seat 3: bin600implus ($26.03 in chips) 
Seat 4: Christasm ($10 in chips) 
Seat 5: No1Sparkles ($10 in chips) 
Seat 6: Zimniy ($10.37 in chips) 
Christasm: posts small blind $0.05
No1Sparkles: posts big blind $0.10
*** HOLE CARDS ***
Zimniy: folds 
Lucky HoBBiT: folds 
NikosVeniz has timed out
NikosVeniz: folds 
bin600implus: folds 
Christasm: folds 
Uncalled bet ($0.05) returned to No1Sparkles
No1Sparkles collected $0.10 from pot
No1Sparkles: doesn't show hand 
*** SUMMARY ***
Total pot $0.10 | Rake $0 
Seat 1: Lucky HoBBiT folded before Flop (didn't bet)
Seat 2: NikosVeniz folded before Flop (didn't bet)
Seat 3: bin600implus (button) folded before Flop (didn't bet)
Seat 4: Christasm (small blind) folded before Flop
Seat 5: No1Sparkles (big blind) collected ($0.10)
Seat 6: Zimniy folded before Flop (didn't bet)



PokerStars Hand #222976244399:  Hold'em No Limit ($0.05/$0.10 USD) - 2021/01/23 17:51:20 ET
Table 'Malzovia' 6-max Seat #4 is the button
Seat 1: Lucky HoBBiT ($23.97 in chips) 
Seat 2: NikosVeniz ($13.45 in chips) 
Seat 3: bin600implus ($26.03 in chips) 
Seat 4: Christasm ($10 in chips) 
Seat 5: No1Sparkles ($10.05 in chips) 
Seat 6: Zimniy ($10.37 in chips) 
No1Sparkles: posts small blind $0.05
Zimniy: posts big blind $0.10
*** HOLE CARDS ***
Lucky HoBBiT: folds 
NikosVeniz: folds 
bin600implus: raises $0.20 to $0.30
Christasm: folds 
No1Sparkles: folds 
Zimniy: folds 
Uncalled bet ($0.20) returned to bin600implus
bin600implus collected $0.25 from pot
bin600implus: doesn't show hand 
*** SUMMARY ***
Total pot $0.25 | Rake $0 
Seat 1: Lucky HoBBiT folded before Flop (didn't bet)
Seat 2: NikosVeniz folded before Flop (didn't bet)
Seat 3: bin600implus collected ($0.25)
Seat 4: Christasm (button) folded before Flop (didn't bet)
Seat 5: No1Sparkles (small blind) folded before Flop
Seat 6: Zimniy (big blind) folded before Flop



PokerStars Hand #222976258844:  Hold'em No Limit ($0.05/$0.10 USD) - 2021/01/23 17:51:40 ET
Table 'Malzovia' 6-max Seat #5 is the button
Seat 1: Lucky HoBBiT ($23.97 in chips) 
Seat 2: NikosVeniz ($13.45 in chips) 
Seat 3: bin600implus ($26.18 in chips) 
Seat 4: Christasm ($10 in chips) 
Seat 5: No1Sparkles ($10 in chips) 
Seat 6: Zimniy ($10.27 in chips) 
Zimniy: posts small blind $0.05
Lucky HoBBiT: posts big blind $0.10
*** HOLE CARDS ***
NikosVeniz: calls $0.10
bin600implus: folds 
Christasm: folds 
No1Sparkles: folds 
Zimniy: folds 
Lucky HoBBiT: raises $0.35 to $0.45
NikosVeniz: calls $0.35
*** FLOP *** [Jc 2h 9c]
Lucky HoBBiT: bets $0.91
NikosVeniz: folds 
Uncalled bet ($0.91) returned to Lucky HoBBiT
Lucky HoBBiT collected $0.91 from pot
Lucky HoBBiT: doesn't show hand 
*** SUMMARY ***
Total pot $0.95 | Rake $0.04 
Board [Jc 2h 9c]
Seat 1: Lucky HoBBiT (big blind) collected ($0.91)
Seat 2: NikosVeniz folded on the Flop
Seat 3: bin600implus folded before Flop (didn't bet)
Seat 4: Christasm folded before Flop (didn't bet)
Seat 5: No1Sparkles (button) folded before Flop (didn't bet)
Seat 6: Zimniy (small blind) folded before Flop



PokerStars Hand #222976273731:  Hold'em No Limit ($0.05/$0.10 USD) - 2021/01/23 17:52:00 ET
Table 'Malzovia' 6-max Seat #6 is the button
Seat 1: Lucky HoBBiT ($24.43 in chips) 
Seat 2: NikosVeniz ($13 in chips) 
Seat 3: bin600implus ($26.18 in chips) 
Seat 4: Christasm ($10 in chips) 
Seat 5: No1Sparkles ($10 in chips) 
Seat 6: Zimniy ($10.22 in chips) 
Lucky HoBBiT: posts small blind $0.05
NikosVeniz: posts big blind $0.10
*** HOLE CARDS ***
bin600implus: folds 
Christasm: folds 
No1Sparkles: folds 
Zimniy: raises $0.15 to $0.25
Lucky HoBBiT: folds 
NikosVeniz: raises $0.15 to $0.40
Zimniy: calls $0.15
*** FLOP *** [7h 8d 8c]
NikosVeniz: bets $0.40
Zimniy: folds 
Uncalled bet ($0.40) returned to NikosVeniz
NikosVeniz collected $0.81 from pot
NikosVeniz: doesn't show hand 
*** SUMMARY ***
Total pot $0.85 | Rake $0.04 
Board [7h 8d 8c]
Seat 1: Lucky HoBBiT (small blind) folded before Flop
Seat 2: NikosVeniz (big blind) collected ($0.81)
Seat 3: bin600implus folded before Flop (didn't bet)
Seat 4: Christasm folded before Flop (didn't bet)
Seat 5: No1Sparkles folded before Flop (didn't bet)
Seat 6: Zimniy (button) folded on the Flop



PokerStars Hand #222976299239:  Hold'em No Limit ($0.05/$0.10 USD) - 2021/01/23 17:52:35 ET
Table 'Malzovia' 6-max Seat #1 is the button
Seat 1: Lucky HoBBiT ($24.38 in chips) 
Seat 2: NikosVeniz ($13.41 in chips) 
Seat 3: bin600implus ($26.18 in chips) 
Seat 4: Christasm ($10 in chips) 
Seat 5: No1Sparkles ($10 in chips) 
Seat 6: Zimniy ($10 in chips) 
NikosVeniz: posts small blind $0.05
bin600implus: posts big blind $0.10
*** HOLE CARDS ***
Christasm has timed out
Christasm: folds 
No1Sparkles: folds 
Zimniy: folds 
Lucky HoBBiT: folds 
NikosVeniz: calls $0.05
bin600implus: checks 
*** FLOP *** [4s 8d 2c]
NikosVeniz: bets $0.10
bin600implus: calls $0.10
*** TURN *** [4s 8d 2c] [Ah]
NikosVeniz: checks 
bin600implus: bets $0.19
NikosVeniz: folds 
Uncalled bet ($0.19) returned to bin600implus
bin600implus collected $0.38 from pot
bin600implus: doesn't show hand 
*** SUMMARY ***
Total pot $0.40 | Rake $0.02 
Board [4s 8d 2c Ah]
Seat 1: Lucky HoBBiT (button) folded before Flop (didn't bet)
Seat 2: NikosVeniz (small blind) folded on the Turn
Seat 3: bin600implus (big blind) collected ($0.38)
Seat 4: Christasm folded before Flop (didn't bet)
Seat 5: No1Sparkles folded before Flop (didn't bet)
Seat 6: Zimniy folded before Flop (didn't bet)



PokerStars Hand #222976325078:  Hold'em No Limit ($0.05/$0.10 USD) - 2021/01/23 17:53:11 ET
Table 'Malzovia' 6-max Seat #2 is the button
Seat 1: Lucky HoBBiT ($24.38 in chips) 
Seat 2: NikosVeniz ($13.21 in chips) 
Seat 3: bin600implus ($26.36 in chips) 
Seat 4: Christasm ($10 in chips) 
Seat 5: No1Sparkles ($10 in chips) 
Seat 6: Zimniy ($10 in chips) 
bin600implus: posts small blind $0.05
Christasm: posts big blind $0.10
*** HOLE CARDS ***
No1Sparkles: folds 
Zimniy: folds 
Lucky HoBBiT: raises $0.15 to $0.25
NikosVeniz: calls $0.25
bin600implus: folds 
Christasm: folds 
*** FLOP *** [Ah 6d 3h]
Lucky HoBBiT: checks 
NikosVeniz: checks 
*** TURN *** [Ah 6d 3h] [4c]
Lucky HoBBiT: checks 
NikosVeniz: checks 
*** RIVER *** [Ah 6d 3h 4c] [5h]
Lucky HoBBiT: checks 
NikosVeniz: checks 
*** SHOW DOWN ***
Lucky HoBBiT: shows [9s Ks] (high card Ace)
NikosVeniz: shows [8c 6c] (a pair of Sixes)
NikosVeniz collected $0.62 from pot
*** SUMMARY ***
Total pot $0.65 | Rake $0.03 
Board [Ah 6d 3h 4c 5h]
Seat 1: Lucky HoBBiT showed [9s Ks] and lost with high card Ace
Seat 2: NikosVeniz (button) showed [8c 6c] and won ($0.62) with a pair of Sixes
Seat 3: bin600implus (small blind) folded before Flop
Seat 4: Christasm (big blind) folded before Flop
Seat 5: No1Sparkles folded before Flop (didn't bet)
Seat 6: Zimniy folded before Flop (didn't bet)



PokerStars Hand #222976350833:  Hold'em No Limit ($0.05/$0.10 USD) - 2021/01/23 17:53:46 ET
Table 'Malzovia' 6-max Seat #3 is the button
Seat 1: Lucky HoBBiT ($24.13 in chips) 
Seat 2: NikosVeniz ($13.58 in chips) 
Seat 3: bin600implus ($26.31 in chips) 
Seat 4: Christasm ($10 in chips) 
Seat 5: No1Sparkles ($10 in chips) 
Seat 6: Zimniy ($10 in chips) 
Christasm: posts small blind $0.05
No1Sparkles: posts big blind $0.10
*** HOLE CARDS ***
Zimniy: folds 
Lucky HoBBiT: folds 
NikosVeniz: calls $0.10
bin600implus: folds 
Christasm: folds 
No1Sparkles: raises $0.30 to $0.40
NikosVeniz: calls $0.30
*** FLOP *** [2c 2h 4d]
No1Sparkles: bets $0.41
NikosVeniz: raises $0.41 to $0.82
No1Sparkles: folds 
Uncalled bet ($0.41) returned to NikosVeniz
NikosVeniz collected $1.59 from pot
NikosVeniz: doesn't show hand 
*** SUMMARY ***
Total pot $1.67 | Rake $0.08 
Board [2c 2h 4d]
Seat 1: Lucky HoBBiT folded before Flop (didn't bet)
Seat 2: NikosVeniz collected ($1.59)
Seat 3: bin600implus (button) folded before Flop (didn't bet)
Seat 4: Christasm (small blind) folded before Flop
Seat 5: No1Sparkles (big blind) folded on the Flop
Seat 6: Zimniy folded before Flop (didn't bet)



PokerStars Hand #222976376146:  Hold'em No Limit ($0.05/$0.10 USD) - 2021/01/23 17:54:21 ET
Table 'Malzovia' 6-max Seat #4 is the button
Seat 1: Lucky HoBBiT ($24.13 in chips) 
Seat 2: NikosVeniz ($14.36 in chips) 
Seat 3: bin600implus ($26.31 in chips) 
Seat 4: Christasm ($10 in chips) 
Seat 5: No1Sparkles ($10 in chips) 
Seat 6: Zimniy ($10 in chips) 
No1Sparkles: posts small blind $0.05
Zimniy: posts big blind $0.10
*** HOLE CARDS ***
Lucky HoBBiT: folds 
NikosVeniz: folds 
bin600implus: raises $0.20 to $0.30
Christasm has timed out
Christasm: folds 
No1Sparkles: raises $0.70 to $1
Zimniy: folds 
bin600implus: calls $0.70
*** FLOP *** [5c 7s 6s]
No1Sparkles: bets $0.66
bin600implus: raises $1.36 to $2.02
No1Sparkles: folds 
Uncalled bet ($1.36) returned to bin600implus
bin600implus collected $3.27 from pot
bin600implus: doesn't show hand 
*** SUMMARY ***
Total pot $3.42 | Rake $0.15 
Board [5c 7s 6s]
Seat 1: Lucky HoBBiT folded before Flop (didn't bet)
Seat 2: NikosVeniz folded before Flop (didn't bet)
Seat 3: bin600implus collected ($3.27)
Seat 4: Christasm (button) folded before Flop (didn't bet)
Seat 5: No1Sparkles (small blind) folded on the Flop
Seat 6: Zimniy (big blind) folded before Flop



PokerStars Hand #222976418749:  Hold'em No Limit ($0.05/$0.10 USD) - 2021/01/23 17:55:24 ET
Table 'Malzovia' 6-max Seat #5 is the button
Seat 1: Lucky HoBBiT ($24.13 in chips) 
Seat 2: NikosVeniz ($14.36 in chips) 
Seat 3: bin600implus ($27.92 in chips) 
Seat 5: No1Sparkles ($10 in chips) 
Seat 6: Zimniy ($10 in chips) 
Zimniy: posts small blind $0.05
Lucky HoBBiT: posts big blind $0.10
*** HOLE CARDS ***
NikosVeniz: calls $0.10
bin600implus: folds 
No1Sparkles: folds 
Zimniy: folds 
Lucky HoBBiT: checks 
*** FLOP *** [Ad 5c 6c]
Lucky HoBBiT: checks 
NikosVeniz: checks 
*** TURN *** [Ad 5c 6c] [2d]
Lucky HoBBiT: checks 
NikosVeniz: checks 
*** RIVER *** [Ad 5c 6c 2d] [Ah]
Lucky HoBBiT: checks 
NikosVeniz: checks 
*** SHOW DOWN ***
Lucky HoBBiT: shows [Td 4h] (a pair of Aces)
NikosVeniz: mucks hand 
Lucky HoBBiT collected $0.24 from pot
*** SUMMARY ***
Total pot $0.25 | Rake $0.01 
Board [Ad 5c 6c 2d Ah]
Seat 1: Lucky HoBBiT (big blind) showed [Td 4h] and won ($0.24) with a pair of Aces
Seat 2: NikosVeniz mucked
Seat 3: bin600implus folded before Flop (didn't bet)
Seat 5: No1Sparkles (button) folded before Flop (didn't bet)
Seat 6: Zimniy (small blind) folded before Flop



